reg;jour;n_dose1;n_complet;n_cum_dose1;n_cum_complet;couv_dose1;couv_complet
01;2020-12-27;0;0;0;0;0.0;0.0
01;2020-12-28;0;0;0;0;0.0;0.0
01;2020-12-29;0;0;0;0;0.0;0.0
01;2020-12-30;0;0;0;0;0.0;0.0
01;2020-12-31;0;0;0;0;0.0;0.0
01;2021-01-01;1;0;1;0;0.0;0.0
01;2021-01-02;0;0;1;0;0.0;0.0
01;2021-01-03;0;0;1;0;0.0;0.0
01;2021-01-04;1;0;2;0;0.0;0.0
01;2021-01-05;0;0;2;0;0.0;0.0
01;2021-01-06;1;0;3;0;0.0;0.0
01;2021-01-07;0;0;3;0;0.0;0.0
01;2021-01-08;37;0;40;0;0.0;0.0
01;2021-01-09;18;0;58;0;0.0;0.0
01;2021-01-10;0;0;58;0;0.0;0.0
01;2021-01-11;52;0;110;0;0.0;0.0
01;2021-01-12;40;0;150;0;0.0;0.0
01;2021-01-13;45;0;195;0;0.1;0.0
01;2021-01-14;60;0;255;0;0.1;0.0
01;2021-01-15;76;0;331;0;0.1;0.0
01;2021-01-16;0;0;331;0;0.1;0.0
01;2021-01-17;0;0;331;0;0.1;0.0
01;2021-01-18;75;0;406;0;0.1;0.0
01;2021-01-19;137;0;543;0;0.1;0.0
01;2021-01-20;134;0;677;0;0.2;0.0
01;2021-01-21;146;1;823;1;0.2;0.0
01;2021-01-22;131;0;954;1;0.3;0.0
01;2021-01-23;1;0;955;1;0.3;0.0
01;2021-01-24;0;0;955;1;0.3;0.0
01;2021-01-25;203;0;1158;1;0.3;0.0
01;2021-01-26;208;1;1366;2;0.4;0.0
01;2021-01-27;233;0;1599;2;0.4;0.0
01;2021-01-28;228;3;1827;5;0.5;0.0
01;2021-01-29;197;1;2024;6;0.5;0.0
01;2021-01-30;16;0;2040;6;0.5;0.0
01;2021-01-31;1;0;2041;6;0.5;0.0
01;2021-02-01;220;4;2261;10;0.6;0.0
01;2021-02-02;240;26;2501;36;0.7;0.0
01;2021-02-03;209;2;2710;38;0.7;0.0
01;2021-02-04;299;20;3009;58;0.8;0.0
01;2021-02-05;245;32;3254;90;0.9;0.0
01;2021-02-06;47;1;3301;91;0.9;0.0
01;2021-02-07;0;0;3301;91;0.9;0.0
01;2021-02-08;215;23;3516;114;0.9;0.0
01;2021-02-09;284;29;3800;143;1.0;0.0
01;2021-02-10;214;29;4014;172;1.1;0.0
01;2021-02-11;291;109;4305;281;1.1;0.1
01;2021-02-12;283;24;4588;305;1.2;0.1
01;2021-02-13;49;7;4637;312;1.2;0.1
01;2021-02-14;19;36;4656;348;1.2;0.1
01;2021-02-15;67;45;4723;393;1.3;0.1
01;2021-02-16;16;1;4739;394;1.3;0.1
01;2021-02-17;17;1;4756;395;1.3;0.1
01;2021-02-18;211;17;4967;412;1.3;0.1
01;2021-02-19;223;20;5190;432;1.4;0.1
01;2021-02-20;47;0;5237;432;1.4;0.1
01;2021-02-21;1;0;5238;432;1.4;0.1
01;2021-02-22;150;63;5388;495;1.4;0.1
01;2021-02-23;187;73;5575;568;1.5;0.2
01;2021-02-24;304;126;5879;694;1.6;0.2
01;2021-02-25;364;79;6243;773;1.7;0.2
01;2021-02-26;180;83;6423;856;1.7;0.2
01;2021-02-27;63;0;6486;856;1.7;0.2
01;2021-02-28;1;0;6487;856;1.7;0.2
01;2021-03-01;131;81;6618;937;1.8;0.2
01;2021-03-02;235;131;6853;1068;1.8;0.3
01;2021-03-03;206;119;7059;1187;1.9;0.3
01;2021-03-04;296;84;7355;1271;2.0;0.3
01;2021-03-05;315;143;7670;1414;2.0;0.4
01;2021-03-06;583;3;8253;1417;2.2;0.4
01;2021-03-07;1;0;8254;1417;2.2;0.4
01;2021-03-08;271;138;8525;1555;2.3;0.4
01;2021-03-09;350;150;8875;1705;2.4;0.5
01;2021-03-10;357;162;9232;1867;2.4;0.5
01;2021-03-11;119;45;9351;1912;2.5;0.5
01;2021-03-12;369;212;9720;2124;2.6;0.6
01;2021-03-13;130;2;9850;2126;2.6;0.6
01;2021-03-14;13;24;9863;2150;2.6;0.6
01;2021-03-15;403;43;10266;2193;2.7;0.6
01;2021-03-16;446;78;10712;2271;2.8;0.6
01;2021-03-17;413;83;11125;2354;3.0;0.6
01;2021-03-18;535;110;11660;2464;3.1;0.7
01;2021-03-19;517;99;12177;2563;3.2;0.7
01;2021-03-20;173;44;12350;2607;3.3;0.7
01;2021-03-21;8;0;12358;2607;3.3;0.7
01;2021-03-22;332;87;12690;2694;3.4;0.7
01;2021-03-23;481;156;13171;2850;3.5;0.8
01;2021-03-24;453;107;13624;2957;3.6;0.8
01;2021-03-25;726;178;14350;3135;3.8;0.8
01;2021-03-26;632;120;14982;3255;4.0;0.9
01;2021-03-27;262;48;15244;3303;4.0;0.9
01;2021-03-28;7;0;15251;3303;4.0;0.9
01;2021-03-29;358;81;15609;3384;4.1;0.9
01;2021-03-30;595;162;16204;3546;4.3;0.9
01;2021-03-31;514;128;16718;3674;4.4;1.0
01;2021-04-01;618;199;17336;3873;4.6;1.0
01;2021-04-02;38;35;17374;3908;4.6;1.0
01;2021-04-03;42;2;17416;3910;4.6;1.0
01;2021-04-04;4;18;17420;3928;4.6;1.0
01;2021-04-05;4;0;17424;3928;4.6;1.0
01;2021-04-06;423;189;17847;4117;4.7;1.1
01;2021-04-07;566;115;18413;4232;4.9;1.1
01;2021-04-08;480;159;18893;4391;5.0;1.2
01;2021-04-09;465;209;19358;4600;5.1;1.2
01;2021-04-10;97;4;19455;4604;5.2;1.2
01;2021-04-11;2;25;19457;4629;5.2;1.2
01;2021-04-12;280;257;19737;4886;5.2;1.3
01;2021-04-13;544;318;20281;5204;5.4;1.4
01;2021-04-14;416;221;20697;5425;5.5;1.4
01;2021-04-15;542;316;21239;5741;5.6;1.5
01;2021-04-16;544;266;21783;6007;5.8;1.6
01;2021-04-17;186;2;21969;6009;5.8;1.6
01;2021-04-18;4;14;21973;6023;5.8;1.6
01;2021-04-19;384;238;22357;6261;5.9;1.7
01;2021-04-20;709;343;23066;6604;6.1;1.8
01;2021-04-21;608;311;23674;6915;6.3;1.8
01;2021-04-22;790;330;24464;7245;6.5;1.9
01;2021-04-23;836;248;25300;7493;6.7;2.0
01;2021-04-24;336;75;25636;7568;6.8;2.0
01;2021-04-25;594;64;26230;7632;7.0;2.0
01;2021-04-26;935;212;27165;7844;7.2;2.1
01;2021-04-27;626;227;27791;8071;7.4;2.1
01;2021-04-28;829;263;28620;8334;7.6;2.2
01;2021-04-29;1186;189;29806;8523;7.9;2.3
01;2021-04-30;1250;170;31056;8693;8.2;2.3
01;2021-05-01;593;38;31649;8731;8.4;2.3
01;2021-05-02;341;17;31990;8748;8.5;2.3
01;2021-05-03;917;171;32907;8919;8.7;2.4
01;2021-05-04;941;196;33848;9115;9.0;2.4
01;2021-05-05;963;242;34811;9357;9.2;2.5
01;2021-05-06;1104;166;35915;9523;9.5;2.5
01;2021-05-07;1205;257;37120;9780;9.8;2.6
01;2021-05-08;314;32;37434;9812;9.9;2.6
01;2021-05-09;178;9;37612;9821;10.0;2.6
01;2021-05-10;829;209;38441;10030;10.2;2.7
01;2021-05-11;928;309;39369;10339;10.4;2.7
01;2021-05-12;890;321;40259;10660;10.7;2.8
01;2021-05-13;209;80;40468;10740;10.7;2.8
01;2021-05-14;846;269;41314;11009;11.0;2.9
01;2021-05-15;440;13;41754;11022;11.1;2.9
01;2021-05-16;180;34;41934;11056;11.1;2.9
01;2021-05-17;693;268;42627;11324;11.3;3.0
01;2021-05-18;689;388;43316;11712;11.5;3.1
01;2021-05-19;675;520;43991;12232;11.7;3.2
01;2021-05-20;750;365;44741;12597;11.9;3.3
01;2021-05-21;789;400;45530;12997;12.1;3.4
01;2021-05-22;475;217;46005;13214;12.2;3.5
01;2021-05-23;199;115;46204;13329;12.3;3.5
01;2021-05-24;194;176;46398;13505;12.3;3.6
01;2021-05-25;499;664;46897;14169;12.4;3.8
01;2021-05-26;556;493;47453;14662;12.6;3.9
01;2021-05-27;127;185;47580;14847;12.6;3.9
01;2021-05-28;499;522;48079;15369;12.8;4.1
01;2021-05-29;220;138;48299;15507;12.8;4.1
01;2021-05-30;71;111;48370;15618;12.8;4.1
01;2021-05-31;410;536;48780;16154;12.9;4.3
01;2021-06-01;516;715;49296;16869;13.1;4.5
01;2021-06-02;528;709;49824;17578;13.2;4.7
01;2021-06-03;467;561;50291;18139;13.3;4.8
01;2021-06-04;613;800;50904;18939;13.5;5.0
01;2021-06-05;264;641;51168;19580;13.6;5.2
01;2021-06-06;121;530;51289;20110;13.6;5.3
01;2021-06-07;319;783;51608;20893;13.7;5.5
01;2021-06-08;441;888;52049;21781;13.8;5.8
01;2021-06-09;389;858;52438;22639;13.9;6.0
01;2021-06-10;461;850;52899;23489;14.0;6.2
01;2021-06-11;440;1230;53339;24719;14.2;6.6
01;2021-06-12;289;660;53628;25379;14.2;6.7
01;2021-06-13;129;314;53757;25693;14.3;6.8
01;2021-06-14;350;3808;54107;29501;14.4;7.8
01;2021-06-15;446;2010;54553;31511;14.5;8.4
01;2021-06-16;445;1490;54998;33001;14.6;8.8
01;2021-06-17;410;1010;55408;34011;14.7;9.0
01;2021-06-18;451;1016;55859;35027;14.8;9.3
01;2021-06-19;294;507;56153;35534;14.9;9.4
01;2021-06-20;107;232;56260;35766;14.9;9.5
01;2021-06-21;312;682;56572;36448;15.0;9.7
01;2021-06-22;313;867;56885;37315;15.1;9.9
01;2021-06-23;343;890;57228;38205;15.2;10.1
01;2021-06-24;354;728;57582;38933;15.3;10.3
02;2020-12-27;0;0;0;0;0.0;0.0
02;2020-12-28;0;0;0;0;0.0;0.0
02;2020-12-29;0;0;0;0;0.0;0.0
02;2020-12-30;0;0;0;0;0.0;0.0
02;2020-12-31;0;0;0;0;0.0;0.0
02;2021-01-01;0;0;0;0;0.0;0.0
02;2021-01-02;0;0;0;0;0.0;0.0
02;2021-01-03;0;0;0;0;0.0;0.0
02;2021-01-04;0;0;0;0;0.0;0.0
02;2021-01-05;0;0;0;0;0.0;0.0
02;2021-01-06;5;0;5;0;0.0;0.0
02;2021-01-07;31;0;36;0;0.0;0.0
02;2021-01-08;80;1;116;1;0.0;0.0
02;2021-01-09;20;0;136;1;0.0;0.0
02;2021-01-10;0;0;136;1;0.0;0.0
02;2021-01-11;122;0;258;1;0.1;0.0
02;2021-01-12;78;0;336;1;0.1;0.0
02;2021-01-13;64;0;400;1;0.1;0.0
02;2021-01-14;88;1;488;2;0.1;0.0
02;2021-01-15;136;0;624;2;0.2;0.0
02;2021-01-16;51;0;675;2;0.2;0.0
02;2021-01-17;0;0;675;2;0.2;0.0
02;2021-01-18;157;0;832;2;0.2;0.0
02;2021-01-19;168;1;1000;3;0.3;0.0
02;2021-01-20;163;0;1163;3;0.3;0.0
02;2021-01-21;181;1;1344;4;0.4;0.0
02;2021-01-22;156;0;1500;4;0.4;0.0
02;2021-01-23;58;0;1558;4;0.4;0.0
02;2021-01-24;0;0;1558;4;0.4;0.0
02;2021-01-25;159;0;1717;4;0.5;0.0
02;2021-01-26;137;0;1854;4;0.5;0.0
02;2021-01-27;161;5;2015;9;0.6;0.0
02;2021-01-28;143;12;2158;21;0.6;0.0
02;2021-01-29;142;41;2300;62;0.6;0.0
02;2021-01-30;96;16;2396;78;0.7;0.0
02;2021-01-31;0;0;2396;78;0.7;0.0
02;2021-02-01;119;74;2515;152;0.7;0.0
02;2021-02-02;184;95;2699;247;0.8;0.1
02;2021-02-03;130;80;2829;327;0.8;0.1
02;2021-02-04;158;73;2987;400;0.8;0.1
02;2021-02-05;120;97;3107;497;0.9;0.1
02;2021-02-06;62;26;3169;523;0.9;0.1
02;2021-02-07;1;0;3170;523;0.9;0.1
02;2021-02-08;137;80;3307;603;0.9;0.2
02;2021-02-09;175;78;3482;681;1.0;0.2
02;2021-02-10;138;90;3620;771;1.0;0.2
02;2021-02-11;150;103;3770;874;1.1;0.2
02;2021-02-12;124;130;3894;1004;1.1;0.3
02;2021-02-13;38;37;3932;1041;1.1;0.3
02;2021-02-14;0;0;3932;1041;1.1;0.3
02;2021-02-15;51;67;3983;1108;1.1;0.3
02;2021-02-16;0;1;3983;1109;1.1;0.3
02;2021-02-17;1;3;3984;1112;1.1;0.3
02;2021-02-18;68;128;4052;1240;1.1;0.3
02;2021-02-19;69;131;4121;1371;1.1;0.4
02;2021-02-20;48;69;4169;1440;1.2;0.4
02;2021-02-21;0;0;4169;1440;1.2;0.4
02;2021-02-22;100;60;4269;1500;1.2;0.4
02;2021-02-23;113;238;4382;1738;1.2;0.5
02;2021-02-24;106;223;4488;1961;1.3;0.5
02;2021-02-25;89;151;4577;2112;1.3;0.6
02;2021-02-26;126;169;4703;2281;1.3;0.6
02;2021-02-27;69;52;4772;2333;1.3;0.7
02;2021-02-28;0;0;4772;2333;1.3;0.7
02;2021-03-01;138;144;4910;2477;1.4;0.7
02;2021-03-02;158;78;5068;2555;1.4;0.7
02;2021-03-03;178;145;5246;2700;1.5;0.8
02;2021-03-04;145;135;5391;2835;1.5;0.8
02;2021-03-05;238;127;5629;2962;1.6;0.8
02;2021-03-06;119;59;5748;3021;1.6;0.8
02;2021-03-07;100;1;5848;3022;1.6;0.8
02;2021-03-08;196;132;6044;3154;1.7;0.9
02;2021-03-09;269;102;6313;3256;1.8;0.9
02;2021-03-10;324;134;6637;3390;1.9;0.9
02;2021-03-11;331;83;6968;3473;1.9;1.0
02;2021-03-12;398;53;7366;3526;2.1;1.0
02;2021-03-13;155;21;7521;3547;2.1;1.0
02;2021-03-14;4;1;7525;3548;2.1;1.0
02;2021-03-15;276;92;7801;3640;2.2;1.0
02;2021-03-16;305;55;8106;3695;2.3;1.0
02;2021-03-17;387;49;8493;3744;2.4;1.0
02;2021-03-18;435;44;8928;3788;2.5;1.1
02;2021-03-19;396;62;9324;3850;2.6;1.1
02;2021-03-20;149;48;9473;3898;2.6;1.1
02;2021-03-21;25;1;9498;3899;2.6;1.1
02;2021-03-22;362;116;9860;4015;2.7;1.1
02;2021-03-23;401;123;10261;4138;2.9;1.2
02;2021-03-24;427;104;10688;4242;3.0;1.2
02;2021-03-25;470;99;11158;4341;3.1;1.2
02;2021-03-26;632;100;11790;4441;3.3;1.2
02;2021-03-27;152;71;11942;4512;3.3;1.3
02;2021-03-28;81;2;12023;4514;3.4;1.3
02;2021-03-29;421;165;12444;4679;3.5;1.3
02;2021-03-30;468;244;12912;4923;3.6;1.4
02;2021-03-31;1143;187;14055;5110;3.9;1.4
02;2021-04-01;951;170;15006;5280;4.2;1.5
02;2021-04-02;895;8;15901;5288;4.4;1.5
02;2021-04-03;788;50;16689;5338;4.7;1.5
02;2021-04-04;750;10;17439;5348;4.9;1.5
02;2021-04-05;828;39;18267;5387;5.1;1.5
02;2021-04-06;883;133;19150;5520;5.3;1.5
02;2021-04-07;1430;324;20580;5844;5.7;1.6
02;2021-04-08;1303;268;21883;6112;6.1;1.7
02;2021-04-09;1239;317;23122;6429;6.4;1.8
02;2021-04-10;837;164;23959;6593;6.7;1.8
02;2021-04-11;621;12;24580;6605;6.9;1.8
02;2021-04-12;868;314;25448;6919;7.1;1.9
02;2021-04-13;867;326;26315;7245;7.3;2.0
02;2021-04-14;957;324;27272;7569;7.6;2.1
02;2021-04-15;958;294;28230;7863;7.9;2.2
02;2021-04-16;991;298;29221;8161;8.1;2.3
02;2021-04-17;528;161;29749;8322;8.3;2.3
02;2021-04-18;339;56;30088;8378;8.4;2.3
02;2021-04-19;668;347;30756;8725;8.6;2.4
02;2021-04-20;868;310;31624;9035;8.8;2.5
02;2021-04-21;999;358;32623;9393;9.1;2.6
02;2021-04-22;602;313;33225;9706;9.3;2.7
02;2021-04-23;605;466;33830;10172;9.4;2.8
02;2021-04-24;360;197;34190;10369;9.5;2.9
02;2021-04-25;168;200;34358;10569;9.6;2.9
02;2021-04-26;515;543;34873;11112;9.7;3.1
02;2021-04-27;558;609;35431;11721;9.9;3.3
02;2021-04-28;449;693;35880;12414;10.0;3.5
02;2021-04-29;651;643;36531;13057;10.2;3.6
02;2021-04-30;770;688;37301;13745;10.4;3.8
02;2021-05-01;243;246;37544;13991;10.5;3.9
02;2021-05-02;226;513;37770;14504;10.5;4.0
02;2021-05-03;569;772;38339;15276;10.7;4.3
02;2021-05-04;524;677;38863;15953;10.8;4.4
02;2021-05-05;541;898;39404;16851;11.0;4.7
02;2021-05-06;546;783;39950;17634;11.1;4.9
02;2021-05-07;629;1016;40579;18650;11.3;5.2
02;2021-05-08;224;526;40803;19176;11.4;5.3
02;2021-05-09;174;506;40977;19682;11.4;5.5
02;2021-05-10;520;861;41497;20543;11.6;5.7
02;2021-05-11;477;875;41974;21418;11.7;6.0
02;2021-05-12;556;914;42530;22332;11.9;6.2
02;2021-05-13;271;534;42801;22866;11.9;6.4
02;2021-05-14;386;753;43187;23619;12.0;6.6
02;2021-05-15;231;581;43418;24200;12.1;6.7
02;2021-05-16;155;442;43573;24642;12.1;6.9
02;2021-05-17;471;756;44044;25398;12.3;7.1
02;2021-05-18;443;677;44487;26075;12.4;7.3
02;2021-05-19;440;742;44927;26817;12.5;7.5
02;2021-05-20;588;501;45515;27318;12.7;7.6
02;2021-05-21;544;705;46059;28023;12.8;7.8
02;2021-05-22;184;365;46243;28388;12.9;7.9
02;2021-05-23;110;181;46353;28569;12.9;8.0
02;2021-05-24;133;242;46486;28811;13.0;8.0
02;2021-05-25;348;706;46834;29517;13.1;8.2
02;2021-05-26;376;713;47210;30230;13.2;8.4
02;2021-05-27;262;648;47472;30878;13.2;8.6
02;2021-05-28;268;820;47740;31698;13.3;8.8
02;2021-05-29;148;512;47888;32210;13.3;9.0
02;2021-05-30;16;33;47904;32243;13.4;9.0
02;2021-05-31;342;686;48246;32929;13.4;9.2
02;2021-06-01;289;548;48535;33477;13.5;9.3
02;2021-06-02;310;574;48845;34051;13.6;9.5
02;2021-06-03;246;431;49091;34482;13.7;9.6
02;2021-06-04;348;651;49439;35133;13.8;9.8
02;2021-06-05;234;362;49673;35495;13.8;9.9
02;2021-06-06;21;31;49694;35526;13.9;9.9
02;2021-06-07;257;741;49951;36267;13.9;10.1
02;2021-06-08;249;591;50200;36858;14.0;10.3
02;2021-06-09;293;704;50493;37562;14.1;10.5
02;2021-06-10;299;454;50792;38016;14.2;10.6
02;2021-06-11;334;543;51126;38559;14.3;10.7
02;2021-06-12;243;323;51369;38882;14.3;10.8
02;2021-06-13;32;29;51401;38911;14.3;10.8
02;2021-06-14;363;553;51764;39464;14.4;11.0
02;2021-06-15;407;494;52171;39958;14.5;11.1
02;2021-06-16;411;444;52582;40402;14.7;11.3
02;2021-06-17;346;578;52928;40980;14.8;11.4
02;2021-06-18;419;542;53347;41522;14.9;11.6
02;2021-06-19;225;195;53572;41717;14.9;11.6
02;2021-06-20;25;17;53597;41734;14.9;11.6
02;2021-06-21;317;578;53914;42312;15.0;11.8
02;2021-06-22;288;464;54202;42776;15.1;11.9
02;2021-06-23;405;561;54607;43337;15.2;12.1
02;2021-06-24;280;432;54887;43769;15.3;12.2
03;2020-12-27;0;0;0;0;0.0;0.0
03;2020-12-28;0;0;0;0;0.0;0.0
03;2020-12-29;0;0;0;0;0.0;0.0
03;2020-12-30;0;0;0;0;0.0;0.0
03;2020-12-31;0;0;0;0;0.0;0.0
03;2021-01-01;0;0;0;0;0.0;0.0
03;2021-01-02;2;2;2;2;0.0;0.0
03;2021-01-03;0;0;2;2;0.0;0.0
03;2021-01-04;0;0;2;2;0.0;0.0
03;2021-01-05;0;0;2;2;0.0;0.0
03;2021-01-06;0;0;2;2;0.0;0.0
03;2021-01-07;0;0;2;2;0.0;0.0
03;2021-01-08;0;0;2;2;0.0;0.0
03;2021-01-09;0;0;2;2;0.0;0.0
03;2021-01-10;0;0;2;2;0.0;0.0
03;2021-01-11;0;0;2;2;0.0;0.0
03;2021-01-12;0;0;2;2;0.0;0.0
03;2021-01-13;30;0;32;2;0.0;0.0
03;2021-01-14;46;0;78;2;0.0;0.0
03;2021-01-15;34;0;112;2;0.0;0.0
03;2021-01-16;18;0;130;2;0.0;0.0
03;2021-01-17;0;0;130;2;0.0;0.0
03;2021-01-18;63;0;193;2;0.1;0.0
03;2021-01-19;149;1;342;3;0.1;0.0
03;2021-01-20;132;0;474;3;0.2;0.0
03;2021-01-21;118;0;592;3;0.2;0.0
03;2021-01-22;76;0;668;3;0.2;0.0
03;2021-01-23;0;0;668;3;0.2;0.0
03;2021-01-24;0;0;668;3;0.2;0.0
03;2021-01-25;56;0;724;3;0.2;0.0
03;2021-01-26;100;0;824;3;0.3;0.0
03;2021-01-27;109;1;933;4;0.3;0.0
03;2021-01-28;96;2;1029;6;0.4;0.0
03;2021-01-29;104;3;1133;9;0.4;0.0
03;2021-01-30;0;0;1133;9;0.4;0.0
03;2021-01-31;0;0;1133;9;0.4;0.0
03;2021-02-01;54;0;1187;9;0.4;0.0
03;2021-02-02;122;4;1309;13;0.5;0.0
03;2021-02-03;116;7;1425;20;0.5;0.0
03;2021-02-04;79;26;1504;46;0.5;0.0
03;2021-02-05;65;8;1569;54;0.5;0.0
03;2021-02-06;0;0;1569;54;0.5;0.0
03;2021-02-07;0;0;1569;54;0.5;0.0
03;2021-02-08;51;13;1620;67;0.6;0.0
03;2021-02-09;92;39;1712;106;0.6;0.0
03;2021-02-10;101;42;1813;148;0.6;0.1
03;2021-02-11;102;93;1915;241;0.7;0.1
03;2021-02-12;86;65;2001;306;0.7;0.1
03;2021-02-13;0;0;2001;306;0.7;0.1
03;2021-02-14;0;0;2001;306;0.7;0.1
03;2021-02-15;27;65;2028;371;0.7;0.1
03;2021-02-16;123;53;2151;424;0.7;0.1
03;2021-02-17;145;119;2296;543;0.8;0.2
03;2021-02-18;102;143;2398;686;0.8;0.2
03;2021-02-19;121;72;2519;758;0.9;0.3
03;2021-02-20;0;0;2519;758;0.9;0.3
03;2021-02-21;0;0;2519;758;0.9;0.3
03;2021-02-22;78;49;2597;807;0.9;0.3
03;2021-02-23;158;100;2755;907;0.9;0.3
03;2021-02-24;190;120;2945;1027;1.0;0.4
03;2021-02-25;258;87;3203;1114;1.1;0.4
03;2021-02-26;264;69;3467;1183;1.2;0.4
03;2021-02-27;121;1;3588;1184;1.2;0.4
03;2021-02-28;0;0;3588;1184;1.2;0.4
03;2021-03-01;180;85;3768;1269;1.3;0.4
03;2021-03-02;255;108;4023;1377;1.4;0.5
03;2021-03-03;255;130;4278;1507;1.5;0.5
03;2021-03-04;281;81;4559;1588;1.6;0.5
03;2021-03-05;270;44;4829;1632;1.7;0.6
03;2021-03-06;116;1;4945;1633;1.7;0.6
03;2021-03-07;0;0;4945;1633;1.7;0.6
03;2021-03-08;187;41;5132;1674;1.8;0.6
03;2021-03-09;349;91;5481;1765;1.9;0.6
03;2021-03-10;357;99;5838;1864;2.0;0.6
03;2021-03-11;270;120;6108;1984;2.1;0.7
03;2021-03-12;285;92;6393;2076;2.2;0.7
03;2021-03-13;110;2;6503;2078;2.2;0.7
03;2021-03-14;0;0;6503;2078;2.2;0.7
03;2021-03-15;180;26;6683;2104;2.3;0.7
03;2021-03-16;241;139;6924;2243;2.4;0.8
03;2021-03-17;273;128;7197;2371;2.5;0.8
03;2021-03-18;250;153;7447;2524;2.6;0.9
03;2021-03-19;284;126;7731;2650;2.7;0.9
03;2021-03-20;255;14;7986;2664;2.7;0.9
03;2021-03-21;119;0;8105;2664;2.8;0.9
03;2021-03-22;219;112;8324;2776;2.9;1.0
03;2021-03-23;261;186;8585;2962;3.0;1.0
03;2021-03-24;225;209;8810;3171;3.0;1.1
03;2021-03-25;167;176;8977;3347;3.1;1.2
03;2021-03-26;189;306;9166;3653;3.2;1.3
03;2021-03-27;55;93;9221;3746;3.2;1.3
03;2021-03-28;0;0;9221;3746;3.2;1.3
03;2021-03-29;174;244;9395;3990;3.2;1.4
03;2021-03-30;446;235;9841;4225;3.4;1.5
03;2021-03-31;318;291;10159;4516;3.5;1.6
03;2021-04-01;445;261;10604;4777;3.6;1.6
03;2021-04-02;306;279;10910;5056;3.8;1.7
03;2021-04-03;151;122;11061;5178;3.8;1.8
03;2021-04-04;0;0;11061;5178;3.8;1.8
03;2021-04-05;118;14;11179;5192;3.8;1.8
03;2021-04-06;439;330;11618;5522;4.0;1.9
03;2021-04-07;500;341;12118;5863;4.2;2.0
03;2021-04-08;510;264;12628;6127;4.3;2.1
03;2021-04-09;493;225;13121;6352;4.5;2.2
03;2021-04-10;146;91;13267;6443;4.6;2.2
03;2021-04-11;2;0;13269;6443;4.6;2.2
03;2021-04-12;551;269;13820;6712;4.8;2.3
03;2021-04-13;671;240;14491;6952;5.0;2.4
03;2021-04-14;717;310;15208;7262;5.2;2.5
03;2021-04-15;758;243;15966;7505;5.5;2.6
03;2021-04-16;709;297;16675;7802;5.7;2.7
03;2021-04-17;476;125;17151;7927;5.9;2.7
03;2021-04-18;489;37;17640;7964;6.1;2.7
03;2021-04-19;682;248;18322;8212;6.3;2.8
03;2021-04-20;550;268;18872;8480;6.5;2.9
03;2021-04-21;794;238;19666;8718;6.8;3.0
03;2021-04-22;656;216;20322;8934;7.0;3.1
03;2021-04-23;663;220;20985;9154;7.2;3.1
03;2021-04-24;523;95;21508;9249;7.4;3.2
03;2021-04-25;602;42;22110;9291;7.6;3.2
03;2021-04-26;734;223;22844;9514;7.9;3.3
03;2021-04-27;765;337;23609;9851;8.1;3.4
03;2021-04-28;674;324;24283;10175;8.4;3.5
03;2021-04-29;611;277;24894;10452;8.6;3.6
03;2021-04-30;672;252;25566;10704;8.8;3.7
03;2021-05-01;209;26;25775;10730;8.9;3.7
03;2021-05-02;594;76;26369;10806;9.1;3.7
03;2021-05-03;554;390;26923;11196;9.3;3.9
03;2021-05-04;613;311;27536;11507;9.5;4.0
03;2021-05-05;647;445;28183;11952;9.7;4.1
03;2021-05-06;624;461;28807;12413;9.9;4.3
03;2021-05-07;539;462;29346;12875;10.1;4.4
03;2021-05-08;341;57;29687;12932;10.2;4.4
03;2021-05-09;262;73;29949;13005;10.3;4.5
03;2021-05-10;418;612;30367;13617;10.4;4.7
03;2021-05-11;375;491;30742;14108;10.6;4.9
03;2021-05-12;462;639;31204;14747;10.7;5.1
03;2021-05-13;332;98;31536;14845;10.8;5.1
03;2021-05-14;470;548;32006;15393;11.0;5.3
03;2021-05-15;253;344;32259;15737;11.1;5.4
03;2021-05-16;206;210;32465;15947;11.2;5.5
03;2021-05-17;443;600;32908;16547;11.3;5.7
03;2021-05-18;556;562;33464;17109;11.5;5.9
03;2021-05-19;507;547;33971;17656;11.7;6.1
03;2021-05-20;609;445;34580;18101;11.9;6.2
03;2021-05-21;482;601;35062;18702;12.1;6.4
03;2021-05-22;167;501;35229;19203;12.1;6.6
03;2021-05-23;267;472;35496;19675;12.2;6.8
03;2021-05-24;559;244;36055;19919;12.4;6.9
03;2021-05-25;494;740;36549;20659;12.6;7.1
03;2021-05-26;406;681;36955;21340;12.7;7.3
03;2021-05-27;656;516;37611;21856;12.9;7.5
03;2021-05-28;480;549;38091;22405;13.1;7.7
03;2021-05-29;231;362;38322;22767;13.2;7.8
03;2021-05-30;146;401;38468;23168;13.2;8.0
03;2021-05-31;337;573;38805;23741;13.3;8.2
03;2021-06-01;382;466;39187;24207;13.5;8.3
03;2021-06-02;500;549;39687;24756;13.7;8.5
03;2021-06-03;413;466;40100;25222;13.8;8.7
03;2021-06-04;518;489;40618;25711;14.0;8.8
03;2021-06-05;269;293;40887;26004;14.1;8.9
03;2021-06-06;208;299;41095;26303;14.1;9.0
03;2021-06-07;458;448;41553;26751;14.3;9.2
03;2021-06-08;508;312;42061;27063;14.5;9.3
03;2021-06-09;480;379;42541;27442;14.6;9.4
03;2021-06-10;345;290;42886;27732;14.8;9.5
03;2021-06-11;389;468;43275;28200;14.9;9.7
03;2021-06-12;163;285;43438;28485;14.9;9.8
03;2021-06-13;200;267;43638;28752;15.0;9.9
03;2021-06-14;350;547;43988;29299;15.1;10.1
03;2021-06-15;355;439;44343;29738;15.3;10.2
03;2021-06-16;389;450;44732;30188;15.4;10.4
03;2021-06-17;364;575;45096;30763;15.5;10.6
03;2021-06-18;336;561;45432;31324;15.6;10.8
03;2021-06-19;230;259;45662;31583;15.7;10.9
03;2021-06-20;123;272;45785;31855;15.8;11.0
03;2021-06-21;264;597;46049;32452;15.8;11.2
03;2021-06-22;307;456;46356;32908;15.9;11.3
03;2021-06-23;269;529;46625;33437;16.0;11.5
03;2021-06-24;341;493;46966;33930;16.2;11.7
04;2020-12-27;0;0;0;0;0.0;0.0
04;2020-12-28;0;0;0;0;0.0;0.0
04;2020-12-29;0;0;0;0;0.0;0.0
04;2020-12-30;0;0;0;0;0.0;0.0
04;2020-12-31;0;0;0;0;0.0;0.0
04;2021-01-01;1;0;1;0;0.0;0.0
04;2021-01-02;0;0;1;0;0.0;0.0
04;2021-01-03;0;0;1;0;0.0;0.0
04;2021-01-04;0;0;1;0;0.0;0.0
04;2021-01-05;2;0;3;0;0.0;0.0
04;2021-01-06;0;0;3;0;0.0;0.0
04;2021-01-07;0;0;3;0;0.0;0.0
04;2021-01-08;0;0;3;0;0.0;0.0
04;2021-01-09;1;0;4;0;0.0;0.0
04;2021-01-10;0;0;4;0;0.0;0.0
04;2021-01-11;0;0;4;0;0.0;0.0
04;2021-01-12;0;0;4;0;0.0;0.0
04;2021-01-13;0;0;4;0;0.0;0.0
04;2021-01-14;0;0;4;0;0.0;0.0
04;2021-01-15;332;0;336;0;0.0;0.0
04;2021-01-16;27;0;363;0;0.0;0.0
04;2021-01-17;0;0;363;0;0.0;0.0
04;2021-01-18;49;1;412;1;0.0;0.0
04;2021-01-19;393;0;805;1;0.1;0.0
04;2021-01-20;482;1;1287;2;0.1;0.0
04;2021-01-21;614;1;1901;3;0.2;0.0
04;2021-01-22;409;1;2310;4;0.3;0.0
04;2021-01-23;75;0;2385;4;0.3;0.0
04;2021-01-24;0;0;2385;4;0.3;0.0
04;2021-01-25;272;0;2657;4;0.3;0.0
04;2021-01-26;429;0;3086;4;0.4;0.0
04;2021-01-27;317;0;3403;4;0.4;0.0
04;2021-01-28;406;0;3809;4;0.4;0.0
04;2021-01-29;421;3;4230;7;0.5;0.0
04;2021-01-30;419;0;4649;7;0.5;0.0
04;2021-01-31;0;0;4649;7;0.5;0.0
04;2021-02-01;372;3;5021;10;0.6;0.0
04;2021-02-02;498;4;5519;14;0.6;0.0
04;2021-02-03;602;14;6121;28;0.7;0.0
04;2021-02-04;626;22;6747;50;0.8;0.0
04;2021-02-05;564;98;7311;148;0.9;0.0
04;2021-02-06;501;4;7812;152;0.9;0.0
04;2021-02-07;0;8;7812;160;0.9;0.0
04;2021-02-08;472;34;8284;194;1.0;0.0
04;2021-02-09;783;90;9067;284;1.1;0.0
04;2021-02-10;820;85;9887;369;1.1;0.0
04;2021-02-11;796;86;10683;455;1.2;0.1
04;2021-02-12;637;95;11320;550;1.3;0.1
04;2021-02-13;651;74;11971;624;1.4;0.1
04;2021-02-14;1;0;11972;624;1.4;0.1
04;2021-02-15;524;126;12496;750;1.5;0.1
04;2021-02-16;650;535;13146;1285;1.5;0.1
04;2021-02-17;592;329;13738;1614;1.6;0.2
04;2021-02-18;493;414;14231;2028;1.7;0.2
04;2021-02-19;496;321;14727;2349;1.7;0.3
04;2021-02-20;576;117;15303;2466;1.8;0.3
04;2021-02-21;0;0;15303;2466;1.8;0.3
04;2021-02-22;401;238;15704;2704;1.8;0.3
04;2021-02-23;607;238;16311;2942;1.9;0.3
04;2021-02-24;583;255;16894;3197;2.0;0.4
04;2021-02-25;645;298;17539;3495;2.0;0.4
04;2021-02-26;483;473;18022;3968;2.1;0.5
04;2021-02-27;386;472;18408;4440;2.1;0.5
04;2021-02-28;0;0;18408;4440;2.1;0.5
04;2021-03-01;289;392;18697;4832;2.2;0.6
04;2021-03-02;487;504;19184;5336;2.2;0.6
04;2021-03-03;755;559;19939;5895;2.3;0.7
04;2021-03-04;775;543;20714;6438;2.4;0.7
04;2021-03-05;727;542;21441;6980;2.5;0.8
04;2021-03-06;812;530;22253;7510;2.6;0.9
04;2021-03-07;0;0;22253;7510;2.6;0.9
04;2021-03-08;436;591;22689;8101;2.6;0.9
04;2021-03-09;670;777;23359;8878;2.7;1.0
04;2021-03-10;644;849;24003;9727;2.8;1.1
04;2021-03-11;699;649;24702;10376;2.9;1.2
04;2021-03-12;729;666;25431;11042;3.0;1.3
04;2021-03-13;667;610;26098;11652;3.0;1.4
04;2021-03-14;2;0;26100;11652;3.0;1.4
04;2021-03-15;504;507;26604;12159;3.1;1.4
04;2021-03-16;680;711;27284;12870;3.2;1.5
04;2021-03-17;847;538;28131;13408;3.3;1.6
04;2021-03-18;1021;556;29152;13964;3.4;1.6
04;2021-03-19;784;543;29936;14507;3.5;1.7
04;2021-03-20;576;600;30512;15107;3.5;1.8
04;2021-03-21;0;0;30512;15107;3.5;1.8
04;2021-03-22;565;482;31077;15589;3.6;1.8
04;2021-03-23;780;640;31857;16229;3.7;1.9
04;2021-03-24;792;671;32649;16900;3.8;2.0
04;2021-03-25;929;555;33578;17455;3.9;2.0
04;2021-03-26;921;450;34499;17905;4.0;2.1
04;2021-03-27;782;340;35281;18245;4.1;2.1
04;2021-03-28;1;0;35282;18245;4.1;2.1
04;2021-03-29;960;272;36242;18517;4.2;2.2
04;2021-03-30;883;503;37125;19020;4.3;2.2
04;2021-03-31;740;674;37865;19694;4.4;2.3
04;2021-04-01;716;709;38581;20403;4.5;2.4
04;2021-04-02;688;761;39269;21164;4.6;2.5
04;2021-04-03;699;707;39968;21871;4.6;2.5
04;2021-04-04;0;0;39968;21871;4.6;2.5
04;2021-04-05;0;2;39968;21873;4.6;2.5
04;2021-04-06;796;642;40764;22515;4.7;2.6
04;2021-04-07;1369;789;42133;23304;4.9;2.7
04;2021-04-08;1792;780;43925;24084;5.1;2.8
04;2021-04-09;1506;786;45431;24870;5.3;2.9
04;2021-04-10;1137;651;46568;25521;5.4;3.0
04;2021-04-11;2;0;46570;25521;5.4;3.0
04;2021-04-12;1239;553;47809;26074;5.6;3.0
04;2021-04-13;1438;754;49247;26828;5.7;3.1
04;2021-04-14;2069;778;51316;27606;6.0;3.2
04;2021-04-15;2502;956;53818;28562;6.3;3.3
04;2021-04-16;1931;785;55749;29347;6.5;3.4
04;2021-04-17;1288;604;57037;29951;6.6;3.5
04;2021-04-18;0;0;57037;29951;6.6;3.5
04;2021-04-19;1377;565;58414;30516;6.8;3.5
04;2021-04-20;1649;807;60063;31323;7.0;3.6
04;2021-04-21;2128;607;62191;31930;7.2;3.7
04;2021-04-22;2946;805;65137;32735;7.6;3.8
04;2021-04-23;2309;815;67446;33550;7.8;3.9
04;2021-04-24;1102;797;68548;34347;8.0;4.0
04;2021-04-25;2;0;68550;34347;8.0;4.0
04;2021-04-26;1165;922;69715;35269;8.1;4.1
04;2021-04-27;1679;1027;71394;36296;8.3;4.2
04;2021-04-28;2896;753;74290;37049;8.6;4.3
04;2021-04-29;3944;813;78234;37862;9.1;4.4
04;2021-04-30;3433;906;81667;38768;9.5;4.5
04;2021-05-01;2106;220;83773;38988;9.7;4.5
04;2021-05-02;2;0;83775;38988;9.7;4.5
04;2021-05-03;1865;572;85640;39560;10.0;4.6
04;2021-05-04;2127;1096;87767;40656;10.2;4.7
04;2021-05-05;3118;1641;90885;42297;10.6;4.9
04;2021-05-06;4004;1589;94889;43886;11.0;5.1
04;2021-05-07;3228;1527;98117;45413;11.4;5.3
04;2021-05-08;1566;503;99683;45916;11.6;5.3
04;2021-05-09;1;0;99684;45916;11.6;5.3
04;2021-05-10;2411;994;102095;46910;11.9;5.5
04;2021-05-11;3649;1642;105744;48552;12.3;5.6
04;2021-05-12;4719;2397;110463;50949;12.8;5.9
04;2021-05-13;3554;585;114017;51534;13.3;6.0
04;2021-05-14;5264;2511;119281;54045;13.9;6.3
04;2021-05-15;3159;1537;122440;55582;14.2;6.5
04;2021-05-16;15;18;122455;55600;14.2;6.5
04;2021-05-17;2997;1480;125452;57080;14.6;6.6
04;2021-05-18;3747;1781;129199;58861;15.0;6.8
04;2021-05-19;4678;2335;133877;61196;15.6;7.1
04;2021-05-20;5138;2807;139015;64003;16.2;7.4
04;2021-05-21;4987;2635;144002;66638;16.7;7.7
04;2021-05-22;3362;1253;147364;67891;17.1;7.9
04;2021-05-23;5;3;147369;67894;17.1;7.9
04;2021-05-24;3636;1079;151005;68973;17.6;8.0
04;2021-05-25;4245;1915;155250;70888;18.1;8.2
04;2021-05-26;4958;2963;160208;73851;18.6;8.6
04;2021-05-27;4602;4094;164810;77945;19.2;9.1
04;2021-05-28;4355;3827;169165;81772;19.7;9.5
04;2021-05-29;2530;2461;171695;84233;20.0;9.8
04;2021-05-30;6;14;171701;84247;20.0;9.8
04;2021-05-31;2342;2250;174043;86497;20.2;10.1
04;2021-06-01;3271;2721;177314;89218;20.6;10.4
04;2021-06-02;3911;3351;181225;92569;21.1;10.8
04;2021-06-03;4011;3663;185236;96232;21.5;11.2
04;2021-06-04;3817;3751;189053;99983;22.0;11.6
04;2021-06-05;2191;1923;191244;101906;22.2;11.9
04;2021-06-06;1060;129;192304;102035;22.4;11.9
04;2021-06-07;1999;2530;194303;104565;22.6;12.2
04;2021-06-08;2512;3320;196815;107885;22.9;12.5
04;2021-06-09;2941;4771;199756;112656;23.2;13.1
04;2021-06-10;3341;4445;203097;117101;23.6;13.6
04;2021-06-11;2827;4619;205924;121720;23.9;14.2
04;2021-06-12;1710;3378;207634;125098;24.1;14.5
04;2021-06-13;1312;242;208946;125340;24.3;14.6
04;2021-06-14;1479;3179;210425;128519;24.5;14.9
04;2021-06-15;2037;3616;212462;132135;24.7;15.4
04;2021-06-16;2699;4644;215161;136779;25.0;15.9
04;2021-06-17;2495;4897;217656;141676;25.3;16.5
04;2021-06-18;2556;4898;220212;146574;25.6;17.0
04;2021-06-19;1292;3515;221504;150089;25.8;17.5
04;2021-06-20;626;287;222130;150376;25.8;17.5
04;2021-06-21;1248;3233;223378;153609;26.0;17.9
04;2021-06-22;1582;3738;224960;157347;26.2;18.3
04;2021-06-23;2176;4960;227136;162307;26.4;18.9
04;2021-06-24;2248;4052;229384;166359;26.7;19.3
05;2020-12-27;0;0;0;0;0.0;0.0
05;2020-12-28;0;0;0;0;0.0;0.0
05;2020-12-29;0;0;0;0;0.0;0.0
05;2020-12-30;0;0;0;0;0.0;0.0
05;2020-12-31;0;0;0;0;0.0;0.0
05;2021-01-01;0;0;0;0;0.0;0.0
05;2021-01-02;0;0;0;0;0.0;0.0
05;2021-01-03;0;0;0;0;0.0;0.0
05;2021-01-04;0;0;0;0;0.0;0.0
05;2021-01-05;0;0;0;0;0.0;0.0
05;2021-01-06;0;0;0;0;0.0;0.0
05;2021-01-07;0;0;0;0;0.0;0.0
05;2021-01-08;0;0;0;0;0.0;0.0
05;2021-01-09;0;0;0;0;0.0;0.0
05;2021-01-10;0;0;0;0;0.0;0.0
05;2021-01-11;0;0;0;0;0.0;0.0
05;2021-01-12;0;0;0;0;0.0;0.0
05;2021-01-13;0;0;0;0;0.0;0.0
05;2021-01-14;0;0;0;0;0.0;0.0
05;2021-01-15;0;0;0;0;0.0;0.0
05;2021-01-16;0;0;0;0;0.0;0.0
05;2021-01-17;0;0;0;0;0.0;0.0
05;2021-01-18;0;0;0;0;0.0;0.0
05;2021-01-19;0;0;0;0;0.0;0.0
05;2021-01-20;0;0;0;0;0.0;0.0
05;2021-01-21;0;0;0;0;0.0;0.0
05;2021-01-22;0;0;0;0;0.0;0.0
05;2021-01-23;0;0;0;0;0.0;0.0
05;2021-01-24;0;0;0;0;0.0;0.0
05;2021-01-25;0;0;0;0;0.0;0.0
05;2021-01-26;0;0;0;0;0.0;0.0
05;2021-01-27;0;0;0;0;0.0;0.0
05;2021-01-28;0;0;0;0;0.0;0.0
05;2021-01-29;0;0;0;0;0.0;0.0
05;2021-01-30;0;0;0;0;0.0;0.0
05;2021-01-31;0;0;0;0;0.0;0.0
05;2021-02-01;0;0;0;0;0.0;0.0
05;2021-02-02;0;0;0;0;0.0;0.0
05;2021-02-03;0;0;0;0;0.0;0.0
05;2021-02-04;0;0;0;0;0.0;0.0
05;2021-02-05;0;0;0;0;0.0;0.0
05;2021-02-06;0;0;0;0;0.0;0.0
05;2021-02-07;0;0;0;0;0.0;0.0
05;2021-02-08;0;0;0;0;0.0;0.0
05;2021-02-09;0;0;0;0;0.0;0.0
05;2021-02-10;0;0;0;0;0.0;0.0
05;2021-02-11;0;0;0;0;0.0;0.0
05;2021-02-12;0;0;0;0;0.0;0.0
05;2021-02-13;0;0;0;0;0.0;0.0
05;2021-02-14;0;0;0;0;0.0;0.0
05;2021-02-15;0;0;0;0;0.0;0.0
05;2021-02-16;0;0;0;0;0.0;0.0
05;2021-02-17;0;0;0;0;0.0;0.0
05;2021-02-18;0;0;0;0;0.0;0.0
05;2021-02-19;0;0;0;0;0.0;0.0
05;2021-02-20;0;0;0;0;0.0;0.0
05;2021-02-21;0;0;0;0;0.0;0.0
05;2021-02-22;0;0;0;0;0.0;0.0
05;2021-02-23;0;0;0;0;0.0;0.0
05;2021-02-24;0;0;0;0;0.0;0.0
05;2021-02-25;0;0;0;0;0.0;0.0
05;2021-02-26;0;0;0;0;0.0;0.0
05;2021-02-27;0;0;0;0;0.0;0.0
05;2021-02-28;0;0;0;0;0.0;0.0
05;2021-03-01;0;0;0;0;0.0;0.0
05;2021-03-02;0;0;0;0;0.0;0.0
05;2021-03-03;0;0;0;0;0.0;0.0
05;2021-03-04;0;0;0;0;0.0;0.0
05;2021-03-05;0;0;0;0;0.0;0.0
05;2021-03-06;0;0;0;0;0.0;0.0
05;2021-03-07;0;0;0;0;0.0;0.0
05;2021-03-08;0;0;0;0;0.0;0.0
05;2021-03-09;0;0;0;0;0.0;0.0
05;2021-03-10;0;0;0;0;0.0;0.0
05;2021-03-11;0;0;0;0;0.0;0.0
05;2021-03-12;0;0;0;0;0.0;0.0
05;2021-03-13;0;0;0;0;0.0;0.0
05;2021-03-14;0;0;0;0;0.0;0.0
05;2021-03-15;0;0;0;0;0.0;0.0
05;2021-03-16;0;0;0;0;0.0;0.0
05;2021-03-17;0;0;0;0;0.0;0.0
05;2021-03-18;0;0;0;0;0.0;0.0
05;2021-03-19;0;0;0;0;0.0;0.0
05;2021-03-20;0;0;0;0;0.0;0.0
05;2021-03-21;0;0;0;0;0.0;0.0
05;2021-03-22;0;0;0;0;0.0;0.0
05;2021-03-23;0;0;0;0;0.0;0.0
05;2021-03-24;0;0;0;0;0.0;0.0
05;2021-03-25;0;0;0;0;0.0;0.0
05;2021-03-26;0;0;0;0;0.0;0.0
05;2021-03-27;0;0;0;0;0.0;0.0
05;2021-03-28;0;0;0;0;0.0;0.0
05;2021-03-29;2;0;2;0;0.0;0.0
05;2021-03-30;0;0;2;0;0.0;0.0
05;2021-03-31;0;0;2;0;0.0;0.0
05;2021-04-01;0;0;2;0;0.0;0.0
05;2021-04-02;0;0;2;0;0.0;0.0
05;2021-04-03;0;0;2;0;0.0;0.0
05;2021-04-04;0;0;2;0;0.0;0.0
05;2021-04-05;0;0;2;0;0.0;0.0
05;2021-04-06;0;0;2;0;0.0;0.0
05;2021-04-07;0;0;2;0;0.0;0.0
05;2021-04-08;1;0;3;0;0.1;0.0
05;2021-04-09;0;0;3;0;0.1;0.0
05;2021-04-10;0;0;3;0;0.1;0.0
05;2021-04-11;0;0;3;0;0.1;0.0
05;2021-04-12;0;0;3;0;0.1;0.0
05;2021-04-13;0;0;3;0;0.1;0.0
05;2021-04-14;0;0;3;0;0.1;0.0
05;2021-04-15;0;0;3;0;0.1;0.0
05;2021-04-16;0;0;3;0;0.1;0.0
05;2021-04-17;0;0;3;0;0.1;0.0
05;2021-04-18;0;0;3;0;0.1;0.0
05;2021-04-19;0;0;3;0;0.1;0.0
05;2021-04-20;0;0;3;0;0.1;0.0
05;2021-04-21;0;0;3;0;0.1;0.0
05;2021-04-22;0;0;3;0;0.1;0.0
05;2021-04-23;0;0;3;0;0.1;0.0
05;2021-04-24;0;0;3;0;0.1;0.0
05;2021-04-25;0;0;3;0;0.1;0.0
05;2021-04-26;0;0;3;0;0.1;0.0
05;2021-04-27;0;0;3;0;0.1;0.0
05;2021-04-28;0;0;3;0;0.1;0.0
05;2021-04-29;0;0;3;0;0.1;0.0
05;2021-04-30;0;0;3;0;0.1;0.0
05;2021-05-01;0;0;3;0;0.1;0.0
05;2021-05-02;0;0;3;0;0.1;0.0
05;2021-05-03;0;0;3;0;0.1;0.0
05;2021-05-04;0;0;3;0;0.1;0.0
05;2021-05-05;0;0;3;0;0.1;0.0
05;2021-05-06;0;0;3;0;0.1;0.0
05;2021-05-07;0;0;3;0;0.1;0.0
05;2021-05-08;0;0;3;0;0.1;0.0
05;2021-05-09;0;0;3;0;0.1;0.0
05;2021-05-10;0;0;3;0;0.1;0.0
05;2021-05-11;0;0;3;0;0.1;0.0
05;2021-05-12;0;0;3;0;0.1;0.0
05;2021-05-13;0;0;3;0;0.1;0.0
05;2021-05-14;0;0;3;0;0.1;0.0
05;2021-05-15;0;0;3;0;0.1;0.0
05;2021-05-16;0;0;3;0;0.1;0.0
05;2021-05-17;0;0;3;0;0.1;0.0
05;2021-05-18;0;0;3;0;0.1;0.0
05;2021-05-19;0;0;3;0;0.1;0.0
05;2021-05-20;0;0;3;0;0.1;0.0
05;2021-05-21;0;0;3;0;0.1;0.0
05;2021-05-22;0;0;3;0;0.1;0.0
05;2021-05-23;0;0;3;0;0.1;0.0
05;2021-05-24;0;0;3;0;0.1;0.0
05;2021-05-25;0;0;3;0;0.1;0.0
05;2021-05-26;0;0;3;0;0.1;0.0
05;2021-05-27;0;0;3;0;0.1;0.0
05;2021-05-28;0;0;3;0;0.1;0.0
05;2021-05-29;0;2;3;2;0.1;0.0
05;2021-05-30;0;0;3;2;0.1;0.0
05;2021-05-31;0;0;3;2;0.1;0.0
05;2021-06-01;0;0;3;2;0.1;0.0
05;2021-06-02;0;0;3;2;0.1;0.0
05;2021-06-03;0;0;3;2;0.1;0.0
05;2021-06-04;0;0;3;2;0.1;0.0
05;2021-06-05;0;0;3;2;0.1;0.0
05;2021-06-06;0;0;3;2;0.1;0.0
05;2021-06-07;0;0;3;2;0.1;0.0
05;2021-06-08;0;0;3;2;0.1;0.0
05;2021-06-09;0;0;3;2;0.1;0.0
05;2021-06-10;0;0;3;2;0.1;0.0
05;2021-06-11;0;0;3;2;0.1;0.0
05;2021-06-12;0;0;3;2;0.1;0.0
05;2021-06-13;0;0;3;2;0.1;0.0
05;2021-06-14;0;0;3;2;0.1;0.0
05;2021-06-15;0;0;3;2;0.1;0.0
05;2021-06-16;0;0;3;2;0.1;0.0
05;2021-06-17;0;0;3;2;0.1;0.0
05;2021-06-18;0;0;3;2;0.1;0.0
05;2021-06-19;0;0;3;2;0.1;0.0
05;2021-06-20;0;0;3;2;0.1;0.0
05;2021-06-21;0;0;3;2;0.1;0.0
05;2021-06-22;0;0;3;2;0.1;0.0
05;2021-06-23;0;0;3;2;0.1;0.0
05;2021-06-24;0;0;3;2;0.1;0.0
06;2020-12-27;0;0;0;0;0.0;0.0
06;2020-12-28;0;0;0;0;0.0;0.0
06;2020-12-29;0;0;0;0;0.0;0.0
06;2020-12-30;0;0;0;0;0.0;0.0
06;2020-12-31;0;0;0;0;0.0;0.0
06;2021-01-01;0;0;0;0;0.0;0.0
06;2021-01-02;0;0;0;0;0.0;0.0
06;2021-01-03;0;0;0;0;0.0;0.0
06;2021-01-04;0;0;0;0;0.0;0.0
06;2021-01-05;0;0;0;0;0.0;0.0
06;2021-01-06;0;0;0;0;0.0;0.0
06;2021-01-07;0;0;0;0;0.0;0.0
06;2021-01-08;0;0;0;0;0.0;0.0
06;2021-01-09;0;0;0;0;0.0;0.0
06;2021-01-10;0;0;0;0;0.0;0.0
06;2021-01-11;9;0;9;0;0.0;0.0
06;2021-01-12;0;0;9;0;0.0;0.0
06;2021-01-13;0;0;9;0;0.0;0.0
06;2021-01-14;0;0;9;0;0.0;0.0
06;2021-01-15;1;0;10;0;0.0;0.0
06;2021-01-16;1;0;11;0;0.0;0.0
06;2021-01-17;0;0;11;0;0.0;0.0
06;2021-01-18;1;0;12;0;0.0;0.0
06;2021-01-19;0;0;12;0;0.0;0.0
06;2021-01-20;0;0;12;0;0.0;0.0
06;2021-01-21;0;0;12;0;0.0;0.0
06;2021-01-22;0;0;12;0;0.0;0.0
06;2021-01-23;1;0;13;0;0.0;0.0
06;2021-01-24;0;0;13;0;0.0;0.0
06;2021-01-25;140;1;153;1;0.1;0.0
06;2021-01-26;166;4;319;5;0.1;0.0
06;2021-01-27;250;2;569;7;0.2;0.0
06;2021-01-28;101;5;670;12;0.2;0.0
06;2021-01-29;230;2;900;14;0.3;0.0
06;2021-01-30;286;9;1186;23;0.4;0.0
06;2021-01-31;1;0;1187;23;0.4;0.0
06;2021-02-01;160;0;1347;23;0.5;0.0
06;2021-02-02;329;6;1676;29;0.6;0.0
06;2021-02-03;228;1;1904;30;0.7;0.0
06;2021-02-04;215;7;2119;37;0.8;0.0
06;2021-02-05;214;1;2333;38;0.8;0.0
06;2021-02-06;83;10;2416;48;0.9;0.0
06;2021-02-07;0;0;2416;48;0.9;0.0
06;2021-02-08;82;3;2498;51;0.9;0.0
06;2021-02-09;193;0;2691;51;1.0;0.0
06;2021-02-10;187;2;2878;53;1.0;0.0
06;2021-02-11;235;2;3113;55;1.1;0.0
06;2021-02-12;287;4;3400;59;1.2;0.0
06;2021-02-13;56;0;3456;59;1.2;0.0
06;2021-02-14;1;0;3457;59;1.2;0.0
06;2021-02-15;359;4;3816;63;1.4;0.0
06;2021-02-16;266;6;4082;69;1.5;0.0
06;2021-02-17;167;5;4249;74;1.5;0.0
06;2021-02-18;217;11;4466;85;1.6;0.0
06;2021-02-19;235;21;4701;106;1.7;0.0
06;2021-02-20;138;7;4839;113;1.7;0.0
06;2021-02-21;0;0;4839;113;1.7;0.0
06;2021-02-22;131;121;4970;234;1.8;0.1
06;2021-02-23;186;151;5156;385;1.8;0.1
06;2021-02-24;176;145;5332;530;1.9;0.2
06;2021-02-25;227;283;5559;813;2.0;0.3
06;2021-02-26;242;259;5801;1072;2.1;0.4
06;2021-02-27;0;0;5801;1072;2.1;0.4
06;2021-02-28;0;0;5801;1072;2.1;0.4
06;2021-03-01;144;259;5945;1331;2.1;0.5
06;2021-03-02;228;257;6173;1588;2.2;0.6
06;2021-03-03;202;188;6375;1776;2.3;0.6
06;2021-03-04;205;139;6580;1915;2.4;0.7
06;2021-03-05;224;114;6804;2029;2.4;0.7
06;2021-03-06;1;0;6805;2029;2.4;0.7
06;2021-03-07;0;0;6805;2029;2.4;0.7
06;2021-03-08;189;125;6994;2154;2.5;0.8
06;2021-03-09;390;155;7384;2309;2.6;0.8
06;2021-03-10;180;178;7564;2487;2.7;0.9
06;2021-03-11;167;207;7731;2694;2.8;1.0
06;2021-03-12;238;288;7969;2982;2.9;1.1
06;2021-03-13;2;0;7971;2982;2.9;1.1
06;2021-03-14;0;0;7971;2982;2.9;1.1
06;2021-03-15;156;292;8127;3274;2.9;1.2
06;2021-03-16;236;223;8363;3497;3.0;1.3
06;2021-03-17;263;140;8626;3637;3.1;1.3
06;2021-03-18;172;232;8798;3869;3.1;1.4
06;2021-03-19;172;296;8970;4165;3.2;1.5
06;2021-03-20;0;0;8970;4165;3.2;1.5
06;2021-03-21;0;0;8970;4165;3.2;1.5
06;2021-03-22;97;136;9067;4301;3.2;1.5
06;2021-03-23;136;240;9203;4541;3.3;1.6
06;2021-03-24;160;146;9363;4687;3.4;1.7
06;2021-03-25;186;206;9549;4893;3.4;1.8
06;2021-03-26;160;212;9709;5105;3.5;1.8
06;2021-03-27;18;0;9727;5105;3.5;1.8
06;2021-03-28;0;0;9727;5105;3.5;1.8
06;2021-03-29;0;2;9727;5107;3.5;1.8
06;2021-03-30;272;334;9999;5441;3.6;1.9
06;2021-03-31;225;125;10224;5566;3.7;2.0
06;2021-04-01;243;104;10467;5670;3.7;2.0
06;2021-04-02;285;263;10752;5933;3.8;2.1
06;2021-04-03;906;307;11658;6240;4.2;2.2
06;2021-04-04;1;0;11659;6240;4.2;2.2
06;2021-04-05;1;0;11660;6240;4.2;2.2
06;2021-04-06;159;282;11819;6522;4.2;2.3
06;2021-04-07;237;265;12056;6787;4.3;2.4
06;2021-04-08;286;140;12342;6927;4.4;2.5
06;2021-04-09;248;171;12590;7098;4.5;2.5
06;2021-04-10;181;114;12771;7212;4.6;2.6
06;2021-04-11;7;0;12778;7212;4.6;2.6
06;2021-04-12;0;19;12778;7231;4.6;2.6
06;2021-04-13;393;343;13171;7574;4.7;2.7
06;2021-04-14;239;205;13410;7779;4.8;2.8
06;2021-04-15;207;117;13617;7896;4.9;2.8
06;2021-04-16;214;127;13831;8023;4.9;2.9
06;2021-04-17;226;132;14057;8155;5.0;2.9
06;2021-04-18;1;0;14058;8155;5.0;2.9
06;2021-04-19;7;1;14065;8156;5.0;2.9
06;2021-04-20;368;224;14433;8380;5.2;3.0
06;2021-04-21;412;150;14845;8530;5.3;3.1
06;2021-04-22;410;150;15255;8680;5.5;3.1
06;2021-04-23;367;166;15622;8846;5.6;3.2
06;2021-04-24;413;127;16035;8973;5.7;3.2
06;2021-04-25;2;0;16037;8973;5.7;3.2
06;2021-04-26;54;8;16091;8981;5.8;3.2
06;2021-04-27;351;293;16442;9274;5.9;3.3
06;2021-04-28;355;515;16797;9789;6.0;3.5
06;2021-04-29;558;343;17355;10132;6.2;3.6
06;2021-04-30;403;238;17758;10370;6.4;3.7
06;2021-05-01;670;285;18428;10655;6.6;3.8
06;2021-05-02;0;0;18428;10655;6.6;3.8
06;2021-05-03;136;6;18564;10661;6.6;3.8
06;2021-05-04;353;426;18917;11087;6.8;4.0
06;2021-05-05;444;317;19361;11404;6.9;4.1
06;2021-05-06;319;200;19680;11604;7.0;4.2
06;2021-05-07;341;134;20021;11738;7.2;4.2
06;2021-05-08;300;140;20321;11878;7.3;4.3
06;2021-05-09;0;0;20321;11878;7.3;4.3
06;2021-05-10;8;9;20329;11887;7.3;4.3
06;2021-05-11;359;489;20688;12376;7.4;4.4
06;2021-05-12;331;310;21019;12686;7.5;4.5
06;2021-05-13;127;97;21146;12783;7.6;4.6
06;2021-05-14;0;0;21146;12783;7.6;4.6
06;2021-05-15;484;283;21630;13066;7.7;4.7
06;2021-05-16;0;0;21630;13066;7.7;4.7
06;2021-05-17;122;51;21752;13117;7.8;4.7
06;2021-05-18;515;430;22267;13547;8.0;4.8
06;2021-05-19;649;663;22916;14210;8.2;5.1
06;2021-05-20;1055;496;23971;14706;8.6;5.3
06;2021-05-21;1046;316;25017;15022;9.0;5.4
06;2021-05-22;1241;300;26258;15322;9.4;5.5
06;2021-05-23;0;0;26258;15322;9.4;5.5
06;2021-05-24;1;0;26259;15322;9.4;5.5
06;2021-05-25;877;624;27136;15946;9.7;5.7
06;2021-05-26;1033;842;28169;16788;10.1;6.0
06;2021-05-27;1305;505;29474;17293;10.5;6.2
06;2021-05-28;948;372;30422;17665;10.9;6.3
06;2021-05-29;1127;388;31549;18053;11.3;6.5
06;2021-05-30;0;1;31549;18054;11.3;6.5
06;2021-05-31;100;6;31649;18060;11.3;6.5
06;2021-06-01;1130;650;32779;18710;11.7;6.7
06;2021-06-02;1147;494;33926;19204;12.1;6.9
06;2021-06-03;791;332;34717;19536;12.4;7.0
06;2021-06-04;977;320;35694;19856;12.8;7.1
06;2021-06-05;655;297;36349;20153;13.0;7.2
06;2021-06-06;0;0;36349;20153;13.0;7.2
06;2021-06-07;84;12;36433;20165;13.0;7.2
06;2021-06-08;917;442;37350;20607;13.4;7.4
06;2021-06-09;951;546;38301;21153;13.7;7.6
06;2021-06-10;650;224;38951;21377;13.9;7.6
06;2021-06-11;825;368;39776;21745;14.2;7.8
06;2021-06-12;563;273;40339;22018;14.4;7.9
06;2021-06-13;0;0;40339;22018;14.4;7.9
06;2021-06-14;178;112;40517;22130;14.5;7.9
06;2021-06-15;399;839;40916;22969;14.6;8.2
06;2021-06-16;880;1437;41796;24406;15.0;8.7
06;2021-06-17;756;650;42552;25056;15.2;9.0
06;2021-06-18;686;617;43238;25673;15.5;9.2
06;2021-06-19;527;638;43765;26311;15.7;9.4
06;2021-06-20;0;0;43765;26311;15.7;9.4
06;2021-06-21;122;128;43887;26439;15.7;9.5
06;2021-06-22;409;1142;44296;27581;15.8;9.9
06;2021-06-23;647;1176;44943;28757;16.1;10.3
06;2021-06-24;409;528;45352;29285;16.2;10.5
07;2020-12-27;0;0;0;0;0.0;0.0
07;2020-12-28;0;0;0;0;0.0;0.0
07;2020-12-29;0;0;0;0;0.0;0.0
07;2020-12-30;0;0;0;0;0.0;0.0
07;2020-12-31;0;0;0;0;0.0;0.0
07;2021-01-01;0;0;0;0;0.0;0.0
07;2021-01-02;0;0;0;0;0.0;0.0
07;2021-01-03;0;0;0;0;0.0;0.0
07;2021-01-04;0;0;0;0;0.0;0.0
07;2021-01-05;0;0;0;0;0.0;0.0
07;2021-01-06;0;0;0;0;0.0;0.0
07;2021-01-07;0;0;0;0;0.0;0.0
07;2021-01-08;0;0;0;0;0.0;0.0
07;2021-01-09;0;0;0;0;0.0;0.0
07;2021-01-10;0;0;0;0;0.0;0.0
07;2021-01-11;0;0;0;0;0.0;0.0
07;2021-01-12;0;0;0;0;0.0;0.0
07;2021-01-13;0;0;0;0;0.0;0.0
07;2021-01-14;0;0;0;0;0.0;0.0
07;2021-01-15;0;0;0;0;0.0;0.0
07;2021-01-16;0;0;0;0;0.0;0.0
07;2021-01-17;0;0;0;0;0.0;0.0
07;2021-01-18;1;0;1;0;0.0;0.0
07;2021-01-19;0;0;1;0;0.0;0.0
07;2021-01-20;0;0;1;0;0.0;0.0
07;2021-01-21;12;0;13;0;0.1;0.0
07;2021-01-22;12;0;25;0;0.3;0.0
07;2021-01-23;0;0;25;0;0.3;0.0
07;2021-01-24;0;0;25;0;0.3;0.0
07;2021-01-25;0;0;25;0;0.3;0.0
07;2021-01-26;0;0;25;0;0.3;0.0
07;2021-01-27;12;0;37;0;0.4;0.0
07;2021-01-28;1;0;38;0;0.4;0.0
07;2021-01-29;6;0;44;0;0.4;0.0
07;2021-01-30;0;0;44;0;0.4;0.0
07;2021-01-31;0;0;44;0;0.4;0.0
07;2021-02-01;0;0;44;0;0.4;0.0
07;2021-02-02;0;0;44;0;0.4;0.0
07;2021-02-03;11;0;55;0;0.6;0.0
07;2021-02-04;12;0;67;0;0.7;0.0
07;2021-02-05;11;0;78;0;0.8;0.0
07;2021-02-06;0;0;78;0;0.8;0.0
07;2021-02-07;0;0;78;0;0.8;0.0
07;2021-02-08;0;0;78;0;0.8;0.0
07;2021-02-09;13;0;91;0;0.9;0.0
07;2021-02-10;0;0;91;0;0.9;0.0
07;2021-02-11;16;0;107;0;1.1;0.0
07;2021-02-12;45;0;152;0;1.5;0.0
07;2021-02-13;0;0;152;0;1.5;0.0
07;2021-02-14;0;0;152;0;1.5;0.0
07;2021-02-15;0;0;152;0;1.5;0.0
07;2021-02-16;0;0;152;0;1.5;0.0
07;2021-02-17;0;0;152;0;1.5;0.0
07;2021-02-18;18;0;170;0;1.7;0.0
07;2021-02-19;34;0;204;0;2.0;0.0
07;2021-02-20;0;0;204;0;2.0;0.0
07;2021-02-21;0;0;204;0;2.0;0.0
07;2021-02-22;0;0;204;0;2.0;0.0
07;2021-02-23;0;22;204;22;2.0;0.2
07;2021-02-24;0;0;204;22;2.0;0.2
07;2021-02-25;15;10;219;32;2.2;0.3
07;2021-02-26;33;21;252;53;2.5;0.5
07;2021-02-27;0;0;252;53;2.5;0.5
07;2021-02-28;0;0;252;53;2.5;0.5
07;2021-03-01;0;0;252;53;2.5;0.5
07;2021-03-02;17;11;269;64;2.7;0.6
07;2021-03-03;0;0;269;64;2.7;0.6
07;2021-03-04;16;11;285;75;2.9;0.8
07;2021-03-05;33;19;318;94;3.2;0.9
07;2021-03-06;0;0;318;94;3.2;0.9
07;2021-03-07;0;0;318;94;3.2;0.9
07;2021-03-08;0;0;318;94;3.2;0.9
07;2021-03-09;1;0;319;94;3.2;0.9
07;2021-03-10;0;0;319;94;3.2;0.9
07;2021-03-11;20;30;339;124;3.4;1.2
07;2021-03-12;62;42;401;166;4.0;1.7
07;2021-03-13;0;0;401;166;4.0;1.7
07;2021-03-14;0;0;401;166;4.0;1.7
07;2021-03-15;0;0;401;166;4.0;1.7
07;2021-03-16;30;9;431;175;4.3;1.8
07;2021-03-17;0;0;431;175;4.3;1.8
07;2021-03-18;29;16;460;191;4.6;1.9
07;2021-03-19;56;31;516;222;5.2;2.2
07;2021-03-20;0;0;516;222;5.2;2.2
07;2021-03-21;0;0;516;222;5.2;2.2
07;2021-03-22;0;0;516;222;5.2;2.2
07;2021-03-23;0;0;516;222;5.2;2.2
07;2021-03-24;0;0;516;222;5.2;2.2
07;2021-03-25;65;17;581;239;5.8;2.4
07;2021-03-26;73;26;654;265;6.6;2.7
07;2021-03-27;0;0;654;265;6.6;2.7
07;2021-03-28;0;0;654;265;6.6;2.7
07;2021-03-29;0;0;654;265;6.6;2.7
07;2021-03-30;40;18;694;283;7.0;2.8
07;2021-03-31;26;15;720;298;7.2;3.0
07;2021-04-01;25;32;745;330;7.5;3.3
07;2021-04-02;0;0;745;330;7.5;3.3
07;2021-04-03;0;0;745;330;7.5;3.3
07;2021-04-04;0;0;745;330;7.5;3.3
07;2021-04-05;9;0;754;330;7.6;3.3
07;2021-04-06;0;0;754;330;7.6;3.3
07;2021-04-07;0;0;754;330;7.6;3.3
07;2021-04-08;57;46;811;376;8.1;3.8
07;2021-04-09;59;31;870;407;8.7;4.1
07;2021-04-10;0;0;870;407;8.7;4.1
07;2021-04-11;0;0;870;407;8.7;4.1
07;2021-04-12;0;0;870;407;8.7;4.1
07;2021-04-13;0;0;870;407;8.7;4.1
07;2021-04-14;5;6;875;413;8.8;4.1
07;2021-04-15;56;71;931;484;9.3;4.9
07;2021-04-16;90;35;1021;519;10.2;5.2
07;2021-04-17;0;1;1021;520;10.2;5.2
07;2021-04-18;0;0;1021;520;10.2;5.2
07;2021-04-19;1;0;1022;520;10.3;5.2
07;2021-04-20;335;66;1357;586;13.6;5.9
07;2021-04-21;337;29;1694;615;17.0;6.2
07;2021-04-22;284;50;1978;665;19.9;6.7
07;2021-04-23;258;41;2236;706;22.4;7.1
07;2021-04-24;231;1;2467;707;24.8;7.1
07;2021-04-25;0;0;2467;707;24.8;7.1
07;2021-04-26;283;20;2750;727;27.6;7.3
07;2021-04-27;224;69;2974;796;29.9;8.0
07;2021-04-28;192;26;3166;822;31.8;8.3
07;2021-04-29;170;22;3336;844;33.5;8.5
07;2021-04-30;172;15;3508;859;35.2;8.6
07;2021-05-01;200;12;3708;871;37.2;8.7
07;2021-05-02;0;0;3708;871;37.2;8.7
07;2021-05-03;134;10;3842;881;38.6;8.8
07;2021-05-04;161;54;4003;935;40.2;9.4
07;2021-05-05;221;30;4224;965;42.4;9.7
07;2021-05-06;175;31;4399;996;44.2;10.0
07;2021-05-07;149;31;4548;1027;45.7;10.3
07;2021-05-08;1;0;4549;1027;45.7;10.3
07;2021-05-09;0;2;4549;1029;45.7;10.3
07;2021-05-10;0;0;4549;1029;45.7;10.3
07;2021-05-11;2;41;4551;1070;45.7;10.7
07;2021-05-12;6;36;4557;1106;45.7;11.1
07;2021-05-13;0;0;4557;1106;45.7;11.1
07;2021-05-14;28;98;4585;1204;46.0;12.1
07;2021-05-15;0;0;4585;1204;46.0;12.1
07;2021-05-16;0;0;4585;1204;46.0;12.1
07;2021-05-17;1;14;4586;1218;46.0;12.2
07;2021-05-18;17;32;4603;1250;46.2;12.5
07;2021-05-19;0;1;4603;1251;46.2;12.6
07;2021-05-20;0;8;4603;1259;46.2;12.6
07;2021-05-21;12;32;4615;1291;46.3;13.0
07;2021-05-22;0;0;4615;1291;46.3;13.0
07;2021-05-23;0;0;4615;1291;46.3;13.0
07;2021-05-24;0;0;4615;1291;46.3;13.0
07;2021-05-25;50;334;4665;1625;46.8;16.3
07;2021-05-26;54;359;4719;1984;47.4;19.9
07;2021-05-27;34;317;4753;2301;47.7;23.1
07;2021-05-28;27;256;4780;2557;48.0;25.7
07;2021-05-29;35;376;4815;2933;48.3;29.4
07;2021-05-30;0;0;4815;2933;48.3;29.4
07;2021-05-31;45;218;4860;3151;48.8;31.6
07;2021-06-01;47;226;4907;3377;49.3;33.9
07;2021-06-02;69;273;4976;3650;50.0;36.6
07;2021-06-03;41;252;5017;3902;50.4;39.2
07;2021-06-04;70;269;5087;4171;51.1;41.9
07;2021-06-05;1;0;5088;4171;51.1;41.9
07;2021-06-06;0;0;5088;4171;51.1;41.9
07;2021-06-07;1;1;5089;4172;51.1;41.9
07;2021-06-08;3;2;5092;4174;51.1;41.9
07;2021-06-09;0;3;5092;4177;51.1;41.9
07;2021-06-10;8;4;5100;4181;51.2;42.0
07;2021-06-11;3;8;5103;4189;51.2;42.1
07;2021-06-12;15;59;5118;4248;51.4;42.6
07;2021-06-13;0;0;5118;4248;51.4;42.6
07;2021-06-14;0;0;5118;4248;51.4;42.6
07;2021-06-15;0;1;5118;4249;51.4;42.7
07;2021-06-16;0;0;5118;4249;51.4;42.7
07;2021-06-17;2;6;5120;4255;51.4;42.7
07;2021-06-18;0;2;5120;4257;51.4;42.7
07;2021-06-19;25;49;5145;4306;51.7;43.2
07;2021-06-20;0;0;5145;4306;51.7;43.2
07;2021-06-21;0;2;5145;4308;51.7;43.2
07;2021-06-22;8;0;5153;4308;51.7;43.2
07;2021-06-23;15;9;5168;4317;51.9;43.3
07;2021-06-24;0;5;5168;4322;51.9;43.4
08;2020-12-27;0;0;0;0;0.0;0.0
08;2020-12-28;0;0;0;0;0.0;0.0
08;2020-12-29;0;0;0;0;0.0;0.0
08;2020-12-30;0;0;0;0;0.0;0.0
08;2020-12-31;0;0;0;0;0.0;0.0
08;2021-01-01;0;0;0;0;0.0;0.0
08;2021-01-02;0;0;0;0;0.0;0.0
08;2021-01-03;0;0;0;0;0.0;0.0
08;2021-01-04;0;0;0;0;0.0;0.0
08;2021-01-05;0;0;0;0;0.0;0.0
08;2021-01-06;0;0;0;0;0.0;0.0
08;2021-01-07;0;0;0;0;0.0;0.0
08;2021-01-08;0;0;0;0;0.0;0.0
08;2021-01-09;0;0;0;0;0.0;0.0
08;2021-01-10;0;0;0;0;0.0;0.0
08;2021-01-11;0;0;0;0;0.0;0.0
08;2021-01-12;0;0;0;0;0.0;0.0
08;2021-01-13;10;0;10;0;0.0;0.0
08;2021-01-14;12;0;22;0;0.1;0.0
08;2021-01-15;7;0;29;0;0.1;0.0
08;2021-01-16;0;0;29;0;0.1;0.0
08;2021-01-17;0;0;29;0;0.1;0.0
08;2021-01-18;0;0;29;0;0.1;0.0
08;2021-01-19;12;0;41;0;0.1;0.0
08;2021-01-20;12;0;53;0;0.1;0.0
08;2021-01-21;6;0;59;0;0.2;0.0
08;2021-01-22;0;0;59;0;0.2;0.0
08;2021-01-23;0;0;59;0;0.2;0.0
08;2021-01-24;0;0;59;0;0.2;0.0
08;2021-01-25;0;0;59;0;0.2;0.0
08;2021-01-26;9;0;68;0;0.2;0.0
08;2021-01-27;10;0;78;0;0.2;0.0
08;2021-01-28;6;0;84;0;0.2;0.0
08;2021-01-29;0;0;84;0;0.2;0.0
08;2021-01-30;0;0;84;0;0.2;0.0
08;2021-01-31;0;0;84;0;0.2;0.0
08;2021-02-01;0;0;84;0;0.2;0.0
08;2021-02-02;38;0;122;0;0.3;0.0
08;2021-02-03;10;0;132;0;0.4;0.0
08;2021-02-04;29;0;161;0;0.5;0.0
08;2021-02-05;7;0;168;0;0.5;0.0
08;2021-02-06;0;0;168;0;0.5;0.0
08;2021-02-07;0;0;168;0;0.5;0.0
08;2021-02-08;0;0;168;0;0.5;0.0
08;2021-02-09;38;0;206;0;0.6;0.0
08;2021-02-10;27;1;233;1;0.7;0.0
08;2021-02-11;0;0;233;1;0.7;0.0
08;2021-02-12;36;0;269;1;0.8;0.0
08;2021-02-13;0;0;269;1;0.8;0.0
08;2021-02-14;0;0;269;1;0.8;0.0
08;2021-02-15;50;0;319;1;0.9;0.0
08;2021-02-16;0;0;319;1;0.9;0.0
08;2021-02-17;0;0;319;1;0.9;0.0
08;2021-02-18;27;0;346;1;1.0;0.0
08;2021-02-19;44;0;390;1;1.1;0.0
08;2021-02-20;0;0;390;1;1.1;0.0
08;2021-02-21;0;0;390;1;1.1;0.0
08;2021-02-22;46;4;436;5;1.2;0.0
08;2021-02-23;41;29;477;34;1.3;0.1
08;2021-02-24;35;1;512;35;1.4;0.1
08;2021-02-25;55;36;567;71;1.6;0.2
08;2021-02-26;39;5;606;76;1.7;0.2
08;2021-02-27;0;0;606;76;1.7;0.2
08;2021-02-28;0;0;606;76;1.7;0.2
08;2021-03-01;48;5;654;81;1.9;0.2
08;2021-03-02;7;27;661;108;1.9;0.3
08;2021-03-03;38;27;699;135;2.0;0.4
08;2021-03-04;30;26;729;161;2.1;0.5
08;2021-03-05;46;11;775;172;2.2;0.5
08;2021-03-06;0;0;775;172;2.2;0.5
08;2021-03-07;0;0;775;172;2.2;0.5
08;2021-03-08;30;7;805;179;2.3;0.5
08;2021-03-09;19;27;824;206;2.3;0.6
08;2021-03-10;32;28;856;234;2.4;0.7
08;2021-03-11;2;0;858;234;2.4;0.7
08;2021-03-12;52;21;910;255;2.6;0.7
08;2021-03-13;11;0;921;255;2.6;0.7
08;2021-03-14;0;0;921;255;2.6;0.7
08;2021-03-15;31;43;952;298;2.7;0.8
08;2021-03-16;73;6;1025;304;2.9;0.9
08;2021-03-17;67;13;1092;317;3.1;0.9
08;2021-03-18;82;39;1174;356;3.3;1.0
08;2021-03-19;30;51;1204;407;3.4;1.2
08;2021-03-20;0;0;1204;407;3.4;1.2
08;2021-03-21;0;0;1204;407;3.4;1.2
08;2021-03-22;34;45;1238;452;3.5;1.3
08;2021-03-23;30;43;1268;495;3.6;1.4
08;2021-03-24;38;42;1306;537;3.7;1.5
08;2021-03-25;91;34;1397;571;4.0;1.6
08;2021-03-26;45;33;1442;604;4.1;1.7
08;2021-03-27;93;3;1535;607;4.3;1.7
08;2021-03-28;0;0;1535;607;4.3;1.7
08;2021-03-29;69;49;1604;656;4.5;1.9
08;2021-03-30;98;24;1702;680;4.8;1.9
08;2021-03-31;89;47;1791;727;5.1;2.1
08;2021-04-01;56;48;1847;775;5.2;2.2
08;2021-04-02;0;0;1847;775;5.2;2.2
08;2021-04-03;0;0;1847;775;5.2;2.2
08;2021-04-04;0;0;1847;775;5.2;2.2
08;2021-04-05;0;0;1847;775;5.2;2.2
08;2021-04-06;49;63;1896;838;5.4;2.4
08;2021-04-07;91;32;1987;870;5.6;2.5
08;2021-04-08;120;7;2107;877;6.0;2.5
08;2021-04-09;89;39;2196;916;6.2;2.6
08;2021-04-10;162;8;2358;924;6.7;2.6
08;2021-04-11;0;0;2358;924;6.7;2.6
08;2021-04-12;41;76;2399;1000;6.8;2.8
08;2021-04-13;48;71;2447;1071;6.9;3.0
08;2021-04-14;81;45;2528;1116;7.2;3.2
08;2021-04-15;92;25;2620;1141;7.4;3.2
08;2021-04-16;77;42;2697;1183;7.6;3.3
08;2021-04-17;165;4;2862;1187;8.1;3.4
08;2021-04-18;0;0;2862;1187;8.1;3.4
08;2021-04-19;52;67;2914;1254;8.2;3.5
08;2021-04-20;83;27;2997;1281;8.5;3.6
08;2021-04-21;90;29;3087;1310;8.7;3.7
08;2021-04-22;101;20;3188;1330;9.0;3.8
08;2021-04-23;44;66;3232;1396;9.1;4.0
08;2021-04-24;99;78;3331;1474;9.4;4.2
08;2021-04-25;0;0;3331;1474;9.4;4.2
08;2021-04-26;28;93;3359;1567;9.5;4.4
08;2021-04-27;58;63;3417;1630;9.7;4.6
08;2021-04-28;88;39;3505;1669;9.9;4.7
08;2021-04-29;90;34;3595;1703;10.2;4.8
08;2021-04-30;104;15;3699;1718;10.5;4.9
08;2021-05-01;0;8;3699;1726;10.5;4.9
08;2021-05-02;0;0;3699;1726;10.5;4.9
08;2021-05-03;24;102;3723;1828;10.5;5.2
08;2021-05-04;157;103;3880;1931;11.0;5.5
08;2021-05-05;141;59;4021;1990;11.4;5.6
08;2021-05-06;199;49;4220;2039;11.9;5.8
08;2021-05-07;127;71;4347;2110;12.3;6.0
08;2021-05-08;69;122;4416;2232;12.5;6.3
08;2021-05-09;0;0;4416;2232;12.5;6.3
08;2021-05-10;123;102;4539;2334;12.8;6.6
08;2021-05-11;132;77;4671;2411;13.2;6.8
08;2021-05-12;156;76;4827;2487;13.7;7.0
08;2021-05-13;80;8;4907;2495;13.9;7.1
08;2021-05-14;129;62;5036;2557;14.3;7.2
08;2021-05-15;85;4;5121;2561;14.5;7.2
08;2021-05-16;0;0;5121;2561;14.5;7.2
08;2021-05-17;145;112;5266;2673;14.9;7.6
08;2021-05-18;150;95;5416;2768;15.3;7.8
08;2021-05-19;84;70;5500;2838;15.6;8.0
08;2021-05-20;103;26;5603;2864;15.9;8.1
08;2021-05-21;97;52;5700;2916;16.1;8.3
08;2021-05-22;99;11;5799;2927;16.4;8.3
08;2021-05-23;0;0;5799;2927;16.4;8.3
08;2021-05-24;33;7;5832;2934;16.5;8.3
08;2021-05-25;119;78;5951;3012;16.8;8.5
08;2021-05-26;106;51;6057;3063;17.1;8.7
08;2021-05-27;109;42;6166;3105;17.5;8.8
08;2021-05-28;33;1;6199;3106;17.5;8.8
08;2021-05-29;59;215;6258;3321;17.7;9.4
08;2021-05-30;0;0;6258;3321;17.7;9.4
08;2021-05-31;108;64;6366;3385;18.0;9.6
08;2021-06-01;112;63;6478;3448;18.3;9.8
08;2021-06-02;130;33;6608;3481;18.7;9.9
08;2021-06-03;100;38;6708;3519;19.0;10.0
08;2021-06-04;126;71;6834;3590;19.3;10.2
08;2021-06-05;82;21;6916;3611;19.6;10.2
08;2021-06-06;0;0;6916;3611;19.6;10.2
08;2021-06-07;96;95;7012;3706;19.8;10.5
08;2021-06-08;78;89;7090;3795;20.1;10.7
08;2021-06-09;98;74;7188;3869;20.3;10.9
08;2021-06-10;111;66;7299;3935;20.7;11.1
08;2021-06-11;116;108;7415;4043;21.0;11.4
08;2021-06-12;57;30;7472;4073;21.1;11.5
08;2021-06-13;0;0;7472;4073;21.1;11.5
08;2021-06-14;106;128;7578;4201;21.4;11.9
08;2021-06-15;86;118;7664;4319;21.7;12.2
08;2021-06-16;103;148;7767;4467;22.0;12.6
08;2021-06-17;84;72;7851;4539;22.2;12.8
08;2021-06-18;65;99;7916;4638;22.4;13.1
08;2021-06-19;64;80;7980;4718;22.6;13.4
08;2021-06-20;0;0;7980;4718;22.6;13.4
08;2021-06-21;78;149;8058;4867;22.8;13.8
08;2021-06-22;69;100;8127;4967;23.0;14.1
08;2021-06-23;68;113;8195;5080;23.2;14.4
08;2021-06-24;42;73;8237;5153;23.3;14.6
11;2020-12-27;13;2;13;2;0.0;0.0
11;2020-12-28;11;0;24;2;0.0;0.0
11;2020-12-29;56;0;80;2;0.0;0.0
11;2020-12-30;91;0;171;2;0.0;0.0
11;2020-12-31;39;0;210;2;0.0;0.0
11;2021-01-01;30;1;240;3;0.0;0.0
11;2021-01-02;64;1;304;4;0.0;0.0
11;2021-01-03;78;0;382;4;0.0;0.0
11;2021-01-04;553;5;935;9;0.0;0.0
11;2021-01-05;2067;17;3002;26;0.0;0.0
11;2021-01-06;3018;22;6020;48;0.0;0.0
11;2021-01-07;5382;38;11402;86;0.1;0.0
11;2021-01-08;7120;47;18522;133;0.2;0.0
11;2021-01-09;1890;6;20412;139;0.2;0.0
11;2021-01-10;1754;8;22166;147;0.2;0.0
11;2021-01-11;8008;65;30174;212;0.2;0.0
11;2021-01-12;10361;101;40535;313;0.3;0.0
11;2021-01-13;10016;100;50551;413;0.4;0.0
11;2021-01-14;10119;136;60670;549;0.5;0.0
11;2021-01-15;8911;85;69581;634;0.6;0.0
11;2021-01-16;2413;35;71994;669;0.6;0.0
11;2021-01-17;1088;19;73082;688;0.6;0.0
11;2021-01-18;12257;134;85339;822;0.7;0.0
11;2021-01-19;15846;127;101185;949;0.8;0.0
11;2021-01-20;18372;119;119557;1068;1.0;0.0
11;2021-01-21;22274;154;141831;1222;1.2;0.0
11;2021-01-22;17079;166;158910;1388;1.3;0.0
11;2021-01-23;4959;20;163869;1408;1.3;0.0
11;2021-01-24;1280;6;165149;1414;1.3;0.0
11;2021-01-25;8871;192;174020;1606;1.4;0.0
11;2021-01-26;12338;386;186358;1992;1.5;0.0
11;2021-01-27;16228;693;202586;2685;1.6;0.0
11;2021-01-28;20299;1196;222885;3881;1.8;0.0
11;2021-01-29;15394;1386;238279;5267;1.9;0.0
11;2021-01-30;4464;105;242743;5372;2.0;0.0
11;2021-01-31;585;22;243328;5394;2.0;0.0
11;2021-02-01;7385;1959;250713;7353;2.0;0.1
11;2021-02-02;8351;2820;259064;10173;2.1;0.1
11;2021-02-03;8122;3807;267186;13980;2.2;0.1
11;2021-02-04;8782;4597;275968;18577;2.2;0.2
11;2021-02-05;8951;4432;284919;23009;2.3;0.2
11;2021-02-06;3269;751;288188;23760;2.3;0.2
11;2021-02-07;588;542;288776;24302;2.4;0.2
11;2021-02-08;6227;5923;295003;30225;2.4;0.2
11;2021-02-09;8432;9684;303435;39909;2.5;0.3
11;2021-02-10;9954;11224;313389;51133;2.6;0.4
11;2021-02-11;12364;16520;325753;67653;2.7;0.6
11;2021-02-12;11859;10611;337612;78264;2.7;0.6
11;2021-02-13;2592;2590;340204;80854;2.8;0.7
11;2021-02-14;312;560;340516;81414;2.8;0.7
11;2021-02-15;4451;12033;344967;93447;2.8;0.8
11;2021-02-16;5665;18519;350632;111966;2.9;0.9
11;2021-02-17;5674;15629;356306;127595;2.9;1.0
11;2021-02-18;8634;20817;364940;148412;3.0;1.2
11;2021-02-19;9037;15456;373977;163868;3.0;1.3
11;2021-02-20;1691;4847;375668;168715;3.1;1.4
11;2021-02-21;396;831;376064;169546;3.1;1.4
11;2021-02-22;4227;9932;380291;179478;3.1;1.5
11;2021-02-23;4945;10556;385236;190034;3.1;1.5
11;2021-02-24;5403;9891;390639;199925;3.2;1.6
11;2021-02-25;8610;14179;399249;214104;3.3;1.7
11;2021-02-26;11179;10196;410428;224300;3.3;1.8
11;2021-02-27;5066;3339;415494;227639;3.4;1.9
11;2021-02-28;741;661;416235;228300;3.4;1.9
11;2021-03-01;8837;8001;425072;236301;3.5;1.9
11;2021-03-02;14380;9665;439452;245966;3.6;2.0
11;2021-03-03;18667;10146;458119;256112;3.7;2.1
11;2021-03-04;28240;11142;486359;267254;4.0;2.2
11;2021-03-05;36477;11123;522836;278377;4.3;2.3
11;2021-03-06;46413;3579;569249;281956;4.6;2.3
11;2021-03-07;34290;2782;603539;284738;4.9;2.3
11;2021-03-08;17754;7434;621293;292172;5.1;2.4
11;2021-03-09;26843;7755;648136;299927;5.3;2.4
11;2021-03-10;27631;8383;675767;308310;5.5;2.5
11;2021-03-11;37026;9921;712793;318231;5.8;2.6
11;2021-03-12;44767;9463;757560;327694;6.2;2.7
11;2021-03-13;39868;2702;797428;330396;6.5;2.7
11;2021-03-14;14271;811;811699;331207;6.6;2.7
11;2021-03-15;29199;4041;840898;335248;6.8;2.7
11;2021-03-16;23742;3881;864640;339129;7.0;2.8
11;2021-03-17;24415;3690;889055;342819;7.2;2.8
11;2021-03-18;28998;4157;918053;346976;7.5;2.8
11;2021-03-19;39644;4346;957697;351322;7.8;2.9
11;2021-03-20;25844;1615;983541;352937;8.0;2.9
11;2021-03-21;5625;1334;989166;354271;8.1;2.9
11;2021-03-22;32115;4278;1021281;358549;8.3;2.9
11;2021-03-23;43287;5501;1064568;364050;8.7;3.0
11;2021-03-24;42622;5103;1107190;369153;9.0;3.0
11;2021-03-25;57901;5299;1165091;374452;9.5;3.0
11;2021-03-26;57697;6054;1222788;380506;10.0;3.1
11;2021-03-27;34488;2136;1257276;382642;10.2;3.1
11;2021-03-28;10155;492;1267431;383134;10.3;3.1
11;2021-03-29;33027;8220;1300458;391354;10.6;3.2
11;2021-03-30;44850;11659;1345308;403013;11.0;3.3
11;2021-03-31;39859;13988;1385167;417001;11.3;3.4
11;2021-04-01;45329;21886;1430496;438887;11.7;3.6
11;2021-04-02;39323;24180;1469819;463067;12.0;3.8
11;2021-04-03;18361;21184;1488180;484251;12.1;3.9
11;2021-04-04;6105;7360;1494285;491611;12.2;4.0
11;2021-04-05;5950;2164;1500235;493775;12.2;4.0
11;2021-04-06;29953;18496;1530188;512271;12.5;4.2
11;2021-04-07;37510;20081;1567698;532352;12.8;4.3
11;2021-04-08;46640;21199;1614338;553551;13.1;4.5
11;2021-04-09;53747;21685;1668085;575236;13.6;4.7
11;2021-04-10;28937;19758;1697022;594994;13.8;4.8
11;2021-04-11;6547;7232;1703569;602226;13.9;4.9
11;2021-04-12;30286;19328;1733855;621554;14.1;5.1
11;2021-04-13;37285;27653;1771140;649207;14.4;5.3
11;2021-04-14;34977;24417;1806117;673624;14.7;5.5
11;2021-04-15;39136;28582;1845253;702206;15.0;5.7
11;2021-04-16;40999;27888;1886252;730094;15.4;5.9
11;2021-04-17;22766;15034;1909018;745128;15.5;6.1
11;2021-04-18;5296;3745;1914314;748873;15.6;6.1
11;2021-04-19;25076;23252;1939390;772125;15.8;6.3
11;2021-04-20;30558;27971;1969948;800096;16.0;6.5
11;2021-04-21;32204;28286;2002152;828382;16.3;6.7
11;2021-04-22;34471;34819;2036623;863201;16.6;7.0
11;2021-04-23;37907;32396;2074530;895597;16.9;7.3
11;2021-04-24;37936;23237;2112466;918834;17.2;7.5
11;2021-04-25;20513;8030;2132979;926864;17.4;7.5
11;2021-04-26;33854;25299;2166833;952163;17.6;7.8
11;2021-04-27;45712;30173;2212545;982336;18.0;8.0
11;2021-04-28;48396;29919;2260941;1012255;18.4;8.2
11;2021-04-29;57763;32413;2318704;1044668;18.9;8.5
11;2021-04-30;61286;31195;2379990;1075863;19.4;8.8
11;2021-05-01;24093;6061;2404083;1081924;19.6;8.8
11;2021-05-02;14623;5030;2418706;1086954;19.7;8.9
11;2021-05-03;54377;35339;2473083;1122293;20.1;9.1
11;2021-05-04;59698;34015;2532781;1156308;20.6;9.4
11;2021-05-05;60284;34211;2593065;1190519;21.1;9.7
11;2021-05-06;67216;38170;2660281;1228689;21.7;10.0
11;2021-05-07;65528;40107;2725809;1268796;22.2;10.3
11;2021-05-08;51119;16980;2776928;1285776;22.6;10.5
11;2021-05-09;33166;10237;2810094;1296013;22.9;10.6
11;2021-05-10;70724;30671;2880818;1326684;23.5;10.8
11;2021-05-11;81775;38193;2962593;1364877;24.1;11.1
11;2021-05-12;83547;32575;3046140;1397452;24.8;11.4
11;2021-05-13;68116;10068;3114256;1407520;25.4;11.5
11;2021-05-14;84357;22174;3198613;1429694;26.1;11.6
11;2021-05-15;66460;15441;3265073;1445135;26.6;11.8
11;2021-05-16;36457;5170;3301530;1450305;26.9;11.8
11;2021-05-17;82364;16935;3383894;1467240;27.6;11.9
11;2021-05-18;98283;19949;3482177;1487189;28.4;12.1
11;2021-05-19;97769;27886;3579946;1515075;29.2;12.3
11;2021-05-20;106493;28867;3686439;1543942;30.0;12.6
11;2021-05-21;100937;26061;3787376;1570003;30.8;12.8
11;2021-05-22;79415;14889;3866791;1584892;31.5;12.9
11;2021-05-23;41655;6072;3908446;1590964;31.8;13.0
11;2021-05-24;59604;8818;3968050;1599782;32.3;13.0
11;2021-05-25;85269;32276;4053319;1632058;33.0;13.3
11;2021-05-26;83772;32554;4137091;1664612;33.7;13.6
11;2021-05-27;92001;40624;4229092;1705236;34.4;13.9
11;2021-05-28;86652;45652;4315744;1750888;35.1;14.3
11;2021-05-29;67993;27585;4383737;1778473;35.7;14.5
11;2021-05-30;35875;8526;4419612;1786999;36.0;14.6
11;2021-05-31;77773;40015;4497385;1827014;36.6;14.9
11;2021-06-01;86718;51002;4584103;1878016;37.3;15.3
11;2021-06-02;82840;45593;4666943;1923609;38.0;15.7
11;2021-06-03;88651;53750;4755594;1977359;38.7;16.1
11;2021-06-04;84476;58799;4840070;2036158;39.4;16.6
11;2021-06-05;63457;49956;4903527;2086114;39.9;17.0
11;2021-06-06;37836;17584;4941363;2103698;40.2;17.1
11;2021-06-07;68791;53665;5010154;2157363;40.8;17.6
11;2021-06-08;72126;61907;5082280;2219270;41.4;18.1
11;2021-06-09;70383;63133;5152663;2282403;42.0;18.6
11;2021-06-10;70810;80837;5223473;2363240;42.5;19.2
11;2021-06-11;65443;72124;5288916;2435364;43.1;19.8
11;2021-06-12;63633;47672;5352549;2483036;43.6;20.2
11;2021-06-13;29506;22874;5382055;2505910;43.8;20.4
11;2021-06-14;43088;75279;5425143;2581189;44.2;21.0
11;2021-06-15;50943;82947;5476086;2664136;44.6;21.7
11;2021-06-16;52240;78234;5528326;2742370;45.0;22.3
11;2021-06-17;53886;81737;5582212;2824107;45.5;23.0
11;2021-06-18;49452;95902;5631664;2920009;45.9;23.8
11;2021-06-19;43244;69131;5674908;2989140;46.2;24.3
11;2021-06-20;16183;36035;5691091;3025175;46.4;24.6
11;2021-06-21;33978;84250;5725069;3109425;46.6;25.3
11;2021-06-22;38560;101079;5763629;3210504;46.9;26.1
11;2021-06-23;39301;98108;5802930;3308612;47.3;26.9
11;2021-06-24;41784;95886;5844714;3404498;47.6;27.7
24;2020-12-27;0;0;0;0;0.0;0.0
24;2020-12-28;17;0;17;0;0.0;0.0
24;2020-12-29;10;0;27;0;0.0;0.0
24;2020-12-30;1;0;28;0;0.0;0.0
24;2020-12-31;0;0;28;0;0.0;0.0
24;2021-01-01;1;0;29;0;0.0;0.0
24;2021-01-02;0;0;29;0;0.0;0.0
24;2021-01-03;0;0;29;0;0.0;0.0
24;2021-01-04;24;0;53;0;0.0;0.0
24;2021-01-05;163;0;216;0;0.0;0.0
24;2021-01-06;328;0;544;0;0.0;0.0
24;2021-01-07;492;1;1036;1;0.0;0.0
24;2021-01-08;952;2;1988;3;0.1;0.0
24;2021-01-09;504;0;2492;3;0.1;0.0
24;2021-01-10;395;0;2887;3;0.1;0.0
24;2021-01-11;1279;0;4166;3;0.2;0.0
24;2021-01-12;2575;9;6741;12;0.3;0.0
24;2021-01-13;2189;7;8930;19;0.3;0.0
24;2021-01-14;2503;52;11433;71;0.4;0.0
24;2021-01-15;2114;8;13547;79;0.5;0.0
24;2021-01-16;857;5;14404;84;0.6;0.0
24;2021-01-17;322;3;14726;87;0.6;0.0
24;2021-01-18;3214;16;17940;103;0.7;0.0
24;2021-01-19;6325;17;24265;120;0.9;0.0
24;2021-01-20;7166;10;31431;130;1.2;0.0
24;2021-01-21;7418;4;38849;134;1.5;0.0
24;2021-01-22;5118;4;43967;138;1.7;0.0
24;2021-01-23;1274;1;45241;139;1.8;0.0
24;2021-01-24;225;1;45466;140;1.8;0.0
24;2021-01-25;3113;24;48579;164;1.9;0.0
24;2021-01-26;4849;88;53428;252;2.1;0.0
24;2021-01-27;5045;183;58473;435;2.3;0.0
24;2021-01-28;5634;508;64107;943;2.5;0.0
24;2021-01-29;3422;731;67529;1674;2.6;0.1
24;2021-01-30;1207;398;68736;2072;2.7;0.1
24;2021-01-31;251;368;68987;2440;2.7;0.1
24;2021-02-01;2170;928;71157;3368;2.8;0.1
24;2021-02-02;3032;1891;74189;5259;2.9;0.2
24;2021-02-03;3110;1768;77299;7027;3.0;0.3
24;2021-02-04;3234;1618;80533;8645;3.1;0.3
24;2021-02-05;2394;1370;82927;10015;3.2;0.4
24;2021-02-06;707;263;83634;10278;3.3;0.4
24;2021-02-07;134;32;83768;10310;3.3;0.4
24;2021-02-08;1967;1571;85735;11881;3.4;0.5
24;2021-02-09;3412;3317;89147;15198;3.5;0.6
24;2021-02-10;4085;3755;93232;18953;3.6;0.7
24;2021-02-11;4654;4775;97886;23728;3.8;0.9
24;2021-02-12;3481;3272;101367;27000;4.0;1.1
24;2021-02-13;839;770;102206;27770;4.0;1.1
24;2021-02-14;426;256;102632;28026;4.0;1.1
24;2021-02-15;1963;2861;104595;30887;4.1;1.2
24;2021-02-16;2848;4498;107443;35385;4.2;1.4
24;2021-02-17;2690;5105;110133;40490;4.3;1.6
24;2021-02-18;3519;5174;113652;45664;4.4;1.8
24;2021-02-19;3200;3557;116852;49221;4.6;1.9
24;2021-02-20;1288;985;118140;50206;4.6;2.0
24;2021-02-21;433;239;118573;50445;4.6;2.0
24;2021-02-22;1650;3061;120223;53506;4.7;2.1
24;2021-02-23;2340;3139;122563;56645;4.8;2.2
24;2021-02-24;2093;3467;124656;60112;4.9;2.3
24;2021-02-25;3620;3167;128276;63279;5.0;2.5
24;2021-02-26;4465;2621;132741;65900;5.2;2.6
24;2021-02-27;1877;995;134618;66895;5.3;2.6
24;2021-02-28;97;219;134715;67114;5.3;2.6
24;2021-03-01;2172;2023;136887;69137;5.3;2.7
24;2021-03-02;3430;2893;140317;72030;5.5;2.8
24;2021-03-03;3548;3411;143865;75441;5.6;2.9
24;2021-03-04;5336;3719;149201;79160;5.8;3.1
24;2021-03-05;7037;3175;156238;82335;6.1;3.2
24;2021-03-06;7375;751;163613;83086;6.4;3.2
24;2021-03-07;2429;289;166042;83375;6.5;3.3
24;2021-03-08;2689;2624;168731;85999;6.6;3.4
24;2021-03-09;5778;2849;174509;88848;6.8;3.5
24;2021-03-10;6405;3526;180914;92374;7.1;3.6
24;2021-03-11;7802;3513;188716;95887;7.4;3.7
24;2021-03-12;10787;2689;199503;98576;7.8;3.9
24;2021-03-13;7118;721;206621;99297;8.1;3.9
24;2021-03-14;1550;270;208171;99567;8.1;3.9
24;2021-03-15;4559;1976;212730;101543;8.3;4.0
24;2021-03-16;4595;2370;217325;103913;8.5;4.1
24;2021-03-17;4462;1986;221787;105899;8.7;4.1
24;2021-03-18;5063;2091;226850;107990;8.9;4.2
24;2021-03-19;7776;1682;234626;109672;9.2;4.3
24;2021-03-20;4432;882;239058;110554;9.3;4.3
24;2021-03-21;557;349;239615;110903;9.4;4.3
24;2021-03-22;4860;1717;244475;112620;9.6;4.4
24;2021-03-23;8036;2295;252511;114915;9.9;4.5
24;2021-03-24;8815;2013;261326;116928;10.2;4.6
24;2021-03-25;12139;1963;273465;118891;10.7;4.6
24;2021-03-26;13271;1990;286736;120881;11.2;4.7
24;2021-03-27;5777;676;292513;121557;11.4;4.8
24;2021-03-28;520;97;293033;121654;11.5;4.8
24;2021-03-29;6760;1876;299793;123530;11.7;4.8
24;2021-03-30;10172;2791;309965;126321;12.1;4.9
24;2021-03-31;9890;2347;319855;128668;12.5;5.0
24;2021-04-01;12040;3399;331895;132067;13.0;5.2
24;2021-04-02;10614;3344;342509;135411;13.4;5.3
24;2021-04-03;3401;1716;345910;137127;13.5;5.4
24;2021-04-04;394;343;346304;137470;13.5;5.4
24;2021-04-05;396;51;346700;137521;13.5;5.4
24;2021-04-06;8314;3419;355014;140940;13.9;5.5
24;2021-04-07;11062;4552;366076;145492;14.3;5.7
24;2021-04-08;14178;4749;380254;150241;14.9;5.9
24;2021-04-09;17747;3721;398001;153962;15.6;6.0
24;2021-04-10;9381;2084;407382;156046;15.9;6.1
24;2021-04-11;2909;1248;410291;157294;16.0;6.1
24;2021-04-12;10841;3442;421132;160736;16.5;6.3
24;2021-04-13;14989;4823;436121;165559;17.0;6.5
24;2021-04-14;13459;4931;449580;170490;17.6;6.7
24;2021-04-15;15336;5130;464916;175620;18.2;6.9
24;2021-04-16;15667;4340;480583;179960;18.8;7.0
24;2021-04-17;8190;1323;488773;181283;19.1;7.1
24;2021-04-18;1100;286;489873;181569;19.1;7.1
24;2021-04-19;9438;4142;499311;185711;19.5;7.3
24;2021-04-20;12721;5978;512032;191689;20.0;7.5
24;2021-04-21;12326;5999;524358;197688;20.5;7.7
24;2021-04-22;13861;7538;538219;205226;21.0;8.0
24;2021-04-23;13693;7046;551912;212272;21.6;8.3
24;2021-04-24;10236;3250;562148;215522;22.0;8.4
24;2021-04-25;3048;433;565196;215955;22.1;8.4
24;2021-04-26;10201;5427;575397;221382;22.5;8.7
24;2021-04-27;13873;7754;589270;229136;23.0;9.0
24;2021-04-28;13019;8456;602289;237592;23.5;9.3
24;2021-04-29;16579;8586;618868;246178;24.2;9.6
24;2021-04-30;17469;7237;636337;253415;24.9;9.9
24;2021-05-01;2911;671;639248;254086;25.0;9.9
24;2021-05-02;2140;318;641388;254404;25.1;9.9
24;2021-05-03;11284;6115;652672;260519;25.5;10.2
24;2021-05-04;12801;10291;665473;270810;26.0;10.6
24;2021-05-05;13873;9578;679346;280388;26.5;11.0
24;2021-05-06;17476;9670;696822;290058;27.2;11.3
24;2021-05-07;14537;11986;711359;302044;27.8;11.8
24;2021-05-08;3706;2375;715065;304419;27.9;11.9
24;2021-05-09;2326;3730;717391;308149;28.0;12.0
24;2021-05-10;11511;12197;728902;320346;28.5;12.5
24;2021-05-11;16352;14203;745254;334549;29.1;13.1
24;2021-05-12;18215;13153;763469;347702;29.8;13.6
24;2021-05-13;6922;3167;770391;350869;30.1;13.7
24;2021-05-14;14490;9177;784881;360046;30.7;14.1
24;2021-05-15;10465;5052;795346;365098;31.1;14.3
24;2021-05-16;3158;1182;798504;366280;31.2;14.3
24;2021-05-17;13291;7657;811795;373937;31.7;14.6
24;2021-05-18;18385;8208;830180;382145;32.4;14.9
24;2021-05-19;19010;7494;849190;389639;33.2;15.2
24;2021-05-20;21300;8427;870490;398066;34.0;15.6
24;2021-05-21;18368;9085;888858;407151;34.7;15.9
24;2021-05-22;7620;4187;896478;411338;35.0;16.1
24;2021-05-23;2981;942;899459;412280;35.1;16.1
24;2021-05-24;8332;1591;907791;413871;35.5;16.2
24;2021-05-25;17724;8850;925515;422721;36.2;16.5
24;2021-05-26;19238;8292;944753;431013;36.9;16.8
24;2021-05-27;20871;10034;965624;441047;37.7;17.2
24;2021-05-28;20437;12257;986061;453304;38.5;17.7
24;2021-05-29;12410;5901;998471;459205;39.0;17.9
24;2021-05-30;2032;1485;1000503;460690;39.1;18.0
24;2021-05-31;14574;8907;1015077;469597;39.7;18.4
24;2021-06-01;19673;12021;1034750;481618;40.4;18.8
24;2021-06-02;17741;10794;1052491;492412;41.1;19.2
24;2021-06-03;20853;11905;1073344;504317;41.9;19.7
24;2021-06-04;19923;13849;1093267;518166;42.7;20.2
24;2021-06-05;9863;8852;1103130;527018;43.1;20.6
24;2021-06-06;1991;3020;1105121;530038;43.2;20.7
24;2021-06-07;14409;12016;1119530;542054;43.7;21.2
24;2021-06-08;16056;14950;1135586;557004;44.4;21.8
24;2021-06-09;16446;12760;1152032;569764;45.0;22.3
24;2021-06-10;17859;12106;1169891;581870;45.7;22.7
24;2021-06-11;17155;15299;1187046;597169;46.4;23.3
24;2021-06-12;10068;7332;1197114;604501;46.8;23.6
24;2021-06-13;892;1313;1198006;605814;46.8;23.7
24;2021-06-14;10446;15263;1208452;621077;47.2;24.3
24;2021-06-15;12963;17118;1221415;638195;47.7;24.9
24;2021-06-16;13432;16270;1234847;654465;48.3;25.6
24;2021-06-17;13104;17308;1247951;671773;48.8;26.3
24;2021-06-18;14520;19818;1262471;691591;49.3;27.0
24;2021-06-19;7906;6639;1270377;698230;49.6;27.3
24;2021-06-20;554;858;1270931;699088;49.7;27.3
24;2021-06-21;8831;16477;1279762;715565;50.0;28.0
24;2021-06-22;10184;19401;1289946;734966;50.4;28.7
24;2021-06-23;9683;17847;1299629;752813;50.8;29.4
24;2021-06-24;8919;12850;1308548;765663;51.1;29.9
27;2020-12-27;4;0;4;0;0.0;0.0
27;2020-12-28;0;0;4;0;0.0;0.0
27;2020-12-29;19;0;23;0;0.0;0.0
27;2020-12-30;20;0;43;0;0.0;0.0
27;2020-12-31;2;0;45;0;0.0;0.0
27;2021-01-01;0;0;45;0;0.0;0.0
27;2021-01-02;1;0;46;0;0.0;0.0
27;2021-01-03;1;0;47;0;0.0;0.0
27;2021-01-04;27;0;74;0;0.0;0.0
27;2021-01-05;263;2;337;2;0.0;0.0
27;2021-01-06;718;1;1055;3;0.0;0.0
27;2021-01-07;1581;3;2636;6;0.1;0.0
27;2021-01-08;1896;3;4532;9;0.2;0.0
27;2021-01-09;689;0;5221;9;0.2;0.0
27;2021-01-10;3;0;5224;9;0.2;0.0
27;2021-01-11;2420;3;7644;12;0.3;0.0
27;2021-01-12;3823;4;11467;16;0.4;0.0
27;2021-01-13;3848;8;15315;24;0.6;0.0
27;2021-01-14;4752;48;20067;72;0.7;0.0
27;2021-01-15;3593;22;23660;94;0.9;0.0
27;2021-01-16;793;11;24453;105;0.9;0.0
27;2021-01-17;116;1;24569;106;0.9;0.0
27;2021-01-18;6250;18;30819;124;1.1;0.0
27;2021-01-19;8394;23;39213;147;1.4;0.0
27;2021-01-20;7905;59;47118;206;1.7;0.0
27;2021-01-21;9454;21;56572;227;2.0;0.0
27;2021-01-22;7707;17;64279;244;2.3;0.0
27;2021-01-23;2985;6;67264;250;2.4;0.0
27;2021-01-24;347;0;67611;250;2.4;0.0
27;2021-01-25;5219;30;72830;280;2.6;0.0
27;2021-01-26;7390;229;80220;509;2.9;0.0
27;2021-01-27;7096;354;87316;863;3.1;0.0
27;2021-01-28;6335;895;93651;1758;3.4;0.1
27;2021-01-29;5930;1266;99581;3024;3.6;0.1
27;2021-01-30;2496;347;102077;3371;3.7;0.1
27;2021-01-31;252;22;102329;3393;3.7;0.1
27;2021-02-01;3358;1403;105687;4796;3.8;0.2
27;2021-02-02;4040;2225;109727;7021;3.9;0.3
27;2021-02-03;3618;2396;113345;9417;4.1;0.3
27;2021-02-04;3703;3152;117048;12569;4.2;0.5
27;2021-02-05;3240;2588;120288;15157;4.3;0.5
27;2021-02-06;1608;671;121896;15828;4.4;0.6
27;2021-02-07;5;87;121901;15915;4.4;0.6
27;2021-02-08;2911;2686;124812;18601;4.5;0.7
27;2021-02-09;3015;3662;127827;22263;4.6;0.8
27;2021-02-10;3055;3413;130882;25676;4.7;0.9
27;2021-02-11;3316;4653;134198;30329;4.8;1.1
27;2021-02-12;2726;4464;136924;34793;4.9;1.3
27;2021-02-13;985;1467;137909;36260;5.0;1.3
27;2021-02-14;258;300;138167;36560;5.0;1.3
27;2021-02-15;1239;5759;139406;42319;5.0;1.5
27;2021-02-16;1507;7439;140913;49758;5.1;1.8
27;2021-02-17;1807;6918;142720;56676;5.1;2.0
27;2021-02-18;2143;6472;144863;63148;5.2;2.3
27;2021-02-19;1736;5673;146599;68821;5.3;2.5
27;2021-02-20;712;2180;147311;71001;5.3;2.6
27;2021-02-21;2;280;147313;71281;5.3;2.6
27;2021-02-22;978;4902;148291;76183;5.3;2.7
27;2021-02-23;1203;5449;149494;81632;5.4;2.9
27;2021-02-24;1508;4871;151002;86503;5.4;3.1
27;2021-02-25;2921;5064;153923;91567;5.5;3.3
27;2021-02-26;3684;4220;157607;95787;5.7;3.4
27;2021-02-27;1911;1958;159518;97745;5.7;3.5
27;2021-02-28;107;282;159625;98027;5.7;3.5
27;2021-03-01;3669;3513;163294;101540;5.9;3.6
27;2021-03-02;5410;4344;168704;105884;6.1;3.8
27;2021-03-03;5962;3574;174666;109458;6.3;3.9
27;2021-03-04;7707;3573;182373;113031;6.6;4.1
27;2021-03-05;9699;3199;192072;116230;6.9;4.2
27;2021-03-06;6226;1086;198298;117316;7.1;4.2
27;2021-03-07;872;187;199170;117503;7.2;4.2
27;2021-03-08;4542;3425;203712;120928;7.3;4.3
27;2021-03-09;8421;3399;212133;124327;7.6;4.5
27;2021-03-10;8718;2815;220851;127142;7.9;4.6
27;2021-03-11;10266;3207;231117;130349;8.3;4.7
27;2021-03-12;11893;2474;243010;132823;8.7;4.8
27;2021-03-13;7049;698;250059;133521;9.0;4.8
27;2021-03-14;212;60;250271;133581;9.0;4.8
27;2021-03-15;7321;1383;257592;134964;9.3;4.8
27;2021-03-16;8246;1091;265838;136055;9.6;4.9
27;2021-03-17;8536;1182;274374;137237;9.9;4.9
27;2021-03-18;8626;1419;283000;138656;10.2;5.0
27;2021-03-19;9442;1098;292442;139754;10.5;5.0
27;2021-03-20;5670;399;298112;140153;10.7;5.0
27;2021-03-21;238;11;298350;140164;10.7;5.0
27;2021-03-22;9334;961;307684;141125;11.1;5.1
27;2021-03-23;14720;1195;322404;142320;11.6;5.1
27;2021-03-24;15183;1251;337587;143571;12.1;5.2
27;2021-03-25;18382;1464;355969;145035;12.8;5.2
27;2021-03-26;18388;1264;374357;146299;13.5;5.3
27;2021-03-27;7684;411;382041;146710;13.7;5.3
27;2021-03-28;492;124;382533;146834;13.7;5.3
27;2021-03-29;10030;3401;392563;150235;14.1;5.4
27;2021-03-30;12967;4013;405530;154248;14.6;5.5
27;2021-03-31;12835;4205;418365;158453;15.0;5.7
27;2021-04-01;14548;4146;432913;162599;15.6;5.8
27;2021-04-02;12943;4048;445856;166647;16.0;6.0
27;2021-04-03;4476;1137;450332;167784;16.2;6.0
27;2021-04-04;69;35;450401;167819;16.2;6.0
27;2021-04-05;345;7;450746;167826;16.2;6.0
27;2021-04-06;9560;6184;460306;174010;16.5;6.3
27;2021-04-07;10193;6469;470499;180479;16.9;6.5
27;2021-04-08;15726;6152;486225;186631;17.5;6.7
27;2021-04-09;17832;6001;504057;192632;18.1;6.9
27;2021-04-10;6064;1948;510121;194580;18.3;7.0
27;2021-04-11;419;83;510540;194663;18.3;7.0
27;2021-04-12;9061;6798;519601;201461;18.7;7.2
27;2021-04-13;11740;8509;531341;209970;19.1;7.5
27;2021-04-14;10287;7840;541628;217810;19.5;7.8
27;2021-04-15;12957;7665;554585;225475;19.9;8.1
27;2021-04-16;12752;6444;567337;231919;20.4;8.3
27;2021-04-17;5918;3029;573255;234948;20.6;8.4
27;2021-04-18;354;189;573609;235137;20.6;8.4
27;2021-04-19;6969;8858;580578;243995;20.9;8.8
27;2021-04-20;8475;10532;589053;254527;21.2;9.1
27;2021-04-21;8334;10142;597387;264669;21.5;9.5
27;2021-04-22;9853;11529;607240;276198;21.8;9.9
27;2021-04-23;11331;10298;618571;286496;22.2;10.3
27;2021-04-24;5162;3955;623733;290451;22.4;10.4
27;2021-04-25;440;294;624173;290745;22.4;10.4
27;2021-04-26;9538;8748;633711;299493;22.8;10.8
27;2021-04-27;13457;10248;647168;309741;23.3;11.1
27;2021-04-28;14188;10354;661356;320095;23.8;11.5
27;2021-04-29;17871;11520;679227;331615;24.4;11.9
27;2021-04-30;18718;9504;697945;341119;25.1;12.3
27;2021-05-01;5426;1544;703371;342663;25.3;12.3
27;2021-05-02;601;73;703972;342736;25.3;12.3
27;2021-05-03;14900;6318;718872;349054;25.8;12.5
27;2021-05-04;13937;10789;732809;359843;26.3;12.9
27;2021-05-05;15552;10015;748361;369858;26.9;13.3
27;2021-05-06;18269;12328;766630;382186;27.5;13.7
27;2021-05-07;17216;11747;783846;393933;28.2;14.2
27;2021-05-08;5945;1507;789791;395440;28.4;14.2
27;2021-05-09;533;439;790324;395879;28.4;14.2
27;2021-05-10;15267;9871;805591;405750;28.9;14.6
27;2021-05-11;20746;12884;826337;418634;29.7;15.0
27;2021-05-12;19654;11740;845991;430374;30.4;15.5
27;2021-05-13;12290;2035;858281;432409;30.8;15.5
27;2021-05-14;22892;8368;881173;440777;31.7;15.8
27;2021-05-15;15380;3391;896553;444168;32.2;16.0
27;2021-05-16;1881;234;898434;444402;32.3;16.0
27;2021-05-17;18924;6773;917358;451175;33.0;16.2
27;2021-05-18;20507;9274;937865;460449;33.7;16.5
27;2021-05-19;22211;7281;960076;467730;34.5;16.8
27;2021-05-20;23178;8187;983254;475917;35.3;17.1
27;2021-05-21;21070;10032;1004324;485949;36.1;17.5
27;2021-05-22;8260;3597;1012584;489546;36.4;17.6
27;2021-05-23;903;305;1013487;489851;36.4;17.6
27;2021-05-24;4226;1080;1017713;490931;36.6;17.6
27;2021-05-25;14849;11615;1032562;502546;37.1;18.1
27;2021-05-26;15347;10637;1047909;513183;37.7;18.4
27;2021-05-27;18374;11799;1066283;524982;38.3;18.9
27;2021-05-28;16058;14114;1082341;539096;38.9;19.4
27;2021-05-29;6809;5151;1089150;544247;39.1;19.6
27;2021-05-30;390;255;1089540;544502;39.1;19.6
27;2021-05-31;13302;10924;1102842;555426;39.6;20.0
27;2021-06-01;16500;13427;1119342;568853;40.2;20.4
27;2021-06-02;16146;11444;1135488;580297;40.8;20.9
27;2021-06-03;17722;11856;1153210;592153;41.4;21.3
27;2021-06-04;16156;14613;1169366;606766;42.0;21.8
27;2021-06-05;8337;6756;1177703;613522;42.3;22.0
27;2021-06-06;1717;644;1179420;614166;42.4;22.1
27;2021-06-07;17423;13085;1196843;627251;43.0;22.5
27;2021-06-08;19644;15316;1216487;642567;43.7;23.1
27;2021-06-09;19021;12484;1235508;655051;44.4;23.5
27;2021-06-10;18979;13886;1254487;668937;45.1;24.0
27;2021-06-11;18097;17074;1272584;686011;45.7;24.6
27;2021-06-12;9466;7835;1282050;693846;46.1;24.9
27;2021-06-13;942;947;1282992;694793;46.1;25.0
27;2021-06-14;11052;17036;1294044;711829;46.5;25.6
27;2021-06-15;14123;17615;1308167;729444;47.0;26.2
27;2021-06-16;14673;15595;1322840;745039;47.5;26.8
27;2021-06-17;15145;17240;1337985;762279;48.1;27.4
27;2021-06-18;14758;20160;1352743;782439;48.6;28.1
27;2021-06-19;7651;8648;1360394;791087;48.9;28.4
27;2021-06-20;170;457;1360564;791544;48.9;28.4
27;2021-06-21;7745;19014;1368309;810558;49.2;29.1
27;2021-06-22;9548;24235;1377857;834793;49.5;30.0
27;2021-06-23;11234;19276;1389091;854069;49.9;30.7
27;2021-06-24;10401;17935;1399492;872004;50.3;31.3
28;2020-12-27;0;0;0;0;0.0;0.0
28;2020-12-28;1;0;1;0;0.0;0.0
28;2020-12-29;2;0;3;0;0.0;0.0
28;2020-12-30;0;0;3;0;0.0;0.0
28;2020-12-31;1;0;4;0;0.0;0.0
28;2021-01-01;2;0;6;0;0.0;0.0
28;2021-01-02;1;0;7;0;0.0;0.0
28;2021-01-03;1;0;8;0;0.0;0.0
28;2021-01-04;16;0;24;0;0.0;0.0
28;2021-01-05;169;0;193;0;0.0;0.0
28;2021-01-06;1393;2;1586;2;0.0;0.0
28;2021-01-07;2599;9;4185;11;0.1;0.0
28;2021-01-08;3428;3;7613;14;0.2;0.0
28;2021-01-09;1331;3;8944;17;0.3;0.0
28;2021-01-10;705;1;9649;18;0.3;0.0
28;2021-01-11;3179;4;12828;22;0.4;0.0
28;2021-01-12;3978;3;16806;25;0.5;0.0
28;2021-01-13;4302;7;21108;32;0.6;0.0
28;2021-01-14;8097;73;29205;105;0.9;0.0
28;2021-01-15;6219;25;35424;130;1.1;0.0
28;2021-01-16;2086;9;37510;139;1.1;0.0
28;2021-01-17;4071;22;41581;161;1.3;0.0
28;2021-01-18;8783;13;50364;174;1.5;0.0
28;2021-01-19;7142;13;57506;187;1.7;0.0
28;2021-01-20;6506;11;64012;198;1.9;0.0
28;2021-01-21;5992;10;70004;208;2.1;0.0
28;2021-01-22;5440;12;75444;220;2.3;0.0
28;2021-01-23;2020;8;77464;228;2.3;0.0
28;2021-01-24;1447;11;78911;239;2.4;0.0
28;2021-01-25;6239;179;85150;418;2.6;0.0
28;2021-01-26;4575;394;89725;812;2.7;0.0
28;2021-01-27;4034;765;93759;1577;2.8;0.0
28;2021-01-28;3755;1049;97514;2626;3.0;0.1
28;2021-01-29;3488;1306;101002;3932;3.1;0.1
28;2021-01-30;1386;517;102388;4449;3.1;0.1
28;2021-01-31;195;126;102583;4575;3.1;0.1
28;2021-02-01;2781;1661;105364;6236;3.2;0.2
28;2021-02-02;2985;2392;108349;8628;3.3;0.3
28;2021-02-03;2947;2671;111296;11299;3.4;0.3
28;2021-02-04;3726;5209;115022;16508;3.5;0.5
28;2021-02-05;3885;4393;118907;20901;3.6;0.6
28;2021-02-06;1140;1549;120047;22450;3.6;0.7
28;2021-02-07;715;1975;120762;24425;3.7;0.7
28;2021-02-08;3800;6863;124562;31288;3.8;0.9
28;2021-02-09;3459;6034;128021;37322;3.9;1.1
28;2021-02-10;3455;5076;131476;42398;4.0;1.3
28;2021-02-11;4208;4900;135684;47298;4.1;1.4
28;2021-02-12;4043;4615;139727;51913;4.2;1.6
28;2021-02-13;1124;1583;140851;53496;4.3;1.6
28;2021-02-14;285;1388;141136;54884;4.3;1.7
28;2021-02-15;2213;6285;143349;61169;4.3;1.9
28;2021-02-16;2654;5669;146003;66838;4.4;2.0
28;2021-02-17;1951;4557;147954;71395;4.5;2.2
28;2021-02-18;2568;4313;150522;75708;4.6;2.3
28;2021-02-19;2547;3723;153069;79431;4.6;2.4
28;2021-02-20;945;1260;154014;80691;4.7;2.4
28;2021-02-21;103;416;154117;81107;4.7;2.5
28;2021-02-22;1669;4233;155786;85340;4.7;2.6
28;2021-02-23;2173;3842;157959;89182;4.8;2.7
28;2021-02-24;2372;3898;160331;93080;4.9;2.8
28;2021-02-25;4771;4201;165102;97281;5.0;2.9
28;2021-02-26;5959;3743;171061;101024;5.2;3.1
28;2021-02-27;3008;1032;174069;102056;5.3;3.1
28;2021-02-28;340;387;174409;102443;5.3;3.1
28;2021-03-01;2524;4659;176933;107102;5.4;3.2
28;2021-03-02;3900;4104;180833;111206;5.5;3.4
28;2021-03-03;4789;3486;185622;114692;5.6;3.5
28;2021-03-04;7302;2863;192924;117555;5.8;3.6
28;2021-03-05;10145;2496;203069;120051;6.1;3.6
28;2021-03-06;9807;790;212876;120841;6.4;3.7
28;2021-03-07;3771;127;216647;120968;6.6;3.7
28;2021-03-08;5865;3277;222512;124245;6.7;3.8
28;2021-03-09;9284;2823;231796;127068;7.0;3.8
28;2021-03-10;9803;2442;241599;129510;7.3;3.9
28;2021-03-11;13961;2014;255560;131524;7.7;4.0
28;2021-03-12;17984;1552;273544;133076;8.3;4.0
28;2021-03-13;11147;525;284691;133601;8.6;4.0
28;2021-03-14;2259;99;286950;133700;8.7;4.0
28;2021-03-15;8643;869;295593;134569;8.9;4.1
28;2021-03-16;7487;1187;303080;135756;9.2;4.1
28;2021-03-17;7716;1188;310796;136944;9.4;4.1
28;2021-03-18;8163;1372;318959;138316;9.7;4.2
28;2021-03-19;11562;1460;330521;139776;10.0;4.2
28;2021-03-20;9667;540;340188;140316;10.3;4.2
28;2021-03-21;2409;22;342597;140338;10.4;4.2
28;2021-03-22;9383;1634;351980;141972;10.7;4.3
28;2021-03-23;12483;1512;364463;143484;11.0;4.3
28;2021-03-24;13250;1594;377713;145078;11.4;4.4
28;2021-03-25;17616;1812;395329;146890;12.0;4.4
28;2021-03-26;20820;1874;416149;148764;12.6;4.5
28;2021-03-27;11491;1123;427640;149887;12.9;4.5
28;2021-03-28;2966;91;430606;149978;13.0;4.5
28;2021-03-29;11761;2958;442367;152936;13.4;4.6
28;2021-03-30;14417;3068;456784;156004;13.8;4.7
28;2021-03-31;14389;3565;471173;159569;14.3;4.8
28;2021-04-01;18021;5549;489194;165118;14.8;5.0
28;2021-04-02;16804;6386;505998;171504;15.3;5.2
28;2021-04-03;6997;3965;512995;175469;15.5;5.3
28;2021-04-04;1776;801;514771;176270;15.6;5.3
28;2021-04-05;3288;737;518059;177007;15.7;5.4
28;2021-04-06;10805;7380;528864;184387;16.0;5.6
28;2021-04-07;12691;6956;541555;191343;16.4;5.8
28;2021-04-08;17659;7544;559214;198887;16.9;6.0
28;2021-04-09;23803;7834;583017;206721;17.6;6.3
28;2021-04-10;13826;4123;596843;210844;18.1;6.4
28;2021-04-11;3028;1194;599871;212038;18.2;6.4
28;2021-04-12;13768;8032;613639;220070;18.6;6.7
28;2021-04-13;16171;8050;629810;228120;19.1;6.9
28;2021-04-14;14308;8031;644118;236151;19.5;7.1
28;2021-04-15;17215;8400;661333;244551;20.0;7.4
28;2021-04-16;20262;7835;681595;252386;20.6;7.6
28;2021-04-17;12735;5025;694330;257411;21.0;7.8
28;2021-04-18;2287;1242;696617;258653;21.1;7.8
28;2021-04-19;10865;8871;707482;267524;21.4;8.1
28;2021-04-20;13900;9774;721382;277298;21.8;8.4
28;2021-04-21;13281;9995;734663;287293;22.2;8.7
28;2021-04-22;15285;11902;749948;299195;22.7;9.1
28;2021-04-23;16420;12321;766368;311516;23.2;9.4
28;2021-04-24;12578;7267;778946;318783;23.6;9.6
28;2021-04-25;3293;1914;782239;320697;23.7;9.7
28;2021-04-26;12533;10181;794772;330878;24.1;10.0
28;2021-04-27;14852;11739;809624;342617;24.5;10.4
28;2021-04-28;15042;10708;824666;353325;25.0;10.7
28;2021-04-29;18450;11764;843116;365089;25.5;11.1
28;2021-04-30;20369;11896;863485;376985;26.1;11.4
28;2021-05-01;12806;2970;876291;379955;26.5;11.5
28;2021-05-02;5983;1838;882274;381793;26.7;11.6
28;2021-05-03;12851;10001;895125;391794;27.1;11.9
28;2021-05-04;13810;13133;908935;404927;27.5;12.3
28;2021-05-05;13941;14469;922876;419396;27.9;12.7
28;2021-05-06;18302;15095;941178;434491;28.5;13.2
28;2021-05-07;17804;17377;958982;451868;29.0;13.7
28;2021-05-08;12619;4698;971601;456566;29.4;13.8
28;2021-05-09;7145;1825;978746;458391;29.6;13.9
28;2021-05-10;14192;14798;992938;473189;30.1;14.3
28;2021-05-11;18106;15338;1011044;488527;30.6;14.8
28;2021-05-12;18777;13972;1029821;502499;31.2;15.2
28;2021-05-13;19674;3730;1049495;506229;31.8;15.3
28;2021-05-14;26309;12517;1075804;518746;32.6;15.7
28;2021-05-15;26892;7074;1102696;525820;33.4;15.9
28;2021-05-16;14116;1568;1116812;527388;33.8;16.0
28;2021-05-17;16148;9419;1132960;536807;34.3;16.2
28;2021-05-18;21003;8756;1153963;545563;34.9;16.5
28;2021-05-19;20852;8472;1174815;554035;35.6;16.8
28;2021-05-20;23084;9649;1197899;563684;36.3;17.1
28;2021-05-21;21409;12066;1219308;575750;36.9;17.4
28;2021-05-22;17551;5979;1236859;581729;37.4;17.6
28;2021-05-23;9109;926;1245968;582655;37.7;17.6
28;2021-05-24;13393;3164;1259361;585819;38.1;17.7
28;2021-05-25;19126;11583;1278487;597402;38.7;18.1
28;2021-05-26;19244;10006;1297731;607408;39.3;18.4
28;2021-05-27;21694;12369;1319425;619777;39.9;18.8
28;2021-05-28;21587;16509;1341012;636286;40.6;19.3
28;2021-05-29;17544;10161;1358556;646447;41.1;19.6
28;2021-05-30;6266;1268;1364822;647715;41.3;19.6
28;2021-05-31;19849;11931;1384671;659646;41.9;20.0
28;2021-06-01;23690;13843;1408361;673489;42.6;20.4
28;2021-06-02;20787;12318;1429148;685807;43.3;20.8
28;2021-06-03;26448;14651;1455596;700458;44.1;21.2
28;2021-06-04;24553;18918;1480149;719376;44.8;21.8
28;2021-06-05;18348;12077;1498497;731453;45.4;22.1
28;2021-06-06;7661;2405;1506158;733858;45.6;22.2
28;2021-06-07;19213;14158;1525371;748016;46.2;22.6
28;2021-06-08;22610;15536;1547981;763552;46.9;23.1
28;2021-06-09;19724;14675;1567705;778227;47.5;23.6
28;2021-06-10;21183;14768;1588888;792995;48.1;24.0
28;2021-06-11;21006;21123;1609894;814118;48.7;24.6
28;2021-06-12;17909;17121;1627803;831239;49.3;25.2
28;2021-06-13;6337;5881;1634140;837120;49.5;25.3
28;2021-06-14;13870;17714;1648010;854834;49.9;25.9
28;2021-06-15;16200;18710;1664210;873544;50.4;26.4
28;2021-06-16;16663;18559;1680873;892103;50.9;27.0
28;2021-06-17;17227;20489;1698100;912592;51.4;27.6
28;2021-06-18;18471;24401;1716571;936993;52.0;28.4
28;2021-06-19;14787;15790;1731358;952783;52.4;28.8
28;2021-06-20;4980;5120;1736338;957903;52.6;29.0
28;2021-06-21;11314;20720;1747652;978623;52.9;29.6
28;2021-06-22;12717;23845;1760369;1002468;53.3;30.3
28;2021-06-23;11817;23561;1772186;1026029;53.6;31.1
28;2021-06-24;12500;24408;1784686;1050437;54.0;31.8
32;2020-12-27;1;0;1;0;0.0;0.0
32;2020-12-28;26;0;27;0;0.0;0.0
32;2020-12-29;12;0;39;0;0.0;0.0
32;2020-12-30;0;0;39;0;0.0;0.0
32;2020-12-31;0;0;39;0;0.0;0.0
32;2021-01-01;1;0;40;0;0.0;0.0
32;2021-01-02;6;0;46;0;0.0;0.0
32;2021-01-03;4;0;50;0;0.0;0.0
32;2021-01-04;82;0;132;0;0.0;0.0
32;2021-01-05;300;0;432;0;0.0;0.0
32;2021-01-06;787;2;1219;2;0.0;0.0
32;2021-01-07;2431;4;3650;6;0.1;0.0
32;2021-01-08;3165;9;6815;15;0.1;0.0
32;2021-01-09;957;3;7772;18;0.1;0.0
32;2021-01-10;640;0;8412;18;0.1;0.0
32;2021-01-11;3268;6;11680;24;0.2;0.0
32;2021-01-12;5005;7;16685;31;0.3;0.0
32;2021-01-13;4941;11;21626;42;0.4;0.0
32;2021-01-14;5723;44;27349;86;0.5;0.0
32;2021-01-15;5223;25;32572;111;0.5;0.0
32;2021-01-16;1636;11;34208;122;0.6;0.0
32;2021-01-17;860;3;35068;125;0.6;0.0
32;2021-01-18;7232;21;42300;146;0.7;0.0
32;2021-01-19;9899;36;52199;182;0.9;0.0
32;2021-01-20;10350;30;62549;212;1.0;0.0
32;2021-01-21;12703;45;75252;257;1.3;0.0
32;2021-01-22;9875;28;85127;285;1.4;0.0
32;2021-01-23;3410;4;88537;289;1.5;0.0
32;2021-01-24;1119;3;89656;292;1.5;0.0
32;2021-01-25;6865;85;96521;377;1.6;0.0
32;2021-01-26;7447;181;103968;558;1.7;0.0
32;2021-01-27;4837;512;108805;1070;1.8;0.0
32;2021-01-28;8595;1690;117400;2760;2.0;0.0
32;2021-01-29;5382;1860;122782;4620;2.1;0.1
32;2021-01-30;534;413;123316;5033;2.1;0.1
32;2021-01-31;67;74;123383;5107;2.1;0.1
32;2021-02-01;191;1816;123574;6923;2.1;0.1
32;2021-02-02;786;3170;124360;10093;2.1;0.2
32;2021-02-03;4073;3190;128433;13283;2.2;0.2
32;2021-02-04;3683;3621;132116;16904;2.2;0.3
32;2021-02-05;1962;3279;134078;20183;2.2;0.3
32;2021-02-06;517;875;134595;21058;2.3;0.4
32;2021-02-07;539;100;135134;21158;2.3;0.4
32;2021-02-08;1865;3683;136999;24841;2.3;0.4
32;2021-02-09;2550;4369;139549;29210;2.3;0.5
32;2021-02-10;2984;5345;142533;34555;2.4;0.6
32;2021-02-11;4776;6197;147309;40752;2.5;0.7
32;2021-02-12;5092;4674;152401;45426;2.6;0.8
32;2021-02-13;939;1893;153340;47319;2.6;0.8
32;2021-02-14;116;711;153456;48030;2.6;0.8
32;2021-02-15;3613;6933;157069;54963;2.6;0.9
32;2021-02-16;4029;8243;161098;63206;2.7;1.1
32;2021-02-17;4302;8695;165400;71901;2.8;1.2
32;2021-02-18;7033;11442;172433;83343;2.9;1.4
32;2021-02-19;7080;8316;179513;91659;3.0;1.5
32;2021-02-20;2517;3017;182030;94676;3.1;1.6
32;2021-02-21;434;489;182464;95165;3.1;1.6
32;2021-02-22;3260;5334;185724;100499;3.1;1.7
32;2021-02-23;5504;5925;191228;106424;3.2;1.8
32;2021-02-24;7443;6062;198671;112486;3.3;1.9
32;2021-02-25;12831;5034;211502;117520;3.5;2.0
32;2021-02-26;12536;2889;224038;120409;3.8;2.0
32;2021-02-27;6485;318;230523;120727;3.9;2.0
32;2021-02-28;364;134;230887;120861;3.9;2.0
32;2021-03-01;7243;861;238130;121722;4.0;2.0
32;2021-03-02;10959;995;249089;122717;4.2;2.1
32;2021-03-03;11988;1741;261077;124458;4.4;2.1
32;2021-03-04;15095;2450;276172;126908;4.6;2.1
32;2021-03-05;17122;2110;293294;129018;4.9;2.2
32;2021-03-06;28090;1052;321384;130070;5.4;2.2
32;2021-03-07;19862;496;341246;130566;5.7;2.2
32;2021-03-08;8914;2565;350160;133131;5.9;2.2
32;2021-03-09;14281;3318;364441;136449;6.1;2.3
32;2021-03-10;15762;3229;380203;139678;6.4;2.3
32;2021-03-11;20923;4718;401126;144396;6.7;2.4
32;2021-03-12;26059;4250;427185;148646;7.2;2.5
32;2021-03-13;41584;2026;468769;150672;7.9;2.5
32;2021-03-14;20099;588;488868;151260;8.2;2.5
32;2021-03-15;13048;3598;501916;154858;8.4;2.6
32;2021-03-16;9790;3483;511706;158341;8.6;2.7
32;2021-03-17;9712;4134;521418;162475;8.7;2.7
32;2021-03-18;10012;5044;531430;167519;8.9;2.8
32;2021-03-19;17940;3819;549370;171338;9.2;2.9
32;2021-03-20;36490;1974;585860;173312;9.8;2.9
32;2021-03-21;19837;780;605697;174092;10.2;2.9
32;2021-03-22;12147;4289;617844;178381;10.4;3.0
32;2021-03-23;18911;5930;636755;184311;10.7;3.1
32;2021-03-24;17908;6159;654663;190470;11.0;3.2
32;2021-03-25;25281;5718;679944;196188;11.4;3.3
32;2021-03-26;28984;5908;708928;202096;11.9;3.4
32;2021-03-27;36659;2162;745587;204258;12.5;3.4
32;2021-03-28;18637;617;764224;204875;12.8;3.4
32;2021-03-29;14576;7040;778800;211915;13.1;3.6
32;2021-03-30;18860;8661;797660;220576;13.4;3.7
32;2021-03-31;15783;9308;813443;229884;13.6;3.9
32;2021-04-01;18209;11043;831652;240927;13.9;4.0
32;2021-04-02;19948;12564;851600;253491;14.3;4.3
32;2021-04-03;30008;10167;881608;263658;14.8;4.4
32;2021-04-04;11652;4734;893260;268392;15.0;4.5
32;2021-04-05;9587;2329;902847;270721;15.1;4.5
32;2021-04-06;14258;10882;917105;281603;15.4;4.7
32;2021-04-07;18072;12564;935177;294167;15.7;4.9
32;2021-04-08;23490;12959;958667;307126;16.1;5.2
32;2021-04-09;29885;13130;988552;320256;16.6;5.4
32;2021-04-10;26112;18801;1014664;339057;17.0;5.7
32;2021-04-11;9135;12006;1023799;351063;17.2;5.9
32;2021-04-12;15404;9502;1039203;360565;17.4;6.0
32;2021-04-13;21779;11572;1060982;372137;17.8;6.2
32;2021-04-14;22448;11120;1083430;383257;18.2;6.4
32;2021-04-15;25702;11126;1109132;394383;18.6;6.6
32;2021-04-16;25279;12438;1134411;406821;19.0;6.8
32;2021-04-17;17931;22985;1152342;429806;19.3;7.2
32;2021-04-18;6388;14043;1158730;443849;19.4;7.4
32;2021-04-19;11641;9803;1170371;453652;19.6;7.6
32;2021-04-20;16402;12278;1186773;465930;19.9;7.8
32;2021-04-21;15777;12568;1202550;478498;20.2;8.0
32;2021-04-22;19025;14992;1221575;493490;20.5;8.3
32;2021-04-23;19628;15959;1241203;509449;20.8;8.5
32;2021-04-24;15421;21021;1256624;530470;21.1;8.9
32;2021-04-25;6949;12287;1263573;542757;21.2;9.1
32;2021-04-26;13206;10723;1276779;553480;21.4;9.3
32;2021-04-27;18671;14108;1295450;567588;21.7;9.5
32;2021-04-28;20164;16022;1315614;583610;22.1;9.8
32;2021-04-29;22383;19930;1337997;603540;22.4;10.1
32;2021-04-30;24996;21562;1362993;625102;22.9;10.5
32;2021-05-01;23027;13925;1386020;639027;23.2;10.7
32;2021-05-02;20942;10332;1406962;649359;23.6;10.9
32;2021-05-03;21928;11291;1428890;660650;24.0;11.1
32;2021-05-04;23834;16273;1452724;676923;24.4;11.4
32;2021-05-05;23929;17413;1476653;694336;24.8;11.6
32;2021-05-06;25715;19875;1502368;714211;25.2;12.0
32;2021-05-07;30729;21494;1533097;735705;25.7;12.3
32;2021-05-08;34543;9042;1567640;744747;26.3;12.5
32;2021-05-09;26795;6503;1594435;751250;26.7;12.6
32;2021-05-10;24208;16115;1618643;767365;27.1;12.9
32;2021-05-11;31289;19028;1649932;786393;27.7;13.2
32;2021-05-12;37259;18805;1687191;805198;28.3;13.5
32;2021-05-13;40512;7331;1727703;812529;29.0;13.6
32;2021-05-14;41720;14590;1769423;827119;29.7;13.9
32;2021-05-15;59515;12111;1828938;839230;30.7;14.1
32;2021-05-16;47789;4808;1876727;844038;31.5;14.2
32;2021-05-17;31384;10920;1908111;854958;32.0;14.3
32;2021-05-18;36537;12442;1944648;867400;32.6;14.5
32;2021-05-19;38725;11523;1983373;878923;33.3;14.7
32;2021-05-20;39693;14890;2023066;893813;33.9;15.0
32;2021-05-21;42276;16950;2065342;910763;34.6;15.3
32;2021-05-22;57680;13048;2123022;923811;35.6;15.5
32;2021-05-23;38876;4381;2161898;928192;36.3;15.6
32;2021-05-24;28435;3824;2190333;932016;36.7;15.6
32;2021-05-25;31050;14868;2221383;946884;37.3;15.9
32;2021-05-26;33983;16756;2255366;963640;37.8;16.2
32;2021-05-27;34605;20662;2289971;984302;38.4;16.5
32;2021-05-28;34259;25149;2324230;1009451;39.0;16.9
32;2021-05-29;37378;19613;2361608;1029064;39.6;17.3
32;2021-05-30;16089;3511;2377697;1032575;39.9;17.3
32;2021-05-31;27866;16520;2405563;1049095;40.3;17.6
32;2021-06-01;32733;24011;2438296;1073106;40.9;18.0
32;2021-06-02;32187;21673;2470483;1094779;41.4;18.4
32;2021-06-03;34276;25059;2504759;1119838;42.0;18.8
32;2021-06-04;35832;27697;2540591;1147535;42.6;19.2
32;2021-06-05;34322;22767;2574913;1170302;43.2;19.6
32;2021-06-06;16510;5713;2591423;1176015;43.5;19.7
32;2021-06-07;21163;19348;2612586;1195363;43.8;20.0
32;2021-06-08;26250;24333;2638836;1219696;44.3;20.5
32;2021-06-09;24351;24376;2663187;1244072;44.7;20.9
32;2021-06-10;24925;26434;2688112;1270506;45.1;21.3
32;2021-06-11;26315;36048;2714427;1306554;45.5;21.9
32;2021-06-12;25950;31504;2740377;1338058;46.0;22.4
32;2021-06-13;11802;14806;2752179;1352864;46.2;22.7
32;2021-06-14;13209;28038;2765388;1380902;46.4;23.2
32;2021-06-15;19571;34582;2784959;1415484;46.7;23.7
32;2021-06-16;20465;32424;2805424;1447908;47.0;24.3
32;2021-06-17;21378;34931;2826802;1482839;47.4;24.9
32;2021-06-18;21513;42570;2848315;1525409;47.8;25.6
32;2021-06-19;22516;43791;2870831;1569200;48.1;26.3
32;2021-06-20;9211;19100;2880042;1588300;48.3;26.6
32;2021-06-21;11338;34836;2891380;1623136;48.5;27.2
32;2021-06-22;13625;41744;2905005;1664880;48.7;27.9
32;2021-06-23;14198;43487;2919203;1708367;49.0;28.7
32;2021-06-24;15191;45672;2934394;1754039;49.2;29.4
44;2020-12-27;0;0;0;0;0.0;0.0
44;2020-12-28;0;0;0;0;0.0;0.0
44;2020-12-29;0;0;0;0;0.0;0.0
44;2020-12-30;0;0;0;0;0.0;0.0
44;2020-12-31;11;0;11;0;0.0;0.0
44;2021-01-01;1;0;12;0;0.0;0.0
44;2021-01-02;3;0;15;0;0.0;0.0
44;2021-01-03;3;0;18;0;0.0;0.0
44;2021-01-04;243;0;261;0;0.0;0.0
44;2021-01-05;770;0;1031;0;0.0;0.0
44;2021-01-06;1243;2;2274;2;0.0;0.0
44;2021-01-07;2425;4;4699;6;0.1;0.0
44;2021-01-08;3131;8;7830;14;0.1;0.0
44;2021-01-09;943;1;8773;15;0.2;0.0
44;2021-01-10;238;0;9011;15;0.2;0.0
44;2021-01-11;2983;8;11994;23;0.2;0.0
44;2021-01-12;5280;8;17274;31;0.3;0.0
44;2021-01-13;7662;18;24936;49;0.5;0.0
44;2021-01-14;9550;82;34486;131;0.6;0.0
44;2021-01-15;6697;28;41183;159;0.7;0.0
44;2021-01-16;1917;10;43100;169;0.8;0.0
44;2021-01-17;902;1;44002;170;0.8;0.0
44;2021-01-18;8714;26;52716;196;1.0;0.0
44;2021-01-19;10662;17;63378;213;1.1;0.0
44;2021-01-20;11027;44;74405;257;1.3;0.0
44;2021-01-21;11725;27;86130;284;1.6;0.0
44;2021-01-22;9631;30;95761;314;1.7;0.0
44;2021-01-23;3286;20;99047;334;1.8;0.0
44;2021-01-24;1568;5;100615;339;1.8;0.0
44;2021-01-25;6627;303;107242;642;1.9;0.0
44;2021-01-26;5643;435;112885;1077;2.0;0.0
44;2021-01-27;7374;602;120259;1679;2.2;0.0
44;2021-01-28;8820;1251;129079;2930;2.3;0.1
44;2021-01-29;6756;1801;135835;4731;2.5;0.1
44;2021-01-30;2548;496;138383;5227;2.5;0.1
44;2021-01-31;1252;55;139635;5282;2.5;0.1
44;2021-02-01;6381;2382;146016;7664;2.6;0.1
44;2021-02-02;6214;3812;152230;11476;2.8;0.2
44;2021-02-03;5596;4555;157826;16031;2.9;0.3
44;2021-02-04;6441;6970;164267;23001;3.0;0.4
44;2021-02-05;6389;5240;170656;28241;3.1;0.5
44;2021-02-06;1972;1207;172628;29448;3.1;0.5
44;2021-02-07;406;594;173034;30042;3.1;0.5
44;2021-02-08;3822;4471;176856;34513;3.2;0.6
44;2021-02-09;5718;5846;182574;40359;3.3;0.7
44;2021-02-10;6251;6047;188825;46406;3.4;0.8
44;2021-02-11;7059;6572;195884;52978;3.6;1.0
44;2021-02-12;7278;5555;203162;58533;3.7;1.1
44;2021-02-13;2545;1258;205707;59791;3.7;1.1
44;2021-02-14;1612;826;207319;60617;3.8;1.1
44;2021-02-15;3996;7216;211315;67833;3.8;1.2
44;2021-02-16;4564;7986;215879;75819;3.9;1.4
44;2021-02-17;4707;8553;220586;84372;4.0;1.5
44;2021-02-18;6029;9287;226615;93659;4.1;1.7
44;2021-02-19;5543;7513;232158;101172;4.2;1.8
44;2021-02-20;2339;2843;234497;104015;4.3;1.9
44;2021-02-21;541;1401;235038;105416;4.3;1.9
44;2021-02-22;4486;7032;239524;112448;4.3;2.0
44;2021-02-23;6027;7277;245551;119725;4.5;2.2
44;2021-02-24;6602;5950;252153;125675;4.6;2.3
44;2021-02-25;10526;7569;262679;133244;4.8;2.4
44;2021-02-26;12369;6376;275048;139620;5.0;2.5
44;2021-02-27;7888;2163;282936;141783;5.1;2.6
44;2021-02-28;2118;518;285054;142301;5.2;2.6
44;2021-03-01;6080;4675;291134;146976;5.3;2.7
44;2021-03-02;9388;5668;300522;152644;5.5;2.8
44;2021-03-03;11268;5594;311790;158238;5.7;2.9
44;2021-03-04;13261;5788;325051;164026;5.9;3.0
44;2021-03-05;17872;5692;342923;169718;6.2;3.1
44;2021-03-06;21346;2170;364269;171888;6.6;3.1
44;2021-03-07;12201;743;376470;172631;6.8;3.1
44;2021-03-08;9402;4261;385872;176892;7.0;3.2
44;2021-03-09;15186;4973;401058;181865;7.3;3.3
44;2021-03-10;16601;5186;417659;187051;7.6;3.4
44;2021-03-11;20342;5662;438001;192713;7.9;3.5
44;2021-03-12;26788;5519;464789;198232;8.4;3.6
44;2021-03-13;24209;2406;488998;200638;8.9;3.6
44;2021-03-14;6765;877;495763;201515;9.0;3.7
44;2021-03-15;12954;3472;508717;204987;9.2;3.7
44;2021-03-16;12832;3978;521549;208965;9.5;3.8
44;2021-03-17;14188;3636;535737;212601;9.7;3.9
44;2021-03-18;15406;3766;551143;216367;10.0;3.9
44;2021-03-19;21405;3893;572548;220260;10.4;4.0
44;2021-03-20;15558;1951;588106;222211;10.7;4.0
44;2021-03-21;4618;286;592724;222497;10.8;4.0
44;2021-03-22;12519;3916;605243;226413;11.0;4.1
44;2021-03-23;19434;5075;624677;231488;11.3;4.2
44;2021-03-24;22042;5190;646719;236678;11.7;4.3
44;2021-03-25;28185;5767;674904;242445;12.2;4.4
44;2021-03-26;30335;5484;705239;247929;12.8;4.5
44;2021-03-27;16222;4693;721461;252622;13.1;4.6
44;2021-03-28;4078;1976;725539;254598;13.2;4.6
44;2021-03-29;14304;6117;739843;260715;13.4;4.7
44;2021-03-30;21395;7827;761238;268542;13.8;4.9
44;2021-03-31;20108;8007;781346;276549;14.2;5.0
44;2021-04-01;23537;9334;804883;285883;14.6;5.2
44;2021-04-02;16226;6892;821109;292775;14.9;5.3
44;2021-04-03;10184;5762;831293;298537;15.1;5.4
44;2021-04-04;3133;1652;834426;300189;15.1;5.4
44;2021-04-05;4423;1414;838849;301603;15.2;5.5
44;2021-04-06;13409;10552;852258;312155;15.5;5.7
44;2021-04-07;17642;12108;869900;324263;15.8;5.9
44;2021-04-08;26006;12398;895906;336661;16.3;6.1
44;2021-04-09;32200;12738;928106;349399;16.8;6.3
44;2021-04-10;18238;10053;946344;359452;17.2;6.5
44;2021-04-11;3028;5967;949372;365419;17.2;6.6
44;2021-04-12;16950;11237;966322;376656;17.5;6.8
44;2021-04-13;21969;13768;988291;390424;17.9;7.1
44;2021-04-14;23091;14048;1011382;404472;18.3;7.3
44;2021-04-15;26258;15354;1037640;419826;18.8;7.6
44;2021-04-16;28077;15198;1065717;435024;19.3;7.9
44;2021-04-17;19801;9030;1085518;444054;19.7;8.1
44;2021-04-18;5049;4629;1090567;448683;19.8;8.1
44;2021-04-19;16923;11742;1107490;460425;20.1;8.4
44;2021-04-20;19099;14293;1126589;474718;20.4;8.6
44;2021-04-21;21116;14943;1147705;489661;20.8;8.9
44;2021-04-22;23687;15866;1171392;505527;21.3;9.2
44;2021-04-23;27781;16553;1199173;522080;21.8;9.5
44;2021-04-24;16962;9149;1216135;531229;22.1;9.6
44;2021-04-25;4819;3559;1220954;534788;22.2;9.7
44;2021-04-26;16691;12008;1237645;546796;22.5;9.9
44;2021-04-27;21143;14613;1258788;561409;22.8;10.2
44;2021-04-28;23762;14784;1282550;576193;23.3;10.5
44;2021-04-29;28118;16926;1310668;593119;23.8;10.8
44;2021-04-30;33094;15991;1343762;609110;24.4;11.1
44;2021-05-01;14843;7008;1358605;616118;24.6;11.2
44;2021-05-02;7896;3989;1366501;620107;24.8;11.3
44;2021-05-03;23996;12351;1390497;632458;25.2;11.5
44;2021-05-04;26956;17250;1417453;649708;25.7;11.8
44;2021-05-05;30790;19124;1448243;668832;26.3;12.1
44;2021-05-06;37966;21051;1486209;689883;27.0;12.5
44;2021-05-07;36106;24768;1522315;714651;27.6;13.0
44;2021-05-08;19545;6681;1541860;721332;28.0;13.1
44;2021-05-09;11299;2898;1553159;724230;28.2;13.1
44;2021-05-10;24467;20742;1577626;744972;28.6;13.5
44;2021-05-11;34404;22885;1612030;767857;29.2;13.9
44;2021-05-12;37086;23971;1649116;791828;29.9;14.4
44;2021-05-13;27865;6352;1676981;798180;30.4;14.5
44;2021-05-14;44112;18822;1721093;817002;31.2;14.8
44;2021-05-15;33934;14044;1755027;831046;31.8;15.1
44;2021-05-16;15544;3487;1770571;834533;32.1;15.1
44;2021-05-17;27098;14484;1797669;849017;32.6;15.4
44;2021-05-18;35019;15223;1832688;864240;33.3;15.7
44;2021-05-19;36786;16305;1869474;880545;33.9;16.0
44;2021-05-20;40748;16398;1910222;896943;34.7;16.3
44;2021-05-21;42722;20843;1952944;917786;35.4;16.7
44;2021-05-22;27643;11531;1980587;929317;35.9;16.9
44;2021-05-23;8651;1711;1989238;931028;36.1;16.9
44;2021-05-24;17874;4640;2007112;935668;36.4;17.0
44;2021-05-25;30157;17569;2037269;953237;37.0;17.3
44;2021-05-26;32309;19467;2069578;972704;37.5;17.6
44;2021-05-27;34490;20779;2104068;993483;38.2;18.0
44;2021-05-28;37435;27771;2141503;1021254;38.9;18.5
44;2021-05-29;26741;20103;2168244;1041357;39.3;18.9
44;2021-05-30;6117;4207;2174361;1045564;39.4;19.0
44;2021-05-31;26957;19665;2201318;1065229;39.9;19.3
44;2021-06-01;31470;22856;2232788;1088085;40.5;19.7
44;2021-06-02;33496;22875;2266284;1110960;41.1;20.2
44;2021-06-03;34505;25248;2300789;1136208;41.7;20.6
44;2021-06-04;39885;32144;2340674;1168352;42.5;21.2
44;2021-06-05;23027;20079;2363701;1188431;42.9;21.6
44;2021-06-06;8299;4450;2372000;1192881;43.0;21.6
44;2021-06-07;28074;22046;2400074;1214927;43.5;22.0
44;2021-06-08;32977;26629;2433051;1241556;44.1;22.5
44;2021-06-09;35585;24840;2468636;1266396;44.8;23.0
44;2021-06-10;34514;25554;2503150;1291950;45.4;23.4
44;2021-06-11;32310;35350;2535460;1327300;46.0;24.1
44;2021-06-12;25667;23420;2561127;1350720;46.5;24.5
44;2021-06-13;6762;6055;2567889;1356775;46.6;24.6
44;2021-06-14;17570;29544;2585459;1386319;46.9;25.2
44;2021-06-15;23520;34922;2608979;1421241;47.3;25.8
44;2021-06-16;24236;36542;2633215;1457783;47.8;26.4
44;2021-06-17;23680;39158;2656895;1496941;48.2;27.2
44;2021-06-18;26297;42904;2683192;1539845;48.7;27.9
44;2021-06-19;20949;28150;2704141;1567995;49.1;28.4
44;2021-06-20;3669;6643;2707810;1574638;49.1;28.6
44;2021-06-21;14700;34007;2722510;1608645;49.4;29.2
44;2021-06-22;15317;41512;2737827;1650157;49.7;29.9
44;2021-06-23;19873;41256;2757700;1691413;50.0;30.7
44;2021-06-24;16310;34128;2774010;1725541;50.3;31.3
52;2020-12-27;0;0;0;0;0.0;0.0
52;2020-12-28;1;0;1;0;0.0;0.0
52;2020-12-29;0;0;1;0;0.0;0.0
52;2020-12-30;0;0;1;0;0.0;0.0
52;2020-12-31;0;0;1;0;0.0;0.0
52;2021-01-01;5;0;6;0;0.0;0.0
52;2021-01-02;1;0;7;0;0.0;0.0
52;2021-01-03;1;0;8;0;0.0;0.0
52;2021-01-04;34;0;42;0;0.0;0.0
52;2021-01-05;168;0;210;0;0.0;0.0
52;2021-01-06;384;1;594;1;0.0;0.0
52;2021-01-07;963;0;1557;1;0.0;0.0
52;2021-01-08;1664;3;3221;4;0.1;0.0
52;2021-01-09;1049;2;4270;6;0.1;0.0
52;2021-01-10;643;1;4913;7;0.1;0.0
52;2021-01-11;2197;0;7110;7;0.2;0.0
52;2021-01-12;3168;4;10278;11;0.3;0.0
52;2021-01-13;2983;4;13261;15;0.3;0.0
52;2021-01-14;3303;25;16564;40;0.4;0.0
52;2021-01-15;3015;9;19579;49;0.5;0.0
52;2021-01-16;894;7;20473;56;0.5;0.0
52;2021-01-17;499;3;20972;59;0.6;0.0
52;2021-01-18;3200;6;24172;65;0.6;0.0
52;2021-01-19;6553;9;30725;74;0.8;0.0
52;2021-01-20;8332;12;39057;86;1.0;0.0
52;2021-01-21;12168;11;51225;97;1.3;0.0
52;2021-01-22;7273;30;58498;127;1.5;0.0
52;2021-01-23;1677;5;60175;132;1.6;0.0
52;2021-01-24;174;0;60349;132;1.6;0.0
52;2021-01-25;3006;13;63355;145;1.7;0.0
52;2021-01-26;6737;154;70092;299;1.8;0.0
52;2021-01-27;7284;151;77376;450;2.0;0.0
52;2021-01-28;9728;469;87104;919;2.3;0.0
52;2021-01-29;5957;910;93061;1829;2.4;0.0
52;2021-01-30;1258;271;94319;2100;2.5;0.1
52;2021-01-31;79;314;94398;2414;2.5;0.1
52;2021-02-01;2521;1191;96919;3605;2.5;0.1
52;2021-02-02;2970;1859;99889;5464;2.6;0.1
52;2021-02-03;2686;2161;102575;7625;2.7;0.2
52;2021-02-04;2962;2117;105537;9742;2.8;0.3
52;2021-02-05;2965;2206;108502;11948;2.9;0.3
52;2021-02-06;1075;662;109577;12610;2.9;0.3
52;2021-02-07;151;297;109728;12907;2.9;0.3
52;2021-02-08;1929;2119;111657;15026;2.9;0.4
52;2021-02-09;3174;3719;114831;18745;3.0;0.5
52;2021-02-10;3318;4763;118149;23508;3.1;0.6
52;2021-02-11;6099;9304;124248;32812;3.3;0.9
52;2021-02-12;4704;5147;128952;37959;3.4;1.0
52;2021-02-13;1150;1243;130102;39202;3.4;1.0
52;2021-02-14;22;541;130124;39743;3.4;1.0
52;2021-02-15;2030;3535;132154;43278;3.5;1.1
52;2021-02-16;4111;6758;136265;50036;3.6;1.3
52;2021-02-17;3874;6952;140139;56988;3.7;1.5
52;2021-02-18;6138;9296;146277;66284;3.8;1.7
52;2021-02-19;5330;5833;151607;72117;4.0;1.9
52;2021-02-20;1028;1476;152635;73593;4.0;1.9
52;2021-02-21;6;274;152641;73867;4.0;1.9
52;2021-02-22;2645;3494;155286;77361;4.1;2.0
52;2021-02-23;3424;3701;158710;81062;4.2;2.1
52;2021-02-24;3304;3040;162014;84102;4.3;2.2
52;2021-02-25;6344;3217;168358;87319;4.4;2.3
52;2021-02-26;6213;2929;174571;90248;4.6;2.4
52;2021-02-27;2216;1047;176787;91295;4.7;2.4
52;2021-02-28;76;88;176863;91383;4.7;2.4
52;2021-03-01;3113;2332;179976;93715;4.7;2.5
52;2021-03-02;4723;3438;184699;97153;4.9;2.6
52;2021-03-03;5277;3413;189976;100566;5.0;2.6
52;2021-03-04;7788;4779;197764;105345;5.2;2.8
52;2021-03-05;9005;3936;206769;109281;5.4;2.9
52;2021-03-06;5636;1155;212405;110436;5.6;2.9
52;2021-03-07;2661;136;215066;110572;5.7;2.9
52;2021-03-08;5841;2426;220907;112998;5.8;3.0
52;2021-03-09;9545;3337;230452;116335;6.1;3.1
52;2021-03-10;9387;3402;239839;119737;6.3;3.1
52;2021-03-11;13573;5057;253412;124794;6.7;3.3
52;2021-03-12;15328;3753;268740;128547;7.1;3.4
52;2021-03-13;8285;763;277025;129310;7.3;3.4
52;2021-03-14;624;72;277649;129382;7.3;3.4
52;2021-03-15;8834;1915;286483;131297;7.5;3.5
52;2021-03-16;7573;2619;294056;133916;7.7;3.5
52;2021-03-17;6457;2385;300513;136301;7.9;3.6
52;2021-03-18;8300;2516;308813;138817;8.1;3.7
52;2021-03-19;11886;2133;320699;140950;8.4;3.7
52;2021-03-20;7085;763;327784;141713;8.6;3.7
52;2021-03-21;1689;47;329473;141760;8.7;3.7
52;2021-03-22;9013;2008;338486;143768;8.9;3.8
52;2021-03-23;13179;2599;351665;146367;9.2;3.8
52;2021-03-24;13256;2044;364921;148411;9.6;3.9
52;2021-03-25;18191;2814;383112;151225;10.1;4.0
52;2021-03-26;18926;2375;402038;153600;10.6;4.0
52;2021-03-27;7553;653;409591;154253;10.8;4.1
52;2021-03-28;2193;67;411784;154320;10.8;4.1
52;2021-03-29;10965;2724;422749;157044;11.1;4.1
52;2021-03-30;15673;3606;438422;160650;11.5;4.2
52;2021-03-31;13686;3284;452108;163934;11.9;4.3
52;2021-04-01;18869;3691;470977;167625;12.4;4.4
52;2021-04-02;17076;3510;488053;171135;12.8;4.5
52;2021-04-03;5515;1193;493568;172328;13.0;4.5
52;2021-04-04;1324;51;494892;172379;13.0;4.5
52;2021-04-05;1781;537;496673;172916;13.1;4.5
52;2021-04-06;11780;5252;508453;178168;13.4;4.7
52;2021-04-07;15186;5699;523639;183867;13.8;4.8
52;2021-04-08;21206;6390;544845;190257;14.3;5.0
52;2021-04-09;26610;5303;571455;195560;15.0;5.1
52;2021-04-10;10111;2363;581566;197923;15.3;5.2
52;2021-04-11;2567;434;584133;198357;15.4;5.2
52;2021-04-12;16328;6585;600461;204942;15.8;5.4
52;2021-04-13;20725;8170;621186;213112;16.3;5.6
52;2021-04-14;17639;6923;638825;220035;16.8;5.8
52;2021-04-15;21146;8030;659971;228065;17.4;6.0
52;2021-04-16;22580;7468;682551;235533;18.0;6.2
52;2021-04-17;9968;3032;692519;238565;18.2;6.3
52;2021-04-18;3036;1304;695555;239869;18.3;6.3
52;2021-04-19;14170;7815;709725;247684;18.7;6.5
52;2021-04-20;18258;9391;727983;257075;19.1;6.8
52;2021-04-21;15971;9162;743954;266237;19.6;7.0
52;2021-04-22;19408;10161;763362;276398;20.1;7.3
52;2021-04-23;20505;9972;783867;286370;20.6;7.5
52;2021-04-24;10011;4979;793878;291349;20.9;7.7
52;2021-04-25;3979;1951;797857;293300;21.0;7.7
52;2021-04-26;16819;9903;814676;303203;21.4;8.0
52;2021-04-27;21062;12556;835738;315759;22.0;8.3
52;2021-04-28;22752;10659;858490;326418;22.6;8.6
52;2021-04-29;25000;12671;883490;339089;23.2;8.9
52;2021-04-30;25631;12484;909121;351573;23.9;9.2
52;2021-05-01;8614;2475;917735;354048;24.1;9.3
52;2021-05-02;4298;1271;922033;355319;24.3;9.3
52;2021-05-03;19060;10621;941093;365940;24.8;9.6
52;2021-05-04;20063;14383;961156;380323;25.3;10.0
52;2021-05-05;20853;12759;982009;393082;25.8;10.3
52;2021-05-06;22466;13836;1004475;406918;26.4;10.7
52;2021-05-07;20686;18022;1025161;424940;27.0;11.2
52;2021-05-08;11221;2083;1036382;427023;27.3;11.2
52;2021-05-09;5395;2226;1041777;429249;27.4;11.3
52;2021-05-10;20766;17282;1062543;446531;27.9;11.7
52;2021-05-11;24845;19549;1087388;466080;28.6;12.3
52;2021-05-12;24770;17105;1112158;483185;29.3;12.7
52;2021-05-13;18574;2741;1130732;485926;29.7;12.8
52;2021-05-14;22726;12417;1153458;498343;30.3;13.1
52;2021-05-15;15628;5186;1169086;503529;30.8;13.2
52;2021-05-16;10280;1147;1179366;504676;31.0;13.3
52;2021-05-17;21088;14648;1200454;519324;31.6;13.7
52;2021-05-18;24689;14975;1225143;534299;32.2;14.1
52;2021-05-19;26704;11423;1251847;545722;32.9;14.4
52;2021-05-20;29255;11999;1281102;557721;33.7;14.7
52;2021-05-21;27317;13830;1308419;571551;34.4;15.0
52;2021-05-22;15408;4703;1323827;576254;34.8;15.2
52;2021-05-23;4469;1141;1328296;577395;34.9;15.2
52;2021-05-24;15992;2753;1344288;580148;35.4;15.3
52;2021-05-25;24419;14527;1368707;594675;36.0;15.6
52;2021-05-26;25139;12651;1393846;607326;36.7;16.0
52;2021-05-27;29057;14811;1422903;622137;37.4;16.4
52;2021-05-28;27896;17856;1450799;639993;38.2;16.8
52;2021-05-29;18313;7770;1469112;647763;38.6;17.0
52;2021-05-30;4228;1717;1473340;649480;38.8;17.1
52;2021-05-31;24397;15863;1497737;665343;39.4;17.5
52;2021-06-01;28801;17805;1526538;683148;40.2;18.0
52;2021-06-02;27420;15212;1553958;698360;40.9;18.4
52;2021-06-03;31704;16273;1585662;714633;41.7;18.8
52;2021-06-04;29202;20723;1614864;735356;42.5;19.3
52;2021-06-05;14532;11796;1629396;747152;42.9;19.7
52;2021-06-06;4775;3531;1634171;750683;43.0;19.7
52;2021-06-07;21694;20873;1655865;771556;43.6;20.3
52;2021-06-08;26421;22025;1682286;793581;44.2;20.9
52;2021-06-09;25643;18611;1707929;812192;44.9;21.4
52;2021-06-10;28701;17582;1736630;829774;45.7;21.8
52;2021-06-11;26955;24308;1763585;854082;46.4;22.5
52;2021-06-12;14590;11841;1778175;865923;46.8;22.8
52;2021-06-13;4379;4516;1782554;870439;46.9;22.9
52;2021-06-14;17588;25385;1800142;895824;47.3;23.6
52;2021-06-15;23683;25321;1823825;921145;48.0;24.2
52;2021-06-16;23270;22460;1847095;943605;48.6;24.8
52;2021-06-17;25904;23071;1872999;966676;49.3;25.4
52;2021-06-18;23228;28707;1896227;995383;49.9;26.2
52;2021-06-19;12433;14240;1908660;1009623;50.2;26.6
52;2021-06-20;3013;4417;1911673;1014040;50.3;26.7
52;2021-06-21;14806;28869;1926479;1042909;50.7;27.4
52;2021-06-22;17367;31769;1943846;1074678;51.1;28.3
52;2021-06-23;18387;26976;1962233;1101654;51.6;29.0
52;2021-06-24;20910;24030;1983143;1125684;52.2;29.6
53;2020-12-27;0;0;0;0;0.0;0.0
53;2020-12-28;0;0;0;0;0.0;0.0
53;2020-12-29;0;0;0;0;0.0;0.0
53;2020-12-30;0;0;0;0;0.0;0.0
53;2020-12-31;0;0;0;0;0.0;0.0
53;2021-01-01;3;0;3;0;0.0;0.0
53;2021-01-02;4;0;7;0;0.0;0.0
53;2021-01-03;0;0;7;0;0.0;0.0
53;2021-01-04;43;0;50;0;0.0;0.0
53;2021-01-05;200;0;250;0;0.0;0.0
53;2021-01-06;331;1;581;1;0.0;0.0
53;2021-01-07;835;1;1416;2;0.0;0.0
53;2021-01-08;1213;0;2629;2;0.1;0.0
53;2021-01-09;34;0;2663;2;0.1;0.0
53;2021-01-10;4;0;2667;2;0.1;0.0
53;2021-01-11;1661;3;4328;5;0.1;0.0
53;2021-01-12;3380;1;7708;6;0.2;0.0
53;2021-01-13;3355;4;11063;10;0.3;0.0
53;2021-01-14;3813;30;14876;40;0.4;0.0
53;2021-01-15;3297;17;18173;57;0.5;0.0
53;2021-01-16;684;4;18857;61;0.6;0.0
53;2021-01-17;180;1;19037;62;0.6;0.0
53;2021-01-18;3361;7;22398;69;0.7;0.0
53;2021-01-19;8176;5;30574;74;0.9;0.0
53;2021-01-20;7058;4;37632;78;1.1;0.0
53;2021-01-21;11478;7;49110;85;1.5;0.0
53;2021-01-22;7812;13;56922;98;1.7;0.0
53;2021-01-23;1492;2;58414;100;1.7;0.0
53;2021-01-24;255;1;58669;101;1.8;0.0
53;2021-01-25;3056;35;61725;136;1.8;0.0
53;2021-01-26;4111;232;65836;368;2.0;0.0
53;2021-01-27;7238;326;73074;694;2.2;0.0
53;2021-01-28;7134;641;80208;1335;2.4;0.0
53;2021-01-29;4230;730;84438;2065;2.5;0.1
53;2021-01-30;844;43;85282;2108;2.6;0.1
53;2021-01-31;79;3;85361;2111;2.6;0.1
53;2021-02-01;2210;1027;87571;3138;2.6;0.1
53;2021-02-02;3437;2017;91008;5155;2.7;0.2
53;2021-02-03;3175;2184;94183;7339;2.8;0.2
53;2021-02-04;7095;2270;101278;9609;3.0;0.3
53;2021-02-05;5584;2136;106862;11745;3.2;0.4
53;2021-02-06;1201;277;108063;12022;3.2;0.4
53;2021-02-07;214;132;108277;12154;3.2;0.4
53;2021-02-08;1651;1532;109928;13686;3.3;0.4
53;2021-02-09;3975;5259;113903;18945;3.4;0.6
53;2021-02-10;3791;4650;117694;23595;3.5;0.7
53;2021-02-11;5733;8794;123427;32389;3.7;1.0
53;2021-02-12;5661;5252;129088;37641;3.9;1.1
53;2021-02-13;1232;852;130320;38493;3.9;1.2
53;2021-02-14;25;348;130345;38841;3.9;1.2
53;2021-02-15;2325;3585;132670;42426;4.0;1.3
53;2021-02-16;4053;3545;136723;45971;4.1;1.4
53;2021-02-17;4073;5375;140796;51346;4.2;1.5
53;2021-02-18;5948;5745;146744;57091;4.4;1.7
53;2021-02-19;5355;4854;152099;61945;4.6;1.9
53;2021-02-20;1189;893;153288;62838;4.6;1.9
53;2021-02-21;166;218;153454;63056;4.6;1.9
53;2021-02-22;2318;2834;155772;65890;4.7;2.0
53;2021-02-23;3947;3674;159719;69564;4.8;2.1
53;2021-02-24;4468;3785;164187;73349;4.9;2.2
53;2021-02-25;7947;7145;172134;80494;5.2;2.4
53;2021-02-26;8677;4412;180811;84906;5.4;2.5
53;2021-02-27;3448;1106;184259;86012;5.5;2.6
53;2021-02-28;228;194;184487;86206;5.5;2.6
53;2021-03-01;3479;2265;187966;88471;5.6;2.6
53;2021-03-02;5617;4461;193583;92932;5.8;2.8
53;2021-03-03;6441;3793;200024;96725;6.0;2.9
53;2021-03-04;9280;4925;209304;101650;6.3;3.0
53;2021-03-05;11910;5219;221214;106869;6.6;3.2
53;2021-03-06;5630;1021;226844;107890;6.8;3.2
53;2021-03-07;913;145;227757;108035;6.8;3.2
53;2021-03-08;5163;2213;232920;110248;7.0;3.3
53;2021-03-09;9663;2935;242583;113183;7.3;3.4
53;2021-03-10;9276;3376;251859;116559;7.5;3.5
53;2021-03-11;14302;4049;266161;120608;8.0;3.6
53;2021-03-12;18600;3253;284761;123861;8.5;3.7
53;2021-03-13;8802;947;293563;124808;8.8;3.7
53;2021-03-14;812;50;294375;124858;8.8;3.7
53;2021-03-15;6891;2031;301266;126889;9.0;3.8
53;2021-03-16;6983;3408;308249;130297;9.2;3.9
53;2021-03-17;8226;2828;316475;133125;9.5;4.0
53;2021-03-18;8715;4657;325190;137782;9.7;4.1
53;2021-03-19;12990;3648;338180;141430;10.1;4.2
53;2021-03-20;7129;817;345309;142247;10.3;4.3
53;2021-03-21;383;32;345692;142279;10.3;4.3
53;2021-03-22;7345;2165;353037;144444;10.6;4.3
53;2021-03-23;12987;3666;366024;148110;11.0;4.4
53;2021-03-24;14388;3240;380412;151350;11.4;4.5
53;2021-03-25;18276;3369;398688;154719;11.9;4.6
53;2021-03-26;20306;3205;418994;157924;12.5;4.7
53;2021-03-27;7403;1014;426397;158938;12.8;4.8
53;2021-03-28;527;86;426924;159024;12.8;4.8
53;2021-03-29;9797;3167;436721;162191;13.1;4.9
53;2021-03-30;15306;4598;452027;166789;13.5;5.0
53;2021-03-31;14137;4265;466164;171054;14.0;5.1
53;2021-04-01;18187;4272;484351;175326;14.5;5.2
53;2021-04-02;17874;4352;502225;179678;15.0;5.4
53;2021-04-03;6428;1427;508653;181105;15.2;5.4
53;2021-04-04;413;33;509066;181138;15.2;5.4
53;2021-04-05;1228;336;510294;181474;15.3;5.4
53;2021-04-06;12522;5675;522816;187149;15.7;5.6
53;2021-04-07;15012;5333;537828;192482;16.1;5.8
53;2021-04-08;20661;6095;558489;198577;16.7;5.9
53;2021-04-09;26622;5570;585111;204147;17.5;6.1
53;2021-04-10;10328;1724;595439;205871;17.8;6.2
53;2021-04-11;816;213;596255;206084;17.8;6.2
53;2021-04-12;15823;4911;612078;210995;18.3;6.3
53;2021-04-13;22687;7251;634765;218246;19.0;6.5
53;2021-04-14;19340;7923;654105;226169;19.6;6.8
53;2021-04-15;25340;8058;679445;234227;20.3;7.0
53;2021-04-16;26168;7542;705613;241769;21.1;7.2
53;2021-04-17;10384;3581;715997;245350;21.4;7.3
53;2021-04-18;1033;148;717030;245498;21.5;7.3
53;2021-04-19;15399;6535;732429;252033;21.9;7.5
53;2021-04-20;16919;9515;749348;261548;22.4;7.8
53;2021-04-21;16741;9441;766089;270989;22.9;8.1
53;2021-04-22;21737;10182;787826;281171;23.6;8.4
53;2021-04-23;21634;10081;809460;291252;24.2;8.7
53;2021-04-24;9983;4166;819443;295418;24.5;8.8
53;2021-04-25;905;332;820348;295750;24.6;8.9
53;2021-04-26;18217;8477;838565;304227;25.1;9.1
53;2021-04-27;19851;12064;858416;316291;25.7;9.5
53;2021-04-28;19941;10813;878357;327104;26.3;9.8
53;2021-04-29;23539;12279;901896;339383;27.0;10.2
53;2021-04-30;23892;12438;925788;351821;27.7;10.5
53;2021-05-01;5121;1631;930909;353452;27.9;10.6
53;2021-05-02;2793;520;933702;353972;28.0;10.6
53;2021-05-03;15710;9380;949412;363352;28.4;10.9
53;2021-05-04;15688;15791;965100;379143;28.9;11.4
53;2021-05-05;14935;14692;980035;393835;29.3;11.8
53;2021-05-06;19252;17843;999287;411678;29.9;12.3
53;2021-05-07;18634;18220;1017921;429898;30.5;12.9
53;2021-05-08;5485;1120;1023406;431018;30.6;12.9
53;2021-05-09;3511;860;1026917;431878;30.7;12.9
53;2021-05-10;16675;15223;1043592;447101;31.2;13.4
53;2021-05-11;18662;18736;1062254;465837;31.8;13.9
53;2021-05-12;21188;15639;1083442;481476;32.4;14.4
53;2021-05-13;9023;3954;1092465;485430;32.7;14.5
53;2021-05-14;21684;13738;1114149;499168;33.4;14.9
53;2021-05-15;13390;5332;1127539;504500;33.8;15.1
53;2021-05-16;3218;875;1130757;505375;33.9;15.1
53;2021-05-17;18112;11170;1148869;516545;34.4;15.5
53;2021-05-18;20884;12395;1169753;528940;35.0;15.8
53;2021-05-19;21552;10629;1191305;539569;35.7;16.2
53;2021-05-20;23817;14720;1215122;554289;36.4;16.6
53;2021-05-21;22823;15236;1237945;569525;37.1;17.0
53;2021-05-22;13139;5837;1251084;575362;37.5;17.2
53;2021-05-23;2976;310;1254060;575672;37.5;17.2
53;2021-05-24;13936;2499;1267996;578171;38.0;17.3
53;2021-05-25;19919;12819;1287915;590990;38.6;17.7
53;2021-05-26;19251;13792;1307166;604782;39.1;18.1
53;2021-05-27;22038;17412;1329204;622194;39.8;18.6
53;2021-05-28;21746;20405;1350950;642599;40.4;19.2
53;2021-05-29;12135;7337;1363085;649936;40.8;19.5
53;2021-05-30;2306;472;1365391;650408;40.9;19.5
53;2021-05-31;20668;14088;1386059;664496;41.5;19.9
53;2021-06-01;22914;16476;1408973;680972;42.2;20.4
53;2021-06-02;21759;14228;1430732;695200;42.8;20.8
53;2021-06-03;25022;16854;1455754;712054;43.6;21.3
53;2021-06-04;23057;22562;1478811;734616;44.3;22.0
53;2021-06-05;17295;8996;1496106;743612;44.8;22.3
53;2021-06-06;4997;1324;1501103;744936;44.9;22.3
53;2021-06-07;18372;17788;1519475;762724;45.5;22.8
53;2021-06-08;23340;18041;1542815;780765;46.2;23.4
53;2021-06-09;23603;15872;1566418;796637;46.9;23.8
53;2021-06-10;26733;16868;1593151;813505;47.7;24.4
53;2021-06-11;26181;21427;1619332;834932;48.5;25.0
53;2021-06-12;18596;7507;1637928;842439;49.0;25.2
53;2021-06-13;7793;3119;1645721;845558;49.3;25.3
53;2021-06-14;16022;19800;1661743;865358;49.7;25.9
53;2021-06-15;20046;20946;1681789;886304;50.3;26.5
53;2021-06-16;21166;18532;1702955;904836;51.0;27.1
53;2021-06-17;21874;20090;1724829;924926;51.6;27.7
53;2021-06-18;22216;25644;1747045;950570;52.3;28.5
53;2021-06-19;12828;9604;1759873;960174;52.7;28.7
53;2021-06-20;5452;2679;1765325;962853;52.8;28.8
53;2021-06-21;14574;22348;1779899;985201;53.3;29.5
53;2021-06-22;16958;24910;1796857;1010111;53.8;30.2
53;2021-06-23;16605;23502;1813462;1033613;54.3;30.9
53;2021-06-24;18914;21807;1832376;1055420;54.9;31.6
75;2020-12-27;1;0;1;0;0.0;0.0
75;2020-12-28;2;0;3;0;0.0;0.0
75;2020-12-29;3;0;6;0;0.0;0.0
75;2020-12-30;2;0;8;0;0.0;0.0
75;2020-12-31;0;0;8;0;0.0;0.0
75;2021-01-01;4;0;12;0;0.0;0.0
75;2021-01-02;2;0;14;0;0.0;0.0
75;2021-01-03;0;0;14;0;0.0;0.0
75;2021-01-04;90;0;104;0;0.0;0.0
75;2021-01-05;124;0;228;0;0.0;0.0
75;2021-01-06;736;1;964;1;0.0;0.0
75;2021-01-07;4923;2;5887;3;0.1;0.0
75;2021-01-08;5468;5;11355;8;0.2;0.0
75;2021-01-09;845;1;12200;9;0.2;0.0
75;2021-01-10;479;0;12679;9;0.2;0.0
75;2021-01-11;3585;1;16264;10;0.3;0.0
75;2021-01-12;5949;6;22213;16;0.4;0.0
75;2021-01-13;6551;15;28764;31;0.5;0.0
75;2021-01-14;8123;63;36887;94;0.6;0.0
75;2021-01-15;7628;32;44515;126;0.7;0.0
75;2021-01-16;1607;14;46122;140;0.8;0.0
75;2021-01-17;425;5;46547;145;0.8;0.0
75;2021-01-18;6888;31;53435;176;0.9;0.0
75;2021-01-19;14049;14;67484;190;1.1;0.0
75;2021-01-20;15535;26;83019;216;1.4;0.0
75;2021-01-21;16962;19;99981;235;1.7;0.0
75;2021-01-22;12971;23;112952;258;1.9;0.0
75;2021-01-23;4421;3;117373;261;2.0;0.0
75;2021-01-24;700;1;118073;262;2.0;0.0
75;2021-01-25;8869;218;126942;480;2.1;0.0
75;2021-01-26;11721;453;138663;933;2.3;0.0
75;2021-01-27;12279;770;150942;1703;2.5;0.0
75;2021-01-28;12940;2659;163882;4362;2.7;0.1
75;2021-01-29;10000;2986;173882;7348;2.9;0.1
75;2021-01-30;3379;516;177261;7864;3.0;0.1
75;2021-01-31;646;420;177907;8284;3.0;0.1
75;2021-02-01;5716;2640;183623;10924;3.1;0.2
75;2021-02-02;9610;4357;193233;15281;3.2;0.3
75;2021-02-03;9595;4373;202828;19654;3.4;0.3
75;2021-02-04;10762;5683;213590;25337;3.6;0.4
75;2021-02-05;7488;5637;221078;30974;3.7;0.5
75;2021-02-06;2378;1106;223456;32080;3.7;0.5
75;2021-02-07;673;252;224129;32332;3.7;0.5
75;2021-02-08;5135;3653;229264;35985;3.8;0.6
75;2021-02-09;7315;8081;236579;44066;3.9;0.7
75;2021-02-10;7542;8740;244121;52806;4.1;0.9
75;2021-02-11;8858;10273;252979;63079;4.2;1.1
75;2021-02-12;7404;8837;260383;71916;4.3;1.2
75;2021-02-13;1953;1760;262336;73676;4.4;1.2
75;2021-02-14;274;364;262610;74040;4.4;1.2
75;2021-02-15;3152;7839;265762;81879;4.4;1.4
75;2021-02-16;4608;10531;270370;92410;4.5;1.5
75;2021-02-17;4758;11305;275128;103715;4.6;1.7
75;2021-02-18;5451;12843;280579;116558;4.7;1.9
75;2021-02-19;5419;9636;285998;126194;4.8;2.1
75;2021-02-20;988;2633;286986;128827;4.8;2.1
75;2021-02-21;187;667;287173;129494;4.8;2.2
75;2021-02-22;3649;8517;290822;138011;4.8;2.3
75;2021-02-23;5354;10955;296176;148966;4.9;2.5
75;2021-02-24;6129;10289;302305;159255;5.0;2.7
75;2021-02-25;10043;11723;312348;170978;5.2;2.8
75;2021-02-26;12265;8870;324613;179848;5.4;3.0
75;2021-02-27;5784;2488;330397;182336;5.5;3.0
75;2021-02-28;312;694;330709;183030;5.5;3.1
75;2021-03-01;5091;7017;335800;190047;5.6;3.2
75;2021-03-02;9350;8172;345150;198219;5.8;3.3
75;2021-03-03;10820;7771;355970;205990;5.9;3.4
75;2021-03-04;16735;8175;372705;214165;6.2;3.6
75;2021-03-05;20800;7479;393505;221644;6.6;3.7
75;2021-03-06;13408;2236;406913;223880;6.8;3.7
75;2021-03-07;3721;468;410634;224348;6.8;3.7
75;2021-03-08;9989;5390;420623;229738;7.0;3.8
75;2021-03-09;16852;6490;437475;236228;7.3;3.9
75;2021-03-10;18254;6314;455729;242542;7.6;4.0
75;2021-03-11;26434;6687;482163;249229;8.0;4.2
75;2021-03-12;31299;5263;513462;254492;8.6;4.2
75;2021-03-13;17858;1202;531320;255694;8.9;4.3
75;2021-03-14;1702;248;533022;255942;8.9;4.3
75;2021-03-15;14077;3428;547099;259370;9.1;4.3
75;2021-03-16;13685;3713;560784;263083;9.3;4.4
75;2021-03-17;14746;3884;575530;266967;9.6;4.4
75;2021-03-18;16381;4689;591911;271656;9.9;4.5
75;2021-03-19;22435;4296;614346;275952;10.2;4.6
75;2021-03-20;14029;822;628375;276774;10.5;4.6
75;2021-03-21;2465;107;630840;276881;10.5;4.6
75;2021-03-22;16794;3462;647634;280343;10.8;4.7
75;2021-03-23;25267;3897;672901;284240;11.2;4.7
75;2021-03-24;27149;4314;700050;288554;11.7;4.8
75;2021-03-25;35656;4642;735706;293196;12.3;4.9
75;2021-03-26;38619;4190;774325;297386;12.9;5.0
75;2021-03-27;15711;1281;790036;298667;13.2;5.0
75;2021-03-28;2726;394;792762;299061;13.2;5.0
75;2021-03-29;22838;4149;815600;303210;13.6;5.1
75;2021-03-30;31650;5981;847250;309191;14.1;5.2
75;2021-03-31;29742;5951;876992;315142;14.6;5.3
75;2021-04-01;35012;6955;912004;322097;15.2;5.4
75;2021-04-02;32333;6875;944337;328972;15.7;5.5
75;2021-04-03;12819;2637;957156;331609;16.0;5.5
75;2021-04-04;2136;340;959292;331949;16.0;5.5
75;2021-04-05;6369;604;965661;332553;16.1;5.5
75;2021-04-06;26383;10838;992044;343391;16.5;5.7
75;2021-04-07;32362;11026;1024406;354417;17.1;5.9
75;2021-04-08;39598;12371;1064004;366788;17.7;6.1
75;2021-04-09;49239;10997;1113243;377785;18.6;6.3
75;2021-04-10;24443;4976;1137686;382761;19.0;6.4
75;2021-04-11;4969;718;1142655;383479;19.0;6.4
75;2021-04-12;27376;11855;1170031;395334;19.5;6.6
75;2021-04-13;35714;14347;1205745;409681;20.1;6.8
75;2021-04-14;35434;14499;1241179;424180;20.7;7.1
75;2021-04-15;37680;15083;1278859;439263;21.3;7.3
75;2021-04-16;37126;15127;1315985;454390;21.9;7.6
75;2021-04-17;19564;7385;1335549;461775;22.3;7.7
75;2021-04-18;4073;2056;1339622;463831;22.3;7.7
75;2021-04-19;20891;14965;1360513;478796;22.7;8.0
75;2021-04-20;28484;19123;1388997;497919;23.2;8.3
75;2021-04-21;27830;18095;1416827;516014;23.6;8.6
75;2021-04-22;30367;19695;1447194;535709;24.1;8.9
75;2021-04-23;29060;20258;1476254;555967;24.6;9.3
75;2021-04-24;17004;9144;1493258;565111;24.9;9.4
75;2021-04-25;4597;1499;1497855;566610;25.0;9.4
75;2021-04-26;22313;19305;1520168;585915;25.3;9.8
75;2021-04-27;29186;24327;1549354;610242;25.8;10.2
75;2021-04-28;31138;24026;1580492;634268;26.3;10.6
75;2021-04-29;37263;26647;1617755;660915;27.0;11.0
75;2021-04-30;37745;25887;1655500;686802;27.6;11.4
75;2021-05-01;15679;5752;1671179;692554;27.9;11.5
75;2021-05-02;7257;2599;1678436;695153;28.0;11.6
75;2021-05-03;27254;21186;1705690;716339;28.4;11.9
75;2021-05-04;30353;29306;1736043;745645;28.9;12.4
75;2021-05-05;31494;31006;1767537;776651;29.5;12.9
75;2021-05-06;35945;32406;1803482;809057;30.1;13.5
75;2021-05-07;37431;34373;1840913;843430;30.7;14.1
75;2021-05-08;17704;8095;1858617;851525;31.0;14.2
75;2021-05-09;7313;4153;1865930;855678;31.1;14.3
75;2021-05-10;25212;29026;1891142;884704;31.5;14.7
75;2021-05-11;35592;32982;1926734;917686;32.1;15.3
75;2021-05-12;35605;30161;1962339;947847;32.7;15.8
75;2021-05-13;22691;7546;1985030;955393;33.1;15.9
75;2021-05-14;33861;20870;2018891;976263;33.6;16.3
75;2021-05-15;22912;11097;2041803;987360;34.0;16.5
75;2021-05-16;7393;2062;2049196;989422;34.2;16.5
75;2021-05-17;33806;19221;2083002;1008643;34.7;16.8
75;2021-05-18;42640;19935;2125642;1028578;35.4;17.1
75;2021-05-19;42652;17622;2168294;1046200;36.1;17.4
75;2021-05-20;45882;20359;2214176;1066559;36.9;17.8
75;2021-05-21;42819;21393;2256995;1087952;37.6;18.1
75;2021-05-22;23237;9800;2280232;1097752;38.0;18.3
75;2021-05-23;7804;1421;2288036;1099173;38.1;18.3
75;2021-05-24;18840;4071;2306876;1103244;38.4;18.4
75;2021-05-25;36812;20966;2343688;1124210;39.1;18.7
75;2021-05-26;38273;21492;2381961;1145702;39.7;19.1
75;2021-05-27;42897;27092;2424858;1172794;40.4;19.5
75;2021-05-28;38839;32289;2463697;1205083;41.1;20.1
75;2021-05-29;19639;18102;2483336;1223185;41.4;20.4
75;2021-05-30;5773;2288;2489109;1225473;41.5;20.4
75;2021-05-31;31613;23127;2520722;1248600;42.0;20.8
75;2021-06-01;40982;29623;2561704;1278223;42.7;21.3
75;2021-06-02;41323;28241;2603027;1306464;43.4;21.8
75;2021-06-03;47583;31217;2650610;1337681;44.2;22.3
75;2021-06-04;44364;36973;2694974;1374654;44.9;22.9
75;2021-06-05;24383;18519;2719357;1393173;45.3;23.2
75;2021-06-06;8728;4320;2728085;1397493;45.5;23.3
75;2021-06-07;31376;31540;2759461;1429033;46.0;23.8
75;2021-06-08;38407;35950;2797868;1464983;46.6;24.4
75;2021-06-09;39294;32935;2837162;1497918;47.3;25.0
75;2021-06-10;42908;31809;2880070;1529727;48.0;25.5
75;2021-06-11;40242;40320;2920312;1570047;48.7;26.2
75;2021-06-12;23189;21528;2943501;1591575;49.1;26.5
75;2021-06-13;8100;5652;2951601;1597227;49.2;26.6
75;2021-06-14;23957;37939;2975558;1635166;49.6;27.3
75;2021-06-15;33119;41678;3008677;1676844;50.1;27.9
75;2021-06-16;34627;37288;3043304;1714132;50.7;28.6
75;2021-06-17;36056;38573;3079360;1752705;51.3;29.2
75;2021-06-18;34658;45301;3114018;1798006;51.9;30.0
75;2021-06-19;20125;23238;3134143;1821244;52.2;30.4
75;2021-06-20;6211;5730;3140354;1826974;52.3;30.4
75;2021-06-21;21398;37326;3161752;1864300;52.7;31.1
75;2021-06-22;25189;43582;3186941;1907882;53.1;31.8
75;2021-06-23;26101;40774;3213042;1948656;53.6;32.5
75;2021-06-24;27682;35542;3240724;1984198;54.0;33.1
76;2020-12-27;0;0;0;0;0.0;0.0
76;2020-12-28;4;0;4;0;0.0;0.0
76;2020-12-29;0;0;4;0;0.0;0.0
76;2020-12-30;0;0;4;0;0.0;0.0
76;2020-12-31;1;0;5;0;0.0;0.0
76;2021-01-01;3;0;8;0;0.0;0.0
76;2021-01-02;2;0;10;0;0.0;0.0
76;2021-01-03;2;0;12;0;0.0;0.0
76;2021-01-04;59;1;71;1;0.0;0.0
76;2021-01-05;473;1;544;2;0.0;0.0
76;2021-01-06;784;2;1328;4;0.0;0.0
76;2021-01-07;2538;3;3866;7;0.1;0.0
76;2021-01-08;3214;2;7080;9;0.1;0.0
76;2021-01-09;1537;1;8617;10;0.1;0.0
76;2021-01-10;517;0;9134;10;0.2;0.0
76;2021-01-11;3525;8;12659;18;0.2;0.0
76;2021-01-12;5743;9;18402;27;0.3;0.0
76;2021-01-13;6475;12;24877;39;0.4;0.0
76;2021-01-14;8997;85;33874;124;0.6;0.0
76;2021-01-15;7251;32;41125;156;0.7;0.0
76;2021-01-16;1954;21;43079;177;0.7;0.0
76;2021-01-17;710;3;43789;180;0.7;0.0
76;2021-01-18;7703;21;51492;201;0.9;0.0
76;2021-01-19;11200;28;62692;229;1.1;0.0
76;2021-01-20;13708;25;76400;254;1.3;0.0
76;2021-01-21;16702;21;93102;275;1.6;0.0
76;2021-01-22;11907;32;105009;307;1.8;0.0
76;2021-01-23;3896;9;108905;316;1.8;0.0
76;2021-01-24;768;12;109673;328;1.9;0.0
76;2021-01-25;7829;97;117502;425;2.0;0.0
76;2021-01-26;10345;283;127847;708;2.2;0.0
76;2021-01-27;10848;482;138695;1190;2.3;0.0
76;2021-01-28;10137;1696;148832;2886;2.5;0.0
76;2021-01-29;8087;1989;156919;4875;2.6;0.1
76;2021-01-30;3185;772;160104;5647;2.7;0.1
76;2021-01-31;521;267;160625;5914;2.7;0.1
76;2021-02-01;5855;2604;166480;8518;2.8;0.1
76;2021-02-02;10056;4001;176536;12519;3.0;0.2
76;2021-02-03;9518;4069;186054;16588;3.1;0.3
76;2021-02-04;10100;5960;196154;22548;3.3;0.4
76;2021-02-05;7774;5027;203928;27575;3.4;0.5
76;2021-02-06;2694;1051;206622;28626;3.5;0.5
76;2021-02-07;542;498;207164;29124;3.5;0.5
76;2021-02-08;4839;4530;212003;33654;3.6;0.6
76;2021-02-09;6318;6821;218321;40475;3.7;0.7
76;2021-02-10;7175;9241;225496;49716;3.8;0.8
76;2021-02-11;9128;10739;234624;60455;4.0;1.0
76;2021-02-12;8046;7691;242670;68146;4.1;1.2
76;2021-02-13;2646;2272;245316;70418;4.1;1.2
76;2021-02-14;357;994;245673;71412;4.1;1.2
76;2021-02-15;3380;6468;249053;77880;4.2;1.3
76;2021-02-16;4242;8696;253295;86576;4.3;1.5
76;2021-02-17;4375;9655;257670;96231;4.3;1.6
76;2021-02-18;5870;9989;263540;106220;4.4;1.8
76;2021-02-19;4840;8130;268380;114350;4.5;1.9
76;2021-02-20;1529;3041;269909;117391;4.6;2.0
76;2021-02-21;264;595;270173;117986;4.6;2.0
76;2021-02-22;3279;7665;273452;125651;4.6;2.1
76;2021-02-23;4918;10245;278370;135896;4.7;2.3
76;2021-02-24;4644;10427;283014;146323;4.8;2.5
76;2021-02-25;8312;9914;291326;156237;4.9;2.6
76;2021-02-26;9636;8403;300962;164640;5.1;2.8
76;2021-02-27;3730;3098;304692;167738;5.1;2.8
76;2021-02-28;432;453;305124;168191;5.1;2.8
76;2021-03-01;5305;6147;310429;174338;5.2;2.9
76;2021-03-02;8215;7570;318644;181908;5.4;3.1
76;2021-03-03;9246;7498;327890;189406;5.5;3.2
76;2021-03-04;14318;7895;342208;197301;5.8;3.3
76;2021-03-05;16869;7119;359077;204420;6.1;3.5
76;2021-03-06;15884;2162;374961;206582;6.3;3.5
76;2021-03-07;11377;467;386338;207049;6.5;3.5
76;2021-03-08;9977;5522;396315;212571;6.7;3.6
76;2021-03-09;16224;6477;412539;219048;7.0;3.7
76;2021-03-10;16410;6498;428949;225546;7.2;3.8
76;2021-03-11;22594;6401;451543;231947;7.6;3.9
76;2021-03-12;26416;5267;477959;237214;8.1;4.0
76;2021-03-13;14920;2160;492879;239374;8.3;4.0
76;2021-03-14;2323;355;495202;239729;8.4;4.0
76;2021-03-15;13514;3298;508716;243027;8.6;4.1
76;2021-03-16;11758;4528;520474;247555;8.8;4.2
76;2021-03-17;12839;3972;533313;251527;9.0;4.2
76;2021-03-18;13701;4989;547014;256516;9.2;4.3
76;2021-03-19;18651;4007;565665;260523;9.5;4.4
76;2021-03-20;10657;1131;576322;261654;9.7;4.4
76;2021-03-21;3195;222;579517;261876;9.8;4.4
76;2021-03-22;14668;3582;594185;265458;10.0;4.5
76;2021-03-23;22240;4322;616425;269780;10.4;4.6
76;2021-03-24;23595;4186;640020;273966;10.8;4.6
76;2021-03-25;32011;4610;672031;278576;11.3;4.7
76;2021-03-26;30835;4076;702866;282652;11.9;4.8
76;2021-03-27;16223;1412;719089;284064;12.1;4.8
76;2021-03-28;4868;192;723957;284256;12.2;4.8
76;2021-03-29;22295;4890;746252;289146;12.6;4.9
76;2021-03-30;29703;5719;775955;294865;13.1;5.0
76;2021-03-31;26881;5594;802836;300459;13.6;5.1
76;2021-04-01;34446;5903;837282;306362;14.1;5.2
76;2021-04-02;29319;5766;866601;312128;14.6;5.3
76;2021-04-03;12143;2851;878744;314979;14.8;5.3
76;2021-04-04;4352;659;883096;315638;14.9;5.3
76;2021-04-05;4288;674;887384;316312;15.0;5.3
76;2021-04-06;22832;9745;910216;326057;15.4;5.5
76;2021-04-07;25249;9865;935465;335922;15.8;5.7
76;2021-04-08;33094;10242;968559;346164;16.3;5.8
76;2021-04-09;38874;9622;1007433;355786;17.0;6.0
76;2021-04-10;22688;5156;1030121;360942;17.4;6.1
76;2021-04-11;8857;1432;1038978;362374;17.5;6.1
76;2021-04-12;26022;10518;1065000;372892;18.0;6.3
76;2021-04-13;35753;12855;1100753;385747;18.6;6.5
76;2021-04-14;32852;13251;1133605;398998;19.1;6.7
76;2021-04-15;37428;13843;1171033;412841;19.8;7.0
76;2021-04-16;34400;13144;1205433;425985;20.3;7.2
76;2021-04-17;21362;6652;1226795;432637;20.7;7.3
76;2021-04-18;7709;2689;1234504;435326;20.8;7.3
76;2021-04-19;22040;12917;1256544;448243;21.2;7.6
76;2021-04-20;27959;16740;1284503;464983;21.7;7.8
76;2021-04-21;27013;16932;1311516;481915;22.1;8.1
76;2021-04-22;30341;17943;1341857;499858;22.6;8.4
76;2021-04-23;28674;16405;1370531;516263;23.1;8.7
76;2021-04-24;18458;10408;1388989;526671;23.4;8.9
76;2021-04-25;6908;4197;1395897;530868;23.6;9.0
76;2021-04-26;19924;18398;1415821;549266;23.9;9.3
76;2021-04-27;26712;21402;1442533;570668;24.3;9.6
76;2021-04-28;25876;20970;1468409;591638;24.8;10.0
76;2021-04-29;29709;23205;1498118;614843;25.3;10.4
76;2021-04-30;30765;20140;1528883;634983;25.8;10.7
76;2021-05-01;17416;7026;1546299;642009;26.1;10.8
76;2021-05-02;9481;4784;1555780;646793;26.3;10.9
76;2021-05-03;26516;16779;1582296;663572;26.7;11.2
76;2021-05-04;29984;25827;1612280;689399;27.2;11.6
76;2021-05-05;28156;26408;1640436;715807;27.7;12.1
76;2021-05-06;31005;30871;1671441;746678;28.2;12.6
76;2021-05-07;31609;30789;1703050;777467;28.7;13.1
76;2021-05-08;17333;10559;1720383;788026;29.0;13.3
76;2021-05-09;9708;8679;1730091;796705;29.2;13.4
76;2021-05-10;24066;28053;1754157;824758;29.6;13.9
76;2021-05-11;31627;33072;1785784;857830;30.1;14.5
76;2021-05-12;33294;29403;1819078;887233;30.7;15.0
76;2021-05-13;25933;9723;1845011;896956;31.1;15.1
76;2021-05-14;34439;21304;1879450;918260;31.7;15.5
76;2021-05-15;24426;12171;1903876;930431;32.1;15.7
76;2021-05-16;15391;3789;1919267;934220;32.4;15.8
76;2021-05-17;27760;19232;1947027;953452;32.9;16.1
76;2021-05-18;35064;19471;1982091;972923;33.5;16.4
76;2021-05-19;36703;16818;2018794;989741;34.1;16.7
76;2021-05-20;40837;18634;2059631;1008375;34.8;17.0
76;2021-05-21;37620;19950;2097251;1028325;35.4;17.4
76;2021-05-22;26912;9250;2124163;1037575;35.9;17.5
76;2021-05-23;13265;1800;2137428;1039375;36.1;17.5
76;2021-05-24;15369;4109;2152797;1043484;36.3;17.6
76;2021-05-25;31495;20744;2184292;1064228;36.9;18.0
76;2021-05-26;33281;19199;2217573;1083427;37.4;18.3
76;2021-05-27;36222;24406;2253795;1107833;38.0;18.7
76;2021-05-28;32378;28253;2286173;1136086;38.6;19.2
76;2021-05-29;19466;16743;2305639;1152829;38.9;19.5
76;2021-05-30;6153;6311;2311792;1159140;39.0;19.6
76;2021-05-31;25692;22874;2337484;1182014;39.5;20.0
76;2021-06-01;31114;29825;2368598;1211839;40.0;20.5
76;2021-06-02;30678;28056;2399276;1239895;40.5;20.9
76;2021-06-03;34111;33099;2433387;1272994;41.1;21.5
76;2021-06-04;34996;34225;2468383;1307219;41.7;22.1
76;2021-06-05;25960;19717;2494343;1326936;42.1;22.4
76;2021-06-06;14069;6462;2508412;1333398;42.3;22.5
76;2021-06-07;25695;27657;2534107;1361055;42.8;23.0
76;2021-06-08;32334;31563;2566441;1392618;43.3;23.5
76;2021-06-09;32221;29075;2598662;1421693;43.9;24.0
76;2021-06-10;31881;29449;2630543;1451142;44.4;24.5
76;2021-06-11;33495;36108;2664038;1487250;45.0;25.1
76;2021-06-12;23169;21891;2687207;1509141;45.4;25.5
76;2021-06-13;12022;7132;2699229;1516273;45.6;25.6
76;2021-06-14;21517;33602;2720746;1549875;45.9;26.2
76;2021-06-15;28665;39688;2749411;1589563;46.4;26.8
76;2021-06-16;26959;36335;2776370;1625898;46.9;27.4
76;2021-06-17;26713;34147;2803083;1660045;47.3;28.0
76;2021-06-18;27337;41096;2830420;1701141;47.8;28.7
76;2021-06-19;20778;23093;2851198;1724234;48.1;29.1
76;2021-06-20;8906;10333;2860104;1734567;48.3;29.3
76;2021-06-21;15017;35197;2875121;1769764;48.5;29.9
76;2021-06-22;18161;40432;2893282;1810196;48.8;30.6
76;2021-06-23;18807;37922;2912089;1848118;49.2;31.2
76;2021-06-24;17240;35282;2929329;1883400;49.4;31.8
84;2020-12-27;1;0;1;0;0.0;0.0
84;2020-12-28;7;0;8;0;0.0;0.0
84;2020-12-29;5;0;13;0;0.0;0.0
84;2020-12-30;6;0;19;0;0.0;0.0
84;2020-12-31;15;0;34;0;0.0;0.0
84;2021-01-01;10;0;44;0;0.0;0.0
84;2021-01-02;2;1;46;1;0.0;0.0
84;2021-01-03;0;0;46;1;0.0;0.0
84;2021-01-04;174;0;220;1;0.0;0.0
84;2021-01-05;467;1;687;2;0.0;0.0
84;2021-01-06;1135;0;1822;2;0.0;0.0
84;2021-01-07;2886;3;4708;5;0.1;0.0
84;2021-01-08;3078;3;7786;8;0.1;0.0
84;2021-01-09;513;1;8299;9;0.1;0.0
84;2021-01-10;161;0;8460;9;0.1;0.0
84;2021-01-11;4294;8;12754;17;0.2;0.0
84;2021-01-12;6363;17;19117;34;0.2;0.0
84;2021-01-13;6842;14;25959;48;0.3;0.0
84;2021-01-14;9071;57;35030;105;0.4;0.0
84;2021-01-15;7764;30;42794;135;0.5;0.0
84;2021-01-16;2953;7;45747;142;0.6;0.0
84;2021-01-17;920;2;46667;144;0.6;0.0
84;2021-01-18;8965;34;55632;178;0.7;0.0
84;2021-01-19;15047;83;70679;261;0.9;0.0
84;2021-01-20;15492;36;86171;297;1.1;0.0
84;2021-01-21;14575;51;100746;348;1.3;0.0
84;2021-01-22;12413;43;113159;391;1.4;0.0
84;2021-01-23;4759;3;117918;394;1.5;0.0
84;2021-01-24;810;1;118728;395;1.5;0.0
84;2021-01-25;8764;151;127492;546;1.6;0.0
84;2021-01-26;11898;320;139390;866;1.7;0.0
84;2021-01-27;12080;618;151470;1484;1.9;0.0
84;2021-01-28;13824;1540;165294;3024;2.1;0.0
84;2021-01-29;10793;1312;176087;4336;2.2;0.1
84;2021-01-30;4140;147;180227;4483;2.2;0.1
84;2021-01-31;499;1;180726;4484;2.2;0.1
84;2021-02-01;6533;1887;187259;6371;2.3;0.1
84;2021-02-02;10590;3518;197849;9889;2.5;0.1
84;2021-02-03;11527;3930;209376;13819;2.6;0.2
84;2021-02-04;12556;5545;221932;19364;2.8;0.2
84;2021-02-05;8612;4701;230544;24065;2.9;0.3
84;2021-02-06;2653;960;233197;25025;2.9;0.3
84;2021-02-07;451;441;233648;25466;2.9;0.3
84;2021-02-08;6223;4971;239871;30437;3.0;0.4
84;2021-02-09;9339;8274;249210;38711;3.1;0.5
84;2021-02-10;9678;8616;258888;47327;3.2;0.6
84;2021-02-11;10696;9925;269584;57252;3.4;0.7
84;2021-02-12;9719;7948;279303;65200;3.5;0.8
84;2021-02-13;3497;2349;282800;67549;3.5;0.8
84;2021-02-14;623;457;283423;68006;3.5;0.8
84;2021-02-15;4871;8371;288294;76377;3.6;1.0
84;2021-02-16;6096;10783;294390;87160;3.7;1.1
84;2021-02-17;6057;11577;300447;98737;3.7;1.2
84;2021-02-18;7102;11772;307549;110509;3.8;1.4
84;2021-02-19;6645;9357;314194;119866;3.9;1.5
84;2021-02-20;1837;3272;316031;123138;3.9;1.5
84;2021-02-21;180;504;316211;123642;3.9;1.5
84;2021-02-22;4290;8857;320501;132499;4.0;1.6
84;2021-02-23;7281;11436;327782;143935;4.1;1.8
84;2021-02-24;7792;12036;335574;155971;4.2;1.9
84;2021-02-25;12726;13817;348300;169788;4.3;2.1
84;2021-02-26;14874;10365;363174;180153;4.5;2.2
84;2021-02-27;5560;2924;368734;183077;4.6;2.3
84;2021-02-28;500;514;369234;183591;4.6;2.3
84;2021-03-01;9289;6427;378523;190018;4.7;2.4
84;2021-03-02;14960;8821;393483;198839;4.9;2.5
84;2021-03-03;14797;8681;408280;207520;5.1;2.6
84;2021-03-04;21001;8463;429281;215983;5.3;2.7
84;2021-03-05;25777;7731;455058;223714;5.7;2.8
84;2021-03-06;19492;2398;474550;226112;5.9;2.8
84;2021-03-07;8414;477;482964;226589;6.0;2.8
84;2021-03-08;12210;6819;495174;233408;6.2;2.9
84;2021-03-09;20675;7713;515849;241121;6.4;3.0
84;2021-03-10;20232;7550;536081;248671;6.7;3.1
84;2021-03-11;29458;8171;565539;256842;7.0;3.2
84;2021-03-12;36176;7721;601715;264563;7.5;3.3
84;2021-03-13;21425;1885;623140;266448;7.8;3.3
84;2021-03-14;4684;479;627824;266927;7.8;3.3
84;2021-03-15;18861;4808;646685;271735;8.1;3.4
84;2021-03-16;17053;6119;663738;277854;8.3;3.5
84;2021-03-17;17578;6476;681316;284330;8.5;3.5
84;2021-03-18;21502;6962;702818;291292;8.7;3.6
84;2021-03-19;28973;5524;731791;296816;9.1;3.7
84;2021-03-20;14538;1416;746329;298232;9.3;3.7
84;2021-03-21;3237;275;749566;298507;9.3;3.7
84;2021-03-22;19734;5145;769300;303652;9.6;3.8
84;2021-03-23;30783;5976;800083;309628;10.0;3.9
84;2021-03-24;29957;5898;830040;315526;10.3;3.9
84;2021-03-25;41548;6514;871588;322040;10.9;4.0
84;2021-03-26;42967;6794;914555;328834;11.4;4.1
84;2021-03-27;18209;2935;932764;331769;11.6;4.1
84;2021-03-28;6505;601;939269;332370;11.7;4.1
84;2021-03-29;22939;7946;962208;340316;12.0;4.2
84;2021-03-30;34950;10234;997158;350550;12.4;4.4
84;2021-03-31;29580;11062;1026738;361612;12.8;4.5
84;2021-04-01;37241;11473;1063979;373085;13.2;4.6
84;2021-04-02;34862;11392;1098841;384477;13.7;4.8
84;2021-04-03;14785;6230;1113626;390707;13.9;4.9
84;2021-04-04;9928;2002;1123554;392709;14.0;4.9
84;2021-04-05;13530;1678;1137084;394387;14.2;4.9
84;2021-04-06;26284;13258;1163368;407645;14.5;5.1
84;2021-04-07;29483;14697;1192851;422342;14.9;5.3
84;2021-04-08;39658;15503;1232509;437845;15.3;5.5
84;2021-04-09;49377;15115;1281886;452960;16.0;5.6
84;2021-04-10;20448;8154;1302334;461114;16.2;5.7
84;2021-04-11;7227;2702;1309561;463816;16.3;5.8
84;2021-04-12;27293;15601;1336854;479417;16.6;6.0
84;2021-04-13;36121;19410;1372975;498827;17.1;6.2
84;2021-04-14;34613;18302;1407588;517129;17.5;6.4
84;2021-04-15;40096;19736;1447684;536865;18.0;6.7
84;2021-04-16;38188;20135;1485872;557000;18.5;6.9
84;2021-04-17;20456;9038;1506328;566038;18.8;7.0
84;2021-04-18;6837;2714;1513165;568752;18.8;7.1
84;2021-04-19;26219;18610;1539384;587362;19.2;7.3
84;2021-04-20;31195;22544;1570579;609906;19.6;7.6
84;2021-04-21;28024;21504;1598603;631410;19.9;7.9
84;2021-04-22;32229;22666;1630832;654076;20.3;8.1
84;2021-04-23;32680;23143;1663512;677219;20.7;8.4
84;2021-04-24;17854;11912;1681366;689131;20.9;8.6
84;2021-04-25;7129;4290;1688495;693421;21.0;8.6
84;2021-04-26;23705;20064;1712200;713485;21.3;8.9
84;2021-04-27;31747;25295;1743947;738780;21.7;9.2
84;2021-04-28;32468;24864;1776415;763644;22.1;9.5
84;2021-04-29;39631;26587;1816046;790231;22.6;9.8
84;2021-04-30;38131;27890;1854177;818121;23.1;10.2
84;2021-05-01;17156;5390;1871333;823511;23.3;10.3
84;2021-05-02;7975;8583;1879308;832094;23.4;10.4
84;2021-05-03;30316;27522;1909624;859616;23.8;10.7
84;2021-05-04;37135;33784;1946759;893400;24.2;11.1
84;2021-05-05;40225;30201;1986984;923601;24.7;11.5
84;2021-05-06;46579;32674;2033563;956275;25.3;11.9
84;2021-05-07;46980;36832;2080543;993107;25.9;12.4
84;2021-05-08;22300;7657;2102843;1000764;26.2;12.5
84;2021-05-09;15909;8913;2118752;1009677;26.4;12.6
84;2021-05-10;36065;32024;2154817;1041701;26.8;13.0
84;2021-05-11;52619;36308;2207436;1078009;27.5;13.4
84;2021-05-12;56866;31905;2264302;1109914;28.2;13.8
84;2021-05-13;47372;10528;2311674;1120442;28.8;13.9
84;2021-05-14;57330;25003;2369004;1145445;29.5;14.3
84;2021-05-15;44037;13625;2413041;1159070;30.0;14.4
84;2021-05-16;30414;5114;2443455;1164184;30.4;14.5
84;2021-05-17;48234;24935;2491689;1189119;31.0;14.8
84;2021-05-18;58872;27379;2550561;1216498;31.8;15.1
84;2021-05-19;58251;23546;2608812;1240044;32.5;15.4
84;2021-05-20;61533;27032;2670345;1267076;33.2;15.8
84;2021-05-21;60861;29388;2731206;1296464;34.0;16.1
84;2021-05-22;40391;12910;2771597;1309374;34.5;16.3
84;2021-05-23;21349;3982;2792946;1313356;34.8;16.4
84;2021-05-24;39708;8543;2832654;1321899;35.3;16.5
84;2021-05-25;50213;31677;2882867;1353576;35.9;16.9
84;2021-05-26;49680;28932;2932547;1382508;36.5;17.2
84;2021-05-27;55629;31846;2988176;1414354;37.2;17.6
84;2021-05-28;54708;40510;3042884;1454864;37.9;18.1
84;2021-05-29;37575;22380;3080459;1477244;38.4;18.4
84;2021-05-30;16109;7263;3096568;1484507;38.6;18.5
84;2021-05-31;44265;29421;3140833;1513928;39.1;18.8
84;2021-06-01;48270;36655;3189103;1550583;39.7;19.3
84;2021-06-02;47685;31222;3236788;1581805;40.3;19.7
84;2021-06-03;55991;36570;3292779;1618375;41.0;20.1
84;2021-06-04;54551;42372;3347330;1660747;41.7;20.7
84;2021-06-05;38042;21678;3385372;1682425;42.1;20.9
84;2021-06-06;15897;6287;3401269;1688712;42.3;21.0
84;2021-06-07;41298;35163;3442567;1723875;42.9;21.5
84;2021-06-08;44955;37909;3487522;1761784;43.4;21.9
84;2021-06-09;40499;33926;3528021;1795710;43.9;22.4
84;2021-06-10;41134;33846;3569155;1829556;44.4;22.8
84;2021-06-11;43234;46334;3612389;1875890;45.0;23.4
84;2021-06-12;28110;22921;3640499;1898811;45.3;23.6
84;2021-06-13;8603;7128;3649102;1905939;45.4;23.7
84;2021-06-14;25511;44541;3674613;1950480;45.7;24.3
84;2021-06-15;31554;49288;3706167;1999768;46.1;24.9
84;2021-06-16;33257;45416;3739424;2045184;46.6;25.5
84;2021-06-17;30468;46928;3769892;2092112;46.9;26.0
84;2021-06-18;34833;59877;3804725;2151989;47.4;26.8
84;2021-06-19;22735;35698;3827460;2187687;47.7;27.2
84;2021-06-20;8657;14380;3836117;2202067;47.8;27.4
84;2021-06-21;19911;56126;3856028;2258193;48.0;28.1
84;2021-06-22;20926;62707;3876954;2320900;48.3;28.9
84;2021-06-23;22187;57547;3899141;2378447;48.5;29.6
84;2021-06-24;22947;55002;3922088;2433449;48.8;30.3
93;2020-12-27;0;0;0;0;0.0;0.0
93;2020-12-28;2;0;2;0;0.0;0.0
93;2020-12-29;1;0;3;0;0.0;0.0
93;2020-12-30;3;0;6;0;0.0;0.0
93;2020-12-31;19;0;25;0;0.0;0.0
93;2021-01-01;13;0;38;0;0.0;0.0
93;2021-01-02;2;0;40;0;0.0;0.0
93;2021-01-03;2;0;42;0;0.0;0.0
93;2021-01-04;133;1;175;1;0.0;0.0
93;2021-01-05;251;1;426;2;0.0;0.0
93;2021-01-06;410;0;836;2;0.0;0.0
93;2021-01-07;1245;2;2081;4;0.0;0.0
93;2021-01-08;1563;2;3644;6;0.1;0.0
93;2021-01-09;540;1;4184;7;0.1;0.0
93;2021-01-10;74;0;4258;7;0.1;0.0
93;2021-01-11;2412;1;6670;8;0.1;0.0
93;2021-01-12;5092;7;11762;15;0.2;0.0
93;2021-01-13;4453;15;16215;30;0.3;0.0
93;2021-01-14;5576;50;21791;80;0.4;0.0
93;2021-01-15;4928;15;26719;95;0.5;0.0
93;2021-01-16;1678;4;28397;99;0.6;0.0
93;2021-01-17;300;1;28697;100;0.6;0.0
93;2021-01-18;7156;30;35853;130;0.7;0.0
93;2021-01-19;13526;34;49379;164;1.0;0.0
93;2021-01-20;12255;35;61634;199;1.2;0.0
93;2021-01-21;12308;50;73942;249;1.5;0.0
93;2021-01-22;10193;28;84135;277;1.7;0.0
93;2021-01-23;3327;6;87462;283;1.7;0.0
93;2021-01-24;537;4;87999;287;1.7;0.0
93;2021-01-25;7249;40;95248;327;1.9;0.0
93;2021-01-26;10067;136;105315;463;2.1;0.0
93;2021-01-27;9692;289;115007;752;2.3;0.0
93;2021-01-28;13667;833;128674;1585;2.5;0.0
93;2021-01-29;9846;982;138520;2567;2.7;0.1
93;2021-01-30;2240;159;140760;2726;2.8;0.1
93;2021-01-31;303;5;141063;2731;2.8;0.1
93;2021-02-01;5162;1518;146225;4249;2.9;0.1
93;2021-02-02;6646;2380;152871;6629;3.0;0.1
93;2021-02-03;5024;1822;157895;8451;3.1;0.2
93;2021-02-04;5532;3161;163427;11612;3.2;0.2
93;2021-02-05;6107;4129;169534;15741;3.4;0.3
93;2021-02-06;1246;973;170780;16714;3.4;0.3
93;2021-02-07;280;81;171060;16795;3.4;0.3
93;2021-02-08;4302;3748;175362;20543;3.5;0.4
93;2021-02-09;5890;7104;181252;27647;3.6;0.5
93;2021-02-10;5955;5886;187207;33533;3.7;0.7
93;2021-02-11;6598;6720;193805;40253;3.8;0.8
93;2021-02-12;5720;6477;199525;46730;3.9;0.9
93;2021-02-13;1128;1450;200653;48180;4.0;1.0
93;2021-02-14;73;384;200726;48564;4.0;1.0
93;2021-02-15;2413;5638;203139;54202;4.0;1.1
93;2021-02-16;3190;7709;206329;61911;4.1;1.2
93;2021-02-17;3604;8528;209933;70439;4.2;1.4
93;2021-02-18;6007;11424;215940;81863;4.3;1.6
93;2021-02-19;5641;8674;221581;90537;4.4;1.8
93;2021-02-20;879;1801;222460;92338;4.4;1.8
93;2021-02-21;68;417;222528;92755;4.4;1.8
93;2021-02-22;3028;6997;225556;99752;4.5;2.0
93;2021-02-23;3962;7245;229518;106997;4.5;2.1
93;2021-02-24;4748;6799;234266;113796;4.6;2.3
93;2021-02-25;8248;6669;242514;120465;4.8;2.4
93;2021-02-26;8275;6185;250789;126650;5.0;2.5
93;2021-02-27;3290;1490;254079;128140;5.0;2.5
93;2021-02-28;304;238;254383;128378;5.0;2.5
93;2021-03-01;5650;4485;260033;132863;5.1;2.6
93;2021-03-02;7214;5931;267247;138794;5.3;2.7
93;2021-03-03;8985;6555;276232;145349;5.5;2.9
93;2021-03-04;12061;6458;288293;151807;5.7;3.0
93;2021-03-05;12197;6102;300490;157909;5.9;3.1
93;2021-03-06;22851;1307;323341;159216;6.4;3.1
93;2021-03-07;17984;608;341325;159824;6.8;3.2
93;2021-03-08;10240;5269;351565;165093;7.0;3.3
93;2021-03-09;13956;5563;365521;170656;7.2;3.4
93;2021-03-10;14491;5282;380012;175938;7.5;3.5
93;2021-03-11;20387;6160;400399;182098;7.9;3.6
93;2021-03-12;21911;5317;422310;187415;8.4;3.7
93;2021-03-13;24595;1227;446905;188642;8.8;3.7
93;2021-03-14;6471;263;453376;188905;9.0;3.7
93;2021-03-15;15940;3107;469316;192012;9.3;3.8
93;2021-03-16;12719;3643;482035;195655;9.5;3.9
93;2021-03-17;15996;4646;498031;200301;9.9;4.0
93;2021-03-18;17034;4896;515065;205197;10.2;4.1
93;2021-03-19;21018;4694;536083;209891;10.6;4.2
93;2021-03-20;10990;1318;547073;211209;10.8;4.2
93;2021-03-21;3256;130;550329;211339;10.9;4.2
93;2021-03-22;17099;3557;567428;214896;11.2;4.3
93;2021-03-23;22652;3879;590080;218775;11.7;4.3
93;2021-03-24;21977;6635;612057;225410;12.1;4.5
93;2021-03-25;29011;6515;641068;231925;12.7;4.6
93;2021-03-26;29909;5030;670977;236955;13.3;4.7
93;2021-03-27;12451;1636;683428;238591;13.5;4.7
93;2021-03-28;3575;100;687003;238691;13.6;4.7
93;2021-03-29;18519;5335;705522;244026;14.0;4.8
93;2021-03-30;28482;6691;734004;250717;14.5;5.0
93;2021-03-31;28775;6636;762779;257353;15.1;5.1
93;2021-04-01;30737;7487;793516;264840;15.7;5.2
93;2021-04-02;26915;8483;820431;273323;16.2;5.4
93;2021-04-03;9757;4977;830188;278300;16.4;5.5
93;2021-04-04;2118;1251;832306;279551;16.5;5.5
93;2021-04-05;6058;1563;838364;281114;16.6;5.6
93;2021-04-06;23410;10022;861774;291136;17.0;5.8
93;2021-04-07;26070;11670;887844;302806;17.6;6.0
93;2021-04-08;28848;14975;916692;317781;18.1;6.3
93;2021-04-09;33593;14619;950285;332400;18.8;6.6
93;2021-04-10;14804;8168;965089;340568;19.1;6.7
93;2021-04-11;3624;2961;968713;343529;19.2;6.8
93;2021-04-12;20595;12205;989308;355734;19.6;7.0
93;2021-04-13;25575;15227;1014883;370961;20.1;7.3
93;2021-04-14;25181;15244;1040064;386205;20.6;7.6
93;2021-04-15;26989;15657;1067053;401862;21.1;7.9
93;2021-04-16;27885;16445;1094938;418307;21.7;8.3
93;2021-04-17;12822;7732;1107760;426039;21.9;8.4
93;2021-04-18;5249;2959;1113009;428998;22.0;8.5
93;2021-04-19;19077;15959;1132086;444957;22.4;8.8
93;2021-04-20;21335;18746;1153421;463703;22.8;9.2
93;2021-04-21;23896;18315;1177317;482018;23.3;9.5
93;2021-04-22;25826;19239;1203143;501257;23.8;9.9
93;2021-04-23;25353;18167;1228496;519424;24.3;10.3
93;2021-04-24;11540;8697;1240036;528121;24.5;10.4
93;2021-04-25;3206;2140;1243242;530261;24.6;10.5
93;2021-04-26;16445;15858;1259687;546119;24.9;10.8
93;2021-04-27;19450;20168;1279137;566287;25.3;11.2
93;2021-04-28;21490;20102;1300627;586389;25.7;11.6
93;2021-04-29;27879;21767;1328506;608156;26.3;12.0
93;2021-04-30;27268;20604;1355774;628760;26.8;12.4
93;2021-05-01;11704;5291;1367478;634051;27.0;12.5
93;2021-05-02;4061;1885;1371539;635936;27.1;12.6
93;2021-05-03;20437;18173;1391976;654109;27.5;12.9
93;2021-05-04;20744;22724;1412720;676833;27.9;13.4
93;2021-05-05;19435;21509;1432155;698342;28.3;13.8
93;2021-05-06;24751;21639;1456906;719981;28.8;14.2
93;2021-05-07;22406;25002;1479312;744983;29.3;14.7
93;2021-05-08;13492;6878;1492804;751861;29.5;14.9
93;2021-05-09;3464;2317;1496268;754178;29.6;14.9
93;2021-05-10;18636;22581;1514904;776759;30.0;15.4
93;2021-05-11;25335;25647;1540239;802406;30.5;15.9
93;2021-05-12;32465;22540;1572704;824946;31.1;16.3
93;2021-05-13;27905;7880;1600609;832826;31.7;16.5
93;2021-05-14;35292;16400;1635901;849226;32.4;16.8
93;2021-05-15;29588;10247;1665489;859473;32.9;17.0
93;2021-05-16;12746;2516;1678235;861989;33.2;17.1
93;2021-05-17;25615;17459;1703850;879448;33.7;17.4
93;2021-05-18;30109;16726;1733959;896174;34.3;17.7
93;2021-05-19;29971;15168;1763930;911342;34.9;18.0
93;2021-05-20;32653;16696;1796583;928038;35.5;18.4
93;2021-05-21;33634;17858;1830217;945896;36.2;18.7
93;2021-05-22;18554;7674;1848771;953570;36.6;18.9
93;2021-05-23;5914;2019;1854685;955589;36.7;18.9
93;2021-05-24;17452;4985;1872137;960574;37.0;19.0
93;2021-05-25;23512;20440;1895649;981014;37.5;19.4
93;2021-05-26;24523;21900;1920172;1002914;38.0;19.8
93;2021-05-27;26304;23304;1946476;1026218;38.5;20.3
93;2021-05-28;22759;26616;1969235;1052834;39.0;20.8
93;2021-05-29;13131;14359;1982366;1067193;39.2;21.1
93;2021-05-30;2584;3182;1984950;1070375;39.3;21.2
93;2021-05-31;20799;21297;2005749;1091672;39.7;21.6
93;2021-06-01;24343;26151;2030092;1117823;40.2;22.1
93;2021-06-02;22148;26092;2052240;1143915;40.6;22.6
93;2021-06-03;27541;27274;2079781;1171189;41.1;23.2
93;2021-06-04;27906;28326;2107687;1199515;41.7;23.7
93;2021-06-05;16259;14229;2123946;1213744;42.0;24.0
93;2021-06-06;4885;2794;2128831;1216538;42.1;24.1
93;2021-06-07;17479;24386;2146310;1240924;42.5;24.5
93;2021-06-08;20957;24077;2167267;1265001;42.9;25.0
93;2021-06-09;20628;25738;2187895;1290739;43.3;25.5
93;2021-06-10;21462;24657;2209357;1315396;43.7;26.0
93;2021-06-11;19542;30690;2228899;1346086;44.1;26.6
93;2021-06-12;12702;15292;2241601;1361378;44.3;26.9
93;2021-06-13;2548;3320;2244149;1364698;44.4;27.0
93;2021-06-14;12994;29348;2257143;1394046;44.6;27.6
93;2021-06-15;16159;30926;2273302;1424972;45.0;28.2
93;2021-06-16;16701;25604;2290003;1450576;45.3;28.7
93;2021-06-17;16969;28116;2306972;1478692;45.6;29.2
93;2021-06-18;16207;27967;2323179;1506659;46.0;29.8
93;2021-06-19;9641;15304;2332820;1521963;46.1;30.1
93;2021-06-20;2388;3698;2335208;1525661;46.2;30.2
93;2021-06-21;9804;30405;2345012;1556066;46.4;30.8
93;2021-06-22;11446;34404;2356458;1590470;46.6;31.5
93;2021-06-23;11293;32207;2367751;1622677;46.8;32.1
93;2021-06-24;11846;33998;2379597;1656675;47.1;32.8
94;2020-12-27;0;0;0;0;0.0;0.0
94;2020-12-28;0;0;0;0;0.0;0.0
94;2020-12-29;0;0;0;0;0.0;0.0
94;2020-12-30;0;0;0;0;0.0;0.0
94;2020-12-31;0;0;0;0;0.0;0.0
94;2021-01-01;0;0;0;0;0.0;0.0
94;2021-01-02;0;0;0;0;0.0;0.0
94;2021-01-03;0;0;0;0;0.0;0.0
94;2021-01-04;2;0;2;0;0.0;0.0
94;2021-01-05;0;0;2;0;0.0;0.0
94;2021-01-06;53;1;55;1;0.0;0.0
94;2021-01-07;333;1;388;2;0.1;0.0
94;2021-01-08;310;0;698;2;0.2;0.0
94;2021-01-09;78;0;776;2;0.2;0.0
94;2021-01-10;34;0;810;2;0.2;0.0
94;2021-01-11;152;2;962;4;0.3;0.0
94;2021-01-12;209;1;1171;5;0.3;0.0
94;2021-01-13;203;0;1374;5;0.4;0.0
94;2021-01-14;264;1;1638;6;0.5;0.0
94;2021-01-15;404;0;2042;6;0.6;0.0
94;2021-01-16;200;1;2242;7;0.7;0.0
94;2021-01-17;91;1;2333;8;0.7;0.0
94;2021-01-18;471;2;2804;10;0.8;0.0
94;2021-01-19;982;0;3786;10;1.1;0.0
94;2021-01-20;808;0;4594;10;1.3;0.0
94;2021-01-21;808;1;5402;11;1.6;0.0
94;2021-01-22;726;0;6128;11;1.8;0.0
94;2021-01-23;243;0;6371;11;1.8;0.0
94;2021-01-24;147;0;6518;11;1.9;0.0
94;2021-01-25;422;2;6940;13;2.0;0.0
94;2021-01-26;790;7;7730;20;2.2;0.0
94;2021-01-27;663;55;8393;75;2.4;0.0
94;2021-01-28;699;230;9092;305;2.6;0.1
94;2021-01-29;621;229;9713;534;2.8;0.2
94;2021-01-30;204;74;9917;608;2.9;0.2
94;2021-01-31;150;12;10067;620;2.9;0.2
94;2021-02-01;458;147;10525;767;3.1;0.2
94;2021-02-02;643;196;11168;963;3.2;0.3
94;2021-02-03;783;167;11951;1130;3.5;0.3
94;2021-02-04;714;298;12665;1428;3.7;0.4
94;2021-02-05;647;201;13312;1629;3.9;0.5
94;2021-02-06;207;75;13519;1704;3.9;0.5
94;2021-02-07;126;58;13645;1762;4.0;0.5
94;2021-02-08;322;366;13967;2128;4.1;0.6
94;2021-02-09;713;616;14680;2744;4.3;0.8
94;2021-02-10;643;430;15323;3174;4.4;0.9
94;2021-02-11;678;497;16001;3671;4.6;1.1
94;2021-02-12;636;428;16637;4099;4.8;1.2
94;2021-02-13;301;72;16938;4171;4.9;1.2
94;2021-02-14;195;78;17133;4249;5.0;1.2
94;2021-02-15;380;310;17513;4559;5.1;1.3
94;2021-02-16;634;604;18147;5163;5.3;1.5
94;2021-02-17;592;482;18739;5645;5.4;1.6
94;2021-02-18;550;545;19289;6190;5.6;1.8
94;2021-02-19;309;610;19598;6800;5.7;2.0
94;2021-02-20;275;200;19873;7000;5.8;2.0
94;2021-02-21;84;84;19957;7084;5.8;2.1
94;2021-02-22;211;406;20168;7490;5.9;2.2
94;2021-02-23;352;648;20520;8138;6.0;2.4
94;2021-02-24;298;609;20818;8747;6.0;2.5
94;2021-02-25;348;608;21166;9355;6.1;2.7
94;2021-02-26;420;555;21586;9910;6.3;2.9
94;2021-02-27;368;152;21954;10062;6.4;2.9
94;2021-02-28;70;123;22024;10185;6.4;3.0
94;2021-03-01;360;413;22384;10598;6.5;3.1
94;2021-03-02;549;655;22933;11253;6.7;3.3
94;2021-03-03;531;692;23464;11945;6.8;3.5
94;2021-03-04;950;635;24414;12580;7.1;3.6
94;2021-03-05;1584;674;25998;13254;7.5;3.8
94;2021-03-06;1843;164;27841;13418;8.1;3.9
94;2021-03-07;1381;100;29222;13518;8.5;3.9
94;2021-03-08;1228;324;30450;13842;8.8;4.0
94;2021-03-09;1313;656;31763;14498;9.2;4.2
94;2021-03-10;1259;578;33022;15076;9.6;4.4
94;2021-03-11;1307;635;34329;15711;10.0;4.6
94;2021-03-12;1516;540;35845;16251;10.4;4.7
94;2021-03-13;1118;303;36963;16554;10.7;4.8
94;2021-03-14;537;184;37500;16738;10.9;4.9
94;2021-03-15;886;400;38386;17138;11.1;5.0
94;2021-03-16;1065;641;39451;17779;11.4;5.2
94;2021-03-17;1225;530;40676;18309;11.8;5.3
94;2021-03-18;994;530;41670;18839;12.1;5.5
94;2021-03-19;1285;342;42955;19181;12.5;5.6
94;2021-03-20;1731;288;44686;19469;13.0;5.6
94;2021-03-21;1126;83;45812;19552;13.3;5.7
94;2021-03-22;888;187;46700;19739;13.5;5.7
94;2021-03-23;1302;319;48002;20058;13.9;5.8
94;2021-03-24;1686;305;49688;20363;14.4;5.9
94;2021-03-25;1752;295;51440;20658;14.9;6.0
94;2021-03-26;2025;345;53465;21003;15.5;6.1
94;2021-03-27;2271;227;55736;21230;16.2;6.2
94;2021-03-28;1070;217;56806;21447;16.5;6.2
94;2021-03-29;1021;312;57827;21759;16.8;6.3
94;2021-03-30;1351;556;59178;22315;17.2;6.5
94;2021-03-31;1427;488;60605;22803;17.6;6.6
94;2021-04-01;1636;679;62241;23482;18.1;6.8
94;2021-04-02;1859;1190;64100;24672;18.6;7.2
94;2021-04-03;1890;1127;65990;25799;19.1;7.5
94;2021-04-04;770;842;66760;26641;19.4;7.7
94;2021-04-05;629;806;67389;27447;19.6;8.0
94;2021-04-06;1580;913;68969;28360;20.0;8.2
94;2021-04-07;2006;848;70975;29208;20.6;8.5
94;2021-04-08;2174;756;73149;29964;21.2;8.7
94;2021-04-09;2099;948;75248;30912;21.8;9.0
94;2021-04-10;2402;625;77650;31537;22.5;9.1
94;2021-04-11;1173;315;78823;31852;22.9;9.2
94;2021-04-12;1517;896;80340;32748;23.3;9.5
94;2021-04-13;1384;1007;81724;33755;23.7;9.8
94;2021-04-14;2087;1075;83811;34830;24.3;10.1
94;2021-04-15;1909;1027;85720;35857;24.9;10.4
94;2021-04-16;1775;1038;87495;36895;25.4;10.7
94;2021-04-17;1749;1373;89244;38268;25.9;11.1
94;2021-04-18;1232;1278;90476;39546;26.2;11.5
94;2021-04-19;1089;772;91565;40318;26.6;11.7
94;2021-04-20;1249;1192;92814;41510;26.9;12.0
94;2021-04-21;1780;1333;94594;42843;27.4;12.4
94;2021-04-22;1821;1374;96415;44217;28.0;12.8
94;2021-04-23;1646;1403;98061;45620;28.4;13.2
94;2021-04-24;2031;1743;100092;47363;29.0;13.7
94;2021-04-25;1260;776;101352;48139;29.4;14.0
94;2021-04-26;1015;1145;102367;49284;29.7;14.3
94;2021-04-27;1308;1217;103675;50501;30.1;14.7
94;2021-04-28;2587;1272;106262;51773;30.8;15.0
94;2021-04-29;1968;1220;108230;52993;31.4;15.4
94;2021-04-30;2261;1878;110491;54871;32.1;15.9
94;2021-05-01;1423;1687;111914;56558;32.5;16.4
94;2021-05-02;1005;947;112919;57505;32.8;16.7
94;2021-05-03;1597;1066;114516;58571;33.2;17.0
94;2021-05-04;1556;1684;116072;60255;33.7;17.5
94;2021-05-05;1807;2357;117879;62612;34.2;18.2
94;2021-05-06;2187;1811;120066;64423;34.8;18.7
94;2021-05-07;2211;1816;122277;66239;35.5;19.2
94;2021-05-08;872;1352;123149;67591;35.7;19.6
94;2021-05-09;1173;1317;124322;68908;36.1;20.0
94;2021-05-10;1372;1536;125694;70444;36.5;20.4
94;2021-05-11;1576;1572;127270;72016;36.9;20.9
94;2021-05-12;1760;1374;129030;73390;37.4;21.3
94;2021-05-13;1936;511;130966;73901;38.0;21.4
94;2021-05-14;1510;1254;132476;75155;38.4;21.8
94;2021-05-15;1453;996;133929;76151;38.9;22.1
94;2021-05-16;1006;666;134935;76817;39.1;22.3
94;2021-05-17;1577;966;136512;77783;39.6;22.6
94;2021-05-18;1563;856;138075;78639;40.1;22.8
94;2021-05-19;1533;894;139608;79533;40.5;23.1
94;2021-05-20;1338;887;140946;80420;40.9;23.3
94;2021-05-21;1211;980;142157;81400;41.2;23.6
94;2021-05-22;998;694;143155;82094;41.5;23.8
94;2021-05-23;681;328;143836;82422;41.7;23.9
94;2021-05-24;162;146;143998;82568;41.8;24.0
94;2021-05-25;946;856;144944;83424;42.1;24.2
94;2021-05-26;946;1953;145890;85377;42.3;24.8
94;2021-05-27;820;2244;146710;87621;42.6;25.4
94;2021-05-28;816;1820;147526;89441;42.8;25.9
94;2021-05-29;637;1253;148163;90694;43.0;26.3
94;2021-05-30;222;548;148385;91242;43.1;26.5
94;2021-05-31;548;1241;148933;92483;43.2;26.8
94;2021-06-01;731;1770;149664;94253;43.4;27.3
94;2021-06-02;609;1927;150273;96180;43.6;27.9
94;2021-06-03;775;1642;151048;97822;43.8;28.4
94;2021-06-04;602;2344;151650;100166;44.0;29.1
94;2021-06-05;551;1934;152201;102100;44.2;29.6
94;2021-06-06;213;1040;152414;103140;44.2;29.9
94;2021-06-07;436;1608;152850;104748;44.3;30.4
94;2021-06-08;690;1869;153540;106617;44.5;30.9
94;2021-06-09;795;2491;154335;109108;44.8;31.7
94;2021-06-10;669;1792;155004;110900;45.0;32.2
94;2021-06-11;694;2294;155698;113194;45.2;32.8
94;2021-06-12;352;1207;156050;114401;45.3;33.2
94;2021-06-13;202;854;156252;115255;45.3;33.4
94;2021-06-14;420;2036;156672;117291;45.5;34.0
94;2021-06-15;547;1724;157219;119015;45.6;34.5
94;2021-06-16;572;1711;157791;120726;45.8;35.0
94;2021-06-17;607;1632;158398;122358;46.0;35.5
94;2021-06-18;574;1874;158972;124232;46.1;36.0
94;2021-06-19;342;1014;159314;125246;46.2;36.3
94;2021-06-20;188;888;159502;126134;46.3;36.6
94;2021-06-21;435;1756;159937;127890;46.4;37.1
94;2021-06-22;535;1951;160472;129841;46.6;37.7
94;2021-06-23;400;1439;160872;131280;46.7;38.1
94;2021-06-24;463;1124;161335;132404;46.8;38.4
