dep;jour;n_dose1;n_complet;n_rappel;n_cum_dose1;n_cum_complet;n_cum_rappel;couv_dose1;couv_complet;couv_rappel
01;2020-12-27;0;0;0;0;0;0;0.0;0.0;0.0
01;2020-12-28;0;0;0;0;0;0;0.0;0.0;0.0
01;2020-12-29;0;0;0;0;0;0;0.0;0.0;0.0
01;2020-12-30;0;0;0;0;0;0;0.0;0.0;0.0
01;2020-12-31;0;0;0;0;0;0;0.0;0.0;0.0
01;2021-01-01;0;0;0;0;0;0;0.0;0.0;0.0
01;2021-01-02;0;0;0;0;0;0;0.0;0.0;0.0
01;2021-01-03;0;0;0;0;0;0;0.0;0.0;0.0
01;2021-01-04;0;0;0;0;0;0;0.0;0.0;0.0
01;2021-01-05;10;2;0;10;2;0;0.0;0.0;0.0
01;2021-01-06;21;0;0;31;2;0;0.0;0.0;0.0
01;2021-01-07;112;0;0;143;2;0;0.0;0.0;0.0
01;2021-01-08;234;1;0;377;3;0;0.1;0.0;0.0
01;2021-01-09;30;1;0;407;4;0;0.1;0.0;0.0
01;2021-01-10;0;0;0;407;4;0;0.1;0.0;0.0
01;2021-01-11;224;0;0;631;4;0;0.1;0.0;0.0
01;2021-01-12;408;1;0;1039;5;0;0.2;0.0;0.0
01;2021-01-13;534;1;0;1573;6;0;0.2;0.0;0.0
01;2021-01-14;637;6;0;2210;12;0;0.3;0.0;0.0
01;2021-01-15;536;4;0;2746;16;0;0.4;0.0;0.0
01;2021-01-16;222;0;0;2968;16;0;0.5;0.0;0.0
01;2021-01-17;127;0;0;3095;16;0;0.5;0.0;0.0
01;2021-01-18;529;5;0;3624;21;0;0.6;0.0;0.0
01;2021-01-19;1103;3;0;4727;24;0;0.7;0.0;0.0
01;2021-01-20;1348;5;0;6075;29;0;0.9;0.0;0.0
01;2021-01-21;1225;9;0;7300;38;0;1.1;0.0;0.0
01;2021-01-22;828;3;0;8128;41;0;1.2;0.0;0.0
01;2021-01-23;283;2;0;8411;43;0;1.3;0.0;0.0
01;2021-01-24;72;1;0;8483;44;0;1.3;0.0;0.0
01;2021-01-25;635;2;0;9118;46;0;1.4;0.0;0.0
01;2021-01-26;813;5;0;9931;51;0;1.5;0.0;0.0
01;2021-01-27;664;15;0;10595;66;0;1.6;0.0;0.0
01;2021-01-28;753;81;0;11348;147;0;1.7;0.0;0.0
01;2021-01-29;690;140;0;12038;287;0;1.8;0.0;0.0
01;2021-01-30;229;14;0;12267;301;0;1.9;0.0;0.0
01;2021-01-31;57;0;0;12324;301;0;1.9;0.0;0.0
01;2021-02-01;522;130;0;12846;431;0;2.0;0.1;0.0
01;2021-02-02;528;230;0;13374;661;0;2.0;0.1;0.0
01;2021-02-03;450;325;0;13824;986;0;2.1;0.2;0.0
01;2021-02-04;548;484;0;14372;1470;0;2.2;0.2;0.0
01;2021-02-05;472;337;0;14844;1807;0;2.3;0.3;0.0
01;2021-02-06;265;139;0;15109;1946;0;2.3;0.3;0.0
01;2021-02-07;6;103;0;15115;2049;0;2.3;0.3;0.0
01;2021-02-08;553;468;0;15668;2517;0;2.4;0.4;0.0
01;2021-02-09;810;907;0;16478;3424;0;2.5;0.5;0.0
01;2021-02-10;890;760;0;17368;4184;0;2.6;0.6;0.0
01;2021-02-11;852;881;0;18220;5065;0;2.8;0.8;0.0
01;2021-02-12;700;607;0;18920;5672;0;2.9;0.9;0.0
01;2021-02-13;201;175;0;19121;5847;0;2.9;0.9;0.0
01;2021-02-14;6;12;0;19127;5859;0;2.9;0.9;0.0
01;2021-02-15;447;534;0;19574;6393;0;3.0;1.0;0.0
01;2021-02-16;656;495;0;20230;6888;0;3.1;1.0;0.0
01;2021-02-17;534;390;0;20764;7278;0;3.2;1.1;0.0
01;2021-02-18;610;636;0;21374;7914;0;3.3;1.2;0.0
01;2021-02-19;601;331;0;21975;8245;0;3.3;1.3;0.0
01;2021-02-20;170;136;0;22145;8381;0;3.4;1.3;0.0
01;2021-02-21;2;0;0;22147;8381;0;3.4;1.3;0.0
01;2021-02-22;462;639;0;22609;9020;0;3.4;1.4;0.0
01;2021-02-23;484;667;0;23093;9687;0;3.5;1.5;0.0
01;2021-02-24;447;534;0;23540;10221;0;3.6;1.6;0.0
01;2021-02-25;839;689;0;24379;10910;0;3.7;1.7;0.0
01;2021-02-26;968;584;0;25347;11494;0;3.9;1.7;0.0
01;2021-02-27;449;111;0;25796;11605;0;3.9;1.8;0.0
01;2021-02-28;29;8;0;25825;11613;0;3.9;1.8;0.0
01;2021-03-01;651;504;0;26476;12117;0;4.0;1.8;0.0
01;2021-03-02;1065;590;0;27541;12707;0;4.2;1.9;0.0
01;2021-03-03;1072;669;0;28613;13376;0;4.4;2.0;0.0
01;2021-03-04;1380;664;0;29993;14040;0;4.6;2.1;0.0
01;2021-03-05;1518;549;0;31511;14589;0;4.8;2.2;0.0
01;2021-03-06;873;118;0;32384;14707;0;4.9;2.2;0.0
01;2021-03-07;97;3;0;32481;14710;0;4.9;2.2;0.0
01;2021-03-08;846;729;0;33327;15439;0;5.1;2.4;0.0
01;2021-03-09;1517;654;0;34844;16093;0;5.3;2.4;0.0
01;2021-03-10;1318;632;0;36162;16725;0;5.5;2.5;0.0
01;2021-03-11;1918;719;0;38080;17444;0;5.8;2.7;0.0
01;2021-03-12;2331;750;0;40411;18194;0;6.2;2.8;0.0
01;2021-03-13;1683;96;0;42094;18290;0;6.4;2.8;0.0
01;2021-03-14;280;59;0;42374;18349;0;6.5;2.8;0.0
01;2021-03-15;1278;473;0;43652;18822;0;6.6;2.9;0.0
01;2021-03-16;1224;557;0;44876;19379;0;6.8;2.9;0.0
01;2021-03-17;1110;361;0;45986;19740;0;7.0;3.0;0.0
01;2021-03-18;1492;551;0;47478;20291;0;7.2;3.1;0.0
01;2021-03-19;1890;582;0;49368;20873;0;7.5;3.2;0.0
01;2021-03-20;1449;109;0;50817;20982;0;7.7;3.2;0.0
01;2021-03-21;148;12;0;50965;20994;0;7.8;3.2;0.0
01;2021-03-22;1639;533;0;52604;21527;0;8.0;3.3;0.0
01;2021-03-23;2324;655;0;54928;22182;0;8.4;3.4;0.0
01;2021-03-24;1732;486;0;56660;22668;0;8.6;3.5;0.0
01;2021-03-25;3016;661;0;59676;23329;0;9.1;3.6;0.0
01;2021-03-26;3035;590;0;62711;23919;0;9.5;3.6;0.0
01;2021-03-27;1346;144;0;64057;24063;0;9.8;3.7;0.0
01;2021-03-28;79;9;0;64136;24072;0;9.8;3.7;0.0
01;2021-03-29;1931;648;0;66067;24720;0;10.1;3.8;0.0
01;2021-03-30;2539;830;0;68606;25550;0;10.4;3.9;0.0
01;2021-03-31;1970;807;0;70576;26357;0;10.7;4.0;0.0
01;2021-04-01;2718;943;0;73294;27300;0;11.2;4.2;0.0
01;2021-04-02;2920;835;0;76214;28135;0;11.6;4.3;0.0
01;2021-04-03;1356;214;0;77570;28349;0;11.8;4.3;0.0
01;2021-04-04;247;34;0;77817;28383;0;11.8;4.3;0.0
01;2021-04-05;1315;84;0;79132;28467;0;12.0;4.3;0.0
01;2021-04-06;2781;962;0;81913;29429;0;12.5;4.5;0.0
01;2021-04-07;2737;910;0;84650;30339;0;12.9;4.6;0.0
01;2021-04-08;3378;1202;0;88028;31541;0;13.4;4.8;0.0
01;2021-04-09;4032;1506;0;92060;33047;0;14.0;5.0;0.0
01;2021-04-10;1749;360;0;93809;33407;0;14.3;5.1;0.0
01;2021-04-11;156;109;0;93965;33516;0;14.3;5.1;0.0
01;2021-04-12;2728;1341;0;96693;34857;0;14.7;5.3;0.0
01;2021-04-13;2885;1548;0;99578;36405;0;15.2;5.5;0.0
01;2021-04-14;3037;1289;0;102615;37694;0;15.6;5.7;0.0
01;2021-04-15;3139;1551;0;105754;39245;0;16.1;6.0;0.0
01;2021-04-16;2978;1606;0;108732;40851;0;16.6;6.2;0.0
01;2021-04-17;1747;723;0;110479;41574;0;16.8;6.3;0.0
01;2021-04-18;166;61;0;110645;41635;0;16.8;6.3;0.0
01;2021-04-19;2239;1666;0;112884;43301;0;17.2;6.6;0.0
01;2021-04-20;2633;1667;0;115517;44968;0;17.6;6.8;0.0
01;2021-04-21;2722;1519;0;118239;46487;0;18.0;7.1;0.0
01;2021-04-22;2929;1768;0;121168;48255;0;18.4;7.3;0.0
01;2021-04-23;2859;1605;0;124027;49860;0;18.9;7.6;0.0
01;2021-04-24;1337;591;0;125364;50451;0;19.1;7.7;0.0
01;2021-04-25;142;30;0;125506;50481;0;19.1;7.7;0.0
01;2021-04-26;2113;1807;0;127619;52288;0;19.4;8.0;0.0
01;2021-04-27;2652;1656;0;130271;53944;0;19.8;8.2;0.0
01;2021-04-28;2643;1597;0;132914;55541;0;20.2;8.5;0.0
01;2021-04-29;2960;1884;0;135874;57425;0;20.7;8.7;0.0
01;2021-04-30;3278;2397;0;139152;59822;0;21.2;9.1;0.0
01;2021-05-01;1368;793;0;140520;60615;0;21.4;9.2;0.0
01;2021-05-02;673;297;0;141193;60912;0;21.5;9.3;0.0
01;2021-05-03;2570;2655;0;143763;63567;0;21.9;9.7;0.0
01;2021-05-04;2713;2813;0;146476;66380;0;22.3;10.1;0.0
01;2021-05-05;3081;2590;0;149557;68970;0;22.8;10.5;0.0
01;2021-05-06;3491;2736;0;153048;71706;0;23.3;10.9;0.0
01;2021-05-07;3627;2890;0;156675;74596;0;23.8;11.4;0.0
01;2021-05-08;1569;940;0;158244;75536;0;24.1;11.5;0.0
01;2021-05-09;1164;253;0;159408;75789;0;24.3;11.5;0.0
01;2021-05-10;2866;3075;0;162274;78864;0;24.7;12.0;0.0
01;2021-05-11;3992;3137;0;166266;82001;0;25.3;12.5;0.0
01;2021-05-12;4063;3121;0;170329;85122;0;25.9;13.0;0.0
01;2021-05-13;3541;1412;0;173870;86534;0;26.5;13.2;0.0
01;2021-05-14;4453;2403;0;178323;88937;0;27.1;13.5;0.0
01;2021-05-15;3040;1445;0;181363;90382;0;27.6;13.8;0.0
01;2021-05-16;1560;223;0;182923;90605;0;27.8;13.8;0.0
01;2021-05-17;3660;2589;0;186583;93194;0;28.4;14.2;0.0
01;2021-05-18;4288;2228;0;190871;95422;0;29.1;14.5;0.0
01;2021-05-19;4439;2069;0;195310;97491;0;29.7;14.8;0.0
01;2021-05-20;4562;2209;0;199872;99700;0;30.4;15.2;0.0
01;2021-05-21;4488;2379;0;204360;102079;0;31.1;15.5;0.0
01;2021-05-22;3197;1028;0;207557;103107;0;31.6;15.7;0.0
01;2021-05-23;1012;136;0;208569;103243;0;31.7;15.7;0.0
01;2021-05-24;2519;471;0;211088;103714;0;32.1;15.8;0.0
01;2021-05-25;3510;2565;0;214598;106279;0;32.7;16.2;0.0
01;2021-05-26;3617;2383;0;218215;108662;0;33.2;16.5;0.0
01;2021-05-27;3955;2334;0;222170;110996;0;33.8;16.9;0.0
01;2021-05-28;3726;2858;0;225896;113854;0;34.4;17.3;0.0
01;2021-05-29;2824;1524;0;228720;115378;0;34.8;17.6;0.0
01;2021-05-30;720;278;0;229440;115656;0;34.9;17.6;0.0
01;2021-05-31;2917;2564;0;232357;118220;0;35.4;18.0;0.0
01;2021-06-01;3306;2781;0;235663;121001;0;35.9;18.4;0.0
01;2021-06-02;3499;2370;0;239162;123371;0;36.4;18.8;0.0
01;2021-06-03;4088;2625;0;243250;125996;0;37.0;19.2;0.0
01;2021-06-04;4836;3577;0;248086;129573;0;37.8;19.7;0.0
01;2021-06-05;3436;1683;0;251522;131256;0;38.3;20.0;0.0
01;2021-06-06;1099;202;0;252621;131458;0;38.5;20.0;0.0
01;2021-06-07;3970;3070;0;256591;134528;0;39.1;20.5;0.0
01;2021-06-08;4462;3058;0;261053;137586;0;39.7;20.9;0.0
01;2021-06-09;3689;2679;0;264742;140265;0;40.3;21.4;0.0
01;2021-06-10;3648;2483;0;268390;142748;0;40.9;21.7;0.0
01;2021-06-11;4031;3708;0;272421;146456;0;41.5;22.3;0.0
01;2021-06-12;2813;2148;0;275234;148604;0;41.9;22.6;0.0
01;2021-06-13;543;615;0;275777;149219;0;42.0;22.7;0.0
01;2021-06-14;2667;3361;0;278444;152580;0;42.4;23.2;0.0
01;2021-06-15;2733;3646;0;281177;156226;0;42.8;23.8;0.0
01;2021-06-16;2942;3618;0;284119;159844;0;43.2;24.3;0.0
01;2021-06-17;2697;3674;0;286816;163518;0;43.7;24.9;0.0
01;2021-06-18;3285;4647;0;290101;168165;0;44.2;25.6;0.0
01;2021-06-19;2189;2645;0;292290;170810;0;44.5;26.0;0.0
01;2021-06-20;532;823;0;292822;171633;0;44.6;26.1;0.0
01;2021-06-21;2042;4051;0;294864;175684;0;44.9;26.7;0.0
01;2021-06-22;1876;4424;0;296740;180108;0;45.2;27.4;0.0
01;2021-06-23;1952;3998;0;298692;184106;0;45.5;28.0;0.0
01;2021-06-24;1893;4010;0;300585;188116;0;45.8;28.6;0.0
01;2021-06-25;2254;5057;0;302839;193173;0;46.1;29.4;0.0
01;2021-06-26;1342;3034;0;304181;196207;0;46.3;29.9;0.0
01;2021-06-27;357;853;0;304538;197060;0;46.4;30.0;0.0
01;2021-06-28;1542;4539;0;306080;201599;0;46.6;30.7;0.0
01;2021-06-29;1660;4425;0;307740;206024;0;46.8;31.4;0.0
01;2021-06-30;1715;4703;0;309455;210727;0;47.1;32.1;0.0
01;2021-07-01;1923;4457;0;311378;215184;0;47.4;32.8;0.0
01;2021-07-02;2087;5223;0;313465;220407;0;47.7;33.5;0.0
01;2021-07-03;1155;3445;0;314620;223852;0;47.9;34.1;0.0
01;2021-07-04;352;891;0;314972;224743;0;47.9;34.2;0.0
01;2021-07-05;1933;4474;0;316905;229217;0;48.2;34.9;0.0
01;2021-07-06;1553;4781;0;318458;233998;0;48.5;35.6;0.0
01;2021-07-07;2130;4057;0;320588;238055;0;48.8;36.2;0.0
01;2021-07-08;1920;4003;0;322508;242058;0;49.1;36.8;0.0
01;2021-07-09;2295;5024;0;324803;247082;0;49.4;37.6;0.0
01;2021-07-10;1307;3509;0;326110;250591;0;49.6;38.1;0.0
01;2021-07-11;406;752;0;326516;251343;0;49.7;38.3;0.0
01;2021-07-12;1793;4784;0;328309;256127;0;50.0;39.0;0.0
01;2021-07-13;2505;5171;0;330814;261298;0;50.4;39.8;0.0
01;2021-07-14;672;749;0;331486;262047;0;50.5;39.9;0.0
01;2021-07-15;3379;5245;0;334865;267292;0;51.0;40.7;0.0
01;2021-07-16;4202;5758;0;339067;273050;0;51.6;41.6;0.0
01;2021-07-17;2417;3533;0;341484;276583;0;52.0;42.1;0.0
01;2021-07-18;607;1118;0;342091;277701;0;52.1;42.3;0.0
01;2021-07-19;3129;4783;0;345220;282484;0;52.5;43.0;0.0
01;2021-07-20;3766;4767;0;348986;287251;0;53.1;43.7;0.0
01;2021-07-21;4282;4583;0;353268;291834;0;53.8;44.4;0.0
01;2021-07-22;4541;4332;0;357809;296166;0;54.5;45.1;0.0
01;2021-07-23;4466;5205;0;362275;301371;0;55.1;45.9;0.0
01;2021-07-24;2652;3187;0;364927;304558;0;55.5;46.4;0.0
01;2021-07-25;451;531;0;365378;305089;0;55.6;46.4;0.0
01;2021-07-26;3863;4022;0;369241;309111;0;56.2;47.1;0.0
01;2021-07-27;4621;3534;0;373862;312645;0;56.9;47.6;0.0
01;2021-07-28;4577;3397;0;378439;316042;0;57.6;48.1;0.0
01;2021-07-29;5175;3070;0;383614;319112;0;58.4;48.6;0.0
01;2021-07-30;5082;4064;0;388696;323176;0;59.2;49.2;0.0
01;2021-07-31;3601;2124;0;392297;325300;0;59.7;49.5;0.0
01;2021-08-01;820;408;0;393117;325708;0;59.8;49.6;0.0
01;2021-08-02;3672;3030;1;396789;328738;1;60.4;50.0;0.0
01;2021-08-03;3750;2882;0;400539;331620;1;61.0;50.5;0.0
01;2021-08-04;3437;2253;0;403976;333873;1;61.5;50.8;0.0
01;2021-08-05;2932;2794;0;406908;336667;1;61.9;51.2;0.0
01;2021-08-06;3289;3595;0;410197;340262;1;62.4;51.8;0.0
01;2021-08-07;1988;1881;0;412185;342143;1;62.7;52.1;0.0
01;2021-08-08;512;328;0;412697;342471;1;62.8;52.1;0.0
01;2021-08-09;1771;3162;0;414468;345633;1;63.1;52.6;0.0
01;2021-08-10;2057;2997;0;416525;348630;1;63.4;53.1;0.0
01;2021-08-11;1971;3034;0;418496;351664;1;63.7;53.5;0.0
01;2021-08-12;1962;3321;0;420458;354985;1;64.0;54.0;0.0
01;2021-08-13;2147;3392;0;422605;358377;1;64.3;54.6;0.0
01;2021-08-14;1453;2211;0;424058;360588;1;64.5;54.9;0.0
01;2021-08-15;98;259;0;424156;360847;1;64.6;54.9;0.0
01;2021-08-16;1300;3513;0;425456;364360;1;64.8;55.5;0.0
01;2021-08-17;1636;3173;0;427092;367533;1;65.0;55.9;0.0
01;2021-08-18;1385;3241;0;428477;370774;1;65.2;56.4;0.0
01;2021-08-19;1369;2836;0;429846;373610;1;65.4;56.9;0.0
01;2021-08-20;1605;4277;0;431451;377887;1;65.7;57.5;0.0
01;2021-08-21;848;2608;0;432299;380495;1;65.8;57.9;0.0
01;2021-08-22;90;126;0;432389;380621;1;65.8;57.9;0.0
01;2021-08-23;1183;3783;0;433572;384404;1;66.0;58.5;0.0
01;2021-08-24;1372;3855;0;434944;388259;1;66.2;59.1;0.0
01;2021-08-25;1225;3718;0;436169;391977;1;66.4;59.7;0.0
01;2021-08-26;1665;3304;0;437834;395281;1;66.6;60.2;0.0
01;2021-08-27;1636;4352;0;439470;399633;1;66.9;60.8;0.0
01;2021-08-28;927;2717;0;440397;402350;1;67.0;61.2;0.0
01;2021-08-29;76;484;0;440473;402834;1;67.0;61.3;0.0
01;2021-08-30;1244;3499;27;441717;406333;28;67.2;61.9;0.0
01;2021-08-31;1208;2703;64;442925;409036;92;67.4;62.3;0.0
01;2021-09-01;1217;2280;205;444142;411316;297;67.6;62.6;0.0
01;2021-09-02;983;1902;302;445125;413218;599;67.8;62.9;0.1
01;2021-09-03;1237;2718;254;446362;415936;853;67.9;63.3;0.1
01;2021-09-04;778;2184;88;447140;418120;941;68.1;63.6;0.1
01;2021-09-05;185;246;32;447325;418366;973;68.1;63.7;0.1
01;2021-09-06;676;1322;380;448001;419688;1353;68.2;63.9;0.2
01;2021-09-07;611;1268;255;448612;420956;1608;68.3;64.1;0.2
01;2021-09-08;865;1627;250;449477;422583;1858;68.4;64.3;0.3
01;2021-09-09;764;1220;223;450241;423803;2081;68.5;64.5;0.3
01;2021-09-10;1055;1796;363;451296;425599;2444;68.7;64.8;0.4
01;2021-09-11;689;1468;68;451985;427067;2512;68.8;65.0;0.4
01;2021-09-12;43;96;5;452028;427163;2517;68.8;65.0;0.4
01;2021-09-13;616;1175;357;452644;428338;2874;68.9;65.2;0.4
01;2021-09-14;617;1050;516;453261;429388;3390;69.0;65.4;0.5
01;2021-09-15;778;1531;458;454039;430919;3848;69.1;65.6;0.6
01;2021-09-16;564;988;480;454603;431907;4328;69.2;65.7;0.7
01;2021-09-17;729;1572;508;455332;433479;4836;69.3;66.0;0.7
01;2021-09-18;364;1220;56;455696;434699;4892;69.4;66.2;0.7
01;2021-09-19;47;104;16;455743;434803;4908;69.4;66.2;0.7
01;2021-09-20;365;717;503;456108;435520;5411;69.4;66.3;0.8
01;2021-09-21;409;808;692;456517;436328;6103;69.5;66.4;0.9
01;2021-09-22;369;1109;480;456886;437437;6583;69.5;66.6;1.0
01;2021-09-23;344;778;474;457230;438215;7057;69.6;66.7;1.1
01;2021-09-24;408;1077;410;457638;439292;7467;69.7;66.9;1.1
01;2021-09-25;277;969;82;457915;440261;7549;69.7;67.0;1.1
01;2021-09-26;19;115;2;457934;440376;7551;69.7;67.0;1.1
01;2021-09-27;195;603;201;458129;440979;7752;69.7;67.1;1.2
01;2021-09-28;320;1144;548;458449;442123;8300;69.8;67.3;1.3
01;2021-09-29;450;1333;457;458899;443456;8757;69.9;67.5;1.3
01;2021-09-30;375;809;446;459274;444265;9203;69.9;67.6;1.4
01;2021-10-01;546;1203;520;459820;445468;9723;70.0;67.8;1.5
01;2021-10-02;417;1242;178;460237;446710;9901;70.1;68.0;1.5
01;2021-10-03;27;62;13;460264;446772;9914;70.1;68.0;1.5
01;2021-10-04;228;566;380;460492;447338;10294;70.1;68.1;1.6
01;2021-10-05;246;547;538;460738;447885;10832;70.1;68.2;1.6
01;2021-10-06;404;804;498;461142;448689;11330;70.2;68.3;1.7
01;2021-10-07;236;516;506;461378;449205;11836;70.2;68.4;1.8
01;2021-10-08;391;778;585;461769;449983;12421;70.3;68.5;1.9
01;2021-10-09;343;678;269;462112;450661;12690;70.3;68.6;1.9
01;2021-10-10;12;28;2;462124;450689;12692;70.3;68.6;1.9
01;2021-10-11;208;478;541;462332;451167;13233;70.4;68.7;2.0
01;2021-10-12;203;391;538;462535;451558;13771;70.4;68.7;2.1
01;2021-10-13;368;591;819;462903;452149;14590;70.5;68.8;2.2
01;2021-10-14;191;578;508;463094;452727;15098;70.5;68.9;2.3
01;2021-10-15;385;564;765;463479;453291;15863;70.5;69.0;2.4
01;2021-10-16;294;447;318;463773;453738;16181;70.6;69.1;2.5
01;2021-10-17;10;30;1;463783;453768;16182;70.6;69.1;2.5
01;2021-10-18;171;265;662;463954;454033;16844;70.6;69.1;2.6
01;2021-10-19;129;301;633;464083;454334;17477;70.6;69.2;2.7
01;2021-10-20;232;475;932;464315;454809;18409;70.7;69.2;2.8
01;2021-10-21;104;377;623;464419;455186;19032;70.7;69.3;2.9
01;2021-10-22;162;542;766;464581;455728;19798;70.7;69.4;3.0
01;2021-10-23;113;467;375;464694;456195;20173;70.7;69.4;3.1
01;2021-10-24;5;7;8;464699;456202;20181;70.7;69.4;3.1
01;2021-10-25;147;242;781;464846;456444;20962;70.8;69.5;3.2
01;2021-10-26;96;186;640;464942;456630;21602;70.8;69.5;3.3
01;2021-10-27;190;394;906;465132;457024;22508;70.8;69.6;3.4
01;2021-10-28;95;173;598;465227;457197;23106;70.8;69.6;3.5
01;2021-10-29;144;315;897;465371;457512;24003;70.8;69.6;3.7
01;2021-10-30;100;346;470;465471;457858;24473;70.9;69.7;3.7
01;2021-10-31;3;11;12;465474;457869;24485;70.9;69.7;3.7
01;2021-11-01;9;11;7;465483;457880;24492;70.9;69.7;3.7
01;2021-11-02;68;185;636;465551;458065;25128;70.9;69.7;3.8
01;2021-11-03;166;391;1307;465717;458456;26435;70.9;69.8;4.0
01;2021-11-04;93;152;816;465810;458608;27251;70.9;69.8;4.1
01;2021-11-05;152;312;1125;465962;458920;28376;70.9;69.9;4.3
01;2021-11-06;89;297;684;466051;459217;29060;70.9;69.9;4.4
01;2021-11-07;1;14;8;466052;459231;29068;70.9;69.9;4.4
01;2021-11-08;99;229;1378;466151;459460;30446;71.0;69.9;4.6
01;2021-11-09;81;192;1294;466232;459652;31740;71.0;70.0;4.8
01;2021-11-10;190;304;1957;466422;459956;33697;71.0;70.0;5.1
01;2021-11-11;9;11;47;466431;459967;33744;71.0;70.0;5.1
01;2021-11-12;106;203;1528;466537;460170;35272;71.0;70.0;5.4
01;2021-11-13;139;165;1117;466676;460335;36389;71.0;70.1;5.5
01;2021-11-14;6;11;18;466682;460346;36407;71.0;70.1;5.5
01;2021-11-15;82;118;1674;466764;460464;38081;71.0;70.1;5.8
01;2021-11-16;91;159;1721;466855;460623;39802;71.1;70.1;6.1
01;2021-11-17;156;279;2384;467011;460902;42186;71.1;70.2;6.4
01;2021-11-18;94;141;1719;467105;461043;43905;71.1;70.2;6.7
01;2021-11-19;150;243;2255;467255;461286;46160;71.1;70.2;7.0
01;2021-11-20;159;152;1294;467414;461438;47454;71.1;70.2;7.2
01;2021-11-21;4;20;12;467418;461458;47466;71.1;70.2;7.2
01;2021-11-22;76;132;2140;467494;461590;49606;71.2;70.3;7.6
01;2021-11-23;110;113;2257;467604;461703;51863;71.2;70.3;7.9
01;2021-11-24;231;250;2820;467835;461953;54683;71.2;70.3;8.3
01;2021-11-25;98;120;2329;467933;462073;57012;71.2;70.3;8.7
01;2021-11-26;159;183;3631;468092;462256;60643;71.3;70.4;9.2
01;2021-11-27;169;190;2273;468261;462446;62916;71.3;70.4;9.6
01;2021-11-28;4;7;498;468265;462453;63414;71.3;70.4;9.7
01;2021-11-29;91;142;3979;468356;462595;67393;71.3;70.4;10.3
01;2021-11-30;88;117;3856;468444;462712;71249;71.3;70.4;10.8
01;2021-12-01;86;172;3394;468530;462884;74643;71.3;70.5;11.4
01;2021-12-02;88;110;4376;468618;462994;79019;71.3;70.5;12.0
01;2021-12-03;118;186;5629;468736;463180;84648;71.3;70.5;12.9
01;2021-12-04;86;176;3013;468822;463356;87661;71.4;70.5;13.3
01;2021-12-05;15;18;1043;468837;463374;88704;71.4;70.5;13.5
01;2021-12-06;88;132;5160;468925;463506;93864;71.4;70.6;14.3
01;2021-12-07;126;148;6671;469051;463654;100535;71.4;70.6;15.3
01;2021-12-08;103;209;5271;469154;463863;105806;71.4;70.6;16.1
01;2021-12-09;97;122;6103;469251;463985;111909;71.4;70.6;17.0
01;2021-12-10;135;199;7046;469386;464184;118955;71.4;70.7;18.1
01;2021-12-11;87;149;3743;469473;464333;122698;71.5;70.7;18.7
01;2021-12-12;15;20;1053;469488;464353;123751;71.5;70.7;18.8
01;2021-12-13;89;139;7026;469577;464492;130777;71.5;70.7;19.9
01;2021-12-14;132;192;8609;469709;464684;139386;71.5;70.7;21.2
01;2021-12-15;127;223;7586;469836;464907;146972;71.5;70.8;22.4
01;2021-12-16;115;147;8026;469951;465054;154998;71.5;70.8;23.6
02;2020-12-27;1;0;0;1;0;0;0.0;0.0;0.0
02;2020-12-28;0;0;0;1;0;0;0.0;0.0;0.0
02;2020-12-29;0;0;0;1;0;0;0.0;0.0;0.0
02;2020-12-30;0;0;0;1;0;0;0.0;0.0;0.0
02;2020-12-31;0;0;0;1;0;0;0.0;0.0;0.0
02;2021-01-01;0;0;0;1;0;0;0.0;0.0;0.0
02;2021-01-02;0;0;0;1;0;0;0.0;0.0;0.0
02;2021-01-03;0;0;0;1;0;0;0.0;0.0;0.0
02;2021-01-04;1;0;0;2;0;0;0.0;0.0;0.0
02;2021-01-05;2;0;0;4;0;0;0.0;0.0;0.0
02;2021-01-06;25;0;0;29;0;0;0.0;0.0;0.0
02;2021-01-07;262;2;0;291;2;0;0.1;0.0;0.0
02;2021-01-08;502;2;0;793;4;0;0.2;0.0;0.0
02;2021-01-09;77;0;0;870;4;0;0.2;0.0;0.0
02;2021-01-10;52;0;0;922;4;0;0.2;0.0;0.0
02;2021-01-11;267;0;0;1189;4;0;0.2;0.0;0.0
02;2021-01-12;356;1;0;1545;5;0;0.3;0.0;0.0
02;2021-01-13;458;4;0;2003;9;0;0.4;0.0;0.0
02;2021-01-14;654;9;0;2657;18;0;0.5;0.0;0.0
02;2021-01-15;614;7;0;3271;25;0;0.6;0.0;0.0
02;2021-01-16;315;4;0;3586;29;0;0.7;0.0;0.0
02;2021-01-17;56;0;0;3642;29;0;0.7;0.0;0.0
02;2021-01-18;757;8;0;4399;37;0;0.8;0.0;0.0
02;2021-01-19;935;5;0;5334;42;0;1.0;0.0;0.0
02;2021-01-20;1320;7;0;6654;49;0;1.3;0.0;0.0
02;2021-01-21;2337;12;0;8991;61;0;1.7;0.0;0.0
02;2021-01-22;1375;6;0;10366;67;0;2.0;0.0;0.0
02;2021-01-23;296;3;0;10662;70;0;2.0;0.0;0.0
02;2021-01-24;61;1;0;10723;71;0;2.0;0.0;0.0
02;2021-01-25;430;13;0;11153;84;0;2.1;0.0;0.0
02;2021-01-26;648;18;0;11801;102;0;2.2;0.0;0.0
02;2021-01-27;188;4;0;11989;106;0;2.3;0.0;0.0
02;2021-01-28;112;229;0;12101;335;0;2.3;0.1;0.0
02;2021-01-29;142;415;0;12243;750;0;2.3;0.1;0.0
02;2021-01-30;13;16;0;12256;766;0;2.3;0.1;0.0
02;2021-01-31;1;10;0;12257;776;0;2.3;0.1;0.0
02;2021-02-01;18;208;0;12275;984;0;2.3;0.2;0.0
02;2021-02-02;71;307;0;12346;1291;0;2.3;0.2;0.0
02;2021-02-03;142;331;0;12488;1622;0;2.4;0.3;0.0
02;2021-02-04;255;363;0;12743;1985;0;2.4;0.4;0.0
02;2021-02-05;234;415;0;12977;2400;0;2.5;0.5;0.0
02;2021-02-06;65;162;0;13042;2562;0;2.5;0.5;0.0
02;2021-02-07;8;1;0;13050;2563;0;2.5;0.5;0.0
02;2021-02-08;297;428;0;13347;2991;0;2.5;0.6;0.0
02;2021-02-09;328;667;0;13675;3658;0;2.6;0.7;0.0
02;2021-02-10;464;992;0;14139;4650;0;2.7;0.9;0.0
02;2021-02-11;882;1671;0;15021;6321;0;2.9;1.2;0.0
02;2021-02-12;834;1007;0;15855;7328;0;3.0;1.4;0.0
02;2021-02-13;280;157;0;16135;7485;0;3.1;1.4;0.0
02;2021-02-14;1;3;0;16136;7488;0;3.1;1.4;0.0
02;2021-02-15;338;680;0;16474;8168;0;3.1;1.6;0.0
02;2021-02-16;423;550;0;16897;8718;0;3.2;1.7;0.0
02;2021-02-17;501;621;0;17398;9339;0;3.3;1.8;0.0
02;2021-02-18;521;452;0;17919;9791;0;3.4;1.9;0.0
02;2021-02-19;441;558;0;18360;10349;0;3.5;2.0;0.0
02;2021-02-20;365;226;0;18725;10575;0;3.6;2.0;0.0
02;2021-02-21;31;19;0;18756;10594;0;3.6;2.0;0.0
02;2021-02-22;368;334;0;19124;10928;0;3.6;2.1;0.0
02;2021-02-23;444;372;0;19568;11300;0;3.7;2.1;0.0
02;2021-02-24;608;175;0;20176;11475;0;3.8;2.2;0.0
02;2021-02-25;883;183;0;21059;11658;0;4.0;2.2;0.0
02;2021-02-26;835;113;0;21894;11771;0;4.2;2.2;0.0
02;2021-02-27;455;24;0;22349;11795;0;4.2;2.2;0.0
02;2021-02-28;49;1;0;22398;11796;0;4.3;2.2;0.0
02;2021-03-01;665;33;0;23063;11829;0;4.4;2.2;0.0
02;2021-03-02;999;162;0;24062;11991;0;4.6;2.3;0.0
02;2021-03-03;769;206;0;24831;12197;0;4.7;2.3;0.0
02;2021-03-04;1189;627;0;26020;12824;0;4.9;2.4;0.0
02;2021-03-05;1099;510;0;27119;13334;0;5.2;2.5;0.0
02;2021-03-06;2180;118;0;29299;13452;0;5.6;2.6;0.0
02;2021-03-07;1497;56;0;30796;13508;0;5.9;2.6;0.0
02;2021-03-08;610;363;0;31406;13871;0;6.0;2.6;0.0
02;2021-03-09;1014;418;0;32420;14289;0;6.2;2.7;0.0
02;2021-03-10;926;452;0;33346;14741;0;6.3;2.8;0.0
02;2021-03-11;1367;387;0;34713;15128;0;6.6;2.9;0.0
02;2021-03-12;1767;405;0;36480;15533;0;6.9;3.0;0.0
02;2021-03-13;2653;243;0;39133;15776;0;7.4;3.0;0.0
02;2021-03-14;1390;46;0;40523;15822;0;7.7;3.0;0.0
02;2021-03-15;636;407;0;41159;16229;0;7.8;3.1;0.0
02;2021-03-16;881;411;0;42040;16640;0;8.0;3.2;0.0
02;2021-03-17;789;460;0;42829;17100;0;8.1;3.3;0.0
02;2021-03-18;691;634;0;43520;17734;0;8.3;3.4;0.0
02;2021-03-19;1249;305;0;44769;18039;0;8.5;3.4;0.0
02;2021-03-20;2472;164;0;47241;18203;0;9.0;3.5;0.0
02;2021-03-21;1406;78;0;48647;18281;0;9.2;3.5;0.0
02;2021-03-22;801;483;0;49448;18764;0;9.4;3.6;0.0
02;2021-03-23;1270;557;0;50718;19321;0;9.6;3.7;0.0
02;2021-03-24;1674;516;0;52392;19837;0;10.0;3.8;0.0
02;2021-03-25;1836;607;0;54228;20444;0;10.3;3.9;0.0
02;2021-03-26;2508;501;0;56736;20945;0;10.8;4.0;0.0
02;2021-03-27;2525;158;0;59261;21103;0;11.3;4.0;0.0
02;2021-03-28;692;21;0;59953;21124;0;11.4;4.0;0.0
02;2021-03-29;1118;853;0;61071;21977;0;11.6;4.2;0.0
02;2021-03-30;1633;838;0;62704;22815;0;11.9;4.3;0.0
02;2021-03-31;1401;733;0;64105;23548;0;12.2;4.5;0.0
02;2021-04-01;1408;871;0;65513;24419;0;12.5;4.6;0.0
02;2021-04-02;1351;1212;0;66864;25631;0;12.7;4.9;0.0
02;2021-04-03;2645;869;0;69509;26500;0;13.2;5.0;0.0
02;2021-04-04;729;241;0;70238;26741;0;13.4;5.1;0.0
02;2021-04-05;1533;133;0;71771;26874;0;13.6;5.1;0.0
02;2021-04-06;1561;867;0;73332;27741;0;13.9;5.3;0.0
02;2021-04-07;1861;802;0;75193;28543;0;14.3;5.4;0.0
02;2021-04-08;1981;1143;0;77174;29686;0;14.7;5.6;0.0
02;2021-04-09;2573;1141;0;79747;30827;0;15.2;5.9;0.0
02;2021-04-10;2554;1212;0;82301;32039;0;15.6;6.1;0.0
02;2021-04-11;498;421;0;82799;32460;0;15.7;6.2;0.0
02;2021-04-12;1836;645;0;84635;33105;0;16.1;6.3;0.0
02;2021-04-13;1705;946;0;86340;34051;0;16.4;6.5;0.0
02;2021-04-14;2727;1005;0;89067;35056;0;16.9;6.7;0.0
02;2021-04-15;2740;869;0;91807;35925;0;17.5;6.8;0.0
02;2021-04-16;2590;1184;0;94397;37109;0;17.9;7.1;0.0
02;2021-04-17;1921;2129;0;96318;39238;0;18.3;7.5;0.0
02;2021-04-18;272;785;0;96590;40023;0;18.4;7.6;0.0
02;2021-04-19;1228;689;0;97818;40712;0;18.6;7.7;0.0
02;2021-04-20;1718;840;0;99536;41552;0;18.9;7.9;0.0
02;2021-04-21;1664;1080;0;101200;42632;0;19.2;8.1;0.0
02;2021-04-22;1883;840;0;103083;43472;0;19.6;8.3;0.0
02;2021-04-23;2074;1443;0;105157;44915;0;20.0;8.5;0.0
02;2021-04-24;1722;1678;0;106879;46593;0;20.3;8.9;0.0
02;2021-04-25;480;303;0;107359;46896;0;20.4;8.9;0.0
02;2021-04-26;1401;674;0;108760;47570;0;20.7;9.0;0.0
02;2021-04-27;1782;1176;0;110542;48746;0;21.0;9.3;0.0
02;2021-04-28;1786;1490;0;112328;50236;0;21.4;9.5;0.0
02;2021-04-29;2012;1271;0;114340;51507;0;21.7;9.8;0.0
02;2021-04-30;2840;1690;0;117180;53197;0;22.3;10.1;0.0
02;2021-05-01;2208;1245;0;119388;54442;0;22.7;10.3;0.0
02;2021-05-02;1926;548;0;121314;54990;0;23.1;10.5;0.0
02;2021-05-03;2362;1040;0;123676;56030;0;23.5;10.7;0.0
02;2021-05-04;1745;1393;0;125421;57423;0;23.8;10.9;0.0
02;2021-05-05;2629;1933;0;128050;59356;0;24.3;11.3;0.0
02;2021-05-06;2534;1923;0;130584;61279;0;24.8;11.6;0.0
02;2021-05-07;2675;2293;0;133259;63572;0;25.3;12.1;0.0
02;2021-05-08;2938;1067;0;136197;64639;0;25.9;12.3;0.0
02;2021-05-09;1907;445;0;138104;65084;0;26.3;12.4;0.0
02;2021-05-10;2539;1639;0;140643;66723;0;26.7;12.7;0.0
02;2021-05-11;3147;1668;0;143790;68391;0;27.3;13.0;0.0
02;2021-05-12;2939;1777;0;146729;70168;0;27.9;13.3;0.0
02;2021-05-13;3045;1013;0;149774;71181;0;28.5;13.5;0.0
02;2021-05-14;3690;1327;0;153464;72508;0;29.2;13.8;0.0
02;2021-05-15;4409;1205;0;157873;73713;0;30.0;14.0;0.0
02;2021-05-16;2861;222;0;160734;73935;0;30.6;14.1;0.0
02;2021-05-17;2416;775;0;163150;74710;0;31.0;14.2;0.0
02;2021-05-18;3032;1073;0;166182;75783;0;31.6;14.4;0.0
02;2021-05-19;3063;1120;0;169245;76903;0;32.2;14.6;0.0
02;2021-05-20;3672;1302;0;172917;78205;0;32.9;14.9;0.0
02;2021-05-21;3819;1167;0;176736;79372;0;33.6;15.1;0.0
02;2021-05-22;5286;1044;0;182022;80416;0;34.6;15.3;0.0
02;2021-05-23;2583;250;0;184605;80666;0;35.1;15.3;0.0
02;2021-05-24;3268;541;0;187873;81207;0;35.7;15.4;0.0
02;2021-05-25;2317;1278;0;190190;82485;0;36.2;15.7;0.0
02;2021-05-26;3108;1563;0;193298;84048;0;36.7;16.0;0.0
02;2021-05-27;3768;1580;0;197066;85628;0;37.5;16.3;0.0
02;2021-05-28;3631;1738;0;200697;87366;0;38.2;16.6;0.0
02;2021-05-29;3978;1645;0;204675;89011;0;38.9;16.9;0.0
02;2021-05-30;1367;199;0;206042;89210;0;39.2;17.0;0.0
02;2021-05-31;2573;1277;0;208615;90487;0;39.7;17.2;0.0
02;2021-06-01;2999;1913;0;211614;92400;0;40.2;17.6;0.0
02;2021-06-02;3292;1787;0;214906;94187;0;40.9;17.9;0.0
02;2021-06-03;3076;1953;0;217982;96140;0;41.4;18.3;0.0
02;2021-06-04;3358;2154;0;221340;98294;0;42.1;18.7;0.0
02;2021-06-05;3314;1855;0;224654;100149;0;42.7;19.0;0.0
02;2021-06-06;1585;279;0;226239;100428;0;43.0;19.1;0.0
02;2021-06-07;1827;1646;0;228066;102074;0;43.4;19.4;0.0
02;2021-06-08;2187;1972;0;230253;104046;0;43.8;19.8;0.0
02;2021-06-09;2236;1897;0;232489;105943;0;44.2;20.1;0.0
02;2021-06-10;2155;2080;0;234644;108023;0;44.6;20.5;0.0
02;2021-06-11;2300;3230;0;236944;111253;0;45.0;21.1;0.0
02;2021-06-12;2238;2810;0;239182;114063;0;45.5;21.7;0.0
02;2021-06-13;634;1455;0;239816;115518;0;45.6;22.0;0.0
02;2021-06-14;1117;2617;0;240933;118135;0;45.8;22.5;0.0
02;2021-06-15;1705;2696;0;242638;120831;0;46.1;23.0;0.0
02;2021-06-16;1595;2993;0;244233;123824;0;46.4;23.5;0.0
02;2021-06-17;1886;3160;0;246119;126984;0;46.8;24.1;0.0
02;2021-06-18;2322;3827;0;248441;130811;0;47.2;24.9;0.0
02;2021-06-19;1796;3907;0;250237;134718;0;47.6;25.6;0.0
02;2021-06-20;615;1559;0;250852;136277;0;47.7;25.9;0.0
02;2021-06-21;852;3348;0;251704;139625;0;47.8;26.5;0.0
02;2021-06-22;1235;3847;2;252939;143472;2;48.1;27.3;0.0
02;2021-06-23;1403;3732;0;254342;147204;2;48.3;28.0;0.0
02;2021-06-24;1413;3313;0;255755;150517;2;48.6;28.6;0.0
02;2021-06-25;1464;4863;0;257219;155380;2;48.9;29.5;0.0
02;2021-06-26;1322;4443;0;258541;159823;2;49.1;30.4;0.0
02;2021-06-27;564;2343;0;259105;162166;2;49.3;30.8;0.0
02;2021-06-28;903;3267;0;260008;165433;2;49.4;31.4;0.0
02;2021-06-29;999;3235;0;261007;168668;2;49.6;32.1;0.0
02;2021-06-30;1447;3424;0;262454;172092;2;49.9;32.7;0.0
02;2021-07-01;1369;3768;0;263823;175860;2;50.2;33.4;0.0
02;2021-07-02;1425;5191;0;265248;181051;2;50.4;34.4;0.0
02;2021-07-03;1043;5794;0;266291;186845;2;50.6;35.5;0.0
02;2021-07-04;528;2300;0;266819;189145;2;50.7;36.0;0.0
02;2021-07-05;690;3993;0;267509;193138;2;50.9;36.7;0.0
02;2021-07-06;870;3352;1;268379;196490;3;51.0;37.4;0.0
02;2021-07-07;1406;3856;1;269785;200346;4;51.3;38.1;0.0
02;2021-07-08;1550;3950;0;271335;204296;4;51.6;38.8;0.0
02;2021-07-09;1411;4360;0;272746;208656;4;51.8;39.7;0.0
02;2021-07-10;1382;4484;0;274128;213140;4;52.1;40.5;0.0
02;2021-07-11;491;1866;0;274619;215006;4;52.2;40.9;0.0
02;2021-07-12;1446;3806;0;276065;218812;4;52.5;41.6;0.0
02;2021-07-13;2213;3852;0;278278;222664;4;52.9;42.3;0.0
02;2021-07-14;1528;1630;0;279806;224294;4;53.2;42.6;0.0
02;2021-07-15;2869;3799;0;282675;228093;4;53.7;43.4;0.0
02;2021-07-16;3294;4483;0;285969;232576;4;54.4;44.2;0.0
02;2021-07-17;3442;4273;0;289411;236849;4;55.0;45.0;0.0
02;2021-07-18;1717;1511;0;291128;238360;4;55.3;45.3;0.0
02;2021-07-19;3243;3134;0;294371;241494;4;56.0;45.9;0.0
02;2021-07-20;3548;3501;0;297919;244995;4;56.6;46.6;0.0
02;2021-07-21;3948;3124;0;301867;248119;4;57.4;47.2;0.0
02;2021-07-22;3544;2988;0;305411;251107;4;58.1;47.7;0.0
02;2021-07-23;3487;3694;0;308898;254801;4;58.7;48.4;0.0
02;2021-07-24;4234;3576;0;313132;258377;4;59.5;49.1;0.0
02;2021-07-25;1937;1004;0;315069;259381;4;59.9;49.3;0.0
02;2021-07-26;3781;2279;0;318850;261660;4;60.6;49.7;0.0
02;2021-07-27;3829;2331;0;322679;263991;4;61.3;50.2;0.0
02;2021-07-28;3524;2311;0;326203;266302;4;62.0;50.6;0.0
02;2021-07-29;2998;2343;0;329201;268645;4;62.6;51.1;0.0
02;2021-07-30;3543;2485;0;332744;271130;4;63.3;51.5;0.0
02;2021-07-31;4079;2335;0;336823;273465;4;64.0;52.0;0.0
02;2021-08-01;1443;668;0;338266;274133;4;64.3;52.1;0.0
02;2021-08-02;2324;1684;0;340590;275817;4;64.7;52.4;0.0
02;2021-08-03;2894;2043;0;343484;277860;4;65.3;52.8;0.0
02;2021-08-04;2961;1833;0;346445;279693;4;65.9;53.2;0.0
02;2021-08-05;2228;2401;0;348673;282094;4;66.3;53.6;0.0
02;2021-08-06;2394;2832;0;351067;284926;4;66.7;54.2;0.0
02;2021-08-07;2731;2800;0;353798;287726;4;67.3;54.7;0.0
02;2021-08-08;1011;1346;0;354809;289072;4;67.4;55.0;0.0
02;2021-08-09;1950;2698;0;356759;291770;4;67.8;55.5;0.0
02;2021-08-10;1975;2653;0;358734;294423;4;68.2;56.0;0.0
02;2021-08-11;1760;2253;0;360494;296676;4;68.5;56.4;0.0
02;2021-08-12;1390;2400;0;361884;299076;4;68.8;56.9;0.0
02;2021-08-13;1741;2950;0;363625;302026;4;69.1;57.4;0.0
02;2021-08-14;1805;3621;0;365430;305647;4;69.5;58.1;0.0
02;2021-08-15;207;572;0;365637;306219;4;69.5;58.2;0.0
02;2021-08-16;1335;3714;0;366972;309933;4;69.8;58.9;0.0
02;2021-08-17;1497;2991;0;368469;312924;4;70.0;59.5;0.0
02;2021-08-18;1611;3210;0;370080;316134;4;70.4;60.1;0.0
02;2021-08-19;1201;3339;0;371281;319473;4;70.6;60.7;0.0
02;2021-08-20;1265;3144;0;372546;322617;4;70.8;61.3;0.0
02;2021-08-21;1495;4030;0;374041;326647;4;71.1;62.1;0.0
02;2021-08-22;401;1550;0;374442;328197;4;71.2;62.4;0.0
02;2021-08-23;1126;3164;0;375568;331361;4;71.4;63.0;0.0
02;2021-08-24;964;2496;0;376532;333857;4;71.6;63.5;0.0
02;2021-08-25;1076;2836;0;377608;336693;4;71.8;64.0;0.0
02;2021-08-26;956;2619;0;378564;339312;4;72.0;64.5;0.0
02;2021-08-27;1018;2826;0;379582;342138;4;72.2;65.0;0.0
02;2021-08-28;1275;3588;0;380857;345726;4;72.4;65.7;0.0
02;2021-08-29;318;1174;0;381175;346900;4;72.5;65.9;0.0
02;2021-08-30;951;2642;44;382126;349542;48;72.6;66.4;0.0
02;2021-08-31;876;2300;97;383002;351842;145;72.8;66.9;0.0
02;2021-09-01;741;1663;146;383743;353505;291;72.9;67.2;0.1
02;2021-09-02;673;1721;171;384416;355226;462;73.1;67.5;0.1
02;2021-09-03;679;1893;193;385095;357119;655;73.2;67.9;0.1
02;2021-09-04;872;2974;90;385967;360093;745;73.4;68.5;0.1
02;2021-09-05;229;457;71;386196;360550;816;73.4;68.5;0.2
02;2021-09-06;448;998;157;386644;361548;973;73.5;68.7;0.2
02;2021-09-07;453;1302;218;387097;362850;1191;73.6;69.0;0.2
02;2021-09-08;520;1777;159;387617;364627;1350;73.7;69.3;0.3
02;2021-09-09;435;1230;164;388052;365857;1514;73.8;69.5;0.3
02;2021-09-10;575;1417;211;388627;367274;1725;73.9;69.8;0.3
02;2021-09-11;746;2227;175;389373;369501;1900;74.0;70.2;0.4
02;2021-09-12;98;288;18;389471;369789;1918;74.0;70.3;0.4
02;2021-09-13;439;972;279;389910;370761;2197;74.1;70.5;0.4
02;2021-09-14;441;890;356;390351;371651;2553;74.2;70.6;0.5
02;2021-09-15;445;1361;572;390796;373012;3125;74.3;70.9;0.6
02;2021-09-16;450;846;412;391246;373858;3537;74.4;71.1;0.7
02;2021-09-17;585;979;463;391831;374837;4000;74.5;71.3;0.8
02;2021-09-18;550;2038;229;392381;376875;4229;74.6;71.6;0.8
02;2021-09-19;76;242;27;392457;377117;4256;74.6;71.7;0.8
02;2021-09-20;295;636;484;392752;377753;4740;74.7;71.8;0.9
02;2021-09-21;279;638;504;393031;378391;5244;74.7;71.9;1.0
02;2021-09-22;351;940;533;393382;379331;5777;74.8;72.1;1.1
02;2021-09-23;263;577;522;393645;379908;6299;74.8;72.2;1.2
02;2021-09-24;283;730;383;393928;380638;6682;74.9;72.4;1.3
02;2021-09-25;313;1205;301;394241;381843;6983;74.9;72.6;1.3
02;2021-09-26;39;159;13;394280;382002;6996;75.0;72.6;1.3
02;2021-09-27;169;395;420;394449;382397;7416;75.0;72.7;1.4
02;2021-09-28;166;386;455;394615;382783;7871;75.0;72.8;1.5
02;2021-09-29;227;464;528;394842;383247;8399;75.1;72.9;1.6
02;2021-09-30;232;473;458;395074;383720;8857;75.1;72.9;1.7
02;2021-10-01;356;672;507;395430;384392;9364;75.2;73.1;1.8
02;2021-10-02;393;875;323;395823;385267;9687;75.2;73.2;1.8
02;2021-10-03;33;69;23;395856;385336;9710;75.3;73.3;1.8
02;2021-10-04;156;386;529;396012;385722;10239;75.3;73.3;1.9
02;2021-10-05;177;332;402;396189;386054;10641;75.3;73.4;2.0
02;2021-10-06;254;437;532;396443;386491;11173;75.4;73.5;2.1
02;2021-10-07;219;434;588;396662;386925;11761;75.4;73.6;2.2
02;2021-10-08;310;602;691;396972;387527;12452;75.5;73.7;2.4
02;2021-10-09;315;700;498;397287;388227;12950;75.5;73.8;2.5
02;2021-10-10;31;67;23;397318;388294;12973;75.5;73.8;2.5
02;2021-10-11;176;325;414;397494;388619;13387;75.6;73.9;2.5
02;2021-10-12;140;297;509;397634;388916;13896;75.6;73.9;2.6
02;2021-10-13;237;403;662;397871;389319;14558;75.6;74.0;2.8
02;2021-10-14;210;319;566;398081;389638;15124;75.7;74.1;2.9
02;2021-10-15;283;430;763;398364;390068;15887;75.7;74.2;3.0
02;2021-10-16;307;409;495;398671;390477;16382;75.8;74.2;3.1
02;2021-10-17;15;31;10;398686;390508;16392;75.8;74.2;3.1
02;2021-10-18;158;242;566;398844;390750;16958;75.8;74.3;3.2
02;2021-10-19;121;228;419;398965;390978;17377;75.8;74.3;3.3
02;2021-10-20;259;293;886;399224;391271;18263;75.9;74.4;3.5
02;2021-10-21;151;248;611;399375;391519;18874;75.9;74.4;3.6
02;2021-10-22;294;415;988;399669;391934;19862;76.0;74.5;3.8
02;2021-10-23;226;384;446;399895;392318;20308;76.0;74.6;3.9
02;2021-10-24;6;8;11;399901;392326;20319;76.0;74.6;3.9
02;2021-10-25;147;216;721;400048;392542;21040;76.0;74.6;4.0
02;2021-10-26;80;150;601;400128;392692;21641;76.1;74.6;4.1
02;2021-10-27;168;252;839;400296;392944;22480;76.1;74.7;4.3
02;2021-10-28;160;207;719;400456;393151;23199;76.1;74.7;4.4
02;2021-10-29;270;378;1080;400726;393529;24279;76.2;74.8;4.6
02;2021-10-30;140;290;483;400866;393819;24762;76.2;74.9;4.7
02;2021-10-31;11;15;33;400877;393834;24795;76.2;74.9;4.7
02;2021-11-01;13;13;9;400890;393847;24804;76.2;74.9;4.7
02;2021-11-02;133;195;697;401023;394042;25501;76.2;74.9;4.8
02;2021-11-03;219;285;1043;401242;394327;26544;76.3;75.0;5.0
02;2021-11-04;141;231;745;401383;394558;27289;76.3;75.0;5.2
02;2021-11-05;203;320;1227;401586;394878;28516;76.3;75.1;5.4
02;2021-11-06;152;237;496;401738;395115;29012;76.4;75.1;5.5
02;2021-11-07;23;28;101;401761;395143;29113;76.4;75.1;5.5
02;2021-11-08;102;140;839;401863;395283;29952;76.4;75.1;5.7
02;2021-11-09;114;162;1147;401977;395445;31099;76.4;75.2;5.9
02;2021-11-10;175;281;1457;402152;395726;32556;76.4;75.2;6.2
02;2021-11-11;7;21;72;402159;395747;32628;76.4;75.2;6.2
02;2021-11-12;219;320;1539;402378;396067;34167;76.5;75.3;6.5
02;2021-11-13;173;271;1038;402551;396338;35205;76.5;75.3;6.7
02;2021-11-14;9;9;87;402560;396347;35292;76.5;75.3;6.7
02;2021-11-15;95;138;1174;402655;396485;36466;76.5;75.4;6.9
02;2021-11-16;118;120;1278;402773;396605;37744;76.6;75.4;7.2
02;2021-11-17;220;234;1617;402993;396839;39361;76.6;75.4;7.5
02;2021-11-18;144;201;1840;403137;397040;41201;76.6;75.5;7.8
02;2021-11-19;242;268;1978;403379;397308;43179;76.7;75.5;8.2
02;2021-11-20;175;192;923;403554;397500;44102;76.7;75.6;8.4
02;2021-11-21;7;10;69;403561;397510;44171;76.7;75.6;8.4
02;2021-11-22;165;103;1412;403726;397613;45583;76.7;75.6;8.7
02;2021-11-23;136;114;1279;403862;397727;46862;76.8;75.6;8.9
02;2021-11-24;184;218;1663;404046;397945;48525;76.8;75.6;9.2
02;2021-11-25;173;159;1852;404219;398104;50377;76.8;75.7;9.6
02;2021-11-26;242;238;3318;404461;398342;53695;76.9;75.7;10.2
02;2021-11-27;231;177;2502;404692;398519;56197;76.9;75.8;10.7
02;2021-11-28;40;24;1596;404732;398543;57793;76.9;75.8;11.0
02;2021-11-29;102;110;2650;404834;398653;60443;77.0;75.8;11.5
02;2021-11-30;140;144;3558;404974;398797;64001;77.0;75.8;12.2
02;2021-12-01;150;186;3731;405124;398983;67732;77.0;75.8;12.9
02;2021-12-02;136;80;4161;405260;399063;71893;77.0;75.9;13.7
02;2021-12-03;172;208;5215;405432;399271;77108;77.1;75.9;14.7
02;2021-12-04;134;172;4322;405566;399443;81430;77.1;75.9;15.5
02;2021-12-05;21;20;1097;405587;399463;82527;77.1;75.9;15.7
02;2021-12-06;113;118;3771;405700;399581;86298;77.1;76.0;16.4
02;2021-12-07;132;127;4583;405832;399708;90881;77.1;76.0;17.3
02;2021-12-08;140;164;5293;405972;399872;96174;77.2;76.0;18.3
02;2021-12-09;147;190;4966;406119;400062;101140;77.2;76.1;19.2
02;2021-12-10;183;245;5979;406302;400307;107119;77.2;76.1;20.4
02;2021-12-11;147;202;4965;406449;400509;112084;77.3;76.1;21.3
02;2021-12-12;58;20;1701;406507;400529;113785;77.3;76.1;21.6
02;2021-12-13;111;138;4770;406618;400667;118555;77.3;76.2;22.5
02;2021-12-14;137;167;5415;406755;400834;123970;77.3;76.2;23.6
02;2021-12-15;121;208;5163;406876;401042;129133;77.3;76.2;24.5
02;2021-12-16;156;214;6071;407032;401256;135204;77.4;76.3;25.7
03;2020-12-27;0;0;0;0;0;0;0.0;0.0;0.0
03;2020-12-28;1;0;0;1;0;0;0.0;0.0;0.0
03;2020-12-29;0;0;0;1;0;0;0.0;0.0;0.0
03;2020-12-30;1;0;0;2;0;0;0.0;0.0;0.0
03;2020-12-31;0;0;0;2;0;0;0.0;0.0;0.0
03;2021-01-01;0;0;0;2;0;0;0.0;0.0;0.0
03;2021-01-02;0;0;0;2;0;0;0.0;0.0;0.0
03;2021-01-03;0;0;0;2;0;0;0.0;0.0;0.0
03;2021-01-04;0;0;0;2;0;0;0.0;0.0;0.0
03;2021-01-05;1;0;0;3;0;0;0.0;0.0;0.0
03;2021-01-06;12;0;0;15;0;0;0.0;0.0;0.0
03;2021-01-07;73;0;0;88;0;0;0.0;0.0;0.0
03;2021-01-08;141;1;0;229;1;0;0.1;0.0;0.0
03;2021-01-09;113;0;0;342;1;0;0.1;0.0;0.0
03;2021-01-10;4;0;0;346;1;0;0.1;0.0;0.0
03;2021-01-11;411;1;0;757;2;0;0.2;0.0;0.0
03;2021-01-12;607;1;0;1364;3;0;0.4;0.0;0.0
03;2021-01-13;743;2;0;2107;5;0;0.6;0.0;0.0
03;2021-01-14;837;5;0;2944;10;0;0.9;0.0;0.0
03;2021-01-15;374;3;0;3318;13;0;1.0;0.0;0.0
03;2021-01-16;260;0;0;3578;13;0;1.1;0.0;0.0
03;2021-01-17;37;0;0;3615;13;0;1.1;0.0;0.0
03;2021-01-18;874;1;0;4489;14;0;1.4;0.0;0.0
03;2021-01-19;1190;2;0;5679;16;0;1.7;0.0;0.0
03;2021-01-20;1327;3;0;7006;19;0;2.1;0.0;0.0
03;2021-01-21;1202;3;0;8208;22;0;2.5;0.0;0.0
03;2021-01-22;1108;5;0;9316;27;0;2.8;0.0;0.0
03;2021-01-23;449;1;0;9765;28;0;2.9;0.0;0.0
03;2021-01-24;1;0;0;9766;28;0;2.9;0.0;0.0
03;2021-01-25;214;0;0;9980;28;0;3.0;0.0;0.0
03;2021-01-26;739;14;0;10719;42;0;3.2;0.0;0.0
03;2021-01-27;703;10;0;11422;52;0;3.4;0.0;0.0
03;2021-01-28;1014;56;0;12436;108;0;3.8;0.0;0.0
03;2021-01-29;824;78;0;13260;186;0;4.0;0.1;0.0
03;2021-01-30;556;6;0;13816;192;0;4.2;0.1;0.0
03;2021-01-31;0;1;0;13816;193;0;4.2;0.1;0.0
03;2021-02-01;176;82;0;13992;275;0;4.2;0.1;0.0
03;2021-02-02;731;263;0;14723;538;0;4.4;0.2;0.0
03;2021-02-03;971;455;0;15694;993;0;4.7;0.3;0.0
03;2021-02-04;1513;646;0;17207;1639;0;5.2;0.5;0.0
03;2021-02-05;884;306;0;18091;1945;0;5.5;0.6;0.0
03;2021-02-06;146;15;0;18237;1960;0;5.5;0.6;0.0
03;2021-02-07;2;0;0;18239;1960;0;5.5;0.6;0.0
03;2021-02-08;145;63;0;18384;2023;0;5.5;0.6;0.0
03;2021-02-09;587;431;0;18971;2454;0;5.7;0.7;0.0
03;2021-02-10;490;416;0;19461;2870;0;5.9;0.9;0.0
03;2021-02-11;934;529;0;20395;3399;0;6.2;1.0;0.0
03;2021-02-12;1042;565;0;21437;3964;0;6.5;1.2;0.0
03;2021-02-13;125;160;0;21562;4124;0;6.5;1.2;0.0
03;2021-02-14;4;4;0;21566;4128;0;6.5;1.2;0.0
03;2021-02-15;301;856;0;21867;4984;0;6.6;1.5;0.0
03;2021-02-16;546;1132;0;22413;6116;0;6.8;1.8;0.0
03;2021-02-17;431;1305;0;22844;7421;0;6.9;2.2;0.0
03;2021-02-18;344;1240;0;23188;8661;0;7.0;2.6;0.0
03;2021-02-19;492;767;0;23680;9428;0;7.1;2.8;0.0
03;2021-02-20;115;181;0;23795;9609;0;7.2;2.9;0.0
03;2021-02-21;2;1;0;23797;9610;0;7.2;2.9;0.0
03;2021-02-22;170;210;0;23967;9820;0;7.2;3.0;0.0
03;2021-02-23;657;835;0;24624;10655;0;7.4;3.2;0.0
03;2021-02-24;582;974;0;25206;11629;0;7.6;3.5;0.0
03;2021-02-25;1046;1758;0;26252;13387;0;7.9;4.0;0.0
03;2021-02-26;780;1292;0;27032;14679;0;8.2;4.4;0.0
03;2021-02-27;97;247;0;27129;14926;0;8.2;4.5;0.0
03;2021-02-28;1;16;0;27130;14942;0;8.2;4.5;0.0
03;2021-03-01;186;243;0;27316;15185;0;8.2;4.6;0.0
03;2021-03-02;784;663;0;28100;15848;0;8.5;4.8;0.0
03;2021-03-03;857;453;0;28957;16301;0;8.7;4.9;0.0
03;2021-03-04;1490;583;0;30447;16884;0;9.2;5.1;0.0
03;2021-03-05;1064;714;0;31511;17598;0;9.5;5.3;0.0
03;2021-03-06;895;117;0;32406;17715;0;9.8;5.3;0.0
03;2021-03-07;14;2;0;32420;17717;0;9.8;5.3;0.0
03;2021-03-08;249;249;0;32669;17966;0;9.9;5.4;0.0
03;2021-03-09;942;448;0;33611;18414;0;10.1;5.6;0.0
03;2021-03-10;924;541;0;34535;18955;0;10.4;5.7;0.0
03;2021-03-11;1615;665;0;36150;19620;0;10.9;5.9;0.0
03;2021-03-12;1256;841;0;37406;20461;0;11.3;6.2;0.0
03;2021-03-13;858;112;0;38264;20573;0;11.5;6.2;0.0
03;2021-03-14;12;7;0;38276;20580;0;11.6;6.2;0.0
03;2021-03-15;301;205;0;38577;20785;0;11.6;6.3;0.0
03;2021-03-16;647;405;0;39224;21190;0;11.8;6.4;0.0
03;2021-03-17;1278;420;0;40502;21610;0;12.2;6.5;0.0
03;2021-03-18;1680;405;0;42182;22015;0;12.7;6.6;0.0
03;2021-03-19;1657;347;0;43839;22362;0;13.2;6.7;0.0
03;2021-03-20;303;29;0;44142;22391;0;13.3;6.8;0.0
03;2021-03-21;4;0;0;44146;22391;0;13.3;6.8;0.0
03;2021-03-22;258;392;0;44404;22783;0;13.4;6.9;0.0
03;2021-03-23;1308;361;0;45712;23144;0;13.8;7.0;0.0
03;2021-03-24;1809;335;0;47521;23479;0;14.3;7.1;0.0
03;2021-03-25;2320;545;0;49841;24024;0;15.0;7.3;0.0
03;2021-03-26;2267;436;0;52108;24460;0;15.7;7.4;0.0
03;2021-03-27;818;28;0;52926;24488;0;16.0;7.4;0.0
03;2021-03-28;14;35;0;52940;24523;0;16.0;7.4;0.0
03;2021-03-29;677;176;0;53617;24699;0;16.2;7.5;0.0
03;2021-03-30;1897;451;0;55514;25150;0;16.8;7.6;0.0
03;2021-03-31;1052;925;0;56566;26075;0;17.1;7.9;0.0
03;2021-04-01;1413;1094;0;57979;27169;0;17.5;8.2;0.0
03;2021-04-02;1711;629;0;59690;27798;0;18.0;8.4;0.0
03;2021-04-03;375;109;0;60065;27907;0;18.1;8.4;0.0
03;2021-04-04;32;0;0;60097;27907;0;18.1;8.4;0.0
03;2021-04-05;40;15;0;60137;27922;0;18.2;8.4;0.0
03;2021-04-06;1123;431;0;61260;28353;0;18.5;8.6;0.0
03;2021-04-07;1571;532;0;62831;28885;0;19.0;8.7;0.0
03;2021-04-08;2130;541;0;64961;29426;0;19.6;8.9;0.0
03;2021-04-09;2047;1105;0;67008;30531;0;20.2;9.2;0.0
03;2021-04-10;952;87;0;67960;30618;0;20.5;9.2;0.0
03;2021-04-11;364;11;0;68324;30629;0;20.6;9.2;0.0
03;2021-04-12;1013;253;0;69337;30882;0;20.9;9.3;0.0
03;2021-04-13;1832;963;0;71169;31845;0;21.5;9.6;0.0
03;2021-04-14;2192;1167;0;73361;33012;0;22.1;10.0;0.0
03;2021-04-15;2536;1366;0;75897;34378;0;22.9;10.4;0.0
03;2021-04-16;2670;1175;0;78567;35553;0;23.7;10.7;0.0
03;2021-04-17;1056;419;0;79623;35972;0;24.0;10.9;0.0
03;2021-04-18;26;7;0;79649;35979;0;24.0;10.9;0.0
03;2021-04-19;1164;609;0;80813;36588;0;24.4;11.0;0.0
03;2021-04-20;1704;1272;0;82517;37860;0;24.9;11.4;0.0
03;2021-04-21;1148;1266;0;83665;39126;0;25.3;11.8;0.0
03;2021-04-22;1660;1001;0;85325;40127;0;25.8;12.1;0.0
03;2021-04-23;2372;1284;0;87697;41411;0;26.5;12.5;0.0
03;2021-04-24;1257;921;0;88954;42332;0;26.8;12.8;0.0
03;2021-04-25;370;25;0;89324;42357;0;27.0;12.8;0.0
03;2021-04-26;1301;496;0;90625;42853;0;27.4;12.9;0.0
03;2021-04-27;1686;1580;0;92311;44433;0;27.9;13.4;0.0
03;2021-04-28;1879;1172;0;94190;45605;0;28.4;13.8;0.0
03;2021-04-29;2276;1211;0;96466;46816;0;29.1;14.1;0.0
03;2021-04-30;1819;834;0;98285;47650;0;29.7;14.4;0.0
03;2021-05-01;449;493;0;98734;48143;0;29.8;14.5;0.0
03;2021-05-02;27;12;0;98761;48155;0;29.8;14.5;0.0
03;2021-05-03;1800;789;0;100561;48944;0;30.4;14.8;0.0
03;2021-05-04;2655;1656;0;103216;50600;0;31.2;15.3;0.0
03;2021-05-05;2409;1323;0;105625;51923;0;31.9;15.7;0.0
03;2021-05-06;2851;1928;0;108476;53851;0;32.7;16.3;0.0
03;2021-05-07;4321;1755;0;112797;55606;0;34.0;16.8;0.0
03;2021-05-08;562;344;0;113359;55950;0;34.2;16.9;0.0
03;2021-05-09;56;366;0;113415;56316;0;34.2;17.0;0.0
03;2021-05-10;1752;1503;0;115167;57819;0;34.8;17.5;0.0
03;2021-05-11;3432;1856;0;118599;59675;0;35.8;18.0;0.0
03;2021-05-12;2584;1473;0;121183;61148;0;36.6;18.5;0.0
03;2021-05-13;3434;349;0;124617;61497;0;37.6;18.6;0.0
03;2021-05-14;3131;1642;0;127748;63139;0;38.6;19.1;0.0
03;2021-05-15;1706;472;0;129454;63611;0;39.1;19.2;0.0
03;2021-05-16;508;54;0;129962;63665;0;39.2;19.2;0.0
03;2021-05-17;1219;879;0;131181;64544;0;39.6;19.5;0.0
03;2021-05-18;2870;1493;0;134051;66037;0;40.5;19.9;0.0
03;2021-05-19;2361;932;0;136412;66969;0;41.2;20.2;0.0
03;2021-05-20;2969;1080;0;139381;68049;0;42.1;20.5;0.0
03;2021-05-21;3551;1260;0;142932;69309;0;43.1;20.9;0.0
03;2021-05-22;1741;350;0;144673;69659;0;43.7;21.0;0.0
03;2021-05-23;599;67;0;145272;69726;0;43.8;21.0;0.0
03;2021-05-24;1939;157;0;147211;69883;0;44.4;21.1;0.0
03;2021-05-25;2758;1651;0;149969;71534;0;45.3;21.6;0.0
03;2021-05-26;1966;1035;0;151935;72569;0;45.9;21.9;0.0
03;2021-05-27;2646;1166;0;154581;73735;0;46.7;22.3;0.0
03;2021-05-28;3116;2197;0;157697;75932;0;47.6;22.9;0.0
03;2021-05-29;1312;595;0;159009;76527;0;48.0;23.1;0.0
03;2021-05-30;173;27;0;159182;76554;0;48.0;23.1;0.0
03;2021-05-31;679;597;0;159861;77151;0;48.3;23.3;0.0
03;2021-06-01;2079;2293;0;161940;79444;0;48.9;24.0;0.0
03;2021-06-02;1425;1706;0;163365;81150;0;49.3;24.5;0.0
03;2021-06-03;1872;2588;0;165237;83738;0;49.9;25.3;0.0
03;2021-06-04;1538;2438;0;166775;86176;0;50.3;26.0;0.0
03;2021-06-05;911;1108;0;167686;87284;0;50.6;26.3;0.0
03;2021-06-06;78;23;0;167764;87307;0;50.6;26.4;0.0
03;2021-06-07;633;1822;0;168397;89129;0;50.8;26.9;0.0
03;2021-06-08;1384;2480;0;169781;91609;0;51.2;27.7;0.0
03;2021-06-09;1129;1784;0;170910;93393;0;51.6;28.2;0.0
03;2021-06-10;1226;2022;0;172136;95415;0;52.0;28.8;0.0
03;2021-06-11;1297;3222;0;173433;98637;0;52.3;29.8;0.0
03;2021-06-12;729;831;0;174162;99468;0;52.6;30.0;0.0
03;2021-06-13;42;28;0;174204;99496;0;52.6;30.0;0.0
03;2021-06-14;427;2005;0;174631;101501;0;52.7;30.6;0.0
03;2021-06-15;1169;3536;0;175800;105037;0;53.1;31.7;0.0
03;2021-06-16;773;2657;0;176573;107694;0;53.3;32.5;0.0
03;2021-06-17;1010;3058;0;177583;110752;0;53.6;33.4;0.0
03;2021-06-18;1052;3649;0;178635;114401;0;53.9;34.5;0.0
03;2021-06-19;571;1369;0;179206;115770;0;54.1;34.9;0.0
03;2021-06-20;29;26;0;179235;115796;0;54.1;35.0;0.0
03;2021-06-21;450;2358;0;179685;118154;0;54.2;35.7;0.0
03;2021-06-22;881;3587;0;180566;121741;0;54.5;36.7;0.0
03;2021-06-23;599;2796;0;181165;124537;0;54.7;37.6;0.0
03;2021-06-24;836;3507;0;182001;128044;0;54.9;38.6;0.0
03;2021-06-25;852;3451;0;182853;131495;0;55.2;39.7;0.0
03;2021-06-26;480;1812;0;183333;133307;0;55.3;40.2;0.0
03;2021-06-27;58;488;0;183391;133795;0;55.4;40.4;0.0
03;2021-06-28;605;1865;0;183996;135660;0;55.5;40.9;0.0
03;2021-06-29;973;3142;0;184969;138802;0;55.8;41.9;0.0
03;2021-06-30;773;2843;0;185742;141645;0;56.1;42.8;0.0
03;2021-07-01;906;2756;0;186648;144401;0;56.3;43.6;0.0
03;2021-07-02;875;3629;0;187523;148030;0;56.6;44.7;0.0
03;2021-07-03;450;1640;0;187973;149670;0;56.7;45.2;0.0
03;2021-07-04;35;294;0;188008;149964;0;56.7;45.3;0.0
03;2021-07-05;722;2073;0;188730;152037;0;57.0;45.9;0.0
03;2021-07-06;1073;3185;0;189803;155222;0;57.3;46.9;0.0
03;2021-07-07;789;2279;0;190592;157501;0;57.5;47.5;0.0
03;2021-07-08;942;2765;0;191534;160266;0;57.8;48.4;0.0
03;2021-07-09;1213;3035;0;192747;163301;0;58.2;49.3;0.0
03;2021-07-10;406;1470;0;193153;164771;0;58.3;49.7;0.0
03;2021-07-11;73;387;0;193226;165158;0;58.3;49.8;0.0
03;2021-07-12;833;1241;0;194059;166399;0;58.6;50.2;0.0
03;2021-07-13;2217;2924;0;196276;169323;0;59.2;51.1;0.0
03;2021-07-14;231;84;0;196507;169407;0;59.3;51.1;0.0
03;2021-07-15;2246;2210;0;198753;171617;0;60.0;51.8;0.0
03;2021-07-16;2334;2034;0;201087;173651;0;60.7;52.4;0.0
03;2021-07-17;921;1385;0;202008;175036;0;61.0;52.8;0.0
03;2021-07-18;82;21;0;202090;175057;0;61.0;52.8;0.0
03;2021-07-19;2081;1259;0;204171;176316;0;61.6;53.2;0.0
03;2021-07-20;2700;2827;0;206871;179143;0;62.4;54.1;0.0
03;2021-07-21;2712;1312;0;209583;180455;0;63.3;54.5;0.0
03;2021-07-22;2494;1732;0;212077;182187;0;64.0;55.0;0.0
03;2021-07-23;2732;1184;0;214809;183371;0;64.8;55.3;0.0
03;2021-07-24;648;541;0;215457;183912;0;65.0;55.5;0.0
03;2021-07-25;102;44;0;215559;183956;0;65.1;55.5;0.0
03;2021-07-26;1807;1441;0;217366;185397;0;65.6;56.0;0.0
03;2021-07-27;2915;1915;0;220281;187312;0;66.5;56.5;0.0
03;2021-07-28;2335;995;0;222616;188307;0;67.2;56.8;0.0
03;2021-07-29;2145;1352;0;224761;189659;0;67.8;57.2;0.0
03;2021-07-30;1930;1251;0;226691;190910;0;68.4;57.6;0.0
03;2021-07-31;837;737;0;227528;191647;0;68.7;57.8;0.0
03;2021-08-01;55;31;0;227583;191678;0;68.7;57.9;0.0
03;2021-08-02;1515;1459;0;229098;193137;0;69.1;58.3;0.0
03;2021-08-03;1977;2483;0;231075;195620;0;69.7;59.0;0.0
03;2021-08-04;1826;838;0;232901;196458;0;70.3;59.3;0.0
03;2021-08-05;1233;1653;0;234134;198111;0;70.7;59.8;0.0
03;2021-08-06;1261;977;0;235395;199088;0;71.0;60.1;0.0
03;2021-08-07;564;536;0;235959;199624;0;71.2;60.3;0.0
03;2021-08-08;82;72;0;236041;199696;0;71.2;60.3;0.0
03;2021-08-09;660;1319;0;236701;201015;0;71.4;60.7;0.0
03;2021-08-10;1569;2987;0;238270;204002;0;71.9;61.6;0.0
03;2021-08-11;1211;2125;0;239481;206127;0;72.3;62.2;0.0
03;2021-08-12;1045;2872;0;240526;208999;0;72.6;63.1;0.0
03;2021-08-13;815;1147;0;241341;210146;0;72.8;63.4;0.0
03;2021-08-14;387;594;0;241728;210740;0;73.0;63.6;0.0
03;2021-08-15;17;98;0;241745;210838;0;73.0;63.6;0.0
03;2021-08-16;678;2387;0;242423;213225;0;73.2;64.4;0.0
03;2021-08-17;1006;2795;0;243429;216020;0;73.5;65.2;0.0
03;2021-08-18;1094;1949;0;244523;217969;0;73.8;65.8;0.0
03;2021-08-19;926;2523;0;245449;220492;0;74.1;66.6;0.0
03;2021-08-20;725;1189;0;246174;221681;0;74.3;66.9;0.0
03;2021-08-21;395;722;0;246569;222403;0;74.4;67.1;0.0
03;2021-08-22;23;34;0;246592;222437;0;74.4;67.1;0.0
03;2021-08-23;715;2062;0;247307;224499;0;74.6;67.8;0.0
03;2021-08-24;843;2130;0;248150;226629;0;74.9;68.4;0.0
03;2021-08-25;835;1725;0;248985;228354;0;75.2;68.9;0.0
03;2021-08-26;528;1321;0;249513;229675;0;75.3;69.3;0.0
03;2021-08-27;457;1549;0;249970;231224;0;75.4;69.8;0.0
03;2021-08-28;217;621;0;250187;231845;0;75.5;70.0;0.0
03;2021-08-29;11;17;0;250198;231862;0;75.5;70.0;0.0
03;2021-08-30;717;1332;21;250915;233194;21;75.7;70.4;0.0
03;2021-08-31;683;1868;106;251598;235062;127;75.9;70.9;0.0
03;2021-09-01;573;1268;216;252171;236330;343;76.1;71.3;0.1
03;2021-09-02;452;1002;146;252623;237332;489;76.2;71.6;0.1
03;2021-09-03;482;1098;133;253105;238430;622;76.4;72.0;0.2
03;2021-09-04;252;602;26;253357;239032;648;76.5;72.1;0.2
03;2021-09-05;12;35;3;253369;239067;651;76.5;72.2;0.2
03;2021-09-06;313;690;417;253682;239757;1068;76.6;72.4;0.3
03;2021-09-07;566;1093;467;254248;240850;1535;76.7;72.7;0.5
03;2021-09-08;384;1203;305;254632;242053;1840;76.9;73.1;0.6
03;2021-09-09;242;612;292;254874;242665;2132;76.9;73.2;0.6
03;2021-09-10;409;914;326;255283;243579;2458;77.1;73.5;0.7
03;2021-09-11;200;601;42;255483;244180;2500;77.1;73.7;0.8
03;2021-09-12;7;19;2;255490;244199;2502;77.1;73.7;0.8
03;2021-09-13;275;603;314;255765;244802;2816;77.2;73.9;0.8
03;2021-09-14;412;884;526;256177;245686;3342;77.3;74.2;1.0
03;2021-09-15;337;960;386;256514;246646;3728;77.4;74.4;1.1
03;2021-09-16;200;547;421;256714;247193;4149;77.5;74.6;1.3
03;2021-09-17;166;383;335;256880;247576;4484;77.5;74.7;1.4
03;2021-09-18;144;324;103;257024;247900;4587;77.6;74.8;1.4
03;2021-09-19;3;19;0;257027;247919;4587;77.6;74.8;1.4
03;2021-09-20;181;423;422;257208;248342;5009;77.6;75.0;1.5
03;2021-09-21;239;671;673;257447;249013;5682;77.7;75.2;1.7
03;2021-09-22;259;664;656;257706;249677;6338;77.8;75.4;1.9
03;2021-09-23;160;424;630;257866;250101;6968;77.8;75.5;2.1
03;2021-09-24;146;350;302;258012;250451;7270;77.9;75.6;2.2
03;2021-09-25;61;268;44;258073;250719;7314;77.9;75.7;2.2
03;2021-09-26;2;2;0;258075;250721;7314;77.9;75.7;2.2
03;2021-09-27;120;336;287;258195;251057;7601;77.9;75.8;2.3
03;2021-09-28;171;583;694;258366;251640;8295;78.0;76.0;2.5
03;2021-09-29;195;463;602;258561;252103;8897;78.0;76.1;2.7
03;2021-09-30;119;236;467;258680;252339;9364;78.1;76.2;2.8
03;2021-10-01;165;477;326;258845;252816;9690;78.1;76.3;2.9
03;2021-10-02;89;191;136;258934;253007;9826;78.2;76.4;3.0
03;2021-10-03;0;1;6;258934;253008;9832;78.2;76.4;3.0
03;2021-10-04;51;118;228;258985;253126;10060;78.2;76.4;3.0
03;2021-10-05;158;369;622;259143;253495;10682;78.2;76.5;3.2
03;2021-10-06;260;496;756;259403;253991;11438;78.3;76.7;3.5
03;2021-10-07;95;202;540;259498;254193;11978;78.3;76.7;3.6
03;2021-10-08;137;284;501;259635;254477;12479;78.4;76.8;3.8
03;2021-10-09;105;175;229;259740;254652;12708;78.4;76.9;3.8
03;2021-10-10;6;8;72;259746;254660;12780;78.4;76.9;3.9
03;2021-10-11;168;276;568;259914;254936;13348;78.4;76.9;4.0
03;2021-10-12;167;275;711;260081;255211;14059;78.5;77.0;4.2
03;2021-10-13;243;364;755;260324;255575;14814;78.6;77.1;4.5
03;2021-10-14;90;159;578;260414;255734;15392;78.6;77.2;4.6
03;2021-10-15;97;188;307;260511;255922;15699;78.6;77.2;4.7
03;2021-10-16;72;100;149;260583;256022;15848;78.7;77.3;4.8
03;2021-10-17;2;2;4;260585;256024;15852;78.7;77.3;4.8
03;2021-10-18;71;121;372;260656;256145;16224;78.7;77.3;4.9
03;2021-10-19;92;136;547;260748;256281;16771;78.7;77.4;5.1
03;2021-10-20;165;323;1044;260913;256604;17815;78.8;77.5;5.4
03;2021-10-21;68;102;732;260981;256706;18547;78.8;77.5;5.6
03;2021-10-22;93;184;578;261074;256890;19125;78.8;77.5;5.8
03;2021-10-23;25;91;152;261099;256981;19277;78.8;77.6;5.8
03;2021-10-24;3;1;10;261102;256982;19287;78.8;77.6;5.8
03;2021-10-25;61;57;486;261163;257039;19773;78.8;77.6;6.0
03;2021-10-26;69;116;457;261232;257155;20230;78.8;77.6;6.1
03;2021-10-27;129;263;1285;261361;257418;21515;78.9;77.7;6.5
03;2021-10-28;70;95;689;261431;257513;22204;78.9;77.7;6.7
03;2021-10-29;59;118;491;261490;257631;22695;78.9;77.8;6.8
03;2021-10-30;28;58;149;261518;257689;22844;78.9;77.8;6.9
03;2021-10-31;0;2;5;261518;257691;22849;78.9;77.8;6.9
03;2021-11-01;8;20;34;261526;257711;22883;78.9;77.8;6.9
03;2021-11-02;58;133;643;261584;257844;23526;79.0;77.8;7.1
03;2021-11-03;144;314;1319;261728;258158;24845;79.0;77.9;7.5
03;2021-11-04;46;117;896;261774;258275;25741;79.0;78.0;7.8
03;2021-11-05;79;122;771;261853;258397;26512;79.0;78.0;8.0
03;2021-11-06;20;72;243;261873;258469;26755;79.0;78.0;8.1
03;2021-11-07;1;4;16;261874;258473;26771;79.0;78.0;8.1
03;2021-11-08;40;101;651;261914;258574;27422;79.1;78.0;8.3
03;2021-11-09;58;98;975;261972;258672;28397;79.1;78.1;8.6
03;2021-11-10;146;236;2031;262118;258908;30428;79.1;78.1;9.2
03;2021-11-11;3;5;44;262121;258913;30472;79.1;78.1;9.2
03;2021-11-12;38;97;655;262159;259010;31127;79.1;78.2;9.4
03;2021-11-13;21;23;344;262180;259033;31471;79.1;78.2;9.5
03;2021-11-14;1;5;9;262181;259038;31480;79.1;78.2;9.5
03;2021-11-15;41;63;853;262222;259101;32333;79.1;78.2;9.8
03;2021-11-16;61;82;1244;262283;259183;33577;79.2;78.2;10.1
03;2021-11-17;150;180;1984;262433;259363;35561;79.2;78.3;10.7
03;2021-11-18;69;74;1679;262502;259437;37240;79.2;78.3;11.2
03;2021-11-19;103;116;1455;262605;259553;38695;79.3;78.3;11.7
03;2021-11-20;46;37;570;262651;259590;39265;79.3;78.4;11.9
03;2021-11-21;0;4;16;262651;259594;39281;79.3;78.4;11.9
03;2021-11-22;57;31;935;262708;259625;40216;79.3;78.4;12.1
03;2021-11-23;59;45;1242;262767;259670;41458;79.3;78.4;12.5
03;2021-11-24;135;135;2006;262902;259805;43464;79.4;78.4;13.1
03;2021-11-25;70;66;1796;262972;259871;45260;79.4;78.4;13.7
03;2021-11-26;88;97;1919;263060;259968;47179;79.4;78.5;14.2
03;2021-11-27;32;41;657;263092;260009;47836;79.4;78.5;14.4
03;2021-11-28;1;3;37;263093;260012;47873;79.4;78.5;14.4
03;2021-11-29;42;59;1636;263135;260071;49509;79.4;78.5;14.9
03;2021-11-30;79;72;3143;263214;260143;52652;79.4;78.5;15.9
03;2021-12-01;78;125;3130;263292;260268;55782;79.5;78.6;16.8
03;2021-12-02;53;42;3673;263345;260310;59455;79.5;78.6;17.9
03;2021-12-03;66;60;3141;263411;260370;62596;79.5;78.6;18.9
03;2021-12-04;51;33;1658;263462;260403;64254;79.5;78.6;19.4
03;2021-12-05;1;3;75;263463;260406;64329;79.5;78.6;19.4
03;2021-12-06;39;50;2895;263502;260456;67224;79.5;78.6;20.3
03;2021-12-07;69;77;4306;263571;260533;71530;79.6;78.6;21.6
03;2021-12-08;51;145;3856;263622;260678;75386;79.6;78.7;22.8
03;2021-12-09;79;73;4344;263701;260751;79730;79.6;78.7;24.1
03;2021-12-10;78;111;5113;263779;260862;84843;79.6;78.7;25.6
03;2021-12-11;36;40;2192;263815;260902;87035;79.6;78.7;26.3
03;2021-12-12;2;5;102;263817;260907;87137;79.6;78.7;26.3
03;2021-12-13;56;69;3364;263873;260976;90501;79.6;78.8;27.3
03;2021-12-14;83;87;5048;263956;261063;95549;79.7;78.8;28.8
03;2021-12-15;65;139;4876;264021;261202;100425;79.7;78.8;30.3
03;2021-12-16;67;94;5382;264088;261296;105807;79.7;78.9;31.9
04;2020-12-27;0;0;0;0;0;0;0.0;0.0;0.0
04;2020-12-28;0;0;0;0;0;0;0.0;0.0;0.0
04;2020-12-29;0;0;0;0;0;0;0.0;0.0;0.0
04;2020-12-30;0;0;0;0;0;0;0.0;0.0;0.0
04;2020-12-31;0;0;0;0;0;0;0.0;0.0;0.0
04;2021-01-01;0;0;0;0;0;0;0.0;0.0;0.0
04;2021-01-02;0;0;0;0;0;0;0.0;0.0;0.0
04;2021-01-03;0;0;0;0;0;0;0.0;0.0;0.0
04;2021-01-04;1;0;0;1;0;0;0.0;0.0;0.0
04;2021-01-05;3;0;0;4;0;0;0.0;0.0;0.0
04;2021-01-06;2;0;0;6;0;0;0.0;0.0;0.0
04;2021-01-07;53;0;0;59;0;0;0.0;0.0;0.0
04;2021-01-08;91;0;0;150;0;0;0.1;0.0;0.0
04;2021-01-09;29;0;0;179;0;0;0.1;0.0;0.0
04;2021-01-10;0;0;0;179;0;0;0.1;0.0;0.0
04;2021-01-11;75;0;0;254;0;0;0.2;0.0;0.0
04;2021-01-12;356;0;0;610;0;0;0.4;0.0;0.0
04;2021-01-13;209;2;0;819;2;0;0.5;0.0;0.0
04;2021-01-14;95;4;0;914;6;0;0.6;0.0;0.0
04;2021-01-15;172;4;0;1086;10;0;0.7;0.0;0.0
04;2021-01-16;80;2;0;1166;12;0;0.7;0.0;0.0
04;2021-01-17;14;0;0;1180;12;0;0.7;0.0;0.0
04;2021-01-18;223;5;0;1403;17;0;0.8;0.0;0.0
04;2021-01-19;446;4;0;1849;21;0;1.1;0.0;0.0
04;2021-01-20;531;9;0;2380;30;0;1.4;0.0;0.0
04;2021-01-21;531;3;0;2911;33;0;1.8;0.0;0.0
04;2021-01-22;541;1;0;3452;34;0;2.1;0.0;0.0
04;2021-01-23;95;1;0;3547;35;0;2.1;0.0;0.0
04;2021-01-24;0;0;0;3547;35;0;2.1;0.0;0.0
04;2021-01-25;225;0;0;3772;35;0;2.3;0.0;0.0
04;2021-01-26;584;2;0;4356;37;0;2.6;0.0;0.0
04;2021-01-27;449;1;0;4805;38;0;2.9;0.0;0.0
04;2021-01-28;565;22;0;5370;60;0;3.3;0.0;0.0
04;2021-01-29;326;65;0;5696;125;0;3.4;0.1;0.0
04;2021-01-30;49;28;0;5745;153;0;3.5;0.1;0.0
04;2021-01-31;1;3;0;5746;156;0;3.5;0.1;0.0
04;2021-02-01;251;126;0;5997;282;0;3.6;0.2;0.0
04;2021-02-02;513;208;0;6510;490;0;3.9;0.3;0.0
04;2021-02-03;296;134;0;6806;624;0;4.1;0.4;0.0
04;2021-02-04;302;65;0;7108;689;0;4.3;0.4;0.0
04;2021-02-05;352;192;0;7460;881;0;4.5;0.5;0.0
04;2021-02-06;33;74;0;7493;955;0;4.5;0.6;0.0
04;2021-02-07;3;12;0;7496;967;0;4.5;0.6;0.0
04;2021-02-08;159;74;0;7655;1041;0;4.6;0.6;0.0
04;2021-02-09;154;147;0;7809;1188;0;4.7;0.7;0.0
04;2021-02-10;253;177;0;8062;1365;0;4.9;0.8;0.0
04;2021-02-11;321;279;0;8383;1644;0;5.1;1.0;0.0
04;2021-02-12;286;309;0;8669;1953;0;5.2;1.2;0.0
04;2021-02-13;22;88;0;8691;2041;0;5.3;1.2;0.0
04;2021-02-14;0;1;0;8691;2042;0;5.3;1.2;0.0
04;2021-02-15;29;149;0;8720;2191;0;5.3;1.3;0.0
04;2021-02-16;79;455;0;8799;2646;0;5.3;1.6;0.0
04;2021-02-17;64;388;0;8863;3034;0;5.4;1.8;0.0
04;2021-02-18;56;547;0;8919;3581;0;5.4;2.2;0.0
04;2021-02-19;61;327;0;8980;3908;0;5.4;2.4;0.0
04;2021-02-20;7;59;0;8987;3967;0;5.4;2.4;0.0
04;2021-02-21;0;0;0;8987;3967;0;5.4;2.4;0.0
04;2021-02-22;15;284;0;9002;4251;0;5.4;2.6;0.0
04;2021-02-23;29;528;0;9031;4779;0;5.5;2.9;0.0
04;2021-02-24;43;400;0;9074;5179;0;5.5;3.1;0.0
04;2021-02-25;71;327;0;9145;5506;0;5.5;3.3;0.0
04;2021-02-26;206;299;0;9351;5805;0;5.7;3.5;0.0
04;2021-02-27;158;64;0;9509;5869;0;5.8;3.6;0.0
04;2021-02-28;0;0;0;9509;5869;0;5.8;3.6;0.0
04;2021-03-01;24;79;0;9533;5948;0;5.8;3.6;0.0
04;2021-03-02;141;45;0;9674;5993;0;5.9;3.6;0.0
04;2021-03-03;354;553;0;10028;6546;0;6.1;4.0;0.0
04;2021-03-04;212;438;0;10240;6984;0;6.2;4.2;0.0
04;2021-03-05;247;304;0;10487;7288;0;6.3;4.4;0.0
04;2021-03-06;849;60;0;11336;7348;0;6.9;4.4;0.0
04;2021-03-07;468;24;0;11804;7372;0;7.1;4.5;0.0
04;2021-03-08;62;87;0;11866;7459;0;7.2;4.5;0.0
04;2021-03-09;215;208;0;12081;7667;0;7.3;4.6;0.0
04;2021-03-10;400;302;0;12481;7969;0;7.6;4.8;0.0
04;2021-03-11;488;325;0;12969;8294;0;7.9;5.0;0.0
04;2021-03-12;681;207;0;13650;8501;0;8.3;5.1;0.0
04;2021-03-13;994;56;0;14644;8557;0;8.9;5.2;0.0
04;2021-03-14;412;7;0;15056;8564;0;9.1;5.2;0.0
04;2021-03-15;115;14;0;15171;8578;0;9.2;5.2;0.0
04;2021-03-16;88;15;0;15259;8593;0;9.2;5.2;0.0
04;2021-03-17;541;87;0;15800;8680;0;9.6;5.3;0.0
04;2021-03-18;786;34;0;16586;8714;0;10.0;5.3;0.0
04;2021-03-19;719;40;0;17305;8754;0;10.5;5.3;0.0
04;2021-03-20;150;4;0;17455;8758;0;10.6;5.3;0.0
04;2021-03-21;2;0;0;17457;8758;0;10.6;5.3;0.0
04;2021-03-22;151;19;0;17608;8777;0;10.7;5.3;0.0
04;2021-03-23;264;17;0;17872;8794;0;10.8;5.3;0.0
04;2021-03-24;1006;40;0;18878;8834;0;11.4;5.3;0.0
04;2021-03-25;1218;60;0;20096;8894;0;12.2;5.4;0.0
04;2021-03-26;1394;77;0;21490;8971;0;13.0;5.4;0.0
04;2021-03-27;240;17;0;21730;8988;0;13.2;5.4;0.0
04;2021-03-28;11;0;0;21741;8988;0;13.2;5.4;0.0
04;2021-03-29;663;27;0;22404;9015;0;13.6;5.5;0.0
04;2021-03-30;1035;143;0;23439;9158;0;14.2;5.5;0.0
04;2021-03-31;1260;113;0;24699;9271;0;15.0;5.6;0.0
04;2021-04-01;1054;133;0;25753;9404;0;15.6;5.7;0.0
04;2021-04-02;1120;127;0;26873;9531;0;16.3;5.8;0.0
04;2021-04-03;219;29;0;27092;9560;0;16.4;5.8;0.0
04;2021-04-04;11;4;0;27103;9564;0;16.4;5.8;0.0
04;2021-04-05;44;4;0;27147;9568;0;16.4;5.8;0.0
04;2021-04-06;895;153;0;28042;9721;0;17.0;5.9;0.0
04;2021-04-07;840;431;0;28882;10152;0;17.5;6.1;0.0
04;2021-04-08;876;636;0;29758;10788;0;18.0;6.5;0.0
04;2021-04-09;672;424;0;30430;11212;0;18.4;6.8;0.0
04;2021-04-10;238;160;0;30668;11372;0;18.6;6.9;0.0
04;2021-04-11;134;51;0;30802;11423;0;18.6;6.9;0.0
04;2021-04-12;604;127;0;31406;11550;0;19.0;7.0;0.0
04;2021-04-13;1050;238;0;32456;11788;0;19.6;7.1;0.0
04;2021-04-14;911;494;0;33367;12282;0;20.2;7.4;0.0
04;2021-04-15;833;641;0;34200;12923;0;20.7;7.8;0.0
04;2021-04-16;781;468;0;34981;13391;0;21.2;8.1;0.0
04;2021-04-17;217;86;0;35198;13477;0;21.3;8.2;0.0
04;2021-04-18;11;15;0;35209;13492;0;21.3;8.2;0.0
04;2021-04-19;356;296;0;35565;13788;0;21.5;8.3;0.0
04;2021-04-20;892;435;0;36457;14223;0;22.1;8.6;0.0
04;2021-04-21;630;717;0;37087;14940;0;22.5;9.0;0.0
04;2021-04-22;659;773;0;37746;15713;0;22.8;9.5;0.0
04;2021-04-23;676;535;0;38422;16248;0;23.3;9.8;0.0
04;2021-04-24;147;68;0;38569;16316;0;23.3;9.9;0.0
04;2021-04-25;5;8;0;38574;16324;0;23.4;9.9;0.0
04;2021-04-26;201;617;0;38775;16941;0;23.5;10.3;0.0
04;2021-04-27;388;882;0;39163;17823;0;23.7;10.8;0.0
04;2021-04-28;457;1012;0;39620;18835;0;24.0;11.4;0.0
04;2021-04-29;667;1026;0;40287;19861;0;24.4;12.0;0.0
04;2021-04-30;489;814;0;40776;20675;0;24.7;12.5;0.0
04;2021-05-01;94;25;0;40870;20700;0;24.7;12.5;0.0
04;2021-05-02;19;116;0;40889;20816;0;24.8;12.6;0.0
04;2021-05-03;193;545;0;41082;21361;0;24.9;12.9;0.0
04;2021-05-04;535;810;0;41617;22171;0;25.2;13.4;0.0
04;2021-05-05;474;880;0;42091;23051;0;25.5;14.0;0.0
04;2021-05-06;1048;559;0;43139;23610;0;26.1;14.3;0.0
04;2021-05-07;664;707;0;43803;24317;0;26.5;14.7;0.0
04;2021-05-08;87;78;0;43890;24395;0;26.6;14.8;0.0
04;2021-05-09;14;6;0;43904;24401;0;26.6;14.8;0.0
04;2021-05-10;486;359;0;44390;24760;0;26.9;15.0;0.0
04;2021-05-11;1158;851;0;45548;25611;0;27.6;15.5;0.0
04;2021-05-12;1358;680;0;46906;26291;0;28.4;15.9;0.0
04;2021-05-13;400;116;0;47306;26407;0;28.6;16.0;0.0
04;2021-05-14;491;300;0;47797;26707;0;28.9;16.2;0.0
04;2021-05-15;203;128;0;48000;26835;0;29.1;16.2;0.0
04;2021-05-16;50;8;0;48050;26843;0;29.1;16.2;0.0
04;2021-05-17;219;310;0;48269;27153;0;29.2;16.4;0.0
04;2021-05-18;451;923;0;48720;28076;0;29.5;17.0;0.0
04;2021-05-19;791;657;0;49511;28733;0;30.0;17.4;0.0
04;2021-05-20;1189;574;0;50700;29307;0;30.7;17.7;0.0
04;2021-05-21;909;765;0;51609;30072;0;31.2;18.2;0.0
04;2021-05-22;167;130;0;51776;30202;0;31.3;18.3;0.0
04;2021-05-23;24;6;0;51800;30208;0;31.4;18.3;0.0
04;2021-05-24;76;41;0;51876;30249;0;31.4;18.3;0.0
04;2021-05-25;854;549;0;52730;30798;0;31.9;18.6;0.0
04;2021-05-26;1017;757;0;53747;31555;0;32.5;19.1;0.0
04;2021-05-27;1280;608;0;55027;32163;0;33.3;19.5;0.0
04;2021-05-28;1073;649;0;56100;32812;0;34.0;19.9;0.0
04;2021-05-29;149;366;0;56249;33178;0;34.0;20.1;0.0
04;2021-05-30;15;8;0;56264;33186;0;34.1;20.1;0.0
04;2021-05-31;509;443;0;56773;33629;0;34.4;20.4;0.0
04;2021-06-01;726;614;0;57499;34243;0;34.8;20.7;0.0
04;2021-06-02;931;1017;0;58430;35260;0;35.4;21.3;0.0
04;2021-06-03;1129;773;0;59559;36033;0;36.1;21.8;0.0
04;2021-06-04;1005;790;0;60564;36823;0;36.7;22.3;0.0
04;2021-06-05;184;212;0;60748;37035;0;36.8;22.4;0.0
04;2021-06-06;23;27;0;60771;37062;0;36.8;22.4;0.0
04;2021-06-07;587;368;0;61358;37430;0;37.1;22.7;0.0
04;2021-06-08;790;581;0;62148;38011;0;37.6;23.0;0.0
04;2021-06-09;1084;683;0;63232;38694;0;38.3;23.4;0.0
04;2021-06-10;1050;578;0;64282;39272;0;38.9;23.8;0.0
04;2021-06-11;872;661;0;65154;39933;0;39.4;24.2;0.0
04;2021-06-12;255;167;0;65409;40100;0;39.6;24.3;0.0
04;2021-06-13;18;10;0;65427;40110;0;39.6;24.3;0.0
04;2021-06-14;468;386;0;65895;40496;0;39.9;24.5;0.0
04;2021-06-15;621;939;0;66516;41435;0;40.3;25.1;0.0
04;2021-06-16;904;741;0;67420;42176;0;40.8;25.5;0.0
04;2021-06-17;862;891;0;68282;43067;0;41.3;26.1;0.0
04;2021-06-18;713;859;0;68995;43926;0;41.8;26.6;0.0
04;2021-06-19;100;161;0;69095;44087;0;41.8;26.7;0.0
04;2021-06-20;12;22;0;69107;44109;0;41.8;26.7;0.0
04;2021-06-21;295;635;0;69402;44744;0;42.0;27.1;0.0
04;2021-06-22;374;1276;0;69776;46020;0;42.2;27.9;0.0
04;2021-06-23;431;1256;0;70207;47276;0;42.5;28.6;0.0
04;2021-06-24;699;793;0;70906;48069;0;42.9;29.1;0.0
04;2021-06-25;444;693;0;71350;48762;0;43.2;29.5;0.0
04;2021-06-26;79;241;0;71429;49003;0;43.2;29.7;0.0
04;2021-06-27;10;25;0;71439;49028;0;43.2;29.7;0.0
04;2021-06-28;160;416;0;71599;49444;0;43.3;29.9;0.0
04;2021-06-29;363;856;0;71962;50300;0;43.6;30.4;0.0
04;2021-06-30;493;1105;0;72455;51405;0;43.9;31.1;0.0
04;2021-07-01;522;1158;0;72977;52563;0;44.2;31.8;0.0
04;2021-07-02;497;1096;0;73474;53659;0;44.5;32.5;0.0
04;2021-07-03;90;221;0;73564;53880;0;44.5;32.6;0.0
04;2021-07-04;14;28;0;73578;53908;0;44.5;32.6;0.0
04;2021-07-05;155;418;0;73733;54326;0;44.6;32.9;0.0
04;2021-07-06;441;1349;0;74174;55675;0;44.9;33.7;0.0
04;2021-07-07;472;1268;0;74646;56943;0;45.2;34.5;0.0
04;2021-07-08;626;1206;0;75272;58149;0;45.6;35.2;0.0
04;2021-07-09;554;1078;0;75826;59227;0;45.9;35.9;0.0
04;2021-07-10;121;215;0;75947;59442;0;46.0;36.0;0.0
04;2021-07-11;14;45;0;75961;59487;0;46.0;36.0;0.0
04;2021-07-12;154;708;0;76115;60195;0;46.1;36.4;0.0
04;2021-07-13;746;1463;0;76861;61658;0;46.5;37.3;0.0
04;2021-07-14;91;81;0;76952;61739;0;46.6;37.4;0.0
04;2021-07-15;999;1500;0;77951;63239;0;47.2;38.3;0.0
04;2021-07-16;1049;1140;0;79000;64379;0;47.8;39.0;0.0
04;2021-07-17;455;276;0;79455;64655;0;48.1;39.1;0.0
04;2021-07-18;121;42;0;79576;64697;0;48.2;39.2;0.0
04;2021-07-19;512;694;0;80088;65391;0;48.5;39.6;0.0
04;2021-07-20;1187;1323;0;81275;66714;0;49.2;40.4;0.0
04;2021-07-21;948;1089;0;82223;67803;0;49.8;41.0;0.0
04;2021-07-22;1327;1189;0;83550;68992;0;50.6;41.8;0.0
04;2021-07-23;1149;1096;0;84699;70088;0;51.3;42.4;0.0
04;2021-07-24;594;250;0;85293;70338;0;51.6;42.6;0.0
04;2021-07-25;55;30;0;85348;70368;0;51.7;42.6;0.0
04;2021-07-26;516;637;0;85864;71005;0;52.0;43.0;0.0
04;2021-07-27;1232;927;0;87096;71932;0;52.7;43.5;0.0
04;2021-07-28;1117;990;0;88213;72922;0;53.4;44.1;0.0
04;2021-07-29;1367;1083;0;89580;74005;0;54.2;44.8;0.0
04;2021-07-30;1167;820;0;90747;74825;0;54.9;45.3;0.0
04;2021-07-31;293;193;0;91040;75018;0;55.1;45.4;0.0
04;2021-08-01;55;27;0;91095;75045;0;55.1;45.4;0.0
04;2021-08-02;256;175;0;91351;75220;0;55.3;45.5;0.0
04;2021-08-03;1156;935;0;92507;76155;0;56.0;46.1;0.0
04;2021-08-04;1077;714;0;93584;76869;0;56.6;46.5;0.0
04;2021-08-05;977;563;0;94561;77432;0;57.2;46.9;0.0
04;2021-08-06;575;461;0;95136;77893;0;57.6;47.2;0.0
04;2021-08-07;206;228;0;95342;78121;0;57.7;47.3;0.0
04;2021-08-08;44;25;0;95386;78146;0;57.7;47.3;0.0
04;2021-08-09;204;222;0;95590;78368;0;57.9;47.4;0.0
04;2021-08-10;588;845;0;96178;79213;0;58.2;48.0;0.0
04;2021-08-11;1072;911;0;97250;80124;0;58.9;48.5;0.0
04;2021-08-12;977;1078;0;98227;81202;0;59.5;49.2;0.0
04;2021-08-13;486;438;0;98713;81640;0;59.8;49.4;0.0
04;2021-08-14;144;161;0;98857;81801;0;59.8;49.5;0.0
04;2021-08-15;16;21;0;98873;81822;0;59.9;49.5;0.0
04;2021-08-16;203;306;0;99076;82128;0;60.0;49.7;0.0
04;2021-08-17;456;969;0;99532;83097;0;60.3;50.3;0.0
04;2021-08-18;643;1269;0;100175;84366;0;60.6;51.1;0.0
04;2021-08-19;608;1247;0;100783;85613;0;61.0;51.8;0.0
04;2021-08-20;716;1353;0;101499;86966;0;61.4;52.6;0.0
04;2021-08-21;107;213;0;101606;87179;0;61.5;52.8;0.0
04;2021-08-22;13;47;0;101619;87226;0;61.5;52.8;0.0
04;2021-08-23;105;226;0;101724;87452;0;61.6;52.9;0.0
04;2021-08-24;589;1318;0;102313;88770;0;61.9;53.7;0.0
04;2021-08-25;581;1137;0;102894;89907;0;62.3;54.4;0.0
04;2021-08-26;427;1053;0;103321;90960;0;62.5;55.1;0.0
04;2021-08-27;428;940;0;103749;91900;0;62.8;55.6;0.0
04;2021-08-28;148;285;0;103897;92185;0;62.9;55.8;0.0
04;2021-08-29;31;43;0;103928;92228;0;62.9;55.8;0.0
04;2021-08-30;131;342;8;104059;92570;8;63.0;56.0;0.0
04;2021-08-31;495;923;27;104554;93493;35;63.3;56.6;0.0
04;2021-09-01;492;1134;50;105046;94627;85;63.6;57.3;0.1
04;2021-09-02;322;838;80;105368;95465;165;63.8;57.8;0.1
04;2021-09-03;292;770;56;105660;96235;221;64.0;58.3;0.1
04;2021-09-04;151;282;14;105811;96517;235;64.1;58.4;0.1
04;2021-09-05;26;17;0;105837;96534;235;64.1;58.4;0.1
04;2021-09-06;98;202;6;105935;96736;241;64.1;58.6;0.1
04;2021-09-07;344;770;194;106279;97506;435;64.3;59.0;0.3
04;2021-09-08;331;728;153;106610;98234;588;64.5;59.5;0.4
04;2021-09-09;304;608;205;106914;98842;793;64.7;59.8;0.5
04;2021-09-10;281;674;128;107195;99516;921;64.9;60.2;0.6
04;2021-09-11;105;185;39;107300;99701;960;65.0;60.4;0.6
04;2021-09-12;8;20;3;107308;99721;963;65.0;60.4;0.6
04;2021-09-13;109;117;33;107417;99838;996;65.0;60.4;0.6
04;2021-09-14;319;535;307;107736;100373;1303;65.2;60.8;0.8
04;2021-09-15;282;631;345;108018;101004;1648;65.4;61.1;1.0
04;2021-09-16;274;446;296;108292;101450;1944;65.6;61.4;1.2
04;2021-09-17;186;493;145;108478;101943;2089;65.7;61.7;1.3
04;2021-09-18;53;160;61;108531;102103;2150;65.7;61.8;1.3
04;2021-09-19;7;18;1;108538;102121;2151;65.7;61.8;1.3
04;2021-09-20;86;89;37;108624;102210;2188;65.8;61.9;1.3
04;2021-09-21;171;523;285;108795;102733;2473;65.9;62.2;1.5
04;2021-09-22;149;627;213;108944;103360;2686;65.9;62.6;1.6
04;2021-09-23;165;321;214;109109;103681;2900;66.0;62.8;1.8
04;2021-09-24;157;433;153;109266;104114;3053;66.1;63.0;1.8
04;2021-09-25;47;137;105;109313;104251;3158;66.2;63.1;1.9
04;2021-09-26;4;22;4;109317;104273;3162;66.2;63.1;1.9
04;2021-09-27;33;98;17;109350;104371;3179;66.2;63.2;1.9
04;2021-09-28;120;255;220;109470;104626;3399;66.3;63.3;2.1
04;2021-09-29;134;354;206;109604;104980;3605;66.3;63.5;2.2
04;2021-09-30;108;236;154;109712;105216;3759;66.4;63.7;2.3
04;2021-10-01;158;206;124;109870;105422;3883;66.5;63.8;2.4
04;2021-10-02;70;158;82;109940;105580;3965;66.6;63.9;2.4
04;2021-10-03;0;5;0;109940;105585;3965;66.6;63.9;2.4
04;2021-10-04;49;71;22;109989;105656;3987;66.6;64.0;2.4
04;2021-10-05;159;311;269;110148;105967;4256;66.7;64.1;2.6
04;2021-10-06;165;308;195;110313;106275;4451;66.8;64.3;2.7
04;2021-10-07;99;248;212;110412;106523;4663;66.8;64.5;2.8
04;2021-10-08;120;185;181;110532;106708;4844;66.9;64.6;2.9
04;2021-10-09;38;106;70;110570;106814;4914;66.9;64.7;3.0
04;2021-10-10;5;6;0;110575;106820;4914;66.9;64.7;3.0
04;2021-10-11;45;125;70;110620;106945;4984;67.0;64.7;3.0
04;2021-10-12;111;169;310;110731;107114;5294;67.0;64.8;3.2
04;2021-10-13;151;249;271;110882;107363;5565;67.1;65.0;3.4
04;2021-10-14;82;178;211;110964;107541;5776;67.2;65.1;3.5
04;2021-10-15;80;147;244;111044;107688;6020;67.2;65.2;3.6
04;2021-10-16;37;74;87;111081;107762;6107;67.2;65.2;3.7
04;2021-10-17;1;4;0;111082;107766;6107;67.2;65.2;3.7
04;2021-10-18;64;104;111;111146;107870;6218;67.3;65.3;3.8
04;2021-10-19;71;176;319;111217;108046;6537;67.3;65.4;4.0
04;2021-10-20;110;185;352;111327;108231;6889;67.4;65.5;4.2
04;2021-10-21;53;111;287;111380;108342;7176;67.4;65.6;4.3
04;2021-10-22;70;115;181;111450;108457;7357;67.5;65.7;4.5
04;2021-10-23;55;65;138;111505;108522;7495;67.5;65.7;4.5
04;2021-10-24;3;8;3;111508;108530;7498;67.5;65.7;4.5
04;2021-10-25;35;40;42;111543;108570;7540;67.5;65.7;4.6
04;2021-10-26;72;89;300;111615;108659;7840;67.6;65.8;4.7
04;2021-10-27;107;187;477;111722;108846;8317;67.6;65.9;5.0
04;2021-10-28;69;73;317;111791;108919;8634;67.7;65.9;5.2
04;2021-10-29;62;81;184;111853;109000;8818;67.7;66.0;5.3
04;2021-10-30;59;57;194;111912;109057;9012;67.7;66.0;5.5
04;2021-10-31;3;11;11;111915;109068;9023;67.7;66.0;5.5
04;2021-11-01;17;9;15;111932;109077;9038;67.8;66.0;5.5
04;2021-11-02;59;66;294;111991;109143;9332;67.8;66.1;5.6
04;2021-11-03;78;134;388;112069;109277;9720;67.8;66.1;5.9
04;2021-11-04;55;83;412;112124;109360;10132;67.9;66.2;6.1
04;2021-11-05;72;125;467;112196;109485;10599;67.9;66.3;6.4
04;2021-11-06;44;56;238;112240;109541;10837;67.9;66.3;6.6
04;2021-11-07;23;17;7;112263;109558;10844;68.0;66.3;6.6
04;2021-11-08;35;44;146;112298;109602;10990;68.0;66.3;6.7
04;2021-11-09;59;95;463;112357;109697;11453;68.0;66.4;6.9
04;2021-11-10;86;130;570;112443;109827;12023;68.1;66.5;7.3
04;2021-11-11;11;13;12;112454;109840;12035;68.1;66.5;7.3
04;2021-11-12;63;78;377;112517;109918;12412;68.1;66.5;7.5
04;2021-11-13;29;47;206;112546;109965;12618;68.1;66.6;7.6
04;2021-11-14;3;9;17;112549;109974;12635;68.1;66.6;7.6
04;2021-11-15;51;48;290;112600;110022;12925;68.2;66.6;7.8
04;2021-11-16;49;82;584;112649;110104;13509;68.2;66.7;8.2
04;2021-11-17;84;92;576;112733;110196;14085;68.2;66.7;8.5
04;2021-11-18;73;74;631;112806;110270;14716;68.3;66.8;8.9
04;2021-11-19;88;106;634;112894;110376;15350;68.3;66.8;9.3
04;2021-11-20;70;63;353;112964;110439;15703;68.4;66.9;9.5
04;2021-11-21;4;9;13;112968;110448;15716;68.4;66.9;9.5
04;2021-11-22;39;43;327;113007;110491;16043;68.4;66.9;9.7
04;2021-11-23;54;64;739;113061;110555;16782;68.4;66.9;10.2
04;2021-11-24;93;96;788;113154;110651;17570;68.5;67.0;10.6
04;2021-11-25;77;60;857;113231;110711;18427;68.5;67.0;11.2
04;2021-11-26;99;75;1051;113330;110786;19478;68.6;67.1;11.8
04;2021-11-27;58;64;479;113388;110850;19957;68.6;67.1;12.1
04;2021-11-28;2;15;27;113390;110865;19984;68.6;67.1;12.1
04;2021-11-29;61;63;876;113451;110928;20860;68.7;67.1;12.6
04;2021-11-30;99;75;1481;113550;111003;22341;68.7;67.2;13.5
04;2021-12-01;101;132;1268;113651;111135;23609;68.8;67.3;14.3
04;2021-12-02;59;62;1450;113710;111197;25059;68.8;67.3;15.2
04;2021-12-03;51;81;1302;113761;111278;26361;68.9;67.4;16.0
04;2021-12-04;69;76;943;113830;111354;27304;68.9;67.4;16.5
04;2021-12-05;8;8;152;113838;111362;27456;68.9;67.4;16.6
04;2021-12-06;51;72;715;113889;111434;28171;68.9;67.5;17.1
04;2021-12-07;84;85;1833;113973;111519;30004;69.0;67.5;18.2
04;2021-12-08;94;93;1903;114067;111612;31907;69.0;67.6;19.3
04;2021-12-09;85;69;1609;114152;111681;33516;69.1;67.6;20.3
04;2021-12-10;81;84;1429;114233;111765;34945;69.1;67.7;21.2
04;2021-12-11;65;66;1080;114298;111831;36025;69.2;67.7;21.8
04;2021-12-12;10;13;202;114308;111844;36227;69.2;67.7;21.9
04;2021-12-13;62;66;868;114370;111910;37095;69.2;67.7;22.5
04;2021-12-14;88;114;1761;114458;112024;38856;69.3;67.8;23.5
04;2021-12-15;106;126;2024;114564;112150;40880;69.3;67.9;24.7
04;2021-12-16;84;89;1801;114648;112239;42681;69.4;67.9;25.8
05;2020-12-27;0;0;0;0;0;0;0.0;0.0;0.0
05;2020-12-28;1;0;0;1;0;0;0.0;0.0;0.0
05;2020-12-29;1;0;0;2;0;0;0.0;0.0;0.0
05;2020-12-30;2;0;0;4;0;0;0.0;0.0;0.0
05;2020-12-31;0;0;0;4;0;0;0.0;0.0;0.0
05;2021-01-01;1;0;0;5;0;0;0.0;0.0;0.0
05;2021-01-02;2;0;0;7;0;0;0.0;0.0;0.0
05;2021-01-03;2;0;0;9;0;0;0.0;0.0;0.0
05;2021-01-04;1;0;0;10;0;0;0.0;0.0;0.0
05;2021-01-05;1;0;0;11;0;0;0.0;0.0;0.0
05;2021-01-06;22;0;0;33;0;0;0.0;0.0;0.0
05;2021-01-07;127;0;0;160;0;0;0.1;0.0;0.0
05;2021-01-08;126;1;0;286;1;0;0.2;0.0;0.0
05;2021-01-09;28;0;0;314;1;0;0.2;0.0;0.0
05;2021-01-10;0;0;0;314;1;0;0.2;0.0;0.0
05;2021-01-11;45;0;0;359;1;0;0.3;0.0;0.0
05;2021-01-12;106;0;0;465;1;0;0.3;0.0;0.0
05;2021-01-13;146;0;0;611;1;0;0.4;0.0;0.0
05;2021-01-14;166;0;0;777;1;0;0.5;0.0;0.0
05;2021-01-15;126;2;0;903;3;0;0.6;0.0;0.0
05;2021-01-16;18;0;0;921;3;0;0.6;0.0;0.0
05;2021-01-17;0;0;0;921;3;0;0.6;0.0;0.0
05;2021-01-18;215;3;0;1136;6;0;0.8;0.0;0.0
05;2021-01-19;232;0;0;1368;6;0;1.0;0.0;0.0
05;2021-01-20;214;1;0;1582;7;0;1.1;0.0;0.0
05;2021-01-21;251;0;0;1833;7;0;1.3;0.0;0.0
05;2021-01-22;189;1;0;2022;8;0;1.4;0.0;0.0
05;2021-01-23;112;0;0;2134;8;0;1.5;0.0;0.0
05;2021-01-24;2;0;0;2136;8;0;1.5;0.0;0.0
05;2021-01-25;295;0;0;2431;8;0;1.7;0.0;0.0
05;2021-01-26;452;1;0;2883;9;0;2.0;0.0;0.0
05;2021-01-27;357;5;0;3240;14;0;2.3;0.0;0.0
05;2021-01-28;347;54;0;3587;68;0;2.5;0.0;0.0
05;2021-01-29;350;88;0;3937;156;0;2.8;0.1;0.0
05;2021-01-30;95;8;0;4032;164;0;2.8;0.1;0.0
05;2021-01-31;3;0;0;4035;164;0;2.8;0.1;0.0
05;2021-02-01;175;28;0;4210;192;0;3.0;0.1;0.0
05;2021-02-02;183;127;0;4393;319;0;3.1;0.2;0.0
05;2021-02-03;202;77;0;4595;396;0;3.2;0.3;0.0
05;2021-02-04;192;125;0;4787;521;0;3.4;0.4;0.0
05;2021-02-05;175;106;0;4962;627;0;3.5;0.4;0.0
05;2021-02-06;74;24;0;5036;651;0;3.6;0.5;0.0
05;2021-02-07;0;6;0;5036;657;0;3.6;0.5;0.0
05;2021-02-08;85;124;0;5121;781;0;3.6;0.6;0.0
05;2021-02-09;100;123;0;5221;904;0;3.7;0.6;0.0
05;2021-02-10;81;171;0;5302;1075;0;3.7;0.8;0.0
05;2021-02-11;90;138;0;5392;1213;0;3.8;0.9;0.0
05;2021-02-12;88;137;0;5480;1350;0;3.9;1.0;0.0
05;2021-02-13;77;30;0;5557;1380;0;3.9;1.0;0.0
05;2021-02-14;1;0;0;5558;1380;0;3.9;1.0;0.0
05;2021-02-15;94;187;0;5652;1567;0;4.0;1.1;0.0
05;2021-02-16;113;276;0;5765;1843;0;4.1;1.3;0.0
05;2021-02-17;133;220;0;5898;2063;0;4.2;1.5;0.0
05;2021-02-18;152;284;0;6050;2347;0;4.3;1.7;0.0
05;2021-02-19;158;299;0;6208;2646;0;4.4;1.9;0.0
05;2021-02-20;34;88;0;6242;2734;0;4.4;1.9;0.0
05;2021-02-21;0;0;0;6242;2734;0;4.4;1.9;0.0
05;2021-02-22;66;244;0;6308;2978;0;4.4;2.1;0.0
05;2021-02-23;19;222;0;6327;3200;0;4.5;2.3;0.0
05;2021-02-24;30;183;0;6357;3383;0;4.5;2.4;0.0
05;2021-02-25;75;176;0;6432;3559;0;4.5;2.5;0.0
05;2021-02-26;166;206;0;6598;3765;0;4.7;2.7;0.0
05;2021-02-27;73;156;0;6671;3921;0;4.7;2.8;0.0
05;2021-02-28;10;0;0;6681;3921;0;4.7;2.8;0.0
05;2021-03-01;98;155;0;6779;4076;0;4.8;2.9;0.0
05;2021-03-02;100;192;0;6879;4268;0;4.9;3.0;0.0
05;2021-03-03;125;218;0;7004;4486;0;4.9;3.2;0.0
05;2021-03-04;257;170;0;7261;4656;0;5.1;3.3;0.0
05;2021-03-05;560;188;0;7821;4844;0;5.5;3.4;0.0
05;2021-03-06;654;60;0;8475;4904;0;6.0;3.5;0.0
05;2021-03-07;482;24;0;8957;4928;0;6.3;3.5;0.0
05;2021-03-08;518;137;0;9475;5065;0;6.7;3.6;0.0
05;2021-03-09;516;153;0;9991;5218;0;7.0;3.7;0.0
05;2021-03-10;508;143;0;10499;5361;0;7.4;3.8;0.0
05;2021-03-11;372;134;0;10871;5495;0;7.7;3.9;0.0
05;2021-03-12;450;93;0;11321;5588;0;8.0;3.9;0.0
05;2021-03-13;766;101;0;12087;5689;0;8.5;4.0;0.0
05;2021-03-14;645;12;0;12732;5701;0;9.0;4.0;0.0
05;2021-03-15;339;119;0;13071;5820;0;9.2;4.1;0.0
05;2021-03-16;153;144;0;13224;5964;0;9.3;4.2;0.0
05;2021-03-17;260;126;0;13484;6090;0;9.5;4.3;0.0
05;2021-03-18;352;44;0;13836;6134;0;9.8;4.3;0.0
05;2021-03-19;448;60;0;14284;6194;0;10.1;4.4;0.0
05;2021-03-20;172;34;0;14456;6228;0;10.2;4.4;0.0
05;2021-03-21;1;0;0;14457;6228;0;10.2;4.4;0.0
05;2021-03-22;697;51;0;15154;6279;0;10.7;4.4;0.0
05;2021-03-23;771;22;0;15925;6301;0;11.2;4.4;0.0
05;2021-03-24;770;90;0;16695;6391;0;11.8;4.5;0.0
05;2021-03-25;874;75;0;17569;6466;0;12.4;4.6;0.0
05;2021-03-26;997;56;0;18566;6522;0;13.1;4.6;0.0
05;2021-03-27;457;41;0;19023;6563;0;13.4;4.6;0.0
05;2021-03-28;19;0;0;19042;6563;0;13.4;4.6;0.0
05;2021-03-29;857;61;0;19899;6624;0;14.0;4.7;0.0
05;2021-03-30;1083;87;0;20982;6711;0;14.8;4.7;0.0
05;2021-03-31;773;256;0;21755;6967;0;15.3;4.9;0.0
05;2021-04-01;845;241;0;22600;7208;0;15.9;5.1;0.0
05;2021-04-02;630;370;0;23230;7578;0;16.4;5.3;0.0
05;2021-04-03;507;182;0;23737;7760;0;16.7;5.5;0.0
05;2021-04-04;314;61;0;24051;7821;0;17.0;5.5;0.0
05;2021-04-05;132;12;0;24183;7833;0;17.1;5.5;0.0
05;2021-04-06;600;266;0;24783;8099;0;17.5;5.7;0.0
05;2021-04-07;761;326;0;25544;8425;0;18.0;5.9;0.0
05;2021-04-08;690;339;0;26234;8764;0;18.5;6.2;0.0
05;2021-04-09;834;406;0;27068;9170;0;19.1;6.5;0.0
05;2021-04-10;665;382;0;27733;9552;0;19.6;6.7;0.0
05;2021-04-11;188;161;0;27921;9713;0;19.7;6.9;0.0
05;2021-04-12;681;259;0;28602;9972;0;20.2;7.0;0.0
05;2021-04-13;847;254;0;29449;10226;0;20.8;7.2;0.0
05;2021-04-14;647;324;0;30096;10550;0;21.2;7.4;0.0
05;2021-04-15;729;370;0;30825;10920;0;21.7;7.7;0.0
05;2021-04-16;721;404;0;31546;11324;0;22.3;8.0;0.0
05;2021-04-17;607;234;0;32153;11558;0;22.7;8.2;0.0
05;2021-04-18;293;22;0;32446;11580;0;22.9;8.2;0.0
05;2021-04-19;330;503;0;32776;12083;0;23.1;8.5;0.0
05;2021-04-20;461;617;0;33237;12700;0;23.4;9.0;0.0
05;2021-04-21;467;609;0;33704;13309;0;23.8;9.4;0.0
05;2021-04-22;397;544;0;34101;13853;0;24.1;9.8;0.0
05;2021-04-23;514;643;0;34615;14496;0;24.4;10.2;0.0
05;2021-04-24;315;372;0;34930;14868;0;24.6;10.5;0.0
05;2021-04-25;269;31;0;35199;14899;0;24.8;10.5;0.0
05;2021-04-26;351;666;0;35550;15565;0;25.1;11.0;0.0
05;2021-04-27;636;702;0;36186;16267;0;25.5;11.5;0.0
05;2021-04-28;463;685;0;36649;16952;0;25.9;12.0;0.0
05;2021-04-29;686;694;0;37335;17646;0;26.3;12.4;0.0
05;2021-04-30;528;703;0;37863;18349;0;26.7;12.9;0.0
05;2021-05-01;150;91;0;38013;18440;0;26.8;13.0;0.0
05;2021-05-02;260;104;0;38273;18544;0;27.0;13.1;0.0
05;2021-05-03;453;456;0;38726;19000;0;27.3;13.4;0.0
05;2021-05-04;393;490;0;39119;19490;0;27.6;13.7;0.0
05;2021-05-05;486;645;0;39605;20135;0;27.9;14.2;0.0
05;2021-05-06;646;699;0;40251;20834;0;28.4;14.7;0.0
05;2021-05-07;580;753;0;40831;21587;0;28.8;15.2;0.0
05;2021-05-08;477;175;0;41308;21762;0;29.1;15.4;0.0
05;2021-05-09;207;62;0;41515;21824;0;29.3;15.4;0.0
05;2021-05-10;527;675;0;42042;22499;0;29.7;15.9;0.0
05;2021-05-11;657;896;0;42699;23395;0;30.1;16.5;0.0
05;2021-05-12;657;701;0;43356;24096;0;30.6;17.0;0.0
05;2021-05-13;891;111;0;44247;24207;0;31.2;17.1;0.0
05;2021-05-14;735;473;0;44982;24680;0;31.7;17.4;0.0
05;2021-05-15;976;314;0;45958;24994;0;32.4;17.6;0.0
05;2021-05-16;226;58;0;46184;25052;0;32.6;17.7;0.0
05;2021-05-17;499;411;0;46683;25463;0;32.9;18.0;0.0
05;2021-05-18;510;398;0;47193;25861;0;33.3;18.2;0.0
05;2021-05-19;700;449;0;47893;26310;0;33.8;18.6;0.0
05;2021-05-20;765;451;0;48658;26761;0;34.3;18.9;0.0
05;2021-05-21;689;513;0;49347;27274;0;34.8;19.2;0.0
05;2021-05-22;580;227;0;49927;27501;0;35.2;19.4;0.0
05;2021-05-23;278;59;0;50205;27560;0;35.4;19.4;0.0
05;2021-05-24;494;153;0;50699;27713;0;35.8;19.5;0.0
05;2021-05-25;553;483;0;51252;28196;0;36.2;19.9;0.0
05;2021-05-26;702;369;0;51954;28565;0;36.7;20.2;0.0
05;2021-05-27;804;559;0;52758;29124;0;37.2;20.5;0.0
05;2021-05-28;663;681;0;53421;29805;0;37.7;21.0;0.0
05;2021-05-29;514;508;0;53935;30313;0;38.0;21.4;0.0
05;2021-05-30;200;80;0;54135;30393;0;38.2;21.4;0.0
05;2021-05-31;559;493;0;54694;30886;0;38.6;21.8;0.0
05;2021-06-01;579;582;0;55273;31468;0;39.0;22.2;0.0
05;2021-06-02;656;668;0;55929;32136;0;39.5;22.7;0.0
05;2021-06-03;719;645;0;56648;32781;0;40.0;23.1;0.0
05;2021-06-04;960;790;0;57608;33571;0;40.6;23.7;0.0
05;2021-06-05;768;473;0;58376;34044;0;41.2;24.0;0.0
05;2021-06-06;194;84;0;58570;34128;0;41.3;24.1;0.0
05;2021-06-07;561;812;0;59131;34940;0;41.7;24.6;0.0
05;2021-06-08;650;641;0;59781;35581;0;42.2;25.1;0.0
05;2021-06-09;625;749;0;60406;36330;0;42.6;25.6;0.0
05;2021-06-10;557;697;0;60963;37027;0;43.0;26.1;0.0
05;2021-06-11;723;721;0;61686;37748;0;43.5;26.6;0.0
05;2021-06-12;552;464;0;62238;38212;0;43.9;27.0;0.0
05;2021-06-13;109;96;0;62347;38308;0;44.0;27.0;0.0
05;2021-06-14;358;631;0;62705;38939;0;44.2;27.5;0.0
05;2021-06-15;521;869;0;63226;39808;0;44.6;28.1;0.0
05;2021-06-16;431;666;0;63657;40474;0;44.9;28.6;0.0
05;2021-06-17;364;782;0;64021;41256;0;45.2;29.1;0.0
05;2021-06-18;396;724;0;64417;41980;0;45.4;29.6;0.0
05;2021-06-19;363;571;0;64780;42551;0;45.7;30.0;0.0
05;2021-06-20;54;89;0;64834;42640;0;45.7;30.1;0.0
05;2021-06-21;292;639;0;65126;43279;0;45.9;30.5;0.0
05;2021-06-22;316;791;0;65442;44070;0;46.2;31.1;0.0
05;2021-06-23;341;742;0;65783;44812;0;46.4;31.6;0.0
05;2021-06-24;381;960;0;66164;45772;0;46.7;32.3;0.0
05;2021-06-25;200;841;0;66364;46613;0;46.8;32.9;0.0
05;2021-06-26;251;1011;0;66615;47624;0;47.0;33.6;0.0
05;2021-06-27;111;162;0;66726;47786;0;47.1;33.7;0.0
05;2021-06-28;230;746;0;66956;48532;0;47.2;34.2;0.0
05;2021-06-29;227;756;0;67183;49288;0;47.4;34.8;0.0
05;2021-06-30;329;772;0;67512;50060;0;47.6;35.3;0.0
05;2021-07-01;362;742;0;67874;50802;0;47.9;35.8;0.0
05;2021-07-02;364;871;0;68238;51673;0;48.1;36.5;0.0
05;2021-07-03;269;701;0;68507;52374;0;48.3;36.9;0.0
05;2021-07-04;146;149;0;68653;52523;0;48.4;37.1;0.0
05;2021-07-05;236;723;0;68889;53246;0;48.6;37.6;0.0
05;2021-07-06;314;795;0;69203;54041;0;48.8;38.1;0.0
05;2021-07-07;354;743;0;69557;54784;0;49.1;38.6;0.0
05;2021-07-08;385;786;0;69942;55570;0;49.3;39.2;0.0
05;2021-07-09;372;931;0;70314;56501;0;49.6;39.9;0.0
05;2021-07-10;262;643;0;70576;57144;0;49.8;40.3;0.0
05;2021-07-11;148;120;0;70724;57264;0;49.9;40.4;0.0
05;2021-07-12;336;922;0;71060;58186;0;50.1;41.0;0.0
05;2021-07-13;421;789;0;71481;58975;0;50.4;41.6;0.0
05;2021-07-14;611;249;0;72092;59224;0;50.9;41.8;0.0
05;2021-07-15;649;920;0;72741;60144;0;51.3;42.4;0.0
05;2021-07-16;872;1296;0;73613;61440;0;51.9;43.3;0.0
05;2021-07-17;533;1133;0;74146;62573;0;52.3;44.1;0.0
05;2021-07-18;243;126;0;74389;62699;0;52.5;44.2;0.0
05;2021-07-19;462;697;0;74851;63396;0;52.8;44.7;0.0
05;2021-07-20;637;712;0;75488;64108;0;53.3;45.2;0.0
05;2021-07-21;743;745;0;76231;64853;0;53.8;45.7;0.0
05;2021-07-22;741;787;0;76972;65640;0;54.3;46.3;0.0
05;2021-07-23;1201;1032;0;78173;66672;0;55.1;47.0;0.0
05;2021-07-24;700;677;0;78873;67349;0;55.6;47.5;0.0
05;2021-07-25;252;121;0;79125;67470;0;55.8;47.6;0.0
05;2021-07-26;593;501;0;79718;67971;0;56.2;47.9;0.0
05;2021-07-27;898;575;0;80616;68546;0;56.9;48.4;0.0
05;2021-07-28;1215;578;0;81831;69124;0;57.7;48.8;0.0
05;2021-07-29;1090;583;0;82921;69707;0;58.5;49.2;0.0
05;2021-07-30;825;527;0;83746;70234;0;59.1;49.5;0.0
05;2021-07-31;632;428;0;84378;70662;0;59.5;49.8;0.0
05;2021-08-01;164;146;0;84542;70808;0;59.6;50.0;0.0
05;2021-08-02;656;380;0;85198;71188;0;60.1;50.2;0.0
05;2021-08-03;674;483;0;85872;71671;0;60.6;50.6;0.0
05;2021-08-04;754;577;0;86626;72248;0;61.1;51.0;0.0
05;2021-08-05;817;577;0;87443;72825;0;61.7;51.4;0.0
05;2021-08-06;723;650;0;88166;73475;0;62.2;51.8;0.0
05;2021-08-07;493;467;0;88659;73942;0;62.5;52.2;0.0
05;2021-08-08;175;212;0;88834;74154;0;62.7;52.3;0.0
05;2021-08-09;589;637;0;89423;74791;0;63.1;52.8;0.0
05;2021-08-10;562;532;0;89985;75323;0;63.5;53.1;0.0
05;2021-08-11;582;620;0;90567;75943;0;63.9;53.6;0.0
05;2021-08-12;639;577;0;91206;76520;0;64.3;54.0;0.0
05;2021-08-13;519;704;0;91725;77224;0;64.7;54.5;0.0
05;2021-08-14;327;598;0;92052;77822;0;64.9;54.9;0.0
05;2021-08-15;145;165;0;92197;77987;0;65.0;55.0;0.0
05;2021-08-16;379;805;0;92576;78792;0;65.3;55.6;0.0
05;2021-08-17;365;714;0;92941;79506;0;65.6;56.1;0.0
05;2021-08-18;374;796;0;93315;80302;0;65.8;56.6;0.0
05;2021-08-19;420;773;0;93735;81075;0;66.1;57.2;0.0
05;2021-08-20;403;906;0;94138;81981;0;66.4;57.8;0.0
05;2021-08-21;278;660;0;94416;82641;0;66.6;58.3;0.0
05;2021-08-22;102;224;0;94518;82865;0;66.7;58.5;0.0
05;2021-08-23;280;697;0;94798;83562;0;66.9;58.9;0.0
05;2021-08-24;347;637;0;95145;84199;0;67.1;59.4;0.0
05;2021-08-25;369;791;0;95514;84990;0;67.4;60.0;0.0
05;2021-08-26;273;723;0;95787;85713;0;67.6;60.5;0.0
05;2021-08-27;296;812;0;96083;86525;0;67.8;61.0;0.0
05;2021-08-28;212;552;0;96295;87077;0;67.9;61.4;0.0
05;2021-08-29;60;232;0;96355;87309;0;68.0;61.6;0.0
05;2021-08-30;231;695;20;96586;88004;20;68.1;62.1;0.0
05;2021-08-31;246;647;20;96832;88651;40;68.3;62.5;0.0
05;2021-09-01;290;545;69;97122;89196;109;68.5;62.9;0.1
05;2021-09-02;251;568;84;97373;89764;193;68.7;63.3;0.1
05;2021-09-03;233;501;76;97606;90265;269;68.9;63.7;0.2
05;2021-09-04;189;530;52;97795;90795;321;69.0;64.1;0.2
05;2021-09-05;54;147;19;97849;90942;340;69.0;64.2;0.2
05;2021-09-06;154;284;88;98003;91226;428;69.1;64.4;0.3
05;2021-09-07;196;442;106;98199;91668;534;69.3;64.7;0.4
05;2021-09-08;190;489;66;98389;92157;600;69.4;65.0;0.4
05;2021-09-09;180;400;81;98569;92557;681;69.5;65.3;0.5
05;2021-09-10;182;313;113;98751;92870;794;69.7;65.5;0.6
05;2021-09-11;131;410;17;98882;93280;811;69.8;65.8;0.6
05;2021-09-12;34;98;2;98916;93378;813;69.8;65.9;0.6
05;2021-09-13;155;269;131;99071;93647;944;69.9;66.1;0.7
05;2021-09-14;229;280;115;99300;93927;1059;70.0;66.3;0.7
05;2021-09-15;180;363;173;99480;94290;1232;70.2;66.5;0.9
05;2021-09-16;171;249;140;99651;94539;1372;70.3;66.7;1.0
05;2021-09-17;138;308;135;99789;94847;1507;70.4;66.9;1.1
05;2021-09-18;99;324;61;99888;95171;1568;70.5;67.1;1.1
05;2021-09-19;14;36;12;99902;95207;1580;70.5;67.2;1.1
05;2021-09-20;65;163;87;99967;95370;1667;70.5;67.3;1.2
05;2021-09-21;85;213;95;100052;95583;1762;70.6;67.4;1.2
05;2021-09-22;108;265;72;100160;95848;1834;70.7;67.6;1.3
05;2021-09-23;100;227;111;100260;96075;1945;70.7;67.8;1.4
05;2021-09-24;93;267;101;100353;96342;2046;70.8;68.0;1.4
05;2021-09-25;87;221;30;100440;96563;2076;70.9;68.1;1.5
05;2021-09-26;13;30;15;100453;96593;2091;70.9;68.1;1.5
05;2021-09-27;63;140;66;100516;96733;2157;70.9;68.2;1.5
05;2021-09-28;68;153;80;100584;96886;2237;71.0;68.3;1.6
05;2021-09-29;88;190;76;100672;97076;2313;71.0;68.5;1.6
05;2021-09-30;62;109;163;100734;97185;2476;71.1;68.6;1.7
05;2021-10-01;181;225;149;100915;97410;2625;71.2;68.7;1.9
05;2021-10-02;85;157;65;101000;97567;2690;71.2;68.8;1.9
05;2021-10-03;18;32;15;101018;97599;2705;71.3;68.8;1.9
05;2021-10-04;93;148;116;101111;97747;2821;71.3;69.0;2.0
05;2021-10-05;77;182;128;101188;97929;2949;71.4;69.1;2.1
05;2021-10-06;91;159;218;101279;98088;3167;71.4;69.2;2.2
05;2021-10-07;68;122;136;101347;98210;3303;71.5;69.3;2.3
05;2021-10-08;123;172;147;101470;98382;3450;71.6;69.4;2.4
05;2021-10-09;66;157;120;101536;98539;3570;71.6;69.5;2.5
05;2021-10-10;14;24;3;101550;98563;3573;71.6;69.5;2.5
05;2021-10-11;64;99;214;101614;98662;3787;71.7;69.6;2.7
05;2021-10-12;60;114;119;101674;98776;3906;71.7;69.7;2.8
05;2021-10-13;82;137;180;101756;98913;4086;71.8;69.8;2.9
05;2021-10-14;65;108;138;101821;99021;4224;71.8;69.9;3.0
05;2021-10-15;58;103;112;101879;99124;4336;71.9;69.9;3.1
05;2021-10-16;80;153;141;101959;99277;4477;71.9;70.0;3.2
05;2021-10-17;8;13;17;101967;99290;4494;71.9;70.0;3.2
05;2021-10-18;48;96;270;102015;99386;4764;72.0;70.1;3.4
05;2021-10-19;51;96;236;102066;99482;5000;72.0;70.2;3.5
05;2021-10-20;62;116;391;102128;99598;5391;72.0;70.3;3.8
05;2021-10-21;47;72;233;102175;99670;5624;72.1;70.3;4.0
05;2021-10-22;45;87;145;102220;99757;5769;72.1;70.4;4.1
05;2021-10-23;85;97;213;102305;99854;5982;72.2;70.4;4.2
05;2021-10-24;12;16;38;102317;99870;6020;72.2;70.5;4.2
05;2021-10-25;57;97;247;102374;99967;6267;72.2;70.5;4.4
05;2021-10-26;44;48;245;102418;100015;6512;72.2;70.6;4.6
05;2021-10-27;82;98;435;102500;100113;6947;72.3;70.6;4.9
05;2021-10-28;42;51;247;102542;100164;7194;72.3;70.7;5.1
05;2021-10-29;55;71;259;102597;100235;7453;72.4;70.7;5.3
05;2021-10-30;59;90;274;102656;100325;7727;72.4;70.8;5.5
05;2021-10-31;10;10;57;102666;100335;7784;72.4;70.8;5.5
05;2021-11-01;15;13;19;102681;100348;7803;72.4;70.8;5.5
05;2021-11-02;80;82;284;102761;100430;8087;72.5;70.8;5.7
05;2021-11-03;66;69;297;102827;100499;8384;72.5;70.9;5.9
05;2021-11-04;33;49;230;102860;100548;8614;72.6;70.9;6.1
05;2021-11-05;72;81;328;102932;100629;8942;72.6;71.0;6.3
05;2021-11-06;38;93;286;102970;100722;9228;72.6;71.1;6.5
05;2021-11-07;16;9;36;102986;100731;9264;72.7;71.1;6.5
05;2021-11-08;49;60;297;103035;100791;9561;72.7;71.1;6.7
05;2021-11-09;55;61;491;103090;100852;10052;72.7;71.1;7.1
05;2021-11-10;92;103;813;103182;100955;10865;72.8;71.2;7.7
05;2021-11-11;16;17;106;103198;100972;10971;72.8;71.2;7.7
05;2021-11-12;53;72;326;103251;101044;11297;72.8;71.3;8.0
05;2021-11-13;56;87;352;103307;101131;11649;72.9;71.3;8.2
05;2021-11-14;17;21;55;103324;101152;11704;72.9;71.4;8.3
05;2021-11-15;42;56;381;103366;101208;12085;72.9;71.4;8.5
05;2021-11-16;86;61;632;103452;101269;12717;73.0;71.4;9.0
05;2021-11-17;65;83;477;103517;101352;13194;73.0;71.5;9.3
05;2021-11-18;76;43;428;103593;101395;13622;73.1;71.5;9.6
05;2021-11-19;64;59;505;103657;101454;14127;73.1;71.6;10.0
05;2021-11-20;88;78;428;103745;101532;14555;73.2;71.6;10.3
05;2021-11-21;13;12;53;103758;101544;14608;73.2;71.6;10.3
05;2021-11-22;68;54;387;103826;101598;14995;73.2;71.7;10.6
05;2021-11-23;106;68;727;103932;101666;15722;73.3;71.7;11.1
05;2021-11-24;61;72;562;103993;101738;16284;73.4;71.8;11.5
05;2021-11-25;71;69;570;104064;101807;16854;73.4;71.8;11.9
05;2021-11-26;100;70;691;104164;101877;17545;73.5;71.9;12.4
05;2021-11-27;86;67;777;104250;101944;18322;73.5;71.9;12.9
05;2021-11-28;14;29;169;104264;101973;18491;73.6;71.9;13.0
05;2021-11-29;86;66;791;104350;102039;19282;73.6;72.0;13.6
05;2021-11-30;117;75;1318;104467;102114;20600;73.7;72.0;14.5
05;2021-12-01;114;119;1573;104581;102233;22173;73.8;72.1;15.6
05;2021-12-02;89;70;1113;104670;102303;23286;73.8;72.2;16.4
05;2021-12-03;90;98;1294;104760;102401;24580;73.9;72.2;17.3
05;2021-12-04;87;85;1040;104847;102486;25620;74.0;72.3;18.1
05;2021-12-05;15;23;308;104862;102509;25928;74.0;72.3;18.3
05;2021-12-06;52;60;802;104914;102569;26730;74.0;72.4;18.9
05;2021-12-07;120;107;1812;105034;102676;28542;74.1;72.4;20.1
05;2021-12-08;82;95;1306;105116;102771;29848;74.2;72.5;21.1
05;2021-12-09;89;94;1550;105205;102865;31398;74.2;72.6;22.1
05;2021-12-10;99;82;1354;105304;102947;32752;74.3;72.6;23.1
05;2021-12-11;100;100;1046;105404;103047;33798;74.4;72.7;23.8
05;2021-12-12;18;12;219;105422;103059;34017;74.4;72.7;24.0
05;2021-12-13;69;92;1081;105491;103151;35098;74.4;72.8;24.8
05;2021-12-14;70;139;1819;105561;103290;36917;74.5;72.9;26.0
05;2021-12-15;112;98;1688;105673;103388;38605;74.5;72.9;27.2
05;2021-12-16;69;89;1491;105742;103477;40096;74.6;73.0;28.3
06;2020-12-27;5;0;0;5;0;0;0.0;0.0;0.0
06;2020-12-28;4;0;0;9;0;0;0.0;0.0;0.0
06;2020-12-29;0;0;0;9;0;0;0.0;0.0;0.0
06;2020-12-30;3;0;0;12;0;0;0.0;0.0;0.0
06;2020-12-31;23;0;0;35;0;0;0.0;0.0;0.0
06;2021-01-01;12;0;0;47;0;0;0.0;0.0;0.0
06;2021-01-02;8;0;0;55;0;0;0.0;0.0;0.0
06;2021-01-03;5;0;0;60;0;0;0.0;0.0;0.0
06;2021-01-04;131;1;0;191;1;0;0.0;0.0;0.0
06;2021-01-05;178;2;0;369;3;0;0.0;0.0;0.0
06;2021-01-06;221;1;0;590;4;0;0.1;0.0;0.0
06;2021-01-07;506;0;0;1096;4;0;0.1;0.0;0.0
06;2021-01-08;678;3;0;1774;7;0;0.2;0.0;0.0
06;2021-01-09;369;4;0;2143;11;0;0.2;0.0;0.0
06;2021-01-10;69;0;0;2212;11;0;0.2;0.0;0.0
06;2021-01-11;1022;6;0;3234;17;0;0.3;0.0;0.0
06;2021-01-12;2131;9;0;5365;26;0;0.5;0.0;0.0
06;2021-01-13;1709;12;0;7074;38;0;0.7;0.0;0.0
06;2021-01-14;2030;23;0;9104;61;0;0.8;0.0;0.0
06;2021-01-15;1666;5;0;10770;66;0;1.0;0.0;0.0
06;2021-01-16;960;7;0;11730;73;0;1.1;0.0;0.0
06;2021-01-17;211;0;0;11941;73;0;1.1;0.0;0.0
06;2021-01-18;2193;20;0;14134;93;0;1.3;0.0;0.0
06;2021-01-19;2664;22;0;16798;115;0;1.6;0.0;0.0
06;2021-01-20;3244;17;0;20042;132;0;1.9;0.0;0.0
06;2021-01-21;2959;31;0;23001;163;0;2.1;0.0;0.0
06;2021-01-22;2959;31;0;25960;194;0;2.4;0.0;0.0
06;2021-01-23;1242;3;0;27202;197;0;2.5;0.0;0.0
06;2021-01-24;33;0;0;27235;197;0;2.5;0.0;0.0
06;2021-01-25;2109;15;0;29344;212;0;2.7;0.0;0.0
06;2021-01-26;3151;49;0;32495;261;0;3.0;0.0;0.0
06;2021-01-27;2462;115;0;34957;376;0;3.2;0.0;0.0
06;2021-01-28;2810;224;0;37767;600;0;3.5;0.1;0.0
06;2021-01-29;2532;325;0;40299;925;0;3.7;0.1;0.0
06;2021-01-30;725;55;0;41024;980;0;3.8;0.1;0.0
06;2021-01-31;11;3;0;41035;983;0;3.8;0.1;0.0
06;2021-02-01;1131;454;0;42166;1437;0;3.9;0.1;0.0
06;2021-02-02;1559;425;0;43725;1862;0;4.1;0.2;0.0
06;2021-02-03;382;154;0;44107;2016;0;4.1;0.2;0.0
06;2021-02-04;810;884;0;44917;2900;0;4.2;0.3;0.0
06;2021-02-05;1075;1099;0;45992;3999;0;4.3;0.4;0.0
06;2021-02-06;185;439;0;46177;4438;0;4.3;0.4;0.0
06;2021-02-07;8;50;0;46185;4488;0;4.3;0.4;0.0
06;2021-02-08;542;1030;0;46727;5518;0;4.3;0.5;0.0
06;2021-02-09;342;763;0;47069;6281;0;4.4;0.6;0.0
06;2021-02-10;418;689;0;47487;6970;0;4.4;0.6;0.0
06;2021-02-11;496;1076;0;47983;8046;0;4.4;0.7;0.0
06;2021-02-12;643;1286;0;48626;9332;0;4.5;0.9;0.0
06;2021-02-13;199;505;0;48825;9837;0;4.5;0.9;0.0
06;2021-02-14;10;5;0;48835;9842;0;4.5;0.9;0.0
06;2021-02-15;438;1237;0;49273;11079;0;4.6;1.0;0.0
06;2021-02-16;843;1954;0;50116;13033;0;4.6;1.2;0.0
06;2021-02-17;809;2065;0;50925;15098;0;4.7;1.4;0.0
06;2021-02-18;1836;2654;0;52761;17752;0;4.9;1.6;0.0
06;2021-02-19;1765;2086;0;54526;19838;0;5.1;1.8;0.0
06;2021-02-20;350;484;0;54876;20322;0;5.1;1.9;0.0
06;2021-02-21;18;60;0;54894;20382;0;5.1;1.9;0.0
06;2021-02-22;1026;1605;0;55920;21987;0;5.2;2.0;0.0
06;2021-02-23;1654;1551;0;57574;23538;0;5.3;2.2;0.0
06;2021-02-24;2004;1298;0;59578;24836;0;5.5;2.3;0.0
06;2021-02-25;3621;1677;0;63199;26513;0;5.9;2.5;0.0
06;2021-02-26;3223;1609;0;66422;28122;0;6.2;2.6;0.0
06;2021-02-27;1341;323;0;67763;28445;0;6.3;2.6;0.0
06;2021-02-28;91;18;0;67854;28463;0;6.3;2.6;0.0
06;2021-03-01;2325;847;0;70179;29310;0;6.5;2.7;0.0
06;2021-03-02;2360;978;0;72539;30288;0;6.7;2.8;0.0
06;2021-03-03;2732;625;0;75271;30913;0;7.0;2.9;0.0
06;2021-03-04;4421;648;0;79692;31561;0;7.4;2.9;0.0
06;2021-03-05;3761;1046;0;83453;32607;0;7.7;3.0;0.0
06;2021-03-06;11100;381;0;94553;32988;0;8.8;3.1;0.0
06;2021-03-07;9492;331;0;104045;33319;0;9.6;3.1;0.0
06;2021-03-08;3834;1190;0;107879;34509;0;10.0;3.2;0.0
06;2021-03-09;4730;944;0;112609;35453;0;10.4;3.3;0.0
06;2021-03-10;4489;898;0;117098;36351;0;10.8;3.4;0.0
06;2021-03-11;6433;947;0;123531;37298;0;11.4;3.5;0.0
06;2021-03-12;6539;1019;0;130070;38317;0;12.1;3.5;0.0
06;2021-03-13;10586;382;0;140656;38699;0;13.0;3.6;0.0
06;2021-03-14;501;60;0;141157;38759;0;13.1;3.6;0.0
06;2021-03-15;4565;760;0;145722;39519;0;13.5;3.7;0.0
06;2021-03-16;3586;1050;0;149308;40569;0;13.8;3.8;0.0
06;2021-03-17;5816;1835;0;155124;42404;0;14.4;3.9;0.0
06;2021-03-18;4916;1786;0;160040;44190;0;14.8;4.1;0.0
06;2021-03-19;6450;1966;0;166490;46156;0;15.4;4.3;0.0
06;2021-03-20;2267;538;0;168757;46694;0;15.6;4.3;0.0
06;2021-03-21;381;24;0;169138;46718;0;15.7;4.3;0.0
06;2021-03-22;3730;697;0;172868;47415;0;16.0;4.4;0.0
06;2021-03-23;5642;1186;0;178510;48601;0;16.5;4.5;0.0
06;2021-03-24;4051;3200;0;182561;51801;0;16.9;4.8;0.0
06;2021-03-25;5632;3143;0;188193;54944;0;17.4;5.1;0.0
06;2021-03-26;5971;1936;0;194164;56880;0;18.0;5.3;0.0
06;2021-03-27;1957;370;0;196121;57250;0;18.2;5.3;0.0
06;2021-03-28;199;8;0;196320;57258;0;18.2;5.3;0.0
06;2021-03-29;3012;2020;0;199332;59278;0;18.5;5.5;0.0
06;2021-03-30;4951;2468;0;204283;61746;0;18.9;5.7;0.0
06;2021-03-31;7510;1695;0;211793;63441;0;19.6;5.9;0.0
06;2021-04-01;7230;2429;0;219023;65870;0;20.3;6.1;0.0
06;2021-04-02;6686;2594;0;225709;68464;0;20.9;6.3;0.0
06;2021-04-03;2534;1323;0;228243;69787;0;21.1;6.5;0.0
06;2021-04-04;270;540;0;228513;70327;0;21.2;6.5;0.0
06;2021-04-05;1329;674;0;229842;71001;0;21.3;6.6;0.0
06;2021-04-06;6199;3259;0;236041;74260;0;21.9;6.9;0.0
06;2021-04-07;5787;3810;0;241828;78070;0;22.4;7.2;0.0
06;2021-04-08;5411;5497;0;247239;83567;0;22.9;7.7;0.0
06;2021-04-09;8762;5654;0;256001;89221;0;23.7;8.3;0.0
06;2021-04-10;2250;2693;0;258251;91914;0;23.9;8.5;0.0
06;2021-04-11;160;97;0;258411;92011;0;23.9;8.5;0.0
06;2021-04-12;4009;3393;0;262420;95404;0;24.3;8.8;0.0
06;2021-04-13;5933;4955;0;268353;100359;0;24.9;9.3;0.0
06;2021-04-14;5001;4226;0;273354;104585;0;25.3;9.7;0.0
06;2021-04-15;5083;4222;0;278437;108807;0;25.8;10.1;0.0
06;2021-04-16;6387;5003;0;284824;113810;0;26.4;10.5;0.0
06;2021-04-17;2562;2924;0;287386;116734;0;26.6;10.8;0.0
06;2021-04-18;225;238;0;287611;116972;0;26.6;10.8;0.0
06;2021-04-19;4799;3885;0;292410;120857;0;27.1;11.2;0.0
06;2021-04-20;4995;4685;0;297405;125542;0;27.6;11.6;0.0
06;2021-04-21;7237;4014;0;304642;129556;0;28.2;12.0;0.0
06;2021-04-22;7422;4076;0;312064;133632;0;28.9;12.4;0.0
06;2021-04-23;7470;4020;0;319534;137652;0;29.6;12.8;0.0
06;2021-04-24;2196;1474;0;321730;139126;0;29.8;12.9;0.0
06;2021-04-25;108;42;0;321838;139168;0;29.8;12.9;0.0
06;2021-04-26;3683;2238;0;325521;141406;0;30.2;13.1;0.0
06;2021-04-27;4155;3928;0;329676;145334;0;30.5;13.5;0.0
06;2021-04-28;3746;4338;0;333422;149672;0;30.9;13.9;0.0
06;2021-04-29;5384;5260;0;338806;154932;0;31.4;14.4;0.0
06;2021-04-30;5887;4927;0;344693;159859;0;31.9;14.8;0.0
06;2021-05-01;3231;793;0;347924;160652;0;32.2;14.9;0.0
06;2021-05-02;473;170;0;348397;160822;0;32.3;14.9;0.0
06;2021-05-03;6040;3383;0;354437;164205;0;32.8;15.2;0.0
06;2021-05-04;5010;5095;0;359447;169300;0;33.3;15.7;0.0
06;2021-05-05;4063;3771;0;363510;173071;0;33.7;16.0;0.0
06;2021-05-06;4676;4559;0;368186;177630;0;34.1;16.5;0.0
06;2021-05-07;5043;5388;0;373229;183018;0;34.6;17.0;0.0
06;2021-05-08;3910;1285;0;377139;184303;0;34.9;17.1;0.0
06;2021-05-09;216;321;0;377355;184624;0;35.0;17.1;0.0
06;2021-05-10;4247;4751;0;381602;189375;0;35.4;17.5;0.0
06;2021-05-11;4218;5230;0;385820;194605;0;35.7;18.0;0.0
06;2021-05-12;7455;4573;0;393275;199178;0;36.4;18.5;0.0
06;2021-05-13;6943;1977;0;400218;201155;0;37.1;18.6;0.0
06;2021-05-14;8763;3070;0;408981;204225;0;37.9;18.9;0.0
06;2021-05-15;7177;1982;0;416158;206207;0;38.6;19.1;0.0
06;2021-05-16;1343;264;0;417501;206471;0;38.7;19.1;0.0
06;2021-05-17;6399;3462;0;423900;209933;0;39.3;19.4;0.0
06;2021-05-18;8144;2981;0;432044;212914;0;40.0;19.7;0.0
06;2021-05-19;6469;2691;0;438513;215605;0;40.6;20.0;0.0
06;2021-05-20;6591;3347;0;445104;218952;0;41.2;20.3;0.0
06;2021-05-21;7151;3623;0;452255;222575;0;41.9;20.6;0.0
06;2021-05-22;2629;1246;0;454884;223821;0;42.1;20.7;0.0
06;2021-05-23;193;627;0;455077;224448;0;42.2;20.8;0.0
06;2021-05-24;2604;898;0;457681;225346;0;42.4;20.9;0.0
06;2021-05-25;4129;4724;0;461810;230070;0;42.8;21.3;0.0
06;2021-05-26;4518;6282;0;466328;236352;0;43.2;21.9;0.0
06;2021-05-27;4546;5945;0;470874;242297;0;43.6;22.4;0.0
06;2021-05-28;3974;6785;0;474848;249082;0;44.0;23.1;0.0
06;2021-05-29;1414;2769;0;476262;251851;0;44.1;23.3;0.0
06;2021-05-30;305;1095;0;476567;252946;0;44.2;23.4;0.0
06;2021-05-31;3554;4745;0;480121;257691;0;44.5;23.9;0.0
06;2021-06-01;4730;6824;0;484851;264515;0;44.9;24.5;0.0
06;2021-06-02;2853;7902;0;487704;272417;0;45.2;25.2;0.0
06;2021-06-03;3769;7630;0;491473;280047;0;45.5;25.9;0.0
06;2021-06-04;4544;7103;0;496017;287150;0;46.0;26.6;0.0
06;2021-06-05;2109;3174;0;498126;290324;0;46.1;26.9;0.0
06;2021-06-06;241;243;0;498367;290567;0;46.2;26.9;0.0
06;2021-06-07;3386;5035;0;501753;295602;0;46.5;27.4;0.0
06;2021-06-08;3629;4852;0;505382;300454;0;46.8;27.8;0.0
06;2021-06-09;3347;6725;0;508729;307179;0;47.1;28.5;0.0
06;2021-06-10;3939;6187;0;512668;313366;0;47.5;29.0;0.0
06;2021-06-11;3078;7512;0;515746;320878;0;47.8;29.7;0.0
06;2021-06-12;1492;3492;0;517238;324370;0;47.9;30.1;0.0
06;2021-06-13;198;433;0;517436;324803;0;47.9;30.1;0.0
06;2021-06-14;2239;7829;0;519675;332632;0;48.1;30.8;0.0
06;2021-06-15;2980;8735;0;522655;341367;0;48.4;31.6;0.0
06;2021-06-16;2820;6346;0;525475;347713;0;48.7;32.2;0.0
06;2021-06-17;3060;6528;0;528535;354241;0;49.0;32.8;0.0
06;2021-06-18;2082;5366;0;530617;359607;0;49.2;33.3;0.0
06;2021-06-19;1156;1529;0;531773;361136;0;49.3;33.5;0.0
06;2021-06-20;216;350;0;531989;361486;0;49.3;33.5;0.0
06;2021-06-21;1460;5573;0;533449;367059;0;49.4;34.0;0.0
06;2021-06-22;1929;6467;0;535378;373526;0;49.6;34.6;0.0
06;2021-06-23;1764;5686;0;537142;379212;0;49.8;35.1;0.0
06;2021-06-24;2853;7959;0;539995;387171;0;50.0;35.9;0.0
06;2021-06-25;1839;8440;0;541834;395611;0;50.2;36.7;0.0
06;2021-06-26;744;2111;0;542578;397722;0;50.3;36.8;0.0
06;2021-06-27;321;1132;0;542899;398854;0;50.3;37.0;0.0
06;2021-06-28;1993;6830;0;544892;405684;0;50.5;37.6;0.0
06;2021-06-29;2010;6625;0;546902;412309;0;50.7;38.2;0.0
06;2021-06-30;1231;6868;0;548133;419177;0;50.8;38.8;0.0
06;2021-07-01;3024;6298;0;551157;425475;0;51.1;39.4;0.0
06;2021-07-02;3548;6997;0;554705;432472;0;51.4;40.1;0.0
06;2021-07-03;1104;3965;0;555809;436437;0;51.5;40.4;0.0
06;2021-07-04;293;327;0;556102;436764;0;51.5;40.5;0.0
06;2021-07-05;3106;4358;0;559208;441122;0;51.8;40.9;0.0
06;2021-07-06;1818;4871;0;561026;445993;0;52.0;41.3;0.0
06;2021-07-07;2865;4785;0;563891;450778;0;52.2;41.8;0.0
06;2021-07-08;2932;5180;0;566823;455958;0;52.5;42.2;0.0
06;2021-07-09;3547;5108;0;570370;461066;0;52.8;42.7;0.0
06;2021-07-10;1459;1996;0;571829;463062;0;53.0;42.9;0.0
06;2021-07-11;319;342;0;572148;463404;0;53.0;42.9;0.0
06;2021-07-12;3256;5669;0;575404;469073;0;53.3;43.5;0.0
06;2021-07-13;5039;7485;0;580443;476558;0;53.8;44.2;0.0
06;2021-07-14;1008;428;0;581451;476986;0;53.9;44.2;0.0
06;2021-07-15;5633;6904;0;587084;483890;0;54.4;44.8;0.0
06;2021-07-16;6621;7853;0;593705;491743;0;55.0;45.6;0.0
06;2021-07-17;2881;4645;0;596586;496388;0;55.3;46.0;0.0
06;2021-07-18;966;4665;0;597552;501053;0;55.4;46.4;0.0
06;2021-07-19;5098;6862;0;602650;507915;0;55.8;47.1;0.0
06;2021-07-20;6433;8574;0;609083;516489;0;56.4;47.8;0.0
06;2021-07-21;6946;7135;0;616029;523624;0;57.1;48.5;0.0
06;2021-07-22;8861;6565;0;624890;530189;0;57.9;49.1;0.0
06;2021-07-23;8112;5734;0;633002;535923;0;58.6;49.7;0.0
06;2021-07-24;2917;2706;0;635919;538629;0;58.9;49.9;0.0
06;2021-07-25;877;457;0;636796;539086;0;59.0;49.9;0.0
06;2021-07-26;6385;5587;0;643181;544673;0;59.6;50.5;0.0
06;2021-07-27;7857;4738;0;651038;549411;0;60.3;50.9;0.0
06;2021-07-28;6643;4332;0;657681;553743;0;60.9;51.3;0.0
06;2021-07-29;7458;4619;0;665139;558362;0;61.6;51.7;0.0
06;2021-07-30;6917;4413;0;672056;562775;0;62.3;52.1;0.0
06;2021-07-31;3108;2491;0;675164;565266;0;62.6;52.4;0.0
06;2021-08-01;703;381;0;675867;565647;0;62.6;52.4;0.0
06;2021-08-02;5476;3646;0;681343;569293;0;63.1;52.7;0.0
06;2021-08-03;5481;4398;0;686824;573691;0;63.6;53.1;0.0
06;2021-08-04;4764;2897;0;691588;576588;0;64.1;53.4;0.0
06;2021-08-05;5360;3730;0;696948;580318;0;64.6;53.8;0.0
06;2021-08-06;4968;5096;0;701916;585414;0;65.0;54.2;0.0
06;2021-08-07;2049;2154;0;703965;587568;0;65.2;54.4;0.0
06;2021-08-08;502;635;0;704467;588203;0;65.3;54.5;0.0
06;2021-08-09;3746;4955;0;708213;593158;0;65.6;55.0;0.0
06;2021-08-10;4411;5728;0;712624;598886;0;66.0;55.5;0.0
06;2021-08-11;3595;5188;0;716219;604074;0;66.4;56.0;0.0
06;2021-08-12;3766;5653;0;719985;609727;0;66.7;56.5;0.0
06;2021-08-13;3069;5535;0;723054;615262;0;67.0;57.0;0.0
06;2021-08-14;1384;2195;0;724438;617457;0;67.1;57.2;0.0
06;2021-08-15;348;570;0;724786;618027;0;67.1;57.3;0.0
06;2021-08-16;2703;5764;0;727489;623791;0;67.4;57.8;0.0
06;2021-08-17;2982;6478;0;730471;630269;0;67.7;58.4;0.0
06;2021-08-18;2535;5494;0;733006;635763;0;67.9;58.9;0.0
06;2021-08-19;3419;6931;0;736425;642694;0;68.2;59.5;0.0
06;2021-08-20;2777;5603;0;739202;648297;0;68.5;60.1;0.0
06;2021-08-21;1476;3110;0;740678;651407;0;68.6;60.3;0.0
06;2021-08-22;321;709;0;740999;652116;0;68.6;60.4;0.0
06;2021-08-23;2081;5457;0;743080;657573;0;68.8;60.9;0.0
06;2021-08-24;2428;5501;0;745508;663074;0;69.1;61.4;0.0
06;2021-08-25;2167;4816;0;747675;667890;0;69.3;61.9;0.0
06;2021-08-26;2306;5573;0;749981;673463;0;69.5;62.4;0.0
06;2021-08-27;2291;5659;0;752272;679122;0;69.7;62.9;0.0
06;2021-08-28;1127;2522;0;753399;681644;0;69.8;63.2;0.0
06;2021-08-29;253;596;0;753652;682240;0;69.8;63.2;0.0
06;2021-08-30;1989;4544;159;755641;686784;159;70.0;63.6;0.0
06;2021-08-31;2212;5025;251;757853;691809;410;70.2;64.1;0.0
06;2021-09-01;2396;3668;508;760249;695477;918;70.4;64.4;0.1
06;2021-09-02;2111;3680;966;762360;699157;1884;70.6;64.8;0.2
06;2021-09-03;1838;3937;982;764198;703094;2866;70.8;65.1;0.3
06;2021-09-04;1176;2253;202;765374;705347;3068;70.9;65.3;0.3
06;2021-09-05;263;392;25;765637;705739;3093;70.9;65.4;0.3
06;2021-09-06;1435;2511;975;767072;708250;4068;71.1;65.6;0.4
06;2021-09-07;1389;2820;1408;768461;711070;5476;71.2;65.9;0.5
06;2021-09-08;1441;2799;1291;769902;713869;6767;71.3;66.1;0.6
06;2021-09-09;1367;2908;1267;771269;716777;8034;71.5;66.4;0.7
06;2021-09-10;1773;3029;1011;773042;719806;9045;71.6;66.7;0.8
06;2021-09-11;961;2061;177;774003;721867;9222;71.7;66.9;0.9
06;2021-09-12;128;302;14;774131;722169;9236;71.7;66.9;0.9
06;2021-09-13;1208;2259;996;775339;724428;10232;71.8;67.1;0.9
06;2021-09-14;1383;2046;1281;776722;726474;11513;72.0;67.3;1.1
06;2021-09-15;1358;2383;1295;778080;728857;12808;72.1;67.5;1.2
06;2021-09-16;1167;2069;1891;779247;730926;14699;72.2;67.7;1.4
06;2021-09-17;1346;2538;1252;780593;733464;15951;72.3;68.0;1.5
06;2021-09-18;601;1691;225;781194;735155;16176;72.4;68.1;1.5
06;2021-09-19;83;250;21;781277;735405;16197;72.4;68.1;1.5
06;2021-09-20;801;1805;1050;782078;737210;17247;72.5;68.3;1.6
06;2021-09-21;874;2035;1637;782952;739245;18884;72.5;68.5;1.7
06;2021-09-22;929;2170;1024;783881;741415;19908;72.6;68.7;1.8
06;2021-09-23;755;1927;1081;784636;743342;20989;72.7;68.9;1.9
06;2021-09-24;819;2053;1087;785455;745395;22076;72.8;69.1;2.0
06;2021-09-25;400;1499;302;785855;746894;22378;72.8;69.2;2.1
06;2021-09-26;76;204;21;785931;747098;22399;72.8;69.2;2.1
06;2021-09-27;606;1378;1367;786537;748476;23766;72.9;69.3;2.2
06;2021-09-28;506;1350;1232;787043;749826;24998;72.9;69.5;2.3
06;2021-09-29;684;1524;777;787727;751350;25775;73.0;69.6;2.4
06;2021-09-30;659;1425;1474;788386;752775;27249;73.0;69.7;2.5
06;2021-10-01;1411;1687;1310;789797;754462;28559;73.2;69.9;2.6
06;2021-10-02;507;1136;400;790304;755598;28959;73.2;70.0;2.7
06;2021-10-03;97;169;29;790401;755767;28988;73.2;70.0;2.7
06;2021-10-04;875;963;1202;791276;756730;30190;73.3;70.1;2.8
06;2021-10-05;657;1296;1746;791933;758026;31936;73.4;70.2;3.0
06;2021-10-06;753;1420;1989;792686;759446;33925;73.4;70.4;3.1
06;2021-10-07;582;1354;1966;793268;760800;35891;73.5;70.5;3.3
06;2021-10-08;888;1569;2162;794156;762369;38053;73.6;70.6;3.5
06;2021-10-09;483;956;575;794639;763325;38628;73.6;70.7;3.6
06;2021-10-10;100;180;30;794739;763505;38658;73.6;70.7;3.6
06;2021-10-11;539;1080;1743;795278;764585;40401;73.7;70.8;3.7
06;2021-10-12;519;934;2076;795797;765519;42477;73.7;70.9;3.9
06;2021-10-13;713;1183;1807;796510;766702;44284;73.8;71.0;4.1
06;2021-10-14;620;1039;2008;797130;767741;46292;73.8;71.1;4.3
06;2021-10-15;892;1224;2165;798022;768965;48457;73.9;71.2;4.5
06;2021-10-16;501;702;612;798523;769667;49069;74.0;71.3;4.5
06;2021-10-17;68;164;47;798591;769831;49116;74.0;71.3;4.6
06;2021-10-18;495;900;2024;799086;770731;51140;74.0;71.4;4.7
06;2021-10-19;505;728;2408;799591;771459;53548;74.1;71.5;5.0
06;2021-10-20;574;896;2621;800165;772355;56169;74.1;71.6;5.2
06;2021-10-21;495;958;2445;800660;773313;58614;74.2;71.6;5.4
06;2021-10-22;668;1066;2360;801328;774379;60974;74.2;71.7;5.6
06;2021-10-23;378;516;768;801706;774895;61742;74.3;71.8;5.7
06;2021-10-24;17;124;13;801723;775019;61755;74.3;71.8;5.7
06;2021-10-25;427;649;1797;802150;775668;63552;74.3;71.9;5.9
06;2021-10-26;425;693;2533;802575;776361;66085;74.4;71.9;6.1
06;2021-10-27;460;815;2454;803035;777176;68539;74.4;72.0;6.3
06;2021-10-28;406;628;2558;803441;777804;71097;74.4;72.1;6.6
06;2021-10-29;524;730;2337;803965;778534;73434;74.5;72.1;6.8
06;2021-10-30;287;459;858;804252;778993;74292;74.5;72.2;6.9
06;2021-10-31;36;62;51;804288;779055;74343;74.5;72.2;6.9
06;2021-11-01;132;120;28;804420;779175;74371;74.5;72.2;6.9
06;2021-11-02;438;691;2494;804858;779866;76865;74.6;72.3;7.1
06;2021-11-03;504;793;3007;805362;780659;79872;74.6;72.3;7.4
06;2021-11-04;405;636;2779;805767;781295;82651;74.6;72.4;7.7
06;2021-11-05;551;742;2584;806318;782037;85235;74.7;72.5;7.9
06;2021-11-06;326;557;1034;806644;782594;86269;74.7;72.5;8.0
06;2021-11-07;63;114;87;806707;782708;86356;74.7;72.5;8.0
06;2021-11-08;391;681;2679;807098;783389;89035;74.8;72.6;8.2
06;2021-11-09;399;620;3324;807497;784009;92359;74.8;72.6;8.6
06;2021-11-10;594;872;4189;808091;784881;96548;74.9;72.7;8.9
06;2021-11-11;78;146;225;808169;785027;96773;74.9;72.7;9.0
06;2021-11-12;515;784;3305;808684;785811;100078;74.9;72.8;9.3
06;2021-11-13;304;371;1128;808988;786182;101206;74.9;72.8;9.4
06;2021-11-14;77;92;140;809065;786274;101346;75.0;72.8;9.4
06;2021-11-15;383;656;3084;809448;786930;104430;75.0;72.9;9.7
06;2021-11-16;381;604;4332;809829;787534;108762;75.0;73.0;10.1
06;2021-11-17;524;733;3861;810353;788267;112623;75.1;73.0;10.4
06;2021-11-18;427;624;4220;810780;788891;116843;75.1;73.1;10.8
06;2021-11-19;600;817;5130;811380;789708;121973;75.2;73.2;11.3
06;2021-11-20;346;479;1608;811726;790187;123581;75.2;73.2;11.4
06;2021-11-21;57;113;126;811783;790300;123707;75.2;73.2;11.5
06;2021-11-22;427;482;3766;812210;790782;127473;75.2;73.3;11.8
06;2021-11-23;413;525;5275;812623;791307;132748;75.3;73.3;12.3
06;2021-11-24;536;700;4822;813159;792007;137570;75.3;73.4;12.7
06;2021-11-25;494;620;5764;813653;792627;143334;75.4;73.4;13.3
06;2021-11-26;574;737;7240;814227;793364;150574;75.4;73.5;13.9
06;2021-11-27;366;481;3571;814593;793845;154145;75.5;73.5;14.3
06;2021-11-28;64;119;741;814657;793964;154886;75.5;73.6;14.3
06;2021-11-29;390;545;7327;815047;794509;162213;75.5;73.6;15.0
06;2021-11-30;425;595;8563;815472;795104;170776;75.5;73.7;15.8
06;2021-12-01;610;751;10334;816082;795855;181110;75.6;73.7;16.8
06;2021-12-02;467;596;12946;816549;796451;194056;75.6;73.8;18.0
06;2021-12-03;485;817;13325;817034;797268;207381;75.7;73.9;19.2
06;2021-12-04;395;509;6347;817429;797777;213728;75.7;73.9;19.8
06;2021-12-05;119;179;1409;817548;797956;215137;75.7;73.9;19.9
06;2021-12-06;438;674;10904;817986;798630;226041;75.8;74.0;20.9
06;2021-12-07;549;685;14852;818535;799315;240893;75.8;74.1;22.3
06;2021-12-08;561;819;12423;819096;800134;253316;75.9;74.1;23.5
06;2021-12-09;572;779;13771;819668;800913;267087;75.9;74.2;24.7
06;2021-12-10;516;824;14208;820184;801737;281295;76.0;74.3;26.1
06;2021-12-11;327;513;5258;820511;802250;286553;76.0;74.3;26.5
06;2021-12-12;83;153;1254;820594;802403;287807;76.0;74.3;26.7
06;2021-12-13;423;690;11112;821017;803093;298919;76.1;74.4;27.7
06;2021-12-14;468;702;12920;821485;803795;311839;76.1;74.5;28.9
06;2021-12-15;565;790;11523;822050;804585;323362;76.2;74.5;30.0
06;2021-12-16;536;746;11737;822586;805331;335099;76.2;74.6;31.0
07;2020-12-27;0;0;0;0;0;0;0.0;0.0;0.0
07;2020-12-28;0;0;0;0;0;0;0.0;0.0;0.0
07;2020-12-29;0;0;0;0;0;0;0.0;0.0;0.0
07;2020-12-30;0;0;0;0;0;0;0.0;0.0;0.0
07;2020-12-31;0;0;0;0;0;0;0.0;0.0;0.0
07;2021-01-01;5;0;0;5;0;0;0.0;0.0;0.0
07;2021-01-02;0;0;0;5;0;0;0.0;0.0;0.0
07;2021-01-03;0;0;0;5;0;0;0.0;0.0;0.0
07;2021-01-04;0;0;0;5;0;0;0.0;0.0;0.0
07;2021-01-05;0;0;0;5;0;0;0.0;0.0;0.0
07;2021-01-06;31;0;0;36;0;0;0.0;0.0;0.0
07;2021-01-07;133;1;0;169;1;0;0.1;0.0;0.0
07;2021-01-08;68;1;0;237;2;0;0.1;0.0;0.0
07;2021-01-09;14;0;0;251;2;0;0.1;0.0;0.0
07;2021-01-10;0;0;0;251;2;0;0.1;0.0;0.0
07;2021-01-11;175;1;0;426;3;0;0.1;0.0;0.0
07;2021-01-12;309;1;0;735;4;0;0.2;0.0;0.0
07;2021-01-13;308;2;0;1043;6;0;0.3;0.0;0.0
07;2021-01-14;463;0;0;1506;6;0;0.5;0.0;0.0
07;2021-01-15;235;0;0;1741;6;0;0.5;0.0;0.0
07;2021-01-16;42;0;0;1783;6;0;0.5;0.0;0.0
07;2021-01-17;3;0;0;1786;6;0;0.5;0.0;0.0
07;2021-01-18;363;3;0;2149;9;0;0.7;0.0;0.0
07;2021-01-19;796;3;0;2945;12;0;0.9;0.0;0.0
07;2021-01-20;556;4;0;3501;16;0;1.1;0.0;0.0
07;2021-01-21;493;5;0;3994;21;0;1.2;0.0;0.0
07;2021-01-22;352;3;0;4346;24;0;1.3;0.0;0.0
07;2021-01-23;153;2;0;4499;26;0;1.4;0.0;0.0
07;2021-01-24;10;0;0;4509;26;0;1.4;0.0;0.0
07;2021-01-25;232;2;0;4741;28;0;1.5;0.0;0.0
07;2021-01-26;529;4;0;5270;32;0;1.6;0.0;0.0
07;2021-01-27;574;12;0;5844;44;0;1.8;0.0;0.0
07;2021-01-28;1165;111;0;7009;155;0;2.1;0.0;0.0
07;2021-01-29;729;28;0;7738;183;0;2.4;0.1;0.0
07;2021-01-30;236;2;0;7974;185;0;2.4;0.1;0.0
07;2021-01-31;11;0;0;7985;185;0;2.4;0.1;0.0
07;2021-02-01;319;50;0;8304;235;0;2.5;0.1;0.0
07;2021-02-02;640;247;0;8944;482;0;2.7;0.1;0.0
07;2021-02-03;1059;236;0;10003;718;0;3.1;0.2;0.0
07;2021-02-04;686;292;0;10689;1010;0;3.3;0.3;0.0
07;2021-02-05;506;254;0;11195;1264;0;3.4;0.4;0.0
07;2021-02-06;138;17;0;11333;1281;0;3.5;0.4;0.0
07;2021-02-07;29;2;0;11362;1283;0;3.5;0.4;0.0
07;2021-02-08;264;193;0;11626;1476;0;3.6;0.5;0.0
07;2021-02-09;509;365;0;12135;1841;0;3.7;0.6;0.0
07;2021-02-10;536;358;0;12671;2199;0;3.9;0.7;0.0
07;2021-02-11;423;293;0;13094;2492;0;4.0;0.8;0.0
07;2021-02-12;294;213;0;13388;2705;0;4.1;0.8;0.0
07;2021-02-13;118;52;0;13506;2757;0;4.1;0.8;0.0
07;2021-02-14;4;0;0;13510;2757;0;4.1;0.8;0.0
07;2021-02-15;302;175;0;13812;2932;0;4.2;0.9;0.0
07;2021-02-16;352;383;0;14164;3315;0;4.3;1.0;0.0
07;2021-02-17;434;358;0;14598;3673;0;4.5;1.1;0.0
07;2021-02-18;538;714;0;15136;4387;0;4.6;1.3;0.0
07;2021-02-19;457;486;0;15593;4873;0;4.8;1.5;0.0
07;2021-02-20;105;91;0;15698;4964;0;4.8;1.5;0.0
07;2021-02-21;17;11;0;15715;4975;0;4.8;1.5;0.0
07;2021-02-22;412;281;0;16127;5256;0;4.9;1.6;0.0
07;2021-02-23;628;616;0;16755;5872;0;5.1;1.8;0.0
07;2021-02-24;886;782;0;17641;6654;0;5.4;2.0;0.0
07;2021-02-25;715;569;0;18356;7223;0;5.6;2.2;0.0
07;2021-02-26;819;332;0;19175;7555;0;5.9;2.3;0.0
07;2021-02-27;202;196;0;19377;7751;0;5.9;2.4;0.0
07;2021-02-28;2;7;0;19379;7758;0;5.9;2.4;0.0
07;2021-03-01;446;243;0;19825;8001;0;6.1;2.4;0.0
07;2021-03-02;657;548;0;20482;8549;0;6.3;2.6;0.0
07;2021-03-03;709;551;0;21191;9100;0;6.5;2.8;0.0
07;2021-03-04;1105;383;0;22296;9483;0;6.8;2.9;0.0
07;2021-03-05;1124;404;0;23420;9887;0;7.2;3.0;0.0
07;2021-03-06;1307;139;0;24727;10026;0;7.6;3.1;0.0
07;2021-03-07;920;32;0;25647;10058;0;7.8;3.1;0.0
07;2021-03-08;425;355;0;26072;10413;0;8.0;3.2;0.0
07;2021-03-09;1110;464;0;27182;10877;0;8.3;3.3;0.0
07;2021-03-10;900;514;0;28082;11391;0;8.6;3.5;0.0
07;2021-03-11;1438;468;0;29520;11859;0;9.0;3.6;0.0
07;2021-03-12;1642;539;0;31162;12398;0;9.5;3.8;0.0
07;2021-03-13;746;143;0;31908;12541;0;9.8;3.8;0.0
07;2021-03-14;18;10;0;31926;12551;0;9.8;3.8;0.0
07;2021-03-15;582;290;0;32508;12841;0;9.9;3.9;0.0
07;2021-03-16;1232;476;0;33740;13317;0;10.3;4.1;0.0
07;2021-03-17;1168;757;0;34908;14074;0;10.7;4.3;0.0
07;2021-03-18;1198;438;0;36106;14512;0;11.0;4.4;0.0
07;2021-03-19;1244;422;0;37350;14934;0;11.4;4.6;0.0
07;2021-03-20;523;115;0;37873;15049;0;11.6;4.6;0.0
07;2021-03-21;20;4;0;37893;15053;0;11.6;4.6;0.0
07;2021-03-22;833;518;0;38726;15571;0;11.8;4.8;0.0
07;2021-03-23;1441;659;0;40167;16230;0;12.3;5.0;0.0
07;2021-03-24;1252;627;0;41419;16857;0;12.7;5.2;0.0
07;2021-03-25;1835;495;0;43254;17352;0;13.2;5.3;0.0
07;2021-03-26;1817;433;0;45071;17785;0;13.8;5.4;0.0
07;2021-03-27;455;115;0;45526;17900;0;13.9;5.5;0.0
07;2021-03-28;31;4;0;45557;17904;0;13.9;5.5;0.0
07;2021-03-29;840;366;0;46397;18270;0;14.2;5.6;0.0
07;2021-03-30;1587;536;0;47984;18806;0;14.7;5.8;0.0
07;2021-03-31;1482;492;0;49466;19298;0;15.1;5.9;0.0
07;2021-04-01;1661;666;0;51127;19964;0;15.6;6.1;0.0
07;2021-04-02;1495;503;0;52622;20467;0;16.1;6.3;0.0
07;2021-04-03;277;236;0;52899;20703;0;16.2;6.3;0.0
07;2021-04-04;34;93;0;52933;20796;0;16.2;6.4;0.0
07;2021-04-05;79;65;0;53012;20861;0;16.2;6.4;0.0
07;2021-04-06;1158;781;0;54170;21642;0;16.6;6.6;0.0
07;2021-04-07;1254;931;0;55424;22573;0;17.0;6.9;0.0
07;2021-04-08;1908;1140;0;57332;23713;0;17.5;7.3;0.0
07;2021-04-09;2296;604;0;59628;24317;0;18.2;7.4;0.0
07;2021-04-10;829;231;0;60457;24548;0;18.5;7.5;0.0
07;2021-04-11;313;16;0;60770;24564;0;18.6;7.5;0.0
07;2021-04-12;1236;638;0;62006;25202;0;19.0;7.7;0.0
07;2021-04-13;1701;1280;0;63707;26482;0;19.5;8.1;0.0
07;2021-04-14;1535;1032;0;65242;27514;0;20.0;8.4;0.0
07;2021-04-15;1368;858;0;66610;28372;0;20.4;8.7;0.0
07;2021-04-16;1421;893;0;68031;29265;0;20.8;9.0;0.0
07;2021-04-17;896;253;0;68927;29518;0;21.1;9.0;0.0
07;2021-04-18;589;45;0;69516;29563;0;21.3;9.0;0.0
07;2021-04-19;1092;607;0;70608;30170;0;21.6;9.2;0.0
07;2021-04-20;1364;1262;0;71972;31432;0;22.0;9.6;0.0
07;2021-04-21;1612;906;0;73584;32338;0;22.5;9.9;0.0
07;2021-04-22;1639;933;0;75223;33271;0;23.0;10.2;0.0
07;2021-04-23;1351;968;0;76574;34239;0;23.4;10.5;0.0
07;2021-04-24;925;306;0;77499;34545;0;23.7;10.6;0.0
07;2021-04-25;717;81;0;78216;34626;0;23.9;10.6;0.0
07;2021-04-26;1056;768;0;79272;35394;0;24.3;10.8;0.0
07;2021-04-27;1352;1489;0;80624;36883;0;24.7;11.3;0.0
07;2021-04-28;1464;1459;0;82088;38342;0;25.1;11.7;0.0
07;2021-04-29;1842;1459;0;83930;39801;0;25.7;12.2;0.0
07;2021-04-30;1493;1383;0;85423;41184;0;26.1;12.6;0.0
07;2021-05-01;916;144;0;86339;41328;0;26.4;12.6;0.0
07;2021-05-02;749;151;0;87088;41479;0;26.6;12.7;0.0
07;2021-05-03;1282;491;0;88370;41970;0;27.0;12.8;0.0
07;2021-05-04;1943;1549;0;90313;43519;0;27.6;13.3;0.0
07;2021-05-05;1683;1364;0;91996;44883;0;28.1;13.7;0.0
07;2021-05-06;2050;1588;0;94046;46471;0;28.8;14.2;0.0
07;2021-05-07;1633;1487;0;95679;47958;0;29.3;14.7;0.0
07;2021-05-08;1150;415;0;96829;48373;0;29.6;14.8;0.0
07;2021-05-09;887;307;0;97716;48680;0;29.9;14.9;0.0
07;2021-05-10;1467;1125;0;99183;49805;0;30.3;15.2;0.0
07;2021-05-11;2350;1542;0;101533;51347;0;31.1;15.7;0.0
07;2021-05-12;2131;1152;0;103664;52499;0;31.7;16.1;0.0
07;2021-05-13;1656;273;0;105320;52772;0;32.2;16.1;0.0
07;2021-05-14;1732;879;0;107052;53651;0;32.8;16.4;0.0
07;2021-05-15;1707;473;0;108759;54124;0;33.3;16.6;0.0
07;2021-05-16;1489;201;0;110248;54325;0;33.7;16.6;0.0
07;2021-05-17;1794;835;0;112042;55160;0;34.3;16.9;0.0
07;2021-05-18;2239;1233;0;114281;56393;0;35.0;17.3;0.0
07;2021-05-19;2246;919;0;116527;57312;0;35.6;17.5;0.0
07;2021-05-20;2071;1227;0;118598;58539;0;36.3;17.9;0.0
07;2021-05-21;1731;1243;0;120329;59782;0;36.8;18.3;0.0
07;2021-05-22;965;530;0;121294;60312;0;37.1;18.5;0.0
07;2021-05-23;658;146;0;121952;60458;0;37.3;18.5;0.0
07;2021-05-24;1467;343;0;123419;60801;0;37.8;18.6;0.0
07;2021-05-25;1977;1350;0;125396;62151;0;38.4;19.0;0.0
07;2021-05-26;1616;1294;0;127012;63445;0;38.9;19.4;0.0
07;2021-05-27;1882;1414;0;128894;64859;0;39.4;19.8;0.0
07;2021-05-28;1729;2002;0;130623;66861;0;40.0;20.5;0.0
07;2021-05-29;972;724;0;131595;67585;0;40.3;20.7;0.0
07;2021-05-30;415;482;0;132010;68067;0;40.4;20.8;0.0
07;2021-05-31;1163;1192;0;133173;69259;0;40.7;21.2;0.0
07;2021-06-01;1768;1904;0;134941;71163;0;41.3;21.8;0.0
07;2021-06-02;1475;1546;0;136416;72709;0;41.7;22.2;0.0
07;2021-06-03;1587;1319;0;138003;74028;0;42.2;22.6;0.0
07;2021-06-04;1604;1626;0;139607;75654;0;42.7;23.1;0.0
07;2021-06-05;920;920;0;140527;76574;0;43.0;23.4;0.0
07;2021-06-06;388;552;0;140915;77126;0;43.1;23.6;0.0
07;2021-06-07;938;1205;0;141853;78331;0;43.4;24.0;0.0
07;2021-06-08;1436;1690;0;143289;80021;0;43.8;24.5;0.0
07;2021-06-09;1054;1444;0;144343;81465;0;44.2;24.9;0.0
07;2021-06-10;867;1432;0;145210;82897;0;44.4;25.4;0.0
07;2021-06-11;1174;2064;0;146384;84961;0;44.8;26.0;0.0
07;2021-06-12;572;1194;0;146956;86155;0;45.0;26.4;0.0
07;2021-06-13;248;367;0;147204;86522;0;45.0;26.5;0.0
07;2021-06-14;638;1935;0;147842;88457;0;45.2;27.1;0.0
07;2021-06-15;975;2451;0;148817;90908;0;45.5;27.8;0.0
07;2021-06-16;995;1864;0;149812;92772;0;45.8;28.4;0.0
07;2021-06-17;884;1933;0;150696;94705;0;46.1;29.0;0.0
07;2021-06-18;918;2373;0;151614;97078;0;46.4;29.7;0.0
07;2021-06-19;522;1389;0;152136;98467;0;46.5;30.1;0.0
07;2021-06-20;282;637;0;152418;99104;0;46.6;30.3;0.0
07;2021-06-21;531;2130;0;152949;101234;0;46.8;31.0;0.0
07;2021-06-22;656;2580;0;153605;103814;0;47.0;31.8;0.0
07;2021-06-23;680;2068;0;154285;105882;0;47.2;32.4;0.0
07;2021-06-24;642;1907;0;154927;107789;0;47.4;33.0;0.0
07;2021-06-25;665;2358;0;155592;110147;0;47.6;33.7;0.0
07;2021-06-26;339;1598;0;155931;111745;0;47.7;34.2;0.0
07;2021-06-27;203;902;0;156134;112647;0;47.8;34.5;0.0
07;2021-06-28;502;2225;0;156636;114872;0;47.9;35.1;0.0
07;2021-06-29;545;2850;0;157181;117722;0;48.1;36.0;0.0
07;2021-06-30;820;2293;0;158001;120015;0;48.3;36.7;0.0
07;2021-07-01;858;1923;0;158859;121938;0;48.6;37.3;0.0
07;2021-07-02;864;2231;0;159723;124169;0;48.9;38.0;0.0
07;2021-07-03;401;1261;0;160124;125430;0;49.0;38.4;0.0
07;2021-07-04;202;608;0;160326;126038;0;49.0;38.6;0.0
07;2021-07-05;646;1736;0;160972;127774;0;49.2;39.1;0.0
07;2021-07-06;859;2377;0;161831;130151;0;49.5;39.8;0.0
07;2021-07-07;935;1874;0;162766;132025;0;49.8;40.4;0.0
07;2021-07-08;1026;1842;0;163792;133867;0;50.1;41.0;0.0
07;2021-07-09;951;2244;0;164743;136111;0;50.4;41.6;0.0
07;2021-07-10;559;1172;0;165302;137283;0;50.6;42.0;0.0
07;2021-07-11;206;518;0;165508;137801;0;50.6;42.2;0.0
07;2021-07-12;756;1798;0;166264;139599;0;50.9;42.7;0.0
07;2021-07-13;1524;2681;0;167788;142280;0;51.3;43.5;0.0
07;2021-07-14;395;236;0;168183;142516;0;51.5;43.6;0.0
07;2021-07-15;1846;2171;0;170029;144687;0;52.0;44.3;0.0
07;2021-07-16;1975;1963;0;172004;146650;0;52.6;44.9;0.0
07;2021-07-17;1292;1102;0;173296;147752;0;53.0;45.2;0.0
07;2021-07-18;313;221;0;173609;147973;0;53.1;45.3;0.0
07;2021-07-19;1427;1595;0;175036;149568;0;53.5;45.8;0.0
07;2021-07-20;2393;2260;0;177429;151828;0;54.3;46.4;0.0
07;2021-07-21;1893;1817;0;179322;153645;0;54.9;47.0;0.0
07;2021-07-22;1996;1372;0;181318;155017;0;55.5;47.4;0.0
07;2021-07-23;2286;1612;0;183604;156629;0;56.2;47.9;0.0
07;2021-07-24;1508;959;0;185112;157588;0;56.6;48.2;0.0
07;2021-07-25;192;56;0;185304;157644;0;56.7;48.2;0.0
07;2021-07-26;2013;1459;0;187317;159103;0;57.3;48.7;0.0
07;2021-07-27;2756;1598;0;190073;160701;0;58.1;49.2;0.0
07;2021-07-28;1907;1239;0;191980;161940;0;58.7;49.5;0.0
07;2021-07-29;2390;1259;0;194370;163199;0;59.5;49.9;0.0
07;2021-07-30;1706;1460;0;196076;164659;0;60.0;50.4;0.0
07;2021-07-31;1217;748;0;197293;165407;0;60.4;50.6;0.0
07;2021-08-01;118;53;0;197411;165460;0;60.4;50.6;0.0
07;2021-08-02;1563;1117;0;198974;166577;0;60.9;51.0;0.0
07;2021-08-03;2213;1727;0;201187;168304;0;61.5;51.5;0.0
07;2021-08-04;1865;956;0;203052;169260;0;62.1;51.8;0.0
07;2021-08-05;1834;1288;0;204886;170548;0;62.7;52.2;0.0
07;2021-08-06;1858;1645;0;206744;172193;0;63.2;52.7;0.0
07;2021-08-07;733;562;0;207477;172755;0;63.5;52.9;0.0
07;2021-08-08;28;47;0;207505;172802;0;63.5;52.9;0.0
07;2021-08-09;1127;1452;0;208632;174254;0;63.8;53.3;0.0
07;2021-08-10;1416;2141;0;210048;176395;0;64.3;54.0;0.0
07;2021-08-11;1301;1620;0;211349;178015;0;64.7;54.5;0.0
07;2021-08-12;1088;1519;0;212437;179534;0;65.0;54.9;0.0
07;2021-08-13;1137;1714;0;213574;181248;0;65.3;55.4;0.0
07;2021-08-14;424;747;0;213998;181995;0;65.5;55.7;0.0
07;2021-08-15;26;53;0;214024;182048;0;65.5;55.7;0.0
07;2021-08-16;747;1580;0;214771;183628;0;65.7;56.2;0.0
07;2021-08-17;1187;2219;0;215958;185847;0;66.1;56.9;0.0
07;2021-08-18;952;1632;0;216910;187479;0;66.4;57.4;0.0
07;2021-08-19;1101;1732;0;218011;189211;0;66.7;57.9;0.0
07;2021-08-20;920;2121;0;218931;191332;0;67.0;58.5;0.0
07;2021-08-21;349;657;0;219280;191989;0;67.1;58.7;0.0
07;2021-08-22;7;41;0;219287;192030;0;67.1;58.7;0.0
07;2021-08-23;544;1569;0;219831;193599;0;67.3;59.2;0.0
07;2021-08-24;1064;2250;0;220895;195849;0;67.6;59.9;0.0
07;2021-08-25;761;1837;0;221656;197686;0;67.8;60.5;0.0
07;2021-08-26;712;1909;0;222368;199595;0;68.0;61.1;0.0
07;2021-08-27;843;1971;0;223211;201566;0;68.3;61.7;0.0
07;2021-08-28;332;684;0;223543;202250;0;68.4;61.9;0.0
07;2021-08-29;11;71;0;223554;202321;0;68.4;61.9;0.0
07;2021-08-30;494;1533;23;224048;203854;23;68.5;62.4;0.0
07;2021-08-31;1033;2111;74;225081;205965;97;68.9;63.0;0.0
07;2021-09-01;677;1365;68;225758;207330;165;69.1;63.4;0.1
07;2021-09-02;615;1322;171;226373;208652;336;69.3;63.8;0.1
07;2021-09-03;780;1718;131;227153;210370;467;69.5;64.4;0.1
07;2021-09-04;346;653;24;227499;211023;491;69.6;64.6;0.2
07;2021-09-05;19;29;4;227518;211052;495;69.6;64.6;0.2
07;2021-09-06;435;845;152;227953;211897;647;69.7;64.8;0.2
07;2021-09-07;509;1064;165;228462;212961;812;69.9;65.2;0.2
07;2021-09-08;485;1060;145;228947;214021;957;70.0;65.5;0.3
07;2021-09-09;446;862;204;229393;214883;1161;70.2;65.7;0.4
07;2021-09-10;551;1243;197;229944;216126;1358;70.3;66.1;0.4
07;2021-09-11;178;605;40;230122;216731;1398;70.4;66.3;0.4
07;2021-09-12;4;16;3;230126;216747;1401;70.4;66.3;0.4
07;2021-09-13;366;577;135;230492;217324;1536;70.5;66.5;0.5
07;2021-09-14;578;880;333;231070;218204;1869;70.7;66.8;0.6
07;2021-09-15;344;844;203;231414;219048;2072;70.8;67.0;0.6
07;2021-09-16;436;599;320;231850;219647;2392;70.9;67.2;0.7
07;2021-09-17;365;886;314;232215;220533;2706;71.0;67.5;0.8
07;2021-09-18;139;504;59;232354;221037;2765;71.1;67.6;0.8
07;2021-09-19;6;26;4;232360;221063;2769;71.1;67.6;0.8
07;2021-09-20;231;427;406;232591;221490;3175;71.2;67.8;1.0
07;2021-09-21;270;687;364;232861;222177;3539;71.2;68.0;1.1
07;2021-09-22;202;773;201;233063;222950;3740;71.3;68.2;1.1
07;2021-09-23;200;556;343;233263;223506;4083;71.4;68.4;1.2
07;2021-09-24;275;882;365;233538;224388;4448;71.4;68.6;1.4
07;2021-09-25;93;330;63;233631;224718;4511;71.5;68.7;1.4
07;2021-09-26;5;13;6;233636;224731;4517;71.5;68.8;1.4
07;2021-09-27;190;499;323;233826;225230;4840;71.5;68.9;1.5
07;2021-09-28;181;475;530;234007;225705;5370;71.6;69.0;1.6
07;2021-09-29;179;563;377;234186;226268;5747;71.6;69.2;1.8
07;2021-09-30;184;438;345;234370;226706;6092;71.7;69.4;1.9
07;2021-10-01;286;617;367;234656;227323;6459;71.8;69.5;2.0
07;2021-10-02;110;214;59;234766;227537;6518;71.8;69.6;2.0
07;2021-10-03;5;17;2;234771;227554;6520;71.8;69.6;2.0
07;2021-10-04;172;385;362;234943;227939;6882;71.9;69.7;2.1
07;2021-10-05;215;484;480;235158;228423;7362;71.9;69.9;2.3
07;2021-10-06;178;365;500;235336;228788;7862;72.0;70.0;2.4
07;2021-10-07;127;402;358;235463;229190;8220;72.0;70.1;2.5
07;2021-10-08;230;480;511;235693;229670;8731;72.1;70.3;2.7
07;2021-10-09;100;171;140;235793;229841;8871;72.1;70.3;2.7
07;2021-10-10;1;4;2;235794;229845;8873;72.1;70.3;2.7
07;2021-10-11;117;293;495;235911;230138;9368;72.2;70.4;2.9
07;2021-10-12;171;390;515;236082;230528;9883;72.2;70.5;3.0
07;2021-10-13;151;274;402;236233;230802;10285;72.3;70.6;3.1
07;2021-10-14;152;239;368;236385;231041;10653;72.3;70.7;3.3
07;2021-10-15;236;375;567;236621;231416;11220;72.4;70.8;3.4
07;2021-10-16;108;130;175;236729;231546;11395;72.4;70.8;3.5
07;2021-10-17;1;5;1;236730;231551;11396;72.4;70.8;3.5
07;2021-10-18;183;240;389;236913;231791;11785;72.5;70.9;3.6
07;2021-10-19;114;148;564;237027;231939;12349;72.5;71.0;3.8
07;2021-10-20;108;200;442;237135;232139;12791;72.5;71.0;3.9
07;2021-10-21;65;156;545;237200;232295;13336;72.6;71.1;4.1
07;2021-10-22;88;270;623;237288;232565;13959;72.6;71.1;4.3
07;2021-10-23;53;72;133;237341;232637;14092;72.6;71.2;4.3
07;2021-10-24;3;8;2;237344;232645;14094;72.6;71.2;4.3
07;2021-10-25;77;155;367;237421;232800;14461;72.6;71.2;4.4
07;2021-10-26;97;172;747;237518;232972;15208;72.7;71.3;4.7
07;2021-10-27;77;173;407;237595;233145;15615;72.7;71.3;4.8
07;2021-10-28;62;115;404;237657;233260;16019;72.7;71.4;4.9
07;2021-10-29;88;208;731;237745;233468;16750;72.7;71.4;5.1
07;2021-10-30;53;85;191;237798;233553;16941;72.7;71.5;5.2
07;2021-10-31;0;2;3;237798;233555;16944;72.7;71.5;5.2
07;2021-11-01;7;10;17;237805;233565;16961;72.8;71.5;5.2
07;2021-11-02;89;192;700;237894;233757;17661;72.8;71.5;5.4
07;2021-11-03;94;125;630;237988;233882;18291;72.8;71.6;5.6
07;2021-11-04;72;122;681;238060;234004;18972;72.8;71.6;5.8
07;2021-11-05;97;227;822;238157;234231;19794;72.9;71.7;6.1
07;2021-11-06;33;86;230;238190;234317;20024;72.9;71.7;6.1
07;2021-11-07;2;11;2;238192;234328;20026;72.9;71.7;6.1
07;2021-11-08;64;158;767;238256;234486;20793;72.9;71.7;6.4
07;2021-11-09;68;134;1051;238324;234620;21844;72.9;71.8;6.7
07;2021-11-10;77;184;1128;238401;234804;22972;72.9;71.8;7.0
07;2021-11-11;4;3;27;238405;234807;22999;72.9;71.8;7.0
07;2021-11-12;110;167;1179;238515;234974;24178;73.0;71.9;7.4
07;2021-11-13;44;85;275;238559;235059;24453;73.0;71.9;7.5
07;2021-11-14;0;10;10;238559;235069;24463;73.0;71.9;7.5
07;2021-11-15;69;105;1056;238628;235174;25519;73.0;71.9;7.8
07;2021-11-16;84;107;1543;238712;235281;27062;73.0;72.0;8.3
07;2021-11-17;101;124;1154;238813;235405;28216;73.1;72.0;8.6
07;2021-11-18;81;109;1059;238894;235514;29275;73.1;72.1;9.0
07;2021-11-19;94;131;1493;238988;235645;30768;73.1;72.1;9.4
07;2021-11-20;79;56;366;239067;235701;31134;73.1;72.1;9.5
07;2021-11-21;0;2;13;239067;235703;31147;73.1;72.1;9.5
07;2021-11-22;71;55;1137;239138;235758;32284;73.2;72.1;9.9
07;2021-11-23;123;94;1797;239261;235852;34081;73.2;72.2;10.4
07;2021-11-24;135;117;1423;239396;235969;35504;73.2;72.2;10.9
07;2021-11-25;99;92;1905;239495;236061;37409;73.3;72.2;11.4
07;2021-11-26;142;124;2587;239637;236185;39996;73.3;72.3;12.2
07;2021-11-27;69;60;1329;239706;236245;41325;73.3;72.3;12.6
07;2021-11-28;12;7;472;239718;236252;41797;73.3;72.3;12.8
07;2021-11-29;63;69;2154;239781;236321;43951;73.4;72.3;13.4
07;2021-11-30;82;88;3338;239863;236409;47289;73.4;72.3;14.5
07;2021-12-01;100;89;2633;239963;236498;49922;73.4;72.4;15.3
07;2021-12-02;56;58;2925;240019;236556;52847;73.4;72.4;16.2
07;2021-12-03;93;118;3632;240112;236674;56479;73.5;72.4;17.3
07;2021-12-04;60;50;1573;240172;236724;58052;73.5;72.4;17.8
07;2021-12-05;6;12;347;240178;236736;58399;73.5;72.4;17.9
07;2021-12-06;62;73;2710;240240;236809;61109;73.5;72.4;18.7
07;2021-12-07;107;114;4366;240347;236923;65475;73.5;72.5;20.0
07;2021-12-08;86;94;3481;240433;237017;68956;73.6;72.5;21.1
07;2021-12-09;97;83;3578;240530;237100;72534;73.6;72.5;22.2
07;2021-12-10;98;113;4245;240628;237213;76779;73.6;72.6;23.5
07;2021-12-11;69;71;1999;240697;237284;78778;73.6;72.6;24.1
07;2021-12-12;9;7;438;240706;237291;79216;73.6;72.6;24.2
07;2021-12-13;80;87;3081;240786;237378;82297;73.7;72.6;25.2
07;2021-12-14;134;134;4628;240920;237512;86925;73.7;72.7;26.6
07;2021-12-15;91;134;3972;241011;237646;90897;73.7;72.7;27.8
07;2021-12-16;95;101;4145;241106;237747;95042;73.8;72.7;29.1
08;2020-12-27;0;0;0;0;0;0;0.0;0.0;0.0
08;2020-12-28;0;0;0;0;0;0;0.0;0.0;0.0
08;2020-12-29;0;0;0;0;0;0;0.0;0.0;0.0
08;2020-12-30;0;0;0;0;0;0;0.0;0.0;0.0
08;2020-12-31;0;0;0;0;0;0;0.0;0.0;0.0
08;2021-01-01;0;0;0;0;0;0;0.0;0.0;0.0
08;2021-01-02;0;0;0;0;0;0;0.0;0.0;0.0
08;2021-01-03;1;0;0;1;0;0;0.0;0.0;0.0
08;2021-01-04;23;0;0;24;0;0;0.0;0.0;0.0
08;2021-01-05;0;0;0;24;0;0;0.0;0.0;0.0
08;2021-01-06;0;0;0;24;0;0;0.0;0.0;0.0
08;2021-01-07;187;0;0;211;0;0;0.1;0.0;0.0
08;2021-01-08;302;0;0;513;0;0;0.2;0.0;0.0
08;2021-01-09;106;0;0;619;0;0;0.2;0.0;0.0
08;2021-01-10;1;0;0;620;0;0;0.2;0.0;0.0
08;2021-01-11;79;1;0;699;1;0;0.3;0.0;0.0
08;2021-01-12;174;0;0;873;1;0;0.3;0.0;0.0
08;2021-01-13;484;1;0;1357;2;0;0.5;0.0;0.0
08;2021-01-14;540;8;0;1897;10;0;0.7;0.0;0.0
08;2021-01-15;294;2;0;2191;12;0;0.8;0.0;0.0
08;2021-01-16;105;0;0;2296;12;0;0.9;0.0;0.0
08;2021-01-17;1;0;0;2297;12;0;0.9;0.0;0.0
08;2021-01-18;384;2;0;2681;14;0;1.0;0.0;0.0
08;2021-01-19;842;1;0;3523;15;0;1.3;0.0;0.0
08;2021-01-20;891;4;0;4414;19;0;1.7;0.0;0.0
08;2021-01-21;729;1;0;5143;20;0;1.9;0.0;0.0
08;2021-01-22;680;2;0;5823;22;0;2.2;0.0;0.0
08;2021-01-23;237;0;0;6060;22;0;2.3;0.0;0.0
08;2021-01-24;1;0;0;6061;22;0;2.3;0.0;0.0
08;2021-01-25;204;0;0;6265;22;0;2.4;0.0;0.0
08;2021-01-26;289;1;0;6554;23;0;2.5;0.0;0.0
08;2021-01-27;413;1;0;6967;24;0;2.6;0.0;0.0
08;2021-01-28;565;173;0;7532;197;0;2.8;0.1;0.0
08;2021-01-29;574;172;0;8106;369;0;3.1;0.1;0.0
08;2021-01-30;207;60;0;8313;429;0;3.1;0.2;0.0
08;2021-01-31;0;0;0;8313;429;0;3.1;0.2;0.0
08;2021-02-01;84;49;0;8397;478;0;3.2;0.2;0.0
08;2021-02-02;201;166;0;8598;644;0;3.2;0.2;0.0
08;2021-02-03;144;169;0;8742;813;0;3.3;0.3;0.0
08;2021-02-04;329;295;0;9071;1108;0;3.4;0.4;0.0
08;2021-02-05;515;343;0;9586;1451;0;3.6;0.5;0.0
08;2021-02-06;142;75;0;9728;1526;0;3.7;0.6;0.0
08;2021-02-07;8;0;0;9736;1526;0;3.7;0.6;0.0
08;2021-02-08;44;175;0;9780;1701;0;3.7;0.6;0.0
08;2021-02-09;217;623;0;9997;2324;0;3.8;0.9;0.0
08;2021-02-10;325;616;0;10322;2940;0;3.9;1.1;0.0
08;2021-02-11;464;358;0;10786;3298;0;4.1;1.2;0.0
08;2021-02-12;662;385;0;11448;3683;0;4.3;1.4;0.0
08;2021-02-13;128;113;0;11576;3796;0;4.4;1.4;0.0
08;2021-02-14;4;61;0;11580;3857;0;4.4;1.5;0.0
08;2021-02-15;225;204;0;11805;4061;0;4.4;1.5;0.0
08;2021-02-16;138;381;0;11943;4442;0;4.5;1.7;0.0
08;2021-02-17;127;409;0;12070;4851;0;4.5;1.8;0.0
08;2021-02-18;229;518;0;12299;5369;0;4.6;2.0;0.0
08;2021-02-19;311;425;0;12610;5794;0;4.7;2.2;0.0
08;2021-02-20;16;205;0;12626;5999;0;4.8;2.3;0.0
08;2021-02-21;0;0;0;12626;5999;0;4.8;2.3;0.0
08;2021-02-22;139;181;0;12765;6180;0;4.8;2.3;0.0
08;2021-02-23;163;324;0;12928;6504;0;4.9;2.4;0.0
08;2021-02-24;169;387;0;13097;6891;0;4.9;2.6;0.0
08;2021-02-25;497;528;0;13594;7419;0;5.1;2.8;0.0
08;2021-02-26;616;631;0;14210;8050;0;5.4;3.0;0.0
08;2021-02-27;308;185;0;14518;8235;0;5.5;3.1;0.0
08;2021-02-28;21;1;0;14539;8236;0;5.5;3.1;0.0
08;2021-03-01;200;103;0;14739;8339;0;5.6;3.1;0.0
08;2021-03-02;623;275;0;15362;8614;0;5.8;3.2;0.0
08;2021-03-03;871;196;0;16233;8810;0;6.1;3.3;0.0
08;2021-03-04;722;345;0;16955;9155;0;6.4;3.4;0.0
08;2021-03-05;1006;546;0;17961;9701;0;6.8;3.7;0.0
08;2021-03-06;652;133;0;18613;9834;0;7.0;3.7;0.0
08;2021-03-07;57;0;0;18670;9834;0;7.0;3.7;0.0
08;2021-03-08;210;126;0;18880;9960;0;7.1;3.8;0.0
08;2021-03-09;686;166;0;19566;10126;0;7.4;3.8;0.0
08;2021-03-10;1043;125;0;20609;10251;0;7.8;3.9;0.0
08;2021-03-11;962;254;0;21571;10505;0;8.1;4.0;0.0
08;2021-03-12;1625;519;0;23196;11024;0;8.7;4.2;0.0
08;2021-03-13;799;112;0;23995;11136;0;9.0;4.2;0.0
08;2021-03-14;28;0;0;24023;11136;0;9.0;4.2;0.0
08;2021-03-15;292;74;0;24315;11210;0;9.2;4.2;0.0
08;2021-03-16;559;43;0;24874;11253;0;9.4;4.2;0.0
08;2021-03-17;802;80;0;25676;11333;0;9.7;4.3;0.0
08;2021-03-18;808;171;0;26484;11504;0;10.0;4.3;0.0
08;2021-03-19;1141;290;0;27625;11794;0;10.4;4.4;0.0
08;2021-03-20;507;26;0;28132;11820;0;10.6;4.5;0.0
08;2021-03-21;17;1;0;28149;11821;0;10.6;4.5;0.0
08;2021-03-22;381;50;0;28530;11871;0;10.7;4.5;0.0
08;2021-03-23;769;69;0;29299;11940;0;11.0;4.5;0.0
08;2021-03-24;1347;76;0;30646;12016;0;11.5;4.5;0.0
08;2021-03-25;1911;104;0;32557;12120;0;12.3;4.6;0.0
08;2021-03-26;2468;175;0;35025;12295;0;13.2;4.6;0.0
08;2021-03-27;912;125;0;35937;12420;0;13.5;4.7;0.0
08;2021-03-28;233;8;0;36170;12428;0;13.6;4.7;0.0
08;2021-03-29;290;182;0;36460;12610;0;13.7;4.7;0.0
08;2021-03-30;846;472;0;37306;13082;0;14.0;4.9;0.0
08;2021-03-31;868;512;0;38174;13594;0;14.4;5.1;0.0
08;2021-04-01;1688;436;0;39862;14030;0;15.0;5.3;0.0
08;2021-04-02;1485;511;0;41347;14541;0;15.6;5.5;0.0
08;2021-04-03;1287;196;0;42634;14737;0;16.1;5.6;0.0
08;2021-04-04;125;5;0;42759;14742;0;16.1;5.6;0.0
08;2021-04-05;14;2;0;42773;14744;0;16.1;5.6;0.0
08;2021-04-06;706;482;0;43479;15226;0;16.4;5.7;0.0
08;2021-04-07;908;692;0;44387;15918;0;16.7;6.0;0.0
08;2021-04-08;1740;519;0;46127;16437;0;17.4;6.2;0.0
08;2021-04-09;2330;727;0;48457;17164;0;18.2;6.5;0.0
08;2021-04-10;1429;228;0;49886;17392;0;18.8;6.5;0.0
08;2021-04-11;16;10;0;49902;17402;0;18.8;6.6;0.0
08;2021-04-12;667;217;0;50569;17619;0;19.0;6.6;0.0
08;2021-04-13;1287;611;0;51856;18230;0;19.5;6.9;0.0
08;2021-04-14;1288;852;0;53144;19082;0;20.0;7.2;0.0
08;2021-04-15;1610;808;0;54754;19890;0;20.6;7.5;0.0
08;2021-04-16;1878;875;0;56632;20765;0;21.3;7.8;0.0
08;2021-04-17;1074;399;0;57706;21164;0;21.7;8.0;0.0
08;2021-04-18;42;16;0;57748;21180;0;21.7;8.0;0.0
08;2021-04-19;1129;312;0;58877;21492;0;22.2;8.1;0.0
08;2021-04-20;1086;572;0;59963;22064;0;22.6;8.3;0.0
08;2021-04-21;1106;768;0;61069;22832;0;23.0;8.6;0.0
08;2021-04-22;1262;885;0;62331;23717;0;23.5;8.9;0.0
08;2021-04-23;1605;1168;0;63936;24885;0;24.1;9.4;0.0
08;2021-04-24;1232;637;0;65168;25522;0;24.5;9.6;0.0
08;2021-04-25;32;204;0;65200;25726;0;24.6;9.7;0.0
08;2021-04-26;946;163;0;66146;25889;0;24.9;9.7;0.0
08;2021-04-27;1258;606;0;67404;26495;0;25.4;10.0;0.0
08;2021-04-28;1371;697;0;68775;27192;0;25.9;10.2;0.0
08;2021-04-29;1105;1306;0;69880;28498;0;26.3;10.7;0.0
08;2021-04-30;1677;1592;0;71557;30090;0;26.9;11.3;0.0
08;2021-05-01;929;475;0;72486;30565;0;27.3;11.5;0.0
08;2021-05-02;581;179;0;73067;30744;0;27.5;11.6;0.0
08;2021-05-03;1093;383;0;74160;31127;0;27.9;11.7;0.0
08;2021-05-04;1270;878;0;75430;32005;0;28.4;12.1;0.0
08;2021-05-05;1513;1313;0;76943;33318;0;29.0;12.5;0.0
08;2021-05-06;1840;1645;0;78783;34963;0;29.7;13.2;0.0
08;2021-05-07;1814;2052;0;80597;37015;0;30.4;13.9;0.0
08;2021-05-08;883;760;0;81480;37775;0;30.7;14.2;0.0
08;2021-05-09;414;60;0;81894;37835;0;30.8;14.2;0.0
08;2021-05-10;1163;666;0;83057;38501;0;31.3;14.5;0.0
08;2021-05-11;1837;968;0;84894;39469;0;32.0;14.9;0.0
08;2021-05-12;1728;1243;0;86622;40712;0;32.6;15.3;0.0
08;2021-05-13;1267;596;0;87889;41308;0;33.1;15.6;0.0
08;2021-05-14;2426;1009;0;90315;42317;0;34.0;15.9;0.0
08;2021-05-15;1737;697;0;92052;43014;0;34.7;16.2;0.0
08;2021-05-16;795;94;0;92847;43108;0;35.0;16.2;0.0
08;2021-05-17;668;885;0;93515;43993;0;35.2;16.6;0.0
08;2021-05-18;1251;837;0;94766;44830;0;35.7;16.9;0.0
08;2021-05-19;1512;959;0;96278;45789;0;36.3;17.2;0.0
08;2021-05-20;1955;948;0;98233;46737;0;37.0;17.6;0.0
08;2021-05-21;2192;1246;0;100425;47983;0;37.8;18.1;0.0
08;2021-05-22;1750;748;0;102175;48731;0;38.5;18.4;0.0
08;2021-05-23;857;89;0;103032;48820;0;38.8;18.4;0.0
08;2021-05-24;748;110;0;103780;48930;0;39.1;18.4;0.0
08;2021-05-25;1318;676;0;105098;49606;0;39.6;18.7;0.0
08;2021-05-26;1435;1022;0;106533;50628;0;40.1;19.1;0.0
08;2021-05-27;1817;1100;0;108350;51728;0;40.8;19.5;0.0
08;2021-05-28;1878;1807;0;110228;53535;0;41.5;20.2;0.0
08;2021-05-29;1582;937;0;111810;54472;0;42.1;20.5;0.0
08;2021-05-30;806;103;0;112616;54575;0;42.4;20.6;0.0
08;2021-05-31;715;556;0;113331;55131;0;42.7;20.8;0.0
08;2021-06-01;1319;889;0;114650;56020;0;43.2;21.1;0.0
08;2021-06-02;1330;1168;0;115980;57188;0;43.7;21.5;0.0
08;2021-06-03;1356;1485;0;117336;58673;0;44.2;22.1;0.0
08;2021-06-04;1724;2337;0;119060;61010;0;44.8;23.0;0.0
08;2021-06-05;1157;1288;0;120217;62298;0;45.3;23.5;0.0
08;2021-06-06;899;105;0;121116;62403;0;45.6;23.5;0.0
08;2021-06-07;701;1112;0;121817;63515;0;45.9;23.9;0.0
08;2021-06-08;923;1446;0;122740;64961;0;46.2;24.5;0.0
08;2021-06-09;867;1358;0;123607;66319;0;46.6;25.0;0.0
08;2021-06-10;1622;1483;0;125229;67802;0;47.2;25.5;0.0
08;2021-06-11;1672;2126;0;126901;69928;0;47.8;26.3;0.0
08;2021-06-12;1275;1427;0;128176;71355;0;48.3;26.9;0.0
08;2021-06-13;388;589;0;128564;71944;0;48.4;27.1;0.0
08;2021-06-14;399;1258;0;128963;73202;0;48.6;27.6;0.0
08;2021-06-15;782;1509;0;129745;74711;0;48.9;28.1;0.0
08;2021-06-16;816;2019;0;130561;76730;0;49.2;28.9;0.0
08;2021-06-17;1260;1784;0;131821;78514;0;49.6;29.6;0.0
08;2021-06-18;1536;2537;0;133357;81051;0;50.2;30.5;0.0
08;2021-06-19;1246;1343;0;134603;82394;0;50.7;31.0;0.0
08;2021-06-20;123;403;0;134726;82797;0;50.7;31.2;0.0
08;2021-06-21;496;1341;0;135222;84138;0;50.9;31.7;0.0
08;2021-06-22;821;1973;0;136043;86111;0;51.2;32.4;0.0
08;2021-06-23;907;1637;0;136950;87748;0;51.6;33.0;0.0
08;2021-06-24;991;1867;0;137941;89615;0;51.9;33.7;0.0
08;2021-06-25;1042;2652;0;138983;92267;0;52.3;34.7;0.0
08;2021-06-26;959;1752;0;139942;94019;0;52.7;35.4;0.0
08;2021-06-27;346;648;0;140288;94667;0;52.8;35.7;0.0
08;2021-06-28;403;1315;0;140691;95982;0;53.0;36.1;0.0
08;2021-06-29;620;1410;0;141311;97392;0;53.2;36.7;0.0
08;2021-06-30;838;1611;0;142149;99003;0;53.5;37.3;0.0
08;2021-07-01;850;2064;0;142999;101067;0;53.9;38.1;0.0
08;2021-07-02;912;2551;0;143911;103618;0;54.2;39.0;0.0
08;2021-07-03;725;2020;0;144636;105638;0;54.5;39.8;0.0
08;2021-07-04;142;850;0;144778;106488;0;54.5;40.1;0.0
08;2021-07-05;117;1188;0;144895;107676;0;54.6;40.6;0.0
08;2021-07-06;446;1706;2;145341;109382;2;54.7;41.2;0.0
08;2021-07-07;408;1727;0;145749;111109;2;54.9;41.8;0.0
08;2021-07-08;672;1839;0;146421;112948;2;55.1;42.5;0.0
08;2021-07-09;728;2371;0;147149;115319;2;55.4;43.4;0.0
08;2021-07-10;611;1849;0;147760;117168;2;55.6;44.1;0.0
08;2021-07-11;236;721;0;147996;117889;2;55.7;44.4;0.0
08;2021-07-12;334;1205;0;148330;119094;2;55.9;44.9;0.0
08;2021-07-13;943;1775;0;149273;120869;2;56.2;45.5;0.0
08;2021-07-14;224;369;0;149497;121238;2;56.3;45.7;0.0
08;2021-07-15;814;2410;0;150311;123648;2;56.6;46.6;0.0
08;2021-07-16;1079;2351;0;151390;125999;2;57.0;47.5;0.0
08;2021-07-17;1031;2021;0;152421;128020;2;57.4;48.2;0.0
08;2021-07-18;349;734;0;152770;128754;2;57.5;48.5;0.0
08;2021-07-19;515;942;0;153285;129696;2;57.7;48.8;0.0
08;2021-07-20;971;1505;0;154256;131201;2;58.1;49.4;0.0
08;2021-07-21;1314;1735;0;155570;132936;2;58.6;50.1;0.0
08;2021-07-22;1309;2088;1;156879;135024;3;59.1;50.9;0.0
08;2021-07-23;1616;2419;0;158495;137443;3;59.7;51.8;0.0
08;2021-07-24;1378;1860;0;159873;139303;3;60.2;52.5;0.0
08;2021-07-25;782;458;0;160655;139761;3;60.5;52.6;0.0
08;2021-07-26;1352;879;0;162007;140640;3;61.0;53.0;0.0
08;2021-07-27;2142;1422;0;164149;142062;3;61.8;53.5;0.0
08;2021-07-28;2346;1488;0;166495;143550;3;62.7;54.1;0.0
08;2021-07-29;2525;1311;0;169020;144861;3;63.7;54.6;0.0
08;2021-07-30;2507;1541;0;171527;146402;3;64.6;55.1;0.0
08;2021-07-31;1875;1031;0;173402;147433;3;65.3;55.5;0.0
08;2021-08-01;899;303;0;174301;147736;3;65.6;55.6;0.0
08;2021-08-02;1266;693;0;175567;148429;3;66.1;55.9;0.0
08;2021-08-03;1659;848;0;177226;149277;3;66.7;56.2;0.0
08;2021-08-04;1514;662;0;178740;149939;3;67.3;56.5;0.0
08;2021-08-05;1813;953;0;180553;150892;3;68.0;56.8;0.0
08;2021-08-06;2414;1111;1;182967;152003;4;68.9;57.2;0.0
08;2021-08-07;1530;1115;0;184497;153118;4;69.5;57.7;0.0
08;2021-08-08;557;370;0;185054;153488;4;69.7;57.8;0.0
08;2021-08-09;680;573;0;185734;154061;4;69.9;58.0;0.0
08;2021-08-10;877;800;0;186611;154861;4;70.3;58.3;0.0
08;2021-08-11;576;834;0;187187;155695;4;70.5;58.6;0.0
08;2021-08-12;1033;1068;0;188220;156763;4;70.9;59.0;0.0
08;2021-08-13;1112;1052;0;189332;157815;4;71.3;59.4;0.0
08;2021-08-14;564;902;0;189896;158717;4;71.5;59.8;0.0
08;2021-08-15;138;262;0;190034;158979;4;71.6;59.9;0.0
08;2021-08-16;241;1256;0;190275;160235;4;71.7;60.3;0.0
08;2021-08-17;522;1263;0;190797;161498;4;71.9;60.8;0.0
08;2021-08-18;329;1319;0;191126;162817;4;72.0;61.3;0.0
08;2021-08-19;588;1826;0;191714;164643;4;72.2;62.0;0.0
08;2021-08-20;677;2177;0;192391;166820;4;72.5;62.8;0.0
08;2021-08-21;266;1329;0;192657;168149;4;72.6;63.3;0.0
08;2021-08-22;107;863;0;192764;169012;4;72.6;63.7;0.0
08;2021-08-23;181;1477;0;192945;170489;4;72.7;64.2;0.0
08;2021-08-24;390;1779;0;193335;172268;4;72.8;64.9;0.0
08;2021-08-25;327;1295;0;193662;173563;4;72.9;65.4;0.0
08;2021-08-26;484;1989;0;194146;175552;4;73.1;66.1;0.0
08;2021-08-27;444;2208;0;194590;177760;4;73.3;66.9;0.0
08;2021-08-28;265;1326;0;194855;179086;4;73.4;67.4;0.0
08;2021-08-29;163;557;0;195018;179643;4;73.4;67.7;0.0
08;2021-08-30;321;1214;10;195339;180857;14;73.6;68.1;0.0
08;2021-08-31;351;1251;40;195690;182108;54;73.7;68.6;0.0
08;2021-09-01;436;1237;115;196126;183345;169;73.9;69.0;0.1
08;2021-09-02;466;1087;150;196592;184432;319;74.0;69.5;0.1
08;2021-09-03;464;1528;149;197056;185960;468;74.2;70.0;0.2
08;2021-09-04;333;1301;57;197389;187261;525;74.3;70.5;0.2
08;2021-09-05;105;165;34;197494;187426;559;74.4;70.6;0.2
08;2021-09-06;188;389;129;197682;187815;688;74.4;70.7;0.3
08;2021-09-07;205;485;149;197887;188300;837;74.5;70.9;0.3
08;2021-09-08;261;518;111;198148;188818;948;74.6;71.1;0.4
08;2021-09-09;316;580;161;198464;189398;1109;74.7;71.3;0.4
08;2021-09-10;479;761;281;198943;190159;1390;74.9;71.6;0.5
08;2021-09-11;348;686;126;199291;190845;1516;75.1;71.9;0.6
08;2021-09-12;48;69;21;199339;190914;1537;75.1;71.9;0.6
08;2021-09-13;358;180;99;199697;191094;1636;75.2;72.0;0.6
08;2021-09-14;236;276;141;199933;191370;1777;75.3;72.1;0.7
08;2021-09-15;231;340;260;200164;191710;2037;75.4;72.2;0.8
08;2021-09-16;215;409;236;200379;192119;2273;75.5;72.4;0.9
08;2021-09-17;313;500;347;200692;192619;2620;75.6;72.5;1.0
08;2021-09-18;175;441;186;200867;193060;2806;75.6;72.7;1.1
08;2021-09-19;24;85;6;200891;193145;2812;75.7;72.7;1.1
08;2021-09-20;62;230;180;200953;193375;2992;75.7;72.8;1.1
08;2021-09-21;120;269;300;201073;193644;3292;75.7;72.9;1.2
08;2021-09-22;131;376;293;201204;194020;3585;75.8;73.1;1.4
08;2021-09-23;170;375;309;201374;194395;3894;75.8;73.2;1.5
08;2021-09-24;164;525;411;201538;194920;4305;75.9;73.4;1.6
08;2021-09-25;105;404;161;201643;195324;4466;75.9;73.6;1.7
08;2021-09-26;20;101;11;201663;195425;4477;75.9;73.6;1.7
08;2021-09-27;48;207;178;201711;195632;4655;76.0;73.7;1.8
08;2021-09-28;80;220;239;201791;195852;4894;76.0;73.8;1.8
08;2021-09-29;114;321;238;201905;196173;5132;76.0;73.9;1.9
08;2021-09-30;143;345;251;202048;196518;5383;76.1;74.0;2.0
08;2021-10-01;171;470;389;202219;196988;5772;76.2;74.2;2.2
08;2021-10-02;133;284;169;202352;197272;5941;76.2;74.3;2.2
08;2021-10-03;24;68;17;202376;197340;5958;76.2;74.3;2.2
08;2021-10-04;80;330;141;202456;197670;6099;76.2;74.4;2.3
08;2021-10-05;78;178;279;202534;197848;6378;76.3;74.5;2.4
08;2021-10-06;96;237;250;202630;198085;6628;76.3;74.6;2.5
08;2021-10-07;100;181;303;202730;198266;6931;76.3;74.7;2.6
08;2021-10-08;157;339;496;202887;198605;7427;76.4;74.8;2.8
08;2021-10-09;128;315;280;203015;198920;7707;76.5;74.9;2.9
08;2021-10-10;32;44;30;203047;198964;7737;76.5;74.9;2.9
08;2021-10-11;59;87;265;203106;199051;8002;76.5;75.0;3.0
08;2021-10-12;79;137;260;203185;199188;8262;76.5;75.0;3.1
08;2021-10-13;112;165;225;203297;199353;8487;76.6;75.1;3.2
08;2021-10-14;60;170;294;203357;199523;8781;76.6;75.1;3.3
08;2021-10-15;211;286;705;203568;199809;9486;76.7;75.2;3.6
08;2021-10-16;72;118;238;203640;199927;9724;76.7;75.3;3.7
08;2021-10-17;34;28;28;203674;199955;9752;76.7;75.3;3.7
08;2021-10-18;78;68;275;203752;200023;10027;76.7;75.3;3.8
08;2021-10-19;60;73;324;203812;200096;10351;76.8;75.4;3.9
08;2021-10-20;109;144;497;203921;200240;10848;76.8;75.4;4.1
08;2021-10-21;72;85;365;203993;200325;11213;76.8;75.4;4.2
08;2021-10-22;141;197;578;204134;200522;11791;76.9;75.5;4.4
08;2021-10-23;69;148;281;204203;200670;12072;76.9;75.6;4.5
08;2021-10-24;20;37;39;204223;200707;12111;76.9;75.6;4.6
08;2021-10-25;68;64;269;204291;200771;12380;76.9;75.6;4.7
08;2021-10-26;82;73;384;204373;200844;12764;77.0;75.6;4.8
08;2021-10-27;79;104;401;204452;200948;13165;77.0;75.7;5.0
08;2021-10-28;84;85;471;204536;201033;13636;77.0;75.7;5.1
08;2021-10-29;147;168;704;204683;201201;14340;77.1;75.8;5.4
08;2021-10-30;54;71;242;204737;201272;14582;77.1;75.8;5.5
08;2021-10-31;15;29;66;204752;201301;14648;77.1;75.8;5.5
08;2021-11-01;2;1;4;204754;201302;14652;77.1;75.8;5.5
08;2021-11-02;66;114;463;204820;201416;15115;77.1;75.9;5.7
08;2021-11-03;77;100;459;204897;201516;15574;77.2;75.9;5.9
08;2021-11-04;72;81;499;204969;201597;16073;77.2;75.9;6.1
08;2021-11-05;85;191;753;205054;201788;16826;77.2;76.0;6.3
08;2021-11-06;68;96;396;205122;201884;17222;77.2;76.0;6.5
08;2021-11-07;10;34;47;205132;201918;17269;77.3;76.0;6.5
08;2021-11-08;36;71;308;205168;201989;17577;77.3;76.1;6.6
08;2021-11-09;76;105;658;205244;202094;18235;77.3;76.1;6.9
08;2021-11-10;81;141;761;205325;202235;18996;77.3;76.2;7.2
08;2021-11-11;3;4;27;205328;202239;19023;77.3;76.2;7.2
08;2021-11-12;133;187;1072;205461;202426;20095;77.4;76.2;7.6
08;2021-11-13;46;62;418;205507;202488;20513;77.4;76.3;7.7
08;2021-11-14;11;17;72;205518;202505;20585;77.4;76.3;7.8
08;2021-11-15;35;69;466;205553;202574;21051;77.4;76.3;7.9
08;2021-11-16;51;77;762;205604;202651;21813;77.4;76.3;8.2
08;2021-11-17;56;86;582;205660;202737;22395;77.5;76.4;8.4
08;2021-11-18;61;112;935;205721;202849;23330;77.5;76.4;8.8
08;2021-11-19;118;197;1370;205839;203046;24700;77.5;76.5;9.3
08;2021-11-20;60;64;534;205899;203110;25234;77.5;76.5;9.5
08;2021-11-21;21;19;100;205920;203129;25334;77.6;76.5;9.5
08;2021-11-22;44;30;530;205964;203159;25864;77.6;76.5;9.7
08;2021-11-23;80;65;886;206044;203224;26750;77.6;76.5;10.1
08;2021-11-24;70;108;842;206114;203332;27592;77.6;76.6;10.4
08;2021-11-25;72;83;1197;206186;203415;28789;77.7;76.6;10.8
08;2021-11-26;142;142;2132;206328;203557;30921;77.7;76.7;11.6
08;2021-11-27;84;65;903;206412;203622;31824;77.7;76.7;12.0
08;2021-11-28;23;21;287;206435;203643;32111;77.7;76.7;12.1
08;2021-11-29;47;33;988;206482;203676;33099;77.8;76.7;12.5
08;2021-11-30;81;84;1820;206563;203760;34919;77.8;76.7;13.2
08;2021-12-01;80;79;1898;206643;203839;36817;77.8;76.8;13.9
08;2021-12-02;66;46;2407;206709;203885;39224;77.8;76.8;14.8
08;2021-12-03;120;154;3001;206829;204039;42225;77.9;76.8;15.9
08;2021-12-04;58;72;1594;206887;204111;43819;77.9;76.9;16.5
08;2021-12-05;12;16;369;206899;204127;44188;77.9;76.9;16.6
08;2021-12-06;29;60;1556;206928;204187;45744;77.9;76.9;17.2
08;2021-12-07;75;70;2593;207003;204257;48337;78.0;76.9;18.2
08;2021-12-08;53;74;1864;207056;204331;50201;78.0;77.0;18.9
08;2021-12-09;62;75;2988;207118;204406;53189;78.0;77.0;20.0
08;2021-12-10;107;122;3989;207225;204528;57178;78.0;77.0;21.5
08;2021-12-11;62;77;2329;207287;204605;59507;78.1;77.1;22.4
08;2021-12-12;13;31;797;207300;204636;60304;78.1;77.1;22.7
08;2021-12-13;43;55;1986;207343;204691;62290;78.1;77.1;23.5
08;2021-12-14;72;82;3136;207415;204773;65426;78.1;77.1;24.6
08;2021-12-15;68;87;2972;207483;204860;68398;78.1;77.2;25.8
08;2021-12-16;99;98;3737;207582;204958;72135;78.2;77.2;27.2
09;2020-12-27;0;0;0;0;0;0;0.0;0.0;0.0
09;2020-12-28;1;0;0;1;0;0;0.0;0.0;0.0
09;2020-12-29;0;0;0;1;0;0;0.0;0.0;0.0
09;2020-12-30;0;0;0;1;0;0;0.0;0.0;0.0
09;2020-12-31;0;0;0;1;0;0;0.0;0.0;0.0
09;2021-01-01;0;0;0;1;0;0;0.0;0.0;0.0
09;2021-01-02;0;0;0;1;0;0;0.0;0.0;0.0
09;2021-01-03;0;0;0;1;0;0;0.0;0.0;0.0
09;2021-01-04;1;0;0;2;0;0;0.0;0.0;0.0
09;2021-01-05;1;0;0;3;0;0;0.0;0.0;0.0
09;2021-01-06;4;0;0;7;0;0;0.0;0.0;0.0
09;2021-01-07;231;2;0;238;2;0;0.2;0.0;0.0
09;2021-01-08;196;0;0;434;2;0;0.3;0.0;0.0
09;2021-01-09;88;0;0;522;2;0;0.3;0.0;0.0
09;2021-01-10;55;0;0;577;2;0;0.4;0.0;0.0
09;2021-01-11;177;0;0;754;2;0;0.5;0.0;0.0
09;2021-01-12;282;0;0;1036;2;0;0.7;0.0;0.0
09;2021-01-13;191;0;0;1227;2;0;0.8;0.0;0.0
09;2021-01-14;431;6;0;1658;8;0;1.1;0.0;0.0
09;2021-01-15;223;2;0;1881;10;0;1.2;0.0;0.0
09;2021-01-16;168;2;0;2049;12;0;1.3;0.0;0.0
09;2021-01-17;93;0;0;2142;12;0;1.4;0.0;0.0
09;2021-01-18;272;1;0;2414;13;0;1.6;0.0;0.0
09;2021-01-19;261;1;0;2675;14;0;1.8;0.0;0.0
09;2021-01-20;368;2;0;3043;16;0;2.0;0.0;0.0
09;2021-01-21;325;1;0;3368;17;0;2.2;0.0;0.0
09;2021-01-22;349;1;0;3717;18;0;2.4;0.0;0.0
09;2021-01-23;212;0;0;3929;18;0;2.6;0.0;0.0
09;2021-01-24;73;1;0;4002;19;0;2.6;0.0;0.0
09;2021-01-25;206;9;0;4208;28;0;2.8;0.0;0.0
09;2021-01-26;570;26;0;4778;54;0;3.1;0.0;0.0
09;2021-01-27;407;41;0;5185;95;0;3.4;0.1;0.0
09;2021-01-28;310;188;0;5495;283;0;3.6;0.2;0.0
09;2021-01-29;233;112;0;5728;395;0;3.8;0.3;0.0
09;2021-01-30;141;52;0;5869;447;0;3.9;0.3;0.0
09;2021-01-31;43;10;0;5912;457;0;3.9;0.3;0.0
09;2021-02-01;90;129;0;6002;586;0;3.9;0.4;0.0
09;2021-02-02;75;280;0;6077;866;0;4.0;0.6;0.0
09;2021-02-03;90;182;0;6167;1048;0;4.0;0.7;0.0
09;2021-02-04;59;304;0;6226;1352;0;4.1;0.9;0.0
09;2021-02-05;92;148;0;6318;1500;0;4.1;1.0;0.0
09;2021-02-06;72;47;0;6390;1547;0;4.2;1.0;0.0
09;2021-02-07;9;56;0;6399;1603;0;4.2;1.1;0.0
09;2021-02-08;35;203;0;6434;1806;0;4.2;1.2;0.0
09;2021-02-09;56;283;0;6490;2089;0;4.3;1.4;0.0
09;2021-02-10;33;210;0;6523;2299;0;4.3;1.5;0.0
09;2021-02-11;36;216;0;6559;2515;0;4.3;1.7;0.0
09;2021-02-12;140;184;0;6699;2699;0;4.4;1.8;0.0
09;2021-02-13;8;131;0;6707;2830;0;4.4;1.9;0.0
09;2021-02-14;0;46;0;6707;2876;0;4.4;1.9;0.0
09;2021-02-15;69;137;0;6776;3013;0;4.4;2.0;0.0
09;2021-02-16;206;469;0;6982;3482;0;4.6;2.3;0.0
09;2021-02-17;94;319;0;7076;3801;0;4.6;2.5;0.0
09;2021-02-18;91;434;0;7167;4235;0;4.7;2.8;0.0
09;2021-02-19;54;271;0;7221;4506;0;4.7;3.0;0.0
09;2021-02-20;45;172;0;7266;4678;0;4.8;3.1;0.0
09;2021-02-21;0;46;0;7266;4724;0;4.8;3.1;0.0
09;2021-02-22;119;226;0;7385;4950;0;4.8;3.2;0.0
09;2021-02-23;152;162;0;7537;5112;0;4.9;3.4;0.0
09;2021-02-24;80;181;0;7617;5293;0;5.0;3.5;0.0
09;2021-02-25;206;175;0;7823;5468;0;5.1;3.6;0.0
09;2021-02-26;146;167;0;7969;5635;0;5.2;3.7;0.0
09;2021-02-27;56;68;0;8025;5703;0;5.3;3.7;0.0
09;2021-02-28;25;15;0;8050;5718;0;5.3;3.8;0.0
09;2021-03-01;220;94;0;8270;5812;0;5.4;3.8;0.0
09;2021-03-02;261;88;0;8531;5900;0;5.6;3.9;0.0
09;2021-03-03;215;122;0;8746;6022;0;5.7;4.0;0.0
09;2021-03-04;374;48;0;9120;6070;0;6.0;4.0;0.0
09;2021-03-05;316;75;0;9436;6145;0;6.2;4.0;0.0
09;2021-03-06;353;39;0;9789;6184;0;6.4;4.1;0.0
09;2021-03-07;128;4;0;9917;6188;0;6.5;4.1;0.0
09;2021-03-08;327;68;0;10244;6256;0;6.7;4.1;0.0
09;2021-03-09;418;145;0;10662;6401;0;7.0;4.2;0.0
09;2021-03-10;523;82;0;11185;6483;0;7.3;4.3;0.0
09;2021-03-11;646;91;0;11831;6574;0;7.8;4.3;0.0
09;2021-03-12;627;35;0;12458;6609;0;8.2;4.3;0.0
09;2021-03-13;359;2;0;12817;6611;0;8.4;4.3;0.0
09;2021-03-14;101;5;0;12918;6616;0;8.5;4.3;0.0
09;2021-03-15;414;53;0;13332;6669;0;8.7;4.4;0.0
09;2021-03-16;313;89;0;13645;6758;0;9.0;4.4;0.0
09;2021-03-17;327;76;0;13972;6834;0;9.2;4.5;0.0
09;2021-03-18;390;39;0;14362;6873;0;9.4;4.5;0.0
09;2021-03-19;479;53;0;14841;6926;0;9.7;4.5;0.0
09;2021-03-20;281;37;0;15122;6963;0;9.9;4.6;0.0
09;2021-03-21;79;0;0;15201;6963;0;10.0;4.6;0.0
09;2021-03-22;373;116;0;15574;7079;0;10.2;4.6;0.0
09;2021-03-23;506;155;0;16080;7234;0;10.6;4.7;0.0
09;2021-03-24;664;39;0;16744;7273;0;11.0;4.8;0.0
09;2021-03-25;797;126;0;17541;7399;0;11.5;4.9;0.0
09;2021-03-26;692;41;0;18233;7440;0;12.0;4.9;0.0
09;2021-03-27;540;65;0;18773;7505;0;12.3;4.9;0.0
09;2021-03-28;122;15;0;18895;7520;0;12.4;4.9;0.0
09;2021-03-29;491;233;0;19386;7753;0;12.7;5.1;0.0
09;2021-03-30;786;145;0;20172;7898;0;13.2;5.2;0.0
09;2021-03-31;729;167;0;20901;8065;0;13.7;5.3;0.0
09;2021-04-01;695;226;0;21596;8291;0;14.2;5.4;0.0
09;2021-04-02;618;235;0;22214;8526;0;14.6;5.6;0.0
09;2021-04-03;604;90;0;22818;8616;0;15.0;5.7;0.0
09;2021-04-04;123;51;0;22941;8667;0;15.1;5.7;0.0
09;2021-04-05;207;57;0;23148;8724;0;15.2;5.7;0.0
09;2021-04-06;879;356;0;24027;9080;0;15.8;6.0;0.0
09;2021-04-07;970;321;0;24997;9401;0;16.4;6.2;0.0
09;2021-04-08;1222;374;0;26219;9775;0;17.2;6.4;0.0
09;2021-04-09;1003;352;0;27222;10127;0;17.9;6.6;0.0
09;2021-04-10;990;154;0;28212;10281;0;18.5;6.7;0.0
09;2021-04-11;169;87;0;28381;10368;0;18.6;6.8;0.0
09;2021-04-12;629;299;0;29010;10667;0;19.0;7.0;0.0
09;2021-04-13;915;369;0;29925;11036;0;19.6;7.2;0.0
09;2021-04-14;1122;419;0;31047;11455;0;20.4;7.5;0.0
09;2021-04-15;990;441;0;32037;11896;0;21.0;7.8;0.0
09;2021-04-16;868;364;0;32905;12260;0;21.6;8.0;0.0
09;2021-04-17;966;286;0;33871;12546;0;22.2;8.2;0.0
09;2021-04-18;96;85;0;33967;12631;0;22.3;8.3;0.0
09;2021-04-19;620;354;0;34587;12985;0;22.7;8.5;0.0
09;2021-04-20;738;478;0;35325;13463;0;23.2;8.8;0.0
09;2021-04-21;811;519;0;36136;13982;0;23.7;9.2;0.0
09;2021-04-22;598;534;0;36734;14516;0;24.1;9.5;0.0
09;2021-04-23;714;388;0;37448;14904;0;24.6;9.8;0.0
09;2021-04-24;617;542;0;38065;15446;0;25.0;10.1;0.0
09;2021-04-25;74;112;0;38139;15558;0;25.0;10.2;0.0
09;2021-04-26;382;477;0;38521;16035;0;25.3;10.5;0.0
09;2021-04-27;423;638;0;38944;16673;0;25.6;10.9;0.0
09;2021-04-28;745;687;0;39689;17360;0;26.0;11.4;0.0
09;2021-04-29;539;691;0;40228;18051;0;26.4;11.8;0.0
09;2021-04-30;589;558;0;40817;18609;0;26.8;12.2;0.0
09;2021-05-01;389;313;0;41206;18922;0;27.0;12.4;0.0
09;2021-05-02;59;100;0;41265;19022;0;27.1;12.5;0.0
09;2021-05-03;507;575;0;41772;19597;0;27.4;12.9;0.0
09;2021-05-04;531;1071;0;42303;20668;0;27.8;13.6;0.0
09;2021-05-05;709;984;0;43012;21652;0;28.2;14.2;0.0
09;2021-05-06;760;881;0;43772;22533;0;28.7;14.8;0.0
09;2021-05-07;858;669;0;44630;23202;0;29.3;15.2;0.0
09;2021-05-08;326;349;0;44956;23551;0;29.5;15.5;0.0
09;2021-05-09;197;87;0;45153;23638;0;29.6;15.5;0.0
09;2021-05-10;444;806;0;45597;24444;0;29.9;16.0;0.0
09;2021-05-11;645;883;0;46242;25327;0;30.3;16.6;0.0
09;2021-05-12;1146;1125;0;47388;26452;0;31.1;17.4;0.0
09;2021-05-13;895;322;0;48283;26774;0;31.7;17.6;0.0
09;2021-05-14;688;533;0;48971;27307;0;32.1;17.9;0.0
09;2021-05-15;784;553;0;49755;27860;0;32.6;18.3;0.0
09;2021-05-16;165;44;0;49920;27904;0;32.8;18.3;0.0
09;2021-05-17;597;384;0;50517;28288;0;33.1;18.6;0.0
09;2021-05-18;1004;398;0;51521;28686;0;33.8;18.8;0.0
09;2021-05-19;1069;348;0;52590;29034;0;34.5;19.1;0.0
09;2021-05-20;984;382;0;53574;29416;0;35.2;19.3;0.0
09;2021-05-21;764;429;0;54338;29845;0;35.7;19.6;0.0
09;2021-05-22;908;297;0;55246;30142;0;36.3;19.8;0.0
09;2021-05-23;117;17;0;55363;30159;0;36.3;19.8;0.0
09;2021-05-24;119;81;0;55482;30240;0;36.4;19.8;0.0
09;2021-05-25;758;478;0;56240;30718;0;36.9;20.2;0.0
09;2021-05-26;811;422;0;57051;31140;0;37.4;20.4;0.0
09;2021-05-27;596;366;0;57647;31506;0;37.8;20.7;0.0
09;2021-05-28;619;469;0;58266;31975;0;38.2;21.0;0.0
09;2021-05-29;821;536;0;59087;32511;0;38.8;21.3;0.0
09;2021-05-30;265;180;0;59352;32691;0;38.9;21.5;0.0
09;2021-05-31;438;557;0;59790;33248;0;39.2;21.8;0.0
09;2021-06-01;715;620;0;60505;33868;0;39.7;22.2;0.0
09;2021-06-02;796;784;0;61301;34652;0;40.2;22.7;0.0
09;2021-06-03;595;636;0;61896;35288;0;40.6;23.2;0.0
09;2021-06-04;708;754;0;62604;36042;0;41.1;23.6;0.0
09;2021-06-05;793;732;0;63397;36774;0;41.6;24.1;0.0
09;2021-06-06;179;92;0;63576;36866;0;41.7;24.2;0.0
09;2021-06-07;499;504;0;64075;37370;0;42.0;24.5;0.0
09;2021-06-08;713;489;0;64788;37859;0;42.5;24.8;0.0
09;2021-06-09;581;718;0;65369;38577;0;42.9;25.3;0.0
09;2021-06-10;508;540;0;65877;39117;0;43.2;25.7;0.0
09;2021-06-11;688;705;0;66565;39822;0;43.7;26.1;0.0
09;2021-06-12;429;604;0;66994;40426;0;44.0;26.5;0.0
09;2021-06-13;93;127;0;67087;40553;0;44.0;26.6;0.0
09;2021-06-14;501;661;0;67588;41214;0;44.3;27.0;0.0
09;2021-06-15;699;865;0;68287;42079;0;44.8;27.6;0.0
09;2021-06-16;476;876;0;68763;42955;0;45.1;28.2;0.0
09;2021-06-17;595;691;0;69358;43646;0;45.5;28.6;0.0
09;2021-06-18;524;975;0;69882;44621;0;45.9;29.3;0.0
09;2021-06-19;360;1102;0;70242;45723;0;46.1;30.0;0.0
09;2021-06-20;24;208;0;70266;45931;0;46.1;30.1;0.0
09;2021-06-21;387;611;0;70653;46542;0;46.4;30.5;0.0
09;2021-06-22;377;876;0;71030;47418;0;46.6;31.1;0.0
09;2021-06-23;324;890;0;71354;48308;0;46.8;31.7;0.0
09;2021-06-24;456;620;0;71810;48928;0;47.1;32.1;0.0
09;2021-06-25;370;780;0;72180;49708;0;47.4;32.6;0.0
09;2021-06-26;326;732;0;72506;50440;0;47.6;33.1;0.0
09;2021-06-27;10;154;0;72516;50594;0;47.6;33.2;0.0
09;2021-06-28;204;750;0;72720;51344;0;47.7;33.7;0.0
09;2021-06-29;255;974;0;72975;52318;0;47.9;34.3;0.0
09;2021-06-30;394;1128;0;73369;53446;0;48.1;35.1;0.0
09;2021-07-01;344;1115;0;73713;54561;0;48.4;35.8;0.0
09;2021-07-02;287;822;0;74000;55383;0;48.6;36.3;0.0
09;2021-07-03;175;979;0;74175;56362;0;48.7;37.0;0.0
09;2021-07-04;15;135;0;74190;56497;0;48.7;37.1;0.0
09;2021-07-05;190;559;0;74380;57056;0;48.8;37.4;0.0
09;2021-07-06;269;983;0;74649;58039;0;49.0;38.1;0.0
09;2021-07-07;347;953;0;74996;58992;0;49.2;38.7;0.0
09;2021-07-08;294;814;0;75290;59806;0;49.4;39.2;0.0
09;2021-07-09;287;825;0;75577;60631;0;49.6;39.8;0.0
09;2021-07-10;261;983;0;75838;61614;0;49.8;40.4;0.0
09;2021-07-11;135;231;0;75973;61845;0;49.9;40.6;0.0
09;2021-07-12;169;786;0;76142;62631;0;50.0;41.1;0.0
09;2021-07-13;607;1004;0;76749;63635;0;50.4;41.8;0.0
09;2021-07-14;402;159;0;77151;63794;0;50.6;41.9;0.0
09;2021-07-15;744;848;0;77895;64642;0;51.1;42.4;0.0
09;2021-07-16;560;988;0;78455;65630;0;51.5;43.1;0.0
09;2021-07-17;751;942;0;79206;66572;0;52.0;43.7;0.0
09;2021-07-18;297;183;0;79503;66755;0;52.2;43.8;0.0
09;2021-07-19;450;786;0;79953;67541;0;52.5;44.3;0.0
09;2021-07-20;724;1033;0;80677;68574;0;52.9;45.0;0.0
09;2021-07-21;849;937;0;81526;69511;0;53.5;45.6;0.0
09;2021-07-22;769;762;0;82295;70273;0;54.0;46.1;0.0
09;2021-07-23;679;748;0;82974;71021;0;54.4;46.6;0.0
09;2021-07-24;792;404;0;83766;71425;0;55.0;46.9;0.0
09;2021-07-25;502;129;0;84268;71554;0;55.3;47.0;0.0
09;2021-07-26;563;637;0;84831;72191;0;55.7;47.4;0.0
09;2021-07-27;1001;790;0;85832;72981;0;56.3;47.9;0.0
09;2021-07-28;967;761;0;86799;73742;0;57.0;48.4;0.0
09;2021-07-29;879;599;0;87678;74341;0;57.5;48.8;0.0
09;2021-07-30;688;527;0;88366;74868;0;58.0;49.1;0.0
09;2021-07-31;1116;335;0;89482;75203;0;58.7;49.3;0.0
09;2021-08-01;151;125;0;89633;75328;0;58.8;49.4;0.0
09;2021-08-02;738;418;0;90371;75746;0;59.3;49.7;0.0
09;2021-08-03;1059;686;0;91430;76432;0;60.0;50.2;0.0
09;2021-08-04;1111;525;0;92541;76957;0;60.7;50.5;0.0
09;2021-08-05;803;559;0;93344;77516;0;61.3;50.9;0.0
09;2021-08-06;862;558;0;94206;78074;0;61.8;51.2;0.0
09;2021-08-07;654;348;0;94860;78422;0;62.2;51.5;0.0
09;2021-08-08;122;152;0;94982;78574;0;62.3;51.6;0.0
09;2021-08-09;562;558;0;95544;79132;0;62.7;51.9;0.0
09;2021-08-10;803;619;0;96347;79751;0;63.2;52.3;0.0
09;2021-08-11;720;731;0;97067;80482;0;63.7;52.8;0.0
09;2021-08-12;527;655;0;97594;81137;0;64.0;53.2;0.0
09;2021-08-13;444;574;0;98038;81711;0;64.3;53.6;0.0
09;2021-08-14;282;674;0;98320;82385;0;64.5;54.1;0.0
09;2021-08-15;58;146;0;98378;82531;0;64.6;54.2;0.0
09;2021-08-16;466;553;0;98844;83084;0;64.9;54.5;0.0
09;2021-08-17;601;673;0;99445;83757;0;65.3;55.0;0.0
09;2021-08-18;502;770;0;99947;84527;0;65.6;55.5;0.0
09;2021-08-19;373;602;0;100320;85129;0;65.8;55.9;0.0
09;2021-08-20;338;675;0;100658;85804;0;66.0;56.3;0.0
09;2021-08-21;268;1118;0;100926;86922;0;66.2;57.0;0.0
09;2021-08-22;62;172;0;100988;87094;0;66.3;57.1;0.0
09;2021-08-23;296;684;0;101284;87778;0;66.5;57.6;0.0
09;2021-08-24;356;834;0;101640;88612;0;66.7;58.1;0.0
09;2021-08-25;225;807;0;101865;89419;0;66.8;58.7;0.0
09;2021-08-26;267;813;0;102132;90232;0;67.0;59.2;0.0
09;2021-08-27;224;688;0;102356;90920;0;67.2;59.7;0.0
09;2021-08-28;227;822;0;102583;91742;0;67.3;60.2;0.0
09;2021-08-29;19;138;0;102602;91880;0;67.3;60.3;0.0
09;2021-08-30;244;629;29;102846;92509;29;67.5;60.7;0.0
09;2021-08-31;286;953;69;103132;93462;98;67.7;61.3;0.1
09;2021-09-01;304;641;181;103436;94103;279;67.9;61.7;0.2
09;2021-09-02;153;443;92;103589;94546;371;68.0;62.0;0.2
09;2021-09-03;220;646;122;103809;95192;493;68.1;62.5;0.3
09;2021-09-04;142;416;58;103951;95608;551;68.2;62.7;0.4
09;2021-09-05;23;77;22;103974;95685;573;68.2;62.8;0.4
09;2021-09-06;165;457;121;104139;96142;694;68.3;63.1;0.5
09;2021-09-07;142;494;139;104281;96636;833;68.4;63.4;0.5
09;2021-09-08;178;696;81;104459;97332;914;68.5;63.9;0.6
09;2021-09-09;151;357;110;104610;97689;1024;68.6;64.1;0.7
09;2021-09-10;126;399;41;104736;98088;1065;68.7;64.4;0.7
09;2021-09-11;114;318;75;104850;98406;1140;68.8;64.6;0.7
09;2021-09-12;18;64;8;104868;98470;1148;68.8;64.6;0.8
09;2021-09-13;133;508;131;105001;98978;1279;68.9;64.9;0.8
09;2021-09-14;142;442;161;105143;99420;1440;69.0;65.2;0.9
09;2021-09-15;168;486;124;105311;99906;1564;69.1;65.6;1.0
09;2021-09-16;119;299;170;105430;100205;1734;69.2;65.8;1.1
09;2021-09-17;153;379;115;105583;100584;1849;69.3;66.0;1.2
09;2021-09-18;111;278;72;105694;100862;1921;69.4;66.2;1.3
09;2021-09-19;1;11;0;105695;100873;1921;69.4;66.2;1.3
09;2021-09-20;63;247;124;105758;101120;2045;69.4;66.4;1.3
09;2021-09-21;86;205;127;105844;101325;2172;69.5;66.5;1.4
09;2021-09-22;144;413;120;105988;101738;2292;69.5;66.8;1.5
09;2021-09-23;73;157;116;106061;101895;2408;69.6;66.9;1.6
09;2021-09-24;110;264;97;106171;102159;2505;69.7;67.0;1.6
09;2021-09-25;38;161;42;106209;102320;2547;69.7;67.1;1.7
09;2021-09-26;1;16;3;106210;102336;2550;69.7;67.2;1.7
09;2021-09-27;66;288;88;106276;102624;2638;69.7;67.3;1.7
09;2021-09-28;76;156;152;106352;102780;2790;69.8;67.4;1.8
09;2021-09-29;82;212;89;106434;102992;2879;69.8;67.6;1.9
09;2021-09-30;44;120;286;106478;103112;3165;69.9;67.7;2.1
09;2021-10-01;89;129;89;106567;103241;3254;69.9;67.7;2.1
09;2021-10-02;61;157;56;106628;103398;3310;70.0;67.8;2.2
09;2021-10-03;1;9;0;106629;103407;3310;70.0;67.9;2.2
09;2021-10-04;67;99;134;106696;103506;3444;70.0;67.9;2.3
09;2021-10-05;60;127;212;106756;103633;3656;70.1;68.0;2.4
09;2021-10-06;117;194;186;106873;103827;3842;70.1;68.1;2.5
09;2021-10-07;60;124;201;106933;103951;4043;70.2;68.2;2.7
09;2021-10-08;103;186;143;107036;104137;4186;70.2;68.3;2.7
09;2021-10-09;46;102;62;107082;104239;4248;70.3;68.4;2.8
09;2021-10-10;0;7;9;107082;104246;4257;70.3;68.4;2.8
09;2021-10-11;59;99;150;107141;104345;4407;70.3;68.5;2.9
09;2021-10-12;51;74;152;107192;104419;4559;70.3;68.5;3.0
09;2021-10-13;86;151;181;107278;104570;4740;70.4;68.6;3.1
09;2021-10-14;51;94;142;107329;104664;4882;70.4;68.7;3.2
09;2021-10-15;73;121;212;107402;104785;5094;70.5;68.8;3.3
09;2021-10-16;66;61;104;107468;104846;5198;70.5;68.8;3.4
09;2021-10-17;3;3;7;107471;104849;5205;70.5;68.8;3.4
09;2021-10-18;44;108;175;107515;104957;5380;70.5;68.9;3.5
09;2021-10-19;50;83;135;107565;105040;5515;70.6;68.9;3.6
09;2021-10-20;79;134;265;107644;105174;5780;70.6;69.0;3.8
09;2021-10-21;54;89;158;107698;105263;5938;70.7;69.1;3.9
09;2021-10-22;51;87;177;107749;105350;6115;70.7;69.1;4.0
09;2021-10-23;42;64;176;107791;105414;6291;70.7;69.2;4.1
09;2021-10-24;0;0;17;107791;105414;6308;70.7;69.2;4.1
09;2021-10-25;43;63;225;107834;105477;6533;70.8;69.2;4.3
09;2021-10-26;44;55;196;107878;105532;6729;70.8;69.2;4.4
09;2021-10-27;57;137;289;107935;105669;7018;70.8;69.3;4.6
09;2021-10-28;61;64;274;107996;105733;7292;70.9;69.4;4.8
09;2021-10-29;72;135;269;108068;105868;7561;70.9;69.5;5.0
09;2021-10-30;27;34;85;108095;105902;7646;70.9;69.5;5.0
09;2021-10-31;1;5;0;108096;105907;7646;70.9;69.5;5.0
09;2021-11-01;9;30;32;108105;105937;7678;70.9;69.5;5.0
09;2021-11-02;41;53;190;108146;105990;7868;71.0;69.5;5.2
09;2021-11-03;60;91;350;108206;106081;8218;71.0;69.6;5.4
09;2021-11-04;49;77;350;108255;106158;8568;71.0;69.7;5.6
09;2021-11-05;61;104;371;108316;106262;8939;71.1;69.7;5.9
09;2021-11-06;58;59;286;108374;106321;9225;71.1;69.8;6.1
09;2021-11-07;5;7;23;108379;106328;9248;71.1;69.8;6.1
09;2021-11-08;44;53;320;108423;106381;9568;71.1;69.8;6.3
09;2021-11-09;61;66;500;108484;106447;10068;71.2;69.8;6.6
09;2021-11-10;65;87;490;108549;106534;10558;71.2;69.9;6.9
09;2021-11-11;6;6;78;108555;106540;10636;71.2;69.9;7.0
09;2021-11-12;47;63;445;108602;106603;11081;71.3;70.0;7.3
09;2021-11-13;24;39;199;108626;106642;11280;71.3;70.0;7.4
09;2021-11-14;0;3;2;108626;106645;11282;71.3;70.0;7.4
09;2021-11-15;37;55;431;108663;106700;11713;71.3;70.0;7.7
09;2021-11-16;33;47;534;108696;106747;12247;71.3;70.0;8.0
09;2021-11-17;70;59;623;108766;106806;12870;71.4;70.1;8.4
09;2021-11-18;33;62;607;108799;106868;13477;71.4;70.1;8.8
09;2021-11-19;56;53;618;108855;106921;14095;71.4;70.2;9.2
09;2021-11-20;61;44;307;108916;106965;14402;71.5;70.2;9.5
09;2021-11-21;0;3;5;108916;106968;14407;71.5;70.2;9.5
09;2021-11-22;47;71;524;108963;107039;14931;71.5;70.2;9.8
09;2021-11-23;77;46;606;109040;107085;15537;71.5;70.3;10.2
09;2021-11-24;60;82;576;109100;107167;16113;71.6;70.3;10.6
09;2021-11-25;59;55;734;109159;107222;16847;71.6;70.4;11.1
09;2021-11-26;81;79;791;109240;107301;17638;71.7;70.4;11.6
09;2021-11-27;44;40;360;109284;107341;17998;71.7;70.4;11.8
09;2021-11-28;3;3;32;109287;107344;18030;71.7;70.4;11.8
09;2021-11-29;56;49;683;109343;107393;18713;71.7;70.5;12.3
09;2021-11-30;75;67;1160;109418;107460;19873;71.8;70.5;13.0
09;2021-12-01;38;56;983;109456;107516;20856;71.8;70.5;13.7
09;2021-12-02;65;46;1301;109521;107562;22157;71.9;70.6;14.5
09;2021-12-03;55;45;1148;109576;107607;23305;71.9;70.6;15.3
09;2021-12-04;43;41;465;109619;107648;23770;71.9;70.6;15.6
09;2021-12-05;2;4;195;109621;107652;23965;71.9;70.6;15.7
09;2021-12-06;39;44;903;109660;107696;24868;72.0;70.7;16.3
09;2021-12-07;53;43;1452;109713;107739;26320;72.0;70.7;17.3
09;2021-12-08;81;64;1334;109794;107803;27654;72.0;70.7;18.1
09;2021-12-09;73;62;1549;109867;107865;29203;72.1;70.8;19.2
09;2021-12-10;59;58;1615;109926;107923;30818;72.1;70.8;20.2
09;2021-12-11;71;30;1602;109997;107953;32420;72.2;70.8;21.3
09;2021-12-12;5;13;799;110002;107966;33219;72.2;70.8;21.8
09;2021-12-13;47;61;1159;110049;108027;34378;72.2;70.9;22.6
09;2021-12-14;68;81;1611;110117;108108;35989;72.3;70.9;23.6
09;2021-12-15;81;93;1466;110198;108201;37455;72.3;71.0;24.6
09;2021-12-16;83;67;1905;110281;108268;39360;72.4;71.0;25.8
10;2020-12-27;0;0;0;0;0;0;0.0;0.0;0.0
10;2020-12-28;0;0;0;0;0;0;0.0;0.0;0.0
10;2020-12-29;0;0;0;0;0;0;0.0;0.0;0.0
10;2020-12-30;0;0;0;0;0;0;0.0;0.0;0.0
10;2020-12-31;0;0;0;0;0;0;0.0;0.0;0.0
10;2021-01-01;0;0;0;0;0;0;0.0;0.0;0.0
10;2021-01-02;1;0;0;1;0;0;0.0;0.0;0.0
10;2021-01-03;0;0;0;1;0;0;0.0;0.0;0.0
10;2021-01-04;0;0;0;1;0;0;0.0;0.0;0.0
10;2021-01-05;2;0;0;3;0;0;0.0;0.0;0.0
10;2021-01-06;1;0;0;4;0;0;0.0;0.0;0.0
10;2021-01-07;77;0;0;81;0;0;0.0;0.0;0.0
10;2021-01-08;237;0;0;318;0;0;0.1;0.0;0.0
10;2021-01-09;2;0;0;320;0;0;0.1;0.0;0.0
10;2021-01-10;1;0;0;321;0;0;0.1;0.0;0.0
10;2021-01-11;112;0;0;433;0;0;0.1;0.0;0.0
10;2021-01-12;182;0;0;615;0;0;0.2;0.0;0.0
10;2021-01-13;306;1;0;921;1;0;0.3;0.0;0.0
10;2021-01-14;368;9;0;1289;10;0;0.4;0.0;0.0
10;2021-01-15;367;3;0;1656;13;0;0.5;0.0;0.0
10;2021-01-16;56;0;0;1712;13;0;0.6;0.0;0.0
10;2021-01-17;0;0;0;1712;13;0;0.6;0.0;0.0
10;2021-01-18;625;3;0;2337;16;0;0.8;0.0;0.0
10;2021-01-19;1317;6;0;3654;22;0;1.2;0.0;0.0
10;2021-01-20;1093;8;0;4747;30;0;1.5;0.0;0.0
10;2021-01-21;1119;2;0;5866;32;0;1.9;0.0;0.0
10;2021-01-22;778;2;0;6644;34;0;2.1;0.0;0.0
10;2021-01-23;313;0;0;6957;34;0;2.2;0.0;0.0
10;2021-01-24;0;0;0;6957;34;0;2.2;0.0;0.0
10;2021-01-25;446;7;0;7403;41;0;2.4;0.0;0.0
10;2021-01-26;492;14;0;7895;55;0;2.5;0.0;0.0
10;2021-01-27;454;15;0;8349;70;0;2.7;0.0;0.0
10;2021-01-28;362;47;0;8711;117;0;2.8;0.0;0.0
10;2021-01-29;417;177;0;9128;294;0;2.9;0.1;0.0
10;2021-01-30;33;0;0;9161;294;0;3.0;0.1;0.0
10;2021-01-31;0;0;0;9161;294;0;3.0;0.1;0.0
10;2021-02-01;397;139;0;9558;433;0;3.1;0.1;0.0
10;2021-02-02;183;147;0;9741;580;0;3.1;0.2;0.0
10;2021-02-03;351;187;0;10092;767;0;3.3;0.2;0.0
10;2021-02-04;342;249;0;10434;1016;0;3.4;0.3;0.0
10;2021-02-05;309;308;0;10743;1324;0;3.5;0.4;0.0
10;2021-02-06;6;37;0;10749;1361;0;3.5;0.4;0.0
10;2021-02-07;0;0;0;10749;1361;0;3.5;0.4;0.0
10;2021-02-08;179;392;0;10928;1753;0;3.5;0.6;0.0
10;2021-02-09;454;574;0;11382;2327;0;3.7;0.8;0.0
10;2021-02-10;631;491;0;12013;2818;0;3.9;0.9;0.0
10;2021-02-11;729;577;0;12742;3395;0;4.1;1.1;0.0
10;2021-02-12;570;501;0;13312;3896;0;4.3;1.3;0.0
10;2021-02-13;34;113;0;13346;4009;0;4.3;1.3;0.0
10;2021-02-14;3;2;0;13349;4011;0;4.3;1.3;0.0
10;2021-02-15;137;444;0;13486;4455;0;4.4;1.4;0.0
10;2021-02-16;111;544;0;13597;4999;0;4.4;1.6;0.0
10;2021-02-17;138;599;0;13735;5598;0;4.4;1.8;0.0
10;2021-02-18;213;557;0;13948;6155;0;4.5;2.0;0.0
10;2021-02-19;190;450;0;14138;6605;0;4.6;2.1;0.0
10;2021-02-20;24;193;0;14162;6798;0;4.6;2.2;0.0
10;2021-02-21;0;0;0;14162;6798;0;4.6;2.2;0.0
10;2021-02-22;83;445;0;14245;7243;0;4.6;2.3;0.0
10;2021-02-23;86;553;0;14331;7796;0;4.6;2.5;0.0
10;2021-02-24;125;376;0;14456;8172;0;4.7;2.6;0.0
10;2021-02-25;340;379;0;14796;8551;0;4.8;2.8;0.0
10;2021-02-26;349;282;0;15145;8833;0;4.9;2.9;0.0
10;2021-02-27;255;124;0;15400;8957;0;5.0;2.9;0.0
10;2021-02-28;0;1;0;15400;8958;0;5.0;2.9;0.0
10;2021-03-01;258;323;0;15658;9281;0;5.1;3.0;0.0
10;2021-03-02;437;352;0;16095;9633;0;5.2;3.1;0.0
10;2021-03-03;465;571;0;16560;10204;0;5.3;3.3;0.0
10;2021-03-04;588;470;0;17148;10674;0;5.5;3.4;0.0
10;2021-03-05;679;270;0;17827;10944;0;5.8;3.5;0.0
10;2021-03-06;922;44;0;18749;10988;0;6.0;3.5;0.0
10;2021-03-07;744;6;0;19493;10994;0;6.3;3.5;0.0
10;2021-03-08;507;434;0;20000;11428;0;6.5;3.7;0.0
10;2021-03-09;644;399;0;20644;11827;0;6.7;3.8;0.0
10;2021-03-10;655;359;0;21299;12186;0;6.9;3.9;0.0
10;2021-03-11;1122;225;0;22421;12411;0;7.2;4.0;0.0
10;2021-03-12;1275;246;0;23696;12657;0;7.6;4.1;0.0
10;2021-03-13;882;34;0;24578;12691;0;7.9;4.1;0.0
10;2021-03-14;1326;20;0;25904;12711;0;8.4;4.1;0.0
10;2021-03-15;809;76;0;26713;12787;0;8.6;4.1;0.0
10;2021-03-16;681;64;0;27394;12851;0;8.8;4.1;0.0
10;2021-03-17;771;67;0;28165;12918;0;9.1;4.2;0.0
10;2021-03-18;832;74;0;28997;12992;0;9.4;4.2;0.0
10;2021-03-19;916;76;0;29913;13068;0;9.7;4.2;0.0
10;2021-03-20;536;16;0;30449;13084;0;9.8;4.2;0.0
10;2021-03-21;1767;43;0;32216;13127;0;10.4;4.2;0.0
10;2021-03-22;816;71;0;33032;13198;0;10.7;4.3;0.0
10;2021-03-23;1181;93;0;34213;13291;0;11.0;4.3;0.0
10;2021-03-24;1271;62;0;35484;13353;0;11.4;4.3;0.0
10;2021-03-25;1605;211;0;37089;13564;0;12.0;4.4;0.0
10;2021-03-26;1380;121;0;38469;13685;0;12.4;4.4;0.0
10;2021-03-27;781;75;0;39250;13760;0;12.7;4.4;0.0
10;2021-03-28;1197;29;0;40447;13789;0;13.1;4.4;0.0
10;2021-03-29;652;304;0;41099;14093;0;13.3;4.5;0.0
10;2021-03-30;916;372;0;42015;14465;0;13.6;4.7;0.0
10;2021-03-31;625;360;0;42640;14825;0;13.8;4.8;0.0
10;2021-04-01;896;667;0;43536;15492;0;14.0;5.0;0.0
10;2021-04-02;1077;582;0;44613;16074;0;14.4;5.2;0.0
10;2021-04-03;560;554;0;45173;16628;0;14.6;5.4;0.0
10;2021-04-04;1746;248;0;46919;16876;0;15.1;5.4;0.0
10;2021-04-05;1731;43;0;48650;16919;0;15.7;5.5;0.0
10;2021-04-06;525;627;0;49175;17546;0;15.9;5.7;0.0
10;2021-04-07;580;524;0;49755;18070;0;16.1;5.8;0.0
10;2021-04-08;1057;582;0;50812;18652;0;16.4;6.0;0.0
10;2021-04-09;1143;584;0;51955;19236;0;16.8;6.2;0.0
10;2021-04-10;1726;344;0;53681;19580;0;17.3;6.3;0.0
10;2021-04-11;70;1224;0;53751;20804;0;17.3;6.7;0.0
10;2021-04-12;984;782;0;54735;21586;0;17.7;7.0;0.0
10;2021-04-13;1460;869;0;56195;22455;0;18.1;7.2;0.0
10;2021-04-14;850;597;0;57045;23052;0;18.4;7.4;0.0
10;2021-04-15;1415;846;0;58460;23898;0;18.9;7.7;0.0
10;2021-04-16;1106;678;0;59566;24576;0;19.2;7.9;0.0
10;2021-04-17;2233;353;0;61799;24929;0;19.9;8.0;0.0
10;2021-04-18;1336;1713;0;63135;26642;0;20.4;8.6;0.0
10;2021-04-19;828;774;0;63963;27416;0;20.6;8.8;0.0
10;2021-04-20;557;951;0;64520;28367;0;20.8;9.2;0.0
10;2021-04-21;614;968;0;65134;29335;0;21.0;9.5;0.0
10;2021-04-22;890;942;0;66024;30277;0;21.3;9.8;0.0
10;2021-04-23;2023;755;0;68047;31032;0;22.0;10.0;0.0
10;2021-04-24;2091;400;0;70138;31432;0;22.6;10.1;0.0
10;2021-04-25;1867;1178;0;72005;32610;0;23.2;10.5;0.0
10;2021-04-26;714;636;0;72719;33246;0;23.5;10.7;0.0
10;2021-04-27;850;544;0;73569;33790;0;23.7;10.9;0.0
10;2021-04-28;861;400;0;74430;34190;0;24.0;11.0;0.0
10;2021-04-29;1435;676;0;75865;34866;0;24.5;11.3;0.0
10;2021-04-30;2083;785;0;77948;35651;0;25.2;11.5;0.0
10;2021-05-01;1847;2039;0;79795;37690;0;25.7;12.2;0.0
10;2021-05-02;1833;1810;0;81628;39500;0;26.3;12.7;0.0
10;2021-05-03;566;476;0;82194;39976;0;26.5;12.9;0.0
10;2021-05-04;1077;1241;0;83271;41217;0;26.9;13.3;0.0
10;2021-05-05;1707;1005;0;84978;42222;0;27.4;13.6;0.0
10;2021-05-06;2195;952;0;87173;43174;0;28.1;13.9;0.0
10;2021-05-07;2152;1104;0;89325;44278;0;28.8;14.3;0.0
10;2021-05-08;2165;892;0;91490;45170;0;29.5;14.6;0.0
10;2021-05-09;1884;106;0;93374;45276;0;30.1;14.6;0.0
10;2021-05-10;534;1092;0;93908;46368;0;30.3;15.0;0.0
10;2021-05-11;1056;1029;0;94964;47397;0;30.6;15.3;0.0
10;2021-05-12;1963;869;0;96927;48266;0;31.3;15.6;0.0
10;2021-05-13;2077;419;0;99004;48685;0;31.9;15.7;0.0
10;2021-05-14;2514;643;0;101518;49328;0;32.8;15.9;0.0
10;2021-05-15;2247;1901;0;103765;51229;0;33.5;16.5;0.0
10;2021-05-16;1885;1350;0;105650;52579;0;34.1;17.0;0.0
10;2021-05-17;1420;445;0;107070;53024;0;34.5;17.1;0.0
10;2021-05-18;2384;594;0;109454;53618;0;35.3;17.3;0.0
10;2021-05-19;1515;630;0;110969;54248;0;35.8;17.5;0.0
10;2021-05-20;1783;820;0;112752;55068;0;36.4;17.8;0.0
10;2021-05-21;2174;609;0;114926;55677;0;37.1;18.0;0.0
10;2021-05-22;2017;408;0;116943;56085;0;37.7;18.1;0.0
10;2021-05-23;1550;125;0;118493;56210;0;38.2;18.1;0.0
10;2021-05-24;1689;162;0;120182;56372;0;38.8;18.2;0.0
10;2021-05-25;1750;486;0;121932;56858;0;39.3;18.3;0.0
10;2021-05-26;1492;416;0;123424;57274;0;39.8;18.5;0.0
10;2021-05-27;1515;725;0;124939;57999;0;40.3;18.7;0.0
10;2021-05-28;1580;1143;0;126519;59142;0;40.8;19.1;0.0
10;2021-05-29;1849;615;0;128368;59757;0;41.4;19.3;0.0
10;2021-05-30;893;126;0;129261;59883;0;41.7;19.3;0.0
10;2021-05-31;1014;744;0;130275;60627;0;42.0;19.6;0.0
10;2021-06-01;1120;859;0;131395;61486;0;42.4;19.8;0.0
10;2021-06-02;1020;698;0;132415;62184;0;42.7;20.1;0.0
10;2021-06-03;1364;1028;0;133779;63212;0;43.2;20.4;0.0
10;2021-06-04;1726;2469;0;135505;65681;0;43.7;21.2;0.0
10;2021-06-05;1362;2259;0;136867;67940;0;44.2;21.9;0.0
10;2021-06-06;930;1741;0;137797;69681;0;44.5;22.5;0.0
10;2021-06-07;722;1087;0;138519;70768;0;44.7;22.8;0.0
10;2021-06-08;910;1108;0;139429;71876;0;45.0;23.2;0.0
10;2021-06-09;878;922;0;140307;72798;0;45.3;23.5;0.0
10;2021-06-10;724;1006;0;141031;73804;0;45.5;23.8;0.0
10;2021-06-11;1180;2115;0;142211;75919;0;45.9;24.5;0.0
10;2021-06-12;861;2259;0;143072;78178;0;46.2;25.2;0.0
10;2021-06-13;378;1724;0;143450;79902;0;46.3;25.8;0.0
10;2021-06-14;551;713;0;144001;80615;0;46.5;26.0;0.0
10;2021-06-15;735;2035;0;144736;82650;0;46.7;26.7;0.0
10;2021-06-16;765;1844;0;145501;84494;0;46.9;27.3;0.0
10;2021-06-17;856;2357;0;146357;86851;0;47.2;28.0;0.0
10;2021-06-18;1042;2471;0;147399;89322;0;47.6;28.8;0.0
10;2021-06-19;982;2423;0;148381;91745;0;47.9;29.6;0.0
10;2021-06-20;518;1491;0;148899;93236;0;48.0;30.1;0.0
10;2021-06-21;651;1030;0;149550;94266;0;48.3;30.4;0.0
10;2021-06-22;704;1500;0;150254;95766;0;48.5;30.9;0.0
10;2021-06-23;673;2300;0;150927;98066;0;48.7;31.6;0.0
10;2021-06-24;789;2474;0;151716;100540;0;49.0;32.4;0.0
10;2021-06-25;720;2873;0;152436;103413;0;49.2;33.4;0.0
10;2021-06-26;504;2523;0;152940;105936;0;49.4;34.2;0.0
10;2021-06-27;405;1787;0;153345;107723;0;49.5;34.8;0.0
10;2021-06-28;632;1660;0;153977;109383;0;49.7;35.3;0.0
10;2021-06-29;618;2536;0;154595;111919;0;49.9;36.1;0.0
10;2021-06-30;574;1540;0;155169;113459;0;50.1;36.6;0.0
10;2021-07-01;580;2026;0;155749;115485;0;50.3;37.3;0.0
10;2021-07-02;704;2580;0;156453;118065;0;50.5;38.1;0.0
10;2021-07-03;528;2391;0;156981;120456;0;50.7;38.9;0.0
10;2021-07-04;400;1526;0;157381;121982;0;50.8;39.4;0.0
10;2021-07-05;665;2044;1;158046;124026;1;51.0;40.0;0.0
10;2021-07-06;675;1900;4;158721;125926;5;51.2;40.6;0.0
10;2021-07-07;660;1634;1;159381;127560;6;51.4;41.2;0.0
10;2021-07-08;750;1423;0;160131;128983;6;51.7;41.6;0.0
10;2021-07-09;812;1896;0;160943;130879;6;51.9;42.2;0.0
10;2021-07-10;638;1872;0;161581;132751;6;52.1;42.8;0.0
10;2021-07-11;491;1258;0;162072;134009;6;52.3;43.2;0.0
10;2021-07-12;774;1587;0;162846;135596;6;52.5;43.8;0.0
10;2021-07-13;1124;1834;0;163970;137430;6;52.9;44.3;0.0
10;2021-07-14;1161;1036;0;165131;138466;6;53.3;44.7;0.0
10;2021-07-15;1437;1994;0;166568;140460;6;53.7;45.3;0.0
10;2021-07-16;1304;2200;0;167872;142660;6;54.2;46.0;0.0
10;2021-07-17;1225;1641;0;169097;144301;6;54.6;46.6;0.0
10;2021-07-18;918;1167;0;170015;145468;6;54.9;46.9;0.0
10;2021-07-19;1360;1600;0;171375;147068;6;55.3;47.5;0.0
10;2021-07-20;1688;1470;0;173063;148538;6;55.8;47.9;0.0
10;2021-07-21;1452;1504;0;174515;150042;6;56.3;48.4;0.0
10;2021-07-22;1924;1599;0;176439;151641;6;56.9;48.9;0.0
10;2021-07-23;1697;1581;0;178136;153222;6;57.5;49.4;0.0
10;2021-07-24;1371;1239;0;179507;154461;6;57.9;49.8;0.0
10;2021-07-25;1224;763;0;180731;155224;6;58.3;50.1;0.0
10;2021-07-26;1808;1309;0;182539;156533;6;58.9;50.5;0.0
10;2021-07-27;2097;1080;0;184636;157613;6;59.6;50.9;0.0
10;2021-07-28;2130;1032;0;186766;158645;6;60.3;51.2;0.0
10;2021-07-29;2299;1161;0;189065;159806;6;61.0;51.6;0.0
10;2021-07-30;2155;1259;0;191220;161065;6;61.7;52.0;0.0
10;2021-07-31;1585;950;0;192805;162015;6;62.2;52.3;0.0
10;2021-08-01;1204;562;0;194009;162577;6;62.6;52.5;0.0
10;2021-08-02;1383;1284;0;195392;163861;6;63.0;52.9;0.0
10;2021-08-03;1523;920;0;196915;164781;6;63.5;53.2;0.0
10;2021-08-04;1307;1071;0;198222;165852;6;64.0;53.5;0.0
10;2021-08-05;1568;1278;0;199790;167130;6;64.5;53.9;0.0
10;2021-08-06;1736;1348;0;201526;168478;6;65.0;54.4;0.0
10;2021-08-07;1107;1082;0;202633;169560;6;65.4;54.7;0.0
10;2021-08-08;637;716;0;203270;170276;6;65.6;54.9;0.0
10;2021-08-09;1265;1454;0;204535;171730;6;66.0;55.4;0.0
10;2021-08-10;1532;1359;0;206067;173089;6;66.5;55.9;0.0
10;2021-08-11;828;1128;0;206895;174217;6;66.8;56.2;0.0
10;2021-08-12;997;1274;0;207892;175491;6;67.1;56.6;0.0
10;2021-08-13;742;1157;0;208634;176648;6;67.3;57.0;0.0
10;2021-08-14;587;1198;0;209221;177846;6;67.5;57.4;0.0
10;2021-08-15;271;771;0;209492;178617;6;67.6;57.6;0.0
10;2021-08-16;662;1588;0;210154;180205;6;67.8;58.1;0.0
10;2021-08-17;769;1729;0;210923;181934;6;68.1;58.7;0.0
10;2021-08-18;702;1612;0;211625;183546;6;68.3;59.2;0.0
10;2021-08-19;530;1543;0;212155;185089;6;68.5;59.7;0.0
10;2021-08-20;585;1765;0;212740;186854;6;68.6;60.3;0.0
10;2021-08-21;439;1410;0;213179;188264;6;68.8;60.7;0.0
10;2021-08-22;199;1011;0;213378;189275;6;68.9;61.1;0.0
10;2021-08-23;475;1603;0;213853;190878;6;69.0;61.6;0.0
10;2021-08-24;617;1721;0;214470;192599;6;69.2;62.1;0.0
10;2021-08-25;473;1389;0;214943;193988;6;69.4;62.6;0.0
10;2021-08-26;437;1511;0;215380;195499;6;69.5;63.1;0.0
10;2021-08-27;589;1636;0;215969;197135;6;69.7;63.6;0.0
10;2021-08-28;383;1306;0;216352;198441;6;69.8;64.0;0.0
10;2021-08-29;222;910;0;216574;199351;6;69.9;64.3;0.0
10;2021-08-30;416;1423;15;216990;200774;21;70.0;64.8;0.0
10;2021-08-31;471;1400;24;217461;202174;45;70.2;65.2;0.0
10;2021-09-01;335;1111;100;217796;203285;145;70.3;65.6;0.0
10;2021-09-02;282;937;177;218078;204222;322;70.4;65.9;0.1
10;2021-09-03;430;1074;158;218508;205296;480;70.5;66.2;0.2
10;2021-09-04;332;1023;83;218840;206319;563;70.6;66.6;0.2
10;2021-09-05;161;360;56;219001;206679;619;70.7;66.7;0.2
10;2021-09-06;255;585;166;219256;207264;785;70.7;66.9;0.3
10;2021-09-07;309;581;161;219565;207845;946;70.8;67.1;0.3
10;2021-09-08;272;585;121;219837;208430;1067;70.9;67.3;0.3
10;2021-09-09;313;681;219;220150;209111;1286;71.0;67.5;0.4
10;2021-09-10;411;744;149;220561;209855;1435;71.2;67.7;0.5
10;2021-09-11;273;648;88;220834;210503;1523;71.3;67.9;0.5
10;2021-09-12;85;194;20;220919;210697;1543;71.3;68.0;0.5
10;2021-09-13;215;401;215;221134;211098;1758;71.4;68.1;0.6
10;2021-09-14;237;548;426;221371;211646;2184;71.4;68.3;0.7
10;2021-09-15;224;469;308;221595;212115;2492;71.5;68.4;0.8
10;2021-09-16;272;419;335;221867;212534;2827;71.6;68.6;0.9
10;2021-09-17;245;726;242;222112;213260;3069;71.7;68.8;1.0
10;2021-09-18;197;549;71;222309;213809;3140;71.7;69.0;1.0
10;2021-09-19;53;208;34;222362;214017;3174;71.8;69.1;1.0
10;2021-09-20;128;496;242;222490;214513;3416;71.8;69.2;1.1
10;2021-09-21;155;499;237;222645;215012;3653;71.8;69.4;1.2
10;2021-09-22;136;320;195;222781;215332;3848;71.9;69.5;1.2
10;2021-09-23;207;340;279;222988;215672;4127;72.0;69.6;1.3
10;2021-09-24;216;514;250;223204;216186;4377;72.0;69.8;1.4
10;2021-09-25;124;431;80;223328;216617;4457;72.1;69.9;1.4
10;2021-09-26;50;186;24;223378;216803;4481;72.1;70.0;1.4
10;2021-09-27;219;261;216;223597;217064;4697;72.1;70.0;1.5
10;2021-09-28;194;327;381;223791;217391;5078;72.2;70.1;1.6
10;2021-09-29;191;278;204;223982;217669;5282;72.3;70.2;1.7
10;2021-09-30;164;203;225;224146;217872;5507;72.3;70.3;1.8
10;2021-10-01;207;451;276;224353;218323;5783;72.4;70.4;1.9
10;2021-10-02;172;303;140;224525;218626;5923;72.4;70.5;1.9
10;2021-10-03;56;101;25;224581;218727;5948;72.5;70.6;1.9
10;2021-10-04;118;201;250;224699;218928;6198;72.5;70.6;2.0
10;2021-10-05;112;216;353;224811;219144;6551;72.5;70.7;2.1
10;2021-10-06;126;209;195;224937;219353;6746;72.6;70.8;2.2
10;2021-10-07;128;309;365;225065;219662;7111;72.6;70.9;2.3
10;2021-10-08;170;269;307;225235;219931;7418;72.7;71.0;2.4
10;2021-10-09;145;246;147;225380;220177;7565;72.7;71.0;2.4
10;2021-10-10;49;78;67;225429;220255;7632;72.7;71.1;2.5
10;2021-10-11;113;192;306;225542;220447;7938;72.8;71.1;2.6
10;2021-10-12;118;190;399;225660;220637;8337;72.8;71.2;2.7
10;2021-10-13;131;187;375;225791;220824;8712;72.9;71.3;2.8
10;2021-10-14;122;207;456;225913;221031;9168;72.9;71.3;3.0
10;2021-10-15;145;287;437;226058;221318;9605;72.9;71.4;3.1
10;2021-10-16;117;187;153;226175;221505;9758;73.0;71.5;3.1
10;2021-10-17;40;50;32;226215;221555;9790;73.0;71.5;3.2
10;2021-10-18;101;161;423;226316;221716;10213;73.0;71.5;3.3
10;2021-10-19;105;196;461;226421;221912;10674;73.1;71.6;3.4
10;2021-10-20;118;180;489;226539;222092;11163;73.1;71.7;3.6
10;2021-10-21;103;220;616;226642;222312;11779;73.1;71.7;3.8
10;2021-10-22;147;225;486;226789;222537;12265;73.2;71.8;4.0
10;2021-10-23;87;185;282;226876;222722;12547;73.2;71.9;4.0
10;2021-10-24;36;43;70;226912;222765;12617;73.2;71.9;4.1
10;2021-10-25;96;124;453;227008;222889;13070;73.3;71.9;4.2
10;2021-10-26;99;124;562;227107;223013;13632;73.3;72.0;4.4
10;2021-10-27;74;132;421;227181;223145;14053;73.3;72.0;4.5
10;2021-10-28;51;94;454;227232;223239;14507;73.3;72.0;4.7
10;2021-10-29;97;172;442;227329;223411;14949;73.4;72.1;4.8
10;2021-10-30;81;119;205;227410;223530;15154;73.4;72.1;4.9
10;2021-10-31;27;44;127;227437;223574;15281;73.4;72.1;4.9
10;2021-11-01;25;18;34;227462;223592;15315;73.4;72.1;4.9
10;2021-11-02;105;132;602;227567;223724;15917;73.4;72.2;5.1
10;2021-11-03;77;117;641;227644;223841;16558;73.5;72.2;5.3
10;2021-11-04;87;96;777;227731;223937;17335;73.5;72.3;5.6
10;2021-11-05;129;184;703;227860;224121;18038;73.5;72.3;5.8
10;2021-11-06;84;115;389;227944;224236;18427;73.6;72.4;5.9
10;2021-11-07;23;48;170;227967;224284;18597;73.6;72.4;6.0
10;2021-11-08;63;95;719;228030;224379;19316;73.6;72.4;6.2
10;2021-11-09;82;130;973;228112;224509;20289;73.6;72.4;6.5
10;2021-11-10;95;143;819;228207;224652;21108;73.6;72.5;6.8
10;2021-11-11;6;6;39;228213;224658;21147;73.6;72.5;6.8
10;2021-11-12;101;138;719;228314;224796;21866;73.7;72.5;7.1
10;2021-11-13;82;92;663;228396;224888;22529;73.7;72.6;7.3
10;2021-11-14;34;45;260;228430;224933;22789;73.7;72.6;7.4
10;2021-11-15;77;115;933;228507;225048;23722;73.7;72.6;7.7
10;2021-11-16;81;108;1196;228588;225156;24918;73.8;72.7;8.0
10;2021-11-17;99;100;991;228687;225256;25909;73.8;72.7;8.4
10;2021-11-18;62;99;1028;228749;225355;26937;73.8;72.7;8.7
10;2021-11-19;127;147;1058;228876;225502;27995;73.9;72.8;9.0
10;2021-11-20;109;150;963;228985;225652;28958;73.9;72.8;9.3
10;2021-11-21;48;35;250;229033;225687;29208;73.9;72.8;9.4
10;2021-11-22;79;71;832;229112;225758;30040;73.9;72.8;9.7
10;2021-11-23;85;95;1308;229197;225853;31348;74.0;72.9;10.1
10;2021-11-24;106;96;1004;229303;225949;32352;74.0;72.9;10.4
10;2021-11-25;90;72;1246;229393;226021;33598;74.0;72.9;10.8
10;2021-11-26;143;165;1662;229536;226186;35260;74.1;73.0;11.4
10;2021-11-27;131;115;1499;229667;226301;36759;74.1;73.0;11.9
10;2021-11-28;43;32;519;229710;226333;37278;74.1;73.0;12.0
10;2021-11-29;79;86;2082;229789;226419;39360;74.1;73.1;12.7
10;2021-11-30;126;101;2678;229915;226520;42038;74.2;73.1;13.6
10;2021-12-01;96;86;2272;230011;226606;44310;74.2;73.1;14.3
10;2021-12-02;82;60;2838;230093;226666;47148;74.2;73.1;15.2
10;2021-12-03;111;105;2899;230204;226771;50047;74.3;73.2;16.1
10;2021-12-04;106;102;2065;230310;226873;52112;74.3;73.2;16.8
10;2021-12-05;47;41;1165;230357;226914;53277;74.3;73.2;17.2
10;2021-12-06;71;88;2759;230428;227002;56036;74.4;73.2;18.1
10;2021-12-07;95;87;3681;230523;227089;59717;74.4;73.3;19.3
10;2021-12-08;102;105;2682;230625;227194;62399;74.4;73.3;20.1
10;2021-12-09;87;101;3426;230712;227295;65825;74.4;73.3;21.2
10;2021-12-10;87;113;3770;230799;227408;69595;74.5;73.4;22.5
10;2021-12-11;108;120;2777;230907;227528;72372;74.5;73.4;23.4
10;2021-12-12;24;42;1410;230931;227570;73782;74.5;73.4;23.8
10;2021-12-13;76;107;3365;231007;227677;77147;74.5;73.5;24.9
10;2021-12-14;71;105;3829;231078;227782;80976;74.6;73.5;26.1
10;2021-12-15;62;132;3174;231140;227914;84150;74.6;73.5;27.2
10;2021-12-16;85;89;3318;231225;228003;87468;74.6;73.6;28.2
11;2020-12-27;0;0;0;0;0;0;0.0;0.0;0.0
11;2020-12-28;0;0;0;0;0;0;0.0;0.0;0.0
11;2020-12-29;0;0;0;0;0;0;0.0;0.0;0.0
11;2020-12-30;0;0;0;0;0;0;0.0;0.0;0.0
11;2020-12-31;0;0;0;0;0;0;0.0;0.0;0.0
11;2021-01-01;1;0;0;1;0;0;0.0;0.0;0.0
11;2021-01-02;3;0;0;4;0;0;0.0;0.0;0.0
11;2021-01-03;0;0;0;4;0;0;0.0;0.0;0.0
11;2021-01-04;1;0;0;5;0;0;0.0;0.0;0.0
11;2021-01-05;89;1;0;94;1;0;0.0;0.0;0.0
11;2021-01-06;26;0;0;120;1;0;0.0;0.0;0.0
11;2021-01-07;115;0;0;235;1;0;0.1;0.0;0.0
11;2021-01-08;98;1;0;333;2;0;0.1;0.0;0.0
11;2021-01-09;85;0;0;418;2;0;0.1;0.0;0.0
11;2021-01-10;68;0;0;486;2;0;0.1;0.0;0.0
11;2021-01-11;149;0;0;635;2;0;0.2;0.0;0.0
11;2021-01-12;506;3;0;1141;5;0;0.3;0.0;0.0
11;2021-01-13;411;1;0;1552;6;0;0.4;0.0;0.0
11;2021-01-14;612;8;0;2164;14;0;0.6;0.0;0.0
11;2021-01-15;327;3;0;2491;17;0;0.7;0.0;0.0
11;2021-01-16;79;1;0;2570;18;0;0.7;0.0;0.0
11;2021-01-17;49;2;0;2619;20;0;0.7;0.0;0.0
11;2021-01-18;468;1;0;3087;21;0;0.8;0.0;0.0
11;2021-01-19;631;11;0;3718;32;0;1.0;0.0;0.0
11;2021-01-20;777;7;0;4495;39;0;1.2;0.0;0.0
11;2021-01-21;742;5;0;5237;44;0;1.4;0.0;0.0
11;2021-01-22;649;3;0;5886;47;0;1.6;0.0;0.0
11;2021-01-23;253;2;0;6139;49;0;1.6;0.0;0.0
11;2021-01-24;178;2;0;6317;51;0;1.7;0.0;0.0
11;2021-01-25;455;14;0;6772;65;0;1.8;0.0;0.0
11;2021-01-26;922;80;0;7694;145;0;2.1;0.0;0.0
11;2021-01-27;868;25;0;8562;170;0;2.3;0.0;0.0
11;2021-01-28;747;70;0;9309;240;0;2.5;0.1;0.0
11;2021-01-29;559;122;0;9868;362;0;2.6;0.1;0.0
11;2021-01-30;174;8;0;10042;370;0;2.7;0.1;0.0
11;2021-01-31;114;1;0;10156;371;0;2.7;0.1;0.0
11;2021-02-01;408;199;0;10564;570;0;2.8;0.2;0.0
11;2021-02-02;522;384;0;11086;954;0;3.0;0.3;0.0
11;2021-02-03;487;348;0;11573;1302;0;3.1;0.3;0.0
11;2021-02-04;498;488;0;12071;1790;0;3.2;0.5;0.0
11;2021-02-05;429;335;0;12500;2125;0;3.4;0.6;0.0
11;2021-02-06;238;61;0;12738;2186;0;3.4;0.6;0.0
11;2021-02-07;122;21;0;12860;2207;0;3.5;0.6;0.0
11;2021-02-08;377;207;0;13237;2414;0;3.6;0.6;0.0
11;2021-02-09;368;321;0;13605;2735;0;3.7;0.7;0.0
11;2021-02-10;413;451;0;14018;3186;0;3.8;0.9;0.0
11;2021-02-11;581;653;0;14599;3839;0;3.9;1.0;0.0
11;2021-02-12;482;416;0;15081;4255;0;4.0;1.1;0.0
11;2021-02-13;192;146;0;15273;4401;0;4.1;1.2;0.0
11;2021-02-14;73;60;0;15346;4461;0;4.1;1.2;0.0
11;2021-02-15;262;270;0;15608;4731;0;4.2;1.3;0.0
11;2021-02-16;304;555;0;15912;5286;0;4.3;1.4;0.0
11;2021-02-17;467;665;0;16379;5951;0;4.4;1.6;0.0
11;2021-02-18;469;599;0;16848;6550;0;4.5;1.8;0.0
11;2021-02-19;336;564;0;17184;7114;0;4.6;1.9;0.0
11;2021-02-20;153;126;0;17337;7240;0;4.7;1.9;0.0
11;2021-02-21;62;61;0;17399;7301;0;4.7;2.0;0.0
11;2021-02-22;141;403;0;17540;7704;0;4.7;2.1;0.0
11;2021-02-23;311;426;0;17851;8130;0;4.8;2.2;0.0
11;2021-02-24;272;442;0;18123;8572;0;4.9;2.3;0.0
11;2021-02-25;595;464;0;18718;9036;0;5.0;2.4;0.0
11;2021-02-26;591;414;0;19309;9450;0;5.2;2.5;0.0
11;2021-02-27;337;148;0;19646;9598;0;5.3;2.6;0.0
11;2021-02-28;101;54;0;19747;9652;0;5.3;2.6;0.0
11;2021-03-01;344;333;0;20091;9985;0;5.4;2.7;0.0
11;2021-03-02;554;396;0;20645;10381;0;5.5;2.8;0.0
11;2021-03-03;614;430;0;21259;10811;0;5.7;2.9;0.0
11;2021-03-04;1076;403;0;22335;11214;0;6.0;3.0;0.0
11;2021-03-05;1015;426;0;23350;11640;0;6.3;3.1;0.0
11;2021-03-06;1094;201;0;24444;11841;0;6.6;3.2;0.0
11;2021-03-07;708;39;0;25152;11880;0;6.7;3.2;0.0
11;2021-03-08;428;362;0;25580;12242;0;6.9;3.3;0.0
11;2021-03-09;1004;416;0;26584;12658;0;7.1;3.4;0.0
11;2021-03-10;1194;536;0;27778;13194;0;7.5;3.5;0.0
11;2021-03-11;1568;464;0;29346;13658;0;7.9;3.7;0.0
11;2021-03-12;1475;440;0;30821;14098;0;8.3;3.8;0.0
11;2021-03-13;1156;223;0;31977;14321;0;8.6;3.8;0.0
11;2021-03-14;522;54;0;32499;14375;0;8.7;3.9;0.0
11;2021-03-15;706;247;0;33205;14622;0;8.9;3.9;0.0
11;2021-03-16;853;206;0;34058;14828;0;9.1;4.0;0.0
11;2021-03-17;916;231;0;34974;15059;0;9.4;4.0;0.0
11;2021-03-18;1124;307;0;36098;15366;0;9.7;4.1;0.0
11;2021-03-19;1328;245;0;37426;15611;0;10.0;4.2;0.0
11;2021-03-20;766;164;0;38192;15775;0;10.2;4.2;0.0
11;2021-03-21;218;67;0;38410;15842;0;10.3;4.3;0.0
11;2021-03-22;788;241;0;39198;16083;0;10.5;4.3;0.0
11;2021-03-23;1768;389;0;40966;16472;0;11.0;4.4;0.0
11;2021-03-24;1794;324;0;42760;16796;0;11.5;4.5;0.0
11;2021-03-25;2154;343;0;44914;17139;0;12.1;4.6;0.0
11;2021-03-26;2073;447;0;46987;17586;0;12.6;4.7;0.0
11;2021-03-27;1143;152;0;48130;17738;0;12.9;4.8;0.0
11;2021-03-28;255;50;0;48385;17788;0;13.0;4.8;0.0
11;2021-03-29;1155;244;0;49540;18032;0;13.3;4.8;0.0
11;2021-03-30;1986;330;0;51526;18362;0;13.8;4.9;0.0
11;2021-03-31;1621;385;0;53147;18747;0;14.3;5.0;0.0
11;2021-04-01;2123;440;0;55270;19187;0;14.8;5.1;0.0
11;2021-04-02;1627;447;0;56897;19634;0;15.3;5.3;0.0
11;2021-04-03;722;152;0;57619;19786;0;15.5;5.3;0.0
11;2021-04-04;215;80;0;57834;19866;0;15.5;5.3;0.0
11;2021-04-05;272;14;0;58106;19880;0;15.6;5.3;0.0
11;2021-04-06;1633;576;0;59739;20456;0;16.0;5.5;0.0
11;2021-04-07;1818;611;0;61557;21067;0;16.5;5.7;0.0
11;2021-04-08;1909;676;0;63466;21743;0;17.0;5.8;0.0
11;2021-04-09;2327;622;0;65793;22365;0;17.7;6.0;0.0
11;2021-04-10;1168;209;0;66961;22574;0;18.0;6.1;0.0
11;2021-04-11;594;129;0;67555;22703;0;18.1;6.1;0.0
11;2021-04-12;1590;580;0;69145;23283;0;18.6;6.2;0.0
11;2021-04-13;2309;861;0;71454;24144;0;19.2;6.5;0.0
11;2021-04-14;1733;1021;0;73187;25165;0;19.6;6.8;0.0
11;2021-04-15;1941;1094;0;75128;26259;0;20.2;7.0;0.0
11;2021-04-16;1918;844;0;77046;27103;0;20.7;7.3;0.0
11;2021-04-17;1698;541;0;78744;27644;0;21.1;7.4;0.0
11;2021-04-18;166;147;0;78910;27791;0;21.2;7.5;0.0
11;2021-04-19;1368;714;0;80278;28505;0;21.5;7.6;0.0
11;2021-04-20;1697;1229;0;81975;29734;0;22.0;8.0;0.0
11;2021-04-21;1765;1242;0;83740;30976;0;22.5;8.3;0.0
11;2021-04-22;1813;1285;0;85553;32261;0;23.0;8.7;0.0
11;2021-04-23;1986;1199;0;87539;33460;0;23.5;9.0;0.0
11;2021-04-24;1693;434;0;89232;33894;0;23.9;9.1;0.0
11;2021-04-25;697;173;0;89929;34067;0;24.1;9.1;0.0
11;2021-04-26;1354;810;0;91283;34877;0;24.5;9.4;0.0
11;2021-04-27;1840;1499;0;93123;36376;0;25.0;9.8;0.0
11;2021-04-28;1937;1385;0;95060;37761;0;25.5;10.1;0.0
11;2021-04-29;2207;1656;0;97267;39417;0;26.1;10.6;0.0
11;2021-04-30;2098;1402;0;99365;40819;0;26.7;11.0;0.0
11;2021-05-01;1337;359;0;100702;41178;0;27.0;11.0;0.0
11;2021-05-02;649;345;0;101351;41523;0;27.2;11.1;0.0
11;2021-05-03;1544;762;0;102895;42285;0;27.6;11.3;0.0
11;2021-05-04;1905;1526;0;104800;43811;0;28.1;11.8;0.0
11;2021-05-05;1892;1541;0;106692;45352;0;28.6;12.2;0.0
11;2021-05-06;2129;1545;0;108821;46897;0;29.2;12.6;0.0
11;2021-05-07;2086;1608;0;110907;48505;0;29.8;13.0;0.0
11;2021-05-08;919;735;0;111826;49240;0;30.0;13.2;0.0
11;2021-05-09;668;584;0;112494;49824;0;30.2;13.4;0.0
11;2021-05-10;1401;1674;0;113895;51498;0;30.6;13.8;0.0
11;2021-05-11;2163;1935;0;116058;53433;0;31.1;14.3;0.0
11;2021-05-12;2034;1662;0;118092;55095;0;31.7;14.8;0.0
11;2021-05-13;1516;437;0;119608;55532;0;32.1;14.9;0.0
11;2021-05-14;1751;1187;0;121359;56719;0;32.6;15.2;0.0
11;2021-05-15;1311;862;0;122670;57581;0;32.9;15.4;0.0
11;2021-05-16;972;207;0;123642;57788;0;33.2;15.5;0.0
11;2021-05-17;1637;1037;0;125279;58825;0;33.6;15.8;0.0
11;2021-05-18;2149;1179;0;127428;60004;0;34.2;16.1;0.0
11;2021-05-19;2094;1127;0;129522;61131;0;34.8;16.4;0.0
11;2021-05-20;2278;1125;0;131800;62256;0;35.4;16.7;0.0
11;2021-05-21;2500;1125;0;134300;63381;0;36.0;17.0;0.0
11;2021-05-22;1680;659;0;135980;64040;0;36.5;17.2;0.0
11;2021-05-23;863;84;0;136843;64124;0;36.7;17.2;0.0
11;2021-05-24;1494;226;0;138337;64350;0;37.1;17.3;0.0
11;2021-05-25;1926;1355;0;140263;65705;0;37.6;17.6;0.0
11;2021-05-26;2031;1291;0;142294;66996;0;38.2;18.0;0.0
11;2021-05-27;2087;1714;0;144381;68710;0;38.7;18.4;0.0
11;2021-05-28;1813;1874;0;146194;70584;0;39.2;18.9;0.0
11;2021-05-29;1410;1560;0;147604;72144;0;39.6;19.4;0.0
11;2021-05-30;560;418;0;148164;72562;0;39.8;19.5;0.0
11;2021-05-31;1339;1604;0;149503;74166;0;40.1;19.9;0.0
11;2021-06-01;1861;1896;0;151364;76062;0;40.6;20.4;0.0
11;2021-06-02;1750;2107;0;153114;78169;0;41.1;21.0;0.0
11;2021-06-03;2546;2452;0;155660;80621;0;41.8;21.6;0.0
11;2021-06-04;2088;2617;0;157748;83238;0;42.3;22.3;0.0
11;2021-06-05;1503;1837;0;159251;85075;0;42.7;22.8;0.0
11;2021-06-06;811;868;0;160062;85943;0;42.9;23.1;0.0
11;2021-06-07;1493;1729;0;161555;87672;0;43.3;23.5;0.0
11;2021-06-08;1991;1981;0;163546;89653;0;43.9;24.1;0.0
11;2021-06-09;1797;2178;0;165343;91831;0;44.4;24.6;0.0
11;2021-06-10;1790;2330;0;167133;94161;0;44.8;25.3;0.0
11;2021-06-11;1847;2445;0;168980;96606;0;45.3;25.9;0.0
11;2021-06-12;1323;1598;0;170303;98204;0;45.7;26.3;0.0
11;2021-06-13;683;720;0;170986;98924;0;45.9;26.5;0.0
11;2021-06-14;1070;2033;0;172056;100957;0;46.2;27.1;0.0
11;2021-06-15;1357;2643;0;173413;103600;0;46.5;27.8;0.0
11;2021-06-16;1335;2486;0;174748;106086;0;46.9;28.5;0.0
11;2021-06-17;1458;2496;0;176206;108582;0;47.3;29.1;0.0
11;2021-06-18;1514;2527;0;177720;111109;0;47.7;29.8;0.0
11;2021-06-19;1155;1428;0;178875;112537;0;48.0;30.2;0.0
11;2021-06-20;308;644;0;179183;113181;0;48.1;30.4;0.0
11;2021-06-21;802;2175;0;179985;115356;0;48.3;31.0;0.0
11;2021-06-22;1008;2704;0;180993;118060;0;48.6;31.7;0.0
11;2021-06-23;1082;2223;0;182075;120283;0;48.9;32.3;0.0
11;2021-06-24;900;2310;0;182975;122593;0;49.1;32.9;0.0
11;2021-06-25;966;2623;0;183941;125216;0;49.4;33.6;0.0
11;2021-06-26;719;1754;0;184660;126970;0;49.5;34.1;0.0
11;2021-06-27;227;779;0;184887;127749;0;49.6;34.3;0.0
11;2021-06-28;699;2377;0;185586;130126;0;49.8;34.9;0.0
11;2021-06-29;903;2677;0;186489;132803;0;50.0;35.6;0.0
11;2021-06-30;873;2657;0;187362;135460;0;50.3;36.3;0.0
11;2021-07-01;973;2003;0;188335;137463;0;50.5;36.9;0.0
11;2021-07-02;1012;2673;0;189347;140136;0;50.8;37.6;0.0
11;2021-07-03;668;1899;0;190015;142035;0;51.0;38.1;0.0
11;2021-07-04;331;1165;0;190346;143200;0;51.1;38.4;0.0
11;2021-07-05;707;2188;0;191053;145388;0;51.3;39.0;0.0
11;2021-07-06;941;2505;0;191994;147893;0;51.5;39.7;0.0
11;2021-07-07;927;2546;0;192921;150439;0;51.8;40.4;0.0
11;2021-07-08;1171;1929;0;194092;152368;0;52.1;40.9;0.0
11;2021-07-09;856;1851;0;194948;154219;0;52.3;41.4;0.0
11;2021-07-10;394;1318;0;195342;155537;0;52.4;41.7;0.0
11;2021-07-11;328;623;0;195670;156160;0;52.5;41.9;0.0
11;2021-07-12;519;2613;0;196189;158773;0;52.6;42.6;0.0
11;2021-07-13;1387;2972;0;197576;161745;0;53.0;43.4;0.0
11;2021-07-14;353;298;0;197929;162043;0;53.1;43.5;0.0
11;2021-07-15;1577;2885;0;199506;164928;0;53.5;44.3;0.0
11;2021-07-16;1930;2737;0;201436;167665;0;54.0;45.0;0.0
11;2021-07-17;1103;2076;0;202539;169741;0;54.3;45.5;0.0
11;2021-07-18;662;895;0;203201;170636;0;54.5;45.8;0.0
11;2021-07-19;1370;2021;0;204571;172657;0;54.9;46.3;0.0
11;2021-07-20;2021;2329;0;206592;174986;0;55.4;47.0;0.0
11;2021-07-21;2025;2429;0;208617;177415;0;56.0;47.6;0.0
11;2021-07-22;2308;1907;0;210925;179322;0;56.6;48.1;0.0
11;2021-07-23;2188;2231;0;213113;181553;0;57.2;48.7;0.0
11;2021-07-24;1409;1592;0;214522;183145;0;57.6;49.1;0.0
11;2021-07-25;823;683;0;215345;183828;0;57.8;49.3;0.0
11;2021-07-26;1658;1376;0;217003;185204;0;58.2;49.7;0.0
11;2021-07-27;2320;1894;0;219323;187098;0;58.8;50.2;0.0
11;2021-07-28;2452;1848;0;221775;188946;0;59.5;50.7;0.0
11;2021-07-29;2666;1682;0;224441;190628;0;60.2;51.1;0.0
11;2021-07-30;2483;1692;0;226924;192320;0;60.9;51.6;0.0
11;2021-07-31;1894;1032;0;228818;193352;0;61.4;51.9;0.0
11;2021-08-01;997;465;0;229815;193817;0;61.7;52.0;0.0
11;2021-08-02;1584;1015;0;231399;194832;0;62.1;52.3;0.0
11;2021-08-03;2256;1454;0;233655;196286;0;62.7;52.7;0.0
11;2021-08-04;2373;1148;1;236028;197434;1;63.3;53.0;0.0
11;2021-08-05;2188;1234;0;238216;198668;1;63.9;53.3;0.0
11;2021-08-06;2058;1506;0;240274;200174;1;64.5;53.7;0.0
11;2021-08-07;1543;1088;0;241817;201262;1;64.9;54.0;0.0
11;2021-08-08;528;238;0;242345;201500;1;65.0;54.1;0.0
11;2021-08-09;1005;1390;0;243350;202890;1;65.3;54.4;0.0
11;2021-08-10;1618;1787;0;244968;204677;1;65.7;54.9;0.0
11;2021-08-11;1534;1598;0;246502;206275;1;66.1;55.3;0.0
11;2021-08-12;1548;1712;0;248050;207987;1;66.6;55.8;0.0
11;2021-08-13;1203;1579;0;249253;209566;1;66.9;56.2;0.0
11;2021-08-14;897;1497;0;250150;211063;1;67.1;56.6;0.0
11;2021-08-15;129;154;0;250279;211217;1;67.2;56.7;0.0
11;2021-08-16;695;1875;0;250974;213092;1;67.3;57.2;0.0
11;2021-08-17;978;2191;0;251952;215283;1;67.6;57.8;0.0
11;2021-08-18;1011;1928;1;252963;217211;2;67.9;58.3;0.0
11;2021-08-19;936;2192;0;253899;219403;2;68.1;58.9;0.0
11;2021-08-20;919;2183;0;254818;221586;2;68.4;59.5;0.0
11;2021-08-21;512;1725;0;255330;223311;2;68.5;59.9;0.0
11;2021-08-22;164;530;0;255494;223841;2;68.6;60.1;0.0
11;2021-08-23;499;1765;0;255993;225606;2;68.7;60.5;0.0
11;2021-08-24;763;2150;0;256756;227756;2;68.9;61.1;0.0
11;2021-08-25;750;2103;0;257506;229859;2;69.1;61.7;0.0
11;2021-08-26;686;1966;0;258192;231825;2;69.3;62.2;0.0
11;2021-08-27;669;2169;0;258861;233994;2;69.5;62.8;0.0
11;2021-08-28;408;1715;0;259269;235709;2;69.6;63.2;0.0
11;2021-08-29;145;505;0;259414;236214;2;69.6;63.4;0.0
11;2021-08-30;446;1315;21;259860;237529;23;69.7;63.7;0.0
11;2021-08-31;585;1817;84;260445;239346;107;69.9;64.2;0.0
11;2021-09-01;638;1645;99;261083;240991;206;70.1;64.7;0.1
11;2021-09-02;573;1570;181;261656;242561;387;70.2;65.1;0.1
11;2021-09-03;536;1513;174;262192;244074;561;70.3;65.5;0.2
11;2021-09-04;476;1434;82;262668;245508;643;70.5;65.9;0.2
11;2021-09-05;149;220;48;262817;245728;691;70.5;65.9;0.2
11;2021-09-06;309;693;186;263126;246421;877;70.6;66.1;0.2
11;2021-09-07;366;896;225;263492;247317;1102;70.7;66.4;0.3
11;2021-09-08;456;1151;175;263948;248468;1277;70.8;66.7;0.3
11;2021-09-09;389;854;204;264337;249322;1481;70.9;66.9;0.4
11;2021-09-10;404;967;198;264741;250289;1679;71.0;67.2;0.5
11;2021-09-11;380;974;84;265121;251263;1763;71.1;67.4;0.5
11;2021-09-12;65;118;18;265186;251381;1781;71.2;67.4;0.5
11;2021-09-13;241;562;361;265427;251943;2142;71.2;67.6;0.6
11;2021-09-14;361;626;433;265788;252569;2575;71.3;67.8;0.7
11;2021-09-15;373;957;254;266161;253526;2829;71.4;68.0;0.8
11;2021-09-16;321;562;616;266482;254088;3445;71.5;68.2;0.9
11;2021-09-17;317;670;261;266799;254758;3706;71.6;68.4;1.0
11;2021-09-18;293;755;149;267092;255513;3855;71.7;68.6;1.0
11;2021-09-19;63;113;28;267155;255626;3883;71.7;68.6;1.0
11;2021-09-20;163;367;387;267318;255993;4270;71.7;68.7;1.1
11;2021-09-21;272;411;287;267590;256404;4557;71.8;68.8;1.2
11;2021-09-22;213;742;392;267803;257146;4949;71.9;69.0;1.3
11;2021-09-23;183;406;350;267986;257552;5299;71.9;69.1;1.4
11;2021-09-24;251;506;564;268237;258058;5863;72.0;69.2;1.6
11;2021-09-25;227;630;115;268464;258688;5978;72.0;69.4;1.6
11;2021-09-26;36;133;32;268500;258821;6010;72.0;69.4;1.6
11;2021-09-27;123;386;303;268623;259207;6313;72.1;69.5;1.7
11;2021-09-28;212;356;300;268835;259563;6613;72.1;69.6;1.8
11;2021-09-29;233;541;355;269068;260104;6968;72.2;69.8;1.9
11;2021-09-30;189;354;320;269257;260458;7288;72.2;69.9;2.0
11;2021-10-01;257;384;462;269514;260842;7750;72.3;70.0;2.1
11;2021-10-02;221;456;136;269735;261298;7886;72.4;70.1;2.1
11;2021-10-03;6;15;1;269741;261313;7887;72.4;70.1;2.1
11;2021-10-04;157;303;311;269898;261616;8198;72.4;70.2;2.2
11;2021-10-05;182;320;466;270080;261936;8664;72.5;70.3;2.3
11;2021-10-06;259;444;469;270339;262380;9133;72.5;70.4;2.5
11;2021-10-07;163;302;413;270502;262682;9546;72.6;70.5;2.6
11;2021-10-08;245;425;473;270747;263107;10019;72.6;70.6;2.7
11;2021-10-09;150;363;203;270897;263470;10222;72.7;70.7;2.7
11;2021-10-10;9;7;0;270906;263477;10222;72.7;70.7;2.7
11;2021-10-11;138;252;287;271044;263729;10509;72.7;70.8;2.8
11;2021-10-12;154;308;446;271198;264037;10955;72.8;70.8;2.9
11;2021-10-13;218;295;482;271416;264332;11437;72.8;70.9;3.1
11;2021-10-14;180;248;484;271596;264580;11921;72.9;71.0;3.2
11;2021-10-15;250;327;571;271846;264907;12492;72.9;71.1;3.4
11;2021-10-16;187;258;181;272033;265165;12673;73.0;71.1;3.4
11;2021-10-17;17;28;13;272050;265193;12686;73.0;71.2;3.4
11;2021-10-18;110;157;274;272160;265350;12960;73.0;71.2;3.5
11;2021-10-19;113;192;469;272273;265542;13429;73.1;71.2;3.6
11;2021-10-20;208;287;677;272481;265829;14106;73.1;71.3;3.8
11;2021-10-21;101;219;527;272582;266048;14633;73.1;71.4;3.9
11;2021-10-22;205;321;797;272787;266369;15430;73.2;71.5;4.1
11;2021-10-23;171;254;363;272958;266623;15793;73.2;71.5;4.2
11;2021-10-24;13;10;2;272971;266633;15795;73.2;71.5;4.2
11;2021-10-25;141;156;601;273112;266789;16396;73.3;71.6;4.4
11;2021-10-26;100;157;489;273212;266946;16885;73.3;71.6;4.5
11;2021-10-27;170;254;752;273382;267200;17637;73.4;71.7;4.7
11;2021-10-28;125;148;613;273507;267348;18250;73.4;71.7;4.9
11;2021-10-29;110;185;766;273617;267533;19016;73.4;71.8;5.1
11;2021-10-30;112;183;320;273729;267716;19336;73.4;71.8;5.2
11;2021-10-31;11;13;0;273740;267729;19336;73.4;71.8;5.2
11;2021-11-01;8;5;4;273748;267734;19340;73.4;71.8;5.2
11;2021-11-02;113;150;669;273861;267884;20009;73.5;71.9;5.4
11;2021-11-03;179;270;1165;274040;268154;21174;73.5;71.9;5.7
11;2021-11-04;148;153;699;274188;268307;21873;73.6;72.0;5.9
11;2021-11-05;109;198;912;274297;268505;22785;73.6;72.0;6.1
11;2021-11-06;132;223;426;274429;268728;23211;73.6;72.1;6.2
11;2021-11-07;11;17;8;274440;268745;23219;73.6;72.1;6.2
11;2021-11-08;105;136;731;274545;268881;23950;73.7;72.1;6.4
11;2021-11-09;82;139;1122;274627;269020;25072;73.7;72.2;6.7
11;2021-11-10;162;276;1312;274789;269296;26384;73.7;72.3;7.1
11;2021-11-11;8;12;19;274797;269308;26403;73.7;72.3;7.1
11;2021-11-12;106;158;988;274903;269466;27391;73.8;72.3;7.3
11;2021-11-13;88;140;483;274991;269606;27874;73.8;72.3;7.5
11;2021-11-14;9;4;18;275000;269610;27892;73.8;72.3;7.5
11;2021-11-15;59;131;728;275059;269741;28620;73.8;72.4;7.7
11;2021-11-16;111;134;1540;275170;269875;30160;73.8;72.4;8.1
11;2021-11-17;126;218;1572;275296;270093;31732;73.9;72.5;8.5
11;2021-11-18;155;178;1683;275451;270271;33415;73.9;72.5;9.0
11;2021-11-19;150;142;1618;275601;270413;35033;73.9;72.6;9.4
11;2021-11-20;96;160;419;275697;270573;35452;74.0;72.6;9.5
11;2021-11-21;23;17;166;275720;270590;35618;74.0;72.6;9.6
11;2021-11-22;98;85;926;275818;270675;36544;74.0;72.6;9.8
11;2021-11-23;155;112;1759;275973;270787;38303;74.0;72.7;10.3
11;2021-11-24;171;172;1493;276144;270959;39796;74.1;72.7;10.7
11;2021-11-25;162;170;1842;276306;271129;41638;74.1;72.7;11.2
11;2021-11-26;199;176;2373;276505;271305;44011;74.2;72.8;11.8
11;2021-11-27;94;142;1144;276599;271447;45155;74.2;72.8;12.1
11;2021-11-28;18;13;88;276617;271460;45243;74.2;72.8;12.1
11;2021-11-29;91;92;1742;276708;271552;46985;74.2;72.9;12.6
11;2021-11-30;153;147;2888;276861;271699;49873;74.3;72.9;13.4
11;2021-12-01;151;188;2940;277012;271887;52813;74.3;72.9;14.2
11;2021-12-02;102;113;3387;277114;272000;56200;74.4;73.0;15.1
11;2021-12-03;145;159;3720;277259;272159;59920;74.4;73.0;16.1
11;2021-12-04;89;80;1759;277348;272239;61679;74.4;73.0;16.5
11;2021-12-05;14;23;93;277362;272262;61772;74.4;73.1;16.6
11;2021-12-06;80;79;2384;277442;272341;64156;74.4;73.1;17.2
11;2021-12-07;115;169;4030;277557;272510;68186;74.5;73.1;18.3
11;2021-12-08;151;189;4331;277708;272699;72517;74.5;73.2;19.5
11;2021-12-09;135;154;4503;277843;272853;77020;74.5;73.2;20.7
11;2021-12-10;150;169;4683;277993;273022;81703;74.6;73.3;21.9
11;2021-12-11;114;165;2817;278107;273187;84520;74.6;73.3;22.7
11;2021-12-12;23;35;432;278130;273222;84952;74.6;73.3;22.8
11;2021-12-13;94;122;3031;278224;273344;87983;74.6;73.3;23.6
11;2021-12-14;174;166;4610;278398;273510;92593;74.7;73.4;24.8
11;2021-12-15;229;207;4960;278627;273717;97553;74.8;73.4;26.2
11;2021-12-16;177;198;5133;278804;273915;102686;74.8;73.5;27.6
12;2020-12-27;1;0;0;1;0;0;0.0;0.0;0.0
12;2020-12-28;0;0;0;1;0;0;0.0;0.0;0.0
12;2020-12-29;0;0;0;1;0;0;0.0;0.0;0.0
12;2020-12-30;0;0;0;1;0;0;0.0;0.0;0.0
12;2020-12-31;0;0;0;1;0;0;0.0;0.0;0.0
12;2021-01-01;2;0;0;3;0;0;0.0;0.0;0.0
12;2021-01-02;0;0;0;3;0;0;0.0;0.0;0.0
12;2021-01-03;0;0;0;3;0;0;0.0;0.0;0.0
12;2021-01-04;2;0;0;5;0;0;0.0;0.0;0.0
12;2021-01-05;1;0;0;6;0;0;0.0;0.0;0.0
12;2021-01-06;12;1;0;18;1;0;0.0;0.0;0.0
12;2021-01-07;197;0;0;215;1;0;0.1;0.0;0.0
12;2021-01-08;67;0;0;282;1;0;0.1;0.0;0.0
12;2021-01-09;3;0;0;285;1;0;0.1;0.0;0.0
12;2021-01-10;1;0;0;286;1;0;0.1;0.0;0.0
12;2021-01-11;110;1;0;396;2;0;0.1;0.0;0.0
12;2021-01-12;351;1;0;747;3;0;0.3;0.0;0.0
12;2021-01-13;287;0;0;1034;3;0;0.4;0.0;0.0
12;2021-01-14;564;11;0;1598;14;0;0.6;0.0;0.0
12;2021-01-15;374;7;0;1972;21;0;0.7;0.0;0.0
12;2021-01-16;136;1;0;2108;22;0;0.8;0.0;0.0
12;2021-01-17;1;0;0;2109;22;0;0.8;0.0;0.0
12;2021-01-18;410;0;0;2519;22;0;0.9;0.0;0.0
12;2021-01-19;600;4;0;3119;26;0;1.1;0.0;0.0
12;2021-01-20;881;4;0;4000;30;0;1.4;0.0;0.0
12;2021-01-21;764;1;0;4764;31;0;1.7;0.0;0.0
12;2021-01-22;732;1;0;5496;32;0;2.0;0.0;0.0
12;2021-01-23;390;0;0;5886;32;0;2.1;0.0;0.0
12;2021-01-24;2;0;0;5888;32;0;2.1;0.0;0.0
12;2021-01-25;459;0;0;6347;32;0;2.3;0.0;0.0
12;2021-01-26;654;2;0;7001;34;0;2.5;0.0;0.0
12;2021-01-27;1807;38;0;8808;72;0;3.2;0.0;0.0
12;2021-01-28;1856;227;0;10664;299;0;3.8;0.1;0.0
12;2021-01-29;1253;45;0;11917;344;0;4.3;0.1;0.0
12;2021-01-30;374;3;0;12291;347;0;4.4;0.1;0.0
12;2021-01-31;1;0;0;12292;347;0;4.4;0.1;0.0
12;2021-02-01;343;91;0;12635;438;0;4.5;0.2;0.0
12;2021-02-02;459;247;0;13094;685;0;4.7;0.2;0.0
12;2021-02-03;487;168;0;13581;853;0;4.9;0.3;0.0
12;2021-02-04;463;482;0;14044;1335;0;5.0;0.5;0.0
12;2021-02-05;449;184;0;14493;1519;0;5.2;0.5;0.0
12;2021-02-06;202;67;0;14695;1586;0;5.3;0.6;0.0
12;2021-02-07;11;0;0;14706;1586;0;5.3;0.6;0.0
12;2021-02-08;127;291;0;14833;1877;0;5.3;0.7;0.0
12;2021-02-09;206;343;0;15039;2220;0;5.4;0.8;0.0
12;2021-02-10;431;478;0;15470;2698;0;5.6;1.0;0.0
12;2021-02-11;534;367;0;16004;3065;0;5.7;1.1;0.0
12;2021-02-12;569;324;0;16573;3389;0;6.0;1.2;0.0
12;2021-02-13;153;127;0;16726;3516;0;6.0;1.3;0.0
12;2021-02-14;3;1;0;16729;3517;0;6.0;1.3;0.0
12;2021-02-15;174;364;0;16903;3881;0;6.1;1.4;0.0
12;2021-02-16;159;498;0;17062;4379;0;6.1;1.6;0.0
12;2021-02-17;324;1453;0;17386;5832;0;6.2;2.1;0.0
12;2021-02-18;668;1595;0;18054;7427;0;6.5;2.7;0.0
12;2021-02-19;580;958;0;18634;8385;0;6.7;3.0;0.0
12;2021-02-20;100;386;0;18734;8771;0;6.7;3.2;0.0
12;2021-02-21;0;1;0;18734;8772;0;6.7;3.2;0.0
12;2021-02-22;148;417;0;18882;9189;0;6.8;3.3;0.0
12;2021-02-23;168;543;0;19050;9732;0;6.8;3.5;0.0
12;2021-02-24;127;658;0;19177;10390;0;6.9;3.7;0.0
12;2021-02-25;219;784;0;19396;11174;0;7.0;4.0;0.0
12;2021-02-26;324;643;0;19720;11817;0;7.1;4.2;0.0
12;2021-02-27;180;335;0;19900;12152;0;7.1;4.4;0.0
12;2021-02-28;9;2;0;19909;12154;0;7.2;4.4;0.0
12;2021-03-01;65;351;0;19974;12505;0;7.2;4.5;0.0
12;2021-03-02;218;506;0;20192;13011;0;7.3;4.7;0.0
12;2021-03-03;258;387;0;20450;13398;0;7.3;4.8;0.0
12;2021-03-04;308;364;0;20758;13762;0;7.5;4.9;0.0
12;2021-03-05;447;363;0;21205;14125;0;7.6;5.1;0.0
12;2021-03-06;792;114;0;21997;14239;0;7.9;5.1;0.0
12;2021-03-07;138;32;0;22135;14271;0;8.0;5.1;0.0
12;2021-03-08;254;216;0;22389;14487;0;8.0;5.2;0.0
12;2021-03-09;742;274;0;23131;14761;0;8.3;5.3;0.0
12;2021-03-10;785;715;0;23916;15476;0;8.6;5.6;0.0
12;2021-03-11;958;642;0;24874;16118;0;8.9;5.8;0.0
12;2021-03-12;1226;514;0;26100;16632;0;9.4;6.0;0.0
12;2021-03-13;864;126;0;26964;16758;0;9.7;6.0;0.0
12;2021-03-14;43;4;0;27007;16762;0;9.7;6.0;0.0
12;2021-03-15;605;156;0;27612;16918;0;9.9;6.1;0.0
12;2021-03-16;811;152;0;28423;17070;0;10.2;6.1;0.0
12;2021-03-17;1389;179;0;29812;17249;0;10.7;6.2;0.0
12;2021-03-18;978;252;0;30790;17501;0;11.1;6.3;0.0
12;2021-03-19;1328;272;0;32118;17773;0;11.5;6.4;0.0
12;2021-03-20;722;75;0;32840;17848;0;11.8;6.4;0.0
12;2021-03-21;261;10;0;33101;17858;0;11.9;6.4;0.0
12;2021-03-22;609;168;0;33710;18026;0;12.1;6.5;0.0
12;2021-03-23;1203;188;0;34913;18214;0;12.5;6.5;0.0
12;2021-03-24;1369;202;0;36282;18416;0;13.0;6.6;0.0
12;2021-03-25;1776;203;0;38058;18619;0;13.7;6.7;0.0
12;2021-03-26;1922;231;0;39980;18850;0;14.4;6.8;0.0
12;2021-03-27;940;59;0;40920;18909;0;14.7;6.8;0.0
12;2021-03-28;76;7;0;40996;18916;0;14.7;6.8;0.0
12;2021-03-29;1007;95;0;42003;19011;0;15.1;6.8;0.0
12;2021-03-30;1659;134;0;43662;19145;0;15.7;6.9;0.0
12;2021-03-31;1410;124;0;45072;19269;0;16.2;6.9;0.0
12;2021-04-01;1904;188;0;46976;19457;0;16.9;7.0;0.0
12;2021-04-02;1507;346;0;48483;19803;0;17.4;7.1;0.0
12;2021-04-03;820;102;0;49303;19905;0;17.7;7.2;0.0
12;2021-04-04;22;2;0;49325;19907;0;17.7;7.2;0.0
12;2021-04-05;547;12;0;49872;19919;0;17.9;7.2;0.0
12;2021-04-06;1079;544;0;50951;20463;0;18.3;7.4;0.0
12;2021-04-07;1595;628;0;52546;21091;0;18.9;7.6;0.0
12;2021-04-08;1975;578;0;54521;21669;0;19.6;7.8;0.0
12;2021-04-09;1992;646;0;56513;22315;0;20.3;8.0;0.0
12;2021-04-10;1333;203;0;57846;22518;0;20.8;8.1;0.0
12;2021-04-11;126;5;0;57972;22523;0;20.8;8.1;0.0
12;2021-04-12;1726;533;0;59698;23056;0;21.4;8.3;0.0
12;2021-04-13;1859;759;0;61557;23815;0;22.1;8.6;0.0
12;2021-04-14;1764;1211;0;63321;25026;0;22.7;9.0;0.0
12;2021-04-15;1950;883;0;65271;25909;0;23.4;9.3;0.0
12;2021-04-16;1677;1214;0;66948;27123;0;24.1;9.7;0.0
12;2021-04-17;1466;547;0;68414;27670;0;24.6;9.9;0.0
12;2021-04-18;10;2;0;68424;27672;0;24.6;9.9;0.0
12;2021-04-19;1610;556;0;70034;28228;0;25.2;10.1;0.0
12;2021-04-20;1516;977;0;71550;29205;0;25.7;10.5;0.0
12;2021-04-21;1630;1162;0;73180;30367;0;26.3;10.9;0.0
12;2021-04-22;1680;1060;0;74860;31427;0;26.9;11.3;0.0
12;2021-04-23;1365;1296;0;76225;32723;0;27.4;11.8;0.0
12;2021-04-24;1328;676;0;77553;33399;0;27.9;12.0;0.0
12;2021-04-25;72;7;0;77625;33406;0;27.9;12.0;0.0
12;2021-04-26;1352;897;0;78977;34303;0;28.4;12.3;0.0
12;2021-04-27;1261;1253;0;80238;35556;0;28.8;12.8;0.0
12;2021-04-28;1094;1756;0;81332;37312;0;29.2;13.4;0.0
12;2021-04-29;1463;1782;0;82795;39094;0;29.7;14.0;0.0
12;2021-04-30;1749;1714;0;84544;40808;0;30.4;14.7;0.0
12;2021-05-01;1470;255;0;86014;41063;0;30.9;14.8;0.0
12;2021-05-02;95;21;0;86109;41084;0;30.9;14.8;0.0
12;2021-05-03;1668;1156;0;87777;42240;0;31.5;15.2;0.0
12;2021-05-04;1450;1328;0;89227;43568;0;32.1;15.7;0.0
12;2021-05-05;1302;1587;0;90529;45155;0;32.5;16.2;0.0
12;2021-05-06;1730;1369;0;92259;46524;0;33.1;16.7;0.0
12;2021-05-07;1484;1717;0;93743;48241;0;33.7;17.3;0.0
12;2021-05-08;1204;437;0;94947;48678;0;34.1;17.5;0.0
12;2021-05-09;27;42;0;94974;48720;0;34.1;17.5;0.0
12;2021-05-10;795;2134;0;95769;50854;0;34.4;18.3;0.0
12;2021-05-11;883;1826;0;96652;52680;0;34.7;18.9;0.0
12;2021-05-12;933;1796;0;97585;54476;0;35.1;19.6;0.0
12;2021-05-13;1501;789;0;99086;55265;0;35.6;19.9;0.0
12;2021-05-14;1179;1479;0;100265;56744;0;36.0;20.4;0.0
12;2021-05-15;993;1027;0;101258;57771;0;36.4;20.8;0.0
12;2021-05-16;14;19;0;101272;57790;0;36.4;20.8;0.0
12;2021-05-17;979;1737;0;102251;59527;0;36.7;21.4;0.0
12;2021-05-18;1423;1531;0;103674;61058;0;37.2;21.9;0.0
12;2021-05-19;1810;1287;0;105484;62345;0;37.9;22.4;0.0
12;2021-05-20;2207;929;0;107691;63274;0;38.7;22.7;0.0
12;2021-05-21;1758;1228;0;109449;64502;0;39.3;23.2;0.0
12;2021-05-22;1138;929;0;110587;65431;0;39.7;23.5;0.0
12;2021-05-23;39;16;0;110626;65447;0;39.7;23.5;0.0
12;2021-05-24;1722;499;0;112348;65946;0;40.4;23.7;0.0
12;2021-05-25;1680;1153;0;114028;67099;0;41.0;24.1;0.0
12;2021-05-26;1877;780;0;115905;67879;0;41.6;24.4;0.0
12;2021-05-27;2039;759;0;117944;68638;0;42.4;24.7;0.0
12;2021-05-28;1875;1047;0;119819;69685;0;43.0;25.0;0.0
12;2021-05-29;1531;773;0;121350;70458;0;43.6;25.3;0.0
12;2021-05-30;107;39;0;121457;70497;0;43.6;25.3;0.0
12;2021-05-31;1637;824;0;123094;71321;0;44.2;25.6;0.0
12;2021-06-01;1823;1047;0;124917;72368;0;44.9;26.0;0.0
12;2021-06-02;1918;1074;0;126835;73442;0;45.6;26.4;0.0
12;2021-06-03;2020;883;0;128855;74325;0;46.3;26.7;0.0
12;2021-06-04;1901;1342;0;130756;75667;0;47.0;27.2;0.0
12;2021-06-05;1577;904;0;132333;76571;0;47.5;27.5;0.0
12;2021-06-06;44;23;0;132377;76594;0;47.6;27.5;0.0
12;2021-06-07;1087;1737;0;133464;78331;0;47.9;28.1;0.0
12;2021-06-08;1361;1188;0;134825;79519;0;48.4;28.6;0.0
12;2021-06-09;993;1248;0;135818;80767;0;48.8;29.0;0.0
12;2021-06-10;1053;896;0;136871;81663;0;49.2;29.3;0.0
12;2021-06-11;1195;1991;0;138066;83654;0;49.6;30.1;0.0
12;2021-06-12;969;1264;0;139035;84918;0;49.9;30.5;0.0
12;2021-06-13;39;62;0;139074;84980;0;50.0;30.5;0.0
12;2021-06-14;695;1781;0;139769;86761;0;50.2;31.2;0.0
12;2021-06-15;782;1841;0;140551;88602;0;50.5;31.8;0.0
12;2021-06-16;857;1751;0;141408;90353;0;50.8;32.5;0.0
12;2021-06-17;693;998;0;142101;91351;0;51.0;32.8;0.0
12;2021-06-18;1097;1759;0;143198;93110;0;51.4;33.4;0.0
12;2021-06-19;858;1296;0;144056;94406;0;51.8;33.9;0.0
12;2021-06-20;17;24;0;144073;94430;0;51.8;33.9;0.0
12;2021-06-21;520;1644;0;144593;96074;0;51.9;34.5;0.0
12;2021-06-22;508;1474;0;145101;97548;0;52.1;35.0;0.0
12;2021-06-23;586;1296;0;145687;98844;0;52.3;35.5;0.0
12;2021-06-24;273;609;0;145960;99453;0;52.4;35.7;0.0
12;2021-06-25;805;1774;0;146765;101227;0;52.7;36.4;0.0
12;2021-06-26;620;1436;0;147385;102663;0;52.9;36.9;0.0
12;2021-06-27;14;28;0;147399;102691;0;53.0;36.9;0.0
12;2021-06-28;467;2382;0;147866;105073;0;53.1;37.7;0.0
12;2021-06-29;545;1927;0;148411;107000;0;53.3;38.4;0.0
12;2021-06-30;789;2079;0;149200;109079;0;53.6;39.2;0.0
12;2021-07-01;356;1100;0;149556;110179;0;53.7;39.6;0.0
12;2021-07-02;747;2487;0;150303;112666;0;54.0;40.5;0.0
12;2021-07-03;547;1770;0;150850;114436;0;54.2;41.1;0.0
12;2021-07-04;13;33;0;150863;114469;0;54.2;41.1;0.0
12;2021-07-05;439;2293;0;151302;116762;0;54.4;41.9;0.0
12;2021-07-06;628;2413;0;151930;119175;0;54.6;42.8;0.0
12;2021-07-07;678;2070;0;152608;121245;0;54.8;43.6;0.0
12;2021-07-08;314;934;0;152922;122179;0;54.9;43.9;0.0
12;2021-07-09;694;2505;0;153616;124684;0;55.2;44.8;0.0
12;2021-07-10;451;1974;0;154067;126658;0;55.3;45.5;0.0
12;2021-07-11;28;100;0;154095;126758;0;55.4;45.5;0.0
12;2021-07-12;535;2328;0;154630;129086;0;55.6;46.4;0.0
12;2021-07-13;820;2512;0;155450;131598;0;55.8;47.3;0.0
12;2021-07-14;111;69;0;155561;131667;0;55.9;47.3;0.0
12;2021-07-15;835;2037;0;156396;133704;0;56.2;48.0;0.0
12;2021-07-16;1174;2445;0;157570;136149;0;56.6;48.9;0.0
12;2021-07-17;727;1879;0;158297;138028;0;56.9;49.6;0.0
12;2021-07-18;52;52;0;158349;138080;0;56.9;49.6;0.0
12;2021-07-19;1226;1955;0;159575;140035;0;57.3;50.3;0.0
12;2021-07-20;1401;1452;0;160976;141487;0;57.8;50.8;0.0
12;2021-07-21;1086;1032;0;162062;142519;0;58.2;51.2;0.0
12;2021-07-22;2109;1311;0;164171;143830;0;59.0;51.7;0.0
12;2021-07-23;1770;1930;0;165941;145760;0;59.6;52.4;0.0
12;2021-07-24;1529;1437;0;167470;147197;0;60.2;52.9;0.0
12;2021-07-25;170;51;0;167640;147248;0;60.2;52.9;0.0
12;2021-07-26;1721;1319;0;169361;148567;0;60.8;53.4;0.0
12;2021-07-27;2129;1020;0;171490;149587;0;61.6;53.7;0.0
12;2021-07-28;1675;711;0;173165;150298;0;62.2;54.0;0.0
12;2021-07-29;1212;744;0;174377;151042;0;62.6;54.3;0.0
12;2021-07-30;2282;1223;0;176659;152265;0;63.5;54.7;0.0
12;2021-07-31;1751;907;0;178410;153172;0;64.1;55.0;0.0
12;2021-08-01;209;52;0;178619;153224;0;64.2;55.0;0.0
12;2021-08-02;1631;757;0;180250;153981;0;64.8;55.3;0.0
12;2021-08-03;1814;716;0;182064;154697;0;65.4;55.6;0.0
12;2021-08-04;1645;756;0;183709;155453;0;66.0;55.8;0.0
12;2021-08-05;1522;656;0;185231;156109;0;66.5;56.1;0.0
12;2021-08-06;1606;1161;0;186837;157270;0;67.1;56.5;0.0
12;2021-08-07;1286;651;0;188123;157921;0;67.6;56.7;0.0
12;2021-08-08;29;35;0;188152;157956;0;67.6;56.7;0.0
12;2021-08-09;1233;1183;0;189385;159139;0;68.0;57.2;0.0
12;2021-08-10;1222;1156;0;190607;160295;0;68.5;57.6;0.0
12;2021-08-11;823;1134;0;191430;161429;0;68.8;58.0;0.0
12;2021-08-12;742;1075;0;192172;162504;0;69.0;58.4;0.0
12;2021-08-13;985;1270;0;193157;163774;0;69.4;58.8;0.0
12;2021-08-14;662;1244;0;193819;165018;0;69.6;59.3;0.0
12;2021-08-15;197;97;0;194016;165115;0;69.7;59.3;0.0
12;2021-08-16;644;1633;0;194660;166748;0;69.9;59.9;0.0
12;2021-08-17;820;1849;0;195480;168597;0;70.2;60.6;0.0
12;2021-08-18;479;1458;0;195959;170055;0;70.4;61.1;0.0
12;2021-08-19;637;1073;0;196596;171128;0;70.6;61.5;0.0
12;2021-08-20;738;1779;0;197334;172907;0;70.9;62.1;0.0
12;2021-08-21;475;1434;0;197809;174341;0;71.1;62.6;0.0
12;2021-08-22;84;66;0;197893;174407;0;71.1;62.7;0.0
12;2021-08-23;435;1812;0;198328;176219;0;71.2;63.3;0.0
12;2021-08-24;484;1825;0;198812;178044;0;71.4;64.0;0.0
12;2021-08-25;354;1547;0;199166;179591;0;71.5;64.5;0.0
12;2021-08-26;474;1565;0;199640;181156;0;71.7;65.1;0.0
12;2021-08-27;581;1689;0;200221;182845;0;71.9;65.7;0.0
12;2021-08-28;323;1489;0;200544;184334;0;72.0;66.2;0.0
12;2021-08-29;156;149;0;200700;184483;0;72.1;66.3;0.0
12;2021-08-30;533;1804;34;201233;186287;34;72.3;66.9;0.0
12;2021-08-31;430;1300;45;201663;187587;79;72.4;67.4;0.0
12;2021-09-01;412;946;85;202075;188533;164;72.6;67.7;0.1
12;2021-09-02;299;769;89;202374;189302;253;72.7;68.0;0.1
12;2021-09-03;476;1190;193;202850;190492;446;72.9;68.4;0.2
12;2021-09-04;432;1019;101;203282;191511;547;73.0;68.8;0.2
12;2021-09-05;52;170;14;203334;191681;561;73.0;68.9;0.2
12;2021-09-06;236;615;214;203570;192296;775;73.1;69.1;0.3
12;2021-09-07;262;468;190;203832;192764;965;73.2;69.2;0.3
12;2021-09-08;265;506;154;204097;193270;1119;73.3;69.4;0.4
12;2021-09-09;198;445;53;204295;193715;1172;73.4;69.6;0.4
12;2021-09-10;486;974;269;204781;194689;1441;73.6;69.9;0.5
12;2021-09-11;369;880;137;205150;195569;1578;73.7;70.3;0.6
12;2021-09-12;22;75;15;205172;195644;1593;73.7;70.3;0.6
12;2021-09-13;188;393;232;205360;196037;1825;73.8;70.4;0.7
12;2021-09-14;278;367;227;205638;196404;2052;73.9;70.6;0.7
12;2021-09-15;241;439;350;205879;196843;2402;74.0;70.7;0.9
12;2021-09-16;366;417;502;206245;197260;2904;74.1;70.9;1.0
12;2021-09-17;325;518;467;206570;197778;3371;74.2;71.1;1.2
12;2021-09-18;232;679;161;206802;198457;3532;74.3;71.3;1.3
12;2021-09-19;4;22;2;206806;198479;3534;74.3;71.3;1.3
12;2021-09-20;108;437;320;206914;198916;3854;74.3;71.5;1.4
12;2021-09-21;119;253;517;207033;199169;4371;74.4;71.6;1.6
12;2021-09-22;148;561;327;207181;199730;4698;74.4;71.8;1.7
12;2021-09-23;104;186;395;207285;199916;5093;74.5;71.8;1.8
12;2021-09-24;193;540;344;207478;200456;5437;74.5;72.0;2.0
12;2021-09-25;156;640;117;207634;201096;5554;74.6;72.2;2.0
12;2021-09-26;1;11;2;207635;201107;5556;74.6;72.2;2.0
12;2021-09-27;79;259;310;207714;201366;5866;74.6;72.3;2.1
12;2021-09-28;103;259;483;207817;201625;6349;74.7;72.4;2.3
12;2021-09-29;106;320;270;207923;201945;6619;74.7;72.5;2.4
12;2021-09-30;63;141;343;207986;202086;6962;74.7;72.6;2.5
12;2021-10-01;187;410;249;208173;202496;7211;74.8;72.7;2.6
12;2021-10-02;178;454;124;208351;202950;7335;74.8;72.9;2.6
12;2021-10-03;1;9;2;208352;202959;7337;74.8;72.9;2.6
12;2021-10-04;94;190;141;208446;203149;7478;74.9;73.0;2.7
12;2021-10-05;70;199;300;208516;203348;7778;74.9;73.1;2.8
12;2021-10-06;127;253;521;208643;203601;8299;75.0;73.1;3.0
12;2021-10-07;82;309;243;208725;203910;8542;75.0;73.3;3.1
12;2021-10-08;143;380;421;208868;204290;8963;75.0;73.4;3.2
12;2021-10-09;156;322;242;209024;204612;9205;75.1;73.5;3.3
12;2021-10-10;1;9;8;209025;204621;9213;75.1;73.5;3.3
12;2021-10-11;62;113;177;209087;204734;9390;75.1;73.6;3.4
12;2021-10-12;51;118;179;209138;204852;9569;75.1;73.6;3.4
12;2021-10-13;141;276;468;209279;205128;10037;75.2;73.7;3.6
12;2021-10-14;74;140;336;209353;205268;10373;75.2;73.7;3.7
12;2021-10-15;93;188;472;209446;205456;10845;75.2;73.8;3.9
12;2021-10-16;177;234;434;209623;205690;11279;75.3;73.9;4.1
12;2021-10-17;2;8;0;209625;205698;11279;75.3;73.9;4.1
12;2021-10-18;72;97;218;209697;205795;11497;75.3;73.9;4.1
12;2021-10-19;53;82;202;209750;205877;11699;75.4;74.0;4.2
12;2021-10-20;138;190;550;209888;206067;12249;75.4;74.0;4.4
12;2021-10-21;71;52;274;209959;206119;12523;75.4;74.0;4.5
12;2021-10-22;90;119;560;210049;206238;13083;75.5;74.1;4.7
12;2021-10-23;155;235;504;210204;206473;13587;75.5;74.2;4.9
12;2021-10-24;2;4;3;210206;206477;13590;75.5;74.2;4.9
12;2021-10-25;19;32;61;210225;206509;13651;75.5;74.2;4.9
12;2021-10-26;106;124;531;210331;206633;14182;75.6;74.2;5.1
12;2021-10-27;66;103;506;210397;206736;14688;75.6;74.3;5.3
12;2021-10-28;64;66;260;210461;206802;14948;75.6;74.3;5.4
12;2021-10-29;53;104;561;210514;206906;15509;75.6;74.3;5.6
12;2021-10-30;100;167;519;210614;207073;16028;75.7;74.4;5.8
12;2021-10-31;1;1;2;210615;207074;16030;75.7;74.4;5.8
12;2021-11-01;6;6;1;210621;207080;16031;75.7;74.4;5.8
12;2021-11-02;39;54;246;210660;207134;16277;75.7;74.4;5.8
12;2021-11-03;135;204;964;210795;207338;17241;75.7;74.5;6.2
12;2021-11-04;32;67;410;210827;207405;17651;75.7;74.5;6.3
12;2021-11-05;61;84;545;210888;207489;18196;75.8;74.5;6.5
12;2021-11-06;136;178;538;211024;207667;18734;75.8;74.6;6.7
12;2021-11-07;1;4;3;211025;207671;18737;75.8;74.6;6.7
12;2021-11-08;67;94;602;211092;207765;19339;75.8;74.6;6.9
12;2021-11-09;34;60;685;211126;207825;20024;75.8;74.7;7.2
12;2021-11-10;114;152;982;211240;207977;21006;75.9;74.7;7.5
12;2021-11-11;5;2;5;211245;207979;21011;75.9;74.7;7.5
12;2021-11-12;67;85;800;211312;208064;21811;75.9;74.7;7.8
12;2021-11-13;139;173;734;211451;208237;22545;76.0;74.8;8.1
12;2021-11-14;1;2;8;211452;208239;22553;76.0;74.8;8.1
12;2021-11-15;60;60;874;211512;208299;23427;76.0;74.8;8.4
12;2021-11-16;69;81;1377;211581;208380;24804;76.0;74.9;8.9
12;2021-11-17;113;115;1096;211694;208495;25900;76.1;74.9;9.3
12;2021-11-18;65;106;986;211759;208601;26886;76.1;74.9;9.7
12;2021-11-19;78;74;1227;211837;208675;28113;76.1;75.0;10.1
12;2021-11-20;101;116;847;211938;208791;28960;76.1;75.0;10.4
12;2021-11-21;2;5;19;211940;208796;28979;76.1;75.0;10.4
12;2021-11-22;59;42;1144;211999;208838;30123;76.2;75.0;10.8
12;2021-11-23;77;39;1257;212076;208877;31380;76.2;75.0;11.3
12;2021-11-24;95;105;1295;212171;208982;32675;76.2;75.1;11.7
12;2021-11-25;88;80;1458;212259;209062;34133;76.3;75.1;12.3
12;2021-11-26;131;86;1791;212390;209148;35924;76.3;75.1;12.9
12;2021-11-27;71;136;1220;212461;209284;37144;76.3;75.2;13.3
12;2021-11-28;13;7;199;212474;209291;37343;76.3;75.2;13.4
12;2021-11-29;52;56;1545;212526;209347;38888;76.3;75.2;14.0
12;2021-11-30;83;72;2003;212609;209419;40891;76.4;75.2;14.7
12;2021-12-01;79;97;1953;212688;209516;42844;76.4;75.3;15.4
12;2021-12-02;65;53;2034;212753;209569;44878;76.4;75.3;16.1
12;2021-12-03;77;81;2465;212830;209650;47343;76.5;75.3;17.0
12;2021-12-04;87;140;1506;212917;209790;48849;76.5;75.4;17.5
12;2021-12-05;12;11;53;212929;209801;48902;76.5;75.4;17.6
12;2021-12-06;57;74;1802;212986;209875;50704;76.5;75.4;18.2
12;2021-12-07;75;95;3301;213061;209970;54005;76.5;75.4;19.4
12;2021-12-08;72;116;2337;213133;210086;56342;76.6;75.5;20.2
12;2021-12-09;68;68;2911;213201;210154;59253;76.6;75.5;21.3
12;2021-12-10;81;82;3500;213282;210236;62753;76.6;75.5;22.5
12;2021-12-11;75;120;2044;213357;210356;64797;76.6;75.6;23.3
12;2021-12-12;11;6;248;213368;210362;65045;76.7;75.6;23.4
12;2021-12-13;58;81;2681;213426;210443;67726;76.7;75.6;24.3
12;2021-12-14;96;94;4500;213522;210537;72226;76.7;75.6;25.9
12;2021-12-15;71;111;2937;213593;210648;75163;76.7;75.7;27.0
12;2021-12-16;97;103;3686;213690;210751;78849;76.8;75.7;28.3
13;2020-12-27;4;0;0;4;0;0;0.0;0.0;0.0
13;2020-12-28;9;0;0;13;0;0;0.0;0.0;0.0
13;2020-12-29;0;0;0;13;0;0;0.0;0.0;0.0
13;2020-12-30;4;0;0;17;0;0;0.0;0.0;0.0
13;2020-12-31;4;0;0;21;0;0;0.0;0.0;0.0
13;2021-01-01;3;0;0;24;0;0;0.0;0.0;0.0
13;2021-01-02;4;1;0;28;1;0;0.0;0.0;0.0
13;2021-01-03;6;1;0;34;2;0;0.0;0.0;0.0
13;2021-01-04;2;1;0;36;3;0;0.0;0.0;0.0
13;2021-01-05;83;1;0;119;4;0;0.0;0.0;0.0
13;2021-01-06;125;1;0;244;5;0;0.0;0.0;0.0
13;2021-01-07;214;1;0;458;6;0;0.0;0.0;0.0
13;2021-01-08;239;0;0;697;6;0;0.0;0.0;0.0
13;2021-01-09;32;0;0;729;6;0;0.0;0.0;0.0
13;2021-01-10;3;0;0;732;6;0;0.0;0.0;0.0
13;2021-01-11;523;2;0;1255;8;0;0.1;0.0;0.0
13;2021-01-12;923;1;0;2178;9;0;0.1;0.0;0.0
13;2021-01-13;1136;2;0;3314;11;0;0.2;0.0;0.0
13;2021-01-14;1661;23;0;4975;34;0;0.2;0.0;0.0
13;2021-01-15;1535;7;0;6510;41;0;0.3;0.0;0.0
13;2021-01-16;458;4;0;6968;45;0;0.3;0.0;0.0
13;2021-01-17;51;0;0;7019;45;0;0.3;0.0;0.0
13;2021-01-18;2312;14;0;9331;59;0;0.5;0.0;0.0
13;2021-01-19;7064;55;0;16395;114;0;0.8;0.0;0.0
13;2021-01-20;5296;27;0;21691;141;0;1.1;0.0;0.0
13;2021-01-21;5339;40;0;27030;181;0;1.3;0.0;0.0
13;2021-01-22;3893;23;0;30923;204;0;1.5;0.0;0.0
13;2021-01-23;1291;8;0;32214;212;0;1.6;0.0;0.0
13;2021-01-24;425;4;0;32639;216;0;1.6;0.0;0.0
13;2021-01-25;2274;25;0;34913;241;0;1.7;0.0;0.0
13;2021-01-26;2799;91;0;37712;332;0;1.9;0.0;0.0
13;2021-01-27;3048;126;0;40760;458;0;2.0;0.0;0.0
13;2021-01-28;3288;227;0;44048;685;0;2.2;0.0;0.0
13;2021-01-29;2547;149;0;46595;834;0;2.3;0.0;0.0
13;2021-01-30;977;29;0;47572;863;0;2.3;0.0;0.0
13;2021-01-31;214;0;0;47786;863;0;2.3;0.0;0.0
13;2021-02-01;1807;309;0;49593;1172;0;2.4;0.1;0.0
13;2021-02-02;2248;674;0;51841;1846;0;2.5;0.1;0.0
13;2021-02-03;1771;587;0;53612;2433;0;2.6;0.1;0.0
13;2021-02-04;1878;957;0;55490;3390;0;2.7;0.2;0.0
13;2021-02-05;2455;1486;0;57945;4876;0;2.8;0.2;0.0
13;2021-02-06;800;336;0;58745;5212;0;2.9;0.3;0.0
13;2021-02-07;250;6;0;58995;5218;0;2.9;0.3;0.0
13;2021-02-08;1797;1511;0;60792;6729;0;3.0;0.3;0.0
13;2021-02-09;3189;4302;0;63981;11031;0;3.1;0.5;0.0
13;2021-02-10;3073;3307;0;67054;14338;0;3.3;0.7;0.0
13;2021-02-11;3491;3526;0;70545;17864;0;3.5;0.9;0.0
13;2021-02-12;2662;3092;0;73207;20956;0;3.6;1.0;0.0
13;2021-02-13;716;608;0;73923;21564;0;3.6;1.1;0.0
13;2021-02-14;69;333;0;73992;21897;0;3.6;1.1;0.0
13;2021-02-15;897;2009;0;74889;23906;0;3.7;1.2;0.0
13;2021-02-16;1267;2580;0;76156;26486;0;3.7;1.3;0.0
13;2021-02-17;1331;2911;0;77487;29397;0;3.8;1.4;0.0
13;2021-02-18;1854;2738;0;79341;32135;0;3.9;1.6;0.0
13;2021-02-19;1505;2257;0;80846;34392;0;4.0;1.7;0.0
13;2021-02-20;436;780;0;81282;35172;0;4.0;1.7;0.0
13;2021-02-21;31;266;0;81313;35438;0;4.0;1.7;0.0
13;2021-02-22;1006;2233;0;82319;37671;0;4.0;1.9;0.0
13;2021-02-23;1243;2494;0;83562;40165;0;4.1;2.0;0.0
13;2021-02-24;1441;2537;0;85003;42702;0;4.2;2.1;0.0
13;2021-02-25;2331;2054;0;87334;44756;0;4.3;2.2;0.0
13;2021-02-26;2402;1998;0;89736;46754;0;4.4;2.3;0.0
13;2021-02-27;955;741;0;90691;47495;0;4.5;2.3;0.0
13;2021-02-28;183;179;0;90874;47674;0;4.5;2.3;0.0
13;2021-03-01;1847;1552;0;92721;49226;0;4.6;2.4;0.0
13;2021-03-02;2918;2617;0;95639;51843;0;4.7;2.5;0.0
13;2021-03-03;3434;2608;0;99073;54451;0;4.9;2.7;0.0
13;2021-03-04;4065;3095;0;103138;57546;0;5.1;2.8;0.0
13;2021-03-05;4030;2710;0;107168;60256;0;5.3;3.0;0.0
13;2021-03-06;5290;820;0;112458;61076;0;5.5;3.0;0.0
13;2021-03-07;4175;371;0;116633;61447;0;5.7;3.0;0.0
13;2021-03-08;3844;1992;0;120477;63439;0;5.9;3.1;0.0
13;2021-03-09;4884;2320;0;125361;65759;0;6.2;3.2;0.0
13;2021-03-10;5184;2071;0;130545;67830;0;6.4;3.3;0.0
13;2021-03-11;7206;2205;0;137751;70035;0;6.8;3.4;0.0
13;2021-03-12;8200;2082;0;145951;72117;0;7.2;3.5;0.0
13;2021-03-13;6214;739;0;152165;72856;0;7.5;3.6;0.0
13;2021-03-14;2223;176;0;154388;73032;0;7.6;3.6;0.0
13;2021-03-15;6159;1247;0;160547;74279;0;7.9;3.7;0.0
13;2021-03-16;4934;1565;0;165481;75844;0;8.1;3.7;0.0
13;2021-03-17;5087;1428;0;170568;77272;0;8.4;3.8;0.0
13;2021-03-18;5711;1807;0;176279;79079;0;8.7;3.9;0.0
13;2021-03-19;6664;1585;0;182943;80664;0;9.0;4.0;0.0
13;2021-03-20;3943;681;0;186886;81345;0;9.2;4.0;0.0
13;2021-03-21;763;91;0;187649;81436;0;9.2;4.0;0.0
13;2021-03-22;6922;1527;0;194571;82963;0;9.6;4.1;0.0
13;2021-03-23;8876;1728;0;203447;84691;0;10.0;4.2;0.0
13;2021-03-24;8611;2146;0;212058;86837;0;10.4;4.3;0.0
13;2021-03-25;10689;2062;0;222747;88899;0;10.9;4.4;0.0
13;2021-03-26;10380;1868;0;233127;90767;0;11.5;4.5;0.0
13;2021-03-27;4693;811;0;237820;91578;0;11.7;4.5;0.0
13;2021-03-28;1088;82;0;238908;91660;0;11.7;4.5;0.0
13;2021-03-29;7171;1957;0;246079;93617;0;12.1;4.6;0.0
13;2021-03-30;11968;2520;0;258047;96137;0;12.7;4.7;0.0
13;2021-03-31;10356;3182;0;268403;99319;0;13.2;4.9;0.0
13;2021-04-01;11743;3053;0;280146;102372;0;13.8;5.0;0.0
13;2021-04-02;9453;3785;0;289599;106157;0;14.2;5.2;0.0
13;2021-04-03;3873;2725;0;293472;108882;0;14.4;5.4;0.0
13;2021-04-04;625;314;0;294097;109196;0;14.5;5.4;0.0
13;2021-04-05;3417;721;0;297514;109917;0;14.6;5.4;0.0
13;2021-04-06;8285;4139;0;305799;114056;0;15.0;5.6;0.0
13;2021-04-07;9722;4600;0;315521;118656;0;15.5;5.8;0.0
13;2021-04-08;9764;5360;0;325285;124016;0;16.0;6.1;0.0
13;2021-04-09;10840;5014;0;336125;129030;0;16.5;6.3;0.0
13;2021-04-10;7020;2121;0;343145;131151;0;16.9;6.4;0.0
13;2021-04-11;1385;555;0;344530;131706;0;16.9;6.5;0.0
13;2021-04-12;7678;4667;0;352208;136373;0;17.3;6.7;0.0
13;2021-04-13;8797;5359;0;361005;141732;0;17.7;7.0;0.0
13;2021-04-14;9219;5704;0;370224;147436;0;18.2;7.2;0.0
13;2021-04-15;9568;5775;0;379792;153211;0;18.7;7.5;0.0
13;2021-04-16;9582;5461;0;389374;158672;0;19.1;7.8;0.0
13;2021-04-17;4020;1990;0;393394;160662;0;19.3;7.9;0.0
13;2021-04-18;2453;1405;0;395847;162067;0;19.5;8.0;0.0
13;2021-04-19;6234;6137;0;402081;168204;0;19.8;8.3;0.0
13;2021-04-20;7200;7287;0;409281;175491;0;20.1;8.6;0.0
13;2021-04-21;7586;7105;0;416867;182596;0;20.5;9.0;0.0
13;2021-04-22;8135;7606;0;425002;190202;0;20.9;9.3;0.0
13;2021-04-23;8117;6619;0;433119;196821;0;21.3;9.7;0.0
13;2021-04-24;4538;3653;0;437657;200474;0;21.5;9.9;0.0
13;2021-04-25;915;533;0;438572;201007;0;21.6;9.9;0.0
13;2021-04-26;6000;6754;0;444572;207761;0;21.9;10.2;0.0
13;2021-04-27;7113;7610;0;451685;215371;0;22.2;10.6;0.0
13;2021-04-28;9160;7442;0;460845;222813;0;22.7;11.0;0.0
13;2021-04-29;11186;7390;0;472031;230203;0;23.2;11.3;0.0
13;2021-04-30;10564;7125;0;482595;237328;0;23.7;11.7;0.0
13;2021-05-01;5076;3588;0;487671;240916;0;24.0;11.8;0.0
13;2021-05-02;2053;735;0;489724;241651;0;24.1;11.9;0.0
13;2021-05-03;6967;7552;0;496691;249203;0;24.4;12.2;0.0
13;2021-05-04;8097;8337;0;504788;257540;0;24.8;12.7;0.0
13;2021-05-05;7942;8723;0;512730;266263;0;25.2;13.1;0.0
13;2021-05-06;9891;8390;0;522621;274653;0;25.7;13.5;0.0
13;2021-05-07;8640;9679;0;531261;284332;0;26.1;14.0;0.0
13;2021-05-08;4463;3773;0;535724;288105;0;26.3;14.2;0.0
13;2021-05-09;978;700;0;536702;288805;0;26.4;14.2;0.0
13;2021-05-10;7416;8492;0;544118;297297;0;26.7;14.6;0.0
13;2021-05-11;10634;9243;0;554752;306540;0;27.3;15.1;0.0
13;2021-05-12;12318;8527;0;567070;315067;0;27.9;15.5;0.0
13;2021-05-13;9158;3505;0;576228;318572;0;28.3;15.7;0.0
13;2021-05-14;12826;6307;0;589054;324879;0;29.0;16.0;0.0
13;2021-05-15;9728;4372;0;598782;329251;0;29.4;16.2;0.0
13;2021-05-16;3169;789;0;601951;330040;0;29.6;16.2;0.0
13;2021-05-17;10024;6649;0;611975;336689;0;30.1;16.5;0.0
13;2021-05-18;11372;6374;0;623347;343063;0;30.6;16.9;0.0
13;2021-05-19;11639;6205;0;634986;349268;0;31.2;17.2;0.0
13;2021-05-20;12657;6244;0;647643;355512;0;31.8;17.5;0.0
13;2021-05-21;12302;6614;0;659945;362126;0;32.4;17.8;0.0
13;2021-05-22;7390;3561;0;667335;365687;0;32.8;18.0;0.0
13;2021-05-23;1110;664;0;668445;366351;0;32.9;18.0;0.0
13;2021-05-24;6465;2362;0;674910;368713;0;33.2;18.1;0.0
13;2021-05-25;8767;7358;0;683677;376071;0;33.6;18.5;0.0
13;2021-05-26;9686;7619;0;693363;383690;0;34.1;18.9;0.0
13;2021-05-27;9775;8208;0;703138;391898;0;34.6;19.3;0.0
13;2021-05-28;8840;8930;0;711978;400828;0;35.0;19.7;0.0
13;2021-05-29;6710;4542;0;718688;405370;0;35.3;19.9;0.0
13;2021-05-30;933;551;0;719621;405921;0;35.4;20.0;0.0
13;2021-05-31;7754;7704;0;727375;413625;0;35.8;20.3;0.0
13;2021-06-01;9191;8962;0;736566;422587;0;36.2;20.8;0.0
13;2021-06-02;9423;8414;0;745989;431001;0;36.7;21.2;0.0
13;2021-06-03;11717;9210;0;757706;440211;0;37.2;21.6;0.0
13;2021-06-04;11495;9779;0;769201;449990;0;37.8;22.1;0.0
13;2021-06-05;7038;5453;0;776239;455443;0;38.2;22.4;0.0
13;2021-06-06;1686;903;0;777925;456346;0;38.2;22.4;0.0
13;2021-06-07;6558;9479;0;784483;465825;0;38.6;22.9;0.0
13;2021-06-08;8130;9670;0;792613;475495;0;39.0;23.4;0.0
13;2021-06-09;8103;9437;0;800716;484932;0;39.4;23.8;0.0
13;2021-06-10;8720;9478;0;809436;494410;0;39.8;24.3;0.0
13;2021-06-11;8017;12126;0;817453;506536;0;40.2;24.9;0.0
13;2021-06-12;5599;6475;0;823052;513011;0;40.5;25.2;0.0
13;2021-06-13;988;1222;0;824040;514233;0;40.5;25.3;0.0
13;2021-06-14;5765;10613;0;829805;524846;0;40.8;25.8;0.0
13;2021-06-15;7024;10928;0;836829;535774;0;41.1;26.3;0.0
13;2021-06-16;6897;9575;0;843726;545349;0;41.5;26.8;0.0
13;2021-06-17;7154;10356;0;850880;555705;0;41.8;27.3;0.0
13;2021-06-18;7081;10668;0;857961;566373;0;42.2;27.8;0.0
13;2021-06-19;4500;7212;0;862461;573585;0;42.4;28.2;0.0
13;2021-06-20;947;1033;0;863408;574618;0;42.4;28.2;0.0
13;2021-06-21;4361;11738;0;867769;586356;0;42.7;28.8;0.0
13;2021-06-22;4687;13492;0;872456;599848;0;42.9;29.5;0.0
13;2021-06-23;4821;13065;0;877277;612913;0;43.1;30.1;0.0
13;2021-06-24;5065;12160;0;882342;625073;0;43.4;30.7;0.0
13;2021-06-25;4882;13960;0;887224;639033;0;43.6;31.4;0.0
13;2021-06-26;2903;9232;0;890127;648265;0;43.8;31.9;0.0
13;2021-06-27;527;1024;0;890654;649289;0;43.8;31.9;0.0
13;2021-06-28;3621;12036;0;894275;661325;0;44.0;32.5;0.0
13;2021-06-29;4270;12550;0;898545;673875;0;44.2;33.1;0.0
13;2021-06-30;4724;12296;0;903269;686171;0;44.4;33.7;0.0
13;2021-07-01;5654;10997;0;908923;697168;0;44.7;34.3;0.0
13;2021-07-02;5577;11904;0;914500;709072;0;45.0;34.9;0.0
13;2021-07-03;3333;8797;0;917833;717869;0;45.1;35.3;0.0
13;2021-07-04;553;986;0;918386;718855;0;45.1;35.3;0.0
13;2021-07-05;3772;10925;0;922158;729780;0;45.3;35.9;0.0
13;2021-07-06;5256;11133;0;927414;740913;0;45.6;36.4;0.0
13;2021-07-07;5352;10226;1;932766;751139;1;45.8;36.9;0.0
13;2021-07-08;5915;9750;2;938681;760889;3;46.1;37.4;0.0
13;2021-07-09;5848;11350;0;944529;772239;3;46.4;38.0;0.0
13;2021-07-10;3116;8321;0;947645;780560;3;46.6;38.4;0.0
13;2021-07-11;536;1091;0;948181;781651;3;46.6;38.4;0.0
13;2021-07-12;4416;10640;0;952597;792291;3;46.8;38.9;0.0
13;2021-07-13;8747;12824;0;961344;805115;3;47.3;39.6;0.0
13;2021-07-14;5445;4567;0;966789;809682;3;47.5;39.8;0.0
13;2021-07-15;10890;12471;0;977679;822153;3;48.1;40.4;0.0
13;2021-07-16;11865;12517;0;989544;834670;3;48.6;41.0;0.0
13;2021-07-17;6473;8282;0;996017;842952;3;49.0;41.4;0.0
13;2021-07-18;932;1126;0;996949;844078;3;49.0;41.5;0.0
13;2021-07-19;9443;10716;0;1006392;854794;3;49.5;42.0;0.0
13;2021-07-20;11627;11145;0;1018019;865939;3;50.0;42.6;0.0
13;2021-07-21;12044;9999;0;1030063;875938;3;50.6;43.1;0.0
13;2021-07-22;13734;9894;0;1043797;885832;3;51.3;43.5;0.0
13;2021-07-23;13775;10569;0;1057572;896401;3;52.0;44.1;0.0
13;2021-07-24;7999;7400;0;1065571;903801;3;52.4;44.4;0.0
13;2021-07-25;1169;836;0;1066740;904637;3;52.4;44.5;0.0
13;2021-07-26;10558;8638;0;1077298;913275;3;53.0;44.9;0.0
13;2021-07-27;12719;8829;0;1090017;922104;3;53.6;45.3;0.0
13;2021-07-28;11856;7789;0;1101873;929893;3;54.2;45.7;0.0
13;2021-07-29;13188;7722;0;1115061;937615;3;54.8;46.1;0.0
13;2021-07-30;12971;8395;0;1128032;946010;3;55.4;46.5;0.0
13;2021-07-31;8188;5623;0;1136220;951633;3;55.8;46.8;0.0
13;2021-08-01;1213;733;0;1137433;952366;3;55.9;46.8;0.0
13;2021-08-02;10077;6479;0;1147510;958845;3;56.4;47.1;0.0
13;2021-08-03;10894;7106;0;1158404;965951;3;56.9;47.5;0.0
13;2021-08-04;9366;6529;0;1167770;972480;3;57.4;47.8;0.0
13;2021-08-05;9125;7304;0;1176895;979784;3;57.8;48.2;0.0
13;2021-08-06;9053;8740;0;1185948;988524;3;58.3;48.6;0.0
13;2021-08-07;5262;5376;0;1191210;993900;3;58.6;48.9;0.0
13;2021-08-08;975;887;0;1192185;994787;3;58.6;48.9;0.0
13;2021-08-09;7912;8606;0;1200097;1003393;3;59.0;49.3;0.0
13;2021-08-10;8542;8653;0;1208639;1012046;3;59.4;49.7;0.0
13;2021-08-11;7484;8377;0;1216123;1020423;3;59.8;50.2;0.0
13;2021-08-12;7327;9235;0;1223450;1029658;3;60.1;50.6;0.0
13;2021-08-13;6636;8671;0;1230086;1038329;3;60.5;51.0;0.0
13;2021-08-14;3776;6280;0;1233862;1044609;3;60.6;51.3;0.0
13;2021-08-15;525;702;0;1234387;1045311;3;60.7;51.4;0.0
13;2021-08-16;6199;10534;0;1240586;1055845;3;61.0;51.9;0.0
13;2021-08-17;6276;10159;0;1246862;1066004;3;61.3;52.4;0.0
13;2021-08-18;6024;9667;0;1252886;1075671;3;61.6;52.9;0.0
13;2021-08-19;6159;10168;0;1259045;1085839;3;61.9;53.4;0.0
13;2021-08-20;5482;10712;0;1264527;1096551;3;62.2;53.9;0.0
13;2021-08-21;2532;6952;0;1267059;1103503;3;62.3;54.2;0.0
13;2021-08-22;402;1010;0;1267461;1104513;3;62.3;54.3;0.0
13;2021-08-23;4594;10761;0;1272055;1115274;3;62.5;54.8;0.0
13;2021-08-24;4986;10609;0;1277041;1125883;3;62.8;55.3;0.0
13;2021-08-25;4771;9804;0;1281812;1135687;3;63.0;55.8;0.0
13;2021-08-26;4671;9432;0;1286483;1145119;3;63.2;56.3;0.0
13;2021-08-27;4688;10289;0;1291171;1155408;3;63.5;56.8;0.0
13;2021-08-28;2279;6386;0;1293450;1161794;3;63.6;57.1;0.0
13;2021-08-29;346;1213;0;1293796;1163007;3;63.6;57.2;0.0
13;2021-08-30;3910;9379;145;1297706;1172386;148;63.8;57.6;0.0
13;2021-08-31;4180;9624;213;1301886;1182010;361;64.0;58.1;0.0
13;2021-09-01;4679;8066;355;1306565;1190076;716;64.2;58.5;0.0
13;2021-09-02;4045;7595;543;1310610;1197671;1259;64.4;58.9;0.1
13;2021-09-03;4104;8279;789;1314714;1205950;2048;64.6;59.3;0.1
13;2021-09-04;2198;5490;181;1316912;1211440;2229;64.7;59.5;0.1
13;2021-09-05;225;468;53;1317137;1211908;2282;64.7;59.6;0.1
13;2021-09-06;3173;5612;717;1320310;1217520;2999;64.9;59.8;0.1
13;2021-09-07;3077;5979;1073;1323387;1223499;4072;65.0;60.1;0.2
13;2021-09-08;3350;6088;849;1326737;1229587;4921;65.2;60.4;0.2
13;2021-09-09;2940;5337;1076;1329677;1234924;5997;65.4;60.7;0.3
13;2021-09-10;3423;6407;1079;1333100;1241331;7076;65.5;61.0;0.3
13;2021-09-11;2250;4981;340;1335350;1246312;7416;65.6;61.3;0.4
13;2021-09-12;266;388;53;1335616;1246700;7469;65.6;61.3;0.4
13;2021-09-13;2530;3977;995;1338146;1250677;8464;65.8;61.5;0.4
13;2021-09-14;3028;4353;1946;1341174;1255030;10410;65.9;61.7;0.5
13;2021-09-15;2799;5060;2015;1343973;1260090;12425;66.1;61.9;0.6
13;2021-09-16;2115;3592;2080;1346088;1263682;14505;66.2;62.1;0.7
13;2021-09-17;2262;4540;1674;1348350;1268222;16179;66.3;62.3;0.8
13;2021-09-18;1511;4070;539;1349861;1272292;16718;66.3;62.5;0.8
13;2021-09-19;100;188;56;1349961;1272480;16774;66.4;62.5;0.8
13;2021-09-20;1471;3043;1525;1351432;1275523;18299;66.4;62.7;0.9
13;2021-09-21;1430;2770;1832;1352862;1278293;20131;66.5;62.8;1.0
13;2021-09-22;1596;4185;1426;1354458;1282478;21557;66.6;63.0;1.1
13;2021-09-23;1504;3347;2075;1355962;1285825;23632;66.6;63.2;1.2
13;2021-09-24;1504;3826;1368;1357466;1289651;25000;66.7;63.4;1.2
13;2021-09-25;1143;3693;485;1358609;1293344;25485;66.8;63.6;1.3
13;2021-09-26;101;256;49;1358710;1293600;25534;66.8;63.6;1.3
13;2021-09-27;1196;2719;1257;1359906;1296319;26791;66.8;63.7;1.3
13;2021-09-28;1226;2424;1286;1361132;1298743;28077;66.9;63.8;1.4
13;2021-09-29;1523;3297;1390;1362655;1302040;29467;67.0;64.0;1.4
13;2021-09-30;1343;2875;1777;1363998;1304915;31244;67.0;64.1;1.5
13;2021-10-01;2221;3144;1644;1366219;1308059;32888;67.2;64.3;1.6
13;2021-10-02;1179;2649;613;1367398;1310708;33501;67.2;64.4;1.6
13;2021-10-03;110;219;30;1367508;1310927;33531;67.2;64.4;1.6
13;2021-10-04;976;1555;1171;1368484;1312482;34702;67.3;64.5;1.7
13;2021-10-05;1215;2308;1993;1369699;1314790;36695;67.3;64.6;1.8
13;2021-10-06;1334;2742;1975;1371033;1317532;38670;67.4;64.8;1.9
13;2021-10-07;1101;2207;2262;1372134;1319739;40932;67.4;64.9;2.0
13;2021-10-08;1481;2748;2404;1373615;1322487;43336;67.5;65.0;2.1
13;2021-10-09;941;2099;916;1374556;1324586;44252;67.6;65.1;2.2
13;2021-10-10;95;139;66;1374651;1324725;44318;67.6;65.1;2.2
13;2021-10-11;978;1695;1901;1375629;1326420;46219;67.6;65.2;2.3
13;2021-10-12;1150;1757;2253;1376779;1328177;48472;67.7;65.3;2.4
13;2021-10-13;1222;2096;2365;1378001;1330273;50837;67.7;65.4;2.5
13;2021-10-14;1050;1788;2445;1379051;1332061;53282;67.8;65.5;2.6
13;2021-10-15;1445;2191;3348;1380496;1334252;56630;67.9;65.6;2.8
13;2021-10-16;907;1528;973;1381403;1335780;57603;67.9;65.7;2.8
13;2021-10-17;80;132;57;1381483;1335912;57660;67.9;65.7;2.8
13;2021-10-18;911;1381;2070;1382394;1337293;59730;67.9;65.7;2.9
13;2021-10-19;940;1462;2573;1383334;1338755;62303;68.0;65.8;3.1
13;2021-10-20;1150;1699;3046;1384484;1340454;65349;68.1;65.9;3.2
13;2021-10-21;905;1467;3012;1385389;1341921;68361;68.1;66.0;3.4
13;2021-10-22;1201;1935;3936;1386590;1343856;72297;68.2;66.1;3.6
13;2021-10-23;730;1177;1329;1387320;1345033;73626;68.2;66.1;3.6
13;2021-10-24;105;134;138;1387425;1345167;73764;68.2;66.1;3.6
13;2021-10-25;805;1125;2699;1388230;1346292;76463;68.2;66.2;3.8
13;2021-10-26;821;1074;2931;1389051;1347366;79394;68.3;66.2;3.9
13;2021-10-27;897;1269;3269;1389948;1348635;82663;68.3;66.3;4.1
13;2021-10-28;736;1038;3330;1390684;1349673;85993;68.4;66.3;4.2
13;2021-10-29;955;1376;3860;1391639;1351049;89853;68.4;66.4;4.4
13;2021-10-30;607;958;1582;1392246;1352007;91435;68.4;66.5;4.5
13;2021-10-31;65;93;128;1392311;1352100;91563;68.4;66.5;4.5
13;2021-11-01;184;166;104;1392495;1352266;91667;68.4;66.5;4.5
13;2021-11-02;811;1200;3260;1393306;1353466;94927;68.5;66.5;4.7
13;2021-11-03;937;1305;3758;1394243;1354771;98685;68.5;66.6;4.9
13;2021-11-04;863;1059;4008;1395106;1355830;102693;68.6;66.6;5.0
13;2021-11-05;969;1347;4439;1396075;1357177;107132;68.6;66.7;5.3
13;2021-11-06;666;920;2003;1396741;1358097;109135;68.7;66.8;5.4
13;2021-11-07;67;128;104;1396808;1358225;109239;68.7;66.8;5.4
13;2021-11-08;631;1061;3703;1397439;1359286;112942;68.7;66.8;5.6
13;2021-11-09;818;1305;5361;1398257;1360591;118303;68.7;66.9;5.8
13;2021-11-10;1053;1527;6476;1399310;1362118;124779;68.8;67.0;6.1
13;2021-11-11;150;206;750;1399460;1362324;125529;68.8;67.0;6.2
13;2021-11-12;856;1220;6460;1400316;1363544;131989;68.8;67.0;6.5
13;2021-11-13;578;784;2346;1400894;1364328;134335;68.9;67.1;6.6
13;2021-11-14;70;151;288;1400964;1364479;134623;68.9;67.1;6.6
13;2021-11-15;623;1053;4853;1401587;1365532;139476;68.9;67.1;6.9
13;2021-11-16;801;1120;6777;1402388;1366652;146253;68.9;67.2;7.2
13;2021-11-17;1017;1177;6968;1403405;1367829;153221;69.0;67.2;7.5
13;2021-11-18;840;1085;6668;1404245;1368914;159889;69.0;67.3;7.9
13;2021-11-19;991;1200;7674;1405236;1370114;167563;69.1;67.3;8.2
13;2021-11-20;809;948;3435;1406045;1371062;170998;69.1;67.4;8.4
13;2021-11-21;63;104;297;1406108;1371166;171295;69.1;67.4;8.4
13;2021-11-22;747;785;5544;1406855;1371951;176839;69.2;67.4;8.7
13;2021-11-23;859;996;7824;1407714;1372947;184663;69.2;67.5;9.1
13;2021-11-24;1136;1255;8100;1408850;1374202;192763;69.2;67.5;9.5
13;2021-11-25;902;1027;9595;1409752;1375229;202358;69.3;67.6;9.9
13;2021-11-26;1071;1143;11677;1410823;1376372;214035;69.3;67.7;10.5
13;2021-11-27;764;975;5993;1411587;1377347;220028;69.4;67.7;10.8
13;2021-11-28;48;136;453;1411635;1377483;220481;69.4;67.7;10.8
13;2021-11-29;821;927;12290;1412456;1378410;232771;69.4;67.8;11.4
13;2021-11-30;909;974;14554;1413365;1379384;247325;69.5;67.8;12.2
13;2021-12-01;961;1070;17202;1414326;1380454;264527;69.5;67.9;13.0
13;2021-12-02;873;941;16891;1415199;1381395;281418;69.6;67.9;13.8
13;2021-12-03;986;1240;20027;1416185;1382635;301445;69.6;68.0;14.8
13;2021-12-04;654;855;9798;1416839;1383490;311243;69.6;68.0;15.3
13;2021-12-05;109;177;1085;1416948;1383667;312328;69.6;68.0;15.4
13;2021-12-06;768;1000;16939;1417716;1384667;329267;69.7;68.1;16.2
13;2021-12-07;976;1160;21344;1418692;1385827;350611;69.7;68.1;17.2
13;2021-12-08;1082;1363;20439;1419774;1387190;371050;69.8;68.2;18.2
13;2021-12-09;913;1170;18555;1420687;1388360;389605;69.8;68.2;19.2
13;2021-12-10;1076;1275;22109;1421763;1389635;411714;69.9;68.3;20.2
13;2021-12-11;593;924;11543;1422356;1390559;423257;69.9;68.3;20.8
13;2021-12-12;126;182;1504;1422482;1390741;424761;69.9;68.4;20.9
13;2021-12-13;769;986;17423;1423251;1391727;442184;70.0;68.4;21.7
13;2021-12-14;1006;1207;22385;1424257;1392934;464569;70.0;68.5;22.8
13;2021-12-15;1123;1342;21629;1425380;1394276;486198;70.1;68.5;23.9
13;2021-12-16;1031;1208;19931;1426411;1395484;506129;70.1;68.6;24.9
14;2020-12-27;0;0;0;0;0;0;0.0;0.0;0.0
14;2020-12-28;1;0;0;1;0;0;0.0;0.0;0.0
14;2020-12-29;0;0;0;1;0;0;0.0;0.0;0.0
14;2020-12-30;0;0;0;1;0;0;0.0;0.0;0.0
14;2020-12-31;5;0;0;6;0;0;0.0;0.0;0.0
14;2021-01-01;3;0;0;9;0;0;0.0;0.0;0.0
14;2021-01-02;2;0;0;11;0;0;0.0;0.0;0.0
14;2021-01-03;0;0;0;11;0;0;0.0;0.0;0.0
14;2021-01-04;5;0;0;16;0;0;0.0;0.0;0.0
14;2021-01-05;28;0;0;44;0;0;0.0;0.0;0.0
14;2021-01-06;351;0;0;395;0;0;0.1;0.0;0.0
14;2021-01-07;421;1;0;816;1;0;0.1;0.0;0.0
14;2021-01-08;651;5;0;1467;6;0;0.2;0.0;0.0
14;2021-01-09;134;0;0;1601;6;0;0.2;0.0;0.0
14;2021-01-10;49;0;0;1650;6;0;0.2;0.0;0.0
14;2021-01-11;678;6;0;2328;12;0;0.3;0.0;0.0
14;2021-01-12;949;6;0;3277;18;0;0.5;0.0;0.0
14;2021-01-13;886;1;0;4163;19;0;0.6;0.0;0.0
14;2021-01-14;2747;29;0;6910;48;0;1.0;0.0;0.0
14;2021-01-15;1832;21;0;8742;69;0;1.3;0.0;0.0
14;2021-01-16;274;3;0;9016;72;0;1.3;0.0;0.0
14;2021-01-17;169;7;0;9185;79;0;1.3;0.0;0.0
14;2021-01-18;1084;6;0;10269;85;0;1.5;0.0;0.0
14;2021-01-19;1155;4;0;11424;89;0;1.7;0.0;0.0
14;2021-01-20;1901;5;0;13325;94;0;1.9;0.0;0.0
14;2021-01-21;1796;9;0;15121;103;0;2.2;0.0;0.0
14;2021-01-22;1432;7;0;16553;110;0;2.4;0.0;0.0
14;2021-01-23;299;1;0;16852;111;0;2.4;0.0;0.0
14;2021-01-24;98;0;0;16950;111;0;2.5;0.0;0.0
14;2021-01-25;929;14;0;17879;125;0;2.6;0.0;0.0
14;2021-01-26;839;42;0;18718;167;0;2.7;0.0;0.0
14;2021-01-27;856;161;0;19574;328;0;2.8;0.0;0.0
14;2021-01-28;755;160;0;20329;488;0;2.9;0.1;0.0
14;2021-01-29;728;245;0;21057;733;0;3.0;0.1;0.0
14;2021-01-30;271;18;0;21328;751;0;3.1;0.1;0.0
14;2021-01-31;62;6;0;21390;757;0;3.1;0.1;0.0
14;2021-02-01;691;233;0;22081;990;0;3.2;0.1;0.0
14;2021-02-02;731;414;0;22812;1404;0;3.3;0.2;0.0
14;2021-02-03;719;431;0;23531;1835;0;3.4;0.3;0.0
14;2021-02-04;1098;1954;0;24629;3789;0;3.6;0.5;0.0
14;2021-02-05;1223;1266;0;25852;5055;0;3.7;0.7;0.0
14;2021-02-06;391;223;0;26243;5278;0;3.8;0.8;0.0
14;2021-02-07;179;80;0;26422;5358;0;3.8;0.8;0.0
14;2021-02-08;728;824;0;27150;6182;0;3.9;0.9;0.0
14;2021-02-09;677;1016;0;27827;7198;0;4.0;1.0;0.0
14;2021-02-10;802;1576;0;28629;8774;0;4.1;1.3;0.0
14;2021-02-11;1281;1445;0;29910;10219;0;4.3;1.5;0.0
14;2021-02-12;1254;1081;0;31164;11300;0;4.5;1.6;0.0
14;2021-02-13;303;222;0;31467;11522;0;4.6;1.7;0.0
14;2021-02-14;84;87;0;31551;11609;0;4.6;1.7;0.0
14;2021-02-15;442;1060;0;31993;12669;0;4.6;1.8;0.0
14;2021-02-16;676;1005;0;32669;13674;0;4.7;2.0;0.0
14;2021-02-17;389;957;0;33058;14631;0;4.8;2.1;0.0
14;2021-02-18;718;882;0;33776;15513;0;4.9;2.2;0.0
14;2021-02-19;708;757;0;34484;16270;0;5.0;2.4;0.0
14;2021-02-20;95;276;0;34579;16546;0;5.0;2.4;0.0
14;2021-02-21;5;101;0;34584;16647;0;5.0;2.4;0.0
14;2021-02-22;416;975;0;35000;17622;0;5.1;2.5;0.0
14;2021-02-23;467;886;0;35467;18508;0;5.1;2.7;0.0
14;2021-02-24;439;888;0;35906;19396;0;5.2;2.8;0.0
14;2021-02-25;1187;1117;0;37093;20513;0;5.4;3.0;0.0
14;2021-02-26;1497;1106;0;38590;21619;0;5.6;3.1;0.0
14;2021-02-27;508;282;0;39098;21901;0;5.7;3.2;0.0
14;2021-02-28;33;49;0;39131;21950;0;5.7;3.2;0.0
14;2021-03-01;519;850;0;39650;22800;0;5.7;3.3;0.0
14;2021-03-02;979;770;0;40629;23570;0;5.9;3.4;0.0
14;2021-03-03;1061;798;0;41690;24368;0;6.0;3.5;0.0
14;2021-03-04;1916;784;0;43606;25152;0;6.3;3.6;0.0
14;2021-03-05;2420;803;0;46026;25955;0;6.7;3.8;0.0
14;2021-03-06;3000;202;0;49026;26157;0;7.1;3.8;0.0
14;2021-03-07;1158;67;0;50184;26224;0;7.3;3.8;0.0
14;2021-03-08;1177;772;0;51361;26996;0;7.4;3.9;0.0
14;2021-03-09;1752;675;0;53113;27671;0;7.7;4.0;0.0
14;2021-03-10;1798;577;0;54911;28248;0;7.9;4.1;0.0
14;2021-03-11;2705;456;0;57616;28704;0;8.3;4.2;0.0
14;2021-03-12;3842;541;0;61458;29245;0;8.9;4.2;0.0
14;2021-03-13;1930;177;0;63388;29422;0;9.2;4.3;0.0
14;2021-03-14;96;41;0;63484;29463;0;9.2;4.3;0.0
14;2021-03-15;1982;143;0;65466;29606;0;9.5;4.3;0.0
14;2021-03-16;1434;280;0;66900;29886;0;9.7;4.3;0.0
14;2021-03-17;1127;192;0;68027;30078;0;9.8;4.3;0.0
14;2021-03-18;1407;287;0;69434;30365;0;10.0;4.4;0.0
14;2021-03-19;2532;261;0;71966;30626;0;10.4;4.4;0.0
14;2021-03-20;2593;45;0;74559;30671;0;10.8;4.4;0.0
14;2021-03-21;480;10;0;75039;30681;0;10.9;4.4;0.0
14;2021-03-22;1813;365;0;76852;31046;0;11.1;4.5;0.0
14;2021-03-23;2202;332;0;79054;31378;0;11.4;4.5;0.0
14;2021-03-24;2430;207;0;81484;31585;0;11.8;4.6;0.0
14;2021-03-25;3212;327;0;84696;31912;0;12.2;4.6;0.0
14;2021-03-26;4464;459;0;89160;32371;0;12.9;4.7;0.0
14;2021-03-27;2337;210;0;91497;32581;0;13.2;4.7;0.0
14;2021-03-28;116;7;0;91613;32588;0;13.2;4.7;0.0
14;2021-03-29;1656;508;0;93269;33096;0;13.5;4.8;0.0
14;2021-03-30;2696;535;0;95965;33631;0;13.9;4.9;0.0
14;2021-03-31;2317;937;0;98282;34568;0;14.2;5.0;0.0
14;2021-04-01;4073;1667;0;102355;36235;0;14.8;5.2;0.0
14;2021-04-02;3700;1262;0;106055;37497;0;15.3;5.4;0.0
14;2021-04-03;1110;1173;0;107165;38670;0;15.5;5.6;0.0
14;2021-04-04;53;443;0;107218;39113;0;15.5;5.7;0.0
14;2021-04-05;1133;304;0;108351;39417;0;15.7;5.7;0.0
14;2021-04-06;2339;1037;0;110690;40454;0;16.0;5.9;0.0
14;2021-04-07;2568;1040;0;113258;41494;0;16.4;6.0;0.0
14;2021-04-08;4121;1131;0;117379;42625;0;17.0;6.2;0.0
14;2021-04-09;5675;1119;0;123054;43744;0;17.8;6.3;0.0
14;2021-04-10;2860;462;0;125914;44206;0;18.2;6.4;0.0
14;2021-04-11;593;156;0;126507;44362;0;18.3;6.4;0.0
14;2021-04-12;2761;1560;0;129268;45922;0;18.7;6.6;0.0
14;2021-04-13;3334;1461;0;132602;47383;0;19.2;6.9;0.0
14;2021-04-14;2948;1148;0;135550;48531;0;19.6;7.0;0.0
14;2021-04-15;4242;1467;0;139792;49998;0;20.2;7.2;0.0
14;2021-04-16;4369;1504;0;144161;51502;0;20.8;7.4;0.0
14;2021-04-17;2349;1623;0;146510;53125;0;21.2;7.7;0.0
14;2021-04-18;519;344;0;147029;53469;0;21.3;7.7;0.0
14;2021-04-19;2644;1646;0;149673;55115;0;21.6;8.0;0.0
14;2021-04-20;3268;1861;0;152941;56976;0;22.1;8.2;0.0
14;2021-04-21;2837;1459;0;155778;58435;0;22.5;8.5;0.0
14;2021-04-22;4002;2070;0;159780;60505;0;23.1;8.8;0.0
14;2021-04-23;4433;2249;0;164213;62754;0;23.7;9.1;0.0
14;2021-04-24;1855;1793;0;166068;64547;0;24.0;9.3;0.0
14;2021-04-25;462;79;0;166530;64626;0;24.1;9.3;0.0
14;2021-04-26;3152;1566;0;169682;66192;0;24.5;9.6;0.0
14;2021-04-27;3382;2499;0;173064;68691;0;25.0;9.9;0.0
14;2021-04-28;3110;1838;0;176174;70529;0;25.5;10.2;0.0
14;2021-04-29;4308;2259;0;180482;72788;0;26.1;10.5;0.0
14;2021-04-30;4872;2603;0;185354;75391;0;26.8;10.9;0.0
14;2021-05-01;3496;222;0;188850;75613;0;27.3;10.9;0.0
14;2021-05-02;1227;76;0;190077;75689;0;27.5;10.9;0.0
14;2021-05-03;2277;2653;0;192354;78342;0;27.8;11.3;0.0
14;2021-05-04;2925;2858;0;195279;81200;0;28.2;11.7;0.0
14;2021-05-05;3523;2593;0;198802;83793;0;28.8;12.1;0.0
14;2021-05-06;4680;3384;0;203482;87177;0;29.4;12.6;0.0
14;2021-05-07;4552;3639;0;208034;90816;0;30.1;13.1;0.0
14;2021-05-08;2788;1220;0;210822;92036;0;30.5;13.3;0.0
14;2021-05-09;1879;615;0;212701;92651;0;30.8;13.4;0.0
14;2021-05-10;3432;3034;0;216133;95685;0;31.3;13.8;0.0
14;2021-05-11;4094;3459;0;220227;99144;0;31.8;14.3;0.0
14;2021-05-12;3961;3103;0;224188;102247;0;32.4;14.8;0.0
14;2021-05-13;4303;1047;0;228491;103294;0;33.0;14.9;0.0
14;2021-05-14;6212;2482;0;234703;105776;0;33.9;15.3;0.0
14;2021-05-15;5109;841;0;239812;106617;0;34.7;15.4;0.0
14;2021-05-16;2381;136;0;242193;106753;0;35.0;15.4;0.0
14;2021-05-17;2750;2122;0;244943;108875;0;35.4;15.7;0.0
14;2021-05-18;3901;2143;0;248844;111018;0;36.0;16.1;0.0
14;2021-05-19;3747;1951;0;252591;112969;0;36.5;16.3;0.0
14;2021-05-20;4383;2621;0;256974;115590;0;37.2;16.7;0.0
14;2021-05-21;4124;3319;0;261098;118909;0;37.8;17.2;0.0
14;2021-05-22;1861;865;0;262959;119774;0;38.0;17.3;0.0
14;2021-05-23;831;83;0;263790;119857;0;38.2;17.3;0.0
14;2021-05-24;2751;688;0;266541;120545;0;38.5;17.4;0.0
14;2021-05-25;3521;3267;0;270062;123812;0;39.1;17.9;0.0
14;2021-05-26;3333;2301;0;273395;126113;0;39.5;18.2;0.0
14;2021-05-27;4530;3144;0;277925;129257;0;40.2;18.7;0.0
14;2021-05-28;4802;3712;0;282727;132969;0;40.9;19.2;0.0
14;2021-05-29;2372;2465;0;285099;135434;0;41.2;19.6;0.0
14;2021-05-30;845;268;0;285944;135702;0;41.4;19.6;0.0
14;2021-05-31;3861;2830;0;289805;138532;0;41.9;20.0;0.0
14;2021-06-01;5382;3121;0;295187;141653;0;42.7;20.5;0.0
14;2021-06-02;4728;2743;0;299915;144396;0;43.4;20.9;0.0
14;2021-06-03;6165;3908;0;306080;148304;0;44.3;21.4;0.0
14;2021-06-04;6056;4928;0;312136;153232;0;45.1;22.2;0.0
14;2021-06-05;4169;1829;0;316305;155061;0;45.7;22.4;0.0
14;2021-06-06;2019;137;0;318324;155198;0;46.0;22.4;0.0
14;2021-06-07;4123;3263;0;322447;158461;0;46.6;22.9;0.0
14;2021-06-08;4924;2966;0;327371;161427;0;47.3;23.3;0.0
14;2021-06-09;4028;2871;0;331399;164298;0;47.9;23.8;0.0
14;2021-06-10;4786;2905;0;336185;167203;0;48.6;24.2;0.0
14;2021-06-11;4639;4674;0;340824;171877;0;49.3;24.9;0.0
14;2021-06-12;3562;4483;0;344386;176360;0;49.8;25.5;0.0
14;2021-06-13;933;1149;0;345319;177509;0;49.9;25.7;0.0
14;2021-06-14;2205;3514;0;347524;181023;0;50.3;26.2;0.0
14;2021-06-15;3194;3727;0;350718;184750;0;50.7;26.7;0.0
14;2021-06-16;3334;4388;0;354052;189138;0;51.2;27.4;0.0
14;2021-06-17;4036;5088;0;358088;194226;0;51.8;28.1;0.0
14;2021-06-18;3671;5824;0;361759;200050;0;52.3;28.9;0.0
14;2021-06-19;2603;2966;0;364362;203016;0;52.7;29.4;0.0
14;2021-06-20;643;1601;0;365005;204617;0;52.8;29.6;0.0
14;2021-06-21;2062;4149;0;367067;208766;0;53.1;30.2;0.0
14;2021-06-22;2444;4981;0;369511;213747;0;53.4;30.9;0.0
14;2021-06-23;2436;4248;0;371947;217995;0;53.8;31.5;0.0
14;2021-06-24;3282;5599;0;375229;223594;0;54.3;32.3;0.0
14;2021-06-25;2643;6951;0;377872;230545;0;54.6;33.3;0.0
14;2021-06-26;2103;4589;0;379975;235134;0;55.0;34.0;0.0
14;2021-06-27;468;1975;0;380443;237109;0;55.0;34.3;0.0
14;2021-06-28;1276;3837;0;381719;240946;0;55.2;34.8;0.0
14;2021-06-29;1721;5126;0;383440;246072;0;55.5;35.6;0.0
14;2021-06-30;1908;4591;0;385348;250663;0;55.7;36.3;0.0
14;2021-07-01;2820;5082;0;388168;255745;0;56.1;37.0;0.0
14;2021-07-02;2462;6405;0;390630;262150;0;56.5;37.9;0.0
14;2021-07-03;1406;2798;0;392036;264948;0;56.7;38.3;0.0
14;2021-07-04;466;909;0;392502;265857;0;56.8;38.4;0.0
14;2021-07-05;1193;4595;0;393695;270452;0;56.9;39.1;0.0
14;2021-07-06;2031;5816;0;395726;276268;0;57.2;40.0;0.0
14;2021-07-07;2140;4390;0;397866;280658;0;57.5;40.6;0.0
14;2021-07-08;2754;5367;0;400620;286025;0;57.9;41.4;0.0
14;2021-07-09;2665;6148;0;403285;292173;0;58.3;42.3;0.0
14;2021-07-10;1935;3234;0;405220;295407;0;58.6;42.7;0.0
14;2021-07-11;928;978;0;406148;296385;0;58.7;42.9;0.0
14;2021-07-12;1523;5656;0;407671;302041;0;59.0;43.7;0.0
14;2021-07-13;2931;7103;0;410602;309144;0;59.4;44.7;0.0
14;2021-07-14;2159;2892;0;412761;312036;0;59.7;45.1;0.0
14;2021-07-15;3909;7246;0;416670;319282;0;60.3;46.2;0.0
14;2021-07-16;4542;7298;0;421212;326580;0;60.9;47.2;0.0
14;2021-07-17;2101;4038;0;423313;330618;0;61.2;47.8;0.0
14;2021-07-18;819;1930;0;424132;332548;0;61.3;48.1;0.0
14;2021-07-19;2578;5810;0;426710;338358;0;61.7;48.9;0.0
14;2021-07-20;3245;6878;0;429955;345236;0;62.2;49.9;0.0
14;2021-07-21;3978;5594;0;433933;350830;0;62.8;50.7;0.0
14;2021-07-22;4851;6209;0;438784;357039;0;63.5;51.6;0.0
14;2021-07-23;5175;6491;0;443959;363530;0;64.2;52.6;0.0
14;2021-07-24;2900;3668;0;446859;367198;0;64.6;53.1;0.0
14;2021-07-25;1459;1308;0;448318;368506;0;64.8;53.3;0.0
14;2021-07-26;4328;3942;0;452646;372448;0;65.5;53.9;0.0
14;2021-07-27;5078;4218;0;457724;376666;0;66.2;54.5;0.0
14;2021-07-28;4914;3804;0;462638;380470;0;66.9;55.0;0.0
14;2021-07-29;6079;4625;0;468717;385095;0;67.8;55.7;0.0
14;2021-07-30;5462;4770;0;474179;389865;0;68.6;56.4;0.0
14;2021-07-31;2738;2446;0;476917;392311;0;69.0;56.7;0.0
14;2021-08-01;1793;943;0;478710;393254;0;69.2;56.9;0.0
14;2021-08-02;3666;4028;0;482376;397282;0;69.8;57.5;0.0
14;2021-08-03;4248;3869;0;486624;401151;0;70.4;58.0;0.0
14;2021-08-04;4209;3314;0;490833;404465;0;71.0;58.5;0.0
14;2021-08-05;4320;3795;0;495153;408260;0;71.6;59.0;0.0
14;2021-08-06;4027;4540;0;499180;412800;0;72.2;59.7;0.0
14;2021-08-07;1944;2171;0;501124;414971;0;72.5;60.0;0.0
14;2021-08-08;673;891;0;501797;415862;0;72.6;60.1;0.0
14;2021-08-09;2074;2832;0;503871;418694;0;72.9;60.6;0.0
14;2021-08-10;3358;3802;0;507229;422496;0;73.4;61.1;0.0
14;2021-08-11;2807;3193;0;510036;425689;0;73.8;61.6;0.0
14;2021-08-12;3097;4179;0;513133;429868;0;74.2;62.2;0.0
14;2021-08-13;2401;3957;0;515534;433825;0;74.6;62.7;0.0
14;2021-08-14;1291;1912;0;516825;435737;0;74.7;63.0;0.0
14;2021-08-15;365;1414;0;517190;437151;0;74.8;63.2;0.0
14;2021-08-16;1692;2813;0;518882;439964;0;75.0;63.6;0.0
14;2021-08-17;2064;4342;0;520946;444306;0;75.3;64.3;0.0
14;2021-08-18;1865;4278;0;522811;448584;0;75.6;64.9;0.0
14;2021-08-19;2147;4843;0;524958;453427;0;75.9;65.6;0.0
14;2021-08-20;1970;5129;0;526928;458556;0;76.2;66.3;0.0
14;2021-08-21;933;2784;0;527861;461340;0;76.3;66.7;0.0
14;2021-08-22;195;1628;0;528056;462968;0;76.4;67.0;0.0
14;2021-08-23;1145;4059;0;529201;467027;0;76.5;67.5;0.0
14;2021-08-24;1246;4211;0;530447;471238;0;76.7;68.2;0.0
14;2021-08-25;1299;4022;0;531746;475260;0;76.9;68.7;0.0
14;2021-08-26;1322;4686;0;533068;479946;0;77.1;69.4;0.0
14;2021-08-27;1348;4974;0;534416;484920;0;77.3;70.1;0.0
14;2021-08-28;714;2821;0;535130;487741;0;77.4;70.5;0.0
14;2021-08-29;201;1049;0;535331;488790;0;77.4;70.7;0.0
14;2021-08-30;921;3386;70;536252;492176;70;77.6;71.2;0.0
14;2021-08-31;1225;4432;153;537477;496608;223;77.7;71.8;0.0
14;2021-09-01;1002;3417;349;538479;500025;572;77.9;72.3;0.1
14;2021-09-02;816;2814;312;539295;502839;884;78.0;72.7;0.1
14;2021-09-03;1053;3502;478;540348;506341;1362;78.1;73.2;0.2
14;2021-09-04;677;2204;144;541025;508545;1506;78.2;73.5;0.2
14;2021-09-05;145;432;54;541170;508977;1560;78.3;73.6;0.2
14;2021-09-06;448;1735;375;541618;510712;1935;78.3;73.9;0.3
14;2021-09-07;474;1800;347;542092;512512;2282;78.4;74.1;0.3
14;2021-09-08;647;2536;429;542739;515048;2711;78.5;74.5;0.4
14;2021-09-09;568;1676;398;543307;516724;3109;78.6;74.7;0.4
14;2021-09-10;732;2291;579;544039;519015;3688;78.7;75.1;0.5
14;2021-09-11;512;1428;142;544551;520443;3830;78.8;75.3;0.6
14;2021-09-12;72;265;51;544623;520708;3881;78.8;75.3;0.6
14;2021-09-13;319;1085;505;544942;521793;4386;78.8;75.5;0.6
14;2021-09-14;634;1226;837;545576;523019;5223;78.9;75.6;0.8
14;2021-09-15;690;1867;711;546266;524886;5934;79.0;75.9;0.9
14;2021-09-16;530;1178;743;546796;526064;6677;79.1;76.1;1.0
14;2021-09-17;569;1324;634;547365;527388;7311;79.2;76.3;1.1
14;2021-09-18;249;985;110;547614;528373;7421;79.2;76.4;1.1
14;2021-09-19;45;150;10;547659;528523;7431;79.2;76.4;1.1
14;2021-09-20;331;729;705;547990;529252;8136;79.3;76.5;1.2
14;2021-09-21;465;766;841;548455;530018;8977;79.3;76.7;1.3
14;2021-09-22;405;1568;809;548860;531586;9786;79.4;76.9;1.4
14;2021-09-23;396;723;772;549256;532309;10558;79.4;77.0;1.5
14;2021-09-24;412;1229;928;549668;533538;11486;79.5;77.2;1.7
14;2021-09-25;200;713;117;549868;534251;11603;79.5;77.3;1.7
14;2021-09-26;41;144;18;549909;534395;11621;79.5;77.3;1.7
14;2021-09-27;270;681;645;550179;535076;12266;79.6;77.4;1.8
14;2021-09-28;344;640;669;550523;535716;12935;79.6;77.5;1.9
14;2021-09-29;300;882;628;550823;536598;13563;79.7;77.6;2.0
14;2021-09-30;313;616;896;551136;537214;14459;79.7;77.7;2.1
14;2021-10-01;440;788;625;551576;538002;15084;79.8;77.8;2.2
14;2021-10-02;264;546;189;551840;538548;15273;79.8;77.9;2.2
14;2021-10-03;35;67;13;551875;538615;15286;79.8;77.9;2.2
14;2021-10-04;266;460;671;552141;539075;15957;79.9;78.0;2.3
14;2021-10-05;261;452;793;552402;539527;16750;79.9;78.0;2.4
14;2021-10-06;366;767;790;552768;540294;17540;79.9;78.1;2.5
14;2021-10-07;218;409;642;552986;540703;18182;80.0;78.2;2.6
14;2021-10-08;380;761;947;553366;541464;19129;80.0;78.3;2.8
14;2021-10-09;193;356;150;553559;541820;19279;80.1;78.4;2.8
14;2021-10-10;8;8;5;553567;541828;19284;80.1;78.4;2.8
14;2021-10-11;173;447;635;553740;542275;19919;80.1;78.4;2.9
14;2021-10-12;287;555;1027;554027;542830;20946;80.1;78.5;3.0
14;2021-10-13;329;471;818;554356;543301;21764;80.2;78.6;3.1
14;2021-10-14;198;418;731;554554;543719;22495;80.2;78.6;3.3
14;2021-10-15;420;551;1373;554974;544270;23868;80.3;78.7;3.5
14;2021-10-16;185;261;552;555159;544531;24420;80.3;78.8;3.5
14;2021-10-17;3;9;11;555162;544540;24431;80.3;78.8;3.5
14;2021-10-18;199;327;729;555361;544867;25160;80.3;78.8;3.6
14;2021-10-19;194;405;981;555555;545272;26141;80.3;78.9;3.8
14;2021-10-20;217;326;901;555772;545598;27042;80.4;78.9;3.9
14;2021-10-21;216;459;975;555988;546057;28017;80.4;79.0;4.1
14;2021-10-22;344;473;1374;556332;546530;29391;80.5;79.0;4.3
14;2021-10-23;166;247;309;556498;546777;29700;80.5;79.1;4.3
14;2021-10-24;10;11;78;556508;546788;29778;80.5;79.1;4.3
14;2021-10-25;194;272;1233;556702;547060;31011;80.5;79.1;4.5
14;2021-10-26;181;218;949;556883;547278;31960;80.5;79.1;4.6
14;2021-10-27;202;436;1448;557085;547714;33408;80.6;79.2;4.8
14;2021-10-28;139;162;823;557224;547876;34231;80.6;79.2;5.0
14;2021-10-29;282;412;1733;557506;548288;35964;80.6;79.3;5.2
14;2021-10-30;97;188;238;557603;548476;36202;80.6;79.3;5.2
14;2021-10-31;2;7;15;557605;548483;36217;80.6;79.3;5.2
14;2021-11-01;6;4;10;557611;548487;36227;80.6;79.3;5.2
14;2021-11-02;184;298;1025;557795;548785;37252;80.7;79.4;5.4
14;2021-11-03;219;319;1443;558014;549104;38695;80.7;79.4;5.6
14;2021-11-04;156;218;1220;558170;549322;39915;80.7;79.4;5.8
14;2021-11-05;257;365;1825;558427;549687;41740;80.8;79.5;6.0
14;2021-11-06;88;150;326;558515;549837;42066;80.8;79.5;6.1
14;2021-11-07;11;14;16;558526;549851;42082;80.8;79.5;6.1
14;2021-11-08;109;243;1709;558635;550094;43791;80.8;79.6;6.3
14;2021-11-09;180;316;2328;558815;550410;46119;80.8;79.6;6.7
14;2021-11-10;259;386;2168;559074;550796;48287;80.9;79.7;7.0
14;2021-11-11;18;22;41;559092;550818;48328;80.9;79.7;7.0
14;2021-11-12;241;376;2138;559333;551194;50466;80.9;79.7;7.3
14;2021-11-13;128;210;696;559461;551404;51162;80.9;79.7;7.4
14;2021-11-14;8;11;30;559469;551415;51192;80.9;79.7;7.4
14;2021-11-15;134;262;2399;559603;551677;53591;80.9;79.8;7.8
14;2021-11-16;173;205;2577;559776;551882;56168;81.0;79.8;8.1
14;2021-11-17;260;312;2838;560036;552194;59006;81.0;79.9;8.5
14;2021-11-18;173;220;2235;560209;552414;61241;81.0;79.9;8.9
14;2021-11-19;359;434;4028;560568;552848;65269;81.1;80.0;9.4
14;2021-11-20;150;157;822;560718;553005;66091;81.1;80.0;9.6
14;2021-11-21;15;19;42;560733;553024;66133;81.1;80.0;9.6
14;2021-11-22;138;139;2391;560871;553163;68524;81.1;80.0;9.9
14;2021-11-23;231;164;3382;561102;553327;71906;81.1;80.0;10.4
14;2021-11-24;333;307;2876;561435;553634;74782;81.2;80.1;10.8
14;2021-11-25;177;141;2650;561612;553775;77432;81.2;80.1;11.2
14;2021-11-26;292;353;6061;561904;554128;83493;81.3;80.1;12.1
14;2021-11-27;146;170;2809;562050;554298;86302;81.3;80.2;12.5
14;2021-11-28;45;24;1570;562095;554322;87872;81.3;80.2;12.7
14;2021-11-29;128;159;4274;562223;554481;92146;81.3;80.2;13.3
14;2021-11-30;238;217;7157;562461;554698;99303;81.3;80.2;14.4
14;2021-12-01;235;222;7158;562696;554920;106461;81.4;80.3;15.4
14;2021-12-02;193;165;7992;562889;555085;114453;81.4;80.3;16.6
14;2021-12-03;211;247;10317;563100;555332;124770;81.4;80.3;18.0
14;2021-12-04;106;136;3918;563206;555468;128688;81.5;80.3;18.6
14;2021-12-05;33;25;2159;563239;555493;130847;81.5;80.3;18.9
14;2021-12-06;116;146;5392;563355;555639;136239;81.5;80.4;19.7
14;2021-12-07;206;200;8774;563561;555839;145013;81.5;80.4;21.0
14;2021-12-08;190;229;7436;563751;556068;152449;81.5;80.4;22.0
14;2021-12-09;195;200;8546;563946;556268;160995;81.6;80.4;23.3
14;2021-12-10;239;345;10477;564185;556613;171472;81.6;80.5;24.8
14;2021-12-11;98;131;3604;564283;556744;175076;81.6;80.5;25.3
14;2021-12-12;48;52;2108;564331;556796;177184;81.6;80.5;25.6
14;2021-12-13;146;185;6498;564477;556981;183682;81.6;80.6;26.6
14;2021-12-14;213;263;9776;564690;557244;193458;81.7;80.6;28.0
14;2021-12-15;206;302;8670;564896;557546;202128;81.7;80.6;29.2
14;2021-12-16;189;217;9010;565085;557763;211138;81.7;80.7;30.5
15;2020-12-27;0;0;0;0;0;0;0.0;0.0;0.0
15;2020-12-28;0;0;0;0;0;0;0.0;0.0;0.0
15;2020-12-29;0;0;0;0;0;0;0.0;0.0;0.0
15;2020-12-30;0;0;0;0;0;0;0.0;0.0;0.0
15;2020-12-31;0;0;0;0;0;0;0.0;0.0;0.0
15;2021-01-01;1;0;0;1;0;0;0.0;0.0;0.0
15;2021-01-02;0;0;0;1;0;0;0.0;0.0;0.0
15;2021-01-03;0;0;0;1;0;0;0.0;0.0;0.0
15;2021-01-04;0;0;0;1;0;0;0.0;0.0;0.0
15;2021-01-05;0;0;0;1;0;0;0.0;0.0;0.0
15;2021-01-06;1;0;0;2;0;0;0.0;0.0;0.0
15;2021-01-07;71;1;0;73;1;0;0.1;0.0;0.0
15;2021-01-08;102;2;0;175;3;0;0.1;0.0;0.0
15;2021-01-09;1;0;0;176;3;0;0.1;0.0;0.0
15;2021-01-10;3;0;0;179;3;0;0.1;0.0;0.0
15;2021-01-11;95;1;0;274;4;0;0.2;0.0;0.0
15;2021-01-12;98;0;0;372;4;0;0.3;0.0;0.0
15;2021-01-13;246;0;0;618;4;0;0.4;0.0;0.0
15;2021-01-14;305;5;0;923;9;0;0.6;0.0;0.0
15;2021-01-15;137;0;0;1060;9;0;0.7;0.0;0.0
15;2021-01-16;83;0;0;1143;9;0;0.8;0.0;0.0
15;2021-01-17;0;0;0;1143;9;0;0.8;0.0;0.0
15;2021-01-18;384;2;0;1527;11;0;1.1;0.0;0.0
15;2021-01-19;483;0;0;2010;11;0;1.4;0.0;0.0
15;2021-01-20;577;2;0;2587;13;0;1.8;0.0;0.0
15;2021-01-21;522;4;0;3109;17;0;2.2;0.0;0.0
15;2021-01-22;496;4;0;3605;21;0;2.5;0.0;0.0
15;2021-01-23;400;1;0;4005;22;0;2.8;0.0;0.0
15;2021-01-24;4;0;0;4009;22;0;2.8;0.0;0.0
15;2021-01-25;382;0;0;4391;22;0;3.1;0.0;0.0
15;2021-01-26;418;0;0;4809;22;0;3.4;0.0;0.0
15;2021-01-27;755;8;0;5564;30;0;3.9;0.0;0.0
15;2021-01-28;628;50;0;6192;80;0;4.3;0.1;0.0
15;2021-01-29;332;73;0;6524;153;0;4.6;0.1;0.0
15;2021-01-30;200;2;0;6724;155;0;4.7;0.1;0.0
15;2021-01-31;0;0;0;6724;155;0;4.7;0.1;0.0
15;2021-02-01;230;90;0;6954;245;0;4.9;0.2;0.0
15;2021-02-02;177;86;0;7131;331;0;5.0;0.2;0.0
15;2021-02-03;263;177;0;7394;508;0;5.2;0.4;0.0
15;2021-02-04;621;196;0;8015;704;0;5.6;0.5;0.0
15;2021-02-05;277;236;0;8292;940;0;5.8;0.7;0.0
15;2021-02-06;89;70;0;8381;1010;0;5.9;0.7;0.0
15;2021-02-07;0;0;0;8381;1010;0;5.9;0.7;0.0
15;2021-02-08;220;106;0;8601;1116;0;6.0;0.8;0.0
15;2021-02-09;192;100;0;8793;1216;0;6.2;0.9;0.0
15;2021-02-10;339;234;0;9132;1450;0;6.4;1.0;0.0
15;2021-02-11;132;211;0;9264;1661;0;6.5;1.2;0.0
15;2021-02-12;141;164;0;9405;1825;0;6.6;1.3;0.0
15;2021-02-13;91;74;0;9496;1899;0;6.6;1.3;0.0
15;2021-02-14;0;0;0;9496;1899;0;6.6;1.3;0.0
15;2021-02-15;62;216;0;9558;2115;0;6.7;1.5;0.0
15;2021-02-16;54;278;0;9612;2393;0;6.7;1.7;0.0
15;2021-02-17;130;448;0;9742;2841;0;6.8;2.0;0.0
15;2021-02-18;105;738;0;9847;3579;0;6.9;2.5;0.0
15;2021-02-19;101;421;0;9948;4000;0;7.0;2.8;0.0
15;2021-02-20;19;242;0;9967;4242;0;7.0;3.0;0.0
15;2021-02-21;0;1;0;9967;4243;0;7.0;3.0;0.0
15;2021-02-22;25;485;0;9992;4728;0;7.0;3.3;0.0
15;2021-02-23;181;448;0;10173;5176;0;7.1;3.6;0.0
15;2021-02-24;48;426;0;10221;5602;0;7.2;3.9;0.0
15;2021-02-25;220;949;0;10441;6551;0;7.3;4.6;0.0
15;2021-02-26;176;446;0;10617;6997;0;7.4;4.9;0.0
15;2021-02-27;123;81;0;10740;7078;0;7.5;5.0;0.0
15;2021-02-28;1;0;0;10741;7078;0;7.5;5.0;0.0
15;2021-03-01;112;214;0;10853;7292;0;7.6;5.1;0.0
15;2021-03-02;249;300;0;11102;7592;0;7.8;5.3;0.0
15;2021-03-03;237;37;0;11339;7629;0;7.9;5.3;0.0
15;2021-03-04;253;265;0;11592;7894;0;8.1;5.5;0.0
15;2021-03-05;348;162;0;11940;8056;0;8.4;5.6;0.0
15;2021-03-06;669;14;0;12609;8070;0;8.8;5.7;0.0
15;2021-03-07;98;3;0;12707;8073;0;8.9;5.7;0.0
15;2021-03-08;102;106;0;12809;8179;0;9.0;5.7;0.0
15;2021-03-09;293;282;0;13102;8461;0;9.2;5.9;0.0
15;2021-03-10;455;174;0;13557;8635;0;9.5;6.0;0.0
15;2021-03-11;417;307;0;13974;8942;0;9.8;6.3;0.0
15;2021-03-12;536;102;0;14510;9044;0;10.2;6.3;0.0
15;2021-03-13;354;9;0;14864;9053;0;10.4;6.3;0.0
15;2021-03-14;18;1;0;14882;9054;0;10.4;6.3;0.0
15;2021-03-15;557;60;0;15439;9114;0;10.8;6.4;0.0
15;2021-03-16;333;31;0;15772;9145;0;11.0;6.4;0.0
15;2021-03-17;204;42;0;15976;9187;0;11.2;6.4;0.0
15;2021-03-18;245;113;0;16221;9300;0;11.4;6.5;0.0
15;2021-03-19;698;48;0;16919;9348;0;11.8;6.5;0.0
15;2021-03-20;140;34;0;17059;9382;0;11.9;6.6;0.0
15;2021-03-21;7;0;0;17066;9382;0;12.0;6.6;0.0
15;2021-03-22;591;79;0;17657;9461;0;12.4;6.6;0.0
15;2021-03-23;774;100;0;18431;9561;0;12.9;6.7;0.0
15;2021-03-24;923;44;0;19354;9605;0;13.6;6.7;0.0
15;2021-03-25;1245;50;0;20599;9655;0;14.4;6.8;0.0
15;2021-03-26;1003;66;0;21602;9721;0;15.1;6.8;0.0
15;2021-03-27;311;8;0;21913;9729;0;15.3;6.8;0.0
15;2021-03-28;25;0;0;21938;9729;0;15.4;6.8;0.0
15;2021-03-29;734;24;0;22672;9753;0;15.9;6.8;0.0
15;2021-03-30;1097;191;0;23769;9944;0;16.6;7.0;0.0
15;2021-03-31;928;41;0;24697;9985;0;17.3;7.0;0.0
15;2021-04-01;1199;103;0;25896;10088;0;18.1;7.1;0.0
15;2021-04-02;1083;70;0;26979;10158;0;18.9;7.1;0.0
15;2021-04-03;133;24;0;27112;10182;0;19.0;7.1;0.0
15;2021-04-04;4;0;0;27116;10182;0;19.0;7.1;0.0
15;2021-04-05;37;2;0;27153;10184;0;19.0;7.1;0.0
15;2021-04-06;783;102;0;27936;10286;0;19.6;7.2;0.0
15;2021-04-07;679;105;0;28615;10391;0;20.0;7.3;0.0
15;2021-04-08;1135;187;0;29750;10578;0;20.8;7.4;0.0
15;2021-04-09;1171;126;0;30921;10704;0;21.7;7.5;0.0
15;2021-04-10;341;41;0;31262;10745;0;21.9;7.5;0.0
15;2021-04-11;35;2;0;31297;10747;0;21.9;7.5;0.0
15;2021-04-12;611;462;0;31908;11209;0;22.3;7.8;0.0
15;2021-04-13;1087;333;0;32995;11542;0;23.1;8.1;0.0
15;2021-04-14;1012;238;0;34007;11780;0;23.8;8.2;0.0
15;2021-04-15;1124;342;0;35131;12122;0;24.6;8.5;0.0
15;2021-04-16;977;562;0;36108;12684;0;25.3;8.9;0.0
15;2021-04-17;414;23;0;36522;12707;0;25.6;8.9;0.0
15;2021-04-18;11;12;0;36533;12719;0;25.6;8.9;0.0
15;2021-04-19;527;529;0;37060;13248;0;26.0;9.3;0.0
15;2021-04-20;798;617;0;37858;13865;0;26.5;9.7;0.0
15;2021-04-21;608;599;0;38466;14464;0;26.9;10.1;0.0
15;2021-04-22;674;789;0;39140;15253;0;27.4;10.7;0.0
15;2021-04-23;719;649;0;39859;15902;0;27.9;11.1;0.0
15;2021-04-24;376;138;0;40235;16040;0;28.2;11.2;0.0
15;2021-04-25;9;9;0;40244;16049;0;28.2;11.2;0.0
15;2021-04-26;328;601;0;40572;16650;0;28.4;11.7;0.0
15;2021-04-27;489;874;0;41061;17524;0;28.8;12.3;0.0
15;2021-04-28;430;755;0;41491;18279;0;29.1;12.8;0.0
15;2021-04-29;647;999;0;42138;19278;0;29.5;13.5;0.0
15;2021-04-30;556;1029;0;42694;20307;0;29.9;14.2;0.0
15;2021-05-01;324;35;0;43018;20342;0;30.1;14.2;0.0
15;2021-05-02;38;5;0;43056;20347;0;30.1;14.2;0.0
15;2021-05-03;849;320;0;43905;20667;0;30.7;14.5;0.0
15;2021-05-04;789;792;0;44694;21459;0;31.3;15.0;0.0
15;2021-05-05;701;653;0;45395;22112;0;31.8;15.5;0.0
15;2021-05-06;857;913;0;46252;23025;0;32.4;16.1;0.0
15;2021-05-07;1115;841;0;47367;23866;0;33.2;16.7;0.0
15;2021-05-08;506;68;0;47873;23934;0;33.5;16.8;0.0
15;2021-05-09;45;25;0;47918;23959;0;33.6;16.8;0.0
15;2021-05-10;627;844;0;48545;24803;0;34.0;17.4;0.0
15;2021-05-11;1111;1140;0;49656;25943;0;34.8;18.2;0.0
15;2021-05-12;1080;813;0;50736;26756;0;35.5;18.7;0.0
15;2021-05-13;1082;398;0;51818;27154;0;36.3;19.0;0.0
15;2021-05-14;1422;562;0;53240;27716;0;37.3;19.4;0.0
15;2021-05-15;1294;396;0;54534;28112;0;38.2;19.7;0.0
15;2021-05-16;23;15;0;54557;28127;0;38.2;19.7;0.0
15;2021-05-17;1029;578;0;55586;28705;0;38.9;20.1;0.0
15;2021-05-18;1212;884;0;56798;29589;0;39.8;20.7;0.0
15;2021-05-19;1050;455;0;57848;30044;0;40.5;21.0;0.0
15;2021-05-20;1230;757;0;59078;30801;0;41.4;21.6;0.0
15;2021-05-21;1322;702;0;60400;31503;0;42.3;22.1;0.0
15;2021-05-22;508;182;0;60908;31685;0;42.6;22.2;0.0
15;2021-05-23;26;19;0;60934;31704;0;42.7;22.2;0.0
15;2021-05-24;671;241;0;61605;31945;0;43.1;22.4;0.0
15;2021-05-25;1124;602;0;62729;32547;0;43.9;22.8;0.0
15;2021-05-26;1094;479;0;63823;33026;0;44.7;23.1;0.0
15;2021-05-27;1268;690;0;65091;33716;0;45.6;23.6;0.0
15;2021-05-28;1468;893;0;66559;34609;0;46.6;24.2;0.0
15;2021-05-29;930;355;0;67489;34964;0;47.3;24.5;0.0
15;2021-05-30;55;34;0;67544;34998;0;47.3;24.5;0.0
15;2021-05-31;1156;488;0;68700;35486;0;48.1;24.8;0.0
15;2021-06-01;1332;580;0;70032;36066;0;49.0;25.3;0.0
15;2021-06-02;859;433;0;70891;36499;0;49.6;25.6;0.0
15;2021-06-03;904;734;0;71795;37233;0;50.3;26.1;0.0
15;2021-06-04;1047;726;0;72842;37959;0;51.0;26.6;0.0
15;2021-06-05;638;268;0;73480;38227;0;51.5;26.8;0.0
15;2021-06-06;35;32;0;73515;38259;0;51.5;26.8;0.0
15;2021-06-07;749;375;0;74264;38634;0;52.0;27.1;0.0
15;2021-06-08;491;416;0;74755;39050;0;52.3;27.3;0.0
15;2021-06-09;441;412;0;75196;39462;0;52.7;27.6;0.0
15;2021-06-10;309;519;0;75505;39981;0;52.9;28.0;0.0
15;2021-06-11;608;1078;0;76113;41059;0;53.3;28.8;0.0
15;2021-06-12;373;486;0;76486;41545;0;53.6;29.1;0.0
15;2021-06-13;25;25;0;76511;41570;0;53.6;29.1;0.0
15;2021-06-14;518;928;0;77029;42498;0;53.9;29.8;0.0
15;2021-06-15;438;1140;0;77467;43638;0;54.2;30.6;0.0
15;2021-06-16;605;899;0;78072;44537;0;54.7;31.2;0.0
15;2021-06-17;305;972;0;78377;45509;0;54.9;31.9;0.0
15;2021-06-18;733;1181;0;79110;46690;0;55.4;32.7;0.0
15;2021-06-19;502;698;0;79612;47388;0;55.7;33.2;0.0
15;2021-06-20;22;18;0;79634;47406;0;55.8;33.2;0.0
15;2021-06-21;280;982;0;79914;48388;0;56.0;33.9;0.0
15;2021-06-22;238;1384;0;80152;49772;0;56.1;34.9;0.0
15;2021-06-23;355;1400;0;80507;51172;0;56.4;35.8;0.0
15;2021-06-24;295;1105;0;80802;52277;0;56.6;36.6;0.0
15;2021-06-25;369;1566;0;81171;53843;0;56.8;37.7;0.0
15;2021-06-26;163;879;0;81334;54722;0;57.0;38.3;0.0
15;2021-06-27;6;27;0;81340;54749;0;57.0;38.3;0.0
15;2021-06-28;189;1237;0;81529;55986;0;57.1;39.2;0.0
15;2021-06-29;280;1223;0;81809;57209;0;57.3;40.1;0.0
15;2021-06-30;300;1017;0;82109;58226;0;57.5;40.8;0.0
15;2021-07-01;373;1206;0;82482;59432;0;57.8;41.6;0.0
15;2021-07-02;397;1332;0;82879;60764;0;58.0;42.5;0.0
15;2021-07-03;240;690;0;83119;61454;0;58.2;43.0;0.0
15;2021-07-04;4;21;0;83123;61475;0;58.2;43.0;0.0
15;2021-07-05;227;1214;0;83350;62689;0;58.4;43.9;0.0
15;2021-07-06;244;1437;0;83594;64126;0;58.5;44.9;0.0
15;2021-07-07;277;1311;0;83871;65437;0;58.7;45.8;0.0
15;2021-07-08;459;1327;0;84330;66764;0;59.1;46.7;0.0
15;2021-07-09;459;1708;0;84789;68472;0;59.4;47.9;0.0
15;2021-07-10;216;871;1;85005;69343;1;59.5;48.6;0.0
15;2021-07-11;9;27;0;85014;69370;1;59.5;48.6;0.0
15;2021-07-12;246;1422;0;85260;70792;1;59.7;49.6;0.0
15;2021-07-13;565;1660;0;85825;72452;1;60.1;50.7;0.0
15;2021-07-14;47;133;0;85872;72585;1;60.1;50.8;0.0
15;2021-07-15;1048;750;0;86920;73335;1;60.9;51.4;0.0
15;2021-07-16;1061;1227;0;87981;74562;1;61.6;52.2;0.0
15;2021-07-17;753;898;0;88734;75460;1;62.1;52.8;0.0
15;2021-07-18;37;18;0;88771;75478;1;62.2;52.9;0.0
15;2021-07-19;973;1160;0;89744;76638;1;62.8;53.7;0.0
15;2021-07-20;1409;554;0;91153;77192;1;63.8;54.1;0.0
15;2021-07-21;1050;595;0;92203;77787;1;64.6;54.5;0.0
15;2021-07-22;818;528;0;93021;78315;1;65.1;54.8;0.0
15;2021-07-23;1221;1014;0;94242;79329;1;66.0;55.5;0.0
15;2021-07-24;615;733;0;94857;80062;1;66.4;56.1;0.0
15;2021-07-25;25;43;0;94882;80105;1;66.4;56.1;0.0
15;2021-07-26;1064;491;0;95946;80596;1;67.2;56.4;0.0
15;2021-07-27;1426;530;0;97372;81126;1;68.2;56.8;0.0
15;2021-07-28;1090;531;0;98462;81657;1;68.9;57.2;0.0
15;2021-07-29;791;433;0;99253;82090;1;69.5;57.5;0.0
15;2021-07-30;912;1030;0;100165;83120;1;70.1;58.2;0.0
15;2021-07-31;563;597;0;100728;83717;1;70.5;58.6;0.0
15;2021-08-01;42;24;0;100770;83741;1;70.6;58.6;0.0
15;2021-08-02;933;486;0;101703;84227;1;71.2;59.0;0.0
15;2021-08-03;981;358;0;102684;84585;1;71.9;59.2;0.0
15;2021-08-04;771;383;0;103455;84968;1;72.4;59.5;0.0
15;2021-08-05;441;311;0;103896;85279;1;72.8;59.7;0.0
15;2021-08-06;750;1132;0;104646;86411;1;73.3;60.5;0.0
15;2021-08-07;249;1064;0;104895;87475;1;73.5;61.3;0.0
15;2021-08-08;9;19;0;104904;87494;1;73.5;61.3;0.0
15;2021-08-09;462;1005;0;105366;88499;1;73.8;62.0;0.0
15;2021-08-10;382;652;0;105748;89151;1;74.0;62.4;0.0
15;2021-08-11;431;872;0;106179;90023;1;74.3;63.0;0.0
15;2021-08-12;488;1098;0;106667;91121;1;74.7;63.8;0.0
15;2021-08-13;610;1002;0;107277;92123;1;75.1;64.5;0.0
15;2021-08-14;170;538;0;107447;92661;1;75.2;64.9;0.0
15;2021-08-15;32;30;0;107479;92691;1;75.3;64.9;0.0
15;2021-08-16;359;981;0;107838;93672;1;75.5;65.6;0.0
15;2021-08-17;366;1017;0;108204;94689;1;75.8;66.3;0.0
15;2021-08-18;392;747;0;108596;95436;1;76.0;66.8;0.0
15;2021-08-19;277;834;0;108873;96270;1;76.2;67.4;0.0
15;2021-08-20;518;1101;0;109391;97371;1;76.6;68.2;0.0
15;2021-08-21;190;766;0;109581;98137;1;76.7;68.7;0.0
15;2021-08-22;17;39;0;109598;98176;1;76.7;68.7;0.0
15;2021-08-23;214;570;0;109812;98746;1;76.9;69.1;0.0
15;2021-08-24;226;535;0;110038;99281;1;77.1;69.5;0.0
15;2021-08-25;200;511;0;110238;99792;1;77.2;69.9;0.0
15;2021-08-26;139;455;0;110377;100247;1;77.3;70.2;0.0
15;2021-08-27;325;1230;0;110702;101477;1;77.5;71.1;0.0
15;2021-08-28;192;806;0;110894;102283;1;77.7;71.6;0.0
15;2021-08-29;14;22;0;110908;102305;1;77.7;71.6;0.0
15;2021-08-30;202;981;3;111110;103286;4;77.8;72.3;0.0
15;2021-08-31;358;651;18;111468;103937;22;78.1;72.8;0.0
15;2021-09-01;183;420;42;111651;104357;64;78.2;73.1;0.0
15;2021-09-02;104;308;36;111755;104665;100;78.3;73.3;0.1
15;2021-09-03;187;815;117;111942;105480;217;78.4;73.9;0.2
15;2021-09-04;148;332;66;112090;105812;283;78.5;74.1;0.2
15;2021-09-05;4;20;1;112094;105832;284;78.5;74.1;0.2
15;2021-09-06;104;320;170;112198;106152;454;78.6;74.3;0.3
15;2021-09-07;106;206;66;112304;106358;520;78.6;74.5;0.4
15;2021-09-08;200;416;186;112504;106774;706;78.8;74.8;0.5
15;2021-09-09;111;366;84;112615;107140;790;78.9;75.0;0.6
15;2021-09-10;212;672;238;112827;107812;1028;79.0;75.5;0.7
15;2021-09-11;92;276;68;112919;108088;1096;79.1;75.7;0.8
15;2021-09-12;4;9;1;112923;108097;1097;79.1;75.7;0.8
15;2021-09-13;93;253;150;113016;108350;1247;79.1;75.9;0.9
15;2021-09-14;127;125;137;113143;108475;1384;79.2;76.0;1.0
15;2021-09-15;74;244;109;113217;108719;1493;79.3;76.1;1.0
15;2021-09-16;45;136;188;113262;108855;1681;79.3;76.2;1.2
15;2021-09-17;238;550;271;113500;109405;1952;79.5;76.6;1.4
15;2021-09-18;71;334;75;113571;109739;2027;79.5;76.8;1.4
15;2021-09-19;2;7;1;113573;109746;2028;79.5;76.8;1.4
15;2021-09-20;103;205;207;113676;109951;2235;79.6;77.0;1.6
15;2021-09-21;41;110;135;113717;110061;2370;79.6;77.1;1.7
15;2021-09-22;79;312;212;113796;110373;2582;79.7;77.3;1.8
15;2021-09-23;41;109;162;113837;110482;2744;79.7;77.4;1.9
15;2021-09-24;128;311;299;113965;110793;3043;79.8;77.6;2.1
15;2021-09-25;38;208;66;114003;111001;3109;79.8;77.7;2.2
15;2021-09-26;2;5;0;114005;111006;3109;79.8;77.7;2.2
15;2021-09-27;84;134;173;114089;111140;3282;79.9;77.8;2.3
15;2021-09-28;79;131;82;114168;111271;3364;79.9;77.9;2.4
15;2021-09-29;67;206;210;114235;111477;3574;80.0;78.1;2.5
15;2021-09-30;31;93;109;114266;111570;3683;80.0;78.1;2.6
15;2021-10-01;113;205;224;114379;111775;3907;80.1;78.3;2.7
15;2021-10-02;29;138;58;114408;111913;3965;80.1;78.4;2.8
15;2021-10-03;0;2;0;114408;111915;3965;80.1;78.4;2.8
15;2021-10-04;54;61;138;114462;111976;4103;80.1;78.4;2.9
15;2021-10-05;32;64;164;114494;112040;4267;80.2;78.5;3.0
15;2021-10-06;71;117;200;114565;112157;4467;80.2;78.5;3.1
15;2021-10-07;40;88;146;114605;112245;4613;80.2;78.6;3.2
15;2021-10-08;52;148;133;114657;112393;4746;80.3;78.7;3.3
15;2021-10-09;53;101;87;114710;112494;4833;80.3;78.8;3.4
15;2021-10-10;1;6;5;114711;112500;4838;80.3;78.8;3.4
15;2021-10-11;48;148;168;114759;112648;5006;80.4;78.9;3.5
15;2021-10-12;37;56;138;114796;112704;5144;80.4;78.9;3.6
15;2021-10-13;74;160;221;114870;112864;5365;80.4;79.0;3.8
15;2021-10-14;25;26;84;114895;112890;5449;80.5;79.0;3.8
15;2021-10-15;61;109;224;114956;112999;5673;80.5;79.1;4.0
15;2021-10-16;47;97;85;115003;113096;5758;80.5;79.2;4.0
15;2021-10-17;1;2;0;115004;113098;5758;80.5;79.2;4.0
15;2021-10-18;44;110;229;115048;113208;5987;80.6;79.3;4.2
15;2021-10-19;22;62;216;115070;113270;6203;80.6;79.3;4.3
15;2021-10-20;28;76;323;115098;113346;6526;80.6;79.4;4.6
15;2021-10-21;28;40;200;115126;113386;6726;80.6;79.4;4.7
15;2021-10-22;16;68;191;115142;113454;6917;80.6;79.4;4.8
15;2021-10-23;15;70;171;115157;113524;7088;80.6;79.5;5.0
15;2021-10-24;0;0;10;115157;113524;7098;80.6;79.5;5.0
15;2021-10-25;28;55;205;115185;113579;7303;80.7;79.5;5.1
15;2021-10-26;15;35;176;115200;113614;7479;80.7;79.6;5.2
15;2021-10-27;31;81;441;115231;113695;7920;80.7;79.6;5.5
15;2021-10-28;14;10;88;115245;113705;8008;80.7;79.6;5.6
15;2021-10-29;18;57;160;115263;113762;8168;80.7;79.7;5.7
15;2021-10-30;13;49;227;115276;113811;8395;80.7;79.7;5.9
15;2021-10-31;1;1;4;115277;113812;8399;80.7;79.7;5.9
15;2021-11-01;0;1;2;115277;113813;8401;80.7;79.7;5.9
15;2021-11-02;18;56;262;115295;113869;8663;80.7;79.7;6.1
15;2021-11-03;40;86;463;115335;113955;9126;80.8;79.8;6.4
15;2021-11-04;38;40;382;115373;113995;9508;80.8;79.8;6.7
15;2021-11-05;20;30;242;115393;114025;9750;80.8;79.8;6.8
15;2021-11-06;19;42;202;115412;114067;9952;80.8;79.9;7.0
15;2021-11-07;0;0;10;115412;114067;9962;80.8;79.9;7.0
15;2021-11-08;36;95;531;115448;114162;10493;80.8;79.9;7.3
15;2021-11-09;16;32;387;115464;114194;10880;80.9;80.0;7.6
15;2021-11-10;32;43;774;115496;114237;11654;80.9;80.0;8.2
15;2021-11-11;0;6;16;115496;114243;11670;80.9;80.0;8.2
15;2021-11-12;13;29;285;115509;114272;11955;80.9;80.0;8.4
15;2021-11-13;29;36;347;115538;114308;12302;80.9;80.0;8.6
15;2021-11-14;0;3;13;115538;114311;12315;80.9;80.0;8.6
15;2021-11-15;14;20;445;115552;114331;12760;80.9;80.1;8.9
15;2021-11-16;22;23;799;115574;114354;13559;80.9;80.1;9.5
15;2021-11-17;42;44;859;115616;114398;14418;81.0;80.1;10.1
15;2021-11-18;27;36;700;115643;114434;15118;81.0;80.1;10.6
15;2021-11-19;23;29;405;115666;114463;15523;81.0;80.1;10.9
15;2021-11-20;27;22;526;115693;114485;16049;81.0;80.2;11.2
15;2021-11-21;0;1;15;115693;114486;16064;81.0;80.2;11.2
15;2021-11-22;17;21;535;115710;114507;16599;81.0;80.2;11.6
15;2021-11-23;23;25;579;115733;114532;17178;81.0;80.2;12.0
15;2021-11-24;47;43;1034;115780;114575;18212;81.1;80.2;12.8
15;2021-11-25;28;14;531;115808;114589;18743;81.1;80.2;13.1
15;2021-11-26;31;24;826;115839;114613;19569;81.1;80.3;13.7
15;2021-11-27;51;34;1172;115890;114647;20741;81.1;80.3;14.5
15;2021-11-28;3;1;54;115893;114648;20795;81.2;80.3;14.6
15;2021-11-29;24;22;826;115917;114670;21621;81.2;80.3;15.1
15;2021-11-30;24;23;1004;115941;114693;22625;81.2;80.3;15.8
15;2021-12-01;24;46;1907;115965;114739;24532;81.2;80.3;17.2
15;2021-12-02;26;28;1199;115991;114767;25731;81.2;80.4;18.0
15;2021-12-03;30;29;947;116021;114796;26678;81.2;80.4;18.7
15;2021-12-04;18;28;1288;116039;114824;27966;81.3;80.4;19.6
15;2021-12-05;4;0;77;116043;114824;28043;81.3;80.4;19.6
15;2021-12-06;23;36;2140;116066;114860;30183;81.3;80.4;21.1
15;2021-12-07;20;19;1403;116086;114879;31586;81.3;80.4;22.1
15;2021-12-08;27;53;2062;116113;114932;33648;81.3;80.5;23.6
15;2021-12-09;20;20;1215;116133;114952;34863;81.3;80.5;24.4
15;2021-12-10;48;27;1805;116181;114979;36668;81.4;80.5;25.7
15;2021-12-11;25;28;1453;116206;115007;38121;81.4;80.5;26.7
15;2021-12-12;3;3;91;116209;115010;38212;81.4;80.5;26.8
15;2021-12-13;32;17;2313;116241;115027;40525;81.4;80.5;28.4
15;2021-12-14;37;22;2011;116278;115049;42536;81.4;80.6;29.8
15;2021-12-15;36;56;2335;116314;115105;44871;81.4;80.6;31.4
15;2021-12-16;29;39;1667;116343;115144;46538;81.5;80.6;32.6
16;2020-12-27;0;0;0;0;0;0;0.0;0.0;0.0
16;2020-12-28;0;0;0;0;0;0;0.0;0.0;0.0
16;2020-12-29;0;0;0;0;0;0;0.0;0.0;0.0
16;2020-12-30;1;0;0;1;0;0;0.0;0.0;0.0
16;2020-12-31;0;0;0;1;0;0;0.0;0.0;0.0
16;2021-01-01;0;0;0;1;0;0;0.0;0.0;0.0
16;2021-01-02;0;0;0;1;0;0;0.0;0.0;0.0
16;2021-01-03;0;0;0;1;0;0;0.0;0.0;0.0
16;2021-01-04;2;0;0;3;0;0;0.0;0.0;0.0
16;2021-01-05;10;0;0;13;0;0;0.0;0.0;0.0
16;2021-01-06;81;0;0;94;0;0;0.0;0.0;0.0
16;2021-01-07;237;0;0;331;0;0;0.1;0.0;0.0
16;2021-01-08;428;2;0;759;2;0;0.2;0.0;0.0
16;2021-01-09;2;0;0;761;2;0;0.2;0.0;0.0
16;2021-01-10;2;0;0;763;2;0;0.2;0.0;0.0
16;2021-01-11;300;0;0;1063;2;0;0.3;0.0;0.0
16;2021-01-12;406;1;0;1469;3;0;0.4;0.0;0.0
16;2021-01-13;460;1;0;1929;4;0;0.6;0.0;0.0
16;2021-01-14;576;7;0;2505;11;0;0.7;0.0;0.0
16;2021-01-15;482;4;0;2987;15;0;0.9;0.0;0.0
16;2021-01-16;1;0;0;2988;15;0;0.9;0.0;0.0
16;2021-01-17;0;0;0;2988;15;0;0.9;0.0;0.0
16;2021-01-18;426;5;0;3414;20;0;1.0;0.0;0.0
16;2021-01-19;793;1;0;4207;21;0;1.2;0.0;0.0
16;2021-01-20;1153;2;0;5360;23;0;1.5;0.0;0.0
16;2021-01-21;1337;12;0;6697;35;0;1.9;0.0;0.0
16;2021-01-22;1132;5;0;7829;40;0;2.2;0.0;0.0
16;2021-01-23;173;1;0;8002;41;0;2.3;0.0;0.0
16;2021-01-24;2;0;0;8004;41;0;2.3;0.0;0.0
16;2021-01-25;586;3;0;8590;44;0;2.5;0.0;0.0
16;2021-01-26;935;2;0;9525;46;0;2.7;0.0;0.0
16;2021-01-27;1276;95;0;10801;141;0;3.1;0.0;0.0
16;2021-01-28;1182;72;0;11983;213;0;3.4;0.1;0.0
16;2021-01-29;742;137;0;12725;350;0;3.7;0.1;0.0
16;2021-01-30;41;1;0;12766;351;0;3.7;0.1;0.0
16;2021-01-31;0;1;0;12766;352;0;3.7;0.1;0.0
16;2021-02-01;382;202;0;13148;554;0;3.8;0.2;0.0
16;2021-02-02;555;174;0;13703;728;0;3.9;0.2;0.0
16;2021-02-03;548;318;0;14251;1046;0;4.1;0.3;0.0
16;2021-02-04;491;264;0;14742;1310;0;4.2;0.4;0.0
16;2021-02-05;458;265;0;15200;1575;0;4.4;0.5;0.0
16;2021-02-06;4;73;0;15204;1648;0;4.4;0.5;0.0
16;2021-02-07;37;3;0;15241;1651;0;4.4;0.5;0.0
16;2021-02-08;361;232;0;15602;1883;0;4.5;0.5;0.0
16;2021-02-09;641;370;0;16243;2253;0;4.7;0.6;0.0
16;2021-02-10;684;704;0;16927;2957;0;4.9;0.8;0.0
16;2021-02-11;795;611;0;17722;3568;0;5.1;1.0;0.0
16;2021-02-12;607;784;0;18329;4352;0;5.3;1.2;0.0
16;2021-02-13;44;65;0;18373;4417;0;5.3;1.3;0.0
16;2021-02-14;0;6;0;18373;4423;0;5.3;1.3;0.0
16;2021-02-15;211;642;0;18584;5065;0;5.3;1.5;0.0
16;2021-02-16;367;933;0;18951;5998;0;5.4;1.7;0.0
16;2021-02-17;323;1179;0;19274;7177;0;5.5;2.1;0.0
16;2021-02-18;480;1147;0;19754;8324;0;5.7;2.4;0.0
16;2021-02-19;377;791;0;20131;9115;0;5.8;2.6;0.0
16;2021-02-20;3;12;0;20134;9127;0;5.8;2.6;0.0
16;2021-02-21;3;0;0;20137;9127;0;5.8;2.6;0.0
16;2021-02-22;149;508;0;20286;9635;0;5.8;2.8;0.0
16;2021-02-23;214;887;0;20500;10522;0;5.9;3.0;0.0
16;2021-02-24;252;791;0;20752;11313;0;6.0;3.2;0.0
16;2021-02-25;403;674;0;21155;11987;0;6.1;3.4;0.0
16;2021-02-26;470;478;0;21625;12465;0;6.2;3.6;0.0
16;2021-02-27;239;4;0;21864;12469;0;6.3;3.6;0.0
16;2021-02-28;5;4;0;21869;12473;0;6.3;3.6;0.0
16;2021-03-01;156;326;0;22025;12799;0;6.3;3.7;0.0
16;2021-03-02;258;633;0;22283;13432;0;6.4;3.9;0.0
16;2021-03-03;392;680;0;22675;14112;0;6.5;4.1;0.0
16;2021-03-04;826;560;0;23501;14672;0;6.7;4.2;0.0
16;2021-03-05;1118;544;0;24619;15216;0;7.1;4.4;0.0
16;2021-03-06;699;8;0;25318;15224;0;7.3;4.4;0.0
16;2021-03-07;109;19;0;25427;15243;0;7.3;4.4;0.0
16;2021-03-08;431;319;0;25858;15562;0;7.4;4.5;0.0
16;2021-03-09;790;693;0;26648;16255;0;7.7;4.7;0.0
16;2021-03-10;615;626;0;27263;16881;0;7.8;4.8;0.0
16;2021-03-11;1425;506;0;28688;17387;0;8.2;5.0;0.0
16;2021-03-12;1174;454;0;29862;17841;0;8.6;5.1;0.0
16;2021-03-13;718;13;0;30580;17854;0;8.8;5.1;0.0
16;2021-03-14;5;0;0;30585;17854;0;8.8;5.1;0.0
16;2021-03-15;483;178;0;31068;18032;0;8.9;5.2;0.0
16;2021-03-16;829;407;0;31897;18439;0;9.2;5.3;0.0
16;2021-03-17;585;251;0;32482;18690;0;9.3;5.4;0.0
16;2021-03-18;986;285;0;33468;18975;0;9.6;5.4;0.0
16;2021-03-19;1080;228;0;34548;19203;0;9.9;5.5;0.0
16;2021-03-20;392;9;0;34940;19212;0;10.0;5.5;0.0
16;2021-03-21;10;0;0;34950;19212;0;10.0;5.5;0.0
16;2021-03-22;761;112;0;35711;19324;0;10.3;5.6;0.0
16;2021-03-23;1417;112;0;37128;19436;0;10.7;5.6;0.0
16;2021-03-24;1142;163;0;38270;19599;0;11.0;5.6;0.0
16;2021-03-25;2032;97;0;40302;19696;0;11.6;5.7;0.0
16;2021-03-26;1926;105;0;42228;19801;0;12.1;5.7;0.0
16;2021-03-27;436;23;0;42664;19824;0;12.3;5.7;0.0
16;2021-03-28;1;0;0;42665;19824;0;12.3;5.7;0.0
16;2021-03-29;931;64;0;43596;19888;0;12.5;5.7;0.0
16;2021-03-30;1867;184;0;45463;20072;0;13.1;5.8;0.0
16;2021-03-31;1506;137;0;46969;20209;0;13.5;5.8;0.0
16;2021-04-01;1926;408;0;48895;20617;0;14.0;5.9;0.0
16;2021-04-02;1431;365;0;50326;20982;0;14.5;6.0;0.0
16;2021-04-03;284;7;0;50610;20989;0;14.5;6.0;0.0
16;2021-04-04;7;0;0;50617;20989;0;14.5;6.0;0.0
16;2021-04-05;38;1;0;50655;20990;0;14.5;6.0;0.0
16;2021-04-06;1973;559;0;52628;21549;0;15.1;6.2;0.0
16;2021-04-07;1871;402;0;54499;21951;0;15.7;6.3;0.0
16;2021-04-08;2713;574;0;57212;22525;0;16.4;6.5;0.0
16;2021-04-09;2627;518;0;59839;23043;0;17.2;6.6;0.0
16;2021-04-10;1234;41;0;61073;23084;0;17.5;6.6;0.0
16;2021-04-11;24;3;0;61097;23087;0;17.5;6.6;0.0
16;2021-04-12;1351;326;0;62448;23413;0;17.9;6.7;0.0
16;2021-04-13;2072;795;0;64520;24208;0;18.5;7.0;0.0
16;2021-04-14;1923;621;0;66443;24829;0;19.1;7.1;0.0
16;2021-04-15;1999;957;0;68442;25786;0;19.7;7.4;0.0
16;2021-04-16;2002;772;0;70444;26558;0;20.2;7.6;0.0
16;2021-04-17;1392;98;0;71836;26656;0;20.6;7.7;0.0
16;2021-04-18;210;8;0;72046;26664;0;20.7;7.7;0.0
16;2021-04-19;1307;534;0;73353;27198;0;21.1;7.8;0.0
16;2021-04-20;1953;1187;0;75306;28385;0;21.6;8.2;0.0
16;2021-04-21;1678;755;0;76984;29140;0;22.1;8.4;0.0
16;2021-04-22;2126;1009;0;79110;30149;0;22.7;8.7;0.0
16;2021-04-23;2234;1134;0;81344;31283;0;23.4;9.0;0.0
16;2021-04-24;779;55;0;82123;31338;0;23.6;9.0;0.0
16;2021-04-25;122;10;0;82245;31348;0;23.6;9.0;0.0
16;2021-04-26;1292;802;0;83537;32150;0;24.0;9.2;0.0
16;2021-04-27;1998;1370;0;85535;33520;0;24.6;9.6;0.0
16;2021-04-28;1561;1124;0;87096;34644;0;25.0;10.0;0.0
16;2021-04-29;2151;1432;0;89247;36076;0;25.6;10.4;0.0
16;2021-04-30;2688;1303;0;91935;37379;0;26.4;10.7;0.0
16;2021-05-01;387;77;0;92322;37456;0;26.5;10.8;0.0
16;2021-05-02;155;17;0;92477;37473;0;26.6;10.8;0.0
16;2021-05-03;2462;563;0;94939;38036;0;27.3;10.9;0.0
16;2021-05-04;1954;2007;0;96893;40043;0;27.8;11.5;0.0
16;2021-05-05;1642;1750;0;98535;41793;0;28.3;12.0;0.0
16;2021-05-06;1758;2181;0;100293;43974;0;28.8;12.6;0.0
16;2021-05-07;2826;2045;0;103119;46019;0;29.6;13.2;0.0
16;2021-05-08;1071;438;0;104190;46457;0;29.9;13.3;0.0
16;2021-05-09;475;27;0;104665;46484;0;30.1;13.4;0.0
16;2021-05-10;1782;1533;0;106447;48017;0;30.6;13.8;0.0
16;2021-05-11;2273;1903;0;108720;49920;0;31.2;14.3;0.0
16;2021-05-12;1705;1725;0;110425;51645;0;31.7;14.8;0.0
16;2021-05-13;1380;349;0;111805;51994;0;32.1;14.9;0.0
16;2021-05-14;1872;1477;0;113677;53471;0;32.6;15.4;0.0
16;2021-05-15;590;812;0;114267;54283;0;32.8;15.6;0.0
16;2021-05-16;198;32;0;114465;54315;0;32.9;15.6;0.0
16;2021-05-17;1568;1155;0;116033;55470;0;33.3;15.9;0.0
16;2021-05-18;2650;1342;0;118683;56812;0;34.1;16.3;0.0
16;2021-05-19;1969;1167;0;120652;57979;0;34.7;16.7;0.0
16;2021-05-20;2787;1350;0;123439;59329;0;35.5;17.0;0.0
16;2021-05-21;2860;1377;0;126299;60706;0;36.3;17.4;0.0
16;2021-05-22;488;635;0;126787;61341;0;36.4;17.6;0.0
16;2021-05-23;278;15;0;127065;61356;0;36.5;17.6;0.0
16;2021-05-24;1342;223;0;128407;61579;0;36.9;17.7;0.0
16;2021-05-25;2736;1399;0;131143;62978;0;37.7;18.1;0.0
16;2021-05-26;1843;1140;0;132986;64118;0;38.2;18.4;0.0
16;2021-05-27;2469;1560;0;135455;65678;0;38.9;18.9;0.0
16;2021-05-28;2832;1507;0;138287;67185;0;39.7;19.3;0.0
16;2021-05-29;828;867;0;139115;68052;0;40.0;19.5;0.0
16;2021-05-30;98;10;0;139213;68062;0;40.0;19.5;0.0
16;2021-05-31;1964;1096;0;141177;69158;0;40.5;19.9;0.0
16;2021-06-01;2324;1664;0;143501;70822;0;41.2;20.3;0.0
16;2021-06-02;1897;1448;0;145398;72270;0;41.8;20.8;0.0
16;2021-06-03;2677;1763;0;148075;74033;0;42.5;21.3;0.0
16;2021-06-04;2789;1998;0;150864;76031;0;43.3;21.8;0.0
16;2021-06-05;1041;569;0;151905;76600;0;43.6;22.0;0.0
16;2021-06-06;203;34;0;152108;76634;0;43.7;22.0;0.0
16;2021-06-07;1944;1256;0;154052;77890;0;44.2;22.4;0.0
16;2021-06-08;2377;1935;0;156429;79825;0;44.9;22.9;0.0
16;2021-06-09;2498;1573;0;158927;81398;0;45.6;23.4;0.0
16;2021-06-10;2537;1930;0;161464;83328;0;46.4;23.9;0.0
16;2021-06-11;2158;2583;0;163622;85911;0;47.0;24.7;0.0
16;2021-06-12;1545;539;0;165167;86450;0;47.4;24.8;0.0
16;2021-06-13;288;85;0;165455;86535;0;47.5;24.9;0.0
16;2021-06-14;850;2646;0;166305;89181;0;47.8;25.6;0.0
16;2021-06-15;1845;2507;0;168150;91688;0;48.3;26.3;0.0
16;2021-06-16;1613;1961;0;169763;93649;0;48.8;26.9;0.0
16;2021-06-17;2015;2340;0;171778;95989;0;49.3;27.6;0.0
16;2021-06-18;2005;3023;0;173783;99012;0;49.9;28.4;0.0
16;2021-06-19;1279;1227;0;175062;100239;0;50.3;28.8;0.0
16;2021-06-20;253;66;0;175315;100305;0;50.4;28.8;0.0
16;2021-06-21;1370;2083;0;176685;102388;0;50.7;29.4;0.0
16;2021-06-22;1659;2863;0;178344;105251;0;51.2;30.2;0.0
16;2021-06-23;1504;2022;0;179848;107273;0;51.7;30.8;0.0
16;2021-06-24;1916;2139;0;181764;109412;0;52.2;31.4;0.0
16;2021-06-25;1893;2598;0;183657;112010;0;52.7;32.2;0.0
16;2021-06-26;1007;762;0;184664;112772;0;53.0;32.4;0.0
16;2021-06-27;146;102;0;184810;112874;0;53.1;32.4;0.0
16;2021-06-28;1112;1962;0;185922;114836;0;53.4;33.0;0.0
16;2021-06-29;1194;3349;0;187116;118185;0;53.7;33.9;0.0
16;2021-06-30;1299;2669;0;188415;120854;0;54.1;34.7;0.0
16;2021-07-01;1803;3085;0;190218;123939;0;54.6;35.6;0.0
16;2021-07-02;1375;3529;0;191593;127468;0;55.0;36.6;0.0
16;2021-07-03;647;1128;0;192240;128596;0;55.2;36.9;0.0
16;2021-07-04;29;97;0;192269;128693;0;55.2;37.0;0.0
16;2021-07-05;805;2329;0;193074;131022;0;55.5;37.6;0.0
16;2021-07-06;1238;3325;0;194312;134347;0;55.8;38.6;0.0
16;2021-07-07;860;2337;0;195172;136684;0;56.1;39.3;0.0
16;2021-07-08;1194;2736;0;196366;139420;0;56.4;40.0;0.0
16;2021-07-09;1136;3601;0;197502;143021;0;56.7;41.1;0.0
16;2021-07-10;347;1345;0;197849;144366;0;56.8;41.5;0.0
16;2021-07-11;32;86;0;197881;144452;0;56.8;41.5;0.0
16;2021-07-12;658;2473;0;198539;146925;0;57.0;42.2;0.0
16;2021-07-13;1361;3486;0;199900;150411;0;57.4;43.2;0.0
16;2021-07-14;813;901;0;200713;151312;0;57.6;43.5;0.0
16;2021-07-15;1294;3367;0;202007;154679;0;58.0;44.4;0.0
16;2021-07-16;1559;3368;0;203566;158047;0;58.5;45.4;0.0
16;2021-07-17;614;1234;0;204180;159281;0;58.6;45.7;0.0
16;2021-07-18;60;73;0;204240;159354;0;58.7;45.8;0.0
16;2021-07-19;720;2818;0;204960;162172;0;58.9;46.6;0.0
16;2021-07-20;1255;3216;0;206215;165388;0;59.2;47.5;0.0
16;2021-07-21;1272;2638;0;207487;168026;0;59.6;48.3;0.0
16;2021-07-22;1962;2853;0;209449;170879;0;60.2;49.1;0.0
16;2021-07-23;1637;3468;0;211086;174347;0;60.6;50.1;0.0
16;2021-07-24;734;1214;0;211820;175561;0;60.8;50.4;0.0
16;2021-07-25;103;71;0;211923;175632;0;60.9;50.4;0.0
16;2021-07-26;1612;2131;0;213535;177763;0;61.3;51.1;0.0
16;2021-07-27;2067;2789;0;215602;180552;0;61.9;51.9;0.0
16;2021-07-28;2032;2288;0;217634;182840;0;62.5;52.5;0.0
16;2021-07-29;2448;2420;0;220082;185260;0;63.2;53.2;0.0
16;2021-07-30;2602;3001;0;222684;188261;0;64.0;54.1;0.0
16;2021-07-31;1052;1321;0;223736;189582;0;64.3;54.4;0.0
16;2021-08-01;273;46;0;224009;189628;0;64.3;54.5;0.0
16;2021-08-02;2198;1791;0;226207;191419;0;65.0;55.0;0.0
16;2021-08-03;2295;2277;0;228502;193696;0;65.6;55.6;0.0
16;2021-08-04;2282;1793;0;230784;195489;0;66.3;56.1;0.0
16;2021-08-05;2889;1587;0;233673;197076;0;67.1;56.6;0.0
16;2021-08-06;2616;2307;0;236289;199383;0;67.9;57.3;0.0
16;2021-08-07;885;628;0;237174;200011;0;68.1;57.4;0.0
16;2021-08-08;100;75;0;237274;200086;0;68.1;57.5;0.0
16;2021-08-09;2178;1127;0;239452;201213;0;68.8;57.8;0.0
16;2021-08-10;2859;1551;0;242311;202764;0;69.6;58.2;0.0
16;2021-08-11;2540;1207;0;244851;203971;0;70.3;58.6;0.0
16;2021-08-12;2037;1707;0;246888;205678;0;70.9;59.1;0.0
16;2021-08-13;2488;1424;0;249376;207102;0;71.6;59.5;0.0
16;2021-08-14;768;481;0;250144;207583;0;71.8;59.6;0.0
16;2021-08-15;62;44;0;250206;207627;0;71.9;59.6;0.0
16;2021-08-16;1296;1613;0;251502;209240;0;72.2;60.1;0.0
16;2021-08-17;1640;1686;0;253142;210926;0;72.7;60.6;0.0
16;2021-08-18;1514;1529;0;254656;212455;0;73.1;61.0;0.0
16;2021-08-19;1424;1867;0;256080;214322;0;73.5;61.6;0.0
16;2021-08-20;1452;1974;0;257532;216296;0;74.0;62.1;0.0
16;2021-08-21;525;843;0;258057;217139;0;74.1;62.4;0.0
16;2021-08-22;15;67;0;258072;217206;0;74.1;62.4;0.0
16;2021-08-23;912;2114;0;258984;219320;0;74.4;63.0;0.0
16;2021-08-24;999;2445;0;259983;221765;0;74.7;63.7;0.0
16;2021-08-25;810;1885;0;260793;223650;0;74.9;64.2;0.0
16;2021-08-26;828;2597;0;261621;226247;0;75.1;65.0;0.0
16;2021-08-27;813;2531;0;262434;228778;0;75.4;65.7;0.0
16;2021-08-28;277;847;0;262711;229625;0;75.5;66.0;0.0
16;2021-08-29;15;67;0;262726;229692;0;75.5;66.0;0.0
16;2021-08-30;610;2369;22;263336;232061;22;75.6;66.6;0.0
16;2021-08-31;669;2657;79;264005;234718;101;75.8;67.4;0.0
16;2021-09-01;481;2340;182;264486;237058;283;76.0;68.1;0.1
16;2021-09-02;538;2109;290;265024;239167;573;76.1;68.7;0.2
16;2021-09-03;531;2510;272;265555;241677;845;76.3;69.4;0.2
16;2021-09-04;329;937;56;265884;242614;901;76.4;69.7;0.3
16;2021-09-05;14;55;3;265898;242669;904;76.4;69.7;0.3
16;2021-09-06;287;1400;291;266185;244069;1195;76.5;70.1;0.3
16;2021-09-07;355;1617;319;266540;245686;1514;76.6;70.6;0.4
16;2021-09-08;360;1891;216;266900;247577;1730;76.7;71.1;0.5
16;2021-09-09;335;1479;216;267235;249056;1946;76.8;71.5;0.6
16;2021-09-10;416;1690;318;267651;250746;2264;76.9;72.0;0.7
16;2021-09-11;197;765;69;267848;251511;2333;76.9;72.2;0.7
16;2021-09-12;17;28;1;267865;251539;2334;76.9;72.2;0.7
16;2021-09-13;241;974;348;268106;252513;2682;77.0;72.5;0.8
16;2021-09-14;365;924;650;268471;253437;3332;77.1;72.8;1.0
16;2021-09-15;354;1301;418;268825;254738;3750;77.2;73.2;1.1
16;2021-09-16;319;831;759;269144;255569;4509;77.3;73.4;1.3
16;2021-09-17;471;1254;400;269615;256823;4909;77.4;73.8;1.4
16;2021-09-18;107;511;46;269722;257334;4955;77.5;73.9;1.4
16;2021-09-19;3;17;5;269725;257351;4960;77.5;73.9;1.4
16;2021-09-20;175;635;583;269900;257986;5543;77.5;74.1;1.6
16;2021-09-21;183;663;633;270083;258649;6176;77.6;74.3;1.8
16;2021-09-22;187;923;360;270270;259572;6536;77.6;74.6;1.9
16;2021-09-23;159;518;458;270429;260090;6994;77.7;74.7;2.0
16;2021-09-24;300;974;466;270729;261064;7460;77.8;75.0;2.1
16;2021-09-25;74;424;42;270803;261488;7502;77.8;75.1;2.2
16;2021-09-26;3;10;26;270806;261498;7528;77.8;75.1;2.2
16;2021-09-27;187;541;559;270993;262039;8087;77.8;75.3;2.3
16;2021-09-28;128;509;538;271121;262548;8625;77.9;75.4;2.5
16;2021-09-29;180;556;584;271301;263104;9209;77.9;75.6;2.6
16;2021-09-30;111;455;498;271412;263559;9707;78.0;75.7;2.8
16;2021-10-01;244;481;457;271656;264040;10164;78.0;75.8;2.9
16;2021-10-02;83;308;73;271739;264348;10237;78.0;75.9;2.9
16;2021-10-03;1;12;9;271740;264360;10246;78.0;75.9;2.9
16;2021-10-04;123;323;398;271863;264683;10644;78.1;76.0;3.1
16;2021-10-05;130;357;449;271993;265040;11093;78.1;76.1;3.2
16;2021-10-06;176;482;428;272169;265522;11521;78.2;76.3;3.3
16;2021-10-07;126;311;326;272295;265833;11847;78.2;76.3;3.4
16;2021-10-08;227;624;640;272522;266457;12487;78.3;76.5;3.6
16;2021-10-09;75;167;73;272597;266624;12560;78.3;76.6;3.6
16;2021-10-10;2;13;13;272599;266637;12573;78.3;76.6;3.6
16;2021-10-11;108;247;556;272707;266884;13129;78.3;76.7;3.8
16;2021-10-12;103;229;404;272810;267113;13533;78.4;76.7;3.9
16;2021-10-13;191;324;458;273001;267437;13991;78.4;76.8;4.0
16;2021-10-14;94;182;347;273095;267619;14338;78.4;76.9;4.1
16;2021-10-15;192;397;600;273287;268016;14938;78.5;77.0;4.3
16;2021-10-16;84;107;125;273371;268123;15063;78.5;77.0;4.3
16;2021-10-17;6;6;7;273377;268129;15070;78.5;77.0;4.3
16;2021-10-18;127;268;542;273504;268397;15612;78.6;77.1;4.5
16;2021-10-19;105;145;578;273609;268542;16190;78.6;77.1;4.6
16;2021-10-20;121;213;522;273730;268755;16712;78.6;77.2;4.8
16;2021-10-21;66;138;419;273796;268893;17131;78.6;77.2;4.9
16;2021-10-22;233;323;641;274029;269216;17772;78.7;77.3;5.1
16;2021-10-23;76;106;79;274105;269322;17851;78.7;77.4;5.1
16;2021-10-24;1;4;5;274106;269326;17856;78.7;77.4;5.1
16;2021-10-25;124;170;682;274230;269496;18538;78.8;77.4;5.3
16;2021-10-26;58;124;506;274288;269620;19044;78.8;77.4;5.5
16;2021-10-27;108;159;462;274396;269779;19506;78.8;77.5;5.6
16;2021-10-28;102;124;473;274498;269903;19979;78.8;77.5;5.7
16;2021-10-29;173;222;940;274671;270125;20919;78.9;77.6;6.0
16;2021-10-30;51;86;170;274722;270211;21089;78.9;77.6;6.1
16;2021-10-31;2;5;12;274724;270216;21101;78.9;77.6;6.1
16;2021-11-01;3;3;20;274727;270219;21121;78.9;77.6;6.1
16;2021-11-02;105;149;852;274832;270368;21973;78.9;77.7;6.3
16;2021-11-03;96;142;482;274928;270510;22455;79.0;77.7;6.4
16;2021-11-04;87;114;570;275015;270624;23025;79.0;77.7;6.6
16;2021-11-05;148;197;941;275163;270821;23966;79.0;77.8;6.9
16;2021-11-06;61;80;262;275224;270901;24228;79.0;77.8;7.0
16;2021-11-07;2;10;17;275226;270911;24245;79.0;77.8;7.0
16;2021-11-08;50;119;896;275276;271030;25141;79.1;77.8;7.2
16;2021-11-09;75;112;1008;275351;271142;26149;79.1;77.9;7.5
16;2021-11-10;94;133;971;275445;271275;27120;79.1;77.9;7.8
16;2021-11-11;4;6;27;275449;271281;27147;79.1;77.9;7.8
16;2021-11-12;82;151;1022;275531;271432;28169;79.1;78.0;8.1
16;2021-11-13;38;75;244;275569;271507;28413;79.1;78.0;8.2
16;2021-11-14;0;2;10;275569;271509;28423;79.1;78.0;8.2
16;2021-11-15;48;115;1100;275617;271624;29523;79.2;78.0;8.5
16;2021-11-16;73;102;1051;275690;271726;30574;79.2;78.0;8.8
16;2021-11-17;113;154;1068;275803;271880;31642;79.2;78.1;9.1
16;2021-11-18;79;130;1078;275882;272010;32720;79.2;78.1;9.4
16;2021-11-19;153;227;1467;276035;272237;34187;79.3;78.2;9.8
16;2021-11-20;59;88;483;276094;272325;34670;79.3;78.2;10.0
16;2021-11-21;2;2;34;276096;272327;34704;79.3;78.2;10.0
16;2021-11-22;71;64;1245;276167;272391;35949;79.3;78.2;10.3
16;2021-11-23;100;90;1467;276267;272481;37416;79.3;78.3;10.7
16;2021-11-24;124;122;1433;276391;272603;38849;79.4;78.3;11.2
16;2021-11-25;115;92;1605;276506;272695;40454;79.4;78.3;11.6
16;2021-11-26;144;150;2111;276650;272845;42565;79.5;78.4;12.2
16;2021-11-27;95;120;1715;276745;272965;44280;79.5;78.4;12.7
16;2021-11-28;35;18;1065;276780;272983;45345;79.5;78.4;13.0
16;2021-11-29;76;81;1845;276856;273064;47190;79.5;78.4;13.6
16;2021-11-30;106;96;2554;276962;273160;49744;79.5;78.5;14.3
16;2021-12-01;111;112;2501;277073;273272;52245;79.6;78.5;15.0
16;2021-12-02;102;72;3202;277175;273344;55447;79.6;78.5;15.9
16;2021-12-03;97;119;3180;277272;273463;58627;79.6;78.5;16.8
16;2021-12-04;76;68;1477;277348;273531;60104;79.7;78.6;17.3
16;2021-12-05;6;5;363;277354;273536;60467;79.7;78.6;17.4
16;2021-12-06;61;79;2603;277415;273615;63070;79.7;78.6;18.1
16;2021-12-07;58;80;3204;277473;273695;66274;79.7;78.6;19.0
16;2021-12-08;123;113;3063;277596;273808;69337;79.7;78.6;19.9
16;2021-12-09;104;104;4188;277700;273912;73525;79.8;78.7;21.1
16;2021-12-10;99;145;4321;277799;274057;77846;79.8;78.7;22.4
16;2021-12-11;84;59;2476;277883;274116;80322;79.8;78.7;23.1
16;2021-12-12;34;15;1368;277917;274131;81690;79.8;78.7;23.5
16;2021-12-13;82;97;3437;277999;274228;85127;79.8;78.8;24.4
16;2021-12-14;105;127;4306;278104;274355;89433;79.9;78.8;25.7
16;2021-12-15;113;144;3612;278217;274499;93045;79.9;78.8;26.7
16;2021-12-16;101;107;4477;278318;274606;97522;79.9;78.9;28.0
17;2020-12-27;2;0;0;2;0;0;0.0;0.0;0.0
17;2020-12-28;1;0;0;3;0;0;0.0;0.0;0.0
17;2020-12-29;0;0;0;3;0;0;0.0;0.0;0.0
17;2020-12-30;0;0;0;3;0;0;0.0;0.0;0.0
17;2020-12-31;0;0;0;3;0;0;0.0;0.0;0.0
17;2021-01-01;2;0;0;5;0;0;0.0;0.0;0.0
17;2021-01-02;0;0;0;5;0;0;0.0;0.0;0.0
17;2021-01-03;0;0;0;5;0;0;0.0;0.0;0.0
17;2021-01-04;52;0;0;57;0;0;0.0;0.0;0.0
17;2021-01-05;86;0;0;143;0;0;0.0;0.0;0.0
17;2021-01-06;124;0;0;267;0;0;0.0;0.0;0.0
17;2021-01-07;470;1;0;737;1;0;0.1;0.0;0.0
17;2021-01-08;428;0;0;1165;1;0;0.2;0.0;0.0
17;2021-01-09;8;0;0;1173;1;0;0.2;0.0;0.0
17;2021-01-10;4;0;0;1177;1;0;0.2;0.0;0.0
17;2021-01-11;388;2;0;1565;3;0;0.2;0.0;0.0
17;2021-01-12;705;1;0;2270;4;0;0.4;0.0;0.0
17;2021-01-13;660;2;0;2930;6;0;0.5;0.0;0.0
17;2021-01-14;641;11;0;3571;17;0;0.6;0.0;0.0
17;2021-01-15;718;2;0;4289;19;0;0.7;0.0;0.0
17;2021-01-16;129;2;0;4418;21;0;0.7;0.0;0.0
17;2021-01-17;19;0;0;4437;21;0;0.7;0.0;0.0
17;2021-01-18;847;5;0;5284;26;0;0.8;0.0;0.0
17;2021-01-19;1871;18;0;7155;44;0;1.1;0.0;0.0
17;2021-01-20;2265;4;0;9420;48;0;1.5;0.0;0.0
17;2021-01-21;2409;12;0;11829;60;0;1.8;0.0;0.0
17;2021-01-22;1829;15;0;13658;75;0;2.1;0.0;0.0
17;2021-01-23;709;2;0;14367;77;0;2.2;0.0;0.0
17;2021-01-24;45;0;0;14412;77;0;2.2;0.0;0.0
17;2021-01-25;1374;6;0;15786;83;0;2.4;0.0;0.0
17;2021-01-26;2043;5;0;17829;88;0;2.8;0.0;0.0
17;2021-01-27;1683;38;0;19512;126;0;3.0;0.0;0.0
17;2021-01-28;2438;231;0;21950;357;0;3.4;0.1;0.0
17;2021-01-29;1715;223;0;23665;580;0;3.7;0.1;0.0
17;2021-01-30;517;5;0;24182;585;0;3.7;0.1;0.0
17;2021-01-31;34;5;0;24216;590;0;3.7;0.1;0.0
17;2021-02-01;735;211;0;24951;801;0;3.9;0.1;0.0
17;2021-02-02;1167;343;0;26118;1144;0;4.0;0.2;0.0
17;2021-02-03;1249;412;0;27367;1556;0;4.2;0.2;0.0
17;2021-02-04;1118;502;0;28485;2058;0;4.4;0.3;0.0
17;2021-02-05;615;766;0;29100;2824;0;4.5;0.4;0.0
17;2021-02-06;25;45;0;29125;2869;0;4.5;0.4;0.0
17;2021-02-07;35;3;0;29160;2872;0;4.5;0.4;0.0
17;2021-02-08;690;428;0;29850;3300;0;4.6;0.5;0.0
17;2021-02-09;1104;1261;0;30954;4561;0;4.8;0.7;0.0
17;2021-02-10;839;1242;0;31793;5803;0;4.9;0.9;0.0
17;2021-02-11;1235;1279;0;33028;7082;0;5.1;1.1;0.0
17;2021-02-12;778;985;0;33806;8067;0;5.2;1.2;0.0
17;2021-02-13;50;137;0;33856;8204;0;5.2;1.3;0.0
17;2021-02-14;1;10;0;33857;8214;0;5.2;1.3;0.0
17;2021-02-15;612;1177;0;34469;9391;0;5.3;1.5;0.0
17;2021-02-16;758;1798;0;35227;11189;0;5.4;1.7;0.0
17;2021-02-17;774;1371;0;36001;12560;0;5.6;1.9;0.0
17;2021-02-18;947;2162;0;36948;14722;0;5.7;2.3;0.0
17;2021-02-19;1050;1533;0;37998;16255;0;5.9;2.5;0.0
17;2021-02-20;103;333;0;38101;16588;0;5.9;2.6;0.0
17;2021-02-21;8;0;0;38109;16588;0;5.9;2.6;0.0
17;2021-02-22;641;1593;0;38750;18181;0;6.0;2.8;0.0
17;2021-02-23;729;1511;0;39479;19692;0;6.1;3.0;0.0
17;2021-02-24;1066;1558;0;40545;21250;0;6.3;3.3;0.0
17;2021-02-25;1097;1659;0;41642;22909;0;6.4;3.5;0.0
17;2021-02-26;1320;1279;0;42962;24188;0;6.6;3.7;0.0
17;2021-02-27;516;234;0;43478;24422;0;6.7;3.8;0.0
17;2021-02-28;24;9;0;43502;24431;0;6.7;3.8;0.0
17;2021-03-01;629;1040;0;44131;25471;0;6.8;3.9;0.0
17;2021-03-02;1087;870;0;45218;26341;0;7.0;4.1;0.0
17;2021-03-03;1594;778;0;46812;27119;0;7.2;4.2;0.0
17;2021-03-04;2403;1130;0;49215;28249;0;7.6;4.4;0.0
17;2021-03-05;2606;683;0;51821;28932;0;8.0;4.5;0.0
17;2021-03-06;1058;38;0;52879;28970;0;8.2;4.5;0.0
17;2021-03-07;182;48;0;53061;29018;0;8.2;4.5;0.0
17;2021-03-08;1016;835;0;54077;29853;0;8.4;4.6;0.0
17;2021-03-09;1715;630;0;55792;30483;0;8.6;4.7;0.0
17;2021-03-10;2065;659;0;57857;31142;0;8.9;4.8;0.0
17;2021-03-11;3200;982;0;61057;32124;0;9.4;5.0;0.0
17;2021-03-12;3300;632;0;64357;32756;0;9.9;5.1;0.0
17;2021-03-13;1211;18;0;65568;32774;0;10.1;5.1;0.0
17;2021-03-14;51;1;0;65619;32775;0;10.1;5.1;0.0
17;2021-03-15;1245;979;0;66864;33754;0;10.3;5.2;0.0
17;2021-03-16;906;538;0;67770;34292;0;10.5;5.3;0.0
17;2021-03-17;1482;715;0;69252;35007;0;10.7;5.4;0.0
17;2021-03-18;1691;751;0;70943;35758;0;11.0;5.5;0.0
17;2021-03-19;2080;535;0;73023;36293;0;11.3;5.6;0.0
17;2021-03-20;1095;54;0;74118;36347;0;11.5;5.6;0.0
17;2021-03-21;38;40;0;74156;36387;0;11.5;5.6;0.0
17;2021-03-22;1553;679;0;75709;37066;0;11.7;5.7;0.0
17;2021-03-23;2451;573;0;78160;37639;0;12.1;5.8;0.0
17;2021-03-24;3464;831;0;81624;38470;0;12.6;5.9;0.0
17;2021-03-25;4630;641;0;86254;39111;0;13.3;6.0;0.0
17;2021-03-26;4841;472;0;91095;39583;0;14.1;6.1;0.0
17;2021-03-27;1719;68;0;92814;39651;0;14.3;6.1;0.0
17;2021-03-28;366;42;0;93180;39693;0;14.4;6.1;0.0
17;2021-03-29;2339;559;0;95519;40252;0;14.8;6.2;0.0
17;2021-03-30;2615;977;0;98134;41229;0;15.2;6.4;0.0
17;2021-03-31;3764;892;0;101898;42121;0;15.7;6.5;0.0
17;2021-04-01;3975;1169;0;105873;43290;0;16.4;6.7;0.0
17;2021-04-02;3611;843;0;109484;44133;0;16.9;6.8;0.0
17;2021-04-03;1153;185;0;110637;44318;0;17.1;6.8;0.0
17;2021-04-04;464;12;0;111101;44330;0;17.2;6.9;0.0
17;2021-04-05;434;120;0;111535;44450;0;17.2;6.9;0.0
17;2021-04-06;3366;1027;0;114901;45477;0;17.8;7.0;0.0
17;2021-04-07;4033;1155;0;118934;46632;0;18.4;7.2;0.0
17;2021-04-08;4530;1468;0;123464;48100;0;19.1;7.4;0.0
17;2021-04-09;6317;840;0;129781;48940;0;20.1;7.6;0.0
17;2021-04-10;2557;86;0;132338;49026;0;20.5;7.6;0.0
17;2021-04-11;749;23;0;133087;49049;0;20.6;7.6;0.0
17;2021-04-12;2875;1615;0;135962;50664;0;21.0;7.8;0.0
17;2021-04-13;4090;1269;0;140052;51933;0;21.6;8.0;0.0
17;2021-04-14;4280;1192;0;144332;53125;0;22.3;8.2;0.0
17;2021-04-15;4540;1164;0;148872;54289;0;23.0;8.4;0.0
17;2021-04-16;4183;1166;0;153055;55455;0;23.7;8.6;0.0
17;2021-04-17;1711;377;0;154766;55832;0;23.9;8.6;0.0
17;2021-04-18;440;79;0;155206;55911;0;24.0;8.6;0.0
17;2021-04-19;2324;2008;0;157530;57919;0;24.3;9.0;0.0
17;2021-04-20;2864;2485;0;160394;60404;0;24.8;9.3;0.0
17;2021-04-21;2963;1878;0;163357;62282;0;25.2;9.6;0.0
17;2021-04-22;3173;2306;0;166530;64588;0;25.7;10.0;0.0
17;2021-04-23;2450;2676;0;168980;67264;0;26.1;10.4;0.0
17;2021-04-24;1666;938;0;170646;68202;0;26.4;10.5;0.0
17;2021-04-25;621;227;0;171267;68429;0;26.5;10.6;0.0
17;2021-04-26;2548;2529;0;173815;70958;0;26.9;11.0;0.0
17;2021-04-27;3112;2603;0;176927;73561;0;27.3;11.4;0.0
17;2021-04-28;3131;2878;0;180058;76439;0;27.8;11.8;0.0
17;2021-04-29;4152;2781;0;184210;79220;0;28.5;12.2;0.0
17;2021-04-30;4415;2566;0;188625;81786;0;29.2;12.6;0.0
17;2021-05-01;898;525;0;189523;82311;0;29.3;12.7;0.0
17;2021-05-02;561;760;0;190084;83071;0;29.4;12.8;0.0
17;2021-05-03;2622;2892;0;192706;85963;0;29.8;13.3;0.0
17;2021-05-04;2400;3656;0;195106;89619;0;30.2;13.8;0.0
17;2021-05-05;2951;3693;0;198057;93312;0;30.6;14.4;0.0
17;2021-05-06;4136;3367;0;202193;96679;0;31.2;14.9;0.0
17;2021-05-07;4405;3650;0;206598;100329;0;31.9;15.5;0.0
17;2021-05-08;1376;775;0;207974;101104;0;32.1;15.6;0.0
17;2021-05-09;1280;676;0;209254;101780;0;32.3;15.7;0.0
17;2021-05-10;2762;3640;0;212016;105420;0;32.8;16.3;0.0
17;2021-05-11;3510;3934;0;215526;109354;0;33.3;16.9;0.0
17;2021-05-12;3599;3704;0;219125;113058;0;33.9;17.5;0.0
17;2021-05-13;2665;694;0;221790;113752;0;34.3;17.6;0.0
17;2021-05-14;3121;2385;0;224911;116137;0;34.8;17.9;0.0
17;2021-05-15;2172;707;0;227083;116844;0;35.1;18.1;0.0
17;2021-05-16;1600;305;0;228683;117149;0;35.3;18.1;0.0
17;2021-05-17;4182;1986;0;232865;119135;0;36.0;18.4;0.0
17;2021-05-18;4723;1641;0;237588;120776;0;36.7;18.7;0.0
17;2021-05-19;5043;1299;0;242631;122075;0;37.5;18.9;0.0
17;2021-05-20;4815;1904;0;247446;123979;0;38.2;19.2;0.0
17;2021-05-21;4775;1904;0;252221;125883;0;39.0;19.5;0.0
17;2021-05-22;2103;546;0;254324;126429;0;39.3;19.5;0.0
17;2021-05-23;1555;110;0;255879;126539;0;39.5;19.6;0.0
17;2021-05-24;1267;211;0;257146;126750;0;39.7;19.6;0.0
17;2021-05-25;3795;1753;0;260941;128503;0;40.3;19.9;0.0
17;2021-05-26;4182;1986;0;265123;130489;0;41.0;20.2;0.0
17;2021-05-27;4932;2116;0;270055;132605;0;41.7;20.5;0.0
17;2021-05-28;4227;3283;0;274282;135888;0;42.4;21.0;0.0
17;2021-05-29;1502;1676;0;275784;137564;0;42.6;21.3;0.0
17;2021-05-30;650;369;0;276434;137933;0;42.7;21.3;0.0
17;2021-05-31;2897;2930;0;279331;140863;0;43.2;21.8;0.0
17;2021-06-01;4297;2879;0;283628;143742;0;43.8;22.2;0.0
17;2021-06-02;4300;3137;0;287928;146879;0;44.5;22.7;0.0
17;2021-06-03;5078;3108;0;293006;149987;0;45.3;23.2;0.0
17;2021-06-04;4538;3767;0;297544;153754;0;46.0;23.8;0.0
17;2021-06-05;2062;1574;0;299606;155328;0;46.3;24.0;0.0
17;2021-06-06;815;688;0;300421;156016;0;46.4;24.1;0.0
17;2021-06-07;3193;4177;0;303614;160193;0;46.9;24.8;0.0
17;2021-06-08;3847;4435;0;307461;164628;0;47.5;25.4;0.0
17;2021-06-09;4478;3077;0;311939;167705;0;48.2;25.9;0.0
17;2021-06-10;4880;2826;0;316819;170531;0;49.0;26.4;0.0
17;2021-06-11;4743;3707;0;321562;174238;0;49.7;26.9;0.0
17;2021-06-12;1978;1410;0;323540;175648;0;50.0;27.1;0.0
17;2021-06-13;621;412;0;324161;176060;0;50.1;27.2;0.0
17;2021-06-14;2687;4501;0;326848;180561;0;50.5;27.9;0.0
17;2021-06-15;3521;4324;0;330369;184885;0;51.1;28.6;0.0
17;2021-06-16;3963;3639;0;334332;188524;0;51.7;29.1;0.0
17;2021-06-17;4196;4117;0;338528;192641;0;52.3;29.8;0.0
17;2021-06-18;3936;4394;0;342464;197035;0;52.9;30.4;0.0
17;2021-06-19;1540;2007;0;344004;199042;0;53.2;30.8;0.0
17;2021-06-20;565;988;0;344569;200030;0;53.2;30.9;0.0
17;2021-06-21;2427;4323;0;346996;204353;0;53.6;31.6;0.0
17;2021-06-22;3340;4372;0;350336;208725;0;54.1;32.3;0.0
17;2021-06-23;3590;3990;0;353926;212715;0;54.7;32.9;0.0
17;2021-06-24;3386;3871;0;357312;216586;0;55.2;33.5;0.0
17;2021-06-25;2580;4910;0;359892;221496;0;55.6;34.2;0.0
17;2021-06-26;945;2302;0;360837;223798;0;55.8;34.6;0.0
17;2021-06-27;381;1747;0;361218;225545;0;55.8;34.9;0.0
17;2021-06-28;1445;5253;0;362663;230798;0;56.0;35.7;0.0
17;2021-06-29;1622;5714;0;364285;236512;0;56.3;36.6;0.0
17;2021-06-30;1962;5517;0;366247;242029;0;56.6;37.4;0.0
17;2021-07-01;2144;5359;0;368391;247388;0;56.9;38.2;0.0
17;2021-07-02;2328;5649;0;370719;253037;0;57.3;39.1;0.0
17;2021-07-03;655;2374;0;371374;255411;0;57.4;39.5;0.0
17;2021-07-04;139;1070;0;371513;256481;0;57.4;39.6;0.0
17;2021-07-05;1646;4784;0;373159;261265;0;57.7;40.4;0.0
17;2021-07-06;1952;5246;0;375111;266511;0;58.0;41.2;0.0
17;2021-07-07;2231;5289;0;377342;271800;0;58.3;42.0;0.0
17;2021-07-08;2591;5107;0;379933;276907;0;58.7;42.8;0.0
17;2021-07-09;2288;5742;0;382221;282649;0;59.1;43.7;0.0
17;2021-07-10;827;2400;0;383048;285049;0;59.2;44.1;0.0
17;2021-07-11;310;793;0;383358;285842;0;59.2;44.2;0.0
17;2021-07-12;1695;5305;0;385053;291147;0;59.5;45.0;0.0
17;2021-07-13;2070;6349;0;387123;297496;0;59.8;46.0;0.0
17;2021-07-14;211;240;0;387334;297736;0;59.9;46.0;0.0
17;2021-07-15;2007;6557;0;389341;304293;0;60.2;47.0;0.0
17;2021-07-16;2593;6510;0;391934;310803;0;60.6;48.0;0.0
17;2021-07-17;1056;2328;0;392990;313131;0;60.7;48.4;0.0
17;2021-07-18;320;936;0;393310;314067;0;60.8;48.5;0.0
17;2021-07-19;2351;5645;0;395661;319712;0;61.1;49.4;0.0
17;2021-07-20;2973;6015;0;398634;325727;0;61.6;50.3;0.0
17;2021-07-21;3468;5703;0;402102;331430;0;62.1;51.2;0.0
17;2021-07-22;3821;5803;0;405923;337233;0;62.7;52.1;0.0
17;2021-07-23;3588;6064;0;409511;343297;0;63.3;53.1;0.0
17;2021-07-24;1807;1575;0;411318;344872;0;63.6;53.3;0.0
17;2021-07-25;798;345;0;412116;345217;0;63.7;53.3;0.0
17;2021-07-26;3190;4970;0;415306;350187;0;64.2;54.1;0.0
17;2021-07-27;4208;4901;0;419514;355088;0;64.8;54.9;0.0
17;2021-07-28;4705;4675;0;424219;359763;0;65.6;55.6;0.0
17;2021-07-29;4690;4752;0;428909;364515;0;66.3;56.3;0.0
17;2021-07-30;4836;5001;0;433745;369516;0;67.0;57.1;0.0
17;2021-07-31;1920;1216;0;435665;370732;0;67.3;57.3;0.0
17;2021-08-01;858;298;0;436523;371030;0;67.5;57.3;0.0
17;2021-08-02;4011;3736;0;440534;374766;0;68.1;57.9;0.0
17;2021-08-03;4998;3518;0;445532;378284;0;68.9;58.5;0.0
17;2021-08-04;5492;2721;0;451024;381005;0;69.7;58.9;0.0
17;2021-08-05;5553;2548;0;456577;383553;0;70.6;59.3;0.0
17;2021-08-06;5138;2963;0;461715;386516;0;71.4;59.7;0.0
17;2021-08-07;1840;851;0;463555;387367;0;71.6;59.9;0.0
17;2021-08-08;764;144;0;464319;387511;0;71.8;59.9;0.0
17;2021-08-09;3479;2865;0;467798;390376;0;72.3;60.3;0.0
17;2021-08-10;4559;2825;0;472357;393201;0;73.0;60.8;0.0
17;2021-08-11;4390;3058;0;476747;396259;0;73.7;61.2;0.0
17;2021-08-12;4399;3154;0;481146;399413;0;74.4;61.7;0.0
17;2021-08-13;4044;3335;0;485190;402748;0;75.0;62.2;0.0
17;2021-08-14;1202;1271;0;486392;404019;0;75.2;62.4;0.0
17;2021-08-15;340;235;0;486732;404254;0;75.2;62.5;0.0
17;2021-08-16;2570;3251;0;489302;407505;0;75.6;63.0;0.0
17;2021-08-17;2782;3573;0;492084;411078;0;76.0;63.5;0.0
17;2021-08-18;2402;3839;0;494486;414917;0;76.4;64.1;0.0
17;2021-08-19;2454;3724;0;496940;418641;0;76.8;64.7;0.0
17;2021-08-20;2286;4246;0;499226;422887;0;77.2;65.4;0.0
17;2021-08-21;695;1336;0;499921;424223;0;77.3;65.6;0.0
17;2021-08-22;160;400;0;500081;424623;0;77.3;65.6;0.0
17;2021-08-23;1836;4339;0;501917;428962;0;77.6;66.3;0.0
17;2021-08-24;1799;4542;0;503716;433504;0;77.8;67.0;0.0
17;2021-08-25;1542;4968;0;505258;438472;0;78.1;67.8;0.0
17;2021-08-26;1554;5063;0;506812;443535;0;78.3;68.5;0.0
17;2021-08-27;1438;5450;0;508250;448985;0;78.5;69.4;0.0
17;2021-08-28;527;1495;0;508777;450480;0;78.6;69.6;0.0
17;2021-08-29;90;528;1;508867;451008;1;78.6;69.7;0.0
17;2021-08-30;1361;4731;50;510228;455739;51;78.9;70.4;0.0
17;2021-08-31;1248;4906;118;511476;460645;169;79.0;71.2;0.0
17;2021-09-01;1197;4537;321;512673;465182;490;79.2;71.9;0.1
17;2021-09-02;1081;3970;383;513754;469152;873;79.4;72.5;0.1
17;2021-09-03;1125;4657;385;514879;473809;1258;79.6;73.2;0.2
17;2021-09-04;331;1146;48;515210;474955;1306;79.6;73.4;0.2
17;2021-09-05;52;120;27;515262;475075;1333;79.6;73.4;0.2
17;2021-09-06;723;3065;512;515985;478140;1845;79.7;73.9;0.3
17;2021-09-07;712;2547;582;516697;480687;2427;79.9;74.3;0.4
17;2021-09-08;799;3480;525;517496;484167;2952;80.0;74.8;0.5
17;2021-09-09;778;2345;733;518274;486512;3685;80.1;75.2;0.6
17;2021-09-10;786;3237;587;519060;489749;4272;80.2;75.7;0.7
17;2021-09-11;322;1035;148;519382;490784;4420;80.3;75.8;0.7
17;2021-09-12;15;35;10;519397;490819;4430;80.3;75.9;0.7
17;2021-09-13;608;1892;863;520005;492711;5293;80.4;76.1;0.8
17;2021-09-14;606;1606;1266;520611;494317;6559;80.5;76.4;1.0
17;2021-09-15;866;2261;947;521477;496578;7506;80.6;76.7;1.2
17;2021-09-16;530;1429;894;522007;498007;8400;80.7;77.0;1.3
17;2021-09-17;628;1888;762;522635;499895;9162;80.8;77.3;1.4
17;2021-09-18;210;687;169;522845;500582;9331;80.8;77.4;1.4
17;2021-09-19;15;18;11;522860;500600;9342;80.8;77.4;1.4
17;2021-09-20;411;1217;949;523271;501817;10291;80.9;77.6;1.6
17;2021-09-21;340;875;784;523611;502692;11075;80.9;77.7;1.7
17;2021-09-22;418;1661;790;524029;504353;11865;81.0;77.9;1.8
17;2021-09-23;362;972;1080;524391;505325;12945;81.0;78.1;2.0
17;2021-09-24;386;1773;1164;524777;507098;14109;81.1;78.4;2.2
17;2021-09-25;155;569;237;524932;507667;14346;81.1;78.5;2.2
17;2021-09-26;9;28;2;524941;507695;14348;81.1;78.5;2.2
17;2021-09-27;402;1135;947;525343;508830;15295;81.2;78.6;2.4
17;2021-09-28;257;679;863;525600;509509;16158;81.2;78.7;2.5
17;2021-09-29;454;1217;955;526054;510726;17113;81.3;78.9;2.6
17;2021-09-30;350;694;895;526404;511420;18008;81.4;79.0;2.8
17;2021-10-01;391;767;800;526795;512187;18808;81.4;79.2;2.9
17;2021-10-02;135;378;147;526930;512565;18955;81.4;79.2;2.9
17;2021-10-03;4;30;2;526934;512595;18957;81.4;79.2;2.9
17;2021-10-04;359;812;1064;527293;513407;20021;81.5;79.3;3.1
17;2021-10-05;354;572;919;527647;513979;20940;81.5;79.4;3.2
17;2021-10-06;410;1070;1130;528057;515049;22070;81.6;79.6;3.4
17;2021-10-07;261;531;802;528318;515580;22872;81.6;79.7;3.5
17;2021-10-08;428;868;1060;528746;516448;23932;81.7;79.8;3.7
17;2021-10-09;170;347;215;528916;516795;24147;81.7;79.9;3.7
17;2021-10-10;6;19;5;528922;516814;24152;81.7;79.9;3.7
17;2021-10-11;352;535;814;529274;517349;24966;81.8;80.0;3.9
17;2021-10-12;228;383;834;529502;517732;25800;81.8;80.0;4.0
17;2021-10-13;354;657;1255;529856;518389;27055;81.9;80.1;4.2
17;2021-10-14;232;397;880;530088;518786;27935;81.9;80.2;4.3
17;2021-10-15;384;633;1237;530472;519419;29172;82.0;80.3;4.5
17;2021-10-16;108;176;243;530580;519595;29415;82.0;80.3;4.5
17;2021-10-17;10;12;0;530590;519607;29415;82.0;80.3;4.5
17;2021-10-18;322;338;951;530912;519945;30366;82.0;80.4;4.7
17;2021-10-19;226;346;935;531138;520291;31301;82.1;80.4;4.8
17;2021-10-20;340;580;1468;531478;520871;32769;82.1;80.5;5.1
17;2021-10-21;216;343;998;531694;521214;33767;82.2;80.5;5.2
17;2021-10-22;320;538;1359;532014;521752;35126;82.2;80.6;5.4
17;2021-10-23;96;179;283;532110;521931;35409;82.2;80.7;5.5
17;2021-10-24;0;5;3;532110;521936;35412;82.2;80.7;5.5
17;2021-10-25;233;339;1212;532343;522275;36624;82.3;80.7;5.7
17;2021-10-26;153;253;971;532496;522528;37595;82.3;80.8;5.8
17;2021-10-27;256;440;2062;532752;522968;39657;82.3;80.8;6.1
17;2021-10-28;161;244;1062;532913;523212;40719;82.4;80.9;6.3
17;2021-10-29;232;411;1743;533145;523623;42462;82.4;80.9;6.6
17;2021-10-30;74;131;414;533219;523754;42876;82.4;80.9;6.6
17;2021-10-31;9;8;3;533228;523762;42879;82.4;80.9;6.6
17;2021-11-01;15;16;22;533243;523778;42901;82.4;80.9;6.6
17;2021-11-02;238;318;1220;533481;524096;44121;82.4;81.0;6.8
17;2021-11-03;234;334;1676;533715;524430;45797;82.5;81.0;7.1
17;2021-11-04;136;211;1335;533851;524641;47132;82.5;81.1;7.3
17;2021-11-05;229;340;1645;534080;524981;48777;82.5;81.1;7.5
17;2021-11-06;83;137;359;534163;525118;49136;82.5;81.2;7.6
17;2021-11-07;1;6;8;534164;525124;49144;82.5;81.2;7.6
17;2021-11-08;190;414;2142;534354;525538;51286;82.6;81.2;7.9
17;2021-11-09;199;388;2331;534553;525926;53617;82.6;81.3;8.3
17;2021-11-10;303;465;2831;534856;526391;56448;82.7;81.3;8.7
17;2021-11-11;4;9;73;534860;526400;56521;82.7;81.4;8.7
17;2021-11-12;164;244;2115;535024;526644;58636;82.7;81.4;9.1
17;2021-11-13;61;63;557;535085;526707;59193;82.7;81.4;9.1
17;2021-11-14;2;25;15;535087;526732;59208;82.7;81.4;9.2
17;2021-11-15;186;234;2313;535273;526966;61521;82.7;81.4;9.5
17;2021-11-16;196;262;2479;535469;527228;64000;82.8;81.5;9.9
17;2021-11-17;296;363;2940;535765;527591;66940;82.8;81.5;10.3
17;2021-11-18;229;197;2591;535994;527788;69531;82.8;81.6;10.7
17;2021-11-19;261;366;2827;536255;528154;72358;82.9;81.6;11.2
17;2021-11-20;115;146;649;536370;528300;73007;82.9;81.6;11.3
17;2021-11-21;9;6;27;536379;528306;73034;82.9;81.6;11.3
17;2021-11-22;285;186;2987;536664;528492;76021;82.9;81.7;11.7
17;2021-11-23;280;212;3307;536944;528704;79328;83.0;81.7;12.3
17;2021-11-24;292;343;3223;537236;529047;82551;83.0;81.8;12.8
17;2021-11-25;276;213;3385;537512;529260;85936;83.1;81.8;13.3
17;2021-11-26;306;322;4123;537818;529582;90059;83.1;81.8;13.9
17;2021-11-27;89;104;1044;537907;529686;91103;83.1;81.9;14.1
17;2021-11-28;12;6;156;537919;529692;91259;83.1;81.9;14.1
17;2021-11-29;162;249;4056;538081;529941;95315;83.2;81.9;14.7
17;2021-11-30;235;200;5476;538316;530141;100791;83.2;81.9;15.6
17;2021-12-01;218;329;5534;538534;530470;106325;83.2;82.0;16.4
17;2021-12-02;209;179;5858;538743;530649;112183;83.3;82.0;17.3
17;2021-12-03;232;259;6189;538975;530908;118372;83.3;82.0;18.3
17;2021-12-04;66;78;1579;539041;530986;119951;83.3;82.1;18.5
17;2021-12-05;9;19;235;539050;531005;120186;83.3;82.1;18.6
17;2021-12-06;133;213;5821;539183;531218;126007;83.3;82.1;19.5
17;2021-12-07;196;190;7338;539379;531408;133345;83.4;82.1;20.6
17;2021-12-08;175;316;6903;539554;531724;140248;83.4;82.2;21.7
17;2021-12-09;191;234;7633;539745;531958;147881;83.4;82.2;22.9
17;2021-12-10;181;281;8322;539926;532239;156203;83.4;82.3;24.1
17;2021-12-11;103;107;2343;540029;532346;158546;83.5;82.3;24.5
17;2021-12-12;27;19;525;540056;532365;159071;83.5;82.3;24.6
17;2021-12-13;159;260;6957;540215;532625;166028;83.5;82.3;25.7
17;2021-12-14;238;337;9119;540453;532962;175147;83.5;82.4;27.1
17;2021-12-15;248;360;8333;540701;533322;183480;83.6;82.4;28.4
17;2021-12-16;269;322;9355;540970;533644;192835;83.6;82.5;29.8
18;2020-12-27;0;0;0;0;0;0;0.0;0.0;0.0
18;2020-12-28;0;0;0;0;0;0;0.0;0.0;0.0
18;2020-12-29;0;0;0;0;0;0;0.0;0.0;0.0
18;2020-12-30;1;0;0;1;0;0;0.0;0.0;0.0
18;2020-12-31;0;0;0;1;0;0;0.0;0.0;0.0
18;2021-01-01;0;0;0;1;0;0;0.0;0.0;0.0
18;2021-01-02;0;0;0;1;0;0;0.0;0.0;0.0
18;2021-01-03;0;0;0;1;0;0;0.0;0.0;0.0
18;2021-01-04;2;0;0;3;0;0;0.0;0.0;0.0
18;2021-01-05;5;0;0;8;0;0;0.0;0.0;0.0
18;2021-01-06;7;0;0;15;0;0;0.0;0.0;0.0
18;2021-01-07;36;1;0;51;1;0;0.0;0.0;0.0
18;2021-01-08;74;0;0;125;1;0;0.0;0.0;0.0
18;2021-01-09;214;0;0;339;1;0;0.1;0.0;0.0
18;2021-01-10;149;0;0;488;1;0;0.2;0.0;0.0
18;2021-01-11;185;0;0;673;1;0;0.2;0.0;0.0
18;2021-01-12;332;0;0;1005;1;0;0.3;0.0;0.0
18;2021-01-13;243;2;0;1248;3;0;0.4;0.0;0.0
18;2021-01-14;288;2;0;1536;5;0;0.5;0.0;0.0
18;2021-01-15;275;2;0;1811;7;0;0.6;0.0;0.0
18;2021-01-16;169;1;0;1980;8;0;0.7;0.0;0.0
18;2021-01-17;2;0;0;1982;8;0;0.7;0.0;0.0
18;2021-01-18;318;0;0;2300;8;0;0.8;0.0;0.0
18;2021-01-19;1281;4;0;3581;12;0;1.2;0.0;0.0
18;2021-01-20;1074;2;0;4655;14;0;1.6;0.0;0.0
18;2021-01-21;887;1;0;5542;15;0;1.9;0.0;0.0
18;2021-01-22;667;1;0;6209;16;0;2.1;0.0;0.0
18;2021-01-23;210;2;0;6419;18;0;2.2;0.0;0.0
18;2021-01-24;4;0;0;6423;18;0;2.2;0.0;0.0
18;2021-01-25;441;1;0;6864;19;0;2.3;0.0;0.0
18;2021-01-26;380;1;0;7244;20;0;2.4;0.0;0.0
18;2021-01-27;410;11;0;7654;31;0;2.6;0.0;0.0
18;2021-01-28;519;12;0;8173;43;0;2.8;0.0;0.0
18;2021-01-29;440;70;0;8613;113;0;2.9;0.0;0.0
18;2021-01-30;362;154;0;8975;267;0;3.0;0.1;0.0
18;2021-01-31;80;120;0;9055;387;0;3.1;0.1;0.0
18;2021-02-01;271;136;0;9326;523;0;3.1;0.2;0.0
18;2021-02-02;442;229;0;9768;752;0;3.3;0.3;0.0
18;2021-02-03;413;192;0;10181;944;0;3.4;0.3;0.0
18;2021-02-04;594;189;0;10775;1133;0;3.6;0.4;0.0
18;2021-02-05;382;169;0;11157;1302;0;3.8;0.4;0.0
18;2021-02-06;274;97;0;11431;1399;0;3.9;0.5;0.0
18;2021-02-07;108;2;0;11539;1401;0;3.9;0.5;0.0
18;2021-02-08;306;236;0;11845;1637;0;4.0;0.6;0.0
18;2021-02-09;593;740;0;12438;2377;0;4.2;0.8;0.0
18;2021-02-10;752;667;0;13190;3044;0;4.5;1.0;0.0
18;2021-02-11;670;456;0;13860;3500;0;4.7;1.2;0.0
18;2021-02-12;493;291;0;14353;3791;0;4.8;1.3;0.0
18;2021-02-13;274;122;0;14627;3913;0;4.9;1.3;0.0
18;2021-02-14;350;92;0;14977;4005;0;5.1;1.4;0.0
18;2021-02-15;370;404;0;15347;4409;0;5.2;1.5;0.0
18;2021-02-16;390;450;0;15737;4859;0;5.3;1.6;0.0
18;2021-02-17;410;500;0;16147;5359;0;5.4;1.8;0.0
18;2021-02-18;270;556;0;16417;5915;0;5.5;2.0;0.0
18;2021-02-19;323;368;0;16740;6283;0;5.6;2.1;0.0
18;2021-02-20;615;230;0;17355;6513;0;5.9;2.2;0.0
18;2021-02-21;313;5;0;17668;6518;0;6.0;2.2;0.0
18;2021-02-22;215;412;0;17883;6930;0;6.0;2.3;0.0
18;2021-02-23;237;383;0;18120;7313;0;6.1;2.5;0.0
18;2021-02-24;225;284;0;18345;7597;0;6.2;2.6;0.0
18;2021-02-25;329;571;0;18674;8168;0;6.3;2.8;0.0
18;2021-02-26;587;293;0;19261;8461;0;6.5;2.9;0.0
18;2021-02-27;495;390;0;19756;8851;0;6.7;3.0;0.0
18;2021-02-28;6;73;0;19762;8924;0;6.7;3.0;0.0
18;2021-03-01;249;426;0;20011;9350;0;6.8;3.2;0.0
18;2021-03-02;323;560;0;20334;9910;0;6.9;3.3;0.0
18;2021-03-03;360;610;0;20694;10520;0;7.0;3.5;0.0
18;2021-03-04;519;606;0;21213;11126;0;7.2;3.8;0.0
18;2021-03-05;588;365;0;21801;11491;0;7.4;3.9;0.0
18;2021-03-06;1077;340;0;22878;11831;0;7.7;4.0;0.0
18;2021-03-07;51;136;0;22929;11967;0;7.7;4.0;0.0
18;2021-03-08;339;379;0;23268;12346;0;7.9;4.2;0.0
18;2021-03-09;463;398;0;23731;12744;0;8.0;4.3;0.0
18;2021-03-10;493;465;0;24224;13209;0;8.2;4.5;0.0
18;2021-03-11;552;408;0;24776;13617;0;8.4;4.6;0.0
18;2021-03-12;799;322;0;25575;13939;0;8.6;4.7;0.0
18;2021-03-13;1192;241;0;26767;14180;0;9.0;4.8;0.0
18;2021-03-14;298;209;0;27065;14389;0;9.1;4.9;0.0
18;2021-03-15;528;393;0;27593;14782;0;9.3;5.0;0.0
18;2021-03-16;447;319;0;28040;15101;0;9.5;5.1;0.0
18;2021-03-17;408;415;0;28448;15516;0;9.6;5.2;0.0
18;2021-03-18;513;249;0;28961;15765;0;9.8;5.3;0.0
18;2021-03-19;793;243;0;29754;16008;0;10.0;5.4;0.0
18;2021-03-20;967;606;0;30721;16614;0;10.4;5.6;0.0
18;2021-03-21;310;303;0;31031;16917;0;10.5;5.7;0.0
18;2021-03-22;600;286;0;31631;17203;0;10.7;5.8;0.0
18;2021-03-23;829;278;0;32460;17481;0;11.0;5.9;0.0
18;2021-03-24;1118;284;0;33578;17765;0;11.3;6.0;0.0
18;2021-03-25;1242;308;0;34820;18073;0;11.7;6.1;0.0
18;2021-03-26;1314;347;0;36134;18420;0;12.2;6.2;0.0
18;2021-03-27;1478;312;0;37612;18732;0;12.7;6.3;0.0
18;2021-03-28;213;5;0;37825;18737;0;12.8;6.3;0.0
18;2021-03-29;1054;218;0;38879;18955;0;13.1;6.4;0.0
18;2021-03-30;1116;322;0;39995;19277;0;13.5;6.5;0.0
18;2021-03-31;1371;274;0;41366;19551;0;14.0;6.6;0.0
18;2021-04-01;1433;356;0;42799;19907;0;14.4;6.7;0.0
18;2021-04-02;1280;328;0;44079;20235;0;14.9;6.8;0.0
18;2021-04-03;623;174;0;44702;20409;0;15.1;6.9;0.0
18;2021-04-04;78;6;0;44780;20415;0;15.1;6.9;0.0
18;2021-04-05;205;2;0;44985;20417;0;15.2;6.9;0.0
18;2021-04-06;1087;367;0;46072;20784;0;15.5;7.0;0.0
18;2021-04-07;1290;412;0;47362;21196;0;16.0;7.2;0.0
18;2021-04-08;1728;368;0;49090;21564;0;16.6;7.3;0.0
18;2021-04-09;1902;329;0;50992;21893;0;17.2;7.4;0.0
18;2021-04-10;2552;653;0;53544;22546;0;18.1;7.6;0.0
18;2021-04-11;1878;324;0;55422;22870;0;18.7;7.7;0.0
18;2021-04-12;1382;423;0;56804;23293;0;19.2;7.9;0.0
18;2021-04-13;1715;492;0;58519;23785;0;19.7;8.0;0.0
18;2021-04-14;1362;530;0;59881;24315;0;20.2;8.2;0.0
18;2021-04-15;1501;579;0;61382;24894;0;20.7;8.4;0.0
18;2021-04-16;1692;636;0;63074;25530;0;21.3;8.6;0.0
18;2021-04-17;1501;525;0;64575;26055;0;21.8;8.8;0.0
18;2021-04-18;369;235;0;64944;26290;0;21.9;8.9;0.0
18;2021-04-19;1309;591;0;66253;26881;0;22.4;9.1;0.0
18;2021-04-20;1366;799;0;67619;27680;0;22.8;9.3;0.0
18;2021-04-21;1232;962;0;68851;28642;0;23.2;9.7;0.0
18;2021-04-22;1350;848;0;70201;29490;0;23.7;9.9;0.0
18;2021-04-23;1387;761;0;71588;30251;0;24.2;10.2;0.0
18;2021-04-24;1326;1253;0;72914;31504;0;24.6;10.6;0.0
18;2021-04-25;299;206;0;73213;31710;0;24.7;10.7;0.0
18;2021-04-26;1186;892;0;74399;32602;0;25.1;11.0;0.0
18;2021-04-27;1461;801;0;75860;33403;0;25.6;11.3;0.0
18;2021-04-28;1346;972;0;77206;34375;0;26.0;11.6;0.0
18;2021-04-29;1745;808;0;78951;35183;0;26.6;11.9;0.0
18;2021-04-30;1516;1046;0;80467;36229;0;27.1;12.2;0.0
18;2021-05-01;781;225;0;81248;36454;0;27.4;12.3;0.0
18;2021-05-02;764;63;0;82012;36517;0;27.7;12.3;0.0
18;2021-05-03;1638;1007;0;83650;37524;0;28.2;12.7;0.0
18;2021-05-04;1681;1333;0;85331;38857;0;28.8;13.1;0.0
18;2021-05-05;1675;1195;0;87006;40052;0;29.4;13.5;0.0
18;2021-05-06;2161;1377;0;89167;41429;0;30.1;14.0;0.0
18;2021-05-07;1283;1407;0;90450;42836;0;30.5;14.5;0.0
18;2021-05-08;976;1433;0;91426;44269;0;30.8;14.9;0.0
18;2021-05-09;482;2153;0;91908;46422;0;31.0;15.7;0.0
18;2021-05-10;1192;1499;0;93100;47921;0;31.4;16.2;0.0
18;2021-05-11;1738;1696;0;94838;49617;0;32.0;16.7;0.0
18;2021-05-12;1859;1387;0;96697;51004;0;32.6;17.2;0.0
18;2021-05-13;1083;324;0;97780;51328;0;33.0;17.3;0.0
18;2021-05-14;1440;981;0;99220;52309;0;33.5;17.6;0.0
18;2021-05-15;1882;1089;0;101102;53398;0;34.1;18.0;0.0
18;2021-05-16;544;555;0;101646;53953;0;34.3;18.2;0.0
18;2021-05-17;1292;1073;0;102938;55026;0;34.7;18.6;0.0
18;2021-05-18;2094;935;0;105032;55961;0;35.4;18.9;0.0
18;2021-05-19;2104;925;0;107136;56886;0;36.1;19.2;0.0
18;2021-05-20;2181;961;0;109317;57847;0;36.9;19.5;0.0
18;2021-05-21;1567;828;0;110884;58675;0;37.4;19.8;0.0
18;2021-05-22;1690;1043;0;112574;59718;0;38.0;20.1;0.0
18;2021-05-23;494;334;0;113068;60052;0;38.1;20.3;0.0
18;2021-05-24;576;302;0;113644;60354;0;38.3;20.4;0.0
18;2021-05-25;1711;1034;0;115355;61388;0;38.9;20.7;0.0
18;2021-05-26;2030;868;0;117385;62256;0;39.6;21.0;0.0
18;2021-05-27;1992;1164;0;119377;63420;0;40.3;21.4;0.0
18;2021-05-28;1707;1361;0;121084;64781;0;40.9;21.9;0.0
18;2021-05-29;2454;1616;0;123538;66397;0;41.7;22.4;0.0
18;2021-05-30;1481;488;0;125019;66885;0;42.2;22.6;0.0
18;2021-05-31;1586;679;0;126605;67564;0;42.7;22.8;0.0
18;2021-06-01;1926;952;0;128531;68516;0;43.4;23.1;0.0
18;2021-06-02;1878;1007;0;130409;69523;0;44.0;23.5;0.0
18;2021-06-03;2056;1214;0;132465;70737;0;44.7;23.9;0.0
18;2021-06-04;1817;1138;0;134282;71875;0;45.3;24.2;0.0
18;2021-06-05;2326;1396;0;136608;73271;0;46.1;24.7;0.0
18;2021-06-06;371;395;0;136979;73666;0;46.2;24.9;0.0
18;2021-06-07;1211;1190;0;138190;74856;0;46.6;25.3;0.0
18;2021-06-08;1480;1315;0;139670;76171;0;47.1;25.7;0.0
18;2021-06-09;1341;1057;0;141011;77228;0;47.6;26.1;0.0
18;2021-06-10;1548;1348;0;142559;78576;0;48.1;26.5;0.0
18;2021-06-11;1463;1401;0;144022;79977;0;48.6;27.0;0.0
18;2021-06-12;1205;2478;0;145227;82455;0;49.0;27.8;0.0
18;2021-06-13;145;258;0;145372;82713;0;49.0;27.9;0.0
18;2021-06-14;657;1852;0;146029;84565;0;49.3;28.5;0.0
18;2021-06-15;1187;1811;0;147216;86376;0;49.7;29.1;0.0
18;2021-06-16;1287;1445;0;148503;87821;0;50.1;29.6;0.0
18;2021-06-17;1327;1662;0;149830;89483;0;50.5;30.2;0.0
18;2021-06-18;1346;1733;0;151176;91216;0;51.0;30.8;0.0
18;2021-06-19;1511;1209;0;152687;92425;0;51.5;31.2;0.0
18;2021-06-20;251;179;0;152938;92604;0;51.6;31.2;0.0
18;2021-06-21;663;1689;0;153601;94293;0;51.8;31.8;0.0
18;2021-06-22;1095;1749;0;154696;96042;0;52.2;32.4;0.0
18;2021-06-23;1035;1704;0;155731;97746;0;52.5;33.0;0.0
18;2021-06-24;1053;1145;0;156784;98891;0;52.9;33.4;0.0
18;2021-06-25;963;1908;0;157747;100799;0;53.2;34.0;0.0
18;2021-06-26;1053;1533;0;158800;102332;0;53.6;34.5;0.0
18;2021-06-27;34;383;0;158834;102715;0;53.6;34.7;0.0
18;2021-06-28;433;1868;0;159267;104583;0;53.7;35.3;0.0
18;2021-06-29;613;2393;0;159880;106976;0;53.9;36.1;0.0
18;2021-06-30;642;2479;0;160522;109455;0;54.2;36.9;0.0
18;2021-07-01;1017;2058;0;161539;111513;0;54.5;37.6;0.0
18;2021-07-02;650;1666;0;162189;113179;0;54.7;38.2;0.0
18;2021-07-03;700;2440;0;162889;115619;0;55.0;39.0;0.0
18;2021-07-04;166;1006;0;163055;116625;0;55.0;39.3;0.0
18;2021-07-05;751;1819;0;163806;118444;0;55.3;40.0;0.0
18;2021-07-06;652;2307;0;164458;120751;0;55.5;40.7;0.0
18;2021-07-07;746;2059;0;165204;122810;0;55.7;41.4;0.0
18;2021-07-08;959;1878;0;166163;124688;0;56.1;42.1;0.0
18;2021-07-09;743;2347;0;166906;127035;0;56.3;42.9;0.0
18;2021-07-10;774;2985;0;167680;130020;0;56.6;43.9;0.0
18;2021-07-11;116;694;0;167796;130714;0;56.6;44.1;0.0
18;2021-07-12;280;2073;0;168076;132787;0;56.7;44.8;0.0
18;2021-07-13;708;2708;0;168784;135495;0;56.9;45.7;0.0
18;2021-07-14;256;903;0;169040;136398;0;57.0;46.0;0.0
18;2021-07-15;1485;2675;0;170525;139073;0;57.5;46.9;0.0
18;2021-07-16;1433;2178;0;171958;141251;0;58.0;47.7;0.0
18;2021-07-17;1128;2156;0;173086;143407;0;58.4;48.4;0.0
18;2021-07-18;259;336;0;173345;143743;0;58.5;48.5;0.0
18;2021-07-19;1265;1640;0;174610;145383;0;58.9;49.0;0.0
18;2021-07-20;1683;2326;0;176293;147709;0;59.5;49.8;0.0
18;2021-07-21;1868;2011;0;178161;149720;0;60.1;50.5;0.0
18;2021-07-22;2108;1955;0;180269;151675;0;60.8;51.2;0.0
18;2021-07-23;1518;1707;0;181787;153382;0;61.3;51.7;0.0
18;2021-07-24;1032;1516;0;182819;154898;0;61.7;52.3;0.0
18;2021-07-25;229;414;0;183048;155312;0;61.8;52.4;0.0
18;2021-07-26;1432;1494;0;184480;156806;0;62.2;52.9;0.0
18;2021-07-27;1876;1718;0;186356;158524;0;62.9;53.5;0.0
18;2021-07-28;2297;1866;0;188653;160390;0;63.6;54.1;0.0
18;2021-07-29;2208;1822;0;190861;162212;0;64.4;54.7;0.0
18;2021-07-30;1714;1437;0;192575;163649;0;65.0;55.2;0.0
18;2021-07-31;1171;1280;0;193746;164929;0;65.4;55.6;0.0
18;2021-08-01;125;39;0;193871;164968;0;65.4;55.7;0.0
18;2021-08-02;1491;825;0;195362;165793;0;65.9;55.9;0.0
18;2021-08-03;1860;1679;0;197222;167472;0;66.5;56.5;0.0
18;2021-08-04;2240;1101;0;199462;168573;0;67.3;56.9;0.0
18;2021-08-05;1721;1233;0;201183;169806;0;67.9;57.3;0.0
18;2021-08-06;1776;1155;0;202959;170961;0;68.5;57.7;0.0
18;2021-08-07;717;831;0;203676;171792;0;68.7;58.0;0.0
18;2021-08-08;62;79;0;203738;171871;0;68.7;58.0;0.0
18;2021-08-09;1122;1034;0;204860;172905;0;69.1;58.3;0.0
18;2021-08-10;1378;1642;0;206238;174547;0;69.6;58.9;0.0
18;2021-08-11;1708;1537;0;207946;176084;0;70.2;59.4;0.0
18;2021-08-12;1617;1621;0;209563;177705;0;70.7;60.0;0.0
18;2021-08-13;1099;1164;0;210662;178869;0;71.1;60.3;0.0
18;2021-08-14;772;657;0;211434;179526;0;71.3;60.6;0.0
18;2021-08-15;39;36;0;211473;179562;0;71.3;60.6;0.0
18;2021-08-16;815;1410;0;212288;180972;0;71.6;61.1;0.0
18;2021-08-17;1007;1977;0;213295;182949;0;72.0;61.7;0.0
18;2021-08-18;1141;1888;0;214436;184837;0;72.3;62.4;0.0
18;2021-08-19;1041;1726;0;215477;186563;0;72.7;62.9;0.0
18;2021-08-20;906;1764;0;216383;188327;0;73.0;63.5;0.0
18;2021-08-21;436;804;0;216819;189131;0;73.1;63.8;0.0
18;2021-08-22;24;88;0;216843;189219;0;73.2;63.8;0.0
18;2021-08-23;535;1664;0;217378;190883;0;73.3;64.4;0.0
18;2021-08-24;843;1734;0;218221;192617;0;73.6;65.0;0.0
18;2021-08-25;793;1882;0;219014;194499;0;73.9;65.6;0.0
18;2021-08-26;745;1697;0;219759;196196;0;74.1;66.2;0.0
18;2021-08-27;563;2061;0;220322;198257;0;74.3;66.9;0.0
18;2021-08-28;515;934;0;220837;199191;0;74.5;67.2;0.0
18;2021-08-29;92;181;0;220929;199372;0;74.5;67.3;0.0
18;2021-08-30;525;1388;33;221454;200760;33;74.7;67.7;0.0
18;2021-08-31;498;1535;47;221952;202295;80;74.9;68.2;0.0
18;2021-09-01;587;1602;130;222539;203897;210;75.1;68.8;0.1
18;2021-09-02;408;1264;154;222947;205161;364;75.2;69.2;0.1
18;2021-09-03;458;1193;164;223405;206354;528;75.4;69.6;0.2
18;2021-09-04;375;847;75;223780;207201;603;75.5;69.9;0.2
18;2021-09-05;32;62;23;223812;207263;626;75.5;69.9;0.2
18;2021-09-06;267;917;211;224079;208180;837;75.6;70.2;0.3
18;2021-09-07;314;946;162;224393;209126;999;75.7;70.6;0.3
18;2021-09-08;402;1094;119;224795;210220;1118;75.8;70.9;0.4
18;2021-09-09;352;952;174;225147;211172;1292;76.0;71.2;0.4
18;2021-09-10;414;914;172;225561;212086;1464;76.1;71.6;0.5
18;2021-09-11;261;824;93;225822;212910;1557;76.2;71.8;0.5
18;2021-09-12;7;28;13;225829;212938;1570;76.2;71.8;0.5
18;2021-09-13;334;741;160;226163;213679;1730;76.3;72.1;0.6
18;2021-09-14;284;784;276;226447;214463;2006;76.4;72.4;0.7
18;2021-09-15;337;1031;340;226784;215494;2346;76.5;72.7;0.8
18;2021-09-16;466;853;293;227250;216347;2639;76.7;73.0;0.9
18;2021-09-17;350;704;361;227600;217051;3000;76.8;73.2;1.0
18;2021-09-18;197;655;132;227797;217706;3132;76.9;73.4;1.1
18;2021-09-19;8;10;11;227805;217716;3143;76.9;73.5;1.1
18;2021-09-20;153;546;288;227958;218262;3431;76.9;73.6;1.2
18;2021-09-21;128;453;270;228086;218715;3701;77.0;73.8;1.2
18;2021-09-22;182;776;358;228268;219491;4059;77.0;74.1;1.4
18;2021-09-23;246;442;526;228514;219933;4585;77.1;74.2;1.5
18;2021-09-24;140;492;355;228654;220425;4940;77.1;74.4;1.7
18;2021-09-25;150;712;173;228804;221137;5113;77.2;74.6;1.7
18;2021-09-26;16;96;48;228820;221233;5161;77.2;74.6;1.7
18;2021-09-27;111;323;276;228931;221556;5437;77.2;74.7;1.8
18;2021-09-28;85;287;306;229016;221843;5743;77.3;74.8;1.9
18;2021-09-29;83;299;226;229099;222142;5969;77.3;74.9;2.0
18;2021-09-30;120;281;529;229219;222423;6498;77.3;75.0;2.2
18;2021-10-01;169;303;336;229388;222726;6834;77.4;75.1;2.3
18;2021-10-02;80;212;77;229468;222938;6911;77.4;75.2;2.3
18;2021-10-03;8;13;32;229476;222951;6943;77.4;75.2;2.3
18;2021-10-04;141;423;364;229617;223374;7307;77.5;75.4;2.5
18;2021-10-05;137;311;418;229754;223685;7725;77.5;75.5;2.6
18;2021-10-06;134;424;459;229888;224109;8184;77.6;75.6;2.8
18;2021-10-07;109;383;343;229997;224492;8527;77.6;75.7;2.9
18;2021-10-08;161;504;571;230158;224996;9098;77.7;75.9;3.1
18;2021-10-09;123;298;159;230281;225294;9257;77.7;76.0;3.1
18;2021-10-10;6;13;36;230287;225307;9293;77.7;76.0;3.1
18;2021-10-11;152;201;510;230439;225508;9803;77.7;76.1;3.3
18;2021-10-12;146;198;630;230585;225706;10433;77.8;76.1;3.5
18;2021-10-13;156;226;451;230741;225932;10884;77.8;76.2;3.7
18;2021-10-14;63;231;328;230804;226163;11212;77.9;76.3;3.8
18;2021-10-15;165;288;768;230969;226451;11980;77.9;76.4;4.0
18;2021-10-16;152;245;825;231121;226696;12805;78.0;76.5;4.3
18;2021-10-17;8;19;36;231129;226715;12841;78.0;76.5;4.3
18;2021-10-18;124;169;464;231253;226884;13305;78.0;76.5;4.5
18;2021-10-19;101;106;447;231354;226990;13752;78.1;76.6;4.6
18;2021-10-20;143;131;651;231497;227121;14403;78.1;76.6;4.9
18;2021-10-21;66;82;404;231563;227203;14807;78.1;76.7;5.0
18;2021-10-22;126;188;583;231689;227391;15390;78.2;76.7;5.2
18;2021-10-23;92;91;313;231781;227482;15703;78.2;76.7;5.3
18;2021-10-24;6;7;27;231787;227489;15730;78.2;76.7;5.3
18;2021-10-25;104;145;543;231891;227634;16273;78.2;76.8;5.5
18;2021-10-26;88;146;431;231979;227780;16704;78.3;76.8;5.6
18;2021-10-27;110;160;601;232089;227940;17305;78.3;76.9;5.8
18;2021-10-28;58;78;531;232147;228018;17836;78.3;76.9;6.0
18;2021-10-29;130;166;641;232277;228184;18477;78.4;77.0;6.2
18;2021-10-30;80;114;200;232357;228298;18677;78.4;77.0;6.3
18;2021-10-31;0;1;2;232357;228299;18679;78.4;77.0;6.3
18;2021-11-01;5;10;2;232362;228309;18681;78.4;77.0;6.3
18;2021-11-02;71;145;508;232433;228454;19189;78.4;77.1;6.5
18;2021-11-03;103;219;796;232536;228673;19985;78.5;77.1;6.7
18;2021-11-04;63;73;459;232599;228746;20444;78.5;77.2;6.9
18;2021-11-05;72;134;721;232671;228880;21165;78.5;77.2;7.1
18;2021-11-06;75;144;1284;232746;229024;22449;78.5;77.3;7.6
18;2021-11-07;6;14;45;232752;229038;22494;78.5;77.3;7.6
18;2021-11-08;61;114;906;232813;229152;23400;78.5;77.3;7.9
18;2021-11-09;78;113;885;232891;229265;24285;78.6;77.3;8.2
18;2021-11-10;113;154;1051;233004;229419;25336;78.6;77.4;8.5
18;2021-11-11;0;2;11;233004;229421;25347;78.6;77.4;8.6
18;2021-11-12;67;127;701;233071;229548;26048;78.6;77.4;8.8
18;2021-11-13;50;106;385;233121;229654;26433;78.6;77.5;8.9
18;2021-11-14;0;3;7;233121;229657;26440;78.6;77.5;8.9
18;2021-11-15;73;111;1173;233194;229768;27613;78.7;77.5;9.3
18;2021-11-16;98;96;1453;233292;229864;29066;78.7;77.6;9.8
18;2021-11-17;159;156;1601;233451;230020;30667;78.8;77.6;10.3
18;2021-11-18;58;75;1074;233509;230095;31741;78.8;77.6;10.7
18;2021-11-19;102;147;1326;233611;230242;33067;78.8;77.7;11.2
18;2021-11-20;76;114;905;233687;230356;33972;78.8;77.7;11.5
18;2021-11-21;16;16;75;233703;230372;34047;78.8;77.7;11.5
18;2021-11-22;99;54;1216;233802;230426;35263;78.9;77.7;11.9
18;2021-11-23;113;89;1479;233915;230515;36742;78.9;77.8;12.4
18;2021-11-24;146;107;1504;234061;230622;38246;79.0;77.8;12.9
18;2021-11-25;52;75;1178;234113;230697;39424;79.0;77.8;13.3
18;2021-11-26;130;117;1796;234243;230814;41220;79.0;77.9;13.9
18;2021-11-27;109;81;990;234352;230895;42210;79.1;77.9;14.2
18;2021-11-28;9;13;416;234361;230908;42626;79.1;77.9;14.4
18;2021-11-29;107;75;2009;234468;230983;44635;79.1;77.9;15.1
18;2021-11-30;82;79;2269;234550;231062;46904;79.1;78.0;15.8
18;2021-12-01;78;112;2528;234628;231174;49432;79.2;78.0;16.7
18;2021-12-02;81;59;2750;234709;231233;52182;79.2;78.0;17.6
18;2021-12-03;74;80;2497;234783;231313;54679;79.2;78.0;18.4
18;2021-12-04;42;90;2191;234825;231403;56870;79.2;78.1;19.2
18;2021-12-05;6;3;118;234831;231406;56988;79.2;78.1;19.2
18;2021-12-06;42;91;2566;234873;231497;59554;79.2;78.1;20.1
18;2021-12-07;51;96;3636;234924;231593;63190;79.3;78.1;21.3
18;2021-12-08;61;142;3065;234985;231735;66255;79.3;78.2;22.4
18;2021-12-09;86;102;3327;235071;231837;69582;79.3;78.2;23.5
18;2021-12-10;80;144;3813;235151;231981;73395;79.3;78.3;24.8
18;2021-12-11;66;85;3176;235217;232066;76571;79.4;78.3;25.8
18;2021-12-12;28;21;689;235245;232087;77260;79.4;78.3;26.1
18;2021-12-13;50;114;2778;235295;232201;80038;79.4;78.3;27.0
18;2021-12-14;82;117;4073;235377;232318;84111;79.4;78.4;28.4
18;2021-12-15;105;139;3927;235482;232457;88038;79.4;78.4;29.7
18;2021-12-16;98;84;3752;235580;232541;91790;79.5;78.5;31.0
19;2020-12-27;0;0;0;0;0;0;0.0;0.0;0.0
19;2020-12-28;0;0;0;0;0;0;0.0;0.0;0.0
19;2020-12-29;1;0;0;1;0;0;0.0;0.0;0.0
19;2020-12-30;0;0;0;1;0;0;0.0;0.0;0.0
19;2020-12-31;0;0;0;1;0;0;0.0;0.0;0.0
19;2021-01-01;0;0;0;1;0;0;0.0;0.0;0.0
19;2021-01-02;0;0;0;1;0;0;0.0;0.0;0.0
19;2021-01-03;0;0;0;1;0;0;0.0;0.0;0.0
19;2021-01-04;0;0;0;1;0;0;0.0;0.0;0.0
19;2021-01-05;0;0;0;1;0;0;0.0;0.0;0.0
19;2021-01-06;0;0;0;1;0;0;0.0;0.0;0.0
19;2021-01-07;323;2;0;324;2;0;0.1;0.0;0.0
19;2021-01-08;236;1;0;560;3;0;0.2;0.0;0.0
19;2021-01-09;2;0;0;562;3;0;0.2;0.0;0.0
19;2021-01-10;1;0;0;563;3;0;0.2;0.0;0.0
19;2021-01-11;45;0;0;608;3;0;0.3;0.0;0.0
19;2021-01-12;383;1;0;991;4;0;0.4;0.0;0.0
19;2021-01-13;340;2;0;1331;6;0;0.6;0.0;0.0
19;2021-01-14;452;1;0;1783;7;0;0.7;0.0;0.0
19;2021-01-15;229;18;0;2012;25;0;0.8;0.0;0.0
19;2021-01-16;11;0;0;2023;25;0;0.8;0.0;0.0
19;2021-01-17;3;0;0;2026;25;0;0.8;0.0;0.0
19;2021-01-18;263;1;0;2289;26;0;1.0;0.0;0.0
19;2021-01-19;470;0;0;2759;26;0;1.1;0.0;0.0
19;2021-01-20;884;10;0;3643;36;0;1.5;0.0;0.0
19;2021-01-21;468;4;0;4111;40;0;1.7;0.0;0.0
19;2021-01-22;1210;13;0;5321;53;0;2.2;0.0;0.0
19;2021-01-23;269;0;0;5590;53;0;2.3;0.0;0.0
19;2021-01-24;38;0;0;5628;53;0;2.3;0.0;0.0
19;2021-01-25;234;0;0;5862;53;0;2.4;0.0;0.0
19;2021-01-26;540;1;0;6402;54;0;2.7;0.0;0.0
19;2021-01-27;300;2;0;6702;56;0;2.8;0.0;0.0
19;2021-01-28;284;236;0;6986;292;0;2.9;0.1;0.0
19;2021-01-29;315;60;0;7301;352;0;3.0;0.1;0.0
19;2021-01-30;128;20;0;7429;372;0;3.1;0.2;0.0
19;2021-01-31;41;1;0;7470;373;0;3.1;0.2;0.0
19;2021-02-01;164;92;0;7634;465;0;3.2;0.2;0.0
19;2021-02-02;308;399;0;7942;864;0;3.3;0.4;0.0
19;2021-02-03;272;215;0;8214;1079;0;3.4;0.4;0.0
19;2021-02-04;262;353;0;8476;1432;0;3.5;0.6;0.0
19;2021-02-05;312;85;0;8788;1517;0;3.7;0.6;0.0
19;2021-02-06;193;5;0;8981;1522;0;3.7;0.6;0.0
19;2021-02-07;45;2;0;9026;1524;0;3.8;0.6;0.0
19;2021-02-08;182;154;0;9208;1678;0;3.8;0.7;0.0
19;2021-02-09;285;264;0;9493;1942;0;3.9;0.8;0.0
19;2021-02-10;488;277;0;9981;2219;0;4.2;0.9;0.0
19;2021-02-11;411;322;0;10392;2541;0;4.3;1.1;0.0
19;2021-02-12;749;1088;0;11141;3629;0;4.6;1.5;0.0
19;2021-02-13;333;178;0;11474;3807;0;4.8;1.6;0.0
19;2021-02-14;95;12;0;11569;3819;0;4.8;1.6;0.0
19;2021-02-15;194;234;0;11763;4053;0;4.9;1.7;0.0
19;2021-02-16;349;176;0;12112;4229;0;5.0;1.8;0.0
19;2021-02-17;291;487;0;12403;4716;0;5.2;2.0;0.0
19;2021-02-18;182;480;0;12585;5196;0;5.2;2.2;0.0
19;2021-02-19;451;281;0;13036;5477;0;5.4;2.3;0.0
19;2021-02-20;128;194;0;13164;5671;0;5.5;2.4;0.0
19;2021-02-21;20;42;0;13184;5713;0;5.5;2.4;0.0
19;2021-02-22;210;207;0;13394;5920;0;5.6;2.5;0.0
19;2021-02-23;249;324;0;13643;6244;0;5.7;2.6;0.0
19;2021-02-24;333;219;0;13976;6463;0;5.8;2.7;0.0
19;2021-02-25;507;364;0;14483;6827;0;6.0;2.8;0.0
19;2021-02-26;425;327;0;14908;7154;0;6.2;3.0;0.0
19;2021-02-27;352;149;0;15260;7303;0;6.3;3.0;0.0
19;2021-02-28;67;36;0;15327;7339;0;6.4;3.1;0.0
19;2021-03-01;262;217;0;15589;7556;0;6.5;3.1;0.0
19;2021-03-02;409;240;0;15998;7796;0;6.7;3.2;0.0
19;2021-03-03;668;347;0;16666;8143;0;6.9;3.4;0.0
19;2021-03-04;797;321;0;17463;8464;0;7.3;3.5;0.0
19;2021-03-05;901;697;0;18364;9161;0;7.6;3.8;0.0
19;2021-03-06;1041;191;0;19405;9352;0;8.1;3.9;0.0
19;2021-03-07;449;38;0;19854;9390;0;8.3;3.9;0.0
19;2021-03-08;582;179;0;20436;9569;0;8.5;4.0;0.0
19;2021-03-09;852;248;0;21288;9817;0;8.9;4.1;0.0
19;2021-03-10;1096;309;0;22384;10126;0;9.3;4.2;0.0
19;2021-03-11;1280;287;0;23664;10413;0;9.8;4.3;0.0
19;2021-03-12;1243;385;0;24907;10798;0;10.4;4.5;0.0
19;2021-03-13;1079;154;0;25986;10952;0;10.8;4.6;0.0
19;2021-03-14;145;78;0;26131;11030;0;10.9;4.6;0.0
19;2021-03-15;661;151;0;26792;11181;0;11.1;4.7;0.0
19;2021-03-16;653;266;0;27445;11447;0;11.4;4.8;0.0
19;2021-03-17;772;290;0;28217;11737;0;11.7;4.9;0.0
19;2021-03-18;734;259;0;28951;11996;0;12.0;5.0;0.0
19;2021-03-19;991;450;0;29942;12446;0;12.5;5.2;0.0
19;2021-03-20;752;122;0;30694;12568;0;12.8;5.2;0.0
19;2021-03-21;117;4;0;30811;12572;0;12.8;5.2;0.0
19;2021-03-22;554;172;0;31365;12744;0;13.1;5.3;0.0
19;2021-03-23;1003;227;0;32368;12971;0;13.5;5.4;0.0
19;2021-03-24;1113;356;0;33481;13327;0;13.9;5.5;0.0
19;2021-03-25;1209;391;0;34690;13718;0;14.4;5.7;0.0
19;2021-03-26;1331;295;0;36021;14013;0;15.0;5.8;0.0
19;2021-03-27;817;187;0;36838;14200;0;15.3;5.9;0.0
19;2021-03-28;72;59;0;36910;14259;0;15.4;5.9;0.0
19;2021-03-29;604;173;0;37514;14432;0;15.6;6.0;0.0
19;2021-03-30;933;349;0;38447;14781;0;16.0;6.2;0.0
19;2021-03-31;1084;498;0;39531;15279;0;16.4;6.4;0.0
19;2021-04-01;1454;375;0;40985;15654;0;17.1;6.5;0.0
19;2021-04-02;1021;529;0;42006;16183;0;17.5;6.7;0.0
19;2021-04-03;585;261;0;42591;16444;0;17.7;6.8;0.0
19;2021-04-04;135;4;0;42726;16448;0;17.8;6.8;0.0
19;2021-04-05;64;72;0;42790;16520;0;17.8;6.9;0.0
19;2021-04-06;731;577;0;43521;17097;0;18.1;7.1;0.0
19;2021-04-07;925;728;0;44446;17825;0;18.5;7.4;0.0
19;2021-04-08;1126;960;0;45572;18785;0;19.0;7.8;0.0
19;2021-04-09;1629;671;0;47201;19456;0;19.6;8.1;0.0
19;2021-04-10;939;522;0;48140;19978;0;20.0;8.3;0.0
19;2021-04-11;511;66;0;48651;20044;0;20.2;8.3;0.0
19;2021-04-12;715;500;0;49366;20544;0;20.5;8.5;0.0
19;2021-04-13;926;561;0;50292;21105;0;20.9;8.8;0.0
19;2021-04-14;1354;815;0;51646;21920;0;21.5;9.1;0.0
19;2021-04-15;1251;800;0;52897;22720;0;22.0;9.5;0.0
19;2021-04-16;1530;814;0;54427;23534;0;22.6;9.8;0.0
19;2021-04-17;776;460;0;55203;23994;0;23.0;10.0;0.0
19;2021-04-18;583;65;0;55786;24059;0;23.2;10.0;0.0
19;2021-04-19;733;430;0;56519;24489;0;23.5;10.2;0.0
19;2021-04-20;922;699;0;57441;25188;0;23.9;10.5;0.0
19;2021-04-21;1184;700;0;58625;25888;0;24.4;10.8;0.0
19;2021-04-22;1089;879;0;59714;26767;0;24.8;11.1;0.0
19;2021-04-23;1186;977;0;60900;27744;0;25.3;11.5;0.0
19;2021-04-24;660;652;0;61560;28396;0;25.6;11.8;0.0
19;2021-04-25;641;72;0;62201;28468;0;25.9;11.8;0.0
19;2021-04-26;1102;338;0;63303;28806;0;26.3;12.0;0.0
19;2021-04-27;1071;551;0;64374;29357;0;26.8;12.2;0.0
19;2021-04-28;1540;567;0;65914;29924;0;27.4;12.5;0.0
19;2021-04-29;1464;1087;0;67378;31011;0;28.0;12.9;0.0
19;2021-04-30;1915;1082;0;69293;32093;0;28.8;13.4;0.0
19;2021-05-01;673;183;0;69966;32276;0;29.1;13.4;0.0
19;2021-05-02;552;150;0;70518;32426;0;29.3;13.5;0.0
19;2021-05-03;959;546;0;71477;32972;0;29.7;13.7;0.0
19;2021-05-04;1144;712;0;72621;33684;0;30.2;14.0;0.0
19;2021-05-05;1388;759;0;74009;34443;0;30.8;14.3;0.0
19;2021-05-06;1346;1162;0;75355;35605;0;31.4;14.8;0.0
19;2021-05-07;1732;1196;0;77087;36801;0;32.1;15.3;0.0
19;2021-05-08;854;228;0;77941;37029;0;32.4;15.4;0.0
19;2021-05-09;470;510;0;78411;37539;0;32.6;15.6;0.0
19;2021-05-10;1211;742;0;79622;38281;0;33.1;15.9;0.0
19;2021-05-11;1652;878;0;81274;39159;0;33.8;16.3;0.0
19;2021-05-12;1935;1339;0;83209;40498;0;34.6;16.9;0.0
19;2021-05-13;635;294;0;83844;40792;0;34.9;17.0;0.0
19;2021-05-14;1593;972;0;85437;41764;0;35.5;17.4;0.0
19;2021-05-15;1341;585;0;86778;42349;0;36.1;17.6;0.0
19;2021-05-16;287;95;0;87065;42444;0;36.2;17.7;0.0
19;2021-05-17;1432;585;0;88497;43029;0;36.8;17.9;0.0
19;2021-05-18;1643;518;0;90140;43547;0;37.5;18.1;0.0
19;2021-05-19;1972;852;0;92112;44399;0;38.3;18.5;0.0
19;2021-05-20;1757;896;0;93869;45295;0;39.1;18.8;0.0
19;2021-05-21;1967;874;0;95836;46169;0;39.9;19.2;0.0
19;2021-05-22;1204;632;0;97040;46801;0;40.4;19.5;0.0
19;2021-05-23;292;126;0;97332;46927;0;40.5;19.5;0.0
19;2021-05-24;218;58;0;97550;46985;0;40.6;19.5;0.0
19;2021-05-25;1486;555;0;99036;47540;0;41.2;19.8;0.0
19;2021-05-26;1932;691;0;100968;48231;0;42.0;20.1;0.0
19;2021-05-27;1807;879;0;102775;49110;0;42.8;20.4;0.0
19;2021-05-28;1939;1065;0;104714;50175;0;43.6;20.9;0.0
19;2021-05-29;1345;699;0;106059;50874;0;44.1;21.2;0.0
19;2021-05-30;181;458;0;106240;51332;0;44.2;21.4;0.0
19;2021-05-31;1176;550;0;107416;51882;0;44.7;21.6;0.0
19;2021-06-01;1297;898;0;108713;52780;0;45.2;22.0;0.0
19;2021-06-02;1758;1016;0;110471;53796;0;46.0;22.4;0.0
19;2021-06-03;1497;1172;0;111968;54968;0;46.6;22.9;0.0
19;2021-06-04;1833;1397;0;113801;56365;0;47.4;23.5;0.0
19;2021-06-05;1135;794;0;114936;57159;0;47.8;23.8;0.0
19;2021-06-06;102;593;0;115038;57752;0;47.9;24.0;0.0
19;2021-06-07;918;1013;0;115956;58765;0;48.2;24.5;0.0
19;2021-06-08;1103;963;0;117059;59728;0;48.7;24.9;0.0
19;2021-06-09;1245;1461;0;118304;61189;0;49.2;25.5;0.0
19;2021-06-10;1258;1533;0;119562;62722;0;49.7;26.1;0.0
19;2021-06-11;1279;1954;0;120841;64676;0;50.3;26.9;0.0
19;2021-06-12;1255;1298;0;122096;65974;0;50.8;27.5;0.0
19;2021-06-13;472;418;0;122568;66392;0;51.0;27.6;0.0
19;2021-06-14;687;1149;0;123255;67541;0;51.3;28.1;0.0
19;2021-06-15;943;1289;0;124198;68830;0;51.7;28.6;0.0
19;2021-06-16;1168;1514;0;125366;70344;0;52.2;29.3;0.0
19;2021-06-17;871;1854;0;126237;72198;0;52.5;30.0;0.0
19;2021-06-18;1012;2159;0;127249;74357;0;52.9;30.9;0.0
19;2021-06-19;846;1390;0;128095;75747;0;53.3;31.5;0.0
19;2021-06-20;341;318;0;128436;76065;0;53.4;31.6;0.0
19;2021-06-21;500;1147;0;128936;77212;0;53.6;32.1;0.0
19;2021-06-22;650;1550;0;129586;78762;0;53.9;32.8;0.0
19;2021-06-23;680;1994;0;130266;80756;0;54.2;33.6;0.0
19;2021-06-24;653;1595;0;130919;82351;0;54.5;34.3;0.0
19;2021-06-25;557;2174;0;131476;84525;0;54.7;35.2;0.0
19;2021-06-26;454;1668;0;131930;86193;0;54.9;35.9;0.0
19;2021-06-27;252;375;0;132182;86568;0;55.0;36.0;0.0
19;2021-06-28;297;1525;0;132479;88093;0;55.1;36.7;0.0
19;2021-06-29;370;1908;0;132849;90001;0;55.3;37.4;0.0
19;2021-06-30;718;2080;0;133567;92081;0;55.6;38.3;0.0
19;2021-07-01;341;2267;0;133908;94348;0;55.7;39.3;0.0
19;2021-07-02;749;2291;0;134657;96639;0;56.0;40.2;0.0
19;2021-07-03;479;1694;0;135136;98333;0;56.2;40.9;0.0
19;2021-07-04;20;65;0;135156;98398;0;56.2;40.9;0.0
19;2021-07-05;585;1047;0;135741;99445;0;56.5;41.4;0.0
19;2021-07-06;470;1540;0;136211;100985;0;56.7;42.0;0.0
19;2021-07-07;611;2126;0;136822;103111;0;56.9;42.9;0.0
19;2021-07-08;724;2106;0;137546;105217;0;57.2;43.8;0.0
19;2021-07-09;683;2608;0;138229;107825;0;57.5;44.9;0.0
19;2021-07-10;530;1644;0;138759;109469;0;57.7;45.5;0.0
19;2021-07-11;60;215;0;138819;109684;0;57.8;45.6;0.0
19;2021-07-12;445;1502;0;139264;111186;0;57.9;46.3;0.0
19;2021-07-13;665;1833;0;139929;113019;0;58.2;47.0;0.0
19;2021-07-14;218;272;0;140147;113291;0;58.3;47.1;0.0
19;2021-07-15;849;1967;0;140996;115258;0;58.7;48.0;0.0
19;2021-07-16;1117;2352;0;142113;117610;0;59.1;48.9;0.0
19;2021-07-17;716;1582;0;142829;119192;0;59.4;49.6;0.0
19;2021-07-18;312;582;0;143141;119774;0;59.6;49.8;0.0
19;2021-07-19;918;1354;0;144059;121128;0;59.9;50.4;0.0
19;2021-07-20;968;1595;0;145027;122723;0;60.3;51.1;0.0
19;2021-07-21;1053;1625;0;146080;124348;0;60.8;51.7;0.0
19;2021-07-22;1334;1720;0;147414;126068;0;61.3;52.5;0.0
19;2021-07-23;1682;1928;0;149096;127996;0;62.0;53.3;0.0
19;2021-07-24;909;1607;0;150005;129603;0;62.4;53.9;0.0
19;2021-07-25;168;457;0;150173;130060;0;62.5;54.1;0.0
19;2021-07-26;905;921;0;151078;130981;0;62.9;54.5;0.0
19;2021-07-27;1370;1049;0;152448;132030;0;63.4;54.9;0.0
19;2021-07-28;1929;1176;0;154377;133206;0;64.2;55.4;0.0
19;2021-07-29;1563;1124;0;155940;134330;0;64.9;55.9;0.0
19;2021-07-30;1830;1033;0;157770;135363;0;65.6;56.3;0.0
19;2021-07-31;1099;965;0;158869;136328;0;66.1;56.7;0.0
19;2021-08-01;344;320;0;159213;136648;0;66.2;56.9;0.0
19;2021-08-02;1059;747;0;160272;137395;0;66.7;57.2;0.0
19;2021-08-03;1389;938;0;161661;138333;0;67.3;57.6;0.0
19;2021-08-04;1678;643;0;163339;138976;0;68.0;57.8;0.0
19;2021-08-05;1418;852;0;164757;139828;0;68.6;58.2;0.0
19;2021-08-06;1786;1138;0;166543;140966;0;69.3;58.7;0.0
19;2021-08-07;1188;896;0;167731;141862;0;69.8;59.0;0.0
19;2021-08-08;184;184;0;167915;142046;0;69.9;59.1;0.0
19;2021-08-09;931;739;0;168846;142785;0;70.3;59.4;0.0
19;2021-08-10;1117;943;0;169963;143728;0;70.7;59.8;0.0
19;2021-08-11;1169;904;0;171132;144632;0;71.2;60.2;0.0
19;2021-08-12;933;1100;0;172065;145732;0;71.6;60.6;0.0
19;2021-08-13;1071;1112;0;173136;146844;0;72.0;61.1;0.0
19;2021-08-14;845;1066;0;173981;147910;0;72.4;61.5;0.0
19;2021-08-15;40;63;0;174021;147973;0;72.4;61.6;0.0
19;2021-08-16;538;964;0;174559;148937;0;72.6;62.0;0.0
19;2021-08-17;554;1121;0;175113;150058;0;72.9;62.4;0.0
19;2021-08-18;570;910;0;175683;150968;0;73.1;62.8;0.0
19;2021-08-19;438;1194;0;176121;152162;0;73.3;63.3;0.0
19;2021-08-20;784;1760;0;176905;153922;0;73.6;64.0;0.0
19;2021-08-21;420;1256;0;177325;155178;0;73.8;64.6;0.0
19;2021-08-22;49;105;0;177374;155283;0;73.8;64.6;0.0
19;2021-08-23;220;1106;0;177594;156389;0;73.9;65.1;0.0
19;2021-08-24;438;1180;0;178032;157569;0;74.1;65.6;0.0
19;2021-08-25;562;1461;0;178594;159030;0;74.3;66.2;0.0
19;2021-08-26;444;1303;0;179038;160333;0;74.5;66.7;0.0
19;2021-08-27;448;1585;0;179486;161918;0;74.7;67.4;0.0
19;2021-08-28;338;1198;0;179824;163116;0;74.8;67.9;0.0
19;2021-08-29;51;170;0;179875;163286;0;74.8;67.9;0.0
19;2021-08-30;228;1070;5;180103;164356;5;74.9;68.4;0.0
19;2021-08-31;316;1260;97;180419;165616;102;75.1;68.9;0.0
19;2021-09-01;364;1333;43;180783;166949;145;75.2;69.5;0.1
19;2021-09-02;342;1089;117;181125;168038;262;75.4;69.9;0.1
19;2021-09-03;379;1373;93;181504;169411;355;75.5;70.5;0.1
19;2021-09-04;270;1253;26;181774;170664;381;75.6;71.0;0.2
19;2021-09-05;25;98;128;181799;170762;509;75.6;71.1;0.2
19;2021-09-06;189;589;69;181988;171351;578;75.7;71.3;0.2
19;2021-09-07;216;680;70;182204;172031;648;75.8;71.6;0.3
19;2021-09-08;266;715;188;182470;172746;836;75.9;71.9;0.3
19;2021-09-09;252;519;94;182722;173265;930;76.0;72.1;0.4
19;2021-09-10;252;697;147;182974;173962;1077;76.1;72.4;0.4
19;2021-09-11;268;949;95;183242;174911;1172;76.2;72.8;0.5
19;2021-09-12;26;48;74;183268;174959;1246;76.3;72.8;0.5
19;2021-09-13;98;252;240;183366;175211;1486;76.3;72.9;0.6
19;2021-09-14;173;340;253;183539;175551;1739;76.4;73.0;0.7
19;2021-09-15;229;559;312;183768;176110;2051;76.5;73.3;0.9
19;2021-09-16;213;355;257;183981;176465;2308;76.6;73.4;1.0
19;2021-09-17;249;522;171;184230;176987;2479;76.7;73.6;1.0
19;2021-09-18;163;628;87;184393;177615;2566;76.7;73.9;1.1
19;2021-09-19;12;23;4;184405;177638;2570;76.7;73.9;1.1
19;2021-09-20;116;212;284;184521;177850;2854;76.8;74.0;1.2
19;2021-09-21;126;267;417;184647;178117;3271;76.8;74.1;1.4
19;2021-09-22;134;365;272;184781;178482;3543;76.9;74.3;1.5
19;2021-09-23;78;277;241;184859;178759;3784;76.9;74.4;1.6
19;2021-09-24;131;333;375;184990;179092;4159;77.0;74.5;1.7
19;2021-09-25;128;507;127;185118;179599;4286;77.0;74.7;1.8
19;2021-09-26;15;24;4;185133;179623;4290;77.0;74.7;1.8
19;2021-09-27;42;201;287;185175;179824;4577;77.0;74.8;1.9
19;2021-09-28;65;197;280;185240;180021;4857;77.1;74.9;2.0
19;2021-09-29;83;334;263;185323;180355;5120;77.1;75.0;2.1
19;2021-09-30;107;279;224;185430;180634;5344;77.2;75.2;2.2
19;2021-10-01;123;233;217;185553;180867;5561;77.2;75.3;2.3
19;2021-10-02;134;302;185;185687;181169;5746;77.3;75.4;2.4
19;2021-10-03;9;12;10;185696;181181;5756;77.3;75.4;2.4
19;2021-10-04;56;119;208;185752;181300;5964;77.3;75.4;2.5
19;2021-10-05;79;161;325;185831;181461;6289;77.3;75.5;2.6
19;2021-10-06;108;239;311;185939;181700;6600;77.4;75.6;2.7
19;2021-10-07;62;231;289;186001;181931;6889;77.4;75.7;2.9
19;2021-10-08;79;235;266;186080;182166;7155;77.4;75.8;3.0
19;2021-10-09;133;245;263;186213;182411;7418;77.5;75.9;3.1
19;2021-10-10;3;8;22;186216;182419;7440;77.5;75.9;3.1
19;2021-10-11;59;148;257;186275;182567;7697;77.5;76.0;3.2
19;2021-10-12;77;159;443;186352;182726;8140;77.5;76.0;3.4
19;2021-10-13;105;184;325;186457;182910;8465;77.6;76.1;3.5
19;2021-10-14;71;98;349;186528;183008;8814;77.6;76.1;3.7
19;2021-10-15;97;152;278;186625;183160;9092;77.7;76.2;3.8
19;2021-10-16;121;219;272;186746;183379;9364;77.7;76.3;3.9
19;2021-10-17;0;21;1;186746;183400;9365;77.7;76.3;3.9
19;2021-10-18;45;73;309;186791;183473;9674;77.7;76.3;4.0
19;2021-10-19;62;79;418;186853;183552;10092;77.7;76.4;4.2
19;2021-10-20;60;141;463;186913;183693;10555;77.8;76.4;4.4
19;2021-10-21;60;105;435;186973;183798;10990;77.8;76.5;4.6
19;2021-10-22;91;111;365;187064;183909;11355;77.8;76.5;4.7
19;2021-10-23;98;186;443;187162;184095;11798;77.9;76.6;4.9
19;2021-10-24;2;13;9;187164;184108;11807;77.9;76.6;4.9
19;2021-10-25;46;70;381;187210;184178;12188;77.9;76.6;5.1
19;2021-10-26;53;66;479;187263;184244;12667;77.9;76.7;5.3
19;2021-10-27;49;84;520;187312;184328;13187;77.9;76.7;5.5
19;2021-10-28;62;90;522;187374;184418;13709;78.0;76.7;5.7
19;2021-10-29;59;95;360;187433;184513;14069;78.0;76.8;5.9
19;2021-10-30;76;125;425;187509;184638;14494;78.0;76.8;6.0
19;2021-10-31;5;5;32;187514;184643;14526;78.0;76.8;6.0
19;2021-11-01;3;2;8;187517;184645;14534;78.0;76.8;6.0
19;2021-11-02;58;76;589;187575;184721;15123;78.0;76.9;6.3
19;2021-11-03;54;98;531;187629;184819;15654;78.1;76.9;6.5
19;2021-11-04;54;63;522;187683;184882;16176;78.1;76.9;6.7
19;2021-11-05;62;101;519;187745;184983;16695;78.1;77.0;6.9
19;2021-11-06;95;123;470;187840;185106;17165;78.2;77.0;7.1
19;2021-11-07;2;3;11;187842;185109;17176;78.2;77.0;7.1
19;2021-11-08;38;70;481;187880;185179;17657;78.2;77.1;7.3
19;2021-11-09;48;92;885;187928;185271;18542;78.2;77.1;7.7
19;2021-11-10;63;83;741;187991;185354;19283;78.2;77.1;8.0
19;2021-11-11;3;1;13;187994;185355;19296;78.2;77.1;8.0
19;2021-11-12;63;76;579;188057;185431;19875;78.2;77.2;8.3
19;2021-11-13;51;70;488;188108;185501;20363;78.3;77.2;8.5
19;2021-11-14;13;3;39;188121;185504;20402;78.3;77.2;8.5
19;2021-11-15;33;56;544;188154;185560;20946;78.3;77.2;8.7
19;2021-11-16;43;51;1042;188197;185611;21988;78.3;77.2;9.1
19;2021-11-17;57;69;844;188254;185680;22832;78.3;77.3;9.5
19;2021-11-18;51;64;691;188305;185744;23523;78.4;77.3;9.8
19;2021-11-19;89;95;995;188394;185839;24518;78.4;77.3;10.2
19;2021-11-20;80;108;691;188474;185947;25209;78.4;77.4;10.5
19;2021-11-21;10;7;52;188484;185954;25261;78.4;77.4;10.5
19;2021-11-22;48;31;734;188532;185985;25995;78.4;77.4;10.8
19;2021-11-23;73;66;1235;188605;186051;27230;78.5;77.4;11.3
19;2021-11-24;72;70;953;188677;186121;28183;78.5;77.4;11.7
19;2021-11-25;69;58;1018;188746;186179;29201;78.5;77.5;12.2
19;2021-11-26;94;61;1256;188840;186240;30457;78.6;77.5;12.7
19;2021-11-27;91;107;1323;188931;186347;31780;78.6;77.5;13.2
19;2021-11-28;31;17;813;188962;186364;32593;78.6;77.5;13.6
19;2021-11-29;29;28;1104;188991;186392;33697;78.6;77.6;14.0
19;2021-11-30;62;68;1824;189053;186460;35521;78.7;77.6;14.8
19;2021-12-01;33;42;1349;189086;186502;36870;78.7;77.6;15.3
19;2021-12-02;37;30;2121;189123;186532;38991;78.7;77.6;16.2
19;2021-12-03;75;86;2167;189198;186618;41158;78.7;77.6;17.1
19;2021-12-04;45;73;1663;189243;186691;42821;78.7;77.7;17.8
19;2021-12-05;8;12;314;189251;186703;43135;78.7;77.7;17.9
19;2021-12-06;32;33;1499;189283;186736;44634;78.8;77.7;18.6
19;2021-12-07;47;46;2291;189330;186782;46925;78.8;77.7;19.5
19;2021-12-08;47;64;1951;189377;186846;48876;78.8;77.7;20.3
19;2021-12-09;44;60;2163;189421;186906;51039;78.8;77.8;21.2
19;2021-12-10;65;83;2847;189486;186989;53886;78.8;77.8;22.4
19;2021-12-11;35;80;2085;189521;187069;55971;78.9;77.8;23.3
19;2021-12-12;12;10;686;189533;187079;56657;78.9;77.8;23.6
19;2021-12-13;32;58;2027;189565;187137;58684;78.9;77.9;24.4
19;2021-12-14;70;75;3282;189635;187212;61966;78.9;77.9;25.8
19;2021-12-15;59;81;2844;189694;187293;64810;78.9;77.9;27.0
19;2021-12-16;68;81;3353;189762;187374;68163;79.0;78.0;28.4
21;2020-12-27;4;0;0;4;0;0;0.0;0.0;0.0
21;2020-12-28;1;0;0;5;0;0;0.0;0.0;0.0
21;2020-12-29;18;0;0;23;0;0;0.0;0.0;0.0
21;2020-12-30;21;0;0;44;0;0;0.0;0.0;0.0
21;2020-12-31;0;0;0;44;0;0;0.0;0.0;0.0
21;2021-01-01;0;0;0;44;0;0;0.0;0.0;0.0
21;2021-01-02;1;0;0;45;0;0;0.0;0.0;0.0
21;2021-01-03;0;0;0;45;0;0;0.0;0.0;0.0
21;2021-01-04;19;0;0;64;0;0;0.0;0.0;0.0
21;2021-01-05;239;1;0;303;1;0;0.1;0.0;0.0
21;2021-01-06;299;0;0;602;1;0;0.1;0.0;0.0
21;2021-01-07;368;0;0;970;1;0;0.2;0.0;0.0
21;2021-01-08;460;2;0;1430;3;0;0.3;0.0;0.0
21;2021-01-09;248;0;0;1678;3;0;0.3;0.0;0.0
21;2021-01-10;2;0;0;1680;3;0;0.3;0.0;0.0
21;2021-01-11;627;1;0;2307;4;0;0.4;0.0;0.0
21;2021-01-12;637;0;0;2944;4;0;0.6;0.0;0.0
21;2021-01-13;692;1;0;3636;5;0;0.7;0.0;0.0
21;2021-01-14;1138;8;0;4774;13;0;0.9;0.0;0.0
21;2021-01-15;696;4;0;5470;17;0;1.0;0.0;0.0
21;2021-01-16;156;2;0;5626;19;0;1.1;0.0;0.0
21;2021-01-17;5;0;0;5631;19;0;1.1;0.0;0.0
21;2021-01-18;1260;6;0;6891;25;0;1.3;0.0;0.0
21;2021-01-19;1244;4;0;8135;29;0;1.5;0.0;0.0
21;2021-01-20;1202;48;0;9337;77;0;1.8;0.0;0.0
21;2021-01-21;1494;8;0;10831;85;0;2.0;0.0;0.0
21;2021-01-22;1241;5;0;12072;90;0;2.3;0.0;0.0
21;2021-01-23;482;0;0;12554;90;0;2.4;0.0;0.0
21;2021-01-24;125;0;0;12679;90;0;2.4;0.0;0.0
21;2021-01-25;907;17;0;13586;107;0;2.5;0.0;0.0
21;2021-01-26;1477;142;0;15063;249;0;2.8;0.0;0.0
21;2021-01-27;1971;159;0;17034;408;0;3.2;0.1;0.0
21;2021-01-28;1458;230;0;18492;638;0;3.5;0.1;0.0
21;2021-01-29;1047;225;0;19539;863;0;3.7;0.2;0.0
21;2021-01-30;480;38;0;20019;901;0;3.8;0.2;0.0
21;2021-01-31;93;4;0;20112;905;0;3.8;0.2;0.0
21;2021-02-01;470;297;0;20582;1202;0;3.9;0.2;0.0
21;2021-02-02;448;370;0;21030;1572;0;3.9;0.3;0.0
21;2021-02-03;497;291;0;21527;1863;0;4.0;0.3;0.0
21;2021-02-04;437;526;0;21964;2389;0;4.1;0.4;0.0
21;2021-02-05;544;514;0;22508;2903;0;4.2;0.5;0.0
21;2021-02-06;159;216;0;22667;3119;0;4.3;0.6;0.0
21;2021-02-07;1;4;0;22668;3123;0;4.3;0.6;0.0
21;2021-02-08;428;398;0;23096;3521;0;4.3;0.7;0.0
21;2021-02-09;514;542;0;23610;4063;0;4.4;0.8;0.0
21;2021-02-10;468;590;0;24078;4653;0;4.5;0.9;0.0
21;2021-02-11;484;732;0;24562;5385;0;4.6;1.0;0.0
21;2021-02-12;391;950;0;24953;6335;0;4.7;1.2;0.0
21;2021-02-13;337;298;0;25290;6633;0;4.7;1.2;0.0
21;2021-02-14;218;152;0;25508;6785;0;4.8;1.3;0.0
21;2021-02-15;129;1344;0;25637;8129;0;4.8;1.5;0.0
21;2021-02-16;219;1493;0;25856;9622;0;4.9;1.8;0.0
21;2021-02-17;381;1923;0;26237;11545;0;4.9;2.2;0.0
21;2021-02-18;576;1316;0;26813;12861;0;5.0;2.4;0.0
21;2021-02-19;216;1084;0;27029;13945;0;5.1;2.6;0.0
21;2021-02-20;120;382;0;27149;14327;0;5.1;2.7;0.0
21;2021-02-21;0;73;0;27149;14400;0;5.1;2.7;0.0
21;2021-02-22;92;782;0;27241;15182;0;5.1;2.8;0.0
21;2021-02-23;179;1006;0;27420;16188;0;5.1;3.0;0.0
21;2021-02-24;212;738;0;27632;16926;0;5.2;3.2;0.0
21;2021-02-25;637;827;0;28269;17753;0;5.3;3.3;0.0
21;2021-02-26;926;708;0;29195;18461;0;5.5;3.5;0.0
21;2021-02-27;520;305;0;29715;18766;0;5.6;3.5;0.0
21;2021-02-28;24;99;0;29739;18865;0;5.6;3.5;0.0
21;2021-03-01;693;613;0;30432;19478;0;5.7;3.7;0.0
21;2021-03-02;1076;540;0;31508;20018;0;5.9;3.8;0.0
21;2021-03-03;1124;457;0;32632;20475;0;6.1;3.8;0.0
21;2021-03-04;1638;516;0;34270;20991;0;6.4;3.9;0.0
21;2021-03-05;2172;659;0;36442;21650;0;6.8;4.1;0.0
21;2021-03-06;1577;208;0;38019;21858;0;7.1;4.1;0.0
21;2021-03-07;36;24;0;38055;21882;0;7.1;4.1;0.0
21;2021-03-08;746;449;0;38801;22331;0;7.3;4.2;0.0
21;2021-03-09;1571;570;0;40372;22901;0;7.6;4.3;0.0
21;2021-03-10;1629;563;0;42001;23464;0;7.9;4.4;0.0
21;2021-03-11;2155;695;0;44156;24159;0;8.3;4.5;0.0
21;2021-03-12;2861;457;0;47017;24616;0;8.8;4.6;0.0
21;2021-03-13;1908;193;0;48925;24809;0;9.2;4.7;0.0
21;2021-03-14;46;47;0;48971;24856;0;9.2;4.7;0.0
21;2021-03-15;1401;94;0;50372;24950;0;9.5;4.7;0.0
21;2021-03-16;1784;158;0;52156;25108;0;9.8;4.7;0.0
21;2021-03-17;1727;122;0;53883;25230;0;10.1;4.7;0.0
21;2021-03-18;2024;272;0;55907;25502;0;10.5;4.8;0.0
21;2021-03-19;1912;152;0;57819;25654;0;10.9;4.8;0.0
21;2021-03-20;1213;41;0;59032;25695;0;11.1;4.8;0.0
21;2021-03-21;6;0;0;59038;25695;0;11.1;4.8;0.0
21;2021-03-22;1516;95;0;60554;25790;0;11.4;4.8;0.0
21;2021-03-23;2624;119;0;63178;25909;0;11.9;4.9;0.0
21;2021-03-24;2797;156;0;65975;26065;0;12.4;4.9;0.0
21;2021-03-25;3641;254;0;69616;26319;0;13.1;4.9;0.0
21;2021-03-26;3614;207;0;73230;26526;0;13.7;5.0;0.0
21;2021-03-27;1637;65;0;74867;26591;0;14.0;5.0;0.0
21;2021-03-28;204;37;0;75071;26628;0;14.1;5.0;0.0
21;2021-03-29;1737;531;0;76808;27159;0;14.4;5.1;0.0
21;2021-03-30;2271;788;0;79079;27947;0;14.8;5.2;0.0
21;2021-03-31;2671;659;0;81750;28606;0;15.3;5.4;0.0
21;2021-04-01;2636;728;0;84386;29334;0;15.8;5.5;0.0
21;2021-04-02;2247;755;0;86633;30089;0;16.3;5.6;0.0
21;2021-04-03;988;280;0;87621;30369;0;16.4;5.7;0.0
21;2021-04-04;4;16;0;87625;30385;0;16.4;5.7;0.0
21;2021-04-05;20;1;0;87645;30386;0;16.4;5.7;0.0
21;2021-04-06;1323;1138;0;88968;31524;0;16.7;5.9;0.0
21;2021-04-07;1696;968;0;90664;32492;0;17.0;6.1;0.0
21;2021-04-08;3108;1112;0;93772;33604;0;17.6;6.3;0.0
21;2021-04-09;3357;1178;0;97129;34782;0;18.2;6.5;0.0
21;2021-04-10;1336;738;0;98465;35520;0;18.5;6.7;0.0
21;2021-04-11;140;9;0;98605;35529;0;18.5;6.7;0.0
21;2021-04-12;1144;1339;0;99749;36868;0;18.7;6.9;0.0
21;2021-04-13;1690;1713;0;101439;38581;0;19.0;7.2;0.0
21;2021-04-14;1488;1437;0;102927;40018;0;19.3;7.5;0.0
21;2021-04-15;1945;1545;0;104872;41563;0;19.7;7.8;0.0
21;2021-04-16;2336;1265;0;107208;42828;0;20.1;8.0;0.0
21;2021-04-17;1048;977;0;108256;43805;0;20.3;8.2;0.0
21;2021-04-18;27;11;0;108283;43816;0;20.3;8.2;0.0
21;2021-04-19;1140;1328;0;109423;45144;0;20.5;8.5;0.0
21;2021-04-20;1273;1781;0;110696;46925;0;20.8;8.8;0.0
21;2021-04-21;1157;1694;0;111853;48619;0;21.0;9.1;0.0
21;2021-04-22;1314;2147;0;113167;50766;0;21.2;9.5;0.0
21;2021-04-23;2037;1750;0;115204;52516;0;21.6;9.9;0.0
21;2021-04-24;1010;838;0;116214;53354;0;21.8;10.0;0.0
21;2021-04-25;21;164;0;116235;53518;0;21.8;10.0;0.0
21;2021-04-26;1120;1570;0;117355;55088;0;22.0;10.3;0.0
21;2021-04-27;1921;1899;0;119276;56987;0;22.4;10.7;0.0
21;2021-04-28;2383;2200;0;121659;59187;0;22.8;11.1;0.0
21;2021-04-29;3296;2263;0;124955;61450;0;23.4;11.5;0.0
21;2021-04-30;3662;1839;0;128617;63289;0;24.1;11.9;0.0
21;2021-05-01;1015;233;0;129632;63522;0;24.3;11.9;0.0
21;2021-05-02;20;10;0;129652;63532;0;24.3;11.9;0.0
21;2021-05-03;2181;1277;0;131833;64809;0;24.7;12.2;0.0
21;2021-05-04;2666;1605;0;134499;66414;0;25.2;12.5;0.0
21;2021-05-05;2500;1711;0;136999;68125;0;25.7;12.8;0.0
21;2021-05-06;3188;2251;0;140187;70376;0;26.3;13.2;0.0
21;2021-05-07;2916;2118;0;143103;72494;0;26.9;13.6;0.0
21;2021-05-08;1166;277;0;144269;72771;0;27.1;13.7;0.0
21;2021-05-09;58;171;0;144327;72942;0;27.1;13.7;0.0
21;2021-05-10;3179;1732;0;147506;74674;0;27.7;14.0;0.0
21;2021-05-11;4827;2039;0;152333;76713;0;28.6;14.4;0.0
21;2021-05-12;4830;1771;0;157163;78484;0;29.5;14.7;0.0
21;2021-05-13;3753;377;0;160916;78861;0;30.2;14.8;0.0
21;2021-05-14;5114;1511;0;166030;80372;0;31.2;15.1;0.0
21;2021-05-15;3452;673;0;169482;81045;0;31.8;15.2;0.0
21;2021-05-16;87;13;0;169569;81058;0;31.8;15.2;0.0
21;2021-05-17;3998;1249;0;173567;82307;0;32.6;15.4;0.0
21;2021-05-18;4252;1542;0;177819;83849;0;33.4;15.7;0.0
21;2021-05-19;3526;1122;0;181345;84971;0;34.0;15.9;0.0
21;2021-05-20;3945;1374;0;185290;86345;0;34.8;16.2;0.0
21;2021-05-21;3712;2131;0;189002;88476;0;35.5;16.6;0.0
21;2021-05-22;1636;750;0;190638;89226;0;35.8;16.7;0.0
21;2021-05-23;54;33;0;190692;89259;0;35.8;16.8;0.0
21;2021-05-24;1717;256;0;192409;89515;0;36.1;16.8;0.0
21;2021-05-25;2688;2013;0;195097;91528;0;36.6;17.2;0.0
21;2021-05-26;2640;2034;0;197737;93562;0;37.1;17.6;0.0
21;2021-05-27;3932;2135;0;201669;95697;0;37.8;18.0;0.0
21;2021-05-28;3535;2820;0;205204;98517;0;38.5;18.5;0.0
21;2021-05-29;1909;1428;0;207113;99945;0;38.9;18.8;0.0
21;2021-05-30;132;29;0;207245;99974;0;38.9;18.8;0.0
21;2021-05-31;2501;1780;0;209746;101754;0;39.4;19.1;0.0
21;2021-06-01;3379;2248;0;213125;104002;0;40.0;19.5;0.0
21;2021-06-02;2828;1829;0;215953;105831;0;40.5;19.9;0.0
21;2021-06-03;3289;2073;0;219242;107904;0;41.1;20.2;0.0
21;2021-06-04;3447;2672;0;222689;110576;0;41.8;20.8;0.0
21;2021-06-05;2837;1638;0;225526;112214;0;42.3;21.1;0.0
21;2021-06-06;101;98;0;225627;112312;0;42.3;21.1;0.0
21;2021-06-07;4213;1504;0;229840;113816;0;43.1;21.4;0.0
21;2021-06-08;4675;2254;0;234515;116070;0;44.0;21.8;0.0
21;2021-06-09;4466;1788;0;238981;117858;0;44.8;22.1;0.0
21;2021-06-10;3848;2603;0;242829;120461;0;45.6;22.6;0.0
21;2021-06-11;4150;3180;0;246979;123641;0;46.3;23.2;0.0
21;2021-06-12;2120;1653;0;249099;125294;0;46.7;23.5;0.0
21;2021-06-13;72;26;0;249171;125320;0;46.8;23.5;0.0
21;2021-06-14;2221;2678;0;251392;127998;0;47.2;24.0;0.0
21;2021-06-15;2920;3167;0;254312;131165;0;47.7;24.6;0.0
21;2021-06-16;2906;2815;0;257218;133980;0;48.3;25.1;0.0
21;2021-06-17;3316;3111;0;260534;137091;0;48.9;25.7;0.0
21;2021-06-18;2482;3869;0;263016;140960;0;49.4;26.5;0.0
21;2021-06-19;1980;1887;0;264996;142847;0;49.7;26.8;0.0
21;2021-06-20;42;37;0;265038;142884;0;49.7;26.8;0.0
21;2021-06-21;1801;3536;0;266839;146420;0;50.1;27.5;0.0
21;2021-06-22;1845;5811;0;268684;152231;0;50.4;28.6;0.0
21;2021-06-23;1999;5048;0;270683;157279;0;50.8;29.5;0.0
21;2021-06-24;2318;4632;0;273001;161911;0;51.2;30.4;0.0
21;2021-06-25;1512;5867;0;274513;167778;0;51.5;31.5;0.0
21;2021-06-26;1353;3837;0;275866;171615;0;51.8;32.2;0.0
21;2021-06-27;30;160;0;275896;171775;0;51.8;32.2;0.0
21;2021-06-28;1351;4079;0;277247;175854;0;52.0;33.0;0.0
21;2021-06-29;1572;4257;0;278819;180111;0;52.3;33.8;0.0
21;2021-06-30;1576;3508;0;280395;183619;0;52.6;34.5;0.0
21;2021-07-01;1722;4219;0;282117;187838;0;52.9;35.2;0.0
21;2021-07-02;2229;4209;0;284346;192047;0;53.4;36.0;0.0
21;2021-07-03;1096;2025;0;285442;194072;0;53.6;36.4;0.0
21;2021-07-04;57;97;0;285499;194169;0;53.6;36.4;0.0
21;2021-07-05;1581;3659;0;287080;197828;0;53.9;37.1;0.0
21;2021-07-06;1395;3649;0;288475;201477;0;54.1;37.8;0.0
21;2021-07-07;1532;3346;0;290007;204823;0;54.4;38.4;0.0
21;2021-07-08;1893;4100;0;291900;208923;0;54.8;39.2;0.0
21;2021-07-09;2049;4402;0;293949;213325;0;55.2;40.0;0.0
21;2021-07-10;1063;2548;0;295012;215873;0;55.4;40.5;0.0
21;2021-07-11;53;122;0;295065;215995;0;55.4;40.5;0.0
21;2021-07-12;1633;3791;0;296698;219786;0;55.7;41.2;0.0
21;2021-07-13;2310;4995;0;299008;224781;0;56.1;42.2;0.0
21;2021-07-14;2617;1947;0;301625;226728;0;56.6;42.5;0.0
21;2021-07-15;3735;4668;0;305360;231396;0;57.3;43.4;0.0
21;2021-07-16;3809;5199;0;309169;236595;0;58.0;44.4;0.0
21;2021-07-17;2567;3987;0;311736;240582;0;58.5;45.1;0.0
21;2021-07-18;213;140;0;311949;240722;0;58.5;45.2;0.0
21;2021-07-19;2297;4730;0;314246;245452;0;59.0;46.1;0.0
21;2021-07-20;2772;5437;0;317018;250889;0;59.5;47.1;0.0
21;2021-07-21;2904;4812;0;319922;255701;0;60.0;48.0;0.0
21;2021-07-22;3068;4732;0;322990;260433;0;60.6;48.9;0.0
21;2021-07-23;4110;4932;0;327100;265365;0;61.4;49.8;0.0
21;2021-07-24;2933;2893;0;330033;268258;0;61.9;50.3;0.0
21;2021-07-25;127;103;0;330160;268361;0;62.0;50.4;0.0
21;2021-07-26;2653;3631;0;332813;271992;0;62.5;51.0;0.0
21;2021-07-27;3442;3877;0;336255;275869;0;63.1;51.8;0.0
21;2021-07-28;3640;3397;0;339895;279266;0;63.8;52.4;0.0
21;2021-07-29;4081;3394;1;343976;282660;1;64.5;53.0;0.0
21;2021-07-30;4340;3389;0;348316;286049;1;65.4;53.7;0.0
21;2021-07-31;3218;2331;0;351534;288380;1;66.0;54.1;0.0
21;2021-08-01;351;100;0;351885;288480;1;66.0;54.1;0.0
21;2021-08-02;2592;3155;0;354477;291635;1;66.5;54.7;0.0
21;2021-08-03;2669;2762;0;357146;294397;1;67.0;55.2;0.0
21;2021-08-04;2365;2435;0;359511;296832;1;67.5;55.7;0.0
21;2021-08-05;2218;3081;0;361729;299913;1;67.9;56.3;0.0
21;2021-08-06;2586;3387;0;364315;303300;1;68.4;56.9;0.0
21;2021-08-07;1851;2566;0;366166;305866;1;68.7;57.4;0.0
21;2021-08-08;120;130;0;366286;305996;1;68.7;57.4;0.0
21;2021-08-09;1643;2911;0;367929;308907;1;69.0;58.0;0.0
21;2021-08-10;1452;2759;0;369381;311666;1;69.3;58.5;0.0
21;2021-08-11;1697;2476;0;371078;314142;1;69.6;59.0;0.0
21;2021-08-12;1277;2505;0;372355;316647;1;69.9;59.4;0.0
21;2021-08-13;1496;2828;0;373851;319475;1;70.2;60.0;0.0
21;2021-08-14;874;2424;0;374725;321899;1;70.3;60.4;0.0
21;2021-08-15;69;104;0;374794;322003;1;70.3;60.4;0.0
21;2021-08-16;1247;2772;0;376041;324775;1;70.6;60.9;0.0
21;2021-08-17;1204;2810;0;377245;327585;1;70.8;61.5;0.0
21;2021-08-18;1042;2899;0;378287;330484;1;71.0;62.0;0.0
21;2021-08-19;970;3046;0;379257;333530;1;71.2;62.6;0.0
21;2021-08-20;1038;4060;0;380295;337590;1;71.4;63.4;0.0
21;2021-08-21;788;3018;0;381083;340608;1;71.5;63.9;0.0
21;2021-08-22;37;147;0;381120;340755;1;71.5;63.9;0.0
21;2021-08-23;877;3272;0;381997;344027;1;71.7;64.6;0.0
21;2021-08-24;981;2987;0;382978;347014;1;71.9;65.1;0.0
21;2021-08-25;850;2637;0;383828;349651;1;72.0;65.6;0.0
21;2021-08-26;713;2506;0;384541;352157;1;72.2;66.1;0.0
21;2021-08-27;1025;3487;0;385566;355644;1;72.4;66.7;0.0
21;2021-08-28;689;2774;0;386255;358418;1;72.5;67.3;0.0
21;2021-08-29;53;233;0;386308;358651;1;72.5;67.3;0.0
21;2021-08-30;787;2231;56;387095;360882;57;72.6;67.7;0.0
21;2021-08-31;913;1993;117;388008;362875;174;72.8;68.1;0.0
21;2021-09-01;695;1649;185;388703;364524;359;72.9;68.4;0.1
21;2021-09-02;525;1317;267;389228;365841;626;73.0;68.7;0.1
21;2021-09-03;762;1852;325;389990;367693;951;73.2;69.0;0.2
21;2021-09-04;738;1454;235;390728;369147;1186;73.3;69.3;0.2
21;2021-09-05;71;73;27;390799;369220;1213;73.3;69.3;0.2
21;2021-09-06;397;1245;245;391196;370465;1458;73.4;69.5;0.3
21;2021-09-07;371;1006;282;391567;371471;1740;73.5;69.7;0.3
21;2021-09-08;564;1270;329;392131;372741;2069;73.6;69.9;0.4
21;2021-09-09;421;907;450;392552;373648;2519;73.7;70.1;0.5
21;2021-09-10;608;1352;413;393160;375000;2932;73.8;70.4;0.6
21;2021-09-11;438;1250;170;393598;376250;3102;73.9;70.6;0.6
21;2021-09-12;28;37;3;393626;376287;3105;73.9;70.6;0.6
21;2021-09-13;233;666;248;393859;376953;3353;73.9;70.7;0.6
21;2021-09-14;449;943;460;394308;377896;3813;74.0;70.9;0.7
21;2021-09-15;452;906;612;394760;378802;4425;74.1;71.1;0.8
21;2021-09-16;339;750;524;395099;379552;4949;74.1;71.2;0.9
21;2021-09-17;528;1026;484;395627;380578;5433;74.2;71.4;1.0
21;2021-09-18;303;950;189;395930;381528;5622;74.3;71.6;1.1
21;2021-09-19;9;35;2;395939;381563;5624;74.3;71.6;1.1
21;2021-09-20;219;579;270;396158;382142;5894;74.3;71.7;1.1
21;2021-09-21;363;655;568;396521;382797;6462;74.4;71.8;1.2
21;2021-09-22;321;909;430;396842;383706;6892;74.5;72.0;1.3
21;2021-09-23;272;469;458;397114;384175;7350;74.5;72.1;1.4
21;2021-09-24;332;783;660;397446;384958;8010;74.6;72.2;1.5
21;2021-09-25;186;843;215;397632;385801;8225;74.6;72.4;1.5
21;2021-09-26;9;33;7;397641;385834;8232;74.6;72.4;1.5
21;2021-09-27;208;427;487;397849;386261;8719;74.7;72.5;1.6
21;2021-09-28;205;451;600;398054;386712;9319;74.7;72.6;1.7
21;2021-09-29;234;511;428;398288;387223;9747;74.7;72.7;1.8
21;2021-09-30;256;405;653;398544;387628;10400;74.8;72.7;2.0
21;2021-10-01;437;783;804;398981;388411;11204;74.9;72.9;2.1
21;2021-10-02;229;556;195;399210;388967;11399;74.9;73.0;2.1
21;2021-10-03;7;26;7;399217;388993;11406;74.9;73.0;2.1
21;2021-10-04;205;292;386;399422;389285;11792;75.0;73.1;2.2
21;2021-10-05;157;417;593;399579;389702;12385;75.0;73.1;2.3
21;2021-10-06;230;490;591;399809;390192;12976;75.0;73.2;2.4
21;2021-10-07;141;324;530;399950;390516;13506;75.1;73.3;2.5
21;2021-10-08;373;690;995;400323;391206;14501;75.1;73.4;2.7
21;2021-10-09;243;423;491;400566;391629;14992;75.2;73.5;2.8
21;2021-10-10;10;22;6;400576;391651;14998;75.2;73.5;2.8
21;2021-10-11;129;282;437;400705;391933;15435;75.2;73.5;2.9
21;2021-10-12;166;397;707;400871;392330;16142;75.2;73.6;3.0
21;2021-10-13;223;385;722;401094;392715;16864;75.3;73.7;3.2
21;2021-10-14;169;334;608;401263;393049;17472;75.3;73.8;3.3
21;2021-10-15;276;449;1008;401539;393498;18480;75.4;73.8;3.5
21;2021-10-16;195;282;480;401734;393780;18960;75.4;73.9;3.6
21;2021-10-17;6;14;5;401740;393794;18965;75.4;73.9;3.6
21;2021-10-18;114;234;578;401854;394028;19543;75.4;73.9;3.7
21;2021-10-19;113;260;600;401967;394288;20143;75.4;74.0;3.8
21;2021-10-20;254;295;853;402221;394583;20996;75.5;74.0;3.9
21;2021-10-21;122;259;653;402343;394842;21649;75.5;74.1;4.1
21;2021-10-22;269;420;1100;402612;395262;22749;75.6;74.2;4.3
21;2021-10-23;163;244;393;402775;395506;23142;75.6;74.2;4.3
21;2021-10-24;17;14;33;402792;395520;23175;75.6;74.2;4.3
21;2021-10-25;169;228;627;402961;395748;23802;75.6;74.3;4.5
21;2021-10-26;124;145;690;403085;395893;24492;75.6;74.3;4.6
21;2021-10-27;207;271;1215;403292;396164;25707;75.7;74.3;4.8
21;2021-10-28;132;172;747;403424;396336;26454;75.7;74.4;5.0
21;2021-10-29;188;303;1349;403612;396639;27803;75.7;74.4;5.2
21;2021-10-30;112;184;383;403724;396823;28186;75.8;74.5;5.3
21;2021-10-31;2;10;13;403726;396833;28199;75.8;74.5;5.3
21;2021-11-01;13;20;1;403739;396853;28200;75.8;74.5;5.3
21;2021-11-02;145;206;776;403884;397059;28976;75.8;74.5;5.4
21;2021-11-03;174;266;1162;404058;397325;30138;75.8;74.6;5.7
21;2021-11-04;125;143;935;404183;397468;31073;75.8;74.6;5.8
21;2021-11-05;209;329;1608;404392;397797;32681;75.9;74.6;6.1
21;2021-11-06;137;241;808;404529;398038;33489;75.9;74.7;6.3
21;2021-11-07;4;4;1;404533;398042;33490;75.9;74.7;6.3
21;2021-11-08;130;170;1263;404663;398212;34753;75.9;74.7;6.5
21;2021-11-09;114;163;1524;404777;398375;36277;76.0;74.8;6.8
21;2021-11-10;193;276;1864;404970;398651;38141;76.0;74.8;7.2
21;2021-11-11;10;16;38;404980;398667;38179;76.0;74.8;7.2
21;2021-11-12;216;276;1878;405196;398943;40057;76.0;74.9;7.5
21;2021-11-13;133;171;564;405329;399114;40621;76.1;74.9;7.6
21;2021-11-14;2;13;14;405331;399127;40635;76.1;74.9;7.6
21;2021-11-15;116;130;1433;405447;399257;42068;76.1;74.9;7.9
21;2021-11-16;104;151;1545;405551;399408;43613;76.1;75.0;8.2
21;2021-11-17;210;253;1898;405761;399661;45511;76.1;75.0;8.5
21;2021-11-18;124;173;1469;405885;399834;46980;76.2;75.0;8.8
21;2021-11-19;225;305;2475;406110;400139;49455;76.2;75.1;9.3
21;2021-11-20;172;210;809;406282;400349;50264;76.2;75.1;9.4
21;2021-11-21;12;6;8;406294;400355;50272;76.2;75.1;9.4
21;2021-11-22;126;117;1622;406420;400472;51894;76.3;75.2;9.7
21;2021-11-23;108;113;1915;406528;400585;53809;76.3;75.2;10.1
21;2021-11-24;233;246;2321;406761;400831;56130;76.3;75.2;10.5
21;2021-11-25;120;133;2227;406881;400964;58357;76.4;75.2;11.0
21;2021-11-26;257;255;4712;407138;401219;63069;76.4;75.3;11.8
21;2021-11-27;169;171;2625;407307;401390;65694;76.4;75.3;12.3
21;2021-11-28;7;5;261;407314;401395;65955;76.4;75.3;12.4
21;2021-11-29;100;112;3975;407414;401507;69930;76.5;75.3;13.1
21;2021-11-30;135;137;4630;407549;401644;74560;76.5;75.4;14.0
21;2021-12-01;168;203;5053;407717;401847;79613;76.5;75.4;14.9
21;2021-12-02;94;135;4949;407811;401982;84562;76.5;75.4;15.9
21;2021-12-03;187;218;6165;407998;402200;90727;76.6;75.5;17.0
21;2021-12-04;150;188;3456;408148;402388;94183;76.6;75.5;17.7
21;2021-12-05;25;8;635;408173;402396;94818;76.6;75.5;17.8
21;2021-12-06;79;148;4574;408252;402544;99392;76.6;75.5;18.7
21;2021-12-07;146;164;5996;408398;402708;105388;76.6;75.6;19.8
21;2021-12-08;140;201;5507;408538;402909;110895;76.7;75.6;20.8
21;2021-12-09;140;138;5511;408678;403047;116406;76.7;75.6;21.8
21;2021-12-10;170;226;6764;408848;403273;123170;76.7;75.7;23.1
21;2021-12-11;111;169;4024;408959;403442;127194;76.7;75.7;23.9
21;2021-12-12;34;26;682;408993;403468;127876;76.8;75.7;24.0
21;2021-12-13;124;153;4908;409117;403621;132784;76.8;75.7;24.9
21;2021-12-14;135;164;6910;409252;403785;139694;76.8;75.8;26.2
21;2021-12-15;175;218;6584;409427;404003;146278;76.8;75.8;27.5
21;2021-12-16;142;141;5937;409569;404144;152215;76.9;75.8;28.6
22;2020-12-27;0;0;0;0;0;0;0.0;0.0;0.0
22;2020-12-28;0;0;0;0;0;0;0.0;0.0;0.0
22;2020-12-29;0;0;0;0;0;0;0.0;0.0;0.0
22;2020-12-30;0;0;0;0;0;0;0.0;0.0;0.0
22;2020-12-31;0;0;0;0;0;0;0.0;0.0;0.0
22;2021-01-01;1;0;0;1;0;0;0.0;0.0;0.0
22;2021-01-02;2;0;0;3;0;0;0.0;0.0;0.0
22;2021-01-03;1;0;0;4;0;0;0.0;0.0;0.0
22;2021-01-04;3;0;0;7;0;0;0.0;0.0;0.0
22;2021-01-05;51;0;0;58;0;0;0.0;0.0;0.0
22;2021-01-06;114;1;0;172;1;0;0.0;0.0;0.0
22;2021-01-07;72;0;0;244;1;0;0.0;0.0;0.0
22;2021-01-08;186;0;0;430;1;0;0.1;0.0;0.0
22;2021-01-09;1;0;0;431;1;0;0.1;0.0;0.0
22;2021-01-10;1;0;0;432;1;0;0.1;0.0;0.0
22;2021-01-11;239;3;0;671;4;0;0.1;0.0;0.0
22;2021-01-12;609;0;0;1280;4;0;0.2;0.0;0.0
22;2021-01-13;663;1;0;1943;5;0;0.3;0.0;0.0
22;2021-01-14;729;8;0;2672;13;0;0.4;0.0;0.0
22;2021-01-15;535;1;0;3207;14;0;0.5;0.0;0.0
22;2021-01-16;101;0;0;3308;14;0;0.6;0.0;0.0
22;2021-01-17;3;0;0;3311;14;0;0.6;0.0;0.0
22;2021-01-18;352;2;0;3663;16;0;0.6;0.0;0.0
22;2021-01-19;753;0;0;4416;16;0;0.7;0.0;0.0
22;2021-01-20;652;2;0;5068;18;0;0.9;0.0;0.0
22;2021-01-21;1003;2;0;6071;20;0;1.0;0.0;0.0
22;2021-01-22;846;2;0;6917;22;0;1.2;0.0;0.0
22;2021-01-23;230;0;0;7147;22;0;1.2;0.0;0.0
22;2021-01-24;12;0;0;7159;22;0;1.2;0.0;0.0
22;2021-01-25;795;11;0;7954;33;0;1.3;0.0;0.0
22;2021-01-26;977;57;0;8931;90;0;1.5;0.0;0.0
22;2021-01-27;3558;115;0;12489;205;0;2.1;0.0;0.0
22;2021-01-28;4258;84;0;16747;289;0;2.8;0.0;0.0
22;2021-01-29;1802;132;0;18549;421;0;3.1;0.1;0.0
22;2021-01-30;282;1;0;18831;422;0;3.2;0.1;0.0
22;2021-01-31;6;0;0;18837;422;0;3.2;0.1;0.0
22;2021-02-01;651;97;0;19488;519;0;3.3;0.1;0.0
22;2021-02-02;870;426;0;20358;945;0;3.4;0.2;0.0
22;2021-02-03;699;486;0;21057;1431;0;3.5;0.2;0.0
22;2021-02-04;938;641;0;21995;2072;0;3.7;0.3;0.0
22;2021-02-05;722;558;0;22717;2630;0;3.8;0.4;0.0
22;2021-02-06;248;2;0;22965;2632;0;3.9;0.4;0.0
22;2021-02-07;13;0;0;22978;2632;0;3.9;0.4;0.0
22;2021-02-08;553;149;0;23531;2781;0;3.9;0.5;0.0
22;2021-02-09;625;425;0;24156;3206;0;4.1;0.5;0.0
22;2021-02-10;451;285;0;24607;3491;0;4.1;0.6;0.0
22;2021-02-11;1058;388;0;25665;3879;0;4.3;0.7;0.0
22;2021-02-12;628;328;0;26293;4207;0;4.4;0.7;0.0
22;2021-02-13;318;92;0;26611;4299;0;4.5;0.7;0.0
22;2021-02-14;4;12;0;26615;4311;0;4.5;0.7;0.0
22;2021-02-15;688;481;0;27303;4792;0;4.6;0.8;0.0
22;2021-02-16;1021;717;0;28324;5509;0;4.8;0.9;0.0
22;2021-02-17;1174;2262;0;29498;7771;0;4.9;1.3;0.0
22;2021-02-18;2088;2847;0;31586;10618;0;5.3;1.8;0.0
22;2021-02-19;1577;1875;0;33163;12493;0;5.6;2.1;0.0
22;2021-02-20;479;210;0;33642;12703;0;5.6;2.1;0.0
22;2021-02-21;12;49;0;33654;12752;0;5.6;2.1;0.0
22;2021-02-22;417;729;0;34071;13481;0;5.7;2.3;0.0
22;2021-02-23;620;944;0;34691;14425;0;5.8;2.4;0.0
22;2021-02-24;711;894;0;35402;15319;0;5.9;2.6;0.0
22;2021-02-25;1202;1199;0;36604;16518;0;6.1;2.8;0.0
22;2021-02-26;1080;716;0;37684;17234;0;6.3;2.9;0.0
22;2021-02-27;575;279;0;38259;17513;0;6.4;2.9;0.0
22;2021-02-28;21;11;0;38280;17524;0;6.4;2.9;0.0
22;2021-03-01;963;555;0;39243;18079;0;6.6;3.0;0.0
22;2021-03-02;1196;879;0;40439;18958;0;6.8;3.2;0.0
22;2021-03-03;1295;863;0;41734;19821;0;7.0;3.3;0.0
22;2021-03-04;1606;911;0;43340;20732;0;7.3;3.5;0.0
22;2021-03-05;2145;809;0;45485;21541;0;7.6;3.6;0.0
22;2021-03-06;1097;285;0;46582;21826;0;7.8;3.7;0.0
22;2021-03-07;224;10;0;46806;21836;0;7.9;3.7;0.0
22;2021-03-08;1282;661;0;48088;22497;0;8.1;3.8;0.0
22;2021-03-09;1819;748;0;49907;23245;0;8.4;3.9;0.0
22;2021-03-10;1945;953;0;51852;24198;0;8.7;4.1;0.0
22;2021-03-11;2367;1594;0;54219;25792;0;9.1;4.3;0.0
22;2021-03-12;3171;967;0;57390;26759;0;9.6;4.5;0.0
22;2021-03-13;1717;285;0;59107;27044;0;9.9;4.5;0.0
22;2021-03-14;258;30;0;59365;27074;0;10.0;4.5;0.0
22;2021-03-15;1596;588;0;60961;27662;0;10.2;4.6;0.0
22;2021-03-16;1554;833;0;62515;28495;0;10.5;4.8;0.0
22;2021-03-17;2459;708;0;64974;29203;0;10.9;4.9;0.0
22;2021-03-18;2437;1103;0;67411;30306;0;11.3;5.1;0.0
22;2021-03-19;3193;811;0;70604;31117;0;11.8;5.2;0.0
22;2021-03-20;2085;281;0;72689;31398;0;12.2;5.3;0.0
22;2021-03-21;45;2;0;72734;31400;0;12.2;5.3;0.0
22;2021-03-22;2283;377;0;75017;31777;0;12.6;5.3;0.0
22;2021-03-23;3025;706;0;78042;32483;0;13.1;5.4;0.0
22;2021-03-24;3379;701;0;81421;33184;0;13.7;5.6;0.0
22;2021-03-25;3818;631;0;85239;33815;0;14.3;5.7;0.0
22;2021-03-26;3869;492;0;89108;34307;0;14.9;5.8;0.0
22;2021-03-27;1926;198;0;91034;34505;0;15.3;5.8;0.0
22;2021-03-28;132;6;0;91166;34511;0;15.3;5.8;0.0
22;2021-03-29;2573;898;0;93739;35409;0;15.7;5.9;0.0
22;2021-03-30;3362;1113;0;97101;36522;0;16.3;6.1;0.0
22;2021-03-31;3313;1059;0;100414;37581;0;16.8;6.3;0.0
22;2021-04-01;4435;1096;0;104849;38677;0;17.6;6.5;0.0
22;2021-04-02;3983;1019;0;108832;39696;0;18.3;6.7;0.0
22;2021-04-03;1664;391;0;110496;40087;0;18.5;6.7;0.0
22;2021-04-04;62;2;0;110558;40089;0;18.5;6.7;0.0
22;2021-04-05;80;19;0;110638;40108;0;18.6;6.7;0.0
22;2021-04-06;2998;1096;0;113636;41204;0;19.1;6.9;0.0
22;2021-04-07;3126;1306;0;116762;42510;0;19.6;7.1;0.0
22;2021-04-08;4107;1265;0;120869;43775;0;20.3;7.3;0.0
22;2021-04-09;4884;1358;0;125753;45133;0;21.1;7.6;0.0
22;2021-04-10;2125;384;0;127878;45517;0;21.4;7.6;0.0
22;2021-04-11;487;26;0;128365;45543;0;21.5;7.6;0.0
22;2021-04-12;2737;1021;0;131102;46564;0;22.0;7.8;0.0
22;2021-04-13;3229;1491;0;134331;48055;0;22.5;8.1;0.0
22;2021-04-14;3081;2321;0;137412;50376;0;23.0;8.4;0.0
22;2021-04-15;3507;2335;0;140919;52711;0;23.6;8.8;0.0
22;2021-04-16;3455;2402;0;144374;55113;0;24.2;9.2;0.0
22;2021-04-17;1671;1647;0;146045;56760;0;24.5;9.5;0.0
22;2021-04-18;53;14;0;146098;56774;0;24.5;9.5;0.0
22;2021-04-19;2817;2108;0;148915;58882;0;25.0;9.9;0.0
22;2021-04-20;3243;2667;0;152158;61549;0;25.5;10.3;0.0
22;2021-04-21;3109;2588;0;155267;64137;0;26.0;10.8;0.0
22;2021-04-22;3434;2996;0;158701;67133;0;26.6;11.3;0.0
22;2021-04-23;3643;2975;0;162344;70108;0;27.2;11.8;0.0
22;2021-04-24;1805;1686;0;164149;71794;0;27.5;12.0;0.0
22;2021-04-25;61;29;0;164210;71823;0;27.5;12.0;0.0
22;2021-04-26;3136;2629;0;167346;74452;0;28.1;12.5;0.0
22;2021-04-27;3398;2807;0;170744;77259;0;28.6;13.0;0.0
22;2021-04-28;3453;2723;0;174197;79982;0;29.2;13.4;0.0
22;2021-04-29;4061;2909;0;178258;82891;0;29.9;13.9;0.0
22;2021-04-30;3935;2831;0;182193;85722;0;30.6;14.4;0.0
22;2021-05-01;133;116;0;182326;85838;0;30.6;14.4;0.0
22;2021-05-02;1241;106;0;183567;85944;0;30.8;14.4;0.0
22;2021-05-03;2062;2432;0;185629;88376;0;31.1;14.8;0.0
22;2021-05-04;2220;2713;0;187849;91089;0;31.5;15.3;0.0
22;2021-05-05;2121;2688;0;189970;93777;0;31.9;15.7;0.0
22;2021-05-06;2607;3273;0;192577;97050;0;32.3;16.3;0.0
22;2021-05-07;2931;3210;0;195508;100260;0;32.8;16.8;0.0
22;2021-05-08;131;165;0;195639;100425;0;32.8;16.8;0.0
22;2021-05-09;643;447;0;196282;100872;0;32.9;16.9;0.0
22;2021-05-10;4304;2537;0;200586;103409;0;33.6;17.3;0.0
22;2021-05-11;4815;2772;0;205401;106181;0;34.5;17.8;0.0
22;2021-05-12;6048;1120;0;211449;107301;0;35.5;18.0;0.0
22;2021-05-13;714;125;0;212163;107426;0;35.6;18.0;0.0
22;2021-05-14;5678;1207;0;217841;108633;0;36.5;18.2;0.0
22;2021-05-15;3575;458;0;221416;109091;0;37.1;18.3;0.0
22;2021-05-16;377;61;0;221793;109152;0;37.2;18.3;0.0
22;2021-05-17;5204;608;0;226997;109760;0;38.1;18.4;0.0
22;2021-05-18;5556;1074;0;232553;110834;0;39.0;18.6;0.0
22;2021-05-19;5711;833;0;238264;111667;0;40.0;18.7;0.0
22;2021-05-20;6134;1448;0;244398;113115;0;41.0;19.0;0.0
22;2021-05-21;5441;1553;0;249839;114668;0;41.9;19.2;0.0
22;2021-05-22;3590;757;0;253429;115425;0;42.5;19.4;0.0
22;2021-05-23;449;28;0;253878;115453;0;42.6;19.4;0.0
22;2021-05-24;4549;245;0;258427;115698;0;43.3;19.4;0.0
22;2021-05-25;4986;1245;0;263413;116943;0;44.2;19.6;0.0
22;2021-05-26;3843;2576;0;267256;119519;0;44.8;20.0;0.0
22;2021-05-27;4150;3565;0;271406;123084;0;45.5;20.6;0.0
22;2021-05-28;4010;4189;0;275416;127273;0;46.2;21.3;0.0
22;2021-05-29;2763;1624;0;278179;128897;0;46.7;21.6;0.0
22;2021-05-30;145;23;0;278324;128920;0;46.7;21.6;0.0
22;2021-05-31;3414;3034;0;281738;131954;0;47.3;22.1;0.0
22;2021-06-01;3450;3566;0;285188;135520;0;47.8;22.7;0.0
22;2021-06-02;2996;3173;0;288184;138693;0;48.3;23.3;0.0
22;2021-06-03;3286;3900;0;291470;142593;0;48.9;23.9;0.0
22;2021-06-04;3365;4422;0;294835;147015;0;49.5;24.7;0.0
22;2021-06-05;3122;1894;0;297957;148909;0;50.0;25.0;0.0
22;2021-06-06;344;55;0;298301;148964;0;50.0;25.0;0.0
22;2021-06-07;2913;3210;0;301214;152174;0;50.5;25.5;0.0
22;2021-06-08;2818;3470;0;304032;155644;0;51.0;26.1;0.0
22;2021-06-09;2642;3504;0;306674;159148;0;51.4;26.7;0.0
22;2021-06-10;2712;4107;0;309386;163255;0;51.9;27.4;0.0
22;2021-06-11;2753;4304;0;312139;167559;0;52.4;28.1;0.0
22;2021-06-12;2212;1397;0;314351;168956;0;52.7;28.3;0.0
22;2021-06-13;303;1125;0;314654;170081;0;52.8;28.5;0.0
22;2021-06-14;2596;2537;0;317250;172618;0;53.2;29.0;0.0
22;2021-06-15;3106;3135;0;320356;175753;0;53.7;29.5;0.0
22;2021-06-16;3043;2917;0;323399;178670;0;54.2;30.0;0.0
22;2021-06-17;2725;3256;0;326124;181926;0;54.7;30.5;0.0
22;2021-06-18;3206;4221;0;329330;186147;0;55.2;31.2;0.0
22;2021-06-19;2754;1419;0;332084;187566;0;55.7;31.5;0.0
22;2021-06-20;239;89;0;332323;187655;0;55.7;31.5;0.0
22;2021-06-21;1884;4884;0;334207;192539;0;56.1;32.3;0.0
22;2021-06-22;2501;5486;0;336708;198025;0;56.5;33.2;0.0
22;2021-06-23;1499;5982;0;338207;204007;0;56.7;34.2;0.0
22;2021-06-24;2700;3907;0;340907;207914;0;57.2;34.9;0.0
22;2021-06-25;1684;6502;0;342591;214416;0;57.5;36.0;0.0
22;2021-06-26;797;3543;0;343388;217959;0;57.6;36.6;0.0
22;2021-06-27;67;475;0;343455;218434;0;57.6;36.6;0.0
22;2021-06-28;1082;5329;0;344537;223763;0;57.8;37.5;0.0
22;2021-06-29;1471;5825;0;346008;229588;0;58.0;38.5;0.0
22;2021-06-30;1242;5655;0;347250;235243;0;58.2;39.5;0.0
22;2021-07-01;1510;5879;0;348760;241122;0;58.5;40.4;0.0
22;2021-07-02;1766;5942;0;350526;247064;0;58.8;41.4;0.0
22;2021-07-03;959;3417;0;351485;250481;0;59.0;42.0;0.0
22;2021-07-04;186;440;0;351671;250921;0;59.0;42.1;0.0
22;2021-07-05;1643;5535;0;353314;256456;0;59.3;43.0;0.0
22;2021-07-06;2302;5774;0;355616;262230;0;59.6;44.0;0.0
22;2021-07-07;2194;4763;0;357810;266993;0;60.0;44.8;0.0
22;2021-07-08;2328;4925;0;360138;271918;0;60.4;45.6;0.0
22;2021-07-09;2320;5250;0;362458;277168;0;60.8;46.5;0.0
22;2021-07-10;1605;3108;0;364063;280276;0;61.1;47.0;0.0
22;2021-07-11;459;145;0;364522;280421;0;61.1;47.0;0.0
22;2021-07-12;2125;4542;0;366647;284963;0;61.5;47.8;0.0
22;2021-07-13;3467;5033;0;370114;289996;0;62.1;48.6;0.0
22;2021-07-14;769;2547;0;370883;292543;0;62.2;49.1;0.0
22;2021-07-15;3394;4677;0;374277;297220;0;62.8;49.9;0.0
22;2021-07-16;3499;5239;0;377776;302459;0;63.4;50.7;0.0
22;2021-07-17;2271;3071;0;380047;305530;0;63.7;51.2;0.0
22;2021-07-18;579;209;0;380626;305739;0;63.8;51.3;0.0
22;2021-07-19;2530;3954;1;383156;309693;1;64.3;51.9;0.0
22;2021-07-20;3540;4056;0;386696;313749;1;64.9;52.6;0.0
22;2021-07-21;3586;3377;0;390282;317126;1;65.5;53.2;0.0
22;2021-07-22;4326;3691;0;394608;320817;1;66.2;53.8;0.0
22;2021-07-23;4033;4243;0;398641;325060;1;66.9;54.5;0.0
22;2021-07-24;1981;2409;0;400622;327469;1;67.2;54.9;0.0
22;2021-07-25;221;278;0;400843;327747;1;67.2;55.0;0.0
22;2021-07-26;2750;3857;0;403593;331604;1;67.7;55.6;0.0
22;2021-07-27;3340;4713;0;406933;336317;1;68.3;56.4;0.0
22;2021-07-28;3353;3581;0;410286;339898;1;68.8;57.0;0.0
22;2021-07-29;3785;3729;0;414071;343627;1;69.5;57.6;0.0
22;2021-07-30;3561;3960;0;417632;347587;1;70.1;58.3;0.0
22;2021-07-31;2033;2655;0;419665;350242;1;70.4;58.7;0.0
22;2021-08-01;247;258;0;419912;350500;1;70.4;58.8;0.0
22;2021-08-02;4192;2435;0;424104;352935;1;71.1;59.2;0.0
22;2021-08-03;4347;3325;0;428451;356260;1;71.9;59.8;0.0
22;2021-08-04;5033;2404;0;433484;358664;1;72.7;60.2;0.0
22;2021-08-05;3721;3545;0;437205;362209;1;73.3;60.8;0.0
22;2021-08-06;3291;3576;0;440496;365785;1;73.9;61.4;0.0
22;2021-08-07;2094;2076;0;442590;367861;1;74.2;61.7;0.0
22;2021-08-08;369;153;0;442959;368014;1;74.3;61.7;0.0
22;2021-08-09;2500;2596;0;445459;370610;1;74.7;62.2;0.0
22;2021-08-10;2598;3318;0;448057;373928;1;75.2;62.7;0.0
22;2021-08-11;2338;2935;0;450395;376863;1;75.5;63.2;0.0
22;2021-08-12;2142;3301;0;452537;380164;1;75.9;63.8;0.0
22;2021-08-13;1974;2896;0;454511;383060;1;76.2;64.3;0.0
22;2021-08-14;1265;1732;0;455776;384792;1;76.4;64.5;0.0
22;2021-08-15;147;270;0;455923;385062;1;76.5;64.6;0.0
22;2021-08-16;1503;3005;0;457426;388067;1;76.7;65.1;0.0
22;2021-08-17;1765;3336;0;459191;391403;1;77.0;65.7;0.0
22;2021-08-18;1490;3135;0;460681;394538;1;77.3;66.2;0.0
22;2021-08-19;1437;3435;0;462118;397973;1;77.5;66.8;0.0
22;2021-08-20;1496;3548;0;463614;401521;1;77.8;67.3;0.0
22;2021-08-21;747;2101;0;464361;403622;1;77.9;67.7;0.0
22;2021-08-22;203;386;0;464564;404008;1;77.9;67.8;0.0
22;2021-08-23;1863;3529;0;466427;407537;1;78.2;68.4;0.0
22;2021-08-24;1412;3234;0;467839;410771;1;78.5;68.9;0.0
22;2021-08-25;866;2595;0;468705;413366;1;78.6;69.3;0.0
22;2021-08-26;1106;4214;0;469811;417580;1;78.8;70.0;0.0
22;2021-08-27;1285;4535;0;471096;422115;1;79.0;70.8;0.0
22;2021-08-28;700;2353;0;471796;424468;1;79.1;71.2;0.0
22;2021-08-29;69;136;0;471865;424604;1;79.1;71.2;0.0
22;2021-08-30;917;3020;52;472782;427624;53;79.3;71.7;0.0
22;2021-08-31;995;3737;68;473777;431361;121;79.5;72.4;0.0
22;2021-09-01;1024;3236;171;474801;434597;292;79.6;72.9;0.0
22;2021-09-02;847;2840;234;475648;437437;526;79.8;73.4;0.1
22;2021-09-03;935;2867;311;476583;440304;837;79.9;73.9;0.1
22;2021-09-04;762;2439;129;477345;442743;966;80.1;74.3;0.2
22;2021-09-05;119;109;29;477464;442852;995;80.1;74.3;0.2
22;2021-09-06;501;1943;319;477965;444795;1314;80.2;74.6;0.2
22;2021-09-07;538;1983;308;478503;446778;1622;80.3;74.9;0.3
22;2021-09-08;627;1962;323;479130;448740;1945;80.4;75.3;0.3
22;2021-09-09;650;1927;405;479780;450667;2350;80.5;75.6;0.4
22;2021-09-10;716;2136;369;480496;452803;2719;80.6;75.9;0.5
22;2021-09-11;537;1556;131;481033;454359;2850;80.7;76.2;0.5
22;2021-09-12;41;123;8;481074;454482;2858;80.7;76.2;0.5
22;2021-09-13;506;2057;592;481580;456539;3450;80.8;76.6;0.6
22;2021-09-14;601;1566;844;482181;458105;4294;80.9;76.8;0.7
22;2021-09-15;456;1716;618;482637;459821;4912;81.0;77.1;0.8
22;2021-09-16;560;1088;991;483197;460909;5903;81.0;77.3;1.0
22;2021-09-17;631;1628;947;483828;462537;6850;81.2;77.6;1.1
22;2021-09-18;280;2015;104;484108;464552;6954;81.2;77.9;1.2
22;2021-09-19;10;57;7;484118;464609;6961;81.2;77.9;1.2
22;2021-09-20;373;736;676;484491;465345;7637;81.3;78.1;1.3
22;2021-09-21;360;914;1011;484851;466259;8648;81.3;78.2;1.5
22;2021-09-22;302;1202;533;485153;467461;9181;81.4;78.4;1.5
22;2021-09-23;390;730;940;485543;468191;10121;81.4;78.5;1.7
22;2021-09-24;375;1150;932;485918;469341;11053;81.5;78.7;1.9
22;2021-09-25;215;1304;176;486133;470645;11229;81.5;78.9;1.9
22;2021-09-26;17;90;15;486150;470735;11244;81.5;79.0;1.9
22;2021-09-27;336;780;697;486486;471515;11941;81.6;79.1;2.0
22;2021-09-28;229;605;702;486715;472120;12643;81.6;79.2;2.1
22;2021-09-29;234;873;936;486949;472993;13579;81.7;79.3;2.3
22;2021-09-30;275;706;1020;487224;473699;14599;81.7;79.5;2.4
22;2021-10-01;326;801;862;487550;474500;15461;81.8;79.6;2.6
22;2021-10-02;306;848;239;487856;475348;15700;81.8;79.7;2.6
22;2021-10-03;5;3;5;487861;475351;15705;81.8;79.7;2.6
22;2021-10-04;149;452;602;488010;475803;16307;81.9;79.8;2.7
22;2021-10-05;217;635;904;488227;476438;17211;81.9;79.9;2.9
22;2021-10-06;235;397;757;488462;476835;17968;81.9;80.0;3.0
22;2021-10-07;233;652;937;488695;477487;18905;82.0;80.1;3.2
22;2021-10-08;313;785;961;489008;478272;19866;82.0;80.2;3.3
22;2021-10-09;226;436;387;489234;478708;20253;82.1;80.3;3.4
22;2021-10-10;6;11;4;489240;478719;20257;82.1;80.3;3.4
22;2021-10-11;158;304;675;489398;479023;20932;82.1;80.3;3.5
22;2021-10-12;106;183;535;489504;479206;21467;82.1;80.4;3.6
22;2021-10-13;184;263;660;489688;479469;22127;82.1;80.4;3.7
22;2021-10-14;209;713;1218;489897;480182;23345;82.2;80.5;3.9
22;2021-10-15;270;482;1360;490167;480664;24705;82.2;80.6;4.1
22;2021-10-16;307;449;669;490474;481113;25374;82.3;80.7;4.3
22;2021-10-17;2;6;3;490476;481119;25377;82.3;80.7;4.3
22;2021-10-18;139;329;1010;490615;481448;26387;82.3;80.8;4.4
22;2021-10-19;70;131;392;490685;481579;26779;82.3;80.8;4.5
22;2021-10-20;167;272;1349;490852;481851;28128;82.3;80.8;4.7
22;2021-10-21;215;419;1736;491067;482270;29864;82.4;80.9;5.0
22;2021-10-22;195;427;1197;491262;482697;31061;82.4;81.0;5.2
22;2021-10-23;233;413;1033;491495;483110;32094;82.4;81.0;5.4
22;2021-10-24;2;10;1;491497;483120;32095;82.4;81.0;5.4
22;2021-10-25;178;162;1505;491675;483282;33600;82.5;81.1;5.6
22;2021-10-26;68;80;419;491743;483362;34019;82.5;81.1;5.7
22;2021-10-27;125;142;1110;491868;483504;35129;82.5;81.1;5.9
22;2021-10-28;204;257;1675;492072;483761;36804;82.5;81.1;6.2
22;2021-10-29;176;337;1414;492248;484098;38218;82.6;81.2;6.4
22;2021-10-30;154;251;889;492402;484349;39107;82.6;81.2;6.6
22;2021-10-31;1;10;7;492403;484359;39114;82.6;81.2;6.6
22;2021-11-01;5;4;9;492408;484363;39123;82.6;81.2;6.6
22;2021-11-02;71;80;539;492479;484443;39662;82.6;81.3;6.7
22;2021-11-03;157;182;1592;492636;484625;41254;82.6;81.3;6.9
22;2021-11-04;213;278;1954;492849;484903;43208;82.7;81.3;7.2
22;2021-11-05;191;316;1784;493040;485219;44992;82.7;81.4;7.5
22;2021-11-06;206;313;1349;493246;485532;46341;82.7;81.4;7.8
22;2021-11-07;3;4;6;493249;485536;46347;82.7;81.4;7.8
22;2021-11-08;110;192;2480;493359;485728;48827;82.8;81.5;8.2
22;2021-11-09;151;161;2113;493510;485889;50940;82.8;81.5;8.5
22;2021-11-10;123;174;1600;493633;486063;52540;82.8;81.5;8.8
22;2021-11-11;1;13;57;493634;486076;52597;82.8;81.5;8.8
22;2021-11-12;195;412;2802;493829;486488;55399;82.8;81.6;9.3
22;2021-11-13;207;301;1670;494036;486789;57069;82.9;81.7;9.6
22;2021-11-14;1;8;2;494037;486797;57071;82.9;81.7;9.6
22;2021-11-15;134;139;2026;494171;486936;59097;82.9;81.7;9.9
22;2021-11-16;139;129;2348;494310;487065;61445;82.9;81.7;10.3
22;2021-11-17;159;166;1955;494469;487231;63400;82.9;81.7;10.6
22;2021-11-18;211;207;2740;494680;487438;66140;83.0;81.8;11.1
22;2021-11-19;234;274;2940;494914;487712;69080;83.0;81.8;11.6
22;2021-11-20;265;270;1253;495179;487982;70333;83.1;81.9;11.8
22;2021-11-21;1;3;1;495180;487985;70334;83.1;81.9;11.8
22;2021-11-22;163;116;2108;495343;488101;72442;83.1;81.9;12.2
22;2021-11-23;183;138;2657;495526;488239;75099;83.1;81.9;12.6
22;2021-11-24;230;197;1976;495756;488436;77075;83.2;81.9;12.9
22;2021-11-25;169;155;3168;495925;488591;80243;83.2;82.0;13.5
22;2021-11-26;228;232;4687;496153;488823;84930;83.2;82.0;14.2
22;2021-11-27;205;255;2060;496358;489078;86990;83.3;82.0;14.6
22;2021-11-28;4;2;53;496362;489080;87043;83.3;82.0;14.6
22;2021-11-29;125;113;4764;496487;489193;91807;83.3;82.1;15.4
22;2021-11-30;159;139;6129;496646;489332;97936;83.3;82.1;16.4
22;2021-12-01;167;147;5436;496813;489479;103372;83.3;82.1;17.3
22;2021-12-02;125;118;5880;496938;489597;109252;83.4;82.1;18.3
22;2021-12-03;146;203;6876;497084;489800;116128;83.4;82.2;19.5
22;2021-12-04;99;254;2429;497183;490054;118557;83.4;82.2;19.9
22;2021-12-05;5;4;120;497188;490058;118677;83.4;82.2;19.9
22;2021-12-06;112;162;5865;497300;490220;124542;83.4;82.2;20.9
22;2021-12-07;126;142;7117;497426;490362;131659;83.4;82.2;22.1
22;2021-12-08;154;190;6820;497580;490552;138479;83.5;82.3;23.2
22;2021-12-09;170;170;7927;497750;490722;146406;83.5;82.3;24.6
22;2021-12-10;204;268;8615;497954;490990;155021;83.5;82.4;26.0
22;2021-12-11;109;263;3817;498063;491253;158838;83.5;82.4;26.6
22;2021-12-12;27;17;1142;498090;491270;159980;83.5;82.4;26.8
22;2021-12-13;132;167;7343;498222;491437;167323;83.6;82.4;28.1
22;2021-12-14;179;183;9116;498401;491620;176439;83.6;82.5;29.6
22;2021-12-15;207;208;7826;498608;491828;184265;83.6;82.5;30.9
22;2021-12-16;174;256;8209;498782;492084;192474;83.7;82.5;32.3
23;2020-12-27;0;0;0;0;0;0;0.0;0.0;0.0
23;2020-12-28;1;0;0;1;0;0;0.0;0.0;0.0
23;2020-12-29;0;0;0;1;0;0;0.0;0.0;0.0
23;2020-12-30;0;0;0;1;0;0;0.0;0.0;0.0
23;2020-12-31;0;0;0;1;0;0;0.0;0.0;0.0
23;2021-01-01;0;0;0;1;0;0;0.0;0.0;0.0
23;2021-01-02;1;0;0;2;0;0;0.0;0.0;0.0
23;2021-01-03;0;0;0;2;0;0;0.0;0.0;0.0
23;2021-01-04;2;0;0;4;0;0;0.0;0.0;0.0
23;2021-01-05;4;0;0;8;0;0;0.0;0.0;0.0
23;2021-01-06;8;0;0;16;0;0;0.0;0.0;0.0
23;2021-01-07;99;1;0;115;1;0;0.1;0.0;0.0
23;2021-01-08;111;0;0;226;1;0;0.2;0.0;0.0
23;2021-01-09;26;0;0;252;1;0;0.2;0.0;0.0
23;2021-01-10;3;0;0;255;1;0;0.2;0.0;0.0
23;2021-01-11;150;1;0;405;2;0;0.3;0.0;0.0
23;2021-01-12;209;5;0;614;7;0;0.5;0.0;0.0
23;2021-01-13;239;0;0;853;7;0;0.7;0.0;0.0
23;2021-01-14;238;3;0;1091;10;0;0.9;0.0;0.0
23;2021-01-15;295;5;0;1386;15;0;1.2;0.0;0.0
23;2021-01-16;154;1;0;1540;16;0;1.3;0.0;0.0
23;2021-01-17;0;0;0;1540;16;0;1.3;0.0;0.0
23;2021-01-18;307;3;0;1847;19;0;1.6;0.0;0.0
23;2021-01-19;451;1;0;2298;20;0;2.0;0.0;0.0
23;2021-01-20;327;1;0;2625;21;0;2.3;0.0;0.0
23;2021-01-21;631;1;0;3256;22;0;2.8;0.0;0.0
23;2021-01-22;444;0;0;3700;22;0;3.2;0.0;0.0
23;2021-01-23;347;1;0;4047;23;0;3.5;0.0;0.0
23;2021-01-24;8;0;0;4055;23;0;3.5;0.0;0.0
23;2021-01-25;360;16;0;4415;39;0;3.8;0.0;0.0
23;2021-01-26;280;6;0;4695;45;0;4.0;0.0;0.0
23;2021-01-27;231;2;0;4926;47;0;4.2;0.0;0.0
23;2021-01-28;229;34;0;5155;81;0;4.4;0.1;0.0
23;2021-01-29;288;99;0;5443;180;0;4.7;0.2;0.0
23;2021-01-30;98;26;0;5541;206;0;4.8;0.2;0.0
23;2021-01-31;2;24;0;5543;230;0;4.8;0.2;0.0
23;2021-02-01;144;93;0;5687;323;0;4.9;0.3;0.0
23;2021-02-02;157;104;0;5844;427;0;5.0;0.4;0.0
23;2021-02-03;99;146;0;5943;573;0;5.1;0.5;0.0
23;2021-02-04;87;209;0;6030;782;0;5.2;0.7;0.0
23;2021-02-05;125;287;0;6155;1069;0;5.3;0.9;0.0
23;2021-02-06;17;163;0;6172;1232;0;5.3;1.1;0.0
23;2021-02-07;1;0;0;6173;1232;0;5.3;1.1;0.0
23;2021-02-08;110;199;0;6283;1431;0;5.4;1.2;0.0
23;2021-02-09;75;276;0;6358;1707;0;5.5;1.5;0.0
23;2021-02-10;88;257;0;6446;1964;0;5.5;1.7;0.0
23;2021-02-11;228;516;0;6674;2480;0;5.7;2.1;0.0
23;2021-02-12;210;252;0;6884;2732;0;5.9;2.3;0.0
23;2021-02-13;8;175;0;6892;2907;0;5.9;2.5;0.0
23;2021-02-14;11;1;0;6903;2908;0;5.9;2.5;0.0
23;2021-02-15;152;330;0;7055;3238;0;6.1;2.8;0.0
23;2021-02-16;95;412;0;7150;3650;0;6.1;3.1;0.0
23;2021-02-17;74;471;0;7224;4121;0;6.2;3.5;0.0
23;2021-02-18;126;372;0;7350;4493;0;6.3;3.9;0.0
23;2021-02-19;107;240;0;7457;4733;0;6.4;4.1;0.0
23;2021-02-20;9;97;0;7466;4830;0;6.4;4.2;0.0
23;2021-02-21;0;0;0;7466;4830;0;6.4;4.2;0.0
23;2021-02-22;99;196;0;7565;5026;0;6.5;4.3;0.0
23;2021-02-23;91;204;0;7656;5230;0;6.6;4.5;0.0
23;2021-02-24;148;152;0;7804;5382;0;6.7;4.6;0.0
23;2021-02-25;164;111;0;7968;5493;0;6.9;4.7;0.0
23;2021-02-26;269;142;0;8237;5635;0;7.1;4.8;0.0
23;2021-02-27;92;15;0;8329;5650;0;7.2;4.9;0.0
23;2021-02-28;3;30;0;8332;5680;0;7.2;4.9;0.0
23;2021-03-01;89;176;0;8421;5856;0;7.2;5.0;0.0
23;2021-03-02;225;128;0;8646;5984;0;7.4;5.1;0.0
23;2021-03-03;139;99;0;8785;6083;0;7.6;5.2;0.0
23;2021-03-04;279;119;0;9064;6202;0;7.8;5.3;0.0
23;2021-03-05;512;129;0;9576;6331;0;8.2;5.4;0.0
23;2021-03-06;493;14;0;10069;6345;0;8.7;5.5;0.0
23;2021-03-07;288;4;0;10357;6349;0;8.9;5.5;0.0
23;2021-03-08;210;78;0;10567;6427;0;9.1;5.5;0.0
23;2021-03-09;360;95;0;10927;6522;0;9.4;5.6;0.0
23;2021-03-10;306;43;0;11233;6565;0;9.7;5.6;0.0
23;2021-03-11;295;53;0;11528;6618;0;9.9;5.7;0.0
23;2021-03-12;528;50;0;12056;6668;0;10.4;5.7;0.0
23;2021-03-13;293;15;0;12349;6683;0;10.6;5.7;0.0
23;2021-03-14;46;34;0;12395;6717;0;10.7;5.8;0.0
23;2021-03-15;219;115;0;12614;6832;0;10.8;5.9;0.0
23;2021-03-16;207;92;0;12821;6924;0;11.0;6.0;0.0
23;2021-03-17;127;100;0;12948;7024;0;11.1;6.0;0.0
23;2021-03-18;189;90;0;13137;7114;0;11.3;6.1;0.0
23;2021-03-19;240;122;0;13377;7236;0;11.5;6.2;0.0
23;2021-03-20;604;34;0;13981;7270;0;12.0;6.3;0.0
23;2021-03-21;107;0;0;14088;7270;0;12.1;6.3;0.0
23;2021-03-22;254;126;0;14342;7396;0;12.3;6.4;0.0
23;2021-03-23;465;86;0;14807;7482;0;12.7;6.4;0.0
23;2021-03-24;427;108;0;15234;7590;0;13.1;6.5;0.0
23;2021-03-25;814;173;0;16048;7763;0;13.8;6.7;0.0
23;2021-03-26;714;172;0;16762;7935;0;14.4;6.8;0.0
23;2021-03-27;506;37;0;17268;7972;0;14.9;6.9;0.0
23;2021-03-28;4;12;0;17272;7984;0;14.9;6.9;0.0
23;2021-03-29;360;106;0;17632;8090;0;15.2;7.0;0.0
23;2021-03-30;538;169;0;18170;8259;0;15.6;7.1;0.0
23;2021-03-31;431;178;0;18601;8437;0;16.0;7.3;0.0
23;2021-04-01;602;169;0;19203;8606;0;16.5;7.4;0.0
23;2021-04-02;509;286;0;19712;8892;0;17.0;7.6;0.0
23;2021-04-03;637;49;0;20349;8941;0;17.5;7.7;0.0
23;2021-04-04;4;1;0;20353;8942;0;17.5;7.7;0.0
23;2021-04-05;7;4;0;20360;8946;0;17.5;7.7;0.0
23;2021-04-06;391;264;0;20751;9210;0;17.8;7.9;0.0
23;2021-04-07;689;261;0;21440;9471;0;18.4;8.1;0.0
23;2021-04-08;784;223;0;22224;9694;0;19.1;8.3;0.0
23;2021-04-09;900;293;0;23124;9987;0;19.9;8.6;0.0
23;2021-04-10;1018;125;0;24142;10112;0;20.8;8.7;0.0
23;2021-04-11;31;5;0;24173;10117;0;20.8;8.7;0.0
23;2021-04-12;638;209;0;24811;10326;0;21.3;8.9;0.0
23;2021-04-13;646;275;0;25457;10601;0;21.9;9.1;0.0
23;2021-04-14;570;181;0;26027;10782;0;22.4;9.3;0.0
23;2021-04-15;878;186;0;26905;10968;0;23.1;9.4;0.0
23;2021-04-16;837;225;0;27742;11193;0;23.9;9.6;0.0
23;2021-04-17;882;531;0;28624;11724;0;24.6;10.1;0.0
23;2021-04-18;20;118;0;28644;11842;0;24.6;10.2;0.0
23;2021-04-19;544;282;0;29188;12124;0;25.1;10.4;0.0
23;2021-04-20;658;299;0;29846;12423;0;25.7;10.7;0.0
23;2021-04-21;673;384;0;30519;12807;0;26.2;11.0;0.0
23;2021-04-22;579;484;0;31098;13291;0;26.7;11.4;0.0
23;2021-04-23;526;342;0;31624;13633;0;27.2;11.7;0.0
23;2021-04-24;767;425;0;32391;14058;0;27.9;12.1;0.0
23;2021-04-25;14;2;0;32405;14060;0;27.9;12.1;0.0
23;2021-04-26;563;267;0;32968;14327;0;28.4;12.3;0.0
23;2021-04-27;634;431;0;33602;14758;0;28.9;12.7;0.0
23;2021-04-28;622;276;0;34224;15034;0;29.4;12.9;0.0
23;2021-04-29;860;378;0;35084;15412;0;30.2;13.3;0.0
23;2021-04-30;665;701;0;35749;16113;0;30.7;13.9;0.0
23;2021-05-01;1149;50;0;36898;16163;0;31.7;13.9;0.0
23;2021-05-02;24;5;0;36922;16168;0;31.8;13.9;0.0
23;2021-05-03;415;502;0;37337;16670;0;32.1;14.3;0.0
23;2021-05-04;616;491;0;37953;17161;0;32.6;14.8;0.0
23;2021-05-05;539;688;0;38492;17849;0;33.1;15.4;0.0
23;2021-05-06;593;676;0;39085;18525;0;33.6;15.9;0.0
23;2021-05-07;662;615;0;39747;19140;0;34.2;16.5;0.0
23;2021-05-08;1063;502;0;40810;19642;0;35.1;16.9;0.0
23;2021-05-09;12;13;0;40822;19655;0;35.1;16.9;0.0
23;2021-05-10;504;639;0;41326;20294;0;35.5;17.5;0.0
23;2021-05-11;562;707;0;41888;21001;0;36.0;18.1;0.0
23;2021-05-12;557;670;0;42445;21671;0;36.5;18.6;0.0
23;2021-05-13;490;60;0;42935;21731;0;36.9;18.7;0.0
23;2021-05-14;627;440;0;43562;22171;0;37.5;19.1;0.0
23;2021-05-15;863;193;0;44425;22364;0;38.2;19.2;0.0
23;2021-05-16;14;4;0;44439;22368;0;38.2;19.2;0.0
23;2021-05-17;500;437;0;44939;22805;0;38.7;19.6;0.0
23;2021-05-18;657;287;0;45596;23092;0;39.2;19.9;0.0
23;2021-05-19;770;258;0;46366;23350;0;39.9;20.1;0.0
23;2021-05-20;714;298;0;47080;23648;0;40.5;20.3;0.0
23;2021-05-21;835;301;0;47915;23949;0;41.2;20.6;0.0
23;2021-05-22;568;119;0;48483;24068;0;41.7;20.7;0.0
23;2021-05-23;10;21;0;48493;24089;0;41.7;20.7;0.0
23;2021-05-24;278;141;0;48771;24230;0;41.9;20.8;0.0
23;2021-05-25;733;335;0;49504;24565;0;42.6;21.1;0.0
23;2021-05-26;871;244;0;50375;24809;0;43.3;21.3;0.0
23;2021-05-27;799;430;0;51174;25239;0;44.0;21.7;0.0
23;2021-05-28;683;663;0;51857;25902;0;44.6;22.3;0.0
23;2021-05-29;530;1003;0;52387;26905;0;45.1;23.1;0.0
23;2021-05-30;23;46;0;52410;26951;0;45.1;23.2;0.0
23;2021-05-31;373;479;0;52783;27430;0;45.4;23.6;0.0
23;2021-06-01;543;757;0;53326;28187;0;45.9;24.2;0.0
23;2021-06-02;534;494;0;53860;28681;0;46.3;24.7;0.0
23;2021-06-03;663;529;0;54523;29210;0;46.9;25.1;0.0
23;2021-06-04;709;550;0;55232;29760;0;47.5;25.6;0.0
23;2021-06-05;477;716;0;55709;30476;0;47.9;26.2;0.0
23;2021-06-06;8;15;0;55717;30491;0;47.9;26.2;0.0
23;2021-06-07;365;631;0;56082;31122;0;48.2;26.8;0.0
23;2021-06-08;337;771;0;56419;31893;0;48.5;27.4;0.0
23;2021-06-09;275;650;0;56694;32543;0;48.8;28.0;0.0
23;2021-06-10;391;684;0;57085;33227;0;49.1;28.6;0.0
23;2021-06-11;377;797;0;57462;34024;0;49.4;29.3;0.0
23;2021-06-12;334;1211;0;57796;35235;0;49.7;30.3;0.0
23;2021-06-13;20;8;0;57816;35243;0;49.7;30.3;0.0
23;2021-06-14;213;555;0;58029;35798;0;49.9;30.8;0.0
23;2021-06-15;247;835;0;58276;36633;0;50.1;31.5;0.0
23;2021-06-16;354;554;0;58630;37187;0;50.4;32.0;0.0
23;2021-06-17;328;717;0;58958;37904;0;50.7;32.6;0.0
23;2021-06-18;370;726;0;59328;38630;0;51.0;33.2;0.0
23;2021-06-19;434;1196;0;59762;39826;0;51.4;34.3;0.0
23;2021-06-20;10;20;0;59772;39846;0;51.4;34.3;0.0
23;2021-06-21;204;583;0;59976;40429;0;51.6;34.8;0.0
23;2021-06-22;227;643;0;60203;41072;0;51.8;35.3;0.0
23;2021-06-23;232;639;0;60435;41711;0;52.0;35.9;0.0
23;2021-06-24;195;582;0;60630;42293;0;52.1;36.4;0.0
23;2021-06-25;291;753;0;60921;43046;0;52.4;37.0;0.0
23;2021-06-26;211;903;0;61132;43949;0;52.6;37.8;0.0
23;2021-06-27;4;15;0;61136;43964;0;52.6;37.8;0.0
23;2021-06-28;110;605;0;61246;44569;0;52.7;38.3;0.0
23;2021-06-29;216;793;0;61462;45362;0;52.9;39.0;0.0
23;2021-06-30;173;777;0;61635;46139;0;53.0;39.7;0.0
23;2021-07-01;183;800;0;61818;46939;0;53.2;40.4;0.0
23;2021-07-02;200;938;0;62018;47877;0;53.3;41.2;0.0
23;2021-07-03;238;828;0;62256;48705;0;53.5;41.9;0.0
23;2021-07-04;0;7;0;62256;48712;0;53.5;41.9;0.0
23;2021-07-05;157;706;0;62413;49418;0;53.7;42.5;0.0
23;2021-07-06;215;886;0;62628;50304;0;53.9;43.3;0.0
23;2021-07-07;221;784;0;62849;51088;0;54.1;43.9;0.0
23;2021-07-08;270;720;0;63119;51808;0;54.3;44.6;0.0
23;2021-07-09;284;993;0;63403;52801;0;54.5;45.4;0.0
23;2021-07-10;230;574;0;63633;53375;0;54.7;45.9;0.0
23;2021-07-11;10;11;0;63643;53386;0;54.7;45.9;0.0
23;2021-07-12;253;659;0;63896;54045;0;55.0;46.5;0.0
23;2021-07-13;486;846;0;64382;54891;0;55.4;47.2;0.0
23;2021-07-14;208;293;0;64590;55184;0;55.6;47.5;0.0
23;2021-07-15;470;753;0;65060;55937;0;56.0;48.1;0.0
23;2021-07-16;765;525;0;65825;56462;0;56.6;48.6;0.0
23;2021-07-17;222;443;0;66047;56905;0;56.8;48.9;0.0
23;2021-07-18;16;15;0;66063;56920;0;56.8;49.0;0.0
23;2021-07-19;668;618;0;66731;57538;0;57.4;49.5;0.0
23;2021-07-20;573;571;0;67304;58109;0;57.9;50.0;0.0
23;2021-07-21;676;616;0;67980;58725;0;58.5;50.5;0.0
23;2021-07-22;823;467;0;68803;59192;0;59.2;50.9;0.0
23;2021-07-23;813;546;0;69616;59738;0;59.9;51.4;0.0
23;2021-07-24;845;419;0;70461;60157;0;60.6;51.7;0.0
23;2021-07-25;20;27;0;70481;60184;0;60.6;51.8;0.0
23;2021-07-26;706;545;0;71187;60729;0;61.2;52.2;0.0
23;2021-07-27;873;444;0;72060;61173;0;62.0;52.6;0.0
23;2021-07-28;838;415;0;72898;61588;0;62.7;53.0;0.0
23;2021-07-29;958;380;0;73856;61968;0;63.5;53.3;0.0
23;2021-07-30;813;488;0;74669;62456;0;64.2;53.7;0.0
23;2021-07-31;910;284;0;75579;62740;0;65.0;54.0;0.0
23;2021-08-01;21;21;0;75600;62761;0;65.0;54.0;0.0
23;2021-08-02;596;495;0;76196;63256;0;65.5;54.4;0.0
23;2021-08-03;726;500;0;76922;63756;0;66.2;54.8;0.0
23;2021-08-04;613;290;0;77535;64046;0;66.7;55.1;0.0
23;2021-08-05;639;336;0;78174;64382;0;67.2;55.4;0.0
23;2021-08-06;435;474;0;78609;64856;0;67.6;55.8;0.0
23;2021-08-07;278;208;0;78887;65064;0;67.8;56.0;0.0
23;2021-08-08;130;36;0;79017;65100;0;68.0;56.0;0.0
23;2021-08-09;436;434;0;79453;65534;0;68.3;56.4;0.0
23;2021-08-10;447;655;0;79900;66189;0;68.7;56.9;0.0
23;2021-08-11;372;467;0;80272;66656;0;69.0;57.3;0.0
23;2021-08-12;484;594;0;80756;67250;0;69.5;57.8;0.0
23;2021-08-13;407;547;0;81163;67797;0;69.8;58.3;0.0
23;2021-08-14;259;366;0;81422;68163;0;70.0;58.6;0.0
23;2021-08-15;27;19;0;81449;68182;0;70.1;58.6;0.0
23;2021-08-16;279;655;0;81728;68837;0;70.3;59.2;0.0
23;2021-08-17;263;732;0;81991;69569;0;70.5;59.8;0.0
23;2021-08-18;196;624;0;82187;70193;0;70.7;60.4;0.0
23;2021-08-19;271;753;0;82458;70946;0;70.9;61.0;0.0
23;2021-08-20;222;666;0;82680;71612;0;71.1;61.6;0.0
23;2021-08-21;135;452;0;82815;72064;0;71.2;62.0;0.0
23;2021-08-22;50;39;0;82865;72103;0;71.3;62.0;0.0
23;2021-08-23;152;779;0;83017;72882;0;71.4;62.7;0.0
23;2021-08-24;265;850;0;83282;73732;0;71.6;63.4;0.0
23;2021-08-25;198;765;0;83480;74497;0;71.8;64.1;0.0
23;2021-08-26;210;699;0;83690;75196;0;72.0;64.7;0.0
23;2021-08-27;205;664;1;83895;75860;1;72.2;65.2;0.0
23;2021-08-28;206;429;0;84101;76289;1;72.3;65.6;0.0
23;2021-08-29;16;73;0;84117;76362;1;72.3;65.7;0.0
23;2021-08-30;189;617;11;84306;76979;12;72.5;66.2;0.0
23;2021-08-31;239;630;12;84545;77609;24;72.7;66.7;0.0
23;2021-09-01;164;391;37;84709;78000;61;72.9;67.1;0.1
23;2021-09-02;128;316;42;84837;78316;103;73.0;67.4;0.1
23;2021-09-03;210;518;69;85047;78834;172;73.1;67.8;0.1
23;2021-09-04;154;687;51;85201;79521;223;73.3;68.4;0.2
23;2021-09-05;5;9;2;85206;79530;225;73.3;68.4;0.2
23;2021-09-06;132;379;99;85338;79909;324;73.4;68.7;0.3
23;2021-09-07;91;368;169;85429;80277;493;73.5;69.0;0.4
23;2021-09-08;107;361;112;85536;80638;605;73.6;69.4;0.5
23;2021-09-09;110;319;74;85646;80957;679;73.7;69.6;0.6
23;2021-09-10;156;329;136;85802;81286;815;73.8;69.9;0.7
23;2021-09-11;99;211;22;85901;81497;837;73.9;70.1;0.7
23;2021-09-12;4;10;8;85905;81507;845;73.9;70.1;0.7
23;2021-09-13;111;319;80;86016;81826;925;74.0;70.4;0.8
23;2021-09-14;101;294;174;86117;82120;1099;74.1;70.6;0.9
23;2021-09-15;87;269;85;86204;82389;1184;74.1;70.9;1.0
23;2021-09-16;119;150;144;86323;82539;1328;74.2;71.0;1.1
23;2021-09-17;152;245;126;86475;82784;1454;74.4;71.2;1.3
23;2021-09-18;40;213;26;86515;82997;1480;74.4;71.4;1.3
23;2021-09-19;6;6;1;86521;83003;1481;74.4;71.4;1.3
23;2021-09-20;61;212;138;86582;83215;1619;74.5;71.6;1.4
23;2021-09-21;75;180;222;86657;83395;1841;74.5;71.7;1.6
23;2021-09-22;67;255;187;86724;83650;2028;74.6;71.9;1.7
23;2021-09-23;64;139;216;86788;83789;2244;74.6;72.1;1.9
23;2021-09-24;80;231;174;86868;84020;2418;74.7;72.3;2.1
23;2021-09-25;37;136;57;86905;84156;2475;74.7;72.4;2.1
23;2021-09-26;1;2;3;86906;84158;2478;74.7;72.4;2.1
23;2021-09-27;37;153;158;86943;84311;2636;74.8;72.5;2.3
23;2021-09-28;44;121;180;86987;84432;2816;74.8;72.6;2.4
23;2021-09-29;66;154;234;87053;84586;3050;74.9;72.7;2.6
23;2021-09-30;47;63;139;87100;84649;3189;74.9;72.8;2.7
23;2021-10-01;93;179;204;87193;84828;3393;75.0;73.0;2.9
23;2021-10-02;28;96;50;87221;84924;3443;75.0;73.0;3.0
23;2021-10-03;2;6;18;87223;84930;3461;75.0;73.0;3.0
23;2021-10-04;46;82;177;87269;85012;3638;75.1;73.1;3.1
23;2021-10-05;36;83;214;87305;85095;3852;75.1;73.2;3.3
23;2021-10-06;50;95;128;87355;85190;3980;75.1;73.3;3.4
23;2021-10-07;60;119;203;87415;85309;4183;75.2;73.4;3.6
23;2021-10-08;59;191;223;87474;85500;4406;75.2;73.5;3.8
23;2021-10-09;22;50;43;87496;85550;4449;75.3;73.6;3.8
23;2021-10-10;0;0;0;87496;85550;4449;75.3;73.6;3.8
23;2021-10-11;20;93;214;87516;85643;4663;75.3;73.7;4.0
23;2021-10-12;50;87;171;87566;85730;4834;75.3;73.7;4.2
23;2021-10-13;46;76;176;87612;85806;5010;75.4;73.8;4.3
23;2021-10-14;38;68;106;87650;85874;5116;75.4;73.9;4.4
23;2021-10-15;76;101;211;87726;85975;5327;75.5;73.9;4.6
23;2021-10-16;34;43;53;87760;86018;5380;75.5;74.0;4.6
23;2021-10-17;1;3;1;87761;86021;5381;75.5;74.0;4.6
23;2021-10-18;49;71;216;87810;86092;5597;75.5;74.0;4.8
23;2021-10-19;35;42;171;87845;86134;5768;75.6;74.1;5.0
23;2021-10-20;46;52;187;87891;86186;5955;75.6;74.1;5.1
23;2021-10-21;24;62;155;87915;86248;6110;75.6;74.2;5.3
23;2021-10-22;36;123;296;87951;86371;6406;75.6;74.3;5.5
23;2021-10-23;27;45;86;87978;86416;6492;75.7;74.3;5.6
23;2021-10-24;6;3;9;87984;86419;6501;75.7;74.3;5.6
23;2021-10-25;43;58;292;88027;86477;6793;75.7;74.4;5.8
23;2021-10-26;34;39;280;88061;86516;7073;75.7;74.4;6.1
23;2021-10-27;20;33;211;88081;86549;7284;75.8;74.4;6.3
23;2021-10-28;31;41;253;88112;86590;7537;75.8;74.5;6.5
23;2021-10-29;45;76;277;88157;86666;7814;75.8;74.5;6.7
23;2021-10-30;33;17;32;88190;86683;7846;75.8;74.6;6.7
23;2021-10-31;1;0;0;88191;86683;7846;75.9;74.6;6.7
23;2021-11-01;0;0;0;88191;86683;7846;75.9;74.6;6.7
23;2021-11-02;37;45;350;88228;86728;8196;75.9;74.6;7.0
23;2021-11-03;26;40;293;88254;86768;8489;75.9;74.6;7.3
23;2021-11-04;25;32;240;88279;86800;8729;75.9;74.7;7.5
23;2021-11-05;44;86;456;88323;86886;9185;76.0;74.7;7.9
23;2021-11-06;22;23;114;88345;86909;9299;76.0;74.7;8.0
23;2021-11-07;3;8;28;88348;86917;9327;76.0;74.8;8.0
23;2021-11-08;21;42;341;88369;86959;9668;76.0;74.8;8.3
23;2021-11-09;40;47;495;88409;87006;10163;76.0;74.8;8.7
23;2021-11-10;33;62;284;88442;87068;10447;76.1;74.9;9.0
23;2021-11-11;0;1;21;88442;87069;10468;76.1;74.9;9.0
23;2021-11-12;31;56;447;88473;87125;10915;76.1;74.9;9.4
23;2021-11-13;14;30;131;88487;87155;11046;76.1;75.0;9.5
23;2021-11-14;0;1;2;88487;87156;11048;76.1;75.0;9.5
23;2021-11-15;26;41;342;88513;87197;11390;76.1;75.0;9.8
23;2021-11-16;25;48;594;88538;87245;11984;76.1;75.0;10.3
23;2021-11-17;30;39;385;88568;87284;12369;76.2;75.1;10.6
23;2021-11-18;39;35;484;88607;87319;12853;76.2;75.1;11.1
23;2021-11-19;49;69;573;88656;87388;13426;76.3;75.2;11.5
23;2021-11-20;19;29;190;88675;87417;13616;76.3;75.2;11.7
23;2021-11-21;0;2;12;88675;87419;13628;76.3;75.2;11.7
23;2021-11-22;32;17;392;88707;87436;14020;76.3;75.2;12.1
23;2021-11-23;40;34;673;88747;87470;14693;76.3;75.2;12.6
23;2021-11-24;49;36;598;88796;87506;15291;76.4;75.3;13.2
23;2021-11-25;35;20;486;88831;87526;15777;76.4;75.3;13.6
23;2021-11-26;60;56;806;88891;87582;16583;76.5;75.3;14.3
23;2021-11-27;38;36;545;88929;87618;17128;76.5;75.4;14.7
23;2021-11-28;5;1;19;88934;87619;17147;76.5;75.4;14.7
23;2021-11-29;14;21;535;88948;87640;17682;76.5;75.4;15.2
23;2021-11-30;46;47;987;88994;87687;18669;76.5;75.4;16.1
23;2021-12-01;49;34;1175;89043;87721;19844;76.6;75.4;17.1
23;2021-12-02;30;18;1220;89073;87739;21064;76.6;75.5;18.1
23;2021-12-03;42;27;1167;89115;87766;22231;76.6;75.5;19.1
23;2021-12-04;32;27;947;89147;87793;23178;76.7;75.5;19.9
23;2021-12-05;8;0;256;89155;87793;23434;76.7;75.5;20.2
23;2021-12-06;18;24;677;89173;87817;24111;76.7;75.5;20.7
23;2021-12-07;32;20;1273;89205;87837;25384;76.7;75.5;21.8
23;2021-12-08;44;39;1389;89249;87876;26773;76.8;75.6;23.0
23;2021-12-09;27;34;1255;89276;87910;28028;76.8;75.6;24.1
23;2021-12-10;38;45;1391;89314;87955;29419;76.8;75.6;25.3
23;2021-12-11;41;29;1314;89355;87984;30733;76.9;75.7;26.4
23;2021-12-12;4;4;68;89359;87988;30801;76.9;75.7;26.5
23;2021-12-13;21;25;1090;89380;88013;31891;76.9;75.7;27.4
23;2021-12-14;57;39;1789;89437;88052;33680;76.9;75.7;29.0
23;2021-12-15;30;41;1326;89467;88093;35006;76.9;75.8;30.1
23;2021-12-16;56;54;1278;89523;88147;36284;77.0;75.8;31.2
24;2020-12-27;0;0;0;0;0;0;0.0;0.0;0.0
24;2020-12-28;0;0;0;0;0;0;0.0;0.0;0.0
24;2020-12-29;2;0;0;2;0;0;0.0;0.0;0.0
24;2020-12-30;1;0;0;3;0;0;0.0;0.0;0.0
24;2020-12-31;0;0;0;3;0;0;0.0;0.0;0.0
24;2021-01-01;1;0;0;4;0;0;0.0;0.0;0.0
24;2021-01-02;0;0;0;4;0;0;0.0;0.0;0.0
24;2021-01-03;1;0;0;5;0;0;0.0;0.0;0.0
24;2021-01-04;1;0;0;6;0;0;0.0;0.0;0.0
24;2021-01-05;0;0;0;6;0;0;0.0;0.0;0.0
24;2021-01-06;4;0;0;10;0;0;0.0;0.0;0.0
24;2021-01-07;201;0;0;211;0;0;0.1;0.0;0.0
24;2021-01-08;284;0;0;495;0;0;0.1;0.0;0.0
24;2021-01-09;184;13;0;679;13;0;0.2;0.0;0.0
24;2021-01-10;36;0;0;715;13;0;0.2;0.0;0.0
24;2021-01-11;258;0;0;973;13;0;0.2;0.0;0.0
24;2021-01-12;309;0;0;1282;13;0;0.3;0.0;0.0
24;2021-01-13;263;1;0;1545;14;0;0.4;0.0;0.0
24;2021-01-14;982;24;0;2527;38;0;0.6;0.0;0.0
24;2021-01-15;601;6;0;3128;44;0;0.8;0.0;0.0
24;2021-01-16;92;0;0;3220;44;0;0.8;0.0;0.0
24;2021-01-17;4;1;0;3224;45;0;0.8;0.0;0.0
24;2021-01-18;348;2;0;3572;47;0;0.9;0.0;0.0
24;2021-01-19;512;2;0;4084;49;0;1.0;0.0;0.0
24;2021-01-20;585;0;0;4669;49;0;1.1;0.0;0.0
24;2021-01-21;690;5;0;5359;54;0;1.3;0.0;0.0
24;2021-01-22;585;1;0;5944;55;0;1.5;0.0;0.0
24;2021-01-23;163;1;0;6107;56;0;1.5;0.0;0.0
24;2021-01-24;13;0;0;6120;56;0;1.5;0.0;0.0
24;2021-01-25;488;0;0;6608;56;0;1.6;0.0;0.0
24;2021-01-26;680;64;0;7288;120;0;1.8;0.0;0.0
24;2021-01-27;1162;14;0;8450;134;0;2.1;0.0;0.0
24;2021-01-28;1000;115;0;9450;249;0;2.3;0.1;0.0
24;2021-01-29;912;140;0;10362;389;0;2.5;0.1;0.0
24;2021-01-30;268;1;0;10630;390;0;2.6;0.1;0.0
24;2021-01-31;10;4;0;10640;394;0;2.6;0.1;0.0
24;2021-02-01;397;175;0;11037;569;0;2.7;0.1;0.0
24;2021-02-02;624;323;0;11661;892;0;2.9;0.2;0.0
24;2021-02-03;648;487;0;12309;1379;0;3.0;0.3;0.0
24;2021-02-04;985;427;0;13294;1806;0;3.3;0.4;0.0
24;2021-02-05;667;418;0;13961;2224;0;3.4;0.5;0.0
24;2021-02-06;143;35;0;14104;2259;0;3.5;0.6;0.0
24;2021-02-07;31;3;0;14135;2262;0;3.5;0.6;0.0
24;2021-02-08;330;246;0;14465;2508;0;3.5;0.6;0.0
24;2021-02-09;480;252;0;14945;2760;0;3.7;0.7;0.0
24;2021-02-10;429;188;0;15374;2948;0;3.8;0.7;0.0
24;2021-02-11;589;564;0;15963;3512;0;3.9;0.9;0.0
24;2021-02-12;515;396;0;16478;3908;0;4.0;1.0;0.0
24;2021-02-13;199;51;0;16677;3959;0;4.1;1.0;0.0
24;2021-02-14;90;8;0;16767;3967;0;4.1;1.0;0.0
24;2021-02-15;200;275;0;16967;4242;0;4.2;1.0;0.0
24;2021-02-16;338;540;0;17305;4782;0;4.2;1.2;0.0
24;2021-02-17;547;827;0;17852;5609;0;4.4;1.4;0.0
24;2021-02-18;435;771;0;18287;6380;0;4.5;1.6;0.0
24;2021-02-19;473;677;0;18760;7057;0;4.6;1.7;0.0
24;2021-02-20;164;151;0;18924;7208;0;4.6;1.8;0.0
24;2021-02-21;107;3;0;19031;7211;0;4.7;1.8;0.0
24;2021-02-22;447;517;0;19478;7728;0;4.8;1.9;0.0
24;2021-02-23;546;677;0;20024;8405;0;4.9;2.1;0.0
24;2021-02-24;534;795;0;20558;9200;0;5.0;2.3;0.0
24;2021-02-25;754;881;0;21312;10081;0;5.2;2.5;0.0
24;2021-02-26;1010;929;0;22322;11010;0;5.5;2.7;0.0
24;2021-02-27;384;265;0;22706;11275;0;5.6;2.8;0.0
24;2021-02-28;19;14;0;22725;11289;0;5.6;2.8;0.0
24;2021-03-01;347;412;0;23072;11701;0;5.6;2.9;0.0
24;2021-03-02;559;477;0;23631;12178;0;5.8;3.0;0.0
24;2021-03-03;678;368;0;24309;12546;0;6.0;3.1;0.0
24;2021-03-04;944;546;0;25253;13092;0;6.2;3.2;0.0
24;2021-03-05;1059;576;0;26312;13668;0;6.4;3.3;0.0
24;2021-03-06;1166;146;0;27478;13814;0;6.7;3.4;0.0
24;2021-03-07;201;62;0;27679;13876;0;6.8;3.4;0.0
24;2021-03-08;613;283;0;28292;14159;0;6.9;3.5;0.0
24;2021-03-09;1172;462;0;29464;14621;0;7.2;3.6;0.0
24;2021-03-10;1194;479;0;30658;15100;0;7.5;3.7;0.0
24;2021-03-11;1701;497;0;32359;15597;0;7.9;3.8;0.0
24;2021-03-12;2185;459;0;34544;16056;0;8.5;3.9;0.0
24;2021-03-13;1424;187;0;35968;16243;0;8.8;4.0;0.0
24;2021-03-14;132;95;0;36100;16338;0;8.8;4.0;0.0
24;2021-03-15;1031;196;0;37131;16534;0;9.1;4.0;0.0
24;2021-03-16;1221;237;0;38352;16771;0;9.4;4.1;0.0
24;2021-03-17;1237;284;0;39589;17055;0;9.7;4.2;0.0
24;2021-03-18;1138;540;0;40727;17595;0;10.0;4.3;0.0
24;2021-03-19;1328;529;0;42055;18124;0;10.3;4.4;0.0
24;2021-03-20;1002;155;0;43057;18279;0;10.5;4.5;0.0
24;2021-03-21;29;12;0;43086;18291;0;10.6;4.5;0.0
24;2021-03-22;1367;429;0;44453;18720;0;10.9;4.6;0.0
24;2021-03-23;1986;396;0;46439;19116;0;11.4;4.7;0.0
24;2021-03-24;1916;384;0;48355;19500;0;11.8;4.8;0.0
24;2021-03-25;2095;510;0;50450;20010;0;12.4;4.9;0.0
24;2021-03-26;2408;297;0;52858;20307;0;12.9;5.0;0.0
24;2021-03-27;1383;44;0;54241;20351;0;13.3;5.0;0.0
24;2021-03-28;74;8;0;54315;20359;0;13.3;5.0;0.0
24;2021-03-29;1720;354;0;56035;20713;0;13.7;5.1;0.0
24;2021-03-30;2488;422;0;58523;21135;0;14.3;5.2;0.0
24;2021-03-31;2183;327;0;60706;21462;0;14.9;5.3;0.0
24;2021-04-01;2281;347;0;62987;21809;0;15.4;5.3;0.0
24;2021-04-02;2131;454;0;65118;22263;0;15.9;5.5;0.0
24;2021-04-03;1331;153;0;66449;22416;0;16.3;5.5;0.0
24;2021-04-04;73;7;0;66522;22423;0;16.3;5.5;0.0
24;2021-04-05;890;68;0;67412;22491;0;16.5;5.5;0.0
24;2021-04-06;2277;786;0;69689;23277;0;17.1;5.7;0.0
24;2021-04-07;2664;712;0;72353;23989;0;17.7;5.9;0.0
24;2021-04-08;2970;1031;0;75323;25020;0;18.4;6.1;0.0
24;2021-04-09;3338;1064;0;78661;26084;0;19.3;6.4;0.0
24;2021-04-10;2480;357;0;81141;26441;0;19.9;6.5;0.0
24;2021-04-11;1016;24;0;82157;26465;0;20.1;6.5;0.0
24;2021-04-12;2377;899;0;84534;27364;0;20.7;6.7;0.0
24;2021-04-13;2805;1239;0;87339;28603;0;21.4;7.0;0.0
24;2021-04-14;2908;1204;0;90247;29807;0;22.1;7.3;0.0
24;2021-04-15;2813;1175;0;93060;30982;0;22.8;7.6;0.0
24;2021-04-16;3229;1049;0;96289;32031;0;23.6;7.8;0.0
24;2021-04-17;2245;451;0;98534;32482;0;24.1;8.0;0.0
24;2021-04-18;437;3;0;98971;32485;0;24.2;8.0;0.0
24;2021-04-19;1636;1120;0;100607;33605;0;24.6;8.2;0.0
24;2021-04-20;2329;1542;0;102936;35147;0;25.2;8.6;0.0
24;2021-04-21;2348;1486;0;105284;36633;0;25.8;9.0;0.0
24;2021-04-22;2235;1399;0;107519;38032;0;26.3;9.3;0.0
24;2021-04-23;1986;1443;0;109505;39475;0;26.8;9.7;0.0
24;2021-04-24;738;736;0;110243;40211;0;27.0;9.8;0.0
24;2021-04-25;66;10;0;110309;40221;0;27.0;9.8;0.0
24;2021-04-26;1417;1500;0;111726;41721;0;27.4;10.2;0.0
24;2021-04-27;1917;1922;0;113643;43643;0;27.8;10.7;0.0
24;2021-04-28;1673;1949;0;115316;45592;0;28.2;11.2;0.0
24;2021-04-29;1824;1943;0;117140;47535;0;28.7;11.6;0.0
24;2021-04-30;2331;1775;0;119471;49310;0;29.3;12.1;0.0
24;2021-05-01;1916;1010;0;121387;50320;0;29.7;12.3;0.0
24;2021-05-02;1835;207;0;123222;50527;0;30.2;12.4;0.0
24;2021-05-03;1674;1782;0;124896;52309;0;30.6;12.8;0.0
24;2021-05-04;2396;2271;0;127292;54580;0;31.2;13.4;0.0
24;2021-05-05;2051;2671;0;129343;57251;0;31.7;14.0;0.0
24;2021-05-06;2145;2713;0;131488;59964;0;32.2;14.7;0.0
24;2021-05-07;2450;2743;0;133938;62707;0;32.8;15.4;0.0
24;2021-05-08;1338;1100;0;135276;63807;0;33.1;15.6;0.0
24;2021-05-09;1113;821;0;136389;64628;0;33.4;15.8;0.0
24;2021-05-10;1367;2541;0;137756;67169;0;33.7;16.4;0.0
24;2021-05-11;2234;2683;0;139990;69852;0;34.3;17.1;0.0
24;2021-05-12;2058;2299;0;142048;72151;0;34.8;17.7;0.0
24;2021-05-13;1591;1168;0;143639;73319;0;35.2;18.0;0.0
24;2021-05-14;2574;1397;0;146213;74716;0;35.8;18.3;0.0
24;2021-05-15;2073;867;0;148286;75583;0;36.3;18.5;0.0
24;2021-05-16;1095;351;0;149381;75934;0;36.6;18.6;0.0
24;2021-05-17;2295;1291;0;151676;77225;0;37.1;18.9;0.0
24;2021-05-18;2606;1799;0;154282;79024;0;37.8;19.3;0.0
24;2021-05-19;2397;1366;0;156679;80390;0;38.4;19.7;0.0
24;2021-05-20;2600;1538;0;159279;81928;0;39.0;20.1;0.0
24;2021-05-21;2555;1379;0;161834;83307;0;39.6;20.4;0.0
24;2021-05-22;1696;455;0;163530;83762;0;40.0;20.5;0.0
24;2021-05-23;817;64;0;164347;83826;0;40.2;20.5;0.0
24;2021-05-24;1367;304;0;165714;84130;0;40.6;20.6;0.0
24;2021-05-25;2253;1411;0;167967;85541;0;41.1;20.9;0.0
24;2021-05-26;2171;1344;0;170138;86885;0;41.7;21.3;0.0
24;2021-05-27;1899;2135;0;172037;89020;0;42.1;21.8;0.0
24;2021-05-28;2182;2028;0;174219;91048;0;42.7;22.3;0.0
24;2021-05-29;1119;2062;0;175338;93110;0;42.9;22.8;0.0
24;2021-05-30;1149;163;0;176487;93273;0;43.2;22.8;0.0
24;2021-05-31;1732;1415;0;178219;94688;0;43.6;23.2;0.0
24;2021-06-01;2634;2005;0;180853;96693;0;44.3;23.7;0.0
24;2021-06-02;2597;1883;0;183450;98576;0;44.9;24.1;0.0
24;2021-06-03;2281;1549;0;185731;100125;0;45.5;24.5;0.0
24;2021-06-04;2373;2021;0;188104;102146;0;46.1;25.0;0.0
24;2021-06-05;1822;1400;0;189926;103546;0;46.5;25.4;0.0
24;2021-06-06;690;221;0;190616;103767;0;46.7;25.4;0.0
24;2021-06-07;1464;1650;0;192080;105417;0;47.0;25.8;0.0
24;2021-06-08;1677;2110;0;193757;107527;0;47.4;26.3;0.0
24;2021-06-09;1421;1729;0;195178;109256;0;47.8;26.8;0.0
24;2021-06-10;1700;1947;0;196878;111203;0;48.2;27.2;0.0
24;2021-06-11;1375;2319;0;198253;113522;0;48.5;27.8;0.0
24;2021-06-12;1098;2507;0;199351;116029;0;48.8;28.4;0.0
24;2021-06-13;1053;882;0;200404;116911;0;49.1;28.6;0.0
24;2021-06-14;1164;2105;0;201568;119016;0;49.4;29.1;0.0
24;2021-06-15;1542;3244;0;203110;122260;0;49.7;29.9;0.0
24;2021-06-16;1717;2867;0;204827;125127;0;50.2;30.6;0.0
24;2021-06-17;1593;2296;0;206420;127423;0;50.5;31.2;0.0
24;2021-06-18;1496;3034;0;207916;130457;0;50.9;31.9;0.0
24;2021-06-19;1202;1609;0;209118;132066;0;51.2;32.3;0.0
24;2021-06-20;470;466;0;209588;132532;0;51.3;32.5;0.0
24;2021-06-21;919;2058;0;210507;134590;0;51.5;33.0;0.0
24;2021-06-22;1349;2646;0;211856;137236;0;51.9;33.6;0.0
24;2021-06-23;1354;2520;0;213210;139756;0;52.2;34.2;0.0
24;2021-06-24;1174;2041;0;214384;141797;0;52.5;34.7;0.0
24;2021-06-25;1023;3010;0;215407;144807;0;52.7;35.5;0.0
24;2021-06-26;803;2158;0;216210;146965;0;52.9;36.0;0.0
24;2021-06-27;385;924;0;216595;147889;0;53.0;36.2;0.0
24;2021-06-28;798;2660;0;217393;150549;0;53.2;36.9;0.0
24;2021-06-29;936;3028;0;218329;153577;0;53.5;37.6;0.0
24;2021-06-30;1078;2651;0;219407;156228;0;53.7;38.3;0.0
24;2021-07-01;1146;2455;0;220553;158683;0;54.0;38.9;0.0
24;2021-07-02;1087;2839;0;221640;161522;0;54.3;39.6;0.0
24;2021-07-03;753;1863;0;222393;163385;0;54.5;40.0;0.0
24;2021-07-04;357;908;0;222750;164293;0;54.5;40.2;0.0
24;2021-07-05;758;2359;0;223508;166652;0;54.7;40.8;0.0
24;2021-07-06;892;3413;0;224400;170065;0;54.9;41.6;0.0
24;2021-07-07;1026;3065;0;225426;173130;0;55.2;42.4;0.0
24;2021-07-08;1345;2155;0;226771;175285;0;55.5;42.9;0.0
24;2021-07-09;1114;3183;0;227885;178468;0;55.8;43.7;0.0
24;2021-07-10;486;1887;0;228371;180355;0;55.9;44.2;0.0
24;2021-07-11;538;983;0;228909;181338;0;56.1;44.4;0.0
24;2021-07-12;865;2573;0;229774;183911;0;56.3;45.0;0.0
24;2021-07-13;1324;3233;0;231098;187144;0;56.6;45.8;0.0
24;2021-07-14;629;1066;0;231727;188210;0;56.7;46.1;0.0
24;2021-07-15;1619;2726;0;233346;190936;0;57.1;46.8;0.0
24;2021-07-16;2103;2536;0;235449;193472;0;57.7;47.4;0.0
24;2021-07-17;1376;2092;0;236825;195564;0;58.0;47.9;0.0
24;2021-07-18;645;806;0;237470;196370;0;58.1;48.1;0.0
24;2021-07-19;1555;2214;0;239025;198584;0;58.5;48.6;0.0
24;2021-07-20;2003;2500;0;241028;201084;0;59.0;49.2;0.0
24;2021-07-21;1925;2310;0;242953;203394;0;59.5;49.8;0.0
24;2021-07-22;2492;2436;0;245445;205830;0;60.1;50.4;0.0
24;2021-07-23;2311;2537;0;247756;208367;0;60.7;51.0;0.0
24;2021-07-24;1735;1528;0;249491;209895;0;61.1;51.4;0.0
24;2021-07-25;796;760;0;250287;210655;0;61.3;51.6;0.0
24;2021-07-26;1552;2005;0;251839;212660;0;61.7;52.1;0.0
24;2021-07-27;2813;2215;0;254652;214875;0;62.4;52.6;0.0
24;2021-07-28;2644;1860;0;257296;216735;0;63.0;53.1;0.0
24;2021-07-29;2982;2164;0;260278;218899;0;63.7;53.6;0.0
24;2021-07-30;2541;1916;0;262819;220815;0;64.4;54.1;0.0
24;2021-07-31;1580;1464;0;264399;222279;0;64.7;54.4;0.0
24;2021-08-01;1018;587;0;265417;222866;0;65.0;54.6;0.0
24;2021-08-02;1947;1581;0;267364;224447;0;65.5;55.0;0.0
24;2021-08-03;2737;1826;0;270101;226273;0;66.1;55.4;0.0
24;2021-08-04;2884;1468;0;272985;227741;0;66.8;55.8;0.0
24;2021-08-05;2851;1348;0;275836;229089;0;67.5;56.1;0.0
24;2021-08-06;2391;1463;0;278227;230552;0;68.1;56.5;0.0
24;2021-08-07;1723;1039;0;279950;231591;0;68.5;56.7;0.0
24;2021-08-08;1005;562;0;280955;232153;0;68.8;56.8;0.0
24;2021-08-09;1583;1339;0;282538;233492;0;69.2;57.2;0.0
24;2021-08-10;2204;1748;0;284742;235240;0;69.7;57.6;0.0
24;2021-08-11;2128;1610;0;286870;236850;0;70.2;58.0;0.0
24;2021-08-12;1873;1867;0;288743;238717;0;70.7;58.5;0.0
24;2021-08-13;1536;1584;0;290279;240301;0;71.1;58.8;0.0
24;2021-08-14;1095;1166;0;291374;241467;0;71.3;59.1;0.0
24;2021-08-15;624;488;0;291998;241955;0;71.5;59.2;0.0
24;2021-08-16;1138;1610;0;293136;243565;0;71.8;59.6;0.0
24;2021-08-17;1541;2031;0;294677;245596;0;72.2;60.1;0.0
24;2021-08-18;1412;1784;0;296089;247380;0;72.5;60.6;0.0
24;2021-08-19;1110;2461;0;297199;249841;0;72.8;61.2;0.0
24;2021-08-20;1092;2412;0;298291;252253;0;73.0;61.8;0.0
24;2021-08-21;783;1564;0;299074;253817;0;73.2;62.2;0.0
24;2021-08-22;290;974;0;299364;254791;0;73.3;62.4;0.0
24;2021-08-23;701;2060;0;300065;256851;0;73.5;62.9;0.0
24;2021-08-24;833;2355;0;300898;259206;0;73.7;63.5;0.0
24;2021-08-25;818;2309;0;301716;261515;0;73.9;64.0;0.0
24;2021-08-26;750;2713;0;302466;264228;0;74.1;64.7;0.0
24;2021-08-27;824;2813;0;303290;267041;0;74.3;65.4;0.0
24;2021-08-28;505;1804;0;303795;268845;0;74.4;65.8;0.0
24;2021-08-29;157;897;0;303952;269742;0;74.4;66.0;0.0
24;2021-08-30;431;2066;16;304383;271808;16;74.5;66.6;0.0
24;2021-08-31;634;2495;55;305017;274303;71;74.7;67.2;0.0
24;2021-09-01;663;2285;100;305680;276588;171;74.8;67.7;0.0
24;2021-09-02;486;1859;121;306166;278447;292;75.0;68.2;0.1
24;2021-09-03;576;2152;180;306742;280599;472;75.1;68.7;0.1
24;2021-09-04;365;1849;63;307107;282448;535;75.2;69.2;0.1
24;2021-09-05;229;849;44;307336;283297;579;75.3;69.4;0.1
24;2021-09-06;324;1465;162;307660;284762;741;75.3;69.7;0.2
24;2021-09-07;485;1676;260;308145;286438;1001;75.5;70.1;0.2
24;2021-09-08;428;1773;172;308573;288211;1173;75.6;70.6;0.3
24;2021-09-09;367;1119;231;308940;289330;1404;75.6;70.8;0.3
24;2021-09-10;408;1645;205;309348;290975;1609;75.7;71.2;0.4
24;2021-09-11;319;1571;70;309667;292546;1679;75.8;71.6;0.4
24;2021-09-12;93;314;60;309760;292860;1739;75.8;71.7;0.4
24;2021-09-13;316;981;221;310076;293841;1960;75.9;72.0;0.5
24;2021-09-14;442;916;306;310518;294757;2266;76.0;72.2;0.6
24;2021-09-15;450;1290;398;310968;296047;2664;76.1;72.5;0.7
24;2021-09-16;290;889;269;311258;296936;2933;76.2;72.7;0.7
24;2021-09-17;413;1047;331;311671;297983;3264;76.3;73.0;0.8
24;2021-09-18;302;1070;152;311973;299053;3416;76.4;73.2;0.8
24;2021-09-19;52;343;34;312025;299396;3450;76.4;73.3;0.8
24;2021-09-20;158;560;254;312183;299956;3704;76.4;73.4;0.9
24;2021-09-21;366;442;436;312549;300398;4140;76.5;73.6;1.0
24;2021-09-22;225;738;440;312774;301136;4580;76.6;73.7;1.1
24;2021-09-23;160;410;414;312934;301546;4994;76.6;73.8;1.2
24;2021-09-24;251;823;369;313185;302369;5363;76.7;74.0;1.3
24;2021-09-25;209;583;120;313394;302952;5483;76.7;74.2;1.3
24;2021-09-26;23;92;14;313417;303044;5497;76.7;74.2;1.3
24;2021-09-27;175;444;312;313592;303488;5809;76.8;74.3;1.4
24;2021-09-28;212;340;586;313804;303828;6395;76.8;74.4;1.6
24;2021-09-29;208;577;392;314012;304405;6787;76.9;74.5;1.7
24;2021-09-30;234;448;480;314246;304853;7267;76.9;74.6;1.8
24;2021-10-01;254;512;406;314500;305365;7673;77.0;74.8;1.9
24;2021-10-02;191;485;177;314691;305850;7850;77.1;74.9;1.9
24;2021-10-03;16;43;4;314707;305893;7854;77.1;74.9;1.9
24;2021-10-04;158;302;316;314865;306195;8170;77.1;75.0;2.0
24;2021-10-05;117;362;338;314982;306557;8508;77.1;75.1;2.1
24;2021-10-06;219;470;589;315201;307027;9097;77.2;75.2;2.2
24;2021-10-07;117;229;416;315318;307256;9513;77.2;75.2;2.3
24;2021-10-08;196;443;553;315514;307699;10066;77.3;75.3;2.5
24;2021-10-09;166;427;413;315680;308126;10479;77.3;75.4;2.6
24;2021-10-10;20;26;18;315700;308152;10497;77.3;75.5;2.6
24;2021-10-11;98;217;398;315798;308369;10895;77.3;75.5;2.7
24;2021-10-12;144;392;708;315942;308761;11603;77.4;75.6;2.8
24;2021-10-13;144;297;557;316086;309058;12160;77.4;75.7;3.0
24;2021-10-14;129;214;526;316215;309272;12686;77.4;75.7;3.1
24;2021-10-15;271;417;1021;316486;309689;13707;77.5;75.8;3.4
24;2021-10-16;173;327;304;316659;310016;14011;77.5;75.9;3.4
24;2021-10-17;14;30;11;316673;310046;14022;77.5;75.9;3.4
24;2021-10-18;105;154;420;316778;310200;14442;77.6;76.0;3.5
24;2021-10-19;130;250;667;316908;310450;15109;77.6;76.0;3.7
24;2021-10-20;132;242;678;317040;310692;15787;77.6;76.1;3.9
24;2021-10-21;93;242;539;317133;310934;16326;77.7;76.1;4.0
24;2021-10-22;145;221;857;317278;311155;17183;77.7;76.2;4.2
24;2021-10-23;98;209;371;317376;311364;17554;77.7;76.2;4.3
24;2021-10-24;10;12;9;317386;311376;17563;77.7;76.2;4.3
24;2021-10-25;95;133;684;317481;311509;18247;77.7;76.3;4.5
24;2021-10-26;86;132;642;317567;311641;18889;77.8;76.3;4.6
24;2021-10-27;134;184;836;317701;311825;19725;77.8;76.4;4.8
24;2021-10-28;82;143;685;317783;311968;20410;77.8;76.4;5.0
24;2021-10-29;142;190;1043;317925;312158;21453;77.8;76.4;5.3
24;2021-10-30;81;169;385;318006;312327;21838;77.9;76.5;5.3
24;2021-10-31;10;14;28;318016;312341;21866;77.9;76.5;5.4
24;2021-11-01;18;14;90;318034;312355;21956;77.9;76.5;5.4
24;2021-11-02;97;109;771;318131;312464;22727;77.9;76.5;5.6
24;2021-11-03;115;175;962;318246;312639;23689;77.9;76.6;5.8
24;2021-11-04;90;121;868;318336;312760;24557;77.9;76.6;6.0
24;2021-11-05;175;219;1217;318511;312979;25774;78.0;76.6;6.3
24;2021-11-06;101;193;633;318612;313172;26407;78.0;76.7;6.5
24;2021-11-07;11;12;55;318623;313184;26462;78.0;76.7;6.5
24;2021-11-08;77;129;877;318700;313313;27339;78.0;76.7;6.7
24;2021-11-09;116;187;1505;318816;313500;28844;78.1;76.8;7.1
24;2021-11-10;125;172;1504;318941;313672;30348;78.1;76.8;7.4
24;2021-11-11;33;37;256;318974;313709;30604;78.1;76.8;7.5
24;2021-11-12;94;168;1300;319068;313877;31904;78.1;76.9;7.8
24;2021-11-13;85;154;769;319153;314031;32673;78.1;76.9;8.0
24;2021-11-14;7;23;60;319160;314054;32733;78.2;76.9;8.0
24;2021-11-15;68;116;1068;319228;314170;33801;78.2;76.9;8.3
24;2021-11-16;100;137;1924;319328;314307;35725;78.2;77.0;8.7
24;2021-11-17;112;140;1654;319440;314447;37379;78.2;77.0;9.2
24;2021-11-18;81;93;1576;319521;314540;38955;78.2;77.0;9.5
24;2021-11-19;171;180;2207;319692;314720;41162;78.3;77.1;10.1
24;2021-11-20;128;129;1150;319820;314849;42312;78.3;77.1;10.4
24;2021-11-21;19;21;198;319839;314870;42510;78.3;77.1;10.4
24;2021-11-22;108;78;1355;319947;314948;43865;78.3;77.1;10.7
24;2021-11-23;127;131;2108;320074;315079;45973;78.4;77.2;11.3
24;2021-11-24;151;140;2083;320225;315219;48056;78.4;77.2;11.8
24;2021-11-25;122;109;2116;320347;315328;50172;78.4;77.2;12.3
24;2021-11-26;153;170;2972;320500;315498;53144;78.5;77.3;13.0
24;2021-11-27;140;147;1761;320640;315645;54905;78.5;77.3;13.4
24;2021-11-28;27;18;711;320667;315663;55616;78.5;77.3;13.6
24;2021-11-29;104;118;2508;320771;315781;58124;78.5;77.3;14.2
24;2021-11-30;139;130;3635;320910;315911;61759;78.6;77.4;15.1
24;2021-12-01;150;118;3500;321060;316029;65259;78.6;77.4;16.0
24;2021-12-02;110;91;3799;321170;316120;69058;78.6;77.4;16.9
24;2021-12-03;145;163;3968;321315;316283;73026;78.7;77.4;17.9
24;2021-12-04;94;108;2540;321409;316391;75566;78.7;77.5;18.5
24;2021-12-05;32;22;1000;321441;316413;76566;78.7;77.5;18.7
24;2021-12-06;99;89;3135;321540;316502;79701;78.7;77.5;19.5
24;2021-12-07;134;114;4713;321674;316616;84414;78.8;77.5;20.7
24;2021-12-08;144;117;4209;321818;316733;88623;78.8;77.6;21.7
24;2021-12-09;124;128;4145;321942;316861;92768;78.8;77.6;22.7
24;2021-12-10;147;148;4618;322089;317009;97386;78.9;77.6;23.8
24;2021-12-11;111;101;2867;322200;317110;100253;78.9;77.6;24.5
24;2021-12-12;34;31;1045;322234;317141;101298;78.9;77.7;24.8
24;2021-12-13;124;110;4150;322358;317251;105448;78.9;77.7;25.8
24;2021-12-14;149;145;5866;322507;317396;111314;79.0;77.7;27.3
24;2021-12-15;131;167;5271;322638;317563;116585;79.0;77.8;28.5
24;2021-12-16;142;154;5537;322780;317717;122122;79.0;77.8;29.9
25;2020-12-27;0;0;0;0;0;0;0.0;0.0;0.0
25;2020-12-28;0;0;0;0;0;0;0.0;0.0;0.0
25;2020-12-29;0;0;0;0;0;0;0.0;0.0;0.0
25;2020-12-30;0;0;0;0;0;0;0.0;0.0;0.0
25;2020-12-31;2;0;0;2;0;0;0.0;0.0;0.0
25;2021-01-01;0;0;0;2;0;0;0.0;0.0;0.0
25;2021-01-02;2;0;0;4;0;0;0.0;0.0;0.0
25;2021-01-03;0;0;0;4;0;0;0.0;0.0;0.0
25;2021-01-04;3;0;0;7;0;0;0.0;0.0;0.0
25;2021-01-05;1;0;0;8;0;0;0.0;0.0;0.0
25;2021-01-06;86;1;0;94;1;0;0.0;0.0;0.0
25;2021-01-07;222;1;0;316;2;0;0.1;0.0;0.0
25;2021-01-08;393;1;0;709;3;0;0.1;0.0;0.0
25;2021-01-09;110;0;0;819;3;0;0.2;0.0;0.0
25;2021-01-10;1;0;0;820;3;0;0.2;0.0;0.0
25;2021-01-11;532;6;0;1352;9;0;0.3;0.0;0.0
25;2021-01-12;730;2;0;2082;11;0;0.4;0.0;0.0
25;2021-01-13;669;11;0;2751;22;0;0.5;0.0;0.0
25;2021-01-14;923;19;0;3674;41;0;0.7;0.0;0.0
25;2021-01-15;824;8;0;4498;49;0;0.8;0.0;0.0
25;2021-01-16;222;1;0;4720;50;0;0.9;0.0;0.0
25;2021-01-17;102;0;0;4822;50;0;0.9;0.0;0.0
25;2021-01-18;1277;6;0;6099;56;0;1.1;0.0;0.0
25;2021-01-19;1400;3;0;7499;59;0;1.4;0.0;0.0
25;2021-01-20;1480;7;0;8979;66;0;1.7;0.0;0.0
25;2021-01-21;1845;5;0;10824;71;0;2.0;0.0;0.0
25;2021-01-22;1476;8;0;12300;79;0;2.3;0.0;0.0
25;2021-01-23;488;1;0;12788;80;0;2.4;0.0;0.0
25;2021-01-24;113;0;0;12901;80;0;2.4;0.0;0.0
25;2021-01-25;1004;2;0;13905;82;0;2.6;0.0;0.0
25;2021-01-26;1428;41;0;15333;123;0;2.8;0.0;0.0
25;2021-01-27;1271;67;0;16604;190;0;3.1;0.0;0.0
25;2021-01-28;1121;85;0;17725;275;0;3.3;0.1;0.0
25;2021-01-29;978;272;0;18703;547;0;3.5;0.1;0.0
25;2021-01-30;318;103;0;19021;650;0;3.5;0.1;0.0
25;2021-01-31;7;0;0;19028;650;0;3.5;0.1;0.0
25;2021-02-01;619;261;0;19647;911;0;3.6;0.2;0.0
25;2021-02-02;677;450;0;20324;1361;0;3.8;0.3;0.0
25;2021-02-03;801;320;0;21125;1681;0;3.9;0.3;0.0
25;2021-02-04;737;495;0;21862;2176;0;4.1;0.4;0.0
25;2021-02-05;551;475;0;22413;2651;0;4.2;0.5;0.0
25;2021-02-06;217;173;0;22630;2824;0;4.2;0.5;0.0
25;2021-02-07;2;34;0;22632;2858;0;4.2;0.5;0.0
25;2021-02-08;616;546;0;23248;3404;0;4.3;0.6;0.0
25;2021-02-09;639;516;0;23887;3920;0;4.4;0.7;0.0
25;2021-02-10;769;522;0;24656;4442;0;4.6;0.8;0.0
25;2021-02-11;636;829;0;25292;5271;0;4.7;1.0;0.0
25;2021-02-12;448;560;0;25740;5831;0;4.8;1.1;0.0
25;2021-02-13;97;141;0;25837;5972;0;4.8;1.1;0.0
25;2021-02-14;1;3;0;25838;5975;0;4.8;1.1;0.0
25;2021-02-15;182;1053;0;26020;7028;0;4.8;1.3;0.0
25;2021-02-16;221;1429;0;26241;8457;0;4.9;1.6;0.0
25;2021-02-17;165;1349;0;26406;9806;0;4.9;1.8;0.0
25;2021-02-18;156;1336;0;26562;11142;0;4.9;2.1;0.0
25;2021-02-19;121;1272;0;26683;12414;0;4.9;2.3;0.0
25;2021-02-20;25;472;0;26708;12886;0;5.0;2.4;0.0
25;2021-02-21;0;136;0;26708;13022;0;5.0;2.4;0.0
25;2021-02-22;117;1092;0;26825;14114;0;5.0;2.6;0.0
25;2021-02-23;201;1147;0;27026;15261;0;5.0;2.8;0.0
25;2021-02-24;153;1034;0;27179;16295;0;5.0;3.0;0.0
25;2021-02-25;504;1061;0;27683;17356;0;5.1;3.2;0.0
25;2021-02-26;605;1079;0;28288;18435;0;5.2;3.4;0.0
25;2021-02-27;227;376;0;28515;18811;0;5.3;3.5;0.0
25;2021-02-28;6;5;0;28521;18816;0;5.3;3.5;0.0
25;2021-03-01;480;628;0;29001;19444;0;5.4;3.6;0.0
25;2021-03-02;631;836;0;29632;20280;0;5.5;3.8;0.0
25;2021-03-03;589;780;0;30221;21060;0;5.6;3.9;0.0
25;2021-03-04;1196;684;0;31417;21744;0;5.8;4.0;0.0
25;2021-03-05;1867;407;0;33284;22151;0;6.2;4.1;0.0
25;2021-03-06;1225;251;0;34509;22402;0;6.4;4.2;0.0
25;2021-03-07;30;15;0;34539;22417;0;6.4;4.2;0.0
25;2021-03-08;597;701;0;35136;23118;0;6.5;4.3;0.0
25;2021-03-09;1115;780;0;36251;23898;0;6.7;4.4;0.0
25;2021-03-10;1211;654;0;37462;24552;0;6.9;4.6;0.0
25;2021-03-11;1648;585;0;39110;25137;0;7.2;4.7;0.0
25;2021-03-12;2004;477;0;41114;25614;0;7.6;4.7;0.0
25;2021-03-13;1145;101;0;42259;25715;0;7.8;4.8;0.0
25;2021-03-14;50;2;0;42309;25717;0;7.8;4.8;0.0
25;2021-03-15;1153;157;0;43462;25874;0;8.1;4.8;0.0
25;2021-03-16;1276;131;0;44738;26005;0;8.3;4.8;0.0
25;2021-03-17;1471;153;0;46209;26158;0;8.6;4.8;0.0
25;2021-03-18;1551;90;0;47760;26248;0;8.9;4.9;0.0
25;2021-03-19;1689;135;0;49449;26383;0;9.2;4.9;0.0
25;2021-03-20;841;42;0;50290;26425;0;9.3;4.9;0.0
25;2021-03-21;26;0;0;50316;26425;0;9.3;4.9;0.0
25;2021-03-22;1488;105;0;51804;26530;0;9.6;4.9;0.0
25;2021-03-23;2215;172;0;54019;26702;0;10.0;4.9;0.0
25;2021-03-24;2483;111;0;56502;26813;0;10.5;5.0;0.0
25;2021-03-25;2926;216;0;59428;27029;0;11.0;5.0;0.0
25;2021-03-26;3220;208;0;62648;27237;0;11.6;5.0;0.0
25;2021-03-27;1193;110;0;63841;27347;0;11.8;5.1;0.0
25;2021-03-28;119;61;0;63960;27408;0;11.9;5.1;0.0
25;2021-03-29;1844;301;0;65804;27709;0;12.2;5.1;0.0
25;2021-03-30;2286;462;0;68090;28171;0;12.6;5.2;0.0
25;2021-03-31;2216;416;0;70306;28587;0;13.0;5.3;0.0
25;2021-04-01;2514;567;0;72820;29154;0;13.5;5.4;0.0
25;2021-04-02;2116;624;0;74936;29778;0;13.9;5.5;0.0
25;2021-04-03;519;134;0;75455;29912;0;14.0;5.5;0.0
25;2021-04-04;42;20;0;75497;29932;0;14.0;5.5;0.0
25;2021-04-05;146;5;0;75643;29937;0;14.0;5.5;0.0
25;2021-04-06;1926;727;0;77569;30664;0;14.4;5.7;0.0
25;2021-04-07;1971;930;0;79540;31594;0;14.7;5.9;0.0
25;2021-04-08;2469;937;0;82009;32531;0;15.2;6.0;0.0
25;2021-04-09;2641;1047;0;84650;33578;0;15.7;6.2;0.0
25;2021-04-10;1002;322;0;85652;33900;0;15.9;6.3;0.0
25;2021-04-11;97;31;0;85749;33931;0;15.9;6.3;0.0
25;2021-04-12;1659;1028;0;87408;34959;0;16.2;6.5;0.0
25;2021-04-13;2056;1415;0;89464;36374;0;16.6;6.7;0.0
25;2021-04-14;1885;1278;0;91349;37652;0;16.9;7.0;0.0
25;2021-04-15;2061;1390;0;93410;39042;0;17.3;7.2;0.0
25;2021-04-16;2135;1060;0;95545;40102;0;17.7;7.4;0.0
25;2021-04-17;1131;472;0;96676;40574;0;17.9;7.5;0.0
25;2021-04-18;126;20;0;96802;40594;0;17.9;7.5;0.0
25;2021-04-19;1370;1291;0;98172;41885;0;18.2;7.8;0.0
25;2021-04-20;1657;1534;0;99829;43419;0;18.5;8.0;0.0
25;2021-04-21;1753;1719;0;101582;45138;0;18.8;8.4;0.0
25;2021-04-22;1930;1683;0;103512;46821;0;19.2;8.7;0.0
25;2021-04-23;1954;1809;0;105466;48630;0;19.6;9.0;0.0
25;2021-04-24;1324;768;0;106790;49398;0;19.8;9.2;0.0
25;2021-04-25;131;110;0;106921;49508;0;19.8;9.2;0.0
25;2021-04-26;1791;1774;0;108712;51282;0;20.2;9.5;0.0
25;2021-04-27;2824;1618;0;111536;52900;0;20.7;9.8;0.0
25;2021-04-28;2543;1556;0;114079;54456;0;21.1;10.1;0.0
25;2021-04-29;2775;1973;0;116854;56429;0;21.7;10.5;0.0
25;2021-04-30;3264;1633;0;120118;58062;0;22.3;10.8;0.0
25;2021-05-01;1724;315;0;121842;58377;0;22.6;10.8;0.0
25;2021-05-02;409;26;0;122251;58403;0;22.7;10.8;0.0
25;2021-05-03;2876;885;0;125127;59288;0;23.2;11.0;0.0
25;2021-05-04;2611;1909;0;127738;61197;0;23.7;11.3;0.0
25;2021-05-05;2630;1719;0;130368;62916;0;24.2;11.7;0.0
25;2021-05-06;2917;2288;0;133285;65204;0;24.7;12.1;0.0
25;2021-05-07;3017;2172;0;136302;67376;0;25.3;12.5;0.0
25;2021-05-08;1333;246;0;137635;67622;0;25.5;12.5;0.0
25;2021-05-09;227;81;0;137862;67703;0;25.6;12.6;0.0
25;2021-05-10;2955;1699;0;140817;69402;0;26.1;12.9;0.0
25;2021-05-11;3544;2028;0;144361;71430;0;26.8;13.2;0.0
25;2021-05-12;3419;1894;0;147780;73324;0;27.4;13.6;0.0
25;2021-05-13;3149;591;0;150929;73915;0;28.0;13.7;0.0
25;2021-05-14;4071;1340;0;155000;75255;0;28.7;14.0;0.0
25;2021-05-15;2946;723;0;157946;75978;0;29.3;14.1;0.0
25;2021-05-16;721;94;0;158667;76072;0;29.4;14.1;0.0
25;2021-05-17;3704;1104;0;162371;77176;0;30.1;14.3;0.0
25;2021-05-18;4455;1252;0;166826;78428;0;30.9;14.5;0.0
25;2021-05-19;4729;1157;0;171555;79585;0;31.8;14.8;0.0
25;2021-05-20;4624;1425;0;176179;81010;0;32.7;15.0;0.0
25;2021-05-21;5207;1932;0;181386;82942;0;33.6;15.4;0.0
25;2021-05-22;2725;715;0;184111;83657;0;34.1;15.5;0.0
25;2021-05-23;702;116;0;184813;83773;0;34.3;15.5;0.0
25;2021-05-24;1457;188;0;186270;83961;0;34.5;15.6;0.0
25;2021-05-25;3111;1729;0;189381;85690;0;35.1;15.9;0.0
25;2021-05-26;3445;1628;0;192826;87318;0;35.7;16.2;0.0
25;2021-05-27;4010;1896;0;196836;89214;0;36.5;16.5;0.0
25;2021-05-28;3607;2677;0;200443;91891;0;37.2;17.0;0.0
25;2021-05-29;1888;1009;0;202331;92900;0;37.5;17.2;0.0
25;2021-05-30;184;92;0;202515;92992;0;37.5;17.2;0.0
25;2021-05-31;2387;1798;0;204902;94790;0;38.0;17.6;0.0
25;2021-06-01;2574;2202;0;207476;96992;0;38.5;18.0;0.0
25;2021-06-02;2593;2367;0;210069;99359;0;38.9;18.4;0.0
25;2021-06-03;3234;2146;0;213303;101505;0;39.5;18.8;0.0
25;2021-06-04;2970;2500;0;216273;104005;0;40.1;19.3;0.0
25;2021-06-05;1426;1431;0;217699;105436;0;40.4;19.5;0.0
25;2021-06-06;944;254;0;218643;105690;0;40.5;19.6;0.0
25;2021-06-07;2669;2621;0;221312;108311;0;41.0;20.1;0.0
25;2021-06-08;2594;2836;0;223906;111147;0;41.5;20.6;0.0
25;2021-06-09;2440;2786;0;226346;113933;0;42.0;21.1;0.0
25;2021-06-10;2396;2601;0;228742;116534;0;42.4;21.6;0.0
25;2021-06-11;2645;3356;0;231387;119890;0;42.9;22.2;0.0
25;2021-06-12;1546;1798;0;232933;121688;0;43.2;22.6;0.0
25;2021-06-13;447;246;0;233380;121934;0;43.3;22.6;0.0
25;2021-06-14;1405;3664;0;234785;125598;0;43.5;23.3;0.0
25;2021-06-15;1570;3459;0;236355;129057;0;43.8;23.9;0.0
25;2021-06-16;2034;3186;0;238389;132243;0;44.2;24.5;0.0
25;2021-06-17;1612;3242;0;240001;135485;0;44.5;25.1;0.0
25;2021-06-18;2264;4181;0;242265;139666;0;44.9;25.9;0.0
25;2021-06-19;1307;1937;0;243572;141603;0;45.2;26.2;0.0
25;2021-06-20;72;235;0;243644;141838;0;45.2;26.3;0.0
25;2021-06-21;1117;3906;0;244761;145744;0;45.4;27.0;0.0
25;2021-06-22;1168;4330;0;245929;150074;0;45.6;27.8;0.0
25;2021-06-23;1451;3837;0;247380;153911;0;45.9;28.5;0.0
25;2021-06-24;1277;3866;0;248657;157777;0;46.1;29.2;0.0
25;2021-06-25;1608;5288;0;250265;163065;0;46.4;30.2;0.0
25;2021-06-26;664;3034;0;250929;166099;0;46.5;30.8;0.0
25;2021-06-27;389;858;0;251318;166957;0;46.6;30.9;0.0
25;2021-06-28;882;4066;0;252200;171023;0;46.8;31.7;0.0
25;2021-06-29;1118;4893;0;253318;175916;0;47.0;32.6;0.0
25;2021-06-30;1306;5087;0;254624;181003;0;47.2;33.6;0.0
25;2021-07-01;1727;4924;0;256351;185927;0;47.5;34.5;0.0
25;2021-07-02;1729;4699;0;258080;190626;0;47.8;35.3;0.0
25;2021-07-03;1005;2482;0;259085;193108;0;48.0;35.8;0.0
25;2021-07-04;383;691;0;259468;193799;0;48.1;35.9;0.0
25;2021-07-05;1281;2502;0;260749;196301;0;48.3;36.4;0.0
25;2021-07-06;1561;4344;0;262310;200645;0;48.6;37.2;0.0
25;2021-07-07;1508;4118;0;263818;204763;0;48.9;38.0;0.0
25;2021-07-08;1547;3716;0;265365;208479;0;49.2;38.6;0.0
25;2021-07-09;1695;4196;0;267060;212675;0;49.5;39.4;0.0
25;2021-07-10;810;2178;0;267870;214853;0;49.7;39.8;0.0
25;2021-07-11;132;307;0;268002;215160;0;49.7;39.9;0.0
25;2021-07-12;1368;3655;0;269370;218815;0;49.9;40.6;0.0
25;2021-07-13;2409;4581;0;271779;223396;0;50.4;41.4;0.0
25;2021-07-14;479;579;0;272258;223975;0;50.5;41.5;0.0
25;2021-07-15;2587;3837;0;274845;227812;0;50.9;42.2;0.0
25;2021-07-16;3461;3802;0;278306;231614;0;51.6;42.9;0.0
25;2021-07-17;2302;2054;0;280608;233668;0;52.0;43.3;0.0
25;2021-07-18;857;1222;0;281465;234890;0;52.2;43.5;0.0
25;2021-07-19;2634;4143;0;284099;239033;0;52.7;44.3;0.0
25;2021-07-20;3435;3712;0;287534;242745;0;53.3;45.0;0.0
25;2021-07-21;3551;3574;0;291085;246319;0;54.0;45.7;0.0
25;2021-07-22;3511;3141;0;294596;249460;0;54.6;46.2;0.0
25;2021-07-23;3724;3386;0;298320;252846;0;55.3;46.9;0.0
25;2021-07-24;1643;2180;0;299963;255026;0;55.6;47.3;0.0
25;2021-07-25;606;608;0;300569;255634;0;55.7;47.4;0.0
25;2021-07-26;3055;2946;0;303624;258580;0;56.3;47.9;0.0
25;2021-07-27;3809;2164;0;307433;260744;0;57.0;48.3;0.0
25;2021-07-28;3793;2349;0;311226;263093;0;57.7;48.8;0.0
25;2021-07-29;4334;2241;0;315560;265334;0;58.5;49.2;0.0
25;2021-07-30;4184;2490;0;319744;267824;0;59.3;49.6;0.0
25;2021-07-31;1939;1466;0;321683;269290;0;59.6;49.9;0.0
25;2021-08-01;1174;210;0;322857;269500;0;59.8;50.0;0.0
25;2021-08-02;2760;2124;0;325617;271624;0;60.4;50.4;0.0
25;2021-08-03;2904;2194;0;328521;273818;0;60.9;50.8;0.0
25;2021-08-04;2998;1585;0;331519;275403;0;61.5;51.1;0.0
25;2021-08-05;2302;1812;0;333821;277215;0;61.9;51.4;0.0
25;2021-08-06;2351;2382;0;336172;279597;0;62.3;51.8;0.0
25;2021-08-07;1284;1167;0;337456;280764;0;62.6;52.0;0.0
25;2021-08-08;303;446;0;337759;281210;0;62.6;52.1;0.0
25;2021-08-09;2017;2268;0;339776;283478;0;63.0;52.5;0.0
25;2021-08-10;1961;2558;0;341737;286036;0;63.3;53.0;0.0
25;2021-08-11;1841;2144;0;343578;288180;0;63.7;53.4;0.0
25;2021-08-12;2194;2563;0;345772;290743;0;64.1;53.9;0.0
25;2021-08-13;1689;2193;0;347461;292936;0;64.4;54.3;0.0
25;2021-08-14;929;1826;0;348390;294762;0;64.6;54.6;0.0
25;2021-08-15;25;64;0;348415;294826;0;64.6;54.7;0.0
25;2021-08-16;1255;3239;0;349670;298065;0;64.8;55.3;0.0
25;2021-08-17;1437;3311;0;351107;301376;0;65.1;55.9;0.0
25;2021-08-18;1237;2906;0;352344;304282;0;65.3;56.4;0.0
25;2021-08-19;1014;2817;0;353358;307099;0;65.5;56.9;0.0
25;2021-08-20;1403;3676;0;354761;310775;0;65.8;57.6;0.0
25;2021-08-21;560;1782;0;355321;312557;0;65.9;57.9;0.0
25;2021-08-22;180;1082;0;355501;313639;0;65.9;58.1;0.0
25;2021-08-23;1073;3211;0;356574;316850;0;66.1;58.7;0.0
25;2021-08-24;1058;3172;0;357632;320022;0;66.3;59.3;0.0
25;2021-08-25;1019;3047;0;358651;323069;0;66.5;59.9;0.0
25;2021-08-26;1134;3142;0;359785;326211;0;66.7;60.5;0.0
25;2021-08-27;1163;3106;0;360948;329317;0;66.9;61.0;0.0
25;2021-08-28;547;1801;0;361495;331118;0;67.0;61.4;0.0
25;2021-08-29;129;461;0;361624;331579;0;67.0;61.5;0.0
25;2021-08-30;897;2732;37;362521;334311;37;67.2;62.0;0.0
25;2021-08-31;945;2308;110;363466;336619;147;67.4;62.4;0.0
25;2021-09-01;915;2283;333;364381;338902;480;67.5;62.8;0.1
25;2021-09-02;776;1711;271;365157;340613;751;67.7;63.1;0.1
25;2021-09-03;772;1856;308;365929;342469;1059;67.8;63.5;0.2
25;2021-09-04;622;1276;184;366551;343745;1243;67.9;63.7;0.2
25;2021-09-05;113;152;51;366664;343897;1294;68.0;63.7;0.2
25;2021-09-06;637;1362;488;367301;345259;1782;68.1;64.0;0.3
25;2021-09-07;520;1114;323;367821;346373;2105;68.2;64.2;0.4
25;2021-09-08;617;1582;397;368438;347955;2502;68.3;64.5;0.5
25;2021-09-09;444;1043;381;368882;348998;2883;68.4;64.7;0.5
25;2021-09-10;818;1610;435;369700;350608;3318;68.5;65.0;0.6
25;2021-09-11;374;1007;114;370074;351615;3432;68.6;65.2;0.6
25;2021-09-12;93;181;26;370167;351796;3458;68.6;65.2;0.6
25;2021-09-13;701;943;385;370868;352739;3843;68.7;65.4;0.7
25;2021-09-14;615;866;496;371483;353605;4339;68.9;65.5;0.8
25;2021-09-15;751;1477;438;372234;355082;4777;69.0;65.8;0.9
25;2021-09-16;514;807;411;372748;355889;5188;69.1;66.0;1.0
25;2021-09-17;726;1317;431;373474;357206;5619;69.2;66.2;1.0
25;2021-09-18;317;831;89;373791;358037;5708;69.3;66.4;1.1
25;2021-09-19;63;143;9;373854;358180;5717;69.3;66.4;1.1
25;2021-09-20;434;728;448;374288;358908;6165;69.4;66.5;1.1
25;2021-09-21;204;584;371;374492;359492;6536;69.4;66.6;1.2
25;2021-09-22;440;1148;484;374932;360640;7020;69.5;66.9;1.3
25;2021-09-23;244;481;334;375176;361121;7354;69.5;66.9;1.4
25;2021-09-24;487;1005;535;375663;362126;7889;69.6;67.1;1.5
25;2021-09-25;246;803;97;375909;362929;7986;69.7;67.3;1.5
25;2021-09-26;13;12;15;375922;362941;8001;69.7;67.3;1.5
25;2021-09-27;302;564;342;376224;363505;8343;69.7;67.4;1.5
25;2021-09-28;220;427;414;376444;363932;8757;69.8;67.5;1.6
25;2021-09-29;429;798;505;376873;364730;9262;69.9;67.6;1.7
25;2021-09-30;266;350;340;377139;365080;9602;69.9;67.7;1.8
25;2021-10-01;596;825;503;377735;365905;10105;70.0;67.8;1.9
25;2021-10-02;264;534;133;377999;366439;10238;70.1;67.9;1.9
25;2021-10-03;10;12;0;378009;366451;10238;70.1;67.9;1.9
25;2021-10-04;348;714;473;378357;367165;10711;70.1;68.1;2.0
25;2021-10-05;157;366;312;378514;367531;11023;70.2;68.1;2.0
25;2021-10-06;411;718;560;378925;368249;11583;70.2;68.3;2.1
25;2021-10-07;156;302;442;379081;368551;12025;70.3;68.3;2.2
25;2021-10-08;479;870;687;379560;369421;12712;70.4;68.5;2.4
25;2021-10-09;287;488;198;379847;369909;12910;70.4;68.6;2.4
25;2021-10-10;5;13;12;379852;369922;12922;70.4;68.6;2.4
25;2021-10-11;247;545;606;380099;370467;13528;70.5;68.7;2.5
25;2021-10-12;163;240;363;380262;370707;13891;70.5;68.7;2.6
25;2021-10-13;467;756;686;380729;371463;14577;70.6;68.9;2.7
25;2021-10-14;146;209;387;380875;371672;14964;70.6;68.9;2.8
25;2021-10-15;514;622;859;381389;372294;15823;70.7;69.0;2.9
25;2021-10-16;282;392;276;381671;372686;16099;70.8;69.1;3.0
25;2021-10-17;8;9;2;381679;372695;16101;70.8;69.1;3.0
25;2021-10-18;225;330;465;381904;373025;16566;70.8;69.1;3.1
25;2021-10-19;106;165;370;382010;373190;16936;70.8;69.2;3.1
25;2021-10-20;322;522;894;382332;373712;17830;70.9;69.3;3.3
25;2021-10-21;141;192;382;382473;373904;18212;70.9;69.3;3.4
25;2021-10-22;441;513;986;382914;374417;19198;71.0;69.4;3.6
25;2021-10-23;243;306;389;383157;374723;19587;71.0;69.5;3.6
25;2021-10-24;3;17;7;383160;374740;19594;71.0;69.5;3.6
25;2021-10-25;257;333;709;383417;375073;20303;71.1;69.5;3.8
25;2021-10-26;151;185;666;383568;375258;20969;71.1;69.6;3.9
25;2021-10-27;297;417;1058;383865;375675;22027;71.2;69.6;4.1
25;2021-10-28;94;131;387;383959;375806;22414;71.2;69.7;4.2
25;2021-10-29;343;454;1149;384302;376260;23563;71.2;69.7;4.4
25;2021-10-30;150;282;299;384452;376542;23862;71.3;69.8;4.4
25;2021-10-31;4;4;13;384456;376546;23875;71.3;69.8;4.4
25;2021-11-01;47;14;10;384503;376560;23885;71.3;69.8;4.4
25;2021-11-02;177;259;700;384680;376819;24585;71.3;69.9;4.6
25;2021-11-03;245;422;1259;384925;377241;25844;71.4;69.9;4.8
25;2021-11-04;134;169;676;385059;377410;26520;71.4;70.0;4.9
25;2021-11-05;280;451;1354;385339;377861;27874;71.4;70.0;5.2
25;2021-11-06;186;286;588;385525;378147;28462;71.5;70.1;5.3
25;2021-11-07;13;20;5;385538;378167;28467;71.5;70.1;5.3
25;2021-11-08;138;205;1018;385676;378372;29485;71.5;70.1;5.5
25;2021-11-09;106;157;1143;385782;378529;30628;71.5;70.2;5.7
25;2021-11-10;247;403;1760;386029;378932;32388;71.6;70.2;6.0
25;2021-11-11;2;23;10;386031;378955;32398;71.6;70.2;6.0
25;2021-11-12;275;456;1794;386306;379411;34192;71.6;70.3;6.3
25;2021-11-13;135;242;689;386441;379653;34881;71.6;70.4;6.5
25;2021-11-14;8;23;17;386449;379676;34898;71.6;70.4;6.5
25;2021-11-15;145;261;1694;386594;379937;36592;71.7;70.4;6.8
25;2021-11-16;144;180;1268;386738;380117;37860;71.7;70.5;7.0
25;2021-11-17;286;353;2211;387024;380470;40071;71.7;70.5;7.4
25;2021-11-18;100;127;1056;387124;380597;41127;71.8;70.6;7.6
25;2021-11-19;351;450;2312;387475;381047;43439;71.8;70.6;8.1
25;2021-11-20;219;264;855;387694;381311;44294;71.9;70.7;8.2
25;2021-11-21;3;13;8;387697;381324;44302;71.9;70.7;8.2
25;2021-11-22;227;168;1784;387924;381492;46086;71.9;70.7;8.5
25;2021-11-23;124;120;1420;388048;381612;47506;71.9;70.7;8.8
25;2021-11-24;289;339;2151;388337;381951;49657;72.0;70.8;9.2
25;2021-11-25;95;102;1177;388432;382053;50834;72.0;70.8;9.4
25;2021-11-26;319;345;3707;388751;382398;54541;72.1;70.9;10.1
25;2021-11-27;169;220;1315;388920;382618;55856;72.1;70.9;10.4
25;2021-11-28;5;20;37;388925;382638;55893;72.1;70.9;10.4
25;2021-11-29;177;185;3410;389102;382823;59303;72.1;71.0;11.0
25;2021-11-30;180;186;3728;389282;383009;63031;72.2;71.0;11.7
25;2021-12-01;184;271;4350;389466;383280;67381;72.2;71.1;12.5
25;2021-12-02;147;132;4600;389613;383412;71981;72.2;71.1;13.3
25;2021-12-03;198;339;5050;389811;383751;77031;72.3;71.1;14.3
25;2021-12-04;117;187;2047;389928;383938;79078;72.3;71.2;14.7
25;2021-12-05;6;12;77;389934;383950;79155;72.3;71.2;14.7
25;2021-12-06;143;175;4387;390077;384125;83542;72.3;71.2;15.5
25;2021-12-07;165;203;5519;390242;384328;89061;72.3;71.2;16.5
25;2021-12-08;196;317;5014;390438;384645;94075;72.4;71.3;17.4
25;2021-12-09;173;159;5215;390611;384804;99290;72.4;71.3;18.4
25;2021-12-10;169;298;6143;390780;385102;105433;72.4;71.4;19.5
25;2021-12-11;97;211;2899;390877;385313;108332;72.5;71.4;20.1
25;2021-12-12;12;25;234;390889;385338;108566;72.5;71.4;20.1
25;2021-12-13;130;223;4938;391019;385561;113504;72.5;71.5;21.0
25;2021-12-14;171;209;6026;391190;385770;119530;72.5;71.5;22.2
25;2021-12-15;168;354;5553;391358;386124;125083;72.5;71.6;23.2
25;2021-12-16;147;178;5832;391505;386302;130915;72.6;71.6;24.3
26;2020-12-27;0;0;0;0;0;0;0.0;0.0;0.0
26;2020-12-28;0;0;0;0;0;0;0.0;0.0;0.0
26;2020-12-29;0;0;0;0;0;0;0.0;0.0;0.0
26;2020-12-30;0;0;0;0;0;0;0.0;0.0;0.0
26;2020-12-31;0;0;0;0;0;0;0.0;0.0;0.0
26;2021-01-01;2;0;0;2;0;0;0.0;0.0;0.0
26;2021-01-02;0;0;0;2;0;0;0.0;0.0;0.0
26;2021-01-03;1;0;0;3;0;0;0.0;0.0;0.0
26;2021-01-04;0;0;0;3;0;0;0.0;0.0;0.0
26;2021-01-05;0;0;0;3;0;0;0.0;0.0;0.0
26;2021-01-06;4;0;0;7;0;0;0.0;0.0;0.0
26;2021-01-07;176;0;0;183;0;0;0.0;0.0;0.0
26;2021-01-08;133;0;0;316;0;0;0.1;0.0;0.0
26;2021-01-09;5;0;0;321;0;0;0.1;0.0;0.0
26;2021-01-10;0;0;0;321;0;0;0.1;0.0;0.0
26;2021-01-11;256;2;0;577;2;0;0.1;0.0;0.0
26;2021-01-12;206;1;0;783;3;0;0.2;0.0;0.0
26;2021-01-13;409;1;0;1192;4;0;0.2;0.0;0.0
26;2021-01-14;501;1;0;1693;5;0;0.3;0.0;0.0
26;2021-01-15;537;1;0;2230;6;0;0.4;0.0;0.0
26;2021-01-16;237;1;0;2467;7;0;0.5;0.0;0.0
26;2021-01-17;0;0;0;2467;7;0;0.5;0.0;0.0
26;2021-01-18;636;2;0;3103;9;0;0.6;0.0;0.0
26;2021-01-19;788;3;0;3891;12;0;0.7;0.0;0.0
26;2021-01-20;794;2;0;4685;14;0;0.9;0.0;0.0
26;2021-01-21;794;2;0;5479;16;0;1.1;0.0;0.0
26;2021-01-22;732;2;0;6211;18;0;1.2;0.0;0.0
26;2021-01-23;473;1;0;6684;19;0;1.3;0.0;0.0
26;2021-01-24;15;0;0;6699;19;0;1.3;0.0;0.0
26;2021-01-25;624;1;0;7323;20;0;1.4;0.0;0.0
26;2021-01-26;769;6;0;8092;26;0;1.6;0.0;0.0
26;2021-01-27;815;9;0;8907;35;0;1.7;0.0;0.0
26;2021-01-28;1259;169;0;10166;204;0;2.0;0.0;0.0
26;2021-01-29;928;68;0;11094;272;0;2.1;0.1;0.0
26;2021-01-30;552;8;0;11646;280;0;2.2;0.1;0.0
26;2021-01-31;11;0;0;11657;280;0;2.2;0.1;0.0
26;2021-02-01;643;172;0;12300;452;0;2.4;0.1;0.0
26;2021-02-02;1214;211;0;13514;663;0;2.6;0.1;0.0
26;2021-02-03;1214;291;0;14728;954;0;2.8;0.2;0.0
26;2021-02-04;943;437;0;15671;1391;0;3.0;0.3;0.0
26;2021-02-05;633;325;0;16304;1716;0;3.1;0.3;0.0
26;2021-02-06;324;219;0;16628;1935;0;3.2;0.4;0.0
26;2021-02-07;36;3;0;16664;1938;0;3.2;0.4;0.0
26;2021-02-08;516;402;0;17180;2340;0;3.3;0.4;0.0
26;2021-02-09;581;439;0;17761;2779;0;3.4;0.5;0.0
26;2021-02-10;652;373;0;18413;3152;0;3.5;0.6;0.0
26;2021-02-11;730;344;0;19143;3496;0;3.7;0.7;0.0
26;2021-02-12;561;444;0;19704;3940;0;3.8;0.8;0.0
26;2021-02-13;317;303;0;20021;4243;0;3.8;0.8;0.0
26;2021-02-14;31;2;0;20052;4245;0;3.9;0.8;0.0
26;2021-02-15;381;507;0;20433;4752;0;3.9;0.9;0.0
26;2021-02-16;294;526;0;20727;5278;0;4.0;1.0;0.0
26;2021-02-17;238;732;0;20965;6010;0;4.0;1.2;0.0
26;2021-02-18;401;897;0;21366;6907;0;4.1;1.3;0.0
26;2021-02-19;342;811;0;21708;7718;0;4.2;1.5;0.0
26;2021-02-20;86;441;0;21794;8159;0;4.2;1.6;0.0
26;2021-02-21;3;12;0;21797;8171;0;4.2;1.6;0.0
26;2021-02-22;160;647;0;21957;8818;0;4.2;1.7;0.0
26;2021-02-23;393;963;0;22350;9781;0;4.3;1.9;0.0
26;2021-02-24;376;1153;0;22726;10934;0;4.4;2.1;0.0
26;2021-02-25;678;1001;0;23404;11935;0;4.5;2.3;0.0
26;2021-02-26;859;608;0;24263;12543;0;4.7;2.4;0.0
26;2021-02-27;304;433;0;24567;12976;0;4.7;2.5;0.0
26;2021-02-28;11;17;0;24578;12993;0;4.7;2.5;0.0
26;2021-03-01;462;628;0;25040;13621;0;4.8;2.6;0.0
26;2021-03-02;678;630;0;25718;14251;0;4.9;2.7;0.0
26;2021-03-03;711;670;0;26429;14921;0;5.1;2.9;0.0
26;2021-03-04;994;558;0;27423;15479;0;5.3;3.0;0.0
26;2021-03-05;1695;511;0;29118;15990;0;5.6;3.1;0.0
26;2021-03-06;2576;437;0;31694;16427;0;6.1;3.2;0.0
26;2021-03-07;2584;195;0;34278;16622;0;6.6;3.2;0.0
26;2021-03-08;899;614;0;35177;17236;0;6.8;3.3;0.0
26;2021-03-09;1299;552;0;36476;17788;0;7.0;3.4;0.0
26;2021-03-10;1193;498;0;37669;18286;0;7.2;3.5;0.0
26;2021-03-11;1533;622;0;39202;18908;0;7.5;3.6;0.0
26;2021-03-12;2170;499;0;41372;19407;0;7.9;3.7;0.0
26;2021-03-13;1769;287;0;43141;19694;0;8.3;3.8;0.0
26;2021-03-14;66;27;0;43207;19721;0;8.3;3.8;0.0
26;2021-03-15;1565;257;0;44772;19978;0;8.6;3.8;0.0
26;2021-03-16;1163;491;0;45935;20469;0;8.8;3.9;0.0
26;2021-03-17;1318;330;0;47253;20799;0;9.1;4.0;0.0
26;2021-03-18;1527;306;0;48780;21105;0;9.4;4.1;0.0
26;2021-03-19;2351;357;0;51131;21462;0;9.8;4.1;0.0
26;2021-03-20;1200;138;0;52331;21600;0;10.1;4.1;0.0
26;2021-03-21;63;21;0;52394;21621;0;10.1;4.2;0.0
26;2021-03-22;1729;215;0;54123;21836;0;10.4;4.2;0.0
26;2021-03-23;2468;324;0;56591;22160;0;10.9;4.3;0.0
26;2021-03-24;2493;278;0;59084;22438;0;11.4;4.3;0.0
26;2021-03-25;2971;346;0;62055;22784;0;11.9;4.4;0.0
26;2021-03-26;2940;358;0;64995;23142;0;12.5;4.4;0.0
26;2021-03-27;1131;152;0;66126;23294;0;12.7;4.5;0.0
26;2021-03-28;78;5;0;66204;23299;0;12.7;4.5;0.0
26;2021-03-29;1785;424;0;67989;23723;0;13.1;4.6;0.0
26;2021-03-30;2226;499;0;70215;24222;0;13.5;4.7;0.0
26;2021-03-31;2344;566;0;72559;24788;0;13.9;4.8;0.0
26;2021-04-01;2185;760;0;74744;25548;0;14.4;4.9;0.0
26;2021-04-02;2173;934;0;76917;26482;0;14.8;5.1;0.0
26;2021-04-03;511;980;0;77428;27462;0;14.9;5.3;0.0
26;2021-04-04;205;736;0;77633;28198;0;14.9;5.4;0.0
26;2021-04-05;472;47;0;78105;28245;0;15.0;5.4;0.0
26;2021-04-06;1446;781;0;79551;29026;0;15.3;5.6;0.0
26;2021-04-07;1752;871;0;81303;29897;0;15.6;5.7;0.0
26;2021-04-08;2949;948;0;84252;30845;0;16.2;5.9;0.0
26;2021-04-09;3414;995;0;87666;31840;0;16.8;6.1;0.0
26;2021-04-10;1258;822;0;88924;32662;0;17.1;6.3;0.0
26;2021-04-11;94;31;0;89018;32693;0;17.1;6.3;0.0
26;2021-04-12;1715;1077;0;90733;33770;0;17.4;6.5;0.0
26;2021-04-13;2677;1462;0;93410;35232;0;17.9;6.8;0.0
26;2021-04-14;2246;1412;0;95656;36644;0;18.4;7.0;0.0
26;2021-04-15;2291;1519;0;97947;38163;0;18.8;7.3;0.0
26;2021-04-16;2221;1561;0;100168;39724;0;19.2;7.6;0.0
26;2021-04-17;995;749;0;101163;40473;0;19.4;7.8;0.0
26;2021-04-18;65;46;0;101228;40519;0;19.4;7.8;0.0
26;2021-04-19;1453;1473;0;102681;41992;0;19.7;8.1;0.0
26;2021-04-20;1684;1738;0;104365;43730;0;20.0;8.4;0.0
26;2021-04-21;1865;1440;0;106230;45170;0;20.4;8.7;0.0
26;2021-04-22;2291;1585;0;108521;46755;0;20.8;9.0;0.0
26;2021-04-23;1958;1555;0;110479;48310;0;21.2;9.3;0.0
26;2021-04-24;1388;759;0;111867;49069;0;21.5;9.4;0.0
26;2021-04-25;509;80;0;112376;49149;0;21.6;9.4;0.0
26;2021-04-26;1307;1443;0;113683;50592;0;21.8;9.7;0.0
26;2021-04-27;1830;1653;0;115513;52245;0;22.2;10.0;0.0
26;2021-04-28;1781;1748;0;117294;53993;0;22.5;10.4;0.0
26;2021-04-29;2735;1886;0;120029;55879;0;23.1;10.7;0.0
26;2021-04-30;2599;1815;0;122628;57694;0;23.6;11.1;0.0
26;2021-05-01;1292;337;0;123920;58031;0;23.8;11.1;0.0
26;2021-05-02;909;116;0;124829;58147;0;24.0;11.2;0.0
26;2021-05-03;2019;1695;0;126848;59842;0;24.4;11.5;0.0
26;2021-05-04;2488;2249;0;129336;62091;0;24.8;11.9;0.0
26;2021-05-05;2520;2088;0;131856;64179;0;25.3;12.3;0.0
26;2021-05-06;3128;2137;0;134984;66316;0;25.9;12.7;0.0
26;2021-05-07;2614;2321;0;137598;68637;0;26.4;13.2;0.0
26;2021-05-08;1802;506;0;139400;69143;0;26.8;13.3;0.0
26;2021-05-09;589;121;0;139989;69264;0;26.9;13.3;0.0
26;2021-05-10;2696;1835;0;142685;71099;0;27.4;13.7;0.0
26;2021-05-11;3979;2214;0;146664;73313;0;28.2;14.1;0.0
26;2021-05-12;4192;1783;0;150856;75096;0;29.0;14.4;0.0
26;2021-05-13;3713;528;0;154569;75624;0;29.7;14.5;0.0
26;2021-05-14;3985;1459;0;158554;77083;0;30.5;14.8;0.0
26;2021-05-15;3468;544;0;162022;77627;0;31.1;14.9;0.0
26;2021-05-16;2792;281;0;164814;77908;0;31.7;15.0;0.0
26;2021-05-17;3142;1416;0;167956;79324;0;32.3;15.2;0.0
26;2021-05-18;3857;1657;0;171813;80981;0;33.0;15.6;0.0
26;2021-05-19;3802;1379;0;175615;82360;0;33.7;15.8;0.0
26;2021-05-20;3992;1678;0;179607;84038;0;34.5;16.1;0.0
26;2021-05-21;3983;1772;0;183590;85810;0;35.3;16.5;0.0
26;2021-05-22;2422;622;0;186012;86432;0;35.7;16.6;0.0
26;2021-05-23;1223;153;0;187235;86585;0;36.0;16.6;0.0
26;2021-05-24;2946;602;0;190181;87187;0;36.5;16.7;0.0
26;2021-05-25;2971;2299;0;193152;89486;0;37.1;17.2;0.0
26;2021-05-26;3354;2168;0;196506;91654;0;37.7;17.6;0.0
26;2021-05-27;3573;2329;0;200079;93983;0;38.4;18.1;0.0
26;2021-05-28;3142;2611;0;203221;96594;0;39.0;18.6;0.0
26;2021-05-29;2222;1436;0;205443;98030;0;39.5;18.8;0.0
26;2021-05-30;367;88;0;205810;98118;0;39.5;18.8;0.0
26;2021-05-31;2488;1766;0;208298;99884;0;40.0;19.2;0.0
26;2021-06-01;2890;2173;0;211188;102057;0;40.6;19.6;0.0
26;2021-06-02;2508;2088;0;213696;104145;0;41.1;20.0;0.0
26;2021-06-03;2672;2290;0;216368;106435;0;41.6;20.4;0.0
26;2021-06-04;2577;2720;0;218945;109155;0;42.1;21.0;0.0
26;2021-06-05;1432;1432;0;220377;110587;0;42.3;21.2;0.0
26;2021-06-06;81;39;0;220458;110626;0;42.4;21.3;0.0
26;2021-06-07;2024;2234;0;222482;112860;0;42.7;21.7;0.0
26;2021-06-08;2258;2098;0;224740;114958;0;43.2;22.1;0.0
26;2021-06-09;1878;2164;0;226618;117122;0;43.5;22.5;0.0
26;2021-06-10;1820;2543;0;228438;119665;0;43.9;23.0;0.0
26;2021-06-11;1716;2970;0;230154;122635;0;44.2;23.6;0.0
26;2021-06-12;1094;1592;0;231248;124227;0;44.4;23.9;0.0
26;2021-06-13;130;211;0;231378;124438;0;44.4;23.9;0.0
26;2021-06-14;1249;3198;0;232627;127636;0;44.7;24.5;0.0
26;2021-06-15;1478;3670;0;234105;131306;0;45.0;25.2;0.0
26;2021-06-16;1637;3224;0;235742;134530;0;45.3;25.8;0.0
26;2021-06-17;1450;2923;0;237192;137453;0;45.6;26.4;0.0
26;2021-06-18;1659;3985;0;238851;141438;0;45.9;27.2;0.0
26;2021-06-19;864;2718;0;239715;144156;0;46.0;27.7;0.0
26;2021-06-20;250;749;0;239965;144905;0;46.1;27.8;0.0
26;2021-06-21;895;4019;0;240860;148924;0;46.3;28.6;0.0
26;2021-06-22;981;4705;0;241841;153629;0;46.5;29.5;0.0
26;2021-06-23;1131;4421;0;242972;158050;0;46.7;30.4;0.0
26;2021-06-24;1251;3988;0;244223;162038;0;46.9;31.1;0.0
26;2021-06-25;1032;4803;0;245255;166841;0;47.1;32.1;0.0
26;2021-06-26;628;3129;0;245883;169970;0;47.2;32.7;0.0
26;2021-06-27;289;1107;0;246172;171077;0;47.3;32.9;0.0
26;2021-06-28;756;4118;0;246928;175195;0;47.4;33.7;0.0
26;2021-06-29;1004;4360;0;247932;179555;0;47.6;34.5;0.0
26;2021-06-30;1352;4191;0;249284;183746;0;47.9;35.3;0.0
26;2021-07-01;1627;3893;0;250911;187639;0;48.2;36.0;0.0
26;2021-07-02;1329;4510;0;252240;192149;0;48.5;36.9;0.0
26;2021-07-03;663;2568;0;252903;194717;0;48.6;37.4;0.0
26;2021-07-04;270;487;0;253173;195204;0;48.6;37.5;0.0
26;2021-07-05;868;3859;0;254041;199063;0;48.8;38.2;0.0
26;2021-07-06;1242;3724;0;255283;202787;0;49.0;39.0;0.0
26;2021-07-07;1394;3330;0;256677;206117;0;49.3;39.6;0.0
26;2021-07-08;2193;3040;0;258870;209157;0;49.7;40.2;0.0
26;2021-07-09;1489;4103;0;260359;213260;0;50.0;41.0;0.0
26;2021-07-10;804;2211;0;261163;215471;0;50.2;41.4;0.0
26;2021-07-11;262;283;0;261425;215754;0;50.2;41.4;0.0
26;2021-07-12;1043;3617;0;262468;219371;0;50.4;42.1;0.0
26;2021-07-13;2117;4100;0;264585;223471;0;50.8;42.9;0.0
26;2021-07-14;848;730;0;265433;224201;0;51.0;43.1;0.0
26;2021-07-15;2883;3415;0;268316;227616;0;51.5;43.7;0.0
26;2021-07-16;2806;3319;0;271122;230935;0;52.1;44.4;0.0
26;2021-07-17;1661;1520;0;272783;232455;0;52.4;44.7;0.0
26;2021-07-18;206;111;0;272989;232566;0;52.4;44.7;0.0
26;2021-07-19;2373;2844;0;275362;235410;0;52.9;45.2;0.0
26;2021-07-20;3306;3302;0;278668;238712;0;53.5;45.9;0.0
26;2021-07-21;3132;2804;0;281800;241516;0;54.1;46.4;0.0
26;2021-07-22;3602;2715;0;285402;244231;0;54.8;46.9;0.0
26;2021-07-23;3432;3063;0;288834;247294;0;55.5;47.5;0.0
26;2021-07-24;2036;1211;0;290870;248505;0;55.9;47.7;0.0
26;2021-07-25;461;112;0;291331;248617;0;56.0;47.8;0.0
26;2021-07-26;3058;2313;0;294389;250930;0;56.6;48.2;0.0
26;2021-07-27;4379;2529;0;298768;253459;0;57.4;48.7;0.0
26;2021-07-28;3931;2165;0;302699;255624;0;58.1;49.1;0.0
26;2021-07-29;3486;2615;0;306185;258239;0;58.8;49.6;0.0
26;2021-07-30;3169;2447;0;309354;260686;0;59.4;50.1;0.0
26;2021-07-31;1104;991;0;310458;261677;0;59.6;50.3;0.0
26;2021-08-01;401;128;0;310859;261805;0;59.7;50.3;0.0
26;2021-08-02;2639;2099;0;313498;263904;0;60.2;50.7;0.0
26;2021-08-03;3163;2122;0;316661;266026;0;60.8;51.1;0.0
26;2021-08-04;3552;1760;0;320213;267786;0;61.5;51.4;0.0
26;2021-08-05;2946;1954;0;323159;269740;0;62.1;51.8;0.0
26;2021-08-06;2946;2402;1;326105;272142;1;62.6;52.3;0.0
26;2021-08-07;682;746;0;326787;272888;1;62.8;52.4;0.0
26;2021-08-08;68;73;0;326855;272961;1;62.8;52.4;0.0
26;2021-08-09;2006;2562;0;328861;275523;1;63.2;52.9;0.0
26;2021-08-10;2298;2745;0;331159;278268;1;63.6;53.5;0.0
26;2021-08-11;2060;2433;0;333219;280701;1;64.0;53.9;0.0
26;2021-08-12;1779;2352;0;334998;283053;1;64.4;54.4;0.0
26;2021-08-13;1707;2233;0;336705;285286;1;64.7;54.8;0.0
26;2021-08-14;409;847;0;337114;286133;1;64.8;55.0;0.0
26;2021-08-15;42;61;0;337156;286194;1;64.8;55.0;0.0
26;2021-08-16;1129;2777;0;338285;288971;1;65.0;55.5;0.0
26;2021-08-17;1633;2917;0;339918;291888;1;65.3;56.1;0.0
26;2021-08-18;1560;3066;0;341478;294954;1;65.6;56.7;0.0
26;2021-08-19;1525;2738;0;343003;297692;1;65.9;57.2;0.0
26;2021-08-20;1311;2698;0;344314;300390;1;66.1;57.7;0.0
26;2021-08-21;528;999;0;344842;301389;1;66.2;57.9;0.0
26;2021-08-22;67;339;0;344909;301728;1;66.3;58.0;0.0
26;2021-08-23;1430;3124;0;346339;304852;1;66.5;58.6;0.0
26;2021-08-24;1631;3338;0;347970;308190;1;66.8;59.2;0.0
26;2021-08-25;1458;3293;0;349428;311483;1;67.1;59.8;0.0
26;2021-08-26;1367;3013;0;350795;314496;1;67.4;60.4;0.0
26;2021-08-27;1464;3309;0;352259;317805;1;67.7;61.1;0.0
26;2021-08-28;392;1057;0;352651;318862;1;67.7;61.3;0.0
26;2021-08-29;22;64;0;352673;318926;1;67.7;61.3;0.0
26;2021-08-30;1365;2958;60;354038;321884;61;68.0;61.8;0.0
26;2021-08-31;1256;3166;122;355294;325050;183;68.3;62.4;0.0
26;2021-09-01;1365;2459;214;356659;327509;397;68.5;62.9;0.1
26;2021-09-02;1072;1888;257;357731;329397;654;68.7;63.3;0.1
26;2021-09-03;1075;2446;275;358806;331843;929;68.9;63.7;0.2
26;2021-09-04;406;703;84;359212;332546;1013;69.0;63.9;0.2
26;2021-09-05;46;49;10;359258;332595;1023;69.0;63.9;0.2
26;2021-09-06;672;1384;379;359930;333979;1402;69.1;64.2;0.3
26;2021-09-07;773;1563;331;360703;335542;1733;69.3;64.5;0.3
26;2021-09-08;819;1684;286;361522;337226;2019;69.4;64.8;0.4
26;2021-09-09;585;1348;319;362107;338574;2338;69.6;65.0;0.4
26;2021-09-10;774;1741;312;362881;340315;2650;69.7;65.4;0.5
26;2021-09-11;306;698;81;363187;341013;2731;69.8;65.5;0.5
26;2021-09-12;14;24;2;363201;341037;2733;69.8;65.5;0.5
26;2021-09-13;536;1204;414;363737;342241;3147;69.9;65.7;0.6
26;2021-09-14;676;1279;422;364413;343520;3569;70.0;66.0;0.7
26;2021-09-15;683;1709;470;365096;345229;4039;70.1;66.3;0.8
26;2021-09-16;525;977;419;365621;346206;4458;70.2;66.5;0.9
26;2021-09-17;611;1650;423;366232;347856;4881;70.4;66.8;0.9
26;2021-09-18;231;661;100;366463;348517;4981;70.4;67.0;1.0
26;2021-09-19;5;36;1;366468;348553;4982;70.4;67.0;1.0
26;2021-09-20;324;1013;491;366792;349566;5473;70.5;67.2;1.1
26;2021-09-21;370;965;425;367162;350531;5898;70.5;67.3;1.1
26;2021-09-22;394;1406;455;367556;351937;6353;70.6;67.6;1.2
26;2021-09-23;352;773;265;367908;352710;6618;70.7;67.8;1.3
26;2021-09-24;431;1357;475;368339;354067;7093;70.8;68.0;1.4
26;2021-09-25;161;536;69;368500;354603;7162;70.8;68.1;1.4
26;2021-09-26;11;30;1;368511;354633;7163;70.8;68.1;1.4
26;2021-09-27;289;730;389;368800;355363;7552;70.8;68.3;1.5
26;2021-09-28;223;633;325;369023;355996;7877;70.9;68.4;1.5
26;2021-09-29;353;1019;328;369376;357015;8205;71.0;68.6;1.6
26;2021-09-30;231;573;461;369607;357588;8666;71.0;68.7;1.7
26;2021-10-01;461;936;564;370068;358524;9230;71.1;68.9;1.8
26;2021-10-02;189;308;99;370257;358832;9329;71.1;68.9;1.8
26;2021-10-03;11;19;3;370268;358851;9332;71.1;68.9;1.8
26;2021-10-04;313;577;554;370581;359428;9886;71.2;69.0;1.9
26;2021-10-05;162;512;536;370743;359940;10422;71.2;69.1;2.0
26;2021-10-06;386;783;575;371129;360723;10997;71.3;69.3;2.1
26;2021-10-07;195;423;472;371324;361146;11469;71.3;69.4;2.2
26;2021-10-08;372;807;670;371696;361953;12139;71.4;69.5;2.3
26;2021-10-09;181;276;165;371877;362229;12304;71.4;69.6;2.4
26;2021-10-10;2;22;3;371879;362251;12307;71.4;69.6;2.4
26;2021-10-11;242;498;763;372121;362749;13070;71.5;69.7;2.5
26;2021-10-12;200;358;546;372321;363107;13616;71.5;69.8;2.6
26;2021-10-13;301;565;684;372622;363672;14300;71.6;69.9;2.7
26;2021-10-14;213;411;593;372835;364083;14893;71.6;69.9;2.9
26;2021-10-15;383;588;817;373218;364671;15710;71.7;70.1;3.0
26;2021-10-16;168;166;178;373386;364837;15888;71.7;70.1;3.1
26;2021-10-17;7;13;13;373393;364850;15901;71.7;70.1;3.1
26;2021-10-18;226;368;758;373619;365218;16659;71.8;70.2;3.2
26;2021-10-19;90;201;529;373709;365419;17188;71.8;70.2;3.3
26;2021-10-20;174;356;708;373883;365775;17896;71.8;70.3;3.4
26;2021-10-21;144;305;886;374027;366080;18782;71.9;70.3;3.6
26;2021-10-22;146;450;825;374173;366530;19607;71.9;70.4;3.8
26;2021-10-23;75;122;122;374248;366652;19729;71.9;70.4;3.8
26;2021-10-24;3;16;12;374251;366668;19741;71.9;70.4;3.8
26;2021-10-25;151;334;888;374402;367002;20629;71.9;70.5;4.0
26;2021-10-26;105;158;649;374507;367160;21278;71.9;70.5;4.1
26;2021-10-27;160;363;902;374667;367523;22180;72.0;70.6;4.3
26;2021-10-28;147;204;953;374814;367727;23133;72.0;70.6;4.4
26;2021-10-29;147;343;877;374961;368070;24010;72.0;70.7;4.6
26;2021-10-30;54;126;309;375015;368196;24319;72.0;70.7;4.7
26;2021-10-31;1;3;3;375016;368199;24322;72.0;70.7;4.7
26;2021-11-01;17;9;16;375033;368208;24338;72.0;70.7;4.7
26;2021-11-02;85;216;729;375118;368424;25067;72.1;70.8;4.8
26;2021-11-03;152;409;1123;375270;368833;26190;72.1;70.9;5.0
26;2021-11-04;106;216;1177;375376;369049;27367;72.1;70.9;5.3
26;2021-11-05;152;293;963;375528;369342;28330;72.1;71.0;5.4
26;2021-11-06;74;158;330;375602;369500;28660;72.2;71.0;5.5
26;2021-11-07;0;12;4;375602;369512;28664;72.2;71.0;5.5
26;2021-11-08;100;255;1249;375702;369767;29913;72.2;71.0;5.7
26;2021-11-09;96;168;1072;375798;369935;30985;72.2;71.1;6.0
26;2021-11-10;166;253;1738;375964;370188;32723;72.2;71.1;6.3
26;2021-11-11;9;16;19;375973;370204;32742;72.2;71.1;6.3
26;2021-11-12;121;236;1390;376094;370440;34132;72.2;71.2;6.6
26;2021-11-13;48;85;428;376142;370525;34560;72.3;71.2;6.6
26;2021-11-14;4;7;4;376146;370532;34564;72.3;71.2;6.6
26;2021-11-15;136;168;1794;376282;370700;36358;72.3;71.2;7.0
26;2021-11-16;116;152;1706;376398;370852;38064;72.3;71.2;7.3
26;2021-11-17;202;245;1836;376600;371097;39900;72.3;71.3;7.7
26;2021-11-18;117;157;1683;376717;371254;41583;72.4;71.3;8.0
26;2021-11-19;158;177;1652;376875;371431;43235;72.4;71.4;8.3
26;2021-11-20;88;102;709;376963;371533;43944;72.4;71.4;8.4
26;2021-11-21;16;21;262;376979;371554;44206;72.4;71.4;8.5
26;2021-11-22;91;76;1765;377070;371630;45971;72.4;71.4;8.8
26;2021-11-23;122;115;2076;377192;371745;48047;72.5;71.4;9.2
26;2021-11-24;170;175;2108;377362;371920;50155;72.5;71.4;9.6
26;2021-11-25;137;125;2198;377499;372045;52353;72.5;71.5;10.1
26;2021-11-26;174;191;2973;377673;372236;55326;72.6;71.5;10.6
26;2021-11-27;81;116;1023;377754;372352;56349;72.6;71.5;10.8
26;2021-11-28;2;6;33;377756;372358;56382;72.6;71.5;10.8
26;2021-11-29;89;109;3121;377845;372467;59503;72.6;71.6;11.4
26;2021-11-30;117;104;3584;377962;372571;63087;72.6;71.6;12.1
26;2021-12-01;129;171;4228;378091;372742;67315;72.6;71.6;12.9
26;2021-12-02;100;109;3845;378191;372851;71160;72.7;71.6;13.7
26;2021-12-03;101;151;4531;378292;373002;75691;72.7;71.7;14.5
26;2021-12-04;75;75;1912;378367;373077;77603;72.7;71.7;14.9
26;2021-12-05;13;26;840;378380;373103;78443;72.7;71.7;15.1
26;2021-12-06;102;167;4142;378482;373270;82585;72.7;71.7;15.9
26;2021-12-07;129;157;5410;378611;373427;87995;72.7;71.7;16.9
26;2021-12-08;159;194;5537;378770;373621;93532;72.8;71.8;18.0
26;2021-12-09;135;142;5970;378905;373763;99502;72.8;71.8;19.1
26;2021-12-10;120;160;6091;379025;373923;105593;72.8;71.8;20.3
26;2021-12-11;86;78;2717;379111;374001;108310;72.8;71.8;20.8
26;2021-12-12;23;12;463;379134;374013;108773;72.8;71.8;20.9
26;2021-12-13;115;149;5380;379249;374162;114153;72.9;71.9;21.9
26;2021-12-14;143;169;6648;379392;374331;120801;72.9;71.9;23.2
26;2021-12-15;159;197;6188;379551;374528;126989;72.9;71.9;24.4
26;2021-12-16;146;176;6414;379697;374704;133403;72.9;72.0;25.6
27;2020-12-27;0;0;0;0;0;0;0.0;0.0;0.0
27;2020-12-28;0;0;0;0;0;0;0.0;0.0;0.0
27;2020-12-29;1;0;0;1;0;0;0.0;0.0;0.0
27;2020-12-30;0;0;0;1;0;0;0.0;0.0;0.0
27;2020-12-31;0;0;0;1;0;0;0.0;0.0;0.0
27;2021-01-01;0;0;0;1;0;0;0.0;0.0;0.0
27;2021-01-02;0;0;0;1;0;0;0.0;0.0;0.0
27;2021-01-03;1;0;0;2;0;0;0.0;0.0;0.0
27;2021-01-04;4;0;0;6;0;0;0.0;0.0;0.0
27;2021-01-05;23;0;0;29;0;0;0.0;0.0;0.0
27;2021-01-06;200;0;0;229;0;0;0.0;0.0;0.0
27;2021-01-07;465;0;0;694;0;0;0.1;0.0;0.0
27;2021-01-08;501;3;0;1195;3;0;0.2;0.0;0.0
27;2021-01-09;92;2;0;1287;5;0;0.2;0.0;0.0
27;2021-01-10;103;0;0;1390;5;0;0.2;0.0;0.0
27;2021-01-11;406;0;0;1796;5;0;0.3;0.0;0.0
27;2021-01-12;492;2;0;2288;7;0;0.4;0.0;0.0
27;2021-01-13;844;3;0;3132;10;0;0.5;0.0;0.0
27;2021-01-14;1646;32;0;4778;42;0;0.8;0.0;0.0
27;2021-01-15;1217;8;0;5995;50;0;1.0;0.0;0.0
27;2021-01-16;309;2;0;6304;52;0;1.0;0.0;0.0
27;2021-01-17;220;2;0;6524;54;0;1.1;0.0;0.0
27;2021-01-18;788;5;0;7312;59;0;1.2;0.0;0.0
27;2021-01-19;871;5;0;8183;64;0;1.4;0.0;0.0
27;2021-01-20;906;1;0;9089;65;0;1.5;0.0;0.0
27;2021-01-21;710;6;0;9799;71;0;1.6;0.0;0.0
27;2021-01-22;807;6;0;10606;77;0;1.8;0.0;0.0
27;2021-01-23;328;0;0;10934;77;0;1.8;0.0;0.0
27;2021-01-24;137;4;0;11071;81;0;1.8;0.0;0.0
27;2021-01-25;621;16;0;11692;97;0;1.9;0.0;0.0
27;2021-01-26;546;27;0;12238;124;0;2.0;0.0;0.0
27;2021-01-27;569;133;0;12807;257;0;2.1;0.0;0.0
27;2021-01-28;593;339;0;13400;596;0;2.2;0.1;0.0
27;2021-01-29;530;146;0;13930;742;0;2.3;0.1;0.0
27;2021-01-30;224;29;0;14154;771;0;2.4;0.1;0.0
27;2021-01-31;27;26;0;14181;797;0;2.4;0.1;0.0
27;2021-02-01;380;242;0;14561;1039;0;2.4;0.2;0.0
27;2021-02-02;324;327;0;14885;1366;0;2.5;0.2;0.0
27;2021-02-03;461;404;0;15346;1770;0;2.6;0.3;0.0
27;2021-02-04;719;912;0;16065;2682;0;2.7;0.4;0.0
27;2021-02-05;668;1059;0;16733;3741;0;2.8;0.6;0.0
27;2021-02-06;72;211;0;16805;3952;0;2.8;0.7;0.0
27;2021-02-07;43;103;0;16848;4055;0;2.8;0.7;0.0
27;2021-02-08;389;437;0;17237;4492;0;2.9;0.7;0.0
27;2021-02-09;381;584;0;17618;5076;0;2.9;0.8;0.0
27;2021-02-10;348;543;0;17966;5619;0;3.0;0.9;0.0
27;2021-02-11;384;536;0;18350;6155;0;3.1;1.0;0.0
27;2021-02-12;353;598;0;18703;6753;0;3.1;1.1;0.0
27;2021-02-13;139;128;0;18842;6881;0;3.1;1.1;0.0
27;2021-02-14;7;85;0;18849;6966;0;3.1;1.2;0.0
27;2021-02-15;403;645;0;19252;7611;0;3.2;1.3;0.0
27;2021-02-16;349;776;0;19601;8387;0;3.3;1.4;0.0
27;2021-02-17;288;691;0;19889;9078;0;3.3;1.5;0.0
27;2021-02-18;388;754;0;20277;9832;0;3.4;1.6;0.0
27;2021-02-19;287;712;0;20564;10544;0;3.4;1.8;0.0
27;2021-02-20;127;230;0;20691;10774;0;3.4;1.8;0.0
27;2021-02-21;11;122;0;20702;10896;0;3.4;1.8;0.0
27;2021-02-22;450;622;0;21152;11518;0;3.5;1.9;0.0
27;2021-02-23;453;656;0;21605;12174;0;3.6;2.0;0.0
27;2021-02-24;431;640;0;22036;12814;0;3.7;2.1;0.0
27;2021-02-25;788;724;0;22824;13538;0;3.8;2.3;0.0
27;2021-02-26;798;717;0;23622;14255;0;3.9;2.4;0.0
27;2021-02-27;366;152;0;23988;14407;0;4.0;2.4;0.0
27;2021-02-28;105;24;0;24093;14431;0;4.0;2.4;0.0
27;2021-03-01;402;518;0;24495;14949;0;4.1;2.5;0.0
27;2021-03-02;679;412;0;25174;15361;0;4.2;2.6;0.0
27;2021-03-03;761;387;0;25935;15748;0;4.3;2.6;0.0
27;2021-03-04;868;275;0;26803;16023;0;4.5;2.7;0.0
27;2021-03-05;1367;294;0;28170;16317;0;4.7;2.7;0.0
27;2021-03-06;1436;99;0;29606;16416;0;4.9;2.7;0.0
27;2021-03-07;508;22;0;30114;16438;0;5.0;2.7;0.0
27;2021-03-08;1066;345;0;31180;16783;0;5.2;2.8;0.0
27;2021-03-09;1658;312;0;32838;17095;0;5.5;2.8;0.0
27;2021-03-10;1912;371;0;34750;17466;0;5.8;2.9;0.0
27;2021-03-11;1942;270;0;36692;17736;0;6.1;3.0;0.0
27;2021-03-12;2727;258;0;39419;17994;0;6.6;3.0;0.0
27;2021-03-13;1752;111;0;41171;18105;0;6.9;3.0;0.0
27;2021-03-14;544;17;0;41715;18122;0;6.9;3.0;0.0
27;2021-03-15;1418;216;0;43133;18338;0;7.2;3.1;0.0
27;2021-03-16;1311;245;0;44444;18583;0;7.4;3.1;0.0
27;2021-03-17;1505;334;0;45949;18917;0;7.6;3.1;0.0
27;2021-03-18;1400;344;0;47349;19261;0;7.9;3.2;0.0
27;2021-03-19;1656;193;0;49005;19454;0;8.2;3.2;0.0
27;2021-03-20;909;50;0;49914;19504;0;8.3;3.2;0.0
27;2021-03-21;296;6;0;50210;19510;0;8.4;3.2;0.0
27;2021-03-22;1290;420;0;51500;19930;0;8.6;3.3;0.0
27;2021-03-23;1769;394;0;53269;20324;0;8.9;3.4;0.0
27;2021-03-24;1677;375;0;54946;20699;0;9.1;3.4;0.0
27;2021-03-25;2231;394;0;57177;21093;0;9.5;3.5;0.0
27;2021-03-26;2800;358;0;59977;21451;0;10.0;3.6;0.0
27;2021-03-27;1645;162;0;61622;21613;0;10.3;3.6;0.0
27;2021-03-28;1047;41;0;62669;21654;0;10.4;3.6;0.0
27;2021-03-29;1675;653;0;64344;22307;0;10.7;3.7;0.0
27;2021-03-30;1744;724;0;66088;23031;0;11.0;3.8;0.0
27;2021-03-31;1830;745;0;67918;23776;0;11.3;4.0;0.0
27;2021-04-01;2416;711;0;70334;24487;0;11.7;4.1;0.0
27;2021-04-02;2276;998;0;72610;25485;0;12.1;4.2;0.0
27;2021-04-03;1570;576;0;74180;26061;0;12.3;4.3;0.0
27;2021-04-04;879;154;0;75059;26215;0;12.5;4.4;0.0
27;2021-04-05;427;35;0;75486;26250;0;12.6;4.4;0.0
27;2021-04-06;1668;1437;0;77154;27687;0;12.8;4.6;0.0
27;2021-04-07;1669;1458;0;78823;29145;0;13.1;4.9;0.0
27;2021-04-08;2137;1437;0;80960;30582;0;13.5;5.1;0.0
27;2021-04-09;3318;1354;0;84278;31936;0;14.0;5.3;0.0
27;2021-04-10;2244;830;0;86522;32766;0;14.4;5.5;0.0
27;2021-04-11;918;216;0;87440;32982;0;14.6;5.5;0.0
27;2021-04-12;2641;1318;0;90081;34300;0;15.0;5.7;0.0
27;2021-04-13;2656;1404;0;92737;35704;0;15.4;5.9;0.0
27;2021-04-14;2279;1338;0;95016;37042;0;15.8;6.2;0.0
27;2021-04-15;2155;1460;0;97171;38502;0;16.2;6.4;0.0
27;2021-04-16;3061;1099;0;100232;39601;0;16.7;6.6;0.0
27;2021-04-17;2192;471;0;102424;40072;0;17.1;6.7;0.0
27;2021-04-18;408;27;0;102832;40099;0;17.1;6.7;0.0
27;2021-04-19;1824;1256;0;104656;41355;0;17.4;6.9;0.0
27;2021-04-20;2426;1371;0;107082;42726;0;17.8;7.1;0.0
27;2021-04-21;2247;1264;0;109329;43990;0;18.2;7.3;0.0
27;2021-04-22;2300;1543;0;111629;45533;0;18.6;7.6;0.0
27;2021-04-23;2639;1378;0;114268;46911;0;19.0;7.8;0.0
27;2021-04-24;3193;1206;0;117461;48117;0;19.6;8.0;0.0
27;2021-04-25;920;942;0;118381;49059;0;19.7;8.2;0.0
27;2021-04-26;1992;1347;0;120373;50406;0;20.0;8.4;0.0
27;2021-04-27;2543;1405;0;122916;51811;0;20.5;8.6;0.0
27;2021-04-28;2488;1578;0;125404;53389;0;20.9;8.9;0.0
27;2021-04-29;2559;1738;0;127963;55127;0;21.3;9.2;0.0
27;2021-04-30;2631;1829;0;130594;56956;0;21.7;9.5;0.0
27;2021-05-01;2654;884;0;133248;57840;0;22.2;9.6;0.0
27;2021-05-02;1434;787;0;134682;58627;0;22.4;9.8;0.0
27;2021-05-03;2934;1205;0;137616;59832;0;22.9;10.0;0.0
27;2021-05-04;2783;1952;0;140399;61784;0;23.4;10.3;0.0
27;2021-05-05;2885;1961;0;143284;63745;0;23.9;10.6;0.0
27;2021-05-06;3168;1629;0;146452;65374;0;24.4;10.9;0.0
27;2021-05-07;3247;2343;0;149699;67717;0;24.9;11.3;0.0
27;2021-05-08;2756;1381;0;152455;69098;0;25.4;11.5;0.0
27;2021-05-09;1295;318;0;153750;69416;0;25.6;11.6;0.0
27;2021-05-10;2867;2486;0;156617;71902;0;26.1;12.0;0.0
27;2021-05-11;3237;2131;0;159854;74033;0;26.6;12.3;0.0
27;2021-05-12;3379;1884;0;163233;75917;0;27.2;12.6;0.0
27;2021-05-13;2391;361;0;165624;76278;0;27.6;12.7;0.0
27;2021-05-14;3799;1902;0;169423;78180;0;28.2;13.0;0.0
27;2021-05-15;5708;919;0;175131;79099;0;29.2;13.2;0.0
27;2021-05-16;2991;346;0;178122;79445;0;29.7;13.2;0.0
27;2021-05-17;2866;1322;0;180988;80767;0;30.1;13.4;0.0
27;2021-05-18;3721;1425;0;184709;82192;0;30.7;13.7;0.0
27;2021-05-19;3937;1254;0;188646;83446;0;31.4;13.9;0.0
27;2021-05-20;3964;1276;0;192610;84722;0;32.1;14.1;0.0
27;2021-05-21;3880;1837;0;196490;86559;0;32.7;14.4;0.0
27;2021-05-22;4144;843;0;200634;87402;0;33.4;14.6;0.0
27;2021-05-23;1073;173;0;201707;87575;0;33.6;14.6;0.0
27;2021-05-24;1826;411;0;203533;87986;0;33.9;14.6;0.0
27;2021-05-25;3308;1691;0;206841;89677;0;34.4;14.9;0.0
27;2021-05-26;3625;1811;0;210466;91488;0;35.0;15.2;0.0
27;2021-05-27;3604;1619;0;214070;93107;0;35.6;15.5;0.0
27;2021-05-28;3525;2727;0;217595;95834;0;36.2;16.0;0.0
27;2021-05-29;4192;2167;0;221787;98001;0;36.9;16.3;0.0
27;2021-05-30;984;247;0;222771;98248;0;37.1;16.4;0.0
27;2021-05-31;3300;2372;0;226071;100620;0;37.6;16.8;0.0
27;2021-06-01;3923;2307;0;229994;102927;0;38.3;17.1;0.0
27;2021-06-02;3518;2157;0;233512;105084;0;38.9;17.5;0.0
27;2021-06-03;4437;2147;0;237949;107231;0;39.6;17.9;0.0
27;2021-06-04;3778;3053;0;241727;110284;0;40.2;18.4;0.0
27;2021-06-05;3085;3153;0;244812;113437;0;40.8;18.9;0.0
27;2021-06-06;1542;760;0;246354;114197;0;41.0;19.0;0.0
27;2021-06-07;2954;2336;0;249308;116533;0;41.5;19.4;0.0
27;2021-06-08;3549;2463;0;252857;118996;0;42.1;19.8;0.0
27;2021-06-09;2629;2490;0;255486;121486;0;42.5;20.2;0.0
27;2021-06-10;2919;2154;0;258405;123640;0;43.0;20.6;0.0
27;2021-06-11;3461;3788;0;261866;127428;0;43.6;21.2;0.0
27;2021-06-12;2374;3964;0;264240;131392;0;44.0;21.9;0.0
27;2021-06-13;1089;2119;0;265329;133511;0;44.2;22.2;0.0
27;2021-06-14;2248;3178;0;267577;136689;0;44.5;22.8;0.0
27;2021-06-15;2933;3246;0;270510;139935;0;45.0;23.3;0.0
27;2021-06-16;2820;3366;0;273330;143301;0;45.5;23.9;0.0
27;2021-06-17;2674;3332;0;276004;146633;0;45.9;24.4;0.0
27;2021-06-18;3149;4433;0;279153;151066;0;46.5;25.1;0.0
27;2021-06-19;2221;2999;0;281374;154065;0;46.8;25.6;0.0
27;2021-06-20;668;710;0;282042;154775;0;47.0;25.8;0.0
27;2021-06-21;1922;3569;0;283964;158344;0;47.3;26.4;0.0
27;2021-06-22;2563;3881;0;286527;162225;0;47.7;27.0;0.0
27;2021-06-23;2111;3695;0;288638;165920;0;48.1;27.6;0.0
27;2021-06-24;2381;3459;0;291019;169379;0;48.4;28.2;0.0
27;2021-06-25;2104;4515;0;293123;173894;0;48.8;28.9;0.0
27;2021-06-26;1136;4921;0;294259;178815;0;49.0;29.8;0.0
27;2021-06-27;419;1551;0;294678;180366;0;49.1;30.0;0.0
27;2021-06-28;1436;3810;0;296114;184176;0;49.3;30.7;0.0
27;2021-06-29;1807;4537;0;297921;188713;0;49.6;31.4;0.0
27;2021-06-30;2205;4336;0;300126;193049;0;50.0;32.1;0.0
27;2021-07-01;2435;4036;0;302561;197085;0;50.4;32.8;0.0
27;2021-07-02;1769;5041;0;304330;202126;0;50.7;33.6;0.0
27;2021-07-03;1372;4618;0;305702;206744;0;50.9;34.4;0.0
27;2021-07-04;500;1543;0;306202;208287;0;51.0;34.7;0.0
27;2021-07-05;1719;3895;0;307921;212182;0;51.3;35.3;0.0
27;2021-07-06;1636;4238;0;309557;216420;0;51.5;36.0;0.0
27;2021-07-07;2010;4862;0;311567;221282;0;51.9;36.8;0.0
27;2021-07-08;2309;4402;0;313876;225684;0;52.3;37.6;0.0
27;2021-07-09;2263;5391;0;316139;231075;0;52.6;38.5;0.0
27;2021-07-10;1282;4243;0;317421;235318;0;52.8;39.2;0.0
27;2021-07-11;409;1033;0;317830;236351;0;52.9;39.3;0.0
27;2021-07-12;1385;4483;0;319215;240834;0;53.1;40.1;0.0
27;2021-07-13;2866;5558;0;322081;246392;0;53.6;41.0;0.0
27;2021-07-14;1881;2174;0;323962;248566;0;53.9;41.4;0.0
27;2021-07-15;3390;5619;0;327352;254185;0;54.5;42.3;0.0
27;2021-07-16;4012;5490;0;331364;259675;0;55.2;43.2;0.0
27;2021-07-17;3025;4008;0;334389;263683;0;55.7;43.9;0.0
27;2021-07-18;620;1167;0;335009;264850;0;55.8;44.1;0.0
27;2021-07-19;3403;4476;0;338412;269326;0;56.3;44.8;0.0
27;2021-07-20;3464;4334;0;341876;273660;0;56.9;45.6;0.0
27;2021-07-21;4056;4433;0;345932;278093;0;57.6;46.3;0.0
27;2021-07-22;4742;4325;0;350674;282418;0;58.4;47.0;0.0
27;2021-07-23;3963;4191;0;354637;286609;0;59.0;47.7;0.0
27;2021-07-24;3374;2761;0;358011;289370;0;59.6;48.2;0.0
27;2021-07-25;556;608;0;358567;289978;0;59.7;48.3;0.0
27;2021-07-26;3319;3833;0;361886;293811;0;60.2;48.9;0.0
27;2021-07-27;3908;3665;0;365794;297476;0;60.9;49.5;0.0
27;2021-07-28;3861;3669;0;369655;301145;0;61.5;50.1;0.0
27;2021-07-29;4855;3728;0;374510;304873;0;62.3;50.8;0.0
27;2021-07-30;4212;3696;0;378722;308569;0;63.0;51.4;0.0
27;2021-07-31;3212;2842;0;381934;311411;0;63.6;51.8;0.0
27;2021-08-01;572;581;0;382506;311992;0;63.7;51.9;0.0
27;2021-08-02;3500;2896;0;386006;314888;0;64.3;52.4;0.0
27;2021-08-03;3686;3049;0;389692;317937;0;64.9;52.9;0.0
27;2021-08-04;3468;2680;0;393160;320617;0;65.5;53.4;0.0
27;2021-08-05;3141;2800;0;396301;323417;0;66.0;53.8;0.0
27;2021-08-06;3593;3535;0;399894;326952;0;66.6;54.4;0.0
27;2021-08-07;2258;2648;0;402152;329600;0;66.9;54.9;0.0
27;2021-08-08;376;332;0;402528;329932;0;67.0;54.9;0.0
27;2021-08-09;2629;3312;0;405157;333244;0;67.4;55.5;0.0
27;2021-08-10;3022;3460;0;408179;336704;0;68.0;56.1;0.0
27;2021-08-11;2841;3028;0;411020;339732;0;68.4;56.6;0.0
27;2021-08-12;2560;3697;0;413580;343429;0;68.9;57.2;0.0
27;2021-08-13;2022;2945;0;415602;346374;0;69.2;57.7;0.0
27;2021-08-14;1336;2852;0;416938;349226;0;69.4;58.1;0.0
27;2021-08-15;114;134;0;417052;349360;0;69.4;58.2;0.0
27;2021-08-16;1867;3994;0;418919;353354;0;69.7;58.8;0.0
27;2021-08-17;2023;3597;0;420942;356951;0;70.1;59.4;0.0
27;2021-08-18;1745;3294;0;422687;360245;0;70.4;60.0;0.0
27;2021-08-19;1839;3671;0;424526;363916;0;70.7;60.6;0.0
27;2021-08-20;1699;3788;0;426225;367704;0;71.0;61.2;0.0
27;2021-08-21;1078;2792;0;427303;370496;0;71.1;61.7;0.0
27;2021-08-22;201;323;0;427504;370819;0;71.2;61.7;0.0
27;2021-08-23;1226;3960;0;428730;374779;0;71.4;62.4;0.0
27;2021-08-24;1470;3991;0;430200;378770;0;71.6;63.1;0.0
27;2021-08-25;1598;3496;0;431798;382266;0;71.9;63.6;0.0
27;2021-08-26;1185;3078;0;432983;385344;0;72.1;64.2;0.0
27;2021-08-27;1302;3632;0;434285;388976;0;72.3;64.8;0.0
27;2021-08-28;969;2993;0;435254;391969;0;72.5;65.3;0.0
27;2021-08-29;114;316;0;435368;392285;0;72.5;65.3;0.0
27;2021-08-30;1008;3656;39;436376;395941;39;72.6;65.9;0.0
27;2021-08-31;1256;3536;113;437632;399477;152;72.9;66.5;0.0
27;2021-09-01;1153;3189;238;438785;402666;390;73.0;67.0;0.1
27;2021-09-02;929;2428;267;439714;405094;657;73.2;67.4;0.1
27;2021-09-03;924;2507;286;440638;407601;943;73.4;67.9;0.2
27;2021-09-04;792;2093;136;441430;409694;1079;73.5;68.2;0.2
27;2021-09-05;85;260;11;441515;409954;1090;73.5;68.2;0.2
27;2021-09-06;617;1719;351;442132;411673;1441;73.6;68.5;0.2
27;2021-09-07;714;2115;267;442846;413788;1708;73.7;68.9;0.3
27;2021-09-08;788;2329;289;443634;416117;1997;73.9;69.3;0.3
27;2021-09-09;665;1718;267;444299;417835;2264;74.0;69.6;0.4
27;2021-09-10;904;2048;438;445203;419883;2702;74.1;69.9;0.4
27;2021-09-11;619;1870;130;445822;421753;2832;74.2;70.2;0.5
27;2021-09-12;67;209;14;445889;421962;2846;74.2;70.2;0.5
27;2021-09-13;441;1134;406;446330;423096;3252;74.3;70.4;0.5
27;2021-09-14;615;1152;427;446945;424248;3679;74.4;70.6;0.6
27;2021-09-15;606;1715;380;447551;425963;4059;74.5;70.9;0.7
27;2021-09-16;596;1148;377;448147;427111;4436;74.6;71.1;0.7
27;2021-09-17;773;1401;399;448920;428512;4835;74.7;71.3;0.8
27;2021-09-18;362;1283;154;449282;429795;4989;74.8;71.6;0.8
27;2021-09-19;59;193;26;449341;429988;5015;74.8;71.6;0.8
27;2021-09-20;305;912;496;449646;430900;5511;74.9;71.7;0.9
27;2021-09-21;412;966;474;450058;431866;5985;74.9;71.9;1.0
27;2021-09-22;326;1148;445;450384;433014;6430;75.0;72.1;1.1
27;2021-09-23;387;795;723;450771;433809;7153;75.0;72.2;1.2
27;2021-09-24;623;1264;518;451394;435073;7671;75.1;72.4;1.3
27;2021-09-25;278;1101;186;451672;436174;7857;75.2;72.6;1.3
27;2021-09-26;18;33;21;451690;436207;7878;75.2;72.6;1.3
27;2021-09-27;216;589;417;451906;436796;8295;75.2;72.7;1.4
27;2021-09-28;314;772;579;452220;437568;8874;75.3;72.8;1.5
27;2021-09-29;266;791;397;452486;438359;9271;75.3;73.0;1.5
27;2021-09-30;172;550;329;452658;438909;9600;75.4;73.1;1.6
27;2021-10-01;452;994;596;453110;439903;10196;75.4;73.2;1.7
27;2021-10-02;363;828;313;453473;440731;10509;75.5;73.4;1.7
27;2021-10-03;14;28;28;453487;440759;10537;75.5;73.4;1.8
27;2021-10-04;242;431;472;453729;441190;11009;75.5;73.4;1.8
27;2021-10-05;316;513;598;454045;441703;11607;75.6;73.5;1.9
27;2021-10-06;308;678;598;454353;442381;12205;75.6;73.6;2.0
27;2021-10-07;162;321;473;454515;442702;12678;75.7;73.7;2.1
27;2021-10-08;367;826;928;454882;443528;13606;75.7;73.8;2.3
27;2021-10-09;283;559;314;455165;444087;13920;75.8;73.9;2.3
27;2021-10-10;18;49;21;455183;444136;13941;75.8;73.9;2.3
27;2021-10-11;225;429;412;455408;444565;14353;75.8;74.0;2.4
27;2021-10-12;271;442;925;455679;445007;15278;75.9;74.1;2.5
27;2021-10-13;308;462;661;455987;445469;15939;75.9;74.2;2.7
27;2021-10-14;159;399;617;456146;445868;16556;75.9;74.2;2.8
27;2021-10-15;392;810;976;456538;446678;17532;76.0;74.4;2.9
27;2021-10-16;323;455;545;456861;447133;18077;76.1;74.4;3.0
27;2021-10-17;27;36;43;456888;447169;18120;76.1;74.4;3.0
27;2021-10-18;210;293;556;457098;447462;18676;76.1;74.5;3.1
27;2021-10-19;220;373;884;457318;447835;19560;76.1;74.6;3.3
27;2021-10-20;255;373;784;457573;448208;20344;76.2;74.6;3.4
27;2021-10-21;165;391;939;457738;448599;21283;76.2;74.7;3.5
27;2021-10-22;279;503;1194;458017;449102;22477;76.2;74.8;3.7
27;2021-10-23;211;436;481;458228;449538;22958;76.3;74.8;3.8
27;2021-10-24;7;12;35;458235;449550;22993;76.3;74.8;3.8
27;2021-10-25;167;215;645;458402;449765;23638;76.3;74.9;3.9
27;2021-10-26;174;252;850;458576;450017;24488;76.3;74.9;4.1
27;2021-10-27;189;320;822;458765;450337;25310;76.4;75.0;4.2
27;2021-10-28;139;176;745;458904;450513;26055;76.4;75.0;4.3
27;2021-10-29;257;440;1256;459161;450953;27311;76.4;75.1;4.5
27;2021-10-30;156;231;438;459317;451184;27749;76.5;75.1;4.6
27;2021-10-31;6;13;13;459323;451197;27762;76.5;75.1;4.6
27;2021-11-01;17;13;22;459340;451210;27784;76.5;75.1;4.6
27;2021-11-02;195;289;855;459535;451499;28639;76.5;75.2;4.8
27;2021-11-03;187;362;1079;459722;451861;29718;76.5;75.2;4.9
27;2021-11-04;167;201;751;459889;452062;30469;76.6;75.3;5.1
27;2021-11-05;255;346;1475;460144;452408;31944;76.6;75.3;5.3
27;2021-11-06;202;358;695;460346;452766;32639;76.6;75.4;5.4
27;2021-11-07;22;30;83;460368;452796;32722;76.6;75.4;5.4
27;2021-11-08;127;208;1044;460495;453004;33766;76.7;75.4;5.6
27;2021-11-09;181;284;1434;460676;453288;35200;76.7;75.5;5.9
27;2021-11-10;241;324;1719;460917;453612;36919;76.7;75.5;6.1
27;2021-11-11;10;12;35;460927;453624;36954;76.7;75.5;6.2
27;2021-11-12;219;290;1624;461146;453914;38578;76.8;75.6;6.4
27;2021-11-13;198;260;893;461344;454174;39471;76.8;75.6;6.6
27;2021-11-14;11;19;51;461355;454193;39522;76.8;75.6;6.6
27;2021-11-15;128;181;1328;461483;454374;40850;76.8;75.6;6.8
27;2021-11-16;182;231;2413;461665;454605;43263;76.9;75.7;7.2
27;2021-11-17;231;247;1909;461896;454852;45172;76.9;75.7;7.5
27;2021-11-18;148;133;1390;462044;454985;46562;76.9;75.7;7.8
27;2021-11-19;230;274;2213;462274;455259;48775;77.0;75.8;8.1
27;2021-11-20;234;269;914;462508;455528;49689;77.0;75.8;8.3
27;2021-11-21;3;7;69;462511;455535;49758;77.0;75.8;8.3
27;2021-11-22;187;108;1644;462698;455643;51402;77.0;75.9;8.6
27;2021-11-23;229;195;2497;462927;455838;53899;77.1;75.9;9.0
27;2021-11-24;257;277;2253;463184;456115;56152;77.1;75.9;9.3
27;2021-11-25;124;123;1751;463308;456238;57903;77.1;76.0;9.6
27;2021-11-26;232;298;3275;463540;456536;61178;77.2;76.0;10.2
27;2021-11-27;197;261;1714;463737;456797;62892;77.2;76.0;10.5
27;2021-11-28;9;16;149;463746;456813;63041;77.2;76.0;10.5
27;2021-11-29;141;137;2921;463887;456950;65962;77.2;76.1;11.0
27;2021-11-30;184;193;5104;464071;457143;71066;77.3;76.1;11.8
27;2021-12-01;185;222;4646;464256;457365;75712;77.3;76.1;12.6
27;2021-12-02;165;100;4428;464421;457465;80140;77.3;76.2;13.3
27;2021-12-03;167;247;5782;464588;457712;85922;77.3;76.2;14.3
27;2021-12-04;204;280;4472;464792;457992;90394;77.4;76.2;15.0
27;2021-12-05;31;36;1178;464823;458028;91572;77.4;76.3;15.2
27;2021-12-06;111;171;4837;464934;458199;96409;77.4;76.3;16.0
27;2021-12-07;148;196;6931;465082;458395;103340;77.4;76.3;17.2
27;2021-12-08;165;235;5765;465247;458630;109105;77.5;76.4;18.2
27;2021-12-09;161;151;7261;465408;458781;116366;77.5;76.4;19.4
27;2021-12-10;160;213;7206;465568;458994;123572;77.5;76.4;20.6
27;2021-12-11;194;288;5259;465762;459282;128831;77.5;76.5;21.4
27;2021-12-12;39;29;1273;465801;459311;130104;77.5;76.5;21.7
27;2021-12-13;117;185;5338;465918;459496;135442;77.6;76.5;22.5
27;2021-12-14;176;267;7680;466094;459763;143122;77.6;76.5;23.8
27;2021-12-15;156;265;5919;466250;460028;149041;77.6;76.6;24.8
27;2021-12-16;214;232;7626;466464;460260;156667;77.7;76.6;26.1
28;2020-12-27;0;0;0;0;0;0;0.0;0.0;0.0
28;2020-12-28;0;0;0;0;0;0;0.0;0.0;0.0
28;2020-12-29;0;0;0;0;0;0;0.0;0.0;0.0
28;2020-12-30;1;0;0;1;0;0;0.0;0.0;0.0
28;2020-12-31;0;0;0;1;0;0;0.0;0.0;0.0
28;2021-01-01;1;0;0;2;0;0;0.0;0.0;0.0
28;2021-01-02;0;0;0;2;0;0;0.0;0.0;0.0
28;2021-01-03;0;0;0;2;0;0;0.0;0.0;0.0
28;2021-01-04;3;0;0;5;0;0;0.0;0.0;0.0
28;2021-01-05;14;0;0;19;0;0;0.0;0.0;0.0
28;2021-01-06;84;0;0;103;0;0;0.0;0.0;0.0
28;2021-01-07;116;0;0;219;0;0;0.1;0.0;0.0
28;2021-01-08;157;2;0;376;2;0;0.1;0.0;0.0
28;2021-01-09;78;0;0;454;2;0;0.1;0.0;0.0
28;2021-01-10;7;0;0;461;2;0;0.1;0.0;0.0
28;2021-01-11;196;1;0;657;3;0;0.2;0.0;0.0
28;2021-01-12;287;2;0;944;5;0;0.2;0.0;0.0
28;2021-01-13;391;3;0;1335;8;0;0.3;0.0;0.0
28;2021-01-14;449;6;0;1784;14;0;0.4;0.0;0.0
28;2021-01-15;403;4;0;2187;18;0;0.5;0.0;0.0
28;2021-01-16;191;2;0;2378;20;0;0.6;0.0;0.0
28;2021-01-17;34;0;0;2412;20;0;0.6;0.0;0.0
28;2021-01-18;416;2;0;2828;22;0;0.7;0.0;0.0
28;2021-01-19;504;3;0;3332;25;0;0.8;0.0;0.0
28;2021-01-20;644;3;0;3976;28;0;0.9;0.0;0.0
28;2021-01-21;826;3;0;4802;31;0;1.1;0.0;0.0
28;2021-01-22;517;2;0;5319;33;0;1.2;0.0;0.0
28;2021-01-23;307;0;0;5626;33;0;1.3;0.0;0.0
28;2021-01-24;11;0;0;5637;33;0;1.3;0.0;0.0
28;2021-01-25;454;5;0;6091;38;0;1.4;0.0;0.0
28;2021-01-26;686;10;0;6777;48;0;1.6;0.0;0.0
28;2021-01-27;1124;54;0;7901;102;0;1.8;0.0;0.0
28;2021-01-28;1460;97;0;9361;199;0;2.2;0.0;0.0
28;2021-01-29;841;101;0;10202;300;0;2.4;0.1;0.0
28;2021-01-30;225;54;0;10427;354;0;2.4;0.1;0.0
28;2021-01-31;1;21;0;10428;375;0;2.4;0.1;0.0
28;2021-02-01;341;97;0;10769;472;0;2.5;0.1;0.0
28;2021-02-02;378;203;0;11147;675;0;2.6;0.2;0.0
28;2021-02-03;466;247;0;11613;922;0;2.7;0.2;0.0
28;2021-02-04;475;252;0;12088;1174;0;2.8;0.3;0.0
28;2021-02-05;405;227;0;12493;1401;0;2.9;0.3;0.0
28;2021-02-06;197;118;0;12690;1519;0;3.0;0.4;0.0
28;2021-02-07;4;4;0;12694;1523;0;3.0;0.4;0.0
28;2021-02-08;314;237;0;13008;1760;0;3.0;0.4;0.0
28;2021-02-09;305;350;0;13313;2110;0;3.1;0.5;0.0
28;2021-02-10;463;424;0;13776;2534;0;3.2;0.6;0.0
28;2021-02-11;575;535;0;14351;3069;0;3.3;0.7;0.0
28;2021-02-12;464;414;0;14815;3483;0;3.4;0.8;0.0
28;2021-02-13;146;192;0;14961;3675;0;3.5;0.9;0.0
28;2021-02-14;0;11;0;14961;3686;0;3.5;0.9;0.0
28;2021-02-15;301;475;0;15262;4161;0;3.6;1.0;0.0
28;2021-02-16;379;704;0;15641;4865;0;3.6;1.1;0.0
28;2021-02-17;566;1078;0;16207;5943;0;3.8;1.4;0.0
28;2021-02-18;694;1393;0;16901;7336;0;3.9;1.7;0.0
28;2021-02-19;577;773;0;17478;8109;0;4.1;1.9;0.0
28;2021-02-20;113;152;0;17591;8261;0;4.1;1.9;0.0
28;2021-02-21;6;35;0;17597;8296;0;4.1;1.9;0.0
28;2021-02-22;248;492;0;17845;8788;0;4.2;2.0;0.0
28;2021-02-23;219;430;0;18064;9218;0;4.2;2.1;0.0
28;2021-02-24;279;463;0;18343;9681;0;4.3;2.3;0.0
28;2021-02-25;567;441;0;18910;10122;0;4.4;2.4;0.0
28;2021-02-26;754;379;0;19664;10501;0;4.6;2.4;0.0
28;2021-02-27;277;76;0;19941;10577;0;4.6;2.5;0.0
28;2021-02-28;22;22;0;19963;10599;0;4.6;2.5;0.0
28;2021-03-01;307;247;0;20270;10846;0;4.7;2.5;0.0
28;2021-03-02;421;300;0;20691;11146;0;4.8;2.6;0.0
28;2021-03-03;440;398;0;21131;11544;0;4.9;2.7;0.0
28;2021-03-04;721;425;0;21852;11969;0;5.1;2.8;0.0
28;2021-03-05;1377;388;0;23229;12357;0;5.4;2.9;0.0
28;2021-03-06;2025;104;0;25254;12461;0;5.9;2.9;0.0
28;2021-03-07;981;46;0;26235;12507;0;6.1;2.9;0.0
28;2021-03-08;448;296;0;26683;12803;0;6.2;3.0;0.0
28;2021-03-09;1030;330;0;27713;13133;0;6.5;3.1;0.0
28;2021-03-10;1386;545;0;29099;13678;0;6.8;3.2;0.0
28;2021-03-11;1558;670;0;30657;14348;0;7.1;3.3;0.0
28;2021-03-12;2314;591;0;32971;14939;0;7.7;3.5;0.0
28;2021-03-13;1124;82;0;34095;15021;0;7.9;3.5;0.0
28;2021-03-14;505;23;0;34600;15044;0;8.1;3.5;0.0
28;2021-03-15;828;244;0;35428;15288;0;8.3;3.6;0.0
28;2021-03-16;778;230;0;36206;15518;0;8.4;3.6;0.0
28;2021-03-17;801;300;0;37007;15818;0;8.6;3.7;0.0
28;2021-03-18;1222;276;0;38229;16094;0;8.9;3.7;0.0
28;2021-03-19;1587;318;0;39816;16412;0;9.3;3.8;0.0
28;2021-03-20;684;28;0;40500;16440;0;9.4;3.8;0.0
28;2021-03-21;18;9;0;40518;16449;0;9.4;3.8;0.0
28;2021-03-22;865;333;0;41383;16782;0;9.6;3.9;0.0
28;2021-03-23;1135;206;0;42518;16988;0;9.9;4.0;0.0
28;2021-03-24;1373;265;0;43891;17253;0;10.2;4.0;0.0
28;2021-03-25;1810;294;0;45701;17547;0;10.6;4.1;0.0
28;2021-03-26;2196;344;0;47897;17891;0;11.2;4.2;0.0
28;2021-03-27;499;50;0;48396;17941;0;11.3;4.2;0.0
28;2021-03-28;41;3;0;48437;17944;0;11.3;4.2;0.0
28;2021-03-29;1175;385;0;49612;18329;0;11.6;4.3;0.0
28;2021-03-30;1794;279;0;51406;18608;0;12.0;4.3;0.0
28;2021-03-31;2019;477;0;53425;19085;0;12.4;4.4;0.0
28;2021-04-01;1918;629;0;55343;19714;0;12.9;4.6;0.0
28;2021-04-02;1672;1329;0;57015;21043;0;13.3;4.9;0.0
28;2021-04-03;636;1072;0;57651;22115;0;13.4;5.1;0.0
28;2021-04-04;58;307;0;57709;22422;0;13.4;5.2;0.0
28;2021-04-05;66;4;0;57775;22426;0;13.5;5.2;0.0
28;2021-04-06;1242;555;0;59017;22981;0;13.7;5.4;0.0
28;2021-04-07;1851;1051;0;60868;24032;0;14.2;5.6;0.0
28;2021-04-08;2111;1116;0;62979;25148;0;14.7;5.9;0.0
28;2021-04-09;3271;941;0;66250;26089;0;15.4;6.1;0.0
28;2021-04-10;1655;196;0;67905;26285;0;15.8;6.1;0.0
28;2021-04-11;157;441;0;68062;26726;0;15.8;6.2;0.0
28;2021-04-12;1692;637;0;69754;27363;0;16.2;6.4;0.0
28;2021-04-13;1995;732;0;71749;28095;0;16.7;6.5;0.0
28;2021-04-14;2858;964;0;74607;29059;0;17.4;6.8;0.0
28;2021-04-15;2563;1214;0;77170;30273;0;18.0;7.0;0.0
28;2021-04-16;2524;887;0;79694;31160;0;18.6;7.3;0.0
28;2021-04-17;2232;188;0;81926;31348;0;19.1;7.3;0.0
28;2021-04-18;48;9;0;81974;31357;0;19.1;7.3;0.0
28;2021-04-19;1558;714;0;83532;32071;0;19.5;7.5;0.0
28;2021-04-20;1824;728;0;85356;32799;0;19.9;7.6;0.0
28;2021-04-21;2602;972;0;87958;33771;0;20.5;7.9;0.0
28;2021-04-22;1836;1239;0;89794;35010;0;20.9;8.2;0.0
28;2021-04-23;2337;1146;0;92131;36156;0;21.5;8.4;0.0
28;2021-04-24;3453;208;0;95584;36364;0;22.3;8.5;0.0
28;2021-04-25;901;71;0;96485;36435;0;22.5;8.5;0.0
28;2021-04-26;1345;947;0;97830;37382;0;22.8;8.7;0.0
28;2021-04-27;1520;1386;0;99350;38768;0;23.1;9.0;0.0
28;2021-04-28;2450;1795;0;101800;40563;0;23.7;9.4;0.0
28;2021-04-29;2261;1499;0;104061;42062;0;24.2;9.8;0.0
28;2021-04-30;3069;1257;0;107130;43319;0;24.9;10.1;0.0
28;2021-05-01;251;141;0;107381;43460;0;25.0;10.1;0.0
28;2021-05-02;188;103;0;107569;43563;0;25.0;10.1;0.0
28;2021-05-03;1321;1077;0;108890;44640;0;25.4;10.4;0.0
28;2021-05-04;1593;1692;0;110483;46332;0;25.7;10.8;0.0
28;2021-05-05;3037;1666;0;113520;47998;0;26.4;11.2;0.0
28;2021-05-06;2620;1481;0;116140;49479;0;27.0;11.5;0.0
28;2021-05-07;2442;1990;0;118582;51469;0;27.6;12.0;0.0
28;2021-05-08;1445;161;0;120027;51630;0;28.0;12.0;0.0
28;2021-05-09;237;624;0;120264;52254;0;28.0;12.2;0.0
28;2021-05-10;1524;1929;0;121788;54183;0;28.4;12.6;0.0
28;2021-05-11;2238;2346;0;124026;56529;0;28.9;13.2;0.0
28;2021-05-12;2731;3185;0;126757;59714;0;29.5;13.9;0.0
28;2021-05-13;696;449;0;127453;60163;0;29.7;14.0;0.0
28;2021-05-14;2158;1574;0;129611;61737;0;30.2;14.4;0.0
28;2021-05-15;1580;1629;0;131191;63366;0;30.6;14.8;0.0
28;2021-05-16;1970;142;0;133161;63508;0;31.0;14.8;0.0
28;2021-05-17;2779;1478;0;135940;64986;0;31.7;15.1;0.0
28;2021-05-18;3188;1339;0;139128;66325;0;32.4;15.4;0.0
28;2021-05-19;4661;1321;0;143789;67646;0;33.5;15.8;0.0
28;2021-05-20;3957;1266;0;147746;68912;0;34.4;16.0;0.0
28;2021-05-21;3321;1594;0;151067;70506;0;35.2;16.4;0.0
28;2021-05-22;878;1145;0;151945;71651;0;35.4;16.7;0.0
28;2021-05-23;1903;137;0;153848;71788;0;35.8;16.7;0.0
28;2021-05-24;1663;390;0;155511;72178;0;36.2;16.8;0.0
28;2021-05-25;2016;1428;0;157527;73606;0;36.7;17.1;0.0
28;2021-05-26;2675;1370;0;160202;74976;0;37.3;17.5;0.0
28;2021-05-27;2908;1268;0;163110;76244;0;38.0;17.8;0.0
28;2021-05-28;3187;1833;0;166297;78077;0;38.7;18.2;0.0
28;2021-05-29;2029;946;0;168326;79023;0;39.2;18.4;0.0
28;2021-05-30;76;60;0;168402;79083;0;39.2;18.4;0.0
28;2021-05-31;2336;1010;0;170738;80093;0;39.8;18.7;0.0
28;2021-06-01;2632;1762;0;173370;81855;0;40.4;19.1;0.0
28;2021-06-02;2443;2466;0;175813;84321;0;40.9;19.6;0.0
28;2021-06-03;2909;1650;0;178722;85971;0;41.6;20.0;0.0
28;2021-06-04;2808;2452;0;181530;88423;0;42.3;20.6;0.0
28;2021-06-05;2001;2493;0;183531;90916;0;42.7;21.2;0.0
28;2021-06-06;1077;946;0;184608;91862;0;43.0;21.4;0.0
28;2021-06-07;3478;1690;0;188086;93552;0;43.8;21.8;0.0
28;2021-06-08;3230;1650;0;191316;95202;0;44.6;22.2;0.0
28;2021-06-09;3724;2249;0;195040;97451;0;45.4;22.7;0.0
28;2021-06-10;3162;1477;0;198202;98928;0;46.2;23.0;0.0
28;2021-06-11;3738;2309;0;201940;101237;0;47.0;23.6;0.0
28;2021-06-12;1300;679;0;203240;101916;0;47.3;23.7;0.0
28;2021-06-13;389;230;0;203629;102146;0;47.4;23.8;0.0
28;2021-06-14;2152;2276;0;205781;104422;0;47.9;24.3;0.0
28;2021-06-15;2080;2467;0;207861;106889;0;48.4;24.9;0.0
28;2021-06-16;2486;4039;0;210347;110928;0;49.0;25.8;0.0
28;2021-06-17;1979;3231;0;212326;114159;0;49.4;26.6;0.0
28;2021-06-18;2461;3835;0;214787;117994;0;50.0;27.5;0.0
28;2021-06-19;819;1881;0;215606;119875;0;50.2;27.9;0.0
28;2021-06-20;60;150;0;215666;120025;0;50.2;28.0;0.0
28;2021-06-21;1684;2226;0;217350;122251;0;50.6;28.5;0.0
28;2021-06-22;1350;2387;0;218700;124638;0;50.9;29.0;0.0
28;2021-06-23;1721;3212;0;220421;127850;0;51.3;29.8;0.0
28;2021-06-24;814;1333;0;221235;129183;0;51.5;30.1;0.0
28;2021-06-25;1871;3253;0;223106;132436;0;52.0;30.8;0.0
28;2021-06-26;403;2134;0;223509;134570;0;52.0;31.3;0.0
28;2021-06-27;499;1195;0;224008;135765;0;52.2;31.6;0.0
28;2021-06-28;1181;3571;0;225189;139336;0;52.4;32.4;0.0
28;2021-06-29;1266;3674;0;226455;143010;0;52.7;33.3;0.0
28;2021-06-30;1421;3999;0;227876;147009;0;53.1;34.2;0.0
28;2021-07-01;1242;3397;0;229118;150406;0;53.4;35.0;0.0
28;2021-07-02;1323;4504;0;230441;154910;0;53.7;36.1;0.0
28;2021-07-03;1106;2439;0;231547;157349;0;53.9;36.6;0.0
28;2021-07-04;184;1267;0;231731;158616;0;54.0;36.9;0.0
28;2021-07-05;1342;2786;0;233073;161402;0;54.3;37.6;0.0
28;2021-07-06;1528;3073;0;234601;164475;0;54.6;38.3;0.0
28;2021-07-07;1556;4024;0;236157;168499;0;55.0;39.2;0.0
28;2021-07-08;1486;3377;0;237643;171876;0;55.3;40.0;0.0
28;2021-07-09;1326;4618;0;238969;176494;0;55.6;41.1;0.0
28;2021-07-10;484;2265;0;239453;178759;0;55.8;41.6;0.0
28;2021-07-11;45;95;0;239498;178854;0;55.8;41.6;0.0
28;2021-07-12;1306;4023;0;240804;182877;0;56.1;42.6;0.0
28;2021-07-13;2004;4284;0;242808;187161;0;56.5;43.6;0.0
28;2021-07-14;1160;1431;0;243968;188592;0;56.8;43.9;0.0
28;2021-07-15;2589;4034;0;246557;192626;0;57.4;44.9;0.0
28;2021-07-16;2288;4813;0;248845;197439;0;57.9;46.0;0.0
28;2021-07-17;1375;2506;0;250220;199945;0;58.3;46.6;0.0
28;2021-07-18;396;954;0;250616;200899;0;58.4;46.8;0.0
28;2021-07-19;1766;4178;0;252382;205077;0;58.8;47.8;0.0
28;2021-07-20;2388;4040;0;254770;209117;0;59.3;48.7;0.0
28;2021-07-21;2749;4325;0;257519;213442;0;60.0;49.7;0.0
28;2021-07-22;3382;3542;0;260901;216984;0;60.8;50.5;0.0
28;2021-07-23;2904;3953;0;263805;220937;0;61.4;51.4;0.0
28;2021-07-24;1790;1423;0;265595;222360;0;61.8;51.8;0.0
28;2021-07-25;146;109;0;265741;222469;0;61.9;51.8;0.0
28;2021-07-26;2745;3200;0;268486;225669;0;62.5;52.6;0.0
28;2021-07-27;3528;2577;0;272014;228246;0;63.3;53.2;0.0
28;2021-07-28;3723;2626;0;275737;230872;0;64.2;53.8;0.0
28;2021-07-29;4025;2118;0;279762;232990;0;65.1;54.3;0.0
28;2021-07-30;3520;2764;0;283282;235754;0;66.0;54.9;0.0
28;2021-07-31;891;810;0;284173;236564;0;66.2;55.1;0.0
28;2021-08-01;410;97;0;284583;236661;0;66.3;55.1;0.0
28;2021-08-02;1715;1448;0;286298;238109;0;66.7;55.4;0.0
28;2021-08-03;2549;2030;0;288847;240139;0;67.3;55.9;0.0
28;2021-08-04;2024;2114;0;290871;242253;0;67.7;56.4;0.0
28;2021-08-05;1807;1773;0;292678;244026;0;68.2;56.8;0.0
28;2021-08-06;1745;2064;0;294423;246090;0;68.6;57.3;0.0
28;2021-08-07;893;1143;0;295316;247233;0;68.8;57.6;0.0
28;2021-08-08;84;97;0;295400;247330;0;68.8;57.6;0.0
28;2021-08-09;1408;1303;0;296808;248633;0;69.1;57.9;0.0
28;2021-08-10;1818;2017;0;298626;250650;0;69.5;58.4;0.0
28;2021-08-11;1408;1821;0;300034;252471;0;69.9;58.8;0.0
28;2021-08-12;1351;2064;0;301385;254535;0;70.2;59.3;0.0
28;2021-08-13;1416;1808;0;302801;256343;0;70.5;59.7;0.0
28;2021-08-14;727;1009;0;303528;257352;0;70.7;59.9;0.0
28;2021-08-15;254;100;0;303782;257452;0;70.7;60.0;0.0
28;2021-08-16;958;2080;0;304740;259532;0;71.0;60.4;0.0
28;2021-08-17;1188;2756;0;305928;262288;0;71.2;61.1;0.0
28;2021-08-18;911;2498;0;306839;264786;0;71.5;61.7;0.0
28;2021-08-19;931;2638;0;307770;267424;0;71.7;62.3;0.0
28;2021-08-20;929;2709;0;308699;270133;0;71.9;62.9;0.0
28;2021-08-21;440;1195;0;309139;271328;0;72.0;63.2;0.0
28;2021-08-22;38;102;0;309177;271430;0;72.0;63.2;0.0
28;2021-08-23;986;2060;0;310163;273490;0;72.2;63.7;0.0
28;2021-08-24;872;2595;0;311035;276085;0;72.4;64.3;0.0
28;2021-08-25;997;2237;0;312032;278322;0;72.7;64.8;0.0
28;2021-08-26;732;1984;0;312764;280306;0;72.8;65.3;0.0
28;2021-08-27;788;2426;0;313552;282732;0;73.0;65.8;0.0
28;2021-08-28;546;1249;0;314098;283981;0;73.1;66.1;0.0
28;2021-08-29;43;81;0;314141;284062;0;73.2;66.1;0.0
28;2021-08-30;928;2030;23;315069;286092;23;73.4;66.6;0.0
28;2021-08-31;745;2205;54;315814;288297;77;73.5;67.1;0.0
28;2021-09-01;754;2287;173;316568;290584;250;73.7;67.7;0.1
28;2021-09-02;582;1986;170;317150;292570;420;73.9;68.1;0.1
28;2021-09-03;724;2323;210;317874;294893;630;74.0;68.7;0.1
28;2021-09-04;611;2313;95;318485;297206;725;74.2;69.2;0.2
28;2021-09-05;178;145;97;318663;297351;822;74.2;69.2;0.2
28;2021-09-06;441;1300;241;319104;298651;1063;74.3;69.5;0.2
28;2021-09-07;385;1377;165;319489;300028;1228;74.4;69.9;0.3
28;2021-09-08;554;1392;180;320043;301420;1408;74.5;70.2;0.3
28;2021-09-09;344;1047;166;320387;302467;1574;74.6;70.4;0.4
28;2021-09-10;606;1381;242;320993;303848;1816;74.7;70.8;0.4
28;2021-09-11;332;1217;75;321325;305065;1891;74.8;71.0;0.4
28;2021-09-12;53;58;29;321378;305123;1920;74.8;71.1;0.4
28;2021-09-13;327;714;308;321705;305837;2228;74.9;71.2;0.5
28;2021-09-14;363;895;341;322068;306732;2569;75.0;71.4;0.6
28;2021-09-15;539;1034;392;322607;307766;2961;75.1;71.7;0.7
28;2021-09-16;277;735;404;322884;308501;3365;75.2;71.8;0.8
28;2021-09-17;319;1042;391;323203;309543;3756;75.3;72.1;0.9
28;2021-09-18;180;359;83;323383;309902;3839;75.3;72.2;0.9
28;2021-09-19;15;29;5;323398;309931;3844;75.3;72.2;0.9
28;2021-09-20;167;487;298;323565;310418;4142;75.3;72.3;1.0
28;2021-09-21;321;874;437;323886;311292;4579;75.4;72.5;1.1
28;2021-09-22;330;977;522;324216;312269;5101;75.5;72.7;1.2
28;2021-09-23;189;498;492;324405;312767;5593;75.5;72.8;1.3
28;2021-09-24;257;967;405;324662;313734;5998;75.6;73.1;1.4
28;2021-09-25;134;423;129;324796;314157;6127;75.6;73.2;1.4
28;2021-09-26;22;49;15;324818;314206;6142;75.6;73.2;1.4
28;2021-09-27;165;680;364;324983;314886;6506;75.7;73.3;1.5
28;2021-09-28;172;466;629;325155;315352;7135;75.7;73.4;1.7
28;2021-09-29;363;733;399;325518;316085;7534;75.8;73.6;1.8
28;2021-09-30;238;452;711;325756;316537;8245;75.9;73.7;1.9
28;2021-10-01;302;697;485;326058;317234;8730;75.9;73.9;2.0
28;2021-10-02;120;222;76;326178;317456;8806;76.0;73.9;2.1
28;2021-10-03;8;22;4;326186;317478;8810;76.0;73.9;2.1
28;2021-10-04;158;255;447;326344;317733;9257;76.0;74.0;2.2
28;2021-10-05;175;394;581;326519;318127;9838;76.0;74.1;2.3
28;2021-10-06;221;626;504;326740;318753;10342;76.1;74.2;2.4
28;2021-10-07;136;294;490;326876;319047;10832;76.1;74.3;2.5
28;2021-10-08;260;516;544;327136;319563;11376;76.2;74.4;2.6
28;2021-10-09;98;204;164;327234;319767;11540;76.2;74.5;2.7
28;2021-10-10;12;26;14;327246;319793;11554;76.2;74.5;2.7
28;2021-10-11;166;226;440;327412;320019;11994;76.2;74.5;2.8
28;2021-10-12;174;322;534;327586;320341;12528;76.3;74.6;2.9
28;2021-10-13;200;406;590;327786;320747;13118;76.3;74.7;3.1
28;2021-10-14;170;263;552;327956;321010;13670;76.4;74.8;3.2
28;2021-10-15;228;374;644;328184;321384;14314;76.4;74.8;3.3
28;2021-10-16;77;160;124;328261;321544;14438;76.4;74.9;3.4
28;2021-10-17;22;22;51;328283;321566;14489;76.4;74.9;3.4
28;2021-10-18;131;142;328;328414;321708;14817;76.5;74.9;3.5
28;2021-10-19;176;261;634;328590;321969;15451;76.5;75.0;3.6
28;2021-10-20;188;413;748;328778;322382;16199;76.6;75.1;3.8
28;2021-10-21;131;173;579;328909;322555;16778;76.6;75.1;3.9
28;2021-10-22;220;302;597;329129;322857;17375;76.6;75.2;4.0
28;2021-10-23;73;126;132;329202;322983;17507;76.7;75.2;4.1
28;2021-10-24;5;13;7;329207;322996;17514;76.7;75.2;4.1
28;2021-10-25;166;204;601;329373;323200;18115;76.7;75.3;4.2
28;2021-10-26;97;181;540;329470;323381;18655;76.7;75.3;4.3
28;2021-10-27;152;228;671;329622;323609;19326;76.8;75.4;4.5
28;2021-10-28;99;158;657;329721;323767;19983;76.8;75.4;4.7
28;2021-10-29;201;270;777;329922;324037;20760;76.8;75.5;4.8
28;2021-10-30;63;79;113;329985;324116;20873;76.8;75.5;4.9
28;2021-10-31;5;8;8;329990;324124;20881;76.8;75.5;4.9
28;2021-11-01;31;33;63;330021;324157;20944;76.9;75.5;4.9
28;2021-11-02;160;216;684;330181;324373;21628;76.9;75.5;5.0
28;2021-11-03;152;221;879;330333;324594;22507;76.9;75.6;5.2
28;2021-11-04;94;174;874;330427;324768;23381;76.9;75.6;5.4
28;2021-11-05;143;231;1001;330570;324999;24382;77.0;75.7;5.7
28;2021-11-06;82;114;280;330652;325113;24662;77.0;75.7;5.7
28;2021-11-07;3;27;32;330655;325140;24694;77.0;75.7;5.8
28;2021-11-08;117;175;1233;330772;325315;25927;77.0;75.8;6.0
28;2021-11-09;128;212;1223;330900;325527;27150;77.1;75.8;6.3
28;2021-11-10;159;205;1634;331059;325732;28784;77.1;75.9;6.7
28;2021-11-11;37;55;241;331096;325787;29025;77.1;75.9;6.8
28;2021-11-12;129;174;1184;331225;325961;30209;77.1;75.9;7.0
28;2021-11-13;68;79;378;331293;326040;30587;77.1;75.9;7.1
28;2021-11-14;3;2;8;331296;326042;30595;77.1;75.9;7.1
28;2021-11-15;120;166;1502;331416;326208;32097;77.2;76.0;7.5
28;2021-11-16;133;156;1793;331549;326364;33890;77.2;76.0;7.9
28;2021-11-17;163;202;1728;331712;326566;35618;77.2;76.0;8.3
28;2021-11-18;140;151;1633;331852;326717;37251;77.3;76.1;8.7
28;2021-11-19;198;250;1877;332050;326967;39128;77.3;76.1;9.1
28;2021-11-20;91;127;474;332141;327094;39602;77.3;76.2;9.2
28;2021-11-21;24;10;145;332165;327104;39747;77.4;76.2;9.3
28;2021-11-22;152;116;1755;332317;327220;41502;77.4;76.2;9.7
28;2021-11-23;127;123;1551;332444;327343;43053;77.4;76.2;10.0
28;2021-11-24;170;205;1559;332614;327548;44612;77.5;76.3;10.4
28;2021-11-25;140;149;2296;332754;327697;46908;77.5;76.3;10.9
28;2021-11-26;175;217;2898;332929;327914;49806;77.5;76.4;11.6
28;2021-11-27;66;99;780;332995;328013;50586;77.5;76.4;11.8
28;2021-11-28;3;11;74;332998;328024;50660;77.5;76.4;11.8
28;2021-11-29;127;123;2904;333125;328147;53564;77.6;76.4;12.5
28;2021-11-30;97;143;3632;333222;328290;57196;77.6;76.4;13.3
28;2021-12-01;127;181;3750;333349;328471;60946;77.6;76.5;14.2
28;2021-12-02;106;104;4309;333455;328575;65255;77.7;76.5;15.2
28;2021-12-03;142;181;5018;333597;328756;70273;77.7;76.6;16.4
28;2021-12-04;59;74;1507;333656;328830;71780;77.7;76.6;16.7
28;2021-12-05;20;21;991;333676;328851;72771;77.7;76.6;16.9
28;2021-12-06;100;149;4448;333776;329000;77219;77.7;76.6;18.0
28;2021-12-07;102;137;4779;333878;329137;81998;77.8;76.6;19.1
28;2021-12-08;148;166;4467;334026;329303;86465;77.8;76.7;20.1
28;2021-12-09;95;125;5600;334121;329428;92065;77.8;76.7;21.4
28;2021-12-10;122;193;5446;334243;329621;97511;77.8;76.8;22.7
28;2021-12-11;65;68;2039;334308;329689;99550;77.9;76.8;23.2
28;2021-12-12;14;12;397;334322;329701;99947;77.9;76.8;23.3
28;2021-12-13;101;134;4642;334423;329835;104589;77.9;76.8;24.4
28;2021-12-14;108;157;7567;334531;329992;112156;77.9;76.8;26.1
28;2021-12-15;116;206;6884;334647;330198;119040;77.9;76.9;27.7
28;2021-12-16;126;188;6089;334773;330386;125129;78.0;76.9;29.1
29;2020-12-27;0;0;0;0;0;0;0.0;0.0;0.0
29;2020-12-28;0;0;0;0;0;0;0.0;0.0;0.0
29;2020-12-29;0;0;0;0;0;0;0.0;0.0;0.0
29;2020-12-30;0;0;0;0;0;0;0.0;0.0;0.0
29;2020-12-31;1;0;0;1;0;0;0.0;0.0;0.0
29;2021-01-01;4;0;0;5;0;0;0.0;0.0;0.0
29;2021-01-02;2;0;0;7;0;0;0.0;0.0;0.0
29;2021-01-03;1;0;0;8;0;0;0.0;0.0;0.0
29;2021-01-04;34;0;0;42;0;0;0.0;0.0;0.0
29;2021-01-05;33;0;0;75;0;0;0.0;0.0;0.0
29;2021-01-06;43;0;0;118;0;0;0.0;0.0;0.0
29;2021-01-07;151;0;0;269;0;0;0.0;0.0;0.0
29;2021-01-08;407;1;0;676;1;0;0.1;0.0;0.0
29;2021-01-09;2;0;0;678;1;0;0.1;0.0;0.0
29;2021-01-10;5;0;0;683;1;0;0.1;0.0;0.0
29;2021-01-11;669;0;0;1352;1;0;0.1;0.0;0.0
29;2021-01-12;1125;0;0;2477;1;0;0.3;0.0;0.0
29;2021-01-13;1085;2;0;3562;3;0;0.4;0.0;0.0
29;2021-01-14;933;5;0;4495;8;0;0.5;0.0;0.0
29;2021-01-15;1278;7;0;5773;15;0;0.6;0.0;0.0
29;2021-01-16;174;1;0;5947;16;0;0.7;0.0;0.0
29;2021-01-17;115;1;0;6062;17;0;0.7;0.0;0.0
29;2021-01-18;919;5;0;6981;22;0;0.8;0.0;0.0
29;2021-01-19;1354;5;0;8335;27;0;0.9;0.0;0.0
29;2021-01-20;2365;3;0;10700;30;0;1.2;0.0;0.0
29;2021-01-21;5544;19;0;16244;49;0;1.8;0.0;0.0
29;2021-01-22;3714;8;0;19958;57;0;2.2;0.0;0.0
29;2021-01-23;538;0;0;20496;57;0;2.3;0.0;0.0
29;2021-01-24;191;0;0;20687;57;0;2.3;0.0;0.0
29;2021-01-25;607;7;0;21294;64;0;2.3;0.0;0.0
29;2021-01-26;960;33;0;22254;97;0;2.5;0.0;0.0
29;2021-01-27;1354;52;0;23608;149;0;2.6;0.0;0.0
29;2021-01-28;893;139;0;24501;288;0;2.7;0.0;0.0
29;2021-01-29;833;204;0;25334;492;0;2.8;0.1;0.0
29;2021-01-30;279;4;0;25613;496;0;2.8;0.1;0.0
29;2021-01-31;67;3;0;25680;499;0;2.8;0.1;0.0
29;2021-02-01;435;441;0;26115;940;0;2.9;0.1;0.0
29;2021-02-02;925;804;0;27040;1744;0;3.0;0.2;0.0
29;2021-02-03;833;869;0;27873;2613;0;3.1;0.3;0.0
29;2021-02-04;948;629;0;28821;3242;0;3.2;0.4;0.0
29;2021-02-05;724;596;0;29545;3838;0;3.3;0.4;0.0
29;2021-02-06;267;105;0;29812;3943;0;3.3;0.4;0.0
29;2021-02-07;75;108;0;29887;4051;0;3.3;0.4;0.0
29;2021-02-08;379;462;0;30266;4513;0;3.3;0.5;0.0
29;2021-02-09;886;832;0;31152;5345;0;3.4;0.6;0.0
29;2021-02-10;1155;1032;0;32307;6377;0;3.6;0.7;0.0
29;2021-02-11;1798;4094;0;34105;10471;0;3.8;1.2;0.0
29;2021-02-12;2310;2505;0;36415;12976;0;4.0;1.4;0.0
29;2021-02-13;623;375;0;37038;13351;0;4.1;1.5;0.0
29;2021-02-14;12;226;0;37050;13577;0;4.1;1.5;0.0
29;2021-02-15;289;1029;0;37339;14606;0;4.1;1.6;0.0
29;2021-02-16;916;1038;0;38255;15644;0;4.2;1.7;0.0
29;2021-02-17;866;902;0;39121;16546;0;4.3;1.8;0.0
29;2021-02-18;1536;876;0;40657;17422;0;4.5;1.9;0.0
29;2021-02-19;1386;1040;0;42043;18462;0;4.6;2.0;0.0
29;2021-02-20;208;360;0;42251;18822;0;4.7;2.1;0.0
29;2021-02-21;155;161;0;42406;18983;0;4.7;2.1;0.0
29;2021-02-22;777;582;0;43183;19565;0;4.8;2.2;0.0
29;2021-02-23;1248;907;0;44431;20472;0;4.9;2.3;0.0
29;2021-02-24;1475;897;0;45906;21369;0;5.1;2.4;0.0
29;2021-02-25;2451;948;0;48357;22317;0;5.3;2.5;0.0
29;2021-02-26;2714;766;0;51071;23083;0;5.6;2.5;0.0
29;2021-02-27;1278;275;0;52349;23358;0;5.8;2.6;0.0
29;2021-02-28;191;69;0;52540;23427;0;5.8;2.6;0.0
29;2021-03-01;942;485;0;53482;23912;0;5.9;2.6;0.0
29;2021-03-02;1834;845;0;55316;24757;0;6.1;2.7;0.0
29;2021-03-03;2126;1053;0;57442;25810;0;6.3;2.8;0.0
29;2021-03-04;2843;1601;0;60285;27411;0;6.6;3.0;0.0
29;2021-03-05;3546;1693;0;63831;29104;0;7.0;3.2;0.0
29;2021-03-06;2008;437;0;65839;29541;0;7.3;3.3;0.0
29;2021-03-07;419;80;0;66258;29621;0;7.3;3.3;0.0
29;2021-03-08;1311;594;0;67569;30215;0;7.5;3.3;0.0
29;2021-03-09;2612;982;0;70181;31197;0;7.7;3.4;0.0
29;2021-03-10;2450;902;0;72631;32099;0;8.0;3.5;0.0
29;2021-03-11;4438;1021;0;77069;33120;0;8.5;3.7;0.0
29;2021-03-12;5253;964;0;82322;34084;0;9.1;3.8;0.0
29;2021-03-13;2799;411;0;85121;34495;0;9.4;3.8;0.0
29;2021-03-14;354;4;0;85475;34499;0;9.4;3.8;0.0
29;2021-03-15;2084;278;0;87559;34777;0;9.7;3.8;0.0
29;2021-03-16;1873;786;0;89432;35563;0;9.9;3.9;0.0
29;2021-03-17;1921;732;0;91353;36295;0;10.1;4.0;0.0
29;2021-03-18;1928;1045;0;93281;37340;0;10.3;4.1;0.0
29;2021-03-19;3322;892;0;96603;38232;0;10.7;4.2;0.0
29;2021-03-20;1934;223;0;98537;38455;0;10.9;4.2;0.0
29;2021-03-21;131;12;0;98668;38467;0;10.9;4.2;0.0
29;2021-03-22;1682;610;0;100350;39077;0;11.1;4.3;0.0
29;2021-03-23;3531;1062;0;103881;40139;0;11.5;4.4;0.0
29;2021-03-24;3856;1005;0;107737;41144;0;11.9;4.5;0.0
29;2021-03-25;4886;1069;0;112623;42213;0;12.4;4.7;0.0
29;2021-03-26;5386;1172;0;118009;43385;0;13.0;4.8;0.0
29;2021-03-27;2484;324;0;120493;43709;0;13.3;4.8;0.0
29;2021-03-28;180;47;0;120673;43756;0;13.3;4.8;0.0
29;2021-03-29;2125;837;0;122798;44593;0;13.5;4.9;0.0
29;2021-03-30;4134;1362;0;126932;45955;0;14.0;5.1;0.0
29;2021-03-31;4138;1169;0;131070;47124;0;14.5;5.2;0.0
29;2021-04-01;5218;1169;0;136288;48293;0;15.0;5.3;0.0
29;2021-04-02;4917;1194;0;141205;49487;0;15.6;5.5;0.0
29;2021-04-03;2669;541;0;143874;50028;0;15.9;5.5;0.0
29;2021-04-04;147;31;0;144021;50059;0;15.9;5.5;0.0
29;2021-04-05;928;313;0;144949;50372;0;16.0;5.6;0.0
29;2021-04-06;3352;1275;0;148301;51647;0;16.4;5.7;0.0
29;2021-04-07;3783;996;0;152084;52643;0;16.8;5.8;0.0
29;2021-04-08;5341;2027;0;157425;54670;0;17.4;6.0;0.0
29;2021-04-09;6827;1586;0;164252;56256;0;18.1;6.2;0.0
29;2021-04-10;3554;713;0;167806;56969;0;18.5;6.3;0.0
29;2021-04-11;116;74;0;167922;57043;0;18.5;6.3;0.0
29;2021-04-12;4001;1526;0;171923;58569;0;19.0;6.5;0.0
29;2021-04-13;5987;1811;0;177910;60380;0;19.6;6.7;0.0
29;2021-04-14;4883;1778;0;182793;62158;0;20.2;6.9;0.0
29;2021-04-15;7224;1795;0;190017;63953;0;21.0;7.1;0.0
29;2021-04-16;6691;1396;0;196708;65349;0;21.7;7.2;0.0
29;2021-04-17;3751;1014;0;200459;66363;0;22.1;7.3;0.0
29;2021-04-18;462;43;0;200921;66406;0;22.2;7.3;0.0
29;2021-04-19;3938;1481;0;204859;67887;0;22.6;7.5;0.0
29;2021-04-20;4477;2241;0;209336;70128;0;23.1;7.7;0.0
29;2021-04-21;4445;2291;0;213781;72419;0;23.6;8.0;0.0
29;2021-04-22;6697;2911;0;220478;75330;0;24.3;8.3;0.0
29;2021-04-23;6100;2280;0;226578;77610;0;25.0;8.6;0.0
29;2021-04-24;3953;1424;0;230531;79034;0;25.4;8.7;0.0
29;2021-04-25;424;159;0;230955;79193;0;25.5;8.7;0.0
29;2021-04-26;5339;1955;0;236294;81148;0;26.1;9.0;0.0
29;2021-04-27;5409;3347;0;241703;84495;0;26.7;9.3;0.0
29;2021-04-28;5523;3088;0;247226;87583;0;27.3;9.7;0.0
29;2021-04-29;6626;3529;0;253852;91112;0;28.0;10.1;0.0
29;2021-04-30;6270;4102;0;260122;95214;0;28.7;10.5;0.0
29;2021-05-01;1973;954;0;262095;96168;0;28.9;10.6;0.0
29;2021-05-02;1219;168;0;263314;96336;0;29.0;10.6;0.0
29;2021-05-03;4542;2369;0;267856;98705;0;29.5;10.9;0.0
29;2021-05-04;4190;3880;0;272046;102585;0;30.0;11.3;0.0
29;2021-05-05;4608;3565;0;276654;106150;0;30.5;11.7;0.0
29;2021-05-06;6194;3828;0;282848;109978;0;31.2;12.1;0.0
29;2021-05-07;5980;4691;0;288828;114669;0;31.9;12.6;0.0
29;2021-05-08;2101;557;0;290929;115226;0;32.1;12.7;0.0
29;2021-05-09;1672;146;0;292601;115372;0;32.3;12.7;0.0
29;2021-05-10;4872;3810;0;297473;119182;0;32.8;13.1;0.0
29;2021-05-11;4833;5106;0;302306;124288;0;33.3;13.7;0.0
29;2021-05-12;5181;4481;0;307487;128769;0;33.9;14.2;0.0
29;2021-05-13;3405;1494;0;310892;130263;0;34.3;14.4;0.0
29;2021-05-14;5768;3980;0;316660;134243;0;34.9;14.8;0.0
29;2021-05-15;4128;2271;0;320788;136514;0;35.4;15.1;0.0
29;2021-05-16;1530;282;0;322318;136796;0;35.6;15.1;0.0
29;2021-05-17;5505;3120;0;327823;139916;0;36.2;15.4;0.0
29;2021-05-18;5756;3119;0;333579;143035;0;36.8;15.8;0.0
29;2021-05-19;6105;3022;0;339684;146057;0;37.5;16.1;0.0
29;2021-05-20;7122;4610;0;346806;150667;0;38.3;16.6;0.0
29;2021-05-21;7115;3889;0;353921;154556;0;39.0;17.0;0.0
29;2021-05-22;5337;2082;0;359258;156638;0;39.6;17.3;0.0
29;2021-05-23;1635;69;0;360893;156707;0;39.8;17.3;0.0
29;2021-05-24;3587;544;0;364480;157251;0;40.2;17.3;0.0
29;2021-05-25;5850;3145;0;370330;160396;0;40.9;17.7;0.0
29;2021-05-26;5870;3173;0;376200;163569;0;41.5;18.0;0.0
29;2021-05-27;6749;4100;0;382949;167669;0;42.2;18.5;0.0
29;2021-05-28;6527;4627;0;389476;172296;0;43.0;19.0;0.0
29;2021-05-29;4346;2796;0;393822;175092;0;43.4;19.3;0.0
29;2021-05-30;1107;364;0;394929;175456;0;43.6;19.4;0.0
29;2021-05-31;6219;3602;0;401148;179058;0;44.2;19.8;0.0
29;2021-06-01;6623;4429;0;407771;183487;0;45.0;20.2;0.0
29;2021-06-02;6170;4148;0;413941;187635;0;45.7;20.7;0.0
29;2021-06-03;7601;4483;0;421542;192118;0;46.5;21.2;0.0
29;2021-06-04;6880;6151;0;428422;198269;0;47.3;21.9;0.0
29;2021-06-05;5495;3033;0;433917;201302;0;47.9;22.2;0.0
29;2021-06-06;1266;531;0;435183;201833;0;48.0;22.3;0.0
29;2021-06-07;4751;5538;0;439934;207371;0;48.5;22.9;0.0
29;2021-06-08;7079;5193;0;447013;212564;0;49.3;23.4;0.0
29;2021-06-09;6434;4703;0;453447;217267;0;50.0;24.0;0.0
29;2021-06-10;7727;4961;0;461174;222228;0;50.9;24.5;0.0
29;2021-06-11;8200;5753;0;469374;227981;0;51.8;25.1;0.0
29;2021-06-12;6368;2737;0;475742;230718;0;52.5;25.5;0.0
29;2021-06-13;2222;1329;0;477964;232047;0;52.7;25.6;0.0
29;2021-06-14;3971;6276;0;481935;238323;0;53.2;26.3;0.0
29;2021-06-15;5333;6106;0;487268;244429;0;53.7;27.0;0.0
29;2021-06-16;5425;5609;0;492693;250038;0;54.3;27.6;0.0
29;2021-06-17;6193;6294;0;498886;256332;0;55.0;28.3;0.0
29;2021-06-18;6003;7446;0;504889;263778;0;55.7;29.1;0.0
29;2021-06-19;4537;3478;0;509426;267256;0;56.2;29.5;0.0
29;2021-06-20;850;1426;0;510276;268682;0;56.3;29.6;0.0
29;2021-06-21;3642;6477;0;513918;275159;0;56.7;30.4;0.0
29;2021-06-22;4303;6354;0;518221;281513;0;57.2;31.1;0.0
29;2021-06-23;4468;6146;0;522689;287659;0;57.7;31.7;0.0
29;2021-06-24;4584;6689;0;527273;294348;0;58.2;32.5;0.0
29;2021-06-25;3508;7490;0;530781;301838;0;58.5;33.3;0.0
29;2021-06-26;2045;4073;0;532826;305911;0;58.8;33.7;0.0
29;2021-06-27;933;1574;0;533759;307485;0;58.9;33.9;0.0
29;2021-06-28;2669;6807;0;536428;314292;0;59.2;34.7;0.0
29;2021-06-29;2722;7649;0;539150;321941;0;59.5;35.5;0.0
29;2021-06-30;2929;7362;0;542079;329303;0;59.8;36.3;0.0
29;2021-07-01;3669;8227;0;545748;337530;0;60.2;37.2;0.0
29;2021-07-02;3418;9416;0;549166;346946;0;60.6;38.3;0.0
29;2021-07-03;2277;5978;0;551443;352924;0;60.8;38.9;0.0
29;2021-07-04;807;1707;0;552250;354631;0;60.9;39.1;0.0
29;2021-07-05;1836;7168;0;554086;361799;0;61.1;39.9;0.0
29;2021-07-06;1601;8056;0;555687;369855;0;61.3;40.8;0.0
29;2021-07-07;1756;6975;0;557443;376830;0;61.5;41.6;0.0
29;2021-07-08;2415;8032;0;559858;384862;0;61.8;42.5;0.0
29;2021-07-09;2585;8968;0;562443;393830;0;62.0;43.4;0.0
29;2021-07-10;1862;6004;0;564305;399834;0;62.2;44.1;0.0
29;2021-07-11;447;1072;0;564752;400906;0;62.3;44.2;0.0
29;2021-07-12;1972;8152;0;566724;409058;0;62.5;45.1;0.0
29;2021-07-13;2798;8607;0;569522;417665;0;62.8;46.1;0.0
29;2021-07-14;2054;3323;0;571576;420988;0;63.0;46.4;0.0
29;2021-07-15;3807;9447;0;575383;430435;0;63.5;47.5;0.0
29;2021-07-16;4495;9039;0;579878;439474;0;64.0;48.5;0.0
29;2021-07-17;3186;5978;0;583064;445452;0;64.3;49.1;0.0
29;2021-07-18;650;1071;0;583714;446523;0;64.4;49.3;0.0
29;2021-07-19;3182;7381;0;586896;453904;0;64.7;50.1;0.0
29;2021-07-20;3671;9182;0;590567;463086;0;65.1;51.1;0.0
29;2021-07-21;3698;7664;0;594265;470750;0;65.6;51.9;0.0
29;2021-07-22;3584;8340;0;597849;479090;0;65.9;52.8;0.0
29;2021-07-23;4121;10371;0;601970;489461;0;66.4;54.0;0.0
29;2021-07-24;2514;5782;0;604484;495243;0;66.7;54.6;0.0
29;2021-07-25;651;2295;0;605135;497538;0;66.8;54.9;0.0
29;2021-07-26;3416;6943;0;608551;504481;0;67.1;55.6;0.0
29;2021-07-27;3865;6935;0;612416;511416;0;67.6;56.4;0.0
29;2021-07-28;4287;5807;0;616703;517223;0;68.0;57.1;0.0
29;2021-07-29;5671;6108;0;622374;523331;0;68.7;57.7;0.0
29;2021-07-30;5376;6225;0;627750;529556;0;69.2;58.4;0.0
29;2021-07-31;2973;4679;0;630723;534235;0;69.6;58.9;0.0
29;2021-08-01;703;861;0;631426;535096;0;69.7;59.0;0.0
29;2021-08-02;4223;4932;0;635649;540028;0;70.1;59.6;0.0
29;2021-08-03;5373;4133;0;641022;544161;0;70.7;60.0;0.0
29;2021-08-04;5523;3500;0;646545;547661;0;71.3;60.4;0.0
29;2021-08-05;6286;3769;0;652831;551430;0;72.0;60.8;0.0
29;2021-08-06;5799;4092;0;658630;555522;0;72.7;61.3;0.0
29;2021-08-07;3916;2726;1;662546;558248;1;73.1;61.6;0.0
29;2021-08-08;835;676;0;663381;558924;1;73.2;61.7;0.0
29;2021-08-09;3034;4409;0;666415;563333;1;73.5;62.1;0.0
29;2021-08-10;4270;3665;0;670685;566998;1;74.0;62.5;0.0
29;2021-08-11;3856;3082;0;674541;570080;1;74.4;62.9;0.0
29;2021-08-12;4436;4257;0;678977;574337;1;74.9;63.4;0.0
29;2021-08-13;4071;3646;0;683048;577983;1;75.3;63.8;0.0
29;2021-08-14;2705;2682;0;685753;580665;1;75.6;64.1;0.0
29;2021-08-15;355;422;0;686108;581087;1;75.7;64.1;0.0
29;2021-08-16;3096;4213;0;689204;585300;1;76.0;64.6;0.0
29;2021-08-17;4087;3344;0;693291;588644;1;76.5;64.9;0.0
29;2021-08-18;3476;3585;0;696767;592229;1;76.9;65.3;0.0
29;2021-08-19;3603;4402;0;700370;596631;1;77.3;65.8;0.0
29;2021-08-20;3247;4493;0;703617;601124;1;77.6;66.3;0.0
29;2021-08-21;2071;3021;0;705688;604145;1;77.8;66.6;0.0
29;2021-08-22;221;422;0;705909;604567;1;77.9;66.7;0.0
29;2021-08-23;2243;4446;0;708152;609013;1;78.1;67.2;0.0
29;2021-08-24;2356;4836;0;710508;613849;1;78.4;67.7;0.0
29;2021-08-25;2058;4204;0;712566;618053;1;78.6;68.2;0.0
29;2021-08-26;2167;5220;0;714733;623273;1;78.8;68.8;0.0
29;2021-08-27;1876;5755;0;716609;629028;1;79.0;69.4;0.0
29;2021-08-28;1360;3857;0;717969;632885;1;79.2;69.8;0.0
29;2021-08-29;384;1265;0;718353;634150;1;79.2;70.0;0.0
29;2021-08-30;1369;4127;65;719722;638277;66;79.4;70.4;0.0
29;2021-08-31;1438;4322;115;721160;642599;181;79.5;70.9;0.0
29;2021-09-01;1313;3748;228;722473;646347;409;79.7;71.3;0.0
29;2021-09-02;1069;3958;338;723542;650305;747;79.8;71.7;0.1
29;2021-09-03;1369;4691;500;724911;654996;1247;80.0;72.3;0.1
29;2021-09-04;1321;3680;256;726232;658676;1503;80.1;72.7;0.2
29;2021-09-05;195;658;44;726427;659334;1547;80.1;72.7;0.2
29;2021-09-06;703;3251;360;727130;662585;1907;80.2;73.1;0.2
29;2021-09-07;867;3341;570;727997;665926;2477;80.3;73.5;0.3
29;2021-09-08;846;3368;489;728843;669294;2966;80.4;73.8;0.3
29;2021-09-09;900;3311;487;729743;672605;3453;80.5;74.2;0.4
29;2021-09-10;1154;4271;728;730897;676876;4181;80.6;74.7;0.5
29;2021-09-11;662;3309;197;731559;680185;4378;80.7;75.0;0.5
29;2021-09-12;109;391;28;731668;680576;4406;80.7;75.1;0.5
29;2021-09-13;794;3084;677;732462;683660;5083;80.8;75.4;0.6
29;2021-09-14;714;2910;1100;733176;686570;6183;80.9;75.7;0.7
29;2021-09-15;690;3160;696;733866;689730;6879;81.0;76.1;0.8
29;2021-09-16;802;2614;1380;734668;692344;8259;81.0;76.4;0.9
29;2021-09-17;855;3069;978;735523;695413;9237;81.1;76.7;1.0
29;2021-09-18;564;3300;502;736087;698713;9739;81.2;77.1;1.1
29;2021-09-19;68;370;38;736155;699083;9777;81.2;77.1;1.1
29;2021-09-20;448;2038;795;736603;701121;10572;81.3;77.3;1.2
29;2021-09-21;431;1774;1146;737034;702895;11718;81.3;77.5;1.3
29;2021-09-22;362;2150;1212;737396;705045;12930;81.3;77.8;1.4
29;2021-09-23;444;1672;1774;737840;706717;14704;81.4;78.0;1.6
29;2021-09-24;461;2104;1367;738301;708821;16071;81.4;78.2;1.8
29;2021-09-25;338;2584;401;738639;711405;16472;81.5;78.5;1.8
29;2021-09-26;51;216;27;738690;711621;16499;81.5;78.5;1.8
29;2021-09-27;305;1499;752;738995;713120;17251;81.5;78.7;1.9
29;2021-09-28;247;1437;785;739242;714557;18036;81.5;78.8;2.0
29;2021-09-29;394;1611;1053;739636;716168;19089;81.6;79.0;2.1
29;2021-09-30;296;1219;1078;739932;717387;20167;81.6;79.1;2.2
29;2021-10-01;504;1445;1305;740436;718832;21472;81.7;79.3;2.4
29;2021-10-02;339;1565;362;740775;720397;21834;81.7;79.5;2.4
29;2021-10-03;13;35;10;740788;720432;21844;81.7;79.5;2.4
29;2021-10-04;313;1199;676;741101;721631;22520;81.7;79.6;2.5
29;2021-10-05;231;1002;861;741332;722633;23381;81.8;79.7;2.6
29;2021-10-06;316;1102;1014;741648;723735;24395;81.8;79.8;2.7
29;2021-10-07;283;877;895;741931;724612;25290;81.8;79.9;2.8
29;2021-10-08;459;1208;1382;742390;725820;26672;81.9;80.1;2.9
29;2021-10-09;313;934;519;742703;726754;27191;81.9;80.2;3.0
29;2021-10-10;5;18;11;742708;726772;27202;81.9;80.2;3.0
29;2021-10-11;277;836;917;742985;727608;28119;82.0;80.3;3.1
29;2021-10-12;229;580;977;743214;728188;29096;82.0;80.3;3.2
29;2021-10-13;293;723;1120;743507;728911;30216;82.0;80.4;3.3
29;2021-10-14;277;640;1119;743784;729551;31335;82.0;80.5;3.5
29;2021-10-15;362;702;1260;744146;730253;32595;82.1;80.6;3.6
29;2021-10-16;303;575;639;744449;730828;33234;82.1;80.6;3.7
29;2021-10-17;13;27;29;744462;730855;33263;82.1;80.6;3.7
29;2021-10-18;206;520;858;744668;731375;34121;82.1;80.7;3.8
29;2021-10-19;203;348;948;744871;731723;35069;82.2;80.7;3.9
29;2021-10-20;306;524;1490;745177;732247;36559;82.2;80.8;4.0
29;2021-10-21;217;397;1143;745394;732644;37702;82.2;80.8;4.2
29;2021-10-22;307;554;1440;745701;733198;39142;82.3;80.9;4.3
29;2021-10-23;274;445;932;745975;733643;40074;82.3;80.9;4.4
29;2021-10-24;1;16;3;745976;733659;40077;82.3;80.9;4.4
29;2021-10-25;168;327;842;746144;733986;40919;82.3;81.0;4.5
29;2021-10-26;172;261;964;746316;734247;41883;82.3;81.0;4.6
29;2021-10-27;317;408;1841;746633;734655;43724;82.4;81.0;4.8
29;2021-10-28;268;329;1397;746901;734984;45121;82.4;81.1;5.0
29;2021-10-29;266;418;1667;747167;735402;46788;82.4;81.1;5.2
29;2021-10-30;209;376;1258;747376;735778;48046;82.4;81.2;5.3
29;2021-10-31;6;14;20;747382;735792;48066;82.4;81.2;5.3
29;2021-11-01;23;8;22;747405;735800;48088;82.4;81.2;5.3
29;2021-11-02;168;272;1205;747573;736072;49293;82.5;81.2;5.4
29;2021-11-03;195;267;1381;747768;736339;50674;82.5;81.2;5.6
29;2021-11-04;212;354;1555;747980;736693;52229;82.5;81.3;5.8
29;2021-11-05;272;394;2464;748252;737087;54693;82.5;81.3;6.0
29;2021-11-06;258;397;1382;748510;737484;56075;82.6;81.4;6.2
29;2021-11-07;10;28;66;748520;737512;56141;82.6;81.4;6.2
29;2021-11-08;157;272;1818;748677;737784;57959;82.6;81.4;6.4
29;2021-11-09;161;261;2249;748838;738045;60208;82.6;81.4;6.6
29;2021-11-10;220;323;2831;749058;738368;63039;82.6;81.4;7.0
29;2021-11-11;8;13;62;749066;738381;63101;82.6;81.4;7.0
29;2021-11-12;200;356;2467;749266;738737;65568;82.6;81.5;7.2
29;2021-11-13;242;329;1684;749508;739066;67252;82.7;81.5;7.4
29;2021-11-14;11;11;70;749519;739077;67322;82.7;81.5;7.4
29;2021-11-15;181;218;2743;749700;739295;70065;82.7;81.6;7.7
29;2021-11-16;195;208;3384;749895;739503;73449;82.7;81.6;8.1
29;2021-11-17;303;316;3371;750198;739819;76820;82.8;81.6;8.5
29;2021-11-18;242;283;3918;750440;740102;80738;82.8;81.6;8.9
29;2021-11-19;338;422;5076;750778;740524;85814;82.8;81.7;9.5
29;2021-11-20;310;283;2357;751088;740807;88171;82.9;81.7;9.7
29;2021-11-21;35;23;134;751123;740830;88305;82.9;81.7;9.7
29;2021-11-22;214;177;3247;751337;741007;91552;82.9;81.7;10.1
29;2021-11-23;223;178;3824;751560;741185;95376;82.9;81.8;10.5
29;2021-11-24;297;287;3995;751857;741472;99371;82.9;81.8;11.0
29;2021-11-25;264;207;4839;752121;741679;104210;83.0;81.8;11.5
29;2021-11-26;325;443;7223;752446;742122;111433;83.0;81.9;12.3
29;2021-11-27;265;292;4024;752711;742414;115457;83.0;81.9;12.7
29;2021-11-28;21;21;404;752732;742435;115861;83.0;81.9;12.8
29;2021-11-29;180;204;4754;752912;742639;120615;83.1;81.9;13.3
29;2021-11-30;248;218;7935;753160;742857;128550;83.1;81.9;14.2
29;2021-12-01;213;235;7515;753373;743092;136065;83.1;82.0;15.0
29;2021-12-02;217;211;9782;753590;743303;145847;83.1;82.0;16.1
29;2021-12-03;217;283;10393;753807;743586;156240;83.2;82.0;17.2
29;2021-12-04;144;330;4899;753951;743916;161139;83.2;82.1;17.8
29;2021-12-05;12;27;778;753963;743943;161917;83.2;82.1;17.9
29;2021-12-06;169;268;7785;754132;744211;169702;83.2;82.1;18.7
29;2021-12-07;213;250;11003;754345;744461;180705;83.2;82.1;19.9
29;2021-12-08;194;328;9057;754539;744789;189762;83.2;82.2;20.9
29;2021-12-09;228;247;12332;754767;745036;202094;83.3;82.2;22.3
29;2021-12-10;276;398;13790;755043;745434;215884;83.3;82.2;23.8
29;2021-12-11;172;364;7262;755215;745798;223146;83.3;82.3;24.6
29;2021-12-12;40;64;1678;755255;745862;224824;83.3;82.3;24.8
29;2021-12-13;196;243;8776;755451;746105;233600;83.3;82.3;25.8
29;2021-12-14;217;291;13163;755668;746396;246763;83.4;82.3;27.2
29;2021-12-15;273;283;12387;755941;746679;259150;83.4;82.4;28.6
29;2021-12-16;249;318;14036;756190;746997;273186;83.4;82.4;30.1
2A;2020-12-27;0;0;0;0;0;0;0.0;0.0;0.0
2A;2020-12-28;0;0;0;0;0;0;0.0;0.0;0.0
2A;2020-12-29;0;0;0;0;0;0;0.0;0.0;0.0
2A;2020-12-30;0;0;0;0;0;0;0.0;0.0;0.0
2A;2020-12-31;0;0;0;0;0;0;0.0;0.0;0.0
2A;2021-01-01;0;0;0;0;0;0;0.0;0.0;0.0
2A;2021-01-02;0;0;0;0;0;0;0.0;0.0;0.0
2A;2021-01-03;0;0;0;0;0;0;0.0;0.0;0.0
2A;2021-01-04;0;0;0;0;0;0;0.0;0.0;0.0
2A;2021-01-05;1;0;0;1;0;0;0.0;0.0;0.0
2A;2021-01-06;6;0;0;7;0;0;0.0;0.0;0.0
2A;2021-01-07;109;1;0;116;1;0;0.1;0.0;0.0
2A;2021-01-08;108;1;0;224;2;0;0.1;0.0;0.0
2A;2021-01-09;38;0;0;262;2;0;0.2;0.0;0.0
2A;2021-01-10;28;0;0;290;2;0;0.2;0.0;0.0
2A;2021-01-11;76;0;0;366;2;0;0.2;0.0;0.0
2A;2021-01-12;82;0;0;448;2;0;0.3;0.0;0.0
2A;2021-01-13;114;1;0;562;3;0;0.3;0.0;0.0
2A;2021-01-14;191;1;0;753;4;0;0.5;0.0;0.0
2A;2021-01-15;135;0;0;888;4;0;0.5;0.0;0.0
2A;2021-01-16;141;2;0;1029;6;0;0.6;0.0;0.0
2A;2021-01-17;72;1;0;1101;7;0;0.7;0.0;0.0
2A;2021-01-18;193;2;0;1294;9;0;0.8;0.0;0.0
2A;2021-01-19;461;5;0;1755;14;0;1.1;0.0;0.0
2A;2021-01-20;349;2;0;2104;16;0;1.3;0.0;0.0
2A;2021-01-21;435;1;0;2539;17;0;1.6;0.0;0.0
2A;2021-01-22;353;0;0;2892;17;0;1.8;0.0;0.0
2A;2021-01-23;171;0;0;3063;17;0;1.9;0.0;0.0
2A;2021-01-24;110;1;0;3173;18;0;2.0;0.0;0.0
2A;2021-01-25;206;0;0;3379;18;0;2.1;0.0;0.0
2A;2021-01-26;400;9;0;3779;27;0;2.3;0.0;0.0
2A;2021-01-27;295;6;0;4074;33;0;2.5;0.0;0.0
2A;2021-01-28;317;72;0;4391;105;0;2.7;0.1;0.0
2A;2021-01-29;329;59;0;4720;164;0;2.9;0.1;0.0
2A;2021-01-30;112;33;0;4832;197;0;3.0;0.1;0.0
2A;2021-01-31;73;11;0;4905;208;0;3.0;0.1;0.0
2A;2021-02-01;215;50;0;5120;258;0;3.2;0.2;0.0
2A;2021-02-02;282;117;0;5402;375;0;3.3;0.2;0.0
2A;2021-02-03;257;72;0;5659;447;0;3.5;0.3;0.0
2A;2021-02-04;247;128;0;5906;575;0;3.6;0.4;0.0
2A;2021-02-05;260;96;0;6166;671;0;3.8;0.4;0.0
2A;2021-02-06;115;58;0;6281;729;0;3.9;0.4;0.0
2A;2021-02-07;49;45;0;6330;774;0;3.9;0.5;0.0
2A;2021-02-08;95;191;0;6425;965;0;4.0;0.6;0.0
2A;2021-02-09;147;285;0;6572;1250;0;4.0;0.8;0.0
2A;2021-02-10;170;214;0;6742;1464;0;4.2;0.9;0.0
2A;2021-02-11;292;324;0;7034;1788;0;4.3;1.1;0.0
2A;2021-02-12;319;283;0;7353;2071;0;4.5;1.3;0.0
2A;2021-02-13;211;58;0;7564;2129;0;4.7;1.3;0.0
2A;2021-02-14;114;70;0;7678;2199;0;4.7;1.4;0.0
2A;2021-02-15;187;180;0;7865;2379;0;4.8;1.5;0.0
2A;2021-02-16;359;319;0;8224;2698;0;5.1;1.7;0.0
2A;2021-02-17;269;181;0;8493;2879;0;5.2;1.8;0.0
2A;2021-02-18;325;198;0;8818;3077;0;5.4;1.9;0.0
2A;2021-02-19;147;287;0;8965;3364;0;5.5;2.1;0.0
2A;2021-02-20;221;117;0;9186;3481;0;5.7;2.1;0.0
2A;2021-02-21;47;42;0;9233;3523;0;5.7;2.2;0.0
2A;2021-02-22;79;203;0;9312;3726;0;5.7;2.3;0.0
2A;2021-02-23;114;284;0;9426;4010;0;5.8;2.5;0.0
2A;2021-02-24;84;280;0;9510;4290;0;5.9;2.6;0.0
2A;2021-02-25;111;258;0;9621;4548;0;5.9;2.8;0.0
2A;2021-02-26;121;251;0;9742;4799;0;6.0;3.0;0.0
2A;2021-02-27;289;66;0;10031;4865;0;6.2;3.0;0.0
2A;2021-02-28;60;54;0;10091;4919;0;6.2;3.0;0.0
2A;2021-03-01;116;140;0;10207;5059;0;6.3;3.1;0.0
2A;2021-03-02;198;269;0;10405;5328;0;6.4;3.3;0.0
2A;2021-03-03;232;242;0;10637;5570;0;6.5;3.4;0.0
2A;2021-03-04;493;206;0;11130;5776;0;6.9;3.6;0.0
2A;2021-03-05;929;287;0;12059;6063;0;7.4;3.7;0.0
2A;2021-03-06;1095;76;0;13154;6139;0;8.1;3.8;0.0
2A;2021-03-07;917;41;0;14071;6180;0;8.7;3.8;0.0
2A;2021-03-08;874;97;0;14945;6277;0;9.2;3.9;0.0
2A;2021-03-09;882;166;0;15827;6443;0;9.7;4.0;0.0
2A;2021-03-10;612;139;0;16439;6582;0;10.1;4.1;0.0
2A;2021-03-11;685;274;0;17124;6856;0;10.5;4.2;0.0
2A;2021-03-12;563;298;0;17687;7154;0;10.9;4.4;0.0
2A;2021-03-13;578;192;0;18265;7346;0;11.2;4.5;0.0
2A;2021-03-14;296;108;0;18561;7454;0;11.4;4.6;0.0
2A;2021-03-15;380;192;0;18941;7646;0;11.7;4.7;0.0
2A;2021-03-16;483;345;0;19424;7991;0;12.0;4.9;0.0
2A;2021-03-17;681;255;0;20105;8246;0;12.4;5.1;0.0
2A;2021-03-18;437;294;0;20542;8540;0;12.6;5.3;0.0
2A;2021-03-19;515;149;0;21057;8689;0;13.0;5.3;0.0
2A;2021-03-20;1005;246;0;22062;8935;0;13.6;5.5;0.0
2A;2021-03-21;632;48;0;22694;8983;0;14.0;5.5;0.0
2A;2021-03-22;333;67;0;23027;9050;0;14.2;5.6;0.0
2A;2021-03-23;493;55;0;23520;9105;0;14.5;5.6;0.0
2A;2021-03-24;825;90;0;24345;9195;0;15.0;5.7;0.0
2A;2021-03-25;901;136;0;25246;9331;0;15.5;5.7;0.0
2A;2021-03-26;1026;151;0;26272;9482;0;16.2;5.8;0.0
2A;2021-03-27;1118;191;0;27390;9673;0;16.9;6.0;0.0
2A;2021-03-28;232;86;0;27622;9759;0;17.0;6.0;0.0
2A;2021-03-29;289;126;0;27911;9885;0;17.2;6.1;0.0
2A;2021-03-30;385;233;0;28296;10118;0;17.4;6.2;0.0
2A;2021-03-31;454;225;0;28750;10343;0;17.7;6.4;0.0
2A;2021-04-01;603;424;0;29353;10767;0;18.1;6.6;0.0
2A;2021-04-02;846;761;0;30199;11528;0;18.6;7.1;0.0
2A;2021-04-03;616;922;0;30815;12450;0;19.0;7.7;0.0
2A;2021-04-04;528;694;0;31343;13144;0;19.3;8.1;0.0
2A;2021-04-05;472;638;0;31815;13782;0;19.6;8.5;0.0
2A;2021-04-06;497;522;0;32312;14304;0;19.9;8.8;0.0
2A;2021-04-07;708;417;0;33020;14721;0;20.3;9.1;0.0
2A;2021-04-08;955;353;0;33975;15074;0;20.9;9.3;0.0
2A;2021-04-09;864;389;0;34839;15463;0;21.4;9.5;0.0
2A;2021-04-10;953;363;0;35792;15826;0;22.0;9.7;0.0
2A;2021-04-11;327;242;0;36119;16068;0;22.2;9.9;0.0
2A;2021-04-12;614;355;0;36733;16423;0;22.6;10.1;0.0
2A;2021-04-13;304;377;0;37037;16800;0;22.8;10.3;0.0
2A;2021-04-14;961;572;0;37998;17372;0;23.4;10.7;0.0
2A;2021-04-15;921;514;0;38919;17886;0;24.0;11.0;0.0
2A;2021-04-16;788;380;0;39707;18266;0;24.4;11.2;0.0
2A;2021-04-17;1214;875;0;40921;19141;0;25.2;11.8;0.0
2A;2021-04-18;868;853;0;41789;19994;0;25.7;12.3;0.0
2A;2021-04-19;230;330;0;42019;20324;0;25.9;12.5;0.0
2A;2021-04-20;305;343;0;42324;20667;0;26.1;12.7;0.0
2A;2021-04-21;647;702;0;42971;21369;0;26.5;13.2;0.0
2A;2021-04-22;794;628;0;43765;21997;0;26.9;13.5;0.0
2A;2021-04-23;875;732;0;44640;22729;0;27.5;14.0;0.0
2A;2021-04-24;1542;914;0;46182;23643;0;28.4;14.6;0.0
2A;2021-04-25;844;277;0;47026;23920;0;29.0;14.7;0.0
2A;2021-04-26;298;218;0;47324;24138;0;29.1;14.9;0.0
2A;2021-04-27;302;355;0;47626;24493;0;29.3;15.1;0.0
2A;2021-04-28;1475;411;0;49101;24904;0;30.2;15.3;0.0
2A;2021-04-29;949;360;0;50050;25264;0;30.8;15.6;0.0
2A;2021-04-30;1019;971;0;51069;26235;0;31.4;16.2;0.0
2A;2021-05-01;867;546;0;51936;26781;0;32.0;16.5;0.0
2A;2021-05-02;574;632;0;52510;27413;0;32.3;16.9;0.0
2A;2021-05-03;543;530;0;53053;27943;0;32.7;17.2;0.0
2A;2021-05-04;667;504;0;53720;28447;0;33.1;17.5;0.0
2A;2021-05-05;880;918;0;54600;29365;0;33.6;18.1;0.0
2A;2021-05-06;786;845;0;55386;30210;0;34.1;18.6;0.0
2A;2021-05-07;948;746;0;56334;30956;0;34.7;19.1;0.0
2A;2021-05-08;372;455;0;56706;31411;0;34.9;19.3;0.0
2A;2021-05-09;635;580;0;57341;31991;0;35.3;19.7;0.0
2A;2021-05-10;373;687;0;57714;32678;0;35.5;20.1;0.0
2A;2021-05-11;502;392;0;58216;33070;0;35.8;20.4;0.0
2A;2021-05-12;697;441;0;58913;33511;0;36.3;20.6;0.0
2A;2021-05-13;665;101;0;59578;33612;0;36.7;20.7;0.0
2A;2021-05-14;558;588;0;60136;34200;0;37.0;21.1;0.0
2A;2021-05-15;623;584;0;60759;34784;0;37.4;21.4;0.0
2A;2021-05-16;548;422;0;61307;35206;0;37.7;21.7;0.0
2A;2021-05-17;449;504;0;61756;35710;0;38.0;22.0;0.0
2A;2021-05-18;494;450;0;62250;36160;0;38.3;22.3;0.0
2A;2021-05-19;635;426;0;62885;36586;0;38.7;22.5;0.0
2A;2021-05-20;581;486;0;63466;37072;0;39.1;22.8;0.0
2A;2021-05-21;420;420;0;63886;37492;0;39.3;23.1;0.0
2A;2021-05-22;338;258;0;64224;37750;0;39.5;23.2;0.0
2A;2021-05-23;390;220;0;64614;37970;0;39.8;23.4;0.0
2A;2021-05-24;84;33;0;64698;38003;0;39.8;23.4;0.0
2A;2021-05-25;338;430;0;65036;38433;0;40.0;23.7;0.0
2A;2021-05-26;341;1060;0;65377;39493;0;40.3;24.3;0.0
2A;2021-05-27;361;1022;0;65738;40515;0;40.5;24.9;0.0
2A;2021-05-28;258;834;0;65996;41349;0;40.6;25.5;0.0
2A;2021-05-29;263;817;0;66259;42166;0;40.8;26.0;0.0
2A;2021-05-30;128;446;0;66387;42612;0;40.9;26.2;0.0
2A;2021-05-31;163;397;0;66550;43009;0;41.0;26.5;0.0
2A;2021-06-01;293;635;0;66843;43644;0;41.2;26.9;0.0
2A;2021-06-02;261;868;0;67104;44512;0;41.3;27.4;0.0
2A;2021-06-03;263;800;0;67367;45312;0;41.5;27.9;0.0
2A;2021-06-04;269;959;0;67636;46271;0;41.6;28.5;0.0
2A;2021-06-05;256;1321;0;67892;47592;0;41.8;29.3;0.0
2A;2021-06-06;130;803;0;68022;48395;0;41.9;29.8;0.0
2A;2021-06-07;143;582;0;68165;48977;0;42.0;30.2;0.0
2A;2021-06-08;297;591;0;68462;49568;0;42.2;30.5;0.0
2A;2021-06-09;302;1198;0;68764;50766;0;42.3;31.3;0.0
2A;2021-06-10;314;780;0;69078;51546;0;42.5;31.7;0.0
2A;2021-06-11;250;913;0;69328;52459;0;42.7;32.3;0.0
2A;2021-06-12;187;611;0;69515;53070;0;42.8;32.7;0.0
2A;2021-06-13;133;679;0;69648;53749;0;42.9;33.1;0.0
2A;2021-06-14;217;790;0;69865;54539;0;43.0;33.6;0.0
2A;2021-06-15;213;467;0;70078;55006;0;43.1;33.9;0.0
2A;2021-06-16;184;679;0;70262;55685;0;43.3;34.3;0.0
2A;2021-06-17;202;513;0;70464;56198;0;43.4;34.6;0.0
2A;2021-06-18;226;713;0;70690;56911;0;43.5;35.0;0.0
2A;2021-06-19;186;572;0;70876;57483;0;43.6;35.4;0.0
2A;2021-06-20;121;586;0;70997;58069;0;43.7;35.8;0.0
2A;2021-06-21;163;674;0;71160;58743;0;43.8;36.2;0.0
2A;2021-06-22;218;697;0;71378;59440;0;43.9;36.6;0.0
2A;2021-06-23;181;489;0;71559;59929;0;44.1;36.9;0.0
2A;2021-06-24;130;330;0;71689;60259;0;44.1;37.1;0.0
2A;2021-06-25;164;434;0;71853;60693;0;44.2;37.4;0.0
2A;2021-06-26;160;714;0;72013;61407;0;44.3;37.8;0.0
2A;2021-06-27;149;645;0;72162;62052;0;44.4;38.2;0.0
2A;2021-06-28;164;556;0;72326;62608;0;44.5;38.5;0.0
2A;2021-06-29;192;586;0;72518;63194;0;44.6;38.9;0.0
2A;2021-06-30;196;421;0;72714;63615;0;44.8;39.2;0.0
2A;2021-07-01;218;433;0;72932;64048;0;44.9;39.4;0.0
2A;2021-07-02;194;334;0;73126;64382;0;45.0;39.6;0.0
2A;2021-07-03;172;520;0;73298;64902;0;45.1;40.0;0.0
2A;2021-07-04;130;501;0;73428;65403;0;45.2;40.3;0.0
2A;2021-07-05;165;222;0;73593;65625;0;45.3;40.4;0.0
2A;2021-07-06;214;334;0;73807;65959;0;45.4;40.6;0.0
2A;2021-07-07;344;507;0;74151;66466;0;45.7;40.9;0.0
2A;2021-07-08;471;512;0;74622;66978;0;45.9;41.2;0.0
2A;2021-07-09;313;351;0;74935;67329;0;46.1;41.5;0.0
2A;2021-07-10;259;313;0;75194;67642;0;46.3;41.6;0.0
2A;2021-07-11;62;104;0;75256;67746;0;46.3;41.7;0.0
2A;2021-07-12;279;313;0;75535;68059;0;46.5;41.9;0.0
2A;2021-07-13;950;441;0;76485;68500;0;47.1;42.2;0.0
2A;2021-07-14;1301;227;0;77786;68727;0;47.9;42.3;0.0
2A;2021-07-15;1092;549;0;78878;69276;0;48.6;42.7;0.0
2A;2021-07-16;871;331;0;79749;69607;0;49.1;42.9;0.0
2A;2021-07-17;865;290;0;80614;69897;0;49.6;43.0;0.0
2A;2021-07-18;427;89;0;81041;69986;0;49.9;43.1;0.0
2A;2021-07-19;696;321;0;81737;70307;0;50.3;43.3;0.0
2A;2021-07-20;900;347;0;82637;70654;0;50.9;43.5;0.0
2A;2021-07-21;1027;492;0;83664;71146;0;51.5;43.8;0.0
2A;2021-07-22;943;503;0;84607;71649;0;52.1;44.1;0.0
2A;2021-07-23;1012;314;0;85619;71963;0;52.7;44.3;0.0
2A;2021-07-24;666;214;0;86285;72177;0;53.1;44.4;0.0
2A;2021-07-25;282;56;0;86567;72233;0;53.3;44.5;0.0
2A;2021-07-26;731;310;0;87298;72543;0;53.7;44.7;0.0
2A;2021-07-27;813;360;0;88111;72903;0;54.2;44.9;0.0
2A;2021-07-28;870;404;0;88981;73307;0;54.8;45.1;0.0
2A;2021-07-29;848;418;0;89829;73725;0;55.3;45.4;0.0
2A;2021-07-30;638;423;0;90467;74148;0;55.7;45.7;0.0
2A;2021-07-31;396;254;0;90863;74402;0;55.9;45.8;0.0
2A;2021-08-01;312;54;0;91175;74456;0;56.1;45.8;0.0
2A;2021-08-02;304;344;0;91479;74800;0;56.3;46.1;0.0
2A;2021-08-03;549;659;0;92028;75459;0;56.7;46.5;0.0
2A;2021-08-04;535;897;0;92563;76356;0;57.0;47.0;0.0
2A;2021-08-05;635;970;0;93198;77326;0;57.4;47.6;0.0
2A;2021-08-06;342;596;0;93540;77922;0;57.6;48.0;0.0
2A;2021-08-07;267;713;0;93807;78635;0;57.8;48.4;0.0
2A;2021-08-08;72;171;0;93879;78806;0;57.8;48.5;0.0
2A;2021-08-09;497;826;0;94376;79632;0;58.1;49.0;0.0
2A;2021-08-10;477;820;0;94853;80452;0;58.4;49.5;0.0
2A;2021-08-11;485;754;0;95338;81206;0;58.7;50.0;0.0
2A;2021-08-12;549;1056;0;95887;82262;0;59.0;50.6;0.0
2A;2021-08-13;397;806;0;96284;83068;0;59.3;51.1;0.0
2A;2021-08-14;338;572;0;96622;83640;0;59.5;51.5;0.0
2A;2021-08-15;27;26;0;96649;83666;0;59.5;51.5;0.0
2A;2021-08-16;402;919;0;97051;84585;0;59.8;52.1;0.0
2A;2021-08-17;647;904;0;97698;85489;0;60.2;52.6;0.0
2A;2021-08-18;426;837;0;98124;86326;0;60.4;53.1;0.0
2A;2021-08-19;341;711;0;98465;87037;0;60.6;53.6;0.0
2A;2021-08-20;293;450;0;98758;87487;0;60.8;53.9;0.0
2A;2021-08-21;182;407;0;98940;87894;0;60.9;54.1;0.0
2A;2021-08-22;115;350;0;99055;88244;0;61.0;54.3;0.0
2A;2021-08-23;286;528;0;99341;88772;0;61.2;54.7;0.0
2A;2021-08-24;279;623;0;99620;89395;0;61.3;55.0;0.0
2A;2021-08-25;324;674;0;99944;90069;0;61.5;55.5;0.0
2A;2021-08-26;309;619;0;100253;90688;0;61.7;55.8;0.0
2A;2021-08-27;208;575;0;100461;91263;0;61.9;56.2;0.0
2A;2021-08-28;213;294;0;100674;91557;0;62.0;56.4;0.0
2A;2021-08-29;78;96;0;100752;91653;0;62.0;56.4;0.0
2A;2021-08-30;236;468;27;100988;92121;27;62.2;56.7;0.0
2A;2021-08-31;168;449;29;101156;92570;56;62.3;57.0;0.0
2A;2021-09-01;333;595;56;101489;93165;112;62.5;57.4;0.1
2A;2021-09-02;258;521;81;101747;93686;193;62.6;57.7;0.1
2A;2021-09-03;210;418;130;101957;94104;323;62.8;57.9;0.2
2A;2021-09-04;130;338;32;102087;94442;355;62.9;58.1;0.2
2A;2021-09-05;28;23;17;102115;94465;372;62.9;58.2;0.2
2A;2021-09-06;109;303;80;102224;94768;452;62.9;58.3;0.3
2A;2021-09-07;193;464;147;102417;95232;599;63.1;58.6;0.4
2A;2021-09-08;206;554;122;102623;95786;721;63.2;59.0;0.4
2A;2021-09-09;198;414;113;102821;96200;834;63.3;59.2;0.5
2A;2021-09-10;171;334;122;102992;96534;956;63.4;59.4;0.6
2A;2021-09-11;130;258;50;103122;96792;1006;63.5;59.6;0.6
2A;2021-09-12;36;66;46;103158;96858;1052;63.5;59.6;0.6
2A;2021-09-13;122;179;57;103280;97037;1109;63.6;59.7;0.7
2A;2021-09-14;212;213;176;103492;97250;1285;63.7;59.9;0.8
2A;2021-09-15;182;457;143;103674;97707;1428;63.8;60.2;0.9
2A;2021-09-16;206;324;175;103880;98031;1603;64.0;60.4;1.0
2A;2021-09-17;127;184;84;104007;98215;1687;64.0;60.5;1.0
2A;2021-09-18;87;250;106;104094;98465;1793;64.1;60.6;1.1
2A;2021-09-19;11;47;14;104105;98512;1807;64.1;60.7;1.1
2A;2021-09-20;44;155;101;104149;98667;1908;64.1;60.7;1.2
2A;2021-09-21;81;222;210;104230;98889;2118;64.2;60.9;1.3
2A;2021-09-22;96;378;225;104326;99267;2343;64.2;61.1;1.4
2A;2021-09-23;85;273;159;104411;99540;2502;64.3;61.3;1.5
2A;2021-09-24;66;269;101;104477;99809;2603;64.3;61.5;1.6
2A;2021-09-25;75;141;41;104552;99950;2644;64.4;61.5;1.6
2A;2021-09-26;14;31;2;104566;99981;2646;64.4;61.6;1.6
2A;2021-09-27;43;104;69;104609;100085;2715;64.4;61.6;1.7
2A;2021-09-28;81;134;133;104690;100219;2848;64.5;61.7;1.8
2A;2021-09-29;115;286;132;104805;100505;2980;64.5;61.9;1.8
2A;2021-09-30;77;201;219;104882;100706;3199;64.6;62.0;2.0
2A;2021-10-01;125;125;209;105007;100831;3408;64.7;62.1;2.1
2A;2021-10-02;83;136;68;105090;100967;3476;64.7;62.2;2.1
2A;2021-10-03;17;38;23;105107;101005;3499;64.7;62.2;2.2
2A;2021-10-04;72;79;107;105179;101084;3606;64.8;62.2;2.2
2A;2021-10-05;51;124;118;105230;101208;3724;64.8;62.3;2.3
2A;2021-10-06;69;128;156;105299;101336;3880;64.8;62.4;2.4
2A;2021-10-07;62;119;147;105361;101455;4027;64.9;62.5;2.5
2A;2021-10-08;71;131;127;105432;101586;4154;64.9;62.5;2.6
2A;2021-10-09;75;220;212;105507;101806;4366;65.0;62.7;2.7
2A;2021-10-10;56;71;171;105563;101877;4537;65.0;62.7;2.8
2A;2021-10-11;44;78;110;105607;101955;4647;65.0;62.8;2.9
2A;2021-10-12;46;70;106;105653;102025;4753;65.0;62.8;2.9
2A;2021-10-13;66;127;234;105719;102152;4987;65.1;62.9;3.1
2A;2021-10-14;73;129;206;105792;102281;5193;65.1;63.0;3.2
2A;2021-10-15;85;94;193;105877;102375;5386;65.2;63.0;3.3
2A;2021-10-16;81;153;331;105958;102528;5717;65.2;63.1;3.5
2A;2021-10-17;38;37;109;105996;102565;5826;65.3;63.1;3.6
2A;2021-10-18;59;82;155;106055;102647;5981;65.3;63.2;3.7
2A;2021-10-19;45;75;207;106100;102722;6188;65.3;63.2;3.8
2A;2021-10-20;82;90;271;106182;102812;6459;65.4;63.3;4.0
2A;2021-10-21;62;79;312;106244;102891;6771;65.4;63.3;4.2
2A;2021-10-22;64;107;287;106308;102998;7058;65.5;63.4;4.3
2A;2021-10-23;60;96;203;106368;103094;7261;65.5;63.5;4.5
2A;2021-10-24;32;45;128;106400;103139;7389;65.5;63.5;4.5
2A;2021-10-25;50;55;181;106450;103194;7570;65.5;63.5;4.7
2A;2021-10-26;41;60;216;106491;103254;7786;65.6;63.6;4.8
2A;2021-10-27;71;93;333;106562;103347;8119;65.6;63.6;5.0
2A;2021-10-28;48;74;276;106610;103421;8395;65.6;63.7;5.2
2A;2021-10-29;53;78;352;106663;103499;8747;65.7;63.7;5.4
2A;2021-10-30;51;81;255;106714;103580;9002;65.7;63.8;5.5
2A;2021-10-31;27;61;96;106741;103641;9098;65.7;63.8;5.6
2A;2021-11-01;14;9;6;106755;103650;9104;65.7;63.8;5.6
2A;2021-11-02;50;49;140;106805;103699;9244;65.8;63.8;5.7
2A;2021-11-03;59;69;340;106864;103768;9584;65.8;63.9;5.9
2A;2021-11-04;54;64;358;106918;103832;9942;65.8;63.9;6.1
2A;2021-11-05;56;94;500;106974;103926;10442;65.9;64.0;6.4
2A;2021-11-06;88;74;303;107062;104000;10745;65.9;64.0;6.6
2A;2021-11-07;30;42;124;107092;104042;10869;65.9;64.1;6.7
2A;2021-11-08;35;73;338;107127;104115;11207;66.0;64.1;6.9
2A;2021-11-09;44;62;454;107171;104177;11661;66.0;64.1;7.2
2A;2021-11-10;72;76;513;107243;104253;12174;66.0;64.2;7.5
2A;2021-11-11;20;12;82;107263;104265;12256;66.0;64.2;7.5
2A;2021-11-12;40;70;518;107303;104335;12774;66.1;64.2;7.9
2A;2021-11-13;69;71;711;107372;104406;13485;66.1;64.3;8.3
2A;2021-11-14;35;53;265;107407;104459;13750;66.1;64.3;8.5
2A;2021-11-15;47;74;537;107454;104533;14287;66.2;64.4;8.8
2A;2021-11-16;60;86;516;107514;104619;14803;66.2;64.4;9.1
2A;2021-11-17;58;79;622;107572;104698;15425;66.2;64.5;9.5
2A;2021-11-18;62;48;662;107634;104746;16087;66.3;64.5;9.9
2A;2021-11-19;74;87;720;107708;104833;16807;66.3;64.5;10.3
2A;2021-11-20;100;83;550;107808;104916;17357;66.4;64.6;10.7
2A;2021-11-21;65;39;370;107873;104955;17727;66.4;64.6;10.9
2A;2021-11-22;55;53;648;107928;105008;18375;66.4;64.7;11.3
2A;2021-11-23;53;62;772;107981;105070;19147;66.5;64.7;11.8
2A;2021-11-24;89;74;731;108070;105144;19878;66.5;64.7;12.2
2A;2021-11-25;75;97;1041;108145;105241;20919;66.6;64.8;12.9
2A;2021-11-26;63;83;1478;108208;105324;22397;66.6;64.8;13.8
2A;2021-11-27;124;109;1470;108332;105433;23867;66.7;64.9;14.7
2A;2021-11-28;66;42;1012;108398;105475;24879;66.7;64.9;15.3
2A;2021-11-29;72;71;1133;108470;105546;26012;66.8;65.0;16.0
2A;2021-11-30;73;58;1260;108543;105604;27272;66.8;65.0;16.8
2A;2021-12-01;91;93;1262;108634;105697;28534;66.9;65.1;17.6
2A;2021-12-02;63;64;1578;108697;105761;30112;66.9;65.1;18.5
2A;2021-12-03;88;82;1731;108785;105843;31843;67.0;65.2;19.6
2A;2021-12-04;90;104;1855;108875;105947;33698;67.0;65.2;20.7
2A;2021-12-05;47;56;947;108922;106003;34645;67.1;65.3;21.3
2A;2021-12-06;76;74;1169;108998;106077;35814;67.1;65.3;22.1
2A;2021-12-07;56;84;1294;109054;106161;37108;67.1;65.4;22.8
2A;2021-12-08;52;92;1268;109106;106253;38376;67.2;65.4;23.6
2A;2021-12-09;56;92;1441;109162;106345;39817;67.2;65.5;24.5
2A;2021-12-10;76;113;1502;109238;106458;41319;67.3;65.5;25.4
2A;2021-12-11;66;99;1469;109304;106557;42788;67.3;65.6;26.3
2A;2021-12-12;55;95;797;109359;106652;43585;67.3;65.7;26.8
2A;2021-12-13;44;73;1126;109403;106725;44711;67.4;65.7;27.5
2A;2021-12-14;47;82;1329;109450;106807;46040;67.4;65.8;28.3
2A;2021-12-15;84;118;1315;109534;106925;47355;67.4;65.8;29.2
2A;2021-12-16;69;109;1445;109603;107034;48800;67.5;65.9;30.0
2B;2020-12-27;0;0;0;0;0;0;0.0;0.0;0.0
2B;2020-12-28;3;0;0;3;0;0;0.0;0.0;0.0
2B;2020-12-29;0;0;0;3;0;0;0.0;0.0;0.0
2B;2020-12-30;0;0;0;3;0;0;0.0;0.0;0.0
2B;2020-12-31;0;0;0;3;0;0;0.0;0.0;0.0
2B;2021-01-01;0;0;0;3;0;0;0.0;0.0;0.0
2B;2021-01-02;0;0;0;3;0;0;0.0;0.0;0.0
2B;2021-01-03;0;0;0;3;0;0;0.0;0.0;0.0
2B;2021-01-04;1;0;0;4;0;0;0.0;0.0;0.0
2B;2021-01-05;0;0;0;4;0;0;0.0;0.0;0.0
2B;2021-01-06;48;1;0;52;1;0;0.0;0.0;0.0
2B;2021-01-07;203;0;0;255;1;0;0.1;0.0;0.0
2B;2021-01-08;189;5;0;444;6;0;0.2;0.0;0.0
2B;2021-01-09;42;1;0;486;7;0;0.3;0.0;0.0
2B;2021-01-10;5;0;0;491;7;0;0.3;0.0;0.0
2B;2021-01-11;70;0;0;561;7;0;0.3;0.0;0.0
2B;2021-01-12;129;1;0;690;8;0;0.4;0.0;0.0
2B;2021-01-13;95;0;0;785;8;0;0.4;0.0;0.0
2B;2021-01-14;72;0;0;857;8;0;0.5;0.0;0.0
2B;2021-01-15;258;1;0;1115;9;0;0.6;0.0;0.0
2B;2021-01-16;50;0;0;1165;9;0;0.6;0.0;0.0
2B;2021-01-17;10;0;0;1175;9;0;0.6;0.0;0.0
2B;2021-01-18;265;1;0;1440;10;0;0.8;0.0;0.0
2B;2021-01-19;485;2;0;1925;12;0;1.1;0.0;0.0
2B;2021-01-20;427;3;0;2352;15;0;1.3;0.0;0.0
2B;2021-01-21;345;0;0;2697;15;0;1.5;0.0;0.0
2B;2021-01-22;374;1;0;3071;16;0;1.7;0.0;0.0
2B;2021-01-23;63;0;0;3134;16;0;1.7;0.0;0.0
2B;2021-01-24;26;0;0;3160;16;0;1.7;0.0;0.0
2B;2021-01-25;204;2;0;3364;18;0;1.8;0.0;0.0
2B;2021-01-26;368;1;0;3732;19;0;2.0;0.0;0.0
2B;2021-01-27;323;48;0;4055;67;0;2.2;0.0;0.0
2B;2021-01-28;342;138;0;4397;205;0;2.4;0.1;0.0
2B;2021-01-29;292;158;0;4689;363;0;2.6;0.2;0.0
2B;2021-01-30;86;35;0;4775;398;0;2.6;0.2;0.0
2B;2021-01-31;66;0;0;4841;398;0;2.7;0.2;0.0
2B;2021-02-01;223;91;0;5064;489;0;2.8;0.3;0.0
2B;2021-02-02;331;77;0;5395;566;0;3.0;0.3;0.0
2B;2021-02-03;490;88;0;5885;654;0;3.2;0.4;0.0
2B;2021-02-04;433;164;0;6318;818;0;3.5;0.4;0.0
2B;2021-02-05;375;101;0;6693;919;0;3.7;0.5;0.0
2B;2021-02-06;80;18;0;6773;937;0;3.7;0.5;0.0
2B;2021-02-07;59;3;0;6832;940;0;3.7;0.5;0.0
2B;2021-02-08;222;149;0;7054;1089;0;3.9;0.6;0.0
2B;2021-02-09;531;292;0;7585;1381;0;4.2;0.8;0.0
2B;2021-02-10;441;211;0;8026;1592;0;4.4;0.9;0.0
2B;2021-02-11;358;133;0;8384;1725;0;4.6;0.9;0.0
2B;2021-02-12;284;123;0;8668;1848;0;4.8;1.0;0.0
2B;2021-02-13;77;15;0;8745;1863;0;4.8;1.0;0.0
2B;2021-02-14;64;4;0;8809;1867;0;4.8;1.0;0.0
2B;2021-02-15;185;129;0;8994;1996;0;4.9;1.1;0.0
2B;2021-02-16;236;274;0;9230;2270;0;5.1;1.2;0.0
2B;2021-02-17;295;277;0;9525;2547;0;5.2;1.4;0.0
2B;2021-02-18;207;330;0;9732;2877;0;5.3;1.6;0.0
2B;2021-02-19;163;285;0;9895;3162;0;5.4;1.7;0.0
2B;2021-02-20;35;66;0;9930;3228;0;5.4;1.8;0.0
2B;2021-02-21;24;28;0;9954;3256;0;5.5;1.8;0.0
2B;2021-02-22;134;172;0;10088;3428;0;5.5;1.9;0.0
2B;2021-02-23;228;333;0;10316;3761;0;5.7;2.1;0.0
2B;2021-02-24;218;279;0;10534;4040;0;5.8;2.2;0.0
2B;2021-02-25;239;321;0;10773;4361;0;5.9;2.4;0.0
2B;2021-02-26;302;274;0;11075;4635;0;6.1;2.5;0.0
2B;2021-02-27;64;87;0;11139;4722;0;6.1;2.6;0.0
2B;2021-02-28;5;62;0;11144;4784;0;6.1;2.6;0.0
2B;2021-03-01;239;254;0;11383;5038;0;6.2;2.8;0.0
2B;2021-03-02;332;361;0;11715;5399;0;6.4;3.0;0.0
2B;2021-03-03;299;413;0;12014;5812;0;6.6;3.2;0.0
2B;2021-03-04;412;384;0;12426;6196;0;6.8;3.4;0.0
2B;2021-03-05;592;359;0;13018;6555;0;7.1;3.6;0.0
2B;2021-03-06;678;97;0;13696;6652;0;7.5;3.6;0.0
2B;2021-03-07;361;60;0;14057;6712;0;7.7;3.7;0.0
2B;2021-03-08;300;236;0;14357;6948;0;7.9;3.8;0.0
2B;2021-03-09;384;464;0;14741;7412;0;8.1;4.1;0.0
2B;2021-03-10;602;408;0;15343;7820;0;8.4;4.3;0.0
2B;2021-03-11;593;335;0;15936;8155;0;8.7;4.5;0.0
2B;2021-03-12;914;225;0;16850;8380;0;9.2;4.6;0.0
2B;2021-03-13;493;104;0;17343;8484;0;9.5;4.7;0.0
2B;2021-03-14;221;67;0;17564;8551;0;9.6;4.7;0.0
2B;2021-03-15;479;201;0;18043;8752;0;9.9;4.8;0.0
2B;2021-03-16;537;270;0;18580;9022;0;10.2;5.0;0.0
2B;2021-03-17;515;246;0;19095;9268;0;10.5;5.1;0.0
2B;2021-03-18;522;219;0;19617;9487;0;10.8;5.2;0.0
2B;2021-03-19;737;197;0;20354;9684;0;11.2;5.3;0.0
2B;2021-03-20;643;37;0;20997;9721;0;11.5;5.3;0.0
2B;2021-03-21;418;34;0;21415;9755;0;11.7;5.4;0.0
2B;2021-03-22;513;129;0;21928;9884;0;12.0;5.4;0.0
2B;2021-03-23;757;247;0;22685;10131;0;12.4;5.6;0.0
2B;2021-03-24;811;214;0;23496;10345;0;12.9;5.7;0.0
2B;2021-03-25;774;154;0;24270;10499;0;13.3;5.8;0.0
2B;2021-03-26;917;179;0;25187;10678;0;13.8;5.9;0.0
2B;2021-03-27;1040;38;0;26227;10716;0;14.4;5.9;0.0
2B;2021-03-28;800;127;0;27027;10843;0;14.8;5.9;0.0
2B;2021-03-29;705;184;0;27732;11027;0;15.2;6.1;0.0
2B;2021-03-30;895;304;0;28627;11331;0;15.7;6.2;0.0
2B;2021-03-31;919;256;0;29546;11587;0;16.2;6.4;0.0
2B;2021-04-01;970;214;0;30516;11801;0;16.7;6.5;0.0
2B;2021-04-02;933;392;0;31449;12193;0;17.3;6.7;0.0
2B;2021-04-03;1190;171;0;32639;12364;0;17.9;6.8;0.0
2B;2021-04-04;190;88;0;32829;12452;0;18.0;6.8;0.0
2B;2021-04-05;120;113;0;32949;12565;0;18.1;6.9;0.0
2B;2021-04-06;932;361;0;33881;12926;0;18.6;7.1;0.0
2B;2021-04-07;1151;418;0;35032;13344;0;19.2;7.3;0.0
2B;2021-04-08;1055;399;0;36087;13743;0;19.8;7.5;0.0
2B;2021-04-09;1111;542;0;37198;14285;0;20.4;7.8;0.0
2B;2021-04-10;1266;251;0;38464;14536;0;21.1;8.0;0.0
2B;2021-04-11;773;78;0;39237;14614;0;21.5;8.0;0.0
2B;2021-04-12;803;516;0;40040;15130;0;22.0;8.3;0.0
2B;2021-04-13;995;602;0;41035;15732;0;22.5;8.6;0.0
2B;2021-04-14;979;467;0;42014;16199;0;23.1;8.9;0.0
2B;2021-04-15;857;505;0;42871;16704;0;23.5;9.2;0.0
2B;2021-04-16;854;598;0;43725;17302;0;24.0;9.5;0.0
2B;2021-04-17;367;433;0;44092;17735;0;24.2;9.7;0.0
2B;2021-04-18;241;332;0;44333;18067;0;24.3;9.9;0.0
2B;2021-04-19;767;424;0;45100;18491;0;24.7;10.1;0.0
2B;2021-04-20;846;793;0;45946;19284;0;25.2;10.6;0.0
2B;2021-04-21;964;585;0;46910;19869;0;25.7;10.9;0.0
2B;2021-04-22;870;701;0;47780;20570;0;26.2;11.3;0.0
2B;2021-04-23;590;599;0;48370;21169;0;26.5;11.6;0.0
2B;2021-04-24;279;743;0;48649;21912;0;26.7;12.0;0.0
2B;2021-04-25;261;457;0;48910;22369;0;26.8;12.3;0.0
2B;2021-04-26;637;864;0;49547;23233;0;27.2;12.7;0.0
2B;2021-04-27;922;830;0;50469;24063;0;27.7;13.2;0.0
2B;2021-04-28;855;809;0;51324;24872;0;28.2;13.6;0.0
2B;2021-04-29;895;830;0;52219;25702;0;28.7;14.1;0.0
2B;2021-04-30;1070;791;0;53289;26493;0;29.2;14.5;0.0
2B;2021-05-01;420;1070;0;53709;27563;0;29.5;15.1;0.0
2B;2021-05-02;300;231;0;54009;27794;0;29.6;15.2;0.0
2B;2021-05-03;911;462;0;54920;28256;0;30.1;15.5;0.0
2B;2021-05-04;734;1062;0;55654;29318;0;30.5;16.1;0.0
2B;2021-05-05;765;1286;0;56419;30604;0;31.0;16.8;0.0
2B;2021-05-06;1164;848;0;57583;31452;0;31.6;17.3;0.0
2B;2021-05-07;962;939;0;58545;32391;0;32.1;17.8;0.0
2B;2021-05-08;387;811;0;58932;33202;0;32.3;18.2;0.0
2B;2021-05-09;368;647;0;59300;33849;0;32.5;18.6;0.0
2B;2021-05-10;823;776;0;60123;34625;0;33.0;19.0;0.0
2B;2021-05-11;793;1065;0;60916;35690;0;33.4;19.6;0.0
2B;2021-05-12;758;843;0;61674;36533;0;33.8;20.0;0.0
2B;2021-05-13;855;348;0;62529;36881;0;34.3;20.2;0.0
2B;2021-05-14;585;522;0;63114;37403;0;34.6;20.5;0.0
2B;2021-05-15;569;325;0;63683;37728;0;34.9;20.7;0.0
2B;2021-05-16;220;169;0;63903;37897;0;35.1;20.8;0.0
2B;2021-05-17;880;374;0;64783;38271;0;35.5;21.0;0.0
2B;2021-05-18;848;348;0;65631;38619;0;36.0;21.2;0.0
2B;2021-05-19;660;376;0;66291;38995;0;36.4;21.4;0.0
2B;2021-05-20;600;343;0;66891;39338;0;36.7;21.6;0.0
2B;2021-05-21;586;472;0;67477;39810;0;37.0;21.8;0.0
2B;2021-05-22;471;353;0;67948;40163;0;37.3;22.0;0.0
2B;2021-05-23;130;41;0;68078;40204;0;37.4;22.1;0.0
2B;2021-05-24;57;109;0;68135;40313;0;37.4;22.1;0.0
2B;2021-05-25;458;323;0;68593;40636;0;37.6;22.3;0.0
2B;2021-05-26;471;720;0;69064;41356;0;37.9;22.7;0.0
2B;2021-05-27;379;1074;0;69443;42430;0;38.1;23.3;0.0
2B;2021-05-28;430;829;0;69873;43259;0;38.3;23.7;0.0
2B;2021-05-29;250;319;0;70123;43578;0;38.5;23.9;0.0
2B;2021-05-30;35;48;0;70158;43626;0;38.5;23.9;0.0
2B;2021-05-31;337;766;0;70495;44392;0;38.7;24.4;0.0
2B;2021-06-01;361;951;0;70856;45343;0;38.9;24.9;0.0
2B;2021-06-02;317;929;0;71173;46272;0;39.1;25.4;0.0
2B;2021-06-03;452;733;0;71625;47005;0;39.3;25.8;0.0
2B;2021-06-04;312;1135;0;71937;48140;0;39.5;26.4;0.0
2B;2021-06-05;237;450;0;72174;48590;0;39.6;26.7;0.0
2B;2021-06-06;37;131;0;72211;48721;0;39.6;26.7;0.0
2B;2021-06-07;270;885;0;72481;49606;0;39.8;27.2;0.0
2B;2021-06-08;341;1093;0;72822;50699;0;40.0;27.8;0.0
2B;2021-06-09;453;1089;0;73275;51788;0;40.2;28.4;0.0
2B;2021-06-10;336;882;0;73611;52670;0;40.4;28.9;0.0
2B;2021-06-11;386;1155;0;73997;53825;0;40.6;29.5;0.0
2B;2021-06-12;140;501;0;74137;54326;0;40.7;29.8;0.0
2B;2021-06-13;29;71;0;74166;54397;0;40.7;29.8;0.0
2B;2021-06-14;175;1001;0;74341;55398;0;40.8;30.4;0.0
2B;2021-06-15;328;1116;0;74669;56514;0;41.0;31.0;0.0
2B;2021-06-16;346;854;0;75015;57368;0;41.2;31.5;0.0
2B;2021-06-17;345;918;0;75360;58286;0;41.3;32.0;0.0
2B;2021-06-18;298;844;0;75658;59130;0;41.5;32.4;0.0
2B;2021-06-19;137;311;0;75795;59441;0;41.6;32.6;0.0
2B;2021-06-20;45;194;0;75840;59635;0;41.6;32.7;0.0
2B;2021-06-21;246;878;0;76086;60513;0;41.7;33.2;0.0
2B;2021-06-22;272;1015;0;76358;61528;0;41.9;33.8;0.0
2B;2021-06-23;196;791;0;76554;62319;0;42.0;34.2;0.0
2B;2021-06-24;281;682;0;76835;63001;0;42.2;34.6;0.0
2B;2021-06-25;194;923;0;77029;63924;0;42.3;35.1;0.0
2B;2021-06-26;96;477;0;77125;64401;0;42.3;35.3;0.0
2B;2021-06-27;26;195;0;77151;64596;0;42.3;35.4;0.0
2B;2021-06-28;292;857;0;77443;65453;0;42.5;35.9;0.0
2B;2021-06-29;240;860;0;77683;66313;0;42.6;36.4;0.0
2B;2021-06-30;321;825;0;78004;67138;0;42.8;36.8;0.0
2B;2021-07-01;212;442;0;78216;67580;0;42.9;37.1;0.0
2B;2021-07-02;191;474;0;78407;68054;0;43.0;37.3;0.0
2B;2021-07-03;86;361;0;78493;68415;0;43.1;37.5;0.0
2B;2021-07-04;6;11;0;78499;68426;0;43.1;37.5;0.0
2B;2021-07-05;237;589;0;78736;69015;0;43.2;37.9;0.0
2B;2021-07-06;404;606;0;79140;69621;0;43.4;38.2;0.0
2B;2021-07-07;355;764;0;79495;70385;0;43.6;38.6;0.0
2B;2021-07-08;169;289;0;79664;70674;0;43.7;38.8;0.0
2B;2021-07-09;216;330;0;79880;71004;0;43.8;39.0;0.0
2B;2021-07-10;161;153;0;80041;71157;0;43.9;39.0;0.0
2B;2021-07-11;19;26;0;80060;71183;0;43.9;39.1;0.0
2B;2021-07-12;429;640;0;80489;71823;0;44.2;39.4;0.0
2B;2021-07-13;730;852;0;81219;72675;0;44.6;39.9;0.0
2B;2021-07-14;294;75;0;81513;72750;0;44.7;39.9;0.0
2B;2021-07-15;1130;508;0;82643;73258;0;45.3;40.2;0.0
2B;2021-07-16;1002;480;0;83645;73738;0;45.9;40.5;0.0
2B;2021-07-17;646;284;0;84291;74022;0;46.2;40.6;0.0
2B;2021-07-18;152;40;0;84443;74062;0;46.3;40.6;0.0
2B;2021-07-19;780;604;0;85223;74666;0;46.8;41.0;0.0
2B;2021-07-20;1049;529;0;86272;75195;0;47.3;41.3;0.0
2B;2021-07-21;1183;603;0;87455;75798;0;48.0;41.6;0.0
2B;2021-07-22;1105;461;0;88560;76259;0;48.6;41.8;0.0
2B;2021-07-23;1112;387;0;89672;76646;0;49.2;42.1;0.0
2B;2021-07-24;457;254;0;90129;76900;0;49.5;42.2;0.0
2B;2021-07-25;167;40;0;90296;76940;0;49.5;42.2;0.0
2B;2021-07-26;795;507;0;91091;77447;0;50.0;42.5;0.0
2B;2021-07-27;1307;552;0;92398;77999;0;50.7;42.8;0.0
2B;2021-07-28;996;487;0;93394;78486;0;51.2;43.1;0.0
2B;2021-07-29;929;356;0;94323;78842;0;51.8;43.3;0.0
2B;2021-07-30;658;296;0;94981;79138;0;52.1;43.4;0.0
2B;2021-07-31;502;187;0;95483;79325;0;52.4;43.5;0.0
2B;2021-08-01;203;31;0;95686;79356;0;52.5;43.5;0.0
2B;2021-08-02;664;388;0;96350;79744;0;52.9;43.8;0.0
2B;2021-08-03;940;571;0;97290;80315;0;53.4;44.1;0.0
2B;2021-08-04;690;372;0;97980;80687;0;53.8;44.3;0.0
2B;2021-08-05;880;433;0;98860;81120;0;54.2;44.5;0.0
2B;2021-08-06;597;429;0;99457;81549;0;54.6;44.7;0.0
2B;2021-08-07;275;304;0;99732;81853;0;54.7;44.9;0.0
2B;2021-08-08;82;70;0;99814;81923;0;54.8;44.9;0.0
2B;2021-08-09;461;632;0;100275;82555;0;55.0;45.3;0.0
2B;2021-08-10;607;944;0;100882;83499;0;55.4;45.8;0.0
2B;2021-08-11;632;717;0;101514;84216;0;55.7;46.2;0.0
2B;2021-08-12;625;884;0;102139;85100;0;56.0;46.7;0.0
2B;2021-08-13;396;771;0;102535;85871;0;56.3;47.1;0.0
2B;2021-08-14;176;349;0;102711;86220;0;56.4;47.3;0.0
2B;2021-08-15;96;107;0;102807;86327;0;56.4;47.4;0.0
2B;2021-08-16;462;925;0;103269;87252;0;56.7;47.9;0.0
2B;2021-08-17;527;1100;0;103796;88352;0;57.0;48.5;0.0
2B;2021-08-18;442;992;0;104238;89344;0;57.2;49.0;0.0
2B;2021-08-19;371;737;0;104609;90081;0;57.4;49.4;0.0
2B;2021-08-20;292;710;0;104901;90791;0;57.6;49.8;0.0
2B;2021-08-21;135;429;0;105036;91220;0;57.6;50.0;0.0
2B;2021-08-22;71;174;0;105107;91394;0;57.7;50.1;0.0
2B;2021-08-23;336;829;0;105443;92223;0;57.9;50.6;0.0
2B;2021-08-24;419;992;0;105862;93215;0;58.1;51.1;0.0
2B;2021-08-25;300;866;0;106162;94081;0;58.2;51.6;0.0
2B;2021-08-26;374;707;0;106536;94788;0;58.5;52.0;0.0
2B;2021-08-27;233;508;0;106769;95296;0;58.6;52.3;0.0
2B;2021-08-28;148;374;0;106917;95670;0;58.7;52.5;0.0
2B;2021-08-29;51;106;0;106968;95776;0;58.7;52.5;0.0
2B;2021-08-30;329;741;17;107297;96517;17;58.9;53.0;0.0
2B;2021-08-31;340;777;47;107637;97294;64;59.1;53.4;0.0
2B;2021-09-01;377;832;62;108014;98126;126;59.3;53.8;0.1
2B;2021-09-02;289;575;73;108303;98701;199;59.4;54.2;0.1
2B;2021-09-03;217;384;69;108520;99085;268;59.5;54.4;0.1
2B;2021-09-04;123;289;40;108643;99374;308;59.6;54.5;0.2
2B;2021-09-05;14;96;25;108657;99470;333;59.6;54.6;0.2
2B;2021-09-06;173;533;84;108830;100003;417;59.7;54.9;0.2
2B;2021-09-07;230;685;200;109060;100688;617;59.8;55.2;0.3
2B;2021-09-08;193;580;110;109253;101268;727;59.9;55.6;0.4
2B;2021-09-09;174;351;112;109427;101619;839;60.0;55.8;0.5
2B;2021-09-10;198;334;110;109625;101953;949;60.1;55.9;0.5
2B;2021-09-11;129;233;54;109754;102186;1003;60.2;56.1;0.6
2B;2021-09-12;15;86;24;109769;102272;1027;60.2;56.1;0.6
2B;2021-09-13;177;438;61;109946;102710;1088;60.3;56.4;0.6
2B;2021-09-14;267;579;274;110213;103289;1362;60.5;56.7;0.7
2B;2021-09-15;158;551;107;110371;103840;1469;60.6;57.0;0.8
2B;2021-09-16;206;288;326;110577;104128;1795;60.7;57.1;1.0
2B;2021-09-17;122;188;134;110699;104316;1929;60.7;57.2;1.1
2B;2021-09-18;58;165;81;110757;104481;2010;60.8;57.3;1.1
2B;2021-09-19;14;21;21;110771;104502;2031;60.8;57.3;1.1
2B;2021-09-20;104;376;122;110875;104878;2153;60.8;57.5;1.2
2B;2021-09-21;103;368;192;110978;105246;2345;60.9;57.7;1.3
2B;2021-09-22;121;403;184;111099;105649;2529;61.0;58.0;1.4
2B;2021-09-23;99;214;207;111198;105863;2736;61.0;58.1;1.5
2B;2021-09-24;92;198;160;111290;106061;2896;61.1;58.2;1.6
2B;2021-09-25;42;127;67;111332;106188;2963;61.1;58.3;1.6
2B;2021-09-26;3;28;28;111335;106216;2991;61.1;58.3;1.6
2B;2021-09-27;66;225;97;111401;106441;3088;61.1;58.4;1.7
2B;2021-09-28;84;189;106;111485;106630;3194;61.2;58.5;1.8
2B;2021-09-29;120;322;133;111605;106952;3327;61.2;58.7;1.8
2B;2021-09-30;71;119;123;111676;107071;3450;61.3;58.7;1.9
2B;2021-10-01;141;162;114;111817;107233;3564;61.4;58.8;2.0
2B;2021-10-02;56;109;117;111873;107342;3681;61.4;58.9;2.0
2B;2021-10-03;8;15;7;111881;107357;3688;61.4;58.9;2.0
2B;2021-10-04;99;149;115;111980;107506;3803;61.4;59.0;2.1
2B;2021-10-05;89;216;218;112069;107722;4021;61.5;59.1;2.2
2B;2021-10-06;126;261;220;112195;107983;4241;61.6;59.2;2.3
2B;2021-10-07;48;121;256;112243;108104;4497;61.6;59.3;2.5
2B;2021-10-08;85;172;146;112328;108276;4643;61.6;59.4;2.5
2B;2021-10-09;79;116;203;112407;108392;4846;61.7;59.5;2.7
2B;2021-10-10;12;23;7;112419;108415;4853;61.7;59.5;2.7
2B;2021-10-11;61;137;163;112480;108552;5016;61.7;59.6;2.8
2B;2021-10-12;82;161;262;112562;108713;5278;61.8;59.6;2.9
2B;2021-10-13;123;235;282;112685;108948;5560;61.8;59.8;3.1
2B;2021-10-14;97;171;336;112782;109119;5896;61.9;59.9;3.2
2B;2021-10-15;83;125;215;112865;109244;6111;61.9;59.9;3.4
2B;2021-10-16;71;100;183;112936;109344;6294;62.0;60.0;3.5
2B;2021-10-17;15;2;14;112951;109346;6308;62.0;60.0;3.5
2B;2021-10-18;72;95;208;113023;109441;6516;62.0;60.0;3.6
2B;2021-10-19;66;85;268;113089;109526;6784;62.0;60.1;3.7
2B;2021-10-20;83;162;429;113172;109688;7213;62.1;60.2;4.0
2B;2021-10-21;76;113;374;113248;109801;7587;62.1;60.2;4.2
2B;2021-10-22;82;114;269;113330;109915;7856;62.2;60.3;4.3
2B;2021-10-23;53;63;172;113383;109978;8028;62.2;60.3;4.4
2B;2021-10-24;0;14;15;113383;109992;8043;62.2;60.3;4.4
2B;2021-10-25;72;107;253;113455;110099;8296;62.2;60.4;4.6
2B;2021-10-26;37;111;346;113492;110210;8642;62.3;60.5;4.7
2B;2021-10-27;62;126;478;113554;110336;9120;62.3;60.5;5.0
2B;2021-10-28;50;69;259;113604;110405;9379;62.3;60.6;5.1
2B;2021-10-29;56;94;462;113660;110499;9841;62.4;60.6;5.4
2B;2021-10-30;43;78;264;113703;110577;10105;62.4;60.7;5.5
2B;2021-10-31;4;12;23;113707;110589;10128;62.4;60.7;5.6
2B;2021-11-01;9;5;7;113716;110594;10135;62.4;60.7;5.6
2B;2021-11-02;76;109;367;113792;110703;10502;62.4;60.7;5.8
2B;2021-11-03;59;105;509;113851;110808;11011;62.5;60.8;6.0
2B;2021-11-04;57;88;454;113908;110896;11465;62.5;60.8;6.3
2B;2021-11-05;63;84;359;113971;110980;11824;62.5;60.9;6.5
2B;2021-11-06;56;54;302;114027;111034;12126;62.6;60.9;6.7
2B;2021-11-07;4;15;13;114031;111049;12139;62.6;60.9;6.7
2B;2021-11-08;39;78;374;114070;111127;12513;62.6;61.0;6.9
2B;2021-11-09;67;92;517;114137;111219;13030;62.6;61.0;7.1
2B;2021-11-10;68;132;660;114205;111351;13690;62.7;61.1;7.5
2B;2021-11-11;12;10;33;114217;111361;13723;62.7;61.1;7.5
2B;2021-11-12;70;93;724;114287;111454;14447;62.7;61.2;7.9
2B;2021-11-13;22;74;398;114309;111528;14845;62.7;61.2;8.1
2B;2021-11-14;14;10;110;114323;111538;14955;62.7;61.2;8.2
2B;2021-11-15;69;71;524;114392;111609;15479;62.8;61.2;8.5
2B;2021-11-16;55;77;682;114447;111686;16161;62.8;61.3;8.9
2B;2021-11-17;80;95;748;114527;111781;16909;62.8;61.3;9.3
2B;2021-11-18;69;68;890;114596;111849;17799;62.9;61.4;9.8
2B;2021-11-19;96;76;692;114692;111925;18491;62.9;61.4;10.1
2B;2021-11-20;37;58;455;114729;111983;18946;62.9;61.4;10.4
2B;2021-11-21;16;17;171;114745;112000;19117;63.0;61.5;10.5
2B;2021-11-22;88;52;669;114833;112052;19786;63.0;61.5;10.9
2B;2021-11-23;82;65;1009;114915;112117;20795;63.1;61.5;11.4
2B;2021-11-24;91;80;947;115006;112197;21742;63.1;61.6;11.9
2B;2021-11-25;76;67;989;115082;112264;22731;63.1;61.6;12.5
2B;2021-11-26;81;94;1320;115163;112358;24051;63.2;61.6;13.2
2B;2021-11-27;91;69;1087;115254;112427;25138;63.2;61.7;13.8
2B;2021-11-28;15;12;198;115269;112439;25336;63.2;61.7;13.9
2B;2021-11-29;68;51;1375;115337;112490;26711;63.3;61.7;14.7
2B;2021-11-30;114;87;1784;115451;112577;28495;63.3;61.8;15.6
2B;2021-12-01;96;100;1793;115547;112677;30288;63.4;61.8;16.6
2B;2021-12-02;109;54;2227;115656;112731;32515;63.5;61.9;17.8
2B;2021-12-03;107;74;2127;115763;112805;34642;63.5;61.9;19.0
2B;2021-12-04;79;67;1253;115842;112872;35895;63.6;61.9;19.7
2B;2021-12-05;9;22;245;115851;112894;36140;63.6;61.9;19.8
2B;2021-12-06;73;86;1278;115924;112980;37418;63.6;62.0;20.5
2B;2021-12-07;78;78;1756;116002;113058;39174;63.6;62.0;21.5
2B;2021-12-08;84;138;1794;116086;113196;40968;63.7;62.1;22.5
2B;2021-12-09;81;83;1662;116167;113279;42630;63.7;62.2;23.4
2B;2021-12-10;120;104;1808;116287;113383;44438;63.8;62.2;24.4
2B;2021-12-11;71;57;1164;116358;113440;45602;63.8;62.2;25.0
2B;2021-12-12;16;22;340;116374;113462;45942;63.9;62.3;25.2
2B;2021-12-13;82;115;1296;116456;113577;47238;63.9;62.3;25.9
2B;2021-12-14;91;116;1700;116547;113693;48938;63.9;62.4;26.9
2B;2021-12-15;121;144;1705;116668;113837;50643;64.0;62.5;27.8
2B;2021-12-16;97;102;1529;116765;113939;52172;64.1;62.5;28.6
30;2020-12-27;0;0;0;0;0;0;0.0;0.0;0.0
30;2020-12-28;0;0;0;0;0;0;0.0;0.0;0.0
30;2020-12-29;0;0;0;0;0;0;0.0;0.0;0.0
30;2020-12-30;1;0;0;1;0;0;0.0;0.0;0.0
30;2020-12-31;0;0;0;1;0;0;0.0;0.0;0.0
30;2021-01-01;1;0;0;2;0;0;0.0;0.0;0.0
30;2021-01-02;1;0;0;3;0;0;0.0;0.0;0.0
30;2021-01-03;0;0;0;3;0;0;0.0;0.0;0.0
30;2021-01-04;2;0;0;5;0;0;0.0;0.0;0.0
30;2021-01-05;6;0;0;11;0;0;0.0;0.0;0.0
30;2021-01-06;122;1;0;133;1;0;0.0;0.0;0.0
30;2021-01-07;307;0;0;440;1;0;0.1;0.0;0.0
30;2021-01-08;476;1;0;916;2;0;0.1;0.0;0.0
30;2021-01-09;259;0;0;1175;2;0;0.2;0.0;0.0
30;2021-01-10;4;0;0;1179;2;0;0.2;0.0;0.0
30;2021-01-11;512;1;0;1691;3;0;0.2;0.0;0.0
30;2021-01-12;788;3;0;2479;6;0;0.3;0.0;0.0
30;2021-01-13;633;1;0;3112;7;0;0.4;0.0;0.0
30;2021-01-14;714;5;0;3826;12;0;0.5;0.0;0.0
30;2021-01-15;771;4;0;4597;16;0;0.6;0.0;0.0
30;2021-01-16;304;1;0;4901;17;0;0.7;0.0;0.0
30;2021-01-17;2;0;0;4903;17;0;0.7;0.0;0.0
30;2021-01-18;918;7;0;5821;24;0;0.8;0.0;0.0
30;2021-01-19;1735;8;0;7556;32;0;1.0;0.0;0.0
30;2021-01-20;1353;4;0;8909;36;0;1.2;0.0;0.0
30;2021-01-21;1303;5;0;10212;41;0;1.4;0.0;0.0
30;2021-01-22;1116;5;0;11328;46;0;1.5;0.0;0.0
30;2021-01-23;646;1;0;11974;47;0;1.6;0.0;0.0
30;2021-01-24;3;0;0;11977;47;0;1.6;0.0;0.0
30;2021-01-25;840;4;0;12817;51;0;1.7;0.0;0.0
30;2021-01-26;1091;18;0;13908;69;0;1.9;0.0;0.0
30;2021-01-27;1006;97;0;14914;166;0;2.0;0.0;0.0
30;2021-01-28;839;251;0;15753;417;0;2.1;0.1;0.0
30;2021-01-29;777;371;0;16530;788;0;2.2;0.1;0.0
30;2021-01-30;485;266;0;17015;1054;0;2.3;0.1;0.0
30;2021-01-31;3;7;0;17018;1061;0;2.3;0.1;0.0
30;2021-02-01;815;412;0;17833;1473;0;2.4;0.2;0.0
30;2021-02-02;1810;631;0;19643;2104;0;2.6;0.3;0.0
30;2021-02-03;1263;463;0;20906;2567;0;2.8;0.3;0.0
30;2021-02-04;1067;661;0;21973;3228;0;2.9;0.4;0.0
30;2021-02-05;708;731;0;22681;3959;0;3.0;0.5;0.0
30;2021-02-06;317;235;0;22998;4194;0;3.1;0.6;0.0
30;2021-02-07;5;10;0;23003;4204;0;3.1;0.6;0.0
30;2021-02-08;606;718;0;23609;4922;0;3.2;0.7;0.0
30;2021-02-09;982;1035;0;24591;5957;0;3.3;0.8;0.0
30;2021-02-10;995;1067;0;25586;7024;0;3.4;0.9;0.0
30;2021-02-11;995;1012;0;26581;8036;0;3.6;1.1;0.0
30;2021-02-12;725;932;0;27306;8968;0;3.6;1.2;0.0
30;2021-02-13;425;401;0;27731;9369;0;3.7;1.3;0.0
30;2021-02-14;3;22;0;27734;9391;0;3.7;1.3;0.0
30;2021-02-15;460;656;0;28194;10047;0;3.8;1.3;0.0
30;2021-02-16;456;930;0;28650;10977;0;3.8;1.5;0.0
30;2021-02-17;695;637;0;29345;11614;0;3.9;1.6;0.0
30;2021-02-18;807;654;0;30152;12268;0;4.0;1.6;0.0
30;2021-02-19;624;764;0;30776;13032;0;4.1;1.7;0.0
30;2021-02-20;230;234;0;31006;13266;0;4.1;1.8;0.0
30;2021-02-21;4;6;0;31010;13272;0;4.1;1.8;0.0
30;2021-02-22;508;786;0;31518;14058;0;4.2;1.9;0.0
30;2021-02-23;961;1483;0;32479;15541;0;4.3;2.1;0.0
30;2021-02-24;901;1169;0;33380;16710;0;4.5;2.2;0.0
30;2021-02-25;1197;983;0;34577;17693;0;4.6;2.4;0.0
30;2021-02-26;1325;697;0;35902;18390;0;4.8;2.5;0.0
30;2021-02-27;529;511;0;36431;18901;0;4.9;2.5;0.0
30;2021-02-28;7;9;0;36438;18910;0;4.9;2.5;0.0
30;2021-03-01;1203;860;0;37641;19770;0;5.0;2.6;0.0
30;2021-03-02;1553;949;0;39194;20719;0;5.2;2.8;0.0
30;2021-03-03;2040;858;0;41234;21577;0;5.5;2.9;0.0
30;2021-03-04;2402;953;0;43636;22530;0;5.8;3.0;0.0
30;2021-03-05;2528;701;0;46164;23231;0;6.2;3.1;0.0
30;2021-03-06;2694;365;0;48858;23596;0;6.5;3.2;0.0
30;2021-03-07;1698;45;0;50556;23641;0;6.8;3.2;0.0
30;2021-03-08;1474;795;0;52030;24436;0;7.0;3.3;0.0
30;2021-03-09;2162;929;0;54192;25365;0;7.2;3.4;0.0
30;2021-03-10;2317;720;0;56509;26085;0;7.5;3.5;0.0
30;2021-03-11;2921;747;0;59430;26832;0;7.9;3.6;0.0
30;2021-03-12;3026;481;0;62456;27313;0;8.3;3.6;0.0
30;2021-03-13;2138;298;0;64594;27611;0;8.6;3.7;0.0
30;2021-03-14;102;7;0;64696;27618;0;8.6;3.7;0.0
30;2021-03-15;1547;593;0;66243;28211;0;8.9;3.8;0.0
30;2021-03-16;1287;1053;0;67530;29264;0;9.0;3.9;0.0
30;2021-03-17;1394;675;0;68924;29939;0;9.2;4.0;0.0
30;2021-03-18;1626;711;0;70550;30650;0;9.4;4.1;0.0
30;2021-03-19;2249;549;0;72799;31199;0;9.7;4.2;0.0
30;2021-03-20;1321;137;0;74120;31336;0;9.9;4.2;0.0
30;2021-03-21;95;6;0;74215;31342;0;9.9;4.2;0.0
30;2021-03-22;2346;710;0;76561;32052;0;10.2;4.3;0.0
30;2021-03-23;3426;805;0;79987;32857;0;10.7;4.4;0.0
30;2021-03-24;3473;804;0;83460;33661;0;11.2;4.5;0.0
30;2021-03-25;4322;817;0;87782;34478;0;11.7;4.6;0.0
30;2021-03-26;4353;632;0;92135;35110;0;12.3;4.7;0.0
30;2021-03-27;1869;339;0;94004;35449;0;12.6;4.7;0.0
30;2021-03-28;66;5;0;94070;35454;0;12.6;4.7;0.0
30;2021-03-29;2775;1426;0;96845;36880;0;12.9;4.9;0.0
30;2021-03-30;3848;1639;0;100693;38519;0;13.5;5.1;0.0
30;2021-03-31;3435;1439;0;104128;39958;0;13.9;5.3;0.0
30;2021-04-01;4019;1344;0;108147;41302;0;14.4;5.5;0.0
30;2021-04-02;3536;1135;0;111683;42437;0;14.9;5.7;0.0
30;2021-04-03;992;1052;0;112675;43489;0;15.1;5.8;0.0
30;2021-04-04;44;196;0;112719;43685;0;15.1;5.8;0.0
30;2021-04-05;703;266;0;113422;43951;0;15.2;5.9;0.0
30;2021-04-06;2842;1482;0;116264;45433;0;15.5;6.1;0.0
30;2021-04-07;2611;1495;0;118875;46928;0;15.9;6.3;0.0
30;2021-04-08;3827;1451;0;122702;48379;0;16.4;6.5;0.0
30;2021-04-09;4728;1444;0;127430;49823;0;17.0;6.7;0.0
30;2021-04-10;2253;1047;0;129683;50870;0;17.3;6.8;0.0
30;2021-04-11;799;61;0;130482;50931;0;17.4;6.8;0.0
30;2021-04-12;2972;1430;0;133454;52361;0;17.8;7.0;0.0
30;2021-04-13;3815;1827;0;137269;54188;0;18.3;7.2;0.0
30;2021-04-14;3364;1520;0;140633;55708;0;18.8;7.4;0.0
30;2021-04-15;3765;1523;0;144398;57231;0;19.3;7.6;0.0
30;2021-04-16;3618;1539;0;148016;58770;0;19.8;7.9;0.0
30;2021-04-17;1476;865;0;149492;59635;0;20.0;8.0;0.0
30;2021-04-18;788;90;0;150280;59725;0;20.1;8.0;0.0
30;2021-04-19;2424;2244;0;152704;61969;0;20.4;8.3;0.0
30;2021-04-20;2778;2747;0;155482;64716;0;20.8;8.6;0.0
30;2021-04-21;2607;2455;0;158089;67171;0;21.1;9.0;0.0
30;2021-04-22;3562;2353;0;161651;69524;0;21.6;9.3;0.0
30;2021-04-23;3555;2340;0;165206;71864;0;22.1;9.6;0.0
30;2021-04-24;1378;1137;0;166584;73001;0;22.3;9.8;0.0
30;2021-04-25;666;107;0;167250;73108;0;22.3;9.8;0.0
30;2021-04-26;2029;2318;0;169279;75426;0;22.6;10.1;0.0
30;2021-04-27;3006;2607;0;172285;78033;0;23.0;10.4;0.0
30;2021-04-28;2978;2450;0;175263;80483;0;23.4;10.8;0.0
30;2021-04-29;3743;2356;0;179006;82839;0;23.9;11.1;0.0
30;2021-04-30;3561;2081;0;182567;84920;0;24.4;11.3;0.0
30;2021-05-01;1674;550;0;184241;85470;0;24.6;11.4;0.0
30;2021-05-02;641;242;0;184882;85712;0;24.7;11.5;0.0
30;2021-05-03;3832;2403;0;188714;88115;0;25.2;11.8;0.0
30;2021-05-04;4109;3351;0;192823;91466;0;25.8;12.2;0.0
30;2021-05-05;4112;2990;0;196935;94456;0;26.3;12.6;0.0
30;2021-05-06;4352;3220;0;201287;97676;0;26.9;13.1;0.0
30;2021-05-07;4183;3088;0;205470;100764;0;27.5;13.5;0.0
30;2021-05-08;1658;706;0;207128;101470;0;27.7;13.6;0.0
30;2021-05-09;372;522;0;207500;101992;0;27.7;13.6;0.0
30;2021-05-10;3090;2996;0;210590;104988;0;28.1;14.0;0.0
30;2021-05-11;5478;3623;0;216068;108611;0;28.9;14.5;0.0
30;2021-05-12;5317;3081;0;221385;111692;0;29.6;14.9;0.0
30;2021-05-13;3424;983;0;224809;112675;0;30.0;15.1;0.0
30;2021-05-14;5042;2303;0;229851;114978;0;30.7;15.4;0.0
30;2021-05-15;3501;1170;0;233352;116148;0;31.2;15.5;0.0
30;2021-05-16;738;323;0;234090;116471;0;31.3;15.6;0.0
30;2021-05-17;3999;2919;0;238089;119390;0;31.8;16.0;0.0
30;2021-05-18;4872;2920;0;242961;122310;0;32.5;16.3;0.0
30;2021-05-19;5078;2474;0;248039;124784;0;33.1;16.7;0.0
30;2021-05-20;5204;2542;0;253243;127326;0;33.8;17.0;0.0
30;2021-05-21;5078;2456;0;258321;129782;0;34.5;17.3;0.0
30;2021-05-22;3113;1231;0;261434;131013;0;34.9;17.5;0.0
30;2021-05-23;439;303;0;261873;131316;0;35.0;17.5;0.0
30;2021-05-24;1046;749;0;262919;132065;0;35.1;17.6;0.0
30;2021-05-25;3239;3142;0;266158;135207;0;35.6;18.1;0.0
30;2021-05-26;3367;2609;0;269525;137816;0;36.0;18.4;0.0
30;2021-05-27;4246;2733;0;273771;140549;0;36.6;18.8;0.0
30;2021-05-28;3682;3322;0;277453;143871;0;37.1;19.2;0.0
30;2021-05-29;1832;1836;0;279285;145707;0;37.3;19.5;0.0
30;2021-05-30;379;541;0;279664;146248;0;37.4;19.5;0.0
30;2021-05-31;3054;2460;0;282718;148708;0;37.8;19.9;0.0
30;2021-06-01;4098;2966;0;286816;151674;0;38.3;20.3;0.0
30;2021-06-02;3702;2714;0;290518;154388;0;38.8;20.6;0.0
30;2021-06-03;4531;3417;0;295049;157805;0;39.4;21.1;0.0
30;2021-06-04;4147;3505;0;299196;161310;0;40.0;21.6;0.0
30;2021-06-05;2039;1432;0;301235;162742;0;40.2;21.7;0.0
30;2021-06-06;770;282;0;302005;163024;0;40.3;21.8;0.0
30;2021-06-07;4701;2731;0;306706;165755;0;41.0;22.1;0.0
30;2021-06-08;4779;3502;0;311485;169257;0;41.6;22.6;0.0
30;2021-06-09;4214;3200;0;315699;172457;0;42.2;23.0;0.0
30;2021-06-10;4649;3448;0;320348;175905;0;42.8;23.5;0.0
30;2021-06-11;4629;4037;0;324977;179942;0;43.4;24.0;0.0
30;2021-06-12;2540;1745;0;327517;181687;0;43.8;24.3;0.0
30;2021-06-13;581;375;0;328098;182062;0;43.8;24.3;0.0
30;2021-06-14;2475;4791;0;330573;186853;0;44.2;25.0;0.0
30;2021-06-15;3273;5444;0;333846;192297;0;44.6;25.7;0.0
30;2021-06-16;3145;4796;0;336991;197093;0;45.0;26.3;0.0
30;2021-06-17;3843;4404;0;340834;201497;0;45.5;26.9;0.0
30;2021-06-18;3708;4834;0;344542;206331;0;46.0;27.6;0.0
30;2021-06-19;1429;2058;0;345971;208389;0;46.2;27.8;0.0
30;2021-06-20;409;554;0;346380;208943;0;46.3;27.9;0.0
30;2021-06-21;2237;5007;0;348617;213950;0;46.6;28.6;0.0
30;2021-06-22;2311;5920;0;350928;219870;0;46.9;29.4;0.0
30;2021-06-23;2487;5471;0;353415;225341;0;47.2;30.1;0.0
30;2021-06-24;2295;4923;0;355710;230264;0;47.5;30.8;0.0
30;2021-06-25;2540;5810;0;358250;236074;0;47.9;31.5;0.0
30;2021-06-26;904;2938;0;359154;239012;0;48.0;31.9;0.0
30;2021-06-27;241;629;0;359395;239641;0;48.0;32.0;0.0
30;2021-06-28;1594;6208;0;360989;245849;0;48.2;32.8;0.0
30;2021-06-29;1836;6211;0;362825;252060;0;48.5;33.7;0.0
30;2021-06-30;2002;5591;0;364827;257651;0;48.7;34.4;0.0
30;2021-07-01;3020;4918;0;367847;262569;0;49.1;35.1;0.0
30;2021-07-02;2853;4773;0;370700;267342;0;49.5;35.7;0.0
30;2021-07-03;1140;3123;0;371840;270465;0;49.7;36.1;0.0
30;2021-07-04;154;512;0;371994;270977;0;49.7;36.2;0.0
30;2021-07-05;1958;4155;0;373952;275132;0;50.0;36.8;0.0
30;2021-07-06;2533;5339;0;376485;280471;0;50.3;37.5;0.0
30;2021-07-07;2397;4414;0;378882;284885;0;50.6;38.1;0.0
30;2021-07-08;1995;3732;0;380877;288617;0;50.9;38.6;0.0
30;2021-07-09;2285;5440;0;383162;294057;0;51.2;39.3;0.0
30;2021-07-10;1349;2147;0;384511;296204;0;51.4;39.6;0.0
30;2021-07-11;101;502;0;384612;296706;0;51.4;39.6;0.0
30;2021-07-12;2271;5183;0;386883;301889;0;51.7;40.3;0.0
30;2021-07-13;3068;6140;0;389951;308029;0;52.1;41.2;0.0
30;2021-07-14;618;672;0;390569;308701;0;52.2;41.2;0.0
30;2021-07-15;3801;5655;0;394370;314356;0;52.7;42.0;0.0
30;2021-07-16;4355;5749;0;398725;320105;0;53.3;42.8;0.0
30;2021-07-17;1680;2492;0;400405;322597;0;53.5;43.1;0.0
30;2021-07-18;235;651;0;400640;323248;0;53.5;43.2;0.0
30;2021-07-19;3201;6098;0;403841;329346;0;54.0;44.0;0.0
30;2021-07-20;4280;6303;0;408121;335649;0;54.5;44.8;0.0
30;2021-07-21;3871;5343;0;411992;340992;0;55.0;45.6;0.0
30;2021-07-22;4598;5579;0;416590;346571;0;55.7;46.3;0.0
30;2021-07-23;4795;5849;0;421385;352420;0;56.3;47.1;0.0
30;2021-07-24;2135;3196;0;423520;355616;0;56.6;47.5;0.0
30;2021-07-25;331;384;0;423851;356000;0;56.6;47.6;0.0
30;2021-07-26;4143;4003;0;427994;360003;0;57.2;48.1;0.0
30;2021-07-27;4722;4518;0;432716;364521;0;57.8;48.7;0.0
30;2021-07-28;4749;3839;0;437465;368360;0;58.4;49.2;0.0
30;2021-07-29;5867;3923;0;443332;372283;0;59.2;49.7;0.0
30;2021-07-30;5331;4164;0;448663;376447;0;59.9;50.3;0.0
30;2021-07-31;2536;1827;0;451199;378274;0;60.3;50.5;0.0
30;2021-08-01;758;319;0;451957;378593;0;60.4;50.6;0.0
30;2021-08-02;3764;3741;0;455721;382334;0;60.9;51.1;0.0
30;2021-08-03;4780;3556;0;460501;385890;0;61.5;51.6;0.0
30;2021-08-04;5207;2815;0;465708;388705;0;62.2;51.9;0.0
30;2021-08-05;4531;3436;0;470239;392141;0;62.8;52.4;0.0
30;2021-08-06;4132;3645;0;474371;395786;0;63.4;52.9;0.0
30;2021-08-07;1798;1857;0;476169;397643;0;63.6;53.1;0.0
30;2021-08-08;568;297;0;476737;397940;0;63.7;53.2;0.0
30;2021-08-09;3298;3439;0;480035;401379;0;64.1;53.6;0.0
30;2021-08-10;3903;3926;0;483938;405305;0;64.7;54.2;0.0
30;2021-08-11;3296;3266;0;487234;408571;0;65.1;54.6;0.0
30;2021-08-12;3566;3741;0;490800;412312;0;65.6;55.1;0.0
30;2021-08-13;3070;3062;0;493870;415374;0;66.0;55.5;0.0
30;2021-08-14;1029;1872;0;494899;417246;0;66.1;55.7;0.0
30;2021-08-15;251;159;0;495150;417405;0;66.2;55.8;0.0
30;2021-08-16;2082;4466;0;497232;421871;0;66.4;56.4;0.0
30;2021-08-17;2566;3913;0;499798;425784;0;66.8;56.9;0.0
30;2021-08-18;2620;3664;0;502418;429448;0;67.1;57.4;0.0
30;2021-08-19;2635;4064;0;505053;433512;0;67.5;57.9;0.0
30;2021-08-20;2407;4333;0;507460;437845;0;67.8;58.5;0.0
30;2021-08-21;919;2656;0;508379;440501;0;67.9;58.9;0.0
30;2021-08-22;204;515;0;508583;441016;0;67.9;58.9;0.0
30;2021-08-23;1574;4220;0;510157;445236;0;68.2;59.5;0.0
30;2021-08-24;1866;4406;0;512023;449642;0;68.4;60.1;0.0
30;2021-08-25;1616;4363;0;513639;454005;0;68.6;60.7;0.0
30;2021-08-26;1790;4268;0;515429;458273;0;68.9;61.2;0.0
30;2021-08-27;1657;4327;0;517086;462600;0;69.1;61.8;0.0
30;2021-08-28;668;2343;0;517754;464943;0;69.2;62.1;0.0
30;2021-08-29;182;607;0;517936;465550;0;69.2;62.2;0.0
30;2021-08-30;1343;4225;57;519279;469775;57;69.4;62.8;0.0
30;2021-08-31;1329;4120;121;520608;473895;178;69.6;63.3;0.0
30;2021-09-01;1344;3482;177;521952;477377;355;69.7;63.8;0.0
30;2021-09-02;1334;3241;276;523286;480618;631;69.9;64.2;0.1
30;2021-09-03;1467;3546;421;524753;484164;1052;70.1;64.7;0.1
30;2021-09-04;657;1803;154;525410;485967;1206;70.2;64.9;0.2
30;2021-09-05;131;469;40;525541;486436;1246;70.2;65.0;0.2
30;2021-09-06;830;2292;456;526371;488728;1702;70.3;65.3;0.2
30;2021-09-07;813;2163;532;527184;490891;2234;70.4;65.6;0.3
30;2021-09-08;939;2551;317;528123;493442;2551;70.6;65.9;0.3
30;2021-09-09;918;2132;371;529041;495574;2922;70.7;66.2;0.4
30;2021-09-10;987;2536;475;530028;498110;3397;70.8;66.6;0.5
30;2021-09-11;537;1499;136;530565;499609;3533;70.9;66.8;0.5
30;2021-09-12;94;240;35;530659;499849;3568;70.9;66.8;0.5
30;2021-09-13;781;1570;458;531440;501419;4026;71.0;67.0;0.5
30;2021-09-14;685;1513;605;532125;502932;4631;71.1;67.2;0.6
30;2021-09-15;823;1863;494;532948;504795;5125;71.2;67.4;0.7
30;2021-09-16;762;1437;750;533710;506232;5875;71.3;67.6;0.8
30;2021-09-17;809;1861;764;534519;508093;6639;71.4;67.9;0.9
30;2021-09-18;412;1010;155;534931;509103;6794;71.5;68.0;0.9
30;2021-09-19;66;156;27;534997;509259;6821;71.5;68.0;0.9
30;2021-09-20;432;1172;588;535429;510431;7409;71.5;68.2;1.0
30;2021-09-21;452;1161;906;535881;511592;8315;71.6;68.4;1.1
30;2021-09-22;504;1413;536;536385;513005;8851;71.7;68.5;1.2
30;2021-09-23;644;1129;806;537029;514134;9657;71.8;68.7;1.3
30;2021-09-24;548;1565;613;537577;515699;10270;71.8;68.9;1.4
30;2021-09-25;339;870;119;537916;516569;10389;71.9;69.0;1.4
30;2021-09-26;54;135;24;537970;516704;10413;71.9;69.0;1.4
30;2021-09-27;398;890;617;538368;517594;11030;71.9;69.2;1.5
30;2021-09-28;533;936;830;538901;518530;11860;72.0;69.3;1.6
30;2021-09-29;467;1110;497;539368;519640;12357;72.1;69.4;1.7
30;2021-09-30;411;917;676;539779;520557;13033;72.1;69.5;1.7
30;2021-10-01;682;1002;836;540461;521559;13869;72.2;69.7;1.9
30;2021-10-02;301;543;228;540762;522102;14097;72.2;69.8;1.9
30;2021-10-03;21;52;4;540783;522154;14101;72.3;69.8;1.9
30;2021-10-04;435;796;845;541218;522950;14946;72.3;69.9;2.0
30;2021-10-05;372;723;907;541590;523673;15853;72.4;70.0;2.1
30;2021-10-06;492;868;940;542082;524541;16793;72.4;70.1;2.2
30;2021-10-07;401;853;847;542483;525394;17640;72.5;70.2;2.4
30;2021-10-08;497;1071;974;542980;526465;18614;72.5;70.3;2.5
30;2021-10-09;314;549;309;543294;527014;18923;72.6;70.4;2.5
30;2021-10-10;11;28;12;543305;527042;18935;72.6;70.4;2.5
30;2021-10-11;288;561;797;543593;527603;19732;72.6;70.5;2.6
30;2021-10-12;387;690;1058;543980;528293;20790;72.7;70.6;2.8
30;2021-10-13;354;680;782;544334;528973;21572;72.7;70.7;2.9
30;2021-10-14;383;677;1090;544717;529650;22662;72.8;70.8;3.0
30;2021-10-15;458;704;1042;545175;530354;23704;72.8;70.9;3.2
30;2021-10-16;216;418;284;545391;530772;23988;72.9;70.9;3.2
30;2021-10-17;12;31;6;545403;530803;23994;72.9;70.9;3.2
30;2021-10-18;305;497;828;545708;531300;24822;72.9;71.0;3.3
30;2021-10-19;307;555;1363;546015;531855;26185;73.0;71.1;3.5
30;2021-10-20;313;447;1079;546328;532302;27264;73.0;71.1;3.6
30;2021-10-21;340;533;1666;546668;532835;28930;73.0;71.2;3.9
30;2021-10-22;369;634;1222;547037;533469;30152;73.1;71.3;4.0
30;2021-10-23;159;296;674;547196;533765;30826;73.1;71.3;4.1
30;2021-10-24;10;21;3;547206;533786;30829;73.1;71.3;4.1
30;2021-10-25;289;405;920;547495;534191;31749;73.1;71.4;4.2
30;2021-10-26;288;354;1299;547783;534545;33048;73.2;71.4;4.4
30;2021-10-27;338;426;1118;548121;534971;34166;73.2;71.5;4.6
30;2021-10-28;309;328;1371;548430;535299;35537;73.3;71.5;4.7
30;2021-10-29;377;481;1462;548807;535780;36999;73.3;71.6;4.9
30;2021-10-30;144;286;511;548951;536066;37510;73.3;71.6;5.0
30;2021-10-31;7;17;6;548958;536083;37516;73.3;71.6;5.0
30;2021-11-01;46;38;21;549004;536121;37537;73.4;71.6;5.0
30;2021-11-02;229;403;1019;549233;536524;38556;73.4;71.7;5.2
30;2021-11-03;365;447;1755;549598;536971;40311;73.4;71.7;5.4
30;2021-11-04;248;342;1514;549846;537313;41825;73.5;71.8;5.6
30;2021-11-05;357;524;1964;550203;537837;43789;73.5;71.9;5.9
30;2021-11-06;169;237;435;550372;538074;44224;73.5;71.9;5.9
30;2021-11-07;16;37;30;550388;538111;44254;73.5;71.9;5.9
30;2021-11-08;176;310;1569;550564;538421;45823;73.6;71.9;6.1
30;2021-11-09;248;394;2210;550812;538815;48033;73.6;72.0;6.4
30;2021-11-10;324;424;2433;551136;539239;50466;73.6;72.0;6.7
30;2021-11-11;30;51;119;551166;539290;50585;73.6;72.1;6.8
30;2021-11-12;267;358;2085;551433;539648;52670;73.7;72.1;7.0
30;2021-11-13;123;199;658;551556;539847;53328;73.7;72.1;7.1
30;2021-11-14;14;28;31;551570;539875;53359;73.7;72.1;7.1
30;2021-11-15;186;332;1992;551756;540207;55351;73.7;72.2;7.4
30;2021-11-16;227;287;2774;551983;540494;58125;73.7;72.2;7.8
30;2021-11-17;300;400;2984;552283;540894;61109;73.8;72.3;8.2
30;2021-11-18;237;368;2667;552520;541262;63776;73.8;72.3;8.5
30;2021-11-19;422;458;3421;552942;541720;67197;73.9;72.4;9.0
30;2021-11-20;136;236;730;553078;541956;67927;73.9;72.4;9.1
30;2021-11-21;6;17;29;553084;541973;67956;73.9;72.4;9.1
30;2021-11-22;224;274;2456;553308;542247;70412;73.9;72.4;9.4
30;2021-11-23;289;245;3010;553597;542492;73422;74.0;72.5;9.8
30;2021-11-24;306;404;3037;553903;542896;76459;74.0;72.5;10.2
30;2021-11-25;327;344;3524;554230;543240;79983;74.0;72.6;10.7
30;2021-11-26;453;480;5434;554683;543720;85417;74.1;72.6;11.4
30;2021-11-27;168;238;1705;554851;543958;87122;74.1;72.7;11.6
30;2021-11-28;29;48;323;554880;544006;87445;74.1;72.7;11.7
30;2021-11-29;199;247;4040;555079;544253;91485;74.2;72.7;12.2
30;2021-11-30;277;327;5723;555356;544580;97208;74.2;72.8;13.0
30;2021-12-01;267;384;5433;555623;544964;102641;74.2;72.8;13.7
30;2021-12-02;265;245;5854;555888;545209;108495;74.3;72.8;14.5
30;2021-12-03;292;350;7306;556180;545559;115801;74.3;72.9;15.5
30;2021-12-04;147;186;2527;556327;545745;118328;74.3;72.9;15.8
30;2021-12-05;29;62;422;556356;545807;118750;74.3;72.9;15.9
30;2021-12-06;218;334;6417;556574;546141;125167;74.4;73.0;16.7
30;2021-12-07;343;353;9222;556917;546494;134389;74.4;73.0;18.0
30;2021-12-08;278;356;8164;557195;546850;142553;74.4;73.1;19.0
30;2021-12-09;328;290;8747;557523;547140;151300;74.5;73.1;20.2
30;2021-12-10;361;397;9634;557884;547537;160934;74.5;73.2;21.5
30;2021-12-11;188;200;3968;558072;547737;164902;74.6;73.2;22.0
30;2021-12-12;16;53;460;558088;547790;165362;74.6;73.2;22.1
30;2021-12-13;257;304;7573;558345;548094;172935;74.6;73.2;23.1
30;2021-12-14;353;372;10821;558698;548466;183756;74.6;73.3;24.6
30;2021-12-15;314;381;8697;559012;548847;192453;74.7;73.3;25.7
30;2021-12-16;353;398;8883;559365;549245;201336;74.7;73.4;26.9
31;2020-12-27;1;0;0;1;0;0;0.0;0.0;0.0
31;2020-12-28;1;0;0;2;0;0;0.0;0.0;0.0
31;2020-12-29;0;0;0;2;0;0;0.0;0.0;0.0
31;2020-12-30;0;0;0;2;0;0;0.0;0.0;0.0
31;2020-12-31;1;0;0;3;0;0;0.0;0.0;0.0
31;2021-01-01;4;0;0;7;0;0;0.0;0.0;0.0
31;2021-01-02;0;0;0;7;0;0;0.0;0.0;0.0
31;2021-01-03;2;0;0;9;0;0;0.0;0.0;0.0
31;2021-01-04;3;1;0;12;1;0;0.0;0.0;0.0
31;2021-01-05;55;0;0;67;1;0;0.0;0.0;0.0
31;2021-01-06;203;1;0;270;2;0;0.0;0.0;0.0
31;2021-01-07;321;1;0;591;3;0;0.0;0.0;0.0
31;2021-01-08;556;0;0;1147;3;0;0.1;0.0;0.0
31;2021-01-09;288;0;0;1435;3;0;0.1;0.0;0.0
31;2021-01-10;278;0;0;1713;3;0;0.1;0.0;0.0
31;2021-01-11;972;4;0;2685;7;0;0.2;0.0;0.0
31;2021-01-12;1157;1;0;3842;8;0;0.3;0.0;0.0
31;2021-01-13;1141;5;0;4983;13;0;0.4;0.0;0.0
31;2021-01-14;1249;19;0;6232;32;0;0.4;0.0;0.0
31;2021-01-15;1061;5;0;7293;37;0;0.5;0.0;0.0
31;2021-01-16;273;2;0;7566;39;0;0.5;0.0;0.0
31;2021-01-17;200;0;0;7766;39;0;0.6;0.0;0.0
31;2021-01-18;1693;7;0;9459;46;0;0.7;0.0;0.0
31;2021-01-19;2916;12;0;12375;58;0;0.9;0.0;0.0
31;2021-01-20;3595;12;0;15970;70;0;1.1;0.0;0.0
31;2021-01-21;3031;9;0;19001;79;0;1.4;0.0;0.0
31;2021-01-22;2303;5;0;21304;84;0;1.5;0.0;0.0
31;2021-01-23;723;2;0;22027;86;0;1.6;0.0;0.0
31;2021-01-24;223;1;0;22250;87;0;1.6;0.0;0.0
31;2021-01-25;1762;13;0;24012;100;0;1.7;0.0;0.0
31;2021-01-26;1995;59;0;26007;159;0;1.9;0.0;0.0
31;2021-01-27;1699;153;0;27706;312;0;2.0;0.0;0.0
31;2021-01-28;1511;288;0;29217;600;0;2.1;0.0;0.0
31;2021-01-29;1399;373;0;30616;973;0;2.2;0.1;0.0
31;2021-01-30;457;180;0;31073;1153;0;2.2;0.1;0.0
31;2021-01-31;77;200;0;31150;1353;0;2.2;0.1;0.0
31;2021-02-01;1249;740;0;32399;2093;0;2.3;0.1;0.0
31;2021-02-02;2997;800;0;35396;2893;0;2.5;0.2;0.0
31;2021-02-03;1875;718;0;37271;3611;0;2.7;0.3;0.0
31;2021-02-04;1882;931;0;39153;4542;0;2.8;0.3;0.0
31;2021-02-05;1393;636;0;40546;5178;0;2.9;0.4;0.0
31;2021-02-06;437;71;0;40983;5249;0;2.9;0.4;0.0
31;2021-02-07;56;59;0;41039;5308;0;2.9;0.4;0.0
31;2021-02-08;1105;680;0;42144;5988;0;3.0;0.4;0.0
31;2021-02-09;1641;1547;0;43785;7535;0;3.1;0.5;0.0
31;2021-02-10;1915;2391;0;45700;9926;0;3.3;0.7;0.0
31;2021-02-11;1795;1792;0;47495;11718;0;3.4;0.8;0.0
31;2021-02-12;1635;863;0;49130;12581;0;3.5;0.9;0.0
31;2021-02-13;513;247;0;49643;12828;0;3.5;0.9;0.0
31;2021-02-14;58;218;0;49701;13046;0;3.5;0.9;0.0
31;2021-02-15;435;1409;0;50136;14455;0;3.6;1.0;0.0
31;2021-02-16;502;1619;0;50638;16074;0;3.6;1.1;0.0
31;2021-02-17;470;1681;0;51108;17755;0;3.6;1.3;0.0
31;2021-02-18;525;1835;0;51633;19590;0;3.7;1.4;0.0
31;2021-02-19;463;1611;0;52096;21201;0;3.7;1.5;0.0
31;2021-02-20;96;537;0;52192;21738;0;3.7;1.6;0.0
31;2021-02-21;73;168;0;52265;21906;0;3.7;1.6;0.0
31;2021-02-22;441;1796;0;52706;23702;0;3.8;1.7;0.0
31;2021-02-23;877;2886;0;53583;26588;0;3.8;1.9;0.0
31;2021-02-24;626;2071;0;54209;28659;0;3.9;2.0;0.0
31;2021-02-25;1436;1888;0;55645;30547;0;4.0;2.2;0.0
31;2021-02-26;1721;1308;0;57366;31855;0;4.1;2.3;0.0
31;2021-02-27;654;416;0;58020;32271;0;4.1;2.3;0.0
31;2021-02-28;92;59;0;58112;32330;0;4.1;2.3;0.0
31;2021-03-01;894;1141;0;59006;33471;0;4.2;2.4;0.0
31;2021-03-02;1282;1657;0;60288;35128;0;4.3;2.5;0.0
31;2021-03-03;1382;1764;0;61670;36892;0;4.4;2.6;0.0
31;2021-03-04;2447;1477;0;64117;38369;0;4.6;2.7;0.0
31;2021-03-05;3056;1576;0;67173;39945;0;4.8;2.9;0.0
31;2021-03-06;2874;421;0;70047;40366;0;5.0;2.9;0.0
31;2021-03-07;5209;114;0;75256;40480;0;5.4;2.9;0.0
31;2021-03-08;1670;1087;0;76926;41567;0;5.5;3.0;0.0
31;2021-03-09;2777;1207;0;79703;42774;0;5.7;3.1;0.0
31;2021-03-10;2592;1082;0;82295;43856;0;5.9;3.1;0.0
31;2021-03-11;4414;1185;0;86709;45041;0;6.2;3.2;0.0
31;2021-03-12;5309;1216;0;92018;46257;0;6.6;3.3;0.0
31;2021-03-13;2859;524;0;94877;46781;0;6.8;3.3;0.0
31;2021-03-14;261;53;0;95138;46834;0;6.8;3.3;0.0
31;2021-03-15;2587;432;0;97725;47266;0;7.0;3.4;0.0
31;2021-03-16;1775;807;0;99500;48073;0;7.1;3.4;0.0
31;2021-03-17;1743;568;0;101243;48641;0;7.2;3.5;0.0
31;2021-03-18;2073;744;0;103316;49385;0;7.4;3.5;0.0
31;2021-03-19;3272;562;0;106588;49947;0;7.6;3.6;0.0
31;2021-03-20;1870;160;0;108458;50107;0;7.7;3.6;0.0
31;2021-03-21;268;33;0;108726;50140;0;7.8;3.6;0.0
31;2021-03-22;2686;397;0;111412;50537;0;8.0;3.6;0.0
31;2021-03-23;4138;363;0;115550;50900;0;8.2;3.6;0.0
31;2021-03-24;4389;307;0;119939;51207;0;8.6;3.7;0.0
31;2021-03-25;6070;542;0;126009;51749;0;9.0;3.7;0.0
31;2021-03-26;5599;554;0;131608;52303;0;9.4;3.7;0.0
31;2021-03-27;4477;220;0;136085;52523;0;9.7;3.7;0.0
31;2021-03-28;2259;50;0;138344;52573;0;9.9;3.8;0.0
31;2021-03-29;4415;493;0;142759;53066;0;10.2;3.8;0.0
31;2021-03-30;6561;580;0;149320;53646;0;10.7;3.8;0.0
31;2021-03-31;5819;434;0;155139;54080;0;11.1;3.9;0.0
31;2021-04-01;7098;625;0;162237;54705;0;11.6;3.9;0.0
31;2021-04-02;6247;645;0;168484;55350;0;12.0;4.0;0.0
31;2021-04-03;4111;214;0;172595;55564;0;12.3;4.0;0.0
31;2021-04-04;2048;116;0;174643;55680;0;12.5;4.0;0.0
31;2021-04-05;612;80;0;175255;55760;0;12.5;4.0;0.0
31;2021-04-06;4352;1201;0;179607;56961;0;12.8;4.1;0.0
31;2021-04-07;6401;1069;0;186008;58030;0;13.3;4.1;0.0
31;2021-04-08;7726;1118;0;193734;59148;0;13.8;4.2;0.0
31;2021-04-09;8491;1339;0;202225;60487;0;14.4;4.3;0.0
31;2021-04-10;5185;611;0;207410;61098;0;14.8;4.4;0.0
31;2021-04-11;2111;148;0;209521;61246;0;15.0;4.4;0.0
31;2021-04-12;6061;1867;0;215582;63113;0;15.4;4.5;0.0
31;2021-04-13;8024;2113;0;223606;65226;0;16.0;4.7;0.0
31;2021-04-14;6746;2046;0;230352;67272;0;16.4;4.8;0.0
31;2021-04-15;7841;2290;0;238193;69562;0;17.0;5.0;0.0
31;2021-04-16;7329;2161;0;245522;71723;0;17.5;5.1;0.0
31;2021-04-17;4603;1003;0;250125;72726;0;17.9;5.2;0.0
31;2021-04-18;2484;398;0;252609;73124;0;18.0;5.2;0.0
31;2021-04-19;5305;2187;0;257914;75311;0;18.4;5.4;0.0
31;2021-04-20;6118;2933;0;264032;78244;0;18.8;5.6;0.0
31;2021-04-21;6052;2915;0;270084;81159;0;19.3;5.8;0.0
31;2021-04-22;6469;3274;0;276553;84433;0;19.7;6.0;0.0
31;2021-04-23;6350;2766;0;282903;87199;0;20.2;6.2;0.0
31;2021-04-24;2029;3355;0;284932;90554;0;20.3;6.5;0.0
31;2021-04-25;807;2092;0;285739;92646;0;20.4;6.6;0.0
31;2021-04-26;3957;3630;0;289696;96276;0;20.7;6.9;0.0
31;2021-04-27;4728;4069;0;294424;100345;0;21.0;7.2;0.0
31;2021-04-28;4724;3791;0;299148;104136;0;21.4;7.4;0.0
31;2021-04-29;5458;4221;0;304606;108357;0;21.7;7.7;0.0
31;2021-04-30;5259;4390;0;309865;112747;0;22.1;8.0;0.0
31;2021-05-01;1951;3206;0;311816;115953;0;22.3;8.3;0.0
31;2021-05-02;1482;1984;0;313298;117937;0;22.4;8.4;0.0
31;2021-05-03;5666;2827;0;318964;120764;0;22.8;8.6;0.0
31;2021-05-04;5036;5040;0;324000;125804;0;23.1;9.0;0.0
31;2021-05-05;3561;6017;0;327561;131821;0;23.4;9.4;0.0
31;2021-05-06;4044;7445;0;331605;139266;0;23.7;9.9;0.0
31;2021-05-07;5870;7241;0;337475;146507;0;24.1;10.5;0.0
31;2021-05-08;4031;3114;0;341506;149621;0;24.4;10.7;0.0
31;2021-05-09;3844;2357;0;345350;151978;0;24.7;10.8;0.0
31;2021-05-10;6446;5747;0;351796;157725;0;25.1;11.3;0.0
31;2021-05-11;6990;6849;0;358786;164574;0;25.6;11.7;0.0
31;2021-05-12;7534;6155;0;366320;170729;0;26.1;12.2;0.0
31;2021-05-13;5693;2166;0;372013;172895;0;26.6;12.3;0.0
31;2021-05-14;8604;4248;0;380617;177143;0;27.2;12.6;0.0
31;2021-05-15;6552;2111;0;387169;179254;0;27.6;12.8;0.0
31;2021-05-16;3843;657;0;391012;179911;0;27.9;12.8;0.0
31;2021-05-17;5990;4259;0;397002;184170;0;28.3;13.1;0.0
31;2021-05-18;6741;4320;0;403743;188490;0;28.8;13.5;0.0
31;2021-05-19;7323;3834;0;411066;192324;0;29.3;13.7;0.0
31;2021-05-20;8271;4888;0;419337;197212;0;29.9;14.1;0.0
31;2021-05-21;8332;4961;0;427669;202173;0;30.5;14.4;0.0
31;2021-05-22;6158;1879;0;433827;204052;0;31.0;14.6;0.0
31;2021-05-23;4410;372;0;438237;204424;0;31.3;14.6;0.0
31;2021-05-24;4774;806;0;443011;205230;0;31.6;14.6;0.0
31;2021-05-25;7376;3871;0;450387;209101;0;32.1;14.9;0.0
31;2021-05-26;7485;4769;0;457872;213870;0;32.7;15.3;0.0
31;2021-05-27;7076;6230;0;464948;220100;0;33.2;15.7;0.0
31;2021-05-28;6559;6506;0;471507;226606;0;33.7;16.2;0.0
31;2021-05-29;4077;4258;0;475584;230864;0;33.9;16.5;0.0
31;2021-05-30;1385;2342;0;476969;233206;0;34.0;16.6;0.0
31;2021-05-31;5940;5248;0;482909;238454;0;34.5;17.0;0.0
31;2021-06-01;7132;6715;0;490041;245169;0;35.0;17.5;0.0
31;2021-06-02;7303;6496;0;497344;251665;0;35.5;18.0;0.0
31;2021-06-03;8248;8243;0;505592;259908;0;36.1;18.6;0.0
31;2021-06-04;9239;7435;0;514831;267343;0;36.7;19.1;0.0
31;2021-06-05;10592;3240;0;525423;270583;0;37.5;19.3;0.0
31;2021-06-06;7907;1565;0;533330;272148;0;38.1;19.4;0.0
31;2021-06-07;8501;5729;0;541831;277877;0;38.7;19.8;0.0
31;2021-06-08;9506;6365;0;551337;284242;0;39.4;20.3;0.0
31;2021-06-09;9888;5812;0;561225;290054;0;40.1;20.7;0.0
31;2021-06-10;10050;6536;0;571275;296590;0;40.8;21.2;0.0
31;2021-06-11;10744;7020;0;582019;303610;0;41.5;21.7;0.0
31;2021-06-12;9662;3770;0;591681;307380;0;42.2;21.9;0.0
31;2021-06-13;7937;1986;0;599618;309366;0;42.8;22.1;0.0
31;2021-06-14;8379;7026;0;607997;316392;0;43.4;22.6;0.0
31;2021-06-15;9866;7735;0;617863;324127;0;44.1;23.1;0.0
31;2021-06-16;8902;5960;0;626765;330087;0;44.7;23.6;0.0
31;2021-06-17;8405;6956;0;635170;337043;0;45.3;24.1;0.0
31;2021-06-18;8810;8544;0;643980;345587;0;46.0;24.7;0.0
31;2021-06-19;7918;6306;0;651898;351893;0;46.5;25.1;0.0
31;2021-06-20;5275;3841;0;657173;355734;0;46.9;25.4;0.0
31;2021-06-21;5349;7882;0;662522;363616;0;47.3;26.0;0.0
31;2021-06-22;5041;8814;0;667563;372430;0;47.7;26.6;0.0
31;2021-06-23;5177;8430;0;672740;380860;0;48.0;27.2;0.0
31;2021-06-24;4525;8847;0;677265;389707;0;48.3;27.8;0.0
31;2021-06-25;5058;10974;0;682323;400681;0;48.7;28.6;0.0
31;2021-06-26;4424;7749;0;686747;408430;0;49.0;29.2;0.0
31;2021-06-27;3329;4572;0;690076;413002;0;49.3;29.5;0.0
31;2021-06-28;3996;7695;0;694072;420697;0;49.5;30.0;0.0
31;2021-06-29;3855;8660;0;697927;429357;0;49.8;30.6;0.0
31;2021-06-30;4343;9361;0;702270;438718;0;50.1;31.3;0.0
31;2021-07-01;4163;9628;0;706433;448346;0;50.4;32.0;0.0
31;2021-07-02;4248;10893;0;710681;459239;0;50.7;32.8;0.0
31;2021-07-03;3995;8187;0;714676;467426;0;51.0;33.4;0.0
31;2021-07-04;2953;5044;0;717629;472470;0;51.2;33.7;0.0
31;2021-07-05;3922;7928;0;721551;480398;0;51.5;34.3;0.0
31;2021-07-06;3827;9426;5;725378;489824;5;51.8;35.0;0.0
31;2021-07-07;4024;9459;0;729402;499283;5;52.1;35.6;0.0
31;2021-07-08;3958;9407;2;733360;508690;7;52.3;36.3;0.0
31;2021-07-09;4512;10504;0;737872;519194;7;52.7;37.1;0.0
31;2021-07-10;3862;7068;0;741734;526262;7;52.9;37.6;0.0
31;2021-07-11;2854;4310;0;744588;530572;7;53.1;37.9;0.0
31;2021-07-12;3755;9854;0;748343;540426;7;53.4;38.6;0.0
31;2021-07-13;6762;10559;0;755105;550985;7;53.9;39.3;0.0
31;2021-07-14;5771;4188;0;760876;555173;7;54.3;39.6;0.0
31;2021-07-15;8265;10132;0;769141;565305;7;54.9;40.4;0.0
31;2021-07-16;7823;11104;0;776964;576409;7;55.5;41.1;0.0
31;2021-07-17;7856;11427;0;784820;587836;7;56.0;42.0;0.0
31;2021-07-18;5763;8916;0;790583;596752;7;56.4;42.6;0.0
31;2021-07-19;5123;11325;0;795706;608077;7;56.8;43.4;0.0
31;2021-07-20;7198;11759;0;802904;619836;7;57.3;44.2;0.0
31;2021-07-21;7215;11897;0;810119;631733;7;57.8;45.1;0.0
31;2021-07-22;7814;11591;0;817933;643324;7;58.4;45.9;0.0
31;2021-07-23;7233;12332;0;825166;655656;7;58.9;46.8;0.0
31;2021-07-24;8980;10368;0;834146;666024;7;59.5;47.5;0.0
31;2021-07-25;6456;8099;0;840602;674123;7;60.0;48.1;0.0
31;2021-07-26;5657;9788;0;846259;683911;7;60.4;48.8;0.0
31;2021-07-27;7902;9477;0;854161;693388;7;61.0;49.5;0.0
31;2021-07-28;8256;8491;0;862417;701879;7;61.6;50.1;0.0
31;2021-07-29;8531;8249;0;870948;710128;7;62.2;50.7;0.0
31;2021-07-30;7473;8252;0;878421;718380;7;62.7;51.3;0.0
31;2021-07-31;5708;7006;0;884129;725386;7;63.1;51.8;0.0
31;2021-08-01;3998;3988;0;888127;729374;7;63.4;52.1;0.0
31;2021-08-02;5624;5542;0;893751;734916;7;63.8;52.5;0.0
31;2021-08-03;5990;5455;0;899741;740371;7;64.2;52.8;0.0
31;2021-08-04;6043;4963;1;905784;745334;8;64.7;53.2;0.0
31;2021-08-05;5581;7227;0;911365;752561;8;65.1;53.7;0.0
31;2021-08-06;5447;7326;0;916812;759887;8;65.4;54.2;0.0
31;2021-08-07;4387;6426;0;921199;766313;8;65.8;54.7;0.0
31;2021-08-08;2984;4892;0;924183;771205;8;66.0;55.0;0.0
31;2021-08-09;4380;7021;0;928563;778226;8;66.3;55.6;0.0
31;2021-08-10;4710;6474;0;933273;784700;8;66.6;56.0;0.0
31;2021-08-11;4518;5951;0;937791;790651;8;66.9;56.4;0.0
31;2021-08-12;4433;6722;0;942224;797373;8;67.3;56.9;0.0
31;2021-08-13;3945;6085;0;946169;803458;8;67.5;57.4;0.0
31;2021-08-14;2865;6116;0;949034;809574;8;67.7;57.8;0.0
31;2021-08-15;1101;3642;0;950135;813216;8;67.8;58.0;0.0
31;2021-08-16;3201;7994;0;953336;821210;8;68.0;58.6;0.0
31;2021-08-17;3451;7177;0;956787;828387;8;68.3;59.1;0.0
31;2021-08-18;3253;6894;2;960040;835281;10;68.5;59.6;0.0
31;2021-08-19;2944;6971;0;962984;842252;10;68.7;60.1;0.0
31;2021-08-20;2893;7212;0;965877;849464;10;68.9;60.6;0.0
31;2021-08-21;1891;6500;0;967768;855964;10;69.1;61.1;0.0
31;2021-08-22;1270;4864;1;969038;860828;11;69.2;61.4;0.0
31;2021-08-23;2253;7450;0;971291;868278;11;69.3;62.0;0.0
31;2021-08-24;2403;6275;0;973694;874553;11;69.5;62.4;0.0
31;2021-08-25;2292;5719;0;975986;880272;11;69.7;62.8;0.0
31;2021-08-26;2192;5862;0;978178;886134;11;69.8;63.3;0.0
31;2021-08-27;2326;6682;0;980504;892816;11;70.0;63.7;0.0
31;2021-08-28;1711;6348;0;982215;899164;11;70.1;64.2;0.0
31;2021-08-29;1122;4454;0;983337;903618;11;70.2;64.5;0.0
31;2021-08-30;2008;6439;49;985345;910057;60;70.3;65.0;0.0
31;2021-08-31;2116;5371;138;987461;915428;198;70.5;65.3;0.0
31;2021-09-01;1904;4581;456;989365;920009;654;70.6;65.7;0.0
31;2021-09-02;1711;4040;517;991076;924049;1171;70.7;66.0;0.1
31;2021-09-03;1767;4585;532;992843;928634;1703;70.9;66.3;0.1
31;2021-09-04;1928;5282;278;994771;933916;1981;71.0;66.7;0.1
31;2021-09-05;941;1900;246;995712;935816;2227;71.1;66.8;0.2
31;2021-09-06;1351;2900;634;997063;938716;2861;71.2;67.0;0.2
31;2021-09-07;1186;2852;578;998249;941568;3439;71.3;67.2;0.2
31;2021-09-08;1345;3466;616;999594;945034;4055;71.4;67.5;0.3
31;2021-09-09;1007;2470;615;1000601;947504;4670;71.4;67.6;0.3
31;2021-09-10;1509;3147;615;1002110;950651;5285;71.5;67.9;0.4
31;2021-09-11;1246;3454;263;1003356;954105;5548;71.6;68.1;0.4
31;2021-09-12;476;1468;132;1003832;955573;5680;71.7;68.2;0.4
31;2021-09-13;1006;1975;752;1004838;957548;6432;71.7;68.4;0.5
31;2021-09-14;1191;1932;973;1006029;959480;7405;71.8;68.5;0.5
31;2021-09-15;1057;2549;859;1007086;962029;8264;71.9;68.7;0.6
31;2021-09-16;911;1640;1132;1007997;963669;9396;72.0;68.8;0.7
31;2021-09-17;1066;2441;864;1009063;966110;10260;72.0;69.0;0.7
31;2021-09-18;834;2672;252;1009897;968782;10512;72.1;69.2;0.8
31;2021-09-19;279;1070;129;1010176;969852;10641;72.1;69.2;0.8
31;2021-09-20;590;1464;726;1010766;971316;11367;72.1;69.3;0.8
31;2021-09-21;795;1566;1253;1011561;972882;12620;72.2;69.4;0.9
31;2021-09-22;805;2047;990;1012366;974929;13610;72.3;69.6;1.0
31;2021-09-23;721;1460;1232;1013087;976389;14842;72.3;69.7;1.1
31;2021-09-24;801;1982;989;1013888;978371;15831;72.4;69.8;1.1
31;2021-09-25;635;2409;229;1014523;980780;16060;72.4;70.0;1.1
31;2021-09-26;228;938;107;1014751;981718;16167;72.4;70.1;1.2
31;2021-09-27;628;1407;744;1015379;983125;16911;72.5;70.2;1.2
31;2021-09-28;708;1263;949;1016087;984388;17860;72.5;70.3;1.3
31;2021-09-29;722;1553;881;1016809;985941;18741;72.6;70.4;1.3
31;2021-09-30;675;1083;1101;1017484;987024;19842;72.6;70.5;1.4
31;2021-10-01;992;1770;916;1018476;988794;20758;72.7;70.6;1.5
31;2021-10-02;749;1646;310;1019225;990440;21068;72.8;70.7;1.5
31;2021-10-03;96;295;26;1019321;990735;21094;72.8;70.7;1.5
31;2021-10-04;449;674;609;1019770;991409;21703;72.8;70.8;1.5
31;2021-10-05;557;1202;1170;1020327;992611;22873;72.8;70.9;1.6
31;2021-10-06;658;1117;849;1020985;993728;23722;72.9;70.9;1.7
31;2021-10-07;620;1309;1187;1021605;995037;24909;72.9;71.0;1.8
31;2021-10-08;829;1168;1149;1022434;996205;26058;73.0;71.1;1.9
31;2021-10-09;495;1189;375;1022929;997394;26433;73.0;71.2;1.9
31;2021-10-10;25;63;28;1022954;997457;26461;73.0;71.2;1.9
31;2021-10-11;417;530;566;1023371;997987;27027;73.0;71.2;1.9
31;2021-10-12;562;1002;1220;1023933;998989;28247;73.1;71.3;2.0
31;2021-10-13;565;1052;952;1024498;1000041;29199;73.1;71.4;2.1
31;2021-10-14;613;1051;1226;1025111;1001092;30425;73.2;71.5;2.2
31;2021-10-15;733;1044;1339;1025844;1002136;31764;73.2;71.5;2.3
31;2021-10-16;465;949;587;1026309;1003085;32351;73.3;71.6;2.3
31;2021-10-17;17;38;14;1026326;1003123;32365;73.3;71.6;2.3
31;2021-10-18;331;498;731;1026657;1003621;33096;73.3;71.6;2.4
31;2021-10-19;496;890;1245;1027153;1004511;34341;73.3;71.7;2.5
31;2021-10-20;555;830;1355;1027708;1005341;35696;73.4;71.8;2.5
31;2021-10-21;550;949;1650;1028258;1006290;37346;73.4;71.8;2.7
31;2021-10-22;607;968;1561;1028865;1007258;38907;73.4;71.9;2.8
31;2021-10-23;403;1033;690;1029268;1008291;39597;73.5;72.0;2.8
31;2021-10-24;19;47;18;1029287;1008338;39615;73.5;72.0;2.8
31;2021-10-25;320;385;1111;1029607;1008723;40726;73.5;72.0;2.9
31;2021-10-26;443;538;1521;1030050;1009261;42247;73.5;72.0;3.0
31;2021-10-27;491;704;1975;1030541;1009965;44222;73.6;72.1;3.2
31;2021-10-28;441;564;1814;1030982;1010529;46036;73.6;72.1;3.3
31;2021-10-29;527;767;2002;1031509;1011296;48038;73.6;72.2;3.4
31;2021-10-30;306;502;656;1031815;1011798;48694;73.7;72.2;3.5
31;2021-10-31;26;34;19;1031841;1011832;48713;73.7;72.2;3.5
31;2021-11-01;53;39;36;1031894;1011871;48749;73.7;72.2;3.5
31;2021-11-02;476;620;1768;1032370;1012491;50517;73.7;72.3;3.6
31;2021-11-03;436;654;1962;1032806;1013145;52479;73.7;72.3;3.7
31;2021-11-04;402;557;2155;1033208;1013702;54634;73.8;72.4;3.9
31;2021-11-05;542;763;2648;1033750;1014465;57282;73.8;72.4;4.1
31;2021-11-06;315;445;882;1034065;1014910;58164;73.8;72.4;4.2
31;2021-11-07;28;44;70;1034093;1014954;58234;73.8;72.4;4.2
31;2021-11-08;285;437;1781;1034378;1015391;60015;73.8;72.5;4.3
31;2021-11-09;478;621;3827;1034856;1016012;63842;73.9;72.5;4.6
31;2021-11-10;497;746;3755;1035353;1016758;67597;73.9;72.6;4.8
31;2021-11-11;24;62;96;1035377;1016820;67693;73.9;72.6;4.8
31;2021-11-12;512;729;3716;1035889;1017549;71409;73.9;72.6;5.1
31;2021-11-13;314;430;1217;1036203;1017979;72626;74.0;72.7;5.2
31;2021-11-14;14;22;52;1036217;1018001;72678;74.0;72.7;5.2
31;2021-11-15;300;396;2476;1036517;1018397;75154;74.0;72.7;5.4
31;2021-11-16;487;654;4737;1037004;1019051;79891;74.0;72.7;5.7
31;2021-11-17;496;564;4009;1037500;1019615;83900;74.1;72.8;6.0
31;2021-11-18;443;504;4268;1037943;1020119;88168;74.1;72.8;6.3
31;2021-11-19;580;677;4997;1038523;1020796;93165;74.1;72.9;6.7
31;2021-11-20;469;459;1836;1038992;1021255;95001;74.2;72.9;6.8
31;2021-11-21;31;50;72;1039023;1021305;95073;74.2;72.9;6.8
31;2021-11-22;324;293;3031;1039347;1021598;98104;74.2;72.9;7.0
31;2021-11-23;479;514;5499;1039826;1022112;103603;74.2;73.0;7.4
31;2021-11-24;495;496;4555;1040321;1022608;108158;74.3;73.0;7.7
31;2021-11-25;437;470;5989;1040758;1023078;114147;74.3;73.0;8.1
31;2021-11-26;535;600;8313;1041293;1023678;122460;74.3;73.1;8.7
31;2021-11-27;369;484;4794;1041662;1024162;127254;74.4;73.1;9.1
31;2021-11-28;30;86;875;1041692;1024248;128129;74.4;73.1;9.1
31;2021-11-29;282;331;5837;1041974;1024579;133966;74.4;73.1;9.6
31;2021-11-30;419;555;9686;1042393;1025134;143652;74.4;73.2;10.3
31;2021-12-01;393;497;9079;1042786;1025631;152731;74.4;73.2;10.9
31;2021-12-02;383;360;11387;1043169;1025991;164118;74.5;73.2;11.7
31;2021-12-03;394;537;12043;1043563;1026528;176161;74.5;73.3;12.6
31;2021-12-04;252;475;6120;1043815;1027003;182281;74.5;73.3;13.0
31;2021-12-05;72;96;1988;1043887;1027099;184269;74.5;73.3;13.2
31;2021-12-06;261;380;9462;1044148;1027479;193731;74.5;73.3;13.8
31;2021-12-07;446;544;12911;1044594;1028023;206642;74.6;73.4;14.8
31;2021-12-08;408;622;11608;1045002;1028645;218250;74.6;73.4;15.6
31;2021-12-09;462;568;15198;1045464;1029213;233448;74.6;73.5;16.7
31;2021-12-10;519;639;15974;1045983;1029852;249422;74.7;73.5;17.8
31;2021-12-11;348;486;9867;1046331;1030338;259289;74.7;73.5;18.5
31;2021-12-12;153;115;4621;1046484;1030453;263910;74.7;73.6;18.8
31;2021-12-13;373;453;12802;1046857;1030906;276712;74.7;73.6;19.8
31;2021-12-14;544;650;17127;1047401;1031556;293839;74.8;73.6;21.0
31;2021-12-15;546;666;14935;1047947;1032222;308774;74.8;73.7;22.0
31;2021-12-16;472;649;16367;1048419;1032871;325141;74.8;73.7;23.2
32;2020-12-27;0;0;0;0;0;0;0.0;0.0;0.0
32;2020-12-28;0;0;0;0;0;0;0.0;0.0;0.0
32;2020-12-29;1;0;0;1;0;0;0.0;0.0;0.0
32;2020-12-30;0;0;0;1;0;0;0.0;0.0;0.0
32;2020-12-31;0;0;0;1;0;0;0.0;0.0;0.0
32;2021-01-01;1;0;0;2;0;0;0.0;0.0;0.0
32;2021-01-02;0;0;0;2;0;0;0.0;0.0;0.0
32;2021-01-03;0;0;0;2;0;0;0.0;0.0;0.0
32;2021-01-04;2;0;0;4;0;0;0.0;0.0;0.0
32;2021-01-05;4;0;0;8;0;0;0.0;0.0;0.0
32;2021-01-06;6;0;0;14;0;0;0.0;0.0;0.0
32;2021-01-07;148;0;0;162;0;0;0.1;0.0;0.0
32;2021-01-08;78;0;0;240;0;0;0.1;0.0;0.0
32;2021-01-09;7;0;0;247;0;0;0.1;0.0;0.0
32;2021-01-10;2;0;0;249;0;0;0.1;0.0;0.0
32;2021-01-11;35;1;0;284;1;0;0.1;0.0;0.0
32;2021-01-12;94;0;0;378;1;0;0.2;0.0;0.0
32;2021-01-13;296;1;0;674;2;0;0.4;0.0;0.0
32;2021-01-14;347;3;0;1021;5;0;0.5;0.0;0.0
32;2021-01-15;415;2;0;1436;7;0;0.8;0.0;0.0
32;2021-01-16;26;1;0;1462;8;0;0.8;0.0;0.0
32;2021-01-17;2;0;0;1464;8;0;0.8;0.0;0.0
32;2021-01-18;312;2;0;1776;10;0;0.9;0.0;0.0
32;2021-01-19;433;0;0;2209;10;0;1.2;0.0;0.0
32;2021-01-20;392;0;0;2601;10;0;1.4;0.0;0.0
32;2021-01-21;605;1;0;3206;11;0;1.7;0.0;0.0
32;2021-01-22;382;1;0;3588;12;0;1.9;0.0;0.0
32;2021-01-23;178;0;0;3766;12;0;2.0;0.0;0.0
32;2021-01-24;6;0;0;3772;12;0;2.0;0.0;0.0
32;2021-01-25;485;1;0;4257;13;0;2.2;0.0;0.0
32;2021-01-26;621;3;0;4878;16;0;2.6;0.0;0.0
32;2021-01-27;673;8;0;5551;24;0;2.9;0.0;0.0
32;2021-01-28;618;24;0;6169;48;0;3.2;0.0;0.0
32;2021-01-29;451;46;0;6620;94;0;3.5;0.0;0.0
32;2021-01-30;270;2;0;6890;96;0;3.6;0.1;0.0
32;2021-01-31;3;6;0;6893;102;0;3.6;0.1;0.0
32;2021-02-01;315;73;0;7208;175;0;3.8;0.1;0.0
32;2021-02-02;643;126;0;7851;301;0;4.1;0.2;0.0
32;2021-02-03;373;175;0;8224;476;0;4.3;0.3;0.0
32;2021-02-04;432;262;0;8656;738;0;4.6;0.4;0.0
32;2021-02-05;345;321;0;9001;1059;0;4.7;0.6;0.0
32;2021-02-06;147;5;0;9148;1064;0;4.8;0.6;0.0
32;2021-02-07;0;32;0;9148;1096;0;4.8;0.6;0.0
32;2021-02-08;305;124;0;9453;1220;0;5.0;0.6;0.0
32;2021-02-09;341;233;0;9794;1453;0;5.2;0.8;0.0
32;2021-02-10;309;260;0;10103;1713;0;5.3;0.9;0.0
32;2021-02-11;366;324;0;10469;2037;0;5.5;1.1;0.0
32;2021-02-12;313;268;0;10782;2305;0;5.7;1.2;0.0
32;2021-02-13;261;1;0;11043;2306;0;5.8;1.2;0.0
32;2021-02-14;0;28;0;11043;2334;0;5.8;1.2;0.0
32;2021-02-15;39;239;0;11082;2573;0;5.8;1.4;0.0
32;2021-02-16;407;384;0;11489;2957;0;6.0;1.6;0.0
32;2021-02-17;199;466;0;11688;3423;0;6.2;1.8;0.0
32;2021-02-18;321;484;0;12009;3907;0;6.3;2.1;0.0
32;2021-02-19;182;293;0;12191;4200;0;6.4;2.2;0.0
32;2021-02-20;9;148;0;12200;4348;0;6.4;2.3;0.0
32;2021-02-21;0;5;0;12200;4353;0;6.4;2.3;0.0
32;2021-02-22;163;421;0;12363;4774;0;6.5;2.5;0.0
32;2021-02-23;434;590;0;12797;5364;0;6.7;2.8;0.0
32;2021-02-24;295;383;0;13092;5747;0;6.9;3.0;0.0
32;2021-02-25;487;521;0;13579;6268;0;7.1;3.3;0.0
32;2021-02-26;456;358;0;14035;6626;0;7.4;3.5;0.0
32;2021-02-27;169;254;0;14204;6880;0;7.5;3.6;0.0
32;2021-02-28;6;1;0;14210;6881;0;7.5;3.6;0.0
32;2021-03-01;74;325;0;14284;7206;0;7.5;3.8;0.0
32;2021-03-02;419;453;0;14703;7659;0;7.7;4.0;0.0
32;2021-03-03;301;332;0;15004;7991;0;7.9;4.2;0.0
32;2021-03-04;550;355;0;15554;8346;0;8.2;4.4;0.0
32;2021-03-05;472;274;0;16026;8620;0;8.4;4.5;0.0
32;2021-03-06;566;174;0;16592;8794;0;8.7;4.6;0.0
32;2021-03-07;65;5;0;16657;8799;0;8.8;4.6;0.0
32;2021-03-08;265;305;0;16922;9104;0;8.9;4.8;0.0
32;2021-03-09;700;375;0;17622;9479;0;9.3;5.0;0.0
32;2021-03-10;515;353;0;18137;9832;0;9.5;5.2;0.0
32;2021-03-11;899;310;0;19036;10142;0;10.0;5.3;0.0
32;2021-03-12;934;355;0;19970;10497;0;10.5;5.5;0.0
32;2021-03-13;500;250;0;20470;10747;0;10.8;5.7;0.0
32;2021-03-14;3;0;0;20473;10747;0;10.8;5.7;0.0
32;2021-03-15;346;43;0;20819;10790;0;11.0;5.7;0.0
32;2021-03-16;323;318;0;21142;11108;0;11.1;5.8;0.0
32;2021-03-17;202;158;0;21344;11266;0;11.2;5.9;0.0
32;2021-03-18;436;306;0;21780;11572;0;11.5;6.1;0.0
32;2021-03-19;456;176;0;22236;11748;0;11.7;6.2;0.0
32;2021-03-20;182;32;0;22418;11780;0;11.8;6.2;0.0
32;2021-03-21;17;0;0;22435;11780;0;11.8;6.2;0.0
32;2021-03-22;398;174;0;22833;11954;0;12.0;6.3;0.0
32;2021-03-23;655;400;0;23488;12354;0;12.4;6.5;0.0
32;2021-03-24;717;277;0;24205;12631;0;12.7;6.6;0.0
32;2021-03-25;990;419;0;25195;13050;0;13.3;6.9;0.0
32;2021-03-26;730;301;0;25925;13351;0;13.6;7.0;0.0
32;2021-03-27;225;8;0;26150;13359;0;13.8;7.0;0.0
32;2021-03-28;13;2;0;26163;13361;0;13.8;7.0;0.0
32;2021-03-29;434;69;0;26597;13430;0;14.0;7.1;0.0
32;2021-03-30;884;294;0;27481;13724;0;14.5;7.2;0.0
32;2021-03-31;727;186;0;28208;13910;0;14.8;7.3;0.0
32;2021-04-01;1344;339;0;29552;14249;0;15.6;7.5;0.0
32;2021-04-02;682;190;0;30234;14439;0;15.9;7.6;0.0
32;2021-04-03;182;7;0;30416;14446;0;16.0;7.6;0.0
32;2021-04-04;18;3;0;30434;14449;0;16.0;7.6;0.0
32;2021-04-05;46;3;0;30480;14452;0;16.0;7.6;0.0
32;2021-04-06;2635;364;0;33115;14816;0;17.4;7.8;0.0
32;2021-04-07;1304;235;0;34419;15051;0;18.1;7.9;0.0
32;2021-04-08;1857;421;0;36276;15472;0;19.1;8.1;0.0
32;2021-04-09;976;236;0;37252;15708;0;19.6;8.3;0.0
32;2021-04-10;904;45;0;38156;15753;0;20.1;8.3;0.0
32;2021-04-11;43;3;0;38199;15756;0;20.1;8.3;0.0
32;2021-04-12;590;65;0;38789;15821;0;20.4;8.3;0.0
32;2021-04-13;2560;405;0;41349;16226;0;21.8;8.5;0.0
32;2021-04-14;1332;294;0;42681;16520;0;22.5;8.7;0.0
32;2021-04-15;1804;456;0;44485;16976;0;23.4;8.9;0.0
32;2021-04-16;732;341;0;45217;17317;0;23.8;9.1;0.0
32;2021-04-17;838;61;0;46055;17378;0;24.2;9.1;0.0
32;2021-04-18;31;6;0;46086;17384;0;24.3;9.1;0.0
32;2021-04-19;537;117;0;46623;17501;0;24.5;9.2;0.0
32;2021-04-20;2378;484;0;49001;17985;0;25.8;9.5;0.0
32;2021-04-21;1004;398;0;50005;18383;0;26.3;9.7;0.0
32;2021-04-22;1649;429;0;51654;18812;0;27.2;9.9;0.0
32;2021-04-23;559;229;0;52213;19041;0;27.5;10.0;0.0
32;2021-04-24;1345;104;0;53558;19145;0;28.2;10.1;0.0
32;2021-04-25;13;18;0;53571;19163;0;28.2;10.1;0.0
32;2021-04-26;360;440;0;53931;19603;0;28.4;10.3;0.0
32;2021-04-27;2297;675;0;56228;20278;0;29.6;10.7;0.0
32;2021-04-28;913;452;0;57141;20730;0;30.1;10.9;0.0
32;2021-04-29;1017;982;0;58158;21712;0;30.6;11.4;0.0
32;2021-04-30;507;436;0;58665;22148;0;30.9;11.7;0.0
32;2021-05-01;2405;119;0;61070;22267;0;32.1;11.7;0.0
32;2021-05-02;16;10;0;61086;22277;0;32.1;11.7;0.0
32;2021-05-03;271;488;0;61357;22765;0;32.3;12.0;0.0
32;2021-05-04;813;2530;0;62170;25295;0;32.7;13.3;0.0
32;2021-05-05;2103;1198;0;64273;26493;0;33.8;13.9;0.0
32;2021-05-06;613;1765;0;64886;28258;0;34.1;14.9;0.0
32;2021-05-07;2003;670;0;66889;28928;0;35.2;15.2;0.0
32;2021-05-08;141;478;0;67030;29406;0;35.3;15.5;0.0
32;2021-05-09;40;201;0;67070;29607;0;35.3;15.6;0.0
32;2021-05-10;1572;625;0;68642;30232;0;36.1;15.9;0.0
32;2021-05-11;771;2308;0;69413;32540;0;36.5;17.1;0.0
32;2021-05-12;1879;1131;0;71292;33671;0;37.5;17.7;0.0
32;2021-05-13;395;1377;0;71687;35048;0;37.7;18.4;0.0
32;2021-05-14;1648;371;0;73335;35419;0;38.6;18.6;0.0
32;2021-05-15;251;730;0;73586;36149;0;38.7;19.0;0.0
32;2021-05-16;49;5;0;73635;36154;0;38.7;19.0;0.0
32;2021-05-17;360;262;0;73995;36416;0;38.9;19.2;0.0
32;2021-05-18;1454;336;0;75449;36752;0;39.7;19.3;0.0
32;2021-05-19;2065;305;0;77514;37057;0;40.8;19.5;0.0
32;2021-05-20;2038;460;0;79552;37517;0;41.9;19.7;0.0
32;2021-05-21;1450;490;0;81002;38007;0;42.6;20.0;0.0
32;2021-05-22;421;137;0;81423;38144;0;42.8;20.1;0.0
32;2021-05-23;36;18;0;81459;38162;0;42.9;20.1;0.0
32;2021-05-24;104;14;0;81563;38176;0;42.9;20.1;0.0
32;2021-05-25;1533;436;0;83096;38612;0;43.7;20.3;0.0
32;2021-05-26;1868;593;0;84964;39205;0;44.7;20.6;0.0
32;2021-05-27;1827;693;0;86791;39898;0;45.7;21.0;0.0
32;2021-05-28;1251;828;0;88042;40726;0;46.3;21.4;0.0
32;2021-05-29;411;370;0;88453;41096;0;46.5;21.6;0.0
32;2021-05-30;12;13;0;88465;41109;0;46.6;21.6;0.0
32;2021-05-31;883;645;0;89348;41754;0;47.0;22.0;0.0
32;2021-06-01;671;2746;0;90019;44500;0;47.4;23.4;0.0
32;2021-06-02;1156;1264;0;91175;45764;0;48.0;24.1;0.0
32;2021-06-03;570;2020;0;91745;47784;0;48.3;25.1;0.0
32;2021-06-04;1322;871;0;93067;48655;0;49.0;25.6;0.0
32;2021-06-05;295;1603;0;93362;50258;0;49.1;26.4;0.0
32;2021-06-06;56;29;0;93418;50287;0;49.2;26.5;0.0
32;2021-06-07;265;460;0;93683;50747;0;49.3;26.7;0.0
32;2021-06-08;732;2336;0;94415;53083;0;49.7;27.9;0.0
32;2021-06-09;1052;980;0;95467;54063;0;50.2;28.4;0.0
32;2021-06-10;731;1143;0;96198;55206;0;50.6;29.0;0.0
32;2021-06-11;881;684;0;97079;55890;0;51.1;29.4;0.0
32;2021-06-12;258;2483;0;97337;58373;0;51.2;30.7;0.0
32;2021-06-13;76;14;0;97413;58387;0;51.3;30.7;0.0
32;2021-06-14;505;376;0;97918;58763;0;51.5;30.9;0.0
32;2021-06-15;1547;1056;0;99465;59819;0;52.3;31.5;0.0
32;2021-06-16;869;2533;0;100334;62352;0;52.8;32.8;0.0
32;2021-06-17;749;881;0;101083;63233;0;53.2;33.3;0.0
32;2021-06-18;311;2420;0;101394;65653;0;53.4;34.5;0.0
32;2021-06-19;948;508;0;102342;66161;0;53.9;34.8;0.0
32;2021-06-20;52;36;0;102394;66197;0;53.9;34.8;0.0
32;2021-06-21;158;1659;0;102552;67856;0;54.0;35.7;0.0
32;2021-06-22;979;1050;0;103531;68906;0;54.5;36.3;0.0
32;2021-06-23;550;1824;0;104081;70730;0;54.8;37.2;0.0
32;2021-06-24;606;642;0;104687;71372;0;55.1;37.6;0.0
32;2021-06-25;502;1839;0;105189;73211;0;55.4;38.5;0.0
32;2021-06-26;175;308;0;105364;73519;0;55.4;38.7;0.0
32;2021-06-27;46;62;0;105410;73581;0;55.5;38.7;0.0
32;2021-06-28;630;599;0;106040;74180;0;55.8;39.0;0.0
32;2021-06-29;797;1796;0;106837;75976;0;56.2;40.0;0.0
32;2021-06-30;773;2324;0;107610;78300;0;56.6;41.2;0.0
32;2021-07-01;578;2130;0;108188;80430;0;56.9;42.3;0.0
32;2021-07-02;654;1756;0;108842;82186;0;57.3;43.2;0.0
32;2021-07-03;506;594;0;109348;82780;0;57.5;43.6;0.0
32;2021-07-04;37;48;0;109385;82828;0;57.6;43.6;0.0
32;2021-07-05;192;419;0;109577;83247;0;57.7;43.8;0.0
32;2021-07-06;834;1867;0;110411;85114;0;58.1;44.8;0.0
32;2021-07-07;804;2196;0;111215;87310;0;58.5;45.9;0.0
32;2021-07-08;518;1828;0;111733;89138;0;58.8;46.9;0.0
32;2021-07-09;639;1624;0;112372;90762;0;59.1;47.8;0.0
32;2021-07-10;534;598;0;112906;91360;0;59.4;48.1;0.0
32;2021-07-11;24;37;0;112930;91397;0;59.4;48.1;0.0
32;2021-07-12;505;1114;0;113435;92511;0;59.7;48.7;0.0
32;2021-07-13;1499;1685;0;114934;94196;0;60.5;49.6;0.0
32;2021-07-14;549;103;0;115483;94299;0;60.8;49.6;0.0
32;2021-07-15;1642;941;0;117125;95240;0;61.6;50.1;0.0
32;2021-07-16;1048;1688;0;118173;96928;0;62.2;51.0;0.0
32;2021-07-17;200;313;0;118373;97241;0;62.3;51.2;0.0
32;2021-07-18;75;80;0;118448;97321;0;62.3;51.2;0.0
32;2021-07-19;1549;372;0;119997;97693;0;63.1;51.4;0.0
32;2021-07-20;1624;1300;0;121621;98993;0;64.0;52.1;0.0
32;2021-07-21;1344;1579;0;122965;100572;0;64.7;52.9;0.0
32;2021-07-22;1613;649;1;124578;101221;1;65.6;53.3;0.0
32;2021-07-23;1121;1630;0;125699;102851;1;66.1;54.1;0.0
32;2021-07-24;263;298;0;125962;103149;1;66.3;54.3;0.0
32;2021-07-25;133;65;0;126095;103214;1;66.4;54.3;0.0
32;2021-07-26;910;1054;0;127005;104268;1;66.8;54.9;0.0
32;2021-07-27;1392;1868;0;128397;106136;1;67.6;55.8;0.0
32;2021-07-28;731;996;0;129128;107132;1;67.9;56.4;0.0
32;2021-07-29;1467;1343;0;130595;108475;1;68.7;57.1;0.0
32;2021-07-30;510;485;0;131105;108960;1;69.0;57.3;0.0
32;2021-07-31;316;450;0;131421;109410;1;69.2;57.6;0.0
32;2021-08-01;62;35;0;131483;109445;1;69.2;57.6;0.0
32;2021-08-02;258;202;0;131741;109647;1;69.3;57.7;0.0
32;2021-08-03;1091;1665;0;132832;111312;1;69.9;58.6;0.0
32;2021-08-04;664;671;0;133496;111983;1;70.2;58.9;0.0
32;2021-08-05;1074;1772;0;134570;113755;1;70.8;59.9;0.0
32;2021-08-06;617;588;0;135187;114343;1;71.1;60.2;0.0
32;2021-08-07;250;225;0;135437;114568;1;71.3;60.3;0.0
32;2021-08-08;45;55;0;135482;114623;1;71.3;60.3;0.0
32;2021-08-09;347;1621;0;135829;116244;1;71.5;61.2;0.0
32;2021-08-10;617;1850;0;136446;118094;1;71.8;62.1;0.0
32;2021-08-11;610;548;0;137056;118642;1;72.1;62.4;0.0
32;2021-08-12;894;1864;0;137950;120506;1;72.6;63.4;0.0
32;2021-08-13;280;386;0;138230;120892;1;72.7;63.6;0.0
32;2021-08-14;225;267;0;138455;121159;1;72.9;63.8;0.0
32;2021-08-15;16;74;0;138471;121233;1;72.9;63.8;0.0
32;2021-08-16;172;240;0;138643;121473;1;73.0;63.9;0.0
32;2021-08-17;514;2097;0;139157;123570;1;73.2;65.0;0.0
32;2021-08-18;373;595;0;139530;124165;1;73.4;65.3;0.0
32;2021-08-19;900;1267;0;140430;125432;1;73.9;66.0;0.0
32;2021-08-20;234;362;0;140664;125794;1;74.0;66.2;0.0
32;2021-08-21;192;334;0;140856;126128;1;74.1;66.4;0.0
32;2021-08-22;23;76;0;140879;126204;1;74.1;66.4;0.0
32;2021-08-23;102;319;0;140981;126523;1;74.2;66.6;0.0
32;2021-08-24;571;1395;0;141552;127918;1;74.5;67.3;0.0
32;2021-08-25;148;357;0;141700;128275;1;74.6;67.5;0.0
32;2021-08-26;342;1982;0;142042;130257;1;74.7;68.5;0.0
32;2021-08-27;314;633;0;142356;130890;1;74.9;68.9;0.0
32;2021-08-28;127;240;0;142483;131130;1;75.0;69.0;0.0
32;2021-08-29;17;59;0;142500;131189;1;75.0;69.0;0.0
32;2021-08-30;67;252;1;142567;131441;2;75.0;69.2;0.0
32;2021-08-31;232;1479;23;142799;132920;25;75.1;69.9;0.0
32;2021-09-01;614;786;48;143413;133706;73;75.5;70.4;0.0
32;2021-09-02;304;1399;150;143717;135105;223;75.6;71.1;0.1
32;2021-09-03;210;434;28;143927;135539;251;75.7;71.3;0.1
32;2021-09-04;77;284;17;144004;135823;268;75.8;71.5;0.1
32;2021-09-05;32;32;0;144036;135855;268;75.8;71.5;0.1
32;2021-09-06;87;177;43;144123;136032;311;75.8;71.6;0.2
32;2021-09-07;425;723;112;144548;136755;423;76.1;72.0;0.2
32;2021-09-08;267;541;79;144815;137296;502;76.2;72.2;0.3
32;2021-09-09;200;840;191;145015;138136;693;76.3;72.7;0.4
32;2021-09-10;210;270;55;145225;138406;748;76.4;72.8;0.4
32;2021-09-11;110;257;30;145335;138663;778;76.5;73.0;0.4
32;2021-09-12;6;20;1;145341;138683;779;76.5;73.0;0.4
32;2021-09-13;35;72;22;145376;138755;801;76.5;73.0;0.4
32;2021-09-14;309;545;304;145685;139300;1105;76.7;73.3;0.6
32;2021-09-15;221;239;140;145906;139539;1245;76.8;73.4;0.7
32;2021-09-16;176;241;177;146082;139780;1422;76.9;73.6;0.7
32;2021-09-17;197;376;220;146279;140156;1642;77.0;73.8;0.9
32;2021-09-18;62;144;24;146341;140300;1666;77.0;73.8;0.9
32;2021-09-19;4;21;0;146345;140321;1666;77.0;73.8;0.9
32;2021-09-20;20;51;61;146365;140372;1727;77.0;73.9;0.9
32;2021-09-21;234;386;338;146599;140758;2065;77.1;74.1;1.1
32;2021-09-22;208;542;197;146807;141300;2262;77.3;74.4;1.2
32;2021-09-23;128;213;207;146935;141513;2469;77.3;74.5;1.3
32;2021-09-24;102;296;224;147037;141809;2693;77.4;74.6;1.4
32;2021-09-25;63;125;28;147100;141934;2721;77.4;74.7;1.4
32;2021-09-26;5;23;3;147105;141957;2724;77.4;74.7;1.4
32;2021-09-27;33;75;136;147138;142032;2860;77.4;74.7;1.5
32;2021-09-28;102;459;599;147240;142491;3459;77.5;75.0;1.8
32;2021-09-29;91;358;467;147331;142849;3926;77.5;75.2;2.1
32;2021-09-30;122;179;260;147453;143028;4186;77.6;75.3;2.2
32;2021-10-01;125;262;197;147578;143290;4383;77.7;75.4;2.3
32;2021-10-02;41;130;46;147619;143420;4429;77.7;75.5;2.3
32;2021-10-03;2;8;7;147621;143428;4436;77.7;75.5;2.3
32;2021-10-04;24;35;58;147645;143463;4494;77.7;75.5;2.4
32;2021-10-05;72;268;437;147717;143731;4931;77.7;75.6;2.6
32;2021-10-06;65;272;305;147782;144003;5236;77.8;75.8;2.8
32;2021-10-07;55;190;319;147837;144193;5555;77.8;75.9;2.9
32;2021-10-08;71;249;245;147908;144442;5800;77.8;76.0;3.1
32;2021-10-09;43;88;56;147951;144530;5856;77.9;76.1;3.1
32;2021-10-10;0;0;0;147951;144530;5856;77.9;76.1;3.1
32;2021-10-11;21;31;41;147972;144561;5897;77.9;76.1;3.1
32;2021-10-12;65;156;305;148037;144717;6202;77.9;76.2;3.3
32;2021-10-13;74;177;219;148111;144894;6421;77.9;76.2;3.4
32;2021-10-14;95;257;439;148206;145151;6860;78.0;76.4;3.6
32;2021-10-15;81;160;286;148287;145311;7146;78.0;76.5;3.8
32;2021-10-16;44;71;61;148331;145382;7207;78.1;76.5;3.8
32;2021-10-17;2;2;0;148333;145384;7207;78.1;76.5;3.8
32;2021-10-18;19;33;67;148352;145417;7274;78.1;76.5;3.8
32;2021-10-19;81;126;406;148433;145543;7680;78.1;76.6;4.0
32;2021-10-20;44;68;334;148477;145611;8014;78.1;76.6;4.2
32;2021-10-21;48;192;444;148525;145803;8458;78.2;76.7;4.5
32;2021-10-22;55;121;288;148580;145924;8746;78.2;76.8;4.6
32;2021-10-23;40;48;89;148620;145972;8835;78.2;76.8;4.6
32;2021-10-24;3;2;1;148623;145974;8836;78.2;76.8;4.6
32;2021-10-25;17;31;56;148640;146005;8892;78.2;76.8;4.7
32;2021-10-26;59;72;470;148699;146077;9362;78.2;76.9;4.9
32;2021-10-27;36;59;212;148735;146136;9574;78.3;76.9;5.0
32;2021-10-28;53;62;374;148788;146198;9948;78.3;76.9;5.2
32;2021-10-29;60;77;236;148848;146275;10184;78.3;77.0;5.4
32;2021-10-30;33;40;51;148881;146315;10235;78.3;77.0;5.4
32;2021-10-31;0;1;3;148881;146316;10238;78.3;77.0;5.4
32;2021-11-01;4;1;2;148885;146317;10240;78.3;77.0;5.4
32;2021-11-02;53;67;368;148938;146384;10608;78.4;77.0;5.6
32;2021-11-03;40;52;254;148978;146436;10862;78.4;77.1;5.7
32;2021-11-04;40;63;460;149018;146499;11322;78.4;77.1;6.0
32;2021-11-05;45;73;401;149063;146572;11723;78.4;77.1;6.2
32;2021-11-06;28;54;96;149091;146626;11819;78.5;77.2;6.2
32;2021-11-07;3;11;14;149094;146637;11833;78.5;77.2;6.2
32;2021-11-08;34;46;239;149128;146683;12072;78.5;77.2;6.4
32;2021-11-09;68;97;884;149196;146780;12956;78.5;77.2;6.8
32;2021-11-10;53;77;563;149249;146857;13519;78.5;77.3;7.1
32;2021-11-11;10;10;20;149259;146867;13539;78.5;77.3;7.1
32;2021-11-12;57;80;662;149316;146947;14201;78.6;77.3;7.5
32;2021-11-13;25;32;124;149341;146979;14325;78.6;77.3;7.5
32;2021-11-14;0;3;1;149341;146982;14326;78.6;77.3;7.5
32;2021-11-15;31;25;520;149372;147007;14846;78.6;77.4;7.8
32;2021-11-16;79;95;1273;149451;147102;16119;78.6;77.4;8.5
32;2021-11-17;66;63;774;149517;147165;16893;78.7;77.4;8.9
32;2021-11-18;50;65;1107;149567;147230;18000;78.7;77.5;9.5
32;2021-11-19;78;96;928;149645;147326;18928;78.7;77.5;10.0
32;2021-11-20;43;60;281;149688;147386;19209;78.8;77.6;10.1
32;2021-11-21;2;5;2;149690;147391;19211;78.8;77.6;10.1
32;2021-11-22;27;33;454;149717;147424;19665;78.8;77.6;10.3
32;2021-11-23;73;55;1307;149790;147479;20972;78.8;77.6;11.0
32;2021-11-24;56;53;776;149846;147532;21748;78.8;77.6;11.4
32;2021-11-25;69;59;1371;149915;147591;23119;78.9;77.7;12.2
32;2021-11-26;92;70;1633;150007;147661;24752;78.9;77.7;13.0
32;2021-11-27;58;38;746;150065;147699;25498;79.0;77.7;13.4
32;2021-11-28;1;5;15;150066;147704;25513;79.0;77.7;13.4
32;2021-11-29;45;43;1099;150111;147747;26612;79.0;77.7;14.0
32;2021-11-30;93;69;2541;150204;147816;29153;79.0;77.8;15.3
32;2021-12-01;59;63;1911;150263;147879;31064;79.1;77.8;16.3
32;2021-12-02;53;42;2616;150316;147921;33680;79.1;77.8;17.7
32;2021-12-03;48;61;1873;150364;147982;35553;79.1;77.9;18.7
32;2021-12-04;28;33;561;150392;148015;36114;79.1;77.9;19.0
32;2021-12-05;6;5;102;150398;148020;36216;79.1;77.9;19.1
32;2021-12-06;44;35;1684;150442;148055;37900;79.2;77.9;19.9
32;2021-12-07;86;88;3696;150528;148143;41596;79.2;78.0;21.9
32;2021-12-08;95;87;3038;150623;148230;44634;79.3;78.0;23.5
32;2021-12-09;70;50;2826;150693;148280;47460;79.3;78.0;25.0
32;2021-12-10;66;79;2638;150759;148359;50098;79.3;78.1;26.4
32;2021-12-11;28;43;723;150787;148402;50821;79.3;78.1;26.7
32;2021-12-12;2;5;117;150789;148407;50938;79.3;78.1;26.8
32;2021-12-13;65;40;2061;150854;148447;52999;79.4;78.1;27.9
32;2021-12-14;100;91;3624;150954;148538;56623;79.4;78.2;29.8
32;2021-12-15;79;75;2714;151033;148613;59337;79.5;78.2;31.2
32;2021-12-16;77;84;3183;151110;148697;62520;79.5;78.2;32.9
33;2020-12-27;2;0;0;2;0;0;0.0;0.0;0.0
33;2020-12-28;2;0;0;4;0;0;0.0;0.0;0.0
33;2020-12-29;0;0;0;4;0;0;0.0;0.0;0.0
33;2020-12-30;3;0;0;7;0;0;0.0;0.0;0.0
33;2020-12-31;1;0;0;8;0;0;0.0;0.0;0.0
33;2021-01-01;1;0;0;9;0;0;0.0;0.0;0.0
33;2021-01-02;1;1;0;10;1;0;0.0;0.0;0.0
33;2021-01-03;1;0;0;11;1;0;0.0;0.0;0.0
33;2021-01-04;2;0;0;13;1;0;0.0;0.0;0.0
33;2021-01-05;3;0;0;16;1;0;0.0;0.0;0.0
33;2021-01-06;149;1;0;165;2;0;0.0;0.0;0.0
33;2021-01-07;1344;4;0;1509;6;0;0.1;0.0;0.0
33;2021-01-08;1204;3;0;2713;9;0;0.2;0.0;0.0
33;2021-01-09;296;1;0;3009;10;0;0.2;0.0;0.0
33;2021-01-10;225;0;0;3234;10;0;0.2;0.0;0.0
33;2021-01-11;650;0;0;3884;10;0;0.2;0.0;0.0
33;2021-01-12;1437;2;0;5321;12;0;0.3;0.0;0.0
33;2021-01-13;1376;9;0;6697;21;0;0.4;0.0;0.0
33;2021-01-14;1341;16;0;8038;37;0;0.5;0.0;0.0
33;2021-01-15;1597;16;0;9635;53;0;0.6;0.0;0.0
33;2021-01-16;567;9;0;10202;62;0;0.6;0.0;0.0
33;2021-01-17;403;4;0;10605;66;0;0.6;0.0;0.0
33;2021-01-18;1224;13;0;11829;79;0;0.7;0.0;0.0
33;2021-01-19;2961;11;0;14790;90;0;0.9;0.0;0.0
33;2021-01-20;3343;16;0;18133;106;0;1.1;0.0;0.0
33;2021-01-21;2856;5;0;20989;111;0;1.3;0.0;0.0
33;2021-01-22;2305;8;0;23294;119;0;1.4;0.0;0.0
33;2021-01-23;846;3;0;24140;122;0;1.5;0.0;0.0
33;2021-01-24;508;2;0;24648;124;0;1.5;0.0;0.0
33;2021-01-25;2139;62;0;26787;186;0;1.6;0.0;0.0
33;2021-01-26;2287;166;0;29074;352;0;1.8;0.0;0.0
33;2021-01-27;2330;213;0;31404;565;0;1.9;0.0;0.0
33;2021-01-28;2212;481;0;33616;1046;0;2.1;0.1;0.0
33;2021-01-29;1778;706;0;35394;1752;0;2.2;0.1;0.0
33;2021-01-30;710;171;0;36104;1923;0;2.2;0.1;0.0
33;2021-01-31;370;155;0;36474;2078;0;2.2;0.1;0.0
33;2021-02-01;1353;658;0;37827;2736;0;2.3;0.2;0.0
33;2021-02-02;2562;1113;0;40389;3849;0;2.5;0.2;0.0
33;2021-02-03;2782;884;0;43171;4733;0;2.6;0.3;0.0
33;2021-02-04;3906;1346;0;47077;6079;0;2.9;0.4;0.0
33;2021-02-05;2139;1163;0;49216;7242;0;3.0;0.4;0.0
33;2021-02-06;650;204;0;49866;7446;0;3.1;0.5;0.0
33;2021-02-07;224;229;0;50090;7675;0;3.1;0.5;0.0
33;2021-02-08;1224;757;0;51314;8432;0;3.1;0.5;0.0
33;2021-02-09;1346;1660;0;52660;10092;0;3.2;0.6;0.0
33;2021-02-10;1286;1696;0;53946;11788;0;3.3;0.7;0.0
33;2021-02-11;1312;1513;0;55258;13301;0;3.4;0.8;0.0
33;2021-02-12;1172;1276;0;56430;14577;0;3.5;0.9;0.0
33;2021-02-13;223;300;0;56653;14877;0;3.5;0.9;0.0
33;2021-02-14;32;238;0;56685;15115;0;3.5;0.9;0.0
33;2021-02-15;684;1699;0;57369;16814;0;3.5;1.0;0.0
33;2021-02-16;836;2053;0;58205;18867;0;3.6;1.2;0.0
33;2021-02-17;727;2079;0;58932;20946;0;3.6;1.3;0.0
33;2021-02-18;930;2223;0;59862;23169;0;3.7;1.4;0.0
33;2021-02-19;923;1986;0;60785;25155;0;3.7;1.5;0.0
33;2021-02-20;83;656;0;60868;25811;0;3.7;1.6;0.0
33;2021-02-21;36;449;0;60904;26260;0;3.7;1.6;0.0
33;2021-02-22;685;1884;0;61589;28144;0;3.8;1.7;0.0
33;2021-02-23;1191;2725;0;62780;30869;0;3.8;1.9;0.0
33;2021-02-24;1321;2502;0;64101;33371;0;3.9;2.0;0.0
33;2021-02-25;2764;3691;0;66865;37062;0;4.1;2.3;0.0
33;2021-02-26;3953;2313;0;70818;39375;0;4.3;2.4;0.0
33;2021-02-27;1338;721;0;72156;40096;0;4.4;2.5;0.0
33;2021-02-28;116;488;0;72272;40584;0;4.4;2.5;0.0
33;2021-03-01;1487;1788;0;73759;42372;0;4.5;2.6;0.0
33;2021-03-02;2274;1753;0;76033;44125;0;4.7;2.7;0.0
33;2021-03-03;2269;1748;0;78302;45873;0;4.8;2.8;0.0
33;2021-03-04;3866;1662;0;82168;47535;0;5.0;2.9;0.0
33;2021-03-05;5683;1775;0;87851;49310;0;5.4;3.0;0.0
33;2021-03-06;3426;561;0;91277;49871;0;5.6;3.1;0.0
33;2021-03-07;786;157;0;92063;50028;0;5.6;3.1;0.0
33;2021-03-08;2606;1140;0;94669;51168;0;5.8;3.1;0.0
33;2021-03-09;4378;1341;0;99047;52509;0;6.1;3.2;0.0
33;2021-03-10;5051;1278;0;104098;53787;0;6.4;3.3;0.0
33;2021-03-11;7371;1261;0;111469;55048;0;6.8;3.4;0.0
33;2021-03-12;9838;1196;0;121307;56244;0;7.4;3.4;0.0
33;2021-03-13;5075;232;0;126382;56476;0;7.7;3.5;0.0
33;2021-03-14;698;27;0;127080;56503;0;7.8;3.5;0.0
33;2021-03-15;4236;674;0;131316;57177;0;8.0;3.5;0.0
33;2021-03-16;3462;873;0;134778;58050;0;8.3;3.6;0.0
33;2021-03-17;3593;948;0;138371;58998;0;8.5;3.6;0.0
33;2021-03-18;3925;1417;0;142296;60415;0;8.7;3.7;0.0
33;2021-03-19;6096;1044;0;148392;61459;0;9.1;3.8;0.0
33;2021-03-20;3293;118;0;151685;61577;0;9.3;3.8;0.0
33;2021-03-21;459;29;0;152144;61606;0;9.3;3.8;0.0
33;2021-03-22;4674;456;0;156818;62062;0;9.6;3.8;0.0
33;2021-03-23;6016;597;0;162834;62659;0;10.0;3.8;0.0
33;2021-03-24;6927;544;0;169761;63203;0;10.4;3.9;0.0
33;2021-03-25;8667;642;0;178428;63845;0;10.9;3.9;0.0
33;2021-03-26;9822;848;0;188250;64693;0;11.5;4.0;0.0
33;2021-03-27;3557;88;0;191807;64781;0;11.7;4.0;0.0
33;2021-03-28;580;31;0;192387;64812;0;11.8;4.0;0.0
33;2021-03-29;6559;688;0;198946;65500;0;12.2;4.0;0.0
33;2021-03-30;7841;1021;0;206787;66521;0;12.7;4.1;0.0
33;2021-03-31;7385;1070;0;214172;67591;0;13.1;4.1;0.0
33;2021-04-01;8594;1167;0;222766;68758;0;13.6;4.2;0.0
33;2021-04-02;8159;1526;0;230925;70284;0;14.1;4.3;0.0
33;2021-04-03;2796;550;0;233721;70834;0;14.3;4.3;0.0
33;2021-04-04;232;165;0;233953;70999;0;14.3;4.3;0.0
33;2021-04-05;762;117;0;234715;71116;0;14.4;4.4;0.0
33;2021-04-06;5851;2605;0;240566;73721;0;14.7;4.5;0.0
33;2021-04-07;7188;2541;0;247754;76262;0;15.2;4.7;0.0
33;2021-04-08;10013;2706;0;257767;78968;0;15.8;4.8;0.0
33;2021-04-09;12351;3007;0;270118;81975;0;16.5;5.0;0.0
33;2021-04-10;5216;1370;0;275334;83345;0;16.9;5.1;0.0
33;2021-04-11;993;343;0;276327;83688;0;16.9;5.1;0.0
33;2021-04-12;7238;3127;0;283565;86815;0;17.4;5.3;0.0
33;2021-04-13;9078;3376;0;292643;90191;0;17.9;5.5;0.0
33;2021-04-14;8796;3608;0;301439;93799;0;18.5;5.7;0.0
33;2021-04-15;9894;3771;0;311333;97570;0;19.1;6.0;0.0
33;2021-04-16;9472;4072;0;320805;101642;0;19.6;6.2;0.0
33;2021-04-17;4538;1607;0;325343;103249;0;19.9;6.3;0.0
33;2021-04-18;932;410;0;326275;103659;0;20.0;6.3;0.0
33;2021-04-19;5400;3629;0;331675;107288;0;20.3;6.6;0.0
33;2021-04-20;7091;4111;0;338766;111399;0;20.7;6.8;0.0
33;2021-04-21;6371;4223;0;345137;115622;0;21.1;7.1;0.0
33;2021-04-22;7119;4322;0;352256;119944;0;21.6;7.3;0.0
33;2021-04-23;7482;4636;0;359738;124580;0;22.0;7.6;0.0
33;2021-04-24;4422;1748;0;364160;126328;0;22.3;7.7;0.0
33;2021-04-25;1602;424;0;365762;126752;0;22.4;7.8;0.0
33;2021-04-26;4999;4919;0;370761;131671;0;22.7;8.1;0.0
33;2021-04-27;6377;5499;0;377138;137170;0;23.1;8.4;0.0
33;2021-04-28;6537;5369;0;383675;142539;0;23.5;8.7;0.0
33;2021-04-29;8130;6080;0;391805;148619;0;24.0;9.1;0.0
33;2021-04-30;8484;6003;0;400289;154622;0;24.5;9.5;0.0
33;2021-05-01;2846;576;0;403135;155198;0;24.7;9.5;0.0
33;2021-05-02;1801;346;0;404936;155544;0;24.8;9.5;0.0
33;2021-05-03;6811;5066;0;411747;160610;0;25.2;9.8;0.0
33;2021-05-04;6634;6442;0;418381;167052;0;25.6;10.2;0.0
33;2021-05-05;7073;7347;0;425454;174399;0;26.0;10.7;0.0
33;2021-05-06;8384;8074;0;433838;182473;0;26.6;11.2;0.0
33;2021-05-07;8430;8686;0;442268;191159;0;27.1;11.7;0.0
33;2021-05-08;3539;1601;0;445807;192760;0;27.3;11.8;0.0
33;2021-05-09;1138;976;0;446945;193736;0;27.4;11.9;0.0
33;2021-05-10;6591;7101;0;453536;200837;0;27.8;12.3;0.0
33;2021-05-11;8444;7665;0;461980;208502;0;28.3;12.8;0.0
33;2021-05-12;9024;6500;0;471004;215002;0;28.8;13.2;0.0
33;2021-05-13;5330;2063;0;476334;217065;0;29.2;13.3;0.0
33;2021-05-14;8254;5221;0;484588;222286;0;29.7;13.6;0.0
33;2021-05-15;5315;2846;0;489903;225132;0;30.0;13.8;0.0
33;2021-05-16;1938;791;0;491841;225923;0;30.1;13.8;0.0
33;2021-05-17;8761;4928;0;500602;230851;0;30.6;14.1;0.0
33;2021-05-18;10634;4730;0;511236;235581;0;31.3;14.4;0.0
33;2021-05-19;10891;4692;0;522127;240273;0;32.0;14.7;0.0
33;2021-05-20;11075;5451;0;533202;245724;0;32.6;15.0;0.0
33;2021-05-21;11041;6133;0;544243;251857;0;33.3;15.4;0.0
33;2021-05-22;5573;2725;0;549816;254582;0;33.7;15.6;0.0
33;2021-05-23;2058;402;0;551874;254984;0;33.8;15.6;0.0
33;2021-05-24;5851;1008;0;557725;255992;0;34.1;15.7;0.0
33;2021-05-25;9814;5639;0;567539;261631;0;34.7;16.0;0.0
33;2021-05-26;9921;5918;0;577460;267549;0;35.4;16.4;0.0
33;2021-05-27;11105;7628;0;588565;275177;0;36.0;16.8;0.0
33;2021-05-28;10187;9402;0;598752;284579;0;36.7;17.4;0.0
33;2021-05-29;5508;4087;0;604260;288666;0;37.0;17.7;0.0
33;2021-05-30;1997;678;0;606257;289344;0;37.1;17.7;0.0
33;2021-05-31;8570;6270;0;614827;295614;0;37.6;18.1;0.0
33;2021-06-01;11782;8524;0;626609;304138;0;38.4;18.6;0.0
33;2021-06-02;11763;8012;0;638372;312150;0;39.1;19.1;0.0
33;2021-06-03;12779;9059;0;651151;321209;0;39.9;19.7;0.0
33;2021-06-04;13058;10670;0;664209;331879;0;40.7;20.3;0.0
33;2021-06-05;5760;5011;0;669969;336890;0;41.0;20.6;0.0
33;2021-06-06;2616;1188;0;672585;338078;0;41.2;20.7;0.0
33;2021-06-07;9656;8188;0;682241;346266;0;41.8;21.2;0.0
33;2021-06-08;11670;9137;0;693911;355403;0;42.5;21.8;0.0
33;2021-06-09;11610;8353;0;705521;363756;0;43.2;22.3;0.0
33;2021-06-10;12815;8232;0;718336;371988;0;44.0;22.8;0.0
33;2021-06-11;12430;10844;0;730766;382832;0;44.7;23.4;0.0
33;2021-06-12;6494;4446;0;737260;387278;0;45.1;23.7;0.0
33;2021-06-13;2739;1316;0;739999;388594;0;45.3;23.8;0.0
33;2021-06-14;8339;9859;0;748338;398453;0;45.8;24.4;0.0
33;2021-06-15;11612;10001;1;759950;408454;1;46.5;25.0;0.0
33;2021-06-16;11622;8743;0;771572;417197;1;47.2;25.5;0.0
33;2021-06-17;12722;9384;0;784294;426581;1;48.0;26.1;0.0
33;2021-06-18;11437;11170;0;795731;437751;1;48.7;26.8;0.0
33;2021-06-19;5693;4875;0;801424;442626;1;49.1;27.1;0.0
33;2021-06-20;2873;1495;0;804297;444121;1;49.2;27.2;0.0
33;2021-06-21;7652;9868;0;811949;453989;1;49.7;27.8;0.0
33;2021-06-22;8632;10953;0;820581;464942;1;50.2;28.5;0.0
33;2021-06-23;8354;10670;0;828935;475612;1;50.7;29.1;0.0
33;2021-06-24;9297;9827;0;838232;485439;1;51.3;29.7;0.0
33;2021-06-25;7626;13506;0;845858;498945;1;51.8;30.5;0.0
33;2021-06-26;4239;6130;0;850097;505075;1;52.0;30.9;0.0
33;2021-06-27;2364;2071;0;852461;507146;1;52.2;31.0;0.0
33;2021-06-28;4630;12676;0;857091;519822;1;52.5;31.8;0.0
33;2021-06-29;6166;13433;0;863257;533255;1;52.8;32.6;0.0
33;2021-06-30;6431;13197;0;869688;546452;1;53.2;33.5;0.0
33;2021-07-01;7798;11737;0;877486;558189;1;53.7;34.2;0.0
33;2021-07-02;6676;15083;0;884162;573272;1;54.1;35.1;0.0
33;2021-07-03;3199;7222;0;887361;580494;1;54.3;35.5;0.0
33;2021-07-04;1969;2501;0;889330;582995;1;54.4;35.7;0.0
33;2021-07-05;4213;12786;0;893543;595781;1;54.7;36.5;0.0
33;2021-07-06;5816;14436;0;899359;610217;1;55.1;37.4;0.0
33;2021-07-07;6464;12947;0;905823;623164;1;55.5;38.2;0.0
33;2021-07-08;7555;12716;0;913378;635880;1;55.9;38.9;0.0
33;2021-07-09;6159;14978;0;919537;650858;1;56.3;39.8;0.0
33;2021-07-10;3115;7461;0;922652;658319;1;56.5;40.3;0.0
33;2021-07-11;1777;2384;0;924429;660703;1;56.6;40.4;0.0
33;2021-07-12;3818;14576;3;928247;675279;4;56.8;41.3;0.0
33;2021-07-13;6946;15899;1;935193;691178;5;57.3;42.3;0.0
33;2021-07-14;3893;5406;0;939086;696584;5;57.5;42.6;0.0
33;2021-07-15;7447;15743;0;946533;712327;5;57.9;43.6;0.0
33;2021-07-16;8289;14994;0;954822;727321;5;58.5;44.5;0.0
33;2021-07-17;3532;6764;0;958354;734085;5;58.7;44.9;0.0
33;2021-07-18;1757;3218;0;960111;737303;5;58.8;45.1;0.0
33;2021-07-19;5813;14862;0;965924;752165;5;59.1;46.0;0.0
33;2021-07-20;7459;15804;0;973383;767969;5;59.6;47.0;0.0
33;2021-07-21;8287;14301;0;981670;782270;5;60.1;47.9;0.0
33;2021-07-22;9237;14770;0;990907;797040;5;60.7;48.8;0.0
33;2021-07-23;9475;16107;0;1000382;813147;5;61.2;49.8;0.0
33;2021-07-24;4143;7680;0;1004525;820827;5;61.5;50.3;0.0
33;2021-07-25;2171;2683;0;1006696;823510;5;61.6;50.4;0.0
33;2021-07-26;6911;13089;0;1013607;836599;5;62.1;51.2;0.0
33;2021-07-27;9771;12985;0;1023378;849584;5;62.7;52.0;0.0
33;2021-07-28;10642;11599;0;1034020;861183;5;63.3;52.7;0.0
33;2021-07-29;11427;11559;0;1045447;872742;5;64.0;53.4;0.0
33;2021-07-30;11036;11850;0;1056483;884592;5;64.7;54.2;0.0
33;2021-07-31;4840;5778;0;1061323;890370;5;65.0;54.5;0.0
33;2021-08-01;2521;1935;0;1063844;892305;5;65.1;54.6;0.0
33;2021-08-02;8326;9542;0;1072170;901847;5;65.6;55.2;0.0
33;2021-08-03;11108;8667;0;1083278;910514;5;66.3;55.7;0.0
33;2021-08-04;11230;7069;0;1094508;917583;5;67.0;56.2;0.0
33;2021-08-05;11347;7686;0;1105855;925269;5;67.7;56.6;0.0
33;2021-08-06;10529;8576;0;1116384;933845;5;68.3;57.2;0.0
33;2021-08-07;5741;4435;0;1122125;938280;5;68.7;57.4;0.0
33;2021-08-08;2943;1698;0;1125068;939978;5;68.9;57.5;0.0
33;2021-08-09;8170;8321;0;1133238;948299;5;69.4;58.1;0.0
33;2021-08-10;8814;7981;1;1142052;956280;6;69.9;58.5;0.0
33;2021-08-11;7516;7099;1;1149568;963379;7;70.4;59.0;0.0
33;2021-08-12;7479;7588;0;1157047;970967;7;70.8;59.4;0.0
33;2021-08-13;7223;7229;0;1164270;978196;7;71.3;59.9;0.0
33;2021-08-14;3348;4224;0;1167618;982420;7;71.5;60.1;0.0
33;2021-08-15;1036;1518;0;1168654;983938;7;71.5;60.2;0.0
33;2021-08-16;5951;8123;0;1174605;992061;7;71.9;60.7;0.0
33;2021-08-17;6073;8655;1;1180678;1000716;8;72.3;61.3;0.0
33;2021-08-18;5098;8348;0;1185776;1009064;8;72.6;61.8;0.0
33;2021-08-19;5168;8830;0;1190944;1017894;8;72.9;62.3;0.0
33;2021-08-20;4625;9321;0;1195569;1027215;8;73.2;62.9;0.0
33;2021-08-21;2030;4901;0;1197599;1032116;8;73.3;63.2;0.0
33;2021-08-22;544;2258;0;1198143;1034374;8;73.4;63.3;0.0
33;2021-08-23;3571;9778;0;1201714;1044152;8;73.6;63.9;0.0
33;2021-08-24;3866;10542;0;1205580;1054694;8;73.8;64.6;0.0
33;2021-08-25;3427;9925;0;1209007;1064619;8;74.0;65.2;0.0
33;2021-08-26;3348;10578;0;1212355;1075197;8;74.2;65.8;0.0
33;2021-08-27;3510;11917;0;1215865;1087114;8;74.4;66.6;0.0
33;2021-08-28;1514;6439;0;1217379;1093553;8;74.5;66.9;0.0
33;2021-08-29;401;2281;0;1217780;1095834;8;74.6;67.1;0.0
33;2021-08-30;2205;10012;68;1219985;1105846;76;74.7;67.7;0.0
33;2021-08-31;2980;10255;217;1222965;1116101;293;74.9;68.3;0.0
33;2021-09-01;2870;7928;608;1225835;1124029;901;75.0;68.8;0.1
33;2021-09-02;2564;7344;633;1228399;1131373;1534;75.2;69.3;0.1
33;2021-09-03;2893;8790;805;1231292;1140163;2339;75.4;69.8;0.1
33;2021-09-04;1580;5602;276;1232872;1145765;2615;75.5;70.1;0.2
33;2021-09-05;380;1294;61;1233252;1147059;2676;75.5;70.2;0.2
33;2021-09-06;1547;6019;757;1234799;1153078;3433;75.6;70.6;0.2
33;2021-09-07;1927;5296;887;1236726;1158374;4320;75.7;70.9;0.3
33;2021-09-08;1710;5570;695;1238436;1163944;5015;75.8;71.3;0.3
33;2021-09-09;1702;5172;1148;1240138;1169116;6163;75.9;71.6;0.4
33;2021-09-10;1960;5688;1089;1242098;1174804;7252;76.0;71.9;0.4
33;2021-09-11;988;3916;268;1243086;1178720;7520;76.1;72.2;0.5
33;2021-09-12;125;473;52;1243211;1179193;7572;76.1;72.2;0.5
33;2021-09-13;1362;3300;1267;1244573;1182493;8839;76.2;72.4;0.5
33;2021-09-14;1414;3232;1934;1245987;1185725;10773;76.3;72.6;0.7
33;2021-09-15;1467;4176;1437;1247454;1189901;12210;76.4;72.8;0.7
33;2021-09-16;1375;3072;1956;1248829;1192973;14166;76.5;73.0;0.9
33;2021-09-17;1667;4212;1562;1250496;1197185;15728;76.6;73.3;1.0
33;2021-09-18;623;2931;342;1251119;1200116;16070;76.6;73.5;1.0
33;2021-09-19;109;355;26;1251228;1200471;16096;76.6;73.5;1.0
33;2021-09-20;966;1996;1362;1252194;1202467;17458;76.7;73.6;1.1
33;2021-09-21;897;2288;1749;1253091;1204755;19207;76.7;73.8;1.2
33;2021-09-22;904;3277;1417;1253995;1208032;20624;76.8;74.0;1.3
33;2021-09-23;842;2173;1491;1254837;1210205;22115;76.8;74.1;1.4
33;2021-09-24;1194;3484;1663;1256031;1213689;23778;76.9;74.3;1.5
33;2021-09-25;529;2289;382;1256560;1215978;24160;76.9;74.4;1.5
33;2021-09-26;70;314;34;1256630;1216292;24194;76.9;74.5;1.5
33;2021-09-27;597;1853;1105;1257227;1218145;25299;77.0;74.6;1.5
33;2021-09-28;763;1949;1541;1257990;1220094;26840;77.0;74.7;1.6
33;2021-09-29;840;2097;1084;1258830;1222191;27924;77.1;74.8;1.7
33;2021-09-30;649;1539;1398;1259479;1223730;29322;77.1;74.9;1.8
33;2021-10-01;1185;2478;1321;1260664;1226208;30643;77.2;75.1;1.9
33;2021-10-02;579;1330;447;1261243;1227538;31090;77.2;75.2;1.9
33;2021-10-03;14;51;4;1261257;1227589;31094;77.2;75.2;1.9
33;2021-10-04;658;1273;1379;1261915;1228862;32473;77.3;75.2;2.0
33;2021-10-05;581;1341;1342;1262496;1230203;33815;77.3;75.3;2.1
33;2021-10-06;748;1611;1310;1263244;1231814;35125;77.3;75.4;2.2
33;2021-10-07;552;1367;1526;1263796;1233181;36651;77.4;75.5;2.2
33;2021-10-08;854;1982;1685;1264650;1235163;38336;77.4;75.6;2.3
33;2021-10-09;516;968;582;1265166;1236131;38918;77.5;75.7;2.4
33;2021-10-10;15;45;14;1265181;1236176;38932;77.5;75.7;2.4
33;2021-10-11;492;1029;1636;1265673;1237205;40568;77.5;75.7;2.5
33;2021-10-12;559;1119;1734;1266232;1238324;42302;77.5;75.8;2.6
33;2021-10-13;732;1279;1640;1266964;1239603;43942;77.6;75.9;2.7
33;2021-10-14;523;1051;1875;1267487;1240654;45817;77.6;76.0;2.8
33;2021-10-15;874;1487;2532;1268361;1242141;48349;77.6;76.0;3.0
33;2021-10-16;444;685;667;1268805;1242826;49016;77.7;76.1;3.0
33;2021-10-17;27;35;20;1268832;1242861;49036;77.7;76.1;3.0
33;2021-10-18;537;647;1788;1269369;1243508;50824;77.7;76.1;3.1
33;2021-10-19;574;932;1844;1269943;1244440;52668;77.7;76.2;3.2
33;2021-10-20;600;1009;2118;1270543;1245449;54786;77.8;76.2;3.4
33;2021-10-21;496;727;1973;1271039;1246176;56759;77.8;76.3;3.5
33;2021-10-22;728;1254;2631;1271767;1247430;59390;77.9;76.4;3.6
33;2021-10-23;379;657;726;1272146;1248087;60116;77.9;76.4;3.7
33;2021-10-24;19;27;8;1272165;1248114;60124;77.9;76.4;3.7
33;2021-10-25;506;675;2146;1272671;1248789;62270;77.9;76.5;3.8
33;2021-10-26;465;589;2240;1273136;1249378;64510;77.9;76.5;3.9
33;2021-10-27;585;858;2697;1273721;1250236;67207;78.0;76.5;4.1
33;2021-10-28;452;554;2381;1274173;1250790;69588;78.0;76.6;4.3
33;2021-10-29;604;851;3237;1274777;1251641;72825;78.0;76.6;4.5
33;2021-10-30;299;428;895;1275076;1252069;73720;78.1;76.7;4.5
33;2021-10-31;12;25;22;1275088;1252094;73742;78.1;76.7;4.5
33;2021-11-01;97;65;81;1275185;1252159;73823;78.1;76.7;4.5
33;2021-11-02;486;711;2387;1275671;1252870;76210;78.1;76.7;4.7
33;2021-11-03;518;688;2593;1276189;1253558;78803;78.1;76.7;4.8
33;2021-11-04;427;570;3167;1276616;1254128;81970;78.2;76.8;5.0
33;2021-11-05;577;827;3838;1277193;1254955;85808;78.2;76.8;5.3
33;2021-11-06;268;415;1020;1277461;1255370;86828;78.2;76.9;5.3
33;2021-11-07;14;34;37;1277475;1255404;86865;78.2;76.9;5.3
33;2021-11-08;388;701;3368;1277863;1256105;90233;78.2;76.9;5.5
33;2021-11-09;519;725;4470;1278382;1256830;94703;78.3;76.9;5.8
33;2021-11-10;490;704;4629;1278872;1257534;99332;78.3;77.0;6.1
33;2021-11-11;116;100;392;1278988;1257634;99724;78.3;77.0;6.1
33;2021-11-12;550;760;4599;1279538;1258394;104323;78.3;77.0;6.4
33;2021-11-13;371;387;1481;1279909;1258781;105804;78.4;77.1;6.5
33;2021-11-14;27;48;99;1279936;1258829;105903;78.4;77.1;6.5
33;2021-11-15;445;558;4371;1280381;1259387;110274;78.4;77.1;6.8
33;2021-11-16;515;683;5468;1280896;1260070;115742;78.4;77.1;7.1
33;2021-11-17;491;615;4993;1281387;1260685;120735;78.4;77.2;7.4
33;2021-11-18;519;541;5728;1281906;1261226;126463;78.5;77.2;7.7
33;2021-11-19;722;876;6974;1282628;1262102;133437;78.5;77.3;8.2
33;2021-11-20;367;413;2010;1282995;1262515;135447;78.5;77.3;8.3
33;2021-11-21;19;41;161;1283014;1262556;135608;78.5;77.3;8.3
33;2021-11-22;499;445;4819;1283513;1263001;140427;78.6;77.3;8.6
33;2021-11-23;545;550;6774;1284058;1263551;147201;78.6;77.4;9.0
33;2021-11-24;551;559;5784;1284609;1264110;152985;78.6;77.4;9.4
33;2021-11-25;538;452;7445;1285147;1264562;160430;78.7;77.4;9.8
33;2021-11-26;695;788;10622;1285842;1265350;171052;78.7;77.5;10.5
33;2021-11-27;391;436;4568;1286233;1265786;175620;78.7;77.5;10.8
33;2021-11-28;33;69;1033;1286266;1265855;176653;78.7;77.5;10.8
33;2021-11-29;463;551;9403;1286729;1266406;186056;78.8;77.5;11.4
33;2021-11-30;560;658;12377;1287289;1267064;198433;78.8;77.6;12.1
33;2021-12-01;514;575;11589;1287803;1267639;210022;78.8;77.6;12.9
33;2021-12-02;426;415;14769;1288229;1268054;224791;78.9;77.6;13.8
33;2021-12-03;487;731;16152;1288716;1268785;240943;78.9;77.7;14.8
33;2021-12-04;289;430;7237;1289005;1269215;248180;78.9;77.7;15.2
33;2021-12-05;70;80;2222;1289075;1269295;250402;78.9;77.7;15.3
33;2021-12-06;342;494;12937;1289417;1269789;263339;78.9;77.7;16.1
33;2021-12-07;421;584;16729;1289838;1270373;280068;79.0;77.8;17.1
33;2021-12-08;435;527;15731;1290273;1270900;295799;79.0;77.8;18.1
33;2021-12-09;467;666;18189;1290740;1271566;313988;79.0;77.8;19.2
33;2021-12-10;516;740;19832;1291256;1272306;333820;79.1;77.9;20.4
33;2021-12-11;404;477;10988;1291660;1272783;344808;79.1;77.9;21.1
33;2021-12-12;71;76;2905;1291731;1272859;347713;79.1;77.9;21.3
33;2021-12-13;448;618;17004;1292179;1273477;364717;79.1;78.0;22.3
33;2021-12-14;500;665;21783;1292679;1274142;386500;79.1;78.0;23.7
33;2021-12-15;592;710;20635;1293271;1274852;407135;79.2;78.0;24.9
33;2021-12-16;585;724;22518;1293856;1275576;429653;79.2;78.1;26.3
34;2020-12-27;0;0;0;0;0;0;0.0;0.0;0.0
34;2020-12-28;1;0;0;1;0;0;0.0;0.0;0.0
34;2020-12-29;1;0;0;2;0;0;0.0;0.0;0.0
34;2020-12-30;0;0;0;2;0;0;0.0;0.0;0.0
34;2020-12-31;0;0;0;2;0;0;0.0;0.0;0.0
34;2021-01-01;4;0;0;6;0;0;0.0;0.0;0.0
34;2021-01-02;0;0;0;6;0;0;0.0;0.0;0.0
34;2021-01-03;0;0;0;6;0;0;0.0;0.0;0.0
34;2021-01-04;22;0;0;28;0;0;0.0;0.0;0.0
34;2021-01-05;112;2;0;140;2;0;0.0;0.0;0.0
34;2021-01-06;186;5;0;326;7;0;0.0;0.0;0.0
34;2021-01-07;390;0;0;716;7;0;0.1;0.0;0.0
34;2021-01-08;626;0;0;1342;7;0;0.1;0.0;0.0
34;2021-01-09;254;1;0;1596;8;0;0.1;0.0;0.0
34;2021-01-10;92;1;0;1688;9;0;0.1;0.0;0.0
34;2021-01-11;589;2;0;2277;11;0;0.2;0.0;0.0
34;2021-01-12;1045;1;0;3322;12;0;0.3;0.0;0.0
34;2021-01-13;1094;7;0;4416;19;0;0.4;0.0;0.0
34;2021-01-14;1934;13;0;6350;32;0;0.5;0.0;0.0
34;2021-01-15;1505;6;0;7855;38;0;0.7;0.0;0.0
34;2021-01-16;329;6;0;8184;44;0;0.7;0.0;0.0
34;2021-01-17;226;1;0;8410;45;0;0.7;0.0;0.0
34;2021-01-18;1138;4;0;9548;49;0;0.8;0.0;0.0
34;2021-01-19;1669;8;0;11217;57;0;1.0;0.0;0.0
34;2021-01-20;2064;24;0;13281;81;0;1.1;0.0;0.0
34;2021-01-21;4032;19;0;17313;100;0;1.5;0.0;0.0
34;2021-01-22;2482;11;0;19795;111;0;1.7;0.0;0.0
34;2021-01-23;567;2;0;20362;113;0;1.7;0.0;0.0
34;2021-01-24;13;0;0;20375;113;0;1.7;0.0;0.0
34;2021-01-25;1236;11;0;21611;124;0;1.8;0.0;0.0
34;2021-01-26;1415;26;0;23026;150;0;2.0;0.0;0.0
34;2021-01-27;1411;38;0;24437;188;0;2.1;0.0;0.0
34;2021-01-28;1377;131;0;25814;319;0;2.2;0.0;0.0
34;2021-01-29;1254;175;0;27068;494;0;2.3;0.0;0.0
34;2021-01-30;478;15;0;27546;509;0;2.3;0.0;0.0
34;2021-01-31;5;0;0;27551;509;0;2.3;0.0;0.0
34;2021-02-01;994;272;0;28545;781;0;2.4;0.1;0.0
34;2021-02-02;1461;498;0;30006;1279;0;2.6;0.1;0.0
34;2021-02-03;2490;557;0;32496;1836;0;2.8;0.2;0.0
34;2021-02-04;2252;898;0;34748;2734;0;3.0;0.2;0.0
34;2021-02-05;1856;1195;0;36604;3929;0;3.1;0.3;0.0
34;2021-02-06;500;239;0;37104;4168;0;3.2;0.4;0.0
34;2021-02-07;35;108;0;37139;4276;0;3.2;0.4;0.0
34;2021-02-08;853;1067;0;37992;5343;0;3.2;0.5;0.0
34;2021-02-09;1038;1306;0;39030;6649;0;3.3;0.6;0.0
34;2021-02-10;1298;1499;0;40328;8148;0;3.4;0.7;0.0
34;2021-02-11;1779;2646;0;42107;10794;0;3.6;0.9;0.0
34;2021-02-12;1834;1640;0;43941;12434;0;3.7;1.1;0.0
34;2021-02-13;361;498;0;44302;12932;0;3.8;1.1;0.0
34;2021-02-14;27;282;0;44329;13214;0;3.8;1.1;0.0
34;2021-02-15;682;1176;0;45011;14390;0;3.8;1.2;0.0
34;2021-02-16;672;1513;0;45683;15903;0;3.9;1.4;0.0
34;2021-02-17;718;1490;0;46401;17393;0;3.9;1.5;0.0
34;2021-02-18;877;1479;0;47278;18872;0;4.0;1.6;0.0
34;2021-02-19;829;1231;0;48107;20103;0;4.1;1.7;0.0
34;2021-02-20;314;478;0;48421;20581;0;4.1;1.7;0.0
34;2021-02-21;65;22;0;48486;20603;0;4.1;1.8;0.0
34;2021-02-22;652;1281;0;49138;21884;0;4.2;1.9;0.0
34;2021-02-23;584;1474;0;49722;23358;0;4.2;2.0;0.0
34;2021-02-24;915;2286;0;50637;25644;0;4.3;2.2;0.0
34;2021-02-25;1606;2184;0;52243;27828;0;4.4;2.4;0.0
34;2021-02-26;1873;1602;0;54116;29430;0;4.6;2.5;0.0
34;2021-02-27;732;439;0;54848;29869;0;4.7;2.5;0.0
34;2021-02-28;88;61;0;54936;29930;0;4.7;2.5;0.0
34;2021-03-01;1007;1169;0;55943;31099;0;4.8;2.6;0.0
34;2021-03-02;1724;1278;0;57667;32377;0;4.9;2.8;0.0
34;2021-03-03;1964;1397;0;59631;33774;0;5.1;2.9;0.0
34;2021-03-04;2932;1650;0;62563;35424;0;5.3;3.0;0.0
34;2021-03-05;3814;1529;0;66377;36953;0;5.6;3.1;0.0
34;2021-03-06;2765;240;0;69142;37193;0;5.9;3.2;0.0
34;2021-03-07;1273;80;0;70415;37273;0;6.0;3.2;0.0
34;2021-03-08;2743;998;0;73158;38271;0;6.2;3.3;0.0
34;2021-03-09;4016;1409;0;77174;39680;0;6.6;3.4;0.0
34;2021-03-10;3973;1335;0;81147;41015;0;6.9;3.5;0.0
34;2021-03-11;5424;1300;0;86571;42315;0;7.4;3.6;0.0
34;2021-03-12;6504;941;0;93075;43256;0;7.9;3.7;0.0
34;2021-03-13;3265;192;0;96340;43448;0;8.2;3.7;0.0
34;2021-03-14;985;51;0;97325;43499;0;8.3;3.7;0.0
34;2021-03-15;3291;583;0;100616;44082;0;8.6;3.7;0.0
34;2021-03-16;2928;684;0;103544;44766;0;8.8;3.8;0.0
34;2021-03-17;3299;710;0;106843;45476;0;9.1;3.9;0.0
34;2021-03-18;3433;961;0;110276;46437;0;9.4;3.9;0.0
34;2021-03-19;4654;807;0;114930;47244;0;9.8;4.0;0.0
34;2021-03-20;3160;86;0;118090;47330;0;10.0;4.0;0.0
34;2021-03-21;1904;49;0;119994;47379;0;10.2;4.0;0.0
34;2021-03-22;3682;500;0;123676;47879;0;10.5;4.1;0.0
34;2021-03-23;4921;560;0;128597;48439;0;10.9;4.1;0.0
34;2021-03-24;5238;682;0;133835;49121;0;11.4;4.2;0.0
34;2021-03-25;7212;767;0;141047;49888;0;12.0;4.2;0.0
34;2021-03-26;7129;576;0;148176;50464;0;12.6;4.3;0.0
34;2021-03-27;2438;116;0;150614;50580;0;12.8;4.3;0.0
34;2021-03-28;686;26;0;151300;50606;0;12.9;4.3;0.0
34;2021-03-29;4176;900;0;155476;51506;0;13.2;4.4;0.0
34;2021-03-30;5244;1112;0;160720;52618;0;13.7;4.5;0.0
34;2021-03-31;5092;1349;0;165812;53967;0;14.1;4.6;0.0
34;2021-04-01;7036;1182;0;172848;55149;0;14.7;4.7;0.0
34;2021-04-02;5860;1301;0;178708;56450;0;15.2;4.8;0.0
34;2021-04-03;1219;252;0;179927;56702;0;15.3;4.8;0.0
34;2021-04-04;178;9;0;180105;56711;0;15.3;4.8;0.0
34;2021-04-05;583;63;0;180688;56774;0;15.4;4.8;0.0
34;2021-04-06;3370;2510;0;184058;59284;0;15.6;5.0;0.0
34;2021-04-07;3545;2671;0;187603;61955;0;16.0;5.3;0.0
34;2021-04-08;5389;2864;0;192992;64819;0;16.4;5.5;0.0
34;2021-04-09;8138;2549;0;201130;67368;0;17.1;5.7;0.0
34;2021-04-10;3302;1447;0;204432;68815;0;17.4;5.9;0.0
34;2021-04-11;1754;779;0;206186;69594;0;17.5;5.9;0.0
34;2021-04-12;4614;2553;0;210800;72147;0;17.9;6.1;0.0
34;2021-04-13;5402;3180;0;216202;75327;0;18.4;6.4;0.0
34;2021-04-14;5699;3300;0;221901;78627;0;18.9;6.7;0.0
34;2021-04-15;7055;3195;0;228956;81822;0;19.5;7.0;0.0
34;2021-04-16;6622;3154;0;235578;84976;0;20.0;7.2;0.0
34;2021-04-17;2620;2104;0;238198;87080;0;20.3;7.4;0.0
34;2021-04-18;1085;1658;0;239283;88738;0;20.3;7.5;0.0
34;2021-04-19;3551;3137;0;242834;91875;0;20.6;7.8;0.0
34;2021-04-20;3949;3678;0;246783;95553;0;21.0;8.1;0.0
34;2021-04-21;4452;3766;0;251235;99319;0;21.4;8.4;0.0
34;2021-04-22;4647;4641;0;255882;103960;0;21.8;8.8;0.0
34;2021-04-23;5560;3524;0;261442;107484;0;22.2;9.1;0.0
34;2021-04-24;3271;1661;0;264713;109145;0;22.5;9.3;0.0
34;2021-04-25;1882;624;0;266595;109769;0;22.7;9.3;0.0
34;2021-04-26;4257;3504;0;270852;113273;0;23.0;9.6;0.0
34;2021-04-27;5157;4086;0;276009;117359;0;23.5;10.0;0.0
34;2021-04-28;5760;3620;0;281769;120979;0;24.0;10.3;0.0
34;2021-04-29;6504;3980;0;288273;124959;0;24.5;10.6;0.0
34;2021-04-30;7844;3411;0;296117;128370;0;25.2;10.9;0.0
34;2021-05-01;2595;572;0;298712;128942;0;25.4;11.0;0.0
34;2021-05-02;3203;345;0;301915;129287;0;25.7;11.0;0.0
34;2021-05-03;6507;3080;0;308422;132367;0;26.2;11.3;0.0
34;2021-05-04;6980;4026;0;315402;136393;0;26.8;11.6;0.0
34;2021-05-05;6377;4648;0;321779;141041;0;27.4;12.0;0.0
34;2021-05-06;6943;5338;0;328722;146379;0;27.9;12.4;0.0
34;2021-05-07;6817;5769;0;335539;152148;0;28.5;12.9;0.0
34;2021-05-08;3657;1244;0;339196;153392;0;28.8;13.0;0.0
34;2021-05-09;2108;1276;0;341304;154668;0;29.0;13.2;0.0
34;2021-05-10;5678;4928;0;346982;159596;0;29.5;13.6;0.0
34;2021-05-11;7133;5457;0;354115;165053;0;30.1;14.0;0.0
34;2021-05-12;7570;4669;0;361685;169722;0;30.8;14.4;0.0
34;2021-05-13;6108;889;0;367793;170611;0;31.3;14.5;0.0
34;2021-05-14;7385;3896;0;375178;174507;0;31.9;14.8;0.0
34;2021-05-15;4822;1860;0;380000;176367;0;32.3;15.0;0.0
34;2021-05-16;4595;511;0;384595;176878;0;32.7;15.0;0.0
34;2021-05-17;8091;2186;0;392686;179064;0;33.4;15.2;0.0
34;2021-05-18;8628;2218;0;401314;181282;0;34.1;15.4;0.0
34;2021-05-19;8170;2052;0;409484;183334;0;34.8;15.6;0.0
34;2021-05-20;8385;2615;0;417869;185949;0;35.5;15.8;0.0
34;2021-05-21;8208;3287;0;426077;189236;0;36.2;16.1;0.0
34;2021-05-22;5536;1244;0;431613;190480;0;36.7;16.2;0.0
34;2021-05-23;3504;538;0;435117;191018;0;37.0;16.2;0.0
34;2021-05-24;1902;846;0;437019;191864;0;37.2;16.3;0.0
34;2021-05-25;6635;3788;0;443654;195652;0;37.7;16.6;0.0
34;2021-05-26;7770;3021;0;451424;198673;0;38.4;16.9;0.0
34;2021-05-27;7760;4243;0;459184;202916;0;39.0;17.3;0.0
34;2021-05-28;7498;5373;0;466682;208289;0;39.7;17.7;0.0
34;2021-05-29;3885;3120;0;470567;211409;0;40.0;18.0;0.0
34;2021-05-30;1799;1362;0;472366;212771;0;40.2;18.1;0.0
34;2021-05-31;5503;5095;0;477869;217866;0;40.6;18.5;0.0
34;2021-06-01;6592;5908;0;484461;223774;0;41.2;19.0;0.0
34;2021-06-02;5967;5664;0;490428;229438;0;41.7;19.5;0.0
34;2021-06-03;7313;6340;0;497741;235778;0;42.3;20.0;0.0
34;2021-06-04;7348;7578;0;505089;243356;0;42.9;20.7;0.0
34;2021-06-05;3938;3662;0;509027;247018;0;43.3;21.0;0.0
34;2021-06-06;3092;1791;0;512119;248809;0;43.5;21.2;0.0
34;2021-06-07;4258;6584;0;516377;255393;0;43.9;21.7;0.0
34;2021-06-08;5547;6605;0;521924;261998;0;44.4;22.3;0.0
34;2021-06-09;5541;6696;0;527465;268694;0;44.8;22.8;0.0
34;2021-06-10;5972;6750;0;533437;275444;0;45.4;23.4;0.0
34;2021-06-11;5310;9063;0;538747;284507;0;45.8;24.2;0.0
34;2021-06-12;3077;4635;0;541824;289142;0;46.1;24.6;0.0
34;2021-06-13;1052;1838;0;542876;290980;0;46.2;24.7;0.0
34;2021-06-14;3355;7663;0;546231;298643;0;46.4;25.4;0.0
34;2021-06-15;3894;8610;0;550125;307253;0;46.8;26.1;0.0
34;2021-06-16;4493;7790;0;554618;315043;0;47.2;26.8;0.0
34;2021-06-17;4091;7743;0;558709;322786;0;47.5;27.4;0.0
34;2021-06-18;4360;9078;0;563069;331864;0;47.9;28.2;0.0
34;2021-06-19;2652;4343;0;565721;336207;0;48.1;28.6;0.0
34;2021-06-20;865;2705;0;566586;338912;0;48.2;28.8;0.0
34;2021-06-21;2204;8351;0;568790;347263;0;48.4;29.5;0.0
34;2021-06-22;2837;9015;0;571627;356278;0;48.6;30.3;0.0
34;2021-06-23;3345;8690;0;574972;364968;0;48.9;31.0;0.0
34;2021-06-24;3347;8372;0;578319;373340;0;49.2;31.7;0.0
34;2021-06-25;3256;10193;0;581575;383533;0;49.4;32.6;0.0
34;2021-06-26;1589;6052;0;583164;389585;0;49.6;33.1;0.0
34;2021-06-27;327;3973;0;583491;393558;0;49.6;33.5;0.0
34;2021-06-28;2156;8960;0;585647;402518;0;49.8;34.2;0.0
34;2021-06-29;2589;9804;0;588236;412322;0;50.0;35.1;0.0
34;2021-06-30;3192;9098;0;591428;421420;0;50.3;35.8;0.0
34;2021-07-01;3492;8988;0;594920;430408;0;50.6;36.6;0.0
34;2021-07-02;3485;9231;0;598405;439639;0;50.9;37.4;0.0
34;2021-07-03;1649;5967;0;600054;445606;0;51.0;37.9;0.0
34;2021-07-04;343;2532;0;600397;448138;0;51.0;38.1;0.0
34;2021-07-05;3058;7656;0;603455;455794;0;51.3;38.8;0.0
34;2021-07-06;3298;8669;0;606753;464463;0;51.6;39.5;0.0
34;2021-07-07;3186;8230;0;609939;472693;0;51.9;40.2;0.0
34;2021-07-08;4045;8287;0;613984;480980;0;52.2;40.9;0.0
34;2021-07-09;3812;8987;0;617796;489967;0;52.5;41.7;0.0
34;2021-07-10;2137;5552;0;619933;495519;0;52.7;42.1;0.0
34;2021-07-11;860;2305;0;620793;497824;0;52.8;42.3;0.0
34;2021-07-12;2747;8520;0;623540;506344;0;53.0;43.1;0.0
34;2021-07-13;4507;9479;0;628047;515823;0;53.4;43.9;0.0
34;2021-07-14;892;576;0;628939;516399;0;53.5;43.9;0.0
34;2021-07-15;5710;9809;0;634649;526208;0;54.0;44.7;0.0
34;2021-07-16;5864;10129;0;640513;536337;0;54.5;45.6;0.0
34;2021-07-17;4426;4523;0;644939;540860;0;54.8;46.0;0.0
34;2021-07-18;394;345;0;645333;541205;0;54.9;46.0;0.0
34;2021-07-19;4980;7898;0;650313;549103;0;55.3;46.7;0.0
34;2021-07-20;6586;7859;0;656899;556962;0;55.9;47.4;0.0
34;2021-07-21;7241;7370;0;664140;564332;0;56.5;48.0;0.0
34;2021-07-22;7252;7543;0;671392;571875;0;57.1;48.6;0.0
34;2021-07-23;7689;7606;0;679081;579481;0;57.7;49.3;0.0
34;2021-07-24;5768;3163;0;684849;582644;0;58.2;49.5;0.0
34;2021-07-25;2796;556;0;687645;583200;0;58.5;49.6;0.0
34;2021-07-26;5965;6017;0;693610;589217;0;59.0;50.1;0.0
34;2021-07-27;7904;5545;0;701514;594762;0;59.6;50.6;0.0
34;2021-07-28;8604;5568;0;710118;600330;0;60.4;51.0;0.0
34;2021-07-29;10245;5577;0;720363;605907;0;61.2;51.5;0.0
34;2021-07-30;9003;6006;0;729366;611913;0;62.0;52.0;0.0
34;2021-07-31;5982;2246;0;735348;614159;0;62.5;52.2;0.0
34;2021-08-01;2913;622;0;738261;614781;0;62.8;52.3;0.0
34;2021-08-02;6762;4633;0;745023;619414;0;63.3;52.7;0.0
34;2021-08-03;7304;4944;0;752327;624358;0;64.0;53.1;0.0
34;2021-08-04;7286;3842;0;759613;628200;0;64.6;53.4;0.0
34;2021-08-05;6347;4391;0;765960;632591;0;65.1;53.8;0.0
34;2021-08-06;5456;4671;0;771416;637262;0;65.6;54.2;0.0
34;2021-08-07;3014;2352;0;774430;639614;0;65.8;54.4;0.0
34;2021-08-08;263;291;0;774693;639905;0;65.9;54.4;0.0
34;2021-08-09;4319;5522;0;779012;645427;0;66.2;54.9;0.0
34;2021-08-10;4648;5729;0;783660;651156;0;66.6;55.4;0.0
34;2021-08-11;4289;5670;0;787949;656826;0;67.0;55.8;0.0
34;2021-08-12;4056;5604;0;792005;662430;0;67.3;56.3;0.0
34;2021-08-13;3677;5237;0;795682;667667;0;67.7;56.8;0.0
34;2021-08-14;1804;2886;0;797486;670553;0;67.8;57.0;0.0
34;2021-08-15;244;291;0;797730;670844;0;67.8;57.0;0.0
34;2021-08-16;2604;6969;0;800334;677813;0;68.0;57.6;0.0
34;2021-08-17;3256;7539;0;803590;685352;0;68.3;58.3;0.0
34;2021-08-18;2905;6792;0;806495;692144;0;68.6;58.8;0.0
34;2021-08-19;2985;6909;0;809480;699053;0;68.8;59.4;0.0
34;2021-08-20;2573;7150;0;812053;706203;0;69.0;60.0;0.0
34;2021-08-21;1332;3601;0;813385;709804;0;69.2;60.4;0.0
34;2021-08-22;178;385;0;813563;710189;0;69.2;60.4;0.0
34;2021-08-23;2198;7878;0;815761;718067;0;69.4;61.1;0.0
34;2021-08-24;2475;8128;0;818236;726195;0;69.6;61.7;0.0
34;2021-08-25;2141;7779;0;820377;733974;0;69.8;62.4;0.0
34;2021-08-26;2360;7154;1;822737;741128;1;70.0;63.0;0.0
34;2021-08-27;2113;6920;1;824850;748048;2;70.1;63.6;0.0
34;2021-08-28;1087;3381;0;825937;751429;2;70.2;63.9;0.0
34;2021-08-29;301;1041;0;826238;752470;2;70.2;64.0;0.0
34;2021-08-30;1888;6299;113;828126;758769;115;70.4;64.5;0.0
34;2021-08-31;1945;6100;240;830071;764869;355;70.6;65.0;0.0
34;2021-09-01;2199;5341;540;832270;770210;895;70.8;65.5;0.1
34;2021-09-02;1632;3811;723;833902;774021;1618;70.9;65.8;0.1
34;2021-09-03;1743;4700;665;835645;778721;2283;71.0;66.2;0.2
34;2021-09-04;1325;3121;274;836970;781842;2557;71.2;66.5;0.2
34;2021-09-05;133;243;21;837103;782085;2578;71.2;66.5;0.2
34;2021-09-06;1149;2848;866;838252;784933;3444;71.3;66.7;0.3
34;2021-09-07;1206;2976;827;839458;787909;4271;71.4;67.0;0.4
34;2021-09-08;1502;3677;706;840960;791586;4977;71.5;67.3;0.4
34;2021-09-09;1109;2892;800;842069;794478;5777;71.6;67.5;0.5
34;2021-09-10;1496;3118;855;843565;797596;6632;71.7;67.8;0.6
34;2021-09-11;1213;1836;233;844778;799432;6865;71.8;68.0;0.6
34;2021-09-12;72;106;11;844850;799538;6876;71.8;68.0;0.6
34;2021-09-13;960;2285;806;845810;801823;7682;71.9;68.2;0.7
34;2021-09-14;1164;2079;1184;846974;803902;8866;72.0;68.4;0.8
34;2021-09-15;1400;2736;1075;848374;806638;9941;72.1;68.6;0.8
34;2021-09-16;870;1751;1029;849244;808389;10970;72.2;68.7;0.9
34;2021-09-17;1056;2306;1061;850300;810695;12031;72.3;68.9;1.0
34;2021-09-18;768;1704;267;851068;812399;12298;72.4;69.1;1.0
34;2021-09-19;49;67;33;851117;812466;12331;72.4;69.1;1.0
34;2021-09-20;612;1762;989;851729;814228;13320;72.4;69.2;1.1
34;2021-09-21;572;1572;984;852301;815800;14304;72.5;69.4;1.2
34;2021-09-22;774;2376;1066;853075;818176;15370;72.5;69.6;1.3
34;2021-09-23;625;1507;926;853700;819683;16296;72.6;69.7;1.4
34;2021-09-24;805;2081;1070;854505;821764;17366;72.7;69.9;1.5
34;2021-09-25;468;1473;225;854973;823237;17591;72.7;70.0;1.5
34;2021-09-26;39;150;18;855012;823387;17609;72.7;70.0;1.5
34;2021-09-27;568;1282;597;855580;824669;18206;72.7;70.1;1.5
34;2021-09-28;569;1015;607;856149;825684;18813;72.8;70.2;1.6
34;2021-09-29;809;1725;778;856958;827409;19591;72.9;70.3;1.7
34;2021-09-30;587;1243;991;857545;828652;20582;72.9;70.5;1.7
34;2021-10-01;996;1406;1016;858541;830058;21598;73.0;70.6;1.8
34;2021-10-02;682;1365;371;859223;831423;21969;73.1;70.7;1.9
34;2021-10-03;58;150;20;859281;831573;21989;73.1;70.7;1.9
34;2021-10-04;661;970;872;859942;832543;22861;73.1;70.8;1.9
34;2021-10-05;515;911;957;860457;833454;23818;73.2;70.9;2.0
34;2021-10-06;867;1557;1355;861324;835011;25173;73.2;71.0;2.1
34;2021-10-07;552;962;1286;861876;835973;26459;73.3;71.1;2.2
34;2021-10-08;843;1327;1542;862719;837300;28001;73.4;71.2;2.4
34;2021-10-09;543;962;469;863262;838262;28470;73.4;71.3;2.4
34;2021-10-10;73;93;26;863335;838355;28496;73.4;71.3;2.4
34;2021-10-11;621;923;1466;863956;839278;29962;73.5;71.4;2.5
34;2021-10-12;477;667;1305;864433;839945;31267;73.5;71.4;2.7
34;2021-10-13;604;1017;1503;865037;840962;32770;73.5;71.5;2.8
34;2021-10-14;510;643;1205;865547;841605;33975;73.6;71.6;2.9
34;2021-10-15;809;1140;1832;866356;842745;35807;73.7;71.7;3.0
34;2021-10-16;456;659;592;866812;843404;36399;73.7;71.7;3.1
34;2021-10-17;69;59;33;866881;843463;36432;73.7;71.7;3.1
34;2021-10-18;579;735;1745;867460;844198;38177;73.8;71.8;3.2
34;2021-10-19;432;626;1537;867892;844824;39714;73.8;71.8;3.4
34;2021-10-20;540;814;2045;868432;845638;41759;73.8;71.9;3.6
34;2021-10-21;418;606;1913;868850;846244;43672;73.9;72.0;3.7
34;2021-10-22;663;955;2094;869513;847199;45766;73.9;72.0;3.9
34;2021-10-23;263;572;694;869776;847771;46460;74.0;72.1;4.0
34;2021-10-24;59;62;54;869835;847833;46514;74.0;72.1;4.0
34;2021-10-25;598;823;2222;870433;848656;48736;74.0;72.2;4.1
34;2021-10-26;362;520;1674;870795;849176;50410;74.0;72.2;4.3
34;2021-10-27;473;725;2185;871268;849901;52595;74.1;72.3;4.5
34;2021-10-28;371;517;1871;871639;850418;54466;74.1;72.3;4.6
34;2021-10-29;543;725;2127;872182;851143;56593;74.2;72.4;4.8
34;2021-10-30;278;563;937;872460;851706;57530;74.2;72.4;4.9
34;2021-10-31;62;35;81;872522;851741;57611;74.2;72.4;4.9
34;2021-11-01;76;50;61;872598;851791;57672;74.2;72.4;4.9
34;2021-11-02;433;749;2008;873031;852540;59680;74.2;72.5;5.1
34;2021-11-03;438;675;2382;873469;853215;62062;74.3;72.5;5.3
34;2021-11-04;338;489;2352;873807;853704;64414;74.3;72.6;5.5
34;2021-11-05;519;649;2785;874326;854353;67199;74.3;72.6;5.7
34;2021-11-06;338;568;1065;874664;854921;68264;74.4;72.7;5.8
34;2021-11-07;60;63;66;874724;854984;68330;74.4;72.7;5.8
34;2021-11-08;372;606;2632;875096;855590;70962;74.4;72.7;6.0
34;2021-11-09;341;535;2789;875437;856125;73751;74.4;72.8;6.3
34;2021-11-10;473;723;3823;875910;856848;77574;74.5;72.9;6.6
34;2021-11-11;54;82;276;875964;856930;77850;74.5;72.9;6.6
34;2021-11-12;448;612;3668;876412;857542;81518;74.5;72.9;6.9
34;2021-11-13;273;369;1455;876685;857911;82973;74.5;72.9;7.1
34;2021-11-14;66;38;111;876751;857949;83084;74.5;72.9;7.1
34;2021-11-15;390;545;3311;877141;858494;86395;74.6;73.0;7.3
34;2021-11-16;347;506;3460;877488;859000;89855;74.6;73.0;7.6
34;2021-11-17;472;619;3808;877960;859619;93663;74.6;73.1;8.0
34;2021-11-18;407;509;3709;878367;860128;97372;74.7;73.1;8.3
34;2021-11-19;572;733;4715;878939;860861;102087;74.7;73.2;8.7
34;2021-11-20;314;443;1537;879253;861304;103624;74.8;73.2;8.8
34;2021-11-21;16;97;124;879269;861401;103748;74.8;73.2;8.8
34;2021-11-22;445;398;3848;879714;861799;107596;74.8;73.3;9.1
34;2021-11-23;407;464;4049;880121;862263;111645;74.8;73.3;9.5
34;2021-11-24;496;581;4252;880617;862844;115897;74.9;73.4;9.9
34;2021-11-25;432;432;4965;881049;863276;120862;74.9;73.4;10.3
34;2021-11-26;640;637;7407;881689;863913;128269;75.0;73.5;10.9
34;2021-11-27;346;417;3311;882035;864330;131580;75.0;73.5;11.2
34;2021-11-28;48;113;627;882083;864443;132207;75.0;73.5;11.2
34;2021-11-29;370;482;6557;882453;864925;138764;75.0;73.5;11.8
34;2021-11-30;440;464;8747;882893;865389;147511;75.1;73.6;12.5
34;2021-12-01;338;512;8395;883231;865901;155906;75.1;73.6;13.3
34;2021-12-02;349;387;10517;883580;866288;166423;75.1;73.7;14.1
34;2021-12-03;349;506;10362;883929;866794;176785;75.2;73.7;15.0
34;2021-12-04;207;320;4617;884136;867114;181402;75.2;73.7;15.4
34;2021-12-05;40;97;816;884176;867211;182218;75.2;73.7;15.5
34;2021-12-06;370;537;9869;884546;867748;192087;75.2;73.8;16.3
34;2021-12-07;465;527;12650;885011;868275;204737;75.2;73.8;17.4
34;2021-12-08;452;648;11224;885463;868923;215961;75.3;73.9;18.4
34;2021-12-09;379;476;13131;885842;869399;229092;75.3;73.9;19.5
34;2021-12-10;461;601;14297;886303;870000;243389;75.4;74.0;20.7
34;2021-12-11;273;482;6741;886576;870482;250130;75.4;74.0;21.3
34;2021-12-12;46;57;1213;886622;870539;251343;75.4;74.0;21.4
34;2021-12-13;355;505;11665;886977;871044;263008;75.4;74.1;22.4
34;2021-12-14;472;600;16245;887449;871644;279253;75.5;74.1;23.7
34;2021-12-15;441;624;13884;887890;872268;293137;75.5;74.2;24.9
34;2021-12-16;478;606;15478;888368;872874;308615;75.5;74.2;26.2
35;2020-12-27;1;0;0;1;0;0;0.0;0.0;0.0
35;2020-12-28;0;0;0;1;0;0;0.0;0.0;0.0
35;2020-12-29;1;0;0;2;0;0;0.0;0.0;0.0
35;2020-12-30;0;0;0;2;0;0;0.0;0.0;0.0
35;2020-12-31;0;0;0;2;0;0;0.0;0.0;0.0
35;2021-01-01;3;0;0;5;0;0;0.0;0.0;0.0
35;2021-01-02;0;0;0;5;0;0;0.0;0.0;0.0
35;2021-01-03;0;0;0;5;0;0;0.0;0.0;0.0
35;2021-01-04;10;0;0;15;0;0;0.0;0.0;0.0
35;2021-01-05;116;0;0;131;0;0;0.0;0.0;0.0
35;2021-01-06;174;0;0;305;0;0;0.0;0.0;0.0
35;2021-01-07;462;1;0;767;1;0;0.1;0.0;0.0
35;2021-01-08;492;1;0;1259;2;0;0.1;0.0;0.0
35;2021-01-09;39;0;0;1298;2;0;0.1;0.0;0.0
35;2021-01-10;4;0;0;1302;2;0;0.1;0.0;0.0
35;2021-01-11;537;0;0;1839;2;0;0.2;0.0;0.0
35;2021-01-12;865;3;0;2704;5;0;0.2;0.0;0.0
35;2021-01-13;922;4;0;3626;9;0;0.3;0.0;0.0
35;2021-01-14;1259;15;0;4885;24;0;0.5;0.0;0.0
35;2021-01-15;703;2;0;5588;26;0;0.5;0.0;0.0
35;2021-01-16;190;2;0;5778;28;0;0.5;0.0;0.0
35;2021-01-17;54;0;0;5832;28;0;0.5;0.0;0.0
35;2021-01-18;1154;2;0;6986;30;0;0.6;0.0;0.0
35;2021-01-19;5127;17;0;12113;47;0;1.1;0.0;0.0
35;2021-01-20;3163;10;0;15276;57;0;1.4;0.0;0.0
35;2021-01-21;3527;13;0;18803;70;0;1.7;0.0;0.0
35;2021-01-22;2024;7;0;20827;77;0;1.9;0.0;0.0
35;2021-01-23;412;1;0;21239;78;0;2.0;0.0;0.0
35;2021-01-24;50;0;0;21289;78;0;2.0;0.0;0.0
35;2021-01-25;874;17;0;22163;95;0;2.0;0.0;0.0
35;2021-01-26;1154;135;0;23317;230;0;2.2;0.0;0.0
35;2021-01-27;1175;130;0;24492;360;0;2.3;0.0;0.0
35;2021-01-28;956;318;0;25448;678;0;2.4;0.1;0.0
35;2021-01-29;751;297;0;26199;975;0;2.4;0.1;0.0
35;2021-01-30;155;21;0;26354;996;0;2.4;0.1;0.0
35;2021-01-31;1;1;0;26355;997;0;2.4;0.1;0.0
35;2021-02-01;646;331;0;27001;1328;0;2.5;0.1;0.0
35;2021-02-02;769;501;0;27770;1829;0;2.6;0.2;0.0
35;2021-02-03;662;519;0;28432;2348;0;2.6;0.2;0.0
35;2021-02-04;648;644;0;29080;2992;0;2.7;0.3;0.0
35;2021-02-05;691;525;0;29771;3517;0;2.8;0.3;0.0
35;2021-02-06;179;12;0;29950;3529;0;2.8;0.3;0.0
35;2021-02-07;4;8;0;29954;3537;0;2.8;0.3;0.0
35;2021-02-08;442;620;0;30396;4157;0;2.8;0.4;0.0
35;2021-02-09;1656;3402;0;32052;7559;0;3.0;0.7;0.0
35;2021-02-10;1279;2612;0;33331;10171;0;3.1;0.9;0.0
35;2021-02-11;1907;3096;0;35238;13267;0;3.3;1.2;0.0
35;2021-02-12;1611;1693;0;36849;14960;0;3.4;1.4;0.0
35;2021-02-13;76;270;0;36925;15230;0;3.4;1.4;0.0
35;2021-02-14;9;72;0;36934;15302;0;3.4;1.4;0.0
35;2021-02-15;743;1029;0;37677;16331;0;3.5;1.5;0.0
35;2021-02-16;928;1121;0;38605;17452;0;3.6;1.6;0.0
35;2021-02-17;890;1180;0;39495;18632;0;3.6;1.7;0.0
35;2021-02-18;1005;1045;0;40500;19677;0;3.7;1.8;0.0
35;2021-02-19;1026;1003;0;41526;20680;0;3.8;1.9;0.0
35;2021-02-20;165;58;0;41691;20738;0;3.9;1.9;0.0
35;2021-02-21;3;3;0;41694;20741;0;3.9;1.9;0.0
35;2021-02-22;713;818;0;42407;21559;0;3.9;2.0;0.0
35;2021-02-23;1377;941;0;43784;22500;0;4.0;2.1;0.0
35;2021-02-24;1294;878;0;45078;23378;0;4.2;2.2;0.0
35;2021-02-25;2148;858;0;47226;24236;0;4.4;2.2;0.0
35;2021-02-26;2500;759;0;49726;24995;0;4.6;2.3;0.0
35;2021-02-27;863;128;0;50589;25123;0;4.7;2.3;0.0
35;2021-02-28;10;2;0;50599;25125;0;4.7;2.3;0.0
35;2021-03-01;881;650;0;51480;25775;0;4.8;2.4;0.0
35;2021-03-02;1588;1886;0;53068;27661;0;4.9;2.6;0.0
35;2021-03-03;1845;941;0;54913;28602;0;5.1;2.6;0.0
35;2021-03-04;2747;1406;0;57660;30008;0;5.3;2.8;0.0
35;2021-03-05;3588;1348;0;61248;31356;0;5.7;2.9;0.0
35;2021-03-06;1351;104;0;62599;31460;0;5.8;2.9;0.0
35;2021-03-07;65;42;0;62664;31502;0;5.8;2.9;0.0
35;2021-03-08;1372;583;0;64036;32085;0;5.9;3.0;0.0
35;2021-03-09;3050;637;0;67086;32722;0;6.2;3.0;0.0
35;2021-03-10;2825;591;0;69911;33313;0;6.5;3.1;0.0
35;2021-03-11;4078;718;0;73989;34031;0;6.8;3.1;0.0
35;2021-03-12;5800;584;0;79789;34615;0;7.4;3.2;0.0
35;2021-03-13;2422;137;0;82211;34752;0;7.6;3.2;0.0
35;2021-03-14;60;27;0;82271;34779;0;7.6;3.2;0.0
35;2021-03-15;1849;627;0;84120;35406;0;7.8;3.3;0.0
35;2021-03-16;2384;676;0;86504;36082;0;8.0;3.3;0.0
35;2021-03-17;2307;584;0;88811;36666;0;8.2;3.4;0.0
35;2021-03-18;2238;585;0;91049;37251;0;8.4;3.4;0.0
35;2021-03-19;3434;515;0;94483;37766;0;8.7;3.5;0.0
35;2021-03-20;1549;124;0;96032;37890;0;8.9;3.5;0.0
35;2021-03-21;53;2;0;96085;37892;0;8.9;3.5;0.0
35;2021-03-22;1709;781;0;97794;38673;0;9.0;3.6;0.0
35;2021-03-23;3500;1188;0;101294;39861;0;9.4;3.7;0.0
35;2021-03-24;3646;931;0;104940;40792;0;9.7;3.8;0.0
35;2021-03-25;5169;945;0;110109;41737;0;10.2;3.9;0.0
35;2021-03-26;5666;763;0;115775;42500;0;10.7;3.9;0.0
35;2021-03-27;1431;224;0;117206;42724;0;10.8;3.9;0.0
35;2021-03-28;24;0;0;117230;42724;0;10.8;3.9;0.0
35;2021-03-29;2761;854;0;119991;43578;0;11.1;4.0;0.0
35;2021-03-30;4199;1240;0;124190;44818;0;11.5;4.1;0.0
35;2021-03-31;3521;1303;0;127711;46121;0;11.8;4.3;0.0
35;2021-04-01;4303;1209;0;132014;47330;0;12.2;4.4;0.0
35;2021-04-02;4927;1148;0;136941;48478;0;12.7;4.5;0.0
35;2021-04-03;839;236;0;137780;48714;0;12.7;4.5;0.0
35;2021-04-04;23;19;0;137803;48733;0;12.7;4.5;0.0
35;2021-04-05;66;3;0;137869;48736;0;12.7;4.5;0.0
35;2021-04-06;3200;1947;0;141069;50683;0;13.0;4.7;0.0
35;2021-04-07;3910;1782;0;144979;52465;0;13.4;4.8;0.0
35;2021-04-08;5681;1576;0;150660;54041;0;13.9;5.0;0.0
35;2021-04-09;7358;1383;0;158018;55424;0;14.6;5.1;0.0
35;2021-04-10;2110;290;0;160128;55714;0;14.8;5.1;0.0
35;2021-04-11;68;37;0;160196;55751;0;14.8;5.2;0.0
35;2021-04-12;4999;1466;0;165195;57217;0;15.3;5.3;0.0
35;2021-04-13;7284;2658;0;172479;59875;0;15.9;5.5;0.0
35;2021-04-14;6043;2215;0;178522;62090;0;16.5;5.7;0.0
35;2021-04-15;7240;2180;0;185762;64270;0;17.2;5.9;0.0
35;2021-04-16;7751;1725;0;193513;65995;0;17.9;6.1;0.0
35;2021-04-17;1779;280;0;195292;66275;0;18.0;6.1;0.0
35;2021-04-18;44;11;0;195336;66286;0;18.1;6.1;0.0
35;2021-04-19;4589;1595;0;199925;67881;0;18.5;6.3;0.0
35;2021-04-20;4920;2554;0;204845;70435;0;18.9;6.5;0.0
35;2021-04-21;4920;2166;0;209765;72601;0;19.4;6.7;0.0
35;2021-04-22;6080;2281;0;215845;74882;0;19.9;6.9;0.0
35;2021-04-23;6460;2265;0;222305;77147;0;20.5;7.1;0.0
35;2021-04-24;1269;389;0;223574;77536;0;20.7;7.2;0.0
35;2021-04-25;59;26;0;223633;77562;0;20.7;7.2;0.0
35;2021-04-26;4767;2176;0;228400;79738;0;21.1;7.4;0.0
35;2021-04-27;5709;3126;0;234109;82864;0;21.6;7.7;0.0
35;2021-04-28;5780;2607;1;239889;85471;1;22.2;7.9;0.0
35;2021-04-29;6781;2760;0;246670;88231;1;22.8;8.2;0.0
35;2021-04-30;7127;2664;0;253797;90895;1;23.5;8.4;0.0
35;2021-05-01;666;266;0;254463;91161;1;23.5;8.4;0.0
35;2021-05-02;49;46;0;254512;91207;1;23.5;8.4;0.0
35;2021-05-03;5079;2393;0;259591;93600;1;24.0;8.7;0.0
35;2021-05-04;4856;5182;0;264447;98782;1;24.4;9.1;0.0
35;2021-05-05;4701;4366;0;269148;103148;1;24.9;9.5;0.0
35;2021-05-06;5955;5129;0;275103;108277;1;25.4;10.0;0.0
35;2021-05-07;5408;5082;0;280511;113359;1;25.9;10.5;0.0
35;2021-05-08;1854;172;0;282365;113531;1;26.1;10.5;0.0
35;2021-05-09;732;114;0;283097;113645;1;26.2;10.5;0.0
35;2021-05-10;3810;4723;0;286907;118368;1;26.5;10.9;0.0
35;2021-05-11;5073;5550;0;291980;123918;1;27.0;11.5;0.0
35;2021-05-12;5671;5172;0;297651;129090;1;27.5;11.9;0.0
35;2021-05-13;2715;1391;0;300366;130481;1;27.8;12.1;0.0
35;2021-05-14;5951;4002;0;306317;134483;1;28.3;12.4;0.0
35;2021-05-15;3447;731;0;309764;135214;1;28.6;12.5;0.0
35;2021-05-16;1227;91;0;310991;135305;1;28.7;12.5;0.0
35;2021-05-17;4981;3654;0;315972;138959;1;29.2;12.8;0.0
35;2021-05-18;6282;4055;0;322254;143014;1;29.8;13.2;0.0
35;2021-05-19;6287;3383;0;328541;146397;1;30.4;13.5;0.0
35;2021-05-20;7087;3728;0;335628;150125;1;31.0;13.9;0.0
35;2021-05-21;6593;4504;0;342221;154629;1;31.6;14.3;0.0
35;2021-05-22;2765;794;0;344986;155423;1;31.9;14.4;0.0
35;2021-05-23;873;74;0;345859;155497;1;32.0;14.4;0.0
35;2021-05-24;3519;1233;0;349378;156730;1;32.3;14.5;0.0
35;2021-05-25;6201;4023;0;355579;160753;1;32.9;14.9;0.0
35;2021-05-26;6370;4056;0;361949;164809;1;33.4;15.2;0.0
35;2021-05-27;7130;4718;0;369079;169527;1;34.1;15.7;0.0
35;2021-05-28;6895;5503;0;375974;175030;1;34.7;16.2;0.0
35;2021-05-29;3611;1266;0;379585;176296;1;35.1;16.3;0.0
35;2021-05-30;946;66;0;380531;176362;1;35.2;16.3;0.0
35;2021-05-31;6864;4181;0;387395;180543;1;35.8;16.7;0.0
35;2021-06-01;8004;4927;0;395399;185470;1;36.5;17.1;0.0
35;2021-06-02;7855;3862;0;403254;189332;1;37.3;17.5;0.0
35;2021-06-03;8675;4912;0;411929;194244;1;38.1;18.0;0.0
35;2021-06-04;7663;7242;0;419592;201486;1;38.8;18.6;0.0
35;2021-06-05;4481;1647;0;424073;203133;1;39.2;18.8;0.0
35;2021-06-06;2755;187;0;426828;203320;1;39.4;18.8;0.0
35;2021-06-07;6318;5441;0;433146;208761;1;40.0;19.3;0.0
35;2021-06-08;7990;5713;0;441136;214474;1;40.8;19.8;0.0
35;2021-06-09;8643;4630;0;449779;219104;1;41.6;20.2;0.0
35;2021-06-10;9496;4673;0;459275;223777;1;42.4;20.7;0.0
35;2021-06-11;8905;7186;0;468180;230963;1;43.3;21.3;0.0
35;2021-06-12;5134;1385;0;473314;232348;1;43.7;21.5;0.0
35;2021-06-13;3162;244;0;476476;232592;1;44.0;21.5;0.0
35;2021-06-14;6286;6316;0;482762;238908;1;44.6;22.1;0.0
35;2021-06-15;7465;6694;0;490227;245602;1;45.3;22.7;0.0
35;2021-06-16;8208;5560;0;498435;251162;1;46.1;23.2;0.0
35;2021-06-17;8619;5752;0;507054;256914;1;46.9;23.7;0.0
35;2021-06-18;8587;7912;0;515641;264826;1;47.7;24.5;0.0
35;2021-06-19;1921;2834;0;517562;267660;1;47.8;24.7;0.0
35;2021-06-20;2569;919;0;520131;268579;1;48.1;24.8;0.0
35;2021-06-21;5703;6304;0;525834;274883;1;48.6;25.4;0.0
35;2021-06-22;6640;7578;0;532474;282461;1;49.2;26.1;0.0
35;2021-06-23;6896;6353;0;539370;288814;1;49.8;26.7;0.0
35;2021-06-24;7967;6043;0;547337;294857;1;50.6;27.2;0.0
35;2021-06-25;6472;8782;0;553809;303639;1;51.2;28.1;0.0
35;2021-06-26;1387;3603;0;555196;307242;1;51.3;28.4;0.0
35;2021-06-27;2274;1216;0;557470;308458;1;51.5;28.5;0.0
35;2021-06-28;4153;7967;0;561623;316425;1;51.9;29.2;0.0
35;2021-06-29;4871;8273;0;566494;324698;1;52.4;30.0;0.0
35;2021-06-30;5381;8094;0;571875;332792;1;52.8;30.8;0.0
35;2021-07-01;6193;7804;0;578068;340596;1;53.4;31.5;0.0
35;2021-07-02;5229;9924;0;583297;350520;1;53.9;32.4;0.0
35;2021-07-03;1130;3594;0;584427;354114;1;54.0;32.7;0.0
35;2021-07-04;1837;1641;0;586264;355755;1;54.2;32.9;0.0
35;2021-07-05;3753;8456;0;590017;364211;1;54.5;33.7;0.0
35;2021-07-06;4612;9721;0;594629;373932;1;55.0;34.6;0.0
35;2021-07-07;4974;8681;0;599603;382613;1;55.4;35.4;0.0
35;2021-07-08;5332;8854;0;604935;391467;1;55.9;36.2;0.0
35;2021-07-09;4054;11788;0;608989;403255;1;56.3;37.3;0.0
35;2021-07-10;1104;3788;0;610093;407043;1;56.4;37.6;0.0
35;2021-07-11;1181;2257;0;611274;409300;1;56.5;37.8;0.0
35;2021-07-12;3108;9535;0;614382;418835;1;56.8;38.7;0.0
35;2021-07-13;4159;11151;0;618541;429986;1;57.2;39.7;0.0
35;2021-07-14;2282;4363;0;620823;434349;1;57.4;40.1;0.0
35;2021-07-15;4787;10472;0;625610;444821;1;57.8;41.1;0.0
35;2021-07-16;5189;11293;0;630799;456114;1;58.3;42.2;0.0
35;2021-07-17;2549;4522;0;633348;460636;1;58.5;42.6;0.0
35;2021-07-18;988;2431;0;634336;463067;1;58.6;42.8;0.0
35;2021-07-19;3675;9407;0;638011;472474;1;59.0;43.7;0.0
35;2021-07-20;5185;11033;0;643196;483507;1;59.4;44.7;0.0
35;2021-07-21;4908;9684;0;648104;493191;1;59.9;45.6;0.0
35;2021-07-22;5272;9837;0;653376;503028;1;60.4;46.5;0.0
35;2021-07-23;5069;11233;0;658445;514261;1;60.9;47.5;0.0
35;2021-07-24;2296;4712;0;660741;518973;1;61.1;48.0;0.0
35;2021-07-25;863;2677;0;661604;521650;1;61.1;48.2;0.0
35;2021-07-26;4318;8751;0;665922;530401;1;61.5;49.0;0.0
35;2021-07-27;5975;9809;0;671897;540210;1;62.1;49.9;0.0
35;2021-07-28;5845;8783;0;677742;548993;1;62.6;50.7;0.0
35;2021-07-29;6763;8391;0;684505;557384;1;63.3;51.5;0.0
35;2021-07-30;6399;9142;0;690904;566526;1;63.9;52.4;0.0
35;2021-07-31;2864;3841;0;693768;570367;1;64.1;52.7;0.0
35;2021-08-01;1481;2263;0;695249;572630;1;64.3;52.9;0.0
35;2021-08-02;5288;6909;0;700537;579539;1;64.7;53.6;0.0
35;2021-08-03;7218;7522;0;707755;587061;1;65.4;54.3;0.0
35;2021-08-04;7262;6612;0;715017;593673;1;66.1;54.9;0.0
35;2021-08-05;7150;6900;0;722167;600573;1;66.7;55.5;0.0
35;2021-08-06;6517;7209;0;728684;607782;1;67.3;56.2;0.0
35;2021-08-07;2585;3270;0;731269;611052;1;67.6;56.5;0.0
35;2021-08-08;1583;2065;0;732852;613117;1;67.7;56.7;0.0
35;2021-08-09;4871;5557;0;737723;618674;1;68.2;57.2;0.0
35;2021-08-10;6525;6353;0;744248;625027;1;68.8;57.8;0.0
35;2021-08-11;6339;5757;0;750587;630784;1;69.4;58.3;0.0
35;2021-08-12;6571;5491;0;757158;636275;1;70.0;58.8;0.0
35;2021-08-13;6301;5075;0;763459;641350;1;70.6;59.3;0.0
35;2021-08-14;2892;2155;0;766351;643505;1;70.8;59.5;0.0
35;2021-08-15;1961;1154;0;768312;644659;1;71.0;59.6;0.0
35;2021-08-16;4432;5163;0;772744;649822;1;71.4;60.1;0.0
35;2021-08-17;5825;6078;0;778569;655900;1;72.0;60.6;0.0
35;2021-08-18;5883;5476;0;784452;661376;1;72.5;61.1;0.0
35;2021-08-19;5516;5769;0;789968;667145;1;73.0;61.7;0.0
35;2021-08-20;4680;6229;0;794648;673374;1;73.4;62.2;0.0
35;2021-08-21;2087;2809;0;796735;676183;1;73.6;62.5;0.0
35;2021-08-22;1465;1661;0;798200;677844;1;73.8;62.6;0.0
35;2021-08-23;2802;6016;0;801002;683860;1;74.0;63.2;0.0
35;2021-08-24;3126;7132;0;804128;690992;1;74.3;63.9;0.0
35;2021-08-25;2986;6555;0;807114;697547;1;74.6;64.5;0.0
35;2021-08-26;2432;6822;0;809546;704369;1;74.8;65.1;0.0
35;2021-08-27;2518;7113;0;812064;711482;1;75.0;65.8;0.0
35;2021-08-28;1076;3126;0;813140;714608;1;75.1;66.0;0.0
35;2021-08-29;443;1637;0;813583;716245;1;75.2;66.2;0.0
35;2021-08-30;1827;5295;100;815410;721540;101;75.4;66.7;0.0
35;2021-08-31;2174;6229;147;817584;727769;248;75.6;67.3;0.0
35;2021-09-01;1811;5624;308;819395;733393;556;75.7;67.8;0.1
35;2021-09-02;1747;5463;389;821142;738856;945;75.9;68.3;0.1
35;2021-09-03;1903;6362;384;823045;745218;1329;76.1;68.9;0.1
35;2021-09-04;1063;3805;86;824108;749023;1415;76.2;69.2;0.1
35;2021-09-05;407;1759;63;824515;750782;1478;76.2;69.4;0.1
35;2021-09-06;1060;4360;409;825575;755142;1887;76.3;69.8;0.2
35;2021-09-07;1224;4634;505;826799;759776;2392;76.4;70.2;0.2
35;2021-09-08;1265;5513;444;828064;765289;2836;76.5;70.7;0.3
35;2021-09-09;1193;4410;475;829257;769699;3311;76.6;71.1;0.3
35;2021-09-10;1463;5545;606;830720;775244;3917;76.8;71.6;0.4
35;2021-09-11;583;3613;113;831303;778857;4030;76.8;72.0;0.4
35;2021-09-12;217;1943;48;831520;780800;4078;76.8;72.2;0.4
35;2021-09-13;1163;3416;580;832683;784216;4658;77.0;72.5;0.4
35;2021-09-14;1242;3016;1227;833925;787232;5885;77.1;72.8;0.5
35;2021-09-15;1103;4210;857;835028;791442;6742;77.2;73.1;0.6
35;2021-09-16;961;2544;997;835989;793986;7739;77.3;73.4;0.7
35;2021-09-17;1172;3462;998;837161;797448;8737;77.4;73.7;0.8
35;2021-09-18;500;2664;165;837661;800112;8902;77.4;73.9;0.8
35;2021-09-19;104;761;28;837765;800873;8930;77.4;74.0;0.8
35;2021-09-20;1042;2284;782;838807;803157;9712;77.5;74.2;0.9
35;2021-09-21;638;1771;1066;839445;804928;10778;77.6;74.4;1.0
35;2021-09-22;752;3263;946;840197;808191;11724;77.6;74.7;1.1
35;2021-09-23;575;1489;1163;840772;809680;12887;77.7;74.8;1.2
35;2021-09-24;852;2701;1025;841624;812381;13912;77.8;75.1;1.3
35;2021-09-25;363;1677;166;841987;814058;14078;77.8;75.2;1.3
35;2021-09-26;8;116;11;841995;814174;14089;77.8;75.2;1.3
35;2021-09-27;485;1464;884;842480;815638;14973;77.9;75.4;1.4
35;2021-09-28;442;1121;1004;842922;816759;15977;77.9;75.5;1.5
35;2021-09-29;551;1825;904;843473;818584;16881;77.9;75.6;1.6
35;2021-09-30;358;854;835;843831;819438;17716;78.0;75.7;1.6
35;2021-10-01;796;2004;1119;844627;821442;18835;78.1;75.9;1.7
35;2021-10-02;333;1026;202;844960;822468;19037;78.1;76.0;1.8
35;2021-10-03;7;29;3;844967;822497;19040;78.1;76.0;1.8
35;2021-10-04;478;941;815;845445;823438;19855;78.1;76.1;1.8
35;2021-10-05;408;876;1061;845853;824314;20916;78.2;76.2;1.9
35;2021-10-06;529;1208;886;846382;825522;21802;78.2;76.3;2.0
35;2021-10-07;353;864;1047;846735;826386;22849;78.3;76.4;2.1
35;2021-10-08;620;1862;1257;847355;828248;24106;78.3;76.5;2.2
35;2021-10-09;349;870;355;847704;829118;24461;78.3;76.6;2.3
35;2021-10-10;6;6;2;847710;829124;24463;78.3;76.6;2.3
35;2021-10-11;391;768;841;848101;829892;25304;78.4;76.7;2.3
35;2021-10-12;366;644;929;848467;830536;26233;78.4;76.8;2.4
35;2021-10-13;460;735;871;848927;831271;27104;78.5;76.8;2.5
35;2021-10-14;297;646;826;849224;831917;27930;78.5;76.9;2.6
35;2021-10-15;597;1422;1636;849821;833339;29566;78.5;77.0;2.7
35;2021-10-16;359;596;461;850180;833935;30027;78.6;77.1;2.8
35;2021-10-17;5;12;0;850185;833947;30027;78.6;77.1;2.8
35;2021-10-18;347;674;857;850532;834621;30884;78.6;77.1;2.9
35;2021-10-19;323;651;943;850855;835272;31827;78.6;77.2;2.9
35;2021-10-20;444;790;1472;851299;836062;33299;78.7;77.3;3.1
35;2021-10-21;279;474;1179;851578;836536;34478;78.7;77.3;3.2
35;2021-10-22;456;883;1795;852034;837419;36273;78.7;77.4;3.4
35;2021-10-23;259;410;581;852293;837829;36854;78.8;77.4;3.4
35;2021-10-24;0;13;10;852293;837842;36864;78.8;77.4;3.4
35;2021-10-25;333;474;1186;852626;838316;38050;78.8;77.5;3.5
35;2021-10-26;282;399;1093;852908;838715;39143;78.8;77.5;3.6
35;2021-10-27;293;474;1312;853201;839189;40455;78.8;77.6;3.7
35;2021-10-28;315;453;1192;853516;839642;41647;78.9;77.6;3.8
35;2021-10-29;463;656;1906;853979;840298;43553;78.9;77.7;4.0
35;2021-10-30;177;283;415;854156;840581;43968;78.9;77.7;4.1
35;2021-10-31;5;10;5;854161;840591;43973;78.9;77.7;4.1
35;2021-11-01;25;14;9;854186;840605;43982;78.9;77.7;4.1
35;2021-11-02;346;559;1404;854532;841164;45386;79.0;77.7;4.2
35;2021-11-03;286;478;1759;854818;841642;47145;79.0;77.8;4.4
35;2021-11-04;253;338;1623;855071;841980;48768;79.0;77.8;4.5
35;2021-11-05;371;574;2481;855442;842554;51249;79.1;77.9;4.7
35;2021-11-06;153;308;596;855595;842862;51845;79.1;77.9;4.8
35;2021-11-07;3;7;3;855598;842869;51848;79.1;77.9;4.8
35;2021-11-08;251;421;2158;855849;843290;54006;79.1;77.9;5.0
35;2021-11-09;331;461;2617;856180;843751;56623;79.1;78.0;5.2
35;2021-11-10;414;530;3011;856594;844281;59634;79.2;78.0;5.5
35;2021-11-11;14;15;58;856608;844296;59692;79.2;78.0;5.5
35;2021-11-12;297;508;2990;856905;844804;62682;79.2;78.1;5.8
35;2021-11-13;168;276;852;857073;845080;63534;79.2;78.1;5.9
35;2021-11-14;6;6;20;857079;845086;63554;79.2;78.1;5.9
35;2021-11-15;242;386;3093;857321;845472;66647;79.2;78.1;6.2
35;2021-11-16;290;351;3494;857611;845823;70141;79.3;78.2;6.5
35;2021-11-17;434;439;3607;858045;846262;73748;79.3;78.2;6.8
35;2021-11-18;318;309;3341;858363;846571;77089;79.3;78.2;7.1
35;2021-11-19;460;549;4437;858823;847120;81526;79.4;78.3;7.5
35;2021-11-20;180;229;1122;859003;847349;82648;79.4;78.3;7.6
35;2021-11-21;4;12;18;859007;847361;82666;79.4;78.3;7.6
35;2021-11-22;303;207;3432;859310;847568;86098;79.4;78.3;8.0
35;2021-11-23;362;274;4140;859672;847842;90238;79.4;78.4;8.3
35;2021-11-24;451;414;3945;860123;848256;94183;79.5;78.4;8.7
35;2021-11-25;303;295;4287;860426;848551;98470;79.5;78.4;9.1
35;2021-11-26;381;434;6621;860807;848985;105091;79.6;78.5;9.7
35;2021-11-27;156;204;1801;860963;849189;106892;79.6;78.5;9.9
35;2021-11-28;8;16;155;860971;849205;107047;79.6;78.5;9.9
35;2021-11-29;197;298;5678;861168;849503;112725;79.6;78.5;10.4
35;2021-11-30;266;348;7404;861434;849851;120129;79.6;78.5;11.1
35;2021-12-01;251;381;7404;861685;850232;127533;79.6;78.6;11.8
35;2021-12-02;226;216;8245;861911;850448;135778;79.7;78.6;12.5
35;2021-12-03;231;369;10685;862142;850817;146463;79.7;78.6;13.5
35;2021-12-04;167;218;3924;862309;851035;150387;79.7;78.6;13.9
35;2021-12-05;36;30;1266;862345;851065;151653;79.7;78.7;14.0
35;2021-12-06;198;263;10290;862543;851328;161943;79.7;78.7;15.0
35;2021-12-07;238;336;12847;862781;851664;174790;79.7;78.7;16.2
35;2021-12-08;274;439;10999;863055;852103;185789;79.8;78.7;17.2
35;2021-12-09;261;329;12098;863316;852432;197887;79.8;78.8;18.3
35;2021-12-10;292;483;14423;863608;852915;212310;79.8;78.8;19.6
35;2021-12-11;180;237;5147;863788;853152;217457;79.8;78.8;20.1
35;2021-12-12;40;25;1678;863828;853177;219135;79.8;78.8;20.3
35;2021-12-13;203;325;11964;864031;853502;231099;79.8;78.9;21.4
35;2021-12-14;267;382;14651;864298;853884;245750;79.9;78.9;22.7
35;2021-12-15;292;474;12873;864590;854358;258623;79.9;79.0;23.9
35;2021-12-16;255;412;14904;864845;854770;273527;79.9;79.0;25.3
36;2020-12-27;0;0;0;0;0;0;0.0;0.0;0.0
36;2020-12-28;1;0;0;1;0;0;0.0;0.0;0.0
36;2020-12-29;0;0;0;1;0;0;0.0;0.0;0.0
36;2020-12-30;0;0;0;1;0;0;0.0;0.0;0.0
36;2020-12-31;0;0;0;1;0;0;0.0;0.0;0.0
36;2021-01-01;0;0;0;1;0;0;0.0;0.0;0.0
36;2021-01-02;0;0;0;1;0;0;0.0;0.0;0.0
36;2021-01-03;0;0;0;1;0;0;0.0;0.0;0.0
36;2021-01-04;0;0;0;1;0;0;0.0;0.0;0.0
36;2021-01-05;0;0;0;1;0;0;0.0;0.0;0.0
36;2021-01-06;20;0;0;21;0;0;0.0;0.0;0.0
36;2021-01-07;51;0;0;72;0;0;0.0;0.0;0.0
36;2021-01-08;110;0;0;182;0;0;0.1;0.0;0.0
36;2021-01-09;84;1;0;266;1;0;0.1;0.0;0.0
36;2021-01-10;135;0;0;401;1;0;0.2;0.0;0.0
36;2021-01-11;213;1;0;614;2;0;0.3;0.0;0.0
36;2021-01-12;280;0;0;894;2;0;0.4;0.0;0.0
36;2021-01-13;187;2;0;1081;4;0;0.5;0.0;0.0
36;2021-01-14;472;4;0;1553;8;0;0.7;0.0;0.0
36;2021-01-15;178;1;0;1731;9;0;0.8;0.0;0.0
36;2021-01-16;24;1;0;1755;10;0;0.8;0.0;0.0
36;2021-01-17;13;1;0;1768;11;0;0.8;0.0;0.0
36;2021-01-18;606;5;0;2374;16;0;1.1;0.0;0.0
36;2021-01-19;1135;1;0;3509;17;0;1.6;0.0;0.0
36;2021-01-20;1087;4;0;4596;21;0;2.1;0.0;0.0
36;2021-01-21;696;1;0;5292;22;0;2.4;0.0;0.0
36;2021-01-22;837;2;0;6129;24;0;2.8;0.0;0.0
36;2021-01-23;291;0;0;6420;24;0;3.0;0.0;0.0
36;2021-01-24;158;1;0;6578;25;0;3.0;0.0;0.0
36;2021-01-25;578;4;0;7156;29;0;3.3;0.0;0.0
36;2021-01-26;570;2;0;7726;31;0;3.6;0.0;0.0
36;2021-01-27;797;14;0;8523;45;0;3.9;0.0;0.0
36;2021-01-28;439;46;0;8962;91;0;4.1;0.0;0.0
36;2021-01-29;473;91;0;9435;182;0;4.3;0.1;0.0
36;2021-01-30;242;71;0;9677;253;0;4.5;0.1;0.0
36;2021-01-31;106;124;0;9783;377;0;4.5;0.2;0.0
36;2021-02-01;323;90;0;10106;467;0;4.7;0.2;0.0
36;2021-02-02;371;162;0;10477;629;0;4.8;0.3;0.0
36;2021-02-03;411;245;0;10888;874;0;5.0;0.4;0.0
36;2021-02-04;248;264;0;11136;1138;0;5.1;0.5;0.0
36;2021-02-05;260;153;0;11396;1291;0;5.2;0.6;0.0
36;2021-02-06;3;1;0;11399;1292;0;5.2;0.6;0.0
36;2021-02-07;2;0;0;11401;1292;0;5.3;0.6;0.0
36;2021-02-08;235;255;0;11636;1547;0;5.4;0.7;0.0
36;2021-02-09;325;591;0;11961;2138;0;5.5;1.0;0.0
36;2021-02-10;473;634;0;12434;2772;0;5.7;1.3;0.0
36;2021-02-11;366;558;0;12800;3330;0;5.9;1.5;0.0
36;2021-02-12;311;443;0;13111;3773;0;6.0;1.7;0.0
36;2021-02-13;128;81;0;13239;3854;0;6.1;1.8;0.0
36;2021-02-14;26;43;0;13265;3897;0;6.1;1.8;0.0
36;2021-02-15;49;545;0;13314;4442;0;6.1;2.0;0.0
36;2021-02-16;114;402;0;13428;4844;0;6.2;2.2;0.0
36;2021-02-17;125;594;0;13553;5438;0;6.2;2.5;0.0
36;2021-02-18;178;576;0;13731;6014;0;6.3;2.8;0.0
36;2021-02-19;169;500;0;13900;6514;0;6.4;3.0;0.0
36;2021-02-20;83;226;0;13983;6740;0;6.4;3.1;0.0
36;2021-02-21;83;145;0;14066;6885;0;6.5;3.2;0.0
36;2021-02-22;162;447;0;14228;7332;0;6.6;3.4;0.0
36;2021-02-23;65;547;0;14293;7879;0;6.6;3.6;0.0
36;2021-02-24;123;656;0;14416;8535;0;6.6;3.9;0.0
36;2021-02-25;266;294;0;14682;8829;0;6.8;4.1;0.0
36;2021-02-26;341;414;0;15023;9243;0;6.9;4.3;0.0
36;2021-02-27;75;261;0;15098;9504;0;7.0;4.4;0.0
36;2021-02-28;13;89;0;15111;9593;0;7.0;4.4;0.0
36;2021-03-01;203;306;0;15314;9899;0;7.1;4.6;0.0
36;2021-03-02;346;341;0;15660;10240;0;7.2;4.7;0.0
36;2021-03-03;385;469;0;16045;10709;0;7.4;4.9;0.0
36;2021-03-04;651;346;0;16696;11055;0;7.7;5.1;0.0
36;2021-03-05;768;278;0;17464;11333;0;8.0;5.2;0.0
36;2021-03-06;403;18;0;17867;11351;0;8.2;5.2;0.0
36;2021-03-07;338;17;0;18205;11368;0;8.4;5.2;0.0
36;2021-03-08;272;265;0;18477;11633;0;8.5;5.4;0.0
36;2021-03-09;454;262;0;18931;11895;0;8.7;5.5;0.0
36;2021-03-10;699;389;0;19630;12284;0;9.0;5.7;0.0
36;2021-03-11;803;253;0;20433;12537;0;9.4;5.8;0.0
36;2021-03-12;1385;278;0;21818;12815;0;10.0;5.9;0.0
36;2021-03-13;553;130;0;22371;12945;0;10.3;6.0;0.0
36;2021-03-14;111;2;0;22482;12947;0;10.4;6.0;0.0
36;2021-03-15;644;159;0;23126;13106;0;10.7;6.0;0.0
36;2021-03-16;440;73;0;23566;13179;0;10.9;6.1;0.0
36;2021-03-17;750;98;0;24316;13277;0;11.2;6.1;0.0
36;2021-03-18;420;80;0;24736;13357;0;11.4;6.2;0.0
36;2021-03-19;714;47;0;25450;13404;0;11.7;6.2;0.0
36;2021-03-20;450;31;0;25900;13435;0;11.9;6.2;0.0
36;2021-03-21;2;0;0;25902;13435;0;11.9;6.2;0.0
36;2021-03-22;500;60;0;26402;13495;0;12.2;6.2;0.0
36;2021-03-23;732;69;0;27134;13564;0;12.5;6.2;0.0
36;2021-03-24;1059;83;0;28193;13647;0;13.0;6.3;0.0
36;2021-03-25;1313;99;0;29506;13746;0;13.6;6.3;0.0
36;2021-03-26;1400;162;0;30906;13908;0;14.2;6.4;0.0
36;2021-03-27;473;45;0;31379;13953;0;14.5;6.4;0.0
36;2021-03-28;68;56;0;31447;14009;0;14.5;6.5;0.0
36;2021-03-29;535;172;0;31982;14181;0;14.7;6.5;0.0
36;2021-03-30;612;256;0;32594;14437;0;15.0;6.6;0.0
36;2021-03-31;1198;167;0;33792;14604;0;15.6;6.7;0.0
36;2021-04-01;1101;420;0;34893;15024;0;16.1;6.9;0.0
36;2021-04-02;903;147;0;35796;15171;0;16.5;7.0;0.0
36;2021-04-03;265;206;0;36061;15377;0;16.6;7.1;0.0
36;2021-04-04;45;2;0;36106;15379;0;16.6;7.1;0.0
36;2021-04-05;16;45;0;36122;15424;0;16.6;7.1;0.0
36;2021-04-06;768;350;0;36890;15774;0;17.0;7.3;0.0
36;2021-04-07;1014;526;0;37904;16300;0;17.5;7.5;0.0
36;2021-04-08;1337;453;0;39241;16753;0;18.1;7.7;0.0
36;2021-04-09;1806;419;0;41047;17172;0;18.9;7.9;0.0
36;2021-04-10;614;227;0;41661;17399;0;19.2;8.0;0.0
36;2021-04-11;236;82;0;41897;17481;0;19.3;8.1;0.0
36;2021-04-12;831;549;0;42728;18030;0;19.7;8.3;0.0
36;2021-04-13;1116;510;0;43844;18540;0;20.2;8.5;0.0
36;2021-04-14;1501;832;0;45345;19372;0;20.9;8.9;0.0
36;2021-04-15;1538;482;0;46883;19854;0;21.6;9.1;0.0
36;2021-04-16;1442;451;0;48325;20305;0;22.3;9.4;0.0
36;2021-04-17;860;255;0;49185;20560;0;22.7;9.5;0.0
36;2021-04-18;345;8;0;49530;20568;0;22.8;9.5;0.0
36;2021-04-19;827;433;0;50357;21001;0;23.2;9.7;0.0
36;2021-04-20;1083;499;0;51440;21500;0;23.7;9.9;0.0
36;2021-04-21;1191;833;0;52631;22333;0;24.2;10.3;0.0
36;2021-04-22;1436;847;0;54067;23180;0;24.9;10.7;0.0
36;2021-04-23;1206;623;0;55273;23803;0;25.5;11.0;0.0
36;2021-04-24;660;380;0;55933;24183;0;25.8;11.1;0.0
36;2021-04-25;374;104;0;56307;24287;0;25.9;11.2;0.0
36;2021-04-26;1068;455;0;57375;24742;0;26.4;11.4;0.0
36;2021-04-27;1139;554;0;58514;25296;0;26.9;11.6;0.0
36;2021-04-28;1306;981;0;59820;26277;0;27.5;12.1;0.0
36;2021-04-29;1699;711;0;61519;26988;0;28.3;12.4;0.0
36;2021-04-30;1374;444;0;62893;27432;0;29.0;12.6;0.0
36;2021-05-01;692;61;0;63585;27493;0;29.3;12.7;0.0
36;2021-05-02;461;64;0;64046;27557;0;29.5;12.7;0.0
36;2021-05-03;1242;322;0;65288;27879;0;30.1;12.8;0.0
36;2021-05-04;751;773;0;66039;28652;0;30.4;13.2;0.0
36;2021-05-05;1221;1257;0;67260;29909;0;31.0;13.8;0.0
36;2021-05-06;1958;780;0;69218;30689;0;31.9;14.1;0.0
36;2021-05-07;1340;754;0;70558;31443;0;32.5;14.5;0.0
36;2021-05-08;344;123;0;70902;31566;0;32.7;14.5;0.0
36;2021-05-09;183;324;0;71085;31890;0;32.7;14.7;0.0
36;2021-05-10;1184;800;0;72269;32690;0;33.3;15.1;0.0
36;2021-05-11;1630;1193;0;73899;33883;0;34.0;15.6;0.0
36;2021-05-12;1689;1365;0;75588;35248;0;34.8;16.2;0.0
36;2021-05-13;592;307;0;76180;35555;0;35.1;16.4;0.0
36;2021-05-14;713;896;0;76893;36451;0;35.4;16.8;0.0
36;2021-05-15;651;584;0;77544;37035;0;35.7;17.1;0.0
36;2021-05-16;336;340;0;77880;37375;0;35.9;17.2;0.0
36;2021-05-17;678;904;0;78558;38279;0;36.2;17.6;0.0
36;2021-05-18;946;946;0;79504;39225;0;36.6;18.1;0.0
36;2021-05-19;1371;815;0;80875;40040;0;37.2;18.4;0.0
36;2021-05-20;1643;1076;0;82518;41116;0;38.0;18.9;0.0
36;2021-05-21;1229;963;0;83747;42079;0;38.6;19.4;0.0
36;2021-05-22;779;342;0;84526;42421;0;38.9;19.5;0.0
36;2021-05-23;428;287;0;84954;42708;0;39.1;19.7;0.0
36;2021-05-24;593;437;0;85547;43145;0;39.4;19.9;0.0
36;2021-05-25;1120;662;0;86667;43807;0;39.9;20.2;0.0
36;2021-05-26;1524;1044;0;88191;44851;0;40.6;20.7;0.0
36;2021-05-27;1520;945;0;89711;45796;0;41.3;21.1;0.0
36;2021-05-28;1012;1396;0;90723;47192;0;41.8;21.7;0.0
36;2021-05-29;778;518;0;91501;47710;0;42.1;22.0;0.0
36;2021-05-30;133;543;0;91634;48253;0;42.2;22.2;0.0
36;2021-05-31;1236;739;0;92870;48992;0;42.8;22.6;0.0
36;2021-06-01;1466;815;0;94336;49807;0;43.4;22.9;0.0
36;2021-06-02;2003;586;0;96339;50393;0;44.4;23.2;0.0
36;2021-06-03;1825;1152;0;98164;51545;0;45.2;23.7;0.0
36;2021-06-04;1764;1030;0;99928;52575;0;46.0;24.2;0.0
36;2021-06-05;827;680;0;100755;53255;0;46.4;24.5;0.0
36;2021-06-06;351;247;0;101106;53502;0;46.6;24.6;0.0
36;2021-06-07;1008;800;0;102114;54302;0;47.0;25.0;0.0
36;2021-06-08;983;914;0;103097;55216;0;47.5;25.4;0.0
36;2021-06-09;1613;956;0;104710;56172;0;48.2;25.9;0.0
36;2021-06-10;1491;1315;0;106201;57487;0;48.9;26.5;0.0
36;2021-06-11;1313;1395;0;107514;58882;0;49.5;27.1;0.0
36;2021-06-12;951;745;0;108465;59627;0;50.0;27.5;0.0
36;2021-06-13;334;270;0;108799;59897;0;50.1;27.6;0.0
36;2021-06-14;600;1201;0;109399;61098;0;50.4;28.1;0.0
36;2021-06-15;695;1151;0;110094;62249;0;50.7;28.7;0.0
36;2021-06-16;881;1413;0;110975;63662;0;51.1;29.3;0.0
36;2021-06-17;770;1807;0;111745;65469;0;51.5;30.2;0.0
36;2021-06-18;719;1789;0;112464;67258;0;51.8;31.0;0.0
36;2021-06-19;348;455;0;112812;67713;0;52.0;31.2;0.0
36;2021-06-20;234;319;0;113046;68032;0;52.1;31.3;0.0
36;2021-06-21;668;1381;0;113714;69413;0;52.4;32.0;0.0
36;2021-06-22;804;1542;0;114518;70955;0;52.7;32.7;0.0
36;2021-06-23;733;1710;0;115251;72665;0;53.1;33.5;0.0
36;2021-06-24;804;1490;0;116055;74155;0;53.4;34.2;0.0
36;2021-06-25;888;1215;0;116943;75370;0;53.9;34.7;0.0
36;2021-06-26;362;634;0;117305;76004;0;54.0;35.0;0.0
36;2021-06-27;107;272;0;117412;76276;0;54.1;35.1;0.0
36;2021-06-28;633;967;0;118045;77243;0;54.4;35.6;0.0
36;2021-06-29;653;1485;0;118698;78728;0;54.7;36.3;0.0
36;2021-06-30;780;2106;0;119478;80834;0;55.0;37.2;0.0
36;2021-07-01;388;1140;0;119866;81974;0;55.2;37.8;0.0
36;2021-07-02;736;1903;0;120602;83877;0;55.5;38.6;0.0
36;2021-07-03;438;1005;0;121040;84882;0;55.7;39.1;0.0
36;2021-07-04;188;339;0;121228;85221;0;55.8;39.2;0.0
36;2021-07-05;459;1417;0;121687;86638;0;56.0;39.9;0.0
36;2021-07-06;502;1295;0;122189;87933;0;56.3;40.5;0.0
36;2021-07-07;554;1852;0;122743;89785;0;56.5;41.3;0.0
36;2021-07-08;547;1735;0;123290;91520;0;56.8;42.1;0.0
36;2021-07-09;721;1660;0;124011;93180;0;57.1;42.9;0.0
36;2021-07-10;459;1191;0;124470;94371;0;57.3;43.5;0.0
36;2021-07-11;250;171;0;124720;94542;0;57.4;43.5;0.0
36;2021-07-12;326;1729;0;125046;96271;0;57.6;44.3;0.0
36;2021-07-13;318;1967;0;125364;98238;0;57.7;45.2;0.0
36;2021-07-14;379;764;0;125743;99002;0;57.9;45.6;0.0
36;2021-07-15;928;2084;0;126671;101086;0;58.3;46.6;0.0
36;2021-07-16;658;1874;0;127329;102960;0;58.6;47.4;0.0
36;2021-07-17;458;1001;0;127787;103961;0;58.9;47.9;0.0
36;2021-07-18;192;396;0;127979;104357;0;58.9;48.1;0.0
36;2021-07-19;641;1515;0;128620;105872;0;59.2;48.8;0.0
36;2021-07-20;863;1407;0;129483;107279;0;59.6;49.4;0.0
36;2021-07-21;897;1936;0;130380;109215;0;60.0;50.3;0.0
36;2021-07-22;1283;1569;0;131663;110784;0;60.6;51.0;0.0
36;2021-07-23;1060;1682;0;132723;112466;0;61.1;51.8;0.0
36;2021-07-24;686;849;0;133409;113315;0;61.4;52.2;0.0
36;2021-07-25;156;401;0;133565;113716;0;61.5;52.4;0.0
36;2021-07-26;1153;1074;0;134718;114790;0;62.0;52.9;0.0
36;2021-07-27;1057;1297;0;135775;116087;0;62.5;53.5;0.0
36;2021-07-28;1549;1374;0;137324;117461;0;63.2;54.1;0.0
36;2021-07-29;1780;1226;0;139104;118687;0;64.1;54.7;0.0
36;2021-07-30;1581;1293;0;140685;119980;0;64.8;55.3;0.0
36;2021-07-31;1009;572;0;141694;120552;0;65.3;55.5;0.0
36;2021-08-01;224;241;0;141918;120793;0;65.4;55.6;0.0
36;2021-08-02;1149;900;0;143067;121693;0;65.9;56.0;0.0
36;2021-08-03;1355;961;0;144422;122654;0;66.5;56.5;0.0
36;2021-08-04;1719;929;0;146141;123583;0;67.3;56.9;0.0
36;2021-08-05;1695;879;0;147836;124462;0;68.1;57.3;0.0
36;2021-08-06;1351;862;0;149187;125324;0;68.7;57.7;0.0
36;2021-08-07;567;553;0;149754;125877;0;69.0;58.0;0.0
36;2021-08-08;289;156;0;150043;126033;0;69.1;58.0;0.0
36;2021-08-09;843;829;0;150886;126862;0;69.5;58.4;0.0
36;2021-08-10;994;1014;0;151880;127876;0;69.9;58.9;0.0
36;2021-08-11;1291;894;0;153171;128770;0;70.5;59.3;0.0
36;2021-08-12;1093;941;0;154264;129711;0;71.0;59.7;0.0
36;2021-08-13;1126;803;0;155390;130514;0;71.6;60.1;0.0
36;2021-08-14;448;810;0;155838;131324;0;71.8;60.5;0.0
36;2021-08-15;343;97;0;156181;131421;0;71.9;60.5;0.0
36;2021-08-16;608;1023;0;156789;132444;0;72.2;61.0;0.0
36;2021-08-17;733;1152;0;157522;133596;0;72.5;61.5;0.0
36;2021-08-18;924;1212;0;158446;134808;0;73.0;62.1;0.0
36;2021-08-19;767;1219;0;159213;136027;0;73.3;62.6;0.0
36;2021-08-20;463;1523;0;159676;137550;0;73.5;63.3;0.0
36;2021-08-21;295;508;0;159971;138058;0;73.7;63.6;0.0
36;2021-08-22;32;73;0;160003;138131;0;73.7;63.6;0.0
36;2021-08-23;502;1272;0;160505;139403;0;73.9;64.2;0.0
36;2021-08-24;542;1259;0;161047;140662;0;74.2;64.8;0.0
36;2021-08-25;458;1148;0;161505;141810;0;74.4;65.3;0.0
36;2021-08-26;587;1507;0;162092;143317;0;74.6;66.0;0.0
36;2021-08-27;512;1430;0;162604;144747;0;74.9;66.7;0.0
36;2021-08-28;348;649;0;162952;145396;0;75.0;67.0;0.0
36;2021-08-29;209;254;0;163161;145650;0;75.1;67.1;0.0
36;2021-08-30;234;810;23;163395;146460;23;75.2;67.4;0.0
36;2021-08-31;362;889;88;163757;147349;111;75.4;67.9;0.1
36;2021-09-01;398;1015;151;164155;148364;262;75.6;68.3;0.1
36;2021-09-02;319;913;141;164474;149277;403;75.7;68.7;0.2
36;2021-09-03;301;1344;134;164775;150621;537;75.9;69.4;0.2
36;2021-09-04;234;801;84;165009;151422;621;76.0;69.7;0.3
36;2021-09-05;120;312;57;165129;151734;678;76.0;69.9;0.3
36;2021-09-06;169;837;179;165298;152571;857;76.1;70.3;0.4
36;2021-09-07;177;692;160;165475;153263;1017;76.2;70.6;0.5
36;2021-09-08;230;1010;177;165705;154273;1194;76.3;71.0;0.5
36;2021-09-09;266;792;185;165971;155065;1379;76.4;71.4;0.6
36;2021-09-10;284;955;180;166255;156020;1559;76.6;71.9;0.7
36;2021-09-11;143;742;41;166398;156762;1600;76.6;72.2;0.7
36;2021-09-12;81;187;45;166479;156949;1645;76.7;72.3;0.8
36;2021-09-13;178;522;169;166657;157471;1814;76.8;72.5;0.8
36;2021-09-14;169;432;385;166826;157903;2199;76.8;72.7;1.0
36;2021-09-15;286;536;352;167112;158439;2551;77.0;73.0;1.2
36;2021-09-16;236;620;269;167348;159059;2820;77.1;73.3;1.3
36;2021-09-17;261;558;150;167609;159617;2970;77.2;73.5;1.4
36;2021-09-18;117;409;90;167726;160026;3060;77.2;73.7;1.4
36;2021-09-19;35;197;22;167761;160223;3082;77.3;73.8;1.4
36;2021-09-20;130;294;273;167891;160517;3355;77.3;73.9;1.5
36;2021-09-21;133;307;238;168024;160824;3593;77.4;74.1;1.7
36;2021-09-22;112;602;296;168136;161426;3889;77.4;74.3;1.8
36;2021-09-23;129;412;364;168265;161838;4253;77.5;74.5;2.0
36;2021-09-24;118;470;319;168383;162308;4572;77.5;74.7;2.1
36;2021-09-25;112;491;129;168495;162799;4701;77.6;75.0;2.2
36;2021-09-26;19;305;55;168514;163104;4756;77.6;75.1;2.2
36;2021-09-27;63;231;192;168577;163335;4948;77.6;75.2;2.3
36;2021-09-28;69;216;221;168646;163551;5169;77.7;75.3;2.4
36;2021-09-29;97;364;287;168743;163915;5456;77.7;75.5;2.5
36;2021-09-30;98;241;371;168841;164156;5827;77.8;75.6;2.7
36;2021-10-01;170;296;282;169011;164452;6109;77.8;75.7;2.8
36;2021-10-02;50;188;133;169061;164640;6242;77.9;75.8;2.9
36;2021-10-03;4;21;8;169065;164661;6250;77.9;75.8;2.9
36;2021-10-04;59;203;356;169124;164864;6606;77.9;75.9;3.0
36;2021-10-05;116;149;327;169240;165013;6933;77.9;76.0;3.2
36;2021-10-06;109;291;294;169349;165304;7227;78.0;76.1;3.3
36;2021-10-07;84;189;268;169433;165493;7495;78.0;76.2;3.5
36;2021-10-08;129;277;483;169562;165770;7978;78.1;76.3;3.7
36;2021-10-09;86;203;188;169648;165973;8166;78.1;76.4;3.8
36;2021-10-10;5;12;17;169653;165985;8183;78.1;76.4;3.8
36;2021-10-11;80;133;251;169733;166118;8434;78.2;76.5;3.9
36;2021-10-12;64;94;341;169797;166212;8775;78.2;76.5;4.0
36;2021-10-13;130;248;512;169927;166460;9287;78.3;76.7;4.3
36;2021-10-14;55;73;360;169982;166533;9647;78.3;76.7;4.4
36;2021-10-15;104;230;431;170086;166763;10078;78.3;76.8;4.6
36;2021-10-16;90;148;182;170176;166911;10260;78.4;76.9;4.7
36;2021-10-17;4;7;13;170180;166918;10273;78.4;76.9;4.7
36;2021-10-18;38;114;193;170218;167032;10466;78.4;76.9;4.8
36;2021-10-19;20;54;139;170238;167086;10605;78.4;76.9;4.9
36;2021-10-20;121;178;512;170359;167264;11117;78.5;77.0;5.1
36;2021-10-21;44;194;304;170403;167458;11421;78.5;77.1;5.3
36;2021-10-22;99;205;414;170502;167663;11835;78.5;77.2;5.5
36;2021-10-23;39;52;198;170541;167715;12033;78.5;77.2;5.5
36;2021-10-24;50;53;60;170591;167768;12093;78.6;77.3;5.6
36;2021-10-25;64;64;312;170655;167832;12405;78.6;77.3;5.7
36;2021-10-26;42;48;244;170697;167880;12649;78.6;77.3;5.8
36;2021-10-27;99;125;475;170796;168005;13124;78.7;77.4;6.0
36;2021-10-28;49;79;457;170845;168084;13581;78.7;77.4;6.3
36;2021-10-29;60;89;237;170905;168173;13818;78.7;77.4;6.4
36;2021-10-30;60;140;321;170965;168313;14139;78.7;77.5;6.5
36;2021-10-31;7;6;4;170972;168319;14143;78.7;77.5;6.5
36;2021-11-01;0;2;2;170972;168321;14145;78.7;77.5;6.5
36;2021-11-02;46;99;312;171018;168420;14457;78.8;77.6;6.7
36;2021-11-03;44;64;335;171062;168484;14792;78.8;77.6;6.8
36;2021-11-04;79;100;587;171141;168584;15379;78.8;77.6;7.1
36;2021-11-05;65;110;570;171206;168694;15949;78.8;77.7;7.3
36;2021-11-06;79;131;442;171285;168825;16391;78.9;77.7;7.5
36;2021-11-07;0;6;13;171285;168831;16404;78.9;77.8;7.6
36;2021-11-08;32;57;435;171317;168888;16839;78.9;77.8;7.8
36;2021-11-09;37;55;441;171354;168943;17280;78.9;77.8;8.0
36;2021-11-10;83;103;634;171437;169046;17914;79.0;77.9;8.3
36;2021-11-11;0;3;26;171437;169049;17940;79.0;77.9;8.3
36;2021-11-12;34;76;456;171471;169125;18396;79.0;77.9;8.5
36;2021-11-13;58;88;488;171529;169213;18884;79.0;77.9;8.7
36;2021-11-14;2;9;26;171531;169222;18910;79.0;77.9;8.7
36;2021-11-15;32;68;598;171563;169290;19508;79.0;78.0;9.0
36;2021-11-16;58;84;802;171621;169374;20310;79.0;78.0;9.4
36;2021-11-17;90;78;782;171711;169452;21092;79.1;78.0;9.7
36;2021-11-18;36;61;568;171747;169513;21660;79.1;78.1;10.0
36;2021-11-19;67;89;972;171814;169602;22632;79.1;78.1;10.4
36;2021-11-20;28;40;372;171842;169642;23004;79.1;78.1;10.6
36;2021-11-21;35;28;213;171877;169670;23217;79.2;78.1;10.7
36;2021-11-22;28;33;529;171905;169703;23746;79.2;78.2;10.9
36;2021-11-23;44;46;822;171949;169749;24568;79.2;78.2;11.3
36;2021-11-24;93;77;1114;172042;169826;25682;79.2;78.2;11.8
36;2021-11-25;65;43;1066;172107;169869;26748;79.3;78.2;12.3
36;2021-11-26;76;80;1479;172183;169949;28227;79.3;78.3;13.0
36;2021-11-27;56;119;691;172239;170068;28918;79.3;78.3;13.3
36;2021-11-28;2;5;52;172241;170073;28970;79.3;78.3;13.3
36;2021-11-29;39;54;1024;172280;170127;29994;79.3;78.3;13.8
36;2021-11-30;54;43;1288;172334;170170;31282;79.4;78.4;14.4
36;2021-12-01;69;49;1612;172403;170219;32894;79.4;78.4;15.1
36;2021-12-02;92;41;2087;172495;170260;34981;79.4;78.4;16.1
36;2021-12-03;55;102;2141;172550;170362;37122;79.5;78.5;17.1
36;2021-12-04;45;31;898;172595;170393;38020;79.5;78.5;17.5
36;2021-12-05;18;27;322;172613;170420;38342;79.5;78.5;17.7
36;2021-12-06;34;33;1262;172647;170453;39604;79.5;78.5;18.2
36;2021-12-07;72;48;2097;172719;170501;41701;79.5;78.5;19.2
36;2021-12-08;62;68;2157;172781;170569;43858;79.6;78.6;20.2
36;2021-12-09;65;53;2860;172846;170622;46718;79.6;78.6;21.5
36;2021-12-10;89;72;2848;172935;170694;49566;79.6;78.6;22.8
36;2021-12-11;33;48;1037;172968;170742;50603;79.7;78.6;23.3
36;2021-12-12;6;6;435;172974;170748;51038;79.7;78.6;23.5
36;2021-12-13;26;84;1550;173000;170832;52588;79.7;78.7;24.2
36;2021-12-14;52;54;2590;173052;170886;55178;79.7;78.7;25.4
36;2021-12-15;66;83;2858;173118;170969;58036;79.7;78.7;26.7
36;2021-12-16;95;84;3149;173213;171053;61185;79.8;78.8;28.2
37;2020-12-27;0;0;0;0;0;0;0.0;0.0;0.0
37;2020-12-28;16;0;0;16;0;0;0.0;0.0;0.0
37;2020-12-29;9;0;0;25;0;0;0.0;0.0;0.0
37;2020-12-30;0;0;0;25;0;0;0.0;0.0;0.0
37;2020-12-31;0;0;0;25;0;0;0.0;0.0;0.0
37;2021-01-01;0;0;0;25;0;0;0.0;0.0;0.0
37;2021-01-02;0;0;0;25;0;0;0.0;0.0;0.0
37;2021-01-03;0;0;0;25;0;0;0.0;0.0;0.0
37;2021-01-04;23;0;0;48;0;0;0.0;0.0;0.0
37;2021-01-05;44;0;0;92;0;0;0.0;0.0;0.0
37;2021-01-06;89;0;0;181;0;0;0.0;0.0;0.0
37;2021-01-07;128;1;0;309;1;0;0.1;0.0;0.0
37;2021-01-08;456;2;0;765;3;0;0.1;0.0;0.0
37;2021-01-09;80;2;0;845;5;0;0.1;0.0;0.0
37;2021-01-10;83;0;0;928;5;0;0.2;0.0;0.0
37;2021-01-11;290;0;0;1218;5;0;0.2;0.0;0.0
37;2021-01-12;660;6;0;1878;11;0;0.3;0.0;0.0
37;2021-01-13;539;1;0;2417;12;0;0.4;0.0;0.0
37;2021-01-14;534;3;0;2951;15;0;0.5;0.0;0.0
37;2021-01-15;636;2;0;3587;17;0;0.6;0.0;0.0
37;2021-01-16;291;2;0;3878;19;0;0.6;0.0;0.0
37;2021-01-17;245;1;0;4123;20;0;0.7;0.0;0.0
37;2021-01-18;752;11;0;4875;31;0;0.8;0.0;0.0
37;2021-01-19;1238;11;0;6113;42;0;1.0;0.0;0.0
37;2021-01-20;1051;5;0;7164;47;0;1.2;0.0;0.0
37;2021-01-21;902;0;0;8066;47;0;1.3;0.0;0.0
37;2021-01-22;788;1;0;8854;48;0;1.5;0.0;0.0
37;2021-01-23;178;0;0;9032;48;0;1.5;0.0;0.0
37;2021-01-24;14;0;0;9046;48;0;1.5;0.0;0.0
37;2021-01-25;560;19;0;9606;67;0;1.6;0.0;0.0
37;2021-01-26;1753;69;0;11359;136;0;1.9;0.0;0.0
37;2021-01-27;1439;77;0;12798;213;0;2.1;0.0;0.0
37;2021-01-28;1500;99;0;14298;312;0;2.4;0.1;0.0
37;2021-01-29;658;306;0;14956;618;0;2.5;0.1;0.0
37;2021-01-30;240;60;0;15196;678;0;2.5;0.1;0.0
37;2021-01-31;14;64;0;15210;742;0;2.5;0.1;0.0
37;2021-02-01;363;211;0;15573;953;0;2.6;0.2;0.0
37;2021-02-02;500;514;0;16073;1467;0;2.7;0.2;0.0
37;2021-02-03;655;359;0;16728;1826;0;2.8;0.3;0.0
37;2021-02-04;594;407;0;17322;2233;0;2.9;0.4;0.0
37;2021-02-05;466;462;0;17788;2695;0;2.9;0.4;0.0
37;2021-02-06;198;6;0;17986;2701;0;3.0;0.4;0.0
37;2021-02-07;24;1;0;18010;2702;0;3.0;0.4;0.0
37;2021-02-08;341;354;0;18351;3056;0;3.0;0.5;0.0
37;2021-02-09;610;728;0;18961;3784;0;3.1;0.6;0.0
37;2021-02-10;659;533;0;19620;4317;0;3.2;0.7;0.0
37;2021-02-11;654;598;0;20274;4915;0;3.3;0.8;0.0
37;2021-02-12;547;579;0;20821;5494;0;3.4;0.9;0.0
37;2021-02-13;152;200;0;20973;5694;0;3.5;0.9;0.0
37;2021-02-14;3;57;0;20976;5751;0;3.5;0.9;0.0
37;2021-02-15;415;495;0;21391;6246;0;3.5;1.0;0.0
37;2021-02-16;826;1390;0;22217;7636;0;3.7;1.3;0.0
37;2021-02-17;626;1311;0;22843;8947;0;3.8;1.5;0.0
37;2021-02-18;895;1384;0;23738;10331;0;3.9;1.7;0.0
37;2021-02-19;804;809;0;24542;11140;0;4.1;1.8;0.0
37;2021-02-20;234;216;0;24776;11356;0;4.1;1.9;0.0
37;2021-02-21;6;13;0;24782;11369;0;4.1;1.9;0.0
37;2021-02-22;329;613;0;25111;11982;0;4.1;2.0;0.0
37;2021-02-23;605;630;0;25716;12612;0;4.2;2.1;0.0
37;2021-02-24;551;644;0;26267;13256;0;4.3;2.2;0.0
37;2021-02-25;857;653;0;27124;13909;0;4.5;2.3;0.0
37;2021-02-26;1082;571;0;28206;14480;0;4.7;2.4;0.0
37;2021-02-27;569;196;0;28775;14676;0;4.8;2.4;0.0
37;2021-02-28;24;5;0;28799;14681;0;4.8;2.4;0.0
37;2021-03-01;601;378;0;29400;15059;0;4.9;2.5;0.0
37;2021-03-02;1083;558;0;30483;15617;0;5.0;2.6;0.0
37;2021-03-03;1002;575;0;31485;16192;0;5.2;2.7;0.0
37;2021-03-04;1574;529;0;33059;16721;0;5.5;2.8;0.0
37;2021-03-05;2149;590;0;35208;17311;0;5.8;2.9;0.0
37;2021-03-06;1204;223;0;36412;17534;0;6.0;2.9;0.0
37;2021-03-07;494;76;0;36906;17610;0;6.1;2.9;0.0
37;2021-03-08;679;419;0;37585;18029;0;6.2;3.0;0.0
37;2021-03-09;1623;702;0;39208;18731;0;6.5;3.1;0.0
37;2021-03-10;1606;754;0;40814;19485;0;6.7;3.2;0.0
37;2021-03-11;2096;721;0;42910;20206;0;7.1;3.3;0.0
37;2021-03-12;3239;529;0;46149;20735;0;7.6;3.4;0.0
37;2021-03-13;1945;193;0;48094;20928;0;7.9;3.5;0.0
37;2021-03-14;226;5;0;48320;20933;0;8.0;3.5;0.0
37;2021-03-15;1050;260;0;49370;21193;0;8.2;3.5;0.0
37;2021-03-16;1070;517;0;50440;21710;0;8.3;3.6;0.0
37;2021-03-17;981;284;0;51421;21994;0;8.5;3.6;0.0
37;2021-03-18;1067;522;0;52488;22516;0;8.7;3.7;0.0
37;2021-03-19;2252;340;0;54740;22856;0;9.0;3.8;0.0
37;2021-03-20;1333;143;0;56073;22999;0;9.3;3.8;0.0
37;2021-03-21;195;5;0;56268;23004;0;9.3;3.8;0.0
37;2021-03-22;1295;250;0;57563;23254;0;9.5;3.8;0.0
37;2021-03-23;2285;568;0;59848;23822;0;9.9;3.9;0.0
37;2021-03-24;2287;469;0;62135;24291;0;10.3;4.0;0.0
37;2021-03-25;3085;443;0;65220;24734;0;10.8;4.1;0.0
37;2021-03-26;3573;425;0;68793;25159;0;11.4;4.2;0.0
37;2021-03-27;1206;126;0;69999;25285;0;11.6;4.2;0.0
37;2021-03-28;145;15;0;70144;25300;0;11.6;4.2;0.0
37;2021-03-29;1626;362;0;71770;25662;0;11.9;4.2;0.0
37;2021-03-30;2570;667;0;74340;26329;0;12.3;4.3;0.0
37;2021-03-31;2134;504;0;76474;26833;0;12.6;4.4;0.0
37;2021-04-01;2642;989;0;79116;27822;0;13.1;4.6;0.0
37;2021-04-02;2842;697;0;81958;28519;0;13.5;4.7;0.0
37;2021-04-03;809;244;0;82767;28763;0;13.7;4.8;0.0
37;2021-04-04;107;14;0;82874;28777;0;13.7;4.8;0.0
37;2021-04-05;35;3;0;82909;28780;0;13.7;4.8;0.0
37;2021-04-06;2247;788;0;85156;29568;0;14.1;4.9;0.0
37;2021-04-07;3201;902;0;88357;30470;0;14.6;5.0;0.0
37;2021-04-08;3981;1010;0;92338;31480;0;15.3;5.2;0.0
37;2021-04-09;4522;997;0;96860;32477;0;16.0;5.4;0.0
37;2021-04-10;1341;459;0;98201;32936;0;16.2;5.4;0.0
37;2021-04-11;114;23;0;98315;32959;0;16.2;5.4;0.0
37;2021-04-12;2590;695;0;100905;33654;0;16.7;5.6;0.0
37;2021-04-13;4094;1221;0;104999;34875;0;17.3;5.8;0.0
37;2021-04-14;3076;929;0;108075;35804;0;17.9;5.9;0.0
37;2021-04-15;3776;1030;0;111851;36834;0;18.5;6.1;0.0
37;2021-04-16;4282;1235;0;116133;38069;0;19.2;6.3;0.0
37;2021-04-17;1176;254;0;117309;38323;0;19.4;6.3;0.0
37;2021-04-18;115;12;0;117424;38335;0;19.4;6.3;0.0
37;2021-04-19;2470;880;0;119894;39215;0;19.8;6.5;0.0
37;2021-04-20;3218;1379;0;123112;40594;0;20.3;6.7;0.0
37;2021-04-21;2971;1254;0;126083;41848;0;20.8;6.9;0.0
37;2021-04-22;3553;1519;0;129636;43367;0;21.4;7.2;0.0
37;2021-04-23;3717;1831;0;133353;45198;0;22.0;7.5;0.0
37;2021-04-24;1153;445;0;134506;45643;0;22.2;7.5;0.0
37;2021-04-25;173;11;0;134679;45654;0;22.2;7.5;0.0
37;2021-04-26;2983;1369;0;137662;47023;0;22.7;7.8;0.0
37;2021-04-27;4278;1872;0;141940;48895;0;23.4;8.1;0.0
37;2021-04-28;3625;1950;0;145565;50845;0;24.0;8.4;0.0
37;2021-04-29;4760;2040;0;150325;52885;0;24.8;8.7;0.0
37;2021-04-30;5031;2034;0;155356;54919;0;25.7;9.1;0.0
37;2021-05-01;645;200;0;156001;55119;0;25.8;9.1;0.0
37;2021-05-02;131;29;0;156132;55148;0;25.8;9.1;0.0
37;2021-05-03;2786;1915;0;158918;57063;0;26.3;9.4;0.0
37;2021-05-04;3772;2747;0;162690;59810;0;26.9;9.9;0.0
37;2021-05-05;3639;2115;0;166329;61925;0;27.5;10.2;0.0
37;2021-05-06;5042;2023;0;171371;63948;0;28.3;10.6;0.0
37;2021-05-07;4651;2845;0;176022;66793;0;29.1;11.0;0.0
37;2021-05-08;645;318;0;176667;67111;0;29.2;11.1;0.0
37;2021-05-09;145;67;0;176812;67178;0;29.2;11.1;0.0
37;2021-05-10;2351;3423;0;179163;70601;0;29.6;11.7;0.0
37;2021-05-11;4069;3946;0;183232;74547;0;30.3;12.3;0.0
37;2021-05-12;4326;2658;0;187558;77205;0;31.0;12.8;0.0
37;2021-05-13;1435;534;0;188993;77739;0;31.2;12.8;0.0
37;2021-05-14;4161;2626;0;193154;80365;0;31.9;13.3;0.0
37;2021-05-15;2548;782;0;195702;81147;0;32.3;13.4;0.0
37;2021-05-16;205;113;0;195907;81260;0;32.4;13.4;0.0
37;2021-05-17;3005;2044;0;198912;83304;0;32.9;13.8;0.0
37;2021-05-18;4171;2396;0;203083;85700;0;33.5;14.2;0.0
37;2021-05-19;3886;1872;0;206969;87572;0;34.2;14.5;0.0
37;2021-05-20;5097;1905;0;212066;89477;0;35.0;14.8;0.0
37;2021-05-21;4717;2582;0;216783;92059;0;35.8;15.2;0.0
37;2021-05-22;1375;748;0;218158;92807;0;36.0;15.3;0.0
37;2021-05-23;148;90;0;218306;92897;0;36.1;15.3;0.0
37;2021-05-24;890;121;0;219196;93018;0;36.2;15.4;0.0
37;2021-05-25;5176;2182;0;224372;95200;0;37.1;15.7;0.0
37;2021-05-26;5104;2185;0;229476;97385;0;37.9;16.1;0.0
37;2021-05-27;6092;2419;0;235568;99804;0;38.9;16.5;0.0
37;2021-05-28;6004;3270;0;241572;103074;0;39.9;17.0;0.0
37;2021-05-29;1743;1187;0;243315;104261;0;40.2;17.2;0.0
37;2021-05-30;131;169;0;243446;104430;0;40.2;17.3;0.0
37;2021-05-31;3726;2529;0;247172;106959;0;40.8;17.7;0.0
37;2021-06-01;5852;3542;0;253024;110501;0;41.8;18.3;0.0
37;2021-06-02;5219;2563;0;258243;113064;0;42.7;18.7;0.0
37;2021-06-03;6201;2961;0;264444;116025;0;43.7;19.2;0.0
37;2021-06-04;5634;4213;0;270078;120238;0;44.6;19.9;0.0
37;2021-06-05;2040;1433;0;272118;121671;0;44.9;20.1;0.0
37;2021-06-06;134;292;0;272252;121963;0;45.0;20.1;0.0
37;2021-06-07;3120;4166;0;275372;126129;0;45.5;20.8;0.0
37;2021-06-08;4189;4671;0;279561;130800;0;46.2;21.6;0.0
37;2021-06-09;3945;3773;0;283506;134573;0;46.8;22.2;0.0
37;2021-06-10;5171;3716;0;288677;138289;0;47.7;22.8;0.0
37;2021-06-11;4883;4844;0;293560;143133;0;48.5;23.6;0.0
37;2021-06-12;3542;1369;0;297102;144502;0;49.1;23.9;0.0
37;2021-06-13;83;298;0;297185;144800;0;49.1;23.9;0.0
37;2021-06-14;2625;4129;0;299810;148929;0;49.5;24.6;0.0
37;2021-06-15;3861;4795;0;303671;153724;0;50.2;25.4;0.0
37;2021-06-16;3235;3730;0;306906;157454;0;50.7;26.0;0.0
37;2021-06-17;3904;4557;0;310810;162011;0;51.3;26.8;0.0
37;2021-06-18;4473;5119;0;315283;167130;0;52.1;27.6;0.0
37;2021-06-19;2454;1248;0;317737;168378;0;52.5;27.8;0.0
37;2021-06-20;43;245;0;317780;168623;0;52.5;27.9;0.0
37;2021-06-21;2372;3946;0;320152;172569;0;52.9;28.5;0.0
37;2021-06-22;2876;5188;0;323028;177757;0;53.4;29.4;0.0
37;2021-06-23;2587;3960;0;325615;181717;0;53.8;30.0;0.0
37;2021-06-24;2789;3665;0;328404;185382;0;54.2;30.6;0.0
37;2021-06-25;3210;4951;0;331614;190333;0;54.8;31.4;0.0
37;2021-06-26;1203;3184;0;332817;193517;0;55.0;32.0;0.0
37;2021-06-27;51;236;0;332868;193753;0;55.0;32.0;0.0
37;2021-06-28;1688;4686;0;334556;198439;0;55.3;32.8;0.0
37;2021-06-29;1848;6421;0;336404;204860;0;55.6;33.8;0.0
37;2021-06-30;1877;4753;0;338281;209613;0;55.9;34.6;0.0
37;2021-07-01;2098;4950;0;340379;214563;0;56.2;35.4;0.0
37;2021-07-02;2654;5737;0;343033;220300;0;56.7;36.4;0.0
37;2021-07-03;888;2295;0;343921;222595;0;56.8;36.8;0.0
37;2021-07-04;30;184;0;343951;222779;0;56.8;36.8;0.0
37;2021-07-05;1598;5196;0;345549;227975;0;57.1;37.7;0.0
37;2021-07-06;1887;6759;0;347436;234734;0;57.4;38.8;0.0
37;2021-07-07;1831;5523;0;349267;240257;0;57.7;39.7;0.0
37;2021-07-08;2357;6692;0;351624;246949;0;58.1;40.8;0.0
37;2021-07-09;1986;7582;0;353610;254531;0;58.4;42.0;0.0
37;2021-07-10;1017;2790;0;354627;257321;0;58.6;42.5;0.0
37;2021-07-11;56;168;0;354683;257489;0;58.6;42.5;0.0
37;2021-07-12;1161;6010;0;355844;263499;0;58.8;43.5;0.0
37;2021-07-13;1703;7776;0;357547;271275;0;59.1;44.8;0.0
37;2021-07-14;622;600;0;358169;271875;0;59.2;44.9;0.0
37;2021-07-15;2622;7551;0;360791;279426;0;59.6;46.2;0.0
37;2021-07-16;2741;7699;0;363532;287125;0;60.1;47.4;0.0
37;2021-07-17;1242;2582;0;364774;289707;0;60.3;47.9;0.0
37;2021-07-18;144;147;0;364918;289854;0;60.3;47.9;0.0
37;2021-07-19;1750;6132;0;366668;295986;0;60.6;48.9;0.0
37;2021-07-20;2989;6965;0;369657;302951;0;61.1;50.0;0.0
37;2021-07-21;3088;5637;0;372745;308588;0;61.6;51.0;0.0
37;2021-07-22;4035;6353;0;376780;314941;0;62.2;52.0;0.0
37;2021-07-23;3854;6897;0;380634;321838;0;62.9;53.2;0.0
37;2021-07-24;1806;3179;0;382440;325017;0;63.2;53.7;0.0
37;2021-07-25;146;145;0;382586;325162;0;63.2;53.7;0.0
37;2021-07-26;3302;4296;0;385888;329458;0;63.7;54.4;0.0
37;2021-07-27;4289;4885;0;390177;334343;0;64.5;55.2;0.0
37;2021-07-28;4166;3681;0;394343;338024;0;65.1;55.8;0.0
37;2021-07-29;4991;4211;0;399334;342235;0;66.0;56.5;0.0
37;2021-07-30;5028;4806;0;404362;347041;0;66.8;57.3;0.0
37;2021-07-31;1944;1810;0;406306;348851;0;67.1;57.6;0.0
37;2021-08-01;120;72;0;406426;348923;0;67.1;57.6;0.0
37;2021-08-02;3360;3194;0;409786;352117;0;67.7;58.2;0.0
37;2021-08-03;5032;3068;0;414818;355185;0;68.5;58.7;0.0
37;2021-08-04;4506;1969;0;419324;357154;0;69.3;59.0;0.0
37;2021-08-05;4680;2582;0;424004;359736;0;70.0;59.4;0.0
37;2021-08-06;4606;3230;0;428610;362966;0;70.8;60.0;0.0
37;2021-08-07;1633;1114;0;430243;364080;0;71.1;60.1;0.0
37;2021-08-08;104;201;0;430347;364281;0;71.1;60.2;0.0
37;2021-08-09;2354;2148;0;432701;366429;0;71.5;60.5;0.0
37;2021-08-10;2974;2646;0;435675;369075;0;72.0;61.0;0.0
37;2021-08-11;2073;2199;0;437748;371274;0;72.3;61.3;0.0
37;2021-08-12;2408;2641;0;440156;373915;0;72.7;61.8;0.0
37;2021-08-13;2362;2792;0;442518;376707;0;73.1;62.2;0.0
37;2021-08-14;755;877;0;443273;377584;0;73.2;62.4;0.0
37;2021-08-15;42;101;0;443315;377685;0;73.2;62.4;0.0
37;2021-08-16;1467;3174;0;444782;380859;0;73.5;62.9;0.0
37;2021-08-17;1783;3870;0;446565;384729;0;73.8;63.6;0.0
37;2021-08-18;1414;3172;0;447979;387901;0;74.0;64.1;0.0
37;2021-08-19;1500;3665;0;449479;391566;0;74.2;64.7;0.0
37;2021-08-20;1557;4444;0;451036;396010;0;74.5;65.4;0.0
37;2021-08-21;646;1261;0;451682;397271;0;74.6;65.6;0.0
37;2021-08-22;25;100;0;451707;397371;0;74.6;65.6;0.0
37;2021-08-23;1259;3969;0;452966;401340;0;74.8;66.3;0.0
37;2021-08-24;1529;4724;0;454495;406064;0;75.1;67.1;0.0
37;2021-08-25;1032;4159;0;455527;410223;0;75.2;67.8;0.0
37;2021-08-26;1258;4256;0;456785;414479;0;75.5;68.5;0.0
37;2021-08-27;1388;5381;0;458173;419860;0;75.7;69.4;0.0
37;2021-08-28;413;1473;0;458586;421333;0;75.8;69.6;0.0
37;2021-08-29;11;57;0;458597;421390;0;75.8;69.6;0.0
37;2021-08-30;1042;3738;67;459639;425128;67;75.9;70.2;0.0
37;2021-08-31;1238;3641;123;460877;428769;190;76.1;70.8;0.0
37;2021-09-01;991;2502;194;461868;431271;384;76.3;71.2;0.1
37;2021-09-02;878;2405;286;462746;433676;670;76.4;71.6;0.1
37;2021-09-03;978;3321;390;463724;436997;1060;76.6;72.2;0.2
37;2021-09-04;657;1331;138;464381;438328;1198;76.7;72.4;0.2
37;2021-09-05;7;42;2;464388;438370;1200;76.7;72.4;0.2
37;2021-09-06;376;1135;217;464764;439505;1417;76.8;72.6;0.2
37;2021-09-07;515;1301;232;465279;440806;1649;76.9;72.8;0.3
37;2021-09-08;806;1815;229;466085;442621;1878;77.0;73.1;0.3
37;2021-09-09;543;1298;283;466628;443919;2161;77.1;73.3;0.4
37;2021-09-10;756;1547;310;467384;445466;2471;77.2;73.6;0.4
37;2021-09-11;385;1028;78;467769;446494;2549;77.3;73.8;0.4
37;2021-09-12;16;44;10;467785;446538;2559;77.3;73.8;0.4
37;2021-09-13;435;1080;370;468220;447618;2929;77.3;73.9;0.5
37;2021-09-14;500;1114;494;468720;448732;3423;77.4;74.1;0.6
37;2021-09-15;614;1450;570;469334;450182;3993;77.5;74.4;0.7
37;2021-09-16;360;815;574;469694;450997;4567;77.6;74.5;0.8
37;2021-09-17;594;1426;536;470288;452423;5103;77.7;74.7;0.8
37;2021-09-18;293;869;134;470581;453292;5237;77.7;74.9;0.9
37;2021-09-19;23;55;20;470604;453347;5257;77.7;74.9;0.9
37;2021-09-20;269;667;422;470873;454014;5679;77.8;75.0;0.9
37;2021-09-21;387;1218;914;471260;455232;6593;77.8;75.2;1.1
37;2021-09-22;393;1235;468;471653;456467;7061;77.9;75.4;1.2
37;2021-09-23;407;1009;556;472060;457476;7617;78.0;75.6;1.3
37;2021-09-24;476;1299;545;472536;458775;8162;78.1;75.8;1.3
37;2021-09-25;221;766;103;472757;459541;8265;78.1;75.9;1.4
37;2021-09-26;6;28;2;472763;459569;8267;78.1;75.9;1.4
37;2021-09-27;272;656;385;473035;460225;8652;78.1;76.0;1.4
37;2021-09-28;381;626;467;473416;460851;9119;78.2;76.1;1.5
37;2021-09-29;357;907;568;473773;461758;9687;78.3;76.3;1.6
37;2021-09-30;371;488;690;474144;462246;10377;78.3;76.4;1.7
37;2021-10-01;461;776;636;474605;463022;11013;78.4;76.5;1.8
37;2021-10-02;228;535;190;474833;463557;11203;78.4;76.6;1.9
37;2021-10-03;16;26;1;474849;463583;11204;78.4;76.6;1.9
37;2021-10-04;260;502;418;475109;464085;11622;78.5;76.7;1.9
37;2021-10-05;309;407;660;475418;464492;12282;78.5;76.7;2.0
37;2021-10-06;346;650;567;475764;465142;12849;78.6;76.8;2.1
37;2021-10-07;271;397;666;476035;465539;13515;78.6;76.9;2.2
37;2021-10-08;402;622;690;476437;466161;14205;78.7;77.0;2.3
37;2021-10-09;199;460;182;476636;466621;14387;78.7;77.1;2.4
37;2021-10-10;6;16;2;476642;466637;14389;78.7;77.1;2.4
37;2021-10-11;213;338;480;476855;466975;14869;78.8;77.1;2.5
37;2021-10-12;216;403;675;477071;467378;15544;78.8;77.2;2.6
37;2021-10-13;299;489;601;477370;467867;16145;78.9;77.3;2.7
37;2021-10-14;209;388;722;477579;468255;16867;78.9;77.3;2.8
37;2021-10-15;372;674;902;477951;468929;17769;79.0;77.5;2.9
37;2021-10-16;223;317;183;478174;469246;17952;79.0;77.5;3.0
37;2021-10-17;9;4;1;478183;469250;17953;79.0;77.5;3.0
37;2021-10-18;204;276;492;478387;469526;18445;79.0;77.6;3.0
37;2021-10-19;178;337;851;478565;469863;19296;79.1;77.6;3.2
37;2021-10-20;247;392;897;478812;470255;20193;79.1;77.7;3.3
37;2021-10-21;166;384;840;478978;470639;21033;79.1;77.7;3.5
37;2021-10-22;355;566;1139;479333;471205;22172;79.2;77.8;3.7
37;2021-10-23;127;186;266;479460;471391;22438;79.2;77.9;3.7
37;2021-10-24;7;12;4;479467;471403;22442;79.2;77.9;3.7
37;2021-10-25;180;229;688;479647;471632;23130;79.2;77.9;3.8
37;2021-10-26;163;240;773;479810;471872;23903;79.3;77.9;3.9
37;2021-10-27;221;406;1100;480031;472278;25003;79.3;78.0;4.1
37;2021-10-28;165;195;696;480196;472473;25699;79.3;78.0;4.2
37;2021-10-29;246;392;1171;480442;472865;26870;79.4;78.1;4.4
37;2021-10-30;97;134;282;480539;472999;27152;79.4;78.1;4.5
37;2021-10-31;3;9;1;480542;473008;27153;79.4;78.1;4.5
37;2021-11-01;9;8;10;480551;473016;27163;79.4;78.1;4.5
37;2021-11-02;215;342;1024;480766;473358;28187;79.4;78.2;4.7
37;2021-11-03;194;298;1206;480960;473656;29393;79.4;78.2;4.9
37;2021-11-04;124;199;1113;481084;473855;30506;79.5;78.3;5.0
37;2021-11-05;304;402;1568;481388;474257;32074;79.5;78.3;5.3
37;2021-11-06;120;203;502;481508;474460;32576;79.5;78.4;5.4
37;2021-11-07;0;11;11;481508;474471;32587;79.5;78.4;5.4
37;2021-11-08;140;234;1041;481648;474705;33628;79.6;78.4;5.6
37;2021-11-09;148;274;2418;481796;474979;36046;79.6;78.5;6.0
37;2021-11-10;211;316;1875;482007;475295;37921;79.6;78.5;6.3
37;2021-11-11;13;12;66;482020;475307;37987;79.6;78.5;6.3
37;2021-11-12;222;428;1843;482242;475735;39830;79.7;78.6;6.6
37;2021-11-13;61;124;501;482303;475859;40331;79.7;78.6;6.7
37;2021-11-14;4;11;5;482307;475870;40336;79.7;78.6;6.7
37;2021-11-15;105;205;1749;482412;476075;42085;79.7;78.6;7.0
37;2021-11-16;208;216;2704;482620;476291;44789;79.7;78.7;7.4
37;2021-11-17;239;256;2240;482859;476547;47029;79.8;78.7;7.8
37;2021-11-18;158;179;2092;483017;476726;49121;79.8;78.7;8.1
37;2021-11-19;302;351;3334;483319;477077;52455;79.8;78.8;8.7
37;2021-11-20;152;164;857;483471;477241;53312;79.9;78.8;8.8
37;2021-11-21;0;7;11;483471;477248;53323;79.9;78.8;8.8
37;2021-11-22;142;90;1567;483613;477338;54890;79.9;78.8;9.1
37;2021-11-23;209;186;2726;483822;477524;57616;79.9;78.9;9.5
37;2021-11-24;265;226;2293;484087;477750;59909;80.0;78.9;9.9
37;2021-11-25;137;155;2621;484224;477905;62530;80.0;78.9;10.3
37;2021-11-26;285;346;4636;484509;478251;67166;80.0;79.0;11.1
37;2021-11-27;122;140;1408;484631;478391;68574;80.1;79.0;11.3
37;2021-11-28;3;16;72;484634;478407;68646;80.1;79.0;11.3
37;2021-11-29;83;157;2937;484717;478564;71583;80.1;79.1;11.8
37;2021-11-30;191;157;4721;484908;478721;76304;80.1;79.1;12.6
37;2021-12-01;170;214;4830;485078;478935;81134;80.1;79.1;13.4
37;2021-12-02;106;118;5994;485184;479053;87128;80.1;79.1;14.4
37;2021-12-03;211;237;7406;485395;479290;94534;80.2;79.2;15.6
37;2021-12-04;68;89;3008;485463;479379;97542;80.2;79.2;16.1
37;2021-12-05;7;10;150;485470;479389;97692;80.2;79.2;16.1
37;2021-12-06;109;135;5089;485579;479524;102781;80.2;79.2;17.0
37;2021-12-07;151;209;7011;485730;479733;109792;80.2;79.2;18.1
37;2021-12-08;112;221;5771;485842;479954;115563;80.3;79.3;19.1
37;2021-12-09;144;166;7381;485986;480120;122944;80.3;79.3;20.3
37;2021-12-10;146;323;8449;486132;480443;131393;80.3;79.4;21.7
37;2021-12-11;90;142;4047;486222;480585;135440;80.3;79.4;22.4
37;2021-12-12;13;9;370;486235;480594;135810;80.3;79.4;22.4
37;2021-12-13;99;180;5623;486334;480774;141433;80.3;79.4;23.4
37;2021-12-14;198;251;8931;486532;481025;150364;80.4;79.5;24.8
37;2021-12-15;153;284;7109;486685;481309;157473;80.4;79.5;26.0
37;2021-12-16;185;202;8209;486870;481511;165682;80.4;79.5;27.4
38;2020-12-27;1;0;0;1;0;0;0.0;0.0;0.0
38;2020-12-28;0;0;0;1;0;0;0.0;0.0;0.0
38;2020-12-29;0;0;0;1;0;0;0.0;0.0;0.0
38;2020-12-30;0;0;0;1;0;0;0.0;0.0;0.0
38;2020-12-31;5;0;0;6;0;0;0.0;0.0;0.0
38;2021-01-01;2;0;0;8;0;0;0.0;0.0;0.0
38;2021-01-02;0;0;0;8;0;0;0.0;0.0;0.0
38;2021-01-03;1;1;0;9;1;0;0.0;0.0;0.0
38;2021-01-04;156;0;0;165;1;0;0.0;0.0;0.0
38;2021-01-05;263;1;0;428;2;0;0.0;0.0;0.0
38;2021-01-06;384;0;0;812;2;0;0.1;0.0;0.0
38;2021-01-07;677;1;0;1489;3;0;0.1;0.0;0.0
38;2021-01-08;716;0;0;2205;3;0;0.2;0.0;0.0
38;2021-01-09;39;0;0;2244;3;0;0.2;0.0;0.0
38;2021-01-10;1;0;0;2245;3;0;0.2;0.0;0.0
38;2021-01-11;849;3;0;3094;6;0;0.2;0.0;0.0
38;2021-01-12;1498;4;0;4592;10;0;0.4;0.0;0.0
38;2021-01-13;1154;8;0;5746;18;0;0.5;0.0;0.0
38;2021-01-14;1723;16;0;7469;34;0;0.6;0.0;0.0
38;2021-01-15;1687;8;0;9156;42;0;0.7;0.0;0.0
38;2021-01-16;319;2;0;9475;44;0;0.7;0.0;0.0
38;2021-01-17;10;0;0;9485;44;0;0.7;0.0;0.0
38;2021-01-18;1227;7;0;10712;51;0;0.8;0.0;0.0
38;2021-01-19;2310;9;0;13022;60;0;1.0;0.0;0.0
38;2021-01-20;2044;5;0;15066;65;0;1.2;0.0;0.0
38;2021-01-21;1776;15;0;16842;80;0;1.3;0.0;0.0
38;2021-01-22;1492;9;0;18334;89;0;1.4;0.0;0.0
38;2021-01-23;487;4;0;18821;93;0;1.5;0.0;0.0
38;2021-01-24;11;0;0;18832;93;0;1.5;0.0;0.0
38;2021-01-25;906;102;0;19738;195;0;1.6;0.0;0.0
38;2021-01-26;993;181;0;20731;376;0;1.6;0.0;0.0
38;2021-01-27;1255;277;0;21986;653;0;1.7;0.1;0.0
38;2021-01-28;1388;484;0;23374;1137;0;1.8;0.1;0.0
38;2021-01-29;1070;380;0;24444;1517;0;1.9;0.1;0.0
38;2021-01-30;383;1;0;24827;1518;0;2.0;0.1;0.0
38;2021-01-31;12;0;0;24839;1518;0;2.0;0.1;0.0
38;2021-02-01;775;592;0;25614;2110;0;2.0;0.2;0.0
38;2021-02-02;1101;959;0;26715;3069;0;2.1;0.2;0.0
38;2021-02-03;1276;724;0;27991;3793;0;2.2;0.3;0.0
38;2021-02-04;1378;999;0;29369;4792;0;2.3;0.4;0.0
38;2021-02-05;1453;866;0;30822;5658;0;2.4;0.4;0.0
38;2021-02-06;251;97;0;31073;5755;0;2.5;0.5;0.0
38;2021-02-07;6;50;0;31079;5805;0;2.5;0.5;0.0
38;2021-02-08;917;884;0;31996;6689;0;2.5;0.5;0.0
38;2021-02-09;1653;1393;0;33649;8082;0;2.7;0.6;0.0
38;2021-02-10;1681;1361;0;35330;9443;0;2.8;0.7;0.0
38;2021-02-11;1905;1243;0;37235;10686;0;2.9;0.8;0.0
38;2021-02-12;1591;1185;0;38826;11871;0;3.1;0.9;0.0
38;2021-02-13;503;221;0;39329;12092;0;3.1;1.0;0.0
38;2021-02-14;7;12;0;39336;12104;0;3.1;1.0;0.0
38;2021-02-15;1021;990;0;40357;13094;0;3.2;1.0;0.0
38;2021-02-16;1385;1072;0;41742;14166;0;3.3;1.1;0.0
38;2021-02-17;1373;1202;0;43115;15368;0;3.4;1.2;0.0
38;2021-02-18;1777;1218;0;44892;16586;0;3.5;1.3;0.0
38;2021-02-19;1272;976;0;46164;17562;0;3.6;1.4;0.0
38;2021-02-20;485;383;0;46649;17945;0;3.7;1.4;0.0
38;2021-02-21;3;8;0;46652;17953;0;3.7;1.4;0.0
38;2021-02-22;1104;994;0;47756;18947;0;3.8;1.5;0.0
38;2021-02-23;1550;1086;0;49306;20033;0;3.9;1.6;0.0
38;2021-02-24;1718;1261;0;51024;21294;0;4.0;1.7;0.0
38;2021-02-25;2572;1201;0;53596;22495;0;4.2;1.8;0.0
38;2021-02-26;3392;1105;0;56988;23600;0;4.5;1.9;0.0
38;2021-02-27;1532;507;0;58520;24107;0;4.6;1.9;0.0
38;2021-02-28;28;15;0;58548;24122;0;4.6;1.9;0.0
38;2021-03-01;2472;873;0;61020;24995;0;4.8;2.0;0.0
38;2021-03-02;4030;1200;0;65050;26195;0;5.1;2.1;0.0
38;2021-03-03;3374;1358;0;68424;27553;0;5.4;2.2;0.0
38;2021-03-04;4530;1460;0;72954;29013;0;5.8;2.3;0.0
38;2021-03-05;5300;1316;0;78254;30329;0;6.2;2.4;0.0
38;2021-03-06;3176;297;0;81430;30626;0;6.4;2.4;0.0
38;2021-03-07;309;34;0;81739;30660;0;6.5;2.4;0.0
38;2021-03-08;2465;934;0;84204;31594;0;6.7;2.5;0.0
38;2021-03-09;4061;1361;0;88265;32955;0;7.0;2.6;0.0
38;2021-03-10;3602;1153;0;91867;34108;0;7.3;2.7;0.0
38;2021-03-11;5199;1634;0;97066;35742;0;7.7;2.8;0.0
38;2021-03-12;7278;1262;0;104344;37004;0;8.2;2.9;0.0
38;2021-03-13;3906;265;0;108250;37269;0;8.6;2.9;0.0
38;2021-03-14;615;22;0;108865;37291;0;8.6;2.9;0.0
38;2021-03-15;2782;1034;0;111647;38325;0;8.8;3.0;0.0
38;2021-03-16;2207;1382;0;113854;39707;0;9.0;3.1;0.0
38;2021-03-17;2128;1210;0;115982;40917;0;9.2;3.2;0.0
38;2021-03-18;2900;1403;0;118882;42320;0;9.4;3.3;0.0
38;2021-03-19;4270;1146;0;123152;43466;0;9.7;3.4;0.0
38;2021-03-20;1987;259;0;125139;43725;0;9.9;3.5;0.0
38;2021-03-21;248;21;0;125387;43746;0;9.9;3.5;0.0
38;2021-03-22;3074;995;0;128461;44741;0;10.2;3.5;0.0
38;2021-03-23;5035;1520;0;133496;46261;0;10.6;3.7;0.0
38;2021-03-24;3963;1586;0;137459;47847;0;10.9;3.8;0.0
38;2021-03-25;6153;1571;0;143612;49418;0;11.4;3.9;0.0
38;2021-03-26;6874;1763;0;150486;51181;0;11.9;4.0;0.0
38;2021-03-27;2660;776;0;153146;51957;0;12.1;4.1;0.0
38;2021-03-28;1025;46;0;154171;52003;0;12.2;4.1;0.0
38;2021-03-29;2907;1855;0;157078;53858;0;12.4;4.3;0.0
38;2021-03-30;4856;2576;0;161934;56434;0;12.8;4.5;0.0
38;2021-03-31;3972;2286;0;165906;58720;0;13.1;4.6;0.0
38;2021-04-01;5490;2601;0;171396;61321;0;13.5;4.8;0.0
38;2021-04-02;4265;2575;0;175661;63896;0;13.9;5.1;0.0
38;2021-04-03;1722;1086;0;177383;64982;0;14.0;5.1;0.0
38;2021-04-04;818;105;0;178201;65087;0;14.1;5.1;0.0
38;2021-04-05;2529;377;0;180730;65464;0;14.3;5.2;0.0
38;2021-04-06;4584;2472;0;185314;67936;0;14.6;5.4;0.0
38;2021-04-07;4619;2867;0;189933;70803;0;15.0;5.6;0.0
38;2021-04-08;5892;2784;0;195825;73587;0;15.5;5.8;0.0
38;2021-04-09;8650;2763;0;204475;76350;0;16.2;6.0;0.0
38;2021-04-10;3631;1608;0;208106;77958;0;16.5;6.2;0.0
38;2021-04-11;1128;198;0;209234;78156;0;16.5;6.2;0.0
38;2021-04-12;4333;2362;0;213567;80518;0;16.9;6.4;0.0
38;2021-04-13;6324;2616;0;219891;83134;0;17.4;6.6;0.0
38;2021-04-14;5354;2640;0;225245;85774;0;17.8;6.8;0.0
38;2021-04-15;6640;3075;0;231885;88849;0;18.3;7.0;0.0
38;2021-04-16;6386;2950;0;238271;91799;0;18.8;7.3;0.0
38;2021-04-17;2855;1131;0;241126;92930;0;19.1;7.3;0.0
38;2021-04-18;1437;159;0;242563;93089;0;19.2;7.4;0.0
38;2021-04-19;4324;3029;0;246887;96118;0;19.5;7.6;0.0
38;2021-04-20;5542;3156;0;252429;99274;0;20.0;7.8;0.0
38;2021-04-21;5136;3009;0;257565;102283;0;20.4;8.1;0.0
38;2021-04-22;5898;3085;0;263463;105368;0;20.8;8.3;0.0
38;2021-04-23;6264;3102;0;269727;108470;0;21.3;8.6;0.0
38;2021-04-24;2992;1500;0;272719;109970;0;21.6;8.7;0.0
38;2021-04-25;889;674;0;273608;110644;0;21.6;8.7;0.0
38;2021-04-26;4552;2677;0;278160;113321;0;22.0;9.0;0.0
38;2021-04-27;6068;3021;0;284228;116342;0;22.5;9.2;0.0
38;2021-04-28;6197;2800;0;290425;119142;0;23.0;9.4;0.0
38;2021-04-29;8238;3373;0;298663;122515;0;23.6;9.7;0.0
38;2021-04-30;7597;4241;0;306260;126756;0;24.2;10.0;0.0
38;2021-05-01;1981;276;0;308241;127032;0;24.4;10.0;0.0
38;2021-05-02;966;485;0;309207;127517;0;24.4;10.1;0.0
38;2021-05-03;5327;3997;0;314534;131514;0;24.9;10.4;0.0
38;2021-05-04;6304;5527;0;320838;137041;0;25.4;10.8;0.0
38;2021-05-05;6518;4790;0;327356;141831;0;25.9;11.2;0.0
38;2021-05-06;7281;5500;0;334637;147331;0;26.5;11.6;0.0
38;2021-05-07;7751;6591;0;342388;153922;0;27.1;12.2;0.0
38;2021-05-08;3911;837;0;346299;154759;0;27.4;12.2;0.0
38;2021-05-09;3270;2038;0;349569;156797;0;27.6;12.4;0.0
38;2021-05-10;6220;5495;0;355789;162292;0;28.1;12.8;0.0
38;2021-05-11;8533;6231;0;364322;168523;0;28.8;13.3;0.0
38;2021-05-12;9726;4931;0;374048;173454;0;29.6;13.7;0.0
38;2021-05-13;7589;1569;0;381637;175023;0;30.2;13.8;0.0
38;2021-05-14;10263;3653;0;391900;178676;0;31.0;14.1;0.0
38;2021-05-15;7409;1583;0;399309;180259;0;31.6;14.2;0.0
38;2021-05-16;6080;706;0;405389;180965;0;32.0;14.3;0.0
38;2021-05-17;8045;3230;0;413434;184195;0;32.7;14.6;0.0
38;2021-05-18;9358;4211;0;422792;188406;0;33.4;14.9;0.0
38;2021-05-19;8851;3576;0;431643;191982;0;34.1;15.2;0.0
38;2021-05-20;9451;4676;0;441094;196658;0;34.9;15.5;0.0
38;2021-05-21;10139;4734;0;451233;201392;0;35.7;15.9;0.0
38;2021-05-22;7497;1984;0;458730;203376;0;36.3;16.1;0.0
38;2021-05-23;5217;619;0;463947;203995;0;36.7;16.1;0.0
38;2021-05-24;7647;1671;0;471594;205666;0;37.3;16.3;0.0
38;2021-05-25;9393;5003;0;480987;210669;0;38.0;16.7;0.0
38;2021-05-26;8186;4996;0;489173;215665;0;38.7;17.0;0.0
38;2021-05-27;9349;5790;0;498522;221455;0;39.4;17.5;0.0
38;2021-05-28;9021;6728;0;507543;228183;0;40.1;18.0;0.0
38;2021-05-29;6011;3633;0;513554;231816;0;40.6;18.3;0.0
38;2021-05-30;2751;1743;0;516305;233559;0;40.8;18.5;0.0
38;2021-05-31;8074;5362;0;524379;238921;0;41.5;18.9;0.0
38;2021-06-01;7879;6557;0;532258;245478;0;42.1;19.4;0.0
38;2021-06-02;7316;5916;0;539574;251394;0;42.7;19.9;0.0
38;2021-06-03;7804;6971;0;547378;258365;0;43.3;20.4;0.0
38;2021-06-04;8374;7679;0;555752;266044;0;43.9;21.0;0.0
38;2021-06-05;6122;4168;0;561874;270212;0;44.4;21.4;0.0
38;2021-06-06;2760;1513;0;564634;271725;0;44.6;21.5;0.0
38;2021-06-07;5872;6983;0;570506;278708;0;45.1;22.0;0.0
38;2021-06-08;6339;7624;0;576845;286332;0;45.6;22.6;0.0
38;2021-06-09;5477;6555;0;582322;292887;0;46.0;23.2;0.0
38;2021-06-10;5836;6861;0;588158;299748;0;46.5;23.7;0.0
38;2021-06-11;6294;7927;0;594452;307675;0;47.0;24.3;0.0
38;2021-06-12;4292;3425;0;598744;311100;0;47.3;24.6;0.0
38;2021-06-13;1260;1359;0;600004;312459;0;47.4;24.7;0.0
38;2021-06-14;3893;7869;0;603897;320328;0;47.7;25.3;0.0
38;2021-06-15;5352;8413;0;609249;328741;0;48.2;26.0;0.0
38;2021-06-16;5298;7869;0;614547;336610;0;48.6;26.6;0.0
38;2021-06-17;4755;7566;0;619302;344176;0;49.0;27.2;0.0
38;2021-06-18;6198;9801;0;625500;353977;0;49.4;28.0;0.0
38;2021-06-19;3775;5644;0;629275;359621;0;49.7;28.4;0.0
38;2021-06-20;1193;2973;0;630468;362594;0;49.8;28.7;0.0
38;2021-06-21;3816;9029;0;634284;371623;0;50.1;29.4;0.0
38;2021-06-22;3738;10686;0;638022;382309;0;50.4;30.2;0.0
38;2021-06-23;3309;10181;0;641331;392490;0;50.7;31.0;0.0
38;2021-06-24;3551;9342;0;644882;401832;0;51.0;31.8;0.0
38;2021-06-25;3938;12014;0;648820;413846;0;51.3;32.7;0.0
38;2021-06-26;2284;8327;0;651104;422173;0;51.5;33.4;0.0
38;2021-06-27;1177;4715;0;652281;426888;0;51.6;33.7;0.0
38;2021-06-28;2707;10766;0;654988;437654;0;51.8;34.6;0.0
38;2021-06-29;3562;11130;0;658550;448784;0;52.1;35.5;0.0
38;2021-06-30;3888;10512;0;662438;459296;0;52.4;36.3;0.0
38;2021-07-01;3835;9267;0;666273;468563;0;52.7;37.0;0.0
38;2021-07-02;3950;11901;0;670223;480464;0;53.0;38.0;0.0
38;2021-07-03;2014;8766;0;672237;489230;0;53.1;38.7;0.0
38;2021-07-04;1321;3362;0;673558;492592;0;53.2;38.9;0.0
38;2021-07-05;3026;10704;0;676584;503296;0;53.5;39.8;0.0
38;2021-07-06;3535;10438;0;680119;513734;0;53.8;40.6;0.0
38;2021-07-07;3780;9666;0;683899;523400;0;54.1;41.4;0.0
38;2021-07-08;3735;8563;0;687634;531963;0;54.4;42.1;0.0
38;2021-07-09;4278;11000;0;691912;542963;0;54.7;42.9;0.0
38;2021-07-10;2558;8111;0;694470;551074;0;54.9;43.6;0.0
38;2021-07-11;1044;2280;0;695514;553354;0;55.0;43.7;0.0
38;2021-07-12;3586;10783;0;699100;564137;0;55.3;44.6;0.0
38;2021-07-13;6721;11274;0;705821;575411;0;55.8;45.5;0.0
38;2021-07-14;4622;3402;0;710443;578813;0;56.2;45.8;0.0
38;2021-07-15;8857;10197;0;719300;589010;0;56.9;46.6;0.0
38;2021-07-16;9154;10989;0;728454;599999;0;57.6;47.4;0.0
38;2021-07-17;5192;7743;0;733646;607742;0;58.0;48.0;0.0
38;2021-07-18;2794;2752;0;736440;610494;0;58.2;48.3;0.0
38;2021-07-19;6317;9425;0;742757;619919;0;58.7;49.0;0.0
38;2021-07-20;6824;8787;0;749581;628706;0;59.3;49.7;0.0
38;2021-07-21;8411;8533;0;757992;637239;0;59.9;50.4;0.0
38;2021-07-22;8233;7437;0;766225;644676;0;60.6;51.0;0.0
38;2021-07-23;9412;9373;0;775637;654049;0;61.3;51.7;0.0
38;2021-07-24;5933;5811;0;781570;659860;0;61.8;52.2;0.0
38;2021-07-25;2806;1892;0;784376;661752;0;62.0;52.3;0.0
38;2021-07-26;8086;7308;0;792462;669060;0;62.6;52.9;0.0
38;2021-07-27;8237;6475;0;800699;675535;0;63.3;53.4;0.0
38;2021-07-28;9141;5927;0;809840;681462;0;64.0;53.9;0.0
38;2021-07-29;8344;5153;0;818184;686615;0;64.7;54.3;0.0
38;2021-07-30;8247;6920;0;826431;693535;0;65.3;54.8;0.0
38;2021-07-31;4969;3885;0;831400;697420;0;65.7;55.1;0.0
38;2021-08-01;1564;1370;0;832964;698790;0;65.8;55.2;0.0
38;2021-08-02;5173;4871;0;838137;703661;0;66.3;55.6;0.0
38;2021-08-03;5473;5087;0;843610;708748;0;66.7;56.0;0.0
38;2021-08-04;5414;4715;0;849024;713463;0;67.1;56.4;0.0
38;2021-08-05;4410;4940;0;853434;718403;0;67.5;56.8;0.0
38;2021-08-06;4611;6370;0;858045;724773;0;67.8;57.3;0.0
38;2021-08-07;2847;3955;0;860892;728728;0;68.1;57.6;0.0
38;2021-08-08;965;2085;0;861857;730813;0;68.1;57.8;0.0
38;2021-08-09;3910;6228;0;865767;737041;0;68.4;58.3;0.0
38;2021-08-10;5006;6529;0;870773;743570;0;68.8;58.8;0.0
38;2021-08-11;4043;5399;0;874816;748969;0;69.2;59.2;0.0
38;2021-08-12;3696;5287;0;878512;754256;0;69.4;59.6;0.0
38;2021-08-13;4228;6440;0;882740;760696;0;69.8;60.1;0.0
38;2021-08-14;2078;4423;0;884818;765119;0;69.9;60.5;0.0
38;2021-08-15;546;1802;0;885364;766921;0;70.0;60.6;0.0
38;2021-08-16;3029;8261;0;888393;775182;0;70.2;61.3;0.0
38;2021-08-17;3431;6428;0;891824;781610;0;70.5;61.8;0.0
38;2021-08-18;3020;7608;0;894844;789218;0;70.7;62.4;0.0
38;2021-08-19;2788;5391;0;897632;794609;0;71.0;62.8;0.0
38;2021-08-20;2997;8536;0;900629;803145;0;71.2;63.5;0.0
38;2021-08-21;1261;5221;0;901890;808366;0;71.3;63.9;0.0
38;2021-08-22;518;1586;0;902408;809952;0;71.3;64.0;0.0
38;2021-08-23;2613;8035;0;905021;817987;0;71.5;64.7;0.0
38;2021-08-24;2767;6048;0;907788;824035;0;71.8;65.1;0.0
38;2021-08-25;2612;6464;0;910400;830499;0;72.0;65.7;0.0
38;2021-08-26;2332;4848;0;912732;835347;0;72.2;66.0;0.0
38;2021-08-27;2627;6580;0;915359;841927;0;72.4;66.6;0.0
38;2021-08-28;1436;4256;0;916795;846183;0;72.5;66.9;0.0
38;2021-08-29;428;1447;0;917223;847630;0;72.5;67.0;0.0
38;2021-08-30;2327;6114;107;919550;853744;107;72.7;67.5;0.0
38;2021-08-31;2340;5041;162;921890;858785;269;72.9;67.9;0.0
38;2021-09-01;2527;4382;361;924417;863167;630;73.1;68.2;0.0
38;2021-09-02;1788;3434;415;926205;866601;1045;73.2;68.5;0.1
38;2021-09-03;2051;4975;510;928256;871576;1555;73.4;68.9;0.1
38;2021-09-04;1242;3197;183;929498;874773;1738;73.5;69.2;0.1
38;2021-09-05;394;786;66;929892;875559;1804;73.5;69.2;0.1
38;2021-09-06;1260;3036;494;931152;878595;2298;73.6;69.5;0.2
38;2021-09-07;1358;2998;605;932510;881593;2903;73.7;69.7;0.2
38;2021-09-08;1803;3381;459;934313;884974;3362;73.9;70.0;0.3
38;2021-09-09;1136;2185;424;935449;887159;3786;73.9;70.1;0.3
38;2021-09-10;1647;3366;692;937096;890525;4478;74.1;70.4;0.4
38;2021-09-11;1099;2433;142;938195;892958;4620;74.2;70.6;0.4
38;2021-09-12;217;555;27;938412;893513;4647;74.2;70.6;0.4
38;2021-09-13;963;2280;751;939375;895793;5398;74.3;70.8;0.4
38;2021-09-14;1004;2126;890;940379;897919;6288;74.3;71.0;0.5
38;2021-09-15;1331;2810;808;941710;900729;7096;74.4;71.2;0.6
38;2021-09-16;764;1687;768;942474;902416;7864;74.5;71.3;0.6
38;2021-09-17;938;2637;793;943412;905053;8657;74.6;71.5;0.7
38;2021-09-18;763;2287;200;944175;907340;8857;74.6;71.7;0.7
38;2021-09-19;116;418;30;944291;907758;8887;74.6;71.8;0.7
38;2021-09-20;609;1741;964;944900;909499;9851;74.7;71.9;0.8
38;2021-09-21;527;1520;1061;945427;911019;10912;74.7;72.0;0.9
38;2021-09-22;729;2713;876;946156;913732;11788;74.8;72.2;0.9
38;2021-09-23;476;1462;980;946632;915194;12768;74.8;72.3;1.0
38;2021-09-24;777;2281;1006;947409;917475;13774;74.9;72.5;1.1
38;2021-09-25;517;1933;205;947926;919408;13979;74.9;72.7;1.1
38;2021-09-26;100;392;22;948026;919800;14001;74.9;72.7;1.1
38;2021-09-27;433;1223;786;948459;921023;14787;75.0;72.8;1.2
38;2021-09-28;535;1204;972;948994;922227;15759;75.0;72.9;1.2
38;2021-09-29;687;1984;1087;949681;924211;16846;75.1;73.1;1.3
38;2021-09-30;459;913;944;950140;925124;17790;75.1;73.1;1.4
38;2021-10-01;872;1556;1047;951012;926680;18837;75.2;73.3;1.5
38;2021-10-02;519;1232;310;951531;927912;19147;75.2;73.4;1.5
38;2021-10-03;83;208;19;951614;928120;19166;75.2;73.4;1.5
38;2021-10-04;581;1011;1234;952195;929131;20400;75.3;73.5;1.6
38;2021-10-05;463;953;1293;952658;930084;21693;75.3;73.5;1.7
38;2021-10-06;660;1363;1217;953318;931447;22910;75.4;73.6;1.8
38;2021-10-07;434;873;1174;953752;932320;24084;75.4;73.7;1.9
38;2021-10-08;743;1364;1554;954495;933684;25638;75.5;73.8;2.0
38;2021-10-09;513;890;365;955008;934574;26003;75.5;73.9;2.1
38;2021-10-10;43;118;61;955051;934692;26064;75.5;73.9;2.1
38;2021-10-11;383;846;1357;955434;935538;27421;75.5;74.0;2.2
38;2021-10-12;495;698;1280;955929;936236;28701;75.6;74.0;2.3
38;2021-10-13;579;1045;1720;956508;937281;30421;75.6;74.1;2.4
38;2021-10-14;409;617;1533;956917;937898;31954;75.6;74.1;2.5
38;2021-10-15;619;1104;1959;957536;939002;33913;75.7;74.2;2.7
38;2021-10-16;447;688;436;957983;939690;34349;75.7;74.3;2.7
38;2021-10-17;12;46;13;957995;939736;34362;75.7;74.3;2.7
38;2021-10-18;408;597;1330;958403;940333;35692;75.8;74.3;2.8
38;2021-10-19;232;520;1605;958635;940853;37297;75.8;74.4;2.9
38;2021-10-20;362;710;1995;958997;941563;39292;75.8;74.4;3.1
38;2021-10-21;188;387;1374;959185;941950;40666;75.8;74.5;3.2
38;2021-10-22;365;773;2233;959550;942723;42899;75.9;74.5;3.4
38;2021-10-23;257;554;599;959807;943277;43498;75.9;74.6;3.4
38;2021-10-24;29;86;64;959836;943363;43562;75.9;74.6;3.4
38;2021-10-25;252;495;1696;960088;943858;45258;75.9;74.6;3.6
38;2021-10-26;213;402;1888;960301;944260;47146;75.9;74.6;3.7
38;2021-10-27;274;624;2046;960575;944884;49192;75.9;74.7;3.9
38;2021-10-28;199;387;1685;960774;945271;50877;76.0;74.7;4.0
38;2021-10-29;278;712;2265;961052;945983;53142;76.0;74.8;4.2
38;2021-10-30;128;444;709;961180;946427;53851;76.0;74.8;4.3
38;2021-10-31;10;27;18;961190;946454;53869;76.0;74.8;4.3
38;2021-11-01;60;46;43;961250;946500;53912;76.0;74.8;4.3
38;2021-11-02;276;567;2041;961526;947067;55953;76.0;74.9;4.4
38;2021-11-03;258;503;2552;961784;947570;58505;76.0;74.9;4.6
38;2021-11-04;232;410;1999;962016;947980;60504;76.0;74.9;4.8
38;2021-11-05;300;569;2760;962316;948549;63264;76.1;75.0;5.0
38;2021-11-06;208;437;1028;962524;948986;64292;76.1;75.0;5.1
38;2021-11-07;6;14;53;962530;949000;64345;76.1;75.0;5.1
38;2021-11-08;172;359;2296;962702;949359;66641;76.1;75.0;5.3
38;2021-11-09;207;419;3436;962909;949778;70077;76.1;75.1;5.5
38;2021-11-10;322;558;4042;963231;950336;74119;76.1;75.1;5.9
38;2021-11-11;15;47;120;963246;950383;74239;76.1;75.1;5.9
38;2021-11-12;292;440;3810;963538;950823;78049;76.2;75.2;6.2
38;2021-11-13;203;254;1193;963741;951077;79242;76.2;75.2;6.3
38;2021-11-14;9;18;78;963750;951095;79320;76.2;75.2;6.3
38;2021-11-15;159;274;3064;963909;951369;82384;76.2;75.2;6.5
38;2021-11-16;175;285;3942;964084;951654;86326;76.2;75.2;6.8
38;2021-11-17;324;396;3940;964408;952050;90266;76.2;75.3;7.1
38;2021-11-18;214;301;3371;964622;952351;93637;76.3;75.3;7.4
38;2021-11-19;259;386;4950;964881;952737;98587;76.3;75.3;7.8
38;2021-11-20;215;307;1495;965096;953044;100082;76.3;75.3;7.9
38;2021-11-21;15;24;183;965111;953068;100265;76.3;75.3;7.9
38;2021-11-22;190;169;3338;965301;953237;103603;76.3;75.4;8.2
38;2021-11-23;229;237;4564;965530;953474;108167;76.3;75.4;8.6
38;2021-11-24;306;424;4667;965836;953898;112834;76.4;75.4;8.9
38;2021-11-25;212;243;5029;966048;954141;117863;76.4;75.4;9.3
38;2021-11-26;277;351;7716;966325;954492;125579;76.4;75.5;9.9
38;2021-11-27;271;273;3864;966596;954765;129443;76.4;75.5;10.2
38;2021-11-28;14;25;310;966610;954790;129753;76.4;75.5;10.3
38;2021-11-29;140;201;6583;966750;954991;136336;76.4;75.5;10.8
38;2021-11-30;194;271;9349;966944;955262;145685;76.4;75.5;11.5
38;2021-12-01;225;380;8869;967169;955642;154554;76.5;75.5;12.2
38;2021-12-02;164;207;9799;967333;955849;164353;76.5;75.6;13.0
38;2021-12-03;209;398;11506;967542;956247;175859;76.5;75.6;13.9
38;2021-12-04;166;257;5955;967708;956504;181814;76.5;75.6;14.4
38;2021-12-05;50;50;2039;967758;956554;183853;76.5;75.6;14.5
38;2021-12-06;135;224;9489;967893;956778;193342;76.5;75.6;15.3
38;2021-12-07;177;264;12055;968070;957042;205397;76.5;75.7;16.2
38;2021-12-08;272;386;10655;968342;957428;216052;76.6;75.7;17.1
38;2021-12-09;162;276;12412;968504;957704;228464;76.6;75.7;18.1
38;2021-12-10;259;354;14952;968763;958058;243416;76.6;75.7;19.2
38;2021-12-11;230;328;9923;968993;958386;253339;76.6;75.8;20.0
38;2021-12-12;57;50;3999;969050;958436;257338;76.6;75.8;20.3
38;2021-12-13;191;255;13044;969241;958691;270382;76.6;75.8;21.4
38;2021-12-14;254;283;16198;969495;958974;286580;76.6;75.8;22.7
38;2021-12-15;272;361;14964;969767;959335;301544;76.7;75.8;23.8
38;2021-12-16;292;328;15649;970059;959663;317193;76.7;75.9;25.1
39;2020-12-27;0;0;0;0;0;0;0.0;0.0;0.0
39;2020-12-28;0;0;0;0;0;0;0.0;0.0;0.0
39;2020-12-29;0;0;0;0;0;0;0.0;0.0;0.0
39;2020-12-30;0;0;0;0;0;0;0.0;0.0;0.0
39;2020-12-31;0;0;0;0;0;0;0.0;0.0;0.0
39;2021-01-01;1;0;0;1;0;0;0.0;0.0;0.0
39;2021-01-02;0;0;0;1;0;0;0.0;0.0;0.0
39;2021-01-03;0;0;0;1;0;0;0.0;0.0;0.0
39;2021-01-04;2;0;0;3;0;0;0.0;0.0;0.0
39;2021-01-05;3;0;0;6;0;0;0.0;0.0;0.0
39;2021-01-06;48;3;0;54;3;0;0.0;0.0;0.0
39;2021-01-07;332;2;0;386;5;0;0.1;0.0;0.0
39;2021-01-08;611;2;0;997;7;0;0.4;0.0;0.0
39;2021-01-09;170;0;0;1167;7;0;0.5;0.0;0.0
39;2021-01-10;1;0;0;1168;7;0;0.5;0.0;0.0
39;2021-01-11;448;1;0;1616;8;0;0.6;0.0;0.0
39;2021-01-12;433;1;0;2049;9;0;0.8;0.0;0.0
39;2021-01-13;409;2;0;2458;11;0;1.0;0.0;0.0
39;2021-01-14;570;3;0;3028;14;0;1.2;0.0;0.0
39;2021-01-15;454;2;0;3482;16;0;1.4;0.0;0.0
39;2021-01-16;138;0;0;3620;16;0;1.4;0.0;0.0
39;2021-01-17;4;1;0;3624;17;0;1.4;0.0;0.0
39;2021-01-18;893;7;0;4517;24;0;1.8;0.0;0.0
39;2021-01-19;1126;8;0;5643;32;0;2.2;0.0;0.0
39;2021-01-20;885;5;0;6528;37;0;2.5;0.0;0.0
39;2021-01-21;1176;3;0;7704;40;0;3.0;0.0;0.0
39;2021-01-22;954;3;0;8658;43;0;3.4;0.0;0.0
39;2021-01-23;368;1;0;9026;44;0;3.5;0.0;0.0
39;2021-01-24;0;0;0;9026;44;0;3.5;0.0;0.0
39;2021-01-25;635;2;0;9661;46;0;3.7;0.0;0.0
39;2021-01-26;1030;15;0;10691;61;0;4.1;0.0;0.0
39;2021-01-27;845;20;0;11536;81;0;4.5;0.0;0.0
39;2021-01-28;679;231;0;12215;312;0;4.7;0.1;0.0
39;2021-01-29;522;390;0;12737;702;0;4.9;0.3;0.0
39;2021-01-30;236;105;0;12973;807;0;5.0;0.3;0.0
39;2021-01-31;1;0;0;12974;807;0;5.0;0.3;0.0
39;2021-02-01;534;254;0;13508;1061;0;5.2;0.4;0.0
39;2021-02-02;716;314;0;14224;1375;0;5.5;0.5;0.0
39;2021-02-03;468;493;0;14692;1868;0;5.7;0.7;0.0
39;2021-02-04;505;436;0;15197;2304;0;5.9;0.9;0.0
39;2021-02-05;413;414;0;15610;2718;0;6.1;1.1;0.0
39;2021-02-06;233;105;0;15843;2823;0;6.1;1.1;0.0
39;2021-02-07;0;2;0;15843;2825;0;6.1;1.1;0.0
39;2021-02-08;307;362;0;16150;3187;0;6.3;1.2;0.0
39;2021-02-09;314;451;0;16464;3638;0;6.4;1.4;0.0
39;2021-02-10;244;339;0;16708;3977;0;6.5;1.5;0.0
39;2021-02-11;545;503;0;17253;4480;0;6.7;1.7;0.0
39;2021-02-12;346;398;0;17599;4878;0;6.8;1.9;0.0
39;2021-02-13;99;65;0;17698;4943;0;6.9;1.9;0.0
39;2021-02-14;1;1;0;17699;4944;0;6.9;1.9;0.0
39;2021-02-15;101;741;0;17800;5685;0;6.9;2.2;0.0
39;2021-02-16;108;877;0;17908;6562;0;6.9;2.5;0.0
39;2021-02-17;59;668;0;17967;7230;0;7.0;2.8;0.0
39;2021-02-18;107;831;0;18074;8061;0;7.0;3.1;0.0
39;2021-02-19;58;484;0;18132;8545;0;7.0;3.3;0.0
39;2021-02-20;20;353;0;18152;8898;0;7.0;3.5;0.0
39;2021-02-21;0;1;0;18152;8899;0;7.0;3.5;0.0
39;2021-02-22;97;677;0;18249;9576;0;7.1;3.7;0.0
39;2021-02-23;19;686;0;18268;10262;0;7.1;4.0;0.0
39;2021-02-24;115;773;0;18383;11035;0;7.1;4.3;0.0
39;2021-02-25;213;700;0;18596;11735;0;7.2;4.6;0.0
39;2021-02-26;202;432;0;18798;12167;0;7.3;4.7;0.0
39;2021-02-27;167;267;0;18965;12434;0;7.4;4.8;0.0
39;2021-02-28;4;0;0;18969;12434;0;7.4;4.8;0.0
39;2021-03-01;258;616;0;19227;13050;0;7.5;5.1;0.0
39;2021-03-02;344;774;0;19571;13824;0;7.6;5.4;0.0
39;2021-03-03;570;474;0;20141;14298;0;7.8;5.5;0.0
39;2021-03-04;638;452;0;20779;14750;0;8.1;5.7;0.0
39;2021-03-05;636;323;0;21415;15073;0;8.3;5.8;0.0
39;2021-03-06;728;217;0;22143;15290;0;8.6;5.9;0.0
39;2021-03-07;200;69;0;22343;15359;0;8.7;6.0;0.0
39;2021-03-08;275;421;0;22618;15780;0;8.8;6.1;0.0
39;2021-03-09;771;418;0;23389;16198;0;9.1;6.3;0.0
39;2021-03-10;930;285;0;24319;16483;0;9.4;6.4;0.0
39;2021-03-11;758;445;0;25077;16928;0;9.7;6.6;0.0
39;2021-03-12;764;280;0;25841;17208;0;10.0;6.7;0.0
39;2021-03-13;746;95;0;26587;17303;0;10.3;6.7;0.0
39;2021-03-14;45;8;0;26632;17311;0;10.3;6.7;0.0
39;2021-03-15;454;114;0;27086;17425;0;10.5;6.8;0.0
39;2021-03-16;493;54;0;27579;17479;0;10.7;6.8;0.0
39;2021-03-17;571;71;0;28150;17550;0;10.9;6.8;0.0
39;2021-03-18;590;73;0;28740;17623;0;11.1;6.8;0.0
39;2021-03-19;424;80;0;29164;17703;0;11.3;6.9;0.0
39;2021-03-20;335;22;0;29499;17725;0;11.4;6.9;0.0
39;2021-03-21;9;1;0;29508;17726;0;11.4;6.9;0.0
39;2021-03-22;734;121;0;30242;17847;0;11.7;6.9;0.0
39;2021-03-23;1071;63;0;31313;17910;0;12.1;6.9;0.0
39;2021-03-24;1124;103;0;32437;18013;0;12.6;7.0;0.0
39;2021-03-25;1961;140;0;34398;18153;0;13.3;7.0;0.0
39;2021-03-26;828;127;0;35226;18280;0;13.7;7.1;0.0
39;2021-03-27;357;11;0;35583;18291;0;13.8;7.1;0.0
39;2021-03-28;37;4;0;35620;18295;0;13.8;7.1;0.0
39;2021-03-29;1010;194;0;36630;18489;0;14.2;7.2;0.0
39;2021-03-30;1341;278;0;37971;18767;0;14.7;7.3;0.0
39;2021-03-31;669;459;0;38640;19226;0;15.0;7.5;0.0
39;2021-04-01;1168;292;0;39808;19518;0;15.4;7.6;0.0
39;2021-04-02;636;138;0;40444;19656;0;15.7;7.6;0.0
39;2021-04-03;202;13;0;40646;19669;0;15.8;7.6;0.0
39;2021-04-04;4;2;0;40650;19671;0;15.8;7.6;0.0
39;2021-04-05;12;2;0;40662;19673;0;15.8;7.6;0.0
39;2021-04-06;813;579;0;41475;20252;0;16.1;7.9;0.0
39;2021-04-07;1069;614;0;42544;20866;0;16.5;8.1;0.0
39;2021-04-08;1654;517;0;44198;21383;0;17.1;8.3;0.0
39;2021-04-09;1641;299;0;45839;21682;0;17.8;8.4;0.0
39;2021-04-10;366;154;0;46205;21836;0;17.9;8.5;0.0
39;2021-04-11;10;1;0;46215;21837;0;17.9;8.5;0.0
39;2021-04-12;677;345;0;46892;22182;0;18.2;8.6;0.0
39;2021-04-13;1167;527;0;48059;22709;0;18.6;8.8;0.0
39;2021-04-14;796;591;0;48855;23300;0;18.9;9.0;0.0
39;2021-04-15;1373;680;0;50228;23980;0;19.5;9.3;0.0
39;2021-04-16;1050;223;0;51278;24203;0;19.9;9.4;0.0
39;2021-04-17;262;74;0;51540;24277;0;20.0;9.4;0.0
39;2021-04-18;6;2;0;51546;24279;0;20.0;9.4;0.0
39;2021-04-19;539;664;0;52085;24943;0;20.2;9.7;0.0
39;2021-04-20;804;552;0;52889;25495;0;20.5;9.9;0.0
39;2021-04-21;1000;663;0;53889;26158;0;20.9;10.1;0.0
39;2021-04-22;1006;1068;0;54895;27226;0;21.3;10.6;0.0
39;2021-04-23;476;378;0;55371;27604;0;21.5;10.7;0.0
39;2021-04-24;305;146;0;55676;27750;0;21.6;10.8;0.0
39;2021-04-25;19;4;0;55695;27754;0;21.6;10.8;0.0
39;2021-04-26;564;1018;0;56259;28772;0;21.8;11.2;0.0
39;2021-04-27;802;953;0;57061;29725;0;22.1;11.5;0.0
39;2021-04-28;1512;433;0;58573;30158;0;22.7;11.7;0.0
39;2021-04-29;2414;861;0;60987;31019;0;23.7;12.0;0.0
39;2021-04-30;2238;420;0;63225;31439;0;24.5;12.2;0.0
39;2021-05-01;84;65;0;63309;31504;0;24.6;12.2;0.0
39;2021-05-02;24;3;0;63333;31507;0;24.6;12.2;0.0
39;2021-05-03;935;768;0;64268;32275;0;24.9;12.5;0.0
39;2021-05-04;994;1077;0;65262;33352;0;25.3;12.9;0.0
39;2021-05-05;1756;868;0;67018;34220;0;26.0;13.3;0.0
39;2021-05-06;2228;1226;0;69246;35446;0;26.9;13.7;0.0
39;2021-05-07;1282;624;0;70528;36070;0;27.4;14.0;0.0
39;2021-05-08;175;51;0;70703;36121;0;27.4;14.0;0.0
39;2021-05-09;23;21;0;70726;36142;0;27.4;14.0;0.0
39;2021-05-10;1706;867;0;72432;37009;0;28.1;14.4;0.0
39;2021-05-11;1768;1464;0;74200;38473;0;28.8;14.9;0.0
39;2021-05-12;1655;1373;0;75855;39846;0;29.4;15.5;0.0
39;2021-05-13;261;48;0;76116;39894;0;29.5;15.5;0.0
39;2021-05-14;2261;359;0;78377;40253;0;30.4;15.6;0.0
39;2021-05-15;1531;262;0;79908;40515;0;31.0;15.7;0.0
39;2021-05-16;37;6;0;79945;40521;0;31.0;15.7;0.0
39;2021-05-17;1924;712;0;81869;41233;0;31.8;16.0;0.0
39;2021-05-18;1707;1120;0;83576;42353;0;32.4;16.4;0.0
39;2021-05-19;2299;540;0;85875;42893;0;33.3;16.6;0.0
39;2021-05-20;2167;787;0;88042;43680;0;34.1;16.9;0.0
39;2021-05-21;1790;585;0;89832;44265;0;34.8;17.2;0.0
39;2021-05-22;322;232;0;90154;44497;0;35.0;17.3;0.0
39;2021-05-23;36;65;0;90190;44562;0;35.0;17.3;0.0
39;2021-05-24;169;52;0;90359;44614;0;35.0;17.3;0.0
39;2021-05-25;1641;1183;0;92000;45797;0;35.7;17.8;0.0
39;2021-05-26;1604;1302;0;93604;47099;0;36.3;18.3;0.0
39;2021-05-27;1473;1538;0;95077;48637;0;36.9;18.9;0.0
39;2021-05-28;974;1254;0;96051;49891;0;37.3;19.3;0.0
39;2021-05-29;352;312;0;96403;50203;0;37.4;19.5;0.0
39;2021-05-30;19;44;0;96422;50247;0;37.4;19.5;0.0
39;2021-05-31;1535;1208;0;97957;51455;0;38.0;20.0;0.0
39;2021-06-01;1789;1327;0;99746;52782;0;38.7;20.5;0.0
39;2021-06-02;1654;1016;0;101400;53798;0;39.3;20.9;0.0
39;2021-06-03;1326;1129;0;102726;54927;0;39.8;21.3;0.0
39;2021-06-04;1019;1076;0;103745;56003;0;40.2;21.7;0.0
39;2021-06-05;671;551;0;104416;56554;0;40.5;21.9;0.0
39;2021-06-06;61;44;0;104477;56598;0;40.5;22.0;0.0
39;2021-06-07;1944;893;0;106421;57491;0;41.3;22.3;0.0
39;2021-06-08;2050;1120;0;108471;58611;0;42.1;22.7;0.0
39;2021-06-09;1654;1174;0;110125;59785;0;42.7;23.2;0.0
39;2021-06-10;1611;1929;0;111736;61714;0;43.3;23.9;0.0
39;2021-06-11;1528;1193;0;113264;62907;0;43.9;24.4;0.0
39;2021-06-12;1096;396;0;114360;63303;0;44.4;24.6;0.0
39;2021-06-13;33;29;0;114393;63332;0;44.4;24.6;0.0
39;2021-06-14;1289;1819;0;115682;65151;0;44.9;25.3;0.0
39;2021-06-15;1329;1287;0;117011;66438;0;45.4;25.8;0.0
39;2021-06-16;1174;1414;0;118185;67852;0;45.8;26.3;0.0
39;2021-06-17;1022;1617;0;119207;69469;0;46.2;26.9;0.0
39;2021-06-18;1502;1191;0;120709;70660;0;46.8;27.4;0.0
39;2021-06-19;346;418;0;121055;71078;0;46.9;27.6;0.0
39;2021-06-20;24;33;0;121079;71111;0;47.0;27.6;0.0
39;2021-06-21;404;2410;0;121483;73521;0;47.1;28.5;0.0
39;2021-06-22;797;2249;0;122280;75770;0;47.4;29.4;0.0
39;2021-06-23;1111;1238;0;123391;77008;0;47.9;29.9;0.0
39;2021-06-24;758;1072;0;124149;78080;0;48.1;30.3;0.0
39;2021-06-25;689;2744;0;124838;80824;0;48.4;31.3;0.0
39;2021-06-26;223;1410;0;125061;82234;0;48.5;31.9;0.0
39;2021-06-27;23;30;0;125084;82264;0;48.5;31.9;0.0
39;2021-06-28;336;2627;0;125420;84891;0;48.6;32.9;0.0
39;2021-06-29;520;2628;0;125940;87519;0;48.8;33.9;0.0
39;2021-06-30;819;2251;0;126759;89770;0;49.2;34.8;0.0
39;2021-07-01;697;1764;0;127456;91534;0;49.4;35.5;0.0
39;2021-07-02;1046;1461;0;128502;92995;0;49.8;36.1;0.0
39;2021-07-03;529;509;0;129031;93504;0;50.0;36.3;0.0
39;2021-07-04;24;37;0;129055;93541;0;50.1;36.3;0.0
39;2021-07-05;556;2469;0;129611;96010;0;50.3;37.2;0.0
39;2021-07-06;818;1860;0;130429;97870;0;50.6;38.0;0.0
39;2021-07-07;611;1371;0;131040;99241;0;50.8;38.5;0.0
39;2021-07-08;685;1005;0;131725;100246;0;51.1;38.9;0.0
39;2021-07-09;1026;1595;0;132751;101841;0;51.5;39.5;0.0
39;2021-07-10;646;588;0;133397;102429;0;51.7;39.7;0.0
39;2021-07-11;24;20;0;133421;102449;0;51.7;39.7;0.0
39;2021-07-12;521;2443;0;133942;104892;0;51.9;40.7;0.0
39;2021-07-13;1487;2553;0;135429;107445;0;52.5;41.7;0.0
39;2021-07-14;82;84;0;135511;107529;0;52.6;41.7;0.0
39;2021-07-15;1579;1792;0;137090;109321;0;53.2;42.4;0.0
39;2021-07-16;2721;1993;0;139811;111314;0;54.2;43.2;0.0
39;2021-07-17;1681;944;0;141492;112258;0;54.9;43.5;0.0
39;2021-07-18;157;87;0;141649;112345;0;54.9;43.6;0.0
39;2021-07-19;1247;2763;0;142896;115108;0;55.4;44.6;0.0
39;2021-07-20;1595;2586;0;144491;117694;0;56.0;45.6;0.0
39;2021-07-21;2091;2367;0;146582;120061;0;56.8;46.6;0.0
39;2021-07-22;1618;1814;0;148200;121875;0;57.5;47.3;0.0
39;2021-07-23;1559;1821;0;149759;123696;0;58.1;48.0;0.0
39;2021-07-24;1092;1229;0;150851;124925;0;58.5;48.4;0.0
39;2021-07-25;53;46;0;150904;124971;0;58.5;48.5;0.0
39;2021-07-26;1112;1870;0;152016;126841;0;59.0;49.2;0.0
39;2021-07-27;1911;1800;0;153927;128641;0;59.7;49.9;0.0
39;2021-07-28;2157;1354;0;156084;129995;0;60.5;50.4;0.0
39;2021-07-29;1916;1508;0;158000;131503;0;61.3;51.0;0.0
39;2021-07-30;1771;1317;0;159771;132820;0;62.0;51.5;0.0
39;2021-07-31;1140;648;0;160911;133468;0;62.4;51.8;0.0
39;2021-08-01;78;31;0;160989;133499;0;62.4;51.8;0.0
39;2021-08-02;1099;1226;0;162088;134725;0;62.9;52.2;0.0
39;2021-08-03;1637;1205;0;163725;135930;0;63.5;52.7;0.0
39;2021-08-04;979;663;0;164704;136593;0;63.9;53.0;0.0
39;2021-08-05;1125;721;0;165829;137314;0;64.3;53.3;0.0
39;2021-08-06;1214;1979;0;167043;139293;0;64.8;54.0;0.0
39;2021-08-07;860;1025;0;167903;140318;0;65.1;54.4;0.0
39;2021-08-08;48;40;0;167951;140358;0;65.1;54.4;0.0
39;2021-08-09;482;392;0;168433;140750;0;65.3;54.6;0.0
39;2021-08-10;1152;941;0;169585;141691;0;65.8;55.0;0.0
39;2021-08-11;874;1369;0;170459;143060;0;66.1;55.5;0.0
39;2021-08-12;1401;1869;0;171860;144929;0;66.7;56.2;0.0
39;2021-08-13;1202;1850;0;173062;146779;0;67.1;56.9;0.0
39;2021-08-14;350;934;0;173412;147713;0;67.3;57.3;0.0
39;2021-08-15;11;15;0;173423;147728;0;67.3;57.3;0.0
39;2021-08-16;504;726;0;173927;148454;0;67.5;57.6;0.0
39;2021-08-17;598;1338;0;174525;149792;0;67.7;58.1;0.0
39;2021-08-18;780;1489;0;175305;151281;0;68.0;58.7;0.0
39;2021-08-19;844;1385;0;176149;152666;0;68.3;59.2;0.0
39;2021-08-20;642;2148;0;176791;154814;0;68.6;60.0;0.0
39;2021-08-21;441;1102;0;177232;155916;0;68.7;60.5;0.0
39;2021-08-22;17;56;0;177249;155972;0;68.7;60.5;0.0
39;2021-08-23;296;919;0;177545;156891;0;68.9;60.8;0.0
39;2021-08-24;441;1463;0;177986;158354;0;69.0;61.4;0.0
39;2021-08-25;605;1465;0;178591;159819;0;69.3;62.0;0.0
39;2021-08-26;677;1613;0;179268;161432;0;69.5;62.6;0.0
39;2021-08-27;412;1778;0;179680;163210;0;69.7;63.3;0.0
39;2021-08-28;324;1159;0;180004;164369;0;69.8;63.7;0.0
39;2021-08-29;10;29;0;180014;164398;0;69.8;63.8;0.0
39;2021-08-30;360;955;8;180374;165353;8;70.0;64.1;0.0
39;2021-08-31;430;1014;36;180804;166367;44;70.1;64.5;0.0
39;2021-09-01;544;1320;158;181348;167687;202;70.3;65.0;0.1
39;2021-09-02;339;1249;129;181687;168936;331;70.5;65.5;0.1
39;2021-09-03;484;1959;161;182171;170895;492;70.7;66.3;0.2
39;2021-09-04;171;255;26;182342;171150;518;70.7;66.4;0.2
39;2021-09-05;9;17;0;182351;171167;518;70.7;66.4;0.2
39;2021-09-06;282;521;97;182633;171688;615;70.8;66.6;0.2
39;2021-09-07;251;342;100;182884;172030;715;70.9;66.7;0.3
39;2021-09-08;458;682;305;183342;172712;1020;71.1;67.0;0.4
39;2021-09-09;428;793;405;183770;173505;1425;71.3;67.3;0.6
39;2021-09-10;245;618;185;184015;174123;1610;71.4;67.5;0.6
39;2021-09-11;269;763;114;184284;174886;1724;71.5;67.8;0.7
39;2021-09-12;10;31;1;184294;174917;1725;71.5;67.8;0.7
39;2021-09-13;192;218;97;184486;175135;1822;71.5;67.9;0.7
39;2021-09-14;225;355;123;184711;175490;1945;71.6;68.1;0.8
39;2021-09-15;275;565;608;184986;176055;2553;71.7;68.3;1.0
39;2021-09-16;434;961;444;185420;177016;2997;71.9;68.7;1.2
39;2021-09-17;432;688;285;185852;177704;3282;72.1;68.9;1.3
39;2021-09-18;108;259;81;185960;177963;3363;72.1;69.0;1.3
39;2021-09-19;3;13;1;185963;177976;3364;72.1;69.0;1.3
39;2021-09-20;111;172;115;186074;178148;3479;72.2;69.1;1.3
39;2021-09-21;117;176;275;186191;178324;3754;72.2;69.2;1.5
39;2021-09-22;278;764;432;186469;179088;4186;72.3;69.5;1.6
39;2021-09-23;184;322;393;186653;179410;4579;72.4;69.6;1.8
39;2021-09-24;225;588;317;186878;179998;4896;72.5;69.8;1.9
39;2021-09-25;82;263;92;186960;180261;4988;72.5;69.9;1.9
39;2021-09-26;1;3;1;186961;180264;4989;72.5;69.9;1.9
39;2021-09-27;131;329;219;187092;180593;5208;72.6;70.0;2.0
39;2021-09-28;73;182;266;187165;180775;5474;72.6;70.1;2.1
39;2021-09-29;203;539;398;187368;181314;5872;72.7;70.3;2.3
39;2021-09-30;186;426;377;187554;181740;6249;72.7;70.5;2.4
39;2021-10-01;160;241;300;187714;181981;6549;72.8;70.6;2.5
39;2021-10-02;118;238;146;187832;182219;6695;72.8;70.7;2.6
39;2021-10-03;1;7;0;187833;182226;6695;72.8;70.7;2.6
39;2021-10-04;76;161;119;187909;182387;6814;72.9;70.7;2.6
39;2021-10-05;80;151;313;187989;182538;7127;72.9;70.8;2.8
39;2021-10-06;212;335;433;188201;182873;7560;73.0;70.9;2.9
39;2021-10-07;138;430;433;188339;183303;7993;73.0;71.1;3.1
39;2021-10-08;240;482;569;188579;183785;8562;73.1;71.3;3.3
39;2021-10-09;64;75;59;188643;183860;8621;73.2;71.3;3.3
39;2021-10-10;0;5;3;188643;183865;8624;73.2;71.3;3.3
39;2021-10-11;49;103;93;188692;183968;8717;73.2;71.3;3.4
39;2021-10-12;102;117;293;188794;184085;9010;73.2;71.4;3.5
39;2021-10-13;108;197;256;188902;184282;9266;73.3;71.5;3.6
39;2021-10-14;135;244;390;189037;184526;9656;73.3;71.6;3.7
39;2021-10-15;325;480;750;189362;185006;10406;73.4;71.7;4.0
39;2021-10-16;62;98;92;189424;185104;10498;73.5;71.8;4.1
39;2021-10-17;3;8;0;189427;185112;10498;73.5;71.8;4.1
39;2021-10-18;35;56;113;189462;185168;10611;73.5;71.8;4.1
39;2021-10-19;63;78;180;189525;185246;10791;73.5;71.8;4.2
39;2021-10-20;64;89;159;189589;185335;10950;73.5;71.9;4.2
39;2021-10-21;122;219;473;189711;185554;11423;73.6;72.0;4.4
39;2021-10-22;312;445;938;190023;185999;12361;73.7;72.1;4.8
39;2021-10-23;65;140;183;190088;186139;12544;73.7;72.2;4.9
39;2021-10-24;2;5;0;190090;186144;12544;73.7;72.2;4.9
39;2021-10-25;34;63;126;190124;186207;12670;73.7;72.2;4.9
39;2021-10-26;52;63;224;190176;186270;12894;73.8;72.2;5.0
39;2021-10-27;102;168;332;190278;186438;13226;73.8;72.3;5.1
39;2021-10-28;166;190;531;190444;186628;13757;73.9;72.4;5.3
39;2021-10-29;127;169;517;190571;186797;14274;73.9;72.4;5.5
39;2021-10-30;38;64;245;190609;186861;14519;73.9;72.5;5.6
39;2021-10-31;0;6;0;190609;186867;14519;73.9;72.5;5.6
39;2021-11-01;8;7;3;190617;186874;14522;73.9;72.5;5.6
39;2021-11-02;44;100;219;190661;186974;14741;73.9;72.5;5.7
39;2021-11-03;93;121;450;190754;187095;15191;74.0;72.6;5.9
39;2021-11-04;70;119;688;190824;187214;15879;74.0;72.6;6.2
39;2021-11-05;212;315;1076;191036;187529;16955;74.1;72.7;6.6
39;2021-11-06;30;49;120;191066;187578;17075;74.1;72.7;6.6
39;2021-11-07;0;4;3;191066;187582;17078;74.1;72.7;6.6
39;2021-11-08;36;69;280;191102;187651;17358;74.1;72.8;6.7
39;2021-11-09;65;91;718;191167;187742;18076;74.1;72.8;7.0
39;2021-11-10;189;183;1276;191356;187925;19352;74.2;72.9;7.5
39;2021-11-11;4;9;25;191360;187934;19377;74.2;72.9;7.5
39;2021-11-12;92;150;615;191452;188084;19992;74.2;72.9;7.8
39;2021-11-13;45;75;345;191497;188159;20337;74.3;73.0;7.9
39;2021-11-14;5;1;11;191502;188160;20348;74.3;73.0;7.9
39;2021-11-15;21;55;259;191523;188215;20607;74.3;73.0;8.0
39;2021-11-16;106;97;1046;191629;188312;21653;74.3;73.0;8.4
39;2021-11-17;96;195;1045;191725;188507;22698;74.4;73.1;8.8
39;2021-11-18;111;117;811;191836;188624;23509;74.4;73.2;9.1
39;2021-11-19;161;237;1403;191997;188861;24912;74.5;73.2;9.7
39;2021-11-20;82;51;378;192079;188912;25290;74.5;73.3;9.8
39;2021-11-21;2;2;2;192081;188914;25292;74.5;73.3;9.8
39;2021-11-22;34;55;334;192115;188969;25626;74.5;73.3;9.9
39;2021-11-23;117;86;1079;192232;189055;26705;74.6;73.3;10.4
39;2021-11-24;139;153;1274;192371;189208;27979;74.6;73.4;10.9
39;2021-11-25;127;86;1185;192498;189294;29164;74.7;73.4;11.3
39;2021-11-26;137;138;1976;192635;189432;31140;74.7;73.5;12.1
39;2021-11-27;45;69;613;192680;189501;31753;74.7;73.5;12.3
39;2021-11-28;5;4;27;192685;189505;31780;74.7;73.5;12.3
39;2021-11-29;51;65;1254;192736;189570;33034;74.7;73.5;12.8
39;2021-11-30;89;106;2338;192825;189676;35372;74.8;73.6;13.7
39;2021-12-01;93;164;2478;192918;189840;37850;74.8;73.6;14.7
39;2021-12-02;85;88;3171;193003;189928;41021;74.9;73.7;15.9
39;2021-12-03;94;145;2797;193097;190073;43818;74.9;73.7;17.0
39;2021-12-04;48;62;1055;193145;190135;44873;74.9;73.7;17.4
39;2021-12-05;2;5;46;193147;190140;44919;74.9;73.7;17.4
39;2021-12-06;55;58;1968;193202;190198;46887;74.9;73.8;18.2
39;2021-12-07;106;115;2978;193308;190313;49865;75.0;73.8;19.3
39;2021-12-08;118;89;3183;193426;190402;53048;75.0;73.8;20.6
39;2021-12-09;120;132;3559;193546;190534;56607;75.1;73.9;22.0
39;2021-12-10;97;178;3355;193643;190712;59962;75.1;74.0;23.3
39;2021-12-11;48;93;1066;193691;190805;61028;75.1;74.0;23.7
39;2021-12-12;5;5;50;193696;190810;61078;75.1;74.0;23.7
39;2021-12-13;89;67;2386;193785;190877;63464;75.2;74.0;24.6
39;2021-12-14;82;126;3257;193867;191003;66721;75.2;74.1;25.9
39;2021-12-15;119;153;3408;193986;191156;70129;75.2;74.1;27.2
39;2021-12-16;84;148;3373;194070;191304;73502;75.3;74.2;28.5
40;2020-12-27;0;0;0;0;0;0;0.0;0.0;0.0
40;2020-12-28;0;0;0;0;0;0;0.0;0.0;0.0
40;2020-12-29;0;0;0;0;0;0;0.0;0.0;0.0
40;2020-12-30;0;0;0;0;0;0;0.0;0.0;0.0
40;2020-12-31;0;0;0;0;0;0;0.0;0.0;0.0
40;2021-01-01;0;0;0;0;0;0;0.0;0.0;0.0
40;2021-01-02;2;0;0;2;0;0;0.0;0.0;0.0
40;2021-01-03;0;0;0;2;0;0;0.0;0.0;0.0
40;2021-01-04;1;0;0;3;0;0;0.0;0.0;0.0
40;2021-01-05;1;0;0;4;0;0;0.0;0.0;0.0
40;2021-01-06;5;0;0;9;0;0;0.0;0.0;0.0
40;2021-01-07;238;1;0;247;1;0;0.1;0.0;0.0
40;2021-01-08;437;4;0;684;5;0;0.2;0.0;0.0
40;2021-01-09;4;0;0;688;5;0;0.2;0.0;0.0
40;2021-01-10;4;0;0;692;5;0;0.2;0.0;0.0
40;2021-01-11;130;0;0;822;5;0;0.2;0.0;0.0
40;2021-01-12;63;0;0;885;5;0;0.2;0.0;0.0
40;2021-01-13;707;6;0;1592;11;0;0.4;0.0;0.0
40;2021-01-14;918;7;0;2510;18;0;0.6;0.0;0.0
40;2021-01-15;855;3;0;3365;21;0;0.8;0.0;0.0
40;2021-01-16;156;0;0;3521;21;0;0.9;0.0;0.0
40;2021-01-17;3;0;0;3524;21;0;0.9;0.0;0.0
40;2021-01-18;477;1;0;4001;22;0;1.0;0.0;0.0
40;2021-01-19;1216;4;0;5217;26;0;1.3;0.0;0.0
40;2021-01-20;943;3;0;6160;29;0;1.5;0.0;0.0
40;2021-01-21;1373;5;0;7533;34;0;1.8;0.0;0.0
40;2021-01-22;906;4;0;8439;38;0;2.0;0.0;0.0
40;2021-01-23;313;0;0;8752;38;0;2.1;0.0;0.0
40;2021-01-24;32;0;0;8784;38;0;2.1;0.0;0.0
40;2021-01-25;453;3;0;9237;41;0;2.2;0.0;0.0
40;2021-01-26;856;5;0;10093;46;0;2.4;0.0;0.0
40;2021-01-27;1131;14;0;11224;60;0;2.7;0.0;0.0
40;2021-01-28;782;131;0;12006;191;0;2.9;0.0;0.0
40;2021-01-29;625;268;0;12631;459;0;3.1;0.1;0.0
40;2021-01-30;252;8;0;12883;467;0;3.1;0.1;0.0
40;2021-01-31;22;2;0;12905;469;0;3.1;0.1;0.0
40;2021-02-01;403;132;0;13308;601;0;3.2;0.1;0.0
40;2021-02-02;934;89;0;14242;690;0;3.5;0.2;0.0
40;2021-02-03;918;322;0;15160;1012;0;3.7;0.2;0.0
40;2021-02-04;1111;607;0;16271;1619;0;3.9;0.4;0.0
40;2021-02-05;813;416;0;17084;2035;0;4.1;0.5;0.0
40;2021-02-06;397;83;0;17481;2118;0;4.2;0.5;0.0
40;2021-02-07;26;1;0;17507;2119;0;4.2;0.5;0.0
40;2021-02-08;426;142;0;17933;2261;0;4.4;0.5;0.0
40;2021-02-09;811;559;0;18744;2820;0;4.5;0.7;0.0
40;2021-02-10;760;532;0;19504;3352;0;4.7;0.8;0.0
40;2021-02-11;800;721;0;20304;4073;0;4.9;1.0;0.0
40;2021-02-12;614;730;0;20918;4803;0;5.1;1.2;0.0
40;2021-02-13;355;108;0;21273;4911;0;5.2;1.2;0.0
40;2021-02-14;10;8;0;21283;4919;0;5.2;1.2;0.0
40;2021-02-15;52;433;0;21335;5352;0;5.2;1.3;0.0
40;2021-02-16;287;642;0;21622;5994;0;5.2;1.5;0.0
40;2021-02-17;343;898;0;21965;6892;0;5.3;1.7;0.0
40;2021-02-18;398;838;0;22363;7730;0;5.4;1.9;0.0
40;2021-02-19;163;679;0;22526;8409;0;5.5;2.0;0.0
40;2021-02-20;45;147;0;22571;8556;0;5.5;2.1;0.0
40;2021-02-21;6;86;0;22577;8642;0;5.5;2.1;0.0
40;2021-02-22;99;592;0;22676;9234;0;5.5;2.2;0.0
40;2021-02-23;246;879;0;22922;10113;0;5.6;2.5;0.0
40;2021-02-24;323;735;0;23245;10848;0;5.6;2.6;0.0
40;2021-02-25;764;1008;0;24009;11856;0;5.8;2.9;0.0
40;2021-02-26;724;702;0;24733;12558;0;6.0;3.0;0.0
40;2021-02-27;406;174;0;25139;12732;0;6.1;3.1;0.0
40;2021-02-28;5;24;0;25144;12756;0;6.1;3.1;0.0
40;2021-03-01;451;533;0;25595;13289;0;6.2;3.2;0.0
40;2021-03-02;778;1046;0;26373;14335;0;6.4;3.5;0.0
40;2021-03-03;963;939;0;27336;15274;0;6.6;3.7;0.0
40;2021-03-04;1372;872;0;28708;16146;0;7.0;3.9;0.0
40;2021-03-05;1299;767;0;30007;16913;0;7.3;4.1;0.0
40;2021-03-06;908;381;0;30915;17294;0;7.5;4.2;0.0
40;2021-03-07;125;32;0;31040;17326;0;7.5;4.2;0.0
40;2021-03-08;908;527;0;31948;17853;0;7.8;4.3;0.0
40;2021-03-09;1554;644;0;33502;18497;0;8.1;4.5;0.0
40;2021-03-10;1809;725;0;35311;19222;0;8.6;4.7;0.0
40;2021-03-11;2070;686;0;37381;19908;0;9.1;4.8;0.0
40;2021-03-12;2213;492;0;39594;20400;0;9.6;5.0;0.0
40;2021-03-13;1110;226;0;40704;20626;0;9.9;5.0;0.0
40;2021-03-14;143;2;0;40847;20628;0;9.9;5.0;0.0
40;2021-03-15;1028;97;0;41875;20725;0;10.2;5.0;0.0
40;2021-03-16;1039;289;0;42914;21014;0;10.4;5.1;0.0
40;2021-03-17;1613;332;0;44527;21346;0;10.8;5.2;0.0
40;2021-03-18;1648;334;0;46175;21680;0;11.2;5.3;0.0
40;2021-03-19;1871;166;0;48046;21846;0;11.7;5.3;0.0
40;2021-03-20;809;15;0;48855;21861;0;11.9;5.3;0.0
40;2021-03-21;108;3;0;48963;21864;0;11.9;5.3;0.0
40;2021-03-22;1243;58;0;50206;21922;0;12.2;5.3;0.0
40;2021-03-23;2377;205;0;52583;22127;0;12.8;5.4;0.0
40;2021-03-24;2417;267;0;55000;22394;0;13.4;5.4;0.0
40;2021-03-25;2873;404;0;57873;22798;0;14.0;5.5;0.0
40;2021-03-26;3151;256;0;61024;23054;0;14.8;5.6;0.0
40;2021-03-27;977;74;0;62001;23128;0;15.0;5.6;0.0
40;2021-03-28;259;36;0;62260;23164;0;15.1;5.6;0.0
40;2021-03-29;1245;398;0;63505;23562;0;15.4;5.7;0.0
40;2021-03-30;2395;446;0;65900;24008;0;16.0;5.8;0.0
40;2021-03-31;2089;351;0;67989;24359;0;16.5;5.9;0.0
40;2021-04-01;2561;377;0;70550;24736;0;17.1;6.0;0.0
40;2021-04-02;2455;254;0;73005;24990;0;17.7;6.1;0.0
40;2021-04-03;760;142;0;73765;25132;0;17.9;6.1;0.0
40;2021-04-04;366;21;0;74131;25153;0;18.0;6.1;0.0
40;2021-04-05;586;57;0;74717;25210;0;18.1;6.1;0.0
40;2021-04-06;2176;870;0;76893;26080;0;18.7;6.3;0.0
40;2021-04-07;2678;966;0;79571;27046;0;19.3;6.6;0.0
40;2021-04-08;3134;982;0;82705;28028;0;20.1;6.8;0.0
40;2021-04-09;3909;691;0;86614;28719;0;21.0;7.0;0.0
40;2021-04-10;1680;428;0;88294;29147;0;21.4;7.1;0.0
40;2021-04-11;90;35;0;88384;29182;0;21.5;7.1;0.0
40;2021-04-12;2237;808;0;90621;29990;0;22.0;7.3;0.0
40;2021-04-13;2678;1213;0;93299;31203;0;22.6;7.6;0.0
40;2021-04-14;2615;1480;0;95914;32683;0;23.3;7.9;0.0
40;2021-04-15;3052;1571;0;98966;34254;0;24.0;8.3;0.0
40;2021-04-16;2954;1245;0;101920;35499;0;24.7;8.6;0.0
40;2021-04-17;1506;439;0;103426;35938;0;25.1;8.7;0.0
40;2021-04-18;126;86;0;103552;36024;0;25.1;8.7;0.0
40;2021-04-19;1231;1136;0;104783;37160;0;25.4;9.0;0.0
40;2021-04-20;1753;1808;0;106536;38968;0;25.9;9.5;0.0
40;2021-04-21;1911;1763;0;108447;40731;0;26.3;9.9;0.0
40;2021-04-22;2172;1856;0;110619;42587;0;26.9;10.3;0.0
40;2021-04-23;2265;1420;0;112884;44007;0;27.4;10.7;0.0
40;2021-04-24;1423;656;0;114307;44663;0;27.7;10.8;0.0
40;2021-04-25;102;94;0;114409;44757;0;27.8;10.9;0.0
40;2021-04-26;1402;1161;0;115811;45918;0;28.1;11.1;0.0
40;2021-04-27;1682;2053;0;117493;47971;0;28.5;11.6;0.0
40;2021-04-28;2235;1479;0;119728;49450;0;29.1;12.0;0.0
40;2021-04-29;2772;1939;0;122500;51389;0;29.7;12.5;0.0
40;2021-04-30;2834;1685;0;125334;53074;0;30.4;12.9;0.0
40;2021-05-01;1349;766;0;126683;53840;0;30.7;13.1;0.0
40;2021-05-02;216;309;0;126899;54149;0;30.8;13.1;0.0
40;2021-05-03;1962;1589;0;128861;55738;0;31.3;13.5;0.0
40;2021-05-04;2091;2600;0;130952;58338;0;31.8;14.2;0.0
40;2021-05-05;2388;2663;0;133340;61001;0;32.4;14.8;0.0
40;2021-05-06;2512;2889;0;135852;63890;0;33.0;15.5;0.0
40;2021-05-07;2149;3068;0;138001;66958;0;33.5;16.3;0.0
40;2021-05-08;791;471;0;138792;67429;0;33.7;16.4;0.0
40;2021-05-09;393;65;0;139185;67494;0;33.8;16.4;0.0
40;2021-05-10;1559;2233;0;140744;69727;0;34.2;16.9;0.0
40;2021-05-11;2447;2714;0;143191;72441;0;34.8;17.6;0.0
40;2021-05-12;2929;2076;0;146120;74517;0;35.5;18.1;0.0
40;2021-05-13;2113;533;0;148233;75050;0;36.0;18.2;0.0
40;2021-05-14;2485;1769;0;150718;76819;0;36.6;18.6;0.0
40;2021-05-15;1503;1009;0;152221;77828;0;36.9;18.9;0.0
40;2021-05-16;487;81;0;152708;77909;0;37.1;18.9;0.0
40;2021-05-17;2347;1472;0;155055;79381;0;37.6;19.3;0.0
40;2021-05-18;2715;1498;0;157770;80879;0;38.3;19.6;0.0
40;2021-05-19;3149;1185;0;160919;82064;0;39.1;19.9;0.0
40;2021-05-20;3732;1290;0;164651;83354;0;40.0;20.2;0.0
40;2021-05-21;3079;1427;0;167730;84781;0;40.7;20.6;0.0
40;2021-05-22;1377;865;0;169107;85646;0;41.0;20.8;0.0
40;2021-05-23;623;67;0;169730;85713;0;41.2;20.8;0.0
40;2021-05-24;1318;458;0;171048;86171;0;41.5;20.9;0.0
40;2021-05-25;2338;1445;0;173386;87616;0;42.1;21.3;0.0
40;2021-05-26;2795;1653;0;176181;89269;0;42.8;21.7;0.0
40;2021-05-27;2880;2041;0;179061;91310;0;43.5;22.2;0.0
40;2021-05-28;2794;2347;0;181855;93657;0;44.1;22.7;0.0
40;2021-05-29;1730;1330;0;183585;94987;0;44.6;23.1;0.0
40;2021-05-30;99;84;0;183684;95071;0;44.6;23.1;0.0
40;2021-05-31;2723;1349;0;186407;96420;0;45.2;23.4;0.0
40;2021-06-01;3171;1915;0;189578;98335;0;46.0;23.9;0.0
40;2021-06-02;3298;2102;0;192876;100437;0;46.8;24.4;0.0
40;2021-06-03;3746;2361;0;196622;102798;0;47.7;25.0;0.0
40;2021-06-04;3200;2866;0;199822;105664;0;48.5;25.6;0.0
40;2021-06-05;1952;1453;0;201774;107117;0;49.0;26.0;0.0
40;2021-06-06;568;108;0;202342;107225;0;49.1;26.0;0.0
40;2021-06-07;2348;2089;0;204690;109314;0;49.7;26.5;0.0
40;2021-06-08;3200;2233;0;207890;111547;0;50.5;27.1;0.0
40;2021-06-09;3329;2340;0;211219;113887;0;51.3;27.6;0.0
40;2021-06-10;3176;2124;0;214395;116011;0;52.0;28.2;0.0
40;2021-06-11;3268;2972;0;217663;118983;0;52.8;28.9;0.0
40;2021-06-12;2056;1718;0;219719;120701;0;53.3;29.3;0.0
40;2021-06-13;650;199;0;220369;120900;0;53.5;29.3;0.0
40;2021-06-14;1604;2699;0;221973;123599;0;53.9;30.0;0.0
40;2021-06-15;2337;2976;0;224310;126575;0;54.4;30.7;0.0
40;2021-06-16;2690;2687;0;227000;129262;0;55.1;31.4;0.0
40;2021-06-17;2537;2615;0;229537;131877;0;55.7;32.0;0.0
40;2021-06-18;2441;3074;0;231978;134951;0;56.3;32.8;0.0
40;2021-06-19;1811;1337;0;233789;136288;0;56.7;33.1;0.0
40;2021-06-20;338;320;0;234127;136608;0;56.8;33.2;0.0
40;2021-06-21;1336;2613;0;235463;139221;0;57.2;33.8;0.0
40;2021-06-22;1714;3213;0;237177;142434;0;57.6;34.6;0.0
40;2021-06-23;1650;3532;0;238827;145966;0;58.0;35.4;0.0
40;2021-06-24;1728;2375;0;240555;148341;0;58.4;36.0;0.0
40;2021-06-25;1831;3403;0;242386;151744;0;58.8;36.8;0.0
40;2021-06-26;1333;1838;0;243719;153582;0;59.2;37.3;0.0
40;2021-06-27;296;427;0;244015;154009;0;59.2;37.4;0.0
40;2021-06-28;1359;3069;0;245374;157078;0;59.6;38.1;0.0
40;2021-06-29;1606;3656;0;246980;160734;0;59.9;39.0;0.0
40;2021-06-30;1795;3819;0;248775;164553;0;60.4;39.9;0.0
40;2021-07-01;1737;4021;0;250512;168574;0;60.8;40.9;0.0
40;2021-07-02;1547;3968;0;252059;172542;0;61.2;41.9;0.0
40;2021-07-03;718;2068;0;252777;174610;0;61.4;42.4;0.0
40;2021-07-04;219;586;0;252996;175196;0;61.4;42.5;0.0
40;2021-07-05;1382;3083;0;254378;178279;0;61.7;43.3;0.0
40;2021-07-06;1664;3681;0;256042;181960;0;62.1;44.2;0.0
40;2021-07-07;1824;3878;0;257866;185838;0;62.6;45.1;0.0
40;2021-07-08;1871;3350;0;259737;189188;0;63.0;45.9;0.0
40;2021-07-09;1679;3995;0;261416;193183;0;63.5;46.9;0.0
40;2021-07-10;842;2226;0;262258;195409;0;63.7;47.4;0.0
40;2021-07-11;160;331;0;262418;195740;0;63.7;47.5;0.0
40;2021-07-12;1068;3913;0;263486;199653;0;64.0;48.5;0.0
40;2021-07-13;1979;4562;0;265465;204215;0;64.4;49.6;0.0
40;2021-07-14;1741;1935;0;267206;206150;0;64.9;50.0;0.0
40;2021-07-15;2253;4695;0;269459;210845;0;65.4;51.2;0.0
40;2021-07-16;2647;3761;0;272106;214606;0;66.0;52.1;0.0
40;2021-07-17;1616;2621;0;273722;217227;0;66.4;52.7;0.0
40;2021-07-18;319;597;0;274041;217824;0;66.5;52.9;0.0
40;2021-07-19;1906;3580;0;275947;221404;0;67.0;53.7;0.0
40;2021-07-20;2310;3784;0;278257;225188;0;67.5;54.7;0.0
40;2021-07-21;2505;3710;0;280762;228898;0;68.1;55.6;0.0
40;2021-07-22;2873;3689;0;283635;232587;0;68.8;56.5;0.0
40;2021-07-23;3098;3849;0;286733;236436;0;69.6;57.4;0.0
40;2021-07-24;2026;2014;0;288759;238450;0;70.1;57.9;0.0
40;2021-07-25;686;465;0;289445;238915;0;70.3;58.0;0.0
40;2021-07-26;2184;2721;0;291629;241636;0;70.8;58.7;0.0
40;2021-07-27;2579;3204;0;294208;244840;0;71.4;59.4;0.0
40;2021-07-28;2703;2981;0;296911;247821;0;72.1;60.2;0.0
40;2021-07-29;2766;2992;0;299677;250813;0;72.7;60.9;0.0
40;2021-07-30;2515;2941;0;302192;253754;0;73.4;61.6;0.0
40;2021-07-31;1472;1707;0;303664;255461;0;73.7;62.0;0.0
40;2021-08-01;233;194;0;303897;255655;0;73.8;62.1;0.0
40;2021-08-02;1636;1944;0;305533;257599;0;74.2;62.5;0.0
40;2021-08-03;1962;2208;0;307495;259807;0;74.6;63.1;0.0
40;2021-08-04;1787;1932;0;309282;261739;0;75.1;63.5;0.0
40;2021-08-05;1675;2208;0;310957;263947;0;75.5;64.1;0.0
40;2021-08-06;1594;2497;0;312551;266444;0;75.9;64.7;0.0
40;2021-08-07;1086;1512;0;313637;267956;0;76.1;65.0;0.0
40;2021-08-08;97;136;0;313734;268092;0;76.2;65.1;0.0
40;2021-08-09;1319;2283;0;315053;270375;0;76.5;65.6;0.0
40;2021-08-10;1263;2394;0;316316;272769;0;76.8;66.2;0.0
40;2021-08-11;1184;2039;0;317500;274808;0;77.1;66.7;0.0
40;2021-08-12;1103;2288;0;318603;277096;0;77.3;67.3;0.0
40;2021-08-13;980;2194;0;319583;279290;0;77.6;67.8;0.0
40;2021-08-14;566;1694;0;320149;280984;0;77.7;68.2;0.0
40;2021-08-15;27;219;0;320176;281203;0;77.7;68.3;0.0
40;2021-08-16;946;2557;0;321122;283760;0;77.9;68.9;0.0
40;2021-08-17;1016;2674;0;322138;286434;0;78.2;69.5;0.0
40;2021-08-18;853;2702;0;322991;289136;0;78.4;70.2;0.0
40;2021-08-19;789;2432;0;323780;291568;0;78.6;70.8;0.0
40;2021-08-20;757;2524;0;324537;294092;0;78.8;71.4;0.0
40;2021-08-21;456;1598;0;324993;295690;0;78.9;71.8;0.0
40;2021-08-22;79;394;0;325072;296084;0;78.9;71.9;0.0
40;2021-08-23;646;2426;0;325718;298510;0;79.1;72.5;0.0
40;2021-08-24;614;2257;0;326332;300767;0;79.2;73.0;0.0
40;2021-08-25;600;1808;0;326932;302575;0;79.4;73.4;0.0
40;2021-08-26;448;1552;0;327380;304127;0;79.5;73.8;0.0
40;2021-08-27;596;2231;0;327976;306358;0;79.6;74.4;0.0
40;2021-08-28;303;1147;0;328279;307505;0;79.7;74.6;0.0
40;2021-08-29;12;67;0;328291;307572;0;79.7;74.7;0.0
40;2021-08-30;571;1956;46;328862;309528;46;79.8;75.1;0.0
40;2021-08-31;463;1428;83;329325;310956;129;79.9;75.5;0.0
40;2021-09-01;475;1313;196;329800;312269;325;80.1;75.8;0.1
40;2021-09-02;425;1278;321;330225;313547;646;80.2;76.1;0.2
40;2021-09-03;441;1337;296;330666;314884;942;80.3;76.4;0.2
40;2021-09-04;352;977;133;331018;315861;1075;80.3;76.7;0.3
40;2021-09-05;12;41;24;331030;315902;1099;80.4;76.7;0.3
40;2021-09-06;254;704;198;331284;316606;1297;80.4;76.9;0.3
40;2021-09-07;273;789;217;331557;317395;1514;80.5;77.0;0.4
40;2021-09-08;372;917;322;331929;318312;1836;80.6;77.3;0.4
40;2021-09-09;278;721;310;332207;319033;2146;80.6;77.4;0.5
40;2021-09-10;371;987;341;332578;320020;2487;80.7;77.7;0.6
40;2021-09-11;263;703;123;332841;320723;2610;80.8;77.8;0.6
40;2021-09-12;25;31;2;332866;320754;2612;80.8;77.9;0.6
40;2021-09-13;353;576;404;333219;321330;3016;80.9;78.0;0.7
40;2021-09-14;316;402;546;333535;321732;3562;81.0;78.1;0.9
40;2021-09-15;414;849;602;333949;322581;4164;81.1;78.3;1.0
40;2021-09-16;257;347;357;334206;322928;4521;81.1;78.4;1.1
40;2021-09-17;353;795;625;334559;323723;5146;81.2;78.6;1.2
40;2021-09-18;189;599;161;334748;324322;5307;81.3;78.7;1.3
40;2021-09-19;3;17;21;334751;324339;5328;81.3;78.7;1.3
40;2021-09-20;165;398;377;334916;324737;5705;81.3;78.8;1.4
40;2021-09-21;161;268;474;335077;325005;6179;81.3;78.9;1.5
40;2021-09-22;233;584;442;335310;325589;6621;81.4;79.0;1.6
40;2021-09-23;160;296;669;335470;325885;7290;81.4;79.1;1.8
40;2021-09-24;240;590;405;335710;326475;7695;81.5;79.2;1.9
40;2021-09-25;137;416;151;335847;326891;7846;81.5;79.3;1.9
40;2021-09-26;1;9;3;335848;326900;7849;81.5;79.3;1.9
40;2021-09-27;106;252;236;335954;327152;8085;81.5;79.4;2.0
40;2021-09-28;77;237;406;336031;327389;8491;81.6;79.5;2.1
40;2021-09-29;219;550;361;336250;327939;8852;81.6;79.6;2.1
40;2021-09-30;107;226;379;336357;328165;9231;81.6;79.7;2.2
40;2021-10-01;262;403;469;336619;328568;9700;81.7;79.8;2.4
40;2021-10-02;198;342;142;336817;328910;9842;81.8;79.8;2.4
40;2021-10-03;1;11;0;336818;328921;9842;81.8;79.8;2.4
40;2021-10-04;121;245;323;336939;329166;10165;81.8;79.9;2.5
40;2021-10-05;102;243;390;337041;329409;10555;81.8;80.0;2.6
40;2021-10-06;265;425;684;337306;329834;11239;81.9;80.1;2.7
40;2021-10-07;112;228;460;337418;330062;11699;81.9;80.1;2.8
40;2021-10-08;204;447;817;337622;330509;12516;82.0;80.2;3.0
40;2021-10-09;139;225;223;337761;330734;12739;82.0;80.3;3.1
40;2021-10-10;3;15;4;337764;330749;12743;82.0;80.3;3.1
40;2021-10-11;82;172;340;337846;330921;13083;82.0;80.3;3.2
40;2021-10-12;101;166;415;337947;331087;13498;82.0;80.4;3.3
40;2021-10-13;210;371;800;338157;331458;14298;82.1;80.5;3.5
40;2021-10-14;77;151;659;338234;331609;14957;82.1;80.5;3.6
40;2021-10-15;148;325;774;338382;331934;15731;82.1;80.6;3.8
40;2021-10-16;116;184;240;338498;332118;15971;82.2;80.6;3.9
40;2021-10-17;2;2;3;338500;332120;15974;82.2;80.6;3.9
40;2021-10-18;76;165;452;338576;332285;16426;82.2;80.7;4.0
40;2021-10-19;92;127;507;338668;332412;16933;82.2;80.7;4.1
40;2021-10-20;192;266;1212;338860;332678;18145;82.3;80.8;4.4
40;2021-10-21;107;149;650;338967;332827;18795;82.3;80.8;4.6
40;2021-10-22;157;232;950;339124;333059;19745;82.3;80.8;4.8
40;2021-10-23;130;218;410;339254;333277;20155;82.3;80.9;4.9
40;2021-10-24;2;4;12;339256;333281;20167;82.3;80.9;4.9
40;2021-10-25;90;125;555;339346;333406;20722;82.4;80.9;5.0
40;2021-10-26;90;95;669;339436;333501;21391;82.4;81.0;5.2
40;2021-10-27;167;267;1307;339603;333768;22698;82.4;81.0;5.5
40;2021-10-28;82;98;686;339685;333866;23384;82.5;81.0;5.7
40;2021-10-29;134;190;1131;339819;334056;24515;82.5;81.1;6.0
40;2021-10-30;106;151;386;339925;334207;24901;82.5;81.1;6.0
40;2021-10-31;2;5;5;339927;334212;24906;82.5;81.1;6.0
40;2021-11-01;15;7;7;339942;334219;24913;82.5;81.1;6.0
40;2021-11-02;91;154;689;340033;334373;25602;82.5;81.2;6.2
40;2021-11-03;161;197;1455;340194;334570;27057;82.6;81.2;6.6
40;2021-11-04;105;130;913;340299;334700;27970;82.6;81.2;6.8
40;2021-11-05;116;168;1438;340415;334868;29408;82.6;81.3;7.1
40;2021-11-06;74;90;377;340489;334958;29785;82.6;81.3;7.2
40;2021-11-07;0;6;3;340489;334964;29788;82.6;81.3;7.2
40;2021-11-08;69;105;969;340558;335069;30757;82.7;81.3;7.5
40;2021-11-09;108;147;1484;340666;335216;32241;82.7;81.4;7.8
40;2021-11-10;151;198;1873;340817;335414;34114;82.7;81.4;8.3
40;2021-11-11;27;20;140;340844;335434;34254;82.7;81.4;8.3
40;2021-11-12;154;207;1927;340998;335641;36181;82.8;81.5;8.8
40;2021-11-13;66;103;450;341064;335744;36631;82.8;81.5;8.9
40;2021-11-14;2;8;6;341066;335752;36637;82.8;81.5;8.9
40;2021-11-15;100;87;1071;341166;335839;37708;82.8;81.5;9.2
40;2021-11-16;110;102;1913;341276;335941;39621;82.8;81.5;9.6
40;2021-11-17;166;167;2006;341442;336108;41627;82.9;81.6;10.1
40;2021-11-18;106;109;1639;341548;336217;43266;82.9;81.6;10.5
40;2021-11-19;164;197;2286;341712;336414;45552;82.9;81.7;11.1
40;2021-11-20;116;151;723;341828;336565;46275;83.0;81.7;11.2
40;2021-11-21;1;7;3;341829;336572;46278;83.0;81.7;11.2
40;2021-11-22;69;46;1357;341898;336618;47635;83.0;81.7;11.6
40;2021-11-23;138;109;2208;342036;336727;49843;83.0;81.7;12.1
40;2021-11-24;202;209;2249;342238;336936;52092;83.1;81.8;12.6
40;2021-11-25;115;120;2046;342353;337056;54138;83.1;81.8;13.1
40;2021-11-26;158;193;3013;342511;337249;57151;83.1;81.9;13.9
40;2021-11-27;81;112;905;342592;337361;58056;83.2;81.9;14.1
40;2021-11-28;9;8;266;342601;337369;58322;83.2;81.9;14.2
40;2021-11-29;73;99;2427;342674;337468;60749;83.2;81.9;14.7
40;2021-11-30;163;128;3680;342837;337596;64429;83.2;81.9;15.6
40;2021-12-01;133;174;4109;342970;337770;68538;83.2;82.0;16.6
40;2021-12-02;97;108;4221;343067;337878;72759;83.3;82.0;17.7
40;2021-12-03;138;205;4730;343205;338083;77489;83.3;82.1;18.8
40;2021-12-04;72;96;1568;343277;338179;79057;83.3;82.1;19.2
40;2021-12-05;9;9;269;343286;338188;79326;83.3;82.1;19.3
40;2021-12-06;126;157;4127;343412;338345;83453;83.4;82.1;20.3
40;2021-12-07;129;162;5720;343541;338507;89173;83.4;82.2;21.6
40;2021-12-08;139;184;4809;343680;338691;93982;83.4;82.2;22.8
40;2021-12-09;123;135;6057;343803;338826;100039;83.5;82.2;24.3
40;2021-12-10;136;194;5826;343939;339020;105865;83.5;82.3;25.7
40;2021-12-11;87;158;2282;344026;339178;108147;83.5;82.3;26.3
40;2021-12-12;19;8;382;344045;339186;108529;83.5;82.3;26.3
40;2021-12-13;99;127;4544;344144;339313;113073;83.5;82.4;27.4
40;2021-12-14;142;173;6142;344286;339486;119215;83.6;82.4;28.9
40;2021-12-15;143;217;5468;344429;339703;124683;83.6;82.5;30.3
40;2021-12-16;126;159;6410;344555;339862;131093;83.6;82.5;31.8
41;2020-12-27;0;0;0;0;0;0;0.0;0.0;0.0
41;2020-12-28;0;0;0;0;0;0;0.0;0.0;0.0
41;2020-12-29;1;0;0;1;0;0;0.0;0.0;0.0
41;2020-12-30;0;0;0;1;0;0;0.0;0.0;0.0
41;2020-12-31;0;0;0;1;0;0;0.0;0.0;0.0
41;2021-01-01;1;0;0;2;0;0;0.0;0.0;0.0
41;2021-01-02;0;0;0;2;0;0;0.0;0.0;0.0
41;2021-01-03;0;0;0;2;0;0;0.0;0.0;0.0
41;2021-01-04;0;0;0;2;0;0;0.0;0.0;0.0
41;2021-01-05;39;0;0;41;0;0;0.0;0.0;0.0
41;2021-01-06;51;0;0;92;0;0;0.0;0.0;0.0
41;2021-01-07;30;0;0;122;0;0;0.0;0.0;0.0
41;2021-01-08;10;0;0;132;0;0;0.0;0.0;0.0
41;2021-01-09;5;0;0;137;0;0;0.0;0.0;0.0
41;2021-01-10;2;0;0;139;0;0;0.0;0.0;0.0
41;2021-01-11;150;0;0;289;0;0;0.1;0.0;0.0
41;2021-01-12;318;1;0;607;1;0;0.2;0.0;0.0
41;2021-01-13;295;1;0;902;2;0;0.3;0.0;0.0
41;2021-01-14;307;2;0;1209;4;0;0.4;0.0;0.0
41;2021-01-15;236;2;0;1445;6;0;0.4;0.0;0.0
41;2021-01-16;3;0;0;1448;6;0;0.4;0.0;0.0
41;2021-01-17;17;0;0;1465;6;0;0.4;0.0;0.0
41;2021-01-18;412;1;0;1877;7;0;0.6;0.0;0.0
41;2021-01-19;844;2;0;2721;9;0;0.8;0.0;0.0
41;2021-01-20;1102;6;0;3823;15;0;1.2;0.0;0.0
41;2021-01-21;1511;10;0;5334;25;0;1.6;0.0;0.0
41;2021-01-22;858;1;0;6192;26;0;1.9;0.0;0.0
41;2021-01-23;91;0;0;6283;26;0;1.9;0.0;0.0
41;2021-01-24;2;0;0;6285;26;0;1.9;0.0;0.0
41;2021-01-25;414;4;0;6699;30;0;2.0;0.0;0.0
41;2021-01-26;534;9;0;7233;39;0;2.2;0.0;0.0
41;2021-01-27;439;3;0;7672;42;0;2.3;0.0;0.0
41;2021-01-28;606;63;0;8278;105;0;2.5;0.0;0.0
41;2021-01-29;280;27;0;8558;132;0;2.6;0.0;0.0
41;2021-01-30;9;2;0;8567;134;0;2.6;0.0;0.0
41;2021-01-31;0;0;0;8567;134;0;2.6;0.0;0.0
41;2021-02-01;346;143;0;8913;277;0;2.7;0.1;0.0
41;2021-02-02;458;239;0;9371;516;0;2.9;0.2;0.0
41;2021-02-03;363;214;0;9734;730;0;3.0;0.2;0.0
41;2021-02-04;499;189;0;10233;919;0;3.1;0.3;0.0
41;2021-02-05;360;208;0;10593;1127;0;3.2;0.3;0.0
41;2021-02-06;10;5;0;10603;1132;0;3.2;0.3;0.0
41;2021-02-07;4;1;0;10607;1133;0;3.2;0.3;0.0
41;2021-02-08;334;299;0;10941;1432;0;3.3;0.4;0.0
41;2021-02-09;548;434;0;11489;1866;0;3.5;0.6;0.0
41;2021-02-10;501;651;0;11990;2517;0;3.7;0.8;0.0
41;2021-02-11;987;1083;0;12977;3600;0;4.0;1.1;0.0
41;2021-02-12;671;364;0;13648;3964;0;4.2;1.2;0.0
41;2021-02-13;17;14;0;13665;3978;0;4.2;1.2;0.0
41;2021-02-14;1;41;0;13666;4019;0;4.2;1.2;0.0
41;2021-02-15;323;320;0;13989;4339;0;4.3;1.3;0.0
41;2021-02-16;363;556;0;14352;4895;0;4.4;1.5;0.0
41;2021-02-17;344;475;0;14696;5370;0;4.5;1.6;0.0
41;2021-02-18;582;384;0;15278;5754;0;4.7;1.8;0.0
41;2021-02-19;460;353;0;15738;6107;0;4.8;1.9;0.0
41;2021-02-20;82;56;0;15820;6163;0;4.8;1.9;0.0
41;2021-02-21;0;0;0;15820;6163;0;4.8;1.9;0.0
41;2021-02-22;339;411;0;16159;6574;0;4.9;2.0;0.0
41;2021-02-23;482;354;0;16641;6928;0;5.1;2.1;0.0
41;2021-02-24;317;451;0;16958;7379;0;5.2;2.3;0.0
41;2021-02-25;667;468;0;17625;7847;0;5.4;2.4;0.0
41;2021-02-26;638;271;0;18263;8118;0;5.6;2.5;0.0
41;2021-02-27;178;15;0;18441;8133;0;5.6;2.5;0.0
41;2021-02-28;3;30;0;18444;8163;0;5.6;2.5;0.0
41;2021-03-01;333;334;0;18777;8497;0;5.7;2.6;0.0
41;2021-03-02;595;425;0;19372;8922;0;5.9;2.7;0.0
41;2021-03-03;534;466;0;19906;9388;0;6.1;2.9;0.0
41;2021-03-04;794;790;0;20700;10178;0;6.3;3.1;0.0
41;2021-03-05;858;652;0;21558;10830;0;6.6;3.3;0.0
41;2021-03-06;746;24;0;22304;10854;0;6.8;3.3;0.0
41;2021-03-07;467;26;0;22771;10880;0;6.9;3.3;0.0
41;2021-03-08;312;377;0;23083;11257;0;7.0;3.4;0.0
41;2021-03-09;1042;449;0;24125;11706;0;7.4;3.6;0.0
41;2021-03-10;776;464;0;24901;12170;0;7.6;3.7;0.0
41;2021-03-11;1176;678;0;26077;12848;0;8.0;3.9;0.0
41;2021-03-12;1188;414;0;27265;13262;0;8.3;4.0;0.0
41;2021-03-13;1192;26;0;28457;13288;0;8.7;4.1;0.0
41;2021-03-14;357;6;0;28814;13294;0;8.8;4.1;0.0
41;2021-03-15;786;354;0;29600;13648;0;9.0;4.2;0.0
41;2021-03-16;940;420;0;30540;14068;0;9.3;4.3;0.0
41;2021-03-17;585;256;0;31125;14324;0;9.5;4.4;0.0
41;2021-03-18;881;397;0;32006;14721;0;9.8;4.5;0.0
41;2021-03-19;915;332;0;32921;15053;0;10.0;4.6;0.0
41;2021-03-20;531;22;0;33452;15075;0;10.2;4.6;0.0
41;2021-03-21;8;0;0;33460;15075;0;10.2;4.6;0.0
41;2021-03-22;781;312;0;34241;15387;0;10.4;4.7;0.0
41;2021-03-23;1201;521;0;35442;15908;0;10.8;4.9;0.0
41;2021-03-24;1255;397;0;36697;16305;0;11.2;5.0;0.0
41;2021-03-25;1890;421;0;38587;16726;0;11.8;5.1;0.0
41;2021-03-26;1577;338;0;40164;17064;0;12.3;5.2;0.0
41;2021-03-27;467;68;0;40631;17132;0;12.4;5.2;0.0
41;2021-03-28;7;1;0;40638;17133;0;12.4;5.2;0.0
41;2021-03-29;928;312;0;41566;17445;0;12.7;5.3;0.0
41;2021-03-30;1462;541;0;43028;17986;0;13.1;5.5;0.0
41;2021-03-31;1141;516;0;44169;18502;0;13.5;5.6;0.0
41;2021-04-01;2103;540;0;46272;19042;0;14.1;5.8;0.0
41;2021-04-02;1251;469;0;47523;19511;0;14.5;6.0;0.0
41;2021-04-03;347;28;0;47870;19539;0;14.6;6.0;0.0
41;2021-04-04;54;2;0;47924;19541;0;14.6;6.0;0.0
41;2021-04-05;142;2;0;48066;19543;0;14.7;6.0;0.0
41;2021-04-06;1299;607;0;49365;20150;0;15.1;6.1;0.0
41;2021-04-07;1857;666;0;51222;20816;0;15.6;6.3;0.0
41;2021-04-08;2219;882;0;53441;21698;0;16.3;6.6;0.0
41;2021-04-09;2522;602;0;55963;22300;0;17.1;6.8;0.0
41;2021-04-10;1053;465;0;57016;22765;0;17.4;6.9;0.0
41;2021-04-11;293;346;0;57309;23111;0;17.5;7.0;0.0
41;2021-04-12;1713;635;0;59022;23746;0;18.0;7.2;0.0
41;2021-04-13;2248;893;0;61270;24639;0;18.7;7.5;0.0
41;2021-04-14;1845;557;0;63115;25196;0;19.3;7.7;0.0
41;2021-04-15;2396;934;0;65511;26130;0;20.0;8.0;0.0
41;2021-04-16;1983;619;0;67494;26749;0;20.6;8.2;0.0
41;2021-04-17;761;120;0;68255;26869;0;20.8;8.2;0.0
41;2021-04-18;26;9;0;68281;26878;0;20.8;8.2;0.0
41;2021-04-19;1299;665;0;69580;27543;0;21.2;8.4;0.0
41;2021-04-20;1965;1040;0;71545;28583;0;21.8;8.7;0.0
41;2021-04-21;1548;828;0;73093;29411;0;22.3;9.0;0.0
41;2021-04-22;2197;1385;0;75290;30796;0;23.0;9.4;0.0
41;2021-04-23;1736;1023;0;77026;31819;0;23.5;9.7;0.0
41;2021-04-24;1422;279;0;78448;32098;0;23.9;9.8;0.0
41;2021-04-25;792;15;0;79240;32113;0;24.2;9.8;0.0
41;2021-04-26;1381;638;0;80621;32751;0;24.6;10.0;0.0
41;2021-04-27;2112;1027;0;82733;33778;0;25.2;10.3;0.0
41;2021-04-28;1620;892;0;84353;34670;0;25.7;10.6;0.0
41;2021-04-29;2204;1311;0;86557;35981;0;26.4;11.0;0.0
41;2021-04-30;1993;871;0;88550;36852;0;27.0;11.2;0.0
41;2021-05-01;216;26;0;88766;36878;0;27.1;11.2;0.0
41;2021-05-02;134;22;0;88900;36900;0;27.1;11.3;0.0
41;2021-05-03;1824;953;0;90724;37853;0;27.7;11.5;0.0
41;2021-05-04;2043;1528;0;92767;39381;0;28.3;12.0;0.0
41;2021-05-05;1922;1229;0;94689;40610;0;28.9;12.4;0.0
41;2021-05-06;2353;1654;0;97042;42264;0;29.6;12.9;0.0
41;2021-05-07;2004;1814;0;99046;44078;0;30.2;13.4;0.0
41;2021-05-08;227;171;0;99273;44249;0;30.3;13.5;0.0
41;2021-05-09;34;373;0;99307;44622;0;30.3;13.6;0.0
41;2021-05-10;1585;1595;0;100892;46217;0;30.8;14.1;0.0
41;2021-05-11;1998;2057;0;102890;48274;0;31.4;14.7;0.0
41;2021-05-12;1953;1687;0;104843;49961;0;32.0;15.2;0.0
41;2021-05-13;1283;897;0;106126;50858;0;32.4;15.5;0.0
41;2021-05-14;1570;1345;0;107696;52203;0;32.9;15.9;0.0
41;2021-05-15;381;354;0;108077;52557;0;33.0;16.0;0.0
41;2021-05-16;41;13;0;108118;52570;0;33.0;16.0;0.0
41;2021-05-17;2364;620;0;110482;53190;0;33.7;16.2;0.0
41;2021-05-18;3027;1004;0;113509;54194;0;34.6;16.5;0.0
41;2021-05-19;2534;725;0;116043;54919;0;35.4;16.8;0.0
41;2021-05-20;3128;1106;0;119171;56025;0;36.4;17.1;0.0
41;2021-05-21;2560;1014;0;121731;57039;0;37.1;17.4;0.0
41;2021-05-22;528;259;0;122259;57298;0;37.3;17.5;0.0
41;2021-05-23;40;10;0;122299;57308;0;37.3;17.5;0.0
41;2021-05-24;2196;130;0;124495;57438;0;38.0;17.5;0.0
41;2021-05-25;2777;638;0;127272;58076;0;38.8;17.7;0.0
41;2021-05-26;2825;751;0;130097;58827;0;39.7;17.9;0.0
41;2021-05-27;3052;1169;0;133149;59996;0;40.6;18.3;0.0
41;2021-05-28;2977;1113;0;136126;61109;0;41.5;18.6;0.0
41;2021-05-29;2045;480;0;138171;61589;0;42.1;18.8;0.0
41;2021-05-30;316;41;0;138487;61630;0;42.2;18.8;0.0
41;2021-05-31;1837;1571;0;140324;63201;0;42.8;19.3;0.0
41;2021-06-01;2324;1931;0;142648;65132;0;43.5;19.9;0.0
41;2021-06-02;1977;1331;0;144625;66463;0;44.1;20.3;0.0
41;2021-06-03;2639;1890;0;147264;68353;0;44.9;20.8;0.0
41;2021-06-04;2324;1964;0;149588;70317;0;45.6;21.4;0.0
41;2021-06-05;888;1404;0;150476;71721;0;45.9;21.9;0.0
41;2021-06-06;135;742;0;150611;72463;0;45.9;22.1;0.0
41;2021-06-07;1664;1640;0;152275;74103;0;46.4;22.6;0.0
41;2021-06-08;1888;2324;0;154163;76427;0;47.0;23.3;0.0
41;2021-06-09;1815;1655;0;155978;78082;0;47.6;23.8;0.0
41;2021-06-10;2142;1811;0;158120;79893;0;48.2;24.4;0.0
41;2021-06-11;1738;1834;0;159858;81727;0;48.8;24.9;0.0
41;2021-06-12;912;740;0;160770;82467;0;49.0;25.2;0.0
41;2021-06-13;59;84;0;160829;82551;0;49.1;25.2;0.0
41;2021-06-14;1465;1987;0;162294;84538;0;49.5;25.8;0.0
41;2021-06-15;1988;2679;0;164282;87217;0;50.1;26.6;0.0
41;2021-06-16;1918;2333;0;166200;89550;0;50.7;27.3;0.0
41;2021-06-17;2008;2476;0;168208;92026;0;51.3;28.1;0.0
41;2021-06-18;1801;2362;0;170009;94388;0;51.9;28.8;0.0
41;2021-06-19;667;612;0;170676;95000;0;52.1;29.0;0.0
41;2021-06-20;33;49;0;170709;95049;0;52.1;29.0;0.0
41;2021-06-21;1439;1830;0;172148;96879;0;52.5;29.6;0.0
41;2021-06-22;1705;2473;0;173853;99352;0;53.0;30.3;0.0
41;2021-06-23;1519;2061;0;175372;101413;0;53.5;30.9;0.0
41;2021-06-24;1495;2165;0;176867;103578;0;54.0;31.6;0.0
41;2021-06-25;1342;2605;0;178209;106183;0;54.4;32.4;0.0
41;2021-06-26;614;779;0;178823;106962;0;54.5;32.6;0.0
41;2021-06-27;13;50;0;178836;107012;0;54.6;32.6;0.0
41;2021-06-28;569;2711;0;179405;109723;0;54.7;33.5;0.0
41;2021-06-29;823;3365;0;180228;113088;0;55.0;34.5;0.0
41;2021-06-30;730;3073;0;180958;116161;0;55.2;35.4;0.0
41;2021-07-01;877;3018;0;181835;119179;0;55.5;36.4;0.0
41;2021-07-02;792;3382;0;182627;122561;0;55.7;37.4;0.0
41;2021-07-03;405;853;0;183032;123414;0;55.8;37.6;0.0
41;2021-07-04;14;36;0;183046;123450;0;55.8;37.7;0.0
41;2021-07-05;539;2823;0;183585;126273;0;56.0;38.5;0.0
41;2021-07-06;826;3474;0;184411;129747;0;56.3;39.6;0.0
41;2021-07-07;742;3155;0;185153;132902;0;56.5;40.5;0.0
41;2021-07-08;1125;3374;0;186278;136276;0;56.8;41.6;0.0
41;2021-07-09;761;3630;0;187039;139906;0;57.1;42.7;0.0
41;2021-07-10;437;2180;0;187476;142086;0;57.2;43.3;0.0
41;2021-07-11;18;287;0;187494;142373;0;57.2;43.4;0.0
41;2021-07-12;992;2586;0;188486;144959;0;57.5;44.2;0.0
41;2021-07-13;1370;3479;0;189856;148438;0;57.9;45.3;0.0
41;2021-07-14;247;1057;0;190103;149495;0;58.0;45.6;0.0
41;2021-07-15;1543;3480;0;191646;152975;0;58.5;46.7;0.0
41;2021-07-16;1330;3492;0;192976;156467;0;58.9;47.7;0.0
41;2021-07-17;602;1107;0;193578;157574;0;59.0;48.1;0.0
41;2021-07-18;55;67;0;193633;157641;0;59.1;48.1;0.0
41;2021-07-19;1366;2537;0;194999;160178;0;59.5;48.9;0.0
41;2021-07-20;1825;2930;0;196824;163108;0;60.0;49.8;0.0
41;2021-07-21;2012;2453;0;198836;165561;0;60.7;50.5;0.0
41;2021-07-22;2496;2591;0;201332;168152;0;61.4;51.3;0.0
41;2021-07-23;2308;2722;0;203640;170874;0;62.1;52.1;0.0
41;2021-07-24;538;1229;0;204178;172103;0;62.3;52.5;0.0
41;2021-07-25;58;50;0;204236;172153;0;62.3;52.5;0.0
41;2021-07-26;1947;2017;0;206183;174170;0;62.9;53.1;0.0
41;2021-07-27;2708;2505;0;208891;176675;0;63.7;53.9;0.0
41;2021-07-28;2445;2068;0;211336;178743;0;64.5;54.5;0.0
41;2021-07-29;2559;2268;0;213895;181011;0;65.2;55.2;0.0
41;2021-07-30;2316;2310;0;216211;183321;0;66.0;55.9;0.0
41;2021-07-31;678;815;0;216889;184136;0;66.2;56.2;0.0
41;2021-08-01;54;30;0;216943;184166;0;66.2;56.2;0.0
41;2021-08-02;1662;1843;0;218605;186009;0;66.7;56.7;0.0
41;2021-08-03;2606;2015;0;221211;188024;0;67.5;57.4;0.0
41;2021-08-04;2537;1404;0;223748;189428;0;68.3;57.8;0.0
41;2021-08-05;2891;1379;0;226639;190807;0;69.1;58.2;0.0
41;2021-08-06;2217;1361;0;228856;192168;0;69.8;58.6;0.0
41;2021-08-07;640;441;0;229496;192609;0;70.0;58.8;0.0
41;2021-08-08;46;39;0;229542;192648;0;70.0;58.8;0.0
41;2021-08-09;1688;1363;0;231230;194011;0;70.5;59.2;0.0
41;2021-08-10;2387;1488;0;233617;195499;0;71.3;59.6;0.0
41;2021-08-11;1554;1539;0;235171;197038;0;71.7;60.1;0.0
41;2021-08-12;1858;1460;0;237029;198498;0;72.3;60.5;0.0
41;2021-08-13;1427;1713;0;238456;200211;0;72.7;61.1;0.0
41;2021-08-14;410;344;0;238866;200555;0;72.9;61.2;0.0
41;2021-08-15;13;28;0;238879;200583;0;72.9;61.2;0.0
41;2021-08-16;889;2059;0;239768;202642;0;73.1;61.8;0.0
41;2021-08-17;1446;1820;0;241214;204462;0;73.6;62.4;0.0
41;2021-08-18;1170;2106;0;242384;206568;0;73.9;63.0;0.0
41;2021-08-19;1207;1734;0;243591;208302;0;74.3;63.5;0.0
41;2021-08-20;945;2384;0;244536;210686;0;74.6;64.3;0.0
41;2021-08-21;233;410;0;244769;211096;0;74.7;64.4;0.0
41;2021-08-22;7;54;0;244776;211150;0;74.7;64.4;0.0
41;2021-08-23;696;2288;0;245472;213438;0;74.9;65.1;0.0
41;2021-08-24;1223;2247;0;246695;215685;0;75.2;65.8;0.0
41;2021-08-25;643;2285;0;247338;217970;0;75.4;66.5;0.0
41;2021-08-26;774;2627;0;248112;220597;0;75.7;67.3;0.0
41;2021-08-27;619;2757;0;248731;223354;0;75.9;68.1;0.0
41;2021-08-28;141;773;0;248872;224127;0;75.9;68.4;0.0
41;2021-08-29;43;44;0;248915;224171;0;75.9;68.4;0.0
41;2021-08-30;712;2193;7;249627;226364;7;76.1;69.0;0.0
41;2021-08-31;708;2459;44;250335;228823;51;76.4;69.8;0.0
41;2021-09-01;571;1862;117;250906;230685;168;76.5;70.4;0.1
41;2021-09-02;514;1924;120;251420;232609;288;76.7;71.0;0.1
41;2021-09-03;630;2058;123;252050;234667;411;76.9;71.6;0.1
41;2021-09-04;232;729;39;252282;235396;450;77.0;71.8;0.1
41;2021-09-05;7;23;7;252289;235419;457;77.0;71.8;0.1
41;2021-09-06;317;1033;144;252606;236452;601;77.1;72.1;0.2
41;2021-09-07;389;1130;174;252995;237582;775;77.2;72.5;0.2
41;2021-09-08;376;1281;116;253371;238863;891;77.3;72.9;0.3
41;2021-09-09;302;1102;143;253673;239965;1034;77.4;73.2;0.3
41;2021-09-10;435;1250;191;254108;241215;1225;77.5;73.6;0.4
41;2021-09-11;155;528;30;254263;241743;1255;77.6;73.7;0.4
41;2021-09-12;5;8;1;254268;241751;1256;77.6;73.7;0.4
41;2021-09-13;236;637;247;254504;242388;1503;77.6;73.9;0.5
41;2021-09-14;333;734;255;254837;243122;1758;77.7;74.2;0.5
41;2021-09-15;298;1129;244;255135;244251;2002;77.8;74.5;0.6
41;2021-09-16;241;800;237;255376;245051;2239;77.9;74.7;0.7
41;2021-09-17;379;738;281;255755;245789;2520;78.0;75.0;0.8
41;2021-09-18;129;262;21;255884;246051;2541;78.1;75.1;0.8
41;2021-09-19;3;19;0;255887;246070;2541;78.1;75.1;0.8
41;2021-09-20;189;562;262;256076;246632;2803;78.1;75.2;0.9
41;2021-09-21;180;487;287;256256;247119;3090;78.2;75.4;0.9
41;2021-09-22;279;876;347;256535;247995;3437;78.3;75.6;1.0
41;2021-09-23;223;612;587;256758;248607;4024;78.3;75.8;1.2
41;2021-09-24;315;648;469;257073;249255;4493;78.4;76.0;1.4
41;2021-09-25;104;322;83;257177;249577;4576;78.4;76.1;1.4
41;2021-09-26;0;9;6;257177;249586;4582;78.4;76.1;1.4
41;2021-09-27;162;380;292;257339;249966;4874;78.5;76.2;1.5
41;2021-09-28;163;395;399;257502;250361;5273;78.5;76.4;1.6
41;2021-09-29;176;530;280;257678;250891;5553;78.6;76.5;1.7
41;2021-09-30;117;326;482;257795;251217;6035;78.6;76.6;1.8
41;2021-10-01;235;406;380;258030;251623;6415;78.7;76.8;2.0
41;2021-10-02;100;196;65;258130;251819;6480;78.7;76.8;2.0
41;2021-10-03;4;5;1;258134;251824;6481;78.7;76.8;2.0
41;2021-10-04;119;259;394;258253;252083;6875;78.8;76.9;2.1
41;2021-10-05;122;262;547;258375;252345;7422;78.8;77.0;2.3
41;2021-10-06;238;433;524;258613;252778;7946;78.9;77.1;2.4
41;2021-10-07;119;178;539;258732;252956;8485;78.9;77.2;2.6
41;2021-10-08;201;475;635;258933;253431;9120;79.0;77.3;2.8
41;2021-10-09;80;219;135;259013;253650;9255;79.0;77.4;2.8
41;2021-10-10;4;13;3;259017;253663;9258;79.0;77.4;2.8
41;2021-10-11;124;218;461;259141;253881;9719;79.0;77.4;3.0
41;2021-10-12;73;169;405;259214;254050;10124;79.1;77.5;3.1
41;2021-10-13;188;315;522;259402;254365;10646;79.1;77.6;3.2
41;2021-10-14;78;133;435;259480;254498;11081;79.1;77.6;3.4
41;2021-10-15;176;458;675;259656;254956;11756;79.2;77.8;3.6
41;2021-10-16;54;114;107;259710;255070;11863;79.2;77.8;3.6
41;2021-10-17;1;3;1;259711;255073;11864;79.2;77.8;3.6
41;2021-10-18;140;221;503;259851;255294;12367;79.3;77.9;3.8
41;2021-10-19;76;146;441;259927;255440;12808;79.3;77.9;3.9
41;2021-10-20;166;269;674;260093;255709;13482;79.3;78.0;4.1
41;2021-10-21;62;72;340;260155;255781;13822;79.4;78.0;4.2
41;2021-10-22;125;315;682;260280;256096;14504;79.4;78.1;4.4
41;2021-10-23;52;69;149;260332;256165;14653;79.4;78.1;4.5
41;2021-10-24;2;5;1;260334;256170;14654;79.4;78.1;4.5
41;2021-10-25;137;157;622;260471;256327;15276;79.5;78.2;4.7
41;2021-10-26;72;88;430;260543;256415;15706;79.5;78.2;4.8
41;2021-10-27;170;235;824;260713;256650;16530;79.5;78.3;5.0
41;2021-10-28;58;137;290;260771;256787;16820;79.5;78.3;5.1
41;2021-10-29;149;232;900;260920;257019;17720;79.6;78.4;5.4
41;2021-10-30;35;55;142;260955;257074;17862;79.6;78.4;5.4
41;2021-10-31;2;7;0;260957;257081;17862;79.6;78.4;5.4
41;2021-11-01;8;10;10;260965;257091;17872;79.6;78.4;5.5
41;2021-11-02;44;81;268;261009;257172;18140;79.6;78.4;5.5
41;2021-11-03;116;179;586;261125;257351;18726;79.7;78.5;5.7
41;2021-11-04;55;79;435;261180;257430;19161;79.7;78.5;5.8
41;2021-11-05;127;204;1225;261307;257634;20386;79.7;78.6;6.2
41;2021-11-06;60;75;317;261367;257709;20703;79.7;78.6;6.3
41;2021-11-07;0;7;8;261367;257716;20711;79.7;78.6;6.3
41;2021-11-08;60;160;1142;261427;257876;21853;79.7;78.7;6.7
41;2021-11-09;76;79;801;261503;257955;22654;79.8;78.7;6.9
41;2021-11-10;102;137;1010;261605;258092;23664;79.8;78.7;7.2
41;2021-11-11;0;11;15;261605;258103;23679;79.8;78.7;7.2
41;2021-11-12;98;122;926;261703;258225;24605;79.8;78.8;7.5
41;2021-11-13;57;84;287;261760;258309;24892;79.8;78.8;7.6
41;2021-11-14;4;6;5;261764;258315;24897;79.8;78.8;7.6
41;2021-11-15;81;85;978;261845;258400;25875;79.9;78.8;7.9
41;2021-11-16;74;70;1175;261919;258470;27050;79.9;78.8;8.3
41;2021-11-17;117;158;1106;262036;258628;28156;79.9;78.9;8.6
41;2021-11-18;98;114;1133;262134;258742;29289;80.0;78.9;8.9
41;2021-11-19;123;125;1525;262257;258867;30814;80.0;79.0;9.4
41;2021-11-20;79;80;498;262336;258947;31312;80.0;79.0;9.6
41;2021-11-21;2;2;28;262338;258949;31340;80.0;79.0;9.6
41;2021-11-22;70;61;1321;262408;259010;32661;80.0;79.0;10.0
41;2021-11-23;81;66;1187;262489;259076;33848;80.1;79.0;10.3
41;2021-11-24;116;112;1476;262605;259188;35324;80.1;79.1;10.8
41;2021-11-25;86;73;1409;262691;259261;36733;80.1;79.1;11.2
41;2021-11-26;138;137;2501;262829;259398;39234;80.2;79.1;12.0
41;2021-11-27;82;79;817;262911;259477;40051;80.2;79.1;12.2
41;2021-11-28;2;5;30;262913;259482;40081;80.2;79.2;12.2
41;2021-11-29;77;65;2339;262990;259547;42420;80.2;79.2;12.9
41;2021-11-30;65;84;1858;263055;259631;44278;80.2;79.2;13.5
41;2021-12-01;88;115;3249;263143;259746;47527;80.3;79.2;14.5
41;2021-12-02;93;74;2898;263236;259820;50425;80.3;79.3;15.4
41;2021-12-03;90;108;3514;263326;259928;53939;80.3;79.3;16.5
41;2021-12-04;57;83;1280;263383;260011;55219;80.3;79.3;16.8
41;2021-12-05;12;8;223;263395;260019;55442;80.3;79.3;16.9
41;2021-12-06;50;61;3559;263445;260080;59001;80.4;79.3;18.0
41;2021-12-07;102;119;4443;263547;260199;63444;80.4;79.4;19.4
41;2021-12-08;94;118;3925;263641;260317;67369;80.4;79.4;20.5
41;2021-12-09;106;106;4241;263747;260423;71610;80.5;79.4;21.8
41;2021-12-10;103;142;4438;263850;260565;76048;80.5;79.5;23.2
41;2021-12-11;54;62;1679;263904;260627;77727;80.5;79.5;23.7
41;2021-12-12;8;7;274;263912;260634;78001;80.5;79.5;23.8
41;2021-12-13;52;86;3666;263964;260720;81667;80.5;79.5;24.9
41;2021-12-14;92;112;5306;264056;260832;86973;80.5;79.6;26.5
41;2021-12-15;99;113;4446;264155;260945;91419;80.6;79.6;27.9
41;2021-12-16;119;131;4929;264274;261076;96348;80.6;79.6;29.4
42;2020-12-27;0;0;0;0;0;0;0.0;0.0;0.0
42;2020-12-28;3;0;0;3;0;0;0.0;0.0;0.0
42;2020-12-29;1;0;0;4;0;0;0.0;0.0;0.0
42;2020-12-30;0;0;0;4;0;0;0.0;0.0;0.0
42;2020-12-31;0;0;0;4;0;0;0.0;0.0;0.0
42;2021-01-01;0;0;0;4;0;0;0.0;0.0;0.0
42;2021-01-02;0;0;0;4;0;0;0.0;0.0;0.0
42;2021-01-03;0;0;0;4;0;0;0.0;0.0;0.0
42;2021-01-04;2;0;0;6;0;0;0.0;0.0;0.0
42;2021-01-05;3;0;0;9;0;0;0.0;0.0;0.0
42;2021-01-06;169;1;0;178;1;0;0.0;0.0;0.0
42;2021-01-07;252;0;0;430;1;0;0.1;0.0;0.0
42;2021-01-08;260;4;0;690;5;0;0.1;0.0;0.0
42;2021-01-09;130;1;0;820;6;0;0.1;0.0;0.0
42;2021-01-10;0;0;0;820;6;0;0.1;0.0;0.0
42;2021-01-11;282;2;0;1102;8;0;0.1;0.0;0.0
42;2021-01-12;403;1;0;1505;9;0;0.2;0.0;0.0
42;2021-01-13;501;2;0;2006;11;0;0.3;0.0;0.0
42;2021-01-14;755;5;0;2761;16;0;0.4;0.0;0.0
42;2021-01-15;692;3;0;3453;19;0;0.5;0.0;0.0
42;2021-01-16;281;2;0;3734;21;0;0.5;0.0;0.0
42;2021-01-17;211;0;0;3945;21;0;0.5;0.0;0.0
42;2021-01-18;952;0;0;4897;21;0;0.6;0.0;0.0
42;2021-01-19;1262;10;0;6159;31;0;0.8;0.0;0.0
42;2021-01-20;938;4;0;7097;35;0;0.9;0.0;0.0
42;2021-01-21;992;3;0;8089;38;0;1.1;0.0;0.0
42;2021-01-22;962;6;0;9051;44;0;1.2;0.0;0.0
42;2021-01-23;400;0;0;9451;44;0;1.2;0.0;0.0
42;2021-01-24;346;0;0;9797;44;0;1.3;0.0;0.0
42;2021-01-25;1090;11;0;10887;55;0;1.4;0.0;0.0
42;2021-01-26;1666;18;0;12553;73;0;1.6;0.0;0.0
42;2021-01-27;1410;118;0;13963;191;0;1.8;0.0;0.0
42;2021-01-28;1616;138;0;15579;329;0;2.0;0.0;0.0
42;2021-01-29;929;107;0;16508;436;0;2.2;0.1;0.0
42;2021-01-30;259;108;0;16767;544;0;2.2;0.1;0.0
42;2021-01-31;247;2;0;17014;546;0;2.2;0.1;0.0
42;2021-02-01;709;65;0;17723;611;0;2.3;0.1;0.0
42;2021-02-02;1809;307;0;19532;918;0;2.6;0.1;0.0
42;2021-02-03;1456;470;0;20988;1388;0;2.7;0.2;0.0
42;2021-02-04;1240;595;0;22228;1983;0;2.9;0.3;0.0
42;2021-02-05;694;491;0;22922;2474;0;3.0;0.3;0.0
42;2021-02-06;303;133;0;23225;2607;0;3.0;0.3;0.0
42;2021-02-07;251;143;0;23476;2750;0;3.1;0.4;0.0
42;2021-02-08;511;590;0;23987;3340;0;3.1;0.4;0.0
42;2021-02-09;710;792;0;24697;4132;0;3.2;0.5;0.0
42;2021-02-10;739;683;0;25436;4815;0;3.3;0.6;0.0
42;2021-02-11;754;713;0;26190;5528;0;3.4;0.7;0.0
42;2021-02-12;680;744;0;26870;6272;0;3.5;0.8;0.0
42;2021-02-13;310;258;0;27180;6530;0;3.6;0.9;0.0
42;2021-02-14;178;207;0;27358;6737;0;3.6;0.9;0.0
42;2021-02-15;516;792;0;27874;7529;0;3.6;1.0;0.0
42;2021-02-16;493;1153;0;28367;8682;0;3.7;1.1;0.0
42;2021-02-17;535;1472;0;28902;10154;0;3.8;1.3;0.0
42;2021-02-18;748;1332;0;29650;11486;0;3.9;1.5;0.0
42;2021-02-19;751;951;0;30401;12437;0;4.0;1.6;0.0
42;2021-02-20;228;411;0;30629;12848;0;4.0;1.7;0.0
42;2021-02-21;61;317;0;30690;13165;0;4.0;1.7;0.0
42;2021-02-22;535;906;0;31225;14071;0;4.1;1.8;0.0
42;2021-02-23;1158;1395;0;32383;15466;0;4.2;2.0;0.0
42;2021-02-24;1200;1209;0;33583;16675;0;4.4;2.2;0.0
42;2021-02-25;1583;1337;0;35166;18012;0;4.6;2.4;0.0
42;2021-02-26;1575;940;0;36741;18952;0;4.8;2.5;0.0
42;2021-02-27;520;270;0;37261;19222;0;4.9;2.5;0.0
42;2021-02-28;159;120;0;37420;19342;0;4.9;2.5;0.0
42;2021-03-01;785;808;0;38205;20150;0;5.0;2.6;0.0
42;2021-03-02;1254;812;0;39459;20962;0;5.2;2.7;0.0
42;2021-03-03;1396;821;0;40855;21783;0;5.3;2.8;0.0
42;2021-03-04;1686;742;0;42541;22525;0;5.6;2.9;0.0
42;2021-03-05;2498;672;0;45039;23197;0;5.9;3.0;0.0
42;2021-03-06;1810;282;0;46849;23479;0;6.1;3.1;0.0
42;2021-03-07;1358;95;0;48207;23574;0;6.3;3.1;0.0
42;2021-03-08;1350;529;0;49557;24103;0;6.5;3.2;0.0
42;2021-03-09;1965;481;0;51522;24584;0;6.7;3.2;0.0
42;2021-03-10;2072;541;0;53594;25125;0;7.0;3.3;0.0
42;2021-03-11;2975;646;0;56569;25771;0;7.4;3.4;0.0
42;2021-03-12;3005;833;0;59574;26604;0;7.8;3.5;0.0
42;2021-03-13;1491;347;0;61065;26951;0;8.0;3.5;0.0
42;2021-03-14;454;170;0;61519;27121;0;8.0;3.5;0.0
42;2021-03-15;1592;587;0;63111;27708;0;8.3;3.6;0.0
42;2021-03-16;1459;778;0;64570;28486;0;8.4;3.7;0.0
42;2021-03-17;1682;1021;0;66252;29507;0;8.7;3.9;0.0
42;2021-03-18;1788;978;0;68040;30485;0;8.9;4.0;0.0
42;2021-03-19;2547;688;0;70587;31173;0;9.2;4.1;0.0
42;2021-03-20;1581;230;0;72168;31403;0;9.4;4.1;0.0
42;2021-03-21;496;99;0;72664;31502;0;9.5;4.1;0.0
42;2021-03-22;1457;742;0;74121;32244;0;9.7;4.2;0.0
42;2021-03-23;2488;869;0;76609;33113;0;10.0;4.3;0.0
42;2021-03-24;2755;797;0;79364;33910;0;10.4;4.4;0.0
42;2021-03-25;3732;940;0;83096;34850;0;10.9;4.6;0.0
42;2021-03-26;3774;792;0;86870;35642;0;11.4;4.7;0.0
42;2021-03-27;1819;430;0;88689;36072;0;11.6;4.7;0.0
42;2021-03-28;998;204;0;89687;36276;0;11.7;4.7;0.0
42;2021-03-29;2092;921;0;91779;37197;0;12.0;4.9;0.0
42;2021-03-30;3188;870;0;94967;38067;0;12.4;5.0;0.0
42;2021-03-31;2497;1098;0;97464;39165;0;12.7;5.1;0.0
42;2021-04-01;3385;1049;0;100849;40214;0;13.2;5.3;0.0
42;2021-04-02;2862;1195;0;103711;41409;0;13.6;5.4;0.0
42;2021-04-03;1369;586;0;105080;41995;0;13.7;5.5;0.0
42;2021-04-04;1339;366;0;106419;42361;0;13.9;5.5;0.0
42;2021-04-05;1847;284;0;108266;42645;0;14.2;5.6;0.0
42;2021-04-06;2236;1413;0;110502;44058;0;14.4;5.8;0.0
42;2021-04-07;2693;1833;0;113195;45891;0;14.8;6.0;0.0
42;2021-04-08;3991;1586;0;117186;47477;0;15.3;6.2;0.0
42;2021-04-09;5047;1528;0;122233;49005;0;16.0;6.4;0.0
42;2021-04-10;2565;762;0;124798;49767;0;16.3;6.5;0.0
42;2021-04-11;1844;412;0;126642;50179;0;16.6;6.6;0.0
42;2021-04-12;3571;1546;0;130213;51725;0;17.0;6.8;0.0
42;2021-04-13;4427;1799;0;134640;53524;0;17.6;7.0;0.0
42;2021-04-14;4096;1879;0;138736;55403;0;18.1;7.2;0.0
42;2021-04-15;4616;1823;0;143352;57226;0;18.7;7.5;0.0
42;2021-04-16;4370;1873;0;147722;59099;0;19.3;7.7;0.0
42;2021-04-17;2777;1024;0;150499;60123;0;19.7;7.9;0.0
42;2021-04-18;1619;393;0;152118;60516;0;19.9;7.9;0.0
42;2021-04-19;2830;1521;0;154948;62037;0;20.3;8.1;0.0
42;2021-04-20;3285;1944;0;158233;63981;0;20.7;8.4;0.0
42;2021-04-21;3279;1777;0;161512;65758;0;21.1;8.6;0.0
42;2021-04-22;3521;1933;0;165033;67691;0;21.6;8.9;0.0
42;2021-04-23;3544;2026;0;168577;69717;0;22.0;9.1;0.0
42;2021-04-24;2123;1494;0;170700;71211;0;22.3;9.3;0.0
42;2021-04-25;1372;895;0;172072;72106;0;22.5;9.4;0.0
42;2021-04-26;2956;1733;0;175028;73839;0;22.9;9.7;0.0
42;2021-04-27;2994;2248;0;178022;76087;0;23.3;9.9;0.0
42;2021-04-28;3189;2592;0;181211;78679;0;23.7;10.3;0.0
42;2021-04-29;3597;2746;0;184808;81425;0;24.2;10.6;0.0
42;2021-04-30;3165;2995;0;187973;84420;0;24.6;11.0;0.0
42;2021-05-01;2587;1003;0;190560;85423;0;24.9;11.2;0.0
42;2021-05-02;1727;1218;0;192287;86641;0;25.1;11.3;0.0
42;2021-05-03;2723;2716;0;195010;89357;0;25.5;11.7;0.0
42;2021-05-04;3274;3080;0;198284;92437;0;25.9;12.1;0.0
42;2021-05-05;3178;3263;0;201462;95700;0;26.3;12.5;0.0
42;2021-05-06;3708;3670;0;205170;99370;0;26.8;13.0;0.0
42;2021-05-07;3507;3916;0;208677;103286;0;27.3;13.5;0.0
42;2021-05-08;2800;1005;0;211477;104291;0;27.7;13.6;0.0
42;2021-05-09;1435;2013;0;212912;106304;0;27.8;13.9;0.0
42;2021-05-10;3041;3681;0;215953;109985;0;28.2;14.4;0.0
42;2021-05-11;4964;3739;0;220917;113724;0;28.9;14.9;0.0
42;2021-05-12;4710;3419;0;225627;117143;0;29.5;15.3;0.0
42;2021-05-13;4911;1117;0;230538;118260;0;30.1;15.5;0.0
42;2021-05-14;4750;2770;0;235288;121030;0;30.8;15.8;0.0
42;2021-05-15;4272;1954;0;239560;122984;0;31.3;16.1;0.0
42;2021-05-16;2461;943;0;242021;123927;0;31.6;16.2;0.0
42;2021-05-17;5302;2706;0;247323;126633;0;32.3;16.6;0.0
42;2021-05-18;5603;2862;0;252926;129495;0;33.1;16.9;0.0
42;2021-05-19;5686;2615;0;258612;132110;0;33.8;17.3;0.0
42;2021-05-20;6079;2778;0;264691;134888;0;34.6;17.6;0.0
42;2021-05-21;5352;3073;0;270043;137961;0;35.3;18.0;0.0
42;2021-05-22;4322;1956;0;274365;139917;0;35.9;18.3;0.0
42;2021-05-23;2189;762;0;276554;140679;0;36.2;18.4;0.0
42;2021-05-24;3862;1227;0;280416;141906;0;36.7;18.6;0.0
42;2021-05-25;4329;3677;0;284745;145583;0;37.2;19.0;0.0
42;2021-05-26;4380;3198;0;289125;148781;0;37.8;19.5;0.0
42;2021-05-27;4647;3428;0;293772;152209;0;38.4;19.9;0.0
42;2021-05-28;4369;3948;0;298141;156157;0;39.0;20.4;0.0
42;2021-05-29;3326;2654;0;301467;158811;0;39.4;20.8;0.0
42;2021-05-30;1525;1066;0;302992;159877;0;39.6;20.9;0.0
42;2021-05-31;3654;3140;0;306646;163017;0;40.1;21.3;0.0
42;2021-06-01;4169;3384;0;310815;166401;0;40.6;21.8;0.0
42;2021-06-02;3907;2805;0;314722;169206;0;41.2;22.1;0.0
42;2021-06-03;4397;3632;0;319119;172838;0;41.7;22.6;0.0
42;2021-06-04;4348;3925;0;323467;176763;0;42.3;23.1;0.0
42;2021-06-05;2948;2153;0;326415;178916;0;42.7;23.4;0.0
42;2021-06-06;1206;1100;0;327621;180016;0;42.8;23.5;0.0
42;2021-06-07;3592;3060;0;331213;183076;0;43.3;23.9;0.0
42;2021-06-08;3201;3079;0;334414;186155;0;43.7;24.3;0.0
42;2021-06-09;2857;3004;0;337271;189159;0;44.1;24.7;0.0
42;2021-06-10;3107;2848;0;340378;192007;0;44.5;25.1;0.0
42;2021-06-11;3423;3845;0;343801;195852;0;45.0;25.6;0.0
42;2021-06-12;2508;2629;0;346309;198481;0;45.3;26.0;0.0
42;2021-06-13;884;1156;0;347193;199637;0;45.4;26.1;0.0
42;2021-06-14;2257;3828;0;349450;203465;0;45.7;26.6;0.0
42;2021-06-15;2691;3905;0;352141;207370;0;46.0;27.1;0.0
42;2021-06-16;2822;3380;0;354963;210750;0;46.4;27.6;0.0
42;2021-06-17;2528;3640;0;357491;214390;0;46.7;28.0;0.0
42;2021-06-18;3057;4867;0;360548;219257;0;47.1;28.7;0.0
42;2021-06-19;2506;3710;0;363054;222967;0;47.5;29.2;0.0
42;2021-06-20;809;1667;0;363863;224634;0;47.6;29.4;0.0
42;2021-06-21;1847;5685;0;365710;230319;0;47.8;30.1;0.0
42;2021-06-22;1810;5490;0;367520;235809;0;48.1;30.8;0.0
42;2021-06-23;1818;4953;0;369338;240762;0;48.3;31.5;0.0
42;2021-06-24;1802;4385;0;371140;245147;0;48.5;32.1;0.0
42;2021-06-25;1963;6395;0;373103;251542;0;48.8;32.9;0.0
42;2021-06-26;1295;5047;0;374398;256589;0;49.0;33.6;0.0
42;2021-06-27;689;2500;0;375087;259089;0;49.0;33.9;0.0
42;2021-06-28;1674;6298;0;376761;265387;0;49.3;34.7;0.0
42;2021-06-29;1474;5921;0;378235;271308;0;49.5;35.5;0.0
42;2021-06-30;1852;5170;0;380087;276478;0;49.7;36.2;0.0
42;2021-07-01;1879;4719;0;381966;281197;0;49.9;36.8;0.0
42;2021-07-02;2197;6092;0;384163;287289;0;50.2;37.6;0.0
42;2021-07-03;1581;4827;0;385744;292116;0;50.4;38.2;0.0
42;2021-07-04;812;2084;0;386556;294200;0;50.5;38.5;0.0
42;2021-07-05;1742;5576;0;388298;299776;0;50.8;39.2;0.0
42;2021-07-06;2026;5053;0;390324;304829;0;51.0;39.9;0.0
42;2021-07-07;2296;4275;0;392620;309104;0;51.3;40.4;0.0
42;2021-07-08;2246;3739;0;394866;312843;0;51.6;40.9;0.0
42;2021-07-09;2413;5604;0;397279;318447;0;51.9;41.6;0.0
42;2021-07-10;1545;4687;0;398824;323134;0;52.2;42.3;0.0
42;2021-07-11;875;1933;0;399699;325067;0;52.3;42.5;0.0
42;2021-07-12;1706;5651;0;401405;330718;0;52.5;43.2;0.0
42;2021-07-13;3381;5878;0;404786;336596;0;52.9;44.0;0.0
42;2021-07-14;3792;1827;0;408578;338423;0;53.4;44.3;0.0
42;2021-07-15;4345;5415;0;412923;343838;0;54.0;45.0;0.0
42;2021-07-16;4179;5839;0;417102;349677;0;54.5;45.7;0.0
42;2021-07-17;2999;4170;0;420101;353847;0;54.9;46.3;0.0
42;2021-07-18;1749;1659;0;421850;355506;0;55.2;46.5;0.0
42;2021-07-19;3432;4812;0;425282;360318;0;55.6;47.1;0.0
42;2021-07-20;4329;4679;0;429611;364997;0;56.2;47.7;0.0
42;2021-07-21;4674;4417;0;434285;369414;0;56.8;48.3;0.0
42;2021-07-22;5110;3866;0;439395;373280;0;57.5;48.8;0.0
42;2021-07-23;5022;4946;0;444417;378226;0;58.1;49.5;0.0
42;2021-07-24;3476;3534;0;447893;381760;0;58.6;49.9;0.0
42;2021-07-25;1443;1267;0;449336;383027;0;58.8;50.1;0.0
42;2021-07-26;4335;4104;0;453671;387131;0;59.3;50.6;0.0
42;2021-07-27;5037;3870;0;458708;391001;0;60.0;51.1;0.0
42;2021-07-28;5262;3537;0;463970;394538;0;60.7;51.6;0.0
42;2021-07-29;5293;3320;0;469263;397858;0;61.4;52.0;0.0
42;2021-07-30;4781;3692;0;474044;401550;0;62.0;52.5;0.0
42;2021-07-31;4144;2847;0;478188;404397;0;62.5;52.9;0.0
42;2021-08-01;2268;1211;0;480456;405608;0;62.8;53.0;0.0
42;2021-08-02;4141;2939;0;484597;408547;0;63.4;53.4;0.0
42;2021-08-03;3707;3151;0;488304;411698;0;63.9;53.8;0.0
42;2021-08-04;3447;3064;0;491751;414762;0;64.3;54.2;0.0
42;2021-08-05;3345;3170;0;495096;417932;0;64.7;54.7;0.0
42;2021-08-06;3602;3872;0;498698;421804;0;65.2;55.2;0.0
42;2021-08-07;2711;2777;0;501409;424581;0;65.6;55.5;0.0
42;2021-08-08;1086;1610;0;502495;426191;0;65.7;55.7;0.0
42;2021-08-09;2753;3713;0;505248;429904;0;66.1;56.2;0.0
42;2021-08-10;3049;3594;0;508297;433498;0;66.5;56.7;0.0
42;2021-08-11;2516;3351;0;510813;436849;0;66.8;57.1;0.0
42;2021-08-12;2401;3438;0;513214;440287;0;67.1;57.6;0.0
42;2021-08-13;2284;3696;0;515498;443983;0;67.4;58.1;0.0
42;2021-08-14;1519;2910;0;517017;446893;0;67.6;58.4;0.0
42;2021-08-15;577;943;0;517594;447836;0;67.7;58.6;0.0
42;2021-08-16;2006;4259;0;519600;452095;0;67.9;59.1;0.0
42;2021-08-17;2169;4079;0;521769;456174;0;68.2;59.7;0.0
42;2021-08-18;1911;4030;0;523680;460204;0;68.5;60.2;0.0
42;2021-08-19;1820;3305;0;525500;463509;0;68.7;60.6;0.0
42;2021-08-20;2116;4367;0;527616;467876;0;69.0;61.2;0.0
42;2021-08-21;1015;3427;0;528631;471303;0;69.1;61.6;0.0
42;2021-08-22;434;1770;0;529065;473073;0;69.2;61.9;0.0
42;2021-08-23;1527;4415;0;530592;477488;0;69.4;62.4;0.0
42;2021-08-24;1676;3943;0;532268;481431;0;69.6;63.0;0.0
42;2021-08-25;1656;3786;0;533924;485217;0;69.8;63.4;0.0
42;2021-08-26;1398;3106;0;535322;488323;0;70.0;63.9;0.0
42;2021-08-27;1690;4376;0;537012;492699;0;70.2;64.4;0.0
42;2021-08-28;1170;3281;0;538182;495980;0;70.4;64.9;0.0
42;2021-08-29;339;1331;0;538521;497311;0;70.4;65.0;0.0
42;2021-08-30;1242;3296;89;539763;500607;89;70.6;65.5;0.0
42;2021-08-31;1209;2692;144;540972;503299;233;70.7;65.8;0.0
42;2021-09-01;1357;2728;215;542329;506027;448;70.9;66.2;0.1
42;2021-09-02;1350;2594;327;543679;508621;775;71.1;66.5;0.1
42;2021-09-03;1526;2932;357;545205;511553;1132;71.3;66.9;0.1
42;2021-09-04;996;2561;182;546201;514114;1314;71.4;67.2;0.2
42;2021-09-05;329;701;136;546530;514815;1450;71.5;67.3;0.2
42;2021-09-06;771;1780;385;547301;516595;1835;71.6;67.6;0.2
42;2021-09-07;837;1640;382;548138;518235;2217;71.7;67.8;0.3
42;2021-09-08;860;1853;330;548998;520088;2547;71.8;68.0;0.3
42;2021-09-09;638;1431;349;549636;521519;2896;71.9;68.2;0.4
42;2021-09-10;916;1937;352;550552;523456;3248;72.0;68.4;0.4
42;2021-09-11;686;2145;117;551238;525601;3365;72.1;68.7;0.4
42;2021-09-12;143;447;36;551381;526048;3401;72.1;68.8;0.4
42;2021-09-13;561;1116;567;551942;527164;3968;72.2;68.9;0.5
42;2021-09-14;763;1286;769;552705;528450;4737;72.3;69.1;0.6
42;2021-09-15;720;1560;599;553425;530010;5336;72.4;69.3;0.7
42;2021-09-16;528;873;738;553953;530883;6074;72.4;69.4;0.8
42;2021-09-17;702;1588;668;554655;532471;6742;72.5;69.6;0.9
42;2021-09-18;544;1705;147;555199;534176;6889;72.6;69.9;0.9
42;2021-09-19;88;346;38;555287;534522;6927;72.6;69.9;0.9
42;2021-09-20;409;851;716;555696;535373;7643;72.7;70.0;1.0
42;2021-09-21;343;807;778;556039;536180;8421;72.7;70.1;1.1
42;2021-09-22;482;1357;774;556521;537537;9195;72.8;70.3;1.2
42;2021-09-23;378;815;742;556899;538352;9937;72.8;70.4;1.3
42;2021-09-24;473;1497;610;557372;539849;10547;72.9;70.6;1.4
42;2021-09-25;350;1169;208;557722;541018;10755;72.9;70.7;1.4
42;2021-09-26;58;260;17;557780;541278;10772;72.9;70.8;1.4
42;2021-09-27;298;795;666;558078;542073;11438;73.0;70.9;1.5
42;2021-09-28;371;720;729;558449;542793;12167;73.0;71.0;1.6
42;2021-09-29;395;954;587;558844;543747;12754;73.1;71.1;1.7
42;2021-09-30;330;636;544;559174;544383;13298;73.1;71.2;1.7
42;2021-10-01;540;991;688;559714;545374;13986;73.2;71.3;1.8
42;2021-10-02;371;753;187;560085;546127;14173;73.2;71.4;1.9
42;2021-10-03;81;158;14;560166;546285;14187;73.2;71.4;1.9
42;2021-10-04;273;527;880;560439;546812;15067;73.3;71.5;2.0
42;2021-10-05;290;524;628;560729;547336;15695;73.3;71.6;2.1
42;2021-10-06;435;843;901;561164;548179;16596;73.4;71.7;2.2
42;2021-10-07;304;555;766;561468;548734;17362;73.4;71.8;2.3
42;2021-10-08;441;844;768;561909;549578;18130;73.5;71.9;2.4
42;2021-10-09;364;633;393;562273;550211;18523;73.5;71.9;2.4
42;2021-10-10;69;106;90;562342;550317;18613;73.5;72.0;2.4
42;2021-10-11;254;455;846;562596;550772;19459;73.6;72.0;2.5
42;2021-10-12;229;428;659;562825;551200;20118;73.6;72.1;2.6
42;2021-10-13;441;644;976;563266;551844;21094;73.7;72.2;2.8
42;2021-10-14;300;401;892;563566;552245;21986;73.7;72.2;2.9
42;2021-10-15;413;583;1072;563979;552828;23058;73.7;72.3;3.0
42;2021-10-16;302;446;435;564281;553274;23493;73.8;72.3;3.1
42;2021-10-17;64;96;82;564345;553370;23575;73.8;72.4;3.1
42;2021-10-18;226;461;921;564571;553831;24496;73.8;72.4;3.2
42;2021-10-19;153;337;924;564724;554168;25420;73.8;72.5;3.3
42;2021-10-20;204;465;1100;564928;554633;26520;73.9;72.5;3.5
42;2021-10-21;138;327;874;565066;554960;27394;73.9;72.6;3.6
42;2021-10-22;177;416;1089;565243;555376;28483;73.9;72.6;3.7
42;2021-10-23;180;375;520;565423;555751;29003;73.9;72.7;3.8
42;2021-10-24;31;72;103;565454;555823;29106;73.9;72.7;3.8
42;2021-10-25;159;328;1028;565613;556151;30134;74.0;72.7;3.9
42;2021-10-26;116;239;949;565729;556390;31083;74.0;72.8;4.1
42;2021-10-27;201;433;1496;565930;556823;32579;74.0;72.8;4.3
42;2021-10-28;152;224;936;566082;557047;33515;74.0;72.8;4.4
42;2021-10-29;189;373;1530;566271;557420;35045;74.0;72.9;4.6
42;2021-10-30;107;323;571;566378;557743;35616;74.1;72.9;4.7
42;2021-10-31;30;91;123;566408;557834;35739;74.1;72.9;4.7
42;2021-11-01;34;29;37;566442;557863;35776;74.1;72.9;4.7
42;2021-11-02;140;271;1127;566582;558134;36903;74.1;73.0;4.8
42;2021-11-03;193;435;1871;566775;558569;38774;74.1;73.0;5.1
42;2021-11-04;117;230;1321;566892;558799;40095;74.1;73.1;5.2
42;2021-11-05;167;328;1892;567059;559127;41987;74.2;73.1;5.5
42;2021-11-06;140;271;552;567199;559398;42539;74.2;73.1;5.6
42;2021-11-07;27;68;142;567226;559466;42681;74.2;73.2;5.6
42;2021-11-08;89;224;1939;567315;559690;44620;74.2;73.2;5.8
42;2021-11-09;107;202;1968;567422;559892;46588;74.2;73.2;6.1
42;2021-11-10;216;257;2406;567638;560149;48994;74.2;73.2;6.4
42;2021-11-11;33;27;150;567671;560176;49144;74.2;73.3;6.4
42;2021-11-12;153;273;2486;567824;560449;51630;74.3;73.3;6.8
42;2021-11-13;142;175;1039;567966;560624;52669;74.3;73.3;6.9
42;2021-11-14;46;28;413;568012;560652;53082;74.3;73.3;6.9
42;2021-11-15;96;182;2489;568108;560834;55571;74.3;73.3;7.3
42;2021-11-16;80;140;2401;568188;560974;57972;74.3;73.4;7.6
42;2021-11-17;210;275;2764;568398;561249;60736;74.3;73.4;7.9
42;2021-11-18;125;171;2435;568523;561420;63171;74.3;73.4;8.3
42;2021-11-19;145;201;2709;568668;561621;65880;74.4;73.4;8.6
42;2021-11-20;240;247;1605;568908;561868;67485;74.4;73.5;8.8
42;2021-11-21;12;23;134;568920;561891;67619;74.4;73.5;8.8
42;2021-11-22;131;119;2878;569051;562010;70497;74.4;73.5;9.2
42;2021-11-23;103;130;2724;569154;562140;73221;74.4;73.5;9.6
42;2021-11-24;228;254;3304;569382;562394;76525;74.5;73.5;10.0
42;2021-11-25;124;132;3028;569506;562526;79553;74.5;73.6;10.4
42;2021-11-26;137;235;4079;569643;562761;83632;74.5;73.6;10.9
42;2021-11-27;182;212;2707;569825;562973;86339;74.5;73.6;11.3
42;2021-11-28;18;28;461;569843;563001;86800;74.5;73.6;11.4
42;2021-11-29;96;133;4697;569939;563134;91497;74.5;73.6;12.0
42;2021-11-30;105;138;4753;570044;563272;96250;74.5;73.7;12.6
42;2021-12-01;102;202;5495;570146;563474;101745;74.6;73.7;13.3
42;2021-12-02;89;119;6170;570235;563593;107915;74.6;73.7;14.1
42;2021-12-03;128;161;6854;570363;563754;114769;74.6;73.7;15.0
42;2021-12-04;99;208;3737;570462;563962;118506;74.6;73.7;15.5
42;2021-12-05;12;25;594;570474;563987;119100;74.6;73.7;15.6
42;2021-12-06;104;155;5670;570578;564142;124770;74.6;73.8;16.3
42;2021-12-07;97;124;6008;570675;564266;130778;74.6;73.8;17.1
42;2021-12-08;150;230;6758;570825;564496;137536;74.6;73.8;18.0
42;2021-12-09;118;164;7194;570943;564660;144730;74.7;73.8;18.9
42;2021-12-10;156;193;7604;571099;564853;152334;74.7;73.9;19.9
42;2021-12-11;83;215;5093;571182;565068;157427;74.7;73.9;20.6
42;2021-12-12;34;56;2493;571216;565124;159920;74.7;73.9;20.9
42;2021-12-13;139;183;7587;571355;565307;167507;74.7;73.9;21.9
42;2021-12-14;174;177;10134;571529;565484;177641;74.7;73.9;23.2
42;2021-12-15;161;247;9122;571690;565731;186763;74.8;74.0;24.4
42;2021-12-16;143;140;9416;571833;565871;196179;74.8;74.0;25.7
43;2020-12-27;0;0;0;0;0;0;0.0;0.0;0.0
43;2020-12-28;0;0;0;0;0;0;0.0;0.0;0.0
43;2020-12-29;0;0;0;0;0;0;0.0;0.0;0.0
43;2020-12-30;0;0;0;0;0;0;0.0;0.0;0.0
43;2020-12-31;0;0;0;0;0;0;0.0;0.0;0.0
43;2021-01-01;3;0;0;3;0;0;0.0;0.0;0.0
43;2021-01-02;0;0;0;3;0;0;0.0;0.0;0.0
43;2021-01-03;0;0;0;3;0;0;0.0;0.0;0.0
43;2021-01-04;2;0;0;5;0;0;0.0;0.0;0.0
43;2021-01-05;0;0;0;5;0;0;0.0;0.0;0.0
43;2021-01-06;8;0;0;13;0;0;0.0;0.0;0.0
43;2021-01-07;163;0;0;176;0;0;0.1;0.0;0.0
43;2021-01-08;148;1;0;324;1;0;0.1;0.0;0.0
43;2021-01-09;6;0;0;330;1;0;0.1;0.0;0.0
43;2021-01-10;2;0;0;332;1;0;0.1;0.0;0.0
43;2021-01-11;144;0;0;476;1;0;0.2;0.0;0.0
43;2021-01-12;258;2;0;734;3;0;0.3;0.0;0.0
43;2021-01-13;259;2;0;993;5;0;0.4;0.0;0.0
43;2021-01-14;312;1;0;1305;6;0;0.6;0.0;0.0
43;2021-01-15;312;2;0;1617;8;0;0.7;0.0;0.0
43;2021-01-16;41;0;0;1658;8;0;0.7;0.0;0.0
43;2021-01-17;5;0;0;1663;8;0;0.7;0.0;0.0
43;2021-01-18;737;7;0;2400;15;0;1.1;0.0;0.0
43;2021-01-19;781;4;0;3181;19;0;1.4;0.0;0.0
43;2021-01-20;548;2;0;3729;21;0;1.6;0.0;0.0
43;2021-01-21;491;2;0;4220;23;0;1.9;0.0;0.0
43;2021-01-22;480;7;0;4700;30;0;2.1;0.0;0.0
43;2021-01-23;6;0;0;4706;30;0;2.1;0.0;0.0
43;2021-01-24;9;0;0;4715;30;0;2.1;0.0;0.0
43;2021-01-25;533;0;0;5248;30;0;2.3;0.0;0.0
43;2021-01-26;585;7;0;5833;37;0;2.6;0.0;0.0
43;2021-01-27;712;5;0;6545;42;0;2.9;0.0;0.0
43;2021-01-28;729;34;0;7274;76;0;3.2;0.0;0.0
43;2021-01-29;688;82;0;7962;158;0;3.5;0.1;0.0
43;2021-01-30;111;1;0;8073;159;0;3.6;0.1;0.0
43;2021-01-31;7;0;0;8080;159;0;3.6;0.1;0.0
43;2021-02-01;391;101;0;8471;260;0;3.7;0.1;0.0
43;2021-02-02;689;158;0;9160;418;0;4.0;0.2;0.0
43;2021-02-03;692;67;0;9852;485;0;4.3;0.2;0.0
43;2021-02-04;538;189;0;10390;674;0;4.6;0.3;0.0
43;2021-02-05;539;184;0;10929;858;0;4.8;0.4;0.0
43;2021-02-06;166;32;0;11095;890;0;4.9;0.4;0.0
43;2021-02-07;7;7;0;11102;897;0;4.9;0.4;0.0
43;2021-02-08;397;303;0;11499;1200;0;5.1;0.5;0.0
43;2021-02-09;346;442;0;11845;1642;0;5.2;0.7;0.0
43;2021-02-10;393;360;0;12238;2002;0;5.4;0.9;0.0
43;2021-02-11;364;374;0;12602;2376;0;5.6;1.0;0.0
43;2021-02-12;424;222;0;13026;2598;0;5.7;1.1;0.0
43;2021-02-13;640;62;0;13666;2660;0;6.0;1.2;0.0
43;2021-02-14;5;12;0;13671;2672;0;6.0;1.2;0.0
43;2021-02-15;62;473;0;13733;3145;0;6.1;1.4;0.0
43;2021-02-16;46;386;0;13779;3531;0;6.1;1.6;0.0
43;2021-02-17;84;497;0;13863;4028;0;6.1;1.8;0.0
43;2021-02-18;158;413;0;14021;4441;0;6.2;2.0;0.0
43;2021-02-19;273;488;0;14294;4929;0;6.3;2.2;0.0
43;2021-02-20;29;17;0;14323;4946;0;6.3;2.2;0.0
43;2021-02-21;0;7;0;14323;4953;0;6.3;2.2;0.0
43;2021-02-22;36;501;0;14359;5454;0;6.3;2.4;0.0
43;2021-02-23;226;753;0;14585;6207;0;6.4;2.7;0.0
43;2021-02-24;164;703;0;14749;6910;0;6.5;3.0;0.0
43;2021-02-25;267;701;0;15016;7611;0;6.6;3.4;0.0
43;2021-02-26;260;669;0;15276;8280;0;6.7;3.6;0.0
43;2021-02-27;144;77;0;15420;8357;0;6.8;3.7;0.0
43;2021-02-28;8;5;0;15428;8362;0;6.8;3.7;0.0
43;2021-03-01;230;471;0;15658;8833;0;6.9;3.9;0.0
43;2021-03-02;364;563;0;16022;9396;0;7.1;4.1;0.0
43;2021-03-03;344;558;0;16366;9954;0;7.2;4.4;0.0
43;2021-03-04;536;455;0;16902;10409;0;7.4;4.6;0.0
43;2021-03-05;596;464;0;17498;10873;0;7.7;4.8;0.0
43;2021-03-06;517;180;0;18015;11053;0;7.9;4.9;0.0
43;2021-03-07;59;2;0;18074;11055;0;8.0;4.9;0.0
43;2021-03-08;489;428;0;18563;11483;0;8.2;5.1;0.0
43;2021-03-09;638;347;0;19201;11830;0;8.5;5.2;0.0
43;2021-03-10;658;476;0;19859;12306;0;8.8;5.4;0.0
43;2021-03-11;928;435;0;20787;12741;0;9.2;5.6;0.0
43;2021-03-12;907;424;0;21694;13165;0;9.6;5.8;0.0
43;2021-03-13;698;126;0;22392;13291;0;9.9;5.9;0.0
43;2021-03-14;10;5;0;22402;13296;0;9.9;5.9;0.0
43;2021-03-15;704;146;0;23106;13442;0;10.2;5.9;0.0
43;2021-03-16;817;273;0;23923;13715;0;10.5;6.0;0.0
43;2021-03-17;634;158;0;24557;13873;0;10.8;6.1;0.0
43;2021-03-18;697;164;0;25254;14037;0;11.1;6.2;0.0
43;2021-03-19;849;131;0;26103;14168;0;11.5;6.2;0.0
43;2021-03-20;430;53;0;26533;14221;0;11.7;6.3;0.0
43;2021-03-21;8;1;0;26541;14222;0;11.7;6.3;0.0
43;2021-03-22;683;50;0;27224;14272;0;12.0;6.3;0.0
43;2021-03-23;869;53;0;28093;14325;0;12.4;6.3;0.0
43;2021-03-24;1169;115;0;29262;14440;0;12.9;6.4;0.0
43;2021-03-25;1518;174;0;30780;14614;0;13.6;6.4;0.0
43;2021-03-26;1568;208;0;32348;14822;0;14.3;6.5;0.0
43;2021-03-27;1274;85;0;33622;14907;0;14.8;6.6;0.0
43;2021-03-28;409;31;0;34031;14938;0;15.0;6.6;0.0
43;2021-03-29;1033;181;0;35064;15119;0;15.5;6.7;0.0
43;2021-03-30;1255;259;0;36319;15378;0;16.0;6.8;0.0
43;2021-03-31;1213;274;0;37532;15652;0;16.5;6.9;0.0
43;2021-04-01;1284;328;0;38816;15980;0;17.1;7.0;0.0
43;2021-04-02;1011;338;0;39827;16318;0;17.6;7.2;0.0
43;2021-04-03;315;190;0;40142;16508;0;17.7;7.3;0.0
43;2021-04-04;20;6;0;40162;16514;0;17.7;7.3;0.0
43;2021-04-05;46;6;0;40208;16520;0;17.7;7.3;0.0
43;2021-04-06;621;576;0;40829;17096;0;18.0;7.5;0.0
43;2021-04-07;811;561;0;41640;17657;0;18.4;7.8;0.0
43;2021-04-08;990;446;0;42630;18103;0;18.8;8.0;0.0
43;2021-04-09;1121;632;0;43751;18735;0;19.3;8.3;0.0
43;2021-04-10;585;224;0;44336;18959;0;19.5;8.4;0.0
43;2021-04-11;47;6;0;44383;18965;0;19.6;8.4;0.0
43;2021-04-12;706;622;0;45089;19587;0;19.9;8.6;0.0
43;2021-04-13;914;727;0;46003;20314;0;20.3;9.0;0.0
43;2021-04-14;834;665;0;46837;20979;0;20.6;9.2;0.0
43;2021-04-15;1016;703;0;47853;21682;0;21.1;9.6;0.0
43;2021-04-16;1000;708;0;48853;22390;0;21.5;9.9;0.0
43;2021-04-17;423;293;0;49276;22683;0;21.7;10.0;0.0
43;2021-04-18;91;11;0;49367;22694;0;21.8;10.0;0.0
43;2021-04-19;678;562;0;50045;23256;0;22.1;10.2;0.0
43;2021-04-20;822;654;0;50867;23910;0;22.4;10.5;0.0
43;2021-04-21;410;913;0;51277;24823;0;22.6;10.9;0.0
43;2021-04-22;705;963;0;51982;25786;0;22.9;11.4;0.0
43;2021-04-23;513;1055;0;52495;26841;0;23.1;11.8;0.0
43;2021-04-24;390;914;0;52885;27755;0;23.3;12.2;0.0
43;2021-04-25;111;404;0;52996;28159;0;23.4;12.4;0.0
43;2021-04-26;482;918;0;53478;29077;0;23.6;12.8;0.0
43;2021-04-27;872;965;0;54350;30042;0;24.0;13.2;0.0
43;2021-04-28;908;1066;0;55258;31108;0;24.4;13.7;0.0
43;2021-04-29;1222;1062;0;56480;32170;0;24.9;14.2;0.0
43;2021-04-30;1188;1044;0;57668;33214;0;25.4;14.6;0.0
43;2021-05-01;450;52;0;58118;33266;0;25.6;14.7;0.0
43;2021-05-02;85;40;0;58203;33306;0;25.7;14.7;0.0
43;2021-05-03;1279;403;0;59482;33709;0;26.2;14.9;0.0
43;2021-05-04;1276;864;0;60758;34573;0;26.8;15.2;0.0
43;2021-05-05;1209;817;0;61967;35390;0;27.3;15.6;0.0
43;2021-05-06;1443;937;0;63410;36327;0;27.9;16.0;0.0
43;2021-05-07;1121;1151;0;64531;37478;0;28.4;16.5;0.0
43;2021-05-08;573;156;0;65104;37634;0;28.7;16.6;0.0
43;2021-05-09;58;72;0;65162;37706;0;28.7;16.6;0.0
43;2021-05-10;1118;733;0;66280;38439;0;29.2;16.9;0.0
43;2021-05-11;1643;1007;0;67923;39446;0;29.9;17.4;0.0
43;2021-05-12;1544;853;0;69467;40299;0;30.6;17.8;0.0
43;2021-05-13;989;395;0;70456;40694;0;31.1;17.9;0.0
43;2021-05-14;2122;1087;0;72578;41781;0;32.0;18.4;0.0
43;2021-05-15;1175;310;0;73753;42091;0;32.5;18.6;0.0
43;2021-05-16;348;70;0;74101;42161;0;32.7;18.6;0.0
43;2021-05-17;1704;657;0;75805;42818;0;33.4;18.9;0.0
43;2021-05-18;1947;711;0;77752;43529;0;34.3;19.2;0.0
43;2021-05-19;2043;609;0;79795;44138;0;35.2;19.5;0.0
43;2021-05-20;2295;811;0;82090;44949;0;36.2;19.8;0.0
43;2021-05-21;2352;726;0;84442;45675;0;37.2;20.1;0.0
43;2021-05-22;1064;331;0;85506;46006;0;37.7;20.3;0.0
43;2021-05-23;78;31;0;85584;46037;0;37.7;20.3;0.0
43;2021-05-24;441;146;0;86025;46183;0;37.9;20.4;0.0
43;2021-05-25;1368;691;0;87393;46874;0;38.5;20.7;0.0
43;2021-05-26;1366;610;0;88759;47484;0;39.1;20.9;0.0
43;2021-05-27;1387;752;0;90146;48236;0;39.7;21.3;0.0
43;2021-05-28;1368;810;0;91514;49046;0;40.3;21.6;0.0
43;2021-05-29;1105;607;0;92619;49653;0;40.8;21.9;0.0
43;2021-05-30;193;67;0;92812;49720;0;40.9;21.9;0.0
43;2021-05-31;1203;521;0;94015;50241;0;41.4;22.1;0.0
43;2021-06-01;1256;1001;0;95271;51242;0;42.0;22.6;0.0
43;2021-06-02;1099;759;0;96370;52001;0;42.5;22.9;0.0
43;2021-06-03;1243;851;0;97613;52852;0;43.0;23.3;0.0
43;2021-06-04;1378;913;0;98991;53765;0;43.6;23.7;0.0
43;2021-06-05;729;486;0;99720;54251;0;43.9;23.9;0.0
43;2021-06-06;44;53;0;99764;54304;0;44.0;23.9;0.0
43;2021-06-07;826;624;0;100590;54928;0;44.3;24.2;0.0
43;2021-06-08;716;762;0;101306;55690;0;44.6;24.5;0.0
43;2021-06-09;637;824;0;101943;56514;0;44.9;24.9;0.0
43;2021-06-10;876;1105;0;102819;57619;0;45.3;25.4;0.0
43;2021-06-11;833;1362;0;103652;58981;0;45.7;26.0;0.0
43;2021-06-12;821;517;0;104473;59498;0;46.0;26.2;0.0
43;2021-06-13;32;84;0;104505;59582;0;46.1;26.3;0.0
43;2021-06-14;477;1192;0;104982;60774;0;46.3;26.8;0.0
43;2021-06-15;629;1218;0;105611;61992;0;46.5;27.3;0.0
43;2021-06-16;593;1033;0;106204;63025;0;46.8;27.8;0.0
43;2021-06-17;633;1473;0;106837;64498;0;47.1;28.4;0.0
43;2021-06-18;881;1517;0;107718;66015;0;47.5;29.1;0.0
43;2021-06-19;437;809;0;108155;66824;0;47.7;29.5;0.0
43;2021-06-20;29;85;0;108184;66909;0;47.7;29.5;0.0
43;2021-06-21;447;1378;0;108631;68287;0;47.9;30.1;0.0
43;2021-06-22;511;1962;0;109142;70249;0;48.1;31.0;0.0
43;2021-06-23;397;1741;0;109539;71990;0;48.3;31.7;0.0
43;2021-06-24;516;1477;0;110055;73467;0;48.5;32.4;0.0
43;2021-06-25;582;2298;0;110637;75765;0;48.8;33.4;0.0
43;2021-06-26;483;1199;0;111120;76964;0;49.0;33.9;0.0
43;2021-06-27;57;143;0;111177;77107;0;49.0;34.0;0.0
43;2021-06-28;350;1869;0;111527;78976;0;49.2;34.8;0.0
43;2021-06-29;534;2326;0;112061;81302;0;49.4;35.8;0.0
43;2021-06-30;479;2211;0;112540;83513;0;49.6;36.8;0.0
43;2021-07-01;499;1839;0;113039;85352;0;49.8;37.6;0.0
43;2021-07-02;512;1939;0;113551;87291;0;50.0;38.5;0.0
43;2021-07-03;265;1052;0;113816;88343;0;50.2;38.9;0.0
43;2021-07-04;30;60;0;113846;88403;0;50.2;39.0;0.0
43;2021-07-05;531;1272;0;114377;89675;0;50.4;39.5;0.0
43;2021-07-06;617;1637;0;114994;91312;0;50.7;40.2;0.0
43;2021-07-07;577;1417;0;115571;92729;0;50.9;40.9;0.0
43;2021-07-08;779;1413;0;116350;94142;0;51.3;41.5;0.0
43;2021-07-09;586;1543;0;116936;95685;0;51.5;42.2;0.0
43;2021-07-10;359;1278;0;117295;96963;0;51.7;42.7;0.0
43;2021-07-11;54;167;0;117349;97130;0;51.7;42.8;0.0
43;2021-07-12;581;1730;0;117930;98860;0;52.0;43.6;0.0
43;2021-07-13;1171;1858;0;119101;100718;0;52.5;44.4;0.0
43;2021-07-14;951;254;0;120052;100972;0;52.9;44.5;0.0
43;2021-07-15;1797;1834;0;121849;102806;0;53.7;45.3;0.0
43;2021-07-16;1597;1618;0;123446;104424;0;54.4;46.0;0.0
43;2021-07-17;1358;1062;0;124804;105486;0;55.0;46.5;0.0
43;2021-07-18;82;92;0;124886;105578;0;55.0;46.5;0.0
43;2021-07-19;1374;1303;0;126260;106881;0;55.6;47.1;0.0
43;2021-07-20;1752;1397;0;128012;108278;0;56.4;47.7;0.0
43;2021-07-21;1767;1156;0;129779;109434;0;57.2;48.2;0.0
43;2021-07-22;1951;1298;0;131730;110732;0;58.1;48.8;0.0
43;2021-07-23;1528;1296;0;133258;112028;0;58.7;49.4;0.0
43;2021-07-24;580;913;0;133838;112941;0;59.0;49.8;0.0
43;2021-07-25;77;62;0;133915;113003;0;59.0;49.8;0.0
43;2021-07-26;1502;1055;0;135417;114058;0;59.7;50.3;0.0
43;2021-07-27;1967;1105;0;137384;115163;0;60.5;50.8;0.0
43;2021-07-28;1830;1053;0;139214;116216;0;61.4;51.2;0.0
43;2021-07-29;1830;997;0;141044;117213;0;62.2;51.7;0.0
43;2021-07-30;1724;1260;0;142768;118473;0;62.9;52.2;0.0
43;2021-07-31;707;560;0;143475;119033;0;63.2;52.5;0.0
43;2021-08-01;98;57;0;143573;119090;0;63.3;52.5;0.0
43;2021-08-02;1489;932;0;145062;120022;0;63.9;52.9;0.0
43;2021-08-03;1265;1081;0;146327;121103;0;64.5;53.4;0.0
43;2021-08-04;1189;1121;0;147516;122224;0;65.0;53.9;0.0
43;2021-08-05;1138;1239;0;148654;123463;0;65.5;54.4;0.0
43;2021-08-06;1098;1404;0;149752;124867;0;66.0;55.0;0.0
43;2021-08-07;492;721;0;150244;125588;0;66.2;55.3;0.0
43;2021-08-08;42;66;0;150286;125654;0;66.2;55.4;0.0
43;2021-08-09;793;1527;0;151079;127181;0;66.6;56.1;0.0
43;2021-08-10;955;1465;0;152034;128646;0;67.0;56.7;0.0
43;2021-08-11;698;1293;0;152732;129939;0;67.3;57.3;0.0
43;2021-08-12;820;1451;0;153552;131390;0;67.7;57.9;0.0
43;2021-08-13;675;1172;0;154227;132562;0;68.0;58.4;0.0
43;2021-08-14;326;554;0;154553;133116;0;68.1;58.7;0.0
43;2021-08-15;16;49;0;154569;133165;0;68.1;58.7;0.0
43;2021-08-16;668;1596;0;155237;134761;0;68.4;59.4;0.0
43;2021-08-17;654;1414;0;155891;136175;0;68.7;60.0;0.0
43;2021-08-18;536;1439;0;156427;137614;0;68.9;60.6;0.0
43;2021-08-19;602;1463;0;157029;139077;0;69.2;61.3;0.0
43;2021-08-20;522;1525;0;157551;140602;0;69.4;62.0;0.0
43;2021-08-21;212;514;0;157763;141116;0;69.5;62.2;0.0
43;2021-08-22;14;80;0;157777;141196;0;69.5;62.2;0.0
43;2021-08-23;490;1547;0;158267;142743;0;69.8;62.9;0.0
43;2021-08-24;498;1321;0;158765;144064;0;70.0;63.5;0.0
43;2021-08-25;473;1276;0;159238;145340;0;70.2;64.1;0.0
43;2021-08-26;451;1110;0;159689;146450;0;70.4;64.5;0.0
43;2021-08-27;539;1301;0;160228;147751;0;70.6;65.1;0.0
43;2021-08-28;182;492;0;160410;148243;0;70.7;65.3;0.0
43;2021-08-29;6;55;0;160416;148298;0;70.7;65.4;0.0
43;2021-08-30;490;1091;21;160906;149389;21;70.9;65.8;0.0
43;2021-08-31;383;871;52;161289;150260;73;71.1;66.2;0.0
43;2021-09-01;320;931;72;161609;151191;145;71.2;66.6;0.1
43;2021-09-02;352;844;102;161961;152035;247;71.4;67.0;0.1
43;2021-09-03;527;920;102;162488;152955;349;71.6;67.4;0.2
43;2021-09-04;306;496;22;162794;153451;371;71.7;67.6;0.2
43;2021-09-05;54;34;15;162848;153485;386;71.8;67.6;0.2
43;2021-09-06;257;674;80;163105;154159;466;71.9;67.9;0.2
43;2021-09-07;242;585;101;163347;154744;567;72.0;68.2;0.2
43;2021-09-08;252;554;94;163599;155298;661;72.1;68.4;0.3
43;2021-09-09;259;569;149;163858;155867;810;72.2;68.7;0.4
43;2021-09-10;333;617;106;164191;156484;916;72.4;69.0;0.4
43;2021-09-11;252;369;51;164443;156853;967;72.5;69.1;0.4
43;2021-09-12;3;16;0;164446;156869;967;72.5;69.1;0.4
43;2021-09-13;169;387;158;164615;157256;1125;72.5;69.3;0.5
43;2021-09-14;219;353;298;164834;157609;1423;72.6;69.5;0.6
43;2021-09-15;240;502;251;165074;158111;1674;72.8;69.7;0.7
43;2021-09-16;183;329;282;165257;158440;1956;72.8;69.8;0.9
43;2021-09-17;229;527;351;165486;158967;2307;72.9;70.1;1.0
43;2021-09-18;149;337;68;165635;159304;2375;73.0;70.2;1.0
43;2021-09-19;6;9;1;165641;159313;2376;73.0;70.2;1.0
43;2021-09-20;116;323;264;165757;159636;2640;73.1;70.4;1.2
43;2021-09-21;147;328;462;165904;159964;3102;73.1;70.5;1.4
43;2021-09-22;133;423;261;166037;160387;3363;73.2;70.7;1.5
43;2021-09-23;82;298;269;166119;160685;3632;73.2;70.8;1.6
43;2021-09-24;182;525;204;166301;161210;3836;73.3;71.0;1.7
43;2021-09-25;101;292;65;166402;161502;3901;73.3;71.2;1.7
43;2021-09-26;2;19;0;166404;161521;3901;73.3;71.2;1.7
43;2021-09-27;138;338;324;166542;161859;4225;73.4;71.3;1.9
43;2021-09-28;352;200;251;166894;162059;4476;73.6;71.4;2.0
43;2021-09-29;155;292;132;167049;162351;4608;73.6;71.6;2.0
43;2021-09-30;88;187;284;167137;162538;4892;73.7;71.6;2.2
43;2021-10-01;142;322;248;167279;162860;5140;73.7;71.8;2.3
43;2021-10-02;101;234;58;167380;163094;5198;73.8;71.9;2.3
43;2021-10-03;8;18;0;167388;163112;5198;73.8;71.9;2.3
43;2021-10-04;118;204;280;167506;163316;5478;73.8;72.0;2.4
43;2021-10-05;122;181;337;167628;163497;5815;73.9;72.1;2.6
43;2021-10-06;129;258;250;167757;163755;6065;73.9;72.2;2.7
43;2021-10-07;71;140;281;167828;163895;6346;74.0;72.2;2.8
43;2021-10-08;177;319;311;168005;164214;6657;74.0;72.4;2.9
43;2021-10-09;104;202;109;168109;164416;6766;74.1;72.5;3.0
43;2021-10-10;6;7;3;168115;164423;6769;74.1;72.5;3.0
43;2021-10-11;113;154;325;168228;164577;7094;74.1;72.5;3.1
43;2021-10-12;108;180;325;168336;164757;7419;74.2;72.6;3.3
43;2021-10-13;110;121;187;168446;164878;7606;74.2;72.7;3.4
43;2021-10-14;99;152;270;168545;165030;7876;74.3;72.7;3.5
43;2021-10-15;168;204;543;168713;165234;8419;74.4;72.8;3.7
43;2021-10-16;101;135;109;168814;165369;8528;74.4;72.9;3.8
43;2021-10-17;2;7;1;168816;165376;8529;74.4;72.9;3.8
43;2021-10-18;102;161;351;168918;165537;8880;74.4;73.0;3.9
43;2021-10-19;72;331;428;168990;165868;9308;74.5;73.1;4.1
43;2021-10-20;59;160;260;169049;166028;9568;74.5;73.2;4.2
43;2021-10-21;46;105;367;169095;166133;9935;74.5;73.2;4.4
43;2021-10-22;61;132;478;169156;166265;10413;74.6;73.3;4.6
43;2021-10-23;34;110;148;169190;166375;10561;74.6;73.3;4.7
43;2021-10-24;2;4;0;169192;166379;10561;74.6;73.3;4.7
43;2021-10-25;42;90;529;169234;166469;11090;74.6;73.4;4.9
43;2021-10-26;71;107;665;169305;166576;11755;74.6;73.4;5.2
43;2021-10-27;55;112;535;169360;166688;12290;74.6;73.5;5.4
43;2021-10-28;35;65;321;169395;166753;12611;74.7;73.5;5.6
43;2021-10-29;96;173;657;169491;166926;13268;74.7;73.6;5.8
43;2021-10-30;35;97;157;169526;167023;13425;74.7;73.6;5.9
43;2021-10-31;0;4;1;169526;167027;13426;74.7;73.6;5.9
43;2021-11-01;1;2;5;169527;167029;13431;74.7;73.6;5.9
43;2021-11-02;78;133;585;169605;167162;14016;74.7;73.7;6.2
43;2021-11-03;65;141;506;169670;167303;14522;74.8;73.7;6.4
43;2021-11-04;50;80;543;169720;167383;15065;74.8;73.8;6.6
43;2021-11-05;63;109;641;169783;167492;15706;74.8;73.8;6.9
43;2021-11-06;34;80;226;169817;167572;15932;74.8;73.9;7.0
43;2021-11-07;1;2;1;169818;167574;15933;74.8;73.9;7.0
43;2021-11-08;44;122;635;169862;167696;16568;74.9;73.9;7.3
43;2021-11-09;64;72;910;169926;167768;17478;74.9;73.9;7.7
43;2021-11-10;70;92;647;169996;167860;18125;74.9;74.0;8.0
43;2021-11-11;0;2;3;169996;167862;18128;74.9;74.0;8.0
43;2021-11-12;63;93;1025;170059;167955;19153;74.9;74.0;8.4
43;2021-11-13;20;28;322;170079;167983;19475;75.0;74.0;8.6
43;2021-11-14;1;12;14;170080;167995;19489;75.0;74.0;8.6
43;2021-11-15;36;42;714;170116;168037;20203;75.0;74.1;8.9
43;2021-11-16;80;82;1179;170196;168119;21382;75.0;74.1;9.4
43;2021-11-17;69;66;761;170265;168185;22143;75.0;74.1;9.8
43;2021-11-18;38;38;751;170303;168223;22894;75.1;74.1;10.1
43;2021-11-19;67;81;988;170370;168304;23882;75.1;74.2;10.5
43;2021-11-20;45;50;281;170415;168354;24163;75.1;74.2;10.6
43;2021-11-21;2;1;20;170417;168355;24183;75.1;74.2;10.7
43;2021-11-22;60;35;820;170477;168390;25003;75.1;74.2;11.0
43;2021-11-23;65;48;1134;170542;168438;26137;75.2;74.2;11.5
43;2021-11-24;73;78;773;170615;168516;26910;75.2;74.3;11.9
43;2021-11-25;54;45;1117;170669;168561;28027;75.2;74.3;12.4
43;2021-11-26;86;65;1489;170755;168626;29516;75.3;74.3;13.0
43;2021-11-27;48;47;731;170803;168673;30247;75.3;74.3;13.3
43;2021-11-28;3;1;29;170806;168674;30276;75.3;74.3;13.3
43;2021-11-29;47;47;1449;170853;168721;31725;75.3;74.4;14.0
43;2021-11-30;67;62;2101;170920;168783;33826;75.3;74.4;14.9
43;2021-12-01;45;61;1846;170965;168844;35672;75.3;74.4;15.7
43;2021-12-02;44;38;2174;171009;168882;37846;75.4;74.4;16.7
43;2021-12-03;69;67;2117;171078;168949;39963;75.4;74.5;17.6
43;2021-12-04;51;39;1506;171129;168988;41469;75.4;74.5;18.3
43;2021-12-05;3;0;27;171132;168988;41496;75.4;74.5;18.3
43;2021-12-06;41;44;2156;171173;169032;43652;75.4;74.5;19.2
43;2021-12-07;62;50;2408;171235;169082;46060;75.5;74.5;20.3
43;2021-12-08;56;56;1928;171291;169138;47988;75.5;74.5;21.1
43;2021-12-09;73;66;2533;171364;169204;50521;75.5;74.6;22.3
43;2021-12-10;47;71;2398;171411;169275;52919;75.5;74.6;23.3
43;2021-12-11;38;63;1159;171449;169338;54078;75.6;74.6;23.8
43;2021-12-12;2;6;62;171451;169344;54140;75.6;74.6;23.9
43;2021-12-13;47;67;2368;171498;169411;56508;75.6;74.7;24.9
43;2021-12-14;67;73;3007;171565;169484;59515;75.6;74.7;26.2
43;2021-12-15;32;72;2313;171597;169556;61828;75.6;74.7;27.2
43;2021-12-16;55;67;2914;171652;169623;64742;75.7;74.8;28.5
44;2020-12-27;2;0;0;2;0;0;0.0;0.0;0.0
44;2020-12-28;4;1;0;6;1;0;0.0;0.0;0.0
44;2020-12-29;1;0;0;7;1;0;0.0;0.0;0.0
44;2020-12-30;1;0;0;8;1;0;0.0;0.0;0.0
44;2020-12-31;0;0;0;8;1;0;0.0;0.0;0.0
44;2021-01-01;2;1;0;10;2;0;0.0;0.0;0.0
44;2021-01-02;0;0;0;10;2;0;0.0;0.0;0.0
44;2021-01-03;3;0;0;13;2;0;0.0;0.0;0.0
44;2021-01-04;4;0;0;17;2;0;0.0;0.0;0.0
44;2021-01-05;5;0;0;22;2;0;0.0;0.0;0.0
44;2021-01-06;32;1;0;54;3;0;0.0;0.0;0.0
44;2021-01-07;204;0;0;258;3;0;0.0;0.0;0.0
44;2021-01-08;551;0;0;809;3;0;0.1;0.0;0.0
44;2021-01-09;475;0;0;1284;3;0;0.1;0.0;0.0
44;2021-01-10;443;1;0;1727;4;0;0.1;0.0;0.0
44;2021-01-11;811;1;0;2538;5;0;0.2;0.0;0.0
44;2021-01-12;957;1;0;3495;6;0;0.2;0.0;0.0
44;2021-01-13;1074;2;0;4569;8;0;0.3;0.0;0.0
44;2021-01-14;1145;9;0;5714;17;0;0.4;0.0;0.0
44;2021-01-15;1051;5;0;6765;22;0;0.5;0.0;0.0
44;2021-01-16;341;3;0;7106;25;0;0.5;0.0;0.0
44;2021-01-17;307;2;0;7413;27;0;0.5;0.0;0.0
44;2021-01-18;831;4;0;8244;31;0;0.6;0.0;0.0
44;2021-01-19;2613;12;0;10857;43;0;0.8;0.0;0.0
44;2021-01-20;2689;6;0;13546;49;0;0.9;0.0;0.0
44;2021-01-21;4564;12;0;18110;61;0;1.3;0.0;0.0
44;2021-01-22;2480;10;0;20590;71;0;1.4;0.0;0.0
44;2021-01-23;768;0;0;21358;71;0;1.5;0.0;0.0
44;2021-01-24;123;0;0;21481;71;0;1.5;0.0;0.0
44;2021-01-25;858;9;0;22339;80;0;1.6;0.0;0.0
44;2021-01-26;2481;22;0;24820;102;0;1.7;0.0;0.0
44;2021-01-27;2078;69;0;26898;171;0;1.9;0.0;0.0
44;2021-01-28;3605;201;0;30503;372;0;2.1;0.0;0.0
44;2021-01-29;2303;486;0;32806;858;0;2.3;0.1;0.0
44;2021-01-30;623;205;0;33429;1063;0;2.3;0.1;0.0
44;2021-01-31;19;204;0;33448;1267;0;2.3;0.1;0.0
44;2021-02-01;560;543;0;34008;1810;0;2.4;0.1;0.0
44;2021-02-02;888;771;0;34896;2581;0;2.4;0.2;0.0
44;2021-02-03;911;877;0;35807;3458;0;2.5;0.2;0.0
44;2021-02-04;981;744;0;36788;4202;0;2.6;0.3;0.0
44;2021-02-05;913;677;0;37701;4879;0;2.6;0.3;0.0
44;2021-02-06;472;272;0;38173;5151;0;2.7;0.4;0.0
44;2021-02-07;65;194;0;38238;5345;0;2.7;0.4;0.0
44;2021-02-08;540;485;0;38778;5830;0;2.7;0.4;0.0
44;2021-02-09;1000;1276;0;39778;7106;0;2.8;0.5;0.0
44;2021-02-10;1171;1264;0;40949;8370;0;2.8;0.6;0.0
44;2021-02-11;2301;3168;0;43250;11538;0;3.0;0.8;0.0
44;2021-02-12;1680;1770;0;44930;13308;0;3.1;0.9;0.0
44;2021-02-13;447;520;0;45377;13828;0;3.2;1.0;0.0
44;2021-02-14;12;178;0;45389;14006;0;3.2;1.0;0.0
44;2021-02-15;484;1097;0;45873;15103;0;3.2;1.1;0.0
44;2021-02-16;1432;2546;0;47305;17649;0;3.3;1.2;0.0
44;2021-02-17;1137;2150;0;48442;19799;0;3.4;1.4;0.0
44;2021-02-18;1983;3652;0;50425;23451;0;3.5;1.6;0.0
44;2021-02-19;1589;2450;0;52014;25901;0;3.6;1.8;0.0
44;2021-02-20;395;631;0;52409;26532;0;3.6;1.8;0.0
44;2021-02-21;7;181;0;52416;26713;0;3.6;1.9;0.0
44;2021-02-22;740;822;0;53156;27535;0;3.7;1.9;0.0
44;2021-02-23;1183;1126;0;54339;28661;0;3.8;2.0;0.0
44;2021-02-24;1246;1056;0;55585;29717;0;3.9;2.1;0.0
44;2021-02-25;2482;1107;0;58067;30824;0;4.0;2.1;0.0
44;2021-02-26;2331;999;0;60398;31823;0;4.2;2.2;0.0
44;2021-02-27;954;431;0;61352;32254;0;4.3;2.2;0.0
44;2021-02-28;6;34;0;61358;32288;0;4.3;2.2;0.0
44;2021-03-01;1001;554;0;62359;32842;0;4.3;2.3;0.0
44;2021-03-02;1794;1088;0;64153;33930;0;4.5;2.4;0.0
44;2021-03-03;1877;1157;0;66030;35087;0;4.6;2.4;0.0
44;2021-03-04;2890;1624;0;68920;36711;0;4.8;2.6;0.0
44;2021-03-05;3506;1312;0;72426;38023;0;5.0;2.6;0.0
44;2021-03-06;2496;484;0;74922;38507;0;5.2;2.7;0.0
44;2021-03-07;989;91;0;75911;38598;0;5.3;2.7;0.0
44;2021-03-08;1825;642;0;77736;39240;0;5.4;2.7;0.0
44;2021-03-09;3394;1155;0;81130;40395;0;5.6;2.8;0.0
44;2021-03-10;3095;1147;0;84225;41542;0;5.9;2.9;0.0
44;2021-03-11;4445;1784;0;88670;43326;0;6.2;3.0;0.0
44;2021-03-12;6006;1344;0;94676;44670;0;6.6;3.1;0.0
44;2021-03-13;3581;314;0;98257;44984;0;6.8;3.1;0.0
44;2021-03-14;435;56;0;98692;45040;0;6.9;3.1;0.0
44;2021-03-15;2657;415;0;101349;45455;0;7.1;3.2;0.0
44;2021-03-16;2194;663;0;103543;46118;0;7.2;3.2;0.0
44;2021-03-17;2069;691;0;105612;46809;0;7.3;3.3;0.0
44;2021-03-18;2290;660;0;107902;47469;0;7.5;3.3;0.0
44;2021-03-19;3812;415;0;111714;47884;0;7.8;3.3;0.0
44;2021-03-20;3192;312;0;114906;48196;0;8.0;3.4;0.0
44;2021-03-21;898;23;0;115804;48219;0;8.1;3.4;0.0
44;2021-03-22;2473;497;0;118277;48716;0;8.2;3.4;0.0
44;2021-03-23;3987;695;0;122264;49411;0;8.5;3.4;0.0
44;2021-03-24;4381;663;0;126645;50074;0;8.8;3.5;0.0
44;2021-03-25;5683;959;0;132328;51033;0;9.2;3.6;0.0
44;2021-03-26;6608;762;0;138936;51795;0;9.7;3.6;0.0
44;2021-03-27;3213;443;0;142149;52238;0;9.9;3.6;0.0
44;2021-03-28;1211;46;0;143360;52284;0;10.0;3.6;0.0
44;2021-03-29;3233;840;0;146593;53124;0;10.2;3.7;0.0
44;2021-03-30;5208;1161;0;151801;54285;0;10.6;3.8;0.0
44;2021-03-31;4664;1354;0;156465;55639;0;10.9;3.9;0.0
44;2021-04-01;6289;1045;0;162754;56684;0;11.3;3.9;0.0
44;2021-04-02;5847;1017;0;168601;57701;0;11.7;4.0;0.0
44;2021-04-03;2403;650;0;171004;58351;0;11.9;4.1;0.0
44;2021-04-04;663;22;0;171667;58373;0;11.9;4.1;0.0
44;2021-04-05;675;288;0;172342;58661;0;12.0;4.1;0.0
44;2021-04-06;4322;1451;0;176664;60112;0;12.3;4.2;0.0
44;2021-04-07;5287;1687;0;181951;61799;0;12.7;4.3;0.0
44;2021-04-08;7265;1742;0;189216;63541;0;13.2;4.4;0.0
44;2021-04-09;10176;1897;0;199392;65438;0;13.9;4.6;0.0
44;2021-04-10;4615;1435;0;204007;66873;0;14.2;4.7;0.0
44;2021-04-11;2091;422;0;206098;67295;0;14.3;4.7;0.0
44;2021-04-12;5636;1744;0;211734;69039;0;14.7;4.8;0.0
44;2021-04-13;6896;2336;0;218630;71375;0;15.2;5.0;0.0
44;2021-04-14;6070;2305;0;224700;73680;0;15.6;5.1;0.0
44;2021-04-15;7046;2243;0;231746;75923;0;16.1;5.3;0.0
44;2021-04-16;8020;2123;0;239766;78046;0;16.7;5.4;0.0
44;2021-04-17;4334;1399;0;244100;79445;0;17.0;5.5;0.0
44;2021-04-18;2197;798;0;246297;80243;0;17.1;5.6;0.0
44;2021-04-19;5065;2009;0;251362;82252;0;17.5;5.7;0.0
44;2021-04-20;6269;2688;0;257631;84940;0;17.9;5.9;0.0
44;2021-04-21;6085;2855;0;263716;87795;0;18.4;6.1;0.0
44;2021-04-22;7015;2598;0;270731;90393;0;18.8;6.3;0.0
44;2021-04-23;7332;3243;0;278063;93636;0;19.3;6.5;0.0
44;2021-04-24;4003;2039;0;282066;95675;0;19.6;6.7;0.0
44;2021-04-25;2027;1036;0;284093;96711;0;19.8;6.7;0.0
44;2021-04-26;5658;2861;0;289751;99572;0;20.2;6.9;0.0
44;2021-04-27;7482;4221;0;297233;103793;0;20.7;7.2;0.0
44;2021-04-28;7673;3781;0;304906;107574;0;21.2;7.5;0.0
44;2021-04-29;9063;4370;0;313969;111944;0;21.8;7.8;0.0
44;2021-04-30;9565;4732;0;323534;116676;0;22.5;8.1;0.0
44;2021-05-01;2968;888;0;326502;117564;0;22.7;8.2;0.0
44;2021-05-02;1970;611;0;328472;118175;0;22.9;8.2;0.0
44;2021-05-03;5551;4221;0;334023;122396;0;23.2;8.5;0.0
44;2021-05-04;6325;5316;0;340348;127712;0;23.7;8.9;0.0
44;2021-05-05;6026;4774;0;346374;132486;0;24.1;9.2;0.0
44;2021-05-06;7416;5070;0;353790;137556;0;24.6;9.6;0.0
44;2021-05-07;7397;5958;0;361187;143514;0;25.1;10.0;0.0
44;2021-05-08;2684;1284;0;363871;144798;0;25.3;10.1;0.0
44;2021-05-09;1888;1791;0;365759;146589;0;25.5;10.2;0.0
44;2021-05-10;6348;6015;0;372107;152604;0;25.9;10.6;0.0
44;2021-05-11;7605;6489;0;379712;159093;0;26.4;11.1;0.0
44;2021-05-12;8122;5959;0;387834;165052;0;27.0;11.5;0.0
44;2021-05-13;5769;1216;0;393603;166268;0;27.4;11.6;0.0
44;2021-05-14;7743;4141;0;401346;170409;0;27.9;11.9;0.0
44;2021-05-15;5050;2244;0;406396;172653;0;28.3;12.0;0.0
44;2021-05-16;3061;769;0;409457;173422;0;28.5;12.1;0.0
44;2021-05-17;6849;5249;0;416306;178671;0;29.0;12.4;0.0
44;2021-05-18;8217;5295;0;424523;183966;0;29.5;12.8;0.0
44;2021-05-19;8613;4398;0;433136;188364;0;30.1;13.1;0.0
44;2021-05-20;8979;4703;0;442115;193067;0;30.8;13.4;0.0
44;2021-05-21;9278;5268;0;451393;198335;0;31.4;13.8;0.0
44;2021-05-22;5567;2289;0;456960;200624;0;31.8;14.0;0.0
44;2021-05-23;2159;850;0;459119;201474;0;31.9;14.0;0.0
44;2021-05-24;5493;1638;0;464612;203112;0;32.3;14.1;0.0
44;2021-05-25;8253;5584;0;472865;208696;0;32.9;14.5;0.0
44;2021-05-26;8641;5141;0;481506;213837;0;33.5;14.9;0.0
44;2021-05-27;10203;5352;0;491709;219189;0;34.2;15.3;0.0
44;2021-05-28;9644;6892;0;501353;226081;0;34.9;15.7;0.0
44;2021-05-29;6431;3318;0;507784;229399;0;35.3;16.0;0.0
44;2021-05-30;2279;724;0;510063;230123;0;35.5;16.0;0.0
44;2021-05-31;8522;6122;0;518585;236245;0;36.1;16.4;0.0
44;2021-06-01;10503;6564;0;529088;242809;0;36.8;16.9;0.0
44;2021-06-02;10068;5652;0;539156;248461;0;37.5;17.3;0.0
44;2021-06-03;11344;5871;0;550500;254332;0;38.3;17.7;0.0
44;2021-06-04;10550;8136;0;561050;262468;0;39.0;18.3;0.0
44;2021-06-05;6407;4351;0;567457;266819;0;39.5;18.6;0.0
44;2021-06-06;2699;1109;0;570156;267928;0;39.7;18.6;0.0
44;2021-06-07;9484;6989;0;579640;274917;0;40.3;19.1;0.0
44;2021-06-08;11142;7618;0;590782;282535;0;41.1;19.7;0.0
44;2021-06-09;10768;6519;0;601550;289054;0;41.9;20.1;0.0
44;2021-06-10;11580;6073;0;613130;295127;0;42.7;20.5;0.0
44;2021-06-11;11839;8717;0;624969;303844;0;43.5;21.1;0.0
44;2021-06-12;7840;4057;0;632809;307901;0;44.0;21.4;0.0
44;2021-06-13;3356;1063;0;636165;308964;0;44.3;21.5;0.0
44;2021-06-14;8459;8411;0;644624;317375;0;44.9;22.1;0.0
44;2021-06-15;10958;8318;0;655582;325693;0;45.6;22.7;0.0
44;2021-06-16;10721;7648;0;666303;333341;0;46.4;23.2;0.0
44;2021-06-17;11517;8667;0;677820;342008;0;47.2;23.8;0.0
44;2021-06-18;10498;10015;1;688318;352023;1;47.9;24.5;0.0
44;2021-06-19;5922;4289;0;694240;356312;1;48.3;24.8;0.0
44;2021-06-20;2601;1362;0;696841;357674;1;48.5;24.9;0.0
44;2021-06-21;7028;9896;0;703869;367570;1;49.0;25.6;0.0
44;2021-06-22;8125;10578;0;711994;378148;1;49.5;26.3;0.0
44;2021-06-23;8249;9148;0;720243;387296;1;50.1;26.9;0.0
44;2021-06-24;8955;8640;0;729198;395936;1;50.7;27.6;0.0
44;2021-06-25;7274;10836;0;736472;406772;1;51.2;28.3;0.0
44;2021-06-26;2949;6470;0;739421;413242;1;51.5;28.8;0.0
44;2021-06-27;935;2515;0;740356;415757;1;51.5;28.9;0.0
44;2021-06-28;4959;10171;0;745315;425928;1;51.9;29.6;0.0
44;2021-06-29;5980;12154;0;751295;438082;1;52.3;30.5;0.0
44;2021-06-30;5876;10677;1;757171;448759;2;52.7;31.2;0.0
44;2021-07-01;6593;10707;0;763764;459466;2;53.1;32.0;0.0
44;2021-07-02;6057;12764;2;769821;472230;4;53.6;32.9;0.0
44;2021-07-03;2566;7063;1;772387;479293;5;53.7;33.4;0.0
44;2021-07-04;1068;2328;0;773455;481621;5;53.8;33.5;0.0
44;2021-07-05;4793;11943;2;778248;493564;7;54.2;34.3;0.0
44;2021-07-06;5395;12775;1;783643;506339;8;54.5;35.2;0.0
44;2021-07-07;5966;11247;2;789609;517586;10;54.9;36.0;0.0
44;2021-07-08;6769;12013;1;796378;529599;11;55.4;36.9;0.0
44;2021-07-09;5625;14297;1;802003;543896;12;55.8;37.8;0.0
44;2021-07-10;2274;7183;0;804277;551079;12;56.0;38.3;0.0
44;2021-07-11;869;2650;0;805146;553729;12;56.0;38.5;0.0
44;2021-07-12;3971;14088;0;809117;567817;12;56.3;39.5;0.0
44;2021-07-13;5458;14861;2;814575;582678;14;56.7;40.5;0.0
44;2021-07-14;3639;6122;0;818214;588800;14;56.9;41.0;0.0
44;2021-07-15;6945;14358;0;825159;603158;14;57.4;42.0;0.0
44;2021-07-16;7861;14920;1;833020;618078;15;58.0;43.0;0.0
44;2021-07-17;3287;7755;1;836307;625833;16;58.2;43.5;0.0
44;2021-07-18;2000;2883;0;838307;628716;16;58.3;43.7;0.0
44;2021-07-19;4829;14647;0;843136;643363;16;58.7;44.8;0.0
44;2021-07-20;6369;15617;0;849505;658980;16;59.1;45.9;0.0
44;2021-07-21;6284;14072;1;855789;673052;17;59.5;46.8;0.0
44;2021-07-22;7254;13636;0;863043;686688;17;60.1;47.8;0.0
44;2021-07-23;6632;15417;0;869675;702105;17;60.5;48.9;0.0
44;2021-07-24;3188;8569;0;872863;710674;17;60.7;49.5;0.0
44;2021-07-25;1122;3125;0;873985;713799;17;60.8;49.7;0.0
44;2021-07-26;6719;12520;1;880704;726319;18;61.3;50.5;0.0
44;2021-07-27;10278;12014;2;890982;738333;20;62.0;51.4;0.0
44;2021-07-28;9789;10625;0;900771;748958;20;62.7;52.1;0.0
44;2021-07-29;10913;10652;0;911684;759610;20;63.4;52.9;0.0
44;2021-07-30;9786;10708;1;921470;770318;21;64.1;53.6;0.0
44;2021-07-31;5139;5386;0;926609;775704;21;64.5;54.0;0.0
44;2021-08-01;2696;1453;0;929305;777157;21;64.7;54.1;0.0
44;2021-08-02;7168;9190;0;936473;786347;21;65.2;54.7;0.0
44;2021-08-03;9231;8134;0;945704;794481;21;65.8;55.3;0.0
44;2021-08-04;9793;6775;0;955497;801256;21;66.5;55.8;0.0
44;2021-08-05;11776;7210;0;967273;808466;21;67.3;56.3;0.0
44;2021-08-06;10169;7965;0;977442;816431;21;68.0;56.8;0.0
44;2021-08-07;4741;3683;0;982183;820114;21;68.3;57.1;0.0
44;2021-08-08;2590;1516;0;984773;821630;21;68.5;57.2;0.0
44;2021-08-09;8452;7344;2;993225;828974;23;69.1;57.7;0.0
44;2021-08-10;9771;7077;0;1002996;836051;23;69.8;58.2;0.0
44;2021-08-11;9685;6244;1;1012681;842295;24;70.5;58.6;0.0
44;2021-08-12;9597;6712;0;1022278;849007;24;71.1;59.1;0.0
44;2021-08-13;7844;5956;1;1030122;854963;25;71.7;59.5;0.0
44;2021-08-14;2938;3058;0;1033060;858021;25;71.9;59.7;0.0
44;2021-08-15;830;953;0;1033890;858974;25;71.9;59.8;0.0
44;2021-08-16;5293;7881;0;1039183;866855;25;72.3;60.3;0.0
44;2021-08-17;5364;8151;2;1044547;875006;27;72.7;60.9;0.0
44;2021-08-18;4725;7566;0;1049272;882572;27;73.0;61.4;0.0
44;2021-08-19;4653;8194;0;1053925;890766;27;73.3;62.0;0.0
44;2021-08-20;4285;8871;0;1058210;899637;27;73.6;62.6;0.0
44;2021-08-21;1862;4621;0;1060072;904258;27;73.8;62.9;0.0
44;2021-08-22;804;2538;0;1060876;906796;27;73.8;63.1;0.0
44;2021-08-23;3426;9304;0;1064302;916100;27;74.1;63.7;0.0
44;2021-08-24;3398;8777;0;1067700;924877;27;74.3;64.4;0.0
44;2021-08-25;2970;8533;0;1070670;933410;27;74.5;64.9;0.0
44;2021-08-26;2689;10001;2;1073359;943411;29;74.7;65.6;0.0
44;2021-08-27;2903;10471;1;1076262;953882;30;74.9;66.4;0.0
44;2021-08-28;1329;5712;0;1077591;959594;30;75.0;66.8;0.0
44;2021-08-29;519;2765;0;1078110;962359;30;75.0;67.0;0.0
44;2021-08-30;2385;10398;93;1080495;972757;123;75.2;67.7;0.0
44;2021-08-31;2602;10478;242;1083097;983235;365;75.4;68.4;0.0
44;2021-09-01;2551;8998;416;1085648;992233;781;75.5;69.0;0.1
44;2021-09-02;2174;7643;480;1087822;999876;1261;75.7;69.6;0.1
44;2021-09-03;1997;8990;500;1089819;1008866;1761;75.8;70.2;0.1
44;2021-09-04;1317;5466;194;1091136;1014332;1955;75.9;70.6;0.1
44;2021-09-05;455;1255;130;1091591;1015587;2085;76.0;70.7;0.1
44;2021-09-06;1484;5487;583;1093075;1021074;2668;76.1;71.0;0.2
44;2021-09-07;1386;4793;575;1094461;1025867;3243;76.2;71.4;0.2
44;2021-09-08;1734;5646;484;1096195;1031513;3727;76.3;71.8;0.3
44;2021-09-09;1359;4124;662;1097554;1035637;4389;76.4;72.1;0.3
44;2021-09-10;1754;5558;686;1099308;1041195;5075;76.5;72.4;0.4
44;2021-09-11;1004;3744;224;1100312;1044939;5299;76.6;72.7;0.4
44;2021-09-12;210;862;36;1100522;1045801;5335;76.6;72.8;0.4
44;2021-09-13;1096;3288;900;1101618;1049089;6235;76.7;73.0;0.4
44;2021-09-14;1060;3046;1330;1102678;1052135;7565;76.7;73.2;0.5
44;2021-09-15;1385;4272;1022;1104063;1056407;8587;76.8;73.5;0.6
44;2021-09-16;930;2227;1173;1104993;1058634;9760;76.9;73.7;0.7
44;2021-09-17;1158;3720;1198;1106151;1062354;10958;77.0;73.9;0.8
44;2021-09-18;674;2958;202;1106825;1065312;11160;77.0;74.1;0.8
44;2021-09-19;175;688;53;1107000;1066000;11213;77.0;74.2;0.8
44;2021-09-20;832;2030;1139;1107832;1068030;12352;77.1;74.3;0.9
44;2021-09-21;716;1799;1081;1108548;1069829;13433;77.1;74.4;0.9
44;2021-09-22;884;3288;933;1109432;1073117;14366;77.2;74.7;1.0
44;2021-09-23;798;1835;1442;1110230;1074952;15808;77.3;74.8;1.1
44;2021-09-24;1003;2820;1154;1111233;1077772;16962;77.3;75.0;1.2
44;2021-09-25;462;2158;256;1111695;1079930;17218;77.4;75.1;1.2
44;2021-09-26;165;472;54;1111860;1080402;17272;77.4;75.2;1.2
44;2021-09-27;720;1661;1045;1112580;1082063;18317;77.4;75.3;1.3
44;2021-09-28;587;1508;1412;1113167;1083571;19729;77.5;75.4;1.4
44;2021-09-29;919;2385;1182;1114086;1085956;20911;77.5;75.6;1.5
44;2021-09-30;665;1427;1615;1114751;1087383;22526;77.6;75.7;1.6
44;2021-10-01;892;2070;1343;1115643;1089453;23869;77.6;75.8;1.7
44;2021-10-02;460;1220;241;1116103;1090673;24110;77.7;75.9;1.7
44;2021-10-03;184;323;58;1116287;1090996;24168;77.7;75.9;1.7
44;2021-10-04;488;882;558;1116775;1091878;24726;77.7;76.0;1.7
44;2021-10-05;469;909;1038;1117244;1092787;25764;77.7;76.0;1.8
44;2021-10-06;691;1470;940;1117935;1094257;26704;77.8;76.1;1.9
44;2021-10-07;524;1012;1322;1118459;1095269;28026;77.8;76.2;2.0
44;2021-10-08;796;1461;1255;1119255;1096730;29281;77.9;76.3;2.0
44;2021-10-09;352;842;338;1119607;1097572;29619;77.9;76.4;2.1
44;2021-10-10;98;188;124;1119705;1097760;29743;77.9;76.4;2.1
44;2021-10-11;494;960;1182;1120199;1098720;30925;77.9;76.5;2.2
44;2021-10-12;441;795;1325;1120640;1099515;32250;78.0;76.5;2.2
44;2021-10-13;598;1050;1065;1121238;1100565;33315;78.0;76.6;2.3
44;2021-10-14;535;893;1372;1121773;1101458;34687;78.1;76.6;2.4
44;2021-10-15;668;1227;1557;1122441;1102685;36244;78.1;76.7;2.5
44;2021-10-16;311;588;301;1122752;1103273;36545;78.1;76.8;2.5
44;2021-10-17;81;163;82;1122833;1103436;36627;78.1;76.8;2.5
44;2021-10-18;559;743;1358;1123392;1104179;37985;78.2;76.8;2.6
44;2021-10-19;217;638;1582;1123609;1104817;39567;78.2;76.9;2.8
44;2021-10-20;325;959;1709;1123934;1105776;41276;78.2;76.9;2.9
44;2021-10-21;209;646;1372;1124143;1106422;42648;78.2;77.0;3.0
44;2021-10-22;255;975;1862;1124398;1107397;44510;78.2;77.1;3.1
44;2021-10-23;123;475;451;1124521;1107872;44961;78.2;77.1;3.1
44;2021-10-24;32;183;111;1124553;1108055;45072;78.2;77.1;3.1
44;2021-10-25;238;526;1518;1124791;1108581;46590;78.3;77.1;3.2
44;2021-10-26;181;418;1488;1124972;1108999;48078;78.3;77.2;3.3
44;2021-10-27;268;598;1897;1125240;1109597;49975;78.3;77.2;3.5
44;2021-10-28;200;454;1883;1125440;1110051;51858;78.3;77.2;3.6
44;2021-10-29;259;705;2416;1125699;1110756;54274;78.3;77.3;3.8
44;2021-10-30;77;292;564;1125776;1111048;54838;78.3;77.3;3.8
44;2021-10-31;31;118;174;1125807;1111166;55012;78.3;77.3;3.8
44;2021-11-01;19;32;17;1125826;1111198;55029;78.3;77.3;3.8
44;2021-11-02;192;411;1588;1126018;1111609;56617;78.4;77.3;3.9
44;2021-11-03;208;535;1858;1126226;1112144;58475;78.4;77.4;4.1
44;2021-11-04;214;448;2168;1126440;1112592;60643;78.4;77.4;4.2
44;2021-11-05;237;651;2510;1126677;1113243;63153;78.4;77.5;4.4
44;2021-11-06;85;257;843;1126762;1113500;63996;78.4;77.5;4.5
44;2021-11-07;13;104;42;1126775;1113604;64038;78.4;77.5;4.5
44;2021-11-08;159;509;2274;1126934;1114113;66312;78.4;77.5;4.6
44;2021-11-09;171;482;3653;1127105;1114595;69965;78.4;77.6;4.9
44;2021-11-10;246;532;3518;1127351;1115127;73483;78.4;77.6;5.1
44;2021-11-11;15;23;60;1127366;1115150;73543;78.4;77.6;5.1
44;2021-11-12;252;507;3809;1127618;1115657;77352;78.5;77.6;5.4
44;2021-11-13;98;214;919;1127716;1115871;78271;78.5;77.6;5.4
44;2021-11-14;1;7;8;1127717;1115878;78279;78.5;77.6;5.4
44;2021-11-15;150;289;3466;1127867;1116167;81745;78.5;77.7;5.7
44;2021-11-16;172;291;4805;1128039;1116458;86550;78.5;77.7;6.0
44;2021-11-17;265;374;4271;1128304;1116832;90821;78.5;77.7;6.3
44;2021-11-18;170;302;4843;1128474;1117134;95664;78.5;77.7;6.7
44;2021-11-19;236;357;5179;1128710;1117491;100843;78.5;77.8;7.0
44;2021-11-20;160;170;1241;1128870;1117661;102084;78.5;77.8;7.1
44;2021-11-21;4;16;10;1128874;1117677;102094;78.6;77.8;7.1
44;2021-11-22;150;178;3948;1129024;1117855;106042;78.6;77.8;7.4
44;2021-11-23;218;200;5930;1129242;1118055;111972;78.6;77.8;7.8
44;2021-11-24;361;304;5399;1129603;1118359;117371;78.6;77.8;8.2
44;2021-11-25;203;237;6307;1129806;1118596;123678;78.6;77.8;8.6
44;2021-11-26;255;351;8265;1130061;1118947;131943;78.6;77.9;9.2
44;2021-11-27;126;199;3007;1130187;1119146;134950;78.6;77.9;9.4
44;2021-11-28;5;19;635;1130192;1119165;135585;78.6;77.9;9.4
44;2021-11-29;159;199;6662;1130351;1119364;142247;78.7;77.9;9.9
44;2021-11-30;211;219;9978;1130562;1119583;152225;78.7;77.9;10.6
44;2021-12-01;187;235;8769;1130749;1119818;160994;78.7;77.9;11.2
44;2021-12-02;149;178;11067;1130898;1119996;172061;78.7;77.9;12.0
44;2021-12-03;168;272;12075;1131066;1120268;184136;78.7;78.0;12.8
44;2021-12-04;82;130;4644;1131148;1120398;188780;78.7;78.0;13.1
44;2021-12-05;13;11;1009;1131161;1120409;189789;78.7;78.0;13.2
44;2021-12-06;105;181;9997;1131266;1120590;199786;78.7;78.0;13.9
44;2021-12-07;175;210;13325;1131441;1120800;213111;78.7;78.0;14.8
44;2021-12-08;192;285;11417;1131633;1121085;224528;78.7;78.0;15.6
44;2021-12-09;155;250;13704;1131788;1121335;238232;78.8;78.0;16.6
44;2021-12-10;165;281;14898;1131953;1121616;253130;78.8;78.0;17.6
44;2021-12-11;112;199;6823;1132065;1121815;259953;78.8;78.1;18.1
44;2021-12-12;14;28;2181;1132079;1121843;262134;78.8;78.1;18.2
44;2021-12-13;161;209;12939;1132240;1122052;275073;78.8;78.1;19.1
44;2021-12-14;193;246;17832;1132433;1122298;292905;78.8;78.1;20.4
44;2021-12-15;247;343;14795;1132680;1122641;307700;78.8;78.1;21.4
44;2021-12-16;169;260;17262;1132849;1122901;324962;78.8;78.1;22.6
45;2020-12-27;3;1;0;3;1;0;0.0;0.0;0.0
45;2020-12-28;0;0;0;3;1;0;0.0;0.0;0.0
45;2020-12-29;0;0;0;3;1;0;0.0;0.0;0.0
45;2020-12-30;0;0;0;3;1;0;0.0;0.0;0.0
45;2020-12-31;0;0;0;3;1;0;0.0;0.0;0.0
45;2021-01-01;0;0;0;3;1;0;0.0;0.0;0.0
45;2021-01-02;0;0;0;3;1;0;0.0;0.0;0.0
45;2021-01-03;0;0;0;3;1;0;0.0;0.0;0.0
45;2021-01-04;0;0;0;3;1;0;0.0;0.0;0.0
45;2021-01-05;73;0;0;76;1;0;0.0;0.0;0.0
45;2021-01-06;86;0;0;162;1;0;0.0;0.0;0.0
45;2021-01-07;226;1;0;388;2;0;0.1;0.0;0.0
45;2021-01-08;215;0;0;603;2;0;0.1;0.0;0.0
45;2021-01-09;38;0;0;641;2;0;0.1;0.0;0.0
45;2021-01-10;22;0;0;663;2;0;0.1;0.0;0.0
45;2021-01-11;267;1;0;930;3;0;0.1;0.0;0.0
45;2021-01-12;618;3;0;1548;6;0;0.2;0.0;0.0
45;2021-01-13;506;1;0;2054;7;0;0.3;0.0;0.0
45;2021-01-14;507;36;0;2561;43;0;0.4;0.0;0.0
45;2021-01-15;396;2;0;2957;45;0;0.4;0.0;0.0
45;2021-01-16;48;1;0;3005;46;0;0.4;0.0;0.0
45;2021-01-17;25;0;0;3030;46;0;0.4;0.0;0.0
45;2021-01-18;749;1;0;3779;47;0;0.6;0.0;0.0
45;2021-01-19;1153;6;0;4932;53;0;0.7;0.0;0.0
45;2021-01-20;2030;14;0;6962;67;0;1.0;0.0;0.0
45;2021-01-21;2460;6;0;9422;73;0;1.4;0.0;0.0
45;2021-01-22;1387;6;0;10809;79;0;1.6;0.0;0.0
45;2021-01-23;154;1;0;10963;80;0;1.6;0.0;0.0
45;2021-01-24;34;0;0;10997;80;0;1.6;0.0;0.0
45;2021-01-25;567;4;0;11564;84;0;1.7;0.0;0.0
45;2021-01-26;885;20;0;12449;104;0;1.8;0.0;0.0
45;2021-01-27;890;41;0;13339;145;0;2.0;0.0;0.0
45;2021-01-28;945;205;0;14284;350;0;2.1;0.1;0.0
45;2021-01-29;612;131;0;14896;481;0;2.2;0.1;0.0
45;2021-01-30;61;33;0;14957;514;0;2.2;0.1;0.0
45;2021-01-31;39;23;0;14996;537;0;2.2;0.1;0.0
45;2021-02-01;485;204;0;15481;741;0;2.3;0.1;0.0
45;2021-02-02;764;451;0;16245;1192;0;2.4;0.2;0.0
45;2021-02-03;746;471;0;16991;1663;0;2.5;0.2;0.0
45;2021-02-04;738;275;0;17729;1938;0;2.6;0.3;0.0
45;2021-02-05;438;153;0;18167;2091;0;2.7;0.3;0.0
45;2021-02-06;43;27;0;18210;2118;0;2.7;0.3;0.0
45;2021-02-07;6;29;0;18216;2147;0;2.7;0.3;0.0
45;2021-02-08;459;183;0;18675;2330;0;2.7;0.3;0.0
45;2021-02-09;976;415;0;19651;2745;0;2.9;0.4;0.0
45;2021-02-10;1211;796;0;20862;3541;0;3.1;0.5;0.0
45;2021-02-11;1348;1483;0;22210;5024;0;3.3;0.7;0.0
45;2021-02-12;1033;1120;0;23243;6144;0;3.4;0.9;0.0
45;2021-02-13;89;149;0;23332;6293;0;3.4;0.9;0.0
45;2021-02-14;40;13;0;23372;6306;0;3.4;0.9;0.0
45;2021-02-15;528;617;0;23900;6923;0;3.5;1.0;0.0
45;2021-02-16;773;974;0;24673;7897;0;3.6;1.2;0.0
45;2021-02-17;617;1070;0;25290;8967;0;3.7;1.3;0.0
45;2021-02-18;840;915;0;26130;9882;0;3.8;1.4;0.0
45;2021-02-19;827;804;0;26957;10686;0;3.9;1.6;0.0
45;2021-02-20;59;96;0;27016;10782;0;4.0;1.6;0.0
45;2021-02-21;18;46;0;27034;10828;0;4.0;1.6;0.0
45;2021-02-22;382;630;0;27416;11458;0;4.0;1.7;0.0
45;2021-02-23;768;797;0;28184;12255;0;4.1;1.8;0.0
45;2021-02-24;610;921;0;28794;13176;0;4.2;1.9;0.0
45;2021-02-25;948;830;0;29742;14006;0;4.4;2.1;0.0
45;2021-02-26;1027;703;0;30769;14709;0;4.5;2.2;0.0
45;2021-02-27;295;62;0;31064;14771;0;4.5;2.2;0.0
45;2021-02-28;26;9;0;31090;14780;0;4.6;2.2;0.0
45;2021-03-01;536;360;0;31626;15140;0;4.6;2.2;0.0
45;2021-03-02;713;706;0;32339;15846;0;4.7;2.3;0.0
45;2021-03-03;949;855;0;33288;16701;0;4.9;2.4;0.0
45;2021-03-04;1123;964;0;34411;17665;0;5.0;2.6;0.0
45;2021-03-05;1448;887;0;35859;18552;0;5.3;2.7;0.0
45;2021-03-06;2080;142;0;37939;18694;0;5.6;2.7;0.0
45;2021-03-07;190;67;0;38129;18761;0;5.6;2.7;0.0
45;2021-03-08;779;784;0;38908;19545;0;5.7;2.9;0.0
45;2021-03-09;1300;716;0;40208;20261;0;5.9;3.0;0.0
45;2021-03-10;1607;921;0;41815;21182;0;6.1;3.1;0.0
45;2021-03-11;1766;758;0;43581;21940;0;6.4;3.2;0.0
45;2021-03-12;2093;647;0;45674;22587;0;6.7;3.3;0.0
45;2021-03-13;1071;55;0;46745;22642;0;6.8;3.3;0.0
45;2021-03-14;67;49;0;46812;22691;0;6.9;3.3;0.0
45;2021-03-15;884;552;0;47696;23243;0;7.0;3.4;0.0
45;2021-03-16;1033;808;0;48729;24051;0;7.1;3.5;0.0
45;2021-03-17;1092;627;0;49821;24678;0;7.3;3.6;0.0
45;2021-03-18;1079;575;0;50900;25253;0;7.5;3.7;0.0
45;2021-03-19;1732;425;0;52632;25678;0;7.7;3.8;0.0
45;2021-03-20;581;82;0;53213;25760;0;7.8;3.8;0.0
45;2021-03-21;34;36;0;53247;25796;0;7.8;3.8;0.0
45;2021-03-22;1008;490;0;54255;26286;0;7.9;3.8;0.0
45;2021-03-23;2090;700;0;56345;26986;0;8.3;4.0;0.0
45;2021-03-24;1970;516;0;58315;27502;0;8.5;4.0;0.0
45;2021-03-25;3167;456;0;61482;27958;0;9.0;4.1;0.0
45;2021-03-26;3526;492;0;65008;28450;0;9.5;4.2;0.0
45;2021-03-27;1855;122;0;66863;28572;0;9.8;4.2;0.0
45;2021-03-28;91;38;0;66954;28610;0;9.8;4.2;0.0
45;2021-03-29;1625;556;0;68579;29166;0;10.0;4.3;0.0
45;2021-03-30;2829;822;0;71408;29988;0;10.5;4.4;0.0
45;2021-03-31;2249;593;0;73657;30581;0;10.8;4.5;0.0
45;2021-04-01;3145;596;0;76802;31177;0;11.2;4.6;0.0
45;2021-04-02;2912;541;0;79714;31718;0;11.7;4.6;0.0
45;2021-04-03;853;105;0;80567;31823;0;11.8;4.7;0.0
45;2021-04-04;122;38;0;80689;31861;0;11.8;4.7;0.0
45;2021-04-05;46;2;0;80735;31863;0;11.8;4.7;0.0
45;2021-04-06;1871;811;0;82606;32674;0;12.1;4.8;0.0
45;2021-04-07;1983;1180;0;84589;33854;0;12.4;5.0;0.0
45;2021-04-08;2992;1065;0;87581;34919;0;12.8;5.1;0.0
45;2021-04-09;3778;693;0;91359;35612;0;13.4;5.2;0.0
45;2021-04-10;2409;200;0;93768;35812;0;13.7;5.2;0.0
45;2021-04-11;183;46;0;93951;35858;0;13.8;5.3;0.0
45;2021-04-12;2630;694;0;96581;36552;0;14.1;5.4;0.0
45;2021-04-13;3976;1175;0;100557;37727;0;14.7;5.5;0.0
45;2021-04-14;3049;1285;0;103606;39012;0;15.2;5.7;0.0
45;2021-04-15;3666;1111;0;107272;40123;0;15.7;5.9;0.0
45;2021-04-16;3903;777;0;111175;40900;0;16.3;6.0;0.0
45;2021-04-17;1612;164;0;112787;41064;0;16.5;6.0;0.0
45;2021-04-18;205;47;0;112992;41111;0;16.5;6.0;0.0
45;2021-04-19;1997;992;0;114989;42103;0;16.8;6.2;0.0
45;2021-04-20;3195;1766;0;118184;43869;0;17.3;6.4;0.0
45;2021-04-21;2834;1395;0;121018;45264;0;17.7;6.6;0.0
45;2021-04-22;3488;1989;0;124506;47253;0;18.2;6.9;0.0
45;2021-04-23;3453;1853;0;127959;49106;0;18.7;7.2;0.0
45;2021-04-24;2277;931;0;130236;50037;0;19.1;7.3;0.0
45;2021-04-25;443;97;0;130679;50134;0;19.1;7.3;0.0
45;2021-04-26;2379;1216;0;133058;51350;0;19.5;7.5;0.0
45;2021-04-27;3583;2375;0;136641;53725;0;20.0;7.9;0.0
45;2021-04-28;3001;2072;0;139642;55797;0;20.4;8.2;0.0
45;2021-04-29;4139;2430;0;143781;58227;0;21.1;8.5;0.0
45;2021-04-30;4595;1877;0;148376;60104;0;21.7;8.8;0.0
45;2021-05-01;514;95;0;148890;60199;0;21.8;8.8;0.0
45;2021-05-02;640;126;0;149530;60325;0;21.9;8.8;0.0
45;2021-05-03;3011;1126;0;152541;61451;0;22.3;9.0;0.0
45;2021-05-04;3479;2470;0;156020;63921;0;22.8;9.4;0.0
45;2021-05-05;2987;2259;0;159007;66180;0;23.3;9.7;0.0
45;2021-05-06;3691;2683;0;162698;68863;0;23.8;10.1;0.0
45;2021-05-07;3162;3241;0;165860;72104;0;24.3;10.6;0.0
45;2021-05-08;868;323;0;166728;72427;0;24.4;10.6;0.0
45;2021-05-09;1473;169;0;168201;72596;0;24.6;10.6;0.0
45;2021-05-10;4194;3066;0;172395;75662;0;25.2;11.1;0.0
45;2021-05-11;5117;3155;0;177512;78817;0;26.0;11.5;0.0
45;2021-05-12;6110;2998;0;183622;81815;0;26.9;12.0;0.0
45;2021-05-13;2778;633;0;186400;82448;0;27.3;12.1;0.0
45;2021-05-14;5189;1725;0;191589;84173;0;28.1;12.3;0.0
45;2021-05-15;4359;664;0;195948;84837;0;28.7;12.4;0.0
45;2021-05-16;386;58;0;196334;84895;0;28.8;12.4;0.0
45;2021-05-17;3700;1611;0;200034;86506;0;29.3;12.7;0.0
45;2021-05-18;5634;1810;0;205668;88316;0;30.1;12.9;0.0
45;2021-05-19;5085;2132;0;210753;90448;0;30.9;13.2;0.0
45;2021-05-20;5861;2197;0;216614;92645;0;31.7;13.6;0.0
45;2021-05-21;5663;2336;0;222277;94981;0;32.5;13.9;0.0
45;2021-05-22;3395;668;0;225672;95649;0;33.0;14.0;0.0
45;2021-05-23;225;105;0;225897;95754;0;33.1;14.0;0.0
45;2021-05-24;3195;255;0;229092;96009;0;33.5;14.1;0.0
45;2021-05-25;5546;3068;0;234638;99077;0;34.4;14.5;0.0
45;2021-05-26;5849;2414;0;240487;101491;0;35.2;14.9;0.0
45;2021-05-27;5809;3337;0;246296;104828;0;36.1;15.4;0.0
45;2021-05-28;5942;3573;0;252238;108401;0;36.9;15.9;0.0
45;2021-05-29;3933;1331;0;256171;109732;0;37.5;16.1;0.0
45;2021-05-30;139;185;0;256310;109917;0;37.5;16.1;0.0
45;2021-05-31;4308;2567;0;260618;112484;0;38.2;16.5;0.0
45;2021-06-01;6174;3233;0;266792;115717;0;39.1;16.9;0.0
45;2021-06-02;4976;3247;0;271768;118964;0;39.8;17.4;0.0
45;2021-06-03;5825;3375;0;277593;122339;0;40.6;17.9;0.0
45;2021-06-04;5892;3325;0;283485;125664;0;41.5;18.4;0.0
45;2021-06-05;2422;1601;0;285907;127265;0;41.9;18.6;0.0
45;2021-06-06;275;340;0;286182;127605;0;41.9;18.7;0.0
45;2021-06-07;4024;2850;0;290206;130455;0;42.5;19.1;0.0
45;2021-06-08;4675;4348;0;294881;134803;0;43.2;19.7;0.0
45;2021-06-09;4471;3508;0;299352;138311;0;43.8;20.3;0.0
45;2021-06-10;4839;2997;0;304191;141308;0;44.5;20.7;0.0
45;2021-06-11;4157;3870;0;308348;145178;0;45.2;21.3;0.0
45;2021-06-12;2717;1602;0;311065;146780;0;45.6;21.5;0.0
45;2021-06-13;128;483;0;311193;147263;0;45.6;21.6;0.0
45;2021-06-14;3048;4369;0;314241;151632;0;46.0;22.2;0.0
45;2021-06-15;3408;4667;0;317649;156299;0;46.5;22.9;0.0
45;2021-06-16;3816;3724;1;321465;160023;1;47.1;23.4;0.0
45;2021-06-17;3473;3835;0;324938;163858;1;47.6;24.0;0.0
45;2021-06-18;3820;5188;0;328758;169046;1;48.1;24.8;0.0
45;2021-06-19;2445;2012;0;331203;171058;1;48.5;25.0;0.0
45;2021-06-20;111;183;0;331314;171241;1;48.5;25.1;0.0
45;2021-06-21;2148;5966;0;333462;177207;1;48.8;25.9;0.0
45;2021-06-22;2444;6791;0;335906;183998;1;49.2;26.9;0.0
45;2021-06-23;2300;5810;0;338206;189808;1;49.5;27.8;0.0
45;2021-06-24;2205;3844;0;340411;193652;1;49.8;28.4;0.0
45;2021-06-25;2425;6593;0;342836;200245;1;50.2;29.3;0.0
45;2021-06-26;1858;3408;0;344694;203653;1;50.5;29.8;0.0
45;2021-06-27;92;240;0;344786;203893;1;50.5;29.9;0.0
45;2021-06-28;2024;5204;0;346810;209097;1;50.8;30.6;0.0
45;2021-06-29;2651;7241;0;349461;216338;1;51.2;31.7;0.0
45;2021-06-30;2881;6263;0;352342;222601;1;51.6;32.6;0.0
45;2021-07-01;2425;5468;0;354767;228069;1;52.0;33.4;0.0
45;2021-07-02;2349;6629;0;357116;234698;1;52.3;34.4;0.0
45;2021-07-03;827;3015;0;357943;237713;1;52.4;34.8;0.0
45;2021-07-04;75;197;0;358018;237910;1;52.4;34.8;0.0
45;2021-07-05;2010;5164;0;360028;243074;1;52.7;35.6;0.0
45;2021-07-06;2662;7188;0;362690;250262;1;53.1;36.6;0.0
45;2021-07-07;2300;6593;0;364990;256855;1;53.4;37.6;0.0
45;2021-07-08;2693;5620;0;367683;262475;1;53.8;38.4;0.0
45;2021-07-09;2190;7115;0;369873;269590;1;54.2;39.5;0.0
45;2021-07-10;1551;4197;0;371424;273787;1;54.4;40.1;0.0
45;2021-07-11;94;171;0;371518;273958;1;54.4;40.1;0.0
45;2021-07-12;1609;5936;0;373127;279894;1;54.6;41.0;0.0
45;2021-07-13;3086;8329;0;376213;288223;1;55.1;42.2;0.0
45;2021-07-14;1553;1711;0;377766;289934;1;55.3;42.5;0.0
45;2021-07-15;3928;7415;0;381694;297349;1;55.9;43.5;0.0
45;2021-07-16;3467;7357;0;385161;304706;1;56.4;44.6;0.0
45;2021-07-17;1485;2731;0;386646;307437;1;56.6;45.0;0.0
45;2021-07-18;251;236;0;386897;307673;1;56.7;45.1;0.0
45;2021-07-19;2109;5895;0;389006;313568;1;57.0;45.9;0.0
45;2021-07-20;4799;6836;0;393805;320404;1;57.7;46.9;0.0
45;2021-07-21;5196;5502;0;399001;325906;1;58.4;47.7;0.0
45;2021-07-22;6264;5069;0;405265;330975;1;59.3;48.5;0.0
45;2021-07-23;4457;5655;0;409722;336630;1;60.0;49.3;0.0
45;2021-07-24;2047;2919;0;411769;339549;1;60.3;49.7;0.0
45;2021-07-25;286;159;0;412055;339708;1;60.3;49.7;0.0
45;2021-07-26;3068;4902;0;415123;344610;1;60.8;50.5;0.0
45;2021-07-27;5445;5054;0;420568;349664;1;61.6;51.2;0.0
45;2021-07-28;4842;4056;0;425410;353720;1;62.3;51.8;0.0
45;2021-07-29;5259;3395;0;430669;357115;1;63.1;52.3;0.0
45;2021-07-30;4930;4785;0;435599;361900;1;63.8;53.0;0.0
45;2021-07-31;1301;2254;0;436900;364154;1;64.0;53.3;0.0
45;2021-08-01;282;97;0;437182;364251;1;64.0;53.3;0.0
45;2021-08-02;3681;3233;0;440863;367484;1;64.6;53.8;0.0
45;2021-08-03;4774;3046;0;445637;370530;1;65.3;54.3;0.0
45;2021-08-04;3578;2405;0;449215;372935;1;65.8;54.6;0.0
45;2021-08-05;3282;2719;0;452497;375654;1;66.3;55.0;0.0
45;2021-08-06;3625;3336;0;456122;378990;1;66.8;55.5;0.0
45;2021-08-07;1705;1258;0;457827;380248;1;67.0;55.7;0.0
45;2021-08-08;136;166;0;457963;380414;1;67.1;55.7;0.0
45;2021-08-09;2617;3231;0;460580;383645;1;67.4;56.2;0.0
45;2021-08-10;3338;3891;0;463918;387536;1;67.9;56.7;0.0
45;2021-08-11;2616;3692;0;466534;391228;1;68.3;57.3;0.0
45;2021-08-12;2145;3545;0;468679;394773;1;68.6;57.8;0.0
45;2021-08-13;1786;4178;0;470465;398951;1;68.9;58.4;0.0
45;2021-08-14;758;1268;0;471223;400219;1;69.0;58.6;0.0
45;2021-08-15;85;91;0;471308;400310;1;69.0;58.6;0.0
45;2021-08-16;1193;2608;0;472501;402918;1;69.2;59.0;0.0
45;2021-08-17;1840;3701;0;474341;406619;1;69.5;59.5;0.0
45;2021-08-18;1689;3907;0;476030;410526;1;69.7;60.1;0.0
45;2021-08-19;1481;4147;0;477511;414673;1;69.9;60.7;0.0
45;2021-08-20;1429;3625;0;478940;418298;1;70.1;61.3;0.0
45;2021-08-21;873;1438;0;479813;419736;1;70.3;61.5;0.0
45;2021-08-22;50;243;0;479863;419979;1;70.3;61.5;0.0
45;2021-08-23;1198;4297;0;481061;424276;1;70.4;62.1;0.0
45;2021-08-24;1672;4633;0;482733;428909;1;70.7;62.8;0.0
45;2021-08-25;1497;3644;0;484230;432553;1;70.9;63.3;0.0
45;2021-08-26;1044;3528;0;485274;436081;1;71.1;63.9;0.0
45;2021-08-27;1389;4805;0;486663;440886;1;71.3;64.6;0.0
45;2021-08-28;845;2119;0;487508;443005;1;71.4;64.9;0.0
45;2021-08-29;117;228;0;487625;443233;1;71.4;64.9;0.0
45;2021-08-30;1133;3982;67;488758;447215;68;71.6;65.5;0.0
45;2021-08-31;1071;4267;133;489829;451482;201;71.7;66.1;0.0
45;2021-09-01;1117;3310;168;490946;454792;369;71.9;66.6;0.1
45;2021-09-02;950;3040;250;491896;457832;619;72.0;67.0;0.1
45;2021-09-03;1042;3524;253;492938;461356;872;72.2;67.6;0.1
45;2021-09-04;548;1435;54;493486;462791;926;72.3;67.8;0.1
45;2021-09-05;23;72;1;493509;462863;927;72.3;67.8;0.1
45;2021-09-06;843;2312;462;494352;465175;1389;72.4;68.1;0.2
45;2021-09-07;720;1735;497;495072;466910;1886;72.5;68.4;0.3
45;2021-09-08;830;2139;394;495902;469049;2280;72.6;68.7;0.3
45;2021-09-09;765;1461;257;496667;470510;2537;72.7;68.9;0.4
45;2021-09-10;773;1603;299;497440;472113;2836;72.8;69.1;0.4
45;2021-09-11;427;1547;107;497867;473660;2943;72.9;69.4;0.4
45;2021-09-12;344;207;179;498211;473867;3122;73.0;69.4;0.5
45;2021-09-13;443;921;340;498654;474788;3462;73.0;69.5;0.5
45;2021-09-14;763;1450;717;499417;476238;4179;73.1;69.7;0.6
45;2021-09-15;738;1704;604;500155;477942;4783;73.2;70.0;0.7
45;2021-09-16;761;990;506;500916;478932;5289;73.4;70.1;0.8
45;2021-09-17;743;1586;535;501659;480518;5824;73.5;70.4;0.9
45;2021-09-18;453;986;188;502112;481504;6012;73.5;70.5;0.9
45;2021-09-19;12;61;1;502124;481565;6013;73.5;70.5;0.9
45;2021-09-20;392;930;671;502516;482495;6684;73.6;70.7;1.0
45;2021-09-21;454;761;642;502970;483256;7326;73.7;70.8;1.1
45;2021-09-22;415;1573;738;503385;484829;8064;73.7;71.0;1.2
45;2021-09-23;503;874;748;503888;485703;8812;73.8;71.1;1.3
45;2021-09-24;539;1289;483;504427;486992;9295;73.9;71.3;1.4
45;2021-09-25;312;762;178;504739;487754;9473;73.9;71.4;1.4
45;2021-09-26;12;30;6;504751;487784;9479;73.9;71.4;1.4
45;2021-09-27;415;730;550;505166;488514;10029;74.0;71.5;1.5
45;2021-09-28;424;765;741;505590;489279;10770;74.0;71.6;1.6
45;2021-09-29;468;936;750;506058;490215;11520;74.1;71.8;1.7
45;2021-09-30;391;812;593;506449;491027;12113;74.2;71.9;1.8
45;2021-10-01;398;747;355;506847;491774;12468;74.2;72.0;1.8
45;2021-10-02;312;561;259;507159;492335;12727;74.3;72.1;1.9
45;2021-10-03;87;335;148;507246;492670;12875;74.3;72.1;1.9
45;2021-10-04;222;367;457;507468;493037;13332;74.3;72.2;2.0
45;2021-10-05;394;681;830;507862;493718;14162;74.4;72.3;2.1
45;2021-10-06;442;719;689;508304;494437;14851;74.4;72.4;2.2
45;2021-10-07;282;703;730;508586;495140;15581;74.5;72.5;2.3
45;2021-10-08;374;727;677;508960;495867;16258;74.5;72.6;2.4
45;2021-10-09;382;633;332;509342;496500;16590;74.6;72.7;2.4
45;2021-10-10;13;14;5;509355;496514;16595;74.6;72.7;2.4
45;2021-10-11;242;399;479;509597;496913;17074;74.6;72.8;2.5
45;2021-10-12;323;552;1012;509920;497465;18086;74.7;72.8;2.6
45;2021-10-13;321;573;886;510241;498038;18972;74.7;72.9;2.8
45;2021-10-14;255;395;621;510496;498433;19593;74.8;73.0;2.9
45;2021-10-15;398;658;858;510894;499091;20451;74.8;73.1;3.0
45;2021-10-16;333;444;309;511227;499535;20760;74.9;73.2;3.0
45;2021-10-17;3;13;9;511230;499548;20769;74.9;73.2;3.0
45;2021-10-18;224;345;475;511454;499893;21244;74.9;73.2;3.1
45;2021-10-19;202;529;843;511656;500422;22087;74.9;73.3;3.2
45;2021-10-20;307;464;923;511963;500886;23010;75.0;73.3;3.4
45;2021-10-21;240;424;956;512203;501310;23966;75.0;73.4;3.5
45;2021-10-22;270;522;903;512473;501832;24869;75.0;73.5;3.6
45;2021-10-23;242;380;383;512715;502212;25252;75.1;73.5;3.7
45;2021-10-24;5;19;3;512720;502231;25255;75.1;73.5;3.7
45;2021-10-25;197;295;715;512917;502526;25970;75.1;73.6;3.8
45;2021-10-26;224;386;1109;513141;502912;27079;75.1;73.6;4.0
45;2021-10-27;242;474;1079;513383;503386;28158;75.2;73.7;4.1
45;2021-10-28;183;253;889;513566;503639;29047;75.2;73.8;4.3
45;2021-10-29;228;351;890;513794;503990;29937;75.2;73.8;4.4
45;2021-10-30;152;279;441;513946;504269;30378;75.3;73.8;4.4
45;2021-10-31;3;6;2;513949;504275;30380;75.3;73.8;4.4
45;2021-11-01;23;30;17;513972;504305;30397;75.3;73.8;4.5
45;2021-11-02;236;430;1095;514208;504735;31492;75.3;73.9;4.6
45;2021-11-03;231;380;1161;514439;505115;32653;75.3;74.0;4.8
45;2021-11-04;179;205;1292;514618;505320;33945;75.4;74.0;5.0
45;2021-11-05;238;357;1267;514856;505677;35212;75.4;74.0;5.2
45;2021-11-06;166;317;553;515022;505994;35765;75.4;74.1;5.2
45;2021-11-07;5;23;19;515027;506017;35784;75.4;74.1;5.2
45;2021-11-08;174;265;1258;515201;506282;37042;75.4;74.1;5.4
45;2021-11-09;154;285;1858;515355;506567;38900;75.5;74.2;5.7
45;2021-11-10;272;411;2031;515627;506978;40931;75.5;74.2;6.0
45;2021-11-11;47;50;184;515674;507028;41115;75.5;74.2;6.0
45;2021-11-12;284;369;2072;515958;507397;43187;75.6;74.3;6.3
45;2021-11-13;199;261;814;516157;507658;44001;75.6;74.3;6.4
45;2021-11-14;6;24;12;516163;507682;44013;75.6;74.3;6.4
45;2021-11-15;159;233;1745;516322;507915;45758;75.6;74.4;6.7
45;2021-11-16;202;248;2319;516524;508163;48077;75.6;74.4;7.0
45;2021-11-17;286;292;2206;516810;508455;50283;75.7;74.5;7.4
45;2021-11-18;173;183;2095;516983;508638;52378;75.7;74.5;7.7
45;2021-11-19;256;334;2154;517239;508972;54532;75.7;74.5;8.0
45;2021-11-20;276;309;964;517515;509281;55496;75.8;74.6;8.1
45;2021-11-21;3;3;29;517518;509284;55525;75.8;74.6;8.1
45;2021-11-22;177;152;2120;517695;509436;57645;75.8;74.6;8.4
45;2021-11-23;231;228;2901;517926;509664;60546;75.8;74.6;8.9
45;2021-11-24;299;283;2636;518225;509947;63182;75.9;74.7;9.3
45;2021-11-25;189;243;3314;518414;510190;66496;75.9;74.7;9.7
45;2021-11-26;228;239;3949;518642;510429;70445;75.9;74.7;10.3
45;2021-11-27;196;226;2199;518838;510655;72644;76.0;74.8;10.6
45;2021-11-28;31;50;1781;518869;510705;74425;76.0;74.8;10.9
45;2021-11-29;108;188;3738;518977;510893;78163;76.0;74.8;11.4
45;2021-11-30;149;172;5034;519126;511065;83197;76.0;74.8;12.2
45;2021-12-01;127;221;5126;519253;511286;88323;76.0;74.9;12.9
45;2021-12-02;120;164;5363;519373;511450;93686;76.1;74.9;13.7
45;2021-12-03;134;251;5034;519507;511701;98720;76.1;74.9;14.5
45;2021-12-04;112;189;2913;519619;511890;101633;76.1;75.0;14.9
45;2021-12-05;11;20;575;519630;511910;102208;76.1;75.0;15.0
45;2021-12-06;90;191;5626;519720;512101;107834;76.1;75.0;15.8
45;2021-12-07;192;236;7912;519912;512337;115746;76.1;75.0;16.9
45;2021-12-08;182;292;7238;520094;512629;122984;76.2;75.1;18.0
45;2021-12-09;147;222;7748;520241;512851;130732;76.2;75.1;19.1
45;2021-12-10;207;276;7463;520448;513127;138195;76.2;75.1;20.2
45;2021-12-11;152;231;4685;520600;513358;142880;76.2;75.2;20.9
45;2021-12-12;57;49;2873;520657;513407;145753;76.2;75.2;21.3
45;2021-12-13;119;206;7039;520776;513613;152792;76.3;75.2;22.4
45;2021-12-14;193;267;10229;520969;513880;163021;76.3;75.3;23.9
45;2021-12-15;176;314;8812;521145;514194;171833;76.3;75.3;25.2
45;2021-12-16;169;273;9429;521314;514467;181262;76.3;75.3;26.5
46;2020-12-27;1;0;0;1;0;0;0.0;0.0;0.0
46;2020-12-28;0;0;0;1;0;0;0.0;0.0;0.0
46;2020-12-29;0;0;0;1;0;0;0.0;0.0;0.0
46;2020-12-30;0;0;0;1;0;0;0.0;0.0;0.0
46;2020-12-31;0;0;0;1;0;0;0.0;0.0;0.0
46;2021-01-01;0;0;0;1;0;0;0.0;0.0;0.0
46;2021-01-02;0;0;0;1;0;0;0.0;0.0;0.0
46;2021-01-03;0;0;0;1;0;0;0.0;0.0;0.0
46;2021-01-04;0;0;0;1;0;0;0.0;0.0;0.0
46;2021-01-05;0;0;0;1;0;0;0.0;0.0;0.0
46;2021-01-06;3;0;0;4;0;0;0.0;0.0;0.0
46;2021-01-07;127;1;0;131;1;0;0.1;0.0;0.0
46;2021-01-08;169;0;0;300;1;0;0.2;0.0;0.0
46;2021-01-09;1;0;0;301;1;0;0.2;0.0;0.0
46;2021-01-10;2;0;0;303;1;0;0.2;0.0;0.0
46;2021-01-11;95;0;0;398;1;0;0.2;0.0;0.0
46;2021-01-12;137;0;0;535;1;0;0.3;0.0;0.0
46;2021-01-13;221;2;0;756;3;0;0.4;0.0;0.0
46;2021-01-14;236;1;0;992;4;0;0.6;0.0;0.0
46;2021-01-15;292;2;0;1284;6;0;0.7;0.0;0.0
46;2021-01-16;17;0;0;1301;6;0;0.8;0.0;0.0
46;2021-01-17;1;0;0;1302;6;0;0.8;0.0;0.0
46;2021-01-18;277;3;0;1579;9;0;0.9;0.0;0.0
46;2021-01-19;390;0;0;1969;9;0;1.1;0.0;0.0
46;2021-01-20;916;3;0;2885;12;0;1.7;0.0;0.0
46;2021-01-21;917;1;0;3802;13;0;2.2;0.0;0.0
46;2021-01-22;409;1;0;4211;14;0;2.4;0.0;0.0
46;2021-01-23;17;0;0;4228;14;0;2.4;0.0;0.0
46;2021-01-24;1;0;0;4229;14;0;2.4;0.0;0.0
46;2021-01-25;225;2;0;4454;16;0;2.6;0.0;0.0
46;2021-01-26;299;2;0;4753;18;0;2.7;0.0;0.0
46;2021-01-27;277;1;0;5030;19;0;2.9;0.0;0.0
46;2021-01-28;308;44;0;5338;63;0;3.1;0.0;0.0
46;2021-01-29;255;83;0;5593;146;0;3.2;0.1;0.0
46;2021-01-30;9;2;0;5602;148;0;3.2;0.1;0.0
46;2021-01-31;0;0;0;5602;148;0;3.2;0.1;0.0
46;2021-02-01;207;149;0;5809;297;0;3.4;0.2;0.0
46;2021-02-02;205;209;0;6014;506;0;3.5;0.3;0.0
46;2021-02-03;251;91;0;6265;597;0;3.6;0.3;0.0
46;2021-02-04;342;87;0;6607;684;0;3.8;0.4;0.0
46;2021-02-05;205;169;0;6812;853;0;3.9;0.5;0.0
46;2021-02-06;16;3;0;6828;856;0;3.9;0.5;0.0
46;2021-02-07;34;0;0;6862;856;0;4.0;0.5;0.0
46;2021-02-08;192;146;0;7054;1002;0;4.1;0.6;0.0
46;2021-02-09;251;224;0;7305;1226;0;4.2;0.7;0.0
46;2021-02-10;324;524;0;7629;1750;0;4.4;1.0;0.0
46;2021-02-11;576;531;0;8205;2281;0;4.7;1.3;0.0
46;2021-02-12;306;341;0;8511;2622;0;4.9;1.5;0.0
46;2021-02-13;8;8;0;8519;2630;0;4.9;1.5;0.0
46;2021-02-14;0;57;0;8519;2687;0;4.9;1.6;0.0
46;2021-02-15;184;299;0;8703;2986;0;5.0;1.7;0.0
46;2021-02-16;211;279;0;8914;3265;0;5.1;1.9;0.0
46;2021-02-17;227;342;0;9141;3607;0;5.3;2.1;0.0
46;2021-02-18;355;296;0;9496;3903;0;5.5;2.3;0.0
46;2021-02-19;244;240;0;9740;4143;0;5.6;2.4;0.0
46;2021-02-20;3;11;0;9743;4154;0;5.6;2.4;0.0
46;2021-02-21;0;0;0;9743;4154;0;5.6;2.4;0.0
46;2021-02-22;153;212;0;9896;4366;0;5.7;2.5;0.0
46;2021-02-23;243;242;0;10139;4608;0;5.9;2.7;0.0
46;2021-02-24;199;356;0;10338;4964;0;6.0;2.9;0.0
46;2021-02-25;255;300;0;10593;5264;0;6.1;3.0;0.0
46;2021-02-26;380;327;0;10973;5591;0;6.3;3.2;0.0
46;2021-02-27;114;6;0;11087;5597;0;6.4;3.2;0.0
46;2021-02-28;7;3;0;11094;5600;0;6.4;3.2;0.0
46;2021-03-01;175;161;0;11269;5761;0;6.5;3.3;0.0
46;2021-03-02;383;203;0;11652;5964;0;6.7;3.4;0.0
46;2021-03-03;436;292;0;12088;6256;0;7.0;3.6;0.0
46;2021-03-04;571;408;0;12659;6664;0;7.3;3.8;0.0
46;2021-03-05;727;345;0;13386;7009;0;7.7;4.0;0.0
46;2021-03-06;467;20;0;13853;7029;0;8.0;4.1;0.0
46;2021-03-07;107;18;0;13960;7047;0;8.1;4.1;0.0
46;2021-03-08;331;237;0;14291;7284;0;8.3;4.2;0.0
46;2021-03-09;704;241;0;14995;7525;0;8.7;4.3;0.0
46;2021-03-10;643;238;0;15638;7763;0;9.0;4.5;0.0
46;2021-03-11;788;243;0;16426;8006;0;9.5;4.6;0.0
46;2021-03-12;852;225;0;17278;8231;0;10.0;4.8;0.0
46;2021-03-13;503;8;0;17781;8239;0;10.3;4.8;0.0
46;2021-03-14;16;0;0;17797;8239;0;10.3;4.8;0.0
46;2021-03-15;474;158;0;18271;8397;0;10.6;4.8;0.0
46;2021-03-16;667;162;0;18938;8559;0;10.9;4.9;0.0
46;2021-03-17;602;189;0;19540;8748;0;11.3;5.1;0.0
46;2021-03-18;684;202;0;20224;8950;0;11.7;5.2;0.0
46;2021-03-19;733;148;0;20957;9098;0;12.1;5.3;0.0
46;2021-03-20;262;4;0;21219;9102;0;12.3;5.3;0.0
46;2021-03-21;6;1;0;21225;9103;0;12.3;5.3;0.0
46;2021-03-22;497;243;0;21722;9346;0;12.5;5.4;0.0
46;2021-03-23;652;221;0;22374;9567;0;12.9;5.5;0.0
46;2021-03-24;627;230;0;23001;9797;0;13.3;5.7;0.0
46;2021-03-25;1041;183;0;24042;9980;0;13.9;5.8;0.0
46;2021-03-26;934;319;0;24976;10299;0;14.4;5.9;0.0
46;2021-03-27;390;67;0;25366;10366;0;14.6;6.0;0.0
46;2021-03-28;126;1;0;25492;10367;0;14.7;6.0;0.0
46;2021-03-29;660;251;0;26152;10618;0;15.1;6.1;0.0
46;2021-03-30;733;341;0;26885;10959;0;15.5;6.3;0.0
46;2021-03-31;825;380;0;27710;11339;0;16.0;6.5;0.0
46;2021-04-01;1104;337;0;28814;11676;0;16.6;6.7;0.0
46;2021-04-02;834;360;0;29648;12036;0;17.1;7.0;0.0
46;2021-04-03;171;151;0;29819;12187;0;17.2;7.0;0.0
46;2021-04-04;2;62;0;29821;12249;0;17.2;7.1;0.0
46;2021-04-05;12;1;0;29833;12250;0;17.2;7.1;0.0
46;2021-04-06;524;469;0;30357;12719;0;17.5;7.3;0.0
46;2021-04-07;740;593;0;31097;13312;0;18.0;7.7;0.0
46;2021-04-08;933;486;0;32030;13798;0;18.5;8.0;0.0
46;2021-04-09;951;464;0;32981;14262;0;19.0;8.2;0.0
46;2021-04-10;490;178;0;33471;14440;0;19.3;8.3;0.0
46;2021-04-11;242;2;0;33713;14442;0;19.5;8.3;0.0
46;2021-04-12;779;512;0;34492;14954;0;19.9;8.6;0.0
46;2021-04-13;1079;649;0;35571;15603;0;20.5;9.0;0.0
46;2021-04-14;1352;555;0;36923;16158;0;21.3;9.3;0.0
46;2021-04-15;1339;603;0;38262;16761;0;22.1;9.7;0.0
46;2021-04-16;1388;489;0;39650;17250;0;22.9;10.0;0.0
46;2021-04-17;847;124;0;40497;17374;0;23.4;10.0;0.0
46;2021-04-18;430;11;0;40927;17385;0;23.6;10.0;0.0
46;2021-04-19;928;518;0;41855;17903;0;24.2;10.3;0.0
46;2021-04-20;1016;651;0;42871;18554;0;24.8;10.7;0.0
46;2021-04-21;1007;623;0;43878;19177;0;25.3;11.1;0.0
46;2021-04-22;1164;617;0;45042;19794;0;26.0;11.4;0.0
46;2021-04-23;941;645;0;45983;20439;0;26.6;11.8;0.0
46;2021-04-24;447;37;0;46430;20476;0;26.8;11.8;0.0
46;2021-04-25;266;10;0;46696;20486;0;27.0;11.8;0.0
46;2021-04-26;684;635;0;47380;21121;0;27.4;12.2;0.0
46;2021-04-27;1048;592;0;48428;21713;0;28.0;12.5;0.0
46;2021-04-28;1095;659;0;49523;22372;0;28.6;12.9;0.0
46;2021-04-29;1234;529;0;50757;22901;0;29.3;13.2;0.0
46;2021-04-30;1253;527;0;52010;23428;0;30.0;13.5;0.0
46;2021-05-01;588;60;0;52598;23488;0;30.4;13.6;0.0
46;2021-05-02;217;1;0;52815;23489;0;30.5;13.6;0.0
46;2021-05-03;689;525;0;53504;24014;0;30.9;13.9;0.0
46;2021-05-04;816;985;0;54320;24999;0;31.4;14.4;0.0
46;2021-05-05;1038;745;0;55358;25744;0;32.0;14.9;0.0
46;2021-05-06;1082;744;0;56440;26488;0;32.6;15.3;0.0
46;2021-05-07;1119;735;0;57559;27223;0;33.2;15.7;0.0
46;2021-05-08;264;373;0;57823;27596;0;33.4;15.9;0.0
46;2021-05-09;42;234;0;57865;27830;0;33.4;16.1;0.0
46;2021-05-10;449;1006;0;58314;28836;0;33.7;16.7;0.0
46;2021-05-11;940;1136;0;59254;29972;0;34.2;17.3;0.0
46;2021-05-12;851;1340;0;60105;31312;0;34.7;18.1;0.0
46;2021-05-13;488;116;0;60593;31428;0;35.0;18.1;0.0
46;2021-05-14;758;932;0;61351;32360;0;35.4;18.7;0.0
46;2021-05-15;273;504;0;61624;32864;0;35.6;19.0;0.0
46;2021-05-16;114;219;0;61738;33083;0;35.7;19.1;0.0
46;2021-05-17;641;825;0;62379;33908;0;36.0;19.6;0.0
46;2021-05-18;1168;854;0;63547;34762;0;36.7;20.1;0.0
46;2021-05-19;1096;772;0;64643;35534;0;37.3;20.5;0.0
46;2021-05-20;1183;697;0;65826;36231;0;38.0;20.9;0.0
46;2021-05-21;865;959;0;66691;37190;0;38.5;21.5;0.0
46;2021-05-22;179;350;0;66870;37540;0;38.6;21.7;0.0
46;2021-05-23;409;28;0;67279;37568;0;38.9;21.7;0.0
46;2021-05-24;376;115;0;67655;37683;0;39.1;21.8;0.0
46;2021-05-25;839;1062;0;68494;38745;0;39.6;22.4;0.0
46;2021-05-26;1043;983;0;69537;39728;0;40.2;22.9;0.0
46;2021-05-27;1213;1048;0;70750;40776;0;40.9;23.5;0.0
46;2021-05-28;1180;1013;0;71930;41789;0;41.5;24.1;0.0
46;2021-05-29;868;384;0;72798;42173;0;42.0;24.4;0.0
46;2021-05-30;293;49;0;73091;42222;0;42.2;24.4;0.0
46;2021-05-31;829;884;0;73920;43106;0;42.7;24.9;0.0
46;2021-06-01;1078;879;0;74998;43985;0;43.3;25.4;0.0
46;2021-06-02;1106;960;0;76104;44945;0;43.9;26.0;0.0
46;2021-06-03;1184;911;0;77288;45856;0;44.6;26.5;0.0
46;2021-06-04;1121;849;0;78409;46705;0;45.3;27.0;0.0
46;2021-06-05;387;395;0;78796;47100;0;45.5;27.2;0.0
46;2021-06-06;169;76;0;78965;47176;0;45.6;27.2;0.0
46;2021-06-07;721;522;0;79686;47698;0;46.0;27.5;0.0
46;2021-06-08;894;811;0;80580;48509;0;46.5;28.0;0.0
46;2021-06-09;1229;861;0;81809;49370;0;47.2;28.5;0.0
46;2021-06-10;903;784;0;82712;50154;0;47.8;29.0;0.0
46;2021-06-11;861;1172;0;83573;51326;0;48.3;29.6;0.0
46;2021-06-12;434;481;0;84007;51807;0;48.5;29.9;0.0
46;2021-06-13;49;73;0;84056;51880;0;48.5;30.0;0.0
46;2021-06-14;519;890;0;84575;52770;0;48.8;30.5;0.0
46;2021-06-15;663;988;0;85238;53758;0;49.2;31.0;0.0
46;2021-06-16;833;892;0;86071;54650;0;49.7;31.6;0.0
46;2021-06-17;505;803;0;86576;55453;0;50.0;32.0;0.0
46;2021-06-18;569;1072;0;87145;56525;0;50.3;32.6;0.0
46;2021-06-19;397;255;0;87542;56780;0;50.6;32.8;0.0
46;2021-06-20;47;164;0;87589;56944;0;50.6;32.9;0.0
46;2021-06-21;387;789;0;87976;57733;0;50.8;33.3;0.0
46;2021-06-22;327;1051;0;88303;58784;0;51.0;33.9;0.0
46;2021-06-23;438;964;0;88741;59748;0;51.2;34.5;0.0
46;2021-06-24;264;752;0;89005;60500;0;51.4;34.9;0.0
46;2021-06-25;447;988;0;89452;61488;0;51.7;35.5;0.0
46;2021-06-26;354;511;0;89806;61999;0;51.9;35.8;0.0
46;2021-06-27;11;41;0;89817;62040;0;51.9;35.8;0.0
46;2021-06-28;287;1147;0;90104;63187;0;52.0;36.5;0.0
46;2021-06-29;328;1453;0;90432;64640;0;52.2;37.3;0.0
46;2021-06-30;461;1318;0;90893;65958;0;52.5;38.1;0.0
46;2021-07-01;329;1067;0;91222;67025;0;52.7;38.7;0.0
46;2021-07-02;424;992;0;91646;68017;0;52.9;39.3;0.0
46;2021-07-03;138;436;0;91784;68453;0;53.0;39.5;0.0
46;2021-07-04;54;127;0;91838;68580;0;53.0;39.6;0.0
46;2021-07-05;302;1033;0;92140;69613;0;53.2;40.2;0.0
46;2021-07-06;316;1250;0;92456;70863;0;53.4;40.9;0.0
46;2021-07-07;530;1482;0;92986;72345;0;53.7;41.8;0.0
46;2021-07-08;342;1021;0;93328;73366;0;53.9;42.4;0.0
46;2021-07-09;373;1451;0;93701;74817;0;54.1;43.2;0.0
46;2021-07-10;313;919;0;94014;75736;0;54.3;43.7;0.0
46;2021-07-11;17;278;0;94031;76014;0;54.3;43.9;0.0
46;2021-07-12;220;1100;0;94251;77114;0;54.4;44.5;0.0
46;2021-07-13;581;1408;0;94832;78522;0;54.8;45.3;0.0
46;2021-07-14;95;169;0;94927;78691;0;54.8;45.4;0.0
46;2021-07-15;784;1269;0;95711;79960;0;55.3;46.2;0.0
46;2021-07-16;651;1219;0;96362;81179;0;55.6;46.9;0.0
46;2021-07-17;333;548;0;96695;81727;0;55.8;47.2;0.0
46;2021-07-18;38;33;0;96733;81760;0;55.9;47.2;0.0
46;2021-07-19;590;1054;0;97323;82814;0;56.2;47.8;0.0
46;2021-07-20;850;1277;0;98173;84091;0;56.7;48.6;0.0
46;2021-07-21;781;1171;0;98954;85262;0;57.1;49.2;0.0
46;2021-07-22;1051;947;0;100005;86209;0;57.8;49.8;0.0
46;2021-07-23;674;1211;0;100679;87420;0;58.1;50.5;0.0
46;2021-07-24;810;633;0;101489;88053;0;58.6;50.8;0.0
46;2021-07-25;140;43;0;101629;88096;0;58.7;50.9;0.0
46;2021-07-26;762;754;0;102391;88850;0;59.1;51.3;0.0
46;2021-07-27;998;790;0;103389;89640;0;59.7;51.8;0.0
46;2021-07-28;1023;880;0;104412;90520;0;60.3;52.3;0.0
46;2021-07-29;1294;714;0;105706;91234;0;61.0;52.7;0.0
46;2021-07-30;1515;759;0;107221;91993;0;61.9;53.1;0.0
46;2021-07-31;778;587;0;107999;92580;0;62.4;53.5;0.0
46;2021-08-01;67;26;0;108066;92606;0;62.4;53.5;0.0
46;2021-08-02;856;511;0;108922;93117;0;62.9;53.8;0.0
46;2021-08-03;1052;505;0;109974;93622;0;63.5;54.1;0.0
46;2021-08-04;1231;409;0;111205;94031;0;64.2;54.3;0.0
46;2021-08-05;1106;680;0;112311;94711;0;64.9;54.7;0.0
46;2021-08-06;1071;615;0;113382;95326;0;65.5;55.0;0.0
46;2021-08-07;533;420;0;113915;95746;0;65.8;55.3;0.0
46;2021-08-08;116;53;0;114031;95799;0;65.9;55.3;0.0
46;2021-08-09;774;555;0;114805;96354;0;66.3;55.6;0.0
46;2021-08-10;966;726;0;115771;97080;0;66.9;56.1;0.0
46;2021-08-11;950;718;0;116721;97798;0;67.4;56.5;0.0
46;2021-08-12;795;596;0;117516;98394;0;67.9;56.8;0.0
46;2021-08-13;760;736;0;118276;99130;0;68.3;57.2;0.0
46;2021-08-14;459;624;0;118735;99754;0;68.6;57.6;0.0
46;2021-08-15;41;53;0;118776;99807;0;68.6;57.6;0.0
46;2021-08-16;634;658;0;119410;100465;0;69.0;58.0;0.0
46;2021-08-17;744;989;0;120154;101454;0;69.4;58.6;0.0
46;2021-08-18;583;841;0;120737;102295;0;69.7;59.1;0.0
46;2021-08-19;529;1076;0;121266;103371;0;70.0;59.7;0.0
46;2021-08-20;439;1199;0;121705;104570;0;70.3;60.4;0.0
46;2021-08-21;304;521;0;122009;105091;0;70.5;60.7;0.0
46;2021-08-22;18;48;0;122027;105139;0;70.5;60.7;0.0
46;2021-08-23;361;1023;0;122388;106162;0;70.7;61.3;0.0
46;2021-08-24;461;1136;0;122849;107298;0;70.9;62.0;0.0
46;2021-08-25;396;1053;0;123245;108351;0;71.2;62.6;0.0
46;2021-08-26;353;904;0;123598;109255;0;71.4;63.1;0.0
46;2021-08-27;379;1305;0;123977;110560;0;71.6;63.8;0.0
46;2021-08-28;232;550;0;124209;111110;0;71.7;64.2;0.0
46;2021-08-29;14;42;0;124223;111152;0;71.7;64.2;0.0
46;2021-08-30;278;958;17;124501;112110;17;71.9;64.7;0.0
46;2021-08-31;300;1079;32;124801;113189;49;72.1;65.4;0.0
46;2021-09-01;377;948;50;125178;114137;99;72.3;65.9;0.1
46;2021-09-02;246;839;41;125424;114976;140;72.4;66.4;0.1
46;2021-09-03;292;966;100;125716;115942;240;72.6;67.0;0.1
46;2021-09-04;197;542;32;125913;116484;272;72.7;67.3;0.2
46;2021-09-05;12;40;3;125925;116524;275;72.7;67.3;0.2
46;2021-09-06;201;586;82;126126;117110;357;72.8;67.6;0.2
46;2021-09-07;226;677;93;126352;117787;450;73.0;68.0;0.3
46;2021-09-08;240;679;91;126592;118466;541;73.1;68.4;0.3
46;2021-09-09;190;458;101;126782;118924;642;73.2;68.7;0.4
46;2021-09-10;269;730;148;127051;119654;790;73.4;69.1;0.5
46;2021-09-11;153;338;34;127204;119992;824;73.5;69.3;0.5
46;2021-09-12;8;31;4;127212;120023;828;73.5;69.3;0.5
46;2021-09-13;166;436;162;127378;120459;990;73.6;69.6;0.6
46;2021-09-14;253;385;340;127631;120844;1330;73.7;69.8;0.8
46;2021-09-15;229;545;183;127860;121389;1513;73.8;70.1;0.9
46;2021-09-16;126;240;119;127986;121629;1632;73.9;70.2;0.9
46;2021-09-17;217;445;207;128203;122074;1839;74.0;70.5;1.1
46;2021-09-18;96;357;31;128299;122431;1870;74.1;70.7;1.1
46;2021-09-19;4;21;0;128303;122452;1870;74.1;70.7;1.1
46;2021-09-20;65;324;141;128368;122776;2011;74.1;70.9;1.2
46;2021-09-21;81;212;210;128449;122988;2221;74.2;71.0;1.3
46;2021-09-22;114;443;269;128563;123431;2490;74.2;71.3;1.4
46;2021-09-23;81;204;384;128644;123635;2874;74.3;71.4;1.7
46;2021-09-24;90;366;225;128734;124001;3099;74.3;71.6;1.8
46;2021-09-25;74;223;41;128808;124224;3140;74.4;71.7;1.8
46;2021-09-26;5;11;4;128813;124235;3144;74.4;71.7;1.8
46;2021-09-27;74;214;200;128887;124449;3344;74.4;71.9;1.9
46;2021-09-28;53;215;149;128940;124664;3493;74.5;72.0;2.0
46;2021-09-29;74;271;182;129014;124935;3675;74.5;72.1;2.1
46;2021-09-30;62;140;206;129076;125075;3881;74.5;72.2;2.2
46;2021-10-01;111;265;142;129187;125340;4023;74.6;72.4;2.3
46;2021-10-02;85;191;57;129272;125531;4080;74.7;72.5;2.4
46;2021-10-03;0;1;0;129272;125532;4080;74.7;72.5;2.4
46;2021-10-04;67;171;204;129339;125703;4284;74.7;72.6;2.5
46;2021-10-05;64;215;202;129403;125918;4486;74.7;72.7;2.6
46;2021-10-06;67;196;197;129470;126114;4683;74.8;72.8;2.7
46;2021-10-07;65;165;275;129535;126279;4958;74.8;72.9;2.9
46;2021-10-08;115;259;321;129650;126538;5279;74.9;73.1;3.0
46;2021-10-09;73;139;111;129723;126677;5390;74.9;73.2;3.1
46;2021-10-10;0;7;0;129723;126684;5390;74.9;73.2;3.1
46;2021-10-11;65;131;233;129788;126815;5623;75.0;73.2;3.2
46;2021-10-12;45;82;266;129833;126897;5889;75.0;73.3;3.4
46;2021-10-13;68;146;292;129901;127043;6181;75.0;73.4;3.6
46;2021-10-14;59;120;321;129960;127163;6502;75.0;73.4;3.8
46;2021-10-15;96;188;293;130056;127351;6795;75.1;73.5;3.9
46;2021-10-16;56;99;108;130112;127450;6903;75.1;73.6;4.0
46;2021-10-17;1;7;1;130113;127457;6904;75.1;73.6;4.0
46;2021-10-18;33;69;251;130146;127526;7155;75.2;73.6;4.1
46;2021-10-19;43;54;264;130189;127580;7419;75.2;73.7;4.3
46;2021-10-20;53;96;356;130242;127676;7775;75.2;73.7;4.5
46;2021-10-21;37;64;211;130279;127740;7986;75.2;73.8;4.6
46;2021-10-22;80;118;433;130359;127858;8419;75.3;73.8;4.9
46;2021-10-23;43;69;126;130402;127927;8545;75.3;73.9;4.9
46;2021-10-24;4;6;3;130406;127933;8548;75.3;73.9;4.9
46;2021-10-25;41;49;250;130447;127982;8798;75.3;73.9;5.1
46;2021-10-26;41;49;286;130488;128031;9084;75.4;73.9;5.2
46;2021-10-27;56;104;357;130544;128135;9441;75.4;74.0;5.5
46;2021-10-28;59;66;195;130603;128201;9636;75.4;74.0;5.6
46;2021-10-29;59;105;315;130662;128306;9951;75.5;74.1;5.7
46;2021-10-30;42;72;188;130704;128378;10139;75.5;74.1;5.9
46;2021-10-31;4;0;5;130708;128378;10144;75.5;74.1;5.9
46;2021-11-01;4;2;18;130712;128380;10162;75.5;74.1;5.9
46;2021-11-02;39;75;358;130751;128455;10520;75.5;74.2;6.1
46;2021-11-03;43;95;414;130794;128550;10934;75.5;74.2;6.3
46;2021-11-04;21;47;218;130815;128597;11152;75.5;74.3;6.4
46;2021-11-05;53;103;440;130868;128700;11592;75.6;74.3;6.7
46;2021-11-06;52;78;328;130920;128778;11920;75.6;74.4;6.9
46;2021-11-07;3;1;11;130923;128779;11931;75.6;74.4;6.9
46;2021-11-08;21;52;398;130944;128831;12329;75.6;74.4;7.1
46;2021-11-09;51;59;573;130995;128890;12902;75.6;74.4;7.5
46;2021-11-10;65;66;655;131060;128956;13557;75.7;74.5;7.8
46;2021-11-11;4;2;19;131064;128958;13576;75.7;74.5;7.8
46;2021-11-12;41;70;504;131105;129028;14080;75.7;74.5;8.1
46;2021-11-13;37;55;242;131142;129083;14322;75.7;74.5;8.3
46;2021-11-14;4;3;18;131146;129086;14340;75.7;74.5;8.3
46;2021-11-15;36;41;442;131182;129127;14782;75.8;74.6;8.5
46;2021-11-16;48;40;644;131230;129167;15426;75.8;74.6;8.9
46;2021-11-17;73;77;739;131303;129244;16165;75.8;74.6;9.3
46;2021-11-18;33;48;524;131336;129292;16689;75.8;74.7;9.6
46;2021-11-19;58;70;760;131394;129362;17449;75.9;74.7;10.1
46;2021-11-20;59;51;409;131453;129413;17858;75.9;74.7;10.3
46;2021-11-21;6;6;15;131459;129419;17873;75.9;74.7;10.3
46;2021-11-22;22;36;561;131481;129455;18434;75.9;74.8;10.6
46;2021-11-23;57;33;730;131538;129488;19164;76.0;74.8;11.1
46;2021-11-24;42;57;840;131580;129545;20004;76.0;74.8;11.6
46;2021-11-25;70;42;1168;131650;129587;21172;76.0;74.8;12.2
46;2021-11-26;62;57;1223;131712;129644;22395;76.1;74.9;12.9
46;2021-11-27;64;59;984;131776;129703;23379;76.1;74.9;13.5
46;2021-11-28;18;10;456;131794;129713;23835;76.1;74.9;13.8
46;2021-11-29;33;28;831;131827;129741;24666;76.1;74.9;14.2
46;2021-11-30;50;33;1568;131877;129774;26234;76.2;74.9;15.1
46;2021-12-01;68;67;1320;131945;129841;27554;76.2;75.0;15.9
46;2021-12-02;44;41;1525;131989;129882;29079;76.2;75.0;16.8
46;2021-12-03;62;67;1713;132051;129949;30792;76.3;75.0;17.8
46;2021-12-04;48;47;1291;132099;129996;32083;76.3;75.1;18.5
46;2021-12-05;24;3;454;132123;129999;32537;76.3;75.1;18.8
46;2021-12-06;56;62;1702;132179;130061;34239;76.3;75.1;19.8
46;2021-12-07;42;53;1997;132221;130114;36236;76.4;75.1;20.9
46;2021-12-08;58;77;1784;132279;130191;38020;76.4;75.2;22.0
46;2021-12-09;51;45;1852;132330;130236;39872;76.4;75.2;23.0
46;2021-12-10;58;55;2243;132388;130291;42115;76.5;75.2;24.3
46;2021-12-11;49;57;1099;132437;130348;43214;76.5;75.3;25.0
46;2021-12-12;8;8;252;132445;130356;43466;76.5;75.3;25.1
46;2021-12-13;64;49;1791;132509;130405;45257;76.5;75.3;26.1
46;2021-12-14;75;64;2723;132584;130469;47980;76.6;75.3;27.7
46;2021-12-15;61;67;2288;132645;130536;50268;76.6;75.4;29.0
46;2021-12-16;81;79;2346;132726;130615;52614;76.6;75.4;30.4
47;2020-12-27;0;0;0;0;0;0;0.0;0.0;0.0
47;2020-12-28;0;0;0;0;0;0;0.0;0.0;0.0
47;2020-12-29;0;0;0;0;0;0;0.0;0.0;0.0
47;2020-12-30;0;0;0;0;0;0;0.0;0.0;0.0
47;2020-12-31;0;0;0;0;0;0;0.0;0.0;0.0
47;2021-01-01;4;0;0;4;0;0;0.0;0.0;0.0
47;2021-01-02;0;0;0;4;0;0;0.0;0.0;0.0
47;2021-01-03;0;0;0;4;0;0;0.0;0.0;0.0
47;2021-01-04;2;0;0;6;0;0;0.0;0.0;0.0
47;2021-01-05;2;0;0;8;0;0;0.0;0.0;0.0
47;2021-01-06;1;0;0;9;0;0;0.0;0.0;0.0
47;2021-01-07;74;1;0;83;1;0;0.0;0.0;0.0
47;2021-01-08;304;0;0;387;1;0;0.1;0.0;0.0
47;2021-01-09;113;0;0;500;1;0;0.2;0.0;0.0
47;2021-01-10;1;0;0;501;1;0;0.2;0.0;0.0
47;2021-01-11;231;0;0;732;1;0;0.2;0.0;0.0
47;2021-01-12;311;0;0;1043;1;0;0.3;0.0;0.0
47;2021-01-13;343;0;0;1386;1;0;0.4;0.0;0.0
47;2021-01-14;365;5;0;1751;6;0;0.5;0.0;0.0
47;2021-01-15;269;1;0;2020;7;0;0.6;0.0;0.0
47;2021-01-16;170;4;0;2190;11;0;0.7;0.0;0.0
47;2021-01-17;2;0;0;2192;11;0;0.7;0.0;0.0
47;2021-01-18;478;3;0;2670;14;0;0.8;0.0;0.0
47;2021-01-19;479;3;0;3149;17;0;1.0;0.0;0.0
47;2021-01-20;520;2;0;3669;19;0;1.1;0.0;0.0
47;2021-01-21;576;2;0;4245;21;0;1.3;0.0;0.0
47;2021-01-22;449;1;0;4694;22;0;1.4;0.0;0.0
47;2021-01-23;375;0;0;5069;22;0;1.5;0.0;0.0
47;2021-01-24;0;0;0;5069;22;0;1.5;0.0;0.0
47;2021-01-25;426;0;0;5495;22;0;1.7;0.0;0.0
47;2021-01-26;743;6;0;6238;28;0;1.9;0.0;0.0
47;2021-01-27;743;2;0;6981;30;0;2.1;0.0;0.0
47;2021-01-28;526;65;0;7507;95;0;2.3;0.0;0.0
47;2021-01-29;436;164;0;7943;259;0;2.4;0.1;0.0
47;2021-01-30;289;40;0;8232;299;0;2.5;0.1;0.0
47;2021-01-31;0;0;0;8232;299;0;2.5;0.1;0.0
47;2021-02-01;349;111;0;8581;410;0;2.6;0.1;0.0
47;2021-02-02;700;307;0;9281;717;0;2.8;0.2;0.0
47;2021-02-03;417;164;0;9698;881;0;2.9;0.3;0.0
47;2021-02-04;385;312;0;10083;1193;0;3.1;0.4;0.0
47;2021-02-05;309;290;0;10392;1483;0;3.1;0.4;0.0
47;2021-02-06;284;96;0;10676;1579;0;3.2;0.5;0.0
47;2021-02-07;1;2;0;10677;1581;0;3.2;0.5;0.0
47;2021-02-08;184;277;0;10861;1858;0;3.3;0.6;0.0
47;2021-02-09;224;274;0;11085;2132;0;3.4;0.6;0.0
47;2021-02-10;262;225;0;11347;2357;0;3.4;0.7;0.0
47;2021-02-11;340;325;0;11687;2682;0;3.5;0.8;0.0
47;2021-02-12;264;390;0;11951;3072;0;3.6;0.9;0.0
47;2021-02-13;223;103;0;12174;3175;0;3.7;1.0;0.0
47;2021-02-14;6;0;0;12180;3175;0;3.7;1.0;0.0
47;2021-02-15;176;377;0;12356;3552;0;3.7;1.1;0.0
47;2021-02-16;298;540;0;12654;4092;0;3.8;1.2;0.0
47;2021-02-17;294;456;0;12948;4548;0;3.9;1.4;0.0
47;2021-02-18;210;557;0;13158;5105;0;4.0;1.5;0.0
47;2021-02-19;212;357;0;13370;5462;0;4.0;1.7;0.0
47;2021-02-20;118;249;0;13488;5711;0;4.1;1.7;0.0
47;2021-02-21;1;0;0;13489;5711;0;4.1;1.7;0.0
47;2021-02-22;76;404;0;13565;6115;0;4.1;1.9;0.0
47;2021-02-23;165;598;0;13730;6713;0;4.2;2.0;0.0
47;2021-02-24;259;561;0;13989;7274;0;4.2;2.2;0.0
47;2021-02-25;356;444;0;14345;7718;0;4.3;2.3;0.0
47;2021-02-26;482;316;0;14827;8034;0;4.5;2.4;0.0
47;2021-02-27;318;212;0;15145;8246;0;4.6;2.5;0.0
47;2021-02-28;0;2;0;15145;8248;0;4.6;2.5;0.0
47;2021-03-01;144;394;0;15289;8642;0;4.6;2.6;0.0
47;2021-03-02;237;368;0;15526;9010;0;4.7;2.7;0.0
47;2021-03-03;265;355;0;15791;9365;0;4.8;2.8;0.0
47;2021-03-04;643;334;0;16434;9699;0;5.0;2.9;0.0
47;2021-03-05;874;288;0;17308;9987;0;5.2;3.0;0.0
47;2021-03-06;509;187;0;17817;10174;0;5.4;3.1;0.0
47;2021-03-07;318;9;0;18135;10183;0;5.5;3.1;0.0
47;2021-03-08;482;222;0;18617;10405;0;5.6;3.1;0.0
47;2021-03-09;522;460;0;19139;10865;0;5.8;3.3;0.0
47;2021-03-10;673;308;0;19812;11173;0;6.0;3.4;0.0
47;2021-03-11;963;386;0;20775;11559;0;6.3;3.5;0.0
47;2021-03-12;1409;316;0;22184;11875;0;6.7;3.6;0.0
47;2021-03-13;914;107;0;23098;11982;0;7.0;3.6;0.0
47;2021-03-14;48;0;0;23146;11982;0;7.0;3.6;0.0
47;2021-03-15;629;154;0;23775;12136;0;7.2;3.7;0.0
47;2021-03-16;782;202;0;24557;12338;0;7.4;3.7;0.0
47;2021-03-17;864;223;0;25421;12561;0;7.7;3.8;0.0
47;2021-03-18;930;190;0;26351;12751;0;8.0;3.9;0.0
47;2021-03-19;1283;135;0;27634;12886;0;8.4;3.9;0.0
47;2021-03-20;1055;58;0;28689;12944;0;8.7;3.9;0.0
47;2021-03-21;335;1;0;29024;12945;0;8.8;3.9;0.0
47;2021-03-22;1027;120;0;30051;13065;0;9.1;4.0;0.0
47;2021-03-23;1186;183;0;31237;13248;0;9.5;4.0;0.0
47;2021-03-24;1232;162;0;32469;13410;0;9.8;4.1;0.0
47;2021-03-25;1555;164;0;34024;13574;0;10.3;4.1;0.0
47;2021-03-26;1887;222;0;35911;13796;0;10.9;4.2;0.0
47;2021-03-27;965;127;0;36876;13923;0;11.2;4.2;0.0
47;2021-03-28;671;7;0;37547;13930;0;11.4;4.2;0.0
47;2021-03-29;1490;114;0;39037;14044;0;11.8;4.3;0.0
47;2021-03-30;1645;149;0;40682;14193;0;12.3;4.3;0.0
47;2021-03-31;1627;185;0;42309;14378;0;12.8;4.4;0.0
47;2021-04-01;1749;278;0;44058;14656;0;13.3;4.4;0.0
47;2021-04-02;1969;451;0;46027;15107;0;13.9;4.6;0.0
47;2021-04-03;1203;182;0;47230;15289;0;14.3;4.6;0.0
47;2021-04-04;467;14;0;47697;15303;0;14.4;4.6;0.0
47;2021-04-05;1190;54;0;48887;15357;0;14.8;4.6;0.0
47;2021-04-06;1427;404;0;50314;15761;0;15.2;4.8;0.0
47;2021-04-07;1697;630;0;52011;16391;0;15.7;5.0;0.0
47;2021-04-08;1866;515;0;53877;16906;0;16.3;5.1;0.0
47;2021-04-09;2228;549;0;56105;17455;0;17.0;5.3;0.0
47;2021-04-10;1581;325;0;57686;17780;0;17.5;5.4;0.0
47;2021-04-11;522;13;0;58208;17793;0;17.6;5.4;0.0
47;2021-04-12;1495;636;0;59703;18429;0;18.1;5.6;0.0
47;2021-04-13;1875;794;0;61578;19223;0;18.6;5.8;0.0
47;2021-04-14;1812;734;0;63390;19957;0;19.2;6.0;0.0
47;2021-04-15;2030;862;0;65420;20819;0;19.8;6.3;0.0
47;2021-04-16;1819;897;0;67239;21716;0;20.4;6.6;0.0
47;2021-04-17;1456;945;0;68695;22661;0;20.8;6.9;0.0
47;2021-04-18;29;5;0;68724;22666;0;20.8;6.9;0.0
47;2021-04-19;1336;946;0;70060;23612;0;21.2;7.1;0.0
47;2021-04-20;1743;914;0;71803;24526;0;21.7;7.4;0.0
47;2021-04-21;1633;805;0;73436;25331;0;22.2;7.7;0.0
47;2021-04-22;1876;1025;0;75312;26356;0;22.8;8.0;0.0
47;2021-04-23;1723;1102;0;77035;27458;0;23.3;8.3;0.0
47;2021-04-24;1519;781;0;78554;28239;0;23.8;8.5;0.0
47;2021-04-25;260;336;0;78814;28575;0;23.9;8.7;0.0
47;2021-04-26;1433;1352;0;80247;29927;0;24.3;9.1;0.0
47;2021-04-27;1888;1465;0;82135;31392;0;24.9;9.5;0.0
47;2021-04-28;2008;1602;0;84143;32994;0;25.5;10.0;0.0
47;2021-04-29;2446;1515;0;86589;34509;0;26.2;10.4;0.0
47;2021-04-30;1983;1775;0;88572;36284;0;26.8;11.0;0.0
47;2021-05-01;2139;940;0;90711;37224;0;27.5;11.3;0.0
47;2021-05-02;40;357;0;90751;37581;0;27.5;11.4;0.0
47;2021-05-03;1520;1393;0;92271;38974;0;27.9;11.8;0.0
47;2021-05-04;1585;1743;0;93856;40717;0;28.4;12.3;0.0
47;2021-05-05;1833;1632;0;95689;42349;0;29.0;12.8;0.0
47;2021-05-06;1961;1518;0;97650;43867;0;29.6;13.3;0.0
47;2021-05-07;1923;1687;0;99573;45554;0;30.1;13.8;0.0
47;2021-05-08;1960;545;0;101533;46099;0;30.7;14.0;0.0
47;2021-05-09;32;362;0;101565;46461;0;30.7;14.1;0.0
47;2021-05-10;1104;1718;0;102669;48179;0;31.1;14.6;0.0
47;2021-05-11;1995;2024;0;104664;50203;0;31.7;15.2;0.0
47;2021-05-12;2343;1476;0;107007;51679;0;32.4;15.6;0.0
47;2021-05-13;1961;604;0;108968;52283;0;33.0;15.8;0.0
47;2021-05-14;1760;841;0;110728;53124;0;33.5;16.1;0.0
47;2021-05-15;1665;850;0;112393;53974;0;34.0;16.3;0.0
47;2021-05-16;310;11;0;112703;53985;0;34.1;16.3;0.0
47;2021-05-17;1679;1164;0;114382;55149;0;34.6;16.7;0.0
47;2021-05-18;2076;1209;0;116458;56358;0;35.3;17.1;0.0
47;2021-05-19;2123;761;0;118581;57119;0;35.9;17.3;0.0
47;2021-05-20;2366;1000;0;120947;58119;0;36.6;17.6;0.0
47;2021-05-21;1412;1163;0;122359;59282;0;37.0;17.9;0.0
47;2021-05-22;2145;823;0;124504;60105;0;37.7;18.2;0.0
47;2021-05-23;46;186;0;124550;60291;0;37.7;18.3;0.0
47;2021-05-24;1356;254;0;125906;60545;0;38.1;18.3;0.0
47;2021-05-25;1389;1327;0;127295;61872;0;38.5;18.7;0.0
47;2021-05-26;1519;1118;0;128814;62990;0;39.0;19.1;0.0
47;2021-05-27;1840;1279;0;130654;64269;0;39.6;19.5;0.0
47;2021-05-28;1411;1562;0;132065;65831;0;40.0;19.9;0.0
47;2021-05-29;1054;1110;0;133119;66941;0;40.3;20.3;0.0
47;2021-05-30;27;50;0;133146;66991;0;40.3;20.3;0.0
47;2021-05-31;1770;1395;0;134916;68386;0;40.8;20.7;0.0
47;2021-06-01;1818;1387;0;136734;69773;0;41.4;21.1;0.0
47;2021-06-02;1934;1311;0;138668;71084;0;42.0;21.5;0.0
47;2021-06-03;2307;1591;0;140975;72675;0;42.7;22.0;0.0
47;2021-06-04;1842;2075;0;142817;74750;0;43.2;22.6;0.0
47;2021-06-05;1480;1444;0;144297;76194;0;43.7;23.1;0.0
47;2021-06-06;223;80;0;144520;76274;0;43.7;23.1;0.0
47;2021-06-07;1542;2140;0;146062;78414;0;44.2;23.7;0.0
47;2021-06-08;1547;1827;0;147609;80241;0;44.7;24.3;0.0
47;2021-06-09;1660;2034;0;149269;82275;0;45.2;24.9;0.0
47;2021-06-10;2207;1604;0;151476;83879;0;45.9;25.4;0.0
47;2021-06-11;1731;2036;0;153207;85915;0;46.4;26.0;0.0
47;2021-06-12;1175;2021;0;154382;87936;0;46.7;26.6;0.0
47;2021-06-13;39;26;0;154421;87962;0;46.7;26.6;0.0
47;2021-06-14;1195;2320;0;155616;90282;0;47.1;27.3;0.0
47;2021-06-15;1381;1967;0;156997;92249;0;47.5;27.9;0.0
47;2021-06-16;1111;2068;0;158108;94317;0;47.9;28.6;0.0
47;2021-06-17;1529;1484;0;159637;95801;0;48.3;29.0;0.0
47;2021-06-18;1353;2435;0;160990;98236;0;48.7;29.7;0.0
47;2021-06-19;1349;2203;0;162339;100439;0;49.1;30.4;0.0
47;2021-06-20;22;50;0;162361;100489;0;49.2;30.4;0.0
47;2021-06-21;995;2273;0;163356;102762;0;49.5;31.1;0.0
47;2021-06-22;766;2338;0;164122;105100;0;49.7;31.8;0.0
47;2021-06-23;968;1898;0;165090;106998;0;50.0;32.4;0.0
47;2021-06-24;1163;1858;0;166253;108856;0;50.3;33.0;0.0
47;2021-06-25;942;2446;0;167195;111302;0;50.6;33.7;0.0
47;2021-06-26;878;2422;0;168073;113724;0;50.9;34.4;0.0
47;2021-06-27;24;300;0;168097;114024;0;50.9;34.5;0.0
47;2021-06-28;764;2202;0;168861;116226;0;51.1;35.2;0.0
47;2021-06-29;770;2195;0;169631;118421;0;51.4;35.8;0.0
47;2021-06-30;735;2126;0;170366;120547;0;51.6;36.5;0.0
47;2021-07-01;816;2001;0;171182;122548;0;51.8;37.1;0.0
47;2021-07-02;837;2123;0;172019;124671;0;52.1;37.7;0.0
47;2021-07-03;661;2761;0;172680;127432;0;52.3;38.6;0.0
47;2021-07-04;46;32;0;172726;127464;0;52.3;38.6;0.0
47;2021-07-05;874;2017;0;173600;129481;0;52.6;39.2;0.0
47;2021-07-06;867;1916;0;174467;131397;0;52.8;39.8;0.0
47;2021-07-07;1253;1948;0;175720;133345;0;53.2;40.4;0.0
47;2021-07-08;1067;2092;0;176787;135437;0;53.5;41.0;0.0
47;2021-07-09;969;2277;0;177756;137714;0;53.8;41.7;0.0
47;2021-07-10;830;1897;0;178586;139611;0;54.1;42.3;0.0
47;2021-07-11;13;43;0;178599;139654;0;54.1;42.3;0.0
47;2021-07-12;558;2364;0;179157;142018;0;54.2;43.0;0.0
47;2021-07-13;1047;2398;0;180204;144416;0;54.6;43.7;0.0
47;2021-07-14;975;1396;0;181179;145812;0;54.8;44.1;0.0
47;2021-07-15;1575;2925;0;182754;148737;0;55.3;45.0;0.0
47;2021-07-16;1604;2502;0;184358;151239;0;55.8;45.8;0.0
47;2021-07-17;1134;2211;0;185492;153450;0;56.2;46.5;0.0
47;2021-07-18;71;221;0;185563;153671;0;56.2;46.5;0.0
47;2021-07-19;979;2316;0;186542;155987;0;56.5;47.2;0.0
47;2021-07-20;1504;2244;0;188046;158231;0;56.9;47.9;0.0
47;2021-07-21;1931;2128;0;189977;160359;0;57.5;48.5;0.0
47;2021-07-22;2076;2197;0;192053;162556;0;58.1;49.2;0.0
47;2021-07-23;1975;2064;0;194028;164620;0;58.7;49.8;0.0
47;2021-07-24;1029;1647;0;195057;166267;0;59.0;50.3;0.0
47;2021-07-25;78;47;0;195135;166314;0;59.1;50.3;0.0
47;2021-07-26;1240;1782;0;196375;168096;0;59.4;50.9;0.0
47;2021-07-27;2052;1529;0;198427;169625;0;60.1;51.3;0.0
47;2021-07-28;1800;1616;0;200227;171241;0;60.6;51.8;0.0
47;2021-07-29;2230;1592;0;202457;172833;0;61.3;52.3;0.0
47;2021-07-30;1860;1567;0;204317;174400;0;61.9;52.8;0.0
47;2021-07-31;1322;1444;0;205639;175844;0;62.3;53.2;0.0
47;2021-08-01;66;36;0;205705;175880;0;62.3;53.2;0.0
47;2021-08-02;1853;1127;0;207558;177007;0;62.8;53.6;0.0
47;2021-08-03;1953;1053;0;209511;178060;0;63.4;53.9;0.0
47;2021-08-04;2056;1291;0;211567;179351;0;64.0;54.3;0.0
47;2021-08-05;2216;1324;0;213783;180675;0;64.7;54.7;0.0
47;2021-08-06;1837;1685;0;215620;182360;0;65.3;55.2;0.0
47;2021-08-07;1372;1180;0;216992;183540;0;65.7;55.6;0.0
47;2021-08-08;56;42;0;217048;183582;0;65.7;55.6;0.0
47;2021-08-09;1730;1131;0;218778;184713;0;66.2;55.9;0.0
47;2021-08-10;1753;1196;0;220531;185909;0;66.8;56.3;0.0
47;2021-08-11;1671;1321;0;222202;187230;0;67.3;56.7;0.0
47;2021-08-12;1794;1226;0;223996;188456;0;67.8;57.0;0.0
47;2021-08-13;1295;1514;0;225291;189970;0;68.2;57.5;0.0
47;2021-08-14;1161;1256;0;226452;191226;0;68.6;57.9;0.0
47;2021-08-15;29;43;0;226481;191269;0;68.6;57.9;0.0
47;2021-08-16;1259;1303;0;227740;192572;0;68.9;58.3;0.0
47;2021-08-17;1066;1597;0;228806;194169;0;69.3;58.8;0.0
47;2021-08-18;1143;1678;0;229949;195847;0;69.6;59.3;0.0
47;2021-08-19;942;1645;0;230891;197492;0;69.9;59.8;0.0
47;2021-08-20;927;1658;0;231818;199150;0;70.2;60.3;0.0
47;2021-08-21;750;1194;0;232568;200344;0;70.4;60.6;0.0
47;2021-08-22;23;57;0;232591;200401;0;70.4;60.7;0.0
47;2021-08-23;594;1761;0;233185;202162;0;70.6;61.2;0.0
47;2021-08-24;793;1605;0;233978;203767;0;70.8;61.7;0.0
47;2021-08-25;747;1779;0;234725;205546;0;71.1;62.2;0.0
47;2021-08-26;704;2042;0;235429;207588;0;71.3;62.8;0.0
47;2021-08-27;681;1844;0;236110;209432;0;71.5;63.4;0.0
47;2021-08-28;507;1497;0;236617;210929;0;71.6;63.9;0.0
47;2021-08-29;19;66;0;236636;210995;0;71.6;63.9;0.0
47;2021-08-30;449;1799;19;237085;212794;19;71.8;64.4;0.0
47;2021-08-31;531;1740;27;237616;214534;46;71.9;64.9;0.0
47;2021-09-01;446;1844;64;238062;216378;110;72.1;65.5;0.0
47;2021-09-02;466;1812;81;238528;218190;191;72.2;66.1;0.1
47;2021-09-03;507;1699;114;239035;219889;305;72.4;66.6;0.1
47;2021-09-04;442;1485;76;239477;221374;381;72.5;67.0;0.1
47;2021-09-05;19;58;2;239496;221432;383;72.5;67.0;0.1
47;2021-09-06;346;1212;170;239842;222644;553;72.6;67.4;0.2
47;2021-09-07;452;1074;159;240294;223718;712;72.7;67.7;0.2
47;2021-09-08;421;1406;142;240715;225124;854;72.9;68.2;0.3
47;2021-09-09;420;1017;249;241135;226141;1103;73.0;68.5;0.3
47;2021-09-10;455;1147;183;241590;227288;1286;73.1;68.8;0.4
47;2021-09-11;380;1234;57;241970;228522;1343;73.2;69.2;0.4
47;2021-09-12;6;18;2;241976;228540;1345;73.3;69.2;0.4
47;2021-09-13;253;773;266;242229;229313;1611;73.3;69.4;0.5
47;2021-09-14;389;765;357;242618;230078;1968;73.4;69.6;0.6
47;2021-09-15;330;868;192;242948;230946;2160;73.5;69.9;0.7
47;2021-09-16;335;559;396;243283;231505;2556;73.6;70.1;0.8
47;2021-09-17;378;652;224;243661;232157;2780;73.8;70.3;0.8
47;2021-09-18;237;881;78;243898;233038;2858;73.8;70.5;0.9
47;2021-09-19;7;14;6;243905;233052;2864;73.8;70.5;0.9
47;2021-09-20;183;498;365;244088;233550;3229;73.9;70.7;1.0
47;2021-09-21;250;397;358;244338;233947;3587;74.0;70.8;1.1
47;2021-09-22;203;608;269;244541;234555;3856;74.0;71.0;1.2
47;2021-09-23;192;387;423;244733;234942;4279;74.1;71.1;1.3
47;2021-09-24;270;606;324;245003;235548;4603;74.2;71.3;1.4
47;2021-09-25;181;565;80;245184;236113;4683;74.2;71.5;1.4
47;2021-09-26;3;9;3;245187;236122;4686;74.2;71.5;1.4
47;2021-09-27;111;375;161;245298;236497;4847;74.3;71.6;1.5
47;2021-09-28;129;358;227;245427;236855;5074;74.3;71.7;1.5
47;2021-09-29;158;444;211;245585;237299;5285;74.3;71.8;1.6
47;2021-09-30;161;354;386;245746;237653;5671;74.4;71.9;1.7
47;2021-10-01;227;520;207;245973;238173;5878;74.5;72.1;1.8
47;2021-10-02;191;433;120;246164;238606;5998;74.5;72.2;1.8
47;2021-10-03;0;6;0;246164;238612;5998;74.5;72.2;1.8
47;2021-10-04;134;329;291;246298;238941;6289;74.6;72.3;1.9
47;2021-10-05;114;309;226;246412;239250;6515;74.6;72.4;2.0
47;2021-10-06;218;416;275;246630;239666;6790;74.7;72.6;2.1
47;2021-10-07;144;359;343;246774;240025;7133;74.7;72.7;2.2
47;2021-10-08;179;398;315;246953;240423;7448;74.8;72.8;2.3
47;2021-10-09;214;327;193;247167;240750;7641;74.8;72.9;2.3
47;2021-10-10;1;9;14;247168;240759;7655;74.8;72.9;2.3
47;2021-10-11;127;214;296;247295;240973;7951;74.9;72.9;2.4
47;2021-10-12;123;263;381;247418;241236;8332;74.9;73.0;2.5
47;2021-10-13;139;262;254;247557;241498;8586;74.9;73.1;2.6
47;2021-10-14;92;209;311;247649;241707;8897;75.0;73.2;2.7
47;2021-10-15;162;354;409;247811;242061;9306;75.0;73.3;2.8
47;2021-10-16;175;224;246;247986;242285;9552;75.1;73.3;2.9
47;2021-10-17;1;7;4;247987;242292;9556;75.1;73.3;2.9
47;2021-10-18;125;200;445;248112;242492;10001;75.1;73.4;3.0
47;2021-10-19;113;180;394;248225;242672;10395;75.1;73.5;3.1
47;2021-10-20;133;174;432;248358;242846;10827;75.2;73.5;3.3
47;2021-10-21;107;135;435;248465;242981;11262;75.2;73.6;3.4
47;2021-10-22;117;188;494;248582;243169;11756;75.3;73.6;3.6
47;2021-10-23;159;221;311;248741;243390;12067;75.3;73.7;3.7
47;2021-10-24;2;7;4;248743;243397;12071;75.3;73.7;3.7
47;2021-10-25;116;149;488;248859;243546;12559;75.3;73.7;3.8
47;2021-10-26;83;140;617;248942;243686;13176;75.4;73.8;4.0
47;2021-10-27;132;178;520;249074;243864;13696;75.4;73.8;4.1
47;2021-10-28;88;154;477;249162;244018;14173;75.4;73.9;4.3
47;2021-10-29;89;177;640;249251;244195;14813;75.5;73.9;4.5
47;2021-10-30;84;200;328;249335;244395;15141;75.5;74.0;4.6
47;2021-10-31;0;4;5;249335;244399;15146;75.5;74.0;4.6
47;2021-11-01;20;15;105;249355;244414;15251;75.5;74.0;4.6
47;2021-11-02;117;147;635;249472;244561;15886;75.5;74.0;4.8
47;2021-11-03;96;176;709;249568;244737;16595;75.5;74.1;5.0
47;2021-11-04;89;117;780;249657;244854;17375;75.6;74.1;5.3
47;2021-11-05;119;163;783;249776;245017;18158;75.6;74.2;5.5
47;2021-11-06;115;208;484;249891;245225;18642;75.6;74.2;5.6
47;2021-11-07;2;13;16;249893;245238;18658;75.6;74.2;5.6
47;2021-11-08;64;139;846;249957;245377;19504;75.7;74.3;5.9
47;2021-11-09;99;150;1101;250056;245527;20605;75.7;74.3;6.2
47;2021-11-10;113;175;986;250169;245702;21591;75.7;74.4;6.5
47;2021-11-11;39;29;283;250208;245731;21874;75.7;74.4;6.6
47;2021-11-12;88;144;1075;250296;245875;22949;75.8;74.4;6.9
47;2021-11-13;114;169;561;250410;246044;23510;75.8;74.5;7.1
47;2021-11-14;1;6;17;250411;246050;23527;75.8;74.5;7.1
47;2021-11-15;81;104;1469;250492;246154;24996;75.8;74.5;7.6
47;2021-11-16;96;129;1593;250588;246283;26589;75.9;74.6;8.0
47;2021-11-17;139;142;1176;250727;246425;27765;75.9;74.6;8.4
47;2021-11-18;88;88;1145;250815;246513;28910;75.9;74.6;8.8
47;2021-11-19;126;125;1398;250941;246638;30308;76.0;74.7;9.2
47;2021-11-20;145;150;844;251086;246788;31152;76.0;74.7;9.4
47;2021-11-21;8;10;20;251094;246798;31172;76.0;74.7;9.4
47;2021-11-22;69;59;1052;251163;246857;32224;76.0;74.7;9.8
47;2021-11-23;117;88;1704;251280;246945;33928;76.1;74.8;10.3
47;2021-11-24;154;154;1362;251434;247099;35290;76.1;74.8;10.7
47;2021-11-25;127;98;1523;251561;247197;36813;76.2;74.8;11.1
47;2021-11-26;128;129;1855;251689;247326;38668;76.2;74.9;11.7
47;2021-11-27;140;140;1553;251829;247466;40221;76.2;74.9;12.2
47;2021-11-28;9;9;168;251838;247475;40389;76.2;74.9;12.2
47;2021-11-29;84;91;2321;251922;247566;42710;76.3;74.9;12.9
47;2021-11-30;131;128;3114;252053;247694;45824;76.3;75.0;13.9
47;2021-12-01;111;132;2781;252164;247826;48605;76.3;75.0;14.7
47;2021-12-02;116;91;2970;252280;247917;51575;76.4;75.0;15.6
47;2021-12-03;124;119;3324;252404;248036;54899;76.4;75.1;16.6
47;2021-12-04;88;127;2195;252492;248163;57094;76.4;75.1;17.3
47;2021-12-05;62;23;1212;252554;248186;58306;76.5;75.1;17.7
47;2021-12-06;87;90;2840;252641;248276;61146;76.5;75.2;18.5
47;2021-12-07;122;118;4164;252763;248394;65310;76.5;75.2;19.8
47;2021-12-08;124;135;3468;252887;248529;68778;76.6;75.2;20.8
47;2021-12-09;121;105;3607;253008;248634;72385;76.6;75.3;21.9
47;2021-12-10;133;145;3715;253141;248779;76100;76.6;75.3;23.0
47;2021-12-11;108;141;2970;253249;248920;79070;76.7;75.4;23.9
47;2021-12-12;9;9;344;253258;248929;79414;76.7;75.4;24.0
47;2021-12-13;96;108;3155;253354;249037;82569;76.7;75.4;25.0
47;2021-12-14;118;136;4077;253472;249173;86646;76.7;75.4;26.2
47;2021-12-15;123;170;3161;253595;249343;89807;76.8;75.5;27.2
47;2021-12-16;129;129;3868;253724;249472;93675;76.8;75.5;28.4
48;2020-12-27;0;0;0;0;0;0;0.0;0.0;0.0
48;2020-12-28;0;0;0;0;0;0;0.0;0.0;0.0
48;2020-12-29;1;0;0;1;0;0;0.0;0.0;0.0
48;2020-12-30;0;0;0;1;0;0;0.0;0.0;0.0
48;2020-12-31;0;0;0;1;0;0;0.0;0.0;0.0
48;2021-01-01;1;0;0;2;0;0;0.0;0.0;0.0
48;2021-01-02;0;0;0;2;0;0;0.0;0.0;0.0
48;2021-01-03;0;0;0;2;0;0;0.0;0.0;0.0
48;2021-01-04;1;0;0;3;0;0;0.0;0.0;0.0
48;2021-01-05;0;0;0;3;0;0;0.0;0.0;0.0
48;2021-01-06;0;0;0;3;0;0;0.0;0.0;0.0
48;2021-01-07;53;0;0;56;0;0;0.1;0.0;0.0
48;2021-01-08;88;1;0;144;1;0;0.2;0.0;0.0
48;2021-01-09;1;0;0;145;1;0;0.2;0.0;0.0
48;2021-01-10;0;0;0;145;1;0;0.2;0.0;0.0
48;2021-01-11;14;0;0;159;1;0;0.2;0.0;0.0
48;2021-01-12;24;1;0;183;2;0;0.2;0.0;0.0
48;2021-01-13;89;0;0;272;2;0;0.4;0.0;0.0
48;2021-01-14;94;1;0;366;3;0;0.5;0.0;0.0
48;2021-01-15;62;0;0;428;3;0;0.6;0.0;0.0
48;2021-01-16;0;0;0;428;3;0;0.6;0.0;0.0
48;2021-01-17;0;0;0;428;3;0;0.6;0.0;0.0
48;2021-01-18;116;0;0;544;3;0;0.7;0.0;0.0
48;2021-01-19;297;2;0;841;5;0;1.1;0.0;0.0
48;2021-01-20;260;0;0;1101;5;0;1.4;0.0;0.0
48;2021-01-21;437;1;0;1538;6;0;2.0;0.0;0.0
48;2021-01-22;236;0;0;1774;6;0;2.3;0.0;0.0
48;2021-01-23;45;0;0;1819;6;0;2.4;0.0;0.0
48;2021-01-24;2;0;0;1821;6;0;2.4;0.0;0.0
48;2021-01-25;119;2;0;1940;8;0;2.5;0.0;0.0
48;2021-01-26;254;0;0;2194;8;0;2.9;0.0;0.0
48;2021-01-27;243;2;0;2437;10;0;3.2;0.0;0.0
48;2021-01-28;220;10;0;2657;20;0;3.5;0.0;0.0
48;2021-01-29;180;59;0;2837;79;0;3.7;0.1;0.0
48;2021-01-30;11;7;0;2848;86;0;3.7;0.1;0.0
48;2021-01-31;0;7;0;2848;93;0;3.7;0.1;0.0
48;2021-02-01;89;45;0;2937;138;0;3.8;0.2;0.0
48;2021-02-02;191;38;0;3128;176;0;4.1;0.2;0.0
48;2021-02-03;186;73;0;3314;249;0;4.3;0.3;0.0
48;2021-02-04;211;14;0;3525;263;0;4.6;0.3;0.0
48;2021-02-05;150;40;0;3675;303;0;4.8;0.4;0.0
48;2021-02-06;31;1;0;3706;304;0;4.9;0.4;0.0
48;2021-02-07;0;0;0;3706;304;0;4.9;0.4;0.0
48;2021-02-08;49;60;0;3755;364;0;4.9;0.5;0.0
48;2021-02-09;84;135;0;3839;499;0;5.0;0.7;0.0
48;2021-02-10;85;183;0;3924;682;0;5.1;0.9;0.0
48;2021-02-11;153;371;0;4077;1053;0;5.3;1.4;0.0
48;2021-02-12;125;148;0;4202;1201;0;5.5;1.6;0.0
48;2021-02-13;20;54;0;4222;1255;0;5.5;1.6;0.0
48;2021-02-14;0;0;0;4222;1255;0;5.5;1.6;0.0
48;2021-02-15;57;103;0;4279;1358;0;5.6;1.8;0.0
48;2021-02-16;65;150;0;4344;1508;0;5.7;2.0;0.0
48;2021-02-17;58;217;0;4402;1725;0;5.8;2.3;0.0
48;2021-02-18;221;118;0;4623;1843;0;6.1;2.4;0.0
48;2021-02-19;81;178;0;4704;2021;0;6.2;2.6;0.0
48;2021-02-20;1;5;0;4705;2026;0;6.2;2.7;0.0
48;2021-02-21;0;14;0;4705;2040;0;6.2;2.7;0.0
48;2021-02-22;29;118;0;4734;2158;0;6.2;2.8;0.0
48;2021-02-23;52;225;0;4786;2383;0;6.3;3.1;0.0
48;2021-02-24;66;284;0;4852;2667;0;6.4;3.5;0.0
48;2021-02-25;143;239;0;4995;2906;0;6.5;3.8;0.0
48;2021-02-26;57;228;0;5052;3134;0;6.6;4.1;0.0
48;2021-02-27;28;4;0;5080;3138;0;6.7;4.1;0.0
48;2021-02-28;3;13;0;5083;3151;0;6.7;4.1;0.0
48;2021-03-01;108;98;0;5191;3249;0;6.8;4.3;0.0
48;2021-03-02;198;90;0;5389;3339;0;7.1;4.4;0.0
48;2021-03-03;152;109;0;5541;3448;0;7.3;4.5;0.0
48;2021-03-04;211;176;0;5752;3624;0;7.5;4.8;0.0
48;2021-03-05;156;133;0;5908;3757;0;7.7;4.9;0.0
48;2021-03-06;200;53;0;6108;3810;0;8.0;5.0;0.0
48;2021-03-07;57;1;0;6165;3811;0;8.1;5.0;0.0
48;2021-03-08;244;115;0;6409;3926;0;8.4;5.1;0.0
48;2021-03-09;355;95;0;6764;4021;0;8.9;5.3;0.0
48;2021-03-10;228;60;0;6992;4081;0;9.2;5.3;0.0
48;2021-03-11;320;88;0;7312;4169;0;9.6;5.5;0.0
48;2021-03-12;271;131;0;7583;4300;0;9.9;5.6;0.0
48;2021-03-13;311;10;0;7894;4310;0;10.3;5.6;0.0
48;2021-03-14;9;0;0;7903;4310;0;10.4;5.6;0.0
48;2021-03-15;173;68;0;8076;4378;0;10.6;5.7;0.0
48;2021-03-16;179;70;0;8255;4448;0;10.8;5.8;0.0
48;2021-03-17;176;103;0;8431;4551;0;11.1;6.0;0.0
48;2021-03-18;178;97;0;8609;4648;0;11.3;6.1;0.0
48;2021-03-19;140;87;0;8749;4735;0;11.5;6.2;0.0
48;2021-03-20;141;5;0;8890;4740;0;11.7;6.2;0.0
48;2021-03-21;2;0;0;8892;4740;0;11.7;6.2;0.0
48;2021-03-22;172;23;0;9064;4763;0;11.9;6.2;0.0
48;2021-03-23;341;98;0;9405;4861;0;12.3;6.4;0.0
48;2021-03-24;363;99;0;9768;4960;0;12.8;6.5;0.0
48;2021-03-25;731;115;0;10499;5075;0;13.8;6.7;0.0
48;2021-03-26;291;65;0;10790;5140;0;14.1;6.7;0.0
48;2021-03-27;108;2;0;10898;5142;0;14.3;6.7;0.0
48;2021-03-28;69;12;0;10967;5154;0;14.4;6.8;0.0
48;2021-03-29;310;85;0;11277;5239;0;14.8;6.9;0.0
48;2021-03-30;361;151;0;11638;5390;0;15.3;7.1;0.0
48;2021-03-31;484;96;0;12122;5486;0;15.9;7.2;0.0
48;2021-04-01;736;85;0;12858;5571;0;16.9;7.3;0.0
48;2021-04-02;508;133;0;13366;5704;0;17.5;7.5;0.0
48;2021-04-03;153;93;0;13519;5797;0;17.7;7.6;0.0
48;2021-04-04;2;1;0;13521;5798;0;17.7;7.6;0.0
48;2021-04-05;54;1;0;13575;5799;0;17.8;7.6;0.0
48;2021-04-06;473;165;0;14048;5964;0;18.4;7.8;0.0
48;2021-04-07;435;146;0;14483;6110;0;19.0;8.0;0.0
48;2021-04-08;628;188;0;15111;6298;0;19.8;8.3;0.0
48;2021-04-09;470;138;0;15581;6436;0;20.4;8.4;0.0
48;2021-04-10;127;71;0;15708;6507;0;20.6;8.5;0.0
48;2021-04-11;3;0;0;15711;6507;0;20.6;8.5;0.0
48;2021-04-12;389;79;0;16100;6586;0;21.1;8.6;0.0
48;2021-04-13;358;120;0;16458;6706;0;21.6;8.8;0.0
48;2021-04-14;594;207;0;17052;6913;0;22.4;9.1;0.0
48;2021-04-15;638;352;0;17690;7265;0;23.2;9.5;0.0
48;2021-04-16;489;210;0;18179;7475;0;23.8;9.8;0.0
48;2021-04-17;92;83;0;18271;7558;0;24.0;9.9;0.0
48;2021-04-18;4;0;0;18275;7558;0;24.0;9.9;0.0
48;2021-04-19;223;110;0;18498;7668;0;24.2;10.1;0.0
48;2021-04-20;224;203;0;18722;7871;0;24.5;10.3;0.0
48;2021-04-21;302;280;0;19024;8151;0;24.9;10.7;0.0
48;2021-04-22;302;485;0;19326;8636;0;25.3;11.3;0.0
48;2021-04-23;251;274;0;19577;8910;0;25.7;11.7;0.0
48;2021-04-24;117;104;0;19694;9014;0;25.8;11.8;0.0
48;2021-04-25;6;13;0;19700;9027;0;25.8;11.8;0.0
48;2021-04-26;129;237;0;19829;9264;0;26.0;12.1;0.0
48;2021-04-27;200;309;0;20029;9573;0;26.3;12.5;0.0
48;2021-04-28;171;446;0;20200;10019;0;26.5;13.1;0.0
48;2021-04-29;220;509;0;20420;10528;0;26.8;13.8;0.0
48;2021-04-30;206;259;0;20626;10787;0;27.0;14.1;0.0
48;2021-05-01;75;9;0;20701;10796;0;27.1;14.2;0.0
48;2021-05-02;1;0;0;20702;10796;0;27.1;14.2;0.0
48;2021-05-03;136;400;0;20838;11196;0;27.3;14.7;0.0
48;2021-05-04;223;410;0;21061;11606;0;27.6;15.2;0.0
48;2021-05-05;119;494;0;21180;12100;0;27.8;15.9;0.0
48;2021-05-06;751;613;0;21931;12713;0;28.7;16.7;0.0
48;2021-05-07;141;511;0;22072;13224;0;28.9;17.3;0.0
48;2021-05-08;325;51;0;22397;13275;0;29.4;17.4;0.0
48;2021-05-09;262;11;0;22659;13286;0;29.7;17.4;0.0
48;2021-05-10;137;349;0;22796;13635;0;29.9;17.9;0.0
48;2021-05-11;259;294;0;23055;13929;0;30.2;18.3;0.0
48;2021-05-12;308;299;0;23363;14228;0;30.6;18.7;0.0
48;2021-05-13;452;155;0;23815;14383;0;31.2;18.9;0.0
48;2021-05-14;283;242;0;24098;14625;0;31.6;19.2;0.0
48;2021-05-15;143;59;0;24241;14684;0;31.8;19.2;0.0
48;2021-05-16;30;7;0;24271;14691;0;31.8;19.3;0.0
48;2021-05-17;490;270;0;24761;14961;0;32.5;19.6;0.0
48;2021-05-18;318;256;0;25079;15217;0;32.9;19.9;0.0
48;2021-05-19;294;304;0;25373;15521;0;33.3;20.3;0.0
48;2021-05-20;400;265;0;25773;15786;0;33.8;20.7;0.0
48;2021-05-21;238;276;0;26011;16062;0;34.1;21.1;0.0
48;2021-05-22;87;54;0;26098;16116;0;34.2;21.1;0.0
48;2021-05-23;7;7;0;26105;16123;0;34.2;21.1;0.0
48;2021-05-24;71;24;0;26176;16147;0;34.3;21.2;0.0
48;2021-05-25;247;291;0;26423;16438;0;34.6;21.5;0.0
48;2021-05-26;476;286;0;26899;16724;0;35.3;21.9;0.0
48;2021-05-27;1238;353;0;28137;17077;0;36.9;22.4;0.0
48;2021-05-28;365;335;0;28502;17412;0;37.4;22.8;0.0
48;2021-05-29;204;100;0;28706;17512;0;37.6;23.0;0.0
48;2021-05-30;7;8;0;28713;17520;0;37.6;23.0;0.0
48;2021-05-31;658;222;0;29371;17742;0;38.5;23.3;0.0
48;2021-06-01;316;288;0;29687;18030;0;38.9;23.6;0.0
48;2021-06-02;444;381;0;30131;18411;0;39.5;24.1;0.0
48;2021-06-03;638;379;0;30769;18790;0;40.3;24.6;0.0
48;2021-06-04;324;286;0;31093;19076;0;40.8;25.0;0.0
48;2021-06-05;160;100;0;31253;19176;0;41.0;25.1;0.0
48;2021-06-06;13;1;0;31266;19177;0;41.0;25.1;0.0
48;2021-06-07;397;159;0;31663;19336;0;41.5;25.3;0.0
48;2021-06-08;650;337;0;32313;19673;0;42.4;25.8;0.0
48;2021-06-09;381;232;0;32694;19905;0;42.9;26.1;0.0
48;2021-06-10;927;230;0;33621;20135;0;44.1;26.4;0.0
48;2021-06-11;382;192;0;34003;20327;0;44.6;26.6;0.0
48;2021-06-12;110;80;0;34113;20407;0;44.7;26.8;0.0
48;2021-06-13;12;6;0;34125;20413;0;44.7;26.8;0.0
48;2021-06-14;140;154;0;34265;20567;0;44.9;27.0;0.0
48;2021-06-15;402;393;0;34667;20960;0;45.4;27.5;0.0
48;2021-06-16;253;179;0;34920;21139;0;45.8;27.7;0.0
48;2021-06-17;453;561;0;35373;21700;0;46.4;28.4;0.0
48;2021-06-18;268;319;0;35641;22019;0;46.7;28.9;0.0
48;2021-06-19;65;321;0;35706;22340;0;46.8;29.3;0.0
48;2021-06-20;111;214;0;35817;22554;0;47.0;29.6;0.0
48;2021-06-21;140;226;0;35957;22780;0;47.1;29.9;0.0
48;2021-06-22;246;379;0;36203;23159;0;47.5;30.4;0.0
48;2021-06-23;110;583;0;36313;23742;0;47.6;31.1;0.0
48;2021-06-24;316;557;0;36629;24299;0;48.0;31.9;0.0
48;2021-06-25;130;279;0;36759;24578;0;48.2;32.2;0.0
48;2021-06-26;29;91;0;36788;24669;0;48.2;32.3;0.0
48;2021-06-27;1;20;0;36789;24689;0;48.2;32.4;0.0
48;2021-06-28;91;262;0;36880;24951;0;48.3;32.7;0.0
48;2021-06-29;297;479;0;37177;25430;0;48.7;33.3;0.0
48;2021-06-30;116;530;0;37293;25960;0;48.9;34.0;0.0
48;2021-07-01;192;631;0;37485;26591;0;49.1;34.9;0.0
48;2021-07-02;161;385;0;37646;26976;0;49.3;35.4;0.0
48;2021-07-03;56;146;0;37702;27122;0;49.4;35.6;0.0
48;2021-07-04;10;7;0;37712;27129;0;49.4;35.6;0.0
48;2021-07-05;78;245;0;37790;27374;0;49.5;35.9;0.0
48;2021-07-06;298;626;0;38088;28000;0;49.9;36.7;0.0
48;2021-07-07;210;523;0;38298;28523;0;50.2;37.4;0.0
48;2021-07-08;227;1171;0;38525;29694;0;50.5;38.9;0.0
48;2021-07-09;166;565;0;38691;30259;0;50.7;39.7;0.0
48;2021-07-10;90;212;0;38781;30471;0;50.8;39.9;0.0
48;2021-07-11;2;19;0;38783;30490;0;50.8;40.0;0.0
48;2021-07-12;152;710;0;38935;31200;0;51.0;40.9;0.0
48;2021-07-13;214;464;0;39149;31664;0;51.3;41.5;0.0
48;2021-07-14;152;126;0;39301;31790;0;51.5;41.7;0.0
48;2021-07-15;232;463;0;39533;32253;0;51.8;42.3;0.0
48;2021-07-16;323;372;0;39856;32625;0;52.2;42.8;0.0
48;2021-07-17;180;165;0;40036;32790;0;52.5;43.0;0.0
48;2021-07-18;10;16;0;40046;32806;0;52.5;43.0;0.0
48;2021-07-19;186;324;0;40232;33130;0;52.7;43.4;0.0
48;2021-07-20;696;1003;0;40928;34133;0;53.7;44.7;0.0
48;2021-07-21;155;341;0;41083;34474;0;53.9;45.2;0.0
48;2021-07-22;750;1009;0;41833;35483;0;54.8;46.5;0.0
48;2021-07-23;432;456;0;42265;35939;0;55.4;47.1;0.0
48;2021-07-24;490;200;0;42755;36139;0;56.0;47.4;0.0
48;2021-07-25;145;51;0;42900;36190;0;56.2;47.4;0.0
48;2021-07-26;238;267;0;43138;36457;0;56.5;47.8;0.0
48;2021-07-27;1094;613;0;44232;37070;0;58.0;48.6;0.0
48;2021-07-28;253;314;0;44485;37384;0;58.3;49.0;0.0
48;2021-07-29;691;594;0;45176;37978;0;59.2;49.8;0.0
48;2021-07-30;290;303;0;45466;38281;0;59.6;50.2;0.0
48;2021-07-31;325;167;0;45791;38448;0;60.0;50.4;0.0
48;2021-08-01;34;37;0;45825;38485;0;60.1;50.4;0.0
48;2021-08-02;262;189;0;46087;38674;0;60.4;50.7;0.0
48;2021-08-03;783;483;0;46870;39157;0;61.4;51.3;0.0
48;2021-08-04;312;185;0;47182;39342;0;61.8;51.6;0.0
48;2021-08-05;528;404;0;47710;39746;0;62.5;52.1;0.0
48;2021-08-06;436;315;0;48146;40061;0;63.1;52.5;0.0
48;2021-08-07;243;132;0;48389;40193;0;63.4;52.7;0.0
48;2021-08-08;11;20;0;48400;40213;0;63.4;52.7;0.0
48;2021-08-09;185;191;0;48585;40404;0;63.7;53.0;0.0
48;2021-08-10;590;477;0;49175;40881;0;64.5;53.6;0.0
48;2021-08-11;276;234;0;49451;41115;0;64.8;53.9;0.0
48;2021-08-12;343;389;0;49794;41504;0;65.3;54.4;0.0
48;2021-08-13;238;267;0;50032;41771;0;65.6;54.8;0.0
48;2021-08-14;130;188;0;50162;41959;0;65.8;55.0;0.0
48;2021-08-15;89;49;0;50251;42008;0;65.9;55.1;0.0
48;2021-08-16;125;271;0;50376;42279;0;66.0;55.4;0.0
48;2021-08-17;310;1072;0;50686;43351;0;66.4;56.8;0.0
48;2021-08-18;177;246;0;50863;43597;0;66.7;57.1;0.0
48;2021-08-19;222;342;0;51085;43939;0;67.0;57.6;0.0
48;2021-08-20;211;300;0;51296;44239;0;67.2;58.0;0.0
48;2021-08-21;75;255;0;51371;44494;0;67.3;58.3;0.0
48;2021-08-22;5;17;0;51376;44511;0;67.3;58.3;0.0
48;2021-08-23;76;241;0;51452;44752;0;67.4;58.7;0.0
48;2021-08-24;281;861;0;51733;45613;0;67.8;59.8;0.0
48;2021-08-25;160;369;0;51893;45982;0;68.0;60.3;0.0
48;2021-08-26;168;439;0;52061;46421;0;68.2;60.9;0.0
48;2021-08-27;148;369;0;52209;46790;0;68.4;61.3;0.0
48;2021-08-28;121;306;0;52330;47096;0;68.6;61.7;0.0
48;2021-08-29;0;6;0;52330;47102;0;68.6;61.7;0.0
48;2021-08-30;71;189;5;52401;47291;5;68.7;62.0;0.0
48;2021-08-31;246;957;15;52647;48248;20;69.0;63.2;0.0
48;2021-09-01;129;345;15;52776;48593;35;69.2;63.7;0.0
48;2021-09-02;132;353;15;52908;48946;50;69.4;64.2;0.1
48;2021-09-03;125;329;30;53033;49275;80;69.5;64.6;0.1
48;2021-09-04;113;204;33;53146;49479;113;69.7;64.9;0.1
48;2021-09-05;7;68;0;53153;49547;113;69.7;64.9;0.1
48;2021-09-06;36;148;18;53189;49695;131;69.7;65.1;0.2
48;2021-09-07;136;319;39;53325;50014;170;69.9;65.6;0.2
48;2021-09-08;94;184;29;53419;50198;199;70.0;65.8;0.3
48;2021-09-09;90;216;63;53509;50414;262;70.1;66.1;0.3
48;2021-09-10;128;252;126;53637;50666;388;70.3;66.4;0.5
48;2021-09-11;89;188;26;53726;50854;414;70.4;66.7;0.5
48;2021-09-12;3;2;1;53729;50856;415;70.4;66.7;0.5
48;2021-09-13;77;79;80;53806;50935;495;70.5;66.8;0.6
48;2021-09-14;157;240;98;53963;51175;593;70.7;67.1;0.8
48;2021-09-15;68;178;60;54031;51353;653;70.8;67.3;0.9
48;2021-09-16;104;193;72;54135;51546;725;71.0;67.6;1.0
48;2021-09-17;103;182;79;54238;51728;804;71.1;67.8;1.1
48;2021-09-18;32;93;13;54270;51821;817;71.1;67.9;1.1
48;2021-09-19;0;2;4;54270;51823;821;71.1;67.9;1.1
48;2021-09-20;36;87;126;54306;51910;947;71.2;68.0;1.2
48;2021-09-21;56;170;135;54362;52080;1082;71.3;68.3;1.4
48;2021-09-22;51;154;57;54413;52234;1139;71.3;68.5;1.5
48;2021-09-23;32;95;58;54445;52329;1197;71.4;68.6;1.6
48;2021-09-24;45;116;80;54490;52445;1277;71.4;68.7;1.7
48;2021-09-25;23;82;15;54513;52527;1292;71.5;68.9;1.7
48;2021-09-26;1;6;0;54514;52533;1292;71.5;68.9;1.7
48;2021-09-27;15;44;59;54529;52577;1351;71.5;68.9;1.8
48;2021-09-28;61;137;156;54590;52714;1507;71.6;69.1;2.0
48;2021-09-29;48;124;69;54638;52838;1576;71.6;69.3;2.1
48;2021-09-30;29;81;127;54667;52919;1703;71.7;69.4;2.2
48;2021-10-01;53;128;78;54720;53047;1781;71.7;69.5;2.3
48;2021-10-02;34;50;27;54754;53097;1808;71.8;69.6;2.4
48;2021-10-03;0;1;0;54754;53098;1808;71.8;69.6;2.4
48;2021-10-04;14;63;36;54768;53161;1844;71.8;69.7;2.4
48;2021-10-05;42;119;59;54810;53280;1903;71.8;69.8;2.5
48;2021-10-06;57;82;196;54867;53362;2099;71.9;69.9;2.8
48;2021-10-07;29;99;162;54896;53461;2261;72.0;70.1;3.0
48;2021-10-08;42;128;114;54938;53589;2375;72.0;70.2;3.1
48;2021-10-09;16;64;42;54954;53653;2417;72.0;70.3;3.2
48;2021-10-10;0;1;0;54954;53654;2417;72.0;70.3;3.2
48;2021-10-11;7;28;55;54961;53682;2472;72.0;70.4;3.2
48;2021-10-12;24;70;126;54985;53752;2598;72.1;70.5;3.4
48;2021-10-13;37;86;146;55022;53838;2744;72.1;70.6;3.6
48;2021-10-14;39;60;75;55061;53898;2819;72.2;70.7;3.7
48;2021-10-15;28;50;148;55089;53948;2967;72.2;70.7;3.9
48;2021-10-16;10;19;27;55099;53967;2994;72.2;70.7;3.9
48;2021-10-17;3;3;3;55102;53970;2997;72.2;70.7;3.9
48;2021-10-18;9;20;83;55111;53990;3080;72.2;70.8;4.0
48;2021-10-19;33;49;121;55144;54039;3201;72.3;70.8;4.2
48;2021-10-20;43;43;168;55187;54082;3369;72.3;70.9;4.4
48;2021-10-21;17;38;178;55204;54120;3547;72.4;70.9;4.6
48;2021-10-22;30;63;130;55234;54183;3677;72.4;71.0;4.8
48;2021-10-23;26;30;42;55260;54213;3719;72.4;71.1;4.9
48;2021-10-24;0;0;0;55260;54213;3719;72.4;71.1;4.9
48;2021-10-25;16;16;79;55276;54229;3798;72.5;71.1;5.0
48;2021-10-26;35;38;145;55311;54267;3943;72.5;71.1;5.2
48;2021-10-27;36;66;199;55347;54333;4142;72.6;71.2;5.4
48;2021-10-28;31;29;294;55378;54362;4436;72.6;71.3;5.8
48;2021-10-29;21;28;148;55399;54390;4584;72.6;71.3;6.0
48;2021-10-30;7;18;30;55406;54408;4614;72.6;71.3;6.0
48;2021-10-31;0;2;0;55406;54410;4614;72.6;71.3;6.0
48;2021-11-01;3;1;2;55409;54411;4616;72.6;71.3;6.1
48;2021-11-02;27;32;124;55436;54443;4740;72.7;71.4;6.2
48;2021-11-03;20;38;142;55456;54481;4882;72.7;71.4;6.4
48;2021-11-04;28;36;165;55484;54517;5047;72.7;71.5;6.6
48;2021-11-05;15;25;119;55499;54542;5166;72.8;71.5;6.8
48;2021-11-06;16;19;66;55515;54561;5232;72.8;71.5;6.9
48;2021-11-07;2;1;0;55517;54562;5232;72.8;71.5;6.9
48;2021-11-08;7;17;53;55524;54579;5285;72.8;71.5;6.9
48;2021-11-09;37;55;277;55561;54634;5562;72.8;71.6;7.3
48;2021-11-10;25;52;305;55586;54686;5867;72.9;71.7;7.7
48;2021-11-11;1;4;41;55587;54690;5908;72.9;71.7;7.7
48;2021-11-12;17;41;220;55604;54731;6128;72.9;71.7;8.0
48;2021-11-13;14;20;74;55618;54751;6202;72.9;71.8;8.1
48;2021-11-14;0;0;3;55618;54751;6205;72.9;71.8;8.1
48;2021-11-15;7;10;154;55625;54761;6359;72.9;71.8;8.3
48;2021-11-16;29;36;367;55654;54797;6726;73.0;71.8;8.8
48;2021-11-17;24;30;348;55678;54827;7074;73.0;71.9;9.3
48;2021-11-18;20;29;440;55698;54856;7514;73.0;71.9;9.8
48;2021-11-19;25;28;318;55723;54884;7832;73.0;71.9;10.3
48;2021-11-20;33;16;118;55756;54900;7950;73.1;72.0;10.4
48;2021-11-21;0;1;1;55756;54901;7951;73.1;72.0;10.4
48;2021-11-22;7;11;235;55763;54912;8186;73.1;72.0;10.7
48;2021-11-23;34;20;321;55797;54932;8507;73.1;72.0;11.2
48;2021-11-24;36;31;322;55833;54963;8829;73.2;72.0;11.6
48;2021-11-25;27;27;441;55860;54990;9270;73.2;72.1;12.2
48;2021-11-26;35;27;498;55895;55017;9768;73.3;72.1;12.8
48;2021-11-27;28;23;295;55923;55040;10063;73.3;72.1;13.2
48;2021-11-28;1;1;6;55924;55041;10069;73.3;72.2;13.2
48;2021-11-29;15;7;473;55939;55048;10542;73.3;72.2;13.8
48;2021-11-30;20;38;512;55959;55086;11054;73.4;72.2;14.5
48;2021-12-01;22;28;410;55981;55114;11464;73.4;72.2;15.0
48;2021-12-02;12;21;442;55993;55135;11906;73.4;72.3;15.6
48;2021-12-03;35;23;662;56028;55158;12568;73.4;72.3;16.5
48;2021-12-04;21;25;358;56049;55183;12926;73.5;72.3;16.9
48;2021-12-05;2;1;10;56051;55184;12936;73.5;72.3;17.0
48;2021-12-06;13;17;590;56064;55201;13526;73.5;72.4;17.7
48;2021-12-07;22;17;872;56086;55218;14398;73.5;72.4;18.9
48;2021-12-08;29;29;632;56115;55247;15030;73.6;72.4;19.7
48;2021-12-09;18;20;671;56133;55267;15701;73.6;72.4;20.6
48;2021-12-10;28;50;998;56161;55317;16699;73.6;72.5;21.9
48;2021-12-11;30;38;636;56191;55355;17335;73.7;72.6;22.7
48;2021-12-12;1;0;20;56192;55355;17355;73.7;72.6;22.7
48;2021-12-13;21;19;718;56213;55374;18073;73.7;72.6;23.7
48;2021-12-14;35;33;960;56248;55407;19033;73.7;72.6;24.9
48;2021-12-15;39;31;692;56287;55438;19725;73.8;72.7;25.9
48;2021-12-16;24;25;662;56311;55463;20387;73.8;72.7;26.7
49;2020-12-27;1;0;0;1;0;0;0.0;0.0;0.0
49;2020-12-28;1;0;0;2;0;0;0.0;0.0;0.0
49;2020-12-29;0;0;0;2;0;0;0.0;0.0;0.0
49;2020-12-30;0;0;0;2;0;0;0.0;0.0;0.0
49;2020-12-31;0;0;0;2;0;0;0.0;0.0;0.0
49;2021-01-01;2;0;0;4;0;0;0.0;0.0;0.0
49;2021-01-02;1;1;0;5;1;0;0.0;0.0;0.0
49;2021-01-03;0;0;0;5;1;0;0.0;0.0;0.0
49;2021-01-04;9;0;0;14;1;0;0.0;0.0;0.0
49;2021-01-05;66;0;0;80;1;0;0.0;0.0;0.0
49;2021-01-06;200;0;0;280;1;0;0.0;0.0;0.0
49;2021-01-07;350;1;0;630;2;0;0.1;0.0;0.0
49;2021-01-08;316;1;0;946;3;0;0.1;0.0;0.0
49;2021-01-09;123;0;0;1069;3;0;0.1;0.0;0.0
49;2021-01-10;113;0;0;1182;3;0;0.1;0.0;0.0
49;2021-01-11;297;0;0;1479;3;0;0.2;0.0;0.0
49;2021-01-12;596;2;0;2075;5;0;0.3;0.0;0.0
49;2021-01-13;603;2;0;2678;7;0;0.3;0.0;0.0
49;2021-01-14;611;9;0;3289;16;0;0.4;0.0;0.0
49;2021-01-15;740;1;0;4029;17;0;0.5;0.0;0.0
49;2021-01-16;145;0;0;4174;17;0;0.5;0.0;0.0
49;2021-01-17;112;2;0;4286;19;0;0.5;0.0;0.0
49;2021-01-18;683;0;0;4969;19;0;0.6;0.0;0.0
49;2021-01-19;1237;7;0;6206;26;0;0.8;0.0;0.0
49;2021-01-20;1505;6;0;7711;32;0;0.9;0.0;0.0
49;2021-01-21;1950;12;0;9661;44;0;1.2;0.0;0.0
49;2021-01-22;1308;5;0;10969;49;0;1.3;0.0;0.0
49;2021-01-23;268;2;0;11237;51;0;1.4;0.0;0.0
49;2021-01-24;0;0;0;11237;51;0;1.4;0.0;0.0
49;2021-01-25;577;5;0;11814;56;0;1.4;0.0;0.0
49;2021-01-26;1018;55;0;12832;111;0;1.6;0.0;0.0
49;2021-01-27;1834;46;0;14666;157;0;1.8;0.0;0.0
49;2021-01-28;2813;81;0;17479;238;0;2.1;0.0;0.0
49;2021-01-29;1638;97;0;19117;335;0;2.3;0.0;0.0
49;2021-01-30;294;47;0;19411;382;0;2.4;0.0;0.0
49;2021-01-31;52;52;0;19463;434;0;2.4;0.1;0.0
49;2021-02-01;662;168;0;20125;602;0;2.5;0.1;0.0
49;2021-02-02;747;348;0;20872;950;0;2.6;0.1;0.0
49;2021-02-03;714;367;0;21586;1317;0;2.6;0.2;0.0
49;2021-02-04;781;444;0;22367;1761;0;2.7;0.2;0.0
49;2021-02-05;743;572;0;23110;2333;0;2.8;0.3;0.0
49;2021-02-06;234;108;0;23344;2441;0;2.9;0.3;0.0
49;2021-02-07;66;83;0;23410;2524;0;2.9;0.3;0.0
49;2021-02-08;542;474;0;23952;2998;0;2.9;0.4;0.0
49;2021-02-09;765;661;0;24717;3659;0;3.0;0.4;0.0
49;2021-02-10;846;945;0;25563;4604;0;3.1;0.6;0.0
49;2021-02-11;1066;1415;0;26629;6019;0;3.3;0.7;0.0
49;2021-02-12;877;987;0;27506;7006;0;3.4;0.9;0.0
49;2021-02-13;261;129;0;27767;7135;0;3.4;0.9;0.0
49;2021-02-14;9;90;0;27776;7225;0;3.4;0.9;0.0
49;2021-02-15;704;688;0;28480;7913;0;3.5;1.0;0.0
49;2021-02-16;1126;1076;0;29606;8989;0;3.6;1.1;0.0
49;2021-02-17;1126;1856;0;30732;10845;0;3.8;1.3;0.0
49;2021-02-18;1792;2340;0;32524;13185;0;4.0;1.6;0.0
49;2021-02-19;1344;1160;0;33868;14345;0;4.2;1.8;0.0
49;2021-02-20;218;370;0;34086;14715;0;4.2;1.8;0.0
49;2021-02-21;1;59;0;34087;14774;0;4.2;1.8;0.0
49;2021-02-22;624;613;0;34711;15387;0;4.3;1.9;0.0
49;2021-02-23;711;850;0;35422;16237;0;4.3;2.0;0.0
49;2021-02-24;818;687;0;36240;16924;0;4.4;2.1;0.0
49;2021-02-25;1194;853;0;37434;17777;0;4.6;2.2;0.0
49;2021-02-26;1606;838;0;39040;18615;0;4.8;2.3;0.0
49;2021-02-27;421;287;0;39461;18902;0;4.8;2.3;0.0
49;2021-02-28;46;33;0;39507;18935;0;4.8;2.3;0.0
49;2021-03-01;750;620;0;40257;19555;0;4.9;2.4;0.0
49;2021-03-02;1055;726;0;41312;20281;0;5.1;2.5;0.0
49;2021-03-03;1512;723;0;42824;21004;0;5.2;2.6;0.0
49;2021-03-04;1755;968;0;44579;21972;0;5.5;2.7;0.0
49;2021-03-05;2226;740;0;46805;22712;0;5.7;2.8;0.0
49;2021-03-06;731;199;0;47536;22911;0;5.8;2.8;0.0
49;2021-03-07;639;15;0;48175;22926;0;5.9;2.8;0.0
49;2021-03-08;1406;717;0;49581;23643;0;6.1;2.9;0.0
49;2021-03-09;2019;755;0;51600;24398;0;6.3;3.0;0.0
49;2021-03-10;2454;923;0;54054;25321;0;6.6;3.1;0.0
49;2021-03-11;3129;1553;0;57183;26874;0;7.0;3.3;0.0
49;2021-03-12;3687;1011;0;60870;27885;0;7.5;3.4;0.0
49;2021-03-13;1511;214;0;62381;28099;0;7.6;3.4;0.0
49;2021-03-14;13;2;0;62394;28101;0;7.6;3.4;0.0
49;2021-03-15;2079;533;0;64473;28634;0;7.9;3.5;0.0
49;2021-03-16;1700;960;0;66173;29594;0;8.1;3.6;0.0
49;2021-03-17;1757;681;0;67930;30275;0;8.3;3.7;0.0
49;2021-03-18;2183;716;0;70113;30991;0;8.6;3.8;0.0
49;2021-03-19;3302;563;0;73415;31554;0;9.0;3.9;0.0
49;2021-03-20;1710;211;0;75125;31765;0;9.2;3.9;0.0
49;2021-03-21;488;21;0;75613;31786;0;9.3;3.9;0.0
49;2021-03-22;2211;554;0;77824;32340;0;9.5;4.0;0.0
49;2021-03-23;3371;663;0;81195;33003;0;10.0;4.0;0.0
49;2021-03-24;3493;480;0;84688;33483;0;10.4;4.1;0.0
49;2021-03-25;4201;647;0;88889;34130;0;10.9;4.2;0.0
49;2021-03-26;4790;505;0;93679;34635;0;11.5;4.2;0.0
49;2021-03-27;1695;109;0;95374;34744;0;11.7;4.3;0.0
49;2021-03-28;380;26;0;95754;34770;0;11.7;4.3;0.0
49;2021-03-29;2474;606;0;98228;35376;0;12.0;4.3;0.0
49;2021-03-30;3340;932;0;101568;36308;0;12.4;4.5;0.0
49;2021-03-31;3005;757;0;104573;37065;0;12.8;4.5;0.0
49;2021-04-01;4114;882;0;108687;37947;0;13.3;4.7;0.0
49;2021-04-02;4276;961;0;112963;38908;0;13.8;4.8;0.0
49;2021-04-03;986;206;0;113949;39114;0;14.0;4.8;0.0
49;2021-04-04;328;6;0;114277;39120;0;14.0;4.8;0.0
49;2021-04-05;899;28;0;115176;39148;0;14.1;4.8;0.0
49;2021-04-06;2442;1327;0;117618;40475;0;14.4;5.0;0.0
49;2021-04-07;3354;1383;0;120972;41858;0;14.8;5.1;0.0
49;2021-04-08;5131;1404;0;126103;43262;0;15.5;5.3;0.0
49;2021-04-09;6183;1423;0;132286;44685;0;16.2;5.5;0.0
49;2021-04-10;2020;501;0;134306;45186;0;16.5;5.5;0.0
49;2021-04-11;389;12;0;134695;45198;0;16.5;5.5;0.0
49;2021-04-12;3983;1543;0;138678;46741;0;17.0;5.7;0.0
49;2021-04-13;5210;1885;0;143888;48626;0;17.6;6.0;0.0
49;2021-04-14;4338;1856;0;148226;50482;0;18.2;6.2;0.0
49;2021-04-15;5113;1880;0;153339;52362;0;18.8;6.4;0.0
49;2021-04-16;5383;2148;0;158722;54510;0;19.5;6.7;0.0
49;2021-04-17;2976;816;0;161698;55326;0;19.8;6.8;0.0
49;2021-04-18;386;468;0;162084;55794;0;19.9;6.8;0.0
49;2021-04-19;3418;2023;0;165502;57817;0;20.3;7.1;0.0
49;2021-04-20;4058;2076;0;169560;59893;0;20.8;7.3;0.0
49;2021-04-21;3562;2127;0;173122;62020;0;21.2;7.6;0.0
49;2021-04-22;4493;2102;0;177615;64122;0;21.8;7.9;0.0
49;2021-04-23;4384;2282;0;181999;66404;0;22.3;8.1;0.0
49;2021-04-24;2612;1190;0;184611;67594;0;22.6;8.3;0.0
49;2021-04-25;59;294;0;184670;67888;0;22.6;8.3;0.0
49;2021-04-26;3399;2179;0;188069;70067;0;23.1;8.6;0.0
49;2021-04-27;4000;2546;0;192069;72613;0;23.5;8.9;0.0
49;2021-04-28;4130;2455;0;196199;75068;0;24.0;9.2;0.0
49;2021-04-29;4713;3041;0;200912;78109;0;24.6;9.6;0.0
49;2021-04-30;4993;3118;0;205905;81227;0;25.2;10.0;0.0
49;2021-05-01;2181;669;0;208086;81896;0;25.5;10.0;0.0
49;2021-05-02;45;51;0;208131;81947;0;25.5;10.0;0.0
49;2021-05-03;4560;2348;0;212691;84295;0;26.1;10.3;0.0
49;2021-05-04;4615;3138;0;217306;87433;0;26.6;10.7;0.0
49;2021-05-05;4429;3025;0;221735;90458;0;27.2;11.1;0.0
49;2021-05-06;4902;3098;0;226637;93556;0;27.8;11.5;0.0
49;2021-05-07;4008;4955;0;230645;98511;0;28.3;12.1;0.0
49;2021-05-08;3373;477;0;234018;98988;0;28.7;12.1;0.0
49;2021-05-09;58;67;0;234076;99055;0;28.7;12.1;0.0
49;2021-05-10;4426;4031;0;238502;103086;0;29.2;12.6;0.0
49;2021-05-11;4991;4772;0;243493;107858;0;29.8;13.2;0.0
49;2021-05-12;4390;4307;0;247883;112165;0;30.4;13.7;0.0
49;2021-05-13;4439;650;0;252322;112815;0;30.9;13.8;0.0
49;2021-05-14;4605;3063;0;256927;115878;0;31.5;14.2;0.0
49;2021-05-15;3735;1649;0;260662;117527;0;31.9;14.4;0.0
49;2021-05-16;2399;92;0;263061;117619;0;32.2;14.4;0.0
49;2021-05-17;4399;3336;0;267460;120955;0;32.8;14.8;0.0
49;2021-05-18;4850;3529;0;272310;124484;0;33.4;15.3;0.0
49;2021-05-19;5174;2979;0;277484;127463;0;34.0;15.6;0.0
49;2021-05-20;5980;2757;0;283464;130220;0;34.7;16.0;0.0
49;2021-05-21;5797;3393;0;289261;133613;0;35.5;16.4;0.0
49;2021-05-22;4454;1125;0;293715;134738;0;36.0;16.5;0.0
49;2021-05-23;73;16;0;293788;134754;0;36.0;16.5;0.0
49;2021-05-24;3786;401;0;297574;135155;0;36.5;16.6;0.0
49;2021-05-25;5576;3166;0;303150;138321;0;37.2;17.0;0.0
49;2021-05-26;5481;2513;0;308631;140834;0;37.8;17.3;0.0
49;2021-05-27;6191;2637;0;314822;143471;0;38.6;17.6;0.0
49;2021-05-28;6156;3794;0;320978;147265;0;39.3;18.0;0.0
49;2021-05-29;4286;1743;0;325264;149008;0;39.9;18.3;0.0
49;2021-05-30;119;32;0;325383;149040;0;39.9;18.3;0.0
49;2021-05-31;5361;2903;0;330744;151943;0;40.5;18.6;0.0
49;2021-06-01;5981;3732;0;336725;155675;0;41.3;19.1;0.0
49;2021-06-02;5254;3449;0;341979;159124;0;41.9;19.5;0.0
49;2021-06-03;5947;3310;0;347926;162434;0;42.6;19.9;0.0
49;2021-06-04;6008;4585;0;353934;167019;0;43.4;20.5;0.0
49;2021-06-05;4060;2477;0;357994;169496;0;43.9;20.8;0.0
49;2021-06-06;193;73;0;358187;169569;0;43.9;20.8;0.0
49;2021-06-07;4287;4299;0;362474;173868;0;44.4;21.3;0.0
49;2021-06-08;5000;4653;0;367474;178521;0;45.0;21.9;0.0
49;2021-06-09;4993;4102;0;372467;182623;0;45.7;22.4;0.0
49;2021-06-10;5671;3672;0;378138;186295;0;46.3;22.8;0.0
49;2021-06-11;4677;5643;0;382815;191938;0;46.9;23.5;0.0
49;2021-06-12;3711;2926;0;386526;194864;0;47.4;23.9;0.0
49;2021-06-13;130;787;0;386656;195651;0;47.4;24.0;0.0
49;2021-06-14;3367;5530;0;390023;201181;0;47.8;24.7;0.0
49;2021-06-15;4169;5966;0;394192;207147;0;48.3;25.4;0.0
49;2021-06-16;4087;5429;0;398279;212576;0;48.8;26.1;0.0
49;2021-06-17;4868;4970;0;403147;217546;0;49.4;26.7;0.0
49;2021-06-18;4017;6467;0;407164;224013;0;49.9;27.5;0.0
49;2021-06-19;3329;3672;0;410493;227685;0;50.3;27.9;0.0
49;2021-06-20;76;72;0;410569;227757;0;50.3;27.9;0.0
49;2021-06-21;2768;6025;0;413337;233782;0;50.7;28.7;0.0
49;2021-06-22;3132;6576;0;416469;240358;0;51.0;29.5;0.0
49;2021-06-23;3072;5907;0;419541;246265;0;51.4;30.2;0.0
49;2021-06-24;4135;4730;0;423676;250995;0;51.9;30.8;0.0
49;2021-06-25;3239;6906;0;426915;257901;0;52.3;31.6;0.0
49;2021-06-26;2433;4191;0;429348;262092;0;52.6;32.1;0.0
49;2021-06-27;39;1480;0;429387;263572;0;52.6;32.3;0.0
49;2021-06-28;2131;6629;0;431518;270201;0;52.9;33.1;0.0
49;2021-06-29;2848;6775;0;434366;276976;0;53.2;33.9;0.0
49;2021-06-30;2736;6334;0;437102;283310;0;53.6;34.7;0.0
49;2021-07-01;3087;6087;0;440189;289397;0;54.0;35.5;0.0
49;2021-07-02;2889;7577;0;443078;296974;0;54.3;36.4;0.0
49;2021-07-03;1970;5000;0;445048;301974;0;54.5;37.0;0.0
49;2021-07-04;49;157;0;445097;302131;0;54.6;37.0;0.0
49;2021-07-05;1695;6547;0;446792;308678;0;54.8;37.8;0.0
49;2021-07-06;2074;7171;1;448866;315849;1;55.0;38.7;0.0
49;2021-07-07;2204;6175;0;451070;322024;1;55.3;39.5;0.0
49;2021-07-08;2692;6104;0;453762;328128;1;55.6;40.2;0.0
49;2021-07-09;2500;7851;0;456262;335979;1;55.9;41.2;0.0
49;2021-07-10;1943;4923;0;458205;340902;1;56.2;41.8;0.0
49;2021-07-11;62;125;0;458267;341027;1;56.2;41.8;0.0
49;2021-07-12;2054;7228;0;460321;348255;1;56.4;42.7;0.0
49;2021-07-13;2743;7970;0;463064;356225;1;56.8;43.7;0.0
49;2021-07-14;2827;3301;0;465891;359526;1;57.1;44.1;0.0
49;2021-07-15;3377;7251;0;469268;366777;1;57.5;45.0;0.0
49;2021-07-16;3610;7988;0;472878;374765;1;58.0;45.9;0.0
49;2021-07-17;2162;5121;0;475040;379886;1;58.2;46.6;0.0
49;2021-07-18;3174;576;0;478214;380462;1;58.6;46.6;0.0
49;2021-07-19;2633;7121;0;480847;387583;1;58.9;47.5;0.0
49;2021-07-20;3455;7383;0;484302;394966;1;59.4;48.4;0.0
49;2021-07-21;3862;6340;0;488164;401306;1;59.8;49.2;0.0
49;2021-07-22;4425;5927;0;492589;407233;1;60.4;49.9;0.0
49;2021-07-23;4756;6632;0;497345;413865;1;61.0;50.7;0.0
49;2021-07-24;3045;4737;0;500390;418602;1;61.3;51.3;0.0
49;2021-07-25;123;160;0;500513;418762;1;61.3;51.3;0.0
49;2021-07-26;3989;5770;0;504502;424532;1;61.8;52.0;0.0
49;2021-07-27;5607;5400;0;510109;429932;1;62.5;52.7;0.0
49;2021-07-28;5721;4402;0;515830;434334;1;63.2;53.2;0.0
49;2021-07-29;6047;4256;0;521877;438590;1;64.0;53.8;0.0
49;2021-07-30;5801;4825;0;527678;443415;1;64.7;54.3;0.0
49;2021-07-31;3663;3370;0;531341;446785;1;65.1;54.8;0.0
49;2021-08-01;157;77;0;531498;446862;1;65.1;54.8;0.0
49;2021-08-02;4306;4618;0;535804;451480;1;65.7;55.3;0.0
49;2021-08-03;5520;3872;0;541324;455352;1;66.3;55.8;0.0
49;2021-08-04;5241;3725;0;546565;459077;1;67.0;56.3;0.0
49;2021-08-05;5339;3506;0;551904;462583;1;67.6;56.7;0.0
49;2021-08-06;5545;4424;0;557449;467007;1;68.3;57.2;0.0
49;2021-08-07;3591;3024;0;561040;470031;1;68.8;57.6;0.0
49;2021-08-08;90;113;0;561130;470144;1;68.8;57.6;0.0
49;2021-08-09;3530;4719;0;564660;474863;1;69.2;58.2;0.0
49;2021-08-10;4224;3944;0;568884;478807;1;69.7;58.7;0.0
49;2021-08-11;3952;3694;0;572836;482501;1;70.2;59.1;0.0
49;2021-08-12;3072;3267;0;575908;485768;1;70.6;59.5;0.0
49;2021-08-13;3917;4133;0;579825;489901;1;71.1;60.0;0.0
49;2021-08-14;2144;2945;0;581969;492846;1;71.3;60.4;0.0
49;2021-08-15;65;74;0;582034;492920;1;71.3;60.4;0.0
49;2021-08-16;2859;4966;0;584893;497886;1;71.7;61.0;0.0
49;2021-08-17;3181;4826;0;588074;502712;1;72.1;61.6;0.0
49;2021-08-18;2862;4291;0;590936;507003;1;72.4;62.1;0.0
49;2021-08-19;1924;3906;0;592860;510909;1;72.7;62.6;0.0
49;2021-08-20;2739;5498;0;595599;516407;1;73.0;63.3;0.0
49;2021-08-21;1362;3840;0;596961;520247;1;73.2;63.8;0.0
49;2021-08-22;37;168;0;596998;520415;1;73.2;63.8;0.0
49;2021-08-23;2223;5294;0;599221;525709;1;73.4;64.4;0.0
49;2021-08-24;2655;5474;0;601876;531183;1;73.8;65.1;0.0
49;2021-08-25;2291;5227;0;604167;536410;1;74.1;65.7;0.0
49;2021-08-26;1784;4689;1;605951;541099;2;74.3;66.3;0.0
49;2021-08-27;2225;6353;0;608176;547452;2;74.5;67.1;0.0
49;2021-08-28;904;3705;0;609080;551157;2;74.7;67.6;0.0
49;2021-08-29;34;162;0;609114;551319;2;74.7;67.6;0.0
49;2021-08-30;1275;4013;47;610389;555332;49;74.8;68.1;0.0
49;2021-08-31;2136;5533;99;612525;560865;148;75.1;68.7;0.0
49;2021-09-01;1637;3941;235;614162;564806;383;75.3;69.2;0.0
49;2021-09-02;1082;2967;205;615244;567773;588;75.4;69.6;0.1
49;2021-09-03;1411;4023;281;616655;571796;869;75.6;70.1;0.1
49;2021-09-04;1179;3229;127;617834;575025;996;75.7;70.5;0.1
49;2021-09-05;23;44;5;617857;575069;1001;75.7;70.5;0.1
49;2021-09-06;1030;2639;377;618887;577708;1378;75.9;70.8;0.2
49;2021-09-07;1109;2536;385;619996;580244;1763;76.0;71.1;0.2
49;2021-09-08;947;2866;277;620943;583110;2040;76.1;71.5;0.3
49;2021-09-09;742;1734;185;621685;584844;2225;76.2;71.7;0.3
49;2021-09-10;990;2924;251;622675;587768;2476;76.3;72.0;0.3
49;2021-09-11;735;2468;119;623410;590236;2595;76.4;72.3;0.3
49;2021-09-12;16;47;3;623426;590283;2598;76.4;72.3;0.3
49;2021-09-13;724;2020;555;624150;592303;3153;76.5;72.6;0.4
49;2021-09-14;658;1691;687;624808;593994;3840;76.6;72.8;0.5
49;2021-09-15;615;2147;663;625423;596141;4503;76.7;73.1;0.6
49;2021-09-16;544;1348;609;625967;597489;5112;76.7;73.2;0.6
49;2021-09-17;919;2444;632;626886;599933;5744;76.8;73.5;0.7
49;2021-09-18;523;2010;148;627409;601943;5892;76.9;73.8;0.7
49;2021-09-19;8;22;6;627417;601965;5898;76.9;73.8;0.7
49;2021-09-20;500;1248;687;627917;603213;6585;77.0;73.9;0.8
49;2021-09-21;415;1546;799;628332;604759;7384;77.0;74.1;0.9
49;2021-09-22;348;2059;640;628680;606818;8024;77.1;74.4;1.0
49;2021-09-23;299;1094;853;628979;607912;8877;77.1;74.5;1.1
49;2021-09-24;558;2204;930;629537;610116;9807;77.2;74.8;1.2
49;2021-09-25;202;1099;101;629739;611215;9908;77.2;74.9;1.2
49;2021-09-26;4;24;0;629743;611239;9908;77.2;74.9;1.2
49;2021-09-27;355;1314;892;630098;612553;10800;77.2;75.1;1.3
49;2021-09-28;395;1010;740;630493;613563;11540;77.3;75.2;1.4
49;2021-09-29;369;1204;636;630862;614767;12176;77.3;75.4;1.5
49;2021-09-30;332;680;855;631194;615447;13031;77.4;75.4;1.6
49;2021-10-01;526;1500;739;631720;616947;13770;77.4;75.6;1.7
49;2021-10-02;334;1101;163;632054;618048;13933;77.5;75.8;1.7
49;2021-10-03;12;24;4;632066;618072;13937;77.5;75.8;1.7
49;2021-10-04;298;750;688;632364;618822;14625;77.5;75.8;1.8
49;2021-10-05;205;570;753;632569;619392;15378;77.5;75.9;1.9
49;2021-10-06;369;718;672;632938;620110;16050;77.6;76.0;2.0
49;2021-10-07;224;442;801;633162;620552;16851;77.6;76.1;2.1
49;2021-10-08;550;1264;1167;633712;621816;18018;77.7;76.2;2.2
49;2021-10-09;252;657;305;633964;622473;18323;77.7;76.3;2.2
49;2021-10-10;7;11;5;633971;622484;18328;77.7;76.3;2.2
49;2021-10-11;299;662;939;634270;623146;19267;77.7;76.4;2.4
49;2021-10-12;257;345;1147;634527;623491;20414;77.8;76.4;2.5
49;2021-10-13;319;527;1060;634846;624018;21474;77.8;76.5;2.6
49;2021-10-14;222;372;953;635068;624390;22427;77.8;76.5;2.7
49;2021-10-15;450;799;1339;635518;625189;23766;77.9;76.6;2.9
49;2021-10-16;229;398;347;635747;625587;24113;77.9;76.7;3.0
49;2021-10-17;3;12;12;635750;625599;24125;77.9;76.7;3.0
49;2021-10-18;272;315;715;636022;625914;24840;78.0;76.7;3.0
49;2021-10-19;113;338;874;636135;626252;25714;78.0;76.8;3.2
49;2021-10-20;147;322;793;636282;626574;26507;78.0;76.8;3.2
49;2021-10-21;91;240;805;636373;626814;27312;78.0;76.8;3.3
49;2021-10-22;189;651;1627;636562;627465;28939;78.0;76.9;3.5
49;2021-10-23;86;296;338;636648;627761;29277;78.0;76.9;3.6
49;2021-10-24;1;13;12;636649;627774;29289;78.0;76.9;3.6
49;2021-10-25;143;304;878;636792;628078;30167;78.0;77.0;3.7
49;2021-10-26;113;204;809;636905;628282;30976;78.1;77.0;3.8
49;2021-10-27;121;277;988;637026;628559;31964;78.1;77.0;3.9
49;2021-10-28;99;211;979;637125;628770;32943;78.1;77.1;4.0
49;2021-10-29;197;579;1816;637322;629349;34759;78.1;77.1;4.3
49;2021-10-30;62;200;342;637384;629549;35101;78.1;77.2;4.3
49;2021-10-31;4;11;18;637388;629560;35119;78.1;77.2;4.3
49;2021-11-01;4;2;15;637392;629562;35134;78.1;77.2;4.3
49;2021-11-02;153;295;1561;637545;629857;36695;78.1;77.2;4.5
49;2021-11-03;121;289;1582;637666;630146;38277;78.2;77.2;4.7
49;2021-11-04;79;168;1313;637745;630314;39590;78.2;77.3;4.9
49;2021-11-05;181;440;2142;637926;630754;41732;78.2;77.3;5.1
49;2021-11-06;84;188;545;638010;630942;42277;78.2;77.3;5.2
49;2021-11-07;3;20;17;638013;630962;42294;78.2;77.3;5.2
49;2021-11-08;84;272;1933;638097;631234;44227;78.2;77.4;5.4
49;2021-11-09;89;225;2827;638186;631459;47054;78.2;77.4;5.8
49;2021-11-10;160;302;3035;638346;631761;50089;78.2;77.4;6.1
49;2021-11-11;5;4;56;638351;631765;50145;78.2;77.4;6.1
49;2021-11-12;164;285;2910;638515;632050;53055;78.3;77.5;6.5
49;2021-11-13;99;134;818;638614;632184;53873;78.3;77.5;6.6
49;2021-11-14;0;1;19;638614;632185;53892;78.3;77.5;6.6
49;2021-11-15;79;154;2363;638693;632339;56255;78.3;77.5;6.9
49;2021-11-16;82;163;3328;638775;632502;59583;78.3;77.5;7.3
49;2021-11-17;142;207;2929;638917;632709;62512;78.3;77.5;7.7
49;2021-11-18;73;123;2897;638990;632832;65409;78.3;77.6;8.0
49;2021-11-19;178;221;3936;639168;633053;69345;78.3;77.6;8.5
49;2021-11-20;104;83;1109;639272;633136;70454;78.4;77.6;8.6
49;2021-11-21;1;5;12;639273;633141;70466;78.4;77.6;8.6
49;2021-11-22;62;108;2397;639335;633249;72863;78.4;77.6;8.9
49;2021-11-23;138;118;3957;639473;633367;76820;78.4;77.6;9.4
49;2021-11-24;173;189;3489;639646;633556;80309;78.4;77.7;9.8
49;2021-11-25;104;100;3624;639750;633656;83933;78.4;77.7;10.3
49;2021-11-26;208;242;5700;639958;633898;89633;78.4;77.7;11.0
49;2021-11-27;135;148;2475;640093;634046;92108;78.5;77.7;11.3
49;2021-11-28;8;13;791;640101;634059;92899;78.5;77.7;11.4
49;2021-11-29;98;112;4784;640199;634171;97683;78.5;77.7;12.0
49;2021-11-30;137;121;6150;640336;634292;103833;78.5;77.7;12.7
49;2021-12-01;122;137;5942;640458;634429;109775;78.5;77.8;13.5
49;2021-12-02;81;75;5902;640539;634504;115677;78.5;77.8;14.2
49;2021-12-03;150;174;7859;640689;634678;123536;78.5;77.8;15.1
49;2021-12-04;64;111;2923;640753;634789;126459;78.5;77.8;15.5
49;2021-12-05;6;13;790;640759;634802;127249;78.5;77.8;15.6
49;2021-12-06;61;103;7379;640820;634905;134628;78.5;77.8;16.5
49;2021-12-07;112;120;9228;640932;635025;143856;78.6;77.8;17.6
49;2021-12-08;121;183;8005;641053;635208;151861;78.6;77.9;18.6
49;2021-12-09;112;125;9337;641165;635333;161198;78.6;77.9;19.8
49;2021-12-10;112;185;10159;641277;635518;171357;78.6;77.9;21.0
49;2021-12-11;69;147;4502;641346;635665;175859;78.6;77.9;21.6
49;2021-12-12;15;14;1484;641361;635679;177343;78.6;77.9;21.7
49;2021-12-13;69;114;8418;641430;635793;185761;78.6;77.9;22.8
49;2021-12-14;125;172;10515;641555;635965;196276;78.6;77.9;24.1
49;2021-12-15;108;174;9413;641663;636139;205689;78.6;78.0;25.2
49;2021-12-16;88;127;10361;641751;636266;216050;78.7;78.0;26.5
50;2020-12-27;0;0;0;0;0;0;0.0;0.0;0.0
50;2020-12-28;1;0;0;1;0;0;0.0;0.0;0.0
50;2020-12-29;1;0;0;2;0;0;0.0;0.0;0.0
50;2020-12-30;0;0;0;2;0;0;0.0;0.0;0.0
50;2020-12-31;0;0;0;2;0;0;0.0;0.0;0.0
50;2021-01-01;1;0;0;3;0;0;0.0;0.0;0.0
50;2021-01-02;0;0;0;3;0;0;0.0;0.0;0.0
50;2021-01-03;0;0;0;3;0;0;0.0;0.0;0.0
50;2021-01-04;1;0;0;4;0;0;0.0;0.0;0.0
50;2021-01-05;0;0;0;4;0;0;0.0;0.0;0.0
50;2021-01-06;122;0;0;126;0;0;0.0;0.0;0.0
50;2021-01-07;311;0;0;437;0;0;0.1;0.0;0.0
50;2021-01-08;428;2;0;865;2;0;0.2;0.0;0.0
50;2021-01-09;227;0;0;1092;2;0;0.2;0.0;0.0
50;2021-01-10;22;0;0;1114;2;0;0.2;0.0;0.0
50;2021-01-11;368;0;0;1482;2;0;0.3;0.0;0.0
50;2021-01-12;597;0;0;2079;2;0;0.4;0.0;0.0
50;2021-01-13;682;5;0;2761;7;0;0.6;0.0;0.0
50;2021-01-14;979;8;0;3740;15;0;0.8;0.0;0.0
50;2021-01-15;693;5;0;4433;20;0;0.9;0.0;0.0
50;2021-01-16;219;3;0;4652;23;0;0.9;0.0;0.0
50;2021-01-17;9;0;0;4661;23;0;0.9;0.0;0.0
50;2021-01-18;646;1;0;5307;24;0;1.1;0.0;0.0
50;2021-01-19;911;9;0;6218;33;0;1.3;0.0;0.0
50;2021-01-20;968;2;0;7186;35;0;1.5;0.0;0.0
50;2021-01-21;912;3;0;8098;38;0;1.7;0.0;0.0
50;2021-01-22;769;2;0;8867;40;0;1.8;0.0;0.0
50;2021-01-23;658;4;0;9525;44;0;1.9;0.0;0.0
50;2021-01-24;846;3;0;10371;47;0;2.1;0.0;0.0
50;2021-01-25;2577;18;0;12948;65;0;2.6;0.0;0.0
50;2021-01-26;1289;15;0;14237;80;0;2.9;0.0;0.0
50;2021-01-27;750;52;0;14987;132;0;3.1;0.0;0.0
50;2021-01-28;753;166;0;15740;298;0;3.2;0.1;0.0
50;2021-01-29;602;303;0;16342;601;0;3.3;0.1;0.0
50;2021-01-30;375;161;0;16717;762;0;3.4;0.2;0.0
50;2021-01-31;5;0;0;16722;762;0;3.4;0.2;0.0
50;2021-02-01;459;215;0;17181;977;0;3.5;0.2;0.0
50;2021-02-02;463;253;0;17644;1230;0;3.6;0.3;0.0
50;2021-02-03;427;369;0;18071;1599;0;3.7;0.3;0.0
50;2021-02-04;510;456;0;18581;2055;0;3.8;0.4;0.0
50;2021-02-05;448;463;0;19029;2518;0;3.9;0.5;0.0
50;2021-02-06;194;112;0;19223;2630;0;3.9;0.5;0.0
50;2021-02-07;1;5;0;19224;2635;0;3.9;0.5;0.0
50;2021-02-08;284;491;0;19508;3126;0;4.0;0.6;0.0
50;2021-02-09;283;648;0;19791;3774;0;4.0;0.8;0.0
50;2021-02-10;576;564;0;20367;4338;0;4.2;0.9;0.0
50;2021-02-11;484;865;0;20851;5203;0;4.2;1.1;0.0
50;2021-02-12;400;673;0;21251;5876;0;4.3;1.2;0.0
50;2021-02-13;300;445;0;21551;6321;0;4.4;1.3;0.0
50;2021-02-14;180;798;0;21731;7119;0;4.4;1.5;0.0
50;2021-02-15;637;1959;0;22368;9078;0;4.6;1.9;0.0
50;2021-02-16;707;1540;0;23075;10618;0;4.7;2.2;0.0
50;2021-02-17;616;837;0;23691;11455;0;4.8;2.3;0.0
50;2021-02-18;529;839;0;24220;12294;0;4.9;2.5;0.0
50;2021-02-19;639;536;0;24859;12830;0;5.1;2.6;0.0
50;2021-02-20;409;205;0;25268;13035;0;5.1;2.7;0.0
50;2021-02-21;79;30;0;25347;13065;0;5.2;2.7;0.0
50;2021-02-22;305;741;0;25652;13806;0;5.2;2.8;0.0
50;2021-02-23;495;572;0;26147;14378;0;5.3;2.9;0.0
50;2021-02-24;632;562;0;26779;14940;0;5.5;3.0;0.0
50;2021-02-25;797;620;0;27576;15560;0;5.6;3.2;0.0
50;2021-02-26;994;404;0;28570;15964;0;5.8;3.3;0.0
50;2021-02-27;841;120;0;29411;16084;0;6.0;3.3;0.0
50;2021-02-28;102;5;0;29513;16089;0;6.0;3.3;0.0
50;2021-03-01;496;595;0;30009;16684;0;6.1;3.4;0.0
50;2021-03-02;635;547;0;30644;17231;0;6.2;3.5;0.0
50;2021-03-03;795;523;0;31439;17754;0;6.4;3.6;0.0
50;2021-03-04;1257;365;0;32696;18119;0;6.7;3.7;0.0
50;2021-03-05;1559;389;0;34255;18508;0;7.0;3.8;0.0
50;2021-03-06;1323;177;0;35578;18685;0;7.3;3.8;0.0
50;2021-03-07;542;40;0;36120;18725;0;7.4;3.8;0.0
50;2021-03-08;1025;618;0;37145;19343;0;7.6;3.9;0.0
50;2021-03-09;1533;582;0;38678;19925;0;7.9;4.1;0.0
50;2021-03-10;1586;337;0;40264;20262;0;8.2;4.1;0.0
50;2021-03-11;2337;377;0;42601;20639;0;8.7;4.2;0.0
50;2021-03-12;2924;281;0;45525;20920;0;9.3;4.3;0.0
50;2021-03-13;1931;143;0;47456;21063;0;9.7;4.3;0.0
50;2021-03-14;264;39;0;47720;21102;0;9.7;4.3;0.0
50;2021-03-15;1411;310;0;49131;21412;0;10.0;4.4;0.0
50;2021-03-16;1309;283;0;50440;21695;0;10.3;4.4;0.0
50;2021-03-17;1303;408;0;51743;22103;0;10.5;4.5;0.0
50;2021-03-18;1185;422;0;52928;22525;0;10.8;4.6;0.0
50;2021-03-19;1795;588;0;54723;23113;0;11.2;4.7;0.0
50;2021-03-20;1696;224;0;56419;23337;0;11.5;4.8;0.0
50;2021-03-21;776;13;0;57195;23350;0;11.7;4.8;0.0
50;2021-03-22;1514;345;0;58709;23695;0;12.0;4.8;0.0
50;2021-03-23;2064;399;0;60773;24094;0;12.4;4.9;0.0
50;2021-03-24;2283;563;0;63056;24657;0;12.9;5.0;0.0
50;2021-03-25;2844;483;0;65900;25140;0;13.4;5.1;0.0
50;2021-03-26;3247;473;0;69147;25613;0;14.1;5.2;0.0
50;2021-03-27;1724;356;0;70871;25969;0;14.4;5.3;0.0
50;2021-03-28;392;19;0;71263;25988;0;14.5;5.3;0.0
50;2021-03-29;2127;700;0;73390;26688;0;15.0;5.4;0.0
50;2021-03-30;2286;632;0;75676;27320;0;15.4;5.6;0.0
50;2021-03-31;2480;564;0;78156;27884;0;15.9;5.7;0.0
50;2021-04-01;3090;879;0;81246;28763;0;16.6;5.9;0.0
50;2021-04-02;2892;902;0;84138;29665;0;17.1;6.0;0.0
50;2021-04-03;1206;662;0;85344;30327;0;17.4;6.2;0.0
50;2021-04-04;304;132;0;85648;30459;0;17.5;6.2;0.0
50;2021-04-05;384;32;0;86032;30491;0;17.5;6.2;0.0
50;2021-04-06;2067;1193;0;88099;31684;0;18.0;6.5;0.0
50;2021-04-07;2568;1186;0;90667;32870;0;18.5;6.7;0.0
50;2021-04-08;3609;1226;0;94276;34096;0;19.2;6.9;0.0
50;2021-04-09;3854;1291;0;98130;35387;0;20.0;7.2;0.0
50;2021-04-10;2416;850;0;100546;36237;0;20.5;7.4;0.0
50;2021-04-11;383;144;0;100929;36381;0;20.6;7.4;0.0
50;2021-04-12;2404;1392;0;103333;37773;0;21.1;7.7;0.0
50;2021-04-13;2643;1520;0;105976;39293;0;21.6;8.0;0.0
50;2021-04-14;2552;1353;0;108528;40646;0;22.1;8.3;0.0
50;2021-04-15;3084;1152;0;111612;41798;0;22.7;8.5;0.0
50;2021-04-16;3219;1130;0;114831;42928;0;23.4;8.7;0.0
50;2021-04-17;2319;1183;0;117150;44111;0;23.9;9.0;0.0
50;2021-04-18;456;650;0;117606;44761;0;24.0;9.1;0.0
50;2021-04-19;1925;1466;0;119531;46227;0;24.4;9.4;0.0
50;2021-04-20;2179;1557;0;121710;47784;0;24.8;9.7;0.0
50;2021-04-21;2418;1754;0;124128;49538;0;25.3;10.1;0.0
50;2021-04-22;2989;1795;0;127117;51333;0;25.9;10.5;0.0
50;2021-04-23;2655;1933;0;129772;53266;0;26.4;10.9;0.0
50;2021-04-24;1821;1376;0;131593;54642;0;26.8;11.1;0.0
50;2021-04-25;491;269;0;132084;54911;0;26.9;11.2;0.0
50;2021-04-26;2078;1876;0;134162;56787;0;27.3;11.6;0.0
50;2021-04-27;2344;1978;0;136506;58765;0;27.8;12.0;0.0
50;2021-04-28;2568;1970;0;139074;60735;0;28.3;12.4;0.0
50;2021-04-29;3209;2086;0;142283;62821;0;29.0;12.8;0.0
50;2021-04-30;2945;1852;0;145228;64673;0;29.6;13.2;0.0
50;2021-05-01;1000;573;0;146228;65246;0;29.8;13.3;0.0
50;2021-05-02;521;415;0;146749;65661;0;29.9;13.4;0.0
50;2021-05-03;1858;1765;0;148607;67426;0;30.3;13.7;0.0
50;2021-05-04;1827;2265;0;150434;69691;0;30.7;14.2;0.0
50;2021-05-05;1723;2910;0;152157;72601;0;31.0;14.8;0.0
50;2021-05-06;2540;2615;0;154697;75216;0;31.5;15.3;0.0
50;2021-05-07;2242;2850;0;156939;78066;0;32.0;15.9;0.0
50;2021-05-08;1014;781;0;157953;78847;0;32.2;16.1;0.0
50;2021-05-09;625;355;0;158578;79202;0;32.3;16.1;0.0
50;2021-05-10;1789;2551;0;160367;81753;0;32.7;16.7;0.0
50;2021-05-11;2631;2750;0;162998;84503;0;33.2;17.2;0.0
50;2021-05-12;3117;2384;0;166115;86887;0;33.9;17.7;0.0
50;2021-05-13;3264;591;0;169379;87478;0;34.5;17.8;0.0
50;2021-05-14;3512;2204;0;172891;89682;0;35.2;18.3;0.0
50;2021-05-15;3496;1752;0;176387;91434;0;35.9;18.6;0.0
50;2021-05-16;967;262;0;177354;91696;0;36.1;18.7;0.0
50;2021-05-17;2219;1823;0;179573;93519;0;36.6;19.1;0.0
50;2021-05-18;2663;1571;0;182236;95090;0;37.1;19.4;0.0
50;2021-05-19;2628;1403;0;184864;96493;0;37.7;19.7;0.0
50;2021-05-20;3347;1586;0;188211;98079;0;38.4;20.0;0.0
50;2021-05-21;3262;1884;0;191473;99963;0;39.0;20.4;0.0
50;2021-05-22;2598;1262;0;194071;101225;0;39.6;20.6;0.0
50;2021-05-23;583;258;0;194654;101483;0;39.7;20.7;0.0
50;2021-05-24;1527;479;0;196181;101962;0;40.0;20.8;0.0
50;2021-05-25;2597;1636;0;198778;103598;0;40.5;21.1;0.0
50;2021-05-26;3106;1427;0;201884;105025;0;41.1;21.4;0.0
50;2021-05-27;3128;1899;0;205012;106924;0;41.8;21.8;0.0
50;2021-05-28;3029;2132;0;208041;109056;0;42.4;22.2;0.0
50;2021-05-29;2564;1326;0;210605;110382;0;42.9;22.5;0.0
50;2021-05-30;821;301;0;211426;110683;0;43.1;22.6;0.0
50;2021-05-31;2769;1786;0;214195;112469;0;43.7;22.9;0.0
50;2021-06-01;3401;2044;0;217596;114513;0;44.3;23.3;0.0
50;2021-06-02;3288;1828;0;220884;116341;0;45.0;23.7;0.0
50;2021-06-03;4013;2054;0;224897;118395;0;45.8;24.1;0.0
50;2021-06-04;3842;2931;0;228739;121326;0;46.6;24.7;0.0
50;2021-06-05;2825;1833;0;231564;123159;0;47.2;25.1;0.0
50;2021-06-06;831;427;0;232395;123586;0;47.4;25.2;0.0
50;2021-06-07;3446;2076;0;235841;125662;0;48.1;25.6;0.0
50;2021-06-08;4021;2215;0;239862;127877;0;48.9;26.1;0.0
50;2021-06-09;4218;1952;0;244080;129829;0;49.7;26.5;0.0
50;2021-06-10;4134;2146;0;248214;131975;0;50.6;26.9;0.0
50;2021-06-11;4062;2788;0;252276;134763;0;51.4;27.5;0.0
50;2021-06-12;3419;1566;0;255695;136329;0;52.1;27.8;0.0
50;2021-06-13;1009;454;0;256704;136783;0;52.3;27.9;0.0
50;2021-06-14;2555;2994;0;259259;139777;0;52.8;28.5;0.0
50;2021-06-15;2894;2632;0;262153;142409;0;53.4;29.0;0.0
50;2021-06-16;3000;1980;0;265153;144389;0;54.0;29.4;0.0
50;2021-06-17;2708;2521;0;267861;146910;0;54.6;29.9;0.0
50;2021-06-18;3108;3129;0;270969;150039;0;55.2;30.6;0.0
50;2021-06-19;2899;1765;0;273868;151804;0;55.8;30.9;0.0
50;2021-06-20;658;666;0;274526;152470;0;55.9;31.1;0.0
50;2021-06-21;1767;3124;0;276293;155594;0;56.3;31.7;0.0
50;2021-06-22;2015;3390;0;278308;158984;0;56.7;32.4;0.0
50;2021-06-23;1866;3837;0;280174;162821;0;57.1;33.2;0.0
50;2021-06-24;1690;3969;0;281864;166790;0;57.4;34.0;0.0
50;2021-06-25;2044;4071;0;283908;170861;0;57.9;34.8;0.0
50;2021-06-26;1824;3381;0;285732;174242;0;58.2;35.5;0.0
50;2021-06-27;552;864;0;286284;175106;0;58.3;35.7;0.0
50;2021-06-28;1793;3426;0;288077;178532;0;58.7;36.4;0.0
50;2021-06-29;1793;3514;0;289870;182046;0;59.1;37.1;0.0
50;2021-06-30;2067;3445;0;291937;185491;0;59.5;37.8;0.0
50;2021-07-01;1839;3264;0;293776;188755;0;59.9;38.5;0.0
50;2021-07-02;1783;3913;0;295559;192668;0;60.2;39.3;0.0
50;2021-07-03;1275;3251;0;296834;195919;0;60.5;39.9;0.0
50;2021-07-04;381;1005;0;297215;196924;0;60.6;40.1;0.0
50;2021-07-05;1189;3453;0;298404;200377;0;60.8;40.8;0.0
50;2021-07-06;1472;3889;0;299876;204266;0;61.1;41.6;0.0
50;2021-07-07;1700;3613;0;301576;207879;0;61.5;42.4;0.0
50;2021-07-08;1283;4008;0;302859;211887;0;61.7;43.2;0.0
50;2021-07-09;1333;4540;0;304192;216427;0;62.0;44.1;0.0
50;2021-07-10;967;3370;0;305159;219797;0;62.2;44.8;0.0
50;2021-07-11;289;947;0;305448;220744;0;62.3;45.0;0.0
50;2021-07-12;1215;4566;0;306663;225310;0;62.5;45.9;0.0
50;2021-07-13;1543;4789;0;308206;230099;0;62.8;46.9;0.0
50;2021-07-14;1224;2216;0;309430;232315;0;63.1;47.3;0.0
50;2021-07-15;1672;5011;0;311102;237326;0;63.4;48.4;0.0
50;2021-07-16;2725;5092;0;313827;242418;0;64.0;49.4;0.0
50;2021-07-17;1875;3566;0;315702;245984;0;64.3;50.1;0.0
50;2021-07-18;393;1001;0;316095;246985;0;64.4;50.3;0.0
50;2021-07-19;1474;5045;0;317569;252030;0;64.7;51.4;0.0
50;2021-07-20;1448;5251;0;319017;257281;0;65.0;52.4;0.0
50;2021-07-21;1787;5142;0;320804;262423;0;65.4;53.5;0.0
50;2021-07-22;1990;4859;0;322794;267282;0;65.8;54.5;0.0
50;2021-07-23;2156;5171;0;324950;272453;0;66.2;55.5;0.0
50;2021-07-24;1259;3555;0;326209;276008;0;66.5;56.3;0.0
50;2021-07-25;295;947;0;326504;276955;0;66.5;56.4;0.0
50;2021-07-26;2250;3330;0;328754;280285;0;67.0;57.1;0.0
50;2021-07-27;2834;3136;0;331588;283421;0;67.6;57.8;0.0
50;2021-07-28;2943;3298;0;334531;286719;0;68.2;58.4;0.0
50;2021-07-29;3543;3070;0;338074;289789;0;68.9;59.1;0.0
50;2021-07-30;2987;2857;0;341061;292646;0;69.5;59.6;0.0
50;2021-07-31;2230;2404;0;343291;295050;0;70.0;60.1;0.0
50;2021-08-01;512;589;0;343803;295639;0;70.1;60.3;0.0
50;2021-08-02;2354;2578;0;346157;298217;0;70.5;60.8;0.0
50;2021-08-03;3245;2327;0;349402;300544;0;71.2;61.3;0.0
50;2021-08-04;3427;2263;0;352829;302807;0;71.9;61.7;0.0
50;2021-08-05;2996;1990;0;355825;304797;0;72.5;62.1;0.0
50;2021-08-06;3345;2549;0;359170;307346;0;73.2;62.6;0.0
50;2021-08-07;2179;1898;0;361349;309244;0;73.6;63.0;0.0
50;2021-08-08;444;627;0;361793;309871;0;73.7;63.2;0.0
50;2021-08-09;2289;2020;0;364082;311891;0;74.2;63.6;0.0
50;2021-08-10;2706;2012;0;366788;313903;0;74.8;64.0;0.0
50;2021-08-11;2590;1888;1;369378;315791;1;75.3;64.4;0.0
50;2021-08-12;2322;2255;0;371700;318046;1;75.8;64.8;0.0
50;2021-08-13;2279;1858;0;373979;319904;1;76.2;65.2;0.0
50;2021-08-14;1639;1595;0;375618;321499;1;76.6;65.5;0.0
50;2021-08-15;354;316;0;375972;321815;1;76.6;65.6;0.0
50;2021-08-16;1599;2079;0;377571;323894;1;77.0;66.0;0.0
50;2021-08-17;1757;2443;0;379328;326337;1;77.3;66.5;0.0
50;2021-08-18;1617;2392;0;380945;328729;1;77.6;67.0;0.0
50;2021-08-19;1524;2447;0;382469;331176;1;77.9;67.5;0.0
50;2021-08-20;1440;2596;0;383909;333772;1;78.2;68.0;0.0
50;2021-08-21;905;2479;0;384814;336251;1;78.4;68.5;0.0
50;2021-08-22;315;464;0;385129;336715;1;78.5;68.6;0.0
50;2021-08-23;1028;2801;0;386157;339516;1;78.7;69.2;0.0
50;2021-08-24;1133;3042;0;387290;342558;1;78.9;69.8;0.0
50;2021-08-25;983;2652;0;388273;345210;1;79.1;70.4;0.0
50;2021-08-26;823;3147;0;389096;348357;1;79.3;71.0;0.0
50;2021-08-27;885;3114;0;389981;351471;1;79.5;71.6;0.0
50;2021-08-28;711;2708;0;390692;354179;1;79.6;72.2;0.0
50;2021-08-29;236;513;0;390928;354692;1;79.7;72.3;0.0
50;2021-08-30;738;2761;62;391666;357453;63;79.8;72.9;0.0
50;2021-08-31;779;2809;97;392445;360262;160;80.0;73.4;0.0
50;2021-09-01;646;2546;222;393091;362808;382;80.1;73.9;0.1
50;2021-09-02;489;2108;301;393580;364916;683;80.2;74.4;0.1
50;2021-09-03;671;2468;323;394251;367384;1006;80.3;74.9;0.2
50;2021-09-04;577;2680;132;394828;370064;1138;80.5;75.4;0.2
50;2021-09-05;158;586;58;394986;370650;1196;80.5;75.5;0.2
50;2021-09-06;366;1792;285;395352;372442;1481;80.6;75.9;0.3
50;2021-09-07;278;1387;274;395630;373829;1755;80.6;76.2;0.4
50;2021-09-08;432;1794;199;396062;375623;1954;80.7;76.6;0.4
50;2021-09-09;380;1210;230;396442;376833;2184;80.8;76.8;0.4
50;2021-09-10;480;1647;368;396922;378480;2552;80.9;77.1;0.5
50;2021-09-11;340;2013;270;397262;380493;2822;81.0;77.5;0.6
50;2021-09-12;63;322;15;397325;380815;2837;81.0;77.6;0.6
50;2021-09-13;370;941;358;397695;381756;3195;81.1;77.8;0.7
50;2021-09-14;396;854;465;398091;382610;3660;81.1;78.0;0.7
50;2021-09-15;410;982;384;398501;383592;4044;81.2;78.2;0.8
50;2021-09-16;440;696;410;398941;384288;4454;81.3;78.3;0.9
50;2021-09-17;439;994;443;399380;385282;4897;81.4;78.5;1.0
50;2021-09-18;287;1323;179;399667;386605;5076;81.5;78.8;1.0
50;2021-09-19;39;246;20;399706;386851;5096;81.5;78.8;1.0
50;2021-09-20;358;561;397;400064;387412;5493;81.5;79.0;1.1
50;2021-09-21;425;575;555;400489;387987;6048;81.6;79.1;1.2
50;2021-09-22;190;822;416;400679;388809;6464;81.7;79.2;1.3
50;2021-09-23;265;382;641;400944;389191;7105;81.7;79.3;1.4
50;2021-09-24;216;769;544;401160;389960;7649;81.8;79.5;1.6
50;2021-09-25;193;872;154;401353;390832;7803;81.8;79.7;1.6
50;2021-09-26;18;150;34;401371;390982;7837;81.8;79.7;1.6
50;2021-09-27;108;383;549;401479;391365;8386;81.8;79.8;1.7
50;2021-09-28;170;381;579;401649;391746;8965;81.9;79.8;1.8
50;2021-09-29;149;454;511;401798;392200;9476;81.9;79.9;1.9
50;2021-09-30;161;398;610;401959;392598;10086;81.9;80.0;2.1
50;2021-10-01;232;534;614;402191;393132;10700;82.0;80.1;2.2
50;2021-10-02;220;487;239;402411;393619;10939;82.0;80.2;2.2
50;2021-10-03;6;8;22;402417;393627;10961;82.0;80.2;2.2
50;2021-10-04;189;388;673;402606;394015;11634;82.1;80.3;2.4
50;2021-10-05;131;326;689;402737;394341;12323;82.1;80.4;2.5
50;2021-10-06;181;426;449;402918;394767;12772;82.1;80.5;2.6
50;2021-10-07;116;314;605;403034;395081;13377;82.1;80.5;2.7
50;2021-10-08;204;426;552;403238;395507;13929;82.2;80.6;2.8
50;2021-10-09;218;466;372;403456;395973;14301;82.2;80.7;2.9
50;2021-10-10;0;2;1;403456;395975;14302;82.2;80.7;2.9
50;2021-10-11;107;207;622;403563;396182;14924;82.2;80.7;3.0
50;2021-10-12;133;334;805;403696;396516;15729;82.3;80.8;3.2
50;2021-10-13;150;281;622;403846;396797;16351;82.3;80.9;3.3
50;2021-10-14;102;284;763;403948;397081;17114;82.3;80.9;3.5
50;2021-10-15;227;346;922;404175;397427;18036;82.4;81.0;3.7
50;2021-10-16;205;306;663;404380;397733;18699;82.4;81.1;3.8
50;2021-10-17;10;14;91;404390;397747;18790;82.4;81.1;3.8
50;2021-10-18;100;293;423;404490;398040;19213;82.4;81.1;3.9
50;2021-10-19;101;233;555;404591;398273;19768;82.5;81.2;4.0
50;2021-10-20;175;267;886;404766;398540;20654;82.5;81.2;4.2
50;2021-10-21;99;229;699;404865;398769;21353;82.5;81.3;4.4
50;2021-10-22;206;328;895;405071;399097;22248;82.6;81.3;4.5
50;2021-10-23;145;224;546;405216;399321;22794;82.6;81.4;4.6
50;2021-10-24;10;10;31;405226;399331;22825;82.6;81.4;4.7
50;2021-10-25;103;137;567;405329;399468;23392;82.6;81.4;4.8
50;2021-10-26;82;115;765;405411;399583;24157;82.6;81.4;4.9
50;2021-10-27;150;217;1533;405561;399800;25690;82.7;81.5;5.2
50;2021-10-28;76;77;888;405637;399877;26578;82.7;81.5;5.4
50;2021-10-29;154;207;1013;405791;400084;27591;82.7;81.5;5.6
50;2021-10-30;137;220;688;405928;400304;28279;82.7;81.6;5.8
50;2021-10-31;6;5;46;405934;400309;28325;82.7;81.6;5.8
50;2021-11-01;2;1;3;405936;400310;28328;82.7;81.6;5.8
50;2021-11-02;94;119;950;406030;400429;29278;82.8;81.6;6.0
50;2021-11-03;167;253;1474;406197;400682;30752;82.8;81.7;6.3
50;2021-11-04;66;77;744;406263;400759;31496;82.8;81.7;6.4
50;2021-11-05;166;258;1553;406429;401017;33049;82.8;81.7;6.7
50;2021-11-06;151;292;1090;406580;401309;34139;82.9;81.8;7.0
50;2021-11-07;5;6;29;406585;401315;34168;82.9;81.8;7.0
50;2021-11-08;77;141;1140;406662;401456;35308;82.9;81.8;7.2
50;2021-11-09;84;161;1443;406746;401617;36751;82.9;81.9;7.5
50;2021-11-10;135;170;1782;406881;401787;38533;82.9;81.9;7.9
50;2021-11-11;5;4;281;406886;401791;38814;82.9;81.9;7.9
50;2021-11-12;129;185;1734;407015;401976;40548;83.0;81.9;8.3
50;2021-11-13;132;176;1253;407147;402152;41801;83.0;82.0;8.5
50;2021-11-14;4;6;452;407151;402158;42253;83.0;82.0;8.6
50;2021-11-15;112;125;1867;407263;402283;44120;83.0;82.0;9.0
50;2021-11-16;87;75;1932;407350;402358;46052;83.0;82.0;9.4
50;2021-11-17;109;160;2107;407459;402518;48159;83.0;82.0;9.8
50;2021-11-18;87;113;2080;407546;402631;50239;83.1;82.1;10.2
50;2021-11-19;134;172;2366;407680;402803;52605;83.1;82.1;10.7
50;2021-11-20;194;191;1504;407874;402994;54109;83.1;82.1;11.0
50;2021-11-21;1;4;9;407875;402998;54118;83.1;82.1;11.0
50;2021-11-22;118;66;2305;407993;403064;56423;83.2;82.1;11.5
50;2021-11-23;132;96;2612;408125;403160;59035;83.2;82.2;12.0
50;2021-11-24;190;201;2583;408315;403361;61618;83.2;82.2;12.6
50;2021-11-25;128;91;2354;408443;403452;63972;83.2;82.2;13.0
50;2021-11-26;143;144;2861;408586;403596;66833;83.3;82.3;13.6
50;2021-11-27;235;212;2376;408821;403808;69209;83.3;82.3;14.1
50;2021-11-28;53;30;1512;408874;403838;70721;83.3;82.3;14.4
50;2021-11-29;120;108;3338;408994;403946;74059;83.4;82.3;15.1
50;2021-11-30;114;111;4588;409108;404057;78647;83.4;82.3;16.0
50;2021-12-01;122;129;4362;409230;404186;83009;83.4;82.4;16.9
50;2021-12-02;124;80;5258;409354;404266;88267;83.4;82.4;18.0
50;2021-12-03;138;162;5174;409492;404428;93441;83.5;82.4;19.0
50;2021-12-04;99;162;3076;409591;404590;96517;83.5;82.5;19.7
50;2021-12-05;8;14;818;409599;404604;97335;83.5;82.5;19.8
50;2021-12-06;98;101;5315;409697;404705;102650;83.5;82.5;20.9
50;2021-12-07;138;119;6517;409835;404824;109167;83.5;82.5;22.2
50;2021-12-08;198;148;6478;410033;404972;115645;83.6;82.5;23.6
50;2021-12-09;168;94;6944;410201;405066;122589;83.6;82.6;25.0
50;2021-12-10;199;168;7560;410400;405234;130149;83.6;82.6;26.5
50;2021-12-11;104;189;4176;410504;405423;134325;83.7;82.6;27.4
50;2021-12-12;23;9;804;410527;405432;135129;83.7;82.6;27.5
50;2021-12-13;125;143;6096;410652;405575;141225;83.7;82.7;28.8
50;2021-12-14;181;131;7767;410833;405706;148992;83.7;82.7;30.4
50;2021-12-15;183;195;6290;411016;405901;155282;83.8;82.7;31.6
50;2021-12-16;160;143;7439;411176;406044;162721;83.8;82.8;33.2
51;2020-12-27;0;0;0;0;0;0;0.0;0.0;0.0
51;2020-12-28;0;0;0;0;0;0;0.0;0.0;0.0
51;2020-12-29;0;0;0;0;0;0;0.0;0.0;0.0
51;2020-12-30;1;0;0;1;0;0;0.0;0.0;0.0
51;2020-12-31;1;0;0;2;0;0;0.0;0.0;0.0
51;2021-01-01;0;0;0;2;0;0;0.0;0.0;0.0
51;2021-01-02;0;0;0;2;0;0;0.0;0.0;0.0
51;2021-01-03;0;0;0;2;0;0;0.0;0.0;0.0
51;2021-01-04;2;0;0;4;0;0;0.0;0.0;0.0
51;2021-01-05;3;0;0;7;0;0;0.0;0.0;0.0
51;2021-01-06;9;0;0;16;0;0;0.0;0.0;0.0
51;2021-01-07;261;1;0;277;1;0;0.0;0.0;0.0
51;2021-01-08;508;1;0;785;2;0;0.1;0.0;0.0
51;2021-01-09;95;1;0;880;3;0;0.2;0.0;0.0
51;2021-01-10;3;0;0;883;3;0;0.2;0.0;0.0
51;2021-01-11;550;1;0;1433;4;0;0.3;0.0;0.0
51;2021-01-12;1428;5;0;2861;9;0;0.5;0.0;0.0
51;2021-01-13;1245;8;0;4106;17;0;0.7;0.0;0.0
51;2021-01-14;1432;10;0;5538;27;0;1.0;0.0;0.0
51;2021-01-15;614;5;0;6152;32;0;1.1;0.0;0.0
51;2021-01-16;176;1;0;6328;33;0;1.1;0.0;0.0
51;2021-01-17;101;0;0;6429;33;0;1.1;0.0;0.0
51;2021-01-18;886;5;0;7315;38;0;1.3;0.0;0.0
51;2021-01-19;1015;6;0;8330;44;0;1.5;0.0;0.0
51;2021-01-20;1023;10;0;9353;54;0;1.7;0.0;0.0
51;2021-01-21;858;3;0;10211;57;0;1.8;0.0;0.0
51;2021-01-22;392;2;0;10603;59;0;1.9;0.0;0.0
51;2021-01-23;294;0;0;10897;59;0;1.9;0.0;0.0
51;2021-01-24;139;1;0;11036;60;0;2.0;0.0;0.0
51;2021-01-25;686;2;0;11722;62;0;2.1;0.0;0.0
51;2021-01-26;754;4;0;12476;66;0;2.2;0.0;0.0
51;2021-01-27;657;5;0;13133;71;0;2.3;0.0;0.0
51;2021-01-28;644;65;0;13777;136;0;2.4;0.0;0.0
51;2021-01-29;474;164;0;14251;300;0;2.5;0.1;0.0
51;2021-01-30;130;7;0;14381;307;0;2.6;0.1;0.0
51;2021-01-31;81;0;0;14462;307;0;2.6;0.1;0.0
51;2021-02-01;282;79;0;14744;386;0;2.6;0.1;0.0
51;2021-02-02;685;710;0;15429;1096;0;2.7;0.2;0.0
51;2021-02-03;597;434;0;16026;1530;0;2.8;0.3;0.0
51;2021-02-04;926;780;0;16952;2310;0;3.0;0.4;0.0
51;2021-02-05;906;524;0;17858;2834;0;3.2;0.5;0.0
51;2021-02-06;37;142;0;17895;2976;0;3.2;0.5;0.0
51;2021-02-07;1;18;0;17896;2994;0;3.2;0.5;0.0
51;2021-02-08;116;420;0;18012;3414;0;3.2;0.6;0.0
51;2021-02-09;243;506;0;18255;3920;0;3.2;0.7;0.0
51;2021-02-10;259;649;0;18514;4569;0;3.3;0.8;0.0
51;2021-02-11;327;575;0;18841;5144;0;3.3;0.9;0.0
51;2021-02-12;369;572;0;19210;5716;0;3.4;1.0;0.0
51;2021-02-13;15;110;0;19225;5826;0;3.4;1.0;0.0
51;2021-02-14;8;167;0;19233;5993;0;3.4;1.1;0.0
51;2021-02-15;254;837;0;19487;6830;0;3.5;1.2;0.0
51;2021-02-16;375;941;0;19862;7771;0;3.5;1.4;0.0
51;2021-02-17;347;902;0;20209;8673;0;3.6;1.5;0.0
51;2021-02-18;410;612;0;20619;9285;0;3.7;1.6;0.0
51;2021-02-19;499;397;0;21118;9682;0;3.7;1.7;0.0
51;2021-02-20;202;295;0;21320;9977;0;3.8;1.8;0.0
51;2021-02-21;10;106;0;21330;10083;0;3.8;1.8;0.0
51;2021-02-22;191;681;0;21521;10764;0;3.8;1.9;0.0
51;2021-02-23;239;1031;0;21760;11795;0;3.9;2.1;0.0
51;2021-02-24;403;689;0;22163;12484;0;3.9;2.2;0.0
51;2021-02-25;1007;850;0;23170;13334;0;4.1;2.4;0.0
51;2021-02-26;1191;638;0;24361;13972;0;4.3;2.5;0.0
51;2021-02-27;603;129;0;24964;14101;0;4.4;2.5;0.0
51;2021-02-28;13;69;0;24977;14170;0;4.4;2.5;0.0
51;2021-03-01;755;313;0;25732;14483;0;4.6;2.6;0.0
51;2021-03-02;1117;467;0;26849;14950;0;4.8;2.7;0.0
51;2021-03-03;1172;468;0;28021;15418;0;5.0;2.7;0.0
51;2021-03-04;1089;700;0;29110;16118;0;5.2;2.9;0.0
51;2021-03-05;1566;646;0;30676;16764;0;5.4;3.0;0.0
51;2021-03-06;1476;66;0;32152;16830;0;5.7;3.0;0.0
51;2021-03-07;292;8;0;32444;16838;0;5.8;3.0;0.0
51;2021-03-08;1016;119;0;33460;16957;0;5.9;3.0;0.0
51;2021-03-09;1671;206;0;35131;17163;0;6.2;3.0;0.0
51;2021-03-10;1963;138;0;37094;17301;0;6.6;3.1;0.0
51;2021-03-11;2407;179;0;39501;17480;0;7.0;3.1;0.0
51;2021-03-12;3242;185;0;42743;17665;0;7.6;3.1;0.0
51;2021-03-13;2504;58;0;45247;17723;0;8.0;3.1;0.0
51;2021-03-14;223;5;0;45470;17728;0;8.1;3.1;0.0
51;2021-03-15;1602;167;0;47072;17895;0;8.3;3.2;0.0
51;2021-03-16;1446;185;0;48518;18080;0;8.6;3.2;0.0
51;2021-03-17;1495;203;0;50013;18283;0;8.9;3.2;0.0
51;2021-03-18;1594;264;0;51607;18547;0;9.2;3.3;0.0
51;2021-03-19;2232;297;0;53839;18844;0;9.5;3.3;0.0
51;2021-03-20;1591;214;0;55430;19058;0;9.8;3.4;0.0
51;2021-03-21;147;6;0;55577;19064;0;9.9;3.4;0.0
51;2021-03-22;1387;132;0;56964;19196;0;10.1;3.4;0.0
51;2021-03-23;2409;180;0;59373;19376;0;10.5;3.4;0.0
51;2021-03-24;2773;123;0;62146;19499;0;11.0;3.5;0.0
51;2021-03-25;3182;343;0;65328;19842;0;11.6;3.5;0.0
51;2021-03-26;3350;500;0;68678;20342;0;12.2;3.6;0.0
51;2021-03-27;1764;253;0;70442;20595;0;12.5;3.7;0.0
51;2021-03-28;247;4;0;70689;20599;0;12.5;3.7;0.0
51;2021-03-29;971;632;0;71660;21231;0;12.7;3.8;0.0
51;2021-03-30;1756;853;0;73416;22084;0;13.0;3.9;0.0
51;2021-03-31;1774;763;0;75190;22847;0;13.3;4.1;0.0
51;2021-04-01;2194;482;0;77384;23329;0;13.7;4.1;0.0
51;2021-04-02;2381;655;0;79765;23984;0;14.1;4.3;0.0
51;2021-04-03;1169;440;0;80934;24424;0;14.4;4.3;0.0
51;2021-04-04;139;13;0;81073;24437;0;14.4;4.3;0.0
51;2021-04-05;125;140;0;81198;24577;0;14.4;4.4;0.0
51;2021-04-06;806;1234;0;82004;25811;0;14.5;4.6;0.0
51;2021-04-07;1340;1410;0;83344;27221;0;14.8;4.8;0.0
51;2021-04-08;2267;1759;0;85611;28980;0;15.2;5.1;0.0
51;2021-04-09;2898;1728;0;88509;30708;0;15.7;5.4;0.0
51;2021-04-10;2182;499;0;90691;31207;0;16.1;5.5;0.0
51;2021-04-11;144;106;0;90835;31313;0;16.1;5.6;0.0
51;2021-04-12;1520;1353;0;92355;32666;0;16.4;5.8;0.0
51;2021-04-13;1979;1681;0;94334;34347;0;16.7;6.1;0.0
51;2021-04-14;2385;1497;0;96719;35844;0;17.2;6.4;0.0
51;2021-04-15;2834;1668;0;99553;37512;0;17.7;6.7;0.0
51;2021-04-16;3179;1562;0;102732;39074;0;18.2;6.9;0.0
51;2021-04-17;1977;734;0;104709;39808;0;18.6;7.1;0.0
51;2021-04-18;350;129;0;105059;39937;0;18.6;7.1;0.0
51;2021-04-19;1634;1160;0;106693;41097;0;18.9;7.3;0.0
51;2021-04-20;1857;1625;0;108550;42722;0;19.3;7.6;0.0
51;2021-04-21;2025;1736;0;110575;44458;0;19.6;7.9;0.0
51;2021-04-22;2464;1602;0;113039;46060;0;20.0;8.2;0.0
51;2021-04-23;3023;1762;0;116062;47822;0;20.6;8.5;0.0
51;2021-04-24;1831;941;0;117893;48763;0;20.9;8.6;0.0
51;2021-04-25;193;179;0;118086;48942;0;20.9;8.7;0.0
51;2021-04-26;1973;728;0;120059;49670;0;21.3;8.8;0.0
51;2021-04-27;2477;1224;0;122536;50894;0;21.7;9.0;0.0
51;2021-04-28;2629;1283;0;125165;52177;0;22.2;9.3;0.0
51;2021-04-29;2819;1465;0;127984;53642;0;22.7;9.5;0.0
51;2021-04-30;3063;1676;0;131047;55318;0;23.2;9.8;0.0
51;2021-05-01;1472;417;0;132519;55735;0;23.5;9.9;0.0
51;2021-05-02;260;142;0;132779;55877;0;23.5;9.9;0.0
51;2021-05-03;2652;809;0;135431;56686;0;24.0;10.1;0.0
51;2021-05-04;2839;1400;0;138270;58086;0;24.5;10.3;0.0
51;2021-05-05;2915;1628;0;141185;59714;0;25.0;10.6;0.0
51;2021-05-06;5427;1951;0;146612;61665;0;26.0;10.9;0.0
51;2021-05-07;3807;1951;0;150419;63616;0;26.7;11.3;0.0
51;2021-05-08;2813;790;0;153232;64406;0;27.2;11.4;0.0
51;2021-05-09;311;140;0;153543;64546;0;27.2;11.4;0.0
51;2021-05-10;3294;1842;0;156837;66388;0;27.8;11.8;0.0
51;2021-05-11;3611;2049;0;160448;68437;0;28.5;12.1;0.0
51;2021-05-12;4251;2247;0;164699;70684;0;29.2;12.5;0.0
51;2021-05-13;1759;512;0;166458;71196;0;29.5;12.6;0.0
51;2021-05-14;5208;1718;0;171666;72914;0;30.4;12.9;0.0
51;2021-05-15;4007;1326;0;175673;74240;0;31.2;13.2;0.0
51;2021-05-16;437;97;0;176110;74337;0;31.2;13.2;0.0
51;2021-05-17;3189;1501;0;179299;75838;0;31.8;13.5;0.0
51;2021-05-18;3876;1705;0;183175;77543;0;32.5;13.8;0.0
51;2021-05-19;4110;1655;0;187285;79198;0;33.2;14.0;0.0
51;2021-05-20;4738;1961;0;192023;81159;0;34.1;14.4;0.0
51;2021-05-21;3790;2411;0;195813;83570;0;34.7;14.8;0.0
51;2021-05-22;2244;1462;0;198057;85032;0;35.1;15.1;0.0
51;2021-05-23;523;222;0;198580;85254;0;35.2;15.1;0.0
51;2021-05-24;2096;704;0;200676;85958;0;35.6;15.2;0.0
51;2021-05-25;3518;1793;0;204194;87751;0;36.2;15.6;0.0
51;2021-05-26;3518;1696;0;207712;89447;0;36.8;15.9;0.0
51;2021-05-27;3495;2093;0;211207;91540;0;37.5;16.2;0.0
51;2021-05-28;3732;2849;0;214939;94389;0;38.1;16.7;0.0
51;2021-05-29;2555;1968;0;217494;96357;0;38.6;17.1;0.0
51;2021-05-30;533;157;0;218027;96514;0;38.7;17.1;0.0
51;2021-05-31;3449;1833;0;221476;98347;0;39.3;17.4;0.0
51;2021-06-01;3875;2405;0;225351;100752;0;40.0;17.9;0.0
51;2021-06-02;5782;2377;0;231133;103129;0;41.0;18.3;0.0
51;2021-06-03;3541;2482;0;234674;105611;0;41.6;18.7;0.0
51;2021-06-04;6141;3009;0;240815;108620;0;42.7;19.3;0.0
51;2021-06-05;2539;1866;0;243354;110486;0;43.2;19.6;0.0
51;2021-06-06;305;225;0;243659;110711;0;43.2;19.6;0.0
51;2021-06-07;3964;2209;0;247623;112920;0;43.9;20.0;0.0
51;2021-06-08;3837;2662;0;251460;115582;0;44.6;20.5;0.0
51;2021-06-09;3835;2733;0;255295;118315;0;45.3;21.0;0.0
51;2021-06-10;3173;2567;0;258468;120882;0;45.8;21.4;0.0
51;2021-06-11;3280;3484;0;261748;124366;0;46.4;22.1;0.0
51;2021-06-12;2204;2161;0;263952;126527;0;46.8;22.4;0.0
51;2021-06-13;248;228;0;264200;126755;0;46.9;22.5;0.0
51;2021-06-14;1560;3451;0;265760;130206;0;47.1;23.1;0.0
51;2021-06-15;2936;3679;0;268696;133885;0;47.7;23.7;0.0
51;2021-06-16;2144;3777;0;270840;137662;0;48.0;24.4;0.0
51;2021-06-17;2545;5435;0;273385;143097;0;48.5;25.4;0.0
51;2021-06-18;2340;5295;0;275725;148392;0;48.9;26.3;0.0
51;2021-06-19;1655;4343;0;277380;152735;0;49.2;27.1;0.0
51;2021-06-20;221;318;0;277601;153053;0;49.2;27.1;0.0
51;2021-06-21;1264;4417;0;278865;157470;0;49.5;27.9;0.0
51;2021-06-22;1529;4039;3;280394;161509;3;49.7;28.6;0.0
51;2021-06-23;3301;4282;0;283695;165791;3;50.3;29.4;0.0
51;2021-06-24;2133;3175;0;285828;168966;3;50.7;30.0;0.0
51;2021-06-25;1811;6324;0;287639;175290;3;51.0;31.1;0.0
51;2021-06-26;1122;4787;0;288761;180077;3;51.2;31.9;0.0
51;2021-06-27;136;435;0;288897;180512;3;51.2;32.0;0.0
51;2021-06-28;1324;4398;0;290221;184910;3;51.5;32.8;0.0
51;2021-06-29;1122;4554;0;291343;189464;3;51.7;33.6;0.0
51;2021-06-30;1614;5877;0;292957;195341;3;52.0;34.6;0.0
51;2021-07-01;1894;3921;0;294851;199262;3;52.3;35.3;0.0
51;2021-07-02;1791;6896;0;296642;206158;3;52.6;36.6;0.0
51;2021-07-03;1002;3301;0;297644;209459;3;52.8;37.1;0.0
51;2021-07-04;191;424;0;297835;209883;3;52.8;37.2;0.0
51;2021-07-05;799;5417;0;298634;215300;3;53.0;38.2;0.0
51;2021-07-06;1210;4913;10;299844;220213;13;53.2;39.1;0.0
51;2021-07-07;1542;4923;4;301386;225136;17;53.5;39.9;0.0
51;2021-07-08;2007;3507;3;303393;228643;20;53.8;40.6;0.0
51;2021-07-09;1800;5119;1;305193;233762;21;54.1;41.5;0.0
51;2021-07-10;1221;3272;0;306414;237034;21;54.3;42.0;0.0
51;2021-07-11;230;388;0;306644;237422;21;54.4;42.1;0.0
51;2021-07-12;1012;4447;0;307656;241869;21;54.6;42.9;0.0
51;2021-07-13;1562;4747;0;309218;246616;21;54.8;43.7;0.0
51;2021-07-14;1069;1603;0;310287;248219;21;55.0;44.0;0.0
51;2021-07-15;2920;4910;0;313207;253129;21;55.6;44.9;0.0
51;2021-07-16;2480;5267;0;315687;258396;21;56.0;45.8;0.0
51;2021-07-17;1820;3391;0;317507;261787;21;56.3;46.4;0.0
51;2021-07-18;284;422;0;317791;262209;21;56.4;46.5;0.0
51;2021-07-19;1970;3979;1;319761;266188;22;56.7;47.2;0.0
51;2021-07-20;2582;4865;0;322343;271053;22;57.2;48.1;0.0
51;2021-07-21;3575;3994;0;325918;275047;22;57.8;48.8;0.0
51;2021-07-22;4344;3768;0;330262;278815;22;58.6;49.5;0.0
51;2021-07-23;3593;4341;0;333855;283156;22;59.2;50.2;0.0
51;2021-07-24;2013;2709;0;335868;285865;22;59.6;50.7;0.0
51;2021-07-25;479;372;0;336347;286237;22;59.7;50.8;0.0
51;2021-07-26;3128;2733;0;339475;288970;22;60.2;51.3;0.0
51;2021-07-27;5495;3167;0;344970;292137;22;61.2;51.8;0.0
51;2021-07-28;3972;4132;0;348942;296269;22;61.9;52.5;0.0
51;2021-07-29;4546;2772;0;353488;299041;22;62.7;53.0;0.0
51;2021-07-30;3675;3111;0;357163;302152;22;63.3;53.6;0.0
51;2021-07-31;2369;1993;0;359532;304145;22;63.8;53.9;0.0
51;2021-08-01;487;314;0;360019;304459;22;63.9;54.0;0.0
51;2021-08-02;3158;2284;0;363177;306743;22;64.4;54.4;0.0
51;2021-08-03;3545;1905;0;366722;308648;22;65.0;54.7;0.0
51;2021-08-04;4059;2112;0;370781;310760;22;65.8;55.1;0.0
51;2021-08-05;2480;1600;0;373261;312360;22;66.2;55.4;0.0
51;2021-08-06;2971;2562;0;376232;314922;22;66.7;55.9;0.0
51;2021-08-07;1938;1633;0;378170;316555;22;67.1;56.1;0.0
51;2021-08-08;417;298;0;378587;316853;22;67.1;56.2;0.0
51;2021-08-09;2419;1917;0;381006;318770;22;67.6;56.5;0.0
51;2021-08-10;2265;1976;0;383271;320746;22;68.0;56.9;0.0
51;2021-08-11;2611;2342;0;385882;323088;22;68.4;57.3;0.0
51;2021-08-12;1740;2043;0;387622;325131;22;68.7;57.7;0.0
51;2021-08-13;1956;2750;0;389578;327881;22;69.1;58.2;0.0
51;2021-08-14;1415;1889;0;390993;329770;22;69.3;58.5;0.0
51;2021-08-15;161;198;0;391154;329968;22;69.4;58.5;0.0
51;2021-08-16;1298;2965;0;392452;332933;22;69.6;59.0;0.0
51;2021-08-17;1495;3153;0;393947;336086;22;69.9;59.6;0.0
51;2021-08-18;1743;3534;0;395690;339620;22;70.2;60.2;0.0
51;2021-08-19;1332;2521;0;397022;342141;22;70.4;60.7;0.0
51;2021-08-20;1586;3848;0;398608;345989;22;70.7;61.4;0.0
51;2021-08-21;898;2276;0;399506;348265;22;70.9;61.8;0.0
51;2021-08-22;112;428;0;399618;348693;22;70.9;61.8;0.0
51;2021-08-23;1100;3488;0;400718;352181;22;71.1;62.5;0.0
51;2021-08-24;1112;3517;0;401830;355698;22;71.3;63.1;0.0
51;2021-08-25;1206;4168;0;403036;359866;22;71.5;63.8;0.0
51;2021-08-26;1000;2490;0;404036;362356;22;71.7;64.3;0.0
51;2021-08-27;1151;3961;0;405187;366317;22;71.9;65.0;0.0
51;2021-08-28;610;2271;0;405797;368588;22;72.0;65.4;0.0
51;2021-08-29;88;411;0;405885;368999;22;72.0;65.4;0.0
51;2021-08-30;1201;4394;48;407086;373393;70;72.2;66.2;0.0
51;2021-08-31;753;2845;93;407839;376238;163;72.3;66.7;0.0
51;2021-09-01;749;2928;165;408588;379166;328;72.5;67.2;0.1
51;2021-09-02;755;1968;177;409343;381134;505;72.6;67.6;0.1
51;2021-09-03;890;2581;285;410233;383715;790;72.8;68.1;0.1
51;2021-09-04;590;2484;95;410823;386199;885;72.9;68.5;0.2
51;2021-09-05;128;216;35;410951;386415;920;72.9;68.5;0.2
51;2021-09-06;412;1450;474;411363;387865;1394;73.0;68.8;0.2
51;2021-09-07;503;1186;427;411866;389051;1821;73.0;69.0;0.3
51;2021-09-08;563;1754;250;412429;390805;2071;73.1;69.3;0.4
51;2021-09-09;455;1175;171;412884;391980;2242;73.2;69.5;0.4
51;2021-09-10;677;1739;303;413561;393719;2545;73.3;69.8;0.5
51;2021-09-11;528;1616;103;414089;395335;2648;73.4;70.1;0.5
51;2021-09-12;29;88;8;414118;395423;2656;73.4;70.1;0.5
51;2021-09-13;424;843;293;414542;396266;2949;73.5;70.3;0.5
51;2021-09-14;572;818;545;415114;397084;3494;73.6;70.4;0.6
51;2021-09-15;491;1327;401;415605;398411;3895;73.7;70.7;0.7
51;2021-09-16;318;642;414;415923;399053;4309;73.8;70.8;0.8
51;2021-09-17;551;1177;550;416474;400230;4859;73.9;71.0;0.9
51;2021-09-18;440;1267;149;416914;401497;5008;73.9;71.2;0.9
51;2021-09-19;16;75;9;416930;401572;5017;73.9;71.2;0.9
51;2021-09-20;277;567;298;417207;402139;5315;74.0;71.3;0.9
51;2021-09-21;239;519;352;417446;402658;5667;74.0;71.4;1.0
51;2021-09-22;308;1246;477;417754;403904;6144;74.1;71.6;1.1
51;2021-09-23;204;607;386;417958;404511;6530;74.1;71.7;1.2
51;2021-09-24;361;956;595;418319;405467;7125;74.2;71.9;1.3
51;2021-09-25;262;895;202;418581;406362;7327;74.2;72.1;1.3
51;2021-09-26;9;126;12;418590;406488;7339;74.2;72.1;1.3
51;2021-09-27;237;413;286;418827;406901;7625;74.3;72.2;1.4
51;2021-09-28;282;374;367;419109;407275;7992;74.3;72.2;1.4
51;2021-09-29;337;713;414;419446;407988;8406;74.4;72.4;1.5
51;2021-09-30;233;400;379;419679;408388;8785;74.4;72.4;1.6
51;2021-10-01;373;704;523;420052;409092;9308;74.5;72.6;1.7
51;2021-10-02;360;699;330;420412;409791;9638;74.6;72.7;1.7
51;2021-10-03;3;5;2;420415;409796;9640;74.6;72.7;1.7
51;2021-10-04;190;406;405;420605;410202;10045;74.6;72.8;1.8
51;2021-10-05;230;430;504;420835;410632;10549;74.6;72.8;1.9
51;2021-10-06;316;536;631;421151;411168;11180;74.7;72.9;2.0
51;2021-10-07;170;370;604;421321;411538;11784;74.7;73.0;2.1
51;2021-10-08;333;606;845;421654;412144;12629;74.8;73.1;2.2
51;2021-10-09;319;557;443;421973;412701;13072;74.8;73.2;2.3
51;2021-10-10;9;12;3;421982;412713;13075;74.8;73.2;2.3
51;2021-10-11;173;309;506;422155;413022;13581;74.9;73.3;2.4
51;2021-10-12;148;363;635;422303;413385;14216;74.9;73.3;2.5
51;2021-10-13;286;419;781;422589;413804;14997;75.0;73.4;2.7
51;2021-10-14;146;198;482;422735;414002;15479;75.0;73.4;2.7
51;2021-10-15;345;514;1231;423080;414516;16710;75.0;73.5;3.0
51;2021-10-16;294;369;486;423374;414885;17196;75.1;73.6;3.0
51;2021-10-17;5;4;8;423379;414889;17204;75.1;73.6;3.1
51;2021-10-18;143;255;655;423522;415144;17859;75.1;73.6;3.2
51;2021-10-19;146;289;660;423668;415433;18519;75.1;73.7;3.3
51;2021-10-20;278;384;987;423946;415817;19506;75.2;73.7;3.5
51;2021-10-21;150;250;643;424096;416067;20149;75.2;73.8;3.6
51;2021-10-22;223;384;1162;424319;416451;21311;75.3;73.9;3.8
51;2021-10-23;206;374;483;424525;416825;21794;75.3;73.9;3.9
51;2021-10-24;1;4;7;424526;416829;21801;75.3;73.9;3.9
51;2021-10-25;157;190;760;424683;417019;22561;75.3;74.0;4.0
51;2021-10-26;119;183;739;424802;417202;23300;75.3;74.0;4.1
51;2021-10-27;224;330;840;425026;417532;24140;75.4;74.1;4.3
51;2021-10-28;128;170;681;425154;417702;24821;75.4;74.1;4.4
51;2021-10-29;177;305;1167;425331;418007;25988;75.4;74.1;4.6
51;2021-10-30;158;299;406;425489;418306;26394;75.5;74.2;4.7
51;2021-10-31;1;6;1;425490;418312;26395;75.5;74.2;4.7
51;2021-11-01;12;8;6;425502;418320;26401;75.5;74.2;4.7
51;2021-11-02;163;227;794;425665;418547;27195;75.5;74.2;4.8
51;2021-11-03;192;231;996;425857;418778;28191;75.5;74.3;5.0
51;2021-11-04;99;155;736;425956;418933;28927;75.5;74.3;5.1
51;2021-11-05;277;371;1423;426233;419304;30350;75.6;74.4;5.4
51;2021-11-06;161;248;688;426394;419552;31038;75.6;74.4;5.5
51;2021-11-07;7;11;16;426401;419563;31054;75.6;74.4;5.5
51;2021-11-08;92;141;901;426493;419704;31955;75.6;74.4;5.7
51;2021-11-09;120;225;1172;426613;419929;33127;75.7;74.5;5.9
51;2021-11-10;197;250;1453;426810;420179;34580;75.7;74.5;6.1
51;2021-11-11;4;25;39;426814;420204;34619;75.7;74.5;6.1
51;2021-11-12;238;346;1785;427052;420550;36404;75.7;74.6;6.5
51;2021-11-13;121;156;692;427173;420706;37096;75.8;74.6;6.6
51;2021-11-14;0;6;14;427173;420712;37110;75.8;74.6;6.6
51;2021-11-15;118;162;1394;427291;420874;38504;75.8;74.6;6.8
51;2021-11-16;121;170;1769;427412;421044;40273;75.8;74.7;7.1
51;2021-11-17;171;220;1753;427583;421264;42026;75.8;74.7;7.5
51;2021-11-18;108;136;1517;427691;421400;43543;75.9;74.7;7.7
51;2021-11-19;258;310;2437;427949;421710;45980;75.9;74.8;8.2
51;2021-11-20;154;230;1160;428103;421940;47140;75.9;74.8;8.4
51;2021-11-21;6;7;46;428109;421947;47186;75.9;74.8;8.4
51;2021-11-22;156;126;1534;428265;422073;48720;76.0;74.9;8.6
51;2021-11-23;159;170;1975;428424;422243;50695;76.0;74.9;9.0
51;2021-11-24;280;201;1864;428704;422444;52559;76.0;74.9;9.3
51;2021-11-25;132;139;2055;428836;422583;54614;76.1;74.9;9.7
51;2021-11-26;246;239;3640;429082;422822;58254;76.1;75.0;10.3
51;2021-11-27;167;195;1802;429249;423017;60056;76.1;75.0;10.7
51;2021-11-28;2;7;136;429251;423024;60192;76.1;75.0;10.7
51;2021-11-29;119;138;3020;429370;423162;63212;76.2;75.1;11.2
51;2021-11-30;164;147;4473;429534;423309;67685;76.2;75.1;12.0
51;2021-12-01;130;173;4200;429664;423482;71885;76.2;75.1;12.7
51;2021-12-02;116;101;4742;429780;423583;76627;76.2;75.1;13.6
51;2021-12-03;157;220;5932;429937;423803;82559;76.3;75.2;14.6
51;2021-12-04;183;156;3999;430120;423959;86558;76.3;75.2;15.4
51;2021-12-05;13;18;384;430133;423977;86942;76.3;75.2;15.4
51;2021-12-06;98;151;4477;430231;424128;91419;76.3;75.2;16.2
51;2021-12-07;145;146;5856;430376;424274;97275;76.3;75.2;17.3
51;2021-12-08;137;187;5242;430513;424461;102517;76.4;75.3;18.2
51;2021-12-09;126;154;6522;430639;424615;109039;76.4;75.3;19.3
51;2021-12-10;189;236;7926;430828;424851;116965;76.4;75.4;20.7
51;2021-12-11;171;167;5038;430999;425018;122003;76.4;75.4;21.6
51;2021-12-12;10;8;496;431009;425026;122499;76.4;75.4;21.7
51;2021-12-13;106;182;5581;431115;425208;128080;76.5;75.4;22.7
51;2021-12-14;135;170;7113;431250;425378;135193;76.5;75.4;24.0
51;2021-12-15;153;240;7578;431403;425618;142771;76.5;75.5;25.3
51;2021-12-16;154;195;7943;431557;425813;150714;76.5;75.5;26.7
52;2020-12-27;0;0;0;0;0;0;0.0;0.0;0.0
52;2020-12-28;0;0;0;0;0;0;0.0;0.0;0.0
52;2020-12-29;0;0;0;0;0;0;0.0;0.0;0.0
52;2020-12-30;0;0;0;0;0;0;0.0;0.0;0.0
52;2020-12-31;0;0;0;0;0;0;0.0;0.0;0.0
52;2021-01-01;0;0;0;0;0;0;0.0;0.0;0.0
52;2021-01-02;0;0;0;0;0;0;0.0;0.0;0.0
52;2021-01-03;0;0;0;0;0;0;0.0;0.0;0.0
52;2021-01-04;0;0;0;0;0;0;0.0;0.0;0.0
52;2021-01-05;3;0;0;3;0;0;0.0;0.0;0.0
52;2021-01-06;1;0;0;4;0;0;0.0;0.0;0.0
52;2021-01-07;2;0;0;6;0;0;0.0;0.0;0.0
52;2021-01-08;160;1;0;166;1;0;0.1;0.0;0.0
52;2021-01-09;89;0;0;255;1;0;0.2;0.0;0.0
52;2021-01-10;0;0;0;255;1;0;0.2;0.0;0.0
52;2021-01-11;167;0;0;422;1;0;0.2;0.0;0.0
52;2021-01-12;154;0;0;576;1;0;0.3;0.0;0.0
52;2021-01-13;465;0;0;1041;1;0;0.6;0.0;0.0
52;2021-01-14;614;9;0;1655;10;0;1.0;0.0;0.0
52;2021-01-15;373;1;0;2028;11;0;1.2;0.0;0.0
52;2021-01-16;17;0;0;2045;11;0;1.2;0.0;0.0
52;2021-01-17;1;0;0;2046;11;0;1.2;0.0;0.0
52;2021-01-18;380;0;0;2426;11;0;1.4;0.0;0.0
52;2021-01-19;392;1;0;2818;12;0;1.7;0.0;0.0
52;2021-01-20;404;2;0;3222;14;0;1.9;0.0;0.0
52;2021-01-21;406;1;0;3628;15;0;2.1;0.0;0.0
52;2021-01-22;320;2;0;3948;17;0;2.3;0.0;0.0
52;2021-01-23;69;2;0;4017;19;0;2.4;0.0;0.0
52;2021-01-24;2;0;0;4019;19;0;2.4;0.0;0.0
52;2021-01-25;261;1;0;4280;20;0;2.5;0.0;0.0
52;2021-01-26;304;1;0;4584;21;0;2.7;0.0;0.0
52;2021-01-27;243;1;0;4827;22;0;2.9;0.0;0.0
52;2021-01-28;186;4;0;5013;26;0;3.0;0.0;0.0
52;2021-01-29;81;92;0;5094;118;0;3.0;0.1;0.0
52;2021-01-30;90;90;0;5184;208;0;3.1;0.1;0.0
52;2021-01-31;0;0;0;5184;208;0;3.1;0.1;0.0
52;2021-02-01;116;145;0;5300;353;0;3.1;0.2;0.0
52;2021-02-02;75;142;0;5375;495;0;3.2;0.3;0.0
52;2021-02-03;81;341;0;5456;836;0;3.2;0.5;0.0
52;2021-02-04;209;520;0;5665;1356;0;3.3;0.8;0.0
52;2021-02-05;109;444;0;5774;1800;0;3.4;1.1;0.0
52;2021-02-06;26;0;0;5800;1800;0;3.4;1.1;0.0
52;2021-02-07;0;0;0;5800;1800;0;3.4;1.1;0.0
52;2021-02-08;39;187;0;5839;1987;0;3.4;1.2;0.0
52;2021-02-09;57;196;0;5896;2183;0;3.5;1.3;0.0
52;2021-02-10;99;179;0;5995;2362;0;3.5;1.4;0.0
52;2021-02-11;128;128;0;6123;2490;0;3.6;1.5;0.0
52;2021-02-12;179;136;0;6302;2626;0;3.7;1.6;0.0
52;2021-02-13;7;3;0;6309;2629;0;3.7;1.6;0.0
52;2021-02-14;6;19;0;6315;2648;0;3.7;1.6;0.0
52;2021-02-15;83;273;0;6398;2921;0;3.8;1.7;0.0
52;2021-02-16;66;327;0;6464;3248;0;3.8;1.9;0.0
52;2021-02-17;47;317;0;6511;3565;0;3.8;2.1;0.0
52;2021-02-18;83;250;0;6594;3815;0;3.9;2.3;0.0
52;2021-02-19;60;211;0;6654;4026;0;3.9;2.4;0.0
52;2021-02-20;16;99;0;6670;4125;0;3.9;2.4;0.0
52;2021-02-21;1;7;0;6671;4132;0;3.9;2.4;0.0
52;2021-02-22;40;364;0;6711;4496;0;4.0;2.7;0.0
52;2021-02-23;59;270;0;6770;4766;0;4.0;2.8;0.0
52;2021-02-24;89;217;0;6859;4983;0;4.1;2.9;0.0
52;2021-02-25;152;213;0;7011;5196;0;4.1;3.1;0.0
52;2021-02-26;302;162;0;7313;5358;0;4.3;3.2;0.0
52;2021-02-27;156;48;0;7469;5406;0;4.4;3.2;0.0
52;2021-02-28;1;1;0;7470;5407;0;4.4;3.2;0.0
52;2021-03-01;158;30;0;7628;5437;0;4.5;3.2;0.0
52;2021-03-02;156;66;0;7784;5503;0;4.6;3.3;0.0
52;2021-03-03;363;54;0;8147;5557;0;4.8;3.3;0.0
52;2021-03-04;401;67;0;8548;5624;0;5.1;3.3;0.0
52;2021-03-05;503;58;0;9051;5682;0;5.3;3.4;0.0
52;2021-03-06;428;40;0;9479;5722;0;5.6;3.4;0.0
52;2021-03-07;30;1;0;9509;5723;0;5.6;3.4;0.0
52;2021-03-08;387;114;0;9896;5837;0;5.8;3.4;0.0
52;2021-03-09;534;126;0;10430;5963;0;6.2;3.5;0.0
52;2021-03-10;339;111;0;10769;6074;0;6.4;3.6;0.0
52;2021-03-11;620;46;0;11389;6120;0;6.7;3.6;0.0
52;2021-03-12;549;61;0;11938;6181;0;7.1;3.7;0.0
52;2021-03-13;521;14;0;12459;6195;0;7.4;3.7;0.0
52;2021-03-14;23;2;0;12482;6197;0;7.4;3.7;0.0
52;2021-03-15;347;31;0;12829;6228;0;7.6;3.7;0.0
52;2021-03-16;247;22;0;13076;6250;0;7.7;3.7;0.0
52;2021-03-17;426;26;0;13502;6276;0;8.0;3.7;0.0
52;2021-03-18;488;25;0;13990;6301;0;8.3;3.7;0.0
52;2021-03-19;509;57;0;14499;6358;0;8.6;3.8;0.0
52;2021-03-20;263;13;0;14762;6371;0;8.7;3.8;0.0
52;2021-03-21;30;1;0;14792;6372;0;8.7;3.8;0.0
52;2021-03-22;386;51;0;15178;6423;0;9.0;3.8;0.0
52;2021-03-23;766;53;0;15944;6476;0;9.4;3.8;0.0
52;2021-03-24;818;72;0;16762;6548;0;9.9;3.9;0.0
52;2021-03-25;1144;99;0;17906;6647;0;10.6;3.9;0.0
52;2021-03-26;1023;136;0;18929;6783;0;11.2;4.0;0.0
52;2021-03-27;498;78;0;19427;6861;0;11.5;4.1;0.0
52;2021-03-28;61;0;0;19488;6861;0;11.5;4.1;0.0
52;2021-03-29;523;190;0;20011;7051;0;11.8;4.2;0.0
52;2021-03-30;881;246;0;20892;7297;0;12.3;4.3;0.0
52;2021-03-31;984;285;0;21876;7582;0;12.9;4.5;0.0
52;2021-04-01;1171;219;0;23047;7801;0;13.6;4.6;0.0
52;2021-04-02;996;111;0;24043;7912;0;14.2;4.7;0.0
52;2021-04-03;437;15;0;24480;7927;0;14.5;4.7;0.0
52;2021-04-04;7;3;0;24487;7930;0;14.5;4.7;0.0
52;2021-04-05;20;0;0;24507;7930;0;14.5;4.7;0.0
52;2021-04-06;487;289;0;24994;8219;0;14.8;4.9;0.0
52;2021-04-07;610;453;0;25604;8672;0;15.1;5.1;0.0
52;2021-04-08;932;270;0;26536;8942;0;15.7;5.3;0.0
52;2021-04-09;1116;157;0;27652;9099;0;16.3;5.4;0.0
52;2021-04-10;796;102;0;28448;9201;0;16.8;5.4;0.0
52;2021-04-11;55;11;0;28503;9212;0;16.8;5.4;0.0
52;2021-04-12;945;319;0;29448;9531;0;17.4;5.6;0.0
52;2021-04-13;1244;409;0;30692;9940;0;18.1;5.9;0.0
52;2021-04-14;1258;512;0;31950;10452;0;18.9;6.2;0.0
52;2021-04-15;1421;477;0;33371;10929;0;19.7;6.5;0.0
52;2021-04-16;1539;367;0;34910;11296;0;20.6;6.7;0.0
52;2021-04-17;1403;135;0;36313;11431;0;21.5;6.8;0.0
52;2021-04-18;503;41;0;36816;11472;0;21.8;6.8;0.0
52;2021-04-19;566;618;0;37382;12090;0;22.1;7.1;0.0
52;2021-04-20;950;709;0;38332;12799;0;22.6;7.6;0.0
52;2021-04-21;1043;705;0;39375;13504;0;23.3;8.0;0.0
52;2021-04-22;1412;694;0;40787;14198;0;24.1;8.4;0.0
52;2021-04-23;1335;641;0;42122;14839;0;24.9;8.8;0.0
52;2021-04-24;528;307;0;42650;15146;0;25.2;8.9;0.0
52;2021-04-25;20;86;0;42670;15232;0;25.2;9.0;0.0
52;2021-04-26;610;501;0;43280;15733;0;25.6;9.3;0.0
52;2021-04-27;918;731;0;44198;16464;0;26.1;9.7;0.0
52;2021-04-28;1379;613;0;45577;17077;0;26.9;10.1;0.0
52;2021-04-29;1299;612;0;46876;17689;0;27.7;10.5;0.0
52;2021-04-30;1246;674;0;48122;18363;0;28.4;10.8;0.0
52;2021-05-01;36;260;0;48158;18623;0;28.5;11.0;0.0
52;2021-05-02;8;6;0;48166;18629;0;28.5;11.0;0.0
52;2021-05-03;1061;633;0;49227;19262;0;29.1;11.4;0.0
52;2021-05-04;1279;746;0;50506;20008;0;29.8;11.8;0.0
52;2021-05-05;1592;705;0;52098;20713;0;30.8;12.2;0.0
52;2021-05-06;1707;576;0;53805;21289;0;31.8;12.6;0.0
52;2021-05-07;1424;1191;0;55229;22480;0;32.6;13.3;0.0
52;2021-05-08;587;267;0;55816;22747;0;33.0;13.4;0.0
52;2021-05-09;50;79;0;55866;22826;0;33.0;13.5;0.0
52;2021-05-10;755;1094;0;56621;23920;0;33.5;14.1;0.0
52;2021-05-11;862;1330;0;57483;25250;0;34.0;14.9;0.0
52;2021-05-12;1132;1300;0;58615;26550;0;34.6;15.7;0.0
52;2021-05-13;180;188;0;58795;26738;0;34.7;15.8;0.0
52;2021-05-14;1123;1372;0;59918;28110;0;35.4;16.6;0.0
52;2021-05-15;579;916;0;60497;29026;0;35.7;17.1;0.0
52;2021-05-16;124;60;0;60621;29086;0;35.8;17.2;0.0
52;2021-05-17;1031;694;0;61652;29780;0;36.4;17.6;0.0
52;2021-05-18;1142;671;0;62794;30451;0;37.1;18.0;0.0
52;2021-05-19;1423;431;0;64217;30882;0;37.9;18.2;0.0
52;2021-05-20;1546;446;0;65763;31328;0;38.9;18.5;0.0
52;2021-05-21;1534;610;0;67297;31938;0;39.8;18.9;0.0
52;2021-05-22;1078;212;0;68375;32150;0;40.4;19.0;0.0
52;2021-05-23;18;3;0;68393;32153;0;40.4;19.0;0.0
52;2021-05-24;508;39;0;68901;32192;0;40.7;19.0;0.0
52;2021-05-25;1275;380;0;70176;32572;0;41.5;19.2;0.0
52;2021-05-26;1338;671;0;71514;33243;0;42.3;19.6;0.0
52;2021-05-27;1374;792;0;72888;34035;0;43.1;20.1;0.0
52;2021-05-28;1411;703;0;74299;34738;0;43.9;20.5;0.0
52;2021-05-29;744;866;0;75043;35604;0;44.3;21.0;0.0
52;2021-05-30;32;552;0;75075;36156;0;44.4;21.4;0.0
52;2021-05-31;730;778;0;75805;36934;0;44.8;21.8;0.0
52;2021-06-01;859;829;0;76664;37763;0;45.3;22.3;0.0
52;2021-06-02;817;728;0;77481;38491;0;45.8;22.7;0.0
52;2021-06-03;791;753;0;78272;39244;0;46.2;23.2;0.0
52;2021-06-04;915;1367;0;79187;40611;0;46.8;24.0;0.0
52;2021-06-05;649;643;0;79836;41254;0;47.2;24.4;0.0
52;2021-06-06;31;57;0;79867;41311;0;47.2;24.4;0.0
52;2021-06-07;435;935;0;80302;42246;0;47.4;25.0;0.0
52;2021-06-08;584;1322;0;80886;43568;0;47.8;25.7;0.0
52;2021-06-09;688;1410;0;81574;44978;0;48.2;26.6;0.0
52;2021-06-10;792;955;0;82366;45933;0;48.7;27.1;0.0
52;2021-06-11;841;1319;0;83207;47252;0;49.2;27.9;0.0
52;2021-06-12;465;605;0;83672;47857;0;49.4;28.3;0.0
52;2021-06-13;13;11;0;83685;47868;0;49.4;28.3;0.0
52;2021-06-14;234;1334;0;83919;49202;0;49.6;29.1;0.0
52;2021-06-15;302;1621;0;84221;50823;0;49.8;30.0;0.0
52;2021-06-16;411;1750;0;84632;52573;0;50.0;31.1;0.0
52;2021-06-17;300;1061;0;84932;53634;0;50.2;31.7;0.0
52;2021-06-18;401;1590;0;85333;55224;0;50.4;32.6;0.0
52;2021-06-19;579;725;0;85912;55949;0;50.8;33.1;0.0
52;2021-06-20;4;24;0;85916;55973;0;50.8;33.1;0.0
52;2021-06-21;495;873;0;86411;56846;0;51.1;33.6;0.0
52;2021-06-22;467;1014;0;86878;57860;0;51.3;34.2;0.0
52;2021-06-23;511;1032;0;87389;58892;0;51.6;34.8;0.0
52;2021-06-24;573;781;0;87962;59673;0;52.0;35.3;0.0
52;2021-06-25;635;1335;0;88597;61008;0;52.3;36.0;0.0
52;2021-06-26;327;809;0;88924;61817;0;52.5;36.5;0.0
52;2021-06-27;5;54;0;88929;61871;0;52.5;36.6;0.0
52;2021-06-28;186;1386;0;89115;63257;0;52.7;37.4;0.0
52;2021-06-29;181;1297;0;89296;64554;0;52.8;38.1;0.0
52;2021-06-30;247;1344;0;89543;65898;0;52.9;38.9;0.0
52;2021-07-01;337;1045;0;89880;66943;0;53.1;39.6;0.0
52;2021-07-02;466;1493;0;90346;68436;0;53.4;40.4;0.0
52;2021-07-03;369;1161;0;90715;69597;0;53.6;41.1;0.0
52;2021-07-04;7;45;0;90722;69642;0;53.6;41.1;0.0
52;2021-07-05;228;1377;0;90950;71019;0;53.7;42.0;0.0
52;2021-07-06;333;1368;0;91283;72387;0;53.9;42.8;0.0
52;2021-07-07;339;1143;0;91622;73530;0;54.1;43.4;0.0
52;2021-07-08;460;1173;0;92082;74703;0;54.4;44.1;0.0
52;2021-07-09;349;1559;0;92431;76262;0;54.6;45.1;0.0
52;2021-07-10;208;857;0;92639;77119;0;54.7;45.6;0.0
52;2021-07-11;17;31;0;92656;77150;0;54.7;45.6;0.0
52;2021-07-12;310;1349;0;92966;78499;0;54.9;46.4;0.0
52;2021-07-13;583;1313;0;93549;79812;0;55.3;47.2;0.0
52;2021-07-14;489;192;0;94038;80004;0;55.6;47.3;0.0
52;2021-07-15;636;1346;0;94674;81350;0;55.9;48.1;0.0
52;2021-07-16;939;1363;0;95613;82713;0;56.5;48.9;0.0
52;2021-07-17;661;449;0;96274;83162;0;56.9;49.1;0.0
52;2021-07-18;135;45;0;96409;83207;0;57.0;49.2;0.0
52;2021-07-19;683;983;0;97092;84190;0;57.4;49.7;0.0
52;2021-07-20;1058;911;0;98150;85101;0;58.0;50.3;0.0
52;2021-07-21;1084;788;0;99234;85889;0;58.6;50.7;0.0
52;2021-07-22;1351;912;0;100585;86801;0;59.4;51.3;0.0
52;2021-07-23;1361;1058;0;101946;87859;0;60.2;51.9;0.0
52;2021-07-24;925;551;0;102871;88410;0;60.8;52.2;0.0
52;2021-07-25;45;30;0;102916;88440;0;60.8;52.3;0.0
52;2021-07-26;930;643;0;103846;89083;0;61.4;52.6;0.0
52;2021-07-27;1255;672;0;105101;89755;0;62.1;53.0;0.0
52;2021-07-28;1294;655;0;106395;90410;0;62.9;53.4;0.0
52;2021-07-29;1216;621;0;107611;91031;0;63.6;53.8;0.0
52;2021-07-30;1377;779;0;108988;91810;0;64.4;54.2;0.0
52;2021-07-31;980;594;0;109968;92404;0;65.0;54.6;0.0
52;2021-08-01;21;18;0;109989;92422;0;65.0;54.6;0.0
52;2021-08-02;1155;606;0;111144;93028;0;65.7;55.0;0.0
52;2021-08-03;1303;586;0;112447;93614;0;66.4;55.3;0.0
52;2021-08-04;1131;584;0;113578;94198;0;67.1;55.7;0.0
52;2021-08-05;973;587;0;114551;94785;0;67.7;56.0;0.0
52;2021-08-06;1042;759;0;115593;95544;0;68.3;56.5;0.0
52;2021-08-07;666;505;0;116259;96049;0;68.7;56.7;0.0
52;2021-08-08;14;18;0;116273;96067;0;68.7;56.8;0.0
52;2021-08-09;460;812;0;116733;96879;0;69.0;57.2;0.0
52;2021-08-10;713;793;0;117446;97672;0;69.4;57.7;0.0
52;2021-08-11;564;817;0;118010;98489;0;69.7;58.2;0.0
52;2021-08-12;642;815;0;118652;99304;0;70.1;58.7;0.0
52;2021-08-13;454;1047;0;119106;100351;0;70.4;59.3;0.0
52;2021-08-14;425;394;0;119531;100745;0;70.6;59.5;0.0
52;2021-08-15;36;26;0;119567;100771;0;70.6;59.5;0.0
52;2021-08-16;366;935;0;119933;101706;0;70.9;60.1;0.0
52;2021-08-17;394;908;0;120327;102614;0;71.1;60.6;0.0
52;2021-08-18;475;939;0;120802;103553;0;71.4;61.2;0.0
52;2021-08-19;430;856;0;121232;104409;0;71.6;61.7;0.0
52;2021-08-20;370;1228;0;121602;105637;0;71.8;62.4;0.0
52;2021-08-21;374;672;0;121976;106309;0;72.1;62.8;0.0
52;2021-08-22;10;26;0;121986;106335;0;72.1;62.8;0.0
52;2021-08-23;400;1024;0;122386;107359;0;72.3;63.4;0.0
52;2021-08-24;292;1040;0;122678;108399;0;72.5;64.0;0.0
52;2021-08-25;243;1060;0;122921;109459;0;72.6;64.7;0.0
52;2021-08-26;297;945;0;123218;110404;0;72.8;65.2;0.0
52;2021-08-27;412;1313;0;123630;111717;0;73.0;66.0;0.0
52;2021-08-28;258;585;0;123888;112302;0;73.2;66.4;0.0
52;2021-08-29;9;22;0;123897;112324;0;73.2;66.4;0.0
52;2021-08-30;216;934;22;124113;113258;22;73.3;66.9;0.0
52;2021-08-31;204;963;18;124317;114221;40;73.5;67.5;0.0
52;2021-09-01;191;958;35;124508;115179;75;73.6;68.1;0.0
52;2021-09-02;189;701;66;124697;115880;141;73.7;68.5;0.1
52;2021-09-03;256;851;100;124953;116731;241;73.8;69.0;0.1
52;2021-09-04;206;598;30;125159;117329;271;73.9;69.3;0.2
52;2021-09-05;8;25;3;125167;117354;274;74.0;69.3;0.2
52;2021-09-06;146;505;38;125313;117859;312;74.0;69.6;0.2
52;2021-09-07;178;419;109;125491;118278;421;74.1;69.9;0.2
52;2021-09-08;161;591;55;125652;118869;476;74.2;70.2;0.3
52;2021-09-09;144;360;83;125796;119229;559;74.3;70.4;0.3
52;2021-09-10;257;590;107;126053;119819;666;74.5;70.8;0.4
52;2021-09-11;157;334;31;126210;120153;697;74.6;71.0;0.4
52;2021-09-12;4;15;3;126214;120168;700;74.6;71.0;0.4
52;2021-09-13;179;466;129;126393;120634;829;74.7;71.3;0.5
52;2021-09-14;152;304;145;126545;120938;974;74.8;71.5;0.6
52;2021-09-15;151;424;103;126696;121362;1077;74.9;71.7;0.6
52;2021-09-16;136;288;156;126832;121650;1233;74.9;71.9;0.7
52;2021-09-17;218;485;165;127050;122135;1398;75.1;72.2;0.8
52;2021-09-18;135;271;69;127185;122406;1467;75.1;72.3;0.9
52;2021-09-19;6;24;4;127191;122430;1471;75.1;72.3;0.9
52;2021-09-20;108;321;93;127299;122751;1564;75.2;72.5;0.9
52;2021-09-21;80;205;145;127379;122956;1709;75.3;72.6;1.0
52;2021-09-22;97;286;119;127476;123242;1828;75.3;72.8;1.1
52;2021-09-23;142;213;179;127618;123455;2007;75.4;72.9;1.2
52;2021-09-24;124;288;205;127742;123743;2212;75.5;73.1;1.3
52;2021-09-25;92;252;150;127834;123995;2362;75.5;73.3;1.4
52;2021-09-26;4;6;0;127838;124001;2362;75.5;73.3;1.4
52;2021-09-27;116;177;154;127954;124178;2516;75.6;73.4;1.5
52;2021-09-28;105;122;141;128059;124300;2657;75.7;73.4;1.6
52;2021-09-29;97;217;79;128156;124517;2736;75.7;73.6;1.6
52;2021-09-30;113;127;79;128269;124644;2815;75.8;73.6;1.7
52;2021-10-01;119;230;168;128388;124874;2983;75.9;73.8;1.8
52;2021-10-02;64;164;40;128452;125038;3023;75.9;73.9;1.8
52;2021-10-03;3;7;3;128455;125045;3026;75.9;73.9;1.8
52;2021-10-04;82;177;171;128537;125222;3197;75.9;74.0;1.9
52;2021-10-05;61;142;81;128598;125364;3278;76.0;74.1;1.9
52;2021-10-06;110;162;128;128708;125526;3406;76.0;74.2;2.0
52;2021-10-07;51;111;237;128759;125637;3643;76.1;74.2;2.2
52;2021-10-08;110;212;239;128869;125849;3882;76.1;74.4;2.3
52;2021-10-09;71;132;59;128940;125981;3941;76.2;74.4;2.3
52;2021-10-10;3;5;0;128943;125986;3941;76.2;74.4;2.3
52;2021-10-11;41;154;125;128984;126140;4066;76.2;74.5;2.4
52;2021-10-12;68;103;177;129052;126243;4243;76.2;74.6;2.5
52;2021-10-13;70;96;150;129122;126339;4393;76.3;74.6;2.6
52;2021-10-14;41;51;112;129163;126390;4505;76.3;74.7;2.7
52;2021-10-15;84;231;210;129247;126621;4715;76.4;74.8;2.8
52;2021-10-16;61;111;115;129308;126732;4830;76.4;74.9;2.9
52;2021-10-17;0;3;0;129308;126735;4830;76.4;74.9;2.9
52;2021-10-18;49;167;161;129357;126902;4991;76.4;75.0;2.9
52;2021-10-19;57;106;157;129414;127008;5148;76.5;75.0;3.0
52;2021-10-20;60;75;240;129474;127083;5388;76.5;75.1;3.2
52;2021-10-21;27;73;165;129501;127156;5553;76.5;75.1;3.3
52;2021-10-22;63;152;326;129564;127308;5879;76.6;75.2;3.5
52;2021-10-23;37;83;101;129601;127391;5980;76.6;75.3;3.5
52;2021-10-24;1;0;9;129602;127391;5989;76.6;75.3;3.5
52;2021-10-25;59;88;347;129661;127479;6336;76.6;75.3;3.7
52;2021-10-26;35;53;273;129696;127532;6609;76.6;75.4;3.9
52;2021-10-27;50;67;290;129746;127599;6899;76.7;75.4;4.1
52;2021-10-28;26;32;316;129772;127631;7215;76.7;75.4;4.3
52;2021-10-29;62;108;291;129834;127739;7506;76.7;75.5;4.4
52;2021-10-30;43;77;139;129877;127816;7645;76.7;75.5;4.5
52;2021-10-31;1;4;1;129878;127820;7646;76.7;75.5;4.5
52;2021-11-01;1;1;6;129879;127821;7652;76.7;75.5;4.5
52;2021-11-02;57;67;307;129936;127888;7959;76.8;75.6;4.7
52;2021-11-03;66;85;355;130002;127973;8314;76.8;75.6;4.9
52;2021-11-04;25;35;279;130027;128008;8593;76.8;75.6;5.1
52;2021-11-05;77;117;425;130104;128125;9018;76.9;75.7;5.3
52;2021-11-06;53;62;196;130157;128187;9214;76.9;75.7;5.4
52;2021-11-07;0;1;0;130157;128188;9214;76.9;75.7;5.4
52;2021-11-08;37;68;382;130194;128256;9596;76.9;75.8;5.7
52;2021-11-09;37;67;466;130231;128323;10062;76.9;75.8;5.9
52;2021-11-10;57;93;826;130288;128416;10888;77.0;75.9;6.4
52;2021-11-11;0;6;6;130288;128422;10894;77.0;75.9;6.4
52;2021-11-12;54;88;594;130342;128510;11488;77.0;75.9;6.8
52;2021-11-13;38;47;342;130380;128557;11830;77.0;76.0;7.0
52;2021-11-14;3;1;4;130383;128558;11834;77.0;76.0;7.0
52;2021-11-15;25;56;548;130408;128614;12382;77.1;76.0;7.3
52;2021-11-16;52;72;973;130460;128686;13355;77.1;76.0;7.9
52;2021-11-17;54;55;763;130514;128741;14118;77.1;76.1;8.3
52;2021-11-18;32;39;442;130546;128780;14560;77.1;76.1;8.6
52;2021-11-19;68;73;757;130614;128853;15317;77.2;76.1;9.0
52;2021-11-20;56;55;444;130670;128908;15761;77.2;76.2;9.3
52;2021-11-21;1;1;18;130671;128909;15779;77.2;76.2;9.3
52;2021-11-22;37;24;845;130708;128933;16624;77.2;76.2;9.8
52;2021-11-23;51;28;827;130759;128961;17451;77.3;76.2;10.3
52;2021-11-24;84;63;769;130843;129024;18220;77.3;76.2;10.8
52;2021-11-25;29;24;522;130872;129048;18742;77.3;76.2;11.1
52;2021-11-26;71;69;1355;130943;129117;20097;77.4;76.3;11.9
52;2021-11-27;47;64;932;130990;129181;21029;77.4;76.3;12.4
52;2021-11-28;2;2;17;130992;129183;21046;77.4;76.3;12.4
52;2021-11-29;52;50;1093;131044;129233;22139;77.4;76.4;13.1
52;2021-11-30;58;33;1457;131102;129266;23596;77.5;76.4;13.9
52;2021-12-01;53;39;1345;131155;129305;24941;77.5;76.4;14.7
52;2021-12-02;31;51;1434;131186;129356;26375;77.5;76.4;15.6
52;2021-12-03;46;97;1972;131232;129453;28347;77.5;76.5;16.7
52;2021-12-04;30;47;802;131262;129500;29149;77.6;76.5;17.2
52;2021-12-05;12;9;200;131274;129509;29349;77.6;76.5;17.3
52;2021-12-06;35;45;1537;131309;129554;30886;77.6;76.5;18.2
52;2021-12-07;44;52;2063;131353;129606;32949;77.6;76.6;19.5
52;2021-12-08;36;69;2033;131389;129675;34982;77.6;76.6;20.7
52;2021-12-09;45;46;2174;131434;129721;37156;77.7;76.6;22.0
52;2021-12-10;49;60;2621;131483;129781;39777;77.7;76.7;23.5
52;2021-12-11;49;50;1375;131532;129831;41152;77.7;76.7;24.3
52;2021-12-12;6;9;265;131538;129840;41417;77.7;76.7;24.5
52;2021-12-13;46;50;2048;131584;129890;43465;77.7;76.7;25.7
52;2021-12-14;62;64;2750;131646;129954;46215;77.8;76.8;27.3
52;2021-12-15;36;80;2610;131682;130034;48825;77.8;76.8;28.8
52;2021-12-16;38;80;2286;131720;130114;51111;77.8;76.9;30.2
53;2020-12-27;0;0;0;0;0;0;0.0;0.0;0.0
53;2020-12-28;0;0;0;0;0;0;0.0;0.0;0.0
53;2020-12-29;0;0;0;0;0;0;0.0;0.0;0.0
53;2020-12-30;0;0;0;0;0;0;0.0;0.0;0.0
53;2020-12-31;0;0;0;0;0;0;0.0;0.0;0.0
53;2021-01-01;0;0;0;0;0;0;0.0;0.0;0.0
53;2021-01-02;3;1;0;3;1;0;0.0;0.0;0.0
53;2021-01-03;0;0;0;3;1;0;0.0;0.0;0.0
53;2021-01-04;0;0;0;3;1;0;0.0;0.0;0.0
53;2021-01-05;0;0;0;3;1;0;0.0;0.0;0.0
53;2021-01-06;1;0;0;4;1;0;0.0;0.0;0.0
53;2021-01-07;99;0;0;103;1;0;0.0;0.0;0.0
53;2021-01-08;266;1;0;369;2;0;0.1;0.0;0.0
53;2021-01-09;133;1;0;502;3;0;0.2;0.0;0.0
53;2021-01-10;17;0;0;519;3;0;0.2;0.0;0.0
53;2021-01-11;176;1;0;695;4;0;0.2;0.0;0.0
53;2021-01-12;350;2;0;1045;6;0;0.3;0.0;0.0
53;2021-01-13;246;0;0;1291;6;0;0.4;0.0;0.0
53;2021-01-14;279;5;0;1570;11;0;0.5;0.0;0.0
53;2021-01-15;337;5;0;1907;16;0;0.6;0.0;0.0
53;2021-01-16;64;0;0;1971;16;0;0.6;0.0;0.0
53;2021-01-17;34;1;0;2005;17;0;0.7;0.0;0.0
53;2021-01-18;369;0;0;2374;17;0;0.8;0.0;0.0
53;2021-01-19;564;0;0;2938;17;0;1.0;0.0;0.0
53;2021-01-20;590;0;0;3528;17;0;1.2;0.0;0.0
53;2021-01-21;666;3;0;4194;20;0;1.4;0.0;0.0
53;2021-01-22;573;9;0;4767;29;0;1.6;0.0;0.0
53;2021-01-23;159;1;0;4926;30;0;1.6;0.0;0.0
53;2021-01-24;8;0;0;4934;30;0;1.6;0.0;0.0
53;2021-01-25;511;0;0;5445;30;0;1.8;0.0;0.0
53;2021-01-26;1149;7;0;6594;37;0;2.2;0.0;0.0
53;2021-01-27;691;5;0;7285;42;0;2.4;0.0;0.0
53;2021-01-28;676;91;0;7961;133;0;2.6;0.0;0.0
53;2021-01-29;415;171;0;8376;304;0;2.7;0.1;0.0
53;2021-01-30;141;0;0;8517;304;0;2.8;0.1;0.0
53;2021-01-31;0;0;0;8517;304;0;2.8;0.1;0.0
53;2021-02-01;311;145;0;8828;449;0;2.9;0.1;0.0
53;2021-02-02;315;198;0;9143;647;0;3.0;0.2;0.0
53;2021-02-03;228;305;0;9371;952;0;3.1;0.3;0.0
53;2021-02-04;183;315;0;9554;1267;0;3.1;0.4;0.0
53;2021-02-05;242;274;0;9796;1541;0;3.2;0.5;0.0
53;2021-02-06;151;26;0;9947;1567;0;3.3;0.5;0.0
53;2021-02-07;1;1;0;9948;1568;0;3.3;0.5;0.0
53;2021-02-08;178;120;0;10126;1688;0;3.3;0.6;0.0
53;2021-02-09;337;173;0;10463;1861;0;3.4;0.6;0.0
53;2021-02-10;190;312;0;10653;2173;0;3.5;0.7;0.0
53;2021-02-11;378;383;0;11031;2556;0;3.6;0.8;0.0
53;2021-02-12;316;487;0;11347;3043;0;3.7;1.0;0.0
53;2021-02-13;104;112;0;11451;3155;0;3.7;1.0;0.0
53;2021-02-14;0;77;0;11451;3232;0;3.7;1.1;0.0
53;2021-02-15;261;426;0;11712;3658;0;3.8;1.2;0.0
53;2021-02-16;494;782;0;12206;4440;0;4.0;1.5;0.0
53;2021-02-17;390;611;0;12596;5051;0;4.1;1.7;0.0
53;2021-02-18;525;544;0;13121;5595;0;4.3;1.8;0.0
53;2021-02-19;858;369;0;13979;5964;0;4.6;2.0;0.0
53;2021-02-20;143;114;0;14122;6078;0;4.6;2.0;0.0
53;2021-02-21;0;15;0;14122;6093;0;4.6;2.0;0.0
53;2021-02-22;178;517;0;14300;6610;0;4.7;2.2;0.0
53;2021-02-23;83;615;0;14383;7225;0;4.7;2.4;0.0
53;2021-02-24;149;480;0;14532;7705;0;4.8;2.5;0.0
53;2021-02-25;490;351;0;15022;8056;0;4.9;2.6;0.0
53;2021-02-26;459;262;0;15481;8318;0;5.1;2.7;0.0
53;2021-02-27;103;126;0;15584;8444;0;5.1;2.8;0.0
53;2021-02-28;2;5;0;15586;8449;0;5.1;2.8;0.0
53;2021-03-01;242;298;0;15828;8747;0;5.2;2.9;0.0
53;2021-03-02;267;274;0;16095;9021;0;5.3;3.0;0.0
53;2021-03-03;352;351;0;16447;9372;0;5.4;3.1;0.0
53;2021-03-04;892;309;0;17339;9681;0;5.7;3.2;0.0
53;2021-03-05;675;271;0;18014;9952;0;5.9;3.3;0.0
53;2021-03-06;454;211;0;18468;10163;0;6.0;3.3;0.0
53;2021-03-07;294;7;0;18762;10170;0;6.1;3.3;0.0
53;2021-03-08;371;179;0;19133;10349;0;6.3;3.4;0.0
53;2021-03-09;924;224;0;20057;10573;0;6.6;3.5;0.0
53;2021-03-10;856;115;0;20913;10688;0;6.8;3.5;0.0
53;2021-03-11;1308;214;0;22221;10902;0;7.3;3.6;0.0
53;2021-03-12;1638;165;0;23859;11067;0;7.8;3.6;0.0
53;2021-03-13;823;23;0;24682;11090;0;8.1;3.6;0.0
53;2021-03-14;6;4;0;24688;11094;0;8.1;3.6;0.0
53;2021-03-15;980;305;0;25668;11399;0;8.4;3.7;0.0
53;2021-03-16;1010;323;0;26678;11722;0;8.7;3.8;0.0
53;2021-03-17;742;266;0;27420;11988;0;9.0;3.9;0.0
53;2021-03-18;1004;355;0;28424;12343;0;9.3;4.0;0.0
53;2021-03-19;1313;584;0;29737;12927;0;9.7;4.2;0.0
53;2021-03-20;614;19;0;30351;12946;0;9.9;4.2;0.0
53;2021-03-21;4;0;0;30355;12946;0;9.9;4.2;0.0
53;2021-03-22;1182;166;0;31537;13112;0;10.3;4.3;0.0
53;2021-03-23;1697;85;0;33234;13197;0;10.9;4.3;0.0
53;2021-03-24;1356;132;0;34590;13329;0;11.3;4.4;0.0
53;2021-03-25;2248;247;0;36838;13576;0;12.1;4.4;0.0
53;2021-03-26;1915;170;0;38753;13746;0;12.7;4.5;0.0
53;2021-03-27;360;14;0;39113;13760;0;12.8;4.5;0.0
53;2021-03-28;14;3;0;39127;13763;0;12.8;4.5;0.0
53;2021-03-29;1352;225;0;40479;13988;0;13.3;4.6;0.0
53;2021-03-30;1838;218;0;42317;14206;0;13.9;4.7;0.0
53;2021-03-31;1657;226;0;43974;14432;0;14.4;4.7;0.0
53;2021-04-01;1797;661;0;45771;15093;0;15.0;4.9;0.0
53;2021-04-02;1929;213;0;47700;15306;0;15.6;5.0;0.0
53;2021-04-03;395;13;0;48095;15319;0;15.8;5.0;0.0
53;2021-04-04;12;3;0;48107;15322;0;15.8;5.0;0.0
53;2021-04-05;15;13;0;48122;15335;0;15.8;5.0;0.0
53;2021-04-06;1183;537;0;49305;15872;0;16.1;5.2;0.0
53;2021-04-07;1134;955;0;50439;16827;0;16.5;5.5;0.0
53;2021-04-08;1669;1031;0;52108;17858;0;17.1;5.8;0.0
53;2021-04-09;1829;452;0;53937;18310;0;17.7;6.0;0.0
53;2021-04-10;561;15;0;54498;18325;0;17.8;6.0;0.0
53;2021-04-11;23;5;0;54521;18330;0;17.9;6.0;0.0
53;2021-04-12;767;1058;0;55288;19388;0;18.1;6.3;0.0
53;2021-04-13;1542;1101;0;56830;20489;0;18.6;6.7;0.0
53;2021-04-14;1041;780;0;57871;21269;0;19.0;7.0;0.0
53;2021-04-15;1257;1113;0;59128;22382;0;19.4;7.3;0.0
53;2021-04-16;1449;786;0;60577;23168;0;19.8;7.6;0.0
53;2021-04-17;435;304;0;61012;23472;0;20.0;7.7;0.0
53;2021-04-18;33;5;0;61045;23477;0;20.0;7.7;0.0
53;2021-04-19;754;989;0;61799;24466;0;20.2;8.0;0.0
53;2021-04-20;993;1453;0;62792;25919;0;20.6;8.5;0.0
53;2021-04-21;966;1030;0;63758;26949;0;20.9;8.8;0.0
53;2021-04-22;1181;1588;0;64939;28537;0;21.3;9.3;0.0
53;2021-04-23;1431;999;0;66370;29536;0;21.7;9.7;0.0
53;2021-04-24;182;34;0;66552;29570;0;21.8;9.7;0.0
53;2021-04-25;44;44;0;66596;29614;0;21.8;9.7;0.0
53;2021-04-26;484;1118;0;67080;30732;0;22.0;10.1;0.0
53;2021-04-27;931;1788;0;68011;32520;0;22.3;10.6;0.0
53;2021-04-28;1163;1319;0;69174;33839;0;22.7;11.1;0.0
53;2021-04-29;1233;1595;0;70407;35434;0;23.1;11.6;0.0
53;2021-04-30;1552;1279;0;71959;36713;0;23.6;12.0;0.0
53;2021-05-01;156;69;0;72115;36782;0;23.6;12.0;0.0
53;2021-05-02;69;11;0;72184;36793;0;23.6;12.0;0.0
53;2021-05-03;1666;701;0;73850;37494;0;24.2;12.3;0.0
53;2021-05-04;1393;1300;0;75243;38794;0;24.6;12.7;0.0
53;2021-05-05;1699;807;0;76942;39601;0;25.2;13.0;0.0
53;2021-05-06;1508;1323;0;78450;40924;0;25.7;13.4;0.0
53;2021-05-07;1573;1358;0;80023;42282;0;26.2;13.8;0.0
53;2021-05-08;979;70;0;81002;42352;0;26.5;13.9;0.0
53;2021-05-09;70;18;0;81072;42370;0;26.5;13.9;0.0
53;2021-05-10;2451;882;0;83523;43252;0;27.4;14.2;0.0
53;2021-05-11;3112;1341;0;86635;44593;0;28.4;14.6;0.0
53;2021-05-12;2686;1160;0;89321;45753;0;29.3;15.0;0.0
53;2021-05-13;377;49;0;89698;45802;0;29.4;15.0;0.0
53;2021-05-14;1942;710;0;91640;46512;0;30.0;15.2;0.0
53;2021-05-15;1160;130;0;92800;46642;0;30.4;15.3;0.0
53;2021-05-16;100;13;0;92900;46655;0;30.4;15.3;0.0
53;2021-05-17;1695;1308;0;94595;47963;0;31.0;15.7;0.0
53;2021-05-18;1913;1544;0;96508;49507;0;31.6;16.2;0.0
53;2021-05-19;2447;799;0;98955;50306;0;32.4;16.5;0.0
53;2021-05-20;3059;929;0;102014;51235;0;33.4;16.8;0.0
53;2021-05-21;2664;943;0;104678;52178;0;34.3;17.1;0.0
53;2021-05-22;246;108;0;104924;52286;0;34.4;17.1;0.0
53;2021-05-23;79;3;0;105003;52289;0;34.4;17.1;0.0
53;2021-05-24;145;17;0;105148;52306;0;34.4;17.1;0.0
53;2021-05-25;1799;846;0;106947;53152;0;35.0;17.4;0.0
53;2021-05-26;1817;940;0;108764;54092;0;35.6;17.7;0.0
53;2021-05-27;2967;1103;0;111731;55195;0;36.6;18.1;0.0
53;2021-05-28;2484;1028;0;114215;56223;0;37.4;18.4;0.0
53;2021-05-29;972;283;0;115187;56506;0;37.7;18.5;0.0
53;2021-05-30;45;12;0;115232;56518;0;37.7;18.5;0.0
53;2021-05-31;2456;903;0;117688;57421;0;38.5;18.8;0.0
53;2021-06-01;3222;1313;0;120910;58734;0;39.6;19.2;0.0
53;2021-06-02;2847;624;0;123757;59358;0;40.5;19.4;0.0
53;2021-06-03;3741;857;0;127498;60215;0;41.8;19.7;0.0
53;2021-06-04;2893;1367;0;130391;61582;0;42.7;20.2;0.0
53;2021-06-05;340;342;0;130731;61924;0;42.8;20.3;0.0
53;2021-06-06;35;47;0;130766;61971;0;42.8;20.3;0.0
53;2021-06-07;2476;1082;0;133242;63053;0;43.6;20.6;0.0
53;2021-06-08;3182;1240;0;136424;64293;0;44.7;21.1;0.0
53;2021-06-09;2248;1022;0;138672;65315;0;45.4;21.4;0.0
53;2021-06-10;3137;929;0;141809;66244;0;46.4;21.7;0.0
53;2021-06-11;2687;1383;0;144496;67627;0;47.3;22.1;0.0
53;2021-06-12;263;268;0;144759;67895;0;47.4;22.2;0.0
53;2021-06-13;56;61;0;144815;67956;0;47.4;22.3;0.0
53;2021-06-14;1502;1878;0;146317;69834;0;47.9;22.9;0.0
53;2021-06-15;1818;2344;0;148135;72178;0;48.5;23.6;0.0
53;2021-06-16;1710;1838;0;149845;74016;0;49.1;24.2;0.0
53;2021-06-17;2728;1682;0;152573;75698;0;50.0;24.8;0.0
53;2021-06-18;2510;1839;0;155083;77537;0;50.8;25.4;0.0
53;2021-06-19;744;1216;0;155827;78753;0;51.0;25.8;0.0
53;2021-06-20;34;465;0;155861;79218;0;51.0;25.9;0.0
53;2021-06-21;946;2623;0;156807;81841;0;51.4;26.8;0.0
53;2021-06-22;1298;3439;0;158105;85280;0;51.8;27.9;0.0
53;2021-06-23;1326;2865;0;159431;88145;0;52.2;28.9;0.0
53;2021-06-24;1686;2068;0;161117;90213;0;52.8;29.5;0.0
53;2021-06-25;1706;2184;0;162823;92397;0;53.3;30.3;0.0
53;2021-06-26;983;484;0;163806;92881;0;53.6;30.4;0.0
53;2021-06-27;23;92;0;163829;92973;0;53.7;30.4;0.0
53;2021-06-28;661;2945;0;164490;95918;0;53.9;31.4;0.0
53;2021-06-29;876;3585;0;165366;99503;0;54.2;32.6;0.0
53;2021-06-30;784;1640;0;166150;101143;0;54.4;33.1;0.0
53;2021-07-01;1405;2560;1;167555;103703;1;54.9;34.0;0.0
53;2021-07-02;1470;2079;0;169025;105782;1;55.4;34.6;0.0
53;2021-07-03;851;723;0;169876;106505;1;55.6;34.9;0.0
53;2021-07-04;11;89;0;169887;106594;1;55.6;34.9;0.0
53;2021-07-05;581;2132;0;170468;108726;1;55.8;35.6;0.0
53;2021-07-06;857;3526;0;171325;112252;1;56.1;36.8;0.0
53;2021-07-07;1016;2610;0;172341;114862;1;56.4;37.6;0.0
53;2021-07-08;1235;2989;0;173576;117851;1;56.8;38.6;0.0
53;2021-07-09;1024;3287;0;174600;121138;1;57.2;39.7;0.0
53;2021-07-10;387;1083;0;174987;122221;1;57.3;40.0;0.0
53;2021-07-11;40;66;0;175027;122287;1;57.3;40.0;0.0
53;2021-07-12;522;3518;0;175549;125805;1;57.5;41.2;0.0
53;2021-07-13;902;4416;0;176451;130221;1;57.8;42.6;0.0
53;2021-07-14;206;267;0;176657;130488;1;57.9;42.7;0.0
53;2021-07-15;1161;4040;0;177818;134528;1;58.2;44.1;0.0
53;2021-07-16;1260;3660;0;179078;138188;1;58.6;45.3;0.0
53;2021-07-17;1375;564;0;180453;138752;1;59.1;45.4;0.0
53;2021-07-18;168;65;0;180621;138817;1;59.1;45.5;0.0
53;2021-07-19;821;3285;0;181442;142102;1;59.4;46.5;0.0
53;2021-07-20;1061;3843;0;182503;145945;1;59.8;47.8;0.0
53;2021-07-21;915;3090;0;183418;149035;1;60.1;48.8;0.0
53;2021-07-22;1600;3246;0;185018;152281;1;60.6;49.9;0.0
53;2021-07-23;1607;3576;0;186625;155857;1;61.1;51.0;0.0
53;2021-07-24;919;477;0;187544;156334;1;61.4;51.2;0.0
53;2021-07-25;103;78;0;187647;156412;1;61.5;51.2;0.0
53;2021-07-26;1645;1959;0;189292;158371;1;62.0;51.9;0.0
53;2021-07-27;2268;2680;0;191560;161051;1;62.7;52.7;0.0
53;2021-07-28;2040;2645;0;193600;163696;1;63.4;53.6;0.0
53;2021-07-29;2366;2393;0;195966;166089;1;64.2;54.4;0.0
53;2021-07-30;1870;2491;0;197836;168580;1;64.8;55.2;0.0
53;2021-07-31;741;400;0;198577;168980;1;65.0;55.3;0.0
53;2021-08-01;131;61;0;198708;169041;1;65.1;55.4;0.0
53;2021-08-02;1915;1710;0;200623;170751;1;65.7;55.9;0.0
53;2021-08-03;2294;1914;0;202917;172665;1;66.5;56.5;0.0
53;2021-08-04;2457;1741;0;205374;174406;1;67.3;57.1;0.0
53;2021-08-05;2616;1430;0;207990;175836;1;68.1;57.6;0.0
53;2021-08-06;2301;1688;0;210291;177524;1;68.9;58.1;0.0
53;2021-08-07;572;344;0;210863;177868;1;69.1;58.2;0.0
53;2021-08-08;81;79;0;210944;177947;1;69.1;58.3;0.0
53;2021-08-09;1721;1600;0;212665;179547;1;69.6;58.8;0.0
53;2021-08-10;2215;1684;0;214880;181231;1;70.4;59.3;0.0
53;2021-08-11;1679;958;0;216559;182189;1;70.9;59.7;0.0
53;2021-08-12;1877;1051;0;218436;183240;1;71.5;60.0;0.0
53;2021-08-13;1868;1295;0;220304;184535;1;72.1;60.4;0.0
53;2021-08-14;180;256;0;220484;184791;1;72.2;60.5;0.0
53;2021-08-15;26;20;0;220510;184811;1;72.2;60.5;0.0
53;2021-08-16;1253;1648;0;221763;186459;1;72.6;61.1;0.0
53;2021-08-17;1462;1668;0;223225;188127;1;73.1;61.6;0.0
53;2021-08-18;1450;1615;0;224675;189742;1;73.6;62.1;0.0
53;2021-08-19;1300;1817;0;225975;191559;1;74.0;62.7;0.0
53;2021-08-20;1068;2043;0;227043;193602;1;74.4;63.4;0.0
53;2021-08-21;208;471;0;227251;194073;1;74.4;63.6;0.0
53;2021-08-22;24;72;0;227275;194145;1;74.4;63.6;0.0
53;2021-08-23;828;1925;0;228103;196070;1;74.7;64.2;0.0
53;2021-08-24;919;2147;0;229022;198217;1;75.0;64.9;0.0
53;2021-08-25;877;2137;0;229899;200354;1;75.3;65.6;0.0
53;2021-08-26;612;2373;0;230511;202727;1;75.5;66.4;0.0
53;2021-08-27;739;2465;0;231250;205192;1;75.7;67.2;0.0
53;2021-08-28;121;407;0;231371;205599;1;75.8;67.3;0.0
53;2021-08-29;15;80;0;231386;205679;1;75.8;67.4;0.0
53;2021-08-30;593;2053;25;231979;207732;26;76.0;68.0;0.0
53;2021-08-31;744;2650;62;232723;210382;88;76.2;68.9;0.0
53;2021-09-01;396;1580;96;233119;211962;184;76.3;69.4;0.1
53;2021-09-02;435;1579;115;233554;213541;299;76.5;69.9;0.1
53;2021-09-03;456;2171;162;234010;215712;461;76.6;70.6;0.2
53;2021-09-04;160;415;33;234170;216127;494;76.7;70.8;0.2
53;2021-09-05;8;34;2;234178;216161;496;76.7;70.8;0.2
53;2021-09-06;310;1388;191;234488;217549;687;76.8;71.2;0.2
53;2021-09-07;287;1633;164;234775;219182;851;76.9;71.8;0.3
53;2021-09-08;425;1906;162;235200;221088;1013;77.0;72.4;0.3
53;2021-09-09;255;1316;116;235455;222404;1129;77.1;72.8;0.4
53;2021-09-10;383;1660;232;235838;224064;1361;77.2;73.4;0.4
53;2021-09-11;82;282;40;235920;224346;1401;77.3;73.5;0.5
53;2021-09-12;1;14;1;235921;224360;1402;77.3;73.5;0.5
53;2021-09-13;256;954;228;236177;225314;1630;77.3;73.8;0.5
53;2021-09-14;232;822;185;236409;226136;1815;77.4;74.1;0.6
53;2021-09-15;357;1077;342;236766;227213;2157;77.5;74.4;0.7
53;2021-09-16;300;409;283;237066;227622;2440;77.6;74.5;0.8
53;2021-09-17;399;963;310;237465;228585;2750;77.8;74.9;0.9
53;2021-09-18;73;207;30;237538;228792;2780;77.8;74.9;0.9
53;2021-09-19;12;15;0;237550;228807;2780;77.8;74.9;0.9
53;2021-09-20;146;391;173;237696;229198;2953;77.8;75.1;1.0
53;2021-09-21;228;619;244;237924;229817;3197;77.9;75.3;1.0
53;2021-09-22;199;699;229;238123;230516;3426;78.0;75.5;1.1
53;2021-09-23;138;374;663;238261;230890;4089;78.0;75.6;1.3
53;2021-09-24;207;648;256;238468;231538;4345;78.1;75.8;1.4
53;2021-09-25;47;155;45;238515;231693;4390;78.1;75.9;1.4
53;2021-09-26;0;4;0;238515;231697;4390;78.1;75.9;1.4
53;2021-09-27;156;380;307;238671;232077;4697;78.2;76.0;1.5
53;2021-09-28;172;303;323;238843;232380;5020;78.2;76.1;1.6
53;2021-09-29;163;503;301;239006;232883;5321;78.3;76.3;1.7
53;2021-09-30;98;220;267;239104;233103;5588;78.3;76.3;1.8
53;2021-10-01;257;588;398;239361;233691;5986;78.4;76.5;2.0
53;2021-10-02;55;114;31;239416;233805;6017;78.4;76.6;2.0
53;2021-10-03;6;8;4;239422;233813;6021;78.4;76.6;2.0
53;2021-10-04;135;276;459;239557;234089;6480;78.4;76.7;2.1
53;2021-10-05;116;216;472;239673;234305;6952;78.5;76.7;2.3
53;2021-10-06;194;366;425;239867;234671;7377;78.6;76.8;2.4
53;2021-10-07;89;295;154;239956;234966;7531;78.6;76.9;2.5
53;2021-10-08;238;494;570;240194;235460;8101;78.7;77.1;2.7
53;2021-10-09;41;73;22;240235;235533;8123;78.7;77.1;2.7
53;2021-10-10;1;2;1;240236;235535;8124;78.7;77.1;2.7
53;2021-10-11;111;172;484;240347;235707;8608;78.7;77.2;2.8
53;2021-10-12;103;221;472;240450;235928;9080;78.7;77.3;3.0
53;2021-10-13;121;235;471;240571;236163;9551;78.8;77.3;3.1
53;2021-10-14;82;129;267;240653;236292;9818;78.8;77.4;3.2
53;2021-10-15;214;350;754;240867;236642;10572;78.9;77.5;3.5
53;2021-10-16;42;68;35;240909;236710;10607;78.9;77.5;3.5
53;2021-10-17;1;2;0;240910;236712;10607;78.9;77.5;3.5
53;2021-10-18;160;205;602;241070;236917;11209;78.9;77.6;3.7
53;2021-10-19;75;193;520;241145;237110;11729;79.0;77.6;3.8
53;2021-10-20;68;149;594;241213;237259;12323;79.0;77.7;4.0
53;2021-10-21;24;83;349;241237;237342;12672;79.0;77.7;4.1
53;2021-10-22;72;292;696;241309;237634;13368;79.0;77.8;4.4
53;2021-10-23;15;49;53;241324;237683;13421;79.0;77.8;4.4
53;2021-10-24;2;2;0;241326;237685;13421;79.0;77.8;4.4
53;2021-10-25;54;120;623;241380;237805;14044;79.0;77.9;4.6
53;2021-10-26;47;94;598;241427;237899;14642;79.1;77.9;4.8
53;2021-10-27;69;149;810;241496;238048;15452;79.1;78.0;5.1
53;2021-10-28;32;66;524;241528;238114;15976;79.1;78.0;5.2
53;2021-10-29;69;247;829;241597;238361;16805;79.1;78.1;5.5
53;2021-10-30;12;32;70;241609;238393;16875;79.1;78.1;5.5
53;2021-10-31;0;2;0;241609;238395;16875;79.1;78.1;5.5
53;2021-11-01;0;2;5;241609;238397;16880;79.1;78.1;5.5
53;2021-11-02;65;150;878;241674;238547;17758;79.1;78.1;5.8
53;2021-11-03;75;132;702;241749;238679;18460;79.2;78.2;6.0
53;2021-11-04;42;95;679;241791;238774;19139;79.2;78.2;6.3
53;2021-11-05;82;217;956;241873;238991;20095;79.2;78.3;6.6
53;2021-11-06;12;49;98;241885;239040;20193;79.2;78.3;6.6
53;2021-11-07;0;1;11;241885;239041;20204;79.2;78.3;6.6
53;2021-11-08;31;147;906;241916;239188;21110;79.2;78.3;6.9
53;2021-11-09;45;124;1132;241961;239312;22242;79.2;78.4;7.3
53;2021-11-10;78;113;1071;242039;239425;23313;79.3;78.4;7.6
53;2021-11-11;3;1;29;242042;239426;23342;79.3;78.4;7.6
53;2021-11-12;35;44;563;242077;239470;23905;79.3;78.4;7.8
53;2021-11-13;11;32;131;242088;239502;24036;79.3;78.4;7.9
53;2021-11-14;0;2;6;242088;239504;24042;79.3;78.4;7.9
53;2021-11-15;45;67;1183;242133;239571;25225;79.3;78.5;8.3
53;2021-11-16;30;58;792;242163;239629;26017;79.3;78.5;8.5
53;2021-11-17;60;66;1082;242223;239695;27099;79.3;78.5;8.9
53;2021-11-18;38;63;1112;242261;239758;28211;79.3;78.5;9.2
53;2021-11-19;82;113;1471;242343;239871;29682;79.4;78.6;9.7
53;2021-11-20;15;18;127;242358;239889;29809;79.4;78.6;9.8
53;2021-11-21;2;0;8;242360;239889;29817;79.4;78.6;9.8
53;2021-11-22;45;25;1198;242405;239914;31015;79.4;78.6;10.2
53;2021-11-23;40;35;1112;242445;239949;32127;79.4;78.6;10.5
53;2021-11-24;79;104;1159;242524;240053;33286;79.4;78.6;10.9
53;2021-11-25;49;54;1237;242573;240107;34523;79.4;78.6;11.3
53;2021-11-26;116;97;2388;242689;240204;36911;79.5;78.7;12.1
53;2021-11-27;15;24;280;242704;240228;37191;79.5;78.7;12.2
53;2021-11-28;3;1;61;242707;240229;37252;79.5;78.7;12.2
53;2021-11-29;51;56;2460;242758;240285;39712;79.5;78.7;13.0
53;2021-11-30;35;50;2106;242793;240335;41818;79.5;78.7;13.7
53;2021-12-01;65;80;2491;242858;240415;44309;79.5;78.7;14.5
53;2021-12-02;35;19;2132;242893;240434;46441;79.5;78.7;15.2
53;2021-12-03;63;80;3579;242956;240514;50020;79.6;78.8;16.4
53;2021-12-04;28;24;1111;242984;240538;51131;79.6;78.8;16.7
53;2021-12-05;0;3;77;242984;240541;51208;79.6;78.8;16.8
53;2021-12-06;33;45;3288;243017;240586;54496;79.6;78.8;17.8
53;2021-12-07;44;35;3234;243061;240621;57730;79.6;78.8;18.9
53;2021-12-08;43;83;2847;243104;240704;60577;79.6;78.8;19.8
53;2021-12-09;54;36;4365;243158;240740;64942;79.6;78.8;21.3
53;2021-12-10;54;71;3869;243212;240811;68811;79.6;78.9;22.5
53;2021-12-11;32;21;1556;243244;240832;70367;79.7;78.9;23.0
53;2021-12-12;7;5;151;243251;240837;70518;79.7;78.9;23.1
53;2021-12-13;27;53;3608;243278;240890;74126;79.7;78.9;24.3
53;2021-12-14;42;53;3623;243320;240943;77749;79.7;78.9;25.5
53;2021-12-15;34;79;3341;243354;241022;81090;79.7;78.9;26.6
53;2021-12-16;49;53;4240;243403;241075;85330;79.7;78.9;27.9
54;2020-12-27;0;0;0;0;0;0;0.0;0.0;0.0
54;2020-12-28;3;0;0;3;0;0;0.0;0.0;0.0
54;2020-12-29;0;0;0;3;0;0;0.0;0.0;0.0
54;2020-12-30;2;0;0;5;0;0;0.0;0.0;0.0
54;2020-12-31;9;0;0;14;0;0;0.0;0.0;0.0
54;2021-01-01;1;0;0;15;0;0;0.0;0.0;0.0
54;2021-01-02;0;0;0;15;0;0;0.0;0.0;0.0
54;2021-01-03;2;0;0;17;0;0;0.0;0.0;0.0
54;2021-01-04;156;0;0;173;0;0;0.0;0.0;0.0
54;2021-01-05;387;1;0;560;1;0;0.1;0.0;0.0
54;2021-01-06;621;1;0;1181;2;0;0.2;0.0;0.0
54;2021-01-07;798;2;0;1979;4;0;0.3;0.0;0.0
54;2021-01-08;692;3;0;2671;7;0;0.4;0.0;0.0
54;2021-01-09;109;0;0;2780;7;0;0.4;0.0;0.0
54;2021-01-10;72;0;0;2852;7;0;0.4;0.0;0.0
54;2021-01-11;950;3;0;3802;10;0;0.5;0.0;0.0
54;2021-01-12;1165;2;0;4967;12;0;0.7;0.0;0.0
54;2021-01-13;2397;7;0;7364;19;0;1.0;0.0;0.0
54;2021-01-14;3261;26;0;10625;45;0;1.5;0.0;0.0
54;2021-01-15;2616;20;0;13241;65;0;1.8;0.0;0.0
54;2021-01-16;813;4;0;14054;69;0;1.9;0.0;0.0
54;2021-01-17;218;0;0;14272;69;0;2.0;0.0;0.0
54;2021-01-18;1574;6;0;15846;75;0;2.2;0.0;0.0
54;2021-01-19;1675;2;0;17521;77;0;2.4;0.0;0.0
54;2021-01-20;1572;5;0;19093;82;0;2.6;0.0;0.0
54;2021-01-21;1452;4;0;20545;86;0;2.8;0.0;0.0
54;2021-01-22;1143;8;0;21688;94;0;3.0;0.0;0.0
54;2021-01-23;479;1;0;22167;95;0;3.0;0.0;0.0
54;2021-01-24;76;0;0;22243;95;0;3.0;0.0;0.0
54;2021-01-25;973;41;0;23216;136;0;3.2;0.0;0.0
54;2021-01-26;223;18;0;23439;154;0;3.2;0.0;0.0
54;2021-01-27;94;175;0;23533;329;0;3.2;0.0;0.0
54;2021-01-28;115;245;0;23648;574;0;3.2;0.1;0.0
54;2021-01-29;61;287;0;23709;861;0;3.2;0.1;0.0
54;2021-01-30;30;14;0;23739;875;0;3.3;0.1;0.0
54;2021-01-31;2;0;0;23741;875;0;3.3;0.1;0.0
54;2021-02-01;45;783;0;23786;1658;0;3.3;0.2;0.0
54;2021-02-02;77;960;0;23863;2618;0;3.3;0.4;0.0
54;2021-02-03;393;1496;0;24256;4114;0;3.3;0.6;0.0
54;2021-02-04;728;2369;0;24984;6483;0;3.4;0.9;0.0
54;2021-02-05;775;1798;0;25759;8281;0;3.5;1.1;0.0
54;2021-02-06;224;349;0;25983;8630;0;3.6;1.2;0.0
54;2021-02-07;5;129;0;25988;8759;0;3.6;1.2;0.0
54;2021-02-08;169;1031;0;26157;9790;0;3.6;1.3;0.0
54;2021-02-09;361;1074;0;26518;10864;0;3.6;1.5;0.0
54;2021-02-10;405;821;0;26923;11685;0;3.7;1.6;0.0
54;2021-02-11;371;894;0;27294;12579;0;3.7;1.7;0.0
54;2021-02-12;513;1301;0;27807;13880;0;3.8;1.9;0.0
54;2021-02-13;174;240;0;27981;14120;0;3.8;1.9;0.0
54;2021-02-14;32;24;0;28013;14144;0;3.8;1.9;0.0
54;2021-02-15;433;1146;0;28446;15290;0;3.9;2.1;0.0
54;2021-02-16;449;1217;0;28895;16507;0;4.0;2.3;0.0
54;2021-02-17;568;1003;0;29463;17510;0;4.0;2.4;0.0
54;2021-02-18;626;848;0;30089;18358;0;4.1;2.5;0.0
54;2021-02-19;557;762;0;30646;19120;0;4.2;2.6;0.0
54;2021-02-20;73;302;0;30719;19422;0;4.2;2.7;0.0
54;2021-02-21;5;25;0;30724;19447;0;4.2;2.7;0.0
54;2021-02-22;538;660;0;31262;20107;0;4.3;2.8;0.0
54;2021-02-23;827;553;0;32089;20660;0;4.4;2.8;0.0
54;2021-02-24;828;396;0;32917;21056;0;4.5;2.9;0.0
54;2021-02-25;1541;720;0;34458;21776;0;4.7;3.0;0.0
54;2021-02-26;1931;767;0;36389;22543;0;5.0;3.1;0.0
54;2021-02-27;899;132;0;37288;22675;0;5.1;3.1;0.0
54;2021-02-28;106;31;0;37394;22706;0;5.1;3.1;0.0
54;2021-03-01;697;244;0;38091;22950;0;5.2;3.1;0.0
54;2021-03-02;1575;222;0;39666;23172;0;5.4;3.2;0.0
54;2021-03-03;1813;115;0;41479;23287;0;5.7;3.2;0.0
54;2021-03-04;2109;168;0;43588;23455;0;6.0;3.2;0.0
54;2021-03-05;2934;200;0;46522;23655;0;6.4;3.2;0.0
54;2021-03-06;4303;136;0;50825;23791;0;7.0;3.3;0.0
54;2021-03-07;2827;81;0;53652;23872;0;7.3;3.3;0.0
54;2021-03-08;1341;118;0;54993;23990;0;7.5;3.3;0.0
54;2021-03-09;2689;162;0;57682;24152;0;7.9;3.3;0.0
54;2021-03-10;3181;151;0;60863;24303;0;8.3;3.3;0.0
54;2021-03-11;3404;166;0;64267;24469;0;8.8;3.4;0.0
54;2021-03-12;5015;240;0;69282;24709;0;9.5;3.4;0.0
54;2021-03-13;4256;157;0;73538;24866;0;10.1;3.4;0.0
54;2021-03-14;559;50;0;74097;24916;0;10.1;3.4;0.0
54;2021-03-15;1695;135;0;75792;25051;0;10.4;3.4;0.0
54;2021-03-16;1788;225;0;77580;25276;0;10.6;3.5;0.0
54;2021-03-17;2001;209;0;79581;25485;0;10.9;3.5;0.0
54;2021-03-18;2045;236;0;81626;25721;0;11.2;3.5;0.0
54;2021-03-19;3336;320;0;84962;26041;0;11.6;3.6;0.0
54;2021-03-20;2395;99;0;87357;26140;0;12.0;3.6;0.0
54;2021-03-21;318;19;0;87675;26159;0;12.0;3.6;0.0
54;2021-03-22;1198;378;0;88873;26537;0;12.2;3.6;0.0
54;2021-03-23;2005;644;0;90878;27181;0;12.4;3.7;0.0
54;2021-03-24;2216;748;0;93094;27929;0;12.7;3.8;0.0
54;2021-03-25;3287;799;0;96381;28728;0;13.2;3.9;0.0
54;2021-03-26;3647;892;0;100028;29620;0;13.7;4.1;0.0
54;2021-03-27;2306;434;0;102334;30054;0;14.0;4.1;0.0
54;2021-03-28;264;110;0;102598;30164;0;14.0;4.1;0.0
54;2021-03-29;1694;455;0;104292;30619;0;14.3;4.2;0.0
54;2021-03-30;2565;1114;0;106857;31733;0;14.6;4.3;0.0
54;2021-03-31;2576;1224;0;109433;32957;0;15.0;4.5;0.0
54;2021-04-01;3109;1364;0;112542;34321;0;15.4;4.7;0.0
54;2021-04-02;2942;1798;0;115484;36119;0;15.8;4.9;0.0
54;2021-04-03;1344;1447;0;116828;37566;0;16.0;5.1;0.0
54;2021-04-04;145;425;0;116973;37991;0;16.0;5.2;0.0
54;2021-04-05;240;566;0;117213;38557;0;16.0;5.3;0.0
54;2021-04-06;1389;1708;0;118602;40265;0;16.2;5.5;0.0
54;2021-04-07;1194;2343;0;119796;42608;0;16.4;5.8;0.0
54;2021-04-08;2604;2505;0;122400;45113;0;16.8;6.2;0.0
54;2021-04-09;4357;3093;0;126757;48206;0;17.4;6.6;0.0
54;2021-04-10;3197;1850;0;129954;50056;0;17.8;6.9;0.0
54;2021-04-11;203;984;0;130157;51040;0;17.8;7.0;0.0
54;2021-04-12;2316;1564;0;132473;52604;0;18.1;7.2;0.0
54;2021-04-13;3121;1965;0;135594;54569;0;18.6;7.5;0.0
54;2021-04-14;3395;1882;0;138989;56451;0;19.0;7.7;0.0
54;2021-04-15;3085;2348;0;142074;58799;0;19.5;8.1;0.0
54;2021-04-16;3189;2691;0;145263;61490;0;19.9;8.4;0.0
54;2021-04-17;3294;1540;0;148557;63030;0;20.3;8.6;0.0
54;2021-04-18;185;273;0;148742;63303;0;20.4;8.7;0.0
54;2021-04-19;2529;1132;0;151271;64435;0;20.7;8.8;0.0
54;2021-04-20;3065;1332;0;154336;65767;0;21.1;9.0;0.0
54;2021-04-21;3794;1604;0;158130;67371;0;21.6;9.2;0.0
54;2021-04-22;3583;2357;0;161713;69728;0;22.1;9.5;0.0
54;2021-04-23;3767;2191;0;165480;71919;0;22.7;9.8;0.0
54;2021-04-24;2267;995;0;167747;72914;0;23.0;10.0;0.0
54;2021-04-25;289;276;0;168036;73190;0;23.0;10.0;0.0
54;2021-04-26;2284;1376;0;170320;74566;0;23.3;10.2;0.0
54;2021-04-27;3161;1402;0;173481;75968;0;23.8;10.4;0.0
54;2021-04-28;2701;1944;0;176182;77912;0;24.1;10.7;0.0
54;2021-04-29;3706;2116;0;179888;80028;0;24.6;11.0;0.0
54;2021-04-30;4483;2071;0;184371;82099;0;25.2;11.2;0.0
54;2021-05-01;2189;799;0;186560;82898;0;25.5;11.3;0.0
54;2021-05-02;276;89;0;186836;82987;0;25.6;11.4;0.0
54;2021-05-03;3057;1092;0;189893;84079;0;26.0;11.5;0.0
54;2021-05-04;3511;1642;0;193404;85721;0;26.5;11.7;0.0
54;2021-05-05;4819;1693;0;198223;87414;0;27.1;12.0;0.0
54;2021-05-06;4533;2878;0;202756;90292;0;27.8;12.4;0.0
54;2021-05-07;5008;3506;0;207764;93798;0;28.4;12.8;0.0
54;2021-05-08;2073;671;0;209837;94469;0;28.7;12.9;0.0
54;2021-05-09;502;184;0;210339;94653;0;28.8;13.0;0.0
54;2021-05-10;3184;2360;0;213523;97013;0;29.2;13.3;0.0
54;2021-05-11;5423;3114;0;218946;100127;0;30.0;13.7;0.0
54;2021-05-12;4215;3507;0;223161;103634;0;30.6;14.2;0.0
54;2021-05-13;2731;516;0;225892;104150;0;30.9;14.3;0.0
54;2021-05-14;6806;2080;0;232698;106230;0;31.9;14.5;0.0
54;2021-05-15;5332;1314;0;238030;107544;0;32.6;14.7;0.0
54;2021-05-16;1066;117;0;239096;107661;0;32.7;14.7;0.0
54;2021-05-17;3717;903;0;242813;108564;0;33.2;14.9;0.0
54;2021-05-18;3409;1224;0;246222;109788;0;33.7;15.0;0.0
54;2021-05-19;3655;1545;0;249877;111333;0;34.2;15.2;0.0
54;2021-05-20;4494;1674;0;254371;113007;0;34.8;15.5;0.0
54;2021-05-21;6437;2543;0;260808;115550;0;35.7;15.8;0.0
54;2021-05-22;5224;1381;0;266032;116931;0;36.4;16.0;0.0
54;2021-05-23;516;89;0;266548;117020;0;36.5;16.0;0.0
54;2021-05-24;1425;352;0;267973;117372;0;36.7;16.1;0.0
54;2021-05-25;4057;1628;0;272030;119000;0;37.2;16.3;0.0
54;2021-05-26;3432;2265;0;275462;121265;0;37.7;16.6;0.0
54;2021-05-27;3864;2437;0;279326;123702;0;38.2;16.9;0.0
54;2021-05-28;4918;3665;0;284244;127367;0;38.9;17.4;0.0
54;2021-05-29;3793;3908;0;288037;131275;0;39.4;18.0;0.0
54;2021-05-30;202;147;0;288239;131422;0;39.5;18.0;0.0
54;2021-05-31;2910;3072;0;291149;134494;0;39.9;18.4;0.0
54;2021-06-01;2911;4176;0;294060;138670;0;40.3;19.0;0.0
54;2021-06-02;2522;3803;0;296582;142473;0;40.6;19.5;0.0
54;2021-06-03;3165;5198;0;299747;147671;0;41.0;20.2;0.0
54;2021-06-04;5217;5356;0;304964;153027;0;41.8;21.0;0.0
54;2021-06-05;2587;3210;0;307551;156237;0;42.1;21.4;0.0
54;2021-06-06;194;259;0;307745;156496;0;42.1;21.4;0.0
54;2021-06-07;3623;2872;0;311368;159368;0;42.6;21.8;0.0
54;2021-06-08;4497;4123;0;315865;163491;0;43.2;22.4;0.0
54;2021-06-09;5769;3142;0;321634;166633;0;44.0;22.8;0.0
54;2021-06-10;5170;4368;0;326804;171001;0;44.7;23.4;0.0
54;2021-06-11;4866;4923;0;331670;175924;0;45.4;24.1;0.0
54;2021-06-12;3959;3116;0;335629;179040;0;46.0;24.5;0.0
54;2021-06-13;141;254;0;335770;179294;0;46.0;24.5;0.0
54;2021-06-14;2351;3635;0;338121;182929;0;46.3;25.0;0.0
54;2021-06-15;2942;4805;0;341063;187734;0;46.7;25.7;0.0
54;2021-06-16;3355;5596;0;344418;193330;0;47.2;26.5;0.0
54;2021-06-17;3103;5277;0;347521;198607;0;47.6;27.2;0.0
54;2021-06-18;3982;6234;0;351503;204841;0;48.1;28.0;0.0
54;2021-06-19;2625;3107;0;354128;207948;0;48.5;28.5;0.0
54;2021-06-20;124;336;0;354252;208284;0;48.5;28.5;0.0
54;2021-06-21;2339;4700;0;356591;212984;0;48.8;29.2;0.0
54;2021-06-22;1949;6175;0;358540;219159;0;49.1;30.0;0.0
54;2021-06-23;2194;5544;0;360734;224703;0;49.4;30.8;0.0
54;2021-06-24;1959;3478;0;362693;228181;0;49.7;31.2;0.0
54;2021-06-25;2182;7078;0;364875;235259;0;50.0;32.2;0.0
54;2021-06-26;2241;5507;0;367116;240766;0;50.3;33.0;0.0
54;2021-06-27;190;727;0;367306;241493;0;50.3;33.1;0.0
54;2021-06-28;1769;4327;0;369075;245820;0;50.5;33.7;0.0
54;2021-06-29;1802;5210;0;370877;251030;0;50.8;34.4;0.0
54;2021-06-30;1921;5152;1;372798;256182;1;51.0;35.1;0.0
54;2021-07-01;2123;5715;0;374921;261897;1;51.3;35.9;0.0
54;2021-07-02;2773;7253;0;377694;269150;1;51.7;36.8;0.0
54;2021-07-03;2624;4005;0;380318;273155;1;52.1;37.4;0.0
54;2021-07-04;209;546;0;380527;273701;1;52.1;37.5;0.0
54;2021-07-05;1537;4158;0;382064;277859;1;52.3;38.0;0.0
54;2021-07-06;1939;5034;0;384003;282893;1;52.6;38.7;0.0
54;2021-07-07;1877;4740;0;385880;287633;1;52.8;39.4;0.0
54;2021-07-08;1647;3975;0;387527;291608;1;53.1;39.9;0.0
54;2021-07-09;3054;6135;0;390581;297743;1;53.5;40.8;0.0
54;2021-07-10;2394;4269;0;392975;302012;1;53.8;41.3;0.0
54;2021-07-11;57;163;0;393032;302175;1;53.8;41.4;0.0
54;2021-07-12;2071;4762;0;395103;306937;1;54.1;42.0;0.0
54;2021-07-13;2721;5183;0;397824;312120;1;54.5;42.7;0.0
54;2021-07-14;1564;1534;0;399388;313654;1;54.7;42.9;0.0
54;2021-07-15;3219;5093;0;402607;318747;1;55.1;43.6;0.0
54;2021-07-16;4642;6536;0;407249;325283;1;55.8;44.5;0.0
54;2021-07-17;4062;4721;0;411311;330004;1;56.3;45.2;0.0
54;2021-07-18;1567;1582;0;412878;331586;1;56.5;45.4;0.0
54;2021-07-19;2601;4178;0;415479;335764;1;56.9;46.0;0.0
54;2021-07-20;3173;4854;0;418652;340618;1;57.3;46.6;0.0
54;2021-07-21;3508;6220;0;422160;346838;1;57.8;47.5;0.0
54;2021-07-22;3658;5582;0;425818;352420;1;58.3;48.3;0.0
54;2021-07-23;4269;6825;0;430087;359245;1;58.9;49.2;0.0
54;2021-07-24;2905;5059;0;432992;364304;1;59.3;49.9;0.0
54;2021-07-25;216;139;0;433208;364443;1;59.3;49.9;0.0
54;2021-07-26;3011;4101;0;436219;368544;1;59.7;50.5;0.0
54;2021-07-27;3985;4028;0;440204;372572;1;60.3;51.0;0.0
54;2021-07-28;5225;3835;0;445429;376407;1;61.0;51.5;0.0
54;2021-07-29;5160;3148;0;450589;379555;1;61.7;52.0;0.0
54;2021-07-30;5007;4747;0;455596;384302;1;62.4;52.6;0.0
54;2021-07-31;4225;3076;0;459821;387378;1;63.0;53.0;0.0
54;2021-08-01;368;141;0;460189;387519;1;63.0;53.1;0.0
54;2021-08-02;3032;3609;0;463221;391128;1;63.4;53.5;0.0
54;2021-08-03;4200;2951;0;467421;394079;1;64.0;54.0;0.0
54;2021-08-04;4411;2703;0;471832;396782;1;64.6;54.3;0.0
54;2021-08-05;4580;2465;0;476412;399247;1;65.2;54.7;0.0
54;2021-08-06;5302;4042;0;481714;403289;1;66.0;55.2;0.0
54;2021-08-07;3570;2902;0;485284;406191;1;66.4;55.6;0.0
54;2021-08-08;326;208;0;485610;406399;1;66.5;55.6;0.0
54;2021-08-09;2808;2728;0;488418;409127;1;66.9;56.0;0.0
54;2021-08-10;2481;3837;0;490899;412964;1;67.2;56.5;0.0
54;2021-08-11;2277;2759;0;493176;415723;1;67.5;56.9;0.0
54;2021-08-12;2104;3180;0;495280;418903;1;67.8;57.4;0.0
54;2021-08-13;2468;4404;0;497748;423307;1;68.1;58.0;0.0
54;2021-08-14;1322;2163;0;499070;425470;1;68.3;58.3;0.0
54;2021-08-15;80;111;0;499150;425581;1;68.3;58.3;0.0
54;2021-08-16;1685;3342;0;500835;428923;1;68.6;58.7;0.0
54;2021-08-17;1887;3481;0;502722;432404;1;68.8;59.2;0.0
54;2021-08-18;1462;4099;0;504184;436503;1;69.0;59.8;0.0
54;2021-08-19;1217;2920;0;505401;439423;1;69.2;60.2;0.0
54;2021-08-20;1673;4838;0;507074;444261;1;69.4;60.8;0.0
54;2021-08-21;1324;3878;0;508398;448139;1;69.6;61.4;0.0
54;2021-08-22;68;92;0;508466;448231;1;69.6;61.4;0.0
54;2021-08-23;1140;3709;0;509606;451940;1;69.8;61.9;0.0
54;2021-08-24;1118;3357;0;510724;455297;1;69.9;62.3;0.0
54;2021-08-25;1305;4340;0;512029;459637;1;70.1;62.9;0.0
54;2021-08-26;983;3151;0;513012;462788;1;70.2;63.4;0.0
54;2021-08-27;1452;5168;0;514464;467956;1;70.4;64.1;0.0
54;2021-08-28;1065;4091;0;515529;472047;1;70.6;64.6;0.0
54;2021-08-29;46;151;0;515575;472198;1;70.6;64.6;0.0
54;2021-08-30;1116;3880;83;516691;476078;84;70.7;65.2;0.0
54;2021-08-31;969;4213;254;517660;480291;338;70.9;65.8;0.0
54;2021-09-01;1162;3272;375;518822;483563;713;71.0;66.2;0.1
54;2021-09-02;741;1973;228;519563;485536;941;71.1;66.5;0.1
54;2021-09-03;948;2916;293;520511;488452;1234;71.3;66.9;0.2
54;2021-09-04;1002;2834;311;521513;491286;1545;71.4;67.3;0.2
54;2021-09-05;41;67;13;521554;491353;1558;71.4;67.3;0.2
54;2021-09-06;515;1289;173;522069;492642;1731;71.5;67.4;0.2
54;2021-09-07;555;1454;184;522624;494096;1915;71.6;67.6;0.3
54;2021-09-08;638;1592;297;523262;495688;2212;71.6;67.9;0.3
54;2021-09-09;899;1658;430;524161;497346;2642;71.8;68.1;0.4
54;2021-09-10;940;2199;508;525101;499545;3150;71.9;68.4;0.4
54;2021-09-11;691;2321;180;525792;501866;3330;72.0;68.7;0.5
54;2021-09-12;80;119;31;525872;501985;3361;72.0;68.7;0.5
54;2021-09-13;653;907;395;526525;502892;3756;72.1;68.9;0.5
54;2021-09-14;637;938;613;527162;503830;4369;72.2;69.0;0.6
54;2021-09-15;625;1639;937;527787;505469;5306;72.3;69.2;0.7
54;2021-09-16;622;671;460;528409;506140;5766;72.3;69.3;0.8
54;2021-09-17;829;1427;595;529238;507567;6361;72.5;69.5;0.9
54;2021-09-18;438;1300;212;529676;508867;6573;72.5;69.7;0.9
54;2021-09-19;29;52;24;529705;508919;6597;72.5;69.7;0.9
54;2021-09-20;372;631;366;530077;509550;6963;72.6;69.8;1.0
54;2021-09-21;432;870;504;530509;510420;7467;72.6;69.9;1.0
54;2021-09-22;414;1074;640;530923;511494;8107;72.7;70.0;1.1
54;2021-09-23;323;793;603;531246;512287;8710;72.7;70.1;1.2
54;2021-09-24;515;1106;625;531761;513393;9335;72.8;70.3;1.3
54;2021-09-25;331;1026;223;532092;514419;9558;72.8;70.4;1.3
54;2021-09-26;13;41;8;532105;514460;9566;72.9;70.4;1.3
54;2021-09-27;228;677;513;532333;515137;10079;72.9;70.5;1.4
54;2021-09-28;296;569;662;532629;515706;10741;72.9;70.6;1.5
54;2021-09-29;388;775;798;533017;516481;11539;73.0;70.7;1.6
54;2021-09-30;217;454;625;533234;516935;12164;73.0;70.8;1.7
54;2021-10-01;577;946;1031;533811;517881;13195;73.1;70.9;1.8
54;2021-10-02;355;882;445;534166;518763;13640;73.1;71.0;1.9
54;2021-10-03;13;23;11;534179;518786;13651;73.1;71.0;1.9
54;2021-10-04;262;503;444;534441;519289;14095;73.2;71.1;1.9
54;2021-10-05;291;861;732;534732;520150;14827;73.2;71.2;2.0
54;2021-10-06;376;758;818;535108;520908;15645;73.3;71.3;2.1
54;2021-10-07;251;637;964;535359;521545;16609;73.3;71.4;2.3
54;2021-10-08;412;867;1323;535771;522412;17932;73.4;71.5;2.5
54;2021-10-09;365;637;631;536136;523049;18563;73.4;71.6;2.5
54;2021-10-10;17;26;32;536153;523075;18595;73.4;71.6;2.5
54;2021-10-11;260;408;841;536413;523483;19436;73.4;71.7;2.7
54;2021-10-12;244;572;988;536657;524055;20424;73.5;71.7;2.8
54;2021-10-13;333;508;1292;536990;524563;21716;73.5;71.8;3.0
54;2021-10-14;263;520;743;537253;525083;22459;73.6;71.9;3.1
54;2021-10-15;418;638;1463;537671;525721;23922;73.6;72.0;3.3
54;2021-10-16;379;521;747;538050;526242;24669;73.7;72.0;3.4
54;2021-10-17;9;19;12;538059;526261;24681;73.7;72.1;3.4
54;2021-10-18;251;392;677;538310;526653;25358;73.7;72.1;3.5
54;2021-10-19;233;325;1096;538543;526978;26454;73.7;72.1;3.6
54;2021-10-20;321;451;1370;538864;527429;27824;73.8;72.2;3.8
54;2021-10-21;138;257;826;539002;527686;28650;73.8;72.2;3.9
54;2021-10-22;369;566;1583;539371;528252;30233;73.8;72.3;4.1
54;2021-10-23;297;415;663;539668;528667;30896;73.9;72.4;4.2
54;2021-10-24;9;5;1;539677;528672;30897;73.9;72.4;4.2
54;2021-10-25;220;266;863;539897;528938;31760;73.9;72.4;4.3
54;2021-10-26;158;201;1019;540055;529139;32779;73.9;72.4;4.5
54;2021-10-27;285;371;1479;540340;529510;34258;74.0;72.5;4.7
54;2021-10-28;140;195;898;540480;529705;35156;74.0;72.5;4.8
54;2021-10-29;271;419;1775;540751;530124;36931;74.0;72.6;5.1
54;2021-10-30;251;366;1074;541002;530490;38005;74.1;72.6;5.2
54;2021-10-31;5;19;14;541007;530509;38019;74.1;72.6;5.2
54;2021-11-01;80;37;113;541087;530546;38132;74.1;72.6;5.2
54;2021-11-02;198;322;979;541285;530868;39111;74.1;72.7;5.4
54;2021-11-03;325;455;1633;541610;531323;40744;74.2;72.7;5.6
54;2021-11-04;189;244;1067;541799;531567;41811;74.2;72.8;5.7
54;2021-11-05;311;438;1951;542110;532005;43762;74.2;72.8;6.0
54;2021-11-06;264;416;1171;542374;532421;44933;74.3;72.9;6.2
54;2021-11-07;10;18;72;542384;532439;45005;74.3;72.9;6.2
54;2021-11-08;194;276;1409;542578;532715;46414;74.3;72.9;6.4
54;2021-11-09;175;282;1788;542753;532997;48202;74.3;73.0;6.6
54;2021-11-10;328;379;2501;543081;533376;50703;74.4;73.0;6.9
54;2021-11-11;76;91;288;543157;533467;50991;74.4;73.0;7.0
54;2021-11-12;304;440;2592;543461;533907;53583;74.4;73.1;7.3
54;2021-11-13;209;329;1348;543670;534236;54931;74.4;73.1;7.5
54;2021-11-14;3;12;15;543673;534248;54946;74.4;73.1;7.5
54;2021-11-15;179;244;1820;543852;534492;56766;74.5;73.2;7.8
54;2021-11-16;167;221;1965;544019;534713;58731;74.5;73.2;8.0
54;2021-11-17;279;319;2585;544298;535032;61316;74.5;73.3;8.4
54;2021-11-18;150;177;2056;544448;535209;63372;74.5;73.3;8.7
54;2021-11-19;318;382;3021;544766;535591;66393;74.6;73.3;9.1
54;2021-11-20;256;350;1578;545022;535941;67971;74.6;73.4;9.3
54;2021-11-21;24;27;183;545046;535968;68154;74.6;73.4;9.3
54;2021-11-22;224;206;1768;545270;536174;69922;74.7;73.4;9.6
54;2021-11-23;187;180;2114;545457;536354;72036;74.7;73.4;9.9
54;2021-11-24;319;314;2641;545776;536668;74677;74.7;73.5;10.2
54;2021-11-25;179;166;2782;545955;536834;77459;74.7;73.5;10.6
54;2021-11-26;309;357;5187;546264;537191;82646;74.8;73.5;11.3
54;2021-11-27;275;329;3774;546539;537520;86420;74.8;73.6;11.8
54;2021-11-28;17;26;583;546556;537546;87003;74.8;73.6;11.9
54;2021-11-29;146;206;4189;546702;537752;91192;74.8;73.6;12.5
54;2021-11-30;159;183;4782;546861;537935;95974;74.9;73.6;13.1
54;2021-12-01;225;328;7613;547086;538263;103587;74.9;73.7;14.2
54;2021-12-02;175;167;6273;547261;538430;109860;74.9;73.7;15.0
54;2021-12-03;285;350;8873;547546;538780;118733;75.0;73.8;16.3
54;2021-12-04;220;309;5313;547766;539089;124046;75.0;73.8;17.0
54;2021-12-05;20;14;495;547786;539103;124541;75.0;73.8;17.1
54;2021-12-06;247;266;6856;548033;539369;131397;75.0;73.8;18.0
54;2021-12-07;203;242;7237;548236;539611;138634;75.1;73.9;19.0
54;2021-12-08;283;356;8416;548519;539967;147050;75.1;73.9;20.1
54;2021-12-09;206;244;7975;548725;540211;155025;75.1;74.0;21.2
54;2021-12-10;328;327;10103;549053;540538;165128;75.2;74.0;22.6
54;2021-12-11;258;323;6076;549311;540861;171204;75.2;74.1;23.4
54;2021-12-12;33;37;579;549344;540898;171783;75.2;74.1;23.5
54;2021-12-13;274;280;7240;549618;541178;179023;75.2;74.1;24.5
54;2021-12-14;264;293;8017;549882;541471;187040;75.3;74.1;25.6
54;2021-12-15;402;393;9485;550284;541864;196525;75.3;74.2;26.9
54;2021-12-16;198;266;7804;550482;542130;204329;75.4;74.2;28.0
55;2020-12-27;0;0;0;0;0;0;0.0;0.0;0.0
55;2020-12-28;2;0;0;2;0;0;0.0;0.0;0.0
55;2020-12-29;0;0;0;2;0;0;0.0;0.0;0.0
55;2020-12-30;0;0;0;2;0;0;0.0;0.0;0.0
55;2020-12-31;0;0;0;2;0;0;0.0;0.0;0.0
55;2021-01-01;0;0;0;2;0;0;0.0;0.0;0.0
55;2021-01-02;0;0;0;2;0;0;0.0;0.0;0.0
55;2021-01-03;0;0;0;2;0;0;0.0;0.0;0.0
55;2021-01-04;2;0;0;4;0;0;0.0;0.0;0.0
55;2021-01-05;4;0;0;8;0;0;0.0;0.0;0.0
55;2021-01-06;7;0;0;15;0;0;0.0;0.0;0.0
55;2021-01-07;121;0;0;136;0;0;0.1;0.0;0.0
55;2021-01-08;145;0;0;281;0;0;0.2;0.0;0.0
55;2021-01-09;28;0;0;309;0;0;0.2;0.0;0.0
55;2021-01-10;1;0;0;310;0;0;0.2;0.0;0.0
55;2021-01-11;155;1;0;465;1;0;0.3;0.0;0.0
55;2021-01-12;136;0;0;601;1;0;0.3;0.0;0.0
55;2021-01-13;177;0;0;778;1;0;0.4;0.0;0.0
55;2021-01-14;642;7;0;1420;8;0;0.8;0.0;0.0
55;2021-01-15;270;0;0;1690;8;0;0.9;0.0;0.0
55;2021-01-16;67;0;0;1757;8;0;1.0;0.0;0.0
55;2021-01-17;3;0;0;1760;8;0;1.0;0.0;0.0
55;2021-01-18;461;1;0;2221;9;0;1.2;0.0;0.0
55;2021-01-19;383;4;0;2604;13;0;1.4;0.0;0.0
55;2021-01-20;452;2;0;3056;15;0;1.7;0.0;0.0
55;2021-01-21;439;2;0;3495;17;0;1.9;0.0;0.0
55;2021-01-22;387;0;0;3882;17;0;2.1;0.0;0.0
55;2021-01-23;54;0;0;3936;17;0;2.2;0.0;0.0
55;2021-01-24;1;0;0;3937;17;0;2.2;0.0;0.0
55;2021-01-25;408;0;0;4345;17;0;2.4;0.0;0.0
55;2021-01-26;439;0;0;4784;17;0;2.6;0.0;0.0
55;2021-01-27;384;1;0;5168;18;0;2.8;0.0;0.0
55;2021-01-28;477;91;0;5645;109;0;3.1;0.1;0.0
55;2021-01-29;155;76;0;5800;185;0;3.2;0.1;0.0
55;2021-01-30;99;19;0;5899;204;0;3.2;0.1;0.0
55;2021-01-31;0;0;0;5899;204;0;3.2;0.1;0.0
55;2021-02-01;139;178;0;6038;382;0;3.3;0.2;0.0
55;2021-02-02;164;157;0;6202;539;0;3.4;0.3;0.0
55;2021-02-03;61;182;0;6263;721;0;3.4;0.4;0.0
55;2021-02-04;230;418;0;6493;1139;0;3.6;0.6;0.0
55;2021-02-05;197;175;0;6690;1314;0;3.7;0.7;0.0
55;2021-02-06;60;58;0;6750;1372;0;3.7;0.8;0.0
55;2021-02-07;4;48;0;6754;1420;0;3.7;0.8;0.0
55;2021-02-08;11;46;0;6765;1466;0;3.7;0.8;0.0
55;2021-02-09;106;132;0;6871;1598;0;3.8;0.9;0.0
55;2021-02-10;81;36;0;6952;1634;0;3.8;0.9;0.0
55;2021-02-11;174;82;0;7126;1716;0;3.9;0.9;0.0
55;2021-02-12;115;47;0;7241;1763;0;4.0;1.0;0.0
55;2021-02-13;12;5;0;7253;1768;0;4.0;1.0;0.0
55;2021-02-14;5;1;0;7258;1769;0;4.0;1.0;0.0
55;2021-02-15;24;433;0;7282;2202;0;4.0;1.2;0.0
55;2021-02-16;141;420;0;7423;2622;0;4.1;1.4;0.0
55;2021-02-17;34;492;0;7457;3114;0;4.1;1.7;0.0
55;2021-02-18;33;338;0;7490;3452;0;4.1;1.9;0.0
55;2021-02-19;145;291;0;7635;3743;0;4.2;2.1;0.0
55;2021-02-20;12;6;0;7647;3749;0;4.2;2.1;0.0
55;2021-02-21;0;0;0;7647;3749;0;4.2;2.1;0.0
55;2021-02-22;61;425;0;7708;4174;0;4.2;2.3;0.0
55;2021-02-23;88;442;0;7796;4616;0;4.3;2.5;0.0
55;2021-02-24;93;381;0;7889;4997;0;4.3;2.8;0.0
55;2021-02-25;282;687;0;8171;5684;0;4.5;3.1;0.0
55;2021-02-26;350;240;0;8521;5924;0;4.7;3.3;0.0
55;2021-02-27;137;87;0;8658;6011;0;4.8;3.3;0.0
55;2021-02-28;9;6;0;8667;6017;0;4.8;3.3;0.0
55;2021-03-01;108;147;0;8775;6164;0;4.8;3.4;0.0
55;2021-03-02;173;178;0;8948;6342;0;4.9;3.5;0.0
55;2021-03-03;232;13;0;9180;6355;0;5.1;3.5;0.0
55;2021-03-04;276;52;0;9456;6407;0;5.2;3.5;0.0
55;2021-03-05;427;63;0;9883;6470;0;5.4;3.6;0.0
55;2021-03-06;310;13;0;10193;6483;0;5.6;3.6;0.0
55;2021-03-07;141;3;0;10334;6486;0;5.7;3.6;0.0
55;2021-03-08;375;53;0;10709;6539;0;5.9;3.6;0.0
55;2021-03-09;669;59;0;11378;6598;0;6.3;3.6;0.0
55;2021-03-10;439;36;0;11817;6634;0;6.5;3.7;0.0
55;2021-03-11;622;152;0;12439;6786;0;6.8;3.7;0.0
55;2021-03-12;876;107;0;13315;6893;0;7.3;3.8;0.0
55;2021-03-13;586;25;0;13901;6918;0;7.7;3.8;0.0
55;2021-03-14;51;2;0;13952;6920;0;7.7;3.8;0.0
55;2021-03-15;425;31;0;14377;6951;0;7.9;3.8;0.0
55;2021-03-16;616;117;0;14993;7068;0;8.3;3.9;0.0
55;2021-03-17;727;28;0;15720;7096;0;8.7;3.9;0.0
55;2021-03-18;390;33;0;16110;7129;0;8.9;3.9;0.0
55;2021-03-19;513;72;0;16623;7201;0;9.2;4.0;0.0
55;2021-03-20;294;16;0;16917;7217;0;9.3;4.0;0.0
55;2021-03-21;9;1;0;16926;7218;0;9.3;4.0;0.0
55;2021-03-22;517;30;0;17443;7248;0;9.6;4.0;0.0
55;2021-03-23;1036;78;0;18479;7326;0;10.2;4.0;0.0
55;2021-03-24;852;67;0;19331;7393;0;10.6;4.1;0.0
55;2021-03-25;1142;91;0;20473;7484;0;11.3;4.1;0.0
55;2021-03-26;678;60;0;21151;7544;0;11.6;4.2;0.0
55;2021-03-27;309;37;0;21460;7581;0;11.8;4.2;0.0
55;2021-03-28;2;6;0;21462;7587;0;11.8;4.2;0.0
55;2021-03-29;933;67;0;22395;7654;0;12.3;4.2;0.0
55;2021-03-30;1419;102;0;23814;7756;0;13.1;4.3;0.0
55;2021-03-31;1441;104;0;25255;7860;0;13.9;4.3;0.0
55;2021-04-01;1217;174;0;26472;8034;0;14.6;4.4;0.0
55;2021-04-02;903;102;0;27375;8136;0;15.1;4.5;0.0
55;2021-04-03;220;37;0;27595;8173;0;15.2;4.5;0.0
55;2021-04-04;14;16;0;27609;8189;0;15.2;4.5;0.0
55;2021-04-05;9;20;0;27618;8209;0;15.2;4.5;0.0
55;2021-04-06;895;319;0;28513;8528;0;15.7;4.7;0.0
55;2021-04-07;903;291;0;29416;8819;0;16.2;4.9;0.0
55;2021-04-08;1568;443;0;30984;9262;0;17.1;5.1;0.0
55;2021-04-09;1353;301;0;32337;9563;0;17.8;5.3;0.0
55;2021-04-10;270;209;0;32607;9772;0;18.0;5.4;0.0
55;2021-04-11;507;50;0;33114;9822;0;18.2;5.4;0.0
55;2021-04-12;786;370;0;33900;10192;0;18.7;5.6;0.0
55;2021-04-13;1214;564;0;35114;10756;0;19.3;5.9;0.0
55;2021-04-14;1287;779;0;36401;11535;0;20.0;6.4;0.0
55;2021-04-15;1508;491;0;37909;12026;0;20.9;6.6;0.0
55;2021-04-16;730;402;0;38639;12428;0;21.3;6.8;0.0
55;2021-04-17;713;83;0;39352;12511;0;21.7;6.9;0.0
55;2021-04-18;41;26;0;39393;12537;0;21.7;6.9;0.0
55;2021-04-19;852;421;0;40245;12958;0;22.2;7.1;0.0
55;2021-04-20;1078;802;0;41323;13760;0;22.7;7.6;0.0
55;2021-04-21;898;678;0;42221;14438;0;23.2;7.9;0.0
55;2021-04-22;1002;738;0;43223;15176;0;23.8;8.4;0.0
55;2021-04-23;1311;633;0;44534;15809;0;24.5;8.7;0.0
55;2021-04-24;365;158;0;44899;15967;0;24.7;8.8;0.0
55;2021-04-25;342;49;0;45241;16016;0;24.9;8.8;0.0
55;2021-04-26;435;793;0;45676;16809;0;25.1;9.3;0.0
55;2021-04-27;562;983;0;46238;17792;0;25.5;9.8;0.0
55;2021-04-28;869;827;0;47107;18619;0;25.9;10.3;0.0
55;2021-04-29;1067;842;0;48174;19461;0;26.5;10.7;0.0
55;2021-04-30;1243;623;0;49417;20084;0;27.2;11.1;0.0
55;2021-05-01;132;136;0;49549;20220;0;27.3;11.1;0.0
55;2021-05-02;13;6;0;49562;20226;0;27.3;11.1;0.0
55;2021-05-03;1160;627;0;50722;20853;0;27.9;11.5;0.0
55;2021-05-04;735;1081;0;51457;21934;0;28.3;12.1;0.0
55;2021-05-05;801;946;0;52258;22880;0;28.8;12.6;0.0
55;2021-05-06;1460;1089;0;53718;23969;0;29.6;13.2;0.0
55;2021-05-07;1441;568;0;55159;24537;0;30.4;13.5;0.0
55;2021-05-08;165;78;0;55324;24615;0;30.5;13.6;0.0
55;2021-05-09;133;450;0;55457;25065;0;30.5;13.8;0.0
55;2021-05-10;911;929;0;56368;25994;0;31.0;14.3;0.0
55;2021-05-11;1200;1256;0;57568;27250;0;31.7;15.0;0.0
55;2021-05-12;1106;1599;0;58674;28849;0;32.3;15.9;0.0
55;2021-05-13;288;88;0;58962;28937;0;32.5;15.9;0.0
55;2021-05-14;597;570;0;59559;29507;0;32.8;16.2;0.0
55;2021-05-15;415;500;0;59974;30007;0;33.0;16.5;0.0
55;2021-05-16;82;17;0;60056;30024;0;33.1;16.5;0.0
55;2021-05-17;1114;774;0;61170;30798;0;33.7;17.0;0.0
55;2021-05-18;1627;839;0;62797;31637;0;34.6;17.4;0.0
55;2021-05-19;1788;737;0;64585;32374;0;35.6;17.8;0.0
55;2021-05-20;2293;692;0;66878;33066;0;36.8;18.2;0.0
55;2021-05-21;1981;795;0;68859;33861;0;37.9;18.6;0.0
55;2021-05-22;325;198;0;69184;34059;0;38.1;18.8;0.0
55;2021-05-23;58;99;0;69242;34158;0;38.1;18.8;0.0
55;2021-05-24;95;8;0;69337;34166;0;38.2;18.8;0.0
55;2021-05-25;1328;628;0;70665;34794;0;38.9;19.2;0.0
55;2021-05-26;1573;965;0;72238;35759;0;39.8;19.7;0.0
55;2021-05-27;1374;965;0;73612;36724;0;40.5;20.2;0.0
55;2021-05-28;1532;918;0;75144;37642;0;41.4;20.7;0.0
55;2021-05-29;1221;661;0;76365;38303;0;42.0;21.1;0.0
55;2021-05-30;27;197;0;76392;38500;0;42.1;21.2;0.0
55;2021-05-31;1002;1039;0;77394;39539;0;42.6;21.8;0.0
55;2021-06-01;890;889;0;78284;40428;0;43.1;22.3;0.0
55;2021-06-02;1134;953;0;79418;41381;0;43.7;22.8;0.0
55;2021-06-03;821;588;0;80239;41969;0;44.2;23.1;0.0
55;2021-06-04;1381;1076;0;81620;43045;0;44.9;23.7;0.0
55;2021-06-05;1242;302;0;82862;43347;0;45.6;23.9;0.0
55;2021-06-06;15;7;0;82877;43354;0;45.6;23.9;0.0
55;2021-06-07;832;703;0;83709;44057;0;46.1;24.3;0.0
55;2021-06-08;803;1045;0;84512;45102;0;46.5;24.8;0.0
55;2021-06-09;942;818;0;85454;45920;0;47.0;25.3;0.0
55;2021-06-10;549;372;0;86003;46292;0;47.3;25.5;0.0
55;2021-06-11;633;1268;0;86636;47560;0;47.7;26.2;0.0
55;2021-06-12;772;534;0;87408;48094;0;48.1;26.5;0.0
55;2021-06-13;261;42;0;87669;48136;0;48.3;26.5;0.0
55;2021-06-14;433;1315;0;88102;49451;0;48.5;27.2;0.0
55;2021-06-15;611;1328;0;88713;50779;0;48.8;28.0;0.0
55;2021-06-16;786;970;0;89499;51749;0;49.3;28.5;0.0
55;2021-06-17;492;960;0;89991;52709;0;49.5;29.0;0.0
55;2021-06-18;697;1557;0;90688;54266;0;49.9;29.9;0.0
55;2021-06-19;651;504;0;91339;54770;0;50.3;30.2;0.0
55;2021-06-20;16;40;0;91355;54810;0;50.3;30.2;0.0
55;2021-06-21;474;1163;0;91829;55973;0;50.6;30.8;0.0
55;2021-06-22;408;1169;0;92237;57142;0;50.8;31.5;0.0
55;2021-06-23;682;1282;0;92919;58424;0;51.2;32.2;0.0
55;2021-06-24;249;590;0;93168;59014;0;51.3;32.5;0.0
55;2021-06-25;693;1393;0;93861;60407;0;51.7;33.3;0.0
55;2021-06-26;492;479;0;94353;60886;0;51.9;33.5;0.0
55;2021-06-27;7;50;0;94360;60936;0;51.9;33.5;0.0
55;2021-06-28;203;1459;0;94563;62395;0;52.1;34.4;0.0
55;2021-06-29;256;1377;0;94819;63772;0;52.2;35.1;0.0
55;2021-06-30;326;2006;0;95145;65778;0;52.4;36.2;0.0
55;2021-07-01;445;2033;0;95590;67811;0;52.6;37.3;0.0
55;2021-07-02;454;1804;0;96044;69615;0;52.9;38.3;0.0
55;2021-07-03;209;362;0;96253;69977;0;53.0;38.5;0.0
55;2021-07-04;38;56;0;96291;70033;0;53.0;38.6;0.0
55;2021-07-05;256;1551;0;96547;71584;0;53.2;39.4;0.0
55;2021-07-06;377;1043;0;96924;72627;0;53.4;40.0;0.0
55;2021-07-07;419;1837;0;97343;74464;0;53.6;41.0;0.0
55;2021-07-08;630;1633;0;97973;76097;0;53.9;41.9;0.0
55;2021-07-09;551;1587;0;98524;77684;0;54.2;42.8;0.0
55;2021-07-10;399;1066;0;98923;78750;0;54.5;43.4;0.0
55;2021-07-11;6;25;0;98929;78775;0;54.5;43.4;0.0
55;2021-07-12;633;1242;0;99562;80017;0;54.8;44.1;0.0
55;2021-07-13;718;1508;0;100280;81525;0;55.2;44.9;0.0
55;2021-07-14;91;75;0;100371;81600;0;55.3;44.9;0.0
55;2021-07-15;865;1705;0;101236;83305;0;55.7;45.9;0.0
55;2021-07-16;1262;1816;0;102498;85121;0;56.4;46.9;0.0
55;2021-07-17;1315;922;0;103813;86043;0;57.2;47.4;0.0
55;2021-07-18;39;37;0;103852;86080;0;57.2;47.4;0.0
55;2021-07-19;653;925;0;104505;87005;0;57.5;47.9;0.0
55;2021-07-20;1064;1152;0;105569;88157;0;58.1;48.5;0.0
55;2021-07-21;1478;1408;0;107047;89565;0;58.9;49.3;0.0
55;2021-07-22;1288;772;0;108335;90337;0;59.6;49.7;0.0
55;2021-07-23;1262;1496;0;109597;91833;0;60.3;50.6;0.0
55;2021-07-24;860;828;0;110457;92661;0;60.8;51.0;0.0
55;2021-07-25;131;233;0;110588;92894;0;60.9;51.1;0.0
55;2021-07-26;760;587;0;111348;93481;0;61.3;51.5;0.0
55;2021-07-27;1259;618;0;112607;94099;0;62.0;51.8;0.0
55;2021-07-28;1230;1153;0;113837;95252;0;62.7;52.4;0.0
55;2021-07-29;920;596;0;114757;95848;0;63.2;52.8;0.0
55;2021-07-30;1420;1092;0;116177;96940;0;64.0;53.4;0.0
55;2021-07-31;873;707;0;117050;97647;0;64.4;53.8;0.0
55;2021-08-01;57;16;0;117107;97663;0;64.5;53.8;0.0
55;2021-08-02;755;536;0;117862;98199;0;64.9;54.1;0.0
55;2021-08-03;833;529;0;118695;98728;0;65.3;54.4;0.0
55;2021-08-04;1403;952;0;120098;99680;0;66.1;54.9;0.0
55;2021-08-05;1179;403;0;121277;100083;0;66.8;55.1;0.0
55;2021-08-06;1043;1162;0;122320;101245;0;67.3;55.7;0.0
55;2021-08-07;697;446;0;123017;101691;0;67.7;56.0;0.0
55;2021-08-08;63;16;0;123080;101707;0;67.8;56.0;0.0
55;2021-08-09;499;464;0;123579;102171;0;68.0;56.2;0.0
55;2021-08-10;536;836;0;124115;103007;0;68.3;56.7;0.0
55;2021-08-11;726;725;0;124841;103732;0;68.7;57.1;0.0
55;2021-08-12;500;624;0;125341;104356;0;69.0;57.5;0.0
55;2021-08-13;553;1210;0;125894;105566;0;69.3;58.1;0.0
55;2021-08-14;254;344;0;126148;105910;0;69.4;58.3;0.0
55;2021-08-15;39;26;0;126187;105936;0;69.5;58.3;0.0
55;2021-08-16;325;817;0;126512;106753;0;69.6;58.8;0.0
55;2021-08-17;355;450;0;126867;107203;0;69.8;59.0;0.0
55;2021-08-18;569;1322;0;127436;108525;0;70.2;59.7;0.0
55;2021-08-19;527;1039;0;127963;109564;0;70.4;60.3;0.0
55;2021-08-20;618;1171;0;128581;110735;0;70.8;61.0;0.0
55;2021-08-21;344;804;0;128925;111539;0;71.0;61.4;0.0
55;2021-08-22;18;41;0;128943;111580;0;71.0;61.4;0.0
55;2021-08-23;332;728;0;129275;112308;0;71.2;61.8;0.0
55;2021-08-24;335;891;0;129610;113199;0;71.4;62.3;0.0
55;2021-08-25;705;1253;0;130315;114452;0;71.7;63.0;0.0
55;2021-08-26;450;1335;0;130765;115787;0;72.0;63.7;0.0
55;2021-08-27;352;1476;0;131117;117263;0;72.2;64.6;0.0
55;2021-08-28;374;739;0;131491;118002;0;72.4;65.0;0.0
55;2021-08-29;191;57;0;131682;118059;0;72.5;65.0;0.0
55;2021-08-30;142;799;9;131824;118858;9;72.6;65.4;0.0
55;2021-08-31;306;941;24;132130;119799;33;72.7;66.0;0.0
55;2021-09-01;546;1339;62;132676;121138;95;73.0;66.7;0.1
55;2021-09-02;246;999;82;132922;122137;177;73.2;67.2;0.1
55;2021-09-03;399;1144;208;133321;123281;385;73.4;67.9;0.2
55;2021-09-04;299;721;22;133620;124002;407;73.6;68.3;0.2
55;2021-09-05;17;89;1;133637;124091;408;73.6;68.3;0.2
55;2021-09-06;78;223;9;133715;124314;417;73.6;68.4;0.2
55;2021-09-07;265;471;188;133980;124785;605;73.8;68.7;0.3
55;2021-09-08;224;378;64;134204;125163;669;73.9;68.9;0.4
55;2021-09-09;218;623;70;134422;125786;739;74.0;69.2;0.4
55;2021-09-10;209;543;139;134631;126329;878;74.1;69.5;0.5
55;2021-09-11;134;399;42;134765;126728;920;74.2;69.8;0.5
55;2021-09-12;3;10;0;134768;126738;920;74.2;69.8;0.5
55;2021-09-13;119;356;122;134887;127094;1042;74.3;70.0;0.6
55;2021-09-14;293;225;126;135180;127319;1168;74.4;70.1;0.6
55;2021-09-15;285;703;228;135465;128022;1396;74.6;70.5;0.8
55;2021-09-16;116;222;117;135581;128244;1513;74.6;70.6;0.8
55;2021-09-17;118;195;127;135699;128439;1640;74.7;70.7;0.9
55;2021-09-18;143;428;79;135842;128867;1719;74.8;70.9;0.9
55;2021-09-19;4;12;3;135846;128879;1722;74.8;71.0;0.9
55;2021-09-20;72;166;34;135918;129045;1756;74.8;71.0;1.0
55;2021-09-21;119;283;232;136037;129328;1988;74.9;71.2;1.1
55;2021-09-22;122;378;102;136159;129706;2090;75.0;71.4;1.2
55;2021-09-23;101;373;272;136260;130079;2362;75.0;71.6;1.3
55;2021-09-24;100;340;202;136360;130419;2564;75.1;71.8;1.4
55;2021-09-25;67;201;54;136427;130620;2618;75.1;71.9;1.4
55;2021-09-26;1;1;0;136428;130621;2618;75.1;71.9;1.4
55;2021-09-27;51;136;132;136479;130757;2750;75.1;72.0;1.5
55;2021-09-28;65;95;105;136544;130852;2855;75.2;72.0;1.6
55;2021-09-29;154;792;199;136698;131644;3054;75.3;72.5;1.7
55;2021-09-30;71;312;174;136769;131956;3228;75.3;72.6;1.8
55;2021-10-01;74;222;154;136843;132178;3382;75.3;72.8;1.9
55;2021-10-02;116;389;82;136959;132567;3464;75.4;73.0;1.9
55;2021-10-03;3;3;0;136962;132570;3464;75.4;73.0;1.9
55;2021-10-04;110;255;255;137072;132825;3719;75.5;73.1;2.0
55;2021-10-05;75;194;186;137147;133019;3905;75.5;73.2;2.1
55;2021-10-06;105;329;175;137252;133348;4080;75.6;73.4;2.2
55;2021-10-07;67;93;184;137319;133441;4264;75.6;73.5;2.3
55;2021-10-08;80;145;127;137399;133586;4391;75.6;73.5;2.4
55;2021-10-09;88;226;118;137487;133812;4509;75.7;73.7;2.5
55;2021-10-10;18;161;20;137505;133973;4529;75.7;73.8;2.5
55;2021-10-11;72;115;134;137577;134088;4663;75.7;73.8;2.6
55;2021-10-12;87;322;257;137664;134410;4920;75.8;74.0;2.7
55;2021-10-13;110;137;281;137774;134547;5201;75.8;74.1;2.9
55;2021-10-14;38;76;118;137812;134623;5319;75.9;74.1;2.9
55;2021-10-15;72;141;150;137884;134764;5469;75.9;74.2;3.0
55;2021-10-16;63;94;95;137947;134858;5564;75.9;74.2;3.1
55;2021-10-17;10;18;11;137957;134876;5575;76.0;74.3;3.1
55;2021-10-18;73;102;277;138030;134978;5852;76.0;74.3;3.2
55;2021-10-19;48;70;197;138078;135048;6049;76.0;74.3;3.3
55;2021-10-20;53;144;307;138131;135192;6356;76.0;74.4;3.5
55;2021-10-21;40;123;199;138171;135315;6555;76.1;74.5;3.6
55;2021-10-22;58;74;187;138229;135389;6742;76.1;74.5;3.7
55;2021-10-23;89;180;333;138318;135569;7075;76.1;74.6;3.9
55;2021-10-24;1;4;5;138319;135573;7080;76.1;74.6;3.9
55;2021-10-25;82;107;337;138401;135680;7417;76.2;74.7;4.1
55;2021-10-26;39;47;172;138440;135727;7589;76.2;74.7;4.2
55;2021-10-27;74;138;293;138514;135865;7882;76.3;74.8;4.3
55;2021-10-28;41;33;222;138555;135898;8104;76.3;74.8;4.5
55;2021-10-29;66;79;313;138621;135977;8417;76.3;74.9;4.6
55;2021-10-30;18;52;83;138639;136029;8500;76.3;74.9;4.7
55;2021-10-31;0;3;2;138639;136032;8502;76.3;74.9;4.7
55;2021-11-01;8;4;1;138647;136036;8503;76.3;74.9;4.7
55;2021-11-02;27;35;108;138674;136071;8611;76.3;74.9;4.7
55;2021-11-03;42;80;287;138716;136151;8898;76.4;75.0;4.9
55;2021-11-04;110;109;865;138826;136260;9763;76.4;75.0;5.4
55;2021-11-05;19;75;206;138845;136335;9969;76.4;75.1;5.5
55;2021-11-06;85;111;422;138930;136446;10391;76.5;75.1;5.7
55;2021-11-07;5;6;31;138935;136452;10422;76.5;75.1;5.7
55;2021-11-08;70;114;620;139005;136566;11042;76.5;75.2;6.1
55;2021-11-09;28;62;455;139033;136628;11497;76.5;75.2;6.3
55;2021-11-10;61;83;774;139094;136711;12271;76.6;75.3;6.8
55;2021-11-11;2;1;24;139096;136712;12295;76.6;75.3;6.8
55;2021-11-12;40;65;403;139136;136777;12698;76.6;75.3;7.0
55;2021-11-13;35;40;136;139171;136817;12834;76.6;75.3;7.1
55;2021-11-14;4;1;16;139175;136818;12850;76.6;75.3;7.1
55;2021-11-15;58;120;866;139233;136938;13716;76.7;75.4;7.6
55;2021-11-16;34;57;515;139267;136995;14231;76.7;75.4;7.8
55;2021-11-17;76;63;782;139343;137058;15013;76.7;75.5;8.3
55;2021-11-18;51;77;563;139394;137135;15576;76.7;75.5;8.6
55;2021-11-19;58;70;615;139452;137205;16191;76.8;75.5;8.9
55;2021-11-20;66;79;638;139518;137284;16829;76.8;75.6;9.3
55;2021-11-21;3;0;3;139521;137284;16832;76.8;75.6;9.3
55;2021-11-22;46;41;959;139567;137325;17791;76.8;75.6;9.8
55;2021-11-23;57;41;922;139624;137366;18713;76.9;75.6;10.3
55;2021-11-24;60;66;904;139684;137432;19617;76.9;75.7;10.8
55;2021-11-25;48;47;557;139732;137479;20174;76.9;75.7;11.1
55;2021-11-26;88;70;1277;139820;137549;21451;77.0;75.7;11.8
55;2021-11-27;61;66;828;139881;137615;22279;77.0;75.8;12.3
55;2021-11-28;4;7;87;139885;137622;22366;77.0;75.8;12.3
55;2021-11-29;58;117;1104;139943;137739;23470;77.0;75.8;12.9
55;2021-11-30;51;35;1010;139994;137774;24480;77.1;75.8;13.5
55;2021-12-01;53;108;1528;140047;137882;26008;77.1;75.9;14.3
55;2021-12-02;51;30;2030;140098;137912;28038;77.1;75.9;15.4
55;2021-12-03;89;66;1926;140187;137978;29964;77.2;76.0;16.5
55;2021-12-04;75;53;822;140262;138031;30786;77.2;76.0;16.9
55;2021-12-05;8;5;301;140270;138036;31087;77.2;76.0;17.1
55;2021-12-06;38;75;1835;140308;138111;32922;77.2;76.0;18.1
55;2021-12-07;46;37;1524;140354;138148;34446;77.3;76.1;19.0
55;2021-12-08;98;62;2201;140452;138210;36647;77.3;76.1;20.2
55;2021-12-09;66;29;1755;140518;138239;38402;77.4;76.1;21.1
55;2021-12-10;69;58;2117;140587;138297;40519;77.4;76.1;22.3
55;2021-12-11;72;96;2311;140659;138393;42830;77.4;76.2;23.6
55;2021-12-12;8;5;94;140667;138398;42924;77.4;76.2;23.6
55;2021-12-13;53;48;1338;140720;138446;44262;77.5;76.2;24.4
55;2021-12-14;66;63;2356;140786;138509;46618;77.5;76.3;25.7
55;2021-12-15;72;61;1790;140858;138570;48408;77.5;76.3;26.7
55;2021-12-16;57;70;2915;140915;138640;51323;77.6;76.3;28.3
56;2020-12-27;0;0;0;0;0;0;0.0;0.0;0.0
56;2020-12-28;1;0;0;1;0;0;0.0;0.0;0.0
56;2020-12-29;0;0;0;1;0;0;0.0;0.0;0.0
56;2020-12-30;0;0;0;1;0;0;0.0;0.0;0.0
56;2020-12-31;0;0;0;1;0;0;0.0;0.0;0.0
56;2021-01-01;1;0;0;2;0;0;0.0;0.0;0.0
56;2021-01-02;1;0;0;3;0;0;0.0;0.0;0.0
56;2021-01-03;0;0;0;3;0;0;0.0;0.0;0.0
56;2021-01-04;1;0;0;4;0;0;0.0;0.0;0.0
56;2021-01-05;3;0;0;7;0;0;0.0;0.0;0.0
56;2021-01-06;10;0;0;17;0;0;0.0;0.0;0.0
56;2021-01-07;185;0;0;202;0;0;0.0;0.0;0.0
56;2021-01-08;149;1;0;351;1;0;0.0;0.0;0.0
56;2021-01-09;2;0;0;353;1;0;0.0;0.0;0.0
56;2021-01-10;2;0;0;355;1;0;0.0;0.0;0.0
56;2021-01-11;255;0;0;610;1;0;0.1;0.0;0.0
56;2021-01-12;739;15;0;1349;16;0;0.2;0.0;0.0
56;2021-01-13;656;1;0;2005;17;0;0.3;0.0;0.0
56;2021-01-14;961;19;0;2966;36;0;0.4;0.0;0.0
56;2021-01-15;810;6;0;3776;42;0;0.5;0.0;0.0
56;2021-01-16;231;4;0;4007;46;0;0.5;0.0;0.0
56;2021-01-17;28;0;0;4035;46;0;0.5;0.0;0.0
56;2021-01-18;955;2;0;4990;48;0;0.7;0.0;0.0
56;2021-01-19;860;23;0;5850;71;0;0.8;0.0;0.0
56;2021-01-20;905;1;0;6755;72;0;0.9;0.0;0.0
56;2021-01-21;1449;18;0;8204;90;0;1.1;0.0;0.0
56;2021-01-22;1228;4;0;9432;94;0;1.2;0.0;0.0
56;2021-01-23;306;4;0;9738;98;0;1.3;0.0;0.0
56;2021-01-24;7;1;0;9745;99;0;1.3;0.0;0.0
56;2021-01-25;795;5;0;10540;104;0;1.4;0.0;0.0
56;2021-01-26;1001;8;0;11541;112;0;1.5;0.0;0.0
56;2021-01-27;1037;65;0;12578;177;0;1.7;0.0;0.0
56;2021-01-28;1032;110;0;13610;287;0;1.8;0.0;0.0
56;2021-01-29;853;111;0;14463;398;0;1.9;0.1;0.0
56;2021-01-30;145;18;0;14608;416;0;1.9;0.1;0.0
56;2021-01-31;5;3;0;14613;419;0;1.9;0.1;0.0
56;2021-02-01;480;149;0;15093;568;0;2.0;0.1;0.0
56;2021-02-02;844;237;0;15937;805;0;2.1;0.1;0.0
56;2021-02-03;901;250;0;16838;1055;0;2.2;0.1;0.0
56;2021-02-04;4358;379;0;21196;1434;0;2.8;0.2;0.0
56;2021-02-05;3388;465;0;24584;1899;0;3.3;0.3;0.0
56;2021-02-06;524;173;0;25108;2072;0;3.3;0.3;0.0
56;2021-02-07;125;23;0;25233;2095;0;3.3;0.3;0.0
56;2021-02-08;303;308;0;25536;2403;0;3.4;0.3;0.0
56;2021-02-09;772;476;0;26308;2879;0;3.5;0.4;0.0
56;2021-02-10;853;742;0;27161;3621;0;3.6;0.5;0.0
56;2021-02-11;987;1108;0;28148;4729;0;3.7;0.6;0.0
56;2021-02-12;1119;642;0;29267;5371;0;3.9;0.7;0.0
56;2021-02-13;215;125;0;29482;5496;0;3.9;0.7;0.0
56;2021-02-14;6;44;0;29488;5540;0;3.9;0.7;0.0
56;2021-02-15;617;1012;0;30105;6552;0;4.0;0.9;0.0
56;2021-02-16;1189;684;0;31294;7236;0;4.1;1.0;0.0
56;2021-02-17;1137;914;0;32431;8150;0;4.3;1.1;0.0
56;2021-02-18;1368;923;0;33799;9073;0;4.5;1.2;0.0
56;2021-02-19;1392;924;0;35191;9997;0;4.7;1.3;0.0
56;2021-02-20;359;261;0;35550;10258;0;4.7;1.4;0.0
56;2021-02-21;2;2;0;35552;10260;0;4.7;1.4;0.0
56;2021-02-22;395;684;0;35947;10944;0;4.8;1.4;0.0
56;2021-02-23;699;862;0;36646;11806;0;4.9;1.6;0.0
56;2021-02-24;933;1094;0;37579;12900;0;5.0;1.7;0.0
56;2021-02-25;2087;4019;0;39666;16919;0;5.2;2.2;0.0
56;2021-02-26;2292;2100;0;41958;19019;0;5.6;2.5;0.0
56;2021-02-27;731;454;0;42689;19473;0;5.6;2.6;0.0
56;2021-02-28;17;111;0;42706;19584;0;5.7;2.6;0.0
56;2021-03-01;723;551;0;43429;20135;0;5.7;2.7;0.0
56;2021-03-02;1011;786;0;44440;20921;0;5.9;2.8;0.0
56;2021-03-03;1163;896;0;45603;21817;0;6.0;2.9;0.0
56;2021-03-04;1980;1000;0;47583;22817;0;6.3;3.0;0.0
56;2021-03-05;2570;1415;0;50153;24232;0;6.6;3.2;0.0
56;2021-03-06;1216;221;0;51369;24453;0;6.8;3.2;0.0
56;2021-03-07;283;27;0;51652;24480;0;6.8;3.2;0.0
56;2021-03-08;1151;418;0;52803;24898;0;7.0;3.3;0.0
56;2021-03-09;2051;640;0;54854;25538;0;7.3;3.4;0.0
56;2021-03-10;1994;922;0;56848;26460;0;7.5;3.5;0.0
56;2021-03-11;3261;768;0;60109;27228;0;8.0;3.6;0.0
56;2021-03-12;4193;807;0;64302;28035;0;8.5;3.7;0.0
56;2021-03-13;1906;162;0;66208;28197;0;8.8;3.7;0.0
56;2021-03-14;182;6;0;66390;28203;0;8.8;3.7;0.0
56;2021-03-15;1374;541;0;67764;28744;0;9.0;3.8;0.0
56;2021-03-16;1084;1047;0;68848;29791;0;9.1;3.9;0.0
56;2021-03-17;1337;782;0;70185;30573;0;9.3;4.0;0.0
56;2021-03-18;1980;1798;0;72165;32371;0;9.6;4.3;0.0
56;2021-03-19;2927;1375;0;75092;33746;0;9.9;4.5;0.0
56;2021-03-20;1460;198;0;76552;33944;0;10.1;4.5;0.0
56;2021-03-21;185;21;0;76737;33965;0;10.2;4.5;0.0
56;2021-03-22;1596;384;0;78333;34349;0;10.4;4.5;0.0
56;2021-03-23;2770;698;0;81103;35047;0;10.7;4.6;0.0
56;2021-03-24;3389;554;0;84492;35601;0;11.2;4.7;0.0
56;2021-03-25;4208;744;0;88700;36345;0;11.7;4.8;0.0
56;2021-03-26;5084;803;0;93784;37148;0;12.4;4.9;0.0
56;2021-03-27;1488;286;0;95272;37434;0;12.6;5.0;0.0
56;2021-03-28;215;11;0;95487;37445;0;12.6;5.0;0.0
56;2021-03-29;2200;555;0;97687;38000;0;12.9;5.0;0.0
56;2021-03-30;3439;826;0;101126;38826;0;13.4;5.1;0.0
56;2021-03-31;3066;738;0;104192;39564;0;13.8;5.2;0.0
56;2021-04-01;4155;845;0;108347;40409;0;14.3;5.3;0.0
56;2021-04-02;3920;1015;0;112267;41424;0;14.9;5.5;0.0
56;2021-04-03;1152;277;0;113419;41701;0;15.0;5.5;0.0
56;2021-04-04;220;10;0;113639;41711;0;15.0;5.5;0.0
56;2021-04-05;212;13;0;113851;41724;0;15.1;5.5;0.0
56;2021-04-06;2719;1222;0;116570;42946;0;15.4;5.7;0.0
56;2021-04-07;3924;1170;0;120494;44116;0;15.9;5.8;0.0
56;2021-04-08;5276;1195;0;125770;45311;0;16.6;6.0;0.0
56;2021-04-09;7149;1260;0;132919;46571;0;17.6;6.2;0.0
56;2021-04-10;2458;396;0;135377;46967;0;17.9;6.2;0.0
56;2021-04-11;189;104;0;135566;47071;0;17.9;6.2;0.0
56;2021-04-12;3764;871;0;139330;47942;0;18.4;6.3;0.0
56;2021-04-13;5704;1246;0;145034;49188;0;19.2;6.5;0.0
56;2021-04-14;4991;1437;0;150025;50625;0;19.9;6.7;0.0
56;2021-04-15;6832;1729;0;156857;52354;0;20.8;6.9;0.0
56;2021-04-16;7678;1955;0;164535;54309;0;21.8;7.2;0.0
56;2021-04-17;2956;625;0;167491;54934;0;22.2;7.3;0.0
56;2021-04-18;507;105;0;167998;55039;0;22.2;7.3;0.0
56;2021-04-19;3596;1243;0;171594;56282;0;22.7;7.4;0.0
56;2021-04-20;3953;1916;0;175547;58198;0;23.2;7.7;0.0
56;2021-04-21;3930;2322;0;179477;60520;0;23.8;8.0;0.0
56;2021-04-22;5048;1935;0;184525;62455;0;24.4;8.3;0.0
56;2021-04-23;5103;2486;0;189628;64941;0;25.1;8.6;0.0
56;2021-04-24;2805;633;0;192433;65574;0;25.5;8.7;0.0
56;2021-04-25;457;144;0;192890;65718;0;25.5;8.7;0.0
56;2021-04-26;4431;1662;0;197321;67380;0;26.1;8.9;0.0
56;2021-04-27;4892;2478;0;202213;69858;0;26.8;9.2;0.0
56;2021-04-28;4764;2212;0;206977;72070;0;27.4;9.5;0.0
56;2021-04-29;5685;2953;0;212662;75023;0;28.1;9.9;0.0
56;2021-04-30;6086;2704;0;218748;77727;0;29.0;10.3;0.0
56;2021-05-01;2301;339;0;221049;78066;0;29.3;10.3;0.0
56;2021-05-02;259;250;0;221308;78316;0;29.3;10.4;0.0
56;2021-05-03;3708;2010;0;225016;80326;0;29.8;10.6;0.0
56;2021-05-04;4234;3740;0;229250;84066;0;30.3;11.1;0.0
56;2021-05-05;3444;3784;0;232694;87850;0;30.8;11.6;0.0
56;2021-05-06;4314;5296;0;237008;93146;0;31.4;12.3;0.0
56;2021-05-07;4210;4872;0;241218;98018;0;31.9;13.0;0.0
56;2021-05-08;1563;306;0;242781;98324;0;32.1;13.0;0.0
56;2021-05-09;522;229;0;243303;98553;0;32.2;13.0;0.0
56;2021-05-10;3597;3796;0;246900;102349;0;32.7;13.5;0.0
56;2021-05-11;4092;4903;0;250992;107252;0;33.2;14.2;0.0
56;2021-05-12;4197;4549;0;255189;111801;0;33.8;14.8;0.0
56;2021-05-13;2411;960;0;257600;112761;0;34.1;14.9;0.0
56;2021-05-14;4140;4192;0;261740;116953;0;34.6;15.5;0.0
56;2021-05-15;2472;1747;0;264212;118700;0;35.0;15.7;0.0
56;2021-05-16;308;466;0;264520;119166;0;35.0;15.8;0.0
56;2021-05-17;2643;3584;0;267163;122750;0;35.4;16.2;0.0
56;2021-05-18;3670;3980;0;270833;126730;0;35.8;16.8;0.0
56;2021-05-19;3708;3263;0;274541;129993;0;36.3;17.2;0.0
56;2021-05-20;4124;4712;0;278665;134705;0;36.9;17.8;0.0
56;2021-05-21;3998;4979;0;282663;139684;0;37.4;18.5;0.0
56;2021-05-22;1720;2074;0;284383;141758;0;37.6;18.8;0.0
56;2021-05-23;339;184;0;284722;141942;0;37.7;18.8;0.0
56;2021-05-24;2325;496;0;287047;142438;0;38.0;18.9;0.0
56;2021-05-25;3367;4308;0;290414;146746;0;38.4;19.4;0.0
56;2021-05-26;3919;3852;0;294333;150598;0;39.0;19.9;0.0
56;2021-05-27;4600;4782;0;298933;155380;0;39.6;20.6;0.0
56;2021-05-28;4761;5760;0;303694;161140;0;40.2;21.3;0.0
56;2021-05-29;1937;1608;0;305631;162748;0;40.5;21.5;0.0
56;2021-05-30;359;74;0;305990;162822;0;40.5;21.5;0.0
56;2021-05-31;4628;3083;0;310618;165905;0;41.1;22.0;0.0
56;2021-06-01;5699;3370;0;316317;169275;0;41.9;22.4;0.0
56;2021-06-02;5734;2937;0;322051;172212;0;42.6;22.8;0.0
56;2021-06-03;6251;3308;0;328302;175520;0;43.5;23.2;0.0
56;2021-06-04;5874;4354;0;334176;179874;0;44.2;23.8;0.0
56;2021-06-05;4280;2346;0;338456;182220;0;44.8;24.1;0.0
56;2021-06-06;728;621;0;339184;182841;0;44.9;24.2;0.0
56;2021-06-07;5042;3229;0;344226;186070;0;45.6;24.6;0.0
56;2021-06-08;6023;3411;0;350249;189481;0;46.4;25.1;0.0
56;2021-06-09;6310;2846;0;356559;192327;0;47.2;25.5;0.0
56;2021-06-10;7363;2986;0;363922;195313;0;48.2;25.8;0.0
56;2021-06-11;6747;3891;0;370669;199204;0;49.1;26.4;0.0
56;2021-06-12;4999;1985;0;375668;201189;0;49.7;26.6;0.0
56;2021-06-13;2048;402;0;377716;201591;0;50.0;26.7;0.0
56;2021-06-14;3401;4559;1;381117;206150;1;50.4;27.3;0.0
56;2021-06-15;4306;4795;0;385423;210945;1;51.0;27.9;0.0
56;2021-06-16;4657;4351;0;390080;215296;1;51.6;28.5;0.0
56;2021-06-17;4444;4655;0;394524;219951;1;52.2;29.1;0.0
56;2021-06-18;4630;5808;0;399154;225759;1;52.8;29.9;0.0
56;2021-06-19;3756;2078;0;402910;227837;1;53.3;30.2;0.0
56;2021-06-20;1646;355;0;404556;228192;1;53.5;30.2;0.0
56;2021-06-21;3345;4483;0;407901;232675;1;54.0;30.8;0.0
56;2021-06-22;3585;5440;0;411486;238115;1;54.5;31.5;0.0
56;2021-06-23;3888;5052;0;415374;243167;1;55.0;32.2;0.0
56;2021-06-24;3614;5254;0;418988;248421;1;55.5;32.9;0.0
56;2021-06-25;3971;6156;0;422959;254577;1;56.0;33.7;0.0
56;2021-06-26;3138;2919;0;426097;257496;1;56.4;34.1;0.0
56;2021-06-27;505;255;0;426602;257751;1;56.5;34.1;0.0
56;2021-06-28;1664;4144;0;428266;261895;1;56.7;34.7;0.0
56;2021-06-29;2455;5803;0;430721;267698;1;57.0;35.4;0.0
56;2021-06-30;2585;5679;0;433306;273377;1;57.3;36.2;0.0
56;2021-07-01;2882;5084;2;436188;278461;3;57.7;36.9;0.0
56;2021-07-02;2695;6228;0;438883;284689;3;58.1;37.7;0.0
56;2021-07-03;2204;2684;0;441087;287373;3;58.4;38.0;0.0
56;2021-07-04;878;825;0;441965;288198;3;58.5;38.1;0.0
56;2021-07-05;1806;5568;0;443771;293766;3;58.7;38.9;0.0
56;2021-07-06;2159;5986;0;445930;299752;3;59.0;39.7;0.0
56;2021-07-07;2728;5680;0;448658;305432;3;59.4;40.4;0.0
56;2021-07-08;3014;6044;1;451672;311476;4;59.8;41.2;0.0
56;2021-07-09;2144;7098;0;453816;318574;4;60.1;42.2;0.0
56;2021-07-10;1199;3049;0;455015;321623;4;60.2;42.6;0.0
56;2021-07-11;380;475;0;455395;322098;4;60.3;42.6;0.0
56;2021-07-12;2039;6817;1;457434;328915;5;60.5;43.5;0.0
56;2021-07-13;2963;7523;0;460397;336438;5;60.9;44.5;0.0
56;2021-07-14;1672;2574;0;462069;339012;5;61.2;44.9;0.0
56;2021-07-15;3535;7005;0;465604;346017;5;61.6;45.8;0.0
56;2021-07-16;3808;7954;0;469412;353971;5;62.1;46.8;0.0
56;2021-07-17;2126;3596;0;471538;357567;5;62.4;47.3;0.0
56;2021-07-18;280;646;0;471818;358213;5;62.4;47.4;0.0
56;2021-07-19;2641;6378;0;474459;364591;5;62.8;48.3;0.0
56;2021-07-20;3339;7876;0;477798;372467;5;63.2;49.3;0.0
56;2021-07-21;2912;7386;0;480710;379853;5;63.6;50.3;0.0
56;2021-07-22;4118;7855;0;484828;387708;5;64.2;51.3;0.0
56;2021-07-23;4177;8242;0;489005;395950;5;64.7;52.4;0.0
56;2021-07-24;1682;4602;0;490687;400552;5;64.9;53.0;0.0
56;2021-07-25;584;1939;0;491271;402491;5;65.0;53.3;0.0
56;2021-07-26;3352;5453;0;494623;407944;5;65.5;54.0;0.0
56;2021-07-27;4823;6064;0;499446;414008;5;66.1;54.8;0.0
56;2021-07-28;4351;5360;0;503797;419368;5;66.7;55.5;0.0
56;2021-07-29;4924;5493;0;508721;424861;5;67.3;56.2;0.0
56;2021-07-30;5075;5665;0;513796;430526;5;68.0;57.0;0.0
56;2021-07-31;2052;2722;0;515848;433248;5;68.3;57.3;0.0
56;2021-08-01;1201;990;0;517049;434238;5;68.4;57.5;0.0
56;2021-08-02;3920;4435;0;520969;438673;5;69.0;58.1;0.0
56;2021-08-03;5417;4672;0;526386;443345;5;69.7;58.7;0.0
56;2021-08-04;5129;3991;0;531515;447336;5;70.3;59.2;0.0
56;2021-08-05;5288;4160;0;536803;451496;5;71.0;59.8;0.0
56;2021-08-06;4979;4378;0;541782;455874;5;71.7;60.3;0.0
56;2021-08-07;2435;2134;0;544217;458008;5;72.0;60.6;0.0
56;2021-08-08;1547;567;0;545764;458575;5;72.2;60.7;0.0
56;2021-08-09;3277;3876;0;549041;462451;5;72.7;61.2;0.0
56;2021-08-10;4240;4120;0;553281;466571;5;73.2;61.8;0.0
56;2021-08-11;3871;3593;0;557152;470164;5;73.7;62.2;0.0
56;2021-08-12;4011;3938;0;561163;474102;5;74.3;62.7;0.0
56;2021-08-13;3656;4056;0;564819;478158;5;74.8;63.3;0.0
56;2021-08-14;1728;2013;0;566547;480171;5;75.0;63.6;0.0
56;2021-08-15;466;480;1;567013;480651;6;75.0;63.6;0.0
56;2021-08-16;2858;4005;0;569871;484656;6;75.4;64.1;0.0
56;2021-08-17;3433;4296;0;573304;488952;6;75.9;64.7;0.0
56;2021-08-18;3383;3958;2;576687;492910;8;76.3;65.2;0.0
56;2021-08-19;2872;4468;0;579559;497378;8;76.7;65.8;0.0
56;2021-08-20;2707;4632;0;582266;502010;8;77.1;66.4;0.0
56;2021-08-21;1216;2180;0;583482;504190;8;77.2;66.7;0.0
56;2021-08-22;261;540;0;583743;504730;8;77.3;66.8;0.0
56;2021-08-23;1883;4524;0;585626;509254;8;77.5;67.4;0.0
56;2021-08-24;1895;4984;0;587521;514238;8;77.8;68.1;0.0
56;2021-08-25;1670;4622;0;589191;518860;8;78.0;68.7;0.0
56;2021-08-26;1412;4929;0;590603;523789;8;78.2;69.3;0.0
56;2021-08-27;1732;5417;0;592335;529206;8;78.4;70.0;0.0
56;2021-08-28;655;2682;0;592990;531888;8;78.5;70.4;0.0
56;2021-08-29;145;505;0;593135;532393;8;78.5;70.5;0.0
56;2021-08-30;1361;4387;122;594496;536780;130;78.7;71.0;0.0
56;2021-08-31;1471;4403;140;595967;541183;270;78.9;71.6;0.0
56;2021-09-01;1363;3726;240;597330;544909;510;79.1;72.1;0.1
56;2021-09-02;1096;3600;316;598426;548509;826;79.2;72.6;0.1
56;2021-09-03;1116;4056;350;599542;552565;1176;79.4;73.1;0.2
56;2021-09-04;791;2341;98;600333;554906;1274;79.5;73.4;0.2
56;2021-09-05;160;461;15;600493;555367;1289;79.5;73.5;0.2
56;2021-09-06;851;3002;464;601344;558369;1753;79.6;73.9;0.2
56;2021-09-07;801;2898;473;602145;561267;2226;79.7;74.3;0.3
56;2021-09-08;977;3169;227;603122;564436;2453;79.8;74.7;0.3
56;2021-09-09;811;2612;376;603933;567048;2829;79.9;75.0;0.4
56;2021-09-10;914;3091;365;604847;570139;3194;80.1;75.5;0.4
56;2021-09-11;503;2052;96;605350;572191;3290;80.1;75.7;0.4
56;2021-09-12;72;309;8;605422;572500;3298;80.1;75.8;0.4
56;2021-09-13;756;2113;572;606178;574613;3870;80.2;76.1;0.5
56;2021-09-14;715;1926;1019;606893;576539;4889;80.3;76.3;0.6
56;2021-09-15;723;2565;548;607616;579104;5437;80.4;76.6;0.7
56;2021-09-16;704;1629;1004;608320;580733;6441;80.5;76.9;0.9
56;2021-09-17;774;2167;738;609094;582900;7179;80.6;77.1;1.0
56;2021-09-18;313;1812;168;609407;584712;7347;80.7;77.4;1.0
56;2021-09-19;73;280;17;609480;584992;7364;80.7;77.4;1.0
56;2021-09-20;454;1335;807;609934;586327;8171;80.7;77.6;1.1
56;2021-09-21;483;1203;914;610417;587530;9085;80.8;77.8;1.2
56;2021-09-22;470;1797;587;610887;589327;9672;80.9;78.0;1.3
56;2021-09-23;500;1038;1128;611387;590365;10800;80.9;78.1;1.4
56;2021-09-24;570;1639;978;611957;592004;11778;81.0;78.4;1.6
56;2021-09-25;290;1165;216;612247;593169;11994;81.0;78.5;1.6
56;2021-09-26;19;118;19;612266;593287;12013;81.0;78.5;1.6
56;2021-09-27;439;1000;785;612705;594287;12798;81.1;78.7;1.7
56;2021-09-28;442;938;884;613147;595225;13682;81.2;78.8;1.8
56;2021-09-29;412;1190;644;613559;596415;14326;81.2;78.9;1.9
56;2021-09-30;338;622;859;613897;597037;15185;81.2;79.0;2.0
56;2021-10-01;521;1193;1248;614418;598230;16433;81.3;79.2;2.2
56;2021-10-02;209;485;202;614627;598715;16635;81.3;79.2;2.2
56;2021-10-03;5;68;9;614632;598783;16644;81.3;79.2;2.2
56;2021-10-04;312;769;792;614944;599552;17436;81.4;79.4;2.3
56;2021-10-05;256;651;761;615200;600203;18197;81.4;79.4;2.4
56;2021-10-06;406;955;625;615606;601158;18822;81.5;79.6;2.5
56;2021-10-07;300;864;1151;615906;602022;19973;81.5;79.7;2.6
56;2021-10-08;442;933;976;616348;602955;20949;81.6;79.8;2.8
56;2021-10-09;156;395;235;616504;603350;21184;81.6;79.9;2.8
56;2021-10-10;8;58;9;616512;603408;21193;81.6;79.9;2.8
56;2021-10-11;269;628;625;616781;604036;21818;81.6;79.9;2.9
56;2021-10-12;297;648;901;617078;604684;22719;81.7;80.0;3.0
56;2021-10-13;252;435;446;617330;605119;23165;81.7;80.1;3.1
56;2021-10-14;281;670;945;617611;605789;24110;81.7;80.2;3.2
56;2021-10-15;494;867;1405;618105;606656;25515;81.8;80.3;3.4
56;2021-10-16;164;234;249;618269;606890;25764;81.8;80.3;3.4
56;2021-10-17;7;26;18;618276;606916;25782;81.8;80.3;3.4
56;2021-10-18;326;523;932;618602;607439;26714;81.9;80.4;3.5
56;2021-10-19;217;504;921;618819;607943;27635;81.9;80.5;3.7
56;2021-10-20;153;251;571;618972;608194;28206;81.9;80.5;3.7
56;2021-10-21;255;426;1228;619227;608620;29434;82.0;80.6;3.9
56;2021-10-22;300;729;1403;619527;609349;30837;82.0;80.6;4.1
56;2021-10-23;123;217;197;619650;609566;31034;82.0;80.7;4.1
56;2021-10-24;1;15;2;619651;609581;31036;82.0;80.7;4.1
56;2021-10-25;221;304;964;619872;609885;32000;82.0;80.7;4.2
56;2021-10-26;192;361;1074;620064;610246;33074;82.1;80.8;4.4
56;2021-10-27;192;334;1036;620256;610580;34110;82.1;80.8;4.5
56;2021-10-28;194;279;1089;620450;610859;35199;82.1;80.8;4.7
56;2021-10-29;323;505;1641;620773;611364;36840;82.2;80.9;4.9
56;2021-10-30;82;135;311;620855;611499;37151;82.2;80.9;4.9
56;2021-10-31;5;12;5;620860;611511;37156;82.2;80.9;4.9
56;2021-11-01;11;14;3;620871;611525;37159;82.2;80.9;4.9
56;2021-11-02;326;446;1337;621197;611971;38496;82.2;81.0;5.1
56;2021-11-03;171;178;1012;621368;612149;39508;82.2;81.0;5.2
56;2021-11-04;320;408;1822;621688;612557;41330;82.3;81.1;5.5
56;2021-11-05;231;437;1725;621919;612994;43055;82.3;81.1;5.7
56;2021-11-06;78;117;467;621997;613111;43522;82.3;81.1;5.8
56;2021-11-07;1;6;15;621998;613117;43537;82.3;81.1;5.8
56;2021-11-08;237;369;2189;622235;613486;45726;82.4;81.2;6.1
56;2021-11-09;221;279;2055;622456;613765;47781;82.4;81.2;6.3
56;2021-11-10;191;280;1923;622647;614045;49704;82.4;81.3;6.6
56;2021-11-11;6;14;63;622653;614059;49767;82.4;81.3;6.6
56;2021-11-12;295;503;3051;622948;614562;52818;82.4;81.3;7.0
56;2021-11-13;105;127;979;623053;614689;53797;82.5;81.4;7.1
56;2021-11-14;3;2;8;623056;614691;53805;82.5;81.4;7.1
56;2021-11-15;168;241;2395;623224;614932;56200;82.5;81.4;7.4
56;2021-11-16;174;220;2581;623398;615152;58781;82.5;81.4;7.8
56;2021-11-17;194;250;2319;623592;615402;61100;82.5;81.4;8.1
56;2021-11-18;229;216;3115;623821;615618;64215;82.6;81.5;8.5
56;2021-11-19;358;427;5312;624179;616045;69527;82.6;81.5;9.2
56;2021-11-20;128;122;922;624307;616167;70449;82.6;81.6;9.3
56;2021-11-21;8;8;8;624315;616175;70457;82.6;81.6;9.3
56;2021-11-22;249;149;3457;624564;616324;73914;82.7;81.6;9.8
56;2021-11-23;169;197;3397;624733;616521;77311;82.7;81.6;10.2
56;2021-11-24;210;214;3015;624943;616735;80326;82.7;81.6;10.6
56;2021-11-25;250;232;4822;625193;616967;85148;82.7;81.7;11.3
56;2021-11-26;386;398;6254;625579;617365;91402;82.8;81.7;12.1
56;2021-11-27;103;102;1469;625682;617467;92871;82.8;81.7;12.3
56;2021-11-28;14;14;74;625696;617481;92945;82.8;81.7;12.3
56;2021-11-29;270;223;4684;625966;617704;97629;82.8;81.8;12.9
56;2021-11-30;220;250;6282;626186;617954;103911;82.9;81.8;13.8
56;2021-12-01;273;223;6260;626459;618177;110171;82.9;81.8;14.6
56;2021-12-02;160;138;6843;626619;618315;117014;82.9;81.8;15.5
56;2021-12-03;246;303;8586;626865;618618;125600;83.0;81.9;16.6
56;2021-12-04;175;144;3694;627040;618762;129294;83.0;81.9;17.1
56;2021-12-05;7;15;429;627047;618777;129723;83.0;81.9;17.2
56;2021-12-06;185;198;6410;627232;618975;136133;83.0;81.9;18.0
56;2021-12-07;212;267;8846;627444;619242;144979;83.0;82.0;19.2
56;2021-12-08;255;248;7456;627699;619490;152435;83.1;82.0;20.2
56;2021-12-09;239;260;9760;627938;619750;162195;83.1;82.0;21.5
56;2021-12-10;298;378;10498;628236;620128;172693;83.1;82.1;22.9
56;2021-12-11;171;145;5252;628407;620273;177945;83.2;82.1;23.6
56;2021-12-12;31;20;735;628438;620293;178680;83.2;82.1;23.6
56;2021-12-13;190;258;8349;628628;620551;187029;83.2;82.1;24.8
56;2021-12-14;254;216;10982;628882;620767;198011;83.2;82.2;26.2
56;2021-12-15;247;285;9623;629129;621052;207634;83.3;82.2;27.5
56;2021-12-16;244;312;11328;629373;621364;218962;83.3;82.2;29.0
57;2020-12-27;0;0;0;0;0;0;0.0;0.0;0.0
57;2020-12-28;4;0;0;4;0;0;0.0;0.0;0.0
57;2020-12-29;7;0;0;11;0;0;0.0;0.0;0.0
57;2020-12-30;6;0;0;17;0;0;0.0;0.0;0.0
57;2020-12-31;2;0;0;19;0;0;0.0;0.0;0.0
57;2021-01-01;4;1;0;23;1;0;0.0;0.0;0.0
57;2021-01-02;5;0;0;28;1;0;0.0;0.0;0.0
57;2021-01-03;0;0;0;28;1;0;0.0;0.0;0.0
57;2021-01-04;21;0;0;49;1;0;0.0;0.0;0.0
57;2021-01-05;197;0;0;246;1;0;0.0;0.0;0.0
57;2021-01-06;229;0;0;475;1;0;0.0;0.0;0.0
57;2021-01-07;577;2;0;1052;3;0;0.1;0.0;0.0
57;2021-01-08;520;2;0;1572;5;0;0.2;0.0;0.0
57;2021-01-09;197;0;0;1769;5;0;0.2;0.0;0.0
57;2021-01-10;111;1;0;1880;6;0;0.2;0.0;0.0
57;2021-01-11;476;1;0;2356;7;0;0.2;0.0;0.0
57;2021-01-12;627;6;0;2983;13;0;0.3;0.0;0.0
57;2021-01-13;704;2;0;3687;15;0;0.4;0.0;0.0
57;2021-01-14;784;8;0;4471;23;0;0.4;0.0;0.0
57;2021-01-15;695;5;0;5166;28;0;0.5;0.0;0.0
57;2021-01-16;439;1;0;5605;29;0;0.5;0.0;0.0
57;2021-01-17;477;1;0;6082;30;0;0.6;0.0;0.0
57;2021-01-18;2635;23;0;8717;53;0;0.8;0.0;0.0
57;2021-01-19;2588;20;0;11305;73;0;1.1;0.0;0.0
57;2021-01-20;2740;26;0;14045;99;0;1.4;0.0;0.0
57;2021-01-21;1773;11;0;15818;110;0;1.5;0.0;0.0
57;2021-01-22;1321;9;0;17139;119;0;1.7;0.0;0.0
57;2021-01-23;574;16;0;17713;135;0;1.7;0.0;0.0
57;2021-01-24;4;0;0;17717;135;0;1.7;0.0;0.0
57;2021-01-25;937;178;0;18654;313;0;1.8;0.0;0.0
57;2021-01-26;1091;200;0;19745;513;0;1.9;0.0;0.0
57;2021-01-27;1072;170;0;20817;683;0;2.0;0.1;0.0
57;2021-01-28;1095;287;0;21912;970;0;2.1;0.1;0.0
57;2021-01-29;1015;376;0;22927;1346;0;2.2;0.1;0.0
57;2021-01-30;449;90;0;23376;1436;0;2.3;0.1;0.0
57;2021-01-31;17;27;0;23393;1463;0;2.3;0.1;0.0
57;2021-02-01;845;365;0;24238;1828;0;2.3;0.2;0.0
57;2021-02-02;1023;376;0;25261;2204;0;2.4;0.2;0.0
57;2021-02-03;996;337;0;26257;2541;0;2.5;0.2;0.0
57;2021-02-04;1173;815;0;27430;3356;0;2.6;0.3;0.0
57;2021-02-05;983;392;0;28413;3748;0;2.7;0.4;0.0
57;2021-02-06;487;326;0;28900;4074;0;2.8;0.4;0.0
57;2021-02-07;104;331;0;29004;4405;0;2.8;0.4;0.0
57;2021-02-08;1207;1454;0;30211;5859;0;2.9;0.6;0.0
57;2021-02-09;1693;1622;0;31904;7481;0;3.1;0.7;0.0
57;2021-02-10;1682;2014;0;33586;9495;0;3.2;0.9;0.0
57;2021-02-11;1455;1265;0;35041;10760;0;3.4;1.0;0.0
57;2021-02-12;1202;678;0;36243;11438;0;3.5;1.1;0.0
57;2021-02-13;1112;185;0;37355;11623;0;3.6;1.1;0.0
57;2021-02-14;1156;28;0;38511;11651;0;3.7;1.1;0.0
57;2021-02-15;765;868;0;39276;12519;0;3.8;1.2;0.0
57;2021-02-16;1065;864;0;40341;13383;0;3.9;1.3;0.0
57;2021-02-17;952;1008;0;41293;14391;0;4.0;1.4;0.0
57;2021-02-18;952;1226;0;42245;15617;0;4.1;1.5;0.0
57;2021-02-19;974;986;0;43219;16603;0;4.2;1.6;0.0
57;2021-02-20;1121;610;0;44340;17213;0;4.3;1.7;0.0
57;2021-02-21;321;22;0;44661;17235;0;4.3;1.7;0.0
57;2021-02-22;1161;925;0;45822;18160;0;4.4;1.8;0.0
57;2021-02-23;2056;1154;0;47878;19314;0;4.6;1.9;0.0
57;2021-02-24;2158;1020;0;50036;20334;0;4.8;2.0;0.0
57;2021-02-25;3188;1141;0;53224;21475;0;5.1;2.1;0.0
57;2021-02-26;3392;978;0;56616;22453;0;5.5;2.2;0.0
57;2021-02-27;3446;542;0;60062;22995;0;5.8;2.2;0.0
57;2021-02-28;1763;61;0;61825;23056;0;6.0;2.2;0.0
57;2021-03-01;1977;1325;0;63802;24381;0;6.2;2.4;0.0
57;2021-03-02;2773;1590;0;66575;25971;0;6.4;2.5;0.0
57;2021-03-03;2738;1613;0;69313;27584;0;6.7;2.7;0.0
57;2021-03-04;3198;1303;0;72511;28887;0;7.0;2.8;0.0
57;2021-03-05;4299;1248;0;76810;30135;0;7.4;2.9;0.0
57;2021-03-06;6906;796;0;83716;30931;0;8.1;3.0;0.0
57;2021-03-07;5678;279;0;89394;31210;0;8.6;3.0;0.0
57;2021-03-08;2288;1005;0;91682;32215;0;8.9;3.1;0.0
57;2021-03-09;3305;1280;0;94987;33495;0;9.2;3.2;0.0
57;2021-03-10;3577;964;0;98564;34459;0;9.5;3.3;0.0
57;2021-03-11;4023;1191;0;102587;35650;0;9.9;3.4;0.0
57;2021-03-12;5081;1217;0;107668;36867;0;10.4;3.6;0.0
57;2021-03-13;6108;964;0;113776;37831;0;11.0;3.7;0.0
57;2021-03-14;2335;419;0;116111;38250;0;11.2;3.7;0.0
57;2021-03-15;2988;867;0;119099;39117;0;11.5;3.8;0.0
57;2021-03-16;2956;1248;0;122055;40365;0;11.8;3.9;0.0
57;2021-03-17;3092;1107;0;125147;41472;0;12.1;4.0;0.0
57;2021-03-18;3404;1025;0;128551;42497;0;12.4;4.1;0.0
57;2021-03-19;4567;1004;0;133118;43501;0;12.9;4.2;0.0
57;2021-03-20;4552;998;0;137670;44499;0;13.3;4.3;0.0
57;2021-03-21;1840;251;0;139510;44750;0;13.5;4.3;0.0
57;2021-03-22;2412;1402;0;141922;46152;0;13.7;4.5;0.0
57;2021-03-23;3425;2227;0;145347;48379;0;14.0;4.7;0.0
57;2021-03-24;3919;2085;0;149266;50464;0;14.4;4.9;0.0
57;2021-03-25;4756;2512;0;154022;52976;0;14.9;5.1;0.0
57;2021-03-26;4822;2168;0;158844;55144;0;15.3;5.3;0.0
57;2021-03-27;3795;2968;0;162639;58112;0;15.7;5.6;0.0
57;2021-03-28;1398;1714;0;164037;59826;0;15.8;5.8;0.0
57;2021-03-29;2051;2085;0;166088;61911;0;16.0;6.0;0.0
57;2021-03-30;3441;2380;0;169529;64291;0;16.4;6.2;0.0
57;2021-03-31;2974;2256;0;172503;66547;0;16.7;6.4;0.0
57;2021-04-01;3417;3054;0;175920;69601;0;17.0;6.7;0.0
57;2021-04-02;2528;2453;0;178448;72054;0;17.2;7.0;0.0
57;2021-04-03;2598;2503;0;181046;74557;0;17.5;7.2;0.0
57;2021-04-04;567;914;0;181613;75471;0;17.5;7.3;0.0
57;2021-04-05;1834;674;0;183447;76145;0;17.7;7.4;0.0
57;2021-04-06;2413;2731;0;185860;78876;0;17.9;7.6;0.0
57;2021-04-07;3705;2989;0;189565;81865;0;18.3;7.9;0.0
57;2021-04-08;5471;2868;0;195036;84733;0;18.8;8.2;0.0
57;2021-04-09;5056;2774;0;200092;87507;0;19.3;8.4;0.0
57;2021-04-10;2452;3450;0;202544;90957;0;19.6;8.8;0.0
57;2021-04-11;1066;1842;0;203610;92799;0;19.7;9.0;0.0
57;2021-04-12;1861;2730;0;205471;95529;0;19.8;9.2;0.0
57;2021-04-13;2101;3032;0;207572;98561;0;20.0;9.5;0.0
57;2021-04-14;2117;3010;0;209689;101571;0;20.2;9.8;0.0
57;2021-04-15;2547;3393;0;212236;104964;0;20.5;10.1;0.0
57;2021-04-16;2770;3276;0;215006;108240;0;20.8;10.4;0.0
57;2021-04-17;2679;3119;0;217685;111359;0;21.0;10.8;0.0
57;2021-04-18;1146;1718;0;218831;113077;0;21.1;10.9;0.0
57;2021-04-19;2355;2331;0;221186;115408;0;21.4;11.1;0.0
57;2021-04-20;2720;2801;0;223906;118209;0;21.6;11.4;0.0
57;2021-04-21;3369;2455;0;227275;120664;0;21.9;11.6;0.0
57;2021-04-22;3426;2323;0;230701;122987;0;22.3;11.9;0.0
57;2021-04-23;4232;2631;0;234933;125618;0;22.7;12.1;0.0
57;2021-04-24;3529;2611;0;238462;128229;0;23.0;12.4;0.0
57;2021-04-25;804;1120;0;239266;129349;0;23.1;12.5;0.0
57;2021-04-26;3129;2135;0;242395;131484;0;23.4;12.7;0.0
57;2021-04-27;4054;2511;0;246449;133995;0;23.8;12.9;0.0
57;2021-04-28;4672;2661;0;251121;136656;0;24.2;13.2;0.0
57;2021-04-29;5656;3471;0;256777;140127;0;24.8;13.5;0.0
57;2021-04-30;4973;3525;0;261750;143652;0;25.3;13.9;0.0
57;2021-05-01;2450;1707;0;264200;145359;0;25.5;14.0;0.0
57;2021-05-02;838;898;0;265038;146257;0;25.6;14.1;0.0
57;2021-05-03;3823;3025;0;268861;149282;0;26.0;14.4;0.0
57;2021-05-04;4987;3178;0;273848;152460;0;26.4;14.7;0.0
57;2021-05-05;6318;3154;0;280166;155614;0;27.0;15.0;0.0
57;2021-05-06;6090;3332;0;286256;158946;0;27.6;15.3;0.0
57;2021-05-07;6843;3477;0;293099;162423;0;28.3;15.7;0.0
57;2021-05-08;4009;1577;0;297108;164000;0;28.7;15.8;0.0
57;2021-05-09;2047;1051;0;299155;165051;0;28.9;15.9;0.0
57;2021-05-10;5186;3121;0;304341;168172;0;29.4;16.2;0.0
57;2021-05-11;7469;2929;0;311810;171101;0;30.1;16.5;0.0
57;2021-05-12;7742;3419;0;319552;174520;0;30.8;16.8;0.0
57;2021-05-13;4603;930;0;324155;175450;0;31.3;16.9;0.0
57;2021-05-14;7732;2695;0;331887;178145;0;32.0;17.2;0.0
57;2021-05-15;5850;2136;0;337737;180281;0;32.6;17.4;0.0
57;2021-05-16;3354;579;0;341091;180860;0;32.9;17.5;0.0
57;2021-05-17;3974;2204;0;345065;183064;0;33.3;17.7;0.0
57;2021-05-18;6267;2161;0;351332;185225;0;33.9;17.9;0.0
57;2021-05-19;6980;2428;0;358312;187653;0;34.6;18.1;0.0
57;2021-05-20;6275;2264;0;364587;189917;0;35.2;18.3;0.0
57;2021-05-21;7733;2969;0;372320;192886;0;35.9;18.6;0.0
57;2021-05-22;5086;2196;0;377406;195082;0;36.4;18.8;0.0
57;2021-05-23;1962;426;0;379368;195508;0;36.6;18.9;0.0
57;2021-05-24;3112;1072;0;382480;196580;0;36.9;19.0;0.0
57;2021-05-25;5621;2854;0;388101;199434;0;37.5;19.3;0.0
57;2021-05-26;6512;3324;0;394613;202758;0;38.1;19.6;0.0
57;2021-05-27;6243;3266;0;400856;206024;0;38.7;19.9;0.0
57;2021-05-28;6964;4745;0;407820;210769;0;39.4;20.3;0.0
57;2021-05-29;5319;4393;0;413139;215162;0;39.9;20.8;0.0
57;2021-05-30;1900;1685;0;415039;216847;0;40.1;20.9;0.0
57;2021-05-31;4395;3487;0;419434;220334;0;40.5;21.3;0.0
57;2021-06-01;5863;3840;0;425297;224174;0;41.1;21.6;0.0
57;2021-06-02;6239;4287;0;431536;228461;0;41.7;22.1;0.0
57;2021-06-03;6170;4125;0;437706;232586;0;42.3;22.5;0.0
57;2021-06-04;7390;5152;0;445096;237738;0;43.0;23.0;0.0
57;2021-06-05;4701;4135;0;449797;241873;0;43.4;23.3;0.0
57;2021-06-06;1924;896;0;451721;242769;0;43.6;23.4;0.0
57;2021-06-07;4337;4179;0;456058;246948;0;44.0;23.8;0.0
57;2021-06-08;6398;4631;0;462456;251579;0;44.6;24.3;0.0
57;2021-06-09;6673;4441;0;469129;256020;0;45.3;24.7;0.0
57;2021-06-10;6007;4779;0;475136;260799;0;45.9;25.2;0.0
57;2021-06-11;5233;5461;0;480369;266260;0;46.4;25.7;0.0
57;2021-06-12;5428;4527;0;485797;270787;0;46.9;26.1;0.0
57;2021-06-13;1408;1139;0;487205;271926;0;47.0;26.3;0.0
57;2021-06-14;3271;4927;0;490476;276853;0;47.3;26.7;0.0
57;2021-06-15;3812;6073;0;494288;282926;0;47.7;27.3;0.0
57;2021-06-16;4335;6695;0;498623;289621;0;48.1;28.0;0.0
57;2021-06-17;4201;6128;0;502824;295749;0;48.5;28.6;0.0
57;2021-06-18;4297;7386;0;507121;303135;0;49.0;29.3;0.0
57;2021-06-19;4025;6271;0;511146;309406;0;49.3;29.9;0.0
57;2021-06-20;948;1650;0;512094;311056;0;49.4;30.0;0.0
57;2021-06-21;2180;6102;0;514274;317158;0;49.6;30.6;0.0
57;2021-06-22;2635;8042;0;516909;325200;0;49.9;31.4;0.0
57;2021-06-23;3069;8393;0;519978;333593;0;50.2;32.2;0.0
57;2021-06-24;2568;5404;0;522546;338997;0;50.4;32.7;0.0
57;2021-06-25;2814;7836;0;525360;346833;0;50.7;33.5;0.0
57;2021-06-26;2791;7128;0;528151;353961;0;51.0;34.2;0.0
57;2021-06-27;716;2798;0;528867;356759;0;51.1;34.4;0.0
57;2021-06-28;1668;5286;0;530535;362045;0;51.2;35.0;0.0
57;2021-06-29;2098;6924;0;532633;368969;0;51.4;35.6;0.0
57;2021-06-30;3068;7402;2;535701;376371;2;51.7;36.3;0.0
57;2021-07-01;2726;6200;0;538427;382571;2;52.0;36.9;0.0
57;2021-07-02;2696;8196;0;541123;390767;2;52.2;37.7;0.0
57;2021-07-03;3131;6424;0;544254;397191;2;52.5;38.3;0.0
57;2021-07-04;888;2437;0;545142;399628;2;52.6;38.6;0.0
57;2021-07-05;1835;4808;0;546977;404436;2;52.8;39.0;0.0
57;2021-07-06;2509;6509;0;549486;410945;2;53.0;39.7;0.0
57;2021-07-07;2771;7182;0;552257;418127;2;53.3;40.4;0.0
57;2021-07-08;2637;6112;0;554894;424239;2;53.6;41.0;0.0
57;2021-07-09;3412;8360;0;558306;432599;2;53.9;41.8;0.0
57;2021-07-10;2989;6871;0;561295;439470;2;54.2;42.4;0.0
57;2021-07-11;815;2188;0;562110;441658;2;54.3;42.6;0.0
57;2021-07-12;2400;6474;0;564510;448132;2;54.5;43.3;0.0
57;2021-07-13;4280;7509;0;568790;455641;2;54.9;44.0;0.0
57;2021-07-14;2753;3775;0;571543;459416;2;55.2;44.4;0.0
57;2021-07-15;4002;7700;0;575545;467116;2;55.6;45.1;0.0
57;2021-07-16;5557;9492;0;581102;476608;2;56.1;46.0;0.0
57;2021-07-17;5477;7030;0;586579;483638;2;56.6;46.7;0.0
57;2021-07-18;1546;2620;0;588125;486258;2;56.8;46.9;0.0
57;2021-07-19;2569;6190;0;590694;492448;2;57.0;47.5;0.0
57;2021-07-20;4259;6960;0;594953;499408;2;57.4;48.2;0.0
57;2021-07-21;5036;6871;0;599989;506279;2;57.9;48.9;0.0
57;2021-07-22;5572;5879;0;605561;512158;2;58.5;49.4;0.0
57;2021-07-23;6575;6381;0;612136;518539;2;59.1;50.1;0.0
57;2021-07-24;4379;6863;0;616515;525402;2;59.5;50.7;0.0
57;2021-07-25;1322;1713;0;617837;527115;2;59.6;50.9;0.0
57;2021-07-26;3710;4561;0;621547;531676;2;60.0;51.3;0.0
57;2021-07-27;6630;5075;0;628177;536751;2;60.6;51.8;0.0
57;2021-07-28;7168;4557;0;635345;541308;2;61.3;52.3;0.0
57;2021-07-29;7439;4617;0;642784;545925;2;62.1;52.7;0.0
57;2021-07-30;6733;5037;0;649517;550962;2;62.7;53.2;0.0
57;2021-07-31;5508;4966;0;655025;555928;2;63.2;53.7;0.0
57;2021-08-01;1963;1106;0;656988;557034;2;63.4;53.8;0.0
57;2021-08-02;3699;3321;0;660687;560355;2;63.8;54.1;0.0
57;2021-08-03;5406;4311;0;666093;564666;2;64.3;54.5;0.0
57;2021-08-04;5021;3513;0;671114;568179;2;64.8;54.9;0.0
57;2021-08-05;5145;3785;0;676259;571964;2;65.3;55.2;0.0
57;2021-08-06;5399;4815;0;681658;576779;2;65.8;55.7;0.0
57;2021-08-07;4256;5025;1;685914;581804;3;66.2;56.2;0.0
57;2021-08-08;1442;1470;0;687356;583274;3;66.4;56.3;0.0
57;2021-08-09;2576;3297;1;689932;586571;4;66.6;56.6;0.0
57;2021-08-10;3477;3882;0;693409;590453;4;66.9;57.0;0.0
57;2021-08-11;3541;3960;0;696950;594413;4;67.3;57.4;0.0
57;2021-08-12;3063;5071;0;700013;599484;4;67.6;57.9;0.0
57;2021-08-13;3299;4692;0;703312;604176;4;67.9;58.3;0.0
57;2021-08-14;2145;4985;0;705457;609161;4;68.1;58.8;0.0
57;2021-08-15;491;1079;0;705948;610240;4;68.2;58.9;0.0
57;2021-08-16;1841;3614;0;707789;613854;4;68.3;59.3;0.0
57;2021-08-17;2320;5315;0;710109;619169;4;68.6;59.8;0.0
57;2021-08-18;2324;5180;0;712433;624349;4;68.8;60.3;0.0
57;2021-08-19;2205;5398;0;714638;629747;4;69.0;60.8;0.0
57;2021-08-20;2037;5973;0;716675;635720;4;69.2;61.4;0.0
57;2021-08-21;1800;5293;0;718475;641013;4;69.4;61.9;0.0
57;2021-08-22;431;1486;0;718906;642499;4;69.4;62.0;0.0
57;2021-08-23;1163;3873;0;720069;646372;4;69.5;62.4;0.0
57;2021-08-24;1766;5485;0;721835;651857;4;69.7;62.9;0.0
57;2021-08-25;1612;5124;0;723447;656981;4;69.8;63.4;0.0
57;2021-08-26;1538;4540;0;724985;661521;4;70.0;63.9;0.0
57;2021-08-27;1732;5723;0;726717;667244;4;70.2;64.4;0.0
57;2021-08-28;1959;5224;0;728676;672468;4;70.3;64.9;0.0
57;2021-08-29;344;1086;0;729020;673554;4;70.4;65.0;0.0
57;2021-08-30;1065;3206;50;730085;676760;54;70.5;65.3;0.0
57;2021-08-31;1432;4166;159;731517;680926;213;70.6;65.7;0.0
57;2021-09-01;1662;3735;338;733179;684661;551;70.8;66.1;0.1
57;2021-09-02;1170;3000;322;734349;687661;873;70.9;66.4;0.1
57;2021-09-03;1543;3917;420;735892;691578;1293;71.0;66.8;0.1
57;2021-09-04;1613;3668;289;737505;695246;1582;71.2;67.1;0.2
57;2021-09-05;348;797;96;737853;696043;1678;71.2;67.2;0.2
57;2021-09-06;814;1779;374;738667;697822;2052;71.3;67.4;0.2
57;2021-09-07;728;1871;402;739395;699693;2454;71.4;67.5;0.2
57;2021-09-08;942;2428;443;740337;702121;2897;71.5;67.8;0.3
57;2021-09-09;677;1932;435;741014;704053;3332;71.5;68.0;0.3
57;2021-09-10;1153;2414;567;742167;706467;3899;71.6;68.2;0.4
57;2021-09-11;1169;2945;335;743336;709412;4234;71.8;68.5;0.4
57;2021-09-12;241;468;66;743577;709880;4300;71.8;68.5;0.4
57;2021-09-13;652;1235;491;744229;711115;4791;71.8;68.6;0.5
57;2021-09-14;776;1490;711;745005;712605;5502;71.9;68.8;0.5
57;2021-09-15;775;1941;753;745780;714546;6255;72.0;69.0;0.6
57;2021-09-16;716;1192;735;746496;715738;6990;72.1;69.1;0.7
57;2021-09-17;1111;1795;637;747607;717533;7627;72.2;69.3;0.7
57;2021-09-18;823;2513;422;748430;720046;8049;72.3;69.5;0.8
57;2021-09-19;118;325;73;748548;720371;8122;72.3;69.5;0.8
57;2021-09-20;453;893;752;749001;721264;8874;72.3;69.6;0.9
57;2021-09-21;490;841;815;749491;722105;9689;72.4;69.7;0.9
57;2021-09-22;512;1310;743;750003;723415;10432;72.4;69.8;1.0
57;2021-09-23;456;1174;757;750459;724589;11189;72.4;70.0;1.1
57;2021-09-24;762;1452;987;751221;726041;12176;72.5;70.1;1.2
57;2021-09-25;520;1936;526;751741;727977;12702;72.6;70.3;1.2
57;2021-09-26;110;306;88;751851;728283;12790;72.6;70.3;1.2
57;2021-09-27;419;837;792;752270;729120;13582;72.6;70.4;1.3
57;2021-09-28;317;608;920;752587;729728;14502;72.7;70.4;1.4
57;2021-09-29;516;1075;1136;753103;730803;15638;72.7;70.5;1.5
57;2021-09-30;332;621;1020;753435;731424;16658;72.7;70.6;1.6
57;2021-10-01;820;1312;1649;754255;732736;18307;72.8;70.7;1.8
57;2021-10-02;697;1499;844;754952;734235;19151;72.9;70.9;1.8
57;2021-10-03;118;217;143;755070;734452;19294;72.9;70.9;1.9
57;2021-10-04;522;605;1087;755592;735057;20381;72.9;71.0;2.0
57;2021-10-05;367;567;1157;755959;735624;21538;73.0;71.0;2.1
57;2021-10-06;520;750;1329;756479;736374;22867;73.0;71.1;2.2
57;2021-10-07;364;621;1139;756843;736995;24006;73.1;71.1;2.3
57;2021-10-08;553;1049;1959;757396;738044;25965;73.1;71.2;2.5
57;2021-10-09;624;1143;1359;758020;739187;27324;73.2;71.4;2.6
57;2021-10-10;97;123;112;758117;739310;27436;73.2;71.4;2.6
57;2021-10-11;410;593;1175;758527;739903;28611;73.2;71.4;2.8
57;2021-10-12;355;478;1103;758882;740381;29714;73.3;71.5;2.9
57;2021-10-13;596;703;1421;759478;741084;31135;73.3;71.5;3.0
57;2021-10-14;350;480;1130;759828;741564;32265;73.4;71.6;3.1
57;2021-10-15;654;996;2572;760482;742560;34837;73.4;71.7;3.4
57;2021-10-16;653;750;1715;761135;743310;36552;73.5;71.8;3.5
57;2021-10-17;98;129;216;761233;743439;36768;73.5;71.8;3.5
57;2021-10-18;429;546;1404;761662;743985;38172;73.5;71.8;3.7
57;2021-10-19;329;416;1165;761991;744401;39337;73.6;71.9;3.8
57;2021-10-20;462;498;1667;762453;744899;41004;73.6;71.9;4.0
57;2021-10-21;296;461;1043;762749;745360;42047;73.6;72.0;4.1
57;2021-10-22;623;745;2675;763372;746105;44722;73.7;72.0;4.3
57;2021-10-23;573;733;1718;763945;746838;46440;73.7;72.1;4.5
57;2021-10-24;84;109;163;764029;746947;46603;73.8;72.1;4.5
57;2021-10-25;354;437;1545;764383;747384;48148;73.8;72.2;4.6
57;2021-10-26;248;311;1349;764631;747695;49497;73.8;72.2;4.8
57;2021-10-27;385;467;1793;765016;748162;51290;73.9;72.2;5.0
57;2021-10-28;249;283;1253;765265;748445;52543;73.9;72.3;5.1
57;2021-10-29;471;583;2362;765736;749028;54905;73.9;72.3;5.3
57;2021-10-30;404;549;1411;766140;749577;56316;74.0;72.4;5.4
57;2021-10-31;53;91;140;766193;749668;56456;74.0;72.4;5.5
57;2021-11-01;117;79;90;766310;749747;56546;74.0;72.4;5.5
57;2021-11-02;376;421;1424;766686;750168;57970;74.0;72.4;5.6
57;2021-11-03;385;559;2245;767071;750727;60215;74.1;72.5;5.8
57;2021-11-04;280;404;1827;767351;751131;62042;74.1;72.5;6.0
57;2021-11-05;484;655;2762;767835;751786;64804;74.1;72.6;6.3
57;2021-11-06;434;715;2008;768269;752501;66812;74.2;72.6;6.4
57;2021-11-07;50;80;170;768319;752581;66982;74.2;72.7;6.5
57;2021-11-08;299;508;2899;768618;753089;69881;74.2;72.7;6.7
57;2021-11-09;262;334;2600;768880;753423;72481;74.2;72.7;7.0
57;2021-11-10;379;531;3239;769259;753954;75720;74.3;72.8;7.3
57;2021-11-11;49;95;336;769308;754049;76056;74.3;72.8;7.3
57;2021-11-12;467;713;4403;769775;754762;80459;74.3;72.9;7.8
57;2021-11-13;394;609;2861;770169;755371;83320;74.4;72.9;8.0
57;2021-11-14;67;118;487;770236;755489;83807;74.4;72.9;8.1
57;2021-11-15;295;423;2882;770531;755912;86689;74.4;73.0;8.4
57;2021-11-16;296;350;2729;770827;756262;89418;74.4;73.0;8.6
57;2021-11-17;429;477;3165;771256;756739;92583;74.5;73.1;8.9
57;2021-11-18;277;334;3057;771533;757073;95640;74.5;73.1;9.2
57;2021-11-19;493;589;4487;772026;757662;100127;74.5;73.1;9.7
57;2021-11-20;509;520;3058;772535;758182;103185;74.6;73.2;10.0
57;2021-11-21;48;56;203;772583;758238;103388;74.6;73.2;10.0
57;2021-11-22;315;254;3415;772898;758492;106803;74.6;73.2;10.3
57;2021-11-23;420;401;3451;773318;758893;110254;74.7;73.3;10.6
57;2021-11-24;383;480;3688;773701;759373;113942;74.7;73.3;11.0
57;2021-11-25;374;371;4368;774075;759744;118310;74.7;73.3;11.4
57;2021-11-26;464;564;7009;774539;760308;125319;74.8;73.4;12.1
57;2021-11-27;449;591;6079;774988;760899;131398;74.8;73.5;12.7
57;2021-11-28;79;94;2436;775067;760993;133834;74.8;73.5;12.9
57;2021-11-29;309;370;5713;775376;761363;139547;74.9;73.5;13.5
57;2021-11-30;349;397;7665;775725;761760;147212;74.9;73.5;14.2
57;2021-12-01;249;417;6434;775974;762177;153646;74.9;73.6;14.8
57;2021-12-02;354;316;9538;776328;762493;163184;74.9;73.6;15.8
57;2021-12-03;393;545;11045;776721;763038;174229;75.0;73.7;16.8
57;2021-12-04;493;587;8922;777214;763625;183151;75.0;73.7;17.7
57;2021-12-05;178;149;2950;777392;763774;186101;75.0;73.7;18.0
57;2021-12-06;380;525;6675;777772;764299;192776;75.1;73.8;18.6
57;2021-12-07;363;472;9359;778135;764771;202135;75.1;73.8;19.5
57;2021-12-08;468;593;8934;778603;765364;211069;75.2;73.9;20.4
57;2021-12-09;435;473;10554;779038;765837;221623;75.2;73.9;21.4
57;2021-12-10;563;664;12480;779601;766501;234103;75.3;74.0;22.6
57;2021-12-11;535;763;10312;780136;767264;244415;75.3;74.1;23.6
57;2021-12-12;190;138;3207;780326;767402;247622;75.3;74.1;23.9
57;2021-12-13;405;495;8178;780731;767897;255800;75.4;74.1;24.7
57;2021-12-14;471;586;10403;781202;768483;266203;75.4;74.2;25.7
57;2021-12-15;542;590;11349;781744;769073;277552;75.5;74.2;26.8
57;2021-12-16;528;539;11946;782272;769612;289498;75.5;74.3;27.9
58;2020-12-27;0;0;0;0;0;0;0.0;0.0;0.0
58;2020-12-28;0;0;0;0;0;0;0.0;0.0;0.0
58;2020-12-29;0;0;0;0;0;0;0.0;0.0;0.0
58;2020-12-30;0;0;0;0;0;0;0.0;0.0;0.0
58;2020-12-31;0;0;0;0;0;0;0.0;0.0;0.0
58;2021-01-01;0;0;0;0;0;0;0.0;0.0;0.0
58;2021-01-02;0;0;0;0;0;0;0.0;0.0;0.0
58;2021-01-03;1;0;0;1;0;0;0.0;0.0;0.0
58;2021-01-04;0;0;0;1;0;0;0.0;0.0;0.0
58;2021-01-05;1;0;0;2;0;0;0.0;0.0;0.0
58;2021-01-06;131;0;0;133;0;0;0.1;0.0;0.0
58;2021-01-07;229;0;0;362;0;0;0.2;0.0;0.0
58;2021-01-08;64;0;0;426;0;0;0.2;0.0;0.0
58;2021-01-09;1;0;0;427;0;0;0.2;0.0;0.0
58;2021-01-10;2;0;0;429;0;0;0.2;0.0;0.0
58;2021-01-11;55;0;0;484;0;0;0.2;0.0;0.0
58;2021-01-12;246;0;0;730;0;0;0.4;0.0;0.0
58;2021-01-13;391;4;0;1121;4;0;0.6;0.0;0.0
58;2021-01-14;266;2;0;1387;6;0;0.7;0.0;0.0
58;2021-01-15;149;0;0;1536;6;0;0.8;0.0;0.0
58;2021-01-16;20;2;0;1556;8;0;0.8;0.0;0.0
58;2021-01-17;1;0;0;1557;8;0;0.8;0.0;0.0
58;2021-01-18;397;1;0;1954;9;0;1.0;0.0;0.0
58;2021-01-19;896;2;0;2850;11;0;1.4;0.0;0.0
58;2021-01-20;1114;1;0;3964;12;0;2.0;0.0;0.0
58;2021-01-21;904;5;0;4868;17;0;2.4;0.0;0.0
58;2021-01-22;726;5;0;5594;22;0;2.8;0.0;0.0
58;2021-01-23;258;0;0;5852;22;0;2.9;0.0;0.0
58;2021-01-24;2;0;0;5854;22;0;2.9;0.0;0.0
58;2021-01-25;364;2;0;6218;24;0;3.1;0.0;0.0
58;2021-01-26;585;3;0;6803;27;0;3.4;0.0;0.0
58;2021-01-27;585;45;0;7388;72;0;3.7;0.0;0.0
58;2021-01-28;675;64;0;8063;136;0;4.0;0.1;0.0
58;2021-01-29;757;12;0;8820;148;0;4.4;0.1;0.0
58;2021-01-30;241;1;0;9061;149;0;4.5;0.1;0.0
58;2021-01-31;11;0;0;9072;149;0;4.5;0.1;0.0
58;2021-02-01;183;74;0;9255;223;0;4.6;0.1;0.0
58;2021-02-02;490;82;0;9745;305;0;4.9;0.2;0.0
58;2021-02-03;291;147;0;10036;452;0;5.0;0.2;0.0
58;2021-02-04;257;93;0;10293;545;0;5.2;0.3;0.0
58;2021-02-05;139;93;0;10432;638;0;5.2;0.3;0.0
58;2021-02-06;94;2;0;10526;640;0;5.3;0.3;0.0
58;2021-02-07;2;0;0;10528;640;0;5.3;0.3;0.0
58;2021-02-08;243;74;0;10771;714;0;5.4;0.4;0.0
58;2021-02-09;426;294;0;11197;1008;0;5.6;0.5;0.0
58;2021-02-10;310;352;0;11507;1360;0;5.8;0.7;0.0
58;2021-02-11;282;367;0;11789;1727;0;5.9;0.9;0.0
58;2021-02-12;201;213;0;11990;1940;0;6.0;1.0;0.0
58;2021-02-13;72;33;0;12062;1973;0;6.0;1.0;0.0
58;2021-02-14;0;2;0;12062;1975;0;6.0;1.0;0.0
58;2021-02-15;112;482;0;12174;2457;0;6.1;1.2;0.0
58;2021-02-16;193;851;0;12367;3308;0;6.2;1.7;0.0
58;2021-02-17;193;694;0;12560;4002;0;6.3;2.0;0.0
58;2021-02-18;161;744;0;12721;4746;0;6.4;2.4;0.0
58;2021-02-19;235;685;0;12956;5431;0;6.5;2.7;0.0
58;2021-02-20;61;234;0;13017;5665;0;6.5;2.8;0.0
58;2021-02-21;0;31;0;13017;5696;0;6.5;2.9;0.0
58;2021-02-22;82;358;0;13099;6054;0;6.6;3.0;0.0
58;2021-02-23;53;580;0;13152;6634;0;6.6;3.3;0.0
58;2021-02-24;53;539;0;13205;7173;0;6.6;3.6;0.0
58;2021-02-25;239;623;0;13444;7796;0;6.7;3.9;0.0
58;2021-02-26;232;567;0;13676;8363;0;6.9;4.2;0.0
58;2021-02-27;102;197;0;13778;8560;0;6.9;4.3;0.0
58;2021-02-28;13;8;0;13791;8568;0;6.9;4.3;0.0
58;2021-03-01;143;216;0;13934;8784;0;7.0;4.4;0.0
58;2021-03-02;375;553;0;14309;9337;0;7.2;4.7;0.0
58;2021-03-03;498;279;0;14807;9616;0;7.4;4.8;0.0
58;2021-03-04;641;250;0;15448;9866;0;7.7;4.9;0.0
58;2021-03-05;740;176;0;16188;10042;0;8.1;5.0;0.0
58;2021-03-06;540;83;0;16728;10125;0;8.4;5.1;0.0
58;2021-03-07;64;5;0;16792;10130;0;8.4;5.1;0.0
58;2021-03-08;160;258;0;16952;10388;0;8.5;5.2;0.0
58;2021-03-09;504;471;0;17456;10859;0;8.7;5.4;0.0
58;2021-03-10;806;243;0;18262;11102;0;9.1;5.6;0.0
58;2021-03-11;831;266;0;19093;11368;0;9.6;5.7;0.0
58;2021-03-12;773;177;0;19866;11545;0;10.0;5.8;0.0
58;2021-03-13;478;67;0;20344;11612;0;10.2;5.8;0.0
58;2021-03-14;36;1;0;20380;11613;0;10.2;5.8;0.0
58;2021-03-15;479;109;0;20859;11722;0;10.5;5.9;0.0
58;2021-03-16;654;219;0;21513;11941;0;10.8;6.0;0.0
58;2021-03-17;659;150;0;22172;12091;0;11.1;6.1;0.0
58;2021-03-18;582;161;0;22754;12252;0;11.4;6.1;0.0
58;2021-03-19;541;107;0;23295;12359;0;11.7;6.2;0.0
58;2021-03-20;313;64;0;23608;12423;0;11.8;6.2;0.0
58;2021-03-21;15;0;0;23623;12423;0;11.8;6.2;0.0
58;2021-03-22;723;23;0;24346;12446;0;12.2;6.2;0.0
58;2021-03-23;1413;44;0;25759;12490;0;12.9;6.3;0.0
58;2021-03-24;1213;74;0;26972;12564;0;13.5;6.3;0.0
58;2021-03-25;1622;43;0;28594;12607;0;14.3;6.3;0.0
58;2021-03-26;1309;56;0;29903;12663;0;15.0;6.3;0.0
58;2021-03-27;380;14;0;30283;12677;0;15.2;6.4;0.0
58;2021-03-28;20;1;0;30303;12678;0;15.2;6.4;0.0
58;2021-03-29;584;144;0;30887;12822;0;15.5;6.4;0.0
58;2021-03-30;1081;238;0;31968;13060;0;16.0;6.5;0.0
58;2021-03-31;973;328;0;32941;13388;0;16.5;6.7;0.0
58;2021-04-01;1436;353;0;34377;13741;0;17.2;6.9;0.0
58;2021-04-02;1366;306;0;35743;14047;0;17.9;7.0;0.0
58;2021-04-03;573;157;0;36316;14204;0;18.2;7.1;0.0
58;2021-04-04;4;2;0;36320;14206;0;18.2;7.1;0.0
58;2021-04-05;49;2;0;36369;14208;0;18.2;7.1;0.0
58;2021-04-06;730;335;0;37099;14543;0;18.6;7.3;0.0
58;2021-04-07;670;489;0;37769;15032;0;18.9;7.5;0.0
58;2021-04-08;1372;406;0;39141;15438;0;19.6;7.7;0.0
58;2021-04-09;1629;393;0;40770;15831;0;20.4;7.9;0.0
58;2021-04-10;576;191;0;41346;16022;0;20.7;8.0;0.0
58;2021-04-11;30;3;0;41376;16025;0;20.7;8.0;0.0
58;2021-04-12;1071;460;0;42447;16485;0;21.3;8.3;0.0
58;2021-04-13;1379;588;0;43826;17073;0;22.0;8.6;0.0
58;2021-04-14;1232;619;0;45058;17692;0;22.6;8.9;0.0
58;2021-04-15;1261;585;0;46319;18277;0;23.2;9.2;0.0
58;2021-04-16;1529;486;0;47848;18763;0;24.0;9.4;0.0
58;2021-04-17;681;234;0;48529;18997;0;24.3;9.5;0.0
58;2021-04-18;19;10;0;48548;19007;0;24.3;9.5;0.0
58;2021-04-19;490;542;0;49038;19549;0;24.6;9.8;0.0
58;2021-04-20;477;946;0;49515;20495;0;24.8;10.3;0.0
58;2021-04-21;541;828;0;50056;21323;0;25.1;10.7;0.0
58;2021-04-22;711;1323;0;50767;22646;0;25.4;11.3;0.0
58;2021-04-23;889;702;0;51656;23348;0;25.9;11.7;0.0
58;2021-04-24;215;222;0;51871;23570;0;26.0;11.8;0.0
58;2021-04-25;16;1;0;51887;23571;0;26.0;11.8;0.0
58;2021-04-26;719;274;0;52606;23845;0;26.4;11.9;0.0
58;2021-04-27;1333;1024;0;53939;24869;0;27.0;12.5;0.0
58;2021-04-28;1459;889;0;55398;25758;0;27.8;12.9;0.0
58;2021-04-29;1330;978;0;56728;26736;0;28.4;13.4;0.0
58;2021-04-30;1160;875;0;57888;27611;0;29.0;13.8;0.0
58;2021-05-01;46;66;0;57934;27677;0;29.0;13.9;0.0
58;2021-05-02;18;5;0;57952;27682;0;29.0;13.9;0.0
58;2021-05-03;993;400;0;58945;28082;0;29.5;14.1;0.0
58;2021-05-04;1058;1212;0;60003;29294;0;30.1;14.7;0.0
58;2021-05-05;933;998;0;60936;30292;0;30.5;15.2;0.0
58;2021-05-06;1352;940;0;62288;31232;0;31.2;15.6;0.0
58;2021-05-07;1114;985;0;63402;32217;0;31.8;16.1;0.0
58;2021-05-08;144;67;0;63546;32284;0;31.8;16.2;0.0
58;2021-05-09;20;31;0;63566;32315;0;31.8;16.2;0.0
58;2021-05-10;930;877;0;64496;33192;0;32.3;16.6;0.0
58;2021-05-11;1385;1821;0;65881;35013;0;33.0;17.5;0.0
58;2021-05-12;1784;1469;0;67665;36482;0;33.9;18.3;0.0
58;2021-05-13;149;174;0;67814;36656;0;34.0;18.4;0.0
58;2021-05-14;2156;807;0;69970;37463;0;35.1;18.8;0.0
58;2021-05-15;1685;422;0;71655;37885;0;35.9;19.0;0.0
58;2021-05-16;124;33;0;71779;37918;0;36.0;19.0;0.0
58;2021-05-17;758;557;0;72537;38475;0;36.3;19.3;0.0
58;2021-05-18;1386;1110;0;73923;39585;0;37.0;19.8;0.0
58;2021-05-19;1757;511;0;75680;40096;0;37.9;20.1;0.0
58;2021-05-20;1743;627;0;77423;40723;0;38.8;20.4;0.0
58;2021-05-21;910;647;0;78333;41370;0;39.2;20.7;0.0
58;2021-05-22;416;231;0;78749;41601;0;39.5;20.8;0.0
58;2021-05-23;46;25;0;78795;41626;0;39.5;20.9;0.0
58;2021-05-24;164;53;0;78959;41679;0;39.6;20.9;0.0
58;2021-05-25;1441;1021;0;80400;42700;0;40.3;21.4;0.0
58;2021-05-26;967;742;0;81367;43442;0;40.8;21.8;0.0
58;2021-05-27;935;907;0;82302;44349;0;41.2;22.2;0.0
58;2021-05-28;639;843;0;82941;45192;0;41.6;22.6;0.0
58;2021-05-29;366;231;0;83307;45423;0;41.7;22.8;0.0
58;2021-05-30;97;19;0;83404;45442;0;41.8;22.8;0.0
58;2021-05-31;832;389;0;84236;45831;0;42.2;23.0;0.0
58;2021-06-01;1490;1531;0;85726;47362;0;42.9;23.7;0.0
58;2021-06-02;1574;988;0;87300;48350;0;43.7;24.2;0.0
58;2021-06-03;1143;887;0;88443;49237;0;44.3;24.7;0.0
58;2021-06-04;976;893;0;89419;50130;0;44.8;25.1;0.0
58;2021-06-05;443;284;0;89862;50414;0;45.0;25.3;0.0
58;2021-06-06;54;53;0;89916;50467;0;45.0;25.3;0.0
58;2021-06-07;750;745;0;90666;51212;0;45.4;25.7;0.0
58;2021-06-08;1310;1717;0;91976;52929;0;46.1;26.5;0.0
58;2021-06-09;1446;970;0;93422;53899;0;46.8;27.0;0.0
58;2021-06-10;1173;930;0;94595;54829;0;47.4;27.5;0.0
58;2021-06-11;987;909;0;95582;55738;0;47.9;27.9;0.0
58;2021-06-12;1084;421;0;96666;56159;0;48.4;28.1;0.0
58;2021-06-13;47;43;0;96713;56202;0;48.5;28.2;0.0
58;2021-06-14;518;1033;0;97231;57235;0;48.7;28.7;0.0
58;2021-06-15;1423;1773;0;98654;59008;0;49.4;29.6;0.0
58;2021-06-16;1667;992;0;100321;60000;0;50.3;30.1;0.0
58;2021-06-17;1798;1133;0;102119;61133;0;51.2;30.6;0.0
58;2021-06-18;890;1150;0;103009;62283;0;51.6;31.2;0.0
58;2021-06-19;567;386;0;103576;62669;0;51.9;31.4;0.0
58;2021-06-20;21;10;0;103597;62679;0;51.9;31.4;0.0
58;2021-06-21;452;646;0;104049;63325;0;52.1;31.7;0.0
58;2021-06-22;953;2028;0;105002;65353;0;52.6;32.7;0.0
58;2021-06-23;1298;1566;0;106300;66919;0;53.3;33.5;0.0
58;2021-06-24;681;981;0;106981;67900;0;53.6;34.0;0.0
58;2021-06-25;759;1713;0;107740;69613;0;54.0;34.9;0.0
58;2021-06-26;513;1300;0;108253;70913;0;54.2;35.5;0.0
58;2021-06-27;31;56;0;108284;70969;0;54.3;35.6;0.0
58;2021-06-28;394;981;0;108678;71950;0;54.4;36.0;0.0
58;2021-06-29;580;2103;0;109258;74053;0;54.7;37.1;0.0
58;2021-06-30;938;1657;0;110196;75710;0;55.2;37.9;0.0
58;2021-07-01;705;1696;0;110901;77406;0;55.6;38.8;0.0
58;2021-07-02;409;931;0;111310;78337;0;55.8;39.2;0.0
58;2021-07-03;237;652;0;111547;78989;0;55.9;39.6;0.0
58;2021-07-04;22;74;0;111569;79063;0;55.9;39.6;0.0
58;2021-07-05;500;841;0;112069;79904;0;56.1;40.0;0.0
58;2021-07-06;630;2099;0;112699;82003;0;56.5;41.1;0.0
58;2021-07-07;382;1099;0;113081;83102;0;56.7;41.6;0.0
58;2021-07-08;430;1075;0;113511;84177;0;56.9;42.2;0.0
58;2021-07-09;717;1460;0;114228;85637;0;57.2;42.9;0.0
58;2021-07-10;278;577;0;114506;86214;0;57.4;43.2;0.0
58;2021-07-11;174;135;0;114680;86349;0;57.5;43.3;0.0
58;2021-07-12;220;1073;0;114900;87422;0;57.6;43.8;0.0
58;2021-07-13;915;2557;0;115815;89979;0;58.0;45.1;0.0
58;2021-07-14;100;120;0;115915;90099;0;58.1;45.1;0.0
58;2021-07-15;1099;1931;0;117014;92030;0;58.6;46.1;0.0
58;2021-07-16;1330;1465;0;118344;93495;0;59.3;46.8;0.0
58;2021-07-17;482;443;0;118826;93938;0;59.5;47.1;0.0
58;2021-07-18;116;41;0;118942;93979;0;59.6;47.1;0.0
58;2021-07-19;1371;970;0;120313;94949;0;60.3;47.6;0.0
58;2021-07-20;1337;2359;0;121650;97308;0;60.9;48.8;0.0
58;2021-07-21;1155;1993;0;122805;99301;0;61.5;49.8;0.0
58;2021-07-22;1134;1615;0;123939;100916;0;62.1;50.6;0.0
58;2021-07-23;1201;1389;0;125140;102305;0;62.7;51.3;0.0
58;2021-07-24;924;1257;0;126064;103562;0;63.2;51.9;0.0
58;2021-07-25;96;61;0;126160;103623;0;63.2;51.9;0.0
58;2021-07-26;914;822;0;127074;104445;0;63.7;52.3;0.0
58;2021-07-27;1488;2381;0;128562;106826;0;64.4;53.5;0.0
58;2021-07-28;1463;1782;0;130025;108608;0;65.1;54.4;0.0
58;2021-07-29;1525;1494;0;131550;110102;0;65.9;55.2;0.0
58;2021-07-30;1374;1283;1;132924;111385;1;66.6;55.8;0.0
58;2021-07-31;595;550;0;133519;111935;1;66.9;56.1;0.0
58;2021-08-01;57;26;0;133576;111961;1;66.9;56.1;0.0
58;2021-08-02;1468;859;0;135044;112820;1;67.7;56.5;0.0
58;2021-08-03;1730;1591;0;136774;114411;1;68.5;57.3;0.0
58;2021-08-04;1190;1088;0;137964;115499;1;69.1;57.9;0.0
58;2021-08-05;1353;1108;0;139317;116607;1;69.8;58.4;0.0
58;2021-08-06;1184;985;0;140501;117592;1;70.4;58.9;0.0
58;2021-08-07;349;432;0;140850;118024;1;70.6;59.1;0.0
58;2021-08-08;34;79;0;140884;118103;1;70.6;59.2;0.0
58;2021-08-09;937;1172;0;141821;119275;1;71.1;59.8;0.0
58;2021-08-10;1539;1255;0;143360;120530;1;71.8;60.4;0.0
58;2021-08-11;992;735;0;144352;121265;1;72.3;60.8;0.0
58;2021-08-12;920;1056;0;145272;122321;1;72.8;61.3;0.0
58;2021-08-13;819;882;0;146091;123203;1;73.2;61.7;0.0
58;2021-08-14;232;363;0;146323;123566;1;73.3;61.9;0.0
58;2021-08-15;23;43;0;146346;123609;1;73.3;61.9;0.0
58;2021-08-16;344;1251;0;146690;124860;1;73.5;62.6;0.0
58;2021-08-17;723;1259;0;147413;126119;1;73.9;63.2;0.0
58;2021-08-18;673;1097;0;148086;127216;1;74.2;63.7;0.0
58;2021-08-19;642;1275;0;148728;128491;1;74.5;64.4;0.0
58;2021-08-20;601;1160;1;149329;129651;2;74.8;65.0;0.0
58;2021-08-21;226;489;0;149555;130140;2;74.9;65.2;0.0
58;2021-08-22;16;113;0;149571;130253;2;74.9;65.3;0.0
58;2021-08-23;362;793;0;149933;131046;2;75.1;65.7;0.0
58;2021-08-24;421;1282;0;150354;132328;2;75.3;66.3;0.0
58;2021-08-25;405;1358;0;150759;133686;2;75.5;67.0;0.0
58;2021-08-26;490;1503;0;151249;135189;2;75.8;67.7;0.0
58;2021-08-27;446;1380;0;151695;136569;2;76.0;68.4;0.0
58;2021-08-28;228;661;0;151923;137230;2;76.1;68.8;0.0
58;2021-08-29;10;52;0;151933;137282;2;76.1;68.8;0.0
58;2021-08-30;321;772;26;152254;138054;28;76.3;69.2;0.0
58;2021-08-31;443;1353;73;152697;139407;101;76.5;69.8;0.1
58;2021-09-01;374;1325;161;153071;140732;262;76.7;70.5;0.1
58;2021-09-02;265;1085;117;153336;141817;379;76.8;71.1;0.2
58;2021-09-03;334;1182;204;153670;142999;583;77.0;71.6;0.3
58;2021-09-04;199;570;64;153869;143569;647;77.1;71.9;0.3
58;2021-09-05;8;42;2;153877;143611;649;77.1;72.0;0.3
58;2021-09-06;136;398;163;154013;144009;812;77.2;72.2;0.4
58;2021-09-07;263;695;174;154276;144704;986;77.3;72.5;0.5
58;2021-09-08;233;913;260;154509;145617;1246;77.4;73.0;0.6
58;2021-09-09;233;457;253;154742;146074;1499;77.5;73.2;0.8
58;2021-09-10;238;626;282;154980;146700;1781;77.6;73.5;0.9
58;2021-09-11;108;407;87;155088;147107;1868;77.7;73.7;0.9
58;2021-09-12;5;11;11;155093;147118;1879;77.7;73.7;0.9
58;2021-09-13;183;388;298;155276;147506;2177;77.8;73.9;1.1
58;2021-09-14;267;574;355;155543;148080;2532;77.9;74.2;1.3
58;2021-09-15;184;521;281;155727;148601;2813;78.0;74.5;1.4
58;2021-09-16;190;424;337;155917;149025;3150;78.1;74.7;1.6
58;2021-09-17;195;377;237;156112;149402;3387;78.2;74.9;1.7
58;2021-09-18;106;355;82;156218;149757;3469;78.3;75.0;1.7
58;2021-09-19;6;10;3;156224;149767;3472;78.3;75.0;1.7
58;2021-09-20;160;223;287;156384;149990;3759;78.4;75.1;1.9
58;2021-09-21;133;364;309;156517;150354;4068;78.4;75.3;2.0
58;2021-09-22;147;490;484;156664;150844;4552;78.5;75.6;2.3
58;2021-09-23;131;294;315;156795;151138;4867;78.6;75.7;2.4
58;2021-09-24;118;345;254;156913;151483;5121;78.6;75.9;2.6
58;2021-09-25;78;319;109;156991;151802;5230;78.7;76.1;2.6
58;2021-09-26;10;15;20;157001;151817;5250;78.7;76.1;2.6
58;2021-09-27;88;221;217;157089;152038;5467;78.7;76.2;2.7
58;2021-09-28;119;307;298;157208;152345;5765;78.8;76.3;2.9
58;2021-09-29;98;322;372;157306;152667;6137;78.8;76.5;3.1
58;2021-09-30;77;208;261;157383;152875;6398;78.9;76.6;3.2
58;2021-10-01;99;215;200;157482;153090;6598;78.9;76.7;3.3
58;2021-10-02;85;201;167;157567;153291;6765;78.9;76.8;3.4
58;2021-10-03;0;4;8;157567;153295;6773;78.9;76.8;3.4
58;2021-10-04;69;169;185;157636;153464;6958;79.0;76.9;3.5
58;2021-10-05;131;294;438;157767;153758;7396;79.0;77.0;3.7
58;2021-10-06;71;281;276;157838;154039;7672;79.1;77.2;3.8
58;2021-10-07;85;138;304;157923;154177;7976;79.1;77.2;4.0
58;2021-10-08;110;217;309;158033;154394;8285;79.2;77.4;4.2
58;2021-10-09;67;134;137;158100;154528;8422;79.2;77.4;4.2
58;2021-10-10;3;14;16;158103;154542;8438;79.2;77.4;4.2
58;2021-10-11;50;152;260;158153;154694;8698;79.2;77.5;4.4
58;2021-10-12;107;196;430;158260;154890;9128;79.3;77.6;4.6
58;2021-10-13;122;230;521;158382;155120;9649;79.4;77.7;4.8
58;2021-10-14;67;209;333;158449;155329;9982;79.4;77.8;5.0
58;2021-10-15;73;107;289;158522;155436;10271;79.4;77.9;5.1
58;2021-10-16;61;117;142;158583;155553;10413;79.5;77.9;5.2
58;2021-10-17;3;7;7;158586;155560;10420;79.5;77.9;5.2
58;2021-10-18;33;68;242;158619;155628;10662;79.5;78.0;5.3
58;2021-10-19;67;100;431;158686;155728;11093;79.5;78.0;5.6
58;2021-10-20;132;151;624;158818;155879;11717;79.6;78.1;5.9
58;2021-10-21;49;78;334;158867;155957;12051;79.6;78.1;6.0
58;2021-10-22;52;88;275;158919;156045;12326;79.6;78.2;6.2
58;2021-10-23;63;89;247;158982;156134;12573;79.7;78.2;6.3
58;2021-10-24;9;18;23;158991;156152;12596;79.7;78.2;6.3
58;2021-10-25;40;63;269;159031;156215;12865;79.7;78.3;6.4
58;2021-10-26;83;116;573;159114;156331;13438;79.7;78.3;6.7
58;2021-10-27;75;87;507;159189;156418;13945;79.8;78.4;7.0
58;2021-10-28;55;92;521;159244;156510;14466;79.8;78.4;7.2
58;2021-10-29;41;68;299;159285;156578;14765;79.8;78.4;7.4
58;2021-10-30;54;74;172;159339;156652;14937;79.8;78.5;7.5
58;2021-10-31;0;10;8;159339;156662;14945;79.8;78.5;7.5
58;2021-11-01;3;0;4;159342;156662;14949;79.8;78.5;7.5
58;2021-11-02;57;93;448;159399;156755;15397;79.9;78.5;7.7
58;2021-11-03;74;143;671;159473;156898;16068;79.9;78.6;8.1
58;2021-11-04;63;70;461;159536;156968;16529;79.9;78.6;8.3
58;2021-11-05;60;66;408;159596;157034;16937;80.0;78.7;8.5
58;2021-11-06;41;54;216;159637;157088;17153;80.0;78.7;8.6
58;2021-11-07;4;6;36;159641;157094;17189;80.0;78.7;8.6
58;2021-11-08;26;39;441;159667;157133;17630;80.0;78.7;8.8
58;2021-11-09;54;84;775;159721;157217;18405;80.0;78.8;9.2
58;2021-11-10;84;144;857;159805;157361;19262;80.1;78.8;9.7
58;2021-11-11;6;8;24;159811;157369;19286;80.1;78.8;9.7
58;2021-11-12;69;74;610;159880;157443;19896;80.1;78.9;10.0
58;2021-11-13;32;61;278;159912;157504;20174;80.1;78.9;10.1
58;2021-11-14;2;8;12;159914;157512;20186;80.1;78.9;10.1
58;2021-11-15;34;46;625;159948;157558;20811;80.1;78.9;10.4
58;2021-11-16;58;89;1014;160006;157647;21825;80.2;79.0;10.9
58;2021-11-17;69;136;951;160075;157783;22776;80.2;79.1;11.4
58;2021-11-18;58;60;856;160133;157843;23632;80.2;79.1;11.8
58;2021-11-19;55;62;743;160188;157905;24375;80.3;79.1;12.2
58;2021-11-20;39;51;361;160227;157956;24736;80.3;79.1;12.4
58;2021-11-21;3;3;48;160230;157959;24784;80.3;79.1;12.4
58;2021-11-22;39;31;682;160269;157990;25466;80.3;79.2;12.8
58;2021-11-23;74;64;1022;160343;158054;26488;80.3;79.2;13.3
58;2021-11-24;89;125;1063;160432;158179;27551;80.4;79.2;13.8
58;2021-11-25;63;65;1326;160495;158244;28877;80.4;79.3;14.5
58;2021-11-26;76;63;1099;160571;158307;29976;80.4;79.3;15.0
58;2021-11-27;44;55;626;160615;158362;30602;80.5;79.3;15.3
58;2021-11-28;9;5;104;160624;158367;30706;80.5;79.3;15.4
58;2021-11-29;60;40;1402;160684;158407;32108;80.5;79.4;16.1
58;2021-11-30;74;58;2101;160758;158465;34209;80.5;79.4;17.1
58;2021-12-01;50;66;1923;160808;158531;36132;80.6;79.4;18.1
58;2021-12-02;52;52;2188;160860;158583;38320;80.6;79.5;19.2
58;2021-12-03;51;64;1954;160911;158647;40274;80.6;79.5;20.2
58;2021-12-04;46;44;934;160957;158691;41208;80.6;79.5;20.6
58;2021-12-05;2;6;132;160959;158697;41340;80.6;79.5;20.7
58;2021-12-06;41;34;1686;161000;158731;43026;80.7;79.5;21.6
58;2021-12-07;50;70;2369;161050;158801;45395;80.7;79.6;22.7
58;2021-12-08;34;70;2028;161084;158871;47423;80.7;79.6;23.8
58;2021-12-09;47;61;2754;161131;158932;50177;80.7;79.6;25.1
58;2021-12-10;68;64;2302;161199;158996;52479;80.8;79.7;26.3
58;2021-12-11;36;56;1022;161235;159052;53501;80.8;79.7;26.8
58;2021-12-12;6;9;185;161241;159061;53686;80.8;79.7;26.9
58;2021-12-13;43;53;1866;161284;159114;55552;80.8;79.7;27.8
58;2021-12-14;51;93;3120;161335;159207;58672;80.8;79.8;29.4
58;2021-12-15;62;81;2449;161397;159288;61121;80.9;79.8;30.6
58;2021-12-16;52;95;2864;161449;159383;63985;80.9;79.9;32.1
59;2020-12-27;0;0;0;0;0;0;0.0;0.0;0.0
59;2020-12-28;25;0;0;25;0;0;0.0;0.0;0.0
59;2020-12-29;0;0;0;25;0;0;0.0;0.0;0.0
59;2020-12-30;1;0;0;26;0;0;0.0;0.0;0.0
59;2020-12-31;1;0;0;27;0;0;0.0;0.0;0.0
59;2021-01-01;2;0;0;29;0;0;0.0;0.0;0.0
59;2021-01-02;4;2;0;33;2;0;0.0;0.0;0.0
59;2021-01-03;3;0;0;36;2;0;0.0;0.0;0.0
59;2021-01-04;80;0;0;116;2;0;0.0;0.0;0.0
59;2021-01-05;201;0;0;317;2;0;0.0;0.0;0.0
59;2021-01-06;404;2;0;721;4;0;0.0;0.0;0.0
59;2021-01-07;1276;1;0;1997;5;0;0.1;0.0;0.0
59;2021-01-08;1253;7;0;3250;12;0;0.1;0.0;0.0
59;2021-01-09;564;2;0;3814;14;0;0.1;0.0;0.0
59;2021-01-10;401;0;0;4215;14;0;0.2;0.0;0.0
59;2021-01-11;1768;7;0;5983;21;0;0.2;0.0;0.0
59;2021-01-12;2400;3;0;8383;24;0;0.3;0.0;0.0
59;2021-01-13;2315;5;0;10698;29;0;0.4;0.0;0.0
59;2021-01-14;2664;25;0;13362;54;0;0.5;0.0;0.0
59;2021-01-15;2211;17;0;15573;71;0;0.6;0.0;0.0
59;2021-01-16;735;3;0;16308;74;0;0.6;0.0;0.0
59;2021-01-17;514;4;0;16822;78;0;0.6;0.0;0.0
59;2021-01-18;3440;13;0;20262;91;0;0.8;0.0;0.0
59;2021-01-19;4723;14;0;24985;105;0;1.0;0.0;0.0
59;2021-01-20;4092;13;0;29077;118;0;1.1;0.0;0.0
59;2021-01-21;4715;43;0;33792;161;0;1.3;0.0;0.0
59;2021-01-22;4063;13;0;37855;174;0;1.5;0.0;0.0
59;2021-01-23;1220;2;0;39075;176;0;1.5;0.0;0.0
59;2021-01-24;163;0;0;39238;176;0;1.5;0.0;0.0
59;2021-01-25;2756;52;0;41994;228;0;1.6;0.0;0.0
59;2021-01-26;2836;129;0;44830;357;0;1.7;0.0;0.0
59;2021-01-27;1780;293;0;46610;650;0;1.8;0.0;0.0
59;2021-01-28;3470;747;0;50080;1397;0;1.9;0.1;0.0
59;2021-01-29;2568;774;0;52648;2171;0;2.0;0.1;0.0
59;2021-01-30;298;177;0;52946;2348;0;2.0;0.1;0.0
59;2021-01-31;26;1;0;52972;2349;0;2.0;0.1;0.0
59;2021-02-01;90;838;0;53062;3187;0;2.0;0.1;0.0
59;2021-02-02;697;1445;0;53759;4632;0;2.1;0.2;0.0
59;2021-02-03;3541;1429;0;57300;6061;0;2.2;0.2;0.0
59;2021-02-04;2830;1707;0;60130;7768;0;2.3;0.3;0.0
59;2021-02-05;1053;1386;0;61183;9154;0;2.4;0.4;0.0
59;2021-02-06;216;378;0;61399;9532;0;2.4;0.4;0.0
59;2021-02-07;250;47;0;61649;9579;0;2.4;0.4;0.0
59;2021-02-08;673;1569;0;62322;11148;0;2.4;0.4;0.0
59;2021-02-09;1011;1790;0;63333;12938;0;2.4;0.5;0.0
59;2021-02-10;1010;1620;0;64343;14558;0;2.5;0.6;0.0
59;2021-02-11;1340;1822;0;65683;16380;0;2.5;0.6;0.0
59;2021-02-12;1447;1587;0;67130;17967;0;2.6;0.7;0.0
59;2021-02-13;193;705;0;67323;18672;0;2.6;0.7;0.0
59;2021-02-14;15;41;0;67338;18713;0;2.6;0.7;0.0
59;2021-02-15;1334;3095;0;68672;21808;0;2.7;0.8;0.0
59;2021-02-16;1430;3691;0;70102;25499;0;2.7;1.0;0.0
59;2021-02-17;1591;3818;0;71693;29317;0;2.8;1.1;0.0
59;2021-02-18;3024;5177;0;74717;34494;0;2.9;1.3;0.0
59;2021-02-19;3209;3635;0;77926;38129;0;3.0;1.5;0.0
59;2021-02-20;1383;1558;0;79309;39687;0;3.1;1.5;0.0
59;2021-02-21;246;244;0;79555;39931;0;3.1;1.5;0.0
59;2021-02-22;1407;2550;0;80962;42481;0;3.1;1.6;0.0
59;2021-02-23;2605;2854;0;83567;45335;0;3.2;1.8;0.0
59;2021-02-24;3994;3888;0;87561;49223;0;3.4;1.9;0.0
59;2021-02-25;6731;3561;0;94292;52784;0;3.6;2.0;0.0
59;2021-02-26;6355;1826;0;100647;54610;0;3.9;2.1;0.0
59;2021-02-27;3025;186;0;103672;54796;0;4.0;2.1;0.0
59;2021-02-28;204;62;0;103876;54858;0;4.0;2.1;0.0
59;2021-03-01;3583;652;0;107459;55510;0;4.2;2.1;0.0
59;2021-03-02;4764;572;0;112223;56082;0;4.3;2.2;0.0
59;2021-03-03;5648;979;0;117871;57061;0;4.6;2.2;0.0
59;2021-03-04;6992;928;0;124863;57989;0;4.8;2.2;0.0
59;2021-03-05;7744;980;0;132607;58969;0;5.1;2.3;0.0
59;2021-03-06;11372;560;0;143979;59529;0;5.6;2.3;0.0
59;2021-03-07;7480;365;0;151459;59894;0;5.9;2.3;0.0
59;2021-03-08;4366;1076;0;155825;60970;0;6.0;2.4;0.0
59;2021-03-09;6388;1390;0;162213;62360;0;6.3;2.4;0.0
59;2021-03-10;6842;1213;0;169055;63573;0;6.5;2.5;0.0
59;2021-03-11;9269;1930;0;178324;65503;0;6.9;2.5;0.0
59;2021-03-12;11927;1597;0;190251;67100;0;7.3;2.6;0.0
59;2021-03-13;16249;1099;0;206500;68199;0;8.0;2.6;0.0
59;2021-03-14;6788;374;0;213288;68573;0;8.2;2.6;0.0
59;2021-03-15;5503;1491;0;218791;70064;0;8.5;2.7;0.0
59;2021-03-16;3699;1368;0;222490;71432;0;8.6;2.8;0.0
59;2021-03-17;3789;2036;0;226279;73468;0;8.7;2.8;0.0
59;2021-03-18;3905;2383;0;230184;75851;0;8.9;2.9;0.0
59;2021-03-19;7642;1859;0;237826;77710;0;9.2;3.0;0.0
59;2021-03-20;15512;1293;0;253338;79003;0;9.8;3.1;0.0
59;2021-03-21;6342;462;0;259680;79465;0;10.0;3.1;0.0
59;2021-03-22;5286;1736;0;264966;81201;0;10.2;3.1;0.0
59;2021-03-23;7678;2816;0;272644;84017;0;10.5;3.2;0.0
59;2021-03-24;6948;2982;0;279592;86999;0;10.8;3.4;0.0
59;2021-03-25;10497;2561;0;290089;89560;0;11.2;3.5;0.0
59;2021-03-26;12207;2875;0;302296;92435;0;11.7;3.6;0.0
59;2021-03-27;15160;1155;0;317456;93590;0;12.3;3.6;0.0
59;2021-03-28;7845;366;0;325301;93956;0;12.6;3.6;0.0
59;2021-03-29;5498;3135;0;330799;97091;0;12.8;3.8;0.0
59;2021-03-30;7568;3746;0;338367;100837;0;13.1;3.9;0.0
59;2021-03-31;6246;4137;0;344613;104974;0;13.3;4.1;0.0
59;2021-04-01;7536;4924;0;352149;109898;0;13.6;4.2;0.0
59;2021-04-02;7722;5446;0;359871;115344;0;13.9;4.5;0.0
59;2021-04-03;12652;4235;0;372523;119579;0;14.4;4.6;0.0
59;2021-04-04;5216;2163;0;377739;121742;0;14.6;4.7;0.0
59;2021-04-05;5598;1473;0;383337;123215;0;14.8;4.8;0.0
59;2021-04-06;5482;4420;0;388819;127635;0;15.0;4.9;0.0
59;2021-04-07;7693;5335;0;396512;132970;0;15.3;5.1;0.0
59;2021-04-08;10321;5790;0;406833;138760;0;15.7;5.4;0.0
59;2021-04-09;13287;5838;0;420120;144598;0;16.2;5.6;0.0
59;2021-04-10;11219;6119;0;431339;150717;0;16.7;5.8;0.0
59;2021-04-11;4471;3522;0;435810;154239;0;16.8;6.0;0.0
59;2021-04-12;6222;4218;0;442032;158457;0;17.1;6.1;0.0
59;2021-04-13;8981;4714;0;451013;163171;0;17.4;6.3;0.0
59;2021-04-14;8735;4297;0;459748;167468;0;17.8;6.5;0.0
59;2021-04-15;10216;4839;0;469964;172307;0;18.2;6.7;0.0
59;2021-04-16;10708;5397;0;480672;177704;0;18.6;6.9;0.0
59;2021-04-17;7111;8739;0;487783;186443;0;18.8;7.2;0.0
59;2021-04-18;3078;4218;0;490861;190661;0;19.0;7.4;0.0
59;2021-04-19;4887;4149;0;495748;194810;0;19.1;7.5;0.0
59;2021-04-20;6895;4264;0;502643;199074;0;19.4;7.7;0.0
59;2021-04-21;6306;4538;0;508949;203612;0;19.7;7.9;0.0
59;2021-04-22;8375;5578;0;517324;209190;0;20.0;8.1;0.0
59;2021-04-23;8338;5741;0;525662;214931;0;20.3;8.3;0.0
59;2021-04-24;5422;7975;0;531084;222906;0;20.5;8.6;0.0
59;2021-04-25;3132;5886;0;534216;228792;0;20.6;8.8;0.0
59;2021-04-26;6259;3739;0;540475;232531;0;20.9;9.0;0.0
59;2021-04-27;8201;5262;0;548676;237793;0;21.2;9.2;0.0
59;2021-04-28;8642;6609;0;557318;244402;0;21.5;9.4;0.0
59;2021-04-29;9254;8612;0;566572;253014;0;21.9;9.8;0.0
59;2021-04-30;10259;8516;0;576831;261530;0;22.3;10.1;0.0
59;2021-05-01;11332;7127;0;588163;268657;0;22.7;10.4;0.0
59;2021-05-02;8156;5568;0;596319;274225;0;23.0;10.6;0.0
59;2021-05-03;9021;4978;0;605340;279203;0;23.4;10.8;0.0
59;2021-05-04;10938;6030;0;616278;285233;0;23.8;11.0;0.0
59;2021-05-05;9857;6281;0;626135;291514;0;24.2;11.3;0.0
59;2021-05-06;10838;8308;0;636973;299822;0;24.6;11.6;0.0
59;2021-05-07;12511;9450;0;649484;309272;0;25.1;11.9;0.0
59;2021-05-08;13743;3949;0;663227;313221;0;25.6;12.1;0.0
59;2021-05-09;10609;3217;0;673836;316438;0;26.0;12.2;0.0
59;2021-05-10;11611;6503;0;685447;322941;0;26.5;12.5;0.0
59;2021-05-11;14302;8310;0;699749;331251;0;27.0;12.8;0.0
59;2021-05-12;15748;8505;0;715497;339756;0;27.6;13.1;0.0
59;2021-05-13;17687;3332;0;733184;343088;0;28.3;13.3;0.0
59;2021-05-14;15446;6791;0;748630;349879;0;28.9;13.5;0.0
59;2021-05-15;22732;5110;0;771362;354989;0;29.8;13.7;0.0
59;2021-05-16;19878;2309;0;791240;357298;0;30.6;13.8;0.0
59;2021-05-17;14445;5084;0;805685;362382;0;31.1;14.0;0.0
59;2021-05-18;16549;5634;0;822234;368016;0;31.8;14.2;0.0
59;2021-05-19;17716;5121;0;839950;373137;0;32.4;14.4;0.0
59;2021-05-20;17369;6875;0;857319;380012;0;33.1;14.7;0.0
59;2021-05-21;17603;8088;0;874922;388100;0;33.8;15.0;0.0
59;2021-05-22;23089;5539;0;898011;393639;0;34.7;15.2;0.0
59;2021-05-23;16716;2194;0;914727;395833;0;35.3;15.3;0.0
59;2021-05-24;14845;1915;0;929572;397748;0;35.9;15.4;0.0
59;2021-05-25;14538;6644;0;944110;404392;0;36.5;15.6;0.0
59;2021-05-26;14967;7036;0;959077;411428;0;37.0;15.9;0.0
59;2021-05-27;15423;9055;0;974500;420483;0;37.6;16.2;0.0
59;2021-05-28;15163;11249;0;989663;431732;0;38.2;16.7;0.0
59;2021-05-29;13848;8591;0;1003511;440323;0;38.8;17.0;0.0
59;2021-05-30;7838;1774;0;1011349;442097;0;39.1;17.1;0.0
59;2021-05-31;13613;7703;0;1024962;449800;0;39.6;17.4;0.0
59;2021-06-01;14790;10313;0;1039752;460113;0;40.2;17.8;0.0
59;2021-06-02;14347;9722;0;1054099;469835;0;40.7;18.1;0.0
59;2021-06-03;15009;11844;0;1069108;481679;0;41.3;18.6;0.0
59;2021-06-04;15277;13204;0;1084385;494883;0;41.9;19.1;0.0
59;2021-06-05;14215;9106;0;1098600;503989;0;42.4;19.5;0.0
59;2021-06-06;8147;3063;0;1106747;507052;0;42.7;19.6;0.0
59;2021-06-07;10032;9143;0;1116779;516195;0;43.1;19.9;0.0
59;2021-06-08;11336;10882;0;1128115;527077;0;43.6;20.4;0.0
59;2021-06-09;10611;11589;0;1138726;538666;0;44.0;20.8;0.0
59;2021-06-10;11259;11959;0;1149985;550625;0;44.4;21.3;0.0
59;2021-06-11;10940;15567;0;1160925;566192;0;44.8;21.9;0.0
59;2021-06-12;10671;13155;0;1171596;579347;0;45.3;22.4;0.0
59;2021-06-13;5941;6672;0;1177537;586019;0;45.5;22.6;0.0
59;2021-06-14;6284;12248;0;1183821;598267;0;45.7;23.1;0.0
59;2021-06-15;8149;15559;0;1191970;613826;0;46.0;23.7;0.0
59;2021-06-16;9054;13285;0;1201024;627111;0;46.4;24.2;0.0
59;2021-06-17;9052;15282;0;1210076;642393;0;46.7;24.8;0.0
59;2021-06-18;8987;19192;0;1219063;661585;0;47.1;25.6;0.0
59;2021-06-19;8624;16436;0;1227687;678021;0;47.4;26.2;0.0
59;2021-06-20;4442;9237;0;1232129;687258;0;47.6;26.5;0.0
59;2021-06-21;5244;15163;0;1237373;702421;0;47.8;27.1;0.0
59;2021-06-22;6161;18266;0;1243534;720687;0;48.0;27.8;0.0
59;2021-06-23;5983;18576;0;1249517;739263;0;48.3;28.6;0.0
59;2021-06-24;7100;19998;0;1256617;759261;0;48.5;29.3;0.0
59;2021-06-25;6342;21025;0;1262959;780286;0;48.8;30.1;0.0
59;2021-06-26;6211;23116;0;1269170;803402;0;49.0;31.0;0.0
59;2021-06-27;4219;15860;0;1273389;819262;0;49.2;31.6;0.0
59;2021-06-28;4771;18988;0;1278160;838250;0;49.4;32.4;0.0
59;2021-06-29;5364;20051;0;1283524;858301;0;49.6;33.2;0.0
59;2021-06-30;6115;19703;0;1289639;878004;0;49.8;33.9;0.0
59;2021-07-01;7058;20303;0;1296697;898307;0;50.1;34.7;0.0
59;2021-07-02;7230;22606;0;1303927;920913;0;50.4;35.6;0.0
59;2021-07-03;5456;23761;0;1309383;944674;0;50.6;36.5;0.0
59;2021-07-04;4038;14730;0;1313421;959404;0;50.7;37.1;0.0
59;2021-07-05;5568;16547;0;1318989;975951;0;50.9;37.7;0.0
59;2021-07-06;6486;18471;0;1325475;994422;0;51.2;38.4;0.0
59;2021-07-07;6820;17174;0;1332295;1011596;0;51.5;39.1;0.0
59;2021-07-08;8070;17395;0;1340365;1028991;0;51.8;39.7;0.0
59;2021-07-09;7601;19789;0;1347966;1048780;0;52.1;40.5;0.0
59;2021-07-10;7226;17813;0;1355192;1066593;0;52.3;41.2;0.0
59;2021-07-11;4056;9289;0;1359248;1075882;0;52.5;41.6;0.0
59;2021-07-12;5781;17496;0;1365029;1093378;0;52.7;42.2;0.0
59;2021-07-13;9840;20613;0;1374869;1113991;0;53.1;43.0;0.0
59;2021-07-14;10000;8183;0;1384869;1122174;0;53.5;43.3;0.0
59;2021-07-15;11823;20255;0;1396692;1142429;0;53.9;44.1;0.0
59;2021-07-16;13255;20361;0;1409947;1162790;0;54.5;44.9;0.0
59;2021-07-17;12580;16759;0;1422527;1179549;0;54.9;45.6;0.0
59;2021-07-18;7626;8170;0;1430153;1187719;0;55.2;45.9;0.0
59;2021-07-19;10527;15962;0;1440680;1203681;0;55.6;46.5;0.0
59;2021-07-20;13571;17057;0;1454251;1220738;0;56.2;47.2;0.0
59;2021-07-21;14923;15644;0;1469174;1236382;0;56.7;47.8;0.0
59;2021-07-22;17292;15427;0;1486466;1251809;0;57.4;48.4;0.0
59;2021-07-23;16087;15973;0;1502553;1267782;0;58.0;49.0;0.0
59;2021-07-24;16092;12363;0;1518645;1280145;0;58.7;49.4;0.0
59;2021-07-25;11225;6968;0;1529870;1287113;0;59.1;49.7;0.0
59;2021-07-26;12946;12401;0;1542816;1299514;0;59.6;50.2;0.0
59;2021-07-27;16122;12077;0;1558938;1311591;0;60.2;50.7;0.0
59;2021-07-28;17459;11841;0;1576397;1323432;0;60.9;51.1;0.0
59;2021-07-29;17377;11859;0;1593774;1335291;0;61.6;51.6;0.0
59;2021-07-30;15997;11622;0;1609771;1346913;0;62.2;52.0;0.0
59;2021-07-31;13536;8926;0;1623307;1355839;0;62.7;52.4;0.0
59;2021-08-01;9298;4364;0;1632605;1360203;0;63.1;52.5;0.0
59;2021-08-02;12278;10056;0;1644883;1370259;0;63.5;52.9;0.0
59;2021-08-03;13655;10213;0;1658538;1380472;0;64.1;53.3;0.0
59;2021-08-04;11754;8811;0;1670292;1389283;0;64.5;53.7;0.0
59;2021-08-05;12957;10045;0;1683249;1399328;0;65.0;54.0;0.0
59;2021-08-06;12568;11338;0;1695817;1410666;0;65.5;54.5;0.0
59;2021-08-07;9311;8922;0;1705128;1419588;0;65.9;54.8;0.0
59;2021-08-08;6425;5066;0;1711553;1424654;0;66.1;55.0;0.0
59;2021-08-09;8341;11063;0;1719894;1435717;0;66.4;55.5;0.0
59;2021-08-10;10268;11208;0;1730162;1446925;0;66.8;55.9;0.0
59;2021-08-11;8729;9929;0;1738891;1456854;0;67.2;56.3;0.0
59;2021-08-12;9060;12510;0;1747951;1469364;0;67.5;56.8;0.0
59;2021-08-13;8410;11926;0;1756361;1481290;0;67.8;57.2;0.0
59;2021-08-14;5683;10461;0;1762044;1491751;0;68.1;57.6;0.0
59;2021-08-15;3042;4382;0;1765086;1496133;0;68.2;57.8;0.0
59;2021-08-16;5783;14047;0;1770869;1510180;0;68.4;58.3;0.0
59;2021-08-17;6991;13243;0;1777860;1523423;0;68.7;58.8;0.0
59;2021-08-18;5814;12022;0;1783674;1535445;0;68.9;59.3;0.0
59;2021-08-19;6202;13934;0;1789876;1549379;0;69.1;59.8;0.0
59;2021-08-20;5734;14604;0;1795610;1563983;0;69.4;60.4;0.0
59;2021-08-21;4083;10376;0;1799693;1574359;0;69.5;60.8;0.0
59;2021-08-22;2592;7170;0;1802285;1581529;0;69.6;61.1;0.0
59;2021-08-23;4622;15572;0;1806907;1597101;0;69.8;61.7;0.0
59;2021-08-24;5263;15319;0;1812170;1612420;0;70.0;62.3;0.0
59;2021-08-25;4553;13201;0;1816723;1625621;0;70.2;62.8;0.0
59;2021-08-26;5006;14337;0;1821729;1639958;0;70.4;63.3;0.0
59;2021-08-27;4817;15176;0;1826546;1655134;0;70.6;63.9;0.0
59;2021-08-28;3609;11900;0;1830155;1667034;0;70.7;64.4;0.0
59;2021-08-29;1761;7859;0;1831916;1674893;0;70.8;64.7;0.0
59;2021-08-30;3714;12340;268;1835630;1687233;268;70.9;65.2;0.0
59;2021-08-31;3681;12155;550;1839311;1699388;818;71.0;65.6;0.0
59;2021-09-01;3601;9566;960;1842912;1708954;1778;71.2;66.0;0.1
59;2021-09-02;3166;9814;1147;1846078;1718768;2925;71.3;66.4;0.1
59;2021-09-03;3666;10577;1285;1849744;1729345;4210;71.4;66.8;0.2
59;2021-09-04;3252;8856;592;1852996;1738201;4802;71.6;67.1;0.2
59;2021-09-05;1060;3164;202;1854056;1741365;5004;71.6;67.3;0.2
59;2021-09-06;2094;5989;1220;1856150;1747354;6224;71.7;67.5;0.2
59;2021-09-07;2190;5965;1105;1858340;1753319;7329;71.8;67.7;0.3
59;2021-09-08;2522;6472;1051;1860862;1759791;8380;71.9;68.0;0.3
59;2021-09-09;2343;5509;1071;1863205;1765300;9451;72.0;68.2;0.4
59;2021-09-10;3236;6584;1426;1866441;1771884;10877;72.1;68.4;0.4
59;2021-09-11;2464;6723;520;1868905;1778607;11397;72.2;68.7;0.4
59;2021-09-12;830;2543;147;1869735;1781150;11544;72.2;68.8;0.4
59;2021-09-13;1978;4126;1401;1871713;1785276;12945;72.3;69.0;0.5
59;2021-09-14;2304;4207;1924;1874017;1789483;14869;72.4;69.1;0.6
59;2021-09-15;2272;5274;1407;1876289;1794757;16276;72.5;69.3;0.6
59;2021-09-16;2086;4077;1985;1878375;1798834;18261;72.6;69.5;0.7
59;2021-09-17;2799;5187;1996;1881174;1804021;20257;72.7;69.7;0.8
59;2021-09-18;1673;5586;660;1882847;1809607;20917;72.7;69.9;0.8
59;2021-09-19;327;1193;146;1883174;1810800;21063;72.7;69.9;0.8
59;2021-09-20;1396;3136;1711;1884570;1813936;22774;72.8;70.1;0.9
59;2021-09-21;1277;2816;2100;1885847;1816752;24874;72.8;70.2;1.0
59;2021-09-22;1390;4641;1901;1887237;1821393;26775;72.9;70.4;1.0
59;2021-09-23;1415;2717;2188;1888652;1824110;28963;72.9;70.5;1.1
59;2021-09-24;1818;4067;2032;1890470;1828177;30995;73.0;70.6;1.2
59;2021-09-25;1143;3822;777;1891613;1831999;31772;73.1;70.8;1.2
59;2021-09-26;280;1087;146;1891893;1833086;31918;73.1;70.8;1.2
59;2021-09-27;1018;2401;1802;1892911;1835487;33720;73.1;70.9;1.3
59;2021-09-28;1044;2110;1709;1893955;1837597;35429;73.2;71.0;1.4
59;2021-09-29;1256;2888;1746;1895211;1840485;37175;73.2;71.1;1.4
59;2021-09-30;1180;2186;1938;1896391;1842671;39113;73.2;71.2;1.5
59;2021-10-01;2021;3238;2581;1898412;1845909;41694;73.3;71.3;1.6
59;2021-10-02;1452;3036;1290;1899864;1848945;42984;73.4;71.4;1.7
59;2021-10-03;233;594;172;1900097;1849539;43156;73.4;71.4;1.7
59;2021-10-04;1207;1934;2422;1901304;1851473;45578;73.4;71.5;1.8
59;2021-10-05;1119;2051;2412;1902423;1853524;47990;73.5;71.6;1.9
59;2021-10-06;1309;2363;2747;1903732;1855887;50737;73.5;71.7;2.0
59;2021-10-07;989;1798;2610;1904721;1857685;53347;73.6;71.8;2.1
59;2021-10-08;1701;3193;3407;1906422;1860878;56754;73.6;71.9;2.2
59;2021-10-09;1257;2164;1782;1907679;1863042;58536;73.7;72.0;2.3
59;2021-10-10;264;430;352;1907943;1863472;58888;73.7;72.0;2.3
59;2021-10-11;1082;1560;2956;1909025;1865032;61844;73.7;72.0;2.4
59;2021-10-12;1070;1595;3183;1910095;1866627;65027;73.8;72.1;2.5
59;2021-10-13;1212;1859;3117;1911307;1868486;68144;73.8;72.2;2.6
59;2021-10-14;976;1510;2786;1912283;1869996;70930;73.9;72.2;2.7
59;2021-10-15;1503;2459;4035;1913786;1872455;74965;73.9;72.3;2.9
59;2021-10-16;1171;1643;1945;1914957;1874098;76910;74.0;72.4;3.0
59;2021-10-17;258;328;325;1915215;1874426;77235;74.0;72.4;3.0
59;2021-10-18;991;1224;3047;1916206;1875650;80282;74.0;72.4;3.1
59;2021-10-19;915;1318;3429;1917121;1876968;83711;74.0;72.5;3.2
59;2021-10-20;1071;1482;3608;1918192;1878450;87319;74.1;72.6;3.4
59;2021-10-21;817;1358;3246;1919009;1879808;90565;74.1;72.6;3.5
59;2021-10-22;1237;1801;4315;1920246;1881609;94880;74.2;72.7;3.7
59;2021-10-23;1044;1406;2365;1921290;1883015;97245;74.2;72.7;3.8
59;2021-10-24;174;232;416;1921464;1883247;97661;74.2;72.7;3.8
59;2021-10-25;940;1179;3347;1922404;1884426;101008;74.3;72.8;3.9
59;2021-10-26;821;1081;3529;1923225;1885507;104537;74.3;72.8;4.0
59;2021-10-27;970;1351;4002;1924195;1886858;108539;74.3;72.9;4.2
59;2021-10-28;794;847;3250;1924989;1887705;111789;74.4;72.9;4.3
59;2021-10-29;1109;1470;4694;1926098;1889175;116483;74.4;73.0;4.5
59;2021-10-30;729;1276;2434;1926827;1890451;118917;74.4;73.0;4.6
59;2021-10-31;109;165;268;1926936;1890616;119185;74.4;73.0;4.6
59;2021-11-01;132;79;83;1927068;1890695;119268;74.4;73.0;4.6
59;2021-11-02;985;1420;4250;1928053;1892115;123518;74.5;73.1;4.8
59;2021-11-03;1028;1439;4799;1929081;1893554;128317;74.5;73.1;5.0
59;2021-11-04;804;944;3711;1929885;1894498;132028;74.5;73.2;5.1
59;2021-11-05;1133;1579;5319;1931018;1896077;137347;74.6;73.2;5.3
59;2021-11-06;858;1218;3098;1931876;1897295;140445;74.6;73.3;5.4
59;2021-11-07;123;226;428;1931999;1897521;140873;74.6;73.3;5.4
59;2021-11-08;694;1081;4772;1932693;1898602;145645;74.7;73.3;5.6
59;2021-11-09;830;1173;6174;1933523;1899775;151819;74.7;73.4;5.9
59;2021-11-10;1151;1478;6874;1934674;1901253;158693;74.7;73.4;6.1
59;2021-11-11;42;73;208;1934716;1901326;158901;74.7;73.4;6.1
59;2021-11-12;1096;1406;7564;1935812;1902732;166465;74.8;73.5;6.4
59;2021-11-13;897;1144;4125;1936709;1903876;170590;74.8;73.5;6.6
59;2021-11-14;121;117;441;1936830;1903993;171031;74.8;73.5;6.6
59;2021-11-15;764;1023;5925;1937594;1905016;176956;74.8;73.6;6.8
59;2021-11-16;883;1005;6826;1938477;1906021;183782;74.9;73.6;7.1
59;2021-11-17;1104;1323;6855;1939581;1907344;190637;74.9;73.7;7.4
59;2021-11-18;889;1005;6668;1940470;1908349;197305;75.0;73.7;7.6
59;2021-11-19;1357;1486;8987;1941827;1909835;206292;75.0;73.8;8.0
59;2021-11-20;1085;1217;5054;1942912;1911052;211346;75.0;73.8;8.2
59;2021-11-21;120;152;472;1943032;1911204;211818;75.0;73.8;8.2
59;2021-11-22;814;673;6177;1943846;1911877;217995;75.1;73.8;8.4
59;2021-11-23;934;900;8008;1944780;1912777;226003;75.1;73.9;8.7
59;2021-11-24;1072;1221;7490;1945852;1913998;233493;75.2;73.9;9.0
59;2021-11-25;866;906;9590;1946718;1914904;243083;75.2;74.0;9.4
59;2021-11-26;1151;1293;15309;1947869;1916197;258392;75.2;74.0;10.0
59;2021-11-27;905;1111;11731;1948774;1917308;270123;75.3;74.1;10.4
59;2021-11-28;151;212;4720;1948925;1917520;274843;75.3;74.1;10.6
59;2021-11-29;697;760;15807;1949622;1918280;290650;75.3;74.1;11.2
59;2021-11-30;888;932;20673;1950510;1919212;311323;75.3;74.1;12.0
59;2021-12-01;742;1101;20211;1951252;1920313;331534;75.4;74.2;12.8
59;2021-12-02;675;683;22053;1951927;1920996;353587;75.4;74.2;13.7
59;2021-12-03;848;1131;26562;1952775;1922127;380149;75.4;74.2;14.7
59;2021-12-04;649;1040;19492;1953424;1923167;399641;75.5;74.3;15.4
59;2021-12-05;176;238;7965;1953600;1923405;407606;75.5;74.3;15.7
59;2021-12-06;634;839;23596;1954234;1924244;431202;75.5;74.3;16.7
59;2021-12-07;692;951;27362;1954926;1925195;458564;75.5;74.4;17.7
59;2021-12-08;725;1073;25073;1955651;1926268;483637;75.5;74.4;18.7
59;2021-12-09;742;882;27760;1956393;1927150;511397;75.6;74.4;19.8
59;2021-12-10;758;1297;31466;1957151;1928447;542863;75.6;74.5;21.0
59;2021-12-11;674;1135;22997;1957825;1929582;565860;75.6;74.5;21.9
59;2021-12-12;238;222;8723;1958063;1929804;574583;75.6;74.5;22.2
59;2021-12-13;667;976;25880;1958730;1930780;600463;75.7;74.6;23.2
59;2021-12-14;799;917;30273;1959529;1931697;630736;75.7;74.6;24.4
59;2021-12-15;777;1170;27613;1960306;1932867;658349;75.7;74.7;25.4
59;2021-12-16;765;943;30234;1961071;1933810;688583;75.7;74.7;26.6
60;2020-12-27;0;0;0;0;0;0;0.0;0.0;0.0
60;2020-12-28;1;0;0;1;0;0;0.0;0.0;0.0
60;2020-12-29;1;0;0;2;0;0;0.0;0.0;0.0
60;2020-12-30;2;0;0;4;0;0;0.0;0.0;0.0
60;2020-12-31;0;0;0;4;0;0;0.0;0.0;0.0
60;2021-01-01;0;0;0;4;0;0;0.0;0.0;0.0
60;2021-01-02;4;0;0;8;0;0;0.0;0.0;0.0
60;2021-01-03;1;0;0;9;0;0;0.0;0.0;0.0
60;2021-01-04;4;0;0;13;0;0;0.0;0.0;0.0
60;2021-01-05;45;1;0;58;1;0;0.0;0.0;0.0
60;2021-01-06;203;4;0;261;5;0;0.0;0.0;0.0
60;2021-01-07;238;4;0;499;9;0;0.1;0.0;0.0
60;2021-01-08;398;4;0;897;13;0;0.1;0.0;0.0
60;2021-01-09;23;0;0;920;13;0;0.1;0.0;0.0
60;2021-01-10;70;0;0;990;13;0;0.1;0.0;0.0
60;2021-01-11;394;5;0;1384;18;0;0.2;0.0;0.0
60;2021-01-12;590;6;0;1974;24;0;0.2;0.0;0.0
60;2021-01-13;576;8;0;2550;32;0;0.3;0.0;0.0
60;2021-01-14;592;11;0;3142;43;0;0.4;0.0;0.0
60;2021-01-15;744;12;0;3886;55;0;0.5;0.0;0.0
60;2021-01-16;132;1;0;4018;56;0;0.5;0.0;0.0
60;2021-01-17;41;0;0;4059;56;0;0.5;0.0;0.0
60;2021-01-18;928;14;0;4987;70;0;0.6;0.0;0.0
60;2021-01-19;1233;18;0;6220;88;0;0.8;0.0;0.0
60;2021-01-20;1760;13;0;7980;101;0;1.0;0.0;0.0
60;2021-01-21;2177;13;0;10157;114;0;1.2;0.0;0.0
60;2021-01-22;1459;23;0;11616;137;0;1.4;0.0;0.0
60;2021-01-23;469;4;0;12085;141;0;1.5;0.0;0.0
60;2021-01-24;71;1;0;12156;142;0;1.5;0.0;0.0
60;2021-01-25;914;12;0;13070;154;0;1.6;0.0;0.0
60;2021-01-26;889;16;0;13959;170;0;1.7;0.0;0.0
60;2021-01-27;657;29;0;14616;199;0;1.8;0.0;0.0
60;2021-01-28;477;171;0;15093;370;0;1.8;0.0;0.0
60;2021-01-29;160;126;0;15253;496;0;1.8;0.1;0.0
60;2021-01-30;33;9;0;15286;505;0;1.9;0.1;0.0
60;2021-01-31;24;56;0;15310;561;0;1.9;0.1;0.0
60;2021-02-01;77;140;0;15387;701;0;1.9;0.1;0.0
60;2021-02-02;46;193;0;15433;894;0;1.9;0.1;0.0
60;2021-02-03;178;295;0;15611;1189;0;1.9;0.1;0.0
60;2021-02-04;191;376;0;15802;1565;0;1.9;0.2;0.0
60;2021-02-05;314;472;0;16116;2037;0;2.0;0.2;0.0
60;2021-02-06;75;85;0;16191;2122;0;2.0;0.3;0.0
60;2021-02-07;29;46;0;16220;2168;0;2.0;0.3;0.0
60;2021-02-08;342;534;0;16562;2702;0;2.0;0.3;0.0
60;2021-02-09;356;521;0;16918;3223;0;2.1;0.4;0.0
60;2021-02-10;593;1055;0;17511;4278;0;2.1;0.5;0.0
60;2021-02-11;965;1123;0;18476;5401;0;2.2;0.7;0.0
60;2021-02-12;881;822;0;19357;6223;0;2.3;0.8;0.0
60;2021-02-13;113;260;0;19470;6483;0;2.4;0.8;0.0
60;2021-02-14;24;89;0;19494;6572;0;2.4;0.8;0.0
60;2021-02-15;633;844;0;20127;7416;0;2.4;0.9;0.0
60;2021-02-16;638;970;0;20765;8386;0;2.5;1.0;0.0
60;2021-02-17;652;941;0;21417;9327;0;2.6;1.1;0.0
60;2021-02-18;681;891;0;22098;10218;0;2.7;1.2;0.0
60;2021-02-19;655;819;0;22753;11037;0;2.8;1.3;0.0
60;2021-02-20;109;208;0;22862;11245;0;2.8;1.4;0.0
60;2021-02-21;27;119;0;22889;11364;0;2.8;1.4;0.0
60;2021-02-22;463;846;0;23352;12210;0;2.8;1.5;0.0
60;2021-02-23;573;777;0;23925;12987;0;2.9;1.6;0.0
60;2021-02-24;802;578;0;24727;13565;0;3.0;1.6;0.0
60;2021-02-25;1156;402;0;25883;13967;0;3.1;1.7;0.0
60;2021-02-26;1294;240;0;27177;14207;0;3.3;1.7;0.0
60;2021-02-27;631;56;0;27808;14263;0;3.4;1.7;0.0
60;2021-02-28;6;12;0;27814;14275;0;3.4;1.7;0.0
60;2021-03-01;849;78;0;28663;14353;0;3.5;1.7;0.0
60;2021-03-02;1001;194;0;29664;14547;0;3.6;1.8;0.0
60;2021-03-03;1353;444;0;31017;14991;0;3.8;1.8;0.0
60;2021-03-04;1824;506;0;32841;15497;0;4.0;1.9;0.0
60;2021-03-05;1983;325;0;34824;15822;0;4.2;1.9;0.0
60;2021-03-06;2171;170;0;36995;15992;0;4.5;1.9;0.0
60;2021-03-07;1113;65;0;38108;16057;0;4.6;1.9;0.0
60;2021-03-08;1167;366;0;39275;16423;0;4.8;2.0;0.0
60;2021-03-09;1933;393;0;41208;16816;0;5.0;2.0;0.0
60;2021-03-10;1974;457;0;43182;17273;0;5.2;2.1;0.0
60;2021-03-11;2431;440;0;45613;17713;0;5.5;2.1;0.0
60;2021-03-12;2750;544;0;48363;18257;0;5.9;2.2;0.0
60;2021-03-13;3737;234;0;52100;18491;0;6.3;2.2;0.0
60;2021-03-14;1655;62;0;53755;18553;0;6.5;2.2;0.0
60;2021-03-15;2133;505;0;55888;19058;0;6.8;2.3;0.0
60;2021-03-16;1534;606;0;57422;19664;0;7.0;2.4;0.0
60;2021-03-17;1648;595;0;59070;20259;0;7.2;2.5;0.0
60;2021-03-18;1668;709;0;60738;20968;0;7.4;2.5;0.0
60;2021-03-19;2576;525;0;63314;21493;0;7.7;2.6;0.0
60;2021-03-20;3116;202;0;66430;21695;0;8.1;2.6;0.0
60;2021-03-21;1964;88;0;68394;21783;0;8.3;2.6;0.0
60;2021-03-22;2155;697;0;70549;22480;0;8.6;2.7;0.0
60;2021-03-23;3212;717;0;73761;23197;0;8.9;2.8;0.0
60;2021-03-24;3083;864;0;76844;24061;0;9.3;2.9;0.0
60;2021-03-25;3881;853;0;80725;24914;0;9.8;3.0;0.0
60;2021-03-26;4319;900;0;85044;25814;0;10.3;3.1;0.0
60;2021-03-27;3980;320;0;89024;26134;0;10.8;3.2;0.0
60;2021-03-28;2277;91;0;91301;26225;0;11.1;3.2;0.0
60;2021-03-29;2691;1079;0;93992;27304;0;11.4;3.3;0.0
60;2021-03-30;3380;1091;0;97372;28395;0;11.8;3.4;0.0
60;2021-03-31;2726;1172;0;100098;29567;0;12.1;3.6;0.0
60;2021-04-01;2814;1179;0;102912;30746;0;12.5;3.7;0.0
60;2021-04-02;3288;1214;0;106200;31960;0;12.9;3.9;0.0
60;2021-04-03;3010;1011;0;109210;32971;0;13.2;4.0;0.0
60;2021-04-04;839;476;0;110049;33447;0;13.3;4.1;0.0
60;2021-04-05;520;97;0;110569;33544;0;13.4;4.1;0.0
60;2021-04-06;1955;1695;0;112524;35239;0;13.6;4.3;0.0
60;2021-04-07;2125;1750;0;114649;36989;0;13.9;4.5;0.0
60;2021-04-08;2788;1527;0;117437;38516;0;14.2;4.7;0.0
60;2021-04-09;3204;1554;0;120641;40070;0;14.6;4.9;0.0
60;2021-04-10;2879;1518;0;123520;41588;0;15.0;5.0;0.0
60;2021-04-11;962;926;0;124482;42514;0;15.1;5.2;0.0
60;2021-04-12;2156;1733;0;126638;44247;0;15.3;5.4;0.0
60;2021-04-13;2866;1794;0;129504;46041;0;15.7;5.6;0.0
60;2021-04-14;3064;1818;0;132568;47859;0;16.1;5.8;0.0
60;2021-04-15;3514;1856;0;136082;49715;0;16.5;6.0;0.0
60;2021-04-16;3296;1947;0;139378;51662;0;16.9;6.3;0.0
60;2021-04-17;2711;2061;0;142089;53723;0;17.2;6.5;0.0
60;2021-04-18;549;1707;0;142638;55430;0;17.3;6.7;0.0
60;2021-04-19;1778;2188;0;144416;57618;0;17.5;7.0;0.0
60;2021-04-20;2300;2588;0;146716;60206;0;17.8;7.3;0.0
60;2021-04-21;2645;2184;0;149361;62390;0;18.1;7.6;0.0
60;2021-04-22;2678;2511;0;152039;64901;0;18.4;7.9;0.0
60;2021-04-23;2674;2453;0;154713;67354;0;18.8;8.2;0.0
60;2021-04-24;2364;3236;0;157077;70590;0;19.0;8.6;0.0
60;2021-04-25;1237;1807;0;158314;72397;0;19.2;8.8;0.0
60;2021-04-26;1902;2532;0;160216;74929;0;19.4;9.1;0.0
60;2021-04-27;2485;2818;0;162701;77747;0;19.7;9.4;0.0
60;2021-04-28;3138;2370;0;165839;80117;0;20.1;9.7;0.0
60;2021-04-29;3397;2695;0;169236;82812;0;20.5;10.0;0.0
60;2021-04-30;3588;2806;0;172824;85618;0;20.9;10.4;0.0
60;2021-05-01;2355;1107;0;175179;86725;0;21.2;10.5;0.0
60;2021-05-02;2159;839;0;177338;87564;0;21.5;10.6;0.0
60;2021-05-03;3252;1935;0;180590;89499;0;21.9;10.8;0.0
60;2021-05-04;3369;2383;0;183959;91882;0;22.3;11.1;0.0
60;2021-05-05;3547;2758;0;187506;94640;0;22.7;11.5;0.0
60;2021-05-06;4211;2624;0;191717;97264;0;23.2;11.8;0.0
60;2021-05-07;4083;2642;0;195800;99906;0;23.7;12.1;0.0
60;2021-05-08;3533;1047;0;199333;100953;0;24.2;12.2;0.0
60;2021-05-09;3317;912;0;202650;101865;0;24.6;12.3;0.0
60;2021-05-10;2746;2372;0;205396;104237;0;24.9;12.6;0.0
60;2021-05-11;4080;2520;0;209476;106757;0;25.4;12.9;0.0
60;2021-05-12;4781;2597;0;214257;109354;0;26.0;13.3;0.0
60;2021-05-13;4753;1045;0;219010;110399;0;26.5;13.4;0.0
60;2021-05-14;5489;1795;0;224499;112194;0;27.2;13.6;0.0
60;2021-05-15;5897;1637;0;230396;113831;0;27.9;13.8;0.0
60;2021-05-16;4599;634;0;234995;114465;0;28.5;13.9;0.0
60;2021-05-17;3607;1593;0;238602;116058;0;28.9;14.1;0.0
60;2021-05-18;4178;2105;0;242780;118163;0;29.4;14.3;0.0
60;2021-05-19;4875;1894;0;247655;120057;0;30.0;14.6;0.0
60;2021-05-20;5364;1833;0;253019;121890;0;30.7;14.8;0.0
60;2021-05-21;5753;1934;0;258772;123824;0;31.4;15.0;0.0
60;2021-05-22;4880;1840;0;263652;125664;0;32.0;15.2;0.0
60;2021-05-23;3445;566;0;267097;126230;0;32.4;15.3;0.0
60;2021-05-24;2921;537;0;270018;126767;0;32.7;15.4;0.0
60;2021-05-25;4309;2054;0;274327;128821;0;33.2;15.6;0.0
60;2021-05-26;4801;1839;0;279128;130660;0;33.8;15.8;0.0
60;2021-05-27;5124;2129;0;284252;132789;0;34.5;16.1;0.0
60;2021-05-28;4874;2650;0;289126;135439;0;35.0;16.4;0.0
60;2021-05-29;4732;2254;0;293858;137693;0;35.6;16.7;0.0
60;2021-05-30;1325;369;0;295183;138062;0;35.8;16.7;0.0
60;2021-05-31;4156;2107;0;299339;140169;0;36.3;17.0;0.0
60;2021-06-01;4889;3061;0;304228;143230;0;36.9;17.4;0.0
60;2021-06-02;4466;2513;0;308694;145743;0;37.4;17.7;0.0
60;2021-06-03;4485;2617;0;313179;148360;0;38.0;18.0;0.0
60;2021-06-04;5070;3030;0;318249;151390;0;38.6;18.3;0.0
60;2021-06-05;4564;3346;0;322813;154736;0;39.1;18.8;0.0
60;2021-06-06;2278;898;0;325091;155634;0;39.4;18.9;0.0
60;2021-06-07;2986;2809;0;328077;158443;0;39.8;19.2;0.0
60;2021-06-08;4106;3257;0;332183;161700;0;40.3;19.6;0.0
60;2021-06-09;3696;3596;0;335879;165296;0;40.7;20.0;0.0
60;2021-06-10;3944;3866;0;339823;169162;0;41.2;20.5;0.0
60;2021-06-11;4213;4440;0;344036;173602;0;41.7;21.0;0.0
60;2021-06-12;4008;4196;0;348044;177798;0;42.2;21.5;0.0
60;2021-06-13;1267;2284;0;349311;180082;0;42.3;21.8;0.0
60;2021-06-14;2241;3649;0;351552;183731;0;42.6;22.3;0.0
60;2021-06-15;3296;4544;0;354848;188275;0;43.0;22.8;0.0
60;2021-06-16;3420;4726;0;358268;193001;0;43.4;23.4;0.0
60;2021-06-17;3305;5125;0;361573;198126;0;43.8;24.0;0.0
60;2021-06-18;3480;4868;0;365053;202994;0;44.2;24.6;0.0
60;2021-06-19;3400;4826;0;368453;207820;0;44.7;25.2;0.0
60;2021-06-20;1390;1917;0;369843;209737;0;44.8;25.4;0.0
60;2021-06-21;1625;4349;0;371468;214086;0;45.0;25.9;0.0
60;2021-06-22;2078;5553;0;373546;219639;0;45.3;26.6;0.0
60;2021-06-23;2188;5456;0;375734;225095;0;45.5;27.3;0.0
60;2021-06-24;2084;5747;0;377818;230842;0;45.8;28.0;0.0
60;2021-06-25;2128;6100;0;379946;236942;0;46.0;28.7;0.0
60;2021-06-26;2043;6777;0;381989;243719;0;46.3;29.5;0.0
60;2021-06-27;745;2611;0;382734;246330;0;46.4;29.9;0.0
60;2021-06-28;1840;4322;0;384574;250652;0;46.6;30.4;0.0
60;2021-06-29;2243;5707;0;386817;256359;0;46.9;31.1;0.0
60;2021-06-30;2468;5666;0;389285;262025;0;47.2;31.8;0.0
60;2021-07-01;2263;5423;0;391548;267448;0;47.5;32.4;0.0
60;2021-07-02;2645;6223;0;394193;273671;0;47.8;33.2;0.0
60;2021-07-03;2440;6028;0;396633;279699;0;48.1;33.9;0.0
60;2021-07-04;797;2681;0;397430;282380;0;48.2;34.2;0.0
60;2021-07-05;1809;4632;0;399239;287012;0;48.4;34.8;0.0
60;2021-07-06;2403;5092;0;401642;292104;0;48.7;35.4;0.0
60;2021-07-07;2520;5705;0;404162;297809;0;49.0;36.1;0.0
60;2021-07-08;3001;5382;0;407163;303191;0;49.3;36.7;0.0
60;2021-07-09;2977;6140;0;410140;309331;0;49.7;37.5;0.0
60;2021-07-10;2721;6146;0;412861;315477;0;50.0;38.2;0.0
60;2021-07-11;1215;2099;0;414076;317576;0;50.2;38.5;0.0
60;2021-07-12;1703;5320;0;415779;322896;0;50.4;39.1;0.0
60;2021-07-13;3553;5686;0;419332;328582;0;50.8;39.8;0.0
60;2021-07-14;2859;1837;0;422191;330419;0;51.2;40.0;0.0
60;2021-07-15;4328;5819;0;426519;336238;0;51.7;40.8;0.0
60;2021-07-16;4552;6135;0;431071;342373;0;52.2;41.5;0.0
60;2021-07-17;4484;5668;0;435555;348041;0;52.8;42.2;0.0
60;2021-07-18;2248;2272;0;437803;350313;0;53.1;42.5;0.0
60;2021-07-19;3375;4448;0;441178;354761;0;53.5;43.0;0.0
60;2021-07-20;5066;5539;0;446244;360300;0;54.1;43.7;0.0
60;2021-07-21;5450;5120;0;451694;365420;0;54.7;44.3;0.0
60;2021-07-22;5805;5094;0;457499;370514;0;55.4;44.9;0.0
60;2021-07-23;6084;5706;0;463583;376220;0;56.2;45.6;0.0
60;2021-07-24;4822;5142;0;468405;381362;0;56.8;46.2;0.0
60;2021-07-25;2641;1955;0;471046;383317;0;57.1;46.5;0.0
60;2021-07-26;3913;4163;0;474959;387480;0;57.6;47.0;0.0
60;2021-07-27;5455;5107;0;480414;392587;0;58.2;47.6;0.0
60;2021-07-28;5883;4376;0;486297;396963;0;58.9;48.1;0.0
60;2021-07-29;6109;4360;0;492406;401323;0;59.7;48.6;0.0
60;2021-07-30;5907;4704;0;498313;406027;0;60.4;49.2;0.0
60;2021-07-31;4549;4400;0;502862;410427;0;60.9;49.7;0.0
60;2021-08-01;1779;954;0;504641;411381;0;61.2;49.9;0.0
60;2021-08-02;3835;3105;0;508476;414486;0;61.6;50.2;0.0
60;2021-08-03;4354;3439;0;512830;417925;0;62.2;50.7;0.0
60;2021-08-04;4023;3343;0;516853;421268;0;62.6;51.1;0.0
60;2021-08-05;3715;2974;0;520568;424242;0;63.1;51.4;0.0
60;2021-08-06;4461;3825;0;525029;428067;0;63.6;51.9;0.0
60;2021-08-07;3488;3600;0;528517;431667;0;64.1;52.3;0.0
60;2021-08-08;1521;1081;0;530038;432748;0;64.2;52.4;0.0
60;2021-08-09;2485;3390;0;532523;436138;0;64.5;52.9;0.0
60;2021-08-10;3732;4275;0;536255;440413;0;65.0;53.4;0.0
60;2021-08-11;3205;4122;0;539460;444535;0;65.4;53.9;0.0
60;2021-08-12;2820;3621;0;542280;448156;0;65.7;54.3;0.0
60;2021-08-13;3011;3684;0;545291;451840;0;66.1;54.8;0.0
60;2021-08-14;2568;3044;0;547859;454884;0;66.4;55.1;0.0
60;2021-08-15;1258;631;0;549117;455515;0;66.6;55.2;0.0
60;2021-08-16;2317;4492;0;551434;460007;0;66.8;55.8;0.0
60;2021-08-17;2720;4712;0;554154;464719;0;67.2;56.3;0.0
60;2021-08-18;2216;4097;0;556370;468816;0;67.4;56.8;0.0
60;2021-08-19;1982;3861;0;558352;472677;0;67.7;57.3;0.0
60;2021-08-20;2001;4646;0;560353;477323;0;67.9;57.9;0.0
60;2021-08-21;1621;3839;0;561974;481162;0;68.1;58.3;0.0
60;2021-08-22;575;1450;0;562549;482612;0;68.2;58.5;0.0
60;2021-08-23;1272;4091;0;563821;486703;0;68.3;59.0;0.0
60;2021-08-24;1585;5319;0;565406;492022;0;68.5;59.6;0.0
60;2021-08-25;1738;4572;0;567144;496594;0;68.7;60.2;0.0
60;2021-08-26;1623;4232;1;568767;500826;1;68.9;60.7;0.0
60;2021-08-27;1584;4959;0;570351;505785;1;69.1;61.3;0.0
60;2021-08-28;1504;4762;0;571855;510547;1;69.3;61.9;0.0
60;2021-08-29;573;1986;0;572428;512533;1;69.4;62.1;0.0
60;2021-08-30;1302;3394;46;573730;515927;47;69.5;62.5;0.0
60;2021-08-31;1768;4294;62;575498;520221;109;69.8;63.1;0.0
60;2021-09-01;1534;3326;164;577032;523547;273;69.9;63.5;0.0
60;2021-09-02;1216;3055;182;578248;526602;455;70.1;63.8;0.1
60;2021-09-03;1147;3333;216;579395;529935;671;70.2;64.2;0.1
60;2021-09-04;1597;3947;154;580992;533882;825;70.4;64.7;0.1
60;2021-09-05;367;1246;37;581359;535128;862;70.5;64.9;0.1
60;2021-09-06;886;2555;239;582245;537683;1101;70.6;65.2;0.1
60;2021-09-07;901;2912;300;583146;540595;1401;70.7;65.5;0.2
60;2021-09-08;963;3044;302;584109;543639;1703;70.8;65.9;0.2
60;2021-09-09;748;2454;224;584857;546093;1927;70.9;66.2;0.2
60;2021-09-10;1124;2972;281;585981;549065;2208;71.0;66.5;0.3
60;2021-09-11;1081;3499;163;587062;552564;2371;71.2;67.0;0.3
60;2021-09-12;285;1072;59;587347;553636;2430;71.2;67.1;0.3
60;2021-09-13;652;1768;274;587999;555404;2704;71.3;67.3;0.3
60;2021-09-14;827;1621;391;588826;557025;3095;71.4;67.5;0.4
60;2021-09-15;649;1575;341;589475;558600;3436;71.4;67.7;0.4
60;2021-09-16;955;1513;586;590430;560113;4022;71.6;67.9;0.5
60;2021-09-17;798;1663;566;591228;561776;4588;71.7;68.1;0.6
60;2021-09-18;833;2732;273;592061;564508;4861;71.8;68.4;0.6
60;2021-09-19;169;488;90;592230;564996;4951;71.8;68.5;0.6
60;2021-09-20;467;1184;414;592697;566180;5365;71.8;68.6;0.7
60;2021-09-21;538;1107;618;593235;567287;5983;71.9;68.8;0.7
60;2021-09-22;487;1449;501;593722;568736;6484;72.0;68.9;0.8
60;2021-09-23;651;915;612;594373;569651;7096;72.0;69.0;0.9
60;2021-09-24;533;1351;604;594906;571002;7700;72.1;69.2;0.9
60;2021-09-25;514;2004;237;595420;573006;7937;72.2;69.4;1.0
60;2021-09-26;82;305;19;595502;573311;7956;72.2;69.5;1.0
60;2021-09-27;364;807;461;595866;574118;8417;72.2;69.6;1.0
60;2021-09-28;344;861;572;596210;574979;8989;72.3;69.7;1.1
60;2021-09-29;447;1134;366;596657;576113;9355;72.3;69.8;1.1
60;2021-09-30;401;764;658;597058;576877;10013;72.4;69.9;1.2
60;2021-10-01;640;1173;746;597698;578050;10759;72.4;70.1;1.3
60;2021-10-02;611;1509;469;598309;579559;11228;72.5;70.2;1.4
60;2021-10-03;94;294;58;598403;579853;11286;72.5;70.3;1.4
60;2021-10-04;422;720;646;598825;580573;11932;72.6;70.4;1.4
60;2021-10-05;347;598;483;599172;581171;12415;72.6;70.4;1.5
60;2021-10-06;432;828;666;599604;581999;13081;72.7;70.5;1.6
60;2021-10-07;243;588;543;599847;582587;13624;72.7;70.6;1.7
60;2021-10-08;515;902;723;600362;583489;14347;72.8;70.7;1.7
60;2021-10-09;657;1271;872;601019;584760;15219;72.8;70.9;1.8
60;2021-10-10;61;175;95;601080;584935;15314;72.9;70.9;1.9
60;2021-10-11;323;536;728;601403;585471;16042;72.9;71.0;1.9
60;2021-10-12;249;567;580;601652;586038;16622;72.9;71.0;2.0
60;2021-10-13;398;681;897;602050;586719;17519;73.0;71.1;2.1
60;2021-10-14;291;682;909;602341;587401;18428;73.0;71.2;2.2
60;2021-10-15;423;781;994;602764;588182;19422;73.1;71.3;2.4
60;2021-10-16;564;936;772;603328;589118;20194;73.1;71.4;2.4
60;2021-10-17;46;139;80;603374;589257;20274;73.1;71.4;2.5
60;2021-10-18;292;542;833;603666;589799;21107;73.2;71.5;2.6
60;2021-10-19;277;345;1000;603943;590144;22107;73.2;71.5;2.7
60;2021-10-20;378;502;1079;604321;590646;23186;73.2;71.6;2.8
60;2021-10-21;205;479;915;604526;591125;24101;73.3;71.6;2.9
60;2021-10-22;371;567;1124;604897;591692;25225;73.3;71.7;3.1
60;2021-10-23;451;725;903;605348;592417;26128;73.4;71.8;3.2
60;2021-10-24;35;64;110;605383;592481;26238;73.4;71.8;3.2
60;2021-10-25;270;390;1047;605653;592871;27285;73.4;71.9;3.3
60;2021-10-26;154;261;861;605807;593132;28146;73.4;71.9;3.4
60;2021-10-27;312;459;1206;606119;593591;29352;73.5;71.9;3.6
60;2021-10-28;205;238;986;606324;593829;30338;73.5;72.0;3.7
60;2021-10-29;318;502;1339;606642;594331;31677;73.5;72.0;3.8
60;2021-10-30;326;589;1209;606968;594920;32886;73.6;72.1;4.0
60;2021-10-31;28;70;70;606996;594990;32956;73.6;72.1;4.0
60;2021-11-01;41;25;62;607037;595015;33018;73.6;72.1;4.0
60;2021-11-02;232;309;1047;607269;595324;34065;73.6;72.2;4.1
60;2021-11-03;316;495;1530;607585;595819;35595;73.6;72.2;4.3
60;2021-11-04;249;343;1218;607834;596162;36813;73.7;72.3;4.5
60;2021-11-05;328;416;1663;608162;596578;38476;73.7;72.3;4.7
60;2021-11-06;345;581;1125;608507;597159;39601;73.8;72.4;4.8
60;2021-11-07;26;45;122;608533;597204;39723;73.8;72.4;4.8
60;2021-11-08;192;329;1410;608725;597533;41133;73.8;72.4;5.0
60;2021-11-09;194;283;1549;608919;597816;42682;73.8;72.5;5.2
60;2021-11-10;334;451;2008;609253;598267;44690;73.8;72.5;5.4
60;2021-11-11;65;73;272;609318;598340;44962;73.8;72.5;5.4
60;2021-11-12;303;434;2131;609621;598774;47093;73.9;72.6;5.7
60;2021-11-13;387;543;1600;610008;599317;48693;73.9;72.6;5.9
60;2021-11-14;27;46;190;610035;599363;48883;73.9;72.6;5.9
60;2021-11-15;205;280;1592;610240;599643;50475;74.0;72.7;6.1
60;2021-11-16;259;248;2009;610499;599891;52484;74.0;72.7;6.4
60;2021-11-17;288;333;2037;610787;600224;54521;74.0;72.7;6.6
60;2021-11-18;234;279;1914;611021;600503;56435;74.1;72.8;6.8
60;2021-11-19;307;381;2398;611328;600884;58833;74.1;72.8;7.1
60;2021-11-20;400;492;1627;611728;601376;60460;74.1;72.9;7.3
60;2021-11-21;34;56;218;611762;601432;60678;74.1;72.9;7.4
60;2021-11-22;209;199;2060;611971;601631;62738;74.2;72.9;7.6
60;2021-11-23;202;241;2452;612173;601872;65190;74.2;72.9;7.9
60;2021-11-24;328;327;2609;612501;602199;67799;74.2;73.0;8.2
60;2021-11-25;263;222;2645;612764;602421;70444;74.3;73.0;8.5
60;2021-11-26;346;412;4435;613110;602833;74879;74.3;73.1;9.1
60;2021-11-27;372;436;4013;613482;603269;78892;74.4;73.1;9.6
60;2021-11-28;48;59;875;613530;603328;79767;74.4;73.1;9.7
60;2021-11-29;170;256;4174;613700;603584;83941;74.4;73.2;10.2
60;2021-11-30;183;249;5178;613883;603833;89119;74.4;73.2;10.8
60;2021-12-01;247;301;5804;614130;604134;94923;74.4;73.2;11.5
60;2021-12-02;238;224;6204;614368;604358;101127;74.5;73.2;12.3
60;2021-12-03;213;293;6987;614581;604651;108114;74.5;73.3;13.1
60;2021-12-04;251;429;5770;614832;605080;113884;74.5;73.3;13.8
60;2021-12-05;51;69;1677;614883;605149;115561;74.5;73.3;14.0
60;2021-12-06;183;230;5675;615066;605379;121236;74.5;73.4;14.7
60;2021-12-07;199;238;7729;615265;605617;128965;74.6;73.4;15.6
60;2021-12-08;248;310;6915;615513;605927;135880;74.6;73.4;16.5
60;2021-12-09;247;300;7364;615760;606227;143244;74.6;73.5;17.4
60;2021-12-10;264;368;8850;616024;606595;152094;74.7;73.5;18.4
60;2021-12-11;298;442;7225;616322;607037;159319;74.7;73.6;19.3
60;2021-12-12;65;76;1739;616387;607113;161058;74.7;73.6;19.5
60;2021-12-13;188;257;7222;616575;607370;168280;74.7;73.6;20.4
60;2021-12-14;263;295;9443;616838;607665;177723;74.8;73.6;21.5
60;2021-12-15;241;374;8541;617079;608039;186264;74.8;73.7;22.6
60;2021-12-16;222;301;8813;617301;608340;195077;74.8;73.7;23.6
61;2020-12-27;0;0;0;0;0;0;0.0;0.0;0.0
61;2020-12-28;0;0;0;0;0;0;0.0;0.0;0.0
61;2020-12-29;0;0;0;0;0;0;0.0;0.0;0.0
61;2020-12-30;0;0;0;0;0;0;0.0;0.0;0.0
61;2020-12-31;0;0;0;0;0;0;0.0;0.0;0.0
61;2021-01-01;2;0;0;2;0;0;0.0;0.0;0.0
61;2021-01-02;0;0;0;2;0;0;0.0;0.0;0.0
61;2021-01-03;0;0;0;2;0;0;0.0;0.0;0.0
61;2021-01-04;1;0;0;3;0;0;0.0;0.0;0.0
61;2021-01-05;2;0;0;5;0;0;0.0;0.0;0.0
61;2021-01-06;72;0;0;77;0;0;0.0;0.0;0.0
61;2021-01-07;139;2;0;216;2;0;0.1;0.0;0.0
61;2021-01-08;342;1;0;558;3;0;0.2;0.0;0.0
61;2021-01-09;138;1;0;696;4;0;0.3;0.0;0.0
61;2021-01-10;31;0;0;727;4;0;0.3;0.0;0.0
61;2021-01-11;356;0;0;1083;4;0;0.4;0.0;0.0
61;2021-01-12;537;3;0;1620;7;0;0.6;0.0;0.0
61;2021-01-13;638;1;0;2258;8;0;0.8;0.0;0.0
61;2021-01-14;489;8;0;2747;16;0;1.0;0.0;0.0
61;2021-01-15;498;2;0;3245;18;0;1.2;0.0;0.0
61;2021-01-16;261;1;0;3506;19;0;1.3;0.0;0.0
61;2021-01-17;777;9;0;4283;28;0;1.5;0.0;0.0
61;2021-01-18;1673;3;0;5956;31;0;2.2;0.0;0.0
61;2021-01-19;1106;3;0;7062;34;0;2.6;0.0;0.0
61;2021-01-20;609;0;0;7671;34;0;2.8;0.0;0.0
61;2021-01-21;718;0;0;8389;34;0;3.0;0.0;0.0
61;2021-01-22;647;0;0;9036;34;0;3.3;0.0;0.0
61;2021-01-23;220;1;0;9256;35;0;3.3;0.0;0.0
61;2021-01-24;197;2;0;9453;37;0;3.4;0.0;0.0
61;2021-01-25;468;1;0;9921;38;0;3.6;0.0;0.0
61;2021-01-26;425;4;0;10346;42;0;3.7;0.0;0.0
61;2021-01-27;443;11;0;10789;53;0;3.9;0.0;0.0
61;2021-01-28;429;47;0;11218;100;0;4.1;0.0;0.0
61;2021-01-29;428;173;0;11646;273;0;4.2;0.1;0.0
61;2021-01-30;164;1;0;11810;274;0;4.3;0.1;0.0
61;2021-01-31;93;0;0;11903;274;0;4.3;0.1;0.0
61;2021-02-01;344;162;0;12247;436;0;4.4;0.2;0.0
61;2021-02-02;360;382;0;12607;818;0;4.6;0.3;0.0
61;2021-02-03;354;438;0;12961;1256;0;4.7;0.5;0.0
61;2021-02-04;309;306;0;13270;1562;0;4.8;0.6;0.0
61;2021-02-05;427;338;0;13697;1900;0;4.9;0.7;0.0
61;2021-02-06;153;75;0;13850;1975;0;5.0;0.7;0.0
61;2021-02-07;32;174;0;13882;2149;0;5.0;0.8;0.0
61;2021-02-08;479;1281;0;14361;3430;0;5.2;1.2;0.0
61;2021-02-09;347;702;0;14708;4132;0;5.3;1.5;0.0
61;2021-02-10;234;514;0;14942;4646;0;5.4;1.7;0.0
61;2021-02-11;346;518;0;15288;5164;0;5.5;1.9;0.0
61;2021-02-12;338;664;0;15626;5828;0;5.6;2.1;0.0
61;2021-02-13;130;372;0;15756;6200;0;5.7;2.2;0.0
61;2021-02-14;2;278;0;15758;6478;0;5.7;2.3;0.0
61;2021-02-15;113;672;0;15871;7150;0;5.7;2.6;0.0
61;2021-02-16;166;565;0;16037;7715;0;5.8;2.8;0.0
61;2021-02-17;59;503;0;16096;8218;0;5.8;3.0;0.0
61;2021-02-18;122;459;0;16218;8677;0;5.9;3.1;0.0
61;2021-02-19;100;340;0;16318;9017;0;5.9;3.3;0.0
61;2021-02-20;42;188;0;16360;9205;0;5.9;3.3;0.0
61;2021-02-21;1;139;0;16361;9344;0;5.9;3.4;0.0
61;2021-02-22;72;505;0;16433;9849;0;5.9;3.6;0.0
61;2021-02-23;98;396;0;16531;10245;0;6.0;3.7;0.0
61;2021-02-24;123;432;0;16654;10677;0;6.0;3.9;0.0
61;2021-02-25;286;375;0;16940;11052;0;6.1;4.0;0.0
61;2021-02-26;287;387;0;17227;11439;0;6.2;4.1;0.0
61;2021-02-27;114;171;0;17341;11610;0;6.3;4.2;0.0
61;2021-02-28;4;100;0;17345;11710;0;6.3;4.2;0.0
61;2021-03-01;215;520;0;17560;12230;0;6.3;4.4;0.0
61;2021-03-02;170;593;0;17730;12823;0;6.4;4.6;0.0
61;2021-03-03;167;363;0;17897;13186;0;6.5;4.8;0.0
61;2021-03-04;460;375;0;18357;13561;0;6.6;4.9;0.0
61;2021-03-05;670;288;0;19027;13849;0;6.9;5.0;0.0
61;2021-03-06;437;173;0;19464;14022;0;7.0;5.1;0.0
61;2021-03-07;169;4;0;19633;14026;0;7.1;5.1;0.0
61;2021-03-08;334;276;0;19967;14302;0;7.2;5.2;0.0
61;2021-03-09;606;164;0;20573;14466;0;7.4;5.2;0.0
61;2021-03-10;657;181;0;21230;14647;0;7.7;5.3;0.0
61;2021-03-11;1064;130;0;22294;14777;0;8.1;5.3;0.0
61;2021-03-12;1387;101;0;23681;14878;0;8.6;5.4;0.0
61;2021-03-13;736;47;0;24417;14925;0;8.8;5.4;0.0
61;2021-03-14;178;6;0;24595;14931;0;8.9;5.4;0.0
61;2021-03-15;716;38;0;25311;14969;0;9.1;5.4;0.0
61;2021-03-16;664;27;0;25975;14996;0;9.4;5.4;0.0
61;2021-03-17;678;23;0;26653;15019;0;9.6;5.4;0.0
61;2021-03-18;814;35;0;27467;15054;0;9.9;5.4;0.0
61;2021-03-19;997;67;0;28464;15121;0;10.3;5.5;0.0
61;2021-03-20;487;18;0;28951;15139;0;10.5;5.5;0.0
61;2021-03-21;62;3;0;29013;15142;0;10.5;5.5;0.0
61;2021-03-22;731;99;0;29744;15241;0;10.7;5.5;0.0
61;2021-03-23;844;49;0;30588;15290;0;11.0;5.5;0.0
61;2021-03-24;1306;77;0;31894;15367;0;11.5;5.5;0.0
61;2021-03-25;1798;80;0;33692;15447;0;12.2;5.6;0.0
61;2021-03-26;1686;58;0;35378;15505;0;12.8;5.6;0.0
61;2021-03-27;936;18;0;36314;15523;0;13.1;5.6;0.0
61;2021-03-28;298;9;0;36612;15532;0;13.2;5.6;0.0
61;2021-03-29;1085;196;0;37697;15728;0;13.6;5.7;0.0
61;2021-03-30;1339;125;0;39036;15853;0;14.1;5.7;0.0
61;2021-03-31;1510;71;0;40546;15924;0;14.6;5.8;0.0
61;2021-04-01;1902;236;0;42448;16160;0;15.3;5.8;0.0
61;2021-04-02;1435;408;0;43883;16568;0;15.8;6.0;0.0
61;2021-04-03;568;277;0;44451;16845;0;16.1;6.1;0.0
61;2021-04-04;167;18;0;44618;16863;0;16.1;6.1;0.0
61;2021-04-05;443;12;0;45061;16875;0;16.3;6.1;0.0
61;2021-04-06;1246;545;0;46307;17420;0;16.7;6.3;0.0
61;2021-04-07;1553;596;0;47860;18016;0;17.3;6.5;0.0
61;2021-04-08;2068;713;0;49928;18729;0;18.0;6.8;0.0
61;2021-04-09;2063;760;0;51991;19489;0;18.8;7.0;0.0
61;2021-04-10;1286;429;0;53277;19918;0;19.2;7.2;0.0
61;2021-04-11;209;147;0;53486;20065;0;19.3;7.2;0.0
61;2021-04-12;1154;632;0;54640;20697;0;19.7;7.5;0.0
61;2021-04-13;1591;626;0;56231;21323;0;20.3;7.7;0.0
61;2021-04-14;1626;779;0;57857;22102;0;20.9;8.0;0.0
61;2021-04-15;2073;764;0;59930;22866;0;21.6;8.3;0.0
61;2021-04-16;1984;647;0;61914;23513;0;22.4;8.5;0.0
61;2021-04-17;1210;288;0;63124;23801;0;22.8;8.6;0.0
61;2021-04-18;428;82;0;63552;23883;0;23.0;8.6;0.0
61;2021-04-19;801;695;0;64353;24578;0;23.2;8.9;0.0
61;2021-04-20;1391;712;0;65744;25290;0;23.7;9.1;0.0
61;2021-04-21;1264;977;0;67008;26267;0;24.2;9.5;0.0
61;2021-04-22;1168;1125;0;68176;27392;0;24.6;9.9;0.0
61;2021-04-23;1150;1030;0;69326;28422;0;25.0;10.3;0.0
61;2021-04-24;1155;700;0;70481;29122;0;25.5;10.5;0.0
61;2021-04-25;273;267;0;70754;29389;0;25.6;10.6;0.0
61;2021-04-26;667;947;0;71421;30336;0;25.8;11.0;0.0
61;2021-04-27;1394;1035;0;72815;31371;0;26.3;11.3;0.0
61;2021-04-28;1251;1258;0;74066;32629;0;26.7;11.8;0.0
61;2021-04-29;1217;1658;0;75283;34287;0;27.2;12.4;0.0
61;2021-04-30;1619;1057;0;76902;35344;0;27.8;12.8;0.0
61;2021-05-01;665;298;0;77567;35642;0;28.0;12.9;0.0
61;2021-05-02;336;197;0;77903;35839;0;28.1;12.9;0.0
61;2021-05-03;832;1102;0;78735;36941;0;28.4;13.3;0.0
61;2021-05-04;1269;1600;0;80004;38541;0;28.9;13.9;0.0
61;2021-05-05;997;1868;0;81001;40409;0;29.3;14.6;0.0
61;2021-05-06;1655;1896;0;82656;42305;0;29.9;15.3;0.0
61;2021-05-07;1370;1755;0;84026;44060;0;30.3;15.9;0.0
61;2021-05-08;810;370;0;84836;44430;0;30.6;16.0;0.0
61;2021-05-09;302;234;0;85138;44664;0;30.7;16.1;0.0
61;2021-05-10;1003;1515;0;86141;46179;0;31.1;16.7;0.0
61;2021-05-11;1467;1347;0;87608;47526;0;31.6;17.2;0.0
61;2021-05-12;1605;1426;0;89213;48952;0;32.2;17.7;0.0
61;2021-05-13;874;417;0;90087;49369;0;32.5;17.8;0.0
61;2021-05-14;1612;1041;0;91699;50410;0;33.1;18.2;0.0
61;2021-05-15;1924;925;0;93623;51335;0;33.8;18.5;0.0
61;2021-05-16;844;245;0;94467;51580;0;34.1;18.6;0.0
61;2021-05-17;1298;793;0;95765;52373;0;34.6;18.9;0.0
61;2021-05-18;2319;880;0;98084;53253;0;35.4;19.2;0.0
61;2021-05-19;2149;752;0;100233;54005;0;36.2;19.5;0.0
61;2021-05-20;2059;832;0;102292;54837;0;36.9;19.8;0.0
61;2021-05-21;2187;884;0;104479;55721;0;37.7;20.1;0.0
61;2021-05-22;1367;578;0;105846;56299;0;38.2;20.3;0.0
61;2021-05-23;479;41;0;106325;56340;0;38.4;20.3;0.0
61;2021-05-24;797;138;0;107122;56478;0;38.7;20.4;0.0
61;2021-05-25;1852;864;0;108974;57342;0;39.4;20.7;0.0
61;2021-05-26;1834;892;0;110808;58234;0;40.0;21.0;0.0
61;2021-05-27;2045;1070;0;112853;59304;0;40.8;21.4;0.0
61;2021-05-28;2028;1319;0;114881;60623;0;41.5;21.9;0.0
61;2021-05-29;1263;520;0;116144;61143;0;41.9;22.1;0.0
61;2021-05-30;381;44;0;116525;61187;0;42.1;22.1;0.0
61;2021-05-31;1510;850;0;118035;62037;0;42.6;22.4;0.0
61;2021-06-01;1916;1309;0;119951;63346;0;43.3;22.9;0.0
61;2021-06-02;1636;1049;0;121587;64395;0;43.9;23.3;0.0
61;2021-06-03;2233;1068;0;123820;65463;0;44.7;23.6;0.0
61;2021-06-04;1853;1315;0;125673;66778;0;45.4;24.1;0.0
61;2021-06-05;1395;1105;0;127068;67883;0;45.9;24.5;0.0
61;2021-06-06;296;162;0;127364;68045;0;46.0;24.6;0.0
61;2021-06-07;2052;860;0;129416;68905;0;46.7;24.9;0.0
61;2021-06-08;1793;1537;0;131209;70442;0;47.4;25.4;0.0
61;2021-06-09;1906;1103;0;133115;71545;0;48.1;25.8;0.0
61;2021-06-10;1888;1153;0;135003;72698;0;48.8;26.3;0.0
61;2021-06-11;1735;1520;0;136738;74218;0;49.4;26.8;0.0
61;2021-06-12;1223;876;0;137961;75094;0;49.8;27.1;0.0
61;2021-06-13;289;328;0;138250;75422;0;49.9;27.2;0.0
61;2021-06-14;1063;1176;0;139313;76598;0;50.3;27.7;0.0
61;2021-06-15;1164;1639;0;140477;78237;0;50.7;28.3;0.0
61;2021-06-16;1105;1352;0;141582;79589;0;51.1;28.7;0.0
61;2021-06-17;1085;1713;0;142667;81302;0;51.5;29.4;0.0
61;2021-06-18;1450;1661;0;144117;82963;0;52.0;30.0;0.0
61;2021-06-19;1040;1136;0;145157;84099;0;52.4;30.4;0.0
61;2021-06-20;239;277;0;145396;84376;0;52.5;30.5;0.0
61;2021-06-21;722;1564;0;146118;85940;0;52.8;31.0;0.0
61;2021-06-22;986;1708;0;147104;87648;0;53.1;31.7;0.0
61;2021-06-23;977;2299;0;148081;89947;0;53.5;32.5;0.0
61;2021-06-24;698;1330;0;148779;91277;0;53.7;33.0;0.0
61;2021-06-25;799;1915;0;149578;93192;0;54.0;33.7;0.0
61;2021-06-26;586;1634;0;150164;94826;0;54.2;34.2;0.0
61;2021-06-27;136;671;0;150300;95497;0;54.3;34.5;0.0
61;2021-06-28;452;2098;0;150752;97595;0;54.4;35.2;0.0
61;2021-06-29;724;2767;0;151476;100362;0;54.7;36.2;0.0
61;2021-06-30;798;2348;0;152274;102710;0;55.0;37.1;0.0
61;2021-07-01;690;1707;0;152964;104417;0;55.2;37.7;0.0
61;2021-07-02;879;2557;0;153843;106974;0;55.6;38.6;0.0
61;2021-07-03;392;1525;0;154235;108499;0;55.7;39.2;0.0
61;2021-07-04;74;477;0;154309;108976;0;55.7;39.4;0.0
61;2021-07-05;674;1617;0;154983;110593;0;56.0;39.9;0.0
61;2021-07-06;870;2666;0;155853;113259;0;56.3;40.9;0.0
61;2021-07-07;842;2258;0;156695;115517;0;56.6;41.7;0.0
61;2021-07-08;829;1912;0;157524;117429;0;56.9;42.4;0.0
61;2021-07-09;738;2309;0;158262;119738;0;57.2;43.2;0.0
61;2021-07-10;398;1559;0;158660;121297;0;57.3;43.8;0.0
61;2021-07-11;203;416;0;158863;121713;0;57.4;44.0;0.0
61;2021-07-12;460;2291;0;159323;124004;0;57.5;44.8;0.0
61;2021-07-13;723;2512;0;160046;126516;0;57.8;45.7;0.0
61;2021-07-14;264;427;0;160310;126943;0;57.9;45.8;0.0
61;2021-07-15;836;2735;0;161146;129678;0;58.2;46.8;0.0
61;2021-07-16;1000;2516;0;162146;132194;0;58.6;47.7;0.0
61;2021-07-17;705;1913;0;162851;134107;0;58.8;48.4;0.0
61;2021-07-18;235;304;0;163086;134411;0;58.9;48.5;0.0
61;2021-07-19;963;2357;0;164049;136768;0;59.2;49.4;0.0
61;2021-07-20;1313;2418;0;165362;139186;0;59.7;50.3;0.0
61;2021-07-21;1454;2122;0;166816;141308;0;60.2;51.0;0.0
61;2021-07-22;1794;2117;0;168610;143425;0;60.9;51.8;0.0
61;2021-07-23;1718;2252;0;170328;145677;0;61.5;52.6;0.0
61;2021-07-24;1228;1716;0;171556;147393;0;62.0;53.2;0.0
61;2021-07-25;263;349;0;171819;147742;0;62.1;53.4;0.0
61;2021-07-26;1258;1838;0;173077;149580;0;62.5;54.0;0.0
61;2021-07-27;2326;1449;0;175403;151029;0;63.3;54.5;0.0
61;2021-07-28;2205;1386;1;177608;152415;1;64.1;55.0;0.0
61;2021-07-29;2398;1468;0;180006;153883;1;65.0;55.6;0.0
61;2021-07-30;2297;1328;0;182303;155211;1;65.8;56.1;0.0
61;2021-07-31;1052;1068;0;183355;156279;1;66.2;56.4;0.0
61;2021-08-01;361;217;0;183716;156496;1;66.3;56.5;0.0
61;2021-08-02;1725;1086;0;185441;157582;1;67.0;56.9;0.0
61;2021-08-03;2022;964;0;187463;158546;1;67.7;57.3;0.0
61;2021-08-04;1985;747;0;189448;159293;1;68.4;57.5;0.0
61;2021-08-05;1592;905;0;191040;160198;1;69.0;57.9;0.0
61;2021-08-06;1850;1095;0;192890;161293;1;69.7;58.2;0.0
61;2021-08-07;1113;674;0;194003;161967;1;70.1;58.5;0.0
61;2021-08-08;330;170;0;194333;162137;1;70.2;58.6;0.0
61;2021-08-09;1109;936;0;195442;163073;1;70.6;58.9;0.0
61;2021-08-10;1315;1141;0;196757;164214;1;71.1;59.3;0.0
61;2021-08-11;1035;1086;0;197792;165300;1;71.4;59.7;0.0
61;2021-08-12;1022;1230;0;198814;166530;1;71.8;60.1;0.0
61;2021-08-13;868;1399;0;199682;167929;1;72.1;60.6;0.0
61;2021-08-14;638;739;0;200320;168668;1;72.3;60.9;0.0
61;2021-08-15;90;177;0;200410;168845;1;72.4;61.0;0.0
61;2021-08-16;834;1498;0;201244;170343;1;72.7;61.5;0.0
61;2021-08-17;1005;1637;0;202249;171980;1;73.0;62.1;0.0
61;2021-08-18;821;1428;0;203070;173408;1;73.3;62.6;0.0
61;2021-08-19;709;1480;0;203779;174888;1;73.6;63.2;0.0
61;2021-08-20;761;2005;0;204540;176893;1;73.9;63.9;0.0
61;2021-08-21;433;1100;0;204973;177993;1;74.0;64.3;0.0
61;2021-08-22;104;333;0;205077;178326;1;74.1;64.4;0.0
61;2021-08-23;435;1608;0;205512;179934;1;74.2;65.0;0.0
61;2021-08-24;561;1777;0;206073;181711;1;74.4;65.6;0.0
61;2021-08-25;488;1675;0;206561;183386;1;74.6;66.2;0.0
61;2021-08-26;440;1603;0;207001;184989;1;74.8;66.8;0.0
61;2021-08-27;493;1808;0;207494;186797;1;74.9;67.5;0.0
61;2021-08-28;257;1174;0;207751;187971;1;75.0;67.9;0.0
61;2021-08-29;49;331;0;207800;188302;1;75.0;68.0;0.0
61;2021-08-30;397;1559;10;208197;189861;11;75.2;68.6;0.0
61;2021-08-31;549;1677;44;208746;191538;55;75.4;69.2;0.0
61;2021-09-01;474;1266;181;209220;192804;236;75.6;69.6;0.1
61;2021-09-02;424;1064;247;209644;193868;483;75.7;70.0;0.2
61;2021-09-03;473;1257;272;210117;195125;755;75.9;70.5;0.3
61;2021-09-04;302;1091;77;210419;196216;832;76.0;70.9;0.3
61;2021-09-05;71;156;41;210490;196372;873;76.0;70.9;0.3
61;2021-09-06;267;947;253;210757;197319;1126;76.1;71.3;0.4
61;2021-09-07;316;1252;169;211073;198571;1295;76.2;71.7;0.5
61;2021-09-08;284;1110;217;211357;199681;1512;76.3;72.1;0.5
61;2021-09-09;269;827;365;211626;200508;1877;76.4;72.4;0.7
61;2021-09-10;327;881;270;211953;201389;2147;76.5;72.7;0.8
61;2021-09-11;242;903;77;212195;202292;2224;76.6;73.1;0.8
61;2021-09-12;37;107;20;212232;202399;2244;76.6;73.1;0.8
61;2021-09-13;206;552;457;212438;202951;2701;76.7;73.3;1.0
61;2021-09-14;203;416;435;212641;203367;3136;76.8;73.4;1.1
61;2021-09-15;237;661;465;212878;204028;3601;76.9;73.7;1.3
61;2021-09-16;220;356;192;213098;204384;3793;77.0;73.8;1.4
61;2021-09-17;245;578;249;213343;204962;4042;77.0;74.0;1.5
61;2021-09-18;184;528;129;213527;205490;4171;77.1;74.2;1.5
61;2021-09-19;3;11;1;213530;205501;4172;77.1;74.2;1.5
61;2021-09-20;166;307;248;213696;205808;4420;77.2;74.3;1.6
61;2021-09-21;244;240;226;213940;206048;4646;77.3;74.4;1.7
61;2021-09-22;158;661;361;214098;206709;5007;77.3;74.7;1.8
61;2021-09-23;153;272;226;214251;206981;5233;77.4;74.7;1.9
61;2021-09-24;151;399;371;214402;207380;5604;77.4;74.9;2.0
61;2021-09-25;147;496;168;214549;207876;5772;77.5;75.1;2.1
61;2021-09-26;8;17;4;214557;207893;5776;77.5;75.1;2.1
61;2021-09-27;130;295;403;214687;208188;6179;77.5;75.2;2.2
61;2021-09-28;98;243;161;214785;208431;6340;77.6;75.3;2.3
61;2021-09-29;115;256;228;214900;208687;6568;77.6;75.4;2.4
61;2021-09-30;183;265;210;215083;208952;6778;77.7;75.5;2.4
61;2021-10-01;116;274;237;215199;209226;7015;77.7;75.6;2.5
61;2021-10-02;210;514;261;215409;209740;7276;77.8;75.7;2.6
61;2021-10-03;2;12;2;215411;209752;7278;77.8;75.7;2.6
61;2021-10-04;104;249;443;215515;210001;7721;77.8;75.8;2.8
61;2021-10-05;107;255;402;215622;210256;8123;77.9;75.9;2.9
61;2021-10-06;156;304;384;215778;210560;8507;77.9;76.0;3.1
61;2021-10-07;151;243;517;215929;210803;9024;78.0;76.1;3.3
61;2021-10-08;164;268;441;216093;211071;9465;78.0;76.2;3.4
61;2021-10-09;71;141;105;216164;211212;9570;78.1;76.3;3.5
61;2021-10-10;3;5;3;216167;211217;9573;78.1;76.3;3.5
61;2021-10-11;132;326;585;216299;211543;10158;78.1;76.4;3.7
61;2021-10-12;76;204;229;216375;211747;10387;78.1;76.5;3.8
61;2021-10-13;125;219;430;216500;211966;10817;78.2;76.5;3.9
61;2021-10-14;69;196;341;216569;212162;11158;78.2;76.6;4.0
61;2021-10-15;164;244;441;216733;212406;11599;78.3;76.7;4.2
61;2021-10-16;67;96;142;216800;212502;11741;78.3;76.7;4.2
61;2021-10-17;8;9;13;216808;212511;11754;78.3;76.7;4.2
61;2021-10-18;71;164;306;216879;212675;12060;78.3;76.8;4.4
61;2021-10-19;65;127;258;216944;212802;12318;78.3;76.9;4.4
61;2021-10-20;72;137;348;217016;212939;12666;78.4;76.9;4.6
61;2021-10-21;104;161;449;217120;213100;13115;78.4;77.0;4.7
61;2021-10-22;119;177;497;217239;213277;13612;78.5;77.0;4.9
61;2021-10-23;92;244;310;217331;213521;13922;78.5;77.1;5.0
61;2021-10-24;1;3;0;217332;213524;13922;78.5;77.1;5.0
61;2021-10-25;88;133;436;217420;213657;14358;78.5;77.2;5.2
61;2021-10-26;54;79;235;217474;213736;14593;78.5;77.2;5.3
61;2021-10-27;78;126;631;217552;213862;15224;78.6;77.2;5.5
61;2021-10-28;67;108;461;217619;213970;15685;78.6;77.3;5.7
61;2021-10-29;127;161;677;217746;214131;16362;78.6;77.3;5.9
61;2021-10-30;31;84;207;217777;214215;16569;78.6;77.4;6.0
61;2021-10-31;5;5;1;217782;214220;16570;78.6;77.4;6.0
61;2021-11-01;5;1;4;217787;214221;16574;78.7;77.4;6.0
61;2021-11-02;60;107;502;217847;214328;17076;78.7;77.4;6.2
61;2021-11-03;68;148;621;217915;214476;17697;78.7;77.5;6.4
61;2021-11-04;66;92;631;217981;214568;18328;78.7;77.5;6.6
61;2021-11-05;116;155;873;218097;214723;19201;78.8;77.5;6.9
61;2021-11-06;64;77;348;218161;214800;19549;78.8;77.6;7.1
61;2021-11-07;2;11;24;218163;214811;19573;78.8;77.6;7.1
61;2021-11-08;60;105;849;218223;214916;20422;78.8;77.6;7.4
61;2021-11-09;44;86;608;218267;215002;21030;78.8;77.6;7.6
61;2021-11-10;89;117;979;218356;215119;22009;78.9;77.7;7.9
61;2021-11-11;5;3;33;218361;215122;22042;78.9;77.7;8.0
61;2021-11-12;83;160;1023;218444;215282;23065;78.9;77.7;8.3
61;2021-11-13;51;53;217;218495;215335;23282;78.9;77.8;8.4
61;2021-11-14;0;7;8;218495;215342;23290;78.9;77.8;8.4
61;2021-11-15;56;83;987;218551;215425;24277;78.9;77.8;8.8
61;2021-11-16;81;59;961;218632;215484;25238;79.0;77.8;9.1
61;2021-11-17;90;106;1062;218722;215590;26300;79.0;77.9;9.5
61;2021-11-18;97;113;1277;218819;215703;27577;79.0;77.9;10.0
61;2021-11-19;111;153;1437;218930;215856;29014;79.1;78.0;10.5
61;2021-11-20;75;70;500;219005;215926;29514;79.1;78.0;10.7
61;2021-11-21;4;5;20;219009;215931;29534;79.1;78.0;10.7
61;2021-11-22;69;43;936;219078;215974;30470;79.1;78.0;11.0
61;2021-11-23;126;69;1387;219204;216043;31857;79.2;78.0;11.5
61;2021-11-24;141;106;1343;219345;216149;33200;79.2;78.1;12.0
61;2021-11-25;117;72;1471;219462;216221;34671;79.3;78.1;12.5
61;2021-11-26;88;129;2018;219550;216350;36689;79.3;78.1;13.2
61;2021-11-27;79;59;1107;219629;216409;37796;79.3;78.2;13.6
61;2021-11-28;4;7;42;219633;216416;37838;79.3;78.2;13.7
61;2021-11-29;59;63;1718;219692;216479;39556;79.3;78.2;14.3
61;2021-11-30;124;78;2298;219816;216557;41854;79.4;78.2;15.1
61;2021-12-01;69;94;2357;219885;216651;44211;79.4;78.2;16.0
61;2021-12-02;86;50;2994;219971;216701;47205;79.4;78.3;17.0
61;2021-12-03;95;109;2857;220066;216810;50062;79.5;78.3;18.1
61;2021-12-04;61;64;1390;220127;216874;51452;79.5;78.3;18.6
61;2021-12-05;10;4;359;220137;216878;51811;79.5;78.3;18.7
61;2021-12-06;41;53;2333;220178;216931;54144;79.5;78.3;19.6
61;2021-12-07;76;74;3486;220254;217005;57630;79.5;78.4;20.8
61;2021-12-08;92;97;3189;220346;217102;60819;79.6;78.4;22.0
61;2021-12-09;82;79;3361;220428;217181;64180;79.6;78.4;23.2
61;2021-12-10;66;147;3473;220494;217328;67653;79.6;78.5;24.4
61;2021-12-11;72;70;2134;220566;217398;69787;79.7;78.5;25.2
61;2021-12-12;13;10;428;220579;217408;70215;79.7;78.5;25.4
61;2021-12-13;96;89;3093;220675;217497;73308;79.7;78.5;26.5
61;2021-12-14;83;108;4127;220758;217605;77435;79.7;78.6;28.0
61;2021-12-15;100;126;3500;220858;217731;80935;79.8;78.6;29.2
61;2021-12-16;89;120;4013;220947;217851;84948;79.8;78.7;30.7
62;2020-12-27;3;0;0;3;0;0;0.0;0.0;0.0
62;2020-12-28;1;0;0;4;0;0;0.0;0.0;0.0
62;2020-12-29;0;0;0;4;0;0;0.0;0.0;0.0
62;2020-12-30;0;0;0;4;0;0;0.0;0.0;0.0
62;2020-12-31;0;0;0;4;0;0;0.0;0.0;0.0
62;2021-01-01;1;0;0;5;0;0;0.0;0.0;0.0
62;2021-01-02;3;2;0;8;2;0;0.0;0.0;0.0
62;2021-01-03;0;0;0;8;2;0;0.0;0.0;0.0
62;2021-01-04;5;0;0;13;2;0;0.0;0.0;0.0
62;2021-01-05;64;0;0;77;2;0;0.0;0.0;0.0
62;2021-01-06;149;0;0;226;2;0;0.0;0.0;0.0
62;2021-01-07;371;0;0;597;2;0;0.0;0.0;0.0
62;2021-01-08;710;10;0;1307;12;0;0.1;0.0;0.0
62;2021-01-09;199;2;0;1506;14;0;0.1;0.0;0.0
62;2021-01-10;109;0;0;1615;14;0;0.1;0.0;0.0
62;2021-01-11;610;2;0;2225;16;0;0.2;0.0;0.0
62;2021-01-12;1319;5;0;3544;21;0;0.2;0.0;0.0
62;2021-01-13;1146;16;0;4690;37;0;0.3;0.0;0.0
62;2021-01-14;1461;10;0;6151;47;0;0.4;0.0;0.0
62;2021-01-15;1335;13;0;7486;60;0;0.5;0.0;0.0
62;2021-01-16;351;3;0;7837;63;0;0.5;0.0;0.0
62;2021-01-17;143;1;0;7980;64;0;0.5;0.0;0.0
62;2021-01-18;1726;9;0;9706;73;0;0.7;0.0;0.0
62;2021-01-19;2039;5;0;11745;78;0;0.8;0.0;0.0
62;2021-01-20;2002;9;0;13747;87;0;0.9;0.0;0.0
62;2021-01-21;2256;6;0;16003;93;0;1.1;0.0;0.0
62;2021-01-22;1800;8;0;17803;101;0;1.2;0.0;0.0
62;2021-01-23;494;1;0;18297;102;0;1.3;0.0;0.0
62;2021-01-24;9;0;0;18306;102;0;1.3;0.0;0.0
62;2021-01-25;1263;12;0;19569;114;0;1.3;0.0;0.0
62;2021-01-26;1597;31;0;21166;145;0;1.5;0.0;0.0
62;2021-01-27;1346;185;0;22512;330;0;1.5;0.0;0.0
62;2021-01-28;4002;405;0;26514;735;0;1.8;0.1;0.0
62;2021-01-29;1992;347;0;28506;1082;0;2.0;0.1;0.0
62;2021-01-30;166;152;0;28672;1234;0;2.0;0.1;0.0
62;2021-01-31;20;3;0;28692;1237;0;2.0;0.1;0.0
62;2021-02-01;53;366;0;28745;1603;0;2.0;0.1;0.0
62;2021-02-02;74;788;0;28819;2391;0;2.0;0.2;0.0
62;2021-02-03;172;648;0;28991;3039;0;2.0;0.2;0.0
62;2021-02-04;193;823;0;29184;3862;0;2.0;0.3;0.0
62;2021-02-05;105;754;0;29289;4616;0;2.0;0.3;0.0
62;2021-02-06;38;162;0;29327;4778;0;2.0;0.3;0.0
62;2021-02-07;242;33;0;29569;4811;0;2.0;0.3;0.0
62;2021-02-08;166;872;0;29735;5683;0;2.0;0.4;0.0
62;2021-02-09;273;1098;0;30008;6781;0;2.1;0.5;0.0
62;2021-02-10;384;1103;0;30392;7884;0;2.1;0.5;0.0
62;2021-02-11;772;1022;0;31164;8906;0;2.1;0.6;0.0
62;2021-02-12;985;848;0;32149;9754;0;2.2;0.7;0.0
62;2021-02-13;179;302;0;32328;10056;0;2.2;0.7;0.0
62;2021-02-14;3;10;0;32331;10066;0;2.2;0.7;0.0
62;2021-02-15;737;1260;0;33068;11326;0;2.3;0.8;0.0
62;2021-02-16;929;1815;0;33997;13141;0;2.3;0.9;0.0
62;2021-02-17;1092;2063;0;35089;15204;0;2.4;1.0;0.0
62;2021-02-18;2240;3705;0;37329;18909;0;2.6;1.3;0.0
62;2021-02-19;2268;2477;0;39597;21386;0;2.7;1.5;0.0
62;2021-02-20;616;499;0;40213;21885;0;2.8;1.5;0.0
62;2021-02-21;84;63;0;40297;21948;0;2.8;1.5;0.0
62;2021-02-22;855;953;0;41152;22901;0;2.8;1.6;0.0
62;2021-02-23;1431;1217;0;42583;24118;0;2.9;1.7;0.0
62;2021-02-24;1587;761;0;44170;24879;0;3.0;1.7;0.0
62;2021-02-25;3257;557;0;47427;25436;0;3.3;1.8;0.0
62;2021-02-26;2959;453;0;50386;25889;0;3.5;1.8;0.0
62;2021-02-27;1838;117;0;52224;26006;0;3.6;1.8;0.0
62;2021-02-28;59;44;0;52283;26050;0;3.6;1.8;0.0
62;2021-03-01;1388;154;0;53671;26204;0;3.7;1.8;0.0
62;2021-03-02;3121;205;0;56792;26409;0;3.9;1.8;0.0
62;2021-03-03;3304;208;0;60096;26617;0;4.1;1.8;0.0
62;2021-03-04;3876;275;0;63972;26892;0;4.4;1.9;0.0
62;2021-03-05;4703;300;0;68675;27192;0;4.7;1.9;0.0
62;2021-03-06;9722;308;0;78397;27500;0;5.4;1.9;0.0
62;2021-03-07;8117;253;0;86514;27753;0;6.0;1.9;0.0
62;2021-03-08;2317;354;0;88831;28107;0;6.1;1.9;0.0
62;2021-03-09;3935;474;0;92766;28581;0;6.4;2.0;0.0
62;2021-03-10;4349;666;0;97115;29247;0;6.7;2.0;0.0
62;2021-03-11;6177;1531;0;103292;30778;0;7.1;2.1;0.0
62;2021-03-12;6828;1453;0;110120;32231;0;7.6;2.2;0.0
62;2021-03-13;14783;872;0;124903;33103;0;8.6;2.3;0.0
62;2021-03-14;9613;411;0;134516;33514;0;9.3;2.3;0.0
62;2021-03-15;3856;1055;0;138372;34569;0;9.5;2.4;0.0
62;2021-03-16;2811;836;0;141183;35405;0;9.7;2.4;0.0
62;2021-03-17;2851;815;0;144034;36220;0;9.9;2.5;0.0
62;2021-03-18;2800;1058;0;146834;37278;0;10.1;2.6;0.0
62;2021-03-19;4835;934;0;151669;38212;0;10.4;2.6;0.0
62;2021-03-20;11340;638;0;163009;38850;0;11.2;2.7;0.0
62;2021-03-21;9219;388;0;172228;39238;0;11.9;2.7;0.0
62;2021-03-22;3061;1157;0;175289;40395;0;12.1;2.8;0.0
62;2021-03-23;5006;1536;0;180295;41931;0;12.4;2.9;0.0
62;2021-03-24;4657;1399;0;184952;43330;0;12.7;3.0;0.0
62;2021-03-25;6575;1517;0;191527;44847;0;13.2;3.1;0.0
62;2021-03-26;7136;1487;0;198663;46334;0;13.7;3.2;0.0
62;2021-03-27;12461;782;0;211124;47116;0;14.5;3.2;0.0
62;2021-03-28;6811;287;0;217935;47403;0;15.0;3.3;0.0
62;2021-03-29;3489;1297;0;221424;48700;0;15.2;3.4;0.0
62;2021-03-30;4579;2257;0;226003;50957;0;15.6;3.5;0.0
62;2021-03-31;4135;2477;0;230138;53434;0;15.8;3.7;0.0
62;2021-04-01;4945;2792;0;235083;56226;0;16.2;3.9;0.0
62;2021-04-02;5021;3372;0;240104;59598;0;16.5;4.1;0.0
62;2021-04-03;8343;3432;0;248447;63030;0;17.1;4.3;0.0
62;2021-04-04;4494;1938;0;252941;64968;0;17.4;4.5;0.0
62;2021-04-05;1205;514;0;254146;65482;0;17.5;4.5;0.0
62;2021-04-06;4030;3095;0;258176;68577;0;17.8;4.7;0.0
62;2021-04-07;5021;3647;0;263197;72224;0;18.1;5.0;0.0
62;2021-04-08;6517;4006;0;269714;76230;0;18.6;5.2;0.0
62;2021-04-09;7687;3605;0;277401;79835;0;19.1;5.5;0.0
62;2021-04-10;6740;8123;0;284141;87958;0;19.6;6.1;0.0
62;2021-04-11;2797;6842;0;286938;94800;0;19.8;6.5;0.0
62;2021-04-12;3471;2518;0;290409;97318;0;20.0;6.7;0.0
62;2021-04-13;6135;3294;0;296544;100612;0;20.4;6.9;0.0
62;2021-04-14;5394;3129;0;301938;103741;0;20.8;7.1;0.0
62;2021-04-15;5850;3046;0;307788;106787;0;21.2;7.4;0.0
62;2021-04-16;5540;3315;0;313328;110102;0;21.6;7.6;0.0
62;2021-04-17;4418;7630;0;317746;117732;0;21.9;8.1;0.0
62;2021-04-18;1970;6638;0;319716;124370;0;22.0;8.6;0.0
62;2021-04-19;2920;2076;0;322636;126446;0;22.2;8.7;0.0
62;2021-04-20;4107;3857;0;326743;130303;0;22.5;9.0;0.0
62;2021-04-21;3733;3883;0;330476;134186;0;22.7;9.2;0.0
62;2021-04-22;4166;5135;0;334642;139321;0;23.0;9.6;0.0
62;2021-04-23;4167;5272;0;338809;144593;0;23.3;10.0;0.0
62;2021-04-24;4444;6742;0;343253;151335;0;23.6;10.4;0.0
62;2021-04-25;1947;3512;0;345200;154847;0;23.8;10.7;0.0
62;2021-04-26;2440;2554;0;347640;157401;0;23.9;10.8;0.0
62;2021-04-27;4569;3656;0;352209;161057;0;24.2;11.1;0.0
62;2021-04-28;4708;4382;0;356917;165439;0;24.6;11.4;0.0
62;2021-04-29;4978;5757;0;361895;171196;0;24.9;11.8;0.0
62;2021-04-30;5554;5699;0;367449;176895;0;25.3;12.2;0.0
62;2021-05-01;6169;3840;0;373618;180735;0;25.7;12.4;0.0
62;2021-05-02;8051;3319;0;381669;184054;0;26.3;12.7;0.0
62;2021-05-03;5071;2451;0;386740;186505;0;26.6;12.8;0.0
62;2021-05-04;5814;4960;0;392554;191465;0;27.0;13.2;0.0
62;2021-05-05;5195;4765;0;397749;196230;0;27.4;13.5;0.0
62;2021-05-06;5892;4995;0;403641;201225;0;27.8;13.9;0.0
62;2021-05-07;8359;4822;0;412000;206047;0;28.4;14.2;0.0
62;2021-05-08;11291;2513;0;423291;208560;0;29.1;14.4;0.0
62;2021-05-09;8998;1704;0;432289;210264;0;29.8;14.5;0.0
62;2021-05-10;5801;4129;0;438090;214393;0;30.2;14.8;0.0
62;2021-05-11;7106;5035;0;445196;219428;0;30.6;15.1;0.0
62;2021-05-12;9335;4713;0;454531;224141;0;31.3;15.4;0.0
62;2021-05-13;10056;1552;0;464587;225693;0;32.0;15.5;0.0
62;2021-05-14;11598;3494;0;476185;229187;0;32.8;15.8;0.0
62;2021-05-15;19346;3349;0;495531;232536;0;34.1;16.0;0.0
62;2021-05-16;16408;1444;0;511939;233980;0;35.2;16.1;0.0
62;2021-05-17;8427;2763;0;520366;236743;0;35.8;16.3;0.0
62;2021-05-18;9299;3139;0;529665;239882;0;36.5;16.5;0.0
62;2021-05-19;8840;2878;0;538505;242760;0;37.1;16.7;0.0
62;2021-05-20;8591;3911;0;547096;246671;0;37.7;17.0;0.0
62;2021-05-21;9758;4313;0;556854;250984;0;38.3;17.3;0.0
62;2021-05-22;17378;3501;0;574232;254485;0;39.5;17.5;0.0
62;2021-05-23;12430;1141;0;586662;255626;0;40.4;17.6;0.0
62;2021-05-24;5029;731;0;591691;256357;0;40.7;17.6;0.0
62;2021-05-25;7216;4037;0;598907;260394;0;41.2;17.9;0.0
62;2021-05-26;7241;4893;0;606148;265287;0;41.7;18.3;0.0
62;2021-05-27;6520;5723;0;612668;271010;0;42.2;18.7;0.0
62;2021-05-28;6795;6885;0;619463;277895;0;42.6;19.1;0.0
62;2021-05-29;10408;5513;0;629871;283408;0;43.4;19.5;0.0
62;2021-05-30;3934;950;0;633805;284358;0;43.6;19.6;0.0
62;2021-05-31;4915;4150;0;638720;288508;0;44.0;19.9;0.0
62;2021-06-01;6567;6536;0;645287;295044;0;44.4;20.3;0.0
62;2021-06-02;7473;5946;0;652760;300990;0;44.9;20.7;0.0
62;2021-06-03;7850;6106;0;660610;307096;0;45.5;21.1;0.0
62;2021-06-04;7927;6440;0;668537;313536;0;46.0;21.6;0.0
62;2021-06-05;8031;6220;0;676568;319756;0;46.6;22.0;0.0
62;2021-06-06;3111;1357;0;679679;321113;0;46.8;22.1;0.0
62;2021-06-07;4871;4069;0;684550;325182;0;47.1;22.4;0.0
62;2021-06-08;6262;6052;0;690812;331234;0;47.6;22.8;0.0
62;2021-06-09;5524;5061;0;696336;336295;0;47.9;23.1;0.0
62;2021-06-10;5198;6189;0;701534;342484;0;48.3;23.6;0.0
62;2021-06-11;6136;9189;0;707670;351673;0;48.7;24.2;0.0
62;2021-06-12;5844;8889;0;713514;360562;0;49.1;24.8;0.0
62;2021-06-13;3148;3826;0;716662;364388;0;49.3;25.1;0.0
62;2021-06-14;2801;7242;0;719463;371630;0;49.5;25.6;0.0
62;2021-06-15;4713;8780;0;724176;380410;0;49.8;26.2;0.0
62;2021-06-16;5130;7680;0;729306;388090;0;50.2;26.7;0.0
62;2021-06-17;5221;8198;0;734527;396288;0;50.6;27.3;0.0
62;2021-06-18;4850;11214;0;739377;407502;0;50.9;28.0;0.0
62;2021-06-19;5786;13973;0;745163;421475;0;51.3;29.0;0.0
62;2021-06-20;2271;4846;0;747434;426321;0;51.4;29.3;0.0
62;2021-06-21;2975;9578;0;750409;435899;0;51.7;30.0;0.0
62;2021-06-22;3525;10484;0;753934;446383;0;51.9;30.7;0.0
62;2021-06-23;3479;10756;0;757413;457139;0;52.1;31.5;0.0
62;2021-06-24;3435;11991;0;760848;469130;0;52.4;32.3;0.0
62;2021-06-25;3821;15603;0;764669;484733;0;52.6;33.4;0.0
62;2021-06-26;3651;18212;0;768320;502945;0;52.9;34.6;0.0
62;2021-06-27;1367;10155;0;769687;513100;0;53.0;35.3;0.0
62;2021-06-28;2050;9472;0;771737;522572;0;53.1;36.0;0.0
62;2021-06-29;3068;11520;0;774805;534092;0;53.3;36.8;0.0
62;2021-06-30;4074;11066;0;778879;545158;0;53.6;37.5;0.0
62;2021-07-01;4460;10613;0;783339;555771;0;53.9;38.3;0.0
62;2021-07-02;4152;12315;0;787491;568086;0;54.2;39.1;0.0
62;2021-07-03;2965;17988;0;790456;586074;0;54.4;40.3;0.0
62;2021-07-04;1581;9656;0;792037;595730;0;54.5;41.0;0.0
62;2021-07-05;2605;7616;0;794642;603346;0;54.7;41.5;0.0
62;2021-07-06;3863;10126;0;798505;613472;0;55.0;42.2;0.0
62;2021-07-07;4019;8924;0;802524;622396;0;55.2;42.8;0.0
62;2021-07-08;5161;8993;0;807685;631389;0;55.6;43.5;0.0
62;2021-07-09;4551;11087;0;812236;642476;0;55.9;44.2;0.0
62;2021-07-10;5116;11863;0;817352;654339;0;56.3;45.0;0.0
62;2021-07-11;1513;2473;0;818865;656812;0;56.4;45.2;0.0
62;2021-07-12;2504;7600;0;821369;664412;0;56.5;45.7;0.0
62;2021-07-13;5344;12025;0;826713;676437;0;56.9;46.6;0.0
62;2021-07-14;3740;3246;0;830453;679683;0;57.2;46.8;0.0
62;2021-07-15;7652;11519;0;838105;691202;0;57.7;47.6;0.0
62;2021-07-16;7925;11094;0;846030;702296;0;58.2;48.3;0.0
62;2021-07-17;9509;10466;0;855539;712762;0;58.9;49.1;0.0
62;2021-07-18;3181;3780;0;858720;716542;0;59.1;49.3;0.0
62;2021-07-19;6184;7403;0;864904;723945;0;59.5;49.8;0.0
62;2021-07-20;8180;10707;0;873084;734652;0;60.1;50.6;0.0
62;2021-07-21;9729;9455;0;882813;744107;0;60.8;51.2;0.0
62;2021-07-22;9918;8891;0;892731;752998;0;61.4;51.8;0.0
62;2021-07-23;10655;8497;0;903386;761495;0;62.2;52.4;0.0
62;2021-07-24;9924;10243;0;913310;771738;0;62.9;53.1;0.0
62;2021-07-25;5922;2054;0;919232;773792;0;63.3;53.3;0.0
62;2021-07-26;6692;5855;0;925924;779647;0;63.7;53.7;0.0
62;2021-07-27;9975;8104;0;935899;787751;0;64.4;54.2;0.0
62;2021-07-28;10548;7473;0;946447;795224;0;65.1;54.7;0.0
62;2021-07-29;11868;7546;0;958315;802770;0;66.0;55.3;0.0
62;2021-07-30;9266;6513;0;967581;809283;0;66.6;55.7;0.0
62;2021-07-31;6968;4308;0;974549;813591;0;67.1;56.0;0.0
62;2021-08-01;2782;1287;0;977331;814878;0;67.3;56.1;0.0
62;2021-08-02;6920;5053;0;984251;819931;0;67.7;56.4;0.0
62;2021-08-03;8484;7568;0;992735;827499;0;68.3;57.0;0.0
62;2021-08-04;9387;5539;0;1002122;833038;0;69.0;57.3;0.0
62;2021-08-05;8194;5780;0;1010316;838818;0;69.5;57.7;0.0
62;2021-08-06;7403;6048;0;1017719;844866;0;70.1;58.2;0.0
62;2021-08-07;5808;5493;0;1023527;850359;0;70.5;58.5;0.0
62;2021-08-08;2041;1502;0;1025568;851861;0;70.6;58.6;0.0
62;2021-08-09;5319;5394;0;1030887;857255;0;71.0;59.0;0.0
62;2021-08-10;6178;7348;0;1037065;864603;0;71.4;59.5;0.0
62;2021-08-11;5432;7400;0;1042497;872003;0;71.8;60.0;0.0
62;2021-08-12;5801;7145;0;1048298;879148;0;72.2;60.5;0.0
62;2021-08-13;4575;6265;0;1052873;885413;0;72.5;60.9;0.0
62;2021-08-14;3956;7086;0;1056829;892499;0;72.7;61.4;0.0
62;2021-08-15;1210;1357;0;1058039;893856;0;72.8;61.5;0.0
62;2021-08-16;3272;6244;0;1061311;900100;0;73.1;62.0;0.0
62;2021-08-17;4013;7213;0;1065324;907313;0;73.3;62.5;0.0
62;2021-08-18;4374;7237;0;1069698;914550;0;73.6;63.0;0.0
62;2021-08-19;4267;8465;0;1073965;923015;0;73.9;63.5;0.0
62;2021-08-20;3370;8637;0;1077335;931652;0;74.2;64.1;0.0
62;2021-08-21;2460;9718;0;1079795;941370;0;74.3;64.8;0.0
62;2021-08-22;483;3009;0;1080278;944379;0;74.4;65.0;0.0
62;2021-08-23;2727;8040;0;1083005;952419;0;74.5;65.6;0.0
62;2021-08-24;3689;10134;0;1086694;962553;0;74.8;66.3;0.0
62;2021-08-25;3469;9071;0;1090163;971624;0;75.0;66.9;0.0
62;2021-08-26;3081;9405;0;1093244;981029;0;75.3;67.5;0.0
62;2021-08-27;2596;8943;0;1095840;989972;0;75.4;68.1;0.0
62;2021-08-28;2097;8126;0;1097937;998098;0;75.6;68.7;0.0
62;2021-08-29;906;2415;0;1098843;1000513;0;75.6;68.9;0.0
62;2021-08-30;2050;7413;102;1100893;1007926;102;75.8;69.4;0.0
62;2021-08-31;2180;7807;195;1103073;1015733;297;75.9;69.9;0.0
62;2021-09-01;1865;5871;400;1104938;1021604;697;76.1;70.3;0.0
62;2021-09-02;1796;6203;448;1106734;1027807;1145;76.2;70.7;0.1
62;2021-09-03;2092;6935;613;1108826;1034742;1758;76.3;71.2;0.1
62;2021-09-04;2127;6517;405;1110953;1041259;2163;76.5;71.7;0.1
62;2021-09-05;321;1236;67;1111274;1042495;2230;76.5;71.8;0.2
62;2021-09-06;1079;3419;532;1112353;1045914;2762;76.6;72.0;0.2
62;2021-09-07;1210;3817;561;1113563;1049731;3323;76.7;72.3;0.2
62;2021-09-08;1311;4070;444;1114874;1053801;3767;76.7;72.5;0.3
62;2021-09-09;1268;4226;482;1116142;1058027;4249;76.8;72.8;0.3
62;2021-09-10;1620;4452;635;1117762;1062479;4884;76.9;73.1;0.3
62;2021-09-11;1276;3989;365;1119038;1066468;5249;77.0;73.4;0.4
62;2021-09-12;219;564;50;1119257;1067032;5299;77.0;73.4;0.4
62;2021-09-13;831;2292;608;1120088;1069324;5907;77.1;73.6;0.4
62;2021-09-14;1333;3323;1088;1121421;1072647;6995;77.2;73.8;0.5
62;2021-09-15;1347;4095;843;1122768;1076742;7838;77.3;74.1;0.5
62;2021-09-16;1361;2855;1034;1124129;1079597;8872;77.4;74.3;0.6
62;2021-09-17;1370;2484;1050;1125499;1082081;9922;77.5;74.5;0.7
62;2021-09-18;1067;2944;517;1126566;1085025;10439;77.5;74.7;0.7
62;2021-09-19;137;475;52;1126703;1085500;10491;77.6;74.7;0.7
62;2021-09-20;610;1535;850;1127313;1087035;11341;77.6;74.8;0.8
62;2021-09-21;904;2406;858;1128217;1089441;12199;77.7;75.0;0.8
62;2021-09-22;785;2607;896;1129002;1092048;13095;77.7;75.2;0.9
62;2021-09-23;712;1771;1486;1129714;1093819;14581;77.8;75.3;1.0
62;2021-09-24;772;1998;934;1130486;1095817;15515;77.8;75.4;1.1
62;2021-09-25;696;2676;653;1131182;1098493;16168;77.9;75.6;1.1
62;2021-09-26;85;329;58;1131267;1098822;16226;77.9;75.6;1.1
62;2021-09-27;353;1133;635;1131620;1099955;16861;77.9;75.7;1.2
62;2021-09-28;582;1676;985;1132202;1101631;17846;77.9;75.8;1.2
62;2021-09-29;723;1875;991;1132925;1103506;18837;78.0;76.0;1.3
62;2021-09-30;432;993;828;1133357;1104499;19665;78.0;76.0;1.4
62;2021-10-01;786;1689;1055;1134143;1106188;20720;78.1;76.1;1.4
62;2021-10-02;731;1556;817;1134874;1107744;21537;78.1;76.3;1.5
62;2021-10-03;94;251;76;1134968;1107995;21613;78.1;76.3;1.5
62;2021-10-04;436;821;1122;1135404;1108816;22735;78.2;76.3;1.6
62;2021-10-05;650;1443;1716;1136054;1110259;24451;78.2;76.4;1.7
62;2021-10-06;607;1260;1196;1136661;1111519;25647;78.2;76.5;1.8
62;2021-10-07;507;1185;1382;1137168;1112704;27029;78.3;76.6;1.9
62;2021-10-08;760;1573;1721;1137928;1114277;28750;78.3;76.7;2.0
62;2021-10-09;644;1375;1515;1138572;1115652;30265;78.4;76.8;2.1
62;2021-10-10;76;203;193;1138648;1115855;30458;78.4;76.8;2.1
62;2021-10-11;374;709;1273;1139022;1116564;31731;78.4;76.9;2.2
62;2021-10-12;499;1302;2454;1139521;1117866;34185;78.4;76.9;2.4
62;2021-10-13;575;930;1666;1140096;1118796;35851;78.5;77.0;2.5
62;2021-10-14;409;737;1396;1140505;1119533;37247;78.5;77.1;2.6
62;2021-10-15;684;1129;2303;1141189;1120662;39550;78.6;77.1;2.7
62;2021-10-16;537;790;1692;1141726;1121452;41242;78.6;77.2;2.8
62;2021-10-17;57;80;165;1141783;1121532;41407;78.6;77.2;2.9
62;2021-10-18;386;542;1817;1142169;1122074;43224;78.6;77.2;3.0
62;2021-10-19;546;841;2938;1142715;1122915;46162;78.7;77.3;3.2
62;2021-10-20;495;724;2189;1143210;1123639;48351;78.7;77.3;3.3
62;2021-10-21;419;544;2213;1143629;1124183;50564;78.7;77.4;3.5
62;2021-10-22;611;980;2816;1144240;1125163;53380;78.8;77.4;3.7
62;2021-10-23;509;753;2280;1144749;1125916;55660;78.8;77.5;3.8
62;2021-10-24;25;53;152;1144774;1125969;55812;78.8;77.5;3.8
62;2021-10-25;430;484;2145;1145204;1126453;57957;78.8;77.5;4.0
62;2021-10-26;472;663;3068;1145676;1127116;61025;78.9;77.6;4.2
62;2021-10-27;407;597;2290;1146083;1127713;63315;78.9;77.6;4.4
62;2021-10-28;407;470;2243;1146490;1128183;65558;78.9;77.7;4.5
62;2021-10-29;505;742;3035;1146995;1128925;68593;79.0;77.7;4.7
62;2021-10-30;368;648;2568;1147363;1129573;71161;79.0;77.8;4.9
62;2021-10-31;25;33;134;1147388;1129606;71295;79.0;77.8;4.9
62;2021-11-01;28;26;78;1147416;1129632;71373;79.0;77.8;4.9
62;2021-11-02;489;703;3333;1147905;1130335;74706;79.0;77.8;5.1
62;2021-11-03;440;638;2769;1148345;1130973;77475;79.0;77.8;5.3
62;2021-11-04;398;423;2459;1148743;1131396;79934;79.1;77.9;5.5
62;2021-11-05;472;634;3313;1149215;1132030;83247;79.1;77.9;5.7
62;2021-11-06;481;643;3110;1149696;1132673;86357;79.1;78.0;5.9
62;2021-11-07;104;116;468;1149800;1132789;86825;79.1;78.0;6.0
62;2021-11-08;299;422;2722;1150099;1133211;89547;79.2;78.0;6.2
62;2021-11-09;446;551;4678;1150545;1133762;94225;79.2;78.0;6.5
62;2021-11-10;537;727;4294;1151082;1134489;98519;79.2;78.1;6.8
62;2021-11-11;16;27;133;1151098;1134516;98652;79.2;78.1;6.8
62;2021-11-12;532;752;4667;1151630;1135268;103319;79.3;78.1;7.1
62;2021-11-13;390;552;2780;1152020;1135820;106099;79.3;78.2;7.3
62;2021-11-14;35;48;249;1152055;1135868;106348;79.3;78.2;7.3
62;2021-11-15;368;407;3614;1152423;1136275;109962;79.3;78.2;7.6
62;2021-11-16;342;432;4354;1152765;1136707;114316;79.3;78.2;7.9
62;2021-11-17;552;572;4665;1153317;1137279;118981;79.4;78.3;8.2
62;2021-11-18;433;604;5022;1153750;1137883;124003;79.4;78.3;8.5
62;2021-11-19;696;676;5867;1154446;1138559;129870;79.5;78.4;8.9
62;2021-11-20;515;568;3816;1154961;1139127;133686;79.5;78.4;9.2
62;2021-11-21;25;68;425;1154986;1139195;134111;79.5;78.4;9.2
62;2021-11-22;420;258;3752;1155406;1139453;137863;79.5;78.4;9.5
62;2021-11-23;432;388;5010;1155838;1139841;142873;79.6;78.5;9.8
62;2021-11-24;476;458;4037;1156314;1140299;146910;79.6;78.5;10.1
62;2021-11-25;507;428;6407;1156821;1140727;153317;79.6;78.5;10.6
62;2021-11-26;635;606;9783;1157456;1141333;163100;79.7;78.6;11.2
62;2021-11-27;400;503;7097;1157856;1141836;170197;79.7;78.6;11.7
62;2021-11-28;44;64;1428;1157900;1141900;171625;79.7;78.6;11.8
62;2021-11-29;286;331;7992;1158186;1142231;179617;79.7;78.6;12.4
62;2021-11-30;418;457;11787;1158604;1142688;191404;79.8;78.7;13.2
62;2021-12-01;343;482;11930;1158947;1143170;203334;79.8;78.7;14.0
62;2021-12-02;341;270;12882;1159288;1143440;216216;79.8;78.7;14.9
62;2021-12-03;428;654;15682;1159716;1144094;231898;79.8;78.8;16.0
62;2021-12-04;371;514;13176;1160087;1144608;245074;79.9;78.8;16.9
62;2021-12-05;66;61;4860;1160153;1144669;249934;79.9;78.8;17.2
62;2021-12-06;293;382;13426;1160446;1145051;263360;79.9;78.8;18.1
62;2021-12-07;316;406;16513;1160762;1145457;279873;79.9;78.8;19.3
62;2021-12-08;380;578;14367;1161142;1146035;294240;79.9;78.9;20.3
62;2021-12-09;414;461;17430;1161556;1146496;311670;80.0;78.9;21.5
62;2021-12-10;457;653;19492;1162013;1147149;331162;80.0;79.0;22.8
62;2021-12-11;385;560;17414;1162398;1147709;348576;80.0;79.0;24.0
62;2021-12-12;116;100;6367;1162514;1147809;354943;80.0;79.0;24.4
62;2021-12-13;348;434;15865;1162862;1148243;370808;80.0;79.0;25.5
62;2021-12-14;406;460;18699;1163268;1148703;389507;80.1;79.1;26.8
62;2021-12-15;350;538;16715;1163618;1149241;406222;80.1;79.1;28.0
62;2021-12-16;450;517;18999;1164068;1149758;425221;80.1;79.1;29.3
63;2020-12-27;0;0;0;0;0;0;0.0;0.0;0.0
63;2020-12-28;0;0;0;0;0;0;0.0;0.0;0.0
63;2020-12-29;0;0;0;0;0;0;0.0;0.0;0.0
63;2020-12-30;0;0;0;0;0;0;0.0;0.0;0.0
63;2020-12-31;1;1;0;1;1;0;0.0;0.0;0.0
63;2021-01-01;1;0;0;2;1;0;0.0;0.0;0.0
63;2021-01-02;0;0;0;2;1;0;0.0;0.0;0.0
63;2021-01-03;0;0;0;2;1;0;0.0;0.0;0.0
63;2021-01-04;0;0;0;2;1;0;0.0;0.0;0.0
63;2021-01-05;1;0;0;3;1;0;0.0;0.0;0.0
63;2021-01-06;5;1;0;8;2;0;0.0;0.0;0.0
63;2021-01-07;303;1;0;311;3;0;0.0;0.0;0.0
63;2021-01-08;216;5;0;527;8;0;0.1;0.0;0.0
63;2021-01-09;101;0;0;628;8;0;0.1;0.0;0.0
63;2021-01-10;82;0;0;710;8;0;0.1;0.0;0.0
63;2021-01-11;435;4;0;1145;12;0;0.2;0.0;0.0
63;2021-01-12;663;1;0;1808;13;0;0.3;0.0;0.0
63;2021-01-13;785;8;0;2593;21;0;0.4;0.0;0.0
63;2021-01-14;548;8;0;3141;29;0;0.5;0.0;0.0
63;2021-01-15;428;6;0;3569;35;0;0.5;0.0;0.0
63;2021-01-16;168;0;0;3737;35;0;0.6;0.0;0.0
63;2021-01-17;140;0;0;3877;35;0;0.6;0.0;0.0
63;2021-01-18;655;3;0;4532;38;0;0.7;0.0;0.0
63;2021-01-19;873;2;0;5405;40;0;0.8;0.0;0.0
63;2021-01-20;1127;12;0;6532;52;0;1.0;0.0;0.0
63;2021-01-21;1088;5;0;7620;57;0;1.2;0.0;0.0
63;2021-01-22;1040;5;0;8660;62;0;1.3;0.0;0.0
63;2021-01-23;200;0;0;8860;62;0;1.3;0.0;0.0
63;2021-01-24;165;2;0;9025;64;0;1.4;0.0;0.0
63;2021-01-25;893;4;0;9918;68;0;1.5;0.0;0.0
63;2021-01-26;971;3;0;10889;71;0;1.6;0.0;0.0
63;2021-01-27;1057;5;0;11946;76;0;1.8;0.0;0.0
63;2021-01-28;1370;70;0;13316;146;0;2.0;0.0;0.0
63;2021-01-29;1200;73;0;14516;219;0;2.2;0.0;0.0
63;2021-01-30;98;2;0;14614;221;0;2.2;0.0;0.0
63;2021-01-31;9;0;0;14623;221;0;2.2;0.0;0.0
63;2021-02-01;656;188;0;15279;409;0;2.3;0.1;0.0
63;2021-02-02;919;255;0;16198;664;0;2.5;0.1;0.0
63;2021-02-03;1597;317;0;17795;981;0;2.7;0.1;0.0
63;2021-02-04;2111;508;0;19906;1489;0;3.0;0.2;0.0
63;2021-02-05;1240;287;0;21146;1776;0;3.2;0.3;0.0
63;2021-02-06;121;5;0;21267;1781;0;3.2;0.3;0.0
63;2021-02-07;11;3;0;21278;1784;0;3.2;0.3;0.0
63;2021-02-08;549;405;0;21827;2189;0;3.3;0.3;0.0
63;2021-02-09;712;436;0;22539;2625;0;3.4;0.4;0.0
63;2021-02-10;642;587;0;23181;3212;0;3.5;0.5;0.0
63;2021-02-11;843;504;0;24024;3716;0;3.6;0.6;0.0
63;2021-02-12;845;820;0;24869;4536;0;3.8;0.7;0.0
63;2021-02-13;115;2;0;24984;4538;0;3.8;0.7;0.0
63;2021-02-14;2;61;0;24986;4599;0;3.8;0.7;0.0
63;2021-02-15;222;852;0;25208;5451;0;3.8;0.8;0.0
63;2021-02-16;426;1169;0;25634;6620;0;3.9;1.0;0.0
63;2021-02-17;405;920;0;26039;7540;0;3.9;1.1;0.0
63;2021-02-18;641;902;0;26680;8442;0;4.0;1.3;0.0
63;2021-02-19;479;1022;0;27159;9464;0;4.1;1.4;0.0
63;2021-02-20;47;40;0;27206;9504;0;4.1;1.4;0.0
63;2021-02-21;3;19;0;27209;9523;0;4.1;1.4;0.0
63;2021-02-22;276;943;0;27485;10466;0;4.2;1.6;0.0
63;2021-02-23;587;1149;0;28072;11615;0;4.3;1.8;0.0
63;2021-02-24;708;1414;0;28780;13029;0;4.4;2.0;0.0
63;2021-02-25;1598;1693;0;30378;14722;0;4.6;2.2;0.0
63;2021-02-26;1638;1416;0;32016;16138;0;4.8;2.4;0.0
63;2021-02-27;633;82;0;32649;16220;0;4.9;2.5;0.0
63;2021-02-28;6;170;0;32655;16390;0;4.9;2.5;0.0
63;2021-03-01;593;546;0;33248;16936;0;5.0;2.6;0.0
63;2021-03-02;965;825;0;34213;17761;0;5.2;2.7;0.0
63;2021-03-03;1077;738;0;35290;18499;0;5.3;2.8;0.0
63;2021-03-04;1794;531;0;37084;19030;0;5.6;2.9;0.0
63;2021-03-05;2654;728;0;39738;19758;0;6.0;3.0;0.0
63;2021-03-06;1577;56;0;41315;19814;0;6.3;3.0;0.0
63;2021-03-07;506;21;0;41821;19835;0;6.3;3.0;0.0
63;2021-03-08;1004;684;0;42825;20519;0;6.5;3.1;0.0
63;2021-03-09;1608;1060;0;44433;21579;0;6.7;3.3;0.0
63;2021-03-10;1683;664;0;46116;22243;0;7.0;3.4;0.0
63;2021-03-11;3135;942;0;49251;23185;0;7.5;3.5;0.0
63;2021-03-12;3580;431;0;52831;23616;0;8.0;3.6;0.0
63;2021-03-13;2101;92;0;54932;23708;0;8.3;3.6;0.0
63;2021-03-14;73;25;0;55005;23733;0;8.3;3.6;0.0
63;2021-03-15;1735;364;0;56740;24097;0;8.6;3.6;0.0
63;2021-03-16;1747;424;0;58487;24521;0;8.9;3.7;0.0
63;2021-03-17;1685;730;0;60172;25251;0;9.1;3.8;0.0
63;2021-03-18;1979;751;0;62151;26002;0;9.4;3.9;0.0
63;2021-03-19;2820;546;0;64971;26548;0;9.8;4.0;0.0
63;2021-03-20;1131;76;0;66102;26624;0;10.0;4.0;0.0
63;2021-03-21;57;42;0;66159;26666;0;10.0;4.0;0.0
63;2021-03-22;2025;261;0;68184;26927;0;10.3;4.1;0.0
63;2021-03-23;3004;365;0;71188;27292;0;10.8;4.1;0.0
63;2021-03-24;3245;364;0;74433;27656;0;11.3;4.2;0.0
63;2021-03-25;4664;439;0;79097;28095;0;12.0;4.3;0.0
63;2021-03-26;4604;589;0;83701;28684;0;12.7;4.3;0.0
63;2021-03-27;2440;232;0;86141;28916;0;13.0;4.4;0.0
63;2021-03-28;1021;75;0;87162;28991;0;13.2;4.4;0.0
63;2021-03-29;2519;522;0;89681;29513;0;13.6;4.5;0.0
63;2021-03-30;3334;663;0;93015;30176;0;14.1;4.6;0.0
63;2021-03-31;3023;808;0;96038;30984;0;14.5;4.7;0.0
63;2021-04-01;3877;595;0;99915;31579;0;15.1;4.8;0.0
63;2021-04-02;3460;719;0;103375;32298;0;15.7;4.9;0.0
63;2021-04-03;1163;188;0;104538;32486;0;15.8;4.9;0.0
63;2021-04-04;834;31;0;105372;32517;0;16.0;4.9;0.0
63;2021-04-05;773;82;0;106145;32599;0;16.1;4.9;0.0
63;2021-04-06;2472;1006;0;108617;33605;0;16.5;5.1;0.0
63;2021-04-07;3252;899;0;111869;34504;0;16.9;5.2;0.0
63;2021-04-08;4732;1246;0;116601;35750;0;17.7;5.4;0.0
63;2021-04-09;5402;1094;0;122003;36844;0;18.5;5.6;0.0
63;2021-04-10;2307;503;0;124310;37347;0;18.8;5.7;0.0
63;2021-04-11;938;50;0;125248;37397;0;19.0;5.7;0.0
63;2021-04-12;1631;1329;0;126879;38726;0;19.2;5.9;0.0
63;2021-04-13;2052;1995;0;128931;40721;0;19.5;6.2;0.0
63;2021-04-14;2760;1502;0;131691;42223;0;19.9;6.4;0.0
63;2021-04-15;3857;1613;0;135548;43836;0;20.5;6.6;0.0
63;2021-04-16;2979;2162;0;138527;45998;0;21.0;7.0;0.0
63;2021-04-17;1287;698;0;139814;46696;0;21.2;7.1;0.0
63;2021-04-18;772;69;0;140586;46765;0;21.3;7.1;0.0
63;2021-04-19;1728;2110;0;142314;48875;0;21.6;7.4;0.0
63;2021-04-20;1804;2342;0;144118;51217;0;21.8;7.8;0.0
63;2021-04-21;1558;2454;0;145676;53671;0;22.1;8.1;0.0
63;2021-04-22;2044;2362;0;147720;56033;0;22.4;8.5;0.0
63;2021-04-23;2091;3081;0;149811;59114;0;22.7;9.0;0.0
63;2021-04-24;1203;1176;0;151014;60290;0;22.9;9.1;0.0
63;2021-04-25;534;409;0;151548;60699;0;23.0;9.2;0.0
63;2021-04-26;1528;2259;0;153076;62958;0;23.2;9.5;0.0
63;2021-04-27;2406;2613;0;155482;65571;0;23.5;9.9;0.0
63;2021-04-28;2427;3156;0;157909;68727;0;23.9;10.4;0.0
63;2021-04-29;3011;2946;0;160920;71673;0;24.4;10.9;0.0
63;2021-04-30;3061;2782;0;163981;74455;0;24.8;11.3;0.0
63;2021-05-01;1188;1007;0;165169;75462;0;25.0;11.4;0.0
63;2021-05-02;869;626;0;166038;76088;0;25.1;11.5;0.0
63;2021-05-03;2788;2271;0;168826;78359;0;25.6;11.9;0.0
63;2021-05-04;3043;2725;0;171869;81084;0;26.0;12.3;0.0
63;2021-05-05;3050;3144;0;174919;84228;0;26.5;12.8;0.0
63;2021-05-06;3843;3152;0;178762;87380;0;27.1;13.2;0.0
63;2021-05-07;4291;3659;0;183053;91039;0;27.7;13.8;0.0
63;2021-05-08;2152;721;0;185205;91760;0;28.1;13.9;0.0
63;2021-05-09;1780;766;0;186985;92526;0;28.3;14.0;0.0
63;2021-05-10;4340;2792;0;191325;95318;0;29.0;14.4;0.0
63;2021-05-11;5577;2825;0;196902;98143;0;29.8;14.9;0.0
63;2021-05-12;5394;2960;0;202296;101103;0;30.6;15.3;0.0
63;2021-05-13;4443;720;0;206739;101823;0;31.3;15.4;0.0
63;2021-05-14;4958;1620;0;211697;103443;0;32.1;15.7;0.0
63;2021-05-15;3740;1014;0;215437;104457;0;32.6;15.8;0.0
63;2021-05-16;3412;442;0;218849;104899;0;33.1;15.9;0.0
63;2021-05-17;3968;2008;0;222817;106907;0;33.7;16.2;0.0
63;2021-05-18;5227;1684;0;228044;108591;0;34.5;16.4;0.0
63;2021-05-19;5392;1691;0;233436;110282;0;35.4;16.7;0.0
63;2021-05-20;6839;2176;0;240275;112458;0;36.4;17.0;0.0
63;2021-05-21;6438;2319;0;246713;114777;0;37.4;17.4;0.0
63;2021-05-22;3436;848;0;250149;115625;0;37.9;17.5;0.0
63;2021-05-23;2319;233;0;252468;115858;0;38.2;17.5;0.0
63;2021-05-24;2887;602;0;255355;116460;0;38.7;17.6;0.0
63;2021-05-25;4317;2634;0;259672;119094;0;39.3;18.0;0.0
63;2021-05-26;5472;2425;0;265144;121519;0;40.2;18.4;0.0
63;2021-05-27;6464;2794;0;271608;124313;0;41.1;18.8;0.0
63;2021-05-28;5720;3899;0;277328;128212;0;42.0;19.4;0.0
63;2021-05-29;3366;1522;0;280694;129734;0;42.5;19.6;0.0
63;2021-05-30;1498;215;0;282192;129949;0;42.7;19.7;0.0
63;2021-05-31;4007;2311;0;286199;132260;0;43.3;20.0;0.0
63;2021-06-01;3902;3054;0;290101;135314;0;43.9;20.5;0.0
63;2021-06-02;3956;2556;0;294057;137870;0;44.5;20.9;0.0
63;2021-06-03;4904;3311;0;298961;141181;0;45.3;21.4;0.0
63;2021-06-04;5086;3689;0;304047;144870;0;46.1;21.9;0.0
63;2021-06-05;2786;1727;0;306833;146597;0;46.5;22.2;0.0
63;2021-06-06;1241;688;0;308074;147285;0;46.7;22.3;0.0
63;2021-06-07;3178;2600;0;311252;149885;0;47.1;22.7;0.0
63;2021-06-08;2974;2811;0;314226;152696;0;47.6;23.1;0.0
63;2021-06-09;3144;2359;0;317370;155055;0;48.1;23.5;0.0
63;2021-06-10;3288;2799;0;320658;157854;0;48.6;23.9;0.0
63;2021-06-11;3114;4226;0;323772;162080;0;49.0;24.5;0.0
63;2021-06-12;1690;1970;0;325462;164050;0;49.3;24.8;0.0
63;2021-06-13;466;1080;0;325928;165130;0;49.4;25.0;0.0
63;2021-06-14;1813;3547;0;327741;168677;0;49.6;25.5;0.0
63;2021-06-15;2336;3680;0;330077;172357;0;50.0;26.1;0.0
63;2021-06-16;2599;3422;0;332676;175779;0;50.4;26.6;0.0
63;2021-06-17;2480;4483;0;335156;180262;0;50.8;27.3;0.0
63;2021-06-18;2567;5991;0;337723;186253;0;51.2;28.2;0.0
63;2021-06-19;1680;3023;0;339403;189276;0;51.4;28.7;0.0
63;2021-06-20;649;2359;0;340052;191635;0;51.5;29.0;0.0
63;2021-06-21;1284;5540;0;341336;197175;0;51.7;29.9;0.0
63;2021-06-22;1356;5799;0;342692;202974;0;51.9;30.7;0.0
63;2021-06-23;1575;5015;0;344267;207989;0;52.1;31.5;0.0
63;2021-06-24;2008;5515;0;346275;213504;0;52.4;32.3;0.0
63;2021-06-25;1791;6164;0;348066;219668;0;52.7;33.3;0.0
63;2021-06-26;1075;3399;0;349141;223067;0;52.9;33.8;0.0
63;2021-06-27;686;3363;0;349827;226430;0;53.0;34.3;0.0
63;2021-06-28;1163;5648;0;350990;232078;0;53.2;35.2;0.0
63;2021-06-29;1282;5335;0;352272;237413;0;53.4;36.0;0.0
63;2021-06-30;1667;5532;0;353939;242945;0;53.6;36.8;0.0
63;2021-07-01;1969;7984;0;355908;250929;0;53.9;38.0;0.0
63;2021-07-02;2181;6703;0;358089;257632;0;54.2;39.0;0.0
63;2021-07-03;962;3009;0;359051;260641;0;54.4;39.5;0.0
63;2021-07-04;1013;1874;0;360064;262515;0;54.5;39.8;0.0
63;2021-07-05;1561;6343;0;361625;268858;0;54.8;40.7;0.0
63;2021-07-06;1645;4976;0;363270;273834;0;55.0;41.5;0.0
63;2021-07-07;1953;4318;0;365223;278152;0;55.3;42.1;0.0
63;2021-07-08;2243;4759;0;367466;282911;0;55.7;42.8;0.0
63;2021-07-09;1995;5949;0;369461;288860;0;56.0;43.8;0.0
63;2021-07-10;1542;3619;0;371003;292479;0;56.2;44.3;0.0
63;2021-07-11;864;1488;0;371867;293967;0;56.3;44.5;0.0
63;2021-07-12;1597;8296;0;373464;302263;0;56.6;45.8;0.0
63;2021-07-13;3609;6214;0;377073;308477;0;57.1;46.7;0.0
63;2021-07-14;3383;1731;0;380456;310208;0;57.6;47.0;0.0
63;2021-07-15;4312;5149;0;384768;315357;0;58.3;47.8;0.0
63;2021-07-16;4638;5796;0;389406;321153;0;59.0;48.6;0.0
63;2021-07-17;2884;2570;0;392290;323723;0;59.4;49.0;0.0
63;2021-07-18;2632;1090;0;394922;324813;0;59.8;49.2;0.0
63;2021-07-19;3909;4787;0;398831;329600;0;60.4;49.9;0.0
63;2021-07-20;4642;5426;0;403473;335026;0;61.1;50.7;0.0
63;2021-07-21;4660;4072;0;408133;339098;0;61.8;51.4;0.0
63;2021-07-22;5289;4408;0;413422;343506;0;62.6;52.0;0.0
63;2021-07-23;5060;4598;0;418482;348104;0;63.4;52.7;0.0
63;2021-07-24;3394;2010;0;421876;350114;0;63.9;53.0;0.0
63;2021-07-25;2692;1308;0;424568;351422;0;64.3;53.2;0.0
63;2021-07-26;3837;3242;0;428405;354664;0;64.9;53.7;0.0
63;2021-07-27;3897;3213;0;432302;357877;0;65.5;54.2;0.0
63;2021-07-28;3784;2740;0;436086;360617;0;66.0;54.6;0.0
63;2021-07-29;4371;3199;0;440457;363816;0;66.7;55.1;0.0
63;2021-07-30;3823;3602;0;444280;367418;0;67.3;55.6;0.0
63;2021-07-31;2161;1831;0;446441;369249;0;67.6;55.9;0.0
63;2021-08-01;1060;793;0;447501;370042;0;67.8;56.0;0.0
63;2021-08-02;2265;2964;0;449766;373006;0;68.1;56.5;0.0
63;2021-08-03;2758;3335;0;452524;376341;0;68.5;57.0;0.0
63;2021-08-04;2831;3181;1;455355;379522;1;69.0;57.5;0.0
63;2021-08-05;2401;3501;0;457756;383023;1;69.3;58.0;0.0
63;2021-08-06;2315;4022;0;460071;387045;1;69.7;58.6;0.0
63;2021-08-07;1271;2723;0;461342;389768;1;69.9;59.0;0.0
63;2021-08-08;335;1169;0;461677;390937;1;69.9;59.2;0.0
63;2021-08-09;1775;4094;0;463452;395031;1;70.2;59.8;0.0
63;2021-08-10;2219;4008;0;465671;399039;1;70.5;60.4;0.0
63;2021-08-11;2045;3651;0;467716;402690;1;70.8;61.0;0.0
63;2021-08-12;1801;4607;0;469517;407297;1;71.1;61.7;0.0
63;2021-08-13;1671;3906;0;471188;411203;1;71.4;62.3;0.0
63;2021-08-14;839;3017;0;472027;414220;1;71.5;62.7;0.0
63;2021-08-15;181;1346;0;472208;415566;1;71.5;62.9;0.0
63;2021-08-16;1137;4302;0;473345;419868;1;71.7;63.6;0.0
63;2021-08-17;1623;4034;0;474968;423902;1;71.9;64.2;0.0
63;2021-08-18;1399;3312;0;476367;427214;1;72.2;64.7;0.0
63;2021-08-19;1316;3508;0;477683;430722;1;72.3;65.2;0.0
63;2021-08-20;1329;3600;0;479012;434322;1;72.6;65.8;0.0
63;2021-08-21;670;2072;0;479682;436394;1;72.7;66.1;0.0
63;2021-08-22;214;1039;0;479896;437433;1;72.7;66.3;0.0
63;2021-08-23;1009;3506;0;480905;440939;1;72.8;66.8;0.0
63;2021-08-24;1066;3046;0;481971;443985;1;73.0;67.2;0.0
63;2021-08-25;1040;2923;0;483011;446908;1;73.2;67.7;0.0
63;2021-08-26;1105;2690;0;484116;449598;1;73.3;68.1;0.0
63;2021-08-27;1094;3261;0;485210;452859;1;73.5;68.6;0.0
63;2021-08-28;675;1684;0;485885;454543;1;73.6;68.8;0.0
63;2021-08-29;108;581;0;485993;455124;1;73.6;68.9;0.0
63;2021-08-30;763;2396;54;486756;457520;55;73.7;69.3;0.0
63;2021-08-31;972;2503;99;487728;460023;154;73.9;69.7;0.0
63;2021-09-01;954;1822;264;488682;461845;418;74.0;70.0;0.1
63;2021-09-02;824;1810;319;489506;463655;737;74.1;70.2;0.1
63;2021-09-03;909;2265;403;490415;465920;1140;74.3;70.6;0.2
63;2021-09-04;661;1398;130;491076;467318;1270;74.4;70.8;0.2
63;2021-09-05;76;201;14;491152;467519;1284;74.4;70.8;0.2
63;2021-09-06;522;1155;384;491674;468674;1668;74.5;71.0;0.3
63;2021-09-07;640;1398;380;492314;470072;2048;74.6;71.2;0.3
63;2021-09-08;679;1442;285;492993;471514;2333;74.7;71.4;0.4
63;2021-09-09;606;1174;353;493599;472688;2686;74.8;71.6;0.4
63;2021-09-10;749;1608;477;494348;474296;3163;74.9;71.8;0.5
63;2021-09-11;461;1024;128;494809;475320;3291;74.9;72.0;0.5
63;2021-09-12;50;159;13;494859;475479;3304;75.0;72.0;0.5
63;2021-09-13;431;876;499;495290;476355;3803;75.0;72.1;0.6
63;2021-09-14;537;835;629;495827;477190;4432;75.1;72.3;0.7
63;2021-09-15;550;1230;392;496377;478420;4824;75.2;72.5;0.7
63;2021-09-16;459;877;565;496836;479297;5389;75.3;72.6;0.8
63;2021-09-17;451;1189;579;497287;480486;5968;75.3;72.8;0.9
63;2021-09-18;299;953;124;497586;481439;6092;75.4;72.9;0.9
63;2021-09-19;41;109;9;497627;481548;6101;75.4;72.9;0.9
63;2021-09-20;337;667;552;497964;482215;6653;75.4;73.0;1.0
63;2021-09-21;401;687;687;498365;482902;7340;75.5;73.1;1.1
63;2021-09-22;376;1099;383;498741;484001;7723;75.5;73.3;1.2
63;2021-09-23;274;650;561;499015;484651;8284;75.6;73.4;1.3
63;2021-09-24;467;1102;527;499482;485753;8811;75.7;73.6;1.3
63;2021-09-25;233;750;140;499715;486503;8951;75.7;73.7;1.4
63;2021-09-26;26;97;6;499741;486600;8957;75.7;73.7;1.4
63;2021-09-27;297;588;490;500038;487188;9447;75.7;73.8;1.4
63;2021-09-28;274;580;580;500312;487768;10027;75.8;73.9;1.5
63;2021-09-29;311;738;689;500623;488506;10716;75.8;74.0;1.6
63;2021-09-30;270;637;718;500893;489143;11434;75.9;74.1;1.7
63;2021-10-01;475;851;627;501368;489994;12061;75.9;74.2;1.8
63;2021-10-02;254;514;150;501622;490508;12211;76.0;74.3;1.8
63;2021-10-03;33;75;12;501655;490583;12223;76.0;74.3;1.9
63;2021-10-04;200;381;423;501855;490964;12646;76.0;74.4;1.9
63;2021-10-05;283;479;623;502138;491443;13269;76.1;74.4;2.0
63;2021-10-06;340;606;580;502478;492049;13849;76.1;74.5;2.1
63;2021-10-07;239;452;762;502717;492501;14611;76.1;74.6;2.2
63;2021-10-08;369;683;868;503086;493184;15479;76.2;74.7;2.3
63;2021-10-09;218;382;254;503304;493566;15733;76.2;74.8;2.4
63;2021-10-10;25;45;14;503329;493611;15747;76.2;74.8;2.4
63;2021-10-11;195;415;690;503524;494026;16437;76.3;74.8;2.5
63;2021-10-12;209;407;755;503733;494433;17192;76.3;74.9;2.6
63;2021-10-13;287;417;789;504020;494850;17981;76.3;75.0;2.7
63;2021-10-14;244;360;851;504264;495210;18832;76.4;75.0;2.9
63;2021-10-15;370;637;1230;504634;495847;20062;76.4;75.1;3.0
63;2021-10-16;207;308;233;504841;496155;20295;76.5;75.1;3.1
63;2021-10-17;23;41;11;504864;496196;20306;76.5;75.2;3.1
63;2021-10-18;194;380;786;505058;496576;21092;76.5;75.2;3.2
63;2021-10-19;129;246;832;505187;496822;21924;76.5;75.2;3.3
63;2021-10-20;170;346;1057;505357;497168;22981;76.5;75.3;3.5
63;2021-10-21;107;341;997;505464;497509;23978;76.6;75.4;3.6
63;2021-10-22;170;496;1334;505634;498005;25312;76.6;75.4;3.8
63;2021-10-23;81;228;335;505715;498233;25647;76.6;75.5;3.9
63;2021-10-24;15;31;21;505730;498264;25668;76.6;75.5;3.9
63;2021-10-25;122;225;981;505852;498489;26649;76.6;75.5;4.0
63;2021-10-26;110;192;1094;505962;498681;27743;76.6;75.5;4.2
63;2021-10-27;115;285;1200;506077;498966;28943;76.7;75.6;4.4
63;2021-10-28;107;285;1175;506184;499251;30118;76.7;75.6;4.6
63;2021-10-29;130;324;1348;506314;499575;31466;76.7;75.7;4.8
63;2021-10-30;54;157;323;506368;499732;31789;76.7;75.7;4.8
63;2021-10-31;4;14;30;506372;499746;31819;76.7;75.7;4.8
63;2021-11-01;29;33;146;506401;499779;31965;76.7;75.7;4.8
63;2021-11-02;125;243;1489;506526;500022;33454;76.7;75.7;5.1
63;2021-11-03;112;272;1257;506638;500294;34711;76.7;75.8;5.3
63;2021-11-04;126;199;1511;506764;500493;36222;76.8;75.8;5.5
63;2021-11-05;151;344;1950;506915;500837;38172;76.8;75.9;5.8
63;2021-11-06;67;187;646;506982;501024;38818;76.8;75.9;5.9
63;2021-11-07;9;30;33;506991;501054;38851;76.8;75.9;5.9
63;2021-11-08;90;215;1709;507081;501269;40560;76.8;75.9;6.1
63;2021-11-09;93;189;2023;507174;501458;42583;76.8;76.0;6.4
63;2021-11-10;145;236;2009;507319;501694;44592;76.8;76.0;6.8
63;2021-11-11;38;34;396;507357;501728;44988;76.8;76.0;6.8
63;2021-11-12;149;207;2077;507506;501935;47065;76.9;76.0;7.1
63;2021-11-13;79;110;755;507585;502045;47820;76.9;76.0;7.2
63;2021-11-14;6;18;65;507591;502063;47885;76.9;76.0;7.3
63;2021-11-15;88;134;2348;507679;502197;50233;76.9;76.1;7.6
63;2021-11-16;105;135;2603;507784;502332;52836;76.9;76.1;8.0
63;2021-11-17;156;191;2344;507940;502523;55180;76.9;76.1;8.4
63;2021-11-18;105;127;2335;508045;502650;57515;76.9;76.1;8.7
63;2021-11-19;172;194;2918;508217;502844;60433;77.0;76.2;9.2
63;2021-11-20;89;103;1007;508306;502947;61440;77.0;76.2;9.3
63;2021-11-21;10;15;68;508316;502962;61508;77.0;76.2;9.3
63;2021-11-22;94;79;2184;508410;503041;63692;77.0;76.2;9.6
63;2021-11-23;105;109;2575;508515;503150;66267;77.0;76.2;10.0
63;2021-11-24;178;190;2376;508693;503340;68643;77.0;76.2;10.4
63;2021-11-25;113;128;2924;508806;503468;71567;77.1;76.3;10.8
63;2021-11-26;181;175;5151;508987;503643;76718;77.1;76.3;11.6
63;2021-11-27;87;72;2393;509074;503715;79111;77.1;76.3;12.0
63;2021-11-28;26;19;991;509100;503734;80102;77.1;76.3;12.1
63;2021-11-29;104;111;4926;509204;503845;85028;77.1;76.3;12.9
63;2021-11-30;118;115;5793;509322;503960;90821;77.1;76.3;13.8
63;2021-12-01;121;155;5877;509443;504115;96698;77.2;76.4;14.6
63;2021-12-02;118;100;6607;509561;504215;103305;77.2;76.4;15.6
63;2021-12-03;118;172;7260;509679;504387;110565;77.2;76.4;16.7
63;2021-12-04;53;103;3505;509732;504490;114070;77.2;76.4;17.3
63;2021-12-05;12;21;1254;509744;504511;115324;77.2;76.4;17.5
63;2021-12-06;106;96;6656;509850;504607;121980;77.2;76.4;18.5
63;2021-12-07;84;127;7985;509934;504734;129965;77.2;76.4;19.7
63;2021-12-08;130;186;6770;510064;504920;136735;77.3;76.5;20.7
63;2021-12-09;89;127;7431;510153;505047;144166;77.3;76.5;21.8
63;2021-12-10;129;200;9016;510282;505247;153182;77.3;76.5;23.2
63;2021-12-11;83;94;4795;510365;505341;157977;77.3;76.5;23.9
63;2021-12-12;6;9;1218;510371;505350;159195;77.3;76.5;24.1
63;2021-12-13;84;128;7786;510455;505478;166981;77.3;76.6;25.3
63;2021-12-14;127;140;9705;510582;505618;176686;77.3;76.6;26.8
63;2021-12-15;139;193;7922;510721;505811;184608;77.4;76.6;28.0
63;2021-12-16;117;138;8982;510838;505949;193590;77.4;76.6;29.3
64;2020-12-27;1;0;0;1;0;0;0.0;0.0;0.0
64;2020-12-28;2;0;0;3;0;0;0.0;0.0;0.0
64;2020-12-29;0;0;0;3;0;0;0.0;0.0;0.0
64;2020-12-30;0;0;0;3;0;0;0.0;0.0;0.0
64;2020-12-31;0;0;0;3;0;0;0.0;0.0;0.0
64;2021-01-01;1;0;0;4;0;0;0.0;0.0;0.0
64;2021-01-02;0;0;0;4;0;0;0.0;0.0;0.0
64;2021-01-03;0;0;0;4;0;0;0.0;0.0;0.0
64;2021-01-04;28;0;0;32;0;0;0.0;0.0;0.0
64;2021-01-05;24;0;0;56;0;0;0.0;0.0;0.0
64;2021-01-06;186;0;0;242;0;0;0.0;0.0;0.0
64;2021-01-07;808;1;0;1050;1;0;0.2;0.0;0.0
64;2021-01-08;832;2;0;1882;3;0;0.3;0.0;0.0
64;2021-01-09;54;0;0;1936;3;0;0.3;0.0;0.0
64;2021-01-10;2;0;0;1938;3;0;0.3;0.0;0.0
64;2021-01-11;515;0;0;2453;3;0;0.4;0.0;0.0
64;2021-01-12;724;3;0;3177;6;0;0.5;0.0;0.0
64;2021-01-13;841;2;0;4018;8;0;0.6;0.0;0.0
64;2021-01-14;992;5;0;5010;13;0;0.7;0.0;0.0
64;2021-01-15;903;5;0;5913;18;0;0.9;0.0;0.0
64;2021-01-16;76;0;0;5989;18;0;0.9;0.0;0.0
64;2021-01-17;3;1;0;5992;19;0;0.9;0.0;0.0
64;2021-01-18;913;7;0;6905;26;0;1.0;0.0;0.0
64;2021-01-19;1422;4;0;8327;30;0;1.2;0.0;0.0
64;2021-01-20;1553;3;0;9880;33;0;1.4;0.0;0.0
64;2021-01-21;2471;4;0;12351;37;0;1.8;0.0;0.0
64;2021-01-22;1531;3;0;13882;40;0;2.0;0.0;0.0
64;2021-01-23;481;1;0;14363;41;0;2.1;0.0;0.0
64;2021-01-24;59;0;0;14422;41;0;2.1;0.0;0.0
64;2021-01-25;915;7;0;15337;48;0;2.2;0.0;0.0
64;2021-01-26;1284;21;0;16621;69;0;2.4;0.0;0.0
64;2021-01-27;1198;119;0;17819;188;0;2.6;0.0;0.0
64;2021-01-28;1606;604;0;19425;792;0;2.8;0.1;0.0
64;2021-01-29;943;597;0;20368;1389;0;3.0;0.2;0.0
64;2021-01-30;445;58;0;20813;1447;0;3.0;0.2;0.0
64;2021-01-31;76;0;0;20889;1447;0;3.1;0.2;0.0
64;2021-02-01;646;305;0;21535;1752;0;3.2;0.3;0.0
64;2021-02-02;1113;537;0;22648;2289;0;3.3;0.3;0.0
64;2021-02-03;1023;633;0;23671;2922;0;3.5;0.4;0.0
64;2021-02-04;1021;544;0;24692;3466;0;3.6;0.5;0.0
64;2021-02-05;801;458;0;25493;3924;0;3.7;0.6;0.0
64;2021-02-06;488;33;0;25981;3957;0;3.8;0.6;0.0
64;2021-02-07;104;5;0;26085;3962;0;3.8;0.6;0.0
64;2021-02-08;716;308;0;26801;4270;0;3.9;0.6;0.0
64;2021-02-09;886;712;0;27687;4982;0;4.1;0.7;0.0
64;2021-02-10;870;747;0;28557;5729;0;4.2;0.8;0.0
64;2021-02-11;1136;1488;0;29693;7217;0;4.3;1.1;0.0
64;2021-02-12;1018;999;0;30711;8216;0;4.5;1.2;0.0
64;2021-02-13;239;302;0;30950;8518;0;4.5;1.2;0.0
64;2021-02-14;34;40;0;30984;8558;0;4.5;1.3;0.0
64;2021-02-15;213;1095;0;31197;9653;0;4.6;1.4;0.0
64;2021-02-16;276;1356;0;31473;11009;0;4.6;1.6;0.0
64;2021-02-17;303;1200;0;31776;12209;0;4.7;1.8;0.0
64;2021-02-18;491;1603;0;32267;13812;0;4.7;2.0;0.0
64;2021-02-19;417;1238;0;32684;15050;0;4.8;2.2;0.0
64;2021-02-20;114;406;0;32798;15456;0;4.8;2.3;0.0
64;2021-02-21;17;68;0;32815;15524;0;4.8;2.3;0.0
64;2021-02-22;428;928;0;33243;16452;0;4.9;2.4;0.0
64;2021-02-23;676;1095;0;33919;17547;0;5.0;2.6;0.0
64;2021-02-24;718;983;0;34637;18530;0;5.1;2.7;0.0
64;2021-02-25;1060;920;0;35697;19450;0;5.2;2.8;0.0
64;2021-02-26;1168;880;0;36865;20330;0;5.4;3.0;0.0
64;2021-02-27;833;375;0;37698;20705;0;5.5;3.0;0.0
64;2021-02-28;42;61;0;37740;20766;0;5.5;3.0;0.0
64;2021-03-01;736;780;0;38476;21546;0;5.6;3.2;0.0
64;2021-03-02;1041;892;0;39517;22438;0;5.8;3.3;0.0
64;2021-03-03;1215;937;0;40732;23375;0;6.0;3.4;0.0
64;2021-03-04;1839;1114;0;42571;24489;0;6.2;3.6;0.0
64;2021-03-05;2119;1024;0;44690;25513;0;6.5;3.7;0.0
64;2021-03-06;1484;515;0;46174;26028;0;6.8;3.8;0.0
64;2021-03-07;585;91;0;46759;26119;0;6.8;3.8;0.0
64;2021-03-08;1459;732;0;48218;26851;0;7.1;3.9;0.0
64;2021-03-09;2028;824;0;50246;27675;0;7.4;4.1;0.0
64;2021-03-10;2047;711;0;52293;28386;0;7.7;4.2;0.0
64;2021-03-11;2866;1055;0;55159;29441;0;8.1;4.3;0.0
64;2021-03-12;3314;607;0;58473;30048;0;8.6;4.4;0.0
64;2021-03-13;2100;192;0;60573;30240;0;8.9;4.4;0.0
64;2021-03-14;209;17;0;60782;30257;0;8.9;4.4;0.0
64;2021-03-15;2212;234;0;62994;30491;0;9.2;4.5;0.0
64;2021-03-16;1935;262;0;64929;30753;0;9.5;4.5;0.0
64;2021-03-17;1985;270;0;66914;31023;0;9.8;4.5;0.0
64;2021-03-18;2312;232;0;69226;31255;0;10.1;4.6;0.0
64;2021-03-19;2900;287;0;72126;31542;0;10.6;4.6;0.0
64;2021-03-20;2286;94;0;74412;31636;0;10.9;4.6;0.0
64;2021-03-21;1170;25;0;75582;31661;0;11.1;4.6;0.0
64;2021-03-22;2429;537;0;78011;32198;0;11.4;4.7;0.0
64;2021-03-23;3038;624;0;81049;32822;0;11.9;4.8;0.0
64;2021-03-24;3353;668;0;84402;33490;0;12.4;4.9;0.0
64;2021-03-25;4134;773;0;88536;34263;0;13.0;5.0;0.0
64;2021-03-26;4214;650;0;92750;34913;0;13.6;5.1;0.0
64;2021-03-27;2869;405;0;95619;35318;0;14.0;5.2;0.0
64;2021-03-28;418;67;0;96037;35385;0;14.1;5.2;0.0
64;2021-03-29;2919;858;0;98956;36243;0;14.5;5.3;0.0
64;2021-03-30;3967;863;0;102923;37106;0;15.1;5.4;0.0
64;2021-03-31;3444;760;0;106367;37866;0;15.6;5.5;0.0
64;2021-04-01;4517;906;0;110884;38772;0;16.2;5.7;0.0
64;2021-04-02;4234;708;0;115118;39480;0;16.9;5.8;0.0
64;2021-04-03;1978;547;0;117096;40027;0;17.1;5.9;0.0
64;2021-04-04;258;40;0;117354;40067;0;17.2;5.9;0.0
64;2021-04-05;1499;117;0;118853;40184;0;17.4;5.9;0.0
64;2021-04-06;3512;1343;0;122365;41527;0;17.9;6.1;0.0
64;2021-04-07;3842;1444;0;126207;42971;0;18.5;6.3;0.0
64;2021-04-08;4994;1508;0;131201;44479;0;19.2;6.5;0.0
64;2021-04-09;5652;1607;0;136853;46086;0;20.0;6.7;0.0
64;2021-04-10;3083;982;0;139936;47068;0;20.5;6.9;0.0
64;2021-04-11;389;218;0;140325;47286;0;20.5;6.9;0.0
64;2021-04-12;3875;1776;0;144200;49062;0;21.1;7.2;0.0
64;2021-04-13;4218;2053;0;148418;51115;0;21.7;7.5;0.0
64;2021-04-14;3919;2010;0;152337;53125;0;22.3;7.8;0.0
64;2021-04-15;4146;2147;0;156483;55272;0;22.9;8.1;0.0
64;2021-04-16;4127;2168;0;160610;57440;0;23.5;8.4;0.0
64;2021-04-17;2426;1375;0;163036;58815;0;23.9;8.6;0.0
64;2021-04-18;993;1077;0;164029;59892;0;24.0;8.8;0.0
64;2021-04-19;2569;2317;0;166598;62209;0;24.4;9.1;0.0
64;2021-04-20;3034;2306;0;169632;64515;0;24.8;9.4;0.0
64;2021-04-21;2961;2479;0;172593;66994;0;25.3;9.8;0.0
64;2021-04-22;3236;2620;0;175829;69614;0;25.7;10.2;0.0
64;2021-04-23;3149;2507;0;178978;72121;0;26.2;10.6;0.0
64;2021-04-24;1907;1496;0;180885;73617;0;26.5;10.8;0.0
64;2021-04-25;244;196;0;181129;73813;0;26.5;10.8;0.0
64;2021-04-26;2466;2594;0;183595;76407;0;26.9;11.2;0.0
64;2021-04-27;2808;2995;0;186403;79402;0;27.3;11.6;0.0
64;2021-04-28;3361;2843;0;189764;82245;0;27.8;12.0;0.0
64;2021-04-29;4388;3332;0;194152;85577;0;28.4;12.5;0.0
64;2021-04-30;3846;3459;0;197998;89036;0;29.0;13.0;0.0
64;2021-05-01;1437;970;0;199435;90006;0;29.2;13.2;0.0
64;2021-05-02;428;300;0;199863;90306;0;29.3;13.2;0.0
64;2021-05-03;2741;3348;0;202604;93654;0;29.7;13.7;0.0
64;2021-05-04;3442;3790;0;206046;97444;0;30.2;14.3;0.0
64;2021-05-05;3135;3894;0;209181;101338;0;30.6;14.8;0.0
64;2021-05-06;3843;3837;0;213024;105175;0;31.2;15.4;0.0
64;2021-05-07;3691;4021;0;216715;109196;0;31.7;16.0;0.0
64;2021-05-08;2497;1183;0;219212;110379;0;32.1;16.2;0.0
64;2021-05-09;643;276;0;219855;110655;0;32.2;16.2;0.0
64;2021-05-10;2669;3982;0;222524;114637;0;32.6;16.8;0.0
64;2021-05-11;3860;3874;0;226384;118511;0;33.1;17.3;0.0
64;2021-05-12;4224;3777;0;230608;122288;0;33.8;17.9;0.0
64;2021-05-13;2882;827;0;233490;123115;0;34.2;18.0;0.0
64;2021-05-14;4710;2934;0;238200;126049;0;34.9;18.5;0.0
64;2021-05-15;3287;1717;0;241487;127766;0;35.3;18.7;0.0
64;2021-05-16;590;189;0;242077;127955;0;35.4;18.7;0.0
64;2021-05-17;3919;2262;0;245996;130217;0;36.0;19.1;0.0
64;2021-05-18;4829;2190;0;250825;132407;0;36.7;19.4;0.0
64;2021-05-19;4695;2049;0;255520;134456;0;37.4;19.7;0.0
64;2021-05-20;5222;2025;0;260742;136481;0;38.2;20.0;0.0
64;2021-05-21;5028;2130;0;265770;138611;0;38.9;20.3;0.0
64;2021-05-22;3281;1370;0;269051;139981;0;39.4;20.5;0.0
64;2021-05-23;413;169;0;269464;140150;0;39.4;20.5;0.0
64;2021-05-24;2768;1048;0;272232;141198;0;39.8;20.7;0.0
64;2021-05-25;4031;2646;0;276263;143844;0;40.4;21.1;0.0
64;2021-05-26;4169;2599;0;280432;146443;0;41.0;21.4;0.0
64;2021-05-27;5035;3053;0;285467;149496;0;41.8;21.9;0.0
64;2021-05-28;4312;3219;0;289779;152715;0;42.4;22.4;0.0
64;2021-05-29;2653;2010;0;292432;154725;0;42.8;22.6;0.0
64;2021-05-30;389;186;0;292821;154911;0;42.9;22.7;0.0
64;2021-05-31;3661;3401;0;296482;158312;0;43.4;23.2;0.0
64;2021-06-01;5060;3324;0;301542;161636;0;44.1;23.7;0.0
64;2021-06-02;4700;2987;0;306242;164623;0;44.8;24.1;0.0
64;2021-06-03;5863;3098;0;312105;167721;0;45.7;24.6;0.0
64;2021-06-04;4815;4331;0;316920;172052;0;46.4;25.2;0.0
64;2021-06-05;3096;2381;0;320016;174433;0;46.8;25.5;0.0
64;2021-06-06;1773;285;0;321789;174718;0;47.1;25.6;0.0
64;2021-06-07;3718;4135;0;325507;178853;0;47.6;26.2;0.0
64;2021-06-08;4641;3873;0;330148;182726;0;48.3;26.7;0.0
64;2021-06-09;4721;3326;0;334869;186052;0;49.0;27.2;0.0
64;2021-06-10;5559;3005;0;340428;189057;0;49.8;27.7;0.0
64;2021-06-11;5067;4570;0;345495;193627;0;50.6;28.3;0.0
64;2021-06-12;3499;2134;0;348994;195761;0;51.1;28.7;0.0
64;2021-06-13;1402;331;0;350396;196092;0;51.3;28.7;0.0
64;2021-06-14;3299;4485;0;353695;200577;0;51.8;29.4;0.0
64;2021-06-15;4172;4394;0;357867;204971;0;52.4;30.0;0.0
64;2021-06-16;4126;4415;0;361993;209386;0;53.0;30.6;0.0
64;2021-06-17;3284;3996;0;365277;213382;0;53.5;31.2;0.0
64;2021-06-18;4040;4819;0;369317;218201;0;54.1;31.9;0.0
64;2021-06-19;2660;3054;0;371977;221255;0;54.4;32.4;0.0
64;2021-06-20;762;478;0;372739;221733;0;54.6;32.5;0.0
64;2021-06-21;2040;4721;0;374779;226454;0;54.9;33.1;0.0
64;2021-06-22;2337;5355;0;377116;231809;0;55.2;33.9;0.0
64;2021-06-23;2811;5116;0;379927;236925;0;55.6;34.7;0.0
64;2021-06-24;2485;3569;0;382412;240494;0;56.0;35.2;0.0
64;2021-06-25;2507;6009;0;384919;246503;0;56.3;36.1;0.0
64;2021-06-26;1564;3647;0;386483;250150;0;56.6;36.6;0.0
64;2021-06-27;409;735;0;386892;250885;0;56.6;36.7;0.0
64;2021-06-28;1687;5576;0;388579;256461;0;56.9;37.5;0.0
64;2021-06-29;1748;5859;0;390327;262320;0;57.1;38.4;0.0
64;2021-06-30;2031;5623;0;392358;267943;0;57.4;39.2;0.0
64;2021-07-01;2223;4963;0;394581;272906;0;57.8;39.9;0.0
64;2021-07-02;2149;5913;0;396730;278819;0;58.1;40.8;0.0
64;2021-07-03;1115;3556;0;397845;282375;0;58.2;41.3;0.0
64;2021-07-04;387;755;0;398232;283130;0;58.3;41.4;0.0
64;2021-07-05;1254;5039;0;399486;288169;0;58.5;42.2;0.0
64;2021-07-06;1905;5916;1;401391;294085;1;58.8;43.0;0.0
64;2021-07-07;1938;5422;0;403329;299507;1;59.0;43.8;0.0
64;2021-07-08;1660;4045;0;404989;303552;1;59.3;44.4;0.0
64;2021-07-09;1768;6039;0;406757;309591;1;59.5;45.3;0.0
64;2021-07-10;1139;3575;0;407896;313166;1;59.7;45.8;0.0
64;2021-07-11;238;741;0;408134;313907;1;59.7;45.9;0.0
64;2021-07-12;1395;5690;0;409529;319597;1;59.9;46.8;0.0
64;2021-07-13;2281;6717;0;411810;326314;1;60.3;47.8;0.0
64;2021-07-14;2173;2927;0;413983;329241;1;60.6;48.2;0.0
64;2021-07-15;2157;4964;0;416140;334205;1;60.9;48.9;0.0
64;2021-07-16;2792;6201;0;418932;340406;1;61.3;49.8;0.0
64;2021-07-17;2243;4040;0;421175;344446;1;61.7;50.4;0.0
64;2021-07-18;650;1791;0;421825;346237;1;61.7;50.7;0.0
64;2021-07-19;2393;5545;0;424218;351782;1;62.1;51.5;0.0
64;2021-07-20;3210;6033;0;427428;357815;1;62.6;52.4;0.0
64;2021-07-21;3459;5441;0;430887;363256;1;63.1;53.2;0.0
64;2021-07-22;3962;5154;0;434849;368410;1;63.7;53.9;0.0
64;2021-07-23;3752;5084;0;438601;373494;1;64.2;54.7;0.0
64;2021-07-24;2606;3966;0;441207;377460;1;64.6;55.3;0.0
64;2021-07-25;730;841;0;441937;378301;1;64.7;55.4;0.0
64;2021-07-26;2934;4497;0;444871;382798;1;65.1;56.0;0.0
64;2021-07-27;4102;4668;0;448973;387466;1;65.7;56.7;0.0
64;2021-07-28;4105;4067;0;453078;391533;1;66.3;57.3;0.0
64;2021-07-29;5213;3339;0;458291;394872;1;67.1;57.8;0.0
64;2021-07-30;4747;3762;0;463038;398634;1;67.8;58.4;0.0
64;2021-07-31;3091;2971;0;466129;401605;1;68.2;58.8;0.0
64;2021-08-01;886;398;0;467015;402003;1;68.4;58.8;0.0
64;2021-08-02;3839;2241;0;470854;404244;1;68.9;59.2;0.0
64;2021-08-03;4042;2740;0;474896;406984;1;69.5;59.6;0.0
64;2021-08-04;3762;2593;0;478658;409577;1;70.1;60.0;0.0
64;2021-08-05;3676;2265;0;482334;411842;1;70.6;60.3;0.0
64;2021-08-06;3442;2817;0;485776;414659;1;71.1;60.7;0.0
64;2021-08-07;2177;2316;0;487953;416975;1;71.4;61.0;0.0
64;2021-08-08;378;464;0;488331;417439;1;71.5;61.1;0.0
64;2021-08-09;2395;2739;0;490726;420178;1;71.8;61.5;0.0
64;2021-08-10;2955;3084;0;493681;423262;1;72.3;62.0;0.0
64;2021-08-11;2753;2893;0;496434;426155;1;72.7;62.4;0.0
64;2021-08-12;2800;2972;0;499234;429127;1;73.1;62.8;0.0
64;2021-08-13;2298;3360;0;501532;432487;1;73.4;63.3;0.0
64;2021-08-14;1483;2457;0;503015;434944;1;73.6;63.7;0.0
64;2021-08-15;173;552;0;503188;435496;1;73.7;63.7;0.0
64;2021-08-16;1901;3013;0;505089;438509;1;73.9;64.2;0.0
64;2021-08-17;2063;3565;0;507152;442074;1;74.2;64.7;0.0
64;2021-08-18;1807;3266;0;508959;445340;1;74.5;65.2;0.0
64;2021-08-19;1742;3302;0;510701;448642;1;74.8;65.7;0.0
64;2021-08-20;1426;3751;0;512127;452393;1;75.0;66.2;0.0
64;2021-08-21;883;2668;0;513010;455061;1;75.1;66.6;0.0
64;2021-08-22;135;777;0;513145;455838;1;75.1;66.7;0.0
64;2021-08-23;1120;3008;0;514265;458846;1;75.3;67.2;0.0
64;2021-08-24;1276;4307;0;515541;463153;1;75.5;67.8;0.0
64;2021-08-25;1175;3573;0;516716;466726;1;75.6;68.3;0.0
64;2021-08-26;990;3456;0;517706;470182;1;75.8;68.8;0.0
64;2021-08-27;1082;3991;1;518788;474173;2;75.9;69.4;0.0
64;2021-08-28;676;2337;0;519464;476510;2;76.0;69.7;0.0
64;2021-08-29;90;477;0;519554;476987;2;76.1;69.8;0.0
64;2021-08-30;861;3306;84;520415;480293;86;76.2;70.3;0.0
64;2021-08-31;920;3534;179;521335;483827;265;76.3;70.8;0.0
64;2021-09-01;920;2842;275;522255;486669;540;76.4;71.2;0.1
64;2021-09-02;856;2681;413;523111;489350;953;76.6;71.6;0.1
64;2021-09-03;842;2579;436;523953;491929;1389;76.7;72.0;0.2
64;2021-09-04;655;2000;166;524608;493929;1555;76.8;72.3;0.2
64;2021-09-05;68;199;51;524676;494128;1606;76.8;72.3;0.2
64;2021-09-06;509;1996;420;525185;496124;2026;76.9;72.6;0.3
64;2021-09-07;632;1815;456;525817;497939;2482;77.0;72.9;0.4
64;2021-09-08;722;2383;281;526539;500322;2763;77.1;73.2;0.4
64;2021-09-09;463;1567;423;527002;501889;3186;77.1;73.5;0.5
64;2021-09-10;693;1927;398;527695;503816;3584;77.2;73.7;0.5
64;2021-09-11;549;1901;152;528244;505717;3736;77.3;74.0;0.5
64;2021-09-12;60;159;37;528304;505876;3773;77.3;74.0;0.6
64;2021-09-13;444;1259;494;528748;507135;4267;77.4;74.2;0.6
64;2021-09-14;434;1017;915;529182;508152;5182;77.5;74.4;0.8
64;2021-09-15;648;1613;647;529830;509765;5829;77.6;74.6;0.9
64;2021-09-16;464;795;936;530294;510560;6765;77.6;74.7;1.0
64;2021-09-17;526;1224;943;530820;511784;7708;77.7;74.9;1.1
64;2021-09-18;304;1161;211;531124;512945;7919;77.7;75.1;1.2
64;2021-09-19;18;45;13;531142;512990;7932;77.7;75.1;1.2
64;2021-09-20;226;446;567;531368;513436;8499;77.8;75.2;1.2
64;2021-09-21;384;882;954;531752;514318;9453;77.8;75.3;1.4
64;2021-09-22;357;1366;726;532109;515684;10179;77.9;75.5;1.5
64;2021-09-23;243;688;752;532352;516372;10931;77.9;75.6;1.6
64;2021-09-24;379;959;694;532731;517331;11625;78.0;75.7;1.7
64;2021-09-25;283;955;185;533014;518286;11810;78.0;75.9;1.7
64;2021-09-26;6;18;9;533020;518304;11819;78.0;75.9;1.7
64;2021-09-27;213;523;494;533233;518827;12313;78.1;75.9;1.8
64;2021-09-28;255;627;732;533488;519454;13045;78.1;76.0;1.9
64;2021-09-29;327;939;765;533815;520393;13810;78.1;76.2;2.0
64;2021-09-30;220;398;666;534035;520791;14476;78.2;76.2;2.1
64;2021-10-01;344;686;735;534379;521477;15211;78.2;76.3;2.2
64;2021-10-02;228;515;172;534607;521992;15383;78.3;76.4;2.3
64;2021-10-03;7;19;3;534614;522011;15386;78.3;76.4;2.3
64;2021-10-04;292;404;670;534906;522415;16056;78.3;76.5;2.4
64;2021-10-05;247;546;779;535153;522961;16835;78.3;76.5;2.5
64;2021-10-06;411;886;757;535564;523847;17592;78.4;76.7;2.6
64;2021-10-07;203;481;855;535767;524328;18447;78.4;76.7;2.7
64;2021-10-08;338;677;943;536105;525005;19390;78.5;76.8;2.8
64;2021-10-09;217;376;222;536322;525381;19612;78.5;76.9;2.9
64;2021-10-10;3;2;6;536325;525383;19618;78.5;76.9;2.9
64;2021-10-11;144;231;528;536469;525614;20146;78.5;76.9;2.9
64;2021-10-12;216;524;1100;536685;526138;21246;78.6;77.0;3.1
64;2021-10-13;322;545;987;537007;526683;22233;78.6;77.1;3.3
64;2021-10-14;190;266;765;537197;526949;22998;78.6;77.1;3.4
64;2021-10-15;302;507;1126;537499;527456;24124;78.7;77.2;3.5
64;2021-10-16;178;269;282;537677;527725;24406;78.7;77.2;3.6
64;2021-10-17;15;10;9;537692;527735;24415;78.7;77.2;3.6
64;2021-10-18;120;259;603;537812;527994;25018;78.7;77.3;3.7
64;2021-10-19;194;321;1109;538006;528315;26127;78.8;77.3;3.8
64;2021-10-20;324;412;1376;538330;528727;27503;78.8;77.4;4.0
64;2021-10-21;184;268;1347;538514;528995;28850;78.8;77.4;4.2
64;2021-10-22;237;389;1296;538751;529384;30146;78.9;77.5;4.4
64;2021-10-23;174;238;441;538925;529622;30587;78.9;77.5;4.5
64;2021-10-24;3;18;5;538928;529640;30592;78.9;77.5;4.5
64;2021-10-25;130;170;847;539058;529810;31439;78.9;77.6;4.6
64;2021-10-26;223;309;1394;539281;530119;32833;78.9;77.6;4.8
64;2021-10-27;251;386;1552;539532;530505;34385;79.0;77.7;5.0
64;2021-10-28;144;175;1323;539676;530680;35708;79.0;77.7;5.2
64;2021-10-29;233;324;1605;539909;531004;37313;79.0;77.7;5.5
64;2021-10-30;143;210;515;540052;531214;37828;79.1;77.8;5.5
64;2021-10-31;1;7;33;540053;531221;37861;79.1;77.8;5.5
64;2021-11-01;43;37;71;540096;531258;37932;79.1;77.8;5.6
64;2021-11-02;180;288;1479;540276;531546;39411;79.1;77.8;5.8
64;2021-11-03;233;356;1760;540509;531902;41171;79.1;77.9;6.0
64;2021-11-04;154;216;1435;540663;532118;42606;79.1;77.9;6.2
64;2021-11-05;220;326;1920;540883;532444;44526;79.2;77.9;6.5
64;2021-11-06;147;199;664;541030;532643;45190;79.2;78.0;6.6
64;2021-11-07;3;18;12;541033;532661;45202;79.2;78.0;6.6
64;2021-11-08;113;161;1411;541146;532822;46613;79.2;78.0;6.8
64;2021-11-09;183;269;2627;541329;533091;49240;79.2;78.0;7.2
64;2021-11-10;252;333;2365;541581;533424;51605;79.3;78.1;7.6
64;2021-11-11;26;31;144;541607;533455;51749;79.3;78.1;7.6
64;2021-11-12;239;291;2536;541846;533746;54285;79.3;78.1;7.9
64;2021-11-13;138;208;927;541984;533954;55212;79.3;78.2;8.1
64;2021-11-14;3;8;21;541987;533962;55233;79.3;78.2;8.1
64;2021-11-15;116;127;1674;542103;534089;56907;79.4;78.2;8.3
64;2021-11-16;217;258;3066;542320;534347;59973;79.4;78.2;8.8
64;2021-11-17;247;291;2623;542567;534638;62596;79.4;78.3;9.2
64;2021-11-18;186;215;2693;542753;534853;65289;79.4;78.3;9.6
64;2021-11-19;229;284;3028;542982;535137;68317;79.5;78.3;10.0
64;2021-11-20;229;201;951;543211;535338;69268;79.5;78.4;10.1
64;2021-11-21;1;10;19;543212;535348;69287;79.5;78.4;10.1
64;2021-11-22;146;122;2336;543358;535470;71623;79.5;78.4;10.5
64;2021-11-23;255;236;3449;543613;535706;75072;79.6;78.4;11.0
64;2021-11-24;227;253;2936;543840;535959;78008;79.6;78.5;11.4
64;2021-11-25;284;210;4399;544124;536169;82407;79.6;78.5;12.1
64;2021-11-26;234;287;4231;544358;536456;86638;79.7;78.5;12.7
64;2021-11-27;174;210;1954;544532;536666;88592;79.7;78.6;13.0
64;2021-11-28;14;12;466;544546;536678;89058;79.7;78.6;13.0
64;2021-11-29;152;164;4101;544698;536842;93159;79.7;78.6;13.6
64;2021-11-30;221;228;6035;544919;537070;99194;79.8;78.6;14.5
64;2021-12-01;183;264;5298;545102;537334;104492;79.8;78.7;15.3
64;2021-12-02;172;168;6571;545274;537502;111063;79.8;78.7;16.3
64;2021-12-03;196;256;6871;545470;537758;117934;79.8;78.7;17.3
64;2021-12-04;155;189;3510;545625;537947;121444;79.9;78.7;17.8
64;2021-12-05;25;25;1196;545650;537972;122640;79.9;78.7;18.0
64;2021-12-06;152;168;5646;545802;538140;128286;79.9;78.8;18.8
64;2021-12-07;167;232;7708;545969;538372;135994;79.9;78.8;19.9
64;2021-12-08;192;290;7036;546161;538662;143030;79.9;78.8;20.9
64;2021-12-09;218;201;8257;546379;538863;151287;80.0;78.9;22.1
64;2021-12-10;244;275;9240;546623;539138;160527;80.0;78.9;23.5
64;2021-12-11;151;243;4658;546774;539381;165185;80.0;79.0;24.2
64;2021-12-12;26;28;2273;546800;539409;167458;80.0;79.0;24.5
64;2021-12-13;139;194;7140;546939;539603;174598;80.1;79.0;25.6
64;2021-12-14;235;308;10089;547174;539911;184687;80.1;79.0;27.0
64;2021-12-15;240;279;8850;547414;540190;193537;80.1;79.1;28.3
64;2021-12-16;226;296;10476;547640;540486;204013;80.2;79.1;29.9
65;2020-12-27;0;0;0;0;0;0;0.0;0.0;0.0
65;2020-12-28;1;0;0;1;0;0;0.0;0.0;0.0
65;2020-12-29;0;0;0;1;0;0;0.0;0.0;0.0
65;2020-12-30;0;0;0;1;0;0;0.0;0.0;0.0
65;2020-12-31;0;0;0;1;0;0;0.0;0.0;0.0
65;2021-01-01;0;0;0;1;0;0;0.0;0.0;0.0
65;2021-01-02;0;0;0;1;0;0;0.0;0.0;0.0
65;2021-01-03;0;0;0;1;0;0;0.0;0.0;0.0
65;2021-01-04;0;0;0;1;0;0;0.0;0.0;0.0
65;2021-01-05;0;0;0;1;0;0;0.0;0.0;0.0
65;2021-01-06;8;0;0;9;0;0;0.0;0.0;0.0
65;2021-01-07;124;0;0;133;0;0;0.1;0.0;0.0
65;2021-01-08;183;1;0;316;1;0;0.1;0.0;0.0
65;2021-01-09;175;2;0;491;3;0;0.2;0.0;0.0
65;2021-01-10;1;0;0;492;3;0;0.2;0.0;0.0
65;2021-01-11;250;3;0;742;6;0;0.3;0.0;0.0
65;2021-01-12;260;2;0;1002;8;0;0.4;0.0;0.0
65;2021-01-13;563;1;0;1565;9;0;0.7;0.0;0.0
65;2021-01-14;556;9;0;2121;18;0;0.9;0.0;0.0
65;2021-01-15;490;2;0;2611;20;0;1.2;0.0;0.0
65;2021-01-16;206;3;0;2817;23;0;1.2;0.0;0.0
65;2021-01-17;0;0;0;2817;23;0;1.2;0.0;0.0
65;2021-01-18;542;5;0;3359;28;0;1.5;0.0;0.0
65;2021-01-19;543;2;0;3902;30;0;1.7;0.0;0.0
65;2021-01-20;572;5;0;4474;35;0;2.0;0.0;0.0
65;2021-01-21;548;1;0;5022;36;0;2.2;0.0;0.0
65;2021-01-22;573;2;0;5595;38;0;2.5;0.0;0.0
65;2021-01-23;176;1;0;5771;39;0;2.5;0.0;0.0
65;2021-01-24;3;1;0;5774;40;0;2.5;0.0;0.0
65;2021-01-25;537;5;0;6311;45;0;2.8;0.0;0.0
65;2021-01-26;808;2;0;7119;47;0;3.1;0.0;0.0
65;2021-01-27;564;8;0;7683;55;0;3.4;0.0;0.0
65;2021-01-28;479;35;0;8162;90;0;3.6;0.0;0.0
65;2021-01-29;404;67;0;8566;157;0;3.8;0.1;0.0
65;2021-01-30;175;67;0;8741;224;0;3.9;0.1;0.0
65;2021-01-31;16;0;0;8757;224;0;3.9;0.1;0.0
65;2021-02-01;316;98;0;9073;322;0;4.0;0.1;0.0
65;2021-02-02;347;182;0;9420;504;0;4.2;0.2;0.0
65;2021-02-03;438;240;0;9858;744;0;4.3;0.3;0.0
65;2021-02-04;287;297;0;10145;1041;0;4.5;0.5;0.0
65;2021-02-05;254;341;0;10399;1382;0;4.6;0.6;0.0
65;2021-02-06;93;97;0;10492;1479;0;4.6;0.7;0.0
65;2021-02-07;11;0;0;10503;1479;0;4.6;0.7;0.0
65;2021-02-08;373;207;0;10876;1686;0;4.8;0.7;0.0
65;2021-02-09;262;359;0;11138;2045;0;4.9;0.9;0.0
65;2021-02-10;284;273;0;11422;2318;0;5.0;1.0;0.0
65;2021-02-11;304;261;0;11726;2579;0;5.2;1.1;0.0
65;2021-02-12;261;214;0;11987;2793;0;5.3;1.2;0.0
65;2021-02-13;118;93;0;12105;2886;0;5.3;1.3;0.0
65;2021-02-14;2;17;0;12107;2903;0;5.3;1.3;0.0
65;2021-02-15;190;389;0;12297;3292;0;5.4;1.5;0.0
65;2021-02-16;440;553;0;12737;3845;0;5.6;1.7;0.0
65;2021-02-17;211;496;0;12948;4341;0;5.7;1.9;0.0
65;2021-02-18;268;563;0;13216;4904;0;5.8;2.2;0.0
65;2021-02-19;142;453;0;13358;5357;0;5.9;2.4;0.0
65;2021-02-20;54;153;0;13412;5510;0;5.9;2.4;0.0
65;2021-02-21;2;45;0;13414;5555;0;5.9;2.4;0.0
65;2021-02-22;162;519;0;13576;6074;0;6.0;2.7;0.0
65;2021-02-23;213;513;0;13789;6587;0;6.1;2.9;0.0
65;2021-02-24;209;601;0;13998;7188;0;6.2;3.2;0.0
65;2021-02-25;232;195;0;14230;7383;0;6.3;3.3;0.0
65;2021-02-26;323;725;0;14553;8108;0;6.4;3.6;0.0
65;2021-02-27;104;199;0;14657;8307;0;6.5;3.7;0.0
65;2021-02-28;1;0;0;14658;8307;0;6.5;3.7;0.0
65;2021-03-01;367;352;0;15025;8659;0;6.6;3.8;0.0
65;2021-03-02;407;339;0;15432;8998;0;6.8;4.0;0.0
65;2021-03-03;371;382;0;15803;9380;0;7.0;4.1;0.0
65;2021-03-04;638;311;0;16441;9691;0;7.2;4.3;0.0
65;2021-03-05;672;275;0;17113;9966;0;7.5;4.4;0.0
65;2021-03-06;1140;87;0;18253;10053;0;8.0;4.4;0.0
65;2021-03-07;240;12;0;18493;10065;0;8.2;4.4;0.0
65;2021-03-08;385;330;0;18878;10395;0;8.3;4.6;0.0
65;2021-03-09;599;294;0;19477;10689;0;8.6;4.7;0.0
65;2021-03-10;583;353;0;20060;11042;0;8.8;4.9;0.0
65;2021-03-11;747;337;0;20807;11379;0;9.2;5.0;0.0
65;2021-03-12;1016;192;0;21823;11571;0;9.6;5.1;0.0
65;2021-03-13;347;86;0;22170;11657;0;9.8;5.1;0.0
65;2021-03-14;5;31;0;22175;11688;0;9.8;5.2;0.0
65;2021-03-15;765;174;0;22940;11862;0;10.1;5.2;0.0
65;2021-03-16;677;216;0;23617;12078;0;10.4;5.3;0.0
65;2021-03-17;663;183;0;24280;12261;0;10.7;5.4;0.0
65;2021-03-18;504;227;0;24784;12488;0;10.9;5.5;0.0
65;2021-03-19;814;148;0;25598;12636;0;11.3;5.6;0.0
65;2021-03-20;248;47;0;25846;12683;0;11.4;5.6;0.0
65;2021-03-21;11;1;0;25857;12684;0;11.4;5.6;0.0
65;2021-03-22;684;149;0;26541;12833;0;11.7;5.7;0.0
65;2021-03-23;821;345;0;27362;13178;0;12.1;5.8;0.0
65;2021-03-24;824;244;0;28186;13422;0;12.4;5.9;0.0
65;2021-03-25;1196;178;0;29382;13600;0;13.0;6.0;0.0
65;2021-03-26;1211;134;0;30593;13734;0;13.5;6.1;0.0
65;2021-03-27;1231;89;0;31824;13823;0;14.0;6.1;0.0
65;2021-03-28;5;2;0;31829;13825;0;14.0;6.1;0.0
65;2021-03-29;1390;328;0;33219;14153;0;14.6;6.2;0.0
65;2021-03-30;1261;350;0;34480;14503;0;15.2;6.4;0.0
65;2021-03-31;1082;349;0;35562;14852;0;15.7;6.5;0.0
65;2021-04-01;1361;371;0;36923;15223;0;16.3;6.7;0.0
65;2021-04-02;1503;277;0;38426;15500;0;16.9;6.8;0.0
65;2021-04-03;228;47;0;38654;15547;0;17.0;6.9;0.0
65;2021-04-04;7;2;0;38661;15549;0;17.0;6.9;0.0
65;2021-04-05;155;46;0;38816;15595;0;17.1;6.9;0.0
65;2021-04-06;1129;455;0;39945;16050;0;17.6;7.1;0.0
65;2021-04-07;1539;412;0;41484;16462;0;18.3;7.3;0.0
65;2021-04-08;1466;382;0;42950;16844;0;18.9;7.4;0.0
65;2021-04-09;1470;440;0;44420;17284;0;19.6;7.6;0.0
65;2021-04-10;1412;146;0;45832;17430;0;20.2;7.7;0.0
65;2021-04-11;8;5;0;45840;17435;0;20.2;7.7;0.0
65;2021-04-12;1215;689;0;47055;18124;0;20.7;8.0;0.0
65;2021-04-13;1418;570;0;48473;18694;0;21.4;8.2;0.0
65;2021-04-14;1731;696;0;50204;19390;0;22.1;8.5;0.0
65;2021-04-15;1539;664;0;51743;20054;0;22.8;8.8;0.0
65;2021-04-16;1618;494;0;53361;20548;0;23.5;9.1;0.0
65;2021-04-17;1832;129;0;55193;20677;0;24.3;9.1;0.0
65;2021-04-18;11;32;0;55204;20709;0;24.3;9.1;0.0
65;2021-04-19;1205;711;0;56409;21420;0;24.9;9.4;0.0
65;2021-04-20;1398;677;0;57807;22097;0;25.5;9.7;0.0
65;2021-04-21;981;960;0;58788;23057;0;25.9;10.2;0.0
65;2021-04-22;1478;705;0;60266;23762;0;26.6;10.5;0.0
65;2021-04-23;1055;1019;0;61321;24781;0;27.0;10.9;0.0
65;2021-04-24;1151;551;0;62472;25332;0;27.5;11.2;0.0
65;2021-04-25;37;17;0;62509;25349;0;27.6;11.2;0.0
65;2021-04-26;1451;1151;0;63960;26500;0;28.2;11.7;0.0
65;2021-04-27;1324;1179;0;65284;27679;0;28.8;12.2;0.0
65;2021-04-28;1630;897;0;66914;28576;0;29.5;12.6;0.0
65;2021-04-29;1748;966;0;68662;29542;0;30.3;13.0;0.0
65;2021-04-30;1569;856;0;70231;30398;0;31.0;13.4;0.0
65;2021-05-01;1437;227;0;71668;30625;0;31.6;13.5;0.0
65;2021-05-02;608;24;0;72276;30649;0;31.9;13.5;0.0
65;2021-05-03;1160;1293;0;73436;31942;0;32.4;14.1;0.0
65;2021-05-04;1384;1102;0;74820;33044;0;33.0;14.6;0.0
65;2021-05-05;1187;1496;0;76007;34540;0;33.5;15.2;0.0
65;2021-05-06;1310;1096;0;77317;35636;0;34.1;15.7;0.0
65;2021-05-07;1103;1411;0;78420;37047;0;34.6;16.3;0.0
65;2021-05-08;1481;404;0;79901;37451;0;35.2;16.5;0.0
65;2021-05-09;11;92;0;79912;37543;0;35.2;16.6;0.0
65;2021-05-10;854;1661;0;80766;39204;0;35.6;17.3;0.0
65;2021-05-11;911;1647;0;81677;40851;0;36.0;18.0;0.0
65;2021-05-12;1043;1473;0;82720;42324;0;36.5;18.7;0.0
65;2021-05-13;1025;141;0;83745;42465;0;36.9;18.7;0.0
65;2021-05-14;1293;945;0;85038;43410;0;37.5;19.1;0.0
65;2021-05-15;1100;427;0;86138;43837;0;38.0;19.3;0.0
65;2021-05-16;1156;62;0;87294;43899;0;38.5;19.4;0.0
65;2021-05-17;954;1387;0;88248;45286;0;38.9;20.0;0.0
65;2021-05-18;1388;1054;0;89636;46340;0;39.5;20.4;0.0
65;2021-05-19;1429;913;0;91065;47253;0;40.1;20.8;0.0
65;2021-05-20;1581;909;0;92646;48162;0;40.8;21.2;0.0
65;2021-05-21;1455;949;0;94101;49111;0;41.5;21.7;0.0
65;2021-05-22;1099;614;0;95200;49725;0;42.0;21.9;0.0
65;2021-05-23;342;13;0;95542;49738;0;42.1;21.9;0.0
65;2021-05-24;530;71;0;96072;49809;0;42.4;22.0;0.0
65;2021-05-25;1209;1350;0;97281;51159;0;42.9;22.6;0.0
65;2021-05-26;1235;1241;0;98516;52400;0;43.4;23.1;0.0
65;2021-05-27;1228;1342;0;99744;53742;0;44.0;23.7;0.0
65;2021-05-28;1208;1544;0;100952;55286;0;44.5;24.4;0.0
65;2021-05-29;821;1346;0;101773;56632;0;44.9;25.0;0.0
65;2021-05-30;20;10;0;101793;56642;0;44.9;25.0;0.0
65;2021-05-31;1065;1205;0;102858;57847;0;45.3;25.5;0.0
65;2021-06-01;1417;926;0;104275;58773;0;46.0;25.9;0.0
65;2021-06-02;1241;986;0;105516;59759;0;46.5;26.3;0.0
65;2021-06-03;1116;1055;0;106632;60814;0;47.0;26.8;0.0
65;2021-06-04;1332;1439;0;107964;62253;0;47.6;27.4;0.0
65;2021-06-05;360;1134;0;108324;63387;0;47.8;27.9;0.0
65;2021-06-06;47;21;0;108371;63408;0;47.8;28.0;0.0
65;2021-06-07;621;1810;0;108992;65218;0;48.0;28.8;0.0
65;2021-06-08;843;1418;0;109835;66636;0;48.4;29.4;0.0
65;2021-06-09;780;1493;0;110615;68129;0;48.8;30.0;0.0
65;2021-06-10;764;1081;0;111379;69210;0;49.1;30.5;0.0
65;2021-06-11;833;1629;0;112212;70839;0;49.5;31.2;0.0
65;2021-06-12;187;603;0;112399;71442;0;49.6;31.5;0.0
65;2021-06-13;42;6;0;112441;71448;0;49.6;31.5;0.0
65;2021-06-14;504;2092;0;112945;73540;0;49.8;32.4;0.0
65;2021-06-15;902;1650;0;113847;75190;0;50.2;33.1;0.0
65;2021-06-16;1026;1253;0;114873;76443;0;50.6;33.7;0.0
65;2021-06-17;743;937;0;115616;77380;0;51.0;34.1;0.0
65;2021-06-18;954;1478;0;116570;78858;0;51.4;34.8;0.0
65;2021-06-19;629;1543;0;117199;80401;0;51.7;35.4;0.0
65;2021-06-20;14;9;0;117213;80410;0;51.7;35.4;0.0
65;2021-06-21;680;1684;0;117893;82094;0;52.0;36.2;0.0
65;2021-06-22;959;1316;0;118852;83410;0;52.4;36.8;0.0
65;2021-06-23;948;1098;0;119800;84508;0;52.8;37.3;0.0
65;2021-06-24;901;906;0;120701;85414;0;53.2;37.7;0.0
65;2021-06-25;804;1632;0;121505;87046;0;53.6;38.4;0.0
65;2021-06-26;175;1308;0;121680;88354;0;53.6;39.0;0.0
65;2021-06-27;24;903;0;121704;89257;0;53.7;39.3;0.0
65;2021-06-28;408;1906;0;122112;91163;0;53.8;40.2;0.0
65;2021-06-29;626;1694;0;122738;92857;0;54.1;40.9;0.0
65;2021-06-30;827;1481;0;123565;94338;0;54.5;41.6;0.0
65;2021-07-01;565;742;0;124130;95080;0;54.7;41.9;0.0
65;2021-07-02;1023;1500;0;125153;96580;0;55.2;42.6;0.0
65;2021-07-03;198;1469;0;125351;98049;0;55.3;43.2;0.0
65;2021-07-04;341;161;0;125692;98210;0;55.4;43.3;0.0
65;2021-07-05;516;1747;0;126208;99957;0;55.6;44.1;0.0
65;2021-07-06;722;1737;0;126930;101694;0;56.0;44.8;0.0
65;2021-07-07;802;1337;0;127732;103031;0;56.3;45.4;0.0
65;2021-07-08;368;648;0;128100;103679;0;56.5;45.7;0.0
65;2021-07-09;518;1388;0;128618;105067;0;56.7;46.3;0.0
65;2021-07-10;277;745;0;128895;105812;0;56.8;46.6;0.0
65;2021-07-11;14;15;0;128909;105827;0;56.8;46.7;0.0
65;2021-07-12;435;1794;0;129344;107621;0;57.0;47.4;0.0
65;2021-07-13;692;1766;0;130036;109387;0;57.3;48.2;0.0
65;2021-07-14;169;90;0;130205;109477;0;57.4;48.3;0.0
65;2021-07-15;1040;1462;0;131245;110939;0;57.9;48.9;0.0
65;2021-07-16;1127;1650;0;132372;112589;0;58.4;49.6;0.0
65;2021-07-17;418;453;0;132790;113042;0;58.5;49.8;0.0
65;2021-07-18;49;60;0;132839;113102;0;58.6;49.9;0.0
65;2021-07-19;731;1374;0;133570;114476;0;58.9;50.5;0.0
65;2021-07-20;1306;1550;0;134876;116026;0;59.5;51.1;0.0
65;2021-07-21;1301;1519;0;136177;117545;0;60.0;51.8;0.0
65;2021-07-22;1860;1151;0;138037;118696;0;60.9;52.3;0.0
65;2021-07-23;1527;1654;0;139564;120350;0;61.5;53.1;0.0
65;2021-07-24;1011;629;0;140575;120979;0;62.0;53.3;0.0
65;2021-07-25;86;60;0;140661;121039;0;62.0;53.4;0.0
65;2021-07-26;1105;1091;0;141766;122130;0;62.5;53.8;0.0
65;2021-07-27;1673;1698;0;143439;123828;0;63.2;54.6;0.0
65;2021-07-28;1477;1191;0;144916;125019;0;63.9;55.1;0.0
65;2021-07-29;2548;1061;0;147464;126080;0;65.0;55.6;0.0
65;2021-07-30;2177;1277;0;149641;127357;0;66.0;56.1;0.0
65;2021-07-31;1886;336;0;151527;127693;0;66.8;56.3;0.0
65;2021-08-01;52;29;0;151579;127722;0;66.8;56.3;0.0
65;2021-08-02;952;739;0;152531;128461;0;67.2;56.6;0.0
65;2021-08-03;1759;902;0;154290;129363;0;68.0;57.0;0.0
65;2021-08-04;1534;560;0;155824;129923;0;68.7;57.3;0.0
65;2021-08-05;1591;720;0;157415;130643;0;69.4;57.6;0.0
65;2021-08-06;1466;840;0;158881;131483;0;70.0;58.0;0.0
65;2021-08-07;646;464;0;159527;131947;0;70.3;58.2;0.0
65;2021-08-08;28;27;0;159555;131974;0;70.3;58.2;0.0
65;2021-08-09;647;949;0;160202;132923;0;70.6;58.6;0.0
65;2021-08-10;1039;1349;0;161241;134272;0;71.1;59.2;0.0
65;2021-08-11;670;1109;0;161911;135381;0;71.4;59.7;0.0
65;2021-08-12;718;1013;0;162629;136394;0;71.7;60.1;0.0
65;2021-08-13;423;882;0;163052;137276;0;71.9;60.5;0.0
65;2021-08-14;520;534;0;163572;137810;0;72.1;60.8;0.0
65;2021-08-15;15;42;0;163587;137852;0;72.1;60.8;0.0
65;2021-08-16;351;1414;0;163938;139266;0;72.3;61.4;0.0
65;2021-08-17;671;1971;0;164609;141237;0;72.6;62.3;0.0
65;2021-08-18;588;1441;0;165197;142678;0;72.8;62.9;0.0
65;2021-08-19;625;1165;0;165822;143843;0;73.1;63.4;0.0
65;2021-08-20;377;1202;0;166199;145045;0;73.3;63.9;0.0
65;2021-08-21;83;210;0;166282;145255;0;73.3;64.0;0.0
65;2021-08-22;13;41;0;166295;145296;0;73.3;64.1;0.0
65;2021-08-23;273;1556;0;166568;146852;0;73.4;64.7;0.0
65;2021-08-24;532;2191;0;167100;149043;0;73.7;65.7;0.0
65;2021-08-25;399;1756;0;167499;150799;0;73.8;66.5;0.0
65;2021-08-26;417;2029;0;167916;152828;0;74.0;67.4;0.0
65;2021-08-27;413;1768;0;168329;154596;0;74.2;68.2;0.0
65;2021-08-28;147;253;0;168476;154849;0;74.3;68.3;0.0
65;2021-08-29;9;26;0;168485;154875;0;74.3;68.3;0.0
65;2021-08-30;252;947;25;168737;155822;25;74.4;68.7;0.0
65;2021-08-31;406;1376;86;169143;157198;111;74.6;69.3;0.0
65;2021-09-01;452;1019;83;169595;158217;194;74.8;69.7;0.1
65;2021-09-02;347;803;125;169942;159020;319;74.9;70.1;0.1
65;2021-09-03;424;952;132;170366;159972;451;75.1;70.5;0.2
65;2021-09-04;172;757;63;170538;160729;514;75.2;70.9;0.2
65;2021-09-05;22;22;23;170560;160751;537;75.2;70.9;0.2
65;2021-09-06;261;499;285;170821;161250;822;75.3;71.1;0.4
65;2021-09-07;291;729;369;171112;161979;1191;75.4;71.4;0.5
65;2021-09-08;327;662;236;171439;162641;1427;75.6;71.7;0.6
65;2021-09-09;227;556;191;171666;163197;1618;75.7;71.9;0.7
65;2021-09-10;354;694;192;172020;163891;1810;75.8;72.2;0.8
65;2021-09-11;67;165;26;172087;164056;1836;75.9;72.3;0.8
65;2021-09-12;8;12;0;172095;164068;1836;75.9;72.3;0.8
65;2021-09-13;192;311;193;172287;164379;2029;76.0;72.5;0.9
65;2021-09-14;172;321;261;172459;164700;2290;76.0;72.6;1.0
65;2021-09-15;235;584;331;172694;165284;2621;76.1;72.9;1.2
65;2021-09-16;147;222;224;172841;165506;2845;76.2;73.0;1.3
65;2021-09-17;254;495;370;173095;166001;3215;76.3;73.2;1.4
65;2021-09-18;91;253;83;173186;166254;3298;76.3;73.3;1.5
65;2021-09-19;3;15;4;173189;166269;3302;76.3;73.3;1.5
65;2021-09-20;103;223;242;173292;166492;3544;76.4;73.4;1.6
65;2021-09-21;110;250;246;173402;166742;3790;76.4;73.5;1.7
65;2021-09-22;143;601;334;173545;167343;4124;76.5;73.8;1.8
65;2021-09-23;60;169;245;173605;167512;4369;76.5;73.8;1.9
65;2021-09-24;158;506;284;173763;168018;4653;76.6;74.1;2.1
65;2021-09-25;78;213;40;173841;168231;4693;76.6;74.2;2.1
65;2021-09-26;2;4;9;173843;168235;4702;76.6;74.2;2.1
65;2021-09-27;55;236;179;173898;168471;4881;76.7;74.3;2.2
65;2021-09-28;85;268;340;173983;168739;5221;76.7;74.4;2.3
65;2021-09-29;140;386;282;174123;169125;5503;76.8;74.6;2.4
65;2021-09-30;47;134;158;174170;169259;5661;76.8;74.6;2.5
65;2021-10-01;179;354;324;174349;169613;5985;76.9;74.8;2.6
65;2021-10-02;26;71;10;174375;169684;5995;76.9;74.8;2.6
65;2021-10-03;0;9;0;174375;169693;5995;76.9;74.8;2.6
65;2021-10-04;123;236;270;174498;169929;6265;76.9;74.9;2.8
65;2021-10-05;67;170;237;174565;170099;6502;77.0;75.0;2.9
65;2021-10-06;151;320;334;174716;170419;6836;77.0;75.1;3.0
65;2021-10-07;69;148;191;174785;170567;7027;77.1;75.2;3.1
65;2021-10-08;180;374;361;174965;170941;7388;77.1;75.4;3.3
65;2021-10-09;32;42;36;174997;170983;7424;77.1;75.4;3.3
65;2021-10-10;4;4;1;175001;170987;7425;77.1;75.4;3.3
65;2021-10-11;93;183;344;175094;171170;7769;77.2;75.5;3.4
65;2021-10-12;48;111;313;175142;171281;8082;77.2;75.5;3.6
65;2021-10-13;124;214;337;175266;171495;8419;77.3;75.6;3.7
65;2021-10-14;45;100;120;175311;171595;8539;77.3;75.6;3.8
65;2021-10-15;172;221;577;175483;171816;9116;77.4;75.7;4.0
65;2021-10-16;32;22;12;175515;171838;9128;77.4;75.8;4.0
65;2021-10-17;1;2;2;175516;171840;9130;77.4;75.8;4.0
65;2021-10-18;91;113;319;175607;171953;9449;77.4;75.8;4.2
65;2021-10-19;53;62;243;175660;172015;9692;77.4;75.8;4.3
65;2021-10-20;107;153;504;175767;172168;10196;77.5;75.9;4.5
65;2021-10-21;39;54;110;175806;172222;10306;77.5;75.9;4.5
65;2021-10-22;121;197;600;175927;172419;10906;77.6;76.0;4.8
65;2021-10-23;12;29;34;175939;172448;10940;77.6;76.0;4.8
65;2021-10-24;1;7;6;175940;172455;10946;77.6;76.0;4.8
65;2021-10-25;95;134;496;176035;172589;11442;77.6;76.1;5.0
65;2021-10-26;33;45;261;176068;172634;11703;77.6;76.1;5.2
65;2021-10-27;96;143;526;176164;172777;12229;77.7;76.2;5.4
65;2021-10-28;25;34;173;176189;172811;12402;77.7;76.2;5.5
65;2021-10-29;98;217;592;176287;173028;12994;77.7;76.3;5.7
65;2021-10-30;20;33;19;176307;173061;13013;77.7;76.3;5.7
65;2021-10-31;0;1;0;176307;173062;13013;77.7;76.3;5.7
65;2021-11-01;7;12;1;176314;173074;13014;77.7;76.3;5.7
65;2021-11-02;35;63;298;176349;173137;13312;77.7;76.3;5.9
65;2021-11-03;114;168;744;176463;173305;14056;77.8;76.4;6.2
65;2021-11-04;37;42;343;176500;173347;14399;77.8;76.4;6.3
65;2021-11-05;102;163;759;176602;173510;15158;77.9;76.5;6.7
65;2021-11-06;21;36;101;176623;173546;15259;77.9;76.5;6.7
65;2021-11-07;1;5;1;176624;173551;15260;77.9;76.5;6.7
65;2021-11-08;53;97;707;176677;173648;15967;77.9;76.6;7.0
65;2021-11-09;36;57;509;176713;173705;16476;77.9;76.6;7.3
65;2021-11-10;95;118;964;176808;173823;17440;77.9;76.6;7.7
65;2021-11-11;0;4;22;176808;173827;17462;77.9;76.6;7.7
65;2021-11-12;94;146;1269;176902;173973;18731;78.0;76.7;8.3
65;2021-11-13;8;13;66;176910;173986;18797;78.0;76.7;8.3
65;2021-11-14;0;5;4;176910;173991;18801;78.0;76.7;8.3
65;2021-11-15;50;99;813;176960;174090;19614;78.0;76.7;8.6
65;2021-11-16;59;58;837;177019;174148;20451;78.0;76.8;9.0
65;2021-11-17;80;131;1096;177099;174279;21547;78.1;76.8;9.5
65;2021-11-18;57;47;630;177156;174326;22177;78.1;76.9;9.8
65;2021-11-19;98;126;1357;177254;174452;23534;78.1;76.9;10.4
65;2021-11-20;20;20;159;177274;174472;23693;78.1;76.9;10.4
65;2021-11-21;2;3;7;177276;174475;23700;78.2;76.9;10.4
65;2021-11-22;52;51;971;177328;174526;24671;78.2;76.9;10.9
65;2021-11-23;69;51;1250;177397;174577;25921;78.2;77.0;11.4
65;2021-11-24;97;105;1284;177494;174682;27205;78.2;77.0;12.0
65;2021-11-25;73;40;1051;177567;174722;28256;78.3;77.0;12.5
65;2021-11-26;116;126;2192;177683;174848;30448;78.3;77.1;13.4
65;2021-11-27;42;25;1115;177725;174873;31563;78.3;77.1;13.9
65;2021-11-28;24;15;562;177749;174888;32125;78.4;77.1;14.2
65;2021-11-29;51;73;1560;177800;174961;33685;78.4;77.1;14.8
65;2021-11-30;114;70;2424;177914;175031;36109;78.4;77.2;15.9
65;2021-12-01;89;125;2402;178003;175156;38511;78.5;77.2;17.0
65;2021-12-02;93;67;2522;178096;175223;41033;78.5;77.2;18.1
65;2021-12-03;91;109;2778;178187;175332;43811;78.6;77.3;19.3
65;2021-12-04;40;35;1152;178227;175367;44963;78.6;77.3;19.8
65;2021-12-05;2;10;685;178229;175377;45648;78.6;77.3;20.1
65;2021-12-06;57;61;1975;178286;175438;47623;78.6;77.3;21.0
65;2021-12-07;74;63;2734;178360;175501;50357;78.6;77.4;22.2
65;2021-12-08;85;116;2560;178445;175617;52917;78.7;77.4;23.3
65;2021-12-09;62;59;2867;178507;175676;55784;78.7;77.4;24.6
65;2021-12-10;84;102;3044;178591;175778;58828;78.7;77.5;25.9
65;2021-12-11;57;33;1404;178648;175811;60232;78.8;77.5;26.6
65;2021-12-12;6;8;819;178654;175819;61051;78.8;77.5;26.9
65;2021-12-13;62;55;2186;178716;175874;63237;78.8;77.5;27.9
65;2021-12-14;89;105;2923;178805;175979;66160;78.8;77.6;29.2
65;2021-12-15;87;104;3147;178892;176083;69307;78.9;77.6;30.6
65;2021-12-16;87;71;3246;178979;176154;72553;78.9;77.7;32.0
66;2020-12-27;0;0;0;0;0;0;0.0;0.0;0.0
66;2020-12-28;3;0;0;3;0;0;0.0;0.0;0.0
66;2020-12-29;1;0;0;4;0;0;0.0;0.0;0.0
66;2020-12-30;0;0;0;4;0;0;0.0;0.0;0.0
66;2020-12-31;2;0;0;6;0;0;0.0;0.0;0.0
66;2021-01-01;1;0;0;7;0;0;0.0;0.0;0.0
66;2021-01-02;0;0;0;7;0;0;0.0;0.0;0.0
66;2021-01-03;0;0;0;7;0;0;0.0;0.0;0.0
66;2021-01-04;31;0;0;38;0;0;0.0;0.0;0.0
66;2021-01-05;134;0;0;172;0;0;0.0;0.0;0.0
66;2021-01-06;184;0;0;356;0;0;0.1;0.0;0.0
66;2021-01-07;169;0;0;525;0;0;0.1;0.0;0.0
66;2021-01-08;212;0;0;737;0;0;0.2;0.0;0.0
66;2021-01-09;227;0;0;964;0;0;0.2;0.0;0.0
66;2021-01-10;9;0;0;973;0;0;0.2;0.0;0.0
66;2021-01-11;387;2;0;1360;2;0;0.3;0.0;0.0
66;2021-01-12;547;2;0;1907;4;0;0.4;0.0;0.0
66;2021-01-13;850;9;0;2757;13;0;0.6;0.0;0.0
66;2021-01-14;855;12;0;3612;25;0;0.8;0.0;0.0
66;2021-01-15;582;1;0;4194;26;0;0.9;0.0;0.0
66;2021-01-16;114;3;0;4308;29;0;0.9;0.0;0.0
66;2021-01-17;46;1;0;4354;30;0;0.9;0.0;0.0
66;2021-01-18;616;3;0;4970;33;0;1.0;0.0;0.0
66;2021-01-19;706;4;0;5676;37;0;1.2;0.0;0.0
66;2021-01-20;1129;6;0;6805;43;0;1.4;0.0;0.0
66;2021-01-21;2300;7;0;9105;50;0;1.9;0.0;0.0
66;2021-01-22;1365;8;0;10470;58;0;2.2;0.0;0.0
66;2021-01-23;388;4;0;10858;62;0;2.3;0.0;0.0
66;2021-01-24;216;9;0;11074;71;0;2.3;0.0;0.0
66;2021-01-25;691;44;0;11765;115;0;2.5;0.0;0.0
66;2021-01-26;786;63;0;12551;178;0;2.6;0.0;0.0
66;2021-01-27;835;95;0;13386;273;0;2.8;0.1;0.0
66;2021-01-28;836;120;0;14222;393;0;3.0;0.1;0.0
66;2021-01-29;786;125;0;15008;518;0;3.1;0.1;0.0
66;2021-01-30;455;85;0;15463;603;0;3.2;0.1;0.0
66;2021-01-31;197;25;0;15660;628;0;3.3;0.1;0.0
66;2021-02-01;544;185;0;16204;813;0;3.4;0.2;0.0
66;2021-02-02;619;276;0;16823;1089;0;3.5;0.2;0.0
66;2021-02-03;713;578;0;17536;1667;0;3.7;0.3;0.0
66;2021-02-04;686;601;0;18222;2268;0;3.8;0.5;0.0
66;2021-02-05;758;411;0;18980;2679;0;4.0;0.6;0.0
66;2021-02-06;400;142;0;19380;2821;0;4.0;0.6;0.0
66;2021-02-07;165;138;0;19545;2959;0;4.1;0.6;0.0
66;2021-02-08;486;366;0;20031;3325;0;4.2;0.7;0.0
66;2021-02-09;512;392;0;20543;3717;0;4.3;0.8;0.0
66;2021-02-10;595;756;0;21138;4473;0;4.4;0.9;0.0
66;2021-02-11;1072;1517;0;22210;5990;0;4.6;1.3;0.0
66;2021-02-12;1079;1131;0;23289;7121;0;4.9;1.5;0.0
66;2021-02-13;345;299;0;23634;7420;0;4.9;1.5;0.0
66;2021-02-14;106;191;0;23740;7611;0;5.0;1.6;0.0
66;2021-02-15;421;680;0;24161;8291;0;5.0;1.7;0.0
66;2021-02-16;311;778;0;24472;9069;0;5.1;1.9;0.0
66;2021-02-17;360;669;0;24832;9738;0;5.2;2.0;0.0
66;2021-02-18;371;748;0;25203;10486;0;5.3;2.2;0.0
66;2021-02-19;386;681;0;25589;11167;0;5.3;2.3;0.0
66;2021-02-20;172;388;0;25761;11555;0;5.4;2.4;0.0
66;2021-02-21;34;162;0;25795;11717;0;5.4;2.4;0.0
66;2021-02-22;405;598;0;26200;12315;0;5.5;2.6;0.0
66;2021-02-23;504;651;0;26704;12966;0;5.6;2.7;0.0
66;2021-02-24;355;733;0;27059;13699;0;5.6;2.9;0.0
66;2021-02-25;706;687;0;27765;14386;0;5.8;3.0;0.0
66;2021-02-26;934;740;0;28699;15126;0;6.0;3.2;0.0
66;2021-02-27;359;407;0;29058;15533;0;6.1;3.2;0.0
66;2021-02-28;59;167;0;29117;15700;0;6.1;3.3;0.0
66;2021-03-01;346;613;0;29463;16313;0;6.2;3.4;0.0
66;2021-03-02;329;651;0;29792;16964;0;6.2;3.5;0.0
66;2021-03-03;524;613;0;30316;17577;0;6.3;3.7;0.0
66;2021-03-04;989;1042;0;31305;18619;0;6.5;3.9;0.0
66;2021-03-05;1506;782;0;32811;19401;0;6.8;4.1;0.0
66;2021-03-06;1126;331;0;33937;19732;0;7.1;4.1;0.0
66;2021-03-07;1028;96;0;34965;19828;0;7.3;4.1;0.0
66;2021-03-08;663;524;0;35628;20352;0;7.4;4.2;0.0
66;2021-03-09;1189;582;0;36817;20934;0;7.7;4.4;0.0
66;2021-03-10;1271;502;0;38088;21436;0;8.0;4.5;0.0
66;2021-03-11;1462;572;0;39550;22008;0;8.3;4.6;0.0
66;2021-03-12;2339;560;0;41889;22568;0;8.7;4.7;0.0
66;2021-03-13;1072;297;0;42961;22865;0;9.0;4.8;0.0
66;2021-03-14;194;83;0;43155;22948;0;9.0;4.8;0.0
66;2021-03-15;1050;394;0;44205;23342;0;9.2;4.9;0.0
66;2021-03-16;928;266;0;45133;23608;0;9.4;4.9;0.0
66;2021-03-17;855;381;0;45988;23989;0;9.6;5.0;0.0
66;2021-03-18;946;328;0;46934;24317;0;9.8;5.1;0.0
66;2021-03-19;1244;317;0;48178;24634;0;10.1;5.1;0.0
66;2021-03-20;812;118;0;48990;24752;0;10.2;5.2;0.0
66;2021-03-21;186;40;0;49176;24792;0;10.3;5.2;0.0
66;2021-03-22;1088;388;0;50264;25180;0;10.5;5.3;0.0
66;2021-03-23;1717;385;0;51981;25565;0;10.9;5.3;0.0
66;2021-03-24;1772;507;0;53753;26072;0;11.2;5.4;0.0
66;2021-03-25;2509;464;0;56262;26536;0;11.7;5.5;0.0
66;2021-03-26;2480;372;0;58742;26908;0;12.3;5.6;0.0
66;2021-03-27;1171;286;0;59913;27194;0;12.5;5.7;0.0
66;2021-03-28;323;3;0;60236;27197;0;12.6;5.7;0.0
66;2021-03-29;1734;244;0;61970;27441;0;12.9;5.7;0.0
66;2021-03-30;2166;175;0;64136;27616;0;13.4;5.8;0.0
66;2021-03-31;1930;245;0;66066;27861;0;13.8;5.8;0.0
66;2021-04-01;2571;308;0;68637;28169;0;14.3;5.9;0.0
66;2021-04-02;2328;266;0;70965;28435;0;14.8;5.9;0.0
66;2021-04-03;1104;318;0;72069;28753;0;15.0;6.0;0.0
66;2021-04-04;104;116;0;72173;28869;0;15.1;6.0;0.0
66;2021-04-05;199;135;0;72372;29004;0;15.1;6.1;0.0
66;2021-04-06;1244;629;0;73616;29633;0;15.4;6.2;0.0
66;2021-04-07;1378;572;0;74994;30205;0;15.7;6.3;0.0
66;2021-04-08;1944;551;0;76938;30756;0;16.1;6.4;0.0
66;2021-04-09;3382;677;0;80320;31433;0;16.8;6.6;0.0
66;2021-04-10;2189;510;0;82509;31943;0;17.2;6.7;0.0
66;2021-04-11;1137;163;0;83646;32106;0;17.5;6.7;0.0
66;2021-04-12;2543;989;0;86189;33095;0;18.0;6.9;0.0
66;2021-04-13;3433;1048;0;89622;34143;0;18.7;7.1;0.0
66;2021-04-14;3128;905;0;92750;35048;0;19.4;7.3;0.0
66;2021-04-15;3367;1002;0;96117;36050;0;20.1;7.5;0.0
66;2021-04-16;3384;1015;0;99501;37065;0;20.8;7.7;0.0
66;2021-04-17;2123;577;0;101624;37642;0;21.2;7.9;0.0
66;2021-04-18;1344;138;0;102968;37780;0;21.5;7.9;0.0
66;2021-04-19;2106;1087;0;105074;38867;0;21.9;8.1;0.0
66;2021-04-20;2212;1058;0;107286;39925;0;22.4;8.3;0.0
66;2021-04-21;2632;1150;0;109918;41075;0;22.9;8.6;0.0
66;2021-04-22;2516;1204;0;112434;42279;0;23.5;8.8;0.0
66;2021-04-23;2228;1185;0;114662;43464;0;23.9;9.1;0.0
66;2021-04-24;2534;846;0;117196;44310;0;24.5;9.3;0.0
66;2021-04-25;1126;271;0;118322;44581;0;24.7;9.3;0.0
66;2021-04-26;1849;1176;0;120171;45757;0;25.1;9.6;0.0
66;2021-04-27;2570;1262;0;122741;47019;0;25.6;9.8;0.0
66;2021-04-28;2295;1608;0;125036;48627;0;26.1;10.2;0.0
66;2021-04-29;2509;2029;0;127545;50656;0;26.6;10.6;0.0
66;2021-04-30;2845;1475;0;130390;52131;0;27.2;10.9;0.0
66;2021-05-01;1867;470;0;132257;52601;0;27.6;11.0;0.0
66;2021-05-02;1419;258;0;133676;52859;0;27.9;11.0;0.0
66;2021-05-03;2778;1055;0;136454;53914;0;28.5;11.3;0.0
66;2021-05-04;2938;1271;0;139392;55185;0;29.1;11.5;0.0
66;2021-05-05;2880;1513;0;142272;56698;0;29.7;11.8;0.0
66;2021-05-06;3529;2000;0;145801;58698;0;30.4;12.3;0.0
66;2021-05-07;2824;2960;0;148625;61658;0;31.0;12.9;0.0
66;2021-05-08;1598;1113;0;150223;62771;0;31.4;13.1;0.0
66;2021-05-09;836;1306;0;151059;64077;0;31.5;13.4;0.0
66;2021-05-10;1669;2770;0;152728;66847;0;31.9;14.0;0.0
66;2021-05-11;2581;2974;0;155309;69821;0;32.4;14.6;0.0
66;2021-05-12;2210;2422;0;157519;72243;0;32.9;15.1;0.0
66;2021-05-13;1971;1284;0;159490;73527;0;33.3;15.4;0.0
66;2021-05-14;2485;1994;0;161975;75521;0;33.8;15.8;0.0
66;2021-05-15;2048;1466;0;164023;76987;0;34.2;16.1;0.0
66;2021-05-16;1983;1139;0;166006;78126;0;34.7;16.3;0.0
66;2021-05-17;1885;1733;0;167891;79859;0;35.1;16.7;0.0
66;2021-05-18;2912;1669;0;170803;81528;0;35.7;17.0;0.0
66;2021-05-19;2618;1278;0;173421;82806;0;36.2;17.3;0.0
66;2021-05-20;3968;1362;0;177389;84168;0;37.0;17.6;0.0
66;2021-05-21;2970;1368;0;180359;85536;0;37.7;17.9;0.0
66;2021-05-22;2728;739;0;183087;86275;0;38.2;18.0;0.0
66;2021-05-23;1358;211;0;184445;86486;0;38.5;18.1;0.0
66;2021-05-24;1818;401;0;186263;86887;0;38.9;18.1;0.0
66;2021-05-25;2602;1578;0;188865;88465;0;39.4;18.5;0.0
66;2021-05-26;2590;1394;0;191455;89859;0;40.0;18.8;0.0
66;2021-05-27;3124;2106;0;194579;91965;0;40.6;19.2;0.0
66;2021-05-28;2490;2905;0;197069;94870;0;41.1;19.8;0.0
66;2021-05-29;1909;1397;0;198978;96267;0;41.5;20.1;0.0
66;2021-05-30;719;904;0;199697;97171;0;41.7;20.3;0.0
66;2021-05-31;1933;1638;0;201630;98809;0;42.1;20.6;0.0
66;2021-06-01;2445;1907;0;204075;100716;0;42.6;21.0;0.0
66;2021-06-02;2597;2210;0;206672;102926;0;43.1;21.5;0.0
66;2021-06-03;2342;2777;0;209014;105703;0;43.6;22.1;0.0
66;2021-06-04;1750;3170;0;210764;108873;0;44.0;22.7;0.0
66;2021-06-05;1279;2447;0;212043;111320;0;44.3;23.2;0.0
66;2021-06-06;314;1142;0;212357;112462;0;44.3;23.5;0.0
66;2021-06-07;1265;2720;0;213622;115182;0;44.6;24.0;0.0
66;2021-06-08;1670;2846;0;215292;118028;0;44.9;24.6;0.0
66;2021-06-09;1911;2594;0;217203;120622;0;45.3;25.2;0.0
66;2021-06-10;1970;2749;0;219173;123371;0;45.8;25.8;0.0
66;2021-06-11;1937;3595;0;221110;126966;0;46.2;26.5;0.0
66;2021-06-12;817;2247;0;221927;129213;0;46.3;27.0;0.0
66;2021-06-13;468;1268;0;222395;130481;0;46.4;27.2;0.0
66;2021-06-14;1297;3246;0;223692;133727;0;46.7;27.9;0.0
66;2021-06-15;1993;3328;0;225685;137055;0;47.1;28.6;0.0
66;2021-06-16;1723;3313;0;227408;140368;0;47.5;29.3;0.0
66;2021-06-17;2241;3363;0;229649;143731;0;47.9;30.0;0.0
66;2021-06-18;2051;3551;0;231700;147282;0;48.4;30.7;0.0
66;2021-06-19;1378;2099;0;233078;149381;0;48.7;31.2;0.0
66;2021-06-20;871;1116;0;233949;150497;0;48.8;31.4;0.0
66;2021-06-21;1041;2661;0;234990;153158;0;49.1;32.0;0.0
66;2021-06-22;1381;3440;0;236371;156598;0;49.3;32.7;0.0
66;2021-06-23;1217;2754;0;237588;159352;0;49.6;33.3;0.0
66;2021-06-24;1360;2951;0;238948;162303;0;49.9;33.9;0.0
66;2021-06-25;1309;3228;0;240257;165531;0;50.2;34.6;0.0
66;2021-06-26;861;2396;0;241118;167927;0;50.3;35.1;0.0
66;2021-06-27;594;1383;0;241712;169310;0;50.5;35.3;0.0
66;2021-06-28;903;2773;0;242615;172083;0;50.7;35.9;0.0
66;2021-06-29;1072;3469;0;243687;175552;0;50.9;36.6;0.0
66;2021-06-30;1176;3028;0;244863;178580;0;51.1;37.3;0.0
66;2021-07-01;1339;3793;0;246202;182373;0;51.4;38.1;0.0
66;2021-07-02;1228;3272;0;247430;185645;0;51.7;38.8;0.0
66;2021-07-03;1025;3592;0;248455;189237;0;51.9;39.5;0.0
66;2021-07-04;632;1625;0;249087;190862;0;52.0;39.8;0.0
66;2021-07-05;977;2726;0;250064;193588;0;52.2;40.4;0.0
66;2021-07-06;1220;3456;0;251284;197044;0;52.5;41.1;0.0
66;2021-07-07;1242;2977;0;252526;200021;0;52.7;41.8;0.0
66;2021-07-08;1157;3117;0;253683;203138;0;53.0;42.4;0.0
66;2021-07-09;1279;3123;0;254962;206261;0;53.2;43.1;0.0
66;2021-07-10;885;2119;0;255847;208380;0;53.4;43.5;0.0
66;2021-07-11;474;1377;0;256321;209757;0;53.5;43.8;0.0
66;2021-07-12;859;3250;0;257180;213007;0;53.7;44.5;0.0
66;2021-07-13;1884;3912;0;259064;216919;0;54.1;45.3;0.0
66;2021-07-14;1682;1106;0;260746;218025;0;54.4;45.5;0.0
66;2021-07-15;2438;2717;0;263184;220742;0;54.9;46.1;0.0
66;2021-07-16;2854;2843;0;266038;223585;0;55.5;46.7;0.0
66;2021-07-17;1883;1818;0;267921;225403;0;55.9;47.1;0.0
66;2021-07-18;1027;967;0;268948;226370;0;56.1;47.3;0.0
66;2021-07-19;2297;2597;0;271245;228967;0;56.6;47.8;0.0
66;2021-07-20;2940;2555;0;274185;231522;0;57.2;48.3;0.0
66;2021-07-21;3270;2540;0;277455;234062;0;57.9;48.9;0.0
66;2021-07-22;3442;2465;0;280897;236527;0;58.6;49.4;0.0
66;2021-07-23;3439;2563;0;284336;239090;0;59.4;49.9;0.0
66;2021-07-24;2435;1709;0;286771;240799;0;59.9;50.3;0.0
66;2021-07-25;1855;1070;0;288626;241869;0;60.3;50.5;0.0
66;2021-07-26;2328;2176;0;290954;244045;0;60.7;50.9;0.0
66;2021-07-27;2745;2409;0;293699;246454;0;61.3;51.5;0.0
66;2021-07-28;2914;2223;0;296613;248677;0;61.9;51.9;0.0
66;2021-07-29;3383;2146;0;299996;250823;0;62.6;52.4;0.0
66;2021-07-30;3635;2103;0;303631;252926;0;63.4;52.8;0.0
66;2021-07-31;1978;1494;0;305609;254420;0;63.8;53.1;0.0
66;2021-08-01;1505;713;0;307114;255133;0;64.1;53.3;0.0
66;2021-08-02;1975;1481;0;309089;256614;0;64.5;53.6;0.0
66;2021-08-03;2239;1533;0;311328;258147;0;65.0;53.9;0.0
66;2021-08-04;2137;1550;0;313465;259697;0;65.4;54.2;0.0
66;2021-08-05;2044;1894;0;315509;261591;0;65.9;54.6;0.0
66;2021-08-06;1978;2060;0;317487;263651;0;66.3;55.0;0.0
66;2021-08-07;1347;1701;0;318834;265352;0;66.6;55.4;0.0
66;2021-08-08;490;1110;0;319324;266462;0;66.7;55.6;0.0
66;2021-08-09;1170;2091;0;320494;268553;0;66.9;56.1;0.0
66;2021-08-10;1435;2384;0;321929;270937;0;67.2;56.6;0.0
66;2021-08-11;1384;2375;0;323313;273312;0;67.5;57.1;0.0
66;2021-08-12;1465;2446;0;324778;275758;0;67.8;57.6;0.0
66;2021-08-13;1287;2429;0;326065;278187;0;68.1;58.1;0.0
66;2021-08-14;573;2160;0;326638;280347;0;68.2;58.5;0.0
66;2021-08-15;133;1351;0;326771;281698;0;68.2;58.8;0.0
66;2021-08-16;1176;2171;0;327947;283869;0;68.5;59.3;0.0
66;2021-08-17;1310;2474;0;329257;286343;0;68.7;59.8;0.0
66;2021-08-18;1171;2596;0;330428;288939;0;69.0;60.3;0.0
66;2021-08-19;1006;2507;0;331434;291446;0;69.2;60.8;0.0
66;2021-08-20;890;2872;0;332324;294318;0;69.4;61.4;0.0
66;2021-08-21;529;1791;0;332853;296109;0;69.5;61.8;0.0
66;2021-08-22;200;1185;0;333053;297294;0;69.5;62.1;0.0
66;2021-08-23;1047;2417;0;334100;299711;0;69.7;62.6;0.0
66;2021-08-24;907;2491;0;335007;302202;0;69.9;63.1;0.0
66;2021-08-25;853;1971;0;335860;304173;0;70.1;63.5;0.0
66;2021-08-26;860;1994;0;336720;306167;0;70.3;63.9;0.0
66;2021-08-27;805;2137;0;337525;308304;0;70.5;64.4;0.0
66;2021-08-28;471;1064;0;337996;309368;0;70.6;64.6;0.0
66;2021-08-29;217;326;0;338213;309694;0;70.6;64.7;0.0
66;2021-08-30;802;2261;49;339015;311955;49;70.8;65.1;0.0
66;2021-08-31;767;2270;78;339782;314225;127;70.9;65.6;0.0
66;2021-09-01;765;1660;202;340547;315885;329;71.1;65.9;0.1
66;2021-09-02;624;1433;235;341171;317318;564;71.2;66.2;0.1
66;2021-09-03;654;1703;276;341825;319021;840;71.4;66.6;0.2
66;2021-09-04;652;1481;132;342477;320502;972;71.5;66.9;0.2
66;2021-09-05;193;268;44;342670;320770;1016;71.5;67.0;0.2
66;2021-09-06;437;1265;515;343107;322035;1531;71.6;67.2;0.3
66;2021-09-07;370;1079;420;343477;323114;1951;71.7;67.5;0.4
66;2021-09-08;559;1178;422;344036;324292;2373;71.8;67.7;0.5
66;2021-09-09;451;1046;447;344487;325338;2820;71.9;67.9;0.6
66;2021-09-10;476;1064;409;344963;326402;3229;72.0;68.1;0.7
66;2021-09-11;482;1085;135;345445;327487;3364;72.1;68.4;0.7
66;2021-09-12;94;134;41;345539;327621;3405;72.1;68.4;0.7
66;2021-09-13;358;1000;623;345897;328621;4028;72.2;68.6;0.8
66;2021-09-14;383;780;580;346280;329401;4608;72.3;68.8;1.0
66;2021-09-15;479;931;625;346759;330332;5233;72.4;69.0;1.1
66;2021-09-16;372;677;535;347131;331009;5768;72.5;69.1;1.2
66;2021-09-17;351;719;660;347482;331728;6428;72.5;69.3;1.3
66;2021-09-18;343;1024;160;347825;332752;6588;72.6;69.5;1.4
66;2021-09-19;76;220;38;347901;332972;6626;72.6;69.5;1.4
66;2021-09-20;277;623;400;348178;333595;7026;72.7;69.6;1.5
66;2021-09-21;288;557;566;348466;334152;7592;72.7;69.8;1.6
66;2021-09-22;306;741;553;348772;334893;8145;72.8;69.9;1.7
66;2021-09-23;236;480;409;349008;335373;8554;72.9;70.0;1.8
66;2021-09-24;331;722;397;349339;336095;8951;72.9;70.2;1.9
66;2021-09-25;216;836;125;349555;336931;9076;73.0;70.3;1.9
66;2021-09-26;63;204;11;349618;337135;9087;73.0;70.4;1.9
66;2021-09-27;178;477;444;349796;337612;9531;73.0;70.5;2.0
66;2021-09-28;251;492;327;350047;338104;9858;73.1;70.6;2.1
66;2021-09-29;236;548;314;350283;338652;10172;73.1;70.7;2.1
66;2021-09-30;321;448;480;350604;339100;10652;73.2;70.8;2.2
66;2021-10-01;398;520;405;351002;339620;11057;73.3;70.9;2.3
66;2021-10-02;277;582;102;351279;340202;11159;73.3;71.0;2.3
66;2021-10-03;75;113;40;351354;340315;11199;73.4;71.0;2.3
66;2021-10-04;252;378;524;351606;340693;11723;73.4;71.1;2.4
66;2021-10-05;241;382;596;351847;341075;12319;73.5;71.2;2.6
66;2021-10-06;211;370;459;352058;341445;12778;73.5;71.3;2.7
66;2021-10-07;233;425;472;352291;341870;13250;73.5;71.4;2.8
66;2021-10-08;283;496;646;352574;342366;13896;73.6;71.5;2.9
66;2021-10-09;294;483;261;352868;342849;14157;73.7;71.6;3.0
66;2021-10-10;6;19;5;352874;342868;14162;73.7;71.6;3.0
66;2021-10-11;211;373;387;353085;343241;14549;73.7;71.7;3.0
66;2021-10-12;227;318;575;353312;343559;15124;73.8;71.7;3.2
66;2021-10-13;220;397;606;353532;343956;15730;73.8;71.8;3.3
66;2021-10-14;210;286;626;353742;344242;16356;73.9;71.9;3.4
66;2021-10-15;329;386;714;354071;344628;17070;73.9;71.9;3.6
66;2021-10-16;232;298;194;354303;344926;17264;74.0;72.0;3.6
66;2021-10-17;7;17;0;354310;344943;17264;74.0;72.0;3.6
66;2021-10-18;193;227;500;354503;345170;17764;74.0;72.1;3.7
66;2021-10-19;207;273;699;354710;345443;18463;74.1;72.1;3.9
66;2021-10-20;191;262;687;354901;345705;19150;74.1;72.2;4.0
66;2021-10-21;208;342;880;355109;346047;20030;74.1;72.2;4.2
66;2021-10-22;208;323;744;355317;346370;20774;74.2;72.3;4.3
66;2021-10-23;221;290;331;355538;346660;21105;74.2;72.4;4.4
66;2021-10-24;4;11;14;355542;346671;21119;74.2;72.4;4.4
66;2021-10-25;173;305;681;355715;346976;21800;74.3;72.4;4.6
66;2021-10-26;149;220;697;355864;347196;22497;74.3;72.5;4.7
66;2021-10-27;135;209;791;355999;347405;23288;74.3;72.5;4.9
66;2021-10-28;171;229;809;356170;347634;24097;74.4;72.6;5.0
66;2021-10-29;183;267;765;356353;347901;24862;74.4;72.6;5.2
66;2021-10-30;120;224;313;356473;348125;25175;74.4;72.7;5.3
66;2021-10-31;6;3;5;356479;348128;25180;74.4;72.7;5.3
66;2021-11-01;37;32;11;356516;348160;25191;74.4;72.7;5.3
66;2021-11-02;194;280;900;356710;348440;26091;74.5;72.7;5.4
66;2021-11-03;214;271;1019;356924;348711;27110;74.5;72.8;5.7
66;2021-11-04;215;205;1084;357139;348916;28194;74.6;72.8;5.9
66;2021-11-05;200;291;1171;357339;349207;29365;74.6;72.9;6.1
66;2021-11-06;147;261;453;357486;349468;29818;74.6;73.0;6.2
66;2021-11-07;10;20;13;357496;349488;29831;74.6;73.0;6.2
66;2021-11-08;107;248;1015;357603;349736;30846;74.7;73.0;6.4
66;2021-11-09;140;207;1497;357743;349943;32343;74.7;73.1;6.8
66;2021-11-10;204;251;1403;357947;350194;33746;74.7;73.1;7.0
66;2021-11-11;14;32;43;357961;350226;33789;74.7;73.1;7.1
66;2021-11-12;162;275;1606;358123;350501;35395;74.8;73.2;7.4
66;2021-11-13;96;197;462;358219;350698;35857;74.8;73.2;7.5
66;2021-11-14;15;11;29;358234;350709;35886;74.8;73.2;7.5
66;2021-11-15;117;169;1588;358351;350878;37474;74.8;73.3;7.8
66;2021-11-16;160;200;2114;358511;351078;39588;74.8;73.3;8.3
66;2021-11-17;179;217;1797;358690;351295;41385;74.9;73.3;8.6
66;2021-11-18;188;224;2311;358878;351519;43696;74.9;73.4;9.1
66;2021-11-19;202;232;2417;359080;351751;46113;75.0;73.4;9.6
66;2021-11-20;211;181;828;359291;351932;46941;75.0;73.5;9.8
66;2021-11-21;17;31;24;359308;351963;46965;75.0;73.5;9.8
66;2021-11-22;217;133;1717;359525;352096;48682;75.1;73.5;10.2
66;2021-11-23;193;210;2552;359718;352306;51234;75.1;73.6;10.7
66;2021-11-24;194;250;1925;359912;352556;53159;75.1;73.6;11.1
66;2021-11-25;195;194;2535;360107;352750;55694;75.2;73.6;11.6
66;2021-11-26;225;244;3597;360332;352994;59291;75.2;73.7;12.4
66;2021-11-27;184;215;1458;360516;353209;60749;75.3;73.7;12.7
66;2021-11-28;50;49;1861;360566;353258;62610;75.3;73.7;13.1
66;2021-11-29;155;190;3581;360721;353448;66191;75.3;73.8;13.8
66;2021-11-30;240;264;4766;360961;353712;70957;75.4;73.8;14.8
66;2021-12-01;189;275;4515;361150;353987;75472;75.4;73.9;15.8
66;2021-12-02;163;171;5691;361313;354158;81163;75.4;73.9;16.9
66;2021-12-03;205;227;5731;361518;354385;86894;75.5;74.0;18.1
66;2021-12-04;128;148;2164;361646;354533;89058;75.5;74.0;18.6
66;2021-12-05;17;23;251;361663;354556;89309;75.5;74.0;18.6
66;2021-12-06;190;193;4725;361853;354749;94034;75.5;74.1;19.6
66;2021-12-07;191;216;5778;362044;354965;99812;75.6;74.1;20.8
66;2021-12-08;212;223;5373;362256;355188;105185;75.6;74.2;22.0
66;2021-12-09;188;243;6245;362444;355431;111430;75.7;74.2;23.3
66;2021-12-10;308;287;6628;362752;355718;118058;75.7;74.3;24.6
66;2021-12-11;159;272;2984;362911;355990;121042;75.8;74.3;25.3
66;2021-12-12;18;41;631;362929;356031;121673;75.8;74.3;25.4
66;2021-12-13;159;237;5081;363088;356268;126754;75.8;74.4;26.5
66;2021-12-14;222;252;7013;363310;356520;133767;75.8;74.4;27.9
66;2021-12-15;220;254;6153;363530;356774;139920;75.9;74.5;29.2
66;2021-12-16;235;243;5709;363765;357017;145629;75.9;74.5;30.4
67;2020-12-27;0;0;0;0;0;0;0.0;0.0;0.0
67;2020-12-28;3;0;0;3;0;0;0.0;0.0;0.0
67;2020-12-29;2;0;0;5;0;0;0.0;0.0;0.0
67;2020-12-30;1;0;0;6;0;0;0.0;0.0;0.0
67;2020-12-31;1;0;0;7;0;0;0.0;0.0;0.0
67;2021-01-01;5;0;0;12;0;0;0.0;0.0;0.0
67;2021-01-02;1;0;0;13;0;0;0.0;0.0;0.0
67;2021-01-03;1;0;0;14;0;0;0.0;0.0;0.0
67;2021-01-04;43;0;0;57;0;0;0.0;0.0;0.0
67;2021-01-05;169;7;0;226;7;0;0.0;0.0;0.0
67;2021-01-06;125;0;0;351;7;0;0.0;0.0;0.0
67;2021-01-07;240;1;0;591;8;0;0.1;0.0;0.0
67;2021-01-08;235;2;0;826;10;0;0.1;0.0;0.0
67;2021-01-09;111;1;0;937;11;0;0.1;0.0;0.0
67;2021-01-10;67;0;0;1004;11;0;0.1;0.0;0.0
67;2021-01-11;189;1;0;1193;12;0;0.1;0.0;0.0
67;2021-01-12;521;3;0;1714;15;0;0.2;0.0;0.0
67;2021-01-13;669;4;0;2383;19;0;0.2;0.0;0.0
67;2021-01-14;1093;8;0;3476;27;0;0.3;0.0;0.0
67;2021-01-15;927;7;0;4403;34;0;0.4;0.0;0.0
67;2021-01-16;199;4;0;4602;38;0;0.4;0.0;0.0
67;2021-01-17;100;0;0;4702;38;0;0.4;0.0;0.0
67;2021-01-18;909;6;0;5611;44;0;0.5;0.0;0.0
67;2021-01-19;1396;5;0;7007;49;0;0.6;0.0;0.0
67;2021-01-20;1835;14;0;8842;63;0;0.8;0.0;0.0
67;2021-01-21;2190;11;0;11032;74;0;1.0;0.0;0.0
67;2021-01-22;1978;11;0;13010;85;0;1.1;0.0;0.0
67;2021-01-23;728;5;0;13738;90;0;1.2;0.0;0.0
67;2021-01-24;397;1;0;14135;91;0;1.2;0.0;0.0
67;2021-01-25;568;30;0;14703;121;0;1.3;0.0;0.0
67;2021-01-26;237;107;0;14940;228;0;1.3;0.0;0.0
67;2021-01-27;1432;137;0;16372;365;0;1.4;0.0;0.0
67;2021-01-28;3003;232;0;19375;597;0;1.7;0.1;0.0
67;2021-01-29;1985;169;0;21360;766;0;1.9;0.1;0.0
67;2021-01-30;1061;78;0;22421;844;0;2.0;0.1;0.0
67;2021-01-31;1127;31;0;23548;875;0;2.1;0.1;0.0
67;2021-02-01;3237;250;0;26785;1125;0;2.4;0.1;0.0
67;2021-02-02;2592;427;0;29377;1552;0;2.6;0.1;0.0
67;2021-02-03;1532;412;0;30909;1964;0;2.7;0.2;0.0
67;2021-02-04;1130;769;0;32039;2733;0;2.8;0.2;0.0
67;2021-02-05;1147;628;0;33186;3361;0;2.9;0.3;0.0
67;2021-02-06;762;142;0;33948;3503;0;3.0;0.3;0.0
67;2021-02-07;291;46;0;34239;3549;0;3.0;0.3;0.0
67;2021-02-08;846;460;0;35085;4009;0;3.1;0.4;0.0
67;2021-02-09;1022;737;0;36107;4746;0;3.2;0.4;0.0
67;2021-02-10;982;807;0;37089;5553;0;3.3;0.5;0.0
67;2021-02-11;1180;1151;0;38269;6704;0;3.4;0.6;0.0
67;2021-02-12;1244;807;0;39513;7511;0;3.5;0.7;0.0
67;2021-02-13;775;270;0;40288;7781;0;3.6;0.7;0.0
67;2021-02-14;251;97;0;40539;7878;0;3.6;0.7;0.0
67;2021-02-15;808;891;0;41347;8769;0;3.7;0.8;0.0
67;2021-02-16;935;1165;0;42282;9934;0;3.7;0.9;0.0
67;2021-02-17;830;1210;0;43112;11144;0;3.8;1.0;0.0
67;2021-02-18;1427;2520;0;44539;13664;0;3.9;1.2;0.0
67;2021-02-19;1306;2098;0;45845;15762;0;4.0;1.4;0.0
67;2021-02-20;606;826;0;46451;16588;0;4.1;1.5;0.0
67;2021-02-21;199;1165;0;46650;17753;0;4.1;1.6;0.0
67;2021-02-22;1368;2084;0;48018;19837;0;4.2;1.8;0.0
67;2021-02-23;1462;1577;0;49480;21414;0;4.4;1.9;0.0
67;2021-02-24;1428;1071;0;50908;22485;0;4.5;2.0;0.0
67;2021-02-25;1630;1475;0;52538;23960;0;4.6;2.1;0.0
67;2021-02-26;2261;1403;0;54799;25363;0;4.8;2.2;0.0
67;2021-02-27;1254;771;0;56053;26134;0;4.9;2.3;0.0
67;2021-02-28;150;364;0;56203;26498;0;5.0;2.3;0.0
67;2021-03-01;674;990;0;56877;27488;0;5.0;2.4;0.0
67;2021-03-02;956;1184;0;57833;28672;0;5.1;2.5;0.0
67;2021-03-03;1476;1241;0;59309;29913;0;5.2;2.6;0.0
67;2021-03-04;2024;1065;0;61333;30978;0;5.4;2.7;0.0
67;2021-03-05;3284;1121;0;64617;32099;0;5.7;2.8;0.0
67;2021-03-06;2392;754;0;67009;32853;0;5.9;2.9;0.0
67;2021-03-07;527;290;0;67536;33143;0;6.0;2.9;0.0
67;2021-03-08;1229;815;0;68765;33958;0;6.1;3.0;0.0
67;2021-03-09;2241;969;0;71006;34927;0;6.3;3.1;0.0
67;2021-03-10;2477;1234;0;73483;36161;0;6.5;3.2;0.0
67;2021-03-11;3219;1408;0;76702;37569;0;6.8;3.3;0.0
67;2021-03-12;5199;1420;0;81901;38989;0;7.2;3.4;0.0
67;2021-03-13;4034;884;0;85935;39873;0;7.6;3.5;0.0
67;2021-03-14;588;380;0;86523;40253;0;7.6;3.6;0.0
67;2021-03-15;2284;1147;0;88807;41400;0;7.8;3.7;0.0
67;2021-03-16;1672;1233;0;90479;42633;0;8.0;3.8;0.0
67;2021-03-17;2174;951;0;92653;43584;0;8.2;3.8;0.0
67;2021-03-18;2460;783;0;95113;44367;0;8.4;3.9;0.0
67;2021-03-19;3765;772;0;98878;45139;0;8.7;4.0;0.0
67;2021-03-20;3054;515;0;101932;45654;0;9.0;4.0;0.0
67;2021-03-21;345;26;0;102277;45680;0;9.0;4.0;0.0
67;2021-03-22;2400;801;0;104677;46481;0;9.2;4.1;0.0
67;2021-03-23;3449;839;0;108126;47320;0;9.5;4.2;0.0
67;2021-03-24;3923;885;0;112049;48205;0;9.9;4.3;0.0
67;2021-03-25;5335;596;0;117384;48801;0;10.4;4.3;0.0
67;2021-03-26;6797;542;0;124181;49343;0;11.0;4.4;0.0
67;2021-03-27;3807;349;0;127988;49692;0;11.3;4.4;0.0
67;2021-03-28;579;107;0;128567;49799;0;11.4;4.4;0.0
67;2021-03-29;3772;494;0;132339;50293;0;11.7;4.4;0.0
67;2021-03-30;4780;779;0;137119;51072;0;12.1;4.5;0.0
67;2021-03-31;4720;819;0;141839;51891;0;12.5;4.6;0.0
67;2021-04-01;5017;1045;0;146856;52936;0;13.0;4.7;0.0
67;2021-04-02;1053;204;0;147909;53140;0;13.1;4.7;0.0
67;2021-04-03;1606;300;0;149515;53440;0;13.2;4.7;0.0
67;2021-04-04;349;28;0;149864;53468;0;13.2;4.7;0.0
67;2021-04-05;386;12;0;150250;53480;0;13.3;4.7;0.0
67;2021-04-06;3431;1287;0;153681;54767;0;13.6;4.8;0.0
67;2021-04-07;4472;1363;0;158153;56130;0;14.0;5.0;0.0
67;2021-04-08;5497;1453;0;163650;57583;0;14.4;5.1;0.0
67;2021-04-09;6980;1386;0;170630;58969;0;15.1;5.2;0.0
67;2021-04-10;4149;957;0;174779;59926;0;15.4;5.3;0.0
67;2021-04-11;850;514;0;175629;60440;0;15.5;5.3;0.0
67;2021-04-12;3839;1524;0;179468;61964;0;15.8;5.5;0.0
67;2021-04-13;4792;1717;0;184260;63681;0;16.3;5.6;0.0
67;2021-04-14;5167;1996;0;189427;65677;0;16.7;5.8;0.0
67;2021-04-15;5945;2214;0;195372;67891;0;17.2;6.0;0.0
67;2021-04-16;7612;2510;0;202984;70401;0;17.9;6.2;0.0
67;2021-04-17;3836;1562;0;206820;71963;0;18.3;6.4;0.0
67;2021-04-18;1063;644;0;207883;72607;0;18.4;6.4;0.0
67;2021-04-19;3505;2196;0;211388;74803;0;18.7;6.6;0.0
67;2021-04-20;4109;1991;0;215497;76794;0;19.0;6.8;0.0
67;2021-04-21;3974;2553;0;219471;79347;0;19.4;7.0;0.0
67;2021-04-22;4420;2911;0;223891;82258;0;19.8;7.3;0.0
67;2021-04-23;5148;2994;0;229039;85252;0;20.2;7.5;0.0
67;2021-04-24;3015;1963;0;232054;87215;0;20.5;7.7;0.0
67;2021-04-25;990;444;0;233044;87659;0;20.6;7.7;0.0
67;2021-04-26;3143;2570;0;236187;90229;0;20.9;8.0;0.0
67;2021-04-27;3963;2890;0;240150;93119;0;21.2;8.2;0.0
67;2021-04-28;4196;3330;0;244346;96449;0;21.6;8.5;0.0
67;2021-04-29;5137;3476;0;249483;99925;0;22.0;8.8;0.0
67;2021-04-30;7121;2439;0;256604;102364;0;22.7;9.0;0.0
67;2021-05-01;2637;768;0;259241;103132;0;22.9;9.1;0.0
67;2021-05-02;2144;668;0;261385;103800;0;23.1;9.2;0.0
67;2021-05-03;5437;2599;0;266822;106399;0;23.6;9.4;0.0
67;2021-05-04;5702;3539;0;272524;109938;0;24.1;9.7;0.0
67;2021-05-05;5131;4110;0;277655;114048;0;24.5;10.1;0.0
67;2021-05-06;6664;4725;0;284319;118773;0;25.1;10.5;0.0
67;2021-05-07;6440;6752;0;290759;125525;0;25.7;11.1;0.0
67;2021-05-08;3503;1007;0;294262;126532;0;26.0;11.2;0.0
67;2021-05-09;3176;607;0;297438;127139;0;26.3;11.2;0.0
67;2021-05-10;4766;4477;0;302204;131616;0;26.7;11.6;0.0
67;2021-05-11;5769;4861;0;307973;136477;0;27.2;12.0;0.0
67;2021-05-12;6685;4718;0;314658;141195;0;27.8;12.5;0.0
67;2021-05-13;7362;1591;0;322020;142786;0;28.4;12.6;0.0
67;2021-05-14;8897;5154;0;330917;147940;0;29.2;13.1;0.0
67;2021-05-15;8022;3447;0;338939;151387;0;29.9;13.4;0.0
67;2021-05-16;5730;913;0;344669;152300;0;30.4;13.4;0.0
67;2021-05-17;5783;3739;0;350452;156039;0;30.9;13.8;0.0
67;2021-05-18;6981;3862;0;357433;159901;0;31.6;14.1;0.0
67;2021-05-19;7555;4050;0;364988;163951;0;32.2;14.5;0.0
67;2021-05-20;8905;4096;0;373893;168047;0;33.0;14.8;0.0
67;2021-05-21;8387;5686;0;382280;173733;0;33.8;15.3;0.0
67;2021-05-22;5902;3306;0;388182;177039;0;34.3;15.6;0.0
67;2021-05-23;2545;586;0;390727;177625;0;34.5;15.7;0.0
67;2021-05-24;4630;869;0;395357;178494;0;34.9;15.8;0.0
67;2021-05-25;5674;4723;0;401031;183217;0;35.4;16.2;0.0
67;2021-05-26;6396;4820;0;407427;188037;0;36.0;16.6;0.0
67;2021-05-27;7604;4878;0;415031;192915;0;36.6;17.0;0.0
67;2021-05-28;8306;6380;0;423337;199295;0;37.4;17.6;0.0
67;2021-05-29;6551;3800;0;429888;203095;0;38.0;17.9;0.0
67;2021-05-30;1148;782;0;431036;203877;0;38.1;18.0;0.0
67;2021-05-31;6673;4040;0;437709;207917;0;38.6;18.4;0.0
67;2021-06-01;7536;4387;0;445245;212304;0;39.3;18.7;0.0
67;2021-06-02;8202;4137;0;453447;216441;0;40.0;19.1;0.0
67;2021-06-03;8960;4864;0;462407;221305;0;40.8;19.5;0.0
67;2021-06-04;8586;6071;0;470993;227376;0;41.6;20.1;0.0
67;2021-06-05;6362;3890;0;477355;231266;0;42.1;20.4;0.0
67;2021-06-06;3163;827;0;480518;232093;0;42.4;20.5;0.0
67;2021-06-07;7409;4222;0;487927;236315;0;43.1;20.9;0.0
67;2021-06-08;8530;4919;0;496457;241234;0;43.8;21.3;0.0
67;2021-06-09;9055;4805;0;505512;246039;0;44.6;21.7;0.0
67;2021-06-10;9519;4968;0;515031;251007;0;45.5;22.2;0.0
67;2021-06-11;7947;8228;0;522978;259235;0;46.2;22.9;0.0
67;2021-06-12;6678;5055;0;529656;264290;0;46.8;23.3;0.0
67;2021-06-13;2792;1018;0;532448;265308;0;47.0;23.4;0.0
67;2021-06-14;5426;6350;0;537874;271658;0;47.5;24.0;0.0
67;2021-06-15;6508;6624;0;544382;278282;0;48.1;24.6;0.0
67;2021-06-16;6733;6569;0;551115;284851;0;48.7;25.2;0.0
67;2021-06-17;6982;8871;0;558097;293722;0;49.3;25.9;0.0
67;2021-06-18;7278;8394;0;565375;302116;0;49.9;26.7;0.0
67;2021-06-19;6026;5706;0;571401;307822;0;50.5;27.2;0.0
67;2021-06-20;1303;1327;0;572704;309149;0;50.6;27.3;0.0
67;2021-06-21;4128;6788;0;576832;315937;0;50.9;27.9;0.0
67;2021-06-22;4122;8897;0;580954;324834;0;51.3;28.7;0.0
67;2021-06-23;5096;8152;0;586050;332986;0;51.7;29.4;0.0
67;2021-06-24;4493;8813;0;590543;341799;0;52.1;30.2;0.0
67;2021-06-25;5175;9948;0;595718;351747;0;52.6;31.1;0.0
67;2021-06-26;3306;8918;0;599024;360665;0;52.9;31.8;0.0
67;2021-06-27;955;3416;0;599979;364081;0;53.0;32.1;0.0
67;2021-06-28;2778;8673;0;602757;372754;0;53.2;32.9;0.0
67;2021-06-29;2854;8662;0;605611;381416;0;53.5;33.7;0.0
67;2021-06-30;3277;8758;6;608888;390174;6;53.8;34.4;0.0
67;2021-07-01;3626;8400;0;612514;398574;6;54.1;35.2;0.0
67;2021-07-02;3754;10911;0;616268;409485;6;54.4;36.2;0.0
67;2021-07-03;2846;7602;0;619114;417087;6;54.7;36.8;0.0
67;2021-07-04;705;1794;0;619819;418881;6;54.7;37.0;0.0
67;2021-07-05;2695;8361;0;622514;427242;6;55.0;37.7;0.0
67;2021-07-06;2996;8572;0;625510;435814;6;55.2;38.5;0.0
67;2021-07-07;3880;8648;0;629390;444462;6;55.6;39.2;0.0
67;2021-07-08;4113;7790;0;633503;452252;6;55.9;39.9;0.0
67;2021-07-09;3708;11343;0;637211;463595;6;56.3;40.9;0.0
67;2021-07-10;2712;7995;0;639923;471590;6;56.5;41.6;0.0
67;2021-07-11;870;1891;0;640793;473481;6;56.6;41.8;0.0
67;2021-07-12;2468;9829;0;643261;483310;6;56.8;42.7;0.0
67;2021-07-13;4111;9960;0;647372;493270;6;57.2;43.6;0.0
67;2021-07-14;3431;4326;0;650803;497596;6;57.5;43.9;0.0
67;2021-07-15;5144;12096;0;655947;509692;6;57.9;45.0;0.0
67;2021-07-16;4922;12225;0;660869;521917;6;58.3;46.1;0.0
67;2021-07-17;3639;8604;0;664508;530521;6;58.7;46.8;0.0
67;2021-07-18;1372;2396;0;665880;532917;6;58.8;47.1;0.0
67;2021-07-19;4487;9686;0;670367;542603;6;59.2;47.9;0.0
67;2021-07-20;5706;9706;0;676073;552309;6;59.7;48.8;0.0
67;2021-07-21;5845;10317;0;681918;562626;6;60.2;49.7;0.0
67;2021-07-22;6368;9821;0;688286;572447;6;60.8;50.5;0.0
67;2021-07-23;7267;10987;0;695553;583434;6;61.4;51.5;0.0
67;2021-07-24;5204;7329;0;700757;590763;6;61.9;52.2;0.0
67;2021-07-25;2091;1870;0;702848;592633;6;62.1;52.3;0.0
67;2021-07-26;4976;7241;0;707824;599874;6;62.5;53.0;0.0
67;2021-07-27;6478;7149;0;714302;607023;6;63.1;53.6;0.0
67;2021-07-28;7404;7117;0;721706;614140;6;63.7;54.2;0.0
67;2021-07-29;8055;6313;0;729761;620453;6;64.4;54.8;0.0
67;2021-07-30;8338;7185;1;738099;627638;7;65.2;55.4;0.0
67;2021-07-31;4989;4743;0;743088;632381;7;65.6;55.8;0.0
67;2021-08-01;2238;1345;0;745326;633726;7;65.8;56.0;0.0
67;2021-08-02;6241;5055;0;751567;638781;7;66.4;56.4;0.0
67;2021-08-03;7051;4673;0;758618;643454;7;67.0;56.8;0.0
67;2021-08-04;6637;4576;0;765255;648030;7;67.6;57.2;0.0
67;2021-08-05;5509;4250;0;770764;652280;7;68.1;57.6;0.0
67;2021-08-06;6063;5372;0;776827;657652;7;68.6;58.1;0.0
67;2021-08-07;4331;4103;1;781158;661755;8;69.0;58.4;0.0
67;2021-08-08;1177;1333;0;782335;663088;8;69.1;58.5;0.0
67;2021-08-09;3093;4510;0;785428;667598;8;69.3;58.9;0.0
67;2021-08-10;3140;4774;0;788568;672372;8;69.6;59.4;0.0
67;2021-08-11;3232;4620;1;791800;676992;9;69.9;59.8;0.0
67;2021-08-12;2933;4734;0;794733;681726;9;70.2;60.2;0.0
67;2021-08-13;3137;5374;0;797870;687100;9;70.4;60.7;0.0
67;2021-08-14;2034;4837;0;799904;691937;9;70.6;61.1;0.0
67;2021-08-15;628;1416;0;800532;693353;9;70.7;61.2;0.0
67;2021-08-16;2015;5258;0;802547;698611;9;70.9;61.7;0.0
67;2021-08-17;2057;5296;0;804604;703907;9;71.0;62.1;0.0
67;2021-08-18;2222;6151;1;806826;710058;10;71.2;62.7;0.0
67;2021-08-19;1815;5897;0;808641;715955;10;71.4;63.2;0.0
67;2021-08-20;2220;7208;0;810861;723163;10;71.6;63.8;0.0
67;2021-08-21;1415;5288;0;812276;728451;10;71.7;64.3;0.0
67;2021-08-22;361;1879;0;812637;730330;10;71.7;64.5;0.0
67;2021-08-23;1779;6630;0;814416;736960;10;71.9;65.1;0.0
67;2021-08-24;1862;6451;0;816278;743411;10;72.1;65.6;0.0
67;2021-08-25;1970;6914;0;818248;750325;10;72.2;66.2;0.0
67;2021-08-26;1752;5332;0;820000;755657;10;72.4;66.7;0.0
67;2021-08-27;2058;6799;0;822058;762456;10;72.6;67.3;0.0
67;2021-08-28;1528;5689;0;823586;768145;10;72.7;67.8;0.0
67;2021-08-29;382;1450;0;823968;769595;10;72.7;67.9;0.0
67;2021-08-30;1348;4279;155;825316;773874;165;72.9;68.3;0.0
67;2021-08-31;1318;3787;238;826634;777661;403;73.0;68.7;0.0
67;2021-09-01;1832;3803;485;828466;781464;888;73.1;69.0;0.1
67;2021-09-02;1027;2496;416;829493;783960;1304;73.2;69.2;0.1
67;2021-09-03;1496;3675;518;830989;787635;1822;73.4;69.5;0.2
67;2021-09-04;1387;3543;339;832376;791178;2161;73.5;69.9;0.2
67;2021-09-05;266;764;92;832642;791942;2253;73.5;69.9;0.2
67;2021-09-06;921;1882;418;833563;793824;2671;73.6;70.1;0.2
67;2021-09-07;783;1735;393;834346;795559;3064;73.7;70.2;0.3
67;2021-09-08;1135;2304;520;835481;797863;3584;73.8;70.4;0.3
67;2021-09-09;1067;1713;512;836548;799576;4096;73.9;70.6;0.4
67;2021-09-10;1340;2282;544;837888;801858;4640;74.0;70.8;0.4
67;2021-09-11;1002;2520;364;838890;804378;5004;74.1;71.0;0.4
67;2021-09-12;227;468;94;839117;804846;5098;74.1;71.1;0.5
67;2021-09-13;686;1363;695;839803;806209;5793;74.1;71.2;0.5
67;2021-09-14;927;1358;1007;840730;807567;6800;74.2;71.3;0.6
67;2021-09-15;975;2013;953;841705;809580;7753;74.3;71.5;0.7
67;2021-09-16;722;1234;1022;842427;810814;8775;74.4;71.6;0.8
67;2021-09-17;964;2119;1044;843391;812933;9819;74.5;71.8;0.9
67;2021-09-18;793;2251;398;844184;815184;10217;74.5;72.0;0.9
67;2021-09-19;98;370;97;844282;815554;10314;74.5;72.0;0.9
67;2021-09-20;568;1049;936;844850;816603;11250;74.6;72.1;1.0
67;2021-09-21;465;909;733;845315;817512;11983;74.6;72.2;1.1
67;2021-09-22;600;1804;1105;845915;819316;13088;74.7;72.3;1.2
67;2021-09-23;529;854;848;846444;820170;13936;74.7;72.4;1.2
67;2021-09-24;630;1569;974;847074;821739;14910;74.8;72.6;1.3
67;2021-09-25;592;1730;388;847666;823469;15298;74.8;72.7;1.4
67;2021-09-26;81;284;81;847747;823753;15379;74.8;72.7;1.4
67;2021-09-27;398;814;595;848145;824567;15974;74.9;72.8;1.4
67;2021-09-28;403;763;628;848548;825330;16602;74.9;72.9;1.5
67;2021-09-29;611;1254;1039;849159;826584;17641;75.0;73.0;1.6
67;2021-09-30;395;835;1120;849554;827419;18761;75.0;73.1;1.7
67;2021-10-01;864;1360;1036;850418;828779;19797;75.1;73.2;1.7
67;2021-10-02;602;1225;380;851020;830004;20177;75.1;73.3;1.8
67;2021-10-03;100;202;79;851120;830206;20256;75.1;73.3;1.8
67;2021-10-04;372;584;528;851492;830790;20784;75.2;73.4;1.8
67;2021-10-05;363;671;646;851855;831461;21430;75.2;73.4;1.9
67;2021-10-06;601;1033;998;852456;832494;22428;75.3;73.5;2.0
67;2021-10-07;449;737;912;852905;833231;23340;75.3;73.6;2.1
67;2021-10-08;711;1176;993;853616;834407;24333;75.4;73.7;2.1
67;2021-10-09;502;980;577;854118;835387;24910;75.4;73.8;2.2
67;2021-10-10;71;102;48;854189;835489;24958;75.4;73.8;2.2
67;2021-10-11;400;599;703;854589;836088;25661;75.5;73.8;2.3
67;2021-10-12;372;554;704;854961;836642;26365;75.5;73.9;2.3
67;2021-10-13;537;913;1076;855498;837555;27441;75.5;73.9;2.4
67;2021-10-14;380;625;814;855878;838180;28255;75.6;74.0;2.5
67;2021-10-15;683;971;1438;856561;839151;29693;75.6;74.1;2.6
67;2021-10-16;533;895;741;857094;840046;30434;75.7;74.2;2.7
67;2021-10-17;110;105;63;857204;840151;30497;75.7;74.2;2.7
67;2021-10-18;406;481;859;857610;840632;31356;75.7;74.2;2.8
67;2021-10-19;313;492;802;857923;841124;32158;75.7;74.3;2.8
67;2021-10-20;454;660;1263;858377;841784;33421;75.8;74.3;3.0
67;2021-10-21;316;483;929;858693;842267;34350;75.8;74.4;3.0
67;2021-10-22;568;692;1413;859261;842959;35763;75.9;74.4;3.2
67;2021-10-23;502;714;1114;859763;843673;36877;75.9;74.5;3.3
67;2021-10-24;56;116;99;859819;843789;36976;75.9;74.5;3.3
67;2021-10-25;324;411;929;860143;844200;37905;75.9;74.5;3.3
67;2021-10-26;260;333;971;860403;844533;38876;76.0;74.6;3.4
67;2021-10-27;393;543;1502;860796;845076;40378;76.0;74.6;3.6
67;2021-10-28;325;408;1102;861121;845484;41480;76.0;74.6;3.7
67;2021-10-29;486;573;1854;861607;846057;43334;76.1;74.7;3.8
67;2021-10-30;366;491;1243;861973;846548;44577;76.1;74.7;3.9
67;2021-10-31;66;89;100;862039;846637;44677;76.1;74.8;3.9
67;2021-11-01;84;56;82;862123;846693;44759;76.1;74.8;4.0
67;2021-11-02;257;345;1058;862380;847038;45817;76.1;74.8;4.0
67;2021-11-03;391;626;1765;862771;847664;47582;76.2;74.8;4.2
67;2021-11-04;302;408;1376;863073;848072;48958;76.2;74.9;4.3
67;2021-11-05;573;689;2635;863646;848761;51593;76.3;74.9;4.6
67;2021-11-06;363;593;1647;864009;849354;53240;76.3;75.0;4.7
67;2021-11-07;41;117;142;864050;849471;53382;76.3;75.0;4.7
67;2021-11-08;248;479;1967;864298;849950;55349;76.3;75.0;4.9
67;2021-11-09;249;367;1993;864547;850317;57342;76.3;75.1;5.1
67;2021-11-10;395;547;2789;864942;850864;60131;76.4;75.1;5.3
67;2021-11-11;46;71;298;864988;850935;60429;76.4;75.1;5.3
67;2021-11-12;427;598;3389;865415;851533;63818;76.4;75.2;5.6
67;2021-11-13;391;552;2179;865806;852085;65997;76.4;75.2;5.8
67;2021-11-14;44;57;205;865850;852142;66202;76.4;75.2;5.8
67;2021-11-15;277;370;2756;866127;852512;68958;76.5;75.3;6.1
67;2021-11-16;340;350;2756;866467;852862;71714;76.5;75.3;6.3
67;2021-11-17;410;480;3593;866877;853342;75307;76.5;75.3;6.6
67;2021-11-18;384;413;3522;867261;853755;78829;76.6;75.4;7.0
67;2021-11-19;559;696;4871;867820;854451;83700;76.6;75.4;7.4
67;2021-11-20;353;534;2779;868173;854985;86479;76.7;75.5;7.6
67;2021-11-21;31;82;232;868204;855067;86711;76.7;75.5;7.7
67;2021-11-22;391;310;3364;868595;855377;90075;76.7;75.5;8.0
67;2021-11-23;397;337;3701;868992;855714;93776;76.7;75.6;8.3
67;2021-11-24;533;516;4149;869525;856230;97925;76.8;75.6;8.6
67;2021-11-25;407;380;4383;869932;856610;102308;76.8;75.6;9.0
67;2021-11-26;602;594;7393;870534;857204;109701;76.9;75.7;9.7
67;2021-11-27;381;455;4803;870915;857659;114504;76.9;75.7;10.1
67;2021-11-28;48;75;944;870963;857734;115448;76.9;75.7;10.2
67;2021-11-29;329;310;5633;871292;858044;121081;76.9;75.8;10.7
67;2021-11-30;390;373;6781;871682;858417;127862;77.0;75.8;11.3
67;2021-12-01;348;428;7274;872030;858845;135136;77.0;75.8;11.9
67;2021-12-02;242;274;8065;872272;859119;143201;77.0;75.9;12.6
67;2021-12-03;327;512;10601;872599;859631;153802;77.0;75.9;13.6
67;2021-12-04;308;410;8006;872907;860041;161808;77.1;75.9;14.3
67;2021-12-05;49;111;1571;872956;860152;163379;77.1;75.9;14.4
67;2021-12-06;240;306;9097;873196;860458;172476;77.1;76.0;15.2
67;2021-12-07;334;395;11709;873530;860853;184185;77.1;76.0;16.3
67;2021-12-08;349;478;10943;873879;861331;195128;77.2;76.0;17.2
67;2021-12-09;313;380;11494;874192;861711;206622;77.2;76.1;18.2
67;2021-12-10;461;578;14492;874653;862289;221114;77.2;76.1;19.5
67;2021-12-11;416;482;10795;875069;862771;231909;77.3;76.2;20.5
67;2021-12-12;95;90;2684;875164;862861;234593;77.3;76.2;20.7
67;2021-12-13;227;417;11714;875391;863278;246307;77.3;76.2;21.7
67;2021-12-14;390;477;14262;875781;863755;260569;77.3;76.3;23.0
67;2021-12-15;378;597;13968;876159;864352;274537;77.4;76.3;24.2
67;2021-12-16;304;514;13565;876463;864866;288102;77.4;76.4;25.4
68;2020-12-27;0;0;0;0;0;0;0.0;0.0;0.0
68;2020-12-28;1;0;0;1;0;0;0.0;0.0;0.0
68;2020-12-29;0;0;0;1;0;0;0.0;0.0;0.0
68;2020-12-30;2;0;0;3;0;0;0.0;0.0;0.0
68;2020-12-31;0;0;0;3;0;0;0.0;0.0;0.0
68;2021-01-01;0;0;0;3;0;0;0.0;0.0;0.0
68;2021-01-02;0;0;0;3;0;0;0.0;0.0;0.0
68;2021-01-03;0;0;0;3;0;0;0.0;0.0;0.0
68;2021-01-04;1;0;0;4;0;0;0.0;0.0;0.0
68;2021-01-05;11;0;0;15;0;0;0.0;0.0;0.0
68;2021-01-06;223;1;0;238;1;0;0.0;0.0;0.0
68;2021-01-07;84;1;0;322;2;0;0.0;0.0;0.0
68;2021-01-08;137;1;0;459;3;0;0.1;0.0;0.0
68;2021-01-09;25;1;0;484;4;0;0.1;0.0;0.0
68;2021-01-10;0;0;0;484;4;0;0.1;0.0;0.0
68;2021-01-11;94;0;0;578;4;0;0.1;0.0;0.0
68;2021-01-12;378;1;0;956;5;0;0.1;0.0;0.0
68;2021-01-13;703;3;0;1659;8;0;0.2;0.0;0.0
68;2021-01-14;383;2;0;2042;10;0;0.3;0.0;0.0
68;2021-01-15;225;1;0;2267;11;0;0.3;0.0;0.0
68;2021-01-16;4;0;0;2271;11;0;0.3;0.0;0.0
68;2021-01-17;1;0;0;2272;11;0;0.3;0.0;0.0
68;2021-01-18;387;4;0;2659;15;0;0.3;0.0;0.0
68;2021-01-19;600;5;0;3259;20;0;0.4;0.0;0.0
68;2021-01-20;748;10;0;4007;30;0;0.5;0.0;0.0
68;2021-01-21;1400;13;0;5407;43;0;0.7;0.0;0.0
68;2021-01-22;1480;14;0;6887;57;0;0.9;0.0;0.0
68;2021-01-23;255;3;0;7142;60;0;0.9;0.0;0.0
68;2021-01-24;671;2;0;7813;62;0;1.0;0.0;0.0
68;2021-01-25;1342;44;0;9155;106;0;1.2;0.0;0.0
68;2021-01-26;1492;76;0;10647;182;0;1.4;0.0;0.0
68;2021-01-27;2679;148;0;13326;330;0;1.7;0.0;0.0
68;2021-01-28;2315;59;0;15641;389;0;2.0;0.1;0.0
68;2021-01-29;1509;137;0;17150;526;0;2.2;0.1;0.0
68;2021-01-30;177;6;0;17327;532;0;2.3;0.1;0.0
68;2021-01-31;7;0;0;17334;532;0;2.3;0.1;0.0
68;2021-02-01;759;122;0;18093;654;0;2.4;0.1;0.0
68;2021-02-02;889;299;0;18982;953;0;2.5;0.1;0.0
68;2021-02-03;992;613;0;19974;1566;0;2.6;0.2;0.0
68;2021-02-04;1010;326;0;20984;1892;0;2.7;0.2;0.0
68;2021-02-05;961;235;0;21945;2127;0;2.9;0.3;0.0
68;2021-02-06;150;7;0;22095;2134;0;2.9;0.3;0.0
68;2021-02-07;3;17;0;22098;2151;0;2.9;0.3;0.0
68;2021-02-08;868;42;0;22966;2193;0;3.0;0.3;0.0
68;2021-02-09;1278;67;0;24244;2260;0;3.2;0.3;0.0
68;2021-02-10;1389;76;0;25633;2336;0;3.4;0.3;0.0
68;2021-02-11;1459;457;0;27092;2793;0;3.5;0.4;0.0
68;2021-02-12;1510;444;0;28602;3237;0;3.7;0.4;0.0
68;2021-02-13;141;6;0;28743;3243;0;3.8;0.4;0.0
68;2021-02-14;61;229;0;28804;3472;0;3.8;0.5;0.0
68;2021-02-15;619;1054;0;29423;4526;0;3.9;0.6;0.0
68;2021-02-16;829;1340;0;30252;5866;0;4.0;0.8;0.0
68;2021-02-17;1209;2063;0;31461;7929;0;4.1;1.0;0.0
68;2021-02-18;1606;2025;0;33067;9954;0;4.3;1.3;0.0
68;2021-02-19;969;1358;0;34036;11312;0;4.5;1.5;0.0
68;2021-02-20;108;165;0;34144;11477;0;4.5;1.5;0.0
68;2021-02-21;1;48;0;34145;11525;0;4.5;1.5;0.0
68;2021-02-22;445;799;0;34590;12324;0;4.5;1.6;0.0
68;2021-02-23;614;1035;0;35204;13359;0;4.6;1.8;0.0
68;2021-02-24;801;1151;0;36005;14510;0;4.7;1.9;0.0
68;2021-02-25;1177;1250;0;37182;15760;0;4.9;2.1;0.0
68;2021-02-26;1150;1002;0;38332;16762;0;5.0;2.2;0.0
68;2021-02-27;547;188;0;38879;16950;0;5.1;2.2;0.0
68;2021-02-28;12;1;0;38891;16951;0;5.1;2.2;0.0
68;2021-03-01;920;775;0;39811;17726;0;5.2;2.3;0.0
68;2021-03-02;1161;924;0;40972;18650;0;5.4;2.4;0.0
68;2021-03-03;1490;986;0;42462;19636;0;5.6;2.6;0.0
68;2021-03-04;1892;1038;0;44354;20674;0;5.8;2.7;0.0
68;2021-03-05;2264;1029;0;46618;21703;0;6.1;2.8;0.0
68;2021-03-06;2200;266;0;48818;21969;0;6.4;2.9;0.0
68;2021-03-07;817;103;0;49635;22072;0;6.5;2.9;0.0
68;2021-03-08;1383;942;0;51018;23014;0;6.7;3.0;0.0
68;2021-03-09;1649;1265;0;52667;24279;0;6.9;3.2;0.0
68;2021-03-10;1884;1746;0;54551;26025;0;7.1;3.4;0.0
68;2021-03-11;2548;1871;0;57099;27896;0;7.5;3.7;0.0
68;2021-03-12;2565;1372;0;59664;29268;0;7.8;3.8;0.0
68;2021-03-13;3274;276;0;62938;29544;0;8.2;3.9;0.0
68;2021-03-14;1405;63;0;64343;29607;0;8.4;3.9;0.0
68;2021-03-15;1630;603;0;65973;30210;0;8.6;4.0;0.0
68;2021-03-16;1862;574;0;67835;30784;0;8.9;4.0;0.0
68;2021-03-17;1803;695;0;69638;31479;0;9.1;4.1;0.0
68;2021-03-18;2043;905;0;71681;32384;0;9.4;4.2;0.0
68;2021-03-19;2900;713;0;74581;33097;0;9.8;4.3;0.0
68;2021-03-20;974;132;0;75555;33229;0;9.9;4.4;0.0
68;2021-03-21;75;2;0;75630;33231;0;9.9;4.4;0.0
68;2021-03-22;1874;568;0;77504;33799;0;10.2;4.4;0.0
68;2021-03-23;2751;583;0;80255;34382;0;10.5;4.5;0.0
68;2021-03-24;3116;755;0;83371;35137;0;10.9;4.6;0.0
68;2021-03-25;3391;765;0;86762;35902;0;11.4;4.7;0.0
68;2021-03-26;3920;709;0;90682;36611;0;11.9;4.8;0.0
68;2021-03-27;1183;175;0;91865;36786;0;12.0;4.8;0.0
68;2021-03-28;60;5;0;91925;36791;0;12.0;4.8;0.0
68;2021-03-29;2240;1292;0;94165;38083;0;12.3;5.0;0.0
68;2021-03-30;2930;1204;0;97095;39287;0;12.7;5.1;0.0
68;2021-03-31;2682;1254;0;99777;40541;0;13.1;5.3;0.0
68;2021-04-01;2778;1445;0;102555;41986;0;13.4;5.5;0.0
68;2021-04-02;321;101;0;102876;42087;0;13.5;5.5;0.0
68;2021-04-03;304;128;0;103180;42215;0;13.5;5.5;0.0
68;2021-04-04;22;2;0;103202;42217;0;13.5;5.5;0.0
68;2021-04-05;66;5;0;103268;42222;0;13.5;5.5;0.0
68;2021-04-06;1767;1226;0;105035;43448;0;13.8;5.7;0.0
68;2021-04-07;2584;1420;0;107619;44868;0;14.1;5.9;0.0
68;2021-04-08;3265;1431;0;110884;46299;0;14.5;6.1;0.0
68;2021-04-09;4177;1473;0;115061;47772;0;15.1;6.3;0.0
68;2021-04-10;1300;1869;0;116361;49641;0;15.2;6.5;0.0
68;2021-04-11;127;1181;0;116488;50822;0;15.3;6.7;0.0
68;2021-04-12;2657;1521;0;119145;52343;0;15.6;6.9;0.0
68;2021-04-13;2739;1966;0;121884;54309;0;16.0;7.1;0.0
68;2021-04-14;3524;2137;0;125408;56446;0;16.4;7.4;0.0
68;2021-04-15;4012;1999;0;129420;58445;0;17.0;7.7;0.0
68;2021-04-16;3890;1958;0;133310;60403;0;17.5;7.9;0.0
68;2021-04-17;1176;451;0;134486;60854;0;17.6;8.0;0.0
68;2021-04-18;115;17;0;134601;60871;0;17.6;8.0;0.0
68;2021-04-19;2307;1760;0;136908;62631;0;17.9;8.2;0.0
68;2021-04-20;2368;2225;0;139276;64856;0;18.2;8.5;0.0
68;2021-04-21;2768;2403;0;142044;67259;0;18.6;8.8;0.0
68;2021-04-22;3181;1946;0;145225;69205;0;19.0;9.1;0.0
68;2021-04-23;3290;2044;0;148515;71249;0;19.5;9.3;0.0
68;2021-04-24;859;542;0;149374;71791;0;19.6;9.4;0.0
68;2021-04-25;214;22;0;149588;71813;0;19.6;9.4;0.0
68;2021-04-26;2258;2101;0;151846;73914;0;19.9;9.7;0.0
68;2021-04-27;2533;2199;0;154379;76113;0;20.2;10.0;0.0
68;2021-04-28;3419;1817;0;157798;77930;0;20.7;10.2;0.0
68;2021-04-29;4007;1753;0;161805;79683;0;21.2;10.4;0.0
68;2021-04-30;4639;1405;0;166444;81088;0;21.8;10.6;0.0
68;2021-05-01;982;130;0;167426;81218;0;21.9;10.6;0.0
68;2021-05-02;732;77;0;168158;81295;0;22.0;10.7;0.0
68;2021-05-03;3506;1754;0;171664;83049;0;22.5;10.9;0.0
68;2021-05-04;3803;2314;0;175467;85363;0;23.0;11.2;0.0
68;2021-05-05;3570;3190;0;179037;88553;0;23.5;11.6;0.0
68;2021-05-06;4664;2882;0;183701;91435;0;24.1;12.0;0.0
68;2021-05-07;4355;2949;0;188056;94384;0;24.6;12.4;0.0
68;2021-05-08;1667;252;0;189723;94636;0;24.9;12.4;0.0
68;2021-05-09;1067;114;0;190790;94750;0;25.0;12.4;0.0
68;2021-05-10;2963;3674;0;193753;98424;0;25.4;12.9;0.0
68;2021-05-11;4532;3569;0;198285;101993;0;26.0;13.4;0.0
68;2021-05-12;5574;3251;0;203859;105244;0;26.7;13.8;0.0
68;2021-05-13;4548;883;0;208407;106127;0;27.3;13.9;0.0
68;2021-05-14;5616;2172;0;214023;108299;0;28.0;14.2;0.0
68;2021-05-15;3508;980;0;217531;109279;0;28.5;14.3;0.0
68;2021-05-16;775;148;0;218306;109427;0;28.6;14.3;0.0
68;2021-05-17;4295;2427;0;222601;111854;0;29.2;14.7;0.0
68;2021-05-18;6020;2308;0;228621;114162;0;30.0;15.0;0.0
68;2021-05-19;5711;2793;0;234332;116955;0;30.7;15.3;0.0
68;2021-05-20;5898;2417;0;240230;119372;0;31.5;15.6;0.0
68;2021-05-21;5708;2873;0;245938;122245;0;32.2;16.0;0.0
68;2021-05-22;2673;967;0;248611;123212;0;32.6;16.1;0.0
68;2021-05-23;140;25;0;248751;123237;0;32.6;16.1;0.0
68;2021-05-24;2209;943;0;250960;124180;0;32.9;16.3;0.0
68;2021-05-25;4188;3307;0;255148;127487;0;33.4;16.7;0.0
68;2021-05-26;4789;3287;0;259937;130774;0;34.1;17.1;0.0
68;2021-05-27;5324;3331;0;265261;134105;0;34.8;17.6;0.0
68;2021-05-28;5407;3718;0;270668;137823;0;35.5;18.1;0.0
68;2021-05-29;1623;1197;0;272291;139020;0;35.7;18.2;0.0
68;2021-05-30;82;65;0;272373;139085;0;35.7;18.2;0.0
68;2021-05-31;4920;2299;0;277293;141384;0;36.3;18.5;0.0
68;2021-06-01;5730;2737;0;283023;144121;0;37.1;18.9;0.0
68;2021-06-02;4834;2960;0;287857;147081;0;37.7;19.3;0.0
68;2021-06-03;5689;3036;0;293546;150117;0;38.5;19.7;0.0
68;2021-06-04;4938;3263;0;298484;153380;0;39.1;20.1;0.0
68;2021-06-05;933;1221;0;299417;154601;0;39.2;20.3;0.0
68;2021-06-06;146;125;0;299563;154726;0;39.3;20.3;0.0
68;2021-06-07;4544;2932;0;304107;157658;0;39.8;20.7;0.0
68;2021-06-08;4676;3441;0;308783;161099;0;40.5;21.1;0.0
68;2021-06-09;4829;3300;0;313612;164399;0;41.1;21.5;0.0
68;2021-06-10;4940;3097;0;318552;167496;0;41.7;21.9;0.0
68;2021-06-11;4893;4033;0;323445;171529;0;42.4;22.5;0.0
68;2021-06-12;2970;1777;0;326415;173306;0;42.8;22.7;0.0
68;2021-06-13;585;676;0;327000;173982;0;42.8;22.8;0.0
68;2021-06-14;2428;4280;0;329428;178262;0;43.2;23.4;0.0
68;2021-06-15;2989;4690;0;332417;182952;0;43.6;24.0;0.0
68;2021-06-16;3302;4404;0;335719;187356;0;44.0;24.5;0.0
68;2021-06-17;2371;4387;0;338090;191743;0;44.3;25.1;0.0
68;2021-06-18;3284;5091;0;341374;196834;0;44.7;25.8;0.0
68;2021-06-19;2248;2196;0;343622;199030;0;45.0;26.1;0.0
68;2021-06-20;272;887;0;343894;199917;0;45.1;26.2;0.0
68;2021-06-21;1963;4961;0;345857;204878;0;45.3;26.8;0.0
68;2021-06-22;1857;5104;0;347714;209982;0;45.6;27.5;0.0
68;2021-06-23;2231;5635;0;349945;215617;0;45.9;28.3;0.0
68;2021-06-24;2087;4744;0;352032;220361;0;46.1;28.9;0.0
68;2021-06-25;2197;6381;0;354229;226742;0;46.4;29.7;0.0
68;2021-06-26;1262;2634;0;355491;229376;0;46.6;30.1;0.0
68;2021-06-27;169;855;0;355660;230231;0;46.6;30.2;0.0
68;2021-06-28;1524;6233;0;357184;236464;0;46.8;31.0;0.0
68;2021-06-29;1490;6449;0;358674;242913;0;47.0;31.8;0.0
68;2021-06-30;1772;6417;0;360446;249330;0;47.2;32.7;0.0
68;2021-07-01;2107;5258;0;362553;254588;0;47.5;33.4;0.0
68;2021-07-02;2175;6377;0;364728;260965;0;47.8;34.2;0.0
68;2021-07-03;1029;2020;0;365757;262985;0;47.9;34.5;0.0
68;2021-07-04;241;230;0;365998;263215;0;48.0;34.5;0.0
68;2021-07-05;1410;5227;0;367408;268442;0;48.1;35.2;0.0
68;2021-07-06;1965;5672;0;369373;274114;0;48.4;35.9;0.0
68;2021-07-07;2372;4970;0;371745;279084;0;48.7;36.6;0.0
68;2021-07-08;2390;4651;0;374135;283735;0;49.0;37.2;0.0
68;2021-07-09;2062;7102;0;376197;290837;0;49.3;38.1;0.0
68;2021-07-10;1023;2072;0;377220;292909;0;49.4;38.4;0.0
68;2021-07-11;156;204;0;377376;293113;0;49.4;38.4;0.0
68;2021-07-12;1613;6470;0;378989;299583;0;49.7;39.3;0.0
68;2021-07-13;2778;6321;0;381767;305904;0;50.0;40.1;0.0
68;2021-07-14;1779;1091;0;383546;306995;0;50.3;40.2;0.0
68;2021-07-15;3182;6501;0;386728;313496;0;50.7;41.1;0.0
68;2021-07-16;3816;6665;0;390544;320161;0;51.2;41.9;0.0
68;2021-07-17;3350;2402;0;393894;322563;0;51.6;42.3;0.0
68;2021-07-18;1016;301;0;394910;322864;0;51.7;42.3;0.0
68;2021-07-19;3180;5899;0;398090;328763;0;52.2;43.1;0.0
68;2021-07-20;4217;5467;0;402307;334230;0;52.7;43.8;0.0
68;2021-07-21;4398;5665;0;406705;339895;0;53.3;44.5;0.0
68;2021-07-22;4182;4700;0;410887;344595;0;53.8;45.2;0.0
68;2021-07-23;5008;5683;0;415895;350278;0;54.5;45.9;0.0
68;2021-07-24;3294;2154;0;419189;352432;0;54.9;46.2;0.0
68;2021-07-25;842;552;0;420031;352984;0;55.0;46.3;0.0
68;2021-07-26;4743;4261;0;424774;357245;0;55.7;46.8;0.0
68;2021-07-27;6127;3649;0;430901;360894;0;56.5;47.3;0.0
68;2021-07-28;6593;3717;0;437494;364611;0;57.3;47.8;0.0
68;2021-07-29;6185;3338;0;443679;367949;0;58.1;48.2;0.0
68;2021-07-30;6196;4246;0;449875;372195;0;58.9;48.8;0.0
68;2021-07-31;3791;1463;0;453666;373658;0;59.4;49.0;0.0
68;2021-08-01;1560;499;0;455226;374157;0;59.6;49.0;0.0
68;2021-08-02;4580;3076;0;459806;377233;0;60.2;49.4;0.0
68;2021-08-03;3563;2461;0;463369;379694;0;60.7;49.8;0.0
68;2021-08-04;3158;2680;1;466527;382374;1;61.1;50.1;0.0
68;2021-08-05;2805;2648;0;469332;385022;1;61.5;50.4;0.0
68;2021-08-06;3972;4163;0;473304;389185;1;62.0;51.0;0.0
68;2021-08-07;1351;1404;0;474655;390589;1;62.2;51.2;0.0
68;2021-08-08;389;819;0;475044;391408;1;62.2;51.3;0.0
68;2021-08-09;2478;3608;0;477522;395016;1;62.6;51.8;0.0
68;2021-08-10;2210;2962;0;479732;397978;1;62.9;52.1;0.0
68;2021-08-11;1912;2912;0;481644;400890;1;63.1;52.5;0.0
68;2021-08-12;1788;2827;0;483432;403717;1;63.3;52.9;0.0
68;2021-08-13;2608;4633;0;486040;408350;1;63.7;53.5;0.0
68;2021-08-14;753;1558;0;486793;409908;1;63.8;53.7;0.0
68;2021-08-15;64;468;0;486857;410376;1;63.8;53.8;0.0
68;2021-08-16;1901;4935;0;488758;415311;1;64.0;54.4;0.0
68;2021-08-17;1741;4710;1;490499;420021;2;64.3;55.0;0.0
68;2021-08-18;1247;3789;0;491746;423810;2;64.4;55.5;0.0
68;2021-08-19;1337;3785;0;493083;427595;2;64.6;56.0;0.0
68;2021-08-20;2159;6030;1;495242;433625;3;64.9;56.8;0.0
68;2021-08-21;549;1495;0;495791;435120;3;65.0;57.0;0.0
68;2021-08-22;127;489;0;495918;435609;3;65.0;57.1;0.0
68;2021-08-23;1188;5297;0;497106;440906;3;65.1;57.8;0.0
68;2021-08-24;1353;5730;0;498459;446636;3;65.3;58.5;0.0
68;2021-08-25;1580;3767;0;500039;450403;3;65.5;59.0;0.0
68;2021-08-26;1916;4424;0;501955;454827;3;65.8;59.6;0.0
68;2021-08-27;1781;6143;1;503736;460970;4;66.0;60.4;0.0
68;2021-08-28;448;1245;0;504184;462215;4;66.1;60.6;0.0
68;2021-08-29;47;433;0;504231;462648;4;66.1;60.6;0.0
68;2021-08-30;1288;4300;37;505519;466948;41;66.2;61.2;0.0
68;2021-08-31;1253;3921;127;506772;470869;168;66.4;61.7;0.0
68;2021-09-01;1010;2175;136;507782;473044;304;66.5;62.0;0.0
68;2021-09-02;918;1771;224;508700;474815;528;66.7;62.2;0.1
68;2021-09-03;1313;4174;296;510013;478989;824;66.8;62.8;0.1
68;2021-09-04;550;951;86;510563;479940;910;66.9;62.9;0.1
68;2021-09-05;202;142;58;510765;480082;968;66.9;62.9;0.1
68;2021-09-06;718;2031;248;511483;482113;1216;67.0;63.2;0.2
68;2021-09-07;627;1268;191;512110;483381;1407;67.1;63.3;0.2
68;2021-09-08;653;1383;159;512763;484764;1566;67.2;63.5;0.2
68;2021-09-09;913;1263;332;513676;486027;1898;67.3;63.7;0.2
68;2021-09-10;1479;2954;331;515155;488981;2229;67.5;64.1;0.3
68;2021-09-11;475;696;56;515630;489677;2285;67.6;64.2;0.3
68;2021-09-12;75;76;10;515705;489753;2295;67.6;64.2;0.3
68;2021-09-13;828;1217;225;516533;490970;2520;67.7;64.3;0.3
68;2021-09-14;975;1311;532;517508;492281;3052;67.8;64.5;0.4
68;2021-09-15;724;1570;555;518232;493851;3607;67.9;64.7;0.5
68;2021-09-16;629;1043;481;518861;494894;4088;68.0;64.8;0.5
68;2021-09-17;984;2260;582;519845;497154;4670;68.1;65.1;0.6
68;2021-09-18;454;797;188;520299;497951;4858;68.2;65.2;0.6
68;2021-09-19;23;74;19;520322;498025;4877;68.2;65.3;0.6
68;2021-09-20;559;956;320;520881;498981;5197;68.2;65.4;0.7
68;2021-09-21;591;1257;756;521472;500238;5953;68.3;65.5;0.8
68;2021-09-22;621;1171;629;522093;501409;6582;68.4;65.7;0.9
68;2021-09-23;355;694;698;522448;502103;7280;68.5;65.8;1.0
68;2021-09-24;638;1524;799;523086;503627;8079;68.5;66.0;1.1
68;2021-09-25;300;697;176;523386;504324;8255;68.6;66.1;1.1
68;2021-09-26;32;57;12;523418;504381;8267;68.6;66.1;1.1
68;2021-09-27;346;676;515;523764;505057;8782;68.6;66.2;1.2
68;2021-09-28;346;548;522;524110;505605;9304;68.7;66.2;1.2
68;2021-09-29;562;859;890;524672;506464;10194;68.7;66.4;1.3
68;2021-09-30;403;763;671;525075;507227;10865;68.8;66.5;1.4
68;2021-10-01;883;1540;702;525958;508767;11567;68.9;66.7;1.5
68;2021-10-02;333;583;203;526291;509350;11770;69.0;66.7;1.5
68;2021-10-03;61;99;15;526352;509449;11785;69.0;66.8;1.5
68;2021-10-04;338;451;440;526690;509900;12225;69.0;66.8;1.6
68;2021-10-05;360;593;507;527050;510493;12732;69.1;66.9;1.7
68;2021-10-06;418;865;563;527468;511358;13295;69.1;67.0;1.7
68;2021-10-07;391;591;668;527859;511949;13963;69.2;67.1;1.8
68;2021-10-08;1052;1587;1169;528911;513536;15132;69.3;67.3;2.0
68;2021-10-09;315;621;298;529226;514157;15430;69.3;67.4;2.0
68;2021-10-10;39;51;45;529265;514208;15475;69.3;67.4;2.0
68;2021-10-11;321;472;418;529586;514680;15893;69.4;67.4;2.1
68;2021-10-12;269;493;511;529855;515173;16404;69.4;67.5;2.1
68;2021-10-13;506;642;661;530361;515815;17065;69.5;67.6;2.2
68;2021-10-14;405;625;792;530766;516440;17857;69.5;67.7;2.3
68;2021-10-15;701;945;1292;531467;517385;19149;69.6;67.8;2.5
68;2021-10-16;229;392;320;531696;517777;19469;69.7;67.8;2.6
68;2021-10-17;29;33;34;531725;517810;19503;69.7;67.8;2.6
68;2021-10-18;262;355;435;531987;518165;19938;69.7;67.9;2.6
68;2021-10-19;278;440;415;532265;518605;20353;69.7;68.0;2.7
68;2021-10-20;441;526;986;532706;519131;21339;69.8;68.0;2.8
68;2021-10-21;367;553;896;533073;519684;22235;69.8;68.1;2.9
68;2021-10-22;582;773;1353;533655;520457;23588;69.9;68.2;3.1
68;2021-10-23;204;354;444;533859;520811;24032;69.9;68.2;3.1
68;2021-10-24;25;49;22;533884;520860;24054;70.0;68.2;3.2
68;2021-10-25;196;267;476;534080;521127;24530;70.0;68.3;3.2
68;2021-10-26;189;286;519;534269;521413;25049;70.0;68.3;3.3
68;2021-10-27;341;418;1058;534610;521831;26107;70.0;68.4;3.4
68;2021-10-28;309;411;1056;534919;522242;27163;70.1;68.4;3.6
68;2021-10-29;452;615;1554;535371;522857;28717;70.1;68.5;3.8
68;2021-10-30;178;310;493;535549;523167;29210;70.2;68.5;3.8
68;2021-10-31;14;42;47;535563;523209;29257;70.2;68.6;3.8
68;2021-11-01;197;35;20;535760;523244;29277;70.2;68.6;3.8
68;2021-11-02;188;360;746;535948;523604;30023;70.2;68.6;3.9
68;2021-11-03;310;495;885;536258;524099;30908;70.3;68.7;4.0
68;2021-11-04;305;365;1305;536563;524464;32213;70.3;68.7;4.2
68;2021-11-05;501;757;2203;537064;525221;34416;70.4;68.8;4.5
68;2021-11-06;177;312;644;537241;525533;35060;70.4;68.9;4.6
68;2021-11-07;22;74;34;537263;525607;35094;70.4;68.9;4.6
68;2021-11-08;200;298;1195;537463;525905;36289;70.4;68.9;4.8
68;2021-11-09;186;341;1326;537649;526246;37615;70.4;69.0;4.9
68;2021-11-10;325;523;2307;537974;526769;39922;70.5;69.0;5.2
68;2021-11-11;6;40;25;537980;526809;39947;70.5;69.0;5.2
68;2021-11-12;347;704;3140;538327;527513;43087;70.5;69.1;5.6
68;2021-11-13;173;274;1040;538500;527787;44127;70.6;69.2;5.8
68;2021-11-14;28;58;83;538528;527845;44210;70.6;69.2;5.8
68;2021-11-15;255;288;2262;538783;528133;46472;70.6;69.2;6.1
68;2021-11-16;383;332;2787;539166;528465;49259;70.6;69.2;6.5
68;2021-11-17;313;388;2737;539479;528853;51996;70.7;69.3;6.8
68;2021-11-18;234;349;2214;539713;529202;54210;70.7;69.3;7.1
68;2021-11-19;379;533;3498;540092;529735;57708;70.8;69.4;7.6
68;2021-11-20;181;275;1202;540273;530010;58910;70.8;69.4;7.7
68;2021-11-21;3;46;48;540276;530056;58958;70.8;69.5;7.7
68;2021-11-22;328;250;2262;540604;530306;61220;70.8;69.5;8.0
68;2021-11-23;417;287;3182;541021;530593;64402;70.9;69.5;8.4
68;2021-11-24;344;321;3045;541365;530914;67447;70.9;69.6;8.8
68;2021-11-25;307;343;3615;541672;531257;71062;71.0;69.6;9.3
68;2021-11-26;477;549;5611;542149;531806;76673;71.0;69.7;10.0
68;2021-11-27;200;328;2193;542349;532134;78866;71.1;69.7;10.3
68;2021-11-28;25;45;459;542374;532179;79325;71.1;69.7;10.4
68;2021-11-29;229;273;4076;542603;532452;83401;71.1;69.8;10.9
68;2021-11-30;321;286;5680;542924;532738;89081;71.1;69.8;11.7
68;2021-12-01;211;343;5498;543135;533081;94579;71.2;69.8;12.4
68;2021-12-02;225;243;7537;543360;533324;102116;71.2;69.9;13.4
68;2021-12-03;277;460;8366;543637;533784;110482;71.2;69.9;14.5
68;2021-12-04;175;286;3239;543812;534070;113721;71.3;70.0;14.9
68;2021-12-05;27;90;921;543839;534160;114642;71.3;70.0;15.0
68;2021-12-06;215;334;6217;544054;534494;120859;71.3;70.0;15.8
68;2021-12-07;236;320;7312;544290;534814;128171;71.3;70.1;16.8
68;2021-12-08;269;467;6721;544559;535281;134892;71.4;70.1;17.7
68;2021-12-09;259;341;8169;544818;535622;143061;71.4;70.2;18.7
68;2021-12-10;316;456;8792;545134;536078;151853;71.4;70.2;19.9
68;2021-12-11;209;268;3880;545343;536346;155733;71.5;70.3;20.4
68;2021-12-12;50;94;1109;545393;536440;156842;71.5;70.3;20.6
68;2021-12-13;246;347;6652;545639;536787;163494;71.5;70.3;21.4
68;2021-12-14;237;426;7703;545876;537213;171197;71.5;70.4;22.4
68;2021-12-15;263;510;7925;546139;537723;179122;71.6;70.5;23.5
68;2021-12-16;292;372;8914;546431;538095;188036;71.6;70.5;24.6
69;2020-12-27;2;0;0;2;0;0;0.0;0.0;0.0
69;2020-12-28;10;1;0;12;1;0;0.0;0.0;0.0
69;2020-12-29;6;0;0;18;1;0;0.0;0.0;0.0
69;2020-12-30;6;1;0;24;2;0;0.0;0.0;0.0
69;2020-12-31;13;3;0;37;5;0;0.0;0.0;0.0
69;2021-01-01;2;0;0;39;5;0;0.0;0.0;0.0
69;2021-01-02;3;0;0;42;5;0;0.0;0.0;0.0
69;2021-01-03;4;2;0;46;7;0;0.0;0.0;0.0
69;2021-01-04;16;0;0;62;7;0;0.0;0.0;0.0
69;2021-01-05;198;7;0;260;14;0;0.0;0.0;0.0
69;2021-01-06;468;6;0;728;20;0;0.0;0.0;0.0
69;2021-01-07;736;5;0;1464;25;0;0.1;0.0;0.0
69;2021-01-08;750;1;0;2214;26;0;0.1;0.0;0.0
69;2021-01-09;47;3;0;2261;29;0;0.1;0.0;0.0
69;2021-01-10;3;1;0;2264;30;0;0.1;0.0;0.0
69;2021-01-11;1020;3;0;3284;33;0;0.2;0.0;0.0
69;2021-01-12;1283;9;0;4567;42;0;0.2;0.0;0.0
69;2021-01-13;1261;3;0;5828;45;0;0.3;0.0;0.0
69;2021-01-14;2121;23;0;7949;68;0;0.4;0.0;0.0
69;2021-01-15;1734;8;0;9683;76;0;0.5;0.0;0.0
69;2021-01-16;891;4;0;10574;80;0;0.6;0.0;0.0
69;2021-01-17;264;3;0;10838;83;0;0.6;0.0;0.0
69;2021-01-18;1694;16;0;12532;99;0;0.7;0.0;0.0
69;2021-01-19;3517;31;0;16049;130;0;0.9;0.0;0.0
69;2021-01-20;4253;32;0;20302;162;0;1.1;0.0;0.0
69;2021-01-21;3914;42;0;24216;204;0;1.3;0.0;0.0
69;2021-01-22;3010;29;0;27226;233;0;1.5;0.0;0.0
69;2021-01-23;1224;3;0;28450;236;0;1.5;0.0;0.0
69;2021-01-24;105;1;0;28555;237;0;1.5;0.0;0.0
69;2021-01-25;2082;47;0;30637;284;0;1.6;0.0;0.0
69;2021-01-26;2449;88;0;33086;372;0;1.8;0.0;0.0
69;2021-01-27;2233;175;0;35319;547;0;1.9;0.0;0.0
69;2021-01-28;2275;356;0;37594;903;0;2.0;0.0;0.0
69;2021-01-29;2051;280;0;39645;1183;0;2.1;0.1;0.0
69;2021-01-30;881;4;0;40526;1187;0;2.2;0.1;0.0
69;2021-01-31;63;1;0;40589;1188;0;2.2;0.1;0.0
69;2021-02-01;1078;377;0;41667;1565;0;2.2;0.1;0.0
69;2021-02-02;1558;425;0;43225;1990;0;2.3;0.1;0.0
69;2021-02-03;1381;528;0;44606;2518;0;2.4;0.1;0.0
69;2021-02-04;1749;905;0;46355;3423;0;2.5;0.2;0.0
69;2021-02-05;791;796;0;47146;4219;0;2.5;0.2;0.0
69;2021-02-06;384;58;0;47530;4277;0;2.5;0.2;0.0
69;2021-02-07;15;7;0;47545;4284;0;2.5;0.2;0.0
69;2021-02-08;1060;986;0;48605;5270;0;2.6;0.3;0.0
69;2021-02-09;1948;2042;0;50553;7312;0;2.7;0.4;0.0
69;2021-02-10;1819;2518;0;52372;9830;0;2.8;0.5;0.0
69;2021-02-11;1767;3097;0;54139;12927;0;2.9;0.7;0.0
69;2021-02-12;1776;1992;0;55915;14919;0;3.0;0.8;0.0
69;2021-02-13;425;750;0;56340;15669;0;3.0;0.8;0.0
69;2021-02-14;86;47;0;56426;15716;0;3.0;0.8;0.0
69;2021-02-15;945;1749;0;57371;17465;0;3.1;0.9;0.0
69;2021-02-16;973;2382;0;58344;19847;0;3.1;1.1;0.0
69;2021-02-17;987;2336;0;59331;22183;0;3.2;1.2;0.0
69;2021-02-18;952;2267;0;60283;24450;0;3.2;1.3;0.0
69;2021-02-19;878;1824;0;61161;26274;0;3.3;1.4;0.0
69;2021-02-20;323;916;0;61484;27190;0;3.3;1.4;0.0
69;2021-02-21;47;70;0;61531;27260;0;3.3;1.5;0.0
69;2021-02-22;574;2074;0;62105;29334;0;3.3;1.6;0.0
69;2021-02-23;733;2092;0;62838;31426;0;3.3;1.7;0.0
69;2021-02-24;1010;2174;0;63848;33600;0;3.4;1.8;0.0
69;2021-02-25;2142;2630;0;65990;36230;0;3.5;1.9;0.0
69;2021-02-26;2675;1820;0;68665;38050;0;3.7;2.0;0.0
69;2021-02-27;907;552;0;69572;38602;0;3.7;2.1;0.0
69;2021-02-28;125;95;0;69697;38697;0;3.7;2.1;0.0
69;2021-03-01;2150;924;0;71847;39621;0;3.8;2.1;0.0
69;2021-03-02;3194;1417;0;75041;41038;0;4.0;2.2;0.0
69;2021-03-03;3547;1246;0;78588;42284;0;4.2;2.3;0.0
69;2021-03-04;4726;1362;0;83314;43646;0;4.4;2.3;0.0
69;2021-03-05;5753;1284;0;89067;44930;0;4.7;2.4;0.0
69;2021-03-06;3385;424;0;92452;45354;0;4.9;2.4;0.0
69;2021-03-07;732;61;0;93184;45415;0;5.0;2.4;0.0
69;2021-03-08;2832;1102;0;96016;46517;0;5.1;2.5;0.0
69;2021-03-09;4490;1241;0;100506;47758;0;5.4;2.5;0.0
69;2021-03-10;4844;1025;0;105350;48783;0;5.6;2.6;0.0
69;2021-03-11;6439;1044;0;111789;49827;0;6.0;2.7;0.0
69;2021-03-12;8417;1186;0;120206;51013;0;6.4;2.7;0.0
69;2021-03-13;4596;264;0;124802;51277;0;6.7;2.7;0.0
69;2021-03-14;2467;151;0;127269;51428;0;6.8;2.7;0.0
69;2021-03-15;4527;724;0;131796;52152;0;7.0;2.8;0.0
69;2021-03-16;3654;721;0;135450;52873;0;7.2;2.8;0.0
69;2021-03-17;3816;923;0;139266;53796;0;7.4;2.9;0.0
69;2021-03-18;4691;1574;0;143957;55370;0;7.7;3.0;0.0
69;2021-03-19;6380;1029;0;150337;56399;0;8.0;3.0;0.0
69;2021-03-20;3486;254;0;153823;56653;0;8.2;3.0;0.0
69;2021-03-21;1798;96;0;155621;56749;0;8.3;3.0;0.0
69;2021-03-22;4423;813;0;160044;57562;0;8.5;3.1;0.0
69;2021-03-23;7042;856;0;167086;58418;0;8.9;3.1;0.0
69;2021-03-24;6239;1017;0;173325;59435;0;9.2;3.2;0.0
69;2021-03-25;8288;1141;0;181613;60576;0;9.7;3.2;0.0
69;2021-03-26;8550;1334;0;190163;61910;0;10.1;3.3;0.0
69;2021-03-27;3099;804;0;193262;62714;0;10.3;3.3;0.0
69;2021-03-28;2055;184;0;195317;62898;0;10.4;3.4;0.0
69;2021-03-29;3999;2130;0;199316;65028;0;10.6;3.5;0.0
69;2021-03-30;7379;2602;0;206695;67630;0;11.0;3.6;0.0
69;2021-03-31;6034;3099;0;212729;70729;0;11.3;3.8;0.0
69;2021-04-01;8084;2699;0;220813;73428;0;11.8;3.9;0.0
69;2021-04-02;7934;3099;0;228747;76527;0;12.2;4.1;0.0
69;2021-04-03;4993;2069;0;233740;78596;0;12.5;4.2;0.0
69;2021-04-04;5907;535;0;239647;79131;0;12.8;4.2;0.0
69;2021-04-05;5501;774;0;245148;79905;0;13.1;4.3;0.0
69;2021-04-06;4986;3375;0;250134;83280;0;13.3;4.4;0.0
69;2021-04-07;5140;3746;0;255274;87026;0;13.6;4.6;0.0
69;2021-04-08;6322;3904;0;261596;90930;0;13.9;4.8;0.0
69;2021-04-09;9168;3762;0;270764;94692;0;14.4;5.0;0.0
69;2021-04-10;2992;2377;0;273756;97069;0;14.6;5.2;0.0
69;2021-04-11;1896;1741;0;275652;98810;0;14.7;5.3;0.0
69;2021-04-12;5307;3509;0;280959;102319;0;15.0;5.5;0.0
69;2021-04-13;7016;4013;0;287975;106332;0;15.4;5.7;0.0
69;2021-04-14;6613;4041;0;294588;110373;0;15.7;5.9;0.0
69;2021-04-15;7733;4434;0;302321;114807;0;16.1;6.1;0.0
69;2021-04-16;7783;4390;0;310104;119197;0;16.5;6.4;0.0
69;2021-04-17;4765;2225;0;314869;121422;0;16.8;6.5;0.0
69;2021-04-18;1698;1654;0;316567;123076;0;16.9;6.6;0.0
69;2021-04-19;6636;3665;0;323203;126741;0;17.2;6.8;0.0
69;2021-04-20;6447;4548;0;329650;131289;0;17.6;7.0;0.0
69;2021-04-21;5689;4285;0;335339;135574;0;17.9;7.2;0.0
69;2021-04-22;6337;5196;0;341676;140770;0;18.2;7.5;0.0
69;2021-04-23;6667;4757;0;348343;145527;0;18.6;7.8;0.0
69;2021-04-24;3229;2016;0;351572;147543;0;18.7;7.9;0.0
69;2021-04-25;2122;1466;0;353694;149009;0;18.9;7.9;0.0
69;2021-04-26;4592;3797;0;358286;152806;0;19.1;8.1;0.0
69;2021-04-27;6617;5106;0;364903;157912;0;19.5;8.4;0.0
69;2021-04-28;6369;4699;0;371272;162611;0;19.8;8.7;0.0
69;2021-04-29;6760;5277;0;378032;167888;0;20.2;8.9;0.0
69;2021-04-30;7086;5985;0;385118;173873;0;20.5;9.3;0.0
69;2021-05-01;3374;636;0;388492;174509;0;20.7;9.3;0.0
69;2021-05-02;1580;5209;0;390072;179718;0;20.8;9.6;0.0
69;2021-05-03;5744;7603;0;395816;187321;0;21.1;10.0;0.0
69;2021-05-04;7365;7605;0;403181;194926;0;21.5;10.4;0.0
69;2021-05-05;10378;5504;0;413559;200430;0;22.0;10.7;0.0
69;2021-05-06;11429;6055;0;424988;206485;0;22.7;11.0;0.0
69;2021-05-07;10822;6972;0;435810;213457;0;23.2;11.4;0.0
69;2021-05-08;4279;1588;0;440089;215045;0;23.5;11.5;0.0
69;2021-05-09;5938;2512;0;446027;217557;0;23.8;11.6;0.0
69;2021-05-10;6778;5981;0;452805;223538;0;24.1;11.9;0.0
69;2021-05-11;9849;6840;0;462654;230378;0;24.7;12.3;0.0
69;2021-05-12;12028;6602;0;474682;236980;0;25.3;12.6;0.0
69;2021-05-13;10777;2466;0;485459;239446;0;25.9;12.8;0.0
69;2021-05-14;12448;5130;0;497907;244576;0;26.5;13.0;0.0
69;2021-05-15;9204;2575;0;507111;247151;0;27.0;13.2;0.0
69;2021-05-16;8029;1756;0;515140;248907;0;27.5;13.3;0.0
69;2021-05-17;11054;5407;0;526194;254314;0;28.0;13.6;0.0
69;2021-05-18;12938;6047;0;539132;260361;0;28.7;13.9;0.0
69;2021-05-19;13205;5574;0;552337;265935;0;29.4;14.2;0.0
69;2021-05-20;11588;5830;0;563925;271765;0;30.1;14.5;0.0
69;2021-05-21;11482;6486;0;575407;278251;0;30.7;14.8;0.0
69;2021-05-22;7220;2584;0;582627;280835;0;31.1;15.0;0.0
69;2021-05-23;5166;1502;0;587793;282337;0;31.3;15.0;0.0
69;2021-05-24;9105;1962;0;596898;284299;0;31.8;15.2;0.0
69;2021-05-25;10336;6153;0;607234;290452;0;32.4;15.5;0.0
69;2021-05-26;10966;6016;0;618200;296468;0;33.0;15.8;0.0
69;2021-05-27;10931;6644;0;629131;303112;0;33.5;16.2;0.0
69;2021-05-28;11760;8576;0;640891;311688;0;34.2;16.6;0.0
69;2021-05-29;8451;5764;0;649342;317452;0;34.6;16.9;0.0
69;2021-05-30;7220;2871;0;656562;320323;0;35.0;17.1;0.0
69;2021-05-31;11188;6257;0;667750;326580;0;35.6;17.4;0.0
69;2021-06-01;12096;7331;0;679846;333911;0;36.2;17.8;0.0
69;2021-06-02;14193;6536;0;694039;340447;0;37.0;18.1;0.0
69;2021-06-03;15794;7214;0;709833;347661;0;37.8;18.5;0.0
69;2021-06-04;13499;8504;0;723332;356165;0;38.6;19.0;0.0
69;2021-06-05;10240;3536;0;733572;359701;0;39.1;19.2;0.0
69;2021-06-06;6981;1681;0;740553;361382;0;39.5;19.3;0.0
69;2021-06-07;11975;6901;0;752528;368283;0;40.1;19.6;0.0
69;2021-06-08;14533;8018;0;767061;376301;0;40.9;20.1;0.0
69;2021-06-09;13602;7235;0;780663;383536;0;41.6;20.4;0.0
69;2021-06-10;14349;7087;0;795012;390623;0;42.4;20.8;0.0
69;2021-06-11;14331;9490;0;809343;400113;0;43.1;21.3;0.0
69;2021-06-12;7899;4220;0;817242;404333;0;43.6;21.6;0.0
69;2021-06-13;4867;2016;0;822109;406349;0;43.8;21.7;0.0
69;2021-06-14;7257;8867;0;829366;415216;0;44.2;22.1;0.0
69;2021-06-15;9311;10617;0;838677;425833;0;44.7;22.7;0.0
69;2021-06-16;9545;11586;0;848222;437419;0;45.2;23.3;0.0
69;2021-06-17;9757;12400;0;857979;449819;0;45.7;24.0;0.0
69;2021-06-18;9970;14134;0;867949;463953;0;46.3;24.7;0.0
69;2021-06-19;5953;8278;0;873902;472231;0;46.6;25.2;0.0
69;2021-06-20;4411;4445;0;878313;476676;0;46.8;25.4;0.0
69;2021-06-21;5360;12096;0;883673;488772;0;47.1;26.1;0.0
69;2021-06-22;6190;13318;0;889863;502090;0;47.4;26.8;0.0
69;2021-06-23;7047;12635;0;896910;514725;0;47.8;27.4;0.0
69;2021-06-24;7627;13012;0;904537;527737;0;48.2;28.1;0.0
69;2021-06-25;6387;15945;0;910924;543682;0;48.6;29.0;0.0
69;2021-06-26;3569;9593;0;914493;553275;0;48.7;29.5;0.0
69;2021-06-27;2882;6993;0;917375;560268;0;48.9;29.9;0.0
69;2021-06-28;3988;14717;0;921363;574985;0;49.1;30.6;0.0
69;2021-06-29;4800;15272;0;926163;590257;0;49.4;31.5;0.0
69;2021-06-30;5927;14077;0;932090;604334;0;49.7;32.2;0.0
69;2021-07-01;7498;11992;0;939588;616326;0;50.1;32.9;0.0
69;2021-07-02;6500;14410;0;946088;630736;0;50.4;33.6;0.0
69;2021-07-03;5077;8899;0;951165;639635;0;50.7;34.1;0.0
69;2021-07-04;3474;5487;0;954639;645122;0;50.9;34.4;0.0
69;2021-07-05;5525;13250;0;960164;658372;0;51.2;35.1;0.0
69;2021-07-06;5444;14264;0;965608;672636;0;51.5;35.9;0.0
69;2021-07-07;6978;13421;0;972586;686057;0;51.8;36.6;0.0
69;2021-07-08;7163;13107;0;979749;699164;0;52.2;37.3;0.0
69;2021-07-09;7065;16268;0;986814;715432;0;52.6;38.1;0.0
69;2021-07-10;2981;10897;0;989795;726329;0;52.8;38.7;0.0
69;2021-07-11;3623;5433;0;993418;731762;0;53.0;39.0;0.0
69;2021-07-12;3922;16495;0;997340;748257;0;53.2;39.9;0.0
69;2021-07-13;6307;18555;0;1003647;766812;0;53.5;40.9;0.0
69;2021-07-14;5041;6545;0;1008688;773357;0;53.8;41.2;0.0
69;2021-07-15;7934;18522;0;1016622;791879;0;54.2;42.2;0.0
69;2021-07-16;9755;17540;0;1026377;809419;0;54.7;43.1;0.0
69;2021-07-17;5110;10939;0;1031487;820358;0;55.0;43.7;0.0
69;2021-07-18;3138;7393;0;1034625;827751;0;55.1;44.1;0.0
69;2021-07-19;6880;14937;0;1041505;842688;0;55.5;44.9;0.0
69;2021-07-20;9351;17007;0;1050856;859695;0;56.0;45.8;0.0
69;2021-07-21;9684;15834;0;1060540;875529;0;56.5;46.7;0.0
69;2021-07-22;11531;15324;0;1072071;890853;0;57.1;47.5;0.0
69;2021-07-23;10999;15740;3;1083070;906593;3;57.7;48.3;0.0
69;2021-07-24;6004;9983;0;1089074;916576;3;58.1;48.9;0.0
69;2021-07-25;4242;5691;0;1093316;922267;3;58.3;49.2;0.0
69;2021-07-26;8732;11742;0;1102048;934009;3;58.7;49.8;0.0
69;2021-07-27;12572;11757;1;1114620;945766;4;59.4;50.4;0.0
69;2021-07-28;11728;11169;0;1126348;956935;4;60.0;51.0;0.0
69;2021-07-29;13898;10869;1;1140246;967804;5;60.8;51.6;0.0
69;2021-07-30;13189;11201;1;1153435;979005;6;61.5;52.2;0.0
69;2021-07-31;7739;6680;0;1161174;985685;6;61.9;52.5;0.0
69;2021-08-01;4426;4462;0;1165600;990147;6;62.1;52.8;0.0
69;2021-08-02;10781;8335;0;1176381;998482;6;62.7;53.2;0.0
69;2021-08-03;12145;7671;0;1188526;1006153;6;63.4;53.6;0.0
69;2021-08-04;11653;7411;0;1200179;1013564;6;64.0;54.0;0.0
69;2021-08-05;10358;7152;0;1210537;1020716;6;64.5;54.4;0.0
69;2021-08-06;9294;7617;0;1219831;1028333;6;65.0;54.8;0.0
69;2021-08-07;4481;4447;1;1224312;1032780;7;65.3;55.1;0.0
69;2021-08-08;3590;3176;0;1227902;1035956;7;65.5;55.2;0.0
69;2021-08-09;6824;8605;0;1234726;1044561;7;65.8;55.7;0.0
69;2021-08-10;7432;6935;0;1242158;1051496;7;66.2;56.0;0.0
69;2021-08-11;7138;7457;0;1249296;1058953;7;66.6;56.4;0.0
69;2021-08-12;6564;6898;0;1255860;1065851;7;66.9;56.8;0.0
69;2021-08-13;6137;8087;0;1261997;1073938;7;67.3;57.2;0.0
69;2021-08-14;3919;5145;0;1265916;1079083;7;67.5;57.5;0.0
69;2021-08-15;2095;2242;0;1268011;1081325;7;67.6;57.6;0.0
69;2021-08-16;4901;8857;0;1272912;1090182;7;67.9;58.1;0.0
69;2021-08-17;5827;8227;0;1278739;1098409;7;68.2;58.5;0.0
69;2021-08-18;5522;9200;0;1284261;1107609;7;68.5;59.0;0.0
69;2021-08-19;5469;8886;0;1289730;1116495;7;68.7;59.5;0.0
69;2021-08-20;5342;8687;0;1295072;1125182;7;69.0;60.0;0.0
69;2021-08-21;2467;4002;0;1297539;1129184;7;69.2;60.2;0.0
69;2021-08-22;1609;2207;0;1299148;1131391;7;69.2;60.3;0.0
69;2021-08-23;3388;11557;0;1302536;1142948;7;69.4;60.9;0.0
69;2021-08-24;4406;12099;0;1306942;1155047;7;69.7;61.6;0.0
69;2021-08-25;3881;11448;0;1310823;1166495;7;69.9;62.2;0.0
69;2021-08-26;3842;10083;0;1314665;1176578;7;70.1;62.7;0.0
69;2021-08-27;3934;12789;0;1318599;1189367;7;70.3;63.4;0.0
69;2021-08-28;1695;7406;0;1320294;1196773;7;70.4;63.8;0.0
69;2021-08-29;1090;5371;0;1321384;1202144;7;70.4;64.1;0.0
69;2021-08-30;3016;10161;87;1324400;1212305;94;70.6;64.6;0.0
69;2021-08-31;3584;8626;196;1327984;1220931;290;70.8;65.1;0.0
69;2021-09-01;3918;7917;379;1331902;1228848;669;71.0;65.5;0.0
69;2021-09-02;3735;6952;900;1335637;1235800;1569;71.2;65.9;0.1
69;2021-09-03;3583;8929;852;1339220;1244729;2421;71.4;66.3;0.1
69;2021-09-04;1978;6908;214;1341198;1251637;2635;71.5;66.7;0.1
69;2021-09-05;1121;2897;230;1342319;1254534;2865;71.6;66.9;0.2
69;2021-09-06;2164;5010;818;1344483;1259544;3683;71.7;67.1;0.2
69;2021-09-07;1989;4588;956;1346472;1264132;4639;71.8;67.4;0.2
69;2021-09-08;2439;5356;704;1348911;1269488;5343;71.9;67.7;0.3
69;2021-09-09;2131;4473;1002;1351042;1273961;6345;72.0;67.9;0.3
69;2021-09-10;2423;5397;1051;1353465;1279358;7396;72.1;68.2;0.4
69;2021-09-11;1476;4153;218;1354941;1283511;7614;72.2;68.4;0.4
69;2021-09-12;408;1715;112;1355349;1285226;7726;72.2;68.5;0.4
69;2021-09-13;1508;3521;1043;1356857;1288747;8769;72.3;68.7;0.5
69;2021-09-14;1614;3137;1502;1358471;1291884;10271;72.4;68.9;0.5
69;2021-09-15;1781;4173;1207;1360252;1296057;11478;72.5;69.1;0.6
69;2021-09-16;1425;2686;1522;1361677;1298743;13000;72.6;69.2;0.7
69;2021-09-17;1641;4103;1577;1363318;1302846;14577;72.7;69.4;0.8
69;2021-09-18;1007;3504;265;1364325;1306350;14842;72.7;69.6;0.8
69;2021-09-19;383;1188;121;1364708;1307538;14963;72.7;69.7;0.8
69;2021-09-20;892;2370;1036;1365600;1309908;15999;72.8;69.8;0.9
69;2021-09-21;880;2622;1474;1366480;1312530;17473;72.8;70.0;0.9
69;2021-09-22;1033;3573;1095;1367513;1316103;18568;72.9;70.2;1.0
69;2021-09-23;805;2518;1470;1368318;1318621;20038;72.9;70.3;1.1
69;2021-09-24;1155;3481;1074;1369473;1322102;21112;73.0;70.5;1.1
69;2021-09-25;666;2334;228;1370139;1324436;21340;73.0;70.6;1.1
69;2021-09-26;264;959;64;1370403;1325395;21404;73.0;70.6;1.1
69;2021-09-27;604;1735;964;1371007;1327130;22368;73.1;70.7;1.2
69;2021-09-28;773;1698;1312;1371780;1328828;23680;73.1;70.8;1.3
69;2021-09-29;1026;2737;1214;1372806;1331565;24894;73.2;71.0;1.3
69;2021-09-30;876;1864;1293;1373682;1333429;26187;73.2;71.1;1.4
69;2021-10-01;1742;2988;1767;1375424;1336417;27954;73.3;71.2;1.5
69;2021-10-02;926;1876;407;1376350;1338293;28361;73.4;71.3;1.5
69;2021-10-03;258;516;160;1376608;1338809;28521;73.4;71.4;1.5
69;2021-10-04;917;1655;1374;1377525;1340464;29895;73.4;71.5;1.6
69;2021-10-05;767;1332;1508;1378292;1341796;31403;73.5;71.5;1.7
69;2021-10-06;1071;2014;1605;1379363;1343810;33008;73.5;71.6;1.8
69;2021-10-07;820;1404;1764;1380183;1345214;34772;73.6;71.7;1.9
69;2021-10-08;1221;2146;2193;1381404;1347360;36965;73.6;71.8;2.0
69;2021-10-09;652;1212;584;1382056;1348572;37549;73.7;71.9;2.0
69;2021-10-10;68;271;132;1382124;1348843;37681;73.7;71.9;2.0
69;2021-10-11;589;1199;1485;1382713;1350042;39166;73.7;72.0;2.1
69;2021-10-12;693;1046;1777;1383406;1351088;40943;73.7;72.0;2.2
69;2021-10-13;1059;1682;2264;1384465;1352770;43207;73.8;72.1;2.3
69;2021-10-14;768;1207;2248;1385233;1353977;45455;73.8;72.2;2.4
69;2021-10-15;1092;1704;2877;1386325;1355681;48332;73.9;72.3;2.6
69;2021-10-16;704;1130;751;1387029;1356811;49083;73.9;72.3;2.6
69;2021-10-17;31;157;64;1387060;1356968;49147;73.9;72.3;2.6
69;2021-10-18;539;813;1876;1387599;1357781;51023;74.0;72.4;2.7
69;2021-10-19;294;728;2175;1387893;1358509;53198;74.0;72.4;2.8
69;2021-10-20;582;1179;2887;1388475;1359688;56085;74.0;72.5;3.0
69;2021-10-21;336;842;2718;1388811;1360530;58803;74.0;72.5;3.1
69;2021-10-22;511;1278;3081;1389322;1361808;61884;74.1;72.6;3.3
69;2021-10-23;456;989;1176;1389778;1362797;63060;74.1;72.6;3.4
69;2021-10-24;21;87;89;1389799;1362884;63149;74.1;72.6;3.4
69;2021-10-25;340;721;2128;1390139;1363605;65277;74.1;72.7;3.5
69;2021-10-26;307;621;2152;1390446;1364226;67429;74.1;72.7;3.6
69;2021-10-27;473;1186;3332;1390919;1365412;70761;74.1;72.8;3.8
69;2021-10-28;371;716;2682;1391290;1366128;73443;74.2;72.8;3.9
69;2021-10-29;438;1024;3363;1391728;1367152;76806;74.2;72.9;4.1
69;2021-10-30;226;610;1048;1391954;1367762;77854;74.2;72.9;4.1
69;2021-10-31;26;69;69;1391980;1367831;77923;74.2;72.9;4.2
69;2021-11-01;94;47;24;1392074;1367878;77947;74.2;72.9;4.2
69;2021-11-02;316;748;2259;1392390;1368626;80206;74.2;73.0;4.3
69;2021-11-03;426;972;3709;1392816;1369598;83915;74.2;73.0;4.5
69;2021-11-04;346;722;3416;1393162;1370320;87331;74.3;73.0;4.7
69;2021-11-05;468;993;4451;1393630;1371313;91782;74.3;73.1;4.9
69;2021-11-06;229;604;1352;1393859;1371917;93134;74.3;73.1;5.0
69;2021-11-07;24;49;102;1393883;1371966;93236;74.3;73.1;5.0
69;2021-11-08;200;568;3164;1394083;1372534;96400;74.3;73.2;5.1
69;2021-11-09;218;510;4114;1394301;1373044;100514;74.3;73.2;5.4
69;2021-11-10;453;845;4956;1394754;1373889;105470;74.3;73.2;5.6
69;2021-11-11;80;120;714;1394834;1374009;106184;74.3;73.2;5.7
69;2021-11-12;403;649;5910;1395237;1374658;112094;74.4;73.3;6.0
69;2021-11-13;285;440;1956;1395522;1375098;114050;74.4;73.3;6.1
69;2021-11-14;17;35;165;1395539;1375133;114215;74.4;73.3;6.1
69;2021-11-15;208;442;3933;1395747;1375575;118148;74.4;73.3;6.3
69;2021-11-16;277;478;5072;1396024;1376053;123220;74.4;73.3;6.6
69;2021-11-17;443;671;5510;1396467;1376724;128730;74.4;73.4;6.9
69;2021-11-18;247;418;5713;1396714;1377142;134443;74.4;73.4;7.2
69;2021-11-19;492;724;7567;1397206;1377866;142010;74.5;73.4;7.6
69;2021-11-20;331;375;2223;1397537;1378241;144233;74.5;73.5;7.7
69;2021-11-21;23;71;147;1397560;1378312;144380;74.5;73.5;7.7
69;2021-11-22;282;352;4621;1397842;1378664;149001;74.5;73.5;7.9
69;2021-11-23;282;344;5304;1398124;1379008;154305;74.5;73.5;8.2
69;2021-11-24;468;610;6185;1398592;1379618;160490;74.5;73.5;8.6
69;2021-11-25;295;426;7255;1398887;1380044;167745;74.6;73.6;8.9
69;2021-11-26;401;596;11814;1399288;1380640;179559;74.6;73.6;9.6
69;2021-11-27;366;546;6273;1399654;1381186;185832;74.6;73.6;9.9
69;2021-11-28;32;68;586;1399686;1381254;186418;74.6;73.6;9.9
69;2021-11-29;207;320;8164;1399893;1381574;194582;74.6;73.6;10.4
69;2021-11-30;251;383;10773;1400144;1381957;205355;74.6;73.7;10.9
69;2021-12-01;322;523;11725;1400466;1382480;217080;74.6;73.7;11.6
69;2021-12-02;261;344;14177;1400727;1382824;231257;74.7;73.7;12.3
69;2021-12-03;305;541;17444;1401032;1383365;248701;74.7;73.7;13.3
69;2021-12-04;186;413;9266;1401218;1383778;257967;74.7;73.8;13.8
69;2021-12-05;32;88;3261;1401250;1383866;261228;74.7;73.8;13.9
69;2021-12-06;197;395;12682;1401447;1384261;273910;74.7;73.8;14.6
69;2021-12-07;256;436;16256;1401703;1384697;290166;74.7;73.8;15.5
69;2021-12-08;331;580;13916;1402034;1385277;304082;74.7;73.8;16.2
69;2021-12-09;247;402;16951;1402281;1385679;321033;74.7;73.9;17.1
69;2021-12-10;307;534;19455;1402588;1386213;340488;74.8;73.9;18.1
69;2021-12-11;209;405;9121;1402797;1386618;349609;74.8;73.9;18.6
69;2021-12-12;41;98;2869;1402838;1386716;352478;74.8;73.9;18.8
69;2021-12-13;251;423;17101;1403089;1387139;369579;74.8;73.9;19.7
69;2021-12-14;281;393;21191;1403370;1387532;390770;74.8;74.0;20.8
69;2021-12-15;306;535;18766;1403676;1388067;409536;74.8;74.0;21.8
69;2021-12-16;300;465;22281;1403976;1388532;431817;74.8;74.0;23.0
70;2020-12-27;0;0;0;0;0;0;0.0;0.0;0.0
70;2020-12-28;0;0;0;0;0;0;0.0;0.0;0.0
70;2020-12-29;0;0;0;0;0;0;0.0;0.0;0.0
70;2020-12-30;0;0;0;0;0;0;0.0;0.0;0.0
70;2020-12-31;0;0;0;0;0;0;0.0;0.0;0.0
70;2021-01-01;1;0;0;1;0;0;0.0;0.0;0.0
70;2021-01-02;0;0;0;1;0;0;0.0;0.0;0.0
70;2021-01-03;0;0;0;1;0;0;0.0;0.0;0.0
70;2021-01-04;0;0;0;1;0;0;0.0;0.0;0.0
70;2021-01-05;2;1;0;3;1;0;0.0;0.0;0.0
70;2021-01-06;26;0;0;29;1;0;0.0;0.0;0.0
70;2021-01-07;129;0;0;158;1;0;0.1;0.0;0.0
70;2021-01-08;67;0;0;225;1;0;0.1;0.0;0.0
70;2021-01-09;19;1;0;244;2;0;0.1;0.0;0.0
70;2021-01-10;0;0;0;244;2;0;0.1;0.0;0.0
70;2021-01-11;175;1;0;419;3;0;0.2;0.0;0.0
70;2021-01-12;240;2;0;659;5;0;0.3;0.0;0.0
70;2021-01-13;219;2;0;878;7;0;0.4;0.0;0.0
70;2021-01-14;214;5;0;1092;12;0;0.5;0.0;0.0
70;2021-01-15;218;3;0;1310;15;0;0.6;0.0;0.0
70;2021-01-16;81;0;0;1391;15;0;0.6;0.0;0.0
70;2021-01-17;7;0;0;1398;15;0;0.6;0.0;0.0
70;2021-01-18;418;0;0;1816;15;0;0.8;0.0;0.0
70;2021-01-19;493;2;0;2309;17;0;1.0;0.0;0.0
70;2021-01-20;495;1;0;2804;18;0;1.2;0.0;0.0
70;2021-01-21;671;3;0;3475;21;0;1.5;0.0;0.0
70;2021-01-22;503;3;0;3978;24;0;1.7;0.0;0.0
70;2021-01-23;250;2;0;4228;26;0;1.8;0.0;0.0
70;2021-01-24;13;0;0;4241;26;0;1.8;0.0;0.0
70;2021-01-25;381;1;0;4622;27;0;2.0;0.0;0.0
70;2021-01-26;367;3;0;4989;30;0;2.1;0.0;0.0
70;2021-01-27;344;14;0;5333;44;0;2.3;0.0;0.0
70;2021-01-28;351;39;0;5684;83;0;2.4;0.0;0.0
70;2021-01-29;329;86;0;6013;169;0;2.6;0.1;0.0
70;2021-01-30;249;20;0;6262;189;0;2.7;0.1;0.0
70;2021-01-31;1;0;0;6263;189;0;2.7;0.1;0.0
70;2021-02-01;260;58;0;6523;247;0;2.8;0.1;0.0
70;2021-02-02;289;127;0;6812;374;0;2.9;0.2;0.0
70;2021-02-03;261;87;0;7073;461;0;3.0;0.2;0.0
70;2021-02-04;288;157;0;7361;618;0;3.2;0.3;0.0
70;2021-02-05;263;117;0;7624;735;0;3.3;0.3;0.0
70;2021-02-06;212;45;0;7836;780;0;3.4;0.3;0.0
70;2021-02-07;0;0;0;7836;780;0;3.4;0.3;0.0
70;2021-02-08;184;250;0;8020;1030;0;3.4;0.4;0.0
70;2021-02-09;211;245;0;8231;1275;0;3.5;0.5;0.0
70;2021-02-10;243;294;0;8474;1569;0;3.6;0.7;0.0
70;2021-02-11;377;365;0;8851;1934;0;3.8;0.8;0.0
70;2021-02-12;228;499;0;9079;2433;0;3.9;1.0;0.0
70;2021-02-13;93;223;0;9172;2656;0;3.9;1.1;0.0
70;2021-02-14;1;31;0;9173;2687;0;3.9;1.2;0.0
70;2021-02-15;82;383;0;9255;3070;0;4.0;1.3;0.0
70;2021-02-16;115;439;0;9370;3509;0;4.0;1.5;0.0
70;2021-02-17;172;362;0;9542;3871;0;4.1;1.7;0.0
70;2021-02-18;213;300;0;9755;4171;0;4.2;1.8;0.0
70;2021-02-19;195;230;0;9950;4401;0;4.3;1.9;0.0
70;2021-02-20;193;91;0;10143;4492;0;4.3;1.9;0.0
70;2021-02-21;3;9;0;10146;4501;0;4.4;1.9;0.0
70;2021-02-22;114;245;0;10260;4746;0;4.4;2.0;0.0
70;2021-02-23;129;271;0;10389;5017;0;4.5;2.2;0.0
70;2021-02-24;157;267;0;10546;5284;0;4.5;2.3;0.0
70;2021-02-25;348;261;0;10894;5545;0;4.7;2.4;0.0
70;2021-02-26;392;184;0;11286;5729;0;4.8;2.5;0.0
70;2021-02-27;157;223;0;11443;5952;0;4.9;2.6;0.0
70;2021-02-28;0;3;0;11443;5955;0;4.9;2.6;0.0
70;2021-03-01;275;254;0;11718;6209;0;5.0;2.7;0.0
70;2021-03-02;497;290;0;12215;6499;0;5.2;2.8;0.0
70;2021-03-03;483;270;0;12698;6769;0;5.4;2.9;0.0
70;2021-03-04;694;296;0;13392;7065;0;5.7;3.0;0.0
70;2021-03-05;787;276;0;14179;7341;0;6.1;3.1;0.0
70;2021-03-06;546;121;0;14725;7462;0;6.3;3.2;0.0
70;2021-03-07;230;24;0;14955;7486;0;6.4;3.2;0.0
70;2021-03-08;563;241;0;15518;7727;0;6.7;3.3;0.0
70;2021-03-09;860;219;0;16378;7946;0;7.0;3.4;0.0
70;2021-03-10;654;214;0;17032;8160;0;7.3;3.5;0.0
70;2021-03-11;786;269;0;17818;8429;0;7.6;3.6;0.0
70;2021-03-12;1055;183;0;18873;8612;0;8.1;3.7;0.0
70;2021-03-13;614;128;0;19487;8740;0;8.4;3.7;0.0
70;2021-03-14;22;4;0;19509;8744;0;8.4;3.7;0.0
70;2021-03-15;748;107;0;20257;8851;0;8.7;3.8;0.0
70;2021-03-16;651;103;0;20908;8954;0;9.0;3.8;0.0
70;2021-03-17;580;179;0;21488;9133;0;9.2;3.9;0.0
70;2021-03-18;645;147;0;22133;9280;0;9.5;4.0;0.0
70;2021-03-19;981;149;0;23114;9429;0;9.9;4.0;0.0
70;2021-03-20;652;187;0;23766;9616;0;10.2;4.1;0.0
70;2021-03-21;13;0;0;23779;9616;0;10.2;4.1;0.0
70;2021-03-22;807;100;0;24586;9716;0;10.5;4.2;0.0
70;2021-03-23;1320;174;0;25906;9890;0;11.1;4.2;0.0
70;2021-03-24;1279;113;0;27185;10003;0;11.7;4.3;0.0
70;2021-03-25;1283;199;0;28468;10202;0;12.2;4.4;0.0
70;2021-03-26;1540;304;0;30008;10506;0;12.9;4.5;0.0
70;2021-03-27;983;123;0;30991;10629;0;13.3;4.6;0.0
70;2021-03-28;10;14;0;31001;10643;0;13.3;4.6;0.0
70;2021-03-29;734;399;0;31735;11042;0;13.6;4.7;0.0
70;2021-03-30;1095;289;0;32830;11331;0;14.1;4.9;0.0
70;2021-03-31;934;310;0;33764;11641;0;14.5;5.0;0.0
70;2021-04-01;1170;415;0;34934;12056;0;15.0;5.2;0.0
70;2021-04-02;1272;330;0;36206;12386;0;15.5;5.3;0.0
70;2021-04-03;617;307;0;36823;12693;0;15.8;5.4;0.0
70;2021-04-04;9;3;0;36832;12696;0;15.8;5.4;0.0
70;2021-04-05;9;2;0;36841;12698;0;15.8;5.4;0.0
70;2021-04-06;822;543;0;37663;13241;0;16.2;5.7;0.0
70;2021-04-07;862;580;0;38525;13821;0;16.5;5.9;0.0
70;2021-04-08;1337;553;0;39862;14374;0;17.1;6.2;0.0
70;2021-04-09;1445;568;0;41307;14942;0;17.7;6.4;0.0
70;2021-04-10;847;319;0;42154;15261;0;18.1;6.5;0.0
70;2021-04-11;32;7;0;42186;15268;0;18.1;6.5;0.0
70;2021-04-12;712;666;0;42898;15934;0;18.4;6.8;0.0
70;2021-04-13;991;778;0;43889;16712;0;18.8;7.2;0.0
70;2021-04-14;859;566;0;44748;17278;0;19.2;7.4;0.0
70;2021-04-15;1161;610;0;45909;17888;0;19.7;7.7;0.0
70;2021-04-16;1271;551;0;47180;18439;0;20.2;7.9;0.0
70;2021-04-17;684;469;0;47864;18908;0;20.5;8.1;0.0
70;2021-04-18;62;6;0;47926;18914;0;20.6;8.1;0.0
70;2021-04-19;577;846;0;48503;19760;0;20.8;8.5;0.0
70;2021-04-20;737;855;0;49240;20615;0;21.1;8.8;0.0
70;2021-04-21;564;904;0;49804;21519;0;21.4;9.2;0.0
70;2021-04-22;843;854;0;50647;22373;0;21.7;9.6;0.0
70;2021-04-23;926;800;0;51573;23173;0;22.1;9.9;0.0
70;2021-04-24;457;650;0;52030;23823;0;22.3;10.2;0.0
70;2021-04-25;17;7;0;52047;23830;0;22.3;10.2;0.0
70;2021-04-26;1064;647;0;53111;24477;0;22.8;10.5;0.0
70;2021-04-27;1220;800;0;54331;25277;0;23.3;10.8;0.0
70;2021-04-28;958;821;0;55289;26098;0;23.7;11.2;0.0
70;2021-04-29;1406;915;0;56695;27013;0;24.3;11.6;0.0
70;2021-04-30;1585;907;0;58280;27920;0;25.0;12.0;0.0
70;2021-05-01;1583;130;0;59863;28050;0;25.7;12.0;0.0
70;2021-05-02;33;5;0;59896;28055;0;25.7;12.0;0.0
70;2021-05-03;1236;565;0;61132;28620;0;26.2;12.3;0.0
70;2021-05-04;1330;796;0;62462;29416;0;26.8;12.6;0.0
70;2021-05-05;1211;886;0;63673;30302;0;27.3;13.0;0.0
70;2021-05-06;1850;1289;0;65523;31591;0;28.1;13.5;0.0
70;2021-05-07;2089;1298;0;67612;32889;0;29.0;14.1;0.0
70;2021-05-08;1224;189;0;68836;33078;0;29.5;14.2;0.0
70;2021-05-09;38;64;0;68874;33142;0;29.5;14.2;0.0
70;2021-05-10;1048;970;0;69922;34112;0;30.0;14.6;0.0
70;2021-05-11;1279;1128;0;71201;35240;0;30.5;15.1;0.0
70;2021-05-12;1208;901;0;72409;36141;0;31.1;15.5;0.0
70;2021-05-13;1552;169;0;73961;36310;0;31.7;15.6;0.0
70;2021-05-14;2095;741;0;76056;37051;0;32.6;15.9;0.0
70;2021-05-15;2366;505;0;78422;37556;0;33.6;16.1;0.0
70;2021-05-16;900;68;0;79322;37624;0;34.0;16.1;0.0
70;2021-05-17;1278;390;0;80600;38014;0;34.6;16.3;0.0
70;2021-05-18;1398;602;0;81998;38616;0;35.2;16.6;0.0
70;2021-05-19;1564;554;0;83562;39170;0;35.8;16.8;0.0
70;2021-05-20;1722;652;0;85284;39822;0;36.6;17.1;0.0
70;2021-05-21;1776;866;0;87060;40688;0;37.3;17.4;0.0
70;2021-05-22;1146;651;0;88206;41339;0;37.8;17.7;0.0
70;2021-05-23;59;20;0;88265;41359;0;37.9;17.7;0.0
70;2021-05-24;236;45;0;88501;41404;0;38.0;17.8;0.0
70;2021-05-25;953;947;0;89454;42351;0;38.4;18.2;0.0
70;2021-05-26;1040;963;0;90494;43314;0;38.8;18.6;0.0
70;2021-05-27;1301;1021;0;91795;44335;0;39.4;19.0;0.0
70;2021-05-28;1511;1219;0;93306;45554;0;40.0;19.5;0.0
70;2021-05-29;1252;578;0;94558;46132;0;40.5;19.8;0.0
70;2021-05-30;10;22;0;94568;46154;0;40.6;19.8;0.0
70;2021-05-31;1007;717;0;95575;46871;0;41.0;20.1;0.0
70;2021-06-01;1283;927;0;96858;47798;0;41.5;20.5;0.0
70;2021-06-02;1146;755;0;98004;48553;0;42.0;20.8;0.0
70;2021-06-03;1344;930;0;99348;49483;0;42.6;21.2;0.0
70;2021-06-04;1387;1181;0;100735;50664;0;43.2;21.7;0.0
70;2021-06-05;960;638;0;101695;51302;0;43.6;22.0;0.0
70;2021-06-06;564;85;0;102259;51387;0;43.9;22.0;0.0
70;2021-06-07;1072;1029;0;103331;52416;0;44.3;22.5;0.0
70;2021-06-08;1300;1219;0;104631;53635;0;44.9;23.0;0.0
70;2021-06-09;1126;982;0;105757;54617;0;45.4;23.4;0.0
70;2021-06-10;1400;903;0;107157;55520;0;46.0;23.8;0.0
70;2021-06-11;1587;1947;0;108744;57467;0;46.6;24.6;0.0
70;2021-06-12;856;1892;0;109600;59359;0;47.0;25.5;0.0
70;2021-06-13;191;28;0;109791;59387;0;47.1;25.5;0.0
70;2021-06-14;550;1237;0;110341;60624;0;47.3;26.0;0.0
70;2021-06-15;548;1470;0;110889;62094;0;47.6;26.6;0.0
70;2021-06-16;718;1383;0;111607;63477;0;47.9;27.2;0.0
70;2021-06-17;1010;2110;0;112617;65587;0;48.3;28.1;0.0
70;2021-06-18;1054;2254;0;113671;67841;0;48.7;29.1;0.0
70;2021-06-19;1060;1524;0;114731;69365;0;49.2;29.7;0.0
70;2021-06-20;11;19;0;114742;69384;0;49.2;29.8;0.0
70;2021-06-21;696;1477;0;115438;70861;0;49.5;30.4;0.0
70;2021-06-22;683;1610;0;116121;72471;0;49.8;31.1;0.0
70;2021-06-23;628;1551;0;116749;74022;0;50.1;31.7;0.0
70;2021-06-24;805;2044;0;117554;76066;0;50.4;32.6;0.0
70;2021-06-25;693;2628;0;118247;78694;0;50.7;33.7;0.0
70;2021-06-26;862;2025;0;119109;80719;0;51.1;34.6;0.0
70;2021-06-27;162;709;0;119271;81428;0;51.1;34.9;0.0
70;2021-06-28;369;1449;0;119640;82877;0;51.3;35.5;0.0
70;2021-06-29;413;1735;0;120053;84612;0;51.5;36.3;0.0
70;2021-06-30;441;1723;0;120494;86335;0;51.7;37.0;0.0
70;2021-07-01;634;1763;0;121128;88098;0;51.9;37.8;0.0
70;2021-07-02;846;1637;0;121974;89735;0;52.3;38.5;0.0
70;2021-07-03;785;1030;0;122759;90765;0;52.6;38.9;0.0
70;2021-07-04;42;95;0;122801;90860;0;52.7;39.0;0.0
70;2021-07-05;616;1111;0;123417;91971;0;52.9;39.4;0.0
70;2021-07-06;687;1382;0;124104;93353;0;53.2;40.0;0.0
70;2021-07-07;531;1430;0;124635;94783;0;53.4;40.6;0.0
70;2021-07-08;733;1495;0;125368;96278;0;53.8;41.3;0.0
70;2021-07-09;848;1746;0;126216;98024;0;54.1;42.0;0.0
70;2021-07-10;745;1040;0;126961;99064;0;54.4;42.5;0.0
70;2021-07-11;18;48;0;126979;99112;0;54.5;42.5;0.0
70;2021-07-12;455;1420;0;127434;100532;0;54.6;43.1;0.0
70;2021-07-13;933;1917;0;128367;102449;0;55.0;43.9;0.0
70;2021-07-14;72;32;0;128439;102481;0;55.1;43.9;0.0
70;2021-07-15;1296;1676;0;129735;104157;0;55.6;44.7;0.0
70;2021-07-16;1601;2077;0;131336;106234;0;56.3;45.6;0.0
70;2021-07-17;1354;1420;0;132690;107654;0;56.9;46.2;0.0
70;2021-07-18;853;618;0;133543;108272;0;57.3;46.4;0.0
70;2021-07-19;933;1147;0;134476;109419;0;57.7;46.9;0.0
70;2021-07-20;1321;1412;0;135797;110831;0;58.2;47.5;0.0
70;2021-07-21;1224;1352;0;137021;112183;0;58.8;48.1;0.0
70;2021-07-22;1677;1630;0;138698;113813;0;59.5;48.8;0.0
70;2021-07-23;1576;2325;0;140274;116138;0;60.2;49.8;0.0
70;2021-07-24;1245;1745;0;141519;117883;0;60.7;50.6;0.0
70;2021-07-25;83;69;0;141602;117952;0;60.7;50.6;0.0
70;2021-07-26;1121;1041;0;142723;118993;0;61.2;51.0;0.0
70;2021-07-27;1406;1000;0;144129;119993;0;61.8;51.5;0.0
70;2021-07-28;1316;1067;0;145445;121060;0;62.4;51.9;0.0
70;2021-07-29;1723;1239;0;147168;122299;0;63.1;52.4;0.0
70;2021-07-30;1893;1324;0;149061;123623;0;63.9;53.0;0.0
70;2021-07-31;1583;1061;0;150644;124684;0;64.6;53.5;0.0
70;2021-08-01;114;17;0;150758;124701;0;64.6;53.5;0.0
70;2021-08-02;803;752;0;151561;125453;0;65.0;53.8;0.0
70;2021-08-03;1287;1036;0;152848;126489;0;65.5;54.2;0.0
70;2021-08-04;1099;857;0;153947;127346;0;66.0;54.6;0.0
70;2021-08-05;1426;1071;0;155373;128417;0;66.6;55.1;0.0
70;2021-08-06;1598;1309;0;156971;129726;0;67.3;55.6;0.0
70;2021-08-07;1040;972;0;158011;130698;0;67.8;56.0;0.0
70;2021-08-08;50;79;0;158061;130777;0;67.8;56.1;0.0
70;2021-08-09;544;830;0;158605;131607;0;68.0;56.4;0.0
70;2021-08-10;882;1195;0;159487;132802;0;68.4;56.9;0.0
70;2021-08-11;724;783;0;160211;133585;0;68.7;57.3;0.0
70;2021-08-12;830;1241;0;161041;134826;0;69.1;57.8;0.0
70;2021-08-13;968;1529;0;162009;136355;0;69.5;58.5;0.0
70;2021-08-14;684;955;0;162693;137310;0;69.8;58.9;0.0
70;2021-08-15;43;36;0;162736;137346;0;69.8;58.9;0.0
70;2021-08-16;541;936;0;163277;138282;0;70.0;59.3;0.0
70;2021-08-17;625;1293;0;163902;139575;0;70.3;59.9;0.0
70;2021-08-18;486;948;0;164388;140523;0;70.5;60.3;0.0
70;2021-08-19;511;1309;0;164899;141832;0;70.7;60.8;0.0
70;2021-08-20;493;1872;0;165392;143704;0;70.9;61.6;0.0
70;2021-08-21;409;1108;0;165801;144812;0;71.1;62.1;0.0
70;2021-08-22;22;109;0;165823;144921;0;71.1;62.1;0.0
70;2021-08-23;305;951;0;166128;145872;0;71.2;62.6;0.0
70;2021-08-24;377;1361;0;166505;147233;0;71.4;63.1;0.0
70;2021-08-25;321;1245;0;166826;148478;0;71.5;63.7;0.0
70;2021-08-26;418;1397;0;167244;149875;0;71.7;64.3;0.0
70;2021-08-27;395;1993;0;167639;151868;0;71.9;65.1;0.0
70;2021-08-28;351;1529;0;167990;153397;0;72.0;65.8;0.0
70;2021-08-29;19;45;0;168009;153442;0;72.0;65.8;0.0
70;2021-08-30;302;813;4;168311;154255;4;72.2;66.1;0.0
70;2021-08-31;357;1128;11;168668;155383;15;72.3;66.6;0.0
70;2021-09-01;309;885;200;168977;156268;215;72.5;67.0;0.1
70;2021-09-02;283;981;166;169260;157249;381;72.6;67.4;0.2
70;2021-09-03;297;1022;188;169557;158271;569;72.7;67.9;0.2
70;2021-09-04;453;1022;136;170010;159293;705;72.9;68.3;0.3
70;2021-09-05;23;33;9;170033;159326;714;72.9;68.3;0.3
70;2021-09-06;155;595;96;170188;159921;810;73.0;68.6;0.3
70;2021-09-07;202;730;135;170390;160651;945;73.1;68.9;0.4
70;2021-09-08;192;756;102;170582;161407;1047;73.2;69.2;0.4
70;2021-09-09;181;675;138;170763;162082;1185;73.2;69.5;0.5
70;2021-09-10;252;783;124;171015;162865;1309;73.3;69.8;0.6
70;2021-09-11;288;800;82;171303;163665;1391;73.5;70.2;0.6
70;2021-09-12;19;44;6;171322;163709;1397;73.5;70.2;0.6
70;2021-09-13;165;369;156;171487;164078;1553;73.5;70.4;0.7
70;2021-09-14;321;400;158;171808;164478;1711;73.7;70.5;0.7
70;2021-09-15;183;485;138;171991;164963;1849;73.8;70.7;0.8
70;2021-09-16;233;386;177;172224;165349;2026;73.9;70.9;0.9
70;2021-09-17;228;483;122;172452;165832;2148;74.0;71.1;0.9
70;2021-09-18;163;434;80;172615;166266;2228;74.0;71.3;1.0
70;2021-09-19;3;23;0;172618;166289;2228;74.0;71.3;1.0
70;2021-09-20;101;212;123;172719;166501;2351;74.1;71.4;1.0
70;2021-09-21;151;275;154;172870;166776;2505;74.1;71.5;1.1
70;2021-09-22;99;347;130;172969;167123;2635;74.2;71.7;1.1
70;2021-09-23;68;207;203;173037;167330;2838;74.2;71.8;1.2
70;2021-09-24;189;394;162;173226;167724;3000;74.3;71.9;1.3
70;2021-09-25;136;462;115;173362;168186;3115;74.3;72.1;1.3
70;2021-09-26;2;6;0;173364;168192;3115;74.3;72.1;1.3
70;2021-09-27;58;209;105;173422;168401;3220;74.4;72.2;1.4
70;2021-09-28;79;191;235;173501;168592;3455;74.4;72.3;1.5
70;2021-09-29;102;242;154;173603;168834;3609;74.4;72.4;1.5
70;2021-09-30;101;168;235;173704;169002;3844;74.5;72.5;1.6
70;2021-10-01;137;267;222;173841;169269;4066;74.5;72.6;1.7
70;2021-10-02;116;304;152;173957;169573;4218;74.6;72.7;1.8
70;2021-10-03;2;2;2;173959;169575;4220;74.6;72.7;1.8
70;2021-10-04;80;168;185;174039;169743;4405;74.6;72.8;1.9
70;2021-10-05;87;283;228;174126;170026;4633;74.7;72.9;2.0
70;2021-10-06;127;216;237;174253;170242;4870;74.7;73.0;2.1
70;2021-10-07;89;210;301;174342;170452;5171;74.8;73.1;2.2
70;2021-10-08;151;247;329;174493;170699;5500;74.8;73.2;2.4
70;2021-10-09;140;293;170;174633;170992;5670;74.9;73.3;2.4
70;2021-10-10;4;4;15;174637;170996;5685;74.9;73.3;2.4
70;2021-10-11;72;119;194;174709;171115;5879;74.9;73.4;2.5
70;2021-10-12;51;117;266;174760;171232;6145;74.9;73.4;2.6
70;2021-10-13;99;176;342;174859;171408;6487;75.0;73.5;2.8
70;2021-10-14;53;116;198;174912;171524;6685;75.0;73.6;2.9
70;2021-10-15;153;207;373;175065;171731;7058;75.1;73.6;3.0
70;2021-10-16;131;165;255;175196;171896;7313;75.1;73.7;3.1
70;2021-10-17;4;12;0;175200;171908;7313;75.1;73.7;3.1
70;2021-10-18;55;100;209;175255;172008;7522;75.2;73.8;3.2
70;2021-10-19;78;83;339;175333;172091;7861;75.2;73.8;3.4
70;2021-10-20;106;137;364;175439;172228;8225;75.2;73.9;3.5
70;2021-10-21;55;90;386;175494;172318;8611;75.3;73.9;3.7
70;2021-10-22;96;139;570;175590;172457;9181;75.3;74.0;3.9
70;2021-10-23;127;166;281;175717;172623;9462;75.4;74.0;4.1
70;2021-10-24;2;2;1;175719;172625;9463;75.4;74.0;4.1
70;2021-10-25;51;78;309;175770;172703;9772;75.4;74.1;4.2
70;2021-10-26;52;88;321;175822;172791;10093;75.4;74.1;4.3
70;2021-10-27;80;122;443;175902;172913;10536;75.4;74.1;4.5
70;2021-10-28;44;69;240;175946;172982;10776;75.5;74.2;4.6
70;2021-10-29;107;140;460;176053;173122;11236;75.5;74.2;4.8
70;2021-10-30;70;131;247;176123;173253;11483;75.5;74.3;4.9
70;2021-10-31;1;2;0;176124;173255;11483;75.5;74.3;4.9
70;2021-11-01;7;5;1;176131;173260;11484;75.5;74.3;4.9
70;2021-11-02;67;103;430;176198;173363;11914;75.6;74.3;5.1
70;2021-11-03;83;129;585;176281;173492;12499;75.6;74.4;5.4
70;2021-11-04;38;44;332;176319;173536;12831;75.6;74.4;5.5
70;2021-11-05;97;144;863;176416;173680;13694;75.7;74.5;5.9
70;2021-11-06;103;143;497;176519;173823;14191;75.7;74.5;6.1
70;2021-11-07;1;4;0;176520;173827;14191;75.7;74.5;6.1
70;2021-11-08;43;71;563;176563;173898;14754;75.7;74.6;6.3
70;2021-11-09;46;76;704;176609;173974;15458;75.7;74.6;6.6
70;2021-11-10;86;127;837;176695;174101;16295;75.8;74.7;7.0
70;2021-11-11;0;5;5;176695;174106;16300;75.8;74.7;7.0
70;2021-11-12;103;134;891;176798;174240;17191;75.8;74.7;7.4
70;2021-11-13;99;148;708;176897;174388;17899;75.9;74.8;7.7
70;2021-11-14;3;7;7;176900;174395;17906;75.9;74.8;7.7
70;2021-11-15;38;44;679;176938;174439;18585;75.9;74.8;8.0
70;2021-11-16;35;38;670;176973;174477;19255;75.9;74.8;8.3
70;2021-11-17;94;117;1043;177067;174594;20298;75.9;74.9;8.7
70;2021-11-18;43;63;719;177110;174657;21017;75.9;74.9;9.0
70;2021-11-19;104;111;995;177214;174768;22012;76.0;74.9;9.4
70;2021-11-20;124;106;590;177338;174874;22602;76.0;75.0;9.7
70;2021-11-21;0;3;2;177338;174877;22604;76.0;75.0;9.7
70;2021-11-22;45;35;782;177383;174912;23386;76.1;75.0;10.0
70;2021-11-23;42;45;901;177425;174957;24287;76.1;75.0;10.4
70;2021-11-24;94;98;1187;177519;175055;25474;76.1;75.1;10.9
70;2021-11-25;62;55;779;177581;175110;26253;76.2;75.1;11.3
70;2021-11-26;108;99;1679;177689;175209;27932;76.2;75.1;12.0
70;2021-11-27;115;134;1034;177804;175343;28966;76.2;75.2;12.4
70;2021-11-28;1;2;47;177805;175345;29013;76.2;75.2;12.4
70;2021-11-29;22;41;1130;177827;175386;30143;76.3;75.2;12.9
70;2021-11-30;71;51;1813;177898;175437;31956;76.3;75.2;13.7
70;2021-12-01;81;106;1791;177979;175543;33747;76.3;75.3;14.5
70;2021-12-02;55;35;2156;178034;175578;35903;76.3;75.3;15.4
70;2021-12-03;67;103;2607;178101;175681;38510;76.4;75.3;16.5
70;2021-12-04;81;101;1998;178182;175782;40508;76.4;75.4;17.4
70;2021-12-05;22;11;443;178204;175793;40951;76.4;75.4;17.6
70;2021-12-06;33;62;1504;178237;175855;42455;76.4;75.4;18.2
70;2021-12-07;73;39;2617;178310;175894;45072;76.5;75.4;19.3
70;2021-12-08;58;89;2340;178368;175983;47412;76.5;75.5;20.3
70;2021-12-09;49;75;3031;178417;176058;50443;76.5;75.5;21.6
70;2021-12-10;68;93;3575;178485;176151;54018;76.5;75.5;23.2
70;2021-12-11;81;135;2734;178566;176286;56752;76.6;75.6;24.3
70;2021-12-12;32;7;557;178598;176293;57309;76.6;75.6;24.6
70;2021-12-13;50;46;2036;178648;176339;59345;76.6;75.6;25.4
70;2021-12-14;76;45;2932;178724;176384;62277;76.6;75.6;26.7
70;2021-12-15;65;78;2584;178789;176462;64861;76.7;75.7;27.8
70;2021-12-16;86;73;3299;178875;176535;68160;76.7;75.7;29.2
71;2020-12-27;1;0;0;1;0;0;0.0;0.0;0.0
71;2020-12-28;8;0;0;9;0;0;0.0;0.0;0.0
71;2020-12-29;2;0;0;11;0;0;0.0;0.0;0.0
71;2020-12-30;0;0;0;11;0;0;0.0;0.0;0.0
71;2020-12-31;0;0;0;11;0;0;0.0;0.0;0.0
71;2021-01-01;92;0;0;103;0;0;0.0;0.0;0.0
71;2021-01-02;7;0;0;110;0;0;0.0;0.0;0.0
71;2021-01-03;0;0;0;110;0;0;0.0;0.0;0.0
71;2021-01-04;3;0;0;113;0;0;0.0;0.0;0.0
71;2021-01-05;15;1;0;128;1;0;0.0;0.0;0.0
71;2021-01-06;75;0;0;203;1;0;0.0;0.0;0.0
71;2021-01-07;78;1;0;281;2;0;0.1;0.0;0.0
71;2021-01-08;152;0;0;433;2;0;0.1;0.0;0.0
71;2021-01-09;93;0;0;526;2;0;0.1;0.0;0.0
71;2021-01-10;2;0;0;528;2;0;0.1;0.0;0.0
71;2021-01-11;237;0;0;765;2;0;0.1;0.0;0.0
71;2021-01-12;770;1;0;1535;3;0;0.3;0.0;0.0
71;2021-01-13;550;2;0;2085;5;0;0.4;0.0;0.0
71;2021-01-14;590;7;0;2675;12;0;0.5;0.0;0.0
71;2021-01-15;641;2;0;3316;14;0;0.6;0.0;0.0
71;2021-01-16;23;0;0;3339;14;0;0.6;0.0;0.0
71;2021-01-17;3;0;0;3342;14;0;0.6;0.0;0.0
71;2021-01-18;954;5;0;4296;19;0;0.8;0.0;0.0
71;2021-01-19;1579;7;0;5875;26;0;1.1;0.0;0.0
71;2021-01-20;1494;8;0;7369;34;0;1.3;0.0;0.0
71;2021-01-21;1913;15;0;9282;49;0;1.7;0.0;0.0
71;2021-01-22;1348;4;0;10630;53;0;1.9;0.0;0.0
71;2021-01-23;772;6;0;11402;59;0;2.1;0.0;0.0
71;2021-01-24;2;0;0;11404;59;0;2.1;0.0;0.0
71;2021-01-25;1009;7;0;12413;66;0;2.3;0.0;0.0
71;2021-01-26;1535;28;0;13948;94;0;2.5;0.0;0.0
71;2021-01-27;1166;33;0;15114;127;0;2.8;0.0;0.0
71;2021-01-28;1092;100;0;16206;227;0;3.0;0.0;0.0
71;2021-01-29;1026;137;0;17232;364;0;3.1;0.1;0.0
71;2021-01-30;584;2;0;17816;366;0;3.3;0.1;0.0
71;2021-01-31;5;15;0;17821;381;0;3.3;0.1;0.0
71;2021-02-01;747;210;0;18568;591;0;3.4;0.1;0.0
71;2021-02-02;780;332;0;19348;923;0;3.5;0.2;0.0
71;2021-02-03;763;401;0;20111;1324;0;3.7;0.2;0.0
71;2021-02-04;736;569;0;20847;1893;0;3.8;0.3;0.0
71;2021-02-05;703;502;0;21550;2395;0;3.9;0.4;0.0
71;2021-02-06;513;21;0;22063;2416;0;4.0;0.4;0.0
71;2021-02-07;3;46;0;22066;2462;0;4.0;0.4;0.0
71;2021-02-08;605;630;0;22671;3092;0;4.1;0.6;0.0
71;2021-02-09;385;972;0;23056;4064;0;4.2;0.7;0.0
71;2021-02-10;418;937;0;23474;5001;0;4.3;0.9;0.0
71;2021-02-11;512;1207;0;23986;6208;0;4.4;1.1;0.0
71;2021-02-12;543;1006;0;24529;7214;0;4.5;1.3;0.0
71;2021-02-13;146;509;0;24675;7723;0;4.5;1.4;0.0
71;2021-02-14;8;4;0;24683;7727;0;4.5;1.4;0.0
71;2021-02-15;311;875;0;24994;8602;0;4.6;1.6;0.0
71;2021-02-16;386;1332;0;25380;9934;0;4.6;1.8;0.0
71;2021-02-17;437;1106;0;25817;11040;0;4.7;2.0;0.0
71;2021-02-18;499;878;0;26316;11918;0;4.8;2.2;0.0
71;2021-02-19;525;748;0;26841;12666;0;4.9;2.3;0.0
71;2021-02-20;221;368;0;27062;13034;0;4.9;2.4;0.0
71;2021-02-21;0;11;0;27062;13045;0;4.9;2.4;0.0
71;2021-02-22;227;855;0;27289;13900;0;5.0;2.5;0.0
71;2021-02-23;448;952;0;27737;14852;0;5.1;2.7;0.0
71;2021-02-24;444;761;0;28181;15613;0;5.1;2.9;0.0
71;2021-02-25;530;757;0;28711;16370;0;5.2;3.0;0.0
71;2021-02-26;846;568;0;29557;16938;0;5.4;3.1;0.0
71;2021-02-27;468;339;0;30025;17277;0;5.5;3.2;0.0
71;2021-02-28;56;17;0;30081;17294;0;5.5;3.2;0.0
71;2021-03-01;1140;703;0;31221;17997;0;5.7;3.3;0.0
71;2021-03-02;1509;716;0;32730;18713;0;6.0;3.4;0.0
71;2021-03-03;1751;756;0;34481;19469;0;6.3;3.6;0.0
71;2021-03-04;1997;823;0;36478;20292;0;6.7;3.7;0.0
71;2021-03-05;2252;682;0;38730;20974;0;7.1;3.8;0.0
71;2021-03-06;793;74;0;39523;21048;0;7.2;3.8;0.0
71;2021-03-07;74;13;0;39597;21061;0;7.2;3.8;0.0
71;2021-03-08;1424;798;0;41021;21859;0;7.5;4.0;0.0
71;2021-03-09;2111;593;0;43132;22452;0;7.9;4.1;0.0
71;2021-03-10;2122;461;0;45254;22913;0;8.3;4.2;0.0
71;2021-03-11;2580;681;0;47834;23594;0;8.7;4.3;0.0
71;2021-03-12;2534;610;0;50368;24204;0;9.2;4.4;0.0
71;2021-03-13;1081;104;0;51449;24308;0;9.4;4.4;0.0
71;2021-03-14;58;8;0;51507;24316;0;9.4;4.4;0.0
71;2021-03-15;1776;478;0;53283;24794;0;9.7;4.5;0.0
71;2021-03-16;1768;218;0;55051;25012;0;10.0;4.6;0.0
71;2021-03-17;2079;259;0;57130;25271;0;10.4;4.6;0.0
71;2021-03-18;1891;455;0;59021;25726;0;10.8;4.7;0.0
71;2021-03-19;2322;327;0;61343;26053;0;11.2;4.8;0.0
71;2021-03-20;1029;52;0;62372;26105;0;11.4;4.8;0.0
71;2021-03-21;25;4;0;62397;26109;0;11.4;4.8;0.0
71;2021-03-22;2447;372;0;64844;26481;0;11.8;4.8;0.0
71;2021-03-23;3285;487;0;68129;26968;0;12.4;4.9;0.0
71;2021-03-24;3187;457;0;71316;27425;0;13.0;5.0;0.0
71;2021-03-25;3866;559;0;75182;27984;0;13.7;5.1;0.0
71;2021-03-26;3809;335;0;78991;28319;0;14.4;5.2;0.0
71;2021-03-27;937;101;0;79928;28420;0;14.6;5.2;0.0
71;2021-03-28;75;11;0;80003;28431;0;14.6;5.2;0.0
71;2021-03-29;2321;1113;0;82324;29544;0;15.0;5.4;0.0
71;2021-03-30;3000;1311;0;85324;30855;0;15.6;5.6;0.0
71;2021-03-31;2453;1495;0;87777;32350;0;16.0;5.9;0.0
71;2021-04-01;2645;1281;0;90422;33631;0;16.5;6.1;0.0
71;2021-04-02;2385;1403;0;92807;35034;0;16.9;6.4;0.0
71;2021-04-03;297;48;0;93104;35082;0;17.0;6.4;0.0
71;2021-04-04;22;8;0;93126;35090;0;17.0;6.4;0.0
71;2021-04-05;95;2;0;93221;35092;0;17.0;6.4;0.0
71;2021-04-06;2096;1827;0;95317;36919;0;17.4;6.7;0.0
71;2021-04-07;2276;1743;0;97593;38662;0;17.8;7.1;0.0
71;2021-04-08;3156;1757;0;100749;40419;0;18.4;7.4;0.0
71;2021-04-09;3870;1619;0;104619;42038;0;19.1;7.7;0.0
71;2021-04-10;830;97;0;105449;42135;0;19.2;7.7;0.0
71;2021-04-11;108;13;0;105557;42148;0;19.3;7.7;0.0
71;2021-04-12;2278;1673;0;107835;43821;0;19.7;8.0;0.0
71;2021-04-13;2528;1832;0;110363;45653;0;20.1;8.3;0.0
71;2021-04-14;2318;1904;0;112681;47557;0;20.6;8.7;0.0
71;2021-04-15;2701;1653;0;115382;49210;0;21.1;9.0;0.0
71;2021-04-16;2564;1668;0;117946;50878;0;21.5;9.3;0.0
71;2021-04-17;947;356;0;118893;51234;0;21.7;9.4;0.0
71;2021-04-18;126;20;0;119019;51254;0;21.7;9.4;0.0
71;2021-04-19;1637;2361;0;120656;53615;0;22.0;9.8;0.0
71;2021-04-20;2104;2435;0;122760;56050;0;22.4;10.2;0.0
71;2021-04-21;2008;2371;0;124768;58421;0;22.8;10.7;0.0
71;2021-04-22;2371;2253;0;127139;60674;0;23.2;11.1;0.0
71;2021-04-23;2695;2088;0;129834;62762;0;23.7;11.5;0.0
71;2021-04-24;574;103;0;130408;62865;0;23.8;11.5;0.0
71;2021-04-25;43;7;0;130451;62872;0;23.8;11.5;0.0
71;2021-04-26;2277;1990;0;132728;64862;0;24.2;11.8;0.0
71;2021-04-27;2815;2177;0;135543;67039;0;24.7;12.2;0.0
71;2021-04-28;2893;2098;0;138436;69137;0;25.3;12.6;0.0
71;2021-04-29;3530;2102;0;141966;71239;0;25.9;13.0;0.0
71;2021-04-30;3689;1595;0;145655;72834;0;26.6;13.3;0.0
71;2021-05-01;137;64;0;145792;72898;0;26.6;13.3;0.0
71;2021-05-02;57;33;0;145849;72931;0;26.6;13.3;0.0
71;2021-05-03;3913;1402;0;149762;74333;0;27.3;13.6;0.0
71;2021-05-04;2763;2240;0;152525;76573;0;27.8;14.0;0.0
71;2021-05-05;3173;1976;0;155698;78549;0;28.4;14.3;0.0
71;2021-05-06;3363;2199;0;159061;80748;0;29.0;14.7;0.0
71;2021-05-07;3419;2619;0;162480;83367;0;29.7;15.2;0.0
71;2021-05-08;309;220;0;162789;83587;0;29.7;15.3;0.0
71;2021-05-09;93;56;0;162882;83643;0;29.7;15.3;0.0
71;2021-05-10;3362;2196;0;166244;85839;0;30.3;15.7;0.0
71;2021-05-11;4227;2258;0;170471;88097;0;31.1;16.1;0.0
71;2021-05-12;3781;2425;0;174252;90522;0;31.8;16.5;0.0
71;2021-05-13;1541;176;0;175793;90698;0;32.1;16.6;0.0
71;2021-05-14;3642;2034;0;179435;92732;0;32.8;16.9;0.0
71;2021-05-15;652;336;0;180087;93068;0;32.9;17.0;0.0
71;2021-05-16;87;17;0;180174;93085;0;32.9;17.0;0.0
71;2021-05-17;3699;1769;0;183873;94854;0;33.6;17.3;0.0
71;2021-05-18;3360;2288;0;187233;97142;0;34.2;17.7;0.0
71;2021-05-19;3764;2152;0;190997;99294;0;34.9;18.1;0.0
71;2021-05-20;4301;2176;0;195298;101470;0;35.6;18.5;0.0
71;2021-05-21;3766;2394;0;199064;103864;0;36.3;19.0;0.0
71;2021-05-22;631;369;0;199695;104233;0;36.5;19.0;0.0
71;2021-05-23;100;60;0;199795;104293;0;36.5;19.0;0.0
71;2021-05-24;400;144;0;200195;104437;0;36.5;19.1;0.0
71;2021-05-25;2714;2896;0;202909;107333;0;37.0;19.6;0.0
71;2021-05-26;3086;2323;0;205995;109656;0;37.6;20.0;0.0
71;2021-05-27;3554;2414;0;209549;112070;0;38.3;20.5;0.0
71;2021-05-28;2980;2999;0;212529;115069;0;38.8;21.0;0.0
71;2021-05-29;891;719;0;213420;115788;0;39.0;21.1;0.0
71;2021-05-30;127;82;0;213547;115870;0;39.0;21.2;0.0
71;2021-05-31;2755;3229;0;216302;119099;0;39.5;21.7;0.0
71;2021-06-01;3520;3390;0;219822;122489;0;40.1;22.4;0.0
71;2021-06-02;3837;2535;0;223659;125024;0;40.8;22.8;0.0
71;2021-06-03;4146;2434;0;227805;127458;0;41.6;23.3;0.0
71;2021-06-04;3677;3428;0;231482;130886;0;42.3;23.9;0.0
71;2021-06-05;1118;729;0;232600;131615;0;42.5;24.0;0.0
71;2021-06-06;138;103;0;232738;131718;0;42.5;24.0;0.0
71;2021-06-07;3189;3701;0;235927;135419;0;43.1;24.7;0.0
71;2021-06-08;3793;3646;0;239720;139065;0;43.8;25.4;0.0
71;2021-06-09;4406;2612;0;244126;141677;0;44.6;25.9;0.0
71;2021-06-10;4930;2720;0;249056;144397;0;45.5;26.4;0.0
71;2021-06-11;4122;3510;0;253178;147907;0;46.2;27.0;0.0
71;2021-06-12;1063;684;0;254241;148591;0;46.4;27.1;0.0
71;2021-06-13;153;200;0;254394;148791;0;46.4;27.2;0.0
71;2021-06-14;3176;3554;0;257570;152345;0;47.0;27.8;0.0
71;2021-06-15;3810;3342;0;261380;155687;0;47.7;28.4;0.0
71;2021-06-16;4183;2617;0;265563;158304;0;48.5;28.9;0.0
71;2021-06-17;3978;2912;0;269541;161216;0;49.2;29.4;0.0
71;2021-06-18;3956;3477;0;273497;164693;0;49.9;30.1;0.0
71;2021-06-19;1292;838;0;274789;165531;0;50.2;30.2;0.0
71;2021-06-20;70;70;0;274859;165601;0;50.2;30.2;0.0
71;2021-06-21;2035;3929;0;276894;169530;0;50.5;30.9;0.0
71;2021-06-22;2447;4193;0;279341;173723;0;51.0;31.7;0.0
71;2021-06-23;2866;3303;0;282207;177026;0;51.5;32.3;0.0
71;2021-06-24;3107;2896;0;285314;179922;0;52.1;32.8;0.0
71;2021-06-25;2455;4351;0;287769;184273;0;52.5;33.6;0.0
71;2021-06-26;503;1005;0;288272;185278;0;52.6;33.8;0.0
71;2021-06-27;60;121;0;288332;185399;0;52.6;33.8;0.0
71;2021-06-28;1445;4404;0;289777;189803;0;52.9;34.6;0.0
71;2021-06-29;1837;4594;0;291614;194397;0;53.2;35.5;0.0
71;2021-06-30;2299;3857;0;293913;198254;0;53.7;36.2;0.0
71;2021-07-01;2503;3807;0;296416;202061;0;54.1;36.9;0.0
71;2021-07-02;2722;3927;0;299138;205988;0;54.6;37.6;0.0
71;2021-07-03;403;1090;0;299541;207078;0;54.7;37.8;0.0
71;2021-07-04;51;192;0;299592;207270;0;54.7;37.8;0.0
71;2021-07-05;2133;4172;0;301725;211442;0;55.1;38.6;0.0
71;2021-07-06;2136;4351;0;303861;215793;0;55.5;39.4;0.0
71;2021-07-07;2569;3577;0;306430;219370;0;55.9;40.0;0.0
71;2021-07-08;2446;3971;0;308876;223341;0;56.4;40.8;0.0
71;2021-07-09;2119;4760;0;310995;228101;0;56.8;41.6;0.0
71;2021-07-10;363;1000;0;311358;229101;0;56.8;41.8;0.0
71;2021-07-11;60;118;0;311418;229219;0;56.8;41.8;0.0
71;2021-07-12;1764;4968;0;313182;234187;0;57.2;42.7;0.0
71;2021-07-13;2416;5457;0;315598;239644;0;57.6;43.7;0.0
71;2021-07-14;1037;470;0;316635;240114;0;57.8;43.8;0.0
71;2021-07-15;2809;5360;0;319444;245474;0;58.3;44.8;0.0
71;2021-07-16;3397;5676;0;322841;251150;0;58.9;45.8;0.0
71;2021-07-17;982;1280;0;323823;252430;0;59.1;46.1;0.0
71;2021-07-18;162;176;0;323985;252606;0;59.1;46.1;0.0
71;2021-07-19;2865;5241;0;326850;257847;0;59.7;47.1;0.0
71;2021-07-20;3256;5559;0;330106;263406;0;60.3;48.1;0.0
71;2021-07-21;3524;5106;0;333630;268512;0;60.9;49.0;0.0
71;2021-07-22;3836;5024;0;337466;273536;0;61.6;49.9;0.0
71;2021-07-23;3271;5645;0;340737;279181;0;62.2;51.0;0.0
71;2021-07-24;1055;1072;0;341792;280253;0;62.4;51.2;0.0
71;2021-07-25;253;153;0;342045;280406;0;62.4;51.2;0.0
71;2021-07-26;3454;4467;0;345499;284873;0;63.1;52.0;0.0
71;2021-07-27;3943;4555;0;349442;289428;0;63.8;52.8;0.0
71;2021-07-28;4172;4406;0;353614;293834;0;64.5;53.6;0.0
71;2021-07-29;4112;4304;0;357726;298138;0;65.3;54.4;0.0
71;2021-07-30;4116;4474;0;361842;302612;0;66.1;55.2;0.0
71;2021-07-31;1043;894;0;362885;303506;0;66.2;55.4;0.0
71;2021-08-01;222;105;0;363107;303611;0;66.3;55.4;0.0
71;2021-08-02;3769;3393;0;366876;307004;0;67.0;56.0;0.0
71;2021-08-03;4078;3518;0;370954;310522;0;67.7;56.7;0.0
71;2021-08-04;4055;2823;0;375009;313345;0;68.5;57.2;0.0
71;2021-08-05;3926;3092;0;378935;316437;0;69.2;57.8;0.0
71;2021-08-06;3499;3835;0;382434;320272;0;69.8;58.5;0.0
71;2021-08-07;669;684;0;383103;320956;0;69.9;58.6;0.0
71;2021-08-08;108;119;0;383211;321075;0;70.0;58.6;0.0
71;2021-08-09;2617;3057;0;385828;324132;0;70.4;59.2;0.0
71;2021-08-10;2763;3144;0;388591;327276;0;70.9;59.7;0.0
71;2021-08-11;2895;3008;0;391486;330284;0;71.5;60.3;0.0
71;2021-08-12;2773;3041;0;394259;333325;0;72.0;60.8;0.0
71;2021-08-13;2476;3185;0;396735;336510;0;72.4;61.4;0.0
71;2021-08-14;369;779;0;397104;337289;0;72.5;61.6;0.0
71;2021-08-15;71;185;0;397175;337474;0;72.5;61.6;0.0
71;2021-08-16;1488;3219;0;398663;340693;0;72.8;62.2;0.0
71;2021-08-17;1579;3094;0;400242;343787;0;73.1;62.8;0.0
71;2021-08-18;1359;2980;0;401601;346767;0;73.3;63.3;0.0
71;2021-08-19;1226;2827;0;402827;349594;0;73.5;63.8;0.0
71;2021-08-20;1202;3590;0;404029;353184;0;73.8;64.5;0.0
71;2021-08-21;211;721;0;404240;353905;0;73.8;64.6;0.0
71;2021-08-22;62;148;0;404302;354053;0;73.8;64.6;0.0
71;2021-08-23;1247;4226;0;405549;358279;0;74.0;65.4;0.0
71;2021-08-24;1187;3534;0;406736;361813;0;74.2;66.0;0.0
71;2021-08-25;881;3588;0;407617;365401;0;74.4;66.7;0.0
71;2021-08-26;893;3248;0;408510;368649;0;74.6;67.3;0.0
71;2021-08-27;1045;4153;0;409555;372802;0;74.8;68.1;0.0
71;2021-08-28;236;641;0;409791;373443;0;74.8;68.2;0.0
71;2021-08-29;37;154;0;409828;373597;0;74.8;68.2;0.0
71;2021-08-30;1092;3505;51;410920;377102;51;75.0;68.8;0.0
71;2021-08-31;907;3117;157;411827;380219;208;75.2;69.4;0.0
71;2021-09-01;898;3123;313;412725;383342;521;75.3;70.0;0.1
71;2021-09-02;609;2663;294;413334;386005;815;75.5;70.5;0.1
71;2021-09-03;811;3469;378;414145;389474;1193;75.6;71.1;0.2
71;2021-09-04;301;692;66;414446;390166;1259;75.7;71.2;0.2
71;2021-09-05;30;104;8;414476;390270;1267;75.7;71.2;0.2
71;2021-09-06;598;2083;404;415074;392353;1671;75.8;71.6;0.3
71;2021-09-07;504;1577;536;415578;393930;2207;75.9;71.9;0.4
71;2021-09-08;657;2028;413;416235;395958;2620;76.0;72.3;0.5
71;2021-09-09;441;1251;561;416676;397209;3181;76.1;72.5;0.6
71;2021-09-10;749;1956;616;417425;399165;3797;76.2;72.9;0.7
71;2021-09-11;232;409;68;417657;399574;3865;76.2;72.9;0.7
71;2021-09-12;27;51;13;417684;399625;3878;76.2;72.9;0.7
71;2021-09-13;611;1212;348;418295;400837;4226;76.4;73.2;0.8
71;2021-09-14;481;978;506;418776;401815;4732;76.4;73.3;0.9
71;2021-09-15;577;1387;565;419353;403202;5297;76.5;73.6;1.0
71;2021-09-16;448;805;527;419801;404007;5824;76.6;73.7;1.1
71;2021-09-17;526;1303;595;420327;405310;6419;76.7;74.0;1.2
71;2021-09-18;159;324;119;420486;405634;6538;76.8;74.0;1.2
71;2021-09-19;16;35;9;420502;405669;6547;76.8;74.1;1.2
71;2021-09-20;433;817;531;420935;406486;7078;76.8;74.2;1.3
71;2021-09-21;274;644;705;421209;407130;7783;76.9;74.3;1.4
71;2021-09-22;310;1181;600;421519;408311;8383;76.9;74.5;1.5
71;2021-09-23;279;568;537;421798;408879;8920;77.0;74.6;1.6
71;2021-09-24;348;945;562;422146;409824;9482;77.1;74.8;1.7
71;2021-09-25;78;237;62;422224;410061;9544;77.1;74.9;1.7
71;2021-09-26;10;40;4;422234;410101;9548;77.1;74.9;1.7
71;2021-09-27;272;678;601;422506;410779;10149;77.1;75.0;1.9
71;2021-09-28;275;453;704;422781;411232;10853;77.2;75.1;2.0
71;2021-09-29;306;703;668;423087;411935;11521;77.2;75.2;2.1
71;2021-09-30;209;478;722;423296;412413;12243;77.3;75.3;2.2
71;2021-10-01;402;807;967;423698;413220;13210;77.3;75.4;2.4
71;2021-10-02;129;230;135;423827;413450;13345;77.4;75.5;2.4
71;2021-10-03;5;16;35;423832;413466;13380;77.4;75.5;2.4
71;2021-10-04;258;535;618;424090;414001;13998;77.4;75.6;2.6
71;2021-10-05;197;379;644;424287;414380;14642;77.4;75.6;2.7
71;2021-10-06;378;643;820;424665;415023;15462;77.5;75.8;2.8
71;2021-10-07;156;358;651;424821;415381;16113;77.5;75.8;2.9
71;2021-10-08;338;645;1086;425159;416026;17199;77.6;75.9;3.1
71;2021-10-09;79;193;165;425238;416219;17364;77.6;76.0;3.2
71;2021-10-10;9;21;23;425247;416240;17387;77.6;76.0;3.2
71;2021-10-11;265;511;740;425512;416751;18127;77.7;76.1;3.3
71;2021-10-12;182;361;743;425694;417112;18870;77.7;76.1;3.4
71;2021-10-13;297;446;927;425991;417558;19797;77.8;76.2;3.6
71;2021-10-14;159;283;759;426150;417841;20556;77.8;76.3;3.8
71;2021-10-15;280;527;1262;426430;418368;21818;77.8;76.4;4.0
71;2021-10-16;114;139;161;426544;418507;21979;77.9;76.4;4.0
71;2021-10-17;3;13;26;426547;418520;22005;77.9;76.4;4.0
71;2021-10-18;235;362;1094;426782;418882;23099;77.9;76.5;4.2
71;2021-10-19;168;280;1055;426950;419162;24154;77.9;76.5;4.4
71;2021-10-20;285;432;1505;427235;419594;25659;78.0;76.6;4.7
71;2021-10-21;129;188;961;427364;419782;26620;78.0;76.6;4.9
71;2021-10-22;233;337;1327;427597;420119;27947;78.1;76.7;5.1
71;2021-10-23;84;117;165;427681;420236;28112;78.1;76.7;5.1
71;2021-10-24;6;30;27;427687;420266;28139;78.1;76.7;5.1
71;2021-10-25;201;299;1067;427888;420565;29206;78.1;76.8;5.3
71;2021-10-26;137;202;939;428025;420767;30145;78.1;76.8;5.5
71;2021-10-27;186;322;1279;428211;421089;31424;78.2;76.9;5.7
71;2021-10-28;132;150;844;428343;421239;32268;78.2;76.9;5.9
71;2021-10-29;197;313;1294;428540;421552;33562;78.2;77.0;6.1
71;2021-10-30;69;121;192;428609;421673;33754;78.2;77.0;6.2
71;2021-10-31;9;14;48;428618;421687;33802;78.2;77.0;6.2
71;2021-11-01;15;9;2;428633;421696;33804;78.2;77.0;6.2
71;2021-11-02;174;242;1326;428807;421938;35130;78.3;77.0;6.4
71;2021-11-03;191;354;1389;428998;422292;36519;78.3;77.1;6.7
71;2021-11-04;132;161;1091;429130;422453;37610;78.3;77.1;6.9
71;2021-11-05;227;307;2100;429357;422760;39710;78.4;77.2;7.2
71;2021-11-06;75;101;292;429432;422861;40002;78.4;77.2;7.3
71;2021-11-07;1;4;22;429433;422865;40024;78.4;77.2;7.3
71;2021-11-08;155;246;1691;429588;423111;41715;78.4;77.2;7.6
71;2021-11-09;96;194;1773;429684;423305;43488;78.4;77.3;7.9
71;2021-11-10;218;297;2041;429902;423602;45529;78.5;77.3;8.3
71;2021-11-11;15;22;87;429917;423624;45616;78.5;77.3;8.3
71;2021-11-12;192;293;2143;430109;423917;47759;78.5;77.4;8.7
71;2021-11-13;60;78;338;430169;423995;48097;78.5;77.4;8.8
71;2021-11-14;4;9;8;430173;424004;48105;78.5;77.4;8.8
71;2021-11-15;138;200;1929;430311;424204;50034;78.5;77.4;9.1
71;2021-11-16;137;162;2078;430448;424366;52112;78.6;77.5;9.5
71;2021-11-17;185;237;2152;430633;424603;54264;78.6;77.5;9.9
71;2021-11-18;123;152;1734;430756;424755;55998;78.6;77.5;10.2
71;2021-11-19;220;277;2673;430976;425032;58671;78.7;77.6;10.7
71;2021-11-20;70;55;489;431046;425087;59160;78.7;77.6;10.8
71;2021-11-21;5;18;87;431051;425105;59247;78.7;77.6;10.8
71;2021-11-22;200;139;2458;431251;425244;61705;78.7;77.6;11.3
71;2021-11-23;138;179;2188;431389;425423;63893;78.7;77.7;11.7
71;2021-11-24;274;280;2694;431663;425703;66587;78.8;77.7;12.2
71;2021-11-25;149;144;2270;431812;425847;68857;78.8;77.7;12.6
71;2021-11-26;269;288;4013;432081;426135;72870;78.9;77.8;13.3
71;2021-11-27;88;98;737;432169;426233;73607;78.9;77.8;13.4
71;2021-11-28;12;18;126;432181;426251;73733;78.9;77.8;13.5
71;2021-11-29;175;166;3719;432356;426417;77452;78.9;77.8;14.1
71;2021-11-30;177;169;4379;432533;426586;81831;79.0;77.9;14.9
71;2021-12-01;181;246;4732;432714;426832;86563;79.0;77.9;15.8
71;2021-12-02;141;90;4482;432855;426922;91045;79.0;77.9;16.6
71;2021-12-03;161;253;5936;433016;427175;96981;79.0;78.0;17.7
71;2021-12-04;93;114;2039;433109;427289;99020;79.1;78.0;18.1
71;2021-12-05;8;16;197;433117;427305;99217;79.1;78.0;18.1
71;2021-12-06;132;211;5904;433249;427516;105121;79.1;78.0;19.2
71;2021-12-07;154;196;7280;433403;427712;112401;79.1;78.1;20.5
71;2021-12-08;159;195;6262;433562;427907;118663;79.1;78.1;21.7
71;2021-12-09;159;171;6850;433721;428078;125513;79.2;78.1;22.9
71;2021-12-10;175;229;7082;433896;428307;132595;79.2;78.2;24.2
71;2021-12-11;95;99;2469;433991;428406;135064;79.2;78.2;24.7
71;2021-12-12;14;10;367;434005;428416;135431;79.2;78.2;24.7
71;2021-12-13;144;187;6575;434149;428603;142006;79.2;78.2;25.9
71;2021-12-14;161;183;7837;434310;428786;149843;79.3;78.3;27.4
71;2021-12-15;150;281;6820;434460;429067;156663;79.3;78.3;28.6
71;2021-12-16;155;166;7318;434615;429233;163981;79.3;78.4;29.9
72;2020-12-27;0;0;0;0;0;0;0.0;0.0;0.0
72;2020-12-28;2;0;0;2;0;0;0.0;0.0;0.0
72;2020-12-29;0;0;0;2;0;0;0.0;0.0;0.0
72;2020-12-30;0;0;0;2;0;0;0.0;0.0;0.0
72;2020-12-31;0;0;0;2;0;0;0.0;0.0;0.0
72;2021-01-01;1;0;0;3;0;0;0.0;0.0;0.0
72;2021-01-02;0;0;0;3;0;0;0.0;0.0;0.0
72;2021-01-03;0;0;0;3;0;0;0.0;0.0;0.0
72;2021-01-04;1;0;0;4;0;0;0.0;0.0;0.0
72;2021-01-05;15;0;0;19;0;0;0.0;0.0;0.0
72;2021-01-06;42;0;0;61;0;0;0.0;0.0;0.0
72;2021-01-07;142;1;0;203;1;0;0.0;0.0;0.0
72;2021-01-08;255;1;0;458;2;0;0.1;0.0;0.0
72;2021-01-09;48;0;0;506;2;0;0.1;0.0;0.0
72;2021-01-10;14;0;0;520;2;0;0.1;0.0;0.0
72;2021-01-11;513;1;0;1033;3;0;0.2;0.0;0.0
72;2021-01-12;621;1;0;1654;4;0;0.3;0.0;0.0
72;2021-01-13;563;2;0;2217;6;0;0.4;0.0;0.0
72;2021-01-14;672;4;0;2889;10;0;0.5;0.0;0.0
72;2021-01-15;505;1;0;3394;11;0;0.6;0.0;0.0
72;2021-01-16;120;0;0;3514;11;0;0.6;0.0;0.0
72;2021-01-17;34;1;0;3548;12;0;0.6;0.0;0.0
72;2021-01-18;407;1;0;3955;13;0;0.7;0.0;0.0
72;2021-01-19;859;5;0;4814;18;0;0.9;0.0;0.0
72;2021-01-20;1506;6;0;6320;24;0;1.1;0.0;0.0
72;2021-01-21;1790;6;0;8110;30;0;1.4;0.0;0.0
72;2021-01-22;1139;6;0;9249;36;0;1.7;0.0;0.0
72;2021-01-23;73;1;0;9322;37;0;1.7;0.0;0.0
72;2021-01-24;12;0;0;9334;37;0;1.7;0.0;0.0
72;2021-01-25;570;6;0;9904;43;0;1.8;0.0;0.0
72;2021-01-26;1214;23;0;11118;66;0;2.0;0.0;0.0
72;2021-01-27;961;24;0;12079;90;0;2.2;0.0;0.0
72;2021-01-28;859;70;0;12938;160;0;2.3;0.0;0.0
72;2021-01-29;712;67;0;13650;227;0;2.4;0.0;0.0
72;2021-01-30;101;1;0;13751;228;0;2.5;0.0;0.0
72;2021-01-31;2;1;0;13753;229;0;2.5;0.0;0.0
72;2021-02-01;552;248;0;14305;477;0;2.6;0.1;0.0
72;2021-02-02;559;295;0;14864;772;0;2.7;0.1;0.0
72;2021-02-03;545;259;0;15409;1031;0;2.8;0.2;0.0
72;2021-02-04;546;367;0;15955;1398;0;2.8;0.2;0.0
72;2021-02-05;532;441;0;16487;1839;0;2.9;0.3;0.0
72;2021-02-06;108;37;0;16595;1876;0;3.0;0.3;0.0
72;2021-02-07;18;6;0;16613;1882;0;3.0;0.3;0.0
72;2021-02-08;350;441;0;16963;2323;0;3.0;0.4;0.0
72;2021-02-09;527;557;0;17490;2880;0;3.1;0.5;0.0
72;2021-02-10;594;924;0;18084;3804;0;3.2;0.7;0.0
72;2021-02-11;941;1351;0;19025;5155;0;3.4;0.9;0.0
72;2021-02-12;891;588;0;19916;5743;0;3.6;1.0;0.0
72;2021-02-13;131;71;0;20047;5814;0;3.6;1.0;0.0
72;2021-02-14;1;40;0;20048;5854;0;3.6;1.0;0.0
72;2021-02-15;266;598;0;20314;6452;0;3.6;1.2;0.0
72;2021-02-16;529;1049;0;20843;7501;0;3.7;1.3;0.0
72;2021-02-17;484;755;0;21327;8256;0;3.8;1.5;0.0
72;2021-02-18;639;721;0;21966;8977;0;3.9;1.6;0.0
72;2021-02-19;557;640;0;22523;9617;0;4.0;1.7;0.0
72;2021-02-20;87;88;0;22610;9705;0;4.0;1.7;0.0
72;2021-02-21;0;3;0;22610;9708;0;4.0;1.7;0.0
72;2021-02-22;345;646;0;22955;10354;0;4.1;1.8;0.0
72;2021-02-23;603;635;0;23558;10989;0;4.2;2.0;0.0
72;2021-02-24;505;603;0;24063;11592;0;4.3;2.1;0.0
72;2021-02-25;929;642;0;24992;12234;0;4.5;2.2;0.0
72;2021-02-26;665;592;0;25657;12826;0;4.6;2.3;0.0
72;2021-02-27;336;97;0;25993;12923;0;4.6;2.3;0.0
72;2021-02-28;15;19;0;26008;12942;0;4.6;2.3;0.0
72;2021-03-01;383;515;0;26391;13457;0;4.7;2.4;0.0
72;2021-03-02;522;665;0;26913;14122;0;4.8;2.5;0.0
72;2021-03-03;743;691;0;27656;14813;0;4.9;2.6;0.0
72;2021-03-04;764;839;0;28420;15652;0;5.1;2.8;0.0
72;2021-03-05;953;752;0;29373;16404;0;5.2;2.9;0.0
72;2021-03-06;815;163;0;30188;16567;0;5.4;3.0;0.0
72;2021-03-07;421;25;0;30609;16592;0;5.5;3.0;0.0
72;2021-03-08;568;487;0;31177;17079;0;5.6;3.0;0.0
72;2021-03-09;1095;645;0;32272;17724;0;5.8;3.2;0.0
72;2021-03-10;1220;651;0;33492;18375;0;6.0;3.3;0.0
72;2021-03-11;1670;522;0;35162;18897;0;6.3;3.4;0.0
72;2021-03-12;1505;519;0;36667;19416;0;6.5;3.5;0.0
72;2021-03-13;1068;133;0;37735;19549;0;6.7;3.5;0.0
72;2021-03-14;25;8;0;37760;19557;0;6.7;3.5;0.0
72;2021-03-15;1210;215;0;38970;19772;0;7.0;3.5;0.0
72;2021-03-16;1115;196;0;40085;19968;0;7.2;3.6;0.0
72;2021-03-17;1105;270;0;41190;20238;0;7.4;3.6;0.0
72;2021-03-18;1175;385;0;42365;20623;0;7.6;3.7;0.0
72;2021-03-19;1385;297;0;43750;20920;0;7.8;3.7;0.0
72;2021-03-20;515;81;0;44265;21001;0;7.9;3.7;0.0
72;2021-03-21;26;4;0;44291;21005;0;7.9;3.7;0.0
72;2021-03-22;1428;346;0;45719;21351;0;8.2;3.8;0.0
72;2021-03-23;1837;507;0;47556;21858;0;8.5;3.9;0.0
72;2021-03-24;1967;306;0;49523;22164;0;8.8;4.0;0.0
72;2021-03-25;2584;480;0;52107;22644;0;9.3;4.0;0.0
72;2021-03-26;2494;371;0;54601;23015;0;9.7;4.1;0.0
72;2021-03-27;710;35;0;55311;23050;0;9.9;4.1;0.0
72;2021-03-28;49;1;0;55360;23051;0;9.9;4.1;0.0
72;2021-03-29;1719;381;0;57079;23432;0;10.2;4.2;0.0
72;2021-03-30;2614;406;0;59693;23838;0;10.7;4.3;0.0
72;2021-03-31;2341;385;0;62034;24223;0;11.1;4.3;0.0
72;2021-04-01;3047;383;0;65081;24606;0;11.6;4.4;0.0
72;2021-04-02;2438;440;0;67519;25046;0;12.1;4.5;0.0
72;2021-04-03;375;65;0;67894;25111;0;12.1;4.5;0.0
72;2021-04-04;26;6;0;67920;25117;0;12.1;4.5;0.0
72;2021-04-05;120;52;0;68040;25169;0;12.1;4.5;0.0
72;2021-04-06;1881;522;0;69921;25691;0;12.5;4.6;0.0
72;2021-04-07;2723;683;0;72644;26374;0;13.0;4.7;0.0
72;2021-04-08;2878;850;0;75522;27224;0;13.5;4.9;0.0
72;2021-04-09;4069;651;0;79591;27875;0;14.2;5.0;0.0
72;2021-04-10;1280;96;0;80871;27971;0;14.4;5.0;0.0
72;2021-04-11;31;8;0;80902;27979;0;14.4;5.0;0.0
72;2021-04-12;2017;968;0;82919;28947;0;14.8;5.2;0.0
72;2021-04-13;2614;1179;0;85533;30126;0;15.3;5.4;0.0
72;2021-04-14;2458;1177;0;87991;31303;0;15.7;5.6;0.0
72;2021-04-15;2704;1199;0;90695;32502;0;16.2;5.8;0.0
72;2021-04-16;2848;1090;0;93543;33592;0;16.7;6.0;0.0
72;2021-04-17;984;184;0;94527;33776;0;16.9;6.0;0.0
72;2021-04-18;90;5;0;94617;33781;0;16.9;6.0;0.0
72;2021-04-19;1619;1200;0;96236;34981;0;17.2;6.2;0.0
72;2021-04-20;3234;1387;0;99470;36368;0;17.8;6.5;0.0
72;2021-04-21;2687;1666;0;102157;38034;0;18.2;6.8;0.0
72;2021-04-22;3012;1909;0;105169;39943;0;18.8;7.1;0.0
72;2021-04-23;3429;1592;0;108598;41535;0;19.4;7.4;0.0
72;2021-04-24;1670;348;0;110268;41883;0;19.7;7.5;0.0
72;2021-04-25;873;26;0;111141;41909;0;19.8;7.5;0.0
72;2021-04-26;3664;1627;0;114805;43536;0;20.5;7.8;0.0
72;2021-04-27;4260;2047;0;119065;45583;0;21.3;8.1;0.0
72;2021-04-28;4070;2073;0;123135;47656;0;22.0;8.5;0.0
72;2021-04-29;4418;1962;0;127553;49618;0;22.8;8.9;0.0
72;2021-04-30;3896;1862;0;131449;51480;0;23.5;9.2;0.0
72;2021-05-01;1660;235;0;133109;51715;0;23.8;9.2;0.0
72;2021-05-02;1496;172;0;134605;51887;0;24.0;9.3;0.0
72;2021-05-03;3607;1280;0;138212;53167;0;24.7;9.5;0.0
72;2021-05-04;4133;2015;0;142345;55182;0;25.4;9.8;0.0
72;2021-05-05;3981;2345;0;146326;57527;0;26.1;10.3;0.0
72;2021-05-06;3818;2180;0;150144;59707;0;26.8;10.7;0.0
72;2021-05-07;3661;2384;0;153805;62091;0;27.5;11.1;0.0
72;2021-05-08;1976;225;0;155781;62316;0;27.8;11.1;0.0
72;2021-05-09;1949;220;0;157730;62536;0;28.2;11.2;0.0
72;2021-05-10;3824;1840;0;161554;64376;0;28.8;11.5;0.0
72;2021-05-11;4634;2313;0;166188;66689;0;29.7;11.9;0.0
72;2021-05-12;4167;2090;0;170355;68779;0;30.4;12.3;0.0
72;2021-05-13;2930;351;0;173285;69130;0;30.9;12.3;0.0
72;2021-05-14;3795;1534;0;177080;70664;0;31.6;12.6;0.0
72;2021-05-15;3144;518;0;180224;71182;0;32.2;12.7;0.0
72;2021-05-16;2389;157;0;182613;71339;0;32.6;12.7;0.0
72;2021-05-17;3861;1477;0;186474;72816;0;33.3;13.0;0.0
72;2021-05-18;4503;1841;0;190977;74657;0;34.1;13.3;0.0
72;2021-05-19;4184;1695;0;195161;76352;0;34.8;13.6;0.0
72;2021-05-20;4486;1552;0;199647;77904;0;35.6;13.9;0.0
72;2021-05-21;4003;1520;0;203650;79424;0;36.4;14.2;0.0
72;2021-05-22;2649;602;0;206299;80026;0;36.8;14.3;0.0
72;2021-05-23;1325;160;0;207624;80186;0;37.1;14.3;0.0
72;2021-05-24;2409;304;0;210033;80490;0;37.5;14.4;0.0
72;2021-05-25;4166;1475;0;214199;81965;0;38.2;14.6;0.0
72;2021-05-26;4195;1531;0;218394;83496;0;39.0;14.9;0.0
72;2021-05-27;4482;2122;0;222876;85618;0;39.8;15.3;0.0
72;2021-05-28;4205;2097;0;227081;87715;0;40.5;15.7;0.0
72;2021-05-29;2708;898;0;229789;88613;0;41.0;15.8;0.0
72;2021-05-30;1086;853;0;230875;89466;0;41.2;16.0;0.0
72;2021-05-31;3183;2451;0;234058;91917;0;41.8;16.4;0.0
72;2021-06-01;3638;2815;0;237696;94732;0;42.4;16.9;0.0
72;2021-06-02;3770;2901;0;241466;97633;0;43.1;17.4;0.0
72;2021-06-03;4496;3035;0;245962;100668;0;43.9;18.0;0.0
72;2021-06-04;4060;2878;0;250022;103546;0;44.6;18.5;0.0
72;2021-06-05;1577;2664;0;251599;106210;0;44.9;19.0;0.0
72;2021-06-06;859;1494;0;252458;107704;0;45.1;19.2;0.0
72;2021-06-07;2003;3611;0;254461;111315;0;45.4;19.9;0.0
72;2021-06-08;3153;4012;0;257614;115327;0;46.0;20.6;0.0
72;2021-06-09;2849;3478;0;260463;118805;0;46.5;21.2;0.0
72;2021-06-10;3066;3403;0;263529;122208;0;47.0;21.8;0.0
72;2021-06-11;3013;3931;0;266542;126139;0;47.6;22.5;0.0
72;2021-06-12;1501;2692;0;268043;128831;0;47.8;23.0;0.0
72;2021-06-13;410;1800;0;268453;130631;0;47.9;23.3;0.0
72;2021-06-14;1492;4317;0;269945;134948;0;48.2;24.1;0.0
72;2021-06-15;2866;3676;0;272811;138624;0;48.7;24.7;0.0
72;2021-06-16;2553;3726;0;275364;142350;0;49.2;25.4;0.0
72;2021-06-17;2452;3945;0;277816;146295;0;49.6;26.1;0.0
72;2021-06-18;2449;4473;0;280265;150768;0;50.0;26.9;0.0
72;2021-06-19;1242;2817;0;281507;153585;0;50.2;27.4;0.0
72;2021-06-20;336;1943;0;281843;155528;0;50.3;27.8;0.0
72;2021-06-21;1593;4143;0;283436;159671;0;50.6;28.5;0.0
72;2021-06-22;1839;5092;0;285275;164763;0;50.9;29.4;0.0
72;2021-06-23;2070;4422;0;287345;169185;0;51.3;30.2;0.0
72;2021-06-24;2316;4028;0;289661;173213;0;51.7;30.9;0.0
72;2021-06-25;1866;5044;0;291527;178257;0;52.0;31.8;0.0
72;2021-06-26;1235;2971;0;292762;181228;0;52.3;32.3;0.0
72;2021-06-27;400;1997;0;293162;183225;0;52.3;32.7;0.0
72;2021-06-28;1432;4523;0;294594;187748;0;52.6;33.5;0.0
72;2021-06-29;1771;5055;0;296365;192803;0;52.9;34.4;0.0
72;2021-06-30;2039;4497;0;298404;197300;0;53.3;35.2;0.0
72;2021-07-01;2039;4480;0;300443;201780;0;53.6;36.0;0.0
72;2021-07-02;1899;4929;1;302342;206709;1;54.0;36.9;0.0
72;2021-07-03;1308;3303;1;303650;210012;2;54.2;37.5;0.0
72;2021-07-04;571;1888;0;304221;211900;2;54.3;37.8;0.0
72;2021-07-05;1206;4287;0;305427;216187;2;54.5;38.6;0.0
72;2021-07-06;1519;5339;1;306946;221526;3;54.8;39.5;0.0
72;2021-07-07;1644;4768;0;308590;226294;3;55.1;40.4;0.0
72;2021-07-08;1739;4515;0;310329;230809;3;55.4;41.2;0.0
72;2021-07-09;2166;4797;0;312495;235606;3;55.8;42.1;0.0
72;2021-07-10;1616;2801;0;314111;238407;3;56.1;42.6;0.0
72;2021-07-11;908;1520;0;315019;239927;3;56.2;42.8;0.0
72;2021-07-12;1559;4006;0;316578;243933;3;56.5;43.5;0.0
72;2021-07-13;2093;5063;0;318671;248996;3;56.9;44.4;0.0
72;2021-07-14;1312;2328;0;319983;251324;3;57.1;44.9;0.0
72;2021-07-15;3438;3834;0;323421;255158;3;57.7;45.5;0.0
72;2021-07-16;3301;4504;0;326722;259662;3;58.3;46.3;0.0
72;2021-07-17;2517;1973;0;329239;261635;3;58.8;46.7;0.0
72;2021-07-18;1669;830;0;330908;262465;3;59.1;46.8;0.0
72;2021-07-19;2731;3836;1;333639;266301;4;59.6;47.5;0.0
72;2021-07-20;2991;4631;0;336630;270932;4;60.1;48.4;0.0
72;2021-07-21;2953;3836;1;339583;274768;5;60.6;49.0;0.0
72;2021-07-22;3793;3174;0;343376;277942;5;61.3;49.6;0.0
72;2021-07-23;3533;4038;0;346909;281980;5;61.9;50.3;0.0
72;2021-07-24;2777;1681;0;349686;283661;5;62.4;50.6;0.0
72;2021-07-25;1375;1043;0;351061;284704;5;62.7;50.8;0.0
72;2021-07-26;2852;3200;0;353913;287904;5;63.2;51.4;0.0
72;2021-07-27;3947;3983;0;357860;291887;5;63.9;52.1;0.0
72;2021-07-28;3718;3269;0;361578;295156;5;64.5;52.7;0.0
72;2021-07-29;3904;2857;0;365482;298013;5;65.2;53.2;0.0
72;2021-07-30;3839;3588;0;369321;301601;5;65.9;53.8;0.0
72;2021-07-31;2398;1910;0;371719;303511;5;66.4;54.2;0.0
72;2021-08-01;1735;439;0;373454;303950;5;66.7;54.3;0.0
72;2021-08-02;3144;2404;0;376598;306354;5;67.2;54.7;0.0
72;2021-08-03;3332;3326;0;379930;309680;5;67.8;55.3;0.0
72;2021-08-04;3695;2602;0;383625;312282;5;68.5;55.7;0.0
72;2021-08-05;3876;2556;0;387501;314838;5;69.2;56.2;0.0
72;2021-08-06;3360;2789;0;390861;317627;5;69.8;56.7;0.0
72;2021-08-07;2259;1682;0;393120;319309;5;70.2;57.0;0.0
72;2021-08-08;1470;705;0;394590;320014;5;70.4;57.1;0.0
72;2021-08-09;2568;2801;0;397158;322815;5;70.9;57.6;0.0
72;2021-08-10;2780;2860;0;399938;325675;5;71.4;58.1;0.0
72;2021-08-11;2285;2354;0;402223;328029;5;71.8;58.6;0.0
72;2021-08-12;2235;2631;0;404458;330660;5;72.2;59.0;0.0
72;2021-08-13;2055;2384;0;406513;333044;5;72.6;59.4;0.0
72;2021-08-14;1094;1585;0;407607;334629;5;72.8;59.7;0.0
72;2021-08-15;562;591;0;408169;335220;5;72.9;59.8;0.0
72;2021-08-16;1619;2554;0;409788;337774;5;73.1;60.3;0.0
72;2021-08-17;1689;3060;0;411477;340834;5;73.4;60.8;0.0
72;2021-08-18;1675;3033;0;413152;343867;5;73.7;61.4;0.0
72;2021-08-19;1222;3100;0;414374;346967;5;74.0;61.9;0.0
72;2021-08-20;1554;3368;0;415928;350335;5;74.2;62.5;0.0
72;2021-08-21;686;2025;0;416614;352360;5;74.4;62.9;0.0
72;2021-08-22;241;1105;0;416855;353465;5;74.4;63.1;0.0
72;2021-08-23;1657;3476;0;418512;356941;5;74.7;63.7;0.0
72;2021-08-24;1462;4162;0;419974;361103;5;75.0;64.5;0.0
72;2021-08-25;1536;3522;0;421510;364625;5;75.2;65.1;0.0
72;2021-08-26;1201;4376;0;422711;369001;5;75.5;65.9;0.0
72;2021-08-27;1163;4159;1;423874;373160;6;75.7;66.6;0.0
72;2021-08-28;844;2607;0;424718;375767;6;75.8;67.1;0.0
72;2021-08-29;337;1565;0;425055;377332;6;75.9;67.4;0.0
72;2021-08-30;1088;3309;61;426143;380641;67;76.1;67.9;0.0
72;2021-08-31;1158;3800;106;427301;384441;173;76.3;68.6;0.0
72;2021-09-01;1076;3127;163;428377;387568;336;76.5;69.2;0.1
72;2021-09-02;909;3123;228;429286;390691;564;76.6;69.7;0.1
72;2021-09-03;910;2998;244;430196;393689;808;76.8;70.3;0.1
72;2021-09-04;696;2507;114;430892;396196;922;76.9;70.7;0.2
72;2021-09-05;223;1370;56;431115;397566;978;77.0;71.0;0.2
72;2021-09-06;577;2425;302;431692;399991;1280;77.1;71.4;0.2
72;2021-09-07;494;2517;381;432186;402508;1661;77.1;71.8;0.3
72;2021-09-08;621;2903;308;432807;405411;1969;77.3;72.4;0.4
72;2021-09-09;409;1706;326;433216;407117;2295;77.3;72.7;0.4
72;2021-09-10;630;2273;353;433846;409390;2648;77.4;73.1;0.5
72;2021-09-11;404;2445;89;434250;411835;2737;77.5;73.5;0.5
72;2021-09-12;147;862;31;434397;412697;2768;77.5;73.7;0.5
72;2021-09-13;370;1249;335;434767;413946;3103;77.6;73.9;0.6
72;2021-09-14;474;1200;517;435241;415146;3620;77.7;74.1;0.6
72;2021-09-15;595;1888;410;435836;417034;4030;77.8;74.4;0.7
72;2021-09-16;347;779;466;436183;417813;4496;77.9;74.6;0.8
72;2021-09-17;448;1394;578;436631;419207;5074;77.9;74.8;0.9
72;2021-09-18;350;1438;127;436981;420645;5201;78.0;75.1;0.9
72;2021-09-19;82;344;33;437063;420989;5234;78.0;75.1;0.9
72;2021-09-20;353;799;348;437416;421788;5582;78.1;75.3;1.0
72;2021-09-21;318;778;645;437734;422566;6227;78.1;75.4;1.1
72;2021-09-22;411;1486;445;438145;424052;6672;78.2;75.7;1.2
72;2021-09-23;378;609;426;438523;424661;7098;78.3;75.8;1.3
72;2021-09-24;569;1018;389;439092;425679;7487;78.4;76.0;1.3
72;2021-09-25;252;978;149;439344;426657;7636;78.4;76.2;1.4
72;2021-09-26;74;194;26;439418;426851;7662;78.4;76.2;1.4
72;2021-09-27;214;614;503;439632;427465;8165;78.5;76.3;1.5
72;2021-09-28;201;418;687;439833;427883;8852;78.5;76.4;1.6
72;2021-09-29;337;949;730;440170;428832;9582;78.6;76.5;1.7
72;2021-09-30;169;342;411;440339;429174;9993;78.6;76.6;1.8
72;2021-10-01;322;717;522;440661;429891;10515;78.7;76.7;1.9
72;2021-10-02;292;563;208;440953;430454;10723;78.7;76.8;1.9
72;2021-10-03;82;142;20;441035;430596;10743;78.7;76.9;1.9
72;2021-10-04;199;419;448;441234;431015;11191;78.8;76.9;2.0
72;2021-10-05;256;349;473;441490;431364;11664;78.8;77.0;2.1
72;2021-10-06;263;537;583;441753;431901;12247;78.9;77.1;2.2
72;2021-10-07;211;342;487;441964;432243;12734;78.9;77.2;2.3
72;2021-10-08;326;646;685;442290;432889;13419;78.9;77.3;2.4
72;2021-10-09;226;436;172;442516;433325;13591;79.0;77.3;2.4
72;2021-10-10;76;111;47;442592;433436;13638;79.0;77.4;2.4
72;2021-10-11;180;290;535;442772;433726;14173;79.0;77.4;2.5
72;2021-10-12;216;344;699;442988;434070;14872;79.1;77.5;2.7
72;2021-10-13;272;474;691;443260;434544;15563;79.1;77.6;2.8
72;2021-10-14;136;287;489;443396;434831;16052;79.1;77.6;2.9
72;2021-10-15;311;429;712;443707;435260;16764;79.2;77.7;3.0
72;2021-10-16;188;263;223;443895;435523;16987;79.2;77.7;3.0
72;2021-10-17;44;91;46;443939;435614;17033;79.2;77.8;3.0
72;2021-10-18;192;344;506;444131;435958;17539;79.3;77.8;3.1
72;2021-10-19;182;250;701;444313;436208;18240;79.3;77.9;3.3
72;2021-10-20;199;390;906;444512;436598;19146;79.3;77.9;3.4
72;2021-10-21;129;331;681;444641;436929;19827;79.4;78.0;3.5
72;2021-10-22;245;521;1035;444886;437450;20862;79.4;78.1;3.7
72;2021-10-23;174;308;385;445060;437758;21247;79.4;78.1;3.8
72;2021-10-24;39;84;42;445099;437842;21289;79.4;78.2;3.8
72;2021-10-25;197;242;767;445296;438084;22056;79.5;78.2;3.9
72;2021-10-26;157;197;960;445453;438281;23016;79.5;78.2;4.1
72;2021-10-27;177;267;1036;445630;438548;24052;79.5;78.3;4.3
72;2021-10-28;131;153;671;445761;438701;24723;79.6;78.3;4.4
72;2021-10-29;226;321;1161;445987;439022;25884;79.6;78.4;4.6
72;2021-10-30;114;197;267;446101;439219;26151;79.6;78.4;4.7
72;2021-10-31;24;74;40;446125;439293;26191;79.6;78.4;4.7
72;2021-11-01;33;23;68;446158;439316;26259;79.6;78.4;4.7
72;2021-11-02;172;246;860;446330;439562;27119;79.7;78.5;4.8
72;2021-11-03;143;280;974;446473;439842;28093;79.7;78.5;5.0
72;2021-11-04;139;170;926;446612;440012;29019;79.7;78.5;5.2
72;2021-11-05;240;301;1509;446852;440313;30528;79.8;78.6;5.4
72;2021-11-06;128;193;545;446980;440506;31073;79.8;78.6;5.5
72;2021-11-07;26;30;74;447006;440536;31147;79.8;78.6;5.6
72;2021-11-08;123;223;1606;447129;440759;32753;79.8;78.7;5.8
72;2021-11-09;163;206;1832;447292;440965;34585;79.8;78.7;6.2
72;2021-11-10;208;236;1868;447500;441201;36453;79.9;78.8;6.5
72;2021-11-11;68;53;215;447568;441254;36668;79.9;78.8;6.5
72;2021-11-12;164;239;1408;447732;441493;38076;79.9;78.8;6.8
72;2021-11-13;106;131;484;447838;441624;38560;79.9;78.8;6.9
72;2021-11-14;45;51;112;447883;441675;38672;79.9;78.8;6.9
72;2021-11-15;106;208;1641;447989;441883;40313;80.0;78.9;7.2
72;2021-11-16;152;177;2111;448141;442060;42424;80.0;78.9;7.6
72;2021-11-17;187;229;1840;448328;442289;44264;80.0;78.9;7.9
72;2021-11-18;150;129;1763;448478;442418;46027;80.1;79.0;8.2
72;2021-11-19;248;259;2356;448726;442677;48383;80.1;79.0;8.6
72;2021-11-20;182;175;538;448908;442852;48921;80.1;79.0;8.7
72;2021-11-21;52;53;107;448960;442905;49028;80.1;79.1;8.8
72;2021-11-22;120;138;1899;449080;443043;50927;80.2;79.1;9.1
72;2021-11-23;141;147;1806;449221;443190;52733;80.2;79.1;9.4
72;2021-11-24;237;214;1981;449458;443404;54714;80.2;79.1;9.8
72;2021-11-25;165;134;2075;449623;443538;56789;80.3;79.2;10.1
72;2021-11-26;250;255;2962;449873;443793;59751;80.3;79.2;10.7
72;2021-11-27;171;176;1614;450044;443969;61365;80.3;79.2;11.0
72;2021-11-28;45;40;1178;450089;444009;62543;80.3;79.3;11.2
72;2021-11-29;109;132;3511;450198;444141;66054;80.4;79.3;11.8
72;2021-11-30;134;138;3898;450332;444279;69952;80.4;79.3;12.5
72;2021-12-01;174;184;4419;450506;444463;74371;80.4;79.3;13.3
72;2021-12-02;117;132;4477;450623;444595;78848;80.4;79.4;14.1
72;2021-12-03;121;185;4885;450744;444780;83733;80.5;79.4;14.9
72;2021-12-04;87;168;2667;450831;444948;86400;80.5;79.4;15.4
72;2021-12-05;35;40;1324;450866;444988;87724;80.5;79.4;15.7
72;2021-12-06;122;131;5122;450988;445119;92846;80.5;79.5;16.6
72;2021-12-07;111;131;6278;451099;445250;99124;80.5;79.5;17.7
72;2021-12-08;125;210;5354;451224;445460;104478;80.5;79.5;18.6
72;2021-12-09;124;134;6202;451348;445594;110680;80.6;79.5;19.8
72;2021-12-10;122;224;6102;451470;445818;116782;80.6;79.6;20.8
72;2021-12-11;91;207;3368;451561;446025;120150;80.6;79.6;21.4
72;2021-12-12;48;56;1775;451609;446081;121925;80.6;79.6;21.8
72;2021-12-13;111;128;5486;451720;446209;127411;80.6;79.6;22.7
72;2021-12-14;127;190;7224;451847;446399;134635;80.7;79.7;24.0
72;2021-12-15;139;214;6414;451986;446613;141049;80.7;79.7;25.2
72;2021-12-16;141;190;7027;452127;446803;148076;80.7;79.8;26.4
73;2020-12-27;0;0;0;0;0;0;0.0;0.0;0.0
73;2020-12-28;0;0;0;0;0;0;0.0;0.0;0.0
73;2020-12-29;0;0;0;0;0;0;0.0;0.0;0.0
73;2020-12-30;0;0;0;0;0;0;0.0;0.0;0.0
73;2020-12-31;0;0;0;0;0;0;0.0;0.0;0.0
73;2021-01-01;1;0;0;1;0;0;0.0;0.0;0.0
73;2021-01-02;0;0;0;1;0;0;0.0;0.0;0.0
73;2021-01-03;0;0;0;1;0;0;0.0;0.0;0.0
73;2021-01-04;7;0;0;8;0;0;0.0;0.0;0.0
73;2021-01-05;3;0;0;11;0;0;0.0;0.0;0.0
73;2021-01-06;11;0;0;22;0;0;0.0;0.0;0.0
73;2021-01-07;43;0;0;65;0;0;0.0;0.0;0.0
73;2021-01-08;90;0;0;155;0;0;0.0;0.0;0.0
73;2021-01-09;0;0;0;155;0;0;0.0;0.0;0.0
73;2021-01-10;1;0;0;156;0;0;0.0;0.0;0.0
73;2021-01-11;112;0;0;268;0;0;0.1;0.0;0.0
73;2021-01-12;321;0;0;589;0;0;0.1;0.0;0.0
73;2021-01-13;373;0;0;962;0;0;0.2;0.0;0.0
73;2021-01-14;529;2;0;1491;2;0;0.3;0.0;0.0
73;2021-01-15;591;1;0;2082;3;0;0.5;0.0;0.0
73;2021-01-16;135;2;0;2217;5;0;0.5;0.0;0.0
73;2021-01-17;10;0;0;2227;5;0;0.5;0.0;0.0
73;2021-01-18;556;0;0;2783;5;0;0.6;0.0;0.0
73;2021-01-19;1171;4;0;3954;9;0;0.9;0.0;0.0
73;2021-01-20;894;3;0;4848;12;0;1.1;0.0;0.0
73;2021-01-21;982;3;0;5830;15;0;1.3;0.0;0.0
73;2021-01-22;868;1;0;6698;16;0;1.5;0.0;0.0
73;2021-01-23;365;0;0;7063;16;0;1.6;0.0;0.0
73;2021-01-24;0;0;0;7063;16;0;1.6;0.0;0.0
73;2021-01-25;611;10;0;7674;26;0;1.8;0.0;0.0
73;2021-01-26;715;7;0;8389;33;0;1.9;0.0;0.0
73;2021-01-27;962;13;0;9351;46;0;2.2;0.0;0.0
73;2021-01-28;862;12;0;10213;58;0;2.4;0.0;0.0
73;2021-01-29;616;17;0;10829;75;0;2.5;0.0;0.0
73;2021-01-30;291;3;0;11120;78;0;2.6;0.0;0.0
73;2021-01-31;0;1;0;11120;79;0;2.6;0.0;0.0
73;2021-02-01;571;42;0;11691;121;0;2.7;0.0;0.0
73;2021-02-02;702;315;0;12393;436;0;2.9;0.1;0.0
73;2021-02-03;609;346;0;13002;782;0;3.0;0.2;0.0
73;2021-02-04;606;226;0;13608;1008;0;3.1;0.2;0.0
73;2021-02-05;600;392;0;14208;1400;0;3.3;0.3;0.0
73;2021-02-06;216;39;0;14424;1439;0;3.3;0.3;0.0
73;2021-02-07;1;1;0;14425;1440;0;3.3;0.3;0.0
73;2021-02-08;497;251;0;14922;1691;0;3.4;0.4;0.0
73;2021-02-09;750;456;0;15672;2147;0;3.6;0.5;0.0
73;2021-02-10;778;394;0;16450;2541;0;3.8;0.6;0.0
73;2021-02-11;946;689;0;17396;3230;0;4.0;0.7;0.0
73;2021-02-12;767;512;0;18163;3742;0;4.2;0.9;0.0
73;2021-02-13;264;66;0;18427;3808;0;4.3;0.9;0.0
73;2021-02-14;8;6;0;18435;3814;0;4.3;0.9;0.0
73;2021-02-15;341;518;0;18776;4332;0;4.3;1.0;0.0
73;2021-02-16;463;737;0;19239;5069;0;4.4;1.2;0.0
73;2021-02-17;450;883;0;19689;5952;0;4.6;1.4;0.0
73;2021-02-18;442;503;0;20131;6455;0;4.7;1.5;0.0
73;2021-02-19;397;604;0;20528;7059;0;4.7;1.6;0.0
73;2021-02-20;85;236;0;20613;7295;0;4.8;1.7;0.0
73;2021-02-21;1;0;0;20614;7295;0;4.8;1.7;0.0
73;2021-02-22;247;383;0;20861;7678;0;4.8;1.8;0.0
73;2021-02-23;323;479;0;21184;8157;0;4.9;1.9;0.0
73;2021-02-24;467;665;0;21651;8822;0;5.0;2.0;0.0
73;2021-02-25;528;520;0;22179;9342;0;5.1;2.2;0.0
73;2021-02-26;725;553;0;22904;9895;0;5.3;2.3;0.0
73;2021-02-27;304;168;0;23208;10063;0;5.4;2.3;0.0
73;2021-02-28;4;3;0;23212;10066;0;5.4;2.3;0.0
73;2021-03-01;569;471;0;23781;10537;0;5.5;2.4;0.0
73;2021-03-02;687;851;0;24468;11388;0;5.7;2.6;0.0
73;2021-03-03;629;1102;0;25097;12490;0;5.8;2.9;0.0
73;2021-03-04;1026;871;0;26123;13361;0;6.0;3.1;0.0
73;2021-03-05;1234;583;0;27357;13944;0;6.3;3.2;0.0
73;2021-03-06;1055;332;0;28412;14276;0;6.6;3.3;0.0
73;2021-03-07;419;83;0;28831;14359;0;6.7;3.3;0.0
73;2021-03-08;609;424;0;29440;14783;0;6.8;3.4;0.0
73;2021-03-09;979;521;0;30419;15304;0;7.0;3.5;0.0
73;2021-03-10;1036;833;0;31455;16137;0;7.3;3.7;0.0
73;2021-03-11;1547;641;0;33002;16778;0;7.6;3.9;0.0
73;2021-03-12;1954;525;0;34956;17303;0;8.1;4.0;0.0
73;2021-03-13;1169;215;0;36125;17518;0;8.4;4.0;0.0
73;2021-03-14;69;2;0;36194;17520;0;8.4;4.1;0.0
73;2021-03-15;1183;399;0;37377;17919;0;8.6;4.1;0.0
73;2021-03-16;798;405;0;38175;18324;0;8.8;4.2;0.0
73;2021-03-17;867;478;0;39042;18802;0;9.0;4.3;0.0
73;2021-03-18;1334;258;0;40376;19060;0;9.3;4.4;0.0
73;2021-03-19;1711;340;0;42087;19400;0;9.7;4.5;0.0
73;2021-03-20;898;137;0;42985;19537;0;9.9;4.5;0.0
73;2021-03-21;121;3;0;43106;19540;0;10.0;4.5;0.0
73;2021-03-22;1206;393;0;44312;19933;0;10.2;4.6;0.0
73;2021-03-23;1509;261;0;45821;20194;0;10.6;4.7;0.0
73;2021-03-24;1647;361;0;47468;20555;0;11.0;4.8;0.0
73;2021-03-25;2092;391;0;49560;20946;0;11.5;4.8;0.0
73;2021-03-26;2469;361;0;52029;21307;0;12.0;4.9;0.0
73;2021-03-27;923;161;0;52952;21468;0;12.2;5.0;0.0
73;2021-03-28;286;17;0;53238;21485;0;12.3;5.0;0.0
73;2021-03-29;1572;271;0;54810;21756;0;12.7;5.0;0.0
73;2021-03-30;2137;503;0;56947;22259;0;13.2;5.1;0.0
73;2021-03-31;2104;417;0;59051;22676;0;13.7;5.2;0.0
73;2021-04-01;2202;374;0;61253;23050;0;14.2;5.3;0.0
73;2021-04-02;2403;256;0;63656;23306;0;14.7;5.4;0.0
73;2021-04-03;864;167;0;64520;23473;0;14.9;5.4;0.0
73;2021-04-04;185;16;0;64705;23489;0;15.0;5.4;0.0
73;2021-04-05;327;38;0;65032;23527;0;15.0;5.4;0.0
73;2021-04-06;1655;542;0;66687;24069;0;15.4;5.6;0.0
73;2021-04-07;2086;677;0;68773;24746;0;15.9;5.7;0.0
73;2021-04-08;2585;854;0;71358;25600;0;16.5;5.9;0.0
73;2021-04-09;3099;592;0;74457;26192;0;17.2;6.1;0.0
73;2021-04-10;1279;366;0;75736;26558;0;17.5;6.1;0.0
73;2021-04-11;150;13;0;75886;26571;0;17.5;6.1;0.0
73;2021-04-12;1750;956;0;77636;27527;0;17.9;6.4;0.0
73;2021-04-13;2003;1135;0;79639;28662;0;18.4;6.6;0.0
73;2021-04-14;2093;1086;0;81732;29748;0;18.9;6.9;0.0
73;2021-04-15;2496;1190;0;84228;30938;0;19.5;7.2;0.0
73;2021-04-16;1952;969;0;86180;31907;0;19.9;7.4;0.0
73;2021-04-17;1246;585;0;87426;32492;0;20.2;7.5;0.0
73;2021-04-18;152;74;0;87578;32566;0;20.2;7.5;0.0
73;2021-04-19;1418;1119;0;88996;33685;0;20.6;7.8;0.0
73;2021-04-20;1870;1385;0;90866;35070;0;21.0;8.1;0.0
73;2021-04-21;1665;1331;0;92531;36401;0;21.4;8.4;0.0
73;2021-04-22;1952;1275;0;94483;37676;0;21.8;8.7;0.0
73;2021-04-23;1984;1285;0;96467;38961;0;22.3;9.0;0.0
73;2021-04-24;1069;720;0;97536;39681;0;22.5;9.2;0.0
73;2021-04-25;95;103;0;97631;39784;0;22.6;9.2;0.0
73;2021-04-26;1250;1370;0;98881;41154;0;22.9;9.5;0.0
73;2021-04-27;1601;1563;0;100482;42717;0;23.2;9.9;0.0
73;2021-04-28;1853;1550;0;102335;44267;0;23.7;10.2;0.0
73;2021-04-29;2562;1581;0;104897;45848;0;24.3;10.6;0.0
73;2021-04-30;2519;1483;0;107416;47331;0;24.8;10.9;0.0
73;2021-05-01;1077;319;0;108493;47650;0;25.1;11.0;0.0
73;2021-05-02;49;160;0;108542;47810;0;25.1;11.1;0.0
73;2021-05-03;1499;1730;0;110041;49540;0;25.4;11.5;0.0
73;2021-05-04;1843;2067;0;111884;51607;0;25.9;11.9;0.0
73;2021-05-05;2060;1909;0;113944;53516;0;26.3;12.4;0.0
73;2021-05-06;2521;1845;0;116465;55361;0;26.9;12.8;0.0
73;2021-05-07;2342;1987;0;118807;57348;0;27.5;13.3;0.0
73;2021-05-08;1751;392;0;120558;57740;0;27.9;13.3;0.0
73;2021-05-09;229;154;0;120787;57894;0;27.9;13.4;0.0
73;2021-05-10;1667;2005;0;122454;59899;0;28.3;13.8;0.0
73;2021-05-11;2484;2522;0;124938;62421;0;28.9;14.4;0.0
73;2021-05-12;3563;2165;0;128501;64586;0;29.7;14.9;0.0
73;2021-05-13;1778;333;0;130279;64919;0;30.1;15.0;0.0
73;2021-05-14;1914;1574;0;132193;66493;0;30.6;15.4;0.0
73;2021-05-15;1723;1029;0;133916;67522;0;31.0;15.6;0.0
73;2021-05-16;420;105;0;134336;67627;0;31.1;15.6;0.0
73;2021-05-17;2016;1942;0;136352;69569;0;31.5;16.1;0.0
73;2021-05-18;2839;1807;0;139191;71376;0;32.2;16.5;0.0
73;2021-05-19;2794;1597;0;141985;72973;0;32.8;16.9;0.0
73;2021-05-20;3478;1567;0;145463;74540;0;33.6;17.2;0.0
73;2021-05-21;2735;1844;0;148198;76384;0;34.3;17.7;0.0
73;2021-05-22;2113;907;0;150311;77291;0;34.8;17.9;0.0
73;2021-05-23;386;29;0;150697;77320;0;34.8;17.9;0.0
73;2021-05-24;2533;354;0;153230;77674;0;35.4;18.0;0.0
73;2021-05-25;2410;1780;0;155640;79454;0;36.0;18.4;0.0
73;2021-05-26;2416;1990;0;158056;81444;0;36.5;18.8;0.0
73;2021-05-27;3247;1789;0;161303;83233;0;37.3;19.2;0.0
73;2021-05-28;3030;2345;0;164333;85578;0;38.0;19.8;0.0
73;2021-05-29;2268;1318;0;166601;86896;0;38.5;20.1;0.0
73;2021-05-30;257;38;0;166858;86934;0;38.6;20.1;0.0
73;2021-05-31;2406;1765;0;169264;88699;0;39.1;20.5;0.0
73;2021-06-01;3155;1943;0;172419;90642;0;39.9;21.0;0.0
73;2021-06-02;2978;1511;0;175397;92153;0;40.5;21.3;0.0
73;2021-06-03;4240;1810;0;179637;93963;0;41.5;21.7;0.0
73;2021-06-04;4142;2325;0;183779;96288;0;42.5;22.3;0.0
73;2021-06-05;2923;1354;0;186702;97642;0;43.2;22.6;0.0
73;2021-06-06;1620;282;0;188322;97924;0;43.5;22.6;0.0
73;2021-06-07;2565;2218;0;190887;100142;0;44.1;23.2;0.0
73;2021-06-08;2572;1993;0;193459;102135;0;44.7;23.6;0.0
73;2021-06-09;2248;1872;0;195707;104007;0;45.2;24.0;0.0
73;2021-06-10;1941;1741;0;197648;105748;0;45.7;24.4;0.0
73;2021-06-11;2114;2516;0;199762;108264;0;46.2;25.0;0.0
73;2021-06-12;2054;1348;0;201816;109612;0;46.7;25.3;0.0
73;2021-06-13;71;98;0;201887;109710;0;46.7;25.4;0.0
73;2021-06-14;1278;3007;0;203165;112717;0;47.0;26.1;0.0
73;2021-06-15;1610;2786;0;204775;115503;0;47.3;26.7;0.0
73;2021-06-16;1476;2600;0;206251;118103;0;47.7;27.3;0.0
73;2021-06-17;1014;1792;0;207265;119895;0;47.9;27.7;0.0
73;2021-06-18;1865;2906;0;209130;122801;0;48.3;28.4;0.0
73;2021-06-19;1255;1971;0;210385;124772;0;48.6;28.8;0.0
73;2021-06-20;373;294;0;210758;125066;0;48.7;28.9;0.0
73;2021-06-21;1089;3055;0;211847;128121;0;49.0;29.6;0.0
73;2021-06-22;1075;2974;0;212922;131095;0;49.2;30.3;0.0
73;2021-06-23;1059;3177;0;213981;134272;0;49.5;31.0;0.0
73;2021-06-24;917;1968;0;214898;136240;0;49.7;31.5;0.0
73;2021-06-25;1227;2939;0;216125;139179;0;50.0;32.2;0.0
73;2021-06-26;842;2493;0;216967;141672;0;50.2;32.8;0.0
73;2021-06-27;279;576;0;217246;142248;0;50.2;32.9;0.0
73;2021-06-28;911;3694;0;218157;145942;0;50.4;33.7;0.0
73;2021-06-29;1038;3532;0;219195;149474;0;50.7;34.6;0.0
73;2021-06-30;1161;3155;0;220356;152629;0;50.9;35.3;0.0
73;2021-07-01;1205;2548;0;221561;155177;0;51.2;35.9;0.0
73;2021-07-02;1253;3734;0;222814;158911;0;51.5;36.7;0.0
73;2021-07-03;926;2812;0;223740;161723;0;51.7;37.4;0.0
73;2021-07-04;280;613;0;224020;162336;0;51.8;37.5;0.0
73;2021-07-05;1137;3669;0;225157;166005;0;52.1;38.4;0.0
73;2021-07-06;1263;3022;0;226420;169027;0;52.3;39.1;0.0
73;2021-07-07;1388;2949;0;227808;171976;0;52.7;39.8;0.0
73;2021-07-08;1318;2327;0;229126;174303;0;53.0;40.3;0.0
73;2021-07-09;1399;3946;0;230525;178249;0;53.3;41.2;0.0
73;2021-07-10;805;2916;0;231330;181165;0;53.5;41.9;0.0
73;2021-07-11;499;1284;0;231829;182449;0;53.6;42.2;0.0
73;2021-07-12;982;4026;0;232811;186475;0;53.8;43.1;0.0
73;2021-07-13;1747;4135;0;234558;190610;0;54.2;44.1;0.0
73;2021-07-14;1588;1705;0;236146;192315;0;54.6;44.5;0.0
73;2021-07-15;2532;3534;0;238678;195849;0;55.2;45.3;0.0
73;2021-07-16;2363;3858;0;241041;199707;0;55.7;46.2;0.0
73;2021-07-17;1501;2488;0;242542;202195;0;56.1;46.7;0.0
73;2021-07-18;929;1042;0;243471;203237;0;56.3;47.0;0.0
73;2021-07-19;2191;3095;0;245662;206332;0;56.8;47.7;0.0
73;2021-07-20;3155;2750;0;248817;209082;0;57.5;48.3;0.0
73;2021-07-21;3044;2574;0;251861;211656;0;58.2;48.9;0.0
73;2021-07-22;2662;2131;0;254523;213787;0;58.8;49.4;0.0
73;2021-07-23;3293;2862;0;257816;216649;0;59.6;50.1;0.0
73;2021-07-24;1945;2162;0;259761;218811;0;60.1;50.6;0.0
73;2021-07-25;537;652;0;260298;219463;0;60.2;50.7;0.0
73;2021-07-26;2498;2362;0;262796;221825;0;60.8;51.3;0.0
73;2021-07-27;3482;2145;0;266278;223970;0;61.6;51.8;0.0
73;2021-07-28;3275;1932;0;269553;225902;0;62.3;52.2;0.0
73;2021-07-29;3530;1822;0;273083;227724;0;63.1;52.6;0.0
73;2021-07-30;3334;2349;0;276417;230073;0;63.9;53.2;0.0
73;2021-07-31;2232;1386;0;278649;231459;0;64.4;53.5;0.0
73;2021-08-01;702;528;0;279351;231987;0;64.6;53.6;0.0
73;2021-08-02;2930;1923;0;282281;233910;0;65.3;54.1;0.0
73;2021-08-03;3161;1793;0;285442;235703;0;66.0;54.5;0.0
73;2021-08-04;2936;1832;0;288378;237535;0;66.7;54.9;0.0
73;2021-08-05;2522;1905;0;290900;239440;0;67.3;55.4;0.0
73;2021-08-06;2202;2262;0;293102;241702;0;67.8;55.9;0.0
73;2021-08-07;1250;1418;0;294352;243120;0;68.1;56.2;0.0
73;2021-08-08;377;494;0;294729;243614;0;68.1;56.3;0.0
73;2021-08-09;1611;2142;0;296340;245756;0;68.5;56.8;0.0
73;2021-08-10;1699;2300;0;298039;248056;0;68.9;57.3;0.0
73;2021-08-11;1591;2292;0;299630;250348;0;69.3;57.9;0.0
73;2021-08-12;1489;2236;0;301119;252584;0;69.6;58.4;0.0
73;2021-08-13;1374;2664;0;302493;255248;0;69.9;59.0;0.0
73;2021-08-14;926;1505;0;303419;256753;0;70.1;59.4;0.0
73;2021-08-15;89;165;0;303508;256918;0;70.2;59.4;0.0
73;2021-08-16;917;1551;0;304425;258469;0;70.4;59.8;0.0
73;2021-08-17;920;1909;0;305345;260378;0;70.6;60.2;0.0
73;2021-08-18;906;2632;0;306251;263010;0;70.8;60.8;0.0
73;2021-08-19;904;2739;0;307155;265749;0;71.0;61.4;0.0
73;2021-08-20;830;2982;0;307985;268731;0;71.2;62.1;0.0
73;2021-08-21;422;1821;0;308407;270552;0;71.3;62.5;0.0
73;2021-08-22;212;799;0;308619;271351;0;71.3;62.7;0.0
73;2021-08-23;701;2815;0;309320;274166;0;71.5;63.4;0.0
73;2021-08-24;860;2976;0;310180;277142;0;71.7;64.1;0.0
73;2021-08-25;721;2725;0;310901;279867;0;71.9;64.7;0.0
73;2021-08-26;682;2264;0;311583;282131;0;72.0;65.2;0.0
73;2021-08-27;762;2589;0;312345;284720;0;72.2;65.8;0.0
73;2021-08-28;430;1682;0;312775;286402;0;72.3;66.2;0.0
73;2021-08-29;251;836;0;313026;287238;0;72.4;66.4;0.0
73;2021-08-30;823;2480;17;313849;289718;17;72.6;67.0;0.0
73;2021-08-31;774;2285;31;314623;292003;48;72.7;67.5;0.0
73;2021-09-01;832;1949;155;315455;293952;203;72.9;68.0;0.0
73;2021-09-02;631;1667;280;316086;295619;483;73.1;68.3;0.1
73;2021-09-03;693;1886;209;316779;297505;692;73.2;68.8;0.2
73;2021-09-04;525;1232;92;317304;298737;784;73.4;69.1;0.2
73;2021-09-05;198;598;40;317502;299335;824;73.4;69.2;0.2
73;2021-09-06;377;1044;242;317879;300379;1066;73.5;69.4;0.2
73;2021-09-07;394;864;248;318273;301243;1314;73.6;69.6;0.3
73;2021-09-08;479;925;188;318752;302168;1502;73.7;69.9;0.3
73;2021-09-09;457;891;275;319209;303059;1777;73.8;70.1;0.4
73;2021-09-10;602;1177;281;319811;304236;2058;73.9;70.3;0.5
73;2021-09-11;363;896;88;320174;305132;2146;74.0;70.5;0.5
73;2021-09-12;68;140;9;320242;305272;2155;74.0;70.6;0.5
73;2021-09-13;342;702;345;320584;305974;2500;74.1;70.7;0.6
73;2021-09-14;397;633;374;320981;306607;2874;74.2;70.9;0.7
73;2021-09-15;416;881;312;321397;307488;3186;74.3;71.1;0.7
73;2021-09-16;324;590;307;321721;308078;3493;74.4;71.2;0.8
73;2021-09-17;390;874;429;322111;308952;3922;74.5;71.4;0.9
73;2021-09-18;257;618;135;322368;309570;4057;74.5;71.6;0.9
73;2021-09-19;45;176;9;322413;309746;4066;74.5;71.6;0.9
73;2021-09-20;182;647;378;322595;310393;4444;74.6;71.8;1.0
73;2021-09-21;283;535;534;322878;310928;4978;74.6;71.9;1.2
73;2021-09-22;270;789;328;323148;311717;5306;74.7;72.1;1.2
73;2021-09-23;246;480;421;323394;312197;5727;74.8;72.2;1.3
73;2021-09-24;283;826;474;323677;313023;6201;74.8;72.4;1.4
73;2021-09-25;187;720;99;323864;313743;6300;74.9;72.5;1.5
73;2021-09-26;60;182;14;323924;313925;6314;74.9;72.6;1.5
73;2021-09-27;238;485;527;324162;314410;6841;74.9;72.7;1.6
73;2021-09-28;190;347;435;324352;314757;7276;75.0;72.8;1.7
73;2021-09-29;232;658;335;324584;315415;7611;75.0;72.9;1.8
73;2021-09-30;200;380;326;324784;315795;7937;75.1;73.0;1.8
73;2021-10-01;276;588;339;325060;316383;8276;75.2;73.1;1.9
73;2021-10-02;191;493;150;325251;316876;8426;75.2;73.3;1.9
73;2021-10-03;8;31;3;325259;316907;8429;75.2;73.3;1.9
73;2021-10-04;249;365;434;325508;317272;8863;75.3;73.3;2.0
73;2021-10-05;179;319;521;325687;317591;9384;75.3;73.4;2.2
73;2021-10-06;310;497;395;325997;318088;9779;75.4;73.5;2.3
73;2021-10-07;170;305;423;326167;318393;10202;75.4;73.6;2.4
73;2021-10-08;323;562;588;326490;318955;10790;75.5;73.7;2.5
73;2021-10-09;170;358;121;326660;319313;10911;75.5;73.8;2.5
73;2021-10-10;6;15;4;326666;319328;10915;75.5;73.8;2.5
73;2021-10-11;208;329;401;326874;319657;11316;75.6;73.9;2.6
73;2021-10-12;150;193;291;327024;319850;11607;75.6;73.9;2.7
73;2021-10-13;233;364;459;327257;320214;12066;75.7;74.0;2.8
73;2021-10-14;175;303;551;327432;320517;12617;75.7;74.1;2.9
73;2021-10-15;226;351;464;327658;320868;13081;75.8;74.2;3.0
73;2021-10-16;122;198;160;327780;321066;13241;75.8;74.2;3.1
73;2021-10-17;4;7;25;327784;321073;13266;75.8;74.2;3.1
73;2021-10-18;178;338;433;327962;321411;13699;75.8;74.3;3.2
73;2021-10-19;102;255;804;328064;321666;14503;75.8;74.4;3.4
73;2021-10-20;108;201;501;328172;321867;15004;75.9;74.4;3.5
73;2021-10-21;79;189;662;328251;322056;15666;75.9;74.5;3.6
73;2021-10-22;115;215;528;328366;322271;16194;75.9;74.5;3.7
73;2021-10-23;66;151;121;328432;322422;16315;75.9;74.5;3.8
73;2021-10-24;2;12;1;328434;322434;16316;75.9;74.5;3.8
73;2021-10-25;106;136;576;328540;322570;16892;76.0;74.6;3.9
73;2021-10-26;128;202;917;328668;322772;17809;76.0;74.6;4.1
73;2021-10-27;94;249;706;328762;323021;18515;76.0;74.7;4.3
73;2021-10-28;88;144;841;328850;323165;19356;76.0;74.7;4.5
73;2021-10-29;124;260;826;328974;323425;20182;76.1;74.8;4.7
73;2021-10-30;61;143;255;329035;323568;20437;76.1;74.8;4.7
73;2021-10-31;6;25;33;329041;323593;20470;76.1;74.8;4.7
73;2021-11-01;23;6;39;329064;323599;20509;76.1;74.8;4.7
73;2021-11-02;116;194;902;329180;323793;21411;76.1;74.9;4.9
73;2021-11-03;89;183;850;329269;323976;22261;76.1;74.9;5.1
73;2021-11-04;85;166;873;329354;324142;23134;76.1;74.9;5.3
73;2021-11-05;103;207;1061;329457;324349;24195;76.2;75.0;5.6
73;2021-11-06;76;142;503;329533;324491;24698;76.2;75.0;5.7
73;2021-11-07;1;5;6;329534;324496;24704;76.2;75.0;5.7
73;2021-11-08;86;154;1197;329620;324650;25901;76.2;75.1;6.0
73;2021-11-09;88;153;1384;329708;324803;27285;76.2;75.1;6.3
73;2021-11-10;135;182;1333;329843;324985;28618;76.3;75.1;6.6
73;2021-11-11;8;22;99;329851;325007;28717;76.3;75.1;6.6
73;2021-11-12;93;157;1245;329944;325164;29962;76.3;75.2;6.9
73;2021-11-13;71;98;483;330015;325262;30445;76.3;75.2;7.0
73;2021-11-14;2;6;5;330017;325268;30450;76.3;75.2;7.0
73;2021-11-15;79;145;1650;330096;325413;32100;76.3;75.2;7.4
73;2021-11-16;90;126;1835;330186;325539;33935;76.3;75.3;7.8
73;2021-11-17;107;146;1492;330293;325685;35427;76.4;75.3;8.2
73;2021-11-18;69;84;1510;330362;325769;36937;76.4;75.3;8.5
73;2021-11-19;155;192;1744;330517;325961;38681;76.4;75.4;8.9
73;2021-11-20;113;114;723;330630;326075;39404;76.4;75.4;9.1
73;2021-11-21;2;14;85;330632;326089;39489;76.4;75.4;9.1
73;2021-11-22;86;84;1788;330718;326173;41277;76.5;75.4;9.5
73;2021-11-23;115;128;2000;330833;326301;43277;76.5;75.4;10.0
73;2021-11-24;150;138;1611;330983;326439;44888;76.5;75.5;10.4
73;2021-11-25;93;82;2059;331076;326521;46947;76.5;75.5;10.9
73;2021-11-26;142;166;2500;331218;326687;49447;76.6;75.5;11.4
73;2021-11-27;103;109;1058;331321;326796;50505;76.6;75.6;11.7
73;2021-11-28;5;26;50;331326;326822;50555;76.6;75.6;11.7
73;2021-11-29;71;99;2678;331397;326921;53233;76.6;75.6;12.3
73;2021-11-30;134;165;3871;331531;327086;57104;76.6;75.6;13.2
73;2021-12-01;107;142;3273;331638;327228;60377;76.7;75.7;14.0
73;2021-12-02;106;107;3940;331744;327335;64317;76.7;75.7;14.9
73;2021-12-03;90;146;4079;331834;327481;68396;76.7;75.7;15.8
73;2021-12-04;73;90;2005;331907;327571;70401;76.7;75.7;16.3
73;2021-12-05;17;23;762;331924;327594;71163;76.7;75.7;16.5
73;2021-12-06;93;134;3450;332017;327728;74613;76.8;75.8;17.2
73;2021-12-07;86;109;4022;332103;327837;78635;76.8;75.8;18.2
73;2021-12-08;118;152;4048;332221;327989;82683;76.8;75.8;19.1
73;2021-12-09;90;135;4796;332311;328124;87479;76.8;75.9;20.2
73;2021-12-10;102;141;4891;332413;328265;92370;76.8;75.9;21.4
73;2021-12-11;81;122;2617;332494;328387;94987;76.9;75.9;22.0
73;2021-12-12;12;13;1283;332506;328400;96270;76.9;75.9;22.3
73;2021-12-13;79;101;4542;332585;328501;100812;76.9;75.9;23.3
73;2021-12-14;105;151;5463;332690;328652;106275;76.9;76.0;24.6
73;2021-12-15;120;181;5120;332810;328833;111395;76.9;76.0;25.8
73;2021-12-16;115;124;6088;332925;328957;117483;77.0;76.1;27.2
74;2020-12-27;2;0;0;2;0;0;0.0;0.0;0.0
74;2020-12-28;2;1;0;4;1;0;0.0;0.0;0.0
74;2020-12-29;0;0;0;4;1;0;0.0;0.0;0.0
74;2020-12-30;0;0;0;4;1;0;0.0;0.0;0.0
74;2020-12-31;0;0;0;4;1;0;0.0;0.0;0.0
74;2021-01-01;0;0;0;4;1;0;0.0;0.0;0.0
74;2021-01-02;1;1;0;5;2;0;0.0;0.0;0.0
74;2021-01-03;1;0;0;6;2;0;0.0;0.0;0.0
74;2021-01-04;1;0;0;7;2;0;0.0;0.0;0.0
74;2021-01-05;3;0;0;10;2;0;0.0;0.0;0.0
74;2021-01-06;46;0;0;56;2;0;0.0;0.0;0.0
74;2021-01-07;220;1;0;276;3;0;0.0;0.0;0.0
74;2021-01-08;288;2;0;564;5;0;0.1;0.0;0.0
74;2021-01-09;79;0;0;643;5;0;0.1;0.0;0.0
74;2021-01-10;74;0;0;717;5;0;0.1;0.0;0.0
74;2021-01-11;373;1;0;1090;6;0;0.1;0.0;0.0
74;2021-01-12;409;3;0;1499;9;0;0.2;0.0;0.0
74;2021-01-13;402;0;0;1901;9;0;0.2;0.0;0.0
74;2021-01-14;467;2;0;2368;11;0;0.3;0.0;0.0
74;2021-01-15;629;4;0;2997;15;0;0.4;0.0;0.0
74;2021-01-16;241;1;0;3238;16;0;0.4;0.0;0.0
74;2021-01-17;113;1;0;3351;17;0;0.4;0.0;0.0
74;2021-01-18;513;0;0;3864;17;0;0.5;0.0;0.0
74;2021-01-19;792;3;0;4656;20;0;0.6;0.0;0.0
74;2021-01-20;1282;3;0;5938;23;0;0.7;0.0;0.0
74;2021-01-21;1496;4;0;7434;27;0;0.9;0.0;0.0
74;2021-01-22;1181;6;0;8615;33;0;1.0;0.0;0.0
74;2021-01-23;317;1;0;8932;34;0;1.1;0.0;0.0
74;2021-01-24;81;1;0;9013;35;0;1.1;0.0;0.0
74;2021-01-25;773;3;0;9786;38;0;1.2;0.0;0.0
74;2021-01-26;1301;25;0;11087;63;0;1.3;0.0;0.0
74;2021-01-27;1058;16;0;12145;79;0;1.5;0.0;0.0
74;2021-01-28;993;48;0;13138;127;0;1.6;0.0;0.0
74;2021-01-29;826;47;0;13964;174;0;1.7;0.0;0.0
74;2021-01-30;331;2;0;14295;176;0;1.7;0.0;0.0
74;2021-01-31;89;2;0;14384;178;0;1.7;0.0;0.0
74;2021-02-01;580;46;0;14964;224;0;1.8;0.0;0.0
74;2021-02-02;610;160;0;15574;384;0;1.9;0.0;0.0
74;2021-02-03;586;138;0;16160;522;0;2.0;0.1;0.0
74;2021-02-04;588;139;0;16748;661;0;2.0;0.1;0.0
74;2021-02-05;524;230;0;17272;891;0;2.1;0.1;0.0
74;2021-02-06;288;132;0;17560;1023;0;2.1;0.1;0.0
74;2021-02-07;85;122;0;17645;1145;0;2.1;0.1;0.0
74;2021-02-08;587;338;0;18232;1483;0;2.2;0.2;0.0
74;2021-02-09;530;514;0;18762;1997;0;2.3;0.2;0.0
74;2021-02-10;749;556;0;19511;2553;0;2.4;0.3;0.0
74;2021-02-11;1025;1007;0;20536;3560;0;2.5;0.4;0.0
74;2021-02-12;882;607;0;21418;4167;0;2.6;0.5;0.0
74;2021-02-13;380;228;0;21798;4395;0;2.6;0.5;0.0
74;2021-02-14;287;99;0;22085;4494;0;2.7;0.5;0.0
74;2021-02-15;274;812;0;22359;5306;0;2.7;0.6;0.0
74;2021-02-16;466;1017;0;22825;6323;0;2.8;0.8;0.0
74;2021-02-17;524;1096;0;23349;7419;0;2.8;0.9;0.0
74;2021-02-18;482;957;0;23831;8376;0;2.9;1.0;0.0
74;2021-02-19;616;646;0;24447;9022;0;3.0;1.1;0.0
74;2021-02-20;118;188;0;24565;9210;0;3.0;1.1;0.0
74;2021-02-21;45;58;0;24610;9268;0;3.0;1.1;0.0
74;2021-02-22;299;802;0;24909;10070;0;3.0;1.2;0.0
74;2021-02-23;305;809;0;25214;10879;0;3.0;1.3;0.0
74;2021-02-24;265;719;0;25479;11598;0;3.1;1.4;0.0
74;2021-02-25;518;733;0;25997;12331;0;3.1;1.5;0.0
74;2021-02-26;930;682;0;26927;13013;0;3.3;1.6;0.0
74;2021-02-27;277;242;0;27204;13255;0;3.3;1.6;0.0
74;2021-02-28;117;67;0;27321;13322;0;3.3;1.6;0.0
74;2021-03-01;721;589;0;28042;13911;0;3.4;1.7;0.0
74;2021-03-02;1064;652;0;29106;14563;0;3.5;1.8;0.0
74;2021-03-03;1024;676;0;30130;15239;0;3.6;1.8;0.0
74;2021-03-04;1564;985;0;31694;16224;0;3.8;2.0;0.0
74;2021-03-05;2027;879;0;33721;17103;0;4.1;2.1;0.0
74;2021-03-06;1738;336;0;35459;17439;0;4.3;2.1;0.0
74;2021-03-07;1342;106;0;36801;17545;0;4.4;2.1;0.0
74;2021-03-08;1163;904;0;37964;18449;0;4.6;2.2;0.0
74;2021-03-09;1893;658;0;39857;19107;0;4.8;2.3;0.0
74;2021-03-10;1724;894;0;41581;20001;0;5.0;2.4;0.0
74;2021-03-11;2411;711;0;43992;20712;0;5.3;2.5;0.0
74;2021-03-12;3158;992;0;47150;21704;0;5.7;2.6;0.0
74;2021-03-13;1924;270;0;49074;21974;0;5.9;2.7;0.0
74;2021-03-14;576;98;0;49650;22072;0;6.0;2.7;0.0
74;2021-03-15;2087;556;0;51737;22628;0;6.2;2.7;0.0
74;2021-03-16;1919;424;0;53656;23052;0;6.5;2.8;0.0
74;2021-03-17;1923;336;0;55579;23388;0;6.7;2.8;0.0
74;2021-03-18;2091;295;0;57670;23683;0;7.0;2.9;0.0
74;2021-03-19;2574;318;0;60244;24001;0;7.3;2.9;0.0
74;2021-03-20;1331;102;0;61575;24103;0;7.4;2.9;0.0
74;2021-03-21;268;33;0;61843;24136;0;7.5;2.9;0.0
74;2021-03-22;1994;321;0;63837;24457;0;7.7;3.0;0.0
74;2021-03-23;2658;344;0;66495;24801;0;8.0;3.0;0.0
74;2021-03-24;2857;340;0;69352;25141;0;8.4;3.0;0.0
74;2021-03-25;3736;321;0;73088;25462;0;8.8;3.1;0.0
74;2021-03-26;3997;413;0;77085;25875;0;9.3;3.1;0.0
74;2021-03-27;1852;268;0;78937;26143;0;9.5;3.2;0.0
74;2021-03-28;429;73;0;79366;26216;0;9.6;3.2;0.0
74;2021-03-29;2868;709;0;82234;26925;0;9.9;3.3;0.0
74;2021-03-30;3418;773;0;85652;27698;0;10.3;3.3;0.0
74;2021-03-31;3055;735;0;88707;28433;0;10.7;3.4;0.0
74;2021-04-01;4001;881;0;92708;29314;0;11.2;3.5;0.0
74;2021-04-02;3516;782;0;96224;30096;0;11.6;3.6;0.0
74;2021-04-03;1573;522;0;97797;30618;0;11.8;3.7;0.0
74;2021-04-04;231;118;0;98028;30736;0;11.8;3.7;0.0
74;2021-04-05;447;18;0;98475;30754;0;11.9;3.7;0.0
74;2021-04-06;2526;1201;0;101001;31955;0;12.2;3.9;0.0
74;2021-04-07;2989;1246;0;103990;33201;0;12.6;4.0;0.0
74;2021-04-08;3695;1209;0;107685;34410;0;13.0;4.2;0.0
74;2021-04-09;3938;1184;0;111623;35594;0;13.5;4.3;0.0
74;2021-04-10;1815;954;0;113438;36548;0;13.7;4.4;0.0
74;2021-04-11;240;171;0;113678;36719;0;13.7;4.4;0.0
74;2021-04-12;2632;1759;0;116310;38478;0;14.0;4.6;0.0
74;2021-04-13;3033;2124;0;119343;40602;0;14.4;4.9;0.0
74;2021-04-14;2828;1955;0;122171;42557;0;14.7;5.1;0.0
74;2021-04-15;3325;1880;0;125496;44437;0;15.1;5.4;0.0
74;2021-04-16;3224;1728;0;128720;46165;0;15.5;5.6;0.0
74;2021-04-17;1827;1015;0;130547;47180;0;15.8;5.7;0.0
74;2021-04-18;203;196;0;130750;47376;0;15.8;5.7;0.0
74;2021-04-19;2050;2037;0;132800;49413;0;16.0;6.0;0.0
74;2021-04-20;2966;2382;0;135766;51795;0;16.4;6.3;0.0
74;2021-04-21;2384;2326;0;138150;54121;0;16.7;6.5;0.0
74;2021-04-22;2484;2302;0;140634;56423;0;17.0;6.8;0.0
74;2021-04-23;2509;2200;0;143143;58623;0;17.3;7.1;0.0
74;2021-04-24;1401;1493;0;144544;60116;0;17.4;7.3;0.0
74;2021-04-25;230;147;0;144774;60263;0;17.5;7.3;0.0
74;2021-04-26;2255;2375;0;147029;62638;0;17.7;7.6;0.0
74;2021-04-27;3082;2798;0;150111;65436;0;18.1;7.9;0.0
74;2021-04-28;3318;2556;0;153429;67992;0;18.5;8.2;0.0
74;2021-04-29;3707;2619;0;157136;70611;0;19.0;8.5;0.0
74;2021-04-30;3900;2173;0;161036;72784;0;19.4;8.8;0.0
74;2021-05-01;2000;386;0;163036;73170;0;19.7;8.8;0.0
74;2021-05-02;202;221;0;163238;73391;0;19.7;8.9;0.0
74;2021-05-03;2496;2901;0;165734;76292;0;20.0;9.2;0.0
74;2021-05-04;3043;2932;0;168777;79224;0;20.4;9.6;0.0
74;2021-05-05;3158;2865;0;171935;82089;0;20.8;9.9;0.0
74;2021-05-06;3659;2584;0;175594;84673;0;21.2;10.2;0.0
74;2021-05-07;3455;3470;0;179049;88143;0;21.6;10.6;0.0
74;2021-05-08;1164;796;0;180213;88939;0;21.8;10.7;0.0
74;2021-05-09;236;246;0;180449;89185;0;21.8;10.8;0.0
74;2021-05-10;3261;3029;0;183710;92214;0;22.2;11.1;0.0
74;2021-05-11;4105;3303;0;187815;95517;0;22.7;11.5;0.0
74;2021-05-12;4859;2868;0;192674;98385;0;23.3;11.9;0.0
74;2021-05-13;2234;921;0;194908;99306;0;23.5;12.0;0.0
74;2021-05-14;5253;2273;0;200161;101579;0;24.2;12.3;0.0
74;2021-05-15;4043;1737;0;204204;103316;0;24.7;12.5;0.0
74;2021-05-16;2321;308;0;206525;103624;0;24.9;12.5;0.0
74;2021-05-17;4860;2772;0;211385;106396;0;25.5;12.8;0.0
74;2021-05-18;6117;2688;0;217502;109084;0;26.3;13.2;0.0
74;2021-05-19;5633;2235;0;223135;111319;0;26.9;13.4;0.0
74;2021-05-20;5941;2413;0;229076;113732;0;27.7;13.7;0.0
74;2021-05-21;5902;2874;0;234978;116606;0;28.4;14.1;0.0
74;2021-05-22;4614;1466;0;239592;118072;0;28.9;14.3;0.0
74;2021-05-23;1688;261;0;241280;118333;0;29.1;14.3;0.0
74;2021-05-24;2306;643;0;243586;118976;0;29.4;14.4;0.0
74;2021-05-25;4689;3184;0;248275;122160;0;30.0;14.7;0.0
74;2021-05-26;4821;2478;0;253096;124638;0;30.6;15.0;0.0
74;2021-05-27;5460;2858;0;258556;127496;0;31.2;15.4;0.0
74;2021-05-28;5094;3484;0;263650;130980;0;31.8;15.8;0.0
74;2021-05-29;3431;2034;0;267081;133014;0;32.2;16.1;0.0
74;2021-05-30;518;301;0;267599;133315;0;32.3;16.1;0.0
74;2021-05-31;4539;3428;0;272138;136743;0;32.9;16.5;0.0
74;2021-06-01;4586;3600;0;276724;140343;0;33.4;16.9;0.0
74;2021-06-02;4801;3063;0;281525;143406;0;34.0;17.3;0.0
74;2021-06-03;6257;3101;0;287782;146507;0;34.7;17.7;0.0
74;2021-06-04;6366;4225;0;294148;150732;0;35.5;18.2;0.0
74;2021-06-05;4008;2539;0;298156;153271;0;36.0;18.5;0.0
74;2021-06-06;217;133;0;298373;153404;0;36.0;18.5;0.0
74;2021-06-07;4576;3936;0;302949;157340;0;36.6;19.0;0.0
74;2021-06-08;4568;3740;0;307517;161080;0;37.1;19.4;0.0
74;2021-06-09;4560;3305;0;312077;164385;0;37.7;19.8;0.0
74;2021-06-10;4652;2735;0;316729;167120;0;38.2;20.2;0.0
74;2021-06-11;4690;3575;0;321419;170695;0;38.8;20.6;0.0
74;2021-06-12;3155;2241;0;324574;172936;0;39.2;20.9;0.0
74;2021-06-13;189;104;0;324763;173040;0;39.2;20.9;0.0
74;2021-06-14;3219;4178;0;327982;177218;0;39.6;21.4;0.0
74;2021-06-15;3280;3674;0;331262;180892;0;40.0;21.8;0.0
74;2021-06-16;4260;2942;0;335522;183834;0;40.5;22.2;0.0
74;2021-06-17;3374;2777;0;338896;186611;0;40.9;22.5;0.0
74;2021-06-18;3798;4408;0;342694;191019;0;41.4;23.1;0.0
74;2021-06-19;2574;2776;0;345268;193795;0;41.7;23.4;0.0
74;2021-06-20;147;132;0;345415;193927;0;41.7;23.4;0.0
74;2021-06-21;2176;5012;0;347591;198939;0;42.0;24.0;0.0
74;2021-06-22;2291;4933;0;349882;203872;0;42.2;24.6;0.0
74;2021-06-23;2757;4356;0;352639;208228;0;42.6;25.1;0.0
74;2021-06-24;2623;4126;0;355262;212354;0;42.9;25.6;0.0
74;2021-06-25;2671;6206;0;357933;218560;0;43.2;26.4;0.0
74;2021-06-26;1486;4805;0;359419;223365;0;43.4;27.0;0.0
74;2021-06-27;83;1366;0;359502;224731;0;43.4;27.1;0.0
74;2021-06-28;1726;6543;0;361228;231274;0;43.6;27.9;0.0
74;2021-06-29;2041;6680;0;363269;237954;0;43.9;28.7;0.0
74;2021-06-30;2535;6010;0;365804;243964;0;44.2;29.4;0.0
74;2021-07-01;3042;4855;0;368846;248819;0;44.5;30.0;0.0
74;2021-07-02;2939;6069;0;371785;254888;0;44.9;30.8;0.0
74;2021-07-03;1462;4559;0;373247;259447;0;45.1;31.3;0.0
74;2021-07-04;113;894;0;373360;260341;0;45.1;31.4;0.0
74;2021-07-05;1913;6263;0;375273;266604;0;45.3;32.2;0.0
74;2021-07-06;2382;5911;0;377655;272515;0;45.6;32.9;0.0
74;2021-07-07;2721;4975;0;380376;277490;0;45.9;33.5;0.0
74;2021-07-08;3413;4464;0;383789;281954;0;46.3;34.0;0.0
74;2021-07-09;2541;6358;0;386330;288312;0;46.6;34.8;0.0
74;2021-07-10;1481;4579;0;387811;292891;0;46.8;35.4;0.0
74;2021-07-11;117;225;0;387928;293116;0;46.8;35.4;0.0
74;2021-07-12;1988;7114;0;389916;300230;0;47.1;36.2;0.0
74;2021-07-13;3660;6842;0;393576;307072;0;47.5;37.1;0.0
74;2021-07-14;2006;2132;0;395582;309204;0;47.8;37.3;0.0
74;2021-07-15;3554;6309;0;399136;315513;0;48.2;38.1;0.0
74;2021-07-16;4013;7111;0;403149;322624;0;48.7;38.9;0.0
74;2021-07-17;2705;4795;0;405854;327419;0;49.0;39.5;0.0
74;2021-07-18;279;273;0;406133;327692;0;49.0;39.6;0.0
74;2021-07-19;3988;6611;0;410121;334303;0;49.5;40.4;0.0
74;2021-07-20;5362;5923;0;415483;340226;0;50.2;41.1;0.0
74;2021-07-21;5192;6022;0;420675;346248;0;50.8;41.8;0.0
74;2021-07-22;4458;4821;0;425133;351069;0;51.3;42.4;0.0
74;2021-07-23;5745;6420;0;430878;357489;0;52.0;43.2;0.0
74;2021-07-24;2968;3904;0;433846;361393;0;52.4;43.6;0.0
74;2021-07-25;250;225;0;434096;361618;0;52.4;43.7;0.0
74;2021-07-26;5018;5562;0;439114;367180;0;53.0;44.3;0.0
74;2021-07-27;6099;4647;0;445213;371827;0;53.7;44.9;0.0
74;2021-07-28;6060;4617;0;451273;376444;0;54.5;45.4;0.0
74;2021-07-29;4817;3613;0;456090;380057;0;55.1;45.9;0.0
74;2021-07-30;6187;4997;0;462277;385054;0;55.8;46.5;0.0
74;2021-07-31;4061;2900;0;466338;387954;0;56.3;46.8;0.0
74;2021-08-01;294;201;0;466632;388155;0;56.3;46.9;0.0
74;2021-08-02;5729;3994;0;472361;392149;0;57.0;47.3;0.0
74;2021-08-03;5328;3490;0;477689;395639;0;57.7;47.8;0.0
74;2021-08-04;5630;3162;0;483319;398801;0;58.3;48.1;0.0
74;2021-08-05;4492;3080;0;487811;401881;0;58.9;48.5;0.0
74;2021-08-06;4566;3860;0;492377;405741;0;59.4;49.0;0.0
74;2021-08-07;2943;2640;0;495320;408381;0;59.8;49.3;0.0
74;2021-08-08;200;208;0;495520;408589;0;59.8;49.3;0.0
74;2021-08-09;4300;4232;0;499820;412821;0;60.3;49.8;0.0
74;2021-08-10;4304;4221;0;504124;417042;0;60.9;50.3;0.0
74;2021-08-11;3868;4276;0;507992;421318;0;61.3;50.9;0.0
74;2021-08-12;3166;3368;0;511158;424686;0;61.7;51.3;0.0
74;2021-08-13;3253;4136;0;514411;428822;0;62.1;51.8;0.0
74;2021-08-14;2031;3049;0;516442;431871;0;62.3;52.1;0.0
74;2021-08-15;97;161;0;516539;432032;0;62.4;52.2;0.0
74;2021-08-16;2922;5266;0;519461;437298;0;62.7;52.8;0.0
74;2021-08-17;2681;4916;0;522142;442214;0;63.0;53.4;0.0
74;2021-08-18;2629;4806;0;524771;447020;0;63.3;54.0;0.0
74;2021-08-19;2116;3616;0;526887;450636;0;63.6;54.4;0.0
74;2021-08-20;2347;5084;0;529234;455720;0;63.9;55.0;0.0
74;2021-08-21;1068;3745;0;530302;459465;0;64.0;55.5;0.0
74;2021-08-22;60;191;0;530362;459656;0;64.0;55.5;0.0
74;2021-08-23;1799;5786;0;532161;465442;0;64.2;56.2;0.0
74;2021-08-24;1896;5100;0;534057;470542;0;64.5;56.8;0.0
74;2021-08-25;1754;5378;0;535811;475920;0;64.7;57.5;0.0
74;2021-08-26;1423;3507;0;537234;479427;0;64.9;57.9;0.0
74;2021-08-27;1686;4996;0;538920;484423;0;65.1;58.5;0.0
74;2021-08-28;880;3612;0;539800;488035;0;65.2;58.9;0.0
74;2021-08-29;78;239;0;539878;488274;0;65.2;58.9;0.0
74;2021-08-30;1617;4960;111;541495;493234;111;65.4;59.5;0.0
74;2021-08-31;1502;4475;144;542997;497709;255;65.5;60.1;0.0
74;2021-09-01;1859;3648;257;544856;501357;512;65.8;60.5;0.1
74;2021-09-02;1159;2642;198;546015;503999;710;65.9;60.8;0.1
74;2021-09-03;1457;3503;331;547472;507502;1041;66.1;61.3;0.1
74;2021-09-04;1130;2522;87;548602;510024;1128;66.2;61.6;0.1
74;2021-09-05;53;136;2;548655;510160;1130;66.2;61.6;0.1
74;2021-09-06;1159;2665;341;549814;512825;1471;66.4;61.9;0.2
74;2021-09-07;953;2329;294;550767;515154;1765;66.5;62.2;0.2
74;2021-09-08;1250;2616;302;552017;517770;2067;66.6;62.5;0.2
74;2021-09-09;1135;1845;314;553152;519615;2381;66.8;62.7;0.3
74;2021-09-10;1099;2547;358;554251;522162;2739;66.9;63.0;0.3
74;2021-09-11;709;2032;114;554960;524194;2853;67.0;63.3;0.3
74;2021-09-12;49;93;8;555009;524287;2861;67.0;63.3;0.3
74;2021-09-13;917;1871;610;555926;526158;3471;67.1;63.5;0.4
74;2021-09-14;991;1665;666;556917;527823;4137;67.2;63.7;0.5
74;2021-09-15;1032;2104;485;557949;529927;4622;67.4;64.0;0.6
74;2021-09-16;735;1016;360;558684;530943;4982;67.4;64.1;0.6
74;2021-09-17;808;1652;474;559492;532595;5456;67.5;64.3;0.7
74;2021-09-18;543;1449;121;560035;534044;5577;67.6;64.5;0.7
74;2021-09-19;11;54;21;560046;534098;5598;67.6;64.5;0.7
74;2021-09-20;728;1543;569;560774;535641;6167;67.7;64.7;0.7
74;2021-09-21;578;1139;459;561352;536780;6626;67.8;64.8;0.8
74;2021-09-22;577;1758;439;561929;538538;7065;67.8;65.0;0.9
74;2021-09-23;601;924;418;562530;539462;7483;67.9;65.1;0.9
74;2021-09-24;657;1630;452;563187;541092;7935;68.0;65.3;1.0
74;2021-09-25;426;1379;130;563613;542471;8065;68.0;65.5;1.0
74;2021-09-26;9;26;0;563622;542497;8065;68.0;65.5;1.0
74;2021-09-27;520;1172;479;564142;543669;8544;68.1;65.6;1.0
74;2021-09-28;369;821;575;564511;544490;9119;68.1;65.7;1.1
74;2021-09-29;506;1333;462;565017;545823;9581;68.2;65.9;1.2
74;2021-09-30;391;1022;432;565408;546845;10013;68.3;66.0;1.2
74;2021-10-01;727;1094;406;566135;547939;10419;68.3;66.1;1.3
74;2021-10-02;418;719;113;566553;548658;10532;68.4;66.2;1.3
74;2021-10-03;9;25;5;566562;548683;10537;68.4;66.2;1.3
74;2021-10-04;575;959;620;567137;549642;11157;68.5;66.3;1.3
74;2021-10-05;356;805;582;567493;550447;11739;68.5;66.4;1.4
74;2021-10-06;426;986;454;567919;551433;12193;68.6;66.6;1.5
74;2021-10-07;270;647;438;568189;552080;12631;68.6;66.6;1.5
74;2021-10-08;612;1127;708;568801;553207;13339;68.7;66.8;1.6
74;2021-10-09;396;732;184;569197;553939;13523;68.7;66.9;1.6
74;2021-10-10;6;25;3;569203;553964;13526;68.7;66.9;1.6
74;2021-10-11;378;808;801;569581;554772;14327;68.8;67.0;1.7
74;2021-10-12;358;653;919;569939;555425;15246;68.8;67.0;1.8
74;2021-10-13;404;793;668;570343;556218;15914;68.8;67.1;1.9
74;2021-10-14;301;543;570;570644;556761;16484;68.9;67.2;2.0
74;2021-10-15;555;905;997;571199;557666;17481;69.0;67.3;2.1
74;2021-10-16;279;534;283;571478;558200;17764;69.0;67.4;2.1
74;2021-10-17;6;28;2;571484;558228;17766;69.0;67.4;2.1
74;2021-10-18;361;648;741;571845;558876;18507;69.0;67.5;2.2
74;2021-10-19;166;516;1084;572011;559392;19591;69.0;67.5;2.4
74;2021-10-20;234;586;1073;572245;559978;20664;69.1;67.6;2.5
74;2021-10-21;105;286;596;572350;560264;21260;69.1;67.6;2.6
74;2021-10-22;264;632;1183;572614;560896;22443;69.1;67.7;2.7
74;2021-10-23;144;372;279;572758;561268;22722;69.1;67.8;2.7
74;2021-10-24;7;19;3;572765;561287;22725;69.1;67.8;2.7
74;2021-10-25;192;418;1060;572957;561705;23785;69.2;67.8;2.9
74;2021-10-26;185;370;1535;573142;562075;25320;69.2;67.9;3.1
74;2021-10-27;212;478;1324;573354;562553;26644;69.2;67.9;3.2
74;2021-10-28;86;221;701;573440;562774;27345;69.2;67.9;3.3
74;2021-10-29;211;508;1414;573651;563282;28759;69.2;68.0;3.5
74;2021-10-30;103;323;504;573754;563605;29263;69.3;68.0;3.5
74;2021-10-31;2;7;0;573756;563612;29263;69.3;68.0;3.5
74;2021-11-01;38;49;36;573794;563661;29299;69.3;68.0;3.5
74;2021-11-02;202;443;1358;573996;564104;30657;69.3;68.1;3.7
74;2021-11-03;177;371;1510;574173;564475;32167;69.3;68.1;3.9
74;2021-11-04;94;248;955;574267;564723;33122;69.3;68.2;4.0
74;2021-11-05;221;422;1763;574488;565145;34885;69.3;68.2;4.2
74;2021-11-06;101;252;512;574589;565397;35397;69.4;68.3;4.3
74;2021-11-07;3;22;3;574592;565419;35400;69.4;68.3;4.3
74;2021-11-08;134;402;1971;574726;565821;37371;69.4;68.3;4.5
74;2021-11-09;154;254;2075;574880;566075;39446;69.4;68.3;4.8
74;2021-11-10;227;382;2490;575107;566457;41936;69.4;68.4;5.1
74;2021-11-11;5;32;20;575112;566489;41956;69.4;68.4;5.1
74;2021-11-12;185;333;2137;575297;566822;44093;69.4;68.4;5.3
74;2021-11-13;143;173;752;575440;566995;44845;69.5;68.4;5.4
74;2021-11-14;3;13;16;575443;567008;44861;69.5;68.4;5.4
74;2021-11-15;115;236;2192;575558;567244;47053;69.5;68.5;5.7
74;2021-11-16;143;206;2654;575701;567450;49707;69.5;68.5;6.0
74;2021-11-17;244;352;2629;575945;567802;52336;69.5;68.5;6.3
74;2021-11-18;93;149;1688;576038;567951;54024;69.5;68.6;6.5
74;2021-11-19;210;314;3114;576248;568265;57138;69.6;68.6;6.9
74;2021-11-20;223;193;970;576471;568458;58108;69.6;68.6;7.0
74;2021-11-21;14;16;33;576485;568474;58141;69.6;68.6;7.0
74;2021-11-22;169;166;2490;576654;568640;60631;69.6;68.6;7.3
74;2021-11-23;193;203;2686;576847;568843;63317;69.6;68.7;7.6
74;2021-11-24;247;299;2617;577094;569142;65934;69.7;68.7;8.0
74;2021-11-25;138;141;2176;577232;569283;68110;69.7;68.7;8.2
74;2021-11-26;249;327;4294;577481;569610;72404;69.7;68.8;8.7
74;2021-11-27;171;218;1920;577652;569828;74324;69.7;68.8;9.0
74;2021-11-28;5;16;84;577657;569844;74408;69.7;68.8;9.0
74;2021-11-29;129;185;3640;577786;570029;78048;69.7;68.8;9.4
74;2021-11-30;169;264;4775;577955;570293;82823;69.8;68.8;10.0
74;2021-12-01;185;256;4767;578140;570549;87590;69.8;68.9;10.6
74;2021-12-02;151;154;4670;578291;570703;92260;69.8;68.9;11.1
74;2021-12-03;186;247;6070;578477;570950;98330;69.8;68.9;11.9
74;2021-12-04;121;195;2792;578598;571145;101122;69.8;68.9;12.2
74;2021-12-05;5;21;254;578603;571166;101376;69.8;68.9;12.2
74;2021-12-06;187;205;5562;578790;571371;106938;69.9;69.0;12.9
74;2021-12-07;188;245;6954;578978;571616;113892;69.9;69.0;13.7
74;2021-12-08;201;294;5773;579179;571910;119665;69.9;69.0;14.4
74;2021-12-09;171;214;6723;579350;572124;126388;69.9;69.1;15.3
74;2021-12-10;151;252;6111;579501;572376;132499;70.0;69.1;16.0
74;2021-12-11;121;228;3819;579622;572604;136318;70.0;69.1;16.5
74;2021-12-12;13;38;370;579635;572642;136688;70.0;69.1;16.5
74;2021-12-13;145;243;6932;579780;572885;143620;70.0;69.2;17.3
74;2021-12-14;230;291;8952;580010;573176;152572;70.0;69.2;18.4
74;2021-12-15;231;361;7750;580241;573537;160322;70.0;69.2;19.4
74;2021-12-16;203;265;7974;580444;573802;168296;70.1;69.3;20.3
75;2020-12-27;27;0;0;27;0;0;0.0;0.0;0.0
75;2020-12-28;27;0;0;54;0;0;0.0;0.0;0.0
75;2020-12-29;21;1;0;75;1;0;0.0;0.0;0.0
75;2020-12-30;67;0;0;142;1;0;0.0;0.0;0.0
75;2020-12-31;45;0;0;187;1;0;0.0;0.0;0.0
75;2021-01-01;43;2;0;230;3;0;0.0;0.0;0.0
75;2021-01-02;40;1;0;270;4;0;0.0;0.0;0.0
75;2021-01-03;70;3;0;340;7;0;0.0;0.0;0.0
75;2021-01-04;231;3;0;571;10;0;0.0;0.0;0.0
75;2021-01-05;656;7;0;1227;17;0;0.1;0.0;0.0
75;2021-01-06;995;3;0;2222;20;0;0.1;0.0;0.0
75;2021-01-07;1482;10;0;3704;30;0;0.2;0.0;0.0
75;2021-01-08;2218;19;0;5922;49;0;0.3;0.0;0.0
75;2021-01-09;788;5;0;6710;54;0;0.3;0.0;0.0
75;2021-01-10;783;2;0;7493;56;0;0.3;0.0;0.0
75;2021-01-11;2183;31;0;9676;87;0;0.5;0.0;0.0
75;2021-01-12;2546;48;0;12222;135;0;0.6;0.0;0.0
75;2021-01-13;2705;43;0;14927;178;0;0.7;0.0;0.0
75;2021-01-14;2765;50;0;17692;228;0;0.8;0.0;0.0
75;2021-01-15;2492;34;0;20184;262;0;0.9;0.0;0.0
75;2021-01-16;890;16;0;21074;278;0;1.0;0.0;0.0
75;2021-01-17;505;10;0;21579;288;0;1.0;0.0;0.0
75;2021-01-18;3050;52;0;24629;340;0;1.1;0.0;0.0
75;2021-01-19;3995;54;0;28624;394;0;1.3;0.0;0.0
75;2021-01-20;4432;49;0;33056;443;0;1.5;0.0;0.0
75;2021-01-21;5220;60;0;38276;503;0;1.8;0.0;0.0
75;2021-01-22;4428;69;0;42704;572;0;2.0;0.0;0.0
75;2021-01-23;1684;12;0;44388;584;0;2.1;0.0;0.0
75;2021-01-24;604;5;0;44992;589;0;2.1;0.0;0.0
75;2021-01-25;1878;24;0;46870;613;0;2.2;0.0;0.0
75;2021-01-26;2752;78;0;49622;691;0;2.3;0.0;0.0
75;2021-01-27;3613;184;0;53235;875;0;2.5;0.0;0.0
75;2021-01-28;4932;278;0;58167;1153;0;2.7;0.1;0.0
75;2021-01-29;3776;290;0;61943;1443;0;2.9;0.1;0.0
75;2021-01-30;1328;49;0;63271;1492;0;2.9;0.1;0.0
75;2021-01-31;197;7;0;63468;1499;0;3.0;0.1;0.0
75;2021-02-01;1782;384;0;65250;1883;0;3.0;0.1;0.0
75;2021-02-02;2212;603;0;67462;2486;0;3.1;0.1;0.0
75;2021-02-03;2110;729;0;69572;3215;0;3.2;0.1;0.0
75;2021-02-04;2329;1021;0;71901;4236;0;3.3;0.2;0.0
75;2021-02-05;2278;858;0;74179;5094;0;3.5;0.2;0.0
75;2021-02-06;1088;154;0;75267;5248;0;3.5;0.2;0.0
75;2021-02-07;176;66;0;75443;5314;0;3.5;0.2;0.0
75;2021-02-08;1346;1281;0;76789;6595;0;3.6;0.3;0.0
75;2021-02-09;1944;1922;0;78733;8517;0;3.7;0.4;0.0
75;2021-02-10;2380;2224;0;81113;10741;0;3.8;0.5;0.0
75;2021-02-11;2797;5017;0;83910;15758;0;3.9;0.7;0.0
75;2021-02-12;3043;2263;0;86953;18021;0;4.0;0.8;0.0
75;2021-02-13;797;896;0;87750;18917;0;4.1;0.9;0.0
75;2021-02-14;144;110;0;87894;19027;0;4.1;0.9;0.0
75;2021-02-15;994;2667;0;88888;21694;0;4.1;1.0;0.0
75;2021-02-16;1281;5720;0;90169;27414;0;4.2;1.3;0.0
75;2021-02-17;1196;3637;0;91365;31051;0;4.3;1.4;0.0
75;2021-02-18;1693;5692;0;93058;36743;0;4.3;1.7;0.0
75;2021-02-19;1988;3919;0;95046;40662;0;4.4;1.9;0.0
75;2021-02-20;462;1440;0;95508;42102;0;4.4;2.0;0.0
75;2021-02-21;167;193;0;95675;42295;0;4.5;2.0;0.0
75;2021-02-22;1050;2335;0;96725;44630;0;4.5;2.1;0.0
75;2021-02-23;1267;2779;0;97992;47409;0;4.6;2.2;0.0
75;2021-02-24;1450;2523;0;99442;49932;0;4.6;2.3;0.0
75;2021-02-25;2281;4364;0;101723;54296;0;4.7;2.5;0.0
75;2021-02-26;2776;2511;0;104499;56807;0;4.9;2.6;0.0
75;2021-02-27;1269;930;0;105768;57737;0;4.9;2.7;0.0
75;2021-02-28;301;171;0;106069;57908;0;4.9;2.7;0.0
75;2021-03-01;2200;1895;0;108269;59803;0;5.0;2.8;0.0
75;2021-03-02;3566;2460;0;111835;62263;0;5.2;2.9;0.0
75;2021-03-03;4575;2553;0;116410;64816;0;5.4;3.0;0.0
75;2021-03-04;6481;2700;0;122891;67516;0;5.7;3.1;0.0
75;2021-03-05;8276;2759;0;131167;70275;0;6.1;3.3;0.0
75;2021-03-06;9940;1126;0;141107;71401;0;6.6;3.3;0.0
75;2021-03-07;8337;1014;0;149444;72415;0;7.0;3.4;0.0
75;2021-03-08;4616;1778;0;154060;74193;0;7.2;3.5;0.0
75;2021-03-09;6271;2210;0;160331;76403;0;7.5;3.6;0.0
75;2021-03-10;6007;2261;0;166338;78664;0;7.7;3.7;0.0
75;2021-03-11;8332;2480;0;174670;81144;0;8.1;3.8;0.0
75;2021-03-12;10121;2547;0;184791;83691;0;8.6;3.9;0.0
75;2021-03-13;7778;817;0;192569;84508;0;9.0;3.9;0.0
75;2021-03-14;3439;270;0;196008;84778;0;9.1;3.9;0.0
75;2021-03-15;6529;1095;0;202537;85873;0;9.4;4.0;0.0
75;2021-03-16;4801;836;0;207338;86709;0;9.7;4.0;0.0
75;2021-03-17;4967;944;0;212305;87653;0;9.9;4.1;0.0
75;2021-03-18;6044;1001;0;218349;88654;0;10.2;4.1;0.0
75;2021-03-19;8675;1138;0;227024;89792;0;10.6;4.2;0.0
75;2021-03-20;5466;548;0;232490;90340;0;10.8;4.2;0.0
75;2021-03-21;1488;435;0;233978;90775;0;10.9;4.2;0.0
75;2021-03-22;7595;1184;0;241573;91959;0;11.2;4.3;0.0
75;2021-03-23;9640;1332;0;251213;93291;0;11.7;4.3;0.0
75;2021-03-24;9480;1307;0;260693;94598;0;12.1;4.4;0.0
75;2021-03-25;12223;1515;0;272916;96113;0;12.7;4.5;0.0
75;2021-03-26;12161;1649;0;285077;97762;0;13.3;4.6;0.0
75;2021-03-27;6558;738;0;291635;98500;0;13.6;4.6;0.0
75;2021-03-28;1669;157;0;293304;98657;0;13.7;4.6;0.0
75;2021-03-29;6713;2096;0;300017;100753;0;14.0;4.7;0.0
75;2021-03-30;9219;2997;0;309236;103750;0;14.4;4.8;0.0
75;2021-03-31;7925;3477;0;317161;107227;0;14.8;5.0;0.0
75;2021-04-01;8679;4838;0;325840;112065;0;15.2;5.2;0.0
75;2021-04-02;7365;5290;0;333205;117355;0;15.5;5.5;0.0
75;2021-04-03;3542;4788;0;336747;122143;0;15.7;5.7;0.0
75;2021-04-04;1138;1499;0;337885;123642;0;15.7;5.8;0.0
75;2021-04-05;1941;1141;0;339826;124783;0;15.8;5.8;0.0
75;2021-04-06;6060;4319;0;345886;129102;0;16.1;6.0;0.0
75;2021-04-07;7343;4186;0;353229;133288;0;16.4;6.2;0.0
75;2021-04-08;9832;4090;0;363061;137378;0;16.9;6.4;0.0
75;2021-04-09;10864;4565;0;373925;141943;0;17.4;6.6;0.0
75;2021-04-10;5603;3868;0;379528;145811;0;17.7;6.8;0.0
75;2021-04-11;1598;1536;0;381126;147347;0;17.7;6.9;0.0
75;2021-04-12;6823;3962;0;387949;151309;0;18.1;7.0;0.0
75;2021-04-13;7659;6111;0;395608;157420;0;18.4;7.3;0.0
75;2021-04-14;7305;5060;0;402913;162480;0;18.8;7.6;0.0
75;2021-04-15;8009;5713;0;410922;168193;0;19.1;7.8;0.0
75;2021-04-16;8430;5729;0;419352;173922;0;19.5;8.1;0.0
75;2021-04-17;4567;3428;0;423919;177350;0;19.7;8.3;0.0
75;2021-04-18;1339;950;0;425258;178300;0;19.8;8.3;0.0
75;2021-04-19;5412;4848;0;430670;183148;0;20.0;8.5;0.0
75;2021-04-20;6261;5518;0;436931;188666;0;20.3;8.8;0.0
75;2021-04-21;6401;5344;0;443332;194010;0;20.6;9.0;0.0
75;2021-04-22;7333;5851;0;450665;199861;0;21.0;9.3;0.0
75;2021-04-23;7989;6128;0;458654;205989;0;21.3;9.6;0.0
75;2021-04-24;6261;3605;0;464915;209594;0;21.6;9.8;0.0
75;2021-04-25;2612;1009;0;467527;210603;0;21.8;9.8;0.0
75;2021-04-26;6531;4875;0;474058;215478;0;22.1;10.0;0.0
75;2021-04-27;9262;6049;0;483320;221527;0;22.5;10.3;0.0
75;2021-04-28;10517;5717;0;493837;227244;0;23.0;10.6;0.0
75;2021-04-29;12202;5868;0;506039;233112;0;23.6;10.9;0.0
75;2021-04-30;12576;5849;0;518615;238961;0;24.1;11.1;0.0
75;2021-05-01;4847;1339;0;523462;240300;0;24.4;11.2;0.0
75;2021-05-02;2339;926;0;525801;241226;0;24.5;11.2;0.0
75;2021-05-03;10136;9367;0;535937;250593;0;24.9;11.7;0.0
75;2021-05-04;10831;7209;0;546768;257802;0;25.5;12.0;0.0
75;2021-05-05;12250;6556;0;559018;264358;0;26.0;12.3;0.0
75;2021-05-06;13245;7670;0;572263;272028;0;26.6;12.7;0.0
75;2021-05-07;12606;8334;0;584869;280362;0;27.2;13.1;0.0
75;2021-05-08;10015;3682;0;594884;284044;0;27.7;13.2;0.0
75;2021-05-09;5036;2339;0;599920;286383;0;27.9;13.3;0.0
75;2021-05-10;12954;6443;0;612874;292826;0;28.5;13.6;0.0
75;2021-05-11;16126;7983;0;629000;300809;0;29.3;14.0;0.0
75;2021-05-12;17976;7304;0;646976;308113;0;30.1;14.3;0.0
75;2021-05-13;15266;2592;0;662242;310705;0;30.8;14.5;0.0
75;2021-05-14;18889;5286;0;681131;315991;0;31.7;14.7;0.0
75;2021-05-15;14291;3019;0;695422;319010;0;32.4;14.8;0.0
75;2021-05-16;6262;982;0;701684;319992;0;32.7;14.9;0.0
75;2021-05-17;17410;4541;0;719094;324533;0;33.5;15.1;0.0
75;2021-05-18;20789;5130;0;739883;329663;0;34.4;15.3;0.0
75;2021-05-19;20631;7550;0;760514;337213;0;35.4;15.7;0.0
75;2021-05-20;22168;7021;0;782682;344234;0;36.4;16.0;0.0
75;2021-05-21;21165;6115;0;803847;350349;0;37.4;16.3;0.0
75;2021-05-22;16442;3234;0;820289;353583;0;38.2;16.5;0.0
75;2021-05-23;7267;1310;0;827556;354893;0;38.5;16.5;0.0
75;2021-05-24;15221;2583;0;842777;357476;0;39.2;16.6;0.0
75;2021-05-25;18489;8019;0;861266;365495;0;40.1;17.0;0.0
75;2021-05-26;18108;7225;0;879374;372720;0;40.9;17.3;0.0
75;2021-05-27;19437;8526;0;898811;381246;0;41.8;17.7;0.0
75;2021-05-28;18583;9755;0;917394;391001;0;42.7;18.2;0.0
75;2021-05-29;15326;5553;0;932720;396554;0;43.4;18.5;0.0
75;2021-05-30;7830;2019;0;940550;398573;0;43.8;18.6;0.0
75;2021-05-31;17655;8959;0;958205;407532;0;44.6;19.0;0.0
75;2021-06-01;18467;11243;0;976672;418775;0;45.5;19.5;0.0
75;2021-06-02;17696;9540;0;994368;428315;0;46.3;19.9;0.0
75;2021-06-03;19244;11120;0;1013612;439435;0;47.2;20.5;0.0
75;2021-06-04;17686;12291;0;1031298;451726;0;48.0;21.0;0.0
75;2021-06-05;12147;9613;0;1043445;461339;0;48.6;21.5;0.0
75;2021-06-06;8066;3130;0;1051511;464469;0;48.9;21.6;0.0
75;2021-06-07;14170;11405;0;1065681;475874;0;49.6;22.2;0.0
75;2021-06-08;14858;13579;0;1080539;489453;0;50.3;22.8;0.0
75;2021-06-09;15384;13827;0;1095923;503280;0;51.0;23.4;0.0
75;2021-06-10;16556;18947;0;1112479;522227;0;51.8;24.3;0.0
75;2021-06-11;13265;15314;0;1125744;537541;0;52.4;25.0;0.0
75;2021-06-12;11871;9486;0;1137615;547027;0;53.0;25.5;0.0
75;2021-06-13;6381;3906;0;1143996;550933;0;53.3;25.6;0.0
75;2021-06-14;10332;15184;0;1154328;566117;0;53.7;26.4;0.0
75;2021-06-15;11206;17620;0;1165534;583737;0;54.3;27.2;0.0
75;2021-06-16;10849;16160;0;1176383;599897;0;54.8;27.9;0.0
75;2021-06-17;10800;16797;0;1187183;616694;0;55.3;28.7;0.0
75;2021-06-18;9194;20727;0;1196377;637421;0;55.7;29.7;0.0
75;2021-06-19;6779;12473;0;1203156;649894;0;56.0;30.3;0.0
75;2021-06-20;2801;6295;0;1205957;656189;0;56.1;30.5;0.0
75;2021-06-21;6996;16767;0;1212953;672956;0;56.5;31.3;0.0
75;2021-06-22;7254;21456;0;1220207;694412;0;56.8;32.3;0.0
75;2021-06-23;7961;20391;0;1228168;714803;0;57.2;33.3;0.0
75;2021-06-24;8764;20395;0;1236932;735198;0;57.6;34.2;0.0
75;2021-06-25;7477;23420;0;1244409;758618;0;57.9;35.3;0.0
75;2021-06-26;6252;16418;0;1250661;775036;0;58.2;36.1;0.0
75;2021-06-27;2282;7486;0;1252943;782522;0;58.3;36.4;0.0
75;2021-06-28;6442;20407;0;1259385;802929;0;58.6;37.4;0.0
75;2021-06-29;7133;23237;0;1266518;826166;0;59.0;38.5;0.0
75;2021-06-30;7324;22166;0;1273842;848332;0;59.3;39.5;0.0
75;2021-07-01;8631;21891;0;1282473;870223;0;59.7;40.5;0.0
75;2021-07-02;7986;22684;0;1290459;892907;0;60.1;41.6;0.0
75;2021-07-03;5751;18449;0;1296210;911356;0;60.3;42.4;0.0
75;2021-07-04;2630;9031;0;1298840;920387;0;60.5;42.8;0.0
75;2021-07-05;6708;20014;0;1305548;940401;0;60.8;43.8;0.0
75;2021-07-06;7425;21833;1;1312973;962234;1;61.1;44.8;0.0
75;2021-07-07;7214;21203;0;1320187;983437;1;61.5;45.8;0.0
75;2021-07-08;7922;20966;0;1328109;1004403;1;61.8;46.8;0.0
75;2021-07-09;7859;21525;0;1335968;1025928;1;62.2;47.8;0.0
75;2021-07-10;5756;16584;0;1341724;1042512;1;62.5;48.5;0.0
75;2021-07-11;2943;8108;0;1344667;1050620;1;62.6;48.9;0.0
75;2021-07-12;6908;20867;0;1351575;1071487;1;62.9;49.9;0.0
75;2021-07-13;10136;21976;0;1361711;1093463;1;63.4;50.9;0.0
75;2021-07-14;6422;8661;0;1368133;1102124;1;63.7;51.3;0.0
75;2021-07-15;10717;22229;0;1378850;1124353;1;64.2;52.3;0.0
75;2021-07-16;11113;19442;0;1389963;1143795;1;64.7;53.2;0.0
75;2021-07-17;7949;14510;0;1397912;1158305;1;65.1;53.9;0.0
75;2021-07-18;4032;6519;0;1401944;1164824;1;65.3;54.2;0.0
75;2021-07-19;9528;18624;0;1411472;1183448;1;65.7;55.1;0.0
75;2021-07-20;11108;19232;0;1422580;1202680;1;66.2;56.0;0.0
75;2021-07-21;10792;17461;0;1433372;1220141;1;66.7;56.8;0.0
75;2021-07-22;11689;16690;0;1445061;1236831;1;67.3;57.6;0.0
75;2021-07-23;11640;15698;0;1456701;1252529;1;67.8;58.3;0.0
75;2021-07-24;7576;11205;0;1464277;1263734;1;68.2;58.8;0.0
75;2021-07-25;3427;4022;0;1467704;1267756;1;68.3;59.0;0.0
75;2021-07-26;10389;13538;1;1478093;1281294;2;68.8;59.6;0.0
75;2021-07-27;12380;12918;0;1490473;1294212;2;69.4;60.2;0.0
75;2021-07-28;11870;11932;0;1502343;1306144;2;69.9;60.8;0.0
75;2021-07-29;11836;11830;0;1514179;1317974;2;70.5;61.4;0.0
75;2021-07-30;11269;11401;0;1525448;1329375;2;71.0;61.9;0.0
75;2021-07-31;6622;7569;0;1532070;1336944;2;71.3;62.2;0.0
75;2021-08-01;2769;2462;0;1534839;1339406;2;71.4;62.3;0.0
75;2021-08-02;7977;9416;0;1542816;1348822;2;71.8;62.8;0.0
75;2021-08-03;8052;8837;0;1550868;1357659;2;72.2;63.2;0.0
75;2021-08-04;7304;7643;0;1558172;1365302;2;72.5;63.6;0.0
75;2021-08-05;6539;7722;0;1564711;1373024;2;72.8;63.9;0.0
75;2021-08-06;6356;8099;0;1571067;1381123;2;73.1;64.3;0.0
75;2021-08-07;3960;5355;0;1575027;1386478;2;73.3;64.5;0.0
75;2021-08-08;1338;2259;0;1576365;1388737;2;73.4;64.6;0.0
75;2021-08-09;5746;8551;0;1582111;1397288;2;73.6;65.0;0.0
75;2021-08-10;6176;8756;0;1588287;1406044;2;73.9;65.5;0.0
75;2021-08-11;5346;7813;0;1593633;1413857;2;74.2;65.8;0.0
75;2021-08-12;4767;8057;0;1598400;1421914;2;74.4;66.2;0.0
75;2021-08-13;4340;6975;0;1602740;1428889;2;74.6;66.5;0.0
75;2021-08-14;2672;5186;0;1605412;1434075;2;74.7;66.8;0.0
75;2021-08-15;666;1216;0;1606078;1435291;2;74.8;66.8;0.0
75;2021-08-16;4246;9805;0;1610324;1445096;2;75.0;67.3;0.0
75;2021-08-17;3957;9557;0;1614281;1454653;2;75.1;67.7;0.0
75;2021-08-18;3509;8698;0;1617790;1463351;2;75.3;68.1;0.0
75;2021-08-19;3476;8736;0;1621266;1472087;2;75.5;68.5;0.0
75;2021-08-20;3165;8467;0;1624431;1480554;2;75.6;68.9;0.0
75;2021-08-21;2157;6210;0;1626588;1486764;2;75.7;69.2;0.0
75;2021-08-22;632;2315;0;1627220;1489079;2;75.7;69.3;0.0
75;2021-08-23;3283;10166;0;1630503;1499245;2;75.9;69.8;0.0
75;2021-08-24;3342;9702;0;1633845;1508947;2;76.1;70.2;0.0
75;2021-08-25;3104;8492;0;1636949;1517439;2;76.2;70.6;0.0
75;2021-08-26;2817;7424;4;1639766;1524863;6;76.3;71.0;0.0
75;2021-08-27;3213;8599;2;1642979;1533462;8;76.5;71.4;0.0
75;2021-08-28;2262;5932;0;1645241;1539394;8;76.6;71.7;0.0
75;2021-08-29;617;1540;0;1645858;1540934;8;76.6;71.7;0.0
75;2021-08-30;3259;9466;562;1649117;1550400;570;76.8;72.2;0.0
75;2021-08-31;3120;8538;1038;1652237;1558938;1608;76.9;72.6;0.1
75;2021-09-01;3379;6865;1764;1655616;1565803;3372;77.1;72.9;0.2
75;2021-09-02;2528;5166;1943;1658144;1570969;5315;77.2;73.1;0.2
75;2021-09-03;2614;5884;1942;1660758;1576853;7257;77.3;73.4;0.3
75;2021-09-04;2764;5534;1050;1663522;1582387;8307;77.4;73.7;0.4
75;2021-09-05;468;920;395;1663990;1583307;8702;77.5;73.7;0.4
75;2021-09-06;1750;4037;1705;1665740;1587344;10407;77.5;73.9;0.5
75;2021-09-07;1580;3564;1595;1667320;1590908;12002;77.6;74.1;0.6
75;2021-09-08;1868;3967;1522;1669188;1594875;13524;77.7;74.2;0.6
75;2021-09-09;1663;3216;1717;1670851;1598091;15241;77.8;74.4;0.7
75;2021-09-10;1970;3773;2038;1672821;1601864;17279;77.9;74.6;0.8
75;2021-09-11;1667;4037;826;1674488;1605901;18105;77.9;74.8;0.8
75;2021-09-12;312;630;178;1674800;1606531;18283;78.0;74.8;0.9
75;2021-09-13;1650;2904;1866;1676450;1609435;20149;78.0;74.9;0.9
75;2021-09-14;1528;2554;1965;1677978;1611989;22114;78.1;75.0;1.0
75;2021-09-15;1752;3096;1834;1679730;1615085;23948;78.2;75.2;1.1
75;2021-09-16;1375;2243;1778;1681105;1617328;25726;78.3;75.3;1.2
75;2021-09-17;1843;3260;2207;1682948;1620588;27933;78.3;75.4;1.3
75;2021-09-18;1162;3457;714;1684110;1624045;28647;78.4;75.6;1.3
75;2021-09-19;216;539;116;1684326;1624584;28763;78.4;75.6;1.3
75;2021-09-20;1285;2425;1849;1685611;1627009;30612;78.5;75.7;1.4
75;2021-09-21;1153;2073;1670;1686764;1629082;32282;78.5;75.8;1.5
75;2021-09-22;1249;2969;1691;1688013;1632051;33973;78.6;76.0;1.6
75;2021-09-23;992;1787;1828;1689005;1633838;35801;78.6;76.1;1.7
75;2021-09-24;1260;2805;2030;1690265;1636643;37831;78.7;76.2;1.8
75;2021-09-25;906;3210;625;1691171;1639853;38456;78.7;76.3;1.8
75;2021-09-26;188;411;120;1691359;1640264;38576;78.7;76.4;1.8
75;2021-09-27;958;2002;1609;1692317;1642266;40185;78.8;76.4;1.9
75;2021-09-28;1021;1604;1680;1693338;1643870;41865;78.8;76.5;1.9
75;2021-09-29;1054;2090;1770;1694392;1645960;43635;78.9;76.6;2.0
75;2021-09-30;902;1745;1942;1695294;1647705;45577;78.9;76.7;2.1
75;2021-10-01;1646;1953;2191;1696940;1649658;47768;79.0;76.8;2.2
75;2021-10-02;1127;2027;896;1698067;1651685;48664;79.0;76.9;2.3
75;2021-10-03;158;282;120;1698225;1651967;48784;79.1;76.9;2.3
75;2021-10-04;1111;1631;2753;1699336;1653598;51537;79.1;77.0;2.4
75;2021-10-05;888;1425;2623;1700224;1655023;54160;79.1;77.0;2.5
75;2021-10-06;1031;1759;2522;1701255;1656782;56682;79.2;77.1;2.6
75;2021-10-07;839;1324;2456;1702094;1658106;59138;79.2;77.2;2.8
75;2021-10-08;1191;2114;3272;1703285;1660220;62410;79.3;77.3;2.9
75;2021-10-09;965;1538;1379;1704250;1661758;63789;79.3;77.4;3.0
75;2021-10-10;181;304;164;1704431;1662062;63953;79.3;77.4;3.0
75;2021-10-11;946;1403;2589;1705377;1663465;66542;79.4;77.4;3.1
75;2021-10-12;893;1399;2870;1706270;1664864;69412;79.4;77.5;3.2
75;2021-10-13;1007;1559;2788;1707277;1666423;72200;79.5;77.6;3.4
75;2021-10-14;835;1287;2840;1708112;1667710;75040;79.5;77.6;3.5
75;2021-10-15;1128;1617;3529;1709240;1669327;78569;79.6;77.7;3.7
75;2021-10-16;970;1366;1466;1710210;1670693;80035;79.6;77.8;3.7
75;2021-10-17;165;233;245;1710375;1670926;80280;79.6;77.8;3.7
75;2021-10-18;828;1178;2941;1711203;1672104;83221;79.7;77.8;3.9
75;2021-10-19;754;1171;3503;1711957;1673275;86724;79.7;77.9;4.0
75;2021-10-20;848;1254;3470;1712805;1674529;90194;79.7;77.9;4.2
75;2021-10-21;614;1116;3053;1713419;1675645;93247;79.8;78.0;4.3
75;2021-10-22;910;1387;3862;1714329;1677032;97109;79.8;78.1;4.5
75;2021-10-23;727;1111;1886;1715056;1678143;98995;79.8;78.1;4.6
75;2021-10-24;110;148;179;1715166;1678291;99174;79.8;78.1;4.6
75;2021-10-25;667;1029;3470;1715833;1679320;102644;79.9;78.2;4.8
75;2021-10-26;668;954;3808;1716501;1680274;106452;79.9;78.2;5.0
75;2021-10-27;645;984;3866;1717146;1681258;110318;79.9;78.3;5.1
75;2021-10-28;588;861;3606;1717734;1682119;113924;80.0;78.3;5.3
75;2021-10-29;680;1051;4216;1718414;1683170;118140;80.0;78.3;5.5
75;2021-10-30;527;806;2022;1718941;1683976;120162;80.0;78.4;5.6
75;2021-10-31;77;137;217;1719018;1684113;120379;80.0;78.4;5.6
75;2021-11-01;183;149;236;1719201;1684262;120615;80.0;78.4;5.6
75;2021-11-02;708;1038;3268;1719909;1685300;123883;80.1;78.4;5.8
75;2021-11-03;602;967;3515;1720511;1686267;127398;80.1;78.5;5.9
75;2021-11-04;536;836;3429;1721047;1687103;130827;80.1;78.5;6.1
75;2021-11-05;632;1009;4357;1721679;1688112;135184;80.1;78.6;6.3
75;2021-11-06;530;853;2115;1722209;1688965;137299;80.2;78.6;6.4
75;2021-11-07;102;159;299;1722311;1689124;137598;80.2;78.6;6.4
75;2021-11-08;479;830;4552;1722790;1689954;142150;80.2;78.7;6.6
75;2021-11-09;563;885;5423;1723353;1690839;147573;80.2;78.7;6.9
75;2021-11-10;726;1118;6096;1724079;1691957;153669;80.3;78.8;7.2
75;2021-11-11;200;316;1106;1724279;1692273;154775;80.3;78.8;7.2
75;2021-11-12;607;986;6277;1724886;1693259;161052;80.3;78.8;7.5
75;2021-11-13;546;809;3025;1725432;1694068;164077;80.3;78.9;7.6
75;2021-11-14;96;151;446;1725528;1694219;164523;80.3;78.9;7.7
75;2021-11-15;498;848;5789;1726026;1695067;170312;80.3;78.9;7.9
75;2021-11-16;576;825;6307;1726602;1695892;176619;80.4;78.9;8.2
75;2021-11-17;676;922;5970;1727278;1696814;182589;80.4;79.0;8.5
75;2021-11-18;514;815;5944;1727792;1697629;188533;80.4;79.0;8.8
75;2021-11-19;670;900;7158;1728462;1698529;195691;80.5;79.1;9.1
75;2021-11-20;612;859;3669;1729074;1699388;199360;80.5;79.1;9.3
75;2021-11-21;80;157;564;1729154;1699545;199924;80.5;79.1;9.3
75;2021-11-22;552;636;6361;1729706;1700181;206285;80.5;79.1;9.6
75;2021-11-23;618;791;7468;1730324;1700972;213753;80.5;79.2;10.0
75;2021-11-24;635;894;7227;1730959;1701866;220980;80.6;79.2;10.3
75;2021-11-25;593;767;9707;1731552;1702633;230687;80.6;79.3;10.7
75;2021-11-26;547;859;13959;1732099;1703492;244646;80.6;79.3;11.4
75;2021-11-27;483;748;10605;1732582;1704240;255251;80.7;79.3;11.9
75;2021-11-28;143;211;4676;1732725;1704451;259927;80.7;79.3;12.1
75;2021-11-29;460;734;15216;1733185;1705185;275143;80.7;79.4;12.8
75;2021-11-30;508;852;18724;1733693;1706037;293867;80.7;79.4;13.7
75;2021-12-01;488;886;19222;1734181;1706923;313089;80.7;79.5;14.6
75;2021-12-02;450;704;20604;1734631;1707627;333693;80.7;79.5;15.5
75;2021-12-03;506;932;22632;1735137;1708559;356325;80.8;79.5;16.6
75;2021-12-04;374;748;15499;1735511;1709307;371824;80.8;79.6;17.3
75;2021-12-05;176;296;8040;1735687;1709603;379864;80.8;79.6;17.7
75;2021-12-06;423;791;20814;1736110;1710394;400678;80.8;79.6;18.7
75;2021-12-07;499;917;24706;1736609;1711311;425384;80.8;79.7;19.8
75;2021-12-08;503;920;22608;1737112;1712231;447992;80.9;79.7;20.9
75;2021-12-09;444;866;24539;1737556;1713097;472531;80.9;79.7;22.0
75;2021-12-10;463;881;26051;1738019;1713978;498582;80.9;79.8;23.2
75;2021-12-11;503;880;20120;1738522;1714858;518702;80.9;79.8;24.1
75;2021-12-12;236;328;12957;1738758;1715186;531659;80.9;79.8;24.7
75;2021-12-13;497;871;25148;1739255;1716057;556807;81.0;79.9;25.9
75;2021-12-14;587;950;29598;1739842;1717007;586405;81.0;79.9;27.3
75;2021-12-15;598;975;27776;1740440;1717982;614181;81.0;80.0;28.6
75;2021-12-16;603;968;29295;1741043;1718950;643476;81.0;80.0;30.0
76;2020-12-27;0;0;0;0;0;0;0.0;0.0;0.0
76;2020-12-28;0;0;0;0;0;0;0.0;0.0;0.0
76;2020-12-29;0;0;0;0;0;0;0.0;0.0;0.0
76;2020-12-30;0;0;0;0;0;0;0.0;0.0;0.0
76;2020-12-31;0;0;0;0;0;0;0.0;0.0;0.0
76;2021-01-01;1;0;0;1;0;0;0.0;0.0;0.0
76;2021-01-02;0;0;0;1;0;0;0.0;0.0;0.0
76;2021-01-03;0;0;0;1;0;0;0.0;0.0;0.0
76;2021-01-04;17;0;0;18;0;0;0.0;0.0;0.0
76;2021-01-05;124;0;0;142;0;0;0.0;0.0;0.0
76;2021-01-06;622;2;0;764;2;0;0.1;0.0;0.0
76;2021-01-07;1233;9;0;1997;11;0;0.2;0.0;0.0
76;2021-01-08;1370;2;0;3367;13;0;0.3;0.0;0.0
76;2021-01-09;665;1;0;4032;14;0;0.3;0.0;0.0
76;2021-01-10;472;2;0;4504;16;0;0.4;0.0;0.0
76;2021-01-11;1287;4;0;5791;20;0;0.5;0.0;0.0
76;2021-01-12;1250;1;0;7041;21;0;0.6;0.0;0.0
76;2021-01-13;1144;5;0;8185;26;0;0.7;0.0;0.0
76;2021-01-14;2070;23;0;10255;49;0;0.8;0.0;0.0
76;2021-01-15;1819;8;0;12074;57;0;1.0;0.0;0.0
76;2021-01-16;953;7;0;13027;64;0;1.0;0.0;0.0
76;2021-01-17;2708;20;0;15735;84;0;1.3;0.0;0.0
76;2021-01-18;4175;18;0;19910;102;0;1.6;0.0;0.0
76;2021-01-19;2840;11;0;22750;113;0;1.8;0.0;0.0
76;2021-01-20;1952;11;0;24702;124;0;2.0;0.0;0.0
76;2021-01-21;1704;5;0;26406;129;0;2.1;0.0;0.0
76;2021-01-22;1610;2;0;28016;131;0;2.3;0.0;0.0
76;2021-01-23;451;4;0;28467;135;0;2.3;0.0;0.0
76;2021-01-24;100;0;0;28567;135;0;2.3;0.0;0.0
76;2021-01-25;1370;131;0;29937;266;0;2.4;0.0;0.0
76;2021-01-26;1323;314;0;31260;580;0;2.5;0.0;0.0
76;2021-01-27;1269;392;0;32529;972;0;2.6;0.1;0.0
76;2021-01-28;1237;320;0;33766;1292;0;2.7;0.1;0.0
76;2021-01-29;1108;367;0;34874;1659;0;2.8;0.1;0.0
76;2021-01-30;259;259;0;35133;1918;0;2.8;0.2;0.0
76;2021-01-31;4;96;0;35137;2014;0;2.8;0.2;0.0
76;2021-02-01;790;741;0;35927;2755;0;2.9;0.2;0.0
76;2021-02-02;962;904;0;36889;3659;0;3.0;0.3;0.0
76;2021-02-03;847;966;0;37736;4625;0;3.0;0.4;0.0
76;2021-02-04;927;1390;0;38663;6015;0;3.1;0.5;0.0
76;2021-02-05;942;1078;0;39605;7093;0;3.2;0.6;0.0
76;2021-02-06;262;841;0;39867;7934;0;3.2;0.6;0.0
76;2021-02-07;438;1522;0;40305;9456;0;3.2;0.8;0.0
76;2021-02-08;1799;3524;0;42104;12980;0;3.4;1.0;0.0
76;2021-02-09;1690;2868;0;43794;15848;0;3.5;1.3;0.0
76;2021-02-10;1413;1746;0;45207;17594;0;3.6;1.4;0.0
76;2021-02-11;1599;1449;0;46806;19043;0;3.8;1.5;0.0
76;2021-02-12;1602;1547;0;48408;20590;0;3.9;1.7;0.0
76;2021-02-13;243;336;0;48651;20926;0;3.9;1.7;0.0
76;2021-02-14;7;75;0;48658;21001;0;3.9;1.7;0.0
76;2021-02-15;530;1569;0;49188;22570;0;4.0;1.8;0.0
76;2021-02-16;699;1529;0;49887;24099;0;4.0;1.9;0.0
76;2021-02-17;605;1384;0;50492;25483;0;4.1;2.0;0.0
76;2021-02-18;774;1306;0;51266;26789;0;4.1;2.2;0.0
76;2021-02-19;838;1234;0;52104;28023;0;4.2;2.3;0.0
76;2021-02-20;260;288;0;52364;28311;0;4.2;2.3;0.0
76;2021-02-21;2;5;0;52366;28316;0;4.2;2.3;0.0
76;2021-02-22;318;1212;0;52684;29528;0;4.2;2.4;0.0
76;2021-02-23;566;1149;0;53250;30677;0;4.3;2.5;0.0
76;2021-02-24;591;1133;0;53841;31810;0;4.3;2.6;0.0
76;2021-02-25;1606;1213;0;55447;33023;0;4.5;2.7;0.0
76;2021-02-26;2146;992;0;57593;34015;0;4.6;2.7;0.0
76;2021-02-27;1091;271;0;58684;34286;0;4.7;2.8;0.0
76;2021-02-28;30;193;0;58714;34479;0;4.7;2.8;0.0
76;2021-03-01;839;1975;0;59553;36454;0;4.8;2.9;0.0
76;2021-03-02;1353;1612;0;60906;38066;0;4.9;3.1;0.0
76;2021-03-03;1857;1322;0;62763;39388;0;5.0;3.2;0.0
76;2021-03-04;2753;1059;0;65516;40447;0;5.3;3.3;0.0
76;2021-03-05;4036;777;0;69552;41224;0;5.6;3.3;0.0
76;2021-03-06;3311;174;0;72863;41398;0;5.9;3.3;0.0
76;2021-03-07;1288;40;0;74151;41438;0;6.0;3.3;0.0
76;2021-03-08;2040;1204;0;76191;42642;0;6.1;3.4;0.0
76;2021-03-09;3517;1125;0;79708;43767;0;6.4;3.5;0.0
76;2021-03-10;3547;1034;0;83255;44801;0;6.7;3.6;0.0
76;2021-03-11;5489;924;0;88744;45725;0;7.1;3.7;0.0
76;2021-03-12;6588;608;0;95332;46333;0;7.7;3.7;0.0
76;2021-03-13;4668;185;0;100000;46518;0;8.0;3.7;0.0
76;2021-03-14;1065;27;0;101065;46545;0;8.1;3.7;0.0
76;2021-03-15;2833;235;0;103898;46780;0;8.4;3.8;0.0
76;2021-03-16;2498;387;0;106396;47167;0;8.6;3.8;0.0
76;2021-03-17;2697;316;0;109093;47483;0;8.8;3.8;0.0
76;2021-03-18;2977;340;0;112070;47823;0;9.0;3.8;0.0
76;2021-03-19;4268;425;0;116338;48248;0;9.4;3.9;0.0
76;2021-03-20;3929;295;0;120267;48543;0;9.7;3.9;0.0
76;2021-03-21;819;15;0;121086;48558;0;9.7;3.9;0.0
76;2021-03-22;3774;355;0;124860;48913;0;10.0;3.9;0.0
76;2021-03-23;5443;371;0;130303;49284;0;10.5;4.0;0.0
76;2021-03-24;5489;411;0;135792;49695;0;10.9;4.0;0.0
76;2021-03-25;7292;576;0;143084;50271;0;11.5;4.0;0.0
76;2021-03-26;8343;616;0;151427;50887;0;12.2;4.1;0.0
76;2021-03-27;4670;385;0;156097;51272;0;12.6;4.1;0.0
76;2021-03-28;1058;39;0;157155;51311;0;12.6;4.1;0.0
76;2021-03-29;5051;839;0;162206;52150;0;13.0;4.2;0.0
76;2021-03-30;6256;1062;0;168462;53212;0;13.5;4.3;0.0
76;2021-03-31;6066;1258;0;174528;54470;0;14.0;4.4;0.0
76;2021-04-01;6285;1992;0;180813;56462;0;14.5;4.5;0.0
76;2021-04-02;6281;2561;0;187094;59023;0;15.0;4.7;0.0
76;2021-04-03;2423;1122;0;189517;60145;0;15.2;4.8;0.0
76;2021-04-04;267;26;0;189784;60171;0;15.3;4.8;0.0
76;2021-04-05;797;356;0;190581;60527;0;15.3;4.9;0.0
76;2021-04-06;3346;2766;0;193927;63293;0;15.6;5.1;0.0
76;2021-04-07;4141;2423;0;198068;65716;0;15.9;5.3;0.0
76;2021-04-08;5524;2717;0;203592;68433;0;16.4;5.5;0.0
76;2021-04-09;8462;2980;0;212054;71413;0;17.0;5.7;0.0
76;2021-04-10;4684;1477;0;216738;72890;0;17.4;5.9;0.0
76;2021-04-11;810;535;0;217548;73425;0;17.5;5.9;0.0
76;2021-04-12;4441;2768;0;221989;76193;0;17.8;6.1;0.0
76;2021-04-13;5642;2802;0;227631;78995;0;18.3;6.4;0.0
76;2021-04-14;4571;3111;0;232202;82106;0;18.7;6.6;0.0
76;2021-04-15;5330;3302;0;237532;85408;0;19.1;6.9;0.0
76;2021-04-16;7051;3239;0;244583;88647;0;19.7;7.1;0.0
76;2021-04-17;4207;1436;0;248790;90083;0;20.0;7.2;0.0
76;2021-04-18;351;156;0;249141;90239;0;20.0;7.3;0.0
76;2021-04-19;3293;3533;0;252434;93772;0;20.3;7.5;0.0
76;2021-04-20;4177;4103;0;256611;97875;0;20.6;7.9;0.0
76;2021-04-21;4056;4445;0;260667;102320;0;21.0;8.2;0.0
76;2021-04-22;4444;5167;0;265111;107487;0;21.3;8.6;0.0
76;2021-04-23;5266;5653;0;270377;113140;0;21.7;9.1;0.0
76;2021-04-24;4060;2093;0;274437;115233;0;22.1;9.3;0.0
76;2021-04-25;970;340;0;275407;115573;0;22.1;9.3;0.0
76;2021-04-26;4362;4160;0;279769;119733;0;22.5;9.6;0.0
76;2021-04-27;4836;4663;0;284605;124396;0;22.9;10.0;0.0
76;2021-04-28;5167;3885;0;289772;128281;0;23.3;10.3;0.0
76;2021-04-29;6750;3850;0;296522;132131;0;23.8;10.6;0.0
76;2021-04-30;7900;4453;0;304422;136584;0;24.5;11.0;0.0
76;2021-05-01;4530;997;0;308952;137581;0;24.8;11.1;0.0
76;2021-05-02;1903;285;0;310855;137866;0;25.0;11.1;0.0
76;2021-05-03;4662;3121;0;315517;140987;0;25.4;11.3;0.0
76;2021-05-04;4718;4312;0;320235;145299;0;25.7;11.7;0.0
76;2021-05-05;4737;4853;0;324972;150152;0;26.1;12.1;0.0
76;2021-05-06;5849;5260;0;330821;155412;0;26.6;12.5;0.0
76;2021-05-07;6120;6428;0;336941;161840;0;27.1;13.0;0.0
76;2021-05-08;4875;906;0;341816;162746;0;27.5;13.1;0.0
76;2021-05-09;2633;274;0;344449;163020;0;27.7;13.1;0.0
76;2021-05-10;4919;4765;0;349368;167785;0;28.1;13.5;0.0
76;2021-05-11;6369;5365;0;355737;173150;0;28.6;13.9;0.0
76;2021-05-12;6321;4844;0;362058;177994;0;29.1;14.3;0.0
76;2021-05-13;8178;1202;0;370236;179196;0;29.8;14.4;0.0
76;2021-05-14;9868;4394;0;380104;183590;0;30.6;14.8;0.0
76;2021-05-15;8786;2405;0;388890;185995;0;31.3;15.0;0.0
76;2021-05-16;6104;474;0;394994;186469;0;31.8;15.0;0.0
76;2021-05-17;7148;3108;0;402142;189577;0;32.3;15.2;0.0
76;2021-05-18;8166;2679;0;410308;192256;0;33.0;15.5;0.0
76;2021-05-19;8253;3075;0;418561;195331;0;33.7;15.7;0.0
76;2021-05-20;9284;3337;0;427845;198668;0;34.4;16.0;0.0
76;2021-05-21;8043;4025;0;435888;202693;0;35.0;16.3;0.0
76;2021-05-22;7023;2267;0;442911;204960;0;35.6;16.5;0.0
76;2021-05-23;5987;404;0;448898;205364;0;36.1;16.5;0.0
76;2021-05-24;6206;1455;0;455104;206819;0;36.6;16.6;0.0
76;2021-05-25;7556;3944;0;462660;210763;0;37.2;16.9;0.0
76;2021-05-26;7171;3551;0;469831;214314;0;37.8;17.2;0.0
76;2021-05-27;8229;4546;0;478060;218860;0;38.4;17.6;0.0
76;2021-05-28;8169;6384;0;486229;225244;0;39.1;18.1;0.0
76;2021-05-29;6264;3466;0;492493;228710;0;39.6;18.4;0.0
76;2021-05-30;3107;404;0;495600;229114;0;39.8;18.4;0.0
76;2021-05-31;7783;3816;0;503383;232930;0;40.5;18.7;0.0
76;2021-06-01;8755;4869;0;512138;237799;0;41.2;19.1;0.0
76;2021-06-02;7436;4437;0;519574;242236;0;41.8;19.5;0.0
76;2021-06-03;9265;5311;0;528839;247547;0;42.5;19.9;0.0
76;2021-06-04;8701;6575;0;537540;254122;0;43.2;20.4;0.0
76;2021-06-05;6217;3836;0;543757;257958;0;43.7;20.7;0.0
76;2021-06-06;2690;713;0;546447;258671;0;43.9;20.8;0.0
76;2021-06-07;6618;5294;0;553065;263965;0;44.5;21.2;0.0
76;2021-06-08;8236;6107;0;561301;270072;0;45.1;21.7;0.0
76;2021-06-09;6907;5961;0;568208;276033;0;45.7;22.2;0.0
76;2021-06-10;7449;6416;0;575657;282449;0;46.3;22.7;0.0
76;2021-06-11;7222;8033;0;582879;290482;0;46.9;23.4;0.0
76;2021-06-12;6694;5795;0;589573;296277;0;47.4;23.8;0.0
76;2021-06-13;2859;1407;0;592432;297684;0;47.6;23.9;0.0
76;2021-06-14;5623;6612;0;598055;304296;0;48.1;24.5;0.0
76;2021-06-15;5890;7308;0;603945;311604;0;48.6;25.1;0.0
76;2021-06-16;6219;7338;0;610164;318942;0;49.1;25.6;0.0
76;2021-06-17;6554;7593;0;616718;326535;0;49.6;26.3;0.0
76;2021-06-18;7005;9111;0;623723;335646;0;50.1;27.0;0.0
76;2021-06-19;5551;6175;0;629274;341821;0;50.6;27.5;0.0
76;2021-06-20;2682;1753;0;631956;343574;0;50.8;27.6;0.0
76;2021-06-21;4650;7814;0;636606;351388;0;51.2;28.3;0.0
76;2021-06-22;4525;9387;0;641131;360775;0;51.5;29.0;0.0
76;2021-06-23;4369;9252;0;645500;370027;0;51.9;29.8;0.0
76;2021-06-24;4467;9668;0;649967;379695;0;52.3;30.5;0.0
76;2021-06-25;4617;11257;0;654584;390952;0;52.6;31.4;0.0
76;2021-06-26;3247;7801;0;657831;398753;0;52.9;32.1;0.0
76;2021-06-27;1351;4867;0;659182;403620;0;53.0;32.5;0.0
76;2021-06-28;3266;9604;0;662448;413224;0;53.3;33.2;0.0
76;2021-06-29;3700;9959;0;666148;423183;0;53.6;34.0;0.0
76;2021-06-30;4032;9554;0;670180;432737;0;53.9;34.8;0.0
76;2021-07-01;4359;9710;0;674539;442447;0;54.2;35.6;0.0
76;2021-07-02;4176;11753;0;678715;454200;0;54.6;36.5;0.0
76;2021-07-03;3352;8320;0;682067;462520;0;54.8;37.2;0.0
76;2021-07-04;1452;5074;0;683519;467594;0;55.0;37.6;0.0
76;2021-07-05;3654;8941;0;687173;476535;0;55.2;38.3;0.0
76;2021-07-06;3749;9855;0;690922;486390;0;55.5;39.1;0.0
76;2021-07-07;3747;9095;0;694669;495485;0;55.9;39.8;0.0
76;2021-07-08;4220;9307;0;698889;504792;0;56.2;40.6;0.0
76;2021-07-09;4191;12081;0;703080;516873;0;56.5;41.6;0.0
76;2021-07-10;2954;8271;0;706034;525144;0;56.8;42.2;0.0
76;2021-07-11;1660;2752;0;707694;527896;0;56.9;42.4;0.0
76;2021-07-12;2993;10714;0;710687;538610;0;57.1;43.3;0.0
76;2021-07-13;4740;11860;0;715427;550470;0;57.5;44.3;0.0
76;2021-07-14;4283;5049;0;719710;555519;0;57.9;44.7;0.0
76;2021-07-15;5636;11689;0;725346;567208;0;58.3;45.6;0.0
76;2021-07-16;6562;11881;0;731908;579089;0;58.8;46.6;0.0
76;2021-07-17;4883;8483;0;736791;587572;0;59.2;47.2;0.0
76;2021-07-18;2195;3377;0;738986;590949;0;59.4;47.5;0.0
76;2021-07-19;5077;10170;0;744063;601119;0;59.8;48.3;0.0
76;2021-07-20;6284;10571;0;750347;611690;0;60.3;49.2;0.0
76;2021-07-21;6300;9589;0;756647;621279;0;60.8;50.0;0.0
76;2021-07-22;8038;8682;0;764685;629961;0;61.5;50.6;0.0
76;2021-07-23;7484;10589;0;772169;640550;0;62.1;51.5;0.0
76;2021-07-24;4892;6796;0;777061;647346;0;62.5;52.0;0.0
76;2021-07-25;2884;2471;0;779945;649817;0;62.7;52.2;0.0
76;2021-07-26;5300;8894;0;785245;658711;0;63.1;53.0;0.0
76;2021-07-27;8096;8404;0;793341;667115;0;63.8;53.6;0.0
76;2021-07-28;8045;7515;0;801386;674630;0;64.4;54.2;0.0
76;2021-07-29;9049;6641;0;810435;681271;0;65.2;54.8;0.0
76;2021-07-30;7766;7551;0;818201;688822;0;65.8;55.4;0.0
76;2021-07-31;6266;5016;0;824467;693838;0;66.3;55.8;0.0
76;2021-08-01;3647;1962;0;828114;695800;0;66.6;55.9;0.0
76;2021-08-02;6271;6661;0;834385;702461;0;67.1;56.5;0.0
76;2021-08-03;7510;6160;0;841895;708621;0;67.7;57.0;0.0
76;2021-08-04;6855;5592;0;848750;714213;0;68.2;57.4;0.0
76;2021-08-05;7522;5420;0;856272;719633;0;68.8;57.9;0.0
76;2021-08-06;6352;6526;0;862624;726159;0;69.4;58.4;0.0
76;2021-08-07;4339;4167;0;866963;730326;0;69.7;58.7;0.0
76;2021-08-08;2229;1775;0;869192;732101;0;69.9;58.9;0.0
76;2021-08-09;5077;6274;0;874269;738375;0;70.3;59.4;0.0
76;2021-08-10;5778;6360;0;880047;744735;0;70.8;59.9;0.0
76;2021-08-11;5854;5340;0;885901;750075;0;71.2;60.3;0.0
76;2021-08-12;5491;5816;0;891392;755891;0;71.7;60.8;0.0
76;2021-08-13;4573;5951;0;895965;761842;0;72.0;61.3;0.0
76;2021-08-14;3466;4442;0;899431;766284;0;72.3;61.6;0.0
76;2021-08-15;1410;2205;0;900841;768489;0;72.4;61.8;0.0
76;2021-08-16;3333;6329;0;904174;774818;0;72.7;62.3;0.0
76;2021-08-17;3534;6705;0;907708;781523;0;73.0;62.8;0.0
76;2021-08-18;3309;6410;0;911017;787933;0;73.2;63.3;0.0
76;2021-08-19;3060;6808;0;914077;794741;0;73.5;63.9;0.0
76;2021-08-20;3201;7391;0;917278;802132;0;73.7;64.5;0.0
76;2021-08-21;1677;3991;0;918955;806123;0;73.9;64.8;0.0
76;2021-08-22;803;3053;0;919758;809176;0;73.9;65.1;0.0
76;2021-08-23;2367;7206;1;922125;816382;1;74.1;65.6;0.0
76;2021-08-24;2569;7207;1;924694;823589;2;74.3;66.2;0.0
76;2021-08-25;2445;6662;1;927139;830251;3;74.5;66.8;0.0
76;2021-08-26;1908;5530;1;929047;835781;4;74.7;67.2;0.0
76;2021-08-27;2505;7394;0;931552;843175;4;74.9;67.8;0.0
76;2021-08-28;1904;5773;0;933456;848948;4;75.0;68.3;0.0
76;2021-08-29;657;2771;0;934113;851719;4;75.1;68.5;0.0
76;2021-08-30;1949;6670;98;936062;858389;102;75.3;69.0;0.0
76;2021-08-31;1809;6519;193;937871;864908;295;75.4;69.5;0.0
76;2021-09-01;1700;5937;488;939571;870845;783;75.5;70.0;0.1
76;2021-09-02;1238;4176;491;940809;875021;1274;75.6;70.4;0.1
76;2021-09-03;1494;6119;621;942303;881140;1895;75.8;70.8;0.2
76;2021-09-04;1486;5491;346;943789;886631;2241;75.9;71.3;0.2
76;2021-09-05;588;1658;133;944377;888289;2374;75.9;71.4;0.2
76;2021-09-06;1153;3906;716;945530;892195;3090;76.0;71.7;0.2
76;2021-09-07;1076;3428;772;946606;895623;3862;76.1;72.0;0.3
76;2021-09-08;1186;3932;683;947792;899555;4545;76.2;72.3;0.4
76;2021-09-09;983;2696;709;948775;902251;5254;76.3;72.5;0.4
76;2021-09-10;1608;3788;834;950383;906039;6088;76.4;72.8;0.5
76;2021-09-11;1084;2964;405;951467;909003;6493;76.5;73.1;0.5
76;2021-09-12;244;751;66;951711;909754;6559;76.5;73.1;0.5
76;2021-09-13;786;2033;1137;952497;911787;7696;76.6;73.3;0.6
76;2021-09-14;1306;2430;1254;953803;914217;8950;76.7;73.5;0.7
76;2021-09-15;1125;3024;1251;954928;917241;10201;76.8;73.7;0.8
76;2021-09-16;1143;1844;961;956071;919085;11162;76.9;73.9;0.9
76;2021-09-17;1275;2568;1299;957346;921653;12461;77.0;74.1;1.0
76;2021-09-18;668;2295;422;958014;923948;12883;77.0;74.3;1.0
76;2021-09-19;168;704;78;958182;924652;12961;77.0;74.3;1.0
76;2021-09-20;793;1589;857;958975;926241;13818;77.1;74.5;1.1
76;2021-09-21;731;1527;1178;959706;927768;14996;77.2;74.6;1.2
76;2021-09-22;625;2124;983;960331;929892;15979;77.2;74.8;1.3
76;2021-09-23;691;1102;1107;961022;930994;17086;77.3;74.9;1.4
76;2021-09-24;950;1844;1230;961972;932838;18316;77.3;75.0;1.5
76;2021-09-25;557;1956;394;962529;934794;18710;77.4;75.2;1.5
76;2021-09-26;95;378;58;962624;935172;18768;77.4;75.2;1.5
76;2021-09-27;517;1131;883;963141;936303;19651;77.4;75.3;1.6
76;2021-09-28;459;1046;1063;963600;937349;20714;77.5;75.4;1.7
76;2021-09-29;707;1447;954;964307;938796;21668;77.5;75.5;1.7
76;2021-09-30;379;782;704;964686;939578;22372;77.6;75.5;1.8
76;2021-10-01;853;1605;1515;965539;941183;23887;77.6;75.7;1.9
76;2021-10-02;541;1218;379;966080;942401;24266;77.7;75.8;2.0
76;2021-10-03;106;339;119;966186;942740;24385;77.7;75.8;2.0
76;2021-10-04;611;1009;1232;966797;943749;25617;77.7;75.9;2.1
76;2021-10-05;458;964;1185;967255;944713;26802;77.8;76.0;2.2
76;2021-10-06;425;828;963;967680;945541;27765;77.8;76.0;2.2
76;2021-10-07;349;788;1356;968029;946329;29121;77.8;76.1;2.3
76;2021-10-08;844;1722;1875;968873;948051;30996;77.9;76.2;2.5
76;2021-10-09;498;895;740;969371;948946;31736;77.9;76.3;2.6
76;2021-10-10;54;87;74;969425;949033;31810;77.9;76.3;2.6
76;2021-10-11;483;992;1234;969908;950025;33044;78.0;76.4;2.7
76;2021-10-12;447;851;1484;970355;950876;34528;78.0;76.5;2.8
76;2021-10-13;556;976;1454;970911;951852;35982;78.1;76.5;2.9
76;2021-10-14;381;643;1323;971292;952495;37305;78.1;76.6;3.0
76;2021-10-15;737;1244;2477;972029;953739;39782;78.2;76.7;3.2
76;2021-10-16;379;538;573;972408;954277;40355;78.2;76.7;3.2
76;2021-10-17;88;193;218;972496;954470;40573;78.2;76.7;3.3
76;2021-10-18;375;747;1430;972871;955217;42003;78.2;76.8;3.4
76;2021-10-19;450;733;1676;973321;955950;43679;78.3;76.9;3.5
76;2021-10-20;418;623;2170;973739;956573;45849;78.3;76.9;3.7
76;2021-10-21;268;522;1955;974007;957095;47804;78.3;77.0;3.8
76;2021-10-22;592;938;2277;974599;958033;50081;78.4;77.0;4.0
76;2021-10-23;318;504;730;974917;958537;50811;78.4;77.1;4.1
76;2021-10-24;7;30;20;974924;958567;50831;78.4;77.1;4.1
76;2021-10-25;468;677;2406;975392;959244;53237;78.4;77.1;4.3
76;2021-10-26;365;448;2001;975757;959692;55238;78.5;77.2;4.4
76;2021-10-27;344;477;2053;976101;960169;57291;78.5;77.2;4.6
76;2021-10-28;339;415;1887;976440;960584;59178;78.5;77.2;4.8
76;2021-10-29;447;842;3278;976887;961426;62456;78.5;77.3;5.0
76;2021-10-30;318;492;1094;977205;961918;63550;78.6;77.3;5.1
76;2021-10-31;32;32;38;977237;961950;63588;78.6;77.3;5.1
76;2021-11-01;23;20;11;977260;961970;63599;78.6;77.3;5.1
76;2021-11-02;412;575;2165;977672;962545;65764;78.6;77.4;5.3
76;2021-11-03;399;544;2226;978071;963089;67990;78.6;77.4;5.5
76;2021-11-04;345;479;2248;978416;963568;70238;78.7;77.5;5.6
76;2021-11-05;584;802;3675;979000;964370;73913;78.7;77.5;5.9
76;2021-11-06;324;440;1245;979324;964810;75158;78.7;77.6;6.0
76;2021-11-07;8;28;40;979332;964838;75198;78.7;77.6;6.0
76;2021-11-08;286;422;2693;979618;965260;77891;78.8;77.6;6.3
76;2021-11-09;263;427;3395;979881;965687;81286;78.8;77.6;6.5
76;2021-11-10;450;625;4130;980331;966312;85416;78.8;77.7;6.9
76;2021-11-11;10;37;108;980341;966349;85524;78.8;77.7;6.9
76;2021-11-12;459;642;4509;980800;966991;90033;78.9;77.7;7.2
76;2021-11-13;282;374;1456;981082;967365;91489;78.9;77.8;7.4
76;2021-11-14;15;22;66;981097;967387;91555;78.9;77.8;7.4
76;2021-11-15;297;393;3601;981394;967780;95156;78.9;77.8;7.7
76;2021-11-16;319;347;4014;981713;968127;99170;78.9;77.8;8.0
76;2021-11-17;413;503;3757;982126;968630;102927;79.0;77.9;8.3
76;2021-11-18;258;314;3716;982384;968944;106643;79.0;77.9;8.6
76;2021-11-19;542;573;5867;982926;969517;112510;79.0;77.9;9.0
76;2021-11-20;442;497;2456;983368;970014;114966;79.1;78.0;9.2
76;2021-11-21;18;22;70;983386;970036;115036;79.1;78.0;9.2
76;2021-11-22;310;258;4196;983696;970294;119232;79.1;78.0;9.6
76;2021-11-23;371;395;4937;984067;970689;124169;79.1;78.0;10.0
76;2021-11-24;451;465;5007;984518;971154;129176;79.2;78.1;10.4
76;2021-11-25;279;298;5047;984797;971452;134223;79.2;78.1;10.8
76;2021-11-26;449;617;8858;985246;972069;143081;79.2;78.2;11.5
76;2021-11-27;270;416;4987;985516;972485;148068;79.2;78.2;11.9
76;2021-11-28;21;22;914;985537;972507;148982;79.2;78.2;12.0
76;2021-11-29;250;352;8506;985787;972859;157488;79.3;78.2;12.7
76;2021-11-30;312;324;9967;986099;973183;167455;79.3;78.2;13.5
76;2021-12-01;294;408;9182;986393;973591;176637;79.3;78.3;14.2
76;2021-12-02;271;236;11331;986664;973827;187968;79.3;78.3;15.1
76;2021-12-03;332;448;13172;986996;974275;201140;79.4;78.3;16.2
76;2021-12-04;212;345;8114;987208;974620;209254;79.4;78.4;16.8
76;2021-12-05;46;40;2066;987254;974660;211320;79.4;78.4;17.0
76;2021-12-06;248;313;10636;987502;974973;221956;79.4;78.4;17.8
76;2021-12-07;236;324;13104;987738;975297;235060;79.4;78.4;18.9
76;2021-12-08;320;466;12957;988058;975763;248017;79.4;78.5;19.9
76;2021-12-09;309;328;15793;988367;976091;263810;79.5;78.5;21.2
76;2021-12-10;344;578;17970;988711;976669;281780;79.5;78.5;22.7
76;2021-12-11;261;379;11167;988972;977048;292947;79.5;78.6;23.6
76;2021-12-12;68;71;4356;989040;977119;297303;79.5;78.6;23.9
76;2021-12-13;222;349;14039;989262;977468;311342;79.5;78.6;25.0
76;2021-12-14;356;393;16770;989618;977861;328112;79.6;78.6;26.4
76;2021-12-15;349;458;15113;989967;978319;343225;79.6;78.7;27.6
76;2021-12-16;338;386;16609;990305;978705;359834;79.6;78.7;28.9
77;2020-12-27;2;1;0;2;1;0;0.0;0.0;0.0
77;2020-12-28;2;0;0;4;1;0;0.0;0.0;0.0
77;2020-12-29;1;0;0;5;1;0;0.0;0.0;0.0
77;2020-12-30;1;0;0;6;1;0;0.0;0.0;0.0
77;2020-12-31;0;0;0;6;1;0;0.0;0.0;0.0
77;2021-01-01;10;0;0;16;1;0;0.0;0.0;0.0
77;2021-01-02;1;0;0;17;1;0;0.0;0.0;0.0
77;2021-01-03;1;0;0;18;1;0;0.0;0.0;0.0
77;2021-01-04;10;0;0;28;1;0;0.0;0.0;0.0
77;2021-01-05;199;1;0;227;2;0;0.0;0.0;0.0
77;2021-01-06;276;2;0;503;4;0;0.0;0.0;0.0
77;2021-01-07;664;10;0;1167;14;0;0.1;0.0;0.0
77;2021-01-08;735;3;0;1902;17;0;0.1;0.0;0.0
77;2021-01-09;259;1;0;2161;18;0;0.2;0.0;0.0
77;2021-01-10;207;2;0;2368;20;0;0.2;0.0;0.0
77;2021-01-11;882;6;0;3250;26;0;0.2;0.0;0.0
77;2021-01-12;1086;5;0;4336;31;0;0.3;0.0;0.0
77;2021-01-13;1143;8;0;5479;39;0;0.4;0.0;0.0
77;2021-01-14;1136;18;0;6615;57;0;0.5;0.0;0.0
77;2021-01-15;989;17;0;7604;74;0;0.5;0.0;0.0
77;2021-01-16;164;1;0;7768;75;0;0.5;0.0;0.0
77;2021-01-17;109;3;0;7877;78;0;0.6;0.0;0.0
77;2021-01-18;1319;12;0;9196;90;0;0.6;0.0;0.0
77;2021-01-19;1878;28;0;11074;118;0;0.8;0.0;0.0
77;2021-01-20;2600;14;0;13674;132;0;1.0;0.0;0.0
77;2021-01-21;2361;38;0;16035;170;0;1.1;0.0;0.0
77;2021-01-22;1274;9;0;17309;179;0;1.2;0.0;0.0
77;2021-01-23;363;1;0;17672;180;0;1.2;0.0;0.0
77;2021-01-24;45;0;0;17717;180;0;1.2;0.0;0.0
77;2021-01-25;1043;26;0;18760;206;0;1.3;0.0;0.0
77;2021-01-26;1735;31;0;20495;237;0;1.4;0.0;0.0
77;2021-01-27;1493;43;0;21988;280;0;1.5;0.0;0.0
77;2021-01-28;1835;130;0;23823;410;0;1.7;0.0;0.0
77;2021-01-29;1366;177;0;25189;587;0;1.8;0.0;0.0
77;2021-01-30;266;5;0;25455;592;0;1.8;0.0;0.0
77;2021-01-31;5;2;0;25460;594;0;1.8;0.0;0.0
77;2021-02-01;686;227;0;26146;821;0;1.8;0.1;0.0
77;2021-02-02;878;341;0;27024;1162;0;1.9;0.1;0.0
77;2021-02-03;864;596;0;27888;1758;0;2.0;0.1;0.0
77;2021-02-04;865;891;0;28753;2649;0;2.0;0.2;0.0
77;2021-02-05;918;859;0;29671;3508;0;2.1;0.2;0.0
77;2021-02-06;201;102;0;29872;3610;0;2.1;0.3;0.0
77;2021-02-07;19;77;0;29891;3687;0;2.1;0.3;0.0
77;2021-02-08;474;998;0;30365;4685;0;2.1;0.3;0.0
77;2021-02-09;719;1560;0;31084;6245;0;2.2;0.4;0.0
77;2021-02-10;1097;1934;0;32181;8179;0;2.3;0.6;0.0
77;2021-02-11;1184;1840;0;33365;10019;0;2.3;0.7;0.0
77;2021-02-12;1201;1268;0;34566;11287;0;2.4;0.8;0.0
77;2021-02-13;230;181;0;34796;11468;0;2.4;0.8;0.0
77;2021-02-14;15;55;0;34811;11523;0;2.4;0.8;0.0
77;2021-02-15;604;1073;0;35415;12596;0;2.5;0.9;0.0
77;2021-02-16;691;1683;0;36106;14279;0;2.5;1.0;0.0
77;2021-02-17;662;1379;0;36768;15658;0;2.6;1.1;0.0
77;2021-02-18;998;1689;0;37766;17347;0;2.7;1.2;0.0
77;2021-02-19;933;1178;0;38699;18525;0;2.7;1.3;0.0
77;2021-02-20;97;257;0;38796;18782;0;2.7;1.3;0.0
77;2021-02-21;12;36;0;38808;18818;0;2.7;1.3;0.0
77;2021-02-22;388;900;0;39196;19718;0;2.8;1.4;0.0
77;2021-02-23;474;1193;0;39670;20911;0;2.8;1.5;0.0
77;2021-02-24;615;1046;0;40285;21957;0;2.8;1.5;0.0
77;2021-02-25;912;1170;0;41197;23127;0;2.9;1.6;0.0
77;2021-02-26;1000;935;0;42197;24062;0;3.0;1.7;0.0
77;2021-02-27;533;227;0;42730;24289;0;3.0;1.7;0.0
77;2021-02-28;36;15;0;42766;24304;0;3.0;1.7;0.0
77;2021-03-01;807;795;0;43573;25099;0;3.1;1.8;0.0
77;2021-03-02;1228;1027;0;44801;26126;0;3.1;1.8;0.0
77;2021-03-03;2099;1221;0;46900;27347;0;3.3;1.9;0.0
77;2021-03-04;3087;1244;0;49987;28591;0;3.5;2.0;0.0
77;2021-03-05;3767;1073;0;53754;29664;0;3.8;2.1;0.0
77;2021-03-06;5018;299;0;58772;29963;0;4.1;2.1;0.0
77;2021-03-07;3456;183;0;62228;30146;0;4.4;2.1;0.0
77;2021-03-08;1509;606;0;63737;30752;0;4.5;2.2;0.0
77;2021-03-09;2747;729;0;66484;31481;0;4.7;2.2;0.0
77;2021-03-10;2732;703;0;69216;32184;0;4.9;2.3;0.0
77;2021-03-11;3962;879;0;73178;33063;0;5.1;2.3;0.0
77;2021-03-12;4365;821;0;77543;33884;0;5.4;2.4;0.0
77;2021-03-13;4635;251;0;82178;34135;0;5.8;2.4;0.0
77;2021-03-14;2112;115;0;84290;34250;0;5.9;2.4;0.0
77;2021-03-15;2788;383;0;87078;34633;0;6.1;2.4;0.0
77;2021-03-16;2671;437;0;89749;35070;0;6.3;2.5;0.0
77;2021-03-17;2646;462;0;92395;35532;0;6.5;2.5;0.0
77;2021-03-18;3236;457;0;95631;35989;0;6.7;2.5;0.0
77;2021-03-19;3582;483;0;99213;36472;0;7.0;2.6;0.0
77;2021-03-20;2393;125;0;101606;36597;0;7.1;2.6;0.0
77;2021-03-21;451;62;0;102057;36659;0;7.2;2.6;0.0
77;2021-03-22;3255;465;0;105312;37124;0;7.4;2.6;0.0
77;2021-03-23;4884;653;0;110196;37777;0;7.7;2.7;0.0
77;2021-03-24;4623;648;0;114819;38425;0;8.1;2.7;0.0
77;2021-03-25;6423;547;0;121242;38972;0;8.5;2.7;0.0
77;2021-03-26;6820;558;0;128062;39530;0;9.0;2.8;0.0
77;2021-03-27;3997;208;0;132059;39738;0;9.3;2.8;0.0
77;2021-03-28;1878;72;0;133937;39810;0;9.4;2.8;0.0
77;2021-03-29;3293;841;0;137230;40651;0;9.6;2.9;0.0
77;2021-03-30;4699;1319;0;141929;41970;0;10.0;2.9;0.0
77;2021-03-31;4371;1289;0;146300;43259;0;10.3;3.0;0.0
77;2021-04-01;5064;2045;0;151364;45304;0;10.6;3.2;0.0
77;2021-04-02;4737;2204;0;156101;47508;0;11.0;3.3;0.0
77;2021-04-03;2265;2319;0;158366;49827;0;11.1;3.5;0.0
77;2021-04-04;738;1423;0;159104;51250;0;11.2;3.6;0.0
77;2021-04-05;588;184;0;159692;51434;0;11.2;3.6;0.0
77;2021-04-06;3452;2074;0;163144;53508;0;11.5;3.8;0.0
77;2021-04-07;4232;2259;0;167376;55767;0;11.8;3.9;0.0
77;2021-04-08;5649;2522;0;173025;58289;0;12.2;4.1;0.0
77;2021-04-09;5993;2208;0;179018;60497;0;12.6;4.2;0.0
77;2021-04-10;3738;2810;0;182756;63307;0;12.8;4.4;0.0
77;2021-04-11;941;838;0;183697;64145;0;12.9;4.5;0.0
77;2021-04-12;3009;2047;0;186706;66192;0;13.1;4.6;0.0
77;2021-04-13;4336;3068;0;191042;69260;0;13.4;4.9;0.0
77;2021-04-14;3415;2715;0;194457;71975;0;13.7;5.1;0.0
77;2021-04-15;4467;3291;0;198924;75266;0;14.0;5.3;0.0
77;2021-04-16;4476;2857;0;203400;78123;0;14.3;5.5;0.0
77;2021-04-17;2214;891;0;205614;79014;0;14.4;5.6;0.0
77;2021-04-18;402;213;0;206016;79227;0;14.5;5.6;0.0
77;2021-04-19;2876;2671;0;208892;81898;0;14.7;5.8;0.0
77;2021-04-20;3270;3636;0;212162;85534;0;14.9;6.0;0.0
77;2021-04-21;3091;3695;0;215253;89229;0;15.1;6.3;0.0
77;2021-04-22;4078;4245;0;219331;93474;0;15.4;6.6;0.0
77;2021-04-23;4614;4068;0;223945;97542;0;15.7;6.9;0.0
77;2021-04-24;6053;3033;0;229998;100575;0;16.2;7.1;0.0
77;2021-04-25;4618;1419;0;234616;101994;0;16.5;7.2;0.0
77;2021-04-26;4130;2545;0;238746;104539;0;16.8;7.3;0.0
77;2021-04-27;5166;3110;0;243912;107649;0;17.1;7.6;0.0
77;2021-04-28;5287;3174;0;249199;110823;0;17.5;7.8;0.0
77;2021-04-29;5997;3713;0;255196;114536;0;17.9;8.0;0.0
77;2021-04-30;6500;3947;0;261696;118483;0;18.4;8.3;0.0
77;2021-05-01;3629;931;0;265325;119414;0;18.6;8.4;0.0
77;2021-05-02;3497;662;0;268822;120076;0;18.9;8.4;0.0
77;2021-05-03;7134;3357;0;275956;123433;0;19.4;8.7;0.0
77;2021-05-04;7598;3800;0;283554;127233;0;19.9;8.9;0.0
77;2021-05-05;7104;3845;0;290658;131078;0;20.4;9.2;0.0
77;2021-05-06;8177;4344;0;298835;135422;0;21.0;9.5;0.0
77;2021-05-07;9236;4242;0;308071;139664;0;21.6;9.8;0.0
77;2021-05-08;6845;1514;0;314916;141178;0;22.1;9.9;0.0
77;2021-05-09;5314;1044;0;320230;142222;0;22.5;10.0;0.0
77;2021-05-10;8729;3074;0;328959;145296;0;23.1;10.2;0.0
77;2021-05-11;10090;3790;0;339049;149086;0;23.8;10.5;0.0
77;2021-05-12;9503;3037;0;348552;152123;0;24.5;10.7;0.0
77;2021-05-13;9528;1150;0;358080;153273;0;25.2;10.8;0.0
77;2021-05-14;10773;2157;0;368853;155430;0;25.9;10.9;0.0
77;2021-05-15;9252;1616;0;378105;157046;0;26.6;11.0;0.0
77;2021-05-16;5049;579;0;383154;157625;0;26.9;11.1;0.0
77;2021-05-17;10090;1785;0;393244;159410;0;27.6;11.2;0.0
77;2021-05-18;11625;2139;0;404869;161549;0;28.4;11.3;0.0
77;2021-05-19;10627;2189;0;415496;163738;0;29.2;11.5;0.0
77;2021-05-20;11947;2827;0;427443;166565;0;30.0;11.7;0.0
77;2021-05-21;11431;3030;0;438874;169595;0;30.8;11.9;0.0
77;2021-05-22;9510;1849;0;448384;171444;0;31.5;12.0;0.0
77;2021-05-23;6323;834;0;454707;172278;0;31.9;12.1;0.0
77;2021-05-24;6729;875;0;461436;173153;0;32.4;12.2;0.0
77;2021-05-25;8263;3411;0;469699;176564;0;33.0;12.4;0.0
77;2021-05-26;7857;3392;0;477556;179956;0;33.5;12.6;0.0
77;2021-05-27;8031;4551;0;485587;184507;0;34.1;13.0;0.0
77;2021-05-28;8058;4720;0;493645;189227;0;34.7;13.3;0.0
77;2021-05-29;7343;2890;0;500988;192117;0;35.2;13.5;0.0
77;2021-05-30;4201;1059;0;505189;193176;0;35.5;13.6;0.0
77;2021-05-31;7819;4473;0;513008;197649;0;36.0;13.9;0.0
77;2021-06-01;9188;5184;0;522196;202833;0;36.7;14.2;0.0
77;2021-06-02;8662;4620;0;530858;207453;0;37.3;14.6;0.0
77;2021-06-03;8684;6174;0;539542;213627;0;37.9;15.0;0.0
77;2021-06-04;9061;6555;0;548603;220182;0;38.5;15.5;0.0
77;2021-06-05;6405;5975;0;555008;226157;0;39.0;15.9;0.0
77;2021-06-06;4366;3226;0;559374;229383;0;39.3;16.1;0.0
77;2021-06-07;6303;5537;0;565677;234920;0;39.7;16.5;0.0
77;2021-06-08;5931;6241;0;571608;241161;0;40.2;16.9;0.0
77;2021-06-09;5307;6127;0;576915;247288;0;40.5;17.4;0.0
77;2021-06-10;5362;7445;0;582277;254733;0;40.9;17.9;0.0
77;2021-06-11;5991;7277;0;588268;262010;0;41.3;18.4;0.0
77;2021-06-12;6214;5794;0;594482;267804;0;41.8;18.8;0.0
77;2021-06-13;3266;3254;0;597748;271058;0;42.0;19.0;0.0
77;2021-06-14;3609;9138;0;601357;280196;0;42.2;19.7;0.0
77;2021-06-15;4538;9740;0;605895;289936;0;42.6;20.4;0.0
77;2021-06-16;5042;9258;0;610937;299194;0;42.9;21.0;0.0
77;2021-06-17;4832;9884;0;615769;309078;0;43.3;21.7;0.0
77;2021-06-18;4754;11027;0;620523;320105;0;43.6;22.5;0.0
77;2021-06-19;5107;8061;0;625630;328166;0;43.9;23.1;0.0
77;2021-06-20;2169;4297;0;627799;332463;0;44.1;23.4;0.0
77;2021-06-21;3336;10107;0;631135;342570;0;44.3;24.1;0.0
77;2021-06-22;3876;11787;0;635011;354357;0;44.6;24.9;0.0
77;2021-06-23;3740;10624;0;638751;364981;0;44.9;25.6;0.0
77;2021-06-24;3757;11334;0;642508;376315;0;45.1;26.4;0.0
77;2021-06-25;3784;11485;0;646292;387800;0;45.4;27.2;0.0
77;2021-06-26;3908;10572;0;650200;398372;0;45.7;28.0;0.0
77;2021-06-27;2034;6113;0;652234;404485;0;45.8;28.4;0.0
77;2021-06-28;2885;10907;0;655119;415392;0;46.0;29.2;0.0
77;2021-06-29;3598;12625;0;658717;428017;0;46.3;30.1;0.0
77;2021-06-30;3560;11528;0;662277;439545;0;46.5;30.9;0.0
77;2021-07-01;3882;11609;0;666159;451154;0;46.8;31.7;0.0
77;2021-07-02;4142;12407;0;670301;463561;0;47.1;32.6;0.0
77;2021-07-03;3378;10717;0;673679;474278;0;47.3;33.3;0.0
77;2021-07-04;1974;6087;0;675653;480365;0;47.5;33.7;0.0
77;2021-07-05;3792;9662;0;679445;490027;0;47.7;34.4;0.0
77;2021-07-06;3991;9896;0;683436;499923;0;48.0;35.1;0.0
77;2021-07-07;4260;9466;2;687696;509389;2;48.3;35.8;0.0
77;2021-07-08;4451;9486;0;692147;518875;2;48.6;36.4;0.0
77;2021-07-09;5094;10881;0;697241;529756;2;49.0;37.2;0.0
77;2021-07-10;4081;9953;0;701322;539709;2;49.3;37.9;0.0
77;2021-07-11;2867;4921;0;704189;544630;2;49.5;38.3;0.0
77;2021-07-12;3644;10655;0;707833;555285;2;49.7;39.0;0.0
77;2021-07-13;6879;12189;0;714712;567474;2;50.2;39.9;0.0
77;2021-07-14;4172;6241;0;718884;573715;2;50.5;40.3;0.0
77;2021-07-15;8287;12440;0;727171;586155;2;51.1;41.2;0.0
77;2021-07-16;8897;10631;0;736068;596786;2;51.7;41.9;0.0
77;2021-07-17;6540;9537;0;742608;606323;2;52.2;42.6;0.0
77;2021-07-18;4109;5045;0;746717;611368;2;52.5;42.9;0.0
77;2021-07-19;7887;9351;0;754604;620719;2;53.0;43.6;0.0
77;2021-07-20;10296;8995;0;764900;629714;2;53.7;44.2;0.0
77;2021-07-21;10226;8361;0;775126;638075;2;54.4;44.8;0.0
77;2021-07-22;11215;8426;0;786341;646501;2;55.2;45.4;0.0
77;2021-07-23;10699;9153;0;797040;655654;2;56.0;46.1;0.0
77;2021-07-24;7591;8135;0;804631;663789;2;56.5;46.6;0.0
77;2021-07-25;5347;3903;0;809978;667692;2;56.9;46.9;0.0
77;2021-07-26;9128;6587;0;819106;674279;2;57.5;47.4;0.0
77;2021-07-27;10913;6603;0;830019;680882;2;58.3;47.8;0.0
77;2021-07-28;9926;7053;0;839945;687935;2;59.0;48.3;0.0
77;2021-07-29;9807;6165;0;849752;694100;2;59.7;48.8;0.0
77;2021-07-30;9875;6962;0;859627;701062;2;60.4;49.2;0.0
77;2021-07-31;7003;6658;0;866630;707720;2;60.9;49.7;0.0
77;2021-08-01;2863;1433;0;869493;709153;2;61.1;49.8;0.0
77;2021-08-02;7378;6148;0;876871;715301;2;61.6;50.2;0.0
77;2021-08-03;6356;5438;0;883227;720739;2;62.0;50.6;0.0
77;2021-08-04;5401;5275;0;888628;726014;2;62.4;51.0;0.0
77;2021-08-05;3924;4076;0;892552;730090;2;62.7;51.3;0.0
77;2021-08-06;6230;6123;0;898782;736213;2;63.1;51.7;0.0
77;2021-08-07;5248;6989;0;904030;743202;2;63.5;52.2;0.0
77;2021-08-08;1939;2137;0;905969;745339;2;63.6;52.4;0.0
77;2021-08-09;5375;7415;0;911344;752754;2;64.0;52.9;0.0
77;2021-08-10;3529;5116;0;914873;757870;2;64.3;53.2;0.0
77;2021-08-11;3615;7190;0;918488;765060;2;64.5;53.7;0.0
77;2021-08-12;3037;4966;0;921525;770026;2;64.7;54.1;0.0
77;2021-08-13;3282;6013;0;924807;776039;2;65.0;54.5;0.0
77;2021-08-14;3014;7526;0;927821;783565;2;65.2;55.0;0.0
77;2021-08-15;818;942;0;928639;784507;2;65.2;55.1;0.0
77;2021-08-16;2812;7823;0;931451;792330;2;65.4;55.7;0.0
77;2021-08-17;3300;8023;0;934751;800353;2;65.7;56.2;0.0
77;2021-08-18;2982;7300;0;937733;807653;2;65.9;56.7;0.0
77;2021-08-19;2948;6149;0;940681;813802;2;66.1;57.2;0.0
77;2021-08-20;2971;6639;0;943652;820441;2;66.3;57.6;0.0
77;2021-08-21;2694;7322;0;946346;827763;2;66.5;58.1;0.0
77;2021-08-22;1614;4856;0;947960;832619;2;66.6;58.5;0.0
77;2021-08-23;2586;9610;0;950546;842229;2;66.8;59.2;0.0
77;2021-08-24;3194;9321;0;953740;851550;2;67.0;59.8;0.0
77;2021-08-25;2723;6934;0;956463;858484;2;67.2;60.3;0.0
77;2021-08-26;2726;6578;0;959189;865062;2;67.4;60.8;0.0
77;2021-08-27;2900;7541;1;962089;872603;3;67.6;61.3;0.0
77;2021-08-28;2113;7341;0;964202;879944;3;67.7;61.8;0.0
77;2021-08-29;1438;4721;0;965640;884665;3;67.8;62.1;0.0
77;2021-08-30;2694;8267;111;968334;892932;114;68.0;62.7;0.0
77;2021-08-31;2916;6082;149;971250;899014;263;68.2;63.2;0.0
77;2021-09-01;2718;4256;346;973968;903270;609;68.4;63.4;0.0
77;2021-09-02;1919;3254;371;975887;906524;980;68.6;63.7;0.1
77;2021-09-03;2276;4596;470;978163;911120;1450;68.7;64.0;0.1
77;2021-09-04;2521;5785;201;980684;916905;1651;68.9;64.4;0.1
77;2021-09-05;873;1443;183;981557;918348;1834;68.9;64.5;0.1
77;2021-09-06;1286;2507;466;982843;920855;2300;69.0;64.7;0.2
77;2021-09-07;1151;2512;361;983994;923367;2661;69.1;64.9;0.2
77;2021-09-08;1847;3157;527;985841;926524;3188;69.2;65.1;0.2
77;2021-09-09;1140;2255;458;986981;928779;3646;69.3;65.2;0.3
77;2021-09-10;1434;2633;412;988415;931412;4058;69.4;65.4;0.3
77;2021-09-11;1968;5334;329;990383;936746;4387;69.6;65.8;0.3
77;2021-09-12;548;1377;72;990931;938123;4459;69.6;65.9;0.3
77;2021-09-13;1202;2030;658;992133;940153;5117;69.7;66.0;0.4
77;2021-09-14;1209;2011;647;993342;942164;5764;69.8;66.2;0.4
77;2021-09-15;1309;2671;896;994651;944835;6660;69.9;66.4;0.5
77;2021-09-16;1067;1802;978;995718;946637;7638;69.9;66.5;0.5
77;2021-09-17;1315;2338;681;997033;948975;8319;70.0;66.7;0.6
77;2021-09-18;1346;3742;329;998379;952717;8648;70.1;66.9;0.6
77;2021-09-19;254;1178;87;998633;953895;8735;70.1;67.0;0.6
77;2021-09-20;942;1838;712;999575;955733;9447;70.2;67.1;0.7
77;2021-09-21;896;1667;943;1000471;957400;10390;70.3;67.3;0.7
77;2021-09-22;879;2688;932;1001350;960088;11322;70.3;67.4;0.8
77;2021-09-23;636;1554;662;1001986;961642;11984;70.4;67.5;0.8
77;2021-09-24;887;1995;770;1002873;963637;12754;70.4;67.7;0.9
77;2021-09-25;1020;3912;519;1003893;967549;13273;70.5;68.0;0.9
77;2021-09-26;252;866;121;1004145;968415;13394;70.5;68.0;0.9
77;2021-09-27;747;1435;770;1004892;969850;14164;70.6;68.1;1.0
77;2021-09-28;813;1059;574;1005705;970909;14738;70.6;68.2;1.0
77;2021-09-29;1017;1874;1032;1006722;972783;15770;70.7;68.3;1.1
77;2021-09-30;697;1091;651;1007419;973874;16421;70.8;68.4;1.2
77;2021-10-01;1221;1300;760;1008640;975174;17181;70.9;68.5;1.2
77;2021-10-02;1182;2196;610;1009822;977370;17791;70.9;68.7;1.2
77;2021-10-03;181;504;91;1010003;977874;17882;70.9;68.7;1.3
77;2021-10-04;661;933;869;1010664;978807;18751;71.0;68.8;1.3
77;2021-10-05;511;937;742;1011175;979744;19493;71.0;68.8;1.4
77;2021-10-06;704;1418;955;1011879;981162;20448;71.1;68.9;1.4
77;2021-10-07;518;877;829;1012397;982039;21277;71.1;69.0;1.5
77;2021-10-08;852;1408;1103;1013249;983447;22380;71.2;69.1;1.6
77;2021-10-09;931;1967;986;1014180;985414;23366;71.2;69.2;1.6
77;2021-10-10;101;157;43;1014281;985571;23409;71.2;69.2;1.6
77;2021-10-11;715;991;1165;1014996;986562;24574;71.3;69.3;1.7
77;2021-10-12;595;995;1380;1015591;987557;25954;71.3;69.4;1.8
77;2021-10-13;827;1084;1485;1016418;988641;27439;71.4;69.4;1.9
77;2021-10-14;513;832;1153;1016931;989473;28592;71.4;69.5;2.0
77;2021-10-15;762;1204;1440;1017693;990677;30032;71.5;69.6;2.1
77;2021-10-16;914;1300;951;1018607;991977;30983;71.6;69.7;2.2
77;2021-10-17;81;123;54;1018688;992100;31037;71.6;69.7;2.2
77;2021-10-18;583;861;1419;1019271;992961;32456;71.6;69.7;2.3
77;2021-10-19;457;895;1159;1019728;993856;33615;71.6;69.8;2.4
77;2021-10-20;621;1137;1820;1020349;994993;35435;71.7;69.9;2.5
77;2021-10-21;416;683;1369;1020765;995676;36804;71.7;69.9;2.6
77;2021-10-22;668;1105;2038;1021433;996781;38842;71.7;70.0;2.7
77;2021-10-23;801;1246;1398;1022234;998027;40240;71.8;70.1;2.8
77;2021-10-24;39;100;39;1022273;998127;40279;71.8;70.1;2.8
77;2021-10-25;481;661;1411;1022754;998788;41690;71.8;70.2;2.9
77;2021-10-26;348;444;1041;1023102;999232;42731;71.9;70.2;3.0
77;2021-10-27;496;700;2143;1023598;999932;44874;71.9;70.2;3.2
77;2021-10-28;374;555;1293;1023972;1000487;46167;71.9;70.3;3.2
77;2021-10-29;545;787;1752;1024517;1001274;47919;72.0;70.3;3.4
77;2021-10-30;570;900;1392;1025087;1002174;49311;72.0;70.4;3.5
77;2021-10-31;42;89;30;1025129;1002263;49341;72.0;70.4;3.5
77;2021-11-01;148;126;213;1025277;1002389;49554;72.0;70.4;3.5
77;2021-11-02;348;584;1261;1025625;1002973;50815;72.0;70.5;3.6
77;2021-11-03;487;786;1899;1026112;1003759;52714;72.1;70.5;3.7
77;2021-11-04;336;578;1708;1026448;1004337;54422;72.1;70.5;3.8
77;2021-11-05;542;696;2126;1026990;1005033;56548;72.1;70.6;4.0
77;2021-11-06;624;1097;1747;1027614;1006130;58295;72.2;70.7;4.1
77;2021-11-07;32;73;33;1027646;1006203;58328;72.2;70.7;4.1
77;2021-11-08;383;628;2547;1028029;1006831;60875;72.2;70.7;4.3
77;2021-11-09;300;501;2118;1028329;1007332;62993;72.2;70.8;4.4
77;2021-11-10;505;730;3100;1028834;1008062;66093;72.3;70.8;4.6
77;2021-11-11;57;111;393;1028891;1008173;66486;72.3;70.8;4.7
77;2021-11-12;537;724;3102;1029428;1008897;69588;72.3;70.9;4.9
77;2021-11-13;654;1003;2214;1030082;1009900;71802;72.4;70.9;5.0
77;2021-11-14;32;79;119;1030114;1009979;71921;72.4;70.9;5.1
77;2021-11-15;350;463;2562;1030464;1010442;74483;72.4;71.0;5.2
77;2021-11-16;374;431;2972;1030838;1010873;77455;72.4;71.0;5.4
77;2021-11-17;452;626;2705;1031290;1011499;80160;72.4;71.1;5.6
77;2021-11-18;353;463;2969;1031643;1011962;83129;72.5;71.1;5.8
77;2021-11-19;547;606;3454;1032190;1012568;86583;72.5;71.1;6.1
77;2021-11-20;830;1094;3077;1033020;1013662;89660;72.6;71.2;6.3
77;2021-11-21;53;88;306;1033073;1013750;89966;72.6;71.2;6.3
77;2021-11-22;440;479;3211;1033513;1014229;93177;72.6;71.2;6.5
77;2021-11-23;314;400;2590;1033827;1014629;95767;72.6;71.3;6.7
77;2021-11-24;517;691;3636;1034344;1015320;99403;72.7;71.3;7.0
77;2021-11-25;387;442;3700;1034731;1015762;103103;72.7;71.4;7.2
77;2021-11-26;566;617;6428;1035297;1016379;109531;72.7;71.4;7.7
77;2021-11-27;699;863;6182;1035996;1017242;115713;72.8;71.5;8.1
77;2021-11-28;64;98;765;1036060;1017340;116478;72.8;71.5;8.2
77;2021-11-29;278;399;6260;1036338;1017739;122738;72.8;71.5;8.6
77;2021-11-30;355;453;8249;1036693;1018192;130987;72.8;71.5;9.2
77;2021-12-01;392;572;9060;1037085;1018764;140047;72.8;71.6;9.8
77;2021-12-02;323;389;10084;1037408;1019153;150131;72.9;71.6;10.5
77;2021-12-03;339;525;10942;1037747;1019678;161073;72.9;71.6;11.3
77;2021-12-04;476;792;8956;1038223;1020470;170029;72.9;71.7;11.9
77;2021-12-05;92;114;2128;1038315;1020584;172157;72.9;71.7;12.1
77;2021-12-06;319;509;10592;1038634;1021093;182749;73.0;71.7;12.8
77;2021-12-07;380;490;14257;1039014;1021583;197006;73.0;71.8;13.8
77;2021-12-08;463;572;14069;1039477;1022155;211075;73.0;71.8;14.8
77;2021-12-09;409;500;15255;1039886;1022655;226330;73.0;71.8;15.9
77;2021-12-10;420;643;16963;1040306;1023298;243293;73.1;71.9;17.1
77;2021-12-11;503;788;14817;1040809;1024086;258110;73.1;71.9;18.1
77;2021-12-12;240;212;7436;1041049;1024298;265546;73.1;72.0;18.7
77;2021-12-13;337;501;12608;1041386;1024799;278154;73.2;72.0;19.5
77;2021-12-14;402;500;15418;1041788;1025299;293572;73.2;72.0;20.6
77;2021-12-15;459;553;14522;1042247;1025852;308094;73.2;72.1;21.6
77;2021-12-16;422;517;15591;1042669;1026369;323685;73.2;72.1;22.7
78;2020-12-27;4;0;0;4;0;0;0.0;0.0;0.0
78;2020-12-28;0;0;0;4;0;0;0.0;0.0;0.0
78;2020-12-29;2;0;0;6;0;0;0.0;0.0;0.0
78;2020-12-30;6;0;0;12;0;0;0.0;0.0;0.0
78;2020-12-31;12;0;0;24;0;0;0.0;0.0;0.0
78;2021-01-01;7;0;0;31;0;0;0.0;0.0;0.0
78;2021-01-02;1;0;0;32;0;0;0.0;0.0;0.0
78;2021-01-03;5;0;0;37;0;0;0.0;0.0;0.0
78;2021-01-04;122;3;0;159;3;0;0.0;0.0;0.0
78;2021-01-05;221;1;0;380;4;0;0.0;0.0;0.0
78;2021-01-06;262;5;0;642;9;0;0.0;0.0;0.0
78;2021-01-07;517;3;0;1159;12;0;0.1;0.0;0.0
78;2021-01-08;704;5;0;1863;17;0;0.1;0.0;0.0
78;2021-01-09;78;1;0;1941;18;0;0.1;0.0;0.0
78;2021-01-10;49;1;0;1990;19;0;0.1;0.0;0.0
78;2021-01-11;908;8;0;2898;27;0;0.2;0.0;0.0
78;2021-01-12;1074;7;0;3972;34;0;0.3;0.0;0.0
78;2021-01-13;964;12;0;4936;46;0;0.3;0.0;0.0
78;2021-01-14;1080;19;0;6016;65;0;0.4;0.0;0.0
78;2021-01-15;1025;9;0;7041;74;0;0.5;0.0;0.0
78;2021-01-16;108;2;0;7149;76;0;0.5;0.0;0.0
78;2021-01-17;80;0;0;7229;76;0;0.5;0.0;0.0
78;2021-01-18;1552;13;0;8781;89;0;0.6;0.0;0.0
78;2021-01-19;2024;23;0;10805;112;0;0.7;0.0;0.0
78;2021-01-20;2045;17;0;12850;129;0;0.9;0.0;0.0
78;2021-01-21;3491;26;0;16341;155;0;1.1;0.0;0.0
78;2021-01-22;2526;25;0;18867;180;0;1.3;0.0;0.0
78;2021-01-23;453;0;0;19320;180;0;1.3;0.0;0.0
78;2021-01-24;74;2;0;19394;182;0;1.3;0.0;0.0
78;2021-01-25;1152;33;0;20546;215;0;1.4;0.0;0.0
78;2021-01-26;1738;39;0;22284;254;0;1.5;0.0;0.0
78;2021-01-27;2320;73;0;24604;327;0;1.7;0.0;0.0
78;2021-01-28;2868;137;0;27472;464;0;1.9;0.0;0.0
78;2021-01-29;1870;103;0;29342;567;0;2.0;0.0;0.0
78;2021-01-30;359;9;0;29701;576;0;2.1;0.0;0.0
78;2021-01-31;33;4;0;29734;580;0;2.1;0.0;0.0
78;2021-02-01;974;262;0;30708;842;0;2.1;0.1;0.0
78;2021-02-02;1191;372;0;31899;1214;0;2.2;0.1;0.0
78;2021-02-03;1202;324;0;33101;1538;0;2.3;0.1;0.0
78;2021-02-04;1374;526;0;34475;2064;0;2.4;0.1;0.0
78;2021-02-05;1346;581;0;35821;2645;0;2.5;0.2;0.0
78;2021-02-06;301;58;0;36122;2703;0;2.5;0.2;0.0
78;2021-02-07;104;34;0;36226;2737;0;2.5;0.2;0.0
78;2021-02-08;841;735;0;37067;3472;0;2.6;0.2;0.0
78;2021-02-09;1260;1193;0;38327;4665;0;2.6;0.3;0.0
78;2021-02-10;1415;1365;0;39742;6030;0;2.7;0.4;0.0
78;2021-02-11;1957;2088;0;41699;8118;0;2.9;0.6;0.0
78;2021-02-12;1953;1480;0;43652;9598;0;3.0;0.7;0.0
78;2021-02-13;196;154;0;43848;9752;0;3.0;0.7;0.0
78;2021-02-14;43;67;0;43891;9819;0;3.0;0.7;0.0
78;2021-02-15;516;1626;0;44407;11445;0;3.1;0.8;0.0
78;2021-02-16;681;1983;0;45088;13428;0;3.1;0.9;0.0
78;2021-02-17;726;2395;0;45814;15823;0;3.2;1.1;0.0
78;2021-02-18;1159;2633;0;46973;18456;0;3.2;1.3;0.0
78;2021-02-19;1015;2007;0;47988;20463;0;3.3;1.4;0.0
78;2021-02-20;174;275;0;48162;20738;0;3.3;1.4;0.0
78;2021-02-21;16;54;0;48178;20792;0;3.3;1.4;0.0
78;2021-02-22;605;1293;0;48783;22085;0;3.4;1.5;0.0
78;2021-02-23;699;1331;0;49482;23416;0;3.4;1.6;0.0
78;2021-02-24;735;1502;0;50217;24918;0;3.5;1.7;0.0
78;2021-02-25;1067;1609;0;51284;26527;0;3.5;1.8;0.0
78;2021-02-26;1422;1473;0;52706;28000;0;3.6;1.9;0.0
78;2021-02-27;825;274;0;53531;28274;0;3.7;2.0;0.0
78;2021-02-28;117;48;0;53648;28322;0;3.7;2.0;0.0
78;2021-03-01;1156;1107;0;54804;29429;0;3.8;2.0;0.0
78;2021-03-02;2035;1274;0;56839;30703;0;3.9;2.1;0.0
78;2021-03-03;2282;1443;0;59121;32146;0;4.1;2.2;0.0
78;2021-03-04;3568;1821;0;62689;33967;0;4.3;2.3;0.0
78;2021-03-05;4089;1865;0;66778;35832;0;4.6;2.5;0.0
78;2021-03-06;7015;384;0;73793;36216;0;5.1;2.5;0.0
78;2021-03-07;4421;221;0;78214;36437;0;5.4;2.5;0.0
78;2021-03-08;1974;929;0;80188;37366;0;5.5;2.6;0.0
78;2021-03-09;3623;1088;0;83811;38454;0;5.8;2.7;0.0
78;2021-03-10;3705;1291;0;87516;39745;0;6.0;2.7;0.0
78;2021-03-11;4974;1536;0;92490;41281;0;6.4;2.8;0.0
78;2021-03-12;6187;1591;0;98677;42872;0;6.8;3.0;0.0
78;2021-03-13;5417;316;0;104094;43188;0;7.2;3.0;0.0
78;2021-03-14;1522;73;0;105616;43261;0;7.3;3.0;0.0
78;2021-03-15;4102;380;0;109718;43641;0;7.6;3.0;0.0
78;2021-03-16;3171;616;0;112889;44257;0;7.8;3.1;0.0
78;2021-03-17;3478;545;0;116367;44802;0;8.0;3.1;0.0
78;2021-03-18;4577;549;0;120944;45351;0;8.3;3.1;0.0
78;2021-03-19;6153;618;0;127097;45969;0;8.8;3.2;0.0
78;2021-03-20;2802;160;0;129899;46129;0;9.0;3.2;0.0
78;2021-03-21;310;39;0;130209;46168;0;9.0;3.2;0.0
78;2021-03-22;3892;508;0;134101;46676;0;9.3;3.2;0.0
78;2021-03-23;5786;698;0;139887;47374;0;9.7;3.3;0.0
78;2021-03-24;5408;728;0;145295;48102;0;10.0;3.3;0.0
78;2021-03-25;7750;776;0;153045;48878;0;10.6;3.4;0.0
78;2021-03-26;7756;921;0;160801;49799;0;11.1;3.4;0.0
78;2021-03-27;4504;335;0;165305;50134;0;11.4;3.5;0.0
78;2021-03-28;2118;81;0;167423;50215;0;11.6;3.5;0.0
78;2021-03-29;4256;1000;0;171679;51215;0;11.9;3.5;0.0
78;2021-03-30;5878;1361;0;177557;52576;0;12.3;3.6;0.0
78;2021-03-31;5743;1692;0;183300;54268;0;12.7;3.7;0.0
78;2021-04-01;6350;2795;0;189650;57063;0;13.1;3.9;0.0
78;2021-04-02;5620;3279;0;195270;60342;0;13.5;4.2;0.0
78;2021-04-03;2411;3384;0;197681;63726;0;13.6;4.4;0.0
78;2021-04-04;464;345;0;198145;64071;0;13.7;4.4;0.0
78;2021-04-05;512;76;0;198657;64147;0;13.7;4.4;0.0
78;2021-04-06;3865;2821;0;202522;66968;0;14.0;4.6;0.0
78;2021-04-07;5059;3113;0;207581;70081;0;14.3;4.8;0.0
78;2021-04-08;6107;3212;0;213688;73293;0;14.8;5.1;0.0
78;2021-04-09;7528;3036;0;221216;76329;0;15.3;5.3;0.0
78;2021-04-10;4189;2466;0;225405;78795;0;15.6;5.4;0.0
78;2021-04-11;582;852;0;225987;79647;0;15.6;5.5;0.0
78;2021-04-12;3691;2767;0;229678;82414;0;15.9;5.7;0.0
78;2021-04-13;5626;3293;0;235304;85707;0;16.2;5.9;0.0
78;2021-04-14;5367;3846;0;240671;89553;0;16.6;6.2;0.0
78;2021-04-15;5199;4634;0;245870;94187;0;17.0;6.5;0.0
78;2021-04-16;6403;4615;0;252273;98802;0;17.4;6.8;0.0
78;2021-04-17;4024;1159;0;256297;99961;0;17.7;6.9;0.0
78;2021-04-18;548;159;0;256845;100120;0;17.7;6.9;0.0
78;2021-04-19;3522;3101;0;260367;103221;0;18.0;7.1;0.0
78;2021-04-20;5007;4121;0;265374;107342;0;18.3;7.4;0.0
78;2021-04-21;5255;3864;0;270629;111206;0;18.7;7.7;0.0
78;2021-04-22;5074;5122;0;275703;116328;0;19.0;8.0;0.0
78;2021-04-23;5776;5046;0;281479;121374;0;19.4;8.4;0.0
78;2021-04-24;5865;3163;0;287344;124537;0;19.8;8.6;0.0
78;2021-04-25;3300;1813;0;290644;126350;0;20.1;8.7;0.0
78;2021-04-26;4997;3630;0;295641;129980;0;20.4;9.0;0.0
78;2021-04-27;5826;4529;0;301467;134509;0;20.8;9.3;0.0
78;2021-04-28;6044;4905;0;307511;139414;0;21.2;9.6;0.0
78;2021-04-29;6940;4714;0;314451;144128;0;21.7;9.9;0.0
78;2021-04-30;8204;4813;0;322655;148941;0;22.3;10.3;0.0
78;2021-05-01;1242;449;0;323897;149390;0;22.4;10.3;0.0
78;2021-05-02;2032;307;0;325929;149697;0;22.5;10.3;0.0
78;2021-05-03;7295;2401;0;333224;152098;0;23.0;10.5;0.0
78;2021-05-04;6865;4373;0;340089;156471;0;23.5;10.8;0.0
78;2021-05-05;7795;5050;0;347884;161521;0;24.0;11.1;0.0
78;2021-05-06;7714;5548;0;355598;167069;0;24.5;11.5;0.0
78;2021-05-07;9421;5684;0;365019;172753;0;25.2;11.9;0.0
78;2021-05-08;4604;1776;0;369623;174529;0;25.5;12.0;0.0
78;2021-05-09;3680;655;0;373303;175184;0;25.8;12.1;0.0
78;2021-05-10;8856;4591;0;382159;179775;0;26.4;12.4;0.0
78;2021-05-11;10236;5598;0;392395;185373;0;27.1;12.8;0.0
78;2021-05-12;10895;4352;0;403290;189725;0;27.8;13.1;0.0
78;2021-05-13;9030;953;0;412320;190678;0;28.5;13.2;0.0
78;2021-05-14;11883;2747;0;424203;193425;0;29.3;13.4;0.0
78;2021-05-15;6940;2624;0;431143;196049;0;29.8;13.5;0.0
78;2021-05-16;4765;868;0;435908;196917;0;30.1;13.6;0.0
78;2021-05-17;9783;1714;0;445691;198631;0;30.8;13.7;0.0
78;2021-05-18;12016;2433;0;457707;201064;0;31.6;13.9;0.0
78;2021-05-19;13398;2740;0;471105;203804;0;32.5;14.1;0.0
78;2021-05-20;13740;3045;0;484845;206849;0;33.5;14.3;0.0
78;2021-05-21;14064;3186;0;498909;210035;0;34.4;14.5;0.0
78;2021-05-22;8857;1738;0;507766;211773;0;35.1;14.6;0.0
78;2021-05-23;4370;547;0;512136;212320;0;35.4;14.7;0.0
78;2021-05-24;5310;709;0;517446;213029;0;35.7;14.7;0.0
78;2021-05-25;10910;3181;0;528356;216210;0;36.5;14.9;0.0
78;2021-05-26;11310;4342;0;539666;220552;0;37.3;15.2;0.0
78;2021-05-27;12109;5228;0;551775;225780;0;38.1;15.6;0.0
78;2021-05-28;12298;6701;0;564073;232481;0;38.9;16.0;0.0
78;2021-05-29;5546;3662;0;569619;236143;0;39.3;16.3;0.0
78;2021-05-30;1204;550;0;570823;236693;0;39.4;16.3;0.0
78;2021-05-31;8881;5479;0;579704;242172;0;40.0;16.7;0.0
78;2021-06-01;11614;7143;0;591318;249315;0;40.8;17.2;0.0
78;2021-06-02;10457;6847;0;601775;256162;0;41.5;17.7;0.0
78;2021-06-03;11182;7491;0;612957;263653;0;42.3;18.2;0.0
78;2021-06-04;11467;8666;0;624424;272319;0;43.1;18.8;0.0
78;2021-06-05;7838;6954;0;632262;279273;0;43.6;19.3;0.0
78;2021-06-06;2876;2188;0;635138;281461;0;43.8;19.4;0.0
78;2021-06-07;9701;6919;0;644839;288380;0;44.5;19.9;0.0
78;2021-06-08;9580;7852;0;654419;296232;0;45.2;20.4;0.0
78;2021-06-09;8565;7715;0;662984;303947;0;45.8;21.0;0.0
78;2021-06-10;8288;8635;0;671272;312582;0;46.3;21.6;0.0
78;2021-06-11;8747;9002;0;680019;321584;0;46.9;22.2;0.0
78;2021-06-12;7760;4068;0;687779;325652;0;47.5;22.5;0.0
78;2021-06-13;1676;2820;0;689455;328472;0;47.6;22.7;0.0
78;2021-06-14;4498;10086;0;693953;338558;0;47.9;23.4;0.0
78;2021-06-15;6291;9516;0;700244;348074;0;48.3;24.0;0.0
78;2021-06-16;6183;9788;0;706427;357862;0;48.8;24.7;0.0
78;2021-06-17;6179;9820;0;712606;367682;0;49.2;25.4;0.0
78;2021-06-18;6834;11702;0;719440;379384;0;49.7;26.2;0.0
78;2021-06-19;5778;7011;0;725218;386395;0;50.1;26.7;0.0
78;2021-06-20;1001;3875;0;726219;390270;0;50.1;26.9;0.0
78;2021-06-21;4468;10831;0;730687;401101;0;50.4;27.7;0.0
78;2021-06-22;4090;12079;0;734777;413180;0;50.7;28.5;0.0
78;2021-06-23;4482;12251;0;739259;425431;0;51.0;29.4;0.0
78;2021-06-24;4486;11823;0;743745;437254;0;51.3;30.2;0.0
78;2021-06-25;4755;14954;0;748500;452208;0;51.7;31.2;0.0
78;2021-06-26;4706;10085;0;753206;462293;0;52.0;31.9;0.0
78;2021-06-27;1324;3577;0;754530;465870;0;52.1;32.2;0.0
78;2021-06-28;3741;12368;0;758271;478238;0;52.3;33.0;0.0
78;2021-06-29;3853;13177;0;762124;491415;0;52.6;33.9;0.0
78;2021-06-30;4509;14738;0;766633;506153;0;52.9;34.9;0.0
78;2021-07-01;4647;13999;0;771280;520152;0;53.2;35.9;0.0
78;2021-07-02;4803;15238;0;776083;535390;0;53.6;37.0;0.0
78;2021-07-03;3404;10872;0;779487;546262;0;53.8;37.7;0.0
78;2021-07-04;959;2728;0;780446;548990;0;53.9;37.9;0.0
78;2021-07-05;3845;10873;0;784291;559863;0;54.1;38.6;0.0
78;2021-07-06;3905;13379;0;788196;573242;0;54.4;39.6;0.0
78;2021-07-07;4482;12803;0;792678;586045;0;54.7;40.5;0.0
78;2021-07-08;4794;13042;0;797472;599087;0;55.1;41.4;0.0
78;2021-07-09;5410;13988;0;802882;613075;0;55.4;42.3;0.0
78;2021-07-10;3238;8490;0;806120;621565;0;55.6;42.9;0.0
78;2021-07-11;1124;2823;0;807244;624388;0;55.7;43.1;0.0
78;2021-07-12;4007;13790;0;811251;638178;0;56.0;44.1;0.0
78;2021-07-13;6451;14094;0;817702;652272;0;56.4;45.0;0.0
78;2021-07-14;4017;6118;0;821719;658390;0;56.7;45.4;0.0
78;2021-07-15;7407;14487;0;829126;672877;0;57.2;46.4;0.0
78;2021-07-16;8551;13202;0;837677;686079;0;57.8;47.4;0.0
78;2021-07-17;5650;6833;0;843327;692912;0;58.2;47.8;0.0
78;2021-07-18;1745;1207;0;845072;694119;0;58.3;47.9;0.0
78;2021-07-19;5839;12447;0;850911;706566;0;58.7;48.8;0.0
78;2021-07-20;7430;11942;0;858341;718508;0;59.3;49.6;0.0
78;2021-07-21;8188;11768;0;866529;730276;0;59.8;50.4;0.0
78;2021-07-22;8778;11270;0;875307;741546;0;60.4;51.2;0.0
78;2021-07-23;8793;11232;0;884100;752778;0;61.0;52.0;0.0
78;2021-07-24;4723;6321;0;888823;759099;0;61.4;52.4;0.0
78;2021-07-25;1918;1289;0;890741;760388;0;61.5;52.5;0.0
78;2021-07-26;7724;8604;0;898465;768992;0;62.0;53.1;0.0
78;2021-07-27;10374;8642;0;908839;777634;0;62.7;53.7;0.0
78;2021-07-28;10018;7806;0;918857;785440;0;63.4;54.2;0.0
78;2021-07-29;10344;7469;0;929201;792909;0;64.1;54.7;0.0
78;2021-07-30;9625;8809;0;938826;801718;0;64.8;55.3;0.0
78;2021-07-31;4324;3874;0;943150;805592;0;65.1;55.6;0.0
78;2021-08-01;1237;820;0;944387;806412;0;65.2;55.7;0.0
78;2021-08-02;4631;3815;0;949018;810227;0;65.5;55.9;0.0
78;2021-08-03;5968;6143;0;954986;816370;0;65.9;56.4;0.0
78;2021-08-04;6115;4771;0;961101;821141;0;66.3;56.7;0.0
78;2021-08-05;5589;4876;0;966690;826017;0;66.7;57.0;0.0
78;2021-08-06;5417;5848;0;972107;831865;0;67.1;57.4;0.0
78;2021-08-07;3459;4449;0;975566;836314;0;67.3;57.7;0.0
78;2021-08-08;840;838;0;976406;837152;0;67.4;57.8;0.0
78;2021-08-09;3300;3906;0;979706;841058;0;67.6;58.1;0.0
78;2021-08-10;4383;5654;0;984089;846712;0;67.9;58.4;0.0
78;2021-08-11;4130;5413;0;988219;852125;0;68.2;58.8;0.0
78;2021-08-12;3936;5681;0;992155;857806;0;68.5;59.2;0.0
78;2021-08-13;3665;4814;0;995820;862620;0;68.7;59.5;0.0
78;2021-08-14;2841;4118;0;998661;866738;0;68.9;59.8;0.0
78;2021-08-15;424;618;0;999085;867356;0;69.0;59.9;0.0
78;2021-08-16;1861;4920;0;1000946;872276;0;69.1;60.2;0.0
78;2021-08-17;3227;6398;0;1004173;878674;0;69.3;60.7;0.0
78;2021-08-18;3087;6032;0;1007260;884706;0;69.5;61.1;0.0
78;2021-08-19;2831;5470;0;1010091;890176;0;69.7;61.4;0.0
78;2021-08-20;2764;6150;0;1012855;896326;0;69.9;61.9;0.0
78;2021-08-21;2233;5011;0;1015088;901337;0;70.1;62.2;0.0
78;2021-08-22;243;731;0;1015331;902068;0;70.1;62.3;0.0
78;2021-08-23;2512;6277;0;1017843;908345;0;70.3;62.7;0.0
78;2021-08-24;3578;8221;0;1021421;916566;0;70.5;63.3;0.0
78;2021-08-25;3414;7929;0;1024835;924495;0;70.7;63.8;0.0
78;2021-08-26;3025;8516;0;1027860;933011;0;71.0;64.4;0.0
78;2021-08-27;2964;8617;0;1030824;941628;0;71.2;65.0;0.0
78;2021-08-28;2541;6216;0;1033365;947844;0;71.3;65.4;0.0
78;2021-08-29;362;705;0;1033727;948549;0;71.4;65.5;0.0
78;2021-08-30;2930;5948;109;1036657;954497;109;71.6;65.9;0.0
78;2021-08-31;3405;6448;187;1040062;960945;296;71.8;66.3;0.0
78;2021-09-01;3136;5964;506;1043198;966909;802;72.0;66.7;0.1
78;2021-09-02;2319;4812;568;1045517;971721;1370;72.2;67.1;0.1
78;2021-09-03;2372;5134;600;1047889;976855;1970;72.3;67.4;0.1
78;2021-09-04;2708;5144;339;1050597;981999;2309;72.5;67.8;0.2
78;2021-09-05;293;415;34;1050890;982414;2343;72.5;67.8;0.2
78;2021-09-06;1343;2816;593;1052233;985230;2936;72.6;68.0;0.2
78;2021-09-07;1464;3219;698;1053697;988449;3634;72.7;68.2;0.3
78;2021-09-08;1811;3689;604;1055508;992138;4238;72.9;68.5;0.3
78;2021-09-09;1146;2867;657;1056654;995005;4895;72.9;68.7;0.3
78;2021-09-10;1526;3330;618;1058180;998335;5513;73.0;68.9;0.4
78;2021-09-11;2221;4327;510;1060401;1002662;6023;73.2;69.2;0.4
78;2021-09-12;133;230;36;1060534;1002892;6059;73.2;69.2;0.4
78;2021-09-13;1100;2122;700;1061634;1005014;6759;73.3;69.4;0.5
78;2021-09-14;1209;2783;1159;1062843;1007797;7918;73.4;69.6;0.5
78;2021-09-15;1375;3789;1003;1064218;1011586;8921;73.5;69.8;0.6
78;2021-09-16;915;2111;1034;1065133;1013697;9955;73.5;70.0;0.7
78;2021-09-17;1260;2872;991;1066393;1016569;10946;73.6;70.2;0.8
78;2021-09-18;1491;4362;426;1067884;1020931;11372;73.7;70.5;0.8
78;2021-09-19;128;389;30;1068012;1021320;11402;73.7;70.5;0.8
78;2021-09-20;753;1674;853;1068765;1022994;12255;73.8;70.6;0.8
78;2021-09-21;833;1958;1177;1069598;1024952;13432;73.8;70.8;0.9
78;2021-09-22;989;3570;940;1070587;1028522;14372;73.9;71.0;1.0
78;2021-09-23;874;1623;1315;1071461;1030145;15687;74.0;71.1;1.1
78;2021-09-24;1025;2329;1079;1072486;1032474;16766;74.0;71.3;1.2
78;2021-09-25;1122;4151;554;1073608;1036625;17320;74.1;71.6;1.2
78;2021-09-26;63;176;17;1073671;1036801;17337;74.1;71.6;1.2
78;2021-09-27;689;1484;990;1074360;1038285;18327;74.2;71.7;1.3
78;2021-09-28;848;1440;1164;1075208;1039725;19491;74.2;71.8;1.3
78;2021-09-29;1054;2272;1086;1076262;1041997;20577;74.3;71.9;1.4
78;2021-09-30;585;1021;933;1076847;1043018;21510;74.3;72.0;1.5
78;2021-10-01;1294;1779;1275;1078141;1044797;22785;74.4;72.1;1.6
78;2021-10-02;1334;2647;738;1079475;1047444;23523;74.5;72.3;1.6
78;2021-10-03;76;110;30;1079551;1047554;23553;74.5;72.3;1.6
78;2021-10-04;613;966;1054;1080164;1048520;24607;74.6;72.4;1.7
78;2021-10-05;574;907;1089;1080738;1049427;25696;74.6;72.4;1.8
78;2021-10-06;890;1587;1721;1081628;1051014;27417;74.7;72.6;1.9
78;2021-10-07;490;858;1300;1082118;1051872;28717;74.7;72.6;2.0
78;2021-10-08;925;1674;2145;1083043;1053546;30862;74.8;72.7;2.1
78;2021-10-09;940;1878;907;1083983;1055424;31769;74.8;72.9;2.2
78;2021-10-10;82;116;60;1084065;1055540;31829;74.8;72.9;2.2
78;2021-10-11;583;824;1250;1084648;1056364;33079;74.9;72.9;2.3
78;2021-10-12;473;758;1457;1085121;1057122;34536;74.9;73.0;2.4
78;2021-10-13;709;1373;2018;1085830;1058495;36554;75.0;73.1;2.5
78;2021-10-14;545;895;1574;1086375;1059390;38128;75.0;73.1;2.6
78;2021-10-15;768;1343;2618;1087143;1060733;40746;75.0;73.2;2.8
78;2021-10-16;877;1343;1097;1088020;1062076;41843;75.1;73.3;2.9
78;2021-10-17;60;89;49;1088080;1062165;41892;75.1;73.3;2.9
78;2021-10-18;475;813;1527;1088555;1062978;43419;75.1;73.4;3.0
78;2021-10-19;451;748;1460;1089006;1063726;44879;75.2;73.4;3.1
78;2021-10-20;720;1214;2637;1089726;1064940;47516;75.2;73.5;3.3
78;2021-10-21;434;787;2020;1090160;1065727;49536;75.3;73.6;3.4
78;2021-10-22;712;1167;2797;1090872;1066894;52333;75.3;73.6;3.6
78;2021-10-23;758;1227;1224;1091630;1068121;53557;75.4;73.7;3.7
78;2021-10-24;56;92;49;1091686;1068213;53606;75.4;73.7;3.7
78;2021-10-25;477;621;1883;1092163;1068834;55489;75.4;73.8;3.8
78;2021-10-26;317;529;1717;1092480;1069363;57206;75.4;73.8;3.9
78;2021-10-27;554;868;2759;1093034;1070231;59965;75.5;73.9;4.1
78;2021-10-28;330;502;1973;1093364;1070733;61938;75.5;73.9;4.3
78;2021-10-29;503;779;2639;1093867;1071512;64577;75.5;74.0;4.5
78;2021-10-30;409;879;1287;1094276;1072391;65864;75.5;74.0;4.5
78;2021-10-31;61;89;65;1094337;1072480;65929;75.5;74.0;4.6
78;2021-11-01;93;81;80;1094430;1072561;66009;75.5;74.0;4.6
78;2021-11-02;421;508;1763;1094851;1073069;67772;75.6;74.1;4.7
78;2021-11-03;482;581;1955;1095333;1073650;69727;75.6;74.1;4.8
78;2021-11-04;417;531;2097;1095750;1074181;71824;75.6;74.2;5.0
78;2021-11-05;557;810;2816;1096307;1074991;74640;75.7;74.2;5.2
78;2021-11-06;358;602;946;1096665;1075593;75586;75.7;74.2;5.2
78;2021-11-07;54;92;142;1096719;1075685;75728;75.7;74.3;5.2
78;2021-11-08;276;599;2121;1096995;1076284;77849;75.7;74.3;5.4
78;2021-11-09;360;567;3213;1097355;1076851;81062;75.8;74.3;5.6
78;2021-11-10;473;784;3334;1097828;1077635;84396;75.8;74.4;5.8
78;2021-11-11;75;117;332;1097903;1077752;84728;75.8;74.4;5.8
78;2021-11-12;435;745;4090;1098338;1078497;88818;75.8;74.4;6.1
78;2021-11-13;377;542;1453;1098715;1079039;90271;75.8;74.5;6.2
78;2021-11-14;70;62;132;1098785;1079101;90403;75.9;74.5;6.2
78;2021-11-15;249;500;2950;1099034;1079601;93353;75.9;74.5;6.4
78;2021-11-16;412;493;4170;1099446;1080094;97523;75.9;74.6;6.7
78;2021-11-17;483;709;4103;1099929;1080803;101626;75.9;74.6;7.0
78;2021-11-18;346;587;3635;1100275;1081390;105261;76.0;74.6;7.3
78;2021-11-19;599;736;5044;1100874;1082126;110305;76.0;74.7;7.6
78;2021-11-20;504;648;2177;1101378;1082774;112482;76.0;74.7;7.8
78;2021-11-21;67;81;205;1101445;1082855;112687;76.0;74.8;7.8
78;2021-11-22;321;433;3383;1101766;1083288;116070;76.1;74.8;8.0
78;2021-11-23;471;513;5000;1102237;1083801;121070;76.1;74.8;8.4
78;2021-11-24;501;693;4543;1102738;1084494;125613;76.1;74.9;8.7
78;2021-11-25;446;507;5529;1103184;1085001;131142;76.2;74.9;9.1
78;2021-11-26;495;714;8249;1103679;1085715;139391;76.2;74.9;9.6
78;2021-11-27;416;537;4856;1104095;1086252;144247;76.2;75.0;10.0
78;2021-11-28;79;102;1398;1104174;1086354;145645;76.2;75.0;10.1
78;2021-11-29;248;416;7035;1104422;1086770;152680;76.2;75.0;10.5
78;2021-11-30;393;538;11193;1104815;1087308;163873;76.3;75.1;11.3
78;2021-12-01;391;489;10887;1105206;1087797;174760;76.3;75.1;12.1
78;2021-12-02;320;413;12465;1105526;1088210;187225;76.3;75.1;12.9
78;2021-12-03;373;562;14262;1105899;1088772;201487;76.3;75.2;13.9
78;2021-12-04;293;410;8737;1106192;1089182;210224;76.4;75.2;14.5
78;2021-12-05;108;147;3687;1106300;1089329;213911;76.4;75.2;14.8
78;2021-12-06;302;457;11395;1106602;1089786;225306;76.4;75.2;15.6
78;2021-12-07;369;578;15678;1106971;1090364;240984;76.4;75.3;16.6
78;2021-12-08;403;618;15799;1107374;1090982;256783;76.4;75.3;17.7
78;2021-12-09;381;479;17796;1107755;1091461;274579;76.5;75.3;19.0
78;2021-12-10;447;682;19335;1108202;1092143;293914;76.5;75.4;20.3
78;2021-12-11;396;669;11866;1108598;1092812;305780;76.5;75.4;21.1
78;2021-12-12;123;162;5097;1108721;1092974;310877;76.5;75.4;21.5
78;2021-12-13;305;518;14268;1109026;1093492;325145;76.6;75.5;22.4
78;2021-12-14;408;658;19171;1109434;1094150;344316;76.6;75.5;23.8
78;2021-12-15;426;636;18002;1109860;1094786;362318;76.6;75.6;25.0
78;2021-12-16;402;591;19931;1110262;1095377;382249;76.6;75.6;26.4
79;2020-12-27;0;0;0;0;0;0;0.0;0.0;0.0
79;2020-12-28;3;0;0;3;0;0;0.0;0.0;0.0
79;2020-12-29;0;0;0;3;0;0;0.0;0.0;0.0
79;2020-12-30;0;0;0;3;0;0;0.0;0.0;0.0
79;2020-12-31;0;0;0;3;0;0;0.0;0.0;0.0
79;2021-01-01;0;0;0;3;0;0;0.0;0.0;0.0
79;2021-01-02;0;0;0;3;0;0;0.0;0.0;0.0
79;2021-01-03;0;0;0;3;0;0;0.0;0.0;0.0
79;2021-01-04;3;0;0;6;0;0;0.0;0.0;0.0
79;2021-01-05;1;0;0;7;0;0;0.0;0.0;0.0
79;2021-01-06;3;0;0;10;0;0;0.0;0.0;0.0
79;2021-01-07;165;0;0;175;0;0;0.0;0.0;0.0
79;2021-01-08;173;0;0;348;0;0;0.1;0.0;0.0
79;2021-01-09;95;1;0;443;1;0;0.1;0.0;0.0
79;2021-01-10;5;0;0;448;1;0;0.1;0.0;0.0
79;2021-01-11;184;1;0;632;2;0;0.2;0.0;0.0
79;2021-01-12;249;1;0;881;3;0;0.2;0.0;0.0
79;2021-01-13;261;0;0;1142;3;0;0.3;0.0;0.0
79;2021-01-14;484;7;0;1626;10;0;0.4;0.0;0.0
79;2021-01-15;585;7;0;2211;17;0;0.6;0.0;0.0
79;2021-01-16;59;0;0;2270;17;0;0.6;0.0;0.0
79;2021-01-17;3;0;0;2273;17;0;0.6;0.0;0.0
79;2021-01-18;471;2;0;2744;19;0;0.7;0.0;0.0
79;2021-01-19;1276;3;0;4020;22;0;1.1;0.0;0.0
79;2021-01-20;1607;2;0;5627;24;0;1.5;0.0;0.0
79;2021-01-21;1947;9;0;7574;33;0;2.0;0.0;0.0
79;2021-01-22;881;5;0;8455;38;0;2.3;0.0;0.0
79;2021-01-23;75;0;0;8530;38;0;2.3;0.0;0.0
79;2021-01-24;1;0;0;8531;38;0;2.3;0.0;0.0
79;2021-01-25;652;6;0;9183;44;0;2.5;0.0;0.0
79;2021-01-26;598;16;0;9781;60;0;2.6;0.0;0.0
79;2021-01-27;729;80;0;10510;140;0;2.8;0.0;0.0
79;2021-01-28;757;155;0;11267;295;0;3.0;0.1;0.0
79;2021-01-29;487;87;0;11754;382;0;3.2;0.1;0.0
79;2021-01-30;9;2;0;11763;384;0;3.2;0.1;0.0
79;2021-01-31;4;0;0;11767;384;0;3.2;0.1;0.0
79;2021-02-01;232;110;0;11999;494;0;3.2;0.1;0.0
79;2021-02-02;333;77;0;12332;571;0;3.3;0.2;0.0
79;2021-02-03;342;64;0;12674;635;0;3.4;0.2;0.0
79;2021-02-04;323;116;0;12997;751;0;3.5;0.2;0.0
79;2021-02-05;333;274;0;13330;1025;0;3.6;0.3;0.0
79;2021-02-06;10;3;0;13340;1028;0;3.6;0.3;0.0
79;2021-02-07;21;2;0;13361;1030;0;3.6;0.3;0.0
79;2021-02-08;281;163;0;13642;1193;0;3.7;0.3;0.0
79;2021-02-09;428;755;0;14070;1948;0;3.8;0.5;0.0
79;2021-02-10;545;1103;0;14615;3051;0;3.9;0.8;0.0
79;2021-02-11;768;1206;0;15383;4257;0;4.1;1.1;0.0
79;2021-02-12;458;742;0;15841;4999;0;4.3;1.3;0.0
79;2021-02-13;53;70;0;15894;5069;0;4.3;1.4;0.0
79;2021-02-14;0;1;0;15894;5070;0;4.3;1.4;0.0
79;2021-02-15;184;486;0;16078;5556;0;4.3;1.5;0.0
79;2021-02-16;338;735;0;16416;6291;0;4.4;1.7;0.0
79;2021-02-17;251;816;0;16667;7107;0;4.5;1.9;0.0
79;2021-02-18;377;989;0;17044;8096;0;4.6;2.2;0.0
79;2021-02-19;306;584;0;17350;8680;0;4.7;2.3;0.0
79;2021-02-20;14;25;0;17364;8705;0;4.7;2.3;0.0
79;2021-02-21;0;0;0;17364;8705;0;4.7;2.3;0.0
79;2021-02-22;142;463;0;17506;9168;0;4.7;2.5;0.0
79;2021-02-23;245;569;0;17751;9737;0;4.8;2.6;0.0
79;2021-02-24;256;518;0;18007;10255;0;4.8;2.8;0.0
79;2021-02-25;538;483;0;18545;10738;0;5.0;2.9;0.0
79;2021-02-26;649;386;0;19194;11124;0;5.2;3.0;0.0
79;2021-02-27;409;10;0;19603;11134;0;5.3;3.0;0.0
79;2021-02-28;29;5;0;19632;11139;0;5.3;3.0;0.0
79;2021-03-01;97;364;0;19729;11503;0;5.3;3.1;0.0
79;2021-03-02;335;495;0;20064;11998;0;5.4;3.2;0.0
79;2021-03-03;671;497;0;20735;12495;0;5.6;3.4;0.0
79;2021-03-04;928;565;0;21663;13060;0;5.8;3.5;0.0
79;2021-03-05;1258;412;0;22921;13472;0;6.2;3.6;0.0
79;2021-03-06;696;13;0;23617;13485;0;6.3;3.6;0.0
79;2021-03-07;98;2;0;23715;13487;0;6.4;3.6;0.0
79;2021-03-08;347;312;0;24062;13799;0;6.5;3.7;0.0
79;2021-03-09;855;347;0;24917;14146;0;6.7;3.8;0.0
79;2021-03-10;1176;373;0;26093;14519;0;7.0;3.9;0.0
79;2021-03-11;1676;325;0;27769;14844;0;7.5;4.0;0.0
79;2021-03-12;1788;156;0;29557;15000;0;7.9;4.0;0.0
79;2021-03-13;1162;15;0;30719;15015;0;8.2;4.0;0.0
79;2021-03-14;53;1;0;30772;15016;0;8.3;4.0;0.0
79;2021-03-15;544;164;0;31316;15180;0;8.4;4.1;0.0
79;2021-03-16;713;155;0;32029;15335;0;8.6;4.1;0.0
79;2021-03-17;636;121;0;32665;15456;0;8.8;4.1;0.0
79;2021-03-18;591;214;0;33256;15670;0;8.9;4.2;0.0
79;2021-03-19;720;256;0;33976;15926;0;9.1;4.3;0.0
79;2021-03-20;1003;19;0;34979;15945;0;9.4;4.3;0.0
79;2021-03-21;9;0;0;34988;15945;0;9.4;4.3;0.0
79;2021-03-22;983;209;0;35971;16154;0;9.7;4.3;0.0
79;2021-03-23;1621;193;0;37592;16347;0;10.1;4.4;0.0
79;2021-03-24;1802;175;0;39394;16522;0;10.6;4.4;0.0
79;2021-03-25;2509;206;0;41903;16728;0;11.2;4.5;0.0
79;2021-03-26;2394;143;0;44297;16871;0;11.9;4.5;0.0
79;2021-03-27;684;21;0;44981;16892;0;12.1;4.5;0.0
79;2021-03-28;3;2;0;44984;16894;0;12.1;4.5;0.0
79;2021-03-29;2065;119;0;47049;17013;0;12.6;4.6;0.0
79;2021-03-30;2702;85;0;49751;17098;0;13.4;4.6;0.0
79;2021-03-31;2649;389;0;52400;17487;0;14.1;4.7;0.0
79;2021-04-01;2656;400;0;55056;17887;0;14.8;4.8;0.0
79;2021-04-02;2699;399;0;57755;18286;0;15.5;4.9;0.0
79;2021-04-03;659;67;0;58414;18353;0;15.7;4.9;0.0
79;2021-04-04;9;1;0;58423;18354;0;15.7;4.9;0.0
79;2021-04-05;384;7;0;58807;18361;0;15.8;4.9;0.0
79;2021-04-06;1676;593;0;60483;18954;0;16.2;5.1;0.0
79;2021-04-07;2903;753;0;63386;19707;0;17.0;5.3;0.0
79;2021-04-08;2537;712;0;65923;20419;0;17.7;5.5;0.0
79;2021-04-09;3518;560;0;69441;20979;0;18.6;5.6;0.0
79;2021-04-10;1364;388;0;70805;21367;0;19.0;5.7;0.0
79;2021-04-11;12;2;0;70817;21369;0;19.0;5.7;0.0
79;2021-04-12;1694;395;0;72511;21764;0;19.5;5.8;0.0
79;2021-04-13;2131;766;0;74642;22530;0;20.0;6.0;0.0
79;2021-04-14;2335;704;0;76977;23234;0;20.7;6.2;0.0
79;2021-04-15;2229;692;0;79206;23926;0;21.3;6.4;0.0
79;2021-04-16;1470;467;0;80676;24393;0;21.7;6.5;0.0
79;2021-04-17;610;350;0;81286;24743;0;21.8;6.6;0.0
79;2021-04-18;14;16;0;81300;24759;0;21.8;6.6;0.0
79;2021-04-19;1117;839;0;82417;25598;0;22.1;6.9;0.0
79;2021-04-20;1548;1247;0;83965;26845;0;22.5;7.2;0.0
79;2021-04-21;1440;1431;0;85405;28276;0;22.9;7.6;0.0
79;2021-04-22;1702;1121;0;87107;29397;0;23.4;7.9;0.0
79;2021-04-23;1345;1213;0;88452;30610;0;23.7;8.2;0.0
79;2021-04-24;681;391;0;89133;31001;0;23.9;8.3;0.0
79;2021-04-25;41;1;0;89174;31002;0;23.9;8.3;0.0
79;2021-04-26;1437;1719;0;90611;32721;0;24.3;8.8;0.0
79;2021-04-27;2052;2256;0;92663;34977;0;24.9;9.4;0.0
79;2021-04-28;1505;2732;0;94168;37709;0;25.3;10.1;0.0
79;2021-04-29;2221;2164;0;96389;39873;0;25.9;10.7;0.0
79;2021-04-30;2192;2300;0;98581;42173;0;26.5;11.3;0.0
79;2021-05-01;580;378;0;99161;42551;0;26.6;11.4;0.0
79;2021-05-02;41;22;0;99202;42573;0;26.6;11.4;0.0
79;2021-05-03;1327;1270;0;100529;43843;0;27.0;11.8;0.0
79;2021-05-04;1879;2191;0;102408;46034;0;27.5;12.4;0.0
79;2021-05-05;1765;2286;0;104173;48320;0;28.0;13.0;0.0
79;2021-05-06;2514;2135;0;106687;50455;0;28.6;13.5;0.0
79;2021-05-07;2141;2601;0;108828;53056;0;29.2;14.2;0.0
79;2021-05-08;396;464;0;109224;53520;0;29.3;14.4;0.0
79;2021-05-09;98;16;0;109322;53536;0;29.3;14.4;0.0
79;2021-05-10;1636;1741;0;110958;55277;0;29.8;14.8;0.0
79;2021-05-11;2516;1654;0;113474;56931;0;30.5;15.3;0.0
79;2021-05-12;2099;2579;0;115573;59510;0;31.0;16.0;0.0
79;2021-05-13;839;325;0;116412;59835;0;31.2;16.1;0.0
79;2021-05-14;2203;713;0;118615;60548;0;31.8;16.2;0.0
79;2021-05-15;1419;514;0;120034;61062;0;32.2;16.4;0.0
79;2021-05-16;128;31;0;120162;61093;0;32.2;16.4;0.0
79;2021-05-17;1917;1147;0;122079;62240;0;32.8;16.7;0.0
79;2021-05-18;3067;1317;0;125146;63557;0;33.6;17.1;0.0
79;2021-05-19;2942;984;0;128088;64541;0;34.4;17.3;0.0
79;2021-05-20;3385;1292;0;131473;65833;0;35.3;17.7;0.0
79;2021-05-21;2872;1136;0;134345;66969;0;36.1;18.0;0.0
79;2021-05-22;1304;284;0;135649;67253;0;36.4;18.0;0.0
79;2021-05-23;115;9;0;135764;67262;0;36.4;18.1;0.0
79;2021-05-24;453;30;0;136217;67292;0;36.6;18.1;0.0
79;2021-05-25;3396;1038;0;139613;68330;0;37.5;18.3;0.0
79;2021-05-26;3317;888;0;142930;69218;0;38.4;18.6;0.0
79;2021-05-27;3873;1754;0;146803;70972;0;39.4;19.0;0.0
79;2021-05-28;3319;1882;0;150122;72854;0;40.3;19.6;0.0
79;2021-05-29;1270;502;0;151392;73356;0;40.6;19.7;0.0
79;2021-05-30;55;16;0;151447;73372;0;40.6;19.7;0.0
79;2021-05-31;2423;826;0;153870;74198;0;41.3;19.9;0.0
79;2021-06-01;3229;1638;0;157099;75836;0;42.2;20.4;0.0
79;2021-06-02;3715;1205;0;160814;77041;0;43.2;20.7;0.0
79;2021-06-03;4124;1776;0;164938;78817;0;44.3;21.2;0.0
79;2021-06-04;3752;2061;0;168690;80878;0;45.3;21.7;0.0
79;2021-06-05;2579;834;0;171269;81712;0;46.0;21.9;0.0
79;2021-06-06;666;73;0;171935;81785;0;46.1;21.9;0.0
79;2021-06-07;2539;1544;0;174474;83329;0;46.8;22.4;0.0
79;2021-06-08;2852;2229;0;177326;85558;0;47.6;23.0;0.0
79;2021-06-09;2995;1952;0;180321;87510;0;48.4;23.5;0.0
79;2021-06-10;2979;2038;0;183300;89548;0;49.2;24.0;0.0
79;2021-06-11;3356;2314;0;186656;91862;0;50.1;24.7;0.0
79;2021-06-12;1510;699;0;188166;92561;0;50.5;24.8;0.0
79;2021-06-13;172;116;0;188338;92677;0;50.5;24.9;0.0
79;2021-06-14;1164;1827;0;189502;94504;0;50.9;25.4;0.0
79;2021-06-15;1707;2572;0;191209;97076;0;51.3;26.1;0.0
79;2021-06-16;1931;2287;0;193140;99363;0;51.8;26.7;0.0
79;2021-06-17;2120;2711;0;195260;102074;0;52.4;27.4;0.0
79;2021-06-18;2175;2410;0;197435;104484;0;53.0;28.0;0.0
79;2021-06-19;1086;693;0;198521;105177;0;53.3;28.2;0.0
79;2021-06-20;15;46;0;198536;105223;0;53.3;28.2;0.0
79;2021-06-21;1124;2376;0;199660;107599;0;53.6;28.9;0.0
79;2021-06-22;1452;3050;0;201112;110649;0;54.0;29.7;0.0
79;2021-06-23;1468;2500;0;202580;113149;0;54.4;30.4;0.0
79;2021-06-24;1916;2055;0;204496;115204;0;54.9;30.9;0.0
79;2021-06-25;1300;2881;0;205796;118085;0;55.2;31.7;0.0
79;2021-06-26;801;980;0;206597;119065;0;55.4;32.0;0.0
79;2021-06-27;29;89;0;206626;119154;0;55.5;32.0;0.0
79;2021-06-28;944;2655;0;207570;121809;0;55.7;32.7;0.0
79;2021-06-29;1266;3670;0;208836;125479;0;56.0;33.7;0.0
79;2021-06-30;1125;3398;0;209961;128877;0;56.3;34.6;0.0
79;2021-07-01;1171;3720;0;211132;132597;0;56.7;35.6;0.0
79;2021-07-02;1344;3408;0;212476;136005;0;57.0;36.5;0.0
79;2021-07-03;367;1657;0;212843;137662;0;57.1;36.9;0.0
79;2021-07-04;18;102;0;212861;137764;0;57.1;37.0;0.0
79;2021-07-05;689;2304;0;213550;140068;0;57.3;37.6;0.0
79;2021-07-06;842;3875;0;214392;143943;0;57.5;38.6;0.0
79;2021-07-07;1185;4187;0;215577;148130;0;57.9;39.8;0.0
79;2021-07-08;1071;4118;0;216648;152248;0;58.1;40.9;0.0
79;2021-07-09;887;3681;0;217535;155929;0;58.4;41.8;0.0
79;2021-07-10;569;1425;0;218104;157354;0;58.5;42.2;0.0
79;2021-07-11;21;44;0;218125;157398;0;58.5;42.2;0.0
79;2021-07-12;577;3619;0;218702;161017;0;58.7;43.2;0.0
79;2021-07-13;1018;5079;0;219720;166096;0;59.0;44.6;0.0
79;2021-07-14;195;879;0;219915;166975;0;59.0;44.8;0.0
79;2021-07-15;1210;4603;0;221125;171578;0;59.3;46.0;0.0
79;2021-07-16;1296;3998;0;222421;175576;0;59.7;47.1;0.0
79;2021-07-17;605;2313;0;223026;177889;0;59.9;47.7;0.0
79;2021-07-18;109;492;0;223135;178381;0;59.9;47.9;0.0
79;2021-07-19;827;3186;0;223962;181567;0;60.1;48.7;0.0
79;2021-07-20;1455;3720;0;225417;185287;0;60.5;49.7;0.0
79;2021-07-21;1286;3656;0;226703;188943;0;60.8;50.7;0.0
79;2021-07-22;1661;3711;0;228364;192654;0;61.3;51.7;0.0
79;2021-07-23;1505;4113;0;229869;196767;0;61.7;52.8;0.0
79;2021-07-24;1007;1458;0;230876;198225;0;62.0;53.2;0.0
79;2021-07-25;110;236;0;230986;198461;0;62.0;53.3;0.0
79;2021-07-26;1377;2433;0;232363;200894;0;62.4;53.9;0.0
79;2021-07-27;2487;2795;0;234850;203689;0;63.0;54.7;0.0
79;2021-07-28;2535;2231;0;237385;205920;0;63.7;55.3;0.0
79;2021-07-29;3128;2676;0;240513;208596;0;64.5;56.0;0.0
79;2021-07-30;2276;2690;0;242789;211286;0;65.2;56.7;0.0
79;2021-07-31;1011;1073;0;243800;212359;0;65.4;57.0;0.0
79;2021-08-01;74;28;0;243874;212387;0;65.4;57.0;0.0
79;2021-08-02;1854;1515;0;245728;213902;0;65.9;57.4;0.0
79;2021-08-03;2978;1901;0;248706;215803;0;66.7;57.9;0.0
79;2021-08-04;2897;1510;0;251603;217313;0;67.5;58.3;0.0
79;2021-08-05;3067;2085;0;254670;219398;0;68.3;58.9;0.0
79;2021-08-06;2414;1461;0;257084;220859;0;69.0;59.3;0.0
79;2021-08-07;1013;774;0;258097;221633;0;69.3;59.5;0.0
79;2021-08-08;74;29;0;258171;221662;0;69.3;59.5;0.0
79;2021-08-09;2356;1073;0;260527;222735;0;69.9;59.8;0.0
79;2021-08-10;2937;1489;0;263464;224224;0;70.7;60.2;0.0
79;2021-08-11;2396;1407;0;265860;225631;0;71.3;60.6;0.0
79;2021-08-12;2606;1410;0;268466;227041;0;72.0;60.9;0.0
79;2021-08-13;2593;1141;0;271059;228182;0;72.7;61.2;0.0
79;2021-08-14;590;442;0;271649;228624;0;72.9;61.4;0.0
79;2021-08-15;39;26;0;271688;228650;0;72.9;61.4;0.0
79;2021-08-16;1567;1245;0;273255;229895;0;73.3;61.7;0.0
79;2021-08-17;2071;1763;0;275326;231658;0;73.9;62.2;0.0
79;2021-08-18;1839;1749;0;277165;233407;0;74.4;62.6;0.0
79;2021-08-19;1457;1804;0;278622;235211;0;74.8;63.1;0.0
79;2021-08-20;1387;2118;0;280009;237329;0;75.1;63.7;0.0
79;2021-08-21;317;659;0;280326;237988;0;75.2;63.9;0.0
79;2021-08-22;13;73;0;280339;238061;0;75.2;63.9;0.0
79;2021-08-23;741;2203;0;281080;240264;0;75.4;64.5;0.0
79;2021-08-24;1013;2552;0;282093;242816;0;75.7;65.2;0.0
79;2021-08-25;1006;2594;0;283099;245410;0;76.0;65.9;0.0
79;2021-08-26;984;2409;0;284083;247819;0;76.2;66.5;0.0
79;2021-08-27;635;2153;0;284718;249972;0;76.4;67.1;0.0
79;2021-08-28;295;905;0;285013;250877;0;76.5;67.3;0.0
79;2021-08-29;10;61;0;285023;250938;0;76.5;67.3;0.0
79;2021-08-30;527;2324;22;285550;253262;22;76.6;68.0;0.0
79;2021-08-31;612;2750;28;286162;256012;50;76.8;68.7;0.0
79;2021-09-01;613;2638;77;286775;258650;127;77.0;69.4;0.0
79;2021-09-02;747;2429;108;287522;261079;235;77.2;70.1;0.1
79;2021-09-03;614;2646;113;288136;263725;348;77.3;70.8;0.1
79;2021-09-04;281;735;25;288417;264460;373;77.4;71.0;0.1
79;2021-09-05;13;47;8;288430;264507;381;77.4;71.0;0.1
79;2021-09-06;345;1691;119;288775;266198;500;77.5;71.4;0.1
79;2021-09-07;368;1973;113;289143;268171;613;77.6;72.0;0.2
79;2021-09-08;519;2092;120;289662;270263;733;77.7;72.5;0.2
79;2021-09-09;331;1538;129;289993;271801;862;77.8;72.9;0.2
79;2021-09-10;409;1880;229;290402;273681;1091;77.9;73.4;0.3
79;2021-09-11;148;893;33;290550;274574;1124;78.0;73.7;0.3
79;2021-09-12;3;26;4;290553;274600;1128;78.0;73.7;0.3
79;2021-09-13;332;942;249;290885;275542;1377;78.1;73.9;0.4
79;2021-09-14;352;1078;382;291237;276620;1759;78.2;74.2;0.5
79;2021-09-15;422;1357;367;291659;277977;2126;78.3;74.6;0.6
79;2021-09-16;437;987;325;292096;278964;2451;78.4;74.9;0.7
79;2021-09-17;427;1272;380;292523;280236;2831;78.5;75.2;0.8
79;2021-09-18;149;634;64;292672;280870;2895;78.5;75.4;0.8
79;2021-09-19;1;12;0;292673;280882;2895;78.5;75.4;0.8
79;2021-09-20;186;533;418;292859;281415;3313;78.6;75.5;0.9
79;2021-09-21;319;685;549;293178;282100;3862;78.7;75.7;1.0
79;2021-09-22;216;1011;571;293394;283111;4433;78.7;76.0;1.2
79;2021-09-23;389;572;449;293783;283683;4882;78.8;76.1;1.3
79;2021-09-24;228;1234;312;294011;284917;5194;78.9;76.5;1.4
79;2021-09-25;80;331;48;294091;285248;5242;78.9;76.6;1.4
79;2021-09-26;0;2;4;294091;285250;5246;78.9;76.6;1.4
79;2021-09-27;204;528;234;294295;285778;5480;79.0;76.7;1.5
79;2021-09-28;129;380;393;294424;286158;5873;79.0;76.8;1.6
79;2021-09-29;299;715;455;294723;286873;6328;79.1;77.0;1.7
79;2021-09-30;153;304;352;294876;287177;6680;79.1;77.1;1.8
79;2021-10-01;272;513;531;295148;287690;7211;79.2;77.2;1.9
79;2021-10-02;118;261;99;295266;287951;7310;79.2;77.3;2.0
79;2021-10-03;1;4;0;295267;287955;7310;79.2;77.3;2.0
79;2021-10-04;168;332;286;295435;288287;7596;79.3;77.4;2.0
79;2021-10-05;109;241;404;295544;288528;8000;79.3;77.4;2.1
79;2021-10-06;151;345;559;295695;288873;8559;79.4;77.5;2.3
79;2021-10-07;109;217;478;295804;289090;9037;79.4;77.6;2.4
79;2021-10-08;217;536;350;296021;289626;9387;79.4;77.7;2.5
79;2021-10-09;92;138;57;296113;289764;9444;79.5;77.8;2.5
79;2021-10-10;1;4;8;296114;289768;9452;79.5;77.8;2.5
79;2021-10-11;126;264;512;296240;290032;9964;79.5;77.8;2.7
79;2021-10-12;150;328;461;296390;290360;10425;79.5;77.9;2.8
79;2021-10-13;182;258;515;296572;290618;10940;79.6;78.0;2.9
79;2021-10-14;137;316;533;296709;290934;11473;79.6;78.1;3.1
79;2021-10-15;197;555;645;296906;291489;12118;79.7;78.2;3.3
79;2021-10-16;86;113;109;296992;291602;12227;79.7;78.3;3.3
79;2021-10-17;2;3;2;296994;291605;12229;79.7;78.3;3.3
79;2021-10-18;129;236;519;297123;291841;12748;79.7;78.3;3.4
79;2021-10-19;91;146;458;297214;291987;13206;79.8;78.4;3.5
79;2021-10-20;116;172;637;297330;292159;13843;79.8;78.4;3.7
79;2021-10-21;91;253;346;297421;292412;14189;79.8;78.5;3.8
79;2021-10-22;189;356;701;297610;292768;14890;79.9;78.6;4.0
79;2021-10-23;95;116;183;297705;292884;15073;79.9;78.6;4.0
79;2021-10-24;0;1;0;297705;292885;15073;79.9;78.6;4.0
79;2021-10-25;119;225;665;297824;293110;15738;79.9;78.7;4.2
79;2021-10-26;119;138;786;297943;293248;16524;80.0;78.7;4.4
79;2021-10-27;121;201;753;298064;293449;17277;80.0;78.8;4.6
79;2021-10-28;75;122;745;298139;293571;18022;80.0;78.8;4.8
79;2021-10-29;117;186;933;298256;293757;18955;80.0;78.8;5.1
79;2021-10-30;78;103;284;298334;293860;19239;80.1;78.9;5.2
79;2021-10-31;0;1;2;298334;293861;19241;80.1;78.9;5.2
79;2021-11-01;3;3;0;298337;293864;19241;80.1;78.9;5.2
79;2021-11-02;94;160;938;298431;294024;20179;80.1;78.9;5.4
79;2021-11-03;109;191;917;298540;294215;21096;80.1;79.0;5.7
79;2021-11-04;107;103;1066;298647;294318;22162;80.1;79.0;5.9
79;2021-11-05;180;300;1266;298827;294618;23428;80.2;79.1;6.3
79;2021-11-06;66;121;321;298893;294739;23749;80.2;79.1;6.4
79;2021-11-07;0;4;2;298893;294743;23751;80.2;79.1;6.4
79;2021-11-08;84;164;1228;298977;294907;24979;80.2;79.1;6.7
79;2021-11-09;85;130;1342;299062;295037;26321;80.3;79.2;7.1
79;2021-11-10;133;170;1423;299195;295207;27744;80.3;79.2;7.4
79;2021-11-11;0;2;24;299195;295209;27768;80.3;79.2;7.5
79;2021-11-12;100;208;1339;299295;295417;29107;80.3;79.3;7.8
79;2021-11-13;57;99;378;299352;295516;29485;80.3;79.3;7.9
79;2021-11-14;0;2;3;299352;295518;29488;80.3;79.3;7.9
79;2021-11-15;76;135;1274;299428;295653;30762;80.4;79.3;8.3
79;2021-11-16;69;131;1691;299497;295784;32453;80.4;79.4;8.7
79;2021-11-17;127;146;1435;299624;295930;33888;80.4;79.4;9.1
79;2021-11-18;77;115;1724;299701;296045;35612;80.4;79.4;9.6
79;2021-11-19;151;148;1827;299852;296193;37439;80.5;79.5;10.0
79;2021-11-20;90;79;377;299942;296272;37816;80.5;79.5;10.1
79;2021-11-21;2;2;12;299944;296274;37828;80.5;79.5;10.2
79;2021-11-22;78;46;1361;300022;296320;39189;80.5;79.5;10.5
79;2021-11-23;119;81;1973;300141;296401;41162;80.5;79.5;11.0
79;2021-11-24;152;114;1469;300293;296515;42631;80.6;79.6;11.4
79;2021-11-25;100;107;1731;300393;296622;44362;80.6;79.6;11.9
79;2021-11-26;147;193;2084;300540;296815;46446;80.7;79.7;12.5
79;2021-11-27;70;80;960;300610;296895;47406;80.7;79.7;12.7
79;2021-11-28;2;2;34;300612;296897;47440;80.7;79.7;12.7
79;2021-11-29;95;109;2196;300707;297006;49636;80.7;79.7;13.3
79;2021-11-30;110;77;2367;300817;297083;52003;80.7;79.7;14.0
79;2021-12-01;91;85;2612;300908;297168;54615;80.8;79.7;14.7
79;2021-12-02;74;76;2828;300982;297244;57443;80.8;79.8;15.4
79;2021-12-03;79;138;3200;301061;297382;60643;80.8;79.8;16.3
79;2021-12-04;48;58;1085;301109;297440;61728;80.8;79.8;16.6
79;2021-12-05;9;5;172;301118;297445;61900;80.8;79.8;16.6
79;2021-12-06;77;93;3013;301195;297538;64913;80.8;79.8;17.4
79;2021-12-07;78;108;3951;301273;297646;68864;80.9;79.9;18.5
79;2021-12-08;92;146;4086;301365;297792;72950;80.9;79.9;19.6
79;2021-12-09;98;85;4339;301463;297877;77289;80.9;79.9;20.7
79;2021-12-10;82;148;3930;301545;298025;81219;80.9;80.0;21.8
79;2021-12-11;63;92;1815;301608;298117;83034;80.9;80.0;22.3
79;2021-12-12;3;11;166;301611;298128;83200;80.9;80.0;22.3
79;2021-12-13;87;99;3878;301698;298227;87078;81.0;80.0;23.4
79;2021-12-14;85;128;5027;301783;298355;92105;81.0;80.1;24.7
79;2021-12-15;110;143;4688;301893;298498;96793;81.0;80.1;26.0
79;2021-12-16;107;115;5317;302000;298613;102110;81.0;80.1;27.4
80;2020-12-27;0;0;0;0;0;0;0.0;0.0;0.0
80;2020-12-28;0;0;0;0;0;0;0.0;0.0;0.0
80;2020-12-29;11;0;0;11;0;0;0.0;0.0;0.0
80;2020-12-30;0;0;0;11;0;0;0.0;0.0;0.0
80;2020-12-31;0;0;0;11;0;0;0.0;0.0;0.0
80;2021-01-01;0;0;0;11;0;0;0.0;0.0;0.0
80;2021-01-02;2;0;0;13;0;0;0.0;0.0;0.0
80;2021-01-03;1;0;0;14;0;0;0.0;0.0;0.0
80;2021-01-04;0;0;0;14;0;0;0.0;0.0;0.0
80;2021-01-05;4;0;0;18;0;0;0.0;0.0;0.0
80;2021-01-06;34;0;0;52;0;0;0.0;0.0;0.0
80;2021-01-07;270;2;0;322;2;0;0.1;0.0;0.0
80;2021-01-08;340;2;0;662;4;0;0.1;0.0;0.0
80;2021-01-09;125;1;0;787;5;0;0.1;0.0;0.0
80;2021-01-10;26;0;0;813;5;0;0.1;0.0;0.0
80;2021-01-11;279;1;0;1092;6;0;0.2;0.0;0.0
80;2021-01-12;454;1;0;1546;7;0;0.3;0.0;0.0
80;2021-01-13;535;4;0;2081;11;0;0.4;0.0;0.0
80;2021-01-14;458;3;0;2539;14;0;0.4;0.0;0.0
80;2021-01-15;382;1;0;2921;15;0;0.5;0.0;0.0
80;2021-01-16;112;1;0;3033;16;0;0.5;0.0;0.0
80;2021-01-17;132;1;0;3165;17;0;0.6;0.0;0.0
80;2021-01-18;501;3;0;3666;20;0;0.6;0.0;0.0
80;2021-01-19;989;17;0;4655;37;0;0.8;0.0;0.0
80;2021-01-20;1115;10;0;5770;47;0;1.0;0.0;0.0
80;2021-01-21;1098;10;0;6868;57;0;1.2;0.0;0.0
80;2021-01-22;1178;6;0;8046;63;0;1.4;0.0;0.0
80;2021-01-23;885;16;0;8931;79;0;1.6;0.0;0.0
80;2021-01-24;778;9;0;9709;88;0;1.7;0.0;0.0
80;2021-01-25;1501;18;0;11210;106;0;2.0;0.0;0.0
80;2021-01-26;1448;13;0;12658;119;0;2.2;0.0;0.0
80;2021-01-27;844;29;0;13502;148;0;2.4;0.0;0.0
80;2021-01-28;650;170;0;14152;318;0;2.5;0.1;0.0
80;2021-01-29;652;205;0;14804;523;0;2.6;0.1;0.0
80;2021-01-30;96;79;0;14900;602;0;2.6;0.1;0.0
80;2021-01-31;1;2;0;14901;604;0;2.6;0.1;0.0
80;2021-02-01;58;235;0;14959;839;0;2.6;0.1;0.0
80;2021-02-02;74;442;0;15033;1281;0;2.6;0.2;0.0
80;2021-02-03;73;533;0;15106;1814;0;2.7;0.3;0.0
80;2021-02-04;327;352;0;15433;2166;0;2.7;0.4;0.0
80;2021-02-05;391;221;0;15824;2387;0;2.8;0.4;0.0
80;2021-02-06;174;72;0;15998;2459;0;2.8;0.4;0.0
80;2021-02-07;3;8;0;16001;2467;0;2.8;0.4;0.0
80;2021-02-08;437;286;0;16438;2753;0;2.9;0.5;0.0
80;2021-02-09;704;297;0;17142;3050;0;3.0;0.5;0.0
80;2021-02-10;622;507;0;17764;3557;0;3.1;0.6;0.0
80;2021-02-11;856;428;0;18620;3985;0;3.3;0.7;0.0
80;2021-02-12;934;376;0;19554;4361;0;3.4;0.8;0.0
80;2021-02-13;202;408;0;19756;4769;0;3.5;0.8;0.0
80;2021-02-14;77;547;0;19833;5316;0;3.5;0.9;0.0
80;2021-02-15;566;1042;0;20399;6358;0;3.6;1.1;0.0
80;2021-02-16;642;1080;0;21041;7438;0;3.7;1.3;0.0
80;2021-02-17;460;1174;0;21501;8612;0;3.8;1.5;0.0
80;2021-02-18;565;1140;0;22066;9752;0;3.9;1.7;0.0
80;2021-02-19;520;899;0;22586;10651;0;4.0;1.9;0.0
80;2021-02-20;36;499;0;22622;11150;0;4.0;2.0;0.0
80;2021-02-21;47;45;0;22669;11195;0;4.0;2.0;0.0
80;2021-02-22;182;621;0;22851;11816;0;4.0;2.1;0.0
80;2021-02-23;450;711;0;23301;12527;0;4.1;2.2;0.0
80;2021-02-24;463;696;0;23764;13223;0;4.2;2.3;0.0
80;2021-02-25;803;549;0;24567;13772;0;4.3;2.4;0.0
80;2021-02-26;1077;534;0;25644;14306;0;4.5;2.5;0.0
80;2021-02-27;495;75;0;26139;14381;0;4.6;2.5;0.0
80;2021-02-28;46;26;0;26185;14407;0;4.6;2.5;0.0
80;2021-03-01;743;100;0;26928;14507;0;4.7;2.5;0.0
80;2021-03-02;1040;138;0;27968;14645;0;4.9;2.6;0.0
80;2021-03-03;1035;105;0;29003;14750;0;5.1;2.6;0.0
80;2021-03-04;1407;297;0;30410;15047;0;5.3;2.6;0.0
80;2021-03-05;1887;378;0;32297;15425;0;5.7;2.7;0.0
80;2021-03-06;2890;322;0;35187;15747;0;6.2;2.8;0.0
80;2021-03-07;1794;81;0;36981;15828;0;6.5;2.8;0.0
80;2021-03-08;720;602;0;37701;16430;0;6.6;2.9;0.0
80;2021-03-09;1287;879;0;38988;17309;0;6.8;3.0;0.0
80;2021-03-10;1766;758;0;40754;18067;0;7.2;3.2;0.0
80;2021-03-11;1916;822;0;42670;18889;0;7.5;3.3;0.0
80;2021-03-12;3168;735;0;45838;19624;0;8.0;3.4;0.0
80;2021-03-13;4017;232;0;49855;19856;0;8.8;3.5;0.0
80;2021-03-14;426;18;0;50281;19874;0;8.8;3.5;0.0
80;2021-03-15;1091;272;0;51372;20146;0;9.0;3.5;0.0
80;2021-03-16;904;366;0;52276;20512;0;9.2;3.6;0.0
80;2021-03-17;722;273;0;52998;20785;0;9.3;3.6;0.0
80;2021-03-18;1074;312;0;54072;21097;0;9.5;3.7;0.0
80;2021-03-19;1801;411;0;55873;21508;0;9.8;3.8;0.0
80;2021-03-20;3825;116;0;59698;21624;0;10.5;3.8;0.0
80;2021-03-21;624;35;0;60322;21659;0;10.6;3.8;0.0
80;2021-03-22;1023;317;0;61345;21976;0;10.8;3.9;0.0
80;2021-03-23;1906;431;0;63251;22407;0;11.1;3.9;0.0
80;2021-03-24;1805;477;0;65056;22884;0;11.4;4.0;0.0
80;2021-03-25;2839;469;0;67895;23353;0;11.9;4.1;0.0
80;2021-03-26;3256;444;0;71151;23797;0;12.5;4.2;0.0
80;2021-03-27;2389;227;0;73540;24024;0;12.9;4.2;0.0
80;2021-03-28;737;93;0;74277;24117;0;13.0;4.2;0.0
80;2021-03-29;2026;764;0;76303;24881;0;13.4;4.4;0.0
80;2021-03-30;2054;883;0;78357;25764;0;13.8;4.5;0.0
80;2021-03-31;1638;1014;0;79995;26778;0;14.0;4.7;0.0
80;2021-04-01;2142;1470;0;82137;28248;0;14.4;5.0;0.0
80;2021-04-02;2894;1602;0;85031;29850;0;14.9;5.2;0.0
80;2021-04-03;3094;857;0;88125;30707;0;15.5;5.4;0.0
80;2021-04-04;238;37;0;88363;30744;0;15.5;5.4;0.0
80;2021-04-05;787;201;0;89150;30945;0;15.6;5.4;0.0
80;2021-04-06;1406;991;0;90556;31936;0;15.9;5.6;0.0
80;2021-04-07;1713;1184;0;92269;33120;0;16.2;5.8;0.0
80;2021-04-08;2239;931;0;94508;34051;0;16.6;6.0;0.0
80;2021-04-09;3585;1405;0;98093;35456;0;17.2;6.2;0.0
80;2021-04-10;2690;1893;0;100783;37349;0;17.7;6.6;0.0
80;2021-04-11;280;228;0;101063;37577;0;17.7;6.6;0.0
80;2021-04-12;1942;585;0;103005;38162;0;18.1;6.7;0.0
80;2021-04-13;2484;1045;0;105489;39207;0;18.5;6.9;0.0
80;2021-04-14;2871;1196;0;108360;40403;0;19.0;7.1;0.0
80;2021-04-15;3700;932;0;112060;41335;0;19.7;7.3;0.0
80;2021-04-16;3440;1006;0;115500;42341;0;20.3;7.4;0.0
80;2021-04-17;1759;2357;0;117259;44698;0;20.6;7.8;0.0
80;2021-04-18;401;488;0;117660;45186;0;20.7;7.9;0.0
80;2021-04-19;1042;902;0;118702;46088;0;20.8;8.1;0.0
80;2021-04-20;1708;959;0;120410;47047;0;21.1;8.3;0.0
80;2021-04-21;1741;1049;0;122151;48096;0;21.4;8.4;0.0
80;2021-04-22;2209;1356;0;124360;49452;0;21.8;8.7;0.0
80;2021-04-23;2693;1410;0;127053;50862;0;22.3;8.9;0.0
80;2021-04-24;1495;1336;0;128548;52198;0;22.6;9.2;0.0
80;2021-04-25;275;594;0;128823;52792;0;22.6;9.3;0.0
80;2021-04-26;1455;1500;0;130278;54292;0;22.9;9.5;0.0
80;2021-04-27;2157;1520;0;132435;55812;0;23.2;9.8;0.0
80;2021-04-28;2345;1515;0;134780;57327;0;23.7;10.1;0.0
80;2021-04-29;3350;2058;0;138130;59385;0;24.2;10.4;0.0
80;2021-04-30;3226;2983;0;141356;62368;0;24.8;10.9;0.0
80;2021-05-01;1090;747;0;142446;63115;0;25.0;11.1;0.0
80;2021-05-02;529;129;0;142975;63244;0;25.1;11.1;0.0
80;2021-05-03;2786;1282;0;145761;64526;0;25.6;11.3;0.0
80;2021-05-04;2666;1813;0;148427;66339;0;26.1;11.6;0.0
80;2021-05-05;3463;1999;0;151890;68338;0;26.7;12.0;0.0
80;2021-05-06;3301;2524;0;155191;70862;0;27.2;12.4;0.0
80;2021-05-07;3572;2701;0;158763;73563;0;27.9;12.9;0.0
80;2021-05-08;2979;883;0;161742;74446;0;28.4;13.1;0.0
80;2021-05-09;1647;301;0;163389;74747;0;28.7;13.1;0.0
80;2021-05-10;2039;1964;0;165428;76711;0;29.0;13.5;0.0
80;2021-05-11;3384;1926;0;168812;78637;0;29.6;13.8;0.0
80;2021-05-12;4649;1693;0;173461;80330;0;30.4;14.1;0.0
80;2021-05-13;3933;429;0;177394;80759;0;31.1;14.2;0.0
80;2021-05-14;5200;1458;0;182594;82217;0;32.0;14.4;0.0
80;2021-05-15;5906;1044;0;188500;83261;0;33.1;14.6;0.0
80;2021-05-16;2811;313;0;191311;83574;0;33.6;14.7;0.0
80;2021-05-17;2564;917;0;193875;84491;0;34.0;14.8;0.0
80;2021-05-18;3922;930;0;197797;85421;0;34.7;15.0;0.0
80;2021-05-19;4013;1041;0;201810;86462;0;35.4;15.2;0.0
80;2021-05-20;4664;1259;0;206474;87721;0;36.2;15.4;0.0
80;2021-05-21;4950;1695;0;211424;89416;0;37.1;15.7;0.0
80;2021-05-22;5187;1209;0;216611;90625;0;38.0;15.9;0.0
80;2021-05-23;2015;262;0;218626;90887;0;38.4;16.0;0.0
80;2021-05-24;1788;209;0;220414;91096;0;38.7;16.0;0.0
80;2021-05-25;2806;1238;0;223220;92334;0;39.2;16.2;0.0
80;2021-05-26;4353;1766;0;227573;94100;0;39.9;16.5;0.0
80;2021-05-27;4042;2470;0;231615;96570;0;40.7;16.9;0.0
80;2021-05-28;3887;2991;0;235502;99561;0;41.3;17.5;0.0
80;2021-05-29;3723;1672;0;239225;101233;0;42.0;17.8;0.0
80;2021-05-30;1214;206;0;240439;101439;0;42.2;17.8;0.0
80;2021-05-31;2716;1460;0;243155;102899;0;42.7;18.1;0.0
80;2021-06-01;4048;2501;0;247203;105400;0;43.4;18.5;0.0
80;2021-06-02;3321;2095;0;250524;107495;0;44.0;18.9;0.0
80;2021-06-03;4238;3048;0;254762;110543;0;44.7;19.4;0.0
80;2021-06-04;4634;3162;0;259396;113705;0;45.5;20.0;0.0
80;2021-06-05;3483;2214;0;262879;115919;0;46.1;20.3;0.0
80;2021-06-06;855;227;0;263734;116146;0;46.3;20.4;0.0
80;2021-06-07;1866;2095;0;265600;118241;0;46.6;20.8;0.0
80;2021-06-08;2731;2759;0;268331;121000;0;47.1;21.2;0.0
80;2021-06-09;2916;2822;0;271247;123822;0;47.6;21.7;0.0
80;2021-06-10;3132;3265;0;274379;127087;0;48.2;22.3;0.0
80;2021-06-11;3165;3954;0;277544;131041;0;48.7;23.0;0.0
80;2021-06-12;3028;2429;0;280572;133470;0;49.2;23.4;0.0
80;2021-06-13;546;545;0;281118;134015;0;49.3;23.5;0.0
80;2021-06-14;1396;3022;0;282514;137037;0;49.6;24.1;0.0
80;2021-06-15;2358;3582;0;284872;140619;0;50.0;24.7;0.0
80;2021-06-16;1655;4342;0;286527;144961;0;50.3;25.4;0.0
80;2021-06-17;2451;3813;0;288978;148774;0;50.7;26.1;0.0
80;2021-06-18;2574;4139;0;291552;152913;0;51.2;26.8;0.0
80;2021-06-19;2892;4481;0;294444;157394;0;51.7;27.6;0.0
80;2021-06-20;326;1249;0;294770;158643;0;51.7;27.8;0.0
80;2021-06-21;1073;2820;0;295843;161463;0;51.9;28.3;0.0
80;2021-06-22;1244;4146;0;297087;165609;0;52.1;29.1;0.0
80;2021-06-23;1797;5244;0;298884;170853;0;52.5;30.0;0.0
80;2021-06-24;1788;4779;0;300672;175632;0;52.8;30.8;0.0
80;2021-06-25;1424;6192;0;302096;181824;0;53.0;31.9;0.0
80;2021-06-26;1897;6212;0;303993;188036;0;53.4;33.0;0.0
80;2021-06-27;413;2215;0;304406;190251;0;53.4;33.4;0.0
80;2021-06-28;997;3403;0;305403;193654;0;53.6;34.0;0.0
80;2021-06-29;1865;4706;0;307268;198360;0;53.9;34.8;0.0
80;2021-06-30;1297;4840;0;308565;203200;0;54.2;35.7;0.0
80;2021-07-01;1669;5069;0;310234;208269;0;54.4;36.6;0.0
80;2021-07-02;1899;6101;0;312133;214370;0;54.8;37.6;0.0
80;2021-07-03;1355;5419;0;313488;219789;0;55.0;38.6;0.0
80;2021-07-04;777;1698;0;314265;221487;0;55.2;38.9;0.0
80;2021-07-05;971;3240;0;315236;224727;0;55.3;39.4;0.0
80;2021-07-06;1854;4063;0;317090;228790;0;55.7;40.2;0.0
80;2021-07-07;1557;4599;0;318647;233389;0;55.9;41.0;0.0
80;2021-07-08;2114;4998;0;320761;238387;0;56.3;41.8;0.0
80;2021-07-09;2608;5419;0;323369;243806;0;56.8;42.8;0.0
80;2021-07-10;1634;4147;0;325003;247953;0;57.0;43.5;0.0
80;2021-07-11;448;950;0;325451;248903;0;57.1;43.7;0.0
80;2021-07-12;952;3604;0;326403;252507;0;57.3;44.3;0.0
80;2021-07-13;2165;5192;0;328568;257699;0;57.7;45.2;0.0
80;2021-07-14;2726;1643;0;331294;259342;0;58.1;45.5;0.0
80;2021-07-15;2866;5312;0;334160;264654;0;58.6;46.4;0.0
80;2021-07-16;3864;5771;0;338024;270425;0;59.3;47.5;0.0
80;2021-07-17;3324;4368;0;341348;274793;0;59.9;48.2;0.0
80;2021-07-18;1025;1021;0;342373;275814;0;60.1;48.4;0.0
80;2021-07-19;2272;3186;0;344645;279000;0;60.5;49.0;0.0
80;2021-07-20;3317;4946;0;347962;283946;0;61.1;49.8;0.0
80;2021-07-21;3498;4407;0;351460;288353;0;61.7;50.6;0.0
80;2021-07-22;4166;4566;0;355626;292919;0;62.4;51.4;0.0
80;2021-07-23;4950;4744;0;360576;297663;0;63.3;52.2;0.0
80;2021-07-24;4087;4302;0;364663;301965;0;64.0;53.0;0.0
80;2021-07-25;1227;725;0;365890;302690;0;64.2;53.1;0.0
80;2021-07-26;2684;2450;0;368574;305140;0;64.7;53.6;0.0
80;2021-07-27;4149;3701;0;372723;308841;0;65.4;54.2;0.0
80;2021-07-28;4693;2791;0;377416;311632;0;66.2;54.7;0.0
80;2021-07-29;4796;3250;0;382212;314882;0;67.1;55.3;0.0
80;2021-07-30;4756;3629;0;386968;318511;0;67.9;55.9;0.0
80;2021-07-31;3909;2984;0;390877;321495;0;68.6;56.4;0.0
80;2021-08-01;1320;421;0;392197;321916;0;68.8;56.5;0.0
80;2021-08-02;2100;1879;0;394297;323795;0;69.2;56.8;0.0
80;2021-08-03;3471;2448;0;397768;326243;0;69.8;57.3;0.0
80;2021-08-04;3220;2520;0;400988;328763;0;70.4;57.7;0.0
80;2021-08-05;3060;2615;0;404048;331378;0;70.9;58.2;0.0
80;2021-08-06;3048;2883;0;407096;334261;0;71.4;58.7;0.0
80;2021-08-07;2304;2539;0;409400;336800;0;71.9;59.1;0.0
80;2021-08-08;652;814;0;410052;337614;0;72.0;59.3;0.0
80;2021-08-09;1406;2215;0;411458;339829;0;72.2;59.6;0.0
80;2021-08-10;2251;2883;0;413709;342712;0;72.6;60.1;0.0
80;2021-08-11;1819;2442;0;415528;345154;0;72.9;60.6;0.0
80;2021-08-12;2092;2684;0;417620;347838;0;73.3;61.0;0.0
80;2021-08-13;1804;3000;0;419424;350838;0;73.6;61.6;0.0
80;2021-08-14;1283;1992;0;420707;352830;0;73.8;61.9;0.0
80;2021-08-15;378;669;0;421085;353499;0;73.9;62.0;0.0
80;2021-08-16;975;2647;0;422060;356146;0;74.1;62.5;0.0
80;2021-08-17;1613;3499;0;423673;359645;0;74.4;63.1;0.0
80;2021-08-18;1148;3631;0;424821;363276;0;74.6;63.8;0.0
80;2021-08-19;1425;3830;0;426246;367106;0;74.8;64.4;0.0
80;2021-08-20;1212;4312;0;427458;371418;0;75.0;65.2;0.0
80;2021-08-21;983;2751;0;428441;374169;0;75.2;65.7;0.0
80;2021-08-22;134;797;0;428575;374966;0;75.2;65.8;0.0
80;2021-08-23;616;3188;0;429191;378154;0;75.3;66.4;0.0
80;2021-08-24;1058;4314;0;430249;382468;0;75.5;67.1;0.0
80;2021-08-25;914;3533;0;431163;386001;0;75.7;67.7;0.0
80;2021-08-26;952;3799;0;432115;389800;0;75.8;68.4;0.0
80;2021-08-27;1030;4340;0;433145;394140;0;76.0;69.2;0.0
80;2021-08-28;656;3222;0;433801;397362;0;76.1;69.7;0.0
80;2021-08-29;193;665;0;433994;398027;0;76.2;69.9;0.0
80;2021-08-30;526;2401;32;434520;400428;32;76.3;70.3;0.0
80;2021-08-31;734;3092;88;435254;403520;120;76.4;70.8;0.0
80;2021-09-01;688;2230;182;435942;405750;302;76.5;71.2;0.1
80;2021-09-02;572;2046;208;436514;407796;510;76.6;71.6;0.1
80;2021-09-03;761;2709;324;437275;410505;834;76.7;72.0;0.1
80;2021-09-04;912;2476;170;438187;412981;1004;76.9;72.5;0.2
80;2021-09-05;163;408;38;438350;413389;1042;76.9;72.6;0.2
80;2021-09-06;410;1363;285;438760;414752;1327;77.0;72.8;0.2
80;2021-09-07;499;1568;273;439259;416320;1600;77.1;73.1;0.3
80;2021-09-08;464;1480;367;439723;417800;1967;77.2;73.3;0.3
80;2021-09-09;522;1395;266;440245;419195;2233;77.3;73.6;0.4
80;2021-09-10;645;1693;393;440890;420888;2626;77.4;73.9;0.5
80;2021-09-11;486;1758;167;441376;422646;2793;77.5;74.2;0.5
80;2021-09-12;73;291;23;441449;422937;2816;77.5;74.2;0.5
80;2021-09-13;324;806;418;441773;423743;3234;77.5;74.4;0.6
80;2021-09-14;600;981;582;442373;424724;3816;77.6;74.5;0.7
80;2021-09-15;379;995;539;442752;425719;4355;77.7;74.7;0.8
80;2021-09-16;483;979;435;443235;426698;4790;77.8;74.9;0.8
80;2021-09-17;521;1196;642;443756;427894;5432;77.9;75.1;1.0
80;2021-09-18;327;1146;265;444083;429040;5697;77.9;75.3;1.0
80;2021-09-19;14;156;19;444097;429196;5716;77.9;75.3;1.0
80;2021-09-20;315;457;343;444412;429653;6059;78.0;75.4;1.1
80;2021-09-21;273;568;546;444685;430221;6605;78.0;75.5;1.2
80;2021-09-22;272;701;579;444957;430922;7184;78.1;75.6;1.3
80;2021-09-23;306;528;609;445263;431450;7793;78.1;75.7;1.4
80;2021-09-24;384;915;713;445647;432365;8506;78.2;75.9;1.5
80;2021-09-25;286;1053;350;445933;433418;8856;78.3;76.1;1.6
80;2021-09-26;12;99;10;445945;433517;8866;78.3;76.1;1.6
80;2021-09-27;178;545;412;446123;434062;9278;78.3;76.2;1.6
80;2021-09-28;156;399;471;446279;434461;9749;78.3;76.3;1.7
80;2021-09-29;283;545;458;446562;435006;10207;78.4;76.3;1.8
80;2021-09-30;197;344;493;446759;435350;10700;78.4;76.4;1.9
80;2021-10-01;334;732;850;447093;436082;11550;78.5;76.5;2.0
80;2021-10-02;320;806;317;447413;436888;11867;78.5;76.7;2.1
80;2021-10-03;17;63;30;447430;436951;11897;78.5;76.7;2.1
80;2021-10-04;157;336;487;447587;437287;12384;78.6;76.7;2.2
80;2021-10-05;160;443;536;447747;437730;12920;78.6;76.8;2.3
80;2021-10-06;272;446;562;448019;438176;13482;78.6;76.9;2.4
80;2021-10-07;197;448;509;448216;438624;13991;78.7;77.0;2.5
80;2021-10-08;279;717;886;448495;439341;14877;78.7;77.1;2.6
80;2021-10-09;269;458;456;448764;439799;15333;78.8;77.2;2.7
80;2021-10-10;22;17;38;448786;439816;15371;78.8;77.2;2.7
80;2021-10-11;156;221;671;448942;440037;16042;78.8;77.2;2.8
80;2021-10-12;178;390;746;449120;440427;16788;78.8;77.3;2.9
80;2021-10-13;197;278;745;449317;440705;17533;78.9;77.3;3.1
80;2021-10-14;212;320;629;449529;441025;18162;78.9;77.4;3.2
80;2021-10-15;317;528;1196;449846;441553;19358;79.0;77.5;3.4
80;2021-10-16;225;369;556;450071;441922;19914;79.0;77.6;3.5
80;2021-10-17;19;17;41;450090;441939;19955;79.0;77.6;3.5
80;2021-10-18;165;309;688;450255;442248;20643;79.0;77.6;3.6
80;2021-10-19;108;168;608;450363;442416;21251;79.0;77.6;3.7
80;2021-10-20;186;266;737;450549;442682;21988;79.1;77.7;3.9
80;2021-10-21;177;282;874;450726;442964;22862;79.1;77.7;4.0
80;2021-10-22;270;385;1278;450996;443349;24140;79.2;77.8;4.2
80;2021-10-23;204;300;688;451200;443649;24828;79.2;77.9;4.4
80;2021-10-24;16;27;28;451216;443676;24856;79.2;77.9;4.4
80;2021-10-25;122;165;809;451338;443841;25665;79.2;77.9;4.5
80;2021-10-26;118;149;866;451456;443990;26531;79.2;77.9;4.7
80;2021-10-27;160;234;889;451616;444224;27420;79.3;78.0;4.8
80;2021-10-28;168;203;765;451784;444427;28185;79.3;78.0;4.9
80;2021-10-29;224;295;1312;452008;444722;29497;79.3;78.1;5.2
80;2021-10-30;159;240;769;452167;444962;30266;79.4;78.1;5.3
80;2021-10-31;12;21;28;452179;444983;30294;79.4;78.1;5.3
80;2021-11-01;6;13;11;452185;444996;30305;79.4;78.1;5.3
80;2021-11-02;180;206;945;452365;445202;31250;79.4;78.1;5.5
80;2021-11-03;87;217;866;452452;445419;32116;79.4;78.2;5.6
80;2021-11-04;134;206;761;452586;445625;32877;79.4;78.2;5.8
80;2021-11-05;252;349;1404;452838;445974;34281;79.5;78.3;6.0
80;2021-11-06;194;270;1017;453032;446244;35298;79.5;78.3;6.2
80;2021-11-07;9;28;54;453041;446272;35352;79.5;78.3;6.2
80;2021-11-08;98;137;871;453139;446409;36223;79.5;78.3;6.4
80;2021-11-09;120;178;1447;453259;446587;37670;79.6;78.4;6.6
80;2021-11-10;155;173;1354;453414;446760;39024;79.6;78.4;6.8
80;2021-11-11;8;9;95;453422;446769;39119;79.6;78.4;6.9
80;2021-11-12;231;320;1641;453653;447089;40760;79.6;78.5;7.2
80;2021-11-13;133;221;1043;453786;447310;41803;79.6;78.5;7.3
80;2021-11-14;22;15;81;453808;447325;41884;79.6;78.5;7.4
80;2021-11-15;95;127;853;453903;447452;42737;79.7;78.5;7.5
80;2021-11-16;144;154;1675;454047;447606;44412;79.7;78.6;7.8
80;2021-11-17;148;181;1286;454195;447787;45698;79.7;78.6;8.0
80;2021-11-18;144;188;1610;454339;447975;47308;79.7;78.6;8.3
80;2021-11-19;279;349;2365;454618;448324;49673;79.8;78.7;8.7
80;2021-11-20;245;263;1440;454863;448587;51113;79.8;78.7;9.0
80;2021-11-21;19;24;92;454882;448611;51205;79.8;78.7;9.0
80;2021-11-22;122;88;1191;455004;448699;52396;79.9;78.8;9.2
80;2021-11-23;145;129;1826;455149;448828;54222;79.9;78.8;9.5
80;2021-11-24;179;138;1669;455328;448966;55891;79.9;78.8;9.8
80;2021-11-25;163;177;2044;455491;449143;57935;79.9;78.8;10.2
80;2021-11-26;243;277;3921;455734;449420;61856;80.0;78.9;10.9
80;2021-11-27;180;238;4349;455914;449658;66205;80.0;78.9;11.6
80;2021-11-28;17;25;1190;455931;449683;67395;80.0;78.9;11.8
80;2021-11-29;97;117;3148;456028;449800;70543;80.0;78.9;12.4
80;2021-11-30;133;150;4976;456161;449950;75519;80.1;79.0;13.3
80;2021-12-01;120;180;4518;456281;450130;80037;80.1;79.0;14.0
80;2021-12-02;162;97;5892;456443;450227;85929;80.1;79.0;15.1
80;2021-12-03;188;232;7104;456631;450459;93033;80.1;79.1;16.3
80;2021-12-04;160;155;6467;456791;450614;99500;80.2;79.1;17.5
80;2021-12-05;39;44;1572;456830;450658;101072;80.2;79.1;17.7
80;2021-12-06;105;138;4286;456935;450796;105358;80.2;79.1;18.5
80;2021-12-07;113;139;6557;457048;450935;111915;80.2;79.1;19.6
80;2021-12-08;139;185;6296;457187;451120;118211;80.2;79.2;20.7
80;2021-12-09;137;135;7006;457324;451255;125217;80.3;79.2;22.0
80;2021-12-10;156;249;8779;457480;451504;133996;80.3;79.2;23.5
80;2021-12-11;159;203;6634;457639;451707;140630;80.3;79.3;24.7
80;2021-12-12;42;33;2319;457681;451740;142949;80.3;79.3;25.1
80;2021-12-13;83;112;5059;457764;451852;148008;80.3;79.3;26.0
80;2021-12-14;170;183;7410;457934;452035;155418;80.4;79.3;27.3
80;2021-12-15;162;175;7146;458096;452210;162564;80.4;79.4;28.5
80;2021-12-16;160;183;7873;458256;452393;170437;80.4;79.4;29.9
81;2020-12-27;0;0;0;0;0;0;0.0;0.0;0.0
81;2020-12-28;0;0;0;0;0;0;0.0;0.0;0.0
81;2020-12-29;0;0;0;0;0;0;0.0;0.0;0.0
81;2020-12-30;0;0;0;0;0;0;0.0;0.0;0.0
81;2020-12-31;1;1;0;1;1;0;0.0;0.0;0.0
81;2021-01-01;0;0;0;1;1;0;0.0;0.0;0.0
81;2021-01-02;0;0;0;1;1;0;0.0;0.0;0.0
81;2021-01-03;0;0;0;1;1;0;0.0;0.0;0.0
81;2021-01-04;1;0;0;2;1;0;0.0;0.0;0.0
81;2021-01-05;2;0;0;4;1;0;0.0;0.0;0.0
81;2021-01-06;7;0;0;11;1;0;0.0;0.0;0.0
81;2021-01-07;269;0;0;280;1;0;0.1;0.0;0.0
81;2021-01-08;311;1;0;591;2;0;0.2;0.0;0.0
81;2021-01-09;71;1;0;662;3;0;0.2;0.0;0.0
81;2021-01-10;4;0;0;666;3;0;0.2;0.0;0.0
81;2021-01-11;146;0;0;812;3;0;0.2;0.0;0.0
81;2021-01-12;250;0;0;1062;3;0;0.3;0.0;0.0
81;2021-01-13;268;1;0;1330;4;0;0.3;0.0;0.0
81;2021-01-14;970;7;0;2300;11;0;0.6;0.0;0.0
81;2021-01-15;572;4;0;2872;15;0;0.7;0.0;0.0
81;2021-01-16;79;2;0;2951;17;0;0.8;0.0;0.0
81;2021-01-17;3;0;0;2954;17;0;0.8;0.0;0.0
81;2021-01-18;566;2;0;3520;19;0;0.9;0.0;0.0
81;2021-01-19;708;5;0;4228;24;0;1.1;0.0;0.0
81;2021-01-20;813;3;0;5041;27;0;1.3;0.0;0.0
81;2021-01-21;1205;13;0;6246;40;0;1.6;0.0;0.0
81;2021-01-22;851;3;0;7097;43;0;1.8;0.0;0.0
81;2021-01-23;227;2;0;7324;45;0;1.9;0.0;0.0
81;2021-01-24;100;0;0;7424;45;0;1.9;0.0;0.0
81;2021-01-25;563;6;0;7987;51;0;2.1;0.0;0.0
81;2021-01-26;635;7;0;8622;58;0;2.2;0.0;0.0
81;2021-01-27;581;3;0;9203;61;0;2.4;0.0;0.0
81;2021-01-28;659;226;0;9862;287;0;2.5;0.1;0.0
81;2021-01-29;317;187;0;10179;474;0;2.6;0.1;0.0
81;2021-01-30;197;38;0;10376;512;0;2.7;0.1;0.0
81;2021-01-31;98;1;0;10474;513;0;2.7;0.1;0.0
81;2021-02-01;296;171;0;10770;684;0;2.8;0.2;0.0
81;2021-02-02;441;182;0;11211;866;0;2.9;0.2;0.0
81;2021-02-03;477;288;0;11688;1154;0;3.0;0.3;0.0
81;2021-02-04;1374;700;0;13062;1854;0;3.4;0.5;0.0
81;2021-02-05;822;325;0;13884;2179;0;3.6;0.6;0.0
81;2021-02-06;242;19;0;14126;2198;0;3.6;0.6;0.0
81;2021-02-07;97;1;0;14223;2199;0;3.7;0.6;0.0
81;2021-02-08;272;226;0;14495;2425;0;3.7;0.6;0.0
81;2021-02-09;430;273;0;14925;2698;0;3.8;0.7;0.0
81;2021-02-10;376;338;0;15301;3036;0;3.9;0.8;0.0
81;2021-02-11;657;481;0;15958;3517;0;4.1;0.9;0.0
81;2021-02-12;543;526;0;16501;4043;0;4.3;1.0;0.0
81;2021-02-13;196;163;0;16697;4206;0;4.3;1.1;0.0
81;2021-02-14;93;1;0;16790;4207;0;4.3;1.1;0.0
81;2021-02-15;236;453;0;17026;4660;0;4.4;1.2;0.0
81;2021-02-16;290;636;0;17316;5296;0;4.5;1.4;0.0
81;2021-02-17;248;546;0;17564;5842;0;4.5;1.5;0.0
81;2021-02-18;488;700;0;18052;6542;0;4.7;1.7;0.0
81;2021-02-19;570;432;0;18622;6974;0;4.8;1.8;0.0
81;2021-02-20;317;279;0;18939;7253;0;4.9;1.9;0.0
81;2021-02-21;22;81;0;18961;7334;0;4.9;1.9;0.0
81;2021-02-22;232;538;0;19193;7872;0;4.9;2.0;0.0
81;2021-02-23;185;593;0;19378;8465;0;5.0;2.2;0.0
81;2021-02-24;298;667;0;19676;9132;0;5.1;2.4;0.0
81;2021-02-25;715;1018;0;20391;10150;0;5.3;2.6;0.0
81;2021-02-26;942;927;0;21333;11077;0;5.5;2.9;0.0
81;2021-02-27;283;234;0;21616;11311;0;5.6;2.9;0.0
81;2021-02-28;18;85;0;21634;11396;0;5.6;2.9;0.0
81;2021-03-01;233;416;0;21867;11812;0;5.6;3.0;0.0
81;2021-03-02;388;506;0;22255;12318;0;5.7;3.2;0.0
81;2021-03-03;485;444;0;22740;12762;0;5.9;3.3;0.0
81;2021-03-04;1118;458;0;23858;13220;0;6.2;3.4;0.0
81;2021-03-05;1403;409;0;25261;13629;0;6.5;3.5;0.0
81;2021-03-06;1010;164;0;26271;13793;0;6.8;3.6;0.0
81;2021-03-07;189;92;0;26460;13885;0;6.8;3.6;0.0
81;2021-03-08;484;359;0;26944;14244;0;6.9;3.7;0.0
81;2021-03-09;827;362;0;27771;14606;0;7.2;3.8;0.0
81;2021-03-10;926;398;0;28697;15004;0;7.4;3.9;0.0
81;2021-03-11;1380;371;0;30077;15375;0;7.8;4.0;0.0
81;2021-03-12;1725;322;0;31802;15697;0;8.2;4.0;0.0
81;2021-03-13;1062;199;0;32864;15896;0;8.5;4.1;0.0
81;2021-03-14;67;78;0;32931;15974;0;8.5;4.1;0.0
81;2021-03-15;1077;239;0;34008;16213;0;8.8;4.2;0.0
81;2021-03-16;737;250;0;34745;16463;0;9.0;4.2;0.0
81;2021-03-17;851;282;0;35596;16745;0;9.2;4.3;0.0
81;2021-03-18;967;571;0;36563;17316;0;9.4;4.5;0.0
81;2021-03-19;1294;472;0;37857;17788;0;9.8;4.6;0.0
81;2021-03-20;698;285;0;38555;18073;0;9.9;4.7;0.0
81;2021-03-21;142;22;0;38697;18095;0;10.0;4.7;0.0
81;2021-03-22;949;285;0;39646;18380;0;10.2;4.7;0.0
81;2021-03-23;1461;231;0;41107;18611;0;10.6;4.8;0.0
81;2021-03-24;1675;297;0;42782;18908;0;11.0;4.9;0.0
81;2021-03-25;2124;362;0;44906;19270;0;11.6;5.0;0.0
81;2021-03-26;2155;301;0;47061;19571;0;12.1;5.0;0.0
81;2021-03-27;1145;42;0;48206;19613;0;12.4;5.1;0.0
81;2021-03-28;716;41;0;48922;19654;0;12.6;5.1;0.0
81;2021-03-29;2792;185;0;51714;19839;0;13.3;5.1;0.0
81;2021-03-30;3088;240;0;54802;20079;0;14.1;5.2;0.0
81;2021-03-31;2694;282;0;57496;20361;0;14.8;5.2;0.0
81;2021-04-01;3324;569;0;60820;20930;0;15.7;5.4;0.0
81;2021-04-02;2657;401;0;63477;21331;0;16.4;5.5;0.0
81;2021-04-03;1149;305;0;64626;21636;0;16.7;5.6;0.0
81;2021-04-04;1333;26;0;65959;21662;0;17.0;5.6;0.0
81;2021-04-05;711;20;0;66670;21682;0;17.2;5.6;0.0
81;2021-04-06;1649;526;0;68319;22208;0;17.6;5.7;0.0
81;2021-04-07;1860;566;0;70179;22774;0;18.1;5.9;0.0
81;2021-04-08;2658;822;0;72837;23596;0;18.8;6.1;0.0
81;2021-04-09;3040;480;0;75877;24076;0;19.6;6.2;0.0
81;2021-04-10;1472;504;0;77349;24580;0;19.9;6.3;0.0
81;2021-04-11;1236;71;0;78585;24651;0;20.3;6.4;0.0
81;2021-04-12;1305;676;0;79890;25327;0;20.6;6.5;0.0
81;2021-04-13;2527;810;0;82417;26137;0;21.2;6.7;0.0
81;2021-04-14;2469;840;0;84886;26977;0;21.9;7.0;0.0
81;2021-04-15;3127;1236;0;88013;28213;0;22.7;7.3;0.0
81;2021-04-16;2735;1100;0;90748;29313;0;23.4;7.6;0.0
81;2021-04-17;1252;338;0;92000;29651;0;23.7;7.6;0.0
81;2021-04-18;497;139;0;92497;29790;0;23.8;7.7;0.0
81;2021-04-19;929;824;0;93426;30614;0;24.1;7.9;0.0
81;2021-04-20;2247;1200;0;95673;31814;0;24.7;8.2;0.0
81;2021-04-21;2155;1065;0;97828;32879;0;25.2;8.5;0.0
81;2021-04-22;2762;1134;0;100590;34013;0;25.9;8.8;0.0
81;2021-04-23;2752;1024;0;103342;35037;0;26.6;9.0;0.0
81;2021-04-24;1258;771;0;104600;35808;0;27.0;9.2;0.0
81;2021-04-25;433;689;0;105033;36497;0;27.1;9.4;0.0
81;2021-04-26;1062;2330;0;106095;38827;0;27.4;10.0;0.0
81;2021-04-27;1516;2340;0;107611;41167;0;27.7;10.6;0.0
81;2021-04-28;1383;2398;0;108994;43565;0;28.1;11.2;0.0
81;2021-04-29;1747;2748;0;110741;46313;0;28.5;11.9;0.0
81;2021-04-30;1931;2322;0;112672;48635;0;29.0;12.5;0.0
81;2021-05-01;378;657;0;113050;49292;0;29.1;12.7;0.0
81;2021-05-02;302;1309;0;113352;50601;0;29.2;13.0;0.0
81;2021-05-03;1102;1205;0;114454;51806;0;29.5;13.4;0.0
81;2021-05-04;2442;1895;0;116896;53701;0;30.1;13.8;0.0
81;2021-05-05;1961;1944;0;118857;55645;0;30.6;14.3;0.0
81;2021-05-06;2658;3423;0;121515;59068;0;31.3;15.2;0.0
81;2021-05-07;1998;2967;0;123513;62035;0;31.8;16.0;0.0
81;2021-05-08;875;944;0;124388;62979;0;32.1;16.2;0.0
81;2021-05-09;572;1278;0;124960;64257;0;32.2;16.6;0.0
81;2021-05-10;838;1624;0;125798;65881;0;32.4;17.0;0.0
81;2021-05-11;1562;2538;0;127360;68419;0;32.8;17.6;0.0
81;2021-05-12;1520;2439;0;128880;70858;0;33.2;18.3;0.0
81;2021-05-13;1167;567;0;130047;71425;0;33.5;18.4;0.0
81;2021-05-14;1801;1660;0;131848;73085;0;34.0;18.8;0.0
81;2021-05-15;1397;596;0;133245;73681;0;34.4;19.0;0.0
81;2021-05-16;1159;384;0;134404;74065;0;34.6;19.1;0.0
81;2021-05-17;1067;884;0;135471;74949;0;34.9;19.3;0.0
81;2021-05-18;1617;1446;0;137088;76395;0;35.3;19.7;0.0
81;2021-05-19;2481;1229;0;139569;77624;0;36.0;20.0;0.0
81;2021-05-20;2768;1348;0;142337;78972;0;36.7;20.4;0.0
81;2021-05-21;2510;1150;0;144847;80122;0;37.3;20.7;0.0
81;2021-05-22;2323;506;0;147170;80628;0;37.9;20.8;0.0
81;2021-05-23;995;72;0;148165;80700;0;38.2;20.8;0.0
81;2021-05-24;678;89;0;148843;80789;0;38.4;20.8;0.0
81;2021-05-25;2223;1071;0;151066;81860;0;38.9;21.1;0.0
81;2021-05-26;1661;850;0;152727;82710;0;39.4;21.3;0.0
81;2021-05-27;2276;1581;0;155003;84291;0;40.0;21.7;0.0
81;2021-05-28;2264;1701;0;157267;85992;0;40.5;22.2;0.0
81;2021-05-29;1211;551;0;158478;86543;0;40.9;22.3;0.0
81;2021-05-30;756;199;0;159234;86742;0;41.1;22.4;0.0
81;2021-05-31;1055;1338;0;160289;88080;0;41.3;22.7;0.0
81;2021-06-01;1699;2611;0;161988;90691;0;41.8;23.4;0.0
81;2021-06-02;1866;2360;0;163854;93051;0;42.2;24.0;0.0
81;2021-06-03;1882;2507;0;165736;95558;0;42.7;24.6;0.0
81;2021-06-04;1922;2855;0;167658;98413;0;43.2;25.4;0.0
81;2021-06-05;1466;1224;0;169124;99637;0;43.6;25.7;0.0
81;2021-06-06;461;356;0;169585;99993;0;43.7;25.8;0.0
81;2021-06-07;1193;1510;0;170778;101503;0;44.0;26.2;0.0
81;2021-06-08;2281;2290;0;173059;103793;0;44.6;26.8;0.0
81;2021-06-09;2346;1781;0;175405;105574;0;45.2;27.2;0.0
81;2021-06-10;1315;1521;0;176720;107095;0;45.6;27.6;0.0
81;2021-06-11;2519;2127;0;179239;109222;0;46.2;28.2;0.0
81;2021-06-12;1578;1009;0;180817;110231;0;46.6;28.4;0.0
81;2021-06-13;514;493;0;181331;110724;0;46.7;28.5;0.0
81;2021-06-14;842;1416;0;182173;112140;0;47.0;28.9;0.0
81;2021-06-15;1655;3357;0;183828;115497;0;47.4;29.8;0.0
81;2021-06-16;1304;2846;0;185132;118343;0;47.7;30.5;0.0
81;2021-06-17;1359;2476;0;186491;120819;0;48.1;31.1;0.0
81;2021-06-18;1862;2632;0;188353;123451;0;48.6;31.8;0.0
81;2021-06-19;883;969;0;189236;124420;0;48.8;32.1;0.0
81;2021-06-20;446;475;0;189682;124895;0;48.9;32.2;0.0
81;2021-06-21;471;1086;0;190153;125981;0;49.0;32.5;0.0
81;2021-06-22;1099;2387;0;191252;128368;0;49.3;33.1;0.0
81;2021-06-23;1143;2059;0;192395;130427;0;49.6;33.6;0.0
81;2021-06-24;1142;1844;0;193537;132271;0;49.9;34.1;0.0
81;2021-06-25;1202;2674;0;194739;134945;0;50.2;34.8;0.0
81;2021-06-26;739;1564;0;195478;136509;0;50.4;35.2;0.0
81;2021-06-27;542;1403;0;196020;137912;0;50.5;35.6;0.0
81;2021-06-28;508;1476;0;196528;139388;0;50.7;35.9;0.0
81;2021-06-29;1056;2495;0;197584;141883;0;50.9;36.6;0.0
81;2021-06-30;1021;2958;0;198605;144841;0;51.2;37.3;0.0
81;2021-07-01;914;2503;0;199519;147344;0;51.4;38.0;0.0
81;2021-07-02;1039;2804;0;200558;150148;0;51.7;38.7;0.0
81;2021-07-03;730;2407;0;201288;152555;0;51.9;39.3;0.0
81;2021-07-04;297;912;0;201585;153467;0;52.0;39.6;0.0
81;2021-07-05;751;1534;0;202336;155001;0;52.2;40.0;0.0
81;2021-07-06;994;2985;0;203330;157986;0;52.4;40.7;0.0
81;2021-07-07;1053;2289;0;204383;160275;0;52.7;41.3;0.0
81;2021-07-08;1016;2153;1;205399;162428;1;53.0;41.9;0.0
81;2021-07-09;1175;2599;0;206574;165027;1;53.3;42.5;0.0
81;2021-07-10;788;1422;0;207362;166449;1;53.5;42.9;0.0
81;2021-07-11;449;921;0;207811;167370;1;53.6;43.1;0.0
81;2021-07-12;782;1649;0;208593;169019;1;53.8;43.6;0.0
81;2021-07-13;2005;2953;0;210598;171972;1;54.3;44.3;0.0
81;2021-07-14;1454;1439;0;212052;173411;1;54.7;44.7;0.0
81;2021-07-15;2454;2717;0;214506;176128;1;55.3;45.4;0.0
81;2021-07-16;2098;2933;0;216604;179061;1;55.8;46.2;0.0
81;2021-07-17;1313;2316;0;217917;181377;1;56.2;46.8;0.0
81;2021-07-18;730;1147;0;218647;182524;1;56.4;47.1;0.0
81;2021-07-19;1171;1755;0;219818;184279;1;56.7;47.5;0.0
81;2021-07-20;2753;2686;0;222571;186965;1;57.4;48.2;0.0
81;2021-07-21;3204;2272;0;225775;189237;1;58.2;48.8;0.0
81;2021-07-22;3210;2047;0;228985;191284;1;59.0;49.3;0.0
81;2021-07-23;2923;3132;0;231908;194416;1;59.8;50.1;0.0
81;2021-07-24;2439;1692;0;234347;196108;1;60.4;50.6;0.0
81;2021-07-25;1555;738;0;235902;196846;1;60.8;50.7;0.0
81;2021-07-26;1871;1544;0;237773;198390;1;61.3;51.1;0.0
81;2021-07-27;3234;2381;0;241007;200771;1;62.1;51.8;0.0
81;2021-07-28;2877;2097;0;243884;202868;1;62.9;52.3;0.0
81;2021-07-29;3134;1755;0;247018;204623;1;63.7;52.8;0.0
81;2021-07-30;2671;2214;0;249689;206837;1;64.4;53.3;0.0
81;2021-07-31;1824;1012;0;251513;207849;1;64.8;53.6;0.0
81;2021-08-01;811;640;0;252324;208489;1;65.0;53.7;0.0
81;2021-08-02;1155;1044;0;253479;209533;1;65.3;54.0;0.0
81;2021-08-03;2216;2017;0;255695;211550;1;65.9;54.5;0.0
81;2021-08-04;1962;1502;0;257657;213052;1;66.4;54.9;0.0
81;2021-08-05;1482;1815;0;259139;214867;1;66.8;55.4;0.0
81;2021-08-06;1650;1981;0;260789;216848;1;67.2;55.9;0.0
81;2021-08-07;959;1086;0;261748;217934;1;67.5;56.2;0.0
81;2021-08-08;428;752;0;262176;218686;1;67.6;56.4;0.0
81;2021-08-09;814;795;0;262990;219481;1;67.8;56.6;0.0
81;2021-08-10;1535;2544;0;264525;222025;1;68.2;57.2;0.0
81;2021-08-11;1110;2345;0;265635;224370;1;68.5;57.8;0.0
81;2021-08-12;1068;2154;0;266703;226524;1;68.8;58.4;0.0
81;2021-08-13;906;2346;0;267609;228870;1;69.0;59.0;0.0
81;2021-08-14;519;1753;0;268128;230623;1;69.1;59.5;0.0
81;2021-08-15;185;1045;0;268313;231668;1;69.2;59.7;0.0
81;2021-08-16;683;1727;0;268996;233395;1;69.3;60.2;0.0
81;2021-08-17;1283;2915;0;270279;236310;1;69.7;60.9;0.0
81;2021-08-18;1020;2296;0;271299;238606;1;69.9;61.5;0.0
81;2021-08-19;924;2182;0;272223;240788;1;70.2;62.1;0.0
81;2021-08-20;913;2254;0;273136;243042;1;70.4;62.7;0.0
81;2021-08-21;489;1575;0;273625;244617;1;70.5;63.1;0.0
81;2021-08-22;215;956;0;273840;245573;1;70.6;63.3;0.0
81;2021-08-23;501;1330;0;274341;246903;1;70.7;63.7;0.0
81;2021-08-24;793;2463;0;275134;249366;1;70.9;64.3;0.0
81;2021-08-25;717;2057;0;275851;251423;1;71.1;64.8;0.0
81;2021-08-26;869;2041;0;276720;253464;1;71.3;65.3;0.0
81;2021-08-27;828;2114;0;277548;255578;1;71.6;65.9;0.0
81;2021-08-28;469;1422;0;278017;257000;1;71.7;66.3;0.0
81;2021-08-29;177;845;0;278194;257845;1;71.7;66.5;0.0
81;2021-08-30;427;1128;26;278621;258973;27;71.8;66.8;0.0
81;2021-08-31;787;1955;91;279408;260928;118;72.0;67.3;0.0
81;2021-09-01;694;1225;171;280102;262153;289;72.2;67.6;0.1
81;2021-09-02;577;1006;207;280679;263159;496;72.4;67.8;0.1
81;2021-09-03;587;1274;193;281266;264433;689;72.5;68.2;0.2
81;2021-09-04;499;898;72;281765;265331;761;72.6;68.4;0.2
81;2021-09-05;119;248;24;281884;265579;785;72.7;68.5;0.2
81;2021-09-06;301;537;197;282185;266116;982;72.7;68.6;0.3
81;2021-09-07;396;1051;268;282581;267167;1250;72.8;68.9;0.3
81;2021-09-08;423;1080;192;283004;268247;1442;73.0;69.2;0.4
81;2021-09-09;383;801;227;283387;269048;1669;73.1;69.4;0.4
81;2021-09-10;409;957;269;283796;270005;1938;73.2;69.6;0.5
81;2021-09-11;396;881;75;284192;270886;2013;73.3;69.8;0.5
81;2021-09-12;80;239;30;284272;271125;2043;73.3;69.9;0.5
81;2021-09-13;241;473;274;284513;271598;2317;73.3;70.0;0.6
81;2021-09-14;490;683;452;285003;272281;2769;73.5;70.2;0.7
81;2021-09-15;445;788;481;285448;273069;3250;73.6;70.4;0.8
81;2021-09-16;346;537;387;285794;273606;3637;73.7;70.5;0.9
81;2021-09-17;431;796;355;286225;274402;3992;73.8;70.7;1.0
81;2021-09-18;267;672;136;286492;275074;4128;73.9;70.9;1.1
81;2021-09-19;57;169;17;286549;275243;4145;73.9;71.0;1.1
81;2021-09-20;136;311;223;286685;275554;4368;73.9;71.0;1.1
81;2021-09-21;263;550;531;286948;276104;4899;74.0;71.2;1.3
81;2021-09-22;201;676;395;287149;276780;5294;74.0;71.4;1.4
81;2021-09-23;162;502;471;287311;277282;5765;74.1;71.5;1.5
81;2021-09-24;298;686;470;287609;277968;6235;74.1;71.7;1.6
81;2021-09-25;168;686;99;287777;278654;6334;74.2;71.8;1.6
81;2021-09-26;34;137;22;287811;278791;6356;74.2;71.9;1.6
81;2021-09-27;137;277;246;287948;279068;6602;74.2;71.9;1.7
81;2021-09-28;179;356;271;288127;279424;6873;74.3;72.0;1.8
81;2021-09-29;233;499;268;288360;279923;7141;74.3;72.2;1.8
81;2021-09-30;150;301;336;288510;280224;7477;74.4;72.2;1.9
81;2021-10-01;289;456;339;288799;280680;7816;74.5;72.4;2.0
81;2021-10-02;198;422;157;288997;281102;7973;74.5;72.5;2.1
81;2021-10-03;52;106;23;289049;281208;7996;74.5;72.5;2.1
81;2021-10-04;111;211;209;289160;281419;8205;74.5;72.5;2.1
81;2021-10-05;150;333;454;289310;281752;8659;74.6;72.6;2.2
81;2021-10-06;215;460;432;289525;282212;9091;74.6;72.8;2.3
81;2021-10-07;153;313;541;289678;282525;9632;74.7;72.8;2.5
81;2021-10-08;209;500;793;289887;283025;10425;74.7;73.0;2.7
81;2021-10-09;151;322;102;290038;283347;10527;74.8;73.0;2.7
81;2021-10-10;46;69;45;290084;283416;10572;74.8;73.1;2.7
81;2021-10-11;135;216;357;290219;283632;10929;74.8;73.1;2.8
81;2021-10-12;131;240;504;290350;283872;11433;74.9;73.2;2.9
81;2021-10-13;208;307;266;290558;284179;11699;74.9;73.3;3.0
81;2021-10-14;136;246;465;290694;284425;12164;74.9;73.3;3.1
81;2021-10-15;257;355;925;290951;284780;13089;75.0;73.4;3.4
81;2021-10-16;190;199;119;291141;284979;13208;75.1;73.5;3.4
81;2021-10-17;3;8;1;291144;284987;13209;75.1;73.5;3.4
81;2021-10-18;105;139;308;291249;285126;13517;75.1;73.5;3.5
81;2021-10-19;142;196;477;291391;285322;13994;75.1;73.6;3.6
81;2021-10-20;175;245;507;291566;285567;14501;75.2;73.6;3.7
81;2021-10-21;114;187;615;291680;285754;15116;75.2;73.7;3.9
81;2021-10-22;194;330;670;291874;286084;15786;75.2;73.8;4.1
81;2021-10-23;122;216;205;291996;286300;15991;75.3;73.8;4.1
81;2021-10-24;43;62;86;292039;286362;16077;75.3;73.8;4.1
81;2021-10-25;127;143;507;292166;286505;16584;75.3;73.9;4.3
81;2021-10-26;104;119;706;292270;286624;17290;75.3;73.9;4.5
81;2021-10-27;105;139;500;292375;286763;17790;75.4;73.9;4.6
81;2021-10-28;69;121;656;292444;286884;18446;75.4;74.0;4.8
81;2021-10-29;145;186;795;292589;287070;19241;75.4;74.0;5.0
81;2021-10-30;133;208;962;292722;287278;20203;75.5;74.1;5.2
81;2021-10-31;38;48;118;292760;287326;20321;75.5;74.1;5.2
81;2021-11-01;6;3;0;292766;287329;20321;75.5;74.1;5.2
81;2021-11-02;109;158;708;292875;287487;21029;75.5;74.1;5.4
81;2021-11-03;190;286;1050;293065;287773;22079;75.6;74.2;5.7
81;2021-11-04;120;135;922;293185;287908;23001;75.6;74.2;5.9
81;2021-11-05;162;238;1177;293347;288146;24178;75.6;74.3;6.2
81;2021-11-06;113;191;449;293460;288337;24627;75.7;74.3;6.3
81;2021-11-07;45;50;109;293505;288387;24736;75.7;74.3;6.4
81;2021-11-08;71;97;553;293576;288484;25289;75.7;74.4;6.5
81;2021-11-09;107;173;1639;293683;288657;26928;75.7;74.4;6.9
81;2021-11-10;208;244;1621;293891;288901;28549;75.8;74.5;7.4
81;2021-11-11;3;5;54;293894;288906;28603;75.8;74.5;7.4
81;2021-11-12;128;183;1195;294022;289089;29798;75.8;74.5;7.7
81;2021-11-13;118;161;602;294140;289250;30400;75.8;74.6;7.8
81;2021-11-14;21;51;138;294161;289301;30538;75.8;74.6;7.9
81;2021-11-15;121;103;1286;294282;289404;31824;75.9;74.6;8.2
81;2021-11-16;127;179;1959;294409;289583;33783;75.9;74.7;8.7
81;2021-11-17;89;153;995;294498;289736;34778;75.9;74.7;9.0
81;2021-11-18;110;151;1488;294608;289887;36266;75.9;74.7;9.3
81;2021-11-19;125;131;1536;294733;290018;37802;76.0;74.8;9.7
81;2021-11-20;61;85;337;294794;290103;38139;76.0;74.8;9.8
81;2021-11-21;122;112;634;294916;290215;38773;76.0;74.8;10.0
81;2021-11-22;52;41;810;294968;290256;39583;76.0;74.8;10.2
81;2021-11-23;176;130;2682;295144;290386;42265;76.1;74.9;10.9
81;2021-11-24;224;194;1935;295368;290580;44200;76.1;74.9;11.4
81;2021-11-25;141;111;2212;295509;290691;46412;76.2;74.9;12.0
81;2021-11-26;220;201;3185;295729;290892;49597;76.2;75.0;12.8
81;2021-11-27;169;173;1541;295898;291065;51138;76.3;75.0;13.2
81;2021-11-28;38;51;842;295936;291116;51980;76.3;75.0;13.4
81;2021-11-29;62;69;1255;295998;291185;53235;76.3;75.1;13.7
81;2021-11-30;140;130;4130;296138;291315;57365;76.3;75.1;14.8
81;2021-12-01;128;166;3101;296266;291481;60466;76.4;75.1;15.6
81;2021-12-02;103;70;3600;296369;291551;64066;76.4;75.2;16.5
81;2021-12-03;86;130;3712;296455;291681;67778;76.4;75.2;17.5
81;2021-12-04;75;75;1648;296530;291756;69426;76.4;75.2;17.9
81;2021-12-05;12;15;764;296542;291771;70190;76.4;75.2;18.1
81;2021-12-06;92;72;2935;296634;291843;73125;76.5;75.2;18.9
81;2021-12-07;113;134;4846;296747;291977;77971;76.5;75.3;20.1
81;2021-12-08;140;228;3781;296887;292205;81752;76.5;75.3;21.1
81;2021-12-09;116;121;4338;297003;292326;86090;76.6;75.4;22.2
81;2021-12-10;122;154;4611;297125;292480;90701;76.6;75.4;23.4
81;2021-12-11;83;91;2461;297208;292571;93162;76.6;75.4;24.0
81;2021-12-12;36;21;1011;297244;292592;94173;76.6;75.4;24.3
81;2021-12-13;92;77;3234;297336;292669;97407;76.7;75.4;25.1
81;2021-12-14;148;204;5636;297484;292873;103043;76.7;75.5;26.6
81;2021-12-15;164;258;4389;297648;293131;107432;76.7;75.6;27.7
81;2021-12-16;151;182;4914;297799;293313;112346;76.8;75.6;29.0
82;2020-12-27;0;0;0;0;0;0;0.0;0.0;0.0
82;2020-12-28;1;0;0;1;0;0;0.0;0.0;0.0
82;2020-12-29;0;0;0;1;0;0;0.0;0.0;0.0
82;2020-12-30;0;0;0;1;0;0;0.0;0.0;0.0
82;2020-12-31;0;0;0;1;0;0;0.0;0.0;0.0
82;2021-01-01;0;0;0;1;0;0;0.0;0.0;0.0
82;2021-01-02;0;0;0;1;0;0;0.0;0.0;0.0
82;2021-01-03;0;0;0;1;0;0;0.0;0.0;0.0
82;2021-01-04;0;0;0;1;0;0;0.0;0.0;0.0
82;2021-01-05;78;0;0;79;0;0;0.0;0.0;0.0
82;2021-01-06;4;0;0;83;0;0;0.0;0.0;0.0
82;2021-01-07;68;0;0;151;0;0;0.1;0.0;0.0
82;2021-01-08;61;0;0;212;0;0;0.1;0.0;0.0
82;2021-01-09;75;0;0;287;0;0;0.1;0.0;0.0
82;2021-01-10;2;0;0;289;0;0;0.1;0.0;0.0
82;2021-01-11;102;0;0;391;0;0;0.1;0.0;0.0
82;2021-01-12;286;0;0;677;0;0;0.3;0.0;0.0
82;2021-01-13;324;1;0;1001;1;0;0.4;0.0;0.0
82;2021-01-14;416;5;0;1417;6;0;0.5;0.0;0.0
82;2021-01-15;602;3;0;2019;9;0;0.8;0.0;0.0
82;2021-01-16;214;3;0;2233;12;0;0.9;0.0;0.0
82;2021-01-17;89;0;0;2322;12;0;0.9;0.0;0.0
82;2021-01-18;415;0;0;2737;12;0;1.0;0.0;0.0
82;2021-01-19;478;1;0;3215;13;0;1.2;0.0;0.0
82;2021-01-20;643;5;0;3858;18;0;1.5;0.0;0.0
82;2021-01-21;450;2;0;4308;20;0;1.6;0.0;0.0
82;2021-01-22;465;2;0;4773;22;0;1.8;0.0;0.0
82;2021-01-23;159;0;0;4932;22;0;1.9;0.0;0.0
82;2021-01-24;2;0;0;4934;22;0;1.9;0.0;0.0
82;2021-01-25;365;0;0;5299;22;0;2.0;0.0;0.0
82;2021-01-26;446;0;0;5745;22;0;2.2;0.0;0.0
82;2021-01-27;508;5;0;6253;27;0;2.4;0.0;0.0
82;2021-01-28;544;34;0;6797;61;0;2.6;0.0;0.0
82;2021-01-29;387;102;0;7184;163;0;2.7;0.1;0.0
82;2021-01-30;57;24;0;7241;187;0;2.8;0.1;0.0
82;2021-01-31;4;2;0;7245;189;0;2.8;0.1;0.0
82;2021-02-01;289;76;0;7534;265;0;2.9;0.1;0.0
82;2021-02-02;360;116;0;7894;381;0;3.0;0.1;0.0
82;2021-02-03;430;81;0;8324;462;0;3.2;0.2;0.0
82;2021-02-04;729;206;0;9053;668;0;3.4;0.3;0.0
82;2021-02-05;456;150;0;9509;818;0;3.6;0.3;0.0
82;2021-02-06;89;37;0;9598;855;0;3.7;0.3;0.0
82;2021-02-07;30;71;0;9628;926;0;3.7;0.4;0.0
82;2021-02-08;151;224;0;9779;1150;0;3.7;0.4;0.0
82;2021-02-09;220;381;0;9999;1531;0;3.8;0.6;0.0
82;2021-02-10;259;575;0;10258;2106;0;3.9;0.8;0.0
82;2021-02-11;221;379;0;10479;2485;0;4.0;0.9;0.0
82;2021-02-12;191;573;0;10670;3058;0;4.1;1.2;0.0
82;2021-02-13;59;119;0;10729;3177;0;4.1;1.2;0.0
82;2021-02-14;6;86;0;10735;3263;0;4.1;1.2;0.0
82;2021-02-15;220;306;0;10955;3569;0;4.2;1.4;0.0
82;2021-02-16;266;381;0;11221;3950;0;4.3;1.5;0.0
82;2021-02-17;328;514;0;11549;4464;0;4.4;1.7;0.0
82;2021-02-18;457;485;0;12006;4949;0;4.6;1.9;0.0
82;2021-02-19;439;513;0;12445;5462;0;4.7;2.1;0.0
82;2021-02-20;68;141;0;12513;5603;0;4.8;2.1;0.0
82;2021-02-21;3;0;0;12516;5603;0;4.8;2.1;0.0
82;2021-02-22;190;388;0;12706;5991;0;4.8;2.3;0.0
82;2021-02-23;268;453;0;12974;6444;0;4.9;2.5;0.0
82;2021-02-24;266;439;0;13240;6883;0;5.0;2.6;0.0
82;2021-02-25;581;497;0;13821;7380;0;5.3;2.8;0.0
82;2021-02-26;600;380;0;14421;7760;0;5.5;3.0;0.0
82;2021-02-27;206;74;0;14627;7834;0;5.6;3.0;0.0
82;2021-02-28;33;8;0;14660;7842;0;5.6;3.0;0.0
82;2021-03-01;257;212;0;14917;8054;0;5.7;3.1;0.0
82;2021-03-02;477;400;0;15394;8454;0;5.9;3.2;0.0
82;2021-03-03;405;361;0;15799;8815;0;6.0;3.4;0.0
82;2021-03-04;565;302;0;16364;9117;0;6.2;3.5;0.0
82;2021-03-05;667;369;0;17031;9486;0;6.5;3.6;0.0
82;2021-03-06;675;54;0;17706;9540;0;6.7;3.6;0.0
82;2021-03-07;318;6;0;18024;9546;0;6.9;3.6;0.0
82;2021-03-08;568;150;0;18592;9696;0;7.1;3.7;0.0
82;2021-03-09;563;245;0;19155;9941;0;7.3;3.8;0.0
82;2021-03-10;737;232;0;19892;10173;0;7.6;3.9;0.0
82;2021-03-11;923;274;0;20815;10447;0;7.9;4.0;0.0
82;2021-03-12;951;115;0;21766;10562;0;8.3;4.0;0.0
82;2021-03-13;548;53;0;22314;10615;0;8.5;4.0;0.0
82;2021-03-14;63;5;0;22377;10620;0;8.5;4.0;0.0
82;2021-03-15;488;309;0;22865;10929;0;8.7;4.2;0.0
82;2021-03-16;214;307;0;23079;11236;0;8.8;4.3;0.0
82;2021-03-17;200;259;0;23279;11495;0;8.9;4.4;0.0
82;2021-03-18;279;326;0;23558;11821;0;9.0;4.5;0.0
82;2021-03-19;508;279;0;24066;12100;0;9.2;4.6;0.0
82;2021-03-20;248;59;0;24314;12159;0;9.3;4.6;0.0
82;2021-03-21;27;0;0;24341;12159;0;9.3;4.6;0.0
82;2021-03-22;410;280;0;24751;12439;0;9.4;4.7;0.0
82;2021-03-23;574;276;0;25325;12715;0;9.6;4.8;0.0
82;2021-03-24;621;298;0;25946;13013;0;9.9;5.0;0.0
82;2021-03-25;915;241;0;26861;13254;0;10.2;5.0;0.0
82;2021-03-26;1113;257;0;27974;13511;0;10.7;5.1;0.0
82;2021-03-27;421;83;0;28395;13594;0;10.8;5.2;0.0
82;2021-03-28;141;3;0;28536;13597;0;10.9;5.2;0.0
82;2021-03-29;783;344;0;29319;13941;0;11.2;5.3;0.0
82;2021-03-30;1079;266;0;30398;14207;0;11.6;5.4;0.0
82;2021-03-31;911;228;0;31309;14435;0;11.9;5.5;0.0
82;2021-04-01;1015;177;0;32324;14612;0;12.3;5.6;0.0
82;2021-04-02;1127;259;0;33451;14871;0;12.7;5.7;0.0
82;2021-04-03;596;125;0;34047;14996;0;13.0;5.7;0.0
82;2021-04-04;248;15;0;34295;15011;0;13.1;5.7;0.0
82;2021-04-05;329;16;0;34624;15027;0;13.2;5.7;0.0
82;2021-04-06;870;473;0;35494;15500;0;13.5;5.9;0.0
82;2021-04-07;944;443;0;36438;15943;0;13.9;6.1;0.0
82;2021-04-08;1383;401;0;37821;16344;0;14.4;6.2;0.0
82;2021-04-09;1526;454;0;39347;16798;0;15.0;6.4;0.0
82;2021-04-10;1502;92;0;40849;16890;0;15.6;6.4;0.0
82;2021-04-11;487;24;0;41336;16914;0;15.7;6.4;0.0
82;2021-04-12;1211;293;0;42547;17207;0;16.2;6.6;0.0
82;2021-04-13;1547;290;0;44094;17497;0;16.8;6.7;0.0
82;2021-04-14;1374;286;0;45468;17783;0;17.3;6.8;0.0
82;2021-04-15;1705;326;0;47173;18109;0;18.0;6.9;0.0
82;2021-04-16;1462;339;0;48635;18448;0;18.5;7.0;0.0
82;2021-04-17;1133;75;0;49768;18523;0;19.0;7.1;0.0
82;2021-04-18;507;16;0;50275;18539;0;19.1;7.1;0.0
82;2021-04-19;895;328;0;51170;18867;0;19.5;7.2;0.0
82;2021-04-20;1204;373;0;52374;19240;0;19.9;7.3;0.0
82;2021-04-21;1114;352;0;53488;19592;0;20.4;7.5;0.0
82;2021-04-22;1398;297;0;54886;19889;0;20.9;7.6;0.0
82;2021-04-23;1034;562;0;55920;20451;0;21.3;7.8;0.0
82;2021-04-24;1042;209;0;56962;20660;0;21.7;7.9;0.0
82;2021-04-25;635;46;0;57597;20706;0;21.9;7.9;0.0
82;2021-04-26;698;624;0;58295;21330;0;22.2;8.1;0.0
82;2021-04-27;903;836;0;59198;22166;0;22.5;8.4;0.0
82;2021-04-28;852;788;0;60050;22954;0;22.9;8.7;0.0
82;2021-04-29;1042;831;0;61092;23785;0;23.3;9.1;0.0
82;2021-04-30;1000;805;0;62092;24590;0;23.6;9.4;0.0
82;2021-05-01;1000;234;0;63092;24824;0;24.0;9.5;0.0
82;2021-05-02;609;136;0;63701;24960;0;24.3;9.5;0.0
82;2021-05-03;423;1035;0;64124;25995;0;24.4;9.9;0.0
82;2021-05-04;820;1050;0;64944;27045;0;24.7;10.3;0.0
82;2021-05-05;593;1088;0;65537;28133;0;25.0;10.7;0.0
82;2021-05-06;849;1340;0;66386;29473;0;25.3;11.2;0.0
82;2021-05-07;786;1322;0;67172;30795;0;25.6;11.7;0.0
82;2021-05-08;830;482;0;68002;31277;0;25.9;11.9;0.0
82;2021-05-09;629;504;0;68631;31781;0;26.1;12.1;0.0
82;2021-05-10;665;1234;0;69296;33015;0;26.4;12.6;0.0
82;2021-05-11;1073;1278;0;70369;34293;0;26.8;13.1;0.0
82;2021-05-12;837;1255;0;71206;35548;0;27.1;13.5;0.0
82;2021-05-13;1215;406;0;72421;35954;0;27.6;13.7;0.0
82;2021-05-14;1306;1144;0;73727;37098;0;28.1;14.1;0.0
82;2021-05-15;1384;624;0;75111;37722;0;28.6;14.4;0.0
82;2021-05-16;497;114;0;75608;37836;0;28.8;14.4;0.0
82;2021-05-17;853;1071;0;76461;38907;0;29.1;14.8;0.0
82;2021-05-18;1313;1086;0;77774;39993;0;29.6;15.2;0.0
82;2021-05-19;1041;880;0;78815;40873;0;30.0;15.6;0.0
82;2021-05-20;1338;1096;0;80153;41969;0;30.5;16.0;0.0
82;2021-05-21;1125;1119;0;81278;43088;0;30.9;16.4;0.0
82;2021-05-22;1436;533;0;82714;43621;0;31.5;16.6;0.0
82;2021-05-23;579;99;0;83293;43720;0;31.7;16.6;0.0
82;2021-05-24;1082;224;0;84375;43944;0;32.1;16.7;0.0
82;2021-05-25;1308;896;0;85683;44840;0;32.6;17.1;0.0
82;2021-05-26;1146;842;0;86829;45682;0;33.1;17.4;0.0
82;2021-05-27;1254;976;0;88083;46658;0;33.5;17.8;0.0
82;2021-05-28;1252;1080;0;89335;47738;0;34.0;18.2;0.0
82;2021-05-29;1121;512;0;90456;48250;0;34.4;18.4;0.0
82;2021-05-30;283;101;0;90739;48351;0;34.6;18.4;0.0
82;2021-05-31;1206;923;0;91945;49274;0;35.0;18.8;0.0
82;2021-06-01;1507;997;0;93452;50271;0;35.6;19.1;0.0
82;2021-06-02;1209;928;0;94661;51199;0;36.0;19.5;0.0
82;2021-06-03;1351;1160;0;96012;52359;0;36.6;19.9;0.0
82;2021-06-04;1882;1206;0;97894;53565;0;37.3;20.4;0.0
82;2021-06-05;1541;863;0;99435;54428;0;37.9;20.7;0.0
82;2021-06-06;295;126;0;99730;54554;0;38.0;20.8;0.0
82;2021-06-07;802;1169;0;100532;55723;0;38.3;21.2;0.0
82;2021-06-08;1354;1067;0;101886;56790;0;38.8;21.6;0.0
82;2021-06-09;1351;1049;0;103237;57839;0;39.3;22.0;0.0
82;2021-06-10;1353;1162;0;104590;59001;0;39.8;22.5;0.0
82;2021-06-11;1635;1032;0;106225;60033;0;40.4;22.9;0.0
82;2021-06-12;1696;1107;0;107921;61140;0;41.1;23.3;0.0
82;2021-06-13;360;119;0;108281;61259;0;41.2;23.3;0.0
82;2021-06-14;1116;1005;0;109397;62264;0;41.7;23.7;0.0
82;2021-06-15;1351;1144;0;110748;63408;0;42.2;24.1;0.0
82;2021-06-16;1472;1100;0;112220;64508;0;42.7;24.6;0.0
82;2021-06-17;1154;1384;0;113374;65892;0;43.2;25.1;0.0
82;2021-06-18;1332;1378;0;114706;67270;0;43.7;25.6;0.0
82;2021-06-19;1734;834;0;116440;68104;0;44.3;25.9;0.0
82;2021-06-20;268;162;0;116708;68266;0;44.4;26.0;0.0
82;2021-06-21;517;1127;0;117225;69393;0;44.6;26.4;0.0
82;2021-06-22;868;1553;0;118093;70946;0;45.0;27.0;0.0
82;2021-06-23;1140;1328;0;119233;72274;0;45.4;27.5;0.0
82;2021-06-24;721;1674;0;119954;73948;0;45.7;28.2;0.0
82;2021-06-25;761;1615;0;120715;75563;0;46.0;28.8;0.0
82;2021-06-26;1084;1652;0;121799;77215;0;46.4;29.4;0.0
82;2021-06-27;177;376;0;121976;77591;0;46.4;29.5;0.0
82;2021-06-28;359;1229;0;122335;78820;0;46.6;30.0;0.0
82;2021-06-29;522;1660;0;122857;80480;0;46.8;30.6;0.0
82;2021-06-30;883;1569;0;123740;82049;0;47.1;31.2;0.0
82;2021-07-01;658;1488;0;124398;83537;0;47.4;31.8;0.0
82;2021-07-02;950;1961;0;125348;85498;0;47.7;32.6;0.0
82;2021-07-03;810;1757;0;126158;87255;0;48.0;33.2;0.0
82;2021-07-04;147;396;0;126305;87651;0;48.1;33.4;0.0
82;2021-07-05;443;1385;0;126748;89036;0;48.3;33.9;0.0
82;2021-07-06;588;1687;0;127336;90723;0;48.5;34.5;0.0
82;2021-07-07;786;1492;0;128122;92215;0;48.8;35.1;0.0
82;2021-07-08;572;1402;1;128694;93617;1;49.0;35.6;0.0
82;2021-07-09;818;1830;0;129512;95447;1;49.3;36.3;0.0
82;2021-07-10;706;1780;0;130218;97227;1;49.6;37.0;0.0
82;2021-07-11;109;336;0;130327;97563;1;49.6;37.2;0.0
82;2021-07-12;594;1641;0;130921;99204;1;49.9;37.8;0.0
82;2021-07-13;848;1881;0;131769;101085;1;50.2;38.5;0.0
82;2021-07-14;699;578;0;132468;101663;1;50.4;38.7;0.0
82;2021-07-15;1052;1708;0;133520;103371;1;50.8;39.4;0.0
82;2021-07-16;1521;2394;0;135041;105765;1;51.4;40.3;0.0
82;2021-07-17;815;1847;0;135856;107612;1;51.7;41.0;0.0
82;2021-07-18;274;169;0;136130;107781;1;51.8;41.0;0.0
82;2021-07-19;932;1794;0;137062;109575;1;52.2;41.7;0.0
82;2021-07-20;1194;1864;0;138256;111439;1;52.6;42.4;0.0
82;2021-07-21;1540;1648;0;139796;113087;1;53.2;43.1;0.0
82;2021-07-22;1430;1764;0;141226;114851;1;53.8;43.7;0.0
82;2021-07-23;1370;2679;0;142596;117530;1;54.3;44.8;0.0
82;2021-07-24;1491;1404;0;144087;118934;1;54.9;45.3;0.0
82;2021-07-25;525;184;0;144612;119118;1;55.1;45.4;0.0
82;2021-07-26;1152;1824;0;145764;120942;1;55.5;46.1;0.0
82;2021-07-27;1615;1643;0;147379;122585;1;56.1;46.7;0.0
82;2021-07-28;1791;1425;0;149170;124010;1;56.8;47.2;0.0
82;2021-07-29;1628;1502;0;150798;125512;1;57.4;47.8;0.0
82;2021-07-30;1873;2212;0;152671;127724;1;58.1;48.6;0.0
82;2021-07-31;868;466;0;153539;128190;1;58.5;48.8;0.0
82;2021-08-01;426;139;0;153965;128329;1;58.6;48.9;0.0
82;2021-08-02;1452;874;0;155417;129203;1;59.2;49.2;0.0
82;2021-08-03;1687;883;0;157104;130086;1;59.8;49.5;0.0
82;2021-08-04;1652;999;0;158756;131085;1;60.5;49.9;0.0
82;2021-08-05;1694;761;0;160450;131846;1;61.1;50.2;0.0
82;2021-08-06;1252;812;0;161702;132658;1;61.6;50.5;0.0
82;2021-08-07;1132;1271;0;162834;133929;1;62.0;51.0;0.0
82;2021-08-08;306;237;0;163140;134166;1;62.1;51.1;0.0
82;2021-08-09;1209;1100;0;164349;135266;1;62.6;51.5;0.0
82;2021-08-10;1514;1088;0;165863;136354;1;63.2;51.9;0.0
82;2021-08-11;1363;1221;0;167226;137575;1;63.7;52.4;0.0
82;2021-08-12;1540;1091;0;168766;138666;1;64.3;52.8;0.0
82;2021-08-13;1407;1190;0;170173;139856;1;64.8;53.3;0.0
82;2021-08-14;498;779;0;170671;140635;1;65.0;53.6;0.0
82;2021-08-15;81;158;0;170752;140793;1;65.0;53.6;0.0
82;2021-08-16;835;1640;0;171587;142433;1;65.3;54.2;0.0
82;2021-08-17;1031;1431;0;172618;143864;1;65.7;54.8;0.0
82;2021-08-18;688;1107;0;173306;144971;1;66.0;55.2;0.0
82;2021-08-19;986;1282;0;174292;146253;1;66.4;55.7;0.0
82;2021-08-20;992;2019;0;175284;148272;1;66.7;56.5;0.0
82;2021-08-21;511;1131;0;175795;149403;1;66.9;56.9;0.0
82;2021-08-22;52;260;0;175847;149663;1;67.0;57.0;0.0
82;2021-08-23;737;1455;0;176584;151118;1;67.2;57.5;0.0
82;2021-08-24;857;1304;0;177441;152422;1;67.6;58.0;0.0
82;2021-08-25;768;1659;0;178209;154081;1;67.9;58.7;0.0
82;2021-08-26;603;1266;0;178812;155347;1;68.1;59.2;0.0
82;2021-08-27;823;1813;0;179635;157160;1;68.4;59.8;0.0
82;2021-08-28;240;954;0;179875;158114;1;68.5;60.2;0.0
82;2021-08-29;72;254;0;179947;158368;1;68.5;60.3;0.0
82;2021-08-30;396;1234;8;180343;159602;9;68.7;60.8;0.0
82;2021-08-31;381;1230;21;180724;160832;30;68.8;61.2;0.0
82;2021-09-01;675;1433;53;181399;162265;83;69.1;61.8;0.0
82;2021-09-02;406;1285;62;181805;163550;145;69.2;62.3;0.1
82;2021-09-03;520;1856;146;182325;165406;291;69.4;63.0;0.1
82;2021-09-04;408;958;45;182733;166364;336;69.6;63.3;0.1
82;2021-09-05;33;82;1;182766;166446;337;69.6;63.4;0.1
82;2021-09-06;362;1119;148;183128;167565;485;69.7;63.8;0.2
82;2021-09-07;227;890;92;183355;168455;577;69.8;64.1;0.2
82;2021-09-08;443;1173;90;183798;169628;667;70.0;64.6;0.3
82;2021-09-09;266;922;111;184064;170550;778;70.1;64.9;0.3
82;2021-09-10;484;1231;207;184548;171781;985;70.3;65.4;0.4
82;2021-09-11;244;590;53;184792;172371;1038;70.4;65.6;0.4
82;2021-09-12;28;70;0;184820;172441;1038;70.4;65.7;0.4
82;2021-09-13;287;806;249;185107;173247;1287;70.5;66.0;0.5
82;2021-09-14;225;797;177;185332;174044;1464;70.6;66.3;0.6
82;2021-09-15;302;1113;398;185634;175157;1862;70.7;66.7;0.7
82;2021-09-16;226;487;258;185860;175644;2120;70.8;66.9;0.8
82;2021-09-17;214;531;173;186074;176175;2293;70.9;67.1;0.9
82;2021-09-18;298;1033;107;186372;177208;2400;71.0;67.5;0.9
82;2021-09-19;5;38;8;186377;177246;2408;71.0;67.5;0.9
82;2021-09-20;146;392;377;186523;177638;2785;71.0;67.6;1.1
82;2021-09-21;101;383;264;186624;178021;3049;71.1;67.8;1.2
82;2021-09-22;140;465;300;186764;178486;3349;71.1;68.0;1.3
82;2021-09-23;115;379;344;186879;178865;3693;71.2;68.1;1.4
82;2021-09-24;204;565;326;187083;179430;4019;71.2;68.3;1.5
82;2021-09-25;168;635;109;187251;180065;4128;71.3;68.6;1.6
82;2021-09-26;9;36;8;187260;180101;4136;71.3;68.6;1.6
82;2021-09-27;106;444;169;187366;180545;4305;71.3;68.7;1.6
82;2021-09-28;99;235;227;187465;180780;4532;71.4;68.8;1.7
82;2021-09-29;233;478;196;187698;181258;4728;71.5;69.0;1.8
82;2021-09-30;116;222;263;187814;181480;4991;71.5;69.1;1.9
82;2021-10-01;219;379;265;188033;181859;5256;71.6;69.2;2.0
82;2021-10-02;140;300;87;188173;182159;5343;71.7;69.4;2.0
82;2021-10-03;4;5;0;188177;182164;5343;71.7;69.4;2.0
82;2021-10-04;125;380;205;188302;182544;5548;71.7;69.5;2.1
82;2021-10-05;134;280;229;188436;182824;5777;71.8;69.6;2.2
82;2021-10-06;167;337;384;188603;183161;6161;71.8;69.7;2.3
82;2021-10-07;81;143;392;188684;183304;6553;71.8;69.8;2.5
82;2021-10-08;168;307;300;188852;183611;6853;71.9;69.9;2.6
82;2021-10-09;124;269;147;188976;183880;7000;72.0;70.0;2.7
82;2021-10-10;7;17;5;188983;183897;7005;72.0;70.0;2.7
82;2021-10-11;79;203;243;189062;184100;7248;72.0;70.1;2.8
82;2021-10-12;84;158;310;189146;184258;7558;72.0;70.2;2.9
82;2021-10-13;179;286;360;189325;184544;7918;72.1;70.3;3.0
82;2021-10-14;51;88;111;189376;184632;8029;72.1;70.3;3.1
82;2021-10-15;196;241;374;189572;184873;8403;72.2;70.4;3.2
82;2021-10-16;103;134;94;189675;185007;8497;72.2;70.4;3.2
82;2021-10-17;0;5;0;189675;185012;8497;72.2;70.4;3.2
82;2021-10-18;127;129;218;189802;185141;8715;72.3;70.5;3.3
82;2021-10-19;113;151;304;189915;185292;9019;72.3;70.6;3.4
82;2021-10-20;186;274;397;190101;185566;9416;72.4;70.7;3.6
82;2021-10-21;65;79;164;190166;185645;9580;72.4;70.7;3.6
82;2021-10-22;120;253;381;190286;185898;9961;72.5;70.8;3.8
82;2021-10-23;122;172;155;190408;186070;10116;72.5;70.9;3.9
82;2021-10-24;1;6;6;190409;186076;10122;72.5;70.9;3.9
82;2021-10-25;85;120;389;190494;186196;10511;72.5;70.9;4.0
82;2021-10-26;112;157;396;190606;186353;10907;72.6;71.0;4.2
82;2021-10-27;85;168;388;190691;186521;11295;72.6;71.0;4.3
82;2021-10-28;49;62;198;190740;186583;11493;72.6;71.0;4.4
82;2021-10-29;108;213;384;190848;186796;11877;72.7;71.1;4.5
82;2021-10-30;106;136;226;190954;186932;12103;72.7;71.2;4.6
82;2021-10-31;2;0;1;190956;186932;12104;72.7;71.2;4.6
82;2021-11-01;7;3;3;190963;186935;12107;72.7;71.2;4.6
82;2021-11-02;81;112;361;191044;187047;12468;72.7;71.2;4.7
82;2021-11-03;117;110;498;191161;187157;12966;72.8;71.3;4.9
82;2021-11-04;95;94;408;191256;187251;13374;72.8;71.3;5.1
82;2021-11-05;100;137;524;191356;187388;13898;72.9;71.4;5.3
82;2021-11-06;59;77;188;191415;187465;14086;72.9;71.4;5.4
82;2021-11-07;0;5;14;191415;187470;14100;72.9;71.4;5.4
82;2021-11-08;47;95;251;191462;187565;14351;72.9;71.4;5.5
82;2021-11-09;75;93;619;191537;187658;14970;72.9;71.5;5.7
82;2021-11-10;100;274;602;191637;187932;15572;73.0;71.6;5.9
82;2021-11-11;4;6;29;191641;187938;15601;73.0;71.6;5.9
82;2021-11-12;78;92;582;191719;188030;16183;73.0;71.6;6.2
82;2021-11-13;61;152;248;191780;188182;16431;73.0;71.7;6.3
82;2021-11-14;2;2;6;191782;188184;16437;73.0;71.7;6.3
82;2021-11-15;55;58;380;191837;188242;16817;73.0;71.7;6.4
82;2021-11-16;82;81;1083;191919;188323;17900;73.1;71.7;6.8
82;2021-11-17;91;121;951;192010;188444;18851;73.1;71.8;7.2
82;2021-11-18;85;66;815;192095;188510;19666;73.1;71.8;7.5
82;2021-11-19;140;107;955;192235;188617;20621;73.2;71.8;7.9
82;2021-11-20;69;68;273;192304;188685;20894;73.2;71.8;8.0
82;2021-11-21;3;6;25;192307;188691;20919;73.2;71.8;8.0
82;2021-11-22;50;47;605;192357;188738;21524;73.2;71.9;8.2
82;2021-11-23;71;86;1198;192428;188824;22722;73.3;71.9;8.7
82;2021-11-24;124;235;1073;192552;189059;23795;73.3;72.0;9.1
82;2021-11-25;79;79;1365;192631;189138;25160;73.4;72.0;9.6
82;2021-11-26;110;146;1336;192741;189284;26496;73.4;72.1;10.1
82;2021-11-27;98;145;672;192839;189429;27168;73.4;72.1;10.3
82;2021-11-28;4;12;37;192843;189441;27205;73.4;72.1;10.4
82;2021-11-29;59;66;1399;192902;189507;28604;73.5;72.2;10.9
82;2021-11-30;95;87;2172;192997;189594;30776;73.5;72.2;11.7
82;2021-12-01;89;88;2075;193086;189682;32851;73.5;72.2;12.5
82;2021-12-02;99;81;2451;193185;189763;35302;73.6;72.3;13.4
82;2021-12-03;127;97;2431;193312;189860;37733;73.6;72.3;14.4
82;2021-12-04;54;94;1384;193366;189954;39117;73.6;72.3;14.9
82;2021-12-05;14;12;132;193380;189966;39249;73.6;72.3;14.9
82;2021-12-06;84;73;2484;193464;190039;41733;73.7;72.4;15.9
82;2021-12-07;110;104;3572;193574;190143;45305;73.7;72.4;17.3
82;2021-12-08;143;122;2493;193717;190265;47798;73.8;72.4;18.2
82;2021-12-09;100;106;3230;193817;190371;51028;73.8;72.5;19.4
82;2021-12-10;93;140;3570;193910;190511;54598;73.8;72.5;20.8
82;2021-12-11;117;95;1822;194027;190606;56420;73.9;72.6;21.5
82;2021-12-12;3;13;125;194030;190619;56545;73.9;72.6;21.5
82;2021-12-13;105;98;2778;194135;190717;59323;73.9;72.6;22.6
82;2021-12-14;131;132;3545;194266;190849;62868;74.0;72.7;23.9
82;2021-12-15;125;137;2885;194391;190986;65753;74.0;72.7;25.0
82;2021-12-16;132;118;3500;194523;191104;69253;74.1;72.8;26.4
83;2020-12-27;4;0;0;4;0;0;0.0;0.0;0.0
83;2020-12-28;6;0;0;10;0;0;0.0;0.0;0.0
83;2020-12-29;3;0;0;13;0;0;0.0;0.0;0.0
83;2020-12-30;4;0;0;17;0;0;0.0;0.0;0.0
83;2020-12-31;1;0;0;18;0;0;0.0;0.0;0.0
83;2021-01-01;3;0;0;21;0;0;0.0;0.0;0.0
83;2021-01-02;1;0;0;22;0;0;0.0;0.0;0.0
83;2021-01-03;0;0;0;22;0;0;0.0;0.0;0.0
83;2021-01-04;3;0;0;25;0;0;0.0;0.0;0.0
83;2021-01-05;6;1;0;31;1;0;0.0;0.0;0.0
83;2021-01-06;84;0;0;115;1;0;0.0;0.0;0.0
83;2021-01-07;317;0;0;432;1;0;0.0;0.0;0.0
83;2021-01-08;426;0;0;858;1;0;0.1;0.0;0.0
83;2021-01-09;57;0;0;915;1;0;0.1;0.0;0.0
83;2021-01-10;5;0;0;920;1;0;0.1;0.0;0.0
83;2021-01-11;503;0;0;1423;1;0;0.1;0.0;0.0
83;2021-01-12;1045;4;0;2468;5;0;0.2;0.0;0.0
83;2021-01-13;965;8;0;3433;13;0;0.3;0.0;0.0
83;2021-01-14;897;6;0;4330;19;0;0.4;0.0;0.0
83;2021-01-15;764;2;0;5094;21;0;0.5;0.0;0.0
83;2021-01-16;66;0;0;5160;21;0;0.5;0.0;0.0
83;2021-01-17;6;0;0;5166;21;0;0.5;0.0;0.0
83;2021-01-18;1288;2;0;6454;23;0;0.6;0.0;0.0
83;2021-01-19;2198;8;0;8652;31;0;0.8;0.0;0.0
83;2021-01-20;1765;10;0;10417;41;0;1.0;0.0;0.0
83;2021-01-21;2267;9;0;12684;50;0;1.2;0.0;0.0
83;2021-01-22;1840;8;0;14524;58;0;1.4;0.0;0.0
83;2021-01-23;278;2;0;14802;60;0;1.4;0.0;0.0
83;2021-01-24;35;1;0;14837;61;0;1.4;0.0;0.0
83;2021-01-25;1574;8;0;16411;69;0;1.5;0.0;0.0
83;2021-01-26;1847;13;0;18258;82;0;1.7;0.0;0.0
83;2021-01-27;2199;96;0;20457;178;0;1.9;0.0;0.0
83;2021-01-28;4971;363;0;25428;541;0;2.4;0.1;0.0
83;2021-01-29;3009;357;0;28437;898;0;2.6;0.1;0.0
83;2021-01-30;261;50;0;28698;948;0;2.7;0.1;0.0
83;2021-01-31;40;0;0;28738;948;0;2.7;0.1;0.0
83;2021-02-01;1295;429;0;30033;1377;0;2.8;0.1;0.0
83;2021-02-02;1464;710;0;31497;2087;0;2.9;0.2;0.0
83;2021-02-03;1568;632;0;33065;2719;0;3.1;0.3;0.0
83;2021-02-04;1534;778;0;34599;3497;0;3.2;0.3;0.0
83;2021-02-05;1310;710;0;35909;4207;0;3.3;0.4;0.0
83;2021-02-06;68;28;0;35977;4235;0;3.4;0.4;0.0
83;2021-02-07;8;4;0;35985;4239;0;3.4;0.4;0.0
83;2021-02-08;1103;638;0;37088;4877;0;3.5;0.5;0.0
83;2021-02-09;1352;982;0;38440;5859;0;3.6;0.5;0.0
83;2021-02-10;1533;852;0;39973;6711;0;3.7;0.6;0.0
83;2021-02-11;1668;1130;0;41641;7841;0;3.9;0.7;0.0
83;2021-02-12;1373;904;0;43014;8745;0;4.0;0.8;0.0
83;2021-02-13;80;49;0;43094;8794;0;4.0;0.8;0.0
83;2021-02-14;6;6;0;43100;8800;0;4.0;0.8;0.0
83;2021-02-15;728;1102;0;43828;9902;0;4.1;0.9;0.0
83;2021-02-16;606;1508;0;44434;11410;0;4.1;1.1;0.0
83;2021-02-17;836;1867;0;45270;13277;0;4.2;1.2;0.0
83;2021-02-18;1543;3815;0;46813;17092;0;4.4;1.6;0.0
83;2021-02-19;1454;2403;0;48267;19495;0;4.5;1.8;0.0
83;2021-02-20;82;200;0;48349;19695;0;4.5;1.8;0.0
83;2021-02-21;21;37;0;48370;19732;0;4.5;1.8;0.0
83;2021-02-22;594;1767;0;48964;21499;0;4.6;2.0;0.0
83;2021-02-23;725;1535;0;49689;23034;0;4.6;2.1;0.0
83;2021-02-24;786;1509;0;50475;24543;0;4.7;2.3;0.0
83;2021-02-25;1294;1478;0;51769;26021;0;4.8;2.4;0.0
83;2021-02-26;1365;1267;0;53134;27288;0;4.9;2.5;0.0
83;2021-02-27;571;91;0;53705;27379;0;5.0;2.5;0.0
83;2021-02-28;18;15;0;53723;27394;0;5.0;2.6;0.0
83;2021-03-01;845;1211;0;54568;28605;0;5.1;2.7;0.0
83;2021-03-02;1044;1337;0;55612;29942;0;5.2;2.8;0.0
83;2021-03-03;1492;1581;0;57104;31523;0;5.3;2.9;0.0
83;2021-03-04;1934;1458;0;59038;32981;0;5.5;3.1;0.0
83;2021-03-05;2299;1289;0;61337;34270;0;5.7;3.2;0.0
83;2021-03-06;3083;162;0;64420;34432;0;6.0;3.2;0.0
83;2021-03-07;2325;70;0;66745;34502;0;6.2;3.2;0.0
83;2021-03-08;968;1317;0;67713;35819;0;6.3;3.3;0.0
83;2021-03-09;2016;1271;0;69729;37090;0;6.5;3.5;0.0
83;2021-03-10;2483;1387;0;72212;38477;0;6.7;3.6;0.0
83;2021-03-11;3764;2139;0;75976;40616;0;7.1;3.8;0.0
83;2021-03-12;3787;1496;0;79763;42112;0;7.4;3.9;0.0
83;2021-03-13;4606;188;0;84369;42300;0;7.9;3.9;0.0
83;2021-03-14;2258;61;0;86627;42361;0;8.1;3.9;0.0
83;2021-03-15;3334;720;0;89961;43081;0;8.4;4.0;0.0
83;2021-03-16;2599;758;0;92560;43839;0;8.6;4.1;0.0
83;2021-03-17;2896;823;0;95456;44662;0;8.9;4.2;0.0
83;2021-03-18;3535;859;0;98991;45521;0;9.2;4.2;0.0
83;2021-03-19;4169;672;0;103160;46193;0;9.6;4.3;0.0
83;2021-03-20;3403;102;0;106563;46295;0;9.9;4.3;0.0
83;2021-03-21;1911;35;0;108474;46330;0;10.1;4.3;0.0
83;2021-03-22;3938;946;0;112412;47276;0;10.5;4.4;0.0
83;2021-03-23;4688;647;0;117100;47923;0;10.9;4.5;0.0
83;2021-03-24;5018;789;0;122118;48712;0;11.4;4.5;0.0
83;2021-03-25;6521;947;0;128639;49659;0;12.0;4.6;0.0
83;2021-03-26;7131;844;0;135770;50503;0;12.6;4.7;0.0
83;2021-03-27;3925;395;0;139695;50898;0;13.0;4.7;0.0
83;2021-03-28;2094;40;0;141789;50938;0;13.2;4.7;0.0
83;2021-03-29;4547;810;0;146336;51748;0;13.6;4.8;0.0
83;2021-03-30;6081;1015;0;152417;52763;0;14.2;4.9;0.0
83;2021-03-31;5680;1083;0;158097;53846;0;14.7;5.0;0.0
83;2021-04-01;6182;1335;0;164279;55181;0;15.3;5.1;0.0
83;2021-04-02;5865;1150;0;170144;56331;0;15.8;5.2;0.0
83;2021-04-03;1916;710;0;172060;57041;0;16.0;5.3;0.0
83;2021-04-04;831;357;0;172891;57398;0;16.1;5.3;0.0
83;2021-04-05;305;78;0;173196;57476;0;16.1;5.4;0.0
83;2021-04-06;4779;1512;0;177975;58988;0;16.6;5.5;0.0
83;2021-04-07;5808;1725;0;183783;60713;0;17.1;5.7;0.0
83;2021-04-08;7767;2128;0;191550;62841;0;17.8;5.9;0.0
83;2021-04-09;7578;2247;0;199128;65088;0;18.5;6.1;0.0
83;2021-04-10;3013;2584;0;202141;67672;0;18.8;6.3;0.0
83;2021-04-11;1633;2009;0;203774;69681;0;19.0;6.5;0.0
83;2021-04-12;4912;2853;0;208686;72534;0;19.4;6.8;0.0
83;2021-04-13;5592;2969;0;214278;75503;0;20.0;7.0;0.0
83;2021-04-14;5976;2989;0;220254;78492;0;20.5;7.3;0.0
83;2021-04-15;6848;3052;0;227102;81544;0;21.1;7.6;0.0
83;2021-04-16;6168;3524;0;233270;85068;0;21.7;7.9;0.0
83;2021-04-17;3377;2107;0;236647;87175;0;22.0;8.1;0.0
83;2021-04-18;2057;1271;0;238704;88446;0;22.2;8.2;0.0
83;2021-04-19;4115;3820;0;242819;92266;0;22.6;8.6;0.0
83;2021-04-20;4427;3923;0;247246;96189;0;23.0;9.0;0.0
83;2021-04-21;4420;4131;0;251666;100320;0;23.4;9.3;0.0
83;2021-04-22;5065;4345;0;256731;104665;0;23.9;9.7;0.0
83;2021-04-23;4523;4507;0;261254;109172;0;24.3;10.2;0.0
83;2021-04-24;2638;2669;0;263892;111841;0;24.6;10.4;0.0
83;2021-04-25;1834;1501;0;265726;113342;0;24.7;10.6;0.0
83;2021-04-26;3543;3862;0;269269;117204;0;25.1;10.9;0.0
83;2021-04-27;4159;4620;0;273428;121824;0;25.5;11.3;0.0
83;2021-04-28;4402;4461;0;277830;126285;0;25.9;11.8;0.0
83;2021-04-29;5882;5197;0;283712;131482;0;26.4;12.2;0.0
83;2021-04-30;5805;4467;0;289517;135949;0;27.0;12.7;0.0
83;2021-05-01;1803;525;0;291320;136474;0;27.1;12.7;0.0
83;2021-05-02;1207;743;0;292527;137217;0;27.2;12.8;0.0
83;2021-05-03;3953;4227;0;296480;141444;0;27.6;13.2;0.0
83;2021-05-04;3629;5166;0;300109;146610;0;27.9;13.7;0.0
83;2021-05-05;3795;5001;0;303904;151611;0;28.3;14.1;0.0
83;2021-05-06;4901;4983;0;308805;156594;0;28.8;14.6;0.0
83;2021-05-07;4286;5350;0;313091;161944;0;29.2;15.1;0.0
83;2021-05-08;2760;1067;0;315851;163011;0;29.4;15.2;0.0
83;2021-05-09;1996;1189;0;317847;164200;0;29.6;15.3;0.0
83;2021-05-10;3280;5437;0;321127;169637;0;29.9;15.8;0.0
83;2021-05-11;5012;5767;0;326139;175404;0;30.4;16.3;0.0
83;2021-05-12;6097;4929;0;332236;180333;0;30.9;16.8;0.0
83;2021-05-13;5923;1299;0;338159;181632;0;31.5;16.9;0.0
83;2021-05-14;6952;3974;0;345111;185606;0;32.1;17.3;0.0
83;2021-05-15;7170;2235;0;352281;187841;0;32.8;17.5;0.0
83;2021-05-16;5987;1150;0;358268;188991;0;33.4;17.6;0.0
83;2021-05-17;4942;4138;0;363210;193129;0;33.8;18.0;0.0
83;2021-05-18;5540;3769;0;368750;196898;0;34.3;18.3;0.0
83;2021-05-19;6169;3486;0;374919;200384;0;34.9;18.7;0.0
83;2021-05-20;6786;3771;0;381705;204155;0;35.5;19.0;0.0
83;2021-05-21;7616;3827;0;389321;207982;0;36.3;19.4;0.0
83;2021-05-22;5491;1700;0;394812;209682;0;36.8;19.5;0.0
83;2021-05-23;4074;619;0;398886;210301;0;37.1;19.6;0.0
83;2021-05-24;5274;895;0;404160;211196;0;37.6;19.7;0.0
83;2021-05-25;5270;4680;0;409430;215876;0;38.1;20.1;0.0
83;2021-05-26;4870;4396;0;414300;220272;0;38.6;20.5;0.0
83;2021-05-27;5043;5165;0;419343;225437;0;39.1;21.0;0.0
83;2021-05-28;4436;5686;0;423779;231123;0;39.5;21.5;0.0
83;2021-05-29;2677;4201;0;426456;235324;0;39.7;21.9;0.0
83;2021-05-30;1140;1283;0;427596;236607;0;39.8;22.0;0.0
83;2021-05-31;5269;4815;0;432865;241422;0;40.3;22.5;0.0
83;2021-06-01;5714;5357;0;438579;246779;0;40.8;23.0;0.0
83;2021-06-02;5163;4706;0;443742;251485;0;41.3;23.4;0.0
83;2021-06-03;5718;5121;0;449460;256606;0;41.9;23.9;0.0
83;2021-06-04;5420;5927;0;454880;262533;0;42.4;24.4;0.0
83;2021-06-05;3777;3175;0;458657;265708;0;42.7;24.7;0.0
83;2021-06-06;1794;1324;0;460451;267032;0;42.9;24.9;0.0
83;2021-06-07;3817;5051;0;464268;272083;0;43.2;25.3;0.0
83;2021-06-08;4131;4789;0;468399;276872;0;43.6;25.8;0.0
83;2021-06-09;4021;4662;0;472420;281534;0;44.0;26.2;0.0
83;2021-06-10;4092;4213;0;476512;285747;0;44.4;26.6;0.0
83;2021-06-11;3636;5443;0;480148;291190;0;44.7;27.1;0.0
83;2021-06-12;2895;2981;0;483043;294171;0;45.0;27.4;0.0
83;2021-06-13;937;1290;0;483980;295461;0;45.1;27.5;0.0
83;2021-06-14;2785;5645;0;486765;301106;0;45.3;28.0;0.0
83;2021-06-15;3151;4993;0;489916;306099;0;45.6;28.5;0.0
83;2021-06-16;3113;4514;0;493029;310613;0;45.9;28.9;0.0
83;2021-06-17;2943;5257;0;495972;315870;0;46.2;29.4;0.0
83;2021-06-18;3193;5829;0;499165;321699;0;46.5;30.0;0.0
83;2021-06-19;2248;3976;0;501413;325675;0;46.7;30.3;0.0
83;2021-06-20;620;1734;0;502033;327409;0;46.8;30.5;0.0
83;2021-06-21;2048;7295;0;504081;334704;0;46.9;31.2;0.0
83;2021-06-22;2087;6944;0;506168;341648;0;47.1;31.8;0.0
83;2021-06-23;2042;6833;0;508210;348481;0;47.3;32.5;0.0
83;2021-06-24;2123;7056;0;510333;355537;0;47.5;33.1;0.0
83;2021-06-25;2160;8089;0;512493;363626;0;47.7;33.9;0.0
83;2021-06-26;1405;6463;0;513898;370089;0;47.9;34.5;0.0
83;2021-06-27;589;2952;0;514487;373041;0;47.9;34.7;0.0
83;2021-06-28;1471;7640;0;515958;380681;0;48.0;35.5;0.0
83;2021-06-29;1877;7590;0;517835;388271;0;48.2;36.2;0.0
83;2021-06-30;2197;7009;0;520032;395280;0;48.4;36.8;0.0
83;2021-07-01;2702;6432;0;522734;401712;0;48.7;37.4;0.0
83;2021-07-02;2437;7493;0;525171;409205;0;48.9;38.1;0.0
83;2021-07-03;1494;5393;0;526665;414598;0;49.0;38.6;0.0
83;2021-07-04;526;2501;0;527191;417099;0;49.1;38.8;0.0
83;2021-07-05;1917;7213;0;529108;424312;0;49.3;39.5;0.0
83;2021-07-06;2506;5817;0;531614;430129;0;49.5;40.1;0.0
83;2021-07-07;2647;4515;0;534261;434644;0;49.8;40.5;0.0
83;2021-07-08;3150;4388;0;537411;439032;0;50.0;40.9;0.0
83;2021-07-09;3035;6598;0;540446;445630;0;50.3;41.5;0.0
83;2021-07-10;1545;4700;0;541991;450330;0;50.5;41.9;0.0
83;2021-07-11;910;1638;0;542901;451968;0;50.6;42.1;0.0
83;2021-07-12;2112;7260;0;545013;459228;0;50.8;42.8;0.0
83;2021-07-13;3914;6816;0;548927;466044;0;51.1;43.4;0.0
83;2021-07-14;1956;1262;0;550883;467306;0;51.3;43.5;0.0
83;2021-07-15;4670;6709;0;555553;474015;0;51.7;44.1;0.0
83;2021-07-16;5239;6801;0;560792;480816;0;52.2;44.8;0.0
83;2021-07-17;3519;4824;0;564311;485640;0;52.6;45.2;0.0
83;2021-07-18;1529;1279;0;565840;486919;0;52.7;45.3;0.0
83;2021-07-19;3926;6107;0;569766;493026;0;53.1;45.9;0.0
83;2021-07-20;5740;5960;0;575506;498986;0;53.6;46.5;0.0
83;2021-07-21;5747;5048;0;581253;504034;0;54.1;46.9;0.0
83;2021-07-22;6907;5347;0;588160;509381;0;54.8;47.4;0.0
83;2021-07-23;6642;5499;0;594802;514880;0;55.4;47.9;0.0
83;2021-07-24;4426;4310;0;599228;519190;0;55.8;48.3;0.0
83;2021-07-25;1298;707;0;600526;519897;0;55.9;48.4;0.0
83;2021-07-26;5347;4405;0;605873;524302;0;56.4;48.8;0.0
83;2021-07-27;6644;4455;0;612517;528757;0;57.0;49.2;0.0
83;2021-07-28;6409;4068;0;618926;532825;0;57.6;49.6;0.0
83;2021-07-29;7383;4504;0;626309;537329;0;58.3;50.0;0.0
83;2021-07-30;6724;4352;0;633033;541681;0;59.0;50.4;0.0
83;2021-07-31;4475;2940;0;637508;544621;0;59.4;50.7;0.0
83;2021-08-01;1121;778;0;638629;545399;0;59.5;50.8;0.0
83;2021-08-02;5822;3210;0;644451;548609;0;60.0;51.1;0.0
83;2021-08-03;6224;3556;0;650675;552165;0;60.6;51.4;0.0
83;2021-08-04;5742;3128;0;656417;555293;0;61.1;51.7;0.0
83;2021-08-05;5972;3562;0;662389;558855;0;61.7;52.0;0.0
83;2021-08-06;5903;4129;0;668292;562984;0;62.2;52.4;0.0
83;2021-08-07;3553;3083;0;671845;566067;0;62.6;52.7;0.0
83;2021-08-08;997;756;0;672842;566823;0;62.7;52.8;0.0
83;2021-08-09;4489;3909;0;677331;570732;0;63.1;53.1;0.0
83;2021-08-10;5099;4452;0;682430;575184;0;63.6;53.6;0.0
83;2021-08-11;4462;4456;0;686892;579640;0;64.0;54.0;0.0
83;2021-08-12;4736;5074;0;691628;584714;0;64.4;54.5;0.0
83;2021-08-13;4565;4907;0;696193;589621;0;64.8;54.9;0.0
83;2021-08-14;3027;3599;0;699220;593220;0;65.1;55.2;0.0
83;2021-08-15;228;355;0;699448;593575;0;65.1;55.3;0.0
83;2021-08-16;3614;5007;0;703062;598582;0;65.5;55.7;0.0
83;2021-08-17;3598;5035;0;706660;603617;0;65.8;56.2;0.0
83;2021-08-18;3432;4805;0;710092;608422;0;66.1;56.7;0.0
83;2021-08-19;4037;5704;0;714129;614126;0;66.5;57.2;0.0
83;2021-08-20;3514;5947;0;717643;620073;0;66.8;57.7;0.0
83;2021-08-21;2175;4188;0;719818;624261;0;67.0;58.1;0.0
83;2021-08-22;584;978;0;720402;625239;0;67.1;58.2;0.0
83;2021-08-23;2442;5552;0;722844;630791;0;67.3;58.7;0.0
83;2021-08-24;2785;5698;0;725629;636489;0;67.6;59.3;0.0
83;2021-08-25;2487;5152;0;728116;641641;0;67.8;59.8;0.0
83;2021-08-26;2834;5751;0;730950;647392;0;68.1;60.3;0.0
83;2021-08-27;2852;5807;0;733802;653199;0;68.3;60.8;0.0
83;2021-08-28;1816;4299;0;735618;657498;0;68.5;61.2;0.0
83;2021-08-29;469;1190;0;736087;658688;0;68.5;61.3;0.0
83;2021-08-30;2288;5044;75;738375;663732;75;68.8;61.8;0.0
83;2021-08-31;2439;5397;170;740814;669129;245;69.0;62.3;0.0
83;2021-09-01;2814;4766;441;743628;673895;686;69.2;62.8;0.1
83;2021-09-02;2465;4393;464;746093;678288;1150;69.5;63.2;0.1
83;2021-09-03;2300;4713;546;748393;683001;1696;69.7;63.6;0.2
83;2021-09-04;1819;4327;227;750212;687328;1923;69.9;64.0;0.2
83;2021-09-05;533;434;110;750745;687762;2033;69.9;64.0;0.2
83;2021-09-06;1862;3360;702;752607;691122;2735;70.1;64.4;0.3
83;2021-09-07;1663;3258;673;754270;694380;3408;70.2;64.7;0.3
83;2021-09-08;1987;3503;515;756257;697883;3923;70.4;65.0;0.4
83;2021-09-09;1553;3326;635;757810;701209;4558;70.6;65.3;0.4
83;2021-09-10;1820;3674;746;759630;704883;5304;70.7;65.6;0.5
83;2021-09-11;1376;3571;262;761006;708454;5566;70.9;66.0;0.5
83;2021-09-12;219;454;43;761225;708908;5609;70.9;66.0;0.5
83;2021-09-13;1281;2500;906;762506;711408;6515;71.0;66.2;0.6
83;2021-09-14;1399;2489;1063;763905;713897;7578;71.1;66.5;0.7
83;2021-09-15;1442;2629;821;765347;716526;8399;71.3;66.7;0.8
83;2021-09-16;1067;2202;964;766414;718728;9363;71.4;66.9;0.9
83;2021-09-17;1062;2613;904;767476;721341;10267;71.5;67.2;1.0
83;2021-09-18;995;2918;289;768471;724259;10556;71.6;67.4;1.0
83;2021-09-19;112;407;51;768583;724666;10607;71.6;67.5;1.0
83;2021-09-20;756;2065;790;769339;726731;11397;71.6;67.7;1.1
83;2021-09-21;695;1798;795;770034;728529;12192;71.7;67.8;1.1
83;2021-09-22;775;2520;699;770809;731049;12891;71.8;68.1;1.2
83;2021-09-23;714;2070;749;771523;733119;13640;71.8;68.3;1.3
83;2021-09-24;790;2253;838;772313;735372;14478;71.9;68.5;1.3
83;2021-09-25;757;2613;280;773070;737985;14758;72.0;68.7;1.4
83;2021-09-26;76;441;30;773146;738426;14788;72.0;68.8;1.4
83;2021-09-27;584;1728;625;773730;740154;15413;72.1;68.9;1.4
83;2021-09-28;539;1482;643;774269;741636;16056;72.1;69.1;1.5
83;2021-09-29;722;1935;575;774991;743571;16631;72.2;69.2;1.5
83;2021-09-30;636;1511;806;775627;745082;17437;72.2;69.4;1.6
83;2021-10-01;1035;1553;844;776662;746635;18281;72.3;69.5;1.7
83;2021-10-02;702;1634;295;777364;748269;18576;72.4;69.7;1.7
83;2021-10-03;115;263;70;777479;748532;18646;72.4;69.7;1.7
83;2021-10-04;636;899;747;778115;749431;19393;72.5;69.8;1.8
83;2021-10-05;647;1146;1090;778762;750577;20483;72.5;69.9;1.9
83;2021-10-06;875;1641;1047;779637;752218;21530;72.6;70.0;2.0
83;2021-10-07;513;1087;1076;780150;753305;22606;72.7;70.2;2.1
83;2021-10-08;819;1425;1292;780969;754730;23898;72.7;70.3;2.2
83;2021-10-09;534;1033;402;781503;755763;24300;72.8;70.4;2.3
83;2021-10-10;26;67;7;781529;755830;24307;72.8;70.4;2.3
83;2021-10-11;658;1073;1332;782187;756903;25639;72.8;70.5;2.4
83;2021-10-12;531;831;1313;782718;757734;26952;72.9;70.6;2.5
83;2021-10-13;711;1102;1292;783429;758836;28244;73.0;70.7;2.6
83;2021-10-14;530;870;1493;783959;759706;29737;73.0;70.7;2.8
83;2021-10-15;760;1125;1825;784719;760831;31562;73.1;70.9;2.9
83;2021-10-16;569;886;550;785288;761717;32112;73.1;70.9;3.0
83;2021-10-17;31;45;15;785319;761762;32127;73.1;70.9;3.0
83;2021-10-18;565;815;1629;785884;762577;33756;73.2;71.0;3.1
83;2021-10-19;416;618;1266;786300;763195;35022;73.2;71.1;3.3
83;2021-10-20;607;907;1969;786907;764102;36991;73.3;71.2;3.4
83;2021-10-21;499;713;1793;787406;764815;38784;73.3;71.2;3.6
83;2021-10-22;548;795;1653;787954;765610;40437;73.4;71.3;3.8
83;2021-10-23;433;568;661;788387;766178;41098;73.4;71.3;3.8
83;2021-10-24;16;58;39;788403;766236;41137;73.4;71.4;3.8
83;2021-10-25;459;732;1949;788862;766968;43086;73.5;71.4;4.0
83;2021-10-26;437;619;2054;789299;767587;45140;73.5;71.5;4.2
83;2021-10-27;495;741;2486;789794;768328;47626;73.5;71.5;4.4
83;2021-10-28;420;598;2381;790214;768926;50007;73.6;71.6;4.7
83;2021-10-29;404;656;2075;790618;769582;52082;73.6;71.7;4.9
83;2021-10-30;368;486;895;790986;770068;52977;73.7;71.7;4.9
83;2021-10-31;21;45;36;791007;770113;53013;73.7;71.7;4.9
83;2021-11-01;73;49;77;791080;770162;53090;73.7;71.7;4.9
83;2021-11-02;381;635;1760;791461;770797;54850;73.7;71.8;5.1
83;2021-11-03;516;796;2921;791977;771593;57771;73.8;71.9;5.4
83;2021-11-04;373;597;2326;792350;772190;60097;73.8;71.9;5.6
83;2021-11-05;458;702;2674;792808;772892;62771;73.8;72.0;5.8
83;2021-11-06;317;553;1178;793125;773445;63949;73.9;72.0;6.0
83;2021-11-07;18;62;46;793143;773507;63995;73.9;72.0;6.0
83;2021-11-08;369;680;3417;793512;774187;67412;73.9;72.1;6.3
83;2021-11-09;369;520;3414;793881;774707;70826;73.9;72.1;6.6
83;2021-11-10;536;865;4494;794417;775572;75320;74.0;72.2;7.0
83;2021-11-11;51;98;110;794468;775670;75430;74.0;72.2;7.0
83;2021-11-12;416;649;3872;794884;776319;79302;74.0;72.3;7.4
83;2021-11-13;301;459;1527;795185;776778;80829;74.1;72.3;7.5
83;2021-11-14;13;64;91;795198;776842;80920;74.1;72.3;7.5
83;2021-11-15;370;574;4364;795568;777416;85284;74.1;72.4;7.9
83;2021-11-16;351;455;4046;795919;777871;89330;74.1;72.4;8.3
83;2021-11-17;514;744;4813;796433;778615;94143;74.2;72.5;8.8
83;2021-11-18;443;616;4594;796876;779231;98737;74.2;72.6;9.2
83;2021-11-19;570;632;4567;797446;779863;103304;74.3;72.6;9.6
83;2021-11-20;364;460;1882;797810;780323;105186;74.3;72.7;9.8
83;2021-11-21;27;55;68;797837;780378;105254;74.3;72.7;9.8
83;2021-11-22;472;388;4970;798309;780766;110224;74.3;72.7;10.3
83;2021-11-23;390;461;4603;798699;781227;114827;74.4;72.8;10.7
83;2021-11-24;639;690;5486;799338;781917;120313;74.4;72.8;11.2
83;2021-11-25;506;495;5924;799844;782412;126237;74.5;72.9;11.8
83;2021-11-26;584;598;7070;800428;783010;133307;74.5;72.9;12.4
83;2021-11-27;463;470;3647;800891;783480;136954;74.6;73.0;12.8
83;2021-11-28;40;60;186;800931;783540;137140;74.6;73.0;12.8
83;2021-11-29;445;506;7979;801376;784046;145119;74.6;73.0;13.5
83;2021-11-30;479;500;8306;801855;784546;153425;74.7;73.1;14.3
83;2021-12-01;484;628;9783;802339;785174;163208;74.7;73.1;15.2
83;2021-12-02;422;411;9965;802761;785585;173173;74.8;73.2;16.1
83;2021-12-03;531;611;10456;803292;786196;183629;74.8;73.2;17.1
83;2021-12-04;397;440;5492;803689;786636;189121;74.8;73.3;17.6
83;2021-12-05;40;100;1778;803729;786736;190899;74.8;73.3;17.8
83;2021-12-06;387;550;10342;804116;787286;201241;74.9;73.3;18.7
83;2021-12-07;490;570;11486;804606;787856;212727;74.9;73.4;19.8
83;2021-12-08;464;650;10830;805070;788506;223557;75.0;73.4;20.8
83;2021-12-09;488;609;11348;805558;789115;234905;75.0;73.5;21.9
83;2021-12-10;527;612;12001;806085;789727;246906;75.1;73.5;23.0
83;2021-12-11;420;489;5858;806505;790216;252764;75.1;73.6;23.5
83;2021-12-12;88;76;1051;806593;790292;253815;75.1;73.6;23.6
83;2021-12-13;425;537;11118;807018;790829;264933;75.2;73.6;24.7
83;2021-12-14;517;551;13108;807535;791380;278041;75.2;73.7;25.9
83;2021-12-15;540;698;12220;808075;792078;290261;75.3;73.8;27.0
83;2021-12-16;509;634;12551;808584;792712;302812;75.3;73.8;28.2
84;2020-12-27;0;0;0;0;0;0;0.0;0.0;0.0
84;2020-12-28;3;0;0;3;0;0;0.0;0.0;0.0
84;2020-12-29;3;0;0;6;0;0;0.0;0.0;0.0
84;2020-12-30;3;0;0;9;0;0;0.0;0.0;0.0
84;2020-12-31;0;0;0;9;0;0;0.0;0.0;0.0
84;2021-01-01;0;0;0;9;0;0;0.0;0.0;0.0
84;2021-01-02;0;0;0;9;0;0;0.0;0.0;0.0
84;2021-01-03;0;0;0;9;0;0;0.0;0.0;0.0
84;2021-01-04;5;0;0;14;0;0;0.0;0.0;0.0
84;2021-01-05;4;0;0;18;0;0;0.0;0.0;0.0
84;2021-01-06;7;0;0;25;0;0;0.0;0.0;0.0
84;2021-01-07;62;0;0;87;0;0;0.0;0.0;0.0
84;2021-01-08;70;0;0;157;0;0;0.0;0.0;0.0
84;2021-01-09;21;0;0;178;0;0;0.0;0.0;0.0
84;2021-01-10;1;0;0;179;0;0;0.0;0.0;0.0
84;2021-01-11;174;1;0;353;1;0;0.1;0.0;0.0
84;2021-01-12;561;3;0;914;4;0;0.2;0.0;0.0
84;2021-01-13;294;0;0;1208;4;0;0.2;0.0;0.0
84;2021-01-14;790;13;0;1998;17;0;0.4;0.0;0.0
84;2021-01-15;514;9;0;2512;26;0;0.4;0.0;0.0
84;2021-01-16;114;1;0;2626;27;0;0.5;0.0;0.0
84;2021-01-17;29;1;0;2655;28;0;0.5;0.0;0.0
84;2021-01-18;593;3;0;3248;31;0;0.6;0.0;0.0
84;2021-01-19;850;2;0;4098;33;0;0.7;0.0;0.0
84;2021-01-20;949;6;0;5047;39;0;0.9;0.0;0.0
84;2021-01-21;961;6;0;6008;45;0;1.1;0.0;0.0
84;2021-01-22;1006;0;0;7014;45;0;1.3;0.0;0.0
84;2021-01-23;215;0;0;7229;45;0;1.3;0.0;0.0
84;2021-01-24;6;0;0;7235;45;0;1.3;0.0;0.0
84;2021-01-25;701;5;0;7936;50;0;1.4;0.0;0.0
84;2021-01-26;876;9;0;8812;59;0;1.6;0.0;0.0
84;2021-01-27;980;6;0;9792;65;0;1.7;0.0;0.0
84;2021-01-28;1428;20;0;11220;85;0;2.0;0.0;0.0
84;2021-01-29;1077;48;0;12297;133;0;2.2;0.0;0.0
84;2021-01-30;124;19;0;12421;152;0;2.2;0.0;0.0
84;2021-01-31;13;0;0;12434;152;0;2.2;0.0;0.0
84;2021-02-01;607;148;0;13041;300;0;2.3;0.1;0.0
84;2021-02-02;745;223;0;13786;523;0;2.5;0.1;0.0
84;2021-02-03;627;224;0;14413;747;0;2.6;0.1;0.0
84;2021-02-04;799;359;0;15212;1106;0;2.7;0.2;0.0
84;2021-02-05;647;377;0;15859;1483;0;2.8;0.3;0.0
84;2021-02-06;107;43;0;15966;1526;0;2.8;0.3;0.0
84;2021-02-07;2;0;0;15968;1526;0;2.8;0.3;0.0
84;2021-02-08;543;259;0;16511;1785;0;2.9;0.3;0.0
84;2021-02-09;648;638;0;17159;2423;0;3.1;0.4;0.0
84;2021-02-10;525;568;0;17684;2991;0;3.2;0.5;0.0
84;2021-02-11;556;561;0;18240;3552;0;3.3;0.6;0.0
84;2021-02-12;534;614;0;18774;4166;0;3.3;0.7;0.0
84;2021-02-13;54;114;0;18828;4280;0;3.4;0.8;0.0
84;2021-02-14;4;8;0;18832;4288;0;3.4;0.8;0.0
84;2021-02-15;200;734;0;19032;5022;0;3.4;0.9;0.0
84;2021-02-16;223;724;0;19255;5746;0;3.4;1.0;0.0
84;2021-02-17;415;765;0;19670;6511;0;3.5;1.2;0.0
84;2021-02-18;503;1029;0;20173;7540;0;3.6;1.3;0.0
84;2021-02-19;711;1049;0;20884;8589;0;3.7;1.5;0.0
84;2021-02-20;68;116;0;20952;8705;0;3.7;1.6;0.0
84;2021-02-21;5;35;0;20957;8740;0;3.7;1.6;0.0
84;2021-02-22;306;644;0;21263;9384;0;3.8;1.7;0.0
84;2021-02-23;274;664;0;21537;10048;0;3.8;1.8;0.0
84;2021-02-24;378;689;0;21915;10737;0;3.9;1.9;0.0
84;2021-02-25;697;756;0;22612;11493;0;4.0;2.0;0.0
84;2021-02-26;811;610;0;23423;12103;0;4.2;2.2;0.0
84;2021-02-27;142;106;0;23565;12209;0;4.2;2.2;0.0
84;2021-02-28;13;2;0;23578;12211;0;4.2;2.2;0.0
84;2021-03-01;461;566;0;24039;12777;0;4.3;2.3;0.0
84;2021-03-02;632;711;0;24671;13488;0;4.4;2.4;0.0
84;2021-03-03;874;810;0;25545;14298;0;4.6;2.5;0.0
84;2021-03-04;1130;607;0;26675;14905;0;4.8;2.7;0.0
84;2021-03-05;1314;505;0;27989;15410;0;5.0;2.7;0.0
84;2021-03-06;1378;68;0;29367;15478;0;5.2;2.8;0.0
84;2021-03-07;557;28;0;29924;15506;0;5.3;2.8;0.0
84;2021-03-08;748;586;0;30672;16092;0;5.5;2.9;0.0
84;2021-03-09;1345;656;0;32017;16748;0;5.7;3.0;0.0
84;2021-03-10;1444;603;0;33461;17351;0;6.0;3.1;0.0
84;2021-03-11;1939;613;0;35400;17964;0;6.3;3.2;0.0
84;2021-03-12;2057;608;0;37457;18572;0;6.7;3.3;0.0
84;2021-03-13;832;47;0;38289;18619;0;6.8;3.3;0.0
84;2021-03-14;287;47;0;38576;18666;0;6.9;3.3;0.0
84;2021-03-15;1067;306;0;39643;18972;0;7.1;3.4;0.0
84;2021-03-16;1160;318;0;40803;19290;0;7.3;3.4;0.0
84;2021-03-17;1169;462;0;41972;19752;0;7.5;3.5;0.0
84;2021-03-18;1449;399;0;43421;20151;0;7.7;3.6;0.0
84;2021-03-19;2101;470;0;45522;20621;0;8.1;3.7;0.0
84;2021-03-20;880;48;0;46402;20669;0;8.3;3.7;0.0
84;2021-03-21;148;9;0;46550;20678;0;8.3;3.7;0.0
84;2021-03-22;1218;445;0;47768;21123;0;8.5;3.8;0.0
84;2021-03-23;1951;429;0;49719;21552;0;8.9;3.8;0.0
84;2021-03-24;2116;391;0;51835;21943;0;9.2;3.9;0.0
84;2021-03-25;3546;401;0;55381;22344;0;9.9;4.0;0.0
84;2021-03-26;3280;485;0;58661;22829;0;10.5;4.1;0.0
84;2021-03-27;944;83;0;59605;22912;0;10.6;4.1;0.0
84;2021-03-28;86;2;0;59691;22914;0;10.6;4.1;0.0
84;2021-03-29;1707;557;0;61398;23471;0;10.9;4.2;0.0
84;2021-03-30;2627;723;0;64025;24194;0;11.4;4.3;0.0
84;2021-03-31;2313;679;0;66338;24873;0;11.8;4.4;0.0
84;2021-04-01;2980;597;0;69318;25470;0;12.4;4.5;0.0
84;2021-04-02;2370;562;0;71688;26032;0;12.8;4.6;0.0
84;2021-04-03;528;83;0;72216;26115;0;12.9;4.7;0.0
84;2021-04-04;24;8;0;72240;26123;0;12.9;4.7;0.0
84;2021-04-05;808;111;0;73048;26234;0;13.0;4.7;0.0
84;2021-04-06;2045;861;0;75093;27095;0;13.4;4.8;0.0
84;2021-04-07;2345;916;0;77438;28011;0;13.8;5.0;0.0
84;2021-04-08;3524;1042;0;80962;29053;0;14.4;5.2;0.0
84;2021-04-09;3948;915;0;84910;29968;0;15.1;5.3;0.0
84;2021-04-10;1412;185;0;86322;30153;0;15.4;5.4;0.0
84;2021-04-11;60;26;0;86382;30179;0;15.4;5.4;0.0
84;2021-04-12;2124;850;0;88506;31029;0;15.8;5.5;0.0
84;2021-04-13;2855;1375;0;91361;32404;0;16.3;5.8;0.0
84;2021-04-14;2668;1331;0;94029;33735;0;16.8;6.0;0.0
84;2021-04-15;3162;1376;0;97191;35111;0;17.3;6.3;0.0
84;2021-04-16;3306;1465;0;100497;36576;0;17.9;6.5;0.0
84;2021-04-17;1504;252;0;102001;36828;0;18.2;6.6;0.0
84;2021-04-18;71;23;0;102072;36851;0;18.2;6.6;0.0
84;2021-04-19;2316;1040;0;104388;37891;0;18.6;6.8;0.0
84;2021-04-20;2518;1586;0;106906;39477;0;19.1;7.0;0.0
84;2021-04-21;2480;1534;0;109386;41011;0;19.5;7.3;0.0
84;2021-04-22;2805;1686;0;112191;42697;0;20.0;7.6;0.0
84;2021-04-23;2735;1809;0;114926;44506;0;20.5;7.9;0.0
84;2021-04-24;1388;354;0;116314;44860;0;20.7;8.0;0.0
84;2021-04-25;88;27;0;116402;44887;0;20.7;8.0;0.0
84;2021-04-26;2085;1397;0;118487;46284;0;21.1;8.3;0.0
84;2021-04-27;2458;1950;0;120945;48234;0;21.6;8.6;0.0
84;2021-04-28;2617;1787;0;123562;50021;0;22.0;8.9;0.0
84;2021-04-29;3141;1989;0;126703;52010;0;22.6;9.3;0.0
84;2021-04-30;2905;2226;0;129608;54236;0;23.1;9.7;0.0
84;2021-05-01;531;275;0;130139;54511;0;23.2;9.7;0.0
84;2021-05-02;134;29;0;130273;54540;0;23.2;9.7;0.0
84;2021-05-03;2081;1692;0;132354;56232;0;23.6;10.0;0.0
84;2021-05-04;2427;2423;0;134781;58655;0;24.0;10.5;0.0
84;2021-05-05;2269;2227;0;137050;60882;0;24.4;10.9;0.0
84;2021-05-06;3105;2211;0;140155;63093;0;25.0;11.2;0.0
84;2021-05-07;2620;2466;0;142775;65559;0;25.5;11.7;0.0
84;2021-05-08;1141;557;0;143916;66116;0;25.7;11.8;0.0
84;2021-05-09;90;82;0;144006;66198;0;25.7;11.8;0.0
84;2021-05-10;2017;2392;0;146023;68590;0;26.0;12.2;0.0
84;2021-05-11;2882;3032;0;148905;71622;0;26.5;12.8;0.0
84;2021-05-12;2801;2730;0;151706;74352;0;27.0;13.3;0.0
84;2021-05-13;2136;832;0;153842;75184;0;27.4;13.4;0.0
84;2021-05-14;2763;1983;0;156605;77167;0;27.9;13.8;0.0
84;2021-05-15;2161;982;0;158766;78149;0;28.3;13.9;0.0
84;2021-05-16;1380;193;0;160146;78342;0;28.5;14.0;0.0
84;2021-05-17;2286;2023;0;162432;80365;0;29.0;14.3;0.0
84;2021-05-18;2918;2016;0;165350;82381;0;29.5;14.7;0.0
84;2021-05-19;3245;1636;0;168595;84017;0;30.1;15.0;0.0
84;2021-05-20;3723;2119;0;172318;86136;0;30.7;15.4;0.0
84;2021-05-21;3503;2215;0;175821;88351;0;31.3;15.7;0.0
84;2021-05-22;1630;650;0;177451;89001;0;31.6;15.9;0.0
84;2021-05-23;178;31;0;177629;89032;0;31.7;15.9;0.0
84;2021-05-24;1895;421;0;179524;89453;0;32.0;15.9;0.0
84;2021-05-25;2953;2145;0;182477;91598;0;32.5;16.3;0.0
84;2021-05-26;3003;2045;0;185480;93643;0;33.1;16.7;0.0
84;2021-05-27;3654;2217;0;189134;95860;0;33.7;17.1;0.0
84;2021-05-28;3023;3082;0;192157;98942;0;34.3;17.6;0.0
84;2021-05-29;1213;1541;0;193370;100483;0;34.5;17.9;0.0
84;2021-05-30;67;108;0;193437;100591;0;34.5;17.9;0.0
84;2021-05-31;2140;2494;0;195577;103085;0;34.9;18.4;0.0
84;2021-06-01;3081;3006;0;198658;106091;0;35.4;18.9;0.0
84;2021-06-02;2998;2413;0;201656;108504;0;35.9;19.3;0.0
84;2021-06-03;3959;2832;0;205615;111336;0;36.7;19.8;0.0
84;2021-06-04;3500;2889;0;209115;114225;0;37.3;20.4;0.0
84;2021-06-05;1665;1384;0;210780;115609;0;37.6;20.6;0.0
84;2021-06-06;880;195;0;211660;115804;0;37.7;20.6;0.0
84;2021-06-07;2340;2645;0;214000;118449;0;38.1;21.1;0.0
84;2021-06-08;3113;2913;0;217113;121362;0;38.7;21.6;0.0
84;2021-06-09;2783;2512;0;219896;123874;0;39.2;22.1;0.0
84;2021-06-10;3278;2693;0;223174;126567;0;39.8;22.6;0.0
84;2021-06-11;2873;2955;0;226047;129522;0;40.3;23.1;0.0
84;2021-06-12;1769;1286;0;227816;130808;0;40.6;23.3;0.0
84;2021-06-13;389;198;0;228205;131006;0;40.7;23.4;0.0
84;2021-06-14;1785;3121;0;229990;134127;0;41.0;23.9;0.0
84;2021-06-15;2312;3301;0;232302;137428;0;41.4;24.5;0.0
84;2021-06-16;2434;2852;0;234736;140280;0;41.8;25.0;0.0
84;2021-06-17;2673;3331;0;237409;143611;0;42.3;25.6;0.0
84;2021-06-18;2241;3418;0;239650;147029;0;42.7;26.2;0.0
84;2021-06-19;1193;1581;0;240843;148610;0;42.9;26.5;0.0
84;2021-06-20;426;329;0;241269;148939;0;43.0;26.5;0.0
84;2021-06-21;1478;3082;0;242747;152021;0;43.3;27.1;0.0
84;2021-06-22;2035;3861;0;244782;155882;0;43.6;27.8;0.0
84;2021-06-23;1947;3244;0;246729;159126;0;44.0;28.4;0.0
84;2021-06-24;1996;3444;0;248725;162570;0;44.3;29.0;0.0
84;2021-06-25;1716;3845;0;250441;166415;0;44.6;29.7;0.0
84;2021-06-26;1049;1740;0;251490;168155;0;44.8;30.0;0.0
84;2021-06-27;243;379;0;251733;168534;0;44.9;30.0;0.0
84;2021-06-28;1081;3175;0;252814;171709;0;45.1;30.6;0.0
84;2021-06-29;1282;3855;0;254096;175564;0;45.3;31.3;0.0
84;2021-06-30;1643;3829;0;255739;179393;0;45.6;32.0;0.0
84;2021-07-01;1840;3721;0;257579;183114;0;45.9;32.6;0.0
84;2021-07-02;1772;3839;0;259351;186953;0;46.2;33.3;0.0
84;2021-07-03;1027;1948;0;260378;188901;0;46.4;33.7;0.0
84;2021-07-04;322;481;0;260700;189382;0;46.5;33.8;0.0
84;2021-07-05;1331;3332;0;262031;192714;0;46.7;34.4;0.0
84;2021-07-06;1517;3910;0;263548;196624;0;47.0;35.0;0.0
84;2021-07-07;1574;2836;0;265122;199460;0;47.3;35.6;0.0
84;2021-07-08;1963;3462;0;267085;202922;0;47.6;36.2;0.0
84;2021-07-09;1820;3784;0;268905;206706;0;47.9;36.8;0.0
84;2021-07-10;1118;2107;0;270023;208813;0;48.1;37.2;0.0
84;2021-07-11;307;285;0;270330;209098;0;48.2;37.3;0.0
84;2021-07-12;1316;3599;0;271646;212697;0;48.4;37.9;0.0
84;2021-07-13;2140;4658;0;273786;217355;0;48.8;38.7;0.0
84;2021-07-14;1685;1171;0;275471;218526;0;49.1;39.0;0.0
84;2021-07-15;2584;4273;0;278055;222799;0;49.6;39.7;0.0
84;2021-07-16;2711;4264;0;280766;227063;0;50.0;40.5;0.0
84;2021-07-17;1467;2268;0;282233;229331;0;50.3;40.9;0.0
84;2021-07-18;816;480;0;283049;229811;0;50.5;41.0;0.0
84;2021-07-19;2212;3487;0;285261;233298;0;50.8;41.6;0.0
84;2021-07-20;2945;3914;0;288206;237212;0;51.4;42.3;0.0
84;2021-07-21;3027;3483;0;291233;240695;0;51.9;42.9;0.0
84;2021-07-22;3568;3508;0;294801;244203;0;52.5;43.5;0.0
84;2021-07-23;3385;3438;0;298186;247641;0;53.2;44.1;0.0
84;2021-07-24;1525;2101;0;299711;249742;0;53.4;44.5;0.0
84;2021-07-25;877;432;0;300588;250174;0;53.6;44.6;0.0
84;2021-07-26;2507;2817;0;303095;252991;0;54.0;45.1;0.0
84;2021-07-27;3278;3223;0;306373;256214;0;54.6;45.7;0.0
84;2021-07-28;3431;2928;0;309804;259142;0;55.2;46.2;0.0
84;2021-07-29;3855;2929;0;313659;262071;0;55.9;46.7;0.0
84;2021-07-30;3746;3055;0;317405;265126;0;56.6;47.3;0.0
84;2021-07-31;1885;1565;0;319290;266691;0;56.9;47.5;0.0
84;2021-08-01;750;402;0;320040;267093;0;57.0;47.6;0.0
84;2021-08-02;2853;2465;0;322893;269558;0;57.6;48.0;0.0
84;2021-08-03;3729;2459;0;326622;272017;0;58.2;48.5;0.0
84;2021-08-04;3367;2236;0;329989;274253;0;58.8;48.9;0.0
84;2021-08-05;3482;2363;0;333471;276616;0;59.4;49.3;0.0
84;2021-08-06;3309;2593;0;336780;279209;0;60.0;49.8;0.0
84;2021-08-07;1755;1546;0;338535;280755;0;60.3;50.0;0.0
84;2021-08-08;321;607;0;338856;281362;0;60.4;50.2;0.0
84;2021-08-09;2548;2366;0;341404;283728;0;60.9;50.6;0.0
84;2021-08-10;3270;2565;0;344674;286293;0;61.4;51.0;0.0
84;2021-08-11;2828;2327;0;347502;288620;0;61.9;51.4;0.0
84;2021-08-12;2806;2678;0;350308;291298;0;62.4;51.9;0.0
84;2021-08-13;2658;2413;0;352966;293711;0;62.9;52.4;0.0
84;2021-08-14;1360;1641;0;354326;295352;0;63.2;52.6;0.0
84;2021-08-15;236;209;0;354562;295561;0;63.2;52.7;0.0
84;2021-08-16;2107;2852;0;356669;298413;0;63.6;53.2;0.0
84;2021-08-17;2344;2908;0;359013;301321;0;64.0;53.7;0.0
84;2021-08-18;2019;2583;0;361032;303904;0;64.4;54.2;0.0
84;2021-08-19;2096;2827;0;363128;306731;0;64.7;54.7;0.0
84;2021-08-20;1870;3014;0;364998;309745;0;65.1;55.2;0.0
84;2021-08-21;987;1722;0;365985;311467;0;65.2;55.5;0.0
84;2021-08-22;118;575;0;366103;312042;0;65.3;55.6;0.0
84;2021-08-23;1567;3038;0;367670;315080;0;65.5;56.2;0.0
84;2021-08-24;1759;3133;0;369429;318213;0;65.9;56.7;0.0
84;2021-08-25;1675;2999;0;371104;321212;0;66.2;57.3;0.0
84;2021-08-26;1442;3301;0;372546;324513;0;66.4;57.8;0.0
84;2021-08-27;1477;3441;0;374023;327954;0;66.7;58.5;0.0
84;2021-08-28;761;1983;0;374784;329937;0;66.8;58.8;0.0
84;2021-08-29;113;508;0;374897;330445;0;66.8;58.9;0.0
84;2021-08-30;1264;2891;40;376161;333336;40;67.1;59.4;0.0
84;2021-08-31;1240;3578;72;377401;336914;112;67.3;60.1;0.0
84;2021-09-01;1299;2996;143;378700;339910;255;67.5;60.6;0.0
84;2021-09-02;1123;2613;291;379823;342523;546;67.7;61.1;0.1
84;2021-09-03;1234;3154;227;381057;345677;773;67.9;61.6;0.1
84;2021-09-04;675;1726;73;381732;347403;846;68.0;61.9;0.2
84;2021-09-05;104;337;6;381836;347740;852;68.1;62.0;0.2
84;2021-09-06;785;2009;267;382621;349749;1119;68.2;62.3;0.2
84;2021-09-07;885;2155;372;383506;351904;1491;68.4;62.7;0.3
84;2021-09-08;836;2343;241;384342;354247;1732;68.5;63.1;0.3
84;2021-09-09;849;1908;388;385191;356155;2120;68.7;63.5;0.4
84;2021-09-10;873;2250;337;386064;358405;2457;68.8;63.9;0.4
84;2021-09-11;528;1559;120;386592;359964;2577;68.9;64.2;0.5
84;2021-09-12;86;192;5;386678;360156;2582;68.9;64.2;0.5
84;2021-09-13;654;1369;491;387332;361525;3073;69.0;64.4;0.5
84;2021-09-14;779;1395;528;388111;362920;3601;69.2;64.7;0.6
84;2021-09-15;774;1749;406;388885;364669;4007;69.3;65.0;0.7
84;2021-09-16;533;1149;499;389418;365818;4506;69.4;65.2;0.8
84;2021-09-17;577;1463;518;389995;367281;5024;69.5;65.5;0.9
84;2021-09-18;414;1252;141;390409;368533;5165;69.6;65.7;0.9
84;2021-09-19;43;140;0;390452;368673;5165;69.6;65.7;0.9
84;2021-09-20;312;818;317;390764;369491;5482;69.7;65.9;1.0
84;2021-09-21;361;1059;453;391125;370550;5935;69.7;66.1;1.1
84;2021-09-22;413;1435;488;391538;371985;6423;69.8;66.3;1.1
84;2021-09-23;357;1035;483;391895;373020;6906;69.9;66.5;1.2
84;2021-09-24;397;1143;348;392292;374163;7254;69.9;66.7;1.3
84;2021-09-25;286;1030;161;392578;375193;7415;70.0;66.9;1.3
84;2021-09-26;38;115;7;392616;375308;7422;70.0;66.9;1.3
84;2021-09-27;278;715;337;392894;376023;7759;70.0;67.0;1.4
84;2021-09-28;321;684;419;393215;376707;8178;70.1;67.1;1.5
84;2021-09-29;319;1072;430;393534;377779;8608;70.1;67.3;1.5
84;2021-09-30;337;813;532;393871;378592;9140;70.2;67.5;1.6
84;2021-10-01;572;800;398;394443;379392;9538;70.3;67.6;1.7
84;2021-10-02;265;708;183;394708;380100;9721;70.4;67.8;1.7
84;2021-10-03;34;72;2;394742;380172;9723;70.4;67.8;1.7
84;2021-10-04;365;506;415;395107;380678;10138;70.4;67.9;1.8
84;2021-10-05;352;484;468;395459;381162;10606;70.5;67.9;1.9
84;2021-10-06;361;733;498;395820;381895;11104;70.6;68.1;2.0
84;2021-10-07;353;599;569;396173;382494;11673;70.6;68.2;2.1
84;2021-10-08;441;722;680;396614;383216;12353;70.7;68.3;2.2
84;2021-10-09;216;549;209;396830;383765;12562;70.7;68.4;2.2
84;2021-10-10;25;91;6;396855;383856;12568;70.7;68.4;2.2
84;2021-10-11;284;362;322;397139;384218;12890;70.8;68.5;2.3
84;2021-10-12;334;402;637;397473;384620;13527;70.9;68.6;2.4
84;2021-10-13;390;567;609;397863;385187;14136;70.9;68.7;2.5
84;2021-10-14;279;396;555;398142;385583;14691;71.0;68.7;2.6
84;2021-10-15;300;557;665;398442;386140;15356;71.0;68.8;2.7
84;2021-10-16;287;373;225;398729;386513;15581;71.1;68.9;2.8
84;2021-10-17;23;47;7;398752;386560;15588;71.1;68.9;2.8
84;2021-10-18;252;352;553;399004;386912;16141;71.1;69.0;2.9
84;2021-10-19;221;380;787;399225;387292;16928;71.2;69.0;3.0
84;2021-10-20;313;459;934;399538;387751;17862;71.2;69.1;3.2
84;2021-10-21;219;361;680;399757;388112;18542;71.3;69.2;3.3
84;2021-10-22;247;482;830;400004;388594;19372;71.3;69.3;3.5
84;2021-10-23;209;285;222;400213;388879;19594;71.3;69.3;3.5
84;2021-10-24;20;28;4;400233;388907;19598;71.3;69.3;3.5
84;2021-10-25;252;356;613;400485;389263;20211;71.4;69.4;3.6
84;2021-10-26;243;324;758;400728;389587;20969;71.4;69.4;3.7
84;2021-10-27;223;397;1139;400951;389984;22108;71.5;69.5;3.9
84;2021-10-28;168;242;672;401119;390226;22780;71.5;69.6;4.1
84;2021-10-29;234;443;983;401353;390669;23763;71.5;69.6;4.2
84;2021-10-30;148;211;379;401501;390880;24142;71.6;69.7;4.3
84;2021-10-31;13;24;9;401514;390904;24151;71.6;69.7;4.3
84;2021-11-01;38;41;42;401552;390945;24193;71.6;69.7;4.3
84;2021-11-02;233;277;804;401785;391222;24997;71.6;69.7;4.5
84;2021-11-03;268;434;1050;402053;391656;26047;71.7;69.8;4.6
84;2021-11-04;170;251;920;402223;391907;26967;71.7;69.9;4.8
84;2021-11-05;234;346;1203;402457;392253;28170;71.7;69.9;5.0
84;2021-11-06;191;307;591;402648;392560;28761;71.8;70.0;5.1
84;2021-11-07;27;42;38;402675;392602;28799;71.8;70.0;5.1
84;2021-11-08;146;237;1054;402821;392839;29853;71.8;70.0;5.3
84;2021-11-09;184;344;1409;403005;393183;31262;71.8;70.1;5.6
84;2021-11-10;248;418;1539;403253;393601;32801;71.9;70.2;5.8
84;2021-11-11;45;45;156;403298;393646;32957;71.9;70.2;5.9
84;2021-11-12;207;243;1409;403505;393889;34366;71.9;70.2;6.1
84;2021-11-13;140;213;551;403645;394102;34917;72.0;70.3;6.2
84;2021-11-14;28;34;46;403673;394136;34963;72.0;70.3;6.2
84;2021-11-15;166;232;1241;403839;394368;36204;72.0;70.3;6.5
84;2021-11-16;177;271;1784;404016;394639;37988;72.0;70.3;6.8
84;2021-11-17;246;338;2049;404262;394977;40037;72.1;70.4;7.1
84;2021-11-18;186;243;1469;404448;395220;41506;72.1;70.4;7.4
84;2021-11-19;267;359;2016;404715;395579;43522;72.1;70.5;7.8
84;2021-11-20;184;205;771;404899;395784;44293;72.2;70.6;7.9
84;2021-11-21;18;32;85;404917;395816;44378;72.2;70.6;7.9
84;2021-11-22;177;220;1442;405094;396036;45820;72.2;70.6;8.2
84;2021-11-23;206;278;2333;405300;396314;48153;72.2;70.6;8.6
84;2021-11-24;248;312;2011;405548;396626;50164;72.3;70.7;8.9
84;2021-11-25;246;214;2224;405794;396840;52388;72.3;70.7;9.3
84;2021-11-26;246;333;3229;406040;397173;55617;72.4;70.8;9.9
84;2021-11-27;172;246;1762;406212;397419;57379;72.4;70.8;10.2
84;2021-11-28;38;48;412;406250;397467;57791;72.4;70.9;10.3
84;2021-11-29;128;195;2645;406378;397662;60436;72.4;70.9;10.8
84;2021-11-30;219;249;4040;406597;397911;64476;72.5;70.9;11.5
84;2021-12-01;234;281;3859;406831;398192;68335;72.5;71.0;12.2
84;2021-12-02;192;185;4782;407023;398377;73117;72.6;71.0;13.0
84;2021-12-03;239;262;5323;407262;398639;78440;72.6;71.1;14.0
84;2021-12-04;155;171;2565;407417;398810;81005;72.6;71.1;14.4
84;2021-12-05;51;49;753;407468;398859;81758;72.6;71.1;14.6
84;2021-12-06;138;180;3892;407606;399039;85650;72.7;71.1;15.3
84;2021-12-07;225;297;6387;407831;399336;92037;72.7;71.2;16.4
84;2021-12-08;226;306;5335;408057;399642;97372;72.7;71.2;17.4
84;2021-12-09;194;276;5975;408251;399918;103347;72.8;71.3;18.4
84;2021-12-10;207;346;5766;408458;400264;109113;72.8;71.3;19.4
84;2021-12-11;193;221;3023;408651;400485;112136;72.8;71.4;20.0
84;2021-12-12;69;52;1004;408720;400537;113140;72.9;71.4;20.2
84;2021-12-13;187;230;4342;408907;400767;117482;72.9;71.4;20.9
84;2021-12-14;275;328;6749;409182;401095;124231;72.9;71.5;22.1
84;2021-12-15;258;293;5883;409440;401388;130114;73.0;71.5;23.2
84;2021-12-16;249;327;6932;409689;401715;137046;73.0;71.6;24.4
85;2020-12-27;0;0;0;0;0;0;0.0;0.0;0.0
85;2020-12-28;0;0;0;0;0;0;0.0;0.0;0.0
85;2020-12-29;0;0;0;0;0;0;0.0;0.0;0.0
85;2020-12-30;0;0;0;0;0;0;0.0;0.0;0.0
85;2020-12-31;0;0;0;0;0;0;0.0;0.0;0.0
85;2021-01-01;0;0;0;0;0;0;0.0;0.0;0.0
85;2021-01-02;0;0;0;0;0;0;0.0;0.0;0.0
85;2021-01-03;0;0;0;0;0;0;0.0;0.0;0.0
85;2021-01-04;22;0;0;22;0;0;0.0;0.0;0.0
85;2021-01-05;57;0;0;79;0;0;0.0;0.0;0.0
85;2021-01-06;94;1;0;173;1;0;0.0;0.0;0.0
85;2021-01-07;164;0;0;337;1;0;0.0;0.0;0.0
85;2021-01-08;289;2;0;626;3;0;0.1;0.0;0.0
85;2021-01-09;284;1;0;910;4;0;0.1;0.0;0.0
85;2021-01-10;66;0;0;976;4;0;0.1;0.0;0.0
85;2021-01-11;453;0;0;1429;4;0;0.2;0.0;0.0
85;2021-01-12;568;1;0;1997;5;0;0.3;0.0;0.0
85;2021-01-13;567;2;0;2564;7;0;0.4;0.0;0.0
85;2021-01-14;701;6;0;3265;13;0;0.5;0.0;0.0
85;2021-01-15;447;3;0;3712;16;0;0.5;0.0;0.0
85;2021-01-16;264;3;0;3976;19;0;0.6;0.0;0.0
85;2021-01-17;39;0;0;4015;19;0;0.6;0.0;0.0
85;2021-01-18;1010;3;0;5025;22;0;0.7;0.0;0.0
85;2021-01-19;1402;18;0;6427;40;0;0.9;0.0;0.0
85;2021-01-20;1917;6;0;8344;46;0;1.2;0.0;0.0
85;2021-01-21;3171;14;0;11515;60;0;1.7;0.0;0.0
85;2021-01-22;1685;20;0;13200;80;0;1.9;0.0;0.0
85;2021-01-23;458;1;0;13658;81;0;2.0;0.0;0.0
85;2021-01-24;46;0;0;13704;81;0;2.0;0.0;0.0
85;2021-01-25;581;1;0;14285;82;0;2.1;0.0;0.0
85;2021-01-26;928;31;0;15213;113;0;2.2;0.0;0.0
85;2021-01-27;1809;30;0;17022;143;0;2.5;0.0;0.0
85;2021-01-28;1733;23;0;18755;166;0;2.7;0.0;0.0
85;2021-01-29;892;72;0;19647;238;0;2.9;0.0;0.0
85;2021-01-30;155;9;0;19802;247;0;2.9;0.0;0.0
85;2021-01-31;4;50;0;19806;297;0;2.9;0.0;0.0
85;2021-02-01;481;118;0;20287;415;0;3.0;0.1;0.0
85;2021-02-02;548;172;0;20835;587;0;3.0;0.1;0.0
85;2021-02-03;427;283;0;21262;870;0;3.1;0.1;0.0
85;2021-02-04;622;280;0;21884;1150;0;3.2;0.2;0.0
85;2021-02-05;647;281;0;22531;1431;0;3.3;0.2;0.0
85;2021-02-06;158;238;0;22689;1669;0;3.3;0.2;0.0
85;2021-02-07;4;5;0;22693;1674;0;3.3;0.2;0.0
85;2021-02-08;380;649;0;23073;2323;0;3.4;0.3;0.0
85;2021-02-09;655;1029;0;23728;3352;0;3.5;0.5;0.0
85;2021-02-10;596;1134;0;24324;4486;0;3.6;0.7;0.0
85;2021-02-11;1507;2924;0;25831;7410;0;3.8;1.1;0.0
85;2021-02-12;1024;1289;0;26855;8699;0;3.9;1.3;0.0
85;2021-02-13;241;470;0;27096;9169;0;4.0;1.3;0.0
85;2021-02-14;3;127;0;27099;9296;0;4.0;1.4;0.0
85;2021-02-15;349;829;0;27448;10125;0;4.0;1.5;0.0
85;2021-02-16;586;1198;0;28034;11323;0;4.1;1.7;0.0
85;2021-02-17;760;1600;0;28794;12923;0;4.2;1.9;0.0
85;2021-02-18;1223;1949;0;30017;14872;0;4.4;2.2;0.0
85;2021-02-19;938;1210;0;30955;16082;0;4.5;2.4;0.0
85;2021-02-20;186;262;0;31141;16344;0;4.6;2.4;0.0
85;2021-02-21;3;13;0;31144;16357;0;4.6;2.4;0.0
85;2021-02-22;797;870;0;31941;17227;0;4.7;2.5;0.0
85;2021-02-23;825;520;0;32766;17747;0;4.8;2.6;0.0
85;2021-02-24;765;343;0;33531;18090;0;4.9;2.6;0.0
85;2021-02-25;1313;432;0;34844;18522;0;5.1;2.7;0.0
85;2021-02-26;1264;367;0;36108;18889;0;5.3;2.8;0.0
85;2021-02-27;422;105;0;36530;18994;0;5.3;2.8;0.0
85;2021-02-28;9;2;0;36539;18996;0;5.3;2.8;0.0
85;2021-03-01;768;435;0;37307;19431;0;5.5;2.8;0.0
85;2021-03-02;1098;767;0;38405;20198;0;5.6;3.0;0.0
85;2021-03-03;886;532;0;39291;20730;0;5.8;3.0;0.0
85;2021-03-04;1600;1164;0;40891;21894;0;6.0;3.2;0.0
85;2021-03-05;1793;878;0;42684;22772;0;6.2;3.3;0.0
85;2021-03-06;1202;137;0;43886;22909;0;6.4;3.4;0.0
85;2021-03-07;334;30;0;44220;22939;0;6.5;3.4;0.0
85;2021-03-08;1743;449;0;45963;23388;0;6.7;3.4;0.0
85;2021-03-09;2237;593;0;48200;23981;0;7.1;3.5;0.0
85;2021-03-10;1882;651;0;50082;24632;0;7.3;3.6;0.0
85;2021-03-11;3168;1080;0;53250;25712;0;7.8;3.8;0.0
85;2021-03-12;2781;854;0;56031;26566;0;8.2;3.9;0.0
85;2021-03-13;1393;173;0;57424;26739;0;8.4;3.9;0.0
85;2021-03-14;175;4;0;57599;26743;0;8.4;3.9;0.0
85;2021-03-15;1939;508;0;59538;27251;0;8.7;4.0;0.0
85;2021-03-16;1620;483;0;61158;27734;0;9.0;4.1;0.0
85;2021-03-17;985;514;0;62143;28248;0;9.1;4.1;0.0
85;2021-03-18;1869;452;0;64012;28700;0;9.4;4.2;0.0
85;2021-03-19;2249;362;0;66261;29062;0;9.7;4.3;0.0
85;2021-03-20;1085;174;0;67346;29236;0;9.9;4.3;0.0
85;2021-03-21;276;5;0;67622;29241;0;9.9;4.3;0.0
85;2021-03-22;1810;541;0;69432;29782;0;10.2;4.4;0.0
85;2021-03-23;2488;749;0;71920;30531;0;10.5;4.5;0.0
85;2021-03-24;2239;521;0;74159;31052;0;10.9;4.5;0.0
85;2021-03-25;3711;612;0;77870;31664;0;11.4;4.6;0.0
85;2021-03-26;3380;673;0;81250;32337;0;11.9;4.7;0.0
85;2021-03-27;1737;124;0;82987;32461;0;12.1;4.8;0.0
85;2021-03-28;548;6;0;83535;32467;0;12.2;4.8;0.0
85;2021-03-29;2422;760;0;85957;33227;0;12.6;4.9;0.0
85;2021-03-30;2885;1009;0;88842;34236;0;13.0;5.0;0.0
85;2021-03-31;2323;674;0;91165;34910;0;13.3;5.1;0.0
85;2021-04-01;3826;924;0;94991;35834;0;13.9;5.2;0.0
85;2021-04-02;2832;1125;0;97823;36959;0;14.3;5.4;0.0
85;2021-04-03;1395;321;0;99218;37280;0;14.5;5.5;0.0
85;2021-04-04;324;34;0;99542;37314;0;14.6;5.5;0.0
85;2021-04-05;140;172;0;99682;37486;0;14.6;5.5;0.0
85;2021-04-06;2169;1589;0;101851;39075;0;14.9;5.7;0.0
85;2021-04-07;3094;1193;0;104945;40268;0;15.4;5.9;0.0
85;2021-04-08;4570;1593;0;109515;41861;0;16.0;6.1;0.0
85;2021-04-09;4600;1212;0;114115;43073;0;16.7;6.3;0.0
85;2021-04-10;1799;400;0;115914;43473;0;17.0;6.4;0.0
85;2021-04-11;44;17;0;115958;43490;0;17.0;6.4;0.0
85;2021-04-12;4177;1436;0;120135;44926;0;17.6;6.6;0.0
85;2021-04-13;4652;1852;0;124787;46778;0;18.3;6.8;0.0
85;2021-04-14;4026;1050;0;128813;47828;0;18.9;7.0;0.0
85;2021-04-15;5361;1757;0;134174;49585;0;19.6;7.3;0.0
85;2021-04-16;5072;1577;0;139246;51162;0;20.4;7.5;0.0
85;2021-04-17;1407;433;0;140653;51595;0;20.6;7.6;0.0
85;2021-04-18;368;31;0;141021;51626;0;20.6;7.6;0.0
85;2021-04-19;3305;1689;0;144326;53315;0;21.1;7.8;0.0
85;2021-04-20;3719;1934;0;148045;55249;0;21.7;8.1;0.0
85;2021-04-21;2747;1687;0;150792;56936;0;22.1;8.3;0.0
85;2021-04-22;3766;2175;0;154558;59111;0;22.6;8.7;0.0
85;2021-04-23;4011;2112;0;158569;61223;0;23.2;9.0;0.0
85;2021-04-24;1653;1497;0;160222;62720;0;23.5;9.2;0.0
85;2021-04-25;952;569;0;161174;63289;0;23.6;9.3;0.0
85;2021-04-26;3631;2290;0;164805;65579;0;24.1;9.6;0.0
85;2021-04-27;4369;2202;0;169174;67781;0;24.8;9.9;0.0
85;2021-04-28;5711;1414;0;174885;69195;0;25.6;10.1;0.0
85;2021-04-29;5537;2025;0;180422;71220;0;26.4;10.4;0.0
85;2021-04-30;5569;1805;0;185991;73025;0;27.2;10.7;0.0
85;2021-05-01;1587;667;0;187578;73692;0;27.5;10.8;0.0
85;2021-05-02;721;443;0;188299;74135;0;27.6;10.9;0.0
85;2021-05-03;3535;2267;0;191834;76402;0;28.1;11.2;0.0
85;2021-05-04;3477;2966;0;195311;79368;0;28.6;11.6;0.0
85;2021-05-05;4565;2179;0;199876;81547;0;29.3;11.9;0.0
85;2021-05-06;4808;2624;0;204684;84171;0;30.0;12.3;0.0
85;2021-05-07;3975;3751;0;208659;87922;0;30.5;12.9;0.0
85;2021-05-08;2066;243;0;210725;88165;0;30.8;12.9;0.0
85;2021-05-09;1374;170;0;212099;88335;0;31.0;12.9;0.0
85;2021-05-10;3333;4759;0;215432;93094;0;31.5;13.6;0.0
85;2021-05-11;4109;4839;0;219541;97933;0;32.1;14.3;0.0
85;2021-05-12;5049;3963;0;224590;101896;0;32.9;14.9;0.0
85;2021-05-13;4537;571;0;229127;102467;0;33.5;15.0;0.0
85;2021-05-14;4191;3022;0;233318;105489;0;34.2;15.4;0.0
85;2021-05-15;2204;739;0;235522;106228;0;34.5;15.5;0.0
85;2021-05-16;1952;134;0;237474;106362;0;34.8;15.6;0.0
85;2021-05-17;4020;3280;0;241494;109642;0;35.3;16.0;0.0
85;2021-05-18;5070;2823;0;246564;112465;0;36.1;16.5;0.0
85;2021-05-19;6239;1771;0;252803;114236;0;37.0;16.7;0.0
85;2021-05-20;6405;2185;0;259208;116421;0;37.9;17.0;0.0
85;2021-05-21;5283;2771;0;264491;119192;0;38.7;17.4;0.0
85;2021-05-22;2288;728;0;266779;119920;0;39.0;17.6;0.0
85;2021-05-23;957;126;0;267736;120046;0;39.2;17.6;0.0
85;2021-05-24;3826;399;0;271562;120445;0;39.7;17.6;0.0
85;2021-05-25;4152;3541;0;275714;123986;0;40.4;18.1;0.0
85;2021-05-26;4893;2670;0;280607;126656;0;41.1;18.5;0.0
85;2021-05-27;4770;3592;0;285377;130248;0;41.8;19.1;0.0
85;2021-05-28;5144;4003;0;290521;134251;0;42.5;19.7;0.0
85;2021-05-29;3539;1498;0;294060;135749;0;43.0;19.9;0.0
85;2021-05-30;754;101;0;294814;135850;0;43.2;19.9;0.0
85;2021-05-31;4464;3381;0;299278;139231;0;43.8;20.4;0.0
85;2021-06-01;5081;3428;0;304359;142659;0;44.5;20.9;0.0
85;2021-06-02;5521;2582;0;309880;145241;0;45.4;21.3;0.0
85;2021-06-03;5868;3271;0;315748;148512;0;46.2;21.7;0.0
85;2021-06-04;5844;3845;0;321592;152357;0;47.1;22.3;0.0
85;2021-06-05;2594;1890;0;324186;154247;0;47.5;22.6;0.0
85;2021-06-06;1250;827;0;325436;155074;0;47.6;22.7;0.0
85;2021-06-07;3268;4801;0;328704;159875;0;48.1;23.4;0.0
85;2021-06-08;4030;4539;0;332734;164414;0;48.7;24.1;0.0
85;2021-06-09;5116;3593;0;337850;168007;0;49.5;24.6;0.0
85;2021-06-10;5224;3632;0;343074;171639;0;50.2;25.1;0.0
85;2021-06-11;4795;4581;0;347869;176220;0;50.9;25.8;0.0
85;2021-06-12;1654;1793;0;349523;178013;0;51.2;26.1;0.0
85;2021-06-13;763;616;0;350286;178629;0;51.3;26.1;0.0
85;2021-06-14;2648;5036;0;352934;183665;0;51.7;26.9;0.0
85;2021-06-15;3762;4985;0;356696;188650;0;52.2;27.6;0.0
85;2021-06-16;4283;3849;0;360979;192499;0;52.8;28.2;0.0
85;2021-06-17;4087;3760;0;365066;196259;0;53.4;28.7;0.0
85;2021-06-18;3732;5609;0;368798;201868;0;54.0;29.5;0.0
85;2021-06-19;1287;1938;0;370085;203806;0;54.2;29.8;0.0
85;2021-06-20;117;471;0;370202;204277;0;54.2;29.9;0.0
85;2021-06-21;2426;5757;0;372628;210034;0;54.5;30.7;0.0
85;2021-06-22;2917;5648;0;375545;215682;0;55.0;31.6;0.0
85;2021-06-23;3578;4444;0;379123;220126;0;55.5;32.2;0.0
85;2021-06-24;3819;4374;0;382942;224500;0;56.1;32.9;0.0
85;2021-06-25;2581;6107;0;385523;230607;0;56.4;33.8;0.0
85;2021-06-26;890;3592;0;386413;234199;0;56.6;34.3;0.0
85;2021-06-27;111;1284;0;386524;235483;0;56.6;34.5;0.0
85;2021-06-28;1337;6591;0;387861;242074;0;56.8;35.4;0.0
85;2021-06-29;1964;6710;0;389825;248784;0;57.1;36.4;0.0
85;2021-06-30;2396;6038;0;392221;254822;0;57.4;37.3;0.0
85;2021-07-01;3064;5796;0;395285;260618;0;57.9;38.1;0.0
85;2021-07-02;2510;6763;0;397795;267381;0;58.2;39.1;0.0
85;2021-07-03;647;3001;0;398442;270382;0;58.3;39.6;0.0
85;2021-07-04;125;977;0;398567;271359;0;58.3;39.7;0.0
85;2021-07-05;1103;6328;2;399670;277687;2;58.5;40.6;0.0
85;2021-07-06;1651;6212;0;401321;283899;2;58.7;41.6;0.0
85;2021-07-07;1687;5762;0;403008;289661;2;59.0;42.4;0.0
85;2021-07-08;2269;5343;0;405277;295004;2;59.3;43.2;0.0
85;2021-07-09;1749;6973;0;407026;301977;2;59.6;44.2;0.0
85;2021-07-10;564;2647;0;407590;304624;2;59.7;44.6;0.0
85;2021-07-11;426;896;0;408016;305520;2;59.7;44.7;0.0
85;2021-07-12;1348;6740;0;409364;312260;2;59.9;45.7;0.0
85;2021-07-13;2042;7368;0;411406;319628;2;60.2;46.8;0.0
85;2021-07-14;1301;1658;0;412707;321286;2;60.4;47.0;0.0
85;2021-07-15;2605;6814;0;415312;328100;2;60.8;48.0;0.0
85;2021-07-16;3352;6817;0;418664;334917;2;61.3;49.0;0.0
85;2021-07-17;1573;2133;0;420237;337050;2;61.5;49.3;0.0
85;2021-07-18;843;822;0;421080;337872;2;61.6;49.5;0.0
85;2021-07-19;3146;6044;0;424226;343916;2;62.1;50.3;0.0
85;2021-07-20;3778;6094;0;428004;350010;2;62.6;51.2;0.0
85;2021-07-21;3606;6066;0;431610;356076;2;63.2;52.1;0.0
85;2021-07-22;3737;6029;0;435347;362105;2;63.7;53.0;0.0
85;2021-07-23;4237;6555;0;439584;368660;2;64.3;54.0;0.0
85;2021-07-24;1411;2296;0;440995;370956;2;64.5;54.3;0.0
85;2021-07-25;441;278;0;441436;371234;2;64.6;54.3;0.0
85;2021-07-26;4106;5127;0;445542;376361;2;65.2;55.1;0.0
85;2021-07-27;4756;5336;0;450298;381697;2;65.9;55.9;0.0
85;2021-07-28;4779;4876;0;455077;386573;2;66.6;56.6;0.0
85;2021-07-29;5611;4665;0;460688;391238;2;67.4;57.3;0.0
85;2021-07-30;5667;4813;0;466355;396051;2;68.3;58.0;0.0
85;2021-07-31;1301;1572;0;467656;397623;2;68.5;58.2;0.0
85;2021-08-01;377;130;0;468033;397753;2;68.5;58.2;0.0
85;2021-08-02;4420;3617;0;472453;401370;2;69.2;58.7;0.0
85;2021-08-03;5889;3338;0;478342;404708;2;70.0;59.2;0.0
85;2021-08-04;6192;3297;1;484534;408005;3;70.9;59.7;0.0
85;2021-08-05;5784;3312;0;490318;411317;3;71.8;60.2;0.0
85;2021-08-06;5373;4142;0;495691;415459;3;72.6;60.8;0.0
85;2021-08-07;1448;1065;0;497139;416524;3;72.8;61.0;0.0
85;2021-08-08;285;176;0;497424;416700;3;72.8;61.0;0.0
85;2021-08-09;4046;2990;0;501470;419690;3;73.4;61.4;0.0
85;2021-08-10;4773;2970;0;506243;422660;3;74.1;61.9;0.0
85;2021-08-11;4572;3679;0;510815;426339;3;74.8;62.4;0.0
85;2021-08-12;4245;3564;0;515060;429903;3;75.4;62.9;0.0
85;2021-08-13;3871;3267;0;518931;433170;3;76.0;63.4;0.0
85;2021-08-14;1019;922;0;519950;434092;3;76.1;63.5;0.0
85;2021-08-15;122;179;0;520072;434271;3;76.1;63.6;0.0
85;2021-08-16;2838;4123;0;522910;438394;3;76.5;64.2;0.0
85;2021-08-17;2983;3716;0;525893;442110;3;77.0;64.7;0.0
85;2021-08-18;3131;3584;0;529024;445694;3;77.4;65.2;0.0
85;2021-08-19;2589;3756;1;531613;449450;4;77.8;65.8;0.0
85;2021-08-20;2455;4823;0;534068;454273;4;78.2;66.5;0.0
85;2021-08-21;639;1281;0;534707;455554;4;78.3;66.7;0.0
85;2021-08-22;265;734;0;534972;456288;4;78.3;66.8;0.0
85;2021-08-23;1875;4921;1;536847;461209;5;78.6;67.5;0.0
85;2021-08-24;1888;4564;1;538735;465773;6;78.9;68.2;0.0
85;2021-08-25;1672;4633;0;540407;470406;6;79.1;68.9;0.0
85;2021-08-26;1539;4545;1;541946;474951;7;79.3;69.5;0.0
85;2021-08-27;1761;5182;1;543707;480133;8;79.6;70.3;0.0
85;2021-08-28;555;1313;0;544262;481446;8;79.7;70.5;0.0
85;2021-08-29;103;737;0;544365;482183;8;79.7;70.6;0.0
85;2021-08-30;1099;4917;26;545464;487100;34;79.8;71.3;0.0
85;2021-08-31;1185;5407;71;546649;492507;105;80.0;72.1;0.0
85;2021-09-01;1190;4969;162;547839;497476;267;80.2;72.8;0.0
85;2021-09-02;975;4012;232;548814;501488;499;80.3;73.4;0.1
85;2021-09-03;1249;4271;299;550063;505759;798;80.5;74.0;0.1
85;2021-09-04;390;1423;81;550453;507182;879;80.6;74.2;0.1
85;2021-09-05;30;164;15;550483;507346;894;80.6;74.3;0.1
85;2021-09-06;841;3461;404;551324;510807;1298;80.7;74.8;0.2
85;2021-09-07;861;2973;404;552185;513780;1702;80.8;75.2;0.2
85;2021-09-08;890;3531;265;553075;517311;1967;81.0;75.7;0.3
85;2021-09-09;638;2499;412;553713;519810;2379;81.0;76.1;0.3
85;2021-09-10;798;3460;338;554511;523270;2717;81.2;76.6;0.4
85;2021-09-11;285;1356;74;554796;524626;2791;81.2;76.8;0.4
85;2021-09-12;17;45;24;554813;524671;2815;81.2;76.8;0.4
85;2021-09-13;560;2220;479;555373;526891;3294;81.3;77.1;0.5
85;2021-09-14;565;1700;788;555938;528591;4082;81.4;77.4;0.6
85;2021-09-15;630;2650;587;556568;531241;4669;81.5;77.8;0.7
85;2021-09-16;406;1373;618;556974;532614;5287;81.5;78.0;0.8
85;2021-09-17;728;2485;607;557702;535099;5894;81.6;78.3;0.9
85;2021-09-18;201;957;89;557903;536056;5983;81.7;78.5;0.9
85;2021-09-19;10;35;6;557913;536091;5989;81.7;78.5;0.9
85;2021-09-20;343;1367;631;558256;537458;6620;81.7;78.7;1.0
85;2021-09-21;431;1107;952;558687;538565;7572;81.8;78.8;1.1
85;2021-09-22;429;2018;846;559116;540583;8418;81.8;79.1;1.2
85;2021-09-23;772;1004;1018;559888;541587;9436;82.0;79.3;1.4
85;2021-09-24;604;2038;686;560492;543625;10122;82.0;79.6;1.5
85;2021-09-25;155;888;150;560647;544513;10272;82.1;79.7;1.5
85;2021-09-26;6;8;0;560653;544521;10272;82.1;79.7;1.5
85;2021-09-27;368;949;973;561021;545470;11245;82.1;79.8;1.6
85;2021-09-28;244;612;758;561265;546082;12003;82.2;79.9;1.8
85;2021-09-29;400;1327;653;561665;547409;12656;82.2;80.1;1.9
85;2021-09-30;336;770;1184;562001;548179;13840;82.3;80.2;2.0
85;2021-10-01;455;960;728;562456;549139;14568;82.3;80.4;2.1
85;2021-10-02;187;538;159;562643;549677;14727;82.4;80.5;2.2
85;2021-10-03;8;18;12;562651;549695;14739;82.4;80.5;2.2
85;2021-10-04;216;698;758;562867;550393;15497;82.4;80.6;2.3
85;2021-10-05;303;455;674;563170;550848;16171;82.4;80.6;2.4
85;2021-10-06;395;884;761;563565;551732;16932;82.5;80.8;2.5
85;2021-10-07;244;415;1063;563809;552147;17995;82.5;80.8;2.6
85;2021-10-08;367;1023;884;564176;553170;18879;82.6;81.0;2.8
85;2021-10-09;124;331;155;564300;553501;19034;82.6;81.0;2.8
85;2021-10-10;14;17;5;564314;553518;19039;82.6;81.0;2.8
85;2021-10-11;229;488;957;564543;554006;19996;82.6;81.1;2.9
85;2021-10-12;170;328;593;564713;554334;20589;82.7;81.1;3.0
85;2021-10-13;342;668;861;565055;555002;21450;82.7;81.2;3.1
85;2021-10-14;203;580;790;565258;555582;22240;82.7;81.3;3.3
85;2021-10-15;262;842;919;565520;556424;23159;82.8;81.4;3.4
85;2021-10-16;108;168;160;565628;556592;23319;82.8;81.5;3.4
85;2021-10-17;2;10;7;565630;556602;23326;82.8;81.5;3.4
85;2021-10-18;239;357;900;565869;556959;24226;82.8;81.5;3.5
85;2021-10-19;76;198;619;565945;557157;24845;82.8;81.6;3.6
85;2021-10-20;178;591;1186;566123;557748;26031;82.9;81.6;3.8
85;2021-10-21;125;363;1488;566248;558111;27519;82.9;81.7;4.0
85;2021-10-22;172;653;1301;566420;558764;28820;82.9;81.8;4.2
85;2021-10-23;44;156;186;566464;558920;29006;82.9;81.8;4.2
85;2021-10-24;1;2;1;566465;558922;29007;82.9;81.8;4.2
85;2021-10-25;166;244;1133;566631;559166;30140;82.9;81.8;4.4
85;2021-10-26;61;139;543;566692;559305;30683;82.9;81.9;4.5
85;2021-10-27;173;456;1373;566865;559761;32056;83.0;81.9;4.7
85;2021-10-28;127;186;1056;566992;559947;33112;83.0;82.0;4.8
85;2021-10-29;134;375;1578;567126;560322;34690;83.0;82.0;5.1
85;2021-10-30;31;105;241;567157;560427;34931;83.0;82.0;5.1
85;2021-10-31;0;1;0;567157;560428;34931;83.0;82.0;5.1
85;2021-11-01;1;2;4;567158;560430;34935;83.0;82.0;5.1
85;2021-11-02;118;302;1255;567276;560732;36190;83.0;82.1;5.3
85;2021-11-03;183;364;1910;567459;561096;38100;83.1;82.1;5.6
85;2021-11-04;109;222;1704;567568;561318;39804;83.1;82.2;5.8
85;2021-11-05;133;323;1812;567701;561641;41616;83.1;82.2;6.1
85;2021-11-06;34;109;444;567735;561750;42060;83.1;82.2;6.2
85;2021-11-07;2;8;19;567737;561758;42079;83.1;82.2;6.2
85;2021-11-08;103;274;1945;567840;562032;44024;83.1;82.3;6.4
85;2021-11-09;85;165;1801;567925;562197;45825;83.1;82.3;6.7
85;2021-11-10;158;260;2714;568083;562457;48539;83.2;82.3;7.1
85;2021-11-11;2;3;59;568085;562460;48598;83.2;82.3;7.1
85;2021-11-12;86;158;1791;568171;562618;50389;83.2;82.4;7.4
85;2021-11-13;24;64;471;568195;562682;50860;83.2;82.4;7.4
85;2021-11-14;2;2;10;568197;562684;50870;83.2;82.4;7.4
85;2021-11-15;76;189;2474;568273;562873;53344;83.2;82.4;7.8
85;2021-11-16;96;127;2661;568369;563000;56005;83.2;82.4;8.2
85;2021-11-17;152;261;2944;568521;563261;58949;83.2;82.4;8.6
85;2021-11-18;99;132;2708;568620;563393;61657;83.2;82.5;9.0
85;2021-11-19;124;202;3080;568744;563595;64737;83.2;82.5;9.5
85;2021-11-20;48;81;555;568792;563676;65292;83.3;82.5;9.6
85;2021-11-21;1;2;2;568793;563678;65294;83.3;82.5;9.6
85;2021-11-22;142;110;3186;568935;563788;68480;83.3;82.5;10.0
85;2021-11-23;136;82;3583;569071;563870;72063;83.3;82.5;10.5
85;2021-11-24;182;257;3142;569253;564127;75205;83.3;82.6;11.0
85;2021-11-25;129;146;3544;569382;564273;78749;83.3;82.6;11.5
85;2021-11-26;129;190;4304;569511;564463;83053;83.4;82.6;12.2
85;2021-11-27;47;83;1633;569558;564546;84686;83.4;82.6;12.4
85;2021-11-28;18;10;909;569576;564556;85595;83.4;82.6;12.5
85;2021-11-29;116;152;4709;569692;564708;90304;83.4;82.7;13.2
85;2021-11-30;147;107;5446;569839;564815;95750;83.4;82.7;14.0
85;2021-12-01;144;152;6095;569983;564967;101845;83.4;82.7;14.9
85;2021-12-02;80;63;5843;570063;565030;107688;83.4;82.7;15.8
85;2021-12-03;96;125;7177;570159;565155;114865;83.5;82.7;16.8
85;2021-12-04;40;41;2559;570199;565196;117424;83.5;82.7;17.2
85;2021-12-05;7;2;427;570206;565198;117851;83.5;82.7;17.3
85;2021-12-06;70;102;6729;570276;565300;124580;83.5;82.7;18.2
85;2021-12-07;71;99;6727;570347;565399;131307;83.5;82.8;19.2
85;2021-12-08;99;155;7371;570446;565554;138678;83.5;82.8;20.3
85;2021-12-09;77;116;7347;570523;565670;146025;83.5;82.8;21.4
85;2021-12-10;121;163;9093;570644;565833;155118;83.5;82.8;22.7
85;2021-12-11;68;55;2787;570712;565888;157905;83.5;82.8;23.1
85;2021-12-12;6;10;1039;570718;565898;158944;83.5;82.8;23.3
85;2021-12-13;85;126;9105;570803;566024;168049;83.6;82.9;24.6
85;2021-12-14;103;151;10185;570906;566175;178234;83.6;82.9;26.1
85;2021-12-15;120;217;9271;571026;566392;187505;83.6;82.9;27.4
85;2021-12-16;114;161;10464;571140;566553;197969;83.6;82.9;29.0
86;2020-12-27;0;0;0;0;0;0;0.0;0.0;0.0
86;2020-12-28;0;0;0;0;0;0;0.0;0.0;0.0
86;2020-12-29;1;0;0;1;0;0;0.0;0.0;0.0
86;2020-12-30;0;0;0;1;0;0;0.0;0.0;0.0
86;2020-12-31;0;0;0;1;0;0;0.0;0.0;0.0
86;2021-01-01;1;0;0;2;0;0;0.0;0.0;0.0
86;2021-01-02;1;0;0;3;0;0;0.0;0.0;0.0
86;2021-01-03;0;0;0;3;0;0;0.0;0.0;0.0
86;2021-01-04;1;0;0;4;0;0;0.0;0.0;0.0
86;2021-01-05;3;0;0;7;0;0;0.0;0.0;0.0
86;2021-01-06;166;1;0;173;1;0;0.0;0.0;0.0
86;2021-01-07;661;0;0;834;1;0;0.2;0.0;0.0
86;2021-01-08;592;3;0;1426;4;0;0.3;0.0;0.0
86;2021-01-09;2;0;0;1428;4;0;0.3;0.0;0.0
86;2021-01-10;165;0;0;1593;4;0;0.4;0.0;0.0
86;2021-01-11;305;0;0;1898;4;0;0.4;0.0;0.0
86;2021-01-12;462;1;0;2360;5;0;0.5;0.0;0.0
86;2021-01-13;340;1;0;2700;6;0;0.6;0.0;0.0
86;2021-01-14;561;1;0;3261;7;0;0.7;0.0;0.0
86;2021-01-15;551;3;0;3812;10;0;0.9;0.0;0.0
86;2021-01-16;5;0;0;3817;10;0;0.9;0.0;0.0
86;2021-01-17;0;0;0;3817;10;0;0.9;0.0;0.0
86;2021-01-18;564;0;0;4381;10;0;1.0;0.0;0.0
86;2021-01-19;1820;2;0;6201;12;0;1.4;0.0;0.0
86;2021-01-20;1441;27;0;7642;39;0;1.7;0.0;0.0
86;2021-01-21;1262;3;0;8904;42;0;2.0;0.0;0.0
86;2021-01-22;824;2;0;9728;44;0;2.2;0.0;0.0
86;2021-01-23;295;2;0;10023;46;0;2.3;0.0;0.0
86;2021-01-24;1;0;0;10024;46;0;2.3;0.0;0.0
86;2021-01-25;588;108;0;10612;154;0;2.4;0.0;0.0
86;2021-01-26;731;120;0;11343;274;0;2.6;0.1;0.0
86;2021-01-27;761;152;0;12104;426;0;2.8;0.1;0.0
86;2021-01-28;1018;413;0;13122;839;0;3.0;0.2;0.0
86;2021-01-29;877;217;0;13999;1056;0;3.2;0.2;0.0
86;2021-01-30;259;101;0;14258;1157;0;3.3;0.3;0.0
86;2021-01-31;54;151;0;14312;1308;0;3.3;0.3;0.0
86;2021-02-01;416;213;0;14728;1521;0;3.4;0.3;0.0
86;2021-02-02;561;376;0;15289;1897;0;3.5;0.4;0.0
86;2021-02-03;521;233;0;15810;2130;0;3.6;0.5;0.0
86;2021-02-04;453;367;0;16263;2497;0;3.7;0.6;0.0
86;2021-02-05;437;725;0;16700;3222;0;3.8;0.7;0.0
86;2021-02-06;137;195;0;16837;3417;0;3.8;0.8;0.0
86;2021-02-07;103;4;0;16940;3421;0;3.9;0.8;0.0
86;2021-02-08;353;312;0;17293;3733;0;4.0;0.9;0.0
86;2021-02-09;737;1070;0;18030;4803;0;4.1;1.1;0.0
86;2021-02-10;940;903;0;18970;5706;0;4.3;1.3;0.0
86;2021-02-11;948;983;0;19918;6689;0;4.6;1.5;0.0
86;2021-02-12;698;405;0;20616;7094;0;4.7;1.6;0.0
86;2021-02-13;179;96;0;20795;7190;0;4.8;1.6;0.0
86;2021-02-14;1;32;0;20796;7222;0;4.8;1.7;0.0
86;2021-02-15;245;496;0;21041;7718;0;4.8;1.8;0.0
86;2021-02-16;372;843;0;21413;8561;0;4.9;2.0;0.0
86;2021-02-17;434;875;0;21847;9436;0;5.0;2.2;0.0
86;2021-02-18;431;894;0;22278;10330;0;5.1;2.4;0.0
86;2021-02-19;577;620;0;22855;10950;0;5.2;2.5;0.0
86;2021-02-20;110;174;0;22965;11124;0;5.3;2.5;0.0
86;2021-02-21;3;3;0;22968;11127;0;5.3;2.5;0.0
86;2021-02-22;225;432;0;23193;11559;0;5.3;2.6;0.0
86;2021-02-23;368;581;0;23561;12140;0;5.4;2.8;0.0
86;2021-02-24;394;586;0;23955;12726;0;5.5;2.9;0.0
86;2021-02-25;857;646;0;24812;13372;0;5.7;3.1;0.0
86;2021-02-26;983;553;0;25795;13925;0;5.9;3.2;0.0
86;2021-02-27;460;134;0;26255;14059;0;6.0;3.2;0.0
86;2021-02-28;7;2;0;26262;14061;0;6.0;3.2;0.0
86;2021-03-01;240;480;0;26502;14541;0;6.1;3.3;0.0
86;2021-03-02;1121;819;0;27623;15360;0;6.3;3.5;0.0
86;2021-03-03;807;627;0;28430;15987;0;6.5;3.7;0.0
86;2021-03-04;1485;583;0;29915;16570;0;6.8;3.8;0.0
86;2021-03-05;1564;322;0;31479;16892;0;7.2;3.9;0.0
86;2021-03-06;976;165;0;32455;17057;0;7.4;3.9;0.0
86;2021-03-07;342;38;0;32797;17095;0;7.5;3.9;0.0
86;2021-03-08;461;522;0;33258;17617;0;7.6;4.0;0.0
86;2021-03-09;1339;502;0;34597;18119;0;7.9;4.1;0.0
86;2021-03-10;939;609;0;35536;18728;0;8.1;4.3;0.0
86;2021-03-11;1774;474;0;37310;19202;0;8.5;4.4;0.0
86;2021-03-12;2150;414;0;39460;19616;0;9.0;4.5;0.0
86;2021-03-13;1402;91;0;40862;19707;0;9.3;4.5;0.0
86;2021-03-14;126;13;0;40988;19720;0;9.4;4.5;0.0
86;2021-03-15;744;160;0;41732;19880;0;9.5;4.5;0.0
86;2021-03-16;820;206;0;42552;20086;0;9.7;4.6;0.0
86;2021-03-17;729;214;0;43281;20300;0;9.9;4.6;0.0
86;2021-03-18;892;111;0;44173;20411;0;10.1;4.7;0.0
86;2021-03-19;2038;340;0;46211;20751;0;10.6;4.7;0.0
86;2021-03-20;605;127;0;46816;20878;0;10.7;4.8;0.0
86;2021-03-21;14;0;0;46830;20878;0;10.7;4.8;0.0
86;2021-03-22;812;272;0;47642;21150;0;10.9;4.8;0.0
86;2021-03-23;1967;333;0;49609;21483;0;11.3;4.9;0.0
86;2021-03-24;1497;339;0;51106;21822;0;11.7;5.0;0.0
86;2021-03-25;2381;364;0;53487;22186;0;12.2;5.1;0.0
86;2021-03-26;2906;366;0;56393;22552;0;12.9;5.2;0.0
86;2021-03-27;731;141;0;57124;22693;0;13.1;5.2;0.0
86;2021-03-28;8;111;0;57132;22804;0;13.1;5.2;0.0
86;2021-03-29;1159;382;0;58291;23186;0;13.3;5.3;0.0
86;2021-03-30;2305;801;0;60596;23987;0;13.9;5.5;0.0
86;2021-03-31;1444;616;0;62040;24603;0;14.2;5.6;0.0
86;2021-04-01;2156;920;0;64196;25523;0;14.7;5.8;0.0
86;2021-04-02;1883;529;0;66079;26052;0;15.1;6.0;0.0
86;2021-04-03;796;286;0;66875;26338;0;15.3;6.0;0.0
86;2021-04-04;80;96;0;66955;26434;0;15.3;6.0;0.0
86;2021-04-05;286;4;0;67241;26438;0;15.4;6.0;0.0
86;2021-04-06;1543;915;0;68784;27353;0;15.7;6.3;0.0
86;2021-04-07;1618;606;0;70402;27959;0;16.1;6.4;0.0
86;2021-04-08;2516;751;0;72918;28710;0;16.7;6.6;0.0
86;2021-04-09;3227;620;0;76145;29330;0;17.4;6.7;0.0
86;2021-04-10;1614;181;0;77759;29511;0;17.8;6.7;0.0
86;2021-04-11;425;11;0;78184;29522;0;17.9;6.7;0.0
86;2021-04-12;808;707;0;78992;30229;0;18.1;6.9;0.0
86;2021-04-13;2381;883;0;81373;31112;0;18.6;7.1;0.0
86;2021-04-14;1836;829;0;83209;31941;0;19.0;7.3;0.0
86;2021-04-15;2255;673;0;85464;32614;0;19.5;7.5;0.0
86;2021-04-16;2397;1169;0;87861;33783;0;20.1;7.7;0.0
86;2021-04-17;1045;276;0;88906;34059;0;20.3;7.8;0.0
86;2021-04-18;122;5;0;89028;34064;0;20.4;7.8;0.0
86;2021-04-19;759;743;0;89787;34807;0;20.5;8.0;0.0
86;2021-04-20;2326;1468;0;92113;36275;0;21.1;8.3;0.0
86;2021-04-21;2038;1032;0;94151;37307;0;21.5;8.5;0.0
86;2021-04-22;2253;1314;0;96404;38621;0;22.0;8.8;0.0
86;2021-04-23;2340;1461;0;98744;40082;0;22.6;9.2;0.0
86;2021-04-24;1228;514;0;99972;40596;0;22.9;9.3;0.0
86;2021-04-25;771;27;0;100743;40623;0;23.0;9.3;0.0
86;2021-04-26;1945;832;0;102688;41455;0;23.5;9.5;0.0
86;2021-04-27;2983;1621;0;105671;43076;0;24.2;9.8;0.0
86;2021-04-28;2877;1408;0;108548;44484;0;24.8;10.2;0.0
86;2021-04-29;3481;1783;0;112029;46267;0;25.6;10.6;0.0
86;2021-04-30;2934;1430;0;114963;47697;0;26.3;10.9;0.0
86;2021-05-01;1544;202;0;116507;47899;0;26.6;11.0;0.0
86;2021-05-02;1211;45;0;117718;47944;0;26.9;11.0;0.0
86;2021-05-03;2417;964;0;120135;48908;0;27.5;11.2;0.0
86;2021-05-04;3287;1858;0;123422;50766;0;28.2;11.6;0.0
86;2021-05-05;3747;1448;0;127169;52214;0;29.1;11.9;0.0
86;2021-05-06;4073;1618;0;131242;53832;0;30.0;12.3;0.0
86;2021-05-07;3985;1815;0;135227;55647;0;30.9;12.7;0.0
86;2021-05-08;1824;383;0;137051;56030;0;31.3;12.8;0.0
86;2021-05-09;1512;184;0;138563;56214;0;31.7;12.9;0.0
86;2021-05-10;1853;1144;0;140416;57358;0;32.1;13.1;0.0
86;2021-05-11;3262;2593;0;143678;59951;0;32.8;13.7;0.0
86;2021-05-12;2141;1632;0;145819;61583;0;33.3;14.1;0.0
86;2021-05-13;1477;278;0;147296;61861;0;33.7;14.1;0.0
86;2021-05-14;1933;794;0;149229;62655;0;34.1;14.3;0.0
86;2021-05-15;1366;459;0;150595;63114;0;34.4;14.4;0.0
86;2021-05-16;734;148;0;151329;63262;0;34.6;14.5;0.0
86;2021-05-17;3005;1028;0;154334;64290;0;35.3;14.7;0.0
86;2021-05-18;3991;1593;0;158325;65883;0;36.2;15.1;0.0
86;2021-05-19;3320;1362;0;161645;67245;0;37.0;15.4;0.0
86;2021-05-20;3928;1570;0;165573;68815;0;37.9;15.7;0.0
86;2021-05-21;3225;1703;0;168798;70518;0;38.6;16.1;0.0
86;2021-05-22;1884;666;0;170682;71184;0;39.0;16.3;0.0
86;2021-05-23;1266;167;0;171948;71351;0;39.3;16.3;0.0
86;2021-05-24;1629;200;0;173577;71551;0;39.7;16.4;0.0
86;2021-05-25;2557;1547;0;176134;73098;0;40.3;16.7;0.0
86;2021-05-26;2543;1453;0;178677;74551;0;40.8;17.0;0.0
86;2021-05-27;3159;1771;0;181836;76322;0;41.6;17.4;0.0
86;2021-05-28;2128;2495;0;183964;78817;0;42.1;18.0;0.0
86;2021-05-29;1397;1252;0;185361;80069;0;42.4;18.3;0.0
86;2021-05-30;862;126;0;186223;80195;0;42.6;18.3;0.0
86;2021-05-31;1819;1738;0;188042;81933;0;43.0;18.7;0.0
86;2021-06-01;2450;2572;0;190492;84505;0;43.6;19.3;0.0
86;2021-06-02;2208;2535;0;192700;87040;0;44.1;19.9;0.0
86;2021-06-03;2976;2370;0;195676;89410;0;44.7;20.4;0.0
86;2021-06-04;2218;2809;0;197894;92219;0;45.2;21.1;0.0
86;2021-06-05;1464;1526;0;199358;93745;0;45.6;21.4;0.0
86;2021-06-06;787;870;0;200145;94615;0;45.8;21.6;0.0
86;2021-06-07;1180;2302;0;201325;96917;0;46.0;22.2;0.0
86;2021-06-08;1904;3539;0;203229;100456;0;46.5;23.0;0.0
86;2021-06-09;1872;3157;0;205101;103613;0;46.9;23.7;0.0
86;2021-06-10;2311;3118;0;207412;106731;0;47.4;24.4;0.0
86;2021-06-11;1617;2772;0;209029;109503;0;47.8;25.0;0.0
86;2021-06-12;899;2149;0;209928;111652;0;48.0;25.5;0.0
86;2021-06-13;281;1405;0;210209;113057;0;48.1;25.8;0.0
86;2021-06-14;1203;2784;0;211412;115841;0;48.3;26.5;0.0
86;2021-06-15;1723;3987;0;213135;119828;0;48.7;27.4;0.0
86;2021-06-16;1785;3066;0;214920;122894;0;49.1;28.1;0.0
86;2021-06-17;1844;4320;0;216764;127214;0;49.6;29.1;0.0
86;2021-06-18;1957;4475;0;218721;131689;0;50.0;30.1;0.0
86;2021-06-19;725;1986;0;219446;133675;0;50.2;30.6;0.0
86;2021-06-20;185;1235;0;219631;134910;0;50.2;30.8;0.0
86;2021-06-21;1197;2100;0;220828;137010;0;50.5;31.3;0.0
86;2021-06-22;1358;3257;0;222186;140267;0;50.8;32.1;0.0
86;2021-06-23;1478;2345;0;223664;142612;0;51.1;32.6;0.0
86;2021-06-24;1705;2666;0;225369;145278;0;51.5;33.2;0.0
86;2021-06-25;1311;3421;0;226680;148699;0;51.8;34.0;0.0
86;2021-06-26;475;2497;0;227155;151196;0;51.9;34.6;0.0
86;2021-06-27;141;1524;0;227296;152720;0;52.0;34.9;0.0
86;2021-06-28;435;3170;0;227731;155890;0;52.1;35.6;0.0
86;2021-06-29;979;4271;0;228710;160161;0;52.3;36.6;0.0
86;2021-06-30;1116;2864;0;229826;163025;0;52.5;37.3;0.0
86;2021-07-01;1539;2973;0;231365;165998;0;52.9;38.0;0.0
86;2021-07-02;1201;3584;0;232566;169582;0;53.2;38.8;0.0
86;2021-07-03;560;2267;0;233126;171849;0;53.3;39.3;0.0
86;2021-07-04;118;1241;0;233244;173090;0;53.3;39.6;0.0
86;2021-07-05;595;2725;0;233839;175815;0;53.5;40.2;0.0
86;2021-07-06;1039;3882;0;234878;179697;0;53.7;41.1;0.0
86;2021-07-07;1291;2556;0;236169;182253;0;54.0;41.7;0.0
86;2021-07-08;1638;3011;0;237807;185264;0;54.4;42.4;0.0
86;2021-07-09;1674;3061;0;239481;188325;0;54.8;43.1;0.0
86;2021-07-10;1165;1880;0;240646;190205;0;55.0;43.5;0.0
86;2021-07-11;476;807;0;241122;191012;0;55.1;43.7;0.0
86;2021-07-12;858;2406;0;241980;193418;0;55.3;44.2;0.0
86;2021-07-13;1759;3210;0;243739;196628;0;55.7;45.0;0.0
86;2021-07-14;796;1141;0;244535;197769;0;55.9;45.2;0.0
86;2021-07-15;1928;3190;0;246463;200959;0;56.3;45.9;0.0
86;2021-07-16;1734;2710;0;248197;203669;0;56.7;46.6;0.0
86;2021-07-17;1340;1653;0;249537;205322;0;57.1;46.9;0.0
86;2021-07-18;418;886;0;249955;206208;0;57.1;47.1;0.0
86;2021-07-19;1414;1973;0;251369;208181;0;57.5;47.6;0.0
86;2021-07-20;2357;2787;0;253726;210968;0;58.0;48.2;0.0
86;2021-07-21;2316;2268;0;256042;213236;0;58.5;48.8;0.0
86;2021-07-22;2722;2821;0;258764;216057;0;59.2;49.4;0.0
86;2021-07-23;2441;2449;0;261205;218506;0;59.7;50.0;0.0
86;2021-07-24;1529;1356;0;262734;219862;0;60.1;50.3;0.0
86;2021-07-25;730;393;0;263464;220255;0;60.2;50.4;0.0
86;2021-07-26;1669;2209;0;265133;222464;0;60.6;50.9;0.0
86;2021-07-27;3248;2780;0;268381;225244;0;61.4;51.5;0.0
86;2021-07-28;3160;2203;0;271541;227447;0;62.1;52.0;0.0
86;2021-07-29;3189;2551;0;274730;229998;0;62.8;52.6;0.0
86;2021-07-30;2266;2465;0;276996;232463;0;63.3;53.1;0.0
86;2021-07-31;1404;1106;0;278400;233569;0;63.6;53.4;0.0
86;2021-08-01;669;344;0;279069;233913;0;63.8;53.5;0.0
86;2021-08-02;1908;1678;0;280977;235591;0;64.2;53.9;0.0
86;2021-08-03;3069;2022;0;284046;237613;0;64.9;54.3;0.0
86;2021-08-04;2601;1737;0;286647;239350;0;65.5;54.7;0.0
86;2021-08-05;3182;2012;0;289829;241362;0;66.3;55.2;0.0
86;2021-08-06;2416;1805;0;292245;243167;0;66.8;55.6;0.0
86;2021-08-07;1510;1031;0;293755;244198;0;67.2;55.8;0.0
86;2021-08-08;837;524;0;294592;244722;0;67.4;55.9;0.0
86;2021-08-09;1843;1355;0;296435;246077;0;67.8;56.3;0.0
86;2021-08-10;2505;1847;0;298940;247924;0;68.3;56.7;0.0
86;2021-08-11;2222;1460;0;301162;249384;0;68.9;57.0;0.0
86;2021-08-12;2209;1839;0;303371;251223;0;69.4;57.4;0.0
86;2021-08-13;1795;1537;0;305166;252760;0;69.8;57.8;0.0
86;2021-08-14;1244;1114;0;306410;253874;0;70.1;58.0;0.0
86;2021-08-15;501;589;0;306911;254463;0;70.2;58.2;0.0
86;2021-08-16;1120;1870;0;308031;256333;0;70.4;58.6;0.0
86;2021-08-17;1507;2168;0;309538;258501;0;70.8;59.1;0.0
86;2021-08-18;1270;1861;0;310808;260362;0;71.1;59.5;0.0
86;2021-08-19;1413;2579;0;312221;262941;0;71.4;60.1;0.0
86;2021-08-20;1237;2636;0;313458;265577;0;71.7;60.7;0.0
86;2021-08-21;795;1856;0;314253;267433;0;71.8;61.1;0.0
86;2021-08-22;319;693;0;314572;268126;0;71.9;61.3;0.0
86;2021-08-23;754;1840;0;315326;269966;0;72.1;61.7;0.0
86;2021-08-24;1049;2669;0;316375;272635;0;72.3;62.3;0.0
86;2021-08-25;887;1973;0;317262;274608;0;72.5;62.8;0.0
86;2021-08-26;872;2644;0;318134;277252;0;72.7;63.4;0.0
86;2021-08-27;847;2208;0;318981;279460;0;72.9;63.9;0.0
86;2021-08-28;504;1672;0;319485;281132;0;73.0;64.3;0.0
86;2021-08-29;109;789;0;319594;281921;0;73.1;64.5;0.0
86;2021-08-30;655;2034;25;320249;283955;25;73.2;64.9;0.0
86;2021-08-31;921;2957;50;321170;286912;75;73.4;65.6;0.0
86;2021-09-01;587;2464;176;321757;289376;251;73.6;66.2;0.1
86;2021-09-02;708;2330;213;322465;291706;464;73.7;66.7;0.1
86;2021-09-03;720;2193;168;323185;293899;632;73.9;67.2;0.1
86;2021-09-04;348;2005;88;323533;295904;720;74.0;67.7;0.2
86;2021-09-05;32;836;11;323565;296740;731;74.0;67.8;0.2
86;2021-09-06;353;1496;176;323918;298236;907;74.1;68.2;0.2
86;2021-09-07;471;1854;219;324389;300090;1126;74.2;68.6;0.3
86;2021-09-08;542;1996;298;324931;302086;1424;74.3;69.1;0.3
86;2021-09-09;483;1619;240;325414;303705;1664;74.4;69.4;0.4
86;2021-09-10;498;1736;318;325912;305441;1982;74.5;69.8;0.5
86;2021-09-11;337;1715;55;326249;307156;2037;74.6;70.2;0.5
86;2021-09-12;93;694;57;326342;307850;2094;74.6;70.4;0.5
86;2021-09-13;328;979;519;326670;308829;2613;74.7;70.6;0.6
86;2021-09-14;381;1310;660;327051;310139;3273;74.8;70.9;0.7
86;2021-09-15;460;1470;298;327511;311609;3571;74.9;71.2;0.8
86;2021-09-16;395;954;828;327906;312563;4399;75.0;71.5;1.0
86;2021-09-17;454;1051;540;328360;313614;4939;75.1;71.7;1.1
86;2021-09-18;290;1148;119;328650;314762;5058;75.1;72.0;1.2
86;2021-09-19;70;388;17;328720;315150;5075;75.2;72.1;1.2
86;2021-09-20;216;607;341;328936;315757;5416;75.2;72.2;1.2
86;2021-09-21;260;836;518;329196;316593;5934;75.3;72.4;1.4
86;2021-09-22;301;1139;426;329497;317732;6360;75.3;72.6;1.5
86;2021-09-23;349;585;730;329846;318317;7090;75.4;72.8;1.6
86;2021-09-24;312;833;341;330158;319150;7431;75.5;73.0;1.7
86;2021-09-25;266;925;136;330424;320075;7567;75.5;73.2;1.7
86;2021-09-26;36;157;16;330460;320232;7583;75.6;73.2;1.7
86;2021-09-27;154;333;361;330614;320565;7944;75.6;73.3;1.8
86;2021-09-28;238;340;527;330852;320905;8471;75.6;73.4;1.9
86;2021-09-29;222;648;517;331074;321553;8988;75.7;73.5;2.1
86;2021-09-30;236;433;674;331310;321986;9662;75.7;73.6;2.2
86;2021-10-01;276;521;475;331586;322507;10137;75.8;73.7;2.3
86;2021-10-02;271;523;203;331857;323030;10340;75.9;73.9;2.4
86;2021-10-03;18;63;4;331875;323093;10344;75.9;73.9;2.4
86;2021-10-04;110;294;397;331985;323387;10741;75.9;73.9;2.5
86;2021-10-05;141;281;476;332126;323668;11217;75.9;74.0;2.6
86;2021-10-06;186;457;336;332312;324125;11553;76.0;74.1;2.6
86;2021-10-07;161;407;760;332473;324532;12313;76.0;74.2;2.8
86;2021-10-08;213;466;484;332686;324998;12797;76.1;74.3;2.9
86;2021-10-09;212;417;203;332898;325415;13000;76.1;74.4;3.0
86;2021-10-10;7;14;7;332905;325429;13007;76.1;74.4;3.0
86;2021-10-11;144;294;428;333049;325723;13435;76.1;74.5;3.1
86;2021-10-12;121;307;684;333170;326030;14119;76.2;74.5;3.2
86;2021-10-13;198;349;636;333368;326379;14755;76.2;74.6;3.4
86;2021-10-14;139;325;798;333507;326704;15553;76.2;74.7;3.6
86;2021-10-15;186;324;689;333693;327028;16242;76.3;74.8;3.7
86;2021-10-16;200;315;207;333893;327343;16449;76.3;74.8;3.8
86;2021-10-17;4;5;0;333897;327348;16449;76.3;74.8;3.8
86;2021-10-18;148;294;530;334045;327642;16979;76.4;74.9;3.9
86;2021-10-19;113;271;796;334158;327913;17775;76.4;75.0;4.1
86;2021-10-20;205;327;696;334363;328240;18471;76.4;75.0;4.2
86;2021-10-21;142;322;591;334505;328562;19062;76.5;75.1;4.4
86;2021-10-22;171;220;637;334676;328782;19699;76.5;75.2;4.5
86;2021-10-23;191;332;318;334867;329114;20017;76.6;75.2;4.6
86;2021-10-24;1;3;2;334868;329117;20019;76.6;75.2;4.6
86;2021-10-25;68;152;628;334936;329269;20647;76.6;75.3;4.7
86;2021-10-26;102;111;638;335038;329380;21285;76.6;75.3;4.9
86;2021-10-27;207;277;681;335245;329657;21966;76.6;75.4;5.0
86;2021-10-28;78;141;531;335323;329798;22497;76.7;75.4;5.1
86;2021-10-29;109;160;697;335432;329958;23194;76.7;75.4;5.3
86;2021-10-30;141;197;372;335573;330155;23566;76.7;75.5;5.4
86;2021-10-31;0;5;5;335573;330160;23571;76.7;75.5;5.4
86;2021-11-01;8;2;21;335581;330162;23592;76.7;75.5;5.4
86;2021-11-02;68;135;793;335649;330297;24385;76.7;75.5;5.6
86;2021-11-03;158;274;1030;335807;330571;25415;76.8;75.6;5.8
86;2021-11-04;100;134;766;335907;330705;26181;76.8;75.6;6.0
86;2021-11-05;138;178;774;336045;330883;26955;76.8;75.6;6.2
86;2021-11-06;143;235;629;336188;331118;27584;76.9;75.7;6.3
86;2021-11-07;2;6;5;336190;331124;27589;76.9;75.7;6.3
86;2021-11-08;74;99;744;336264;331223;28333;76.9;75.7;6.5
86;2021-11-09;100;141;1385;336364;331364;29718;76.9;75.8;6.8
86;2021-11-10;145;303;1538;336509;331667;31256;76.9;75.8;7.1
86;2021-11-11;12;9;71;336521;331676;31327;76.9;75.8;7.2
86;2021-11-12;84;146;922;336605;331822;32249;77.0;75.9;7.4
86;2021-11-13;88;218;881;336693;332040;33130;77.0;75.9;7.6
86;2021-11-14;2;2;21;336695;332042;33151;77.0;75.9;7.6
86;2021-11-15;65;69;872;336760;332111;34023;77.0;75.9;7.8
86;2021-11-16;101;132;1543;336861;332243;35566;77.0;76.0;8.1
86;2021-11-17;132;224;1657;336993;332467;37223;77.0;76.0;8.5
86;2021-11-18;122;113;1557;337115;332580;38780;77.1;76.0;8.9
86;2021-11-19;138;143;1558;337253;332723;40338;77.1;76.1;9.2
86;2021-11-20;100;180;974;337353;332903;41312;77.1;76.1;9.4
86;2021-11-21;2;4;18;337355;332907;41330;77.1;76.1;9.4
86;2021-11-22;79;42;914;337434;332949;42244;77.1;76.1;9.7
86;2021-11-23;135;108;1617;337569;333057;43861;77.2;76.1;10.0
86;2021-11-24;126;169;1612;337695;333226;45473;77.2;76.2;10.4
86;2021-11-25;176;107;2069;337871;333333;47542;77.2;76.2;10.9
86;2021-11-26;145;142;1846;338016;333475;49388;77.3;76.2;11.3
86;2021-11-27;86;131;1107;338102;333606;50495;77.3;76.3;11.5
86;2021-11-28;3;9;69;338105;333615;50564;77.3;76.3;11.6
86;2021-11-29;81;69;2099;338186;333684;52663;77.3;76.3;12.0
86;2021-11-30;145;125;3905;338331;333809;56568;77.4;76.3;12.9
86;2021-12-01;87;104;3010;338418;333913;59578;77.4;76.3;13.6
86;2021-12-02;121;102;4424;338539;334015;64002;77.4;76.4;14.6
86;2021-12-03;92;118;3717;338631;334133;67719;77.4;76.4;15.5
86;2021-12-04;66;93;2293;338697;334226;70012;77.4;76.4;16.0
86;2021-12-05;10;17;731;338707;334243;70743;77.4;76.4;16.2
86;2021-12-06;48;72;2735;338755;334315;73478;77.4;76.4;16.8
86;2021-12-07;116;105;5179;338871;334420;78657;77.5;76.5;18.0
86;2021-12-08;85;130;4996;338956;334550;83653;77.5;76.5;19.1
86;2021-12-09;107;149;5869;339063;334699;89522;77.5;76.5;20.5
86;2021-12-10;132;157;5107;339195;334856;94629;77.5;76.6;21.6
86;2021-12-11;79;90;3199;339274;334946;97828;77.6;76.6;22.4
86;2021-12-12;22;22;714;339296;334968;98542;77.6;76.6;22.5
86;2021-12-13;71;86;3845;339367;335054;102387;77.6;76.6;23.4
86;2021-12-14;141;186;6447;339508;335240;108834;77.6;76.6;24.9
86;2021-12-15;116;147;4980;339624;335387;113814;77.6;76.7;26.0
86;2021-12-16;141;238;7164;339765;335625;120978;77.7;76.7;27.7
87;2020-12-27;0;0;0;0;0;0;0.0;0.0;0.0
87;2020-12-28;1;0;0;1;0;0;0.0;0.0;0.0
87;2020-12-29;0;0;0;1;0;0;0.0;0.0;0.0
87;2020-12-30;1;0;0;2;0;0;0.0;0.0;0.0
87;2020-12-31;0;0;0;2;0;0;0.0;0.0;0.0
87;2021-01-01;0;0;0;2;0;0;0.0;0.0;0.0
87;2021-01-02;0;0;0;2;0;0;0.0;0.0;0.0
87;2021-01-03;0;0;0;2;0;0;0.0;0.0;0.0
87;2021-01-04;1;0;0;3;0;0;0.0;0.0;0.0
87;2021-01-05;2;0;0;5;0;0;0.0;0.0;0.0
87;2021-01-06;22;0;0;27;0;0;0.0;0.0;0.0
87;2021-01-07;253;0;0;280;0;0;0.1;0.0;0.0
87;2021-01-08;347;0;0;627;0;0;0.2;0.0;0.0
87;2021-01-09;64;0;0;691;0;0;0.2;0.0;0.0
87;2021-01-10;33;0;0;724;0;0;0.2;0.0;0.0
87;2021-01-11;397;0;0;1121;0;0;0.3;0.0;0.0
87;2021-01-12;616;0;0;1737;0;0;0.5;0.0;0.0
87;2021-01-13;506;1;0;2243;1;0;0.6;0.0;0.0
87;2021-01-14;435;3;0;2678;4;0;0.7;0.0;0.0
87;2021-01-15;507;3;0;3185;7;0;0.9;0.0;0.0
87;2021-01-16;208;1;0;3393;8;0;0.9;0.0;0.0
87;2021-01-17;4;0;0;3397;8;0;0.9;0.0;0.0
87;2021-01-18;604;5;0;4001;13;0;1.1;0.0;0.0
87;2021-01-19;689;2;0;4690;15;0;1.3;0.0;0.0
87;2021-01-20;701;4;0;5391;19;0;1.5;0.0;0.0
87;2021-01-21;759;2;0;6150;21;0;1.7;0.0;0.0
87;2021-01-22;734;5;0;6884;26;0;1.9;0.0;0.0
87;2021-01-23;308;2;0;7192;28;0;1.9;0.0;0.0
87;2021-01-24;0;0;0;7192;28;0;1.9;0.0;0.0
87;2021-01-25;619;9;0;7811;37;0;2.1;0.0;0.0
87;2021-01-26;618;55;0;8429;92;0;2.3;0.0;0.0
87;2021-01-27;581;50;0;9010;142;0;2.4;0.0;0.0
87;2021-01-28;869;122;0;9879;264;0;2.7;0.1;0.0
87;2021-01-29;727;205;0;10606;469;0;2.9;0.1;0.0
87;2021-01-30;321;73;0;10927;542;0;2.9;0.1;0.0
87;2021-01-31;31;65;0;10958;607;0;3.0;0.2;0.0
87;2021-02-01;395;297;0;11353;904;0;3.1;0.2;0.0
87;2021-02-02;431;460;0;11784;1364;0;3.2;0.4;0.0
87;2021-02-03;619;338;0;12403;1702;0;3.3;0.5;0.0
87;2021-02-04;547;547;0;12950;2249;0;3.5;0.6;0.0
87;2021-02-05;340;343;0;13290;2592;0;3.6;0.7;0.0
87;2021-02-06;56;156;0;13346;2748;0;3.6;0.7;0.0
87;2021-02-07;20;0;0;13366;2748;0;3.6;0.7;0.0
87;2021-02-08;244;409;0;13610;3157;0;3.7;0.9;0.0
87;2021-02-09;262;466;0;13872;3623;0;3.7;1.0;0.0
87;2021-02-10;267;623;0;14139;4246;0;3.8;1.1;0.0
87;2021-02-11;307;539;0;14446;4785;0;3.9;1.3;0.0
87;2021-02-12;281;558;0;14727;5343;0;4.0;1.4;0.0
87;2021-02-13;30;176;0;14757;5519;0;4.0;1.5;0.0
87;2021-02-14;1;4;0;14758;5523;0;4.0;1.5;0.0
87;2021-02-15;241;392;0;14999;5915;0;4.0;1.6;0.0
87;2021-02-16;326;301;0;15325;6216;0;4.1;1.7;0.0
87;2021-02-17;319;397;0;15644;6613;0;4.2;1.8;0.0
87;2021-02-18;470;634;0;16114;7247;0;4.3;2.0;0.0
87;2021-02-19;407;485;0;16521;7732;0;4.5;2.1;0.0
87;2021-02-20;117;195;0;16638;7927;0;4.5;2.1;0.0
87;2021-02-21;5;8;0;16643;7935;0;4.5;2.1;0.0
87;2021-02-22;424;578;0;17067;8513;0;4.6;2.3;0.0
87;2021-02-23;563;645;0;17630;9158;0;4.8;2.5;0.0
87;2021-02-24;514;707;0;18144;9865;0;4.9;2.7;0.0
87;2021-02-25;782;723;0;18926;10588;0;5.1;2.9;0.0
87;2021-02-26;852;503;0;19778;11091;0;5.3;3.0;0.0
87;2021-02-27;406;213;0;20184;11304;0;5.4;3.0;0.0
87;2021-02-28;5;1;0;20189;11305;0;5.4;3.0;0.0
87;2021-03-01;499;366;0;20688;11671;0;5.6;3.1;0.0
87;2021-03-02;971;389;0;21659;12060;0;5.8;3.3;0.0
87;2021-03-03;1125;364;0;22784;12424;0;6.1;3.4;0.0
87;2021-03-04;1399;350;0;24183;12774;0;6.5;3.4;0.0
87;2021-03-05;1762;299;0;25945;13073;0;7.0;3.5;0.0
87;2021-03-06;1003;53;0;26948;13126;0;7.3;3.5;0.0
87;2021-03-07;271;8;0;27219;13134;0;7.3;3.5;0.0
87;2021-03-08;812;239;0;28031;13373;0;7.6;3.6;0.0
87;2021-03-09;1270;243;0;29301;13616;0;7.9;3.7;0.0
87;2021-03-10;1286;224;0;30587;13840;0;8.2;3.7;0.0
87;2021-03-11;1726;259;0;32313;14099;0;8.7;3.8;0.0
87;2021-03-12;2080;292;0;34393;14391;0;9.3;3.9;0.0
87;2021-03-13;1307;27;0;35700;14418;0;9.6;3.9;0.0
87;2021-03-14;94;1;0;35794;14419;0;9.7;3.9;0.0
87;2021-03-15;957;341;0;36751;14760;0;9.9;4.0;0.0
87;2021-03-16;1039;233;0;37790;14993;0;10.2;4.0;0.0
87;2021-03-17;1076;246;0;38866;15239;0;10.5;4.1;0.0
87;2021-03-18;1184;350;0;40050;15589;0;10.8;4.2;0.0
87;2021-03-19;1613;301;0;41663;15890;0;11.2;4.3;0.0
87;2021-03-20;986;90;0;42649;15980;0;11.5;4.3;0.0
87;2021-03-21;35;0;0;42684;15980;0;11.5;4.3;0.0
87;2021-03-22;1003;390;0;43687;16370;0;11.8;4.4;0.0
87;2021-03-23;1340;408;0;45027;16778;0;12.1;4.5;0.0
87;2021-03-24;1483;388;0;46510;17166;0;12.5;4.6;0.0
87;2021-03-25;2400;391;0;48910;17557;0;13.2;4.7;0.0
87;2021-03-26;2456;410;0;51366;17967;0;13.9;4.8;0.0
87;2021-03-27;876;131;0;52242;18098;0;14.1;4.9;0.0
87;2021-03-28;260;17;0;52502;18115;0;14.2;4.9;0.0
87;2021-03-29;1098;406;0;53600;18521;0;14.5;5.0;0.0
87;2021-03-30;1876;646;0;55476;19167;0;15.0;5.2;0.0
87;2021-03-31;1663;683;0;57139;19850;0;15.4;5.4;0.0
87;2021-04-01;2255;577;0;59394;20427;0;16.0;5.5;0.0
87;2021-04-02;1844;596;0;61238;21023;0;16.5;5.7;0.0
87;2021-04-03;494;256;0;61732;21279;0;16.6;5.7;0.0
87;2021-04-04;5;1;0;61737;21280;0;16.7;5.7;0.0
87;2021-04-05;96;4;0;61833;21284;0;16.7;5.7;0.0
87;2021-04-06;1034;910;0;62867;22194;0;17.0;6.0;0.0
87;2021-04-07;1551;929;0;64418;23123;0;17.4;6.2;0.0
87;2021-04-08;1749;1021;0;66167;24144;0;17.8;6.5;0.0
87;2021-04-09;2649;737;0;68816;24881;0;18.6;6.7;0.0
87;2021-04-10;1226;313;0;70042;25194;0;18.9;6.8;0.0
87;2021-04-11;102;7;0;70144;25201;0;18.9;6.8;0.0
87;2021-04-12;1652;815;0;71796;26016;0;19.4;7.0;0.0
87;2021-04-13;2254;1027;0;74050;27043;0;20.0;7.3;0.0
87;2021-04-14;2509;1197;0;76559;28240;0;20.6;7.6;0.0
87;2021-04-15;2215;1047;0;78774;29287;0;21.2;7.9;0.0
87;2021-04-16;2670;1041;0;81444;30328;0;22.0;8.2;0.0
87;2021-04-17;824;447;0;82268;30775;0;22.2;8.3;0.0
87;2021-04-18;137;146;0;82405;30921;0;22.2;8.3;0.0
87;2021-04-19;1686;820;0;84091;31741;0;22.7;8.6;0.0
87;2021-04-20;2068;890;0;86159;32631;0;23.2;8.8;0.0
87;2021-04-21;2236;971;0;88395;33602;0;23.8;9.1;0.0
87;2021-04-22;2549;1151;0;90944;34753;0;24.5;9.4;0.0
87;2021-04-23;2004;1186;0;92948;35939;0;25.1;9.7;0.0
87;2021-04-24;1031;613;0;93979;36552;0;25.3;9.9;0.0
87;2021-04-25;108;106;0;94087;36658;0;25.4;9.9;0.0
87;2021-04-26;1318;883;0;95405;37541;0;25.7;10.1;0.0
87;2021-04-27;2302;1206;0;97707;38747;0;26.4;10.5;0.0
87;2021-04-28;3720;1445;0;101427;40192;0;27.4;10.8;0.0
87;2021-04-29;2971;1839;0;104398;42031;0;28.2;11.3;0.0
87;2021-04-30;3074;1392;0;107472;43423;0;29.0;11.7;0.0
87;2021-05-01;756;65;0;108228;43488;0;29.2;11.7;0.0
87;2021-05-02;388;17;0;108616;43505;0;29.3;11.7;0.0
87;2021-05-03;2124;956;0;110740;44461;0;29.9;12.0;0.0
87;2021-05-04;2731;1127;0;113471;45588;0;30.6;12.3;0.0
87;2021-05-05;2816;1553;0;116287;47141;0;31.4;12.7;0.0
87;2021-05-06;2533;1740;0;118820;48881;0;32.0;13.2;0.0
87;2021-05-07;2864;1748;0;121684;50629;0;32.8;13.7;0.0
87;2021-05-08;825;321;0;122509;50950;0;33.0;13.7;0.0
87;2021-05-09;57;157;0;122566;51107;0;33.1;13.8;0.0
87;2021-05-10;1802;1576;0;124368;52683;0;33.5;14.2;0.0
87;2021-05-11;2380;1915;0;126748;54598;0;34.2;14.7;0.0
87;2021-05-12;2676;2047;0;129424;56645;0;34.9;15.3;0.0
87;2021-05-13;1131;293;0;130555;56938;0;35.2;15.4;0.0
87;2021-05-14;2230;1717;0;132785;58655;0;35.8;15.8;0.0
87;2021-05-15;1099;489;0;133884;59144;0;36.1;16.0;0.0
87;2021-05-16;201;81;0;134085;59225;0;36.2;16.0;0.0
87;2021-05-17;1624;1649;0;135709;60874;0;36.6;16.4;0.0
87;2021-05-18;2709;1795;0;138418;62669;0;37.3;16.9;0.0
87;2021-05-19;2901;1546;0;141319;64215;0;38.1;17.3;0.0
87;2021-05-20;3335;1720;0;144654;65935;0;39.0;17.8;0.0
87;2021-05-21;2811;1800;0;147465;67735;0;39.8;18.3;0.0
87;2021-05-22;1548;641;0;149013;68376;0;40.2;18.4;0.0
87;2021-05-23;251;91;0;149264;68467;0;40.3;18.5;0.0
87;2021-05-24;1101;148;0;150365;68615;0;40.6;18.5;0.0
87;2021-05-25;2154;1778;0;152519;70393;0;41.1;19.0;0.0
87;2021-05-26;3249;2435;0;155768;72828;0;42.0;19.6;0.0
87;2021-05-27;2970;2316;0;158738;75144;0;42.8;20.3;0.0
87;2021-05-28;2651;2512;0;161389;77656;0;43.5;20.9;0.0
87;2021-05-29;1167;1369;0;162556;79025;0;43.8;21.3;0.0
87;2021-05-30;285;85;0;162841;79110;0;43.9;21.3;0.0
87;2021-05-31;2315;1370;0;165156;80480;0;44.5;21.7;0.0
87;2021-06-01;2543;1909;0;167699;82389;0;45.2;22.2;0.0
87;2021-06-02;2573;1858;0;170272;84247;0;45.9;22.7;0.0
87;2021-06-03;3149;2467;0;173421;86714;0;46.8;23.4;0.0
87;2021-06-04;2831;2033;0;176252;88747;0;47.5;23.9;0.0
87;2021-06-05;1404;663;0;177656;89410;0;47.9;24.1;0.0
87;2021-06-06;266;110;0;177922;89520;0;48.0;24.1;0.0
87;2021-06-07;2034;1836;0;179956;91356;0;48.5;24.6;0.0
87;2021-06-08;2843;2474;0;182799;93830;0;49.3;25.3;0.0
87;2021-06-09;2244;2666;0;185043;96496;0;49.9;26.0;0.0
87;2021-06-10;2784;2488;0;187827;98984;0;50.7;26.7;0.0
87;2021-06-11;2306;2946;0;190133;101930;0;51.3;27.5;0.0
87;2021-06-12;1224;1134;0;191357;103064;0;51.6;27.8;0.0
87;2021-06-13;296;497;0;191653;103561;0;51.7;27.9;0.0
87;2021-06-14;990;2595;0;192643;106156;0;52.0;28.6;0.0
87;2021-06-15;1336;3222;0;193979;109378;0;52.3;29.5;0.0
87;2021-06-16;1645;3292;0;195624;112670;0;52.8;30.4;0.0
87;2021-06-17;2341;2270;0;197965;114940;0;53.4;31.0;0.0
87;2021-06-18;1709;2939;0;199674;117879;0;53.9;31.8;0.0
87;2021-06-19;1041;1219;0;200715;119098;0;54.1;32.1;0.0
87;2021-06-20;219;204;0;200934;119302;0;54.2;32.2;0.0
87;2021-06-21;950;2511;0;201884;121813;0;54.4;32.9;0.0
87;2021-06-22;1001;2829;0;202885;124642;0;54.7;33.6;0.0
87;2021-06-23;1198;3091;0;204083;127733;0;55.0;34.5;0.0
87;2021-06-24;1541;2553;0;205624;130286;0;55.5;35.1;0.0
87;2021-06-25;1345;2706;0;206969;132992;0;55.8;35.9;0.0
87;2021-06-26;546;1299;0;207515;134291;0;56.0;36.2;0.0
87;2021-06-27;34;264;0;207549;134555;0;56.0;36.3;0.0
87;2021-06-28;683;2596;0;208232;137151;0;56.2;37.0;0.0
87;2021-06-29;1087;3435;0;209319;140586;0;56.5;37.9;0.0
87;2021-06-30;1057;2737;0;210376;143323;0;56.7;38.7;0.0
87;2021-07-01;1280;2548;0;211656;145871;0;57.1;39.3;0.0
87;2021-07-02;1154;3476;0;212810;149347;0;57.4;40.3;0.0
87;2021-07-03;436;1613;0;213246;150960;0;57.5;40.7;0.0
87;2021-07-04;34;393;0;213280;151353;0;57.5;40.8;0.0
87;2021-07-05;653;2475;0;213933;153828;0;57.7;41.5;0.0
87;2021-07-06;575;3240;0;214508;157068;0;57.9;42.4;0.0
87;2021-07-07;876;3326;0;215384;160394;0;58.1;43.3;0.0
87;2021-07-08;1059;3554;0;216443;163948;0;58.4;44.2;0.0
87;2021-07-09;1098;3717;0;217541;167665;0;58.7;45.2;0.0
87;2021-07-10;331;1477;0;217872;169142;0;58.8;45.6;0.0
87;2021-07-11;64;330;0;217936;169472;0;58.8;45.7;0.0
87;2021-07-12;582;3180;0;218518;172652;0;58.9;46.6;0.0
87;2021-07-13;892;3513;0;219410;176165;0;59.2;47.5;0.0
87;2021-07-14;513;584;0;219923;176749;0;59.3;47.7;0.0
87;2021-07-15;1363;3437;0;221286;180186;0;59.7;48.6;0.0
87;2021-07-16;1728;3600;0;223014;183786;0;60.1;49.6;0.0
87;2021-07-17;685;1458;0;223699;185244;0;60.3;50.0;0.0
87;2021-07-18;121;281;0;223820;185525;0;60.4;50.0;0.0
87;2021-07-19;1367;3318;0;225187;188843;0;60.7;50.9;0.0
87;2021-07-20;1764;3481;0;226951;192324;0;61.2;51.9;0.0
87;2021-07-21;1476;3044;0;228427;195368;0;61.6;52.7;0.0
87;2021-07-22;1896;3112;0;230323;198480;0;62.1;53.5;0.0
87;2021-07-23;1868;3065;0;232191;201545;0;62.6;54.4;0.0
87;2021-07-24;876;1319;0;233067;202864;0;62.9;54.7;0.0
87;2021-07-25;148;231;0;233215;203095;0;62.9;54.8;0.0
87;2021-07-26;1499;2291;0;234714;205386;0;63.3;55.4;0.0
87;2021-07-27;2466;1996;0;237180;207382;0;64.0;55.9;0.0
87;2021-07-28;2292;1933;0;239472;209315;0;64.6;56.5;0.0
87;2021-07-29;2825;1899;0;242297;211214;0;65.3;57.0;0.0
87;2021-07-30;2432;1895;0;244729;213109;0;66.0;57.5;0.0
87;2021-07-31;1200;914;0;245929;214023;0;66.3;57.7;0.0
87;2021-08-01;296;163;0;246225;214186;0;66.4;57.8;0.0
87;2021-08-02;2025;1498;0;248250;215684;0;67.0;58.2;0.0
87;2021-08-03;2347;1293;0;250597;216977;0;67.6;58.5;0.0
87;2021-08-04;2214;996;0;252811;217973;0;68.2;58.8;0.0
87;2021-08-05;2358;1354;0;255169;219327;0;68.8;59.2;0.0
87;2021-08-06;2038;1620;0;257207;220947;0;69.4;59.6;0.0
87;2021-08-07;1082;793;0;258289;221740;0;69.7;59.8;0.0
87;2021-08-08;213;128;0;258502;221868;0;69.7;59.8;0.0
87;2021-08-09;1722;1462;0;260224;223330;0;70.2;60.2;0.0
87;2021-08-10;2094;1492;0;262318;224822;0;70.7;60.6;0.0
87;2021-08-11;1806;1255;0;264124;226077;0;71.2;61.0;0.0
87;2021-08-12;1902;1424;0;266026;227501;0;71.7;61.4;0.0
87;2021-08-13;1566;1533;0;267592;229034;0;72.2;61.8;0.0
87;2021-08-14;674;704;0;268266;229738;0;72.4;62.0;0.0
87;2021-08-15;74;106;0;268340;229844;0;72.4;62.0;0.0
87;2021-08-16;1366;1680;0;269706;231524;0;72.7;62.4;0.0
87;2021-08-17;1284;1652;0;270990;233176;0;73.1;62.9;0.0
87;2021-08-18;1150;1928;0;272140;235104;0;73.4;63.4;0.0
87;2021-08-19;1104;1759;0;273244;236863;0;73.7;63.9;0.0
87;2021-08-20;870;2140;0;274114;239003;0;73.9;64.5;0.0
87;2021-08-21;351;972;0;274465;239975;0;74.0;64.7;0.0
87;2021-08-22;84;233;0;274549;240208;0;74.0;64.8;0.0
87;2021-08-23;699;2307;0;275248;242515;0;74.2;65.4;0.0
87;2021-08-24;733;2136;0;275981;244651;0;74.4;66.0;0.0
87;2021-08-25;678;2007;0;276659;246658;0;74.6;66.5;0.0
87;2021-08-26;803;2126;0;277462;248784;0;74.8;67.1;0.0
87;2021-08-27;737;2554;0;278199;251338;0;75.0;67.8;0.0
87;2021-08-28;323;1290;0;278522;252628;0;75.1;68.1;0.0
87;2021-08-29;64;263;0;278586;252891;0;75.1;68.2;0.0
87;2021-08-30;466;2115;15;279052;255006;15;75.3;68.8;0.0
87;2021-08-31;566;1833;27;279618;256839;42;75.4;69.3;0.0
87;2021-09-01;729;2262;121;280347;259101;163;75.6;69.9;0.0
87;2021-09-02;538;2004;201;280885;261105;364;75.8;70.4;0.1
87;2021-09-03;593;2009;334;281478;263114;698;75.9;71.0;0.2
87;2021-09-04;281;1134;61;281759;264248;759;76.0;71.3;0.2
87;2021-09-05;10;24;2;281769;264272;761;76.0;71.3;0.2
87;2021-09-06;370;1474;374;282139;265746;1135;76.1;71.7;0.3
87;2021-09-07;356;1151;285;282495;266897;1420;76.2;72.0;0.4
87;2021-09-08;430;1411;308;282925;268308;1728;76.3;72.4;0.5
87;2021-09-09;327;917;308;283252;269225;2036;76.4;72.6;0.5
87;2021-09-10;427;1300;329;283679;270525;2365;76.5;73.0;0.6
87;2021-09-11;284;882;70;283963;271407;2435;76.6;73.2;0.7
87;2021-09-12;7;18;2;283970;271425;2437;76.6;73.2;0.7
87;2021-09-13;308;721;372;284278;272146;2809;76.7;73.4;0.8
87;2021-09-14;287;606;412;284565;272752;3221;76.7;73.6;0.9
87;2021-09-15;336;930;339;284901;273682;3560;76.8;73.8;1.0
87;2021-09-16;318;747;374;285219;274429;3934;76.9;74.0;1.1
87;2021-09-17;370;830;429;285589;275259;4363;77.0;74.2;1.2
87;2021-09-18;261;688;123;285850;275947;4486;77.1;74.4;1.2
87;2021-09-19;9;23;7;285859;275970;4493;77.1;74.4;1.2
87;2021-09-20;184;440;247;286043;276410;4740;77.1;74.5;1.3
87;2021-09-21;274;487;307;286317;276897;5047;77.2;74.7;1.4
87;2021-09-22;219;723;416;286536;277620;5463;77.3;74.9;1.5
87;2021-09-23;206;506;393;286742;278126;5856;77.3;75.0;1.6
87;2021-09-24;258;686;557;287000;278812;6413;77.4;75.2;1.7
87;2021-09-25;149;474;156;287149;279286;6569;77.4;75.3;1.8
87;2021-09-26;5;11;4;287154;279297;6573;77.4;75.3;1.8
87;2021-09-27;186;382;246;287340;279679;6819;77.5;75.4;1.8
87;2021-09-28;178;296;346;287518;279975;7165;77.5;75.5;1.9
87;2021-09-29;142;388;347;287660;280363;7512;77.6;75.6;2.0
87;2021-09-30;121;257;389;287781;280620;7901;77.6;75.7;2.1
87;2021-10-01;213;478;353;287994;281098;8254;77.7;75.8;2.2
87;2021-10-02;146;349;136;288140;281447;8390;77.7;75.9;2.3
87;2021-10-03;5;6;2;288145;281453;8392;77.7;75.9;2.3
87;2021-10-04;148;275;449;288293;281728;8841;77.8;76.0;2.4
87;2021-10-05;108;209;480;288401;281937;9321;77.8;76.0;2.5
87;2021-10-06;185;384;589;288586;282321;9910;77.8;76.1;2.7
87;2021-10-07;113;249;409;288699;282570;10319;77.9;76.2;2.8
87;2021-10-08;223;461;679;288922;283031;10998;77.9;76.3;3.0
87;2021-10-09;148;324;243;289070;283355;11241;78.0;76.4;3.0
87;2021-10-10;3;8;3;289073;283363;11244;78.0;76.4;3.0
87;2021-10-11;126;260;310;289199;283623;11554;78.0;76.5;3.1
87;2021-10-12;101;218;574;289300;283841;12128;78.0;76.6;3.3
87;2021-10-13;151;201;494;289451;284042;12622;78.1;76.6;3.4
87;2021-10-14;115;236;501;289566;284278;13123;78.1;76.7;3.5
87;2021-10-15;175;313;601;289741;284591;13724;78.1;76.8;3.7
87;2021-10-16;134;253;294;289875;284844;14018;78.2;76.8;3.8
87;2021-10-17;6;10;0;289881;284854;14018;78.2;76.8;3.8
87;2021-10-18;115;190;526;289996;285044;14544;78.2;76.9;3.9
87;2021-10-19;121;179;603;290117;285223;15147;78.2;76.9;4.1
87;2021-10-20;123;165;623;290240;285388;15770;78.3;77.0;4.3
87;2021-10-21;92;243;620;290332;285631;16390;78.3;77.0;4.4
87;2021-10-22;162;267;604;290494;285898;16994;78.3;77.1;4.6
87;2021-10-23;88;144;242;290582;286042;17236;78.4;77.1;4.6
87;2021-10-24;5;8;1;290587;286050;17237;78.4;77.1;4.6
87;2021-10-25;112;172;546;290699;286222;17783;78.4;77.2;4.8
87;2021-10-26;54;74;571;290753;286296;18354;78.4;77.2;5.0
87;2021-10-27;112;178;739;290865;286474;19093;78.4;77.3;5.1
87;2021-10-28;94;116;585;290959;286590;19678;78.5;77.3;5.3
87;2021-10-29;144;195;687;291103;286785;20365;78.5;77.3;5.5
87;2021-10-30;70;125;263;291173;286910;20628;78.5;77.4;5.6
87;2021-10-31;4;5;5;291177;286915;20633;78.5;77.4;5.6
87;2021-11-01;4;3;5;291181;286918;20638;78.5;77.4;5.6
87;2021-11-02;101;128;663;291282;287046;21301;78.6;77.4;5.7
87;2021-11-03;86;186;644;291368;287232;21945;78.6;77.5;5.9
87;2021-11-04;79;109;654;291447;287341;22599;78.6;77.5;6.1
87;2021-11-05;129;187;840;291576;287528;23439;78.6;77.5;6.3
87;2021-11-06;94;106;313;291670;287634;23752;78.7;77.6;6.4
87;2021-11-07;2;9;0;291672;287643;23752;78.7;77.6;6.4
87;2021-11-08;95;113;798;291767;287756;24550;78.7;77.6;6.6
87;2021-11-09;85;124;1171;291852;287880;25721;78.7;77.6;6.9
87;2021-11-10;114;197;1103;291966;288077;26824;78.7;77.7;7.2
87;2021-11-11;4;5;18;291970;288082;26842;78.7;77.7;7.2
87;2021-11-12;89;156;1035;292059;288238;27877;78.8;77.7;7.5
87;2021-11-13;45;65;326;292104;288303;28203;78.8;77.8;7.6
87;2021-11-14;2;8;3;292106;288311;28206;78.8;77.8;7.6
87;2021-11-15;70;104;1073;292176;288415;29279;78.8;77.8;7.9
87;2021-11-16;85;107;1493;292261;288522;30772;78.8;77.8;8.3
87;2021-11-17;139;154;1307;292400;288676;32079;78.9;77.9;8.7
87;2021-11-18;135;124;1500;292535;288800;33579;78.9;77.9;9.1
87;2021-11-19;116;166;1661;292651;288966;35240;78.9;77.9;9.5
87;2021-11-20;78;116;614;292729;289082;35854;79.0;78.0;9.7
87;2021-11-21;10;7;54;292739;289089;35908;79.0;78.0;9.7
87;2021-11-22;93;88;1338;292832;289177;37246;79.0;78.0;10.0
87;2021-11-23;128;100;1999;292960;289277;39245;79.0;78.0;10.6
87;2021-11-24;159;116;1665;293119;289393;40910;79.1;78.1;11.0
87;2021-11-25;103;115;2180;293222;289508;43090;79.1;78.1;11.6
87;2021-11-26;127;138;2511;293349;289646;45601;79.1;78.1;12.3
87;2021-11-27;79;91;1256;293428;289737;46857;79.1;78.1;12.6
87;2021-11-28;5;6;62;293433;289743;46919;79.1;78.1;12.7
87;2021-11-29;71;100;2119;293504;289843;49038;79.2;78.2;13.2
87;2021-11-30;103;97;2998;293607;289940;52036;79.2;78.2;14.0
87;2021-12-01;63;124;2908;293670;290064;54944;79.2;78.2;14.8
87;2021-12-02;67;63;3581;293737;290127;58525;79.2;78.2;15.8
87;2021-12-03;92;120;3928;293829;290247;62453;79.2;78.3;16.8
87;2021-12-04;62;123;1317;293891;290370;63770;79.3;78.3;17.2
87;2021-12-05;0;9;221;293891;290379;63991;79.3;78.3;17.3
87;2021-12-06;44;85;2780;293935;290464;66771;79.3;78.3;18.0
87;2021-12-07;77;108;5518;294012;290572;72289;79.3;78.4;19.5
87;2021-12-08;94;111;4524;294106;290683;76813;79.3;78.4;20.7
87;2021-12-09;68;106;4310;294174;290789;81123;79.3;78.4;21.9
87;2021-12-10;97;131;5579;294271;290920;86702;79.4;78.5;23.4
87;2021-12-11;54;74;2454;294325;290994;89156;79.4;78.5;24.0
87;2021-12-12;6;14;330;294331;291008;89486;79.4;78.5;24.1
87;2021-12-13;82;102;4339;294413;291110;93825;79.4;78.5;25.3
87;2021-12-14;99;128;5873;294512;291238;99698;79.4;78.5;26.9
87;2021-12-15;98;170;5232;294610;291408;104930;79.5;78.6;28.3
87;2021-12-16;65;108;5306;294675;291516;110236;79.5;78.6;29.7
88;2020-12-27;0;0;0;0;0;0;0.0;0.0;0.0
88;2020-12-28;0;0;0;0;0;0;0.0;0.0;0.0
88;2020-12-29;0;0;0;0;0;0;0.0;0.0;0.0
88;2020-12-30;0;0;0;0;0;0;0.0;0.0;0.0
88;2020-12-31;0;0;0;0;0;0;0.0;0.0;0.0
88;2021-01-01;1;0;0;1;0;0;0.0;0.0;0.0
88;2021-01-02;0;0;0;1;0;0;0.0;0.0;0.0
88;2021-01-03;0;0;0;1;0;0;0.0;0.0;0.0
88;2021-01-04;1;0;0;2;0;0;0.0;0.0;0.0
88;2021-01-05;8;0;0;10;0;0;0.0;0.0;0.0
88;2021-01-06;19;0;0;29;0;0;0.0;0.0;0.0
88;2021-01-07;80;0;0;109;0;0;0.0;0.0;0.0
88;2021-01-08;170;2;0;279;2;0;0.1;0.0;0.0
88;2021-01-09;174;1;0;453;3;0;0.1;0.0;0.0
88;2021-01-10;2;0;0;455;3;0;0.1;0.0;0.0
88;2021-01-11;222;0;0;677;3;0;0.2;0.0;0.0
88;2021-01-12;419;0;0;1096;3;0;0.3;0.0;0.0
88;2021-01-13;485;3;0;1581;6;0;0.4;0.0;0.0
88;2021-01-14;367;4;0;1948;10;0;0.5;0.0;0.0
88;2021-01-15;372;3;0;2320;13;0;0.6;0.0;0.0
88;2021-01-16;61;0;0;2381;13;0;0.7;0.0;0.0
88;2021-01-17;0;0;0;2381;13;0;0.7;0.0;0.0
88;2021-01-18;458;0;0;2839;13;0;0.8;0.0;0.0
88;2021-01-19;461;1;0;3300;14;0;0.9;0.0;0.0
88;2021-01-20;474;1;0;3774;15;0;1.0;0.0;0.0
88;2021-01-21;1435;7;0;5209;22;0;1.4;0.0;0.0
88;2021-01-22;1117;3;0;6326;25;0;1.8;0.0;0.0
88;2021-01-23;280;0;0;6606;25;0;1.8;0.0;0.0
88;2021-01-24;267;2;0;6873;27;0;1.9;0.0;0.0
88;2021-01-25;865;3;0;7738;30;0;2.2;0.0;0.0
88;2021-01-26;359;9;0;8097;39;0;2.3;0.0;0.0
88;2021-01-27;19;5;0;8116;44;0;2.3;0.0;0.0
88;2021-01-28;154;36;0;8270;80;0;2.3;0.0;0.0
88;2021-01-29;508;136;0;8778;216;0;2.4;0.1;0.0
88;2021-01-30;286;117;0;9064;333;0;2.5;0.1;0.0
88;2021-01-31;1;1;0;9065;334;0;2.5;0.1;0.0
88;2021-02-01;411;273;0;9476;607;0;2.6;0.2;0.0
88;2021-02-02;325;348;0;9801;955;0;2.7;0.3;0.0
88;2021-02-03;434;245;0;10235;1200;0;2.8;0.3;0.0
88;2021-02-04;325;242;0;10560;1442;0;2.9;0.4;0.0
88;2021-02-05;461;282;0;11021;1724;0;3.1;0.5;0.0
88;2021-02-06;109;57;0;11130;1781;0;3.1;0.5;0.0
88;2021-02-07;0;4;0;11130;1785;0;3.1;0.5;0.0
88;2021-02-08;356;202;0;11486;1987;0;3.2;0.6;0.0
88;2021-02-09;294;283;0;11780;2270;0;3.3;0.6;0.0
88;2021-02-10;423;346;0;12203;2616;0;3.4;0.7;0.0
88;2021-02-11;811;1010;0;13014;3626;0;3.6;1.0;0.0
88;2021-02-12;912;677;0;13926;4303;0;3.9;1.2;0.0
88;2021-02-13;158;200;0;14084;4503;0;3.9;1.3;0.0
88;2021-02-14;76;193;0;14160;4696;0;3.9;1.3;0.0
88;2021-02-15;620;989;0;14780;5685;0;4.1;1.6;0.0
88;2021-02-16;470;689;0;15250;6374;0;4.2;1.8;0.0
88;2021-02-17;464;435;0;15714;6809;0;4.4;1.9;0.0
88;2021-02-18;519;366;0;16233;7175;0;4.5;2.0;0.0
88;2021-02-19;560;421;0;16793;7596;0;4.7;2.1;0.0
88;2021-02-20;163;103;0;16956;7699;0;4.7;2.1;0.0
88;2021-02-21;0;24;0;16956;7723;0;4.7;2.1;0.0
88;2021-02-22;418;337;0;17374;8060;0;4.8;2.2;0.0
88;2021-02-23;407;237;0;17781;8297;0;4.9;2.3;0.0
88;2021-02-24;543;229;0;18324;8526;0;5.1;2.4;0.0
88;2021-02-25;682;296;0;19006;8822;0;5.3;2.5;0.0
88;2021-02-26;879;293;0;19885;9115;0;5.5;2.5;0.0
88;2021-02-27;265;34;0;20150;9149;0;5.6;2.5;0.0
88;2021-02-28;28;0;0;20178;9149;0;5.6;2.5;0.0
88;2021-03-01;361;453;0;20539;9602;0;5.7;2.7;0.0
88;2021-03-02;438;472;0;20977;10074;0;5.8;2.8;0.0
88;2021-03-03;666;454;0;21643;10528;0;6.0;2.9;0.0
88;2021-03-04;1037;731;0;22680;11259;0;6.3;3.1;0.0
88;2021-03-05;921;690;0;23601;11949;0;6.6;3.3;0.0
88;2021-03-06;1789;123;0;25390;12072;0;7.1;3.4;0.0
88;2021-03-07;1033;81;0;26423;12153;0;7.3;3.4;0.0
88;2021-03-08;721;668;0;27144;12821;0;7.6;3.6;0.0
88;2021-03-09;1101;512;0;28245;13333;0;7.9;3.7;0.0
88;2021-03-10;1062;495;0;29307;13828;0;8.2;3.8;0.0
88;2021-03-11;1413;400;0;30720;14228;0;8.5;4.0;0.0
88;2021-03-12;1289;493;0;32009;14721;0;8.9;4.1;0.0
88;2021-03-13;1243;130;0;33252;14851;0;9.2;4.1;0.0
88;2021-03-14;168;5;0;33420;14856;0;9.3;4.1;0.0
88;2021-03-15;903;436;0;34323;15292;0;9.5;4.3;0.0
88;2021-03-16;967;339;0;35290;15631;0;9.8;4.3;0.0
88;2021-03-17;832;415;0;36122;16046;0;10.0;4.5;0.0
88;2021-03-18;1249;397;0;37371;16443;0;10.4;4.6;0.0
88;2021-03-19;1372;506;0;38743;16949;0;10.8;4.7;0.0
88;2021-03-20;1267;62;0;40010;17011;0;11.1;4.7;0.0
88;2021-03-21;37;0;0;40047;17011;0;11.1;4.7;0.0
88;2021-03-22;1127;531;0;41174;17542;0;11.5;4.9;0.0
88;2021-03-23;1613;436;0;42787;17978;0;11.9;5.0;0.0
88;2021-03-24;1739;475;0;44526;18453;0;12.4;5.1;0.0
88;2021-03-25;2350;483;0;46876;18936;0;13.0;5.3;0.0
88;2021-03-26;2316;451;0;49192;19387;0;13.7;5.4;0.0
88;2021-03-27;879;306;0;50071;19693;0;13.9;5.5;0.0
88;2021-03-28;64;5;0;50135;19698;0;13.9;5.5;0.0
88;2021-03-29;1210;441;0;51345;20139;0;14.3;5.6;0.0
88;2021-03-30;1962;399;0;53307;20538;0;14.8;5.7;0.0
88;2021-03-31;1529;577;0;54836;21115;0;15.3;5.9;0.0
88;2021-04-01;2053;696;0;56889;21811;0;15.8;6.1;0.0
88;2021-04-02;2560;625;0;59449;22436;0;16.5;6.2;0.0
88;2021-04-03;663;211;0;60112;22647;0;16.7;6.3;0.0
88;2021-04-04;22;10;0;60134;22657;0;16.7;6.3;0.0
88;2021-04-05;26;7;0;60160;22664;0;16.7;6.3;0.0
88;2021-04-06;1077;681;0;61237;23345;0;17.0;6.5;0.0
88;2021-04-07;1473;694;0;62710;24039;0;17.4;6.7;0.0
88;2021-04-08;1737;777;0;64447;24816;0;17.9;6.9;0.0
88;2021-04-09;2843;762;0;67290;25578;0;18.7;7.1;0.0
88;2021-04-10;734;638;0;68024;26216;0;18.9;7.3;0.0
88;2021-04-11;36;10;0;68060;26226;0;18.9;7.3;0.0
88;2021-04-12;1437;908;0;69497;27134;0;19.3;7.5;0.0
88;2021-04-13;1975;1036;0;71472;28170;0;19.9;7.8;0.0
88;2021-04-14;1852;869;0;73324;29039;0;20.4;8.1;0.0
88;2021-04-15;1864;1194;0;75188;30233;0;20.9;8.4;0.0
88;2021-04-16;2021;969;0;77209;31202;0;21.5;8.7;0.0
88;2021-04-17;1251;706;0;78460;31908;0;21.8;8.9;0.0
88;2021-04-18;228;23;0;78688;31931;0;21.9;8.9;0.0
88;2021-04-19;1131;1074;0;79819;33005;0;22.2;9.2;0.0
88;2021-04-20;1145;1257;0;80964;34262;0;22.5;9.5;0.0
88;2021-04-21;1451;1214;0;82415;35476;0;22.9;9.9;0.0
88;2021-04-22;1876;1539;0;84291;37015;0;23.4;10.3;0.0
88;2021-04-23;1795;1909;0;86086;38924;0;23.9;10.8;0.0
88;2021-04-24;1038;749;0;87124;39673;0;24.2;11.0;0.0
88;2021-04-25;40;3;0;87164;39676;0;24.2;11.0;0.0
88;2021-04-26;1105;1040;0;88269;40716;0;24.6;11.3;0.0
88;2021-04-27;1228;1621;0;89497;42337;0;24.9;11.8;0.0
88;2021-04-28;1526;1363;0;91023;43700;0;25.3;12.2;0.0
88;2021-04-29;1873;1371;0;92896;45071;0;25.8;12.5;0.0
88;2021-04-30;2240;1455;1;95136;46526;1;26.5;12.9;0.0
88;2021-05-01;1905;288;0;97041;46814;1;27.0;13.0;0.0
88;2021-05-02;1180;121;0;98221;46935;1;27.3;13.1;0.0
88;2021-05-03;1465;1097;0;99686;48032;1;27.7;13.4;0.0
88;2021-05-04;1395;1366;0;101081;49398;1;28.1;13.7;0.0
88;2021-05-05;2267;1478;0;103348;50876;1;28.7;14.2;0.0
88;2021-05-06;2954;1173;0;106302;52049;1;29.6;14.5;0.0
88;2021-05-07;2617;1225;0;108919;53274;1;30.3;14.8;0.0
88;2021-05-08;1454;462;0;110373;53736;1;30.7;14.9;0.0
88;2021-05-09;1461;146;0;111834;53882;1;31.1;15.0;0.0
88;2021-05-10;1631;1482;0;113465;55364;1;31.6;15.4;0.0
88;2021-05-11;2408;1819;0;115873;57183;1;32.2;15.9;0.0
88;2021-05-12;2335;1737;0;118208;58920;1;32.9;16.4;0.0
88;2021-05-13;2715;640;0;120923;59560;1;33.6;16.6;0.0
88;2021-05-14;2218;1383;0;123141;60943;1;34.3;17.0;0.0
88;2021-05-15;1631;741;0;124772;61684;1;34.7;17.2;0.0
88;2021-05-16;1133;96;0;125905;61780;1;35.0;17.2;0.0
88;2021-05-17;1751;913;0;127656;62693;1;35.5;17.4;0.0
88;2021-05-18;1978;1059;0;129634;63752;1;36.1;17.7;0.0
88;2021-05-19;2334;1069;0;131968;64821;1;36.7;18.0;0.0
88;2021-05-20;2818;1188;0;134786;66009;1;37.5;18.4;0.0
88;2021-05-21;2448;1104;0;137234;67113;1;38.2;18.7;0.0
88;2021-05-22;1470;711;0;138704;67824;1;38.6;18.9;0.0
88;2021-05-23;535;73;0;139239;67897;1;38.7;18.9;0.0
88;2021-05-24;1257;388;0;140496;68285;1;39.1;19.0;0.0
88;2021-05-25;1446;1095;0;141942;69380;1;39.5;19.3;0.0
88;2021-05-26;2060;1070;0;144002;70450;1;40.1;19.6;0.0
88;2021-05-27;1795;1268;0;145797;71718;1;40.6;19.9;0.0
88;2021-05-28;1683;1859;0;147480;73577;1;41.0;20.5;0.0
88;2021-05-29;1243;1693;0;148723;75270;1;41.4;20.9;0.0
88;2021-05-30;548;406;0;149271;75676;1;41.5;21.0;0.0
88;2021-05-31;1141;1727;0;150412;77403;1;41.8;21.5;0.0
88;2021-06-01;1582;1880;0;151994;79283;1;42.3;22.1;0.0
88;2021-06-02;1843;1764;0;153837;81047;1;42.8;22.5;0.0
88;2021-06-03;2503;1593;0;156340;82640;1;43.5;23.0;0.0
88;2021-06-04;1862;1839;0;158202;84479;1;44.0;23.5;0.0
88;2021-06-05;1429;1105;0;159631;85584;1;44.4;23.8;0.0
88;2021-06-06;670;151;0;160301;85735;1;44.6;23.8;0.0
88;2021-06-07;1235;1599;0;161536;87334;1;44.9;24.3;0.0
88;2021-06-08;1618;1788;0;163154;89122;1;45.4;24.8;0.0
88;2021-06-09;1588;1804;0;164742;90926;1;45.8;25.3;0.0
88;2021-06-10;1743;1914;0;166485;92840;1;46.3;25.8;0.0
88;2021-06-11;1550;2100;0;168035;94940;1;46.7;26.4;0.0
88;2021-06-12;755;1630;0;168790;96570;1;46.9;26.9;0.0
88;2021-06-13;452;355;0;169242;96925;1;47.1;27.0;0.0
88;2021-06-14;953;2064;0;170195;98989;1;47.3;27.5;0.0
88;2021-06-15;1800;2340;0;171995;101329;1;47.8;28.2;0.0
88;2021-06-16;1409;2715;0;173404;104044;1;48.2;28.9;0.0
88;2021-06-17;1559;2551;0;174963;106595;1;48.7;29.6;0.0
88;2021-06-18;1359;2301;0;176322;108896;1;49.0;30.3;0.0
88;2021-06-19;627;1076;0;176949;109972;1;49.2;30.6;0.0
88;2021-06-20;78;82;0;177027;110054;1;49.2;30.6;0.0
88;2021-06-21;643;2287;0;177670;112341;1;49.4;31.2;0.0
88;2021-06-22;881;3184;0;178551;115525;1;49.7;32.1;0.0
88;2021-06-23;1093;2647;0;179644;118172;1;50.0;32.9;0.0
88;2021-06-24;712;2471;0;180356;120643;1;50.2;33.6;0.0
88;2021-06-25;1358;2923;0;181714;123566;1;50.5;34.4;0.0
88;2021-06-26;801;2031;0;182515;125597;1;50.8;34.9;0.0
88;2021-06-27;520;622;0;183035;126219;1;50.9;35.1;0.0
88;2021-06-28;701;2218;0;183736;128437;1;51.1;35.7;0.0
88;2021-06-29;829;3058;0;184565;131495;1;51.3;36.6;0.0
88;2021-06-30;1029;2848;0;185594;134343;1;51.6;37.4;0.0
88;2021-07-01;1056;2554;0;186650;136897;1;51.9;38.1;0.0
88;2021-07-02;1025;2898;0;187675;139795;1;52.2;38.9;0.0
88;2021-07-03;654;1700;0;188329;141495;1;52.4;39.4;0.0
88;2021-07-04;250;771;0;188579;142266;1;52.5;39.6;0.0
88;2021-07-05;945;1792;0;189524;144058;1;52.7;40.1;0.0
88;2021-07-06;1012;2183;0;190536;146241;1;53.0;40.7;0.0
88;2021-07-07;1140;2412;0;191676;148653;1;53.3;41.3;0.0
88;2021-07-08;1004;1962;0;192680;150615;1;53.6;41.9;0.0
88;2021-07-09;1535;2472;0;194215;153087;1;54.0;42.6;0.0
88;2021-07-10;729;1820;0;194944;154907;1;54.2;43.1;0.0
88;2021-07-11;444;656;0;195388;155563;1;54.3;43.3;0.0
88;2021-07-12;990;2293;0;196378;157856;1;54.6;43.9;0.0
88;2021-07-13;1289;2453;0;197667;160309;1;55.0;44.6;0.0
88;2021-07-14;1116;721;0;198783;161030;1;55.3;44.8;0.0
88;2021-07-15;1710;3131;0;200493;164161;1;55.8;45.7;0.0
88;2021-07-16;1533;2863;0;202026;167024;1;56.2;46.5;0.0
88;2021-07-17;961;1691;0;202987;168715;1;56.5;46.9;0.0
88;2021-07-18;320;727;0;203307;169442;1;56.5;47.1;0.0
88;2021-07-19;1499;2044;0;204806;171486;1;57.0;47.7;0.0
88;2021-07-20;2081;2309;0;206887;173795;1;57.5;48.3;0.0
88;2021-07-21;1960;2196;0;208847;175991;1;58.1;49.0;0.0
88;2021-07-22;1872;2195;0;210719;178186;1;58.6;49.6;0.0
88;2021-07-23;2517;2786;0;213236;180972;1;59.3;50.3;0.0
88;2021-07-24;1263;1321;0;214499;182293;1;59.7;50.7;0.0
88;2021-07-25;445;591;0;214944;182884;1;59.8;50.9;0.0
88;2021-07-26;1653;1897;0;216597;184781;1;60.2;51.4;0.0
88;2021-07-27;2361;1972;0;218958;186753;1;60.9;51.9;0.0
88;2021-07-28;2316;1906;0;221274;188659;1;61.5;52.5;0.0
88;2021-07-29;2993;1598;0;224267;190257;1;62.4;52.9;0.0
88;2021-07-30;2340;2247;0;226607;192504;1;63.0;53.5;0.0
88;2021-07-31;1307;1112;0;227914;193616;1;63.4;53.9;0.0
88;2021-08-01;452;448;0;228366;194064;1;63.5;54.0;0.0
88;2021-08-02;2248;1622;0;230614;195686;1;64.1;54.4;0.0
88;2021-08-03;2762;1512;0;233376;197198;1;64.9;54.9;0.0
88;2021-08-04;2451;1543;0;235827;198741;1;65.6;55.3;0.0
88;2021-08-05;2028;1375;0;237855;200116;1;66.2;55.7;0.0
88;2021-08-06;2847;1932;0;240702;202048;1;67.0;56.2;0.0
88;2021-08-07;1232;992;0;241934;203040;1;67.3;56.5;0.0
88;2021-08-08;715;315;0;242649;203355;1;67.5;56.6;0.0
88;2021-08-09;1424;1562;0;244073;204917;1;67.9;57.0;0.0
88;2021-08-10;1826;1963;0;245899;206880;1;68.4;57.5;0.0
88;2021-08-11;1759;1679;0;247658;208559;1;68.9;58.0;0.0
88;2021-08-12;1581;1376;0;249239;209935;1;69.3;58.4;0.0
88;2021-08-13;1839;2079;0;251078;212014;1;69.8;59.0;0.0
88;2021-08-14;590;998;0;251668;213012;1;70.0;59.2;0.0
88;2021-08-15;280;485;0;251948;213497;1;70.1;59.4;0.0
88;2021-08-16;1040;1857;0;252988;215354;1;70.4;59.9;0.0
88;2021-08-17;1206;1976;0;254194;217330;1;70.7;60.5;0.0
88;2021-08-18;1179;1915;0;255373;219245;1;71.0;61.0;0.0
88;2021-08-19;998;1601;0;256371;220846;1;71.3;61.4;0.0
88;2021-08-20;1023;2280;0;257394;223126;1;71.6;62.1;0.0
88;2021-08-21;439;1292;0;257833;224418;1;71.7;62.4;0.0
88;2021-08-22;91;471;0;257924;224889;1;71.7;62.6;0.0
88;2021-08-23;695;1562;0;258619;226451;1;71.9;63.0;0.0
88;2021-08-24;871;1899;0;259490;228350;1;72.2;63.5;0.0
88;2021-08-25;856;2411;0;260346;230761;1;72.4;64.2;0.0
88;2021-08-26;834;2035;0;261180;232796;1;72.6;64.8;0.0
88;2021-08-27;801;2634;0;261981;235430;1;72.9;65.5;0.0
88;2021-08-28;494;1452;0;262475;236882;1;73.0;65.9;0.0
88;2021-08-29;128;657;0;262603;237539;1;73.0;66.1;0.0
88;2021-08-30;665;2220;38;263268;239759;39;73.2;66.7;0.0
88;2021-08-31;781;2335;46;264049;242094;85;73.4;67.3;0.0
88;2021-09-01;666;1915;86;264715;244009;171;73.6;67.9;0.0
88;2021-09-02;646;1557;129;265361;245566;300;73.8;68.3;0.1
88;2021-09-03;726;2058;157;266087;247624;457;74.0;68.9;0.1
88;2021-09-04;465;1127;56;266552;248751;513;74.1;69.2;0.1
88;2021-09-05;182;366;53;266734;249117;566;74.2;69.3;0.2
88;2021-09-06;467;1085;148;267201;250202;714;74.3;69.6;0.2
88;2021-09-07;542;1153;188;267743;251355;902;74.5;69.9;0.3
88;2021-09-08;451;1245;149;268194;252600;1051;74.6;70.3;0.3
88;2021-09-09;530;783;293;268724;253383;1344;74.7;70.5;0.4
88;2021-09-10;593;1286;227;269317;254669;1571;74.9;70.8;0.4
88;2021-09-11;351;811;72;269668;255480;1643;75.0;71.1;0.5
88;2021-09-12;62;122;18;269730;255602;1661;75.0;71.1;0.5
88;2021-09-13;401;633;333;270131;256235;1994;75.1;71.3;0.6
88;2021-09-14;537;706;572;270668;256941;2566;75.3;71.5;0.7
88;2021-09-15;425;931;417;271093;257872;2983;75.4;71.7;0.8
88;2021-09-16;264;527;337;271357;258399;3320;75.5;71.9;0.9
88;2021-09-17;411;967;426;271768;259366;3746;75.6;72.1;1.0
88;2021-09-18;234;718;149;272002;260084;3895;75.7;72.3;1.1
88;2021-09-19;45;157;10;272047;260241;3905;75.7;72.4;1.1
88;2021-09-20;224;536;368;272271;260777;4273;75.7;72.5;1.2
88;2021-09-21;214;569;351;272485;261346;4624;75.8;72.7;1.3
88;2021-09-22;187;744;456;272672;262090;5080;75.8;72.9;1.4
88;2021-09-23;277;610;326;272949;262700;5406;75.9;73.1;1.5
88;2021-09-24;268;797;473;273217;263497;5879;76.0;73.3;1.6
88;2021-09-25;130;596;179;273347;264093;6058;76.0;73.5;1.7
88;2021-09-26;16;150;22;273363;264243;6080;76.0;73.5;1.7
88;2021-09-27;153;431;428;273516;264674;6508;76.1;73.6;1.8
88;2021-09-28;177;500;475;273693;265174;6983;76.1;73.8;1.9
88;2021-09-29;163;484;368;273856;265658;7351;76.2;73.9;2.0
88;2021-09-30;136;455;254;273992;266113;7605;76.2;74.0;2.1
88;2021-10-01;241;655;355;274233;266768;7960;76.3;74.2;2.2
88;2021-10-02;151;366;102;274384;267134;8062;76.3;74.3;2.2
88;2021-10-03;24;72;19;274408;267206;8081;76.3;74.3;2.2
88;2021-10-04;149;435;387;274557;267641;8468;76.4;74.4;2.4
88;2021-10-05;178;550;477;274735;268191;8945;76.4;74.6;2.5
88;2021-10-06;182;391;402;274917;268582;9347;76.5;74.7;2.6
88;2021-10-07;75;223;173;274992;268805;9520;76.5;74.8;2.6
88;2021-10-08;268;610;521;275260;269415;10041;76.6;74.9;2.8
88;2021-10-09;131;260;137;275391;269675;10178;76.6;75.0;2.8
88;2021-10-10;23;43;12;275414;269718;10190;76.6;75.0;2.8
88;2021-10-11;107;229;447;275521;269947;10637;76.6;75.1;3.0
88;2021-10-12;146;267;717;275667;270214;11354;76.7;75.2;3.2
88;2021-10-13;146;238;536;275813;270452;11890;76.7;75.2;3.3
88;2021-10-14;84;200;281;275897;270652;12171;76.7;75.3;3.4
88;2021-10-15;193;377;586;276090;271029;12757;76.8;75.4;3.5
88;2021-10-16;132;139;156;276222;271168;12913;76.8;75.4;3.6
88;2021-10-17;1;13;0;276223;271181;12913;76.8;75.4;3.6
88;2021-10-18;166;224;637;276389;271405;13550;76.9;75.5;3.8
88;2021-10-19;142;156;478;276531;271561;14028;76.9;75.5;3.9
88;2021-10-20;156;190;449;276687;271751;14477;77.0;75.6;4.0
88;2021-10-21;97;124;299;276784;271875;14776;77.0;75.6;4.1
88;2021-10-22;168;255;762;276952;272130;15538;77.0;75.7;4.3
88;2021-10-23;92;139;191;277044;272269;15729;77.1;75.7;4.4
88;2021-10-24;2;1;8;277046;272270;15737;77.1;75.7;4.4
88;2021-10-25;170;178;731;277216;272448;16468;77.1;75.8;4.6
88;2021-10-26;174;185;886;277390;272633;17354;77.2;75.8;4.8
88;2021-10-27;113;152;663;277503;272785;18017;77.2;75.9;5.0
88;2021-10-28;57;82;218;277560;272867;18235;77.2;75.9;5.1
88;2021-10-29;166;209;801;277726;273076;19036;77.2;76.0;5.3
88;2021-10-30;71;169;308;277797;273245;19344;77.3;76.0;5.4
88;2021-10-31;2;6;0;277799;273251;19344;77.3;76.0;5.4
88;2021-11-01;8;18;12;277807;273269;19356;77.3;76.0;5.4
88;2021-11-02;133;188;782;277940;273457;20138;77.3;76.1;5.6
88;2021-11-03;111;168;829;278051;273625;20967;77.3;76.1;5.8
88;2021-11-04;63;103;428;278114;273728;21395;77.4;76.1;6.0
88;2021-11-05;141;231;987;278255;273959;22382;77.4;76.2;6.2
88;2021-11-06;103;147;327;278358;274106;22709;77.4;76.2;6.3
88;2021-11-07;7;7;17;278365;274113;22726;77.4;76.2;6.3
88;2021-11-08;116;161;1012;278481;274274;23738;77.5;76.3;6.6
88;2021-11-09;95;182;1317;278576;274456;25055;77.5;76.3;7.0
88;2021-11-10;156;181;1270;278732;274637;26325;77.5;76.4;7.3
88;2021-11-11;1;7;11;278733;274644;26336;77.5;76.4;7.3
88;2021-11-12;139;155;1294;278872;274799;27630;77.6;76.4;7.7
88;2021-11-13;74;137;441;278946;274936;28071;77.6;76.5;7.8
88;2021-11-14;1;2;4;278947;274938;28075;77.6;76.5;7.8
88;2021-11-15;113;177;1226;279060;275115;29301;77.6;76.5;8.2
88;2021-11-16;140;144;1466;279200;275259;30767;77.7;76.6;8.6
88;2021-11-17;118;179;1068;279318;275438;31835;77.7;76.6;8.9
88;2021-11-18;77;84;829;279395;275522;32664;77.7;76.6;9.1
88;2021-11-19;165;212;1739;279560;275734;34403;77.8;76.7;9.6
88;2021-11-20;105;105;570;279665;275839;34973;77.8;76.7;9.7
88;2021-11-21;12;15;30;279677;275854;35003;77.8;76.7;9.7
88;2021-11-22;85;56;1232;279762;275910;36235;77.8;76.7;10.1
88;2021-11-23;140;143;1990;279902;276053;38225;77.9;76.8;10.6
88;2021-11-24;137;123;1363;280039;276176;39588;77.9;76.8;11.0
88;2021-11-25;87;71;1105;280126;276247;40693;77.9;76.8;11.3
88;2021-11-26;186;179;2244;280312;276426;42937;78.0;76.9;11.9
88;2021-11-27;137;150;1330;280449;276576;44267;78.0;76.9;12.3
88;2021-11-28;0;5;45;280449;276581;44312;78.0;76.9;12.3
88;2021-11-29;133;106;2545;280582;276687;46857;78.0;77.0;13.0
88;2021-11-30;96;105;2506;280678;276792;49363;78.1;77.0;13.7
88;2021-12-01;109;124;3423;280787;276916;52786;78.1;77.0;14.7
88;2021-12-02;121;52;3536;280908;276968;56322;78.1;77.0;15.7
88;2021-12-03;117;152;3771;281025;277120;60093;78.2;77.1;16.7
88;2021-12-04;95;107;2453;281120;277227;62546;78.2;77.1;17.4
88;2021-12-05;9;19;260;281129;277246;62806;78.2;77.1;17.5
88;2021-12-06;86;102;3172;281215;277348;65978;78.2;77.1;18.4
88;2021-12-07;113;128;4247;281328;277476;70225;78.3;77.2;19.5
88;2021-12-08;117;136;3687;281445;277612;73912;78.3;77.2;20.6
88;2021-12-09;109;104;3568;281554;277716;77480;78.3;77.2;21.6
88;2021-12-10;105;160;4474;281659;277876;81954;78.3;77.3;22.8
88;2021-12-11;116;139;2841;281775;278015;84795;78.4;77.3;23.6
88;2021-12-12;18;12;585;281793;278027;85380;78.4;77.3;23.7
88;2021-12-13;103;87;3602;281896;278114;88982;78.4;77.4;24.8
88;2021-12-14;155;171;5063;282051;278285;94045;78.5;77.4;26.2
88;2021-12-15;163;135;3917;282214;278420;97962;78.5;77.4;27.2
88;2021-12-16;144;116;4616;282358;278536;102578;78.5;77.5;28.5
89;2020-12-27;0;0;0;0;0;0;0.0;0.0;0.0
89;2020-12-28;0;0;0;0;0;0;0.0;0.0;0.0
89;2020-12-29;0;0;0;0;0;0;0.0;0.0;0.0
89;2020-12-30;0;0;0;0;0;0;0.0;0.0;0.0
89;2020-12-31;0;0;0;0;0;0;0.0;0.0;0.0
89;2021-01-01;0;0;0;0;0;0;0.0;0.0;0.0
89;2021-01-02;0;0;0;0;0;0;0.0;0.0;0.0
89;2021-01-03;0;0;0;0;0;0;0.0;0.0;0.0
89;2021-01-04;0;0;0;0;0;0;0.0;0.0;0.0
89;2021-01-05;3;0;0;3;0;0;0.0;0.0;0.0
89;2021-01-06;46;0;0;49;0;0;0.0;0.0;0.0
89;2021-01-07;194;0;0;243;0;0;0.1;0.0;0.0
89;2021-01-08;55;0;0;298;0;0;0.1;0.0;0.0
89;2021-01-09;4;0;0;302;0;0;0.1;0.0;0.0
89;2021-01-10;0;0;0;302;0;0;0.1;0.0;0.0
89;2021-01-11;221;0;0;523;0;0;0.2;0.0;0.0
89;2021-01-12;327;1;0;850;1;0;0.3;0.0;0.0
89;2021-01-13;501;3;0;1351;4;0;0.4;0.0;0.0
89;2021-01-14;637;7;0;1988;11;0;0.6;0.0;0.0
89;2021-01-15;287;3;0;2275;14;0;0.7;0.0;0.0
89;2021-01-16;90;4;0;2365;18;0;0.7;0.0;0.0
89;2021-01-17;0;0;0;2365;18;0;0.7;0.0;0.0
89;2021-01-18;494;1;0;2859;19;0;0.9;0.0;0.0
89;2021-01-19;775;4;0;3634;23;0;1.1;0.0;0.0
89;2021-01-20;762;0;0;4396;23;0;1.3;0.0;0.0
89;2021-01-21;878;1;0;5274;24;0;1.6;0.0;0.0
89;2021-01-22;960;1;0;6234;25;0;1.9;0.0;0.0
89;2021-01-23;154;0;0;6388;25;0;1.9;0.0;0.0
89;2021-01-24;93;1;0;6481;26;0;2.0;0.0;0.0
89;2021-01-25;479;3;0;6960;29;0;2.1;0.0;0.0
89;2021-01-26;584;15;0;7544;44;0;2.3;0.0;0.0
89;2021-01-27;489;34;0;8033;78;0;2.4;0.0;0.0
89;2021-01-28;551;118;0;8584;196;0;2.6;0.1;0.0
89;2021-01-29;849;41;0;9433;237;0;2.8;0.1;0.0
89;2021-01-30;165;64;0;9598;301;0;2.9;0.1;0.0
89;2021-01-31;23;2;0;9621;303;0;2.9;0.1;0.0
89;2021-02-01;257;153;0;9878;456;0;3.0;0.1;0.0
89;2021-02-02;283;322;0;10161;778;0;3.1;0.2;0.0
89;2021-02-03;293;325;0;10454;1103;0;3.1;0.3;0.0
89;2021-02-04;421;539;0;10875;1642;0;3.3;0.5;0.0
89;2021-02-05;364;193;0;11239;1835;0;3.4;0.6;0.0
89;2021-02-06;78;65;0;11317;1900;0;3.4;0.6;0.0
89;2021-02-07;1;1;0;11318;1901;0;3.4;0.6;0.0
89;2021-02-08;271;185;0;11589;2086;0;3.5;0.6;0.0
89;2021-02-09;294;441;0;11883;2527;0;3.6;0.8;0.0
89;2021-02-10;389;303;0;12272;2830;0;3.7;0.9;0.0
89;2021-02-11;329;552;0;12601;3382;0;3.8;1.0;0.0
89;2021-02-12;436;564;0;13037;3946;0;3.9;1.2;0.0
89;2021-02-13;50;125;0;13087;4071;0;3.9;1.2;0.0
89;2021-02-14;20;104;0;13107;4175;0;3.9;1.3;0.0
89;2021-02-15;211;407;0;13318;4582;0;4.0;1.4;0.0
89;2021-02-16;136;559;0;13454;5141;0;4.1;1.5;0.0
89;2021-02-17;271;431;0;13725;5572;0;4.1;1.7;0.0
89;2021-02-18;234;537;0;13959;6109;0;4.2;1.8;0.0
89;2021-02-19;235;607;0;14194;6716;0;4.3;2.0;0.0
89;2021-02-20;35;120;0;14229;6836;0;4.3;2.1;0.0
89;2021-02-21;1;9;0;14230;6845;0;4.3;2.1;0.0
89;2021-02-22;221;443;0;14451;7288;0;4.4;2.2;0.0
89;2021-02-23;179;489;0;14630;7777;0;4.4;2.3;0.0
89;2021-02-24;326;403;0;14956;8180;0;4.5;2.5;0.0
89;2021-02-25;385;461;0;15341;8641;0;4.6;2.6;0.0
89;2021-02-26;375;320;0;15716;8961;0;4.7;2.7;0.0
89;2021-02-27;143;89;0;15859;9050;0;4.8;2.7;0.0
89;2021-02-28;2;13;0;15861;9063;0;4.8;2.7;0.0
89;2021-03-01;518;248;0;16379;9311;0;4.9;2.8;0.0
89;2021-03-02;733;363;0;17112;9674;0;5.2;2.9;0.0
89;2021-03-03;640;272;0;17752;9946;0;5.3;3.0;0.0
89;2021-03-04;673;382;0;18425;10328;0;5.5;3.1;0.0
89;2021-03-05;756;486;0;19181;10814;0;5.8;3.3;0.0
89;2021-03-06;552;136;0;19733;10950;0;5.9;3.3;0.0
89;2021-03-07;307;47;0;20040;10997;0;6.0;3.3;0.0
89;2021-03-08;568;313;0;20608;11310;0;6.2;3.4;0.0
89;2021-03-09;1010;288;0;21618;11598;0;6.5;3.5;0.0
89;2021-03-10;1026;254;0;22644;11852;0;6.8;3.6;0.0
89;2021-03-11;1090;307;0;23734;12159;0;7.1;3.7;0.0
89;2021-03-12;1279;334;0;25013;12493;0;7.5;3.8;0.0
89;2021-03-13;634;48;0;25647;12541;0;7.7;3.8;0.0
89;2021-03-14;11;1;0;25658;12542;0;7.7;3.8;0.0
89;2021-03-15;839;304;0;26497;12846;0;8.0;3.9;0.0
89;2021-03-16;932;214;0;27429;13060;0;8.3;3.9;0.0
89;2021-03-17;923;208;0;28352;13268;0;8.5;4.0;0.0
89;2021-03-18;893;220;0;29245;13488;0;8.8;4.1;0.0
89;2021-03-19;1122;194;0;30367;13682;0;9.1;4.1;0.0
89;2021-03-20;827;28;0;31194;13710;0;9.4;4.1;0.0
89;2021-03-21;193;11;0;31387;13721;0;9.5;4.1;0.0
89;2021-03-22;1051;223;0;32438;13944;0;9.8;4.2;0.0
89;2021-03-23;1701;230;0;34139;14174;0;10.3;4.3;0.0
89;2021-03-24;1937;324;0;36076;14498;0;10.9;4.4;0.0
89;2021-03-25;1847;183;0;37923;14681;0;11.4;4.4;0.0
89;2021-03-26;2504;177;0;40427;14858;0;12.2;4.5;0.0
89;2021-03-27;1682;50;0;42109;14908;0;12.7;4.5;0.0
89;2021-03-28;26;0;0;42135;14908;0;12.7;4.5;0.0
89;2021-03-29;942;564;0;43077;15472;0;13.0;4.7;0.0
89;2021-03-30;1166;565;0;44243;16037;0;13.3;4.8;0.0
89;2021-03-31;1911;487;0;46154;16524;0;13.9;5.0;0.0
89;2021-04-01;2043;467;0;48197;16991;0;14.5;5.1;0.0
89;2021-04-02;1974;443;0;50171;17434;0;15.1;5.2;0.0
89;2021-04-03;912;243;0;51083;17677;0;15.4;5.3;0.0
89;2021-04-04;29;12;0;51112;17689;0;15.4;5.3;0.0
89;2021-04-05;91;5;0;51203;17694;0;15.4;5.3;0.0
89;2021-04-06;1017;750;0;52220;18444;0;15.7;5.6;0.0
89;2021-04-07;985;799;0;53205;19243;0;16.0;5.8;0.0
89;2021-04-08;1689;716;0;54894;19959;0;16.5;6.0;0.0
89;2021-04-09;2122;749;0;57016;20708;0;17.2;6.2;0.0
89;2021-04-10;895;184;0;57911;20892;0;17.4;6.3;0.0
89;2021-04-11;48;5;0;57959;20897;0;17.5;6.3;0.0
89;2021-04-12;962;791;0;58921;21688;0;17.7;6.5;0.0
89;2021-04-13;1315;1049;0;60236;22737;0;18.1;6.8;0.0
89;2021-04-14;1185;1007;0;61421;23744;0;18.5;7.1;0.0
89;2021-04-15;1381;927;0;62802;24671;0;18.9;7.4;0.0
89;2021-04-16;1322;915;0;64124;25586;0;19.3;7.7;0.0
89;2021-04-17;997;440;0;65121;26026;0;19.6;7.8;0.0
89;2021-04-18;47;176;0;65168;26202;0;19.6;7.9;0.0
89;2021-04-19;716;1020;0;65884;27222;0;19.8;8.2;0.0
89;2021-04-20;988;1532;0;66872;28754;0;20.1;8.7;0.0
89;2021-04-21;823;1091;0;67695;29845;0;20.4;9.0;0.0
89;2021-04-22;1058;1155;0;68753;31000;0;20.7;9.3;0.0
89;2021-04-23;1664;1892;0;70417;32892;0;21.2;9.9;0.0
89;2021-04-24;1137;1114;0;71554;34006;0;21.5;10.2;0.0
89;2021-04-25;179;18;0;71733;34024;0;21.6;10.2;0.0
89;2021-04-26;1440;749;0;73173;34773;0;22.0;10.5;0.0
89;2021-04-27;1721;1040;0;74894;35813;0;22.6;10.8;0.0
89;2021-04-28;1587;1764;0;76481;37577;0;23.0;11.3;0.0
89;2021-04-29;1914;1815;0;78395;39392;0;23.6;11.9;0.0
89;2021-04-30;1796;1639;0;80191;41031;0;24.1;12.4;0.0
89;2021-05-01;843;642;0;81034;41673;0;24.4;12.5;0.0
89;2021-05-02;161;47;0;81195;41720;0;24.4;12.6;0.0
89;2021-05-03;1520;777;0;82715;42497;0;24.9;12.8;0.0
89;2021-05-04;1573;1112;0;84288;43609;0;25.4;13.1;0.0
89;2021-05-05;2280;1192;0;86568;44801;0;26.1;13.5;0.0
89;2021-05-06;2350;1364;0;88918;46165;0;26.8;13.9;0.0
89;2021-05-07;2653;1273;0;91571;47438;0;27.6;14.3;0.0
89;2021-05-08;1671;504;0;93242;47942;0;28.1;14.4;0.0
89;2021-05-09;259;33;0;93501;47975;0;28.2;14.4;0.0
89;2021-05-10;1269;950;0;94770;48925;0;28.5;14.7;0.0
89;2021-05-11;2550;1449;0;97320;50374;0;29.3;15.2;0.0
89;2021-05-12;2109;1201;0;99429;51575;0;29.9;15.5;0.0
89;2021-05-13;542;318;0;99971;51893;0;30.1;15.6;0.0
89;2021-05-14;1957;1042;0;101928;52935;0;30.7;15.9;0.0
89;2021-05-15;2034;374;0;103962;53309;0;31.3;16.1;0.0
89;2021-05-16;109;50;0;104071;53359;0;31.3;16.1;0.0
89;2021-05-17;2169;631;0;106240;53990;0;32.0;16.3;0.0
89;2021-05-18;2426;831;0;108666;54821;0;32.7;16.5;0.0
89;2021-05-19;2879;878;0;111545;55699;0;33.6;16.8;0.0
89;2021-05-20;2964;885;0;114509;56584;0;34.5;17.0;0.0
89;2021-05-21;2503;854;0;117012;57438;0;35.2;17.3;0.0
89;2021-05-22;1397;565;0;118409;58003;0;35.7;17.5;0.0
89;2021-05-23;215;15;0;118624;58018;0;35.7;17.5;0.0
89;2021-05-24;443;221;0;119067;58239;0;35.9;17.5;0.0
89;2021-05-25;1650;971;0;120717;59210;0;36.4;17.8;0.0
89;2021-05-26;1861;1005;0;122578;60215;0;36.9;18.1;0.0
89;2021-05-27;2194;1329;0;124772;61544;0;37.6;18.5;0.0
89;2021-05-28;2131;1387;0;126903;62931;0;38.2;18.9;0.0
89;2021-05-29;687;651;0;127590;63582;0;38.4;19.1;0.0
89;2021-05-30;87;29;0;127677;63611;0;38.4;19.2;0.0
89;2021-05-31;1379;964;0;129056;64575;0;38.9;19.4;0.0
89;2021-06-01;1697;982;0;130753;65557;0;39.4;19.7;0.0
89;2021-06-02;2064;1231;0;132817;66788;0;40.0;20.1;0.0
89;2021-06-03;2446;1467;0;135263;68255;0;40.7;20.6;0.0
89;2021-06-04;2272;1835;0;137535;70090;0;41.4;21.1;0.0
89;2021-06-05;1258;1196;0;138793;71286;0;41.8;21.5;0.0
89;2021-06-06;97;69;0;138890;71355;0;41.8;21.5;0.0
89;2021-06-07;2143;1440;0;141033;72795;0;42.5;21.9;0.0
89;2021-06-08;2237;1485;0;143270;74280;0;43.1;22.4;0.0
89;2021-06-09;2296;1473;0;145566;75753;0;43.8;22.8;0.0
89;2021-06-10;2801;1638;0;148367;77391;0;44.7;23.3;0.0
89;2021-06-11;2002;1728;0;150369;79119;0;45.3;23.8;0.0
89;2021-06-12;1040;797;0;151409;79916;0;45.6;24.1;0.0
89;2021-06-13;198;432;0;151607;80348;0;45.7;24.2;0.0
89;2021-06-14;1364;1764;0;152971;82112;0;46.1;24.7;0.0
89;2021-06-15;1456;1969;0;154427;84081;0;46.5;25.3;0.0
89;2021-06-16;1159;2548;0;155586;86629;0;46.8;26.1;0.0
89;2021-06-17;1472;2366;0;157058;88995;0;47.3;26.8;0.0
89;2021-06-18;1624;2812;0;158682;91807;0;47.8;27.6;0.0
89;2021-06-19;720;1631;0;159402;93438;0;48.0;28.1;0.0
89;2021-06-20;71;161;0;159473;93599;0;48.0;28.2;0.0
89;2021-06-21;774;1564;0;160247;95163;0;48.3;28.7;0.0
89;2021-06-22;1080;2724;0;161327;97887;0;48.6;29.5;0.0
89;2021-06-23;1176;1892;0;162503;99779;0;48.9;30.0;0.0
89;2021-06-24;1116;1623;0;163619;101402;0;49.3;30.5;0.0
89;2021-06-25;982;2508;0;164601;103910;0;49.6;31.3;0.0
89;2021-06-26;605;2278;0;165206;106188;0;49.7;32.0;0.0
89;2021-06-27;42;90;0;165248;106278;0;49.8;32.0;0.0
89;2021-06-28;975;2545;0;166223;108823;0;50.1;32.8;0.0
89;2021-06-29;704;2548;0;166927;111371;0;50.3;33.5;0.0
89;2021-06-30;1057;3194;0;167984;114565;0;50.6;34.5;0.0
89;2021-07-01;979;2981;0;168963;117546;0;50.9;35.4;0.0
89;2021-07-02;1198;2760;0;170161;120306;0;51.2;36.2;0.0
89;2021-07-03;585;1585;0;170746;121891;0;51.4;36.7;0.0
89;2021-07-04;35;143;0;170781;122034;0;51.4;36.7;0.0
89;2021-07-05;1280;1878;0;172061;123912;0;51.8;37.3;0.0
89;2021-07-06;1060;2338;0;173121;126250;0;52.1;38.0;0.0
89;2021-07-07;709;1869;0;173830;128119;0;52.3;38.6;0.0
89;2021-07-08;849;1999;0;174679;130118;0;52.6;39.2;0.0
89;2021-07-09;1173;2577;0;175852;132695;0;53.0;40.0;0.0
89;2021-07-10;739;1025;0;176591;133720;0;53.2;40.3;0.0
89;2021-07-11;68;116;0;176659;133836;0;53.2;40.3;0.0
89;2021-07-12;1334;2000;0;177993;135836;0;53.6;40.9;0.0
89;2021-07-13;2095;2805;0;180088;138641;0;54.2;41.7;0.0
89;2021-07-14;432;450;0;180520;139091;0;54.4;41.9;0.0
89;2021-07-15;2213;3245;0;182733;142336;0;55.0;42.9;0.0
89;2021-07-16;2362;2940;0;185095;145276;0;55.7;43.7;0.0
89;2021-07-17;1281;1362;0;186376;146638;0;56.1;44.2;0.0
89;2021-07-18;336;171;0;186712;146809;0;56.2;44.2;0.0
89;2021-07-19;1636;2837;0;188348;149646;0;56.7;45.1;0.0
89;2021-07-20;2076;3337;0;190424;152983;0;57.3;46.1;0.0
89;2021-07-21;2087;2688;0;192511;155671;0;58.0;46.9;0.0
89;2021-07-22;2598;2970;0;195109;158641;0;58.8;47.8;0.0
89;2021-07-23;2543;3093;0;197652;161734;0;59.5;48.7;0.0
89;2021-07-24;1270;1237;0;198922;162971;0;59.9;49.1;0.0
89;2021-07-25;219;231;0;199141;163202;0;60.0;49.1;0.0
89;2021-07-26;1783;2314;0;200924;165516;0;60.5;49.8;0.0
89;2021-07-27;2494;1954;0;203418;167470;0;61.3;50.4;0.0
89;2021-07-28;2575;1424;0;205993;168894;0;62.0;50.9;0.0
89;2021-07-29;2604;1627;0;208597;170521;0;62.8;51.3;0.0
89;2021-07-30;2617;1657;0;211214;172178;0;63.6;51.8;0.0
89;2021-07-31;1173;1099;0;212387;173277;0;64.0;52.2;0.0
89;2021-08-01;175;68;0;212562;173345;0;64.0;52.2;0.0
89;2021-08-02;1841;1346;0;214403;174691;0;64.6;52.6;0.0
89;2021-08-03;2404;1298;0;216807;175989;0;65.3;53.0;0.0
89;2021-08-04;1510;1610;0;218317;177599;0;65.7;53.5;0.0
89;2021-08-05;1508;1665;0;219825;179264;0;66.2;54.0;0.0
89;2021-08-06;2094;1675;0;221919;180939;0;66.8;54.5;0.0
89;2021-08-07;929;1195;0;222848;182134;0;67.1;54.8;0.0
89;2021-08-08;94;103;0;222942;182237;0;67.1;54.9;0.0
89;2021-08-09;1095;1342;0;224037;183579;0;67.5;55.3;0.0
89;2021-08-10;1692;1850;0;225729;185429;0;68.0;55.8;0.0
89;2021-08-11;1470;1613;0;227199;187042;0;68.4;56.3;0.0
89;2021-08-12;1340;1451;0;228539;188493;0;68.8;56.8;0.0
89;2021-08-13;1233;1975;0;229772;190468;0;69.2;57.4;0.0
89;2021-08-14;521;1116;0;230293;191584;0;69.3;57.7;0.0
89;2021-08-15;38;109;0;230331;191693;0;69.4;57.7;0.0
89;2021-08-16;1017;2047;0;231348;193740;0;69.7;58.3;0.0
89;2021-08-17;802;1701;0;232150;195441;0;69.9;58.9;0.0
89;2021-08-18;615;1942;0;232765;197383;0;70.1;59.4;0.0
89;2021-08-19;698;1449;0;233463;198832;0;70.3;59.9;0.0
89;2021-08-20;1009;2209;0;234472;201041;0;70.6;60.5;0.0
89;2021-08-21;311;1159;0;234783;202200;0;70.7;60.9;0.0
89;2021-08-22;42;139;0;234825;202339;0;70.7;60.9;0.0
89;2021-08-23;742;2256;0;235567;204595;0;70.9;61.6;0.0
89;2021-08-24;842;2440;0;236409;207035;0;71.2;62.3;0.0
89;2021-08-25;576;1544;0;236985;208579;0;71.4;62.8;0.0
89;2021-08-26;588;2022;0;237573;210601;0;71.5;63.4;0.0
89;2021-08-27;784;2233;0;238357;212834;0;71.8;64.1;0.0
89;2021-08-28;381;1373;0;238738;214207;0;71.9;64.5;0.0
89;2021-08-29;21;148;0;238759;214355;0;71.9;64.5;0.0
89;2021-08-30;587;2192;25;239346;216547;25;72.1;65.2;0.0
89;2021-08-31;578;1590;40;239924;218137;65;72.2;65.7;0.0
89;2021-09-01;550;1364;80;240474;219501;145;72.4;66.1;0.0
89;2021-09-02;469;1387;150;240943;220888;295;72.6;66.5;0.1
89;2021-09-03;594;1884;181;241537;222772;476;72.7;67.1;0.1
89;2021-09-04;463;955;56;242000;223727;532;72.9;67.4;0.2
89;2021-09-05;27;35;7;242027;223762;539;72.9;67.4;0.2
89;2021-09-06;394;1485;294;242421;225247;833;73.0;67.8;0.3
89;2021-09-07;356;944;236;242777;226191;1069;73.1;68.1;0.3
89;2021-09-08;346;904;173;243123;227095;1242;73.2;68.4;0.4
89;2021-09-09;278;832;131;243401;227927;1373;73.3;68.6;0.4
89;2021-09-10;462;1339;174;243863;229266;1547;73.4;69.0;0.5
89;2021-09-11;295;792;61;244158;230058;1608;73.5;69.3;0.5
89;2021-09-12;14;56;10;244172;230114;1618;73.5;69.3;0.5
89;2021-09-13;381;1026;232;244553;231140;1850;73.6;69.6;0.6
89;2021-09-14;380;664;218;244933;231804;2068;73.8;69.8;0.6
89;2021-09-15;253;728;164;245186;232532;2232;73.8;70.0;0.7
89;2021-09-16;254;544;414;245440;233076;2646;73.9;70.2;0.8
89;2021-09-17;477;1039;344;245917;234115;2990;74.0;70.5;0.9
89;2021-09-18;183;749;92;246100;234864;3082;74.1;70.7;0.9
89;2021-09-19;9;23;12;246109;234887;3094;74.1;70.7;0.9
89;2021-09-20;254;670;380;246363;235557;3474;74.2;70.9;1.0
89;2021-09-21;301;455;466;246664;236012;3940;74.3;71.1;1.2
89;2021-09-22;205;602;261;246869;236614;4201;74.3;71.2;1.3
89;2021-09-23;219;421;274;247088;237035;4475;74.4;71.4;1.3
89;2021-09-24;301;822;322;247389;237857;4797;74.5;71.6;1.4
89;2021-09-25;112;486;75;247501;238343;4872;74.5;71.8;1.5
89;2021-09-26;8;29;5;247509;238372;4877;74.5;71.8;1.5
89;2021-09-27;181;439;377;247690;238811;5254;74.6;71.9;1.6
89;2021-09-28;238;367;309;247928;239178;5563;74.7;72.0;1.7
89;2021-09-29;201;375;312;248129;239553;5875;74.7;72.1;1.8
89;2021-09-30;151;406;327;248280;239959;6202;74.8;72.3;1.9
89;2021-10-01;293;495;380;248573;240454;6582;74.8;72.4;2.0
89;2021-10-02;141;358;84;248714;240812;6666;74.9;72.5;2.0
89;2021-10-03;7;21;5;248721;240833;6671;74.9;72.5;2.0
89;2021-10-04;127;392;329;248848;241225;7000;74.9;72.6;2.1
89;2021-10-05;149;430;328;248997;241655;7328;75.0;72.8;2.2
89;2021-10-06;231;423;434;249228;242078;7762;75.0;72.9;2.3
89;2021-10-07;83;323;385;249311;242401;8147;75.1;73.0;2.5
89;2021-10-08;226;526;494;249537;242927;8641;75.1;73.1;2.6
89;2021-10-09;126;252;173;249663;243179;8814;75.2;73.2;2.7
89;2021-10-10;1;9;7;249664;243188;8821;75.2;73.2;2.7
89;2021-10-11;137;296;276;249801;243484;9097;75.2;73.3;2.7
89;2021-10-12;116;228;432;249917;243712;9529;75.3;73.4;2.9
89;2021-10-13;162;257;396;250079;243969;9925;75.3;73.5;3.0
89;2021-10-14;120;242;397;250199;244211;10322;75.3;73.5;3.1
89;2021-10-15;209;420;518;250408;244631;10840;75.4;73.7;3.3
89;2021-10-16;119;137;153;250527;244768;10993;75.4;73.7;3.3
89;2021-10-17;5;12;31;250532;244780;11024;75.4;73.7;3.3
89;2021-10-18;120;246;398;250652;245026;11422;75.5;73.8;3.4
89;2021-10-19;141;240;545;250793;245266;11967;75.5;73.9;3.6
89;2021-10-20;104;267;641;250897;245533;12608;75.5;73.9;3.8
89;2021-10-21;106;157;548;251003;245690;13156;75.6;74.0;4.0
89;2021-10-22;227;325;586;251230;246015;13742;75.6;74.1;4.1
89;2021-10-23;105;149;304;251335;246164;14046;75.7;74.1;4.2
89;2021-10-24;1;9;3;251336;246173;14049;75.7;74.1;4.2
89;2021-10-25;101;143;569;251437;246316;14618;75.7;74.2;4.4
89;2021-10-26;97;134;620;251534;246450;15238;75.7;74.2;4.6
89;2021-10-27;138;215;784;251672;246665;16022;75.8;74.3;4.8
89;2021-10-28;75;119;735;251747;246784;16757;75.8;74.3;5.0
89;2021-10-29;134;220;706;251881;247004;17463;75.8;74.4;5.3
89;2021-10-30;73;115;345;251954;247119;17808;75.9;74.4;5.4
89;2021-10-31;5;12;18;251959;247131;17826;75.9;74.4;5.4
89;2021-11-01;6;8;12;251965;247139;17838;75.9;74.4;5.4
89;2021-11-02;104;155;609;252069;247294;18447;75.9;74.5;5.6
89;2021-11-03;129;222;946;252198;247516;19393;75.9;74.5;5.8
89;2021-11-04;85;110;588;252283;247626;19981;76.0;74.6;6.0
89;2021-11-05;164;229;952;252447;247855;20933;76.0;74.6;6.3
89;2021-11-06;61;146;408;252508;248001;21341;76.0;74.7;6.4
89;2021-11-07;1;9;18;252509;248010;21359;76.0;74.7;6.4
89;2021-11-08;120;99;869;252629;248109;22228;76.1;74.7;6.7
89;2021-11-09;99;126;933;252728;248235;23161;76.1;74.7;7.0
89;2021-11-10;142;164;1199;252870;248399;24360;76.1;74.8;7.3
89;2021-11-11;6;11;43;252876;248410;24403;76.1;74.8;7.3
89;2021-11-12;115;189;1037;252991;248599;25440;76.2;74.9;7.7
89;2021-11-13;59;138;650;253050;248737;26090;76.2;74.9;7.9
89;2021-11-14;4;13;30;253054;248750;26120;76.2;74.9;7.9
89;2021-11-15;101;125;1119;253155;248875;27239;76.2;74.9;8.2
89;2021-11-16;104;126;1233;253259;249001;28472;76.3;75.0;8.6
89;2021-11-17;142;169;1158;253401;249170;29630;76.3;75.0;8.9
89;2021-11-18;62;86;768;253463;249256;30398;76.3;75.1;9.2
89;2021-11-19;143;205;1344;253606;249461;31742;76.4;75.1;9.6
89;2021-11-20;100;129;746;253706;249590;32488;76.4;75.2;9.8
89;2021-11-21;10;15;40;253716;249605;32528;76.4;75.2;9.8
89;2021-11-22;116;91;1324;253832;249696;33852;76.4;75.2;10.2
89;2021-11-23;98;104;1303;253930;249800;35155;76.5;75.2;10.6
89;2021-11-24;148;119;1262;254078;249919;36417;76.5;75.3;11.0
89;2021-11-25;100;124;1424;254178;250043;37841;76.5;75.3;11.4
89;2021-11-26;125;157;1925;254303;250200;39766;76.6;75.3;12.0
89;2021-11-27;105;116;1081;254408;250316;40847;76.6;75.4;12.3
89;2021-11-28;2;18;79;254410;250334;40926;76.6;75.4;12.3
89;2021-11-29;103;130;1859;254513;250464;42785;76.6;75.4;12.9
89;2021-11-30;105;125;2337;254618;250589;45122;76.7;75.5;13.6
89;2021-12-01;110;132;2480;254728;250721;47602;76.7;75.5;14.3
89;2021-12-02;81;61;2314;254809;250782;49916;76.7;75.5;15.0
89;2021-12-03;106;125;2898;254915;250907;52814;76.8;75.6;15.9
89;2021-12-04;42;92;1823;254957;250999;54637;76.8;75.6;16.5
89;2021-12-05;5;8;108;254962;251007;54745;76.8;75.6;16.5
89;2021-12-06;78;97;3365;255040;251104;58110;76.8;75.6;17.5
89;2021-12-07;111;113;3565;255151;251217;61675;76.8;75.6;18.6
89;2021-12-08;108;107;3159;255259;251324;64834;76.9;75.7;19.5
89;2021-12-09;116;85;3394;255375;251409;68228;76.9;75.7;20.5
89;2021-12-10;118;156;4003;255493;251565;72231;76.9;75.8;21.8
89;2021-12-11;61;120;2711;255554;251685;74942;77.0;75.8;22.6
89;2021-12-12;10;12;237;255564;251697;75179;77.0;75.8;22.6
89;2021-12-13;108;143;3787;255672;251840;78966;77.0;75.8;23.8
89;2021-12-14;108;125;5050;255780;251965;84016;77.0;75.9;25.3
89;2021-12-15;102;159;3645;255882;252124;87661;77.1;75.9;26.4
89;2021-12-16;102;125;3982;255984;252249;91643;77.1;76.0;27.6
90;2020-12-27;0;0;0;0;0;0;0.0;0.0;0.0
90;2020-12-28;0;0;0;0;0;0;0.0;0.0;0.0
90;2020-12-29;0;0;0;0;0;0;0.0;0.0;0.0
90;2020-12-30;1;0;0;1;0;0;0.0;0.0;0.0
90;2020-12-31;0;0;0;1;0;0;0.0;0.0;0.0
90;2021-01-01;0;0;0;1;0;0;0.0;0.0;0.0
90;2021-01-02;1;0;0;2;0;0;0.0;0.0;0.0
90;2021-01-03;0;0;0;2;0;0;0.0;0.0;0.0
90;2021-01-04;4;0;0;6;0;0;0.0;0.0;0.0
90;2021-01-05;0;0;0;6;0;0;0.0;0.0;0.0
90;2021-01-06;6;0;0;12;0;0;0.0;0.0;0.0
90;2021-01-07;10;0;0;22;0;0;0.0;0.0;0.0
90;2021-01-08;93;0;0;115;0;0;0.1;0.0;0.0
90;2021-01-09;34;0;0;149;0;0;0.1;0.0;0.0
90;2021-01-10;0;0;0;149;0;0;0.1;0.0;0.0
90;2021-01-11;136;0;0;285;0;0;0.2;0.0;0.0
90;2021-01-12;335;0;0;620;0;0;0.4;0.0;0.0
90;2021-01-13;358;2;0;978;2;0;0.7;0.0;0.0
90;2021-01-14;310;2;0;1288;4;0;0.9;0.0;0.0
90;2021-01-15;299;7;0;1587;11;0;1.1;0.0;0.0
90;2021-01-16;77;2;0;1664;13;0;1.2;0.0;0.0
90;2021-01-17;1;0;0;1665;13;0;1.2;0.0;0.0
90;2021-01-18;278;1;0;1943;14;0;1.4;0.0;0.0
90;2021-01-19;358;5;0;2301;19;0;1.6;0.0;0.0
90;2021-01-20;318;2;0;2619;21;0;1.9;0.0;0.0
90;2021-01-21;301;1;0;2920;22;0;2.1;0.0;0.0
90;2021-01-22;335;1;0;3255;23;0;2.3;0.0;0.0
90;2021-01-23;118;0;0;3373;23;0;2.4;0.0;0.0
90;2021-01-24;2;0;0;3375;23;0;2.4;0.0;0.0
90;2021-01-25;287;3;0;3662;26;0;2.6;0.0;0.0
90;2021-01-26;259;2;0;3921;28;0;2.8;0.0;0.0
90;2021-01-27;267;4;0;4188;32;0;3.0;0.0;0.0
90;2021-01-28;301;24;0;4489;56;0;3.2;0.0;0.0
90;2021-01-29;245;89;0;4734;145;0;3.4;0.1;0.0
90;2021-01-30;134;23;0;4868;168;0;3.5;0.1;0.0
90;2021-01-31;111;0;0;4979;168;0;3.6;0.1;0.0
90;2021-02-01;254;62;0;5233;230;0;3.7;0.2;0.0
90;2021-02-02;271;99;0;5504;329;0;3.9;0.2;0.0
90;2021-02-03;233;271;0;5737;600;0;4.1;0.4;0.0
90;2021-02-04;235;218;0;5972;818;0;4.3;0.6;0.0
90;2021-02-05;225;224;0;6197;1042;0;4.4;0.7;0.0
90;2021-02-06;83;49;0;6280;1091;0;4.5;0.8;0.0
90;2021-02-07;2;0;0;6282;1091;0;4.5;0.8;0.0
90;2021-02-08;161;155;0;6443;1246;0;4.6;0.9;0.0
90;2021-02-09;117;112;0;6560;1358;0;4.7;1.0;0.0
90;2021-02-10;177;36;0;6737;1394;0;4.8;1.0;0.0
90;2021-02-11;164;93;0;6901;1487;0;4.9;1.1;0.0
90;2021-02-12;129;214;0;7030;1701;0;5.0;1.2;0.0
90;2021-02-13;83;42;0;7113;1743;0;5.1;1.2;0.0
90;2021-02-14;0;1;0;7113;1744;0;5.1;1.2;0.0
90;2021-02-15;118;210;0;7231;1954;0;5.2;1.4;0.0
90;2021-02-16;100;200;0;7331;2154;0;5.2;1.5;0.0
90;2021-02-17;145;181;0;7476;2335;0;5.3;1.7;0.0
90;2021-02-18;128;256;0;7604;2591;0;5.4;1.8;0.0
90;2021-02-19;81;257;0;7685;2848;0;5.5;2.0;0.0
90;2021-02-20;44;92;0;7729;2940;0;5.5;2.1;0.0
90;2021-02-21;0;1;0;7729;2941;0;5.5;2.1;0.0
90;2021-02-22;46;295;0;7775;3236;0;5.5;2.3;0.0
90;2021-02-23;49;247;0;7824;3483;0;5.6;2.5;0.0
90;2021-02-24;79;268;0;7903;3751;0;5.6;2.7;0.0
90;2021-02-25;89;304;0;7992;4055;0;5.7;2.9;0.0
90;2021-02-26;95;318;0;8087;4373;0;5.8;3.1;0.0
90;2021-02-27;140;155;0;8227;4528;0;5.9;3.2;0.0
90;2021-02-28;7;106;0;8234;4634;0;5.9;3.3;0.0
90;2021-03-01;150;206;0;8384;4840;0;6.0;3.5;0.0
90;2021-03-02;182;263;0;8566;5103;0;6.1;3.6;0.0
90;2021-03-03;227;299;0;8793;5402;0;6.3;3.9;0.0
90;2021-03-04;225;244;0;9018;5646;0;6.4;4.0;0.0
90;2021-03-05;338;248;0;9356;5894;0;6.7;4.2;0.0
90;2021-03-06;261;98;0;9617;5992;0;6.9;4.3;0.0
90;2021-03-07;27;2;0;9644;5994;0;6.9;4.3;0.0
90;2021-03-08;186;228;0;9830;6222;0;7.0;4.4;0.0
90;2021-03-09;360;146;0;10190;6368;0;7.3;4.5;0.0
90;2021-03-10;321;182;0;10511;6550;0;7.5;4.7;0.0
90;2021-03-11;314;133;0;10825;6683;0;7.7;4.8;0.0
90;2021-03-12;486;130;0;11311;6813;0;8.1;4.9;0.0
90;2021-03-13;491;51;0;11802;6864;0;8.4;4.9;0.0
90;2021-03-14;53;0;0;11855;6864;0;8.5;4.9;0.0
90;2021-03-15;390;121;0;12245;6985;0;8.7;5.0;0.0
90;2021-03-16;421;103;0;12666;7088;0;9.0;5.1;0.0
90;2021-03-17;306;73;0;12972;7161;0;9.3;5.1;0.0
90;2021-03-18;321;80;0;13293;7241;0;9.5;5.2;0.0
90;2021-03-19;432;80;0;13725;7321;0;9.8;5.2;0.0
90;2021-03-20;404;49;0;14129;7370;0;10.1;5.3;0.0
90;2021-03-21;3;0;0;14132;7370;0;10.1;5.3;0.0
90;2021-03-22;334;34;0;14466;7404;0;10.3;5.3;0.0
90;2021-03-23;660;73;0;15126;7477;0;10.8;5.3;0.0
90;2021-03-24;737;50;0;15863;7527;0;11.3;5.4;0.0
90;2021-03-25;815;69;0;16678;7596;0;11.9;5.4;0.0
90;2021-03-26;1056;46;0;17734;7642;0;12.7;5.5;0.0
90;2021-03-27;337;24;0;18071;7666;0;12.9;5.5;0.0
90;2021-03-28;35;0;0;18106;7666;0;12.9;5.5;0.0
90;2021-03-29;604;146;0;18710;7812;0;13.4;5.6;0.0
90;2021-03-30;584;143;0;19294;7955;0;13.8;5.7;0.0
90;2021-03-31;631;90;0;19925;8045;0;14.2;5.7;0.0
90;2021-04-01;490;120;0;20415;8165;0;14.6;5.8;0.0
90;2021-04-02;543;103;0;20958;8268;0;15.0;5.9;0.0
90;2021-04-03;299;34;0;21257;8302;0;15.2;5.9;0.0
90;2021-04-04;3;2;0;21260;8304;0;15.2;5.9;0.0
90;2021-04-05;3;0;0;21263;8304;0;15.2;5.9;0.0
90;2021-04-06;520;234;0;21783;8538;0;15.5;6.1;0.0
90;2021-04-07;402;228;0;22185;8766;0;15.8;6.3;0.0
90;2021-04-08;469;206;0;22654;8972;0;16.2;6.4;0.0
90;2021-04-09;658;207;0;23312;9179;0;16.6;6.5;0.0
90;2021-04-10;239;39;0;23551;9218;0;16.8;6.6;0.0
90;2021-04-11;9;38;0;23560;9256;0;16.8;6.6;0.0
90;2021-04-12;423;421;0;23983;9677;0;17.1;6.9;0.0
90;2021-04-13;470;463;0;24453;10140;0;17.4;7.2;0.0
90;2021-04-14;418;329;0;24871;10469;0;17.7;7.5;0.0
90;2021-04-15;737;267;0;25608;10736;0;18.3;7.7;0.0
90;2021-04-16;331;349;0;25939;11085;0;18.5;7.9;0.0
90;2021-04-17;147;84;0;26086;11169;0;18.6;8.0;0.0
90;2021-04-18;18;4;0;26104;11173;0;18.6;8.0;0.0
90;2021-04-19;372;485;0;26476;11658;0;18.9;8.3;0.0
90;2021-04-20;435;550;0;26911;12208;0;19.2;8.7;0.0
90;2021-04-21;327;478;0;27238;12686;0;19.4;9.1;0.0
90;2021-04-22;471;489;0;27709;13175;0;19.8;9.4;0.0
90;2021-04-23;437;598;0;28146;13773;0;20.1;9.8;0.0
90;2021-04-24;231;119;0;28377;13892;0;20.2;9.9;0.0
90;2021-04-25;11;1;0;28388;13893;0;20.3;9.9;0.0
90;2021-04-26;397;595;0;28785;14488;0;20.5;10.3;0.0
90;2021-04-27;564;525;0;29349;15013;0;20.9;10.7;0.0
90;2021-04-28;645;420;0;29994;15433;0;21.4;11.0;0.0
90;2021-04-29;884;355;0;30878;15788;0;22.0;11.3;0.0
90;2021-04-30;940;368;0;31818;16156;0;22.7;11.5;0.0
90;2021-05-01;131;45;0;31949;16201;0;22.8;11.6;0.0
90;2021-05-02;28;1;0;31977;16202;0;22.8;11.6;0.0
90;2021-05-03;837;278;0;32814;16480;0;23.4;11.8;0.0
90;2021-05-04;736;562;0;33550;17042;0;23.9;12.2;0.0
90;2021-05-05;837;472;0;34387;17514;0;24.5;12.5;0.0
90;2021-05-06;788;489;0;35175;18003;0;25.1;12.8;0.0
90;2021-05-07;487;428;0;35662;18431;0;25.4;13.2;0.0
90;2021-05-08;55;31;0;35717;18462;0;25.5;13.2;0.0
90;2021-05-09;23;30;0;35740;18492;0;25.5;13.2;0.0
90;2021-05-10;593;440;0;36333;18932;0;25.9;13.5;0.0
90;2021-05-11;850;521;0;37183;19453;0;26.5;13.9;0.0
90;2021-05-12;709;551;0;37892;20004;0;27.0;14.3;0.0
90;2021-05-13;1254;234;0;39146;20238;0;27.9;14.4;0.0
90;2021-05-14;1036;369;0;40182;20607;0;28.7;14.7;0.0
90;2021-05-15;279;125;0;40461;20732;0;28.9;14.8;0.0
90;2021-05-16;41;10;0;40502;20742;0;28.9;14.8;0.0
90;2021-05-17;958;286;0;41460;21028;0;29.6;15.0;0.0
90;2021-05-18;1271;398;0;42731;21426;0;30.5;15.3;0.0
90;2021-05-19;1482;347;0;44213;21773;0;31.5;15.5;0.0
90;2021-05-20;1426;267;0;45639;22040;0;32.6;15.7;0.0
90;2021-05-21;1430;428;0;47069;22468;0;33.6;16.0;0.0
90;2021-05-22;322;145;0;47391;22613;0;33.8;16.1;0.0
90;2021-05-23;12;1;0;47403;22614;0;33.8;16.1;0.0
90;2021-05-24;340;224;0;47743;22838;0;34.1;16.3;0.0
90;2021-05-25;737;676;0;48480;23514;0;34.6;16.8;0.0
90;2021-05-26;885;501;0;49365;24015;0;35.2;17.1;0.0
90;2021-05-27;1177;368;0;50542;24383;0;36.1;17.4;0.0
90;2021-05-28;827;695;0;51369;25078;0;36.7;17.9;0.0
90;2021-05-29;183;291;0;51552;25369;0;36.8;18.1;0.0
90;2021-05-30;7;1;0;51559;25370;0;36.8;18.1;0.0
90;2021-05-31;906;538;0;52465;25908;0;37.4;18.5;0.0
90;2021-06-01;944;575;0;53409;26483;0;38.1;18.9;0.0
90;2021-06-02;769;544;0;54178;27027;0;38.7;19.3;0.0
90;2021-06-03;793;576;0;54971;27603;0;39.2;19.7;0.0
90;2021-06-04;865;823;0;55836;28426;0;39.8;20.3;0.0
90;2021-06-05;121;404;0;55957;28830;0;39.9;20.6;0.0
90;2021-06-06;33;19;0;55990;28849;0;40.0;20.6;0.0
90;2021-06-07;1095;935;0;57085;29784;0;40.7;21.3;0.0
90;2021-06-08;1319;821;0;58404;30605;0;41.7;21.8;0.0
90;2021-06-09;880;599;0;59284;31204;0;42.3;22.3;0.0
90;2021-06-10;647;473;0;59931;31677;0;42.8;22.6;0.0
90;2021-06-11;753;990;0;60684;32667;0;43.3;23.3;0.0
90;2021-06-12;688;350;0;61372;33017;0;43.8;23.6;0.0
90;2021-06-13;22;20;0;61394;33037;0;43.8;23.6;0.0
90;2021-06-14;280;917;0;61674;33954;0;44.0;24.2;0.0
90;2021-06-15;536;899;0;62210;34853;0;44.4;24.9;0.0
90;2021-06-16;518;606;0;62728;35459;0;44.8;25.3;0.0
90;2021-06-17;408;571;0;63136;36030;0;45.1;25.7;0.0
90;2021-06-18;577;983;0;63713;37013;0;45.5;26.4;0.0
90;2021-06-19;415;233;0;64128;37246;0;45.8;26.6;0.0
90;2021-06-20;9;47;0;64137;37293;0;45.8;26.6;0.0
90;2021-06-21;288;1240;0;64425;38533;0;46.0;27.5;0.0
90;2021-06-22;346;1072;0;64771;39605;0;46.2;28.3;0.0
90;2021-06-23;377;783;0;65148;40388;0;46.5;28.8;0.0
90;2021-06-24;324;757;0;65472;41145;0;46.7;29.4;0.0
90;2021-06-25;402;1344;0;65874;42489;0;47.0;30.3;0.0
90;2021-06-26;388;762;0;66262;43251;0;47.3;30.9;0.0
90;2021-06-27;13;42;0;66275;43293;0;47.3;30.9;0.0
90;2021-06-28;363;1419;0;66638;44712;0;47.5;31.9;0.0
90;2021-06-29;292;1497;0;66930;46209;0;47.8;33.0;0.0
90;2021-06-30;455;1346;0;67385;47555;0;48.1;33.9;0.0
90;2021-07-01;347;1029;0;67732;48584;0;48.3;34.7;0.0
90;2021-07-02;543;1302;0;68275;49886;0;48.7;35.6;0.0
90;2021-07-03;87;296;0;68362;50182;0;48.8;35.8;0.0
90;2021-07-04;13;46;0;68375;50228;0;48.8;35.8;0.0
90;2021-07-05;399;948;0;68774;51176;0;49.1;36.5;0.0
90;2021-07-06;482;1120;0;69256;52296;0;49.4;37.3;0.0
90;2021-07-07;372;1176;0;69628;53472;0;49.7;38.2;0.0
90;2021-07-08;309;714;0;69937;54186;0;49.9;38.7;0.0
90;2021-07-09;440;1049;0;70377;55235;0;50.2;39.4;0.0
90;2021-07-10;82;229;0;70459;55464;0;50.3;39.6;0.0
90;2021-07-11;18;22;0;70477;55486;0;50.3;39.6;0.0
90;2021-07-12;262;1160;0;70739;56646;0;50.5;40.4;0.0
90;2021-07-13;512;1212;0;71251;57858;0;50.8;41.3;0.0
90;2021-07-14;106;60;0;71357;57918;0;50.9;41.3;0.0
90;2021-07-15;725;1332;0;72082;59250;0;51.4;42.3;0.0
90;2021-07-16;755;1494;0;72837;60744;0;52.0;43.3;0.0
90;2021-07-17;389;825;0;73226;61569;0;52.3;43.9;0.0
90;2021-07-18;78;42;0;73304;61611;0;52.3;44.0;0.0
90;2021-07-19;946;1264;0;74250;62875;0;53.0;44.9;0.0
90;2021-07-20;1083;1052;0;75333;63927;0;53.8;45.6;0.0
90;2021-07-21;1149;868;0;76482;64795;0;54.6;46.2;0.0
90;2021-07-22;1016;672;0;77498;65467;0;55.3;46.7;0.0
90;2021-07-23;928;1008;0;78426;66475;0;56.0;47.4;0.0
90;2021-07-24;196;133;0;78622;66608;0;56.1;47.5;0.0
90;2021-07-25;47;32;0;78669;66640;0;56.1;47.6;0.0
90;2021-07-26;954;750;0;79623;67390;0;56.8;48.1;0.0
90;2021-07-27;959;702;0;80582;68092;0;57.5;48.6;0.0
90;2021-07-28;839;597;0;81421;68689;0;58.1;49.0;0.0
90;2021-07-29;895;473;0;82316;69162;0;58.7;49.4;0.0
90;2021-07-30;862;570;0;83178;69732;0;59.4;49.8;0.0
90;2021-07-31;493;302;0;83671;70034;0;59.7;50.0;0.0
90;2021-08-01;38;27;0;83709;70061;0;59.7;50.0;0.0
90;2021-08-02;853;511;0;84562;70572;0;60.3;50.4;0.0
90;2021-08-03;863;509;0;85425;71081;0;61.0;50.7;0.0
90;2021-08-04;1041;435;0;86466;71516;0;61.7;51.0;0.0
90;2021-08-05;542;276;0;87008;71792;0;62.1;51.2;0.0
90;2021-08-06;599;433;0;87607;72225;0;62.5;51.5;0.0
90;2021-08-07;100;135;0;87707;72360;0;62.6;51.6;0.0
90;2021-08-08;36;44;0;87743;72404;0;62.6;51.7;0.0
90;2021-08-09;653;766;0;88396;73170;0;63.1;52.2;0.0
90;2021-08-10;499;992;0;88895;74162;0;63.4;52.9;0.0
90;2021-08-11;532;814;0;89427;74976;0;63.8;53.5;0.0
90;2021-08-12;397;717;0;89824;75693;0;64.1;54.0;0.0
90;2021-08-13;472;786;0;90296;76479;0;64.4;54.6;0.0
90;2021-08-14;81;170;0;90377;76649;0;64.5;54.7;0.0
90;2021-08-15;6;37;0;90383;76686;0;64.5;54.7;0.0
90;2021-08-16;411;627;0;90794;77313;0;64.8;55.2;0.0
90;2021-08-17;327;989;0;91121;78302;0;65.0;55.9;0.0
90;2021-08-18;275;849;0;91396;79151;0;65.2;56.5;0.0
90;2021-08-19;252;672;0;91648;79823;0;65.4;57.0;0.0
90;2021-08-20;341;777;0;91989;80600;0;65.6;57.5;0.0
90;2021-08-21;50;168;0;92039;80768;0;65.7;57.6;0.0
90;2021-08-22;3;36;0;92042;80804;0;65.7;57.7;0.0
90;2021-08-23;284;552;0;92326;81356;0;65.9;58.1;0.0
90;2021-08-24;295;937;0;92621;82293;0;66.1;58.7;0.0
90;2021-08-25;239;933;0;92860;83226;0;66.3;59.4;0.0
90;2021-08-26;223;678;0;93083;83904;0;66.4;59.9;0.0
90;2021-08-27;268;786;0;93351;84690;0;66.6;60.4;0.0
90;2021-08-28;41;160;0;93392;84850;0;66.6;60.5;0.0
90;2021-08-29;6;12;0;93398;84862;0;66.6;60.6;0.0
90;2021-08-30;312;655;11;93710;85517;11;66.9;61.0;0.0
90;2021-08-31;251;917;19;93961;86434;30;67.0;61.7;0.0
90;2021-09-01;288;671;141;94249;87105;171;67.3;62.2;0.1
90;2021-09-02;174;376;67;94423;87481;238;67.4;62.4;0.2
90;2021-09-03;249;535;33;94672;88016;271;67.6;62.8;0.2
90;2021-09-04;76;182;35;94748;88198;306;67.6;62.9;0.2
90;2021-09-05;10;31;2;94758;88229;308;67.6;63.0;0.2
90;2021-09-06;149;674;48;94907;88903;356;67.7;63.4;0.3
90;2021-09-07;199;513;111;95106;89416;467;67.9;63.8;0.3
90;2021-09-08;211;536;89;95317;89952;556;68.0;64.2;0.4
90;2021-09-09;186;264;65;95503;90216;621;68.1;64.4;0.4
90;2021-09-10;191;440;93;95694;90656;714;68.3;64.7;0.5
90;2021-09-11;32;39;14;95726;90695;728;68.3;64.7;0.5
90;2021-09-12;5;10;2;95731;90705;730;68.3;64.7;0.5
90;2021-09-13;220;331;156;95951;91036;886;68.5;65.0;0.6
90;2021-09-14;152;328;131;96103;91364;1017;68.6;65.2;0.7
90;2021-09-15;163;349;106;96266;91713;1123;68.7;65.4;0.8
90;2021-09-16;154;230;114;96420;91943;1237;68.8;65.6;0.9
90;2021-09-17;180;318;142;96600;92261;1379;68.9;65.8;1.0
90;2021-09-18;28;65;37;96628;92326;1416;68.9;65.9;1.0
90;2021-09-19;9;8;18;96637;92334;1434;69.0;65.9;1.0
90;2021-09-20;137;226;206;96774;92560;1640;69.1;66.0;1.2
90;2021-09-21;97;239;183;96871;92799;1823;69.1;66.2;1.3
90;2021-09-22;96;301;205;96967;93100;2028;69.2;66.4;1.4
90;2021-09-23;83;133;37;97050;93233;2065;69.2;66.5;1.5
90;2021-09-24;107;292;165;97157;93525;2230;69.3;66.7;1.6
90;2021-09-25;32;58;20;97189;93583;2250;69.3;66.8;1.6
90;2021-09-26;1;5;1;97190;93588;2251;69.3;66.8;1.6
90;2021-09-27;90;197;139;97280;93785;2390;69.4;66.9;1.7
90;2021-09-28;91;140;94;97371;93925;2484;69.5;67.0;1.8
90;2021-09-29;73;225;87;97444;94150;2571;69.5;67.2;1.8
90;2021-09-30;75;134;83;97519;94284;2654;69.6;67.3;1.9
90;2021-10-01;153;217;150;97672;94501;2804;69.7;67.4;2.0
90;2021-10-02;20;63;18;97692;94564;2822;69.7;67.5;2.0
90;2021-10-03;5;10;0;97697;94574;2822;69.7;67.5;2.0
90;2021-10-04;118;191;154;97815;94765;2976;69.8;67.6;2.1
90;2021-10-05;47;142;212;97862;94907;3188;69.8;67.7;2.3
90;2021-10-06;97;177;250;97959;95084;3438;69.9;67.8;2.5
90;2021-10-07;53;117;182;98012;95201;3620;69.9;67.9;2.6
90;2021-10-08;122;223;162;98134;95424;3782;70.0;68.1;2.7
90;2021-10-09;29;36;34;98163;95460;3816;70.0;68.1;2.7
90;2021-10-10;3;4;3;98166;95464;3819;70.0;68.1;2.7
90;2021-10-11;75;130;153;98241;95594;3972;70.1;68.2;2.8
90;2021-10-12;77;120;195;98318;95714;4167;70.2;68.3;3.0
90;2021-10-13;100;148;192;98418;95862;4359;70.2;68.4;3.1
90;2021-10-14;65;106;115;98483;95968;4474;70.3;68.5;3.2
90;2021-10-15;126;182;184;98609;96150;4658;70.4;68.6;3.3
90;2021-10-16;25;43;28;98634;96193;4686;70.4;68.6;3.3
90;2021-10-17;0;3;1;98634;96196;4687;70.4;68.6;3.3
90;2021-10-18;79;128;176;98713;96324;4863;70.4;68.7;3.5
90;2021-10-19;57;107;196;98770;96431;5059;70.5;68.8;3.6
90;2021-10-20;59;98;163;98829;96529;5222;70.5;68.9;3.7
90;2021-10-21;50;59;155;98879;96588;5377;70.6;68.9;3.8
90;2021-10-22;62;152;168;98941;96740;5545;70.6;69.0;4.0
90;2021-10-23;22;22;29;98963;96762;5574;70.6;69.0;4.0
90;2021-10-24;0;4;1;98963;96766;5575;70.6;69.0;4.0
90;2021-10-25;54;105;176;99017;96871;5751;70.7;69.1;4.1
90;2021-10-26;64;85;266;99081;96956;6017;70.7;69.2;4.3
90;2021-10-27;41;125;329;99122;97081;6346;70.7;69.3;4.5
90;2021-10-28;40;46;168;99162;97127;6514;70.8;69.3;4.6
90;2021-10-29;56;92;293;99218;97219;6807;70.8;69.4;4.9
90;2021-10-30;16;27;36;99234;97246;6843;70.8;69.4;4.9
90;2021-10-31;1;8;0;99235;97254;6843;70.8;69.4;4.9
90;2021-11-01;2;1;0;99237;97255;6843;70.8;69.4;4.9
90;2021-11-02;59;90;195;99296;97345;7038;70.9;69.5;5.0
90;2021-11-03;58;108;357;99354;97453;7395;70.9;69.5;5.3
90;2021-11-04;41;65;185;99395;97518;7580;70.9;69.6;5.4
90;2021-11-05;75;112;308;99470;97630;7888;71.0;69.7;5.6
90;2021-11-06;14;29;52;99484;97659;7940;71.0;69.7;5.7
90;2021-11-07;0;2;7;99484;97661;7947;71.0;69.7;5.7
90;2021-11-08;43;72;356;99527;97733;8303;71.0;69.7;5.9
90;2021-11-09;39;72;381;99566;97805;8684;71.0;69.8;6.2
90;2021-11-10;68;75;398;99634;97880;9082;71.1;69.8;6.5
90;2021-11-11;4;7;5;99638;97887;9087;71.1;69.8;6.5
90;2021-11-12;49;83;431;99687;97970;9518;71.1;69.9;6.8
90;2021-11-13;12;34;56;99699;98004;9574;71.1;69.9;6.8
90;2021-11-14;0;4;0;99699;98008;9574;71.1;69.9;6.8
90;2021-11-15;39;53;428;99738;98061;10002;71.2;70.0;7.1
90;2021-11-16;61;59;451;99799;98120;10453;71.2;70.0;7.5
90;2021-11-17;46;80;561;99845;98200;11014;71.2;70.1;7.9
90;2021-11-18;46;46;434;99891;98246;11448;71.3;70.1;8.2
90;2021-11-19;66;61;643;99957;98307;12091;71.3;70.1;8.6
90;2021-11-20;18;20;78;99975;98327;12169;71.3;70.2;8.7
90;2021-11-21;0;2;1;99975;98329;12170;71.3;70.2;8.7
90;2021-11-22;72;41;572;100047;98370;12742;71.4;70.2;9.1
90;2021-11-23;48;59;612;100095;98429;13354;71.4;70.2;9.5
90;2021-11-24;57;76;460;100152;98505;13814;71.5;70.3;9.9
90;2021-11-25;36;41;418;100188;98546;14232;71.5;70.3;10.2
90;2021-11-26;46;84;737;100234;98630;14969;71.5;70.4;10.7
90;2021-11-27;9;27;164;100243;98657;15133;71.5;70.4;10.8
90;2021-11-28;3;6;16;100246;98663;15149;71.5;70.4;10.8
90;2021-11-29;38;53;1141;100284;98716;16290;71.6;70.4;11.6
90;2021-11-30;47;57;1355;100331;98773;17645;71.6;70.5;12.6
90;2021-12-01;39;66;1329;100370;98839;18974;71.6;70.5;13.5
90;2021-12-02;34;30;1502;100404;98869;20476;71.6;70.5;14.6
90;2021-12-03;43;58;1693;100447;98927;22169;71.7;70.6;15.8
90;2021-12-04;29;24;634;100476;98951;22803;71.7;70.6;16.3
90;2021-12-05;3;2;99;100479;98953;22902;71.7;70.6;16.3
90;2021-12-06;35;54;1526;100514;99007;24428;71.7;70.6;17.4
90;2021-12-07;42;79;1874;100556;99086;26302;71.8;70.7;18.8
90;2021-12-08;36;61;1547;100592;99147;27849;71.8;70.7;19.9
90;2021-12-09;34;46;1521;100626;99193;29370;71.8;70.8;21.0
90;2021-12-10;53;88;1764;100679;99281;31134;71.8;70.8;22.2
90;2021-12-11;12;20;560;100691;99301;31694;71.8;70.9;22.6
90;2021-12-12;0;3;37;100691;99304;31731;71.8;70.9;22.6
90;2021-12-13;48;70;1626;100739;99374;33357;71.9;70.9;23.8
90;2021-12-14;40;66;1824;100779;99440;35181;71.9;71.0;25.1
90;2021-12-15;20;70;1335;100799;99510;36516;71.9;71.0;26.1
90;2021-12-16;46;43;1410;100845;99553;37926;72.0;71.0;27.1
91;2020-12-27;1;0;0;1;0;0;0.0;0.0;0.0
91;2020-12-28;0;0;0;1;0;0;0.0;0.0;0.0
91;2020-12-29;1;0;0;2;0;0;0.0;0.0;0.0
91;2020-12-30;5;0;0;7;0;0;0.0;0.0;0.0
91;2020-12-31;0;0;0;7;0;0;0.0;0.0;0.0
91;2021-01-01;9;0;0;16;0;0;0.0;0.0;0.0
91;2021-01-02;0;0;0;16;0;0;0.0;0.0;0.0
91;2021-01-03;2;0;0;18;0;0;0.0;0.0;0.0
91;2021-01-04;12;0;0;30;0;0;0.0;0.0;0.0
91;2021-01-05;140;3;0;170;3;0;0.0;0.0;0.0
91;2021-01-06;287;2;0;457;5;0;0.0;0.0;0.0
91;2021-01-07;585;7;0;1042;12;0;0.1;0.0;0.0
91;2021-01-08;526;5;0;1568;17;0;0.1;0.0;0.0
91;2021-01-09;111;3;0;1679;20;0;0.1;0.0;0.0
91;2021-01-10;24;0;0;1703;20;0;0.1;0.0;0.0
91;2021-01-11;760;7;0;2463;27;0;0.2;0.0;0.0
91;2021-01-12;1080;14;0;3543;41;0;0.3;0.0;0.0
91;2021-01-13;887;12;0;4430;53;0;0.3;0.0;0.0
91;2021-01-14;972;17;0;5402;70;0;0.4;0.0;0.0
91;2021-01-15;784;8;0;6186;78;0;0.5;0.0;0.0
91;2021-01-16;304;7;0;6490;85;0;0.5;0.0;0.0
91;2021-01-17;101;1;0;6591;86;0;0.5;0.0;0.0
91;2021-01-18;1165;17;0;7756;103;0;0.6;0.0;0.0
91;2021-01-19;1994;35;0;9750;138;0;0.7;0.0;0.0
91;2021-01-20;2339;38;0;12089;176;0;0.9;0.0;0.0
91;2021-01-21;2222;27;0;14311;203;0;1.1;0.0;0.0
91;2021-01-22;1883;20;0;16194;223;0;1.2;0.0;0.0
91;2021-01-23;433;2;0;16627;225;0;1.3;0.0;0.0
91;2021-01-24;75;2;0;16702;227;0;1.3;0.0;0.0
91;2021-01-25;1075;8;0;17777;235;0;1.3;0.0;0.0
91;2021-01-26;1653;55;0;19430;290;0;1.5;0.0;0.0
91;2021-01-27;2331;104;0;21761;394;0;1.6;0.0;0.0
91;2021-01-28;1949;221;0;23710;615;0;1.8;0.0;0.0
91;2021-01-29;1732;83;0;25442;698;0;1.9;0.1;0.0
91;2021-01-30;382;11;0;25824;709;0;2.0;0.1;0.0
91;2021-01-31;48;3;0;25872;712;0;2.0;0.1;0.0
91;2021-02-01;940;215;0;26812;927;0;2.0;0.1;0.0
91;2021-02-02;888;367;0;27700;1294;0;2.1;0.1;0.0
91;2021-02-03;992;527;0;28692;1821;0;2.2;0.1;0.0
91;2021-02-04;868;357;0;29560;2178;0;2.2;0.2;0.0
91;2021-02-05;1016;444;0;30576;2622;0;2.3;0.2;0.0
91;2021-02-06;297;97;0;30873;2719;0;2.3;0.2;0.0
91;2021-02-07;19;12;0;30892;2731;0;2.3;0.2;0.0
91;2021-02-08;809;647;0;31701;3378;0;2.4;0.3;0.0
91;2021-02-09;908;1018;0;32609;4396;0;2.5;0.3;0.0
91;2021-02-10;1039;1145;0;33648;5541;0;2.6;0.4;0.0
91;2021-02-11;1209;1268;0;34857;6809;0;2.6;0.5;0.0
91;2021-02-12;1105;1000;0;35962;7809;0;2.7;0.6;0.0
91;2021-02-13;305;310;0;36267;8119;0;2.7;0.6;0.0
91;2021-02-14;14;90;0;36281;8209;0;2.7;0.6;0.0
91;2021-02-15;421;1307;0;36702;9516;0;2.8;0.7;0.0
91;2021-02-16;609;2040;0;37311;11556;0;2.8;0.9;0.0
91;2021-02-17;790;2457;0;38101;14013;0;2.9;1.1;0.0
91;2021-02-18;950;1993;0;39051;16006;0;3.0;1.2;0.0
91;2021-02-19;962;1445;0;40013;17451;0;3.0;1.3;0.0
91;2021-02-20;145;415;0;40158;17866;0;3.0;1.4;0.0
91;2021-02-21;17;43;0;40175;17909;0;3.0;1.4;0.0
91;2021-02-22;404;1157;0;40579;19066;0;3.1;1.4;0.0
91;2021-02-23;508;1070;0;41087;20136;0;3.1;1.5;0.0
91;2021-02-24;591;1005;0;41678;21141;0;3.2;1.6;0.0
91;2021-02-25;815;1176;0;42493;22317;0;3.2;1.7;0.0
91;2021-02-26;1191;1034;0;43684;23351;0;3.3;1.8;0.0
91;2021-02-27;621;290;0;44305;23641;0;3.4;1.8;0.0
91;2021-02-28;76;66;0;44381;23707;0;3.4;1.8;0.0
91;2021-03-01;986;945;0;45367;24652;0;3.4;1.9;0.0
91;2021-03-02;1485;1078;0;46852;25730;0;3.6;2.0;0.0
91;2021-03-03;1732;1234;0;48584;26964;0;3.7;2.0;0.0
91;2021-03-04;2702;1148;0;51286;28112;0;3.9;2.1;0.0
91;2021-03-05;3830;1202;0;55116;29314;0;4.2;2.2;0.0
91;2021-03-06;4819;436;0;59935;29750;0;4.5;2.3;0.0
91;2021-03-07;3020;199;0;62955;29949;0;4.8;2.3;0.0
91;2021-03-08;1787;987;0;64742;30936;0;4.9;2.3;0.0
91;2021-03-09;2979;941;0;67721;31877;0;5.1;2.4;0.0
91;2021-03-10;2981;1002;0;70702;32879;0;5.4;2.5;0.0
91;2021-03-11;4091;1124;0;74793;34003;0;5.7;2.6;0.0
91;2021-03-12;5081;1024;0;79874;35027;0;6.1;2.7;0.0
91;2021-03-13;5279;363;0;85153;35390;0;6.5;2.7;0.0
91;2021-03-14;522;50;0;85675;35440;0;6.5;2.7;0.0
91;2021-03-15;3187;486;0;88862;35926;0;6.7;2.7;0.0
91;2021-03-16;2719;440;0;91581;36366;0;6.9;2.8;0.0
91;2021-03-17;2470;393;0;94051;36759;0;7.1;2.8;0.0
91;2021-03-18;2614;448;0;96665;37207;0;7.3;2.8;0.0
91;2021-03-19;4171;462;0;100836;37669;0;7.6;2.9;0.0
91;2021-03-20;3412;198;0;104248;37867;0;7.9;2.9;0.0
91;2021-03-21;206;71;0;104454;37938;0;7.9;2.9;0.0
91;2021-03-22;3317;599;0;107771;38537;0;8.2;2.9;0.0
91;2021-03-23;4412;721;0;112183;39258;0;8.5;3.0;0.0
91;2021-03-24;4209;598;0;116392;39856;0;8.8;3.0;0.0
91;2021-03-25;5574;565;0;121966;40421;0;9.2;3.1;0.0
91;2021-03-26;6003;671;0;127969;41092;0;9.7;3.1;0.0
91;2021-03-27;4602;337;0;132571;41429;0;10.0;3.1;0.0
91;2021-03-28;430;62;0;133001;41491;0;10.1;3.1;0.0
91;2021-03-29;3712;1118;0;136713;42609;0;10.4;3.2;0.0
91;2021-03-30;4929;1306;0;141642;43915;0;10.7;3.3;0.0
91;2021-03-31;3860;1472;0;145502;45387;0;11.0;3.4;0.0
91;2021-04-01;4461;1862;0;149963;47249;0;11.4;3.6;0.0
91;2021-04-02;4389;2415;0;154352;49664;0;11.7;3.8;0.0
91;2021-04-03;2113;2451;0;156465;52115;0;11.9;3.9;0.0
91;2021-04-04;682;1128;0;157147;53243;0;11.9;4.0;0.0
91;2021-04-05;679;162;0;157826;53405;0;12.0;4.0;0.0
91;2021-04-06;3884;1982;0;161710;55387;0;12.3;4.2;0.0
91;2021-04-07;4195;2128;0;165905;57515;0;12.6;4.4;0.0
91;2021-04-08;5260;2322;0;171165;59837;0;13.0;4.5;0.0
91;2021-04-09;6063;2356;0;177228;62193;0;13.4;4.7;0.0
91;2021-04-10;3118;2739;0;180346;64932;0;13.7;4.9;0.0
91;2021-04-11;333;229;0;180679;65161;0;13.7;4.9;0.0
91;2021-04-12;3384;2360;0;184063;67521;0;14.0;5.1;0.0
91;2021-04-13;4313;2962;0;188376;70483;0;14.3;5.3;0.0
91;2021-04-14;4252;2512;0;192628;72995;0;14.6;5.5;0.0
91;2021-04-15;4908;2701;0;197536;75696;0;15.0;5.7;0.0
91;2021-04-16;5156;2968;0;202692;78664;0;15.4;6.0;0.0
91;2021-04-17;3128;2001;0;205820;80665;0;15.6;6.1;0.0
91;2021-04-18;432;125;0;206252;80790;0;15.6;6.1;0.0
91;2021-04-19;2804;2851;0;209056;83641;0;15.8;6.3;0.0
91;2021-04-20;3691;3055;0;212747;86696;0;16.1;6.6;0.0
91;2021-04-21;3575;3045;0;216322;89741;0;16.4;6.8;0.0
91;2021-04-22;3780;3699;0;220102;93440;0;16.7;7.1;0.0
91;2021-04-23;4362;3541;0;224464;96981;0;17.0;7.4;0.0
91;2021-04-24;4053;3378;0;228517;100359;0;17.3;7.6;0.0
91;2021-04-25;2638;704;0;231155;101063;0;17.5;7.7;0.0
91;2021-04-26;3990;3006;0;235145;104069;0;17.8;7.9;0.0
91;2021-04-27;5062;3204;0;240207;107273;0;18.2;8.1;0.0
91;2021-04-28;5315;2949;0;245522;110222;0;18.6;8.4;0.0
91;2021-04-29;6426;3289;0;251948;113511;0;19.1;8.6;0.0
91;2021-04-30;6074;3109;0;258022;116620;0;19.6;8.8;0.0
91;2021-05-01;3535;637;0;261557;117257;0;19.8;8.9;0.0
91;2021-05-02;928;205;0;262485;117462;0;19.9;8.9;0.0
91;2021-05-03;5778;3245;0;268263;120707;0;20.3;9.1;0.0
91;2021-05-04;6116;3815;0;274379;124522;0;20.8;9.4;0.0
91;2021-05-05;5602;3353;0;279981;127875;0;21.2;9.7;0.0
91;2021-05-06;6036;3851;0;286017;131726;0;21.7;10.0;0.0
91;2021-05-07;6694;4096;0;292711;135822;0;22.2;10.3;0.0
91;2021-05-08;6090;1489;0;298801;137311;0;22.6;10.4;0.0
91;2021-05-09;4687;767;0;303488;138078;0;23.0;10.5;0.0
91;2021-05-10;6561;3479;0;310049;141557;0;23.5;10.7;0.0
91;2021-05-11;7831;4295;0;317880;145852;0;24.1;11.1;0.0
91;2021-05-12;7258;3869;0;325138;149721;0;24.6;11.3;0.0
91;2021-05-13;5631;1149;0;330769;150870;0;25.1;11.4;0.0
91;2021-05-14;7803;2667;0;338572;153537;0;25.7;11.6;0.0
91;2021-05-15;7657;2053;0;346229;155590;0;26.2;11.8;0.0
91;2021-05-16;4391;445;0;350620;156035;0;26.6;11.8;0.0
91;2021-05-17;7757;1935;0;358377;157970;0;27.2;12.0;0.0
91;2021-05-18;8991;2012;0;367368;159982;0;27.8;12.1;0.0
91;2021-05-19;8554;2444;0;375922;162426;0;28.5;12.3;0.0
91;2021-05-20;9522;2674;0;385444;165100;0;29.2;12.5;0.0
91;2021-05-21;9248;2827;0;394692;167927;0;29.9;12.7;0.0
91;2021-05-22;7498;1562;0;402190;169489;0;30.5;12.8;0.0
91;2021-05-23;4681;559;0;406871;170048;0;30.8;12.9;0.0
91;2021-05-24;5044;644;0;411915;170692;0;31.2;12.9;0.0
91;2021-05-25;8553;3208;0;420468;173900;0;31.9;13.2;0.0
91;2021-05-26;7821;3323;0;428289;177223;0;32.5;13.4;0.0
91;2021-05-27;8557;3814;0;436846;181037;0;33.1;13.7;0.0
91;2021-05-28;8027;4688;0;444873;185725;0;33.7;14.1;0.0
91;2021-05-29;8582;3510;0;453455;189235;0;34.4;14.3;0.0
91;2021-05-30;4621;896;0;458076;190131;0;34.7;14.4;0.0
91;2021-05-31;7312;4112;0;465388;194243;0;35.3;14.7;0.0
91;2021-06-01;8337;5280;0;473725;199523;0;35.9;15.1;0.0
91;2021-06-02;8088;4601;0;481813;204124;0;36.5;15.5;0.0
91;2021-06-03;8441;5246;0;490254;209370;0;37.2;15.9;0.0
91;2021-06-04;7830;6140;0;498084;215510;0;37.8;16.3;0.0
91;2021-06-05;6337;6128;0;504421;221638;0;38.2;16.8;0.0
91;2021-06-06;3851;2313;0;508272;223951;0;38.5;17.0;0.0
91;2021-06-07;6231;5888;0;514503;229839;0;39.0;17.4;0.0
91;2021-06-08;7125;6482;0;521628;236321;0;39.5;17.9;0.0
91;2021-06-09;6815;6048;0;528443;242369;0;40.1;18.4;0.0
91;2021-06-10;7267;7559;0;535710;249928;0;40.6;18.9;0.0
91;2021-06-11;6752;7556;0;542462;257484;0;41.1;19.5;0.0
91;2021-06-12;6197;6969;0;548659;264453;0;41.6;20.0;0.0
91;2021-06-13;2654;2160;0;551313;266613;0;41.8;20.2;0.0
91;2021-06-14;4427;7889;0;555740;274502;0;42.1;20.8;0.0
91;2021-06-15;5733;8046;0;561473;282548;0;42.6;21.4;0.0
91;2021-06-16;5172;7093;0;566645;289641;0;42.9;22.0;0.0
91;2021-06-17;6041;7737;0;572686;297378;0;43.4;22.5;0.0
91;2021-06-18;4913;9497;0;577599;306875;0;43.8;23.3;0.0
91;2021-06-19;4049;7254;0;581648;314129;0;44.1;23.8;0.0
91;2021-06-20;957;4212;0;582605;318341;0;44.2;24.1;0.0
91;2021-06-21;3424;8123;0;586029;326464;0;44.4;24.7;0.0
91;2021-06-22;4044;9925;0;590073;336389;0;44.7;25.5;0.0
91;2021-06-23;4145;8720;0;594218;345109;0;45.0;26.2;0.0
91;2021-06-24;4740;8903;0;598958;354012;0;45.4;26.8;0.0
91;2021-06-25;3646;10190;0;602604;364202;0;45.7;27.6;0.0
91;2021-06-26;2905;8284;0;605509;372486;0;45.9;28.2;0.0
91;2021-06-27;611;3229;0;606120;375715;0;45.9;28.5;0.0
91;2021-06-28;3083;8924;0;609203;384639;0;46.2;29.2;0.0
91;2021-06-29;3594;10274;0;612797;394913;0;46.4;29.9;0.0
91;2021-06-30;3883;9531;0;616680;404444;0;46.7;30.7;0.0
91;2021-07-01;4214;9692;0;620894;414136;0;47.1;31.4;0.0
91;2021-07-02;4131;10101;0;625025;424237;0;47.4;32.2;0.0
91;2021-07-03;3006;9909;0;628031;434146;0;47.6;32.9;0.0
91;2021-07-04;985;4549;0;629016;438695;0;47.7;33.2;0.0
91;2021-07-05;2988;7810;0;632004;446505;0;47.9;33.8;0.0
91;2021-07-06;3800;10085;0;635804;456590;0;48.2;34.6;0.0
91;2021-07-07;4071;9683;0;639875;466273;0;48.5;35.3;0.0
91;2021-07-08;4571;9684;0;644446;475957;0;48.8;36.1;0.0
91;2021-07-09;4390;10473;0;648836;486430;0;49.2;36.9;0.0
91;2021-07-10;3554;9906;0;652390;496336;0;49.4;37.6;0.0
91;2021-07-11;1219;4304;0;653609;500640;0;49.5;37.9;0.0
91;2021-07-12;3243;9923;0;656852;510563;0;49.8;38.7;0.0
91;2021-07-13;5655;11402;0;662507;521965;0;50.2;39.6;0.0
91;2021-07-14;3335;4062;0;665842;526027;0;50.5;39.9;0.0
91;2021-07-15;6149;11165;0;671991;537192;0;50.9;40.7;0.0
91;2021-07-16;7547;10428;0;679538;547620;0;51.5;41.5;0.0
91;2021-07-17;6299;8944;0;685837;556564;0;52.0;42.2;0.0
91;2021-07-18;3732;3567;0;689569;560131;0;52.3;42.5;0.0
91;2021-07-19;5080;8405;0;694649;568536;0;52.6;43.1;0.0
91;2021-07-20;7543;9916;0;702192;578452;0;53.2;43.8;0.0
91;2021-07-21;7748;8411;0;709940;586863;0;53.8;44.5;0.0
91;2021-07-22;8167;8986;0;718107;595849;0;54.4;45.2;0.0
91;2021-07-23;8268;8811;0;726375;604660;0;55.1;45.8;0.0
91;2021-07-24;5824;6693;0;732199;611353;0;55.5;46.3;0.0
91;2021-07-25;3511;1626;0;735710;612979;0;55.8;46.5;0.0
91;2021-07-26;6170;7159;0;741880;620138;0;56.2;47.0;0.0
91;2021-07-27;8719;7609;0;750599;627747;0;56.9;47.6;0.0
91;2021-07-28;8376;6449;0;758975;634196;0;57.5;48.1;0.0
91;2021-07-29;8455;6516;0;767430;640712;0;58.2;48.6;0.0
91;2021-07-30;7796;6346;0;775226;647058;0;58.8;49.0;0.0
91;2021-07-31;5305;5076;0;780531;652134;0;59.2;49.4;0.0
91;2021-08-01;2715;1412;0;783246;653546;0;59.4;49.5;0.0
91;2021-08-02;5568;4856;0;788814;658402;0;59.8;49.9;0.0
91;2021-08-03;6317;5413;0;795131;663815;0;60.3;50.3;0.0
91;2021-08-04;6268;4844;0;801399;668659;0;60.7;50.7;0.0
91;2021-08-05;5798;5099;0;807197;673758;0;61.2;51.1;0.0
91;2021-08-06;6035;6398;0;813232;680156;0;61.6;51.6;0.0
91;2021-08-07;3270;3350;0;816502;683506;0;61.9;51.8;0.0
91;2021-08-08;883;1494;0;817385;685000;0;62.0;51.9;0.0
91;2021-08-09;4245;5084;0;821630;690084;0;62.3;52.3;0.0
91;2021-08-10;4915;5609;0;826545;695693;0;62.6;52.7;0.0
91;2021-08-11;4376;5565;0;830921;701258;0;63.0;53.1;0.0
91;2021-08-12;4232;5753;0;835153;707011;0;63.3;53.6;0.0
91;2021-08-13;4174;5642;0;839327;712653;0;63.6;54.0;0.0
91;2021-08-14;2214;3336;0;841541;715989;0;63.8;54.3;0.0
91;2021-08-15;259;464;0;841800;716453;0;63.8;54.3;0.0
91;2021-08-16;3052;5861;0;844852;722314;0;64.0;54.7;0.0
91;2021-08-17;3638;6821;0;848490;729135;0;64.3;55.3;0.0
91;2021-08-18;3017;6570;0;851507;735705;0;64.5;55.8;0.0
91;2021-08-19;3437;6540;0;854944;742245;0;64.8;56.3;0.0
91;2021-08-20;3148;7395;0;858092;749640;0;65.0;56.8;0.0
91;2021-08-21;2297;4172;0;860389;753812;0;65.2;57.1;0.0
91;2021-08-22;704;1722;0;861093;755534;0;65.3;57.3;0.0
91;2021-08-23;2471;6365;0;863564;761899;0;65.5;57.7;0.0
91;2021-08-24;2961;7545;0;866525;769444;0;65.7;58.3;0.0
91;2021-08-25;3171;7050;0;869696;776494;0;65.9;58.9;0.0
91;2021-08-26;2739;6376;0;872435;782870;0;66.1;59.3;0.0
91;2021-08-27;2781;7734;0;875216;790604;0;66.3;59.9;0.0
91;2021-08-28;2180;5071;0;877396;795675;0;66.5;60.3;0.0
91;2021-08-29;1531;2638;0;878927;798313;0;66.6;60.5;0.0
91;2021-08-30;1844;6040;75;880771;804353;75;66.8;61.0;0.0
91;2021-08-31;2209;6049;190;882980;810402;265;66.9;61.4;0.0
91;2021-09-01;2608;4562;254;885588;814964;519;67.1;61.8;0.0
91;2021-09-02;2105;3794;363;887693;818758;882;67.3;62.1;0.1
91;2021-09-03;2174;4706;371;889867;823464;1253;67.4;62.4;0.1
91;2021-09-04;2072;4124;142;891939;827588;1395;67.6;62.7;0.1
91;2021-09-05;661;843;68;892600;828431;1463;67.7;62.8;0.1
91;2021-09-06;1623;3050;540;894223;831481;2003;67.8;63.0;0.2
91;2021-09-07;1523;2872;511;895746;834353;2514;67.9;63.2;0.2
91;2021-09-08;1796;3141;509;897542;837494;3023;68.0;63.5;0.2
91;2021-09-09;1329;2790;611;898871;840284;3634;68.1;63.7;0.3
91;2021-09-10;1822;3391;525;900693;843675;4159;68.3;63.9;0.3
91;2021-09-11;1693;4032;208;902386;847707;4367;68.4;64.2;0.3
91;2021-09-12;547;907;87;902933;848614;4454;68.4;64.3;0.3
91;2021-09-13;1373;2283;727;904306;850897;5181;68.5;64.5;0.4
91;2021-09-14;1693;2537;1119;905999;853434;6300;68.7;64.7;0.5
91;2021-09-15;1659;3259;871;907658;856693;7171;68.8;64.9;0.5
91;2021-09-16;1381;2153;1021;909039;858846;8192;68.9;65.1;0.6
91;2021-09-17;1380;2757;772;910419;861603;8964;69.0;65.3;0.7
91;2021-09-18;1285;3346;258;911704;864949;9222;69.1;65.6;0.7
91;2021-09-19;391;1017;62;912095;865966;9284;69.1;65.6;0.7
91;2021-09-20;777;1589;844;912872;867555;10128;69.2;65.8;0.8
91;2021-09-21;906;1653;1167;913778;869208;11295;69.3;65.9;0.9
91;2021-09-22;916;2530;633;914694;871738;11928;69.3;66.1;0.9
91;2021-09-23;881;1683;1072;915575;873421;13000;69.4;66.2;1.0
91;2021-09-24;912;2142;845;916487;875563;13845;69.5;66.4;1.0
91;2021-09-25;1010;3153;357;917497;878716;14202;69.5;66.6;1.1
91;2021-09-26;197;718;115;917694;879434;14317;69.6;66.7;1.1
91;2021-09-27;747;1529;663;918441;880963;14980;69.6;66.8;1.1
91;2021-09-28;863;1313;655;919304;882276;15635;69.7;66.9;1.2
91;2021-09-29;971;2191;773;920275;884467;16408;69.7;67.0;1.2
91;2021-09-30;656;1159;796;920931;885626;17204;69.8;67.1;1.3
91;2021-10-01;1348;1827;898;922279;887453;18102;69.9;67.3;1.4
91;2021-10-02;1020;2162;454;923299;889615;18556;70.0;67.4;1.4
91;2021-10-03;218;532;98;923517;890147;18654;70.0;67.5;1.4
91;2021-10-04;732;1128;1087;924249;891275;19741;70.1;67.6;1.5
91;2021-10-05;693;1144;951;924942;892419;20692;70.1;67.6;1.6
91;2021-10-06;790;1718;1206;925732;894137;21898;70.2;67.8;1.7
91;2021-10-07;611;1050;1210;926343;895187;23108;70.2;67.8;1.8
91;2021-10-08;842;1696;1412;927185;896883;24520;70.3;68.0;1.9
91;2021-10-09;963;1770;685;928148;898653;25205;70.3;68.1;1.9
91;2021-10-10;236;441;131;928384;899094;25336;70.4;68.1;1.9
91;2021-10-11;585;953;1102;928969;900047;26438;70.4;68.2;2.0
91;2021-10-12;558;1023;1099;929527;901070;27537;70.5;68.3;2.1
91;2021-10-13;743;1326;1393;930270;902396;28930;70.5;68.4;2.2
91;2021-10-14;492;975;976;930762;903371;29906;70.5;68.5;2.3
91;2021-10-15;876;1366;1729;931638;904737;31635;70.6;68.6;2.4
91;2021-10-16;837;1343;699;932475;906080;32334;70.7;68.7;2.5
91;2021-10-17;189;284;248;932664;906364;32582;70.7;68.7;2.5
91;2021-10-18;591;876;1340;933255;907240;33922;70.7;68.8;2.6
91;2021-10-19;470;984;1091;933725;908224;35013;70.8;68.8;2.7
91;2021-10-20;595;1010;1737;934320;909234;36750;70.8;68.9;2.8
91;2021-10-21;314;683;1244;934634;909917;37994;70.8;69.0;2.9
91;2021-10-22;591;1119;1790;935225;911036;39784;70.9;69.0;3.0
91;2021-10-23;643;1128;1032;935868;912164;40816;70.9;69.1;3.1
91;2021-10-24;133;225;213;936001;912389;41029;70.9;69.2;3.1
91;2021-10-25;363;625;1300;936364;913014;42329;71.0;69.2;3.2
91;2021-10-26;435;603;1455;936799;913617;43784;71.0;69.2;3.3
91;2021-10-27;488;818;1888;937287;914435;45672;71.0;69.3;3.5
91;2021-10-28;309;500;1317;937596;914935;46989;71.1;69.3;3.6
91;2021-10-29;499;777;2051;938095;915712;49040;71.1;69.4;3.7
91;2021-10-30;483;891;1076;938578;916603;50116;71.1;69.5;3.8
91;2021-10-31;98;155;216;938676;916758;50332;71.1;69.5;3.8
91;2021-11-01;84;106;63;938760;916864;50395;71.2;69.5;3.8
91;2021-11-02;426;629;1261;939186;917493;51656;71.2;69.5;3.9
91;2021-11-03;491;737;1920;939677;918230;53576;71.2;69.6;4.1
91;2021-11-04;330;522;1401;940007;918752;54977;71.2;69.6;4.2
91;2021-11-05;448;765;2434;940455;919517;57411;71.3;69.7;4.4
91;2021-11-06;505;875;1447;940960;920392;58858;71.3;69.8;4.5
91;2021-11-07;82;161;238;941042;920553;59096;71.3;69.8;4.5
91;2021-11-08;219;461;1891;941261;921014;60987;71.3;69.8;4.6
91;2021-11-09;312;621;2611;941573;921635;63598;71.4;69.9;4.8
91;2021-11-10;473;759;3133;942046;922394;66731;71.4;69.9;5.1
91;2021-11-11;119;157;520;942165;922551;67251;71.4;69.9;5.1
91;2021-11-12;446;713;3557;942611;923264;70808;71.4;70.0;5.4
91;2021-11-13;538;848;2176;943149;924112;72984;71.5;70.0;5.5
91;2021-11-14;56;137;271;943205;924249;73255;71.5;70.1;5.6
91;2021-11-15;270;462;2190;943475;924711;75445;71.5;70.1;5.7
91;2021-11-16;372;505;3304;943847;925216;78749;71.5;70.1;6.0
91;2021-11-17;388;602;3007;944235;925818;81756;71.6;70.2;6.2
91;2021-11-18;293;423;2830;944528;926241;84586;71.6;70.2;6.4
91;2021-11-19;427;628;3426;944955;926869;88012;71.6;70.2;6.7
91;2021-11-20;584;784;2672;945539;927653;90684;71.7;70.3;6.9
91;2021-11-21;136;184;453;945675;927837;91137;71.7;70.3;6.9
91;2021-11-22;265;298;2397;945940;928135;93534;71.7;70.3;7.1
91;2021-11-23;332;430;3207;946272;928565;96741;71.7;70.4;7.3
91;2021-11-24;427;549;2990;946699;929114;99731;71.8;70.4;7.6
91;2021-11-25;341;444;4114;947040;929558;103845;71.8;70.5;7.9
91;2021-11-26;434;541;6451;947474;930099;110296;71.8;70.5;8.4
91;2021-11-27;510;753;5788;947984;930852;116084;71.8;70.6;8.8
91;2021-11-28;101;144;1791;948085;930996;117875;71.9;70.6;8.9
91;2021-11-29;190;340;5202;948275;931336;123077;71.9;70.6;9.3
91;2021-11-30;286;414;7663;948561;931750;130740;71.9;70.6;9.9
91;2021-12-01;255;504;8700;948816;932254;139440;71.9;70.7;10.6
91;2021-12-02;207;327;9057;949023;932581;148497;71.9;70.7;11.3
91;2021-12-03;229;432;10175;949252;933013;158672;71.9;70.7;12.0
91;2021-12-04;306;568;8740;949558;933581;167412;72.0;70.8;12.7
91;2021-12-05;98;147;3665;949656;933728;171077;72.0;70.8;13.0
91;2021-12-06;219;404;7438;949875;934132;178515;72.0;70.8;13.5
91;2021-12-07;252;474;11370;950127;934606;189885;72.0;70.8;14.4
91;2021-12-08;291;524;10162;950418;935130;200047;72.0;70.9;15.2
91;2021-12-09;251;448;11823;950669;935578;211870;72.1;70.9;16.1
91;2021-12-10;262;513;12553;950931;936091;224423;72.1;70.9;17.0
91;2021-12-11;361;676;13050;951292;936767;237473;72.1;71.0;18.0
91;2021-12-12;171;221;6674;951463;936988;244147;72.1;71.0;18.5
91;2021-12-13;226;376;8715;951689;937364;252862;72.1;71.0;19.2
91;2021-12-14;316;401;14174;952005;937765;267036;72.2;71.1;20.2
91;2021-12-15;318;520;12734;952323;938285;279770;72.2;71.1;21.2
91;2021-12-16;336;486;14103;952659;938771;293873;72.2;71.2;22.3
92;2020-12-27;7;0;0;7;0;0;0.0;0.0;0.0
92;2020-12-28;14;0;0;21;0;0;0.0;0.0;0.0
92;2020-12-29;50;0;0;71;0;0;0.0;0.0;0.0
92;2020-12-30;21;0;0;92;0;0;0.0;0.0;0.0
92;2020-12-31;11;0;0;103;0;0;0.0;0.0;0.0
92;2021-01-01;13;0;0;116;0;0;0.0;0.0;0.0
92;2021-01-02;9;0;0;125;0;0;0.0;0.0;0.0
92;2021-01-03;25;2;0;150;2;0;0.0;0.0;0.0
92;2021-01-04;86;1;0;236;3;0;0.0;0.0;0.0
92;2021-01-05;268;4;0;504;7;0;0.0;0.0;0.0
92;2021-01-06;512;10;0;1016;17;0;0.1;0.0;0.0
92;2021-01-07;798;4;0;1814;21;0;0.1;0.0;0.0
92;2021-01-08;1049;9;0;2863;30;0;0.2;0.0;0.0
92;2021-01-09;209;0;0;3072;30;0;0.2;0.0;0.0
92;2021-01-10;199;2;0;3271;32;0;0.2;0.0;0.0
92;2021-01-11;1119;21;0;4390;53;0;0.3;0.0;0.0
92;2021-01-12;1561;17;0;5951;70;0;0.4;0.0;0.0
92;2021-01-13;1404;12;0;7355;82;0;0.5;0.0;0.0
92;2021-01-14;1362;16;0;8717;98;0;0.5;0.0;0.0
92;2021-01-15;1244;11;0;9961;109;0;0.6;0.0;0.0
92;2021-01-16;340;4;0;10301;113;0;0.6;0.0;0.0
92;2021-01-17;142;3;0;10443;116;0;0.6;0.0;0.0
92;2021-01-18;1946;26;0;12389;142;0;0.8;0.0;0.0
92;2021-01-19;2057;21;0;14446;163;0;0.9;0.0;0.0
92;2021-01-20;2343;26;0;16789;189;0;1.0;0.0;0.0
92;2021-01-21;3552;27;0;20341;216;0;1.3;0.0;0.0
92;2021-01-22;2970;43;0;23311;259;0;1.4;0.0;0.0
92;2021-01-23;430;1;0;23741;260;0;1.5;0.0;0.0
92;2021-01-24;111;0;0;23852;260;0;1.5;0.0;0.0
92;2021-01-25;1224;18;0;25076;278;0;1.6;0.0;0.0
92;2021-01-26;1573;27;0;26649;305;0;1.7;0.0;0.0
92;2021-01-27;2222;104;0;28871;409;0;1.8;0.0;0.0
92;2021-01-28;3963;181;0;32834;590;0;2.0;0.0;0.0
92;2021-01-29;2845;245;0;35679;835;0;2.2;0.1;0.0
92;2021-01-30;455;12;0;36134;847;0;2.2;0.1;0.0
92;2021-01-31;72;2;0;36206;849;0;2.2;0.1;0.0
92;2021-02-01;1196;276;0;37402;1125;0;2.3;0.1;0.0
92;2021-02-02;1414;407;0;38816;1532;0;2.4;0.1;0.0
92;2021-02-03;1300;455;0;40116;1987;0;2.5;0.1;0.0
92;2021-02-04;1298;606;0;41414;2593;0;2.6;0.2;0.0
92;2021-02-05;1603;561;0;43017;3154;0;2.7;0.2;0.0
92;2021-02-06;261;62;0;43278;3216;0;2.7;0.2;0.0
92;2021-02-07;77;39;0;43355;3255;0;2.7;0.2;0.0
92;2021-02-08;926;769;0;44281;4024;0;2.7;0.2;0.0
92;2021-02-09;1276;1343;0;45557;5367;0;2.8;0.3;0.0
92;2021-02-10;1292;1324;0;46849;6691;0;2.9;0.4;0.0
92;2021-02-11;1859;2350;0;48708;9041;0;3.0;0.6;0.0
92;2021-02-12;1594;1564;0;50302;10605;0;3.1;0.7;0.0
92;2021-02-13;202;250;0;50504;10855;0;3.1;0.7;0.0
92;2021-02-14;47;39;0;50551;10894;0;3.1;0.7;0.0
92;2021-02-15;629;2037;0;51180;12931;0;3.2;0.8;0.0
92;2021-02-16;832;2679;0;52012;15610;0;3.2;1.0;0.0
92;2021-02-17;660;1999;0;52672;17609;0;3.3;1.1;0.0
92;2021-02-18;1466;3655;0;54138;21264;0;3.4;1.3;0.0
92;2021-02-19;1630;2782;0;55768;24046;0;3.5;1.5;0.0
92;2021-02-20;222;612;0;55990;24658;0;3.5;1.5;0.0
92;2021-02-21;50;90;0;56040;24748;0;3.5;1.5;0.0
92;2021-02-22;605;1523;0;56645;26271;0;3.5;1.6;0.0
92;2021-02-23;781;1603;0;57426;27874;0;3.6;1.7;0.0
92;2021-02-24;767;1497;0;58193;29371;0;3.6;1.8;0.0
92;2021-02-25;1196;2279;0;59389;31650;0;3.7;2.0;0.0
92;2021-02-26;1733;1692;0;61122;33342;0;3.8;2.1;0.0
92;2021-02-27;614;266;0;61736;33608;0;3.8;2.1;0.0
92;2021-02-28;107;77;0;61843;33685;0;3.8;2.1;0.0
92;2021-03-01;1293;1332;0;63136;35017;0;3.9;2.2;0.0
92;2021-03-02;2155;1568;0;65291;36585;0;4.0;2.3;0.0
92;2021-03-03;2938;1451;0;68229;38036;0;4.2;2.4;0.0
92;2021-03-04;3946;1702;0;72175;39738;0;4.5;2.5;0.0
92;2021-03-05;5430;1909;0;77605;41647;0;4.8;2.6;0.0
92;2021-03-06;6769;499;0;84374;42146;0;5.2;2.6;0.0
92;2021-03-07;4268;491;0;88642;42637;0;5.5;2.6;0.0
92;2021-03-08;2754;1174;0;91396;43811;0;5.7;2.7;0.0
92;2021-03-09;3695;1262;0;95091;45073;0;5.9;2.8;0.0
92;2021-03-10;3990;1141;0;99081;46214;0;6.1;2.9;0.0
92;2021-03-11;5308;1529;0;104389;47743;0;6.5;3.0;0.0
92;2021-03-12;7052;1640;0;111441;49383;0;6.9;3.1;0.0
92;2021-03-13;5919;341;0;117360;49724;0;7.3;3.1;0.0
92;2021-03-14;2036;128;0;119396;49852;0;7.4;3.1;0.0
92;2021-03-15;4354;699;0;123750;50551;0;7.7;3.1;0.0
92;2021-03-16;3928;680;0;127678;51231;0;7.9;3.2;0.0
92;2021-03-17;4273;524;0;131951;51755;0;8.2;3.2;0.0
92;2021-03-18;4496;825;0;136447;52580;0;8.5;3.3;0.0
92;2021-03-19;6492;795;0;142939;53375;0;8.9;3.3;0.0
92;2021-03-20;3263;180;0;146202;53555;0;9.1;3.3;0.0
92;2021-03-21;629;147;0;146831;53702;0;9.1;3.3;0.0
92;2021-03-22;4920;634;0;151751;54336;0;9.4;3.4;0.0
92;2021-03-23;6618;991;0;158369;55327;0;9.8;3.4;0.0
92;2021-03-24;6911;855;0;165280;56182;0;10.2;3.5;0.0
92;2021-03-25;8948;794;0;174228;56976;0;10.8;3.5;0.0
92;2021-03-26;8982;1051;0;183210;58027;0;11.4;3.6;0.0
92;2021-03-27;3880;343;0;187090;58370;0;11.6;3.6;0.0
92;2021-03-28;899;73;0;187989;58443;0;11.6;3.6;0.0
92;2021-03-29;5138;1250;0;193127;59693;0;12.0;3.7;0.0
92;2021-03-30;7118;1812;0;200245;61505;0;12.4;3.8;0.0
92;2021-03-31;6084;2367;0;206329;63872;0;12.8;4.0;0.0
92;2021-04-01;6543;4019;0;212872;67891;0;13.2;4.2;0.0
92;2021-04-02;6038;3888;0;218910;71779;0;13.6;4.4;0.0
92;2021-04-03;1618;2049;0;220528;73828;0;13.7;4.6;0.0
92;2021-04-04;745;1161;0;221273;74989;0;13.7;4.6;0.0
92;2021-04-05;984;315;0;222257;75304;0;13.8;4.7;0.0
92;2021-04-06;4205;2386;0;226462;77690;0;14.0;4.8;0.0
92;2021-04-07;5392;3305;0;231854;80995;0;14.4;5.0;0.0
92;2021-04-08;6251;3399;0;238105;84394;0;14.8;5.2;0.0
92;2021-04-09;8056;3410;0;246161;87804;0;15.3;5.4;0.0
92;2021-04-10;3241;1901;0;249402;89705;0;15.5;5.6;0.0
92;2021-04-11;618;1020;0;250020;90725;0;15.5;5.6;0.0
92;2021-04-12;4382;2994;0;254402;93719;0;15.8;5.8;0.0
92;2021-04-13;5211;4728;0;259613;98447;0;16.1;6.1;0.0
92;2021-04-14;5495;4426;0;265108;102873;0;16.4;6.4;0.0
92;2021-04-15;5727;4408;0;270835;107281;0;16.8;6.6;0.0
92;2021-04-16;5975;4383;0;276810;111664;0;17.2;6.9;0.0
92;2021-04-17;2727;1862;0;279537;113526;0;17.3;7.0;0.0
92;2021-04-18;722;483;0;280259;114009;0;17.4;7.1;0.0
92;2021-04-19;3668;3540;0;283927;117549;0;17.6;7.3;0.0
92;2021-04-20;4974;4377;0;288901;121926;0;17.9;7.6;0.0
92;2021-04-21;5202;4817;0;294103;126743;0;18.2;7.9;0.0
92;2021-04-22;5210;5497;0;299313;132240;0;18.5;8.2;0.0
92;2021-04-23;5773;4967;0;305086;137207;0;18.9;8.5;0.0
92;2021-04-24;5303;2581;0;310389;139788;0;19.2;8.7;0.0
92;2021-04-25;2139;569;0;312528;140357;0;19.4;8.7;0.0
92;2021-04-26;4571;3966;0;317099;144323;0;19.6;8.9;0.0
92;2021-04-27;6999;5618;0;324098;149941;0;20.1;9.3;0.0
92;2021-04-28;8221;4968;0;332319;154909;0;20.6;9.6;0.0
92;2021-04-29;8828;5092;0;341147;160001;0;21.1;9.9;0.0
92;2021-04-30;9801;4983;0;350948;164984;0;21.7;10.2;0.0
92;2021-05-01;2354;665;0;353302;165649;0;21.9;10.3;0.0
92;2021-05-02;1325;489;0;354627;166138;0;22.0;10.3;0.0
92;2021-05-03;7628;4968;0;362255;171106;0;22.4;10.6;0.0
92;2021-05-04;10202;4948;0;372457;176054;0;23.1;10.9;0.0
92;2021-05-05;9850;5425;0;382307;181479;0;23.7;11.2;0.0
92;2021-05-06;10987;5228;0;393294;186707;0;24.4;11.6;0.0
92;2021-05-07;9888;5613;0;403182;192320;0;25.0;11.9;0.0
92;2021-05-08;7395;2350;0;410577;194670;0;25.4;12.1;0.0
92;2021-05-09;4244;1134;0;414821;195804;0;25.7;12.1;0.0
92;2021-05-10;10459;4529;0;425280;200333;0;26.4;12.4;0.0
92;2021-05-11;13454;6171;0;438734;206504;0;27.2;12.8;0.0
92;2021-05-12;13797;5100;0;452531;211604;0;28.0;13.1;0.0
92;2021-05-13;9706;1329;0;462237;212933;0;28.6;13.2;0.0
92;2021-05-14;12844;3095;0;475081;216028;0;29.4;13.4;0.0
92;2021-05-15;9426;1709;0;484507;217737;0;30.0;13.5;0.0
92;2021-05-16;5080;621;0;489587;218358;0;30.3;13.5;0.0
92;2021-05-17;11974;2731;0;501561;221089;0;31.1;13.7;0.0
92;2021-05-18;16587;3259;0;518148;224348;0;32.1;13.9;0.0
92;2021-05-19;16171;4296;0;534319;228644;0;33.1;14.2;0.0
92;2021-05-20;17030;4500;0;551349;233144;0;34.2;14.4;0.0
92;2021-05-21;15123;3955;0;566472;237099;0;35.1;14.7;0.0
92;2021-05-22;10627;1946;0;577099;239045;0;35.8;14.8;0.0
92;2021-05-23;5385;749;0;582484;239794;0;36.1;14.9;0.0
92;2021-05-24;8067;1144;0;590551;240938;0;36.6;14.9;0.0
92;2021-05-25;13629;4899;0;604180;245837;0;37.4;15.2;0.0
92;2021-05-26;12766;5221;0;616946;251058;0;38.2;15.6;0.0
92;2021-05-27;13598;6484;0;630544;257542;0;39.1;16.0;0.0
92;2021-05-28;12623;6760;0;643167;264302;0;39.9;16.4;0.0
92;2021-05-29;8430;3175;0;651597;267477;0;40.4;16.6;0.0
92;2021-05-30;4027;898;0;655624;268375;0;40.6;16.6;0.0
92;2021-05-31;12472;6068;0;668096;274443;0;41.4;17.0;0.0
92;2021-06-01;12704;8240;0;680800;282683;0;42.2;17.5;0.0
92;2021-06-02;13713;7202;0;694513;289885;0;43.0;18.0;0.0
92;2021-06-03;14024;7959;0;708537;297844;0;43.9;18.5;0.0
92;2021-06-04;12244;8680;0;720781;306524;0;44.7;19.0;0.0
92;2021-06-05;8010;6770;0;728791;313294;0;45.2;19.4;0.0
92;2021-06-06;4697;2129;0;733488;315423;0;45.5;19.5;0.0
92;2021-06-07;10231;8110;0;743719;323533;0;46.1;20.0;0.0
92;2021-06-08;11193;10080;0;754912;333613;0;46.8;20.7;0.0
92;2021-06-09;10778;9999;0;765690;343612;0;47.4;21.3;0.0
92;2021-06-10;11181;11748;0;776871;355360;0;48.1;22.0;0.0
92;2021-06-11;8577;11501;0;785448;366861;0;48.7;22.7;0.0
92;2021-06-12;7240;5940;0;792688;372801;0;49.1;23.1;0.0
92;2021-06-13;3802;3047;0;796490;375848;0;49.4;23.3;0.0
92;2021-06-14;5283;11602;0;801773;387450;0;49.7;24.0;0.0
92;2021-06-15;6839;13282;0;808612;400732;0;50.1;24.8;0.0
92;2021-06-16;6861;12288;0;815473;413020;0;50.5;25.6;0.0
92;2021-06-17;7286;13324;0;822759;426344;0;51.0;26.4;0.0
92;2021-06-18;7223;14449;0;829982;440793;0;51.4;27.3;0.0
92;2021-06-19;4729;9513;0;834711;450306;0;51.7;27.9;0.0
92;2021-06-20;2065;5355;0;836776;455661;0;51.9;28.2;0.0
92;2021-06-21;4579;12582;0;841355;468243;0;52.1;29.0;0.0
92;2021-06-22;5574;16346;0;846929;484589;0;52.5;30.0;0.0
92;2021-06-23;5456;15376;0;852385;499965;0;52.8;31.0;0.0
92;2021-06-24;6067;14439;0;858452;514404;0;53.2;31.9;0.0
92;2021-06-25;4994;16408;0;863446;530812;0;53.5;32.9;0.0
92;2021-06-26;4215;11553;0;867661;542365;0;53.8;33.6;0.0
92;2021-06-27;1600;6286;0;869261;548651;0;53.9;34.0;0.0
92;2021-06-28;3594;13174;0;872855;561825;0;54.1;34.8;0.0
92;2021-06-29;4501;17594;0;877356;579419;0;54.4;35.9;0.0
92;2021-06-30;4671;16153;0;882027;595572;0;54.7;36.9;0.0
92;2021-07-01;5942;16133;0;887969;611705;0;55.0;37.9;0.0
92;2021-07-02;5476;16341;0;893445;628046;0;55.4;38.9;0.0
92;2021-07-03;3557;11895;0;897002;639941;0;55.6;39.7;0.0
92;2021-07-04;1383;5277;0;898385;645218;0;55.7;40.0;0.0
92;2021-07-05;4630;12819;0;903015;658037;0;56.0;40.8;0.0
92;2021-07-06;5312;15683;0;908327;673720;0;56.3;41.7;0.0
92;2021-07-07;4931;12819;0;913258;686539;0;56.6;42.5;0.0
92;2021-07-08;5595;14420;0;918853;700959;0;56.9;43.4;0.0
92;2021-07-09;5918;15327;0;924771;716286;0;57.3;44.4;0.0
92;2021-07-10;3915;10200;0;928686;726486;0;57.5;45.0;0.0
92;2021-07-11;1726;4250;0;930412;730736;0;57.7;45.3;0.0
92;2021-07-12;4531;15104;0;934943;745840;0;57.9;46.2;0.0
92;2021-07-13;8025;16883;0;942968;762723;0;58.4;47.3;0.0
92;2021-07-14;4759;5576;0;947727;768299;0;58.7;47.6;0.0
92;2021-07-15;9160;16126;0;956887;784425;0;59.3;48.6;0.0
92;2021-07-16;9087;14389;0;965974;798814;0;59.9;49.5;0.0
92;2021-07-17;6139;8537;0;972113;807351;0;60.2;50.0;0.0
92;2021-07-18;2359;3642;0;974472;810993;0;60.4;50.3;0.0
92;2021-07-19;6447;12713;0;980919;823706;0;60.8;51.0;0.0
92;2021-07-20;9240;13304;0;990159;837010;0;61.4;51.9;0.0
92;2021-07-21;9463;11776;0;999622;848786;0;61.9;52.6;0.0
92;2021-07-22;10473;12606;0;1010095;861392;0;62.6;53.4;0.0
92;2021-07-23;9806;11264;0;1019901;872656;0;63.2;54.1;0.0
92;2021-07-24;5883;6818;0;1025784;879474;0;63.6;54.5;0.0
92;2021-07-25;2627;2503;0;1028411;881977;0;63.7;54.7;0.0
92;2021-07-26;8131;9218;0;1036542;891195;0;64.2;55.2;0.0
92;2021-07-27;9664;9555;0;1046206;900750;0;64.8;55.8;0.0
92;2021-07-28;9409;8292;0;1055615;909042;0;65.4;56.3;0.0
92;2021-07-29;9036;8502;0;1064651;917544;0;66.0;56.9;0.0
92;2021-07-30;8223;8383;0;1072874;925927;0;66.5;57.4;0.0
92;2021-07-31;4936;4869;0;1077810;930796;0;66.8;57.7;0.0
92;2021-08-01;2116;1697;0;1079926;932493;0;66.9;57.8;0.0
92;2021-08-02;5369;5554;0;1085295;938047;0;67.3;58.1;0.0
92;2021-08-03;5659;6785;0;1090954;944832;0;67.6;58.5;0.0
92;2021-08-04;5309;5638;0;1096263;950470;0;67.9;58.9;0.0
92;2021-08-05;4730;6178;0;1100993;956648;0;68.2;59.3;0.0
92;2021-08-06;4933;6742;0;1105926;963390;0;68.5;59.7;0.0
92;2021-08-07;2814;4255;0;1108740;967645;0;68.7;60.0;0.0
92;2021-08-08;1048;1532;0;1109788;969177;0;68.8;60.1;0.0
92;2021-08-09;3621;5405;0;1113409;974582;0;69.0;60.4;0.0
92;2021-08-10;4193;6753;0;1117602;981335;0;69.3;60.8;0.0
92;2021-08-11;3555;5610;0;1121157;986945;0;69.5;61.2;0.0
92;2021-08-12;3500;6201;0;1124657;993146;0;69.7;61.5;0.0
92;2021-08-13;3118;5734;0;1127775;998880;0;69.9;61.9;0.0
92;2021-08-14;1908;4089;0;1129683;1002969;0;70.0;62.2;0.0
92;2021-08-15;573;935;0;1130256;1003904;0;70.0;62.2;0.0
92;2021-08-16;2549;6241;0;1132805;1010145;0;70.2;62.6;0.0
92;2021-08-17;2945;7575;0;1135750;1017720;0;70.4;63.1;0.0
92;2021-08-18;2501;6043;0;1138251;1023763;0;70.5;63.4;0.0
92;2021-08-19;2553;6135;0;1140804;1029898;0;70.7;63.8;0.0
92;2021-08-20;2328;5887;0;1143132;1035785;0;70.8;64.2;0.0
92;2021-08-21;1364;4292;0;1144496;1040077;0;70.9;64.5;0.0
92;2021-08-22;420;1686;0;1144916;1041763;0;70.9;64.6;0.0
92;2021-08-23;2333;6976;0;1147249;1048739;0;71.1;65.0;0.0
92;2021-08-24;2827;8297;0;1150076;1057036;0;71.3;65.5;0.0
92;2021-08-25;2706;7268;0;1152782;1064304;0;71.4;66.0;0.0
92;2021-08-26;2705;6885;0;1155487;1071189;0;71.6;66.4;0.0
92;2021-08-27;2644;6827;0;1158131;1078016;0;71.8;66.8;0.0
92;2021-08-28;1567;4484;0;1159698;1082500;0;71.9;67.1;0.0
92;2021-08-29;339;979;0;1160037;1083479;0;71.9;67.1;0.0
92;2021-08-30;2138;5337;198;1162175;1088816;198;72.0;67.5;0.0
92;2021-08-31;2731;6431;442;1164906;1095247;640;72.2;67.9;0.0
92;2021-09-01;3150;5639;855;1168056;1100886;1495;72.4;68.2;0.1
92;2021-09-02;2460;4775;842;1170516;1105661;2337;72.5;68.5;0.1
92;2021-09-03;2380;4739;1028;1172896;1110400;3365;72.7;68.8;0.2
92;2021-09-04;2057;4038;361;1174953;1114438;3726;72.8;69.1;0.2
92;2021-09-05;413;763;108;1175366;1115201;3834;72.8;69.1;0.2
92;2021-09-06;1181;2668;929;1176547;1117869;4763;72.9;69.3;0.3
92;2021-09-07;1414;2804;917;1177961;1120673;5680;73.0;69.4;0.4
92;2021-09-08;1907;3192;894;1179868;1123865;6574;73.1;69.6;0.4
92;2021-09-09;1102;2386;741;1180970;1126251;7315;73.2;69.8;0.5
92;2021-09-10;1640;3029;1153;1182610;1129280;8468;73.3;70.0;0.5
92;2021-09-11;1411;2555;260;1184021;1131835;8728;73.4;70.1;0.5
92;2021-09-12;212;437;50;1184233;1132272;8778;73.4;70.2;0.5
92;2021-09-13;1188;1945;1143;1185421;1134217;9921;73.5;70.3;0.6
92;2021-09-14;1103;2093;1325;1186524;1136310;11246;73.5;70.4;0.7
92;2021-09-15;1515;3217;1316;1188039;1139527;12562;73.6;70.6;0.8
92;2021-09-16;1020;1884;1208;1189059;1141411;13770;73.7;70.7;0.9
92;2021-09-17;1353;2754;1243;1190412;1144165;15013;73.8;70.9;0.9
92;2021-09-18;872;2135;323;1191284;1146300;15336;73.8;71.0;1.0
92;2021-09-19;143;284;21;1191427;1146584;15357;73.8;71.1;1.0
92;2021-09-20;749;1659;1173;1192176;1148243;16530;73.9;71.2;1.0
92;2021-09-21;729;1676;1356;1192905;1149919;17886;73.9;71.3;1.1
92;2021-09-22;1013;3479;1105;1193918;1153398;18991;74.0;71.5;1.2
92;2021-09-23;720;1696;1116;1194638;1155094;20107;74.0;71.6;1.2
92;2021-09-24;1022;2583;1083;1195660;1157677;21190;74.1;71.7;1.3
92;2021-09-25;638;2084;287;1196298;1159761;21477;74.1;71.9;1.3
92;2021-09-26;103;264;29;1196401;1160025;21506;74.1;71.9;1.3
92;2021-09-27;668;1446;987;1197069;1161471;22493;74.2;72.0;1.4
92;2021-09-28;692;1376;1035;1197761;1162847;23528;74.2;72.1;1.5
92;2021-09-29;986;2471;1165;1198747;1165318;24693;74.3;72.2;1.5
92;2021-09-30;810;1250;1113;1199557;1166568;25806;74.3;72.3;1.6
92;2021-10-01;1241;1913;1431;1200798;1168481;27237;74.4;72.4;1.7
92;2021-10-02;848;1582;412;1201646;1170063;27649;74.5;72.5;1.7
92;2021-10-03;98;206;46;1201744;1170269;27695;74.5;72.5;1.7
92;2021-10-04;707;1076;1364;1202451;1171345;29059;74.5;72.6;1.8
92;2021-10-05;663;1134;1663;1203114;1172479;30722;74.6;72.7;1.9
92;2021-10-06;951;1714;1933;1204065;1174193;32655;74.6;72.8;2.0
92;2021-10-07;524;898;1482;1204589;1175091;34137;74.6;72.8;2.1
92;2021-10-08;1035;1746;2138;1205624;1176837;36275;74.7;72.9;2.2
92;2021-10-09;686;1230;674;1206310;1178067;36949;74.8;73.0;2.3
92;2021-10-10;131;190;35;1206441;1178257;36984;74.8;73.0;2.3
92;2021-10-11;596;903;1453;1207037;1179160;38437;74.8;73.1;2.4
92;2021-10-12;700;1008;1771;1207737;1180168;40208;74.8;73.1;2.5
92;2021-10-13;894;1377;2344;1208631;1181545;42552;74.9;73.2;2.6
92;2021-10-14;558;845;1724;1209189;1182390;44276;74.9;73.3;2.7
92;2021-10-15;872;1364;2414;1210061;1183754;46690;75.0;73.4;2.9
92;2021-10-16;695;1061;955;1210756;1184815;47645;75.0;73.4;3.0
92;2021-10-17;78;150;74;1210834;1184965;47719;75.0;73.4;3.0
92;2021-10-18;481;730;1556;1211315;1185695;49275;75.1;73.5;3.1
92;2021-10-19;312;705;2081;1211627;1186400;51356;75.1;73.5;3.2
92;2021-10-20;410;944;2779;1212037;1187344;54135;75.1;73.6;3.4
92;2021-10-21;232;621;2012;1212269;1187965;56147;75.1;73.6;3.5
92;2021-10-22;384;1080;2749;1212653;1189045;58896;75.1;73.7;3.6
92;2021-10-23;280;798;1029;1212933;1189843;59925;75.2;73.7;3.7
92;2021-10-24;33;76;94;1212966;1189919;60019;75.2;73.7;3.7
92;2021-10-25;304;550;1953;1213270;1190469;61972;75.2;73.8;3.8
92;2021-10-26;306;631;2297;1213576;1191100;64269;75.2;73.8;4.0
92;2021-10-27;335;836;3181;1213911;1191936;67450;75.2;73.9;4.2
92;2021-10-28;218;460;2167;1214129;1192396;69617;75.2;73.9;4.3
92;2021-10-29;313;776;3027;1214442;1193172;72644;75.3;73.9;4.5
92;2021-10-30;213;610;1153;1214655;1193782;73797;75.3;74.0;4.6
92;2021-10-31;22;81;71;1214677;1193863;73868;75.3;74.0;4.6
92;2021-11-01;78;96;128;1214755;1193959;73996;75.3;74.0;4.6
92;2021-11-02;288;709;2072;1215043;1194668;76068;75.3;74.0;4.7
92;2021-11-03;291;772;2619;1215334;1195440;78687;75.3;74.1;4.9
92;2021-11-04;241;552;2314;1215575;1195992;81001;75.3;74.1;5.0
92;2021-11-05;311;702;2942;1215886;1196694;83943;75.3;74.2;5.2
92;2021-11-06;198;499;1025;1216084;1197193;84968;75.4;74.2;5.3
92;2021-11-07;26;92;89;1216110;1197285;85057;75.4;74.2;5.3
92;2021-11-08;158;485;2729;1216268;1197770;87786;75.4;74.2;5.4
92;2021-11-09;215;535;3549;1216483;1198305;91335;75.4;74.3;5.7
92;2021-11-10;336;667;4317;1216819;1198972;95652;75.4;74.3;5.9
92;2021-11-11;69;115;509;1216888;1199087;96161;75.4;74.3;6.0
92;2021-11-12;243;538;4111;1217131;1199625;100272;75.4;74.3;6.2
92;2021-11-13;205;302;1541;1217336;1199927;101813;75.4;74.4;6.3
92;2021-11-14;34;52;148;1217370;1199979;101961;75.4;74.4;6.3
92;2021-11-15;208;362;3610;1217578;1200341;105571;75.4;74.4;6.5
92;2021-11-16;223;382;3700;1217801;1200723;109271;75.5;74.4;6.8
92;2021-11-17;324;497;3930;1218125;1201220;113201;75.5;74.4;7.0
92;2021-11-18;232;418;4125;1218357;1201638;117326;75.5;74.5;7.3
92;2021-11-19;376;522;5241;1218733;1202160;122567;75.5;74.5;7.6
92;2021-11-20;240;361;1870;1218973;1202521;124437;75.5;74.5;7.7
92;2021-11-21;26;60;229;1218999;1202581;124666;75.5;74.5;7.7
92;2021-11-22;204;317;3738;1219203;1202898;128404;75.6;74.5;8.0
92;2021-11-23;256;339;4415;1219459;1203237;132819;75.6;74.6;8.2
92;2021-11-24;353;495;4886;1219812;1203732;137705;75.6;74.6;8.5
92;2021-11-25;243;340;6183;1220055;1204072;143888;75.6;74.6;8.9
92;2021-11-26;315;513;10392;1220370;1204585;154280;75.6;74.6;9.6
92;2021-11-27;225;297;6161;1220595;1204882;160441;75.6;74.7;9.9
92;2021-11-28;52;112;3888;1220647;1204994;164329;75.6;74.7;10.2
92;2021-11-29;188;317;9520;1220835;1205311;173849;75.7;74.7;10.8
92;2021-11-30;236;364;12948;1221071;1205675;186797;75.7;74.7;11.6
92;2021-12-01;230;392;14283;1221301;1206067;201080;75.7;74.7;12.5
92;2021-12-02;192;309;15231;1221493;1206376;216311;75.7;74.8;13.4
92;2021-12-03;236;418;18263;1221729;1206794;234574;75.7;74.8;14.5
92;2021-12-04;175;328;11357;1221904;1207122;245931;75.7;74.8;15.2
92;2021-12-05;67;93;4069;1221971;1207215;250000;75.7;74.8;15.5
92;2021-12-06;159;341;13784;1222130;1207556;263784;75.7;74.8;16.3
92;2021-12-07;204;367;17987;1222334;1207923;281771;75.7;74.9;17.5
92;2021-12-08;256;488;17193;1222590;1208411;298964;75.8;74.9;18.5
92;2021-12-09;224;390;18546;1222814;1208801;317510;75.8;74.9;19.7
92;2021-12-10;250;487;20690;1223064;1209288;338200;75.8;74.9;21.0
92;2021-12-11;205;367;13365;1223269;1209655;351565;75.8;75.0;21.8
92;2021-12-12;60;111;5802;1223329;1209766;357367;75.8;75.0;22.1
92;2021-12-13;183;387;17127;1223512;1210153;374494;75.8;75.0;23.2
92;2021-12-14;247;399;21459;1223759;1210552;395953;75.8;75.0;24.5
92;2021-12-15;295;497;19481;1224054;1211049;415434;75.9;75.0;25.7
92;2021-12-16;279;443;21474;1224333;1211492;436908;75.9;75.1;27.1
93;2020-12-27;7;3;0;7;3;0;0.0;0.0;0.0
93;2020-12-28;2;0;0;9;3;0;0.0;0.0;0.0
93;2020-12-29;0;0;0;9;3;0;0.0;0.0;0.0
93;2020-12-30;27;1;0;36;4;0;0.0;0.0;0.0
93;2020-12-31;7;0;0;43;4;0;0.0;0.0;0.0
93;2021-01-01;14;0;0;57;4;0;0.0;0.0;0.0
93;2021-01-02;4;0;0;61;4;0;0.0;0.0;0.0
93;2021-01-03;7;0;0;68;4;0;0.0;0.0;0.0
93;2021-01-04;18;1;0;86;5;0;0.0;0.0;0.0
93;2021-01-05;94;2;0;180;7;0;0.0;0.0;0.0
93;2021-01-06;138;3;0;318;10;0;0.0;0.0;0.0
93;2021-01-07;363;5;0;681;15;0;0.0;0.0;0.0
93;2021-01-08;503;4;0;1184;19;0;0.1;0.0;0.0
93;2021-01-09;43;0;0;1227;19;0;0.1;0.0;0.0
93;2021-01-10;57;0;0;1284;19;0;0.1;0.0;0.0
93;2021-01-11;508;4;0;1792;23;0;0.1;0.0;0.0
93;2021-01-12;734;6;0;2526;29;0;0.2;0.0;0.0
93;2021-01-13;713;10;0;3239;39;0;0.2;0.0;0.0
93;2021-01-14;659;15;0;3898;54;0;0.2;0.0;0.0
93;2021-01-15;570;7;0;4468;61;0;0.3;0.0;0.0
93;2021-01-16;126;3;0;4594;64;0;0.3;0.0;0.0
93;2021-01-17;62;2;0;4656;66;0;0.3;0.0;0.0
93;2021-01-18;974;19;0;5630;85;0;0.3;0.0;0.0
93;2021-01-19;1287;16;0;6917;101;0;0.4;0.0;0.0
93;2021-01-20;1335;23;0;8252;124;0;0.5;0.0;0.0
93;2021-01-21;1614;36;0;9866;160;0;0.6;0.0;0.0
93;2021-01-22;1207;27;0;11073;187;0;0.7;0.0;0.0
93;2021-01-23;576;6;0;11649;193;0;0.7;0.0;0.0
93;2021-01-24;55;0;0;11704;193;0;0.7;0.0;0.0
93;2021-01-25;851;10;0;12555;203;0;0.8;0.0;0.0
93;2021-01-26;1015;30;0;13570;233;0;0.8;0.0;0.0
93;2021-01-27;1694;75;0;15264;308;0;0.9;0.0;0.0
93;2021-01-28;1827;144;0;17091;452;0;1.0;0.0;0.0
93;2021-01-29;1376;171;0;18467;623;0;1.1;0.0;0.0
93;2021-01-30;695;29;0;19162;652;0;1.1;0.0;0.0
93;2021-01-31;24;4;0;19186;656;0;1.1;0.0;0.0
93;2021-02-01;746;110;0;19932;766;0;1.2;0.0;0.0
93;2021-02-02;792;232;0;20724;998;0;1.2;0.1;0.0
93;2021-02-03;862;317;0;21586;1315;0;1.3;0.1;0.0
93;2021-02-04;710;382;0;22296;1697;0;1.3;0.1;0.0
93;2021-02-05;652;332;0;22948;2029;0;1.4;0.1;0.0
93;2021-02-06;508;52;0;23456;2081;0;1.4;0.1;0.0
93;2021-02-07;18;23;0;23474;2104;0;1.4;0.1;0.0
93;2021-02-08;678;512;0;24152;2616;0;1.4;0.2;0.0
93;2021-02-09;650;629;0;24802;3245;0;1.5;0.2;0.0
93;2021-02-10;740;758;0;25542;4003;0;1.5;0.2;0.0
93;2021-02-11;984;1003;0;26526;5006;0;1.6;0.3;0.0
93;2021-02-12;933;689;0;27459;5695;0;1.6;0.3;0.0
93;2021-02-13;321;248;0;27780;5943;0;1.7;0.4;0.0
93;2021-02-14;21;68;0;27801;6011;0;1.7;0.4;0.0
93;2021-02-15;423;918;0;28224;6929;0;1.7;0.4;0.0
93;2021-02-16;517;1167;0;28741;8096;0;1.7;0.5;0.0
93;2021-02-17;579;1428;0;29320;9524;0;1.8;0.6;0.0
93;2021-02-18;1016;1704;0;30336;11228;0;1.8;0.7;0.0
93;2021-02-19;939;1427;0;31275;12655;0;1.9;0.8;0.0
93;2021-02-20;233;545;0;31508;13200;0;1.9;0.8;0.0
93;2021-02-21;23;45;0;31531;13245;0;1.9;0.8;0.0
93;2021-02-22;539;903;0;32070;14148;0;1.9;0.8;0.0
93;2021-02-23;522;847;0;32592;14995;0;2.0;0.9;0.0
93;2021-02-24;610;951;0;33202;15946;0;2.0;1.0;0.0
93;2021-02-25;927;998;0;34129;16944;0;2.0;1.0;0.0
93;2021-02-26;1133;820;0;35262;17764;0;2.1;1.1;0.0
93;2021-02-27;520;463;0;35782;18227;0;2.1;1.1;0.0
93;2021-02-28;83;49;0;35865;18276;0;2.1;1.1;0.0
93;2021-03-01;977;723;0;36842;18999;0;2.2;1.1;0.0
93;2021-03-02;1410;820;0;38252;19819;0;2.3;1.2;0.0
93;2021-03-03;1697;840;0;39949;20659;0;2.4;1.2;0.0
93;2021-03-04;2584;918;0;42533;21577;0;2.5;1.3;0.0
93;2021-03-05;3559;833;0;46092;22410;0;2.8;1.3;0.0
93;2021-03-06;4109;495;0;50201;22905;0;3.0;1.4;0.0
93;2021-03-07;3202;287;0;53403;23192;0;3.2;1.4;0.0
93;2021-03-08;2021;895;0;55424;24087;0;3.3;1.4;0.0
93;2021-03-09;2743;735;0;58167;24822;0;3.5;1.5;0.0
93;2021-03-10;2849;828;0;61016;25650;0;3.7;1.5;0.0
93;2021-03-11;3640;1068;0;64656;26718;0;3.9;1.6;0.0
93;2021-03-12;4164;1123;0;68820;27841;0;4.1;1.7;0.0
93;2021-03-13;3738;506;0;72558;28347;0;4.3;1.7;0.0
93;2021-03-14;1124;104;0;73682;28451;0;4.4;1.7;0.0
93;2021-03-15;3012;554;0;76694;29005;0;4.6;1.7;0.0
93;2021-03-16;2648;493;0;79342;29498;0;4.8;1.8;0.0
93;2021-03-17;2245;559;0;81587;30057;0;4.9;1.8;0.0
93;2021-03-18;2767;645;0;84354;30702;0;5.1;1.8;0.0
93;2021-03-19;3342;596;0;87696;31298;0;5.3;1.9;0.0
93;2021-03-20;2766;280;0;90462;31578;0;5.4;1.9;0.0
93;2021-03-21;789;196;0;91251;31774;0;5.5;1.9;0.0
93;2021-03-22;3392;570;0;94643;32344;0;5.7;1.9;0.0
93;2021-03-23;4286;725;0;98929;33069;0;5.9;2.0;0.0
93;2021-03-24;4021;679;0;102950;33748;0;6.2;2.0;0.0
93;2021-03-25;5427;792;0;108377;34540;0;6.5;2.1;0.0
93;2021-03-26;5288;816;0;113665;35356;0;6.8;2.1;0.0
93;2021-03-27;3769;297;0;117434;35653;0;7.0;2.1;0.0
93;2021-03-28;835;63;0;118269;35716;0;7.1;2.1;0.0
93;2021-03-29;3531;939;0;121800;36655;0;7.3;2.2;0.0
93;2021-03-30;4390;1243;0;126190;37898;0;7.6;2.3;0.0
93;2021-03-31;3938;1280;0;130128;39178;0;7.8;2.3;0.0
93;2021-04-01;4228;2692;0;134356;41870;0;8.0;2.5;0.0
93;2021-04-02;3492;2858;0;137848;44728;0;8.3;2.7;0.0
93;2021-04-03;2259;1797;0;140107;46525;0;8.4;2.8;0.0
93;2021-04-04;809;230;0;140916;46755;0;8.4;2.8;0.0
93;2021-04-05;797;123;0;141713;46878;0;8.5;2.8;0.0
93;2021-04-06;3743;2034;0;145456;48912;0;8.7;2.9;0.0
93;2021-04-07;4016;1929;0;149472;50841;0;8.9;3.0;0.0
93;2021-04-08;4843;2386;0;154315;53227;0;9.2;3.2;0.0
93;2021-04-09;5247;2701;0;159562;55928;0;9.6;3.3;0.0
93;2021-04-10;3220;2074;0;162782;58002;0;9.7;3.5;0.0
93;2021-04-11;778;591;0;163560;58593;0;9.8;3.5;0.0
93;2021-04-12;3723;2239;0;167283;60832;0;10.0;3.6;0.0
93;2021-04-13;4015;3198;0;171298;64030;0;10.3;3.8;0.0
93;2021-04-14;3762;2157;0;175060;66187;0;10.5;4.0;0.0
93;2021-04-15;4094;2727;0;179154;68914;0;10.7;4.1;0.0
93;2021-04-16;3757;2521;0;182911;71435;0;11.0;4.3;0.0
93;2021-04-17;2548;1963;0;185459;73398;0;11.1;4.4;0.0
93;2021-04-18;467;513;0;185926;73911;0;11.1;4.4;0.0
93;2021-04-19;2897;2415;0;188823;76326;0;11.3;4.6;0.0
93;2021-04-20;3241;2887;0;192064;79213;0;11.5;4.7;0.0
93;2021-04-21;3050;2610;0;195114;81823;0;11.7;4.9;0.0
93;2021-04-22;3527;3681;0;198641;85504;0;11.9;5.1;0.0
93;2021-04-23;3739;3076;0;202380;88580;0;12.1;5.3;0.0
93;2021-04-24;3628;2679;0;206008;91259;0;12.3;5.5;0.0
93;2021-04-25;1409;738;0;207417;91997;0;12.4;5.5;0.0
93;2021-04-26;3625;2788;0;211042;94785;0;12.6;5.7;0.0
93;2021-04-27;5107;3163;0;216149;97948;0;12.9;5.9;0.0
93;2021-04-28;4692;3068;0;220841;101016;0;13.2;6.0;0.0
93;2021-04-29;6044;3076;0;226885;104092;0;13.6;6.2;0.0
93;2021-04-30;6567;3065;0;233452;107157;0;14.0;6.4;0.0
93;2021-05-01;3014;918;0;236466;108075;0;14.2;6.5;0.0
93;2021-05-02;952;751;0;237418;108826;0;14.2;6.5;0.0
93;2021-05-03;6046;4474;0;243464;113300;0;14.6;6.8;0.0
93;2021-05-04;6069;4287;0;249533;117587;0;14.9;7.0;0.0
93;2021-05-05;6046;3605;0;255579;121192;0;15.3;7.3;0.0
93;2021-05-06;6853;3994;0;262432;125186;0;15.7;7.5;0.0
93;2021-05-07;5694;4340;0;268126;129526;0;16.1;7.8;0.0
93;2021-05-08;5455;2151;0;273581;131677;0;16.4;7.9;0.0
93;2021-05-09;3654;1386;0;277235;133063;0;16.6;8.0;0.0
93;2021-05-10;7192;3554;0;284427;136617;0;17.0;8.2;0.0
93;2021-05-11;7576;4168;0;292003;140785;0;17.5;8.4;0.0
93;2021-05-12;7210;3216;0;299213;144001;0;17.9;8.6;0.0
93;2021-05-13;6069;1140;0;305282;145141;0;18.3;8.7;0.0
93;2021-05-14;8565;3014;0;313847;148155;0;18.8;8.9;0.0
93;2021-05-15;8549;2260;0;322396;150415;0;19.3;9.0;0.0
93;2021-05-16;4200;673;0;326596;151088;0;19.6;9.0;0.0
93;2021-05-17;8215;1903;0;334811;152991;0;20.0;9.2;0.0
93;2021-05-18;9131;2017;0;343942;155008;0;20.6;9.3;0.0
93;2021-05-19;8625;3037;0;352567;158045;0;21.1;9.5;0.0
93;2021-05-20;10019;3322;0;362586;161367;0;21.7;9.7;0.0
93;2021-05-21;9816;2744;0;372402;164111;0;22.3;9.8;0.0
93;2021-05-22;9214;1987;0;381616;166098;0;22.8;9.9;0.0
93;2021-05-23;5689;898;0;387305;166996;0;23.2;10.0;0.0
93;2021-05-24;7582;1442;0;394887;168438;0;23.6;10.1;0.0
93;2021-05-25;8244;4091;0;403131;172529;0;24.1;10.3;0.0
93;2021-05-26;8047;3409;0;411178;175938;0;24.6;10.5;0.0
93;2021-05-27;9331;3718;0;420509;179656;0;25.2;10.8;0.0
93;2021-05-28;9250;4701;0;429759;184357;0;25.7;11.0;0.0
93;2021-05-29;7839;3277;0;437598;187634;0;26.2;11.2;0.0
93;2021-05-30;5316;1223;0;442914;188857;0;26.5;11.3;0.0
93;2021-05-31;7081;4268;0;449995;193125;0;26.9;11.6;0.0
93;2021-06-01;8613;5181;0;458608;198306;0;27.5;11.9;0.0
93;2021-06-02;8010;4202;0;466618;202508;0;27.9;12.1;0.0
93;2021-06-03;8360;4473;0;474978;206981;0;28.4;12.4;0.0
93;2021-06-04;8680;5820;0;483658;212801;0;29.0;12.7;0.0
93;2021-06-05;7052;5073;0;490710;217874;0;29.4;13.0;0.0
93;2021-06-06;5209;1543;0;495919;219417;0;29.7;13.1;0.0
93;2021-06-07;7072;5812;0;502991;225229;0;30.1;13.5;0.0
93;2021-06-08;7862;6115;0;510853;231344;0;30.6;13.9;0.0
93;2021-06-09;7911;6202;0;518764;237546;0;31.1;14.2;0.0
93;2021-06-10;7110;8198;0;525874;245744;0;31.5;14.7;0.0
93;2021-06-11;7044;7600;0;532918;253344;0;31.9;15.2;0.0
93;2021-06-12;7329;5221;0;540247;258565;0;32.3;15.5;0.0
93;2021-06-13;4581;2119;0;544828;260684;0;32.6;15.6;0.0
93;2021-06-14;4763;7447;0;549591;268131;0;32.9;16.1;0.0
93;2021-06-15;5790;7978;0;555381;276109;0;33.3;16.5;0.0
93;2021-06-16;5711;7308;0;561092;283417;0;33.6;17.0;0.0
93;2021-06-17;5148;7348;0;566240;290765;0;33.9;17.4;0.0
93;2021-06-18;6090;9534;0;572330;300299;0;34.3;18.0;0.0
93;2021-06-19;5513;8283;0;577843;308582;0;34.6;18.5;0.0
93;2021-06-20;3131;4757;0;580974;313339;0;34.8;18.8;0.0
93;2021-06-21;3624;8303;0;584598;321642;0;35.0;19.3;0.0
93;2021-06-22;4068;9136;0;588666;330778;0;35.2;19.8;0.0
93;2021-06-23;4140;8735;0;592806;339513;0;35.5;20.3;0.0
93;2021-06-24;3915;8320;0;596721;347833;0;35.7;20.8;0.0
93;2021-06-25;4538;10776;0;601259;358609;0;36.0;21.5;0.0
93;2021-06-26;4103;10492;0;605362;369101;0;36.2;22.1;0.0
93;2021-06-27;2348;5147;0;607710;374248;0;36.4;22.4;0.0
93;2021-06-28;3406;9449;0;611116;383697;0;36.6;23.0;0.0
93;2021-06-29;3734;9534;0;614850;393231;0;36.8;23.5;0.0
93;2021-06-30;3872;9267;0;618722;402498;0;37.0;24.1;0.0
93;2021-07-01;4861;9413;0;623583;411911;0;37.3;24.7;0.0
93;2021-07-02;5053;10500;0;628636;422411;0;37.6;25.3;0.0
93;2021-07-03;4454;10422;0;633090;432833;0;37.9;25.9;0.0
93;2021-07-04;2380;6119;0;635470;438952;0;38.0;26.3;0.0
93;2021-07-05;4204;8616;0;639674;447568;0;38.3;26.8;0.0
93;2021-07-06;4478;9583;1;644152;457151;1;38.6;27.4;0.0
93;2021-07-07;4763;9725;0;648915;466876;1;38.9;28.0;0.0
93;2021-07-08;4746;9366;0;653661;476242;1;39.1;28.5;0.0
93;2021-07-09;5447;11104;0;659108;487346;1;39.5;29.2;0.0
93;2021-07-10;4789;10970;0;663897;498316;1;39.8;29.8;0.0
93;2021-07-11;2624;6517;0;666521;504833;1;39.9;30.2;0.0
93;2021-07-12;4801;10040;0;671322;514873;1;40.2;30.8;0.0
93;2021-07-13;8765;11830;0;680087;526703;1;40.7;31.5;0.0
93;2021-07-14;7007;5788;0;687094;532491;1;41.1;31.9;0.0
93;2021-07-15;9876;12392;1;696970;544883;2;41.7;32.6;0.0
93;2021-07-16;10475;11769;0;707445;556652;2;42.4;33.3;0.0
93;2021-07-17;8550;11155;0;715995;567807;2;42.9;34.0;0.0
93;2021-07-18;4802;6242;0;720797;574049;2;43.2;34.4;0.0
93;2021-07-19;7573;9497;0;728370;583546;2;43.6;34.9;0.0
93;2021-07-20;9911;9687;0;738281;593233;2;44.2;35.5;0.0
93;2021-07-21;11062;9669;0;749343;602902;2;44.9;36.1;0.0
93;2021-07-22;11235;8571;0;760578;611473;2;45.5;36.6;0.0
93;2021-07-23;11868;9832;0;772446;621305;2;46.3;37.2;0.0
93;2021-07-24;9602;8784;0;782048;630089;2;46.8;37.7;0.0
93;2021-07-25;5387;4780;0;787435;634869;2;47.1;38.0;0.0
93;2021-07-26;9641;7359;0;797076;642228;2;47.7;38.5;0.0
93;2021-07-27;11663;7277;1;808739;649505;3;48.4;38.9;0.0
93;2021-07-28;11607;7665;0;820346;657170;3;49.1;39.3;0.0
93;2021-07-29;10801;6725;0;831147;663895;3;49.8;39.8;0.0
93;2021-07-30;11015;7434;0;842162;671329;3;50.4;40.2;0.0
93;2021-07-31;8251;6413;0;850413;677742;3;50.9;40.6;0.0
93;2021-08-01;4534;3226;0;854947;680968;3;51.2;40.8;0.0
93;2021-08-02;7538;5515;0;862485;686483;3;51.6;41.1;0.0
93;2021-08-03;6711;6166;0;869196;692649;3;52.0;41.5;0.0
93;2021-08-04;6750;6571;0;875946;699220;3;52.4;41.9;0.0
93;2021-08-05;5542;6153;0;881488;705373;3;52.8;42.2;0.0
93;2021-08-06;6207;7347;0;887695;712720;3;53.2;42.7;0.0
93;2021-08-07;5104;6857;0;892799;719577;3;53.5;43.1;0.0
93;2021-08-08;2630;3728;0;895429;723305;3;53.6;43.3;0.0
93;2021-08-09;5559;6826;0;900988;730131;3;53.9;43.7;0.0
93;2021-08-10;5911;7633;0;906899;737764;3;54.3;44.2;0.0
93;2021-08-11;5620;7985;0;912519;745749;3;54.6;44.7;0.0
93;2021-08-12;5061;7660;0;917580;753409;3;54.9;45.1;0.0
93;2021-08-13;4754;7491;0;922334;760900;3;55.2;45.6;0.0
93;2021-08-14;3743;7309;0;926077;768209;3;55.4;46.0;0.0
93;2021-08-15;1440;2239;0;927517;770448;3;55.5;46.1;0.0
93;2021-08-16;4294;8901;0;931811;779349;3;55.8;46.7;0.0
93;2021-08-17;4778;9053;0;936589;788402;3;56.1;47.2;0.0
93;2021-08-18;4344;9132;0;940933;797534;3;56.3;47.8;0.0
93;2021-08-19;3718;7933;0;944651;805467;3;56.6;48.2;0.0
93;2021-08-20;3912;8949;0;948563;814416;3;56.8;48.8;0.0
93;2021-08-21;3030;8231;0;951593;822647;3;57.0;49.3;0.0
93;2021-08-22;1352;4215;0;952945;826862;3;57.1;49.5;0.0
93;2021-08-23;3442;8112;0;956387;834974;3;57.3;50.0;0.0
93;2021-08-24;3599;7732;0;959986;842706;3;57.5;50.5;0.0
93;2021-08-25;3487;7705;0;963473;850411;3;57.7;50.9;0.0
93;2021-08-26;3114;6468;0;966587;856879;3;57.9;51.3;0.0
93;2021-08-27;3364;7702;0;969951;864581;3;58.1;51.8;0.0
93;2021-08-28;2743;7134;0;972694;871715;3;58.2;52.2;0.0
93;2021-08-29;1235;3202;0;973929;874917;3;58.3;52.4;0.0
93;2021-08-30;2644;6687;94;976573;881604;97;58.5;52.8;0.0
93;2021-08-31;2763;6674;162;979336;888278;259;58.6;53.2;0.0
93;2021-09-01;3579;6104;321;982915;894382;580;58.9;53.6;0.0
93;2021-09-02;2711;4779;296;985626;899161;876;59.0;53.8;0.1
93;2021-09-03;2676;5847;329;988302;905008;1205;59.2;54.2;0.1
93;2021-09-04;2861;5986;243;991163;910994;1448;59.3;54.5;0.1
93;2021-09-05;947;2050;87;992110;913044;1535;59.4;54.7;0.1
93;2021-09-06;1656;3853;310;993766;916897;1845;59.5;54.9;0.1
93;2021-09-07;1754;3668;249;995520;920565;2094;59.6;55.1;0.1
93;2021-09-08;2189;3996;332;997709;924561;2426;59.7;55.4;0.1
93;2021-09-09;1886;3321;364;999595;927882;2790;59.9;55.6;0.2
93;2021-09-10;2677;3993;372;1002272;931875;3162;60.0;55.8;0.2
93;2021-09-11;2013;4633;186;1004285;936508;3348;60.1;56.1;0.2
93;2021-09-12;632;1580;75;1004917;938088;3423;60.2;56.2;0.2
93;2021-09-13;1960;2973;458;1006877;941061;3881;60.3;56.3;0.2
93;2021-09-14;1905;2788;617;1008782;943849;4498;60.4;56.5;0.3
93;2021-09-15;1924;3100;588;1010706;946949;5086;60.5;56.7;0.3
93;2021-09-16;1613;2318;489;1012319;949267;5575;60.6;56.8;0.3
93;2021-09-17;1861;3189;542;1014180;952456;6117;60.7;57.0;0.4
93;2021-09-18;1373;3769;359;1015553;956225;6476;60.8;57.3;0.4
93;2021-09-19;383;1242;97;1015936;957467;6573;60.8;57.3;0.4
93;2021-09-20;1197;1935;447;1017133;959402;7020;60.9;57.4;0.4
93;2021-09-21;1011;1848;449;1018144;961250;7469;61.0;57.6;0.4
93;2021-09-22;1249;2775;550;1019393;964025;8019;61.0;57.7;0.5
93;2021-09-23;1005;1670;513;1020398;965695;8532;61.1;57.8;0.5
93;2021-09-24;1296;2570;631;1021694;968265;9163;61.2;58.0;0.5
93;2021-09-25;1152;3392;264;1022846;971657;9427;61.2;58.2;0.6
93;2021-09-26;296;1038;81;1023142;972695;9508;61.3;58.2;0.6
93;2021-09-27;862;1582;466;1024004;974277;9974;61.3;58.3;0.6
93;2021-09-28;897;1371;498;1024901;975648;10472;61.4;58.4;0.6
93;2021-09-29;1134;2183;600;1026035;977831;11072;61.4;58.5;0.7
93;2021-09-30;878;1576;635;1026913;979407;11707;61.5;58.6;0.7
93;2021-10-01;2085;2026;663;1028998;981433;12370;61.6;58.8;0.7
93;2021-10-02;1382;2085;363;1030380;983518;12733;61.7;58.9;0.8
93;2021-10-03;237;496;97;1030617;984014;12830;61.7;58.9;0.8
93;2021-10-04;1075;1492;704;1031692;985506;13534;61.8;59.0;0.8
93;2021-10-05;891;1358;563;1032583;986864;14097;61.8;59.1;0.8
93;2021-10-06;1110;1721;936;1033693;988585;15033;61.9;59.2;0.9
93;2021-10-07;882;1541;937;1034575;990126;15970;61.9;59.3;1.0
93;2021-10-08;1128;1848;972;1035703;991974;16942;62.0;59.4;1.0
93;2021-10-09;1263;2019;612;1036966;993993;17554;62.1;59.5;1.1
93;2021-10-10;258;424;110;1037224;994417;17664;62.1;59.5;1.1
93;2021-10-11;927;1444;851;1038151;995861;18515;62.2;59.6;1.1
93;2021-10-12;776;1247;951;1038927;997108;19466;62.2;59.7;1.2
93;2021-10-13;1025;1542;1118;1039952;998650;20584;62.3;59.8;1.2
93;2021-10-14;851;1329;1059;1040803;999979;21643;62.3;59.9;1.3
93;2021-10-15;1123;1621;1200;1041926;1001600;22843;62.4;60.0;1.4
93;2021-10-16;1072;1563;686;1042998;1003163;23529;62.4;60.1;1.4
93;2021-10-17;213;303;164;1043211;1003466;23693;62.5;60.1;1.4
93;2021-10-18;735;1198;938;1043946;1004664;24631;62.5;60.2;1.5
93;2021-10-19;706;1123;917;1044652;1005787;25548;62.5;60.2;1.5
93;2021-10-20;718;1077;1425;1045370;1006864;26973;62.6;60.3;1.6
93;2021-10-21;551;972;1277;1045921;1007836;28250;62.6;60.3;1.7
93;2021-10-22;793;1291;1374;1046714;1009127;29624;62.7;60.4;1.8
93;2021-10-23;812;1266;961;1047526;1010393;30585;62.7;60.5;1.8
93;2021-10-24;164;249;165;1047690;1010642;30750;62.7;60.5;1.8
93;2021-10-25;526;913;1106;1048216;1011555;31856;62.8;60.6;1.9
93;2021-10-26;498;823;1116;1048714;1012378;32972;62.8;60.6;2.0
93;2021-10-27;647;1012;1566;1049361;1013390;34538;62.8;60.7;2.1
93;2021-10-28;568;935;1432;1049929;1014325;35970;62.9;60.7;2.2
93;2021-10-29;605;1040;1468;1050534;1015365;37438;62.9;60.8;2.2
93;2021-10-30;612;1236;1045;1051146;1016601;38483;62.9;60.9;2.3
93;2021-10-31;152;244;177;1051298;1016845;38660;62.9;60.9;2.3
93;2021-11-01;232;206;90;1051530;1017051;38750;63.0;60.9;2.3
93;2021-11-02;611;885;1058;1052141;1017936;39808;63.0;60.9;2.4
93;2021-11-03;547;1020;1320;1052688;1018956;41128;63.0;61.0;2.5
93;2021-11-04;502;846;1277;1053190;1019802;42405;63.1;61.1;2.5
93;2021-11-05;552;948;1345;1053742;1020750;43750;63.1;61.1;2.6
93;2021-11-06;558;971;957;1054300;1021721;44707;63.1;61.2;2.7
93;2021-11-07;92;221;174;1054392;1021942;44881;63.1;61.2;2.7
93;2021-11-08;398;730;1528;1054790;1022672;46409;63.2;61.2;2.8
93;2021-11-09;420;871;1929;1055210;1023543;48338;63.2;61.3;2.9
93;2021-11-10;600;1004;2525;1055810;1024547;50863;63.2;61.3;3.0
93;2021-11-11;170;245;483;1055980;1024792;51346;63.2;61.4;3.1
93;2021-11-12;574;915;2725;1056554;1025707;54071;63.3;61.4;3.2
93;2021-11-13;546;805;1509;1057100;1026512;55580;63.3;61.5;3.3
93;2021-11-14;94;202;287;1057194;1026714;55867;63.3;61.5;3.3
93;2021-11-15;421;761;2509;1057615;1027475;58376;63.3;61.5;3.5
93;2021-11-16;474;724;2694;1058089;1028199;61070;63.4;61.6;3.7
93;2021-11-17;526;868;2340;1058615;1029067;63410;63.4;61.6;3.8
93;2021-11-18;420;693;2317;1059035;1029760;65727;63.4;61.7;3.9
93;2021-11-19;524;870;2924;1059559;1030630;68651;63.4;61.7;4.1
93;2021-11-20;696;1016;2086;1060255;1031646;70737;63.5;61.8;4.2
93;2021-11-21;106;235;385;1060361;1031881;71122;63.5;61.8;4.3
93;2021-11-22;396;607;2822;1060757;1032488;73944;63.5;61.8;4.4
93;2021-11-23;453;757;2926;1061210;1033245;76870;63.5;61.9;4.6
93;2021-11-24;555;847;2892;1061765;1034092;79762;63.6;61.9;4.8
93;2021-11-25;438;693;3994;1062203;1034785;83756;63.6;62.0;5.0
93;2021-11-26;518;866;6374;1062721;1035651;90130;63.6;62.0;5.4
93;2021-11-27;542;821;5519;1063263;1036472;95649;63.7;62.1;5.7
93;2021-11-28;162;267;2205;1063425;1036739;97854;63.7;62.1;5.9
93;2021-11-29;349;637;6770;1063774;1037376;104624;63.7;62.1;6.3
93;2021-11-30;382;663;8280;1064156;1038039;112904;63.7;62.2;6.8
93;2021-12-01;424;786;8242;1064580;1038825;121146;63.7;62.2;7.3
93;2021-12-02;383;637;8026;1064963;1039462;129172;63.8;62.2;7.7
93;2021-12-03;413;785;9980;1065376;1040247;139152;63.8;62.3;8.3
93;2021-12-04;415;787;7584;1065791;1041034;146736;63.8;62.3;8.8
93;2021-12-05;157;279;3321;1065948;1041313;150057;63.8;62.3;9.0
93;2021-12-06;373;694;8726;1066321;1042007;158783;63.8;62.4;9.5
93;2021-12-07;413;770;9967;1066734;1042777;168750;63.9;62.4;10.1
93;2021-12-08;461;832;10207;1067195;1043609;178957;63.9;62.5;10.7
93;2021-12-09;428;708;9465;1067623;1044317;188422;63.9;62.5;11.3
93;2021-12-10;500;823;12404;1068123;1045140;200826;64.0;62.6;12.0
93;2021-12-11;461;846;9612;1068584;1045986;210438;64.0;62.6;12.6
93;2021-12-12;214;347;5541;1068798;1046333;215979;64.0;62.6;12.9
93;2021-12-13;418;729;10153;1069216;1047062;226132;64.0;62.7;13.5
93;2021-12-14;473;703;12047;1069689;1047765;238179;64.0;62.7;14.3
93;2021-12-15;470;730;11459;1070159;1048495;249638;64.1;62.8;14.9
93;2021-12-16;420;704;10673;1070579;1049199;260311;64.1;62.8;15.6
94;2020-12-27;13;0;0;13;0;0;0.0;0.0;0.0
94;2020-12-28;9;1;0;22;1;0;0.0;0.0;0.0
94;2020-12-29;3;0;0;25;1;0;0.0;0.0;0.0
94;2020-12-30;10;0;0;35;1;0;0.0;0.0;0.0
94;2020-12-31;13;2;0;48;3;0;0.0;0.0;0.0
94;2021-01-01;14;0;0;62;3;0;0.0;0.0;0.0
94;2021-01-02;10;0;0;72;3;0;0.0;0.0;0.0
94;2021-01-03;12;0;0;84;3;0;0.0;0.0;0.0
94;2021-01-04;65;1;0;149;4;0;0.0;0.0;0.0
94;2021-01-05;262;2;0;411;6;0;0.0;0.0;0.0
94;2021-01-06;376;6;0;787;12;0;0.1;0.0;0.0
94;2021-01-07;728;7;0;1515;19;0;0.1;0.0;0.0
94;2021-01-08;946;10;0;2461;29;0;0.2;0.0;0.0
94;2021-01-09;132;0;0;2593;29;0;0.2;0.0;0.0
94;2021-01-10;100;0;0;2693;29;0;0.2;0.0;0.0
94;2021-01-11;1043;12;0;3736;41;0;0.3;0.0;0.0
94;2021-01-12;1297;17;0;5033;58;0;0.4;0.0;0.0
94;2021-01-13;1312;17;0;6345;75;0;0.5;0.0;0.0
94;2021-01-14;1361;23;0;7706;98;0;0.5;0.0;0.0
94;2021-01-15;1094;18;0;8800;116;0;0.6;0.0;0.0
94;2021-01-16;270;2;0;9070;118;0;0.6;0.0;0.0
94;2021-01-17;134;3;0;9204;121;0;0.7;0.0;0.0
94;2021-01-18;1443;27;0;10647;148;0;0.8;0.0;0.0
94;2021-01-19;1873;23;0;12520;171;0;0.9;0.0;0.0
94;2021-01-20;2165;29;0;14685;200;0;1.0;0.0;0.0
94;2021-01-21;2957;31;0;17642;231;0;1.3;0.0;0.0
94;2021-01-22;2116;19;0;19758;250;0;1.4;0.0;0.0
94;2021-01-23;745;5;0;20503;255;0;1.5;0.0;0.0
94;2021-01-24;272;1;0;20775;256;0;1.5;0.0;0.0
94;2021-01-25;1307;28;0;22082;284;0;1.6;0.0;0.0
94;2021-01-26;1540;27;0;23622;311;0;1.7;0.0;0.0
94;2021-01-27;1953;77;0;25575;388;0;1.8;0.0;0.0
94;2021-01-28;1924;148;0;27499;536;0;2.0;0.0;0.0
94;2021-01-29;1529;189;0;29028;725;0;2.1;0.1;0.0
94;2021-01-30;661;13;0;29689;738;0;2.1;0.1;0.0
94;2021-01-31;126;12;0;29815;750;0;2.1;0.1;0.0
94;2021-02-01;914;239;0;30729;989;0;2.2;0.1;0.0
94;2021-02-02;969;319;0;31698;1308;0;2.3;0.1;0.0
94;2021-02-03;854;395;0;32552;1703;0;2.3;0.1;0.0
94;2021-02-04;998;525;0;33550;2228;0;2.4;0.2;0.0
94;2021-02-05;989;570;0;34539;2798;0;2.5;0.2;0.0
94;2021-02-06;467;71;0;35006;2869;0;2.5;0.2;0.0
94;2021-02-07;115;13;0;35121;2882;0;2.5;0.2;0.0
94;2021-02-08;698;664;0;35819;3546;0;2.5;0.3;0.0
94;2021-02-09;1075;1135;0;36894;4681;0;2.6;0.3;0.0
94;2021-02-10;1104;1228;0;37998;5909;0;2.7;0.4;0.0
94;2021-02-11;1465;1857;0;39463;7766;0;2.8;0.6;0.0
94;2021-02-12;1372;1527;0;40835;9293;0;2.9;0.7;0.0
94;2021-02-13;300;244;0;41135;9537;0;2.9;0.7;0.0
94;2021-02-14;46;82;0;41181;9619;0;2.9;0.7;0.0
94;2021-02-15;679;1517;0;41860;11136;0;3.0;0.8;0.0
94;2021-02-16;693;2247;0;42553;13383;0;3.0;1.0;0.0
94;2021-02-17;642;1575;0;43195;14958;0;3.1;1.1;0.0
94;2021-02-18;943;1894;0;44138;16852;0;3.1;1.2;0.0
94;2021-02-19;920;1571;0;45058;18423;0;3.2;1.3;0.0
94;2021-02-20;180;859;0;45238;19282;0;3.2;1.4;0.0
94;2021-02-21;43;148;0;45281;19430;0;3.2;1.4;0.0
94;2021-02-22;481;1284;0;45762;20714;0;3.3;1.5;0.0
94;2021-02-23;641;1435;0;46403;22149;0;3.3;1.6;0.0
94;2021-02-24;655;1058;0;47058;23207;0;3.3;1.7;0.0
94;2021-02-25;1152;1645;0;48210;24852;0;3.4;1.8;0.0
94;2021-02-26;1312;1213;0;49522;26065;0;3.5;1.9;0.0
94;2021-02-27;594;595;0;50116;26660;0;3.6;1.9;0.0
94;2021-02-28;87;82;0;50203;26742;0;3.6;1.9;0.0
94;2021-03-01;948;999;0;51151;27741;0;3.6;2.0;0.0
94;2021-03-02;1603;1127;0;52754;28868;0;3.8;2.1;0.0
94;2021-03-03;2011;1126;0;54765;29994;0;3.9;2.1;0.0
94;2021-03-04;3024;1265;0;57789;31259;0;4.1;2.2;0.0
94;2021-03-05;4120;1428;0;61909;32687;0;4.4;2.3;0.0
94;2021-03-06;5153;639;0;67062;33326;0;4.8;2.4;0.0
94;2021-03-07;3928;526;0;70990;33852;0;5.0;2.4;0.0
94;2021-03-08;1857;891;0;72847;34743;0;5.2;2.5;0.0
94;2021-03-09;2720;1069;0;75567;35812;0;5.4;2.5;0.0
94;2021-03-10;3193;1123;0;78760;36935;0;5.6;2.6;0.0
94;2021-03-11;4127;1100;0;82887;38035;0;5.9;2.7;0.0
94;2021-03-12;4780;1003;0;87667;39038;0;6.2;2.8;0.0
94;2021-03-13;4444;454;0;92111;39492;0;6.6;2.8;0.0
94;2021-03-14;2159;150;0;94270;39642;0;6.7;2.8;0.0
94;2021-03-15;3311;734;0;97581;40376;0;6.9;2.9;0.0
94;2021-03-16;2807;500;0;100388;40876;0;7.1;2.9;0.0
94;2021-03-17;2896;447;0;103284;41323;0;7.3;2.9;0.0
94;2021-03-18;3395;463;0;106679;41786;0;7.6;3.0;0.0
94;2021-03-19;4444;645;0;111123;42431;0;7.9;3.0;0.0
94;2021-03-20;3695;315;0;114818;42746;0;8.2;3.0;0.0
94;2021-03-21;1164;290;0;115982;43036;0;8.2;3.1;0.0
94;2021-03-22;3424;643;0;119406;43679;0;8.5;3.1;0.0
94;2021-03-23;4742;743;0;124148;44422;0;8.8;3.2;0.0
94;2021-03-24;4922;673;0;129070;45095;0;9.2;3.2;0.0
94;2021-03-25;6583;780;0;135653;45875;0;9.6;3.3;0.0
94;2021-03-26;6335;808;0;141988;46683;0;10.1;3.3;0.0
94;2021-03-27;4514;314;0;146502;46997;0;10.4;3.3;0.0
94;2021-03-28;1499;94;0;148001;47091;0;10.5;3.3;0.0
94;2021-03-29;4102;1145;0;152103;48236;0;10.8;3.4;0.0
94;2021-03-30;5223;1410;0;157326;49646;0;11.2;3.5;0.0
94;2021-03-31;4770;1743;0;162096;51389;0;11.5;3.7;0.0
94;2021-04-01;5720;2355;0;167816;53744;0;11.9;3.8;0.0
94;2021-04-02;5245;2485;0;173061;56229;0;12.3;4.0;0.0
94;2021-04-03;2932;2437;0;175993;58666;0;12.5;4.2;0.0
94;2021-04-04;992;704;0;176985;59370;0;12.6;4.2;0.0
94;2021-04-05;774;189;0;177759;59559;0;12.6;4.2;0.0
94;2021-04-06;3574;2364;0;181333;61923;0;12.9;4.4;0.0
94;2021-04-07;3981;2224;0;185314;64147;0;13.2;4.6;0.0
94;2021-04-08;5007;2156;0;190321;66303;0;13.5;4.7;0.0
94;2021-04-09;5938;2592;0;196259;68895;0;14.0;4.9;0.0
94;2021-04-10;3241;3130;0;199500;72025;0;14.2;5.1;0.0
94;2021-04-11;1015;1594;0;200515;73619;0;14.3;5.2;0.0
94;2021-04-12;3550;2385;0;204065;76004;0;14.5;5.4;0.0
94;2021-04-13;4371;3305;0;208436;79309;0;14.8;5.6;0.0
94;2021-04-14;3809;2837;0;212245;82146;0;15.1;5.8;0.0
94;2021-04-15;4584;3231;0;216829;85377;0;15.4;6.1;0.0
94;2021-04-16;4842;3035;0;221671;88412;0;15.8;6.3;0.0
94;2021-04-17;2777;2590;0;224448;91002;0;16.0;6.5;0.0
94;2021-04-18;942;892;0;225390;91894;0;16.0;6.5;0.0
94;2021-04-19;3071;2619;0;228461;94513;0;16.2;6.7;0.0
94;2021-04-20;3321;3017;0;231782;97530;0;16.5;6.9;0.0
94;2021-04-21;3295;3324;0;235077;100854;0;16.7;7.2;0.0
94;2021-04-22;3913;3777;0;238990;104631;0;17.0;7.4;0.0
94;2021-04-23;4277;3909;0;243267;108540;0;17.3;7.7;0.0
94;2021-04-24;4325;3225;0;247592;111765;0;17.6;7.9;0.0
94;2021-04-25;2234;1100;0;249826;112865;0;17.8;8.0;0.0
94;2021-04-26;3932;3178;0;253758;116043;0;18.0;8.3;0.0
94;2021-04-27;5135;3480;0;258893;119523;0;18.4;8.5;0.0
94;2021-04-28;5169;3743;0;264062;123266;0;18.8;8.8;0.0
94;2021-04-29;6245;3873;0;270307;127139;0;19.2;9.0;0.0
94;2021-04-30;6417;3948;0;276724;131087;0;19.7;9.3;0.0
94;2021-05-01;3995;895;0;280719;131982;0;20.0;9.4;0.0
94;2021-05-02;2267;1137;0;282986;133119;0;20.1;9.5;0.0
94;2021-05-03;5765;5110;0;288751;138229;0;20.5;9.8;0.0
94;2021-05-04;6114;3774;0;294865;142003;0;21.0;10.1;0.0
94;2021-05-05;6195;3631;0;301060;145634;0;21.4;10.4;0.0
94;2021-05-06;6996;3939;0;308056;149573;0;21.9;10.6;0.0
94;2021-05-07;6504;4442;0;314560;154015;0;22.4;11.0;0.0
94;2021-05-08;5298;2446;0;319858;156461;0;22.7;11.1;0.0
94;2021-05-09;3846;1817;0;323704;158278;0;23.0;11.3;0.0
94;2021-05-10;7132;3306;0;330836;161584;0;23.5;11.5;0.0
94;2021-05-11;8451;4073;0;339287;165657;0;24.1;11.8;0.0
94;2021-05-12;9179;3791;0;348466;169448;0;24.8;12.1;0.0
94;2021-05-13;7985;1323;0;356451;170771;0;25.4;12.1;0.0
94;2021-05-14;9481;3232;0;365932;174003;0;26.0;12.4;0.0
94;2021-05-15;8324;2171;0;374256;176174;0;26.6;12.5;0.0
94;2021-05-16;3944;773;0;378200;176947;0;26.9;12.6;0.0
94;2021-05-17;9425;2234;0;387625;179181;0;27.6;12.7;0.0
94;2021-05-18;9886;2410;0;397511;181591;0;28.3;12.9;0.0
94;2021-05-19;9829;3464;0;407340;185055;0;29.0;13.2;0.0
94;2021-05-20;10366;3847;0;417706;188902;0;29.7;13.4;0.0
94;2021-05-21;10166;3022;0;427872;191924;0;30.4;13.6;0.0
94;2021-05-22;8790;1874;0;436662;193798;0;31.1;13.8;0.0
94;2021-05-23;4026;611;0;440688;194409;0;31.3;13.8;0.0
94;2021-05-24;7388;1106;0;448076;195515;0;31.9;13.9;0.0
94;2021-05-25;8259;3917;0;456335;199432;0;32.5;14.2;0.0
94;2021-05-26;8362;3336;0;464697;202768;0;33.1;14.4;0.0
94;2021-05-27;8660;4542;0;473357;207310;0;33.7;14.7;0.0
94;2021-05-28;8670;5003;0;482027;212313;0;34.3;15.1;0.0
94;2021-05-29;7856;3356;0;489883;215669;0;34.8;15.3;0.0
94;2021-05-30;3525;805;0;493408;216474;0;35.1;15.4;0.0
94;2021-05-31;8368;4131;0;501776;220605;0;35.7;15.7;0.0
94;2021-06-01;9001;5115;0;510777;225720;0;36.3;16.1;0.0
94;2021-06-02;8344;4715;0;519121;230435;0;36.9;16.4;0.0
94;2021-06-03;8775;5797;0;527896;236232;0;37.5;16.8;0.0
94;2021-06-04;9101;6597;0;536997;242829;0;38.2;17.3;0.0
94;2021-06-05;7066;5980;0;544063;248809;0;38.7;17.7;0.0
94;2021-06-06;3061;1711;0;547124;250520;0;38.9;17.8;0.0
94;2021-06-07;7334;5815;0;554458;256335;0;39.4;18.2;0.0
94;2021-06-08;7659;6333;0;562117;262668;0;40.0;18.7;0.0
94;2021-06-09;7460;6953;0;569577;269621;0;40.5;19.2;0.0
94;2021-06-10;7665;9768;0;577242;279389;0;41.1;19.9;0.0
94;2021-06-11;7106;7897;0;584348;287286;0;41.6;20.4;0.0
94;2021-06-12;8232;6344;0;592580;293630;0;42.1;20.9;0.0
94;2021-06-13;2735;2652;0;595315;296282;0;42.3;21.1;0.0
94;2021-06-14;5886;7901;0;601201;304183;0;42.8;21.6;0.0
94;2021-06-15;6681;8540;0;607882;312723;0;43.2;22.2;0.0
94;2021-06-16;6270;8027;0;614152;320750;0;43.7;22.8;0.0
94;2021-06-17;5905;8360;0;620057;329110;0;44.1;23.4;0.0
94;2021-06-18;5816;10720;0;625873;339830;0;44.5;24.2;0.0
94;2021-06-19;5162;8552;0;631035;348382;0;44.9;24.8;0.0
94;2021-06-20;1598;3492;0;632633;351874;0;45.0;25.0;0.0
94;2021-06-21;4420;9915;0;637053;361789;0;45.3;25.7;0.0
94;2021-06-22;4512;10095;0;641565;371884;0;45.6;26.4;0.0
94;2021-06-23;4217;10313;0;645782;382197;0;45.9;27.2;0.0
94;2021-06-24;4606;9606;0;650388;391803;0;46.3;27.9;0.0
94;2021-06-25;4178;12645;0;654566;404448;0;46.6;28.8;0.0
94;2021-06-26;3322;10678;0;657888;415126;0;46.8;29.5;0.0
94;2021-06-27;1075;4024;0;658963;419150;0;46.9;29.8;0.0
94;2021-06-28;3339;10395;0;662302;429545;0;47.1;30.5;0.0
94;2021-06-29;3809;11136;0;666111;440681;0;47.4;31.3;0.0
94;2021-06-30;4023;10330;0;670134;451011;0;47.7;32.1;0.0
94;2021-07-01;4674;10178;0;674808;461189;0;48.0;32.8;0.0
94;2021-07-02;4534;10988;0;679342;472177;0;48.3;33.6;0.0
94;2021-07-03;3523;10476;0;682865;482653;0;48.6;34.3;0.0
94;2021-07-04;1430;4102;0;684295;486755;0;48.7;34.6;0.0
94;2021-07-05;3811;9739;0;688106;496494;0;48.9;35.3;0.0
94;2021-07-06;4122;9763;0;692228;506257;0;49.2;36.0;0.0
94;2021-07-07;4311;10017;0;696539;516274;0;49.5;36.7;0.0
94;2021-07-08;4637;9433;0;701176;525707;0;49.9;37.4;0.0
94;2021-07-09;4743;10840;0;705919;536547;0;50.2;38.2;0.0
94;2021-07-10;3837;9669;0;709756;546216;0;50.5;38.8;0.0
94;2021-07-11;1532;3746;0;711288;549962;0;50.6;39.1;0.0
94;2021-07-12;3679;10812;0;714967;560774;0;50.8;39.9;0.0
94;2021-07-13;6243;11625;0;721210;572399;0;51.3;40.7;0.0
94;2021-07-14;4521;5168;0;725731;577567;0;51.6;41.1;0.0
94;2021-07-15;7211;11922;0;732942;589489;0;52.1;41.9;0.0
94;2021-07-16;7776;11138;0;740718;600627;0;52.7;42.7;0.0
94;2021-07-17;5967;10135;0;746685;610762;0;53.1;43.4;0.0
94;2021-07-18;2807;3378;0;749492;614140;0;53.3;43.7;0.0
94;2021-07-19;6536;9818;0;756028;623958;0;53.8;44.4;0.0
94;2021-07-20;8115;9880;0;764143;633838;0;54.3;45.1;0.0
94;2021-07-21;8726;9290;0;772869;643128;0;55.0;45.7;0.0
94;2021-07-22;9527;9061;1;782396;652189;1;55.6;46.4;0.0
94;2021-07-23;9071;9447;0;791467;661636;1;56.3;47.1;0.0
94;2021-07-24;7026;8206;0;798493;669842;1;56.8;47.6;0.0
94;2021-07-25;2491;2655;0;800984;672497;1;57.0;47.8;0.0
94;2021-07-26;7416;7968;0;808400;680465;1;57.5;48.4;0.0
94;2021-07-27;8541;7266;0;816941;687731;1;58.1;48.9;0.0
94;2021-07-28;8675;6790;0;825616;694521;1;58.7;49.4;0.0
94;2021-07-29;8703;6605;0;834319;701126;1;59.3;49.9;0.0
94;2021-07-30;7779;6774;0;842098;707900;1;59.9;50.3;0.0
94;2021-07-31;6357;5919;0;848455;713819;1;60.3;50.8;0.0
94;2021-08-01;2645;1710;0;851100;715529;1;60.5;50.9;0.0
94;2021-08-02;6336;5558;0;857436;721087;1;61.0;51.3;0.0
94;2021-08-03;6100;5524;0;863536;726611;1;61.4;51.7;0.0
94;2021-08-04;5819;5264;0;869355;731875;1;61.8;52.1;0.0
94;2021-08-05;5712;5681;0;875067;737556;1;62.2;52.5;0.0
94;2021-08-06;5318;5752;0;880385;743308;1;62.6;52.9;0.0
94;2021-08-07;4029;4477;0;884414;747785;1;62.9;53.2;0.0
94;2021-08-08;1288;1706;0;885702;749491;1;63.0;53.3;0.0
94;2021-08-09;4513;6268;0;890215;755759;1;63.3;53.8;0.0
94;2021-08-10;4892;6092;0;895107;761851;1;63.7;54.2;0.0
94;2021-08-11;3905;5740;0;899012;767591;1;63.9;54.6;0.0
94;2021-08-12;3995;6252;0;903007;773843;1;64.2;55.0;0.0
94;2021-08-13;3372;5541;0;906379;779384;1;64.5;55.4;0.0
94;2021-08-14;2585;4870;0;908964;784254;1;64.6;55.8;0.0
94;2021-08-15;558;917;0;909522;785171;1;64.7;55.8;0.0
94;2021-08-16;3190;6956;0;912712;792127;1;64.9;56.3;0.0
94;2021-08-17;3134;6911;0;915846;799038;1;65.1;56.8;0.0
94;2021-08-18;2950;6421;0;918796;805459;1;65.3;57.3;0.0
94;2021-08-19;2935;6430;0;921731;811889;1;65.6;57.7;0.0
94;2021-08-20;2790;6569;0;924521;818458;1;65.8;58.2;0.0
94;2021-08-21;2182;5555;0;926703;824013;1;65.9;58.6;0.0
94;2021-08-22;715;2356;0;927418;826369;1;66.0;58.8;0.0
94;2021-08-23;2560;7074;0;929978;833443;1;66.1;59.3;0.0
94;2021-08-24;2835;6982;0;932813;840425;1;66.3;59.8;0.0
94;2021-08-25;2471;6104;0;935284;846529;1;66.5;60.2;0.0
94;2021-08-26;2345;5940;0;937629;852469;1;66.7;60.6;0.0
94;2021-08-27;2398;6283;0;940027;858752;1;66.9;61.1;0.0
94;2021-08-28;2107;5723;0;942134;864475;1;67.0;61.5;0.0
94;2021-08-29;700;1902;0;942834;866377;1;67.1;61.6;0.0
94;2021-08-30;2437;6610;166;945271;872987;167;67.2;62.1;0.0
94;2021-08-31;2391;6452;260;947662;879439;427;67.4;62.5;0.0
94;2021-09-01;2494;4874;559;950156;884313;986;67.6;62.9;0.1
94;2021-09-02;1963;4122;595;952119;888435;1581;67.7;63.2;0.1
94;2021-09-03;1950;4604;623;954069;893039;2204;67.9;63.5;0.2
94;2021-09-04;2127;4534;283;956196;897573;2487;68.0;63.8;0.2
94;2021-09-05;619;1034;156;956815;898607;2643;68.1;63.9;0.2
94;2021-09-06;1438;3003;662;958253;901610;3305;68.2;64.1;0.2
94;2021-09-07;1270;2806;599;959523;904416;3904;68.2;64.3;0.3
94;2021-09-08;1463;2875;496;960986;907291;4400;68.3;64.5;0.3
94;2021-09-09;1172;2425;637;962158;909716;5037;68.4;64.7;0.4
94;2021-09-10;1590;3017;742;963748;912733;5779;68.5;64.9;0.4
94;2021-09-11;1571;3693;258;965319;916426;6037;68.7;65.2;0.4
94;2021-09-12;383;924;92;965702;917350;6129;68.7;65.2;0.4
94;2021-09-13;1195;2095;678;966897;919445;6807;68.8;65.4;0.5
94;2021-09-14;1257;2073;1030;968154;921518;7837;68.9;65.5;0.6
94;2021-09-15;1314;2720;932;969468;924238;8769;69.0;65.7;0.6
94;2021-09-16;997;1782;1102;970465;926020;9871;69.0;65.9;0.7
94;2021-09-17;1186;2295;888;971651;928315;10759;69.1;66.0;0.8
94;2021-09-18;1072;3187;332;972723;931502;11091;69.2;66.2;0.8
94;2021-09-19;265;748;164;972988;932250;11255;69.2;66.3;0.8
94;2021-09-20;812;1646;768;973800;933896;12023;69.3;66.4;0.9
94;2021-09-21;901;1623;954;974701;935519;12977;69.3;66.5;0.9
94;2021-09-22;915;2199;706;975616;937718;13683;69.4;66.7;1.0
94;2021-09-23;767;1455;851;976383;939173;14534;69.4;66.8;1.0
94;2021-09-24;979;1899;821;977362;941072;15355;69.5;66.9;1.1
94;2021-09-25;927;2801;370;978289;943873;15725;69.6;67.1;1.1
94;2021-09-26;231;619;93;978520;944492;15818;69.6;67.2;1.1
94;2021-09-27;636;1368;758;979156;945860;16576;69.6;67.3;1.2
94;2021-09-28;687;1275;872;979843;947135;17448;69.7;67.4;1.2
94;2021-09-29;806;1560;692;980649;948695;18140;69.7;67.5;1.3
94;2021-09-30;950;1139;1012;981599;949834;19152;69.8;67.6;1.4
94;2021-10-01;1317;1605;978;982916;951439;20130;69.9;67.7;1.4
94;2021-10-02;1024;2003;446;983940;953442;20576;70.0;67.8;1.5
94;2021-10-03;217;431;101;984157;953873;20677;70.0;67.8;1.5
94;2021-10-04;656;1035;979;984813;954908;21656;70.0;67.9;1.5
94;2021-10-05;664;1066;934;985477;955974;22590;70.1;68.0;1.6
94;2021-10-06;686;1222;1006;986163;957196;23596;70.1;68.1;1.7
94;2021-10-07;615;993;1282;986778;958189;24878;70.2;68.1;1.8
94;2021-10-08;960;1445;1346;987738;959634;26224;70.2;68.3;1.9
94;2021-10-09;825;1497;634;988563;961131;26858;70.3;68.4;1.9
94;2021-10-10;188;360;241;988751;961491;27099;70.3;68.4;1.9
94;2021-10-11;580;941;1185;989331;962432;28284;70.4;68.4;2.0
94;2021-10-12;634;1088;1345;989965;963520;29629;70.4;68.5;2.1
94;2021-10-13;737;1070;1180;990702;964590;30809;70.5;68.6;2.2
94;2021-10-14;636;1022;1530;991338;965612;32339;70.5;68.7;2.3
94;2021-10-15;868;1276;1618;992206;966888;33957;70.6;68.8;2.4
94;2021-10-16;810;1249;882;993016;968137;34839;70.6;68.9;2.5
94;2021-10-17;172;284;186;993188;968421;35025;70.6;68.9;2.5
94;2021-10-18;483;804;1531;993671;969225;36556;70.7;68.9;2.6
94;2021-10-19;341;710;1523;994012;969935;38079;70.7;69.0;2.7
94;2021-10-20;398;819;1662;994410;970754;39741;70.7;69.0;2.8
94;2021-10-21;342;788;1850;994752;971542;41591;70.7;69.1;3.0
94;2021-10-22;425;1108;1997;995177;972650;43588;70.8;69.2;3.1
94;2021-10-23;462;1001;1240;995639;973651;44828;70.8;69.2;3.2
94;2021-10-24;95;185;294;995734;973836;45122;70.8;69.3;3.2
94;2021-10-25;313;550;1608;996047;974386;46730;70.8;69.3;3.3
94;2021-10-26;304;553;1806;996351;974939;48536;70.9;69.3;3.5
94;2021-10-27;306;624;1595;996657;975563;50131;70.9;69.4;3.6
94;2021-10-28;312;584;1936;996969;976147;52067;70.9;69.4;3.7
94;2021-10-29;314;683;1887;997283;976830;53954;70.9;69.5;3.8
94;2021-10-30;303;648;1158;997586;977478;55112;70.9;69.5;3.9
94;2021-10-31;65;151;255;997651;977629;55367;71.0;69.5;3.9
94;2021-11-01;76;85;65;997727;977714;55432;71.0;69.5;3.9
94;2021-11-02;299;678;1831;998026;978392;57263;71.0;69.6;4.1
94;2021-11-03;290;590;1765;998316;978982;59028;71.0;69.6;4.2
94;2021-11-04;295;579;2206;998611;979561;61234;71.0;69.7;4.4
94;2021-11-05;298;595;2184;998909;980156;63418;71.0;69.7;4.5
94;2021-11-06;308;655;1428;999217;980811;64846;71.1;69.8;4.6
94;2021-11-07;73;152;450;999290;980963;65296;71.1;69.8;4.6
94;2021-11-08;185;497;2058;999475;981460;67354;71.1;69.8;4.8
94;2021-11-09;249;590;2903;999724;982050;70257;71.1;69.8;5.0
94;2021-11-10;342;606;2998;1000066;982656;73255;71.1;69.9;5.2
94;2021-11-11;25;89;211;1000091;982745;73466;71.1;69.9;5.2
94;2021-11-12;327;630;3326;1000418;983375;76792;71.2;69.9;5.5
94;2021-11-13;328;556;1931;1000746;983931;78723;71.2;70.0;5.6
94;2021-11-14;59;125;380;1000805;984056;79103;71.2;70.0;5.6
94;2021-11-15;180;346;2627;1000985;984402;81730;71.2;70.0;5.8
94;2021-11-16;247;388;3394;1001232;984790;85124;71.2;70.0;6.1
94;2021-11-17;330;497;2918;1001562;985287;88042;71.2;70.1;6.3
94;2021-11-18;291;400;3442;1001853;985687;91484;71.3;70.1;6.5
94;2021-11-19;351;487;3805;1002204;986174;95289;71.3;70.1;6.8
94;2021-11-20;420;558;2266;1002624;986732;97555;71.3;70.2;6.9
94;2021-11-21;71;80;427;1002695;986812;97982;71.3;70.2;7.0
94;2021-11-22;209;318;2854;1002904;987130;100836;71.3;70.2;7.2
94;2021-11-23;247;327;3547;1003151;987457;104383;71.3;70.2;7.4
94;2021-11-24;349;424;3480;1003500;987881;107863;71.4;70.3;7.7
94;2021-11-25;287;357;4704;1003787;988238;112567;71.4;70.3;8.0
94;2021-11-26;346;444;6701;1004133;988682;119268;71.4;70.3;8.5
94;2021-11-27;319;424;5484;1004452;989106;124752;71.4;70.3;8.9
94;2021-11-28;64;88;1929;1004516;989194;126681;71.4;70.4;9.0
94;2021-11-29;153;275;6031;1004669;989469;132712;71.5;70.4;9.4
94;2021-11-30;246;368;9261;1004915;989837;141973;71.5;70.4;10.1
94;2021-12-01;250;432;9535;1005165;990269;151508;71.5;70.4;10.8
94;2021-12-02;218;262;10303;1005383;990531;161811;71.5;70.4;11.5
94;2021-12-03;227;418;11107;1005610;990949;172918;71.5;70.5;12.3
94;2021-12-04;212;418;8606;1005822;991367;181524;71.5;70.5;12.9
94;2021-12-05;69;103;2868;1005891;991470;184392;71.5;70.5;13.1
94;2021-12-06;175;338;9862;1006066;991808;194254;71.6;70.5;13.8
94;2021-12-07;248;393;12903;1006314;992201;207157;71.6;70.6;14.7
94;2021-12-08;245;395;11688;1006559;992596;218845;71.6;70.6;15.6
94;2021-12-09;264;382;13072;1006823;992978;231917;71.6;70.6;16.5
94;2021-12-10;249;477;13592;1007072;993455;245509;71.6;70.7;17.5
94;2021-12-11;252;458;10839;1007324;993913;256348;71.6;70.7;18.2
94;2021-12-12;93;122;5156;1007417;994035;261504;71.6;70.7;18.6
94;2021-12-13;195;324;11682;1007612;994359;273186;71.7;70.7;19.4
94;2021-12-14;256;398;14717;1007868;994757;287903;71.7;70.7;20.5
94;2021-12-15;314;500;13222;1008182;995257;301125;71.7;70.8;21.4
94;2021-12-16;298;447;14748;1008480;995704;315873;71.7;70.8;22.5
95;2020-12-27;8;0;0;8;0;0;0.0;0.0;0.0
95;2020-12-28;5;0;0;13;0;0;0.0;0.0;0.0
95;2020-12-29;2;0;0;15;0;0;0.0;0.0;0.0
95;2020-12-30;3;0;0;18;0;0;0.0;0.0;0.0
95;2020-12-31;5;0;0;23;0;0;0.0;0.0;0.0
95;2021-01-01;1;0;0;24;0;0;0.0;0.0;0.0
95;2021-01-02;14;0;0;38;0;0;0.0;0.0;0.0
95;2021-01-03;3;0;0;41;0;0;0.0;0.0;0.0
95;2021-01-04;62;0;0;103;0;0;0.0;0.0;0.0
95;2021-01-05;302;1;0;405;1;0;0.0;0.0;0.0
95;2021-01-06;207;1;0;612;2;0;0.0;0.0;0.0
95;2021-01-07;252;3;0;864;5;0;0.1;0.0;0.0
95;2021-01-08;433;3;0;1297;8;0;0.1;0.0;0.0
95;2021-01-09;279;0;0;1576;8;0;0.1;0.0;0.0
95;2021-01-10;334;2;0;1910;10;0;0.2;0.0;0.0
95;2021-01-11;577;13;0;2487;23;0;0.2;0.0;0.0
95;2021-01-12;846;6;0;3333;29;0;0.3;0.0;0.0
95;2021-01-13;862;15;0;4195;44;0;0.3;0.0;0.0
95;2021-01-14;891;15;0;5086;59;0;0.4;0.0;0.0
95;2021-01-15;870;16;0;5956;75;0;0.5;0.0;0.0
95;2021-01-16;303;4;0;6259;79;0;0.5;0.0;0.0
95;2021-01-17;138;1;0;6397;80;0;0.5;0.0;0.0
95;2021-01-18;1309;10;0;7706;90;0;0.6;0.0;0.0
95;2021-01-19;1542;14;0;9248;104;0;0.7;0.0;0.0
95;2021-01-20;1912;11;0;11160;115;0;0.9;0.0;0.0
95;2021-01-21;1858;10;0;13018;125;0;1.0;0.0;0.0
95;2021-01-22;1496;13;0;14514;138;0;1.2;0.0;0.0
95;2021-01-23;564;1;0;15078;139;0;1.2;0.0;0.0
95;2021-01-24;160;0;0;15238;139;0;1.2;0.0;0.0
95;2021-01-25;809;42;0;16047;181;0;1.3;0.0;0.0
95;2021-01-26;1017;152;0;17064;333;0;1.4;0.0;0.0
95;2021-01-27;1277;141;0;18341;474;0;1.5;0.0;0.0
95;2021-01-28;1574;65;0;19915;539;0;1.6;0.0;0.0
95;2021-01-29;1192;193;0;21107;732;0;1.7;0.1;0.0
95;2021-01-30;450;5;0;21557;737;0;1.7;0.1;0.0
95;2021-01-31;170;2;0;21727;739;0;1.7;0.1;0.0
95;2021-02-01;497;253;0;22224;992;0;1.8;0.1;0.0
95;2021-02-02;552;253;0;22776;1245;0;1.8;0.1;0.0
95;2021-02-03;597;461;0;23373;1706;0;1.9;0.1;0.0
95;2021-02-04;949;408;0;24322;2114;0;1.9;0.2;0.0
95;2021-02-05;656;370;0;24978;2484;0;2.0;0.2;0.0
95;2021-02-06;352;232;0;25330;2716;0;2.0;0.2;0.0
95;2021-02-07;126;311;0;25456;3027;0;2.0;0.2;0.0
95;2021-02-08;694;426;0;26150;3453;0;2.1;0.3;0.0
95;2021-02-09;1003;1039;0;27153;4492;0;2.2;0.4;0.0
95;2021-02-10;1143;1374;0;28296;5866;0;2.3;0.5;0.0
95;2021-02-11;1294;1269;0;29590;7135;0;2.4;0.6;0.0
95;2021-02-12;1007;1062;0;30597;8197;0;2.5;0.7;0.0
95;2021-02-13;332;328;0;30929;8525;0;2.5;0.7;0.0
95;2021-02-14;41;102;0;30970;8627;0;2.5;0.7;0.0
95;2021-02-15;365;1062;0;31335;9689;0;2.5;0.8;0.0
95;2021-02-16;502;1055;0;31837;10744;0;2.6;0.9;0.0
95;2021-02-17;589;1141;0;32426;11885;0;2.6;1.0;0.0
95;2021-02-18;728;1659;0;33154;13544;0;2.7;1.1;0.0
95;2021-02-19;770;1330;0;33924;14874;0;2.7;1.2;0.0
95;2021-02-20;286;496;0;34210;15370;0;2.7;1.2;0.0
95;2021-02-21;116;238;0;34326;15608;0;2.7;1.3;0.0
95;2021-02-22;312;944;0;34638;16552;0;2.8;1.3;0.0
95;2021-02-23;355;790;0;34993;17342;0;2.8;1.4;0.0
95;2021-02-24;358;886;0;35351;18228;0;2.8;1.5;0.0
95;2021-02-25;725;1152;0;36076;19380;0;2.9;1.6;0.0
95;2021-02-26;1080;887;0;37156;20267;0;3.0;1.6;0.0
95;2021-02-27;384;411;0;37540;20678;0;3.0;1.7;0.0
95;2021-02-28;51;171;0;37591;20849;0;3.0;1.7;0.0
95;2021-03-01;781;543;0;38372;21392;0;3.1;1.7;0.0
95;2021-03-02;1333;842;0;39705;22234;0;3.2;1.8;0.0
95;2021-03-03;1570;915;0;41275;23149;0;3.3;1.9;0.0
95;2021-03-04;3063;1179;0;44338;24328;0;3.6;1.9;0.0
95;2021-03-05;3465;1061;0;47803;25389;0;3.8;2.0;0.0
95;2021-03-06;3741;489;0;51544;25878;0;4.1;2.1;0.0
95;2021-03-07;3658;328;0;55202;26206;0;4.4;2.1;0.0
95;2021-03-08;1442;805;0;56644;27011;0;4.5;2.2;0.0
95;2021-03-09;2525;538;0;59169;27549;0;4.7;2.2;0.0
95;2021-03-10;2502;858;0;61671;28407;0;4.9;2.3;0.0
95;2021-03-11;3209;1139;0;64880;29546;0;5.2;2.4;0.0
95;2021-03-12;3688;877;0;68568;30423;0;5.5;2.4;0.0
95;2021-03-13;3411;431;0;71979;30854;0;5.8;2.5;0.0
95;2021-03-14;1616;241;0;73595;31095;0;5.9;2.5;0.0
95;2021-03-15;2280;355;0;75875;31450;0;6.1;2.5;0.0
95;2021-03-16;1657;413;0;77532;31863;0;6.2;2.6;0.0
95;2021-03-17;2076;411;0;79608;32274;0;6.4;2.6;0.0
95;2021-03-18;2591;398;0;82199;32672;0;6.6;2.6;0.0
95;2021-03-19;3393;372;0;85592;33044;0;6.9;2.6;0.0
95;2021-03-20;2657;213;0;88249;33257;0;7.1;2.7;0.0
95;2021-03-21;948;212;0;89197;33469;0;7.1;2.7;0.0
95;2021-03-22;2821;326;0;92018;33795;0;7.4;2.7;0.0
95;2021-03-23;3525;459;0;95543;34254;0;7.7;2.7;0.0
95;2021-03-24;3619;493;0;99162;34747;0;7.9;2.8;0.0
95;2021-03-25;5559;648;0;104721;35395;0;8.4;2.8;0.0
95;2021-03-26;5425;673;0;110146;36068;0;8.8;2.9;0.0
95;2021-03-27;3329;219;0;113475;36287;0;9.1;2.9;0.0
95;2021-03-28;1052;72;0;114527;36359;0;9.2;2.9;0.0
95;2021-03-29;2807;585;0;117334;36944;0;9.4;3.0;0.0
95;2021-03-30;3921;1191;0;121255;38135;0;9.7;3.1;0.0
95;2021-03-31;3806;1575;0;125061;39710;0;10.0;3.2;0.0
95;2021-04-01;4907;2202;0;129968;41912;0;10.4;3.4;0.0
95;2021-04-02;3642;2586;0;133610;44498;0;10.7;3.6;0.0
95;2021-04-03;2104;2269;0;135714;46767;0;10.9;3.7;0.0
95;2021-04-04;885;950;0;136599;47717;0;10.9;3.8;0.0
95;2021-04-05;687;88;0;137286;47805;0;11.0;3.8;0.0
95;2021-04-06;2309;1463;0;139595;49268;0;11.2;3.9;0.0
95;2021-04-07;4448;1982;0;144043;51250;0;11.5;4.1;0.0
95;2021-04-08;4968;2272;0;149011;53522;0;11.9;4.3;0.0
95;2021-04-09;5761;2193;0;154772;55715;0;12.4;4.5;0.0
95;2021-04-10;3697;1412;0;158469;57127;0;12.7;4.6;0.0
95;2021-04-11;1137;800;0;159606;57927;0;12.8;4.6;0.0
95;2021-04-12;3084;1610;0;162690;59537;0;13.0;4.8;0.0
95;2021-04-13;3371;1863;0;166061;61400;0;13.3;4.9;0.0
95;2021-04-14;3175;2007;0;169236;63407;0;13.6;5.1;0.0
95;2021-04-15;4142;2949;0;173378;66356;0;13.9;5.3;0.0
95;2021-04-16;4338;2825;0;177716;69181;0;14.2;5.5;0.0
95;2021-04-17;2487;1785;0;180203;70966;0;14.4;5.7;0.0
95;2021-04-18;1056;745;0;181259;71711;0;14.5;5.7;0.0
95;2021-04-19;2542;2193;0;183801;73904;0;14.7;5.9;0.0
95;2021-04-20;2511;2398;0;186312;76302;0;14.9;6.1;0.0
95;2021-04-21;3970;2524;0;190282;78826;0;15.2;6.3;0.0
95;2021-04-22;3556;4071;0;193838;82897;0;15.5;6.6;0.0
95;2021-04-23;3274;3384;0;197112;86281;0;15.8;6.9;0.0
95;2021-04-24;3620;2371;0;200732;88652;0;16.1;7.1;0.0
95;2021-04-25;1860;1034;0;202592;89686;0;16.2;7.2;0.0
95;2021-04-26;3036;2488;0;205628;92174;0;16.5;7.4;0.0
95;2021-04-27;4177;2333;0;209805;94507;0;16.8;7.6;0.0
95;2021-04-28;4212;2825;0;214017;97332;0;17.1;7.8;0.0
95;2021-04-29;6086;4107;0;220103;101439;0;17.6;8.1;0.0
95;2021-04-30;6633;3065;0;226736;104504;0;18.2;8.4;0.0
95;2021-05-01;2464;894;0;229200;105398;0;18.4;8.4;0.0
95;2021-05-02;1938;948;0;231138;106346;0;18.5;8.5;0.0
95;2021-05-03;4883;2705;0;236021;109051;0;18.9;8.7;0.0
95;2021-05-04;5965;2986;0;241986;112037;0;19.4;9.0;0.0
95;2021-05-05;5210;3755;0;247196;115792;0;19.8;9.3;0.0
95;2021-05-06;7208;4531;0;254404;120323;0;20.4;9.6;0.0
95;2021-05-07;5617;4661;0;260021;124984;0;20.8;10.0;0.0
95;2021-05-08;4995;1725;0;265016;126709;0;21.2;10.2;0.0
95;2021-05-09;2577;1415;0;267593;128124;0;21.4;10.3;0.0
95;2021-05-10;8022;3049;0;275615;131173;0;22.1;10.5;0.0
95;2021-05-11;7461;3559;0;283076;134732;0;22.7;10.8;0.0
95;2021-05-12;8289;3249;0;291365;137981;0;23.3;11.1;0.0
95;2021-05-13;6410;1153;0;297775;139134;0;23.9;11.1;0.0
95;2021-05-14;6630;2060;0;304405;141194;0;24.4;11.3;0.0
95;2021-05-15;4654;1243;0;309059;142437;0;24.8;11.4;0.0
95;2021-05-16;3899;743;0;312958;143180;0;25.1;11.5;0.0
95;2021-05-17;6264;1379;0;319222;144559;0;25.6;11.6;0.0
95;2021-05-18;8074;1779;0;327296;146338;0;26.2;11.7;0.0
95;2021-05-19;8312;2662;0;335608;149000;0;26.9;11.9;0.0
95;2021-05-20;10186;2475;0;345794;151475;0;27.7;12.1;0.0
95;2021-05-21;9038;2513;0;354832;153988;0;28.4;12.3;0.0
95;2021-05-22;7833;1513;0;362665;155501;0;29.1;12.5;0.0
95;2021-05-23;3563;868;0;366228;156369;0;29.3;12.5;0.0
95;2021-05-24;2980;604;0;369208;156973;0;29.6;12.6;0.0
95;2021-05-25;6725;2339;0;375933;159312;0;30.1;12.8;0.0
95;2021-05-26;7791;3051;0;383724;162363;0;30.7;13.0;0.0
95;2021-05-27;8834;4363;0;392558;166726;0;31.4;13.4;0.0
95;2021-05-28;6967;4528;0;399525;171254;0;32.0;13.7;0.0
95;2021-05-29;4943;2895;0;404468;174149;0;32.4;14.0;0.0
95;2021-05-30;2945;1296;0;407413;175445;0;32.6;14.1;0.0
95;2021-05-31;5232;3366;0;412645;178811;0;33.1;14.3;0.0
95;2021-06-01;7420;4114;0;420065;182925;0;33.6;14.7;0.0
95;2021-06-02;7383;4478;0;427448;187403;0;34.2;15.0;0.0
95;2021-06-03;7280;6028;0;434728;193431;0;34.8;15.5;0.0
95;2021-06-04;7655;4759;0;442383;198190;0;35.4;15.9;0.0
95;2021-06-05;6573;3895;0;448956;202085;0;36.0;16.2;0.0
95;2021-06-06;3241;1411;0;452197;203496;0;36.2;16.3;0.0
95;2021-06-07;5106;4636;0;457303;208132;0;36.6;16.7;0.0
95;2021-06-08;5887;5524;0;463190;213656;0;37.1;17.1;0.0
95;2021-06-09;5829;6268;0;469019;219924;0;37.6;17.6;0.0
95;2021-06-10;5995;7250;0;475014;227174;0;38.1;18.2;0.0
95;2021-06-11;6128;6427;0;481142;233601;0;38.5;18.7;0.0
95;2021-06-12;5201;4201;0;486343;237802;0;39.0;19.0;0.0
95;2021-06-13;1827;2763;0;488170;240565;0;39.1;19.3;0.0
95;2021-06-14;4016;5852;0;492186;246417;0;39.4;19.7;0.0
95;2021-06-15;4240;7678;0;496426;254095;0;39.8;20.4;0.0
95;2021-06-16;4989;7254;0;501415;261349;0;40.2;20.9;0.0
95;2021-06-17;5714;7697;0;507129;269046;0;40.6;21.6;0.0
95;2021-06-18;5152;7727;0;512281;276773;0;41.0;22.2;0.0
95;2021-06-19;4332;7758;0;516613;284531;0;41.4;22.8;0.0
95;2021-06-20;1239;2985;0;517852;287516;0;41.5;23.0;0.0
95;2021-06-21;2967;7068;0;520819;294584;0;41.7;23.6;0.0
95;2021-06-22;4209;8443;0;525028;303027;0;42.1;24.3;0.0
95;2021-06-23;4140;9899;0;529168;312926;0;42.4;25.1;0.0
95;2021-06-24;4275;9445;0;533443;322371;0;42.7;25.8;0.0
95;2021-06-25;4296;9679;0;537739;332050;0;43.1;26.6;0.0
95;2021-06-26;3630;7833;0;541369;339883;0;43.4;27.2;0.0
95;2021-06-27;836;3437;0;542205;343320;0;43.4;27.5;0.0
95;2021-06-28;2408;8101;0;544613;351421;0;43.6;28.2;0.0
95;2021-06-29;2466;8124;0;547079;359545;0;43.8;28.8;0.0
95;2021-06-30;3655;9392;0;550734;368937;0;44.1;29.6;0.0
95;2021-07-01;4297;9991;0;555031;378928;0;44.5;30.4;0.0
95;2021-07-02;4214;9655;0;559245;388583;0;44.8;31.1;0.0
95;2021-07-03;3308;8292;0;562553;396875;0;45.1;31.8;0.0
95;2021-07-04;1045;3068;0;563598;399943;0;45.1;32.0;0.0
95;2021-07-05;2700;4945;0;566298;404888;0;45.4;32.4;0.0
95;2021-07-06;2940;7576;0;569238;412464;0;45.6;33.0;0.0
95;2021-07-07;3989;9016;0;573227;421480;0;45.9;33.8;0.0
95;2021-07-08;4809;9211;0;578036;430691;0;46.3;34.5;0.0
95;2021-07-09;4707;9650;0;582743;440341;0;46.7;35.3;0.0
95;2021-07-10;3458;7000;0;586201;447341;0;47.0;35.8;0.0
95;2021-07-11;1303;2950;0;587504;450291;0;47.1;36.1;0.0
95;2021-07-12;3243;8635;0;590747;458926;0;47.3;36.8;0.0
95;2021-07-13;6033;9777;0;596780;468703;0;47.8;37.5;0.0
95;2021-07-14;4989;5346;0;601769;474049;0;48.2;38.0;0.0
95;2021-07-15;7670;11321;0;609439;485370;0;48.8;38.9;0.0
95;2021-07-16;8565;11132;0;618004;496502;0;49.5;39.8;0.0
95;2021-07-17;5535;7465;0;623539;503967;0;49.9;40.4;0.0
95;2021-07-18;3308;2591;0;626847;506558;0;50.2;40.6;0.0
95;2021-07-19;5446;6556;0;632293;513114;0;50.7;41.1;0.0
95;2021-07-20;7051;8098;0;639344;521212;0;51.2;41.8;0.0
95;2021-07-21;9208;8878;0;648552;530090;0;52.0;42.5;0.0
95;2021-07-22;10003;9187;0;658555;539277;0;52.8;43.2;0.0
95;2021-07-23;10516;9645;0;669071;548922;0;53.6;44.0;0.0
95;2021-07-24;5627;6222;0;674698;555144;0;54.0;44.5;0.0
95;2021-07-25;2594;2250;0;677292;557394;0;54.3;44.7;0.0
95;2021-07-26;5480;4754;0;682772;562148;0;54.7;45.0;0.0
95;2021-07-27;8617;6952;0;691389;569100;0;55.4;45.6;0.0
95;2021-07-28;9487;7280;0;700876;576380;0;56.1;46.2;0.0
95;2021-07-29;8539;5847;0;709415;582227;0;56.8;46.6;0.0
95;2021-07-30;8493;7157;0;717908;589384;0;57.5;47.2;0.0
95;2021-07-31;4513;3687;0;722421;593071;0;57.9;47.5;0.0
95;2021-08-01;2023;1318;0;724444;594389;0;58.0;47.6;0.0
95;2021-08-02;4842;3958;0;729286;598347;0;58.4;47.9;0.0
95;2021-08-03;5852;5414;0;735138;603761;0;58.9;48.4;0.0
95;2021-08-04;5951;5501;0;741089;609262;0;59.4;48.8;0.0
95;2021-08-05;5856;5156;0;746945;614418;0;59.8;49.2;0.0
95;2021-08-06;5838;6436;0;752783;620854;0;60.3;49.7;0.0
95;2021-08-07;2781;3389;0;755564;624243;0;60.5;50.0;0.0
95;2021-08-08;1180;1894;0;756744;626137;0;60.6;50.2;0.0
95;2021-08-09;4032;4978;0;760776;631115;0;60.9;50.6;0.0
95;2021-08-10;4887;5585;0;765663;636700;0;61.3;51.0;0.0
95;2021-08-11;4639;6142;0;770302;642842;0;61.7;51.5;0.0
95;2021-08-12;4443;6363;0;774745;649205;0;62.1;52.0;0.0
95;2021-08-13;3540;5244;0;778285;654449;0;62.3;52.4;0.0
95;2021-08-14;3070;3741;0;781355;658190;0;62.6;52.7;0.0
95;2021-08-15;409;570;0;781764;658760;0;62.6;52.8;0.0
95;2021-08-16;2756;6040;0;784520;664800;0;62.8;53.3;0.0
95;2021-08-17;3232;6891;0;787752;671691;0;63.1;53.8;0.0
95;2021-08-18;3643;7524;0;791395;679215;0;63.4;54.4;0.0
95;2021-08-19;3127;6277;0;794522;685492;0;63.6;54.9;0.0
95;2021-08-20;3234;7315;0;797756;692807;0;63.9;55.5;0.0
95;2021-08-21;2298;4238;0;800054;697045;0;64.1;55.8;0.0
95;2021-08-22;609;1879;0;800663;698924;0;64.1;56.0;0.0
95;2021-08-23;2322;5971;0;802985;704895;0;64.3;56.5;0.0
95;2021-08-24;2608;6337;0;805593;711232;0;64.5;57.0;0.0
95;2021-08-25;3286;7473;1;808879;718705;1;64.8;57.6;0.0
95;2021-08-26;2623;6598;0;811502;725303;1;65.0;58.1;0.0
95;2021-08-27;2965;7601;0;814467;732904;1;65.2;58.7;0.0
95;2021-08-28;2406;5012;0;816873;737916;1;65.4;59.1;0.0
95;2021-08-29;534;1379;0;817407;739295;1;65.5;59.2;0.0
95;2021-08-30;2424;5704;81;819831;744999;82;65.7;59.7;0.0
95;2021-08-31;2395;5716;206;822226;750715;288;65.9;60.1;0.0
95;2021-09-01;2850;5296;442;825076;756011;730;66.1;60.6;0.1
95;2021-09-02;1887;3919;413;826963;759930;1143;66.2;60.9;0.1
95;2021-09-03;2143;4810;472;829106;764740;1615;66.4;61.3;0.1
95;2021-09-04;2251;4746;218;831357;769486;1833;66.6;61.6;0.1
95;2021-09-05;429;700;24;831786;770186;1857;66.6;61.7;0.1
95;2021-09-06;1269;2898;406;833055;773084;2263;66.7;61.9;0.2
95;2021-09-07;1372;2899;340;834427;775983;2603;66.8;62.2;0.2
95;2021-09-08;1592;3374;362;836019;779357;2965;67.0;62.4;0.2
95;2021-09-09;1198;2794;447;837217;782151;3412;67.1;62.7;0.3
95;2021-09-10;1600;3079;496;838817;785230;3908;67.2;62.9;0.3
95;2021-09-11;1421;3232;245;840238;788462;4153;67.3;63.2;0.3
95;2021-09-12;285;552;105;840523;789014;4258;67.3;63.2;0.3
95;2021-09-13;1178;2186;441;841701;791200;4699;67.4;63.4;0.4
95;2021-09-14;1202;2138;610;842903;793338;5309;67.5;63.6;0.4
95;2021-09-15;1396;3254;771;844299;796592;6080;67.6;63.8;0.5
95;2021-09-16;883;1721;599;845182;798313;6679;67.7;63.9;0.5
95;2021-09-17;1193;2711;672;846375;801024;7351;67.8;64.2;0.6
95;2021-09-18;1186;3622;242;847561;804646;7593;67.9;64.5;0.6
95;2021-09-19;231;543;48;847792;805189;7641;67.9;64.5;0.6
95;2021-09-20;695;1399;589;848487;806588;8230;68.0;64.6;0.7
95;2021-09-21;777;1623;942;849264;808211;9172;68.0;64.7;0.7
95;2021-09-22;936;2741;625;850200;810952;9797;68.1;65.0;0.8
95;2021-09-23;770;1225;687;850970;812177;10484;68.2;65.1;0.8
95;2021-09-24;793;2004;702;851763;814181;11186;68.2;65.2;0.9
95;2021-09-25;1006;3234;337;852769;817415;11523;68.3;65.5;0.9
95;2021-09-26;115;311;31;852884;817726;11554;68.3;65.5;0.9
95;2021-09-27;618;1162;502;853502;818888;12056;68.4;65.6;1.0
95;2021-09-28;681;1271;841;854183;820159;12897;68.4;65.7;1.0
95;2021-09-29;808;1764;665;854991;821923;13562;68.5;65.8;1.1
95;2021-09-30;793;1123;841;855784;823046;14403;68.6;65.9;1.2
95;2021-10-01;1269;1392;843;857053;824438;15246;68.7;66.0;1.2
95;2021-10-02;1266;2110;573;858319;826548;15819;68.8;66.2;1.3
95;2021-10-03;140;244;30;858459;826792;15849;68.8;66.2;1.3
95;2021-10-04;616;887;490;859075;827679;16339;68.8;66.3;1.3
95;2021-10-05;726;1072;879;859801;828751;17218;68.9;66.4;1.4
95;2021-10-06;781;1279;930;860582;830030;18148;68.9;66.5;1.5
95;2021-10-07;541;861;836;861123;830891;18984;69.0;66.6;1.5
95;2021-10-08;877;1350;1170;862000;832241;20154;69.1;66.7;1.6
95;2021-10-09;922;1576;671;862922;833817;20825;69.1;66.8;1.7
95;2021-10-10;151;238;47;863073;834055;20872;69.1;66.8;1.7
95;2021-10-11;482;681;707;863555;834736;21579;69.2;66.9;1.7
95;2021-10-12;535;894;984;864090;835630;22563;69.2;66.9;1.8
95;2021-10-13;797;1133;1102;864887;836763;23665;69.3;67.0;1.9
95;2021-10-14;553;1059;1051;865440;837822;24716;69.3;67.1;2.0
95;2021-10-15;909;1066;1326;866349;838888;26042;69.4;67.2;2.1
95;2021-10-16;839;1238;875;867188;840126;26917;69.5;67.3;2.2
95;2021-10-17;100;198;123;867288;840324;27040;69.5;67.3;2.2
95;2021-10-18;435;624;518;867723;840948;27558;69.5;67.4;2.2
95;2021-10-19;530;812;1225;868253;841760;28783;69.6;67.4;2.3
95;2021-10-20;510;825;1202;868763;842585;29985;69.6;67.5;2.4
95;2021-10-21;374;664;1235;869137;843249;31220;69.6;67.5;2.5
95;2021-10-22;574;1085;1383;869711;844334;32603;69.7;67.6;2.6
95;2021-10-23;618;1105;998;870329;845439;33601;69.7;67.7;2.7
95;2021-10-24;84;148;89;870413;845587;33690;69.7;67.7;2.7
95;2021-10-25;325;490;611;870738;846077;34301;69.8;67.8;2.7
95;2021-10-26;460;643;1310;871198;846720;35611;69.8;67.8;2.9
95;2021-10-27;465;735;1555;871663;847455;37166;69.8;67.9;3.0
95;2021-10-28;405;707;1526;872068;848162;38692;69.9;67.9;3.1
95;2021-10-29;499;759;1518;872567;848921;40210;69.9;68.0;3.2
95;2021-10-30;444;787;1038;873011;849708;41248;69.9;68.1;3.3
95;2021-10-31;87;155;56;873098;849863;41304;69.9;68.1;3.3
95;2021-11-01;159;147;127;873257;850010;41431;70.0;68.1;3.3
95;2021-11-02;451;671;1172;873708;850681;42603;70.0;68.1;3.4
95;2021-11-03;422;671;1340;874130;851352;43943;70.0;68.2;3.5
95;2021-11-04;352;568;1467;874482;851920;45410;70.1;68.2;3.6
95;2021-11-05;415;725;1611;874897;852645;47021;70.1;68.3;3.8
95;2021-11-06;446;839;1166;875343;853484;48187;70.1;68.4;3.9
95;2021-11-07;70;159;115;875413;853643;48302;70.1;68.4;3.9
95;2021-11-08;212;417;1045;875625;854060;49347;70.1;68.4;4.0
95;2021-11-09;384;666;2279;876009;854726;51626;70.2;68.5;4.1
95;2021-11-10;428;707;2695;876437;855433;54321;70.2;68.5;4.4
95;2021-11-11;148;187;684;876585;855620;55005;70.2;68.5;4.4
95;2021-11-12;475;835;3016;877060;856455;58021;70.3;68.6;4.6
95;2021-11-13;425;731;1480;877485;857186;59501;70.3;68.7;4.8
95;2021-11-14;99;133;159;877584;857319;59660;70.3;68.7;4.8
95;2021-11-15;230;399;1446;877814;857718;61106;70.3;68.7;4.9
95;2021-11-16;395;600;2942;878209;858318;64048;70.3;68.8;5.1
95;2021-11-17;391;610;2655;878600;858928;66703;70.4;68.8;5.3
95;2021-11-18;339;504;2604;878939;859432;69307;70.4;68.8;5.6
95;2021-11-19;490;745;3465;879429;860177;72772;70.4;68.9;5.8
95;2021-11-20;495;709;1607;879924;860886;74379;70.5;69.0;6.0
95;2021-11-21;70;192;331;879994;861078;74710;70.5;69.0;6.0
95;2021-11-22;248;390;1809;880242;861468;76519;70.5;69.0;6.1
95;2021-11-23;400;517;3206;880642;861985;79725;70.5;69.0;6.4
95;2021-11-24;440;624;2996;881082;862609;82721;70.6;69.1;6.6
95;2021-11-25;400;480;3476;881482;863089;86197;70.6;69.1;6.9
95;2021-11-26;448;617;5950;881930;863706;92147;70.6;69.2;7.4
95;2021-11-27;396;605;4713;882326;864311;96860;70.7;69.2;7.8
95;2021-11-28;140;168;1267;882466;864479;98127;70.7;69.2;7.9
95;2021-11-29;186;312;3823;882652;864791;101950;70.7;69.3;8.2
95;2021-11-30;283;517;7850;882935;865308;109800;70.7;69.3;8.8
95;2021-12-01;361;557;8597;883296;865865;118397;70.8;69.4;9.5
95;2021-12-02;291;420;10224;883587;866285;128621;70.8;69.4;10.3
95;2021-12-03;404;592;11088;883991;866877;139709;70.8;69.4;11.2
95;2021-12-04;323;549;7725;884314;867426;147434;70.8;69.5;11.8
95;2021-12-05;111;204;3176;884425;867630;150610;70.8;69.5;12.1
95;2021-12-06;180;382;5934;884605;868012;156544;70.9;69.5;12.5
95;2021-12-07;302;512;10881;884907;868524;167425;70.9;69.6;13.4
95;2021-12-08;389;569;10356;885296;869093;177781;70.9;69.6;14.2
95;2021-12-09;327;498;11828;885623;869591;189609;70.9;69.7;15.2
95;2021-12-10;402;590;14308;886025;870181;203917;71.0;69.7;16.3
95;2021-12-11;304;560;9600;886329;870741;213517;71.0;69.8;17.1
95;2021-12-12;175;192;4678;886504;870933;218195;71.0;69.8;17.5
95;2021-12-13;260;443;7999;886764;871376;226194;71.0;69.8;18.1
95;2021-12-14;372;564;12298;887136;871940;238492;71.1;69.8;19.1
95;2021-12-15;398;569;11232;887534;872509;249724;71.1;69.9;20.0
95;2021-12-16;355;511;12614;887889;873020;262338;71.1;69.9;21.0
