dep;jour;n_dose1;n_complet;n_cum_dose1;n_cum_complet;couv_dose1;couv_complet
01;2020-12-27;1;0;1;0;0.0;0.0
01;2020-12-28;0;0;1;0;0.0;0.0
01;2020-12-29;0;0;1;0;0.0;0.0
01;2020-12-30;0;0;1;0;0.0;0.0
01;2020-12-31;0;0;1;0;0.0;0.0
01;2021-01-01;2;0;3;0;0.0;0.0
01;2021-01-02;0;0;3;0;0.0;0.0
01;2021-01-03;0;0;3;0;0.0;0.0
01;2021-01-04;2;0;5;0;0.0;0.0
01;2021-01-05;2;0;7;0;0.0;0.0
01;2021-01-06;1;0;8;0;0.0;0.0
01;2021-01-07;67;0;75;0;0.0;0.0
01;2021-01-08;159;1;234;1;0.0;0.0
01;2021-01-09;2;1;236;2;0.0;0.0
01;2021-01-10;1;0;237;2;0.0;0.0
01;2021-01-11;148;0;385;2;0.1;0.0
01;2021-01-12;318;2;703;4;0.1;0.0
01;2021-01-13;445;1;1148;5;0.2;0.0
01;2021-01-14;530;3;1678;8;0.3;0.0
01;2021-01-15;398;4;2076;12;0.3;0.0
01;2021-01-16;202;0;2278;12;0.3;0.0
01;2021-01-17;128;0;2406;12;0.4;0.0
01;2021-01-18;380;3;2786;15;0.4;0.0
01;2021-01-19;1041;2;3827;17;0.6;0.0
01;2021-01-20;1262;4;5089;21;0.8;0.0
01;2021-01-21;1101;6;6190;27;0.9;0.0
01;2021-01-22;650;4;6840;31;1.0;0.0
01;2021-01-23;223;0;7063;31;1.1;0.0
01;2021-01-24;70;1;7133;32;1.1;0.0
01;2021-01-25;485;1;7618;33;1.2;0.0
01;2021-01-26;745;5;8363;38;1.3;0.0
01;2021-01-27;518;7;8881;45;1.4;0.0
01;2021-01-28;682;57;9563;102;1.5;0.0
01;2021-01-29;640;102;10203;204;1.6;0.0
01;2021-01-30;237;15;10440;219;1.6;0.0
01;2021-01-31;62;0;10502;219;1.6;0.0
01;2021-02-01;459;73;10961;292;1.7;0.0
01;2021-02-02;519;185;11480;477;1.7;0.1
01;2021-02-03;376;300;11856;777;1.8;0.1
01;2021-02-04;480;417;12336;1194;1.9;0.2
01;2021-02-05;444;281;12780;1475;1.9;0.2
01;2021-02-06;264;143;13044;1618;2.0;0.2
01;2021-02-07;2;111;13046;1729;2.0;0.3
01;2021-02-08;506;404;13552;2133;2.1;0.3
01;2021-02-09;776;857;14328;2990;2.2;0.5
01;2021-02-10;957;720;15285;3710;2.3;0.6
01;2021-02-11;795;774;16080;4484;2.4;0.7
01;2021-02-12;640;552;16720;5036;2.5;0.8
01;2021-02-13;161;151;16881;5187;2.6;0.8
01;2021-02-14;2;9;16883;5196;2.6;0.8
01;2021-02-15;437;445;17320;5641;2.6;0.9
01;2021-02-16;659;422;17979;6063;2.7;0.9
01;2021-02-17;524;251;18503;6314;2.8;1.0
01;2021-02-18;592;570;19095;6884;2.9;1.0
01;2021-02-19;580;249;19675;7133;3.0;1.1
01;2021-02-20;201;154;19876;7287;3.0;1.1
01;2021-02-21;1;1;19877;7288;3.0;1.1
01;2021-02-22;429;557;20306;7845;3.1;1.2
01;2021-02-23;483;523;20789;8368;3.2;1.3
01;2021-02-24;435;462;21224;8830;3.2;1.3
01;2021-02-25;827;610;22051;9440;3.4;1.4
01;2021-02-26;874;545;22925;9985;3.5;1.5
01;2021-02-27;480;118;23405;10103;3.6;1.5
01;2021-02-28;20;3;23425;10106;3.6;1.5
01;2021-03-01;636;460;24061;10566;3.7;1.6
01;2021-03-02;964;561;25025;11127;3.8;1.7
01;2021-03-03;945;669;25970;11796;4.0;1.8
01;2021-03-04;1198;646;27168;12442;4.1;1.9
01;2021-03-05;1357;501;28525;12943;4.3;2.0
01;2021-03-06;781;102;29306;13045;4.5;2.0
01;2021-03-07;44;1;29350;13046;4.5;2.0
01;2021-03-08;670;627;30020;13673;4.6;2.1
01;2021-03-09;1341;617;31361;14290;4.8;2.2
01;2021-03-10;1163;560;32524;14850;5.0;2.3
01;2021-03-11;1686;645;34210;15495;5.2;2.4
01;2021-03-12;2006;648;36216;16143;5.5;2.5
01;2021-03-13;1502;102;37718;16245;5.7;2.5
01;2021-03-14;134;59;37852;16304;5.8;2.5
01;2021-03-15;1154;407;39006;16711;5.9;2.5
01;2021-03-16;1014;566;40020;17277;6.1;2.6
01;2021-03-17;839;347;40859;17624;6.2;2.7
01;2021-03-18;1295;475;42154;18099;6.4;2.8
01;2021-03-19;1750;548;43904;18647;6.7;2.8
01;2021-03-20;1447;137;45351;18784;6.9;2.9
01;2021-03-21;99;11;45450;18795;6.9;2.9
01;2021-03-22;1576;493;47026;19288;7.2;2.9
01;2021-03-23;2197;655;49223;19943;7.5;3.0
01;2021-03-24;1616;421;50839;20364;7.7;3.1
01;2021-03-25;2911;636;53750;21000;8.2;3.2
01;2021-03-26;2871;617;56621;21617;8.6;3.3
01;2021-03-27;1311;164;57932;21781;8.8;3.3
01;2021-03-28;22;1;57954;21782;8.8;3.3
01;2021-03-29;1930;548;59884;22330;9.1;3.4
01;2021-03-30;2515;779;62399;23109;9.5;3.5
01;2021-03-31;1869;630;64268;23739;9.8;3.6
01;2021-04-01;2569;860;66837;24599;10.2;3.7
01;2021-04-02;2818;733;69655;25332;10.6;3.9
01;2021-04-03;1256;137;70911;25469;10.8;3.9
01;2021-04-04;3;1;70914;25470;10.8;3.9
01;2021-04-05;1261;67;72175;25537;11.0;3.9
01;2021-04-06;2824;801;74999;26338;11.4;4.0
01;2021-04-07;2741;710;77740;27048;11.8;4.1
01;2021-04-08;3245;1007;80985;28055;12.3;4.3
01;2021-04-09;3983;1336;84968;29391;12.9;4.5
01;2021-04-10;1823;305;86791;29696;13.2;4.5
01;2021-04-11;44;22;86835;29718;13.2;4.5
01;2021-04-12;2716;1229;89551;30947;13.6;4.7
01;2021-04-13;2944;1331;92495;32278;14.1;4.9
01;2021-04-14;3126;1083;95621;33361;14.6;5.1
01;2021-04-15;3075;1484;98696;34845;15.0;5.3
01;2021-04-16;2861;1585;101557;36430;15.5;5.5
01;2021-04-17;1654;682;103211;37112;15.7;5.6
01;2021-04-18;13;0;103224;37112;15.7;5.6
01;2021-04-19;2039;1524;105263;38636;16.0;5.9
01;2021-04-20;2668;1574;107931;40210;16.4;6.1
01;2021-04-21;2690;1352;110621;41562;16.8;6.3
01;2021-04-22;2835;1531;113456;43093;17.3;6.6
01;2021-04-23;2765;1535;116221;44628;17.7;6.8
01;2021-04-24;1448;656;117669;45284;17.9;6.9
01;2021-04-25;9;0;117678;45284;17.9;6.9
01;2021-04-26;1970;1730;119648;47014;18.2;7.2
01;2021-04-27;2572;1559;122220;48573;18.6;7.4
01;2021-04-28;2500;1577;124720;50150;19.0;7.6
01;2021-04-29;2716;1775;127436;51925;19.4;7.9
01;2021-04-30;2982;2252;130418;54177;19.9;8.2
01;2021-05-01;1473;859;131891;55036;20.1;8.4
01;2021-05-02;545;76;132436;55112;20.2;8.4
01;2021-05-03;2296;2482;134732;57594;20.5;8.8
01;2021-05-04;2539;2643;137271;60237;20.9;9.2
01;2021-05-05;2527;2503;139798;62740;21.3;9.6
01;2021-05-06;2995;2530;142793;65270;21.7;9.9
01;2021-05-07;3215;2779;146008;68049;22.2;10.4
01;2021-05-08;1645;922;147653;68971;22.5;10.5
01;2021-05-09;1022;162;148675;69133;22.6;10.5
01;2021-05-10;2500;3071;151175;72204;23.0;11.0
01;2021-05-11;3581;3066;154756;75270;23.6;11.5
01;2021-05-12;3652;3004;158408;78274;24.1;11.9
01;2021-05-13;4088;1503;162496;79777;24.7;12.1
01;2021-05-14;4272;2347;166768;82124;25.4;12.5
01;2021-05-15;3159;1435;169927;83559;25.9;12.7
01;2021-05-16;1413;150;171340;83709;26.1;12.7
01;2021-05-17;3445;2469;174785;86178;26.6;13.1
01;2021-05-18;4075;1959;178860;88137;27.2;13.4
01;2021-05-19;3974;1904;182834;90041;27.8;13.7
01;2021-05-20;4526;2017;187360;92058;28.5;14.0
01;2021-05-21;4621;2198;191981;94256;29.2;14.3
01;2021-05-22;3368;955;195349;95211;29.7;14.5
01;2021-05-23;834;84;196183;95295;29.9;14.5
01;2021-05-24;2765;500;198948;95795;30.3;14.6
01;2021-05-25;3559;2429;202507;98224;30.8;15.0
01;2021-05-26;3569;2252;206076;100476;31.4;15.3
01;2021-05-27;3853;2097;209929;102573;32.0;15.6
01;2021-05-28;3664;2638;213593;105211;32.5;16.0
01;2021-05-29;3055;1305;216648;106516;33.0;16.2
01;2021-05-30;613;88;217261;106604;33.1;16.2
01;2021-05-31;2407;2521;219668;109125;33.4;16.6
01;2021-06-01;2771;2590;222439;111715;33.9;17.0
01;2021-06-02;2883;2203;225322;113918;34.3;17.3
01;2021-06-03;3366;2441;228688;116359;34.8;17.7
01;2021-06-04;4501;3373;233189;119732;35.5;18.2
01;2021-06-05;3252;1732;236441;121464;36.0;18.5
01;2021-06-06;670;78;237111;121542;36.1;18.5
01;2021-06-07;3389;2875;240500;124417;36.6;18.9
01;2021-06-08;3649;2719;244149;127136;37.2;19.4
01;2021-06-09;2948;2637;247097;129773;37.6;19.8
01;2021-06-10;2767;2043;249864;131816;38.0;20.1
01;2021-06-11;3072;3368;252936;135184;38.5;20.6
01;2021-06-12;2402;2197;255338;137381;38.9;20.9
01;2021-06-13;201;479;255539;137860;38.9;21.0
01;2021-06-14;2119;3162;257658;141022;39.2;21.5
01;2021-06-15;2005;3368;259663;144390;39.5;22.0
01;2021-06-16;2175;3287;261838;147677;39.9;22.5
01;2021-06-17;1959;3174;263797;150851;40.2;23.0
01;2021-06-18;2635;4163;266432;155014;40.6;23.6
01;2021-06-19;1727;2556;268159;157570;40.8;24.0
01;2021-06-20;159;498;268318;158068;40.8;24.1
01;2021-06-21;1798;3703;270116;161771;41.1;24.6
01;2021-06-22;1552;4002;271668;165773;41.4;25.2
01;2021-06-23;1583;3754;273251;169527;41.6;25.8
01;2021-06-24;1471;3565;274722;173092;41.8;26.3
01;2021-06-25;1889;4566;276611;177658;42.1;27.0
01;2021-06-26;1209;2946;277820;180604;42.3;27.5
01;2021-06-27;171;339;277991;180943;42.3;27.5
01;2021-06-28;1382;4024;279373;184967;42.5;28.2
01;2021-06-29;1409;3853;280782;188820;42.7;28.7
01;2021-06-30;1381;4157;282163;192977;43.0;29.4
01;2021-07-01;1431;4088;283594;197065;43.2;30.0
01;2021-07-02;1587;4987;285181;202052;43.4;30.8
01;2021-07-03;858;3374;286039;205426;43.5;31.3
01;2021-07-04;105;499;286144;205925;43.6;31.3
01;2021-07-05;1486;4082;287630;210007;43.8;32.0
01;2021-07-06;1105;4275;288735;214282;44.0;32.6
01;2021-07-07;1757;3697;290492;217979;44.2;33.2
01;2021-07-08;1474;3677;291966;221656;44.4;33.7
01;2021-07-09;1885;4364;293851;226020;44.7;34.4
01;2021-07-10;1119;3438;294970;229458;44.9;34.9
01;2021-07-11;105;418;295075;229876;44.9;35.0
01;2021-07-12;1422;3844;296497;233720;45.1;35.6
01;2021-07-13;2059;4116;298556;237836;45.4;36.2
01;2021-07-14;148;179;298704;238015;45.5;36.2
01;2021-07-15;3104;4191;301808;242206;45.9;36.9
01;2021-07-16;3745;4838;305553;247044;46.5;37.6
01;2021-07-17;2203;3044;307756;250088;46.8;38.1
01;2021-07-18;290;551;308046;250639;46.9;38.2
01;2021-07-19;2915;3871;310961;254510;47.3;38.7
01;2021-07-20;3297;3694;314258;258204;47.8;39.3
01;2021-07-21;3935;3566;318193;261770;48.4;39.8
01;2021-07-22;4219;3496;322412;265266;49.1;40.4
01;2021-07-23;3941;4221;326353;269487;49.7;41.0
01;2021-07-24;2731;2713;329084;272200;50.1;41.4
01;2021-07-25;61;60;329145;272260;50.1;41.4
01;2021-07-26;3346;3240;332491;275500;50.6;41.9
01;2021-07-27;4105;2791;336596;278291;51.2;42.4
01;2021-07-28;3989;2652;340585;280943;51.8;42.8
01;2021-07-29;4696;2438;345281;283381;52.6;43.1
01;2021-07-30;4458;3431;349739;286812;53.2;43.7
01;2021-07-31;3641;1773;353380;288585;53.8;43.9
01;2021-08-01;397;76;353777;288661;53.9;43.9
01;2021-08-02;3078;2455;356855;291116;54.3;44.3
01;2021-08-03;3069;2456;359924;293572;54.8;44.7
01;2021-08-04;2543;1737;362467;295309;55.2;45.0
01;2021-08-05;2247;2364;364714;297673;55.5;45.3
01;2021-08-06;2750;3114;367464;300787;55.9;45.8
01;2021-08-07;2071;1837;369535;302624;56.2;46.1
01;2021-08-08;248;258;369783;302882;56.3;46.1
01;2021-08-09;1136;2633;370919;305515;56.5;46.5
01;2021-08-10;1445;2412;372364;307927;56.7;46.9
01;2021-08-11;1472;2596;373836;310523;56.9;47.3
01;2021-08-12;1626;2828;375462;313351;57.2;47.7
01;2021-08-13;1814;2728;377276;316079;57.4;48.1
01;2021-08-14;1392;2233;378668;318312;57.6;48.5
01;2021-08-15;18;21;378686;318333;57.6;48.5
01;2021-08-16;983;3012;379669;321345;57.8;48.9
01;2021-08-17;1355;2761;381024;324106;58.0;49.3
01;2021-08-18;1257;2907;382281;327013;58.2;49.8
01;2021-08-19;1301;2425;383582;329438;58.4;50.1
01;2021-08-20;1458;3951;385040;333389;58.6;50.7
01;2021-08-21;883;2848;385923;336237;58.7;51.2
01;2021-08-22;19;20;385942;336257;58.7;51.2
01;2021-08-23;1115;3019;387057;339276;58.9;51.6
01;2021-08-24;1229;3153;388286;342429;59.1;52.1
01;2021-08-25;1124;2993;389410;345422;59.3;52.6
01;2021-08-26;1649;2740;391059;348162;59.5;53.0
01;2021-08-27;1642;3652;392701;351814;59.8;53.6
01;2021-08-28;1045;2591;393746;354405;59.9;53.9
01;2021-08-29;16;31;393762;354436;59.9;54.0
01;2021-08-30;1187;2708;394949;357144;60.1;54.4
01;2021-08-31;1092;1895;396041;359039;60.3;54.7
01;2021-09-01;922;1697;396963;360736;60.4;54.9
01;2021-09-02;805;1523;397768;362259;60.5;55.1
01;2021-09-03;1130;2196;398898;364455;60.7;55.5
01;2021-09-04;796;1898;399694;366353;60.8;55.8
01;2021-09-05;97;60;399791;366413;60.9;55.8
01;2021-09-06;651;1093;400442;367506;61.0;55.9
01;2021-09-07;578;1019;401020;368525;61.0;56.1
01;2021-09-08;815;1390;401835;369915;61.2;56.3
01;2021-09-09;769;1130;402604;371045;61.3;56.5
01;2021-09-10;1046;1558;403650;372603;61.4;56.7
01;2021-09-11;736;1432;404386;374035;61.6;56.9
01;2021-09-12;25;38;404411;374073;61.6;56.9
01;2021-09-13;575;998;404986;375071;61.6;57.1
01;2021-09-14;618;992;405604;376063;61.7;57.2
01;2021-09-15;723;1447;406327;377510;61.9;57.5
01;2021-09-16;491;922;406818;378432;61.9;57.6
01;2021-09-17;756;1392;407574;379824;62.0;57.8
01;2021-09-18;377;1205;407951;381029;62.1;58.0
01;2021-09-19;9;10;407960;381039;62.1;58.0
01;2021-09-20;373;635;408333;381674;62.2;58.1
01;2021-09-21;383;701;408716;382375;62.2;58.2
01;2021-09-22;347;899;409063;383274;62.3;58.3
01;2021-09-23;295;658;409358;383932;62.3;58.4
01;2021-09-24;402;944;409760;384876;62.4;58.6
01;2021-09-25;307;955;410067;385831;62.4;58.7
01;2021-09-26;2;24;410069;385855;62.4;58.7
01;2021-09-27;174;557;410243;386412;62.4;58.8
01;2021-09-28;310;1194;410553;387606;62.5;59.0
01;2021-09-29;464;1281;411017;388887;62.6;59.2
01;2021-09-30;347;831;411364;389718;62.6;59.3
01;2021-10-01;464;1076;411828;390794;62.7;59.5
01;2021-10-02;396;1307;412224;392101;62.7;59.7
01;2021-10-03;0;0;412224;392101;62.7;59.7
01;2021-10-04;195;512;412419;392613;62.8;59.8
01;2021-10-05;205;535;412624;393148;62.8;59.8
01;2021-10-06;338;743;412962;393891;62.9;60.0
01;2021-10-07;199;490;413161;394381;62.9;60.0
01;2021-10-08;334;719;413495;395100;62.9;60.1
01;2021-10-09;346;695;413841;395795;63.0;60.2
01;2021-10-10;8;18;413849;395813;63.0;60.2
01;2021-10-11;176;401;414025;396214;63.0;60.3
02;2020-12-27;0;0;0;0;0.0;0.0
02;2020-12-28;0;0;0;0;0.0;0.0
02;2020-12-29;0;0;0;0;0.0;0.0
02;2020-12-30;0;0;0;0;0.0;0.0
02;2020-12-31;0;0;0;0;0.0;0.0
02;2021-01-01;0;0;0;0;0.0;0.0
02;2021-01-02;0;0;0;0;0.0;0.0
02;2021-01-03;0;0;0;0;0.0;0.0
02;2021-01-04;0;0;0;0;0.0;0.0
02;2021-01-05;0;0;0;0;0.0;0.0
02;2021-01-06;22;0;22;0;0.0;0.0
02;2021-01-07;261;1;283;1;0.1;0.0
02;2021-01-08;489;3;772;4;0.1;0.0
02;2021-01-09;75;0;847;4;0.2;0.0
02;2021-01-10;49;0;896;4;0.2;0.0
02;2021-01-11;267;0;1163;4;0.2;0.0
02;2021-01-12;354;1;1517;5;0.3;0.0
02;2021-01-13;469;4;1986;9;0.4;0.0
02;2021-01-14;652;11;2638;20;0.5;0.0
02;2021-01-15;630;8;3268;28;0.6;0.0
02;2021-01-16;333;5;3601;33;0.7;0.0
02;2021-01-17;62;0;3663;33;0.7;0.0
02;2021-01-18;811;10;4474;43;0.9;0.0
02;2021-01-19;941;7;5415;50;1.0;0.0
02;2021-01-20;1431;5;6846;55;1.3;0.0
02;2021-01-21;2605;13;9451;68;1.8;0.0
02;2021-01-22;1420;5;10871;73;2.1;0.0
02;2021-01-23;290;2;11161;75;2.1;0.0
02;2021-01-24;67;0;11228;75;2.1;0.0
02;2021-01-25;432;10;11660;85;2.2;0.0
02;2021-01-26;704;17;12364;102;2.4;0.0
02;2021-01-27;162;3;12526;105;2.4;0.0
02;2021-01-28;69;246;12595;351;2.4;0.1
02;2021-01-29;119;418;12714;769;2.4;0.1
02;2021-01-30;4;14;12718;783;2.4;0.1
02;2021-01-31;0;10;12718;793;2.4;0.2
02;2021-02-01;11;211;12729;1004;2.4;0.2
02;2021-02-02;45;329;12774;1333;2.4;0.3
02;2021-02-03;124;338;12898;1671;2.5;0.3
02;2021-02-04;226;357;13124;2028;2.5;0.4
02;2021-02-05;179;413;13303;2441;2.5;0.5
02;2021-02-06;69;176;13372;2617;2.5;0.5
02;2021-02-07;9;0;13381;2617;2.5;0.5
02;2021-02-08;306;433;13687;3050;2.6;0.6
02;2021-02-09;322;680;14009;3730;2.7;0.7
02;2021-02-10;485;1042;14494;4772;2.8;0.9
02;2021-02-11;937;1860;15431;6632;2.9;1.3
02;2021-02-12;885;1119;16316;7751;3.1;1.5
02;2021-02-13;290;129;16606;7880;3.2;1.5
02;2021-02-14;1;5;16607;7885;3.2;1.5
02;2021-02-15;344;681;16951;8566;3.2;1.6
02;2021-02-16;414;561;17365;9127;3.3;1.7
02;2021-02-17;499;631;17864;9758;3.4;1.9
02;2021-02-18;507;446;18371;10204;3.5;1.9
02;2021-02-19;444;569;18815;10773;3.6;2.0
02;2021-02-20;372;234;19187;11007;3.6;2.1
02;2021-02-21;39;17;19226;11024;3.7;2.1
02;2021-02-22;377;317;19603;11341;3.7;2.2
02;2021-02-23;432;362;20035;11703;3.8;2.2
02;2021-02-24;600;146;20635;11849;3.9;2.3
02;2021-02-25;870;137;21505;11986;4.1;2.3
02;2021-02-26;808;76;22313;12062;4.2;2.3
02;2021-02-27;444;16;22757;12078;4.3;2.3
02;2021-02-28;55;2;22812;12080;4.3;2.3
02;2021-03-01;638;26;23450;12106;4.5;2.3
02;2021-03-02;1031;130;24481;12236;4.7;2.3
02;2021-03-03;754;204;25235;12440;4.8;2.4
02;2021-03-04;1161;658;26396;13098;5.0;2.5
02;2021-03-05;1049;510;27445;13608;5.2;2.6
02;2021-03-06;2141;102;29586;13710;5.6;2.6
02;2021-03-07;1504;55;31090;13765;5.9;2.6
02;2021-03-08;574;371;31664;14136;6.0;2.7
02;2021-03-09;997;406;32661;14542;6.2;2.8
02;2021-03-10;895;476;33556;15018;6.4;2.9
02;2021-03-11;1294;392;34850;15410;6.6;2.9
02;2021-03-12;1706;419;36556;15829;6.9;3.0
02;2021-03-13;2592;250;39148;16079;7.4;3.1
02;2021-03-14;1458;45;40606;16124;7.7;3.1
02;2021-03-15;612;457;41218;16581;7.8;3.2
02;2021-03-16;862;407;42080;16988;8.0;3.2
02;2021-03-17;759;456;42839;17444;8.1;3.3
02;2021-03-18;610;624;43449;18068;8.3;3.4
02;2021-03-19;1171;304;44620;18372;8.5;3.5
02;2021-03-20;2429;163;47049;18535;8.9;3.5
02;2021-03-21;1488;84;48537;18619;9.2;3.5
02;2021-03-22;762;497;49299;19116;9.4;3.6
02;2021-03-23;1195;552;50494;19668;9.6;3.7
02;2021-03-24;1582;506;52076;20174;9.9;3.8
02;2021-03-25;1693;599;53769;20773;10.2;3.9
02;2021-03-26;2412;498;56181;21271;10.7;4.0
02;2021-03-27;2494;141;58675;21412;11.2;4.1
02;2021-03-28;638;15;59313;21427;11.3;4.1
02;2021-03-29;1038;861;60351;22288;11.5;4.2
02;2021-03-30;1553;846;61904;23134;11.8;4.4
02;2021-03-31;1298;717;63202;23851;12.0;4.5
02;2021-04-01;1290;865;64492;24716;12.3;4.7
02;2021-04-02;1183;1231;65675;25947;12.5;4.9
02;2021-04-03;2644;853;68319;26800;13.0;5.1
02;2021-04-04;727;240;69046;27040;13.1;5.1
02;2021-04-05;1509;134;70555;27174;13.4;5.2
02;2021-04-06;1539;859;72094;28033;13.7;5.3
02;2021-04-07;1872;780;73966;28813;14.1;5.5
02;2021-04-08;1919;1111;75885;29924;14.4;5.7
02;2021-04-09;2432;1099;78317;31023;14.9;5.9
02;2021-04-10;2430;1214;80747;32237;15.3;6.1
02;2021-04-11;475;418;81222;32655;15.4;6.2
02;2021-04-12;1823;635;83045;33290;15.8;6.3
02;2021-04-13;1601;928;84646;34218;16.1;6.5
02;2021-04-14;2583;979;87229;35197;16.6;6.7
02;2021-04-15;2494;781;89723;35978;17.1;6.8
02;2021-04-16;2439;1132;92162;37110;17.5;7.1
02;2021-04-17;1890;2148;94052;39258;17.9;7.5
02;2021-04-18;270;814;94322;40072;17.9;7.6
02;2021-04-19;1158;636;95480;40708;18.2;7.7
02;2021-04-20;1674;767;97154;41475;18.5;7.9
02;2021-04-21;1550;996;98704;42471;18.8;8.1
02;2021-04-22;1748;708;100452;43179;19.1;8.2
02;2021-04-23;1930;1417;102382;44596;19.5;8.5
02;2021-04-24;1714;1646;104096;46242;19.8;8.8
02;2021-04-25;462;235;104558;46477;19.9;8.8
02;2021-04-26;1339;564;105897;47041;20.1;8.9
02;2021-04-27;1627;1098;107524;48139;20.4;9.2
02;2021-04-28;1592;1440;109116;49579;20.7;9.4
02;2021-04-29;1889;1183;111005;50762;21.1;9.6
02;2021-04-30;2716;1661;113721;52423;21.6;10.0
02;2021-05-01;1991;1235;115712;53658;22.0;10.2
02;2021-05-02;1982;423;117694;54081;22.4;10.3
02;2021-05-03;2224;987;119918;55068;22.8;10.5
02;2021-05-04;1522;1317;121440;56385;23.1;10.7
02;2021-05-05;2327;1843;123767;58228;23.5;11.1
02;2021-05-06;2122;1740;125889;59968;23.9;11.4
02;2021-05-07;2357;2184;128246;62152;24.4;11.8
02;2021-05-08;2917;951;131163;63103;24.9;12.0
02;2021-05-09;1823;424;132986;63527;25.3;12.1
02;2021-05-10;2375;1485;135361;65012;25.7;12.4
02;2021-05-11;2878;1579;138239;66591;26.3;12.7
02;2021-05-12;2675;1628;140914;68219;26.8;13.0
02;2021-05-13;2990;1039;143904;69258;27.4;13.2
02;2021-05-14;3381;1209;147285;70467;28.0;13.4
02;2021-05-15;4374;1086;151659;71553;28.8;13.6
02;2021-05-16;2795;212;154454;71765;29.4;13.6
02;2021-05-17;2147;665;156601;72430;29.8;13.8
02;2021-05-18;2634;979;159235;73409;30.3;14.0
02;2021-05-19;2852;1001;162087;74410;30.8;14.1
02;2021-05-20;3553;1234;165640;75644;31.5;14.4
02;2021-05-21;3818;1075;169458;76719;32.2;14.6
02;2021-05-22;5845;970;175303;77689;33.3;14.8
02;2021-05-23;2658;240;177961;77929;33.8;14.8
02;2021-05-24;3541;544;181502;78473;34.5;14.9
02;2021-05-25;2257;1164;183759;79637;34.9;15.1
02;2021-05-26;3079;1498;186838;81135;35.5;15.4
02;2021-05-27;3649;1493;190487;82628;36.2;15.7
02;2021-05-28;3515;1586;194002;84214;36.9;16.0
02;2021-05-29;4078;1573;198080;85787;37.7;16.3
02;2021-05-30;1449;187;199529;85974;37.9;16.3
02;2021-05-31;2575;1196;202104;87170;38.4;16.6
02;2021-06-01;2870;1870;204974;89040;39.0;16.9
02;2021-06-02;3160;1656;208134;90696;39.6;17.2
02;2021-06-03;2854;1841;210988;92537;40.1;17.6
02;2021-06-04;3142;2063;214130;94600;40.7;18.0
02;2021-06-05;3441;1736;217571;96336;41.4;18.3
02;2021-06-06;1736;259;219307;96595;41.7;18.4
02;2021-06-07;1613;1501;220920;98096;42.0;18.6
02;2021-06-08;2061;1848;222981;99944;42.4;19.0
02;2021-06-09;2057;1653;225038;101597;42.8;19.3
02;2021-06-10;2011;1843;227049;103440;43.2;19.7
02;2021-06-11;2193;3073;229242;106513;43.6;20.2
02;2021-06-12;2311;2598;231553;109111;44.0;20.7
02;2021-06-13;683;1387;232236;110498;44.1;21.0
02;2021-06-14;1049;2392;233285;112890;44.3;21.5
02;2021-06-15;1518;2462;234803;115352;44.6;21.9
02;2021-06-16;1534;2749;236337;118101;44.9;22.5
02;2021-06-17;1782;2860;238119;120961;45.3;23.0
02;2021-06-18;2312;3573;240431;124534;45.7;23.7
02;2021-06-19;1841;3823;242272;128357;46.1;24.4
02;2021-06-20;645;1523;242917;129880;46.2;24.7
02;2021-06-21;806;3190;243723;133070;46.3;25.3
02;2021-06-22;1155;3668;244878;136738;46.6;26.0
02;2021-06-23;1226;3589;246104;140327;46.8;26.7
02;2021-06-24;1327;3150;247431;143477;47.0;27.3
02;2021-06-25;1399;4545;248830;148022;47.3;28.1
02;2021-06-26;1345;4228;250175;152250;47.6;28.9
02;2021-06-27;600;2333;250775;154583;47.7;29.4
02;2021-06-28;877;3021;251652;157604;47.8;30.0
02;2021-06-29;919;2929;252571;160533;48.0;30.5
02;2021-06-30;1509;3161;254080;163694;48.3;31.1
02;2021-07-01;1193;3592;255273;167286;48.5;31.8
02;2021-07-02;1358;5136;256631;172422;48.8;32.8
02;2021-07-03;999;5989;257630;178411;49.0;33.9
02;2021-07-04;509;2370;258139;180781;49.1;34.4
02;2021-07-05;661;3937;258800;184718;49.2;35.1
02;2021-07-06;675;3045;259475;187763;49.3;35.7
02;2021-07-07;1321;3726;260796;191489;49.6;36.4
02;2021-07-08;1393;3871;262189;195360;49.8;37.1
02;2021-07-09;1283;4221;263472;199581;50.1;37.9
02;2021-07-10;1333;4607;264805;204188;50.3;38.8
02;2021-07-11;480;1967;265285;206155;50.4;39.2
02;2021-07-12;1417;3732;266702;209887;50.7;39.9
02;2021-07-13;2066;3662;268768;213549;51.1;40.6
02;2021-07-14;1753;1599;270521;215148;51.4;40.9
02;2021-07-15;2727;3564;273248;218712;51.9;41.6
02;2021-07-16;3164;4219;276412;222931;52.5;42.4
02;2021-07-17;3561;4230;279973;227161;53.2;43.2
02;2021-07-18;2037;1616;282010;228777;53.6;43.5
02;2021-07-19;3440;3038;285450;231815;54.3;44.1
02;2021-07-20;3501;3306;288951;235121;54.9;44.7
02;2021-07-21;3910;2952;292861;238073;55.7;45.3
02;2021-07-22;3324;2806;296185;240879;56.3;45.8
02;2021-07-23;3205;3559;299390;244438;56.9;46.5
02;2021-07-24;4447;3725;303837;248163;57.8;47.2
02;2021-07-25;2192;1089;306029;249252;58.2;47.4
02;2021-07-26;3874;2253;309903;251505;58.9;47.8
02;2021-07-27;3660;2148;313563;253653;59.6;48.2
02;2021-07-28;3279;2101;316842;255754;60.2;48.6
02;2021-07-29;2583;2225;319425;257979;60.7;49.0
02;2021-07-30;3313;2311;322738;260290;61.4;49.5
02;2021-07-31;4183;2281;326921;262571;62.1;49.9
02;2021-08-01;1475;692;328396;263263;62.4;50.0
02;2021-08-02;2042;1602;330438;264865;62.8;50.3
02;2021-08-03;2530;1903;332968;266768;63.3;50.7
02;2021-08-04;2577;1713;335545;268481;63.8;51.0
02;2021-08-05;1849;2266;337394;270747;64.1;51.5
02;2021-08-06;2101;2741;339495;273488;64.5;52.0
02;2021-08-07;2522;2785;342017;276273;65.0;52.5
02;2021-08-08;1025;1572;343042;277845;65.2;52.8
02;2021-08-09;1909;2749;344951;280594;65.6;53.3
02;2021-08-10;1766;2462;346717;283056;65.9;53.8
02;2021-08-11;1481;2109;348198;285165;66.2;54.2
02;2021-08-12;1205;2332;349403;287497;66.4;54.7
02;2021-08-13;1611;2910;351014;290407;66.7;55.2
02;2021-08-14;1666;3696;352680;294103;67.0;55.9
02;2021-08-15;161;572;352841;294675;67.1;56.0
02;2021-08-16;1282;3755;354123;298430;67.3;56.7
02;2021-08-17;1421;2840;355544;301270;67.6;57.3
02;2021-08-18;1578;3184;357122;304454;67.9;57.9
02;2021-08-19;1134;3218;358256;307672;68.1;58.5
02;2021-08-20;1205;2951;359461;310623;68.3;59.0
02;2021-08-21;1449;4082;360910;314705;68.6;59.8
02;2021-08-22;407;1657;361317;316362;68.7;60.1
02;2021-08-23;1157;3080;362474;319442;68.9;60.7
02;2021-08-24;907;2184;363381;321626;69.1;61.1
02;2021-08-25;1021;2596;364402;324222;69.3;61.6
02;2021-08-26;913;2334;365315;326556;69.4;62.1
02;2021-08-27;965;2615;366280;329171;69.6;62.6
02;2021-08-28;1301;3429;367581;332600;69.9;63.2
02;2021-08-29;328;1171;367909;333771;69.9;63.4
02;2021-08-30;996;2430;368905;336201;70.1;63.9
02;2021-08-31;865;2171;369770;338372;70.3;64.3
02;2021-09-01;708;1422;370478;339794;70.4;64.6
02;2021-09-02;651;1610;371129;341404;70.6;64.9
02;2021-09-03;695;1796;371824;343200;70.7;65.2
02;2021-09-04;857;2760;372681;345960;70.8;65.8
02;2021-09-05;226;455;372907;346415;70.9;65.9
02;2021-09-06;406;901;373313;347316;71.0;66.0
02;2021-09-07;456;1195;373769;348511;71.1;66.3
02;2021-09-08;517;1736;374286;350247;71.2;66.6
02;2021-09-09;443;1176;374729;351423;71.2;66.8
02;2021-09-10;563;1363;375292;352786;71.3;67.1
02;2021-09-11;724;2127;376016;354913;71.5;67.5
02;2021-09-12;91;270;376107;355183;71.5;67.5
02;2021-09-13;424;952;376531;356135;71.6;67.7
02;2021-09-14;413;820;376944;356955;71.7;67.9
02;2021-09-15;447;1306;377391;358261;71.7;68.1
02;2021-09-16;456;832;377847;359093;71.8;68.3
02;2021-09-17;584;936;378431;360029;71.9;68.4
02;2021-09-18;565;2030;378996;362059;72.0;68.8
02;2021-09-19;78;259;379074;362318;72.1;68.9
02;2021-09-20;295;654;379369;362972;72.1;69.0
02;2021-09-21;278;626;379647;363598;72.2;69.1
02;2021-09-22;361;906;380008;364504;72.2;69.3
02;2021-09-23;261;563;380269;365067;72.3;69.4
02;2021-09-24;296;762;380565;365829;72.3;69.5
02;2021-09-25;318;1209;380883;367038;72.4;69.8
02;2021-09-26;33;158;380916;367196;72.4;69.8
02;2021-09-27;139;369;381055;367565;72.4;69.9
02;2021-09-28;156;392;381211;367957;72.5;69.9
02;2021-09-29;228;418;381439;368375;72.5;70.0
02;2021-09-30;238;479;381677;368854;72.6;70.1
02;2021-10-01;350;657;382027;369511;72.6;70.2
02;2021-10-02;390;853;382417;370364;72.7;70.4
02;2021-10-03;36;59;382453;370423;72.7;70.4
02;2021-10-04;155;361;382608;370784;72.7;70.5
02;2021-10-05;175;318;382783;371102;72.8;70.5
02;2021-10-06;252;420;383035;371522;72.8;70.6
02;2021-10-07;231;462;383266;371984;72.9;70.7
02;2021-10-08;313;603;383579;372587;72.9;70.8
02;2021-10-09;321;688;383900;373275;73.0;71.0
02;2021-10-10;30;56;383930;373331;73.0;71.0
02;2021-10-11;159;301;384089;373632;73.0;71.0
03;2020-12-27;0;0;0;0;0.0;0.0
03;2020-12-28;1;0;1;0;0.0;0.0
03;2020-12-29;0;0;1;0;0.0;0.0
03;2020-12-30;1;0;2;0;0.0;0.0
03;2020-12-31;0;0;2;0;0.0;0.0
03;2021-01-01;0;0;2;0;0.0;0.0
03;2021-01-02;0;0;2;0;0.0;0.0
03;2021-01-03;0;0;2;0;0.0;0.0
03;2021-01-04;0;0;2;0;0.0;0.0
03;2021-01-05;0;0;2;0;0.0;0.0
03;2021-01-06;10;0;12;0;0.0;0.0
03;2021-01-07;61;0;73;0;0.0;0.0
03;2021-01-08;146;1;219;1;0.1;0.0
03;2021-01-09;122;0;341;1;0.1;0.0
03;2021-01-10;6;0;347;1;0.1;0.0
03;2021-01-11;412;1;759;2;0.2;0.0
03;2021-01-12;631;0;1390;2;0.4;0.0
03;2021-01-13;669;2;2059;4;0.6;0.0
03;2021-01-14;860;4;2919;8;0.9;0.0
03;2021-01-15;387;3;3306;11;1.0;0.0
03;2021-01-16;278;0;3584;11;1.1;0.0
03;2021-01-17;42;0;3626;11;1.1;0.0
03;2021-01-18;878;0;4504;11;1.4;0.0
03;2021-01-19;1151;2;5655;13;1.7;0.0
03;2021-01-20;1292;4;6947;17;2.1;0.0
03;2021-01-21;1202;5;8149;22;2.5;0.0
03;2021-01-22;1117;6;9266;28;2.8;0.0
03;2021-01-23;465;1;9731;29;2.9;0.0
03;2021-01-24;0;0;9731;29;2.9;0.0
03;2021-01-25;187;0;9918;29;3.0;0.0
03;2021-01-26;680;14;10598;43;3.2;0.0
03;2021-01-27;696;11;11294;54;3.4;0.0
03;2021-01-28;1021;50;12315;104;3.7;0.0
03;2021-01-29;856;83;13171;187;4.0;0.1
03;2021-01-30;600;2;13771;189;4.2;0.1
03;2021-01-31;0;0;13771;189;4.2;0.1
03;2021-02-01;160;76;13931;265;4.2;0.1
03;2021-02-02;767;268;14698;533;4.4;0.2
03;2021-02-03;1056;492;15754;1025;4.8;0.3
03;2021-02-04;1558;645;17312;1670;5.2;0.5
03;2021-02-05;948;318;18260;1988;5.5;0.6
03;2021-02-06;152;13;18412;2001;5.6;0.6
03;2021-02-07;5;0;18417;2001;5.6;0.6
03;2021-02-08;128;56;18545;2057;5.6;0.6
03;2021-02-09;612;448;19157;2505;5.8;0.8
03;2021-02-10;485;344;19642;2849;5.9;0.9
03;2021-02-11;1027;585;20669;3434;6.2;1.0
03;2021-02-12;1078;555;21747;3989;6.6;1.2
03;2021-02-13;126;167;21873;4156;6.6;1.3
03;2021-02-14;0;1;21873;4157;6.6;1.3
03;2021-02-15;309;862;22182;5019;6.7;1.5
03;2021-02-16;548;1166;22730;6185;6.9;1.9
03;2021-02-17;452;1356;23182;7541;7.0;2.3
03;2021-02-18;368;1270;23550;8811;7.1;2.7
03;2021-02-19;497;794;24047;9605;7.3;2.9
03;2021-02-20;128;183;24175;9788;7.3;3.0
03;2021-02-21;2;1;24177;9789;7.3;3.0
03;2021-02-22;158;202;24335;9991;7.3;3.0
03;2021-02-23;720;949;25055;10940;7.6;3.3
03;2021-02-24;610;1023;25665;11963;7.7;3.6
03;2021-02-25;1093;1834;26758;13797;8.1;4.2
03;2021-02-26;822;1375;27580;15172;8.3;4.6
03;2021-02-27;96;258;27676;15430;8.4;4.7
03;2021-02-28;0;15;27676;15445;8.4;4.7
03;2021-03-01;178;240;27854;15685;8.4;4.7
03;2021-03-02;818;660;28672;16345;8.7;4.9
03;2021-03-03;904;462;29576;16807;8.9;5.1
03;2021-03-04;1541;591;31117;17398;9.4;5.3
03;2021-03-05;1122;737;32239;18135;9.7;5.5
03;2021-03-06;915;114;33154;18249;10.0;5.5
03;2021-03-07;2;0;33156;18249;10.0;5.5
03;2021-03-08;240;246;33396;18495;10.1;5.6
03;2021-03-09;1016;440;34412;18935;10.4;5.7
03;2021-03-10;941;554;35353;19489;10.7;5.9
03;2021-03-11;1675;659;37028;20148;11.2;6.1
03;2021-03-12;1303;869;38331;21017;11.6;6.3
03;2021-03-13;864;114;39195;21131;11.8;6.4
03;2021-03-14;2;8;39197;21139;11.8;6.4
03;2021-03-15;250;200;39447;21339;11.9;6.4
03;2021-03-16;650;404;40097;21743;12.1;6.6
03;2021-03-17;1304;449;41401;22192;12.5;6.7
03;2021-03-18;1720;400;43121;22592;13.0;6.8
03;2021-03-19;1728;365;44849;22957;13.5;6.9
03;2021-03-20;301;27;45150;22984;13.6;6.9
03;2021-03-21;1;0;45151;22984;13.6;6.9
03;2021-03-22;223;397;45374;23381;13.7;7.1
03;2021-03-23;1355;357;46729;23738;14.1;7.2
03;2021-03-24;1824;352;48553;24090;14.7;7.3
03;2021-03-25;2367;572;50920;24662;15.4;7.4
03;2021-03-26;2240;452;53160;25114;16.0;7.6
03;2021-03-27;817;23;53977;25137;16.3;7.6
03;2021-03-28;1;39;53978;25176;16.3;7.6
03;2021-03-29;659;176;54637;25352;16.5;7.7
03;2021-03-30;1908;458;56545;25810;17.1;7.8
03;2021-03-31;1014;987;57559;26797;17.4;8.1
03;2021-04-01;1375;1127;58934;27924;17.8;8.4
03;2021-04-02;1705;616;60639;28540;18.3;8.6
03;2021-04-03;365;100;61004;28640;18.4;8.6
03;2021-04-04;3;0;61007;28640;18.4;8.6
03;2021-04-05;18;14;61025;28654;18.4;8.6
03;2021-04-06;1073;414;62098;29068;18.7;8.8
03;2021-04-07;1562;524;63660;29592;19.2;8.9
03;2021-04-08;2121;489;65781;30081;19.9;9.1
03;2021-04-09;2056;1165;67837;31246;20.5;9.4
03;2021-04-10;1013;73;68850;31319;20.8;9.5
03;2021-04-11;478;9;69328;31328;20.9;9.5
03;2021-04-12;986;228;70314;31556;21.2;9.5
03;2021-04-13;1873;989;72187;32545;21.8;9.8
03;2021-04-14;2334;1225;74521;33770;22.5;10.2
03;2021-04-15;2621;1405;77142;35175;23.3;10.6
03;2021-04-16;2834;1187;79976;36362;24.1;11.0
03;2021-04-17;1083;443;81059;36805;24.5;11.1
03;2021-04-18;0;0;81059;36805;24.5;11.1
03;2021-04-19;1191;588;82250;37393;24.8;11.3
03;2021-04-20;1747;1277;83997;38670;25.4;11.7
03;2021-04-21;1122;1295;85119;39965;25.7;12.1
03;2021-04-22;1675;1006;86794;40971;26.2;12.4
03;2021-04-23;2478;1274;89272;42245;26.9;12.8
03;2021-04-24;1301;928;90573;43173;27.3;13.0
03;2021-04-25;350;16;90923;43189;27.4;13.0
03;2021-04-26;1332;467;92255;43656;27.8;13.2
03;2021-04-27;1766;1530;94021;45186;28.4;13.6
03;2021-04-28;1930;1125;95951;46311;29.0;14.0
03;2021-04-29;2371;1253;98322;47564;29.7;14.4
03;2021-04-30;1931;810;100253;48374;30.3;14.6
03;2021-05-01;438;493;100691;48867;30.4;14.7
03;2021-05-02;2;1;100693;48868;30.4;14.7
03;2021-05-03;1912;775;102605;49643;31.0;15.0
03;2021-05-04;2847;1637;105452;51280;31.8;15.5
03;2021-05-05;2604;1332;108056;52612;32.6;15.9
03;2021-05-06;3095;2011;111151;54623;33.5;16.5
03;2021-05-07;4729;1800;115880;56423;35.0;17.0
03;2021-05-08;661;381;116541;56804;35.2;17.1
03;2021-05-09;49;511;116590;57315;35.2;17.3
03;2021-05-10;1892;1481;118482;58796;35.8;17.7
03;2021-05-11;3902;1841;122384;60637;36.9;18.3
03;2021-05-12;2972;1523;125356;62160;37.8;18.8
03;2021-05-13;4384;410;129740;62570;39.2;18.9
03;2021-05-14;3655;1698;133395;64268;40.3;19.4
03;2021-05-15;1943;491;135338;64759;40.8;19.5
03;2021-05-16;522;57;135860;64816;41.0;19.6
03;2021-05-17;1277;862;137137;65678;41.4;19.8
03;2021-05-18;3068;1506;140205;67184;42.3;20.3
03;2021-05-19;2623;967;142828;68151;43.1;20.6
03;2021-05-20;3334;1145;146162;69296;44.1;20.9
03;2021-05-21;4194;1285;150356;70581;45.4;21.3
03;2021-05-22;2012;359;152368;70940;46.0;21.4
03;2021-05-23;641;73;153009;71013;46.2;21.4
03;2021-05-24;2654;216;155663;71229;47.0;21.5
03;2021-05-25;3067;1691;158730;72920;47.9;22.0
03;2021-05-26;2336;1044;161066;73964;48.6;22.3
03;2021-05-27;2945;1126;164011;75090;49.5;22.7
03;2021-05-28;3848;2287;167859;77377;50.7;23.4
03;2021-05-29;1748;603;169607;77980;51.2;23.5
03;2021-05-30;242;23;169849;78003;51.3;23.5
03;2021-05-31;697;575;170546;78578;51.5;23.7
03;2021-06-01;2302;2347;172848;80925;52.2;24.4
03;2021-06-02;1534;1749;174382;82674;52.6;25.0
03;2021-06-03;2060;2755;176442;85429;53.3;25.8
03;2021-06-04;1698;2508;178140;87937;53.8;26.5
03;2021-06-05;1076;1143;179216;89080;54.1;26.9
03;2021-06-06;59;7;179275;89087;54.1;26.9
03;2021-06-07;785;1815;180060;90902;54.3;27.4
03;2021-06-08;1458;2557;181518;93459;54.8;28.2
03;2021-06-09;1267;1877;182785;95336;55.2;28.8
03;2021-06-10;1381;2124;184166;97460;55.6;29.4
03;2021-06-11;1503;3450;185669;100910;56.0;30.5
03;2021-06-12;831;823;186500;101733;56.3;30.7
03;2021-06-13;20;10;186520;101743;56.3;30.7
03;2021-06-14;381;2177;186901;103920;56.4;31.4
03;2021-06-15;1317;3837;188218;107757;56.8;32.5
03;2021-06-16;788;2890;189006;110647;57.0;33.4
03;2021-06-17;1083;3334;190089;113981;57.4;34.4
03;2021-06-18;1107;3981;191196;117962;57.7;35.6
03;2021-06-19;641;1618;191837;119580;57.9;36.1
03;2021-06-20;20;8;191857;119588;57.9;36.1
03;2021-06-21;461;2636;192318;122224;58.0;36.9
03;2021-06-22;1027;4003;193345;126227;58.4;38.1
03;2021-06-23;716;3285;194061;129512;58.6;39.1
03;2021-06-24;982;3862;195043;133374;58.9;40.3
03;2021-06-25;1016;3893;196059;137267;59.2;41.4
03;2021-06-26;513;2040;196572;139307;59.3;42.0
03;2021-06-27;65;486;196637;139793;59.4;42.2
03;2021-06-28;642;2101;197279;141894;59.5;42.8
03;2021-06-29;1028;3330;198307;145224;59.9;43.8
03;2021-06-30;831;3120;199138;148344;60.1;44.8
03;2021-07-01;987;2936;200125;151280;60.4;45.7
03;2021-07-02;920;4094;201045;155374;60.7;46.9
03;2021-07-03;487;1884;201532;157258;60.8;47.5
03;2021-07-04;20;332;201552;157590;60.8;47.6
03;2021-07-05;818;2381;202370;159971;61.1;48.3
03;2021-07-06;1171;3462;203541;163433;61.4;49.3
03;2021-07-07;804;2618;204345;166051;61.7;50.1
03;2021-07-08;1060;3043;205405;169094;62.0;51.0
03;2021-07-09;1470;3626;206875;172720;62.4;52.1
03;2021-07-10;508;1926;207383;174646;62.6;52.7
03;2021-07-11;61;492;207444;175138;62.6;52.9
03;2021-07-12;939;1148;208383;176286;62.9;53.2
03;2021-07-13;2612;3153;210995;179439;63.7;54.2
03;2021-07-14;195;25;211190;179464;63.7;54.2
03;2021-07-15;2613;2454;213803;181918;64.5;54.9
03;2021-07-16;2737;2275;216540;184193;65.4;55.6
03;2021-07-17;1032;1626;217572;185819;65.7;56.1
03;2021-07-18;33;8;217605;185827;65.7;56.1
03;2021-07-19;2391;1277;219996;187104;66.4;56.5
03;2021-07-20;3074;3033;223070;190137;67.3;57.4
03;2021-07-21;3214;1439;226284;191576;68.3;57.8
03;2021-07-22;2851;1887;229135;193463;69.2;58.4
03;2021-07-23;3205;1307;232340;194770;70.1;58.8
03;2021-07-24;590;581;232930;195351;70.3;59.0
03;2021-07-25;18;5;232948;195356;70.3;59.0
03;2021-07-26;2043;1579;234991;196935;70.9;59.4
03;2021-07-27;3321;2230;238312;199165;71.9;60.1
03;2021-07-28;2718;1118;241030;200283;72.7;60.5
03;2021-07-29;2549;1662;243579;201945;73.5;61.0
03;2021-07-30;2136;1455;245715;203400;74.2;61.4
03;2021-07-31;964;893;246679;204293;74.5;61.7
03;2021-08-01;13;20;246692;204313;74.5;61.7
03;2021-08-02;1679;1605;248371;205918;75.0;62.2
03;2021-08-03;2223;2778;250594;208696;75.6;63.0
03;2021-08-04;2195;894;252789;209590;76.3;63.3
03;2021-08-05;1265;1939;254054;211529;76.7;63.8
03;2021-08-06;1281;1025;255335;212554;77.1;64.2
03;2021-08-07;614;496;255949;213050;77.3;64.3
03;2021-08-08;66;29;256015;213079;77.3;64.3
03;2021-08-09;597;1304;256612;214383;77.5;64.7
03;2021-08-10;1676;3471;258288;217854;78.0;65.8
03;2021-08-11;1332;2529;259620;220383;78.4;66.5
03;2021-08-12;1137;3514;260757;223897;78.7;67.6
03;2021-08-13;776;1052;261533;224949;78.9;67.9
03;2021-08-14;380;566;261913;225515;79.1;68.1
03;2021-08-15;9;61;261922;225576;79.1;68.1
03;2021-08-16;725;2693;262647;228269;79.3;68.9
03;2021-08-17;1076;3218;263723;231487;79.6;69.9
03;2021-08-18;1164;2157;264887;233644;80.0;70.5
03;2021-08-19;1010;3049;265897;236693;80.3;71.4
03;2021-08-20;718;1138;266615;237831;80.5;71.8
03;2021-08-21;418;727;267033;238558;80.6;72.0
03;2021-08-22;8;6;267041;238564;80.6;72.0
03;2021-08-23;784;2289;267825;240853;80.8;72.7
03;2021-08-24;893;2406;268718;243259;81.1;73.4
03;2021-08-25;934;2029;269652;245288;81.4;74.0
03;2021-08-26;574;1435;270226;246723;81.6;74.5
03;2021-08-27;457;1581;270683;248304;81.7;74.9
03;2021-08-28;219;674;270902;248978;81.8;75.1
03;2021-08-29;4;0;270906;248978;81.8;75.1
03;2021-08-30;768;1450;271674;250428;82.0;75.6
03;2021-08-31;706;1949;272380;252377;82.2;76.2
03;2021-09-01;605;1292;272985;253669;82.4;76.6
03;2021-09-02;479;1090;273464;254759;82.5;76.9
03;2021-09-03;492;1073;273956;255832;82.7;77.2
03;2021-09-04;251;608;274207;256440;82.8;77.4
03;2021-09-05;7;14;274214;256454;82.8;77.4
03;2021-09-06;320;688;274534;257142;82.9;77.6
03;2021-09-07;578;1172;275112;258314;83.0;78.0
03;2021-09-08;424;1243;275536;259557;83.2;78.3
03;2021-09-09;275;661;275811;260218;83.2;78.5
03;2021-09-10;414;911;276225;261129;83.4;78.8
03;2021-09-11;209;649;276434;261778;83.4;79.0
03;2021-09-12;2;20;276436;261798;83.4;79.0
03;2021-09-13;285;660;276721;262458;83.5;79.2
03;2021-09-14;448;931;277169;263389;83.7;79.5
03;2021-09-15;360;996;277529;264385;83.8;79.8
03;2021-09-16;219;556;277748;264941;83.8;80.0
03;2021-09-17;161;356;277909;265297;83.9;80.1
03;2021-09-18;132;311;278041;265608;83.9;80.2
03;2021-09-19;0;11;278041;265619;83.9;80.2
03;2021-09-20;187;424;278228;266043;84.0;80.3
03;2021-09-21;249;722;278477;266765;84.1;80.5
03;2021-09-22;267;685;278744;267450;84.1;80.7
03;2021-09-23;178;460;278922;267910;84.2;80.9
03;2021-09-24;148;321;279070;268231;84.2;81.0
03;2021-09-25;51;257;279121;268488;84.2;81.0
03;2021-09-26;3;0;279124;268488;84.2;81.0
03;2021-09-27;116;326;279240;268814;84.3;81.1
03;2021-09-28;193;617;279433;269431;84.3;81.3
03;2021-09-29;213;505;279646;269936;84.4;81.5
03;2021-09-30;122;251;279768;270187;84.4;81.5
03;2021-10-01;155;489;279923;270676;84.5;81.7
03;2021-10-02;82;176;280005;270852;84.5;81.8
03;2021-10-03;0;0;280005;270852;84.5;81.8
03;2021-10-04;42;102;280047;270954;84.5;81.8
03;2021-10-05;169;389;280216;271343;84.6;81.9
03;2021-10-06;274;546;280490;271889;84.7;82.1
03;2021-10-07;99;207;280589;272096;84.7;82.1
03;2021-10-08;128;281;280717;272377;84.7;82.2
03;2021-10-09;108;166;280825;272543;84.8;82.3
03;2021-10-10;0;1;280825;272544;84.8;82.3
03;2021-10-11;160;293;280985;272837;84.8;82.3
04;2020-12-27;0;0;0;0;0.0;0.0
04;2020-12-28;1;0;1;0;0.0;0.0
04;2020-12-29;0;0;1;0;0.0;0.0
04;2020-12-30;0;0;1;0;0.0;0.0
04;2020-12-31;0;0;1;0;0.0;0.0
04;2021-01-01;0;0;1;0;0.0;0.0
04;2021-01-02;0;0;1;0;0.0;0.0
04;2021-01-03;0;0;1;0;0.0;0.0
04;2021-01-04;0;0;1;0;0.0;0.0
04;2021-01-05;4;0;5;0;0.0;0.0
04;2021-01-06;0;0;5;0;0.0;0.0
04;2021-01-07;61;0;66;0;0.0;0.0
04;2021-01-08;88;0;154;0;0.1;0.0
04;2021-01-09;57;0;211;0;0.1;0.0
04;2021-01-10;0;0;211;0;0.1;0.0
04;2021-01-11;77;0;288;0;0.2;0.0
04;2021-01-12;421;0;709;0;0.4;0.0
04;2021-01-13;244;2;953;2;0.6;0.0
04;2021-01-14;90;2;1043;4;0.6;0.0
04;2021-01-15;164;4;1207;8;0.7;0.0
04;2021-01-16;106;3;1313;11;0.8;0.0
04;2021-01-17;14;0;1327;11;0.8;0.0
04;2021-01-18;236;9;1563;20;0.9;0.0
04;2021-01-19;469;4;2032;24;1.2;0.0
04;2021-01-20;574;10;2606;34;1.6;0.0
04;2021-01-21;614;6;3220;40;1.9;0.0
04;2021-01-22;639;1;3859;41;2.3;0.0
04;2021-01-23;111;0;3970;41;2.4;0.0
04;2021-01-24;0;0;3970;41;2.4;0.0
04;2021-01-25;240;0;4210;41;2.5;0.0
04;2021-01-26;656;1;4866;42;2.9;0.0
04;2021-01-27;480;0;5346;42;3.2;0.0
04;2021-01-28;665;22;6011;64;3.6;0.0
04;2021-01-29;368;43;6379;107;3.9;0.1
04;2021-01-30;65;41;6444;148;3.9;0.1
04;2021-01-31;1;5;6445;153;3.9;0.1
04;2021-02-01;268;150;6713;303;4.1;0.2
04;2021-02-02;562;225;7275;528;4.4;0.3
04;2021-02-03;367;159;7642;687;4.6;0.4
04;2021-02-04;359;54;8001;741;4.8;0.4
04;2021-02-05;379;219;8380;960;5.1;0.6
04;2021-02-06;50;93;8430;1053;5.1;0.6
04;2021-02-07;2;22;8432;1075;5.1;0.7
04;2021-02-08;163;71;8595;1146;5.2;0.7
04;2021-02-09;196;143;8791;1289;5.3;0.8
04;2021-02-10;253;170;9044;1459;5.5;0.9
04;2021-02-11;363;291;9407;1750;5.7;1.1
04;2021-02-12;293;317;9700;2067;5.9;1.3
04;2021-02-13;27;94;9727;2161;5.9;1.3
04;2021-02-14;0;0;9727;2161;5.9;1.3
04;2021-02-15;31;164;9758;2325;5.9;1.4
04;2021-02-16;81;520;9839;2845;6.0;1.7
04;2021-02-17;67;431;9906;3276;6.0;2.0
04;2021-02-18;45;614;9951;3890;6.0;2.4
04;2021-02-19;53;372;10004;4262;6.1;2.6
04;2021-02-20;5;71;10009;4333;6.1;2.6
04;2021-02-21;0;0;10009;4333;6.1;2.6
04;2021-02-22;7;297;10016;4630;6.1;2.8
04;2021-02-23;19;594;10035;5224;6.1;3.2
04;2021-02-24;38;447;10073;5671;6.1;3.4
04;2021-02-25;73;377;10146;6048;6.1;3.7
04;2021-02-26;216;335;10362;6383;6.3;3.9
04;2021-02-27;179;75;10541;6458;6.4;3.9
04;2021-02-28;1;0;10542;6458;6.4;3.9
04;2021-03-01;18;74;10560;6532;6.4;4.0
04;2021-03-02;135;41;10695;6573;6.5;4.0
04;2021-03-03;375;644;11070;7217;6.7;4.4
04;2021-03-04;208;490;11278;7707;6.8;4.7
04;2021-03-05;236;358;11514;8065;7.0;4.9
04;2021-03-06;912;78;12426;8143;7.5;4.9
04;2021-03-07;498;26;12924;8169;7.8;4.9
04;2021-03-08;45;84;12969;8253;7.9;5.0
04;2021-03-09;215;258;13184;8511;8.0;5.2
04;2021-03-10;401;376;13585;8887;8.2;5.4
04;2021-03-11;495;342;14080;9229;8.5;5.6
04;2021-03-12;697;210;14777;9439;8.9;5.7
04;2021-03-13;1088;64;15865;9503;9.6;5.8
04;2021-03-14;460;4;16325;9507;9.9;5.8
04;2021-03-15;93;14;16418;9521;9.9;5.8
04;2021-03-16;74;9;16492;9530;10.0;5.8
04;2021-03-17;534;86;17026;9616;10.3;5.8
04;2021-03-18;814;25;17840;9641;10.8;5.8
04;2021-03-19;723;33;18563;9674;11.2;5.9
04;2021-03-20;159;3;18722;9677;11.3;5.9
04;2021-03-21;0;0;18722;9677;11.3;5.9
04;2021-03-22;105;13;18827;9690;11.4;5.9
04;2021-03-23;245;7;19072;9697;11.5;5.9
04;2021-03-24;1024;54;20096;9751;12.2;5.9
04;2021-03-25;1326;48;21422;9799;13.0;5.9
04;2021-03-26;1448;68;22870;9867;13.8;6.0
04;2021-03-27;266;22;23136;9889;14.0;6.0
04;2021-03-28;2;0;23138;9889;14.0;6.0
04;2021-03-29;680;13;23818;9902;14.4;6.0
04;2021-03-30;1086;150;24904;10052;15.1;6.1
04;2021-03-31;1327;107;26231;10159;15.9;6.1
04;2021-04-01;1133;133;27364;10292;16.6;6.2
04;2021-04-02;1185;115;28549;10407;17.3;6.3
04;2021-04-03;250;21;28799;10428;17.4;6.3
04;2021-04-04;1;0;28800;10428;17.4;6.3
04;2021-04-05;36;1;28836;10429;17.5;6.3
04;2021-04-06;929;155;29765;10584;18.0;6.4
04;2021-04-07;881;438;30646;11022;18.6;6.7
04;2021-04-08;926;696;31572;11718;19.1;7.1
04;2021-04-09;678;423;32250;12141;19.5;7.3
04;2021-04-10;231;192;32481;12333;19.7;7.5
04;2021-04-11;153;65;32634;12398;19.8;7.5
04;2021-04-12;593;103;33227;12501;20.1;7.6
04;2021-04-13;1189;242;34416;12743;20.8;7.7
04;2021-04-14;994;500;35410;13243;21.4;8.0
04;2021-04-15;921;673;36331;13916;22.0;8.4
04;2021-04-16;819;457;37150;14373;22.5;8.7
04;2021-04-17;209;69;37359;14442;22.6;8.7
04;2021-04-18;0;13;37359;14455;22.6;8.8
04;2021-04-19;338;288;37697;14743;22.8;8.9
04;2021-04-20;1003;446;38700;15189;23.4;9.2
04;2021-04-21;656;747;39356;15936;23.8;9.6
04;2021-04-22;758;855;40114;16791;24.3;10.2
04;2021-04-23;696;540;40810;17331;24.7;10.5
04;2021-04-24;165;65;40975;17396;24.8;10.5
04;2021-04-25;0;0;40975;17396;24.8;10.5
04;2021-04-26;172;613;41147;18009;24.9;10.9
04;2021-04-27;395;967;41542;18976;25.1;11.5
04;2021-04-28;431;1089;41973;20065;25.4;12.1
04;2021-04-29;688;1130;42661;21195;25.8;12.8
04;2021-04-30;436;850;43097;22045;26.1;13.3
04;2021-05-01;104;22;43201;22067;26.2;13.4
04;2021-05-02;8;131;43209;22198;26.2;13.4
04;2021-05-03;151;551;43360;22749;26.2;13.8
04;2021-05-04;564;839;43924;23588;26.6;14.3
04;2021-05-05;514;927;44438;24515;26.9;14.8
04;2021-05-06;1161;592;45599;25107;27.6;15.2
04;2021-05-07;656;765;46255;25872;28.0;15.7
04;2021-05-08;48;99;46303;25971;28.0;15.7
04;2021-05-09;0;0;46303;25971;28.0;15.7
04;2021-05-10;467;297;46770;26268;28.3;15.9
04;2021-05-11;1198;907;47968;27175;29.0;16.5
04;2021-05-12;1387;741;49355;27916;29.9;16.9
04;2021-05-13;378;131;49733;28047;30.1;17.0
04;2021-05-14;441;296;50174;28343;30.4;17.2
04;2021-05-15;99;162;50273;28505;30.4;17.3
04;2021-05-16;4;6;50277;28511;30.4;17.3
04;2021-05-17;155;297;50432;28808;30.5;17.4
04;2021-05-18;392;975;50824;29783;30.8;18.0
04;2021-05-19;773;688;51597;30471;31.2;18.4
04;2021-05-20;1256;548;52853;31019;32.0;18.8
04;2021-05-21;853;787;53706;31806;32.5;19.3
04;2021-05-22;105;146;53811;31952;32.6;19.3
04;2021-05-23;1;1;53812;31953;32.6;19.3
04;2021-05-24;2;36;53814;31989;32.6;19.4
04;2021-05-25;868;596;54682;32585;33.1;19.7
04;2021-05-26;1048;791;55730;33376;33.7;20.2
04;2021-05-27;1356;632;57086;34008;34.6;20.6
04;2021-05-28;1119;656;58205;34664;35.2;21.0
04;2021-05-29;90;398;58295;35062;35.3;21.2
04;2021-05-30;3;1;58298;35063;35.3;21.2
04;2021-05-31;420;416;58718;35479;35.5;21.5
04;2021-06-01;640;641;59358;36120;35.9;21.9
04;2021-06-02;871;1063;60229;37183;36.5;22.5
04;2021-06-03;1196;851;61425;38034;37.2;23.0
04;2021-06-04;978;779;62403;38813;37.8;23.5
04;2021-06-05;142;203;62545;39016;37.9;23.6
04;2021-06-06;7;13;62552;39029;37.9;23.6
04;2021-06-07;563;317;63115;39346;38.2;23.8
04;2021-06-08;839;595;63954;39941;38.7;24.2
04;2021-06-09;1146;688;65100;40629;39.4;24.6
04;2021-06-10;1142;585;66242;41214;40.1;24.9
04;2021-06-11;944;615;67186;41829;40.7;25.3
04;2021-06-12;212;148;67398;41977;40.8;25.4
04;2021-06-13;1;1;67399;41978;40.8;25.4
04;2021-06-14;478;303;67877;42281;41.1;25.6
04;2021-06-15;644;1003;68521;43284;41.5;26.2
04;2021-06-16;1022;787;69543;44071;42.1;26.7
04;2021-06-17;1001;959;70544;45030;42.7;27.3
04;2021-06-18;761;886;71305;45916;43.2;27.8
04;2021-06-19;40;85;71345;46001;43.2;27.8
04;2021-06-20;7;9;71352;46010;43.2;27.9
04;2021-06-21;305;614;71657;46624;43.4;28.2
04;2021-06-22;361;1308;72018;47932;43.6;29.0
04;2021-06-23;474;1311;72492;49243;43.9;29.8
04;2021-06-24;852;820;73344;50063;44.4;30.3
04;2021-06-25;461;639;73805;50702;44.7;30.7
04;2021-06-26;57;130;73862;50832;44.7;30.8
04;2021-06-27;4;4;73866;50836;44.7;30.8
04;2021-06-28;158;341;74024;51177;44.8;31.0
04;2021-06-29;370;839;74394;52016;45.0;31.5
04;2021-06-30;541;1121;74935;53137;45.4;32.2
04;2021-07-01;578;1219;75513;54356;45.7;32.9
04;2021-07-02;557;1090;76070;55446;46.0;33.6
04;2021-07-03;65;162;76135;55608;46.1;33.7
04;2021-07-04;6;6;76141;55614;46.1;33.7
04;2021-07-05;106;297;76247;55911;46.2;33.8
04;2021-07-06;503;1383;76750;57294;46.5;34.7
04;2021-07-07;494;1341;77244;58635;46.8;35.5
04;2021-07-08;725;1361;77969;59996;47.2;36.3
04;2021-07-09;580;1063;78549;61059;47.5;37.0
04;2021-07-10;92;177;78641;61236;47.6;37.1
04;2021-07-11;0;21;78641;61257;47.6;37.1
04;2021-07-12;128;652;78769;61909;47.7;37.5
04;2021-07-13;882;1541;79651;63450;48.2;38.4
04;2021-07-14;26;43;79677;63493;48.2;38.4
04;2021-07-15;1219;1736;80896;65229;49.0;39.5
04;2021-07-16;1082;1118;81978;66347;49.6;40.2
04;2021-07-17;446;235;82424;66582;49.9;40.3
04;2021-07-18;114;18;82538;66600;50.0;40.3
04;2021-07-19;484;655;83022;67255;50.3;40.7
04;2021-07-20;1313;1469;84335;68724;51.1;41.6
04;2021-07-21;1126;1166;85461;69890;51.7;42.3
04;2021-07-22;1500;1372;86961;71262;52.6;43.1
04;2021-07-23;1150;1142;88111;72404;53.3;43.8
04;2021-07-24;685;215;88796;72619;53.8;44.0
04;2021-07-25;42;20;88838;72639;53.8;44.0
04;2021-07-26;445;639;89283;73278;54.0;44.4
04;2021-07-27;1370;1046;90653;74324;54.9;45.0
04;2021-07-28;1073;1037;91726;75361;55.5;45.6
04;2021-07-29;1561;1302;93287;76663;56.5;46.4
04;2021-07-30;1244;924;94531;77587;57.2;47.0
04;2021-07-31;251;176;94782;77763;57.4;47.1
04;2021-08-01;48;19;94830;77782;57.4;47.1
04;2021-08-02;196;110;95026;77892;57.5;47.2
04;2021-08-03;1348;1117;96374;79009;58.3;47.8
04;2021-08-04;1178;864;97552;79873;59.1;48.4
04;2021-08-05;1194;738;98746;80611;59.8;48.8
04;2021-08-06;516;396;99262;81007;60.1;49.0
04;2021-08-07;162;162;99424;81169;60.2;49.1
04;2021-08-08;25;12;99449;81181;60.2;49.1
04;2021-08-09;102;117;99551;81298;60.3;49.2
04;2021-08-10;655;981;100206;82279;60.7;49.8
04;2021-08-11;1147;1020;101353;83299;61.4;50.4
04;2021-08-12;1124;1308;102477;84607;62.0;51.2
04;2021-08-13;443;386;102920;84993;62.3;51.4
04;2021-08-14;100;73;103020;85066;62.4;51.5
04;2021-08-15;1;0;103021;85066;62.4;51.5
04;2021-08-16;103;138;103124;85204;62.4;51.6
04;2021-08-17;496;1015;103620;86219;62.7;52.2
04;2021-08-18;720;1318;104340;87537;63.2;53.0
04;2021-08-19;740;1413;105080;88950;63.6;53.8
04;2021-08-20;748;1363;105828;90313;64.1;54.7
04;2021-08-21;66;111;105894;90424;64.1;54.7
04;2021-08-22;15;45;105909;90469;64.1;54.8
04;2021-08-23;55;110;105964;90579;64.1;54.8
04;2021-08-24;684;1493;106648;92072;64.6;55.7
04;2021-08-25;658;1183;107306;93255;65.0;56.5
04;2021-08-26;488;1217;107794;94472;65.3;57.2
04;2021-08-27;452;929;108246;95401;65.5;57.7
04;2021-08-28;132;245;108378;95646;65.6;57.9
04;2021-08-29;27;23;108405;95669;65.6;57.9
04;2021-08-30;122;240;108527;95909;65.7;58.1
04;2021-08-31;511;976;109038;96885;66.0;58.6
04;2021-09-01;511;1200;109549;98085;66.3;59.4
04;2021-09-02;336;855;109885;98940;66.5;59.9
04;2021-09-03;288;766;110173;99706;66.7;60.4
04;2021-09-04;148;227;110321;99933;66.8;60.5
04;2021-09-05;14;9;110335;99942;66.8;60.5
04;2021-09-06;57;103;110392;100045;66.8;60.6
04;2021-09-07;371;834;110763;100879;67.0;61.1
04;2021-09-08;328;740;111091;101619;67.2;61.5
04;2021-09-09;341;724;111432;102343;67.5;62.0
04;2021-09-10;278;667;111710;103010;67.6;62.4
04;2021-09-11;93;114;111803;103124;67.7;62.4
04;2021-09-12;18;23;111821;103147;67.7;62.4
04;2021-09-13;95;72;111916;103219;67.7;62.5
04;2021-09-14;335;609;112251;103828;67.9;62.9
04;2021-09-15;309;702;112560;104530;68.1;63.3
04;2021-09-16;310;522;112870;105052;68.3;63.6
04;2021-09-17;185;565;113055;105617;68.4;63.9
04;2021-09-18;48;123;113103;105740;68.5;64.0
04;2021-09-19;0;5;113103;105745;68.5;64.0
04;2021-09-20;79;51;113182;105796;68.5;64.0
04;2021-09-21;188;570;113370;106366;68.6;64.4
04;2021-09-22;162;677;113532;107043;68.7;64.8
04;2021-09-23;205;377;113737;107420;68.8;65.0
04;2021-09-24;143;436;113880;107856;68.9;65.3
04;2021-09-25;42;99;113922;107955;69.0;65.3
04;2021-09-26;6;26;113928;107981;69.0;65.4
04;2021-09-27;19;66;113947;108047;69.0;65.4
04;2021-09-28;139;277;114086;108324;69.1;65.6
04;2021-09-29;136;383;114222;108707;69.1;65.8
04;2021-09-30;123;274;114345;108981;69.2;66.0
04;2021-10-01;121;182;114466;109163;69.3;66.1
04;2021-10-02;60;135;114526;109298;69.3;66.2
04;2021-10-03;3;5;114529;109303;69.3;66.2
04;2021-10-04;35;45;114564;109348;69.3;66.2
04;2021-10-05;171;341;114735;109689;69.5;66.4
04;2021-10-06;183;341;114918;110030;69.6;66.6
04;2021-10-07;94;282;115012;110312;69.6;66.8
04;2021-10-08;98;170;115110;110482;69.7;66.9
04;2021-10-09;25;88;115135;110570;69.7;66.9
04;2021-10-10;1;2;115136;110572;69.7;66.9
04;2021-10-11;31;118;115167;110690;69.7;67.0
05;2020-12-27;0;0;0;0;0.0;0.0
05;2020-12-28;1;0;1;0;0.0;0.0
05;2020-12-29;1;0;2;0;0.0;0.0
05;2020-12-30;2;0;4;0;0.0;0.0
05;2020-12-31;0;0;4;0;0.0;0.0
05;2021-01-01;2;0;6;0;0.0;0.0
05;2021-01-02;2;0;8;0;0.0;0.0
05;2021-01-03;1;0;9;0;0.0;0.0
05;2021-01-04;2;0;11;0;0.0;0.0
05;2021-01-05;0;0;11;0;0.0;0.0
05;2021-01-06;22;1;33;1;0.0;0.0
05;2021-01-07;128;0;161;1;0.1;0.0
05;2021-01-08;146;1;307;2;0.2;0.0
05;2021-01-09;11;0;318;2;0.2;0.0
05;2021-01-10;0;0;318;2;0.2;0.0
05;2021-01-11;44;0;362;2;0.3;0.0
05;2021-01-12;105;0;467;2;0.3;0.0
05;2021-01-13;139;0;606;2;0.4;0.0
05;2021-01-14;167;0;773;2;0.5;0.0
05;2021-01-15;127;1;900;3;0.6;0.0
05;2021-01-16;15;0;915;3;0.6;0.0
05;2021-01-17;0;0;915;3;0.6;0.0
05;2021-01-18;226;1;1141;4;0.8;0.0
05;2021-01-19;227;0;1368;4;1.0;0.0
05;2021-01-20;213;0;1581;4;1.1;0.0
05;2021-01-21;255;0;1836;4;1.3;0.0
05;2021-01-22;196;1;2032;5;1.4;0.0
05;2021-01-23;113;0;2145;5;1.5;0.0
05;2021-01-24;0;0;2145;5;1.5;0.0
05;2021-01-25;316;0;2461;5;1.7;0.0
05;2021-01-26;486;0;2947;5;2.1;0.0
05;2021-01-27;389;4;3336;9;2.4;0.0
05;2021-01-28;363;56;3699;65;2.6;0.0
05;2021-01-29;364;113;4063;178;2.9;0.1
05;2021-01-30;97;9;4160;187;2.9;0.1
05;2021-01-31;4;0;4164;187;2.9;0.1
05;2021-02-01;177;21;4341;208;3.1;0.1
05;2021-02-02;187;121;4528;329;3.2;0.2
05;2021-02-03;208;63;4736;392;3.3;0.3
05;2021-02-04;197;125;4933;517;3.5;0.4
05;2021-02-05;183;109;5116;626;3.6;0.4
05;2021-02-06;76;24;5192;650;3.7;0.5
05;2021-02-07;0;5;5192;655;3.7;0.5
05;2021-02-08;84;124;5276;779;3.7;0.5
05;2021-02-09;97;113;5373;892;3.8;0.6
05;2021-02-10;81;175;5454;1067;3.8;0.8
05;2021-02-11;87;137;5541;1204;3.9;0.8
05;2021-02-12;85;148;5626;1352;4.0;1.0
05;2021-02-13;75;31;5701;1383;4.0;1.0
05;2021-02-14;0;0;5701;1383;4.0;1.0
05;2021-02-15;98;190;5799;1573;4.1;1.1
05;2021-02-16;111;286;5910;1859;4.2;1.3
05;2021-02-17;136;231;6046;2090;4.3;1.5
05;2021-02-18;154;299;6200;2389;4.4;1.7
05;2021-02-19;158;322;6358;2711;4.5;1.9
05;2021-02-20;31;87;6389;2798;4.5;2.0
05;2021-02-21;0;0;6389;2798;4.5;2.0
05;2021-02-22;70;247;6459;3045;4.6;2.1
05;2021-02-23;18;237;6477;3282;4.6;2.3
05;2021-02-24;20;190;6497;3472;4.6;2.4
05;2021-02-25;56;174;6553;3646;4.6;2.6
05;2021-02-26;145;215;6698;3861;4.7;2.7
05;2021-02-27;65;171;6763;4032;4.8;2.8
05;2021-02-28;11;0;6774;4032;4.8;2.8
05;2021-03-01;92;169;6866;4201;4.8;3.0
05;2021-03-02;92;198;6958;4399;4.9;3.1
05;2021-03-03;112;233;7070;4632;5.0;3.3
05;2021-03-04;242;167;7312;4799;5.2;3.4
05;2021-03-05;578;193;7890;4992;5.6;3.5
05;2021-03-06;670;60;8560;5052;6.0;3.6
05;2021-03-07;516;21;9076;5073;6.4;3.6
05;2021-03-08;556;139;9632;5212;6.8;3.7
05;2021-03-09;520;167;10152;5379;7.2;3.8
05;2021-03-10;498;145;10650;5524;7.5;3.9
05;2021-03-11;377;141;11027;5665;7.8;4.0
05;2021-03-12;435;93;11462;5758;8.1;4.1
05;2021-03-13;797;98;12259;5856;8.6;4.1
05;2021-03-14;670;12;12929;5868;9.1;4.1
05;2021-03-15;354;125;13283;5993;9.4;4.2
05;2021-03-16;149;144;13432;6137;9.5;4.3
05;2021-03-17;262;120;13694;6257;9.7;4.4
05;2021-03-18;364;35;14058;6292;9.9;4.4
05;2021-03-19;450;59;14508;6351;10.2;4.5
05;2021-03-20;167;32;14675;6383;10.4;4.5
05;2021-03-21;1;0;14676;6383;10.4;4.5
05;2021-03-22;718;39;15394;6422;10.9;4.5
05;2021-03-23;805;18;16199;6440;11.4;4.5
05;2021-03-24;789;78;16988;6518;12.0;4.6
05;2021-03-25;901;59;17889;6577;12.6;4.6
05;2021-03-26;1023;49;18912;6626;13.3;4.7
05;2021-03-27;467;35;19379;6661;13.7;4.7
05;2021-03-28;10;0;19389;6661;13.7;4.7
05;2021-03-29;905;67;20294;6728;14.3;4.7
05;2021-03-30;1142;79;21436;6807;15.1;4.8
05;2021-03-31;824;255;22260;7062;15.7;5.0
05;2021-04-01;901;244;23161;7306;16.3;5.2
05;2021-04-02;664;380;23825;7686;16.8;5.4
05;2021-04-03;551;187;24376;7873;17.2;5.6
05;2021-04-04;350;64;24726;7937;17.4;5.6
05;2021-04-05;158;12;24884;7949;17.6;5.6
05;2021-04-06;646;276;25530;8225;18.0;5.8
05;2021-04-07;773;324;26303;8549;18.6;6.0
05;2021-04-08;733;338;27036;8887;19.1;6.3
05;2021-04-09;883;413;27919;9300;19.7;6.6
05;2021-04-10;714;389;28633;9689;20.2;6.8
05;2021-04-11;191;174;28824;9863;20.3;7.0
05;2021-04-12;732;264;29556;10127;20.8;7.1
05;2021-04-13;921;249;30477;10376;21.5;7.3
05;2021-04-14;666;329;31143;10705;22.0;7.6
05;2021-04-15;768;400;31911;11105;22.5;7.8
05;2021-04-16;730;411;32641;11516;23.0;8.1
05;2021-04-17;671;242;33312;11758;23.5;8.3
05;2021-04-18;305;23;33617;11781;23.7;8.3
05;2021-04-19;363;538;33980;12319;24.0;8.7
05;2021-04-20;482;631;34462;12950;24.3;9.1
05;2021-04-21;494;629;34956;13579;24.7;9.6
05;2021-04-22;385;549;35341;14128;24.9;10.0
05;2021-04-23;523;657;35864;14785;25.3;10.4
05;2021-04-24;347;384;36211;15169;25.5;10.7
05;2021-04-25;288;23;36499;15192;25.7;10.7
05;2021-04-26;367;708;36866;15900;26.0;11.2
05;2021-04-27;657;751;37523;16651;26.5;11.7
05;2021-04-28;468;721;37991;17372;26.8;12.3
05;2021-04-29;702;750;38693;18122;27.3;12.8
05;2021-04-30;509;756;39202;18878;27.7;13.3
05;2021-05-01;138;110;39340;18988;27.8;13.4
05;2021-05-02;267;115;39607;19103;27.9;13.5
05;2021-05-03;458;494;40065;19597;28.3;13.8
05;2021-05-04;384;503;40449;20100;28.5;14.2
05;2021-05-05;461;671;40910;20771;28.9;14.7
05;2021-05-06;644;726;41554;21497;29.3;15.2
05;2021-05-07;595;800;42149;22297;29.7;15.7
05;2021-05-08;481;177;42630;22474;30.1;15.9
05;2021-05-09;208;57;42838;22531;30.2;15.9
05;2021-05-10;500;697;43338;23228;30.6;16.4
05;2021-05-11;669;916;44007;24144;31.0;17.0
05;2021-05-12;647;733;44654;24877;31.5;17.5
05;2021-05-13;960;116;45614;24993;32.2;17.6
05;2021-05-14;826;495;46440;25488;32.8;18.0
05;2021-05-15;1044;353;47484;25841;33.5;18.2
05;2021-05-16;235;52;47719;25893;33.7;18.3
05;2021-05-17;484;430;48203;26323;34.0;18.6
05;2021-05-18;519;419;48722;26742;34.4;18.9
05;2021-05-19;727;459;49449;27201;34.9;19.2
05;2021-05-20;747;434;50196;27635;35.4;19.5
05;2021-05-21;705;513;50901;28148;35.9;19.9
05;2021-05-22;607;239;51508;28387;36.3;20.0
05;2021-05-23;277;59;51785;28446;36.5;20.1
05;2021-05-24;510;157;52295;28603;36.9;20.2
05;2021-05-25;515;483;52810;29086;37.3;20.5
05;2021-05-26;695;362;53505;29448;37.7;20.8
05;2021-05-27;799;572;54304;30020;38.3;21.2
05;2021-05-28;666;648;54970;30668;38.8;21.6
05;2021-05-29;566;544;55536;31212;39.2;22.0
05;2021-05-30;212;82;55748;31294;39.3;22.1
05;2021-05-31;576;495;56324;31789;39.7;22.4
05;2021-06-01;590;586;56914;32375;40.1;22.8
05;2021-06-02;684;703;57598;33078;40.6;23.3
05;2021-06-03;716;651;58314;33729;41.1;23.8
05;2021-06-04;1017;818;59331;34547;41.9;24.4
05;2021-06-05;807;508;60138;35055;42.4;24.7
05;2021-06-06;203;89;60341;35144;42.6;24.8
05;2021-06-07;605;833;60946;35977;43.0;25.4
05;2021-06-08;702;661;61648;36638;43.5;25.8
05;2021-06-09;648;783;62296;37421;43.9;26.4
05;2021-06-10;545;719;62841;38140;44.3;26.9
05;2021-06-11;765;723;63606;38863;44.9;27.4
05;2021-06-12;593;485;64199;39348;45.3;27.8
05;2021-06-13;113;91;64312;39439;45.4;27.8
05;2021-06-14;403;669;64715;40108;45.7;28.3
05;2021-06-15;543;912;65258;41020;46.0;28.9
05;2021-06-16;433;671;65691;41691;46.3;29.4
05;2021-06-17;360;805;66051;42496;46.6;30.0
05;2021-06-18;400;725;66451;43221;46.9;30.5
05;2021-06-19;421;570;66872;43791;47.2;30.9
05;2021-06-20;64;77;66936;43868;47.2;30.9
05;2021-06-21;319;641;67255;44509;47.4;31.4
05;2021-06-22;356;829;67611;45338;47.7;32.0
05;2021-06-23;354;763;67965;46101;47.9;32.5
05;2021-06-24;388;1022;68353;47123;48.2;33.2
05;2021-06-25;229;893;68582;48016;48.4;33.9
05;2021-06-26;292;1074;68874;49090;48.6;34.6
05;2021-06-27;128;170;69002;49260;48.7;34.7
05;2021-06-28;254;792;69256;50052;48.9;35.3
05;2021-06-29;250;785;69506;50837;49.0;35.9
05;2021-06-30;329;790;69835;51627;49.3;36.4
05;2021-07-01;385;793;70220;52420;49.5;37.0
05;2021-07-02;369;871;70589;53291;49.8;37.6
05;2021-07-03;305;741;70894;54032;50.0;38.1
05;2021-07-04;179;175;71073;54207;50.1;38.2
05;2021-07-05;264;780;71337;54987;50.3;38.8
05;2021-07-06;336;858;71673;55845;50.6;39.4
05;2021-07-07;400;781;72073;56626;50.8;39.9
05;2021-07-08;431;848;72504;57474;51.1;40.5
05;2021-07-09;422;994;72926;58468;51.4;41.2
05;2021-07-10;314;729;73240;59197;51.7;41.8
05;2021-07-11;176;120;73416;59317;51.8;41.8
05;2021-07-12;416;1014;73832;60331;52.1;42.6
05;2021-07-13;482;869;74314;61200;52.4;43.2
05;2021-07-14;837;300;75151;61500;53.0;43.4
05;2021-07-15;709;993;75860;62493;53.5;44.1
05;2021-07-16;1027;1456;76887;63949;54.2;45.1
05;2021-07-17;672;1306;77559;65255;54.7;46.0
05;2021-07-18;286;132;77845;65387;54.9;46.1
05;2021-07-19;572;792;78417;66179;55.3;46.7
05;2021-07-20;763;801;79180;66980;55.9;47.3
05;2021-07-21;882;841;80062;67821;56.5;47.8
05;2021-07-22;812;870;80874;68691;57.1;48.5
05;2021-07-23;1446;1239;82320;69930;58.1;49.3
05;2021-07-24;864;836;83184;70766;58.7;49.9
05;2021-07-25;305;160;83489;70926;58.9;50.0
05;2021-07-26;778;561;84267;71487;59.4;50.4
05;2021-07-27;1259;757;85526;72244;60.3;51.0
05;2021-07-28;1523;720;87049;72964;61.4;51.5
05;2021-07-29;1346;724;88395;73688;62.4;52.0
05;2021-07-30;960;595;89355;74283;63.0;52.4
05;2021-07-31;782;526;90137;74809;63.6;52.8
05;2021-08-01;192;178;90329;74987;63.7;52.9
05;2021-08-02;835;549;91164;75536;64.3;53.3
05;2021-08-03;828;610;91992;76146;64.9;53.7
05;2021-08-04;992;758;92984;76904;65.6;54.3
05;2021-08-05;981;727;93965;77631;66.3;54.8
05;2021-08-06;873;793;94838;78424;66.9;55.3
05;2021-08-07;631;642;95469;79066;67.3;55.8
05;2021-08-08;196;270;95665;79336;67.5;56.0
05;2021-08-09;775;847;96440;80183;68.0;56.6
05;2021-08-10;651;700;97091;80883;68.5;57.1
05;2021-08-11;743;857;97834;81740;69.0;57.7
05;2021-08-12;795;786;98629;82526;69.6;58.2
05;2021-08-13;626;893;99255;83419;70.0;58.8
05;2021-08-14;410;781;99665;84200;70.3;59.4
05;2021-08-15;188;224;99853;84424;70.4;59.6
05;2021-08-16;488;1086;100341;85510;70.8;60.3
05;2021-08-17;433;880;100774;86390;71.1;60.9
05;2021-08-18;438;974;101212;87364;71.4;61.6
05;2021-08-19;500;964;101712;88328;71.8;62.3
05;2021-08-20;478;1115;102190;89443;72.1;63.1
05;2021-08-21;359;851;102549;90294;72.3;63.7
05;2021-08-22;117;254;102666;90548;72.4;63.9
05;2021-08-23;321;828;102987;91376;72.7;64.5
05;2021-08-24;404;781;103391;92157;72.9;65.0
05;2021-08-25;408;926;103799;93083;73.2;65.7
05;2021-08-26;307;816;104106;93899;73.4;66.2
05;2021-08-27;334;921;104440;94820;73.7;66.9
05;2021-08-28;246;655;104686;95475;73.8;67.4
05;2021-08-29;66;255;104752;95730;73.9;67.5
05;2021-08-30;268;774;105020;96504;74.1;68.1
05;2021-08-31;253;687;105273;97191;74.3;68.6
05;2021-09-01;271;581;105544;97772;74.5;69.0
05;2021-09-02;255;603;105799;98375;74.6;69.4
05;2021-09-03;253;533;106052;98908;74.8;69.8
05;2021-09-04;203;607;106255;99515;75.0;70.2
05;2021-09-05;55;158;106310;99673;75.0;70.3
05;2021-09-06;164;328;106474;100001;75.1;70.5
05;2021-09-07;218;496;106692;100497;75.3;70.9
05;2021-09-08;177;521;106869;101018;75.4;71.3
05;2021-09-09;196;435;107065;101453;75.5;71.6
05;2021-09-10;183;329;107248;101782;75.7;71.8
05;2021-09-11;148;441;107396;102223;75.8;72.1
05;2021-09-12;24;105;107420;102328;75.8;72.2
05;2021-09-13;170;282;107590;102610;75.9;72.4
05;2021-09-14;223;269;107813;102879;76.1;72.6
05;2021-09-15;177;376;107990;103255;76.2;72.8
05;2021-09-16;174;254;108164;103509;76.3;73.0
05;2021-09-17;147;319;108311;103828;76.4;73.2
05;2021-09-18;120;359;108431;104187;76.5;73.5
05;2021-09-19;16;38;108447;104225;76.5;73.5
05;2021-09-20;59;166;108506;104391;76.5;73.6
05;2021-09-21;81;246;108587;104637;76.6;73.8
05;2021-09-22;108;290;108695;104927;76.7;74.0
05;2021-09-23;99;238;108794;105165;76.7;74.2
05;2021-09-24;85;281;108879;105446;76.8;74.4
05;2021-09-25;85;225;108964;105671;76.9;74.5
05;2021-09-26;17;31;108981;105702;76.9;74.6
05;2021-09-27;63;144;109044;105846;76.9;74.7
05;2021-09-28;68;159;109112;106005;77.0;74.8
05;2021-09-29;85;199;109197;106204;77.0;74.9
05;2021-09-30;59;102;109256;106306;77.1;75.0
05;2021-10-01;116;240;109372;106546;77.2;75.2
05;2021-10-02;93;194;109465;106740;77.2;75.3
05;2021-10-03;14;31;109479;106771;77.2;75.3
05;2021-10-04;64;160;109543;106931;77.3;75.4
05;2021-10-05;66;180;109609;107111;77.3;75.6
05;2021-10-06;83;164;109692;107275;77.4;75.7
05;2021-10-07;47;113;109739;107388;77.4;75.8
05;2021-10-08;83;144;109822;107532;77.5;75.9
05;2021-10-09;80;176;109902;107708;77.5;76.0
05;2021-10-10;12;22;109914;107730;77.5;76.0
05;2021-10-11;60;103;109974;107833;77.6;76.1
06;2020-12-27;16;4;16;4;0.0;0.0
06;2020-12-28;26;3;42;7;0.0;0.0
06;2020-12-29;12;3;54;10;0.0;0.0
06;2020-12-30;10;1;64;11;0.0;0.0
06;2020-12-31;30;1;94;12;0.0;0.0
06;2021-01-01;26;4;120;16;0.0;0.0
06;2021-01-02;9;0;129;16;0.0;0.0
06;2021-01-03;11;3;140;19;0.0;0.0
06;2021-01-04;160;3;300;22;0.0;0.0
06;2021-01-05;195;11;495;33;0.0;0.0
06;2021-01-06;256;10;751;43;0.1;0.0
06;2021-01-07;528;7;1279;50;0.1;0.0
06;2021-01-08;695;5;1974;55;0.2;0.0
06;2021-01-09;391;5;2365;60;0.2;0.0
06;2021-01-10;83;2;2448;62;0.2;0.0
06;2021-01-11;1166;7;3614;69;0.3;0.0
06;2021-01-12;2253;13;5867;82;0.5;0.0
06;2021-01-13;1757;15;7624;97;0.7;0.0
06;2021-01-14;2188;30;9812;127;0.9;0.0
06;2021-01-15;1893;7;11705;134;1.1;0.0
06;2021-01-16;995;7;12700;141;1.2;0.0
06;2021-01-17;248;0;12948;141;1.2;0.0
06;2021-01-18;2515;26;15463;167;1.4;0.0
06;2021-01-19;2781;26;18244;193;1.7;0.0
06;2021-01-20;3394;21;21638;214;2.0;0.0
06;2021-01-21;3068;35;24706;249;2.3;0.0
06;2021-01-22;3035;39;27741;288;2.6;0.0
06;2021-01-23;1311;5;29052;293;2.7;0.0
06;2021-01-24;34;0;29086;293;2.7;0.0
06;2021-01-25;2098;16;31184;309;2.9;0.0
06;2021-01-26;3421;55;34605;364;3.2;0.0
06;2021-01-27;2580;114;37185;478;3.4;0.0
06;2021-01-28;2832;219;40017;697;3.7;0.1
06;2021-01-29;2533;329;42550;1026;3.9;0.1
06;2021-01-30;674;47;43224;1073;4.0;0.1
06;2021-01-31;4;1;43228;1074;4.0;0.1
06;2021-02-01;1031;470;44259;1544;4.1;0.1
06;2021-02-02;1520;421;45779;1965;4.2;0.2
06;2021-02-03;342;139;46121;2104;4.3;0.2
06;2021-02-04;727;894;46848;2998;4.3;0.3
06;2021-02-05;1019;1107;47867;4105;4.4;0.4
06;2021-02-06;173;466;48040;4571;4.5;0.4
06;2021-02-07;14;49;48054;4620;4.5;0.4
06;2021-02-08;546;1087;48600;5707;4.5;0.5
06;2021-02-09;328;736;48928;6443;4.5;0.6
06;2021-02-10;389;667;49317;7110;4.6;0.7
06;2021-02-11;487;1065;49804;8175;4.6;0.8
06;2021-02-12;662;1311;50466;9486;4.7;0.9
06;2021-02-13;207;518;50673;10004;4.7;0.9
06;2021-02-14;21;5;50694;10009;4.7;0.9
06;2021-02-15;469;1261;51163;11270;4.7;1.0
06;2021-02-16;877;2003;52040;13273;4.8;1.2
06;2021-02-17;847;2120;52887;15393;4.9;1.4
06;2021-02-18;1833;2684;54720;18077;5.1;1.7
06;2021-02-19;1779;2152;56499;20229;5.2;1.9
06;2021-02-20;291;525;56790;20754;5.3;1.9
06;2021-02-21;25;56;56815;20810;5.3;1.9
06;2021-02-22;1093;1623;57908;22433;5.4;2.1
06;2021-02-23;1777;1555;59685;23988;5.5;2.2
06;2021-02-24;2129;1298;61814;25286;5.7;2.3
06;2021-02-25;3873;1692;65687;26978;6.1;2.5
06;2021-02-26;3417;1630;69104;28608;6.4;2.7
06;2021-02-27;1444;338;70548;28946;6.5;2.7
06;2021-02-28;104;25;70652;28971;6.5;2.7
06;2021-03-01;2443;840;73095;29811;6.8;2.8
06;2021-03-02;2476;998;75571;30809;7.0;2.9
06;2021-03-03;2882;588;78453;31397;7.3;2.9
06;2021-03-04;4647;632;83100;32029;7.7;3.0
06;2021-03-05;3931;1050;87031;33079;8.1;3.1
06;2021-03-06;11985;402;99016;33481;9.2;3.1
06;2021-03-07;10225;352;109241;33833;10.1;3.1
06;2021-03-08;4192;1219;113433;35052;10.5;3.2
06;2021-03-09;5023;981;118456;36033;11.0;3.3
06;2021-03-10;4744;891;123200;36924;11.4;3.4
06;2021-03-11;6747;941;129947;37865;12.0;3.5
06;2021-03-12;6898;1043;136845;38908;12.7;3.6
06;2021-03-13;11284;402;148129;39310;13.7;3.6
06;2021-03-14;518;56;148647;39366;13.8;3.6
06;2021-03-15;4855;787;153502;40153;14.2;3.7
06;2021-03-16;3784;1072;157286;41225;14.6;3.8
06;2021-03-17;6215;1917;163501;43142;15.1;4.0
06;2021-03-18;5138;1854;168639;44996;15.6;4.2
06;2021-03-19;6844;2064;175483;47060;16.3;4.4
06;2021-03-20;2381;560;177864;47620;16.5;4.4
06;2021-03-21;416;27;178280;47647;16.5;4.4
06;2021-03-22;4000;720;182280;48367;16.9;4.5
06;2021-03-23;5999;1238;188279;49605;17.4;4.6
06;2021-03-24;4236;3347;192515;52952;17.8;4.9
06;2021-03-25;5890;3274;198405;56226;18.4;5.2
06;2021-03-26;6375;2019;204780;58245;19.0;5.4
06;2021-03-27;2044;373;206824;58618;19.2;5.4
06;2021-03-28;219;8;207043;58626;19.2;5.4
06;2021-03-29;3212;2110;210255;60736;19.5;5.6
06;2021-03-30;5199;2550;215454;63286;20.0;5.9
06;2021-03-31;8064;1703;223518;64989;20.7;6.0
06;2021-04-01;7678;2522;231196;67511;21.4;6.3
06;2021-04-02;7258;2744;238454;70255;22.1;6.5
06;2021-04-03;2724;1379;241178;71634;22.3;6.6
06;2021-04-04;305;550;241483;72184;22.4;6.7
06;2021-04-05;1417;702;242900;72886;22.5;6.8
06;2021-04-06;6688;3341;249588;76227;23.1;7.1
06;2021-04-07;6238;3924;255826;80151;23.7;7.4
06;2021-04-08;5757;5691;261583;85842;24.2;8.0
06;2021-04-09;9403;5907;270986;91749;25.1;8.5
06;2021-04-10;2396;2789;273382;94538;25.3;8.8
06;2021-04-11;189;60;273571;94598;25.3;8.8
06;2021-04-12;4392;3550;277963;98148;25.8;9.1
06;2021-04-13;6395;5157;284358;103305;26.3;9.6
06;2021-04-14;5481;4520;289839;107825;26.9;10.0
06;2021-04-15;5560;4414;295399;112239;27.4;10.4
06;2021-04-16;7095;5219;302494;117458;28.0;10.9
06;2021-04-17;2789;3063;305283;120521;28.3;11.2
06;2021-04-18;272;228;305555;120749;28.3;11.2
06;2021-04-19;5507;4062;311062;124811;28.8;11.6
06;2021-04-20;5671;4894;316733;129705;29.3;12.0
06;2021-04-21;8338;4211;325071;133916;30.1;12.4
06;2021-04-22;8585;4231;333656;138147;30.9;12.8
06;2021-04-23;8856;4321;342512;142468;31.7;13.2
06;2021-04-24;2358;1500;344870;143968;32.0;13.3
06;2021-04-25;122;29;344992;143997;32.0;13.3
06;2021-04-26;4163;2328;349155;146325;32.3;13.6
06;2021-04-27;4596;4063;353751;150388;32.8;13.9
06;2021-04-28;4166;4591;357917;154979;33.2;14.4
06;2021-04-29;6097;5478;364014;160457;33.7;14.9
06;2021-04-30;6790;5206;370804;165663;34.4;15.3
06;2021-05-01;4168;846;374972;166509;34.7;15.4
06;2021-05-02;495;161;375467;166670;34.8;15.4
06;2021-05-03;6931;3581;382398;170251;35.4;15.8
06;2021-05-04;5757;5420;388155;175671;36.0;16.3
06;2021-05-05;4552;3925;392707;179596;36.4;16.6
06;2021-05-06;5237;4758;397944;184354;36.9;17.1
06;2021-05-07;5663;5687;403607;190041;37.4;17.6
06;2021-05-08;4879;1338;408486;191379;37.8;17.7
06;2021-05-09;206;308;408692;191687;37.9;17.8
06;2021-05-10;4836;5056;413528;196743;38.3;18.2
06;2021-05-11;4949;5570;418477;202313;38.8;18.7
06;2021-05-12;9112;4907;427589;207220;39.6;19.2
06;2021-05-13;9283;2151;436872;209371;40.5;19.4
06;2021-05-14;10863;3374;447735;212745;41.5;19.7
06;2021-05-15;9315;2246;457050;214991;42.3;19.9
06;2021-05-16;1506;288;458556;215279;42.5;19.9
06;2021-05-17;7527;3765;466083;219044;43.2;20.3
06;2021-05-18;9752;3235;475835;222279;44.1;20.6
06;2021-05-19;7720;2990;483555;225269;44.8;20.9
06;2021-05-20;7988;3684;491543;228953;45.5;21.2
06;2021-05-21;8836;3955;500379;232908;46.4;21.6
06;2021-05-22;3033;1326;503412;234234;46.6;21.7
06;2021-05-23;134;631;503546;234865;46.7;21.8
06;2021-05-24;3208;1002;506754;235867;46.9;21.9
06;2021-05-25;4766;4934;511520;240801;47.4;22.3
06;2021-05-26;5696;6634;517216;247435;47.9;22.9
06;2021-05-27;5594;6287;522810;253722;48.4;23.5
06;2021-05-28;4985;7295;527795;261017;48.9;24.2
06;2021-05-29;1638;2925;529433;263942;49.0;24.5
06;2021-05-30;258;1122;529691;265064;49.1;24.6
06;2021-05-31;4421;5133;534112;270197;49.5;25.0
06;2021-06-01;5760;7436;539872;277633;50.0;25.7
06;2021-06-02;3327;8556;543199;286189;50.3;26.5
06;2021-06-03;4551;8309;547750;294498;50.7;27.3
06;2021-06-04;5491;7734;553241;302232;51.3;28.0
06;2021-06-05;2468;3350;555709;305582;51.5;28.3
06;2021-06-06;186;237;555895;305819;51.5;28.3
06;2021-06-07;4150;5586;560045;311405;51.9;28.8
06;2021-06-08;4489;5226;564534;316631;52.3;29.3
06;2021-06-09;4126;7366;568660;323997;52.7;30.0
06;2021-06-10;4797;6873;573457;330870;53.1;30.7
06;2021-06-11;3932;8364;577389;339234;53.5;31.4
06;2021-06-12;1748;3752;579137;342986;53.7;31.8
06;2021-06-13;151;439;579288;343425;53.7;31.8
06;2021-06-14;2746;8607;582034;352032;53.9;32.6
06;2021-06-15;3298;9496;585332;361528;54.2;33.5
06;2021-06-16;3517;7023;588849;368551;54.6;34.1
06;2021-06-17;3687;7195;592536;375746;54.9;34.8
06;2021-06-18;2646;5929;595182;381675;55.1;35.4
06;2021-06-19;1320;1689;596502;383364;55.3;35.5
06;2021-06-20;211;349;596713;383713;55.3;35.5
06;2021-06-21;1737;6296;598450;390009;55.4;36.1
06;2021-06-22;2377;7363;600827;397372;55.7;36.8
06;2021-06-23;2097;6548;602924;403920;55.9;37.4
06;2021-06-24;3499;8976;606423;412896;56.2;38.3
06;2021-06-25;2309;9607;608732;422503;56.4;39.1
06;2021-06-26;893;2288;609625;424791;56.5;39.4
06;2021-06-27;379;1192;610004;425983;56.5;39.5
06;2021-06-28;2503;8124;612507;434107;56.7;40.2
06;2021-06-29;2396;7732;614903;441839;57.0;40.9
06;2021-06-30;1522;7693;616425;449532;57.1;41.6
06;2021-07-01;3573;7484;619998;457016;57.4;42.3
06;2021-07-02;4477;8284;624475;465300;57.9;43.1
06;2021-07-03;1240;4307;625715;469607;58.0;43.5
06;2021-07-04;318;303;626033;469910;58.0;43.5
06;2021-07-05;4080;5145;630113;475055;58.4;44.0
06;2021-07-06;2152;5816;632265;480871;58.6;44.6
06;2021-07-07;4189;5984;636454;486855;59.0;45.1
06;2021-07-08;3732;6336;640186;493191;59.3;45.7
06;2021-07-09;4869;6242;645055;499433;59.8;46.3
06;2021-07-10;1779;2332;646834;501765;59.9;46.5
06;2021-07-11;333;323;647167;502088;60.0;46.5
06;2021-07-12;4212;7153;651379;509241;60.3;47.2
06;2021-07-13;6127;9027;657506;518268;60.9;48.0
06;2021-07-14;1251;442;658757;518710;61.0;48.1
06;2021-07-15;6854;8041;665611;526751;61.7;48.8
06;2021-07-16;8541;9039;674152;535790;62.5;49.6
06;2021-07-17;3168;5478;677320;541268;62.7;50.1
06;2021-07-18;1079;5333;678399;546601;62.8;50.6
06;2021-07-19;6170;8035;684569;554636;63.4;51.4
06;2021-07-20;7604;10266;692173;564902;64.1;52.3
06;2021-07-21;8480;8720;700653;573622;64.9;53.1
06;2021-07-22;10456;7888;711109;581510;65.9;53.9
06;2021-07-23;9576;6934;720685;588444;66.8;54.5
06;2021-07-24;3306;3107;723991;591551;67.1;54.8
06;2021-07-25;1005;482;724996;592033;67.2;54.8
06;2021-07-26;7666;6892;732662;598925;67.9;55.5
06;2021-07-27;9278;5600;741940;604525;68.7;56.0
06;2021-07-28;7495;5417;749435;609942;69.4;56.5
06;2021-07-29;8894;5792;758329;615734;70.3;57.0
06;2021-07-30;8560;5567;766889;621301;71.0;57.6
06;2021-07-31;3831;3083;770720;624384;71.4;57.8
06;2021-08-01;901;437;771621;624821;71.5;57.9
06;2021-08-02;7152;4634;778773;629455;72.1;58.3
06;2021-08-03;6868;5509;785641;634964;72.8;58.8
06;2021-08-04;5840;3525;791481;638489;73.3;59.2
06;2021-08-05;6788;4478;798269;642967;74.0;59.6
06;2021-08-06;6124;6124;804393;649091;74.5;60.1
06;2021-08-07;2326;2473;806719;651564;74.7;60.4
06;2021-08-08;617;635;807336;652199;74.8;60.4
06;2021-08-09;4885;6041;812221;658240;75.2;61.0
06;2021-08-10;5522;6917;817743;665157;75.8;61.6
06;2021-08-11;4463;6219;822206;671376;76.2;62.2
06;2021-08-12;4746;6743;826952;678119;76.6;62.8
06;2021-08-13;3882;6455;830834;684574;77.0;63.4
06;2021-08-14;1599;2275;832433;686849;77.1;63.6
06;2021-08-15;420;639;832853;687488;77.2;63.7
06;2021-08-16;3298;6911;836151;694399;77.5;64.3
06;2021-08-17;3848;7779;839999;702178;77.8;65.1
06;2021-08-18;3001;6411;843000;708589;78.1;65.6
06;2021-08-19;4029;8128;847029;716717;78.5;66.4
06;2021-08-20;3324;6536;850353;723253;78.8;67.0
06;2021-08-21;1844;3593;852197;726846;79.0;67.3
06;2021-08-22;388;712;852585;727558;79.0;67.4
06;2021-08-23;2560;6530;855145;734088;79.2;68.0
06;2021-08-24;2900;6475;858045;740563;79.5;68.6
06;2021-08-25;2637;5682;860682;746245;79.7;69.1
06;2021-08-26;2738;6892;863420;753137;80.0;69.8
06;2021-08-27;2659;7078;866079;760215;80.2;70.4
06;2021-08-28;1299;3335;867378;763550;80.4;70.7
06;2021-08-29;298;827;867676;764377;80.4;70.8
06;2021-08-30;2469;6184;870145;770561;80.6;71.4
06;2021-08-31;2778;6857;872923;777418;80.9;72.0
06;2021-09-01;2944;5288;875867;782706;81.1;72.5
06;2021-09-02;2488;5492;878355;788198;81.4;73.0
06;2021-09-03;2192;5961;880547;794159;81.6;73.6
06;2021-09-04;1386;3496;881933;797655;81.7;73.9
06;2021-09-05;286;498;882219;798153;81.7;73.9
06;2021-09-06;1610;3928;883829;802081;81.9;74.3
06;2021-09-07;1645;4133;885474;806214;82.0;74.7
06;2021-09-08;1589;3217;887063;809431;82.2;75.0
06;2021-09-09;1457;3348;888520;812779;82.3;75.3
06;2021-09-10;1910;3502;890430;816281;82.5;75.6
06;2021-09-11;1087;2278;891517;818559;82.6;75.8
06;2021-09-12;145;325;891662;818884;82.6;75.9
06;2021-09-13;1317;2645;892979;821529;82.7;76.1
06;2021-09-14;1542;2279;894521;823808;82.9;76.3
06;2021-09-15;1507;2760;896028;826568;83.0;76.6
06;2021-09-16;1383;2427;897411;828995;83.1;76.8
06;2021-09-17;1514;2879;898925;831874;83.3;77.1
06;2021-09-18;694;1963;899619;833837;83.3;77.3
06;2021-09-19;108;289;899727;834126;83.4;77.3
06;2021-09-20;737;2137;900464;836263;83.4;77.5
06;2021-09-21;987;2481;901451;838744;83.5;77.7
06;2021-09-22;1048;2513;902499;841257;83.6;77.9
06;2021-09-23;818;2200;903317;843457;83.7;78.1
06;2021-09-24;921;2353;904238;845810;83.8;78.4
06;2021-09-25;492;1781;904730;847591;83.8;78.5
06;2021-09-26;101;224;904831;847815;83.8;78.5
06;2021-09-27;666;1618;905497;849433;83.9;78.7
06;2021-09-28;578;1603;906075;851036;83.9;78.8
06;2021-09-29;821;1791;906896;852827;84.0;79.0
06;2021-09-30;760;1707;907656;854534;84.1;79.2
06;2021-10-01;948;2088;908604;856622;84.2;79.4
06;2021-10-02;500;1348;909104;857970;84.2;79.5
06;2021-10-03;105;171;909209;858141;84.2;79.5
06;2021-10-04;423;1180;909632;859321;84.3;79.6
06;2021-10-05;616;1640;910248;860961;84.3;79.8
06;2021-10-06;761;1742;911009;862703;84.4;79.9
06;2021-10-07;639;1564;911648;864267;84.5;80.1
06;2021-10-08;850;1732;912498;865999;84.5;80.2
06;2021-10-09;519;1147;913017;867146;84.6;80.3
06;2021-10-10;137;209;913154;867355;84.6;80.4
06;2021-10-11;545;1252;913699;868607;84.6;80.5
07;2020-12-27;0;0;0;0;0.0;0.0
07;2020-12-28;0;0;0;0;0.0;0.0
07;2020-12-29;0;0;0;0;0.0;0.0
07;2020-12-30;0;0;0;0;0.0;0.0
07;2020-12-31;0;0;0;0;0.0;0.0
07;2021-01-01;7;0;7;0;0.0;0.0
07;2021-01-02;0;0;7;0;0.0;0.0
07;2021-01-03;0;0;7;0;0.0;0.0
07;2021-01-04;0;0;7;0;0.0;0.0
07;2021-01-05;0;0;7;0;0.0;0.0
07;2021-01-06;31;0;38;0;0.0;0.0
07;2021-01-07;130;1;168;1;0.1;0.0
07;2021-01-08;45;1;213;2;0.1;0.0
07;2021-01-09;17;0;230;2;0.1;0.0
07;2021-01-10;0;0;230;2;0.1;0.0
07;2021-01-11;157;1;387;3;0.1;0.0
07;2021-01-12;310;1;697;4;0.2;0.0
07;2021-01-13;308;4;1005;8;0.3;0.0
07;2021-01-14;475;0;1480;8;0.5;0.0
07;2021-01-15;188;0;1668;8;0.5;0.0
07;2021-01-16;17;0;1685;8;0.5;0.0
07;2021-01-17;2;0;1687;8;0.5;0.0
07;2021-01-18;364;5;2051;13;0.6;0.0
07;2021-01-19;830;3;2881;16;0.9;0.0
07;2021-01-20;605;8;3486;24;1.1;0.0
07;2021-01-21;454;3;3940;27;1.2;0.0
07;2021-01-22;292;0;4232;27;1.3;0.0
07;2021-01-23;107;0;4339;27;1.3;0.0
07;2021-01-24;0;0;4339;27;1.3;0.0
07;2021-01-25;164;0;4503;27;1.4;0.0
07;2021-01-26;491;4;4994;31;1.5;0.0
07;2021-01-27;558;14;5552;45;1.7;0.0
07;2021-01-28;1207;103;6759;148;2.1;0.0
07;2021-01-29;714;19;7473;167;2.3;0.1
07;2021-01-30;212;4;7685;171;2.4;0.1
07;2021-01-31;7;0;7692;171;2.4;0.1
07;2021-02-01;267;33;7959;204;2.4;0.1
07;2021-02-02;664;240;8623;444;2.6;0.1
07;2021-02-03;1046;235;9669;679;3.0;0.2
07;2021-02-04;722;270;10391;949;3.2;0.3
07;2021-02-05;484;255;10875;1204;3.3;0.4
07;2021-02-06;98;2;10973;1206;3.4;0.4
07;2021-02-07;12;1;10985;1207;3.4;0.4
07;2021-02-08;239;175;11224;1382;3.4;0.4
07;2021-02-09;490;331;11714;1713;3.6;0.5
07;2021-02-10;539;397;12253;2110;3.7;0.6
07;2021-02-11;400;282;12653;2392;3.9;0.7
07;2021-02-12;266;162;12919;2554;4.0;0.8
07;2021-02-13;69;20;12988;2574;4.0;0.8
07;2021-02-14;1;0;12989;2574;4.0;0.8
07;2021-02-15;270;130;13259;2704;4.1;0.8
07;2021-02-16;352;364;13611;3068;4.2;0.9
07;2021-02-17;466;330;14077;3398;4.3;1.0
07;2021-02-18;564;767;14641;4165;4.5;1.3
07;2021-02-19;458;508;15099;4673;4.6;1.4
07;2021-02-20;109;69;15208;4742;4.7;1.5
07;2021-02-21;15;0;15223;4742;4.7;1.5
07;2021-02-22;425;217;15648;4959;4.8;1.5
07;2021-02-23;648;622;16296;5581;5.0;1.7
07;2021-02-24;927;710;17223;6291;5.3;1.9
07;2021-02-25;709;539;17932;6830;5.5;2.1
07;2021-02-26;844;295;18776;7125;5.7;2.2
07;2021-02-27;190;145;18966;7270;5.8;2.2
07;2021-02-28;1;0;18967;7270;5.8;2.2
07;2021-03-01;438;215;19405;7485;5.9;2.3
07;2021-03-02;658;566;20063;8051;6.1;2.5
07;2021-03-03;695;537;20758;8588;6.4;2.6
07;2021-03-04;1101;360;21859;8948;6.7;2.7
07;2021-03-05;1083;378;22942;9326;7.0;2.9
07;2021-03-06;1127;99;24069;9425;7.4;2.9
07;2021-03-07;717;21;24786;9446;7.6;2.9
07;2021-03-08;353;320;25139;9766;7.7;3.0
07;2021-03-09;1090;439;26229;10205;8.0;3.1
07;2021-03-10;868;522;27097;10727;8.3;3.3
07;2021-03-11;1373;473;28470;11200;8.7;3.4
07;2021-03-12;1618;571;30088;11771;9.2;3.6
07;2021-03-13;683;105;30771;11876;9.4;3.6
07;2021-03-14;4;0;30775;11876;9.4;3.6
07;2021-03-15;525;292;31300;12168;9.6;3.7
07;2021-03-16;1208;488;32508;12656;9.9;3.9
07;2021-03-17;1189;782;33697;13438;10.3;4.1
07;2021-03-18;1217;418;34914;13856;10.7;4.2
07;2021-03-19;1269;426;36183;14282;11.1;4.4
07;2021-03-20;467;109;36650;14391;11.2;4.4
07;2021-03-21;3;2;36653;14393;11.2;4.4
07;2021-03-22;791;537;37444;14930;11.5;4.6
07;2021-03-23;1519;727;38963;15657;11.9;4.8
07;2021-03-24;1280;673;40243;16330;12.3;5.0
07;2021-03-25;1852;520;42095;16850;12.9;5.2
07;2021-03-26;1834;446;43929;17296;13.4;5.3
07;2021-03-27;384;101;44313;17397;13.6;5.3
07;2021-03-28;6;1;44319;17398;13.6;5.3
07;2021-03-29;789;361;45108;17759;13.8;5.4
07;2021-03-30;1526;516;46634;18275;14.3;5.6
07;2021-03-31;1662;508;48296;18783;14.8;5.7
07;2021-04-01;1590;667;49886;19450;15.3;6.0
07;2021-04-02;1522;443;51408;19893;15.7;6.1
07;2021-04-03;230;106;51638;19999;15.8;6.1
07;2021-04-04;3;1;51641;20000;15.8;6.1
07;2021-04-05;0;66;51641;20066;15.8;6.1
07;2021-04-06;1157;761;52798;20827;16.2;6.4
07;2021-04-07;1316;907;54114;21734;16.6;6.6
07;2021-04-08;1969;1183;56083;22917;17.2;7.0
07;2021-04-09;2423;576;58506;23493;17.9;7.2
07;2021-04-10;807;164;59313;23657;18.1;7.2
07;2021-04-11;340;13;59653;23670;18.2;7.2
07;2021-04-12;1287;604;60940;24274;18.6;7.4
07;2021-04-13;1767;1340;62707;25614;19.2;7.8
07;2021-04-14;1687;1020;64394;26634;19.7;8.1
07;2021-04-15;1443;848;65837;27482;20.1;8.4
07;2021-04-16;1506;918;67343;28400;20.6;8.7
07;2021-04-17;870;217;68213;28617;20.9;8.8
07;2021-04-18;699;39;68912;28656;21.1;8.8
07;2021-04-19;1161;574;70073;29230;21.4;8.9
07;2021-04-20;1440;1321;71513;30551;21.9;9.3
07;2021-04-21;1719;919;73232;31470;22.4;9.6
07;2021-04-22;1816;971;75048;32441;23.0;9.9
07;2021-04-23;1411;972;76459;33413;23.4;10.2
07;2021-04-24;962;254;77421;33667;23.7;10.3
07;2021-04-25;717;69;78138;33736;23.9;10.3
07;2021-04-26;1137;680;79275;34416;24.3;10.5
07;2021-04-27;1394;1567;80669;35983;24.7;11.0
07;2021-04-28;1635;1760;82304;37743;25.2;11.5
07;2021-04-29;1938;1536;84242;39279;25.8;12.0
07;2021-04-30;1660;1486;85902;40765;26.3;12.5
07;2021-05-01;960;120;86862;40885;26.6;12.5
07;2021-05-02;844;155;87706;41040;26.8;12.6
07;2021-05-03;1280;435;88986;41475;27.2;12.7
07;2021-05-04;2170;1568;91156;43043;27.9;13.2
07;2021-05-05;1744;1388;92900;44431;28.4;13.6
07;2021-05-06;2101;1588;95001;46019;29.1;14.1
07;2021-05-07;1597;1557;96598;47576;29.6;14.6
07;2021-05-08;1230;406;97828;47982;29.9;14.7
07;2021-05-09;1030;327;98858;48309;30.2;14.8
07;2021-05-10;1406;1177;100264;49486;30.7;15.1
07;2021-05-11;2470;1698;102734;51184;31.4;15.7
07;2021-05-12;2165;1279;104899;52463;32.1;16.0
07;2021-05-13;1712;273;106611;52736;32.6;16.1
07;2021-05-14;1734;999;108345;53735;33.1;16.4
07;2021-05-15;1626;500;109971;54235;33.6;16.6
07;2021-05-16;1442;214;111413;54449;34.1;16.7
07;2021-05-17;1771;859;113184;55308;34.6;16.9
07;2021-05-18;2295;1303;115479;56611;35.3;17.3
07;2021-05-19;2375;1000;117854;57611;36.1;17.6
07;2021-05-20;2165;1308;120019;58919;36.7;18.0
07;2021-05-21;1757;1312;121776;60231;37.3;18.4
07;2021-05-22;935;543;122711;60774;37.5;18.6
07;2021-05-23;856;157;123567;60931;37.8;18.6
07;2021-05-24;1648;339;125215;61270;38.3;18.7
07;2021-05-25;2184;1481;127399;62751;39.0;19.2
07;2021-05-26;1526;1379;128925;64130;39.4;19.6
07;2021-05-27;2015;1412;130940;65542;40.1;20.1
07;2021-05-28;1771;2079;132711;67621;40.6;20.7
07;2021-05-29;942;683;133653;68304;40.9;20.9
07;2021-05-30;622;570;134275;68874;41.1;21.1
07;2021-05-31;1133;1284;135408;70158;41.4;21.5
07;2021-06-01;2152;2001;137560;72159;42.1;22.1
07;2021-06-02;1532;1653;139092;73812;42.6;22.6
07;2021-06-03;1712;1254;140804;75066;43.1;23.0
07;2021-06-04;1676;1594;142480;76660;43.6;23.5
07;2021-06-05;987;955;143467;77615;43.9;23.7
07;2021-06-06;598;624;144065;78239;44.1;23.9
07;2021-06-07;961;1193;145026;79432;44.4;24.3
07;2021-06-08;1547;1772;146573;81204;44.8;24.8
07;2021-06-09;1030;1421;147603;82625;45.2;25.3
07;2021-06-10;789;1388;148392;84013;45.4;25.7
07;2021-06-11;1154;2032;149546;86045;45.8;26.3
07;2021-06-12;643;1217;150189;87262;45.9;26.7
07;2021-06-13;395;444;150584;87706;46.1;26.8
07;2021-06-14;566;1958;151150;89664;46.2;27.4
07;2021-06-15;936;2552;152086;92216;46.5;28.2
07;2021-06-16;1023;1854;153109;94070;46.8;28.8
07;2021-06-17;885;1949;153994;96019;47.1;29.4
07;2021-06-18;868;2282;154862;98301;47.4;30.1
07;2021-06-19;603;1452;155465;99753;47.6;30.5
07;2021-06-20;369;729;155834;100482;47.7;30.7
07;2021-06-21;516;2143;156350;102625;47.8;31.4
07;2021-06-22;655;2662;157005;105287;48.0;32.2
07;2021-06-23;680;1960;157685;107247;48.2;32.8
07;2021-06-24;646;1852;158331;109099;48.4;33.4
07;2021-06-25;701;2177;159032;111276;48.7;34.0
07;2021-06-26;362;1430;159394;112706;48.8;34.5
07;2021-06-27;285;1073;159679;113779;48.9;34.8
07;2021-06-28;506;2241;160185;116020;49.0;35.5
07;2021-06-29;540;2988;160725;119008;49.2;36.4
07;2021-06-30;822;2278;161547;121286;49.4;37.1
07;2021-07-01;776;1951;162323;123237;49.7;37.7
07;2021-07-02;880;2298;163203;125535;49.9;38.4
07;2021-07-03;421;1137;163624;126672;50.1;38.8
07;2021-07-04;211;852;163835;127524;50.1;39.0
07;2021-07-05;670;1685;164505;129209;50.3;39.5
07;2021-07-06;880;2630;165385;131839;50.6;40.3
07;2021-07-07;969;1951;166354;133790;50.9;40.9
07;2021-07-08;928;1959;167282;135749;51.2;41.5
07;2021-07-09;995;2262;168277;138011;51.5;42.2
07;2021-07-10;598;1100;168875;139111;51.7;42.6
07;2021-07-11;239;614;169114;139725;51.7;42.7
07;2021-07-12;807;1769;169921;141494;52.0;43.3
07;2021-07-13;1770;3173;171691;144667;52.5;44.3
07;2021-07-14;167;133;171858;144800;52.6;44.3
07;2021-07-15;1960;2468;173818;147268;53.2;45.1
07;2021-07-16;2056;1987;175874;149255;53.8;45.7
07;2021-07-17;1484;1250;177358;150505;54.3;46.0
07;2021-07-18;771;480;178129;150985;54.5;46.2
07;2021-07-19;1514;1689;179643;152674;55.0;46.7
07;2021-07-20;2518;2678;182161;155352;55.7;47.5
07;2021-07-21;1856;1917;184017;157269;56.3;48.1
07;2021-07-22;1918;1374;185935;158643;56.9;48.5
07;2021-07-23;2264;1688;188199;160331;57.6;49.0
07;2021-07-24;1642;1112;189841;161443;58.1;49.4
07;2021-07-25;34;22;189875;161465;58.1;49.4
07;2021-07-26;2199;1546;192074;163011;58.8;49.9
07;2021-07-27;3017;1916;195091;164927;59.7;50.5
07;2021-07-28;1643;1309;196734;166236;60.2;50.9
07;2021-07-29;2540;1274;199274;167510;61.0;51.2
07;2021-07-30;1356;1415;200630;168925;61.4;51.7
07;2021-07-31;1506;922;202136;169847;61.8;52.0
07;2021-08-01;74;26;202210;169873;61.9;52.0
07;2021-08-02;1516;1133;203726;171006;62.3;52.3
07;2021-08-03;2418;1911;206144;172917;63.1;52.9
07;2021-08-04;1947;1033;208091;173950;63.7;53.2
07;2021-08-05;1893;1296;209984;175246;64.2;53.6
07;2021-08-06;2033;1711;212017;176957;64.9;54.1
07;2021-08-07;998;556;213015;177513;65.2;54.3
07;2021-08-08;12;23;213027;177536;65.2;54.3
07;2021-08-09;1258;1382;214285;178918;65.6;54.7
07;2021-08-10;1599;2259;215884;181177;66.0;55.4
07;2021-08-11;1399;1600;217283;182777;66.5;55.9
07;2021-08-12;1105;1485;218388;184262;66.8;56.4
07;2021-08-13;1182;1790;219570;186052;67.2;56.9
07;2021-08-14;512;766;220082;186818;67.3;57.2
07;2021-08-15;9;28;220091;186846;67.3;57.2
07;2021-08-16;754;1328;220845;188174;67.6;57.6
07;2021-08-17;1339;2278;222184;190452;68.0;58.3
07;2021-08-18;879;1517;223063;191969;68.2;58.7
07;2021-08-19;1149;1697;224212;193666;68.6;59.2
07;2021-08-20;899;2086;225111;195752;68.9;59.9
07;2021-08-21;364;549;225475;196301;69.0;60.1
07;2021-08-22;7;23;225482;196324;69.0;60.1
07;2021-08-23;467;1307;225949;197631;69.1;60.5
07;2021-08-24;1125;2312;227074;199943;69.5;61.2
07;2021-08-25;692;1838;227766;201781;69.7;61.7
07;2021-08-26;690;2021;228456;203802;69.9;62.3
07;2021-08-27;784;1830;229240;205632;70.1;62.9
07;2021-08-28;338;608;229578;206240;70.2;63.1
07;2021-08-29;1;33;229579;206273;70.2;63.1
07;2021-08-30;429;1304;230008;207577;70.4;63.5
07;2021-08-31;1094;2203;231102;209780;70.7;64.2
07;2021-09-01;543;1346;231645;211126;70.9;64.6
07;2021-09-02;605;1384;232250;212510;71.1;65.0
07;2021-09-03;741;1775;232991;214285;71.3;65.6
07;2021-09-04;309;696;233300;214981;71.4;65.8
07;2021-09-05;26;28;233326;215009;71.4;65.8
07;2021-09-06;403;906;233729;215915;71.5;66.1
07;2021-09-07;523;1296;234252;217211;71.7;66.5
07;2021-09-08;443;1042;234695;218253;71.8;66.8
07;2021-09-09;479;858;235174;219111;71.9;67.0
07;2021-09-10;518;1245;235692;220356;72.1;67.4
07;2021-09-11;167;628;235859;220984;72.2;67.6
07;2021-09-12;0;7;235859;220991;72.2;67.6
07;2021-09-13;351;524;236210;221515;72.3;67.8
07;2021-09-14;535;885;236745;222400;72.4;68.0
07;2021-09-15;304;744;237049;223144;72.5;68.3
07;2021-09-16;430;568;237479;223712;72.7;68.4
07;2021-09-17;318;802;237797;224514;72.7;68.7
07;2021-09-18;100;454;237897;224968;72.8;68.8
07;2021-09-19;3;32;237900;225000;72.8;68.8
07;2021-09-20;239;365;238139;225365;72.9;68.9
07;2021-09-21;286;696;238425;226061;72.9;69.2
07;2021-09-22;172;726;238597;226787;73.0;69.4
07;2021-09-23;189;532;238786;227319;73.1;69.5
07;2021-09-24;278;838;239064;228157;73.1;69.8
07;2021-09-25;49;206;239113;228363;73.2;69.9
07;2021-09-26;6;17;239119;228380;73.2;69.9
07;2021-09-27;145;458;239264;228838;73.2;70.0
07;2021-09-28;178;522;239442;229360;73.3;70.2
07;2021-09-29;127;513;239569;229873;73.3;70.3
07;2021-09-30;174;451;239743;230324;73.3;70.5
07;2021-10-01;220;593;239963;230917;73.4;70.6
07;2021-10-02;76;137;240039;231054;73.4;70.7
07;2021-10-03;10;15;240049;231069;73.4;70.7
07;2021-10-04;161;366;240210;231435;73.5;70.8
07;2021-10-05;206;446;240416;231881;73.5;70.9
07;2021-10-06;161;330;240577;232211;73.6;71.0
07;2021-10-07;140;438;240717;232649;73.6;71.2
07;2021-10-08;207;428;240924;233077;73.7;71.3
07;2021-10-09;65;95;240989;233172;73.7;71.3
07;2021-10-10;0;1;240989;233173;73.7;71.3
07;2021-10-11;97;267;241086;233440;73.8;71.4
08;2020-12-27;1;0;1;0;0.0;0.0
08;2020-12-28;0;0;1;0;0.0;0.0
08;2020-12-29;0;0;1;0;0.0;0.0
08;2020-12-30;0;0;1;0;0.0;0.0
08;2020-12-31;0;0;1;0;0.0;0.0
08;2021-01-01;0;0;1;0;0.0;0.0
08;2021-01-02;0;0;1;0;0.0;0.0
08;2021-01-03;2;0;3;0;0.0;0.0
08;2021-01-04;24;0;27;0;0.0;0.0
08;2021-01-05;1;0;28;0;0.0;0.0
08;2021-01-06;0;0;28;0;0.0;0.0
08;2021-01-07;188;0;216;0;0.1;0.0
08;2021-01-08;315;1;531;1;0.2;0.0
08;2021-01-09;115;0;646;1;0.2;0.0
08;2021-01-10;1;0;647;1;0.2;0.0
08;2021-01-11;66;0;713;1;0.3;0.0
08;2021-01-12;157;0;870;1;0.3;0.0
08;2021-01-13;480;1;1350;2;0.5;0.0
08;2021-01-14;538;9;1888;11;0.7;0.0
08;2021-01-15;288;2;2176;13;0.8;0.0
08;2021-01-16;107;0;2283;13;0.9;0.0
08;2021-01-17;2;0;2285;13;0.9;0.0
08;2021-01-18;371;2;2656;15;1.0;0.0
08;2021-01-19;873;2;3529;17;1.3;0.0
08;2021-01-20;909;4;4438;21;1.7;0.0
08;2021-01-21;743;1;5181;22;2.0;0.0
08;2021-01-22;678;1;5859;23;2.2;0.0
08;2021-01-23;237;0;6096;23;2.3;0.0
08;2021-01-24;0;0;6096;23;2.3;0.0
08;2021-01-25;209;0;6305;23;2.4;0.0
08;2021-01-26;303;2;6608;25;2.5;0.0
08;2021-01-27;410;1;7018;26;2.6;0.0
08;2021-01-28;565;183;7583;209;2.9;0.1
08;2021-01-29;588;182;8171;391;3.1;0.1
08;2021-01-30;222;63;8393;454;3.2;0.2
08;2021-01-31;0;0;8393;454;3.2;0.2
08;2021-02-01;80;46;8473;500;3.2;0.2
08;2021-02-02;192;172;8665;672;3.3;0.3
08;2021-02-03;140;169;8805;841;3.3;0.3
08;2021-02-04;309;287;9114;1128;3.4;0.4
08;2021-02-05;499;360;9613;1488;3.6;0.6
08;2021-02-06;149;75;9762;1563;3.7;0.6
08;2021-02-07;8;0;9770;1563;3.7;0.6
08;2021-02-08;40;172;9810;1735;3.7;0.7
08;2021-02-09;221;646;10031;2381;3.8;0.9
08;2021-02-10;334;639;10365;3020;3.9;1.1
08;2021-02-11;467;365;10832;3385;4.1;1.3
08;2021-02-12;676;386;11508;3771;4.3;1.4
08;2021-02-13;140;114;11648;3885;4.4;1.5
08;2021-02-14;3;60;11651;3945;4.4;1.5
08;2021-02-15;227;208;11878;4153;4.5;1.6
08;2021-02-16;130;374;12008;4527;4.5;1.7
08;2021-02-17;112;414;12120;4941;4.6;1.9
08;2021-02-18;215;518;12335;5459;4.6;2.1
08;2021-02-19;305;423;12640;5882;4.8;2.2
08;2021-02-20;7;206;12647;6088;4.8;2.3
08;2021-02-21;0;0;12647;6088;4.8;2.3
08;2021-02-22;131;180;12778;6268;4.8;2.4
08;2021-02-23;150;319;12928;6587;4.9;2.5
08;2021-02-24;163;388;13091;6975;4.9;2.6
08;2021-02-25;500;529;13591;7504;5.1;2.8
08;2021-02-26;603;626;14194;8130;5.3;3.1
08;2021-02-27;318;194;14512;8324;5.5;3.1
08;2021-02-28;19;1;14531;8325;5.5;3.1
08;2021-03-01;200;105;14731;8430;5.5;3.2
08;2021-03-02;654;281;15385;8711;5.8;3.3
08;2021-03-03;899;202;16284;8913;6.1;3.4
08;2021-03-04;735;335;17019;9248;6.4;3.5
08;2021-03-05;1021;543;18040;9791;6.8;3.7
08;2021-03-06;695;141;18735;9932;7.1;3.7
08;2021-03-07;75;2;18810;9934;7.1;3.7
08;2021-03-08;217;125;19027;10059;7.2;3.8
08;2021-03-09;688;156;19715;10215;7.4;3.8
08;2021-03-10;1038;124;20753;10339;7.8;3.9
08;2021-03-11;982;255;21735;10594;8.2;4.0
08;2021-03-12;1632;519;23367;11113;8.8;4.2
08;2021-03-13;798;125;24165;11238;9.1;4.2
08;2021-03-14;22;0;24187;11238;9.1;4.2
08;2021-03-15;291;73;24478;11311;9.2;4.3
08;2021-03-16;563;40;25041;11351;9.4;4.3
08;2021-03-17;804;66;25845;11417;9.7;4.3
08;2021-03-18;817;162;26662;11579;10.0;4.4
08;2021-03-19;1134;286;27796;11865;10.5;4.5
08;2021-03-20;511;20;28307;11885;10.7;4.5
08;2021-03-21;13;1;28320;11886;10.7;4.5
08;2021-03-22;367;45;28687;11931;10.8;4.5
08;2021-03-23;733;63;29420;11994;11.1;4.5
08;2021-03-24;1327;75;30747;12069;11.6;4.5
08;2021-03-25;1906;98;32653;12167;12.3;4.6
08;2021-03-26;2571;174;35224;12341;13.3;4.6
08;2021-03-27;898;125;36122;12466;13.6;4.7
08;2021-03-28;228;7;36350;12473;13.7;4.7
08;2021-03-29;261;184;36611;12657;13.8;4.8
08;2021-03-30;832;488;37443;13145;14.1;5.0
08;2021-03-31;852;534;38295;13679;14.4;5.2
08;2021-04-01;1687;453;39982;14132;15.1;5.3
08;2021-04-02;1497;523;41479;14655;15.6;5.5
08;2021-04-03;1329;205;42808;14860;16.1;5.6
08;2021-04-04;134;4;42942;14864;16.2;5.6
08;2021-04-05;17;0;42959;14864;16.2;5.6
08;2021-04-06;702;484;43661;15348;16.4;5.8
08;2021-04-07;909;705;44570;16053;16.8;6.0
08;2021-04-08;1745;523;46315;16576;17.4;6.2
08;2021-04-09;2347;730;48662;17306;18.3;6.5
08;2021-04-10;1445;229;50107;17535;18.9;6.6
08;2021-04-11;10;6;50117;17541;18.9;6.6
08;2021-04-12;671;218;50788;17759;19.1;6.7
08;2021-04-13;1309;613;52097;18372;19.6;6.9
08;2021-04-14;1280;867;53377;19239;20.1;7.2
08;2021-04-15;1606;810;54983;20049;20.7;7.6
08;2021-04-16;1873;884;56856;20933;21.4;7.9
08;2021-04-17;1112;403;57968;21336;21.8;8.0
08;2021-04-18;23;14;57991;21350;21.8;8.0
08;2021-04-19;1151;301;59142;21651;22.3;8.2
08;2021-04-20;1120;544;60262;22195;22.7;8.4
08;2021-04-21;1139;747;61401;22942;23.1;8.6
08;2021-04-22;1326;880;62727;23822;23.6;9.0
08;2021-04-23;1675;1174;64402;24996;24.3;9.4
08;2021-04-24;1325;647;65727;25643;24.8;9.7
08;2021-04-25;26;198;65753;25841;24.8;9.7
08;2021-04-26;1040;157;66793;25998;25.2;9.8
08;2021-04-27;1338;601;68131;26599;25.7;10.0
08;2021-04-28;1453;682;69584;27281;26.2;10.3
08;2021-04-29;1174;1316;70758;28597;26.6;10.8
08;2021-04-30;1769;1618;72527;30215;27.3;11.4
08;2021-05-01;1049;497;73576;30712;27.7;11.6
08;2021-05-02;627;183;74203;30895;27.9;11.6
08;2021-05-03;1172;376;75375;31271;28.4;11.8
08;2021-05-04;1328;876;76703;32147;28.9;12.1
08;2021-05-05;1567;1336;78270;33483;29.5;12.6
08;2021-05-06;1971;1664;80241;35147;30.2;13.2
08;2021-05-07;1860;2102;82101;37249;30.9;14.0
08;2021-05-08;922;768;83023;38017;31.3;14.3
08;2021-05-09;443;71;83466;38088;31.4;14.3
08;2021-05-10;1192;665;84658;38753;31.9;14.6
08;2021-05-11;1907;946;86565;39699;32.6;15.0
08;2021-05-12;1809;1239;88374;40938;33.3;15.4
08;2021-05-13;1306;620;89680;41558;33.8;15.7
08;2021-05-14;2535;1037;92215;42595;34.7;16.0
08;2021-05-15;1820;712;94035;43307;35.4;16.3
08;2021-05-16;820;102;94855;43409;35.7;16.3
08;2021-05-17;700;906;95555;44315;36.0;16.7
08;2021-05-18;1250;841;96805;45156;36.5;17.0
08;2021-05-19;1611;960;98416;46116;37.1;17.4
08;2021-05-20;2147;964;100563;47080;37.9;17.7
08;2021-05-21;2339;1274;102902;48354;38.8;18.2
08;2021-05-22;1817;763;104719;49117;39.4;18.5
08;2021-05-23;864;90;105583;49207;39.8;18.5
08;2021-05-24;716;106;106299;49313;40.0;18.6
08;2021-05-25;1456;669;107755;49982;40.6;18.8
08;2021-05-26;1529;1011;109284;50993;41.2;19.2
08;2021-05-27;2006;1146;111290;52139;41.9;19.6
08;2021-05-28;1973;1822;113263;53961;42.7;20.3
08;2021-05-29;1767;966;115030;54927;43.3;20.7
08;2021-05-30;836;102;115866;55029;43.6;20.7
08;2021-05-31;755;570;116621;55599;43.9;20.9
08;2021-06-01;1350;879;117971;56478;44.4;21.3
08;2021-06-02;1295;1194;119266;57672;44.9;21.7
08;2021-06-03;1386;1524;120652;59196;45.4;22.3
08;2021-06-04;1777;2419;122429;61615;46.1;23.2
08;2021-06-05;1176;1380;123605;62995;46.6;23.7
08;2021-06-06;907;107;124512;63102;46.9;23.8
08;2021-06-07;661;1174;125173;64276;47.1;24.2
08;2021-06-08;931;1496;126104;65772;47.5;24.8
08;2021-06-09;840;1391;126944;67163;47.8;25.3
08;2021-06-10;1719;1563;128663;68726;48.5;25.9
08;2021-06-11;1721;2211;130384;70937;49.1;26.7
08;2021-06-12;1417;1528;131801;72465;49.6;27.3
08;2021-06-13;385;598;132186;73063;49.8;27.5
08;2021-06-14;380;1304;132566;74367;49.9;28.0
08;2021-06-15;742;1548;133308;75915;50.2;28.6
08;2021-06-16;808;2054;134116;77969;50.5;29.4
08;2021-06-17;1285;1854;135401;79823;51.0;30.1
08;2021-06-18;1610;2594;137011;82417;51.6;31.0
08;2021-06-19;1324;1407;138335;83824;52.1;31.6
08;2021-06-20;117;423;138452;84247;52.1;31.7
08;2021-06-21;494;1395;138946;85642;52.3;32.3
08;2021-06-22;812;2023;139758;87665;52.6;33.0
08;2021-06-23;859;1672;140617;89337;53.0;33.6
08;2021-06-24;1038;1923;141655;91260;53.3;34.4
08;2021-06-25;1084;2735;142739;93995;53.8;35.4
08;2021-06-26;1010;1784;143749;95779;54.1;36.1
08;2021-06-27;351;643;144100;96422;54.3;36.3
08;2021-06-28;397;1323;144497;97745;54.4;36.8
08;2021-06-29;627;1472;145124;99217;54.7;37.4
08;2021-06-30;857;1689;145981;100906;55.0;38.0
08;2021-07-01;887;2194;146868;103100;55.3;38.8
08;2021-07-02;939;2645;147807;105745;55.7;39.8
08;2021-07-03;784;2145;148591;107890;56.0;40.6
08;2021-07-04;128;861;148719;108751;56.0;41.0
08;2021-07-05;104;1195;148823;109946;56.0;41.4
08;2021-07-06;425;1835;149248;111781;56.2;42.1
08;2021-07-07;364;1780;149612;113561;56.3;42.8
08;2021-07-08;716;2016;150328;115577;56.6;43.5
08;2021-07-09;732;2432;151060;118009;56.9;44.4
08;2021-07-10;652;2003;151712;120012;57.1;45.2
08;2021-07-11;238;725;151950;120737;57.2;45.5
08;2021-07-12;312;1192;152262;121929;57.3;45.9
08;2021-07-13;947;1788;153209;123717;57.7;46.6
08;2021-07-14;179;329;153388;124046;57.8;46.7
08;2021-07-15;759;2448;154147;126494;58.1;47.6
08;2021-07-16;1084;2408;155231;128902;58.5;48.5
08;2021-07-17;993;2108;156224;131010;58.8;49.3
08;2021-07-18;346;741;156570;131751;59.0;49.6
08;2021-07-19;459;918;157029;132669;59.1;50.0
08;2021-07-20;878;1435;157907;134104;59.5;50.5
08;2021-07-21;1237;1717;159144;135821;59.9;51.2
08;2021-07-22;1150;2167;160294;137988;60.4;52.0
08;2021-07-23;1584;2444;161878;140432;61.0;52.9
08;2021-07-24;1309;1924;163187;142356;61.5;53.6
08;2021-07-25;774;445;163961;142801;61.7;53.8
08;2021-07-26;1324;846;165285;143647;62.2;54.1
08;2021-07-27;2186;1408;167471;145055;63.1;54.6
08;2021-07-28;2413;1454;169884;146509;64.0;55.2
08;2021-07-29;2601;1347;172485;147856;65.0;55.7
08;2021-07-30;2601;1587;175086;149443;65.9;56.3
08;2021-07-31;1972;1075;177058;150518;66.7;56.7
08;2021-08-01;935;301;177993;150819;67.0;56.8
08;2021-08-02;1255;682;179248;151501;67.5;57.1
08;2021-08-03;1634;824;180882;152325;68.1;57.4
08;2021-08-04;1493;665;182375;152990;68.7;57.6
08;2021-08-05;1905;977;184280;153967;69.4;58.0
08;2021-08-06;2589;1099;186869;155066;70.4;58.4
08;2021-08-07;1673;1162;188542;156228;71.0;58.8
08;2021-08-08;585;374;189127;156602;71.2;59.0
08;2021-08-09;672;534;189799;157136;71.5;59.2
08;2021-08-10;879;750;190678;157886;71.8;59.5
08;2021-08-11;525;791;191203;158677;72.0;59.8
08;2021-08-12;1161;1080;192364;159757;72.4;60.2
08;2021-08-13;1157;1013;193521;160770;72.9;60.5
08;2021-08-14;587;913;194108;161683;73.1;60.9
08;2021-08-15;137;273;194245;161956;73.2;61.0
08;2021-08-16;218;1177;194463;163133;73.2;61.4
08;2021-08-17;514;1210;194977;164343;73.4;61.9
08;2021-08-18;281;1263;195258;165606;73.5;62.4
08;2021-08-19;606;1888;195864;167494;73.8;63.1
08;2021-08-20;685;2178;196549;169672;74.0;63.9
08;2021-08-21;273;1340;196822;171012;74.1;64.4
08;2021-08-22;104;900;196926;171912;74.2;64.7
08;2021-08-23;160;1448;197086;173360;74.2;65.3
08;2021-08-24;364;1752;197450;175112;74.4;65.9
08;2021-08-25;323;1248;197773;176360;74.5;66.4
08;2021-08-26;502;2064;198275;178424;74.7;67.2
08;2021-08-27;451;2324;198726;180748;74.8;68.1
08;2021-08-28;262;1289;198988;182037;74.9;68.6
08;2021-08-29;169;563;199157;182600;75.0;68.8
08;2021-08-30;302;1156;199459;183756;75.1;69.2
08;2021-08-31;360;1248;199819;185004;75.3;69.7
08;2021-09-01;417;1232;200236;186236;75.4;70.1
08;2021-09-02;466;1150;200702;187386;75.6;70.6
08;2021-09-03;464;1553;201166;188939;75.8;71.2
08;2021-09-04;349;1413;201515;190352;75.9;71.7
08;2021-09-05;106;173;201621;190525;75.9;71.8
08;2021-09-06;196;404;201817;190929;76.0;71.9
08;2021-09-07;205;488;202022;191417;76.1;72.1
08;2021-09-08;281;500;202303;191917;76.2;72.3
08;2021-09-09;344;590;202647;192507;76.3;72.5
08;2021-09-10;495;780;203142;193287;76.5;72.8
08;2021-09-11;383;732;203525;194019;76.6;73.1
08;2021-09-12;52;71;203577;194090;76.7;73.1
08;2021-09-13;385;174;203962;194264;76.8;73.2
08;2021-09-14;247;275;204209;194539;76.9;73.3
08;2021-09-15;219;318;204428;194857;77.0;73.4
08;2021-09-16;230;422;204658;195279;77.1;73.5
08;2021-09-17;322;501;204980;195780;77.2;73.7
08;2021-09-18;172;430;205152;196210;77.3;73.9
08;2021-09-19;29;90;205181;196300;77.3;73.9
08;2021-09-20;54;237;205235;196537;77.3;74.0
08;2021-09-21;123;277;205358;196814;77.3;74.1
08;2021-09-22;130;368;205488;197182;77.4;74.3
08;2021-09-23;173;412;205661;197594;77.5;74.4
08;2021-09-24;162;517;205823;198111;77.5;74.6
08;2021-09-25;121;415;205944;198526;77.6;74.8
08;2021-09-26;23;105;205967;198631;77.6;74.8
08;2021-09-27;49;211;206016;198842;77.6;74.9
08;2021-09-28;80;226;206096;199068;77.6;75.0
08;2021-09-29;116;339;206212;199407;77.7;75.1
08;2021-09-30;147;376;206359;199783;77.7;75.2
08;2021-10-01;163;465;206522;200248;77.8;75.4
08;2021-10-02;141;288;206663;200536;77.8;75.5
08;2021-10-03;24;67;206687;200603;77.8;75.5
08;2021-10-04;58;347;206745;200950;77.9;75.7
08;2021-10-05;79;172;206824;201122;77.9;75.7
08;2021-10-06;92;242;206916;201364;77.9;75.8
08;2021-10-07;102;196;207018;201560;78.0;75.9
08;2021-10-08;152;355;207170;201915;78.0;76.0
08;2021-10-09;136;331;207306;202246;78.1;76.2
08;2021-10-10;34;47;207340;202293;78.1;76.2
08;2021-10-11;58;83;207398;202376;78.1;76.2
09;2020-12-27;0;0;0;0;0.0;0.0
09;2020-12-28;1;0;1;0;0.0;0.0
09;2020-12-29;0;0;1;0;0.0;0.0
09;2020-12-30;0;0;1;0;0.0;0.0
09;2020-12-31;0;0;1;0;0.0;0.0
09;2021-01-01;0;0;1;0;0.0;0.0
09;2021-01-02;0;0;1;0;0.0;0.0
09;2021-01-03;0;0;1;0;0.0;0.0
09;2021-01-04;2;1;3;1;0.0;0.0
09;2021-01-05;0;0;3;1;0.0;0.0
09;2021-01-06;3;0;6;1;0.0;0.0
09;2021-01-07;257;2;263;3;0.2;0.0
09;2021-01-08;228;0;491;3;0.3;0.0
09;2021-01-09;103;0;594;3;0.4;0.0
09;2021-01-10;60;0;654;3;0.4;0.0
09;2021-01-11;176;0;830;3;0.5;0.0
09;2021-01-12;303;0;1133;3;0.7;0.0
09;2021-01-13;196;0;1329;3;0.9;0.0
09;2021-01-14;432;7;1761;10;1.2;0.0
09;2021-01-15;223;1;1984;11;1.3;0.0
09;2021-01-16;192;3;2176;14;1.4;0.0
09;2021-01-17;123;0;2299;14;1.5;0.0
09;2021-01-18;263;2;2562;16;1.7;0.0
09;2021-01-19;255;1;2817;17;1.8;0.0
09;2021-01-20;346;2;3163;19;2.1;0.0
09;2021-01-21;330;1;3493;20;2.3;0.0
09;2021-01-22;328;1;3821;21;2.5;0.0
09;2021-01-23;237;0;4058;21;2.7;0.0
09;2021-01-24;85;1;4143;22;2.7;0.0
09;2021-01-25;208;12;4351;34;2.9;0.0
09;2021-01-26;629;25;4980;59;3.3;0.0
09;2021-01-27;472;49;5452;108;3.6;0.1
09;2021-01-28;286;205;5738;313;3.8;0.2
09;2021-01-29;251;129;5989;442;3.9;0.3
09;2021-01-30;143;55;6132;497;4.0;0.3
09;2021-01-31;56;10;6188;507;4.1;0.3
09;2021-02-01;81;142;6269;649;4.1;0.4
09;2021-02-02;58;295;6327;944;4.2;0.6
09;2021-02-03;87;204;6414;1148;4.2;0.8
09;2021-02-04;49;299;6463;1447;4.2;0.9
09;2021-02-05;90;154;6553;1601;4.3;1.1
09;2021-02-06;68;51;6621;1652;4.3;1.1
09;2021-02-07;6;71;6627;1723;4.3;1.1
09;2021-02-08;23;177;6650;1900;4.4;1.2
09;2021-02-09;55;290;6705;2190;4.4;1.4
09;2021-02-10;14;195;6719;2385;4.4;1.6
09;2021-02-11;6;219;6725;2604;4.4;1.7
09;2021-02-12;147;176;6872;2780;4.5;1.8
09;2021-02-13;8;144;6880;2924;4.5;1.9
09;2021-02-14;0;52;6880;2976;4.5;2.0
09;2021-02-15;76;133;6956;3109;4.6;2.0
09;2021-02-16;227;509;7183;3618;4.7;2.4
09;2021-02-17;83;387;7266;4005;4.8;2.6
09;2021-02-18;87;447;7353;4452;4.8;2.9
09;2021-02-19;63;284;7416;4736;4.9;3.1
09;2021-02-20;58;199;7474;4935;4.9;3.2
09;2021-02-21;0;51;7474;4986;4.9;3.3
09;2021-02-22;127;217;7601;5203;5.0;3.4
09;2021-02-23;161;145;7762;5348;5.1;3.5
09;2021-02-24;74;178;7836;5526;5.1;3.6
09;2021-02-25;211;169;8047;5695;5.3;3.7
09;2021-02-26;162;177;8209;5872;5.4;3.9
09;2021-02-27;65;71;8274;5943;5.4;3.9
09;2021-02-28;44;17;8318;5960;5.5;3.9
09;2021-03-01;248;95;8566;6055;5.6;4.0
09;2021-03-02;282;77;8848;6132;5.8;4.0
09;2021-03-03;252;132;9100;6264;6.0;4.1
09;2021-03-04;414;33;9514;6297;6.2;4.1
09;2021-03-05;331;65;9845;6362;6.5;4.2
09;2021-03-06;397;46;10242;6408;6.7;4.2
09;2021-03-07;124;4;10366;6412;6.8;4.2
09;2021-03-08;379;64;10745;6476;7.1;4.2
09;2021-03-09;437;144;11182;6620;7.3;4.3
09;2021-03-10;562;73;11744;6693;7.7;4.4
09;2021-03-11;695;79;12439;6772;8.2;4.4
09;2021-03-12;661;35;13100;6807;8.6;4.5
09;2021-03-13;384;3;13484;6810;8.8;4.5
09;2021-03-14;122;5;13606;6815;8.9;4.5
09;2021-03-15;465;50;14071;6865;9.2;4.5
09;2021-03-16;370;81;14441;6946;9.5;4.6
09;2021-03-17;399;71;14840;7017;9.7;4.6
09;2021-03-18;454;43;15294;7060;10.0;4.6
09;2021-03-19;526;56;15820;7116;10.4;4.7
09;2021-03-20;314;39;16134;7155;10.6;4.7
09;2021-03-21;105;0;16239;7155;10.7;4.7
09;2021-03-22;424;120;16663;7275;10.9;4.8
09;2021-03-23;566;174;17229;7449;11.3;4.9
09;2021-03-24;710;44;17939;7493;11.8;4.9
09;2021-03-25;869;139;18808;7632;12.3;5.0
09;2021-03-26;751;47;19559;7679;12.8;5.0
09;2021-03-27;620;70;20179;7749;13.2;5.1
09;2021-03-28;132;24;20311;7773;13.3;5.1
09;2021-03-29;498;279;20809;8052;13.7;5.3
09;2021-03-30;729;157;21538;8209;14.1;5.4
09;2021-03-31;803;183;22341;8392;14.7;5.5
09;2021-04-01;734;257;23075;8649;15.1;5.7
09;2021-04-02;692;268;23767;8917;15.6;5.9
09;2021-04-03;772;117;24539;9034;16.1;5.9
09;2021-04-04;122;57;24661;9091;16.2;6.0
09;2021-04-05;237;61;24898;9152;16.3;6.0
09;2021-04-06;1059;396;25957;9548;17.0;6.3
09;2021-04-07;1207;364;27164;9912;17.8;6.5
09;2021-04-08;1470;414;28634;10326;18.8;6.8
09;2021-04-09;1137;417;29771;10743;19.5;7.0
09;2021-04-10;1349;196;31120;10939;20.4;7.2
09;2021-04-11;173;102;31293;11041;20.5;7.2
09;2021-04-12;737;346;32030;11387;21.0;7.5
09;2021-04-13;1047;417;33077;11804;21.7;7.7
09;2021-04-14;1332;512;34409;12316;22.6;8.1
09;2021-04-15;1148;508;35557;12824;23.3;8.4
09;2021-04-16;1032;415;36589;13239;24.0;8.7
09;2021-04-17;1192;358;37781;13597;24.8;8.9
09;2021-04-18;102;96;37883;13693;24.9;9.0
09;2021-04-19;697;408;38580;14101;25.3;9.3
09;2021-04-20;766;531;39346;14632;25.8;9.6
09;2021-04-21;938;590;40284;15222;26.4;10.0
09;2021-04-22;666;609;40950;15831;26.9;10.4
09;2021-04-23;773;432;41723;16263;27.4;10.7
09;2021-04-24;741;670;42464;16933;27.9;11.1
09;2021-04-25;75;113;42539;17046;27.9;11.2
09;2021-04-26;382;533;42921;17579;28.2;11.5
09;2021-04-27;444;722;43365;18301;28.5;12.0
09;2021-04-28;806;795;44171;19096;29.0;12.5
09;2021-04-29;550;775;44721;19871;29.3;13.0
09;2021-04-30;622;724;45343;20595;29.8;13.5
09;2021-05-01;478;455;45821;21050;30.1;13.8
09;2021-05-02;52;100;45873;21150;30.1;13.9
09;2021-05-03;521;664;46394;21814;30.4;14.3
09;2021-05-04;554;1349;46948;23163;30.8;15.2
09;2021-05-05;822;1348;47770;24511;31.3;16.1
09;2021-05-06;848;1032;48618;25543;31.9;16.8
09;2021-05-07;978;822;49596;26365;32.5;17.3
09;2021-05-08;395;461;49991;26826;32.8;17.6
09;2021-05-09;265;85;50256;26911;33.0;17.7
09;2021-05-10;504;966;50760;27877;33.3;18.3
09;2021-05-11;741;1052;51501;28929;33.8;19.0
09;2021-05-12;1535;1405;53036;30334;34.8;19.9
09;2021-05-13;1383;425;54419;30759;35.7;20.2
09;2021-05-14;987;656;55406;31415;36.4;20.6
09;2021-05-15;1236;789;56642;32204;37.2;21.1
09;2021-05-16;296;48;56938;32252;37.4;21.2
09;2021-05-17;873;413;57811;32665;37.9;21.4
09;2021-05-18;1290;395;59101;33060;38.8;21.7
09;2021-05-19;1495;371;60596;33431;39.8;21.9
09;2021-05-20;1379;404;61975;33835;40.7;22.2
09;2021-05-21;1162;495;63137;34330;41.4;22.5
09;2021-05-22;1544;364;64681;34694;42.4;22.8
09;2021-05-23;272;24;64953;34718;42.6;22.8
09;2021-05-24;177;100;65130;34818;42.7;22.8
09;2021-05-25;998;500;66128;35318;43.4;23.2
09;2021-05-26;1285;448;67413;35766;44.2;23.5
09;2021-05-27;965;403;68378;36169;44.9;23.7
09;2021-05-28;958;513;69336;36682;45.5;24.1
09;2021-05-29;1794;601;71130;37283;46.7;24.5
09;2021-05-30;541;197;71671;37480;47.0;24.6
09;2021-05-31;717;593;72388;38073;47.5;25.0
09;2021-06-01;970;642;73358;38715;48.1;25.4
09;2021-06-02;1009;897;74367;39612;48.8;26.0
09;2021-06-03;809;681;75176;40293;49.3;26.4
09;2021-06-04;877;798;76053;41091;49.9;27.0
09;2021-06-05;1320;875;77373;41966;50.8;27.5
09;2021-06-06;304;108;77677;42074;51.0;27.6
09;2021-06-07;623;518;78300;42592;51.4;27.9
09;2021-06-08;821;488;79121;43080;51.9;28.3
09;2021-06-09;805;834;79926;43914;52.4;28.8
09;2021-06-10;642;534;80568;44448;52.9;29.2
09;2021-06-11;830;761;81398;45209;53.4;29.7
09;2021-06-12;635;808;82033;46017;53.8;30.2
09;2021-06-13;94;130;82127;46147;53.9;30.3
09;2021-06-14;628;708;82755;46855;54.3;30.7
09;2021-06-15;824;889;83579;47744;54.8;31.3
09;2021-06-16;627;1079;84206;48823;55.3;32.0
09;2021-06-17;779;852;84985;49675;55.8;32.6
09;2021-06-18;636;1150;85621;50825;56.2;33.4
09;2021-06-19;516;1580;86137;52405;56.5;34.4
09;2021-06-20;8;279;86145;52684;56.5;34.6
09;2021-06-21;473;698;86618;53382;56.8;35.0
09;2021-06-22;463;1066;87081;54448;57.1;35.7
09;2021-06-23;435;1224;87516;55672;57.4;36.5
09;2021-06-24;581;769;88097;56441;57.8;37.0
09;2021-06-25;410;1064;88507;57505;58.1;37.7
09;2021-06-26;443;1087;88950;58592;58.4;38.4
09;2021-06-27;2;275;88952;58867;58.4;38.6
09;2021-06-28;239;1047;89191;59914;58.5;39.3
09;2021-06-29;314;1229;89505;61143;58.7;40.1
09;2021-06-30;456;1492;89961;62635;59.0;41.1
09;2021-07-01;384;1434;90345;64069;59.3;42.0
09;2021-07-02;308;1162;90653;65231;59.5;42.8
09;2021-07-03;210;1617;90863;66848;59.6;43.9
09;2021-07-04;4;253;90867;67101;59.6;44.0
09;2021-07-05;188;713;91055;67814;59.7;44.5
09;2021-07-06;293;1222;91348;69036;59.9;45.3
09;2021-07-07;419;1399;91767;70435;60.2;46.2
09;2021-07-08;325;1058;92092;71493;60.4;46.9
09;2021-07-09;292;1152;92384;72645;60.6;47.7
09;2021-07-10;345;1725;92729;74370;60.8;48.8
09;2021-07-11;147;392;92876;74762;60.9;49.1
09;2021-07-12;187;1074;93063;75836;61.1;49.8
09;2021-07-13;641;1308;93704;77144;61.5;50.6
09;2021-07-14;490;220;94194;77364;61.8;50.8
09;2021-07-15;819;1166;95013;78530;62.3;51.5
09;2021-07-16;610;1191;95623;79721;62.7;52.3
09;2021-07-17;1015;1444;96638;81165;63.4;53.3
09;2021-07-18;302;221;96940;81386;63.6;53.4
09;2021-07-19;483;973;97423;82359;63.9;54.0
09;2021-07-20;830;1260;98253;83619;64.5;54.9
09;2021-07-21;1016;1165;99269;84784;65.1;55.6
09;2021-07-22;846;910;100115;85694;65.7;56.2
09;2021-07-23;724;912;100839;86606;66.2;56.8
09;2021-07-24;927;463;101766;87069;66.8;57.1
09;2021-07-25;560;134;102326;87203;67.1;57.2
09;2021-07-26;647;765;102973;87968;67.6;57.7
09;2021-07-27;1177;949;104150;88917;68.3;58.3
09;2021-07-28;1197;988;105347;89905;69.1;59.0
09;2021-07-29;1042;739;106389;90644;69.8;59.5
09;2021-07-30;779;623;107168;91267;70.3;59.9
09;2021-07-31;1379;419;108547;91686;71.2;60.2
09;2021-08-01;141;125;108688;91811;71.3;60.2
09;2021-08-02;614;478;109302;92289;71.7;60.6
09;2021-08-03;1254;767;110556;93056;72.5;61.1
09;2021-08-04;1400;654;111956;93710;73.5;61.5
09;2021-08-05;997;677;112953;94387;74.1;61.9
09;2021-08-06;1017;641;113970;95028;74.8;62.4
09;2021-08-07;825;430;114795;95458;75.3;62.6
09;2021-08-08;129;131;114924;95589;75.4;62.7
09;2021-08-09;690;650;115614;96239;75.9;63.1
09;2021-08-10;940;695;116554;96934;76.5;63.6
09;2021-08-11;896;866;117450;97800;77.1;64.2
09;2021-08-12;631;731;118081;98531;77.5;64.7
09;2021-08-13;465;645;118546;99176;77.8;65.1
09;2021-08-14;311;828;118857;100004;78.0;65.6
09;2021-08-15;67;138;118924;100142;78.0;65.7
09;2021-08-16;547;620;119471;100762;78.4;66.1
09;2021-08-17;674;777;120145;101539;78.8;66.6
09;2021-08-18;620;931;120765;102470;79.2;67.2
09;2021-08-19;432;722;121197;103192;79.5;67.7
09;2021-08-20;363;749;121560;103941;79.8;68.2
09;2021-08-21;343;1384;121903;105325;80.0;69.1
09;2021-08-22;67;168;121970;105493;80.0;69.2
09;2021-08-23;341;759;122311;106252;80.3;69.7
09;2021-08-24;407;955;122718;107207;80.5;70.3
09;2021-08-25;283;1003;123001;108210;80.7;71.0
09;2021-08-26;316;928;123317;109138;80.9;71.6
09;2021-08-27;226;740;123543;109878;81.1;72.1
09;2021-08-28;257;970;123800;110848;81.2;72.7
09;2021-08-29;15;144;123815;110992;81.2;72.8
09;2021-08-30;275;720;124090;111712;81.4;73.3
09;2021-08-31;314;1064;124404;112776;81.6;74.0
09;2021-09-01;360;770;124764;113546;81.9;74.5
09;2021-09-02;159;494;124923;114040;82.0;74.8
09;2021-09-03;223;743;125146;114783;82.1;75.3
09;2021-09-04;200;474;125346;115257;82.2;75.6
09;2021-09-05;25;80;125371;115337;82.3;75.7
09;2021-09-06;182;520;125553;115857;82.4;76.0
09;2021-09-07;157;547;125710;116404;82.5;76.4
09;2021-09-08;204;827;125914;117231;82.6;76.9
09;2021-09-09;160;434;126074;117665;82.7;77.2
09;2021-09-10;130;429;126204;118094;82.8;77.5
09;2021-09-11;175;400;126379;118494;82.9;77.8
09;2021-09-12;27;71;126406;118565;82.9;77.8
09;2021-09-13;129;418;126535;118983;83.0;78.1
09;2021-09-14;144;502;126679;119485;83.1;78.4
09;2021-09-15;188;603;126867;120088;83.2;78.8
09;2021-09-16;130;324;126997;120412;83.3;79.0
09;2021-09-17;146;405;127143;120817;83.4;79.3
09;2021-09-18;158;345;127301;121162;83.5;79.5
09;2021-09-19;2;0;127303;121162;83.5;79.5
09;2021-09-20;71;290;127374;121452;83.6;79.7
09;2021-09-21;101;205;127475;121657;83.6;79.8
09;2021-09-22;141;471;127616;122128;83.7;80.1
09;2021-09-23;71;164;127687;122292;83.8;80.2
09;2021-09-24;117;289;127804;122581;83.9;80.4
09;2021-09-25;62;195;127866;122776;83.9;80.6
09;2021-09-26;0;17;127866;122793;83.9;80.6
09;2021-09-27;82;327;127948;123120;84.0;80.8
09;2021-09-28;74;175;128022;123295;84.0;80.9
09;2021-09-29;97;235;128119;123530;84.1;81.1
09;2021-09-30;43;119;128162;123649;84.1;81.1
09;2021-10-01;82;125;128244;123774;84.2;81.2
09;2021-10-02;83;230;128327;124004;84.2;81.4
09;2021-10-03;2;8;128329;124012;84.2;81.4
09;2021-10-04;53;114;128382;124126;84.2;81.4
09;2021-10-05;70;125;128452;124251;84.3;81.5
09;2021-10-06;123;221;128575;124472;84.4;81.7
09;2021-10-07;60;165;128635;124637;84.4;81.8
09;2021-10-08;107;178;128742;124815;84.5;81.9
09;2021-10-09;54;132;128796;124947;84.5;82.0
09;2021-10-10;0;8;128796;124955;84.5;82.0
09;2021-10-11;69;107;128865;125062;84.6;82.1
10;2020-12-27;0;0;0;0;0.0;0.0
10;2020-12-28;0;0;0;0;0.0;0.0
10;2020-12-29;0;0;0;0;0.0;0.0
10;2020-12-30;0;0;0;0;0.0;0.0
10;2020-12-31;0;0;0;0;0.0;0.0
10;2021-01-01;0;0;0;0;0.0;0.0
10;2021-01-02;1;0;1;0;0.0;0.0
10;2021-01-03;0;0;1;0;0.0;0.0
10;2021-01-04;0;0;1;0;0.0;0.0
10;2021-01-05;1;0;2;0;0.0;0.0
10;2021-01-06;0;0;2;0;0.0;0.0
10;2021-01-07;84;0;86;0;0.0;0.0
10;2021-01-08;255;0;341;0;0.1;0.0
10;2021-01-09;0;0;341;0;0.1;0.0
10;2021-01-10;1;0;342;0;0.1;0.0
10;2021-01-11;118;1;460;1;0.1;0.0
10;2021-01-12;195;4;655;5;0.2;0.0
10;2021-01-13;314;0;969;5;0.3;0.0
10;2021-01-14;392;10;1361;15;0.4;0.0
10;2021-01-15;359;3;1720;18;0.6;0.0
10;2021-01-16;56;0;1776;18;0.6;0.0
10;2021-01-17;1;0;1777;18;0.6;0.0
10;2021-01-18;702;4;2479;22;0.8;0.0
10;2021-01-19;1392;8;3871;30;1.2;0.0
10;2021-01-20;1084;9;4955;39;1.6;0.0
10;2021-01-21;1152;2;6107;41;2.0;0.0
10;2021-01-22;818;2;6925;43;2.2;0.0
10;2021-01-23;309;0;7234;43;2.3;0.0
10;2021-01-24;0;0;7234;43;2.3;0.0
10;2021-01-25;445;8;7679;51;2.5;0.0
10;2021-01-26;487;17;8166;68;2.6;0.0
10;2021-01-27;458;15;8624;83;2.8;0.0
10;2021-01-28;358;49;8982;132;2.9;0.0
10;2021-01-29;430;191;9412;323;3.0;0.1
10;2021-01-30;30;0;9442;323;3.0;0.1
10;2021-01-31;0;0;9442;323;3.0;0.1
10;2021-02-01;409;139;9851;462;3.2;0.1
10;2021-02-02;182;151;10033;613;3.2;0.2
10;2021-02-03;361;215;10394;828;3.4;0.3
10;2021-02-04;342;269;10736;1097;3.5;0.4
10;2021-02-05;328;322;11064;1419;3.6;0.5
10;2021-02-06;3;35;11067;1454;3.6;0.5
10;2021-02-07;0;0;11067;1454;3.6;0.5
10;2021-02-08;190;411;11257;1865;3.6;0.6
10;2021-02-09;485;586;11742;2451;3.8;0.8
10;2021-02-10;667;482;12409;2933;4.0;0.9
10;2021-02-11;781;596;13190;3529;4.3;1.1
10;2021-02-12;580;549;13770;4078;4.4;1.3
10;2021-02-13;37;120;13807;4198;4.5;1.4
10;2021-02-14;0;0;13807;4198;4.5;1.4
10;2021-02-15;143;442;13950;4640;4.5;1.5
10;2021-02-16;116;541;14066;5181;4.5;1.7
10;2021-02-17;129;603;14195;5784;4.6;1.9
10;2021-02-18;217;555;14412;6339;4.7;2.0
10;2021-02-19;188;473;14600;6812;4.7;2.2
10;2021-02-20;24;183;14624;6995;4.7;2.3
10;2021-02-21;0;0;14624;6995;4.7;2.3
10;2021-02-22;77;445;14701;7440;4.7;2.4
10;2021-02-23;76;557;14777;7997;4.8;2.6
10;2021-02-24;114;373;14891;8370;4.8;2.7
10;2021-02-25;322;373;15213;8743;4.9;2.8
10;2021-02-26;351;283;15564;9026;5.0;2.9
10;2021-02-27;275;129;15839;9155;5.1;3.0
10;2021-02-28;0;0;15839;9155;5.1;3.0
10;2021-03-01;257;332;16096;9487;5.2;3.1
10;2021-03-02;435;369;16531;9856;5.3;3.2
10;2021-03-03;454;583;16985;10439;5.5;3.4
10;2021-03-04;636;501;17621;10940;5.7;3.5
10;2021-03-05;677;254;18298;11194;5.9;3.6
10;2021-03-06;950;46;19248;11240;6.2;3.6
10;2021-03-07;769;7;20017;11247;6.5;3.6
10;2021-03-08;502;442;20519;11689;6.6;3.8
10;2021-03-09;673;435;21192;12124;6.8;3.9
10;2021-03-10;662;365;21854;12489;7.1;4.0
10;2021-03-11;1174;238;23028;12727;7.4;4.1
10;2021-03-12;1338;250;24366;12977;7.9;4.2
10;2021-03-13;891;39;25257;13016;8.1;4.2
10;2021-03-14;1381;17;26638;13033;8.6;4.2
10;2021-03-15;821;82;27459;13115;8.9;4.2
10;2021-03-16;688;64;28147;13179;9.1;4.3
10;2021-03-17;831;68;28978;13247;9.4;4.3
10;2021-03-18;885;83;29863;13330;9.6;4.3
10;2021-03-19;952;71;30815;13401;9.9;4.3
10;2021-03-20;552;19;31367;13420;10.1;4.3
10;2021-03-21;1849;43;33216;13463;10.7;4.3
10;2021-03-22;879;76;34095;13539;11.0;4.4
10;2021-03-23;1243;94;35338;13633;11.4;4.4
10;2021-03-24;1311;60;36649;13693;11.8;4.4
10;2021-03-25;1676;232;38325;13925;12.4;4.5
10;2021-03-26;1432;116;39757;14041;12.8;4.5
10;2021-03-27;762;80;40519;14121;13.1;4.6
10;2021-03-28;1221;31;41740;14152;13.5;4.6
10;2021-03-29;648;305;42388;14457;13.7;4.7
10;2021-03-30;927;376;43315;14833;14.0;4.8
10;2021-03-31;617;361;43932;15194;14.2;4.9
10;2021-04-01;883;688;44815;15882;14.5;5.1
10;2021-04-02;1069;589;45884;16471;14.8;5.3
10;2021-04-03;540;606;46424;17077;15.0;5.5
10;2021-04-04;1826;264;48250;17341;15.6;5.6
10;2021-04-05;1843;43;50093;17384;16.2;5.6
10;2021-04-06;514;651;50607;18035;16.3;5.8
10;2021-04-07;592;541;51199;18576;16.5;6.0
10;2021-04-08;1061;609;52260;19185;16.9;6.2
10;2021-04-09;1130;613;53390;19798;17.2;6.4
10;2021-04-10;1769;352;55159;20150;17.8;6.5
10;2021-04-11;55;1221;55214;21371;17.8;6.9
10;2021-04-12;1001;808;56215;22179;18.1;7.2
10;2021-04-13;1506;896;57721;23075;18.6;7.4
10;2021-04-14;824;603;58545;23678;18.9;7.6
10;2021-04-15;1454;899;59999;24577;19.4;7.9
10;2021-04-16;1109;697;61108;25274;19.7;8.2
10;2021-04-17;2391;363;63499;25637;20.5;8.3
10;2021-04-18;1422;1789;64921;27426;20.9;8.8
10;2021-04-19;837;833;65758;28259;21.2;9.1
10;2021-04-20;546;1037;66304;29296;21.4;9.5
10;2021-04-21;636;975;66940;30271;21.6;9.8
10;2021-04-22;932;963;67872;31234;21.9;10.1
10;2021-04-23;2172;779;70044;32013;22.6;10.3
10;2021-04-24;2296;380;72340;32393;23.3;10.5
10;2021-04-25;1991;1217;74331;33610;24.0;10.8
10;2021-04-26;773;623;75104;34233;24.2;11.0
10;2021-04-27;895;537;75999;34770;24.5;11.2
10;2021-04-28;873;407;76872;35177;24.8;11.4
10;2021-04-29;1433;674;78305;35851;25.3;11.6
10;2021-04-30;2172;771;80477;36622;26.0;11.8
10;2021-05-01;1988;2169;82465;38791;26.6;12.5
10;2021-05-02;1948;1898;84413;40689;27.2;13.1
10;2021-05-03;622;447;85035;41136;27.4;13.3
10;2021-05-04;1144;1248;86179;42384;27.8;13.7
10;2021-05-05;1753;1022;87932;43406;28.4;14.0
10;2021-05-06;2257;951;90189;44357;29.1;14.3
10;2021-05-07;2218;1141;92407;45498;29.8;14.7
10;2021-05-08;2270;860;94677;46358;30.6;15.0
10;2021-05-09;2004;100;96681;46458;31.2;15.0
10;2021-05-10;531;1094;97212;47552;31.4;15.3
10;2021-05-11;1052;1034;98264;48586;31.7;15.7
10;2021-05-12;2062;884;100326;49470;32.4;16.0
10;2021-05-13;2181;436;102507;49906;33.1;16.1
10;2021-05-14;2728;673;105235;50579;34.0;16.3
10;2021-05-15;2423;2053;107658;52632;34.7;17.0
10;2021-05-16;2080;1448;109738;54080;35.4;17.5
10;2021-05-17;1451;442;111189;54522;35.9;17.6
10;2021-05-18;2510;640;113699;55162;36.7;17.8
10;2021-05-19;1554;642;115253;55804;37.2;18.0
10;2021-05-20;1895;847;117148;56651;37.8;18.3
10;2021-05-21;2318;618;119466;57269;38.5;18.5
10;2021-05-22;2179;422;121645;57691;39.3;18.6
10;2021-05-23;1816;138;123461;57829;39.8;18.7
10;2021-05-24;1968;177;125429;58006;40.5;18.7
10;2021-05-25;2195;491;127624;58497;41.2;18.9
10;2021-05-26;1679;421;129303;58918;41.7;19.0
10;2021-05-27;1659;753;130962;59671;42.3;19.3
10;2021-05-28;1720;1186;132682;60857;42.8;19.6
10;2021-05-29;2170;643;134852;61500;43.5;19.8
10;2021-05-30;1029;136;135881;61636;43.8;19.9
10;2021-05-31;1039;750;136920;62386;44.2;20.1
10;2021-06-01;1135;887;138055;63273;44.5;20.4
10;2021-06-02;1035;720;139090;63993;44.9;20.6
10;2021-06-03;1473;1069;140563;65062;45.4;21.0
10;2021-06-04;1768;2598;142331;67660;45.9;21.8
10;2021-06-05;1518;2451;143849;70111;46.4;22.6
10;2021-06-06;1005;1874;144854;71985;46.7;23.2
10;2021-06-07;700;1112;145554;73097;47.0;23.6
10;2021-06-08;896;1172;146450;74269;47.3;24.0
10;2021-06-09;880;913;147330;75182;47.5;24.3
10;2021-06-10;678;1070;148008;76252;47.8;24.6
10;2021-06-11;1200;2209;149208;78461;48.1;25.3
10;2021-06-12;856;2389;150064;80850;48.4;26.1
10;2021-06-13;401;1834;150465;82684;48.6;26.7
10;2021-06-14;538;743;151003;83427;48.7;26.9
10;2021-06-15;741;2132;151744;85559;49.0;27.6
10;2021-06-16;741;1858;152485;87417;49.2;28.2
10;2021-06-17;851;2457;153336;89874;49.5;29.0
10;2021-06-18;1030;2473;154366;92347;49.8;29.8
10;2021-06-19;981;2595;155347;94942;50.1;30.6
10;2021-06-20;549;1597;155896;96539;50.3;31.2
10;2021-06-21;684;1045;156580;97584;50.5;31.5
10;2021-06-22;745;1526;157325;99110;50.8;32.0
10;2021-06-23;653;2406;157978;101516;51.0;32.8
10;2021-06-24;787;2617;158765;104133;51.2;33.6
10;2021-06-25;730;3047;159495;107180;51.5;34.6
10;2021-06-26;514;2746;160009;109926;51.6;35.5
10;2021-06-27;402;1940;160411;111866;51.8;36.1
10;2021-06-28;683;1784;161094;113650;52.0;36.7
10;2021-06-29;616;2698;161710;116348;52.2;37.5
10;2021-06-30;534;1524;162244;117872;52.4;38.0
10;2021-07-01;555;2172;162799;120044;52.5;38.7
10;2021-07-02;664;2726;163463;122770;52.7;39.6
10;2021-07-03;529;2600;163992;125370;52.9;40.5
10;2021-07-04;411;1726;164403;127096;53.0;41.0
10;2021-07-05;667;2224;165070;129320;53.3;41.7
10;2021-07-06;651;2188;165721;131508;53.5;42.4
10;2021-07-07;639;1703;166360;133211;53.7;43.0
10;2021-07-08;751;1459;167111;134670;53.9;43.5
10;2021-07-09;820;1949;167931;136619;54.2;44.1
10;2021-07-10;632;2096;168563;138715;54.4;44.8
10;2021-07-11;500;1384;169063;140099;54.6;45.2
10;2021-07-12;783;1624;169846;141723;54.8;45.7
10;2021-07-13;1126;1874;170972;143597;55.2;46.3
10;2021-07-14;1169;1054;172141;144651;55.5;46.7
10;2021-07-15;1477;1980;173618;146631;56.0;47.3
10;2021-07-16;1241;2275;174859;148906;56.4;48.0
10;2021-07-17;1287;1738;176146;150644;56.8;48.6
10;2021-07-18;942;1225;177088;151869;57.1;49.0
10;2021-07-19;1361;1622;178449;153491;57.6;49.5
10;2021-07-20;1685;1433;180134;154924;58.1;50.0
10;2021-07-21;1395;1485;181529;156409;58.6;50.5
10;2021-07-22;1941;1598;183470;158007;59.2;51.0
10;2021-07-23;1606;1544;185076;159551;59.7;51.5
10;2021-07-24;1389;1228;186465;160779;60.2;51.9
10;2021-07-25;1251;789;187716;161568;60.6;52.1
10;2021-07-26;1914;1318;189630;162886;61.2;52.6
10;2021-07-27;2139;1071;191769;163957;61.9;52.9
10;2021-07-28;2094;1018;193863;164975;62.6;53.2
10;2021-07-29;2444;1204;196307;166179;63.3;53.6
10;2021-07-30;2176;1311;198483;167490;64.0;54.0
10;2021-07-31;1680;938;200163;168428;64.6;54.3
10;2021-08-01;1236;570;201399;168998;65.0;54.5
10;2021-08-02;1463;1337;202862;170335;65.5;55.0
10;2021-08-03;1635;897;204497;171232;66.0;55.3
10;2021-08-04;1370;1068;205867;172300;66.4;55.6
10;2021-08-05;1654;1345;207521;173645;67.0;56.0
10;2021-08-06;1835;1333;209356;174978;67.6;56.5
10;2021-08-07;1156;1133;210512;176111;67.9;56.8
10;2021-08-08;660;751;211172;176862;68.1;57.1
10;2021-08-09;1311;1542;212483;178404;68.6;57.6
10;2021-08-10;1670;1353;214153;179757;69.1;58.0
10;2021-08-11;854;1108;215007;180865;69.4;58.4
10;2021-08-12;1055;1225;216062;182090;69.7;58.8
10;2021-08-13;739;1075;216801;183165;70.0;59.1
10;2021-08-14;587;1235;217388;184400;70.1;59.5
10;2021-08-15;317;781;217705;185181;70.2;59.8
10;2021-08-16;725;1618;218430;186799;70.5;60.3
10;2021-08-17;877;1776;219307;188575;70.8;60.8
10;2021-08-18;723;1620;220030;190195;71.0;61.4
10;2021-08-19;551;1571;220581;191766;71.2;61.9
10;2021-08-20;644;1733;221225;193499;71.4;62.4
10;2021-08-21;452;1419;221677;194918;71.5;62.9
10;2021-08-22;189;1061;221866;195979;71.6;63.2
10;2021-08-23;481;1562;222347;197541;71.7;63.7
10;2021-08-24;669;1771;223016;199312;72.0;64.3
10;2021-08-25;460;1381;223476;200693;72.1;64.8
10;2021-08-26;432;1486;223908;202179;72.3;65.2
10;2021-08-27;626;1588;224534;203767;72.5;65.8
10;2021-08-28;396;1333;224930;205100;72.6;66.2
10;2021-08-29;225;946;225155;206046;72.7;66.5
10;2021-08-30;433;1376;225588;207422;72.8;66.9
10;2021-08-31;470;1426;226058;208848;72.9;67.4
10;2021-09-01;298;1104;226356;209952;73.0;67.7
10;2021-09-02;273;972;226629;210924;73.1;68.1
10;2021-09-03;404;1062;227033;211986;73.3;68.4
10;2021-09-04;342;1014;227375;213000;73.4;68.7
10;2021-09-05;174;409;227549;213409;73.4;68.9
10;2021-09-06;272;595;227821;214004;73.5;69.1
10;2021-09-07;303;601;228124;214605;73.6;69.2
10;2021-09-08;255;607;228379;215212;73.7;69.4
10;2021-09-09;333;720;228712;215932;73.8;69.7
10;2021-09-10;433;762;229145;216694;73.9;69.9
10;2021-09-11;264;634;229409;217328;74.0;70.1
10;2021-09-12;93;210;229502;217538;74.1;70.2
10;2021-09-13;226;473;229728;218011;74.1;70.3
10;2021-09-14;249;597;229977;218608;74.2;70.5
10;2021-09-15;238;637;230215;219245;74.3;70.7
10;2021-09-16;281;598;230496;219843;74.4;70.9
10;2021-09-17;270;859;230766;220702;74.5;71.2
10;2021-09-18;197;610;230963;221312;74.5;71.4
10;2021-09-19;62;224;231025;221536;74.5;71.5
10;2021-09-20;138;627;231163;222163;74.6;71.7
10;2021-09-21;151;554;231314;222717;74.6;71.9
10;2021-09-22;132;305;231446;223022;74.7;72.0
10;2021-09-23;215;353;231661;223375;74.8;72.1
10;2021-09-24;211;547;231872;223922;74.8;72.3
10;2021-09-25;112;420;231984;224342;74.9;72.4
10;2021-09-26;58;215;232042;224557;74.9;72.5
10;2021-09-27;220;267;232262;224824;74.9;72.5
10;2021-09-28;204;362;232466;225186;75.0;72.7
10;2021-09-29;190;292;232656;225478;75.1;72.8
10;2021-09-30;156;220;232812;225698;75.1;72.8
10;2021-10-01;202;447;233014;226145;75.2;73.0
10;2021-10-02;145;285;233159;226430;75.2;73.1
10;2021-10-03;58;128;233217;226558;75.3;73.1
10;2021-10-04;98;194;233315;226752;75.3;73.2
10;2021-10-05;107;216;233422;226968;75.3;73.2
10;2021-10-06;136;226;233558;227194;75.4;73.3
10;2021-10-07;137;318;233695;227512;75.4;73.4
10;2021-10-08;184;286;233879;227798;75.5;73.5
10;2021-10-09;123;245;234002;228043;75.5;73.6
10;2021-10-10;53;87;234055;228130;75.5;73.6
10;2021-10-11;111;193;234166;228323;75.6;73.7
11;2020-12-27;0;0;0;0;0.0;0.0
11;2020-12-28;1;0;1;0;0.0;0.0
11;2020-12-29;1;0;2;0;0.0;0.0
11;2020-12-30;0;0;2;0;0.0;0.0
11;2020-12-31;0;0;2;0;0.0;0.0
11;2021-01-01;0;0;2;0;0.0;0.0
11;2021-01-02;5;0;7;0;0.0;0.0
11;2021-01-03;0;0;7;0;0.0;0.0
11;2021-01-04;1;0;8;0;0.0;0.0
11;2021-01-05;95;1;103;1;0.0;0.0
11;2021-01-06;26;0;129;1;0.0;0.0
11;2021-01-07;119;0;248;1;0.1;0.0
11;2021-01-08;91;1;339;2;0.1;0.0
11;2021-01-09;86;0;425;2;0.1;0.0
11;2021-01-10;67;0;492;2;0.1;0.0
11;2021-01-11;136;0;628;2;0.2;0.0
11;2021-01-12;545;3;1173;5;0.3;0.0
11;2021-01-13;409;1;1582;6;0.4;0.0
11;2021-01-14;646;10;2228;16;0.6;0.0
11;2021-01-15;342;3;2570;19;0.7;0.0
11;2021-01-16;77;1;2647;20;0.7;0.0
11;2021-01-17;47;2;2694;22;0.7;0.0
11;2021-01-18;388;0;3082;22;0.8;0.0
11;2021-01-19;539;12;3621;34;1.0;0.0
11;2021-01-20;693;7;4314;41;1.2;0.0
11;2021-01-21;650;7;4964;48;1.3;0.0
11;2021-01-22;524;2;5488;50;1.5;0.0
11;2021-01-23;165;2;5653;52;1.5;0.0
11;2021-01-24;139;1;5792;53;1.6;0.0
11;2021-01-25;378;19;6170;72;1.7;0.0
11;2021-01-26;851;85;7021;157;1.9;0.0
11;2021-01-27;804;27;7825;184;2.1;0.0
11;2021-01-28;652;62;8477;246;2.3;0.1
11;2021-01-29;442;124;8919;370;2.4;0.1
11;2021-01-30;138;4;9057;374;2.4;0.1
11;2021-01-31;82;0;9139;374;2.5;0.1
11;2021-02-01;344;197;9483;571;2.5;0.2
11;2021-02-02;412;407;9895;978;2.7;0.3
11;2021-02-03;392;354;10287;1332;2.8;0.4
11;2021-02-04;376;499;10663;1831;2.9;0.5
11;2021-02-05;320;336;10983;2167;2.9;0.6
11;2021-02-06;210;65;11193;2232;3.0;0.6
11;2021-02-07;109;14;11302;2246;3.0;0.6
11;2021-02-08;317;160;11619;2406;3.1;0.6
11;2021-02-09;300;279;11919;2685;3.2;0.7
11;2021-02-10;344;446;12263;3131;3.3;0.8
11;2021-02-11;609;631;12872;3762;3.5;1.0
11;2021-02-12;407;381;13279;4143;3.6;1.1
11;2021-02-13;195;118;13474;4261;3.6;1.1
11;2021-02-14;73;26;13547;4287;3.6;1.2
11;2021-02-15;241;209;13788;4496;3.7;1.2
11;2021-02-16;264;509;14052;5005;3.8;1.3
11;2021-02-17;454;620;14506;5625;3.9;1.5
11;2021-02-18;456;571;14962;6196;4.0;1.7
11;2021-02-19;300;535;15262;6731;4.1;1.8
11;2021-02-20;148;75;15410;6806;4.1;1.8
11;2021-02-21;59;46;15469;6852;4.2;1.8
11;2021-02-22;124;328;15593;7180;4.2;1.9
11;2021-02-23;283;318;15876;7498;4.3;2.0
11;2021-02-24;252;366;16128;7864;4.3;2.1
11;2021-02-25;563;332;16691;8196;4.5;2.2
11;2021-02-26;524;315;17215;8511;4.6;2.3
11;2021-02-27;319;100;17534;8611;4.7;2.3
11;2021-02-28;95;24;17629;8635;4.7;2.3
11;2021-03-01;339;315;17968;8950;4.8;2.4
11;2021-03-02;563;390;18531;9340;5.0;2.5
11;2021-03-03;601;432;19132;9772;5.1;2.6
11;2021-03-04;1078;410;20210;10182;5.4;2.7
11;2021-03-05;1002;412;21212;10594;5.7;2.8
11;2021-03-06;1096;207;22308;10801;6.0;2.9
11;2021-03-07;658;33;22966;10834;6.2;2.9
11;2021-03-08;369;353;23335;11187;6.3;3.0
11;2021-03-09;997;401;24332;11588;6.5;3.1
11;2021-03-10;1175;545;25507;12133;6.8;3.3
11;2021-03-11;1572;450;27079;12583;7.3;3.4
11;2021-03-12;1457;444;28536;13027;7.7;3.5
11;2021-03-13;1160;241;29696;13268;8.0;3.6
11;2021-03-14;523;54;30219;13322;8.1;3.6
11;2021-03-15;651;241;30870;13563;8.3;3.6
11;2021-03-16;853;201;31723;13764;8.5;3.7
11;2021-03-17;907;221;32630;13985;8.8;3.8
11;2021-03-18;1172;287;33802;14272;9.1;3.8
11;2021-03-19;1372;248;35174;14520;9.4;3.9
11;2021-03-20;790;176;35964;14696;9.6;3.9
11;2021-03-21;225;68;36189;14764;9.7;4.0
11;2021-03-22;809;221;36998;14985;9.9;4.0
11;2021-03-23;1807;393;38805;15378;10.4;4.1
11;2021-03-24;1847;322;40652;15700;10.9;4.2
11;2021-03-25;2190;375;42842;16075;11.5;4.3
11;2021-03-26;2125;450;44967;16525;12.1;4.4
11;2021-03-27;1178;147;46145;16672;12.4;4.5
11;2021-03-28;265;44;46410;16716;12.5;4.5
11;2021-03-29;1182;224;47592;16940;12.8;4.5
11;2021-03-30;1995;329;49587;17269;13.3;4.6
11;2021-03-31;1614;386;51201;17655;13.7;4.7
11;2021-04-01;2145;430;53346;18085;14.3;4.9
11;2021-04-02;1642;429;54988;18514;14.8;5.0
11;2021-04-03;720;146;55708;18660;14.9;5.0
11;2021-04-04;198;76;55906;18736;15.0;5.0
11;2021-04-05;257;4;56163;18740;15.1;5.0
11;2021-04-06;1574;555;57737;19295;15.5;5.2
11;2021-04-07;1778;576;59515;19871;16.0;5.3
11;2021-04-08;1785;686;61300;20557;16.4;5.5
11;2021-04-09;2261;608;63561;21165;17.1;5.7
11;2021-04-10;1168;181;64729;21346;17.4;5.7
11;2021-04-11;551;106;65280;21452;17.5;5.8
11;2021-04-12;1615;545;66895;21997;17.9;5.9
11;2021-04-13;2262;890;69157;22887;18.6;6.1
11;2021-04-14;1661;1020;70818;23907;19.0;6.4
11;2021-04-15;1843;1134;72661;25041;19.5;6.7
11;2021-04-16;1838;851;74499;25892;20.0;6.9
11;2021-04-17;1772;564;76271;26456;20.5;7.1
11;2021-04-18;114;155;76385;26611;20.5;7.1
11;2021-04-19;1384;739;77769;27350;20.9;7.3
11;2021-04-20;1729;1284;79498;28634;21.3;7.7
11;2021-04-21;1780;1324;81278;29958;21.8;8.0
11;2021-04-22;1749;1326;83027;31284;22.3;8.4
11;2021-04-23;2014;1239;85041;32523;22.8;8.7
11;2021-04-24;1735;469;86776;32992;23.3;8.9
11;2021-04-25;659;183;87435;33175;23.5;8.9
11;2021-04-26;1380;839;88815;34014;23.8;9.1
11;2021-04-27;1839;1556;90654;35570;24.3;9.5
11;2021-04-28;2008;1470;92662;37040;24.9;9.9
11;2021-04-29;2247;1642;94909;38682;25.5;10.4
11;2021-04-30;2158;1427;97067;40109;26.0;10.8
11;2021-05-01;1338;345;98405;40454;26.4;10.9
11;2021-05-02;588;336;98993;40790;26.6;10.9
11;2021-05-03;1487;739;100480;41529;27.0;11.1
11;2021-05-04;1878;1431;102358;42960;27.5;11.5
11;2021-05-05;1895;1441;104253;44401;28.0;11.9
11;2021-05-06;2191;1475;106444;45876;28.6;12.3
11;2021-05-07;2105;1560;108549;47436;29.1;12.7
11;2021-05-08;898;728;109447;48164;29.4;12.9
11;2021-05-09;628;543;110075;48707;29.5;13.1
11;2021-05-10;1327;1652;111402;50359;29.9;13.5
11;2021-05-11;2041;1874;113443;52233;30.4;14.0
11;2021-05-12;1848;1653;115291;53886;30.9;14.5
11;2021-05-13;1405;414;116696;54300;31.3;14.6
11;2021-05-14;1718;1184;118414;55484;31.8;14.9
11;2021-05-15;1158;897;119572;56381;32.1;15.1
11;2021-05-16;808;164;120380;56545;32.3;15.2
11;2021-05-17;1470;1046;121850;57591;32.7;15.5
11;2021-05-18;1898;1192;123748;58783;33.2;15.8
11;2021-05-19;1846;1124;125594;59907;33.7;16.1
11;2021-05-20;1971;1091;127565;60998;34.2;16.4
11;2021-05-21;2276;1092;129841;62090;34.8;16.7
11;2021-05-22;1485;727;131326;62817;35.2;16.9
11;2021-05-23;768;72;132094;62889;35.4;16.9
11;2021-05-24;1411;224;133505;63113;35.8;16.9
11;2021-05-25;1811;1353;135316;64466;36.3;17.3
11;2021-05-26;1934;1299;137250;65765;36.8;17.6
11;2021-05-27;1989;1722;139239;67487;37.4;18.1
11;2021-05-28;1754;1901;140993;69388;37.8;18.6
11;2021-05-29;1428;1601;142421;70989;38.2;19.0
11;2021-05-30;486;395;142907;71384;38.3;19.2
11;2021-05-31;1261;1616;144168;73000;38.7;19.6
11;2021-06-01;1856;1904;146024;74904;39.2;20.1
11;2021-06-02;1761;2068;147785;76972;39.7;20.7
11;2021-06-03;2597;2409;150382;79381;40.3;21.3
11;2021-06-04;2147;2668;152529;82049;40.9;22.0
11;2021-06-05;1588;1903;154117;83952;41.4;22.5
11;2021-06-06;877;857;154994;84809;41.6;22.8
11;2021-06-07;1527;1709;156521;86518;42.0;23.2
11;2021-06-08;2042;1996;158563;88514;42.5;23.7
11;2021-06-09;1786;2184;160349;90698;43.0;24.3
11;2021-06-10;1806;2427;162155;93125;43.5;25.0
11;2021-06-11;1864;2495;164019;95620;44.0;25.7
11;2021-06-12;1455;1624;165474;97244;44.4;26.1
11;2021-06-13;713;723;166187;97967;44.6;26.3
11;2021-06-14;1032;1968;167219;99935;44.9;26.8
11;2021-06-15;1395;2685;168614;102620;45.2;27.5
11;2021-06-16;1335;2528;169949;105148;45.6;28.2
11;2021-06-17;1474;2522;171423;107670;46.0;28.9
11;2021-06-18;1518;2487;172941;110157;46.4;29.6
11;2021-06-19;1236;1410;174177;111567;46.7;29.9
11;2021-06-20;299;599;174476;112166;46.8;30.1
11;2021-06-21;838;2122;175314;114288;47.0;30.7
11;2021-06-22;1016;2606;176330;116894;47.3;31.4
11;2021-06-23;1095;2089;177425;118983;47.6;31.9
11;2021-06-24;909;2244;178334;121227;47.8;32.5
11;2021-06-25;993;2547;179327;123774;48.1;33.2
11;2021-06-26;773;1655;180100;125429;48.3;33.7
11;2021-06-27;210;688;180310;126117;48.4;33.8
11;2021-06-28;697;2297;181007;128414;48.6;34.5
11;2021-06-29;963;2602;181970;131016;48.8;35.2
11;2021-06-30;906;2520;182876;133536;49.1;35.8
11;2021-07-01;1004;1889;183880;135425;49.3;36.3
11;2021-07-02;966;2540;184846;137965;49.6;37.0
11;2021-07-03;729;1807;185575;139772;49.8;37.5
11;2021-07-04;340;1109;185915;140881;49.9;37.8
11;2021-07-05;695;2132;186610;143013;50.1;38.4
11;2021-07-06;972;2521;187582;145534;50.3;39.0
11;2021-07-07;945;2510;188527;148044;50.6;39.7
11;2021-07-08;1191;1911;189718;149955;50.9;40.2
11;2021-07-09;824;1796;190542;151751;51.1;40.7
11;2021-07-10;369;1302;190911;153053;51.2;41.1
11;2021-07-11;313;564;191224;153617;51.3;41.2
11;2021-07-12;505;2672;191729;156289;51.4;41.9
11;2021-07-13;1304;3064;193033;159353;51.8;42.8
11;2021-07-14;210;233;193243;159586;51.8;42.8
11;2021-07-15;1451;2961;194694;162547;52.2;43.6
11;2021-07-16;1876;2734;196570;165281;52.7;44.3
11;2021-07-17;1075;2166;197645;167447;53.0;44.9
11;2021-07-18;652;946;198297;168393;53.2;45.2
11;2021-07-19;1355;2089;199652;170482;53.6;45.7
11;2021-07-20;1998;2403;201650;172885;54.1;46.4
11;2021-07-21;2015;2441;203665;175326;54.6;47.0
11;2021-07-22;2415;1884;206080;177210;55.3;47.5
11;2021-07-23;2231;2282;208311;179492;55.9;48.2
11;2021-07-24;1274;1629;209585;181121;56.2;48.6
11;2021-07-25;749;693;210334;181814;56.4;48.8
11;2021-07-26;1667;1427;212001;183241;56.9;49.2
11;2021-07-27;2341;2000;214342;185241;57.5;49.7
11;2021-07-28;2480;1991;216822;187232;58.2;50.2
11;2021-07-29;2771;1795;219593;189027;58.9;50.7
11;2021-07-30;2575;1803;222168;190830;59.6;51.2
11;2021-07-31;2008;1143;224176;191973;60.1;51.5
11;2021-08-01;1011;482;225187;192455;60.4;51.6
11;2021-08-02;1929;1151;227116;193606;60.9;51.9
11;2021-08-03;2442;1602;229558;195208;61.6;52.4
11;2021-08-04;2560;1269;232118;196477;62.3;52.7
11;2021-08-05;2382;1334;234500;197811;62.9;53.1
11;2021-08-06;2252;1661;236752;199472;63.5;53.5
11;2021-08-07;1665;1172;238417;200644;64.0;53.8
11;2021-08-08;599;210;239016;200854;64.1;53.9
11;2021-08-09;1033;1434;240049;202288;64.4;54.3
11;2021-08-10;1747;1987;241796;204275;64.9;54.8
11;2021-08-11;1717;1689;243513;205964;65.3;55.3
11;2021-08-12;1715;1858;245228;207822;65.8;55.8
11;2021-08-13;1348;1655;246576;209477;66.2;56.2
11;2021-08-14;984;1596;247560;211073;66.4;56.6
11;2021-08-15;138;125;247698;211198;66.5;56.7
11;2021-08-16;731;1914;248429;213112;66.7;57.2
11;2021-08-17;1046;2391;249475;215503;66.9;57.8
11;2021-08-18;1108;2032;250583;217535;67.2;58.4
11;2021-08-19;1006;2291;251589;219826;67.5;59.0
11;2021-08-20;976;2291;252565;222117;67.8;59.6
11;2021-08-21;576;1838;253141;223955;67.9;60.1
11;2021-08-22;192;512;253333;224467;68.0;60.2
11;2021-08-23;522;1817;253855;226284;68.1;60.7
11;2021-08-24;799;2255;254654;228539;68.3;61.3
11;2021-08-25;796;2158;255450;230697;68.5;61.9
11;2021-08-26;759;2001;256209;232698;68.7;62.4
11;2021-08-27;701;2223;256910;234921;68.9;63.0
11;2021-08-28;436;1745;257346;236666;69.0;63.5
11;2021-08-29;143;514;257489;237180;69.1;63.6
11;2021-08-30;455;1322;257944;238502;69.2;64.0
11;2021-08-31;585;1865;258529;240367;69.4;64.5
11;2021-09-01;608;1714;259137;242081;69.5;65.0
11;2021-09-02;557;1553;259694;243634;69.7;65.4
11;2021-09-03;538;1549;260232;245183;69.8;65.8
11;2021-09-04;489;1483;260721;246666;70.0;66.2
11;2021-09-05;153;236;260874;246902;70.0;66.2
11;2021-09-06;299;673;261173;247575;70.1;66.4
11;2021-09-07;357;895;261530;248470;70.2;66.7
11;2021-09-08;478;1155;262008;249625;70.3;67.0
11;2021-09-09;394;862;262402;250487;70.4;67.2
11;2021-09-10;381;990;262783;251477;70.5;67.5
11;2021-09-11;378;985;263161;252462;70.6;67.7
11;2021-09-12;61;127;263222;252589;70.6;67.8
11;2021-09-13;238;731;263460;253320;70.7;68.0
11;2021-09-14;352;623;263812;253943;70.8;68.1
11;2021-09-15;359;972;264171;254915;70.9;68.4
11;2021-09-16;305;586;264476;255501;71.0;68.6
11;2021-09-17;313;682;264789;256183;71.0;68.7
11;2021-09-18;269;731;265058;256914;71.1;68.9
11;2021-09-19;59;123;265117;257037;71.1;69.0
11;2021-09-20;166;333;265283;257370;71.2;69.1
11;2021-09-21;288;417;265571;257787;71.3;69.2
11;2021-09-22;227;768;265798;258555;71.3;69.4
11;2021-09-23;179;398;265977;258953;71.4;69.5
11;2021-09-24;275;519;266252;259472;71.4;69.6
11;2021-09-25;235;674;266487;260146;71.5;69.8
11;2021-09-26;35;131;266522;260277;71.5;69.8
11;2021-09-27;105;385;266627;260662;71.5;69.9
11;2021-09-28;213;355;266840;261017;71.6;70.0
11;2021-09-29;221;537;267061;261554;71.7;70.2
11;2021-09-30;194;360;267255;261914;71.7;70.3
11;2021-10-01;226;389;267481;262303;71.8;70.4
11;2021-10-02;232;446;267713;262749;71.8;70.5
11;2021-10-03;2;1;267715;262750;71.8;70.5
11;2021-10-04;138;295;267853;263045;71.9;70.6
11;2021-10-05;177;321;268030;263366;71.9;70.7
11;2021-10-06;261;446;268291;263812;72.0;70.8
11;2021-10-07;166;290;268457;264102;72.0;70.9
11;2021-10-08;211;420;268668;264522;72.1;71.0
11;2021-10-09;147;365;268815;264887;72.1;71.1
11;2021-10-10;0;1;268815;264888;72.1;71.1
11;2021-10-11;129;249;268944;265137;72.2;71.1
12;2020-12-27;0;0;0;0;0.0;0.0
12;2020-12-28;0;0;0;0;0.0;0.0
12;2020-12-29;0;0;0;0;0.0;0.0
12;2020-12-30;0;0;0;0;0.0;0.0
12;2020-12-31;0;0;0;0;0.0;0.0
12;2021-01-01;0;0;0;0;0.0;0.0
12;2021-01-02;0;0;0;0;0.0;0.0
12;2021-01-03;2;0;2;0;0.0;0.0
12;2021-01-04;1;0;3;0;0.0;0.0
12;2021-01-05;1;0;4;0;0.0;0.0
12;2021-01-06;12;0;16;0;0.0;0.0
12;2021-01-07;202;0;218;0;0.1;0.0
12;2021-01-08;65;0;283;0;0.1;0.0
12;2021-01-09;0;0;283;0;0.1;0.0
12;2021-01-10;1;0;284;0;0.1;0.0
12;2021-01-11;99;0;383;0;0.1;0.0
12;2021-01-12;361;2;744;2;0.3;0.0
12;2021-01-13;285;0;1029;2;0.4;0.0
12;2021-01-14;600;12;1629;14;0.6;0.0
12;2021-01-15;367;10;1996;24;0.7;0.0
12;2021-01-16;138;2;2134;26;0.8;0.0
12;2021-01-17;1;0;2135;26;0.8;0.0
12;2021-01-18;452;0;2587;26;0.9;0.0
12;2021-01-19;609;4;3196;30;1.1;0.0
12;2021-01-20;879;5;4075;35;1.5;0.0
12;2021-01-21;736;1;4811;36;1.7;0.0
12;2021-01-22;799;1;5610;37;2.0;0.0
12;2021-01-23;382;0;5992;37;2.2;0.0
12;2021-01-24;0;0;5992;37;2.2;0.0
12;2021-01-25;453;0;6445;37;2.3;0.0
12;2021-01-26;650;0;7095;37;2.5;0.0
12;2021-01-27;1887;40;8982;77;3.2;0.0
12;2021-01-28;1886;232;10868;309;3.9;0.1
12;2021-01-29;1331;46;12199;355;4.4;0.1
12;2021-01-30;359;2;12558;357;4.5;0.1
12;2021-01-31;0;0;12558;357;4.5;0.1
12;2021-02-01;335;89;12893;446;4.6;0.2
12;2021-02-02;459;241;13352;687;4.8;0.2
12;2021-02-03;458;168;13810;855;5.0;0.3
12;2021-02-04;459;526;14269;1381;5.1;0.5
12;2021-02-05;449;183;14718;1564;5.3;0.6
12;2021-02-06;220;66;14938;1630;5.4;0.6
12;2021-02-07;8;0;14946;1630;5.4;0.6
12;2021-02-08;104;313;15050;1943;5.4;0.7
12;2021-02-09;209;341;15259;2284;5.5;0.8
12;2021-02-10;468;475;15727;2759;5.6;1.0
12;2021-02-11;539;344;16266;3103;5.8;1.1
12;2021-02-12;570;345;16836;3448;6.0;1.2
12;2021-02-13;175;132;17011;3580;6.1;1.3
12;2021-02-14;1;0;17012;3580;6.1;1.3
12;2021-02-15;175;374;17187;3954;6.2;1.4
12;2021-02-16;171;509;17358;4463;6.2;1.6
12;2021-02-17;366;1431;17724;5894;6.4;2.1
12;2021-02-18;678;1662;18402;7556;6.6;2.7
12;2021-02-19;594;974;18996;8530;6.8;3.1
12;2021-02-20;103;392;19099;8922;6.9;3.2
12;2021-02-21;0;0;19099;8922;6.9;3.2
12;2021-02-22;150;398;19249;9320;6.9;3.3
12;2021-02-23;157;558;19406;9878;7.0;3.5
12;2021-02-24;156;685;19562;10563;7.0;3.8
12;2021-02-25;201;769;19763;11332;7.1;4.1
12;2021-02-26;320;650;20083;11982;7.2;4.3
12;2021-02-27;191;350;20274;12332;7.3;4.4
12;2021-02-28;13;0;20287;12332;7.3;4.4
12;2021-03-01;50;349;20337;12681;7.3;4.6
12;2021-03-02;190;507;20527;13188;7.4;4.7
12;2021-03-03;244;388;20771;13576;7.5;4.9
12;2021-03-04;278;363;21049;13939;7.6;5.0
12;2021-03-05;421;370;21470;14309;7.7;5.1
12;2021-03-06;793;129;22263;14438;8.0;5.2
12;2021-03-07;140;33;22403;14471;8.0;5.2
12;2021-03-08;234;208;22637;14679;8.1;5.3
12;2021-03-09;716;234;23353;14913;8.4;5.4
12;2021-03-10;785;744;24138;15657;8.7;5.6
12;2021-03-11;919;663;25057;16320;9.0;5.9
12;2021-03-12;1259;530;26316;16850;9.5;6.1
12;2021-03-13;896;140;27212;16990;9.8;6.1
12;2021-03-14;45;2;27257;16992;9.8;6.1
12;2021-03-15;559;157;27816;17149;10.0;6.2
12;2021-03-16;818;162;28634;17311;10.3;6.2
12;2021-03-17;1504;167;30138;17478;10.8;6.3
12;2021-03-18;997;255;31135;17733;11.2;6.4
12;2021-03-19;1383;283;32518;18016;11.7;6.5
12;2021-03-20;725;82;33243;18098;11.9;6.5
12;2021-03-21;264;10;33507;18108;12.0;6.5
12;2021-03-22;606;175;34113;18283;12.3;6.6
12;2021-03-23;1214;178;35327;18461;12.7;6.6
12;2021-03-24;1422;210;36749;18671;13.2;6.7
12;2021-03-25;1843;206;38592;18877;13.9;6.8
12;2021-03-26;1978;231;40570;19108;14.6;6.9
12;2021-03-27;981;68;41551;19176;14.9;6.9
12;2021-03-28;60;1;41611;19177;14.9;6.9
12;2021-03-29;963;85;42574;19262;15.3;6.9
12;2021-03-30;1737;124;44311;19386;15.9;7.0
12;2021-03-31;1460;107;45771;19493;16.4;7.0
12;2021-04-01;1957;167;47728;19660;17.1;7.1
12;2021-04-02;1614;346;49342;20006;17.7;7.2
12;2021-04-03;882;96;50224;20102;18.0;7.2
12;2021-04-04;1;0;50225;20102;18.0;7.2
12;2021-04-05;645;15;50870;20117;18.3;7.2
12;2021-04-06;1151;538;52021;20655;18.7;7.4
12;2021-04-07;1652;645;53673;21300;19.3;7.7
12;2021-04-08;2098;575;55771;21875;20.0;7.9
12;2021-04-09;2112;657;57883;22532;20.8;8.1
12;2021-04-10;1427;222;59310;22754;21.3;8.2
12;2021-04-11;120;1;59430;22755;21.4;8.2
12;2021-04-12;1836;506;61266;23261;22.0;8.4
12;2021-04-13;1907;780;63173;24041;22.7;8.6
12;2021-04-14;1832;1322;65005;25363;23.4;9.1
12;2021-04-15;1937;901;66942;26264;24.0;9.4
12;2021-04-16;1675;1205;68617;27469;24.7;9.9
12;2021-04-17;1553;568;70170;28037;25.2;10.1
12;2021-04-18;0;0;70170;28037;25.2;10.1
12;2021-04-19;1687;550;71857;28587;25.8;10.3
12;2021-04-20;1546;986;73403;29573;26.4;10.6
12;2021-04-21;1693;1183;75096;30756;27.0;11.0
12;2021-04-22;1690;1097;76786;31853;27.6;11.4
12;2021-04-23;1382;1335;78168;33188;28.1;11.9
12;2021-04-24;1450;720;79618;33908;28.6;12.2
12;2021-04-25;60;0;79678;33908;28.6;12.2
12;2021-04-26;1459;898;81137;34806;29.1;12.5
12;2021-04-27;1321;1281;82458;36087;29.6;13.0
12;2021-04-28;1113;1870;83571;37957;30.0;13.6
12;2021-04-29;1571;1911;85142;39868;30.6;14.3
12;2021-04-30;1815;1839;86957;41707;31.2;15.0
12;2021-05-01;1617;261;88574;41968;31.8;15.1
12;2021-05-02;9;0;88583;41968;31.8;15.1
12;2021-05-03;1713;1252;90296;43220;32.4;15.5
12;2021-05-04;1482;1396;91778;44616;33.0;16.0
12;2021-05-05;1296;1677;93074;46293;33.4;16.6
12;2021-05-06;1753;1379;94827;47672;34.1;17.1
12;2021-05-07;1483;1780;96310;49452;34.6;17.8
12;2021-05-08;1330;461;97640;49913;35.1;17.9
12;2021-05-09;13;34;97653;49947;35.1;17.9
12;2021-05-10;829;2217;98482;52164;35.4;18.7
12;2021-05-11;928;1851;99410;54015;35.7;19.4
12;2021-05-12;948;1820;100358;55835;36.1;20.1
12;2021-05-13;1587;811;101945;56646;36.6;20.3
12;2021-05-14;1235;1534;103180;58180;37.1;20.9
12;2021-05-15;1067;1115;104247;59295;37.5;21.3
12;2021-05-16;2;19;104249;59314;37.5;21.3
12;2021-05-17;1082;1810;105331;61124;37.8;22.0
12;2021-05-18;1427;1535;106758;62659;38.4;22.5
12;2021-05-19;1915;1330;108673;63989;39.0;23.0
12;2021-05-20;2118;876;110791;64865;39.8;23.3
12;2021-05-21;1821;1253;112612;66118;40.5;23.8
12;2021-05-22;1207;1016;113819;67134;40.9;24.1
12;2021-05-23;7;12;113826;67146;40.9;24.1
12;2021-05-24;1956;537;115782;67683;41.6;24.3
12;2021-05-25;1742;1159;117524;68842;42.2;24.7
12;2021-05-26;1998;780;119522;69622;42.9;25.0
12;2021-05-27;2165;744;121687;70366;43.7;25.3
12;2021-05-28;1927;1031;123614;71397;44.4;25.6
12;2021-05-29;1637;805;125251;72202;45.0;25.9
12;2021-05-30;9;43;125260;72245;45.0;26.0
12;2021-05-31;1699;817;126959;73062;45.6;26.2
12;2021-06-01;1887;1028;128846;74090;46.3;26.6
12;2021-06-02;1979;1051;130825;75141;47.0;27.0
12;2021-06-03;2123;831;132948;75972;47.8;27.3
12;2021-06-04;1967;1418;134915;77390;48.5;27.8
12;2021-06-05;1738;985;136653;78375;49.1;28.2
12;2021-06-06;6;6;136659;78381;49.1;28.2
12;2021-06-07;1092;1811;137751;80192;49.5;28.8
12;2021-06-08;1332;1201;139083;81393;50.0;29.2
12;2021-06-09;895;1292;139978;82685;50.3;29.7
12;2021-06-10;1022;920;141000;83605;50.7;30.0
12;2021-06-11;1204;2081;142204;85686;51.1;30.8
12;2021-06-12;1033;1322;143237;87008;51.5;31.3
12;2021-06-13;6;47;143243;87055;51.5;31.3
12;2021-06-14;662;1830;143905;88885;51.7;31.9
12;2021-06-15;745;1885;144650;90770;52.0;32.6
12;2021-06-16;820;1818;145470;92588;52.3;33.3
12;2021-06-17;678;995;146148;93583;52.5;33.6
12;2021-06-18;1134;1840;147282;95423;52.9;34.3
12;2021-06-19;914;1406;148196;96829;53.2;34.8
12;2021-06-20;4;10;148200;96839;53.2;34.8
12;2021-06-21;511;1737;148711;98576;53.4;35.4
12;2021-06-22;502;1474;149213;100050;53.6;35.9
12;2021-06-23;579;1306;149792;101356;53.8;36.4
12;2021-06-24;249;545;150041;101901;53.9;36.6
12;2021-06-25;876;1842;150917;103743;54.2;37.3
12;2021-06-26;673;1527;151590;105270;54.5;37.8
12;2021-06-27;1;9;151591;105279;54.5;37.8
12;2021-06-28;467;2454;152058;107733;54.6;38.7
12;2021-06-29;565;1958;152623;109691;54.8;39.4
12;2021-06-30;828;2132;153451;111823;55.1;40.2
12;2021-07-01;345;1086;153796;112909;55.3;40.6
12;2021-07-02;796;2629;154592;115538;55.5;41.5
12;2021-07-03;565;1872;155157;117410;55.7;42.2
12;2021-07-04;1;0;155158;117410;55.7;42.2
12;2021-07-05;440;2406;155598;119816;55.9;43.0
12;2021-07-06;640;2495;156238;122311;56.1;43.9
12;2021-07-07;688;2116;156926;124427;56.4;44.7
12;2021-07-08;295;913;157221;125340;56.5;45.0
12;2021-07-09;724;2589;157945;127929;56.7;46.0
12;2021-07-10;445;2077;158390;130006;56.9;46.7
12;2021-07-11;0;0;158390;130006;56.9;46.7
12;2021-07-12;587;2439;158977;132445;57.1;47.6
12;2021-07-13;840;2593;159817;135038;57.4;48.5
12;2021-07-14;44;25;159861;135063;57.4;48.5
12;2021-07-15;795;2107;160656;137170;57.7;49.3
12;2021-07-16;1247;2556;161903;139726;58.2;50.2
12;2021-07-17;790;2007;162693;141733;58.4;50.9
12;2021-07-18;25;11;162718;141744;58.5;50.9
12;2021-07-19;1319;2005;164037;143749;58.9;51.6
12;2021-07-20;1422;1475;165459;145224;59.4;52.2
12;2021-07-21;1022;941;166481;146165;59.8;52.5
12;2021-07-22;2236;1308;168717;147473;60.6;53.0
12;2021-07-23;1865;2064;170582;149537;61.3;53.7
12;2021-07-24;1604;1566;172186;151103;61.9;54.3
12;2021-07-25;97;28;172283;151131;61.9;54.3
12;2021-07-26;1930;1438;174213;152569;62.6;54.8
12;2021-07-27;2236;1011;176449;153580;63.4;55.2
12;2021-07-28;1715;675;178164;154255;64.0;55.4
12;2021-07-29;1189;807;179353;155062;64.4;55.7
12;2021-07-30;2507;1284;181860;156346;65.3;56.2
12;2021-07-31;1967;1005;183827;157351;66.0;56.5
12;2021-08-01;225;38;184052;157389;66.1;56.5
12;2021-08-02;1815;833;185867;158222;66.8;56.8
12;2021-08-03;1960;776;187827;158998;67.5;57.1
12;2021-08-04;1694;833;189521;159831;68.1;57.4
12;2021-08-05;1636;688;191157;160519;68.7;57.7
12;2021-08-06;1706;1314;192863;161833;69.3;58.1
12;2021-08-07;1448;744;194311;162577;69.8;58.4
12;2021-08-08;0;3;194311;162580;69.8;58.4
12;2021-08-09;1351;1415;195662;163995;70.3;58.9
12;2021-08-10;1343;1254;197005;165249;70.8;59.4
12;2021-08-11;820;1195;197825;166444;71.1;59.8
12;2021-08-12;737;1070;198562;167514;71.3;60.2
12;2021-08-13;1075;1335;199637;168849;71.7;60.7
12;2021-08-14;739;1354;200376;170203;72.0;61.1
12;2021-08-15;255;75;200631;170278;72.1;61.2
12;2021-08-16;670;1817;201301;172095;72.3;61.8
12;2021-08-17;905;1991;202206;174086;72.6;62.5
12;2021-08-18;448;1522;202654;175608;72.8;63.1
12;2021-08-19;641;1115;203295;176723;73.0;63.5
12;2021-08-20;797;1888;204092;178611;73.3;64.2
12;2021-08-21;473;1526;204565;180137;73.5;64.7
12;2021-08-22;93;27;204658;180164;73.5;64.7
12;2021-08-23;453;1921;205111;182085;73.7;65.4
12;2021-08-24;486;1918;205597;184003;73.9;66.1
12;2021-08-25;333;1579;205930;185582;74.0;66.7
12;2021-08-26;487;1607;206417;187189;74.2;67.2
12;2021-08-27;599;1699;207016;188888;74.4;67.9
12;2021-08-28;332;1553;207348;190441;74.5;68.4
12;2021-08-29;176;143;207524;190584;74.6;68.5
12;2021-08-30;563;1870;208087;192454;74.8;69.1
12;2021-08-31;419;1344;208506;193798;74.9;69.6
12;2021-09-01;425;923;208931;194721;75.1;70.0
12;2021-09-02;267;735;209198;195456;75.2;70.2
12;2021-09-03;490;1189;209688;196645;75.3;70.6
12;2021-09-04;432;1092;210120;197737;75.5;71.0
12;2021-09-05;52;192;210172;197929;75.5;71.1
12;2021-09-06;214;592;210386;198521;75.6;71.3
12;2021-09-07;270;482;210656;199003;75.7;71.5
12;2021-09-08;245;464;210901;199467;75.8;71.7
12;2021-09-09;174;394;211075;199861;75.8;71.8
12;2021-09-10;500;1005;211575;200866;76.0;72.2
12;2021-09-11;386;936;211961;201802;76.1;72.5
12;2021-09-12;17;102;211978;201904;76.2;72.5
12;2021-09-13;157;389;212135;202293;76.2;72.7
12;2021-09-14;280;349;212415;202642;76.3;72.8
12;2021-09-15;246;407;212661;203049;76.4;72.9
12;2021-09-16;387;412;213048;203461;76.5;73.1
12;2021-09-17;345;505;213393;203966;76.7;73.3
12;2021-09-18;242;687;213635;204653;76.7;73.5
12;2021-09-19;0;4;213635;204657;76.7;73.5
12;2021-09-20;107;432;213742;205089;76.8;73.7
12;2021-09-21;112;220;213854;205309;76.8;73.8
12;2021-09-22;132;578;213986;205887;76.9;74.0
12;2021-09-23;106;161;214092;206048;76.9;74.0
12;2021-09-24;216;535;214308;206583;77.0;74.2
12;2021-09-25;161;667;214469;207250;77.0;74.5
12;2021-09-26;0;1;214469;207251;77.0;74.5
12;2021-09-27;82;242;214551;207493;77.1;74.5
12;2021-09-28;96;252;214647;207745;77.1;74.6
12;2021-09-29;112;325;214759;208070;77.2;74.7
12;2021-09-30;51;123;214810;208193;77.2;74.8
12;2021-10-01;161;404;214971;208597;77.2;74.9
12;2021-10-02;182;478;215153;209075;77.3;75.1
12;2021-10-03;0;2;215153;209077;77.3;75.1
12;2021-10-04;84;169;215237;209246;77.3;75.2
12;2021-10-05;67;191;215304;209437;77.3;75.2
12;2021-10-06;117;266;215421;209703;77.4;75.3
12;2021-10-07;67;317;215488;210020;77.4;75.4
12;2021-10-08;153;401;215641;210421;77.5;75.6
12;2021-10-09;168;346;215809;210767;77.5;75.7
12;2021-10-10;1;0;215810;210767;77.5;75.7
12;2021-10-11;54;98;215864;210865;77.5;75.8
13;2020-12-27;5;0;5;0;0.0;0.0
13;2020-12-28;6;0;11;0;0.0;0.0
13;2020-12-29;1;0;12;0;0.0;0.0
13;2020-12-30;3;0;15;0;0.0;0.0
13;2020-12-31;6;0;21;0;0.0;0.0
13;2021-01-01;4;1;25;1;0.0;0.0
13;2021-01-02;4;0;29;1;0.0;0.0
13;2021-01-03;11;3;40;4;0.0;0.0
13;2021-01-04;1;1;41;5;0.0;0.0
13;2021-01-05;80;1;121;6;0.0;0.0
13;2021-01-06;122;0;243;6;0.0;0.0
13;2021-01-07;174;1;417;7;0.0;0.0
13;2021-01-08;189;0;606;7;0.0;0.0
13;2021-01-09;13;0;619;7;0.0;0.0
13;2021-01-10;3;0;622;7;0.0;0.0
13;2021-01-11;482;2;1104;9;0.1;0.0
13;2021-01-12;813;2;1917;11;0.1;0.0
13;2021-01-13;1087;2;3004;13;0.1;0.0
13;2021-01-14;1588;29;4592;42;0.2;0.0
13;2021-01-15;1538;9;6130;51;0.3;0.0
13;2021-01-16;406;3;6536;54;0.3;0.0
13;2021-01-17;44;0;6580;54;0.3;0.0
13;2021-01-18;2389;10;8969;64;0.4;0.0
13;2021-01-19;7419;53;16388;117;0.8;0.0
13;2021-01-20;5585;32;21973;149;1.1;0.0
13;2021-01-21;5363;38;27336;187;1.3;0.0
13;2021-01-22;4007;26;31343;213;1.5;0.0
13;2021-01-23;1358;8;32701;221;1.6;0.0
13;2021-01-24;491;6;33192;227;1.6;0.0
13;2021-01-25;2342;31;35534;258;1.7;0.0
13;2021-01-26;2951;92;38485;350;1.9;0.0
13;2021-01-27;3121;126;41606;476;2.0;0.0
13;2021-01-28;3252;198;44858;674;2.2;0.0
13;2021-01-29;2513;138;47371;812;2.3;0.0
13;2021-01-30;1025;12;48396;824;2.4;0.0
13;2021-01-31;252;2;48648;826;2.4;0.0
13;2021-02-01;1864;291;50512;1117;2.5;0.1
13;2021-02-02;2258;614;52770;1731;2.6;0.1
13;2021-02-03;1869;580;54639;2311;2.7;0.1
13;2021-02-04;1907;929;56546;3240;2.8;0.2
13;2021-02-05;2629;1556;59175;4796;2.9;0.2
13;2021-02-06;857;312;60032;5108;3.0;0.3
13;2021-02-07;279;6;60311;5114;3.0;0.3
13;2021-02-08;1906;1544;62217;6658;3.1;0.3
13;2021-02-09;3320;4465;65537;11123;3.2;0.5
13;2021-02-10;3249;3419;68786;14542;3.4;0.7
13;2021-02-11;3584;3597;72370;18139;3.6;0.9
13;2021-02-12;2840;3146;75210;21285;3.7;1.0
13;2021-02-13;734;597;75944;21882;3.7;1.1
13;2021-02-14;73;378;76017;22260;3.7;1.1
13;2021-02-15;971;2026;76988;24286;3.8;1.2
13;2021-02-16;1396;2629;78384;26915;3.9;1.3
13;2021-02-17;1350;3002;79734;29917;3.9;1.5
13;2021-02-18;1904;2687;81638;32604;4.0;1.6
13;2021-02-19;1517;2183;83155;34787;4.1;1.7
13;2021-02-20;458;783;83613;35570;4.1;1.7
13;2021-02-21;33;284;83646;35854;4.1;1.8
13;2021-02-22;1023;2262;84669;38116;4.2;1.9
13;2021-02-23;1290;2678;85959;40794;4.2;2.0
13;2021-02-24;1520;2623;87479;43417;4.3;2.1
13;2021-02-25;2384;2151;89863;45568;4.4;2.2
13;2021-02-26;2459;2130;92322;47698;4.5;2.3
13;2021-02-27;983;750;93305;48448;4.6;2.4
13;2021-02-28;195;208;93500;48656;4.6;2.4
13;2021-03-01;1927;1538;95427;50194;4.7;2.5
13;2021-03-02;3012;2643;98439;52837;4.8;2.6
13;2021-03-03;3491;2584;101930;55421;5.0;2.7
13;2021-03-04;4208;3155;106138;58576;5.2;2.9
13;2021-03-05;4043;2799;110181;61375;5.4;3.0
13;2021-03-06;5304;841;115485;62216;5.7;3.1
13;2021-03-07;4296;384;119781;62600;5.9;3.1
13;2021-03-08;3930;2013;123711;64613;6.1;3.2
13;2021-03-09;5082;2296;128793;66909;6.3;3.3
13;2021-03-10;5179;2004;133972;68913;6.6;3.4
13;2021-03-11;7312;2165;141284;71078;6.9;3.5
13;2021-03-12;8334;2139;149618;73217;7.4;3.6
13;2021-03-13;6379;750;155997;73967;7.7;3.6
13;2021-03-14;2313;175;158310;74142;7.8;3.6
13;2021-03-15;6358;1334;164668;75476;8.1;3.7
13;2021-03-16;5078;1562;169746;77038;8.3;3.8
13;2021-03-17;5174;1436;174920;78474;8.6;3.9
13;2021-03-18;5816;1900;180736;80374;8.9;4.0
13;2021-03-19;6811;1625;187547;81999;9.2;4.0
13;2021-03-20;4045;708;191592;82707;9.4;4.1
13;2021-03-21;727;89;192319;82796;9.5;4.1
13;2021-03-22;7297;1572;199616;84368;9.8;4.1
13;2021-03-23;9132;1779;208748;86147;10.3;4.2
13;2021-03-24;8867;2207;217615;88354;10.7;4.3
13;2021-03-25;10917;2136;228532;90490;11.2;4.4
13;2021-03-26;10717;1942;239249;92432;11.8;4.5
13;2021-03-27;4869;842;244118;93274;12.0;4.6
13;2021-03-28;1120;83;245238;93357;12.1;4.6
13;2021-03-29;7579;2022;252817;95379;12.4;4.7
13;2021-03-30;12617;2557;265434;97936;13.0;4.8
13;2021-03-31;10810;3207;276244;101143;13.6;5.0
13;2021-04-01;12276;3126;288520;104269;14.2;5.1
13;2021-04-02;9790;3917;298310;108186;14.7;5.3
13;2021-04-03;4007;2819;302317;111005;14.9;5.5
13;2021-04-04;631;307;302948;111312;14.9;5.5
13;2021-04-05;3537;734;306485;112046;15.1;5.5
13;2021-04-06;8520;4271;315005;116317;15.5;5.7
13;2021-04-07;10077;4712;325082;121029;16.0;5.9
13;2021-04-08;10117;5489;335199;126518;16.5;6.2
13;2021-04-09;11281;5147;346480;131665;17.0;6.5
13;2021-04-10;7300;2107;353780;133772;17.4;6.6
13;2021-04-11;1380;535;355160;134307;17.5;6.6
13;2021-04-12;7984;4825;363144;139132;17.8;6.8
13;2021-04-13;9146;5529;372290;144661;18.3;7.1
13;2021-04-14;9535;5835;381825;150496;18.8;7.4
13;2021-04-15;9880;5980;391705;156476;19.3;7.7
13;2021-04-16;9968;5585;401673;162061;19.7;8.0
13;2021-04-17;4079;2028;405752;164089;19.9;8.1
13;2021-04-18;2527;1426;408279;165515;20.1;8.1
13;2021-04-19;6458;6419;414737;171934;20.4;8.5
13;2021-04-20;7403;7617;422140;179551;20.7;8.8
13;2021-04-21;7772;7393;429912;186944;21.1;9.2
13;2021-04-22;8461;7940;438373;194884;21.5;9.6
13;2021-04-23;8395;6848;446768;201732;22.0;9.9
13;2021-04-24;4624;3819;451392;205551;22.2;10.1
13;2021-04-25;877;528;452269;206079;22.2;10.1
13;2021-04-26;6167;7122;458436;213201;22.5;10.5
13;2021-04-27;7264;8044;465700;221245;22.9;10.9
13;2021-04-28;9453;7733;475153;228978;23.4;11.3
13;2021-04-29;11408;7637;486561;236615;23.9;11.6
13;2021-04-30;10918;7388;497479;244003;24.5;12.0
13;2021-05-01;5365;3799;502844;247802;24.7;12.2
13;2021-05-02;2101;750;504945;248552;24.8;12.2
13;2021-05-03;7295;7874;512240;256426;25.2;12.6
13;2021-05-04;8456;8523;520696;264949;25.6;13.0
13;2021-05-05;8226;8982;528922;273931;26.0;13.5
13;2021-05-06;10143;8600;539065;282531;26.5;13.9
13;2021-05-07;8852;10047;547917;292578;26.9;14.4
13;2021-05-08;4568;3938;552485;296516;27.2;14.6
13;2021-05-09;939;688;553424;297204;27.2;14.6
13;2021-05-10;7710;8772;561134;305976;27.6;15.0
13;2021-05-11;10979;9582;572113;315558;28.1;15.5
13;2021-05-12;12841;8735;584954;324293;28.8;15.9
13;2021-05-13;9508;3642;594462;327935;29.2;16.1
13;2021-05-14;13656;6455;608118;334390;29.9;16.4
13;2021-05-15;10196;4540;618314;338930;30.4;16.7
13;2021-05-16;3129;794;621443;339724;30.5;16.7
13;2021-05-17;10843;6813;632286;346537;31.1;17.0
13;2021-05-18;11924;6486;644210;353023;31.7;17.4
13;2021-05-19;12157;6361;656367;359384;32.3;17.7
13;2021-05-20;13444;6470;669811;365854;32.9;18.0
13;2021-05-21;12990;6784;682801;372638;33.6;18.3
13;2021-05-22;7514;3638;690315;376276;33.9;18.5
13;2021-05-23;862;638;691177;376914;34.0;18.5
13;2021-05-24;6761;2469;697938;379383;34.3;18.6
13;2021-05-25;9270;7596;707208;386979;34.8;19.0
13;2021-05-26;10144;7838;717352;394817;35.3;19.4
13;2021-05-27;10338;8422;727690;403239;35.8;19.8
13;2021-05-28;9005;9175;736695;412414;36.2;20.3
13;2021-05-29;7173;4625;743868;417039;36.6;20.5
13;2021-05-30;891;527;744759;417566;36.6;20.5
13;2021-05-31;8184;8032;752943;425598;37.0;20.9
13;2021-06-01;9579;9299;762522;434897;37.5;21.4
13;2021-06-02;10082;8786;772604;443683;38.0;21.8
13;2021-06-03;12295;9500;784899;453183;38.6;22.3
13;2021-06-04;12025;10047;796924;463230;39.2;22.8
13;2021-06-05;7821;5596;804745;468826;39.6;23.0
13;2021-06-06;1671;887;806416;469713;39.6;23.1
13;2021-06-07;6686;9883;813102;479596;40.0;23.6
13;2021-06-08;8317;9995;821419;489591;40.4;24.1
13;2021-06-09;8397;9742;829816;499333;40.8;24.5
13;2021-06-10;8953;9787;838769;509120;41.2;25.0
13;2021-06-11;8231;12714;847000;521834;41.6;25.6
13;2021-06-12;5778;6704;852778;528538;41.9;26.0
13;2021-06-13;950;1216;853728;529754;42.0;26.0
13;2021-06-14;5994;11143;859722;540897;42.3;26.6
13;2021-06-15;7284;11407;867006;552304;42.6;27.1
13;2021-06-16;7340;9868;874346;562172;43.0;27.6
13;2021-06-17;7444;10717;881790;572889;43.3;28.2
13;2021-06-18;7550;11076;889340;583965;43.7;28.7
13;2021-06-19;4616;7499;893956;591464;43.9;29.1
13;2021-06-20;1861;1045;895817;592509;44.0;29.1
13;2021-06-21;4462;12262;900279;604771;44.3;29.7
13;2021-06-22;4941;13877;905220;618648;44.5;30.4
13;2021-06-23;5148;13578;910368;632226;44.7;31.1
13;2021-06-24;5342;12855;915710;645081;45.0;31.7
13;2021-06-25;5243;14681;920953;659762;45.3;32.4
13;2021-06-26;3016;9681;923969;669443;45.4;32.9
13;2021-06-27;537;931;924506;670374;45.4;33.0
13;2021-06-28;3731;12564;928237;682938;45.6;33.6
13;2021-06-29;4500;12904;932737;695842;45.8;34.2
13;2021-06-30;4904;12698;937641;708540;46.1;34.8
13;2021-07-01;5580;11499;943221;720039;46.4;35.4
13;2021-07-02;5572;12398;948793;732437;46.6;36.0
13;2021-07-03;3504;9161;952297;741598;46.8;36.5
13;2021-07-04;476;867;952773;742465;46.8;36.5
13;2021-07-05;3872;11778;956645;754243;47.0;37.1
13;2021-07-06;5461;11681;962106;765924;47.3;37.6
13;2021-07-07;5822;10707;967928;776631;47.6;38.2
13;2021-07-08;6231;10330;974159;786961;47.9;38.7
13;2021-07-09;5933;11935;980092;798896;48.2;39.3
13;2021-07-10;3163;8637;983255;807533;48.3;39.7
13;2021-07-11;435;1012;983690;808545;48.4;39.7
13;2021-07-12;4493;10949;988183;819494;48.6;40.3
13;2021-07-13;8981;13187;997164;832681;49.0;40.9
13;2021-07-14;5610;4872;1002774;837553;49.3;41.2
13;2021-07-15;11438;12948;1014212;850501;49.9;41.8
13;2021-07-16;12195;12936;1026407;863437;50.5;42.4
13;2021-07-17;6584;8494;1032991;871931;50.8;42.9
13;2021-07-18;727;1062;1033718;872993;50.8;42.9
13;2021-07-19;9809;11153;1043527;884146;51.3;43.5
13;2021-07-20;12273;11664;1055800;895810;51.9;44.0
13;2021-07-21;12689;10363;1068489;906173;52.5;44.5
13;2021-07-22;14557;10469;1083046;916642;53.2;45.1
13;2021-07-23;14485;10982;1097531;927624;53.9;45.6
13;2021-07-24;8343;7980;1105874;935604;54.4;46.0
13;2021-07-25;1017;785;1106891;936389;54.4;46.0
13;2021-07-26;11649;9124;1118540;945513;55.0;46.5
13;2021-07-27;13608;9426;1132148;954939;55.6;46.9
13;2021-07-28;12340;8187;1144488;963126;56.3;47.3
13;2021-07-29;13765;8096;1158253;971222;56.9;47.7
13;2021-07-30;13716;8644;1171969;979866;57.6;48.2
13;2021-07-31;8678;5846;1180647;985712;58.0;48.5
13;2021-08-01;1107;730;1181754;986442;58.1;48.5
13;2021-08-02;10054;6733;1191808;993175;58.6;48.8
13;2021-08-03;11073;7301;1202881;1000476;59.1;49.2
13;2021-08-04;9429;6574;1212310;1007050;59.6;49.5
13;2021-08-05;9527;7583;1221837;1014633;60.1;49.9
13;2021-08-06;9198;9006;1231035;1023639;60.5;50.3
13;2021-08-07;5441;5586;1236476;1029225;60.8;50.6
13;2021-08-08;905;805;1237381;1030030;60.8;50.6
13;2021-08-09;8398;9080;1245779;1039110;61.2;51.1
13;2021-08-10;9149;8913;1254928;1048023;61.7;51.5
13;2021-08-11;7910;8545;1262838;1056568;62.1;51.9
13;2021-08-12;7791;9674;1270629;1066242;62.5;52.4
13;2021-08-13;6959;9191;1277588;1075433;62.8;52.9
13;2021-08-14;3690;6456;1281278;1081889;63.0;53.2
13;2021-08-15;485;731;1281763;1082620;63.0;53.2
13;2021-08-16;6579;11082;1288342;1093702;63.3;53.8
13;2021-08-17;6674;10617;1295016;1104319;63.7;54.3
13;2021-08-18;6343;10181;1301359;1114500;64.0;54.8
13;2021-08-19;6670;10617;1308029;1125117;64.3;55.3
13;2021-08-20;5832;11237;1313861;1136354;64.6;55.9
13;2021-08-21;2617;7568;1316478;1143922;64.7;56.2
13;2021-08-22;369;1090;1316847;1145012;64.7;56.3
13;2021-08-23;4976;11223;1321823;1156235;65.0;56.8
13;2021-08-24;5447;10918;1327270;1167153;65.2;57.4
13;2021-08-25;5213;10099;1332483;1177252;65.5;57.9
13;2021-08-26;5129;9786;1337612;1187038;65.7;58.3
13;2021-08-27;5092;10635;1342704;1197673;66.0;58.9
13;2021-08-28;2361;6461;1345065;1204134;66.1;59.2
13;2021-08-29;338;1139;1345403;1205273;66.1;59.2
13;2021-08-30;4243;9719;1349646;1214992;66.3;59.7
13;2021-08-31;4870;9914;1354516;1224906;66.6;60.2
13;2021-09-01;4703;8264;1359219;1233170;66.8;60.6
13;2021-09-02;4773;8004;1363992;1241174;67.0;61.0
13;2021-09-03;4274;8650;1368266;1249824;67.3;61.4
13;2021-09-04;2173;5408;1370439;1255232;67.4;61.7
13;2021-09-05;185;347;1370624;1255579;67.4;61.7
13;2021-09-06;3141;6034;1373765;1261613;67.5;62.0
13;2021-09-07;3220;6245;1376985;1267858;67.7;62.3
13;2021-09-08;3512;6352;1380497;1274210;67.9;62.6
13;2021-09-09;3166;5729;1383663;1279939;68.0;62.9
13;2021-09-10;3671;6748;1387334;1286687;68.2;63.2
13;2021-09-11;2292;5143;1389626;1291830;68.3;63.5
13;2021-09-12;230;293;1389856;1292123;68.3;63.5
13;2021-09-13;2504;4264;1392360;1296387;68.4;63.7
13;2021-09-14;3203;4613;1395563;1301000;68.6;63.9
13;2021-09-15;2880;5519;1398443;1306519;68.7;64.2
13;2021-09-16;2219;3902;1400662;1310421;68.8;64.4
13;2021-09-17;2333;4875;1402995;1315296;69.0;64.7
13;2021-09-18;1532;4250;1404527;1319546;69.0;64.9
13;2021-09-19;125;176;1404652;1319722;69.0;64.9
13;2021-09-20;1539;3306;1406191;1323028;69.1;65.0
13;2021-09-21;1471;2926;1407662;1325954;69.2;65.2
13;2021-09-22;1684;4543;1409346;1330497;69.3;65.4
13;2021-09-23;1646;3537;1410992;1334034;69.4;65.6
13;2021-09-24;1619;4272;1412611;1338306;69.4;65.8
13;2021-09-25;1229;3967;1413840;1342273;69.5;66.0
13;2021-09-26;87;258;1413927;1342531;69.5;66.0
13;2021-09-27;1251;3154;1415178;1345685;69.6;66.1
13;2021-09-28;1326;2637;1416504;1348322;69.6;66.3
13;2021-09-29;1601;3553;1418105;1351875;69.7;66.4
13;2021-09-30;1357;3199;1419462;1355074;69.8;66.6
13;2021-10-01;1557;3565;1421019;1358639;69.8;66.8
13;2021-10-02;1176;2815;1422195;1361454;69.9;66.9
13;2021-10-03;101;418;1422296;1361872;69.9;66.9
13;2021-10-04;622;1591;1422918;1363463;69.9;67.0
13;2021-10-05;1134;2458;1424052;1365921;70.0;67.1
13;2021-10-06;1257;3139;1425309;1369060;70.1;67.3
13;2021-10-07;1019;2498;1426328;1371558;70.1;67.4
13;2021-10-08;1360;3251;1427688;1374809;70.2;67.6
13;2021-10-09;914;2321;1428602;1377130;70.2;67.7
13;2021-10-10;81;120;1428683;1377250;70.2;67.7
13;2021-10-11;900;1696;1429583;1378946;70.3;67.8
14;2020-12-27;0;0;0;0;0.0;0.0
14;2020-12-28;1;1;1;1;0.0;0.0
14;2020-12-29;1;0;2;1;0.0;0.0
14;2020-12-30;0;0;2;1;0.0;0.0
14;2020-12-31;3;0;5;1;0.0;0.0
14;2021-01-01;2;0;7;1;0.0;0.0
14;2021-01-02;1;0;8;1;0.0;0.0
14;2021-01-03;0;0;8;1;0.0;0.0
14;2021-01-04;10;0;18;1;0.0;0.0
14;2021-01-05;24;0;42;1;0.0;0.0
14;2021-01-06;352;0;394;1;0.1;0.0
14;2021-01-07;402;2;796;3;0.1;0.0
14;2021-01-08;631;5;1427;8;0.2;0.0
14;2021-01-09;127;0;1554;8;0.2;0.0
14;2021-01-10;41;0;1595;8;0.2;0.0
14;2021-01-11;674;5;2269;13;0.3;0.0
14;2021-01-12;954;7;3223;20;0.5;0.0
14;2021-01-13;850;1;4073;21;0.6;0.0
14;2021-01-14;2841;28;6914;49;1.0;0.0
14;2021-01-15;1898;22;8812;71;1.3;0.0
14;2021-01-16;271;3;9083;74;1.3;0.0
14;2021-01-17;145;7;9228;81;1.3;0.0
14;2021-01-18;1086;6;10314;87;1.5;0.0
14;2021-01-19;1155;3;11469;90;1.7;0.0
14;2021-01-20;1987;5;13456;95;1.9;0.0
14;2021-01-21;1817;7;15273;102;2.2;0.0
14;2021-01-22;1494;6;16767;108;2.4;0.0
14;2021-01-23;297;1;17064;109;2.5;0.0
14;2021-01-24;73;1;17137;110;2.5;0.0
14;2021-01-25;911;10;18048;120;2.6;0.0
14;2021-01-26;848;37;18896;157;2.7;0.0
14;2021-01-27;884;160;19780;317;2.9;0.0
14;2021-01-28;782;145;20562;462;3.0;0.1
14;2021-01-29;786;230;21348;692;3.1;0.1
14;2021-01-30;270;12;21618;704;3.1;0.1
14;2021-01-31;58;3;21676;707;3.1;0.1
14;2021-02-01;729;226;22405;933;3.2;0.1
14;2021-02-02;830;420;23235;1353;3.4;0.2
14;2021-02-03;761;387;23996;1740;3.5;0.3
14;2021-02-04;1170;2056;25166;3796;3.6;0.5
14;2021-02-05;1296;1315;26462;5111;3.8;0.7
14;2021-02-06;398;237;26860;5348;3.9;0.8
14;2021-02-07;180;72;27040;5420;3.9;0.8
14;2021-02-08;773;822;27813;6242;4.0;0.9
14;2021-02-09;723;1009;28536;7251;4.1;1.0
14;2021-02-10;825;1607;29361;8858;4.2;1.3
14;2021-02-11;1351;1430;30712;10288;4.4;1.5
14;2021-02-12;1383;1080;32095;11368;4.6;1.6
14;2021-02-13;308;186;32403;11554;4.7;1.7
14;2021-02-14;84;64;32487;11618;4.7;1.7
14;2021-02-15;443;1077;32930;12695;4.8;1.8
14;2021-02-16;679;976;33609;13671;4.9;2.0
14;2021-02-17;405;978;34014;14649;4.9;2.1
14;2021-02-18;707;884;34721;15533;5.0;2.2
14;2021-02-19;734;777;35455;16310;5.1;2.4
14;2021-02-20;91;268;35546;16578;5.1;2.4
14;2021-02-21;6;90;35552;16668;5.1;2.4
14;2021-02-22;432;1040;35984;17708;5.2;2.6
14;2021-02-23;487;920;36471;18628;5.3;2.7
14;2021-02-24;441;890;36912;19518;5.3;2.8
14;2021-02-25;1224;1177;38136;20695;5.5;3.0
14;2021-02-26;1576;1161;39712;21856;5.7;3.2
14;2021-02-27;507;269;40219;22125;5.8;3.2
14;2021-02-28;27;41;40246;22166;5.8;3.2
14;2021-03-01;522;929;40768;23095;5.9;3.3
14;2021-03-02;966;807;41734;23902;6.0;3.5
14;2021-03-03;1080;841;42814;24743;6.2;3.6
14;2021-03-04;1950;794;44764;25537;6.5;3.7
14;2021-03-05;2433;881;47197;26418;6.8;3.8
14;2021-03-06;3078;210;50275;26628;7.3;3.9
14;2021-03-07;1196;64;51471;26692;7.4;3.9
14;2021-03-08;1254;816;52725;27508;7.6;4.0
14;2021-03-09;1741;699;54466;28207;7.9;4.1
14;2021-03-10;1835;594;56301;28801;8.1;4.2
14;2021-03-11;2759;480;59060;29281;8.5;4.2
14;2021-03-12;4047;583;63107;29864;9.1;4.3
14;2021-03-13;1852;179;64959;30043;9.4;4.3
14;2021-03-14;31;39;64990;30082;9.4;4.4
14;2021-03-15;2006;143;66996;30225;9.7;4.4
14;2021-03-16;1401;279;68397;30504;9.9;4.4
14;2021-03-17;1155;197;69552;30701;10.1;4.4
14;2021-03-18;1481;305;71033;31006;10.3;4.5
14;2021-03-19;2608;272;73641;31278;10.7;4.5
14;2021-03-20;2659;43;76300;31321;11.0;4.5
14;2021-03-21;454;9;76754;31330;11.1;4.5
14;2021-03-22;1872;363;78626;31693;11.4;4.6
14;2021-03-23;2179;327;80805;32020;11.7;4.6
14;2021-03-24;2432;195;83237;32215;12.0;4.7
14;2021-03-25;3292;327;86529;32542;12.5;4.7
14;2021-03-26;4609;485;91138;33027;13.2;4.8
14;2021-03-27;2230;234;93368;33261;13.5;4.8
14;2021-03-28;36;1;93404;33262;13.5;4.8
14;2021-03-29;1614;487;95018;33749;13.7;4.9
14;2021-03-30;2722;519;97740;34268;14.1;5.0
14;2021-03-31;2326;931;100066;35199;14.5;5.1
14;2021-04-01;4177;1688;104243;36887;15.1;5.3
14;2021-04-02;3867;1275;108110;38162;15.6;5.5
14;2021-04-03;1126;1206;109236;39368;15.8;5.7
14;2021-04-04;25;483;109261;39851;15.8;5.8
14;2021-04-05;1218;325;110479;40176;16.0;5.8
14;2021-04-06;2383;1001;112862;41177;16.3;6.0
14;2021-04-07;2730;1037;115592;42214;16.7;6.1
14;2021-04-08;4303;1125;119895;43339;17.3;6.3
14;2021-04-09;6031;1193;125926;44532;18.2;6.4
14;2021-04-10;2896;444;128822;44976;18.6;6.5
14;2021-04-11;629;125;129451;45101;18.7;6.5
14;2021-04-12;2915;1589;132366;46690;19.1;6.8
14;2021-04-13;3471;1450;135837;48140;19.6;7.0
14;2021-04-14;3123;1174;138960;49314;20.1;7.1
14;2021-04-15;4398;1520;143358;50834;20.7;7.4
14;2021-04-16;4598;1569;147956;52403;21.4;7.6
14;2021-04-17;2312;1667;150268;54070;21.7;7.8
14;2021-04-18;539;328;150807;54398;21.8;7.9
14;2021-04-19;2760;1706;153567;56104;22.2;8.1
14;2021-04-20;3390;1836;156957;57940;22.7;8.4
14;2021-04-21;3015;1477;159972;59417;23.1;8.6
14;2021-04-22;4230;2095;164202;61512;23.7;8.9
14;2021-04-23;4651;2316;168853;63828;24.4;9.2
14;2021-04-24;1851;1757;170704;65585;24.7;9.5
14;2021-04-25;456;29;171160;65614;24.8;9.5
14;2021-04-26;3379;1572;174539;67186;25.2;9.7
14;2021-04-27;3502;2579;178041;69765;25.7;10.1
14;2021-04-28;3245;1899;181286;71664;26.2;10.4
14;2021-04-29;4544;2316;185830;73980;26.9;10.7
14;2021-04-30;5124;2653;190954;76633;27.6;11.1
14;2021-05-01;3554;204;194508;76837;28.1;11.1
14;2021-05-02;1238;56;195746;76893;28.3;11.1
14;2021-05-03;2482;2770;198228;79663;28.7;11.5
14;2021-05-04;3128;2913;201356;82576;29.1;11.9
14;2021-05-05;3687;2760;205043;85336;29.7;12.3
14;2021-05-06;4929;3490;209972;88826;30.4;12.8
14;2021-05-07;4870;3854;214842;92680;31.1;13.4
14;2021-05-08;2728;1265;217570;93945;31.5;13.6
14;2021-05-09;1914;671;219484;94616;31.7;13.7
14;2021-05-10;3637;3152;223121;97768;32.3;14.1
14;2021-05-11;4346;3610;227467;101378;32.9;14.7
14;2021-05-12;4052;3224;231519;104602;33.5;15.1
14;2021-05-13;4688;1132;236207;105734;34.2;15.3
14;2021-05-14;6674;2629;242881;108363;35.1;15.7
14;2021-05-15;5148;778;248029;109141;35.9;15.8
14;2021-05-16;2319;120;250348;109261;36.2;15.8
14;2021-05-17;2820;2261;253168;111522;36.6;16.1
14;2021-05-18;4089;2244;257257;113766;37.2;16.5
14;2021-05-19;3752;2023;261009;115789;37.7;16.7
14;2021-05-20;4482;2768;265491;118557;38.4;17.1
14;2021-05-21;4276;3528;269767;122085;39.0;17.7
14;2021-05-22;1669;865;271436;122950;39.3;17.8
14;2021-05-23;649;71;272085;123021;39.3;17.8
14;2021-05-24;2845;751;274930;123772;39.8;17.9
14;2021-05-25;3635;3387;278565;127159;40.3;18.4
14;2021-05-26;3438;2407;282003;129566;40.8;18.7
14;2021-05-27;4771;3241;286774;132807;41.5;19.2
14;2021-05-28;5090;3893;291864;136700;42.2;19.8
14;2021-05-29;2342;2458;294206;139158;42.5;20.1
14;2021-05-30;759;237;294965;139395;42.7;20.2
14;2021-05-31;4089;2967;299054;142362;43.3;20.6
14;2021-06-01;5738;3218;304792;145580;44.1;21.1
14;2021-06-02;5024;2862;309816;148442;44.8;21.5
14;2021-06-03;6658;4019;316474;152461;45.8;22.0
14;2021-06-04;6444;5142;322918;157603;46.7;22.8
14;2021-06-05;4359;1866;327277;159469;47.3;23.1
14;2021-06-06;2043;83;329320;159552;47.6;23.1
14;2021-06-07;4253;3452;333573;163004;48.2;23.6
14;2021-06-08;5234;3132;338807;166136;49.0;24.0
14;2021-06-09;4270;2967;343077;169103;49.6;24.5
14;2021-06-10;5080;2973;348157;172076;50.4;24.9
14;2021-06-11;4840;4887;352997;176963;51.1;25.6
14;2021-06-12;3677;4520;356674;181483;51.6;26.2
14;2021-06-13;848;1089;357522;182572;51.7;26.4
14;2021-06-14;2185;3792;359707;186364;52.0;27.0
14;2021-06-15;3314;3970;363021;190334;52.5;27.5
14;2021-06-16;3446;4556;366467;194890;53.0;28.2
14;2021-06-17;4230;5269;370697;200159;53.6;28.9
14;2021-06-18;3732;6121;374429;206280;54.2;29.8
14;2021-06-19;2591;2951;377020;209231;54.5;30.3
14;2021-06-20;581;1556;377601;210787;54.6;30.5
14;2021-06-21;2121;4359;379722;215146;54.9;31.1
14;2021-06-22;2582;5180;382304;220326;55.3;31.9
14;2021-06-23;2503;4348;384807;224674;55.7;32.5
14;2021-06-24;3450;5811;388257;230485;56.2;33.3
14;2021-06-25;2752;7278;391009;237763;56.5;34.4
14;2021-06-26;2177;4539;393186;242302;56.9;35.0
14;2021-06-27;440;1828;393626;244130;56.9;35.3
14;2021-06-28;1311;3970;394937;248100;57.1;35.9
14;2021-06-29;1789;5365;396726;253465;57.4;36.7
14;2021-06-30;2024;4618;398750;258083;57.7;37.3
14;2021-07-01;2931;5072;401681;263155;58.1;38.1
14;2021-07-02;2600;6669;404281;269824;58.5;39.0
14;2021-07-03;1430;2647;405711;272471;58.7;39.4
14;2021-07-04;422;713;406133;273184;58.7;39.5
14;2021-07-05;1191;4777;407324;277961;58.9;40.2
14;2021-07-06;2090;6002;409414;283963;59.2;41.1
14;2021-07-07;2257;4578;411671;288541;59.5;41.7
14;2021-07-08;2912;5527;414583;294068;60.0;42.5
14;2021-07-09;2771;6433;417354;300501;60.4;43.5
14;2021-07-10;2037;3203;419391;303704;60.7;43.9
14;2021-07-11;900;871;420291;304575;60.8;44.0
14;2021-07-12;1634;5904;421925;310479;61.0;44.9
14;2021-07-13;3081;7340;425006;317819;61.5;46.0
14;2021-07-14;2260;3065;427266;320884;61.8;46.4
14;2021-07-15;4172;7655;431438;328539;62.4;47.5
14;2021-07-16;4708;7696;436146;336235;63.1;48.6
14;2021-07-17;2114;4214;438260;340449;63.4;49.2
14;2021-07-18;821;1870;439081;342319;63.5;49.5
14;2021-07-19;2599;6128;441680;348447;63.9;50.4
14;2021-07-20;3247;7258;444927;355705;64.3;51.4
14;2021-07-21;4105;5846;449032;361551;64.9;52.3
14;2021-07-22;4852;6604;453884;368155;65.6;53.2
14;2021-07-23;5384;6771;459268;374926;66.4;54.2
14;2021-07-24;3084;3795;462352;378721;66.9;54.8
14;2021-07-25;1504;1249;463856;379970;67.1;55.0
14;2021-07-26;4682;4186;468538;384156;67.8;55.6
14;2021-07-27;5404;4364;473942;388520;68.5;56.2
14;2021-07-28;5117;3974;479059;392494;69.3;56.8
14;2021-07-29;6446;4887;485505;397381;70.2;57.5
14;2021-07-30;5842;5171;491347;402552;71.1;58.2
14;2021-07-31;2774;2513;494121;405065;71.5;58.6
14;2021-08-01;1895;934;496016;405999;71.7;58.7
14;2021-08-02;3948;4293;499964;410292;72.3;59.3
14;2021-08-03;4482;4173;504446;414465;73.0;59.9
14;2021-08-04;4650;3538;509096;418003;73.6;60.5
14;2021-08-05;4658;4039;513754;422042;74.3;61.0
14;2021-08-06;4431;4808;518185;426850;74.9;61.7
14;2021-08-07;2133;2295;520318;429145;75.2;62.1
14;2021-08-08;638;854;520956;429999;75.3;62.2
14;2021-08-09;2129;2877;523085;432876;75.7;62.6
14;2021-08-10;3663;4171;526748;437047;76.2;63.2
14;2021-08-11;3076;3456;529824;440503;76.6;63.7
14;2021-08-12;3481;4351;533305;444854;77.1;64.3
14;2021-08-13;2638;4139;535943;448993;77.5;64.9
14;2021-08-14;1423;2009;537366;451002;77.7;65.2
14;2021-08-15;389;1484;537755;452486;77.8;65.4
14;2021-08-16;1833;2785;539588;455271;78.0;65.8
14;2021-08-17;2263;4570;541851;459841;78.4;66.5
14;2021-08-18;2064;4528;543915;464369;78.7;67.2
14;2021-08-19;2336;5086;546251;469455;79.0;67.9
14;2021-08-20;2189;5403;548440;474858;79.3;68.7
14;2021-08-21;1016;2837;549456;477695;79.5;69.1
14;2021-08-22;170;1564;549626;479259;79.5;69.3
14;2021-08-23;1269;4170;550895;483429;79.7;69.9
14;2021-08-24;1347;4302;552242;487731;79.9;70.5
14;2021-08-25;1400;4398;553642;492129;80.1;71.2
14;2021-08-26;1433;5081;555075;497210;80.3;71.9
14;2021-08-27;1467;5289;556542;502499;80.5;72.7
14;2021-08-28;735;3005;557277;505504;80.6;73.1
14;2021-08-29;186;1015;557463;506519;80.6;73.3
14;2021-08-30;1016;3548;558479;510067;80.8;73.8
14;2021-08-31;1330;4642;559809;514709;81.0;74.4
14;2021-09-01;1069;3626;560878;518335;81.1;75.0
14;2021-09-02;864;3039;561742;521374;81.2;75.4
14;2021-09-03;1183;3862;562925;525236;81.4;76.0
14;2021-09-04;665;2225;563590;527461;81.5;76.3
14;2021-09-05;126;372;563716;527833;81.5;76.3
14;2021-09-06;468;1852;564184;529685;81.6;76.6
14;2021-09-07;498;1860;564682;531545;81.7;76.9
14;2021-09-08;681;2705;565363;534250;81.8;77.3
14;2021-09-09;595;1777;565958;536027;81.9;77.5
14;2021-09-10;771;2362;566729;538389;82.0;77.9
14;2021-09-11;522;1486;567251;539875;82.0;78.1
14;2021-09-12;67;240;567318;540115;82.0;78.1
14;2021-09-13;311;1154;567629;541269;82.1;78.3
14;2021-09-14;656;1262;568285;542531;82.2;78.5
14;2021-09-15;716;1997;569001;544528;82.3;78.8
14;2021-09-16;591;1339;569592;545867;82.4;78.9
14;2021-09-17;630;1454;570222;547321;82.5;79.2
14;2021-09-18;218;970;570440;548291;82.5;79.3
14;2021-09-19;40;137;570480;548428;82.5;79.3
14;2021-09-20;332;811;570812;549239;82.6;79.4
14;2021-09-21;538;847;571350;550086;82.6;79.6
14;2021-09-22;484;1754;571834;551840;82.7;79.8
14;2021-09-23;445;784;572279;552624;82.8;79.9
14;2021-09-24;405;1310;572684;553934;82.8;80.1
14;2021-09-25;191;690;572875;554624;82.9;80.2
14;2021-09-26;41;140;572916;554764;82.9;80.2
14;2021-09-27;276;710;573192;555474;82.9;80.3
14;2021-09-28;359;674;573551;556148;82.9;80.4
14;2021-09-29;305;919;573856;557067;83.0;80.6
14;2021-09-30;340;687;574196;557754;83.0;80.7
14;2021-10-01;449;831;574645;558585;83.1;80.8
14;2021-10-02;246;514;574891;559099;83.1;80.9
14;2021-10-03;37;61;574928;559160;83.1;80.9
14;2021-10-04;281;502;575209;559662;83.2;80.9
14;2021-10-05;270;446;575479;560108;83.2;81.0
14;2021-10-06;387;793;575866;560901;83.3;81.1
14;2021-10-07;224;408;576090;561309;83.3;81.2
14;2021-10-08;424;834;576514;562143;83.4;81.3
14;2021-10-09;186;339;576700;562482;83.4;81.3
14;2021-10-10;3;2;576703;562484;83.4;81.3
14;2021-10-11;177;461;576880;562945;83.4;81.4
15;2020-12-27;2;0;2;0;0.0;0.0
15;2020-12-28;0;0;2;0;0.0;0.0
15;2020-12-29;0;0;2;0;0.0;0.0
15;2020-12-30;0;0;2;0;0.0;0.0
15;2020-12-31;0;0;2;0;0.0;0.0
15;2021-01-01;1;0;3;0;0.0;0.0
15;2021-01-02;0;0;3;0;0.0;0.0
15;2021-01-03;0;0;3;0;0.0;0.0
15;2021-01-04;0;0;3;0;0.0;0.0
15;2021-01-05;0;0;3;0;0.0;0.0
15;2021-01-06;0;0;3;0;0.0;0.0
15;2021-01-07;72;0;75;0;0.1;0.0
15;2021-01-08;110;2;185;2;0.1;0.0
15;2021-01-09;0;0;185;2;0.1;0.0
15;2021-01-10;2;0;187;2;0.1;0.0
15;2021-01-11;99;1;286;3;0.2;0.0
15;2021-01-12;94;0;380;3;0.3;0.0
15;2021-01-13;230;0;610;3;0.4;0.0
15;2021-01-14;313;5;923;8;0.6;0.0
15;2021-01-15;138;0;1061;8;0.7;0.0
15;2021-01-16;90;0;1151;8;0.8;0.0
15;2021-01-17;0;0;1151;8;0.8;0.0
15;2021-01-18;404;2;1555;10;1.1;0.0
15;2021-01-19;550;0;2105;10;1.5;0.0
15;2021-01-20;629;2;2734;12;1.9;0.0
15;2021-01-21;576;4;3310;16;2.3;0.0
15;2021-01-22;503;3;3813;19;2.7;0.0
15;2021-01-23;432;1;4245;20;3.0;0.0
15;2021-01-24;6;0;4251;20;3.0;0.0
15;2021-01-25;401;0;4652;20;3.3;0.0
15;2021-01-26;437;0;5089;20;3.6;0.0
15;2021-01-27;736;8;5825;28;4.1;0.0
15;2021-01-28;623;53;6448;81;4.5;0.1
15;2021-01-29;336;82;6784;163;4.8;0.1
15;2021-01-30;218;3;7002;166;4.9;0.1
15;2021-01-31;1;1;7003;167;4.9;0.1
15;2021-02-01;239;94;7242;261;5.1;0.2
15;2021-02-02;189;89;7431;350;5.2;0.2
15;2021-02-03;267;159;7698;509;5.4;0.4
15;2021-02-04;663;204;8361;713;5.9;0.5
15;2021-02-05;296;256;8657;969;6.1;0.7
15;2021-02-06;98;77;8755;1046;6.1;0.7
15;2021-02-07;0;0;8755;1046;6.1;0.7
15;2021-02-08;233;108;8988;1154;6.3;0.8
15;2021-02-09;206;119;9194;1273;6.4;0.9
15;2021-02-10;338;301;9532;1574;6.7;1.1
15;2021-02-11;118;239;9650;1813;6.8;1.3
15;2021-02-12;136;159;9786;1972;6.9;1.4
15;2021-02-13;92;77;9878;2049;6.9;1.4
15;2021-02-14;0;0;9878;2049;6.9;1.4
15;2021-02-15;64;215;9942;2264;7.0;1.6
15;2021-02-16;52;295;9994;2559;7.0;1.8
15;2021-02-17;134;474;10128;3033;7.1;2.1
15;2021-02-18;87;754;10215;3787;7.2;2.7
15;2021-02-19;90;429;10305;4216;7.2;3.0
15;2021-02-20;20;258;10325;4474;7.2;3.1
15;2021-02-21;0;0;10325;4474;7.2;3.1
15;2021-02-22;23;496;10348;4970;7.2;3.5
15;2021-02-23;180;457;10528;5427;7.4;3.8
15;2021-02-24;31;456;10559;5883;7.4;4.1
15;2021-02-25;228;1001;10787;6884;7.6;4.8
15;2021-02-26;186;475;10973;7359;7.7;5.2
15;2021-02-27;145;89;11118;7448;7.8;5.2
15;2021-02-28;1;0;11119;7448;7.8;5.2
15;2021-03-01;121;223;11240;7671;7.9;5.4
15;2021-03-02;251;307;11491;7978;8.0;5.6
15;2021-03-03;207;29;11698;8007;8.2;5.6
15;2021-03-04;246;248;11944;8255;8.4;5.8
15;2021-03-05;348;175;12292;8430;8.6;5.9
15;2021-03-06;680;11;12972;8441;9.1;5.9
15;2021-03-07;81;2;13053;8443;9.1;5.9
15;2021-03-08;93;107;13146;8550;9.2;6.0
15;2021-03-09;281;294;13427;8844;9.4;6.2
15;2021-03-10;417;180;13844;9024;9.7;6.3
15;2021-03-11;434;296;14278;9320;10.0;6.5
15;2021-03-12;525;96;14803;9416;10.4;6.6
15;2021-03-13;355;7;15158;9423;10.6;6.6
15;2021-03-14;18;0;15176;9423;10.6;6.6
15;2021-03-15;542;64;15718;9487;11.0;6.6
15;2021-03-16;328;22;16046;9509;11.2;6.7
15;2021-03-17;130;53;16176;9562;11.3;6.7
15;2021-03-18;250;96;16426;9658;11.5;6.8
15;2021-03-19;669;33;17095;9691;12.0;6.8
15;2021-03-20;148;38;17243;9729;12.1;6.8
15;2021-03-21;6;0;17249;9729;12.1;6.8
15;2021-03-22;574;82;17823;9811;12.5;6.9
15;2021-03-23;776;102;18599;9913;13.0;6.9
15;2021-03-24;936;36;19535;9949;13.7;7.0
15;2021-03-25;1282;33;20817;9982;14.6;7.0
15;2021-03-26;1010;63;21827;10045;15.3;7.0
15;2021-03-27;301;7;22128;10052;15.5;7.0
15;2021-03-28;20;0;22148;10052;15.5;7.0
15;2021-03-29;782;19;22930;10071;16.1;7.1
15;2021-03-30;1135;205;24065;10276;16.9;7.2
15;2021-03-31;941;28;25006;10304;17.5;7.2
15;2021-04-01;1233;65;26239;10369;18.4;7.3
15;2021-04-02;1141;62;27380;10431;19.2;7.3
15;2021-04-03;120;18;27500;10449;19.3;7.3
15;2021-04-04;0;0;27500;10449;19.3;7.3
15;2021-04-05;33;3;27533;10452;19.3;7.3
15;2021-04-06;834;87;28367;10539;19.9;7.4
15;2021-04-07;663;108;29030;10647;20.3;7.5
15;2021-04-08;1246;151;30276;10798;21.2;7.6
15;2021-04-09;1277;106;31553;10904;22.1;7.6
15;2021-04-10;364;21;31917;10925;22.3;7.6
15;2021-04-11;14;0;31931;10925;22.4;7.6
15;2021-04-12;644;461;32575;11386;22.8;8.0
15;2021-04-13;1124;324;33699;11710;23.6;8.2
15;2021-04-14;1038;199;34737;11909;24.3;8.3
15;2021-04-15;1183;314;35920;12223;25.2;8.6
15;2021-04-16;1038;555;36958;12778;25.9;8.9
15;2021-04-17;445;15;37403;12793;26.2;9.0
15;2021-04-18;0;10;37403;12803;26.2;9.0
15;2021-04-19;537;514;37940;13317;26.6;9.3
15;2021-04-20;847;616;38787;13933;27.2;9.8
15;2021-04-21;592;651;39379;14584;27.6;10.2
15;2021-04-22;728;777;40107;15361;28.1;10.8
15;2021-04-23;730;681;40837;16042;28.6;11.2
15;2021-04-24;363;123;41200;16165;28.8;11.3
15;2021-04-25;1;3;41201;16168;28.9;11.3
15;2021-04-26;325;632;41526;16800;29.1;11.8
15;2021-04-27;467;939;41993;17739;29.4;12.4
15;2021-04-28;383;789;42376;18528;29.7;13.0
15;2021-04-29;587;1014;42963;19542;30.1;13.7
15;2021-04-30;547;1077;43510;20619;30.5;14.4
15;2021-05-01;283;29;43793;20648;30.7;14.5
15;2021-05-02;0;0;43793;20648;30.7;14.5
15;2021-05-03;881;331;44674;20979;31.3;14.7
15;2021-05-04;801;857;45475;21836;31.8;15.3
15;2021-05-05;676;680;46151;22516;32.3;15.8
15;2021-05-06;826;967;46977;23483;32.9;16.4
15;2021-05-07;1154;906;48131;24389;33.7;17.1
15;2021-05-08;491;55;48622;24444;34.0;17.1
15;2021-05-09;24;9;48646;24453;34.1;17.1
15;2021-05-10;704;913;49350;25366;34.6;17.8
15;2021-05-11;1186;1186;50536;26552;35.4;18.6
15;2021-05-12;1147;837;51683;27389;36.2;19.2
15;2021-05-13;1165;440;52848;27829;37.0;19.5
15;2021-05-14;1503;583;54351;28412;38.1;19.9
15;2021-05-15;1410;418;55761;28830;39.0;20.2
15;2021-05-16;1;10;55762;28840;39.0;20.2
15;2021-05-17;999;605;56761;29445;39.7;20.6
15;2021-05-18;1221;970;57982;30415;40.6;21.3
15;2021-05-19;1020;459;59002;30874;41.3;21.6
15;2021-05-20;1239;782;60241;31656;42.2;22.2
15;2021-05-21;1348;749;61589;32405;43.1;22.7
15;2021-05-22;527;188;62116;32593;43.5;22.8
15;2021-05-23;2;11;62118;32604;43.5;22.8
15;2021-05-24;693;257;62811;32861;44.0;23.0
15;2021-05-25;1151;620;63962;33481;44.8;23.4
15;2021-05-26;1093;459;65055;33940;45.6;23.8
15;2021-05-27;1271;660;66326;34600;46.4;24.2
15;2021-05-28;1509;887;67835;35487;47.5;24.8
15;2021-05-29;984;361;68819;35848;48.2;25.1
15;2021-05-30;14;25;68833;35873;48.2;25.1
15;2021-05-31;1199;480;70032;36353;49.0;25.5
15;2021-06-01;1398;570;71430;36923;50.0;25.9
15;2021-06-02;863;418;72293;37341;50.6;26.1
15;2021-06-03;932;704;73225;38045;51.3;26.6
15;2021-06-04;1076;719;74301;38764;52.0;27.1
15;2021-06-05;651;264;74952;39028;52.5;27.3
15;2021-06-06;16;20;74968;39048;52.5;27.3
15;2021-06-07;797;351;75765;39399;53.1;27.6
15;2021-06-08;477;397;76242;39796;53.4;27.9
15;2021-06-09;376;377;76618;40173;53.6;28.1
15;2021-06-10;276;423;76894;40596;53.8;28.4
15;2021-06-11;660;1100;77554;41696;54.3;29.2
15;2021-06-12;377;467;77931;42163;54.6;29.5
15;2021-06-13;11;6;77942;42169;54.6;29.5
15;2021-06-14;542;977;78484;43146;55.0;30.2
15;2021-06-15;450;1164;78934;44310;55.3;31.0
15;2021-06-16;543;899;79477;45209;55.7;31.7
15;2021-06-17;292;934;79769;46143;55.9;32.3
15;2021-06-18;740;1205;80509;47348;56.4;33.2
15;2021-06-19;542;704;81051;48052;56.8;33.6
15;2021-06-20;11;1;81062;48053;56.8;33.6
15;2021-06-21;279;1042;81341;49095;57.0;34.4
15;2021-06-22;232;1480;81573;50575;57.1;35.4
15;2021-06-23;346;1445;81919;52020;57.4;36.4
15;2021-06-24;291;1094;82210;53114;57.6;37.2
15;2021-06-25;378;1641;82588;54755;57.8;38.3
15;2021-06-26;164;908;82752;55663;57.9;39.0
15;2021-06-27;0;0;82752;55663;57.9;39.0
15;2021-06-28;176;1228;82928;56891;58.1;39.8
15;2021-06-29;302;1264;83230;58155;58.3;40.7
15;2021-06-30;268;982;83498;59137;58.5;41.4
15;2021-07-01;380;1220;83878;60357;58.7;42.3
15;2021-07-02;410;1348;84288;61705;59.0;43.2
15;2021-07-03;252;707;84540;62412;59.2;43.7
15;2021-07-04;1;1;84541;62413;59.2;43.7
15;2021-07-05;248;1257;84789;63670;59.4;44.6
15;2021-07-06;275;1469;85064;65139;59.6;45.6
15;2021-07-07;255;1344;85319;66483;59.7;46.6
15;2021-07-08;489;1353;85808;67836;60.1;47.5
15;2021-07-09;488;1783;86296;69619;60.4;48.7
15;2021-07-10;215;862;86511;70481;60.6;49.4
15;2021-07-11;9;5;86520;70486;60.6;49.4
15;2021-07-12;278;1484;86798;71970;60.8;50.4
15;2021-07-13;587;1776;87385;73746;61.2;51.6
15;2021-07-14;16;130;87401;73876;61.2;51.7
15;2021-07-15;1132;729;88533;74605;62.0;52.2
15;2021-07-16;1139;1336;89672;75941;62.8;53.2
15;2021-07-17;819;953;90491;76894;63.4;53.8
15;2021-07-18;0;2;90491;76896;63.4;53.8
15;2021-07-19;1074;1270;91565;78166;64.1;54.7
15;2021-07-20;1612;570;93177;78736;65.2;55.1
15;2021-07-21;1189;603;94366;79339;66.1;55.6
15;2021-07-22;894;512;95260;79851;66.7;55.9
15;2021-07-23;1341;1065;96601;80916;67.6;56.7
15;2021-07-24;628;770;97229;81686;68.1;57.2
15;2021-07-25;1;24;97230;81710;68.1;57.2
15;2021-07-26;1247;594;98477;82304;69.0;57.6
15;2021-07-27;1691;576;100168;82880;70.1;58.0
15;2021-07-28;1238;584;101406;83464;71.0;58.4
15;2021-07-29;838;402;102244;83866;71.6;58.7
15;2021-07-30;1007;1131;103251;84997;72.3;59.5
15;2021-07-31;603;636;103854;85633;72.7;60.0
15;2021-08-01;21;12;103875;85645;72.7;60.0
15;2021-08-02;1143;543;105018;86188;73.5;60.4
15;2021-08-03;1162;383;106180;86571;74.4;60.6
15;2021-08-04;788;408;106968;86979;74.9;60.9
15;2021-08-05;383;284;107351;87263;75.2;61.1
15;2021-08-06;788;1236;108139;88499;75.7;62.0
15;2021-08-07;265;1160;108404;89659;75.9;62.8
15;2021-08-08;3;6;108407;89665;75.9;62.8
15;2021-08-09;511;1164;108918;90829;76.3;63.6
15;2021-08-10;435;725;109353;91554;76.6;64.1
15;2021-08-11;411;1007;109764;92561;76.9;64.8
15;2021-08-12;520;1182;110284;93743;77.2;65.6
15;2021-08-13;682;1137;110966;94880;77.7;66.4
15;2021-08-14;179;552;111145;95432;77.8;66.8
15;2021-08-15;17;9;111162;95441;77.8;66.8
15;2021-08-16;387;1134;111549;96575;78.1;67.6
15;2021-08-17;402;1140;111951;97715;78.4;68.4
15;2021-08-18;368;803;112319;98518;78.6;69.0
15;2021-08-19;300;878;112619;99396;78.9;69.6
15;2021-08-20;601;1215;113220;100611;79.3;70.5
15;2021-08-21;218;867;113438;101478;79.4;71.1
15;2021-08-22;12;26;113450;101504;79.4;71.1
15;2021-08-23;229;611;113679;102115;79.6;71.5
15;2021-08-24;245;590;113924;102705;79.8;71.9
15;2021-08-25;155;493;114079;103198;79.9;72.3
15;2021-08-26;136;363;114215;103561;80.0;72.5
15;2021-08-27;366;1337;114581;104898;80.2;73.5
15;2021-08-28;214;857;114795;105755;80.4;74.1
15;2021-08-29;7;13;114802;105768;80.4;74.1
15;2021-08-30;225;1056;115027;106824;80.5;74.8
15;2021-08-31;404;649;115431;107473;80.8;75.3
15;2021-09-01;182;402;115613;107875;81.0;75.5
15;2021-09-02;97;229;115710;108104;81.0;75.7
15;2021-09-03;202;889;115912;108993;81.2;76.3
15;2021-09-04;157;358;116069;109351;81.3;76.6
15;2021-09-05;0;2;116069;109353;81.3;76.6
15;2021-09-06;98;303;116167;109656;81.3;76.8
15;2021-09-07;100;197;116267;109853;81.4;76.9
15;2021-09-08;201;410;116468;110263;81.6;77.2
15;2021-09-09;100;314;116568;110577;81.6;77.4
15;2021-09-10;233;760;116801;111337;81.8;78.0
15;2021-09-11;95;290;116896;111627;81.9;78.2
15;2021-09-12;0;0;116896;111627;81.9;78.2
15;2021-09-13;102;265;116998;111892;81.9;78.3
15;2021-09-14;124;107;117122;111999;82.0;78.4
15;2021-09-15;69;247;117191;112246;82.1;78.6
15;2021-09-16;33;101;117224;112347;82.1;78.7
15;2021-09-17;266;605;117490;112952;82.3;79.1
15;2021-09-18;79;380;117569;113332;82.3;79.4
15;2021-09-19;0;0;117569;113332;82.3;79.4
15;2021-09-20;123;217;117692;113549;82.4;79.5
15;2021-09-21;41;107;117733;113656;82.4;79.6
15;2021-09-22;84;355;117817;114011;82.5;79.8
15;2021-09-23;37;109;117854;114120;82.5;79.9
15;2021-09-24;138;334;117992;114454;82.6;80.1
15;2021-09-25;42;217;118034;114671;82.7;80.3
15;2021-09-26;1;5;118035;114676;82.7;80.3
15;2021-09-27;88;133;118123;114809;82.7;80.4
15;2021-09-28;74;131;118197;114940;82.8;80.5
15;2021-09-29;69;191;118266;115131;82.8;80.6
15;2021-09-30;37;94;118303;115225;82.8;80.7
15;2021-10-01;117;216;118420;115441;82.9;80.8
15;2021-10-02;30;143;118450;115584;82.9;80.9
15;2021-10-03;0;2;118450;115586;82.9;80.9
15;2021-10-04;59;59;118509;115645;83.0;81.0
15;2021-10-05;34;51;118543;115696;83.0;81.0
15;2021-10-06;79;105;118622;115801;83.1;81.1
15;2021-10-07;46;91;118668;115892;83.1;81.2
15;2021-10-08;54;174;118722;116066;83.1;81.3
15;2021-10-09;54;107;118776;116173;83.2;81.3
15;2021-10-10;1;6;118777;116179;83.2;81.4
15;2021-10-11;50;163;118827;116342;83.2;81.5
16;2020-12-27;0;0;0;0;0.0;0.0
16;2020-12-28;2;0;2;0;0.0;0.0
16;2020-12-29;0;0;2;0;0.0;0.0
16;2020-12-30;1;0;3;0;0.0;0.0
16;2020-12-31;0;0;3;0;0.0;0.0
16;2021-01-01;0;0;3;0;0.0;0.0
16;2021-01-02;0;0;3;0;0.0;0.0
16;2021-01-03;0;0;3;0;0.0;0.0
16;2021-01-04;1;0;4;0;0.0;0.0
16;2021-01-05;1;0;5;0;0.0;0.0
16;2021-01-06;88;0;93;0;0.0;0.0
16;2021-01-07;240;0;333;0;0.1;0.0
16;2021-01-08;465;2;798;2;0.2;0.0
16;2021-01-09;1;0;799;2;0.2;0.0
16;2021-01-10;1;0;800;2;0.2;0.0
16;2021-01-11;304;0;1104;2;0.3;0.0
16;2021-01-12;437;1;1541;3;0.4;0.0
16;2021-01-13;480;1;2021;4;0.6;0.0
16;2021-01-14;601;7;2622;11;0.8;0.0
16;2021-01-15;503;3;3125;14;0.9;0.0
16;2021-01-16;0;0;3125;14;0.9;0.0
16;2021-01-17;0;0;3125;14;0.9;0.0
16;2021-01-18;432;6;3557;20;1.0;0.0
16;2021-01-19;834;2;4391;22;1.3;0.0
16;2021-01-20;1188;3;5579;25;1.6;0.0
16;2021-01-21;1384;13;6963;38;2.0;0.0
16;2021-01-22;1115;3;8078;41;2.3;0.0
16;2021-01-23;183;2;8261;43;2.4;0.0
16;2021-01-24;0;0;8261;43;2.4;0.0
16;2021-01-25;641;3;8902;46;2.6;0.0
16;2021-01-26;1026;2;9928;48;2.9;0.0
16;2021-01-27;1406;105;11334;153;3.3;0.0
16;2021-01-28;1276;72;12610;225;3.6;0.1
16;2021-01-29;742;141;13352;366;3.8;0.1
16;2021-01-30;36;0;13388;366;3.8;0.1
16;2021-01-31;0;0;13388;366;3.8;0.1
16;2021-02-01;395;203;13783;569;4.0;0.2
16;2021-02-02;576;175;14359;744;4.1;0.2
16;2021-02-03;621;350;14980;1094;4.3;0.3
16;2021-02-04;465;269;15445;1363;4.4;0.4
16;2021-02-05;505;275;15950;1638;4.6;0.5
16;2021-02-06;4;80;15954;1718;4.6;0.5
16;2021-02-07;41;3;15995;1721;4.6;0.5
16;2021-02-08;357;217;16352;1938;4.7;0.6
16;2021-02-09;650;294;17002;2232;4.9;0.6
16;2021-02-10;694;677;17696;2909;5.1;0.8
16;2021-02-11;804;617;18500;3526;5.3;1.0
16;2021-02-12;622;835;19122;4361;5.5;1.3
16;2021-02-13;43;79;19165;4440;5.5;1.3
16;2021-02-14;2;7;19167;4447;5.5;1.3
16;2021-02-15;217;661;19384;5108;5.6;1.5
16;2021-02-16;375;952;19759;6060;5.7;1.7
16;2021-02-17;346;1306;20105;7366;5.8;2.1
16;2021-02-18;511;1249;20616;8615;5.9;2.5
16;2021-02-19;389;784;21005;9399;6.0;2.7
16;2021-02-20;2;8;21007;9407;6.0;2.7
16;2021-02-21;2;0;21009;9407;6.0;2.7
16;2021-02-22;136;529;21145;9936;6.1;2.9
16;2021-02-23;207;922;21352;10858;6.1;3.1
16;2021-02-24;277;894;21629;11752;6.2;3.4
16;2021-02-25;395;689;22024;12441;6.3;3.6
16;2021-02-26;479;501;22503;12942;6.5;3.7
16;2021-02-27;249;1;22752;12943;6.5;3.7
16;2021-02-28;5;5;22757;12948;6.5;3.7
16;2021-03-01;152;329;22909;13277;6.6;3.8
16;2021-03-02;271;671;23180;13948;6.7;4.0
16;2021-03-03;391;725;23571;14673;6.8;4.2
16;2021-03-04;804;571;24375;15244;7.0;4.4
16;2021-03-05;1143;545;25518;15789;7.3;4.5
16;2021-03-06;753;16;26271;15805;7.5;4.5
16;2021-03-07;94;18;26365;15823;7.6;4.5
16;2021-03-08;437;321;26802;16144;7.7;4.6
16;2021-03-09;774;699;27576;16843;7.9;4.8
16;2021-03-10;606;665;28182;17508;8.1;5.0
16;2021-03-11;1448;539;29630;18047;8.5;5.2
16;2021-03-12;1165;462;30795;18509;8.8;5.3
16;2021-03-13;765;15;31560;18524;9.1;5.3
16;2021-03-14;1;0;31561;18524;9.1;5.3
16;2021-03-15;462;186;32023;18710;9.2;5.4
16;2021-03-16;860;423;32883;19133;9.4;5.5
16;2021-03-17;591;284;33474;19417;9.6;5.6
16;2021-03-18;1033;283;34507;19700;9.9;5.7
16;2021-03-19;1103;248;35610;19948;10.2;5.7
16;2021-03-20;396;5;36006;19953;10.3;5.7
16;2021-03-21;9;0;36015;19953;10.3;5.7
16;2021-03-22;728;101;36743;20054;10.6;5.8
16;2021-03-23;1464;107;38207;20161;11.0;5.8
16;2021-03-24;1123;185;39330;20346;11.3;5.8
16;2021-03-25;2047;94;41377;20440;11.9;5.9
16;2021-03-26;1918;99;43295;20539;12.4;5.9
16;2021-03-27;432;22;43727;20561;12.6;5.9
16;2021-03-28;0;0;43727;20561;12.6;5.9
16;2021-03-29;923;60;44650;20621;12.8;5.9
16;2021-03-30;1882;179;46532;20800;13.4;6.0
16;2021-03-31;1513;135;48045;20935;13.8;6.0
16;2021-04-01;2009;402;50054;21337;14.4;6.1
16;2021-04-02;1442;381;51496;21718;14.8;6.2
16;2021-04-03;288;5;51784;21723;14.9;6.2
16;2021-04-04;1;0;51785;21723;14.9;6.2
16;2021-04-05;2;0;51787;21723;14.9;6.2
16;2021-04-06;2013;548;53800;22271;15.5;6.4
16;2021-04-07;1953;407;55753;22678;16.0;6.5
16;2021-04-08;2823;590;58576;23268;16.8;6.7
16;2021-04-09;2694;555;61270;23823;17.6;6.8
16;2021-04-10;1290;38;62560;23861;18.0;6.9
16;2021-04-11;2;0;62562;23861;18.0;6.9
16;2021-04-12;1430;316;63992;24177;18.4;6.9
16;2021-04-13;2124;842;66116;25019;19.0;7.2
16;2021-04-14;1951;634;68067;25653;19.5;7.4
16;2021-04-15;2102;985;70169;26638;20.2;7.7
16;2021-04-16;2043;789;72212;27427;20.7;7.9
16;2021-04-17;1507;93;73719;27520;21.2;7.9
16;2021-04-18;197;3;73916;27523;21.2;7.9
16;2021-04-19;1440;524;75356;28047;21.6;8.1
16;2021-04-20;2053;1234;77409;29281;22.2;8.4
16;2021-04-21;1776;752;79185;30033;22.7;8.6
16;2021-04-22;2290;1010;81475;31043;23.4;8.9
16;2021-04-23;2362;1174;83837;32217;24.1;9.3
16;2021-04-24;829;38;84666;32255;24.3;9.3
16;2021-04-25;117;6;84783;32261;24.4;9.3
16;2021-04-26;1400;810;86183;33071;24.8;9.5
16;2021-04-27;2055;1417;88238;34488;25.3;9.9
16;2021-04-28;1592;1127;89830;35615;25.8;10.2
16;2021-04-29;2250;1501;92080;37116;26.4;10.7
16;2021-04-30;2856;1344;94936;38460;27.3;11.0
16;2021-05-01;353;60;95289;38520;27.4;11.1
16;2021-05-02;155;13;95444;38533;27.4;11.1
16;2021-05-03;2611;538;98055;39071;28.2;11.2
16;2021-05-04;2057;2046;100112;41117;28.8;11.8
16;2021-05-05;1688;1832;101800;42949;29.2;12.3
16;2021-05-06;1886;2248;103686;45197;29.8;13.0
16;2021-05-07;3072;2123;106758;47320;30.7;13.6
16;2021-05-08;1197;468;107955;47788;31.0;13.7
16;2021-05-09;530;27;108485;47815;31.2;13.7
16;2021-05-10;1930;1624;110415;49439;31.7;14.2
16;2021-05-11;2354;1965;112769;51404;32.4;14.8
16;2021-05-12;1734;1799;114503;53203;32.9;15.3
16;2021-05-13;1461;355;115964;53558;33.3;15.4
16;2021-05-14;1989;1563;117953;55121;33.9;15.8
16;2021-05-15;596;895;118549;56016;34.0;16.1
16;2021-05-16;132;6;118681;56022;34.1;16.1
16;2021-05-17;1609;1286;120290;57308;34.5;16.5
16;2021-05-18;2756;1426;123046;58734;35.3;16.9
16;2021-05-19;2006;1241;125052;59975;35.9;17.2
16;2021-05-20;2832;1389;127884;61364;36.7;17.6
16;2021-05-21;2943;1396;130827;62760;37.6;18.0
16;2021-05-22;411;711;131238;63471;37.7;18.2
16;2021-05-23;210;11;131448;63482;37.8;18.2
16;2021-05-24;1262;234;132710;63716;38.1;18.3
16;2021-05-25;2759;1461;135469;65177;38.9;18.7
16;2021-05-26;1833;1186;137302;66363;39.4;19.1
16;2021-05-27;2416;1583;139718;67946;40.1;19.5
16;2021-05-28;2899;1565;142617;69511;41.0;20.0
16;2021-05-29;814;883;143431;70394;41.2;20.2
16;2021-05-30;1;4;143432;70398;41.2;20.2
16;2021-05-31;1984;1105;145416;71503;41.8;20.5
16;2021-06-01;2344;1713;147760;73216;42.4;21.0
16;2021-06-02;1820;1503;149580;74719;43.0;21.5
16;2021-06-03;2622;1761;152202;76480;43.7;22.0
16;2021-06-04;2833;2030;155035;78510;44.5;22.5
16;2021-06-05;1006;549;156041;79059;44.8;22.7
16;2021-06-06;161;29;156202;79088;44.9;22.7
16;2021-06-07;1991;1281;158193;80369;45.4;23.1
16;2021-06-08;2394;1999;160587;82368;46.1;23.7
16;2021-06-09;2528;1616;163115;83984;46.8;24.1
16;2021-06-10;2569;2003;165684;85987;47.6;24.7
16;2021-06-11;2152;2733;167836;88720;48.2;25.5
16;2021-06-12;1613;517;169449;89237;48.7;25.6
16;2021-06-13;260;72;169709;89309;48.7;25.7
16;2021-06-14;797;2798;170506;92107;49.0;26.5
16;2021-06-15;1866;2623;172372;94730;49.5;27.2
16;2021-06-16;1575;2083;173947;96813;50.0;27.8
16;2021-06-17;2040;2509;175987;99322;50.5;28.5
16;2021-06-18;2060;3217;178047;102539;51.1;29.4
16;2021-06-19;1351;1311;179398;103850;51.5;29.8
16;2021-06-20;243;28;179641;103878;51.6;29.8
16;2021-06-21;1411;2168;181052;106046;52.0;30.5
16;2021-06-22;1675;2943;182727;108989;52.5;31.3
16;2021-06-23;1562;2016;184289;111005;52.9;31.9
16;2021-06-24;1928;2167;186217;113172;53.5;32.5
16;2021-06-25;1983;2727;188200;115899;54.1;33.3
16;2021-06-26;1060;725;189260;116624;54.4;33.5
16;2021-06-27;132;25;189392;116649;54.4;33.5
16;2021-06-28;1164;1964;190556;118613;54.7;34.1
16;2021-06-29;1282;3365;191838;121978;55.1;35.0
16;2021-06-30;1337;2714;193175;124692;55.5;35.8
16;2021-07-01;1865;3156;195040;127848;56.0;36.7
16;2021-07-02;1423;3580;196463;131428;56.4;37.7
16;2021-07-03;696;1111;197159;132539;56.6;38.1
16;2021-07-04;3;15;197162;132554;56.6;38.1
16;2021-07-05;815;2298;197977;134852;56.9;38.7
16;2021-07-06;1278;3366;199255;138218;57.2;39.7
16;2021-07-07;871;2276;200126;140494;57.5;40.4
16;2021-07-08;1234;2736;201360;143230;57.8;41.1
16;2021-07-09;1113;3709;202473;146939;58.2;42.2
16;2021-07-10;338;1338;202811;148277;58.2;42.6
16;2021-07-11;2;13;202813;148290;58.2;42.6
16;2021-07-12;634;2436;203447;150726;58.4;43.3
16;2021-07-13;1385;3530;204832;154256;58.8;44.3
16;2021-07-14;797;877;205629;155133;59.1;44.6
16;2021-07-15;1250;3408;206879;158541;59.4;45.5
16;2021-07-16;1498;3383;208377;161924;59.8;46.5
16;2021-07-17;539;1188;208916;163112;60.0;46.8
16;2021-07-18;14;6;208930;163118;60.0;46.8
16;2021-07-19;618;2853;209548;165971;60.2;47.7
16;2021-07-20;1125;3288;210673;169259;60.5;48.6
16;2021-07-21;1117;2619;211790;171878;60.8;49.4
16;2021-07-22;1871;2862;213661;174740;61.4;50.2
16;2021-07-23;1552;3545;215213;178285;61.8;51.2
16;2021-07-24;639;1213;215852;179498;62.0;51.6
16;2021-07-25;11;11;215863;179509;62.0;51.6
16;2021-07-26;1529;2129;217392;181638;62.4;52.2
16;2021-07-27;1865;2819;219257;184457;63.0;53.0
16;2021-07-28;1864;2311;221121;186768;63.5;53.6
16;2021-07-29;2241;2476;223362;189244;64.2;54.4
16;2021-07-30;2355;3109;225717;192353;64.8;55.2
16;2021-07-31;960;1353;226677;193706;65.1;55.6
16;2021-08-01;192;22;226869;193728;65.2;55.6
16;2021-08-02;2121;1829;228990;195557;65.8;56.2
16;2021-08-03;2121;2328;231111;197885;66.4;56.8
16;2021-08-04;2122;1886;233233;199771;67.0;57.4
16;2021-08-05;2775;1655;236008;201426;67.8;57.9
16;2021-08-06;2512;2365;238520;203791;68.5;58.5
16;2021-08-07;828;559;239348;204350;68.7;58.7
16;2021-08-08;37;33;239385;204383;68.8;58.7
16;2021-08-09;2183;1061;241568;205444;69.4;59.0
16;2021-08-10;2886;1586;244454;207030;70.2;59.5
16;2021-08-11;2603;1232;247057;208262;71.0;59.8
16;2021-08-12;2012;1735;249069;209997;71.5;60.3
16;2021-08-13;2686;1467;251755;211464;72.3;60.7
16;2021-08-14;758;455;252513;211919;72.5;60.9
16;2021-08-15;29;4;252542;211923;72.5;60.9
16;2021-08-16;1339;1582;253881;213505;72.9;61.3
16;2021-08-17;1837;1628;255718;215133;73.4;61.8
16;2021-08-18;1591;1471;257309;216604;73.9;62.2
16;2021-08-19;1517;1777;258826;218381;74.3;62.7
16;2021-08-20;1601;1902;260427;220283;74.8;63.3
16;2021-08-21;564;827;260991;221110;75.0;63.5
16;2021-08-22;4;5;260995;221115;75.0;63.5
16;2021-08-23;993;2064;261988;223179;75.2;64.1
16;2021-08-24;1040;2376;263028;225555;75.5;64.8
16;2021-08-25;887;1781;263915;227336;75.8;65.3
16;2021-08-26;880;2531;264795;229867;76.1;66.0
16;2021-08-27;853;2408;265648;232275;76.3;66.7
16;2021-08-28;261;771;265909;233046;76.4;66.9
16;2021-08-29;2;15;265911;233061;76.4;66.9
16;2021-08-30;638;2373;266549;235434;76.6;67.6
16;2021-08-31;668;2545;267217;237979;76.7;68.3
16;2021-09-01;468;2354;267685;240333;76.9;69.0
16;2021-09-02;544;2078;268229;242411;77.0;69.6
16;2021-09-03;544;2543;268773;244954;77.2;70.4
16;2021-09-04;365;904;269138;245858;77.3;70.6
16;2021-09-05;6;29;269144;245887;77.3;70.6
16;2021-09-06;318;1457;269462;247344;77.4;71.0
16;2021-09-07;355;1673;269817;249017;77.5;71.5
16;2021-09-08;392;1989;270209;251006;77.6;72.1
16;2021-09-09;347;1497;270556;252503;77.7;72.5
16;2021-09-10;440;1767;270996;254270;77.8;73.0
16;2021-09-11;185;785;271181;255055;77.9;73.3
16;2021-09-12;6;21;271187;255076;77.9;73.3
16;2021-09-13;256;1066;271443;256142;78.0;73.6
16;2021-09-14;372;956;271815;257098;78.1;73.8
16;2021-09-15;349;1347;272164;258445;78.2;74.2
16;2021-09-16;303;887;272467;259332;78.3;74.5
16;2021-09-17;500;1376;272967;260708;78.4;74.9
16;2021-09-18;100;535;273067;261243;78.4;75.0
16;2021-09-19;0;9;273067;261252;78.4;75.0
16;2021-09-20;195;722;273262;261974;78.5;75.2
16;2021-09-21;183;674;273445;262648;78.5;75.4
16;2021-09-22;187;990;273632;263638;78.6;75.7
16;2021-09-23;170;559;273802;264197;78.6;75.9
16;2021-09-24;338;1049;274140;265246;78.7;76.2
16;2021-09-25;64;439;274204;265685;78.8;76.3
16;2021-09-26;1;6;274205;265691;78.8;76.3
16;2021-09-27;193;581;274398;266272;78.8;76.5
16;2021-09-28;145;536;274543;266808;78.9;76.6
16;2021-09-29;197;606;274740;267414;78.9;76.8
16;2021-09-30;115;482;274855;267896;78.9;76.9
16;2021-10-01;241;540;275096;268436;79.0;77.1
16;2021-10-02;81;324;275177;268760;79.0;77.2
16;2021-10-03;0;7;275177;268767;79.0;77.2
16;2021-10-04;117;356;275294;269123;79.1;77.3
16;2021-10-05;122;375;275416;269498;79.1;77.4
16;2021-10-06;182;510;275598;270008;79.2;77.5
16;2021-10-07;122;315;275720;270323;79.2;77.6
16;2021-10-08;232;673;275952;270996;79.3;77.8
16;2021-10-09;76;181;276028;271177;79.3;77.9
16;2021-10-10;1;10;276029;271187;79.3;77.9
16;2021-10-11;106;274;276135;271461;79.3;78.0
17;2020-12-27;0;0;0;0;0.0;0.0
17;2020-12-28;0;0;0;0;0.0;0.0
17;2020-12-29;0;0;0;0;0.0;0.0
17;2020-12-30;1;0;1;0;0.0;0.0
17;2020-12-31;0;0;1;0;0.0;0.0
17;2021-01-01;1;0;2;0;0.0;0.0
17;2021-01-02;1;0;3;0;0.0;0.0
17;2021-01-03;0;0;3;0;0.0;0.0
17;2021-01-04;56;0;59;0;0.0;0.0
17;2021-01-05;98;0;157;0;0.0;0.0
17;2021-01-06;132;0;289;0;0.0;0.0
17;2021-01-07;484;1;773;1;0.1;0.0
17;2021-01-08;418;1;1191;2;0.2;0.0
17;2021-01-09;0;0;1191;2;0.2;0.0
17;2021-01-10;1;0;1192;2;0.2;0.0
17;2021-01-11;381;2;1573;4;0.2;0.0
17;2021-01-12;751;1;2324;5;0.4;0.0
17;2021-01-13;655;2;2979;7;0.5;0.0
17;2021-01-14;616;9;3595;16;0.6;0.0
17;2021-01-15;681;2;4276;18;0.7;0.0
17;2021-01-16;129;2;4405;20;0.7;0.0
17;2021-01-17;19;0;4424;20;0.7;0.0
17;2021-01-18;887;5;5311;25;0.8;0.0
17;2021-01-19;1909;17;7220;42;1.1;0.0
17;2021-01-20;2396;4;9616;46;1.5;0.0
17;2021-01-21;2500;12;12116;58;1.9;0.0
17;2021-01-22;1893;15;14009;73;2.2;0.0
17;2021-01-23;738;1;14747;74;2.3;0.0
17;2021-01-24;50;0;14797;74;2.3;0.0
17;2021-01-25;1383;5;16180;79;2.5;0.0
17;2021-01-26;2110;5;18290;84;2.8;0.0
17;2021-01-27;1676;33;19966;117;3.1;0.0
17;2021-01-28;2476;232;22442;349;3.5;0.1
17;2021-01-29;1740;222;24182;571;3.7;0.1
17;2021-01-30;528;5;24710;576;3.8;0.1
17;2021-01-31;37;2;24747;578;3.8;0.1
17;2021-02-01;741;210;25488;788;3.9;0.1
17;2021-02-02;1202;347;26690;1135;4.1;0.2
17;2021-02-03;1300;401;27990;1536;4.3;0.2
17;2021-02-04;1162;503;29152;2039;4.5;0.3
17;2021-02-05;603;757;29755;2796;4.6;0.4
17;2021-02-06;25;43;29780;2839;4.6;0.4
17;2021-02-07;31;13;29811;2852;4.6;0.4
17;2021-02-08;706;400;30517;3252;4.7;0.5
17;2021-02-09;1102;1316;31619;4568;4.9;0.7
17;2021-02-10;866;1288;32485;5856;5.0;0.9
17;2021-02-11;1241;1402;33726;7258;5.2;1.1
17;2021-02-12;774;966;34500;8224;5.3;1.3
17;2021-02-13;43;104;34543;8328;5.3;1.3
17;2021-02-14;1;10;34544;8338;5.3;1.3
17;2021-02-15;621;1221;35165;9559;5.4;1.5
17;2021-02-16;751;1827;35916;11386;5.6;1.8
17;2021-02-17;795;1357;36711;12743;5.7;2.0
17;2021-02-18;965;2185;37676;14928;5.8;2.3
17;2021-02-19;1069;1538;38745;16466;6.0;2.5
17;2021-02-20;105;311;38850;16777;6.0;2.6
17;2021-02-21;9;2;38859;16779;6.0;2.6
17;2021-02-22;648;1630;39507;18409;6.1;2.8
17;2021-02-23;782;1535;40289;19944;6.2;3.1
17;2021-02-24;1080;1586;41369;21530;6.4;3.3
17;2021-02-25;1087;1709;42456;23239;6.6;3.6
17;2021-02-26;1308;1296;43764;24535;6.8;3.8
17;2021-02-27;529;248;44293;24783;6.8;3.8
17;2021-02-28;19;9;44312;24792;6.8;3.8
17;2021-03-01;638;1042;44950;25834;6.9;4.0
17;2021-03-02;1095;870;46045;26704;7.1;4.1
17;2021-03-03;1617;795;47662;27499;7.4;4.2
17;2021-03-04;2426;1143;50088;28642;7.7;4.4
17;2021-03-05;2665;683;52753;29325;8.2;4.5
17;2021-03-06;1028;32;53781;29357;8.3;4.5
17;2021-03-07;183;47;53964;29404;8.3;4.5
17;2021-03-08;1019;835;54983;30239;8.5;4.7
17;2021-03-09;1745;621;56728;30860;8.8;4.8
17;2021-03-10;2048;648;58776;31508;9.1;4.9
17;2021-03-11;3228;999;62004;32507;9.6;5.0
17;2021-03-12;3356;630;65360;33137;10.1;5.1
17;2021-03-13;1203;13;66563;33150;10.3;5.1
17;2021-03-14;33;0;66596;33150;10.3;5.1
17;2021-03-15;1243;996;67839;34146;10.5;5.3
17;2021-03-16;892;536;68731;34682;10.6;5.4
17;2021-03-17;1459;707;70190;35389;10.8;5.5
17;2021-03-18;1683;766;71873;36155;11.1;5.6
17;2021-03-19;2096;549;73969;36704;11.4;5.7
17;2021-03-20;1086;59;75055;36763;11.6;5.7
17;2021-03-21;37;43;75092;36806;11.6;5.7
17;2021-03-22;1577;693;76669;37499;11.8;5.8
17;2021-03-23;2491;584;79160;38083;12.2;5.9
17;2021-03-24;3545;861;82705;38944;12.8;6.0
17;2021-03-25;4713;650;87418;39594;13.5;6.1
17;2021-03-26;4943;478;92361;40072;14.3;6.2
17;2021-03-27;1737;69;94098;40141;14.5;6.2
17;2021-03-28;369;45;94467;40186;14.6;6.2
17;2021-03-29;2361;569;96828;40755;15.0;6.3
17;2021-03-30;2654;990;99482;41745;15.4;6.5
17;2021-03-31;3843;912;103325;42657;16.0;6.6
17;2021-04-01;4013;1170;107338;43827;16.6;6.8
17;2021-04-02;3708;841;111046;44668;17.2;6.9
17;2021-04-03;1152;187;112198;44855;17.3;6.9
17;2021-04-04;501;6;112699;44861;17.4;6.9
17;2021-04-05;445;128;113144;44989;17.5;7.0
17;2021-04-06;3479;1032;116623;46021;18.0;7.1
17;2021-04-07;4131;1159;120754;47180;18.7;7.3
17;2021-04-08;4567;1482;125321;48662;19.4;7.5
17;2021-04-09;6498;846;131819;49508;20.4;7.7
17;2021-04-10;2582;72;134401;49580;20.8;7.7
17;2021-04-11;790;18;135191;49598;20.9;7.7
17;2021-04-12;2889;1624;138080;51222;21.3;7.9
17;2021-04-13;4152;1289;142232;52511;22.0;8.1
17;2021-04-14;4419;1214;146651;53725;22.7;8.3
17;2021-04-15;4601;1140;151252;54865;23.4;8.5
17;2021-04-16;4298;1155;155550;56020;24.0;8.7
17;2021-04-17;1682;384;157232;56404;24.3;8.7
17;2021-04-18;471;81;157703;56485;24.4;8.7
17;2021-04-19;2336;2063;160039;58548;24.7;9.0
17;2021-04-20;2927;2559;162966;61107;25.2;9.4
17;2021-04-21;2974;1942;165940;63049;25.6;9.7
17;2021-04-22;3121;2366;169061;65415;26.1;10.1
17;2021-04-23;2446;2731;171507;68146;26.5;10.5
17;2021-04-24;1669;929;173176;69075;26.8;10.7
17;2021-04-25;664;246;173840;69321;26.9;10.7
17;2021-04-26;2578;2627;176418;71948;27.3;11.1
17;2021-04-27;3151;2672;179569;74620;27.8;11.5
17;2021-04-28;3102;2940;182671;77560;28.2;12.0
17;2021-04-29;4149;2867;186820;80427;28.9;12.4
17;2021-04-30;4355;2640;191175;83067;29.5;12.8
17;2021-05-01;849;543;192024;83610;29.7;12.9
17;2021-05-02;553;839;192577;84449;29.8;13.1
17;2021-05-03;2546;2963;195123;87412;30.2;13.5
17;2021-05-04;2315;3726;197438;91138;30.5;14.1
17;2021-05-05;2907;3704;200345;94842;31.0;14.7
17;2021-05-06;4120;3405;204465;98247;31.6;15.2
17;2021-05-07;4359;3633;208824;101880;32.3;15.7
17;2021-05-08;1306;753;210130;102633;32.5;15.9
17;2021-05-09;1311;706;211441;103339;32.7;16.0
17;2021-05-10;2726;3694;214167;107033;33.1;16.5
17;2021-05-11;3500;3997;217667;111030;33.6;17.2
17;2021-05-12;3529;3813;221196;114843;34.2;17.7
17;2021-05-13;2542;693;223738;115536;34.6;17.9
17;2021-05-14;3031;2394;226769;117930;35.0;18.2
17;2021-05-15;2127;662;228896;118592;35.4;18.3
17;2021-05-16;1733;318;230629;118910;35.6;18.4
17;2021-05-17;4288;1999;234917;120909;36.3;18.7
17;2021-05-18;4746;1637;239663;122546;37.0;18.9
17;2021-05-19;5071;1281;244734;123827;37.8;19.1
17;2021-05-20;4940;1947;249674;125774;38.6;19.4
17;2021-05-21;4994;1955;254668;127729;39.4;19.7
17;2021-05-22;2390;532;257058;128261;39.7;19.8
17;2021-05-23;1900;128;258958;128389;40.0;19.8
17;2021-05-24;1426;210;260384;128599;40.2;19.9
17;2021-05-25;4031;1769;264415;130368;40.9;20.1
17;2021-05-26;4368;2040;268783;132408;41.5;20.5
17;2021-05-27;5211;2139;273994;134547;42.3;20.8
17;2021-05-28;4467;3437;278461;137984;43.0;21.3
17;2021-05-29;1559;1707;280020;139691;43.3;21.6
17;2021-05-30;857;410;280877;140101;43.4;21.7
17;2021-05-31;2947;3013;283824;143114;43.9;22.1
17;2021-06-01;4295;2927;288119;146041;44.5;22.6
17;2021-06-02;4203;3175;292322;149216;45.2;23.1
17;2021-06-03;5058;3167;297380;152383;46.0;23.5
17;2021-06-04;4513;3859;301893;156242;46.7;24.1
17;2021-06-05;1991;1603;303884;157845;47.0;24.4
17;2021-06-06;852;734;304736;158579;47.1;24.5
17;2021-06-07;3138;4345;307874;162924;47.6;25.2
17;2021-06-08;3790;4496;311664;167420;48.2;25.9
17;2021-06-09;4345;3055;316009;170475;48.8;26.3
17;2021-06-10;4927;2794;320936;173269;49.6;26.8
17;2021-06-11;4794;3693;325730;176962;50.3;27.3
17;2021-06-12;1813;1405;327543;178367;50.6;27.6
17;2021-06-13;612;415;328155;178782;50.7;27.6
17;2021-06-14;2834;4538;330989;183320;51.2;28.3
17;2021-06-15;3625;4381;334614;187701;51.7;29.0
17;2021-06-16;4127;3695;338741;191396;52.3;29.6
17;2021-06-17;4367;4125;343108;195521;53.0;30.2
17;2021-06-18;4059;4441;347167;199962;53.7;30.9
17;2021-06-19;1450;1988;348617;201950;53.9;31.2
17;2021-06-20;595;1036;349212;202986;54.0;31.4
17;2021-06-21;2559;4371;351771;207357;54.4;32.0
17;2021-06-22;3532;4452;355303;211809;54.9;32.7
17;2021-06-23;3795;3998;359098;215807;55.5;33.4
17;2021-06-24;3600;3959;362698;219766;56.1;34.0
17;2021-06-25;2718;4991;365416;224757;56.5;34.7
17;2021-06-26;905;2334;366321;227091;56.6;35.1
17;2021-06-27;397;1904;366718;228995;56.7;35.4
17;2021-06-28;1523;5416;368241;234411;56.9;36.2
17;2021-06-29;1684;5892;369925;240303;57.2;37.1
17;2021-06-30;2030;5548;371955;245851;57.5;38.0
17;2021-07-01;2267;5562;374222;251413;57.8;38.9
17;2021-07-02;2485;5983;376707;257396;58.2;39.8
17;2021-07-03;627;2544;377334;259940;58.3;40.2
17;2021-07-04;155;1250;377489;261190;58.3;40.4
17;2021-07-05;1887;5176;379376;266366;58.6;41.2
17;2021-07-06;2129;5600;381505;271966;59.0;42.0
17;2021-07-07;2406;5500;383911;277466;59.3;42.9
17;2021-07-08;2915;5446;386826;282912;59.8;43.7
17;2021-07-09;2526;6078;389352;288990;60.2;44.7
17;2021-07-10;826;2471;390178;291461;60.3;45.0
17;2021-07-11;379;906;390557;292367;60.4;45.2
17;2021-07-12;2002;5617;392559;297984;60.7;46.1
17;2021-07-13;2372;6720;394931;304704;61.0;47.1
17;2021-07-14;71;71;395002;304775;61.0;47.1
17;2021-07-15;2190;6862;397192;311637;61.4;48.2
17;2021-07-16;2777;6965;399969;318602;61.8;49.2
17;2021-07-17;1051;2274;401020;320876;62.0;49.6
17;2021-07-18;312;1036;401332;321912;62.0;49.7
17;2021-07-19;2634;5908;403966;327820;62.4;50.7
17;2021-07-20;3314;6317;407280;334137;62.9;51.6
17;2021-07-21;3802;6029;411082;340166;63.5;52.6
17;2021-07-22;4248;6269;415330;346435;64.2;53.5
17;2021-07-23;3903;6566;419233;353001;64.8;54.6
17;2021-07-24;2067;1403;421300;354404;65.1;54.8
17;2021-07-25;1040;417;422340;354821;65.3;54.8
17;2021-07-26;3735;5425;426075;360246;65.8;55.7
17;2021-07-27;4728;5442;430803;365688;66.6;56.5
17;2021-07-28;5215;5177;436018;370865;67.4;57.3
17;2021-07-29;5166;5343;441184;376208;68.2;58.1
17;2021-07-30;5512;5577;446696;381785;69.0;59.0
17;2021-07-31;2116;1215;448812;383000;69.4;59.2
17;2021-08-01;1095;359;449907;383359;69.5;59.2
17;2021-08-02;4621;4393;454528;387752;70.2;59.9
17;2021-08-03;5762;4165;460290;391917;71.1;60.6
17;2021-08-04;6202;3379;466492;395296;72.1;61.1
17;2021-08-05;6389;3150;472881;398446;73.1;61.6
17;2021-08-06;5888;3601;478769;402047;74.0;62.1
17;2021-08-07;1992;869;480761;402916;74.3;62.3
17;2021-08-08;978;219;481739;403135;74.4;62.3
17;2021-08-09;3923;3696;485662;406831;75.1;62.9
17;2021-08-10;5087;3488;490749;410319;75.8;63.4
17;2021-08-11;4919;3812;495668;414131;76.6;64.0
17;2021-08-12;4896;3959;500564;418090;77.4;64.6
17;2021-08-13;4521;4142;505085;422232;78.1;65.3
17;2021-08-14;1239;1383;506324;423615;78.2;65.5
17;2021-08-15;407;377;506731;423992;78.3;65.5
17;2021-08-16;2855;4065;509586;428057;78.8;66.2
17;2021-08-17;3052;4291;512638;432348;79.2;66.8
17;2021-08-18;2622;4555;515260;436903;79.6;67.5
17;2021-08-19;2733;4372;517993;441275;80.1;68.2
17;2021-08-20;2501;5025;520494;446300;80.4;69.0
17;2021-08-21;684;1355;521178;447655;80.5;69.2
17;2021-08-22;221;457;521399;448112;80.6;69.3
17;2021-08-23;1987;4956;523386;453068;80.9;70.0
17;2021-08-24;1941;5091;525327;458159;81.2;70.8
17;2021-08-25;1660;5506;526987;463665;81.4;71.7
17;2021-08-26;1603;5761;528590;469426;81.7;72.5
17;2021-08-27;1551;5954;530141;475380;81.9;73.5
17;2021-08-28;521;1455;530662;476835;82.0;73.7
17;2021-08-29;87;575;530749;477410;82.0;73.8
17;2021-08-30;1436;5049;532185;482459;82.2;74.6
17;2021-08-31;1327;5238;533512;487697;82.4;75.4
17;2021-09-01;1195;4758;534707;492455;82.6;76.1
17;2021-09-02;1139;4144;535846;496599;82.8;76.7
17;2021-09-03;1169;4918;537015;501517;83.0;77.5
17;2021-09-04;287;917;537302;502434;83.0;77.6
17;2021-09-05;55;103;537357;502537;83.0;77.7
17;2021-09-06;729;3207;538086;505744;83.2;78.2
17;2021-09-07;719;2636;538805;508380;83.3;78.6
17;2021-09-08;823;3591;539628;511971;83.4;79.1
17;2021-09-09;818;2402;540446;514373;83.5;79.5
17;2021-09-10;803;3330;541249;517703;83.6;80.0
17;2021-09-11;304;852;541553;518555;83.7;80.1
17;2021-09-12;10;13;541563;518568;83.7;80.1
17;2021-09-13;653;1933;542216;520501;83.8;80.4
17;2021-09-14;618;1623;542834;522124;83.9;80.7
17;2021-09-15;941;2376;543775;524500;84.0;81.1
17;2021-09-16;544;1453;544319;525953;84.1;81.3
17;2021-09-17;619;1921;544938;527874;84.2;81.6
17;2021-09-18;193;583;545131;528457;84.2;81.7
17;2021-09-19;13;6;545144;528463;84.2;81.7
17;2021-09-20;432;1226;545576;529689;84.3;81.9
17;2021-09-21;324;892;545900;530581;84.4;82.0
17;2021-09-22;419;1694;546319;532275;84.4;82.3
17;2021-09-23;357;971;546676;533246;84.5;82.4
17;2021-09-24;385;1821;547061;535067;84.5;82.7
17;2021-09-25;127;472;547188;535539;84.6;82.8
17;2021-09-26;0;16;547188;535555;84.6;82.8
17;2021-09-27;437;1176;547625;536731;84.6;82.9
17;2021-09-28;275;688;547900;537419;84.7;83.1
17;2021-09-29;453;1213;548353;538632;84.7;83.2
17;2021-09-30;372;715;548725;539347;84.8;83.4
17;2021-10-01;360;742;549085;540089;84.9;83.5
17;2021-10-02;108;310;549193;540399;84.9;83.5
17;2021-10-03;4;28;549197;540427;84.9;83.5
17;2021-10-04;366;861;549563;541288;84.9;83.7
17;2021-10-05;377;579;549940;541867;85.0;83.7
17;2021-10-06;424;1131;550364;542998;85.1;83.9
17;2021-10-07;275;556;550639;543554;85.1;84.0
17;2021-10-08;418;888;551057;544442;85.2;84.1
17;2021-10-09;148;314;551205;544756;85.2;84.2
17;2021-10-10;1;23;551206;544779;85.2;84.2
17;2021-10-11;385;562;551591;545341;85.2;84.3
18;2020-12-27;0;0;0;0;0.0;0.0
18;2020-12-28;0;0;0;0;0.0;0.0
18;2020-12-29;0;0;0;0;0.0;0.0
18;2020-12-30;1;0;1;0;0.0;0.0
18;2020-12-31;0;0;1;0;0.0;0.0
18;2021-01-01;0;0;1;0;0.0;0.0
18;2021-01-02;0;0;1;0;0.0;0.0
18;2021-01-03;0;0;1;0;0.0;0.0
18;2021-01-04;3;0;4;0;0.0;0.0
18;2021-01-05;0;0;4;0;0.0;0.0
18;2021-01-06;1;0;5;0;0.0;0.0
18;2021-01-07;30;1;35;1;0.0;0.0
18;2021-01-08;65;0;100;1;0.0;0.0
18;2021-01-09;225;1;325;2;0.1;0.0
18;2021-01-10;146;0;471;2;0.2;0.0
18;2021-01-11;169;0;640;2;0.2;0.0
18;2021-01-12;371;0;1011;2;0.3;0.0
18;2021-01-13;270;2;1281;4;0.4;0.0
18;2021-01-14;269;2;1550;6;0.5;0.0
18;2021-01-15;332;2;1882;8;0.6;0.0
18;2021-01-16;288;3;2170;11;0.7;0.0
18;2021-01-17;1;0;2171;11;0.7;0.0
18;2021-01-18;291;0;2462;11;0.8;0.0
18;2021-01-19;1373;5;3835;16;1.3;0.0
18;2021-01-20;1239;2;5074;18;1.7;0.0
18;2021-01-21;965;0;6039;18;2.0;0.0
18;2021-01-22;780;2;6819;20;2.3;0.0
18;2021-01-23;249;2;7068;22;2.4;0.0
18;2021-01-24;0;0;7068;22;2.4;0.0
18;2021-01-25;509;1;7577;23;2.6;0.0
18;2021-01-26;395;1;7972;24;2.7;0.0
18;2021-01-27;390;2;8362;26;2.8;0.0
18;2021-01-28;566;8;8928;34;3.0;0.0
18;2021-01-29;490;73;9418;107;3.2;0.0
18;2021-01-30;431;159;9849;266;3.3;0.1
18;2021-01-31;82;116;9931;382;3.4;0.1
18;2021-02-01;328;139;10259;521;3.5;0.2
18;2021-02-02;507;240;10766;761;3.6;0.3
18;2021-02-03;398;204;11164;965;3.8;0.3
18;2021-02-04;630;228;11794;1193;4.0;0.4
18;2021-02-05;448;194;12242;1387;4.1;0.5
18;2021-02-06;283;100;12525;1487;4.2;0.5
18;2021-02-07;108;1;12633;1488;4.3;0.5
18;2021-02-08;268;230;12901;1718;4.4;0.6
18;2021-02-09;583;780;13484;2498;4.5;0.8
18;2021-02-10;741;695;14225;3193;4.8;1.1
18;2021-02-11;655;451;14880;3644;5.0;1.2
18;2021-02-12;502;330;15382;3974;5.2;1.3
18;2021-02-13;286;124;15668;4098;5.3;1.4
18;2021-02-14;364;98;16032;4196;5.4;1.4
18;2021-02-15;378;394;16410;4590;5.5;1.5
18;2021-02-16;399;402;16809;4992;5.7;1.7
18;2021-02-17;403;456;17212;5448;5.8;1.8
18;2021-02-18;344;537;17556;5985;5.9;2.0
18;2021-02-19;471;305;18027;6290;6.1;2.1
18;2021-02-20;721;241;18748;6531;6.3;2.2
18;2021-02-21;317;4;19065;6535;6.4;2.2
18;2021-02-22;218;369;19283;6904;6.5;2.3
18;2021-02-23;204;350;19487;7254;6.6;2.4
18;2021-02-24;241;273;19728;7527;6.7;2.5
18;2021-02-25;294;519;20022;8046;6.8;2.7
18;2021-02-26;583;236;20605;8282;7.0;2.8
18;2021-02-27;510;388;21115;8670;7.1;2.9
18;2021-02-28;7;68;21122;8738;7.1;2.9
18;2021-03-01;237;412;21359;9150;7.2;3.1
18;2021-03-02;284;519;21643;9669;7.3;3.3
18;2021-03-03;346;586;21989;10255;7.4;3.5
18;2021-03-04;475;571;22464;10826;7.6;3.7
18;2021-03-05;524;372;22988;11198;7.8;3.8
18;2021-03-06;1071;347;24059;11545;8.1;3.9
18;2021-03-07;7;140;24066;11685;8.1;3.9
18;2021-03-08;336;363;24402;12048;8.2;4.1
18;2021-03-09;410;367;24812;12415;8.4;4.2
18;2021-03-10;422;453;25234;12868;8.5;4.3
18;2021-03-11;518;426;25752;13294;8.7;4.5
18;2021-03-12;705;305;26457;13599;8.9;4.6
18;2021-03-13;1164;252;27621;13851;9.3;4.7
18;2021-03-14;301;215;27922;14066;9.4;4.7
18;2021-03-15;492;382;28414;14448;9.6;4.9
18;2021-03-16;392;314;28806;14762;9.7;5.0
18;2021-03-17;383;414;29189;15176;9.8;5.1
18;2021-03-18;512;230;29701;15406;10.0;5.2
18;2021-03-19;755;228;30456;15634;10.3;5.3
18;2021-03-20;986;623;31442;16257;10.6;5.5
18;2021-03-21;308;308;31750;16565;10.7;5.6
18;2021-03-22;602;299;32352;16864;10.9;5.7
18;2021-03-23;707;295;33059;17159;11.2;5.8
18;2021-03-24;1052;299;34111;17458;11.5;5.9
18;2021-03-25;1049;304;35160;17762;11.9;6.0
18;2021-03-26;1208;351;36368;18113;12.3;6.1
18;2021-03-27;1488;322;37856;18435;12.8;6.2
18;2021-03-28;215;0;38071;18435;12.8;6.2
18;2021-03-29;1101;201;39172;18636;13.2;6.3
18;2021-03-30;1084;305;40256;18941;13.6;6.4
18;2021-03-31;1305;256;41561;19197;14.0;6.5
18;2021-04-01;1375;350;42936;19547;14.5;6.6
18;2021-04-02;1229;312;44165;19859;14.9;6.7
18;2021-04-03;581;181;44746;20040;15.1;6.8
18;2021-04-04;71;5;44817;20045;15.1;6.8
18;2021-04-05;199;0;45016;20045;15.2;6.8
18;2021-04-06;1027;353;46043;20398;15.5;6.9
18;2021-04-07;1322;368;47365;20766;16.0;7.0
18;2021-04-08;1692;351;49057;21117;16.6;7.1
18;2021-04-09;1833;284;50890;21401;17.2;7.2
18;2021-04-10;2632;653;53522;22054;18.1;7.4
18;2021-04-11;1986;322;55508;22376;18.7;7.5
18;2021-04-12;1401;404;56909;22780;19.2;7.7
18;2021-04-13;1785;470;58694;23250;19.8;7.8
18;2021-04-14;1378;518;60072;23768;20.3;8.0
18;2021-04-15;1532;534;61604;24302;20.8;8.2
18;2021-04-16;1614;594;63218;24896;21.3;8.4
18;2021-04-17;1599;524;64817;25420;21.9;8.6
18;2021-04-18;377;232;65194;25652;22.0;8.7
18;2021-04-19;1317;595;66511;26247;22.4;8.9
18;2021-04-20;1445;716;67956;26963;22.9;9.1
18;2021-04-21;1270;910;69226;27873;23.4;9.4
18;2021-04-22;1403;705;70629;28578;23.8;9.6
18;2021-04-23;1387;738;72016;29316;24.3;9.9
18;2021-04-24;1355;1274;73371;30590;24.8;10.3
18;2021-04-25;287;217;73658;30807;24.9;10.4
18;2021-04-26;1205;957;74863;31764;25.3;10.7
18;2021-04-27;1544;766;76407;32530;25.8;11.0
18;2021-04-28;1358;879;77765;33409;26.2;11.3
18;2021-04-29;1851;736;79616;34145;26.9;11.5
18;2021-04-30;1569;999;81185;35144;27.4;11.9
18;2021-05-01;788;212;81973;35356;27.7;11.9
18;2021-05-02;806;61;82779;35417;27.9;11.9
18;2021-05-03;1627;1015;84406;36432;28.5;12.3
18;2021-05-04;1729;1287;86135;37719;29.1;12.7
18;2021-05-05;1735;1216;87870;38935;29.6;13.1
18;2021-05-06;2162;1368;90032;40303;30.4;13.6
18;2021-05-07;1234;1404;91266;41707;30.8;14.1
18;2021-05-08;994;1471;92260;43178;31.1;14.6
18;2021-05-09;500;2261;92760;45439;31.3;15.3
18;2021-05-10;1157;1508;93917;46947;31.7;15.8
18;2021-05-11;1696;1752;95613;48699;32.3;16.4
18;2021-05-12;1806;1497;97419;50196;32.9;16.9
18;2021-05-13;1061;370;98480;50566;33.2;17.1
18;2021-05-14;1345;942;99825;51508;33.7;17.4
18;2021-05-15;1809;1164;101634;52672;34.3;17.8
18;2021-05-16;537;581;102171;53253;34.5;18.0
18;2021-05-17;1245;1091;103416;54344;34.9;18.3
18;2021-05-18;2146;933;105562;55277;35.6;18.6
18;2021-05-19;2162;920;107724;56197;36.3;19.0
18;2021-05-20;2275;983;109999;57180;37.1;19.3
18;2021-05-21;1495;765;111494;57945;37.6;19.5
18;2021-05-22;1724;1075;113218;59020;38.2;19.9
18;2021-05-23;486;336;113704;59356;38.4;20.0
18;2021-05-24;461;293;114165;59649;38.5;20.1
18;2021-05-25;1841;1061;116006;60710;39.1;20.5
18;2021-05-26;2153;846;118159;61556;39.9;20.8
18;2021-05-27;2209;1231;120368;62787;40.6;21.2
18;2021-05-28;1712;1308;122080;64095;41.2;21.6
18;2021-05-29;2621;1663;124701;65758;42.1;22.2
18;2021-05-30;1482;504;126183;66262;42.6;22.4
18;2021-05-31;1786;693;127969;66955;43.2;22.6
18;2021-06-01;2039;947;130008;67902;43.9;22.9
18;2021-06-02;2010;1018;132018;68920;44.5;23.3
18;2021-06-03;2283;1202;134301;70122;45.3;23.7
18;2021-06-04;1912;1123;136213;71245;46.0;24.0
18;2021-06-05;2800;1450;139013;72695;46.9;24.5
18;2021-06-06;364;381;139377;73076;47.0;24.7
18;2021-06-07;1294;1232;140671;74308;47.5;25.1
18;2021-06-08;1490;1394;142161;75702;48.0;25.5
18;2021-06-09;1329;1068;143490;76770;48.4;25.9
18;2021-06-10;1631;1410;145121;78180;49.0;26.4
18;2021-06-11;1496;1404;146617;79584;49.5;26.8
18;2021-06-12;1245;2510;147862;82094;49.9;27.7
18;2021-06-13;126;263;147988;82357;49.9;27.8
18;2021-06-14;656;1828;148644;84185;50.1;28.4
18;2021-06-15;1093;1823;149737;86008;50.5;29.0
18;2021-06-16;1255;1441;150992;87449;50.9;29.5
18;2021-06-17;1205;1670;152197;89119;51.3;30.1
18;2021-06-18;1290;1667;153487;90786;51.8;30.6
18;2021-06-19;1564;1251;155051;92037;52.3;31.1
18;2021-06-20;246;159;155297;92196;52.4;31.1
18;2021-06-21;665;1601;155962;93797;52.6;31.6
18;2021-06-22;1068;1645;157030;95442;53.0;32.2
18;2021-06-23;944;1642;157974;97084;53.3;32.8
18;2021-06-24;1033;1062;159007;98146;53.6;33.1
18;2021-06-25;892;1746;159899;99892;53.9;33.7
18;2021-06-26;1097;1474;160996;101366;54.3;34.2
18;2021-06-27;31;372;161027;101738;54.3;34.3
18;2021-06-28;422;1922;161449;103660;54.5;35.0
18;2021-06-29;597;2379;162046;106039;54.7;35.8
18;2021-06-30;600;2543;162646;108582;54.9;36.6
18;2021-07-01;964;2157;163610;110739;55.2;37.4
18;2021-07-02;614;1685;164224;112424;55.4;37.9
18;2021-07-03;754;2574;164978;114998;55.7;38.8
18;2021-07-04;164;1032;165142;116030;55.7;39.1
18;2021-07-05;765;1877;165907;117907;56.0;39.8
18;2021-07-06;559;2301;166466;120208;56.2;40.6
18;2021-07-07;766;2115;167232;122323;56.4;41.3
18;2021-07-08;1031;1984;168263;124307;56.8;41.9
18;2021-07-09;703;2307;168966;126614;57.0;42.7
18;2021-07-10;781;3175;169747;129789;57.3;43.8
18;2021-07-11;84;668;169831;130457;57.3;44.0
18;2021-07-12;223;2253;170054;132710;57.4;44.8
18;2021-07-13;619;2904;170673;135614;57.6;45.8
18;2021-07-14;194;937;170867;136551;57.6;46.1
18;2021-07-15;1396;2816;172263;139367;58.1;47.0
18;2021-07-16;1185;2122;173448;141489;58.5;47.7
18;2021-07-17;1130;2472;174578;143961;58.9;48.6
18;2021-07-18;228;332;174806;144293;59.0;48.7
18;2021-07-19;1055;1657;175861;145950;59.3;49.2
18;2021-07-20;1625;2269;177486;148219;59.9;50.0
18;2021-07-21;1901;2062;179387;150281;60.5;50.7
18;2021-07-22;2211;1901;181598;152182;61.3;51.3
18;2021-07-23;1395;1613;182993;153795;61.7;51.9
18;2021-07-24;891;1534;183884;155329;62.0;52.4
18;2021-07-25;192;396;184076;155725;62.1;52.5
18;2021-07-26;1397;1502;185473;157227;62.6;53.0
18;2021-07-27;1825;1538;187298;158765;63.2;53.6
18;2021-07-28;2198;1797;189496;160562;63.9;54.2
18;2021-07-29;2140;1817;191636;162379;64.7;54.8
18;2021-07-30;1585;1344;193221;163723;65.2;55.2
18;2021-07-31;1237;1281;194458;165004;65.6;55.7
18;2021-08-01;90;34;194548;165038;65.6;55.7
18;2021-08-02;1410;765;195958;165803;66.1;55.9
18;2021-08-03;1719;1630;197677;167433;66.7;56.5
18;2021-08-04;2440;1102;200117;168535;67.5;56.9
18;2021-08-05;1529;1247;201646;169782;68.0;57.3
18;2021-08-06;1582;1142;203228;170924;68.6;57.7
18;2021-08-07;610;764;203838;171688;68.8;57.9
18;2021-08-08;49;60;203887;171748;68.8;57.9
18;2021-08-09;1105;874;204992;172622;69.2;58.2
18;2021-08-10;1208;1511;206200;174133;69.6;58.7
18;2021-08-11;1608;1510;207808;175643;70.1;59.3
18;2021-08-12;1554;1594;209362;177237;70.6;59.8
18;2021-08-13;1087;1172;210449;178409;71.0;60.2
18;2021-08-14;759;603;211208;179012;71.3;60.4
18;2021-08-15;35;17;211243;179029;71.3;60.4
18;2021-08-16;830;1201;212073;180230;71.5;60.8
18;2021-08-17;979;1999;213052;182229;71.9;61.5
18;2021-08-18;1158;1961;214210;184190;72.3;62.1
18;2021-08-19;1105;1612;215315;185802;72.6;62.7
18;2021-08-20;911;1758;216226;187560;72.9;63.3
18;2021-08-21;419;705;216645;188265;73.1;63.5
18;2021-08-22;22;73;216667;188338;73.1;63.5
18;2021-08-23;487;1680;217154;190018;73.3;64.1
18;2021-08-24;903;1494;218057;191512;73.6;64.6
18;2021-08-25;840;1864;218897;193376;73.9;65.2
18;2021-08-26;772;1532;219669;194908;74.1;65.8
18;2021-08-27;575;1994;220244;196902;74.3;66.4
18;2021-08-28;501;873;220745;197775;74.5;66.7
18;2021-08-29;92;176;220837;197951;74.5;66.8
18;2021-08-30;528;1409;221365;199360;74.7;67.3
18;2021-08-31;507;1397;221872;200757;74.9;67.7
18;2021-09-01;578;1509;222450;202266;75.0;68.2
18;2021-09-02;398;1108;222848;203374;75.2;68.6
18;2021-09-03;455;1141;223303;204515;75.3;69.0
18;2021-09-04;357;735;223660;205250;75.5;69.2
18;2021-09-05;29;56;223689;205306;75.5;69.3
18;2021-09-06;279;871;223968;206177;75.6;69.6
18;2021-09-07;280;828;224248;207005;75.7;69.8
18;2021-09-08;404;1032;224652;208037;75.8;70.2
18;2021-09-09;357;988;225009;209025;75.9;70.5
18;2021-09-10;414;933;225423;209958;76.1;70.8
18;2021-09-11;262;783;225685;210741;76.1;71.1
18;2021-09-12;8;19;225693;210760;76.1;71.1
18;2021-09-13;310;704;226003;211464;76.2;71.3
18;2021-09-14;283;774;226286;212238;76.3;71.6
18;2021-09-15;321;1053;226607;213291;76.5;72.0
18;2021-09-16;471;879;227078;214170;76.6;72.3
18;2021-09-17;337;737;227415;214907;76.7;72.5
18;2021-09-18;184;618;227599;215525;76.8;72.7
18;2021-09-19;6;4;227605;215529;76.8;72.7
18;2021-09-20;157;550;227762;216079;76.8;72.9
18;2021-09-21;112;424;227874;216503;76.9;73.0
18;2021-09-22;192;870;228066;217373;76.9;73.3
18;2021-09-23;249;466;228315;217839;77.0;73.5
18;2021-09-24;141;489;228456;218328;77.1;73.7
18;2021-09-25;159;690;228615;219018;77.1;73.9
18;2021-09-26;15;89;228630;219107;77.1;73.9
18;2021-09-27;109;315;228739;219422;77.2;74.0
18;2021-09-28;70;273;228809;219695;77.2;74.1
18;2021-09-29;68;281;228877;219976;77.2;74.2
18;2021-09-30;116;280;228993;220256;77.3;74.3
18;2021-10-01;143;289;229136;220545;77.3;74.4
18;2021-10-02;62;163;229198;220708;77.3;74.5
18;2021-10-03;6;10;229204;220718;77.3;74.5
18;2021-10-04;143;457;229347;221175;77.4;74.6
18;2021-10-05;161;336;229508;221511;77.4;74.7
18;2021-10-06;134;442;229642;221953;77.5;74.9
18;2021-10-07;99;372;229741;222325;77.5;75.0
18;2021-10-08;145;520;229886;222845;77.6;75.2
18;2021-10-09;118;314;230004;223159;77.6;75.3
18;2021-10-10;4;13;230008;223172;77.6;75.3
18;2021-10-11;156;199;230164;223371;77.7;75.4
19;2020-12-27;0;0;0;0;0.0;0.0
19;2020-12-28;0;0;0;0;0.0;0.0
19;2020-12-29;1;0;1;0;0.0;0.0
19;2020-12-30;0;0;1;0;0.0;0.0
19;2020-12-31;0;0;1;0;0.0;0.0
19;2021-01-01;0;0;1;0;0.0;0.0
19;2021-01-02;0;0;1;0;0.0;0.0
19;2021-01-03;0;0;1;0;0.0;0.0
19;2021-01-04;0;0;1;0;0.0;0.0
19;2021-01-05;0;0;1;0;0.0;0.0
19;2021-01-06;0;0;1;0;0.0;0.0
19;2021-01-07;344;2;345;2;0.1;0.0
19;2021-01-08;248;1;593;3;0.2;0.0
19;2021-01-09;1;0;594;3;0.2;0.0
19;2021-01-10;1;0;595;3;0.2;0.0
19;2021-01-11;38;0;633;3;0.3;0.0
19;2021-01-12;416;2;1049;5;0.4;0.0
19;2021-01-13;429;11;1478;16;0.6;0.0
19;2021-01-14;475;1;1953;17;0.8;0.0
19;2021-01-15;226;18;2179;35;0.9;0.0
19;2021-01-16;0;0;2179;35;0.9;0.0
19;2021-01-17;1;0;2180;35;0.9;0.0
19;2021-01-18;251;2;2431;37;1.0;0.0
19;2021-01-19;521;0;2952;37;1.2;0.0
19;2021-01-20;921;9;3873;46;1.6;0.0
19;2021-01-21;507;5;4380;51;1.8;0.0
19;2021-01-22;1318;18;5698;69;2.4;0.0
19;2021-01-23;281;0;5979;69;2.5;0.0
19;2021-01-24;38;0;6017;69;2.5;0.0
19;2021-01-25;233;0;6250;69;2.6;0.0
19;2021-01-26;608;4;6858;73;2.9;0.0
19;2021-01-27;334;5;7192;78;3.0;0.0
19;2021-01-28;297;251;7489;329;3.1;0.1
19;2021-01-29;347;61;7836;390;3.3;0.2
19;2021-01-30;130;26;7966;416;3.3;0.2
19;2021-01-31;41;1;8007;417;3.3;0.2
19;2021-02-01;158;95;8165;512;3.4;0.2
19;2021-02-02;303;429;8468;941;3.5;0.4
19;2021-02-03;285;246;8753;1187;3.6;0.5
19;2021-02-04;255;375;9008;1562;3.7;0.6
19;2021-02-05;311;76;9319;1638;3.9;0.7
19;2021-02-06;215;2;9534;1640;4.0;0.7
19;2021-02-07;48;2;9582;1642;4.0;0.7
19;2021-02-08;177;150;9759;1792;4.1;0.7
19;2021-02-09;333;274;10092;2066;4.2;0.9
19;2021-02-10;517;296;10609;2362;4.4;1.0
19;2021-02-11;414;319;11023;2681;4.6;1.1
19;2021-02-12;799;1162;11822;3843;4.9;1.6
19;2021-02-13;352;187;12174;4030;5.1;1.7
19;2021-02-14;98;13;12272;4043;5.1;1.7
19;2021-02-15;200;243;12472;4286;5.2;1.8
19;2021-02-16;386;171;12858;4457;5.4;1.9
19;2021-02-17;306;468;13164;4925;5.5;2.0
19;2021-02-18;174;507;13338;5432;5.5;2.3
19;2021-02-19;469;299;13807;5731;5.7;2.4
19;2021-02-20;133;207;13940;5938;5.8;2.5
19;2021-02-21;20;40;13960;5978;5.8;2.5
19;2021-02-22;221;211;14181;6189;5.9;2.6
19;2021-02-23;268;345;14449;6534;6.0;2.7
19;2021-02-24;361;208;14810;6742;6.2;2.8
19;2021-02-25;519;382;15329;7124;6.4;3.0
19;2021-02-26;395;318;15724;7442;6.5;3.1
19;2021-02-27;348;162;16072;7604;6.7;3.2
19;2021-02-28;68;36;16140;7640;6.7;3.2
19;2021-03-01;266;221;16406;7861;6.8;3.3
19;2021-03-02;428;258;16834;8119;7.0;3.4
19;2021-03-03;692;340;17526;8459;7.3;3.5
19;2021-03-04;826;353;18352;8812;7.6;3.7
19;2021-03-05;891;737;19243;9549;8.0;4.0
19;2021-03-06;1072;216;20315;9765;8.5;4.1
19;2021-03-07;463;38;20778;9803;8.6;4.1
19;2021-03-08;640;166;21418;9969;8.9;4.1
19;2021-03-09;836;251;22254;10220;9.3;4.3
19;2021-03-10;1155;322;23409;10542;9.7;4.4
19;2021-03-11;1274;310;24683;10852;10.3;4.5
19;2021-03-12;1136;407;25819;11259;10.7;4.7
19;2021-03-13;1110;169;26929;11428;11.2;4.8
19;2021-03-14;161;85;27090;11513;11.3;4.8
19;2021-03-15;699;137;27789;11650;11.6;4.8
19;2021-03-16;688;304;28477;11954;11.8;5.0
19;2021-03-17;839;283;29316;12237;12.2;5.1
19;2021-03-18;767;283;30083;12520;12.5;5.2
19;2021-03-19;1014;488;31097;13008;12.9;5.4
19;2021-03-20;784;132;31881;13140;13.3;5.5
19;2021-03-21;128;4;32009;13144;13.3;5.5
19;2021-03-22;548;177;32557;13321;13.5;5.5
19;2021-03-23;1045;234;33602;13555;14.0;5.6
19;2021-03-24;1172;373;34774;13928;14.5;5.8
19;2021-03-25;1189;415;35963;14343;15.0;6.0
19;2021-03-26;1325;279;37288;14622;15.5;6.1
19;2021-03-27;854;191;38142;14813;15.9;6.2
19;2021-03-28;63;60;38205;14873;15.9;6.2
19;2021-03-29;612;177;38817;15050;16.2;6.3
19;2021-03-30;971;344;39788;15394;16.6;6.4
19;2021-03-31;1157;498;40945;15892;17.0;6.6
19;2021-04-01;1491;429;42436;16321;17.7;6.8
19;2021-04-02;1007;529;43443;16850;18.1;7.0
19;2021-04-03;597;285;44040;17135;18.3;7.1
19;2021-04-04;130;3;44170;17138;18.4;7.1
19;2021-04-05;40;76;44210;17214;18.4;7.2
19;2021-04-06;734;604;44944;17818;18.7;7.4
19;2021-04-07;976;732;45920;18550;19.1;7.7
19;2021-04-08;1116;1020;47036;19570;19.6;8.1
19;2021-04-09;1641;616;48677;20186;20.3;8.4
19;2021-04-10;946;560;49623;20746;20.6;8.6
19;2021-04-11;557;74;50180;20820;20.9;8.7
19;2021-04-12;681;524;50861;21344;21.2;8.9
19;2021-04-13;915;576;51776;21920;21.5;9.1
19;2021-04-14;1333;852;53109;22772;22.1;9.5
19;2021-04-15;1229;873;54338;23645;22.6;9.8
19;2021-04-16;1506;823;55844;24468;23.2;10.2
19;2021-04-17;761;480;56605;24948;23.6;10.4
19;2021-04-18;661;72;57266;25020;23.8;10.4
19;2021-04-19;730;440;57996;25460;24.1;10.6
19;2021-04-20;979;751;58975;26211;24.5;10.9
19;2021-04-21;1271;700;60246;26911;25.1;11.2
19;2021-04-22;1188;900;61434;27811;25.6;11.6
19;2021-04-23;1127;1021;62561;28832;26.0;12.0
19;2021-04-24;678;676;63239;29508;26.3;12.3
19;2021-04-25;675;70;63914;29578;26.6;12.3
19;2021-04-26;1056;332;64970;29910;27.0;12.4
19;2021-04-27;1027;569;65997;30479;27.5;12.7
19;2021-04-28;1553;557;67550;31036;28.1;12.9
19;2021-04-29;1453;1197;69003;32233;28.7;13.4
19;2021-04-30;1876;1062;70879;33295;29.5;13.9
19;2021-05-01;671;175;71550;33470;29.8;13.9
19;2021-05-02;551;152;72101;33622;30.0;14.0
19;2021-05-03;854;547;72955;34169;30.4;14.2
19;2021-05-04;1025;709;73980;34878;30.8;14.5
19;2021-05-05;1256;741;75236;35619;31.3;14.8
19;2021-05-06;1127;1200;76363;36819;31.8;15.3
19;2021-05-07;1663;1191;78026;38010;32.5;15.8
19;2021-05-08;712;206;78738;38216;32.8;15.9
19;2021-05-09;487;547;79225;38763;33.0;16.1
19;2021-05-10;1164;671;80389;39434;33.4;16.4
19;2021-05-11;1639;858;82028;40292;34.1;16.8
19;2021-05-12;1945;1322;83973;41614;34.9;17.3
19;2021-05-13;571;242;84544;41856;35.2;17.4
19;2021-05-14;1646;987;86190;42843;35.9;17.8
19;2021-05-15;1443;592;87633;43435;36.5;18.1
19;2021-05-16;350;82;87983;43517;36.6;18.1
19;2021-05-17;1498;559;89481;44076;37.2;18.3
19;2021-05-18;1669;500;91150;44576;37.9;18.5
19;2021-05-19;2009;829;93159;45405;38.8;18.9
19;2021-05-20;1722;892;94881;46297;39.5;19.3
19;2021-05-21;1964;814;96845;47111;40.3;19.6
19;2021-05-22;1271;651;98116;47762;40.8;19.9
19;2021-05-23;324;131;98440;47893;41.0;19.9
19;2021-05-24;139;46;98579;47939;41.0;19.9
19;2021-05-25;1503;492;100082;48431;41.6;20.2
19;2021-05-26;1924;666;102006;49097;42.4;20.4
19;2021-05-27;1786;837;103792;49934;43.2;20.8
19;2021-05-28;1937;991;105729;50925;44.0;21.2
19;2021-05-29;1375;705;107104;51630;44.6;21.5
19;2021-05-30;191;497;107295;52127;44.6;21.7
19;2021-05-31;1199;537;108494;52664;45.1;21.9
19;2021-06-01;1284;886;109778;53550;45.7;22.3
19;2021-06-02;1816;958;111594;54508;46.4;22.7
19;2021-06-03;1447;1255;113041;55763;47.0;23.2
19;2021-06-04;1848;1358;114889;57121;47.8;23.8
19;2021-06-05;1210;815;116099;57936;48.3;24.1
19;2021-06-06;87;648;116186;58584;48.3;24.4
19;2021-06-07;922;934;117108;59518;48.7;24.8
19;2021-06-08;1104;906;118212;60424;49.2;25.1
19;2021-06-09;1328;1463;119540;61887;49.7;25.8
19;2021-06-10;1283;1580;120823;63467;50.3;26.4
19;2021-06-11;1306;1921;122129;65388;50.8;27.2
19;2021-06-12;1356;1317;123485;66705;51.4;27.8
19;2021-06-13;542;424;124027;67129;51.6;27.9
19;2021-06-14;736;1016;124763;68145;51.9;28.4
19;2021-06-15;979;1143;125742;69288;52.3;28.8
19;2021-06-16;1222;1363;126964;70651;52.8;29.4
19;2021-06-17;868;1788;127832;72439;53.2;30.1
19;2021-06-18;1056;2135;128888;74574;53.6;31.0
19;2021-06-19;919;1302;129807;75876;54.0;31.6
19;2021-06-20;395;327;130202;76203;54.2;31.7
19;2021-06-21;500;1074;130702;77277;54.4;32.2
19;2021-06-22;698;1490;131400;78767;54.7;32.8
19;2021-06-23;744;1989;132144;80756;55.0;33.6
19;2021-06-24;687;1663;132831;82419;55.3;34.3
19;2021-06-25;562;2216;133393;84635;55.5;35.2
19;2021-06-26;474;1741;133867;86376;55.7;35.9
19;2021-06-27;289;446;134156;86822;55.8;36.1
19;2021-06-28;315;1499;134471;88321;56.0;36.7
19;2021-06-29;353;1893;134824;90214;56.1;37.5
19;2021-06-30;796;2152;135620;92366;56.4;38.4
19;2021-07-01;361;2322;135981;94688;56.6;39.4
19;2021-07-02;798;2316;136779;97004;56.9;40.4
19;2021-07-03;513;1744;137292;98748;57.1;41.1
19;2021-07-04;1;73;137293;98821;57.1;41.1
19;2021-07-05;600;1015;137893;99836;57.4;41.5
19;2021-07-06;504;1541;138397;101377;57.6;42.2
19;2021-07-07;706;2046;139103;103423;57.9;43.0
19;2021-07-08;770;2148;139873;105571;58.2;43.9
19;2021-07-09;716;2659;140589;108230;58.5;45.0
19;2021-07-10;586;1708;141175;109938;58.7;45.7
19;2021-07-11;45;212;141220;110150;58.8;45.8
19;2021-07-12;446;1487;141666;111637;58.9;46.5
19;2021-07-13;687;1828;142353;113465;59.2;47.2
19;2021-07-14;201;272;142554;113737;59.3;47.3
19;2021-07-15;870;2050;143424;115787;59.7;48.2
19;2021-07-16;1228;2445;144652;118232;60.2;49.2
19;2021-07-17;703;1718;145355;119950;60.5;49.9
19;2021-07-18;365;672;145720;120622;60.6;50.2
19;2021-07-19;968;1401;146688;122023;61.0;50.8
19;2021-07-20;967;1676;147655;123699;61.4;51.5
19;2021-07-21;1083;1711;148738;125410;61.9;52.2
19;2021-07-22;1392;1857;150130;127267;62.5;53.0
19;2021-07-23;1784;1996;151914;129263;63.2;53.8
19;2021-07-24;908;1753;152822;131016;63.6;54.5
19;2021-07-25;164;513;152986;131529;63.7;54.7
19;2021-07-26;911;911;153897;132440;64.0;55.1
19;2021-07-27;1424;1117;155321;133557;64.6;55.6
19;2021-07-28;2045;1224;157366;134781;65.5;56.1
19;2021-07-29;1623;1204;158989;135985;66.2;56.6
19;2021-07-30;1909;1027;160898;137012;66.9;57.0
19;2021-07-31;1129;1018;162027;138030;67.4;57.4
19;2021-08-01;347;372;162374;138402;67.6;57.6
19;2021-08-02;1195;810;163569;139212;68.1;57.9
19;2021-08-03;1453;1055;165022;140267;68.7;58.4
19;2021-08-04;1983;763;167005;141030;69.5;58.7
19;2021-08-05;1630;958;168635;141988;70.2;59.1
19;2021-08-06;1962;1219;170597;143207;71.0;59.6
19;2021-08-07;1335;1001;171932;144208;71.5;60.0
19;2021-08-08;187;234;172119;144442;71.6;60.1
19;2021-08-09;1009;784;173128;145226;72.0;60.4
19;2021-08-10;1280;1014;174408;146240;72.6;60.8
19;2021-08-11;1356;1006;175764;147246;73.1;61.3
19;2021-08-12;1016;1276;176780;148522;73.6;61.8
19;2021-08-13;1181;1275;177961;149797;74.0;62.3
19;2021-08-14;979;1165;178940;150962;74.5;62.8
19;2021-08-15;30;54;178970;151016;74.5;62.8
19;2021-08-16;592;1029;179562;152045;74.7;63.3
19;2021-08-17;633;1167;180195;153212;75.0;63.7
19;2021-08-18;656;979;180851;154191;75.2;64.2
19;2021-08-19;438;1258;181289;155449;75.4;64.7
19;2021-08-20;867;1927;182156;157376;75.8;65.5
19;2021-08-21;495;1376;182651;158752;76.0;66.1
19;2021-08-22;52;93;182703;158845;76.0;66.1
19;2021-08-23;226;1158;182929;160003;76.1;66.6
19;2021-08-24;538;1317;183467;161320;76.3;67.1
19;2021-08-25;649;1557;184116;162877;76.6;67.8
19;2021-08-26;477;1463;184593;164340;76.8;68.4
19;2021-08-27;501;1689;185094;166029;77.0;69.1
19;2021-08-28;360;1277;185454;167306;77.2;69.6
19;2021-08-29;60;182;185514;167488;77.2;69.7
19;2021-08-30;224;1089;185738;168577;77.3;70.1
19;2021-08-31;326;1352;186064;169929;77.4;70.7
19;2021-09-01;365;1433;186429;171362;77.6;71.3
19;2021-09-02;346;1193;186775;172555;77.7;71.8
19;2021-09-03;412;1423;187187;173978;77.9;72.4
19;2021-09-04;302;1361;187489;175339;78.0;73.0
19;2021-09-05;32;106;187521;175445;78.0;73.0
19;2021-09-06;197;630;187718;176075;78.1;73.3
19;2021-09-07;229;755;187947;176830;78.2;73.6
19;2021-09-08;287;741;188234;177571;78.3;73.9
19;2021-09-09;253;536;188487;178107;78.4;74.1
19;2021-09-10;252;708;188739;178815;78.5;74.4
19;2021-09-11;295;1055;189034;179870;78.7;74.8
19;2021-09-12;42;70;189076;179940;78.7;74.9
19;2021-09-13;106;245;189182;180185;78.7;75.0
19;2021-09-14;170;387;189352;180572;78.8;75.1
19;2021-09-15;245;670;189597;181242;78.9;75.4
19;2021-09-16;234;411;189831;181653;79.0;75.6
19;2021-09-17;255;531;190086;182184;79.1;75.8
19;2021-09-18;183;689;190269;182873;79.2;76.1
19;2021-09-19;17;34;190286;182907;79.2;76.1
19;2021-09-20;112;205;190398;183112;79.2;76.2
19;2021-09-21;143;295;190541;183407;79.3;76.3
19;2021-09-22;152;398;190693;183805;79.3;76.5
19;2021-09-23;87;300;190780;184105;79.4;76.6
19;2021-09-24;123;360;190903;184465;79.4;76.8
19;2021-09-25;140;568;191043;185033;79.5;77.0
19;2021-09-26;14;25;191057;185058;79.5;77.0
19;2021-09-27;43;215;191100;185273;79.5;77.1
19;2021-09-28;67;202;191167;185475;79.5;77.2
19;2021-09-29;82;341;191249;185816;79.6;77.3
19;2021-09-30;104;272;191353;186088;79.6;77.4
19;2021-10-01;115;233;191468;186321;79.7;77.5
19;2021-10-02;151;340;191619;186661;79.7;77.7
19;2021-10-03;9;11;191628;186672;79.7;77.7
19;2021-10-04;56;134;191684;186806;79.8;77.7
19;2021-10-05;100;187;191784;186993;79.8;77.8
19;2021-10-06;107;249;191891;187242;79.8;77.9
19;2021-10-07;65;242;191956;187484;79.9;78.0
19;2021-10-08;80;222;192036;187706;79.9;78.1
19;2021-10-09;146;276;192182;187982;80.0;78.2
19;2021-10-10;3;10;192185;187992;80.0;78.2
19;2021-10-11;54;164;192239;188156;80.0;78.3
21;2020-12-27;4;0;4;0;0.0;0.0
21;2020-12-28;2;0;6;0;0.0;0.0
21;2020-12-29;19;0;25;0;0.0;0.0
21;2020-12-30;22;0;47;0;0.0;0.0
21;2020-12-31;0;0;47;0;0.0;0.0
21;2021-01-01;0;0;47;0;0.0;0.0
21;2021-01-02;1;0;48;0;0.0;0.0
21;2021-01-03;1;0;49;0;0.0;0.0
21;2021-01-04;23;0;72;0;0.0;0.0
21;2021-01-05;250;2;322;2;0.1;0.0
21;2021-01-06;300;0;622;2;0.1;0.0
21;2021-01-07;389;1;1011;3;0.2;0.0
21;2021-01-08;455;2;1466;5;0.3;0.0
21;2021-01-09;252;0;1718;5;0.3;0.0
21;2021-01-10;2;1;1720;6;0.3;0.0
21;2021-01-11;624;1;2344;7;0.4;0.0
21;2021-01-12;655;0;2999;7;0.6;0.0
21;2021-01-13;706;2;3705;9;0.7;0.0
21;2021-01-14;1190;10;4895;19;0.9;0.0
21;2021-01-15;719;5;5614;24;1.1;0.0
21;2021-01-16;162;1;5776;25;1.1;0.0
21;2021-01-17;5;0;5781;25;1.1;0.0
21;2021-01-18;1318;7;7099;32;1.3;0.0
21;2021-01-19;1370;5;8469;37;1.6;0.0
21;2021-01-20;1300;49;9769;86;1.8;0.0
21;2021-01-21;1543;8;11312;94;2.1;0.0
21;2021-01-22;1246;5;12558;99;2.4;0.0
21;2021-01-23;490;1;13048;100;2.4;0.0
21;2021-01-24;124;0;13172;100;2.5;0.0
21;2021-01-25;928;20;14100;120;2.6;0.0
21;2021-01-26;1545;147;15645;267;2.9;0.1
21;2021-01-27;2061;172;17706;439;3.3;0.1
21;2021-01-28;1460;240;19166;679;3.6;0.1
21;2021-01-29;1022;212;20188;891;3.8;0.2
21;2021-01-30;470;32;20658;923;3.9;0.2
21;2021-01-31;97;3;20755;926;3.9;0.2
21;2021-02-01;453;287;21208;1213;4.0;0.2
21;2021-02-02;456;442;21664;1655;4.1;0.3
21;2021-02-03;446;284;22110;1939;4.1;0.4
21;2021-02-04;417;541;22527;2480;4.2;0.5
21;2021-02-05;489;526;23016;3006;4.3;0.6
21;2021-02-06;162;228;23178;3234;4.3;0.6
21;2021-02-07;2;2;23180;3236;4.3;0.6
21;2021-02-08;433;390;23613;3626;4.4;0.7
21;2021-02-09;516;524;24129;4150;4.5;0.8
21;2021-02-10;461;584;24590;4734;4.6;0.9
21;2021-02-11;486;750;25076;5484;4.7;1.0
21;2021-02-12;356;936;25432;6420;4.8;1.2
21;2021-02-13;365;325;25797;6745;4.8;1.3
21;2021-02-14;239;149;26036;6894;4.9;1.3
21;2021-02-15;120;1406;26156;8300;4.9;1.6
21;2021-02-16;207;1567;26363;9867;4.9;1.9
21;2021-02-17;403;1989;26766;11856;5.0;2.2
21;2021-02-18;604;1353;27370;13209;5.1;2.5
21;2021-02-19;218;1136;27588;14345;5.2;2.7
21;2021-02-20;121;425;27709;14770;5.2;2.8
21;2021-02-21;1;83;27710;14853;5.2;2.8
21;2021-02-22;84;773;27794;15626;5.2;2.9
21;2021-02-23;169;1039;27963;16665;5.2;3.1
21;2021-02-24;226;745;28189;17410;5.3;3.3
21;2021-02-25;647;831;28836;18241;5.4;3.4
21;2021-02-26;926;720;29762;18961;5.6;3.6
21;2021-02-27;532;300;30294;19261;5.7;3.6
21;2021-02-28;24;133;30318;19394;5.7;3.6
21;2021-03-01;680;630;30998;20024;5.8;3.8
21;2021-03-02;1055;556;32053;20580;6.0;3.9
21;2021-03-03;1169;449;33222;21029;6.2;3.9
21;2021-03-04;1689;522;34911;21551;6.6;4.0
21;2021-03-05;2196;668;37107;22219;7.0;4.2
21;2021-03-06;1595;202;38702;22421;7.3;4.2
21;2021-03-07;4;16;38706;22437;7.3;4.2
21;2021-03-08;773;449;39479;22886;7.4;4.3
21;2021-03-09;1572;577;41051;23463;7.7;4.4
21;2021-03-10;1627;565;42678;24028;8.0;4.5
21;2021-03-11;2197;705;44875;24733;8.4;4.6
21;2021-03-12;2904;442;47779;25175;9.0;4.7
21;2021-03-13;1932;190;49711;25365;9.3;4.8
21;2021-03-14;38;48;49749;25413;9.3;4.8
21;2021-03-15;1416;87;51165;25500;9.6;4.8
21;2021-03-16;1883;159;53048;25659;10.0;4.8
21;2021-03-17;1810;119;54858;25778;10.3;4.8
21;2021-03-18;2128;272;56986;26050;10.7;4.9
21;2021-03-19;1964;151;58950;26201;11.1;4.9
21;2021-03-20;1228;39;60178;26240;11.3;4.9
21;2021-03-21;2;0;60180;26240;11.3;4.9
21;2021-03-22;1556;93;61736;26333;11.6;4.9
21;2021-03-23;2696;109;64432;26442;12.1;5.0
21;2021-03-24;2896;165;67328;26607;12.6;5.0
21;2021-03-25;3731;249;71059;26856;13.3;5.0
21;2021-03-26;3655;207;74714;27063;14.0;5.1
21;2021-03-27;1732;62;76446;27125;14.3;5.1
21;2021-03-28;200;38;76646;27163;14.4;5.1
21;2021-03-29;1788;522;78434;27685;14.7;5.2
21;2021-03-30;2347;810;80781;28495;15.2;5.3
21;2021-03-31;2718;656;83499;29151;15.7;5.5
21;2021-04-01;2694;725;86193;29876;16.2;5.6
21;2021-04-02;2249;749;88442;30625;16.6;5.7
21;2021-04-03;1018;282;89460;30907;16.8;5.8
21;2021-04-04;2;12;89462;30919;16.8;5.8
21;2021-04-05;9;0;89471;30919;16.8;5.8
21;2021-04-06;1359;1140;90830;32059;17.0;6.0
21;2021-04-07;1750;970;92580;33029;17.4;6.2
21;2021-04-08;3217;1151;95797;34180;18.0;6.4
21;2021-04-09;3481;1190;99278;35370;18.6;6.6
21;2021-04-10;1375;749;100653;36119;18.9;6.8
21;2021-04-11;145;4;100798;36123;18.9;6.8
21;2021-04-12;1117;1348;101915;37471;19.1;7.0
21;2021-04-13;1655;1787;103570;39258;19.4;7.4
21;2021-04-14;1485;1475;105055;40733;19.7;7.6
21;2021-04-15;1899;1594;106954;42327;20.1;7.9
21;2021-04-16;2322;1316;109276;43643;20.5;8.2
21;2021-04-17;1020;977;110296;44620;20.7;8.4
21;2021-04-18;15;4;110311;44624;20.7;8.4
21;2021-04-19;1110;1323;111421;45947;20.9;8.6
21;2021-04-20;1244;1837;112665;47784;21.1;9.0
21;2021-04-21;1096;1723;113761;49507;21.3;9.3
21;2021-04-22;1275;2219;115036;51726;21.6;9.7
21;2021-04-23;1984;1732;117020;53458;22.0;10.0
21;2021-04-24;1001;874;118021;54332;22.1;10.2
21;2021-04-25;9;169;118030;54501;22.1;10.2
21;2021-04-26;1013;1598;119043;56099;22.3;10.5
21;2021-04-27;1843;1943;120886;58042;22.7;10.9
21;2021-04-28;2231;2231;123117;60273;23.1;11.3
21;2021-04-29;3135;2272;126252;62545;23.7;11.7
21;2021-04-30;3563;1866;129815;64411;24.4;12.1
21;2021-05-01;962;227;130777;64638;24.5;12.1
21;2021-05-02;2;5;130779;64643;24.5;12.1
21;2021-05-03;2081;1351;132860;65994;24.9;12.4
21;2021-05-04;2577;1651;135437;67645;25.4;12.7
21;2021-05-05;2247;1692;137684;69337;25.8;13.0
21;2021-05-06;3015;2251;140699;71588;26.4;13.4
21;2021-05-07;2805;2181;143504;73769;26.9;13.8
21;2021-05-08;1067;272;144571;74041;27.1;13.9
21;2021-05-09;26;177;144597;74218;27.1;13.9
21;2021-05-10;3169;1730;147766;75948;27.7;14.3
21;2021-05-11;4923;2006;152689;77954;28.7;14.6
21;2021-05-12;4805;1750;157494;79704;29.6;15.0
21;2021-05-13;3845;369;161339;80073;30.3;15.0
21;2021-05-14;5197;1472;166536;81545;31.3;15.3
21;2021-05-15;3428;647;169964;82192;31.9;15.4
21;2021-05-16;49;4;170013;82196;31.9;15.4
21;2021-05-17;4128;1259;174141;83455;32.7;15.7
21;2021-05-18;4359;1502;178500;84957;33.5;15.9
21;2021-05-19;3470;1128;181970;86085;34.1;16.2
21;2021-05-20;3898;1361;185868;87446;34.9;16.4
21;2021-05-21;3628;2157;189496;89603;35.6;16.8
21;2021-05-22;1669;771;191165;90374;35.9;17.0
21;2021-05-23;4;17;191169;90391;35.9;17.0
21;2021-05-24;1815;266;192984;90657;36.2;17.0
21;2021-05-25;2648;1963;195632;92620;36.7;17.4
21;2021-05-26;2604;2000;198236;94620;37.2;17.8
21;2021-05-27;4014;2099;202250;96719;38.0;18.2
21;2021-05-28;3572;2822;205822;99541;38.6;18.7
21;2021-05-29;1932;1469;207754;101010;39.0;19.0
21;2021-05-30;98;13;207852;101023;39.0;19.0
21;2021-05-31;2501;1780;210353;102803;39.5;19.3
21;2021-06-01;3449;2254;213802;105057;40.1;19.7
21;2021-06-02;2617;1762;216419;106819;40.6;20.0
21;2021-06-03;3146;2077;219565;108896;41.2;20.4
21;2021-06-04;3286;2591;222851;111487;41.8;20.9
21;2021-06-05;2922;1654;225773;113141;42.4;21.2
21;2021-06-06;51;85;225824;113226;42.4;21.2
21;2021-06-07;4314;1347;230138;114573;43.2;21.5
21;2021-06-08;4935;2146;235073;116719;44.1;21.9
21;2021-06-09;4500;1631;239573;118350;45.0;22.2
21;2021-06-10;3933;2596;243506;120946;45.7;22.7
21;2021-06-11;4164;3109;247670;124055;46.5;23.3
21;2021-06-12;2199;1608;249869;125663;46.9;23.6
21;2021-06-13;29;11;249898;125674;46.9;23.6
21;2021-06-14;2198;2565;252096;128239;47.3;24.1
21;2021-06-15;2958;3092;255054;131331;47.9;24.6
21;2021-06-16;2850;2612;257904;133943;48.4;25.1
21;2021-06-17;3422;3042;261326;136985;49.0;25.7
21;2021-06-18;2424;3802;263750;140787;49.5;26.4
21;2021-06-19;2045;1865;265795;142652;49.9;26.8
21;2021-06-20;26;13;265821;142665;49.9;26.8
21;2021-06-21;1840;3407;267661;146072;50.2;27.4
21;2021-06-22;1885;5829;269546;151901;50.6;28.5
21;2021-06-23;2030;5011;271576;156912;51.0;29.4
21;2021-06-24;2367;4666;273943;161578;51.4;30.3
21;2021-06-25;1530;5895;275473;167473;51.7;31.4
21;2021-06-26;1441;3899;276914;171372;52.0;32.2
21;2021-06-27;18;125;276932;171497;52.0;32.2
21;2021-06-28;1397;4017;278329;175514;52.2;32.9
21;2021-06-29;1633;4174;279962;179688;52.5;33.7
21;2021-06-30;1568;3372;281530;183060;52.8;34.4
21;2021-07-01;1663;4147;283193;187207;53.1;35.1
21;2021-07-02;2179;4231;285372;191438;53.6;35.9
21;2021-07-03;1096;2101;286468;193539;53.8;36.3
21;2021-07-04;37;55;286505;193594;53.8;36.3
21;2021-07-05;1611;3628;288116;197222;54.1;37.0
21;2021-07-06;1349;3583;289465;200805;54.3;37.7
21;2021-07-07;1455;3240;290920;204045;54.6;38.3
21;2021-07-08;1884;4160;292804;208205;54.9;39.1
21;2021-07-09;2081;4350;294885;212555;55.3;39.9
21;2021-07-10;1089;2547;295974;215102;55.5;40.4
21;2021-07-11;21;74;295995;215176;55.5;40.4
21;2021-07-12;1656;3727;297651;218903;55.9;41.1
21;2021-07-13;2343;4889;299994;223792;56.3;42.0
21;2021-07-14;2874;2017;302868;225809;56.8;42.4
21;2021-07-15;3814;4551;306682;230360;57.6;43.2
21;2021-07-16;3889;5254;310571;235614;58.3;44.2
21;2021-07-17;2775;4170;313346;239784;58.8;45.0
21;2021-07-18;157;82;313503;239866;58.8;45.0
21;2021-07-19;2375;4624;315878;244490;59.3;45.9
21;2021-07-20;2760;5487;318638;249977;59.8;46.9
21;2021-07-21;2908;4787;321546;254764;60.3;47.8
21;2021-07-22;3026;4721;324572;259485;60.9;48.7
21;2021-07-23;4352;4896;328924;264381;61.7;49.6
21;2021-07-24;3034;3020;331958;267401;62.3;50.2
21;2021-07-25;68;40;332026;267441;62.3;50.2
21;2021-07-26;2663;3590;334689;271031;62.8;50.9
21;2021-07-27;3412;3772;338101;274803;63.4;51.6
21;2021-07-28;3574;3354;341675;278157;64.1;52.2
21;2021-07-29;4135;3366;345810;281523;64.9;52.8
21;2021-07-30;4622;3353;350432;284876;65.8;53.5
21;2021-07-31;3427;2378;353859;287254;66.4;53.9
21;2021-08-01;331;57;354190;287311;66.5;53.9
21;2021-08-02;2540;3168;356730;290479;66.9;54.5
21;2021-08-03;2624;2761;359354;293240;67.4;55.0
21;2021-08-04;2364;2487;361718;295727;67.9;55.5
21;2021-08-05;2219;3078;363937;298805;68.3;56.1
21;2021-08-06;2591;3312;366528;302117;68.8;56.7
21;2021-08-07;1905;2660;368433;304777;69.1;57.2
21;2021-08-08;75;70;368508;304847;69.2;57.2
21;2021-08-09;1651;2930;370159;307777;69.5;57.8
21;2021-08-10;1413;2715;371572;310492;69.7;58.3
21;2021-08-11;1666;2446;373238;312938;70.0;58.7
21;2021-08-12;1176;2419;374414;315357;70.3;59.2
21;2021-08-13;1524;2747;375938;318104;70.5;59.7
21;2021-08-14;860;2435;376798;320539;70.7;60.2
21;2021-08-15;51;64;376849;320603;70.7;60.2
21;2021-08-16;1400;2823;378249;323426;71.0;60.7
21;2021-08-17;1205;2775;379454;326201;71.2;61.2
21;2021-08-18;1029;2872;380483;329073;71.4;61.8
21;2021-08-19;957;3068;381440;332141;71.6;62.3
21;2021-08-20;1064;4192;382504;336333;71.8;63.1
21;2021-08-21;844;3143;383348;339476;71.9;63.7
21;2021-08-22;35;117;383383;339593;71.9;63.7
21;2021-08-23;939;3220;384322;342813;72.1;64.3
21;2021-08-24;987;2877;385309;345690;72.3;64.9
21;2021-08-25;870;2551;386179;348241;72.5;65.3
21;2021-08-26;728;2427;386907;350668;72.6;65.8
21;2021-08-27;1034;3398;387941;354066;72.8;66.4
21;2021-08-28;711;2757;388652;356823;72.9;67.0
21;2021-08-29;48;215;388700;357038;72.9;67.0
21;2021-08-30;790;2214;389490;359252;73.1;67.4
21;2021-08-31;944;1989;390434;361241;73.3;67.8
21;2021-09-01;625;1613;391059;362854;73.4;68.1
21;2021-09-02;549;1213;391608;364067;73.5;68.3
21;2021-09-03;787;1714;392395;365781;73.6;68.6
21;2021-09-04;752;1445;393147;367226;73.8;68.9
21;2021-09-05;69;79;393216;367305;73.8;68.9
21;2021-09-06;410;1243;393626;368548;73.9;69.2
21;2021-09-07;392;1033;394018;369581;73.9;69.4
21;2021-09-08;554;1285;394572;370866;74.0;69.6
21;2021-09-09;400;933;394972;371799;74.1;69.8
21;2021-09-10;669;1390;395641;373189;74.2;70.0
21;2021-09-11;472;1300;396113;374489;74.3;70.3
21;2021-09-12;20;34;396133;374523;74.3;70.3
21;2021-09-13;254;702;396387;375225;74.4;70.4
21;2021-09-14;473;953;396860;376178;74.5;70.6
21;2021-09-15;486;905;397346;377083;74.6;70.8
21;2021-09-16;342;759;397688;377842;74.6;70.9
21;2021-09-17;555;1057;398243;378899;74.7;71.1
21;2021-09-18;327;1007;398570;379906;74.8;71.3
21;2021-09-19;5;21;398575;379927;74.8;71.3
21;2021-09-20;253;620;398828;380547;74.8;71.4
21;2021-09-21;366;664;399194;381211;74.9;71.5
21;2021-09-22;335;905;399529;382116;75.0;71.7
21;2021-09-23;273;522;399802;382638;75.0;71.8
21;2021-09-24;359;806;400161;383444;75.1;72.0
21;2021-09-25;215;866;400376;384310;75.1;72.1
21;2021-09-26;6;21;400382;384331;75.1;72.1
21;2021-09-27;242;447;400624;384778;75.2;72.2
21;2021-09-28;210;488;400834;385266;75.2;72.3
21;2021-09-29;245;535;401079;385801;75.3;72.4
21;2021-09-30;290;404;401369;386205;75.3;72.5
21;2021-10-01;362;833;401731;387038;75.4;72.6
21;2021-10-02;223;574;401954;387612;75.4;72.7
21;2021-10-03;6;22;401960;387634;75.4;72.7
21;2021-10-04;196;330;402156;387964;75.5;72.8
21;2021-10-05;153;461;402309;388425;75.5;72.9
21;2021-10-06;240;508;402549;388933;75.5;73.0
21;2021-10-07;136;330;402685;389263;75.6;73.0
21;2021-10-08;380;737;403065;390000;75.6;73.2
21;2021-10-09;249;441;403314;390441;75.7;73.3
21;2021-10-10;4;14;403318;390455;75.7;73.3
21;2021-10-11;132;313;403450;390768;75.7;73.3
22;2020-12-27;0;0;0;0;0.0;0.0
22;2020-12-28;0;0;0;0;0.0;0.0
22;2020-12-29;0;0;0;0;0.0;0.0
22;2020-12-30;0;0;0;0;0.0;0.0
22;2020-12-31;0;0;0;0;0.0;0.0
22;2021-01-01;0;0;0;0;0.0;0.0
22;2021-01-02;2;0;2;0;0.0;0.0
22;2021-01-03;0;0;2;0;0.0;0.0
22;2021-01-04;5;0;7;0;0.0;0.0
22;2021-01-05;61;0;68;0;0.0;0.0
22;2021-01-06;114;1;182;1;0.0;0.0
22;2021-01-07;67;0;249;1;0.0;0.0
22;2021-01-08;174;0;423;1;0.1;0.0
22;2021-01-09;1;0;424;1;0.1;0.0
22;2021-01-10;0;0;424;1;0.1;0.0
22;2021-01-11;234;3;658;4;0.1;0.0
22;2021-01-12;627;0;1285;4;0.2;0.0
22;2021-01-13;677;1;1962;5;0.3;0.0
22;2021-01-14;717;8;2679;13;0.4;0.0
22;2021-01-15;529;2;3208;15;0.5;0.0
22;2021-01-16;96;0;3304;15;0.6;0.0
22;2021-01-17;1;0;3305;15;0.6;0.0
22;2021-01-18;312;2;3617;17;0.6;0.0
22;2021-01-19;686;1;4303;18;0.7;0.0
22;2021-01-20;598;1;4901;19;0.8;0.0
22;2021-01-21;947;2;5848;21;1.0;0.0
22;2021-01-22;840;2;6688;23;1.1;0.0
22;2021-01-23;219;0;6907;23;1.2;0.0
22;2021-01-24;2;0;6909;23;1.2;0.0
22;2021-01-25;751;11;7660;34;1.3;0.0
22;2021-01-26;1018;59;8678;93;1.5;0.0
22;2021-01-27;3858;118;12536;211;2.1;0.0
22;2021-01-28;4511;89;17047;300;2.9;0.1
22;2021-01-29;1898;130;18945;430;3.2;0.1
22;2021-01-30;289;0;19234;430;3.2;0.1
22;2021-01-31;3;0;19237;430;3.2;0.1
22;2021-02-01;642;81;19879;511;3.3;0.1
22;2021-02-02;903;436;20782;947;3.5;0.2
22;2021-02-03;691;503;21473;1450;3.6;0.2
22;2021-02-04;964;639;22437;2089;3.8;0.4
22;2021-02-05;723;565;23160;2654;3.9;0.4
22;2021-02-06;256;2;23416;2656;3.9;0.4
22;2021-02-07;0;0;23416;2656;3.9;0.4
22;2021-02-08;531;134;23947;2790;4.0;0.5
22;2021-02-09;614;347;24561;3137;4.1;0.5
22;2021-02-10;425;201;24986;3338;4.2;0.6
22;2021-02-11;1085;325;26071;3663;4.4;0.6
22;2021-02-12;595;329;26666;3992;4.5;0.7
22;2021-02-13;319;78;26985;4070;4.5;0.7
22;2021-02-14;0;5;26985;4075;4.5;0.7
22;2021-02-15;672;430;27657;4505;4.6;0.8
22;2021-02-16;1042;702;28699;5207;4.8;0.9
22;2021-02-17;1203;2457;29902;7664;5.0;1.3
22;2021-02-18;2147;3009;32049;10673;5.4;1.8
22;2021-02-19;1637;1947;33686;12620;5.7;2.1
22;2021-02-20;480;214;34166;12834;5.7;2.2
22;2021-02-21;7;49;34173;12883;5.7;2.2
22;2021-02-22;401;718;34574;13601;5.8;2.3
22;2021-02-23;665;934;35239;14535;5.9;2.4
22;2021-02-24;695;947;35934;15482;6.0;2.6
22;2021-02-25;1200;1202;37134;16684;6.2;2.8
22;2021-02-26;1066;710;38200;17394;6.4;2.9
22;2021-02-27;564;285;38764;17679;6.5;3.0
22;2021-02-28;16;8;38780;17687;6.5;3.0
22;2021-03-01;958;524;39738;18211;6.7;3.1
22;2021-03-02;1208;879;40946;19090;6.9;3.2
22;2021-03-03;1325;865;42271;19955;7.1;3.3
22;2021-03-04;1602;935;43873;20890;7.4;3.5
22;2021-03-05;2109;808;45982;21698;7.7;3.6
22;2021-03-06;1114;302;47096;22000;7.9;3.7
22;2021-03-07;219;1;47315;22001;7.9;3.7
22;2021-03-08;1291;662;48606;22663;8.2;3.8
22;2021-03-09;1824;756;50430;23419;8.5;3.9
22;2021-03-10;1988;1006;52418;24425;8.8;4.1
22;2021-03-11;2375;1661;54793;26086;9.2;4.4
22;2021-03-12;3101;968;57894;27054;9.7;4.5
22;2021-03-13;1722;296;59616;27350;10.0;4.6
22;2021-03-14;245;25;59861;27375;10.0;4.6
22;2021-03-15;1620;570;61481;27945;10.3;4.7
22;2021-03-16;1603;858;63084;28803;10.6;4.8
22;2021-03-17;2651;708;65735;29511;11.0;4.9
22;2021-03-18;2553;1109;68288;30620;11.5;5.1
22;2021-03-19;3281;803;71569;31423;12.0;5.3
22;2021-03-20;2208;288;73777;31711;12.4;5.3
22;2021-03-21;16;0;73793;31711;12.4;5.3
22;2021-03-22;2363;367;76156;32078;12.8;5.4
22;2021-03-23;3142;787;79298;32865;13.3;5.5
22;2021-03-24;3485;692;82783;33557;13.9;5.6
22;2021-03-25;3961;610;86744;34167;14.5;5.7
22;2021-03-26;4003;491;90747;34658;15.2;5.8
22;2021-03-27;2092;183;92839;34841;15.6;5.8
22;2021-03-28;67;1;92906;34842;15.6;5.8
22;2021-03-29;2766;914;95672;35756;16.0;6.0
22;2021-03-30;3567;1159;99239;36915;16.6;6.2
22;2021-03-31;3673;1091;102912;38006;17.3;6.4
22;2021-04-01;4943;1135;107855;39141;18.1;6.6
22;2021-04-02;4391;1042;112246;40183;18.8;6.7
22;2021-04-03;1998;404;114244;40587;19.2;6.8
22;2021-04-04;37;0;114281;40587;19.2;6.8
22;2021-04-05;15;0;114296;40587;19.2;6.8
22;2021-04-06;3288;1142;117584;41729;19.7;7.0
22;2021-04-07;3429;1376;121013;43105;20.3;7.2
22;2021-04-08;4446;1327;125459;44432;21.0;7.5
22;2021-04-09;5183;1368;130642;45800;21.9;7.7
22;2021-04-10;2447;371;133089;46171;22.3;7.7
22;2021-04-11;485;10;133574;46181;22.4;7.7
22;2021-04-12;2988;1013;136562;47194;22.9;7.9
22;2021-04-13;3318;1520;139880;48714;23.5;8.2
22;2021-04-14;3166;2492;143046;51206;24.0;8.6
22;2021-04-15;3599;2437;146645;53643;24.6;9.0
22;2021-04-16;3633;2494;150278;56137;25.2;9.4
22;2021-04-17;1920;1794;152198;57931;25.5;9.7
22;2021-04-18;17;0;152215;57931;25.5;9.7
22;2021-04-19;3022;2151;155237;60082;26.0;10.1
22;2021-04-20;3310;2799;158547;62881;26.6;10.5
22;2021-04-21;3223;2741;161770;65622;27.1;11.0
22;2021-04-22;3593;3139;165363;68761;27.7;11.5
22;2021-04-23;3727;3177;169090;71938;28.4;12.1
22;2021-04-24;2005;1967;171095;73905;28.7;12.4
22;2021-04-25;17;0;171112;73905;28.7;12.4
22;2021-04-26;3213;2858;174325;76763;29.2;12.9
22;2021-04-27;3371;3146;177696;79909;29.8;13.4
22;2021-04-28;3488;3159;181184;83068;30.4;13.9
22;2021-04-29;4080;3277;185264;86345;31.1;14.5
22;2021-04-30;3905;3229;189169;89574;31.7;15.0
22;2021-05-01;60;69;189229;89643;31.7;15.0
22;2021-05-02;1237;59;190466;89702;31.9;15.0
22;2021-05-03;2029;2714;192495;92416;32.3;15.5
22;2021-05-04;2155;2899;194650;95315;32.6;16.0
22;2021-05-05;2049;3006;196699;98321;33.0;16.5
22;2021-05-06;2508;3498;199207;101819;33.4;17.1
22;2021-05-07;2829;3408;202036;105227;33.9;17.7
22;2021-05-08;45;121;202081;105348;33.9;17.7
22;2021-05-09;602;438;202683;105786;34.0;17.7
22;2021-05-10;4473;2733;207156;108519;34.7;18.2
22;2021-05-11;5106;2903;212262;111422;35.6;18.7
22;2021-05-12;6599;1025;218861;112447;36.7;18.9
22;2021-05-13;528;35;219389;112482;36.8;18.9
22;2021-05-14;6407;1089;225796;113571;37.9;19.0
22;2021-05-15;3988;429;229784;114000;38.5;19.1
22;2021-05-16;419;37;230203;114037;38.6;19.1
22;2021-05-17;5668;521;235871;114558;39.6;19.2
22;2021-05-18;6011;955;241882;115513;40.6;19.4
22;2021-05-19;6131;711;248013;116224;41.6;19.5
22;2021-05-20;6587;1375;254600;117599;42.7;19.7
22;2021-05-21;5899;1455;260499;119054;43.7;20.0
22;2021-05-22;4093;772;264592;119826;44.4;20.1
22;2021-05-23;407;17;264999;119843;44.4;20.1
22;2021-05-24;5315;226;270314;120069;45.3;20.1
22;2021-05-25;5638;1180;275952;121249;46.3;20.3
22;2021-05-26;4226;2811;280178;124060;47.0;20.8
22;2021-05-27;4504;3841;284682;127901;47.8;21.5
22;2021-05-28;4384;4436;289066;132337;48.5;22.2
22;2021-05-29;3046;1771;292112;134108;49.0;22.5
22;2021-05-30;19;7;292131;134115;49.0;22.5
22;2021-05-31;3653;3155;295784;137270;49.6;23.0
22;2021-06-01;3520;3690;299304;140960;50.2;23.6
22;2021-06-02;3085;3387;302389;144347;50.7;24.2
22;2021-06-03;3196;4099;305585;148446;51.3;24.9
22;2021-06-04;3371;4540;308956;152986;51.8;25.7
22;2021-06-05;3543;2027;312499;155013;52.4;26.0
22;2021-06-06;214;30;312713;155043;52.5;26.0
22;2021-06-07;3042;3256;315755;158299;53.0;26.6
22;2021-06-08;2798;3530;318553;161829;53.4;27.1
22;2021-06-09;2543;3506;321096;165335;53.9;27.7
22;2021-06-10;2516;4249;323612;169584;54.3;28.4
22;2021-06-11;2551;4227;326163;173811;54.7;29.2
22;2021-06-12;2411;1454;328574;175265;55.1;29.4
22;2021-06-13;134;1093;328708;176358;55.1;29.6
22;2021-06-14;2644;2470;331352;178828;55.6;30.0
22;2021-06-15;3095;2996;334447;181824;56.1;30.5
22;2021-06-16;3008;2812;337455;184636;56.6;31.0
22;2021-06-17;2560;3182;340015;187818;57.0;31.5
22;2021-06-18;3102;4116;343117;191934;57.6;32.2
22;2021-06-19;2984;1455;346101;193389;58.1;32.4
22;2021-06-20;157;8;346258;193397;58.1;32.4
22;2021-06-21;1783;5021;348041;198418;58.4;33.3
22;2021-06-22;2403;5554;350444;203972;58.8;34.2
22;2021-06-23;1285;6203;351729;210175;59.0;35.3
22;2021-06-24;2578;3912;354307;214087;59.4;35.9
22;2021-06-25;1568;6812;355875;220899;59.7;37.1
22;2021-06-26;783;3853;356658;224752;59.8;37.7
22;2021-06-27;4;511;356662;225263;59.8;37.8
22;2021-06-28;1051;5586;357713;230849;60.0;38.7
22;2021-06-29;1375;5954;359088;236803;60.2;39.7
22;2021-06-30;1129;5738;360217;242541;60.4;40.7
22;2021-07-01;1383;6037;361600;248578;60.7;41.7
22;2021-07-02;1708;6094;363308;254672;60.9;42.7
22;2021-07-03;1009;3819;364317;258491;61.1;43.4
22;2021-07-04;149;365;364466;258856;61.1;43.4
22;2021-07-05;1598;5804;366064;264660;61.4;44.4
22;2021-07-06;2312;5992;368376;270652;61.8;45.4
22;2021-07-07;2292;4933;370668;275585;62.2;46.2
22;2021-07-08;2503;5097;373171;280682;62.6;47.1
22;2021-07-09;2496;5386;375667;286068;63.0;48.0
22;2021-07-10;1808;3359;377475;289427;63.3;48.5
22;2021-07-11;484;75;377959;289502;63.4;48.6
22;2021-07-12;2334;4733;380293;294235;63.8;49.4
22;2021-07-13;3782;5055;384075;299290;64.4;50.2
22;2021-07-14;700;2490;384775;301780;64.5;50.6
22;2021-07-15;3871;4622;388646;306402;65.2;51.4
22;2021-07-16;3835;5293;392481;311695;65.8;52.3
22;2021-07-17;2558;3411;395039;315106;66.3;52.9
22;2021-07-18;570;88;395609;315194;66.4;52.9
22;2021-07-19;2773;4104;398382;319298;66.8;53.6
22;2021-07-20;3923;4133;402305;323431;67.5;54.3
22;2021-07-21;3999;3420;406304;326851;68.2;54.8
22;2021-07-22;4861;3707;411165;330558;69.0;55.4
22;2021-07-23;4452;4220;415617;334778;69.7;56.2
22;2021-07-24;2260;2616;417877;337394;70.1;56.6
22;2021-07-25;118;150;417995;337544;70.1;56.6
22;2021-07-26;3021;3921;421016;341465;70.6;57.3
22;2021-07-27;3728;4918;424744;346383;71.2;58.1
22;2021-07-28;3705;3662;428449;350045;71.9;58.7
22;2021-07-29;4294;3779;432743;353824;72.6;59.3
22;2021-07-30;4039;3978;436782;357802;73.3;60.0
22;2021-07-31;2402;2806;439184;360608;73.7;60.5
22;2021-08-01;118;150;439302;360758;73.7;60.5
22;2021-08-02;4670;2552;443972;363310;74.5;60.9
22;2021-08-03;4787;3427;448759;366737;75.3;61.5
22;2021-08-04;5774;2499;454533;369236;76.2;61.9
22;2021-08-05;4128;3803;458661;373039;76.9;62.6
22;2021-08-06;3654;3811;462315;376850;77.5;63.2
22;2021-08-07;2355;2269;464670;379119;77.9;63.6
22;2021-08-08;427;71;465097;379190;78.0;63.6
22;2021-08-09;2722;2708;467819;381898;78.5;64.1
22;2021-08-10;2735;3513;470554;385411;78.9;64.6
22;2021-08-11;2428;3114;472982;388525;79.3;65.2
22;2021-08-12;2215;3478;475197;392003;79.7;65.8
22;2021-08-13;1938;2972;477135;394975;80.0;66.3
22;2021-08-14;1343;1911;478478;396886;80.3;66.6
22;2021-08-15;87;199;478565;397085;80.3;66.6
22;2021-08-16;1470;3177;480035;400262;80.5;67.1
22;2021-08-17;1757;3459;481792;403721;80.8;67.7
22;2021-08-18;1406;3302;483198;407023;81.0;68.3
22;2021-08-19;1350;3609;484548;410632;81.3;68.9
22;2021-08-20;1462;3605;486010;414237;81.5;69.5
22;2021-08-21;814;2261;486824;416498;81.7;69.9
22;2021-08-22;151;308;486975;416806;81.7;69.9
22;2021-08-23;1967;3609;488942;420415;82.0;70.5
22;2021-08-24;1432;3246;490374;423661;82.3;71.1
22;2021-08-25;844;2507;491218;426168;82.4;71.5
22;2021-08-26;1055;4294;492273;430462;82.6;72.2
22;2021-08-27;1326;4602;493599;435064;82.8;73.0
22;2021-08-28;737;2517;494336;437581;82.9;73.4
22;2021-08-29;35;26;494371;437607;82.9;73.4
22;2021-08-30;925;2925;495296;440532;83.1;73.9
22;2021-08-31;968;3740;496264;444272;83.2;74.5
22;2021-09-01;971;3252;497235;447524;83.4;75.1
22;2021-09-02;839;2833;498074;450357;83.5;75.5
22;2021-09-03;943;2767;499017;453124;83.7;76.0
22;2021-09-04;783;2606;499800;455730;83.8;76.4
22;2021-09-05;97;28;499897;455758;83.8;76.4
22;2021-09-06;491;1862;500388;457620;83.9;76.8
22;2021-09-07;515;2014;500903;459634;84.0;77.1
22;2021-09-08;634;1879;501537;461513;84.1;77.4
22;2021-09-09;679;1924;502216;463437;84.2;77.7
22;2021-09-10;706;2121;502922;465558;84.4;78.1
22;2021-09-11;585;1693;503507;467251;84.5;78.4
22;2021-09-12;31;81;503538;467332;84.5;78.4
22;2021-09-13;486;2097;504024;469429;84.5;78.7
22;2021-09-14;592;1572;504616;471001;84.6;79.0
22;2021-09-15;462;1703;505078;472704;84.7;79.3
22;2021-09-16;551;1042;505629;473746;84.8;79.5
22;2021-09-17;626;1631;506255;475377;84.9;79.7
22;2021-09-18;283;2161;506538;477538;85.0;80.1
22;2021-09-19;1;8;506539;477546;85.0;80.1
22;2021-09-20;363;709;506902;478255;85.0;80.2
22;2021-09-21;363;956;507265;479211;85.1;80.4
22;2021-09-22;298;1160;507563;480371;85.1;80.6
22;2021-09-23;405;720;507968;481091;85.2;80.7
22;2021-09-24;362;1099;508330;482190;85.3;80.9
22;2021-09-25;219;1386;508549;483576;85.3;81.1
22;2021-09-26;12;70;508561;483646;85.3;81.1
22;2021-09-27;336;744;508897;484390;85.4;81.2
22;2021-09-28;203;576;509100;484966;85.4;81.3
22;2021-09-29;232;887;509332;485853;85.4;81.5
22;2021-09-30;271;740;509603;486593;85.5;81.6
22;2021-10-01;278;777;509881;487370;85.5;81.7
22;2021-10-02;332;915;510213;488285;85.6;81.9
22;2021-10-03;0;0;510213;488285;85.6;81.9
22;2021-10-04;118;426;510331;488711;85.6;82.0
22;2021-10-05;220;644;510551;489355;85.6;82.1
22;2021-10-06;224;369;510775;489724;85.7;82.1
22;2021-10-07;243;688;511018;490412;85.7;82.3
22;2021-10-08;316;774;511334;491186;85.8;82.4
22;2021-10-09;239;461;511573;491647;85.8;82.5
22;2021-10-10;4;8;511577;491655;85.8;82.5
22;2021-10-11;130;260;511707;491915;85.8;82.5
23;2020-12-27;0;0;0;0;0.0;0.0
23;2020-12-28;2;0;2;0;0.0;0.0
23;2020-12-29;0;0;2;0;0.0;0.0
23;2020-12-30;0;0;2;0;0.0;0.0
23;2020-12-31;0;0;2;0;0.0;0.0
23;2021-01-01;0;0;2;0;0.0;0.0
23;2021-01-02;1;0;3;0;0.0;0.0
23;2021-01-03;1;1;4;1;0.0;0.0
23;2021-01-04;1;0;5;1;0.0;0.0
23;2021-01-05;3;0;8;1;0.0;0.0
23;2021-01-06;10;0;18;1;0.0;0.0
23;2021-01-07;116;1;134;2;0.1;0.0
23;2021-01-08;117;0;251;2;0.2;0.0
23;2021-01-09;36;0;287;2;0.2;0.0
23;2021-01-10;1;0;288;2;0.2;0.0
23;2021-01-11;176;2;464;4;0.4;0.0
23;2021-01-12;237;6;701;10;0.6;0.0
23;2021-01-13;310;0;1011;10;0.9;0.0
23;2021-01-14;293;5;1304;15;1.1;0.0
23;2021-01-15;334;5;1638;20;1.4;0.0
23;2021-01-16;163;1;1801;21;1.5;0.0
23;2021-01-17;0;0;1801;21;1.5;0.0
23;2021-01-18;342;3;2143;24;1.8;0.0
23;2021-01-19;498;2;2641;26;2.3;0.0
23;2021-01-20;363;1;3004;27;2.6;0.0
23;2021-01-21;700;1;3704;28;3.2;0.0
23;2021-01-22;481;0;4185;28;3.6;0.0
23;2021-01-23;368;1;4553;29;3.9;0.0
23;2021-01-24;0;0;4553;29;3.9;0.0
23;2021-01-25;382;17;4935;46;4.2;0.0
23;2021-01-26;301;5;5236;51;4.5;0.0
23;2021-01-27;227;3;5463;54;4.7;0.0
23;2021-01-28;232;45;5695;99;4.9;0.1
23;2021-01-29;304;104;5999;203;5.2;0.2
23;2021-01-30;100;28;6099;231;5.2;0.2
23;2021-01-31;2;33;6101;264;5.2;0.2
23;2021-02-01;148;105;6249;369;5.4;0.3
23;2021-02-02;157;123;6406;492;5.5;0.4
23;2021-02-03;105;207;6511;699;5.6;0.6
23;2021-02-04;77;263;6588;962;5.7;0.8
23;2021-02-05;117;312;6705;1274;5.8;1.1
23;2021-02-06;14;167;6719;1441;5.8;1.2
23;2021-02-07;1;0;6720;1441;5.8;1.2
23;2021-02-08;123;216;6843;1657;5.9;1.4
23;2021-02-09;89;298;6932;1955;6.0;1.7
23;2021-02-10;92;281;7024;2236;6.0;1.9
23;2021-02-11;246;588;7270;2824;6.3;2.4
23;2021-02-12;174;284;7444;3108;6.4;2.7
23;2021-02-13;8;191;7452;3299;6.4;2.8
23;2021-02-14;8;0;7460;3299;6.4;2.8
23;2021-02-15;157;366;7617;3665;6.6;3.2
23;2021-02-16;103;439;7720;4104;6.6;3.5
23;2021-02-17;65;490;7785;4594;6.7;4.0
23;2021-02-18;142;368;7927;4962;6.8;4.3
23;2021-02-19;109;254;8036;5216;6.9;4.5
23;2021-02-20;2;93;8038;5309;6.9;4.6
23;2021-02-21;0;0;8038;5309;6.9;4.6
23;2021-02-22;104;212;8142;5521;7.0;4.7
23;2021-02-23;108;218;8250;5739;7.1;4.9
23;2021-02-24;176;168;8426;5907;7.2;5.1
23;2021-02-25;184;110;8610;6017;7.4;5.2
23;2021-02-26;287;168;8897;6185;7.7;5.3
23;2021-02-27;112;11;9009;6196;7.7;5.3
23;2021-02-28;1;31;9010;6227;7.7;5.4
23;2021-03-01;88;201;9098;6428;7.8;5.5
23;2021-03-02;229;132;9327;6560;8.0;5.6
23;2021-03-03;133;90;9460;6650;8.1;5.7
23;2021-03-04;307;138;9767;6788;8.4;5.8
23;2021-03-05;517;111;10284;6899;8.8;5.9
23;2021-03-06;495;7;10779;6906;9.3;5.9
23;2021-03-07;313;3;11092;6909;9.5;5.9
23;2021-03-08;197;73;11289;6982;9.7;6.0
23;2021-03-09;421;103;11710;7085;10.1;6.1
23;2021-03-10;349;39;12059;7124;10.4;6.1
23;2021-03-11;324;48;12383;7172;10.7;6.2
23;2021-03-12;621;35;13004;7207;11.2;6.2
23;2021-03-13;288;12;13292;7219;11.4;6.2
23;2021-03-14;47;34;13339;7253;11.5;6.2
23;2021-03-15;220;125;13559;7378;11.7;6.3
23;2021-03-16;192;91;13751;7469;11.8;6.4
23;2021-03-17;131;101;13882;7570;11.9;6.5
23;2021-03-18;192;99;14074;7669;12.1;6.6
23;2021-03-19;208;123;14282;7792;12.3;6.7
23;2021-03-20;631;37;14913;7829;12.8;6.7
23;2021-03-21;128;0;15041;7829;12.9;6.7
23;2021-03-22;274;157;15315;7986;13.2;6.9
23;2021-03-23;504;104;15819;8090;13.6;7.0
23;2021-03-24;422;124;16241;8214;14.0;7.1
23;2021-03-25;821;190;17062;8404;14.7;7.2
23;2021-03-26;735;195;17797;8599;15.3;7.4
23;2021-03-27;507;50;18304;8649;15.7;7.4
23;2021-03-28;3;9;18307;8658;15.7;7.4
23;2021-03-29;358;111;18665;8769;16.1;7.5
23;2021-03-30;537;178;19202;8947;16.5;7.7
23;2021-03-31;411;175;19613;9122;16.9;7.8
23;2021-04-01;600;175;20213;9297;17.4;8.0
23;2021-04-02;498;299;20711;9596;17.8;8.3
23;2021-04-03;715;44;21426;9640;18.4;8.3
23;2021-04-04;4;0;21430;9640;18.4;8.3
23;2021-04-05;2;3;21432;9643;18.4;8.3
23;2021-04-06;382;293;21814;9936;18.8;8.5
23;2021-04-07;706;310;22520;10246;19.4;8.8
23;2021-04-08;805;239;23325;10485;20.1;9.0
23;2021-04-09;940;370;24265;10855;20.9;9.3
23;2021-04-10;1097;111;25362;10966;21.8;9.4
23;2021-04-11;21;2;25383;10968;21.8;9.4
23;2021-04-12;692;236;26075;11204;22.4;9.6
23;2021-04-13;670;303;26745;11507;23.0;9.9
23;2021-04-14;586;178;27331;11685;23.5;10.0
23;2021-04-15;929;186;28260;11871;24.3;10.2
23;2021-04-16;905;218;29165;12089;25.1;10.4
23;2021-04-17;996;555;30161;12644;25.9;10.9
23;2021-04-18;3;136;30164;12780;25.9;11.0
23;2021-04-19;613;297;30777;13077;26.5;11.2
23;2021-04-20;720;297;31497;13374;27.1;11.5
23;2021-04-21;733;397;32230;13771;27.7;11.8
23;2021-04-22;655;474;32885;14245;28.3;12.3
23;2021-04-23;596;347;33481;14592;28.8;12.6
23;2021-04-24;855;450;34336;15042;29.5;12.9
23;2021-04-25;0;0;34336;15042;29.5;12.9
23;2021-04-26;615;255;34951;15297;30.1;13.2
23;2021-04-27;675;429;35626;15726;30.6;13.5
23;2021-04-28;628;277;36254;16003;31.2;13.8
23;2021-04-29;883;379;37137;16382;31.9;14.1
23;2021-04-30;719;787;37856;17169;32.6;14.8
23;2021-05-01;1229;44;39085;17213;33.6;14.8
23;2021-05-02;14;0;39099;17213;33.6;14.8
23;2021-05-03;430;522;39529;17735;34.0;15.3
23;2021-05-04;617;513;40146;18248;34.5;15.7
23;2021-05-05;540;714;40686;18962;35.0;16.3
23;2021-05-06;728;702;41414;19664;35.6;16.9
23;2021-05-07;685;645;42099;20309;36.2;17.5
23;2021-05-08;1411;589;43510;20898;37.4;18.0
23;2021-05-09;4;1;43514;20899;37.4;18.0
23;2021-05-10;555;656;44069;21555;37.9;18.5
23;2021-05-11;560;765;44629;22320;38.4;19.2
23;2021-05-12;720;662;45349;22982;39.0;19.8
23;2021-05-13;538;56;45887;23038;39.5;19.8
23;2021-05-14;787;458;46674;23496;40.1;20.2
23;2021-05-15;995;235;47669;23731;41.0;20.4
23;2021-05-16;0;0;47669;23731;41.0;20.4
23;2021-05-17;566;448;48235;24179;41.5;20.8
23;2021-05-18;777;292;49012;24471;42.2;21.0
23;2021-05-19;1051;259;50063;24730;43.1;21.3
23;2021-05-20;838;314;50901;25044;43.8;21.5
23;2021-05-21;1108;311;52009;25355;44.7;21.8
23;2021-05-22;740;125;52749;25480;45.4;21.9
23;2021-05-23;3;20;52752;25500;45.4;21.9
23;2021-05-24;363;166;53115;25666;45.7;22.1
23;2021-05-25;908;336;54023;26002;46.5;22.4
23;2021-05-26;1077;227;55100;26229;47.4;22.6
23;2021-05-27;931;437;56031;26666;48.2;22.9
23;2021-05-28;781;744;56812;27410;48.9;23.6
23;2021-05-29;638;1102;57450;28512;49.4;24.5
23;2021-05-30;6;63;57456;28575;49.4;24.6
23;2021-05-31;433;541;57889;29116;49.8;25.0
23;2021-06-01;582;827;58471;29943;50.3;25.8
23;2021-06-02;624;520;59095;30463;50.8;26.2
23;2021-06-03;708;552;59803;31015;51.4;26.7
23;2021-06-04;778;614;60581;31629;52.1;27.2
23;2021-06-05;543;777;61124;32406;52.6;27.9
23;2021-06-06;0;0;61124;32406;52.6;27.9
23;2021-06-07;393;697;61517;33103;52.9;28.5
23;2021-06-08;323;776;61840;33879;53.2;29.1
23;2021-06-09;287;648;62127;34527;53.4;29.7
23;2021-06-10;374;692;62501;35219;53.8;30.3
23;2021-06-11;384;808;62885;36027;54.1;31.0
23;2021-06-12;376;1265;63261;37292;54.4;32.1
23;2021-06-13;13;5;63274;37297;54.4;32.1
23;2021-06-14;236;589;63510;37886;54.6;32.6
23;2021-06-15;229;861;63739;38747;54.8;33.3
23;2021-06-16;362;579;64101;39326;55.1;33.8
23;2021-06-17;339;810;64440;40136;55.4;34.5
23;2021-06-18;356;767;64796;40903;55.7;35.2
23;2021-06-19;493;1523;65289;42426;56.2;36.5
23;2021-06-20;2;11;65291;42437;56.2;36.5
23;2021-06-21;205;620;65496;43057;56.3;37.0
23;2021-06-22;216;687;65712;43744;56.5;37.6
23;2021-06-23;221;750;65933;44494;56.7;38.3
23;2021-06-24;200;606;66133;45100;56.9;38.8
23;2021-06-25;302;816;66435;45916;57.1;39.5
23;2021-06-26;221;999;66656;46915;57.3;40.4
23;2021-06-27;3;0;66659;46915;57.3;40.4
23;2021-06-28;115;690;66774;47605;57.4;40.9
23;2021-06-29;189;823;66963;48428;57.6;41.7
23;2021-06-30;169;944;67132;49372;57.7;42.5
23;2021-07-01;168;870;67300;50242;57.9;43.2
23;2021-07-02;192;1069;67492;51311;58.0;44.1
23;2021-07-03;250;979;67742;52290;58.3;45.0
23;2021-07-04;1;0;67743;52290;58.3;45.0
23;2021-07-05;160;804;67903;53094;58.4;45.7
23;2021-07-06;215;1043;68118;54137;58.6;46.6
23;2021-07-07;211;853;68329;54990;58.8;47.3
23;2021-07-08;254;740;68583;55730;59.0;47.9
23;2021-07-09;275;1012;68858;56742;59.2;48.8
23;2021-07-10;234;644;69092;57386;59.4;49.4
23;2021-07-11;0;0;69092;57386;59.4;49.4
23;2021-07-12;232;702;69324;58088;59.6;50.0
23;2021-07-13;471;917;69795;59005;60.0;50.7
23;2021-07-14;212;320;70007;59325;60.2;51.0
23;2021-07-15;483;810;70490;60135;60.6;51.7
23;2021-07-16;764;568;71254;60703;61.3;52.2
23;2021-07-17;220;478;71474;61181;61.5;52.6
23;2021-07-18;0;1;71474;61182;61.5;52.6
23;2021-07-19;704;630;72178;61812;62.1;53.2
23;2021-07-20;633;569;72811;62381;62.6;53.7
23;2021-07-21;702;636;73513;63017;63.2;54.2
23;2021-07-22;945;439;74458;63456;64.0;54.6
23;2021-07-23;840;508;75298;63964;64.8;55.0
23;2021-07-24;1013;439;76311;64403;65.6;55.4
23;2021-07-25;13;16;76324;64419;65.6;55.4
23;2021-07-26;788;563;77112;64982;66.3;55.9
23;2021-07-27;928;436;78040;65418;67.1;56.3
23;2021-07-28;877;411;78917;65829;67.9;56.6
23;2021-07-29;1049;400;79966;66229;68.8;57.0
23;2021-07-30;947;521;80913;66750;69.6;57.4
23;2021-07-31;1165;306;82078;67056;70.6;57.7
23;2021-08-01;19;8;82097;67064;70.6;57.7
23;2021-08-02;674;506;82771;67570;71.2;58.1
23;2021-08-03;768;458;83539;68028;71.8;58.5
23;2021-08-04;613;298;84152;68326;72.4;58.8
23;2021-08-05;692;365;84844;68691;73.0;59.1
23;2021-08-06;421;482;85265;69173;73.3;59.5
23;2021-08-07;299;188;85564;69361;73.6;59.7
23;2021-08-08;146;38;85710;69399;73.7;59.7
23;2021-08-09;492;492;86202;69891;74.1;60.1
23;2021-08-10;467;608;86669;70499;74.5;60.6
23;2021-08-11;428;487;87097;70986;74.9;61.1
23;2021-08-12;514;567;87611;71553;75.4;61.5
23;2021-08-13;420;578;88031;72131;75.7;62.0
23;2021-08-14;287;390;88318;72521;76.0;62.4
23;2021-08-15;27;9;88345;72530;76.0;62.4
23;2021-08-16;276;710;88621;73240;76.2;63.0
23;2021-08-17;277;732;88898;73972;76.5;63.6
23;2021-08-18;180;637;89078;74609;76.6;64.2
23;2021-08-19;257;726;89335;75335;76.8;64.8
23;2021-08-20;215;682;89550;76017;77.0;65.4
23;2021-08-21;140;500;89690;76517;77.1;65.8
23;2021-08-22;54;48;89744;76565;77.2;65.9
23;2021-08-23;149;816;89893;77381;77.3;66.6
23;2021-08-24;265;911;90158;78292;77.5;67.3
23;2021-08-25;187;791;90345;79083;77.7;68.0
23;2021-08-26;220;744;90565;79827;77.9;68.7
23;2021-08-27;213;639;90778;80466;78.1;69.2
23;2021-08-28;222;454;91000;80920;78.3;69.6
23;2021-08-29;15;88;91015;81008;78.3;69.7
23;2021-08-30;187;651;91202;81659;78.4;70.2
23;2021-08-31;229;663;91431;82322;78.6;70.8
23;2021-09-01;160;391;91591;82713;78.8;71.1
23;2021-09-02;118;306;91709;83019;78.9;71.4
23;2021-09-03;210;508;91919;83527;79.1;71.8
23;2021-09-04;178;793;92097;84320;79.2;72.5
23;2021-09-05;5;4;92102;84324;79.2;72.5
23;2021-09-06;133;379;92235;84703;79.3;72.9
23;2021-09-07;98;343;92333;85046;79.4;73.1
23;2021-09-08;121;357;92454;85403;79.5;73.5
23;2021-09-09;117;306;92571;85709;79.6;73.7
23;2021-09-10;150;312;92721;86021;79.7;74.0
23;2021-09-11;102;202;92823;86223;79.8;74.2
23;2021-09-12;5;7;92828;86230;79.8;74.2
23;2021-09-13;113;323;92941;86553;79.9;74.4
23;2021-09-14;112;288;93053;86841;80.0;74.7
23;2021-09-15;97;242;93150;87083;80.1;74.9
23;2021-09-16;127;153;93277;87236;80.2;75.0
23;2021-09-17;140;227;93417;87463;80.3;75.2
23;2021-09-18;44;224;93461;87687;80.4;75.4
23;2021-09-19;0;1;93461;87688;80.4;75.4
23;2021-09-20;59;217;93520;87905;80.4;75.6
23;2021-09-21;85;184;93605;88089;80.5;75.8
23;2021-09-22;71;260;93676;88349;80.6;76.0
23;2021-09-23;58;133;93734;88482;80.6;76.1
23;2021-09-24;64;234;93798;88716;80.7;76.3
23;2021-09-25;27;138;93825;88854;80.7;76.4
23;2021-09-26;0;1;93825;88855;80.7;76.4
23;2021-09-27;34;159;93859;89014;80.7;76.6
23;2021-09-28;34;133;93893;89147;80.8;76.7
23;2021-09-29;64;156;93957;89303;80.8;76.8
23;2021-09-30;43;64;94000;89367;80.8;76.9
23;2021-10-01;82;178;94082;89545;80.9;77.0
23;2021-10-02;22;97;94104;89642;80.9;77.1
23;2021-10-03;1;4;94105;89646;80.9;77.1
23;2021-10-04;42;93;94147;89739;81.0;77.2
23;2021-10-05;34;83;94181;89822;81.0;77.3
23;2021-10-06;56;97;94237;89919;81.1;77.3
23;2021-10-07;62;126;94299;90045;81.1;77.4
23;2021-10-08;52;191;94351;90236;81.1;77.6
23;2021-10-09;16;44;94367;90280;81.2;77.6
23;2021-10-10;0;0;94367;90280;81.2;77.6
23;2021-10-11;20;97;94387;90377;81.2;77.7
24;2020-12-27;2;1;2;1;0.0;0.0
24;2020-12-28;1;0;3;1;0.0;0.0
24;2020-12-29;2;0;5;1;0.0;0.0
24;2020-12-30;1;0;6;1;0.0;0.0
24;2020-12-31;1;0;7;1;0.0;0.0
24;2021-01-01;2;1;9;2;0.0;0.0
24;2021-01-02;1;0;10;2;0.0;0.0
24;2021-01-03;1;0;11;2;0.0;0.0
24;2021-01-04;1;0;12;2;0.0;0.0
24;2021-01-05;1;0;13;2;0.0;0.0
24;2021-01-06;3;0;16;2;0.0;0.0
24;2021-01-07;190;0;206;2;0.1;0.0
24;2021-01-08;282;0;488;2;0.1;0.0
24;2021-01-09;185;13;673;15;0.2;0.0
24;2021-01-10;35;0;708;15;0.2;0.0
24;2021-01-11;269;0;977;15;0.2;0.0
24;2021-01-12;280;0;1257;15;0.3;0.0
24;2021-01-13;233;1;1490;16;0.4;0.0
24;2021-01-14;1024;31;2514;47;0.6;0.0
24;2021-01-15;607;6;3121;53;0.8;0.0
24;2021-01-16;88;0;3209;53;0.8;0.0
24;2021-01-17;2;1;3211;54;0.8;0.0
24;2021-01-18;300;1;3511;55;0.9;0.0
24;2021-01-19;467;1;3978;56;1.0;0.0
24;2021-01-20;557;3;4535;59;1.1;0.0
24;2021-01-21;646;6;5181;65;1.3;0.0
24;2021-01-22;517;1;5698;66;1.4;0.0
24;2021-01-23;154;1;5852;67;1.4;0.0
24;2021-01-24;4;1;5856;68;1.4;0.0
24;2021-01-25;443;1;6299;69;1.5;0.0
24;2021-01-26;638;65;6937;134;1.7;0.0
24;2021-01-27;1267;15;8204;149;2.0;0.0
24;2021-01-28;986;131;9190;280;2.3;0.1
24;2021-01-29;933;139;10123;419;2.5;0.1
24;2021-01-30;282;1;10405;420;2.5;0.1
24;2021-01-31;0;0;10405;420;2.5;0.1
24;2021-02-01;379;170;10784;590;2.6;0.1
24;2021-02-02;616;308;11400;898;2.8;0.2
24;2021-02-03;654;491;12054;1389;3.0;0.3
24;2021-02-04;977;392;13031;1781;3.2;0.4
24;2021-02-05;689;410;13720;2191;3.4;0.5
24;2021-02-06;141;36;13861;2227;3.4;0.5
24;2021-02-07;33;1;13894;2228;3.4;0.5
24;2021-02-08;310;237;14204;2465;3.5;0.6
24;2021-02-09;454;231;14658;2696;3.6;0.7
24;2021-02-10;378;112;15036;2808;3.7;0.7
24;2021-02-11;561;515;15597;3323;3.8;0.8
24;2021-02-12;498;390;16095;3713;3.9;0.9
24;2021-02-13;202;45;16297;3758;4.0;0.9
24;2021-02-14;89;0;16386;3758;4.0;0.9
24;2021-02-15;188;241;16574;3999;4.1;1.0
24;2021-02-16;336;520;16910;4519;4.1;1.1
24;2021-02-17;586;848;17496;5367;4.3;1.3
24;2021-02-18;446;734;17942;6101;4.4;1.5
24;2021-02-19;463;679;18405;6780;4.5;1.7
24;2021-02-20;164;140;18569;6920;4.5;1.7
24;2021-02-21;112;0;18681;6920;4.6;1.7
24;2021-02-22;427;527;19108;7447;4.7;1.8
24;2021-02-23;565;683;19673;8130;4.8;2.0
24;2021-02-24;539;831;20212;8961;4.9;2.2
24;2021-02-25;727;865;20939;9826;5.1;2.4
24;2021-02-26;978;973;21917;10799;5.4;2.6
24;2021-02-27;363;266;22280;11065;5.5;2.7
24;2021-02-28;25;4;22305;11069;5.5;2.7
24;2021-03-01;291;371;22596;11440;5.5;2.8
24;2021-03-02;541;420;23137;11860;5.7;2.9
24;2021-03-03;681;343;23818;12203;5.8;3.0
24;2021-03-04;914;506;24732;12709;6.1;3.1
24;2021-03-05;1067;570;25799;13279;6.3;3.3
24;2021-03-06;1125;145;26924;13424;6.6;3.3
24;2021-03-07;232;63;27156;13487;6.6;3.3
24;2021-03-08;529;256;27685;13743;6.8;3.4
24;2021-03-09;1175;443;28860;14186;7.1;3.5
24;2021-03-10;1142;452;30002;14638;7.3;3.6
24;2021-03-11;1610;470;31612;15108;7.7;3.7
24;2021-03-12;2058;444;33670;15552;8.2;3.8
24;2021-03-13;1348;204;35018;15756;8.6;3.9
24;2021-03-14;141;93;35159;15849;8.6;3.9
24;2021-03-15;953;172;36112;16021;8.8;3.9
24;2021-03-16;1144;234;37256;16255;9.1;4.0
24;2021-03-17;1217;292;38473;16547;9.4;4.1
24;2021-03-18;1054;561;39527;17108;9.7;4.2
24;2021-03-19;1250;543;40777;17651;10.0;4.3
24;2021-03-20;1054;150;41831;17801;10.2;4.4
24;2021-03-21;25;11;41856;17812;10.2;4.4
24;2021-03-22;1224;424;43080;18236;10.5;4.5
24;2021-03-23;1878;400;44958;18636;11.0;4.6
24;2021-03-24;1892;390;46850;19026;11.5;4.7
24;2021-03-25;1992;475;48842;19501;12.0;4.8
24;2021-03-26;2374;285;51216;19786;12.5;4.8
24;2021-03-27;1349;43;52565;19829;12.9;4.9
24;2021-03-28;63;9;52628;19838;12.9;4.9
24;2021-03-29;1673;329;54301;20167;13.3;4.9
24;2021-03-30;2410;403;56711;20570;13.9;5.0
24;2021-03-31;2187;317;58898;20887;14.4;5.1
24;2021-04-01;2195;315;61093;21202;15.0;5.2
24;2021-04-02;2072;396;63165;21598;15.5;5.3
24;2021-04-03;1376;123;64541;21721;15.8;5.3
24;2021-04-04;74;1;64615;21722;15.8;5.3
24;2021-04-05;948;61;65563;21783;16.1;5.3
24;2021-04-06;2355;704;67918;22487;16.6;5.5
24;2021-04-07;2716;696;70634;23183;17.3;5.7
24;2021-04-08;3001;965;73635;24148;18.0;5.9
24;2021-04-09;3486;1012;77121;25160;18.9;6.2
24;2021-04-10;2596;315;79717;25475;19.5;6.2
24;2021-04-11;1103;22;80820;25497;19.8;6.2
24;2021-04-12;2498;817;83318;26314;20.4;6.4
24;2021-04-13;2902;1208;86220;27522;21.1;6.7
24;2021-04-14;2939;1200;89159;28722;21.8;7.0
24;2021-04-15;2790;1104;91949;29826;22.5;7.3
24;2021-04-16;3266;977;95215;30803;23.3;7.5
24;2021-04-17;2272;503;97487;31306;23.9;7.7
24;2021-04-18;424;6;97911;31312;24.0;7.7
24;2021-04-19;1598;1013;99509;32325;24.4;7.9
24;2021-04-20;2268;1437;101777;33762;24.9;8.3
24;2021-04-21;2146;1445;103923;35207;25.4;8.6
24;2021-04-22;2061;1262;105984;36469;26.0;8.9
24;2021-04-23;1960;1340;107944;37809;26.4;9.3
24;2021-04-24;863;724;108807;38533;26.6;9.4
24;2021-04-25;54;4;108861;38537;26.7;9.4
24;2021-04-26;1295;1480;110156;40017;27.0;9.8
24;2021-04-27;1848;1881;112004;41898;27.4;10.3
24;2021-04-28;1507;1957;113511;43855;27.8;10.7
24;2021-04-29;1730;1894;115241;45749;28.2;11.2
24;2021-04-30;2271;1780;117512;47529;28.8;11.6
24;2021-05-01;2059;1072;119571;48601;29.3;11.9
24;2021-05-02;1924;217;121495;48818;29.7;12.0
24;2021-05-03;1475;1837;122970;50655;30.1;12.4
24;2021-05-04;2228;2307;125198;52962;30.7;13.0
24;2021-05-05;1891;2722;127089;55684;31.1;13.6
24;2021-05-06;1890;2800;128979;58484;31.6;14.3
24;2021-05-07;2263;2795;131242;61279;32.1;15.0
24;2021-05-08;1285;1154;132527;62433;32.5;15.3
24;2021-05-09;1169;903;133696;63336;32.7;15.5
24;2021-05-10;1097;2627;134793;65963;33.0;16.2
24;2021-05-11;2037;2798;136830;68761;33.5;16.8
24;2021-05-12;1924;2258;138754;71019;34.0;17.4
24;2021-05-13;1465;1217;140219;72236;34.3;17.7
24;2021-05-14;2378;1333;142597;73569;34.9;18.0
24;2021-05-15;2048;816;144645;74385;35.4;18.2
24;2021-05-16;1172;347;145817;74732;35.7;18.3
24;2021-05-17;2240;1255;148057;75987;36.3;18.6
24;2021-05-18;2485;1820;150542;77807;36.9;19.1
24;2021-05-19;2283;1377;152825;79184;37.4;19.4
24;2021-05-20;2376;1577;155201;80761;38.0;19.8
24;2021-05-21;2434;1415;157635;82176;38.6;20.1
24;2021-05-22;1719;409;159354;82585;39.0;20.2
24;2021-05-23;950;72;160304;82657;39.3;20.2
24;2021-05-24;1518;333;161822;82990;39.6;20.3
24;2021-05-25;2297;1386;164119;84376;40.2;20.7
24;2021-05-26;2148;1320;166267;85696;40.7;21.0
24;2021-05-27;1750;2193;168017;87889;41.1;21.5
24;2021-05-28;2144;2004;170161;89893;41.7;22.0
24;2021-05-29;1153;2084;171314;91977;41.9;22.5
24;2021-05-30;1418;171;172732;92148;42.3;22.6
24;2021-05-31;1740;1365;174472;93513;42.7;22.9
24;2021-06-01;2582;1978;177054;95491;43.4;23.4
24;2021-06-02;2654;1785;179708;97276;44.0;23.8
24;2021-06-03;2289;1464;181997;98740;44.6;24.2
24;2021-06-04;2378;1899;184375;100639;45.1;24.6
24;2021-06-05;2007;1415;186382;102054;45.6;25.0
24;2021-06-06;767;222;187149;102276;45.8;25.0
24;2021-06-07;1432;1497;188581;103773;46.2;25.4
24;2021-06-08;1677;1905;190258;105678;46.6;25.9
24;2021-06-09;1322;1596;191580;107274;46.9;26.3
24;2021-06-10;1579;1914;193159;109188;47.3;26.7
24;2021-06-11;1334;2080;194493;111268;47.6;27.2
24;2021-06-12;1117;2543;195610;113811;47.9;27.9
24;2021-06-13;1238;919;196848;114730;48.2;28.1
24;2021-06-14;1166;1857;198014;116587;48.5;28.5
24;2021-06-15;1488;2993;199502;119580;48.9;29.3
24;2021-06-16;1670;2733;201172;122313;49.3;29.9
24;2021-06-17;1544;2180;202716;124493;49.6;30.5
24;2021-06-18;1400;2861;204116;127354;50.0;31.2
24;2021-06-19;1273;1522;205389;128876;50.3;31.6
24;2021-06-20;514;501;205903;129377;50.4;31.7
24;2021-06-21;932;1833;206835;131210;50.6;32.1
24;2021-06-22;1451;2591;208286;133801;51.0;32.8
24;2021-06-23;1425;2419;209711;136220;51.4;33.4
24;2021-06-24;1137;1917;210848;138137;51.6;33.8
24;2021-06-25;968;2818;211816;140955;51.9;34.5
24;2021-06-26;866;2104;212682;143059;52.1;35.0
24;2021-06-27;402;979;213084;144038;52.2;35.3
24;2021-06-28;818;2482;213902;146520;52.4;35.9
24;2021-06-29;938;2867;214840;149387;52.6;36.6
24;2021-06-30;1111;2456;215951;151843;52.9;37.2
24;2021-07-01;1131;2303;217082;154146;53.2;37.7
24;2021-07-02;1096;2745;218178;156891;53.4;38.4
24;2021-07-03;811;1903;218989;158794;53.6;38.9
24;2021-07-04;411;1013;219400;159807;53.7;39.1
24;2021-07-05;793;2316;220193;162123;53.9;39.7
24;2021-07-06;879;3354;221072;165477;54.1;40.5
24;2021-07-07;1086;3041;222158;168518;54.4;41.3
24;2021-07-08;1339;2121;223497;170639;54.7;41.8
24;2021-07-09;1177;3216;224674;173855;55.0;42.6
24;2021-07-10;481;1964;225155;175819;55.1;43.1
24;2021-07-11;587;1189;225742;177008;55.3;43.3
24;2021-07-12;907;2516;226649;179524;55.5;44.0
24;2021-07-13;1323;3219;227972;182743;55.8;44.7
24;2021-07-14;619;1189;228591;183932;56.0;45.0
24;2021-07-15;1697;2777;230288;186709;56.4;45.7
24;2021-07-16;2149;2598;232437;189307;56.9;46.4
24;2021-07-17;1528;2239;233965;191546;57.3;46.9
24;2021-07-18;709;887;234674;192433;57.5;47.1
24;2021-07-19;1580;2187;236254;194620;57.8;47.7
24;2021-07-20;2017;2440;238271;197060;58.3;48.3
24;2021-07-21;1875;2330;240146;199390;58.8;48.8
24;2021-07-22;2351;2443;242497;201833;59.4;49.4
24;2021-07-23;2303;2623;244800;204456;59.9;50.1
24;2021-07-24;1807;1545;246607;206001;60.4;50.4
24;2021-07-25;816;875;247423;206876;60.6;50.7
24;2021-07-26;1572;2015;248995;208891;61.0;51.1
24;2021-07-27;2848;2289;251843;211180;61.7;51.7
24;2021-07-28;2765;1940;254608;213120;62.3;52.2
24;2021-07-29;3063;2240;257671;215360;63.1;52.7
24;2021-07-30;2466;1920;260137;217280;63.7;53.2
24;2021-07-31;1654;1570;261791;218850;64.1;53.6
24;2021-08-01;1117;658;262908;219508;64.4;53.7
24;2021-08-02;1946;1623;264854;221131;64.9;54.1
24;2021-08-03;2887;1908;267741;223039;65.6;54.6
24;2021-08-04;3077;1631;270818;224670;66.3;55.0
24;2021-08-05;3049;1441;273867;226111;67.1;55.4
24;2021-08-06;2537;1540;276404;227651;67.7;55.7
24;2021-08-07;1792;1120;278196;228771;68.1;56.0
24;2021-08-08;1108;687;279304;229458;68.4;56.2
24;2021-08-09;1740;1383;281044;230841;68.8;56.5
24;2021-08-10;2266;1786;283310;232627;69.4;57.0
24;2021-08-11;2279;1698;285589;234325;69.9;57.4
24;2021-08-12;1916;1956;287505;236281;70.4;57.9
24;2021-08-13;1530;1625;289035;237906;70.8;58.3
24;2021-08-14;1171;1242;290206;239148;71.1;58.6
24;2021-08-15;741;583;290947;239731;71.2;58.7
24;2021-08-16;1123;1706;292070;241437;71.5;59.1
24;2021-08-17;1632;2108;293702;243545;71.9;59.6
24;2021-08-18;1562;1925;295264;245470;72.3;60.1
24;2021-08-19;1127;2635;296391;248105;72.6;60.8
24;2021-08-20;1107;2429;297498;250534;72.8;61.3
24;2021-08-21;874;1634;298372;252168;73.1;61.7
24;2021-08-22;350;1101;298722;253269;73.1;62.0
24;2021-08-23;673;2036;299395;255305;73.3;62.5
24;2021-08-24;818;2395;300213;257700;73.5;63.1
24;2021-08-25;813;2323;301026;260023;73.7;63.7
24;2021-08-26;747;2840;301773;262863;73.9;64.4
24;2021-08-27;801;2765;302574;265628;74.1;65.0
24;2021-08-28;522;1909;303096;267537;74.2;65.5
24;2021-08-29;171;1029;303267;268566;74.3;65.8
24;2021-08-30;376;1951;303643;270517;74.4;66.2
24;2021-08-31;593;2429;304236;272946;74.5;66.8
24;2021-09-01;627;2378;304863;275324;74.6;67.4
24;2021-09-02;465;1779;305328;277103;74.8;67.9
24;2021-09-03;550;2046;305878;279149;74.9;68.4
24;2021-09-04;365;1938;306243;281087;75.0;68.8
24;2021-09-05;245;931;306488;282018;75.0;69.1
24;2021-09-06;345;1465;306833;283483;75.1;69.4
24;2021-09-07;478;1646;307311;285129;75.2;69.8
24;2021-09-08;400;1759;307711;286888;75.3;70.2
24;2021-09-09;335;1102;308046;287990;75.4;70.5
24;2021-09-10;387;1583;308433;289573;75.5;70.9
24;2021-09-11;317;1609;308750;291182;75.6;71.3
24;2021-09-12;92;374;308842;291556;75.6;71.4
24;2021-09-13;294;1014;309136;292570;75.7;71.6
24;2021-09-14;430;911;309566;293481;75.8;71.9
24;2021-09-15;412;1267;309978;294748;75.9;72.2
24;2021-09-16;249;890;310227;295638;76.0;72.4
24;2021-09-17;410;1037;310637;296675;76.1;72.6
24;2021-09-18;312;1111;310949;297786;76.1;72.9
24;2021-09-19;45;347;310994;298133;76.2;73.0
24;2021-09-20;154;577;311148;298710;76.2;73.1
24;2021-09-21;381;408;311529;299118;76.3;73.2
24;2021-09-22;226;697;311755;299815;76.3;73.4
24;2021-09-23;135;389;311890;300204;76.4;73.5
24;2021-09-24;249;812;312139;301016;76.4;73.7
24;2021-09-25;215;592;312354;301608;76.5;73.9
24;2021-09-26;32;106;312386;301714;76.5;73.9
24;2021-09-27;180;494;312566;302208;76.5;74.0
24;2021-09-28;209;328;312775;302536;76.6;74.1
24;2021-09-29;227;586;313002;303122;76.6;74.2
24;2021-09-30;253;439;313255;303561;76.7;74.3
24;2021-10-01;229;487;313484;304048;76.8;74.4
24;2021-10-02;195;483;313679;304531;76.8;74.6
24;2021-10-03;17;39;313696;304570;76.8;74.6
24;2021-10-04;112;288;313808;304858;76.8;74.6
24;2021-10-05;102;341;313910;305199;76.9;74.7
24;2021-10-06;200;438;314110;305637;76.9;74.8
24;2021-10-07;104;175;314214;305812;76.9;74.9
24;2021-10-08;186;440;314400;306252;77.0;75.0
24;2021-10-09;168;470;314568;306722;77.0;75.1
24;2021-10-10;14;31;314582;306753;77.0;75.1
24;2021-10-11;86;189;314668;306942;77.1;75.2
25;2020-12-27;0;0;0;0;0.0;0.0
25;2020-12-28;1;0;1;0;0.0;0.0
25;2020-12-29;0;0;1;0;0.0;0.0
25;2020-12-30;0;0;1;0;0.0;0.0
25;2020-12-31;3;1;4;1;0.0;0.0
25;2021-01-01;0;0;4;1;0.0;0.0
25;2021-01-02;1;0;5;1;0.0;0.0
25;2021-01-03;0;0;5;1;0.0;0.0
25;2021-01-04;1;0;6;1;0.0;0.0
25;2021-01-05;1;0;7;1;0.0;0.0
25;2021-01-06;75;1;82;2;0.0;0.0
25;2021-01-07;235;1;317;3;0.1;0.0
25;2021-01-08;345;1;662;4;0.1;0.0
25;2021-01-09;102;0;764;4;0.1;0.0
25;2021-01-10;0;0;764;4;0.1;0.0
25;2021-01-11;503;6;1267;10;0.2;0.0
25;2021-01-12;682;2;1949;12;0.4;0.0
25;2021-01-13;627;11;2576;23;0.5;0.0
25;2021-01-14;896;19;3472;42;0.6;0.0
25;2021-01-15;787;9;4259;51;0.8;0.0
25;2021-01-16;206;1;4465;52;0.8;0.0
25;2021-01-17;112;0;4577;52;0.8;0.0
25;2021-01-18;1299;6;5876;58;1.1;0.0
25;2021-01-19;1416;5;7292;63;1.4;0.0
25;2021-01-20;1421;6;8713;69;1.6;0.0
25;2021-01-21;1843;4;10556;73;2.0;0.0
25;2021-01-22;1509;8;12065;81;2.2;0.0
25;2021-01-23;499;1;12564;82;2.3;0.0
25;2021-01-24;119;0;12683;82;2.4;0.0
25;2021-01-25;990;0;13673;82;2.5;0.0
25;2021-01-26;1490;42;15163;124;2.8;0.0
25;2021-01-27;1248;70;16411;194;3.0;0.0
25;2021-01-28;1090;75;17501;269;3.2;0.0
25;2021-01-29;906;234;18407;503;3.4;0.1
25;2021-01-30;293;91;18700;594;3.5;0.1
25;2021-01-31;2;0;18702;594;3.5;0.1
25;2021-02-01;613;222;19315;816;3.6;0.2
25;2021-02-02;674;415;19989;1231;3.7;0.2
25;2021-02-03;758;248;20747;1479;3.8;0.3
25;2021-02-04;716;444;21463;1923;4.0;0.4
25;2021-02-05;521;468;21984;2391;4.1;0.4
25;2021-02-06;197;156;22181;2547;4.1;0.5
25;2021-02-07;2;34;22183;2581;4.1;0.5
25;2021-02-08;612;508;22795;3089;4.2;0.6
25;2021-02-09;615;490;23410;3579;4.3;0.7
25;2021-02-10;818;503;24228;4082;4.5;0.8
25;2021-02-11;589;849;24817;4931;4.6;0.9
25;2021-02-12;413;550;25230;5481;4.7;1.0
25;2021-02-13;98;141;25328;5622;4.7;1.0
25;2021-02-14;0;0;25328;5622;4.7;1.0
25;2021-02-15;186;1033;25514;6655;4.7;1.2
25;2021-02-16;213;1454;25727;8109;4.8;1.5
25;2021-02-17;107;1336;25834;9445;4.8;1.8
25;2021-02-18;147;1428;25981;10873;4.8;2.0
25;2021-02-19;102;1269;26083;12142;4.8;2.3
25;2021-02-20;27;491;26110;12633;4.8;2.3
25;2021-02-21;1;143;26111;12776;4.8;2.4
25;2021-02-22;83;1061;26194;13837;4.9;2.6
25;2021-02-23;195;1076;26389;14913;4.9;2.8
25;2021-02-24;104;975;26493;15888;4.9;2.9
25;2021-02-25;522;1003;27015;16891;5.0;3.1
25;2021-02-26;607;981;27622;17872;5.1;3.3
25;2021-02-27;228;374;27850;18246;5.2;3.4
25;2021-02-28;6;1;27856;18247;5.2;3.4
25;2021-03-01;443;623;28299;18870;5.2;3.5
25;2021-03-02;653;833;28952;19703;5.4;3.7
25;2021-03-03;544;736;29496;20439;5.5;3.8
25;2021-03-04;1159;663;30655;21102;5.7;3.9
25;2021-03-05;1854;399;32509;21501;6.0;4.0
25;2021-03-06;1171;227;33680;21728;6.2;4.0
25;2021-03-07;9;9;33689;21737;6.2;4.0
25;2021-03-08;548;708;34237;22445;6.3;4.2
25;2021-03-09;1040;783;35277;23228;6.5;4.3
25;2021-03-10;1150;655;36427;23883;6.8;4.4
25;2021-03-11;1659;590;38086;24473;7.1;4.5
25;2021-03-12;1996;466;40082;24939;7.4;4.6
25;2021-03-13;1121;101;41203;25040;7.6;4.6
25;2021-03-14;35;0;41238;25040;7.6;4.6
25;2021-03-15;1125;148;42363;25188;7.9;4.7
25;2021-03-16;1288;127;43651;25315;8.1;4.7
25;2021-03-17;1413;144;45064;25459;8.4;4.7
25;2021-03-18;1526;86;46590;25545;8.6;4.7
25;2021-03-19;1595;132;48185;25677;8.9;4.8
25;2021-03-20;822;42;49007;25719;9.1;4.8
25;2021-03-21;24;0;49031;25719;9.1;4.8
25;2021-03-22;1486;88;50517;25807;9.4;4.8
25;2021-03-23;2161;164;52678;25971;9.8;4.8
25;2021-03-24;2418;100;55096;26071;10.2;4.8
25;2021-03-25;2837;201;57933;26272;10.7;4.9
25;2021-03-26;3160;183;61093;26455;11.3;4.9
25;2021-03-27;1112;91;62205;26546;11.5;4.9
25;2021-03-28;121;65;62326;26611;11.6;4.9
25;2021-03-29;1790;286;64116;26897;11.9;5.0
25;2021-03-30;2214;404;66330;27301;12.3;5.1
25;2021-03-31;2220;368;68550;27669;12.7;5.1
25;2021-04-01;2451;530;71001;28199;13.2;5.2
25;2021-04-02;2026;613;73027;28812;13.5;5.3
25;2021-04-03;447;110;73474;28922;13.6;5.4
25;2021-04-04;39;21;73513;28943;13.6;5.4
25;2021-04-05;145;4;73658;28947;13.7;5.4
25;2021-04-06;1937;691;75595;29638;14.0;5.5
25;2021-04-07;1878;857;77473;30495;14.4;5.7
25;2021-04-08;2435;832;79908;31327;14.8;5.8
25;2021-04-09;2597;998;82505;32325;15.3;6.0
25;2021-04-10;978;292;83483;32617;15.5;6.0
25;2021-04-11;105;28;83588;32645;15.5;6.1
25;2021-04-12;1556;968;85144;33613;15.8;6.2
25;2021-04-13;1988;1326;87132;34939;16.2;6.5
25;2021-04-14;1750;1221;88882;36160;16.5;6.7
25;2021-04-15;1997;1329;90879;37489;16.8;6.9
25;2021-04-16;2085;1009;92964;38498;17.2;7.1
25;2021-04-17;1104;417;94068;38915;17.4;7.2
25;2021-04-18;118;18;94186;38933;17.5;7.2
25;2021-04-19;1327;1246;95513;40179;17.7;7.4
25;2021-04-20;1615;1466;97128;41645;18.0;7.7
25;2021-04-21;1717;1636;98845;43281;18.3;8.0
25;2021-04-22;1855;1713;100700;44994;18.7;8.3
25;2021-04-23;1903;1771;102603;46765;19.0;8.7
25;2021-04-24;1278;705;103881;47470;19.3;8.8
25;2021-04-25;140;114;104021;47584;19.3;8.8
25;2021-04-26;1722;1686;105743;49270;19.6;9.1
25;2021-04-27;2804;1524;108547;50794;20.1;9.4
25;2021-04-28;2425;1563;110972;52357;20.6;9.7
25;2021-04-29;2648;1836;113620;54193;21.1;10.0
25;2021-04-30;3109;1581;116729;55774;21.6;10.3
25;2021-05-01;1789;333;118518;56107;22.0;10.4
25;2021-05-02;442;22;118960;56129;22.1;10.4
25;2021-05-03;2901;848;121861;56977;22.6;10.6
25;2021-05-04;2639;1884;124500;58861;23.1;10.9
25;2021-05-05;2597;1670;127097;60531;23.6;11.2
25;2021-05-06;2927;2170;130024;62701;24.1;11.6
25;2021-05-07;3063;2129;133087;64830;24.7;12.0
25;2021-05-08;1334;230;134421;65060;24.9;12.1
25;2021-05-09;244;87;134665;65147;25.0;12.1
25;2021-05-10;3129;1639;137794;66786;25.5;12.4
25;2021-05-11;3747;2042;141541;68828;26.2;12.8
25;2021-05-12;3688;1791;145229;70619;26.9;13.1
25;2021-05-13;3523;599;148752;71218;27.6;13.2
25;2021-05-14;4482;1307;153234;72525;28.4;13.4
25;2021-05-15;3282;710;156516;73235;29.0;13.6
25;2021-05-16;723;93;157239;73328;29.1;13.6
25;2021-05-17;4089;1099;161328;74427;29.9;13.8
25;2021-05-18;5205;1194;166533;75621;30.9;14.0
25;2021-05-19;5247;1134;171780;76755;31.8;14.2
25;2021-05-20;5134;1455;176914;78210;32.8;14.5
25;2021-05-21;5764;1983;182678;80193;33.9;14.9
25;2021-05-22;3174;722;185852;80915;34.5;15.0
25;2021-05-23;781;157;186633;81072;34.6;15.0
25;2021-05-24;1529;152;188162;81224;34.9;15.1
25;2021-05-25;3513;1651;191675;82875;35.5;15.4
25;2021-05-26;3974;1561;195649;84436;36.3;15.7
25;2021-05-27;4519;1897;200168;86333;37.1;16.0
25;2021-05-28;3994;2653;204162;88986;37.8;16.5
25;2021-05-29;2016;1021;206178;90007;38.2;16.7
25;2021-05-30;174;96;206352;90103;38.3;16.7
25;2021-05-31;2672;1708;209024;91811;38.7;17.0
25;2021-06-01;2729;2157;211753;93968;39.3;17.4
25;2021-06-02;2608;2251;214361;96219;39.7;17.8
25;2021-06-03;3274;2046;217635;98265;40.3;18.2
25;2021-06-04;3209;2411;220844;100676;40.9;18.7
25;2021-06-05;1491;1403;222335;102079;41.2;18.9
25;2021-06-06;987;259;223322;102338;41.4;19.0
25;2021-06-07;2782;2575;226104;104913;41.9;19.4
25;2021-06-08;2603;2761;228707;107674;42.4;20.0
25;2021-06-09;2382;2763;231089;110437;42.8;20.5
25;2021-06-10;2325;2653;233414;113090;43.3;21.0
25;2021-06-11;2709;3305;236123;116395;43.8;21.6
25;2021-06-12;1571;1861;237694;118256;44.1;21.9
25;2021-06-13;497;259;238191;118515;44.2;22.0
25;2021-06-14;1421;3753;239612;122268;44.4;22.7
25;2021-06-15;1643;3568;241255;125836;44.7;23.3
25;2021-06-16;1954;3273;243209;129109;45.1;23.9
25;2021-06-17;1474;3323;244683;132432;45.4;24.5
25;2021-06-18;2286;4297;246969;136729;45.8;25.3
25;2021-06-19;1350;1979;248319;138708;46.0;25.7
25;2021-06-20;59;239;248378;138947;46.0;25.8
25;2021-06-21;1139;4139;249517;143086;46.3;26.5
25;2021-06-22;1151;4673;250668;147759;46.5;27.4
25;2021-06-23;1404;4072;252072;151831;46.7;28.1
25;2021-06-24;1191;4085;253263;155916;46.9;28.9
25;2021-06-25;1640;5603;254903;161519;47.3;29.9
25;2021-06-26;626;3384;255529;164903;47.4;30.6
25;2021-06-27;451;877;255980;165780;47.5;30.7
25;2021-06-28;907;4476;256887;170256;47.6;31.6
25;2021-06-29;1130;5469;258017;175725;47.8;32.6
25;2021-06-30;1311;5371;259328;181096;48.1;33.6
25;2021-07-01;1706;5230;261034;186326;48.4;34.5
25;2021-07-02;1748;5061;262782;191387;48.7;35.5
25;2021-07-03;1042;2692;263824;194079;48.9;36.0
25;2021-07-04;409;722;264233;194801;49.0;36.1
25;2021-07-05;1299;2579;265532;197380;49.2;36.6
25;2021-07-06;1568;4748;267100;202128;49.5;37.5
25;2021-07-07;1597;4501;268697;206629;49.8;38.3
25;2021-07-08;1554;3932;270251;210561;50.1;39.0
25;2021-07-09;1796;4590;272047;215151;50.4;39.9
25;2021-07-10;781;2371;272828;217522;50.6;40.3
25;2021-07-11;127;307;272955;217829;50.6;40.4
25;2021-07-12;1404;3859;274359;221688;50.9;41.1
25;2021-07-13;2470;4770;276829;226458;51.3;42.0
25;2021-07-14;379;561;277208;227019;51.4;42.1
25;2021-07-15;2403;3658;279611;230677;51.8;42.8
25;2021-07-16;3485;3834;283096;234511;52.5;43.5
25;2021-07-17;2207;2040;285303;236551;52.9;43.9
25;2021-07-18;808;1300;286111;237851;53.0;44.1
25;2021-07-19;2543;4207;288654;242058;53.5;44.9
25;2021-07-20;3384;3714;292038;245772;54.1;45.6
25;2021-07-21;3300;3369;295338;249141;54.7;46.2
25;2021-07-22;3351;2985;298689;252126;55.4;46.7
25;2021-07-23;3566;3357;302255;255483;56.0;47.4
25;2021-07-24;1413;2270;303668;257753;56.3;47.8
25;2021-07-25;679;710;304347;258463;56.4;47.9
25;2021-07-26;3056;3012;307403;261475;57.0;48.5
25;2021-07-27;3835;2127;311238;263602;57.7;48.9
25;2021-07-28;3692;2120;314930;265722;58.4;49.3
25;2021-07-29;4321;2093;319251;267815;59.2;49.6
25;2021-07-30;4291;2490;323542;270305;60.0;50.1
25;2021-07-31;1821;1469;325363;271774;60.3;50.4
25;2021-08-01;1352;201;326715;271975;60.6;50.4
25;2021-08-02;2743;2214;329458;274189;61.1;50.8
25;2021-08-03;2839;2203;332297;276392;61.6;51.2
25;2021-08-04;2941;1429;335238;277821;62.1;51.5
25;2021-08-05;2206;1732;337444;279553;62.6;51.8
25;2021-08-06;2291;2349;339735;281902;63.0;52.3
25;2021-08-07;1294;1206;341029;283108;63.2;52.5
25;2021-08-08;325;477;341354;283585;63.3;52.6
25;2021-08-09;2025;2231;343379;285816;63.7;53.0
25;2021-08-10;1975;2524;345354;288340;64.0;53.5
25;2021-08-11;1831;2033;347185;290373;64.4;53.8
25;2021-08-12;2149;2503;349334;292876;64.8;54.3
25;2021-08-13;1712;2023;351046;294899;65.1;54.7
25;2021-08-14;969;1791;352015;296690;65.3;55.0
25;2021-08-15;9;45;352024;296735;65.3;55.0
25;2021-08-16;1262;3261;353286;299996;65.5;55.6
25;2021-08-17;1458;3285;354744;303281;65.8;56.2
25;2021-08-18;1236;2804;355980;306085;66.0;56.7
25;2021-08-19;987;2867;356967;308952;66.2;57.3
25;2021-08-20;1434;3694;358401;312646;66.4;58.0
25;2021-08-21;568;1782;358969;314428;66.5;58.3
25;2021-08-22;212;1273;359181;315701;66.6;58.5
25;2021-08-23;1116;3336;360297;319037;66.8;59.1
25;2021-08-24;1071;3234;361368;322271;67.0;59.7
25;2021-08-25;1018;3061;362386;325332;67.2;60.3
25;2021-08-26;1144;3006;363530;328338;67.4;60.9
25;2021-08-27;1205;3064;364735;331402;67.6;61.4
25;2021-08-28;588;1791;365323;333193;67.7;61.8
25;2021-08-29;162;513;365485;333706;67.8;61.9
25;2021-08-30;941;2787;366426;336493;67.9;62.4
25;2021-08-31;971;2304;367397;338797;68.1;62.8
25;2021-09-01;844;2221;368241;341018;68.3;63.2
25;2021-09-02;796;1666;369037;342684;68.4;63.5
25;2021-09-03;803;1887;369840;344571;68.6;63.9
25;2021-09-04;692;1358;370532;345929;68.7;64.1
25;2021-09-05;128;183;370660;346112;68.7;64.2
25;2021-09-06;632;1344;371292;347456;68.8;64.4
25;2021-09-07;490;1106;371782;348562;68.9;64.6
25;2021-09-08;623;1607;372405;350169;69.0;64.9
25;2021-09-09;426;989;372831;351158;69.1;65.1
25;2021-09-10;848;1626;373679;352784;69.3;65.4
25;2021-09-11;375;1034;374054;353818;69.3;65.6
25;2021-09-12;111;203;374165;354021;69.4;65.6
25;2021-09-13;726;962;374891;354983;69.5;65.8
25;2021-09-14;626;855;375517;355838;69.6;66.0
25;2021-09-15;759;1480;376276;357318;69.8;66.2
25;2021-09-16;501;829;376777;358147;69.8;66.4
25;2021-09-17;746;1339;377523;359486;70.0;66.6
25;2021-09-18;319;871;377842;360357;70.0;66.8
25;2021-09-19;78;166;377920;360523;70.1;66.8
25;2021-09-20;454;742;378374;361265;70.1;67.0
25;2021-09-21;202;591;378576;361856;70.2;67.1
25;2021-09-22;450;1192;379026;363048;70.3;67.3
25;2021-09-23;253;456;379279;363504;70.3;67.4
25;2021-09-24;491;1052;379770;364556;70.4;67.6
25;2021-09-25;282;896;380052;365452;70.5;67.7
25;2021-09-26;8;5;380060;365457;70.5;67.7
25;2021-09-27;293;586;380353;366043;70.5;67.9
25;2021-09-28;209;442;380562;366485;70.5;67.9
25;2021-09-29;459;822;381021;367307;70.6;68.1
25;2021-09-30;224;363;381245;367670;70.7;68.2
25;2021-10-01;425;888;381670;368558;70.8;68.3
25;2021-10-02;276;578;381946;369136;70.8;68.4
25;2021-10-03;9;6;381955;369142;70.8;68.4
25;2021-10-04;322;729;382277;369871;70.9;68.6
25;2021-10-05;115;365;382392;370236;70.9;68.6
25;2021-10-06;410;762;382802;370998;71.0;68.8
25;2021-10-07;127;278;382929;371276;71.0;68.8
25;2021-10-08;483;894;383412;372170;71.1;69.0
25;2021-10-09;293;511;383705;372681;71.1;69.1
25;2021-10-10;6;28;383711;372709;71.1;69.1
25;2021-10-11;263;594;383974;373303;71.2;69.2
26;2020-12-27;0;0;0;0;0.0;0.0
26;2020-12-28;0;0;0;0;0.0;0.0
26;2020-12-29;0;0;0;0;0.0;0.0
26;2020-12-30;0;0;0;0;0.0;0.0
26;2020-12-31;0;0;0;0;0.0;0.0
26;2021-01-01;1;0;1;0;0.0;0.0
26;2021-01-02;0;0;1;0;0.0;0.0
26;2021-01-03;0;0;1;0;0.0;0.0
26;2021-01-04;0;0;1;0;0.0;0.0
26;2021-01-05;0;0;1;0;0.0;0.0
26;2021-01-06;0;0;1;0;0.0;0.0
26;2021-01-07;168;0;169;0;0.0;0.0
26;2021-01-08;126;0;295;0;0.1;0.0
26;2021-01-09;2;0;297;0;0.1;0.0
26;2021-01-10;0;0;297;0;0.1;0.0
26;2021-01-11;267;2;564;2;0.1;0.0
26;2021-01-12;177;1;741;3;0.1;0.0
26;2021-01-13;418;1;1159;4;0.2;0.0
26;2021-01-14;490;2;1649;6;0.3;0.0
26;2021-01-15;563;2;2212;8;0.4;0.0
26;2021-01-16;250;1;2462;9;0.5;0.0
26;2021-01-17;0;0;2462;9;0.5;0.0
26;2021-01-18;637;1;3099;10;0.6;0.0
26;2021-01-19;786;3;3885;13;0.7;0.0
26;2021-01-20;742;0;4627;13;0.9;0.0
26;2021-01-21;807;5;5434;18;1.0;0.0
26;2021-01-22;787;5;6221;23;1.2;0.0
26;2021-01-23;563;3;6784;26;1.3;0.0
26;2021-01-24;24;0;6808;26;1.3;0.0
26;2021-01-25;696;2;7504;28;1.4;0.0
26;2021-01-26;800;4;8304;32;1.6;0.0
26;2021-01-27;823;9;9127;41;1.8;0.0
26;2021-01-28;1332;169;10459;210;2.0;0.0
26;2021-01-29;971;67;11430;277;2.2;0.1
26;2021-01-30;606;5;12036;282;2.3;0.1
26;2021-01-31;24;0;12060;282;2.3;0.1
26;2021-02-01;708;189;12768;471;2.5;0.1
26;2021-02-02;1276;216;14044;687;2.7;0.1
26;2021-02-03;1265;279;15309;966;2.9;0.2
26;2021-02-04;985;459;16294;1425;3.1;0.3
26;2021-02-05;674;336;16968;1761;3.3;0.3
26;2021-02-06;407;238;17375;1999;3.3;0.4
26;2021-02-07;57;2;17432;2001;3.3;0.4
26;2021-02-08;545;416;17977;2417;3.5;0.5
26;2021-02-09;618;475;18595;2892;3.6;0.6
26;2021-02-10;665;341;19260;3233;3.7;0.6
26;2021-02-11;753;328;20013;3561;3.8;0.7
26;2021-02-12;591;447;20604;4008;4.0;0.8
26;2021-02-13;388;332;20992;4340;4.0;0.8
26;2021-02-14;36;0;21028;4340;4.0;0.8
26;2021-02-15;414;526;21442;4866;4.1;0.9
26;2021-02-16;294;550;21736;5416;4.2;1.0
26;2021-02-17;194;737;21930;6153;4.2;1.2
26;2021-02-18;337;890;22267;7043;4.3;1.4
26;2021-02-19;341;803;22608;7846;4.3;1.5
26;2021-02-20;95;487;22703;8333;4.4;1.6
26;2021-02-21;3;24;22706;8357;4.4;1.6
26;2021-02-22;144;707;22850;9064;4.4;1.7
26;2021-02-23;398;1002;23248;10066;4.5;1.9
26;2021-02-24;346;1225;23594;11291;4.5;2.2
26;2021-02-25;747;1073;24341;12364;4.7;2.4
26;2021-02-26;925;642;25266;13006;4.9;2.5
26;2021-02-27;278;508;25544;13514;4.9;2.6
26;2021-02-28;3;30;25547;13544;4.9;2.6
26;2021-03-01;459;661;26006;14205;5.0;2.7
26;2021-03-02;742;634;26748;14839;5.1;2.9
26;2021-03-03;733;683;27481;15522;5.3;3.0
26;2021-03-04;1045;584;28526;16106;5.5;3.1
26;2021-03-05;1710;533;30236;16639;5.8;3.2
26;2021-03-06;2773;505;33009;17144;6.3;3.3
26;2021-03-07;2989;226;35998;17370;6.9;3.3
26;2021-03-08;908;652;36906;18022;7.1;3.5
26;2021-03-09;1325;558;38231;18580;7.3;3.6
26;2021-03-10;1218;514;39449;19094;7.6;3.7
26;2021-03-11;1610;655;41059;19749;7.9;3.8
26;2021-03-12;2216;488;43275;20237;8.3;3.9
26;2021-03-13;1886;347;45161;20584;8.7;4.0
26;2021-03-14;68;38;45229;20622;8.7;4.0
26;2021-03-15;1653;252;46882;20874;9.0;4.0
26;2021-03-16;1232;520;48114;21394;9.2;4.1
26;2021-03-17;1369;307;49483;21701;9.5;4.2
26;2021-03-18;1587;285;51070;21986;9.8;4.2
26;2021-03-19;2445;354;53515;22340;10.3;4.3
26;2021-03-20;1290;152;54805;22492;10.5;4.3
26;2021-03-21;61;21;54866;22513;10.5;4.3
26;2021-03-22;1847;202;56713;22715;10.9;4.4
26;2021-03-23;2474;283;59187;22998;11.4;4.4
26;2021-03-24;2551;250;61738;23248;11.9;4.5
26;2021-03-25;3044;347;64782;23595;12.4;4.5
26;2021-03-26;3053;364;67835;23959;13.0;4.6
26;2021-03-27;1243;163;69078;24122;13.3;4.6
26;2021-03-28;94;7;69172;24129;13.3;4.6
26;2021-03-29;1908;409;71080;24538;13.7;4.7
26;2021-03-30;2383;552;73463;25090;14.1;4.8
26;2021-03-31;2229;587;75692;25677;14.5;4.9
26;2021-04-01;2279;787;77971;26464;15.0;5.1
26;2021-04-02;2213;996;80184;27460;15.4;5.3
26;2021-04-03;551;1204;80735;28664;15.5;5.5
26;2021-04-04;215;887;80950;29551;15.6;5.7
26;2021-04-05;557;52;81507;29603;15.7;5.7
26;2021-04-06;1486;833;82993;30436;15.9;5.8
26;2021-04-07;1793;900;84786;31336;16.3;6.0
26;2021-04-08;3008;942;87794;32278;16.9;6.2
26;2021-04-09;3415;1013;91209;33291;17.5;6.4
26;2021-04-10;1356;929;92565;34220;17.8;6.6
26;2021-04-11;88;35;92653;34255;17.8;6.6
26;2021-04-12;1713;1128;94366;35383;18.1;6.8
26;2021-04-13;2797;1459;97163;36842;18.7;7.1
26;2021-04-14;2204;1490;99367;38332;19.1;7.4
26;2021-04-15;2282;1602;101649;39934;19.5;7.7
26;2021-04-16;2272;1596;103921;41530;20.0;8.0
26;2021-04-17;1095;841;105016;42371;20.2;8.1
26;2021-04-18;36;52;105052;42423;20.2;8.1
26;2021-04-19;1547;1575;106599;43998;20.5;8.5
26;2021-04-20;1796;1732;108395;45730;20.8;8.8
26;2021-04-21;2012;1517;110407;47247;21.2;9.1
26;2021-04-22;2289;1606;112696;48853;21.6;9.4
26;2021-04-23;2012;1644;114708;50497;22.0;9.7
26;2021-04-24;1655;846;116363;51343;22.4;9.9
26;2021-04-25;629;97;116992;51440;22.5;9.9
26;2021-04-26;1377;1599;118369;53039;22.7;10.2
26;2021-04-27;1986;1686;120355;54725;23.1;10.5
26;2021-04-28;1865;1545;122220;56270;23.5;10.8
26;2021-04-29;2866;1898;125086;58168;24.0;11.2
26;2021-04-30;2626;1768;127712;59936;24.5;11.5
26;2021-05-01;1538;380;129250;60316;24.8;11.6
26;2021-05-02;1084;118;130334;60434;25.0;11.6
26;2021-05-03;2200;1791;132534;62225;25.5;12.0
26;2021-05-04;2614;2365;135148;64590;26.0;12.4
26;2021-05-05;2772;2202;137920;66792;26.5;12.8
26;2021-05-06;3322;2228;141242;69020;27.1;13.3
26;2021-05-07;2860;2262;144102;71282;27.7;13.7
26;2021-05-08;1960;622;146062;71904;28.1;13.8
26;2021-05-09;713;123;146775;72027;28.2;13.8
26;2021-05-10;3021;1831;149796;73858;28.8;14.2
26;2021-05-11;4445;2188;154241;76046;29.6;14.6
26;2021-05-12;4828;1695;159069;77741;30.6;14.9
26;2021-05-13;4363;617;163432;78358;31.4;15.1
26;2021-05-14;4640;1551;168072;79909;32.3;15.4
26;2021-05-15;4468;626;172540;80535;33.1;15.5
26;2021-05-16;3629;345;176169;80880;33.8;15.5
26;2021-05-17;3657;1487;179826;82367;34.5;15.8
26;2021-05-18;4474;1743;184300;84110;35.4;16.2
26;2021-05-19;4486;1450;188786;85560;36.3;16.4
26;2021-05-20;4684;1770;193470;87330;37.2;16.8
26;2021-05-21;4729;1804;198199;89134;38.1;17.1
26;2021-05-22;3189;690;201388;89824;38.7;17.3
26;2021-05-23;1597;183;202985;90007;39.0;17.3
26;2021-05-24;3788;743;206773;90750;39.7;17.4
26;2021-05-25;3591;2348;210364;93098;40.4;17.9
26;2021-05-26;4177;2272;214541;95370;41.2;18.3
26;2021-05-27;4211;2460;218752;97830;42.0;18.8
26;2021-05-28;3776;2769;222528;100599;42.7;19.3
26;2021-05-29;3087;1653;225615;102252;43.3;19.6
26;2021-05-30;320;70;225935;102322;43.4;19.7
26;2021-05-31;3082;1854;229017;104176;44.0;20.0
26;2021-06-01;3110;2309;232127;106485;44.6;20.5
26;2021-06-02;2869;2220;234996;108705;45.1;20.9
26;2021-06-03;2849;2491;237845;111196;45.7;21.4
26;2021-06-04;2667;2917;240512;114113;46.2;21.9
26;2021-06-05;1806;1694;242318;115807;46.5;22.2
26;2021-06-06;9;0;242327;115807;46.6;22.2
26;2021-06-07;2346;2431;244673;118238;47.0;22.7
26;2021-06-08;2453;2293;247126;120531;47.5;23.2
26;2021-06-09;2096;2390;249222;122921;47.9;23.6
26;2021-06-10;1981;2764;251203;125685;48.3;24.1
26;2021-06-11;1887;3272;253090;128957;48.6;24.8
26;2021-06-12;1219;1790;254309;130747;48.9;25.1
26;2021-06-13;97;214;254406;130961;48.9;25.2
26;2021-06-14;1415;3498;255821;134459;49.1;25.8
26;2021-06-15;1586;3964;257407;138423;49.4;26.6
26;2021-06-16;1784;3472;259191;141895;49.8;27.3
26;2021-06-17;1509;3167;260700;145062;50.1;27.9
26;2021-06-18;1797;4368;262497;149430;50.4;28.7
26;2021-06-19;934;3180;263431;152610;50.6;29.3
26;2021-06-20;263;876;263694;153486;50.7;29.5
26;2021-06-21;1005;4558;264699;158044;50.8;30.4
26;2021-06-22;1061;5119;265760;163163;51.1;31.3
26;2021-06-23;1168;5072;266928;168235;51.3;32.3
26;2021-06-24;1258;4544;268186;172779;51.5;33.2
26;2021-06-25;1014;5542;269200;178321;51.7;34.3
26;2021-06-26;662;3823;269862;182144;51.8;35.0
26;2021-06-27;299;1273;270161;183417;51.9;35.2
26;2021-06-28;778;4757;270939;188174;52.0;36.1
26;2021-06-29;1097;4956;272036;193130;52.3;37.1
26;2021-06-30;1411;4890;273447;198020;52.5;38.0
26;2021-07-01;1651;4389;275098;202409;52.8;38.9
26;2021-07-02;1333;5163;276431;207572;53.1;39.9
26;2021-07-03;769;3321;277200;210893;53.3;40.5
26;2021-07-04;331;633;277531;211526;53.3;40.6
26;2021-07-05;887;4673;278418;216199;53.5;41.5
26;2021-07-06;1266;4199;279684;220398;53.7;42.3
26;2021-07-07;1440;3797;281124;224195;54.0;43.1
26;2021-07-08;2387;3330;283511;227525;54.5;43.7
26;2021-07-09;1558;4789;285069;232314;54.8;44.6
26;2021-07-10;910;2913;285979;235227;54.9;45.2
26;2021-07-11;332;347;286311;235574;55.0;45.3
26;2021-07-12;1113;4218;287424;239792;55.2;46.1
26;2021-07-13;2301;4343;289725;244135;55.7;46.9
26;2021-07-14;1060;814;290785;244949;55.9;47.1
26;2021-07-15;3166;3659;293951;248608;56.5;47.8
26;2021-07-16;3000;3688;296951;252296;57.0;48.5
26;2021-07-17;1876;1814;298827;254110;57.4;48.8
26;2021-07-18;20;24;298847;254134;57.4;48.8
26;2021-07-19;2724;3265;301571;257399;57.9;49.4
26;2021-07-20;3706;3370;305277;260769;58.6;50.1
26;2021-07-21;3588;3087;308865;263856;59.3;50.7
26;2021-07-22;4119;2973;312984;266829;60.1;51.3
26;2021-07-23;3860;3402;316844;270231;60.9;51.9
26;2021-07-24;2344;1363;319188;271594;61.3;52.2
26;2021-07-25;608;97;319796;271691;61.4;52.2
26;2021-07-26;3429;2584;323225;274275;62.1;52.7
26;2021-07-27;4840;2621;328065;276896;63.0;53.2
26;2021-07-28;4534;2390;332599;279286;63.9;53.7
26;2021-07-29;3902;2900;336501;282186;64.6;54.2
26;2021-07-30;3484;2675;339985;284861;65.3;54.7
26;2021-07-31;1144;1010;341129;285871;65.5;54.9
26;2021-08-01;419;108;341548;285979;65.6;54.9
26;2021-08-02;2953;2364;344501;288343;66.2;55.4
26;2021-08-03;3299;2297;347800;290640;66.8;55.8
26;2021-08-04;3999;2016;351799;292656;67.6;56.2
26;2021-08-05;3154;2207;354953;294863;68.2;56.6
26;2021-08-06;3174;2639;358127;297502;68.8;57.2
26;2021-08-07;640;845;358767;298347;68.9;57.3
26;2021-08-08;29;13;358796;298360;68.9;57.3
26;2021-08-09;2191;3062;360987;301422;69.3;57.9
26;2021-08-10;2341;3049;363328;304471;69.8;58.5
26;2021-08-11;2078;2719;365406;307190;70.2;59.0
26;2021-08-12;1775;2586;367181;309776;70.5;59.5
26;2021-08-13;1742;2424;368923;312200;70.9;60.0
26;2021-08-14;272;872;369195;313072;70.9;60.1
26;2021-08-15;6;8;369201;313080;70.9;60.1
26;2021-08-16;1190;3291;370391;316371;71.2;60.8
26;2021-08-17;1523;3154;371914;319525;71.4;61.4
26;2021-08-18;1631;3376;373545;322901;71.8;62.0
26;2021-08-19;1552;3069;375097;325970;72.1;62.6
26;2021-08-20;1446;2980;376543;328950;72.3;63.2
26;2021-08-21;599;1090;377142;330040;72.4;63.4
26;2021-08-22;58;379;377200;330419;72.5;63.5
26;2021-08-23;1601;3621;378801;334040;72.8;64.2
26;2021-08-24;1748;3596;380549;337636;73.1;64.9
26;2021-08-25;1605;3660;382154;341296;73.4;65.6
26;2021-08-26;1494;3160;383648;344456;73.7;66.2
26;2021-08-27;1570;3607;385218;348063;74.0;66.9
26;2021-08-28;395;1104;385613;349167;74.1;67.1
26;2021-08-29;10;25;385623;349192;74.1;67.1
26;2021-08-30;1466;3385;387089;352577;74.4;67.7
26;2021-08-31;1286;3312;388375;355889;74.6;68.4
26;2021-09-01;1378;2598;389753;358487;74.9;68.9
26;2021-09-02;1116;1948;390869;360435;75.1;69.2
26;2021-09-03;1103;2520;391972;362955;75.3;69.7
26;2021-09-04;431;654;392403;363609;75.4;69.8
26;2021-09-05;25;18;392428;363627;75.4;69.9
26;2021-09-06;735;1445;393163;365072;75.5;70.1
26;2021-09-07;760;1417;393923;366489;75.7;70.4
26;2021-09-08;851;1665;394774;368154;75.8;70.7
26;2021-09-09;520;1322;395294;369476;75.9;71.0
26;2021-09-10;837;1750;396131;371226;76.1;71.3
26;2021-09-11;307;715;396438;371941;76.2;71.5
26;2021-09-12;0;5;396438;371946;76.2;71.5
26;2021-09-13;543;1292;396981;373238;76.3;71.7
26;2021-09-14;732;1280;397713;374518;76.4;71.9
26;2021-09-15;713;1831;398426;376349;76.5;72.3
26;2021-09-16;499;1007;398925;377356;76.6;72.5
26;2021-09-17;618;1732;399543;379088;76.8;72.8
26;2021-09-18;272;743;399815;379831;76.8;73.0
26;2021-09-19;3;13;399818;379844;76.8;73.0
26;2021-09-20;335;1095;400153;380939;76.9;73.2
26;2021-09-21;415;1013;400568;381952;76.9;73.4
26;2021-09-22;424;1518;400992;383470;77.0;73.7
26;2021-09-23;360;780;401352;384250;77.1;73.8
26;2021-09-24;441;1431;401793;385681;77.2;74.1
26;2021-09-25;180;598;401973;386279;77.2;74.2
26;2021-09-26;2;19;401975;386298;77.2;74.2
26;2021-09-27;312;811;402287;387109;77.3;74.4
26;2021-09-28;245;610;402532;387719;77.3;74.5
26;2021-09-29;385;1009;402917;388728;77.4;74.7
26;2021-09-30;226;517;403143;389245;77.4;74.8
26;2021-10-01;446;999;403589;390244;77.5;75.0
26;2021-10-02;189;340;403778;390584;77.6;75.0
26;2021-10-03;5;4;403783;390588;77.6;75.0
26;2021-10-04;320;631;404103;391219;77.6;75.2
26;2021-10-05;153;503;404256;391722;77.7;75.3
26;2021-10-06;385;798;404641;392520;77.7;75.4
26;2021-10-07;166;399;404807;392919;77.8;75.5
26;2021-10-08;376;843;405183;393762;77.8;75.6
26;2021-10-09;202;315;405385;394077;77.9;75.7
26;2021-10-10;1;17;405386;394094;77.9;75.7
26;2021-10-11;261;525;405647;394619;77.9;75.8
27;2020-12-27;2;0;2;0;0.0;0.0
27;2020-12-28;1;0;3;0;0.0;0.0
27;2020-12-29;2;0;5;0;0.0;0.0
27;2020-12-30;0;0;5;0;0.0;0.0
27;2020-12-31;0;0;5;0;0.0;0.0
27;2021-01-01;0;0;5;0;0.0;0.0
27;2021-01-02;0;0;5;0;0.0;0.0
27;2021-01-03;2;0;7;0;0.0;0.0
27;2021-01-04;0;0;7;0;0.0;0.0
27;2021-01-05;15;0;22;0;0.0;0.0
27;2021-01-06;161;0;183;0;0.0;0.0
27;2021-01-07;373;1;556;1;0.1;0.0
27;2021-01-08;443;2;999;3;0.2;0.0
27;2021-01-09;72;1;1071;4;0.2;0.0
27;2021-01-10;100;0;1171;4;0.2;0.0
27;2021-01-11;383;0;1554;4;0.3;0.0
27;2021-01-12;409;2;1963;6;0.3;0.0
27;2021-01-13;840;3;2803;9;0.5;0.0
27;2021-01-14;1629;32;4432;41;0.7;0.0
27;2021-01-15;1224;6;5656;47;0.9;0.0
27;2021-01-16;332;2;5988;49;1.0;0.0
27;2021-01-17;205;0;6193;49;1.0;0.0
27;2021-01-18;800;3;6993;52;1.2;0.0
27;2021-01-19;772;3;7765;55;1.3;0.0
27;2021-01-20;871;1;8636;56;1.4;0.0
27;2021-01-21;654;4;9290;60;1.5;0.0
27;2021-01-22;778;5;10068;65;1.7;0.0
27;2021-01-23;350;0;10418;65;1.7;0.0
27;2021-01-24;169;6;10587;71;1.8;0.0
27;2021-01-25;635;15;11222;86;1.9;0.0
27;2021-01-26;462;17;11684;103;1.9;0.0
27;2021-01-27;506;104;12190;207;2.0;0.0
27;2021-01-28;517;294;12707;501;2.1;0.1
27;2021-01-29;509;108;13216;609;2.2;0.1
27;2021-01-30;242;29;13458;638;2.2;0.1
27;2021-01-31;27;24;13485;662;2.2;0.1
27;2021-02-01;348;194;13833;856;2.3;0.1
27;2021-02-02;308;280;14141;1136;2.4;0.2
27;2021-02-03;487;400;14628;1536;2.4;0.3
27;2021-02-04;717;884;15345;2420;2.6;0.4
27;2021-02-05;664;1141;16009;3561;2.7;0.6
27;2021-02-06;126;220;16135;3781;2.7;0.6
27;2021-02-07;25;42;16160;3823;2.7;0.6
27;2021-02-08;312;378;16472;4201;2.7;0.7
27;2021-02-09;341;554;16813;4755;2.8;0.8
27;2021-02-10;305;521;17118;5276;2.8;0.9
27;2021-02-11;318;453;17436;5729;2.9;1.0
27;2021-02-12;230;542;17666;6271;2.9;1.0
27;2021-02-13;151;133;17817;6404;3.0;1.1
27;2021-02-14;6;92;17823;6496;3.0;1.1
27;2021-02-15;389;598;18212;7094;3.0;1.2
27;2021-02-16;296;733;18508;7827;3.1;1.3
27;2021-02-17;247;635;18755;8462;3.1;1.4
27;2021-02-18;363;681;19118;9143;3.2;1.5
27;2021-02-19;218;689;19336;9832;3.2;1.6
27;2021-02-20;129;250;19465;10082;3.2;1.7
27;2021-02-21;12;136;19477;10218;3.2;1.7
27;2021-02-22;482;566;19959;10784;3.3;1.8
27;2021-02-23;496;622;20455;11406;3.4;1.9
27;2021-02-24;543;648;20998;12054;3.5;2.0
27;2021-02-25;847;759;21845;12813;3.6;2.1
27;2021-02-26;955;693;22800;13506;3.8;2.2
27;2021-02-27;408;162;23208;13668;3.9;2.3
27;2021-02-28;174;30;23382;13698;3.9;2.3
27;2021-03-01;488;442;23870;14140;4.0;2.4
27;2021-03-02;765;371;24635;14511;4.1;2.4
27;2021-03-03;853;363;25488;14874;4.2;2.5
27;2021-03-04;886;237;26374;15111;4.4;2.5
27;2021-03-05;1304;242;27678;15353;4.6;2.6
27;2021-03-06;1637;110;29315;15463;4.9;2.6
27;2021-03-07;620;18;29935;15481;5.0;2.6
27;2021-03-08;1204;304;31139;15785;5.2;2.6
27;2021-03-09;1828;270;32967;16055;5.5;2.7
27;2021-03-10;2116;352;35083;16407;5.8;2.7
27;2021-03-11;2162;233;37245;16640;6.2;2.8
27;2021-03-12;2817;204;40062;16844;6.7;2.8
27;2021-03-13;1919;129;41981;16973;7.0;2.8
27;2021-03-14;655;16;42636;16989;7.1;2.8
27;2021-03-15;1558;218;44194;17207;7.4;2.9
27;2021-03-16;1489;242;45683;17449;7.6;2.9
27;2021-03-17;1856;375;47539;17824;7.9;3.0
27;2021-03-18;1687;349;49226;18173;8.2;3.0
27;2021-03-19;1835;177;51061;18350;8.5;3.1
27;2021-03-20;905;43;51966;18393;8.7;3.1
27;2021-03-21;258;3;52224;18396;8.7;3.1
27;2021-03-22;1235;548;53459;18944;8.9;3.2
27;2021-03-23;1627;460;55086;19404;9.2;3.2
27;2021-03-24;1523;480;56609;19884;9.4;3.3
27;2021-03-25;2165;521;58774;20405;9.8;3.4
27;2021-03-26;2531;446;61305;20851;10.2;3.5
27;2021-03-27;1568;202;62873;21053;10.5;3.5
27;2021-03-28;1149;50;64022;21103;10.7;3.5
27;2021-03-29;1375;835;65397;21938;10.9;3.7
27;2021-03-30;1391;850;66788;22788;11.1;3.8
27;2021-03-31;1485;877;68273;23665;11.4;3.9
27;2021-04-01;1956;815;70229;24480;11.7;4.1
27;2021-04-02;1999;1186;72228;25666;12.0;4.3
27;2021-04-03;1563;741;73791;26407;12.3;4.4
27;2021-04-04;979;176;74770;26583;12.4;4.4
27;2021-04-05;283;7;75053;26590;12.5;4.4
27;2021-04-06;1413;1804;76466;28394;12.7;4.7
27;2021-04-07;1322;1747;77788;30141;12.9;5.0
27;2021-04-08;1685;1685;79473;31826;13.2;5.3
27;2021-04-09;2945;1569;82418;33395;13.7;5.6
27;2021-04-10;2033;988;84451;34383;14.1;5.7
27;2021-04-11;946;212;85397;34595;14.2;5.8
27;2021-04-12;2434;1518;87831;36113;14.6;6.0
27;2021-04-13;2393;1549;90224;37662;15.0;6.3
27;2021-04-14;2085;1632;92309;39294;15.4;6.5
27;2021-04-15;1874;1662;94183;40956;15.7;6.8
27;2021-04-16;2751;1118;96934;42074;16.1;7.0
27;2021-04-17;2168;498;99102;42572;16.5;7.1
27;2021-04-18;452;18;99554;42590;16.6;7.1
27;2021-04-19;1712;1175;101266;43765;16.9;7.3
27;2021-04-20;2388;1310;103654;45075;17.3;7.5
27;2021-04-21;2210;1083;105864;46158;17.6;7.7
27;2021-04-22;2180;1423;108044;47581;18.0;7.9
27;2021-04-23;2446;1183;110490;48764;18.4;8.1
27;2021-04-24;3260;1151;113750;49915;18.9;8.3
27;2021-04-25;1130;1052;114880;50967;19.1;8.5
27;2021-04-26;1925;1148;116805;52115;19.4;8.7
27;2021-04-27;2528;1094;119333;53209;19.9;8.9
27;2021-04-28;2395;1320;121728;54529;20.3;9.1
27;2021-04-29;2491;1476;124219;56005;20.7;9.3
27;2021-04-30;2371;1616;126590;57621;21.1;9.6
27;2021-05-01;2638;892;129228;58513;21.5;9.7
27;2021-05-02;1952;901;131180;59414;21.8;9.9
27;2021-05-03;3064;882;134244;60296;22.3;10.0
27;2021-05-04;2782;1652;137026;61948;22.8;10.3
27;2021-05-05;2816;1653;139842;63601;23.3;10.6
27;2021-05-06;3184;1298;143026;64899;23.8;10.8
27;2021-05-07;3322;2003;146348;66902;24.4;11.1
27;2021-05-08;2805;1332;149153;68234;24.8;11.4
27;2021-05-09;1697;298;150850;68532;25.1;11.4
27;2021-05-10;2950;2272;153800;70804;25.6;11.8
27;2021-05-11;3358;1759;157158;72563;26.2;12.1
27;2021-05-12;3464;1729;160622;74292;26.7;12.4
27;2021-05-13;1892;255;162514;74547;27.1;12.4
27;2021-05-14;3884;1790;166398;76337;27.7;12.7
27;2021-05-15;6601;953;172999;77290;28.8;12.9
27;2021-05-16;3668;438;176667;77728;29.4;12.9
27;2021-05-17;2774;1161;179441;78889;29.9;13.1
27;2021-05-18;3845;1296;183286;80185;30.5;13.3
27;2021-05-19;3967;1154;187253;81339;31.2;13.5
27;2021-05-20;3874;1174;191127;82513;31.8;13.7
27;2021-05-21;3968;1801;195095;84314;32.5;14.0
27;2021-05-22;4367;802;199462;85116;33.2;14.2
27;2021-05-23;799;173;200261;85289;33.3;14.2
27;2021-05-24;1489;342;201750;85631;33.6;14.3
27;2021-05-25;3510;1608;205260;87239;34.2;14.5
27;2021-05-26;3855;1740;209115;88979;34.8;14.8
27;2021-05-27;3789;1487;212904;90466;35.4;15.1
27;2021-05-28;3403;2634;216307;93100;36.0;15.5
27;2021-05-29;4822;2302;221129;95402;36.8;15.9
27;2021-05-30;1117;247;222246;95649;37.0;15.9
27;2021-05-31;3464;2275;225710;97924;37.6;16.3
27;2021-06-01;3813;2250;229523;100174;38.2;16.7
27;2021-06-02;3341;2183;232864;102357;38.8;17.0
27;2021-06-03;4430;2126;237294;104483;39.5;17.4
27;2021-06-04;3603;2978;240897;107461;40.1;17.9
27;2021-06-05;3207;3351;244104;110812;40.6;18.4
27;2021-06-06;2004;1005;246108;111817;41.0;18.6
27;2021-06-07;2570;2357;248678;114174;41.4;19.0
27;2021-06-08;3126;2379;251804;116553;41.9;19.4
27;2021-06-09;2305;2471;254109;119024;42.3;19.8
27;2021-06-10;2431;2041;256540;121065;42.7;20.2
27;2021-06-11;2889;3772;259429;124837;43.2;20.8
27;2021-06-12;1982;4191;261411;129028;43.5;21.5
27;2021-06-13;1084;2687;262495;131715;43.7;21.9
27;2021-06-14;1996;3112;264491;134827;44.0;22.4
27;2021-06-15;2688;3021;267179;137848;44.5;22.9
27;2021-06-16;2501;3261;269680;141109;44.9;23.5
27;2021-06-17;2298;3291;271978;144400;45.3;24.0
27;2021-06-18;2746;4420;274724;148820;45.7;24.8
27;2021-06-19;1863;3392;276587;152212;46.0;25.3
27;2021-06-20;607;710;277194;152922;46.1;25.5
27;2021-06-21;1703;3496;278897;156418;46.4;26.0
27;2021-06-22;2385;3719;281282;160137;46.8;26.7
27;2021-06-23;2073;3572;283355;163709;47.2;27.3
27;2021-06-24;2256;3413;285611;167122;47.5;27.8
27;2021-06-25;1936;4460;287547;171582;47.9;28.6
27;2021-06-26;884;5352;288431;176934;48.0;29.5
27;2021-06-27;377;1427;288808;178361;48.1;29.7
27;2021-06-28;1129;3405;289937;181766;48.3;30.3
27;2021-06-29;1703;4365;291640;186131;48.6;31.0
27;2021-06-30;2115;4096;293755;190227;48.9;31.7
27;2021-07-01;2224;3908;295979;194135;49.3;32.3
27;2021-07-02;1589;4620;297568;198755;49.5;33.1
27;2021-07-03;1309;4774;298877;203529;49.8;33.9
27;2021-07-04;504;1403;299381;204932;49.8;34.1
27;2021-07-05;1417;3529;300798;208461;50.1;34.7
27;2021-07-06;1366;4180;302164;212641;50.3;35.4
27;2021-07-07;1756;4905;303920;217546;50.6;36.2
27;2021-07-08;2089;4356;306009;221902;50.9;36.9
27;2021-07-09;1984;5287;307993;227189;51.3;37.8
27;2021-07-10;1167;4179;309160;231368;51.5;38.5
27;2021-07-11;426;1139;309586;232507;51.5;38.7
27;2021-07-12;1253;4373;310839;236880;51.7;39.4
27;2021-07-13;2759;5347;313598;242227;52.2;40.3
27;2021-07-14;1518;1753;315116;243980;52.5;40.6
27;2021-07-15;3033;5468;318149;249448;53.0;41.5
27;2021-07-16;3820;5290;321969;254738;53.6;42.4
27;2021-07-17;2732;3878;324701;258616;54.1;43.1
27;2021-07-18;553;1266;325254;259882;54.1;43.3
27;2021-07-19;3687;3791;328941;263673;54.8;43.9
27;2021-07-20;3460;3593;332401;267266;55.3;44.5
27;2021-07-21;4250;3901;336651;271167;56.0;45.1
27;2021-07-22;4750;3716;341401;274883;56.8;45.8
27;2021-07-23;3592;3400;344993;278283;57.4;46.3
27;2021-07-24;3114;2329;348107;280612;58.0;46.7
27;2021-07-25;493;545;348600;281157;58.0;46.8
27;2021-07-26;3072;3175;351672;284332;58.5;47.3
27;2021-07-27;3596;3104;355268;287436;59.1;47.9
27;2021-07-28;3592;3242;358860;290678;59.7;48.4
27;2021-07-29;4590;3511;363450;294189;60.5;49.0
27;2021-07-30;3817;3146;367267;297335;61.1;49.5
27;2021-07-31;3062;2585;370329;299920;61.7;49.9
27;2021-08-01;540;498;370869;300418;61.7;50.0
27;2021-08-02;3319;2584;374188;303002;62.3;50.4
27;2021-08-03;3427;2770;377615;305772;62.9;50.9
27;2021-08-04;3061;2334;380676;308106;63.4;51.3
27;2021-08-05;2676;2358;383352;310464;63.8;51.7
27;2021-08-06;3269;3244;386621;313708;64.4;52.2
27;2021-08-07;1801;2558;388422;316266;64.7;52.7
27;2021-08-08;218;197;388640;316463;64.7;52.7
27;2021-08-09;2210;2807;390850;319270;65.1;53.2
27;2021-08-10;2811;3514;393661;322784;65.5;53.7
27;2021-08-11;2637;3099;396298;325883;66.0;54.3
27;2021-08-12;2363;3905;398661;329788;66.4;54.9
27;2021-08-13;1745;2572;400406;332360;66.7;55.3
27;2021-08-14;1163;2889;401569;335249;66.9;55.8
27;2021-08-15;18;23;401587;335272;66.9;55.8
27;2021-08-16;1811;3816;403398;339088;67.2;56.5
27;2021-08-17;2046;3443;405444;342531;67.5;57.0
27;2021-08-18;1457;2986;406901;345517;67.7;57.5
27;2021-08-19;1711;3356;408612;348873;68.0;58.1
27;2021-08-20;1636;3440;410248;352313;68.3;58.7
27;2021-08-21;988;2842;411236;355155;68.5;59.1
27;2021-08-22;184;162;411420;355317;68.5;59.2
27;2021-08-23;1080;4008;412500;359325;68.7;59.8
27;2021-08-24;1440;3970;413940;363295;68.9;60.5
27;2021-08-25;1717;3414;415657;366709;69.2;61.0
27;2021-08-26;1157;2932;416814;369641;69.4;61.5
27;2021-08-27;1265;3223;418079;372864;69.6;62.1
27;2021-08-28;912;2870;418991;375734;69.8;62.6
27;2021-08-29;87;135;419078;375869;69.8;62.6
27;2021-08-30;905;3278;419983;379147;69.9;63.1
27;2021-08-31;1225;3083;421208;382230;70.1;63.6
27;2021-09-01;998;2922;422206;385152;70.3;64.1
27;2021-09-02;873;2187;423079;387339;70.4;64.5
27;2021-09-03;847;2170;423926;389509;70.6;64.8
27;2021-09-04;731;1957;424657;391466;70.7;65.2
27;2021-09-05;36;154;424693;391620;70.7;65.2
27;2021-09-06;538;1457;425231;393077;70.8;65.4
27;2021-09-07;698;2086;425929;395163;70.9;65.8
27;2021-09-08;771;2088;426700;397251;71.0;66.1
27;2021-09-09;683;1648;427383;398899;71.1;66.4
27;2021-09-10;900;1927;428283;400826;71.3;66.7
27;2021-09-11;609;1811;428892;402637;71.4;67.0
27;2021-09-12;42;171;428934;402808;71.4;67.1
27;2021-09-13;351;928;429285;403736;71.5;67.2
27;2021-09-14;594;1095;429879;404831;71.6;67.4
27;2021-09-15;556;1669;430435;406500;71.7;67.7
27;2021-09-16;599;1132;431034;407632;71.8;67.9
27;2021-09-17;790;1292;431824;408924;71.9;68.1
27;2021-09-18;364;1247;432188;410171;71.9;68.3
27;2021-09-19;56;161;432244;410332;72.0;68.3
27;2021-09-20;260;773;432504;411105;72.0;68.4
27;2021-09-21;428;963;432932;412068;72.1;68.6
27;2021-09-22;299;1030;433231;413098;72.1;68.8
27;2021-09-23;344;757;433575;413855;72.2;68.9
27;2021-09-24;578;1244;434153;415099;72.3;69.1
27;2021-09-25;291;1122;434444;416221;72.3;69.3
27;2021-09-26;4;12;434448;416233;72.3;69.3
27;2021-09-27;190;474;434638;416707;72.4;69.4
27;2021-09-28;313;725;434951;417432;72.4;69.5
27;2021-09-29;242;726;435193;418158;72.4;69.6
27;2021-09-30;162;521;435355;418679;72.5;69.7
27;2021-10-01;343;999;435698;419678;72.5;69.9
27;2021-10-02;364;797;436062;420475;72.6;70.0
27;2021-10-03;13;12;436075;420487;72.6;70.0
27;2021-10-04;178;374;436253;420861;72.6;70.1
27;2021-10-05;262;465;436515;421326;72.7;70.1
27;2021-10-06;280;693;436795;422019;72.7;70.3
27;2021-10-07;143;280;436938;422299;72.7;70.3
27;2021-10-08;329;822;437267;423121;72.8;70.4
27;2021-10-09;254;537;437521;423658;72.8;70.5
27;2021-10-10;12;35;437533;423693;72.8;70.5
27;2021-10-11;158;387;437691;424080;72.9;70.6
28;2020-12-27;0;0;0;0;0.0;0.0
28;2020-12-28;0;0;0;0;0.0;0.0
28;2020-12-29;0;0;0;0;0.0;0.0
28;2020-12-30;0;0;0;0;0.0;0.0
28;2020-12-31;0;0;0;0;0.0;0.0
28;2021-01-01;1;0;1;0;0.0;0.0
28;2021-01-02;0;0;1;0;0.0;0.0
28;2021-01-03;0;0;1;0;0.0;0.0
28;2021-01-04;0;0;1;0;0.0;0.0
28;2021-01-05;5;0;6;0;0.0;0.0
28;2021-01-06;84;0;90;0;0.0;0.0
28;2021-01-07;102;0;192;0;0.0;0.0
28;2021-01-08;134;2;326;2;0.1;0.0
28;2021-01-09;79;0;405;2;0.1;0.0
28;2021-01-10;1;0;406;2;0.1;0.0
28;2021-01-11;204;0;610;2;0.1;0.0
28;2021-01-12;265;2;875;4;0.2;0.0
28;2021-01-13;398;3;1273;7;0.3;0.0
28;2021-01-14;451;6;1724;13;0.4;0.0
28;2021-01-15;374;3;2098;16;0.5;0.0
28;2021-01-16;206;2;2304;18;0.5;0.0
28;2021-01-17;21;0;2325;18;0.5;0.0
28;2021-01-18;373;2;2698;20;0.6;0.0
28;2021-01-19;503;4;3201;24;0.7;0.0
28;2021-01-20;636;1;3837;25;0.9;0.0
28;2021-01-21;796;3;4633;28;1.1;0.0
28;2021-01-22;478;1;5111;29;1.2;0.0
28;2021-01-23;353;0;5464;29;1.3;0.0
28;2021-01-24;1;0;5465;29;1.3;0.0
28;2021-01-25;456;4;5921;33;1.4;0.0
28;2021-01-26;717;9;6638;42;1.5;0.0
28;2021-01-27;1211;52;7849;94;1.8;0.0
28;2021-01-28;1587;95;9436;189;2.2;0.0
28;2021-01-29;896;99;10332;288;2.4;0.1
28;2021-01-30;249;53;10581;341;2.5;0.1
28;2021-01-31;2;22;10583;363;2.5;0.1
28;2021-02-01;325;121;10908;484;2.5;0.1
28;2021-02-02;368;239;11276;723;2.6;0.2
28;2021-02-03;473;258;11749;981;2.7;0.2
28;2021-02-04;525;279;12274;1260;2.9;0.3
28;2021-02-05;436;230;12710;1490;3.0;0.3
28;2021-02-06;201;129;12911;1619;3.0;0.4
28;2021-02-07;0;0;12911;1619;3.0;0.4
28;2021-02-08;331;250;13242;1869;3.1;0.4
28;2021-02-09;281;344;13523;2213;3.1;0.5
28;2021-02-10;443;399;13966;2612;3.3;0.6
28;2021-02-11;562;492;14528;3104;3.4;0.7
28;2021-02-12;453;431;14981;3535;3.5;0.8
28;2021-02-13;181;191;15162;3726;3.5;0.9
28;2021-02-14;0;2;15162;3728;3.5;0.9
28;2021-02-15;280;473;15442;4201;3.6;1.0
28;2021-02-16;396;710;15838;4911;3.7;1.1
28;2021-02-17;584;1153;16422;6064;3.8;1.4
28;2021-02-18;666;1408;17088;7472;4.0;1.7
28;2021-02-19;548;767;17636;8239;4.1;1.9
28;2021-02-20;114;145;17750;8384;4.1;2.0
28;2021-02-21;7;33;17757;8417;4.1;2.0
28;2021-02-22;223;521;17980;8938;4.2;2.1
28;2021-02-23;203;379;18183;9317;4.2;2.2
28;2021-02-24;244;474;18427;9791;4.3;2.3
28;2021-02-25;574;454;19001;10245;4.4;2.4
28;2021-02-26;764;378;19765;10623;4.6;2.5
28;2021-02-27;265;86;20030;10709;4.7;2.5
28;2021-02-28;23;17;20053;10726;4.7;2.5
28;2021-03-01;292;215;20345;10941;4.7;2.5
28;2021-03-02;396;293;20741;11234;4.8;2.6
28;2021-03-03;367;399;21108;11633;4.9;2.7
28;2021-03-04;720;494;21828;12127;5.1;2.8
28;2021-03-05;1319;419;23147;12546;5.4;2.9
28;2021-03-06;1999;95;25146;12641;5.9;2.9
28;2021-03-07;974;42;26120;12683;6.1;3.0
28;2021-03-08;398;308;26518;12991;6.2;3.0
28;2021-03-09;981;364;27499;13355;6.4;3.1
28;2021-03-10;1358;558;28857;13913;6.7;3.2
28;2021-03-11;1535;710;30392;14623;7.1;3.4
28;2021-03-12;2255;645;32647;15268;7.6;3.6
28;2021-03-13;1235;134;33882;15402;7.9;3.6
28;2021-03-14;519;18;34401;15420;8.0;3.6
28;2021-03-15;755;234;35156;15654;8.2;3.6
28;2021-03-16;716;224;35872;15878;8.4;3.7
28;2021-03-17;746;290;36618;16168;8.5;3.8
28;2021-03-18;1203;277;37821;16445;8.8;3.8
28;2021-03-19;1558;340;39379;16785;9.2;3.9
28;2021-03-20;639;21;40018;16806;9.3;3.9
28;2021-03-21;29;8;40047;16814;9.3;3.9
28;2021-03-22;766;325;40813;17139;9.5;4.0
28;2021-03-23;1027;193;41840;17332;9.7;4.0
28;2021-03-24;1315;281;43155;17613;10.0;4.1
28;2021-03-25;1796;291;44951;17904;10.5;4.2
28;2021-03-26;2084;348;47035;18252;11.0;4.3
28;2021-03-27;402;38;47437;18290;11.0;4.3
28;2021-03-28;12;0;47449;18290;11.0;4.3
28;2021-03-29;1139;358;48588;18648;11.3;4.3
28;2021-03-30;1711;255;50299;18903;11.7;4.4
28;2021-03-31;2017;482;52316;19385;12.2;4.5
28;2021-04-01;1796;591;54112;19976;12.6;4.7
28;2021-04-02;1583;1321;55695;21297;13.0;5.0
28;2021-04-03;607;1071;56302;22368;13.1;5.2
28;2021-04-04;33;302;56335;22670;13.1;5.3
28;2021-04-05;40;3;56375;22673;13.1;5.3
28;2021-04-06;1222;463;57597;23136;13.4;5.4
28;2021-04-07;1890;1007;59487;24143;13.9;5.6
28;2021-04-08;2086;1076;61573;25219;14.3;5.9
28;2021-04-09;3230;924;64803;26143;15.1;6.1
28;2021-04-10;1581;202;66384;26345;15.5;6.1
28;2021-04-11;141;451;66525;26796;15.5;6.2
28;2021-04-12;1672;567;68197;27363;15.9;6.4
28;2021-04-13;1875;673;70072;28036;16.3;6.5
28;2021-04-14;2771;906;72843;28942;17.0;6.7
28;2021-04-15;2557;1153;75400;30095;17.6;7.0
28;2021-04-16;2554;810;77954;30905;18.2;7.2
28;2021-04-17;2309;134;80263;31039;18.7;7.2
28;2021-04-18;45;8;80308;31047;18.7;7.2
28;2021-04-19;1576;651;81884;31698;19.1;7.4
28;2021-04-20;1836;598;83720;32296;19.5;7.5
28;2021-04-21;2680;965;86400;33261;20.1;7.7
28;2021-04-22;1783;1224;88183;34485;20.5;8.0
28;2021-04-23;2325;1109;90508;35594;21.1;8.3
28;2021-04-24;3656;143;94164;35737;21.9;8.3
28;2021-04-25;1012;38;95176;35775;22.2;8.3
28;2021-04-26;1331;930;96507;36705;22.5;8.5
28;2021-04-27;1436;1287;97943;37992;22.8;8.8
28;2021-04-28;2373;1834;100316;39826;23.4;9.3
28;2021-04-29;2130;1516;102446;41342;23.9;9.6
28;2021-04-30;2973;1231;105419;42573;24.5;9.9
28;2021-05-01;127;121;105546;42694;24.6;9.9
28;2021-05-02;2;65;105548;42759;24.6;10.0
28;2021-05-03;1048;1022;106596;43781;24.8;10.2
28;2021-05-04;1359;1673;107955;45454;25.1;10.6
28;2021-05-05;2830;1654;110785;47108;25.8;11.0
28;2021-05-06;2456;1475;113241;48583;26.4;11.3
28;2021-05-07;2311;1934;115552;50517;26.9;11.8
28;2021-05-08;1078;118;116630;50635;27.2;11.8
28;2021-05-09;105;610;116735;51245;27.2;11.9
28;2021-05-10;1308;1894;118043;53139;27.5;12.4
28;2021-05-11;2024;2344;120067;55483;28.0;12.9
28;2021-05-12;2620;3237;122687;58720;28.6;13.7
28;2021-05-13;289;452;122976;59172;28.6;13.8
28;2021-05-14;1900;1616;124876;60788;29.1;14.2
28;2021-05-15;1433;1673;126309;62461;29.4;14.5
28;2021-05-16;1986;131;128295;62592;29.9;14.6
28;2021-05-17;2874;1493;131169;64085;30.5;14.9
28;2021-05-18;3382;1381;134551;65466;31.3;15.2
28;2021-05-19;5089;1283;139640;66749;32.5;15.5
28;2021-05-20;4149;1231;143789;67980;33.5;15.8
28;2021-05-21;3464;1587;147253;69567;34.3;16.2
28;2021-05-22;729;1161;147982;70728;34.5;16.5
28;2021-05-23;1956;139;149938;70867;34.9;16.5
28;2021-05-24;1428;395;151366;71262;35.2;16.6
28;2021-05-25;1876;1408;153242;72670;35.7;16.9
28;2021-05-26;2765;1346;156007;74016;36.3;17.2
28;2021-05-27;2754;1235;158761;75251;37.0;17.5
28;2021-05-28;3080;1732;161841;76983;37.7;17.9
28;2021-05-29;1868;873;163709;77856;38.1;18.1
28;2021-05-30;16;47;163725;77903;38.1;18.1
28;2021-05-31;2014;937;165739;78840;38.6;18.4
28;2021-06-01;2133;1662;167872;80502;39.1;18.7
28;2021-06-02;2077;2457;169949;82959;39.6;19.3
28;2021-06-03;2498;1562;172447;84521;40.2;19.7
28;2021-06-04;2608;2358;175055;86879;40.8;20.2
28;2021-06-05;1909;2522;176964;89401;41.2;20.8
28;2021-06-06;1060;1046;178024;90447;41.5;21.1
28;2021-06-07;3575;1575;181599;92022;42.3;21.4
28;2021-06-08;3196;1520;184795;93542;43.0;21.8
28;2021-06-09;3675;2130;188470;95672;43.9;22.3
28;2021-06-10;3140;1262;191610;96934;44.6;22.6
28;2021-06-11;3790;2135;195400;99069;45.5;23.1
28;2021-06-12;1304;560;196704;99629;45.8;23.2
28;2021-06-13;385;108;197089;99737;45.9;23.2
28;2021-06-14;2207;1996;199296;101733;46.4;23.7
28;2021-06-15;2092;2224;201388;103957;46.9;24.2
28;2021-06-16;2508;3982;203896;107939;47.5;25.1
28;2021-06-17;1940;3135;205836;111074;47.9;25.9
28;2021-06-18;2487;3789;208323;114863;48.5;26.7
28;2021-06-19;776;1612;209099;116475;48.7;27.1
28;2021-06-20;23;24;209122;116499;48.7;27.1
28;2021-06-21;1682;1989;210804;118488;49.1;27.6
28;2021-06-22;1372;2109;212176;120597;49.4;28.1
28;2021-06-23;1782;3164;213958;123761;49.8;28.8
28;2021-06-24;734;929;214692;124690;50.0;29.0
28;2021-06-25;1888;3028;216580;127718;50.4;29.7
28;2021-06-26;310;2114;216890;129832;50.5;30.2
28;2021-06-27;588;1284;217478;131116;50.6;30.5
28;2021-06-28;1225;3655;218703;134771;50.9;31.4
28;2021-06-29;1342;3791;220045;138562;51.2;32.3
28;2021-06-30;1494;4261;221539;142823;51.6;33.3
28;2021-07-01;1277;3500;222816;146323;51.9;34.1
28;2021-07-02;1313;4651;224129;150974;52.2;35.2
28;2021-07-03;1131;2372;225260;153346;52.5;35.7
28;2021-07-04;145;1325;225405;154671;52.5;36.0
28;2021-07-05;1360;2512;226765;157183;52.8;36.6
28;2021-07-06;1508;2870;228273;160053;53.2;37.3
28;2021-07-07;1636;4143;229909;164196;53.5;38.2
28;2021-07-08;1467;3241;231376;167437;53.9;39.0
28;2021-07-09;1393;4520;232769;171957;54.2;40.0
28;2021-07-10;528;2206;233297;174163;54.3;40.6
28;2021-07-11;2;1;233299;174164;54.3;40.6
28;2021-07-12;1526;3929;234825;178093;54.7;41.5
28;2021-07-13;2261;4143;237086;182236;55.2;42.4
28;2021-07-14;1328;1395;238414;183631;55.5;42.8
28;2021-07-15;2985;3974;241399;187605;56.2;43.7
28;2021-07-16;2444;4752;243843;192357;56.8;44.8
28;2021-07-17;1263;2431;245106;194788;57.1;45.4
28;2021-07-18;368;945;245474;195733;57.2;45.6
28;2021-07-19;1806;4339;247280;200072;57.6;46.6
28;2021-07-20;2476;4091;249756;204163;58.2;47.5
28;2021-07-21;2959;4286;252715;208449;58.8;48.5
28;2021-07-22;3670;3431;256385;211880;59.7;49.3
28;2021-07-23;2959;3998;259344;215878;60.4;50.3
28;2021-07-24;1715;1484;261059;217362;60.8;50.6
28;2021-07-25;67;60;261126;217422;60.8;50.6
28;2021-07-26;2930;3387;264056;220809;61.5;51.4
28;2021-07-27;3885;2621;267941;223430;62.4;52.0
28;2021-07-28;3947;2745;271888;226175;63.3;52.7
28;2021-07-29;4466;2092;276354;228267;64.4;53.2
28;2021-07-30;3825;2848;280179;231115;65.2;53.8
28;2021-07-31;763;826;280942;231941;65.4;54.0
28;2021-08-01;378;65;281320;232006;65.5;54.0
28;2021-08-02;1793;1520;283113;233526;65.9;54.4
28;2021-08-03;2684;2167;285797;235693;66.6;54.9
28;2021-08-04;1932;2303;287729;237996;67.0;55.4
28;2021-08-05;1663;1731;289392;239727;67.4;55.8
28;2021-08-06;1618;1969;291010;241696;67.8;56.3
28;2021-08-07;798;1002;291808;242698;68.0;56.5
28;2021-08-08;22;33;291830;242731;68.0;56.5
28;2021-08-09;1388;1102;293218;243833;68.3;56.8
28;2021-08-10;1714;2027;294932;245860;68.7;57.3
28;2021-08-11;1273;1572;296205;247432;69.0;57.6
28;2021-08-12;1165;1881;297370;249313;69.2;58.1
28;2021-08-13;1321;1649;298691;250962;69.6;58.4
28;2021-08-14;659;844;299350;251806;69.7;58.6
28;2021-08-15;264;59;299614;251865;69.8;58.7
28;2021-08-16;862;2145;300476;254010;70.0;59.2
28;2021-08-17;1126;2798;301602;256808;70.2;59.8
28;2021-08-18;891;2412;302493;259220;70.4;60.4
28;2021-08-19;889;2616;303382;261836;70.6;61.0
28;2021-08-20;939;2753;304321;264589;70.9;61.6
28;2021-08-21;381;1001;304702;265590;71.0;61.8
28;2021-08-22;9;31;304711;265621;71.0;61.9
28;2021-08-23;1041;2149;305752;267770;71.2;62.4
28;2021-08-24;867;2582;306619;270352;71.4;63.0
28;2021-08-25;1075;2208;307694;272560;71.7;63.5
28;2021-08-26;701;1817;308395;274377;71.8;63.9
28;2021-08-27;749;2369;309144;276746;72.0;64.4
28;2021-08-28;524;1098;309668;277844;72.1;64.7
28;2021-08-29;7;23;309675;277867;72.1;64.7
28;2021-08-30;994;2164;310669;280031;72.3;65.2
28;2021-08-31;798;2186;311467;282217;72.5;65.7
28;2021-09-01;748;2433;312215;284650;72.7;66.3
28;2021-09-02;542;1958;312757;286608;72.8;66.7
28;2021-09-03;665;2365;313422;288973;73.0;67.3
28;2021-09-04;585;2503;314007;291476;73.1;67.9
28;2021-09-05;210;139;314217;291615;73.2;67.9
28;2021-09-06;405;1388;314622;293003;73.3;68.2
28;2021-09-07;352;1299;314974;294302;73.3;68.5
28;2021-09-08;544;1425;315518;295727;73.5;68.9
28;2021-09-09;319;982;315837;296709;73.5;69.1
28;2021-09-10;591;1417;316428;298126;73.7;69.4
28;2021-09-11;298;1257;316726;299383;73.8;69.7
28;2021-09-12;40;28;316766;299411;73.8;69.7
28;2021-09-13;312;735;317078;300146;73.8;69.9
28;2021-09-14;322;941;317400;301087;73.9;70.1
28;2021-09-15;526;1027;317926;302114;74.0;70.4
28;2021-09-16;252;689;318178;302803;74.1;70.5
28;2021-09-17;301;1046;318479;303849;74.2;70.8
28;2021-09-18;124;237;318603;304086;74.2;70.8
28;2021-09-19;7;17;318610;304103;74.2;70.8
28;2021-09-20;154;459;318764;304562;74.2;70.9
28;2021-09-21;392;935;319156;305497;74.3;71.1
28;2021-09-22;328;1067;319484;306564;74.4;71.4
28;2021-09-23;190;507;319674;307071;74.4;71.5
28;2021-09-24;255;969;319929;308040;74.5;71.7
28;2021-09-25;99;326;320028;308366;74.5;71.8
28;2021-09-26;21;34;320049;308400;74.5;71.8
28;2021-09-27;167;665;320216;309065;74.6;72.0
28;2021-09-28;172;440;320388;309505;74.6;72.1
28;2021-09-29;352;687;320740;310192;74.7;72.2
28;2021-09-30;234;451;320974;310643;74.7;72.3
28;2021-10-01;250;725;321224;311368;74.8;72.5
28;2021-10-02;76;151;321300;311519;74.8;72.5
28;2021-10-03;0;6;321300;311525;74.8;72.5
28;2021-10-04;132;255;321432;311780;74.9;72.6
28;2021-10-05;159;369;321591;312149;74.9;72.7
28;2021-10-06;198;608;321789;312757;74.9;72.8
28;2021-10-07;130;272;321919;313029;75.0;72.9
28;2021-10-08;254;464;322173;313493;75.0;73.0
28;2021-10-09;75;142;322248;313635;75.0;73.0
28;2021-10-10;10;12;322258;313647;75.0;73.0
28;2021-10-11;158;223;322416;313870;75.1;73.1
29;2020-12-27;0;0;0;0;0.0;0.0
29;2020-12-28;1;1;1;1;0.0;0.0
29;2020-12-29;0;0;1;1;0.0;0.0
29;2020-12-30;0;0;1;1;0.0;0.0
29;2020-12-31;0;0;1;1;0.0;0.0
29;2021-01-01;3;0;4;1;0.0;0.0
29;2021-01-02;2;0;6;1;0.0;0.0
29;2021-01-03;1;0;7;1;0.0;0.0
29;2021-01-04;33;0;40;1;0.0;0.0
29;2021-01-05;32;0;72;1;0.0;0.0
29;2021-01-06;43;0;115;1;0.0;0.0
29;2021-01-07;139;0;254;1;0.0;0.0
29;2021-01-08;408;1;662;2;0.1;0.0
29;2021-01-09;2;0;664;2;0.1;0.0
29;2021-01-10;2;0;666;2;0.1;0.0
29;2021-01-11;668;0;1334;2;0.1;0.0
29;2021-01-12;1121;0;2455;2;0.3;0.0
29;2021-01-13;1101;2;3556;4;0.4;0.0
29;2021-01-14;895;4;4451;8;0.5;0.0
29;2021-01-15;1222;7;5673;15;0.6;0.0
29;2021-01-16;168;1;5841;16;0.6;0.0
29;2021-01-17;111;1;5952;17;0.7;0.0
29;2021-01-18;842;6;6794;23;0.7;0.0
29;2021-01-19;1314;3;8108;26;0.9;0.0
29;2021-01-20;2393;3;10501;29;1.2;0.0
29;2021-01-21;5660;16;16161;45;1.8;0.0
29;2021-01-22;3807;8;19968;53;2.2;0.0
29;2021-01-23;539;0;20507;53;2.3;0.0
29;2021-01-24;200;1;20707;54;2.3;0.0
29;2021-01-25;573;7;21280;61;2.3;0.0
29;2021-01-26;951;34;22231;95;2.5;0.0
29;2021-01-27;1286;53;23517;148;2.6;0.0
29;2021-01-28;803;137;24320;285;2.7;0.0
29;2021-01-29;781;205;25101;490;2.8;0.1
29;2021-01-30;282;4;25383;494;2.8;0.1
29;2021-01-31;80;5;25463;499;2.8;0.1
29;2021-02-01;429;448;25892;947;2.9;0.1
29;2021-02-02;879;825;26771;1772;3.0;0.2
29;2021-02-03;810;895;27581;2667;3.0;0.3
29;2021-02-04;870;644;28451;3311;3.1;0.4
29;2021-02-05;676;584;29127;3895;3.2;0.4
29;2021-02-06;249;104;29376;3999;3.2;0.4
29;2021-02-07;78;104;29454;4103;3.2;0.5
29;2021-02-08;384;445;29838;4548;3.3;0.5
29;2021-02-09;864;852;30702;5400;3.4;0.6
29;2021-02-10;1150;1017;31852;6417;3.5;0.7
29;2021-02-11;1802;4163;33654;10580;3.7;1.2
29;2021-02-12;2328;2502;35982;13082;4.0;1.4
29;2021-02-13;639;413;36621;13495;4.0;1.5
29;2021-02-14;12;228;36633;13723;4.0;1.5
29;2021-02-15;267;945;36900;14668;4.1;1.6
29;2021-02-16;887;1054;37787;15722;4.2;1.7
29;2021-02-17;800;851;38587;16573;4.3;1.8
29;2021-02-18;1530;844;40117;17417;4.4;1.9
29;2021-02-19;1417;1008;41534;18425;4.6;2.0
29;2021-02-20;204;366;41738;18791;4.6;2.1
29;2021-02-21;163;167;41901;18958;4.6;2.1
29;2021-02-22;773;560;42674;19518;4.7;2.2
29;2021-02-23;1270;904;43944;20422;4.8;2.3
29;2021-02-24;1472;826;45416;21248;5.0;2.3
29;2021-02-25;2511;909;47927;22157;5.3;2.4
29;2021-02-26;2678;717;50605;22874;5.6;2.5
29;2021-02-27;1285;280;51890;23154;5.7;2.6
29;2021-02-28;200;73;52090;23227;5.7;2.6
29;2021-03-01;947;480;53037;23707;5.9;2.6
29;2021-03-02;1816;798;54853;24505;6.1;2.7
29;2021-03-03;2094;1021;56947;25526;6.3;2.8
29;2021-03-04;2843;1557;59790;27083;6.6;3.0
29;2021-03-05;3539;1685;63329;28768;7.0;3.2
29;2021-03-06;2000;441;65329;29209;7.2;3.2
29;2021-03-07;412;83;65741;29292;7.3;3.2
29;2021-03-08;1273;594;67014;29886;7.4;3.3
29;2021-03-09;2603;977;69617;30863;7.7;3.4
29;2021-03-10;2426;871;72043;31734;7.9;3.5
29;2021-03-11;4520;1006;76563;32740;8.4;3.6
29;2021-03-12;5272;973;81835;33713;9.0;3.7
29;2021-03-13;2825;414;84660;34127;9.3;3.8
29;2021-03-14;367;3;85027;34130;9.4;3.8
29;2021-03-15;2050;272;87077;34402;9.6;3.8
29;2021-03-16;1825;748;88902;35150;9.8;3.9
29;2021-03-17;1862;716;90764;35866;10.0;4.0
29;2021-03-18;1866;1038;92630;36904;10.2;4.1
29;2021-03-19;3270;885;95900;37789;10.6;4.2
29;2021-03-20;1914;225;97814;38014;10.8;4.2
29;2021-03-21;132;11;97946;38025;10.8;4.2
29;2021-03-22;1647;559;99593;38584;11.0;4.3
29;2021-03-23;3443;1042;103036;39626;11.4;4.4
29;2021-03-24;3781;1025;106817;40651;11.8;4.5
29;2021-03-25;4822;1078;111639;41729;12.3;4.6
29;2021-03-26;5423;1172;117062;42901;12.9;4.7
29;2021-03-27;2429;335;119491;43236;13.2;4.8
29;2021-03-28;198;50;119689;43286;13.2;4.8
29;2021-03-29;2042;825;121731;44111;13.4;4.9
29;2021-03-30;3976;1334;125707;45445;13.9;5.0
29;2021-03-31;3937;1162;129644;46607;14.3;5.1
29;2021-04-01;5028;1153;134672;47760;14.9;5.3
29;2021-04-02;4765;1172;139437;48932;15.4;5.4
29;2021-04-03;2500;538;141937;49470;15.7;5.5
29;2021-04-04;146;33;142083;49503;15.7;5.5
29;2021-04-05;972;333;143055;49836;15.8;5.5
29;2021-04-06;3198;1246;146253;51082;16.1;5.6
29;2021-04-07;3653;944;149906;52026;16.5;5.7
29;2021-04-08;5285;2058;155191;54084;17.1;6.0
29;2021-04-09;6759;1570;161950;55654;17.9;6.1
29;2021-04-10;3504;714;165454;56368;18.3;6.2
29;2021-04-11;120;80;165574;56448;18.3;6.2
29;2021-04-12;3853;1486;169427;57934;18.7;6.4
29;2021-04-13;5865;1764;175292;59698;19.3;6.6
29;2021-04-14;4759;1745;180051;61443;19.9;6.8
29;2021-04-15;7174;1734;187225;63177;20.7;7.0
29;2021-04-16;6703;1358;193928;64535;21.4;7.1
29;2021-04-17;3829;971;197757;65506;21.8;7.2
29;2021-04-18;489;41;198246;65547;21.9;7.2
29;2021-04-19;3881;1466;202127;67013;22.3;7.4
29;2021-04-20;4397;2137;206524;69150;22.8;7.6
29;2021-04-21;4378;2199;210902;71349;23.3;7.9
29;2021-04-22;6638;2857;217540;74206;24.0;8.2
29;2021-04-23;6050;2210;223590;76416;24.7;8.4
29;2021-04-24;4008;1323;227598;77739;25.1;8.6
29;2021-04-25;435;172;228033;77911;25.2;8.6
29;2021-04-26;5260;1882;233293;79793;25.7;8.8
29;2021-04-27;5336;3198;238629;82991;26.3;9.2
29;2021-04-28;5359;2913;243988;85904;26.9;9.5
29;2021-04-29;6594;3353;250582;89257;27.6;9.8
29;2021-04-30;6265;3909;256847;93166;28.3;10.3
29;2021-05-01;1986;981;258833;94147;28.6;10.4
29;2021-05-02;1249;196;260082;94343;28.7;10.4
29;2021-05-03;4539;2293;264621;96636;29.2;10.7
29;2021-05-04;4107;3741;268728;100377;29.6;11.1
29;2021-05-05;4524;3413;273252;103790;30.1;11.4
29;2021-05-06;6239;3727;279491;107517;30.8;11.9
29;2021-05-07;5985;4624;285476;112141;31.5;12.4
29;2021-05-08;2097;564;287573;112705;31.7;12.4
29;2021-05-09;1731;141;289304;112846;31.9;12.4
29;2021-05-10;4767;3770;294071;116616;32.4;12.9
29;2021-05-11;4708;4999;298779;121615;33.0;13.4
29;2021-05-12;5023;4381;303802;125996;33.5;13.9
29;2021-05-13;3441;1500;307243;127496;33.9;14.1
29;2021-05-14;5649;4001;312892;131497;34.5;14.5
29;2021-05-15;4049;2312;316941;133809;35.0;14.8
29;2021-05-16;1588;294;318529;134103;35.1;14.8
29;2021-05-17;5562;3130;324091;137233;35.7;15.1
29;2021-05-18;5732;3097;329823;140330;36.4;15.5
29;2021-05-19;6214;2970;336037;143300;37.1;15.8
29;2021-05-20;7172;4568;343209;147868;37.9;16.3
29;2021-05-21;7210;3813;350419;151681;38.7;16.7
29;2021-05-22;5342;2128;355761;153809;39.2;17.0
29;2021-05-23;1631;65;357392;153874;39.4;17.0
29;2021-05-24;3485;534;360877;154408;39.8;17.0
29;2021-05-25;5835;3042;366712;157450;40.5;17.4
29;2021-05-26;5889;2996;372601;160446;41.1;17.7
29;2021-05-27;6825;3986;379426;164432;41.9;18.1
29;2021-05-28;6544;4448;385970;168880;42.6;18.6
29;2021-05-29;4382;2808;390352;171688;43.1;18.9
29;2021-05-30;1113;360;391465;172048;43.2;19.0
29;2021-05-31;6384;3458;397849;175506;43.9;19.4
29;2021-06-01;6603;4351;404452;179857;44.6;19.8
29;2021-06-02;6162;4132;410614;183989;45.3;20.3
29;2021-06-03;7689;4525;418303;188514;46.1;20.8
29;2021-06-04;6812;6165;425115;194679;46.9;21.5
29;2021-06-05;5350;3037;430465;197716;47.5;21.8
29;2021-06-06;1284;538;431749;198254;47.6;21.9
29;2021-06-07;4659;5564;436408;203818;48.1;22.5
29;2021-06-08;7172;5210;443580;209028;48.9;23.1
29;2021-06-09;6404;4753;449984;213781;49.6;23.6
29;2021-06-10;7775;5063;457759;218844;50.5;24.1
29;2021-06-11;8473;5875;466232;224719;51.4;24.8
29;2021-06-12;6562;2817;472794;227536;52.2;25.1
29;2021-06-13;2351;1372;475145;228908;52.4;25.3
29;2021-06-14;4034;6319;479179;235227;52.9;25.9
29;2021-06-15;5477;6181;484656;241408;53.5;26.6
29;2021-06-16;5570;5630;490226;247038;54.1;27.3
29;2021-06-17;6370;6319;496596;253357;54.8;27.9
29;2021-06-18;6116;7492;502712;260849;55.5;28.8
29;2021-06-19;4619;3527;507331;264376;56.0;29.2
29;2021-06-20;891;1452;508222;265828;56.1;29.3
29;2021-06-21;3761;6495;511983;272323;56.5;30.0
29;2021-06-22;4490;6425;516473;278748;57.0;30.7
29;2021-06-23;4673;6132;521146;284880;57.5;31.4
29;2021-06-24;4810;6746;525956;291626;58.0;32.2
29;2021-06-25;3599;7533;529555;299159;58.4;33.0
29;2021-06-26;2131;4093;531686;303252;58.6;33.5
29;2021-06-27;967;1631;532653;304883;58.8;33.6
29;2021-06-28;2844;6862;535497;311745;59.1;34.4
29;2021-06-29;2813;7731;538310;319476;59.4;35.2
29;2021-06-30;3048;7510;541358;326986;59.7;36.1
29;2021-07-01;3790;8424;545148;335410;60.1;37.0
29;2021-07-02;3608;9669;548756;345079;60.5;38.1
29;2021-07-03;2327;6053;551083;351132;60.8;38.7
29;2021-07-04;814;1771;551897;352903;60.9;38.9
29;2021-07-05;1914;7157;553811;360060;61.1;39.7
29;2021-07-06;1543;8006;555354;368066;61.3;40.6
29;2021-07-07;1707;7040;557061;375106;61.4;41.4
29;2021-07-08;2454;8208;559515;383314;61.7;42.3
29;2021-07-09;2627;9069;562142;392383;62.0;43.3
29;2021-07-10;1917;6104;564059;398487;62.2;44.0
29;2021-07-11;449;1064;564508;399551;62.3;44.1
29;2021-07-12;1983;8376;566491;407927;62.5;45.0
29;2021-07-13;2754;8665;569245;416592;62.8;46.0
29;2021-07-14;2086;3372;571331;419964;63.0;46.3
29;2021-07-15;3859;9734;575190;429698;63.4;47.4
29;2021-07-16;4621;9200;579811;438898;64.0;48.4
29;2021-07-17;3223;6117;583034;445015;64.3;49.1
29;2021-07-18;668;1079;583702;446094;64.4;49.2
29;2021-07-19;3157;7545;586859;453639;64.7;50.0
29;2021-07-20;3556;9434;590415;463073;65.1;51.1
29;2021-07-21;3664;7711;594079;470784;65.5;51.9
29;2021-07-22;3429;8538;597508;479322;65.9;52.9
29;2021-07-23;4066;10707;601574;490029;66.4;54.1
29;2021-07-24;2536;5957;604110;495986;66.6;54.7
29;2021-07-25;655;2359;604765;498345;66.7;55.0
29;2021-07-26;3400;7281;608165;505626;67.1;55.8
29;2021-07-27;3721;7111;611886;512737;67.5;56.6
29;2021-07-28;4208;6036;616094;518773;68.0;57.2
29;2021-07-29;5706;6365;621800;525138;68.6;57.9
29;2021-07-30;5473;6538;627273;531676;69.2;58.6
29;2021-07-31;2939;4932;630212;536608;69.5;59.2
29;2021-08-01;659;921;630871;537529;69.6;59.3
29;2021-08-02;4308;5221;635179;542750;70.1;59.9
29;2021-08-03;5490;4410;640669;547160;70.7;60.4
29;2021-08-04;5744;3610;646413;550770;71.3;60.8
29;2021-08-05;6655;4111;653068;554881;72.0;61.2
29;2021-08-06;6217;4336;659285;559217;72.7;61.7
29;2021-08-07;4294;2960;663579;562177;73.2;62.0
29;2021-08-08;854;754;664433;562931;73.3;62.1
29;2021-08-09;3084;4741;667517;567672;73.6;62.6
29;2021-08-10;4494;3865;672011;571537;74.1;63.0
29;2021-08-11;3975;3189;675986;574726;74.6;63.4
29;2021-08-12;4652;4501;680638;579227;75.1;63.9
29;2021-08-13;4239;3720;684877;582947;75.5;64.3
29;2021-08-14;2968;2845;687845;585792;75.9;64.6
29;2021-08-15;338;405;688183;586197;75.9;64.7
29;2021-08-16;3289;4375;691472;590572;76.3;65.1
29;2021-08-17;4411;3421;695883;593993;76.8;65.5
29;2021-08-18;3685;3620;699568;597613;77.2;65.9
29;2021-08-19;3916;4719;703484;602332;77.6;66.4
29;2021-08-20;3512;4600;706996;606932;78.0;66.9
29;2021-08-21;2277;3164;709273;610096;78.2;67.3
29;2021-08-22;218;415;709491;610511;78.3;67.3
29;2021-08-23;2505;4627;711996;615138;78.5;67.9
29;2021-08-24;2468;4954;714464;620092;78.8;68.4
29;2021-08-25;2169;4230;716633;624322;79.1;68.9
29;2021-08-26;2362;5341;718995;629663;79.3;69.5
29;2021-08-27;2067;5914;721062;635577;79.5;70.1
29;2021-08-28;1475;4001;722537;639578;79.7;70.6
29;2021-08-29;453;1318;722990;640896;79.8;70.7
29;2021-08-30;1458;4158;724448;645054;79.9;71.2
29;2021-08-31;1631;4405;726079;649459;80.1;71.6
29;2021-09-01;1345;3756;727424;653215;80.2;72.1
29;2021-09-02;1176;4059;728600;657274;80.4;72.5
29;2021-09-03;1442;4765;730042;662039;80.5;73.0
29;2021-09-04;1419;3775;731461;665814;80.7;73.4
29;2021-09-05;227;687;731688;666501;80.7;73.5
29;2021-09-06;741;3351;732429;669852;80.8;73.9
29;2021-09-07;930;3448;733359;673300;80.9;74.3
29;2021-09-08;913;3435;734272;676735;81.0;74.6
29;2021-09-09;964;3459;735236;680194;81.1;75.0
29;2021-09-10;1200;4375;736436;684569;81.2;75.5
29;2021-09-11;733;3452;737169;688021;81.3;75.9
29;2021-09-12;117;410;737286;688431;81.3;75.9
29;2021-09-13;839;3235;738125;691666;81.4;76.3
29;2021-09-14;725;3010;738850;694676;81.5;76.6
29;2021-09-15;717;3225;739567;697901;81.6;77.0
29;2021-09-16;842;2789;740409;700690;81.7;77.3
29;2021-09-17;932;3243;741341;703933;81.8;77.6
29;2021-09-18;597;3449;741938;707382;81.8;78.0
29;2021-09-19;84;443;742022;707825;81.9;78.1
29;2021-09-20;491;2169;742513;709994;81.9;78.3
29;2021-09-21;474;1917;742987;711911;82.0;78.5
29;2021-09-22;365;2241;743352;714152;82.0;78.8
29;2021-09-23;466;1755;743818;715907;82.0;79.0
29;2021-09-24;485;2230;744303;718137;82.1;79.2
29;2021-09-25;340;2733;744643;720870;82.1;79.5
29;2021-09-26;56;239;744699;721109;82.1;79.5
29;2021-09-27;328;1638;745027;722747;82.2;79.7
29;2021-09-28;264;1567;745291;724314;82.2;79.9
29;2021-09-29;399;1677;745690;725991;82.3;80.1
29;2021-09-30;321;1327;746011;727318;82.3;80.2
29;2021-10-01;460;1536;746471;728854;82.3;80.4
29;2021-10-02;359;1674;746830;730528;82.4;80.6
29;2021-10-03;7;30;746837;730558;82.4;80.6
29;2021-10-04;298;1318;747135;731876;82.4;80.7
29;2021-10-05;238;1066;747373;732942;82.4;80.8
29;2021-10-06;302;1176;747675;734118;82.5;81.0
29;2021-10-07;315;916;747990;735034;82.5;81.1
29;2021-10-08;444;1268;748434;736302;82.6;81.2
29;2021-10-09;336;998;748770;737300;82.6;81.3
29;2021-10-10;5;12;748775;737312;82.6;81.3
29;2021-10-11;293;917;749068;738229;82.6;81.4
2A;2020-12-27;0;0;0;0;0.0;0.0
2A;2020-12-28;0;0;0;0;0.0;0.0
2A;2020-12-29;0;0;0;0;0.0;0.0
2A;2020-12-30;0;0;0;0;0.0;0.0
2A;2020-12-31;0;0;0;0;0.0;0.0
2A;2021-01-01;0;0;0;0;0.0;0.0
2A;2021-01-02;1;0;1;0;0.0;0.0
2A;2021-01-03;0;0;1;0;0.0;0.0
2A;2021-01-04;0;0;1;0;0.0;0.0
2A;2021-01-05;0;0;1;0;0.0;0.0
2A;2021-01-06;6;0;7;0;0.0;0.0
2A;2021-01-07;122;1;129;1;0.1;0.0
2A;2021-01-08;114;2;243;3;0.1;0.0
2A;2021-01-09;39;0;282;3;0.2;0.0
2A;2021-01-10;33;0;315;3;0.2;0.0
2A;2021-01-11;78;0;393;3;0.2;0.0
2A;2021-01-12;85;0;478;3;0.3;0.0
2A;2021-01-13;113;1;591;4;0.4;0.0
2A;2021-01-14;192;1;783;5;0.5;0.0
2A;2021-01-15;149;0;932;5;0.6;0.0
2A;2021-01-16;160;2;1092;7;0.7;0.0
2A;2021-01-17;86;1;1178;8;0.7;0.0
2A;2021-01-18;201;2;1379;10;0.8;0.0
2A;2021-01-19;488;5;1867;15;1.1;0.0
2A;2021-01-20;356;1;2223;16;1.4;0.0
2A;2021-01-21;453;1;2676;17;1.6;0.0
2A;2021-01-22;367;0;3043;17;1.9;0.0
2A;2021-01-23;183;0;3226;17;2.0;0.0
2A;2021-01-24;118;1;3344;18;2.1;0.0
2A;2021-01-25;215;0;3559;18;2.2;0.0
2A;2021-01-26;402;9;3961;27;2.4;0.0
2A;2021-01-27;325;7;4286;34;2.6;0.0
2A;2021-01-28;335;79;4621;113;2.8;0.1
2A;2021-01-29;342;63;4963;176;3.1;0.1
2A;2021-01-30;128;38;5091;214;3.1;0.1
2A;2021-01-31;92;12;5183;226;3.2;0.1
2A;2021-02-01;230;49;5413;275;3.3;0.2
2A;2021-02-02;288;118;5701;393;3.5;0.2
2A;2021-02-03;265;75;5966;468;3.7;0.3
2A;2021-02-04;256;123;6222;591;3.8;0.4
2A;2021-02-05;267;106;6489;697;4.0;0.4
2A;2021-02-06;121;60;6610;757;4.1;0.5
2A;2021-02-07;68;54;6678;811;4.1;0.5
2A;2021-02-08;92;210;6770;1021;4.2;0.6
2A;2021-02-09;128;302;6898;1323;4.2;0.8
2A;2021-02-10;167;237;7065;1560;4.3;1.0
2A;2021-02-11;299;363;7364;1923;4.5;1.2
2A;2021-02-12;345;302;7709;2225;4.7;1.4
2A;2021-02-13;225;60;7934;2285;4.9;1.4
2A;2021-02-14;135;79;8069;2364;5.0;1.5
2A;2021-02-15;198;182;8267;2546;5.1;1.6
2A;2021-02-16;384;320;8651;2866;5.3;1.8
2A;2021-02-17;298;168;8949;3034;5.5;1.9
2A;2021-02-18;340;199;9289;3233;5.7;2.0
2A;2021-02-19;145;298;9434;3531;5.8;2.2
2A;2021-02-20;243;138;9677;3669;6.0;2.3
2A;2021-02-21;58;54;9735;3723;6.0;2.3
2A;2021-02-22;77;215;9812;3938;6.0;2.4
2A;2021-02-23;122;289;9934;4227;6.1;2.6
2A;2021-02-24;82;297;10016;4524;6.2;2.8
2A;2021-02-25;104;265;10120;4789;6.2;2.9
2A;2021-02-26;123;272;10243;5061;6.3;3.1
2A;2021-02-27;308;70;10551;5131;6.5;3.2
2A;2021-02-28;69;66;10620;5197;6.5;3.2
2A;2021-03-01;117;152;10737;5349;6.6;3.3
2A;2021-03-02;199;265;10936;5614;6.7;3.5
2A;2021-03-03;249;258;11185;5872;6.9;3.6
2A;2021-03-04;508;227;11693;6099;7.2;3.8
2A;2021-03-05;973;291;12666;6390;7.8;3.9
2A;2021-03-06;1167;75;13833;6465;8.5;4.0
2A;2021-03-07;1021;48;14854;6513;9.1;4.0
2A;2021-03-08;933;93;15787;6606;9.7;4.1
2A;2021-03-09;938;153;16725;6759;10.3;4.2
2A;2021-03-10;634;141;17359;6900;10.7;4.2
2A;2021-03-11;723;281;18082;7181;11.1;4.4
2A;2021-03-12;562;318;18644;7499;11.5;4.6
2A;2021-03-13;613;199;19257;7698;11.9;4.7
2A;2021-03-14;312;126;19569;7824;12.0;4.8
2A;2021-03-15;377;204;19946;8028;12.3;4.9
2A;2021-03-16;498;371;20444;8399;12.6;5.2
2A;2021-03-17;703;278;21147;8677;13.0;5.3
2A;2021-03-18;447;304;21594;8981;13.3;5.5
2A;2021-03-19;489;160;22083;9141;13.6;5.6
2A;2021-03-20;1079;265;23162;9406;14.3;5.8
2A;2021-03-21;695;54;23857;9460;14.7;5.8
2A;2021-03-22;347;68;24204;9528;14.9;5.9
2A;2021-03-23;518;59;24722;9587;15.2;5.9
2A;2021-03-24;864;92;25586;9679;15.8;6.0
2A;2021-03-25;930;142;26516;9821;16.3;6.0
2A;2021-03-26;1080;166;27596;9987;17.0;6.1
2A;2021-03-27;1189;201;28785;10188;17.7;6.3
2A;2021-03-28;241;97;29026;10285;17.9;6.3
2A;2021-03-29;283;138;29309;10423;18.0;6.4
2A;2021-03-30;384;238;29693;10661;18.3;6.6
2A;2021-03-31;445;226;30138;10887;18.6;6.7
2A;2021-04-01;638;453;30776;11340;18.9;7.0
2A;2021-04-02;904;787;31680;12127;19.5;7.5
2A;2021-04-03;644;983;32324;13110;19.9;8.1
2A;2021-04-04;578;785;32902;13895;20.3;8.6
2A;2021-04-05;525;700;33427;14595;20.6;9.0
2A;2021-04-06;548;561;33975;15156;20.9;9.3
2A;2021-04-07;795;429;34770;15585;21.4;9.6
2A;2021-04-08;1047;358;35817;15943;22.1;9.8
2A;2021-04-09;935;399;36752;16342;22.6;10.1
2A;2021-04-10;1058;384;37810;16726;23.3;10.3
2A;2021-04-11;362;256;38172;16982;23.5;10.5
2A;2021-04-12;671;343;38843;17325;23.9;10.7
2A;2021-04-13;329;381;39172;17706;24.1;10.9
2A;2021-04-14;1045;591;40217;18297;24.8;11.3
2A;2021-04-15;1044;529;41261;18826;25.4;11.6
2A;2021-04-16;872;394;42133;19220;25.9;11.8
2A;2021-04-17;1369;938;43502;20158;26.8;12.4
2A;2021-04-18;981;949;44483;21107;27.4;13.0
2A;2021-04-19;270;343;44753;21450;27.6;13.2
2A;2021-04-20;354;344;45107;21794;27.8;13.4
2A;2021-04-21;729;736;45836;22530;28.2;13.9
2A;2021-04-22;897;649;46733;23179;28.8;14.3
2A;2021-04-23;986;779;47719;23958;29.4;14.8
2A;2021-04-24;1750;985;49469;24943;30.5;15.4
2A;2021-04-25;976;306;50445;25249;31.1;15.5
2A;2021-04-26;308;228;50753;25477;31.2;15.7
2A;2021-04-27;342;349;51095;25826;31.5;15.9
2A;2021-04-28;1676;426;52771;26252;32.5;16.2
2A;2021-04-29;1053;361;53824;26613;33.1;16.4
2A;2021-04-30;1131;1063;54955;27676;33.8;17.0
2A;2021-05-01;970;575;55925;28251;34.4;17.4
2A;2021-05-02;674;708;56599;28959;34.8;17.8
2A;2021-05-03;583;576;57182;29535;35.2;18.2
2A;2021-05-04;752;536;57934;30071;35.7;18.5
2A;2021-05-05;1011;985;58945;31056;36.3;19.1
2A;2021-05-06;904;911;59849;31967;36.8;19.7
2A;2021-05-07;1157;834;61006;32801;37.6;20.2
2A;2021-05-08;422;502;61428;33303;37.8;20.5
2A;2021-05-09;783;636;62211;33939;38.3;20.9
2A;2021-05-10;454;741;62665;34680;38.6;21.4
2A;2021-05-11;652;417;63317;35097;39.0;21.6
2A;2021-05-12;925;488;64242;35585;39.6;21.9
2A;2021-05-13;920;138;65162;35723;40.1;22.0
2A;2021-05-14;797;678;65959;36401;40.6;22.4
2A;2021-05-15;778;649;66737;37050;41.1;22.8
2A;2021-05-16;740;501;67477;37551;41.5;23.1
2A;2021-05-17;584;558;68061;38109;41.9;23.5
2A;2021-05-18;614;475;68675;38584;42.3;23.8
2A;2021-05-19;787;481;69462;39065;42.8;24.1
2A;2021-05-20;692;539;70154;39604;43.2;24.4
2A;2021-05-21;536;483;70690;40087;43.5;24.7
2A;2021-05-22;440;310;71130;40397;43.8;24.9
2A;2021-05-23;533;284;71663;40681;44.1;25.0
2A;2021-05-24;125;33;71788;40714;44.2;25.1
2A;2021-05-25;421;503;72209;41217;44.5;25.4
2A;2021-05-26;425;1166;72634;42383;44.7;26.1
2A;2021-05-27;435;1111;73069;43494;45.0;26.8
2A;2021-05-28;298;915;73367;44409;45.2;27.3
2A;2021-05-29;334;900;73701;45309;45.4;27.9
2A;2021-05-30;181;507;73882;45816;45.5;28.2
2A;2021-05-31;191;413;74073;46229;45.6;28.5
2A;2021-06-01;342;727;74415;46956;45.8;28.9
2A;2021-06-02;285;940;74700;47896;46.0;29.5
2A;2021-06-03;306;850;75006;48746;46.2;30.0
2A;2021-06-04;271;1091;75277;49837;46.3;30.7
2A;2021-06-05;319;1443;75596;51280;46.5;31.6
2A;2021-06-06;173;907;75769;52187;46.6;32.1
2A;2021-06-07;171;658;75940;52845;46.8;32.5
2A;2021-06-08;324;706;76264;53551;47.0;33.0
2A;2021-06-09;304;1320;76568;54871;47.1;33.8
2A;2021-06-10;329;857;76897;55728;47.3;34.3
2A;2021-06-11;277;1021;77174;56749;47.5;34.9
2A;2021-06-12;232;665;77406;57414;47.7;35.3
2A;2021-06-13;189;797;77595;58211;47.8;35.8
2A;2021-06-14;251;922;77846;59133;47.9;36.4
2A;2021-06-15;217;507;78063;59640;48.1;36.7
2A;2021-06-16;213;776;78276;60416;48.2;37.2
2A;2021-06-17;235;591;78511;61007;48.3;37.6
2A;2021-06-18;246;912;78757;61919;48.5;38.1
2A;2021-06-19;208;689;78965;62608;48.6;38.5
2A;2021-06-20;150;692;79115;63300;48.7;39.0
2A;2021-06-21;184;795;79299;64095;48.8;39.5
2A;2021-06-22;236;841;79535;64936;49.0;40.0
2A;2021-06-23;217;568;79752;65504;49.1;40.3
2A;2021-06-24;149;369;79901;65873;49.2;40.6
2A;2021-06-25;167;470;80068;66343;49.3;40.8
2A;2021-06-26;203;872;80271;67215;49.4;41.4
2A;2021-06-27;175;794;80446;68009;49.5;41.9
2A;2021-06-28;194;704;80640;68713;49.6;42.3
2A;2021-06-29;216;689;80856;69402;49.8;42.7
2A;2021-06-30;245;494;81101;69896;49.9;43.0
2A;2021-07-01;211;484;81312;70380;50.1;43.3
2A;2021-07-02;294;368;81606;70748;50.2;43.6
2A;2021-07-03;211;617;81817;71365;50.4;43.9
2A;2021-07-04;179;664;81996;72029;50.5;44.3
2A;2021-07-05;164;235;82160;72264;50.6;44.5
2A;2021-07-06;252;389;82412;72653;50.7;44.7
2A;2021-07-07;433;611;82845;73264;51.0;45.1
2A;2021-07-08;592;705;83437;73969;51.4;45.5
2A;2021-07-09;384;420;83821;74389;51.6;45.8
2A;2021-07-10;281;346;84102;74735;51.8;46.0
2A;2021-07-11;92;161;84194;74896;51.8;46.1
2A;2021-07-12;317;348;84511;75244;52.0;46.3
2A;2021-07-13;1178;535;85689;75779;52.8;46.7
2A;2021-07-14;1623;342;87312;76121;53.8;46.9
2A;2021-07-15;1436;836;88748;76957;54.6;47.4
2A;2021-07-16;1168;467;89916;77424;55.4;47.7
2A;2021-07-17;1096;348;91012;77772;56.0;47.9
2A;2021-07-18;635;136;91647;77908;56.4;48.0
2A;2021-07-19;918;430;92565;78338;57.0;48.2
2A;2021-07-20;1283;475;93848;78813;57.8;48.5
2A;2021-07-21;1426;725;95274;79538;58.7;49.0
2A;2021-07-22;1400;767;96674;80305;59.5;49.4
2A;2021-07-23;1439;463;98113;80768;60.4;49.7
2A;2021-07-24;896;290;99009;81058;61.0;49.9
2A;2021-07-25;451;81;99460;81139;61.2;50.0
2A;2021-07-26;1198;507;100658;81646;62.0;50.3
2A;2021-07-27;1297;520;101955;82166;62.8;50.6
2A;2021-07-28;1199;593;103154;82759;63.5;51.0
2A;2021-07-29;1230;656;104384;83415;64.3;51.4
2A;2021-07-30;961;610;105345;84025;64.9;51.7
2A;2021-07-31;548;340;105893;84365;65.2;51.9
2A;2021-08-01;570;124;106463;84489;65.5;52.0
2A;2021-08-02;451;494;106914;84983;65.8;52.3
2A;2021-08-03;814;881;107728;85864;66.3;52.9
2A;2021-08-04;724;1161;108452;87025;66.8;53.6
2A;2021-08-05;956;1348;109408;88373;67.4;54.4
2A;2021-08-06;390;815;109798;89188;67.6;54.9
2A;2021-08-07;352;888;110150;90076;67.8;55.5
2A;2021-08-08;78;185;110228;90261;67.9;55.6
2A;2021-08-09;663;1142;110891;91403;68.3;56.3
2A;2021-08-10;642;1209;111533;92612;68.7;57.0
2A;2021-08-11;593;1064;112126;93676;69.0;57.7
2A;2021-08-12;742;1491;112868;95167;69.5;58.6
2A;2021-08-13;486;1066;113354;96233;69.8;59.2
2A;2021-08-14;414;766;113768;96999;70.0;59.7
2A;2021-08-15;27;26;113795;97025;70.1;59.7
2A;2021-08-16;481;1292;114276;98317;70.4;60.5
2A;2021-08-17;940;1557;115216;99874;70.9;61.5
2A;2021-08-18;525;1123;115741;100997;71.3;62.2
2A;2021-08-19;431;1010;116172;102007;71.5;62.8
2A;2021-08-20;328;574;116500;102581;71.7;63.2
2A;2021-08-21;240;535;116740;103116;71.9;63.5
2A;2021-08-22;197;617;116937;103733;72.0;63.9
2A;2021-08-23;325;744;117262;104477;72.2;64.3
2A;2021-08-24;326;858;117588;105335;72.4;64.9
2A;2021-08-25;401;881;117989;106216;72.6;65.4
2A;2021-08-26;342;769;118331;106985;72.9;65.9
2A;2021-08-27;245;716;118576;107701;73.0;66.3
2A;2021-08-28;256;352;118832;108053;73.2;66.5
2A;2021-08-29;97;115;118929;108168;73.2;66.6
2A;2021-08-30;244;605;119173;108773;73.4;67.0
2A;2021-08-31;172;493;119345;109266;73.5;67.3
2A;2021-09-01;344;758;119689;110024;73.7;67.7
2A;2021-09-02;314;610;120003;110634;73.9;68.1
2A;2021-09-03;243;457;120246;111091;74.0;68.4
2A;2021-09-04;151;404;120397;111495;74.1;68.6
2A;2021-09-05;29;23;120426;111518;74.1;68.7
2A;2021-09-06;111;342;120537;111860;74.2;68.9
2A;2021-09-07;191;630;120728;112490;74.3;69.3
2A;2021-09-08;221;651;120949;113141;74.5;69.7
2A;2021-09-09;211;461;121160;113602;74.6;69.9
2A;2021-09-10;155;344;121315;113946;74.7;70.2
2A;2021-09-11;135;282;121450;114228;74.8;70.3
2A;2021-09-12;41;81;121491;114309;74.8;70.4
2A;2021-09-13;101;181;121592;114490;74.9;70.5
2A;2021-09-14;227;232;121819;114722;75.0;70.6
2A;2021-09-15;191;541;122010;115263;75.1;71.0
2A;2021-09-16;214;366;122224;115629;75.3;71.2
2A;2021-09-17;134;176;122358;115805;75.3;71.3
2A;2021-09-18;104;302;122462;116107;75.4;71.5
2A;2021-09-19;10;49;122472;116156;75.4;71.5
2A;2021-09-20;37;130;122509;116286;75.4;71.6
2A;2021-09-21;89;246;122598;116532;75.5;71.7
2A;2021-09-22;99;448;122697;116980;75.5;72.0
2A;2021-09-23;90;325;122787;117305;75.6;72.2
2A;2021-09-24;59;259;122846;117564;75.6;72.4
2A;2021-09-25;63;143;122909;117707;75.7;72.5
2A;2021-09-26;10;29;122919;117736;75.7;72.5
2A;2021-09-27;43;104;122962;117840;75.7;72.6
2A;2021-09-28;102;172;123064;118012;75.8;72.7
2A;2021-09-29;108;297;123172;118309;75.8;72.8
2A;2021-09-30;74;209;123246;118518;75.9;73.0
2A;2021-10-01;81;119;123327;118637;75.9;73.0
2A;2021-10-02;78;137;123405;118774;76.0;73.1
2A;2021-10-03;18;33;123423;118807;76.0;73.1
2A;2021-10-04;44;81;123467;118888;76.0;73.2
2A;2021-10-05;38;114;123505;119002;76.0;73.3
2A;2021-10-06;56;119;123561;119121;76.1;73.3
2A;2021-10-07;56;111;123617;119232;76.1;73.4
2A;2021-10-08;50;135;123667;119367;76.1;73.5
2A;2021-10-09;78;263;123745;119630;76.2;73.7
2A;2021-10-10;71;80;123816;119710;76.2;73.7
2A;2021-10-11;32;68;123848;119778;76.3;73.7
2B;2020-12-27;0;0;0;0;0.0;0.0
2B;2020-12-28;0;0;0;0;0.0;0.0
2B;2020-12-29;0;0;0;0;0.0;0.0
2B;2020-12-30;0;0;0;0;0.0;0.0
2B;2020-12-31;0;0;0;0;0.0;0.0
2B;2021-01-01;0;0;0;0;0.0;0.0
2B;2021-01-02;0;0;0;0;0.0;0.0
2B;2021-01-03;0;0;0;0;0.0;0.0
2B;2021-01-04;2;0;2;0;0.0;0.0
2B;2021-01-05;0;0;2;0;0.0;0.0
2B;2021-01-06;48;1;50;1;0.0;0.0
2B;2021-01-07;210;0;260;1;0.1;0.0
2B;2021-01-08;197;3;457;4;0.3;0.0
2B;2021-01-09;40;0;497;4;0.3;0.0
2B;2021-01-10;1;0;498;4;0.3;0.0
2B;2021-01-11;74;0;572;4;0.3;0.0
2B;2021-01-12;128;1;700;5;0.4;0.0
2B;2021-01-13;93;0;793;5;0.4;0.0
2B;2021-01-14;72;0;865;5;0.5;0.0
2B;2021-01-15;259;2;1124;7;0.6;0.0
2B;2021-01-16;44;0;1168;7;0.6;0.0
2B;2021-01-17;8;0;1176;7;0.6;0.0
2B;2021-01-18;271;1;1447;8;0.8;0.0
2B;2021-01-19;507;1;1954;9;1.1;0.0
2B;2021-01-20;462;3;2416;12;1.3;0.0
2B;2021-01-21;358;0;2774;12;1.5;0.0
2B;2021-01-22;382;1;3156;13;1.7;0.0
2B;2021-01-23;61;0;3217;13;1.8;0.0
2B;2021-01-24;29;0;3246;13;1.8;0.0
2B;2021-01-25;210;2;3456;15;1.9;0.0
2B;2021-01-26;392;1;3848;16;2.1;0.0
2B;2021-01-27;341;48;4189;64;2.3;0.0
2B;2021-01-28;365;146;4554;210;2.5;0.1
2B;2021-01-29;296;162;4850;372;2.7;0.2
2B;2021-01-30;80;33;4930;405;2.7;0.2
2B;2021-01-31;60;0;4990;405;2.7;0.2
2B;2021-02-01;233;94;5223;499;2.9;0.3
2B;2021-02-02;358;78;5581;577;3.1;0.3
2B;2021-02-03;520;91;6101;668;3.3;0.4
2B;2021-02-04;458;173;6559;841;3.6;0.5
2B;2021-02-05;394;95;6953;936;3.8;0.5
2B;2021-02-06;87;14;7040;950;3.9;0.5
2B;2021-02-07;60;0;7100;950;3.9;0.5
2B;2021-02-08;231;153;7331;1103;4.0;0.6
2B;2021-02-09;586;313;7917;1416;4.3;0.8
2B;2021-02-10;485;196;8402;1612;4.6;0.9
2B;2021-02-11;382;129;8784;1741;4.8;1.0
2B;2021-02-12;299;125;9083;1866;5.0;1.0
2B;2021-02-13;77;13;9160;1879;5.0;1.0
2B;2021-02-14;62;1;9222;1880;5.1;1.0
2B;2021-02-15;190;128;9412;2008;5.2;1.1
2B;2021-02-16;249;287;9661;2295;5.3;1.3
2B;2021-02-17;312;318;9973;2613;5.5;1.4
2B;2021-02-18;215;347;10188;2960;5.6;1.6
2B;2021-02-19;163;306;10351;3266;5.7;1.8
2B;2021-02-20;32;62;10383;3328;5.7;1.8
2B;2021-02-21;28;29;10411;3357;5.7;1.8
2B;2021-02-22;133;188;10544;3545;5.8;1.9
2B;2021-02-23;232;355;10776;3900;5.9;2.1
2B;2021-02-24;229;310;11005;4210;6.0;2.3
2B;2021-02-25;245;340;11250;4550;6.2;2.5
2B;2021-02-26;301;282;11551;4832;6.3;2.7
2B;2021-02-27;60;85;11611;4917;6.4;2.7
2B;2021-02-28;1;57;11612;4974;6.4;2.7
2B;2021-03-01;246;261;11858;5235;6.5;2.9
2B;2021-03-02;352;390;12210;5625;6.7;3.1
2B;2021-03-03;299;434;12509;6059;6.9;3.3
2B;2021-03-04;447;409;12956;6468;7.1;3.5
2B;2021-03-05;619;384;13575;6852;7.4;3.8
2B;2021-03-06;682;101;14257;6953;7.8;3.8
2B;2021-03-07;361;60;14618;7013;8.0;3.8
2B;2021-03-08;301;240;14919;7253;8.2;4.0
2B;2021-03-09;384;506;15303;7759;8.4;4.3
2B;2021-03-10;631;447;15934;8206;8.7;4.5
2B;2021-03-11;585;355;16519;8561;9.1;4.7
2B;2021-03-12;967;231;17486;8792;9.6;4.8
2B;2021-03-13;511;110;17997;8902;9.9;4.9
2B;2021-03-14;226;64;18223;8966;10.0;4.9
2B;2021-03-15;516;202;18739;9168;10.3;5.0
2B;2021-03-16;571;279;19310;9447;10.6;5.2
2B;2021-03-17;530;263;19840;9710;10.9;5.3
2B;2021-03-18;551;230;20391;9940;11.2;5.5
2B;2021-03-19;805;195;21196;10135;11.6;5.6
2B;2021-03-20;656;38;21852;10173;12.0;5.6
2B;2021-03-21;428;37;22280;10210;12.2;5.6
2B;2021-03-22;546;126;22826;10336;12.5;5.7
2B;2021-03-23;788;260;23614;10596;13.0;5.8
2B;2021-03-24;832;215;24446;10811;13.4;5.9
2B;2021-03-25;825;164;25271;10975;13.9;6.0
2B;2021-03-26;958;191;26229;11166;14.4;6.1
2B;2021-03-27;1092;40;27321;11206;15.0;6.1
2B;2021-03-28;830;126;28151;11332;15.4;6.2
2B;2021-03-29;745;181;28896;11513;15.9;6.3
2B;2021-03-30;971;333;29867;11846;16.4;6.5
2B;2021-03-31;981;266;30848;12112;16.9;6.6
2B;2021-04-01;1003;230;31851;12342;17.5;6.8
2B;2021-04-02;966;414;32817;12756;18.0;7.0
2B;2021-04-03;1247;154;34064;12910;18.7;7.1
2B;2021-04-04;197;61;34261;12971;18.8;7.1
2B;2021-04-05;109;113;34370;13084;18.9;7.2
2B;2021-04-06;1032;362;35402;13446;19.4;7.4
2B;2021-04-07;1231;431;36633;13877;20.1;7.6
2B;2021-04-08;1128;409;37761;14286;20.7;7.8
2B;2021-04-09;1166;568;38927;14854;21.4;8.1
2B;2021-04-10;1352;267;40279;15121;22.1;8.3
2B;2021-04-11;815;65;41094;15186;22.5;8.3
2B;2021-04-12;853;559;41947;15745;23.0;8.6
2B;2021-04-13;1063;632;43010;16377;23.6;9.0
2B;2021-04-14;1046;494;44056;16871;24.2;9.3
2B;2021-04-15;886;520;44942;17391;24.7;9.5
2B;2021-04-16;910;649;45852;18040;25.2;9.9
2B;2021-04-17;386;447;46238;18487;25.4;10.1
2B;2021-04-18;253;343;46491;18830;25.5;10.3
2B;2021-04-19;822;438;47313;19268;26.0;10.6
2B;2021-04-20;898;846;48211;20114;26.5;11.0
2B;2021-04-21;1055;610;49266;20724;27.0;11.4
2B;2021-04-22;937;734;50203;21458;27.5;11.8
2B;2021-04-23;662;630;50865;22088;27.9;12.1
2B;2021-04-24;288;772;51153;22860;28.1;12.5
2B;2021-04-25;285;477;51438;23337;28.2;12.8
2B;2021-04-26;708;921;52146;24258;28.6;13.3
2B;2021-04-27;966;876;53112;25134;29.1;13.8
2B;2021-04-28;918;865;54030;25999;29.6;14.3
2B;2021-04-29;925;873;54955;26872;30.2;14.7
2B;2021-04-30;1133;832;56088;27704;30.8;15.2
2B;2021-05-01;460;1116;56548;28820;31.0;15.8
2B;2021-05-02;335;245;56883;29065;31.2;15.9
2B;2021-05-03;1017;496;57900;29561;31.8;16.2
2B;2021-05-04;811;1154;58711;30715;32.2;16.9
2B;2021-05-05;800;1377;59511;32092;32.7;17.6
2B;2021-05-06;1285;905;60796;32997;33.4;18.1
2B;2021-05-07;1062;990;61858;33987;33.9;18.6
2B;2021-05-08;459;853;62317;34840;34.2;19.1
2B;2021-05-09;392;683;62709;35523;34.4;19.5
2B;2021-05-10;925;805;63634;36328;34.9;19.9
2B;2021-05-11;933;1163;64567;37491;35.4;20.6
2B;2021-05-12;859;893;65426;38384;35.9;21.1
2B;2021-05-13;1028;376;66454;38760;36.5;21.3
2B;2021-05-14;719;577;67173;39337;36.9;21.6
2B;2021-05-15;702;353;67875;39690;37.2;21.8
2B;2021-05-16;300;180;68175;39870;37.4;21.9
2B;2021-05-17;1004;406;69179;40276;38.0;22.1
2B;2021-05-18;990;382;70169;40658;38.5;22.3
2B;2021-05-19;773;416;70942;41074;38.9;22.5
2B;2021-05-20;668;359;71610;41433;39.3;22.7
2B;2021-05-21;707;502;72317;41935;39.7;23.0
2B;2021-05-22;576;392;72893;42327;40.0;23.2
2B;2021-05-23;170;46;73063;42373;40.1;23.2
2B;2021-05-24;40;115;73103;42488;40.1;23.3
2B;2021-05-25;548;354;73651;42842;40.4;23.5
2B;2021-05-26;545;787;74196;43629;40.7;23.9
2B;2021-05-27;407;1131;74603;44760;40.9;24.6
2B;2021-05-28;550;905;75153;45665;41.2;25.1
2B;2021-05-29;311;353;75464;46018;41.4;25.2
2B;2021-05-30;46;45;75510;46063;41.4;25.3
2B;2021-05-31;375;831;75885;46894;41.6;25.7
2B;2021-06-01;414;1037;76299;47931;41.9;26.3
2B;2021-06-02;363;988;76662;48919;42.1;26.8
2B;2021-06-03;498;806;77160;49725;42.3;27.3
2B;2021-06-04;343;1253;77503;50978;42.5;28.0
2B;2021-06-05;257;494;77760;51472;42.7;28.2
2B;2021-06-06;51;129;77811;51601;42.7;28.3
2B;2021-06-07;280;949;78091;52550;42.8;28.8
2B;2021-06-08;399;1167;78490;53717;43.1;29.5
2B;2021-06-09;519;1177;79009;54894;43.4;30.1
2B;2021-06-10;369;939;79378;55833;43.6;30.6
2B;2021-06-11;432;1275;79810;57108;43.8;31.3
2B;2021-06-12;152;545;79962;57653;43.9;31.6
2B;2021-06-13;27;59;79989;57712;43.9;31.7
2B;2021-06-14;195;1115;80184;58827;44.0;32.3
2B;2021-06-15;344;1217;80528;60044;44.2;32.9
2B;2021-06-16;383;935;80911;60979;44.4;33.5
2B;2021-06-17;402;1049;81313;62028;44.6;34.0
2B;2021-06-18;348;960;81661;62988;44.8;34.6
2B;2021-06-19;144;330;81805;63318;44.9;34.7
2B;2021-06-20;44;194;81849;63512;44.9;34.8
2B;2021-06-21;265;962;82114;64474;45.1;35.4
2B;2021-06-22;317;1115;82431;65589;45.2;36.0
2B;2021-06-23;209;871;82640;66460;45.3;36.5
2B;2021-06-24;337;758;82977;67218;45.5;36.9
2B;2021-06-25;210;1074;83187;68292;45.6;37.5
2B;2021-06-26;105;550;83292;68842;45.7;37.8
2B;2021-06-27;31;214;83323;69056;45.7;37.9
2B;2021-06-28;329;954;83652;70010;45.9;38.4
2B;2021-06-29;270;985;83922;70995;46.0;39.0
2B;2021-06-30;380;948;84302;71943;46.3;39.5
2B;2021-07-01;226;507;84528;72450;46.4;39.8
2B;2021-07-02;219;557;84747;73007;46.5;40.1
2B;2021-07-03;92;398;84839;73405;46.5;40.3
2B;2021-07-04;2;0;84841;73405;46.5;40.3
2B;2021-07-05;263;666;85104;74071;46.7;40.6
2B;2021-07-06;450;707;85554;74778;46.9;41.0
2B;2021-07-07;381;911;85935;75689;47.2;41.5
2B;2021-07-08;183;351;86118;76040;47.3;41.7
2B;2021-07-09;250;377;86368;76417;47.4;41.9
2B;2021-07-10;197;199;86565;76616;47.5;42.0
2B;2021-07-11;13;14;86578;76630;47.5;42.0
2B;2021-07-12;497;747;87075;77377;47.8;42.5
2B;2021-07-13;822;1021;87897;78398;48.2;43.0
2B;2021-07-14;344;100;88241;78498;48.4;43.1
2B;2021-07-15;1270;589;89511;79087;49.1;43.4
2B;2021-07-16;1120;564;90631;79651;49.7;43.7
2B;2021-07-17;710;318;91341;79969;50.1;43.9
2B;2021-07-18;179;49;91520;80018;50.2;43.9
2B;2021-07-19;857;708;92377;80726;50.7;44.3
2B;2021-07-20;1210;683;93587;81409;51.3;44.7
2B;2021-07-21;1396;726;94983;82135;52.1;45.1
2B;2021-07-22;1330;604;96313;82739;52.8;45.4
2B;2021-07-23;1330;503;97643;83242;53.6;45.7
2B;2021-07-24;534;315;98177;83557;53.9;45.8
2B;2021-07-25;203;71;98380;83628;54.0;45.9
2B;2021-07-26;913;634;99293;84262;54.5;46.2
2B;2021-07-27;1578;711;100871;84973;55.3;46.6
2B;2021-07-28;1177;633;102048;85606;56.0;47.0
2B;2021-07-29;1144;449;103192;86055;56.6;47.2
2B;2021-07-30;763;350;103955;86405;57.0;47.4
2B;2021-07-31;539;234;104494;86639;57.3;47.5
2B;2021-08-01;230;57;104724;86696;57.5;47.6
2B;2021-08-02;799;471;105523;87167;57.9;47.8
2B;2021-08-03;1138;786;106661;87953;58.5;48.3
2B;2021-08-04;810;454;107471;88407;59.0;48.5
2B;2021-08-05;1026;560;108497;88967;59.5;48.8
2B;2021-08-06;704;526;109201;89493;59.9;49.1
2B;2021-08-07;306;408;109507;89901;60.1;49.3
2B;2021-08-08;93;142;109600;90043;60.1;49.4
2B;2021-08-09;536;747;110136;90790;60.4;49.8
2B;2021-08-10;739;1133;110875;91923;60.8;50.4
2B;2021-08-11;753;902;111628;92825;61.2;50.9
2B;2021-08-12;692;1045;112320;93870;61.6;51.5
2B;2021-08-13;494;948;112814;94818;61.9;52.0
2B;2021-08-14;200;437;113014;95255;62.0;52.3
2B;2021-08-15;117;173;113131;95428;62.1;52.4
2B;2021-08-16;509;1063;113640;96491;62.4;52.9
2B;2021-08-17;587;1308;114227;97799;62.7;53.7
2B;2021-08-18;506;1193;114733;98992;63.0;54.3
2B;2021-08-19;434;900;115167;99892;63.2;54.8
2B;2021-08-20;369;813;115536;100705;63.4;55.3
2B;2021-08-21;158;474;115694;101179;63.5;55.5
2B;2021-08-22;79;208;115773;101387;63.5;55.6
2B;2021-08-23;376;945;116149;102332;63.7;56.1
2B;2021-08-24;498;1214;116647;103546;64.0;56.8
2B;2021-08-25;347;971;116994;104517;64.2;57.3
2B;2021-08-26;404;817;117398;105334;64.4;57.8
2B;2021-08-27;262;572;117660;105906;64.6;58.1
2B;2021-08-28;168;442;117828;106348;64.6;58.4
2B;2021-08-29;53;126;117881;106474;64.7;58.4
2B;2021-08-30;364;836;118245;107310;64.9;58.9
2B;2021-08-31;380;863;118625;108173;65.1;59.4
2B;2021-09-01;369;913;118994;109086;65.3;59.9
2B;2021-09-02;306;654;119300;109740;65.5;60.2
2B;2021-09-03;220;422;119520;110162;65.6;60.4
2B;2021-09-04;124;306;119644;110468;65.6;60.6
2B;2021-09-05;17;102;119661;110570;65.7;60.7
2B;2021-09-06;165;570;119826;111140;65.7;61.0
2B;2021-09-07;259;759;120085;111899;65.9;61.4
2B;2021-09-08;203;621;120288;112520;66.0;61.7
2B;2021-09-09;185;405;120473;112925;66.1;62.0
2B;2021-09-10;201;366;120674;113291;66.2;62.2
2B;2021-09-11;130;249;120804;113540;66.3;62.3
2B;2021-09-12;17;94;120821;113634;66.3;62.3
2B;2021-09-13;191;464;121012;114098;66.4;62.6
2B;2021-09-14;280;634;121292;114732;66.5;63.0
2B;2021-09-15;159;598;121451;115330;66.6;63.3
2B;2021-09-16;216;301;121667;115631;66.8;63.4
2B;2021-09-17;115;194;121782;115825;66.8;63.6
2B;2021-09-18;51;157;121833;115982;66.8;63.6
2B;2021-09-19;15;18;121848;116000;66.9;63.6
2B;2021-09-20;106;409;121954;116409;66.9;63.9
2B;2021-09-21;100;410;122054;116819;67.0;64.1
2B;2021-09-22;116;404;122170;117223;67.0;64.3
2B;2021-09-23;103;228;122273;117451;67.1;64.4
2B;2021-09-24;87;213;122360;117664;67.1;64.6
2B;2021-09-25;36;123;122396;117787;67.2;64.6
2B;2021-09-26;2;23;122398;117810;67.2;64.6
2B;2021-09-27;71;229;122469;118039;67.2;64.8
2B;2021-09-28;99;194;122568;118233;67.2;64.9
2B;2021-09-29;120;345;122688;118578;67.3;65.1
2B;2021-09-30;71;133;122759;118711;67.4;65.1
2B;2021-10-01;113;163;122872;118874;67.4;65.2
2B;2021-10-02;52;114;122924;118988;67.4;65.3
2B;2021-10-03;13;15;122937;119003;67.5;65.3
2B;2021-10-04;84;156;123021;119159;67.5;65.4
2B;2021-10-05;90;225;123111;119384;67.5;65.5
2B;2021-10-06;125;285;123236;119669;67.6;65.7
2B;2021-10-07;49;137;123285;119806;67.6;65.7
2B;2021-10-08;82;171;123367;119977;67.7;65.8
2B;2021-10-09;67;108;123434;120085;67.7;65.9
2B;2021-10-10;11;22;123445;120107;67.7;65.9
2B;2021-10-11;60;145;123505;120252;67.8;66.0
30;2020-12-27;3;0;3;0;0.0;0.0
30;2020-12-28;2;0;5;0;0.0;0.0
30;2020-12-29;0;0;5;0;0.0;0.0
30;2020-12-30;0;0;5;0;0.0;0.0
30;2020-12-31;0;0;5;0;0.0;0.0
30;2021-01-01;0;0;5;0;0.0;0.0
30;2021-01-02;0;0;5;0;0.0;0.0
30;2021-01-03;0;0;5;0;0.0;0.0
30;2021-01-04;0;0;5;0;0.0;0.0
30;2021-01-05;4;0;9;0;0.0;0.0
30;2021-01-06;128;0;137;0;0.0;0.0
30;2021-01-07;314;0;451;0;0.1;0.0
30;2021-01-08;532;2;983;2;0.1;0.0
30;2021-01-09;270;0;1253;2;0.2;0.0
30;2021-01-10;0;0;1253;2;0.2;0.0
30;2021-01-11;536;1;1789;3;0.2;0.0
30;2021-01-12;801;3;2590;6;0.3;0.0
30;2021-01-13;641;0;3231;6;0.4;0.0
30;2021-01-14;653;5;3884;11;0.5;0.0
30;2021-01-15;756;2;4640;13;0.6;0.0
30;2021-01-16;313;0;4953;13;0.7;0.0
30;2021-01-17;4;0;4957;13;0.7;0.0
30;2021-01-18;949;11;5906;24;0.8;0.0
30;2021-01-19;1735;6;7641;30;1.0;0.0
30;2021-01-20;1303;3;8944;33;1.2;0.0
30;2021-01-21;1230;3;10174;36;1.4;0.0
30;2021-01-22;1078;7;11252;43;1.5;0.0
30;2021-01-23;634;2;11886;45;1.6;0.0
30;2021-01-24;0;0;11886;45;1.6;0.0
30;2021-01-25;830;5;12716;50;1.7;0.0
30;2021-01-26;1060;17;13776;67;1.8;0.0
30;2021-01-27;983;110;14759;177;2.0;0.0
30;2021-01-28;714;272;15473;449;2.1;0.1
30;2021-01-29;671;440;16144;889;2.2;0.1
30;2021-01-30;473;285;16617;1174;2.2;0.2
30;2021-01-31;3;7;16620;1181;2.2;0.2
30;2021-02-01;816;441;17436;1622;2.3;0.2
30;2021-02-02;1875;683;19311;2305;2.6;0.3
30;2021-02-03;1185;486;20496;2791;2.7;0.4
30;2021-02-04;970;661;21466;3452;2.9;0.5
30;2021-02-05;599;762;22065;4214;2.9;0.6
30;2021-02-06;296;261;22361;4475;3.0;0.6
30;2021-02-07;3;9;22364;4484;3.0;0.6
30;2021-02-08;574;735;22938;5219;3.1;0.7
30;2021-02-09;986;1008;23924;6227;3.2;0.8
30;2021-02-10;985;1093;24909;7320;3.3;1.0
30;2021-02-11;929;1031;25838;8351;3.5;1.1
30;2021-02-12;619;997;26457;9348;3.5;1.2
30;2021-02-13;435;383;26892;9731;3.6;1.3
30;2021-02-14;3;23;26895;9754;3.6;1.3
30;2021-02-15;450;616;27345;10370;3.7;1.4
30;2021-02-16;460;847;27805;11217;3.7;1.5
30;2021-02-17;683;619;28488;11836;3.8;1.6
30;2021-02-18;797;526;29285;12362;3.9;1.7
30;2021-02-19;577;670;29862;13032;4.0;1.7
30;2021-02-20;224;228;30086;13260;4.0;1.8
30;2021-02-21;5;3;30091;13263;4.0;1.8
30;2021-02-22;502;764;30593;14027;4.1;1.9
30;2021-02-23;973;1467;31566;15494;4.2;2.1
30;2021-02-24;931;1196;32497;16690;4.3;2.2
30;2021-02-25;1211;893;33708;17583;4.5;2.3
30;2021-02-26;1336;599;35044;18182;4.7;2.4
30;2021-02-27;564;542;35608;18724;4.8;2.5
30;2021-02-28;6;7;35614;18731;4.8;2.5
30;2021-03-01;1343;830;36957;19561;4.9;2.6
30;2021-03-02;1714;915;38671;20476;5.2;2.7
30;2021-03-03;2311;769;40982;21245;5.5;2.8
30;2021-03-04;2638;879;43620;22124;5.8;3.0
30;2021-03-05;2765;622;46385;22746;6.2;3.0
30;2021-03-06;2998;370;49383;23116;6.6;3.1
30;2021-03-07;1862;50;51245;23166;6.8;3.1
30;2021-03-08;1556;789;52801;23955;7.1;3.2
30;2021-03-09;2277;873;55078;24828;7.4;3.3
30;2021-03-10;2360;663;57438;25491;7.7;3.4
30;2021-03-11;3053;710;60491;26201;8.1;3.5
30;2021-03-12;3115;404;63606;26605;8.5;3.6
30;2021-03-13;2227;298;65833;26903;8.8;3.6
30;2021-03-14;83;3;65916;26906;8.8;3.6
30;2021-03-15;1580;571;67496;27477;9.0;3.7
30;2021-03-16;1297;1072;68793;28549;9.2;3.8
30;2021-03-17;1456;650;70249;29199;9.4;3.9
30;2021-03-18;1648;716;71897;29915;9.6;4.0
30;2021-03-19;2250;553;74147;30468;9.9;4.1
30;2021-03-20;1400;149;75547;30617;10.1;4.1
30;2021-03-21;58;9;75605;30626;10.1;4.1
30;2021-03-22;2394;727;77999;31353;10.4;4.2
30;2021-03-23;3512;821;81511;32174;10.9;4.3
30;2021-03-24;3637;835;85148;33009;11.4;4.4
30;2021-03-25;4406;854;89554;33863;12.0;4.5
30;2021-03-26;4361;652;93915;34515;12.5;4.6
30;2021-03-27;1971;381;95886;34896;12.8;4.7
30;2021-03-28;35;29;95921;34925;12.8;4.7
30;2021-03-29;2816;1660;98737;36585;13.2;4.9
30;2021-03-30;3777;1890;102514;38475;13.7;5.1
30;2021-03-31;3505;1656;106019;40131;14.2;5.4
30;2021-04-01;4016;1473;110035;41604;14.7;5.6
30;2021-04-02;3605;1234;113640;42838;15.2;5.7
30;2021-04-03;1061;1230;114701;44068;15.3;5.9
30;2021-04-04;30;189;114731;44257;15.3;5.9
30;2021-04-05;765;292;115496;44549;15.4;6.0
30;2021-04-06;3045;1582;118541;46131;15.8;6.2
30;2021-04-07;2719;1634;121260;47765;16.2;6.4
30;2021-04-08;3922;1499;125182;49264;16.7;6.6
30;2021-04-09;4889;1529;130071;50793;17.4;6.8
30;2021-04-10;2426;1180;132497;51973;17.7;6.9
30;2021-04-11;951;60;133448;52033;17.8;7.0
30;2021-04-12;3142;1499;136590;53532;18.2;7.2
30;2021-04-13;4019;1942;140609;55474;18.8;7.4
30;2021-04-14;3387;1548;143996;57022;19.2;7.6
30;2021-04-15;3827;1476;147823;58498;19.8;7.8
30;2021-04-16;3704;1549;151527;60047;20.2;8.0
30;2021-04-17;1493;959;153020;61006;20.4;8.2
30;2021-04-18;961;67;153981;61073;20.6;8.2
30;2021-04-19;2447;2301;156428;63374;20.9;8.5
30;2021-04-20;2817;2837;159245;66211;21.3;8.8
30;2021-04-21;2599;2580;161844;68791;21.6;9.2
30;2021-04-22;3525;2323;165369;71114;22.1;9.5
30;2021-04-23;3580;2311;168949;73425;22.6;9.8
30;2021-04-24;1347;1231;170296;74656;22.8;10.0
30;2021-04-25;748;92;171044;74748;22.9;10.0
30;2021-04-26;2015;2392;173059;77140;23.1;10.3
30;2021-04-27;2952;2605;176011;79745;23.5;10.7
30;2021-04-28;2839;2495;178850;82240;23.9;11.0
30;2021-04-29;3621;2333;182471;84573;24.4;11.3
30;2021-04-30;3409;2032;185880;86605;24.8;11.6
30;2021-05-01;1746;604;187626;87209;25.1;11.7
30;2021-05-02;667;246;188293;87455;25.2;11.7
30;2021-05-03;3750;2512;192043;89967;25.7;12.0
30;2021-05-04;3976;3547;196019;93514;26.2;12.5
30;2021-05-05;3941;3126;199960;96640;26.7;12.9
30;2021-05-06;4202;3378;204162;100018;27.3;13.4
30;2021-05-07;4080;3071;208242;103089;27.8;13.8
30;2021-05-08;1606;723;209848;103812;28.0;13.9
30;2021-05-09;372;613;210220;104425;28.1;14.0
30;2021-05-10;2921;3121;213141;107546;28.5;14.4
30;2021-05-11;5388;3655;218529;111201;29.2;14.9
30;2021-05-12;5303;3219;223832;114420;29.9;15.3
30;2021-05-13;3230;1029;227062;115449;30.3;15.4
30;2021-05-14;4890;2461;231952;117910;31.0;15.8
30;2021-05-15;3407;1206;235359;119116;31.4;15.9
30;2021-05-16;397;338;235756;119454;31.5;16.0
30;2021-05-17;3793;3033;239549;122487;32.0;16.4
30;2021-05-18;4826;3036;244375;125523;32.7;16.8
30;2021-05-19;4774;2547;249149;128070;33.3;17.1
30;2021-05-20;5014;2576;254163;130646;34.0;17.5
30;2021-05-21;4884;2474;259047;133120;34.6;17.8
30;2021-05-22;3155;1286;262202;134406;35.0;18.0
30;2021-05-23;289;344;262491;134750;35.1;18.0
30;2021-05-24;785;766;263276;135516;35.2;18.1
30;2021-05-25;2654;3158;265930;138674;35.5;18.5
30;2021-05-26;2887;2572;268817;141246;35.9;18.9
30;2021-05-27;3757;2716;272574;143962;36.4;19.2
30;2021-05-28;3325;3263;275899;147225;36.9;19.7
30;2021-05-29;1687;1797;277586;149022;37.1;19.9
30;2021-05-30;360;584;277946;149606;37.1;20.0
30;2021-05-31;2830;2298;280776;151904;37.5;20.3
30;2021-06-01;3657;2796;284433;154700;38.0;20.7
30;2021-06-02;3320;2451;287753;157151;38.4;21.0
30;2021-06-03;4129;3358;291882;160509;39.0;21.4
30;2021-06-04;3896;3400;295778;163909;39.5;21.9
30;2021-06-05;1904;1313;297682;165222;39.8;22.1
30;2021-06-06;684;265;298366;165487;39.9;22.1
30;2021-06-07;4721;2527;303087;168014;40.5;22.4
30;2021-06-08;4830;3330;307917;171344;41.1;22.9
30;2021-06-09;4151;2992;312068;174336;41.7;23.3
30;2021-06-10;4613;3358;316681;177694;42.3;23.7
30;2021-06-11;4583;3811;321264;181505;42.9;24.3
30;2021-06-12;2485;1709;323749;183214;43.3;24.5
30;2021-06-13;493;344;324242;183558;43.3;24.5
30;2021-06-14;2470;4712;326712;188270;43.7;25.2
30;2021-06-15;3198;5312;329910;193582;44.1;25.9
30;2021-06-16;3107;4648;333017;198230;44.5;26.5
30;2021-06-17;3923;4377;336940;202607;45.0;27.1
30;2021-06-18;3714;4698;340654;207305;45.5;27.7
30;2021-06-19;1441;2004;342095;209309;45.7;28.0
30;2021-06-20;357;491;342452;209800;45.8;28.0
30;2021-06-21;2379;4911;344831;214711;46.1;28.7
30;2021-06-22;2365;5742;347196;220453;46.4;29.5
30;2021-06-23;2529;5344;349725;225797;46.7;30.2
30;2021-06-24;2336;4708;352061;230505;47.0;30.8
30;2021-06-25;2611;5603;354672;236108;47.4;31.5
30;2021-06-26;909;2940;355581;239048;47.5;31.9
30;2021-06-27;222;527;355803;239575;47.5;32.0
30;2021-06-28;1670;6024;357473;245599;47.8;32.8
30;2021-06-29;1837;6023;359310;251622;48.0;33.6
30;2021-06-30;2001;5255;361311;256877;48.3;34.3
30;2021-07-01;3105;4719;364416;261596;48.7;35.0
30;2021-07-02;2833;4626;367249;266222;49.1;35.6
30;2021-07-03;1154;3047;368403;269269;49.2;36.0
30;2021-07-04;116;393;368519;269662;49.2;36.0
30;2021-07-05;2025;4029;370544;273691;49.5;36.6
30;2021-07-06;2663;4975;373207;278666;49.9;37.2
30;2021-07-07;2538;4224;375745;282890;50.2;37.8
30;2021-07-08;2012;3418;377757;286308;50.5;38.3
30;2021-07-09;2410;5314;380167;291622;50.8;39.0
30;2021-07-10;1504;2159;381671;293781;51.0;39.3
30;2021-07-11;47;415;381718;294196;51.0;39.3
30;2021-07-12;2527;5154;384245;299350;51.3;40.0
30;2021-07-13;3300;6029;387545;305379;51.8;40.8
30;2021-07-14;502;550;388047;305929;51.8;40.9
30;2021-07-15;4127;5477;392174;311406;52.4;41.6
30;2021-07-16;5038;5729;397212;317135;53.1;42.4
30;2021-07-17;1706;2467;398918;319602;53.3;42.7
30;2021-07-18;146;602;399064;320204;53.3;42.8
30;2021-07-19;3374;6315;402438;326519;53.8;43.6
30;2021-07-20;4641;6524;407079;333043;54.4;44.5
30;2021-07-21;4063;5415;411142;338458;54.9;45.2
30;2021-07-22;4900;5745;416042;344203;55.6;46.0
30;2021-07-23;4998;5872;421040;350075;56.3;46.8
30;2021-07-24;2240;3257;423280;353332;56.6;47.2
30;2021-07-25;137;310;423417;353642;56.6;47.2
30;2021-07-26;4414;4134;427831;357776;57.2;47.8
30;2021-07-27;4856;4654;432687;362430;57.8;48.4
30;2021-07-28;4877;4025;437564;366455;58.5;49.0
30;2021-07-29;5929;4141;443493;370596;59.3;49.5
30;2021-07-30;5343;4396;448836;374992;60.0;50.1
30;2021-07-31;2655;1965;451491;376957;60.3;50.4
30;2021-08-01;735;311;452226;377268;60.4;50.4
30;2021-08-02;3685;4013;455911;381281;60.9;50.9
30;2021-08-03;4887;3957;460798;385238;61.6;51.5
30;2021-08-04;5285;3055;466083;388293;62.3;51.9
30;2021-08-05;4617;3797;470700;392090;62.9;52.4
30;2021-08-06;4332;4066;475032;396156;63.5;52.9
30;2021-08-07;1841;1953;476873;398109;63.7;53.2
30;2021-08-08;620;280;477493;398389;63.8;53.2
30;2021-08-09;3343;3762;480836;402151;64.2;53.7
30;2021-08-10;3926;4401;484762;406552;64.8;54.3
30;2021-08-11;3402;3481;488164;410033;65.2;54.8
30;2021-08-12;3763;4224;491927;414257;65.7;55.3
30;2021-08-13;3308;3341;495235;417598;66.2;55.8
30;2021-08-14;1134;2048;496369;419646;66.3;56.1
30;2021-08-15;270;176;496639;419822;66.4;56.1
30;2021-08-16;2201;4865;498840;424687;66.6;56.7
30;2021-08-17;2745;4199;501585;428886;67.0;57.3
30;2021-08-18;2845;3836;504430;432722;67.4;57.8
30;2021-08-19;2858;4318;507288;437040;67.8;58.4
30;2021-08-20;2608;4468;509896;441508;68.1;59.0
30;2021-08-21;1018;2888;510914;444396;68.3;59.4
30;2021-08-22;227;516;511141;444912;68.3;59.4
30;2021-08-23;1687;4476;512828;449388;68.5;60.0
30;2021-08-24;1955;4526;514783;453914;68.8;60.6
30;2021-08-25;1691;4345;516474;458259;69.0;61.2
30;2021-08-26;1852;4257;518326;462516;69.3;61.8
30;2021-08-27;1777;4358;520103;466874;69.5;62.4
30;2021-08-28;681;2476;520784;469350;69.6;62.7
30;2021-08-29;182;614;520966;469964;69.6;62.8
30;2021-08-30;1408;4247;522374;474211;69.8;63.4
30;2021-08-31;1341;4072;523715;478283;70.0;63.9
30;2021-09-01;1243;3445;524958;481728;70.1;64.4
30;2021-09-02;1399;3312;526357;485040;70.3;64.8
30;2021-09-03;1548;3754;527905;488794;70.5;65.3
30;2021-09-04;686;1808;528591;490602;70.6;65.5
30;2021-09-05;136;486;528727;491088;70.6;65.6
30;2021-09-06;745;2277;529472;493365;70.7;65.9
30;2021-09-07;702;2110;530174;495475;70.8;66.2
30;2021-09-08;869;2551;531043;498026;71.0;66.5
30;2021-09-09;911;2163;531954;500189;71.1;66.8
30;2021-09-10;941;2614;532895;502803;71.2;67.2
30;2021-09-11;553;1584;533448;504387;71.3;67.4
30;2021-09-12;95;224;533543;504611;71.3;67.4
30;2021-09-13;690;1601;534233;506212;71.4;67.6
30;2021-09-14;650;1522;534883;507734;71.5;67.8
30;2021-09-15;731;1838;535614;509572;71.6;68.1
30;2021-09-16;752;1477;536366;511049;71.7;68.3
30;2021-09-17;802;2030;537168;513079;71.8;68.6
30;2021-09-18;399;1011;537567;514090;71.8;68.7
30;2021-09-19;69;158;537636;514248;71.8;68.7
30;2021-09-20;396;1204;538032;515452;71.9;68.9
30;2021-09-21;451;1161;538483;516613;71.9;69.0
30;2021-09-22;483;1384;538966;517997;72.0;69.2
30;2021-09-23;625;1201;539591;519198;72.1;69.4
30;2021-09-24;559;1629;540150;520827;72.2;69.6
30;2021-09-25;324;857;540474;521684;72.2;69.7
30;2021-09-26;54;168;540528;521852;72.2;69.7
30;2021-09-27;378;891;540906;522743;72.3;69.8
30;2021-09-28;575;894;541481;523637;72.3;70.0
30;2021-09-29;456;1066;541937;524703;72.4;70.1
30;2021-09-30;405;912;542342;525615;72.5;70.2
30;2021-10-01;500;1000;542842;526615;72.5;70.4
30;2021-10-02;267;580;543109;527195;72.6;70.4
30;2021-10-03;25;47;543134;527242;72.6;70.4
30;2021-10-04;330;788;543464;528030;72.6;70.5
30;2021-10-05;310;660;543774;528690;72.7;70.6
30;2021-10-06;377;854;544151;529544;72.7;70.8
30;2021-10-07;378;840;544529;530384;72.8;70.9
30;2021-10-08;428;1054;544957;531438;72.8;71.0
30;2021-10-09;284;563;545241;532001;72.8;71.1
30;2021-10-10;5;34;545246;532035;72.8;71.1
30;2021-10-11;240;541;545486;532576;72.9;71.2
31;2020-12-27;0;0;0;0;0.0;0.0
31;2020-12-28;2;0;2;0;0.0;0.0
31;2020-12-29;0;0;2;0;0.0;0.0
31;2020-12-30;0;0;2;0;0.0;0.0
31;2020-12-31;1;0;3;0;0.0;0.0
31;2021-01-01;4;0;7;0;0.0;0.0
31;2021-01-02;1;0;8;0;0.0;0.0
31;2021-01-03;2;0;10;0;0.0;0.0
31;2021-01-04;5;0;15;0;0.0;0.0
31;2021-01-05;50;0;65;0;0.0;0.0
31;2021-01-06;212;2;277;2;0.0;0.0
31;2021-01-07;284;1;561;3;0.0;0.0
31;2021-01-08;546;1;1107;4;0.1;0.0
31;2021-01-09;275;0;1382;4;0.1;0.0
31;2021-01-10;286;0;1668;4;0.1;0.0
31;2021-01-11;983;4;2651;8;0.2;0.0
31;2021-01-12;1192;1;3843;9;0.3;0.0
31;2021-01-13;1158;5;5001;14;0.4;0.0
31;2021-01-14;1179;20;6180;34;0.4;0.0
31;2021-01-15;1048;3;7228;37;0.5;0.0
31;2021-01-16;243;1;7471;38;0.5;0.0
31;2021-01-17;176;0;7647;38;0.5;0.0
31;2021-01-18;1616;6;9263;44;0.7;0.0
31;2021-01-19;2937;12;12200;56;0.9;0.0
31;2021-01-20;3683;15;15883;71;1.1;0.0
31;2021-01-21;2997;9;18880;80;1.3;0.0
31;2021-01-22;2275;7;21155;87;1.5;0.0
31;2021-01-23;728;2;21883;89;1.6;0.0
31;2021-01-24;212;1;22095;90;1.6;0.0
31;2021-01-25;1744;9;23839;99;1.7;0.0
31;2021-01-26;1839;64;25678;163;1.8;0.0
31;2021-01-27;1573;151;27251;314;1.9;0.0
31;2021-01-28;1385;299;28636;613;2.0;0.0
31;2021-01-29;1360;351;29996;964;2.1;0.1
31;2021-01-30;446;186;30442;1150;2.2;0.1
31;2021-01-31;61;209;30503;1359;2.2;0.1
31;2021-02-01;1183;752;31686;2111;2.3;0.2
31;2021-02-02;3056;816;34742;2927;2.5;0.2
31;2021-02-03;1922;788;36664;3715;2.6;0.3
31;2021-02-04;1814;847;38478;4562;2.7;0.3
31;2021-02-05;1343;579;39821;5141;2.8;0.4
31;2021-02-06;385;57;40206;5198;2.9;0.4
31;2021-02-07;37;42;40243;5240;2.9;0.4
31;2021-02-08;1116;666;41359;5906;3.0;0.4
31;2021-02-09;1680;1574;43039;7480;3.1;0.5
31;2021-02-10;1964;2475;45003;9955;3.2;0.7
31;2021-02-11;1814;1826;46817;11781;3.3;0.8
31;2021-02-12;1540;797;48357;12578;3.5;0.9
31;2021-02-13;504;228;48861;12806;3.5;0.9
31;2021-02-14;56;216;48917;13022;3.5;0.9
31;2021-02-15;445;1368;49362;14390;3.5;1.0
31;2021-02-16;463;1543;49825;15933;3.6;1.1
31;2021-02-17;473;1633;50298;17566;3.6;1.3
31;2021-02-18;477;1748;50775;19314;3.6;1.4
31;2021-02-19;393;1564;51168;20878;3.7;1.5
31;2021-02-20;69;529;51237;21407;3.7;1.5
31;2021-02-21;77;161;51314;21568;3.7;1.5
31;2021-02-22;434;1731;51748;23299;3.7;1.7
31;2021-02-23;863;3011;52611;26310;3.8;1.9
31;2021-02-24;652;2187;53263;28497;3.8;2.0
31;2021-02-25;1435;1847;54698;30344;3.9;2.2
31;2021-02-26;1711;1234;56409;31578;4.0;2.3
31;2021-02-27;638;404;57047;31982;4.1;2.3
31;2021-02-28;78;54;57125;32036;4.1;2.3
31;2021-03-01;875;1134;58000;33170;4.1;2.4
31;2021-03-02;1239;1667;59239;34837;4.2;2.5
31;2021-03-03;1357;1814;60596;36651;4.3;2.6
31;2021-03-04;2424;1508;63020;38159;4.5;2.7
31;2021-03-05;3053;1607;66073;39766;4.7;2.8
31;2021-03-06;2834;413;68907;40179;4.9;2.9
31;2021-03-07;5368;112;74275;40291;5.3;2.9
31;2021-03-08;1599;1097;75874;41388;5.4;3.0
31;2021-03-09;2792;1199;78666;42587;5.6;3.0
31;2021-03-10;2574;1104;81240;43691;5.8;3.1
31;2021-03-11;4382;1170;85622;44861;6.1;3.2
31;2021-03-12;5321;1212;90943;46073;6.5;3.3
31;2021-03-13;2839;510;93782;46583;6.7;3.3
31;2021-03-14;235;49;94017;46632;6.7;3.3
31;2021-03-15;2584;434;96601;47066;6.9;3.4
31;2021-03-16;1746;823;98347;47889;7.0;3.4
31;2021-03-17;1656;563;100003;48452;7.1;3.5
31;2021-03-18;1988;713;101991;49165;7.3;3.5
31;2021-03-19;3185;534;105176;49699;7.5;3.5
31;2021-03-20;1797;142;106973;49841;7.6;3.6
31;2021-03-21;211;35;107184;49876;7.7;3.6
31;2021-03-22;2580;375;109764;50251;7.8;3.6
31;2021-03-23;4057;328;113821;50579;8.1;3.6
31;2021-03-24;4356;299;118177;50878;8.4;3.6
31;2021-03-25;6042;536;124219;51414;8.9;3.7
31;2021-03-26;5466;525;129685;51939;9.3;3.7
31;2021-03-27;4350;214;134035;52153;9.6;3.7
31;2021-03-28;2291;49;136326;52202;9.7;3.7
31;2021-03-29;4206;435;140532;52637;10.0;3.8
31;2021-03-30;6595;560;147127;53197;10.5;3.8
31;2021-03-31;5650;395;152777;53592;10.9;3.8
31;2021-04-01;6968;568;159745;54160;11.4;3.9
31;2021-04-02;6102;596;165847;54756;11.8;3.9
31;2021-04-03;3927;159;169774;54915;12.1;3.9
31;2021-04-04;2060;116;171834;55031;12.3;3.9
31;2021-04-05;481;70;172315;55101;12.3;3.9
31;2021-04-06;4165;1159;176480;56260;12.6;4.0
31;2021-04-07;5988;991;182468;57251;13.0;4.1
31;2021-04-08;7570;1043;190038;58294;13.6;4.2
31;2021-04-09;8385;1261;198423;59555;14.2;4.3
31;2021-04-10;4717;549;203140;60104;14.5;4.3
31;2021-04-11;2069;140;205209;60244;14.6;4.3
31;2021-04-12;6001;1846;211210;62090;15.1;4.4
31;2021-04-13;8047;2050;219257;64140;15.7;4.6
31;2021-04-14;6654;1932;225911;66072;16.1;4.7
31;2021-04-15;7771;2254;233682;68326;16.7;4.9
31;2021-04-16;7177;2103;240859;70429;17.2;5.0
31;2021-04-17;4414;915;245273;71344;17.5;5.1
31;2021-04-18;2513;358;247786;71702;17.7;5.1
31;2021-04-19;5220;2035;253006;73737;18.1;5.3
31;2021-04-20;6074;2854;259080;76591;18.5;5.5
31;2021-04-21;5974;2803;265054;79394;18.9;5.7
31;2021-04-22;6379;3251;271433;82645;19.4;5.9
31;2021-04-23;6283;2566;277716;85211;19.8;6.1
31;2021-04-24;1616;3143;279332;88354;19.9;6.3
31;2021-04-25;688;2097;280020;90451;20.0;6.5
31;2021-04-26;3794;3229;283814;93680;20.3;6.7
31;2021-04-27;4517;3902;288331;97582;20.6;7.0
31;2021-04-28;4544;3561;292875;101143;20.9;7.2
31;2021-04-29;5183;4078;298058;105221;21.3;7.5
31;2021-04-30;5039;4148;303097;109369;21.6;7.8
31;2021-05-01;1487;3120;304584;112489;21.7;8.0
31;2021-05-02;1416;1979;306000;114468;21.8;8.2
31;2021-05-03;5658;2426;311658;116894;22.2;8.3
31;2021-05-04;4780;4750;316438;121644;22.6;8.7
31;2021-05-05;2994;5731;319432;127375;22.8;9.1
31;2021-05-06;3635;7386;323067;134761;23.1;9.6
31;2021-05-07;5257;7178;328324;141939;23.4;10.1
31;2021-05-08;3634;3103;331958;145042;23.7;10.4
31;2021-05-09;3760;2310;335718;147352;24.0;10.5
31;2021-05-10;5683;5482;341401;152834;24.4;10.9
31;2021-05-11;6605;6704;348006;159538;24.8;11.4
31;2021-05-12;6171;5939;354177;165477;25.3;11.8
31;2021-05-13;4642;2068;358819;167545;25.6;12.0
31;2021-05-14;6911;3982;365730;171527;26.1;12.2
31;2021-05-15;5145;1756;370875;173283;26.5;12.4
31;2021-05-16;3300;634;374175;173917;26.7;12.4
31;2021-05-17;5143;4151;379318;178068;27.1;12.7
31;2021-05-18;5589;4279;384907;182347;27.5;13.0
31;2021-05-19;5782;3763;390689;186110;27.9;13.3
31;2021-05-20;6473;4806;397162;190916;28.3;13.6
31;2021-05-21;5984;4605;403146;195521;28.8;14.0
31;2021-05-22;4081;1628;407227;197149;29.1;14.1
31;2021-05-23;3583;342;410810;197491;29.3;14.1
31;2021-05-24;3881;707;414691;198198;29.6;14.1
31;2021-05-25;6190;3613;420881;201811;30.0;14.4
31;2021-05-26;5608;4644;426489;206455;30.4;14.7
31;2021-05-27;4788;6193;431277;212648;30.8;15.2
31;2021-05-28;4116;6349;435393;218997;31.1;15.6
31;2021-05-29;1917;4031;437310;223028;31.2;15.9
31;2021-05-30;751;2362;438061;225390;31.3;16.1
31;2021-05-31;4397;5083;442458;230473;31.6;16.5
31;2021-06-01;5954;6565;448412;237038;32.0;16.9
31;2021-06-02;5803;6308;454215;243346;32.4;17.4
31;2021-06-03;7308;8139;461523;251485;32.9;18.0
31;2021-06-04;7541;7165;469064;258650;33.5;18.5
31;2021-06-05;9078;2778;478142;261428;34.1;18.7
31;2021-06-06;8106;1579;486248;263007;34.7;18.8
31;2021-06-07;7987;5474;494235;268481;35.3;19.2
31;2021-06-08;9105;6051;503340;274532;35.9;19.6
31;2021-06-09;8918;5558;512258;280090;36.6;20.0
31;2021-06-10;9781;6362;522039;286452;37.3;20.4
31;2021-06-11;10050;6637;532089;293089;38.0;20.9
31;2021-06-12;8788;3026;540877;296115;38.6;21.1
31;2021-06-13;8378;2018;549255;298133;39.2;21.3
31;2021-06-14;8428;6731;557683;304864;39.8;21.8
31;2021-06-15;9773;7445;567456;312309;40.5;22.3
31;2021-06-16;8735;5261;576191;317570;41.1;22.7
31;2021-06-17;8277;6609;584468;324179;41.7;23.1
31;2021-06-18;8551;7755;593019;331934;42.3;23.7
31;2021-06-19;7364;5442;600383;337376;42.9;24.1
31;2021-06-20;5572;3727;605955;341103;43.3;24.3
31;2021-06-21;5374;6918;611329;348021;43.6;24.8
31;2021-06-22;4987;8231;616316;356252;44.0;25.4
31;2021-06-23;5105;7284;621421;363536;44.4;25.9
31;2021-06-24;4633;8340;626054;371876;44.7;26.5
31;2021-06-25;5014;9313;631068;381189;45.0;27.2
31;2021-06-26;4282;6398;635350;387587;45.4;27.7
31;2021-06-27;3596;4106;638946;391693;45.6;28.0
31;2021-06-28;4098;6646;643044;398339;45.9;28.4
31;2021-06-29;3798;7563;646842;405902;46.2;29.0
31;2021-06-30;4280;7821;651122;413723;46.5;29.5
31;2021-07-01;4122;8471;655244;422194;46.8;30.1
31;2021-07-02;4113;9329;659357;431523;47.1;30.8
31;2021-07-03;4100;6113;663457;437636;47.4;31.2
31;2021-07-04;3205;4812;666662;442448;47.6;31.6
31;2021-07-05;4057;7094;670719;449542;47.9;32.1
31;2021-07-06;3889;8363;674608;457905;48.2;32.7
31;2021-07-07;3964;7962;678572;465867;48.4;33.3
31;2021-07-08;4054;8540;682626;474407;48.7;33.9
31;2021-07-09;4462;8800;687088;483207;49.0;34.5
31;2021-07-10;3918;5498;691006;488705;49.3;34.9
31;2021-07-11;3137;4138;694143;492843;49.5;35.2
31;2021-07-12;3825;8640;697968;501483;49.8;35.8
31;2021-07-13;6920;9446;704888;510929;50.3;36.5
31;2021-07-14;6167;3938;711055;514867;50.8;36.8
31;2021-07-15;8515;9451;719570;524318;51.4;37.4
31;2021-07-16;7775;9919;727345;534237;51.9;38.1
31;2021-07-17;8357;10557;735702;544794;52.5;38.9
31;2021-07-18;6620;9474;742322;554268;53.0;39.6
31;2021-07-19;4794;10778;747116;565046;53.3;40.3
31;2021-07-20;7160;11483;754276;576529;53.8;41.2
31;2021-07-21;7040;11531;761316;588060;54.3;42.0
31;2021-07-22;8165;11767;769481;599827;54.9;42.8
31;2021-07-23;7474;11817;776955;611644;55.5;43.7
31;2021-07-24;10310;10575;787265;622219;56.2;44.4
31;2021-07-25;7560;8803;794825;631022;56.7;45.0
31;2021-07-26;5514;9545;800339;640567;57.1;45.7
31;2021-07-27;7961;9198;808300;649765;57.7;46.4
31;2021-07-28;8677;8285;816977;658050;58.3;47.0
31;2021-07-29;8855;8054;825832;666104;58.9;47.5
31;2021-07-30;7673;7988;833505;674092;59.5;48.1
31;2021-07-31;6015;7394;839520;681486;59.9;48.6
31;2021-08-01;4431;4303;843951;685789;60.2;49.0
31;2021-08-02;5491;5419;849442;691208;60.6;49.3
31;2021-08-03;5896;5187;855338;696395;61.1;49.7
31;2021-08-04;5925;4808;861263;701203;61.5;50.1
31;2021-08-05;5585;7232;866848;708435;61.9;50.6
31;2021-08-06;5303;7344;872151;715779;62.3;51.1
31;2021-08-07;4596;6651;876747;722430;62.6;51.6
31;2021-08-08;3385;5579;880132;728009;62.8;52.0
31;2021-08-09;4396;7011;884528;735020;63.1;52.5
31;2021-08-10;4686;6285;889214;741305;63.5;52.9
31;2021-08-11;4527;5860;893741;747165;63.8;53.3
31;2021-08-12;4524;6759;898265;753924;64.1;53.8
31;2021-08-13;4174;6204;902439;760128;64.4;54.3
31;2021-08-14;3033;6462;905472;766590;64.6;54.7
31;2021-08-15;1309;4097;906781;770687;64.7;55.0
31;2021-08-16;3219;8118;910000;778805;65.0;55.6
31;2021-08-17;3435;7098;913435;785903;65.2;56.1
31;2021-08-18;3314;7007;916749;792910;65.4;56.6
31;2021-08-19;2987;6994;919736;799904;65.7;57.1
31;2021-08-20;3025;7396;922761;807300;65.9;57.6
31;2021-08-21;1980;6800;924741;814100;66.0;58.1
31;2021-08-22;1486;5638;926227;819738;66.1;58.5
31;2021-08-23;2385;7728;928612;827466;66.3;59.1
31;2021-08-24;2609;6174;931221;833640;66.5;59.5
31;2021-08-25;2413;5728;933634;839368;66.6;59.9
31;2021-08-26;2279;5800;935913;845168;66.8;60.3
31;2021-08-27;2363;6663;938276;851831;67.0;60.8
31;2021-08-28;1846;6790;940122;858621;67.1;61.3
31;2021-08-29;1282;5067;941404;863688;67.2;61.7
31;2021-08-30;2190;6586;943594;870274;67.4;62.1
31;2021-08-31;2257;5450;945851;875724;67.5;62.5
31;2021-09-01;1754;4656;947605;880380;67.6;62.8
31;2021-09-02;1770;4050;949375;884430;67.8;63.1
31;2021-09-03;1830;4714;951205;889144;67.9;63.5
31;2021-09-04;2006;5688;953211;894832;68.0;63.9
31;2021-09-05;1129;2172;954340;897004;68.1;64.0
31;2021-09-06;1365;3038;955705;900042;68.2;64.2
31;2021-09-07;1262;2865;956967;902907;68.3;64.5
31;2021-09-08;1424;3424;958391;906331;68.4;64.7
31;2021-09-09;1109;2557;959500;908888;68.5;64.9
31;2021-09-10;1676;3405;961176;912293;68.6;65.1
31;2021-09-11;1292;3775;962468;916068;68.7;65.4
31;2021-09-12;541;1683;963009;917751;68.7;65.5
31;2021-09-13;1014;1988;964023;919739;68.8;65.7
31;2021-09-14;1247;2001;965270;921740;68.9;65.8
31;2021-09-15;1086;2691;966356;924431;69.0;66.0
31;2021-09-16;899;1680;967255;926111;69.0;66.1
31;2021-09-17;1076;2508;968331;928619;69.1;66.3
31;2021-09-18;856;2798;969187;931417;69.2;66.5
31;2021-09-19;321;1241;969508;932658;69.2;66.6
31;2021-09-20;608;1598;970116;934256;69.2;66.7
31;2021-09-21;822;1561;970938;935817;69.3;66.8
31;2021-09-22;833;2060;971771;937877;69.4;66.9
31;2021-09-23;773;1548;972544;939425;69.4;67.1
31;2021-09-24;830;2008;973374;941433;69.5;67.2
31;2021-09-25;662;2534;974036;943967;69.5;67.4
31;2021-09-26;249;1127;974285;945094;69.5;67.5
31;2021-09-27;689;1509;974974;946603;69.6;67.6
31;2021-09-28;728;1350;975702;947953;69.6;67.7
31;2021-09-29;757;1666;976459;949619;69.7;67.8
31;2021-09-30;719;1245;977178;950864;69.8;67.9
31;2021-10-01;826;1851;978004;952715;69.8;68.0
31;2021-10-02;765;1761;978769;954476;69.9;68.1
31;2021-10-03;107;349;978876;954825;69.9;68.2
31;2021-10-04;390;692;979266;955517;69.9;68.2
31;2021-10-05;535;1318;979801;956835;69.9;68.3
31;2021-10-06;602;1191;980403;958026;70.0;68.4
31;2021-10-07;639;1388;981042;959414;70.0;68.5
31;2021-10-08;757;1186;981799;960600;70.1;68.6
31;2021-10-09;505;1274;982304;961874;70.1;68.7
31;2021-10-10;20;57;982324;961931;70.1;68.7
31;2021-10-11;361;507;982685;962438;70.1;68.7
32;2020-12-27;0;0;0;0;0.0;0.0
32;2020-12-28;0;0;0;0;0.0;0.0
32;2020-12-29;0;0;0;0;0.0;0.0
32;2020-12-30;0;0;0;0;0.0;0.0
32;2020-12-31;0;0;0;0;0.0;0.0
32;2021-01-01;0;0;0;0;0.0;0.0
32;2021-01-02;0;0;0;0;0.0;0.0
32;2021-01-03;1;0;1;0;0.0;0.0
32;2021-01-04;3;0;4;0;0.0;0.0
32;2021-01-05;2;0;6;0;0.0;0.0
32;2021-01-06;3;0;9;0;0.0;0.0
32;2021-01-07;155;0;164;0;0.1;0.0
32;2021-01-08;70;0;234;0;0.1;0.0
32;2021-01-09;5;0;239;0;0.1;0.0
32;2021-01-10;0;0;239;0;0.1;0.0
32;2021-01-11;11;0;250;0;0.1;0.0
32;2021-01-12;96;0;346;0;0.2;0.0
32;2021-01-13;325;1;671;1;0.4;0.0
32;2021-01-14;389;3;1060;4;0.6;0.0
32;2021-01-15;449;3;1509;7;0.8;0.0
32;2021-01-16;17;2;1526;9;0.8;0.0
32;2021-01-17;1;0;1527;9;0.8;0.0
32;2021-01-18;345;1;1872;10;1.0;0.0
32;2021-01-19;420;0;2292;10;1.2;0.0
32;2021-01-20;358;0;2650;10;1.4;0.0
32;2021-01-21;582;2;3232;12;1.7;0.0
32;2021-01-22;372;0;3604;12;1.9;0.0
32;2021-01-23;189;0;3793;12;2.0;0.0
32;2021-01-24;5;0;3798;12;2.0;0.0
32;2021-01-25;468;1;4266;13;2.2;0.0
32;2021-01-26;611;0;4877;13;2.6;0.0
32;2021-01-27;703;4;5580;17;2.9;0.0
32;2021-01-28;687;15;6267;32;3.3;0.0
32;2021-01-29;461;54;6728;86;3.5;0.0
32;2021-01-30;260;0;6988;86;3.7;0.0
32;2021-01-31;4;5;6992;91;3.7;0.0
32;2021-02-01;289;58;7281;149;3.8;0.1
32;2021-02-02;640;139;7921;288;4.2;0.2
32;2021-02-03;338;200;8259;488;4.3;0.3
32;2021-02-04;426;279;8685;767;4.6;0.4
32;2021-02-05;346;360;9031;1127;4.8;0.6
32;2021-02-06;148;0;9179;1127;4.8;0.6
32;2021-02-07;0;36;9179;1163;4.8;0.6
32;2021-02-08;278;121;9457;1284;5.0;0.7
32;2021-02-09;310;229;9767;1513;5.1;0.8
32;2021-02-10;272;254;10039;1767;5.3;0.9
32;2021-02-11;383;317;10422;2084;5.5;1.1
32;2021-02-12;298;280;10720;2364;5.6;1.2
32;2021-02-13;249;1;10969;2365;5.8;1.2
32;2021-02-14;0;28;10969;2393;5.8;1.3
32;2021-02-15;25;212;10994;2605;5.8;1.4
32;2021-02-16;395;369;11389;2974;6.0;1.6
32;2021-02-17;191;474;11580;3448;6.1;1.8
32;2021-02-18;333;493;11913;3941;6.3;2.1
32;2021-02-19;184;278;12097;4219;6.4;2.2
32;2021-02-20;1;120;12098;4339;6.4;2.3
32;2021-02-21;0;0;12098;4339;6.4;2.3
32;2021-02-22;158;385;12256;4724;6.4;2.5
32;2021-02-23;432;571;12688;5295;6.7;2.8
32;2021-02-24;277;381;12965;5676;6.8;3.0
32;2021-02-25;481;526;13446;6202;7.1;3.3
32;2021-02-26;444;384;13890;6586;7.3;3.5
32;2021-02-27;157;246;14047;6832;7.4;3.6
32;2021-02-28;4;0;14051;6832;7.4;3.6
32;2021-03-01;51;300;14102;7132;7.4;3.8
32;2021-03-02;414;449;14516;7581;7.6;4.0
32;2021-03-03;276;292;14792;7873;7.8;4.1
32;2021-03-04;541;340;15333;8213;8.1;4.3
32;2021-03-05;438;248;15771;8461;8.3;4.5
32;2021-03-06;520;173;16291;8634;8.6;4.5
32;2021-03-07;25;5;16316;8639;8.6;4.5
32;2021-03-08;234;295;16550;8934;8.7;4.7
32;2021-03-09;644;333;17194;9267;9.0;4.9
32;2021-03-10;482;329;17676;9596;9.3;5.0
32;2021-03-11;855;295;18531;9891;9.8;5.2
32;2021-03-12;881;344;19412;10235;10.2;5.4
32;2021-03-13;492;246;19904;10481;10.5;5.5
32;2021-03-14;1;0;19905;10481;10.5;5.5
32;2021-03-15;264;26;20169;10507;10.6;5.5
32;2021-03-16;314;310;20483;10817;10.8;5.7
32;2021-03-17;150;156;20633;10973;10.9;5.8
32;2021-03-18;375;309;21008;11282;11.1;5.9
32;2021-03-19;405;183;21413;11465;11.3;6.0
32;2021-03-20;136;33;21549;11498;11.3;6.1
32;2021-03-21;0;0;21549;11498;11.3;6.1
32;2021-03-22;340;170;21889;11668;11.5;6.1
32;2021-03-23;560;399;22449;12067;11.8;6.3
32;2021-03-24;643;271;23092;12338;12.2;6.5
32;2021-03-25;899;418;23991;12756;12.6;6.7
32;2021-03-26;657;294;24648;13050;13.0;6.9
32;2021-03-27;165;3;24813;13053;13.1;6.9
32;2021-03-28;1;1;24814;13054;13.1;6.9
32;2021-03-29;371;49;25185;13103;13.3;6.9
32;2021-03-30;766;290;25951;13393;13.7;7.0
32;2021-03-31;654;174;26605;13567;14.0;7.1
32;2021-04-01;1237;320;27842;13887;14.7;7.3
32;2021-04-02;575;167;28417;14054;15.0;7.4
32;2021-04-03;114;0;28531;14054;15.0;7.4
32;2021-04-04;0;0;28531;14054;15.0;7.4
32;2021-04-05;0;0;28531;14054;15.0;7.4
32;2021-04-06;2650;316;31181;14370;16.4;7.6
32;2021-04-07;1178;206;32359;14576;17.0;7.7
32;2021-04-08;1736;407;34095;14983;17.9;7.9
32;2021-04-09;883;218;34978;15201;18.4;8.0
32;2021-04-10;809;30;35787;15231;18.8;8.0
32;2021-04-11;14;0;35801;15231;18.8;8.0
32;2021-04-12;477;23;36278;15254;19.1;8.0
32;2021-04-13;2469;389;38747;15643;20.4;8.2
32;2021-04-14;1226;264;39973;15907;21.0;8.4
32;2021-04-15;1704;395;41677;16302;21.9;8.6
32;2021-04-16;638;283;42315;16585;22.3;8.7
32;2021-04-17;783;39;43098;16624;22.7;8.7
32;2021-04-18;13;1;43111;16625;22.7;8.7
32;2021-04-19;502;46;43613;16671;22.9;8.8
32;2021-04-20;2472;394;46085;17065;24.3;9.0
32;2021-04-21;1009;302;47094;17367;24.8;9.1
32;2021-04-22;1662;321;48756;17688;25.7;9.3
32;2021-04-23;549;159;49305;17847;25.9;9.4
32;2021-04-24;1392;58;50697;17905;26.7;9.4
32;2021-04-25;0;11;50697;17916;26.7;9.4
32;2021-04-26;387;359;51084;18275;26.9;9.6
32;2021-04-27;2551;559;53635;18834;28.2;9.9
32;2021-04-28;972;357;54607;19191;28.7;10.1
32;2021-04-29;1008;885;55615;20076;29.3;10.6
32;2021-04-30;453;363;56068;20439;29.5;10.8
32;2021-05-01;2607;98;58675;20537;30.9;10.8
32;2021-05-02;0;0;58675;20537;30.9;10.8
32;2021-05-03;170;321;58845;20858;31.0;11.0
32;2021-05-04;785;2497;59630;23355;31.4;12.3
32;2021-05-05;2360;1101;61990;24456;32.6;12.9
32;2021-05-06;516;1661;62506;26117;32.9;13.7
32;2021-05-07;2286;539;64792;26656;34.1;14.0
32;2021-05-08;70;516;64862;27172;34.1;14.3
32;2021-05-09;21;179;64883;27351;34.1;14.4
32;2021-05-10;1994;553;66877;27904;35.2;14.7
32;2021-05-11;651;2278;67528;30182;35.5;15.9
32;2021-05-12;2313;1137;69841;31319;36.8;16.5
32;2021-05-13;280;1417;70121;32736;36.9;17.2
32;2021-05-14;2223;328;72344;33064;38.1;17.4
32;2021-05-15;134;712;72478;33776;38.1;17.8
32;2021-05-16;2;0;72480;33776;38.1;17.8
32;2021-05-17;353;170;72833;33946;38.3;17.9
32;2021-05-18;1642;298;74475;34244;39.2;18.0
32;2021-05-19;2474;273;76949;34517;40.5;18.2
32;2021-05-20;2885;471;79834;34988;42.0;18.4
32;2021-05-21;2532;500;82366;35488;43.3;18.7
32;2021-05-22;334;110;82700;35598;43.5;18.7
32;2021-05-23;2;13;82702;35611;43.5;18.7
32;2021-05-24;3;0;82705;35611;43.5;18.7
32;2021-05-25;1982;373;84687;35984;44.6;18.9
32;2021-05-26;2547;557;87234;36541;45.9;19.2
32;2021-05-27;2876;626;90110;37167;47.4;19.6
32;2021-05-28;2308;767;92418;37934;48.6;20.0
32;2021-05-29;372;314;92790;38248;48.8;20.1
32;2021-05-30;4;6;92794;38254;48.8;20.1
32;2021-05-31;1413;626;94207;38880;49.6;20.5
32;2021-06-01;567;2889;94774;41769;49.9;22.0
32;2021-06-02;1580;1351;96354;43120;50.7;22.7
32;2021-06-03;395;2086;96749;45206;50.9;23.8
32;2021-06-04;1836;831;98585;46037;51.9;24.2
32;2021-06-05;206;1660;98791;47697;52.0;25.1
32;2021-06-06;8;14;98799;47711;52.0;25.1
32;2021-06-07;102;418;98901;48129;52.0;25.3
32;2021-06-08;663;2538;99564;50667;52.4;26.7
32;2021-06-09;1191;1056;100755;51723;53.0;27.2
32;2021-06-10;684;1225;101439;52948;53.4;27.9
32;2021-06-11;926;663;102365;53611;53.9;28.2
32;2021-06-12;150;2679;102515;56290;53.9;29.6
32;2021-06-13;1;1;102516;56291;53.9;29.6
32;2021-06-14;528;210;103044;56501;54.2;29.7
32;2021-06-15;1733;1027;104777;57528;55.1;30.3
32;2021-06-16;850;2778;105627;60306;55.6;31.7
32;2021-06-17;859;829;106486;61135;56.0;32.2
32;2021-06-18;315;2724;106801;63859;56.2;33.6
32;2021-06-19;914;437;107715;64296;56.7;33.8
32;2021-06-20;5;13;107720;64309;56.7;33.8
32;2021-06-21;67;1994;107787;66303;56.7;34.9
32;2021-06-22;1042;971;108829;67274;57.3;35.4
32;2021-06-23;517;2184;109346;69458;57.5;36.5
32;2021-06-24;528;517;109874;69975;57.8;36.8
32;2021-06-25;501;2360;110375;72335;58.1;38.1
32;2021-06-26;108;171;110483;72506;58.1;38.2
32;2021-06-27;2;5;110485;72511;58.1;38.2
32;2021-06-28;630;603;111115;73114;58.5;38.5
32;2021-06-29;800;1982;111915;75096;58.9;39.5
32;2021-06-30;757;2726;112672;77822;59.3;41.0
32;2021-07-01;538;2638;113210;80460;59.6;42.3
32;2021-07-02;641;2335;113851;82795;59.9;43.6
32;2021-07-03;481;506;114332;83301;60.2;43.8
32;2021-07-04;2;12;114334;83313;60.2;43.8
32;2021-07-05;76;390;114410;83703;60.2;44.0
32;2021-07-06;878;2083;115288;85786;60.7;45.1
32;2021-07-07;781;2757;116069;88543;61.1;46.6
32;2021-07-08;479;2268;116548;90811;61.3;47.8
32;2021-07-09;615;2226;117163;93037;61.7;49.0
32;2021-07-10;536;520;117699;93557;61.9;49.2
32;2021-07-11;0;5;117699;93562;61.9;49.2
32;2021-07-12;526;1244;118225;94806;62.2;49.9
32;2021-07-13;1695;1817;119920;96623;63.1;50.8
32;2021-07-14;492;36;120412;96659;63.4;50.9
32;2021-07-15;2096;892;122508;97551;64.5;51.3
32;2021-07-16;1170;1914;123678;99465;65.1;52.3
32;2021-07-17;78;128;123756;99593;65.1;52.4
32;2021-07-18;2;5;123758;99598;65.1;52.4
32;2021-07-19;1997;147;125755;99745;66.2;52.5
32;2021-07-20;2036;1272;127791;101017;67.2;53.2
32;2021-07-21;1614;1692;129405;102709;68.1;54.0
32;2021-07-22;1946;513;131351;103222;69.1;54.3
32;2021-07-23;1408;1731;132759;104953;69.9;55.2
32;2021-07-24;139;118;132898;105071;69.9;55.3
32;2021-07-25;34;10;132932;105081;69.9;55.3
32;2021-07-26;1071;1070;134003;106151;70.5;55.9
32;2021-07-27;1730;2100;135733;108251;71.4;57.0
32;2021-07-28;694;975;136427;109226;71.8;57.5
32;2021-07-29;1694;1609;138121;110835;72.7;58.3
32;2021-07-30;363;349;138484;111184;72.9;58.5
32;2021-07-31;186;350;138670;111534;73.0;58.7
32;2021-08-01;18;4;138688;111538;73.0;58.7
32;2021-08-02;82;76;138770;111614;73.0;58.7
32;2021-08-03;1173;1792;139943;113406;73.6;59.7
32;2021-08-04;634;652;140577;114058;74.0;60.0
32;2021-08-05;1105;1944;141682;116002;74.6;61.0
32;2021-08-06;563;495;142245;116497;74.9;61.3
32;2021-08-07;148;92;142393;116589;74.9;61.3
32;2021-08-08;1;0;142394;116589;74.9;61.3
32;2021-08-09;263;1826;142657;118415;75.1;62.3
32;2021-08-10;715;2078;143372;120493;75.4;63.4
32;2021-08-11;579;446;143951;120939;75.7;63.6
32;2021-08-12;931;2102;144882;123041;76.2;64.7
32;2021-08-13;178;249;145060;123290;76.3;64.9
32;2021-08-14;113;117;145173;123407;76.4;64.9
32;2021-08-15;13;21;145186;123428;76.4;64.9
32;2021-08-16;44;40;145230;123468;76.4;65.0
32;2021-08-17;573;2301;145803;125769;76.7;66.2
32;2021-08-18;312;559;146115;126328;76.9;66.5
32;2021-08-19;957;1410;147072;127738;77.4;67.2
32;2021-08-20;171;166;147243;127904;77.5;67.3
32;2021-08-21;150;192;147393;128096;77.6;67.4
32;2021-08-22;8;3;147401;128099;77.6;67.4
32;2021-08-23;45;101;147446;128200;77.6;67.5
32;2021-08-24;585;1449;148031;129649;77.9;68.2
32;2021-08-25;94;191;148125;129840;77.9;68.3
32;2021-08-26;321;2261;148446;132101;78.1;69.5
32;2021-08-27;275;553;148721;132654;78.3;69.8
32;2021-08-28;70;109;148791;132763;78.3;69.9
32;2021-08-29;1;8;148792;132771;78.3;69.9
32;2021-08-30;20;49;148812;132820;78.3;69.9
32;2021-08-31;195;1516;149007;134336;78.4;70.7
32;2021-09-01;649;784;149656;135120;78.7;71.1
32;2021-09-02;318;1579;149974;136699;78.9;71.9
32;2021-09-03;188;294;150162;136993;79.0;72.1
32;2021-09-04;49;90;150211;137083;79.0;72.1
32;2021-09-05;12;15;150223;137098;79.0;72.1
32;2021-09-06;38;72;150261;137170;79.1;72.2
32;2021-09-07;438;810;150699;137980;79.3;72.6
32;2021-09-08;255;483;150954;138463;79.4;72.9
32;2021-09-09;227;885;151181;139348;79.6;73.3
32;2021-09-10;203;195;151384;139543;79.7;73.4
32;2021-09-11;88;137;151472;139680;79.7;73.5
32;2021-09-12;7;11;151479;139691;79.7;73.5
32;2021-09-13;4;10;151483;139701;79.7;73.5
32;2021-09-14;321;573;151804;140274;79.9;73.8
32;2021-09-15;200;145;152004;140419;80.0;73.9
32;2021-09-16;182;216;152186;140635;80.1;74.0
32;2021-09-17;199;345;152385;140980;80.2;74.2
32;2021-09-18;40;62;152425;141042;80.2;74.2
32;2021-09-19;0;2;152425;141044;80.2;74.2
32;2021-09-20;4;18;152429;141062;80.2;74.2
32;2021-09-21;241;458;152670;141520;80.3;74.5
32;2021-09-22;233;547;152903;142067;80.5;74.8
32;2021-09-23;132;218;153035;142285;80.5;74.9
32;2021-09-24;101;288;153136;142573;80.6;75.0
32;2021-09-25;28;51;153164;142624;80.6;75.0
32;2021-09-26;3;5;153167;142629;80.6;75.1
32;2021-09-27;9;29;153176;142658;80.6;75.1
32;2021-09-28;113;515;153289;143173;80.7;75.3
32;2021-09-29;88;334;153377;143507;80.7;75.5
32;2021-09-30;170;201;153547;143708;80.8;75.6
32;2021-10-01;100;243;153647;143951;80.8;75.7
32;2021-10-02;28;103;153675;144054;80.9;75.8
32;2021-10-03;0;8;153675;144062;80.9;75.8
32;2021-10-04;7;13;153682;144075;80.9;75.8
32;2021-10-05;59;287;153741;144362;80.9;76.0
32;2021-10-06;41;260;153782;144622;80.9;76.1
32;2021-10-07;55;216;153837;144838;80.9;76.2
32;2021-10-08;65;257;153902;145095;81.0;76.3
32;2021-10-09;25;52;153927;145147;81.0;76.4
32;2021-10-10;0;0;153927;145147;81.0;76.4
32;2021-10-11;11;46;153938;145193;81.0;76.4
33;2020-12-27;4;0;4;0;0.0;0.0
33;2020-12-28;4;0;8;0;0.0;0.0
33;2020-12-29;0;0;8;0;0.0;0.0
33;2020-12-30;0;0;8;0;0.0;0.0
33;2020-12-31;1;0;9;0;0.0;0.0
33;2021-01-01;0;0;9;0;0.0;0.0
33;2021-01-02;2;1;11;1;0.0;0.0
33;2021-01-03;2;1;13;2;0.0;0.0
33;2021-01-04;2;0;15;2;0.0;0.0
33;2021-01-05;2;0;17;2;0.0;0.0
33;2021-01-06;134;1;151;3;0.0;0.0
33;2021-01-07;1309;4;1460;7;0.1;0.0
33;2021-01-08;1200;3;2660;10;0.2;0.0
33;2021-01-09;298;1;2958;11;0.2;0.0
33;2021-01-10;229;0;3187;11;0.2;0.0
33;2021-01-11;628;0;3815;11;0.2;0.0
33;2021-01-12;1415;2;5230;13;0.3;0.0
33;2021-01-13;1313;9;6543;22;0.4;0.0
33;2021-01-14;1293;19;7836;41;0.5;0.0
33;2021-01-15;1610;14;9446;55;0.6;0.0
33;2021-01-16;568;10;10014;65;0.6;0.0
33;2021-01-17;406;4;10420;69;0.6;0.0
33;2021-01-18;1225;14;11645;83;0.7;0.0
33;2021-01-19;2937;13;14582;96;0.9;0.0
33;2021-01-20;3422;17;18004;113;1.1;0.0
33;2021-01-21;2863;9;20867;122;1.3;0.0
33;2021-01-22;2328;13;23195;135;1.4;0.0
33;2021-01-23;853;3;24048;138;1.5;0.0
33;2021-01-24;532;2;24580;140;1.5;0.0
33;2021-01-25;2172;63;26752;203;1.6;0.0
33;2021-01-26;2263;164;29015;367;1.8;0.0
33;2021-01-27;2263;209;31278;576;1.9;0.0
33;2021-01-28;2160;438;33438;1014;2.0;0.1
33;2021-01-29;1825;684;35263;1698;2.2;0.1
33;2021-01-30;707;172;35970;1870;2.2;0.1
33;2021-01-31;390;158;36360;2028;2.2;0.1
33;2021-02-01;1457;648;37817;2676;2.3;0.2
33;2021-02-02;2646;1112;40463;3788;2.5;0.2
33;2021-02-03;2942;874;43405;4662;2.7;0.3
33;2021-02-04;4031;1351;47436;6013;2.9;0.4
33;2021-02-05;2193;1172;49629;7185;3.0;0.4
33;2021-02-06;648;199;50277;7384;3.1;0.5
33;2021-02-07;219;229;50496;7613;3.1;0.5
33;2021-02-08;1265;756;51761;8369;3.2;0.5
33;2021-02-09;1327;1675;53088;10044;3.3;0.6
33;2021-02-10;1267;1747;54355;11791;3.3;0.7
33;2021-02-11;1305;1443;55660;13234;3.4;0.8
33;2021-02-12;1121;1250;56781;14484;3.5;0.9
33;2021-02-13;204;292;56985;14776;3.5;0.9
33;2021-02-14;47;245;57032;15021;3.5;0.9
33;2021-02-15;684;1717;57716;16738;3.5;1.0
33;2021-02-16;816;2053;58532;18791;3.6;1.2
33;2021-02-17;668;2048;59200;20839;3.6;1.3
33;2021-02-18;899;2241;60099;23080;3.7;1.4
33;2021-02-19;918;2014;61017;25094;3.7;1.5
33;2021-02-20;78;656;61095;25750;3.7;1.6
33;2021-02-21;37;460;61132;26210;3.7;1.6
33;2021-02-22;709;1885;61841;28095;3.8;1.7
33;2021-02-23;1235;2746;63076;30841;3.9;1.9
33;2021-02-24;1407;2522;64483;33363;3.9;2.0
33;2021-02-25;2839;3759;67322;37122;4.1;2.3
33;2021-02-26;4059;2335;71381;39457;4.4;2.4
33;2021-02-27;1360;722;72741;40179;4.5;2.5
33;2021-02-28;127;514;72868;40693;4.5;2.5
33;2021-03-01;1537;1856;74405;42549;4.6;2.6
33;2021-03-02;2326;1747;76731;44296;4.7;2.7
33;2021-03-03;2312;1709;79043;46005;4.8;2.8
33;2021-03-04;3937;1672;82980;47677;5.1;2.9
33;2021-03-05;5762;1744;88742;49421;5.4;3.0
33;2021-03-06;3416;566;92158;49987;5.6;3.1
33;2021-03-07;741;160;92899;50147;5.7;3.1
33;2021-03-08;2712;1153;95611;51300;5.9;3.1
33;2021-03-09;4404;1341;100015;52641;6.1;3.2
33;2021-03-10;5122;1243;105137;53884;6.4;3.3
33;2021-03-11;7546;1238;112683;55122;6.9;3.4
33;2021-03-12;10119;1180;122802;56302;7.5;3.4
33;2021-03-13;5155;219;127957;56521;7.8;3.5
33;2021-03-14;714;29;128671;56550;7.9;3.5
33;2021-03-15;4445;685;133116;57235;8.1;3.5
33;2021-03-16;3582;883;136698;58118;8.4;3.6
33;2021-03-17;3643;954;140341;59072;8.6;3.6
33;2021-03-18;4037;1417;144378;60489;8.8;3.7
33;2021-03-19;6270;1042;150648;61531;9.2;3.8
33;2021-03-20;3368;109;154016;61640;9.4;3.8
33;2021-03-21;462;30;154478;61670;9.5;3.8
33;2021-03-22;4901;456;159379;62126;9.8;3.8
33;2021-03-23;6324;612;165703;62738;10.1;3.8
33;2021-03-24;7076;530;172779;63268;10.6;3.9
33;2021-03-25;8843;661;181622;63929;11.1;3.9
33;2021-03-26;10040;864;191662;64793;11.7;4.0
33;2021-03-27;3619;84;195281;64877;12.0;4.0
33;2021-03-28;577;34;195858;64911;12.0;4.0
33;2021-03-29;6765;707;202623;65618;12.4;4.0
33;2021-03-30;8103;1050;210726;66668;12.9;4.1
33;2021-03-31;7577;1071;218303;67739;13.4;4.1
33;2021-04-01;8824;1204;227127;68943;13.9;4.2
33;2021-04-02;8411;1567;235538;70510;14.4;4.3
33;2021-04-03;2832;526;238370;71036;14.6;4.3
33;2021-04-04;218;160;238588;71196;14.6;4.4
33;2021-04-05;694;125;239282;71321;14.6;4.4
33;2021-04-06;6048;2689;245330;74010;15.0;4.5
33;2021-04-07;7422;2552;252752;76562;15.5;4.7
33;2021-04-08;10329;2789;263081;79351;16.1;4.9
33;2021-04-09;12686;3103;275767;82454;16.9;5.0
33;2021-04-10;5357;1395;281124;83849;17.2;5.1
33;2021-04-11;1002;353;282126;84202;17.3;5.2
33;2021-04-12;7426;3285;289552;87487;17.7;5.4
33;2021-04-13;9321;3500;298873;90987;18.3;5.6
33;2021-04-14;9040;3649;307913;94636;18.9;5.8
33;2021-04-15;10110;3890;318023;98526;19.5;6.0
33;2021-04-16;9718;4233;327741;102759;20.1;6.3
33;2021-04-17;4652;1662;332393;104421;20.3;6.4
33;2021-04-18;929;414;333322;104835;20.4;6.4
33;2021-04-19;5616;3844;338938;108679;20.7;6.7
33;2021-04-20;7294;4272;346232;112951;21.2;6.9
33;2021-04-21;6594;4355;352826;117306;21.6;7.2
33;2021-04-22;7350;4494;360176;121800;22.1;7.5
33;2021-04-23;7703;4837;367879;126637;22.5;7.8
33;2021-04-24;4500;1804;372379;128441;22.8;7.9
33;2021-04-25;1652;418;374031;128859;22.9;7.9
33;2021-04-26;5270;5090;379301;133949;23.2;8.2
33;2021-04-27;6579;5633;385880;139582;23.6;8.5
33;2021-04-28;6782;5583;392662;145165;24.0;8.9
33;2021-04-29;8425;6251;401087;151416;24.6;9.3
33;2021-04-30;8740;6134;409827;157550;25.1;9.6
33;2021-05-01;2902;516;412729;158066;25.3;9.7
33;2021-05-02;1835;348;414564;158414;25.4;9.7
33;2021-05-03;7018;5222;421582;163636;25.8;10.0
33;2021-05-04;6827;6673;428409;170309;26.2;10.4
33;2021-05-05;7140;7573;435549;177882;26.7;10.9
33;2021-05-06;8704;8245;444253;186127;27.2;11.4
33;2021-05-07;8610;8924;452863;195051;27.7;11.9
33;2021-05-08;3543;1600;456406;196651;27.9;12.0
33;2021-05-09;1118;969;457524;197620;28.0;12.1
33;2021-05-10;6874;7312;464398;204932;28.4;12.5
33;2021-05-11;8634;7882;473032;212814;29.0;13.0
33;2021-05-12;9175;6704;482207;219518;29.5;13.4
33;2021-05-13;5211;2114;487418;221632;29.8;13.6
33;2021-05-14;8129;5354;495547;226986;30.3;13.9
33;2021-05-15;5179;2865;500726;229851;30.7;14.1
33;2021-05-16;1842;803;502568;230654;30.8;14.1
33;2021-05-17;8861;5112;511429;235766;31.3;14.4
33;2021-05-18;10625;4890;522054;240656;32.0;14.7
33;2021-05-19;10900;4786;532954;245442;32.6;15.0
33;2021-05-20;10907;5588;543861;251030;33.3;15.4
33;2021-05-21;10915;6251;554776;257281;34.0;15.8
33;2021-05-22;5121;2751;559897;260032;34.3;15.9
33;2021-05-23;1751;385;561648;260417;34.4;15.9
33;2021-05-24;5412;1001;567060;261418;34.7;16.0
33;2021-05-25;9391;5784;576451;267202;35.3;16.4
33;2021-05-26;9675;6048;586126;273250;35.9;16.7
33;2021-05-27;10901;7725;597027;280975;36.6;17.2
33;2021-05-28;10062;9519;607089;290494;37.2;17.8
33;2021-05-29;5042;4117;612131;294611;37.5;18.0
33;2021-05-30;1703;667;613834;295278;37.6;18.1
33;2021-05-31;8550;6422;622384;301700;38.1;18.5
33;2021-06-01;11802;8722;634186;310422;38.8;19.0
33;2021-06-02;11711;8215;645897;318637;39.5;19.5
33;2021-06-03;12715;9209;658612;327846;40.3;20.1
33;2021-06-04;12933;10957;671545;338803;41.1;20.7
33;2021-06-05;5272;5063;676817;343866;41.4;21.1
33;2021-06-06;2526;1194;679343;345060;41.6;21.1
33;2021-06-07;9758;8503;689101;353563;42.2;21.6
33;2021-06-08;11938;9465;701039;363028;42.9;22.2
33;2021-06-09;11775;8533;712814;371561;43.6;22.7
33;2021-06-10;12950;8395;725764;379956;44.4;23.3
33;2021-06-11;12516;11171;738280;391127;45.2;23.9
33;2021-06-12;6185;4481;744465;395608;45.6;24.2
33;2021-06-13;2613;1283;747078;396891;45.7;24.3
33;2021-06-14;8580;10158;755658;407049;46.3;24.9
33;2021-06-15;12054;10274;767712;417323;47.0;25.5
33;2021-06-16;12058;8878;779770;426201;47.7;26.1
33;2021-06-17;13116;9622;792886;435823;48.5;26.7
33;2021-06-18;11797;11443;804683;447266;49.3;27.4
33;2021-06-19;5610;4821;810293;452087;49.6;27.7
33;2021-06-20;2946;1475;813239;453562;49.8;27.8
33;2021-06-21;7875;10167;821114;463729;50.3;28.4
33;2021-06-22;9065;11085;830179;474814;50.8;29.1
33;2021-06-23;8672;10847;838851;485661;51.4;29.7
33;2021-06-24;9743;9979;848594;495640;52.0;30.3
33;2021-06-25;8047;13716;856641;509356;52.4;31.2
33;2021-06-26;4345;5920;860986;515276;52.7;31.5
33;2021-06-27;2467;1959;863453;517235;52.9;31.7
33;2021-06-28;4871;12763;868324;529998;53.2;32.4
33;2021-06-29;6443;13656;874767;543654;53.6;33.3
33;2021-06-30;6681;13394;881448;557048;54.0;34.1
33;2021-07-01;8046;11808;889494;568856;54.5;34.8
33;2021-07-02;6843;15110;896337;583966;54.9;35.8
33;2021-07-03;3227;6785;899564;590751;55.1;36.2
33;2021-07-04;2065;2379;901629;593130;55.2;36.3
33;2021-07-05;4398;12908;906027;606038;55.5;37.1
33;2021-07-06;6147;14593;912174;620631;55.8;38.0
33;2021-07-07;6895;13053;919069;633684;56.3;38.8
33;2021-07-08;7972;12758;927041;646442;56.8;39.6
33;2021-07-09;6471;15111;933512;661553;57.2;40.5
33;2021-07-10;3114;7162;936626;668715;57.3;40.9
33;2021-07-11;1844;2303;938470;671018;57.5;41.1
33;2021-07-12;3951;14705;942421;685723;57.7;42.0
33;2021-07-13;7153;16107;949574;701830;58.1;43.0
33;2021-07-14;3689;5315;953263;707145;58.4;43.3
33;2021-07-15;7627;15982;960890;723127;58.8;44.3
33;2021-07-16;8589;15151;969479;738278;59.4;45.2
33;2021-07-17;3156;6433;972635;744711;59.5;45.6
33;2021-07-18;1702;3205;974337;747916;59.6;45.8
33;2021-07-19;5871;15095;980208;763011;60.0;46.7
33;2021-07-20;7432;16135;987640;779146;60.5;47.7
33;2021-07-21;8370;14543;996010;793689;61.0;48.6
33;2021-07-22;9365;15110;1005375;808799;61.5;49.5
33;2021-07-23;9666;16350;1015041;825149;62.1;50.5
33;2021-07-24;3838;7554;1018879;832703;62.4;51.0
33;2021-07-25;2093;2667;1020972;835370;62.5;51.1
33;2021-07-26;6966;13420;1027938;848790;62.9;52.0
33;2021-07-27;10091;13403;1038029;862193;63.5;52.8
33;2021-07-28;10931;11976;1048960;874169;64.2;53.5
33;2021-07-29;11673;11912;1060633;886081;64.9;54.2
33;2021-07-30;11400;12225;1072033;898306;65.6;55.0
33;2021-07-31;4761;5650;1076794;903956;65.9;55.3
33;2021-08-01;2484;1951;1079278;905907;66.1;55.5
33;2021-08-02;8419;9892;1087697;915799;66.6;56.1
33;2021-08-03;11560;9027;1099257;924826;67.3;56.6
33;2021-08-04;12286;7370;1111543;932196;68.0;57.1
33;2021-08-05;11936;8046;1123479;940242;68.8;57.6
33;2021-08-06;11231;9057;1134710;949299;69.5;58.1
33;2021-08-07;5929;4517;1140639;953816;69.8;58.4
33;2021-08-08;3200;1819;1143839;955635;70.0;58.5
33;2021-08-09;8661;8721;1152500;964356;70.6;59.0
33;2021-08-10;9374;8452;1161874;972808;71.1;59.6
33;2021-08-11;8115;7589;1169989;980397;71.6;60.0
33;2021-08-12;7980;8021;1177969;988418;72.1;60.5
33;2021-08-13;7847;7680;1185816;996098;72.6;61.0
33;2021-08-14;3526;4332;1189342;1000430;72.8;61.2
33;2021-08-15;1211;1881;1190553;1002311;72.9;61.4
33;2021-08-16;6429;8628;1196982;1010939;73.3;61.9
33;2021-08-17;6639;9070;1203621;1020009;73.7;62.4
33;2021-08-18;5631;8771;1209252;1028780;74.0;63.0
33;2021-08-19;5505;9120;1214757;1037900;74.4;63.5
33;2021-08-20;4962;9836;1219719;1047736;74.7;64.1
33;2021-08-21;2208;5037;1221927;1052773;74.8;64.5
33;2021-08-22;565;2366;1222492;1055139;74.8;64.6
33;2021-08-23;3922;10289;1226414;1065428;75.1;65.2
33;2021-08-24;4143;11094;1230557;1076522;75.3;65.9
33;2021-08-25;3724;10489;1234281;1087011;75.6;66.5
33;2021-08-26;3662;11057;1237943;1098068;75.8;67.2
33;2021-08-27;3829;12587;1241772;1110655;76.0;68.0
33;2021-08-28;1580;6639;1243352;1117294;76.1;68.4
33;2021-08-29;455;2426;1243807;1119720;76.1;68.5
33;2021-08-30;2377;10460;1246184;1130180;76.3;69.2
33;2021-08-31;3250;10859;1249434;1141039;76.5;69.9
33;2021-09-01;2868;8284;1252302;1149323;76.7;70.4
33;2021-09-02;2710;7786;1255012;1157109;76.8;70.8
33;2021-09-03;3116;9374;1258128;1166483;77.0;71.4
33;2021-09-04;1656;5793;1259784;1172276;77.1;71.8
33;2021-09-05;414;1459;1260198;1173735;77.1;71.9
33;2021-09-06;1624;6438;1261822;1180173;77.2;72.3
33;2021-09-07;2080;5717;1263902;1185890;77.4;72.6
33;2021-09-08;1766;5903;1265668;1191793;77.5;73.0
33;2021-09-09;1902;5651;1267570;1197444;77.6;73.3
33;2021-09-10;2096;6304;1269666;1203748;77.7;73.7
33;2021-09-11;1002;4232;1270668;1207980;77.8;74.0
33;2021-09-12;131;556;1270799;1208536;77.8;74.0
33;2021-09-13;1507;3615;1272306;1212151;77.9;74.2
33;2021-09-14;1564;3487;1273870;1215638;78.0;74.4
33;2021-09-15;1547;4445;1275417;1220083;78.1;74.7
33;2021-09-16;1483;3349;1276900;1223432;78.2;74.9
33;2021-09-17;1801;4517;1278701;1227949;78.3;75.2
33;2021-09-18;606;3052;1279307;1231001;78.3;75.4
33;2021-09-19;115;398;1279422;1231399;78.3;75.4
33;2021-09-20;1056;2158;1280478;1233557;78.4;75.5
33;2021-09-21;956;2450;1281434;1236007;78.5;75.7
33;2021-09-22;959;3446;1282393;1239453;78.5;75.9
33;2021-09-23;904;2305;1283297;1241758;78.6;76.0
33;2021-09-24;1289;3721;1284586;1245479;78.6;76.2
33;2021-09-25;515;2354;1285101;1247833;78.7;76.4
33;2021-09-26;64;333;1285165;1248166;78.7;76.4
33;2021-09-27;667;2014;1285832;1250180;78.7;76.5
33;2021-09-28;826;2150;1286658;1252330;78.8;76.7
33;2021-09-29;889;2211;1287547;1254541;78.8;76.8
33;2021-09-30;694;1686;1288241;1256227;78.9;76.9
33;2021-10-01;1059;2684;1289300;1258911;78.9;77.1
33;2021-10-02;557;1350;1289857;1260261;79.0;77.2
33;2021-10-03;10;45;1289867;1260306;79.0;77.2
33;2021-10-04;645;1399;1290512;1261705;79.0;77.2
33;2021-10-05;546;1424;1291058;1263129;79.0;77.3
33;2021-10-06;785;1684;1291843;1264813;79.1;77.4
33;2021-10-07;582;1477;1292425;1266290;79.1;77.5
33;2021-10-08;862;2112;1293287;1268402;79.2;77.7
33;2021-10-09;493;925;1293780;1269327;79.2;77.7
33;2021-10-10;5;42;1293785;1269369;79.2;77.7
33;2021-10-11;490;1183;1294275;1270552;79.2;77.8
34;2020-12-27;1;0;1;0;0.0;0.0
34;2020-12-28;3;0;4;0;0.0;0.0
34;2020-12-29;0;0;4;0;0.0;0.0
34;2020-12-30;0;0;4;0;0.0;0.0
34;2020-12-31;0;0;4;0;0.0;0.0
34;2021-01-01;1;0;5;0;0.0;0.0
34;2021-01-02;2;0;7;0;0.0;0.0
34;2021-01-03;0;0;7;0;0.0;0.0
34;2021-01-04;23;0;30;0;0.0;0.0
34;2021-01-05;108;2;138;2;0.0;0.0
34;2021-01-06;199;7;337;9;0.0;0.0
34;2021-01-07;364;0;701;9;0.1;0.0
34;2021-01-08;606;0;1307;9;0.1;0.0
34;2021-01-09;244;0;1551;9;0.1;0.0
34;2021-01-10;94;1;1645;10;0.1;0.0
34;2021-01-11;567;2;2212;12;0.2;0.0
34;2021-01-12;1009;1;3221;13;0.3;0.0
34;2021-01-13;1098;7;4319;20;0.4;0.0
34;2021-01-14;1955;14;6274;34;0.5;0.0
34;2021-01-15;1471;7;7745;41;0.7;0.0
34;2021-01-16;332;7;8077;48;0.7;0.0
34;2021-01-17;235;1;8312;49;0.7;0.0
34;2021-01-18;1125;5;9437;54;0.8;0.0
34;2021-01-19;1610;8;11047;62;0.9;0.0
34;2021-01-20;2091;23;13138;85;1.1;0.0
34;2021-01-21;4234;20;17372;105;1.5;0.0
34;2021-01-22;2556;10;19928;115;1.7;0.0
34;2021-01-23;600;2;20528;117;1.7;0.0
34;2021-01-24;3;0;20531;117;1.7;0.0
34;2021-01-25;1242;6;21773;123;1.9;0.0
34;2021-01-26;1461;20;23234;143;2.0;0.0
34;2021-01-27;1472;24;24706;167;2.1;0.0
34;2021-01-28;1393;124;26099;291;2.2;0.0
34;2021-01-29;1260;139;27359;430;2.3;0.0
34;2021-01-30;479;25;27838;455;2.4;0.0
34;2021-01-31;4;0;27842;455;2.4;0.0
34;2021-02-01;1028;248;28870;703;2.5;0.1
34;2021-02-02;1464;443;30334;1146;2.6;0.1
34;2021-02-03;2654;525;32988;1671;2.8;0.1
34;2021-02-04;2318;887;35306;2558;3.0;0.2
34;2021-02-05;1891;1176;37197;3734;3.2;0.3
34;2021-02-06;497;241;37694;3975;3.2;0.3
34;2021-02-07;34;108;37728;4083;3.2;0.3
34;2021-02-08;860;1060;38588;5143;3.3;0.4
34;2021-02-09;1035;1301;39623;6444;3.4;0.5
34;2021-02-10;1295;1504;40918;7948;3.5;0.7
34;2021-02-11;1794;2706;42712;10654;3.6;0.9
34;2021-02-12;1923;1645;44635;12299;3.8;1.0
34;2021-02-13;357;513;44992;12812;3.8;1.1
34;2021-02-14;22;286;45014;13098;3.8;1.1
34;2021-02-15;673;1203;45687;14301;3.9;1.2
34;2021-02-16;666;1523;46353;15824;3.9;1.3
34;2021-02-17;715;1519;47068;17343;4.0;1.5
34;2021-02-18;838;1490;47906;18833;4.1;1.6
34;2021-02-19;816;1225;48722;20058;4.1;1.7
34;2021-02-20;300;479;49022;20537;4.2;1.7
34;2021-02-21;64;18;49086;20555;4.2;1.7
34;2021-02-22;630;1296;49716;21851;4.2;1.9
34;2021-02-23;566;1479;50282;23330;4.3;2.0
34;2021-02-24;943;2333;51225;25663;4.4;2.2
34;2021-02-25;1608;2276;52833;27939;4.5;2.4
34;2021-02-26;1850;1632;54683;29571;4.6;2.5
34;2021-02-27;702;431;55385;30002;4.7;2.6
34;2021-02-28;86;64;55471;30066;4.7;2.6
34;2021-03-01;932;1162;56403;31228;4.8;2.7
34;2021-03-02;1592;1279;57995;32507;4.9;2.8
34;2021-03-03;1835;1407;59830;33914;5.1;2.9
34;2021-03-04;2868;1629;62698;35543;5.3;3.0
34;2021-03-05;3686;1544;66384;37087;5.6;3.2
34;2021-03-06;2640;208;69024;37295;5.9;3.2
34;2021-03-07;1242;78;70266;37373;6.0;3.2
34;2021-03-08;2781;1014;73047;38387;6.2;3.3
34;2021-03-09;4020;1458;77067;39845;6.6;3.4
34;2021-03-10;3992;1342;81059;41187;6.9;3.5
34;2021-03-11;5436;1317;86495;42504;7.4;3.6
34;2021-03-12;6491;941;92986;43445;7.9;3.7
34;2021-03-13;3138;182;96124;43627;8.2;3.7
34;2021-03-14;1003;56;97127;43683;8.3;3.7
34;2021-03-15;3308;574;100435;44257;8.5;3.8
34;2021-03-16;2912;674;103347;44931;8.8;3.8
34;2021-03-17;3305;746;106652;45677;9.1;3.9
34;2021-03-18;3450;948;110102;46625;9.4;4.0
34;2021-03-19;4692;808;114794;47433;9.8;4.0
34;2021-03-20;3148;71;117942;47504;10.0;4.0
34;2021-03-21;1997;61;119939;47565;10.2;4.0
34;2021-03-22;3683;475;123622;48040;10.5;4.1
34;2021-03-23;4961;544;128583;48584;10.9;4.1
34;2021-03-24;5221;654;133804;49238;11.4;4.2
34;2021-03-25;7197;732;141001;49970;12.0;4.2
34;2021-03-26;7169;583;148170;50553;12.6;4.3
34;2021-03-27;2374;87;150544;50640;12.8;4.3
34;2021-03-28;700;22;151244;50662;12.9;4.3
34;2021-03-29;4187;769;155431;51431;13.2;4.4
34;2021-03-30;5220;974;160651;52405;13.7;4.5
34;2021-03-31;5069;1219;165720;53624;14.1;4.6
34;2021-04-01;7030;1068;172750;54692;14.7;4.7
34;2021-04-02;5822;1201;178572;55893;15.2;4.8
34;2021-04-03;1137;88;179709;55981;15.3;4.8
34;2021-04-04;166;5;179875;55986;15.3;4.8
34;2021-04-05;433;26;180308;56012;15.3;4.8
34;2021-04-06;3136;2460;183444;58472;15.6;5.0
34;2021-04-07;3387;2648;186831;61120;15.9;5.2
34;2021-04-08;5251;2816;192082;63936;16.3;5.4
34;2021-04-09;8074;2509;200156;66445;17.0;5.6
34;2021-04-10;3164;1377;203320;67822;17.3;5.8
34;2021-04-11;1715;808;205035;68630;17.4;5.8
34;2021-04-12;4501;2539;209536;71169;17.8;6.1
34;2021-04-13;5240;3062;214776;74231;18.3;6.3
34;2021-04-14;5621;3253;220397;77484;18.7;6.6
34;2021-04-15;6997;3182;227394;80666;19.3;6.9
34;2021-04-16;6579;3176;233973;83842;19.9;7.1
34;2021-04-17;2378;2076;236351;85918;20.1;7.3
34;2021-04-18;988;1723;237339;87641;20.2;7.5
34;2021-04-19;3421;3123;240760;90764;20.5;7.7
34;2021-04-20;3768;3666;244528;94430;20.8;8.0
34;2021-04-21;4241;3732;248769;98162;21.2;8.3
34;2021-04-22;4490;4621;253259;102783;21.5;8.7
34;2021-04-23;5378;3536;258637;106319;22.0;9.0
34;2021-04-24;3164;1588;261801;107907;22.3;9.2
34;2021-04-25;1919;650;263720;108557;22.4;9.2
34;2021-04-26;4223;3482;267943;112039;22.8;9.5
34;2021-04-27;5128;4031;273071;116070;23.2;9.9
34;2021-04-28;5771;3558;278842;119628;23.7;10.2
34;2021-04-29;6421;3952;285263;123580;24.3;10.5
34;2021-04-30;7870;3301;293133;126881;24.9;10.8
34;2021-05-01;2405;508;295538;127389;25.1;10.8
34;2021-05-02;3260;329;298798;127718;25.4;10.9
34;2021-05-03;6577;2916;305375;130634;26.0;11.1
34;2021-05-04;7109;3818;312484;134452;26.6;11.4
34;2021-05-05;6498;4537;318982;138989;27.1;11.8
34;2021-05-06;6945;5220;325927;144209;27.7;12.3
34;2021-05-07;6928;5692;332855;149901;28.3;12.7
34;2021-05-08;3609;1174;336464;151075;28.6;12.8
34;2021-05-09;2178;1290;338642;152365;28.8;13.0
34;2021-05-10;5853;4809;344495;157174;29.3;13.4
34;2021-05-11;7411;5332;351906;162506;29.9;13.8
34;2021-05-12;7756;4470;359662;166976;30.6;14.2
34;2021-05-13;6128;786;365790;167762;31.1;14.3
34;2021-05-14;7491;3747;373281;171509;31.7;14.6
34;2021-05-15;4863;1686;378144;173195;32.2;14.7
34;2021-05-16;4949;460;383093;173655;32.6;14.8
34;2021-05-17;8693;1987;391786;175642;33.3;14.9
34;2021-05-18;9143;1980;400929;177622;34.1;15.1
34;2021-05-19;8625;1812;409554;179434;34.8;15.3
34;2021-05-20;8866;2520;418420;181954;35.6;15.5
34;2021-05-21;8784;3229;427204;185183;36.3;15.7
34;2021-05-22;5787;1154;432991;186337;36.8;15.8
34;2021-05-23;3883;549;436874;186886;37.1;15.9
34;2021-05-24;1898;853;438772;187739;37.3;16.0
34;2021-05-25;7142;3816;445914;191555;37.9;16.3
34;2021-05-26;8319;3040;454233;194595;38.6;16.5
34;2021-05-27;8316;4307;462549;198902;39.3;16.9
34;2021-05-28;8063;5456;470612;204358;40.0;17.4
34;2021-05-29;4006;3110;474618;207468;40.4;17.6
34;2021-05-30;1985;1389;476603;208857;40.5;17.8
34;2021-05-31;5878;5260;482481;214117;41.0;18.2
34;2021-06-01;6948;6111;489429;220228;41.6;18.7
34;2021-06-02;6136;5814;495565;226042;42.1;19.2
34;2021-06-03;7705;6487;503270;232529;42.8;19.8
34;2021-06-04;7651;7591;510921;240120;43.4;20.4
34;2021-06-05;4140;3680;515061;243800;43.8;20.7
34;2021-06-06;3266;1865;518327;245665;44.1;20.9
34;2021-06-07;4415;6766;522742;252431;44.4;21.5
34;2021-06-08;5854;6829;528596;259260;44.9;22.0
34;2021-06-09;5826;6845;534422;266105;45.4;22.6
34;2021-06-10;6322;6877;540744;272982;46.0;23.2
34;2021-06-11;5400;9279;546144;282261;46.4;24.0
34;2021-06-12;3166;4728;549310;286989;46.7;24.4
34;2021-06-13;1081;1908;550391;288897;46.8;24.6
34;2021-06-14;3443;7814;553834;296711;47.1;25.2
34;2021-06-15;3951;8793;557785;305504;47.4;26.0
34;2021-06-16;4620;7858;562405;313362;47.8;26.6
34;2021-06-17;4228;7954;566633;321316;48.2;27.3
34;2021-06-18;4351;9331;570984;330647;48.5;28.1
34;2021-06-19;2729;4406;573713;335053;48.8;28.5
34;2021-06-20;888;2873;574601;337926;48.9;28.7
34;2021-06-21;2181;8555;576782;346481;49.0;29.5
34;2021-06-22;2974;9405;579756;355886;49.3;30.3
34;2021-06-23;3528;8965;583284;364851;49.6;31.0
34;2021-06-24;3559;8676;586843;373527;49.9;31.8
34;2021-06-25;3378;10440;590221;383967;50.2;32.6
34;2021-06-26;1641;6191;591862;390158;50.3;33.2
34;2021-06-27;308;4268;592170;394426;50.3;33.5
34;2021-06-28;2265;9428;594435;403854;50.5;34.3
34;2021-06-29;2683;10298;597118;414152;50.8;35.2
34;2021-06-30;3356;9546;600474;423698;51.1;36.0
34;2021-07-01;3530;9449;604004;433147;51.4;36.8
34;2021-07-02;3434;9742;607438;442889;51.6;37.7
34;2021-07-03;1682;6158;609120;449047;51.8;38.2
34;2021-07-04;312;2763;609432;451810;51.8;38.4
34;2021-07-05;3234;7998;612666;459808;52.1;39.1
34;2021-07-06;3531;9176;616197;468984;52.4;39.9
34;2021-07-07;3273;8654;619470;477638;52.7;40.6
34;2021-07-08;4303;8877;623773;486515;53.0;41.4
34;2021-07-09;4010;9349;627783;495864;53.4;42.2
34;2021-07-10;2140;5717;629923;501581;53.6;42.6
34;2021-07-11;924;2576;630847;504157;53.6;42.9
34;2021-07-12;2929;8970;633776;513127;53.9;43.6
34;2021-07-13;4657;10048;638433;523175;54.3;44.5
34;2021-07-14;784;357;639217;523532;54.3;44.5
34;2021-07-15;5910;10399;645127;533931;54.9;45.4
34;2021-07-16;5860;10736;650987;544667;55.3;46.3
34;2021-07-17;4500;4420;655487;549087;55.7;46.7
34;2021-07-18;235;199;655722;549286;55.8;46.7
34;2021-07-19;5117;8334;660839;557620;56.2;47.4
34;2021-07-20;6896;8390;667735;566010;56.8;48.1
34;2021-07-21;7649;7832;675384;573842;57.4;48.8
34;2021-07-22;7443;8181;682827;582023;58.1;49.5
34;2021-07-23;7843;8167;690670;590190;58.7;50.2
34;2021-07-24;6150;3062;696820;593252;59.2;50.4
34;2021-07-25;3210;547;700030;593799;59.5;50.5
34;2021-07-26;6238;6432;706268;600231;60.0;51.0
34;2021-07-27;8755;6058;715023;606289;60.8;51.5
34;2021-07-28;9711;5932;724734;612221;61.6;52.1
34;2021-07-29;11326;6054;736060;618275;62.6;52.6
34;2021-07-30;9848;6544;745908;624819;63.4;53.1
34;2021-07-31;6445;2197;752353;627016;64.0;53.3
34;2021-08-01;3317;621;755670;627637;64.2;53.4
34;2021-08-02;7361;5070;763031;632707;64.9;53.8
34;2021-08-03;8143;5401;771174;638108;65.6;54.3
34;2021-08-04;8446;4569;779620;642677;66.3;54.6
34;2021-08-05;7136;5032;786756;647709;66.9;55.1
34;2021-08-06;6225;5235;792981;652944;67.4;55.5
34;2021-08-07;3110;2437;796091;655381;67.7;55.7
34;2021-08-08;202;204;796293;655585;67.7;55.7
34;2021-08-09;4781;6181;801074;661766;68.1;56.3
34;2021-08-10;5398;6485;806472;668251;68.6;56.8
34;2021-08-11;4832;6543;811304;674794;69.0;57.4
34;2021-08-12;4576;6201;815880;680995;69.4;57.9
34;2021-08-13;4111;5739;819991;686734;69.7;58.4
34;2021-08-14;1796;2881;821787;689615;69.9;58.6
34;2021-08-15;209;194;821996;689809;69.9;58.6
34;2021-08-16;2904;7550;824900;697359;70.1;59.3
34;2021-08-17;3594;8282;828494;705641;70.4;60.0
34;2021-08-18;3207;7564;831701;713205;70.7;60.6
34;2021-08-19;3268;7786;834969;720991;71.0;61.3
34;2021-08-20;2724;7722;837693;728713;71.2;62.0
34;2021-08-21;1399;3563;839092;732276;71.3;62.3
34;2021-08-22;163;308;839255;732584;71.4;62.3
34;2021-08-23;2330;8655;841585;741239;71.6;63.0
34;2021-08-24;2729;8962;844314;750201;71.8;63.8
34;2021-08-25;2346;8543;846660;758744;72.0;64.5
34;2021-08-26;2608;7888;849268;766632;72.2;65.2
34;2021-08-27;2197;7573;851465;774205;72.4;65.8
34;2021-08-28;1118;3561;852583;777766;72.5;66.1
34;2021-08-29;368;1357;852951;779123;72.5;66.2
34;2021-08-30;2054;6768;855005;785891;72.7;66.8
34;2021-08-31;2122;6583;857127;792474;72.9;67.4
34;2021-09-01;2062;5883;859189;798357;73.1;67.9
34;2021-09-02;1667;4089;860856;802446;73.2;68.2
34;2021-09-03;1776;4926;862632;807372;73.3;68.6
34;2021-09-04;1366;3090;863998;810462;73.5;68.9
34;2021-09-05;141;220;864139;810682;73.5;68.9
34;2021-09-06;1181;3172;865320;813854;73.6;69.2
34;2021-09-07;1365;3294;866685;817148;73.7;69.5
34;2021-09-08;1629;4073;868314;821221;73.8;69.8
34;2021-09-09;1193;3103;869507;824324;73.9;70.1
34;2021-09-10;1525;3301;871032;827625;74.1;70.4
34;2021-09-11;1285;1847;872317;829472;74.2;70.5
34;2021-09-12;91;81;872408;829553;74.2;70.5
34;2021-09-13;1004;2528;873412;832081;74.3;70.7
34;2021-09-14;1237;2271;874649;834352;74.4;70.9
34;2021-09-15;1485;2952;876134;837304;74.5;71.2
34;2021-09-16;884;1879;877018;839183;74.6;71.4
34;2021-09-17;1125;2416;878143;841599;74.7;71.6
34;2021-09-18;793;1763;878936;843362;74.7;71.7
34;2021-09-19;36;59;878972;843421;74.7;71.7
34;2021-09-20;614;1910;879586;845331;74.8;71.9
34;2021-09-21;611;1779;880197;847110;74.8;72.0
34;2021-09-22;832;2528;881029;849638;74.9;72.2
34;2021-09-23;668;1658;881697;851296;75.0;72.4
34;2021-09-24;842;2220;882539;853516;75.0;72.6
34;2021-09-25;492;1555;883031;855071;75.1;72.7
34;2021-09-26;51;142;883082;855213;75.1;72.7
34;2021-09-27;621;1478;883703;856691;75.1;72.8
34;2021-09-28;630;1128;884333;857819;75.2;72.9
34;2021-09-29;856;1811;885189;859630;75.3;73.1
34;2021-09-30;605;1346;885794;860976;75.3;73.2
34;2021-10-01;719;1501;886513;862477;75.4;73.3
34;2021-10-02;653;1389;887166;863866;75.4;73.4
34;2021-10-03;60;162;887226;864028;75.4;73.5
34;2021-10-04;597;1084;887823;865112;75.5;73.6
34;2021-10-05;531;1034;888354;866146;75.5;73.6
34;2021-10-06;840;1710;889194;867856;75.6;73.8
34;2021-10-07;551;1000;889745;868856;75.6;73.9
34;2021-10-08;846;1394;890591;870250;75.7;74.0
34;2021-10-09;578;1011;891169;871261;75.8;74.1
34;2021-10-10;65;73;891234;871334;75.8;74.1
34;2021-10-11;683;1054;891917;872388;75.8;74.2
35;2020-12-27;0;0;0;0;0.0;0.0
35;2020-12-28;0;0;0;0;0.0;0.0
35;2020-12-29;2;0;2;0;0.0;0.0
35;2020-12-30;0;0;2;0;0.0;0.0
35;2020-12-31;3;0;5;0;0.0;0.0
35;2021-01-01;3;0;8;0;0.0;0.0
35;2021-01-02;1;0;9;0;0.0;0.0
35;2021-01-03;0;0;9;0;0.0;0.0
35;2021-01-04;10;0;19;0;0.0;0.0
35;2021-01-05;110;0;129;0;0.0;0.0
35;2021-01-06;175;0;304;0;0.0;0.0
35;2021-01-07;440;1;744;1;0.1;0.0
35;2021-01-08;513;1;1257;2;0.1;0.0
35;2021-01-09;31;0;1288;2;0.1;0.0
35;2021-01-10;2;0;1290;2;0.1;0.0
35;2021-01-11;538;0;1828;2;0.2;0.0
35;2021-01-12;886;3;2714;5;0.3;0.0
35;2021-01-13;971;4;3685;9;0.3;0.0
35;2021-01-14;1261;18;4946;27;0.5;0.0
35;2021-01-15;732;3;5678;30;0.5;0.0
35;2021-01-16;189;3;5867;33;0.5;0.0
35;2021-01-17;44;0;5911;33;0.5;0.0
35;2021-01-18;1222;2;7133;35;0.7;0.0
35;2021-01-19;5407;18;12540;53;1.2;0.0
35;2021-01-20;3238;10;15778;63;1.5;0.0
35;2021-01-21;3643;17;19421;80;1.8;0.0
35;2021-01-22;2087;10;21508;90;2.0;0.0
35;2021-01-23;421;1;21929;91;2.0;0.0
35;2021-01-24;51;0;21980;91;2.0;0.0
35;2021-01-25;918;17;22898;108;2.1;0.0
35;2021-01-26;1130;142;24028;250;2.2;0.0
35;2021-01-27;1029;125;25057;375;2.3;0.0
35;2021-01-28;916;298;25973;673;2.4;0.1
35;2021-01-29;725;290;26698;963;2.5;0.1
35;2021-01-30;140;19;26838;982;2.5;0.1
35;2021-01-31;0;0;26838;982;2.5;0.1
35;2021-02-01;673;333;27511;1315;2.5;0.1
35;2021-02-02;725;483;28236;1798;2.6;0.2
35;2021-02-03;662;506;28898;2304;2.7;0.2
35;2021-02-04;590;657;29488;2961;2.7;0.3
35;2021-02-05;624;563;30112;3524;2.8;0.3
35;2021-02-06;175;9;30287;3533;2.8;0.3
35;2021-02-07;1;0;30288;3533;2.8;0.3
35;2021-02-08;446;653;30734;4186;2.8;0.4
35;2021-02-09;1715;3559;32449;7745;3.0;0.7
35;2021-02-10;1370;2728;33819;10473;3.1;1.0
35;2021-02-11;1945;3237;35764;13710;3.3;1.3
35;2021-02-12;1663;1730;37427;15440;3.5;1.4
35;2021-02-13;58;254;37485;15694;3.5;1.5
35;2021-02-14;8;69;37493;15763;3.5;1.5
35;2021-02-15;771;1098;38264;16861;3.5;1.6
35;2021-02-16;920;1020;39184;17881;3.6;1.7
35;2021-02-17;895;1087;40079;18968;3.7;1.8
35;2021-02-18;1020;996;41099;19964;3.8;1.8
35;2021-02-19;1013;968;42112;20932;3.9;1.9
35;2021-02-20;143;49;42255;20981;3.9;1.9
35;2021-02-21;5;0;42260;20981;3.9;1.9
35;2021-02-22;776;831;43036;21812;4.0;2.0
35;2021-02-23;1288;868;44324;22680;4.1;2.1
35;2021-02-24;1404;815;45728;23495;4.2;2.2
35;2021-02-25;2249;790;47977;24285;4.4;2.2
35;2021-02-26;2599;736;50576;25021;4.7;2.3
35;2021-02-27;869;104;51445;25125;4.8;2.3
35;2021-02-28;10;1;51455;25126;4.8;2.3
35;2021-03-01;959;691;52414;25817;4.8;2.4
35;2021-03-02;1634;1995;54048;27812;5.0;2.6
35;2021-03-03;1914;972;55962;28784;5.2;2.7
35;2021-03-04;2917;1418;58879;30202;5.4;2.8
35;2021-03-05;3715;1352;62594;31554;5.8;2.9
35;2021-03-06;1337;87;63931;31641;5.9;2.9
35;2021-03-07;1;40;63932;31681;5.9;2.9
35;2021-03-08;1475;589;65407;32270;6.0;3.0
35;2021-03-09;3238;620;68645;32890;6.3;3.0
35;2021-03-10;2902;566;71547;33456;6.6;3.1
35;2021-03-11;4199;727;75746;34183;7.0;3.2
35;2021-03-12;6049;571;81795;34754;7.6;3.2
35;2021-03-13;2428;136;84223;34890;7.8;3.2
35;2021-03-14;18;25;84241;34915;7.8;3.2
35;2021-03-15;1966;676;86207;35591;8.0;3.3
35;2021-03-16;2505;734;88712;36325;8.2;3.4
35;2021-03-17;2397;603;91109;36928;8.4;3.4
35;2021-03-18;2335;599;93444;37527;8.6;3.5
35;2021-03-19;3546;514;96990;38041;9.0;3.5
35;2021-03-20;1543;114;98533;38155;9.1;3.5
35;2021-03-21;38;1;98571;38156;9.1;3.5
35;2021-03-22;1749;843;100320;38999;9.3;3.6
35;2021-03-23;3626;1187;103946;40186;9.6;3.7
35;2021-03-24;3730;994;107676;41180;10.0;3.8
35;2021-03-25;5328;1012;113004;42192;10.4;3.9
35;2021-03-26;5853;824;118857;43016;11.0;4.0
35;2021-03-27;1416;211;120273;43227;11.1;4.0
35;2021-03-28;4;0;120277;43227;11.1;4.0
35;2021-03-29;2778;912;123055;44139;11.4;4.1
35;2021-03-30;4292;1338;127347;45477;11.8;4.2
35;2021-03-31;3471;1349;130818;46826;12.1;4.3
35;2021-04-01;4250;1245;135068;48071;12.5;4.4
35;2021-04-02;4861;1216;139929;49287;12.9;4.6
35;2021-04-03;763;216;140692;49503;13.0;4.6
35;2021-04-04;6;0;140698;49503;13.0;4.6
35;2021-04-05;24;2;140722;49505;13.0;4.6
35;2021-04-06;3279;2032;144001;51537;13.3;4.8
35;2021-04-07;3966;1849;147967;53386;13.7;4.9
35;2021-04-08;5803;1597;153770;54983;14.2;5.1
35;2021-04-09;7430;1430;161200;56413;14.9;5.2
35;2021-04-10;1860;255;163060;56668;15.1;5.2
35;2021-04-11;35;23;163095;56691;15.1;5.2
35;2021-04-12;5137;1603;168232;58294;15.5;5.4
35;2021-04-13;7624;2793;175856;61087;16.3;5.6
35;2021-04-14;6314;2306;182170;63393;16.8;5.9
35;2021-04-15;7565;2189;189735;65582;17.5;6.1
35;2021-04-16;8081;1766;197816;67348;18.3;6.2
35;2021-04-17;1571;223;199387;67571;18.4;6.2
35;2021-04-18;10;4;199397;67575;18.4;6.2
35;2021-04-19;4819;1674;204216;69249;18.9;6.4
35;2021-04-20;5165;2648;209381;71897;19.3;6.6
35;2021-04-21;5134;2218;214515;74115;19.8;6.8
35;2021-04-22;6429;2334;220944;76449;20.4;7.1
35;2021-04-23;6821;2375;227765;78824;21.0;7.3
35;2021-04-24;1132;265;228897;79089;21.2;7.3
35;2021-04-25;8;16;228905;79105;21.2;7.3
35;2021-04-26;5099;2163;234004;81268;21.6;7.5
35;2021-04-27;6090;3213;240094;84481;22.2;7.8
35;2021-04-28;6173;2572;246267;87053;22.8;8.0
35;2021-04-29;7117;2769;253384;89822;23.4;8.3
35;2021-04-30;7564;2551;260948;92373;24.1;8.5
35;2021-05-01;618;239;261566;92612;24.2;8.6
35;2021-05-02;15;21;261581;92633;24.2;8.6
35;2021-05-03;5307;2335;266888;94968;24.7;8.8
35;2021-05-04;5067;5343;271955;100311;25.1;9.3
35;2021-05-05;4881;4451;276836;104762;25.6;9.7
35;2021-05-06;6176;5280;283012;110042;26.2;10.2
35;2021-05-07;5620;5252;288632;115294;26.7;10.7
35;2021-05-08;1719;136;290351;115430;26.8;10.7
35;2021-05-09;698;75;291049;115505;26.9;10.7
35;2021-05-10;3719;4955;294768;120460;27.2;11.1
35;2021-05-11;4774;5810;299542;126270;27.7;11.7
35;2021-05-12;5292;5501;304834;131771;28.2;12.2
35;2021-05-13;2699;1424;307533;133195;28.4;12.3
35;2021-05-14;5460;4334;312993;137529;28.9;12.7
35;2021-05-15;2929;718;315922;138247;29.2;12.8
35;2021-05-16;997;61;316919;138308;29.3;12.8
35;2021-05-17;4474;3882;321393;142190;29.7;13.1
35;2021-05-18;5838;4329;327231;146519;30.2;13.5
35;2021-05-19;5866;3633;333097;150152;30.8;13.9
35;2021-05-20;6448;4009;339545;154161;31.4;14.2
35;2021-05-21;6140;4770;345685;158931;31.9;14.7
35;2021-05-22;2118;739;347803;159670;32.1;14.8
35;2021-05-23;688;46;348491;159716;32.2;14.8
35;2021-05-24;3206;1298;351697;161014;32.5;14.9
35;2021-05-25;5541;4278;357238;165292;33.0;15.3
35;2021-05-26;5721;4165;362959;169457;33.5;15.7
35;2021-05-27;6527;4778;369486;174235;34.1;16.1
35;2021-05-28;6330;5573;375816;179808;34.7;16.6
35;2021-05-29;2873;1147;378689;180955;35.0;16.7
35;2021-05-30;878;39;379567;180994;35.1;16.7
35;2021-05-31;6309;4393;385876;185387;35.7;17.1
35;2021-06-01;7365;5124;393241;190511;36.3;17.6
35;2021-06-02;7219;3798;400460;194309;37.0;18.0
35;2021-06-03;8156;4999;408616;199308;37.8;18.4
35;2021-06-04;7274;7469;415890;206777;38.4;19.1
35;2021-06-05;4138;1588;420028;208365;38.8;19.3
35;2021-06-06;3053;146;423081;208511;39.1;19.3
35;2021-06-07;5782;5778;428863;214289;39.6;19.8
35;2021-06-08;7603;5956;436466;220245;40.3;20.4
35;2021-06-09;8461;4818;444927;225063;41.1;20.8
35;2021-06-10;9346;4752;454273;229815;42.0;21.2
35;2021-06-11;8632;7472;462905;237287;42.8;21.9
35;2021-06-12;4684;1209;467589;238496;43.2;22.0
35;2021-06-13;3386;227;470975;238723;43.5;22.1
35;2021-06-14;6231;6519;477206;245242;44.1;22.7
35;2021-06-15;7504;6966;484710;252208;44.8;23.3
35;2021-06-16;8323;5626;493033;257834;45.6;23.8
35;2021-06-17;8898;5913;501931;263747;46.4;24.4
35;2021-06-18;8717;8098;510648;271845;47.2;25.1
35;2021-06-19;1504;2510;512152;274355;47.3;25.4
35;2021-06-20;2953;883;515105;275238;47.6;25.4
35;2021-06-21;5930;6377;521035;281615;48.2;26.0
35;2021-06-22;6841;7500;527876;289115;48.8;26.7
35;2021-06-23;7254;6144;535130;295259;49.5;27.3
35;2021-06-24;8367;5925;543497;301184;50.2;27.8
35;2021-06-25;6627;8481;550124;309665;50.8;28.6
35;2021-06-26;1107;3077;551231;312742;50.9;28.9
35;2021-06-27;2635;1031;553866;313773;51.2;29.0
35;2021-06-28;4298;7761;558164;321534;51.6;29.7
35;2021-06-29;5089;7972;563253;329506;52.1;30.5
35;2021-06-30;5602;7897;568855;337403;52.6;31.2
35;2021-07-01;6587;7551;575442;344954;53.2;31.9
35;2021-07-02;5333;9862;580775;354816;53.7;32.8
35;2021-07-03;1083;2839;581858;357655;53.8;33.1
35;2021-07-04;2149;1554;584007;359209;54.0;33.2
35;2021-07-05;3735;8209;587742;367418;54.3;34.0
35;2021-07-06;4787;9478;592529;376896;54.8;34.8
35;2021-07-07;5060;8323;597589;385219;55.2;35.6
35;2021-07-08;5386;8490;602975;393709;55.7;36.4
35;2021-07-09;3907;11548;606882;405257;56.1;37.5
35;2021-07-10;892;3148;607774;408405;56.2;37.7
35;2021-07-11;1300;2355;609074;410760;56.3;38.0
35;2021-07-12;3121;9145;612195;419905;56.6;38.8
35;2021-07-13;3981;10749;616176;430654;56.9;39.8
35;2021-07-14;2154;4452;618330;435106;57.1;40.2
35;2021-07-15;4293;10181;622623;445287;57.5;41.2
35;2021-07-16;4802;11009;627425;456296;58.0;42.2
35;2021-07-17;1988;4064;629413;460360;58.2;42.5
35;2021-07-18;844;2571;630257;462931;58.2;42.8
35;2021-07-19;3251;8974;633508;471905;58.5;43.6
35;2021-07-20;4242;10592;637750;482497;58.9;44.6
35;2021-07-21;4372;9389;642122;491886;59.3;45.5
35;2021-07-22;4852;9657;646974;501543;59.8;46.4
35;2021-07-23;4564;11012;651538;512555;60.2;47.4
35;2021-07-24;1587;4267;653125;516822;60.4;47.8
35;2021-07-25;815;2846;653940;519668;60.4;48.0
35;2021-07-26;3893;8737;657833;528405;60.8;48.8
35;2021-07-27;5281;9658;663114;538063;61.3;49.7
35;2021-07-28;5317;8672;668431;546735;61.8;50.5
35;2021-07-29;6114;8342;674545;555077;62.3;51.3
35;2021-07-30;5904;9085;680449;564162;62.9;52.1
35;2021-07-31;2322;3655;682771;567817;63.1;52.5
35;2021-08-01;1526;2415;684297;570232;63.2;52.7
35;2021-08-02;4757;6949;689054;577181;63.7;53.3
35;2021-08-03;6712;7582;695766;584763;64.3;54.0
35;2021-08-04;6714;6594;702480;591357;64.9;54.7
35;2021-08-05;6685;6984;709165;598341;65.5;55.3
35;2021-08-06;6067;7322;715232;605663;66.1;56.0
35;2021-08-07;2109;3151;717341;608814;66.3;56.3
35;2021-08-08;1523;2257;718864;611071;66.4;56.5
35;2021-08-09;4617;5535;723481;616606;66.9;57.0
35;2021-08-10;6565;6381;730046;622987;67.5;57.6
35;2021-08-11;6474;5865;736520;628852;68.1;58.1
35;2021-08-12;7013;5586;743533;634438;68.7;58.6
35;2021-08-13;6697;5068;750230;639506;69.3;59.1
35;2021-08-14;3049;1985;753279;641491;69.6;59.3
35;2021-08-15;2471;1261;755750;642752;69.8;59.4
35;2021-08-16;4871;5296;760621;648048;70.3;59.9
35;2021-08-17;6408;6081;767029;654129;70.9;60.5
35;2021-08-18;6487;5633;773516;659762;71.5;61.0
35;2021-08-19;6302;5764;779818;665526;72.1;61.5
35;2021-08-20;5134;6349;784952;671875;72.5;62.1
35;2021-08-21;2384;2634;787336;674509;72.8;62.3
35;2021-08-22;1765;1797;789101;676306;72.9;62.5
35;2021-08-23;3105;6013;792206;682319;73.2;63.1
35;2021-08-24;3503;7221;795709;689540;73.5;63.7
35;2021-08-25;3314;6616;799023;696156;73.8;64.3
35;2021-08-26;2641;6895;801664;703051;74.1;65.0
35;2021-08-27;2784;7261;804448;710312;74.3;65.6
35;2021-08-28;1179;2954;805627;713266;74.5;65.9
35;2021-08-29;517;1760;806144;715026;74.5;66.1
35;2021-08-30;1978;5389;808122;720415;74.7;66.6
35;2021-08-31;2388;6360;810510;726775;74.9;67.2
35;2021-09-01;1924;5759;812434;732534;75.1;67.7
35;2021-09-02;1844;5752;814278;738286;75.3;68.2
35;2021-09-03;2032;6631;816310;744917;75.4;68.8
35;2021-09-04;1134;4009;817444;748926;75.5;69.2
35;2021-09-05;517;2007;817961;750933;75.6;69.4
35;2021-09-06;1137;4591;819098;755524;75.7;69.8
35;2021-09-07;1326;4868;820424;760392;75.8;70.3
35;2021-09-08;1335;5817;821759;766209;75.9;70.8
35;2021-09-09;1261;4845;823020;771054;76.1;71.3
35;2021-09-10;1586;5976;824606;777030;76.2;71.8
35;2021-09-11;625;3798;825231;780828;76.3;72.2
35;2021-09-12;285;2324;825516;783152;76.3;72.4
35;2021-09-13;1324;3835;826840;786987;76.4;72.7
35;2021-09-14;1381;3397;828221;790384;76.5;73.0
35;2021-09-15;1231;4596;829452;794980;76.7;73.5
35;2021-09-16;1129;2850;830581;797830;76.8;73.7
35;2021-09-17;1277;3896;831858;801726;76.9;74.1
35;2021-09-18;518;2877;832376;804603;76.9;74.4
35;2021-09-19;167;1020;832543;805623;76.9;74.5
35;2021-09-20;1150;2649;833693;808272;77.0;74.7
35;2021-09-21;665;1927;834358;810199;77.1;74.9
35;2021-09-22;857;3624;835215;813823;77.2;75.2
35;2021-09-23;565;1532;835780;815355;77.2;75.4
35;2021-09-24;972;3039;836752;818394;77.3;75.6
35;2021-09-25;421;1958;837173;820352;77.4;75.8
35;2021-09-26;16;164;837189;820516;77.4;75.8
35;2021-09-27;519;1626;837708;822142;77.4;76.0
35;2021-09-28;460;1185;838168;823327;77.5;76.1
35;2021-09-29;610;1981;838778;825308;77.5;76.3
35;2021-09-30;352;835;839130;826143;77.5;76.3
35;2021-10-01;808;2163;839938;828306;77.6;76.5
35;2021-10-02;359;1135;840297;829441;77.7;76.7
35;2021-10-03;2;12;840299;829453;77.7;76.7
35;2021-10-04;514;1011;840813;830464;77.7;76.7
35;2021-10-05;433;984;841246;831448;77.7;76.8
35;2021-10-06;604;1331;841850;832779;77.8;77.0
35;2021-10-07;378;979;842228;833758;77.8;77.1
35;2021-10-08;696;2073;842924;835831;77.9;77.2
35;2021-10-09;373;880;843297;836711;77.9;77.3
35;2021-10-10;0;4;843297;836715;77.9;77.3
35;2021-10-11;427;917;843724;837632;78.0;77.4
36;2020-12-27;0;0;0;0;0.0;0.0
36;2020-12-28;0;0;0;0;0.0;0.0
36;2020-12-29;0;0;0;0;0.0;0.0
36;2020-12-30;0;0;0;0;0.0;0.0
36;2020-12-31;0;0;0;0;0.0;0.0
36;2021-01-01;0;0;0;0;0.0;0.0
36;2021-01-02;0;0;0;0;0.0;0.0
36;2021-01-03;0;0;0;0;0.0;0.0
36;2021-01-04;2;0;2;0;0.0;0.0
36;2021-01-05;0;0;2;0;0.0;0.0
36;2021-01-06;24;0;26;0;0.0;0.0
36;2021-01-07;51;0;77;0;0.0;0.0
36;2021-01-08;111;0;188;0;0.1;0.0
36;2021-01-09;84;0;272;0;0.1;0.0
36;2021-01-10;142;0;414;0;0.2;0.0
36;2021-01-11;240;1;654;1;0.3;0.0
36;2021-01-12;282;0;936;1;0.4;0.0
36;2021-01-13;198;1;1134;2;0.5;0.0
36;2021-01-14;506;4;1640;6;0.8;0.0
36;2021-01-15;179;1;1819;7;0.8;0.0
36;2021-01-16;24;1;1843;8;0.8;0.0
36;2021-01-17;19;1;1862;9;0.9;0.0
36;2021-01-18;612;5;2474;14;1.1;0.0
36;2021-01-19;1173;2;3647;16;1.7;0.0
36;2021-01-20;1102;4;4749;20;2.2;0.0
36;2021-01-21;721;1;5470;21;2.5;0.0
36;2021-01-22;858;2;6328;23;2.9;0.0
36;2021-01-23;294;0;6622;23;3.0;0.0
36;2021-01-24;185;1;6807;24;3.1;0.0
36;2021-01-25;640;5;7447;29;3.4;0.0
36;2021-01-26;609;1;8056;30;3.7;0.0
36;2021-01-27;853;20;8909;50;4.1;0.0
36;2021-01-28;478;44;9387;94;4.3;0.0
36;2021-01-29;572;96;9959;190;4.6;0.1
36;2021-01-30;288;71;10247;261;4.7;0.1
36;2021-01-31;115;130;10362;391;4.8;0.2
36;2021-02-01;379;100;10741;491;4.9;0.2
36;2021-02-02;410;175;11151;666;5.1;0.3
36;2021-02-03;473;264;11624;930;5.4;0.4
36;2021-02-04;275;272;11899;1202;5.5;0.6
36;2021-02-05;301;164;12200;1366;5.6;0.6
36;2021-02-06;1;0;12201;1366;5.6;0.6
36;2021-02-07;1;0;12202;1366;5.6;0.6
36;2021-02-08;280;258;12482;1624;5.7;0.7
36;2021-02-09;328;605;12810;2229;5.9;1.0
36;2021-02-10;489;656;13299;2885;6.1;1.3
36;2021-02-11;384;593;13683;3478;6.3;1.6
36;2021-02-12;303;459;13986;3937;6.4;1.8
36;2021-02-13;126;81;14112;4018;6.5;1.9
36;2021-02-14;22;43;14134;4061;6.5;1.9
36;2021-02-15;42;575;14176;4636;6.5;2.1
36;2021-02-16;107;412;14283;5048;6.6;2.3
36;2021-02-17;117;622;14400;5670;6.6;2.6
36;2021-02-18;161;614;14561;6284;6.7;2.9
36;2021-02-19;181;540;14742;6824;6.8;3.1
36;2021-02-20;86;239;14828;7063;6.8;3.3
36;2021-02-21;87;156;14915;7219;6.9;3.3
36;2021-02-22;162;512;15077;7731;6.9;3.6
36;2021-02-23;62;574;15139;8305;7.0;3.8
36;2021-02-24;110;680;15249;8985;7.0;4.1
36;2021-02-25;251;281;15500;9266;7.1;4.3
36;2021-02-26;339;468;15839;9734;7.3;4.5
36;2021-02-27;73;277;15912;10011;7.3;4.6
36;2021-02-28;13;97;15925;10108;7.3;4.7
36;2021-03-01;218;341;16143;10449;7.4;4.8
36;2021-03-02;352;367;16495;10816;7.6;5.0
36;2021-03-03;394;532;16889;11348;7.8;5.2
36;2021-03-04;662;358;17551;11706;8.1;5.4
36;2021-03-05;800;298;18351;12004;8.5;5.5
36;2021-03-06;410;18;18761;12022;8.6;5.5
36;2021-03-07;339;9;19100;12031;8.8;5.5
36;2021-03-08;251;316;19351;12347;8.9;5.7
36;2021-03-09;449;270;19800;12617;9.1;5.8
36;2021-03-10;724;409;20524;13026;9.5;6.0
36;2021-03-11;840;246;21364;13272;9.8;6.1
36;2021-03-12;1446;300;22810;13572;10.5;6.3
36;2021-03-13;576;129;23386;13701;10.8;6.3
36;2021-03-14;113;1;23499;13702;10.8;6.3
36;2021-03-15;648;159;24147;13861;11.1;6.4
36;2021-03-16;445;67;24592;13928;11.3;6.4
36;2021-03-17;766;92;25358;14020;11.7;6.5
36;2021-03-18;414;72;25772;14092;11.9;6.5
36;2021-03-19;737;40;26509;14132;12.2;6.5
36;2021-03-20;450;27;26959;14159;12.4;6.5
36;2021-03-21;0;0;26959;14159;12.4;6.5
36;2021-03-22;497;60;27456;14219;12.6;6.5
36;2021-03-23;777;60;28233;14279;13.0;6.6
36;2021-03-24;1089;78;29322;14357;13.5;6.6
36;2021-03-25;1339;90;30661;14447;14.1;6.7
36;2021-03-26;1419;159;32080;14606;14.8;6.7
36;2021-03-27;475;43;32555;14649;15.0;6.7
36;2021-03-28;68;57;32623;14706;15.0;6.8
36;2021-03-29;462;187;33085;14893;15.2;6.9
36;2021-03-30;583;263;33668;15156;15.5;7.0
36;2021-03-31;1262;172;34930;15328;16.1;7.1
36;2021-04-01;1086;432;36016;15760;16.6;7.3
36;2021-04-02;966;144;36982;15904;17.0;7.3
36;2021-04-03;282;195;37264;16099;17.2;7.4
36;2021-04-04;42;2;37306;16101;17.2;7.4
36;2021-04-05;15;46;37321;16147;17.2;7.4
36;2021-04-06;820;362;38141;16509;17.6;7.6
36;2021-04-07;1072;545;39213;17054;18.1;7.9
36;2021-04-08;1347;482;40560;17536;18.7;8.1
36;2021-04-09;1936;406;42496;17942;19.6;8.3
36;2021-04-10;591;244;43087;18186;19.8;8.4
36;2021-04-11;256;90;43343;18276;20.0;8.4
36;2021-04-12;848;561;44191;18837;20.4;8.7
36;2021-04-13;1140;519;45331;19356;20.9;8.9
36;2021-04-14;1582;866;46913;20222;21.6;9.3
36;2021-04-15;1654;474;48567;20696;22.4;9.5
36;2021-04-16;1485;470;50052;21166;23.1;9.7
36;2021-04-17;893;251;50945;21417;23.5;9.9
36;2021-04-18;383;7;51328;21424;23.6;9.9
36;2021-04-19;874;444;52202;21868;24.0;10.1
36;2021-04-20;1145;524;53347;22392;24.6;10.3
36;2021-04-21;1240;881;54587;23273;25.1;10.7
36;2021-04-22;1593;873;56180;24146;25.9;11.1
36;2021-04-23;1329;618;57509;24764;26.5;11.4
36;2021-04-24;677;380;58186;25144;26.8;11.6
36;2021-04-25;413;95;58599;25239;27.0;11.6
36;2021-04-26;1134;450;59733;25689;27.5;11.8
36;2021-04-27;1278;553;61011;26242;28.1;12.1
36;2021-04-28;1488;1065;62499;27307;28.8;12.6
36;2021-04-29;2016;715;64515;28022;29.7;12.9
36;2021-04-30;1553;458;66068;28480;30.4;13.1
36;2021-05-01;724;64;66792;28544;30.8;13.1
36;2021-05-02;498;64;67290;28608;31.0;13.2
36;2021-05-03;1293;320;68583;28928;31.6;13.3
36;2021-05-04;780;805;69363;29733;31.9;13.7
36;2021-05-05;1282;1306;70645;31039;32.5;14.3
36;2021-05-06;2137;797;72782;31836;33.5;14.7
36;2021-05-07;1469;771;74251;32607;34.2;15.0
36;2021-05-08;306;105;74557;32712;34.3;15.1
36;2021-05-09;174;343;74731;33055;34.4;15.2
36;2021-05-10;1216;818;75947;33873;35.0;15.6
36;2021-05-11;1725;1251;77672;35124;35.8;16.2
36;2021-05-12;1827;1486;79499;36610;36.6;16.9
36;2021-05-13;548;304;80047;36914;36.9;17.0
36;2021-05-14;701;1037;80748;37951;37.2;17.5
36;2021-05-15;635;592;81383;38543;37.5;17.8
36;2021-05-16;337;377;81720;38920;37.6;17.9
36;2021-05-17;615;944;82335;39864;37.9;18.4
36;2021-05-18;874;937;83209;40801;38.3;18.8
36;2021-05-19;1333;845;84542;41646;38.9;19.2
36;2021-05-20;1611;1209;86153;42855;39.7;19.7
36;2021-05-21;1106;1068;87259;43923;40.2;20.2
36;2021-05-22;678;342;87937;44265;40.5;20.4
36;2021-05-23;428;297;88365;44562;40.7;20.5
36;2021-05-24;506;469;88871;45031;40.9;20.7
36;2021-05-25;1045;686;89916;45717;41.4;21.1
36;2021-05-26;1472;1165;91388;46882;42.1;21.6
36;2021-05-27;1398;977;92786;47859;42.7;22.0
36;2021-05-28;921;1480;93707;49339;43.2;22.7
36;2021-05-29;700;507;94407;49846;43.5;23.0
36;2021-05-30;111;572;94518;50418;43.5;23.2
36;2021-05-31;1137;764;95655;51182;44.1;23.6
36;2021-06-01;1413;830;97068;52012;44.7;24.0
36;2021-06-02;2062;614;99130;52626;45.7;24.2
36;2021-06-03;1902;1201;101032;53827;46.5;24.8
36;2021-06-04;1772;1045;102804;54872;47.3;25.3
36;2021-06-05;693;658;103497;55530;47.7;25.6
36;2021-06-06;336;272;103833;55802;47.8;25.7
36;2021-06-07;983;808;104816;56610;48.3;26.1
36;2021-06-08;957;981;105773;57591;48.7;26.5
36;2021-06-09;1675;1071;107448;58662;49.5;27.0
36;2021-06-10;1530;1382;108978;60044;50.2;27.7
36;2021-06-11;1288;1499;110266;61543;50.8;28.3
36;2021-06-12;921;784;111187;62327;51.2;28.7
36;2021-06-13;343;269;111530;62596;51.4;28.8
36;2021-06-14;605;1269;112135;63865;51.6;29.4
36;2021-06-15;733;1215;112868;65080;52.0;30.0
36;2021-06-16;903;1519;113771;66599;52.4;30.7
36;2021-06-17;749;1904;114520;68503;52.7;31.5
36;2021-06-18;706;1879;115226;70382;53.1;32.4
36;2021-06-19;295;395;115521;70777;53.2;32.6
36;2021-06-20;235;327;115756;71104;53.3;32.7
36;2021-06-21;692;1449;116448;72553;53.6;33.4
36;2021-06-22;841;1552;117289;74105;54.0;34.1
36;2021-06-23;774;1791;118063;75896;54.4;35.0
36;2021-06-24;855;1522;118918;77418;54.8;35.7
36;2021-06-25;942;1221;119860;78639;55.2;36.2
36;2021-06-26;324;602;120184;79241;55.3;36.5
36;2021-06-27;105;267;120289;79508;55.4;36.6
36;2021-06-28;696;923;120985;80431;55.7;37.0
36;2021-06-29;688;1459;121673;81890;56.0;37.7
36;2021-06-30;836;2149;122509;84039;56.4;38.7
36;2021-07-01;353;1081;122862;85120;56.6;39.2
36;2021-07-02;749;1843;123611;86963;56.9;40.0
36;2021-07-03;465;885;124076;87848;57.1;40.5
36;2021-07-04;185;326;124261;88174;57.2;40.6
36;2021-07-05;493;1335;124754;89509;57.5;41.2
36;2021-07-06;491;1220;125245;90729;57.7;41.8
36;2021-07-07;586;1791;125831;92520;57.9;42.6
36;2021-07-08;549;1707;126380;94227;58.2;43.4
36;2021-07-09;786;1654;127166;95881;58.6;44.2
36;2021-07-10;469;1119;127635;97000;58.8;44.7
36;2021-07-11;257;154;127892;97154;58.9;44.7
36;2021-07-12;332;1628;128224;98782;59.1;45.5
36;2021-07-13;311;1936;128535;100718;59.2;46.4
36;2021-07-14;376;763;128911;101481;59.4;46.7
36;2021-07-15;917;2164;129828;103645;59.8;47.7
36;2021-07-16;628;1873;130456;105518;60.1;48.6
36;2021-07-17;400;859;130856;106377;60.3;49.0
36;2021-07-18;199;408;131055;106785;60.4;49.2
36;2021-07-19;552;1456;131607;108241;60.6;49.8
36;2021-07-20;776;1407;132383;109648;61.0;50.5
36;2021-07-21;713;1984;133096;111632;61.3;51.4
36;2021-07-22;1138;1686;134234;113318;61.8;52.2
36;2021-07-23;968;1746;135202;115064;62.3;53.0
36;2021-07-24;605;801;135807;115865;62.5;53.4
36;2021-07-25;148;404;135955;116269;62.6;53.5
36;2021-07-26;948;1086;136903;117355;63.0;54.0
36;2021-07-27;816;1355;137719;118710;63.4;54.7
36;2021-07-28;1385;1402;139104;120112;64.1;55.3
36;2021-07-29;1708;1310;140812;121422;64.8;55.9
36;2021-07-30;1445;1322;142257;122744;65.5;56.5
36;2021-07-31;933;537;143190;123281;65.9;56.8
36;2021-08-01;210;239;143400;123520;66.0;56.9
36;2021-08-02;1116;892;144516;124412;66.6;57.3
36;2021-08-03;1271;999;145787;125411;67.1;57.8
36;2021-08-04;1695;940;147482;126351;67.9;58.2
36;2021-08-05;1824;910;149306;127261;68.8;58.6
36;2021-08-06;1418;877;150724;128138;69.4;59.0
36;2021-08-07;541;527;151265;128665;69.7;59.3
36;2021-08-08;292;153;151557;128818;69.8;59.3
36;2021-08-09;818;846;152375;129664;70.2;59.7
36;2021-08-10;1067;1012;153442;130676;70.7;60.2
36;2021-08-11;1356;858;154798;131534;71.3;60.6
36;2021-08-12;1161;854;155959;132388;71.8;61.0
36;2021-08-13;1193;778;157152;133166;72.4;61.3
36;2021-08-14;426;836;157578;134002;72.6;61.7
36;2021-08-15;365;113;157943;134115;72.7;61.8
36;2021-08-16;606;954;158549;135069;73.0;62.2
36;2021-08-17;766;1002;159315;136071;73.4;62.7
36;2021-08-18;1039;1164;160354;137235;73.8;63.2
36;2021-08-19;840;1178;161194;138413;74.2;63.7
36;2021-08-20;488;1480;161682;139893;74.5;64.4
36;2021-08-21;309;468;161991;140361;74.6;64.6
36;2021-08-22;27;65;162018;140426;74.6;64.7
36;2021-08-23;551;1179;162569;141605;74.9;65.2
36;2021-08-24;589;1204;163158;142809;75.1;65.8
36;2021-08-25;466;1094;163624;143903;75.4;66.3
36;2021-08-26;666;1480;164290;145383;75.7;67.0
36;2021-08-27;529;1409;164819;146792;75.9;67.6
36;2021-08-28;368;580;165187;147372;76.1;67.9
36;2021-08-29;222;241;165409;147613;76.2;68.0
36;2021-08-30;246;726;165655;148339;76.3;68.3
36;2021-08-31;387;833;166042;149172;76.5;68.7
36;2021-09-01;388;1060;166430;150232;76.6;69.2
36;2021-09-02;324;910;166754;151142;76.8;69.6
36;2021-09-03;297;1362;167051;152504;76.9;70.2
36;2021-09-04;248;781;167299;153285;77.0;70.6
36;2021-09-05;119;327;167418;153612;77.1;70.7
36;2021-09-06;150;872;167568;154484;77.2;71.1
36;2021-09-07;192;689;167760;155173;77.3;71.5
36;2021-09-08;236;1121;167996;156294;77.4;72.0
36;2021-09-09;293;834;168289;157128;77.5;72.4
36;2021-09-10;270;951;168559;158079;77.6;72.8
36;2021-09-11;165;724;168724;158803;77.7;73.1
36;2021-09-12;82;190;168806;158993;77.7;73.2
36;2021-09-13;168;550;168974;159543;77.8;73.5
36;2021-09-14;170;438;169144;159981;77.9;73.7
36;2021-09-15;301;568;169445;160549;78.0;73.9
36;2021-09-16;250;670;169695;161219;78.2;74.2
36;2021-09-17;256;567;169951;161786;78.3;74.5
36;2021-09-18;123;427;170074;162213;78.3;74.7
36;2021-09-19;43;214;170117;162427;78.3;74.8
36;2021-09-20;131;325;170248;162752;78.4;75.0
36;2021-09-21;132;300;170380;163052;78.5;75.1
36;2021-09-22;118;674;170498;163726;78.5;75.4
36;2021-09-23;135;438;170633;164164;78.6;75.6
36;2021-09-24;128;497;170761;164661;78.6;75.8
36;2021-09-25;119;502;170880;165163;78.7;76.1
36;2021-09-26;15;318;170895;165481;78.7;76.2
36;2021-09-27;66;224;170961;165705;78.7;76.3
36;2021-09-28;69;233;171030;165938;78.8;76.4
36;2021-09-29;107;387;171137;166325;78.8;76.6
36;2021-09-30;110;252;171247;166577;78.9;76.7
36;2021-10-01;163;308;171410;166885;78.9;76.9
36;2021-10-02;43;183;171453;167068;79.0;76.9
36;2021-10-03;4;23;171457;167091;79.0;77.0
36;2021-10-04;54;195;171511;167286;79.0;77.0
36;2021-10-05;115;163;171626;167449;79.0;77.1
36;2021-10-06;99;293;171725;167742;79.1;77.3
36;2021-10-07;84;204;171809;167946;79.1;77.3
36;2021-10-08;130;268;171939;168214;79.2;77.5
36;2021-10-09;80;207;172019;168421;79.2;77.6
36;2021-10-10;4;11;172023;168432;79.2;77.6
36;2021-10-11;86;140;172109;168572;79.3;77.6
37;2020-12-27;1;0;1;0;0.0;0.0
37;2020-12-28;17;0;18;0;0.0;0.0
37;2020-12-29;10;0;28;0;0.0;0.0
37;2020-12-30;0;0;28;0;0.0;0.0
37;2020-12-31;0;0;28;0;0.0;0.0
37;2021-01-01;0;0;28;0;0.0;0.0
37;2021-01-02;0;0;28;0;0.0;0.0
37;2021-01-03;2;0;30;0;0.0;0.0
37;2021-01-04;23;0;53;0;0.0;0.0
37;2021-01-05;47;0;100;0;0.0;0.0
37;2021-01-06;79;0;179;0;0.0;0.0
37;2021-01-07;116;1;295;1;0.0;0.0
37;2021-01-08;442;1;737;2;0.1;0.0
37;2021-01-09;80;2;817;4;0.1;0.0
37;2021-01-10;83;0;900;4;0.1;0.0
37;2021-01-11;281;0;1181;4;0.2;0.0
37;2021-01-12;658;5;1839;9;0.3;0.0
37;2021-01-13;561;1;2400;10;0.4;0.0
37;2021-01-14;525;4;2925;14;0.5;0.0
37;2021-01-15;628;1;3553;15;0.6;0.0
37;2021-01-16;304;2;3857;17;0.6;0.0
37;2021-01-17;263;1;4120;18;0.7;0.0
37;2021-01-18;733;9;4853;27;0.8;0.0
37;2021-01-19;1244;11;6097;38;1.0;0.0
37;2021-01-20;1039;5;7136;43;1.2;0.0
37;2021-01-21;858;1;7994;44;1.3;0.0
37;2021-01-22;767;2;8761;46;1.4;0.0
37;2021-01-23;173;0;8934;46;1.5;0.0
37;2021-01-24;2;0;8936;46;1.5;0.0
37;2021-01-25;543;17;9479;63;1.6;0.0
37;2021-01-26;1814;69;11293;132;1.9;0.0
37;2021-01-27;1523;77;12816;209;2.1;0.0
37;2021-01-28;1535;95;14351;304;2.4;0.1
37;2021-01-29;634;310;14985;614;2.5;0.1
37;2021-01-30;204;61;15189;675;2.5;0.1
37;2021-01-31;15;64;15204;739;2.5;0.1
37;2021-02-01;333;198;15537;937;2.6;0.2
37;2021-02-02;522;526;16059;1463;2.7;0.2
37;2021-02-03;659;349;16718;1812;2.8;0.3
37;2021-02-04;549;409;17267;2221;2.9;0.4
37;2021-02-05;468;443;17735;2664;2.9;0.4
37;2021-02-06;191;2;17926;2666;3.0;0.4
37;2021-02-07;21;1;17947;2667;3.0;0.4
37;2021-02-08;333;323;18280;2990;3.0;0.5
37;2021-02-09;627;709;18907;3699;3.1;0.6
37;2021-02-10;664;509;19571;4208;3.2;0.7
37;2021-02-11;613;562;20184;4770;3.3;0.8
37;2021-02-12;489;552;20673;5322;3.4;0.9
37;2021-02-13;156;204;20829;5526;3.4;0.9
37;2021-02-14;2;72;20831;5598;3.4;0.9
37;2021-02-15;427;480;21258;6078;3.5;1.0
37;2021-02-16;841;1444;22099;7522;3.7;1.2
37;2021-02-17;634;1371;22733;8893;3.8;1.5
37;2021-02-18;913;1417;23646;10310;3.9;1.7
37;2021-02-19;797;836;24443;11146;4.0;1.8
37;2021-02-20;245;209;24688;11355;4.1;1.9
37;2021-02-21;5;1;24693;11356;4.1;1.9
37;2021-02-22;335;581;25028;11937;4.1;2.0
37;2021-02-23;605;631;25633;12568;4.2;2.1
37;2021-02-24;573;623;26206;13191;4.3;2.2
37;2021-02-25;875;613;27081;13804;4.5;2.3
37;2021-02-26;1118;577;28199;14381;4.7;2.4
37;2021-02-27;585;188;28784;14569;4.8;2.4
37;2021-02-28;23;0;28807;14569;4.8;2.4
37;2021-03-01;603;361;29410;14930;4.9;2.5
37;2021-03-02;1090;544;30500;15474;5.0;2.6
37;2021-03-03;973;549;31473;16023;5.2;2.6
37;2021-03-04;1608;485;33081;16508;5.5;2.7
37;2021-03-05;2132;566;35213;17074;5.8;2.8
37;2021-03-06;1165;216;36378;17290;6.0;2.9
37;2021-03-07;472;68;36850;17358;6.1;2.9
37;2021-03-08;670;401;37520;17759;6.2;2.9
37;2021-03-09;1654;704;39174;18463;6.5;3.0
37;2021-03-10;1608;755;40782;19218;6.7;3.2
37;2021-03-11;2051;707;42833;19925;7.1;3.3
37;2021-03-12;3210;481;46043;20406;7.6;3.4
37;2021-03-13;1948;192;47991;20598;7.9;3.4
37;2021-03-14;206;4;48197;20602;8.0;3.4
37;2021-03-15;1070;252;49267;20854;8.1;3.4
37;2021-03-16;1050;535;50317;21389;8.3;3.5
37;2021-03-17;937;281;51254;21670;8.5;3.6
37;2021-03-18;1036;528;52290;22198;8.6;3.7
37;2021-03-19;2218;346;54508;22544;9.0;3.7
37;2021-03-20;1336;145;55844;22689;9.2;3.7
37;2021-03-21;205;4;56049;22693;9.3;3.7
37;2021-03-22;1288;243;57337;22936;9.5;3.8
37;2021-03-23;2257;573;59594;23509;9.8;3.9
37;2021-03-24;2245;469;61839;23978;10.2;4.0
37;2021-03-25;2985;449;64824;24427;10.7;4.0
37;2021-03-26;3525;413;68349;24840;11.3;4.1
37;2021-03-27;1176;129;69525;24969;11.5;4.1
37;2021-03-28;139;1;69664;24970;11.5;4.1
37;2021-03-29;1606;350;71270;25320;11.8;4.2
37;2021-03-30;2525;627;73795;25947;12.2;4.3
37;2021-03-31;2050;485;75845;26432;12.5;4.4
37;2021-04-01;2601;972;78446;27404;13.0;4.5
37;2021-04-02;2808;672;81254;28076;13.4;4.6
37;2021-04-03;818;226;82072;28302;13.6;4.7
37;2021-04-04;104;1;82176;28303;13.6;4.7
37;2021-04-05;4;0;82180;28303;13.6;4.7
37;2021-04-06;2243;785;84423;29088;13.9;4.8
37;2021-04-07;3173;881;87596;29969;14.5;5.0
37;2021-04-08;4045;972;91641;30941;15.1;5.1
37;2021-04-09;4544;960;96185;31901;15.9;5.3
37;2021-04-10;1329;437;97514;32338;16.1;5.3
37;2021-04-11;104;1;97618;32339;16.1;5.3
37;2021-04-12;2642;680;100260;33019;16.6;5.5
37;2021-04-13;4114;1167;104374;34186;17.2;5.6
37;2021-04-14;3043;896;107417;35082;17.7;5.8
37;2021-04-15;3757;1023;111174;36105;18.4;6.0
37;2021-04-16;4359;1231;115533;37336;19.1;6.2
37;2021-04-17;1147;228;116680;37564;19.3;6.2
37;2021-04-18;98;3;116778;37567;19.3;6.2
37;2021-04-19;2481;852;119259;38419;19.7;6.3
37;2021-04-20;3233;1340;122492;39759;20.2;6.6
37;2021-04-21;2928;1163;125420;40922;20.7;6.8
37;2021-04-22;3456;1405;128876;42327;21.3;7.0
37;2021-04-23;3694;1819;132570;44146;21.9;7.3
37;2021-04-24;1007;387;133577;44533;22.1;7.4
37;2021-04-25;46;2;133623;44535;22.1;7.4
37;2021-04-26;2971;1351;136594;45886;22.6;7.6
37;2021-04-27;4186;1817;140780;47703;23.3;7.9
37;2021-04-28;3466;1957;144246;49660;23.8;8.2
37;2021-04-29;4586;2028;148832;51688;24.6;8.5
37;2021-04-30;5056;1995;153888;53683;25.4;8.9
37;2021-05-01;638;214;154526;53897;25.5;8.9
37;2021-05-02;104;15;154630;53912;25.5;8.9
37;2021-05-03;2672;1960;157302;55872;26.0;9.2
37;2021-05-04;3731;2722;161033;58594;26.6;9.7
37;2021-05-05;3498;2091;164531;60685;27.2;10.0
37;2021-05-06;4992;1954;169523;62639;28.0;10.3
37;2021-05-07;4685;2887;174208;65526;28.8;10.8
37;2021-05-08;538;312;174746;65838;28.9;10.9
37;2021-05-09;63;41;174809;65879;28.9;10.9
37;2021-05-10;2161;3486;176970;69365;29.2;11.5
37;2021-05-11;3868;3882;180838;73247;29.9;12.1
37;2021-05-12;4041;2547;184879;75794;30.5;12.5
37;2021-05-13;1139;517;186018;76311;30.7;12.6
37;2021-05-14;4046;2680;190064;78991;31.4;13.0
37;2021-05-15;2322;744;192386;79735;31.8;13.2
37;2021-05-16;22;70;192408;79805;31.8;13.2
37;2021-05-17;2765;2046;195173;81851;32.2;13.5
37;2021-05-18;3876;2362;199049;84213;32.9;13.9
37;2021-05-19;3495;1808;202544;86021;33.5;14.2
37;2021-05-20;4751;1778;207295;87799;34.2;14.5
37;2021-05-21;4525;2572;211820;90371;35.0;14.9
37;2021-05-22;1078;752;212898;91123;35.2;15.1
37;2021-05-23;73;89;212971;91212;35.2;15.1
37;2021-05-24;513;107;213484;91319;35.3;15.1
37;2021-05-25;5123;2177;218607;93496;36.1;15.4
37;2021-05-26;4930;2101;223537;95597;36.9;15.8
37;2021-05-27;5983;2367;229520;97964;37.9;16.2
37;2021-05-28;6019;3268;235539;101232;38.9;16.7
37;2021-05-29;1520;1167;237059;102399;39.2;16.9
37;2021-05-30;55;160;237114;102559;39.2;16.9
37;2021-05-31;3647;2529;240761;105088;39.8;17.4
37;2021-06-01;5841;3623;246602;108711;40.7;18.0
37;2021-06-02;5079;2459;251681;111170;41.6;18.4
37;2021-06-03;6086;2884;257767;114054;42.6;18.8
37;2021-06-04;5510;4209;263277;118263;43.5;19.5
37;2021-06-05;1853;1306;265130;119569;43.8;19.8
37;2021-06-06;49;197;265179;119766;43.8;19.8
37;2021-06-07;3021;4168;268200;123934;44.3;20.5
37;2021-06-08;4201;4658;272401;128592;45.0;21.2
37;2021-06-09;3883;3573;276284;132165;45.6;21.8
37;2021-06-10;5271;3622;281555;135787;46.5;22.4
37;2021-06-11;4972;4839;286527;140626;47.3;23.2
37;2021-06-12;3552;1349;290079;141975;47.9;23.5
37;2021-06-13;15;164;290094;142139;47.9;23.5
37;2021-06-14;2666;4039;292760;146178;48.4;24.1
37;2021-06-15;3898;4780;296658;150958;49.0;24.9
37;2021-06-16;3261;3602;299919;154560;49.5;25.5
37;2021-06-17;4013;4497;303932;159057;50.2;26.3
37;2021-06-18;4704;5075;308636;164132;51.0;27.1
37;2021-06-19;2519;1101;311155;165233;51.4;27.3
37;2021-06-20;10;183;311165;165416;51.4;27.3
37;2021-06-21;2417;3827;313582;169243;51.8;28.0
37;2021-06-22;2968;5008;316550;174251;52.3;28.8
37;2021-06-23;2625;3644;319175;177895;52.7;29.4
37;2021-06-24;2873;3544;322048;181439;53.2;30.0
37;2021-06-25;3308;4882;325356;186321;53.7;30.8
37;2021-06-26;1238;3086;326594;189407;53.9;31.3
37;2021-06-27;23;142;326617;189549;54.0;31.3
37;2021-06-28;1703;4510;328320;194059;54.2;32.1
37;2021-06-29;1904;6225;330224;200284;54.5;33.1
37;2021-06-30;1870;4443;332094;204727;54.9;33.8
37;2021-07-01;2124;4795;334218;209522;55.2;34.6
37;2021-07-02;2681;5595;336899;215117;55.7;35.5
37;2021-07-03;944;2139;337843;217256;55.8;35.9
37;2021-07-04;5;105;337848;217361;55.8;35.9
37;2021-07-05;1709;5137;339557;222498;56.1;36.8
37;2021-07-06;2003;6760;341560;229258;56.4;37.9
37;2021-07-07;1944;5466;343504;234724;56.7;38.8
37;2021-07-08;2465;6662;345969;241386;57.1;39.9
37;2021-07-09;1986;7646;347955;249032;57.5;41.1
37;2021-07-10;1016;2619;348971;251651;57.6;41.6
37;2021-07-11;26;96;348997;251747;57.6;41.6
37;2021-07-12;1130;5984;350127;257731;57.8;42.6
37;2021-07-13;1614;7817;351741;265548;58.1;43.9
37;2021-07-14;525;408;352266;265956;58.2;43.9
37;2021-07-15;2625;7502;354891;273458;58.6;45.2
37;2021-07-16;2757;7804;357648;281262;59.1;46.5
37;2021-07-17;1202;2447;358850;283709;59.3;46.9
37;2021-07-18;50;53;358900;283762;59.3;46.9
37;2021-07-19;1652;6127;360552;289889;59.6;47.9
37;2021-07-20;2906;7065;363458;296954;60.0;49.1
37;2021-07-21;2981;5785;366439;302739;60.5;50.0
37;2021-07-22;4057;6533;370496;309272;61.2;51.1
37;2021-07-23;3808;7108;374304;316380;61.8;52.3
37;2021-07-24;1775;3308;376079;319688;62.1;52.8
37;2021-07-25;66;77;376145;319765;62.1;52.8
37;2021-07-26;3236;4321;379381;324086;62.7;53.5
37;2021-07-27;4429;4963;383810;329049;63.4;54.4
37;2021-07-28;4136;3664;387946;332713;64.1;55.0
37;2021-07-29;5086;4195;393032;336908;64.9;55.7
37;2021-07-30;5247;4939;398279;341847;65.8;56.5
37;2021-07-31;1921;1846;400200;343693;66.1;56.8
37;2021-08-01;31;52;400231;343745;66.1;56.8
37;2021-08-02;3293;3296;403524;347041;66.7;57.3
37;2021-08-03;5262;3146;408786;350187;67.5;57.8
37;2021-08-04;4559;1931;413345;352118;68.3;58.2
37;2021-08-05;4788;2599;418133;354717;69.1;58.6
37;2021-08-06;4852;3307;422985;358024;69.9;59.1
37;2021-08-07;1626;1125;424611;359149;70.1;59.3
37;2021-08-08;34;177;424645;359326;70.1;59.4
37;2021-08-09;2435;2258;427080;361584;70.5;59.7
37;2021-08-10;3027;2639;430107;364223;71.0;60.2
37;2021-08-11;2099;2108;432206;366331;71.4;60.5
37;2021-08-12;2613;2692;434819;369023;71.8;61.0
37;2021-08-13;2484;2776;437303;371799;72.2;61.4
37;2021-08-14;756;814;438059;372613;72.4;61.6
37;2021-08-15;12;57;438071;372670;72.4;61.6
37;2021-08-16;1466;3160;439537;375830;72.6;62.1
37;2021-08-17;1796;3974;441333;379804;72.9;62.7
37;2021-08-18;1399;3141;442732;382945;73.1;63.3
37;2021-08-19;1598;3842;444330;386787;73.4;63.9
37;2021-08-20;1598;4554;445928;391341;73.7;64.6
37;2021-08-21;610;1201;446538;392542;73.8;64.8
37;2021-08-22;3;31;446541;392573;73.8;64.8
37;2021-08-23;1291;3985;447832;396558;74.0;65.5
37;2021-08-24;1541;4852;449373;401410;74.2;66.3
37;2021-08-25;1054;4222;450427;405632;74.4;67.0
37;2021-08-26;1279;4513;451706;410145;74.6;67.8
37;2021-08-27;1456;5663;453162;415808;74.9;68.7
37;2021-08-28;408;1462;453570;417270;74.9;68.9
37;2021-08-29;1;18;453571;417288;74.9;68.9
37;2021-08-30;1076;3877;454647;421165;75.1;69.6
37;2021-08-31;1280;3713;455927;424878;75.3;70.2
37;2021-09-01;977;2493;456904;427371;75.5;70.6
37;2021-09-02;896;2529;457800;429900;75.6;71.0
37;2021-09-03;1046;3566;458846;433466;75.8;71.6
37;2021-09-04;667;1323;459513;434789;75.9;71.8
37;2021-09-05;1;28;459514;434817;75.9;71.8
37;2021-09-06;377;1091;459891;435908;76.0;72.0
37;2021-09-07;536;1299;460427;437207;76.1;72.2
37;2021-09-08;819;1871;461246;439078;76.2;72.5
37;2021-09-09;556;1272;461802;440350;76.3;72.7
37;2021-09-10;816;1610;462618;441960;76.4;73.0
37;2021-09-11;401;939;463019;442899;76.5;73.2
37;2021-09-12;15;15;463034;442914;76.5;73.2
37;2021-09-13;449;1057;463483;443971;76.6;73.3
37;2021-09-14;509;1089;463992;445060;76.6;73.5
37;2021-09-15;624;1477;464616;446537;76.7;73.8
37;2021-09-16;354;770;464970;447307;76.8;73.9
37;2021-09-17;635;1472;465605;448779;76.9;74.1
37;2021-09-18;306;841;465911;449620;77.0;74.3
37;2021-09-19;16;42;465927;449662;77.0;74.3
37;2021-09-20;271;681;466198;450343;77.0;74.4
37;2021-09-21;438;1323;466636;451666;77.1;74.6
37;2021-09-22;426;1289;467062;452955;77.2;74.8
37;2021-09-23;427;1046;467489;454001;77.2;75.0
37;2021-09-24;502;1406;467991;455407;77.3;75.2
37;2021-09-25;231;769;468222;456176;77.3;75.4
37;2021-09-26;1;22;468223;456198;77.3;75.4
37;2021-09-27;289;692;468512;456890;77.4;75.5
37;2021-09-28;396;661;468908;457551;77.5;75.6
37;2021-09-29;366;940;469274;458491;77.5;75.7
37;2021-09-30;372;495;469646;458986;77.6;75.8
37;2021-10-01;438;804;470084;459790;77.7;76.0
37;2021-10-02;223;561;470307;460351;77.7;76.0
37;2021-10-03;19;22;470326;460373;77.7;76.0
37;2021-10-04;259;520;470585;460893;77.7;76.1
37;2021-10-05;323;433;470908;461326;77.8;76.2
37;2021-10-06;371;699;471279;462025;77.8;76.3
37;2021-10-07;281;415;471560;462440;77.9;76.4
37;2021-10-08;391;644;471951;463084;78.0;76.5
37;2021-10-09;205;487;472156;463571;78.0;76.6
37;2021-10-10;3;7;472159;463578;78.0;76.6
37;2021-10-11;213;344;472372;463922;78.0;76.6
38;2020-12-27;1;0;1;0;0.0;0.0
38;2020-12-28;1;0;2;0;0.0;0.0
38;2020-12-29;0;0;2;0;0.0;0.0
38;2020-12-30;2;0;4;0;0.0;0.0
38;2020-12-31;5;0;9;0;0.0;0.0
38;2021-01-01;4;0;13;0;0.0;0.0
38;2021-01-02;1;0;14;0;0.0;0.0
38;2021-01-03;3;1;17;1;0.0;0.0
38;2021-01-04;163;0;180;1;0.0;0.0
38;2021-01-05;258;1;438;2;0.0;0.0
38;2021-01-06;364;0;802;2;0.1;0.0
38;2021-01-07;636;1;1438;3;0.1;0.0
38;2021-01-08;695;0;2133;3;0.2;0.0
38;2021-01-09;30;0;2163;3;0.2;0.0
38;2021-01-10;2;0;2165;3;0.2;0.0
38;2021-01-11;801;2;2966;5;0.2;0.0
38;2021-01-12;1471;5;4437;10;0.4;0.0
38;2021-01-13;1084;5;5521;15;0.4;0.0
38;2021-01-14;1683;15;7204;30;0.6;0.0
38;2021-01-15;1675;9;8879;39;0.7;0.0
38;2021-01-16;307;2;9186;41;0.7;0.0
38;2021-01-17;3;0;9189;41;0.7;0.0
38;2021-01-18;1179;6;10368;47;0.8;0.0
38;2021-01-19;2241;6;12609;53;1.0;0.0
38;2021-01-20;1889;10;14498;63;1.1;0.0
38;2021-01-21;1644;14;16142;77;1.3;0.0
38;2021-01-22;1401;9;17543;86;1.4;0.0
38;2021-01-23;379;3;17922;89;1.4;0.0
38;2021-01-24;1;0;17923;89;1.4;0.0
38;2021-01-25;795;107;18718;196;1.5;0.0
38;2021-01-26;855;183;19573;379;1.5;0.0
38;2021-01-27;1093;278;20666;657;1.6;0.1
38;2021-01-28;1175;480;21841;1137;1.7;0.1
38;2021-01-29;954;376;22795;1513;1.8;0.1
38;2021-01-30;304;0;23099;1513;1.8;0.1
38;2021-01-31;0;0;23099;1513;1.8;0.1
38;2021-02-01;703;598;23802;2111;1.9;0.2
38;2021-02-02;964;954;24766;3065;2.0;0.2
38;2021-02-03;1230;700;25996;3765;2.1;0.3
38;2021-02-04;1278;971;27274;4736;2.2;0.4
38;2021-02-05;1400;845;28674;5581;2.3;0.4
38;2021-02-06;188;95;28862;5676;2.3;0.4
38;2021-02-07;3;48;28865;5724;2.3;0.5
38;2021-02-08;862;791;29727;6515;2.3;0.5
38;2021-02-09;1537;1309;31264;7824;2.5;0.6
38;2021-02-10;1581;1284;32845;9108;2.6;0.7
38;2021-02-11;1871;1156;34716;10264;2.7;0.8
38;2021-02-12;1509;1125;36225;11389;2.9;0.9
38;2021-02-13;467;191;36692;11580;2.9;0.9
38;2021-02-14;1;7;36693;11587;2.9;0.9
38;2021-02-15;976;940;37669;12527;3.0;1.0
38;2021-02-16;1379;975;39048;13502;3.1;1.1
38;2021-02-17;1376;1060;40424;14562;3.2;1.2
38;2021-02-18;1791;1062;42215;15624;3.3;1.2
38;2021-02-19;1256;869;43471;16493;3.4;1.3
38;2021-02-20;470;316;43941;16809;3.5;1.3
38;2021-02-21;1;1;43942;16810;3.5;1.3
38;2021-02-22;1075;903;45017;17713;3.6;1.4
38;2021-02-23;1542;951;46559;18664;3.7;1.5
38;2021-02-24;1741;1142;48300;19806;3.8;1.6
38;2021-02-25;2501;1058;50801;20864;4.0;1.6
38;2021-02-26;3311;999;54112;21863;4.3;1.7
38;2021-02-27;1511;442;55623;22305;4.4;1.8
38;2021-02-28;33;2;55656;22307;4.4;1.8
38;2021-03-01;2512;799;58168;23106;4.6;1.8
38;2021-03-02;4048;1069;62216;24175;4.9;1.9
38;2021-03-03;3367;1263;65583;25438;5.2;2.0
38;2021-03-04;4489;1403;70072;26841;5.5;2.1
38;2021-03-05;5233;1230;75305;28071;6.0;2.2
38;2021-03-06;3044;276;78349;28347;6.2;2.2
38;2021-03-07;115;2;78464;28349;6.2;2.2
38;2021-03-08;2440;910;80904;29259;6.4;2.3
38;2021-03-09;4030;1328;84934;30587;6.7;2.4
38;2021-03-10;3508;1102;88442;31689;7.0;2.5
38;2021-03-11;5142;1551;93584;33240;7.4;2.6
38;2021-03-12;7095;1202;100679;34442;8.0;2.7
38;2021-03-13;3772;236;104451;34678;8.3;2.7
38;2021-03-14;544;15;104995;34693;8.3;2.7
38;2021-03-15;2702;1020;107697;35713;8.5;2.8
38;2021-03-16;2081;1358;109778;37071;8.7;2.9
38;2021-03-17;2025;1214;111803;38285;8.8;3.0
38;2021-03-18;2641;1377;114444;39662;9.0;3.1
38;2021-03-19;4008;1076;118452;40738;9.4;3.2
38;2021-03-20;1826;252;120278;40990;9.5;3.2
38;2021-03-21;132;8;120410;40998;9.5;3.2
38;2021-03-22;2865;1011;123275;42009;9.7;3.3
38;2021-03-23;4780;1502;128055;43511;10.1;3.4
38;2021-03-24;3709;1587;131764;45098;10.4;3.6
38;2021-03-25;5791;1559;137555;46657;10.9;3.7
38;2021-03-26;6599;1757;144154;48414;11.4;3.8
38;2021-03-27;2513;765;146667;49179;11.6;3.9
38;2021-03-28;926;48;147593;49227;11.7;3.9
38;2021-03-29;2679;1852;150272;51079;11.9;4.0
38;2021-03-30;4564;2554;154836;53633;12.2;4.2
38;2021-03-31;3665;2233;158501;55866;12.5;4.4
38;2021-04-01;5137;2538;163638;58404;12.9;4.6
38;2021-04-02;3873;2538;167511;60942;13.2;4.8
38;2021-04-03;1418;945;168929;61887;13.4;4.9
38;2021-04-04;430;46;169359;61933;13.4;4.9
38;2021-04-05;2177;354;171536;62287;13.6;4.9
38;2021-04-06;4346;2411;175882;64698;13.9;5.1
38;2021-04-07;4415;2752;180297;67450;14.3;5.3
38;2021-04-08;5652;2681;185949;70131;14.7;5.5
38;2021-04-09;8563;2747;194512;72878;15.4;5.8
38;2021-04-10;3597;1499;198109;74377;15.7;5.9
38;2021-04-11;1049;112;199158;74489;15.7;5.9
38;2021-04-12;4203;2260;203361;76749;16.1;6.1
38;2021-04-13;6123;2480;209484;79229;16.6;6.3
38;2021-04-14;5117;2467;214601;81696;17.0;6.5
38;2021-04-15;6361;2777;220962;84473;17.5;6.7
38;2021-04-16;6213;2729;227175;87202;18.0;6.9
38;2021-04-17;2588;997;229763;88199;18.2;7.0
38;2021-04-18;1331;72;231094;88271;18.3;7.0
38;2021-04-19;3949;2842;235043;91113;18.6;7.2
38;2021-04-20;5425;2860;240468;93973;19.0;7.4
38;2021-04-21;4976;2712;245444;96685;19.4;7.6
38;2021-04-22;5790;2840;251234;99525;19.9;7.9
38;2021-04-23;6041;2829;257275;102354;20.3;8.1
38;2021-04-24;2665;1351;259940;103705;20.5;8.2
38;2021-04-25;805;592;260745;104297;20.6;8.2
38;2021-04-26;4487;2483;265232;106780;21.0;8.4
38;2021-04-27;6040;2741;271272;109521;21.4;8.7
38;2021-04-28;6197;2512;277469;112033;21.9;8.9
38;2021-04-29;8332;3079;285801;115112;22.6;9.1
38;2021-04-30;7674;4068;293475;119180;23.2;9.4
38;2021-05-01;1546;204;295021;119384;23.3;9.4
38;2021-05-02;847;74;295868;119458;23.4;9.4
38;2021-05-03;5298;3593;301166;123051;23.8;9.7
38;2021-05-04;6203;5091;307369;128142;24.3;10.1
38;2021-05-05;6067;4612;313436;132754;24.8;10.5
38;2021-05-06;6709;5339;320145;138093;25.3;10.9
38;2021-05-07;7284;6448;327429;144541;25.9;11.4
38;2021-05-08;3778;724;331207;145265;26.2;11.5
38;2021-05-09;2853;1932;334060;147197;26.4;11.6
38;2021-05-10;6157;5311;340217;152508;26.9;12.1
38;2021-05-11;8226;6029;348443;158537;27.5;12.5
38;2021-05-12;9045;4710;357488;163247;28.3;12.9
38;2021-05-13;6635;1417;364123;164664;28.8;13.0
38;2021-05-14;9566;3425;373689;168089;29.5;13.3
38;2021-05-15;6864;1452;380553;169541;30.1;13.4
38;2021-05-16;5473;650;386026;170191;30.5;13.5
38;2021-05-17;7671;3008;393697;173199;31.1;13.7
38;2021-05-18;8622;4035;402319;177234;31.8;14.0
38;2021-05-19;8158;3348;410477;180582;32.4;14.3
38;2021-05-20;8978;4496;419455;185078;33.2;14.6
38;2021-05-21;9960;4586;429415;189664;33.9;15.0
38;2021-05-22;7457;1908;436872;191572;34.5;15.1
38;2021-05-23;5589;580;442461;192152;35.0;15.2
38;2021-05-24;7502;1627;449963;193779;35.6;15.3
38;2021-05-25;9544;4852;459507;198631;36.3;15.7
38;2021-05-26;8126;4727;467633;203358;37.0;16.1
38;2021-05-27;9134;5664;476767;209022;37.7;16.5
38;2021-05-28;8786;6500;485553;215522;38.4;17.0
38;2021-05-29;5821;3256;491374;218778;38.8;17.3
38;2021-05-30;2695;1593;494069;220371;39.1;17.4
38;2021-05-31;8271;5136;502340;225507;39.7;17.8
38;2021-06-01;7964;6433;510304;231940;40.3;18.3
38;2021-06-02;7141;5624;517445;237564;40.9;18.8
38;2021-06-03;7393;6835;524838;244399;41.5;19.3
38;2021-06-04;8130;7615;532968;252014;42.1;19.9
38;2021-06-05;5794;3949;538762;255963;42.6;20.2
38;2021-06-06;2509;1463;541271;257426;42.8;20.4
38;2021-06-07;5554;6870;546825;264296;43.2;20.9
38;2021-06-08;5879;7529;552704;271825;43.7;21.5
38;2021-06-09;5047;6471;557751;278296;44.1;22.0
38;2021-06-10;5427;6791;563178;285087;44.5;22.5
38;2021-06-11;5888;7786;569066;292873;45.0;23.2
38;2021-06-12;3945;3259;573011;296132;45.3;23.4
38;2021-06-13;1256;1299;574267;297431;45.4;23.5
38;2021-06-14;3868;7663;578135;305094;45.7;24.1
38;2021-06-15;5233;8147;583368;313241;46.1;24.8
38;2021-06-16;5125;7408;588493;320649;46.5;25.3
38;2021-06-17;4523;7058;593016;327707;46.9;25.9
38;2021-06-18;6164;9231;599180;336938;47.4;26.6
38;2021-06-19;3596;4972;602776;341910;47.7;27.0
38;2021-06-20;1038;2901;603814;344811;47.7;27.3
38;2021-06-21;3748;8709;607562;353520;48.0;27.9
38;2021-06-22;3790;10107;611352;363627;48.3;28.7
38;2021-06-23;3156;9544;614508;373171;48.6;29.5
38;2021-06-24;3381;8589;617889;381760;48.8;30.2
38;2021-06-25;3786;11492;621675;393252;49.1;31.1
38;2021-06-26;2229;7851;623904;401103;49.3;31.7
38;2021-06-27;1098;4356;625002;405459;49.4;32.1
38;2021-06-28;2952;10304;627954;415763;49.6;32.9
38;2021-06-29;3785;10451;631739;426214;49.9;33.7
38;2021-06-30;4061;9944;635800;436158;50.3;34.5
38;2021-07-01;3548;9012;639348;445170;50.5;35.2
38;2021-07-02;3726;11616;643074;456786;50.8;36.1
38;2021-07-03;1739;8788;644813;465574;51.0;36.8
38;2021-07-04;1244;3209;646057;468783;51.1;37.1
38;2021-07-05;3058;10545;649115;479328;51.3;37.9
38;2021-07-06;3460;10234;652575;489562;51.6;38.7
38;2021-07-07;3569;9399;656144;498961;51.9;39.4
38;2021-07-08;3549;8226;659693;507187;52.2;40.1
38;2021-07-09;3897;10738;663590;517925;52.5;40.9
38;2021-07-10;2405;7808;665995;525733;52.6;41.6
38;2021-07-11;777;2030;666772;527763;52.7;41.7
38;2021-07-12;3483;10677;670255;538440;53.0;42.6
38;2021-07-13;6600;10935;676855;549375;53.5;43.4
38;2021-07-14;4670;3332;681525;552707;53.9;43.7
38;2021-07-15;8733;9669;690258;562376;54.6;44.5
38;2021-07-16;8759;10704;699017;573080;55.3;45.3
38;2021-07-17;4739;7485;703756;580565;55.6;45.9
38;2021-07-18;2570;2488;706326;583053;55.8;46.1
38;2021-07-19;5824;9223;712150;592276;56.3;46.8
38;2021-07-20;6289;8305;718439;600581;56.8;47.5
38;2021-07-21;7865;8028;726304;608609;57.4;48.1
38;2021-07-22;7598;6998;733902;615607;58.0;48.7
38;2021-07-23;8942;9047;742844;624654;58.7;49.4
38;2021-07-24;5576;5535;748420;630189;59.2;49.8
38;2021-07-25;2868;1655;751288;631844;59.4;49.9
38;2021-07-26;7869;7500;759157;639344;60.0;50.5
38;2021-07-27;7628;6275;766785;645619;60.6;51.0
38;2021-07-28;8622;5715;775407;651334;61.3;51.5
38;2021-07-29;7684;4685;783091;656019;61.9;51.9
38;2021-07-30;7810;6666;790901;662685;62.5;52.4
38;2021-07-31;4359;3606;795260;666291;62.9;52.7
38;2021-08-01;1298;1084;796558;667375;63.0;52.8
38;2021-08-02;3943;4453;800501;671828;63.3;53.1
38;2021-08-03;4591;4558;805092;676386;63.6;53.5
38;2021-08-04;4638;4357;809730;680743;64.0;53.8
38;2021-08-05;3740;4641;813470;685384;64.3;54.2
38;2021-08-06;4159;5949;817629;691333;64.6;54.7
38;2021-08-07;2319;3532;819948;694865;64.8;54.9
38;2021-08-08;791;2015;820739;696880;64.9;55.1
38;2021-08-09;3612;5577;824351;702457;65.2;55.5
38;2021-08-10;4930;6256;829281;708713;65.6;56.0
38;2021-08-11;3979;4666;833260;713379;65.9;56.4
38;2021-08-12;3403;4608;836663;717987;66.1;56.8
38;2021-08-13;4206;6033;840869;724020;66.5;57.2
38;2021-08-14;1785;4020;842654;728040;66.6;57.6
38;2021-08-15;538;1917;843192;729957;66.7;57.7
38;2021-08-16;2979;7924;846171;737881;66.9;58.3
38;2021-08-17;3445;5963;849616;743844;67.2;58.8
38;2021-08-18;2996;7140;852612;750984;67.4;59.4
38;2021-08-19;2614;4830;855226;755814;67.6;59.7
38;2021-08-20;2912;8430;858138;764244;67.8;60.4
38;2021-08-21;1206;5014;859344;769258;67.9;60.8
38;2021-08-22;511;1510;859855;770768;68.0;60.9
38;2021-08-23;2592;7626;862447;778394;68.2;61.5
38;2021-08-24;2570;5330;865017;783724;68.4;62.0
38;2021-08-25;2616;5876;867633;789600;68.6;62.4
38;2021-08-26;2281;4244;869914;793844;68.8;62.8
38;2021-08-27;2505;5932;872419;799776;69.0;63.2
38;2021-08-28;1424;3689;873843;803465;69.1;63.5
38;2021-08-29;377;1085;874220;804550;69.1;63.6
38;2021-08-30;2335;5677;876555;810227;69.3;64.1
38;2021-08-31;2223;4592;878778;814819;69.5;64.4
38;2021-09-01;2217;4053;880995;818872;69.6;64.7
38;2021-09-02;1671;3025;882666;821897;69.8;65.0
38;2021-09-03;2033;4583;884699;826480;69.9;65.3
38;2021-09-04;1153;2658;885852;829138;70.0;65.5
38;2021-09-05;390;664;886242;829802;70.1;65.6
38;2021-09-06;1198;2964;887440;832766;70.2;65.8
38;2021-09-07;1304;2880;888744;835646;70.3;66.1
38;2021-09-08;1731;3255;890475;838901;70.4;66.3
38;2021-09-09;1121;1970;891596;840871;70.5;66.5
38;2021-09-10;1597;3271;893193;844142;70.6;66.7
38;2021-09-11;1040;2268;894233;846410;70.7;66.9
38;2021-09-12;217;525;894450;846935;70.7;67.0
38;2021-09-13;910;2129;895360;849064;70.8;67.1
38;2021-09-14;917;1870;896277;850934;70.9;67.3
38;2021-09-15;1331;2762;897608;853696;71.0;67.5
38;2021-09-16;718;1557;898326;855253;71.0;67.6
38;2021-09-17;893;2501;899219;857754;71.1;67.8
38;2021-09-18;708;2221;899927;859975;71.1;68.0
38;2021-09-19;101;371;900028;860346;71.1;68.0
38;2021-09-20;628;1722;900656;862068;71.2;68.1
38;2021-09-21;491;1401;901147;863469;71.2;68.3
38;2021-09-22;688;2733;901835;866202;71.3;68.5
38;2021-09-23;447;1399;902282;867601;71.3;68.6
38;2021-09-24;772;2195;903054;869796;71.4;68.8
38;2021-09-25;493;1935;903547;871731;71.4;68.9
38;2021-09-26;94;378;903641;872109;71.4;68.9
38;2021-09-27;427;1228;904068;873337;71.5;69.0
38;2021-09-28;508;1116;904576;874453;71.5;69.1
38;2021-09-29;680;1906;905256;876359;71.6;69.3
38;2021-09-30;443;825;905699;877184;71.6;69.3
38;2021-10-01;609;1388;906308;878572;71.6;69.5
38;2021-10-02;481;1161;906789;879733;71.7;69.5
38;2021-10-03;94;193;906883;879926;71.7;69.6
38;2021-10-04;459;953;907342;880879;71.7;69.6
38;2021-10-05;406;870;907748;881749;71.8;69.7
38;2021-10-06;620;1250;908368;882999;71.8;69.8
38;2021-10-07;412;873;908780;883872;71.8;69.9
38;2021-10-08;657;1288;909437;885160;71.9;70.0
38;2021-10-09;502;867;909939;886027;71.9;70.0
38;2021-10-10;40;108;909979;886135;71.9;70.1
38;2021-10-11;376;785;910355;886920;72.0;70.1
39;2020-12-27;0;0;0;0;0.0;0.0
39;2020-12-28;0;0;0;0;0.0;0.0
39;2020-12-29;0;0;0;0;0.0;0.0
39;2020-12-30;0;0;0;0;0.0;0.0
39;2020-12-31;0;0;0;0;0.0;0.0
39;2021-01-01;0;0;0;0;0.0;0.0
39;2021-01-02;0;0;0;0;0.0;0.0
39;2021-01-03;0;0;0;0;0.0;0.0
39;2021-01-04;3;0;3;0;0.0;0.0
39;2021-01-05;3;0;6;0;0.0;0.0
39;2021-01-06;57;3;63;3;0.0;0.0
39;2021-01-07;333;3;396;6;0.2;0.0
39;2021-01-08;657;2;1053;8;0.4;0.0
39;2021-01-09;169;0;1222;8;0.5;0.0
39;2021-01-10;1;0;1223;8;0.5;0.0
39;2021-01-11;474;1;1697;9;0.7;0.0
39;2021-01-12;431;1;2128;10;0.8;0.0
39;2021-01-13;408;2;2536;12;1.0;0.0
39;2021-01-14;574;4;3110;16;1.2;0.0
39;2021-01-15;471;2;3581;18;1.4;0.0
39;2021-01-16;141;1;3722;19;1.4;0.0
39;2021-01-17;0;1;3722;20;1.4;0.0
39;2021-01-18;924;7;4646;27;1.8;0.0
39;2021-01-19;1181;7;5827;34;2.3;0.0
39;2021-01-20;905;4;6732;38;2.6;0.0
39;2021-01-21;1179;2;7911;40;3.1;0.0
39;2021-01-22;985;3;8896;43;3.5;0.0
39;2021-01-23;383;1;9279;44;3.6;0.0
39;2021-01-24;0;0;9279;44;3.6;0.0
39;2021-01-25;642;2;9921;46;3.8;0.0
39;2021-01-26;1123;13;11044;59;4.3;0.0
39;2021-01-27;928;19;11972;78;4.6;0.0
39;2021-01-28;741;242;12713;320;4.9;0.1
39;2021-01-29;583;424;13296;744;5.2;0.3
39;2021-01-30;264;110;13560;854;5.3;0.3
39;2021-01-31;1;0;13561;854;5.3;0.3
39;2021-02-01;562;263;14123;1117;5.5;0.4
39;2021-02-02;754;321;14877;1438;5.8;0.6
39;2021-02-03;531;515;15408;1953;6.0;0.8
39;2021-02-04;556;462;15964;2415;6.2;0.9
39;2021-02-05;438;429;16402;2844;6.4;1.1
39;2021-02-06;265;111;16667;2955;6.5;1.1
39;2021-02-07;0;1;16667;2956;6.5;1.1
39;2021-02-08;321;374;16988;3330;6.6;1.3
39;2021-02-09;383;483;17371;3813;6.7;1.5
39;2021-02-10;253;336;17624;4149;6.8;1.6
39;2021-02-11;586;511;18210;4660;7.1;1.8
39;2021-02-12;385;417;18595;5077;7.2;2.0
39;2021-02-13;100;69;18695;5146;7.3;2.0
39;2021-02-14;0;0;18695;5146;7.3;2.0
39;2021-02-15;99;756;18794;5902;7.3;2.3
39;2021-02-16;99;910;18893;6812;7.3;2.6
39;2021-02-17;58;694;18951;7506;7.3;2.9
39;2021-02-18;109;864;19060;8370;7.4;3.2
39;2021-02-19;100;485;19160;8855;7.4;3.4
39;2021-02-20;18;364;19178;9219;7.4;3.6
39;2021-02-21;0;0;19178;9219;7.4;3.6
39;2021-02-22;100;729;19278;9948;7.5;3.9
39;2021-02-23;4;764;19282;10712;7.5;4.2
39;2021-02-24;125;869;19407;11581;7.5;4.5
39;2021-02-25;214;753;19621;12334;7.6;4.8
39;2021-02-26;218;470;19839;12804;7.7;5.0
39;2021-02-27;169;298;20008;13102;7.8;5.1
39;2021-02-28;1;0;20009;13102;7.8;5.1
39;2021-03-01;218;640;20227;13742;7.8;5.3
39;2021-03-02;329;826;20556;14568;8.0;5.6
39;2021-03-03;602;534;21158;15102;8.2;5.9
39;2021-03-04;658;486;21816;15588;8.5;6.0
39;2021-03-05;670;332;22486;15920;8.7;6.2
39;2021-03-06;775;250;23261;16170;9.0;6.3
39;2021-03-07;242;84;23503;16254;9.1;6.3
39;2021-03-08;285;449;23788;16703;9.2;6.5
39;2021-03-09;844;467;24632;17170;9.6;6.7
39;2021-03-10;985;343;25617;17513;9.9;6.8
39;2021-03-11;829;469;26446;17982;10.3;7.0
39;2021-03-12;805;292;27251;18274;10.6;7.1
39;2021-03-13;789;105;28040;18379;10.9;7.1
39;2021-03-14;35;10;28075;18389;10.9;7.1
39;2021-03-15;513;110;28588;18499;11.1;7.2
39;2021-03-16;555;69;29143;18568;11.3;7.2
39;2021-03-17;611;57;29754;18625;11.5;7.2
39;2021-03-18;600;73;30354;18698;11.8;7.3
39;2021-03-19;393;72;30747;18770;11.9;7.3
39;2021-03-20;312;12;31059;18782;12.0;7.3
39;2021-03-21;3;0;31062;18782;12.0;7.3
39;2021-03-22;755;118;31817;18900;12.3;7.3
39;2021-03-23;1129;46;32946;18946;12.8;7.3
39;2021-03-24;1179;102;34125;19048;13.2;7.4
39;2021-03-25;2042;135;36167;19183;14.0;7.4
39;2021-03-26;797;116;36964;19299;14.3;7.5
39;2021-03-27;345;7;37309;19306;14.5;7.5
39;2021-03-28;36;4;37345;19310;14.5;7.5
39;2021-03-29;1036;198;38381;19508;14.9;7.6
39;2021-03-30;1400;271;39781;19779;15.4;7.7
39;2021-03-31;658;531;40439;20310;15.7;7.9
39;2021-04-01;1310;319;41749;20629;16.2;8.0
39;2021-04-02;626;131;42375;20760;16.4;8.1
39;2021-04-03;180;8;42555;20768;16.5;8.1
39;2021-04-04;4;1;42559;20769;16.5;8.1
39;2021-04-05;1;0;42560;20769;16.5;8.1
39;2021-04-06;824;634;43384;21403;16.8;8.3
39;2021-04-07;1134;685;44518;22088;17.3;8.6
39;2021-04-08;1790;583;46308;22671;18.0;8.8
39;2021-04-09;1675;294;47983;22965;18.6;8.9
39;2021-04-10;348;188;48331;23153;18.7;9.0
39;2021-04-11;2;0;48333;23153;18.7;9.0
39;2021-04-12;680;400;49013;23553;19.0;9.1
39;2021-04-13;1200;583;50213;24136;19.5;9.4
39;2021-04-14;845;641;51058;24777;19.8;9.6
39;2021-04-15;1479;722;52537;25499;20.4;9.9
39;2021-04-16;1090;176;53627;25675;20.8;10.0
39;2021-04-17;197;61;53824;25736;20.9;10.0
39;2021-04-18;0;0;53824;25736;20.9;10.0
39;2021-04-19;523;699;54347;26435;21.1;10.3
39;2021-04-20;766;547;55113;26982;21.4;10.5
39;2021-04-21;1142;724;56255;27706;21.8;10.7
39;2021-04-22;1012;1132;57267;28838;22.2;11.2
39;2021-04-23;457;364;57724;29202;22.4;11.3
39;2021-04-24;275;149;57999;29351;22.5;11.4
39;2021-04-25;12;3;58011;29354;22.5;11.4
39;2021-04-26;568;1041;58579;30395;22.7;11.8
39;2021-04-27;788;984;59367;31379;23.0;12.2
39;2021-04-28;1720;419;61087;31798;23.7;12.3
39;2021-04-29;2570;976;63657;32774;24.7;12.7
39;2021-04-30;2473;394;66130;33168;25.6;12.9
39;2021-05-01;41;53;66171;33221;25.7;12.9
39;2021-05-02;0;0;66171;33221;25.7;12.9
39;2021-05-03;917;812;67088;34033;26.0;13.2
39;2021-05-04;948;1128;68036;35161;26.4;13.6
39;2021-05-05;1954;892;69990;36053;27.1;14.0
39;2021-05-06;2425;1349;72415;37402;28.1;14.5
39;2021-05-07;1286;576;73701;37978;28.6;14.7
39;2021-05-08;179;55;73880;38033;28.7;14.8
39;2021-05-09;10;8;73890;38041;28.7;14.8
39;2021-05-10;1762;852;75652;38893;29.3;15.1
39;2021-05-11;1774;1515;77426;40408;30.0;15.7
39;2021-05-12;1810;1500;79236;41908;30.7;16.3
39;2021-05-13;246;23;79482;41931;30.8;16.3
39;2021-05-14;2392;335;81874;42266;31.8;16.4
39;2021-05-15;1848;256;83722;42522;32.5;16.5
39;2021-05-16;0;0;83722;42522;32.5;16.5
39;2021-05-17;1986;726;85708;43248;33.2;16.8
39;2021-05-18;1690;1180;87398;44428;33.9;17.2
39;2021-05-19;2496;558;89894;44986;34.9;17.4
39;2021-05-20;2465;756;92359;45742;35.8;17.7
39;2021-05-21;1800;561;94159;46303;36.5;18.0
39;2021-05-22;322;218;94481;46521;36.6;18.0
39;2021-05-23;8;36;94489;46557;36.6;18.1
39;2021-05-24;8;28;94497;46585;36.6;18.1
39;2021-05-25;1725;1197;96222;47782;37.3;18.5
39;2021-05-26;1643;1377;97865;49159;38.0;19.1
39;2021-05-27;1485;1624;99350;50783;38.5;19.7
39;2021-05-28;856;1220;100206;52003;38.9;20.2
39;2021-05-29;261;276;100467;52279;39.0;20.3
39;2021-05-30;2;40;100469;52319;39.0;20.3
39;2021-05-31;1625;1245;102094;53564;39.6;20.8
39;2021-06-01;1893;1321;103987;54885;40.3;21.3
39;2021-06-02;1705;1167;105692;56052;41.0;21.7
39;2021-06-03;1326;1160;107018;57212;41.5;22.2
39;2021-06-04;940;1073;107958;58285;41.9;22.6
39;2021-06-05;766;516;108724;58801;42.2;22.8
39;2021-06-06;1;36;108725;58837;42.2;22.8
39;2021-06-07;2106;918;110831;59755;43.0;23.2
39;2021-06-08;2208;1155;113039;60910;43.8;23.6
39;2021-06-09;1733;1240;114772;62150;44.5;24.1
39;2021-06-10;1616;2080;116388;64230;45.1;24.9
39;2021-06-11;1568;1270;117956;65500;45.7;25.4
39;2021-06-12;1264;350;119220;65850;46.2;25.5
39;2021-06-13;11;18;119231;65868;46.2;25.5
39;2021-06-14;1335;1894;120566;67762;46.8;26.3
39;2021-06-15;1386;1259;121952;69021;47.3;26.8
39;2021-06-16;1171;1536;123123;70557;47.8;27.4
39;2021-06-17;1044;1718;124167;72275;48.2;28.0
39;2021-06-18;1638;1180;125805;73455;48.8;28.5
39;2021-06-19;249;411;126054;73866;48.9;28.6
39;2021-06-20;2;18;126056;73884;48.9;28.7
39;2021-06-21;351;2495;126407;76379;49.0;29.6
39;2021-06-22;815;2294;127222;78673;49.3;30.5
39;2021-06-23;1200;1301;128422;79974;49.8;31.0
39;2021-06-24;736;1044;129158;81018;50.1;31.4
39;2021-06-25;679;2961;129837;83979;50.4;32.6
39;2021-06-26;206;1564;130043;85543;50.4;33.2
39;2021-06-27;0;0;130043;85543;50.4;33.2
39;2021-06-28;305;2743;130348;88286;50.6;34.2
39;2021-06-29;497;2697;130845;90983;50.7;35.3
39;2021-06-30;895;2426;131740;93409;51.1;36.2
39;2021-07-01;645;1939;132385;95348;51.3;37.0
39;2021-07-02;1111;1406;133496;96754;51.8;37.5
39;2021-07-03;554;524;134050;97278;52.0;37.7
39;2021-07-04;2;1;134052;97279;52.0;37.7
39;2021-07-05;601;2589;134653;99868;52.2;38.7
39;2021-07-06;835;1887;135488;101755;52.5;39.5
39;2021-07-07;591;1389;136079;103144;52.8;40.0
39;2021-07-08;700;906;136779;104050;53.0;40.4
39;2021-07-09;1078;1585;137857;105635;53.5;41.0
39;2021-07-10;739;476;138596;106111;53.8;41.2
39;2021-07-11;28;8;138624;106119;53.8;41.2
39;2021-07-12;577;2599;139201;108718;54.0;42.2
39;2021-07-13;1638;2660;140839;111378;54.6;43.2
39;2021-07-14;17;21;140856;111399;54.6;43.2
39;2021-07-15;1906;1837;142762;113236;55.4;43.9
39;2021-07-16;3226;2053;145988;115289;56.6;44.7
39;2021-07-17;2225;1163;148213;116452;57.5;45.2
39;2021-07-18;164;52;148377;116504;57.5;45.2
39;2021-07-19;1399;2952;149776;119456;58.1;46.3
39;2021-07-20;1842;2813;151618;122269;58.8;47.4
39;2021-07-21;2587;2583;154205;124852;59.8;48.4
39;2021-07-22;1934;1845;156139;126697;60.6;49.1
39;2021-07-23;1814;1933;157953;128630;61.3;49.9
39;2021-07-24;1400;1428;159353;130058;61.8;50.4
39;2021-07-25;0;1;159353;130059;61.8;50.4
39;2021-07-26;1318;2001;160671;132060;62.3;51.2
39;2021-07-27;2343;1905;163014;133965;63.2;52.0
39;2021-07-28;2688;1475;165702;135440;64.3;52.5
39;2021-07-29;2200;1743;167902;137183;65.1;53.2
39;2021-07-30;2045;1466;169947;138649;65.9;53.8
39;2021-07-31;1367;657;171314;139306;66.4;54.0
39;2021-08-01;10;18;171324;139324;66.4;54.0
39;2021-08-02;1205;1401;172529;140725;66.9;54.6
39;2021-08-03;1920;1486;174449;142211;67.7;55.2
39;2021-08-04;1047;659;175496;142870;68.1;55.4
39;2021-08-05;1242;740;176738;143610;68.5;55.7
39;2021-08-06;1375;2289;178113;145899;69.1;56.6
39;2021-08-07;1069;1213;179182;147112;69.5;57.1
39;2021-08-08;26;10;179208;147122;69.5;57.1
39;2021-08-09;436;304;179644;147426;69.7;57.2
39;2021-08-10;1230;931;180874;148357;70.1;57.5
39;2021-08-11;893;1532;181767;149889;70.5;58.1
39;2021-08-12;1596;2171;183363;152060;71.1;59.0
39;2021-08-13;1334;2119;184697;154179;71.6;59.8
39;2021-08-14;361;1106;185058;155285;71.8;60.2
39;2021-08-15;1;1;185059;155286;71.8;60.2
39;2021-08-16;488;736;185547;156022;72.0;60.5
39;2021-08-17;574;1443;186121;157465;72.2;61.1
39;2021-08-18;862;1727;186983;159192;72.5;61.7
39;2021-08-19;906;1593;187889;160785;72.9;62.4
39;2021-08-20;640;2500;188529;163285;73.1;63.3
39;2021-08-21;467;1291;188996;164576;73.3;63.8
39;2021-08-22;7;11;189003;164587;73.3;63.8
39;2021-08-23;267;972;189270;165559;73.4;64.2
39;2021-08-24;456;1607;189726;167166;73.6;64.8
39;2021-08-25;631;1604;190357;168770;73.8;65.5
39;2021-08-26;718;1860;191075;170630;74.1;66.2
39;2021-08-27;405;2060;191480;172690;74.3;67.0
39;2021-08-28;325;1369;191805;174059;74.4;67.5
39;2021-08-29;0;1;191805;174060;74.4;67.5
39;2021-08-30;345;1009;192150;175069;74.5;67.9
39;2021-08-31;399;1006;192549;176075;74.7;68.3
39;2021-09-01;512;1425;193061;177500;74.9;68.8
39;2021-09-02;332;1369;193393;178869;75.0;69.4
39;2021-09-03;477;2247;193870;181116;75.2;70.2
39;2021-09-04;148;183;194018;181299;75.2;70.3
39;2021-09-05;0;1;194018;181300;75.2;70.3
39;2021-09-06;242;481;194260;181781;75.3;70.5
39;2021-09-07;228;253;194488;182034;75.4;70.6
39;2021-09-08;441;677;194929;182711;75.6;70.9
39;2021-09-09;438;843;195367;183554;75.8;71.2
39;2021-09-10;198;586;195565;184140;75.8;71.4
39;2021-09-11;282;817;195847;184957;76.0;71.7
39;2021-09-12;0;32;195847;184989;76.0;71.7
39;2021-09-13;143;150;195990;185139;76.0;71.8
39;2021-09-14;182;296;196172;185435;76.1;71.9
39;2021-09-15;267;585;196439;186020;76.2;72.1
39;2021-09-16;476;1052;196915;187072;76.4;72.6
39;2021-09-17;424;671;197339;187743;76.5;72.8
39;2021-09-18;96;237;197435;187980;76.6;72.9
39;2021-09-19;3;3;197438;187983;76.6;72.9
39;2021-09-20;70;128;197508;188111;76.6;73.0
39;2021-09-21;87;125;197595;188236;76.6;73.0
39;2021-09-22;269;778;197864;189014;76.7;73.3
39;2021-09-23;173;312;198037;189326;76.8;73.4
39;2021-09-24;206;584;198243;189910;76.9;73.7
39;2021-09-25;65;250;198308;190160;76.9;73.7
39;2021-09-26;0;0;198308;190160;76.9;73.7
39;2021-09-27;131;318;198439;190478;77.0;73.9
39;2021-09-28;55;138;198494;190616;77.0;73.9
39;2021-09-29;195;511;198689;191127;77.1;74.1
39;2021-09-30;201;448;198890;191575;77.1;74.3
39;2021-10-01;104;199;198994;191774;77.2;74.4
39;2021-10-02;97;227;199091;192001;77.2;74.5
39;2021-10-03;2;1;199093;192002;77.2;74.5
39;2021-10-04;40;131;199133;192133;77.2;74.5
39;2021-10-05;55;125;199188;192258;77.2;74.6
39;2021-10-06;183;347;199371;192605;77.3;74.7
39;2021-10-07;135;464;199506;193069;77.4;74.9
39;2021-10-08;221;492;199727;193561;77.5;75.1
39;2021-10-09;49;47;199776;193608;77.5;75.1
39;2021-10-10;0;1;199776;193609;77.5;75.1
39;2021-10-11;16;53;199792;193662;77.5;75.1
40;2020-12-27;0;0;0;0;0.0;0.0
40;2020-12-28;0;0;0;0;0.0;0.0
40;2020-12-29;0;0;0;0;0.0;0.0
40;2020-12-30;0;0;0;0;0.0;0.0
40;2020-12-31;1;0;1;0;0.0;0.0
40;2021-01-01;0;0;1;0;0.0;0.0
40;2021-01-02;1;0;2;0;0.0;0.0
40;2021-01-03;0;0;2;0;0.0;0.0
40;2021-01-04;0;0;2;0;0.0;0.0
40;2021-01-05;0;0;2;0;0.0;0.0
40;2021-01-06;1;0;3;0;0.0;0.0
40;2021-01-07;212;0;215;0;0.1;0.0
40;2021-01-08;391;4;606;4;0.1;0.0
40;2021-01-09;0;0;606;4;0.1;0.0
40;2021-01-10;1;0;607;4;0.1;0.0
40;2021-01-11;111;0;718;4;0.2;0.0
40;2021-01-12;0;0;718;4;0.2;0.0
40;2021-01-13;681;6;1399;10;0.3;0.0
40;2021-01-14;901;9;2300;19;0.6;0.0
40;2021-01-15;811;4;3111;23;0.8;0.0
40;2021-01-16;157;0;3268;23;0.8;0.0
40;2021-01-17;1;1;3269;24;0.8;0.0
40;2021-01-18;406;0;3675;24;0.9;0.0
40;2021-01-19;1203;4;4878;28;1.2;0.0
40;2021-01-20;881;2;5759;30;1.4;0.0
40;2021-01-21;1265;6;7024;36;1.7;0.0
40;2021-01-22;811;2;7835;38;1.9;0.0
40;2021-01-23;289;0;8124;38;2.0;0.0
40;2021-01-24;2;0;8126;38;2.0;0.0
40;2021-01-25;394;2;8520;40;2.1;0.0
40;2021-01-26;802;6;9322;46;2.3;0.0
40;2021-01-27;1118;12;10440;58;2.5;0.0
40;2021-01-28;709;112;11149;170;2.7;0.0
40;2021-01-29;601;229;11750;399;2.9;0.1
40;2021-01-30;237;4;11987;403;2.9;0.1
40;2021-01-31;1;0;11988;403;2.9;0.1
40;2021-02-01;359;132;12347;535;3.0;0.1
40;2021-02-02;922;52;13269;587;3.2;0.1
40;2021-02-03;895;300;14164;887;3.4;0.2
40;2021-02-04;1059;602;15223;1489;3.7;0.4
40;2021-02-05;794;422;16017;1911;3.9;0.5
40;2021-02-06;382;84;16399;1995;4.0;0.5
40;2021-02-07;10;0;16409;1995;4.0;0.5
40;2021-02-08;375;121;16784;2116;4.1;0.5
40;2021-02-09;815;541;17599;2657;4.3;0.6
40;2021-02-10;749;469;18348;3126;4.5;0.8
40;2021-02-11;739;682;19087;3808;4.6;0.9
40;2021-02-12;627;641;19714;4449;4.8;1.1
40;2021-02-13;400;94;20114;4543;4.9;1.1
40;2021-02-14;0;0;20114;4543;4.9;1.1
40;2021-02-15;48;385;20162;4928;4.9;1.2
40;2021-02-16;284;600;20446;5528;5.0;1.3
40;2021-02-17;359;891;20805;6419;5.1;1.6
40;2021-02-18;383;694;21188;7113;5.1;1.7
40;2021-02-19;145;643;21333;7756;5.2;1.9
40;2021-02-20;39;94;21372;7850;5.2;1.9
40;2021-02-21;1;66;21373;7916;5.2;1.9
40;2021-02-22;53;561;21426;8477;5.2;2.1
40;2021-02-23;180;835;21606;9312;5.2;2.3
40;2021-02-24;283;684;21889;9996;5.3;2.4
40;2021-02-25;726;989;22615;10985;5.5;2.7
40;2021-02-26;656;632;23271;11617;5.6;2.8
40;2021-02-27;384;101;23655;11718;5.7;2.8
40;2021-02-28;2;0;23657;11718;5.7;2.8
40;2021-03-01;418;509;24075;12227;5.8;3.0
40;2021-03-02;733;1040;24808;13267;6.0;3.2
40;2021-03-03;934;910;25742;14177;6.2;3.4
40;2021-03-04;1326;827;27068;15004;6.6;3.6
40;2021-03-05;1233;742;28301;15746;6.9;3.8
40;2021-03-06;868;393;29169;16139;7.1;3.9
40;2021-03-07;93;10;29262;16149;7.1;3.9
40;2021-03-08;838;504;30100;16653;7.3;4.0
40;2021-03-09;1506;642;31606;17295;7.7;4.2
40;2021-03-10;1754;717;33360;18012;8.1;4.4
40;2021-03-11;1986;698;35346;18710;8.6;4.5
40;2021-03-12;2051;551;37397;19261;9.1;4.7
40;2021-03-13;972;255;38369;19516;9.3;4.7
40;2021-03-14;98;0;38467;19516;9.3;4.7
40;2021-03-15;924;88;39391;19604;9.6;4.8
40;2021-03-16;989;275;40380;19879;9.8;4.8
40;2021-03-17;1577;349;41957;20228;10.2;4.9
40;2021-03-18;1559;339;43516;20567;10.6;5.0
40;2021-03-19;1808;145;45324;20712;11.0;5.0
40;2021-03-20;706;15;46030;20727;11.2;5.0
40;2021-03-21;52;1;46082;20728;11.2;5.0
40;2021-03-22;1174;35;47256;20763;11.5;5.0
40;2021-03-23;2325;170;49581;20933;12.0;5.1
40;2021-03-24;2327;232;51908;21165;12.6;5.1
40;2021-03-25;2768;384;54676;21549;13.3;5.2
40;2021-03-26;3123;212;57799;21761;14.0;5.3
40;2021-03-27;923;49;58722;21810;14.3;5.3
40;2021-03-28;178;47;58900;21857;14.3;5.3
40;2021-03-29;1153;381;60053;22238;14.6;5.4
40;2021-03-30;2298;390;62351;22628;15.1;5.5
40;2021-03-31;1994;309;64345;22937;15.6;5.6
40;2021-04-01;2413;335;66758;23272;16.2;5.6
40;2021-04-02;2361;222;69119;23494;16.8;5.7
40;2021-04-03;741;122;69860;23616;17.0;5.7
40;2021-04-04;363;9;70223;23625;17.0;5.7
40;2021-04-05;523;40;70746;23665;17.2;5.7
40;2021-04-06;2095;809;72841;24474;17.7;5.9
40;2021-04-07;2664;876;75505;25350;18.3;6.2
40;2021-04-08;3063;901;78568;26251;19.1;6.4
40;2021-04-09;3826;611;82394;26862;20.0;6.5
40;2021-04-10;1600;343;83994;27205;20.4;6.6
40;2021-04-11;52;6;84046;27211;20.4;6.6
40;2021-04-12;2179;736;86225;27947;20.9;6.8
40;2021-04-13;2567;1092;88792;29039;21.6;7.0
40;2021-04-14;2571;1377;91363;30416;22.2;7.4
40;2021-04-15;2987;1516;94350;31932;22.9;7.8
40;2021-04-16;2878;1185;97228;33117;23.6;8.0
40;2021-04-17;1464;348;98692;33465;24.0;8.1
40;2021-04-18;57;24;98749;33489;24.0;8.1
40;2021-04-19;1056;1023;99805;34512;24.2;8.4
40;2021-04-20;1622;1745;101427;36257;24.6;8.8
40;2021-04-21;1777;1740;103204;37997;25.1;9.2
40;2021-04-22;2112;1776;105316;39773;25.6;9.7
40;2021-04-23;2163;1398;107479;41171;26.1;10.0
40;2021-04-24;1329;627;108808;41798;26.4;10.1
40;2021-04-25;37;57;108845;41855;26.4;10.2
40;2021-04-26;1251;1137;110096;42992;26.7;10.4
40;2021-04-27;1487;2033;111583;45025;27.1;10.9
40;2021-04-28;2052;1371;113635;46396;27.6;11.3
40;2021-04-29;2609;1901;116244;48297;28.2;11.7
40;2021-04-30;2700;1617;118944;49914;28.9;12.1
40;2021-05-01;1228;781;120172;50695;29.2;12.3
40;2021-05-02;143;323;120315;51018;29.2;12.4
40;2021-05-03;1857;1502;122172;52520;29.7;12.7
40;2021-05-04;1880;2467;124052;54987;30.1;13.3
40;2021-05-05;2187;2670;126239;57657;30.6;14.0
40;2021-05-06;2237;2867;128476;60524;31.2;14.7
40;2021-05-07;1901;3007;130377;63531;31.6;15.4
40;2021-05-08;675;469;131052;64000;31.8;15.5
40;2021-05-09;316;22;131368;64022;31.9;15.5
40;2021-05-10;1400;2057;132768;66079;32.2;16.0
40;2021-05-11;2196;2512;134964;68591;32.8;16.6
40;2021-05-12;2731;1945;137695;70536;33.4;17.1
40;2021-05-13;1984;515;139679;71051;33.9;17.2
40;2021-05-14;2324;1658;142003;72709;34.5;17.6
40;2021-05-15;1340;961;143343;73670;34.8;17.9
40;2021-05-16;434;24;143777;73694;34.9;17.9
40;2021-05-17;2119;1311;145896;75005;35.4;18.2
40;2021-05-18;2508;1416;148404;76421;36.0;18.5
40;2021-05-19;2954;1105;151358;77526;36.7;18.8
40;2021-05-20;3584;1163;154942;78689;37.6;19.1
40;2021-05-21;2925;1329;157867;80018;38.3;19.4
40;2021-05-22;1146;796;159013;80814;38.6;19.6
40;2021-05-23;631;29;159644;80843;38.8;19.6
40;2021-05-24;1212;332;160856;81175;39.0;19.7
40;2021-05-25;2168;1309;163024;82484;39.6;20.0
40;2021-05-26;2614;1563;165638;84047;40.2;20.4
40;2021-05-27;2733;2002;168371;86049;40.9;20.9
40;2021-05-28;2567;2275;170938;88324;41.5;21.4
40;2021-05-29;1558;1257;172496;89581;41.9;21.7
40;2021-05-30;4;52;172500;89633;41.9;21.8
40;2021-05-31;2567;1207;175067;90840;42.5;22.0
40;2021-06-01;3011;1770;178078;92610;43.2;22.5
40;2021-06-02;3170;1992;181248;94602;44.0;23.0
40;2021-06-03;3589;2330;184837;96932;44.9;23.5
40;2021-06-04;3015;2802;187852;99734;45.6;24.2
40;2021-06-05;1780;1395;189632;101129;46.0;24.5
40;2021-06-06;458;79;190090;101208;46.1;24.6
40;2021-06-07;2184;2024;192274;103232;46.7;25.1
40;2021-06-08;2954;2101;195228;105333;47.4;25.6
40;2021-06-09;3212;2266;198440;107599;48.2;26.1
40;2021-06-10;2994;2097;201434;109696;48.9;26.6
40;2021-06-11;3142;2799;204576;112495;49.7;27.3
40;2021-06-12;1963;1634;206539;114129;50.1;27.7
40;2021-06-13;645;162;207184;114291;50.3;27.7
40;2021-06-14;1457;2495;208641;116786;50.6;28.3
40;2021-06-15;2235;2818;210876;119604;51.2;29.0
40;2021-06-16;2608;2459;213484;122063;51.8;29.6
40;2021-06-17;2431;2439;215915;124502;52.4;30.2
40;2021-06-18;2326;2902;218241;127404;53.0;30.9
40;2021-06-19;1798;1229;220039;128633;53.4;31.2
40;2021-06-20;346;276;220385;128909;53.5;31.3
40;2021-06-21;1395;2318;221780;131227;53.8;31.9
40;2021-06-22;1690;2996;223470;134223;54.2;32.6
40;2021-06-23;1603;3343;225073;137566;54.6;33.4
40;2021-06-24;1733;2384;226806;139950;55.1;34.0
40;2021-06-25;1757;3264;228563;143214;55.5;34.8
40;2021-06-26;1328;1712;229891;144926;55.8;35.2
40;2021-06-27;262;354;230153;145280;55.9;35.3
40;2021-06-28;1334;2818;231487;148098;56.2;35.9
40;2021-06-29;1713;3392;233200;151490;56.6;36.8
40;2021-06-30;1773;3642;234973;155132;57.0;37.7
40;2021-07-01;1715;3954;236688;159086;57.5;38.6
40;2021-07-02;1560;3811;238248;162897;57.8;39.5
40;2021-07-03;676;1923;238924;164820;58.0;40.0
40;2021-07-04;219;483;239143;165303;58.0;40.1
40;2021-07-05;1477;3020;240620;168323;58.4;40.9
40;2021-07-06;1768;3613;242388;171936;58.8;41.7
40;2021-07-07;1973;3850;244361;175786;59.3;42.7
40;2021-07-08;2099;3409;246460;179195;59.8;43.5
40;2021-07-09;2108;3947;248568;183142;60.3;44.5
40;2021-07-10;1004;2155;249572;185297;60.6;45.0
40;2021-07-11;207;294;249779;185591;60.6;45.0
40;2021-07-12;1314;4047;251093;189638;60.9;46.0
40;2021-07-13;2428;4698;253521;194336;61.5;47.2
40;2021-07-14;2198;2060;255719;196396;62.1;47.7
40;2021-07-15;2842;4860;258561;201256;62.8;48.9
40;2021-07-16;3311;3944;261872;205200;63.6;49.8
40;2021-07-17;2110;2595;263982;207795;64.1;50.4
40;2021-07-18;472;542;264454;208337;64.2;50.6
40;2021-07-19;2565;3701;267019;212038;64.8;51.5
40;2021-07-20;3065;4052;270084;216090;65.6;52.5
40;2021-07-21;3204;3887;273288;219977;66.3;53.4
40;2021-07-22;3857;3933;277145;223910;67.3;54.3
40;2021-07-23;4092;4110;281237;228020;68.3;55.3
40;2021-07-24;2795;2113;284032;230133;68.9;55.9
40;2021-07-25;958;491;284990;230624;69.2;56.0
40;2021-07-26;2943;3076;287933;233700;69.9;56.7
40;2021-07-27;3526;3602;291459;237302;70.7;57.6
40;2021-07-28;3379;3398;294838;240700;71.6;58.4
40;2021-07-29;3546;3432;298384;244132;72.4;59.3
40;2021-07-30;3137;3405;301521;247537;73.2;60.1
40;2021-07-31;1781;1908;303302;249445;73.6;60.5
40;2021-08-01;342;287;303644;249732;73.7;60.6
40;2021-08-02;2004;2382;305648;252114;74.2;61.2
40;2021-08-03;2335;2697;307983;254811;74.8;61.9
40;2021-08-04;2094;2323;310077;257134;75.3;62.4
40;2021-08-05;1971;2669;312048;259803;75.7;63.1
40;2021-08-06;1886;3068;313934;262871;76.2;63.8
40;2021-08-07;1218;1746;315152;264617;76.5;64.2
40;2021-08-08;84;154;315236;264771;76.5;64.3
40;2021-08-09;1600;3124;316836;267895;76.9;65.0
40;2021-08-10;1429;3159;318265;271054;77.3;65.8
40;2021-08-11;1422;2844;319687;273898;77.6;66.5
40;2021-08-12;1277;3102;320964;277000;77.9;67.2
40;2021-08-13;1139;2980;322103;279980;78.2;68.0
40;2021-08-14;618;2033;322721;282013;78.3;68.5
40;2021-08-15;5;172;322726;282185;78.3;68.5
40;2021-08-16;1108;3382;323834;285567;78.6;69.3
40;2021-08-17;1161;3418;324995;288985;78.9;70.1
40;2021-08-18;989;3258;325984;292243;79.1;70.9
40;2021-08-19;855;2972;326839;295215;79.3;71.7
40;2021-08-20;811;3033;327650;298248;79.5;72.4
40;2021-08-21;523;1901;328173;300149;79.7;72.9
40;2021-08-22;71;464;328244;300613;79.7;73.0
40;2021-08-23;730;2818;328974;303431;79.9;73.7
40;2021-08-24;697;2540;329671;305971;80.0;74.3
40;2021-08-25;678;2002;330349;307973;80.2;74.8
40;2021-08-26;493;1674;330842;309647;80.3;75.2
40;2021-08-27;638;2468;331480;312115;80.5;75.8
40;2021-08-28;328;1215;331808;313330;80.5;76.1
40;2021-08-29;1;9;331809;313339;80.5;76.1
40;2021-08-30;600;2116;332409;315455;80.7;76.6
40;2021-08-31;470;1381;332879;316836;80.8;76.9
40;2021-09-01;451;1349;333330;318185;80.9;77.2
40;2021-09-02;404;1276;333734;319461;81.0;77.5
40;2021-09-03;445;1354;334179;320815;81.1;77.9
40;2021-09-04;369;1051;334548;321866;81.2;78.1
40;2021-09-05;4;10;334552;321876;81.2;78.1
40;2021-09-06;246;698;334798;322574;81.3;78.3
40;2021-09-07;294;774;335092;323348;81.3;78.5
40;2021-09-08;423;895;335515;324243;81.4;78.7
40;2021-09-09;264;718;335779;324961;81.5;78.9
40;2021-09-10;359;933;336138;325894;81.6;79.1
40;2021-09-11;248;755;336386;326649;81.7;79.3
40;2021-09-12;8;7;336394;326656;81.7;79.3
40;2021-09-13;469;596;336863;327252;81.8;79.4
40;2021-09-14;294;378;337157;327630;81.8;79.5
40;2021-09-15;444;896;337601;328526;81.9;79.7
40;2021-09-16;238;348;337839;328874;82.0;79.8
40;2021-09-17;368;788;338207;329662;82.1;80.0
40;2021-09-18;179;634;338386;330296;82.1;80.2
40;2021-09-19;0;9;338386;330305;82.1;80.2
40;2021-09-20;153;382;338539;330687;82.2;80.3
40;2021-09-21;149;287;338688;330974;82.2;80.3
40;2021-09-22;229;559;338917;331533;82.3;80.5
40;2021-09-23;164;298;339081;331831;82.3;80.5
40;2021-09-24;237;606;339318;332437;82.4;80.7
40;2021-09-25;134;427;339452;332864;82.4;80.8
40;2021-09-26;0;2;339452;332866;82.4;80.8
40;2021-09-27;86;224;339538;333090;82.4;80.9
40;2021-09-28;82;229;339620;333319;82.4;80.9
40;2021-09-29;206;585;339826;333904;82.5;81.0
40;2021-09-30;98;221;339924;334125;82.5;81.1
40;2021-10-01;225;437;340149;334562;82.6;81.2
40;2021-10-02;181;321;340330;334883;82.6;81.3
40;2021-10-03;0;2;340330;334885;82.6;81.3
40;2021-10-04;131;250;340461;335135;82.6;81.3
40;2021-10-05;74;200;340535;335335;82.7;81.4
40;2021-10-06;252;458;340787;335793;82.7;81.5
40;2021-10-07;97;196;340884;335989;82.7;81.6
40;2021-10-08;167;449;341051;336438;82.8;81.7
40;2021-10-09;140;212;341191;336650;82.8;81.7
40;2021-10-10;2;8;341193;336658;82.8;81.7
40;2021-10-11;67;255;341260;336913;82.8;81.8
41;2020-12-27;0;0;0;0;0.0;0.0
41;2020-12-28;0;0;0;0;0.0;0.0
41;2020-12-29;0;0;0;0;0.0;0.0
41;2020-12-30;0;0;0;0;0.0;0.0
41;2020-12-31;0;0;0;0;0.0;0.0
41;2021-01-01;0;0;0;0;0.0;0.0
41;2021-01-02;2;0;2;0;0.0;0.0
41;2021-01-03;0;0;2;0;0.0;0.0
41;2021-01-04;0;0;2;0;0.0;0.0
41;2021-01-05;35;0;37;0;0.0;0.0
41;2021-01-06;71;0;108;0;0.0;0.0
41;2021-01-07;21;0;129;0;0.0;0.0
41;2021-01-08;1;0;130;0;0.0;0.0
41;2021-01-09;0;0;130;0;0.0;0.0
41;2021-01-10;0;0;130;0;0.0;0.0
41;2021-01-11;133;0;263;0;0.1;0.0
41;2021-01-12;321;1;584;1;0.2;0.0
41;2021-01-13;271;0;855;1;0.3;0.0
41;2021-01-14;284;2;1139;3;0.3;0.0
41;2021-01-15;215;1;1354;4;0.4;0.0
41;2021-01-16;0;0;1354;4;0.4;0.0
41;2021-01-17;0;0;1354;4;0.4;0.0
41;2021-01-18;397;2;1751;6;0.5;0.0
41;2021-01-19;857;2;2608;8;0.8;0.0
41;2021-01-20;1059;5;3667;13;1.1;0.0
41;2021-01-21;1568;9;5235;22;1.6;0.0
41;2021-01-22;839;1;6074;23;1.9;0.0
41;2021-01-23;92;0;6166;23;1.9;0.0
41;2021-01-24;0;0;6166;23;1.9;0.0
41;2021-01-25;421;1;6587;24;2.0;0.0
41;2021-01-26;473;4;7060;28;2.2;0.0
41;2021-01-27;441;2;7501;30;2.3;0.0
41;2021-01-28;604;56;8105;86;2.5;0.0
41;2021-01-29;260;30;8365;116;2.6;0.0
41;2021-01-30;0;0;8365;116;2.6;0.0
41;2021-01-31;0;0;8365;116;2.6;0.0
41;2021-02-01;349;148;8714;264;2.7;0.1
41;2021-02-02;470;230;9184;494;2.8;0.2
41;2021-02-03;342;203;9526;697;2.9;0.2
41;2021-02-04;559;154;10085;851;3.1;0.3
41;2021-02-05;329;188;10414;1039;3.2;0.3
41;2021-02-06;5;0;10419;1039;3.2;0.3
41;2021-02-07;2;0;10421;1039;3.2;0.3
41;2021-02-08;305;306;10726;1345;3.3;0.4
41;2021-02-09;599;454;11325;1799;3.5;0.5
41;2021-02-10;486;695;11811;2494;3.6;0.8
41;2021-02-11;1067;1159;12878;3653;3.9;1.1
41;2021-02-12;688;361;13566;4014;4.1;1.2
41;2021-02-13;9;5;13575;4019;4.1;1.2
41;2021-02-14;3;27;13578;4046;4.1;1.2
41;2021-02-15;314;306;13892;4352;4.2;1.3
41;2021-02-16;354;567;14246;4919;4.3;1.5
41;2021-02-17;317;457;14563;5376;4.4;1.6
41;2021-02-18;617;326;15180;5702;4.6;1.7
41;2021-02-19;456;337;15636;6039;4.8;1.8
41;2021-02-20;68;58;15704;6097;4.8;1.9
41;2021-02-21;0;0;15704;6097;4.8;1.9
41;2021-02-22;311;414;16015;6511;4.9;2.0
41;2021-02-23;454;346;16469;6857;5.0;2.1
41;2021-02-24;284;442;16753;7299;5.1;2.2
41;2021-02-25;675;461;17428;7760;5.3;2.4
41;2021-02-26;630;253;18058;8013;5.5;2.4
41;2021-02-27;161;4;18219;8017;5.6;2.4
41;2021-02-28;4;31;18223;8048;5.6;2.5
41;2021-03-01;311;315;18534;8363;5.7;2.6
41;2021-03-02;649;410;19183;8773;5.9;2.7
41;2021-03-03;496;411;19679;9184;6.0;2.8
41;2021-03-04;785;840;20464;10024;6.2;3.1
41;2021-03-05;840;675;21304;10699;6.5;3.3
41;2021-03-06;715;23;22019;10722;6.7;3.3
41;2021-03-07;498;20;22517;10742;6.9;3.3
41;2021-03-08;301;376;22818;11118;7.0;3.4
41;2021-03-09;1043;452;23861;11570;7.3;3.5
41;2021-03-10;721;457;24582;12027;7.5;3.7
41;2021-03-11;1184;686;25766;12713;7.9;3.9
41;2021-03-12;1115;415;26881;13128;8.2;4.0
41;2021-03-13;1224;20;28105;13148;8.6;4.0
41;2021-03-14;392;7;28497;13155;8.7;4.0
41;2021-03-15;798;353;29295;13508;8.9;4.1
41;2021-03-16;1061;412;30356;13920;9.3;4.2
41;2021-03-17;586;240;30942;14160;9.4;4.3
41;2021-03-18;926;399;31868;14559;9.7;4.4
41;2021-03-19;911;335;32779;14894;10.0;4.5
41;2021-03-20;543;22;33322;14916;10.2;4.5
41;2021-03-21;1;0;33323;14916;10.2;4.5
41;2021-03-22;810;275;34133;15191;10.4;4.6
41;2021-03-23;1309;495;35442;15686;10.8;4.8
41;2021-03-24;1231;367;36673;16053;11.2;4.9
41;2021-03-25;2026;439;38699;16492;11.8;5.0
41;2021-03-26;1655;327;40354;16819;12.3;5.1
41;2021-03-27;451;58;40805;16877;12.4;5.1
41;2021-03-28;1;0;40806;16877;12.4;5.1
41;2021-03-29;939;310;41745;17187;12.7;5.2
41;2021-03-30;1496;599;43241;17786;13.2;5.4
41;2021-03-31;1148;497;44389;18283;13.5;5.6
41;2021-04-01;2252;568;46641;18851;14.2;5.8
41;2021-04-02;1242;475;47883;19326;14.6;5.9
41;2021-04-03;321;5;48204;19331;14.7;5.9
41;2021-04-04;39;0;48243;19331;14.7;5.9
41;2021-04-05;140;2;48383;19333;14.8;5.9
41;2021-04-06;1301;626;49684;19959;15.2;6.1
41;2021-04-07;1852;711;51536;20670;15.7;6.3
41;2021-04-08;2294;920;53830;21590;16.4;6.6
41;2021-04-09;2568;613;56398;22203;17.2;6.8
41;2021-04-10;954;498;57352;22701;17.5;6.9
41;2021-04-11;279;376;57631;23077;17.6;7.0
41;2021-04-12;1689;659;59320;23736;18.1;7.2
41;2021-04-13;2259;988;61579;24724;18.8;7.5
41;2021-04-14;1794;554;63373;25278;19.3;7.7
41;2021-04-15;2384;980;65757;26258;20.1;8.0
41;2021-04-16;1929;628;67686;26886;20.6;8.2
41;2021-04-17;647;138;68333;27024;20.8;8.2
41;2021-04-18;5;0;68338;27024;20.8;8.2
41;2021-04-19;1260;745;69598;27769;21.2;8.5
41;2021-04-20;2004;1203;71602;28972;21.8;8.8
41;2021-04-21;1503;920;73105;29892;22.3;9.1
41;2021-04-22;2236;1604;75341;31496;23.0;9.6
41;2021-04-23;1736;1080;77077;32576;23.5;9.9
41;2021-04-24;1544;283;78621;32859;24.0;10.0
41;2021-04-25;1007;21;79628;32880;24.3;10.0
41;2021-04-26;1355;625;80983;33505;24.7;10.2
41;2021-04-27;2093;1041;83076;34546;25.3;10.5
41;2021-04-28;1562;864;84638;35410;25.8;10.8
41;2021-04-29;2210;1380;86848;36790;26.5;11.2
41;2021-04-30;1963;878;88811;37668;27.1;11.5
41;2021-05-01;189;12;89000;37680;27.1;11.5
41;2021-05-02;107;17;89107;37697;27.2;11.5
41;2021-05-03;1864;896;90971;38593;27.7;11.8
41;2021-05-04;2092;1543;93063;40136;28.4;12.2
41;2021-05-05;1882;1193;94945;41329;29.0;12.6
41;2021-05-06;2447;1695;97392;43024;29.7;13.1
41;2021-05-07;2016;1805;99408;44829;30.3;13.7
41;2021-05-08;202;154;99610;44983;30.4;13.7
41;2021-05-09;11;354;99621;45337;30.4;13.8
41;2021-05-10;1590;1558;101211;46895;30.9;14.3
41;2021-05-11;2085;2102;103296;48997;31.5;14.9
41;2021-05-12;1951;1678;105247;50675;32.1;15.5
41;2021-05-13;1485;949;106732;51624;32.6;15.7
41;2021-05-14;1576;1305;108308;52929;33.0;16.1
41;2021-05-15;206;295;108514;53224;33.1;16.2
41;2021-05-16;4;0;108518;53224;33.1;16.2
41;2021-05-17;2484;564;111002;53788;33.9;16.4
41;2021-05-18;3138;1032;114140;54820;34.8;16.7
41;2021-05-19;2553;675;116693;55495;35.6;16.9
41;2021-05-20;3349;1152;120042;56647;36.6;17.3
41;2021-05-21;2727;968;122769;57615;37.4;17.6
41;2021-05-22;396;237;123165;57852;37.6;17.6
41;2021-05-23;6;2;123171;57854;37.6;17.6
41;2021-05-24;2605;150;125776;58004;38.4;17.7
41;2021-05-25;2991;577;128767;58581;39.3;17.9
41;2021-05-26;3037;652;131804;59233;40.2;18.1
41;2021-05-27;3294;1111;135098;60344;41.2;18.4
41;2021-05-28;3144;979;138242;61323;42.2;18.7
41;2021-05-29;2073;429;140315;61752;42.8;18.8
41;2021-05-30;344;22;140659;61774;42.9;18.8
41;2021-05-31;1710;1505;142369;63279;43.4;19.3
41;2021-06-01;2263;2012;144632;65291;44.1;19.9
41;2021-06-02;1832;1289;146464;66580;44.7;20.3
41;2021-06-03;2597;1942;149061;68522;45.5;20.9
41;2021-06-04;2303;1967;151364;70489;46.2;21.5
41;2021-06-05;611;1583;151975;72072;46.4;22.0
41;2021-06-06;109;927;152084;72999;46.4;22.3
41;2021-06-07;1515;1530;153599;74529;46.9;22.7
41;2021-06-08;1712;2413;155311;76942;47.4;23.5
41;2021-06-09;1615;1641;156926;78583;47.9;24.0
41;2021-06-10;1917;1819;158843;80402;48.5;24.5
41;2021-06-11;1572;1794;160415;82196;48.9;25.1
41;2021-06-12;664;649;161079;82845;49.1;25.3
41;2021-06-13;13;77;161092;82922;49.1;25.3
41;2021-06-14;1269;1963;162361;84885;49.5;25.9
41;2021-06-15;1834;2761;164195;87646;50.1;26.7
41;2021-06-16;1724;2309;165919;89955;50.6;27.4
41;2021-06-17;1810;2574;167729;92529;51.2;28.2
41;2021-06-18;1662;2400;169391;94929;51.7;29.0
41;2021-06-19;412;531;169803;95460;51.8;29.1
41;2021-06-20;11;32;169814;95492;51.8;29.1
41;2021-06-21;1325;1779;171139;97271;52.2;29.7
41;2021-06-22;1619;2563;172758;99834;52.7;30.5
41;2021-06-23;1375;2045;174133;101879;53.1;31.1
41;2021-06-24;1483;2308;175616;104187;53.6;31.8
41;2021-06-25;1294;2617;176910;106804;54.0;32.6
41;2021-06-26;433;614;177343;107418;54.1;32.8
41;2021-06-27;1;4;177344;107422;54.1;32.8
41;2021-06-28;404;2696;177748;110118;54.2;33.6
41;2021-06-29;664;3442;178412;113560;54.4;34.6
41;2021-06-30;552;3068;178964;116628;54.6;35.6
41;2021-07-01;765;3106;179729;119734;54.8;36.5
41;2021-07-02;589;3501;180318;123235;55.0;37.6
41;2021-07-03;158;647;180476;123882;55.1;37.8
41;2021-07-04;2;2;180478;123884;55.1;37.8
41;2021-07-05;284;2818;180762;126702;55.1;38.6
41;2021-07-06;666;3634;181428;130336;55.3;39.8
41;2021-07-07;479;3137;181907;133473;55.5;40.7
41;2021-07-08;940;3366;182847;136839;55.8;41.7
41;2021-07-09;540;3641;183387;140480;55.9;42.9
41;2021-07-10;247;2088;183634;142568;56.0;43.5
41;2021-07-11;5;280;183639;142848;56.0;43.6
41;2021-07-12;861;2291;184500;145139;56.3;44.3
41;2021-07-13;1198;3285;185698;148424;56.6;45.3
41;2021-07-14;141;1080;185839;149504;56.7;45.6
41;2021-07-15;1333;3320;187172;152824;57.1;46.6
41;2021-07-16;1091;3389;188263;156213;57.4;47.6
41;2021-07-17;344;807;188607;157020;57.5;47.9
41;2021-07-18;24;32;188631;157052;57.5;47.9
41;2021-07-19;1191;2319;189822;159371;57.9;48.6
41;2021-07-20;1643;2744;191465;162115;58.4;49.5
41;2021-07-21;1709;2086;193174;164201;58.9;50.1
41;2021-07-22;2263;2300;195437;166501;59.6;50.8
41;2021-07-23;2104;2468;197541;168969;60.3;51.5
41;2021-07-24;329;842;197870;169811;60.4;51.8
41;2021-07-25;19;23;197889;169834;60.4;51.8
41;2021-07-26;1902;1679;199791;171513;60.9;52.3
41;2021-07-27;2534;2345;202325;173858;61.7;53.0
41;2021-07-28;2161;1831;204486;175689;62.4;53.6
41;2021-07-29;2345;2027;206831;177716;63.1;54.2
41;2021-07-30;2151;2084;208982;179800;63.7;54.8
41;2021-07-31;380;581;209362;180381;63.9;55.0
41;2021-08-01;21;7;209383;180388;63.9;55.0
41;2021-08-02;1550;1605;210933;181993;64.3;55.5
41;2021-08-03;2517;1857;213450;183850;65.1;56.1
41;2021-08-04;2302;1199;215752;185049;65.8;56.4
41;2021-08-05;3047;1266;218799;186315;66.7;56.8
41;2021-08-06;2214;1305;221013;187620;67.4;57.2
41;2021-08-07;511;347;221524;187967;67.6;57.3
41;2021-08-08;13;20;221537;187987;67.6;57.3
41;2021-08-09;1689;1357;223226;189344;68.1;57.8
41;2021-08-10;2563;1423;225789;190767;68.9;58.2
41;2021-08-11;1593;1440;227382;192207;69.4;58.6
41;2021-08-12;1942;1339;229324;193546;70.0;59.0
41;2021-08-13;1474;1697;230798;195243;70.4;59.6
41;2021-08-14;364;209;231162;195452;70.5;59.6
41;2021-08-15;0;16;231162;195468;70.5;59.6
41;2021-08-16;864;2069;232026;197537;70.8;60.3
41;2021-08-17;1498;1634;233524;199171;71.2;60.8
41;2021-08-18;1135;1971;234659;201142;71.6;61.4
41;2021-08-19;1311;1554;235970;202696;72.0;61.8
41;2021-08-20;915;2313;236885;205009;72.3;62.5
41;2021-08-21;120;227;237005;205236;72.3;62.6
41;2021-08-22;1;32;237006;205268;72.3;62.6
41;2021-08-23;694;2295;237700;207563;72.5;63.3
41;2021-08-24;1415;2313;239115;209876;72.9;64.0
41;2021-08-25;620;2200;239735;212076;73.1;64.7
41;2021-08-26;843;2821;240578;214897;73.4;65.6
41;2021-08-27;621;2763;241199;217660;73.6;66.4
41;2021-08-28;99;622;241298;218282;73.6;66.6
41;2021-08-29;46;24;241344;218306;73.6;66.6
41;2021-08-30;668;2114;242012;220420;73.8;67.2
41;2021-08-31;765;2556;242777;222976;74.1;68.0
41;2021-09-01;501;1711;243278;224687;74.2;68.5
41;2021-09-02;628;2011;243906;226698;74.4;69.2
41;2021-09-03;650;2101;244556;228799;74.6;69.8
41;2021-09-04;194;555;244750;229354;74.7;70.0
41;2021-09-05;3;0;244753;229354;74.7;70.0
41;2021-09-06;291;958;245044;230312;74.7;70.3
41;2021-09-07;415;1195;245459;231507;74.9;70.6
41;2021-09-08;314;1171;245773;232678;75.0;71.0
41;2021-09-09;295;1164;246068;233842;75.1;71.3
41;2021-09-10;381;1197;246449;235039;75.2;71.7
41;2021-09-11;85;366;246534;235405;75.2;71.8
41;2021-09-12;0;9;246534;235414;75.2;71.8
41;2021-09-13;200;646;246734;236060;75.3;72.0
41;2021-09-14;364;826;247098;236886;75.4;72.3
41;2021-09-15;279;1070;247377;237956;75.5;72.6
41;2021-09-16;236;833;247613;238789;75.5;72.8
41;2021-09-17;360;713;247973;239502;75.6;73.1
41;2021-09-18;78;169;248051;239671;75.7;73.1
41;2021-09-19;0;7;248051;239678;75.7;73.1
41;2021-09-20;177;514;248228;240192;75.7;73.3
41;2021-09-21;181;515;248409;240707;75.8;73.4
41;2021-09-22;268;802;248677;241509;75.9;73.7
41;2021-09-23;237;662;248914;242171;75.9;73.9
41;2021-09-24;313;630;249227;242801;76.0;74.1
41;2021-09-25;70;233;249297;243034;76.0;74.1
41;2021-09-26;0;3;249297;243037;76.0;74.1
41;2021-09-27;165;342;249462;243379;76.1;74.2
41;2021-09-28;156;421;249618;243800;76.1;74.4
41;2021-09-29;178;490;249796;244290;76.2;74.5
41;2021-09-30;112;337;249908;244627;76.2;74.6
41;2021-10-01;210;390;250118;245017;76.3;74.7
41;2021-10-02;80;140;250198;245157;76.3;74.8
41;2021-10-03;0;0;250198;245157;76.3;74.8
41;2021-10-04;106;264;250304;245421;76.4;74.9
41;2021-10-05;117;297;250421;245718;76.4;75.0
41;2021-10-06;224;412;250645;246130;76.5;75.1
41;2021-10-07;120;176;250765;246306;76.5;75.1
41;2021-10-08;198;510;250963;246816;76.6;75.3
41;2021-10-09;51;119;251014;246935;76.6;75.3
41;2021-10-10;0;18;251014;246953;76.6;75.3
41;2021-10-11;118;170;251132;247123;76.6;75.4
42;2020-12-27;1;0;1;0;0.0;0.0
42;2020-12-28;0;0;1;0;0.0;0.0
42;2020-12-29;0;0;1;0;0.0;0.0
42;2020-12-30;0;0;1;0;0.0;0.0
42;2020-12-31;0;0;1;0;0.0;0.0
42;2021-01-01;0;0;1;0;0.0;0.0
42;2021-01-02;0;0;1;0;0.0;0.0
42;2021-01-03;0;0;1;0;0.0;0.0
42;2021-01-04;1;0;2;0;0.0;0.0
42;2021-01-05;1;0;3;0;0.0;0.0
42;2021-01-06;178;1;181;1;0.0;0.0
42;2021-01-07;256;0;437;1;0.1;0.0
42;2021-01-08;264;5;701;6;0.1;0.0
42;2021-01-09;136;1;837;7;0.1;0.0
42;2021-01-10;0;0;837;7;0.1;0.0
42;2021-01-11;293;2;1130;9;0.1;0.0
42;2021-01-12;412;1;1542;10;0.2;0.0
42;2021-01-13;527;2;2069;12;0.3;0.0
42;2021-01-14;775;4;2844;16;0.4;0.0
42;2021-01-15;707;4;3551;20;0.5;0.0
42;2021-01-16;298;2;3849;22;0.5;0.0
42;2021-01-17;219;0;4068;22;0.5;0.0
42;2021-01-18;967;1;5035;23;0.7;0.0
42;2021-01-19;1329;10;6364;33;0.8;0.0
42;2021-01-20;956;4;7320;37;1.0;0.0
42;2021-01-21;1023;6;8343;43;1.1;0.0
42;2021-01-22;992;7;9335;50;1.2;0.0
42;2021-01-23;401;0;9736;50;1.3;0.0
42;2021-01-24;359;0;10095;50;1.3;0.0
42;2021-01-25;1100;13;11195;63;1.5;0.0
42;2021-01-26;1750;21;12945;84;1.7;0.0
42;2021-01-27;1456;126;14401;210;1.9;0.0
42;2021-01-28;1667;146;16068;356;2.1;0.0
42;2021-01-29;946;120;17014;476;2.2;0.1
42;2021-01-30;257;110;17271;586;2.3;0.1
42;2021-01-31;258;2;17529;588;2.3;0.1
42;2021-02-01;738;63;18267;651;2.4;0.1
42;2021-02-02;1854;322;20121;973;2.6;0.1
42;2021-02-03;1518;492;21639;1465;2.8;0.2
42;2021-02-04;1279;616;22918;2081;3.0;0.3
42;2021-02-05;684;528;23602;2609;3.1;0.3
42;2021-02-06;304;151;23906;2760;3.1;0.4
42;2021-02-07;276;154;24182;2914;3.2;0.4
42;2021-02-08;506;615;24688;3529;3.2;0.5
42;2021-02-09;703;798;25391;4327;3.3;0.6
42;2021-02-10;742;689;26133;5016;3.4;0.7
42;2021-02-11;773;688;26906;5704;3.5;0.7
42;2021-02-12;675;754;27581;6458;3.6;0.8
42;2021-02-13;428;304;28009;6762;3.7;0.9
42;2021-02-14;186;221;28195;6983;3.7;0.9
42;2021-02-15;520;820;28715;7803;3.8;1.0
42;2021-02-16;490;1240;29205;9043;3.8;1.2
42;2021-02-17;518;1531;29723;10574;3.9;1.4
42;2021-02-18;757;1388;30480;11962;4.0;1.6
42;2021-02-19;768;1023;31248;12985;4.1;1.7
42;2021-02-20;248;424;31496;13409;4.1;1.8
42;2021-02-21;63;327;31559;13736;4.1;1.8
42;2021-02-22;574;961;32133;14697;4.2;1.9
42;2021-02-23;1211;1440;33344;16137;4.4;2.1
42;2021-02-24;1244;1221;34588;17358;4.5;2.3
42;2021-02-25;1667;1420;36255;18778;4.7;2.5
42;2021-02-26;1646;927;37901;19705;5.0;2.6
42;2021-02-27;580;297;38481;20002;5.0;2.6
42;2021-02-28;167;127;38648;20129;5.1;2.6
42;2021-03-01;807;847;39455;20976;5.2;2.7
42;2021-03-02;1275;822;40730;21798;5.3;2.9
42;2021-03-03;1368;811;42098;22609;5.5;3.0
42;2021-03-04;1705;729;43803;23338;5.7;3.1
42;2021-03-05;2623;679;46426;24017;6.1;3.1
42;2021-03-06;1933;276;48359;24293;6.3;3.2
42;2021-03-07;1491;97;49850;24390;6.5;3.2
42;2021-03-08;1405;518;51255;24908;6.7;3.3
42;2021-03-09;1983;464;53238;25372;7.0;3.3
42;2021-03-10;2053;514;55291;25886;7.2;3.4
42;2021-03-11;3048;641;58339;26527;7.6;3.5
42;2021-03-12;3008;837;61347;27364;8.0;3.6
42;2021-03-13;1479;374;62826;27738;8.2;3.6
42;2021-03-14;472;178;63298;27916;8.3;3.7
42;2021-03-15;1572;609;64870;28525;8.5;3.7
42;2021-03-16;1472;783;66342;29308;8.7;3.8
42;2021-03-17;1723;1085;68065;30393;8.9;4.0
42;2021-03-18;1803;1033;69868;31426;9.1;4.1
42;2021-03-19;2566;691;72434;32117;9.5;4.2
42;2021-03-20;1672;235;74106;32352;9.7;4.2
42;2021-03-21;526;102;74632;32454;9.8;4.2
42;2021-03-22;1426;747;76058;33201;9.9;4.3
42;2021-03-23;2507;875;78565;34076;10.3;4.5
42;2021-03-24;2783;797;81348;34873;10.6;4.6
42;2021-03-25;3720;944;85068;35817;11.1;4.7
42;2021-03-26;3759;793;88827;36610;11.6;4.8
42;2021-03-27;1806;454;90633;37064;11.9;4.8
42;2021-03-28;1039;217;91672;37281;12.0;4.9
42;2021-03-29;2064;933;93736;38214;12.3;5.0
42;2021-03-30;3146;880;96882;39094;12.7;5.1
42;2021-03-31;2444;1084;99326;40178;13.0;5.3
42;2021-04-01;3391;1060;102717;41238;13.4;5.4
42;2021-04-02;2849;1236;105566;42474;13.8;5.6
42;2021-04-03;1418;612;106984;43086;14.0;5.6
42;2021-04-04;1403;397;108387;43483;14.2;5.7
42;2021-04-05;1901;304;110288;43787;14.4;5.7
42;2021-04-06;2292;1420;112580;45207;14.7;5.9
42;2021-04-07;2761;1845;115341;47052;15.1;6.2
42;2021-04-08;4025;1606;119366;48658;15.6;6.4
42;2021-04-09;5134;1569;124500;50227;16.3;6.6
42;2021-04-10;2591;777;127091;51004;16.6;6.7
42;2021-04-11;1957;434;129048;51438;16.9;6.7
42;2021-04-12;3699;1555;132747;52993;17.4;6.9
42;2021-04-13;4659;1816;137406;54809;18.0;7.2
42;2021-04-14;4308;1913;141714;56722;18.5;7.4
42;2021-04-15;4809;1849;146523;58571;19.2;7.7
42;2021-04-16;4621;1899;151144;60470;19.8;7.9
42;2021-04-17;2982;1079;154126;61549;20.2;8.0
42;2021-04-18;1887;417;156013;61966;20.4;8.1
42;2021-04-19;3090;1544;159103;63510;20.8;8.3
42;2021-04-20;3468;1962;162571;65472;21.3;8.6
42;2021-04-21;3479;1754;166050;67226;21.7;8.8
42;2021-04-22;3768;1959;169818;69185;22.2;9.0
42;2021-04-23;3842;2024;173660;71209;22.7;9.3
42;2021-04-24;2363;1520;176023;72729;23.0;9.5
42;2021-04-25;1658;949;177681;73678;23.2;9.6
42;2021-04-26;3280;1740;180961;75418;23.7;9.9
42;2021-04-27;3253;2217;184214;77635;24.1;10.2
42;2021-04-28;3463;2629;187677;80264;24.5;10.5
42;2021-04-29;3768;2822;191445;83086;25.0;10.9
42;2021-04-30;3360;3037;194805;86123;25.5;11.3
42;2021-05-01;2968;1055;197773;87178;25.9;11.4
42;2021-05-02;1934;1264;199707;88442;26.1;11.6
42;2021-05-03;2868;2771;202575;91213;26.5;11.9
42;2021-05-04;3416;3136;205991;94349;26.9;12.3
42;2021-05-05;3328;3405;209319;97754;27.4;12.8
42;2021-05-06;3888;3776;213207;101530;27.9;13.3
42;2021-05-07;3732;4044;216939;105574;28.4;13.8
42;2021-05-08;3164;1075;220103;106649;28.8;13.9
42;2021-05-09;1505;2213;221608;108862;29.0;14.2
42;2021-05-10;3250;3831;224858;112693;29.4;14.7
42;2021-05-11;5574;3917;230432;116610;30.1;15.2
42;2021-05-12;5339;3571;235771;120181;30.8;15.7
42;2021-05-13;5451;1152;241222;121333;31.5;15.9
42;2021-05-14;5237;2928;246459;124261;32.2;16.2
42;2021-05-15;4880;2127;251339;126388;32.9;16.5
42;2021-05-16;2873;1036;254212;127424;33.2;16.7
42;2021-05-17;5885;2840;260097;130264;34.0;17.0
42;2021-05-18;6251;2983;266348;133247;34.8;17.4
42;2021-05-19;6523;2752;272871;135999;35.7;17.8
42;2021-05-20;7103;2898;279974;138897;36.6;18.2
42;2021-05-21;6351;3276;286325;142173;37.4;18.6
42;2021-05-22;5834;2134;292159;144307;38.2;18.9
42;2021-05-23;2832;874;294991;145181;38.6;19.0
42;2021-05-24;5246;1434;300237;146615;39.3;19.2
42;2021-05-25;5152;3941;305389;150556;39.9;19.7
42;2021-05-26;5160;3459;310549;154015;40.6;20.1
42;2021-05-27;5366;3639;315915;157654;41.3;20.6
42;2021-05-28;5044;4208;320959;161862;42.0;21.2
42;2021-05-29;4340;2988;325299;164850;42.5;21.6
42;2021-05-30;1983;1210;327282;166060;42.8;21.7
42;2021-05-31;4241;3424;331523;169484;43.4;22.2
42;2021-06-01;4592;3570;336115;173054;44.0;22.6
42;2021-06-02;4481;3017;340596;176071;44.5;23.0
42;2021-06-03;4930;3844;345526;179915;45.2;23.5
42;2021-06-04;4766;4218;350292;184133;45.8;24.1
42;2021-06-05;3689;2427;353981;186560;46.3;24.4
42;2021-06-06;1445;1295;355426;187855;46.5;24.6
42;2021-06-07;3992;3377;359418;191232;47.0;25.0
42;2021-06-08;3466;3248;362884;194480;47.5;25.4
42;2021-06-09;2964;3206;365848;197686;47.8;25.9
42;2021-06-10;3242;2934;369090;200620;48.3;26.2
42;2021-06-11;3585;4118;372675;204738;48.7;26.8
42;2021-06-12;2863;2882;375538;207620;49.1;27.1
42;2021-06-13;944;1278;376482;208898;49.2;27.3
42;2021-06-14;2313;4062;378795;212960;49.5;27.8
42;2021-06-15;2830;4070;381625;217030;49.9;28.4
42;2021-06-16;2919;3552;384544;220582;50.3;28.8
42;2021-06-17;2635;3738;387179;224320;50.6;29.3
42;2021-06-18;3093;5146;390272;229466;51.0;30.0
42;2021-06-19;2845;4243;393117;233709;51.4;30.6
42;2021-06-20;857;1844;393974;235553;51.5;30.8
42;2021-06-21;1909;6277;395883;241830;51.8;31.6
42;2021-06-22;1875;5891;397758;247721;52.0;32.4
42;2021-06-23;1845;5321;399603;253042;52.3;33.1
42;2021-06-24;1785;4683;401388;257725;52.5;33.7
42;2021-06-25;2036;6952;403424;264677;52.8;34.6
42;2021-06-26;1408;5818;404832;270495;52.9;35.4
42;2021-06-27;756;2858;405588;273353;53.0;35.7
42;2021-06-28;1746;7063;407334;280416;53.3;36.7
42;2021-06-29;1526;6566;408860;286982;53.5;37.5
42;2021-06-30;1969;5766;410829;292748;53.7;38.3
42;2021-07-01;1779;5120;412608;297868;54.0;39.0
42;2021-07-02;2048;6740;414656;304608;54.2;39.8
42;2021-07-03;1760;5979;416416;310587;54.5;40.6
42;2021-07-04;853;2514;417269;313101;54.6;40.9
42;2021-07-05;1716;6289;418985;319390;54.8;41.8
42;2021-07-06;2106;5576;421091;324966;55.1;42.5
42;2021-07-07;2338;4657;423429;329623;55.4;43.1
42;2021-07-08;2272;3958;425701;333581;55.7;43.6
42;2021-07-09;2416;6096;428117;339677;56.0;44.4
42;2021-07-10;1693;5581;429810;345258;56.2;45.1
42;2021-07-11;921;2304;430731;347562;56.3;45.4
42;2021-07-12;1776;6290;432507;353852;56.6;46.3
42;2021-07-13;3610;6290;436117;360142;57.0;47.1
42;2021-07-14;4480;2055;440597;362197;57.6;47.4
42;2021-07-15;4558;5630;445155;367827;58.2;48.1
42;2021-07-16;4442;6198;449597;374025;58.8;48.9
42;2021-07-17;3219;4710;452816;378735;59.2;49.5
42;2021-07-18;1838;1743;454654;380478;59.5;49.8
42;2021-07-19;3806;5073;458460;385551;60.0;50.4
42;2021-07-20;4719;4821;463179;390372;60.6;51.0
42;2021-07-21;5176;4720;468355;395092;61.2;51.7
42;2021-07-22;5501;3939;473856;399031;62.0;52.2
42;2021-07-23;5500;5120;479356;404151;62.7;52.8
42;2021-07-24;4038;3834;483394;407985;63.2;53.3
42;2021-07-25;1656;1391;485050;409376;63.4;53.5
42;2021-07-26;4731;4314;489781;413690;64.0;54.1
42;2021-07-27;5333;3958;495114;417648;64.7;54.6
42;2021-07-28;5782;3676;500896;421324;65.5;55.1
42;2021-07-29;5678;3435;506574;424759;66.2;55.5
42;2021-07-30;5141;3776;511715;428535;66.9;56.0
42;2021-07-31;4765;3057;516480;431592;67.5;56.4
42;2021-08-01;2498;1318;518978;432910;67.9;56.6
42;2021-08-02;4367;3106;523345;436016;68.4;57.0
42;2021-08-03;3826;3285;527171;439301;68.9;57.4
42;2021-08-04;3473;3224;530644;442525;69.4;57.9
42;2021-08-05;3402;3315;534046;445840;69.8;58.3
42;2021-08-06;3640;3995;537686;449835;70.3;58.8
42;2021-08-07;3022;3067;540708;452902;70.7;59.2
42;2021-08-08;1200;1717;541908;454619;70.9;59.4
42;2021-08-09;2808;3860;544716;458479;71.2;60.0
42;2021-08-10;3275;3909;547991;462388;71.7;60.5
42;2021-08-11;2593;3521;550584;465909;72.0;60.9
42;2021-08-12;2517;3569;553101;469478;72.3;61.4
42;2021-08-13;2334;3908;555435;473386;72.6;61.9
42;2021-08-14;1652;3269;557087;476655;72.8;62.3
42;2021-08-15;600;1027;557687;477682;72.9;62.5
42;2021-08-16;2077;4572;559764;482254;73.2;63.1
42;2021-08-17;2246;4175;562010;486429;73.5;63.6
42;2021-08-18;2053;4146;564063;490575;73.8;64.1
42;2021-08-19;1931;3369;565994;493944;74.0;64.6
42;2021-08-20;2270;4612;568264;498556;74.3;65.2
42;2021-08-21;1083;3866;569347;502422;74.5;65.7
42;2021-08-22;501;2020;569848;504442;74.5;66.0
42;2021-08-23;1625;4668;571473;509110;74.7;66.6
42;2021-08-24;1748;4044;573221;513154;75.0;67.1
42;2021-08-25;1748;3899;574969;517053;75.2;67.6
42;2021-08-26;1445;3048;576414;520101;75.4;68.0
42;2021-08-27;1776;4564;578190;524665;75.6;68.6
42;2021-08-28;1311;3707;579501;528372;75.8;69.1
42;2021-08-29;377;1428;579878;529800;75.8;69.3
42;2021-08-30;1284;3342;581162;533142;76.0;69.7
42;2021-08-31;1238;2713;582400;535855;76.2;70.1
42;2021-09-01;1253;2811;583653;538666;76.3;70.4
42;2021-09-02;1322;2613;584975;541279;76.5;70.8
42;2021-09-03;1573;2938;586548;544217;76.7;71.2
42;2021-09-04;1046;2816;587594;547033;76.8;71.5
42;2021-09-05;381;741;587975;547774;76.9;71.6
42;2021-09-06;763;1781;588738;549555;77.0;71.9
42;2021-09-07;824;1582;589562;551137;77.1;72.1
42;2021-09-08;918;1919;590480;553056;77.2;72.3
42;2021-09-09;658;1462;591138;554518;77.3;72.5
42;2021-09-10;928;1984;592066;556502;77.4;72.8
42;2021-09-11;728;2307;592794;558809;77.5;73.1
42;2021-09-12;163;518;592957;559327;77.5;73.1
42;2021-09-13;551;1160;593508;560487;77.6;73.3
42;2021-09-14;773;1362;594281;561849;77.7;73.5
42;2021-09-15;704;1569;594985;563418;77.8;73.7
42;2021-09-16;526;824;595511;564242;77.9;73.8
42;2021-09-17;734;1636;596245;565878;78.0;74.0
42;2021-09-18;577;1799;596822;567677;78.0;74.2
42;2021-09-19;100;367;596922;568044;78.1;74.3
42;2021-09-20;399;850;597321;568894;78.1;74.4
42;2021-09-21;343;738;597664;569632;78.2;74.5
42;2021-09-22;472;1382;598136;571014;78.2;74.7
42;2021-09-23;372;907;598508;571921;78.3;74.8
42;2021-09-24;471;1563;598979;573484;78.3;75.0
42;2021-09-25;388;1274;599367;574758;78.4;75.2
42;2021-09-26;61;289;599428;575047;78.4;75.2
42;2021-09-27;331;792;599759;575839;78.4;75.3
42;2021-09-28;342;707;600101;576546;78.5;75.4
42;2021-09-29;405;957;600506;577503;78.5;75.5
42;2021-09-30;358;689;600864;578192;78.6;75.6
42;2021-10-01;487;1018;601351;579210;78.6;75.7
42;2021-10-02;378;779;601729;579989;78.7;75.8
42;2021-10-03;90;176;601819;580165;78.7;75.9
42;2021-10-04;269;523;602088;580688;78.7;75.9
42;2021-10-05;286;465;602374;581153;78.8;76.0
42;2021-10-06;412;798;602786;581951;78.8;76.1
42;2021-10-07;287;574;603073;582525;78.9;76.2
42;2021-10-08;405;839;603478;583364;78.9;76.3
42;2021-10-09;381;670;603859;584034;79.0;76.4
42;2021-10-10;89;113;603948;584147;79.0;76.4
42;2021-10-11;256;438;604204;584585;79.0;76.4
43;2020-12-27;0;0;0;0;0.0;0.0
43;2020-12-28;0;0;0;0;0.0;0.0
43;2020-12-29;0;0;0;0;0.0;0.0
43;2020-12-30;0;0;0;0;0.0;0.0
43;2020-12-31;0;0;0;0;0.0;0.0
43;2021-01-01;0;0;0;0;0.0;0.0
43;2021-01-02;0;0;0;0;0.0;0.0
43;2021-01-03;0;0;0;0;0.0;0.0
43;2021-01-04;2;0;2;0;0.0;0.0
43;2021-01-05;0;0;2;0;0.0;0.0
43;2021-01-06;0;0;2;0;0.0;0.0
43;2021-01-07;167;0;169;0;0.1;0.0
43;2021-01-08;151;1;320;1;0.1;0.0
43;2021-01-09;0;0;320;1;0.1;0.0
43;2021-01-10;0;0;320;1;0.1;0.0
43;2021-01-11;137;0;457;1;0.2;0.0
43;2021-01-12;244;1;701;2;0.3;0.0
43;2021-01-13;244;2;945;4;0.4;0.0
43;2021-01-14;294;2;1239;6;0.5;0.0
43;2021-01-15;303;2;1542;8;0.7;0.0
43;2021-01-16;32;0;1574;8;0.7;0.0
43;2021-01-17;0;0;1574;8;0.7;0.0
43;2021-01-18;760;6;2334;14;1.0;0.0
43;2021-01-19;776;5;3110;19;1.4;0.0
43;2021-01-20;519;2;3629;21;1.6;0.0
43;2021-01-21;447;2;4076;23;1.8;0.0
43;2021-01-22;467;7;4543;30;2.0;0.0
43;2021-01-23;1;0;4544;30;2.0;0.0
43;2021-01-24;2;0;4546;30;2.0;0.0
43;2021-01-25;539;0;5085;30;2.2;0.0
43;2021-01-26;614;6;5699;36;2.5;0.0
43;2021-01-27;740;0;6439;36;2.8;0.0
43;2021-01-28;747;31;7186;67;3.2;0.0
43;2021-01-29;722;84;7908;151;3.5;0.1
43;2021-01-30;109;0;8017;151;3.5;0.1
43;2021-01-31;0;0;8017;151;3.5;0.1
43;2021-02-01;403;101;8420;252;3.7;0.1
43;2021-02-02;717;151;9137;403;4.0;0.2
43;2021-02-03;690;44;9827;447;4.3;0.2
43;2021-02-04;525;170;10352;617;4.6;0.3
43;2021-02-05;544;170;10896;787;4.8;0.3
43;2021-02-06;167;19;11063;806;4.9;0.4
43;2021-02-07;0;0;11063;806;4.9;0.4
43;2021-02-08;411;304;11474;1110;5.1;0.5
43;2021-02-09;368;432;11842;1542;5.2;0.7
43;2021-02-10;401;361;12243;1903;5.4;0.8
43;2021-02-11;388;396;12631;2299;5.6;1.0
43;2021-02-12;425;201;13056;2500;5.8;1.1
43;2021-02-13;570;42;13626;2542;6.0;1.1
43;2021-02-14;0;0;13626;2542;6.0;1.1
43;2021-02-15;69;477;13695;3019;6.0;1.3
43;2021-02-16;41;372;13736;3391;6.1;1.5
43;2021-02-17;87;483;13823;3874;6.1;1.7
43;2021-02-18;147;379;13970;4253;6.2;1.9
43;2021-02-19;278;513;14248;4766;6.3;2.1
43;2021-02-20;22;4;14270;4770;6.3;2.1
43;2021-02-21;0;0;14270;4770;6.3;2.1
43;2021-02-22;16;500;14286;5270;6.3;2.3
43;2021-02-23;202;800;14488;6070;6.4;2.7
43;2021-02-24;147;730;14635;6800;6.4;3.0
43;2021-02-25;228;694;14863;7494;6.6;3.3
43;2021-02-26;222;673;15085;8167;6.6;3.6
43;2021-02-27;139;76;15224;8243;6.7;3.6
43;2021-02-28;1;0;15225;8243;6.7;3.6
43;2021-03-01;208;480;15433;8723;6.8;3.8
43;2021-03-02;342;579;15775;9302;7.0;4.1
43;2021-03-03;338;588;16113;9890;7.1;4.4
43;2021-03-04;551;466;16664;10356;7.3;4.6
43;2021-03-05;566;456;17230;10812;7.6;4.8
43;2021-03-06;489;182;17719;10994;7.8;4.8
43;2021-03-07;12;0;17731;10994;7.8;4.8
43;2021-03-08;447;447;18178;11441;8.0;5.0
43;2021-03-09;621;361;18799;11802;8.3;5.2
43;2021-03-10;674;505;19473;12307;8.6;5.4
43;2021-03-11;955;447;20428;12754;9.0;5.6
43;2021-03-12;944;431;21372;13185;9.4;5.8
43;2021-03-13;792;117;22164;13302;9.8;5.9
43;2021-03-14;2;0;22166;13302;9.8;5.9
43;2021-03-15;706;147;22872;13449;10.1;5.9
43;2021-03-16;847;289;23719;13738;10.5;6.1
43;2021-03-17;638;140;24357;13878;10.7;6.1
43;2021-03-18;676;142;25033;14020;11.0;6.2
43;2021-03-19;839;110;25872;14130;11.4;6.2
43;2021-03-20;450;61;26322;14191;11.6;6.3
43;2021-03-21;0;0;26322;14191;11.6;6.3
43;2021-03-22;742;41;27064;14232;11.9;6.3
43;2021-03-23;872;49;27936;14281;12.3;6.3
43;2021-03-24;1174;97;29110;14378;12.8;6.3
43;2021-03-25;1594;162;30704;14540;13.5;6.4
43;2021-03-26;1609;192;32313;14732;14.2;6.5
43;2021-03-27;1449;79;33762;14811;14.9;6.5
43;2021-03-28;420;20;34182;14831;15.1;6.5
43;2021-03-29;1096;171;35278;15002;15.5;6.6
43;2021-03-30;1314;245;36592;15247;16.1;6.7
43;2021-03-31;1306;267;37898;15514;16.7;6.8
43;2021-04-01;1347;344;39245;15858;17.3;7.0
43;2021-04-02;1052;357;40297;16215;17.8;7.1
43;2021-04-03;340;199;40637;16414;17.9;7.2
43;2021-04-04;0;0;40637;16414;17.9;7.2
43;2021-04-05;3;0;40640;16414;17.9;7.2
43;2021-04-06;687;608;41327;17022;18.2;7.5
43;2021-04-07;868;578;42195;17600;18.6;7.8
43;2021-04-08;1086;463;43281;18063;19.1;8.0
43;2021-04-09;1147;663;44428;18726;19.6;8.3
43;2021-04-10;626;265;45054;18991;19.9;8.4
43;2021-04-11;0;0;45054;18991;19.9;8.4
43;2021-04-12;681;650;45735;19641;20.2;8.7
43;2021-04-13;917;727;46652;20368;20.6;9.0
43;2021-04-14;723;672;47375;21040;20.9;9.3
43;2021-04-15;959;702;48334;21742;21.3;9.6
43;2021-04-16;1008;694;49342;22436;21.7;9.9
43;2021-04-17;423;305;49765;22741;21.9;10.0
43;2021-04-18;3;5;49768;22746;21.9;10.0
43;2021-04-19;628;568;50396;23314;22.2;10.3
43;2021-04-20;839;677;51235;23991;22.6;10.6
43;2021-04-21;320;988;51555;24979;22.7;11.0
43;2021-04-22;680;1017;52235;25996;23.0;11.5
43;2021-04-23;401;1103;52636;27099;23.2;11.9
43;2021-04-24;347;1041;52983;28140;23.4;12.4
43;2021-04-25;23;403;53006;28543;23.4;12.6
43;2021-04-26;385;965;53391;29508;23.5;13.0
43;2021-04-27;825;989;54216;30497;23.9;13.4
43;2021-04-28;794;1110;55010;31607;24.2;13.9
43;2021-04-29;1236;1141;56246;32748;24.8;14.4
43;2021-04-30;1199;1070;57445;33818;25.3;14.9
43;2021-05-01;400;27;57845;33845;25.5;14.9
43;2021-05-02;1;0;57846;33845;25.5;14.9
43;2021-05-03;1218;409;59064;34254;26.0;15.1
43;2021-05-04;1237;958;60301;35212;26.6;15.5
43;2021-05-05;1144;849;61445;36061;27.1;15.9
43;2021-05-06;1405;941;62850;37002;27.7;16.3
43;2021-05-07;1089;1173;63939;38175;28.2;16.8
43;2021-05-08;521;136;64460;38311;28.4;16.9
43;2021-05-09;0;2;64460;38313;28.4;16.9
43;2021-05-10;1084;725;65544;39038;28.9;17.2
43;2021-05-11;1553;1010;67097;40048;29.6;17.6
43;2021-05-12;1482;810;68579;40858;30.2;18.0
43;2021-05-13;936;378;69515;41236;30.6;18.2
43;2021-05-14;2204;1111;71719;42347;31.6;18.7
43;2021-05-15;1271;315;72990;42662;32.2;18.8
43;2021-05-16;272;47;73262;42709;32.3;18.8
43;2021-05-17;1625;631;74887;43340;33.0;19.1
43;2021-05-18;1966;676;76853;44016;33.9;19.4
43;2021-05-19;2065;576;78918;44592;34.8;19.7
43;2021-05-20;2338;805;81256;45397;35.8;20.0
43;2021-05-21;2385;709;83641;46106;36.9;20.3
43;2021-05-22;1208;342;84849;46448;37.4;20.5
43;2021-05-23;1;0;84850;46448;37.4;20.5
43;2021-05-24;382;99;85232;46547;37.6;20.5
43;2021-05-25;1407;654;86639;47201;38.2;20.8
43;2021-05-26;1347;559;87986;47760;38.8;21.0
43;2021-05-27;1388;713;89374;48473;39.4;21.4
43;2021-05-28;1348;735;90722;49208;40.0;21.7
43;2021-05-29;1135;604;91857;49812;40.5;22.0
43;2021-05-30;149;17;92006;49829;40.5;22.0
43;2021-05-31;1207;442;93213;50271;41.1;22.2
43;2021-06-01;1281;986;94494;51257;41.6;22.6
43;2021-06-02;1086;700;95580;51957;42.1;22.9
43;2021-06-03;1192;857;96772;52814;42.6;23.3
43;2021-06-04;1351;860;98123;53674;43.2;23.7
43;2021-06-05;823;454;98946;54128;43.6;23.9
43;2021-06-06;10;5;98956;54133;43.6;23.9
43;2021-06-07;748;518;99704;54651;43.9;24.1
43;2021-06-08;664;706;100368;55357;44.2;24.4
43;2021-06-09;538;760;100906;56117;44.5;24.7
43;2021-06-10;807;1120;101713;57237;44.8;25.2
43;2021-06-11;761;1348;102474;58585;45.2;25.8
43;2021-06-12;914;514;103388;59099;45.6;26.0
43;2021-06-13;3;27;103391;59126;45.6;26.1
43;2021-06-14;446;1087;103837;60213;45.8;26.5
43;2021-06-15;629;1195;104466;61408;46.0;27.1
43;2021-06-16;549;974;105015;62382;46.3;27.5
43;2021-06-17;601;1502;105616;63884;46.5;28.2
43;2021-06-18;898;1464;106514;65348;46.9;28.8
43;2021-06-19;447;781;106961;66129;47.1;29.1
43;2021-06-20;0;12;106961;66141;47.1;29.1
43;2021-06-21;424;1307;107385;67448;47.3;29.7
43;2021-06-22;533;1959;107918;69407;47.6;30.6
43;2021-06-23;343;1743;108261;71150;47.7;31.4
43;2021-06-24;511;1494;108772;72644;47.9;32.0
43;2021-06-25;597;2345;109369;74989;48.2;33.0
43;2021-06-26;505;1245;109874;76234;48.4;33.6
43;2021-06-27;10;20;109884;76254;48.4;33.6
43;2021-06-28;341;1784;110225;78038;48.6;34.4
43;2021-06-29;525;2382;110750;80420;48.8;35.4
43;2021-06-30;460;2276;111210;82696;49.0;36.4
43;2021-07-01;473;1910;111683;84606;49.2;37.3
43;2021-07-02;500;1964;112183;86570;49.4;38.2
43;2021-07-03;258;1108;112441;87678;49.6;38.6
43;2021-07-04;1;0;112442;87678;49.6;38.6
43;2021-07-05;526;1202;112968;88880;49.8;39.2
43;2021-07-06;633;1681;113601;90561;50.1;39.9
43;2021-07-07;524;1423;114125;91984;50.3;40.5
43;2021-07-08;837;1417;114962;93401;50.7;41.2
43;2021-07-09;549;1500;115511;94901;50.9;41.8
43;2021-07-10;401;1337;115912;96238;51.1;42.4
43;2021-07-11;23;99;115935;96337;51.1;42.5
43;2021-07-12;604;1685;116539;98022;51.4;43.2
43;2021-07-13;1186;1849;117725;99871;51.9;44.0
43;2021-07-14;848;161;118573;100032;52.3;44.1
43;2021-07-15;1932;1843;120505;101875;53.1;44.9
43;2021-07-16;1752;1616;122257;103491;53.9;45.6
43;2021-07-17;1544;1202;123801;104693;54.6;46.1
43;2021-07-18;4;19;123805;104712;54.6;46.1
43;2021-07-19;1441;1258;125246;105970;55.2;46.7
43;2021-07-20;1895;1451;127141;107421;56.0;47.3
43;2021-07-21;1854;1113;128995;108534;56.9;47.8
43;2021-07-22;2110;1333;131105;109867;57.8;48.4
43;2021-07-23;1619;1325;132724;111192;58.5;49.0
43;2021-07-24;576;1000;133300;112192;58.7;49.4
43;2021-07-25;0;1;133300;112193;58.7;49.4
43;2021-07-26;1643;1072;134943;113265;59.5;49.9
43;2021-07-27;2284;1228;137227;114493;60.5;50.5
43;2021-07-28;1954;1093;139181;115586;61.3;50.9
43;2021-07-29;1986;1019;141167;116605;62.2;51.4
43;2021-07-30;1867;1339;143034;117944;63.0;52.0
43;2021-07-31;706;611;143740;118555;63.3;52.2
43;2021-08-01;13;21;143753;118576;63.4;52.3
43;2021-08-02;1534;970;145287;119546;64.0;52.7
43;2021-08-03;1405;1170;146692;120716;64.7;53.2
43;2021-08-04;1263;1109;147955;121825;65.2;53.7
43;2021-08-05;1254;1285;149209;123110;65.8;54.3
43;2021-08-06;1129;1466;150338;124576;66.3;54.9
43;2021-08-07;758;759;151096;125335;66.6;55.2
43;2021-08-08;5;0;151101;125335;66.6;55.2
43;2021-08-09;822;1636;151923;126971;67.0;56.0
43;2021-08-10;1023;1585;152946;128556;67.4;56.7
43;2021-08-11;680;1340;153626;129896;67.7;57.2
43;2021-08-12;875;1605;154501;131501;68.1;58.0
43;2021-08-13;681;1179;155182;132680;68.4;58.5
43;2021-08-14;364;557;155546;133237;68.6;58.7
43;2021-08-15;5;9;155551;133246;68.6;58.7
43;2021-08-16;686;1675;156237;134921;68.9;59.5
43;2021-08-17;712;1511;156949;136432;69.2;60.1
43;2021-08-18;558;1513;157507;137945;69.4;60.8
43;2021-08-19;641;1614;158148;139559;69.7;61.5
43;2021-08-20;518;1597;158666;141156;69.9;62.2
43;2021-08-21;239;555;158905;141711;70.0;62.5
43;2021-08-22;7;7;158912;141718;70.0;62.5
43;2021-08-23;500;1588;159412;143306;70.3;63.2
43;2021-08-24;518;1398;159930;144704;70.5;63.8
43;2021-08-25;522;1298;160452;146002;70.7;64.3
43;2021-08-26;475;1138;160927;147140;70.9;64.8
43;2021-08-27;529;1360;161456;148500;71.2;65.4
43;2021-08-28;178;499;161634;148999;71.2;65.7
43;2021-08-29;0;1;161634;149000;71.2;65.7
43;2021-08-30;500;1041;162134;150041;71.5;66.1
43;2021-08-31;382;834;162516;150875;71.6;66.5
43;2021-09-01;309;884;162825;151759;71.8;66.9
43;2021-09-02;311;870;163136;152629;71.9;67.3
43;2021-09-03;503;914;163639;153543;72.1;67.7
43;2021-09-04;319;545;163958;154088;72.3;67.9
43;2021-09-05;39;9;163997;154097;72.3;67.9
43;2021-09-06;250;679;164247;154776;72.4;68.2
43;2021-09-07;237;614;164484;155390;72.5;68.5
43;2021-09-08;207;694;164691;156084;72.6;68.8
43;2021-09-09;268;640;164959;156724;72.7;69.1
43;2021-09-10;329;609;165288;157333;72.8;69.3
43;2021-09-11;267;402;165555;157735;73.0;69.5
43;2021-09-12;0;4;165555;157739;73.0;69.5
43;2021-09-13;148;375;165703;158114;73.0;69.7
43;2021-09-14;211;332;165914;158446;73.1;69.8
43;2021-09-15;224;499;166138;158945;73.2;70.1
43;2021-09-16;196;356;166334;159301;73.3;70.2
43;2021-09-17;234;530;166568;159831;73.4;70.4
43;2021-09-18;157;349;166725;160180;73.5;70.6
43;2021-09-19;2;4;166727;160184;73.5;70.6
43;2021-09-20;102;306;166829;160490;73.5;70.7
43;2021-09-21;149;321;166978;160811;73.6;70.9
43;2021-09-22;124;393;167102;161204;73.6;71.0
43;2021-09-23;71;292;167173;161496;73.7;71.2
43;2021-09-24;170;488;167343;161984;73.8;71.4
43;2021-09-25;101;296;167444;162280;73.8;71.5
43;2021-09-26;0;0;167444;162280;73.8;71.5
43;2021-09-27;152;341;167596;162621;73.9;71.7
43;2021-09-28;388;220;167984;162841;74.0;71.8
43;2021-09-29;145;302;168129;163143;74.1;71.9
43;2021-09-30;79;181;168208;163324;74.1;72.0
43;2021-10-01;139;321;168347;163645;74.2;72.1
43;2021-10-02;102;244;168449;163889;74.2;72.2
43;2021-10-03;3;7;168452;163896;74.2;72.2
43;2021-10-04;113;176;168565;164072;74.3;72.3
43;2021-10-05;108;181;168673;164253;74.3;72.4
43;2021-10-06;121;224;168794;164477;74.4;72.5
43;2021-10-07;54;146;168848;164623;74.4;72.6
43;2021-10-08;168;313;169016;164936;74.5;72.7
43;2021-10-09;101;210;169117;165146;74.5;72.8
43;2021-10-10;1;1;169118;165147;74.5;72.8
43;2021-10-11;106;128;169224;165275;74.6;72.8
44;2020-12-27;1;0;1;0;0.0;0.0
44;2020-12-28;3;0;4;0;0.0;0.0
44;2020-12-29;1;0;5;0;0.0;0.0
44;2020-12-30;2;0;7;0;0.0;0.0
44;2020-12-31;1;0;8;0;0.0;0.0
44;2021-01-01;2;1;10;1;0.0;0.0
44;2021-01-02;0;0;10;1;0.0;0.0
44;2021-01-03;4;0;14;1;0.0;0.0
44;2021-01-04;0;0;14;1;0.0;0.0
44;2021-01-05;2;0;16;1;0.0;0.0
44;2021-01-06;20;1;36;2;0.0;0.0
44;2021-01-07;187;0;223;2;0.0;0.0
44;2021-01-08;528;0;751;2;0.1;0.0
44;2021-01-09;473;0;1224;2;0.1;0.0
44;2021-01-10;456;1;1680;3;0.1;0.0
44;2021-01-11;800;1;2480;4;0.2;0.0
44;2021-01-12;910;3;3390;7;0.2;0.0
44;2021-01-13;1086;1;4476;8;0.3;0.0
44;2021-01-14;1116;6;5592;14;0.4;0.0
44;2021-01-15;998;5;6590;19;0.5;0.0
44;2021-01-16;336;3;6926;22;0.5;0.0
44;2021-01-17;328;1;7254;23;0.5;0.0
44;2021-01-18;856;3;8110;26;0.6;0.0
44;2021-01-19;2625;11;10735;37;0.7;0.0
44;2021-01-20;2746;6;13481;43;0.9;0.0
44;2021-01-21;4538;12;18019;55;1.3;0.0
44;2021-01-22;2431;8;20450;63;1.4;0.0
44;2021-01-23;767;1;21217;64;1.5;0.0
44;2021-01-24;120;0;21337;64;1.5;0.0
44;2021-01-25;840;9;22177;73;1.5;0.0
44;2021-01-26;2563;20;24740;93;1.7;0.0
44;2021-01-27;2103;71;26843;164;1.9;0.0
44;2021-01-28;3732;203;30575;367;2.1;0.0
44;2021-01-29;2370;489;32945;856;2.3;0.1
44;2021-01-30;628;211;33573;1067;2.3;0.1
44;2021-01-31;14;210;33587;1277;2.3;0.1
44;2021-02-01;594;544;34181;1821;2.4;0.1
44;2021-02-02;879;757;35060;2578;2.4;0.2
44;2021-02-03;888;889;35948;3467;2.5;0.2
44;2021-02-04;938;724;36886;4191;2.6;0.3
44;2021-02-05;897;636;37783;4827;2.6;0.3
44;2021-02-06;471;270;38254;5097;2.7;0.4
44;2021-02-07;72;203;38326;5300;2.7;0.4
44;2021-02-08;522;460;38848;5760;2.7;0.4
44;2021-02-09;993;1253;39841;7013;2.8;0.5
44;2021-02-10;1144;1307;40985;8320;2.9;0.6
44;2021-02-11;2292;3075;43277;11395;3.0;0.8
44;2021-02-12;1662;1776;44939;13171;3.1;0.9
44;2021-02-13;433;506;45372;13677;3.2;1.0
44;2021-02-14;10;176;45382;13853;3.2;1.0
44;2021-02-15;505;1097;45887;14950;3.2;1.0
44;2021-02-16;1440;2558;47327;17508;3.3;1.2
44;2021-02-17;1106;2167;48433;19675;3.4;1.4
44;2021-02-18;1959;3717;50392;23392;3.5;1.6
44;2021-02-19;1580;2532;51972;25924;3.6;1.8
44;2021-02-20;409;642;52381;26566;3.6;1.8
44;2021-02-21;6;177;52387;26743;3.6;1.9
44;2021-02-22;717;834;53104;27577;3.7;1.9
44;2021-02-23;1248;1126;54352;28703;3.8;2.0
44;2021-02-24;1238;1099;55590;29802;3.9;2.1
44;2021-02-25;2445;1086;58035;30888;4.0;2.1
44;2021-02-26;2291;962;60326;31850;4.2;2.2
44;2021-02-27;975;451;61301;32301;4.3;2.2
44;2021-02-28;7;32;61308;32333;4.3;2.2
44;2021-03-01;988;563;62296;32896;4.3;2.3
44;2021-03-02;1814;1059;64110;33955;4.5;2.4
44;2021-03-03;1860;1137;65970;35092;4.6;2.4
44;2021-03-04;2882;1588;68852;36680;4.8;2.6
44;2021-03-05;3481;1338;72333;38018;5.0;2.6
44;2021-03-06;2507;497;74840;38515;5.2;2.7
44;2021-03-07;988;90;75828;38605;5.3;2.7
44;2021-03-08;1783;624;77611;39229;5.4;2.7
44;2021-03-09;3352;1150;80963;40379;5.6;2.8
44;2021-03-10;3079;1120;84042;41499;5.8;2.9
44;2021-03-11;4439;1793;88481;43292;6.2;3.0
44;2021-03-12;5893;1321;94374;44613;6.6;3.1
44;2021-03-13;3629;305;98003;44918;6.8;3.1
44;2021-03-14;431;64;98434;44982;6.8;3.1
44;2021-03-15;2687;378;101121;45360;7.0;3.2
44;2021-03-16;2149;631;103270;45991;7.2;3.2
44;2021-03-17;1960;682;105230;46673;7.3;3.2
44;2021-03-18;2168;641;107398;47314;7.5;3.3
44;2021-03-19;3784;371;111182;47685;7.7;3.3
44;2021-03-20;3213;302;114395;47987;8.0;3.3
44;2021-03-21;914;22;115309;48009;8.0;3.3
44;2021-03-22;2460;445;117769;48454;8.2;3.4
44;2021-03-23;3960;708;121729;49162;8.5;3.4
44;2021-03-24;4303;636;126032;49798;8.8;3.5
44;2021-03-25;5636;946;131668;50744;9.2;3.5
44;2021-03-26;6510;772;138178;51516;9.6;3.6
44;2021-03-27;3216;436;141394;51952;9.8;3.6
44;2021-03-28;1244;45;142638;51997;9.9;3.6
44;2021-03-29;3120;792;145758;52789;10.1;3.7
44;2021-03-30;5138;1121;150896;53910;10.5;3.8
44;2021-03-31;4612;1316;155508;55226;10.8;3.8
44;2021-04-01;6140;1023;161648;56249;11.2;3.9
44;2021-04-02;5795;965;167443;57214;11.7;4.0
44;2021-04-03;2435;655;169878;57869;11.8;4.0
44;2021-04-04;667;23;170545;57892;11.9;4.0
44;2021-04-05;692;288;171237;58180;11.9;4.0
44;2021-04-06;4216;1390;175453;59570;12.2;4.1
44;2021-04-07;5076;1654;180529;61224;12.6;4.3
44;2021-04-08;7182;1678;187711;62902;13.1;4.4
44;2021-04-09;10066;1834;197777;64736;13.8;4.5
44;2021-04-10;4563;1460;202340;66196;14.1;4.6
44;2021-04-11;2148;431;204488;66627;14.2;4.6
44;2021-04-12;5463;1594;209951;68221;14.6;4.7
44;2021-04-13;6728;2265;216679;70486;15.1;4.9
44;2021-04-14;5911;2243;222590;72729;15.5;5.1
44;2021-04-15;6709;2223;229299;74952;16.0;5.2
44;2021-04-16;7785;2055;237084;77007;16.5;5.4
44;2021-04-17;4300;1391;241384;78398;16.8;5.5
44;2021-04-18;2253;822;243637;79220;17.0;5.5
44;2021-04-19;5042;1912;248679;81132;17.3;5.6
44;2021-04-20;6282;2649;254961;83781;17.7;5.8
44;2021-04-21;6006;2794;260967;86575;18.2;6.0
44;2021-04-22;6958;2518;267925;89093;18.6;6.2
44;2021-04-23;7335;3190;275260;92283;19.2;6.4
44;2021-04-24;3971;2057;279231;94340;19.4;6.6
44;2021-04-25;2076;1060;281307;95400;19.6;6.6
44;2021-04-26;5648;2765;286955;98165;20.0;6.8
44;2021-04-27;7415;4105;294370;102270;20.5;7.1
44;2021-04-28;7608;3793;301978;106063;21.0;7.4
44;2021-04-29;8964;4286;310942;110349;21.6;7.7
44;2021-04-30;9570;4715;320512;115064;22.3;8.0
44;2021-05-01;2848;928;323360;115992;22.5;8.1
44;2021-05-02;1903;618;325263;116610;22.6;8.1
44;2021-05-03;5548;4084;330811;120694;23.0;8.4
44;2021-05-04;6326;5136;337137;125830;23.5;8.8
44;2021-05-05;6071;4635;343208;130465;23.9;9.1
44;2021-05-06;7255;4884;350463;135349;24.4;9.4
44;2021-05-07;7451;5726;357914;141075;24.9;9.8
44;2021-05-08;2583;1269;360497;142344;25.1;9.9
44;2021-05-09;1801;1812;362298;144156;25.2;10.0
44;2021-05-10;6573;5778;368871;149934;25.7;10.4
44;2021-05-11;7787;6280;376658;156214;26.2;10.9
44;2021-05-12;8195;5723;384853;161937;26.8;11.3
44;2021-05-13;5304;1194;390157;163131;27.1;11.4
44;2021-05-14;7587;3974;397744;167105;27.7;11.6
44;2021-05-15;5008;2234;402752;169339;28.0;11.8
44;2021-05-16;2791;741;405543;170080;28.2;11.8
44;2021-05-17;6744;5148;412287;175228;28.7;12.2
44;2021-05-18;7962;5234;420249;180462;29.2;12.6
44;2021-05-19;8165;4283;428414;184745;29.8;12.9
44;2021-05-20;8367;4650;436781;189395;30.4;13.2
44;2021-05-21;8845;5217;445626;194612;31.0;13.5
44;2021-05-22;5097;2232;450723;196844;31.4;13.7
44;2021-05-23;1759;825;452482;197669;31.5;13.8
44;2021-05-24;4884;1616;457366;199285;31.8;13.9
44;2021-05-25;7740;5552;465106;204837;32.4;14.3
44;2021-05-26;8181;5043;473287;209880;32.9;14.6
44;2021-05-27;9659;5358;482946;215238;33.6;15.0
44;2021-05-28;9182;6912;492128;222150;34.2;15.5
44;2021-05-29;5883;3333;498011;225483;34.7;15.7
44;2021-05-30;1775;705;499786;226188;34.8;15.7
44;2021-05-31;8059;6183;507845;232371;35.3;16.2
44;2021-06-01;9905;6571;517750;238942;36.0;16.6
44;2021-06-02;9534;5700;527284;244642;36.7;17.0
44;2021-06-03;10853;5888;538137;250530;37.4;17.4
44;2021-06-04;9959;8075;548096;258605;38.1;18.0
44;2021-06-05;5780;4344;553876;262949;38.5;18.3
44;2021-06-06;2361;1130;556237;264079;38.7;18.4
44;2021-06-07;9549;6936;565786;271015;39.4;18.9
44;2021-06-08;10907;7509;576693;278524;40.1;19.4
44;2021-06-09;10552;6329;587245;284853;40.9;19.8
44;2021-06-10;11424;6043;598669;290896;41.7;20.2
44;2021-06-11;11959;8647;610628;299543;42.5;20.8
44;2021-06-12;7761;4096;618389;303639;43.0;21.1
44;2021-06-13;2792;1004;621181;304643;43.2;21.2
44;2021-06-14;8761;8415;629942;313058;43.8;21.8
44;2021-06-15;11706;8260;641648;321318;44.6;22.4
44;2021-06-16;10976;7661;652624;328979;45.4;22.9
44;2021-06-17;11726;8685;664350;337664;46.2;23.5
44;2021-06-18;10900;10117;675250;347781;47.0;24.2
44;2021-06-19;5883;4324;681133;352105;47.4;24.5
44;2021-06-20;2535;1339;683668;353444;47.6;24.6
44;2021-06-21;7349;10015;691017;363459;48.1;25.3
44;2021-06-22;8469;10627;699486;374086;48.7;26.0
44;2021-06-23;8554;9139;708040;383225;49.3;26.7
44;2021-06-24;9122;8569;717162;391794;49.9;27.3
44;2021-06-25;7643;10817;724805;402611;50.4;28.0
44;2021-06-26;2958;6470;727763;409081;50.6;28.5
44;2021-06-27;816;2403;728579;411484;50.7;28.6
44;2021-06-28;5229;10056;733808;421540;51.1;29.3
44;2021-06-29;6179;12086;739987;433626;51.5;30.2
44;2021-06-30;6183;10448;746170;444074;51.9;30.9
44;2021-07-01;6930;10483;753100;454557;52.4;31.6
44;2021-07-02;6693;12551;759793;467108;52.9;32.5
44;2021-07-03;2584;7004;762377;474112;53.0;33.0
44;2021-07-04;995;2235;763372;476347;53.1;33.1
44;2021-07-05;5315;11871;768687;488218;53.5;34.0
44;2021-07-06;6058;12599;774745;500817;53.9;34.8
44;2021-07-07;6513;11101;781258;511918;54.4;35.6
44;2021-07-08;7391;11959;788649;523877;54.9;36.5
44;2021-07-09;6259;14253;794908;538130;55.3;37.4
44;2021-07-10;2446;7007;797354;545137;55.5;37.9
44;2021-07-11;731;2262;798085;547399;55.5;38.1
44;2021-07-12;4395;14053;802480;561452;55.8;39.1
44;2021-07-13;5767;14850;808247;576302;56.2;40.1
44;2021-07-14;3688;5809;811935;582111;56.5;40.5
44;2021-07-15;7228;14291;819163;596402;57.0;41.5
44;2021-07-16;8234;14994;827397;611396;57.6;42.5
44;2021-07-17;3371;7578;830768;618974;57.8;43.1
44;2021-07-18;1433;2548;832201;621522;57.9;43.2
44;2021-07-19;4870;14697;837071;636219;58.2;44.3
44;2021-07-20;6034;15672;843105;651891;58.7;45.4
44;2021-07-21;5843;13987;848948;665878;59.1;46.3
44;2021-07-22;6722;13750;855670;679628;59.5;47.3
44;2021-07-23;6160;15636;861830;695264;60.0;48.4
44;2021-07-24;2856;8718;864686;703982;60.2;49.0
44;2021-07-25;945;3088;865631;707070;60.2;49.2
44;2021-07-26;6082;12685;871713;719755;60.7;50.1
44;2021-07-27;9714;12191;881427;731946;61.3;50.9
44;2021-07-28;9262;10846;890689;742792;62.0;51.7
44;2021-07-29;10287;10848;900976;753640;62.7;52.4
44;2021-07-30;9183;10927;910159;764567;63.3;53.2
44;2021-07-31;4791;5652;914950;770219;63.7;53.6
44;2021-08-01;2575;1409;917525;771628;63.8;53.7
44;2021-08-02;6631;9477;924156;781105;64.3;54.4
44;2021-08-03;8467;8537;932623;789642;64.9;54.9
44;2021-08-04;9128;6987;941751;796629;65.5;55.4
44;2021-08-05;11570;7524;953321;804153;66.3;56.0
44;2021-08-06;9700;8202;963021;812355;67.0;56.5
44;2021-08-07;4610;3704;967631;816059;67.3;56.8
44;2021-08-08;2540;1727;970171;817786;67.5;56.9
44;2021-08-09;8907;7980;979078;825766;68.1;57.5
44;2021-08-10;10272;7625;989350;833391;68.8;58.0
44;2021-08-11;10423;6789;999773;840180;69.6;58.5
44;2021-08-12;10421;7347;1010194;847527;70.3;59.0
44;2021-08-13;8465;6166;1018659;853693;70.9;59.4
44;2021-08-14;3233;3222;1021892;856915;71.1;59.6
44;2021-08-15;716;933;1022608;857848;71.2;59.7
44;2021-08-16;5854;8307;1028462;866155;71.6;60.3
44;2021-08-17;5607;8180;1034069;874335;72.0;60.8
44;2021-08-18;4822;7621;1038891;881956;72.3;61.4
44;2021-08-19;4975;8351;1043866;890307;72.6;62.0
44;2021-08-20;4504;8922;1048370;899229;72.9;62.6
44;2021-08-21;1960;4612;1050330;903841;73.1;62.9
44;2021-08-22;712;2441;1051042;906282;73.1;63.1
44;2021-08-23;3677;9433;1054719;915715;73.4;63.7
44;2021-08-24;3644;8698;1058363;924413;73.6;64.3
44;2021-08-25;3147;8587;1061510;933000;73.9;64.9
44;2021-08-26;2969;10339;1064479;943339;74.1;65.6
44;2021-08-27;3084;10452;1067563;953791;74.3;66.4
44;2021-08-28;1386;5849;1068949;959640;74.4;66.8
44;2021-08-29;565;2706;1069514;962346;74.4;67.0
44;2021-08-30;2666;10873;1072180;973219;74.6;67.7
44;2021-08-31;2828;10970;1075008;984189;74.8;68.5
44;2021-09-01;2724;9512;1077732;993701;75.0;69.1
44;2021-09-02;2286;8286;1080018;1001987;75.2;69.7
44;2021-09-03;2167;9700;1082185;1011687;75.3;70.4
44;2021-09-04;1454;5827;1083639;1017514;75.4;70.8
44;2021-09-05;442;1318;1084081;1018832;75.4;70.9
44;2021-09-06;1656;6053;1085737;1024885;75.5;71.3
44;2021-09-07;1486;5206;1087223;1030091;75.7;71.7
44;2021-09-08;1908;6051;1089131;1036142;75.8;72.1
44;2021-09-09;1515;4536;1090646;1040678;75.9;72.4
44;2021-09-10;1846;5891;1092492;1046569;76.0;72.8
44;2021-09-11;1090;3940;1093582;1050509;76.1;73.1
44;2021-09-12;238;813;1093820;1051322;76.1;73.2
44;2021-09-13;1202;3573;1095022;1054895;76.2;73.4
44;2021-09-14;1123;3298;1096145;1058193;76.3;73.6
44;2021-09-15;1452;4489;1097597;1062682;76.4;73.9
44;2021-09-16;993;2381;1098590;1065063;76.4;74.1
44;2021-09-17;1264;3849;1099854;1068912;76.5;74.4
44;2021-09-18;779;3131;1100633;1072043;76.6;74.6
44;2021-09-19;217;703;1100850;1072746;76.6;74.6
44;2021-09-20;924;2206;1101774;1074952;76.7;74.8
44;2021-09-21;750;1869;1102524;1076821;76.7;74.9
44;2021-09-22;940;3547;1103464;1080368;76.8;75.2
44;2021-09-23;832;1933;1104296;1082301;76.8;75.3
44;2021-09-24;1106;3000;1105402;1085301;76.9;75.5
44;2021-09-25;499;2292;1105901;1087593;77.0;75.7
44;2021-09-26;185;487;1106086;1088080;77.0;75.7
44;2021-09-27;770;1788;1106856;1089868;77.0;75.8
44;2021-09-28;659;1678;1107515;1091546;77.1;76.0
44;2021-09-29;965;2508;1108480;1094054;77.1;76.1
44;2021-09-30;724;1519;1109204;1095573;77.2;76.2
44;2021-10-01;918;2274;1110122;1097847;77.2;76.4
44;2021-10-02;476;1321;1110598;1099168;77.3;76.5
44;2021-10-03;219;362;1110817;1099530;77.3;76.5
44;2021-10-04;504;963;1111321;1100493;77.3;76.6
44;2021-10-05;463;966;1111784;1101459;77.4;76.6
44;2021-10-06;718;1530;1112502;1102989;77.4;76.7
44;2021-10-07;582;1071;1113084;1104060;77.5;76.8
44;2021-10-08;849;1552;1113933;1105612;77.5;76.9
44;2021-10-09;414;960;1114347;1106572;77.5;77.0
44;2021-10-10;110;228;1114457;1106800;77.5;77.0
44;2021-10-11;517;997;1114974;1107797;77.6;77.1
45;2020-12-27;0;0;0;0;0.0;0.0
45;2020-12-28;1;0;1;0;0.0;0.0
45;2020-12-29;0;0;1;0;0.0;0.0
45;2020-12-30;0;0;1;0;0.0;0.0
45;2020-12-31;1;0;2;0;0.0;0.0
45;2021-01-01;0;0;2;0;0.0;0.0
45;2021-01-02;0;0;2;0;0.0;0.0
45;2021-01-03;0;0;2;0;0.0;0.0
45;2021-01-04;0;0;2;0;0.0;0.0
45;2021-01-05;76;0;78;0;0.0;0.0
45;2021-01-06;68;0;146;0;0.0;0.0
45;2021-01-07;216;1;362;1;0.1;0.0
45;2021-01-08;199;1;561;2;0.1;0.0
45;2021-01-09;42;0;603;2;0.1;0.0
45;2021-01-10;23;0;626;2;0.1;0.0
45;2021-01-11;254;0;880;2;0.1;0.0
45;2021-01-12;680;3;1560;5;0.2;0.0
45;2021-01-13;496;2;2056;7;0.3;0.0
45;2021-01-14;494;40;2550;47;0.4;0.0
45;2021-01-15;391;3;2941;50;0.4;0.0
45;2021-01-16;39;1;2980;51;0.4;0.0
45;2021-01-17;24;0;3004;51;0.4;0.0
45;2021-01-18;816;2;3820;53;0.6;0.0
45;2021-01-19;1197;8;5017;61;0.7;0.0
45;2021-01-20;2119;13;7136;74;1.0;0.0
45;2021-01-21;2521;7;9657;81;1.4;0.0
45;2021-01-22;1408;7;11065;88;1.6;0.0
45;2021-01-23;124;0;11189;88;1.6;0.0
45;2021-01-24;39;0;11228;88;1.6;0.0
45;2021-01-25;557;3;11785;91;1.7;0.0
45;2021-01-26;870;19;12655;110;1.9;0.0
45;2021-01-27;650;45;13305;155;1.9;0.0
45;2021-01-28;881;212;14186;367;2.1;0.1
45;2021-01-29;578;124;14764;491;2.2;0.1
45;2021-01-30;40;41;14804;532;2.2;0.1
45;2021-01-31;37;23;14841;555;2.2;0.1
45;2021-02-01;461;205;15302;760;2.2;0.1
45;2021-02-02;761;467;16063;1227;2.4;0.2
45;2021-02-03;773;479;16836;1706;2.5;0.2
45;2021-02-04;715;274;17551;1980;2.6;0.3
45;2021-02-05;418;152;17969;2132;2.6;0.3
45;2021-02-06;39;29;18008;2161;2.6;0.3
45;2021-02-07;7;31;18015;2192;2.6;0.3
45;2021-02-08;455;194;18470;2386;2.7;0.3
45;2021-02-09;1006;411;19476;2797;2.9;0.4
45;2021-02-10;1280;811;20756;3608;3.0;0.5
45;2021-02-11;1385;1527;22141;5135;3.2;0.8
45;2021-02-12;1052;1140;23193;6275;3.4;0.9
45;2021-02-13;85;158;23278;6433;3.4;0.9
45;2021-02-14;40;11;23318;6444;3.4;0.9
45;2021-02-15;524;607;23842;7051;3.5;1.0
45;2021-02-16;758;932;24600;7983;3.6;1.2
45;2021-02-17;642;1046;25242;9029;3.7;1.3
45;2021-02-18;841;849;26083;9878;3.8;1.4
45;2021-02-19;827;761;26910;10639;3.9;1.6
45;2021-02-20;59;94;26969;10733;3.9;1.6
45;2021-02-21;17;44;26986;10777;4.0;1.6
45;2021-02-22;409;632;27395;11409;4.0;1.7
45;2021-02-23;816;790;28211;12199;4.1;1.8
45;2021-02-24;655;917;28866;13116;4.2;1.9
45;2021-02-25;963;781;29829;13897;4.4;2.0
45;2021-02-26;1044;684;30873;14581;4.5;2.1
45;2021-02-27;291;52;31164;14633;4.6;2.1
45;2021-02-28;28;5;31192;14638;4.6;2.1
45;2021-03-01;536;336;31728;14974;4.6;2.2
45;2021-03-02;668;726;32396;15700;4.7;2.3
45;2021-03-03;981;898;33377;16598;4.9;2.4
45;2021-03-04;1108;995;34485;17593;5.0;2.6
45;2021-03-05;1444;874;35929;18467;5.3;2.7
45;2021-03-06;2021;141;37950;18608;5.6;2.7
45;2021-03-07;143;59;38093;18667;5.6;2.7
45;2021-03-08;753;849;38846;19516;5.7;2.9
45;2021-03-09;1256;720;40102;20236;5.9;3.0
45;2021-03-10;1591;906;41693;21142;6.1;3.1
45;2021-03-11;1722;758;43415;21900;6.4;3.2
45;2021-03-12;2072;615;45487;22515;6.7;3.3
45;2021-03-13;988;48;46475;22563;6.8;3.3
45;2021-03-14;24;43;46499;22606;6.8;3.3
45;2021-03-15;810;597;47309;23203;6.9;3.4
45;2021-03-16;942;839;48251;24042;7.1;3.5
45;2021-03-17;1054;689;49305;24731;7.2;3.6
45;2021-03-18;997;585;50302;25316;7.4;3.7
45;2021-03-19;1619;431;51921;25747;7.6;3.8
45;2021-03-20;498;82;52419;25829;7.7;3.8
45;2021-03-21;20;35;52439;25864;7.7;3.8
45;2021-03-22;914;533;53353;26397;7.8;3.9
45;2021-03-23;1985;731;55338;27128;8.1;4.0
45;2021-03-24;1896;556;57234;27684;8.4;4.1
45;2021-03-25;2983;458;60217;28142;8.8;4.1
45;2021-03-26;3390;489;63607;28631;9.3;4.2
45;2021-03-27;1796;126;65403;28757;9.6;4.2
45;2021-03-28;89;40;65492;28797;9.6;4.2
45;2021-03-29;1531;543;67023;29340;9.8;4.3
45;2021-03-30;2785;790;69808;30130;10.2;4.4
45;2021-03-31;2135;586;71943;30716;10.5;4.5
45;2021-04-01;2968;569;74911;31285;11.0;4.6
45;2021-04-02;2827;522;77738;31807;11.4;4.7
45;2021-04-03;810;73;78548;31880;11.5;4.7
45;2021-04-04;113;33;78661;31913;11.5;4.7
45;2021-04-05;15;2;78676;31915;11.5;4.7
45;2021-04-06;1735;798;80411;32713;11.8;4.8
45;2021-04-07;1775;1118;82186;33831;12.0;5.0
45;2021-04-08;2772;1024;84958;34855;12.4;5.1
45;2021-04-09;3676;650;88634;35505;13.0;5.2
45;2021-04-10;2323;120;90957;35625;13.3;5.2
45;2021-04-11;153;25;91110;35650;13.3;5.2
45;2021-04-12;2606;679;93716;36329;13.7;5.3
45;2021-04-13;3848;1096;97564;37425;14.3;5.5
45;2021-04-14;2929;1225;100493;38650;14.7;5.7
45;2021-04-15;3518;1044;104011;39694;15.2;5.8
45;2021-04-16;3775;693;107786;40387;15.8;5.9
45;2021-04-17;1614;116;109400;40503;16.0;5.9
45;2021-04-18;200;43;109600;40546;16.0;5.9
45;2021-04-19;1938;946;111538;41492;16.3;6.1
45;2021-04-20;3074;1701;114612;43193;16.8;6.3
45;2021-04-21;2726;1309;117338;44502;17.2;6.5
45;2021-04-22;3420;1845;120758;46347;17.7;6.8
45;2021-04-23;3278;1788;124036;48135;18.2;7.0
45;2021-04-24;2023;870;126059;49005;18.5;7.2
45;2021-04-25;291;87;126350;49092;18.5;7.2
45;2021-04-26;2228;1165;128578;50257;18.8;7.4
45;2021-04-27;3351;2354;131929;52611;19.3;7.7
45;2021-04-28;2801;1947;134730;54558;19.7;8.0
45;2021-04-29;3854;2346;138584;56904;20.3;8.3
45;2021-04-30;4391;1816;142975;58720;20.9;8.6
45;2021-05-01;451;62;143426;58782;21.0;8.6
45;2021-05-02;627;122;144053;58904;21.1;8.6
45;2021-05-03;2821;994;146874;59898;21.5;8.8
45;2021-05-04;3157;2351;150031;62249;22.0;9.1
45;2021-05-05;2715;2164;152746;64413;22.4;9.4
45;2021-05-06;3330;2543;156076;66956;22.9;9.8
45;2021-05-07;2871;3199;158947;70155;23.3;10.3
45;2021-05-08;613;251;159560;70406;23.4;10.3
45;2021-05-09;1498;133;161058;70539;23.6;10.3
45;2021-05-10;4139;2982;165197;73521;24.2;10.8
45;2021-05-11;5030;2975;170227;76496;24.9;11.2
45;2021-05-12;6078;2785;176305;79281;25.8;11.6
45;2021-05-13;2449;598;178754;79879;26.2;11.7
45;2021-05-14;4965;1633;183719;81512;26.9;11.9
45;2021-05-15;4066;618;187785;82130;27.5;12.0
45;2021-05-16;289;33;188074;82163;27.5;12.0
45;2021-05-17;3359;1539;191433;83702;28.0;12.3
45;2021-05-18;5117;1682;196550;85384;28.8;12.5
45;2021-05-19;4494;2064;201044;87448;29.4;12.8
45;2021-05-20;5268;2142;206312;89590;30.2;13.1
45;2021-05-21;5141;2226;211453;91816;31.0;13.4
45;2021-05-22;3042;632;214495;92448;31.4;13.5
45;2021-05-23;15;94;214510;92542;31.4;13.6
45;2021-05-24;2826;216;217336;92758;31.8;13.6
45;2021-05-25;4961;3034;222297;95792;32.6;14.0
45;2021-05-26;5106;2338;227403;98130;33.3;14.4
45;2021-05-27;5306;3237;232709;101367;34.1;14.8
45;2021-05-28;5665;3593;238374;104960;34.9;15.4
45;2021-05-29;3671;1290;242045;106250;35.4;15.6
45;2021-05-30;33;182;242078;106432;35.4;15.6
45;2021-05-31;4331;2520;246409;108952;36.1;16.0
45;2021-06-01;6090;3007;252499;111959;37.0;16.4
45;2021-06-02;4937;3108;257436;115067;37.7;16.9
45;2021-06-03;5615;3207;263051;118274;38.5;17.3
45;2021-06-04;5895;3186;268946;121460;39.4;17.8
45;2021-06-05;2035;1338;270981;122798;39.7;18.0
45;2021-06-06;88;198;271069;122996;39.7;18.0
45;2021-06-07;4081;2724;275150;125720;40.3;18.4
45;2021-06-08;4646;4080;279796;129800;41.0;19.0
45;2021-06-09;4356;3345;284152;133145;41.6;19.5
45;2021-06-10;4646;2687;288798;135832;42.3;19.9
45;2021-06-11;4121;3669;292919;139501;42.9;20.4
45;2021-06-12;2440;1507;295359;141008;43.3;20.6
45;2021-06-13;21;424;295380;141432;43.3;20.7
45;2021-06-14;3142;4157;298522;145589;43.7;21.3
45;2021-06-15;3388;4325;301910;149914;44.2;22.0
45;2021-06-16;3908;3457;305818;153371;44.8;22.5
45;2021-06-17;3523;3539;309341;156910;45.3;23.0
45;2021-06-18;3799;5028;313140;161938;45.9;23.7
45;2021-06-19;2393;1761;315533;163699;46.2;24.0
45;2021-06-20;48;142;315581;163841;46.2;24.0
45;2021-06-21;2164;5851;317745;169692;46.5;24.8
45;2021-06-22;2417;6529;320162;176221;46.9;25.8
45;2021-06-23;2282;5600;322444;181821;47.2;26.6
45;2021-06-24;2137;3531;324581;185352;47.5;27.1
45;2021-06-25;2444;6446;327025;191798;47.9;28.1
45;2021-06-26;1948;3094;328973;194892;48.2;28.5
45;2021-06-27;53;138;329026;195030;48.2;28.6
45;2021-06-28;2083;4835;331109;199865;48.5;29.3
45;2021-06-29;2847;6817;333956;206682;48.9;30.3
45;2021-06-30;2888;5854;336844;212536;49.3;31.1
45;2021-07-01;2398;5039;339242;217575;49.7;31.9
45;2021-07-02;2378;6284;341620;223859;50.0;32.8
45;2021-07-03;754;2540;342374;226399;50.1;33.2
45;2021-07-04;6;12;342380;226411;50.1;33.2
45;2021-07-05;2143;4992;344523;231403;50.5;33.9
45;2021-07-06;2806;6776;347329;238179;50.9;34.9
45;2021-07-07;2447;6064;349776;244243;51.2;35.8
45;2021-07-08;2826;5377;352602;249620;51.6;36.6
45;2021-07-09;2158;6986;354760;256606;51.9;37.6
45;2021-07-10;1552;3862;356312;260468;52.2;38.1
45;2021-07-11;24;31;356336;260499;52.2;38.1
45;2021-07-12;1591;5996;357927;266495;52.4;39.0
45;2021-07-13;3042;8236;360969;274731;52.9;40.2
45;2021-07-14;1480;1520;362449;276251;53.1;40.5
45;2021-07-15;3734;7291;366183;283542;53.6;41.5
45;2021-07-16;3255;7447;369438;290989;54.1;42.6
45;2021-07-17;1285;2332;370723;293321;54.3;43.0
45;2021-07-18;15;19;370738;293340;54.3;43.0
45;2021-07-19;1870;5936;372608;299276;54.6;43.8
45;2021-07-20;4756;6904;377364;306180;55.3;44.8
45;2021-07-21;5176;5480;382540;311660;56.0;45.6
45;2021-07-22;6179;4904;388719;316564;56.9;46.4
45;2021-07-23;4260;5481;392979;322045;57.5;47.2
45;2021-07-24;1864;2825;394843;324870;57.8;47.6
45;2021-07-25;5;14;394848;324884;57.8;47.6
45;2021-07-26;2913;4985;397761;329869;58.2;48.3
45;2021-07-27;5464;5084;403225;334953;59.0;49.0
45;2021-07-28;4989;4181;408214;339134;59.8;49.7
45;2021-07-29;5280;3257;413494;342391;60.6;50.1
45;2021-07-30;4762;4708;418256;347099;61.2;50.8
45;2021-07-31;849;1950;419105;349049;61.4;51.1
45;2021-08-01;2;4;419107;349053;61.4;51.1
45;2021-08-02;3640;3245;422747;352298;61.9;51.6
45;2021-08-03;4877;3011;427624;355309;62.6;52.0
45;2021-08-04;3744;2235;431368;357544;63.2;52.4
45;2021-08-05;3327;2641;434695;360185;63.7;52.7
45;2021-08-06;3747;3271;438442;363456;64.2;53.2
45;2021-08-07;1680;1050;440122;364506;64.4;53.4
45;2021-08-08;9;18;440131;364524;64.5;53.4
45;2021-08-09;2627;3015;442758;367539;64.8;53.8
45;2021-08-10;3517;3808;446275;371347;65.4;54.4
45;2021-08-11;2701;3721;448976;375068;65.7;54.9
45;2021-08-12;2093;3430;451069;378498;66.1;55.4
45;2021-08-13;1743;4224;452812;382722;66.3;56.0
45;2021-08-14;681;956;453493;383678;66.4;56.2
45;2021-08-15;62;31;453555;383709;66.4;56.2
45;2021-08-16;1159;2319;454714;386028;66.6;56.5
45;2021-08-17;1858;3448;456572;389476;66.9;57.0
45;2021-08-18;1782;4050;458354;393526;67.1;57.6
45;2021-08-19;1445;4268;459799;397794;67.3;58.3
45;2021-08-20;1424;3681;461223;401475;67.5;58.8
45;2021-08-21;905;1154;462128;402629;67.7;59.0
45;2021-08-22;4;8;462132;402637;67.7;59.0
45;2021-08-23;1333;4245;463465;406882;67.9;59.6
45;2021-08-24;1736;4522;465201;411404;68.1;60.2
45;2021-08-25;1585;3726;466786;415130;68.4;60.8
45;2021-08-26;1010;3450;467796;418580;68.5;61.3
45;2021-08-27;1432;4982;469228;423562;68.7;62.0
45;2021-08-28;878;2029;470106;425591;68.8;62.3
45;2021-08-29;100;38;470206;425629;68.9;62.3
45;2021-08-30;1222;4040;471428;429669;69.0;62.9
45;2021-08-31;1077;4391;472505;434060;69.2;63.6
45;2021-09-01;1105;3383;473610;437443;69.4;64.1
45;2021-09-02;925;3116;474535;440559;69.5;64.5
45;2021-09-03;1090;3595;475625;444154;69.6;65.0
45;2021-09-04;495;1261;476120;445415;69.7;65.2
45;2021-09-05;1;16;476121;445431;69.7;65.2
45;2021-09-06;885;2361;477006;447792;69.9;65.6
45;2021-09-07;712;1725;477718;449517;70.0;65.8
45;2021-09-08;859;2218;478577;451735;70.1;66.2
45;2021-09-09;799;1443;479376;453178;70.2;66.4
45;2021-09-10;787;1607;480163;454785;70.3;66.6
45;2021-09-11;442;1520;480605;456305;70.4;66.8
45;2021-09-12;372;161;480977;456466;70.4;66.8
45;2021-09-13;440;972;481417;457438;70.5;67.0
45;2021-09-14;758;1439;482175;458877;70.6;67.2
45;2021-09-15;800;1829;482975;460706;70.7;67.5
45;2021-09-16;805;962;483780;461668;70.8;67.6
45;2021-09-17;766;1656;484546;463324;71.0;67.8
45;2021-09-18;483;991;485029;464315;71.0;68.0
45;2021-09-19;2;29;485031;464344;71.0;68.0
45;2021-09-20;412;979;485443;465323;71.1;68.1
45;2021-09-21;447;749;485890;466072;71.2;68.2
45;2021-09-22;439;1702;486329;467774;71.2;68.5
45;2021-09-23;528;840;486857;468614;71.3;68.6
45;2021-09-24;579;1375;487436;469989;71.4;68.8
45;2021-09-25;351;783;487787;470772;71.4;68.9
45;2021-09-26;2;11;487789;470783;71.4;68.9
45;2021-09-27;435;757;488224;471540;71.5;69.1
45;2021-09-28;451;754;488675;472294;71.6;69.2
45;2021-09-29;477;968;489152;473262;71.6;69.3
45;2021-09-30;357;823;489509;474085;71.7;69.4
45;2021-10-01;317;767;489826;474852;71.7;69.5
45;2021-10-02;293;546;490119;475398;71.8;69.6
45;2021-10-03;98;369;490217;475767;71.8;69.7
45;2021-10-04;219;341;490436;476108;71.8;69.7
45;2021-10-05;347;655;490783;476763;71.9;69.8
45;2021-10-06;435;719;491218;477482;71.9;69.9
45;2021-10-07;282;760;491500;478242;72.0;70.0
45;2021-10-08;342;667;491842;478909;72.0;70.1
45;2021-10-09;418;721;492260;479630;72.1;70.2
45;2021-10-10;4;7;492264;479637;72.1;70.2
45;2021-10-11;200;414;492464;480051;72.1;70.3
46;2020-12-27;4;0;4;0;0.0;0.0
46;2020-12-28;0;0;4;0;0.0;0.0
46;2020-12-29;0;0;4;0;0.0;0.0
46;2020-12-30;0;0;4;0;0.0;0.0
46;2020-12-31;0;0;4;0;0.0;0.0
46;2021-01-01;0;0;4;0;0.0;0.0
46;2021-01-02;0;0;4;0;0.0;0.0
46;2021-01-03;1;0;5;0;0.0;0.0
46;2021-01-04;0;0;5;0;0.0;0.0
46;2021-01-05;0;0;5;0;0.0;0.0
46;2021-01-06;3;0;8;0;0.0;0.0
46;2021-01-07;135;1;143;1;0.1;0.0
46;2021-01-08;181;0;324;1;0.2;0.0
46;2021-01-09;1;0;325;1;0.2;0.0
46;2021-01-10;2;0;327;1;0.2;0.0
46;2021-01-11;118;0;445;1;0.3;0.0
46;2021-01-12;141;0;586;1;0.3;0.0
46;2021-01-13;235;2;821;3;0.5;0.0
46;2021-01-14;244;3;1065;6;0.6;0.0
46;2021-01-15;306;2;1371;8;0.8;0.0
46;2021-01-16;18;0;1389;8;0.8;0.0
46;2021-01-17;0;0;1389;8;0.8;0.0
46;2021-01-18;276;3;1665;11;1.0;0.0
46;2021-01-19;390;1;2055;12;1.2;0.0
46;2021-01-20;939;3;2994;15;1.7;0.0
46;2021-01-21;997;1;3991;16;2.3;0.0
46;2021-01-22;391;2;4382;18;2.5;0.0
46;2021-01-23;0;0;4382;18;2.5;0.0
46;2021-01-24;0;0;4382;18;2.5;0.0
46;2021-01-25;204;2;4586;20;2.6;0.0
46;2021-01-26;264;1;4850;21;2.8;0.0
46;2021-01-27;276;0;5126;21;3.0;0.0
46;2021-01-28;279;43;5405;64;3.1;0.0
46;2021-01-29;233;91;5638;155;3.3;0.1
46;2021-01-30;1;0;5639;155;3.3;0.1
46;2021-01-31;1;0;5640;155;3.3;0.1
46;2021-02-01;234;173;5874;328;3.4;0.2
46;2021-02-02;210;238;6084;566;3.5;0.3
46;2021-02-03;227;97;6311;663;3.6;0.4
46;2021-02-04;372;86;6683;749;3.9;0.4
46;2021-02-05;226;177;6909;926;4.0;0.5
46;2021-02-06;9;0;6918;926;4.0;0.5
46;2021-02-07;43;0;6961;926;4.0;0.5
46;2021-02-08;197;156;7158;1082;4.1;0.6
46;2021-02-09;271;225;7429;1307;4.3;0.8
46;2021-02-10;280;546;7709;1853;4.5;1.1
46;2021-02-11;655;557;8364;2410;4.8;1.4
46;2021-02-12;324;342;8688;2752;5.0;1.6
46;2021-02-13;2;0;8690;2752;5.0;1.6
46;2021-02-14;0;62;8690;2814;5.0;1.6
46;2021-02-15;195;293;8885;3107;5.1;1.8
46;2021-02-16;217;284;9102;3391;5.3;2.0
46;2021-02-17;201;328;9303;3719;5.4;2.1
46;2021-02-18;337;267;9640;3986;5.6;2.3
46;2021-02-19;277;234;9917;4220;5.7;2.4
46;2021-02-20;0;0;9917;4220;5.7;2.4
46;2021-02-21;1;0;9918;4220;5.7;2.4
46;2021-02-22;131;193;10049;4413;5.8;2.5
46;2021-02-23;225;169;10274;4582;5.9;2.6
46;2021-02-24;179;324;10453;4906;6.0;2.8
46;2021-02-25;247;341;10700;5247;6.2;3.0
46;2021-02-26;403;344;11103;5591;6.4;3.2
46;2021-02-27;120;1;11223;5592;6.5;3.2
46;2021-02-28;0;3;11223;5595;6.5;3.2
46;2021-03-01;169;181;11392;5776;6.6;3.3
46;2021-03-02;406;233;11798;6009;6.8;3.5
46;2021-03-03;460;331;12258;6340;7.1;3.7
46;2021-03-04;607;456;12865;6796;7.4;3.9
46;2021-03-05;808;365;13673;7161;7.9;4.1
46;2021-03-06;476;17;14149;7178;8.2;4.1
46;2021-03-07;101;19;14250;7197;8.2;4.2
46;2021-03-08;348;249;14598;7446;8.4;4.3
46;2021-03-09;746;271;15344;7717;8.9;4.5
46;2021-03-10;686;248;16030;7965;9.3;4.6
46;2021-03-11;851;257;16881;8222;9.7;4.7
46;2021-03-12;927;228;17808;8450;10.3;4.9
46;2021-03-13;512;4;18320;8454;10.6;4.9
46;2021-03-14;1;0;18321;8454;10.6;4.9
46;2021-03-15;505;166;18826;8620;10.9;5.0
46;2021-03-16;752;174;19578;8794;11.3;5.1
46;2021-03-17;674;207;20252;9001;11.7;5.2
46;2021-03-18;758;216;21010;9217;12.1;5.3
46;2021-03-19;811;153;21821;9370;12.6;5.4
46;2021-03-20;294;5;22115;9375;12.8;5.4
46;2021-03-21;2;0;22117;9375;12.8;5.4
46;2021-03-22;555;241;22672;9616;13.1;5.6
46;2021-03-23;702;212;23374;9828;13.5;5.7
46;2021-03-24;673;240;24047;10068;13.9;5.8
46;2021-03-25;1135;187;25182;10255;14.5;5.9
46;2021-03-26;1023;342;26205;10597;15.1;6.1
46;2021-03-27;420;73;26625;10670;15.4;6.2
46;2021-03-28;127;1;26752;10671;15.4;6.2
46;2021-03-29;733;253;27485;10924;15.9;6.3
46;2021-03-30;767;365;28252;11289;16.3;6.5
46;2021-03-31;865;421;29117;11710;16.8;6.8
46;2021-04-01;1172;351;30289;12061;17.5;7.0
46;2021-04-02;922;396;31211;12457;18.0;7.2
46;2021-04-03;167;166;31378;12623;18.1;7.3
46;2021-04-04;0;71;31378;12694;18.1;7.3
46;2021-04-05;3;0;31381;12694;18.1;7.3
46;2021-04-06;544;517;31925;13211;18.4;7.6
46;2021-04-07;784;647;32709;13858;18.9;8.0
46;2021-04-08;960;542;33669;14400;19.4;8.3
46;2021-04-09;1018;506;34687;14906;20.0;8.6
46;2021-04-10;506;211;35193;15117;20.3;8.7
46;2021-04-11;232;1;35425;15118;20.5;8.7
46;2021-04-12;845;547;36270;15665;20.9;9.0
46;2021-04-13;1186;721;37456;16386;21.6;9.5
46;2021-04-14;1533;615;38989;17001;22.5;9.8
46;2021-04-15;1504;665;40493;17666;23.4;10.2
46;2021-04-16;1584;566;42077;18232;24.3;10.5
46;2021-04-17;995;137;43072;18369;24.9;10.6
46;2021-04-18;517;10;43589;18379;25.2;10.6
46;2021-04-19;1070;573;44659;18952;25.8;10.9
46;2021-04-20;1229;734;45888;19686;26.5;11.4
46;2021-04-21;1230;714;47118;20400;27.2;11.8
46;2021-04-22;1391;730;48509;21130;28.0;12.2
46;2021-04-23;1132;733;49641;21863;28.7;12.6
46;2021-04-24;472;19;50113;21882;28.9;12.6
46;2021-04-25;351;11;50464;21893;29.1;12.6
46;2021-04-26;852;730;51316;22623;29.6;13.1
46;2021-04-27;1221;668;52537;23291;30.3;13.5
46;2021-04-28;1289;669;53826;23960;31.1;13.8
46;2021-04-29;1417;527;55243;24487;31.9;14.1
46;2021-04-30;1438;569;56681;25056;32.7;14.5
46;2021-05-01;697;74;57378;25130;33.1;14.5
46;2021-05-02;346;4;57724;25134;33.3;14.5
46;2021-05-03;853;570;58577;25704;33.8;14.8
46;2021-05-04;1037;1063;59614;26767;34.4;15.5
46;2021-05-05;1374;789;60988;27556;35.2;15.9
46;2021-05-06;1377;743;62365;28299;36.0;16.3
46;2021-05-07;1396;791;63761;29090;36.8;16.8
46;2021-05-08;280;412;64041;29502;37.0;17.0
46;2021-05-09;23;225;64064;29727;37.0;17.2
46;2021-05-10;515;1137;64579;30864;37.3;17.8
46;2021-05-11;1031;1256;65610;32120;37.9;18.5
46;2021-05-12;993;1564;66603;33684;38.5;19.5
46;2021-05-13;598;143;67201;33827;38.8;19.5
46;2021-05-14;958;1097;68159;34924;39.4;20.2
46;2021-05-15;254;654;68413;35578;39.5;20.5
46;2021-05-16;77;297;68490;35875;39.6;20.7
46;2021-05-17;652;960;69142;36835;39.9;21.3
46;2021-05-18;1402;1024;70544;37859;40.7;21.9
46;2021-05-19;1305;904;71849;38763;41.5;22.4
46;2021-05-20;1453;813;73302;39576;42.3;22.9
46;2021-05-21;997;1158;74299;40734;42.9;23.5
46;2021-05-22;146;369;74445;41103;43.0;23.7
46;2021-05-23;451;26;74896;41129;43.3;23.8
46;2021-05-24;411;113;75307;41242;43.5;23.8
46;2021-05-25;960;1333;76267;42575;44.0;24.6
46;2021-05-26;1237;1149;77504;43724;44.8;25.2
46;2021-05-27;1432;1195;78936;44919;45.6;25.9
46;2021-05-28;1428;1211;80364;46130;46.4;26.6
46;2021-05-29;1049;397;81413;46527;47.0;26.9
46;2021-05-30;409;39;81822;46566;47.3;26.9
46;2021-05-31;968;976;82790;47542;47.8;27.5
46;2021-06-01;1277;999;84067;48541;48.5;28.0
46;2021-06-02;1319;1116;85386;49657;49.3;28.7
46;2021-06-03;1415;1012;86801;50669;50.1;29.3
46;2021-06-04;1329;977;88130;51646;50.9;29.8
46;2021-06-05;381;414;88511;52060;51.1;30.1
46;2021-06-06;209;96;88720;52156;51.2;30.1
46;2021-06-07;814;617;89534;52773;51.7;30.5
46;2021-06-08;1020;896;90554;53669;52.3;31.0
46;2021-06-09;1505;974;92059;54643;53.2;31.6
46;2021-06-10;981;852;93040;55495;53.7;32.0
46;2021-06-11;969;1322;94009;56817;54.3;32.8
46;2021-06-12;459;549;94468;57366;54.6;33.1
46;2021-06-13;27;86;94495;57452;54.6;33.2
46;2021-06-14;593;1138;95088;58590;54.9;33.8
46;2021-06-15;751;1246;95839;59836;55.3;34.6
46;2021-06-16;1002;1113;96841;60949;55.9;35.2
46;2021-06-17;527;897;97368;61846;56.2;35.7
46;2021-06-18;656;1253;98024;63099;56.6;36.4
46;2021-06-19;457;313;98481;63412;56.9;36.6
46;2021-06-20;39;161;98520;63573;56.9;36.7
46;2021-06-21;429;946;98949;64519;57.1;37.3
46;2021-06-22;350;1177;99299;65696;57.3;37.9
46;2021-06-23;519;1074;99818;66770;57.6;38.6
46;2021-06-24;251;820;100069;67590;57.8;39.0
46;2021-06-25;491;1118;100560;68708;58.1;39.7
46;2021-06-26;398;553;100958;69261;58.3;40.0
46;2021-06-27;3;4;100961;69265;58.3;40.0
46;2021-06-28;315;1341;101276;70606;58.5;40.8
46;2021-06-29;375;1680;101651;72286;58.7;41.7
46;2021-06-30;509;1577;102160;73863;59.0;42.7
46;2021-07-01;487;1153;102647;75016;59.3;43.3
46;2021-07-02;455;1087;103102;76103;59.5;43.9
46;2021-07-03;120;454;103222;76557;59.6;44.2
46;2021-07-04;57;127;103279;76684;59.6;44.3
46;2021-07-05;347;1186;103626;77870;59.8;45.0
46;2021-07-06;449;1457;104075;79327;60.1;45.8
46;2021-07-07;583;1728;104658;81055;60.4;46.8
46;2021-07-08;340;1164;104998;82219;60.6;47.5
46;2021-07-09;395;1706;105393;83925;60.9;48.5
46;2021-07-10;285;1039;105678;84964;61.0;49.1
46;2021-07-11;15;375;105693;85339;61.0;49.3
46;2021-07-12;248;1259;105941;86598;61.2;50.0
46;2021-07-13;626;1670;106567;88268;61.5;51.0
46;2021-07-14;73;144;106640;88412;61.6;51.1
46;2021-07-15;917;1464;107557;89876;62.1;51.9
46;2021-07-16;766;1394;108323;91270;62.6;52.7
46;2021-07-17;364;539;108687;91809;62.8;53.0
46;2021-07-18;2;0;108689;91809;62.8;53.0
46;2021-07-19;729;1188;109418;92997;63.2;53.7
46;2021-07-20;983;1438;110401;94435;63.8;54.5
46;2021-07-21;1001;1379;111402;95814;64.3;55.3
46;2021-07-22;1404;1118;112806;96932;65.1;56.0
46;2021-07-23;768;1322;113574;98254;65.6;56.7
46;2021-07-24;957;665;114531;98919;66.1;57.1
46;2021-07-25;136;17;114667;98936;66.2;57.1
46;2021-07-26;881;878;115548;99814;66.7;57.6
46;2021-07-27;1220;978;116768;100792;67.4;58.2
46;2021-07-28;1284;1114;118052;101906;68.2;58.8
46;2021-07-29;1580;849;119632;102755;69.1;59.3
46;2021-07-30;1933;956;121565;103711;70.2;59.9
46;2021-07-31;958;662;122523;104373;70.8;60.3
46;2021-08-01;12;3;122535;104376;70.8;60.3
46;2021-08-02;974;591;123509;104967;71.3;60.6
46;2021-08-03;1365;679;124874;105646;72.1;61.0
46;2021-08-04;1735;586;126609;106232;73.1;61.3
46;2021-08-05;1382;842;127991;107074;73.9;61.8
46;2021-08-06;1422;848;129413;107922;74.7;62.3
46;2021-08-07;707;544;130120;108466;75.1;62.6
46;2021-08-08;152;66;130272;108532;75.2;62.7
46;2021-08-09;1018;694;131290;109226;75.8;63.1
46;2021-08-10;1206;892;132496;110118;76.5;63.6
46;2021-08-11;1260;1064;133756;111182;77.2;64.2
46;2021-08-12;990;800;134746;111982;77.8;64.7
46;2021-08-13;953;1005;135699;112987;78.4;65.2
46;2021-08-14;588;774;136287;113761;78.7;65.7
46;2021-08-15;8;27;136295;113788;78.7;65.7
46;2021-08-16;795;811;137090;114599;79.2;66.2
46;2021-08-17;889;1288;137979;115887;79.7;66.9
46;2021-08-18;769;1051;138748;116938;80.1;67.5
46;2021-08-19;673;1362;139421;118300;80.5;68.3
46;2021-08-20;520;1557;139941;119857;80.8;69.2
46;2021-08-21;378;649;140319;120506;81.0;69.6
46;2021-08-22;2;31;140321;120537;81.0;69.6
46;2021-08-23;424;1204;140745;121741;81.3;70.3
46;2021-08-24;554;1338;141299;123079;81.6;71.1
46;2021-08-25;530;1398;141829;124477;81.9;71.9
46;2021-08-26;392;1095;142221;125572;82.1;72.5
46;2021-08-27;436;1912;142657;127484;82.4;73.6
46;2021-08-28;272;652;142929;128136;82.5;74.0
46;2021-08-29;5;11;142934;128147;82.5;74.0
46;2021-08-30;295;1112;143229;129259;82.7;74.6
46;2021-08-31;340;1239;143569;130498;82.9;75.4
46;2021-09-01;393;1083;143962;131581;83.1;76.0
46;2021-09-02;271;963;144233;132544;83.3;76.5
46;2021-09-03;322;1155;144555;133699;83.5;77.2
46;2021-09-04;188;635;144743;134334;83.6;77.6
46;2021-09-05;8;15;144751;134349;83.6;77.6
46;2021-09-06;219;655;144970;135004;83.7;78.0
46;2021-09-07;252;683;145222;135687;83.9;78.4
46;2021-09-08;277;798;145499;136485;84.0;78.8
46;2021-09-09;201;530;145700;137015;84.1;79.1
46;2021-09-10;277;851;145977;137866;84.3;79.6
46;2021-09-11;151;354;146128;138220;84.4;79.8
46;2021-09-12;8;22;146136;138242;84.4;79.8
46;2021-09-13;178;503;146314;138745;84.5;80.1
46;2021-09-14;266;403;146580;139148;84.6;80.4
46;2021-09-15;257;677;146837;139825;84.8;80.7
46;2021-09-16;132;265;146969;140090;84.9;80.9
46;2021-09-17;234;555;147203;140645;85.0;81.2
46;2021-09-18;101;364;147304;141009;85.1;81.4
46;2021-09-19;3;9;147307;141018;85.1;81.4
46;2021-09-20;70;350;147377;141368;85.1;81.6
46;2021-09-21;70;237;147447;141605;85.1;81.8
46;2021-09-22;128;482;147575;142087;85.2;82.1
46;2021-09-23;83;226;147658;142313;85.3;82.2
46;2021-09-24;76;400;147734;142713;85.3;82.4
46;2021-09-25;69;221;147803;142934;85.4;82.5
46;2021-09-26;3;8;147806;142942;85.4;82.5
46;2021-09-27;76;229;147882;143171;85.4;82.7
46;2021-09-28;48;225;147930;143396;85.4;82.8
46;2021-09-29;84;291;148014;143687;85.5;83.0
46;2021-09-30;63;146;148077;143833;85.5;83.1
46;2021-10-01;101;296;148178;144129;85.6;83.2
46;2021-10-02;80;191;148258;144320;85.6;83.3
46;2021-10-03;0;0;148258;144320;85.6;83.3
46;2021-10-04;63;188;148321;144508;85.7;83.5
46;2021-10-05;66;220;148387;144728;85.7;83.6
46;2021-10-06;72;219;148459;144947;85.7;83.7
46;2021-10-07;61;177;148520;145124;85.8;83.8
46;2021-10-08;123;266;148643;145390;85.8;84.0
46;2021-10-09;71;139;148714;145529;85.9;84.0
46;2021-10-10;4;7;148718;145536;85.9;84.0
46;2021-10-11;57;132;148775;145668;85.9;84.1
47;2020-12-27;0;0;0;0;0.0;0.0
47;2020-12-28;0;0;0;0;0.0;0.0
47;2020-12-29;0;0;0;0;0.0;0.0
47;2020-12-30;0;0;0;0;0.0;0.0
47;2020-12-31;0;0;0;0;0.0;0.0
47;2021-01-01;4;0;4;0;0.0;0.0
47;2021-01-02;0;0;4;0;0.0;0.0
47;2021-01-03;0;0;4;0;0.0;0.0
47;2021-01-04;0;0;4;0;0.0;0.0
47;2021-01-05;1;0;5;0;0.0;0.0
47;2021-01-06;0;0;5;0;0.0;0.0
47;2021-01-07;71;1;76;1;0.0;0.0
47;2021-01-08;314;0;390;1;0.1;0.0
47;2021-01-09;113;0;503;1;0.2;0.0
47;2021-01-10;0;0;503;1;0.2;0.0
47;2021-01-11;249;1;752;2;0.2;0.0
47;2021-01-12;327;0;1079;2;0.3;0.0
47;2021-01-13;349;0;1428;2;0.4;0.0
47;2021-01-14;370;4;1798;6;0.5;0.0
47;2021-01-15;287;2;2085;8;0.6;0.0
47;2021-01-16;176;4;2261;12;0.7;0.0
47;2021-01-17;0;0;2261;12;0.7;0.0
47;2021-01-18;487;2;2748;14;0.8;0.0
47;2021-01-19;469;3;3217;17;1.0;0.0
47;2021-01-20;517;1;3734;18;1.1;0.0
47;2021-01-21;586;1;4320;19;1.3;0.0
47;2021-01-22;471;1;4791;20;1.5;0.0
47;2021-01-23;390;0;5181;20;1.6;0.0
47;2021-01-24;0;0;5181;20;1.6;0.0
47;2021-01-25;434;0;5615;20;1.7;0.0
47;2021-01-26;792;7;6407;27;1.9;0.0
47;2021-01-27;731;1;7138;28;2.2;0.0
47;2021-01-28;575;67;7713;95;2.3;0.0
47;2021-01-29;461;170;8174;265;2.5;0.1
47;2021-01-30;301;39;8475;304;2.6;0.1
47;2021-01-31;0;0;8475;304;2.6;0.1
47;2021-02-01;372;117;8847;421;2.7;0.1
47;2021-02-02;759;316;9606;737;2.9;0.2
47;2021-02-03;426;163;10032;900;3.0;0.3
47;2021-02-04;370;317;10402;1217;3.1;0.4
47;2021-02-05;300;309;10702;1526;3.2;0.5
47;2021-02-06;296;99;10998;1625;3.3;0.5
47;2021-02-07;0;0;10998;1625;3.3;0.5
47;2021-02-08;183;285;11181;1910;3.4;0.6
47;2021-02-09;232;258;11413;2168;3.5;0.7
47;2021-02-10;254;245;11667;2413;3.5;0.7
47;2021-02-11;356;378;12023;2791;3.6;0.8
47;2021-02-12;243;412;12266;3203;3.7;1.0
47;2021-02-13;226;111;12492;3314;3.8;1.0
47;2021-02-14;0;0;12492;3314;3.8;1.0
47;2021-02-15;194;382;12686;3696;3.8;1.1
47;2021-02-16;303;588;12989;4284;3.9;1.3
47;2021-02-17;326;455;13315;4739;4.0;1.4
47;2021-02-18;201;597;13516;5336;4.1;1.6
47;2021-02-19;193;365;13709;5701;4.2;1.7
47;2021-02-20;117;268;13826;5969;4.2;1.8
47;2021-02-21;0;0;13826;5969;4.2;1.8
47;2021-02-22;75;406;13901;6375;4.2;1.9
47;2021-02-23;149;651;14050;7026;4.3;2.1
47;2021-02-24;261;564;14311;7590;4.3;2.3
47;2021-02-25;304;412;14615;8002;4.4;2.4
47;2021-02-26;467;323;15082;8325;4.6;2.5
47;2021-02-27;324;213;15406;8538;4.7;2.6
47;2021-02-28;0;0;15406;8538;4.7;2.6
47;2021-03-01;124;398;15530;8936;4.7;2.7
47;2021-03-02;199;366;15729;9302;4.8;2.8
47;2021-03-03;244;350;15973;9652;4.8;2.9
47;2021-03-04;593;333;16566;9985;5.0;3.0
47;2021-03-05;845;287;17411;10272;5.3;3.1
47;2021-03-06;506;193;17917;10465;5.4;3.2
47;2021-03-07;331;6;18248;10471;5.5;3.2
47;2021-03-08;459;227;18707;10698;5.7;3.2
47;2021-03-09;508;494;19215;11192;5.8;3.4
47;2021-03-10;666;301;19881;11493;6.0;3.5
47;2021-03-11;940;383;20821;11876;6.3;3.6
47;2021-03-12;1373;301;22194;12177;6.7;3.7
47;2021-03-13;950;110;23144;12287;7.0;3.7
47;2021-03-14;51;0;23195;12287;7.0;3.7
47;2021-03-15;593;163;23788;12450;7.2;3.8
47;2021-03-16;750;177;24538;12627;7.4;3.8
47;2021-03-17;861;213;25399;12840;7.7;3.9
47;2021-03-18;917;177;26316;13017;8.0;3.9
47;2021-03-19;1272;130;27588;13147;8.4;4.0
47;2021-03-20;1088;60;28676;13207;8.7;4.0
47;2021-03-21;344;1;29020;13208;8.8;4.0
47;2021-03-22;1009;96;30029;13304;9.1;4.0
47;2021-03-23;1146;149;31175;13453;9.4;4.1
47;2021-03-24;1214;133;32389;13586;9.8;4.1
47;2021-03-25;1567;156;33956;13742;10.3;4.2
47;2021-03-26;1882;202;35838;13944;10.8;4.2
47;2021-03-27;980;131;36818;14075;11.1;4.3
47;2021-03-28;699;6;37517;14081;11.4;4.3
47;2021-03-29;1511;82;39028;14163;11.8;4.3
47;2021-03-30;1645;128;40673;14291;12.3;4.3
47;2021-03-31;1605;157;42278;14448;12.8;4.4
47;2021-04-01;1682;270;43960;14718;13.3;4.5
47;2021-04-02;1932;457;45892;15175;13.9;4.6
47;2021-04-03;1202;184;47094;15359;14.3;4.6
47;2021-04-04;475;13;47569;15372;14.4;4.7
47;2021-04-05;1297;61;48866;15433;14.8;4.7
47;2021-04-06;1386;390;50252;15823;15.2;4.8
47;2021-04-07;1698;598;51950;16421;15.7;5.0
47;2021-04-08;1835;480;53785;16901;16.3;5.1
47;2021-04-09;2085;547;55870;17448;16.9;5.3
47;2021-04-10;1565;326;57435;17774;17.4;5.4
47;2021-04-11;530;9;57965;17783;17.5;5.4
47;2021-04-12;1438;617;59403;18400;18.0;5.6
47;2021-04-13;1813;765;61216;19165;18.5;5.8
47;2021-04-14;1750;722;62966;19887;19.1;6.0
47;2021-04-15;2012;849;64978;20736;19.7;6.3
47;2021-04-16;1768;898;66746;21634;20.2;6.5
47;2021-04-17;1471;969;68217;22603;20.7;6.8
47;2021-04-18;23;0;68240;22603;20.7;6.8
47;2021-04-19;1331;932;69571;23535;21.1;7.1
47;2021-04-20;1625;910;71196;24445;21.6;7.4
47;2021-04-21;1623;775;72819;25220;22.0;7.6
47;2021-04-22;1880;1059;74699;26279;22.6;8.0
47;2021-04-23;1729;1077;76428;27356;23.1;8.3
47;2021-04-24;1549;807;77977;28163;23.6;8.5
47;2021-04-25;242;345;78219;28508;23.7;8.6
47;2021-04-26;1491;1366;79710;29874;24.1;9.0
47;2021-04-27;1921;1476;81631;31350;24.7;9.5
47;2021-04-28;2090;1595;83721;32945;25.3;10.0
47;2021-04-29;2532;1514;86253;34459;26.1;10.4
47;2021-04-30;2044;1780;88297;36239;26.7;11.0
47;2021-05-01;2263;986;90560;37225;27.4;11.3
47;2021-05-02;21;358;90581;37583;27.4;11.4
47;2021-05-03;1596;1422;92177;39005;27.9;11.8
47;2021-05-04;1645;1732;93822;40737;28.4;12.3
47;2021-05-05;1926;1643;95748;42380;29.0;12.8
47;2021-05-06;2105;1509;97853;43889;29.6;13.3
47;2021-05-07;2001;1623;99854;45512;30.2;13.8
47;2021-05-08;2097;464;101951;45976;30.9;13.9
47;2021-05-09;24;359;101975;46335;30.9;14.0
47;2021-05-10;1202;1672;103177;48007;31.2;14.5
47;2021-05-11;2172;1987;105349;49994;31.9;15.1
47;2021-05-12;2624;1451;107973;51445;32.7;15.6
47;2021-05-13;2380;656;110353;52101;33.4;15.8
47;2021-05-14;2061;859;112414;52960;34.0;16.0
47;2021-05-15;1934;865;114348;53825;34.6;16.3
47;2021-05-16;367;9;114715;53834;34.7;16.3
47;2021-05-17;1884;1124;116599;54958;35.3;16.6
47;2021-05-18;2359;1140;118958;56098;36.0;17.0
47;2021-05-19;2344;759;121302;56857;36.7;17.2
47;2021-05-20;2589;972;123891;57829;37.5;17.5
47;2021-05-21;1538;1134;125429;58963;38.0;17.8
47;2021-05-22;2369;839;127798;59802;38.7;18.1
47;2021-05-23;25;186;127823;59988;38.7;18.2
47;2021-05-24;1549;237;129372;60225;39.2;18.2
47;2021-05-25;1481;1318;130853;61543;39.6;18.6
47;2021-05-26;1599;1091;132452;62634;40.1;19.0
47;2021-05-27;1944;1269;134396;63903;40.7;19.3
47;2021-05-28;1459;1537;135855;65440;41.1;19.8
47;2021-05-29;1153;1124;137008;66564;41.5;20.2
47;2021-05-30;12;45;137020;66609;41.5;20.2
47;2021-05-31;1868;1424;138888;68033;42.0;20.6
47;2021-06-01;1921;1344;140809;69377;42.6;21.0
47;2021-06-02;2100;1332;142909;70709;43.3;21.4
47;2021-06-03;2486;1613;145395;72322;44.0;21.9
47;2021-06-04;1965;2118;147360;74440;44.6;22.5
47;2021-06-05;1640;1475;149000;75915;45.1;23.0
47;2021-06-06;211;70;149211;75985;45.2;23.0
47;2021-06-07;1659;2239;150870;78224;45.7;23.7
47;2021-06-08;1629;1904;152499;80128;46.2;24.3
47;2021-06-09;1824;2124;154323;82252;46.7;24.9
47;2021-06-10;2377;1620;156700;83872;47.4;25.4
47;2021-06-11;1826;2101;158526;85973;48.0;26.0
47;2021-06-12;1351;2102;159877;88075;48.4;26.7
47;2021-06-13;4;10;159881;88085;48.4;26.7
47;2021-06-14;1281;2444;161162;90529;48.8;27.4
47;2021-06-15;1464;2033;162626;92562;49.2;28.0
47;2021-06-16;1203;2189;163829;94751;49.6;28.7
47;2021-06-17;1657;1524;165486;96275;50.1;29.1
47;2021-06-18;1439;2496;166925;98771;50.5;29.9
47;2021-06-19;1542;2453;168467;101224;51.0;30.6
47;2021-06-20;5;33;168472;101257;51.0;30.7
47;2021-06-21;1136;2513;169608;103770;51.3;31.4
47;2021-06-22;762;2507;170370;106277;51.6;32.2
47;2021-06-23;999;2015;171369;108292;51.9;32.8
47;2021-06-24;1211;1936;172580;110228;52.2;33.4
47;2021-06-25;1006;2608;173586;112836;52.5;34.2
47;2021-06-26;986;2789;174572;115625;52.8;35.0
47;2021-06-27;16;349;174588;115974;52.9;35.1
47;2021-06-28;875;2407;175463;118381;53.1;35.8
47;2021-06-29;797;2313;176260;120694;53.4;36.5
47;2021-06-30;730;2303;176990;122997;53.6;37.2
47;2021-07-01;923;2107;177913;125104;53.9;37.9
47;2021-07-02;885;2274;178798;127378;54.1;38.6
47;2021-07-03;726;3042;179524;130420;54.3;39.5
47;2021-07-04;34;12;179558;130432;54.4;39.5
47;2021-07-05;978;2147;180536;132579;54.7;40.1
47;2021-07-06;1007;1957;181543;134536;55.0;40.7
47;2021-07-07;1298;2064;182841;136600;55.4;41.4
47;2021-07-08;1142;2192;183983;138792;55.7;42.0
47;2021-07-09;1047;2405;185030;141197;56.0;42.7
47;2021-07-10;951;2131;185981;143328;56.3;43.4
47;2021-07-11;1;6;185982;143334;56.3;43.4
47;2021-07-12;556;2580;186538;145914;56.5;44.2
47;2021-07-13;1094;2585;187632;148499;56.8;45.0
47;2021-07-14;1165;1577;188797;150076;57.2;45.4
47;2021-07-15;1717;3135;190514;153211;57.7;46.4
47;2021-07-16;1722;2677;192236;155888;58.2;47.2
47;2021-07-17;1201;2458;193437;158346;58.6;47.9
47;2021-07-18;36;188;193473;158534;58.6;48.0
47;2021-07-19;1113;2561;194586;161095;58.9;48.8
47;2021-07-20;1638;2341;196224;163436;59.4;49.5
47;2021-07-21;2192;2240;198416;165676;60.1;50.2
47;2021-07-22;2157;2298;200573;167974;60.7;50.8
47;2021-07-23;2124;2251;202697;170225;61.4;51.5
47;2021-07-24;1114;1915;203811;172140;61.7;52.1
47;2021-07-25;20;1;203831;172141;61.7;52.1
47;2021-07-26;1236;1946;205067;174087;62.1;52.7
47;2021-07-27;2123;1633;207190;175720;62.7;53.2
47;2021-07-28;1880;1606;209070;177326;63.3;53.7
47;2021-07-29;2340;1605;211410;178931;64.0;54.2
47;2021-07-30;1865;1627;213275;180558;64.6;54.7
47;2021-07-31;1486;1668;214761;182226;65.0;55.2
47;2021-08-01;18;8;214779;182234;65.0;55.2
47;2021-08-02;2053;1219;216832;183453;65.6;55.5
47;2021-08-03;2159;1106;218991;184559;66.3;55.9
47;2021-08-04;2192;1528;221183;186087;67.0;56.3
47;2021-08-05;2408;1447;223591;187534;67.7;56.8
47;2021-08-06;1999;1841;225590;189375;68.3;57.3
47;2021-08-07;1628;1418;227218;190793;68.8;57.8
47;2021-08-08;24;22;227242;190815;68.8;57.8
47;2021-08-09;1883;1214;229125;192029;69.4;58.1
47;2021-08-10;1920;1298;231045;193327;69.9;58.5
47;2021-08-11;1804;1401;232849;194728;70.5;58.9
47;2021-08-12;2059;1340;234908;196068;71.1;59.4
47;2021-08-13;1424;1668;236332;197736;71.5;59.9
47;2021-08-14;1349;1443;237681;199179;72.0;60.3
47;2021-08-15;11;18;237692;199197;72.0;60.3
47;2021-08-16;1436;1445;239128;200642;72.4;60.7
47;2021-08-17;1124;1684;240252;202326;72.7;61.2
47;2021-08-18;1181;1714;241433;204040;73.1;61.8
47;2021-08-19;1039;1813;242472;205853;73.4;62.3
47;2021-08-20;972;1708;243444;207561;73.7;62.8
47;2021-08-21;829;1277;244273;208838;73.9;63.2
47;2021-08-22;19;31;244292;208869;74.0;63.2
47;2021-08-23;614;1826;244906;210695;74.1;63.8
47;2021-08-24;811;1622;245717;212317;74.4;64.3
47;2021-08-25;811;1787;246528;214104;74.6;64.8
47;2021-08-26;741;2080;247269;216184;74.9;65.4
47;2021-08-27;700;1979;247969;218163;75.1;66.0
47;2021-08-28;568;1670;248537;219833;75.2;66.5
47;2021-08-29;2;16;248539;219849;75.2;66.6
47;2021-08-30;459;1908;248998;221757;75.4;67.1
47;2021-08-31;583;1793;249581;223550;75.6;67.7
47;2021-09-01;422;1956;250003;225506;75.7;68.3
47;2021-09-02;436;1945;250439;227451;75.8;68.9
47;2021-09-03;504;1845;250943;229296;76.0;69.4
47;2021-09-04;479;1743;251422;231039;76.1;69.9
47;2021-09-05;12;35;251434;231074;76.1;70.0
47;2021-09-06;343;1251;251777;232325;76.2;70.3
47;2021-09-07;478;1114;252255;233439;76.4;70.7
47;2021-09-08;419;1484;252674;234923;76.5;71.1
47;2021-09-09;423;1098;253097;236021;76.6;71.4
47;2021-09-10;472;1163;253569;237184;76.8;71.8
47;2021-09-11;438;1373;254007;238557;76.9;72.2
47;2021-09-12;3;6;254010;238563;76.9;72.2
47;2021-09-13;255;731;254265;239294;77.0;72.4
47;2021-09-14;402;797;254667;240091;77.1;72.7
47;2021-09-15;342;940;255009;241031;77.2;73.0
47;2021-09-16;324;560;255333;241591;77.3;73.1
47;2021-09-17;398;646;255731;242237;77.4;73.3
47;2021-09-18;263;956;255994;243193;77.5;73.6
47;2021-09-19;4;4;255998;243197;77.5;73.6
47;2021-09-20;166;470;256164;243667;77.5;73.8
47;2021-09-21;285;454;256449;244121;77.6;73.9
47;2021-09-22;214;616;256663;244737;77.7;74.1
47;2021-09-23;209;378;256872;245115;77.8;74.2
47;2021-09-24;283;614;257155;245729;77.8;74.4
47;2021-09-25;215;628;257370;246357;77.9;74.6
47;2021-09-26;6;6;257376;246363;77.9;74.6
47;2021-09-27;112;377;257488;246740;77.9;74.7
47;2021-09-28;127;374;257615;247114;78.0;74.8
47;2021-09-29;148;473;257763;247587;78.0;75.0
47;2021-09-30;160;355;257923;247942;78.1;75.1
47;2021-10-01;182;519;258105;248461;78.1;75.2
47;2021-10-02;194;485;258299;248946;78.2;75.4
47;2021-10-03;0;5;258299;248951;78.2;75.4
47;2021-10-04;132;362;258431;249313;78.2;75.5
47;2021-10-05;110;307;258541;249620;78.3;75.6
47;2021-10-06;225;459;258766;250079;78.3;75.7
47;2021-10-07;155;367;258921;250446;78.4;75.8
47;2021-10-08;171;413;259092;250859;78.4;75.9
47;2021-10-09;236;375;259328;251234;78.5;76.1
47;2021-10-10;0;3;259328;251237;78.5;76.1
47;2021-10-11;139;207;259467;251444;78.5;76.1
48;2020-12-27;0;0;0;0;0.0;0.0
48;2020-12-28;0;0;0;0;0.0;0.0
48;2020-12-29;0;0;0;0;0.0;0.0
48;2020-12-30;0;0;0;0;0.0;0.0
48;2020-12-31;0;0;0;0;0.0;0.0
48;2021-01-01;0;0;0;0;0.0;0.0
48;2021-01-02;0;0;0;0;0.0;0.0
48;2021-01-03;0;0;0;0;0.0;0.0
48;2021-01-04;0;0;0;0;0.0;0.0
48;2021-01-05;0;0;0;0;0.0;0.0
48;2021-01-06;0;0;0;0;0.0;0.0
48;2021-01-07;56;0;56;0;0.1;0.0
48;2021-01-08;88;1;144;1;0.2;0.0
48;2021-01-09;1;0;145;1;0.2;0.0
48;2021-01-10;0;0;145;1;0.2;0.0
48;2021-01-11;13;0;158;1;0.2;0.0
48;2021-01-12;20;1;178;2;0.2;0.0
48;2021-01-13;104;0;282;2;0.4;0.0
48;2021-01-14;90;1;372;3;0.5;0.0
48;2021-01-15;63;0;435;3;0.6;0.0
48;2021-01-16;0;0;435;3;0.6;0.0
48;2021-01-17;0;0;435;3;0.6;0.0
48;2021-01-18;117;0;552;3;0.7;0.0
48;2021-01-19;345;2;897;5;1.2;0.0
48;2021-01-20;364;0;1261;5;1.7;0.0
48;2021-01-21;466;1;1727;6;2.3;0.0
48;2021-01-22;269;0;1996;6;2.6;0.0
48;2021-01-23;36;0;2032;6;2.7;0.0
48;2021-01-24;0;0;2032;6;2.7;0.0
48;2021-01-25;109;2;2141;8;2.8;0.0
48;2021-01-26;261;0;2402;8;3.1;0.0
48;2021-01-27;257;2;2659;10;3.5;0.0
48;2021-01-28;273;11;2932;21;3.8;0.0
48;2021-01-29;175;60;3107;81;4.1;0.1
48;2021-01-30;1;7;3108;88;4.1;0.1
48;2021-01-31;0;6;3108;94;4.1;0.1
48;2021-02-01;100;48;3208;142;4.2;0.2
48;2021-02-02;194;36;3402;178;4.5;0.2
48;2021-02-03;177;82;3579;260;4.7;0.3
48;2021-02-04;234;14;3813;274;5.0;0.4
48;2021-02-05;145;37;3958;311;5.2;0.4
48;2021-02-06;34;1;3992;312;5.2;0.4
48;2021-02-07;0;0;3992;312;5.2;0.4
48;2021-02-08;50;60;4042;372;5.3;0.5
48;2021-02-09;66;167;4108;539;5.4;0.7
48;2021-02-10;64;303;4172;842;5.5;1.1
48;2021-02-11;165;407;4337;1249;5.7;1.6
48;2021-02-12;120;155;4457;1404;5.8;1.8
48;2021-02-13;8;55;4465;1459;5.9;1.9
48;2021-02-14;0;0;4465;1459;5.9;1.9
48;2021-02-15;51;106;4516;1565;5.9;2.1
48;2021-02-16;43;173;4559;1738;6.0;2.3
48;2021-02-17;35;284;4594;2022;6.0;2.7
48;2021-02-18;252;113;4846;2135;6.4;2.8
48;2021-02-19;60;183;4906;2318;6.4;3.0
48;2021-02-20;0;1;4906;2319;6.4;3.0
48;2021-02-21;0;14;4906;2333;6.4;3.1
48;2021-02-22;24;129;4930;2462;6.5;3.2
48;2021-02-23;74;221;5004;2683;6.6;3.5
48;2021-02-24;68;265;5072;2948;6.6;3.9
48;2021-02-25;148;263;5220;3211;6.8;4.2
48;2021-02-26;51;229;5271;3440;6.9;4.5
48;2021-02-27;28;1;5299;3441;6.9;4.5
48;2021-02-28;3;14;5302;3455;7.0;4.5
48;2021-03-01;102;97;5404;3552;7.1;4.7
48;2021-03-02;199;87;5603;3639;7.3;4.8
48;2021-03-03;153;109;5756;3748;7.5;4.9
48;2021-03-04;195;184;5951;3932;7.8;5.2
48;2021-03-05;136;141;6087;4073;8.0;5.3
48;2021-03-06;180;53;6267;4126;8.2;5.4
48;2021-03-07;75;2;6342;4128;8.3;5.4
48;2021-03-08;352;148;6694;4276;8.8;5.6
48;2021-03-09;377;106;7071;4382;9.3;5.7
48;2021-03-10;263;61;7334;4443;9.6;5.8
48;2021-03-11;334;91;7668;4534;10.1;5.9
48;2021-03-12;256;153;7924;4687;10.4;6.1
48;2021-03-13;301;5;8225;4692;10.8;6.2
48;2021-03-14;8;0;8233;4692;10.8;6.2
48;2021-03-15;174;64;8407;4756;11.0;6.2
48;2021-03-16;167;66;8574;4822;11.2;6.3
48;2021-03-17;156;110;8730;4932;11.4;6.5
48;2021-03-18;191;104;8921;5036;11.7;6.6
48;2021-03-19;116;96;9037;5132;11.8;6.7
48;2021-03-20;101;0;9138;5132;12.0;6.7
48;2021-03-21;0;0;9138;5132;12.0;6.7
48;2021-03-22;160;21;9298;5153;12.2;6.8
48;2021-03-23;329;103;9627;5256;12.6;6.9
48;2021-03-24;284;100;9911;5356;13.0;7.0
48;2021-03-25;757;123;10668;5479;14.0;7.2
48;2021-03-26;269;62;10937;5541;14.3;7.3
48;2021-03-27;104;1;11041;5542;14.5;7.3
48;2021-03-28;80;21;11121;5563;14.6;7.3
48;2021-03-29;305;81;11426;5644;15.0;7.4
48;2021-03-30;364;132;11790;5776;15.5;7.6
48;2021-03-31;448;88;12238;5864;16.0;7.7
48;2021-04-01;732;73;12970;5937;17.0;7.8
48;2021-04-02;487;136;13457;6073;17.6;8.0
48;2021-04-03;140;83;13597;6156;17.8;8.1
48;2021-04-04;0;0;13597;6156;17.8;8.1
48;2021-04-05;43;1;13640;6157;17.9;8.1
48;2021-04-06;465;160;14105;6317;18.5;8.3
48;2021-04-07;465;142;14570;6459;19.1;8.5
48;2021-04-08;620;188;15190;6647;19.9;8.7
48;2021-04-09;446;123;15636;6770;20.5;8.9
48;2021-04-10;95;60;15731;6830;20.6;9.0
48;2021-04-11;2;0;15733;6830;20.6;9.0
48;2021-04-12;364;71;16097;6901;21.1;9.0
48;2021-04-13;361;92;16458;6993;21.6;9.2
48;2021-04-14;624;187;17082;7180;22.4;9.4
48;2021-04-15;701;363;17783;7543;23.3;9.9
48;2021-04-16;538;229;18321;7772;24.0;10.2
48;2021-04-17;89;73;18410;7845;24.1;10.3
48;2021-04-18;0;0;18410;7845;24.1;10.3
48;2021-04-19;196;106;18606;7951;24.4;10.4
48;2021-04-20;216;182;18822;8133;24.7;10.7
48;2021-04-21;284;207;19106;8340;25.0;10.9
48;2021-04-22;306;482;19412;8822;25.4;11.6
48;2021-04-23;255;242;19667;9064;25.8;11.9
48;2021-04-24;97;95;19764;9159;25.9;12.0
48;2021-04-25;1;9;19765;9168;25.9;12.0
48;2021-04-26;87;211;19852;9379;26.0;12.3
48;2021-04-27;172;292;20024;9671;26.2;12.7
48;2021-04-28;149;415;20173;10086;26.4;13.2
48;2021-04-29;203;490;20376;10576;26.7;13.9
48;2021-04-30;172;226;20548;10802;26.9;14.2
48;2021-05-01;0;0;20548;10802;26.9;14.2
48;2021-05-02;0;0;20548;10802;26.9;14.2
48;2021-05-03;106;386;20654;11188;27.1;14.7
48;2021-05-04;227;421;20881;11609;27.4;15.2
48;2021-05-05;84;486;20965;12095;27.5;15.9
48;2021-05-06;775;642;21740;12737;28.5;16.7
48;2021-05-07;96;503;21836;13240;28.6;17.4
48;2021-05-08;309;43;22145;13283;29.0;17.4
48;2021-05-09;285;9;22430;13292;29.4;17.4
48;2021-05-10;55;325;22485;13617;29.5;17.8
48;2021-05-11;221;290;22706;13907;29.8;18.2
48;2021-05-12;249;313;22955;14220;30.1;18.6
48;2021-05-13;472;158;23427;14378;30.7;18.8
48;2021-05-14;244;222;23671;14600;31.0;19.1
48;2021-05-15;84;46;23755;14646;31.1;19.2
48;2021-05-16;1;6;23756;14652;31.1;19.2
48;2021-05-17;474;267;24230;14919;31.8;19.6
48;2021-05-18;263;229;24493;15148;32.1;19.9
48;2021-05-19;207;277;24700;15425;32.4;20.2
48;2021-05-20;318;256;25018;15681;32.8;20.6
48;2021-05-21;174;267;25192;15948;33.0;20.9
48;2021-05-22;25;50;25217;15998;33.1;21.0
48;2021-05-23;0;6;25217;16004;33.1;21.0
48;2021-05-24;0;14;25217;16018;33.1;21.0
48;2021-05-25;181;267;25398;16285;33.3;21.3
48;2021-05-26;416;298;25814;16583;33.8;21.7
48;2021-05-27;1178;380;26992;16963;35.4;22.2
48;2021-05-28;315;350;27307;17313;35.8;22.7
48;2021-05-29;79;50;27386;17363;35.9;22.8
48;2021-05-30;0;1;27386;17364;35.9;22.8
48;2021-05-31;624;263;28010;17627;36.7;23.1
48;2021-06-01;272;305;28282;17932;37.1;23.5
48;2021-06-02;407;424;28689;18356;37.6;24.1
48;2021-06-03;629;431;29318;18787;38.4;24.6
48;2021-06-04;291;283;29609;19070;38.8;25.0
48;2021-06-05;121;77;29730;19147;39.0;25.1
48;2021-06-06;1;1;29731;19148;39.0;25.1
48;2021-06-07;440;161;30171;19309;39.5;25.3
48;2021-06-08;616;309;30787;19618;40.4;25.7
48;2021-06-09;379;190;31166;19808;40.9;26.0
48;2021-06-10;1003;242;32169;20050;42.2;26.3
48;2021-06-11;371;161;32540;20211;42.7;26.5
48;2021-06-12;74;57;32614;20268;42.8;26.6
48;2021-06-13;0;2;32614;20270;42.8;26.6
48;2021-06-14;124;115;32738;20385;42.9;26.7
48;2021-06-15;407;386;33145;20771;43.4;27.2
48;2021-06-16;260;144;33405;20915;43.8;27.4
48;2021-06-17;486;575;33891;21490;44.4;28.2
48;2021-06-18;254;315;34145;21805;44.8;28.6
48;2021-06-19;35;291;34180;22096;44.8;29.0
48;2021-06-20;123;224;34303;22320;45.0;29.3
48;2021-06-21;125;134;34428;22454;45.1;29.4
48;2021-06-22;258;335;34686;22789;45.5;29.9
48;2021-06-23;111;545;34797;23334;45.6;30.6
48;2021-06-24;364;610;35161;23944;46.1;31.4
48;2021-06-25;154;276;35315;24220;46.3;31.7
48;2021-06-26;15;45;35330;24265;46.3;31.8
48;2021-06-27;1;1;35331;24266;46.3;31.8
48;2021-06-28;81;177;35412;24443;46.4;32.0
48;2021-06-29;297;415;35709;24858;46.8;32.6
48;2021-06-30;98;465;35807;25323;46.9;33.2
48;2021-07-01;194;669;36001;25992;47.2;34.1
48;2021-07-02;148;369;36149;26361;47.4;34.6
48;2021-07-03;42;89;36191;26450;47.4;34.7
48;2021-07-04;7;0;36198;26450;47.5;34.7
48;2021-07-05;40;117;36238;26567;47.5;34.8
48;2021-07-06;277;598;36515;27165;47.9;35.6
48;2021-07-07;201;489;36716;27654;48.1;36.3
48;2021-07-08;223;1189;36939;28843;48.4;37.8
48;2021-07-09;159;553;37098;29396;48.6;38.5
48;2021-07-10;95;147;37193;29543;48.8;38.7
48;2021-07-11;0;4;37193;29547;48.8;38.7
48;2021-07-12;139;672;37332;30219;48.9;39.6
48;2021-07-13;211;430;37543;30649;49.2;40.2
48;2021-07-14;179;145;37722;30794;49.4;40.4
48;2021-07-15;187;459;37909;31253;49.7;41.0
48;2021-07-16;234;315;38143;31568;50.0;41.4
48;2021-07-17;129;118;38272;31686;50.2;41.5
48;2021-07-18;4;5;38276;31691;50.2;41.5
48;2021-07-19;105;306;38381;31997;50.3;41.9
48;2021-07-20;677;993;39058;32990;51.2;43.2
48;2021-07-21;68;371;39126;33361;51.3;43.7
48;2021-07-22;777;1125;39903;34486;52.3;45.2
48;2021-07-23;367;439;40270;34925;52.8;45.8
48;2021-07-24;509;170;40779;35095;53.5;46.0
48;2021-07-25;138;46;40917;35141;53.6;46.1
48;2021-07-26;101;199;41018;35340;53.8;46.3
48;2021-07-27;1195;644;42213;35984;55.3;47.2
48;2021-07-28;177;316;42390;36300;55.6;47.6
48;2021-07-29;716;646;43106;36946;56.5;48.4
48;2021-07-30;200;292;43306;37238;56.8;48.8
48;2021-07-31;339;178;43645;37416;57.2;49.0
48;2021-08-01;18;55;43663;37471;57.2;49.1
48;2021-08-02;228;164;43891;37635;57.5;49.3
48;2021-08-03;925;575;44816;38210;58.7;50.1
48;2021-08-04;328;220;45144;38430;59.2;50.4
48;2021-08-05;674;475;45818;38905;60.1;51.0
48;2021-08-06;442;275;46260;39180;60.6;51.4
48;2021-08-07;249;125;46509;39305;61.0;51.5
48;2021-08-08;2;5;46511;39310;61.0;51.5
48;2021-08-09;170;141;46681;39451;61.2;51.7
48;2021-08-10;726;555;47407;40006;62.1;52.4
48;2021-08-11;295;238;47702;40244;62.5;52.8
48;2021-08-12;419;415;48121;40659;63.1;53.3
48;2021-08-13;229;212;48350;40871;63.4;53.6
48;2021-08-14;137;165;48487;41036;63.6;53.8
48;2021-08-15;131;81;48618;41117;63.7;53.9
48;2021-08-16;121;192;48739;41309;63.9;54.2
48;2021-08-17;364;1188;49103;42497;64.4;55.7
48;2021-08-18;211;201;49314;42698;64.6;56.0
48;2021-08-19;240;325;49554;43023;65.0;56.4
48;2021-08-20;215;284;49769;43307;65.2;56.8
48;2021-08-21;85;232;49854;43539;65.4;57.1
48;2021-08-22;0;0;49854;43539;65.4;57.1
48;2021-08-23;65;153;49919;43692;65.4;57.3
48;2021-08-24;308;952;50227;44644;65.8;58.5
48;2021-08-25;156;351;50383;44995;66.0;59.0
48;2021-08-26;180;499;50563;45494;66.3;59.6
48;2021-08-27;153;338;50716;45832;66.5;60.1
48;2021-08-28;127;303;50843;46135;66.6;60.5
48;2021-08-29;0;1;50843;46136;66.6;60.5
48;2021-08-30;54;143;50897;46279;66.7;60.7
48;2021-08-31;257;1051;51154;47330;67.1;62.0
48;2021-09-01;125;334;51279;47664;67.2;62.5
48;2021-09-02;131;388;51410;48052;67.4;63.0
48;2021-09-03;138;297;51548;48349;67.6;63.4
48;2021-09-04;121;208;51669;48557;67.7;63.7
48;2021-09-05;3;25;51672;48582;67.7;63.7
48;2021-09-06;34;178;51706;48760;67.8;63.9
48;2021-09-07;160;347;51866;49107;68.0;64.4
48;2021-09-08;96;181;51962;49288;68.1;64.6
48;2021-09-09;96;235;52058;49523;68.2;64.9
48;2021-09-10;128;263;52186;49786;68.4;65.3
48;2021-09-11;89;195;52275;49981;68.5;65.5
48;2021-09-12;1;2;52276;49983;68.5;65.5
48;2021-09-13;78;66;52354;50049;68.6;65.6
48;2021-09-14;205;259;52559;50308;68.9;65.9
48;2021-09-15;68;164;52627;50472;69.0;66.2
48;2021-09-16;122;220;52749;50692;69.1;66.4
48;2021-09-17;101;183;52850;50875;69.3;66.7
48;2021-09-18;33;90;52883;50965;69.3;66.8
48;2021-09-19;0;0;52883;50965;69.3;66.8
48;2021-09-20;29;88;52912;51053;69.4;66.9
48;2021-09-21;63;183;52975;51236;69.4;67.2
48;2021-09-22;49;151;53024;51387;69.5;67.4
48;2021-09-23;28;100;53052;51487;69.5;67.5
48;2021-09-24;43;118;53095;51605;69.6;67.6
48;2021-09-25;27;78;53122;51683;69.6;67.7
48;2021-09-26;1;0;53123;51683;69.6;67.7
48;2021-09-27;11;43;53134;51726;69.7;67.8
48;2021-09-28;66;155;53200;51881;69.7;68.0
48;2021-09-29;51;133;53251;52014;69.8;68.2
48;2021-09-30;42;87;53293;52101;69.9;68.3
48;2021-10-01;56;141;53349;52242;69.9;68.5
48;2021-10-02;33;51;53382;52293;70.0;68.5
48;2021-10-03;0;1;53382;52294;70.0;68.5
48;2021-10-04;19;62;53401;52356;70.0;68.6
48;2021-10-05;48;151;53449;52507;70.1;68.8
48;2021-10-06;65;94;53514;52601;70.1;69.0
48;2021-10-07;33;112;53547;52713;70.2;69.1
48;2021-10-08;37;113;53584;52826;70.2;69.2
48;2021-10-09;14;55;53598;52881;70.3;69.3
48;2021-10-10;0;1;53598;52882;70.3;69.3
48;2021-10-11;6;25;53604;52907;70.3;69.4
49;2020-12-27;0;0;0;0;0.0;0.0
49;2020-12-28;2;0;2;0;0.0;0.0
49;2020-12-29;0;0;2;0;0.0;0.0
49;2020-12-30;0;0;2;0;0.0;0.0
49;2020-12-31;0;0;2;0;0.0;0.0
49;2021-01-01;2;0;4;0;0.0;0.0
49;2021-01-02;1;1;5;1;0.0;0.0
49;2021-01-03;0;0;5;1;0.0;0.0
49;2021-01-04;10;0;15;1;0.0;0.0
49;2021-01-05;92;0;107;1;0.0;0.0
49;2021-01-06;233;0;340;1;0.0;0.0
49;2021-01-07;367;1;707;2;0.1;0.0
49;2021-01-08;328;1;1035;3;0.1;0.0
49;2021-01-09;118;0;1153;3;0.1;0.0
49;2021-01-10;114;0;1267;3;0.2;0.0
49;2021-01-11;287;0;1554;3;0.2;0.0
49;2021-01-12;623;0;2177;3;0.3;0.0
49;2021-01-13;602;2;2779;5;0.3;0.0
49;2021-01-14;590;7;3369;12;0.4;0.0
49;2021-01-15;764;1;4133;13;0.5;0.0
49;2021-01-16;148;0;4281;13;0.5;0.0
49;2021-01-17;111;2;4392;15;0.5;0.0
49;2021-01-18;691;0;5083;15;0.6;0.0
49;2021-01-19;1204;8;6287;23;0.8;0.0
49;2021-01-20;1511;7;7798;30;1.0;0.0
49;2021-01-21;1943;14;9741;44;1.2;0.0
49;2021-01-22;1305;6;11046;50;1.4;0.0
49;2021-01-23;263;1;11309;51;1.4;0.0
49;2021-01-24;1;0;11310;51;1.4;0.0
49;2021-01-25;552;5;11862;56;1.5;0.0
49;2021-01-26;989;75;12851;131;1.6;0.0
49;2021-01-27;1860;50;14711;181;1.8;0.0
49;2021-01-28;2877;91;17588;272;2.2;0.0
49;2021-01-29;1588;92;19176;364;2.4;0.0
49;2021-01-30;300;46;19476;410;2.4;0.1
49;2021-01-31;62;51;19538;461;2.4;0.1
49;2021-02-01;661;163;20199;624;2.5;0.1
49;2021-02-02;744;384;20943;1008;2.6;0.1
49;2021-02-03;677;382;21620;1390;2.6;0.2
49;2021-02-04;758;445;22378;1835;2.7;0.2
49;2021-02-05;708;590;23086;2425;2.8;0.3
49;2021-02-06;228;111;23314;2536;2.9;0.3
49;2021-02-07;59;84;23373;2620;2.9;0.3
49;2021-02-08;549;480;23922;3100;2.9;0.4
49;2021-02-09;716;648;24638;3748;3.0;0.5
49;2021-02-10;807;950;25445;4698;3.1;0.6
49;2021-02-11;1028;1410;26473;6108;3.2;0.7
49;2021-02-12;869;961;27342;7069;3.4;0.9
49;2021-02-13;266;120;27608;7189;3.4;0.9
49;2021-02-14;9;106;27617;7295;3.4;0.9
49;2021-02-15;730;664;28347;7959;3.5;1.0
49;2021-02-16;1106;1121;29453;9080;3.6;1.1
49;2021-02-17;1160;1873;30613;10953;3.8;1.3
49;2021-02-18;1811;2438;32424;13391;4.0;1.6
49;2021-02-19;1397;1108;33821;14499;4.1;1.8
49;2021-02-20;232;381;34053;14880;4.2;1.8
49;2021-02-21;0;64;34053;14944;4.2;1.8
49;2021-02-22;647;573;34700;15517;4.3;1.9
49;2021-02-23;734;856;35434;16373;4.3;2.0
49;2021-02-24;824;641;36258;17014;4.4;2.1
49;2021-02-25;1208;809;37466;17823;4.6;2.2
49;2021-02-26;1678;848;39144;18671;4.8;2.3
49;2021-02-27;435;282;39579;18953;4.9;2.3
49;2021-02-28;49;38;39628;18991;4.9;2.3
49;2021-03-01;768;587;40396;19578;5.0;2.4
49;2021-03-02;1082;701;41478;20279;5.1;2.5
49;2021-03-03;1559;676;43037;20955;5.3;2.6
49;2021-03-04;1769;942;44806;21897;5.5;2.7
49;2021-03-05;2215;700;47021;22597;5.8;2.8
49;2021-03-06;717;190;47738;22787;5.9;2.8
49;2021-03-07;627;13;48365;22800;5.9;2.8
49;2021-03-08;1398;717;49763;23517;6.1;2.9
49;2021-03-09;2052;744;51815;24261;6.4;3.0
49;2021-03-10;2530;874;54345;25135;6.7;3.1
49;2021-03-11;3195;1476;57540;26611;7.1;3.3
49;2021-03-12;3766;1025;61306;27636;7.5;3.4
49;2021-03-13;1501;218;62807;27854;7.7;3.4
49;2021-03-14;6;0;62813;27854;7.7;3.4
49;2021-03-15;2083;536;64896;28390;8.0;3.5
49;2021-03-16;1732;964;66628;29354;8.2;3.6
49;2021-03-17;1810;681;68438;30035;8.4;3.7
49;2021-03-18;2205;736;70643;30771;8.7;3.8
49;2021-03-19;3333;567;73976;31338;9.1;3.8
49;2021-03-20;1743;211;75719;31549;9.3;3.9
49;2021-03-21;499;22;76218;31571;9.3;3.9
49;2021-03-22;2248;554;78466;32125;9.6;3.9
49;2021-03-23;3406;688;81872;32813;10.0;4.0
49;2021-03-24;3603;506;85475;33319;10.5;4.1
49;2021-03-25;4225;654;89700;33973;11.0;4.2
49;2021-03-26;4886;513;94586;34486;11.6;4.2
49;2021-03-27;1675;104;96261;34590;11.8;4.2
49;2021-03-28;400;28;96661;34618;11.8;4.2
49;2021-03-29;2371;613;99032;35231;12.1;4.3
49;2021-03-30;3267;947;102299;36178;12.5;4.4
49;2021-03-31;2980;754;105279;36932;12.9;4.5
49;2021-04-01;4117;877;109396;37809;13.4;4.6
49;2021-04-02;4297;964;113693;38773;13.9;4.8
49;2021-04-03;971;193;114664;38966;14.1;4.8
49;2021-04-04;315;3;114979;38969;14.1;4.8
49;2021-04-05;944;23;115923;38992;14.2;4.8
49;2021-04-06;2329;1327;118252;40319;14.5;4.9
49;2021-04-07;3309;1372;121561;41691;14.9;5.1
49;2021-04-08;5186;1436;126747;43127;15.5;5.3
49;2021-04-09;6207;1444;132954;44571;16.3;5.5
49;2021-04-10;2065;502;135019;45073;16.5;5.5
49;2021-04-11;390;9;135409;45082;16.6;5.5
49;2021-04-12;4073;1583;139482;46665;17.1;5.7
49;2021-04-13;5380;1921;144862;48586;17.8;6.0
49;2021-04-14;4542;1882;149404;50468;18.3;6.2
49;2021-04-15;5381;1894;154785;52362;19.0;6.4
49;2021-04-16;5761;2145;160546;54507;19.7;6.7
49;2021-04-17;3335;855;163881;55362;20.1;6.8
49;2021-04-18;381;476;164262;55838;20.1;6.8
49;2021-04-19;3710;2061;167972;57899;20.6;7.1
49;2021-04-20;4371;2112;172343;60011;21.1;7.4
49;2021-04-21;3955;2209;176298;62220;21.6;7.6
49;2021-04-22;4837;2115;181135;64335;22.2;7.9
49;2021-04-23;4814;2339;185949;66674;22.8;8.2
49;2021-04-24;2938;1159;188887;67833;23.2;8.3
49;2021-04-25;40;282;188927;68115;23.2;8.3
49;2021-04-26;3744;2113;192671;70228;23.6;8.6
49;2021-04-27;4472;2512;197143;72740;24.2;8.9
49;2021-04-28;4615;2501;201758;75241;24.7;9.2
49;2021-04-29;5206;3027;206964;78268;25.4;9.6
49;2021-04-30;5558;3217;212522;81485;26.0;10.0
49;2021-05-01;2365;667;214887;82152;26.3;10.1
49;2021-05-02;5;40;214892;82192;26.3;10.1
49;2021-05-03;5012;2407;219904;84599;27.0;10.4
49;2021-05-04;4972;3047;224876;87646;27.6;10.7
49;2021-05-05;4789;3008;229665;90654;28.1;11.1
49;2021-05-06;5328;3099;234993;93753;28.8;11.5
49;2021-05-07;4281;5031;239274;98784;29.3;12.1
49;2021-05-08;3577;440;242851;99224;29.8;12.2
49;2021-05-09;10;41;242861;99265;29.8;12.2
49;2021-05-10;4829;4282;247690;103547;30.4;12.7
49;2021-05-11;5397;5092;253087;108639;31.0;13.3
49;2021-05-12;4800;4595;257887;113234;31.6;13.9
49;2021-05-13;4778;691;262665;113925;32.2;14.0
49;2021-05-14;5170;3272;267835;117197;32.8;14.4
49;2021-05-15;4157;1806;271992;119003;33.3;14.6
49;2021-05-16;2786;119;274778;119122;33.7;14.6
49;2021-05-17;4835;3692;279613;122814;34.3;15.1
49;2021-05-18;5472;3769;285085;126583;34.9;15.5
49;2021-05-19;5916;3228;291001;129811;35.7;15.9
49;2021-05-20;6807;2966;297808;132777;36.5;16.3
49;2021-05-21;6450;3746;304258;136523;37.3;16.7
49;2021-05-22;5183;1199;309441;137722;37.9;16.9
49;2021-05-23;1;12;309442;137734;37.9;16.9
49;2021-05-24;4212;448;313654;138182;38.4;16.9
49;2021-05-25;6326;3308;319980;141490;39.2;17.3
49;2021-05-26;6273;2665;326253;144155;40.0;17.7
49;2021-05-27;7114;2728;333367;146883;40.9;18.0
49;2021-05-28;6875;4028;340242;150911;41.7;18.5
49;2021-05-29;5023;1901;345265;152812;42.3;18.7
49;2021-05-30;21;14;345286;152826;42.3;18.7
49;2021-05-31;6036;3221;351322;156047;43.1;19.1
49;2021-06-01;6592;3991;357914;160038;43.9;19.6
49;2021-06-02;5794;3742;363708;163780;44.6;20.1
49;2021-06-03;6602;3421;370310;167201;45.4;20.5
49;2021-06-04;6470;4867;376780;172068;46.2;21.1
49;2021-06-05;4385;2698;381165;174766;46.7;21.4
49;2021-06-06;39;50;381204;174816;46.7;21.4
49;2021-06-07;4634;4761;385838;179577;47.3;22.0
49;2021-06-08;5185;5106;391023;184683;47.9;22.6
49;2021-06-09;5325;4505;396348;189188;48.6;23.2
49;2021-06-10;6005;3785;402353;192973;49.3;23.7
49;2021-06-11;4872;6041;407225;199014;49.9;24.4
49;2021-06-12;4097;3203;411322;202217;50.4;24.8
49;2021-06-13;20;989;411342;203206;50.4;24.9
49;2021-06-14;3410;6016;414752;209222;50.8;25.6
49;2021-06-15;4241;6396;418993;215618;51.4;26.4
49;2021-06-16;4150;5682;423143;221300;51.9;27.1
49;2021-06-17;5069;5078;428212;226378;52.5;27.7
49;2021-06-18;4134;6888;432346;233266;53.0;28.6
49;2021-06-19;3525;3974;435871;237240;53.4;29.1
49;2021-06-20;33;25;435904;237265;53.4;29.1
49;2021-06-21;2828;6512;438732;243777;53.8;29.9
49;2021-06-22;3208;7009;441940;250786;54.2;30.7
49;2021-06-23;3253;6313;445193;257099;54.6;31.5
49;2021-06-24;4317;4979;449510;262078;55.1;32.1
49;2021-06-25;3325;7448;452835;269526;55.5;33.0
49;2021-06-26;2570;4626;455405;274152;55.8;33.6
49;2021-06-27;15;1544;455420;275696;55.8;33.8
49;2021-06-28;2234;7184;457654;282880;56.1;34.7
49;2021-06-29;3028;7272;460682;290152;56.5;35.6
49;2021-06-30;2824;6805;463506;296957;56.8;36.4
49;2021-07-01;3393;6273;466899;303230;57.2;37.2
49;2021-07-02;3063;8067;469962;311297;57.6;38.2
49;2021-07-03;2007;5486;471969;316783;57.8;38.8
49;2021-07-04;7;53;471976;316836;57.8;38.8
49;2021-07-05;1738;7078;473714;323914;58.1;39.7
49;2021-07-06;1894;7551;475608;331465;58.3;40.6
49;2021-07-07;2100;6625;477708;338090;58.6;41.4
49;2021-07-08;2689;6357;480397;344447;58.9;42.2
49;2021-07-09;2361;8251;482758;352698;59.2;43.2
49;2021-07-10;1802;5345;484560;358043;59.4;43.9
49;2021-07-11;12;35;484572;358078;59.4;43.9
49;2021-07-12;1947;7713;486519;365791;59.6;44.8
49;2021-07-13;2572;8304;489091;374095;59.9;45.9
49;2021-07-14;2893;3375;491984;377470;60.3;46.3
49;2021-07-15;3165;7554;495149;385024;60.7;47.2
49;2021-07-16;3396;8299;498545;393323;61.1;48.2
49;2021-07-17;2103;5481;500648;398804;61.4;48.9
49;2021-07-18;3751;583;504399;399387;61.8;49.0
49;2021-07-19;2666;7452;507065;406839;62.1;49.9
49;2021-07-20;3588;7483;510653;414322;62.6;50.8
49;2021-07-21;4228;6464;514881;420786;63.1;51.6
49;2021-07-22;4815;5867;519696;426653;63.7;52.3
49;2021-07-23;5111;6630;524807;433283;64.3;53.1
49;2021-07-24;3690;5004;528497;438287;64.8;53.7
49;2021-07-25;67;33;528564;438320;64.8;53.7
49;2021-07-26;4517;5903;533081;444223;65.3;54.4
49;2021-07-27;5753;5445;538834;449668;66.0;55.1
49;2021-07-28;6019;4361;544853;454029;66.8;55.6
49;2021-07-29;6702;4158;551555;458187;67.6;56.2
49;2021-07-30;6173;4792;557728;462979;68.4;56.7
49;2021-07-31;3959;3421;561687;466400;68.8;57.2
49;2021-08-01;21;22;561708;466422;68.8;57.2
49;2021-08-02;4271;4659;565979;471081;69.4;57.7
49;2021-08-03;5434;3804;571413;474885;70.0;58.2
49;2021-08-04;5276;3722;576689;478607;70.7;58.7
49;2021-08-05;5307;3289;581996;481896;71.3;59.1
49;2021-08-06;5718;4284;587714;486180;72.0;59.6
49;2021-08-07;3926;3044;591640;489224;72.5;60.0
49;2021-08-08;24;36;591664;489260;72.5;60.0
49;2021-08-09;3501;4682;595165;493942;72.9;60.5
49;2021-08-10;4251;3903;599416;497845;73.5;61.0
49;2021-08-11;4007;3654;603423;501499;74.0;61.5
49;2021-08-12;2665;3055;606088;504554;74.3;61.8
49;2021-08-13;3926;4270;610014;508824;74.8;62.4
49;2021-08-14;2279;3149;612293;511973;75.0;62.8
49;2021-08-15;30;26;612323;511999;75.1;62.8
49;2021-08-16;2831;5061;615154;517060;75.4;63.4
49;2021-08-17;3275;4911;618429;521971;75.8;64.0
49;2021-08-18;2977;4114;621406;526085;76.2;64.5
49;2021-08-19;1549;3663;622955;529748;76.4;64.9
49;2021-08-20;2733;5773;625688;535521;76.7;65.6
49;2021-08-21;1400;4150;627088;539671;76.9;66.1
49;2021-08-22;6;41;627094;539712;76.9;66.2
49;2021-08-23;2257;5627;629351;545339;77.1;66.8
49;2021-08-24;2746;5787;632097;551126;77.5;67.5
49;2021-08-25;2330;5431;634427;556557;77.8;68.2
49;2021-08-26;1717;4827;636144;561384;78.0;68.8
49;2021-08-27;2455;6813;638599;568197;78.3;69.6
49;2021-08-28;906;4302;639505;572499;78.4;70.2
49;2021-08-29;5;94;639510;572593;78.4;70.2
49;2021-08-30;1154;4256;640664;576849;78.5;70.7
49;2021-08-31;2249;5914;642913;582763;78.8;71.4
49;2021-09-01;1684;4296;644597;587059;79.0;72.0
49;2021-09-02;1064;2619;645661;589678;79.1;72.3
49;2021-09-03;1461;3951;647122;593629;79.3;72.8
49;2021-09-04;1211;3451;648333;597080;79.5;73.2
49;2021-09-05;5;5;648338;597085;79.5;73.2
49;2021-09-06;1098;2622;649436;599707;79.6;73.5
49;2021-09-07;1191;2538;650627;602245;79.7;73.8
49;2021-09-08;989;3069;651616;605314;79.9;74.2
49;2021-09-09;771;1607;652387;606921;80.0;74.4
49;2021-09-10;973;2839;653360;609760;80.1;74.7
49;2021-09-11;725;2524;654085;612284;80.2;75.0
49;2021-09-12;12;7;654097;612291;80.2;75.0
49;2021-09-13;745;2087;654842;614378;80.3;75.3
49;2021-09-14;644;1709;655486;616087;80.3;75.5
49;2021-09-15;622;2229;656108;618316;80.4;75.8
49;2021-09-16;524;1288;656632;619604;80.5;75.9
49;2021-09-17;931;2518;657563;622122;80.6;76.3
49;2021-09-18;542;2005;658105;624127;80.7;76.5
49;2021-09-19;2;8;658107;624135;80.7;76.5
49;2021-09-20;522;1246;658629;625381;80.7;76.7
49;2021-09-21;432;1598;659061;626979;80.8;76.8
49;2021-09-22;336;1996;659397;628975;80.8;77.1
49;2021-09-23;328;1169;659725;630144;80.9;77.2
49;2021-09-24;566;2242;660291;632386;80.9;77.5
49;2021-09-25;197;1014;660488;633400;81.0;77.6
49;2021-09-26;0;0;660488;633400;81.0;77.6
49;2021-09-27;384;1374;660872;634774;81.0;77.8
49;2021-09-28;413;1061;661285;635835;81.1;77.9
49;2021-09-29;378;1242;661663;637077;81.1;78.1
49;2021-09-30;319;708;661982;637785;81.1;78.2
49;2021-10-01;545;1505;662527;639290;81.2;78.4
49;2021-10-02;354;1134;662881;640424;81.2;78.5
49;2021-10-03;4;13;662885;640437;81.2;78.5
49;2021-10-04;315;759;663200;641196;81.3;78.6
49;2021-10-05;188;553;663388;641749;81.3;78.7
49;2021-10-06;404;751;663792;642500;81.4;78.7
49;2021-10-07;221;410;664013;642910;81.4;78.8
49;2021-10-08;562;1263;664575;644173;81.5;79.0
49;2021-10-09;262;649;664837;644822;81.5;79.0
49;2021-10-10;3;2;664840;644824;81.5;79.0
49;2021-10-11;307;711;665147;645535;81.5;79.1
50;2020-12-27;0;0;0;0;0.0;0.0
50;2020-12-28;0;0;0;0;0.0;0.0
50;2020-12-29;1;0;1;0;0.0;0.0
50;2020-12-30;0;0;1;0;0.0;0.0
50;2020-12-31;0;0;1;0;0.0;0.0
50;2021-01-01;0;0;1;0;0.0;0.0
50;2021-01-02;0;0;1;0;0.0;0.0
50;2021-01-03;0;0;1;0;0.0;0.0
50;2021-01-04;1;0;2;0;0.0;0.0
50;2021-01-05;0;0;2;0;0.0;0.0
50;2021-01-06;126;0;128;0;0.0;0.0
50;2021-01-07;324;0;452;0;0.1;0.0
50;2021-01-08;436;2;888;2;0.2;0.0
50;2021-01-09;236;0;1124;2;0.2;0.0
50;2021-01-10;23;0;1147;2;0.2;0.0
50;2021-01-11;391;1;1538;3;0.3;0.0
50;2021-01-12;599;0;2137;3;0.4;0.0
50;2021-01-13;695;5;2832;8;0.6;0.0
50;2021-01-14;1051;11;3883;19;0.8;0.0
50;2021-01-15;710;4;4593;23;0.9;0.0
50;2021-01-16;215;3;4808;26;1.0;0.0
50;2021-01-17;1;0;4809;26;1.0;0.0
50;2021-01-18;620;2;5429;28;1.1;0.0
50;2021-01-19;902;9;6331;37;1.3;0.0
50;2021-01-20;964;1;7295;38;1.5;0.0
50;2021-01-21;917;4;8212;42;1.7;0.0
50;2021-01-22;716;4;8928;46;1.8;0.0
50;2021-01-23;668;4;9596;50;2.0;0.0
50;2021-01-24;882;3;10478;53;2.1;0.0
50;2021-01-25;2708;16;13186;69;2.7;0.0
50;2021-01-26;1336;16;14522;85;3.0;0.0
50;2021-01-27;769;56;15291;141;3.1;0.0
50;2021-01-28;716;170;16007;311;3.3;0.1
50;2021-01-29;581;307;16588;618;3.4;0.1
50;2021-01-30;382;164;16970;782;3.5;0.2
50;2021-01-31;0;0;16970;782;3.5;0.2
50;2021-02-01;451;224;17421;1006;3.6;0.2
50;2021-02-02;417;235;17838;1241;3.6;0.3
50;2021-02-03;391;375;18229;1616;3.7;0.3
50;2021-02-04;486;448;18715;2064;3.8;0.4
50;2021-02-05;426;448;19141;2512;3.9;0.5
50;2021-02-06;179;114;19320;2626;3.9;0.5
50;2021-02-07;0;0;19320;2626;3.9;0.5
50;2021-02-08;254;505;19574;3131;4.0;0.6
50;2021-02-09;246;640;19820;3771;4.0;0.8
50;2021-02-10;571;557;20391;4328;4.2;0.9
50;2021-02-11;436;915;20827;5243;4.2;1.1
50;2021-02-12;330;671;21157;5914;4.3;1.2
50;2021-02-13;306;487;21463;6401;4.4;1.3
50;2021-02-14;186;826;21649;7227;4.4;1.5
50;2021-02-15;664;2030;22313;9257;4.5;1.9
50;2021-02-16;747;1615;23060;10872;4.7;2.2
50;2021-02-17;632;823;23692;11695;4.8;2.4
50;2021-02-18;569;809;24261;12504;4.9;2.5
50;2021-02-19;631;519;24892;13023;5.1;2.7
50;2021-02-20;423;191;25315;13214;5.2;2.7
50;2021-02-21;85;29;25400;13243;5.2;2.7
50;2021-02-22;291;720;25691;13963;5.2;2.8
50;2021-02-23;503;565;26194;14528;5.3;3.0
50;2021-02-24;624;571;26818;15099;5.5;3.1
50;2021-02-25;780;594;27598;15693;5.6;3.2
50;2021-02-26;998;398;28596;16091;5.8;3.3
50;2021-02-27;887;115;29483;16206;6.0;3.3
50;2021-02-28;111;0;29594;16206;6.0;3.3
50;2021-03-01;488;557;30082;16763;6.1;3.4
50;2021-03-02;651;521;30733;17284;6.3;3.5
50;2021-03-03;798;457;31531;17741;6.4;3.6
50;2021-03-04;1247;340;32778;18081;6.7;3.7
50;2021-03-05;1553;354;34331;18435;7.0;3.8
50;2021-03-06;1321;161;35652;18596;7.3;3.8
50;2021-03-07;550;42;36202;18638;7.4;3.8
50;2021-03-08;1026;625;37228;19263;7.6;3.9
50;2021-03-09;1557;587;38785;19850;7.9;4.0
50;2021-03-10;1607;323;40392;20173;8.2;4.1
50;2021-03-11;2352;362;42744;20535;8.7;4.2
50;2021-03-12;2863;252;45607;20787;9.3;4.2
50;2021-03-13;1995;141;47602;20928;9.7;4.3
50;2021-03-14;280;43;47882;20971;9.8;4.3
50;2021-03-15;1378;301;49260;21272;10.0;4.3
50;2021-03-16;1341;285;50601;21557;10.3;4.4
50;2021-03-17;1296;417;51897;21974;10.6;4.5
50;2021-03-18;1162;435;53059;22409;10.8;4.6
50;2021-03-19;1733;595;54792;23004;11.2;4.7
50;2021-03-20;1688;234;56480;23238;11.5;4.7
50;2021-03-21;794;12;57274;23250;11.7;4.7
50;2021-03-22;1508;342;58782;23592;12.0;4.8
50;2021-03-23;2078;403;60860;23995;12.4;4.9
50;2021-03-24;2281;558;63141;24553;12.9;5.0
50;2021-03-25;2813;476;65954;25029;13.4;5.1
50;2021-03-26;3205;480;69159;25509;14.1;5.2
50;2021-03-27;1824;379;70983;25888;14.5;5.3
50;2021-03-28;403;20;71386;25908;14.5;5.3
50;2021-03-29;2139;723;73525;26631;15.0;5.4
50;2021-03-30;2283;648;75808;27279;15.4;5.6
50;2021-03-31;2479;576;78287;27855;16.0;5.7
50;2021-04-01;3104;876;81391;28731;16.6;5.9
50;2021-04-02;2960;935;84351;29666;17.2;6.0
50;2021-04-03;1245;686;85596;30352;17.4;6.2
50;2021-04-04;320;135;85916;30487;17.5;6.2
50;2021-04-05;400;28;86316;30515;17.6;6.2
50;2021-04-06;2127;1226;88443;31741;18.0;6.5
50;2021-04-07;2558;1185;91001;32926;18.5;6.7
50;2021-04-08;3597;1214;94598;34140;19.3;7.0
50;2021-04-09;3936;1304;98534;35444;20.1;7.2
50;2021-04-10;2534;879;101068;36323;20.6;7.4
50;2021-04-11;411;146;101479;36469;20.7;7.4
50;2021-04-12;2438;1381;103917;37850;21.2;7.7
50;2021-04-13;2678;1523;106595;39373;21.7;8.0
50;2021-04-14;2608;1360;109203;40733;22.3;8.3
50;2021-04-15;3161;1120;112364;41853;22.9;8.5
50;2021-04-16;3363;1105;115727;42958;23.6;8.8
50;2021-04-17;2397;1188;118124;44146;24.1;9.0
50;2021-04-18;425;666;118549;44812;24.2;9.1
50;2021-04-19;1996;1473;120545;46285;24.6;9.4
50;2021-04-20;2273;1593;122818;47878;25.0;9.8
50;2021-04-21;2548;1764;125366;49642;25.6;10.1
50;2021-04-22;3078;1829;128444;51471;26.2;10.5
50;2021-04-23;2757;1923;131201;53394;26.7;10.9
50;2021-04-24;1900;1439;133101;54833;27.1;11.2
50;2021-04-25;470;273;133571;55106;27.2;11.2
50;2021-04-26;2119;1891;135690;56997;27.7;11.6
50;2021-04-27;2412;2005;138102;59002;28.1;12.0
50;2021-04-28;2708;1977;140810;60979;28.7;12.4
50;2021-04-29;3285;2053;144095;63032;29.4;12.8
50;2021-04-30;2999;1937;147094;64969;30.0;13.2
50;2021-05-01;1015;597;148109;65566;30.2;13.4
50;2021-05-02;522;448;148631;66014;30.3;13.5
50;2021-05-03;1771;1806;150402;67820;30.7;13.8
50;2021-05-04;1771;2332;152173;70152;31.0;14.3
50;2021-05-05;1659;2955;153832;73107;31.4;14.9
50;2021-05-06;2530;2589;156362;75696;31.9;15.4
50;2021-05-07;2150;2861;158512;78557;32.3;16.0
50;2021-05-08;1170;796;159682;79353;32.5;16.2
50;2021-05-09;624;362;160306;79715;32.7;16.2
50;2021-05-10;1705;2604;162011;82319;33.0;16.8
50;2021-05-11;2542;2848;164553;85167;33.5;17.4
50;2021-05-12;3179;2440;167732;87607;34.2;17.9
50;2021-05-13;3382;612;171114;88219;34.9;18.0
50;2021-05-14;3568;2279;174682;90498;35.6;18.4
50;2021-05-15;4001;1875;178683;92373;36.4;18.8
50;2021-05-16;947;267;179630;92640;36.6;18.9
50;2021-05-17;2140;1879;181770;94519;37.0;19.3
50;2021-05-18;2523;1620;184293;96139;37.6;19.6
50;2021-05-19;2503;1448;186796;97587;38.1;19.9
50;2021-05-20;3261;1624;190057;99211;38.7;20.2
50;2021-05-21;3156;1912;193213;101123;39.4;20.6
50;2021-05-22;2651;1328;195864;102451;39.9;20.9
50;2021-05-23;603;284;196467;102735;40.0;20.9
50;2021-05-24;1527;490;197994;103225;40.4;21.0
50;2021-05-25;2448;1671;200442;104896;40.9;21.4
50;2021-05-26;3002;1461;203444;106357;41.5;21.7
50;2021-05-27;3036;1972;206480;108329;42.1;22.1
50;2021-05-28;2941;2126;209421;110455;42.7;22.5
50;2021-05-29;2760;1404;212181;111859;43.2;22.8
50;2021-05-30;812;327;212993;112186;43.4;22.9
50;2021-05-31;2651;1817;215644;114003;43.9;23.2
50;2021-06-01;3333;2069;218977;116072;44.6;23.7
50;2021-06-02;3259;1785;222236;117857;45.3;24.0
50;2021-06-03;3914;2061;226150;119918;46.1;24.4
50;2021-06-04;3822;2886;229972;122804;46.9;25.0
50;2021-06-05;2958;1847;232930;124651;47.5;25.4
50;2021-06-06;813;442;233743;125093;47.6;25.5
50;2021-06-07;3512;2082;237255;127175;48.4;25.9
50;2021-06-08;4073;2228;241328;129403;49.2;26.4
50;2021-06-09;4253;1998;245581;131401;50.1;26.8
50;2021-06-10;4193;2118;249774;133519;50.9;27.2
50;2021-06-11;4224;2712;253998;136231;51.8;27.8
50;2021-06-12;3738;1613;257736;137844;52.5;28.1
50;2021-06-13;1143;451;258879;138295;52.8;28.2
50;2021-06-14;2693;2967;261572;141262;53.3;28.8
50;2021-06-15;3016;2602;264588;143864;53.9;29.3
50;2021-06-16;3097;1976;267685;145840;54.6;29.7
50;2021-06-17;2798;2486;270483;148326;55.1;30.2
50;2021-06-18;3239;3055;273722;151381;55.8;30.9
50;2021-06-19;3176;1927;276898;153308;56.4;31.2
50;2021-06-20;731;710;277629;154018;56.6;31.4
50;2021-06-21;1819;3133;279448;157151;57.0;32.0
50;2021-06-22;2064;3393;281512;160544;57.4;32.7
50;2021-06-23;1871;3875;283383;164419;57.8;33.5
50;2021-06-24;1711;4008;285094;168427;58.1;34.3
50;2021-06-25;2134;4009;287228;172436;58.5;35.1
50;2021-06-26;2147;3695;289375;176131;59.0;35.9
50;2021-06-27;615;895;289990;177026;59.1;36.1
50;2021-06-28;1927;3349;291917;180375;59.5;36.8
50;2021-06-29;1881;3408;293798;183783;59.9;37.5
50;2021-06-30;2179;3411;295977;187194;60.3;38.2
50;2021-07-01;1944;3287;297921;190481;60.7;38.8
50;2021-07-02;1898;3935;299819;194416;61.1;39.6
50;2021-07-03;1448;3447;301267;197863;61.4;40.3
50;2021-07-04;445;1066;301712;198929;61.5;40.5
50;2021-07-05;1262;3412;302974;202341;61.7;41.2
50;2021-07-06;1573;3896;304547;206237;62.1;42.0
50;2021-07-07;1804;3617;306351;209854;62.4;42.8
50;2021-07-08;1374;4101;307725;213955;62.7;43.6
50;2021-07-09;1394;4572;309119;218527;63.0;44.5
50;2021-07-10;1023;3599;310142;222126;63.2;45.3
50;2021-07-11;373;1018;310515;223144;63.3;45.5
50;2021-07-12;1317;4625;311832;227769;63.6;46.4
50;2021-07-13;1624;4857;313456;232626;63.9;47.4
50;2021-07-14;1476;2359;314932;234985;64.2;47.9
50;2021-07-15;1687;5056;316619;240041;64.5;48.9
50;2021-07-16;2992;5244;319611;245285;65.1;50.0
50;2021-07-17;2149;3733;321760;249018;65.6;50.8
50;2021-07-18;402;1092;322162;250110;65.7;51.0
50;2021-07-19;1571;5186;323733;255296;66.0;52.0
50;2021-07-20;1924;5407;325657;260703;66.4;53.1
50;2021-07-21;1802;5259;327459;265962;66.7;54.2
50;2021-07-22;1947;5004;329406;270966;67.1;55.2
50;2021-07-23;2072;5385;331478;276351;67.6;56.3
50;2021-07-24;1311;3836;332789;280187;67.8;57.1
50;2021-07-25;274;1037;333063;281224;67.9;57.3
50;2021-07-26;2290;3487;335353;284711;68.3;58.0
50;2021-07-27;2899;3347;338252;288058;68.9;58.7
50;2021-07-28;2998;3689;341250;291747;69.5;59.5
50;2021-07-29;3581;3233;344831;294980;70.3;60.1
50;2021-07-30;3075;3009;347906;297989;70.9;60.7
50;2021-07-31;2406;2672;350312;300661;71.4;61.3
50;2021-08-01;484;686;350796;301347;71.5;61.4
50;2021-08-02;2475;2741;353271;304088;72.0;62.0
50;2021-08-03;3404;2470;356675;306558;72.7;62.5
50;2021-08-04;3602;2323;360277;308881;73.4;63.0
50;2021-08-05;3189;2159;363466;311040;74.1;63.4
50;2021-08-06;3658;2800;367124;313840;74.8;64.0
50;2021-08-07;2462;2156;369586;315996;75.3;64.4
50;2021-08-08;511;712;370097;316708;75.4;64.5
50;2021-08-09;2494;2135;372591;318843;75.9;65.0
50;2021-08-10;2987;1989;375578;320832;76.5;65.4
50;2021-08-11;2852;2018;378430;322850;77.1;65.8
50;2021-08-12;2596;2439;381026;325289;77.7;66.3
50;2021-08-13;2506;1979;383532;327268;78.2;66.7
50;2021-08-14;1811;1748;385343;329016;78.5;67.1
50;2021-08-15;399;334;385742;329350;78.6;67.1
50;2021-08-16;1721;2228;387463;331578;79.0;67.6
50;2021-08-17;1973;2704;389436;334282;79.4;68.1
50;2021-08-18;1846;2389;391282;336671;79.7;68.6
50;2021-08-19;1710;2579;392992;339250;80.1;69.1
50;2021-08-20;1621;2739;394613;341989;80.4;69.7
50;2021-08-21;1016;2727;395629;344716;80.6;70.3
50;2021-08-22;384;519;396013;345235;80.7;70.4
50;2021-08-23;1138;2906;397151;348141;80.9;71.0
50;2021-08-24;1246;3222;398397;351363;81.2;71.6
50;2021-08-25;1107;2649;399504;354012;81.4;72.1
50;2021-08-26;866;3156;400370;357168;81.6;72.8
50;2021-08-27;937;3181;401307;360349;81.8;73.4
50;2021-08-28;794;2887;402101;363236;81.9;74.0
50;2021-08-29;283;575;402384;363811;82.0;74.1
50;2021-08-30;773;2875;403157;366686;82.2;74.7
50;2021-08-31;822;2928;403979;369614;82.3;75.3
50;2021-09-01;706;2659;404685;372273;82.5;75.9
50;2021-09-02;530;2220;405215;374493;82.6;76.3
50;2021-09-03;699;2540;405914;377033;82.7;76.8
50;2021-09-04;620;2852;406534;379885;82.9;77.4
50;2021-09-05;194;669;406728;380554;82.9;77.6
50;2021-09-06;434;1898;407162;382452;83.0;77.9
50;2021-09-07;330;1473;407492;383925;83.0;78.2
50;2021-09-08;502;1934;407994;385859;83.2;78.6
50;2021-09-09;419;1274;408413;387133;83.2;78.9
50;2021-09-10;531;1689;408944;388822;83.3;79.2
50;2021-09-11;365;2179;409309;391001;83.4;79.7
50;2021-09-12;71;369;409380;391370;83.4;79.8
50;2021-09-13;414;1022;409794;392392;83.5;80.0
50;2021-09-14;414;938;410208;393330;83.6;80.2
50;2021-09-15;419;1087;410627;394417;83.7;80.4
50;2021-09-16;464;748;411091;395165;83.8;80.5
50;2021-09-17;462;1032;411553;396197;83.9;80.7
50;2021-09-18;314;1467;411867;397664;83.9;81.0
50;2021-09-19;46;276;411913;397940;83.9;81.1
50;2021-09-20;383;589;412296;398529;84.0;81.2
50;2021-09-21;431;625;412727;399154;84.1;81.3
50;2021-09-22;216;867;412943;400021;84.2;81.5
50;2021-09-23;272;452;413215;400473;84.2;81.6
50;2021-09-24;253;819;413468;401292;84.3;81.8
50;2021-09-25;213;934;413681;402226;84.3;82.0
50;2021-09-26;20;181;413701;402407;84.3;82.0
50;2021-09-27;110;392;413811;402799;84.3;82.1
50;2021-09-28;160;385;413971;403184;84.4;82.2
50;2021-09-29;156;526;414127;403710;84.4;82.3
50;2021-09-30;165;424;414292;404134;84.4;82.4
50;2021-10-01;206;592;414498;404726;84.5;82.5
50;2021-10-02;224;540;414722;405266;84.5;82.6
50;2021-10-03;2;5;414724;405271;84.5;82.6
50;2021-10-04;180;484;414904;405755;84.6;82.7
50;2021-10-05;135;399;415039;406154;84.6;82.8
50;2021-10-06;191;490;415230;406644;84.6;82.9
50;2021-10-07;112;362;415342;407006;84.6;82.9
50;2021-10-08;209;499;415551;407505;84.7;83.1
50;2021-10-09;218;515;415769;408020;84.7;83.2
50;2021-10-10;0;0;415769;408020;84.7;83.2
50;2021-10-11;94;230;415863;408250;84.8;83.2
51;2020-12-27;0;0;0;0;0.0;0.0
51;2020-12-28;0;0;0;0;0.0;0.0
51;2020-12-29;0;0;0;0;0.0;0.0
51;2020-12-30;0;0;0;0;0.0;0.0
51;2020-12-31;1;0;1;0;0.0;0.0
51;2021-01-01;0;0;1;0;0.0;0.0
51;2021-01-02;0;0;1;0;0.0;0.0
51;2021-01-03;0;0;1;0;0.0;0.0
51;2021-01-04;1;0;2;0;0.0;0.0
51;2021-01-05;1;0;3;0;0.0;0.0
51;2021-01-06;6;0;9;0;0.0;0.0
51;2021-01-07;262;1;271;1;0.0;0.0
51;2021-01-08;508;1;779;2;0.1;0.0
51;2021-01-09;91;1;870;3;0.2;0.0
51;2021-01-10;0;0;870;3;0.2;0.0
51;2021-01-11;545;2;1415;5;0.3;0.0
51;2021-01-12;1542;6;2957;11;0.5;0.0
51;2021-01-13;1289;7;4246;18;0.8;0.0
51;2021-01-14;1475;7;5721;25;1.0;0.0
51;2021-01-15;607;4;6328;29;1.1;0.0
51;2021-01-16;177;1;6505;30;1.2;0.0
51;2021-01-17;102;0;6607;30;1.2;0.0
51;2021-01-18;845;4;7452;34;1.3;0.0
51;2021-01-19;997;5;8449;39;1.5;0.0
51;2021-01-20;955;11;9404;50;1.7;0.0
51;2021-01-21;790;3;10194;53;1.8;0.0
51;2021-01-22;394;2;10588;55;1.9;0.0
51;2021-01-23;294;0;10882;55;1.9;0.0
51;2021-01-24;130;1;11012;56;2.0;0.0
51;2021-01-25;712;3;11724;59;2.1;0.0
51;2021-01-26;779;5;12503;64;2.2;0.0
51;2021-01-27;656;4;13159;68;2.3;0.0
51;2021-01-28;646;68;13805;136;2.4;0.0
51;2021-01-29;474;142;14279;278;2.5;0.0
51;2021-01-30;126;5;14405;283;2.6;0.1
51;2021-01-31;83;0;14488;283;2.6;0.1
51;2021-02-01;275;58;14763;341;2.6;0.1
51;2021-02-02;738;723;15501;1064;2.7;0.2
51;2021-02-03;642;472;16143;1536;2.9;0.3
51;2021-02-04;968;816;17111;2352;3.0;0.4
51;2021-02-05;972;513;18083;2865;3.2;0.5
51;2021-02-06;30;147;18113;3012;3.2;0.5
51;2021-02-07;0;18;18113;3030;3.2;0.5
51;2021-02-08;115;412;18228;3442;3.2;0.6
51;2021-02-09;222;471;18450;3913;3.3;0.7
51;2021-02-10;220;637;18670;4550;3.3;0.8
51;2021-02-11;302;530;18972;5080;3.4;0.9
51;2021-02-12;341;564;19313;5644;3.4;1.0
51;2021-02-13;8;115;19321;5759;3.4;1.0
51;2021-02-14;8;171;19329;5930;3.4;1.1
51;2021-02-15;266;848;19595;6778;3.5;1.2
51;2021-02-16;402;969;19997;7747;3.5;1.4
51;2021-02-17;367;877;20364;8624;3.6;1.5
51;2021-02-18;437;593;20801;9217;3.7;1.6
51;2021-02-19;528;424;21329;9641;3.8;1.7
51;2021-02-20;205;293;21534;9934;3.8;1.8
51;2021-02-21;10;101;21544;10035;3.8;1.8
51;2021-02-22;195;689;21739;10724;3.9;1.9
51;2021-02-23;262;1099;22001;11823;3.9;2.1
51;2021-02-24;414;689;22415;12512;4.0;2.2
51;2021-02-25;1049;887;23464;13399;4.2;2.4
51;2021-02-26;1228;668;24692;14067;4.4;2.5
51;2021-02-27;590;124;25282;14191;4.5;2.5
51;2021-02-28;7;71;25289;14262;4.5;2.5
51;2021-03-01;768;314;26057;14576;4.6;2.6
51;2021-03-02;1128;467;27185;15043;4.8;2.7
51;2021-03-03;1195;467;28380;15510;5.0;2.8
51;2021-03-04;1061;701;29441;16211;5.2;2.9
51;2021-03-05;1562;675;31003;16886;5.5;3.0
51;2021-03-06;1434;60;32437;16946;5.8;3.0
51;2021-03-07;251;6;32688;16952;5.8;3.0
51;2021-03-08;992;101;33680;17053;6.0;3.0
51;2021-03-09;1665;195;35345;17248;6.3;3.1
51;2021-03-10;1999;114;37344;17362;6.6;3.1
51;2021-03-11;2371;175;39715;17537;7.0;3.1
51;2021-03-12;3255;167;42970;17704;7.6;3.1
51;2021-03-13;2550;54;45520;17758;8.1;3.1
51;2021-03-14;190;5;45710;17763;8.1;3.2
51;2021-03-15;1580;151;47290;17914;8.4;3.2
51;2021-03-16;1478;186;48768;18100;8.6;3.2
51;2021-03-17;1497;211;50265;18311;8.9;3.2
51;2021-03-18;1615;289;51880;18600;9.2;3.3
51;2021-03-19;2311;303;54191;18903;9.6;3.4
51;2021-03-20;1661;220;55852;19123;9.9;3.4
51;2021-03-21;133;5;55985;19128;9.9;3.4
51;2021-03-22;1416;126;57401;19254;10.2;3.4
51;2021-03-23;2469;170;59870;19424;10.6;3.4
51;2021-03-24;2846;138;62716;19562;11.1;3.5
51;2021-03-25;3254;339;65970;19901;11.7;3.5
51;2021-03-26;3411;511;69381;20412;12.3;3.6
51;2021-03-27;1842;253;71223;20665;12.6;3.7
51;2021-03-28;213;3;71436;20668;12.7;3.7
51;2021-03-29;991;641;72427;21309;12.8;3.8
51;2021-03-30;1748;862;74175;22171;13.2;3.9
51;2021-03-31;1739;761;75914;22932;13.5;4.1
51;2021-04-01;2280;463;78194;23395;13.9;4.1
51;2021-04-02;2425;645;80619;24040;14.3;4.3
51;2021-04-03;1301;413;81920;24453;14.5;4.3
51;2021-04-04;106;2;82026;24455;14.5;4.3
51;2021-04-05;72;141;82098;24596;14.6;4.4
51;2021-04-06;763;1233;82861;25829;14.7;4.6
51;2021-04-07;1312;1412;84173;27241;14.9;4.8
51;2021-04-08;2208;1783;86381;29024;15.3;5.1
51;2021-04-09;2863;1737;89244;30761;15.8;5.5
51;2021-04-10;2219;503;91463;31264;16.2;5.5
51;2021-04-11;105;85;91568;31349;16.2;5.6
51;2021-04-12;1450;1344;93018;32693;16.5;5.8
51;2021-04-13;1936;1682;94954;34375;16.8;6.1
51;2021-04-14;2460;1560;97414;35935;17.3;6.4
51;2021-04-15;2855;1675;100269;37610;17.8;6.7
51;2021-04-16;3214;1609;103483;39219;18.4;7.0
51;2021-04-17;1966;776;105449;39995;18.7;7.1
51;2021-04-18;296;114;105745;40109;18.8;7.1
51;2021-04-19;1561;1162;107306;41271;19.0;7.3
51;2021-04-20;1791;1665;109097;42936;19.3;7.6
51;2021-04-21;2002;1745;111099;44681;19.7;7.9
51;2021-04-22;2407;1666;113506;46347;20.1;8.2
51;2021-04-23;2982;1831;116488;48178;20.7;8.5
51;2021-04-24;1749;955;118237;49133;21.0;8.7
51;2021-04-25;123;161;118360;49294;21.0;8.7
51;2021-04-26;1851;761;120211;50055;21.3;8.9
51;2021-04-27;2442;1237;122653;51292;21.8;9.1
51;2021-04-28;2552;1315;125205;52607;22.2;9.3
51;2021-04-29;2676;1464;127881;54071;22.7;9.6
51;2021-04-30;2975;1679;130856;55750;23.2;9.9
51;2021-05-01;1453;412;132309;56162;23.5;10.0
51;2021-05-02;107;99;132416;56261;23.5;10.0
51;2021-05-03;2484;766;134900;57027;23.9;10.1
51;2021-05-04;2788;1358;137688;58385;24.4;10.4
51;2021-05-05;2860;1642;140548;60027;24.9;10.6
51;2021-05-06;5344;1956;145892;61983;25.9;11.0
51;2021-05-07;3705;1940;149597;63923;26.5;11.3
51;2021-05-08;2862;820;152459;64743;27.0;11.5
51;2021-05-09;212;92;152671;64835;27.1;11.5
51;2021-05-10;3214;1869;155885;66704;27.6;11.8
51;2021-05-11;3643;2042;159528;68746;28.3;12.2
51;2021-05-12;4182;2237;163710;70983;29.0;12.6
51;2021-05-13;1777;505;165487;71488;29.4;12.7
51;2021-05-14;5401;1744;170888;73232;30.3;13.0
51;2021-05-15;4227;1355;175115;74587;31.1;13.2
51;2021-05-16;284;47;175399;74634;31.1;13.2
51;2021-05-17;3131;1524;178530;76158;31.7;13.5
51;2021-05-18;3918;1767;182448;77925;32.4;13.8
51;2021-05-19;4031;1724;186479;79649;33.1;14.1
51;2021-05-20;4649;1969;191128;81618;33.9;14.5
51;2021-05-21;3597;2473;194725;84091;34.5;14.9
51;2021-05-22;2075;1548;196800;85639;34.9;15.2
51;2021-05-23;308;210;197108;85849;35.0;15.2
51;2021-05-24;2018;720;199126;86569;35.3;15.4
51;2021-05-25;3130;1829;202256;88398;35.9;15.7
51;2021-05-26;3297;1711;205553;90109;36.5;16.0
51;2021-05-27;3267;2062;208820;92171;37.0;16.3
51;2021-05-28;3605;2823;212425;94994;37.7;16.8
51;2021-05-29;2401;1995;214826;96989;38.1;17.2
51;2021-05-30;401;133;215227;97122;38.2;17.2
51;2021-05-31;3348;1784;218575;98906;38.8;17.5
51;2021-06-01;3854;2334;222429;101240;39.5;18.0
51;2021-06-02;6096;2332;228525;103572;40.5;18.4
51;2021-06-03;3580;2427;232105;105999;41.2;18.8
51;2021-06-04;6346;2943;238451;108942;42.3;19.3
51;2021-06-05;2597;1822;241048;110764;42.8;19.6
51;2021-06-06;172;157;241220;110921;42.8;19.7
51;2021-06-07;4302;2166;245522;113087;43.5;20.1
51;2021-06-08;3925;2533;249447;115620;44.2;20.5
51;2021-06-09;4016;2750;253463;118370;45.0;21.0
51;2021-06-10;3208;2491;256671;120861;45.5;21.4
51;2021-06-11;3358;3429;260029;124290;46.1;22.0
51;2021-06-12;2165;2170;262194;126460;46.5;22.4
51;2021-06-13;191;149;262385;126609;46.5;22.5
51;2021-06-14;1627;3331;264012;129940;46.8;23.0
51;2021-06-15;3189;3577;267201;133517;47.4;23.7
51;2021-06-16;2208;3685;269409;137202;47.8;24.3
51;2021-06-17;2609;5402;272018;142604;48.2;25.3
51;2021-06-18;2355;5212;274373;147816;48.7;26.2
51;2021-06-19;1683;4425;276056;152241;49.0;27.0
51;2021-06-20;184;228;276240;152469;49.0;27.0
51;2021-06-21;1231;4440;277471;156909;49.2;27.8
51;2021-06-22;1558;4044;279029;160953;49.5;28.5
51;2021-06-23;3670;4239;282699;165192;50.1;29.3
51;2021-06-24;2246;3226;284945;168418;50.5;29.9
51;2021-06-25;1905;6526;286850;174944;50.9;31.0
51;2021-06-26;1203;5065;288053;180009;51.1;31.9
51;2021-06-27;103;336;288156;180345;51.1;32.0
51;2021-06-28;1401;4413;289557;184758;51.4;32.8
51;2021-06-29;1174;4463;290731;189221;51.6;33.6
51;2021-06-30;1686;6044;292417;195265;51.9;34.6
51;2021-07-01;1978;3765;294395;199030;52.2;35.3
51;2021-07-02;1838;6887;296233;205917;52.5;36.5
51;2021-07-03;1003;3198;297236;209115;52.7;37.1
51;2021-07-04;171;254;297407;209369;52.7;37.1
51;2021-07-05;770;5529;298177;214898;52.9;38.1
51;2021-07-06;1246;4781;299423;219679;53.1;39.0
51;2021-07-07;1617;4935;301040;224614;53.4;39.8
51;2021-07-08;2067;3431;303107;228045;53.8;40.4
51;2021-07-09;1854;5056;304961;233101;54.1;41.3
51;2021-07-10;1238;3204;306199;236305;54.3;41.9
51;2021-07-11;190;281;306389;236586;54.3;42.0
51;2021-07-12;996;4380;307385;240966;54.5;42.7
51;2021-07-13;1480;4775;308865;245741;54.8;43.6
51;2021-07-14;1071;1691;309936;247432;55.0;43.9
51;2021-07-15;2938;4915;312874;252347;55.5;44.8
51;2021-07-16;2365;5275;315239;257622;55.9;45.7
51;2021-07-17;1821;3481;317060;261103;56.2;46.3
51;2021-07-18;163;330;317223;261433;56.3;46.4
51;2021-07-19;1892;3977;319115;265410;56.6;47.1
51;2021-07-20;2585;5143;321700;270553;57.1;48.0
51;2021-07-21;3611;4069;325311;274622;57.7;48.7
51;2021-07-22;4412;3758;329723;278380;58.5;49.4
51;2021-07-23;3640;4381;333363;282761;59.1;50.2
51;2021-07-24;2086;2726;335449;285487;59.5;50.6
51;2021-07-25;356;258;335805;285745;59.6;50.7
51;2021-07-26;3113;2808;338918;288553;60.1;51.2
51;2021-07-27;5864;3277;344782;291830;61.2;51.8
51;2021-07-28;4139;4321;348921;296151;61.9;52.5
51;2021-07-29;4701;2722;353622;298873;62.7;53.0
51;2021-07-30;3628;3163;357250;302036;63.4;53.6
51;2021-07-31;2526;2132;359776;304168;63.8;53.9
51;2021-08-01;375;236;360151;304404;63.9;54.0
51;2021-08-02;3287;2310;363438;306714;64.5;54.4
51;2021-08-03;3775;1913;367213;308627;65.1;54.7
51;2021-08-04;4450;2126;371663;310753;65.9;55.1
51;2021-08-05;2655;1536;374318;312289;66.4;55.4
51;2021-08-06;3044;2552;377362;314841;66.9;55.8
51;2021-08-07;2161;1700;379523;316541;67.3;56.1
51;2021-08-08;368;208;379891;316749;67.4;56.2
51;2021-08-09;2604;1852;382495;318601;67.8;56.5
51;2021-08-10;2372;1984;384867;320585;68.3;56.9
51;2021-08-11;2917;2341;387784;322926;68.8;57.3
51;2021-08-12;1754;1958;389538;324884;69.1;57.6
51;2021-08-13;2066;2670;391604;327554;69.5;58.1
51;2021-08-14;1583;2027;393187;329581;69.7;58.5
51;2021-08-15;149;150;393336;329731;69.8;58.5
51;2021-08-16;1356;3016;394692;332747;70.0;59.0
51;2021-08-17;1560;3283;396252;336030;70.3;59.6
51;2021-08-18;1899;3693;398151;339723;70.6;60.3
51;2021-08-19;1409;2548;399560;342271;70.9;60.7
51;2021-08-20;1708;3974;401268;346245;71.2;61.4
51;2021-08-21;988;2497;402256;348742;71.3;61.9
51;2021-08-22;101;343;402357;349085;71.4;61.9
51;2021-08-23;1111;3607;403468;352692;71.6;62.6
51;2021-08-24;1174;3643;404642;356335;71.8;63.2
51;2021-08-25;1321;4488;405963;360823;72.0;64.0
51;2021-08-26;1058;2547;407021;363370;72.2;64.4
51;2021-08-27;1214;4178;408235;367548;72.4;65.2
51;2021-08-28;655;2632;408890;370180;72.5;65.7
51;2021-08-29;84;360;408974;370540;72.5;65.7
51;2021-08-30;1332;4788;410306;375328;72.8;66.6
51;2021-08-31;778;2915;411084;378243;72.9;67.1
51;2021-09-01;738;3215;411822;381458;73.0;67.7
51;2021-09-02;800;2048;412622;383506;73.2;68.0
51;2021-09-03;905;2628;413527;386134;73.3;68.5
51;2021-09-04;622;2706;414149;388840;73.5;69.0
51;2021-09-05;122;194;414271;389034;73.5;69.0
51;2021-09-06;436;1509;414707;390543;73.6;69.3
51;2021-09-07;519;1256;415226;391799;73.6;69.5
51;2021-09-08;627;1925;415853;393724;73.8;69.8
51;2021-09-09;466;1190;416319;394914;73.8;70.0
51;2021-09-10;671;1787;416990;396701;74.0;70.4
51;2021-09-11;562;1828;417552;398529;74.1;70.7
51;2021-09-12;19;79;417571;398608;74.1;70.7
51;2021-09-13;427;851;417998;399459;74.1;70.8
51;2021-09-14;594;873;418592;400332;74.2;71.0
51;2021-09-15;494;1425;419086;401757;74.3;71.3
51;2021-09-16;307;657;419393;402414;74.4;71.4
51;2021-09-17;551;1129;419944;403543;74.5;71.6
51;2021-09-18;470;1421;420414;404964;74.6;71.8
51;2021-09-19;14;64;420428;405028;74.6;71.8
51;2021-09-20;280;536;420708;405564;74.6;71.9
51;2021-09-21;255;490;420963;406054;74.7;72.0
51;2021-09-22;318;1353;421281;407407;74.7;72.3
51;2021-09-23;195;602;421476;408009;74.8;72.4
51;2021-09-24;366;978;421842;408987;74.8;72.5
51;2021-09-25;283;984;422125;409971;74.9;72.7
51;2021-09-26;7;129;422132;410100;74.9;72.7
51;2021-09-27;259;446;422391;410546;74.9;72.8
51;2021-09-28;298;363;422689;410909;75.0;72.9
51;2021-09-29;348;775;423037;411684;75.0;73.0
51;2021-09-30;263;415;423300;412099;75.1;73.1
51;2021-10-01;355;717;423655;412816;75.1;73.2
51;2021-10-02;371;761;424026;413577;75.2;73.4
51;2021-10-03;0;1;424026;413578;75.2;73.4
51;2021-10-04;180;445;424206;414023;75.2;73.4
51;2021-10-05;204;432;424410;414455;75.3;73.5
51;2021-10-06;312;553;424722;415008;75.3;73.6
51;2021-10-07;163;368;424885;415376;75.4;73.7
51;2021-10-08;313;590;425198;415966;75.4;73.8
51;2021-10-09;321;603;425519;416569;75.5;73.9
51;2021-10-10;2;2;425521;416571;75.5;73.9
51;2021-10-11;168;298;425689;416869;75.5;73.9
52;2020-12-27;0;0;0;0;0.0;0.0
52;2020-12-28;1;0;1;0;0.0;0.0
52;2020-12-29;0;0;1;0;0.0;0.0
52;2020-12-30;0;0;1;0;0.0;0.0
52;2020-12-31;0;0;1;0;0.0;0.0
52;2021-01-01;0;0;1;0;0.0;0.0
52;2021-01-02;1;0;2;0;0.0;0.0
52;2021-01-03;0;0;2;0;0.0;0.0
52;2021-01-04;0;0;2;0;0.0;0.0
52;2021-01-05;0;0;2;0;0.0;0.0
52;2021-01-06;2;0;4;0;0.0;0.0
52;2021-01-07;0;0;4;0;0.0;0.0
52;2021-01-08;200;1;204;1;0.1;0.0
52;2021-01-09;93;0;297;1;0.2;0.0
52;2021-01-10;0;0;297;1;0.2;0.0
52;2021-01-11;207;0;504;1;0.3;0.0
52;2021-01-12;171;0;675;1;0.4;0.0
52;2021-01-13;563;3;1238;4;0.7;0.0
52;2021-01-14;677;11;1915;15;1.1;0.0
52;2021-01-15;411;1;2326;16;1.4;0.0
52;2021-01-16;16;1;2342;17;1.4;0.0
52;2021-01-17;0;0;2342;17;1.4;0.0
52;2021-01-18;427;0;2769;17;1.6;0.0
52;2021-01-19;440;1;3209;18;1.9;0.0
52;2021-01-20;422;0;3631;18;2.1;0.0
52;2021-01-21;423;2;4054;20;2.4;0.0
52;2021-01-22;320;2;4374;22;2.6;0.0
52;2021-01-23;73;2;4447;24;2.6;0.0
52;2021-01-24;0;0;4447;24;2.6;0.0
52;2021-01-25;236;0;4683;24;2.8;0.0
52;2021-01-26;308;0;4991;24;2.9;0.0
52;2021-01-27;238;1;5229;25;3.1;0.0
52;2021-01-28;174;4;5403;29;3.2;0.0
52;2021-01-29;74;122;5477;151;3.2;0.1
52;2021-01-30;91;95;5568;246;3.3;0.1
52;2021-01-31;0;0;5568;246;3.3;0.1
52;2021-02-01;117;189;5685;435;3.4;0.3
52;2021-02-02;61;176;5746;611;3.4;0.4
52;2021-02-03;89;410;5835;1021;3.4;0.6
52;2021-02-04;231;592;6066;1613;3.6;1.0
52;2021-02-05;113;505;6179;2118;3.7;1.3
52;2021-02-06;22;0;6201;2118;3.7;1.3
52;2021-02-07;0;1;6201;2119;3.7;1.3
52;2021-02-08;34;208;6235;2327;3.7;1.4
52;2021-02-09;47;216;6282;2543;3.7;1.5
52;2021-02-10;88;189;6370;2732;3.8;1.6
52;2021-02-11;129;148;6499;2880;3.8;1.7
52;2021-02-12;187;128;6686;3008;4.0;1.8
52;2021-02-13;5;1;6691;3009;4.0;1.8
52;2021-02-14;0;16;6691;3025;4.0;1.8
52;2021-02-15;79;277;6770;3302;4.0;2.0
52;2021-02-16;50;358;6820;3660;4.0;2.2
52;2021-02-17;38;313;6858;3973;4.1;2.3
52;2021-02-18;82;279;6940;4252;4.1;2.5
52;2021-02-19;50;192;6990;4444;4.1;2.6
52;2021-02-20;14;106;7004;4550;4.1;2.7
52;2021-02-21;0;0;7004;4550;4.1;2.7
52;2021-02-22;42;382;7046;4932;4.2;2.9
52;2021-02-23;56;278;7102;5210;4.2;3.1
52;2021-02-24;81;246;7183;5456;4.2;3.2
52;2021-02-25;161;238;7344;5694;4.3;3.4
52;2021-02-26;296;182;7640;5876;4.5;3.5
52;2021-02-27;149;49;7789;5925;4.6;3.5
52;2021-02-28;0;0;7789;5925;4.6;3.5
52;2021-03-01;162;14;7951;5939;4.7;3.5
52;2021-03-02;243;52;8194;5991;4.8;3.5
52;2021-03-03;356;38;8550;6029;5.1;3.6
52;2021-03-04;381;58;8931;6087;5.3;3.6
52;2021-03-05;531;54;9462;6141;5.6;3.6
52;2021-03-06;409;36;9871;6177;5.8;3.6
52;2021-03-07;0;0;9871;6177;5.8;3.6
52;2021-03-08;398;112;10269;6289;6.1;3.7
52;2021-03-09;549;111;10818;6400;6.4;3.8
52;2021-03-10;308;109;11126;6509;6.6;3.8
52;2021-03-11;587;36;11713;6545;6.9;3.9
52;2021-03-12;594;70;12307;6615;7.3;3.9
52;2021-03-13;494;11;12801;6626;7.6;3.9
52;2021-03-14;15;3;12816;6629;7.6;3.9
52;2021-03-15;318;28;13134;6657;7.8;3.9
52;2021-03-16;203;16;13337;6673;7.9;3.9
52;2021-03-17;369;16;13706;6689;8.1;4.0
52;2021-03-18;442;12;14148;6701;8.4;4.0
52;2021-03-19;453;55;14601;6756;8.6;4.0
52;2021-03-20;259;12;14860;6768;8.8;4.0
52;2021-03-21;15;1;14875;6769;8.8;4.0
52;2021-03-22;375;49;15250;6818;9.0;4.0
52;2021-03-23;686;141;15936;6959;9.4;4.1
52;2021-03-24;771;74;16707;7033;9.9;4.2
52;2021-03-25;1144;89;17851;7122;10.5;4.2
52;2021-03-26;1037;139;18888;7261;11.2;4.3
52;2021-03-27;477;77;19365;7338;11.4;4.3
52;2021-03-28;53;0;19418;7338;11.5;4.3
52;2021-03-29;507;185;19925;7523;11.8;4.4
52;2021-03-30;868;341;20793;7864;12.3;4.6
52;2021-03-31;956;293;21749;8157;12.9;4.8
52;2021-04-01;1145;183;22894;8340;13.5;4.9
52;2021-04-02;958;111;23852;8451;14.1;5.0
52;2021-04-03;462;3;24314;8454;14.4;5.0
52;2021-04-04;1;1;24315;8455;14.4;5.0
52;2021-04-05;1;0;24316;8455;14.4;5.0
52;2021-04-06;434;296;24750;8751;14.6;5.2
52;2021-04-07;506;451;25256;9202;14.9;5.4
52;2021-04-08;860;212;26116;9414;15.4;5.6
52;2021-04-09;1059;131;27175;9545;16.1;5.6
52;2021-04-10;850;102;28025;9647;16.6;5.7
52;2021-04-11;96;1;28121;9648;16.6;5.7
52;2021-04-12;933;282;29054;9930;17.2;5.9
52;2021-04-13;1251;381;30305;10311;17.9;6.1
52;2021-04-14;1345;459;31650;10770;18.7;6.4
52;2021-04-15;1505;443;33155;11213;19.6;6.6
52;2021-04-16;1569;366;34724;11579;20.5;6.8
52;2021-04-17;1312;137;36036;11716;21.3;6.9
52;2021-04-18;510;29;36546;11745;21.6;6.9
52;2021-04-19;697;612;37243;12357;22.0;7.3
52;2021-04-20;1079;679;38322;13036;22.6;7.7
52;2021-04-21;1058;675;39380;13711;23.3;8.1
52;2021-04-22;1468;736;40848;14447;24.1;8.5
52;2021-04-23;1250;671;42098;15118;24.9;8.9
52;2021-04-24;477;293;42575;15411;25.2;9.1
52;2021-04-25;3;77;42578;15488;25.2;9.2
52;2021-04-26;631;564;43209;16052;25.5;9.5
52;2021-04-27;932;672;44141;16724;26.1;9.9
52;2021-04-28;1444;570;45585;17294;26.9;10.2
52;2021-04-29;1452;583;47037;17877;27.8;10.6
52;2021-04-30;1316;618;48353;18495;28.6;10.9
52;2021-05-01;8;232;48361;18727;28.6;11.1
52;2021-05-02;0;1;48361;18728;28.6;11.1
52;2021-05-03;1159;630;49520;19358;29.3;11.4
52;2021-05-04;1445;723;50965;20081;30.1;11.9
52;2021-05-05;1767;648;52732;20729;31.2;12.2
52;2021-05-06;1963;537;54695;21266;32.3;12.6
52;2021-05-07;1441;1170;56136;22436;33.2;13.3
52;2021-05-08;587;318;56723;22754;33.5;13.4
52;2021-05-09;1;47;56724;22801;33.5;13.5
52;2021-05-10;792;1101;57516;23902;34.0;14.1
52;2021-05-11;868;1391;58384;25293;34.5;14.9
52;2021-05-12;1206;1382;59590;26675;35.2;15.8
52;2021-05-13;67;184;59657;26859;35.2;15.9
52;2021-05-14;1185;1366;60842;28225;35.9;16.7
52;2021-05-15;492;929;61334;29154;36.2;17.2
52;2021-05-16;8;43;61342;29197;36.2;17.3
52;2021-05-17;1141;705;62483;29902;36.9;17.7
52;2021-05-18;1218;677;63701;30579;37.6;18.1
52;2021-05-19;1541;415;65242;30994;38.5;18.3
52;2021-05-20;1546;422;66788;31416;39.5;18.6
52;2021-05-21;1625;611;68413;32027;40.4;18.9
52;2021-05-22;1089;210;69502;32237;41.1;19.0
52;2021-05-23;1;0;69503;32237;41.1;19.0
52;2021-05-24;405;33;69908;32270;41.3;19.1
52;2021-05-25;1352;385;71260;32655;42.1;19.3
52;2021-05-26;1476;672;72736;33327;43.0;19.7
52;2021-05-27;1564;787;74300;34114;43.9;20.2
52;2021-05-28;1494;673;75794;34787;44.8;20.6
52;2021-05-29;695;834;76489;35621;45.2;21.0
52;2021-05-30;16;551;76505;36172;45.2;21.4
52;2021-05-31;825;829;77330;37001;45.7;21.9
52;2021-06-01;956;816;78286;37817;46.3;22.3
52;2021-06-02;896;754;79182;38571;46.8;22.8
52;2021-06-03;825;825;80007;39396;47.3;23.3
52;2021-06-04;883;1340;80890;40736;47.8;24.1
52;2021-06-05;581;637;81471;41373;48.1;24.4
52;2021-06-06;27;55;81498;41428;48.2;24.5
52;2021-06-07;359;931;81857;42359;48.4;25.0
52;2021-06-08;556;1471;82413;43830;48.7;25.9
52;2021-06-09;611;1474;83024;45304;49.1;26.8
52;2021-06-10;794;1159;83818;46463;49.5;27.5
52;2021-06-11;830;1348;84648;47811;50.0;28.2
52;2021-06-12;423;586;85071;48397;50.3;28.6
52;2021-06-13;2;6;85073;48403;50.3;28.6
52;2021-06-14;170;1413;85243;49816;50.4;29.4
52;2021-06-15;221;1807;85464;51623;50.5;30.5
52;2021-06-16;351;1996;85815;53619;50.7;31.7
52;2021-06-17;265;1156;86080;54775;50.9;32.4
52;2021-06-18;308;1553;86388;56328;51.0;33.3
52;2021-06-19;502;690;86890;57018;51.3;33.7
52;2021-06-20;1;17;86891;57035;51.3;33.7
52;2021-06-21;523;898;87414;57933;51.6;34.2
52;2021-06-22;503;1047;87917;58980;51.9;34.8
52;2021-06-23;563;1041;88480;60021;52.3;35.5
52;2021-06-24;610;715;89090;60736;52.6;35.9
52;2021-06-25;661;1314;89751;62050;53.0;36.7
52;2021-06-26;264;722;90015;62772;53.2;37.1
52;2021-06-27;1;8;90016;62780;53.2;37.1
52;2021-06-28;184;1442;90200;64222;53.3;37.9
52;2021-06-29;163;1414;90363;65636;53.4;38.8
52;2021-06-30;221;1468;90584;67104;53.5;39.6
52;2021-07-01;320;1020;90904;68124;53.7;40.3
52;2021-07-02;430;1454;91334;69578;54.0;41.1
52;2021-07-03;302;1148;91636;70726;54.1;41.8
52;2021-07-04;0;11;91636;70737;54.1;41.8
52;2021-07-05;175;1448;91811;72185;54.2;42.6
52;2021-07-06;284;1449;92095;73634;54.4;43.5
52;2021-07-07;309;1163;92404;74797;54.6;44.2
52;2021-07-08;473;1166;92877;75963;54.9;44.9
52;2021-07-09;288;1620;93165;77583;55.0;45.8
52;2021-07-10;155;822;93320;78405;55.1;46.3
52;2021-07-11;13;12;93333;78417;55.1;46.3
52;2021-07-12;299;1467;93632;79884;55.3;47.2
52;2021-07-13;590;1369;94222;81253;55.7;48.0
52;2021-07-14;437;153;94659;81406;55.9;48.1
52;2021-07-15;614;1428;95273;82834;56.3;48.9
52;2021-07-16;899;1339;96172;84173;56.8;49.7
52;2021-07-17;530;343;96702;84516;57.1;49.9
52;2021-07-18;3;12;96705;84528;57.1;49.9
52;2021-07-19;691;987;97396;85515;57.5;50.5
52;2021-07-20;1110;831;98506;86346;58.2;51.0
52;2021-07-21;1161;738;99667;87084;58.9;51.5
52;2021-07-22;1447;869;101114;87953;59.7;52.0
52;2021-07-23;1399;956;102513;88909;60.6;52.5
52;2021-07-24;873;487;103386;89396;61.1;52.8
52;2021-07-25;22;21;103408;89417;61.1;52.8
52;2021-07-26;1010;614;104418;90031;61.7;53.2
52;2021-07-27;1342;657;105760;90688;62.5;53.6
52;2021-07-28;1382;644;107142;91332;63.3;54.0
52;2021-07-29;1263;622;108405;91954;64.1;54.3
52;2021-07-30;1365;713;109770;92667;64.9;54.8
52;2021-07-31;873;549;110643;93216;65.4;55.1
52;2021-08-01;1;14;110644;93230;65.4;55.1
52;2021-08-02;1185;561;111829;93791;66.1;55.4
52;2021-08-03;1363;540;113192;94331;66.9;55.7
52;2021-08-04;1157;579;114349;94910;67.6;56.1
52;2021-08-05;1026;574;115375;95484;68.2;56.4
52;2021-08-06;1057;698;116432;96182;68.8;56.8
52;2021-08-07;519;422;116951;96604;69.1;57.1
52;2021-08-08;0;6;116951;96610;69.1;57.1
52;2021-08-09;469;871;117420;97481;69.4;57.6
52;2021-08-10;717;748;118137;98229;69.8;58.0
52;2021-08-11;535;837;118672;99066;70.1;58.5
52;2021-08-12;623;750;119295;99816;70.5;59.0
52;2021-08-13;420;1029;119715;100845;70.7;59.6
52;2021-08-14;421;360;120136;101205;71.0;59.8
52;2021-08-15;13;13;120149;101218;71.0;59.8
52;2021-08-16;327;934;120476;102152;71.2;60.4
52;2021-08-17;416;911;120892;103063;71.4;60.9
52;2021-08-18;489;944;121381;104007;71.7;61.5
52;2021-08-19;461;836;121842;104843;72.0;61.9
52;2021-08-20;384;1210;122226;106053;72.2;62.7
52;2021-08-21;394;605;122620;106658;72.4;63.0
52;2021-08-22;5;11;122625;106669;72.5;63.0
52;2021-08-23;431;1058;123056;107727;72.7;63.6
52;2021-08-24;307;1077;123363;108804;72.9;64.3
52;2021-08-25;254;1061;123617;109865;73.0;64.9
52;2021-08-26;302;914;123919;110779;73.2;65.5
52;2021-08-27;429;1276;124348;112055;73.5;66.2
52;2021-08-28;243;495;124591;112550;73.6;66.5
52;2021-08-29;3;25;124594;112575;73.6;66.5
52;2021-08-30;204;977;124798;113552;73.7;67.1
52;2021-08-31;205;1034;125003;114586;73.9;67.7
52;2021-09-01;183;1040;125186;115626;74.0;68.3
52;2021-09-02;194;698;125380;116324;74.1;68.7
52;2021-09-03;243;857;125623;117181;74.2;69.2
52;2021-09-04;189;527;125812;117708;74.3;69.5
52;2021-09-05;2;13;125814;117721;74.3;69.6
52;2021-09-06;126;511;125940;118232;74.4;69.9
52;2021-09-07;163;420;126103;118652;74.5;70.1
52;2021-09-08;143;571;126246;119223;74.6;70.4
52;2021-09-09;139;362;126385;119585;74.7;70.7
52;2021-09-10;256;640;126641;120225;74.8;71.0
52;2021-09-11;151;292;126792;120517;74.9;71.2
52;2021-09-12;2;9;126794;120526;74.9;71.2
52;2021-09-13;176;494;126970;121020;75.0;71.5
52;2021-09-14;146;325;127116;121345;75.1;71.7
52;2021-09-15;150;448;127266;121793;75.2;72.0
52;2021-09-16;136;309;127402;122102;75.3;72.1
52;2021-09-17;232;543;127634;122645;75.4;72.5
52;2021-09-18;134;243;127768;122888;75.5;72.6
52;2021-09-19;4;18;127772;122906;75.5;72.6
52;2021-09-20;106;355;127878;123261;75.6;72.8
52;2021-09-21;94;208;127972;123469;75.6;73.0
52;2021-09-22;107;319;128079;123788;75.7;73.1
52;2021-09-23;138;207;128217;123995;75.8;73.3
52;2021-09-24;128;284;128345;124279;75.8;73.4
52;2021-09-25;93;250;128438;124529;75.9;73.6
52;2021-09-26;0;0;128438;124529;75.9;73.6
52;2021-09-27;116;181;128554;124710;76.0;73.7
52;2021-09-28;120;144;128674;124854;76.0;73.8
52;2021-09-29;93;207;128767;125061;76.1;73.9
52;2021-09-30;117;125;128884;125186;76.2;74.0
52;2021-10-01;117;226;129001;125412;76.2;74.1
52;2021-10-02;63;150;129064;125562;76.3;74.2
52;2021-10-03;0;6;129064;125568;76.3;74.2
52;2021-10-04;83;179;129147;125747;76.3;74.3
52;2021-10-05;57;133;129204;125880;76.3;74.4
52;2021-10-06;120;170;129324;126050;76.4;74.5
52;2021-10-07;54;101;129378;126151;76.4;74.5
52;2021-10-08;112;225;129490;126376;76.5;74.7
52;2021-10-09;66;132;129556;126508;76.5;74.7
52;2021-10-10;0;1;129556;126509;76.5;74.7
52;2021-10-11;43;163;129599;126672;76.6;74.8
53;2020-12-27;0;0;0;0;0.0;0.0
53;2020-12-28;0;0;0;0;0.0;0.0
53;2020-12-29;0;0;0;0;0.0;0.0
53;2020-12-30;0;0;0;0;0.0;0.0
53;2020-12-31;0;0;0;0;0.0;0.0
53;2021-01-01;0;0;0;0;0.0;0.0
53;2021-01-02;3;1;3;1;0.0;0.0
53;2021-01-03;0;0;3;1;0.0;0.0
53;2021-01-04;1;0;4;1;0.0;0.0
53;2021-01-05;0;0;4;1;0.0;0.0
53;2021-01-06;0;0;4;1;0.0;0.0
53;2021-01-07;102;0;106;1;0.0;0.0
53;2021-01-08;284;1;390;2;0.1;0.0
53;2021-01-09;134;1;524;3;0.2;0.0
53;2021-01-10;15;0;539;3;0.2;0.0
53;2021-01-11;176;1;715;4;0.2;0.0
53;2021-01-12;456;1;1171;5;0.4;0.0
53;2021-01-13;254;0;1425;5;0.5;0.0
53;2021-01-14;290;7;1715;12;0.6;0.0
53;2021-01-15;343;4;2058;16;0.7;0.0
53;2021-01-16;60;0;2118;16;0.7;0.0
53;2021-01-17;25;2;2143;18;0.7;0.0
53;2021-01-18;364;0;2507;18;0.8;0.0
53;2021-01-19;594;0;3101;18;1.0;0.0
53;2021-01-20;742;0;3843;18;1.3;0.0
53;2021-01-21;773;3;4616;21;1.5;0.0
53;2021-01-22;703;10;5319;31;1.7;0.0
53;2021-01-23;160;1;5479;32;1.8;0.0
53;2021-01-24;6;0;5485;32;1.8;0.0
53;2021-01-25;550;0;6035;32;2.0;0.0
53;2021-01-26;1199;7;7234;39;2.4;0.0
53;2021-01-27;696;6;7930;45;2.6;0.0
53;2021-01-28;737;97;8667;142;2.8;0.0
53;2021-01-29;422;187;9089;329;3.0;0.1
53;2021-01-30;130;0;9219;329;3.0;0.1
53;2021-01-31;0;0;9219;329;3.0;0.1
53;2021-02-01;298;149;9517;478;3.1;0.2
53;2021-02-02;309;232;9826;710;3.2;0.2
53;2021-02-03;228;377;10054;1087;3.3;0.4
53;2021-02-04;184;332;10238;1419;3.4;0.5
53;2021-02-05;234;303;10472;1722;3.4;0.6
53;2021-02-06;153;23;10625;1745;3.5;0.6
53;2021-02-07;0;0;10625;1745;3.5;0.6
53;2021-02-08;168;106;10793;1851;3.5;0.6
53;2021-02-09;369;216;11162;2067;3.7;0.7
53;2021-02-10;266;433;11428;2500;3.7;0.8
53;2021-02-11;433;492;11861;2992;3.9;1.0
53;2021-02-12;318;572;12179;3564;4.0;1.2
53;2021-02-13;96;66;12275;3630;4.0;1.2
53;2021-02-14;0;99;12275;3729;4.0;1.2
53;2021-02-15;239;431;12514;4160;4.1;1.4
53;2021-02-16;527;840;13041;5000;4.3;1.6
53;2021-02-17;391;614;13432;5614;4.4;1.8
53;2021-02-18;547;579;13979;6193;4.6;2.0
53;2021-02-19;895;429;14874;6622;4.9;2.2
53;2021-02-20;139;113;15013;6735;4.9;2.2
53;2021-02-21;1;20;15014;6755;4.9;2.2
53;2021-02-22;161;584;15175;7339;5.0;2.4
53;2021-02-23;59;655;15234;7994;5.0;2.6
53;2021-02-24;137;517;15371;8511;5.0;2.8
53;2021-02-25;457;360;15828;8871;5.2;2.9
53;2021-02-26;437;262;16265;9133;5.3;3.0
53;2021-02-27;86;115;16351;9248;5.4;3.0
53;2021-02-28;0;0;16351;9248;5.4;3.0
53;2021-03-01;231;278;16582;9526;5.4;3.1
53;2021-03-02;246;255;16828;9781;5.5;3.2
53;2021-03-03;321;392;17149;10173;5.6;3.3
53;2021-03-04;859;347;18008;10520;5.9;3.4
53;2021-03-05;660;281;18668;10801;6.1;3.5
53;2021-03-06;447;212;19115;11013;6.3;3.6
53;2021-03-07;276;5;19391;11018;6.4;3.6
53;2021-03-08;375;181;19766;11199;6.5;3.7
53;2021-03-09;878;248;20644;11447;6.8;3.7
53;2021-03-10;807;111;21451;11558;7.0;3.8
53;2021-03-11;1247;229;22698;11787;7.4;3.9
53;2021-03-12;1603;149;24301;11936;8.0;3.9
53;2021-03-13;824;15;25125;11951;8.2;3.9
53;2021-03-14;1;0;25126;11951;8.2;3.9
53;2021-03-15;1001;300;26127;12251;8.6;4.0
53;2021-03-16;1035;332;27162;12583;8.9;4.1
53;2021-03-17;687;261;27849;12844;9.1;4.2
53;2021-03-18;972;345;28821;13189;9.4;4.3
53;2021-03-19;1346;600;30167;13789;9.9;4.5
53;2021-03-20;592;17;30759;13806;10.1;4.5
53;2021-03-21;3;1;30762;13807;10.1;4.5
53;2021-03-22;1213;159;31975;13966;10.5;4.6
53;2021-03-23;1699;73;33674;14039;11.0;4.6
53;2021-03-24;1323;118;34997;14157;11.5;4.6
53;2021-03-25;2323;246;37320;14403;12.2;4.7
53;2021-03-26;1882;153;39202;14556;12.8;4.8
53;2021-03-27;339;3;39541;14559;12.9;4.8
53;2021-03-28;2;0;39543;14559;12.9;4.8
53;2021-03-29;1474;213;41017;14772;13.4;4.8
53;2021-03-30;1944;205;42961;14977;14.1;4.9
53;2021-03-31;1791;225;44752;15202;14.7;5.0
53;2021-04-01;1948;675;46700;15877;15.3;5.2
53;2021-04-02;2075;229;48775;16106;16.0;5.3
53;2021-04-03;414;2;49189;16108;16.1;5.3
53;2021-04-04;11;0;49200;16108;16.1;5.3
53;2021-04-05;9;15;49209;16123;16.1;5.3
53;2021-04-06;1305;507;50514;16630;16.5;5.4
53;2021-04-07;1172;927;51686;17557;16.9;5.7
53;2021-04-08;1663;1010;53349;18567;17.5;6.1
53;2021-04-09;1959;408;55308;18975;18.1;6.2
53;2021-04-10;543;13;55851;18988;18.3;6.2
53;2021-04-11;13;0;55864;18988;18.3;6.2
53;2021-04-12;694;1069;56558;20057;18.5;6.6
53;2021-04-13;1470;1110;58028;21167;19.0;6.9
53;2021-04-14;1022;738;59050;21905;19.3;7.2
53;2021-04-15;1156;1109;60206;23014;19.7;7.5
53;2021-04-16;1271;816;61477;23830;20.1;7.8
53;2021-04-17;279;274;61756;24104;20.2;7.9
53;2021-04-18;0;0;61756;24104;20.2;7.9
53;2021-04-19;681;1068;62437;25172;20.4;8.2
53;2021-04-20;936;1453;63373;26625;20.8;8.7
53;2021-04-21;852;1013;64225;27638;21.0;9.1
53;2021-04-22;1045;1617;65270;29255;21.4;9.6
53;2021-04-23;1329;1055;66599;30310;21.8;9.9
53;2021-04-24;68;7;66667;30317;21.8;9.9
53;2021-04-25;6;39;66673;30356;21.8;9.9
53;2021-04-26;368;1238;67041;31594;22.0;10.3
53;2021-04-27;723;1975;67764;33569;22.2;11.0
53;2021-04-28;977;1393;68741;34962;22.5;11.4
53;2021-04-29;1052;1715;69793;36677;22.9;12.0
53;2021-04-30;1366;1316;71159;37993;23.3;12.4
53;2021-05-01;36;51;71195;38044;23.3;12.5
53;2021-05-02;0;0;71195;38044;23.3;12.5
53;2021-05-03;1570;709;72765;38753;23.8;12.7
53;2021-05-04;1303;1441;74068;40194;24.3;13.2
53;2021-05-05;1611;827;75679;41021;24.8;13.4
53;2021-05-06;1390;1404;77069;42425;25.2;13.9
53;2021-05-07;1537;1306;78606;43731;25.7;14.3
53;2021-05-08;939;36;79545;43767;26.0;14.3
53;2021-05-09;11;2;79556;43769;26.1;14.3
53;2021-05-10;2414;815;81970;44584;26.8;14.6
53;2021-05-11;3097;1286;85067;45870;27.9;15.0
53;2021-05-12;2751;1094;87818;46964;28.8;15.4
53;2021-05-13;350;27;88168;46991;28.9;15.4
53;2021-05-14;2021;678;90189;47669;29.5;15.6
53;2021-05-15;1058;63;91247;47732;29.9;15.6
53;2021-05-16;3;0;91250;47732;29.9;15.6
53;2021-05-17;1701;1196;92951;48928;30.4;16.0
53;2021-05-18;1880;1551;94831;50479;31.1;16.5
53;2021-05-19;2302;748;97133;51227;31.8;16.8
53;2021-05-20;3216;867;100349;52094;32.9;17.1
53;2021-05-21;2798;829;103147;52923;33.8;17.3
53;2021-05-22;21;60;103168;52983;33.8;17.4
53;2021-05-23;1;0;103169;52983;33.8;17.4
53;2021-05-24;8;6;103177;52989;33.8;17.4
53;2021-05-25;1820;803;104997;53792;34.4;17.6
53;2021-05-26;1853;908;106850;54700;35.0;17.9
53;2021-05-27;3072;1079;109922;55779;36.0;18.3
53;2021-05-28;2562;884;112484;56663;36.8;18.6
53;2021-05-29;846;244;113330;56907;37.1;18.6
53;2021-05-30;18;6;113348;56913;37.1;18.6
53;2021-05-31;2565;802;115913;57715;38.0;18.9
53;2021-06-01;3489;1257;119402;58972;39.1;19.3
53;2021-06-02;3183;526;122585;59498;40.1;19.5
53;2021-06-03;4198;789;126783;60287;41.5;19.7
53;2021-06-04;3179;1266;129962;61553;42.6;20.2
53;2021-06-05;137;245;130099;61798;42.6;20.2
53;2021-06-06;1;4;130100;61802;42.6;20.2
53;2021-06-07;2629;922;132729;62724;43.5;20.5
53;2021-06-08;3588;1130;136317;63854;44.6;20.9
53;2021-06-09;2455;944;138772;64798;45.4;21.2
53;2021-06-10;3521;848;142293;65646;46.6;21.5
53;2021-06-11;2964;1213;145257;66859;47.6;21.9
53;2021-06-12;108;138;145365;66997;47.6;21.9
53;2021-06-13;10;2;145375;66999;47.6;21.9
53;2021-06-14;1600;1789;146975;68788;48.1;22.5
53;2021-06-15;1898;2265;148873;71053;48.8;23.3
53;2021-06-16;1828;1733;150701;72786;49.4;23.8
53;2021-06-17;3011;1651;153712;74437;50.3;24.4
53;2021-06-18;2705;1808;156417;76245;51.2;25.0
53;2021-06-19;761;1165;157178;77410;51.5;25.3
53;2021-06-20;3;479;157181;77889;51.5;25.5
53;2021-06-21;918;2525;158099;80414;51.8;26.3
53;2021-06-22;1299;3452;159398;83866;52.2;27.5
53;2021-06-23;1362;2892;160760;86758;52.6;28.4
53;2021-06-24;1802;2033;162562;88791;53.2;29.1
53;2021-06-25;1785;2045;164347;90836;53.8;29.7
53;2021-06-26;977;351;165324;91187;54.1;29.9
53;2021-06-27;8;8;165332;91195;54.1;29.9
53;2021-06-28;662;2899;165994;94094;54.4;30.8
53;2021-06-29;858;3648;166852;97742;54.6;32.0
53;2021-06-30;749;1518;167601;99260;54.9;32.5
53;2021-07-01;1507;2630;169108;101890;55.4;33.4
53;2021-07-02;1528;2026;170636;103916;55.9;34.0
53;2021-07-03;858;574;171494;104490;56.2;34.2
53;2021-07-04;0;4;171494;104494;56.2;34.2
53;2021-07-05;542;2058;172036;106552;56.3;34.9
53;2021-07-06;859;3615;172895;110167;56.6;36.1
53;2021-07-07;1024;2652;173919;112819;57.0;36.9
53;2021-07-08;1313;3116;175232;115935;57.4;38.0
53;2021-07-09;1131;3399;176363;119334;57.8;39.1
53;2021-07-10;422;1001;176785;120335;57.9;39.4
53;2021-07-11;12;20;176797;120355;57.9;39.4
53;2021-07-12;503;3707;177300;124062;58.1;40.6
53;2021-07-13;894;4763;178194;128825;58.4;42.2
53;2021-07-14;104;284;178298;129109;58.4;42.3
53;2021-07-15;1112;4346;179410;133455;58.8;43.7
53;2021-07-16;1248;3847;180658;137302;59.2;45.0
53;2021-07-17;1318;300;181976;137602;59.6;45.1
53;2021-07-18;27;20;182003;137622;59.6;45.1
53;2021-07-19;734;3426;182737;141048;59.8;46.2
53;2021-07-20;985;4123;183722;145171;60.2;47.5
53;2021-07-21;686;3274;184408;148445;60.4;48.6
53;2021-07-22;1512;3525;185920;151970;60.9;49.8
53;2021-07-23;1603;3761;187523;155731;61.4;51.0
53;2021-07-24;956;280;188479;156011;61.7;51.1
53;2021-07-25;60;24;188539;156035;61.7;51.1
53;2021-07-26;1727;1941;190266;157976;62.3;51.7
53;2021-07-27;2356;2824;192622;160800;63.1;52.7
53;2021-07-28;2145;2813;194767;163613;63.8;53.6
53;2021-07-29;2491;2546;197258;166159;64.6;54.4
53;2021-07-30;1828;2647;199086;168806;65.2;55.3
53;2021-07-31;626;232;199712;169038;65.4;55.4
53;2021-08-01;37;25;199749;169063;65.4;55.4
53;2021-08-02;2082;1733;201831;170796;66.1;55.9
53;2021-08-03;2415;1905;204246;172701;66.9;56.6
53;2021-08-04;2475;1863;206721;174564;67.7;57.2
53;2021-08-05;2869;1542;209590;176106;68.6;57.7
53;2021-08-06;2517;1720;212107;177826;69.5;58.2
53;2021-08-07;483;272;212590;178098;69.6;58.3
53;2021-08-08;6;19;212596;178117;69.6;58.3
53;2021-08-09;1839;1650;214435;179767;70.2;58.9
53;2021-08-10;2324;1748;216759;181515;71.0;59.4
53;2021-08-11;1680;867;218439;182382;71.5;59.7
53;2021-08-12;2007;984;220446;183366;72.2;60.0
53;2021-08-13;2039;1315;222485;184681;72.9;60.5
53;2021-08-14;66;63;222551;184744;72.9;60.5
53;2021-08-15;1;2;222552;184746;72.9;60.5
53;2021-08-16;1337;1596;223889;186342;73.3;61.0
53;2021-08-17;1548;1657;225437;187999;73.8;61.6
53;2021-08-18;1515;1600;226952;189599;74.3;62.1
53;2021-08-19;1374;1972;228326;191571;74.8;62.7
53;2021-08-20;1099;2082;229425;193653;75.1;63.4
53;2021-08-21;189;341;229614;193994;75.2;63.5
53;2021-08-22;0;0;229614;193994;75.2;63.5
53;2021-08-23;843;1915;230457;195909;75.5;64.2
53;2021-08-24;903;2117;231360;198026;75.8;64.8
53;2021-08-25;915;2272;232275;200298;76.1;65.6
53;2021-08-26;666;2614;232941;202912;76.3;66.4
53;2021-08-27;754;2645;233695;205557;76.5;67.3
53;2021-08-28;48;133;233743;205690;76.5;67.4
53;2021-08-29;12;31;233755;205721;76.5;67.4
53;2021-08-30;620;2085;234375;207806;76.8;68.1
53;2021-08-31;762;2859;235137;210665;77.0;69.0
53;2021-09-01;342;1544;235479;212209;77.1;69.5
53;2021-09-02;441;1701;235920;213910;77.3;70.1
53;2021-09-03;449;2338;236369;216248;77.4;70.8
53;2021-09-04;115;188;236484;216436;77.4;70.9
53;2021-09-05;1;12;236485;216448;77.4;70.9
53;2021-09-06;299;1468;236784;217916;77.5;71.4
53;2021-09-07;288;1782;237072;219698;77.6;71.9
53;2021-09-08;421;2006;237493;221704;77.8;72.6
53;2021-09-09;237;1351;237730;223055;77.9;73.0
53;2021-09-10;383;1838;238113;224893;78.0;73.6
53;2021-09-11;39;86;238152;224979;78.0;73.7
53;2021-09-12;0;1;238152;224980;78.0;73.7
53;2021-09-13;231;974;238383;225954;78.1;74.0
53;2021-09-14;243;841;238626;226795;78.1;74.3
53;2021-09-15;334;1071;238960;227866;78.3;74.6
53;2021-09-16;305;380;239265;228246;78.4;74.7
53;2021-09-17;429;1057;239694;229303;78.5;75.1
53;2021-09-18;44;70;239738;229373;78.5;75.1
53;2021-09-19;8;14;239746;229387;78.5;75.1
53;2021-09-20;123;382;239869;229769;78.6;75.2
53;2021-09-21;248;651;240117;230420;78.6;75.5
53;2021-09-22;193;665;240310;231085;78.7;75.7
53;2021-09-23;132;395;240442;231480;78.7;75.8
53;2021-09-24;197;639;240639;232119;78.8;76.0
53;2021-09-25;27;50;240666;232169;78.8;76.0
53;2021-09-26;0;0;240666;232169;78.8;76.0
53;2021-09-27;160;374;240826;232543;78.9;76.2
53;2021-09-28;163;281;240989;232824;78.9;76.2
53;2021-09-29;159;488;241148;233312;79.0;76.4
53;2021-09-30;87;213;241235;233525;79.0;76.5
53;2021-10-01;267;621;241502;234146;79.1;76.7
53;2021-10-02;28;52;241530;234198;79.1;76.7
53;2021-10-03;3;7;241533;234205;79.1;76.7
53;2021-10-04;132;277;241665;234482;79.1;76.8
53;2021-10-05;109;210;241774;234692;79.2;76.9
53;2021-10-06;187;345;241961;235037;79.2;77.0
53;2021-10-07;82;287;242043;235324;79.3;77.1
53;2021-10-08;243;537;242286;235861;79.3;77.2
53;2021-10-09;14;27;242300;235888;79.3;77.2
53;2021-10-10;0;0;242300;235888;79.3;77.2
53;2021-10-11;108;159;242408;236047;79.4;77.3
54;2020-12-27;0;0;0;0;0.0;0.0
54;2020-12-28;1;0;1;0;0.0;0.0
54;2020-12-29;0;0;1;0;0.0;0.0
54;2020-12-30;1;0;2;0;0.0;0.0
54;2020-12-31;10;0;12;0;0.0;0.0
54;2021-01-01;0;0;12;0;0.0;0.0
54;2021-01-02;0;0;12;0;0.0;0.0
54;2021-01-03;2;0;14;0;0.0;0.0
54;2021-01-04;163;0;177;0;0.0;0.0
54;2021-01-05;396;2;573;2;0.1;0.0
54;2021-01-06;650;1;1223;3;0.2;0.0
54;2021-01-07;816;2;2039;5;0.3;0.0
54;2021-01-08;706;3;2745;8;0.4;0.0
54;2021-01-09;81;0;2826;8;0.4;0.0
54;2021-01-10;78;0;2904;8;0.4;0.0
54;2021-01-11;974;3;3878;11;0.5;0.0
54;2021-01-12;1182;1;5060;12;0.7;0.0
54;2021-01-13;2428;9;7488;21;1.0;0.0
54;2021-01-14;3401;28;10889;49;1.5;0.0
54;2021-01-15;2718;19;13607;68;1.9;0.0
54;2021-01-16;815;4;14422;72;2.0;0.0
54;2021-01-17;209;0;14631;72;2.0;0.0
54;2021-01-18;1558;7;16189;79;2.2;0.0
54;2021-01-19;1707;2;17896;81;2.5;0.0
54;2021-01-20;1525;5;19421;86;2.7;0.0
54;2021-01-21;1373;5;20794;91;2.8;0.0
54;2021-01-22;1092;8;21886;99;3.0;0.0
54;2021-01-23;477;1;22363;100;3.1;0.0
54;2021-01-24;66;0;22429;100;3.1;0.0
54;2021-01-25;946;35;23375;135;3.2;0.0
54;2021-01-26;142;5;23517;140;3.2;0.0
54;2021-01-27;12;166;23529;306;3.2;0.0
54;2021-01-28;32;229;23561;535;3.2;0.1
54;2021-01-29;19;275;23580;810;3.2;0.1
54;2021-01-30;7;1;23587;811;3.2;0.1
54;2021-01-31;1;0;23588;811;3.2;0.1
54;2021-02-01;13;784;23601;1595;3.2;0.2
54;2021-02-02;25;966;23626;2561;3.2;0.4
54;2021-02-03;364;1530;23990;4091;3.3;0.6
54;2021-02-04;739;2454;24729;6545;3.4;0.9
54;2021-02-05;799;1888;25528;8433;3.5;1.2
54;2021-02-06;204;333;25732;8766;3.5;1.2
54;2021-02-07;4;124;25736;8890;3.5;1.2
54;2021-02-08;117;994;25853;9884;3.5;1.4
54;2021-02-09;306;1067;26159;10951;3.6;1.5
54;2021-02-10;386;795;26545;11746;3.6;1.6
54;2021-02-11;294;813;26839;12559;3.7;1.7
54;2021-02-12;446;1292;27285;13851;3.7;1.9
54;2021-02-13;148;236;27433;14087;3.8;1.9
54;2021-02-14;9;11;27442;14098;3.8;1.9
54;2021-02-15;428;1128;27870;15226;3.8;2.1
54;2021-02-16;401;1222;28271;16448;3.9;2.3
54;2021-02-17;518;956;28789;17404;3.9;2.4
54;2021-02-18;595;780;29384;18184;4.0;2.5
54;2021-02-19;519;777;29903;18961;4.1;2.6
54;2021-02-20;34;282;29937;19243;4.1;2.6
54;2021-02-21;3;24;29940;19267;4.1;2.6
54;2021-02-22;484;598;30424;19865;4.2;2.7
54;2021-02-23;679;560;31103;20425;4.3;2.8
54;2021-02-24;728;354;31831;20779;4.4;2.8
54;2021-02-25;1474;724;33305;21503;4.6;2.9
54;2021-02-26;1776;791;35081;22294;4.8;3.1
54;2021-02-27;698;111;35779;22405;4.9;3.1
54;2021-02-28;11;28;35790;22433;4.9;3.1
54;2021-03-01;625;218;36415;22651;5.0;3.1
54;2021-03-02;1456;151;37871;22802;5.2;3.1
54;2021-03-03;1737;63;39608;22865;5.4;3.1
54;2021-03-04;2014;103;41622;22968;5.7;3.1
54;2021-03-05;2797;146;44419;23114;6.1;3.2
54;2021-03-06;4024;119;48443;23233;6.6;3.2
54;2021-03-07;2625;72;51068;23305;7.0;3.2
54;2021-03-08;1338;68;52406;23373;7.2;3.2
54;2021-03-09;2627;107;55033;23480;7.5;3.2
54;2021-03-10;3184;114;58217;23594;8.0;3.2
54;2021-03-11;3380;104;61597;23698;8.4;3.2
54;2021-03-12;4949;200;66546;23898;9.1;3.3
54;2021-03-13;4203;134;70749;24032;9.7;3.3
54;2021-03-14;543;40;71292;24072;9.8;3.3
54;2021-03-15;1719;105;73011;24177;10.0;3.3
54;2021-03-16;1730;159;74741;24336;10.2;3.3
54;2021-03-17;2080;138;76821;24474;10.5;3.4
54;2021-03-18;2063;168;78884;24642;10.8;3.4
54;2021-03-19;3319;269;82203;24911;11.3;3.4
54;2021-03-20;2308;79;84511;24990;11.6;3.4
54;2021-03-21;294;14;84805;25004;11.6;3.4
54;2021-03-22;1034;308;85839;25312;11.8;3.5
54;2021-03-23;1938;457;87777;25769;12.0;3.5
54;2021-03-24;2194;698;89971;26467;12.3;3.6
54;2021-03-25;3172;723;93143;27190;12.8;3.7
54;2021-03-26;3512;806;96655;27996;13.2;3.8
54;2021-03-27;2420;278;99075;28274;13.6;3.9
54;2021-03-28;280;7;99355;28281;13.6;3.9
54;2021-03-29;1668;359;101023;28640;13.8;3.9
54;2021-03-30;2558;906;103581;29546;14.2;4.0
54;2021-03-31;2599;1135;106180;30681;14.5;4.2
54;2021-04-01;3237;1272;109417;31953;15.0;4.4
54;2021-04-02;2962;1679;112379;33632;15.4;4.6
54;2021-04-03;1264;1310;113643;34942;15.6;4.8
54;2021-04-04;137;421;113780;35363;15.6;4.8
54;2021-04-05;144;574;113924;35937;15.6;4.9
54;2021-04-06;1265;1649;115189;37586;15.8;5.1
54;2021-04-07;923;2248;116112;39834;15.9;5.5
54;2021-04-08;2325;2447;118437;42281;16.2;5.8
54;2021-04-09;4114;3139;122551;45420;16.8;6.2
54;2021-04-10;3207;1681;125758;47101;17.2;6.4
54;2021-04-11;206;1001;125964;48102;17.2;6.6
54;2021-04-12;2198;1532;128162;49634;17.5;6.8
54;2021-04-13;3001;1981;131163;51615;18.0;7.1
54;2021-04-14;3260;1872;134423;53487;18.4;7.3
54;2021-04-15;2876;2303;137299;55790;18.8;7.6
54;2021-04-16;3141;2605;140440;58395;19.2;8.0
54;2021-04-17;3475;1488;143915;59883;19.7;8.2
54;2021-04-18;64;245;143979;60128;19.7;8.2
54;2021-04-19;2464;1090;146443;61218;20.0;8.4
54;2021-04-20;3011;1257;149454;62475;20.5;8.6
54;2021-04-21;4401;1643;153855;64118;21.1;8.8
54;2021-04-22;3723;2393;157578;66511;21.6;9.1
54;2021-04-23;3868;2091;161446;68602;22.1;9.4
54;2021-04-24;2347;1040;163793;69642;22.4;9.5
54;2021-04-25;284;277;164077;69919;22.5;9.6
54;2021-04-26;2306;1274;166383;71193;22.8;9.7
54;2021-04-27;3288;1442;169671;72635;23.2;9.9
54;2021-04-28;2974;1961;172645;74596;23.6;10.2
54;2021-04-29;3795;2089;176440;76685;24.2;10.5
54;2021-04-30;4493;1981;180933;78666;24.8;10.8
54;2021-05-01;2265;808;183198;79474;25.1;10.9
54;2021-05-02;229;68;183427;79542;25.1;10.9
54;2021-05-03;3097;949;186524;80491;25.5;11.0
54;2021-05-04;3514;1458;190038;81949;26.0;11.2
54;2021-05-05;4892;1420;194930;83369;26.7;11.4
54;2021-05-06;4434;2803;199364;86172;27.3;11.8
54;2021-05-07;4823;3418;204187;89590;28.0;12.3
54;2021-05-08;2030;644;206217;90234;28.2;12.4
54;2021-05-09;375;136;206592;90370;28.3;12.4
54;2021-05-10;3207;2242;209799;92612;28.7;12.7
54;2021-05-11;5492;2939;215291;95551;29.5;13.1
54;2021-05-12;4146;3390;219437;98941;30.0;13.5
54;2021-05-13;2648;492;222085;99433;30.4;13.6
54;2021-05-14;6883;2003;228968;101436;31.3;13.9
54;2021-05-15;5484;1324;234452;102760;32.1;14.1
54;2021-05-16;944;108;235396;102868;32.2;14.1
54;2021-05-17;3799;830;239195;103698;32.7;14.2
54;2021-05-18;3288;1104;242483;104802;33.2;14.3
54;2021-05-19;3464;1515;245947;106317;33.7;14.6
54;2021-05-20;4538;1621;250485;107938;34.3;14.8
54;2021-05-21;6753;2522;257238;110460;35.2;15.1
54;2021-05-22;5662;1377;262900;111837;36.0;15.3
54;2021-05-23;504;55;263404;111892;36.1;15.3
54;2021-05-24;1444;343;264848;112235;36.3;15.4
54;2021-05-25;4200;1544;269048;113779;36.8;15.6
54;2021-05-26;3535;2218;272583;115997;37.3;15.9
54;2021-05-27;4179;2434;276762;118431;37.9;16.2
54;2021-05-28;4990;3573;281752;122004;38.6;16.7
54;2021-05-29;3844;3999;285596;126003;39.1;17.3
54;2021-05-30;127;83;285723;126086;39.1;17.3
54;2021-05-31;2940;3066;288663;129152;39.5;17.7
54;2021-06-01;2622;4194;291285;133346;39.9;18.3
54;2021-06-02;2167;4097;293452;137443;40.2;18.8
54;2021-06-03;3145;5655;296597;143098;40.6;19.6
54;2021-06-04;5103;5492;301700;148590;41.3;20.3
54;2021-06-05;2342;3283;304042;151873;41.6;20.8
54;2021-06-06;72;236;304114;152109;41.6;20.8
54;2021-06-07;3706;2937;307820;155046;42.1;21.2
54;2021-06-08;4544;4274;312364;159320;42.8;21.8
54;2021-06-09;6003;3318;318367;162638;43.6;22.3
54;2021-06-10;5296;4452;323663;167090;44.3;22.9
54;2021-06-11;5023;4923;328686;172013;45.0;23.6
54;2021-06-12;4242;3233;332928;175246;45.6;24.0
54;2021-06-13;54;210;332982;175456;45.6;24.0
54;2021-06-14;2334;3595;335316;179051;45.9;24.5
54;2021-06-15;2831;4730;338147;183781;46.3;25.2
54;2021-06-16;3491;5658;341638;189439;46.8;25.9
54;2021-06-17;3138;5222;344776;194661;47.2;26.7
54;2021-06-18;4157;6242;348933;200903;47.8;27.5
54;2021-06-19;2648;3129;351581;204032;48.1;27.9
54;2021-06-20;101;339;351682;204371;48.1;28.0
54;2021-06-21;2556;4772;354238;209143;48.5;28.6
54;2021-06-22;2047;6223;356285;215366;48.8;29.5
54;2021-06-23;2245;5596;358530;220962;49.1;30.3
54;2021-06-24;2090;3455;360620;224417;49.4;30.7
54;2021-06-25;2196;7061;362816;231478;49.7;31.7
54;2021-06-26;2383;5674;365199;237152;50.0;32.5
54;2021-06-27;134;608;365333;237760;50.0;32.6
54;2021-06-28;1959;4357;367292;242117;50.3;33.1
54;2021-06-29;1941;5205;369233;247322;50.6;33.9
54;2021-06-30;1983;5123;371216;252445;50.8;34.6
54;2021-07-01;2143;5983;373359;258428;51.1;35.4
54;2021-07-02;2815;7563;376174;265991;51.5;36.4
54;2021-07-03;2837;4098;379011;270089;51.9;37.0
54;2021-07-04;196;499;379207;270588;51.9;37.0
54;2021-07-05;1668;4251;380875;274839;52.1;37.6
54;2021-07-06;2000;5080;382875;279919;52.4;38.3
54;2021-07-07;1906;4845;384781;284764;52.7;39.0
54;2021-07-08;1679;4114;386460;288878;52.9;39.6
54;2021-07-09;3204;6026;389664;294904;53.3;40.4
54;2021-07-10;2547;4376;392211;299280;53.7;41.0
54;2021-07-11;9;103;392220;299383;53.7;41.0
54;2021-07-12;2100;4698;394320;304081;54.0;41.6
54;2021-07-13;2619;4974;396939;309055;54.3;42.3
54;2021-07-14;1535;1506;398474;310561;54.6;42.5
54;2021-07-15;3172;4836;401646;315397;55.0;43.2
54;2021-07-16;4666;6224;406312;321621;55.6;44.0
54;2021-07-17;4005;4773;410317;326394;56.2;44.7
54;2021-07-18;1804;1688;412121;328082;56.4;44.9
54;2021-07-19;2591;4046;414712;332128;56.8;45.5
54;2021-07-20;2910;4814;417622;336942;57.2;46.1
54;2021-07-21;3133;6335;420755;343277;57.6;47.0
54;2021-07-22;3283;5735;424038;349012;58.1;47.8
54;2021-07-23;3982;6989;428020;356001;58.6;48.7
54;2021-07-24;2945;5334;430965;361335;59.0;49.5
54;2021-07-25;71;50;431036;361385;59.0;49.5
54;2021-07-26;2981;4179;434017;365564;59.4;50.0
54;2021-07-27;3717;4008;437734;369572;59.9;50.6
54;2021-07-28;5211;3879;442945;373451;60.6;51.1
54;2021-07-29;5157;3208;448102;376659;61.4;51.6
54;2021-07-30;5133;5003;453235;381662;62.1;52.3
54;2021-07-31;4538;3231;457773;384893;62.7;52.7
54;2021-08-01;257;73;458030;384966;62.7;52.7
54;2021-08-02;3098;3704;461128;388670;63.1;53.2
54;2021-08-03;4109;2921;465237;391591;63.7;53.6
54;2021-08-04;4428;2707;469665;394298;64.3;54.0
54;2021-08-05;4623;2434;474288;396732;64.9;54.3
54;2021-08-06;5456;3995;479744;400727;65.7;54.9
54;2021-08-07;3676;2829;483420;403556;66.2;55.3
54;2021-08-08;248;114;483668;403670;66.2;55.3
54;2021-08-09;2980;2694;486648;406364;66.6;55.6
54;2021-08-10;2564;3768;489212;410132;67.0;56.2
54;2021-08-11;2335;2565;491547;412697;67.3;56.5
54;2021-08-12;2192;3009;493739;415706;67.6;56.9
54;2021-08-13;2633;4449;496372;420155;68.0;57.5
54;2021-08-14;1436;2077;497808;422232;68.2;57.8
54;2021-08-15;31;43;497839;422275;68.2;57.8
54;2021-08-16;1864;3432;499703;425707;68.4;58.3
54;2021-08-17;1950;3312;501653;429019;68.7;58.7
54;2021-08-18;1500;4107;503153;433126;68.9;59.3
54;2021-08-19;1258;2790;504411;435916;69.1;59.7
54;2021-08-20;1876;4932;506287;440848;69.3;60.4
54;2021-08-21;1471;4016;507758;444864;69.5;60.9
54;2021-08-22;63;28;507821;444892;69.5;60.9
54;2021-08-23;1224;3860;509045;448752;69.7;61.4
54;2021-08-24;1141;3157;510186;451909;69.9;61.9
54;2021-08-25;1427;4382;511613;456291;70.0;62.5
54;2021-08-26;1006;3111;512619;459402;70.2;62.9
54;2021-08-27;1530;5326;514149;464728;70.4;63.6
54;2021-08-28;1148;4282;515297;469010;70.6;64.2
54;2021-08-29;17;50;515314;469060;70.6;64.2
54;2021-08-30;1215;4124;516529;473184;70.7;64.8
54;2021-08-31;1069;4462;517598;477646;70.9;65.4
54;2021-09-01;1109;3399;518707;481045;71.0;65.9
54;2021-09-02;730;1982;519437;483027;71.1;66.1
54;2021-09-03;985;2976;520422;486003;71.3;66.5
54;2021-09-04;1177;3160;521599;489163;71.4;67.0
54;2021-09-05;27;22;521626;489185;71.4;67.0
54;2021-09-06;498;1354;522124;490539;71.5;67.2
54;2021-09-07;605;1464;522729;492003;71.6;67.4
54;2021-09-08;635;1687;523364;493690;71.7;67.6
54;2021-09-09;944;1753;524308;495443;71.8;67.8
54;2021-09-10;1018;2388;525326;497831;71.9;68.2
54;2021-09-11;745;2556;526071;500387;72.0;68.5
54;2021-09-12;93;116;526164;500503;72.0;68.5
54;2021-09-13;646;943;526810;501446;72.1;68.7
54;2021-09-14;622;977;527432;502423;72.2;68.8
54;2021-09-15;635;1745;528067;504168;72.3;69.0
54;2021-09-16;639;714;528706;504882;72.4;69.1
54;2021-09-17;887;1533;529593;506415;72.5;69.3
54;2021-09-18;489;1437;530082;507852;72.6;69.5
54;2021-09-19;29;38;530111;507890;72.6;69.5
54;2021-09-20;375;658;530486;508548;72.6;69.6
54;2021-09-21;441;939;530927;509487;72.7;69.8
54;2021-09-22;405;1120;531332;510607;72.7;69.9
54;2021-09-23;323;845;531655;511452;72.8;70.0
54;2021-09-24;517;1179;532172;512631;72.9;70.2
54;2021-09-25;341;1077;532513;513708;72.9;70.3
54;2021-09-26;9;30;532522;513738;72.9;70.3
54;2021-09-27;231;677;532753;514415;72.9;70.4
54;2021-09-28;337;631;533090;515046;73.0;70.5
54;2021-09-29;391;805;533481;515851;73.0;70.6
54;2021-09-30;230;466;533711;516317;73.1;70.7
54;2021-10-01;480;1011;534191;517328;73.1;70.8
54;2021-10-02;392;959;534583;518287;73.2;71.0
54;2021-10-03;2;10;534585;518297;73.2;71.0
54;2021-10-04;201;528;534786;518825;73.2;71.0
54;2021-10-05;297;943;535083;519768;73.3;71.2
54;2021-10-06;367;807;535450;520575;73.3;71.3
54;2021-10-07;268;687;535718;521262;73.3;71.4
54;2021-10-08;405;971;536123;522233;73.4;71.5
54;2021-10-09;414;731;536537;522964;73.5;71.6
54;2021-10-10;9;18;536546;522982;73.5;71.6
54;2021-10-11;259;431;536805;523413;73.5;71.7
55;2020-12-27;0;0;0;0;0.0;0.0
55;2020-12-28;2;0;2;0;0.0;0.0
55;2020-12-29;0;0;2;0;0.0;0.0
55;2020-12-30;0;0;2;0;0.0;0.0
55;2020-12-31;0;0;2;0;0.0;0.0
55;2021-01-01;0;0;2;0;0.0;0.0
55;2021-01-02;0;0;2;0;0.0;0.0
55;2021-01-03;0;0;2;0;0.0;0.0
55;2021-01-04;1;0;3;0;0.0;0.0
55;2021-01-05;0;0;3;0;0.0;0.0
55;2021-01-06;0;0;3;0;0.0;0.0
55;2021-01-07;122;0;125;0;0.1;0.0
55;2021-01-08;127;0;252;0;0.1;0.0
55;2021-01-09;52;0;304;0;0.2;0.0
55;2021-01-10;0;0;304;0;0.2;0.0
55;2021-01-11;128;1;432;1;0.2;0.0
55;2021-01-12;119;0;551;1;0.3;0.0
55;2021-01-13;134;0;685;1;0.4;0.0
55;2021-01-14;645;8;1330;9;0.7;0.0
55;2021-01-15;237;0;1567;9;0.9;0.0
55;2021-01-16;62;0;1629;9;0.9;0.0
55;2021-01-17;1;0;1630;9;0.9;0.0
55;2021-01-18;414;1;2044;10;1.1;0.0
55;2021-01-19;352;3;2396;13;1.3;0.0
55;2021-01-20;456;2;2852;15;1.6;0.0
55;2021-01-21;430;0;3282;15;1.8;0.0
55;2021-01-22;390;0;3672;15;2.0;0.0
55;2021-01-23;49;0;3721;15;2.0;0.0
55;2021-01-24;0;0;3721;15;2.0;0.0
55;2021-01-25;436;0;4157;15;2.3;0.0
55;2021-01-26;431;0;4588;15;2.5;0.0
55;2021-01-27;424;0;5012;15;2.8;0.0
55;2021-01-28;486;97;5498;112;3.0;0.1
55;2021-01-29;159;54;5657;166;3.1;0.1
55;2021-01-30;92;28;5749;194;3.2;0.1
55;2021-01-31;0;0;5749;194;3.2;0.1
55;2021-02-01;153;176;5902;370;3.2;0.2
55;2021-02-02;159;147;6061;517;3.3;0.3
55;2021-02-03;53;156;6114;673;3.4;0.4
55;2021-02-04;236;399;6350;1072;3.5;0.6
55;2021-02-05;174;140;6524;1212;3.6;0.7
55;2021-02-06;62;56;6586;1268;3.6;0.7
55;2021-02-07;2;53;6588;1321;3.6;0.7
55;2021-02-08;0;18;6588;1339;3.6;0.7
55;2021-02-09;92;116;6680;1455;3.7;0.8
55;2021-02-10;65;23;6745;1478;3.7;0.8
55;2021-02-11;175;98;6920;1576;3.8;0.9
55;2021-02-12;95;28;7015;1604;3.9;0.9
55;2021-02-13;0;0;7015;1604;3.9;0.9
55;2021-02-14;0;0;7015;1604;3.9;0.9
55;2021-02-15;15;417;7030;2021;3.9;1.1
55;2021-02-16;143;394;7173;2415;3.9;1.3
55;2021-02-17;26;489;7199;2904;4.0;1.6
55;2021-02-18;20;341;7219;3245;4.0;1.8
55;2021-02-19;125;287;7344;3532;4.0;1.9
55;2021-02-20;11;0;7355;3532;4.0;1.9
55;2021-02-21;0;0;7355;3532;4.0;1.9
55;2021-02-22;55;458;7410;3990;4.1;2.2
55;2021-02-23;85;439;7495;4429;4.1;2.4
55;2021-02-24;72;415;7567;4844;4.2;2.7
55;2021-02-25;270;684;7837;5528;4.3;3.0
55;2021-02-26;324;236;8161;5764;4.5;3.2
55;2021-02-27;125;87;8286;5851;4.6;3.2
55;2021-02-28;2;8;8288;5859;4.6;3.2
55;2021-03-01;77;141;8365;6000;4.6;3.3
55;2021-03-02;125;170;8490;6170;4.7;3.4
55;2021-03-03;198;3;8688;6173;4.8;3.4
55;2021-03-04;238;43;8926;6216;4.9;3.4
55;2021-03-05;362;47;9288;6263;5.1;3.4
55;2021-03-06;224;6;9512;6269;5.2;3.5
55;2021-03-07;74;5;9586;6274;5.3;3.5
55;2021-03-08;329;52;9915;6326;5.5;3.5
55;2021-03-09;635;50;10550;6376;5.8;3.5
55;2021-03-10;397;26;10947;6402;6.0;3.5
55;2021-03-11;597;147;11544;6549;6.4;3.6
55;2021-03-12;816;94;12360;6643;6.8;3.7
55;2021-03-13;522;13;12882;6656;7.1;3.7
55;2021-03-14;14;0;12896;6656;7.1;3.7
55;2021-03-15;393;24;13289;6680;7.3;3.7
55;2021-03-16;568;111;13857;6791;7.6;3.7
55;2021-03-17;683;22;14540;6813;8.0;3.8
55;2021-03-18;323;23;14863;6836;8.2;3.8
55;2021-03-19;471;60;15334;6896;8.4;3.8
55;2021-03-20;254;16;15588;6912;8.6;3.8
55;2021-03-21;1;1;15589;6913;8.6;3.8
55;2021-03-22;474;21;16063;6934;8.8;3.8
55;2021-03-23;973;66;17036;7000;9.4;3.9
55;2021-03-24;802;43;17838;7043;9.8;3.9
55;2021-03-25;1097;83;18935;7126;10.4;3.9
55;2021-03-26;602;36;19537;7162;10.8;3.9
55;2021-03-27;256;23;19793;7185;10.9;4.0
55;2021-03-28;0;0;19793;7185;10.9;4.0
55;2021-03-29;944;41;20737;7226;11.4;4.0
55;2021-03-30;1425;75;22162;7301;12.2;4.0
55;2021-03-31;1483;73;23645;7374;13.0;4.1
55;2021-04-01;1207;130;24852;7504;13.7;4.1
55;2021-04-02;902;75;25754;7579;14.2;4.2
55;2021-04-03;93;12;25847;7591;14.2;4.2
55;2021-04-04;2;0;25849;7591;14.2;4.2
55;2021-04-05;6;12;25855;7603;14.2;4.2
55;2021-04-06;933;276;26788;7879;14.7;4.3
55;2021-04-07;993;240;27781;8119;15.3;4.5
55;2021-04-08;1649;421;29430;8540;16.2;4.7
55;2021-04-09;1431;263;30861;8803;17.0;4.8
55;2021-04-10;243;175;31104;8978;17.1;4.9
55;2021-04-11;452;23;31556;9001;17.4;5.0
55;2021-04-12;855;330;32411;9331;17.8;5.1
55;2021-04-13;1355;530;33766;9861;18.6;5.4
55;2021-04-14;1372;728;35138;10589;19.3;5.8
55;2021-04-15;1637;461;36775;11050;20.2;6.1
55;2021-04-16;704;379;37479;11429;20.6;6.3
55;2021-04-17;677;32;38156;11461;21.0;6.3
55;2021-04-18;38;19;38194;11480;21.0;6.3
55;2021-04-19;961;348;39155;11828;21.6;6.5
55;2021-04-20;1173;776;40328;12604;22.2;6.9
55;2021-04-21;990;641;41318;13245;22.7;7.3
55;2021-04-22;1099;683;42417;13928;23.4;7.7
55;2021-04-23;1424;600;43841;14528;24.1;8.0
55;2021-04-24;313;124;44154;14652;24.3;8.1
55;2021-04-25;384;51;44538;14703;24.5;8.1
55;2021-04-26;478;815;45016;15518;24.8;8.5
55;2021-04-27;570;996;45586;16514;25.1;9.1
55;2021-04-28;931;815;46517;17329;25.6;9.5
55;2021-04-29;1118;859;47635;18188;26.2;10.0
55;2021-04-30;1280;624;48915;18812;26.9;10.4
55;2021-05-01;153;132;49068;18944;27.0;10.4
55;2021-05-02;2;3;49070;18947;27.0;10.4
55;2021-05-03;1209;630;50279;19577;27.7;10.8
55;2021-05-04;683;1180;50962;20757;28.1;11.4
55;2021-05-05;656;1074;51618;21831;28.4;12.0
55;2021-05-06;1350;1163;52968;22994;29.2;12.7
55;2021-05-07;1433;556;54401;23550;29.9;13.0
55;2021-05-08;156;77;54557;23627;30.0;13.0
55;2021-05-09;62;523;54619;24150;30.1;13.3
55;2021-05-10;860;1030;55479;25180;30.5;13.9
55;2021-05-11;1072;1380;56551;26560;31.1;14.6
55;2021-05-12;1031;1765;57582;28325;31.7;15.6
55;2021-05-13;99;75;57681;28400;31.8;15.6
55;2021-05-14;352;556;58033;28956;31.9;15.9
55;2021-05-15;291;492;58324;29448;32.1;16.2
55;2021-05-16;3;10;58327;29458;32.1;16.2
55;2021-05-17;1028;841;59355;30299;32.7;16.7
55;2021-05-18;1567;893;60922;31192;33.5;17.2
55;2021-05-19;1809;777;62731;31969;34.5;17.6
55;2021-05-20;2215;730;64946;32699;35.8;18.0
55;2021-05-21;2010;800;66956;33499;36.9;18.4
55;2021-05-22;198;167;67154;33666;37.0;18.5
55;2021-05-23;23;120;67177;33786;37.0;18.6
55;2021-05-24;0;0;67177;33786;37.0;18.6
55;2021-05-25;1347;653;68524;34439;37.7;19.0
55;2021-05-26;1675;1018;70199;35457;38.6;19.5
55;2021-05-27;1322;983;71521;36440;39.4;20.1
55;2021-05-28;1521;930;73042;37370;40.2;20.6
55;2021-05-29;1403;698;74445;38068;41.0;21.0
55;2021-05-30;15;205;74460;38273;41.0;21.1
55;2021-05-31;1048;1130;75508;39403;41.6;21.7
55;2021-06-01;919;955;76427;40358;42.1;22.2
55;2021-06-02;1162;983;77589;41341;42.7;22.8
55;2021-06-03;703;545;78292;41886;43.1;23.1
55;2021-06-04;1388;1100;79680;42986;43.9;23.7
55;2021-06-05;1366;278;81046;43264;44.6;23.8
55;2021-06-06;0;2;81046;43266;44.6;23.8
55;2021-06-07;791;714;81837;43980;45.1;24.2
55;2021-06-08;700;1073;82537;45053;45.4;24.8
55;2021-06-09;852;872;83389;45925;45.9;25.3
55;2021-06-10;378;275;83767;46200;46.1;25.4
55;2021-06-11;528;1287;84295;47487;46.4;26.1
55;2021-06-12;761;519;85056;48006;46.8;26.4
55;2021-06-13;265;33;85321;48039;47.0;26.4
55;2021-06-14;391;1362;85712;49401;47.2;27.2
55;2021-06-15;574;1212;86286;50613;47.5;27.9
55;2021-06-16;735;832;87021;51445;47.9;28.3
55;2021-06-17;425;858;87446;52303;48.1;28.8
55;2021-06-18;667;1474;88113;53777;48.5;29.6
55;2021-06-19;593;456;88706;54233;48.8;29.9
55;2021-06-20;0;0;88706;54233;48.8;29.9
55;2021-06-21;441;1023;89147;55256;49.1;30.4
55;2021-06-22;335;1012;89482;56268;49.3;31.0
55;2021-06-23;626;1210;90108;57478;49.6;31.6
55;2021-06-24;164;433;90272;57911;49.7;31.9
55;2021-06-25;642;1227;90914;59138;50.1;32.6
55;2021-06-26;418;341;91332;59479;50.3;32.7
55;2021-06-27;1;2;91333;59481;50.3;32.7
55;2021-06-28;149;1379;91482;60860;50.4;33.5
55;2021-06-29;201;1288;91683;62148;50.5;34.2
55;2021-06-30;272;1930;91955;64078;50.6;35.3
55;2021-07-01;388;1977;92343;66055;50.8;36.4
55;2021-07-02;392;1719;92735;67774;51.1;37.3
55;2021-07-03;107;262;92842;68036;51.1;37.5
55;2021-07-04;12;19;92854;68055;51.1;37.5
55;2021-07-05;222;1508;93076;69563;51.2;38.3
55;2021-07-06;327;900;93403;70463;51.4;38.8
55;2021-07-07;389;1801;93792;72264;51.6;39.8
55;2021-07-08;535;1594;94327;73858;51.9;40.7
55;2021-07-09;457;1478;94784;75336;52.2;41.5
55;2021-07-10;356;1112;95140;76448;52.4;42.1
55;2021-07-11;0;9;95140;76457;52.4;42.1
55;2021-07-12;608;1166;95748;77623;52.7;42.7
55;2021-07-13;599;1487;96347;79110;53.0;43.6
55;2021-07-14;1;13;96348;79123;53.0;43.6
55;2021-07-15;782;1646;97130;80769;53.5;44.5
55;2021-07-16;1255;1810;98385;82579;54.2;45.5
55;2021-07-17;1284;822;99669;83401;54.9;45.9
55;2021-07-18;1;2;99670;83403;54.9;45.9
55;2021-07-19;597;785;100267;84188;55.2;46.3
55;2021-07-20;1001;1024;101268;85212;55.8;46.9
55;2021-07-21;1482;1371;102750;86583;56.6;47.7
55;2021-07-22;1174;568;103924;87151;57.2;48.0
55;2021-07-23;1113;1356;105037;88507;57.8;48.7
55;2021-07-24;819;762;105856;89269;58.3;49.1
55;2021-07-25;120;229;105976;89498;58.3;49.3
55;2021-07-26;668;444;106644;89942;58.7;49.5
55;2021-07-27;1166;479;107810;90421;59.4;49.8
55;2021-07-28;1039;1066;108849;91487;59.9;50.4
55;2021-07-29;670;446;109519;91933;60.3;50.6
55;2021-07-30;1272;966;110791;92899;61.0;51.1
55;2021-07-31;714;613;111505;93512;61.4;51.5
55;2021-08-01;9;5;111514;93517;61.4;51.5
55;2021-08-02;820;443;112334;93960;61.8;51.7
55;2021-08-03;792;418;113126;94378;62.3;52.0
55;2021-08-04;1248;951;114374;95329;63.0;52.5
55;2021-08-05;1055;324;115429;95653;63.5;52.7
55;2021-08-06;819;1096;116248;96749;64.0;53.3
55;2021-08-07;596;336;116844;97085;64.3;53.4
55;2021-08-08;0;0;116844;97085;64.3;53.4
55;2021-08-09;402;306;117246;97391;64.5;53.6
55;2021-08-10;447;776;117693;98167;64.8;54.0
55;2021-08-11;595;640;118288;98807;65.1;54.4
55;2021-08-12;327;489;118615;99296;65.3;54.7
55;2021-08-13;439;1110;119054;100406;65.5;55.3
55;2021-08-14;144;190;119198;100596;65.6;55.4
55;2021-08-15;11;5;119209;100601;65.6;55.4
55;2021-08-16;246;739;119455;101340;65.8;55.8
55;2021-08-17;259;289;119714;101629;65.9;56.0
55;2021-08-18;576;1241;120290;102870;66.2;56.6
55;2021-08-19;451;960;120741;103830;66.5;57.2
55;2021-08-20;623;1012;121364;104842;66.8;57.7
55;2021-08-21;292;772;121656;105614;67.0;58.1
55;2021-08-22;8;6;121664;105620;67.0;58.1
55;2021-08-23;357;612;122021;106232;67.2;58.5
55;2021-08-24;338;833;122359;107065;67.4;58.9
55;2021-08-25;678;1173;123037;108238;67.7;59.6
55;2021-08-26;473;1253;123510;109491;68.0;60.3
55;2021-08-27;336;1247;123846;110738;68.2;61.0
55;2021-08-28;388;578;124234;111316;68.4;61.3
55;2021-08-29;217;59;124451;111375;68.5;61.3
55;2021-08-30;175;670;124626;112045;68.6;61.7
55;2021-08-31;286;802;124912;112847;68.8;62.1
55;2021-09-01;702;1213;125614;114060;69.2;62.8
55;2021-09-02;275;820;125889;114880;69.3;63.2
55;2021-09-03;446;1046;126335;115926;69.6;63.8
55;2021-09-04;290;576;126625;116502;69.7;64.1
55;2021-09-05;18;91;126643;116593;69.7;64.2
55;2021-09-06;61;122;126704;116715;69.8;64.3
55;2021-09-07;284;402;126988;117117;69.9;64.5
55;2021-09-08;275;275;127263;117392;70.1;64.6
55;2021-09-09;199;544;127462;117936;70.2;64.9
55;2021-09-10;253;420;127715;118356;70.3;65.2
55;2021-09-11;99;281;127814;118637;70.4;65.3
55;2021-09-12;1;2;127815;118639;70.4;65.3
55;2021-09-13;103;328;127918;118967;70.4;65.5
55;2021-09-14;245;173;128163;119140;70.6;65.6
55;2021-09-15;308;638;128471;119778;70.7;65.9
55;2021-09-16;120;181;128591;119959;70.8;66.0
55;2021-09-17;89;123;128680;120082;70.8;66.1
55;2021-09-18;142;391;128822;120473;70.9;66.3
55;2021-09-19;1;59;128823;120532;70.9;66.4
55;2021-09-20;66;192;128889;120724;71.0;66.5
55;2021-09-21;100;332;128989;121056;71.0;66.6
55;2021-09-22;109;395;129098;121451;71.1;66.9
55;2021-09-23;95;427;129193;121878;71.1;67.1
55;2021-09-24;88;370;129281;122248;71.2;67.3
55;2021-09-25;57;160;129338;122408;71.2;67.4
55;2021-09-26;0;34;129338;122442;71.2;67.4
55;2021-09-27;48;129;129386;122571;71.2;67.5
55;2021-09-28;51;124;129437;122695;71.3;67.5
55;2021-09-29;157;861;129594;123556;71.3;68.0
55;2021-09-30;58;331;129652;123887;71.4;68.2
55;2021-10-01;57;274;129709;124161;71.4;68.4
55;2021-10-02;91;372;129800;124533;71.5;68.6
55;2021-10-03;0;59;129800;124592;71.5;68.6
55;2021-10-04;107;390;129907;124982;71.5;68.8
55;2021-10-05;71;259;129978;125241;71.6;68.9
55;2021-10-06;101;378;130079;125619;71.6;69.2
55;2021-10-07;57;152;130136;125771;71.6;69.2
55;2021-10-08;61;143;130197;125914;71.7;69.3
55;2021-10-09;54;240;130251;126154;71.7;69.5
55;2021-10-10;20;194;130271;126348;71.7;69.6
55;2021-10-11;66;173;130337;126521;71.8;69.7
56;2020-12-27;0;0;0;0;0.0;0.0
56;2020-12-28;1;0;1;0;0.0;0.0
56;2020-12-29;0;0;1;0;0.0;0.0
56;2020-12-30;0;0;1;0;0.0;0.0
56;2020-12-31;0;0;1;0;0.0;0.0
56;2021-01-01;0;0;1;0;0.0;0.0
56;2021-01-02;1;0;2;0;0.0;0.0
56;2021-01-03;2;2;4;2;0.0;0.0
56;2021-01-04;2;1;6;3;0.0;0.0
56;2021-01-05;1;0;7;3;0.0;0.0
56;2021-01-06;2;0;9;3;0.0;0.0
56;2021-01-07;198;0;207;3;0.0;0.0
56;2021-01-08;119;0;326;3;0.0;0.0
56;2021-01-09;1;0;327;3;0.0;0.0
56;2021-01-10;1;0;328;3;0.0;0.0
56;2021-01-11;242;0;570;3;0.1;0.0
56;2021-01-12;755;15;1325;18;0.2;0.0
56;2021-01-13;638;1;1963;19;0.3;0.0
56;2021-01-14;970;19;2933;38;0.4;0.0
56;2021-01-15;844;5;3777;43;0.5;0.0
56;2021-01-16;235;3;4012;46;0.5;0.0
56;2021-01-17;27;0;4039;46;0.5;0.0
56;2021-01-18;1006;1;5045;47;0.7;0.0
56;2021-01-19;866;24;5911;71;0.8;0.0
56;2021-01-20;885;1;6796;72;0.9;0.0
56;2021-01-21;1450;16;8246;88;1.1;0.0
56;2021-01-22;1183;4;9429;92;1.2;0.0
56;2021-01-23;319;3;9748;95;1.3;0.0
56;2021-01-24;6;0;9754;95;1.3;0.0
56;2021-01-25;830;4;10584;99;1.4;0.0
56;2021-01-26;1034;4;11618;103;1.5;0.0
56;2021-01-27;1082;62;12700;165;1.7;0.0
56;2021-01-28;975;123;13675;288;1.8;0.0
56;2021-01-29;875;107;14550;395;1.9;0.1
56;2021-01-30;139;19;14689;414;1.9;0.1
56;2021-01-31;0;0;14689;414;1.9;0.1
56;2021-02-01;480;155;15169;569;2.0;0.1
56;2021-02-02;941;258;16110;827;2.1;0.1
56;2021-02-03;1025;270;17135;1097;2.3;0.1
56;2021-02-04;4705;360;21840;1457;2.9;0.2
56;2021-02-05;3596;436;25436;1893;3.4;0.3
56;2021-02-06;551;171;25987;2064;3.4;0.3
56;2021-02-07;136;26;26123;2090;3.5;0.3
56;2021-02-08;297;291;26420;2381;3.5;0.3
56;2021-02-09;795;506;27215;2887;3.6;0.4
56;2021-02-10;864;700;28079;3587;3.7;0.5
56;2021-02-11;973;1081;29052;4668;3.8;0.6
56;2021-02-12;1153;645;30205;5313;4.0;0.7
56;2021-02-13;220;103;30425;5416;4.0;0.7
56;2021-02-14;6;46;30431;5462;4.0;0.7
56;2021-02-15;623;1087;31054;6549;4.1;0.9
56;2021-02-16;1219;735;32273;7284;4.3;1.0
56;2021-02-17;1189;959;33462;8243;4.4;1.1
56;2021-02-18;1351;882;34813;9125;4.6;1.2
56;2021-02-19;1323;916;36136;10041;4.8;1.3
56;2021-02-20;365;259;36501;10300;4.8;1.4
56;2021-02-21;2;1;36503;10301;4.8;1.4
56;2021-02-22;376;704;36879;11005;4.9;1.5
56;2021-02-23;742;951;37621;11956;5.0;1.6
56;2021-02-24;918;1187;38539;13143;5.1;1.7
56;2021-02-25;2032;4258;40571;17401;5.4;2.3
56;2021-02-26;2356;2255;42927;19656;5.7;2.6
56;2021-02-27;748;447;43675;20103;5.8;2.7
56;2021-02-28;15;114;43690;20217;5.8;2.7
56;2021-03-01;649;559;44339;20776;5.9;2.7
56;2021-03-02;980;789;45319;21565;6.0;2.9
56;2021-03-03;1150;910;46469;22475;6.2;3.0
56;2021-03-04;1965;1039;48434;23514;6.4;3.1
56;2021-03-05;2584;1435;51018;24949;6.8;3.3
56;2021-03-06;1209;223;52227;25172;6.9;3.3
56;2021-03-07;282;24;52509;25196;6.9;3.3
56;2021-03-08;1141;394;53650;25590;7.1;3.4
56;2021-03-09;2043;633;55693;26223;7.4;3.5
56;2021-03-10;2000;939;57693;27162;7.6;3.6
56;2021-03-11;3251;744;60944;27906;8.1;3.7
56;2021-03-12;4209;834;65153;28740;8.6;3.8
56;2021-03-13;1884;153;67037;28893;8.9;3.8
56;2021-03-14;195;4;67232;28897;8.9;3.8
56;2021-03-15;1285;531;68517;29428;9.1;3.9
56;2021-03-16;1088;1029;69605;30457;9.2;4.0
56;2021-03-17;1371;778;70976;31235;9.4;4.1
56;2021-03-18;2001;1863;72977;33098;9.7;4.4
56;2021-03-19;2947;1398;75924;34496;10.0;4.6
56;2021-03-20;1492;207;77416;34703;10.2;4.6
56;2021-03-21;209;22;77625;34725;10.3;4.6
56;2021-03-22;1612;407;79237;35132;10.5;4.6
56;2021-03-23;2810;687;82047;35819;10.9;4.7
56;2021-03-24;3450;527;85497;36346;11.3;4.8
56;2021-03-25;4238;731;89735;37077;11.9;4.9
56;2021-03-26;5092;774;94827;37851;12.6;5.0
56;2021-03-27;1502;296;96329;38147;12.7;5.0
56;2021-03-28;264;11;96593;38158;12.8;5.1
56;2021-03-29;2236;507;98829;38665;13.1;5.1
56;2021-03-30;3519;787;102348;39452;13.5;5.2
56;2021-03-31;3115;723;105463;40175;14.0;5.3
56;2021-04-01;4079;827;109542;41002;14.5;5.4
56;2021-04-02;3925;954;113467;41956;15.0;5.6
56;2021-04-03;1186;270;114653;42226;15.2;5.6
56;2021-04-04;233;4;114886;42230;15.2;5.6
56;2021-04-05;244;8;115130;42238;15.2;5.6
56;2021-04-06;2828;1238;117958;43476;15.6;5.8
56;2021-04-07;4023;1196;121981;44672;16.1;5.9
56;2021-04-08;5296;1170;127277;45842;16.8;6.1
56;2021-04-09;7396;1289;134673;47131;17.8;6.2
56;2021-04-10;2576;430;137249;47561;18.2;6.3
56;2021-04-11;194;101;137443;47662;18.2;6.3
56;2021-04-12;3932;838;141375;48500;18.7;6.4
56;2021-04-13;5965;1268;147340;49768;19.5;6.6
56;2021-04-14;5168;1434;152508;51202;20.2;6.8
56;2021-04-15;7153;1779;159661;52981;21.1;7.0
56;2021-04-16;7842;2020;167503;55001;22.2;7.3
56;2021-04-17;3130;649;170633;55650;22.6;7.4
56;2021-04-18;528;110;171161;55760;22.7;7.4
56;2021-04-19;3719;1264;174880;57024;23.1;7.5
56;2021-04-20;4107;1981;178987;59005;23.7;7.8
56;2021-04-21;4059;2327;183046;61332;24.2;8.1
56;2021-04-22;5173;1928;188219;63260;24.9;8.4
56;2021-04-23;5172;2424;193391;65684;25.6;8.7
56;2021-04-24;2899;648;196290;66332;26.0;8.8
56;2021-04-25;465;149;196755;66481;26.0;8.8
56;2021-04-26;4710;1672;201465;68153;26.7;9.0
56;2021-04-27;5097;2554;206562;70707;27.3;9.4
56;2021-04-28;4966;2250;211528;72957;28.0;9.7
56;2021-04-29;5842;2944;217370;75901;28.8;10.0
56;2021-04-30;6246;2804;223616;78705;29.6;10.4
56;2021-05-01;2489;365;226105;79070;29.9;10.5
56;2021-05-02;307;254;226412;79324;30.0;10.5
56;2021-05-03;3863;2069;230275;81393;30.5;10.8
56;2021-05-04;4379;3911;234654;85304;31.1;11.3
56;2021-05-05;3522;3879;238176;89183;31.5;11.8
56;2021-05-06;4377;5447;242553;94630;32.1;12.5
56;2021-05-07;4267;5016;246820;99646;32.7;13.2
56;2021-05-08;1645;324;248465;99970;32.9;13.2
56;2021-05-09;494;227;248959;100197;33.0;13.3
56;2021-05-10;3751;3809;252710;104006;33.4;13.8
56;2021-05-11;4169;5053;256879;109059;34.0;14.4
56;2021-05-12;4342;4776;261221;113835;34.6;15.1
56;2021-05-13;2397;1014;263618;114849;34.9;15.2
56;2021-05-14;4227;4362;267845;119211;35.4;15.8
56;2021-05-15;2488;1895;270333;121106;35.8;16.0
56;2021-05-16;237;488;270570;121594;35.8;16.1
56;2021-05-17;2513;3668;273083;125262;36.1;16.6
56;2021-05-18;3522;4102;276605;129364;36.6;17.1
56;2021-05-19;3527;3398;280132;132762;37.1;17.6
56;2021-05-20;3805;4819;283937;137581;37.6;18.2
56;2021-05-21;3748;5228;287685;142809;38.1;18.9
56;2021-05-22;1696;2207;289381;145016;38.3;19.2
56;2021-05-23;284;197;289665;145213;38.3;19.2
56;2021-05-24;2058;497;291723;145710;38.6;19.3
56;2021-05-25;3141;4471;294864;150181;39.0;19.9
56;2021-05-26;3735;3938;298599;154119;39.5;20.4
56;2021-05-27;4362;4868;302961;158987;40.1;21.0
56;2021-05-28;4640;5961;307601;164948;40.7;21.8
56;2021-05-29;1886;1635;309487;166583;41.0;22.0
56;2021-05-30;318;67;309805;166650;41.0;22.1
56;2021-05-31;4502;3222;314307;169872;41.6;22.5
56;2021-06-01;5664;3387;319971;173259;42.3;22.9
56;2021-06-02;5631;2953;325602;176212;43.1;23.3
56;2021-06-03;6189;3304;331791;179516;43.9;23.8
56;2021-06-04;5814;4413;337605;183929;44.7;24.3
56;2021-06-05;4346;2385;341951;186314;45.3;24.7
56;2021-06-06;496;615;342447;186929;45.3;24.7
56;2021-06-07;5101;3172;347548;190101;46.0;25.2
56;2021-06-08;6070;3375;353618;193476;46.8;25.6
56;2021-06-09;6431;2815;360049;196291;47.7;26.0
56;2021-06-10;7479;2874;367528;199165;48.6;26.4
56;2021-06-11;6768;3867;374296;203032;49.5;26.9
56;2021-06-12;5103;2064;379399;205096;50.2;27.1
56;2021-06-13;1978;439;381377;205535;50.5;27.2
56;2021-06-14;3313;4595;384690;210130;50.9;27.8
56;2021-06-15;4201;4897;388891;215027;51.5;28.5
56;2021-06-16;4497;4504;393388;219531;52.1;29.1
56;2021-06-17;4257;4752;397645;224283;52.6;29.7
56;2021-06-18;4513;5973;402158;230256;53.2;30.5
56;2021-06-19;3832;2144;405990;232400;53.7;30.8
56;2021-06-20;1503;340;407493;232740;53.9;30.8
56;2021-06-21;3306;4462;410799;237202;54.4;31.4
56;2021-06-22;3483;5441;414282;242643;54.8;32.1
56;2021-06-23;3763;5061;418045;247704;55.3;32.8
56;2021-06-24;3478;5320;421523;253024;55.8;33.5
56;2021-06-25;3884;6281;425407;259305;56.3;34.3
56;2021-06-26;3202;2916;428609;262221;56.7;34.7
56;2021-06-27;305;163;428914;262384;56.8;34.7
56;2021-06-28;1575;3982;430489;266366;57.0;35.3
56;2021-06-29;2433;5770;432922;272136;57.3;36.0
56;2021-06-30;2499;5561;435421;277697;57.6;36.8
56;2021-07-01;2735;4960;438156;282657;58.0;37.4
56;2021-07-02;2671;6205;440827;288862;58.3;38.2
56;2021-07-03;2203;2684;443030;291546;58.6;38.6
56;2021-07-04;778;811;443808;292357;58.7;38.7
56;2021-07-05;1872;5442;445680;297799;59.0;39.4
56;2021-07-06;2190;5933;447870;303732;59.3;40.2
56;2021-07-07;2844;5642;450714;309374;59.7;40.9
56;2021-07-08;3086;6036;453800;315410;60.1;41.7
56;2021-07-09;2213;7098;456013;322508;60.4;42.7
56;2021-07-10;1126;3004;457139;325512;60.5;43.1
56;2021-07-11;256;344;457395;325856;60.5;43.1
56;2021-07-12;2181;6605;459576;332461;60.8;44.0
56;2021-07-13;3259;7467;462835;339928;61.3;45.0
56;2021-07-14;1785;2591;464620;342519;61.5;45.3
56;2021-07-15;3819;7069;468439;349588;62.0;46.3
56;2021-07-16;4076;8096;472515;357684;62.5;47.3
56;2021-07-17;2320;3525;474835;361209;62.8;47.8
56;2021-07-18;256;478;475091;361687;62.9;47.9
56;2021-07-19;2868;6359;477959;368046;63.3;48.7
56;2021-07-20;3722;7913;481681;375959;63.8;49.8
56;2021-07-21;3096;7519;484777;383478;64.2;50.8
56;2021-07-22;4391;8035;489168;391513;64.7;51.8
56;2021-07-23;4389;8412;493557;399925;65.3;52.9
56;2021-07-24;1687;4602;495244;404527;65.5;53.5
56;2021-07-25;551;1916;495795;406443;65.6;53.8
56;2021-07-26;3680;5461;499475;411904;66.1;54.5
56;2021-07-27;5375;6201;504850;418105;66.8;55.3
56;2021-07-28;4687;5465;509537;423570;67.4;56.1
56;2021-07-29;5378;5628;514915;429198;68.1;56.8
56;2021-07-30;5383;5864;520298;435062;68.9;57.6
56;2021-07-31;2158;2693;522456;437755;69.1;57.9
56;2021-08-01;1255;977;523711;438732;69.3;58.1
56;2021-08-02;4537;4600;528248;443332;69.9;58.7
56;2021-08-03;6387;4962;534635;448294;70.8;59.3
56;2021-08-04;5952;4363;540587;452657;71.5;59.9
56;2021-08-05;6097;4605;546684;457262;72.4;60.5
56;2021-08-06;5855;4926;552539;462188;73.1;61.2
56;2021-08-07;2859;2228;555398;464416;73.5;61.5
56;2021-08-08;1830;566;557228;464982;73.7;61.5
56;2021-08-09;3936;4267;561164;469249;74.3;62.1
56;2021-08-10;4928;4612;566092;473861;74.9;62.7
56;2021-08-11;4565;4138;570657;477999;75.5;63.3
56;2021-08-12;4488;4549;575145;482548;76.1;63.9
56;2021-08-13;4214;4814;579359;487362;76.7;64.5
56;2021-08-14;1792;2136;581151;489498;76.9;64.8
56;2021-08-15;348;485;581499;489983;77.0;64.8
56;2021-08-16;3066;4522;584565;494505;77.4;65.4
56;2021-08-17;3761;5055;588326;499560;77.9;66.1
56;2021-08-18;3740;4609;592066;504169;78.4;66.7
56;2021-08-19;3069;4992;595135;509161;78.8;67.4
56;2021-08-20;2905;5260;598040;514421;79.2;68.1
56;2021-08-21;1159;2399;599199;516820;79.3;68.4
56;2021-08-22;129;503;599328;517323;79.3;68.5
56;2021-08-23;1928;4969;601256;522292;79.6;69.1
56;2021-08-24;1924;5513;603180;527805;79.8;69.9
56;2021-08-25;1710;5056;604890;532861;80.1;70.5
56;2021-08-26;1409;5326;606299;538187;80.2;71.2
56;2021-08-27;1757;5878;608056;544065;80.5;72.0
56;2021-08-28;605;2802;608661;546867;80.6;72.4
56;2021-08-29;79;476;608740;547343;80.6;72.4
56;2021-08-30;1381;4626;610121;551969;80.8;73.1
56;2021-08-31;1473;4648;611594;556617;80.9;73.7
56;2021-09-01;1321;3927;612915;560544;81.1;74.2
56;2021-09-02;1086;3711;614001;564255;81.3;74.7
56;2021-09-03;1103;4240;615104;568495;81.4;75.2
56;2021-09-04;766;2340;615870;570835;81.5;75.6
56;2021-09-05;128;365;615998;571200;81.5;75.6
56;2021-09-06;885;3115;616883;574315;81.6;76.0
56;2021-09-07;820;3001;617703;577316;81.8;76.4
56;2021-09-08;967;3234;618670;580550;81.9;76.8
56;2021-09-09;800;2667;619470;583217;82.0;77.2
56;2021-09-10;942;3160;620412;586377;82.1;77.6
56;2021-09-11;474;2017;620886;588394;82.2;77.9
56;2021-09-12;34;167;620920;588561;82.2;77.9
56;2021-09-13;765;2071;621685;590632;82.3;78.2
56;2021-09-14;700;1870;622385;592502;82.4;78.4
56;2021-09-15;713;2499;623098;595001;82.5;78.7
56;2021-09-16;710;1591;623808;596592;82.6;79.0
56;2021-09-17;761;2148;624569;598740;82.7;79.2
56;2021-09-18;305;1706;624874;600446;82.7;79.5
56;2021-09-19;32;112;624906;600558;82.7;79.5
56;2021-09-20;426;1287;625332;601845;82.8;79.7
56;2021-09-21;500;1165;625832;603010;82.8;79.8
56;2021-09-22;463;1704;626295;604714;82.9;80.0
56;2021-09-23;543;1049;626838;605763;83.0;80.2
56;2021-09-24;581;1613;627419;607376;83.0;80.4
56;2021-09-25;256;1029;627675;608405;83.1;80.5
56;2021-09-26;12;79;627687;608484;83.1;80.5
56;2021-09-27;475;1000;628162;609484;83.1;80.7
56;2021-09-28;436;958;628598;610442;83.2;80.8
56;2021-09-29;386;1168;628984;611610;83.2;80.9
56;2021-09-30;333;606;629317;612216;83.3;81.0
56;2021-10-01;514;1256;629831;613472;83.4;81.2
56;2021-10-02;161;403;629992;613875;83.4;81.2
56;2021-10-03;5;77;629997;613952;83.4;81.3
56;2021-10-04;295;762;630292;614714;83.4;81.4
56;2021-10-05;239;619;630531;615333;83.5;81.4
56;2021-10-06;404;945;630935;616278;83.5;81.6
56;2021-10-07;308;879;631243;617157;83.5;81.7
56;2021-10-08;426;910;631669;618067;83.6;81.8
56;2021-10-09;152;383;631821;618450;83.6;81.9
56;2021-10-10;9;56;631830;618506;83.6;81.9
56;2021-10-11;277;617;632107;619123;83.7;81.9
57;2020-12-27;2;0;2;0;0.0;0.0
57;2020-12-28;0;0;2;0;0.0;0.0
57;2020-12-29;3;0;5;0;0.0;0.0
57;2020-12-30;1;0;6;0;0.0;0.0
57;2020-12-31;0;0;6;0;0.0;0.0
57;2021-01-01;1;1;7;1;0.0;0.0
57;2021-01-02;3;0;10;1;0.0;0.0
57;2021-01-03;0;0;10;1;0.0;0.0
57;2021-01-04;17;0;27;1;0.0;0.0
57;2021-01-05;199;0;226;1;0.0;0.0
57;2021-01-06;226;1;452;2;0.0;0.0
57;2021-01-07;586;2;1038;4;0.1;0.0
57;2021-01-08;509;2;1547;6;0.1;0.0
57;2021-01-09;203;0;1750;6;0.2;0.0
57;2021-01-10;109;1;1859;7;0.2;0.0
57;2021-01-11;470;1;2329;8;0.2;0.0
57;2021-01-12;612;7;2941;15;0.3;0.0
57;2021-01-13;696;2;3637;17;0.4;0.0
57;2021-01-14;708;6;4345;23;0.4;0.0
57;2021-01-15;636;5;4981;28;0.5;0.0
57;2021-01-16;452;1;5433;29;0.5;0.0
57;2021-01-17;493;1;5926;30;0.6;0.0
57;2021-01-18;2716;23;8642;53;0.8;0.0
57;2021-01-19;2567;22;11209;75;1.1;0.0
57;2021-01-20;2770;23;13979;98;1.3;0.0
57;2021-01-21;1803;9;15782;107;1.5;0.0
57;2021-01-22;1325;8;17107;115;1.7;0.0
57;2021-01-23;543;15;17650;130;1.7;0.0
57;2021-01-24;1;0;17651;130;1.7;0.0
57;2021-01-25;869;186;18520;316;1.8;0.0
57;2021-01-26;1112;214;19632;530;1.9;0.1
57;2021-01-27;1070;183;20702;713;2.0;0.1
57;2021-01-28;1041;296;21743;1009;2.1;0.1
57;2021-01-29;983;392;22726;1401;2.2;0.1
57;2021-01-30;440;93;23166;1494;2.2;0.1
57;2021-01-31;11;27;23177;1521;2.2;0.1
57;2021-02-01;828;351;24005;1872;2.3;0.2
57;2021-02-02;989;363;24994;2235;2.4;0.2
57;2021-02-03;987;318;25981;2553;2.5;0.2
57;2021-02-04;1138;803;27119;3356;2.6;0.3
57;2021-02-05;929;354;28048;3710;2.7;0.4
57;2021-02-06;482;347;28530;4057;2.8;0.4
57;2021-02-07;103;336;28633;4393;2.8;0.4
57;2021-02-08;1258;1548;29891;5941;2.9;0.6
57;2021-02-09;1763;1676;31654;7617;3.1;0.7
57;2021-02-10;1711;2075;33365;9692;3.2;0.9
57;2021-02-11;1488;1326;34853;11018;3.4;1.1
57;2021-02-12;1227;677;36080;11695;3.5;1.1
57;2021-02-13;1152;179;37232;11874;3.6;1.1
57;2021-02-14;1211;28;38443;11902;3.7;1.1
57;2021-02-15;766;858;39209;12760;3.8;1.2
57;2021-02-16;1076;798;40285;13558;3.9;1.3
57;2021-02-17;1008;962;41293;14520;4.0;1.4
57;2021-02-18;976;1157;42269;15677;4.1;1.5
57;2021-02-19;956;934;43225;16611;4.2;1.6
57;2021-02-20;1172;614;44397;17225;4.3;1.7
57;2021-02-21;323;13;44720;17238;4.3;1.7
57;2021-02-22;1230;911;45950;18149;4.4;1.8
57;2021-02-23;2234;1087;48184;19236;4.7;1.9
57;2021-02-24;2287;1004;50471;20240;4.9;2.0
57;2021-02-25;3297;1128;53768;21368;5.2;2.1
57;2021-02-26;3593;962;57361;22330;5.5;2.2
57;2021-02-27;3698;543;61059;22873;5.9;2.2
57;2021-02-28;1897;62;62956;22935;6.1;2.2
57;2021-03-01;2083;1344;65039;24279;6.3;2.3
57;2021-03-02;2868;1613;67907;25892;6.6;2.5
57;2021-03-03;2834;1617;70741;27509;6.8;2.7
57;2021-03-04;3287;1302;74028;28811;7.1;2.8
57;2021-03-05;4460;1258;78488;30069;7.6;2.9
57;2021-03-06;7265;798;85753;30867;8.3;3.0
57;2021-03-07;6070;286;91823;31153;8.9;3.0
57;2021-03-08;2300;1018;94123;32171;9.1;3.1
57;2021-03-09;3408;1313;97531;33484;9.4;3.2
57;2021-03-10;3593;980;101124;34464;9.8;3.3
57;2021-03-11;4047;1266;105171;35730;10.2;3.4
57;2021-03-12;5131;1224;110302;36954;10.6;3.6
57;2021-03-13;6287;997;116589;37951;11.3;3.7
57;2021-03-14;2425;431;119014;38382;11.5;3.7
57;2021-03-15;2966;887;121980;39269;11.8;3.8
57;2021-03-16;3062;1305;125042;40574;12.1;3.9
57;2021-03-17;3052;1158;128094;41732;12.4;4.0
57;2021-03-18;3403;1086;131497;42818;12.7;4.1
57;2021-03-19;4626;1064;136123;43882;13.1;4.2
57;2021-03-20;4703;1040;140826;44922;13.6;4.3
57;2021-03-21;1896;257;142722;45179;13.8;4.4
57;2021-03-22;2479;1501;145201;46680;14.0;4.5
57;2021-03-23;3442;2369;148643;49049;14.3;4.7
57;2021-03-24;3898;2169;152541;51218;14.7;4.9
57;2021-03-25;4743;2612;157284;53830;15.2;5.2
57;2021-03-26;4841;2283;162125;56113;15.7;5.4
57;2021-03-27;3710;3167;165835;59280;16.0;5.7
57;2021-03-28;1398;1849;167233;61129;16.1;5.9
57;2021-03-29;1932;2206;169165;63335;16.3;6.1
57;2021-03-30;3303;2525;172468;65860;16.6;6.4
57;2021-03-31;2826;2336;175294;68196;16.9;6.6
57;2021-04-01;3223;3190;178517;71386;17.2;6.9
57;2021-04-02;2392;2598;180909;73984;17.5;7.1
57;2021-04-03;2565;2668;183474;76652;17.7;7.4
57;2021-04-04;596;970;184070;77622;17.8;7.5
57;2021-04-05;1922;676;185992;78298;18.0;7.6
57;2021-04-06;2453;2859;188445;81157;18.2;7.8
57;2021-04-07;3816;3128;192261;84285;18.6;8.1
57;2021-04-08;5612;2927;197873;87212;19.1;8.4
57;2021-04-09;5014;2768;202887;89980;19.6;8.7
57;2021-04-10;2353;3650;205240;93630;19.8;9.0
57;2021-04-11;1099;1892;206339;95522;19.9;9.2
57;2021-04-12;1795;2758;208134;98280;20.1;9.5
57;2021-04-13;1976;3034;210110;101314;20.3;9.8
57;2021-04-14;1922;2995;212032;104309;20.5;10.1
57;2021-04-15;2364;3434;214396;107743;20.7;10.4
57;2021-04-16;2700;3299;217096;111042;21.0;10.7
57;2021-04-17;2474;3184;219570;114226;21.2;11.0
57;2021-04-18;1241;1774;220811;116000;21.3;11.2
57;2021-04-19;2142;2260;222953;118260;21.5;11.4
57;2021-04-20;2513;2787;225466;121047;21.8;11.7
57;2021-04-21;2568;2382;228034;123429;22.0;11.9
57;2021-04-22;3209;2253;231243;125682;22.3;12.1
57;2021-04-23;4060;2586;235303;128268;22.7;12.4
57;2021-04-24;3396;2564;238699;130832;23.0;12.6
57;2021-04-25;757;1127;239456;131959;23.1;12.7
57;2021-04-26;2972;2003;242428;133962;23.4;12.9
57;2021-04-27;3898;2385;246326;136347;23.8;13.2
57;2021-04-28;4213;2596;250539;138943;24.2;13.4
57;2021-04-29;5261;3465;255800;142408;24.7;13.7
57;2021-04-30;4729;3555;260529;145963;25.2;14.1
57;2021-05-01;2356;1687;262885;147650;25.4;14.3
57;2021-05-02;790;915;263675;148565;25.5;14.3
57;2021-05-03;3561;2995;267236;151560;25.8;14.6
57;2021-05-04;4871;3175;272107;154735;26.3;14.9
57;2021-05-05;6123;3171;278230;157906;26.9;15.2
57;2021-05-06;5990;3282;284220;161188;27.4;15.6
57;2021-05-07;6853;3449;291073;164637;28.1;15.9
57;2021-05-08;4051;1605;295124;166242;28.5;16.0
57;2021-05-09;2048;1114;297172;167356;28.7;16.2
57;2021-05-10;5129;3067;302301;170423;29.2;16.5
57;2021-05-11;7453;2850;309754;173273;29.9;16.7
57;2021-05-12;7843;3248;317597;176521;30.7;17.0
57;2021-05-13;4509;915;322106;177436;31.1;17.1
57;2021-05-14;7840;2633;329946;180069;31.9;17.4
57;2021-05-15;5965;2047;335911;182116;32.4;17.6
57;2021-05-16;3307;578;339218;182694;32.7;17.6
57;2021-05-17;3867;2064;343085;184758;33.1;17.8
57;2021-05-18;6292;2104;349377;186862;33.7;18.0
57;2021-05-19;7018;2327;356395;189189;34.4;18.3
57;2021-05-20;6046;2180;362441;191369;35.0;18.5
57;2021-05-21;7563;2925;370004;194294;35.7;18.8
57;2021-05-22;4895;2171;374899;196465;36.2;19.0
57;2021-05-23;1964;430;376863;196895;36.4;19.0
57;2021-05-24;3027;1060;379890;197955;36.7;19.1
57;2021-05-25;5571;2806;385461;200761;37.2;19.4
57;2021-05-26;6375;3178;391836;203939;37.8;19.7
57;2021-05-27;5794;3124;397630;207063;38.4;20.0
57;2021-05-28;7024;4738;404654;211801;39.1;20.4
57;2021-05-29;5220;4245;409874;216046;39.6;20.9
57;2021-05-30;1968;1743;411842;217789;39.8;21.0
57;2021-05-31;4315;3340;416157;221129;40.2;21.3
57;2021-06-01;5934;3718;422091;224847;40.7;21.7
57;2021-06-02;6340;3907;428431;228754;41.4;22.1
57;2021-06-03;6209;3702;434640;232456;42.0;22.4
57;2021-06-04;7569;4992;442209;237448;42.7;22.9
57;2021-06-05;4764;4032;446973;241480;43.1;23.3
57;2021-06-06;1992;890;448965;242370;43.3;23.4
57;2021-06-07;4315;4034;453280;246404;43.8;23.8
57;2021-06-08;6721;4314;460001;250718;44.4;24.2
57;2021-06-09;6876;4156;466877;254874;45.1;24.6
57;2021-06-10;6218;4597;473095;259471;45.7;25.0
57;2021-06-11;5360;5366;478455;264837;46.2;25.6
57;2021-06-12;5741;4452;484196;269289;46.7;26.0
57;2021-06-13;1500;1142;485696;270431;46.9;26.1
57;2021-06-14;3381;4698;489077;275129;47.2;26.6
57;2021-06-15;3815;6024;492892;281153;47.6;27.1
57;2021-06-16;4400;6597;497292;287750;48.0;27.8
57;2021-06-17;4201;6073;501493;293823;48.4;28.4
57;2021-06-18;4273;7308;505766;301131;48.8;29.1
57;2021-06-19;4158;6292;509924;307423;49.2;29.7
57;2021-06-20;986;1665;510910;309088;49.3;29.8
57;2021-06-21;2065;5966;512975;315054;49.5;30.4
57;2021-06-22;2644;7987;515619;323041;49.8;31.2
57;2021-06-23;3071;8385;518690;331426;50.1;32.0
57;2021-06-24;2457;5288;521147;336714;50.3;32.5
57;2021-06-25;2856;7825;524003;344539;50.6;33.3
57;2021-06-26;2872;7258;526875;351797;50.9;34.0
57;2021-06-27;752;2985;527627;354782;50.9;34.2
57;2021-06-28;1591;5079;529218;359861;51.1;34.7
57;2021-06-29;2081;6832;531299;366693;51.3;35.4
57;2021-06-30;3068;7321;534367;374014;51.6;36.1
57;2021-07-01;2706;5957;537073;379971;51.8;36.7
57;2021-07-02;2697;8073;539770;388044;52.1;37.5
57;2021-07-03;3238;6528;543008;394572;52.4;38.1
57;2021-07-04;942;2467;543950;397039;52.5;38.3
57;2021-07-05;1713;4608;545663;401647;52.7;38.8
57;2021-07-06;2425;6480;548088;408127;52.9;39.4
57;2021-07-07;2732;7089;550820;415216;53.2;40.1
57;2021-07-08;2495;5876;553315;421092;53.4;40.7
57;2021-07-09;3424;8415;556739;429507;53.7;41.5
57;2021-07-10;3096;6943;559835;436450;54.0;42.1
57;2021-07-11;854;2233;560689;438683;54.1;42.3
57;2021-07-12;2441;6433;563130;445116;54.4;43.0
57;2021-07-13;4415;7507;567545;452623;54.8;43.7
57;2021-07-14;2823;3843;570368;456466;55.1;44.1
57;2021-07-15;3962;7789;574330;464255;55.4;44.8
57;2021-07-16;5643;9829;579973;474084;56.0;45.8
57;2021-07-17;5823;7287;585796;481371;56.6;46.5
57;2021-07-18;1491;2660;587287;484031;56.7;46.7
57;2021-07-19;2375;6201;589662;490232;56.9;47.3
57;2021-07-20;4331;6915;593993;497147;57.3;48.0
57;2021-07-21;5304;6908;599297;504055;57.9;48.7
57;2021-07-22;5982;5958;605279;510013;58.4;49.2
57;2021-07-23;7016;6407;612295;516420;59.1;49.9
57;2021-07-24;4536;7037;616831;523457;59.5;50.5
57;2021-07-25;1334;1770;618165;525227;59.7;50.7
57;2021-07-26;3724;4496;621889;529723;60.0;51.1
57;2021-07-27;6867;4953;628756;534676;60.7;51.6
57;2021-07-28;7488;4566;636244;539242;61.4;52.1
57;2021-07-29;7636;4603;643880;543845;62.2;52.5
57;2021-07-30;6874;4899;650754;548744;62.8;53.0
57;2021-07-31;5707;5024;656461;553768;63.4;53.5
57;2021-08-01;2027;1116;658488;554884;63.6;53.6
57;2021-08-02;3543;3182;662031;558066;63.9;53.9
57;2021-08-03;5805;4284;667836;562350;64.5;54.3
57;2021-08-04;5228;3463;673064;565813;65.0;54.6
57;2021-08-05;5376;3785;678440;569598;65.5;55.0
57;2021-08-06;5624;4855;684064;574453;66.0;55.5
57;2021-08-07;4586;5169;688650;579622;66.5;56.0
57;2021-08-08;1480;1507;690130;581129;66.6;56.1
57;2021-08-09;2625;3177;692755;584306;66.9;56.4
57;2021-08-10;3520;3788;696275;588094;67.2;56.8
57;2021-08-11;3724;4024;699999;592118;67.6;57.2
57;2021-08-12;3161;5217;703160;597335;67.9;57.7
57;2021-08-13;3497;4734;706657;602069;68.2;58.1
57;2021-08-14;2165;5186;708822;607255;68.4;58.6
57;2021-08-15;529;1093;709351;608348;68.5;58.7
57;2021-08-16;1790;3568;711141;611916;68.7;59.1
57;2021-08-17;2380;5355;713521;617271;68.9;59.6
57;2021-08-18;2473;5375;715994;622646;69.1;60.1
57;2021-08-19;2214;5486;718208;628132;69.3;60.6
57;2021-08-20;2058;6034;720266;634166;69.5;61.2
57;2021-08-21;1874;5395;722140;639561;69.7;61.7
57;2021-08-22;454;1530;722594;641091;69.8;61.9
57;2021-08-23;1144;3719;723738;644810;69.9;62.2
57;2021-08-24;1817;5614;725555;650424;70.0;62.8
57;2021-08-25;1620;5318;727175;655742;70.2;63.3
57;2021-08-26;1609;4674;728784;660416;70.4;63.8
57;2021-08-27;1770;5897;730554;666313;70.5;64.3
57;2021-08-28;2014;5385;732568;671698;70.7;64.8
57;2021-08-29;342;1090;732910;672788;70.8;64.9
57;2021-08-30;1033;3210;733943;675998;70.9;65.3
57;2021-08-31;1553;4295;735496;680293;71.0;65.7
57;2021-09-01;1460;3844;736956;684137;71.1;66.0
57;2021-09-02;1179;3107;738135;687244;71.3;66.3
57;2021-09-03;1568;3956;739703;691200;71.4;66.7
57;2021-09-04;1685;3741;741388;694941;71.6;67.1
57;2021-09-05;383;847;741771;695788;71.6;67.2
57;2021-09-06;773;1770;742544;697558;71.7;67.3
57;2021-09-07;704;1856;743248;699414;71.8;67.5
57;2021-09-08;930;2507;744178;701921;71.8;67.8
57;2021-09-09;613;1970;744791;703891;71.9;68.0
57;2021-09-10;1083;2471;745874;706362;72.0;68.2
57;2021-09-11;1181;2976;747055;709338;72.1;68.5
57;2021-09-12;248;490;747303;709828;72.1;68.5
57;2021-09-13;589;1350;747892;711178;72.2;68.7
57;2021-09-14;780;1703;748672;712881;72.3;68.8
57;2021-09-15;770;1994;749442;714875;72.3;69.0
57;2021-09-16;714;1229;750156;716104;72.4;69.1
57;2021-09-17;1114;1789;751270;717893;72.5;69.3
57;2021-09-18;807;2586;752077;720479;72.6;69.6
57;2021-09-19;120;346;752197;720825;72.6;69.6
57;2021-09-20;410;867;752607;721692;72.7;69.7
57;2021-09-21;502;827;753109;722519;72.7;69.8
57;2021-09-22;492;1307;753601;723826;72.8;69.9
57;2021-09-23;466;1215;754067;725041;72.8;70.0
57;2021-09-24;741;1435;754808;726476;72.9;70.1
57;2021-09-25;503;1999;755311;728475;72.9;70.3
57;2021-09-26;121;326;755432;728801;72.9;70.4
57;2021-09-27;440;844;755872;729645;73.0;70.4
57;2021-09-28;314;598;756186;730243;73.0;70.5
57;2021-09-29;557;1110;756743;731353;73.1;70.6
57;2021-09-30;289;615;757032;731968;73.1;70.7
57;2021-10-01;522;1328;757554;733296;73.1;70.8
57;2021-10-02;662;1562;758216;734858;73.2;70.9
57;2021-10-03;121;232;758337;735090;73.2;71.0
57;2021-10-04;363;617;758700;735707;73.2;71.0
57;2021-10-05;284;576;758984;736283;73.3;71.1
57;2021-10-06;456;769;759440;737052;73.3;71.2
57;2021-10-07;312;627;759752;737679;73.3;71.2
57;2021-10-08;501;1036;760253;738715;73.4;71.3
57;2021-10-09;607;1150;760860;739865;73.5;71.4
57;2021-10-10;101;121;760961;739986;73.5;71.4
57;2021-10-11;339;611;761300;740597;73.5;71.5
58;2020-12-27;0;0;0;0;0.0;0.0
58;2020-12-28;0;0;0;0;0.0;0.0
58;2020-12-29;1;0;1;0;0.0;0.0
58;2020-12-30;0;0;1;0;0.0;0.0
58;2020-12-31;0;0;1;0;0.0;0.0
58;2021-01-01;0;0;1;0;0.0;0.0
58;2021-01-02;0;0;1;0;0.0;0.0
58;2021-01-03;1;0;2;0;0.0;0.0
58;2021-01-04;0;0;2;0;0.0;0.0
58;2021-01-05;2;0;4;0;0.0;0.0
58;2021-01-06;145;0;149;0;0.1;0.0
58;2021-01-07;241;0;390;0;0.2;0.0
58;2021-01-08;63;0;453;0;0.2;0.0
58;2021-01-09;1;0;454;0;0.2;0.0
58;2021-01-10;0;0;454;0;0.2;0.0
58;2021-01-11;55;0;509;0;0.3;0.0
58;2021-01-12;260;0;769;0;0.4;0.0
58;2021-01-13;412;4;1181;4;0.6;0.0
58;2021-01-14;292;2;1473;6;0.7;0.0
58;2021-01-15;143;0;1616;6;0.8;0.0
58;2021-01-16;10;1;1626;7;0.8;0.0
58;2021-01-17;0;0;1626;7;0.8;0.0
58;2021-01-18;413;1;2039;8;1.0;0.0
58;2021-01-19;987;3;3026;11;1.5;0.0
58;2021-01-20;1208;2;4234;13;2.1;0.0
58;2021-01-21;962;5;5196;18;2.6;0.0
58;2021-01-22;779;3;5975;21;3.0;0.0
58;2021-01-23;253;0;6228;21;3.1;0.0
58;2021-01-24;2;0;6230;21;3.1;0.0
58;2021-01-25;439;1;6669;22;3.3;0.0
58;2021-01-26;650;4;7319;26;3.7;0.0
58;2021-01-27;604;44;7923;70;4.0;0.0
58;2021-01-28;758;66;8681;136;4.3;0.1
58;2021-01-29;838;7;9519;143;4.8;0.1
58;2021-01-30;281;0;9800;143;4.9;0.1
58;2021-01-31;10;0;9810;143;4.9;0.1
58;2021-02-01;200;73;10010;216;5.0;0.1
58;2021-02-02;566;83;10576;299;5.3;0.1
58;2021-02-03;279;147;10855;446;5.4;0.2
58;2021-02-04;284;93;11139;539;5.6;0.3
58;2021-02-05;184;93;11323;632;5.7;0.3
58;2021-02-06;89;0;11412;632;5.7;0.3
58;2021-02-07;0;0;11412;632;5.7;0.3
58;2021-02-08;306;72;11718;704;5.9;0.4
58;2021-02-09;503;315;12221;1019;6.1;0.5
58;2021-02-10;350;380;12571;1399;6.3;0.7
58;2021-02-11;286;381;12857;1780;6.4;0.9
58;2021-02-12;243;204;13100;1984;6.6;1.0
58;2021-02-13;83;29;13183;2013;6.6;1.0
58;2021-02-14;0;3;13183;2016;6.6;1.0
58;2021-02-15;114;526;13297;2542;6.7;1.3
58;2021-02-16;208;937;13505;3479;6.8;1.7
58;2021-02-17;221;760;13726;4239;6.9;2.1
58;2021-02-18;187;787;13913;5026;7.0;2.5
58;2021-02-19;238;722;14151;5748;7.1;2.9
58;2021-02-20;62;228;14213;5976;7.1;3.0
58;2021-02-21;0;30;14213;6006;7.1;3.0
58;2021-02-22;78;403;14291;6409;7.2;3.2
58;2021-02-23;49;617;14340;7026;7.2;3.5
58;2021-02-24;39;628;14379;7654;7.2;3.8
58;2021-02-25;252;702;14631;8356;7.3;4.2
58;2021-02-26;246;621;14877;8977;7.5;4.5
58;2021-02-27;104;189;14981;9166;7.5;4.6
58;2021-02-28;11;8;14992;9174;7.5;4.6
58;2021-03-01;145;246;15137;9420;7.6;4.7
58;2021-03-02;416;642;15553;10062;7.8;5.0
58;2021-03-03;523;295;16076;10357;8.1;5.2
58;2021-03-04;725;279;16801;10636;8.4;5.3
58;2021-03-05;866;205;17667;10841;8.9;5.4
58;2021-03-06;577;87;18244;10928;9.1;5.5
58;2021-03-07;63;12;18307;10940;9.2;5.5
58;2021-03-08;156;300;18463;11240;9.3;5.6
58;2021-03-09;546;548;19009;11788;9.5;5.9
58;2021-03-10;841;245;19850;12033;9.9;6.0
58;2021-03-11;858;277;20708;12310;10.4;6.2
58;2021-03-12;862;201;21570;12511;10.8;6.3
58;2021-03-13;506;67;22076;12578;11.1;6.3
58;2021-03-14;34;1;22110;12579;11.1;6.3
58;2021-03-15;530;119;22640;12698;11.3;6.4
58;2021-03-16;725;224;23365;12922;11.7;6.5
58;2021-03-17;755;198;24120;13120;12.1;6.6
58;2021-03-18;584;180;24704;13300;12.4;6.7
58;2021-03-19;540;108;25244;13408;12.6;6.7
58;2021-03-20;322;64;25566;13472;12.8;6.7
58;2021-03-21;17;1;25583;13473;12.8;6.8
58;2021-03-22;797;26;26380;13499;13.2;6.8
58;2021-03-23;1636;44;28016;13543;14.0;6.8
58;2021-03-24;1371;82;29387;13625;14.7;6.8
58;2021-03-25;1840;49;31227;13674;15.6;6.9
58;2021-03-26;1414;57;32641;13731;16.4;6.9
58;2021-03-27;358;8;32999;13739;16.5;6.9
58;2021-03-28;20;0;33019;13739;16.5;6.9
58;2021-03-29;636;154;33655;13893;16.9;7.0
58;2021-03-30;1187;259;34842;14152;17.5;7.1
58;2021-03-31;1116;396;35958;14548;18.0;7.3
58;2021-04-01;1547;407;37505;14955;18.8;7.5
58;2021-04-02;1463;369;38968;15324;19.5;7.7
58;2021-04-03;568;152;39536;15476;19.8;7.8
58;2021-04-04;1;1;39537;15477;19.8;7.8
58;2021-04-05;48;0;39585;15477;19.8;7.8
58;2021-04-06;823;347;40408;15824;20.2;7.9
58;2021-04-07;697;552;41105;16376;20.6;8.2
58;2021-04-08;1493;427;42598;16803;21.3;8.4
58;2021-04-09;1775;487;44373;17290;22.2;8.7
58;2021-04-10;650;202;45023;17492;22.6;8.8
58;2021-04-11;17;3;45040;17495;22.6;8.8
58;2021-04-12;1116;504;46156;17999;23.1;9.0
58;2021-04-13;1435;630;47591;18629;23.8;9.3
58;2021-04-14;1358;699;48949;19328;24.5;9.7
58;2021-04-15;1441;613;50390;19941;25.2;10.0
58;2021-04-16;1734;516;52124;20457;26.1;10.2
58;2021-04-17;721;234;52845;20691;26.5;10.4
58;2021-04-18;20;7;52865;20698;26.5;10.4
58;2021-04-19;530;606;53395;21304;26.8;10.7
58;2021-04-20;487;1120;53882;22424;27.0;11.2
58;2021-04-21;628;970;54510;23394;27.3;11.7
58;2021-04-22;768;1525;55278;24919;27.7;12.5
58;2021-04-23;919;787;56197;25706;28.2;12.9
58;2021-04-24;211;208;56408;25914;28.3;13.0
58;2021-04-25;109;9;56517;25923;28.3;13.0
58;2021-04-26;761;247;57278;26170;28.7;13.1
58;2021-04-27;1499;1120;58777;27290;29.4;13.7
58;2021-04-28;1536;1054;60313;28344;30.2;14.2
58;2021-04-29;1444;1048;61757;29392;30.9;14.7
58;2021-04-30;1258;943;63015;30335;31.6;15.2
58;2021-05-01;6;17;63021;30352;31.6;15.2
58;2021-05-02;4;2;63025;30354;31.6;15.2
58;2021-05-03;1042;407;64067;30761;32.1;15.4
58;2021-05-04;1073;1347;65140;32108;32.6;16.1
58;2021-05-05;955;1095;66095;33203;33.1;16.6
58;2021-05-06;1363;1061;67458;34264;33.8;17.2
58;2021-05-07;1111;1092;68569;35356;34.4;17.7
58;2021-05-08;59;60;68628;35416;34.4;17.7
58;2021-05-09;7;21;68635;35437;34.4;17.8
58;2021-05-10;875;992;69510;36429;34.8;18.3
58;2021-05-11;1184;1985;70694;38414;35.4;19.2
58;2021-05-12;1660;1558;72354;39972;36.3;20.0
58;2021-05-13;49;183;72403;40155;36.3;20.1
58;2021-05-14;2311;908;74714;41063;37.4;20.6
58;2021-05-15;1726;456;76440;41519;38.3;20.8
58;2021-05-16;118;33;76558;41552;38.4;20.8
58;2021-05-17;793;611;77351;42163;38.8;21.1
58;2021-05-18;1333;1182;78684;43345;39.4;21.7
58;2021-05-19;1738;548;80422;43893;40.3;22.0
58;2021-05-20;1701;674;82123;44567;41.1;22.3
58;2021-05-21;854;730;82977;45297;41.6;22.7
58;2021-05-22;304;240;83281;45537;41.7;22.8
58;2021-05-23;2;21;83283;45558;41.7;22.8
58;2021-05-24;21;42;83304;45600;41.7;22.8
58;2021-05-25;1386;1156;84690;46756;42.4;23.4
58;2021-05-26;845;839;85535;47595;42.9;23.8
58;2021-05-27;753;943;86288;48538;43.2;24.3
58;2021-05-28;429;909;86717;49447;43.4;24.8
58;2021-05-29;151;212;86868;49659;43.5;24.9
58;2021-05-30;21;19;86889;49678;43.5;24.9
58;2021-05-31;757;398;87646;50076;43.9;25.1
58;2021-06-01;1372;1656;89018;51732;44.6;25.9
58;2021-06-02;1467;1048;90485;52780;45.3;26.4
58;2021-06-03;1024;958;91509;53738;45.8;26.9
58;2021-06-04;842;909;92351;54647;46.3;27.4
58;2021-06-05;272;263;92623;54910;46.4;27.5
58;2021-06-06;26;50;92649;54960;46.4;27.5
58;2021-06-07;712;793;93361;55753;46.8;27.9
58;2021-06-08;1321;1758;94682;57511;47.4;28.8
58;2021-06-09;1417;1008;96099;58519;48.1;29.3
58;2021-06-10;1106;982;97205;59501;48.7;29.8
58;2021-06-11;1023;907;98228;60408;49.2;30.3
58;2021-06-12;1056;415;99284;60823;49.7;30.5
58;2021-06-13;36;33;99320;60856;49.8;30.5
58;2021-06-14;516;1016;99836;61872;50.0;31.0
58;2021-06-15;1592;1757;101428;63629;50.8;31.9
58;2021-06-16;1806;994;103234;64623;51.7;32.4
58;2021-06-17;2023;1109;105257;65732;52.7;32.9
58;2021-06-18;986;1061;106243;66793;53.2;33.5
58;2021-06-19;581;320;106824;67113;53.5;33.6
58;2021-06-20;9;2;106833;67115;53.5;33.6
58;2021-06-21;472;553;107305;67668;53.8;33.9
58;2021-06-22;1028;1965;108333;69633;54.3;34.9
58;2021-06-23;1477;1511;109810;71144;55.0;35.6
58;2021-06-24;729;1024;110539;72168;55.4;36.2
58;2021-06-25;824;1719;111363;73887;55.8;37.0
58;2021-06-26;554;1228;111917;75115;56.1;37.6
58;2021-06-27;18;26;111935;75141;56.1;37.6
58;2021-06-28;463;987;112398;76128;56.3;38.1
58;2021-06-29;623;2161;113021;78289;56.6;39.2
58;2021-06-30;999;1625;114020;79914;57.1;40.0
58;2021-07-01;760;1674;114780;81588;57.5;40.9
58;2021-07-02;444;851;115224;82439;57.7;41.3
58;2021-07-03;249;512;115473;82951;57.9;41.6
58;2021-07-04;12;30;115485;82981;57.9;41.6
58;2021-07-05;510;768;115995;83749;58.1;42.0
58;2021-07-06;695;2121;116690;85870;58.5;43.0
58;2021-07-07;388;955;117078;86825;58.7;43.5
58;2021-07-08;399;1019;117477;87844;58.9;44.0
58;2021-07-09;709;1422;118186;89266;59.2;44.7
58;2021-07-10;261;412;118447;89678;59.3;44.9
58;2021-07-11;175;53;118622;89731;59.4;45.0
58;2021-07-12;197;968;118819;90699;59.5;45.4
58;2021-07-13;933;2503;119752;93202;60.0;46.7
58;2021-07-14;27;60;119779;93262;60.0;46.7
58;2021-07-15;1135;1936;120914;95198;60.6;47.7
58;2021-07-16;1411;1446;122325;96644;61.3;48.4
58;2021-07-17;463;289;122788;96933;61.5;48.6
58;2021-07-18;102;21;122890;96954;61.6;48.6
58;2021-07-19;1655;987;124545;97941;62.4;49.1
58;2021-07-20;1408;2455;125953;100396;63.1;50.3
58;2021-07-21;1178;2010;127131;102406;63.7;51.3
58;2021-07-22;1143;1670;128274;104076;64.3;52.1
58;2021-07-23;1268;1446;129542;105522;64.9;52.9
58;2021-07-24;1000;1272;130542;106794;65.4;53.5
58;2021-07-25;89;40;130631;106834;65.4;53.5
58;2021-07-26;980;860;131611;107694;65.9;54.0
58;2021-07-27;1566;2569;133177;110263;66.7;55.2
58;2021-07-28;1570;1974;134747;112237;67.5;56.2
58;2021-07-29;1581;1628;136328;113865;68.3;57.0
58;2021-07-30;1466;1427;137794;115292;69.0;57.8
58;2021-07-31;568;525;138362;115817;69.3;58.0
58;2021-08-01;35;13;138397;115830;69.3;58.0
58;2021-08-02;1590;863;139987;116693;70.1;58.5
58;2021-08-03;2051;1781;142038;118474;71.2;59.4
58;2021-08-04;1307;1185;143345;119659;71.8;60.0
58;2021-08-05;1621;1175;144966;120834;72.6;60.5
58;2021-08-06;1359;1032;146325;121866;73.3;61.1
58;2021-08-07;318;401;146643;122267;73.5;61.3
58;2021-08-08;30;58;146673;122325;73.5;61.3
58;2021-08-09;1083;1388;147756;123713;74.0;62.0
58;2021-08-10;1779;1388;149535;125101;74.9;62.7
58;2021-08-11;1134;780;150669;125881;75.5;63.1
58;2021-08-12;1067;1109;151736;126990;76.0;63.6
58;2021-08-13;930;955;152666;127945;76.5;64.1
58;2021-08-14;232;317;152898;128262;76.6;64.3
58;2021-08-15;14;27;152912;128289;76.6;64.3
58;2021-08-16;311;1402;153223;129691;76.8;65.0
58;2021-08-17;805;1337;154028;131028;77.2;65.6
58;2021-08-18;767;1171;154795;132199;77.6;66.2
58;2021-08-19;731;1342;155526;133541;77.9;66.9
58;2021-08-20;708;1298;156234;134839;78.3;67.6
58;2021-08-21;254;476;156488;135315;78.4;67.8
58;2021-08-22;9;86;156497;135401;78.4;67.8
58;2021-08-23;418;816;156915;136217;78.6;68.2
58;2021-08-24;513;1481;157428;137698;78.9;69.0
58;2021-08-25;436;1542;157864;139240;79.1;69.8
58;2021-08-26;553;1731;158417;140971;79.4;70.6
58;2021-08-27;494;1565;158911;142536;79.6;71.4
58;2021-08-28;244;640;159155;143176;79.7;71.7
58;2021-08-29;9;42;159164;143218;79.7;71.8
58;2021-08-30;356;783;159520;144001;79.9;72.1
58;2021-08-31;493;1530;160013;145531;80.2;72.9
58;2021-09-01;428;1494;160441;147025;80.4;73.7
58;2021-09-02;291;1238;160732;148263;80.5;74.3
58;2021-09-03;364;1323;161096;149586;80.7;74.9
58;2021-09-04;206;637;161302;150223;80.8;75.3
58;2021-09-05;3;27;161305;150250;80.8;75.3
58;2021-09-06;117;395;161422;150645;80.9;75.5
58;2021-09-07;320;808;161742;151453;81.0;75.9
58;2021-09-08;240;1036;161982;152489;81.2;76.4
58;2021-09-09;248;472;162230;152961;81.3;76.6
58;2021-09-10;260;679;162490;153640;81.4;77.0
58;2021-09-11;128;439;162618;154079;81.5;77.2
58;2021-09-12;5;6;162623;154085;81.5;77.2
58;2021-09-13;207;439;162830;154524;81.6;77.4
58;2021-09-14;290;662;163120;155186;81.7;77.8
58;2021-09-15;189;573;163309;155759;81.8;78.0
58;2021-09-16;205;451;163514;156210;81.9;78.3
58;2021-09-17;197;376;163711;156586;82.0;78.5
58;2021-09-18;118;362;163829;156948;82.1;78.6
58;2021-09-19;5;4;163834;156952;82.1;78.6
58;2021-09-20;174;230;164008;157182;82.2;78.8
58;2021-09-21;139;421;164147;157603;82.2;79.0
58;2021-09-22;159;535;164306;158138;82.3;79.2
58;2021-09-23;135;288;164441;158426;82.4;79.4
58;2021-09-24;113;391;164554;158817;82.4;79.6
58;2021-09-25;93;374;164647;159191;82.5;79.8
58;2021-09-26;6;13;164653;159204;82.5;79.8
58;2021-09-27;91;232;164744;159436;82.5;79.9
58;2021-09-28;126;330;164870;159766;82.6;80.0
58;2021-09-29;99;346;164969;160112;82.7;80.2
58;2021-09-30;67;217;165036;160329;82.7;80.3
58;2021-10-01;89;220;165125;160549;82.7;80.4
58;2021-10-02;85;220;165210;160769;82.8;80.5
58;2021-10-03;0;6;165210;160775;82.8;80.6
58;2021-10-04;61;203;165271;160978;82.8;80.7
58;2021-10-05;134;324;165405;161302;82.9;80.8
58;2021-10-06;65;310;165470;161612;82.9;81.0
58;2021-10-07;90;161;165560;161773;82.9;81.1
58;2021-10-08;102;225;165662;161998;83.0;81.2
58;2021-10-09;59;139;165721;162137;83.0;81.2
58;2021-10-10;3;8;165724;162145;83.0;81.2
58;2021-10-11;57;160;165781;162305;83.1;81.3
59;2020-12-27;1;0;1;0;0.0;0.0
59;2020-12-28;27;0;28;0;0.0;0.0
59;2020-12-29;0;0;28;0;0.0;0.0
59;2020-12-30;0;0;28;0;0.0;0.0
59;2020-12-31;2;0;30;0;0.0;0.0
59;2021-01-01;3;0;33;0;0.0;0.0
59;2021-01-02;4;2;37;2;0.0;0.0
59;2021-01-03;4;0;41;2;0.0;0.0
59;2021-01-04;79;0;120;2;0.0;0.0
59;2021-01-05;217;0;337;2;0.0;0.0
59;2021-01-06;428;2;765;4;0.0;0.0
59;2021-01-07;1314;1;2079;5;0.1;0.0
59;2021-01-08;1262;10;3341;15;0.1;0.0
59;2021-01-09;608;3;3949;18;0.2;0.0
59;2021-01-10;431;1;4380;19;0.2;0.0
59;2021-01-11;1846;7;6226;26;0.2;0.0
59;2021-01-12;2471;2;8697;28;0.3;0.0
59;2021-01-13;2369;3;11066;31;0.4;0.0
59;2021-01-14;2758;28;13824;59;0.5;0.0
59;2021-01-15;2276;17;16100;76;0.6;0.0
59;2021-01-16;771;3;16871;79;0.7;0.0
59;2021-01-17;560;4;17431;83;0.7;0.0
59;2021-01-18;3511;15;20942;98;0.8;0.0
59;2021-01-19;4760;12;25702;110;1.0;0.0
59;2021-01-20;4135;13;29837;123;1.2;0.0
59;2021-01-21;4732;42;34569;165;1.3;0.0
59;2021-01-22;4026;13;38595;178;1.5;0.0
59;2021-01-23;1217;3;39812;181;1.5;0.0
59;2021-01-24;170;0;39982;181;1.5;0.0
59;2021-01-25;2729;60;42711;241;1.6;0.0
59;2021-01-26;2825;140;45536;381;1.8;0.0
59;2021-01-27;1736;307;47272;688;1.8;0.0
59;2021-01-28;3399;763;50671;1451;2.0;0.1
59;2021-01-29;2544;798;53215;2249;2.1;0.1
59;2021-01-30;288;174;53503;2423;2.1;0.1
59;2021-01-31;24;0;53527;2423;2.1;0.1
59;2021-02-01;79;864;53606;3287;2.1;0.1
59;2021-02-02;691;1464;54297;4751;2.1;0.2
59;2021-02-03;3755;1461;58052;6212;2.2;0.2
59;2021-02-04;2967;1737;61019;7949;2.4;0.3
59;2021-02-05;1071;1408;62090;9357;2.4;0.4
59;2021-02-06;208;354;62298;9711;2.4;0.4
59;2021-02-07;268;49;62566;9760;2.4;0.4
59;2021-02-08;684;1610;63250;11370;2.4;0.4
59;2021-02-09;1016;1840;64266;13210;2.5;0.5
59;2021-02-10;975;1626;65241;14836;2.5;0.6
59;2021-02-11;1349;1809;66590;16645;2.6;0.6
59;2021-02-12;1416;1645;68006;18290;2.6;0.7
59;2021-02-13;208;740;68214;19030;2.6;0.7
59;2021-02-14;13;42;68227;19072;2.6;0.7
59;2021-02-15;1397;3097;69624;22169;2.7;0.9
59;2021-02-16;1438;3757;71062;25926;2.7;1.0
59;2021-02-17;1624;3813;72686;29739;2.8;1.1
59;2021-02-18;3107;5183;75793;34922;2.9;1.3
59;2021-02-19;3208;3621;79001;38543;3.1;1.5
59;2021-02-20;1413;1584;80414;40127;3.1;1.5
59;2021-02-21;242;263;80656;40390;3.1;1.6
59;2021-02-22;1431;2565;82087;42955;3.2;1.7
59;2021-02-23;2658;2869;84745;45824;3.3;1.8
59;2021-02-24;4107;4072;88852;49896;3.4;1.9
59;2021-02-25;6921;3732;95773;53628;3.7;2.1
59;2021-02-26;6498;1896;102271;55524;4.0;2.1
59;2021-02-27;3095;194;105366;55718;4.1;2.2
59;2021-02-28;208;60;105574;55778;4.1;2.2
59;2021-03-01;3691;672;109265;56450;4.2;2.2
59;2021-03-02;4795;577;114060;57027;4.4;2.2
59;2021-03-03;5749;1019;119809;58046;4.6;2.2
59;2021-03-04;7086;966;126895;59012;4.9;2.3
59;2021-03-05;7838;1014;134733;60026;5.2;2.3
59;2021-03-06;11563;565;146296;60591;5.7;2.3
59;2021-03-07;7587;361;153883;60952;5.9;2.4
59;2021-03-08;4498;1121;158381;62073;6.1;2.4
59;2021-03-09;6577;1454;164958;63527;6.4;2.5
59;2021-03-10;7028;1218;171986;64745;6.6;2.5
59;2021-03-11;9476;1910;181462;66655;7.0;2.6
59;2021-03-12;12158;1585;193620;68240;7.5;2.6
59;2021-03-13;16558;1130;210178;69370;8.1;2.7
59;2021-03-14;6964;343;217142;69713;8.4;2.7
59;2021-03-15;5613;1513;222755;71226;8.6;2.8
59;2021-03-16;3740;1335;226495;72561;8.7;2.8
59;2021-03-17;3856;2106;230351;74667;8.9;2.9
59;2021-03-18;3958;2517;234309;77184;9.1;3.0
59;2021-03-19;7743;1842;242052;79026;9.3;3.1
59;2021-03-20;16023;1299;258075;80325;10.0;3.1
59;2021-03-21;6318;457;264393;80782;10.2;3.1
59;2021-03-22;5449;1784;269842;82566;10.4;3.2
59;2021-03-23;7773;2837;277615;85403;10.7;3.3
59;2021-03-24;6860;2994;284475;88397;11.0;3.4
59;2021-03-25;10534;2589;295009;90986;11.4;3.5
59;2021-03-26;12254;2864;307263;93850;11.9;3.6
59;2021-03-27;15275;1170;322538;95020;12.5;3.7
59;2021-03-28;7985;367;330523;95387;12.8;3.7
59;2021-03-29;5495;3214;336018;98601;13.0;3.8
59;2021-03-30;7540;3765;343558;102366;13.3;4.0
59;2021-03-31;6156;4122;349714;106488;13.5;4.1
59;2021-04-01;7494;4932;357208;111420;13.8;4.3
59;2021-04-02;7645;5533;364853;116953;14.1;4.5
59;2021-04-03;13019;4316;377872;121269;14.6;4.7
59;2021-04-04;5348;2192;383220;123461;14.8;4.8
59;2021-04-05;6021;1543;389241;125004;15.0;4.8
59;2021-04-06;5404;4506;394645;129510;15.2;5.0
59;2021-04-07;7624;5458;402269;134968;15.5;5.2
59;2021-04-08;10393;5786;412662;140754;15.9;5.4
59;2021-04-09;13422;5958;426084;146712;16.5;5.7
59;2021-04-10;11478;6158;437562;152870;16.9;5.9
59;2021-04-11;4636;3570;442198;156440;17.1;6.0
59;2021-04-12;6304;4354;448502;160794;17.3;6.2
59;2021-04-13;8934;4810;457436;165604;17.7;6.4
59;2021-04-14;8789;4357;466225;169961;18.0;6.6
59;2021-04-15;10306;4862;476531;174823;18.4;6.8
59;2021-04-16;10880;5508;487411;180331;18.8;7.0
59;2021-04-17;7296;9086;494707;189417;19.1;7.3
59;2021-04-18;3234;4175;497941;193592;19.2;7.5
59;2021-04-19;5044;4303;502985;197895;19.4;7.6
59;2021-04-20;6898;4227;509883;202122;19.7;7.8
59;2021-04-21;6271;4438;516154;206560;19.9;8.0
59;2021-04-22;8612;5526;524766;212086;20.3;8.2
59;2021-04-23;8458;5710;533224;217796;20.6;8.4
59;2021-04-24;5537;8066;538761;225862;20.8;8.7
59;2021-04-25;3242;6081;542003;231943;20.9;9.0
59;2021-04-26;6493;3801;548496;235744;21.2;9.1
59;2021-04-27;8367;5209;556863;240953;21.5;9.3
59;2021-04-28;8766;6585;565629;247538;21.8;9.6
59;2021-04-29;9417;8588;575046;256126;22.2;9.9
59;2021-04-30;10605;8559;585651;264685;22.6;10.2
59;2021-05-01;11998;7611;597649;272296;23.1;10.5
59;2021-05-02;8642;6001;606291;278297;23.4;10.7
59;2021-05-03;9554;5074;615845;283371;23.8;10.9
59;2021-05-04;11427;6019;627272;289390;24.2;11.2
59;2021-05-05;10294;6229;637566;295619;24.6;11.4
59;2021-05-06;11198;8467;648764;304086;25.1;11.7
59;2021-05-07;13297;9636;662061;313722;25.6;12.1
59;2021-05-08;14742;4181;676803;317903;26.1;12.3
59;2021-05-09;11492;3336;688295;321239;26.6;12.4
59;2021-05-10;12746;6660;701041;327899;27.1;12.7
59;2021-05-11;15112;8336;716153;336235;27.7;13.0
59;2021-05-12;16626;8653;732779;344888;28.3;13.3
59;2021-05-13;18441;3462;751220;348350;29.0;13.5
59;2021-05-14;15783;6971;767003;355321;29.6;13.7
59;2021-05-15;23443;5294;790446;360615;30.5;13.9
59;2021-05-16;21176;2416;811622;363031;31.3;14.0
59;2021-05-17;15066;5273;826688;368304;31.9;14.2
59;2021-05-18;16925;5677;843613;373981;32.6;14.4
59;2021-05-19;18319;5114;861932;379095;33.3;14.6
59;2021-05-20;17934;6997;879866;386092;34.0;14.9
59;2021-05-21;18370;8286;898236;394378;34.7;15.2
59;2021-05-22;23812;5687;922048;400065;35.6;15.5
59;2021-05-23;17921;2276;939969;402341;36.3;15.5
59;2021-05-24;16691;2145;956660;404486;37.0;15.6
59;2021-05-25;14990;6674;971650;411160;37.5;15.9
59;2021-05-26;15892;7046;987542;418206;38.1;16.2
59;2021-05-27;16151;9176;1003693;427382;38.8;16.5
59;2021-05-28;15884;11474;1019577;438856;39.4;17.0
59;2021-05-29;14370;8713;1033947;447569;39.9;17.3
59;2021-05-30;8406;1840;1042353;449409;40.3;17.4
59;2021-05-31;14203;7978;1056556;457387;40.8;17.7
59;2021-06-01;15085;10422;1071641;467809;41.4;18.1
59;2021-06-02;14769;9933;1086410;477742;42.0;18.5
59;2021-06-03;15630;12139;1102040;489881;42.6;18.9
59;2021-06-04;15608;13478;1117648;503359;43.2;19.4
59;2021-06-05;14978;9346;1132626;512705;43.7;19.8
59;2021-06-06;8826;3205;1141452;515910;44.1;19.9
59;2021-06-07;10527;9435;1151979;525345;44.5;20.3
59;2021-06-08;11760;11090;1163739;536435;44.9;20.7
59;2021-06-09;10759;11913;1174498;548348;45.4;21.2
59;2021-06-10;11503;12330;1186001;560678;45.8;21.7
59;2021-06-11;10973;15995;1196974;576673;46.2;22.3
59;2021-06-12;11069;13685;1208043;590358;46.7;22.8
59;2021-06-13;6344;7029;1214387;597387;46.9;23.1
59;2021-06-14;6505;12692;1220892;610079;47.2;23.6
59;2021-06-15;8231;15956;1229123;626035;47.5;24.2
59;2021-06-16;9205;13552;1238328;639587;47.8;24.7
59;2021-06-17;9187;15659;1247515;655246;48.2;25.3
59;2021-06-18;9081;20067;1256596;675313;48.5;26.1
59;2021-06-19;8952;17491;1265548;692804;48.9;26.8
59;2021-06-20;4900;10189;1270448;702993;49.1;27.2
59;2021-06-21;5279;15974;1275727;718967;49.3;27.8
59;2021-06-22;6336;18688;1282063;737655;49.5;28.5
59;2021-06-23;6168;19084;1288231;756739;49.8;29.2
59;2021-06-24;7339;20539;1295570;777278;50.0;30.0
59;2021-06-25;6507;21196;1302077;798474;50.3;30.8
59;2021-06-26;6489;23751;1308566;822225;50.5;31.8
59;2021-06-27;4752;17079;1313318;839304;50.7;32.4
59;2021-06-28;5003;19822;1318321;859126;50.9;33.2
59;2021-06-29;5549;20383;1323870;879509;51.1;34.0
59;2021-06-30;6132;20098;1330002;899607;51.4;34.7
59;2021-07-01;6772;20842;1336774;920449;51.6;35.6
59;2021-07-02;6837;23242;1343611;943691;51.9;36.5
59;2021-07-03;5562;24607;1349173;968298;52.1;37.4
59;2021-07-04;4416;15976;1353589;984274;52.3;38.0
59;2021-07-05;5672;17486;1359261;1001760;52.5;38.7
59;2021-07-06;6610;18800;1365871;1020560;52.8;39.4
59;2021-07-07;6939;17452;1372810;1038012;53.0;40.1
59;2021-07-08;8027;17697;1380837;1055709;53.3;40.8
59;2021-07-09;7705;20304;1388542;1076013;53.6;41.6
59;2021-07-10;7450;18539;1395992;1094552;53.9;42.3
59;2021-07-11;4448;10233;1400440;1104785;54.1;42.7
59;2021-07-12;5917;18048;1406357;1122833;54.3;43.4
59;2021-07-13;9910;20757;1416267;1143590;54.7;44.2
59;2021-07-14;9782;8455;1426049;1152045;55.1;44.5
59;2021-07-15;11638;20410;1437687;1172455;55.5;45.3
59;2021-07-16;13216;20514;1450903;1192969;56.0;46.1
59;2021-07-17;12400;17476;1463303;1210445;56.5;46.8
59;2021-07-18;7962;8684;1471265;1219129;56.8;47.1
59;2021-07-19;10404;16456;1481669;1235585;57.2;47.7
59;2021-07-20;13409;17127;1495078;1252712;57.7;48.4
59;2021-07-21;14526;15605;1509604;1268317;58.3;49.0
59;2021-07-22;17064;15226;1526668;1283543;59.0;49.6
59;2021-07-23;15728;15844;1542396;1299387;59.6;50.2
59;2021-07-24;16355;12312;1558751;1311699;60.2;50.7
59;2021-07-25;11916;7340;1570667;1319039;60.7;50.9
59;2021-07-26;13041;12625;1583708;1331664;61.2;51.4
59;2021-07-27;16229;11971;1599937;1343635;61.8;51.9
59;2021-07-28;17457;11679;1617394;1355314;62.5;52.3
59;2021-07-29;17422;11683;1634816;1366997;63.1;52.8
59;2021-07-30;15923;11619;1650739;1378616;63.8;53.2
59;2021-07-31;14022;9209;1664761;1387825;64.3;53.6
59;2021-08-01;9959;4575;1674720;1392400;64.7;53.8
59;2021-08-02;12214;10035;1686934;1402435;65.2;54.2
59;2021-08-03;13454;10061;1700388;1412496;65.7;54.6
59;2021-08-04;11240;8290;1711628;1420786;66.1;54.9
59;2021-08-05;12723;9793;1724351;1430579;66.6;55.3
59;2021-08-06;12562;11047;1736913;1441626;67.1;55.7
59;2021-08-07;9739;9300;1746652;1450926;67.5;56.0
59;2021-08-08;6960;5269;1753612;1456195;67.7;56.2
59;2021-08-09;8410;10829;1762022;1467024;68.1;56.7
59;2021-08-10;10405;10757;1772427;1477781;68.5;57.1
59;2021-08-11;8676;9322;1781103;1487103;68.8;57.4
59;2021-08-12;9003;12077;1790106;1499180;69.1;57.9
59;2021-08-13;8640;11753;1798746;1510933;69.5;58.4
59;2021-08-14;5953;10394;1804699;1521327;69.7;58.8
59;2021-08-15;3377;4666;1808076;1525993;69.8;58.9
59;2021-08-16;5878;13867;1813954;1539860;70.1;59.5
59;2021-08-17;6991;12764;1820945;1552624;70.3;60.0
59;2021-08-18;5956;11469;1826901;1564093;70.6;60.4
59;2021-08-19;6355;13874;1833256;1577967;70.8;60.9
59;2021-08-20;5837;14588;1839093;1592555;71.0;61.5
59;2021-08-21;4188;10295;1843281;1602850;71.2;61.9
59;2021-08-22;2852;7651;1846133;1610501;71.3;62.2
59;2021-08-23;4785;15732;1850918;1626233;71.5;62.8
59;2021-08-24;5302;15194;1856220;1641427;71.7;63.4
59;2021-08-25;4665;13086;1860885;1654513;71.9;63.9
59;2021-08-26;5211;14349;1866096;1668862;72.1;64.5
59;2021-08-27;5008;15432;1871104;1684294;72.3;65.1
59;2021-08-28;3808;12372;1874912;1696666;72.4;65.5
59;2021-08-29;1945;8435;1876857;1705101;72.5;65.9
59;2021-08-30;3895;12670;1880752;1717771;72.6;66.3
59;2021-08-31;3829;12396;1884581;1730167;72.8;66.8
59;2021-09-01;3315;9770;1887896;1739937;72.9;67.2
59;2021-09-02;3215;9908;1891111;1749845;73.0;67.6
59;2021-09-03;3831;10907;1894942;1760752;73.2;68.0
59;2021-09-04;3397;9395;1898339;1770147;73.3;68.4
59;2021-09-05;1242;3454;1899581;1773601;73.4;68.5
59;2021-09-06;2157;6203;1901738;1779804;73.5;68.7
59;2021-09-07;2261;6031;1903999;1785835;73.5;69.0
59;2021-09-08;2588;6547;1906587;1792382;73.6;69.2
59;2021-09-09;2443;5732;1909030;1798114;73.7;69.5
59;2021-09-10;3326;6792;1912356;1804906;73.9;69.7
59;2021-09-11;2600;7022;1914956;1811928;74.0;70.0
59;2021-09-12;914;2785;1915870;1814713;74.0;70.1
59;2021-09-13;1955;4262;1917825;1818975;74.1;70.3
59;2021-09-14;2340;4273;1920165;1823248;74.2;70.4
59;2021-09-15;2276;5364;1922441;1828612;74.3;70.6
59;2021-09-16;2178;4259;1924619;1832871;74.3;70.8
59;2021-09-17;2925;5456;1927544;1838327;74.5;71.0
59;2021-09-18;1787;5919;1929331;1844246;74.5;71.2
59;2021-09-19;384;1302;1929715;1845548;74.5;71.3
59;2021-09-20;1359;3301;1931074;1848849;74.6;71.4
59;2021-09-21;1335;2939;1932409;1851788;74.6;71.5
59;2021-09-22;1409;4740;1933818;1856528;74.7;71.7
59;2021-09-23;1514;2823;1935332;1859351;74.8;71.8
59;2021-09-24;1902;4241;1937234;1863592;74.8;72.0
59;2021-09-25;1157;4020;1938391;1867612;74.9;72.1
59;2021-09-26;314;1209;1938705;1868821;74.9;72.2
59;2021-09-27;1089;2534;1939794;1871355;74.9;72.3
59;2021-09-28;1076;2196;1940870;1873551;75.0;72.4
59;2021-09-29;1289;2959;1942159;1876510;75.0;72.5
59;2021-09-30;1239;2262;1943398;1878772;75.1;72.6
59;2021-10-01;1677;3387;1945075;1882159;75.1;72.7
59;2021-10-02;1465;3255;1946540;1885414;75.2;72.8
59;2021-10-03;263;631;1946803;1886045;75.2;72.8
59;2021-10-04;1076;1981;1947879;1888026;75.2;72.9
59;2021-10-05;1142;2167;1949021;1890193;75.3;73.0
59;2021-10-06;1259;2498;1950280;1892691;75.3;73.1
59;2021-10-07;967;1777;1951247;1894468;75.4;73.2
59;2021-10-08;1675;3300;1952922;1897768;75.4;73.3
59;2021-10-09;1306;2303;1954228;1900071;75.5;73.4
59;2021-10-10;283;446;1954511;1900517;75.5;73.4
59;2021-10-11;1016;1613;1955527;1902130;75.5;73.5
60;2020-12-27;0;0;0;0;0.0;0.0
60;2020-12-28;0;0;0;0;0.0;0.0
60;2020-12-29;1;0;1;0;0.0;0.0
60;2020-12-30;1;0;2;0;0.0;0.0
60;2020-12-31;0;0;2;0;0.0;0.0
60;2021-01-01;0;0;2;0;0.0;0.0
60;2021-01-02;5;0;7;0;0.0;0.0
60;2021-01-03;1;0;8;0;0.0;0.0
60;2021-01-04;1;0;9;0;0.0;0.0
60;2021-01-05;37;0;46;0;0.0;0.0
60;2021-01-06;188;4;234;4;0.0;0.0
60;2021-01-07;235;4;469;8;0.1;0.0
60;2021-01-08;380;4;849;12;0.1;0.0
60;2021-01-09;3;0;852;12;0.1;0.0
60;2021-01-10;60;0;912;12;0.1;0.0
60;2021-01-11;345;5;1257;17;0.2;0.0
60;2021-01-12;537;5;1794;22;0.2;0.0
60;2021-01-13;475;5;2269;27;0.3;0.0
60;2021-01-14;509;7;2778;34;0.3;0.0
60;2021-01-15;704;10;3482;44;0.4;0.0
60;2021-01-16;124;1;3606;45;0.4;0.0
60;2021-01-17;32;0;3638;45;0.4;0.0
60;2021-01-18;861;9;4499;54;0.5;0.0
60;2021-01-19;1207;14;5706;68;0.7;0.0
60;2021-01-20;1721;15;7427;83;0.9;0.0
60;2021-01-21;2267;14;9694;97;1.2;0.0
60;2021-01-22;1548;23;11242;120;1.4;0.0
60;2021-01-23;499;4;11741;124;1.4;0.0
60;2021-01-24;61;1;11802;125;1.4;0.0
60;2021-01-25;898;15;12700;140;1.5;0.0
60;2021-01-26;951;17;13651;157;1.7;0.0
60;2021-01-27;646;8;14297;165;1.7;0.0
60;2021-01-28;396;168;14693;333;1.8;0.0
60;2021-01-29;77;106;14770;439;1.8;0.1
60;2021-01-30;0;1;14770;440;1.8;0.1
60;2021-01-31;22;61;14792;501;1.8;0.1
60;2021-02-01;41;105;14833;606;1.8;0.1
60;2021-02-02;26;159;14859;765;1.8;0.1
60;2021-02-03;165;238;15024;1003;1.8;0.1
60;2021-02-04;170;339;15194;1342;1.8;0.2
60;2021-02-05;314;471;15508;1813;1.9;0.2
60;2021-02-06;65;79;15573;1892;1.9;0.2
60;2021-02-07;31;32;15604;1924;1.9;0.2
60;2021-02-08;330;516;15934;2440;1.9;0.3
60;2021-02-09;321;468;16255;2908;2.0;0.4
60;2021-02-10;557;994;16812;3902;2.0;0.5
60;2021-02-11;942;1132;17754;5034;2.2;0.6
60;2021-02-12;920;859;18674;5893;2.3;0.7
60;2021-02-13;91;309;18765;6202;2.3;0.8
60;2021-02-14;25;87;18790;6289;2.3;0.8
60;2021-02-15;614;805;19404;7094;2.4;0.9
60;2021-02-16;580;921;19984;8015;2.4;1.0
60;2021-02-17;632;934;20616;8949;2.5;1.1
60;2021-02-18;684;826;21300;9775;2.6;1.2
60;2021-02-19;641;763;21941;10538;2.7;1.3
60;2021-02-20;104;187;22045;10725;2.7;1.3
60;2021-02-21;23;121;22068;10846;2.7;1.3
60;2021-02-22;461;871;22529;11717;2.7;1.4
60;2021-02-23;535;784;23064;12501;2.8;1.5
60;2021-02-24;794;555;23858;13056;2.9;1.6
60;2021-02-25;1095;313;24953;13369;3.0;1.6
60;2021-02-26;1298;199;26251;13568;3.2;1.6
60;2021-02-27;669;35;26920;13603;3.3;1.6
60;2021-02-28;7;10;26927;13613;3.3;1.6
60;2021-03-01;895;50;27822;13663;3.4;1.7
60;2021-03-02;1012;169;28834;13832;3.5;1.7
60;2021-03-03;1322;459;30156;14291;3.7;1.7
60;2021-03-04;1727;528;31883;14819;3.9;1.8
60;2021-03-05;1823;304;33706;15123;4.1;1.8
60;2021-03-06;1919;151;35625;15274;4.3;1.9
60;2021-03-07;885;38;36510;15312;4.4;1.9
60;2021-03-08;980;319;37490;15631;4.5;1.9
60;2021-03-09;1643;363;39133;15994;4.7;1.9
60;2021-03-10;1938;436;41071;16430;5.0;2.0
60;2021-03-11;2325;390;43396;16820;5.3;2.0
60;2021-03-12;2596;554;45992;17374;5.6;2.1
60;2021-03-13;3839;218;49831;17592;6.0;2.1
60;2021-03-14;1782;65;51613;17657;6.3;2.1
60;2021-03-15;2091;507;53704;18164;6.5;2.2
60;2021-03-16;1584;633;55288;18797;6.7;2.3
60;2021-03-17;1658;626;56946;19423;6.9;2.4
60;2021-03-18;1760;742;58706;20165;7.1;2.4
60;2021-03-19;2591;534;61297;20699;7.4;2.5
60;2021-03-20;3241;202;64538;20901;7.8;2.5
60;2021-03-21;2124;99;66662;21000;8.1;2.5
60;2021-03-22;2132;720;68794;21720;8.3;2.6
60;2021-03-23;3309;732;72103;22452;8.7;2.7
60;2021-03-24;3070;881;75173;23333;9.1;2.8
60;2021-03-25;3848;863;79021;24196;9.6;2.9
60;2021-03-26;4217;883;83238;25079;10.1;3.0
60;2021-03-27;4141;330;87379;25409;10.6;3.1
60;2021-03-28;2450;87;89829;25496;10.9;3.1
60;2021-03-29;2612;1091;92441;26587;11.2;3.2
60;2021-03-30;3286;1081;95727;27668;11.6;3.4
60;2021-03-31;2668;1152;98395;28820;11.9;3.5
60;2021-04-01;2562;1105;100957;29925;12.2;3.6
60;2021-04-02;3310;1115;104267;31040;12.6;3.8
60;2021-04-03;3172;1019;107439;32059;13.0;3.9
60;2021-04-04;874;488;108313;32547;13.1;3.9
60;2021-04-05;458;85;108771;32632;13.2;4.0
60;2021-04-06;1969;1627;110740;34259;13.4;4.2
60;2021-04-07;1984;1757;112724;36016;13.7;4.4
60;2021-04-08;2610;1503;115334;37519;14.0;4.5
60;2021-04-09;2999;1532;118333;39051;14.3;4.7
60;2021-04-10;2927;1594;121260;40645;14.7;4.9
60;2021-04-11;1045;1002;122305;41647;14.8;5.0
60;2021-04-12;2045;1726;124350;43373;15.1;5.3
60;2021-04-13;2750;1790;127100;45163;15.4;5.5
60;2021-04-14;3143;1830;130243;46993;15.8;5.7
60;2021-04-15;3563;1903;133806;48896;16.2;5.9
60;2021-04-16;3288;1962;137094;50858;16.6;6.2
60;2021-04-17;2848;2178;139942;53036;17.0;6.4
60;2021-04-18;573;1834;140515;54870;17.0;6.7
60;2021-04-19;1743;2218;142258;57088;17.2;6.9
60;2021-04-20;2129;2681;144387;59769;17.5;7.2
60;2021-04-21;2653;2212;147040;61981;17.8;7.5
60;2021-04-22;2628;2514;149668;64495;18.1;7.8
60;2021-04-23;2651;2507;152319;67002;18.5;8.1
60;2021-04-24;2470;3461;154789;70463;18.8;8.5
60;2021-04-25;1159;1965;155948;72428;18.9;8.8
60;2021-04-26;1890;2537;157838;74965;19.1;9.1
60;2021-04-27;2311;2852;160149;77817;19.4;9.4
60;2021-04-28;3061;2403;163210;80220;19.8;9.7
60;2021-04-29;3154;2630;166364;82850;20.2;10.0
60;2021-04-30;3459;2969;169823;85819;20.6;10.4
60;2021-05-01;2353;1127;172176;86946;20.9;10.5
60;2021-05-02;2147;847;174323;87793;21.1;10.6
60;2021-05-03;2955;1861;177278;89654;21.5;10.9
60;2021-05-04;3016;2361;180294;92015;21.9;11.2
60;2021-05-05;3260;2812;183554;94827;22.2;11.5
60;2021-05-06;3649;2487;187203;97314;22.7;11.8
60;2021-05-07;3986;2528;191189;99842;23.2;12.1
60;2021-05-08;3582;973;194771;100815;23.6;12.2
60;2021-05-09;3458;959;198229;101774;24.0;12.3
60;2021-05-10;2392;2295;200621;104069;24.3;12.6
60;2021-05-11;3672;2472;204293;106541;24.8;12.9
60;2021-05-12;4717;2557;209010;109098;25.3;13.2
60;2021-05-13;5292;1131;214302;110229;26.0;13.4
60;2021-05-14;5602;1813;219904;112042;26.7;13.6
60;2021-05-15;6172;1721;226076;113763;27.4;13.8
60;2021-05-16;4858;690;230934;114453;28.0;13.9
60;2021-05-17;3715;1673;234649;116126;28.4;14.1
60;2021-05-18;4045;2078;238694;118204;28.9;14.3
60;2021-05-19;5097;1858;243791;120062;29.5;14.6
60;2021-05-20;5460;1813;249251;121875;30.2;14.8
60;2021-05-21;5969;1974;255220;123849;30.9;15.0
60;2021-05-22;5354;1982;260574;125831;31.6;15.3
60;2021-05-23;4263;658;264837;126489;32.1;15.3
60;2021-05-24;2950;534;267787;127023;32.5;15.4
60;2021-05-25;4138;2005;271925;129028;33.0;15.6
60;2021-05-26;4466;1833;276391;130861;33.5;15.9
60;2021-05-27;4611;1998;281002;132859;34.1;16.1
60;2021-05-28;4626;2508;285628;135367;34.6;16.4
60;2021-05-29;4612;2275;290240;137642;35.2;16.7
60;2021-05-30;1086;348;291326;137990;35.3;16.7
60;2021-05-31;3832;2085;295158;140075;35.8;17.0
60;2021-06-01;4445;2854;299603;142929;36.3;17.3
60;2021-06-02;3916;2451;303519;145380;36.8;17.6
60;2021-06-03;3904;2382;307423;147762;37.3;17.9
60;2021-06-04;4652;2910;312075;150672;37.8;18.3
60;2021-06-05;4302;3419;316377;154091;38.3;18.7
60;2021-06-06;2159;795;318536;154886;38.6;18.8
60;2021-06-07;2778;2762;321314;157648;38.9;19.1
60;2021-06-08;3802;3012;325116;160660;39.4;19.5
60;2021-06-09;3249;3402;328365;164062;39.8;19.9
60;2021-06-10;3454;3368;331819;167430;40.2;20.3
60;2021-06-11;3881;4194;335700;171624;40.7;20.8
60;2021-06-12;3780;4282;339480;175906;41.1;21.3
60;2021-06-13;1154;2225;340634;178131;41.3;21.6
60;2021-06-14;1911;3307;342545;181438;41.5;22.0
60;2021-06-15;3015;4165;345560;185603;41.9;22.5
60;2021-06-16;3250;4489;348810;190092;42.3;23.0
60;2021-06-17;2978;4785;351788;194877;42.6;23.6
60;2021-06-18;2982;4606;354770;199483;43.0;24.2
60;2021-06-19;3144;4728;357914;204211;43.4;24.8
60;2021-06-20;1431;1936;359345;206147;43.6;25.0
60;2021-06-21;1408;4042;360753;210189;43.7;25.5
60;2021-06-22;1758;5293;362511;215482;43.9;26.1
60;2021-06-23;1860;5237;364371;220719;44.2;26.8
60;2021-06-24;1803;5601;366174;226320;44.4;27.4
60;2021-06-25;1906;5731;368080;232051;44.6;28.1
60;2021-06-26;1860;6973;369940;239024;44.8;29.0
60;2021-06-27;713;2593;370653;241617;44.9;29.3
60;2021-06-28;1781;4142;372434;245759;45.1;29.8
60;2021-06-29;2010;5467;374444;251226;45.4;30.4
60;2021-06-30;2296;5360;376740;256586;45.7;31.1
60;2021-07-01;1888;4919;378628;261505;45.9;31.7
60;2021-07-02;2370;5878;380998;267383;46.2;32.4
60;2021-07-03;2400;6160;383398;273543;46.5;33.2
60;2021-07-04;792;2724;384190;276267;46.6;33.5
60;2021-07-05;1659;4406;385849;280673;46.8;34.0
60;2021-07-06;2146;4501;387995;285174;47.0;34.6
60;2021-07-07;2174;5119;390169;290293;47.3;35.2
60;2021-07-08;2672;4692;392841;294985;47.6;35.8
60;2021-07-09;2640;5568;395481;300553;47.9;36.4
60;2021-07-10;2579;5875;398060;306428;48.2;37.1
60;2021-07-11;1212;1942;399272;308370;48.4;37.4
60;2021-07-12;1447;4737;400719;313107;48.6;37.9
60;2021-07-13;2912;5019;403631;318126;48.9;38.6
60;2021-07-14;2584;1411;406215;319537;49.2;38.7
60;2021-07-15;3430;4873;409645;324410;49.6;39.3
60;2021-07-16;3698;5242;413343;329652;50.1;40.0
60;2021-07-17;4079;5135;417422;334787;50.6;40.6
60;2021-07-18;2186;2131;419608;336918;50.9;40.8
60;2021-07-19;2542;3892;422150;340810;51.2;41.3
60;2021-07-20;4197;4904;426347;345714;51.7;41.9
60;2021-07-21;4352;4286;430699;350000;52.2;42.4
60;2021-07-22;4627;4337;435326;354337;52.8;42.9
60;2021-07-23;4980;4902;440306;359239;53.4;43.5
60;2021-07-24;4314;4675;444620;363914;53.9;44.1
60;2021-07-25;2604;1831;447224;365745;54.2;44.3
60;2021-07-26;3377;3757;450601;369502;54.6;44.8
60;2021-07-27;4437;4634;455038;374136;55.2;45.3
60;2021-07-28;4554;3771;459592;377907;55.7;45.8
60;2021-07-29;4901;3714;464493;381621;56.3;46.3
60;2021-07-30;5026;4263;469519;385884;56.9;46.8
60;2021-07-31;4063;3969;473582;389853;57.4;47.3
60;2021-08-01;1684;862;475266;390715;57.6;47.4
60;2021-08-02;3198;2755;478464;393470;58.0;47.7
60;2021-08-03;3605;2894;482069;396364;58.4;48.0
60;2021-08-04;3316;2801;485385;399165;58.8;48.4
60;2021-08-05;3032;2260;488417;401425;59.2;48.7
60;2021-08-06;3830;3057;492247;404482;59.7;49.0
60;2021-08-07;3370;3078;495617;407560;60.1;49.4
60;2021-08-08;1534;911;497151;408471;60.3;49.5
60;2021-08-09;2206;2874;499357;411345;60.5;49.9
60;2021-08-10;3276;3313;502633;414658;60.9;50.3
60;2021-08-11;2788;3239;505421;417897;61.3;50.6
60;2021-08-12;2355;2665;507776;420562;61.5;51.0
60;2021-08-13;2751;2999;510527;423561;61.9;51.3
60;2021-08-14;2542;2735;513069;426296;62.2;51.7
60;2021-08-15;1362;553;514431;426849;62.3;51.7
60;2021-08-16;2040;3774;516471;430623;62.6;52.2
60;2021-08-17;2346;3820;518817;434443;62.9;52.7
60;2021-08-18;1943;3284;520760;437727;63.1;53.1
60;2021-08-19;1647;3075;522407;440802;63.3;53.4
60;2021-08-20;1865;3999;524272;444801;63.5;53.9
60;2021-08-21;1612;3492;525884;448293;63.7;54.3
60;2021-08-22;576;1339;526460;449632;63.8;54.5
60;2021-08-23;1104;3223;527564;452855;63.9;54.9
60;2021-08-24;1371;4494;528935;457349;64.1;55.4
60;2021-08-25;1431;3586;530366;460935;64.3;55.9
60;2021-08-26;1432;3459;531798;464394;64.5;56.3
60;2021-08-27;1436;4174;533234;468568;64.6;56.8
60;2021-08-28;1379;4479;534613;473047;64.8;57.3
60;2021-08-29;550;2041;535163;475088;64.9;57.6
60;2021-08-30;1231;2964;536394;478052;65.0;57.9
60;2021-08-31;1643;3799;538037;481851;65.2;58.4
60;2021-09-01;1237;2664;539274;484515;65.4;58.7
60;2021-09-02;1058;2568;540332;487083;65.5;59.0
60;2021-09-03;1024;2975;541356;490058;65.6;59.4
60;2021-09-04;1520;3605;542876;493663;65.8;59.8
60;2021-09-05;367;1331;543243;494994;65.8;60.0
60;2021-09-06;798;2382;544041;497376;65.9;60.3
60;2021-09-07;839;2776;544880;500152;66.0;60.6
60;2021-09-08;886;2708;545766;502860;66.1;60.9
60;2021-09-09;685;2157;546451;505017;66.2;61.2
60;2021-09-10;1051;2770;547502;507787;66.4;61.5
60;2021-09-11;1062;3332;548564;511119;66.5;61.9
60;2021-09-12;308;1108;548872;512227;66.5;62.1
60;2021-09-13;610;1720;549482;513947;66.6;62.3
60;2021-09-14;760;1496;550242;515443;66.7;62.5
60;2021-09-15;570;1243;550812;516686;66.8;62.6
60;2021-09-16;916;1327;551728;518013;66.9;62.8
60;2021-09-17;714;1465;552442;519478;67.0;63.0
60;2021-09-18;819;2609;553261;522087;67.1;63.3
60;2021-09-19;191;497;553452;522584;67.1;63.3
60;2021-09-20;456;1098;553908;523682;67.1;63.5
60;2021-09-21;499;984;554407;524666;67.2;63.6
60;2021-09-22;442;1306;554849;525972;67.2;63.7
60;2021-09-23;626;900;555475;526872;67.3;63.9
60;2021-09-24;489;1195;555964;528067;67.4;64.0
60;2021-09-25;493;1876;556457;529943;67.4;64.2
60;2021-09-26;78;294;556535;530237;67.5;64.3
60;2021-09-27;335;765;556870;531002;67.5;64.4
60;2021-09-28;320;883;557190;531885;67.5;64.5
60;2021-09-29;407;1047;557597;532932;67.6;64.6
60;2021-09-30;367;736;557964;533668;67.6;64.7
60;2021-10-01;411;1036;558375;534704;67.7;64.8
60;2021-10-02;588;1466;558963;536170;67.7;65.0
60;2021-10-03;80;305;559043;536475;67.8;65.0
60;2021-10-04;358;680;559401;537155;67.8;65.1
60;2021-10-05;263;533;559664;537688;67.8;65.2
60;2021-10-06;360;761;560024;538449;67.9;65.3
60;2021-10-07;181;556;560205;539005;67.9;65.3
60;2021-10-08;430;789;560635;539794;67.9;65.4
60;2021-10-09;596;1269;561231;541063;68.0;65.6
60;2021-10-10;49;188;561280;541251;68.0;65.6
60;2021-10-11;278;513;561558;541764;68.1;65.7
61;2020-12-27;0;0;0;0;0.0;0.0
61;2020-12-28;0;0;0;0;0.0;0.0
61;2020-12-29;0;0;0;0;0.0;0.0
61;2020-12-30;0;0;0;0;0.0;0.0
61;2020-12-31;0;0;0;0;0.0;0.0
61;2021-01-01;2;0;2;0;0.0;0.0
61;2021-01-02;1;0;3;0;0.0;0.0
61;2021-01-03;0;0;3;0;0.0;0.0
61;2021-01-04;1;0;4;0;0.0;0.0
61;2021-01-05;3;0;7;0;0.0;0.0
61;2021-01-06;77;0;84;0;0.0;0.0
61;2021-01-07;175;2;259;2;0.1;0.0
61;2021-01-08;405;1;664;3;0.2;0.0
61;2021-01-09;165;1;829;4;0.3;0.0
61;2021-01-10;49;0;878;4;0.3;0.0
61;2021-01-11;396;1;1274;5;0.5;0.0
61;2021-01-12;681;3;1955;8;0.7;0.0
61;2021-01-13;740;2;2695;10;1.0;0.0
61;2021-01-14;530;9;3225;19;1.2;0.0
61;2021-01-15;537;4;3762;23;1.4;0.0
61;2021-01-16;289;1;4051;24;1.5;0.0
61;2021-01-17;891;12;4942;36;1.8;0.0
61;2021-01-18;1914;3;6856;39;2.5;0.0
61;2021-01-19;1327;5;8183;44;3.0;0.0
61;2021-01-20;685;0;8868;44;3.2;0.0
61;2021-01-21;848;1;9716;45;3.5;0.0
61;2021-01-22;764;1;10480;46;3.8;0.0
61;2021-01-23;257;2;10737;48;3.9;0.0
61;2021-01-24;229;2;10966;50;4.0;0.0
61;2021-01-25;578;1;11544;51;4.2;0.0
61;2021-01-26;568;2;12112;53;4.4;0.0
61;2021-01-27;572;14;12684;67;4.6;0.0
61;2021-01-28;466;53;13150;120;4.7;0.0
61;2021-01-29;479;204;13629;324;4.9;0.1
61;2021-01-30;212;3;13841;327;5.0;0.1
61;2021-01-31;109;3;13950;330;5.0;0.1
61;2021-02-01;430;190;14380;520;5.2;0.2
61;2021-02-02;389;424;14769;944;5.3;0.3
61;2021-02-03;412;491;15181;1435;5.5;0.5
61;2021-02-04;390;338;15571;1773;5.6;0.6
61;2021-02-05;536;361;16107;2134;5.8;0.8
61;2021-02-06;206;93;16313;2227;5.9;0.8
61;2021-02-07;45;199;16358;2426;5.9;0.9
61;2021-02-08;541;1405;16899;3831;6.1;1.4
61;2021-02-09;404;810;17303;4641;6.2;1.7
61;2021-02-10;280;560;17583;5201;6.3;1.9
61;2021-02-11;432;558;18015;5759;6.5;2.1
61;2021-02-12;401;736;18416;6495;6.7;2.3
61;2021-02-13;133;431;18549;6926;6.7;2.5
61;2021-02-14;3;315;18552;7241;6.7;2.6
61;2021-02-15;169;841;18721;8082;6.8;2.9
61;2021-02-16;203;679;18924;8761;6.8;3.2
61;2021-02-17;44;638;18968;9399;6.9;3.4
61;2021-02-18;161;524;19129;9923;6.9;3.6
61;2021-02-19;101;391;19230;10314;6.9;3.7
61;2021-02-20;40;236;19270;10550;7.0;3.8
61;2021-02-21;2;155;19272;10705;7.0;3.9
61;2021-02-22;88;566;19360;11271;7.0;4.1
61;2021-02-23;102;495;19462;11766;7.0;4.2
61;2021-02-24;173;570;19635;12336;7.1;4.5
61;2021-02-25;265;445;19900;12781;7.2;4.6
61;2021-02-26;266;465;20166;13246;7.3;4.8
61;2021-02-27;110;228;20276;13474;7.3;4.9
61;2021-02-28;4;122;20280;13596;7.3;4.9
61;2021-03-01;215;611;20495;14207;7.4;5.1
61;2021-03-02;148;700;20643;14907;7.5;5.4
61;2021-03-03;143;448;20786;15355;7.5;5.5
61;2021-03-04;429;444;21215;15799;7.7;5.7
61;2021-03-05;702;302;21917;16101;7.9;5.8
61;2021-03-06;436;232;22353;16333;8.1;5.9
61;2021-03-07;155;2;22508;16335;8.1;5.9
61;2021-03-08;295;314;22803;16649;8.2;6.0
61;2021-03-09;622;186;23425;16835;8.5;6.1
61;2021-03-10;672;189;24097;17024;8.7;6.1
61;2021-03-11;1120;131;25217;17155;9.1;6.2
61;2021-03-12;1467;105;26684;17260;9.6;6.2
61;2021-03-13;775;56;27459;17316;9.9;6.3
61;2021-03-14;226;6;27685;17322;10.0;6.3
61;2021-03-15;814;37;28499;17359;10.3;6.3
61;2021-03-16;723;23;29222;17382;10.6;6.3
61;2021-03-17;761;12;29983;17394;10.8;6.3
61;2021-03-18;858;29;30841;17423;11.1;6.3
61;2021-03-19;1026;51;31867;17474;11.5;6.3
61;2021-03-20;478;17;32345;17491;11.7;6.3
61;2021-03-21;72;3;32417;17494;11.7;6.3
61;2021-03-22;797;94;33214;17588;12.0;6.4
61;2021-03-23;920;41;34134;17629;12.3;6.4
61;2021-03-24;1373;70;35507;17699;12.8;6.4
61;2021-03-25;1876;69;37383;17768;13.5;6.4
61;2021-03-26;1800;47;39183;17815;14.2;6.4
61;2021-03-27;1083;19;40266;17834;14.5;6.4
61;2021-03-28;359;9;40625;17843;14.7;6.4
61;2021-03-29;1273;184;41898;18027;15.1;6.5
61;2021-03-30;1470;102;43368;18129;15.7;6.5
61;2021-03-31;1687;54;45055;18183;16.3;6.6
61;2021-04-01;2051;233;47106;18416;17.0;6.7
61;2021-04-02;1519;435;48625;18851;17.6;6.8
61;2021-04-03;640;290;49265;19141;17.8;6.9
61;2021-04-04;193;1;49458;19142;17.9;6.9
61;2021-04-05;534;8;49992;19150;18.1;6.9
61;2021-04-06;1350;621;51342;19771;18.5;7.1
61;2021-04-07;1695;663;53037;20434;19.2;7.4
61;2021-04-08;2266;837;55303;21271;20.0;7.7
61;2021-04-09;2133;837;57436;22108;20.7;8.0
61;2021-04-10;1534;489;58970;22597;21.3;8.2
61;2021-04-11;238;202;59208;22799;21.4;8.2
61;2021-04-12;1284;737;60492;23536;21.8;8.5
61;2021-04-13;1742;707;62234;24243;22.5;8.8
61;2021-04-14;1734;788;63968;25031;23.1;9.0
61;2021-04-15;2268;789;66236;25820;23.9;9.3
61;2021-04-16;2227;691;68463;26511;24.7;9.6
61;2021-04-17;1483;321;69946;26832;25.3;9.7
61;2021-04-18;538;99;70484;26931;25.5;9.7
61;2021-04-19;936;750;71420;27681;25.8;10.0
61;2021-04-20;1523;786;72943;28467;26.3;10.3
61;2021-04-21;1351;1041;74294;29508;26.8;10.7
61;2021-04-22;1292;1222;75586;30730;27.3;11.1
61;2021-04-23;1213;1154;76799;31884;27.7;11.5
61;2021-04-24;1437;823;78236;32707;28.3;11.8
61;2021-04-25;361;333;78597;33040;28.4;11.9
61;2021-04-26;670;1146;79267;34186;28.6;12.3
61;2021-04-27;1465;1146;80732;35332;29.2;12.8
61;2021-04-28;1386;1392;82118;36724;29.7;13.3
61;2021-04-29;1246;1861;83364;38585;30.1;13.9
61;2021-04-30;1719;1177;85083;39762;30.7;14.4
61;2021-05-01;789;324;85872;40086;31.0;14.5
61;2021-05-02;439;227;86311;40313;31.2;14.6
61;2021-05-03;843;1251;87154;41564;31.5;15.0
61;2021-05-04;1323;1753;88477;43317;32.0;15.6
61;2021-05-05;1008;2032;89485;45349;32.3;16.4
61;2021-05-06;1772;2215;91257;47564;33.0;17.2
61;2021-05-07;1376;1974;92633;49538;33.5;17.9
61;2021-05-08;929;473;93562;50011;33.8;18.1
61;2021-05-09;395;293;93957;50304;33.9;18.2
61;2021-05-10;987;1756;94944;52060;34.3;18.8
61;2021-05-11;1377;1516;96321;53576;34.8;19.3
61;2021-05-12;1869;1594;98190;55170;35.5;19.9
61;2021-05-13;889;491;99079;55661;35.8;20.1
61;2021-05-14;1851;1191;100930;56852;36.4;20.5
61;2021-05-15;2111;1121;103041;57973;37.2;20.9
61;2021-05-16;984;300;104025;58273;37.6;21.0
61;2021-05-17;1312;914;105337;59187;38.0;21.4
61;2021-05-18;2422;894;107759;60081;38.9;21.7
61;2021-05-19;2400;804;110159;60885;39.8;22.0
61;2021-05-20;2212;819;112371;61704;40.6;22.3
61;2021-05-21;2150;861;114521;62565;41.4;22.6
61;2021-05-22;1780;718;116301;63283;42.0;22.9
61;2021-05-23;714;54;117015;63337;42.3;22.9
61;2021-05-24;914;112;117929;63449;42.6;22.9
61;2021-05-25;1991;921;119920;64370;43.3;23.2
61;2021-05-26;2046;932;121966;65302;44.0;23.6
61;2021-05-27;2041;1094;124007;66396;44.8;24.0
61;2021-05-28;2052;1378;126059;67774;45.5;24.5
61;2021-05-29;1466;557;127525;68331;46.1;24.7
61;2021-05-30;450;44;127975;68375;46.2;24.7
61;2021-05-31;1559;938;129534;69313;46.8;25.0
61;2021-06-01;1875;1389;131409;70702;47.5;25.5
61;2021-06-02;1676;1137;133085;71839;48.1;25.9
61;2021-06-03;2250;1110;135335;72949;48.9;26.3
61;2021-06-04;1897;1346;137232;74295;49.6;26.8
61;2021-06-05;1669;1240;138901;75535;50.2;27.3
61;2021-06-06;318;230;139219;75765;50.3;27.4
61;2021-06-07;2189;867;141408;76632;51.1;27.7
61;2021-06-08;1847;1570;143255;78202;51.7;28.2
61;2021-06-09;1975;1185;145230;79387;52.4;28.7
61;2021-06-10;1974;1192;147204;80579;53.2;29.1
61;2021-06-11;1823;1581;149027;82160;53.8;29.7
61;2021-06-12;1424;999;150451;83159;54.3;30.0
61;2021-06-13;340;377;150791;83536;54.5;30.2
61;2021-06-14;1107;1188;151898;84724;54.9;30.6
61;2021-06-15;1214;1694;153112;86418;55.3;31.2
61;2021-06-16;1114;1363;154226;87781;55.7;31.7
61;2021-06-17;1020;1731;155246;89512;56.1;32.3
61;2021-06-18;1523;1671;156769;91183;56.6;32.9
61;2021-06-19;1245;1302;158014;92485;57.1;33.4
61;2021-06-20;289;345;158303;92830;57.2;33.5
61;2021-06-21;807;1629;159110;94459;57.5;34.1
61;2021-06-22;1024;1683;160134;96142;57.8;34.7
61;2021-06-23;967;2436;161101;98578;58.2;35.6
61;2021-06-24;650;1361;161751;99939;58.4;36.1
61;2021-06-25;839;2167;162590;102106;58.7;36.9
61;2021-06-26;620;1955;163210;104061;58.9;37.6
61;2021-06-27;139;799;163349;104860;59.0;37.9
61;2021-06-28;478;2247;163827;107107;59.2;38.7
61;2021-06-29;699;2858;164526;109965;59.4;39.7
61;2021-06-30;771;2463;165297;112428;59.7;40.6
61;2021-07-01;633;1699;165930;114127;59.9;41.2
61;2021-07-02;842;2496;166772;116623;60.2;42.1
61;2021-07-03;417;1910;167189;118533;60.4;42.8
61;2021-07-04;75;638;167264;119171;60.4;43.0
61;2021-07-05;682;1774;167946;120945;60.7;43.7
61;2021-07-06;991;2794;168937;123739;61.0;44.7
61;2021-07-07;734;2360;169671;126099;61.3;45.5
61;2021-07-08;840;1944;170511;128043;61.6;46.2
61;2021-07-09;723;2375;171234;130418;61.8;47.1
61;2021-07-10;463;1767;171697;132185;62.0;47.7
61;2021-07-11;244;489;171941;132674;62.1;47.9
61;2021-07-12;438;2290;172379;134964;62.3;48.7
61;2021-07-13;643;2488;173022;137452;62.5;49.6
61;2021-07-14;150;334;173172;137786;62.5;49.8
61;2021-07-15;815;2814;173987;140600;62.8;50.8
61;2021-07-16;967;2572;174954;143172;63.2;51.7
61;2021-07-17;708;2232;175662;145404;63.4;52.5
61;2021-07-18;339;368;176001;145772;63.6;52.6
61;2021-07-19;934;2403;176935;148175;63.9;53.5
61;2021-07-20;1326;2356;178261;150531;64.4;54.4
61;2021-07-21;1503;2181;179764;152712;64.9;55.1
61;2021-07-22;1750;2188;181514;154900;65.6;55.9
61;2021-07-23;1793;2306;183307;157206;66.2;56.8
61;2021-07-24;1457;2008;184764;159214;66.7;57.5
61;2021-07-25;323;393;185087;159607;66.8;57.6
61;2021-07-26;1252;1933;186339;161540;67.3;58.3
61;2021-07-27;2420;1583;188759;163123;68.2;58.9
61;2021-07-28;2457;1355;191216;164478;69.1;59.4
61;2021-07-29;2563;1577;193779;166055;70.0;60.0
61;2021-07-30;2396;1393;196175;167448;70.8;60.5
61;2021-07-31;1282;1301;197457;168749;71.3;60.9
61;2021-08-01;504;259;197961;169008;71.5;61.0
61;2021-08-02;1913;1123;199874;170131;72.2;61.4
61;2021-08-03;2452;915;202326;171046;73.1;61.8
61;2021-08-04;2344;781;204670;171827;73.9;62.1
61;2021-08-05;1901;992;206571;172819;74.6;62.4
61;2021-08-06;2164;1163;208735;173982;75.4;62.8
61;2021-08-07;1422;799;210157;174781;75.9;63.1
61;2021-08-08;447;263;210604;175044;76.1;63.2
61;2021-08-09;1310;1112;211914;176156;76.5;63.6
61;2021-08-10;1315;1107;213229;177263;77.0;64.0
61;2021-08-11;1117;1257;214346;178520;77.4;64.5
61;2021-08-12;1038;1321;215384;179841;77.8;64.9
61;2021-08-13;879;1610;216263;181451;78.1;65.5
61;2021-08-14;717;864;216980;182315;78.4;65.8
61;2021-08-15;94;183;217074;182498;78.4;65.9
61;2021-08-16;913;1541;217987;184039;78.7;66.5
61;2021-08-17;1153;1701;219140;185740;79.1;67.1
61;2021-08-18;811;1479;219951;187219;79.4;67.6
61;2021-08-19;745;1570;220696;188789;79.7;68.2
61;2021-08-20;800;2131;221496;190920;80.0;68.9
61;2021-08-21;492;1345;221988;192265;80.2;69.4
61;2021-08-22;137;447;222125;192712;80.2;69.6
61;2021-08-23;415;1702;222540;194414;80.4;70.2
61;2021-08-24;528;1899;223068;196313;80.6;70.9
61;2021-08-25;412;1735;223480;198048;80.7;71.5
61;2021-08-26;429;1598;223909;199646;80.9;72.1
61;2021-08-27;515;1889;224424;201535;81.0;72.8
61;2021-08-28;286;1365;224710;202900;81.2;73.3
61;2021-08-29;50;417;224760;203317;81.2;73.4
61;2021-08-30;400;1618;225160;204935;81.3;74.0
61;2021-08-31;505;1672;225665;206607;81.5;74.6
61;2021-09-01;454;1312;226119;207919;81.7;75.1
61;2021-09-02;421;1097;226540;209016;81.8;75.5
61;2021-09-03;476;1296;227016;210312;82.0;76.0
61;2021-09-04;348;1254;227364;211566;82.1;76.4
61;2021-09-05;76;181;227440;211747;82.1;76.5
61;2021-09-06;286;973;227726;212720;82.2;76.8
61;2021-09-07;362;1391;228088;214111;82.4;77.3
61;2021-09-08;274;1193;228362;215304;82.5;77.8
61;2021-09-09;295;886;228657;216190;82.6;78.1
61;2021-09-10;366;889;229023;217079;82.7;78.4
61;2021-09-11;270;1021;229293;218100;82.8;78.8
61;2021-09-12;37;109;229330;218209;82.8;78.8
61;2021-09-13;208;526;229538;218735;82.9;79.0
61;2021-09-14;197;361;229735;219096;83.0;79.1
61;2021-09-15;258;595;229993;219691;83.1;79.3
61;2021-09-16;221;269;230214;219960;83.1;79.4
61;2021-09-17;241;533;230455;220493;83.2;79.6
61;2021-09-18;217;611;230672;221104;83.3;79.8
61;2021-09-19;1;0;230673;221104;83.3;79.8
61;2021-09-20;178;268;230851;221372;83.4;79.9
61;2021-09-21;236;187;231087;221559;83.5;80.0
61;2021-09-22;158;692;231245;222251;83.5;80.3
61;2021-09-23;163;228;231408;222479;83.6;80.3
61;2021-09-24;135;378;231543;222857;83.6;80.5
61;2021-09-25;171;596;231714;223453;83.7;80.7
61;2021-09-26;9;16;231723;223469;83.7;80.7
61;2021-09-27;124;293;231847;223762;83.7;80.8
61;2021-09-28;95;248;231942;224010;83.8;80.9
61;2021-09-29;105;216;232047;224226;83.8;81.0
61;2021-09-30;204;237;232251;224463;83.9;81.1
61;2021-10-01;87;265;232338;224728;83.9;81.2
61;2021-10-02;197;565;232535;225293;84.0;81.4
61;2021-10-03;1;8;232536;225301;84.0;81.4
61;2021-10-04;108;287;232644;225588;84.0;81.5
61;2021-10-05;112;289;232756;225877;84.1;81.6
61;2021-10-06;155;320;232911;226197;84.1;81.7
61;2021-10-07;140;259;233051;226456;84.2;81.8
61;2021-10-08;156;243;233207;226699;84.2;81.9
61;2021-10-09;89;168;233296;226867;84.3;81.9
61;2021-10-10;1;2;233297;226869;84.3;81.9
61;2021-10-11;138;386;233435;227255;84.3;82.1
62;2020-12-27;2;0;2;0;0.0;0.0
62;2020-12-28;1;0;3;0;0.0;0.0
62;2020-12-29;0;0;3;0;0.0;0.0
62;2020-12-30;0;0;3;0;0.0;0.0
62;2020-12-31;0;0;3;0;0.0;0.0
62;2021-01-01;0;0;3;0;0.0;0.0
62;2021-01-02;3;2;6;2;0.0;0.0
62;2021-01-03;0;0;6;2;0.0;0.0
62;2021-01-04;3;0;9;2;0.0;0.0
62;2021-01-05;47;0;56;2;0.0;0.0
62;2021-01-06;123;0;179;2;0.0;0.0
62;2021-01-07;352;0;531;2;0.0;0.0
62;2021-01-08;713;9;1244;11;0.1;0.0
62;2021-01-09;164;1;1408;12;0.1;0.0
62;2021-01-10;84;0;1492;12;0.1;0.0
62;2021-01-11;557;3;2049;15;0.1;0.0
62;2021-01-12;1260;6;3309;21;0.2;0.0
62;2021-01-13;1139;17;4448;38;0.3;0.0
62;2021-01-14;1385;9;5833;47;0.4;0.0
62;2021-01-15;1300;13;7133;60;0.5;0.0
62;2021-01-16;309;3;7442;63;0.5;0.0
62;2021-01-17;107;1;7549;64;0.5;0.0
62;2021-01-18;1667;10;9216;74;0.6;0.0
62;2021-01-19;2104;6;11320;80;0.8;0.0
62;2021-01-20;2056;7;13376;87;0.9;0.0
62;2021-01-21;2244;10;15620;97;1.1;0.0
62;2021-01-22;1835;7;17455;104;1.2;0.0
62;2021-01-23;512;1;17967;105;1.2;0.0
62;2021-01-24;0;0;17967;105;1.2;0.0
62;2021-01-25;1286;8;19253;113;1.3;0.0
62;2021-01-26;1546;21;20799;134;1.4;0.0
62;2021-01-27;1518;179;22317;313;1.5;0.0
62;2021-01-28;4182;403;26499;716;1.8;0.0
62;2021-01-29;2048;340;28547;1056;2.0;0.1
62;2021-01-30;159;151;28706;1207;2.0;0.1
62;2021-01-31;22;3;28728;1210;2.0;0.1
62;2021-02-01;46;355;28774;1565;2.0;0.1
62;2021-02-02;59;785;28833;2350;2.0;0.2
62;2021-02-03;44;627;28877;2977;2.0;0.2
62;2021-02-04;81;801;28958;3778;2.0;0.3
62;2021-02-05;81;749;29039;4527;2.0;0.3
62;2021-02-06;32;199;29071;4726;2.0;0.3
62;2021-02-07;236;31;29307;4757;2.0;0.3
62;2021-02-08;133;841;29440;5598;2.0;0.4
62;2021-02-09;227;1093;29667;6691;2.0;0.5
62;2021-02-10;385;1165;30052;7856;2.1;0.5
62;2021-02-11;726;996;30778;8852;2.1;0.6
62;2021-02-12;968;778;31746;9630;2.2;0.7
62;2021-02-13;162;266;31908;9896;2.2;0.7
62;2021-02-14;0;0;31908;9896;2.2;0.7
62;2021-02-15;665;1265;32573;11161;2.2;0.8
62;2021-02-16;923;1775;33496;12936;2.3;0.9
62;2021-02-17;1082;2069;34578;15005;2.4;1.0
62;2021-02-18;2228;3771;36806;18776;2.5;1.3
62;2021-02-19;2312;2548;39118;21324;2.7;1.5
62;2021-02-20;616;480;39734;21804;2.7;1.5
62;2021-02-21;88;50;39822;21854;2.7;1.5
62;2021-02-22;849;963;40671;22817;2.8;1.6
62;2021-02-23;1419;1212;42090;24029;2.9;1.7
62;2021-02-24;1547;656;43637;24685;3.0;1.7
62;2021-02-25;3169;426;46806;25111;3.2;1.7
62;2021-02-26;2912;355;49718;25466;3.4;1.8
62;2021-02-27;1829;99;51547;25565;3.5;1.8
62;2021-02-28;52;42;51599;25607;3.6;1.8
62;2021-03-01;1322;125;52921;25732;3.6;1.8
62;2021-03-02;3155;189;56076;25921;3.9;1.8
62;2021-03-03;3273;141;59349;26062;4.1;1.8
62;2021-03-04;3810;229;63159;26291;4.3;1.8
62;2021-03-05;4647;250;67806;26541;4.7;1.8
62;2021-03-06;9620;292;77426;26833;5.3;1.8
62;2021-03-07;8074;247;85500;27080;5.9;1.9
62;2021-03-08;2195;272;87695;27352;6.0;1.9
62;2021-03-09;3810;398;91505;27750;6.3;1.9
62;2021-03-10;4233;630;95738;28380;6.6;2.0
62;2021-03-11;5993;1551;101731;29931;7.0;2.1
62;2021-03-12;6638;1444;108369;31375;7.5;2.2
62;2021-03-13;14724;834;123093;32209;8.5;2.2
62;2021-03-14;9583;444;132676;32653;9.1;2.2
62;2021-03-15;3761;1026;136437;33679;9.4;2.3
62;2021-03-16;2736;864;139173;34543;9.6;2.4
62;2021-03-17;2805;744;141978;35287;9.8;2.4
62;2021-03-18;2726;956;144704;36243;10.0;2.5
62;2021-03-19;4784;941;149488;37184;10.3;2.6
62;2021-03-20;11066;635;160554;37819;11.1;2.6
62;2021-03-21;9447;384;170001;38203;11.7;2.6
62;2021-03-22;2944;1120;172945;39323;11.9;2.7
62;2021-03-23;4997;1504;177942;40827;12.2;2.8
62;2021-03-24;4696;1392;182638;42219;12.6;2.9
62;2021-03-25;6553;1494;189191;43713;13.0;3.0
62;2021-03-26;7048;1517;196239;45230;13.5;3.1
62;2021-03-27;12593;768;208832;45998;14.4;3.2
62;2021-03-28;6941;291;215773;46289;14.9;3.2
62;2021-03-29;3470;1218;219243;47507;15.1;3.3
62;2021-03-30;4549;2223;223792;49730;15.4;3.4
62;2021-03-31;4225;2489;228017;52219;15.7;3.6
62;2021-04-01;4977;2775;232994;54994;16.0;3.8
62;2021-04-02;5067;3244;238061;58238;16.4;4.0
62;2021-04-03;8207;3373;246268;61611;17.0;4.2
62;2021-04-04;4582;1946;250850;63557;17.3;4.4
62;2021-04-05;944;468;251794;64025;17.3;4.4
62;2021-04-06;4121;3022;255915;67047;17.6;4.6
62;2021-04-07;5071;3539;260986;70586;18.0;4.9
62;2021-04-08;6492;4017;267478;74603;18.4;5.1
62;2021-04-09;7628;3496;275106;78099;18.9;5.4
62;2021-04-10;6637;8091;281743;86190;19.4;5.9
62;2021-04-11;2804;6905;284547;93095;19.6;6.4
62;2021-04-12;3419;2389;287966;95484;19.8;6.6
62;2021-04-13;6171;3174;294137;98658;20.2;6.8
62;2021-04-14;5306;3073;299443;101731;20.6;7.0
62;2021-04-15;5733;3019;305176;104750;21.0;7.2
62;2021-04-16;5418;3215;310594;107965;21.4;7.4
62;2021-04-17;4355;7378;314949;115343;21.7;7.9
62;2021-04-18;1957;6859;316906;122202;21.8;8.4
62;2021-04-19;2777;1939;319683;124141;22.0;8.5
62;2021-04-20;4148;3900;323831;128041;22.3;8.8
62;2021-04-21;3746;3989;327577;132030;22.5;9.1
62;2021-04-22;3948;5194;331525;137224;22.8;9.4
62;2021-04-23;4064;5333;335589;142557;23.1;9.8
62;2021-04-24;4401;6738;339990;149295;23.4;10.3
62;2021-04-25;1911;3505;341901;152800;23.5;10.5
62;2021-04-26;2224;2436;344125;155236;23.7;10.7
62;2021-04-27;4408;3774;348533;159010;24.0;10.9
62;2021-04-28;4591;4422;353124;163432;24.3;11.2
62;2021-04-29;4787;5909;357911;169341;24.6;11.7
62;2021-04-30;5215;5741;363126;175082;25.0;12.1
62;2021-05-01;5725;3482;368851;178564;25.4;12.3
62;2021-05-02;7826;3163;376677;181727;25.9;12.5
62;2021-05-03;4510;2352;381187;184079;26.2;12.7
62;2021-05-04;5398;4992;386585;189071;26.6;13.0
62;2021-05-05;4736;4843;391321;193914;26.9;13.3
62;2021-05-06;5619;4955;396940;198869;27.3;13.7
62;2021-05-07;7691;4691;404631;203560;27.9;14.0
62;2021-05-08;10659;2352;415290;205912;28.6;14.2
62;2021-05-09;8625;1642;423915;207554;29.2;14.3
62;2021-05-10;4867;4032;428782;211586;29.5;14.6
62;2021-05-11;6414;5060;435196;216646;30.0;14.9
62;2021-05-12;8624;4609;443820;221255;30.5;15.2
62;2021-05-13;9999;1492;453819;222747;31.2;15.3
62;2021-05-14;11880;3415;465699;226162;32.1;15.6
62;2021-05-15;19780;3303;485479;229465;33.4;15.8
62;2021-05-16;16399;1423;501878;230888;34.5;15.9
62;2021-05-17;8180;2660;510058;233548;35.1;16.1
62;2021-05-18;9325;3133;519383;236681;35.8;16.3
62;2021-05-19;8615;2934;527998;239615;36.3;16.5
62;2021-05-20;8341;3843;536339;243458;36.9;16.8
62;2021-05-21;9397;4223;545736;247681;37.6;17.0
62;2021-05-22;17874;3538;563610;251219;38.8;17.3
62;2021-05-23;12373;1164;575983;252383;39.6;17.4
62;2021-05-24;3911;587;579894;252970;39.9;17.4
62;2021-05-25;7221;4098;587115;257068;40.4;17.7
62;2021-05-26;6782;4913;593897;261981;40.9;18.0
62;2021-05-27;6382;5694;600279;267675;41.3;18.4
62;2021-05-28;6518;6772;606797;274447;41.8;18.9
62;2021-05-29;10849;5547;617646;279994;42.5;19.3
62;2021-05-30;4036;985;621682;280979;42.8;19.3
62;2021-05-31;4794;3971;626476;284950;43.1;19.6
62;2021-06-01;6520;6534;632996;291484;43.6;20.1
62;2021-06-02;7444;5820;640440;297304;44.1;20.5
62;2021-06-03;7854;5898;648294;303202;44.6;20.9
62;2021-06-04;7903;6264;656197;309466;45.2;21.3
62;2021-06-05;8274;6238;664471;315704;45.7;21.7
62;2021-06-06;3128;1292;667599;316996;46.0;21.8
62;2021-06-07;4625;3772;672224;320768;46.3;22.1
62;2021-06-08;6207;5911;678431;326679;46.7;22.5
62;2021-06-09;5498;4768;683929;331447;47.1;22.8
62;2021-06-10;5207;5889;689136;337336;47.4;23.2
62;2021-06-11;6208;8876;695344;346212;47.9;23.8
62;2021-06-12;5935;8647;701279;354859;48.3;24.4
62;2021-06-13;3225;3803;704504;358662;48.5;24.7
62;2021-06-14;2610;6781;707114;365443;48.7;25.2
62;2021-06-15;4675;8540;711789;373983;49.0;25.7
62;2021-06-16;5082;7431;716871;381414;49.3;26.3
62;2021-06-17;5235;8045;722106;389459;49.7;26.8
62;2021-06-18;4825;10494;726931;399953;50.0;27.5
62;2021-06-19;5793;13442;732724;413395;50.4;28.5
62;2021-06-20;2101;4369;734825;417764;50.6;28.8
62;2021-06-21;2976;8928;737801;426692;50.8;29.4
62;2021-06-22;3431;10170;741232;436862;51.0;30.1
62;2021-06-23;3388;10324;744620;447186;51.3;30.8
62;2021-06-24;3346;11786;747966;458972;51.5;31.6
62;2021-06-25;3724;15768;751690;474740;51.7;32.7
62;2021-06-26;3549;18426;755239;493166;52.0;33.9
62;2021-06-27;1121;9814;756360;502980;52.1;34.6
62;2021-06-28;1923;8870;758283;511850;52.2;35.2
62;2021-06-29;2974;11463;761257;523313;52.4;36.0
62;2021-06-30;4142;10816;765399;534129;52.7;36.8
62;2021-07-01;4483;10486;769882;544615;53.0;37.5
62;2021-07-02;4161;11984;774043;556599;53.3;38.3
62;2021-07-03;2996;18053;777039;574652;53.5;39.6
62;2021-07-04;1451;9196;778490;583848;53.6;40.2
62;2021-07-05;2416;6917;780906;590765;53.8;40.7
62;2021-07-06;3821;10016;784727;600781;54.0;41.4
62;2021-07-07;3917;8918;788644;609699;54.3;42.0
62;2021-07-08;5247;9089;793891;618788;54.6;42.6
62;2021-07-09;4472;10849;798363;629637;55.0;43.3
62;2021-07-10;4975;11891;803338;641528;55.3;44.2
62;2021-07-11;1337;2091;804675;643619;55.4;44.3
62;2021-07-12;2327;7135;807002;650754;55.5;44.8
62;2021-07-13;5175;12161;812177;662915;55.9;45.6
62;2021-07-14;3634;3164;815811;666079;56.2;45.8
62;2021-07-15;7587;11501;823398;677580;56.7;46.6
62;2021-07-16;7625;11046;831023;688626;57.2;47.4
62;2021-07-17;9719;10335;840742;698961;57.9;48.1
62;2021-07-18;2712;3458;843454;702419;58.1;48.4
62;2021-07-19;6013;7025;849467;709444;58.5;48.8
62;2021-07-20;7935;10725;857402;720169;59.0;49.6
62;2021-07-21;9776;9413;867178;729582;59.7;50.2
62;2021-07-22;9800;9025;876978;738607;60.4;50.8
62;2021-07-23;10630;8412;887608;747019;61.1;51.4
62;2021-07-24;9664;10321;897272;757340;61.8;52.1
62;2021-07-25;5549;1877;902821;759217;62.1;52.3
62;2021-07-26;6239;5390;909060;764607;62.6;52.6
62;2021-07-27;9851;8129;918911;772736;63.3;53.2
62;2021-07-28;10405;7489;929316;780225;64.0;53.7
62;2021-07-29;12006;7662;941322;787887;64.8;54.2
62;2021-07-30;9092;6295;950414;794182;65.4;54.7
62;2021-07-31;6639;4026;957053;798208;65.9;54.9
62;2021-08-01;2342;1103;959395;799311;66.0;55.0
62;2021-08-02;6866;4760;966261;804071;66.5;55.3
62;2021-08-03;8629;7476;974890;811547;67.1;55.9
62;2021-08-04;9491;5484;984381;817031;67.8;56.2
62;2021-08-05;8376;5635;992757;822666;68.3;56.6
62;2021-08-06;7322;5935;1000079;828601;68.8;57.0
62;2021-08-07;5493;4960;1005572;833561;69.2;57.4
62;2021-08-08;1877;1301;1007449;834862;69.3;57.5
62;2021-08-09;5262;5033;1012711;839895;69.7;57.8
62;2021-08-10;6222;7360;1018933;847255;70.1;58.3
62;2021-08-11;5415;7383;1024348;854638;70.5;58.8
62;2021-08-12;6009;7004;1030357;861642;70.9;59.3
62;2021-08-13;4522;6061;1034879;867703;71.2;59.7
62;2021-08-14;3838;6868;1038717;874571;71.5;60.2
62;2021-08-15;1141;1212;1039858;875783;71.6;60.3
62;2021-08-16;3188;5866;1043046;881649;71.8;60.7
62;2021-08-17;4172;7348;1047218;888997;72.1;61.2
62;2021-08-18;4362;7244;1051580;896241;72.4;61.7
62;2021-08-19;4392;8581;1055972;904822;72.7;62.3
62;2021-08-20;3447;8464;1059419;913286;72.9;62.9
62;2021-08-21;2459;9766;1061878;923052;73.1;63.5
62;2021-08-22;392;2817;1062270;925869;73.1;63.7
62;2021-08-23;2748;7830;1065018;933699;73.3;64.3
62;2021-08-24;3840;10409;1068858;944108;73.6;65.0
62;2021-08-25;3509;9196;1072367;953304;73.8;65.6
62;2021-08-26;3193;9774;1075560;963078;74.0;66.3
62;2021-08-27;2599;8826;1078159;971904;74.2;66.9
62;2021-08-28;2043;7997;1080202;979901;74.4;67.5
62;2021-08-29;864;2253;1081066;982154;74.4;67.6
62;2021-08-30;2049;7289;1083115;989443;74.6;68.1
62;2021-08-31;2142;7829;1085257;997272;74.7;68.6
62;2021-09-01;1825;5812;1087082;1003084;74.8;69.0
62;2021-09-02;1853;6449;1088935;1009533;75.0;69.5
62;2021-09-03;2071;6898;1091006;1016431;75.1;70.0
62;2021-09-04;2123;6276;1093129;1022707;75.2;70.4
62;2021-09-05;319;1198;1093448;1023905;75.3;70.5
62;2021-09-06;1032;3360;1094480;1027265;75.3;70.7
62;2021-09-07;1236;3858;1095716;1031123;75.4;71.0
62;2021-09-08;1288;4172;1097004;1035295;75.5;71.3
62;2021-09-09;1274;4261;1098278;1039556;75.6;71.6
62;2021-09-10;1592;4402;1099870;1043958;75.7;71.9
62;2021-09-11;1275;3952;1101145;1047910;75.8;72.1
62;2021-09-12;201;495;1101346;1048405;75.8;72.2
62;2021-09-13;776;2235;1102122;1050640;75.9;72.3
62;2021-09-14;1280;3381;1103402;1054021;76.0;72.6
62;2021-09-15;1343;4221;1104745;1058242;76.0;72.8
62;2021-09-16;1382;2919;1106127;1061161;76.1;73.0
62;2021-09-17;1335;2418;1107462;1063579;76.2;73.2
62;2021-09-18;1089;2882;1108551;1066461;76.3;73.4
62;2021-09-19;138;448;1108689;1066909;76.3;73.4
62;2021-09-20;600;1481;1109289;1068390;76.4;73.5
62;2021-09-21;886;2423;1110175;1070813;76.4;73.7
62;2021-09-22;789;2673;1110964;1073486;76.5;73.9
62;2021-09-23;729;1838;1111693;1075324;76.5;74.0
62;2021-09-24;812;1985;1112505;1077309;76.6;74.2
62;2021-09-25;717;2669;1113222;1079978;76.6;74.3
62;2021-09-26;73;373;1113295;1080351;76.6;74.4
62;2021-09-27;318;1055;1113613;1081406;76.7;74.4
62;2021-09-28;585;1704;1114198;1083110;76.7;74.6
62;2021-09-29;759;1902;1114957;1085012;76.7;74.7
62;2021-09-30;448;1006;1115405;1086018;76.8;74.8
62;2021-10-01;698;1660;1116103;1087678;76.8;74.9
62;2021-10-02;699;1497;1116802;1089175;76.9;75.0
62;2021-10-03;81;236;1116883;1089411;76.9;75.0
62;2021-10-04;373;790;1117256;1090201;76.9;75.0
62;2021-10-05;602;1453;1117858;1091654;76.9;75.1
62;2021-10-06;563;1244;1118421;1092898;77.0;75.2
62;2021-10-07;478;1258;1118899;1094156;77.0;75.3
62;2021-10-08;745;1589;1119644;1095745;77.1;75.4
62;2021-10-09;619;1388;1120263;1097133;77.1;75.5
62;2021-10-10;58;198;1120321;1097331;77.1;75.5
62;2021-10-11;328;652;1120649;1097983;77.1;75.6
63;2020-12-27;0;0;0;0;0.0;0.0
63;2020-12-28;1;0;1;0;0.0;0.0
63;2020-12-29;0;0;1;0;0.0;0.0
63;2020-12-30;0;0;1;0;0.0;0.0
63;2020-12-31;0;0;1;0;0.0;0.0
63;2021-01-01;1;0;2;0;0.0;0.0
63;2021-01-02;0;0;2;0;0.0;0.0
63;2021-01-03;1;0;3;0;0.0;0.0
63;2021-01-04;0;0;3;0;0.0;0.0
63;2021-01-05;1;0;4;0;0.0;0.0
63;2021-01-06;4;1;8;1;0.0;0.0
63;2021-01-07;310;1;318;2;0.0;0.0
63;2021-01-08;217;6;535;8;0.1;0.0
63;2021-01-09;91;0;626;8;0.1;0.0
63;2021-01-10;82;0;708;8;0.1;0.0
63;2021-01-11;432;4;1140;12;0.2;0.0
63;2021-01-12;661;1;1801;13;0.3;0.0
63;2021-01-13;873;8;2674;21;0.4;0.0
63;2021-01-14;547;10;3221;31;0.5;0.0
63;2021-01-15;432;5;3653;36;0.6;0.0
63;2021-01-16;157;0;3810;36;0.6;0.0
63;2021-01-17;133;0;3943;36;0.6;0.0
63;2021-01-18;634;3;4577;39;0.7;0.0
63;2021-01-19;868;2;5445;41;0.8;0.0
63;2021-01-20;1069;12;6514;53;1.0;0.0
63;2021-01-21;1018;3;7532;56;1.1;0.0
63;2021-01-22;970;3;8502;59;1.3;0.0
63;2021-01-23;192;0;8694;59;1.3;0.0
63;2021-01-24;165;2;8859;61;1.3;0.0
63;2021-01-25;829;4;9688;65;1.5;0.0
63;2021-01-26;974;2;10662;67;1.6;0.0
63;2021-01-27;1003;5;11665;72;1.8;0.0
63;2021-01-28;1323;69;12988;141;2.0;0.0
63;2021-01-29;1066;66;14054;207;2.1;0.0
63;2021-01-30;68;0;14122;207;2.1;0.0
63;2021-01-31;6;0;14128;207;2.1;0.0
63;2021-02-01;575;180;14703;387;2.2;0.1
63;2021-02-02;886;235;15589;622;2.4;0.1
63;2021-02-03;1475;287;17064;909;2.6;0.1
63;2021-02-04;2120;521;19184;1430;2.9;0.2
63;2021-02-05;1144;272;20328;1702;3.1;0.3
63;2021-02-06;116;0;20444;1702;3.1;0.3
63;2021-02-07;9;1;20453;1703;3.1;0.3
63;2021-02-08;538;405;20991;2108;3.2;0.3
63;2021-02-09;671;433;21662;2541;3.3;0.4
63;2021-02-10;609;602;22271;3143;3.4;0.5
63;2021-02-11;751;473;23022;3616;3.5;0.5
63;2021-02-12;820;808;23842;4424;3.6;0.7
63;2021-02-13;82;1;23924;4425;3.6;0.7
63;2021-02-14;0;65;23924;4490;3.6;0.7
63;2021-02-15;202;782;24126;5272;3.7;0.8
63;2021-02-16;409;1136;24535;6408;3.7;1.0
63;2021-02-17;359;876;24894;7284;3.8;1.1
63;2021-02-18;608;824;25502;8108;3.9;1.2
63;2021-02-19;449;970;25951;9078;3.9;1.4
63;2021-02-20;35;32;25986;9110;3.9;1.4
63;2021-02-21;2;17;25988;9127;3.9;1.4
63;2021-02-22;292;928;26280;10055;4.0;1.5
63;2021-02-23;580;1134;26860;11189;4.1;1.7
63;2021-02-24;696;1415;27556;12604;4.2;1.9
63;2021-02-25;1603;1665;29159;14269;4.4;2.2
63;2021-02-26;1623;1365;30782;15634;4.7;2.4
63;2021-02-27;641;72;31423;15706;4.8;2.4
63;2021-02-28;4;178;31427;15884;4.8;2.4
63;2021-03-01;586;518;32013;16402;4.8;2.5
63;2021-03-02;907;803;32920;17205;5.0;2.6
63;2021-03-03;1036;727;33956;17932;5.1;2.7
63;2021-03-04;1754;502;35710;18434;5.4;2.8
63;2021-03-05;2612;700;38322;19134;5.8;2.9
63;2021-03-06;1551;55;39873;19189;6.0;2.9
63;2021-03-07;512;21;40385;19210;6.1;2.9
63;2021-03-08;967;648;41352;19858;6.3;3.0
63;2021-03-09;1539;1065;42891;20923;6.5;3.2
63;2021-03-10;1655;618;44546;21541;6.7;3.3
63;2021-03-11;3056;898;47602;22439;7.2;3.4
63;2021-03-12;3513;396;51115;22835;7.7;3.5
63;2021-03-13;2049;86;53164;22921;8.1;3.5
63;2021-03-14;61;22;53225;22943;8.1;3.5
63;2021-03-15;1771;374;54996;23317;8.3;3.5
63;2021-03-16;1747;416;56743;23733;8.6;3.6
63;2021-03-17;1642;692;58385;24425;8.8;3.7
63;2021-03-18;1945;753;60330;25178;9.1;3.8
63;2021-03-19;2741;498;63071;25676;9.6;3.9
63;2021-03-20;1122;72;64193;25748;9.7;3.9
63;2021-03-21;50;45;64243;25793;9.7;3.9
63;2021-03-22;1984;261;66227;26054;10.0;3.9
63;2021-03-23;2885;348;69112;26402;10.5;4.0
63;2021-03-24;3224;352;72336;26754;11.0;4.1
63;2021-03-25;4597;398;76933;27152;11.7;4.1
63;2021-03-26;4692;577;81625;27729;12.4;4.2
63;2021-03-27;2457;234;84082;27963;12.7;4.2
63;2021-03-28;1047;83;85129;28046;12.9;4.2
63;2021-03-29;2480;525;87609;28571;13.3;4.3
63;2021-03-30;3283;632;90892;29203;13.8;4.4
63;2021-03-31;2968;761;93860;29964;14.2;4.5
63;2021-04-01;3845;543;97705;30507;14.8;4.6
63;2021-04-02;3484;712;101189;31219;15.3;4.7
63;2021-04-03;1174;181;102363;31400;15.5;4.8
63;2021-04-04;877;29;103240;31429;15.6;4.8
63;2021-04-05;801;86;104041;31515;15.8;4.8
63;2021-04-06;2482;943;106523;32458;16.1;4.9
63;2021-04-07;3208;875;109731;33333;16.6;5.0
63;2021-04-08;4720;1230;114451;34563;17.3;5.2
63;2021-04-09;5314;1012;119765;35575;18.1;5.4
63;2021-04-10;2221;481;121986;36056;18.5;5.5
63;2021-04-11;835;41;122821;36097;18.6;5.5
63;2021-04-12;1592;1315;124413;37412;18.8;5.7
63;2021-04-13;1986;1968;126399;39380;19.1;6.0
63;2021-04-14;2631;1440;129030;40820;19.5;6.2
63;2021-04-15;3809;1548;132839;42368;20.1;6.4
63;2021-04-16;2840;2167;135679;44535;20.5;6.7
63;2021-04-17;1233;673;136912;45208;20.7;6.8
63;2021-04-18;803;67;137715;45275;20.9;6.9
63;2021-04-19;1657;2107;139372;47382;21.1;7.2
63;2021-04-20;1702;2302;141074;49684;21.4;7.5
63;2021-04-21;1514;2414;142588;52098;21.6;7.9
63;2021-04-22;1916;2269;144504;54367;21.9;8.2
63;2021-04-23;2019;3115;146523;57482;22.2;8.7
63;2021-04-24;1192;1128;147715;58610;22.4;8.9
63;2021-04-25;554;412;148269;59022;22.5;8.9
63;2021-04-26;1438;2242;149707;61264;22.7;9.3
63;2021-04-27;2326;2616;152033;63880;23.0;9.7
63;2021-04-28;2346;3172;154379;67052;23.4;10.2
63;2021-04-29;2882;2841;157261;69893;23.8;10.6
63;2021-04-30;2862;2823;160123;72716;24.3;11.0
63;2021-05-01;1127;1052;161250;73768;24.4;11.2
63;2021-05-02;897;640;162147;74408;24.6;11.3
63;2021-05-03;2685;2252;164832;76660;25.0;11.6
63;2021-05-04;2878;2699;167710;79359;25.4;12.0
63;2021-05-05;2938;3126;170648;82485;25.8;12.5
63;2021-05-06;3673;3060;174321;85545;26.4;13.0
63;2021-05-07;4032;3546;178353;89091;27.0;13.5
63;2021-05-08;2002;655;180355;89746;27.3;13.6
63;2021-05-09;1802;608;182157;90354;27.6;13.7
63;2021-05-10;4195;2765;186352;93119;28.2;14.1
63;2021-05-11;5339;2769;191691;95888;29.0;14.5
63;2021-05-12;5274;2913;196965;98801;29.8;15.0
63;2021-05-13;4136;700;201101;99501;30.5;15.1
63;2021-05-14;4772;1514;205873;101015;31.2;15.3
63;2021-05-15;3727;986;209600;102001;31.7;15.4
63;2021-05-16;3521;448;213121;102449;32.3;15.5
63;2021-05-17;3902;1992;217023;104441;32.9;15.8
63;2021-05-18;5124;1615;222147;106056;33.6;16.1
63;2021-05-19;5228;1629;227375;107685;34.4;16.3
63;2021-05-20;6806;2092;234181;109777;35.5;16.6
63;2021-05-21;6256;2334;240437;112111;36.4;17.0
63;2021-05-22;3352;848;243789;112959;36.9;17.1
63;2021-05-23;2388;245;246177;113204;37.3;17.1
63;2021-05-24;2643;581;248820;113785;37.7;17.2
63;2021-05-25;4270;2646;253090;116431;38.3;17.6
63;2021-05-26;5452;2422;258542;118853;39.2;18.0
63;2021-05-27;6502;2801;265044;121654;40.1;18.4
63;2021-05-28;5422;3906;270466;125560;41.0;19.0
63;2021-05-29;3361;1503;273827;127063;41.5;19.2
63;2021-05-30;1579;217;275406;127280;41.7;19.3
63;2021-05-31;4157;2288;279563;129568;42.3;19.6
63;2021-06-01;3805;2962;283368;132530;42.9;20.1
63;2021-06-02;3886;2535;287254;135065;43.5;20.5
63;2021-06-03;4902;3142;292156;138207;44.2;20.9
63;2021-06-04;5100;3624;297256;141831;45.0;21.5
63;2021-06-05;2816;1746;300072;143577;45.4;21.7
63;2021-06-06;1309;698;301381;144275;45.6;21.9
63;2021-06-07;3163;2519;304544;146794;46.1;22.2
63;2021-06-08;2882;2755;307426;149549;46.6;22.7
63;2021-06-09;3025;2271;310451;151820;47.0;23.0
63;2021-06-10;3226;2691;313677;154511;47.5;23.4
63;2021-06-11;3099;4047;316776;158558;48.0;24.0
63;2021-06-12;1640;1969;318416;160527;48.2;24.3
63;2021-06-13;482;1098;318898;161625;48.3;24.5
63;2021-06-14;1824;3472;320722;165097;48.6;25.0
63;2021-06-15;2210;3480;322932;168577;48.9;25.5
63;2021-06-16;2576;3315;325508;171892;49.3;26.0
63;2021-06-17;2398;4316;327906;176208;49.7;26.7
63;2021-06-18;2480;5828;330386;182036;50.0;27.6
63;2021-06-19;1643;2835;332029;184871;50.3;28.0
63;2021-06-20;678;2441;332707;187312;50.4;28.4
63;2021-06-21;1272;5389;333979;192701;50.6;29.2
63;2021-06-22;1233;5539;335212;198240;50.8;30.0
63;2021-06-23;1531;4766;336743;203006;51.0;30.7
63;2021-06-24;1925;5383;338668;208389;51.3;31.6
63;2021-06-25;1751;5899;340419;214288;51.6;32.5
63;2021-06-26;1073;3352;341492;217640;51.7;33.0
63;2021-06-27;712;3487;342204;221127;51.8;33.5
63;2021-06-28;1136;5663;343340;226790;52.0;34.3
63;2021-06-29;1226;5159;344566;231949;52.2;35.1
63;2021-06-30;1606;5294;346172;237243;52.4;35.9
63;2021-07-01;1927;8069;348099;245312;52.7;37.2
63;2021-07-02;2061;6540;350160;251852;53.0;38.1
63;2021-07-03;965;2929;351125;254781;53.2;38.6
63;2021-07-04;1066;1885;352191;256666;53.3;38.9
63;2021-07-05;1540;6280;353731;262946;53.6;39.8
63;2021-07-06;1607;4808;355338;267754;53.8;40.6
63;2021-07-07;1973;4089;357311;271843;54.1;41.2
63;2021-07-08;2205;4587;359516;276430;54.5;41.9
63;2021-07-09;1911;5720;361427;282150;54.7;42.7
63;2021-07-10;1534;3415;362961;285565;55.0;43.3
63;2021-07-11;910;1538;363871;287103;55.1;43.5
63;2021-07-12;1597;8702;365468;295805;55.4;44.8
63;2021-07-13;3598;6134;369066;301939;55.9;45.7
63;2021-07-14;3618;1790;372684;303729;56.4;46.0
63;2021-07-15;4415;5036;377099;308765;57.1;46.8
63;2021-07-16;4693;5788;381792;314553;57.8;47.6
63;2021-07-17;3012;2473;384804;317026;58.3;48.0
63;2021-07-18;2825;1091;387629;318117;58.7;48.2
63;2021-07-19;4002;4848;391631;322965;59.3;48.9
63;2021-07-20;4737;5460;396368;328425;60.0;49.7
63;2021-07-21;4789;3978;401157;332403;60.8;50.3
63;2021-07-22;5509;4402;406666;336805;61.6;51.0
63;2021-07-23;5161;4652;411827;341457;62.4;51.7
63;2021-07-24;3679;1952;415506;343409;62.9;52.0
63;2021-07-25;3065;1438;418571;344847;63.4;52.2
63;2021-07-26;4040;3230;422611;348077;64.0;52.7
63;2021-07-27;3933;3163;426544;351240;64.6;53.2
63;2021-07-28;3851;2716;430395;353956;65.2;53.6
63;2021-07-29;4453;3159;434848;357115;65.9;54.1
63;2021-07-30;3807;3575;438655;360690;66.4;54.6
63;2021-07-31;2161;1721;440816;362411;66.8;54.9
63;2021-08-01;1197;836;442013;363247;66.9;55.0
63;2021-08-02;2226;3067;444239;366314;67.3;55.5
63;2021-08-03;2728;3255;446967;369569;67.7;56.0
63;2021-08-04;2808;3245;449775;372814;68.1;56.5
63;2021-08-05;2444;3481;452219;376295;68.5;57.0
63;2021-08-06;2352;4152;454571;380447;68.8;57.6
63;2021-08-07;1305;2808;455876;383255;69.0;58.0
63;2021-08-08;324;1205;456200;384460;69.1;58.2
63;2021-08-09;1849;4210;458049;388670;69.4;58.9
63;2021-08-10;2218;3994;460267;392664;69.7;59.5
63;2021-08-11;2100;3628;462367;396292;70.0;60.0
63;2021-08-12;1855;4620;464222;400912;70.3;60.7
63;2021-08-13;1677;4009;465899;404921;70.6;61.3
63;2021-08-14;841;3239;466740;408160;70.7;61.8
63;2021-08-15;184;1451;466924;409611;70.7;62.0
63;2021-08-16;1171;4396;468095;414007;70.9;62.7
63;2021-08-17;1601;4052;469696;418059;71.1;63.3
63;2021-08-18;1452;3305;471148;421364;71.4;63.8
63;2021-08-19;1322;3443;472470;424807;71.6;64.3
63;2021-08-20;1386;3712;473856;428519;71.8;64.9
63;2021-08-21;674;2166;474530;430685;71.9;65.2
63;2021-08-22;212;1092;474742;431777;71.9;65.4
63;2021-08-23;1075;3591;475817;435368;72.1;65.9
63;2021-08-24;1090;2990;476907;438358;72.2;66.4
63;2021-08-25;1005;2786;477912;441144;72.4;66.8
63;2021-08-26;1130;2707;479042;443851;72.6;67.2
63;2021-08-27;1149;3161;480191;447012;72.7;67.7
63;2021-08-28;698;1709;480889;448721;72.8;68.0
63;2021-08-29;107;577;480996;449298;72.9;68.1
63;2021-08-30;789;2399;481785;451697;73.0;68.4
63;2021-08-31;992;2471;482777;454168;73.1;68.8
63;2021-09-01;919;1866;483696;456034;73.3;69.1
63;2021-09-02;820;1769;484516;457803;73.4;69.3
63;2021-09-03;905;2262;485421;460065;73.5;69.7
63;2021-09-04;709;1411;486130;461476;73.6;69.9
63;2021-09-05;80;258;486210;461734;73.6;69.9
63;2021-09-06;562;1144;486772;462878;73.7;70.1
63;2021-09-07;660;1343;487432;464221;73.8;70.3
63;2021-09-08;705;1456;488137;465677;73.9;70.5
63;2021-09-09;595;1163;488732;466840;74.0;70.7
63;2021-09-10;732;1645;489464;468485;74.1;71.0
63;2021-09-11;459;998;489923;469483;74.2;71.1
63;2021-09-12;50;144;489973;469627;74.2;71.1
63;2021-09-13;456;930;490429;470557;74.3;71.3
63;2021-09-14;530;814;490959;471371;74.4;71.4
63;2021-09-15;580;1288;491539;472659;74.4;71.6
63;2021-09-16;476;872;492015;473531;74.5;71.7
63;2021-09-17;474;1261;492489;474792;74.6;71.9
63;2021-09-18;317;992;492806;475784;74.6;72.1
63;2021-09-19;44;97;492850;475881;74.6;72.1
63;2021-09-20;365;707;493215;476588;74.7;72.2
63;2021-09-21;410;662;493625;477250;74.8;72.3
63;2021-09-22;400;1113;494025;478363;74.8;72.5
63;2021-09-23;299;665;494324;479028;74.9;72.6
63;2021-09-24;484;1181;494808;480209;74.9;72.7
63;2021-09-25;253;816;495061;481025;75.0;72.9
63;2021-09-26;26;100;495087;481125;75.0;72.9
63;2021-09-27;317;643;495404;481768;75.0;73.0
63;2021-09-28;292;617;495696;482385;75.1;73.1
63;2021-09-29;304;734;496000;483119;75.1;73.2
63;2021-09-30;295;657;496295;483776;75.2;73.3
63;2021-10-01;472;853;496767;484629;75.2;73.4
63;2021-10-02;273;558;497040;485187;75.3;73.5
63;2021-10-03;37;69;497077;485256;75.3;73.5
63;2021-10-04;208;401;497285;485657;75.3;73.6
63;2021-10-05;259;454;497544;486111;75.4;73.6
63;2021-10-06;331;602;497875;486713;75.4;73.7
63;2021-10-07;243;460;498118;487173;75.4;73.8
63;2021-10-08;408;711;498526;487884;75.5;73.9
63;2021-10-09;239;417;498765;488301;75.5;74.0
63;2021-10-10;36;57;498801;488358;75.5;74.0
63;2021-10-11;205;433;499006;488791;75.6;74.0
64;2020-12-27;1;0;1;0;0.0;0.0
64;2020-12-28;2;0;3;0;0.0;0.0
64;2020-12-29;0;0;3;0;0.0;0.0
64;2020-12-30;1;0;4;0;0.0;0.0
64;2020-12-31;0;0;4;0;0.0;0.0
64;2021-01-01;1;0;5;0;0.0;0.0
64;2021-01-02;0;0;5;0;0.0;0.0
64;2021-01-03;0;0;5;0;0.0;0.0
64;2021-01-04;29;0;34;0;0.0;0.0
64;2021-01-05;25;0;59;0;0.0;0.0
64;2021-01-06;189;0;248;0;0.0;0.0
64;2021-01-07;842;1;1090;1;0.2;0.0
64;2021-01-08;880;3;1970;4;0.3;0.0
64;2021-01-09;55;0;2025;4;0.3;0.0
64;2021-01-10;2;0;2027;4;0.3;0.0
64;2021-01-11;543;0;2570;4;0.4;0.0
64;2021-01-12;760;4;3330;8;0.5;0.0
64;2021-01-13;866;3;4196;11;0.6;0.0
64;2021-01-14;1046;6;5242;17;0.8;0.0
64;2021-01-15;929;5;6171;22;0.9;0.0
64;2021-01-16;70;0;6241;22;0.9;0.0
64;2021-01-17;8;2;6249;24;0.9;0.0
64;2021-01-18;942;8;7191;32;1.1;0.0
64;2021-01-19;1448;4;8639;36;1.3;0.0
64;2021-01-20;1618;3;10257;39;1.5;0.0
64;2021-01-21;2603;2;12860;41;1.9;0.0
64;2021-01-22;1651;4;14511;45;2.1;0.0
64;2021-01-23;525;1;15036;46;2.2;0.0
64;2021-01-24;89;0;15125;46;2.2;0.0
64;2021-01-25;974;9;16099;55;2.4;0.0
64;2021-01-26;1358;22;17457;77;2.6;0.0
64;2021-01-27;1241;119;18698;196;2.7;0.0
64;2021-01-28;1652;632;20350;828;3.0;0.1
64;2021-01-29;975;651;21325;1479;3.1;0.2
64;2021-01-30;469;59;21794;1538;3.2;0.2
64;2021-01-31;93;0;21887;1538;3.2;0.2
64;2021-02-01;675;311;22562;1849;3.3;0.3
64;2021-02-02;1134;554;23696;2403;3.5;0.4
64;2021-02-03;1044;646;24740;3049;3.6;0.4
64;2021-02-04;1028;535;25768;3584;3.8;0.5
64;2021-02-05;869;456;26637;4040;3.9;0.6
64;2021-02-06;501;32;27138;4072;4.0;0.6
64;2021-02-07;131;5;27269;4077;4.0;0.6
64;2021-02-08;769;311;28038;4388;4.1;0.6
64;2021-02-09;949;714;28987;5102;4.2;0.7
64;2021-02-10;916;790;29903;5892;4.4;0.9
64;2021-02-11;1199;1508;31102;7400;4.6;1.1
64;2021-02-12;1076;1064;32178;8464;4.7;1.2
64;2021-02-13;223;314;32401;8778;4.7;1.3
64;2021-02-14;38;48;32439;8826;4.7;1.3
64;2021-02-15;223;1132;32662;9958;4.8;1.5
64;2021-02-16;261;1405;32923;11363;4.8;1.7
64;2021-02-17;291;1244;33214;12607;4.9;1.8
64;2021-02-18;509;1714;33723;14321;4.9;2.1
64;2021-02-19;413;1287;34136;15608;5.0;2.3
64;2021-02-20;119;435;34255;16043;5.0;2.3
64;2021-02-21;20;83;34275;16126;5.0;2.4
64;2021-02-22;479;985;34754;17111;5.1;2.5
64;2021-02-23;722;1145;35476;18256;5.2;2.7
64;2021-02-24;731;1014;36207;19270;5.3;2.8
64;2021-02-25;1094;955;37301;20225;5.5;3.0
64;2021-02-26;1216;915;38517;21140;5.6;3.1
64;2021-02-27;864;405;39381;21545;5.8;3.2
64;2021-02-28;42;82;39423;21627;5.8;3.2
64;2021-03-01;767;799;40190;22426;5.9;3.3
64;2021-03-02;1077;918;41267;23344;6.0;3.4
64;2021-03-03;1252;1000;42519;24344;6.2;3.6
64;2021-03-04;1883;1184;44402;25528;6.5;3.7
64;2021-03-05;2199;1078;46601;26606;6.8;3.9
64;2021-03-06;1543;518;48144;27124;7.0;4.0
64;2021-03-07;595;113;48739;27237;7.1;4.0
64;2021-03-08;1534;765;50273;28002;7.4;4.1
64;2021-03-09;2070;849;52343;28851;7.7;4.2
64;2021-03-10;2083;765;54426;29616;8.0;4.3
64;2021-03-11;2976;1078;57402;30694;8.4;4.5
64;2021-03-12;3488;608;60890;31302;8.9;4.6
64;2021-03-13;2258;171;63148;31473;9.2;4.6
64;2021-03-14;233;15;63381;31488;9.3;4.6
64;2021-03-15;2337;234;65718;31722;9.6;4.6
64;2021-03-16;2002;269;67720;31991;9.9;4.7
64;2021-03-17;2071;241;69791;32232;10.2;4.7
64;2021-03-18;2463;209;72254;32441;10.6;4.7
64;2021-03-19;3014;288;75268;32729;11.0;4.8
64;2021-03-20;2470;95;77738;32824;11.4;4.8
64;2021-03-21;1282;27;79020;32851;11.6;4.8
64;2021-03-22;2588;557;81608;33408;11.9;4.9
64;2021-03-23;3197;650;84805;34058;12.4;5.0
64;2021-03-24;3564;708;88369;34766;12.9;5.1
64;2021-03-25;4350;806;92719;35572;13.6;5.2
64;2021-03-26;4429;711;97148;36283;14.2;5.3
64;2021-03-27;2974;437;100122;36720;14.7;5.4
64;2021-03-28;521;56;100643;36776;14.7;5.4
64;2021-03-29;3028;891;103671;37667;15.2;5.5
64;2021-03-30;4135;874;107806;38541;15.8;5.6
64;2021-03-31;3594;796;111400;39337;16.3;5.8
64;2021-04-01;4787;944;116187;40281;17.0;5.9
64;2021-04-02;4444;746;120631;41027;17.7;6.0
64;2021-04-03;2061;588;122692;41615;18.0;6.1
64;2021-04-04;309;50;123001;41665;18.0;6.1
64;2021-04-05;1689;144;124690;41809;18.3;6.1
64;2021-04-06;3647;1396;128337;43205;18.8;6.3
64;2021-04-07;3947;1517;132284;44722;19.4;6.5
64;2021-04-08;5192;1602;137476;46324;20.1;6.8
64;2021-04-09;5899;1647;143375;47971;21.0;7.0
64;2021-04-10;3222;1055;146597;49026;21.5;7.2
64;2021-04-11;448;253;147045;49279;21.5;7.2
64;2021-04-12;4047;1869;151092;51148;22.1;7.5
64;2021-04-13;4466;2170;155558;53318;22.8;7.8
64;2021-04-14;4090;2144;159648;55462;23.4;8.1
64;2021-04-15;4394;2299;164042;57761;24.0;8.5
64;2021-04-16;4300;2261;168342;60022;24.6;8.8
64;2021-04-17;2479;1504;170821;61526;25.0;9.0
64;2021-04-18;1096;1181;171917;62707;25.2;9.2
64;2021-04-19;2735;2450;174652;65157;25.6;9.5
64;2021-04-20;3208;2434;177860;67591;26.0;9.9
64;2021-04-21;3225;2567;181085;70158;26.5;10.3
64;2021-04-22;3389;2787;184474;72945;27.0;10.7
64;2021-04-23;3435;2617;187909;75562;27.5;11.1
64;2021-04-24;2068;1591;189977;77153;27.8;11.3
64;2021-04-25;290;237;190267;77390;27.9;11.3
64;2021-04-26;2661;2656;192928;80046;28.2;11.7
64;2021-04-27;3060;3137;195988;83183;28.7;12.2
64;2021-04-28;3604;3065;199592;86248;29.2;12.6
64;2021-04-29;4650;3465;204242;89713;29.9;13.1
64;2021-04-30;4085;3616;208327;93329;30.5;13.7
64;2021-05-01;1486;1032;209813;94361;30.7;13.8
64;2021-05-02;446;325;210259;94686;30.8;13.9
64;2021-05-03;2910;3527;213169;98213;31.2;14.4
64;2021-05-04;3646;4002;216815;102215;31.7;15.0
64;2021-05-05;3358;4012;220173;106227;32.2;15.5
64;2021-05-06;4110;3992;224283;110219;32.8;16.1
64;2021-05-07;3922;4196;228205;114415;33.4;16.7
64;2021-05-08;2623;1236;230828;115651;33.8;16.9
64;2021-05-09;722;305;231550;115956;33.9;17.0
64;2021-05-10;2862;4238;234412;120194;34.3;17.6
64;2021-05-11;4183;4150;238595;124344;34.9;18.2
64;2021-05-12;4489;3945;243084;128289;35.6;18.8
64;2021-05-13;3198;887;246282;129176;36.0;18.9
64;2021-05-14;5153;3150;251435;132326;36.8;19.4
64;2021-05-15;3526;1865;254961;134191;37.3;19.6
64;2021-05-16;498;225;255459;134416;37.4;19.7
64;2021-05-17;4190;2390;259649;136806;38.0;20.0
64;2021-05-18;5163;2304;264812;139110;38.8;20.4
64;2021-05-19;4980;2165;269792;141275;39.5;20.7
64;2021-05-20;5567;2158;275359;143433;40.3;21.0
64;2021-05-21;5268;2249;280627;145682;41.1;21.3
64;2021-05-22;3581;1508;284208;147190;41.6;21.5
64;2021-05-23;431;206;284639;147396;41.7;21.6
64;2021-05-24;2996;1232;287635;148628;42.1;21.8
64;2021-05-25;4332;2851;291967;151479;42.7;22.2
64;2021-05-26;4359;2716;296326;154195;43.4;22.6
64;2021-05-27;5283;3156;301609;157351;44.1;23.0
64;2021-05-28;4620;3440;306229;160791;44.8;23.5
64;2021-05-29;2810;2114;309039;162905;45.2;23.8
64;2021-05-30;439;203;309478;163108;45.3;23.9
64;2021-05-31;3889;3662;313367;166770;45.9;24.4
64;2021-06-01;5335;3571;318702;170341;46.7;24.9
64;2021-06-02;4931;3176;323633;173517;47.4;25.4
64;2021-06-03;6365;3263;329998;176780;48.3;25.9
64;2021-06-04;5150;4558;335148;181338;49.1;26.5
64;2021-06-05;3482;2524;338630;183862;49.6;26.9
64;2021-06-06;2014;330;340644;184192;49.9;27.0
64;2021-06-07;4128;4333;344772;188525;50.5;27.6
64;2021-06-08;5151;4126;349923;192651;51.2;28.2
64;2021-06-09;5151;3660;355074;196311;52.0;28.7
64;2021-06-10;6181;3145;361255;199456;52.9;29.2
64;2021-06-11;5586;4879;366841;204335;53.7;29.9
64;2021-06-12;3949;2336;370790;206671;54.3;30.3
64;2021-06-13;1555;394;372345;207065;54.5;30.3
64;2021-06-14;3669;4794;376014;211859;55.0;31.0
64;2021-06-15;4572;4708;380586;216567;55.7;31.7
64;2021-06-16;4470;4664;385056;221231;56.4;32.4
64;2021-06-17;3641;4306;388697;225537;56.9;33.0
64;2021-06-18;4421;5170;393118;230707;57.5;33.8
64;2021-06-19;2984;3282;396102;233989;58.0;34.3
64;2021-06-20;881;539;396983;234528;58.1;34.3
64;2021-06-21;2314;5125;399297;239653;58.4;35.1
64;2021-06-22;2555;5726;401852;245379;58.8;35.9
64;2021-06-23;3104;5481;404956;250860;59.3;36.7
64;2021-06-24;2719;3810;407675;254670;59.7;37.3
64;2021-06-25;2900;6436;410575;261106;60.1;38.2
64;2021-06-26;1798;3835;412373;264941;60.4;38.8
64;2021-06-27;493;713;412866;265654;60.4;38.9
64;2021-06-28;1935;6070;414801;271724;60.7;39.8
64;2021-06-29;1967;6265;416768;277989;61.0;40.7
64;2021-06-30;2255;6000;419023;283989;61.3;41.6
64;2021-07-01;2406;5342;421429;289331;61.7;42.4
64;2021-07-02;2307;6406;423736;295737;62.0;43.3
64;2021-07-03;1263;3783;424999;299520;62.2;43.8
64;2021-07-04;411;847;425410;300367;62.3;44.0
64;2021-07-05;1376;5405;426786;305772;62.5;44.8
64;2021-07-06;1994;6151;428780;311923;62.8;45.7
64;2021-07-07;2063;5751;430843;317674;63.1;46.5
64;2021-07-08;1804;4397;432647;322071;63.3;47.1
64;2021-07-09;1825;6536;434472;328607;63.6;48.1
64;2021-07-10;1171;3880;435643;332487;63.8;48.7
64;2021-07-11;253;860;435896;333347;63.8;48.8
64;2021-07-12;1501;6086;437397;339433;64.0;49.7
64;2021-07-13;2366;7248;439763;346681;64.4;50.7
64;2021-07-14;2368;3407;442131;350088;64.7;51.2
64;2021-07-15;2105;5480;444236;355568;65.0;52.0
64;2021-07-16;2848;6777;447084;362345;65.4;53.0
64;2021-07-17;2338;4586;449422;366931;65.8;53.7
64;2021-07-18;716;2051;450138;368982;65.9;54.0
64;2021-07-19;2348;6122;452486;375104;66.2;54.9
64;2021-07-20;3130;6560;455616;381664;66.7;55.9
64;2021-07-21;3345;6046;458961;387710;67.2;56.8
64;2021-07-22;3808;5718;462769;393428;67.7;57.6
64;2021-07-23;3724;5620;466493;399048;68.3;58.4
64;2021-07-24;2553;4431;469046;403479;68.7;59.1
64;2021-07-25;754;1062;469800;404541;68.8;59.2
64;2021-07-26;3085;5131;472885;409672;69.2;60.0
64;2021-07-27;4260;5146;477145;414818;69.8;60.7
64;2021-07-28;4315;4599;481460;419417;70.5;61.4
64;2021-07-29;5518;3904;486978;423321;71.3;62.0
64;2021-07-30;5146;4234;492124;427555;72.0;62.6
64;2021-07-31;3171;3346;495295;430901;72.5;63.1
64;2021-08-01;1145;589;496440;431490;72.7;63.2
64;2021-08-02;4369;2631;500809;434121;73.3;63.5
64;2021-08-03;4556;3176;505365;437297;74.0;64.0
64;2021-08-04;4132;3000;509497;440297;74.6;64.4
64;2021-08-05;4037;2614;513534;442911;75.2;64.8
64;2021-08-06;3844;3338;517378;446249;75.7;65.3
64;2021-08-07;2481;2701;519859;448950;76.1;65.7
64;2021-08-08;492;609;520351;449559;76.2;65.8
64;2021-08-09;2739;3201;523090;452760;76.6;66.3
64;2021-08-10;3353;3436;526443;456196;77.1;66.8
64;2021-08-11;3068;3264;529511;459460;77.5;67.3
64;2021-08-12;3191;3307;532702;462767;78.0;67.7
64;2021-08-13;2575;3660;535277;466427;78.4;68.3
64;2021-08-14;1632;2683;536909;469110;78.6;68.7
64;2021-08-15;208;691;537117;469801;78.6;68.8
64;2021-08-16;2102;3236;539219;473037;78.9;69.2
64;2021-08-17;2299;3709;541518;476746;79.3;69.8
64;2021-08-18;2044;3520;543562;480266;79.6;70.3
64;2021-08-19;1938;3525;545500;483791;79.8;70.8
64;2021-08-20;1578;3975;547078;487766;80.1;71.4
64;2021-08-21;975;2882;548053;490648;80.2;71.8
64;2021-08-22;160;895;548213;491543;80.2;72.0
64;2021-08-23;1269;3238;549482;494781;80.4;72.4
64;2021-08-24;1378;4596;550860;499377;80.6;73.1
64;2021-08-25;1260;3747;552120;503124;80.8;73.6
64;2021-08-26;1111;3532;553231;506656;81.0;74.2
64;2021-08-27;1189;4230;554420;510886;81.2;74.8
64;2021-08-28;735;2496;555155;513382;81.3;75.1
64;2021-08-29;90;533;555245;513915;81.3;75.2
64;2021-08-30;989;3518;556234;517433;81.4;75.7
64;2021-08-31;990;3761;557224;521194;81.6;76.3
64;2021-09-01;930;2912;558154;524106;81.7;76.7
64;2021-09-02;899;2814;559053;526920;81.8;77.1
64;2021-09-03;874;2746;559927;529666;82.0;77.5
64;2021-09-04;698;2055;560625;531721;82.1;77.8
64;2021-09-05;74;206;560699;531927;82.1;77.9
64;2021-09-06;532;2130;561231;534057;82.2;78.2
64;2021-09-07;717;1937;561948;535994;82.3;78.5
64;2021-09-08;736;2539;562684;538533;82.4;78.8
64;2021-09-09;482;1720;563166;540253;82.4;79.1
64;2021-09-10;744;2056;563910;542309;82.5;79.4
64;2021-09-11;594;1973;564504;544282;82.6;79.7
64;2021-09-12;60;167;564564;544449;82.6;79.7
64;2021-09-13;441;1404;565005;545853;82.7;79.9
64;2021-09-14;490;1088;565495;546941;82.8;80.1
64;2021-09-15;689;1747;566184;548688;82.9;80.3
64;2021-09-16;486;844;566670;549532;82.9;80.4
64;2021-09-17;565;1353;567235;550885;83.0;80.6
64;2021-09-18;332;1258;567567;552143;83.1;80.8
64;2021-09-19;18;42;567585;552185;83.1;80.8
64;2021-09-20;248;481;567833;552666;83.1;80.9
64;2021-09-21;431;952;568264;553618;83.2;81.0
64;2021-09-22;380;1426;568644;555044;83.2;81.2
64;2021-09-23;278;730;568922;555774;83.3;81.4
64;2021-09-24;398;986;569320;556760;83.3;81.5
64;2021-09-25;298;1033;569618;557793;83.4;81.6
64;2021-09-26;0;4;569618;557797;83.4;81.6
64;2021-09-27;234;567;569852;558364;83.4;81.7
64;2021-09-28;260;671;570112;559035;83.5;81.8
64;2021-09-29;341;984;570453;560019;83.5;82.0
64;2021-09-30;257;441;570710;560460;83.5;82.0
64;2021-10-01;308;727;571018;561187;83.6;82.1
64;2021-10-02;214;566;571232;561753;83.6;82.2
64;2021-10-03;0;2;571232;561755;83.6;82.2
64;2021-10-04;238;425;571470;562180;83.6;82.3
64;2021-10-05;314;634;571784;562814;83.7;82.4
64;2021-10-06;406;910;572190;563724;83.8;82.5
64;2021-10-07;202;501;572392;564225;83.8;82.6
64;2021-10-08;315;704;572707;564929;83.8;82.7
64;2021-10-09;247;403;572954;565332;83.9;82.8
64;2021-10-10;0;8;572954;565340;83.9;82.8
64;2021-10-11;141;256;573095;565596;83.9;82.8
65;2020-12-27;0;0;0;0;0.0;0.0
65;2020-12-28;1;1;1;1;0.0;0.0
65;2020-12-29;0;0;1;1;0.0;0.0
65;2020-12-30;0;0;1;1;0.0;0.0
65;2020-12-31;0;0;1;1;0.0;0.0
65;2021-01-01;1;1;2;2;0.0;0.0
65;2021-01-02;0;0;2;2;0.0;0.0
65;2021-01-03;0;0;2;2;0.0;0.0
65;2021-01-04;0;0;2;2;0.0;0.0
65;2021-01-05;1;0;3;2;0.0;0.0
65;2021-01-06;3;0;6;2;0.0;0.0
65;2021-01-07;168;0;174;2;0.1;0.0
65;2021-01-08;253;1;427;3;0.2;0.0
65;2021-01-09;177;2;604;5;0.3;0.0
65;2021-01-10;1;0;605;5;0.3;0.0
65;2021-01-11;275;3;880;8;0.4;0.0
65;2021-01-12;271;1;1151;9;0.5;0.0
65;2021-01-13;587;1;1738;10;0.8;0.0
65;2021-01-14;581;9;2319;19;1.0;0.0
65;2021-01-15;527;2;2846;21;1.3;0.0
65;2021-01-16;221;2;3067;23;1.4;0.0
65;2021-01-17;0;0;3067;23;1.4;0.0
65;2021-01-18;554;5;3621;28;1.6;0.0
65;2021-01-19;571;2;4192;30;1.8;0.0
65;2021-01-20;585;6;4777;36;2.1;0.0
65;2021-01-21;585;0;5362;36;2.4;0.0
65;2021-01-22;598;2;5960;38;2.6;0.0
65;2021-01-23;174;1;6134;39;2.7;0.0
65;2021-01-24;3;1;6137;40;2.7;0.0
65;2021-01-25;551;4;6688;44;2.9;0.0
65;2021-01-26;883;2;7571;46;3.3;0.0
65;2021-01-27;592;14;8163;60;3.6;0.0
65;2021-01-28;509;71;8672;131;3.8;0.1
65;2021-01-29;426;138;9098;269;4.0;0.1
65;2021-01-30;182;74;9280;343;4.1;0.2
65;2021-01-31;15;0;9295;343;4.1;0.2
65;2021-02-01;351;120;9646;463;4.3;0.2
65;2021-02-02;432;194;10078;657;4.4;0.3
65;2021-02-03;463;245;10541;902;4.6;0.4
65;2021-02-04;310;332;10851;1234;4.8;0.5
65;2021-02-05;284;362;11135;1596;4.9;0.7
65;2021-02-06;99;99;11234;1695;5.0;0.7
65;2021-02-07;10;0;11244;1695;5.0;0.7
65;2021-02-08;426;221;11670;1916;5.1;0.8
65;2021-02-09;272;379;11942;2295;5.3;1.0
65;2021-02-10;298;269;12240;2564;5.4;1.1
65;2021-02-11;320;275;12560;2839;5.5;1.3
65;2021-02-12;277;229;12837;3068;5.7;1.4
65;2021-02-13;126;97;12963;3165;5.7;1.4
65;2021-02-14;3;16;12966;3181;5.7;1.4
65;2021-02-15;203;412;13169;3593;5.8;1.6
65;2021-02-16;489;578;13658;4171;6.0;1.8
65;2021-02-17;231;500;13889;4671;6.1;2.1
65;2021-02-18;284;581;14173;5252;6.2;2.3
65;2021-02-19;156;478;14329;5730;6.3;2.5
65;2021-02-20;53;158;14382;5888;6.3;2.6
65;2021-02-21;3;48;14385;5936;6.3;2.6
65;2021-02-22;167;539;14552;6475;6.4;2.9
65;2021-02-23;249;527;14801;7002;6.5;3.1
65;2021-02-24;231;639;15032;7641;6.6;3.4
65;2021-02-25;215;183;15247;7824;6.7;3.4
65;2021-02-26;349;772;15596;8596;6.9;3.8
65;2021-02-27;109;204;15705;8800;6.9;3.9
65;2021-02-28;1;0;15706;8800;6.9;3.9
65;2021-03-01;379;373;16085;9173;7.1;4.0
65;2021-03-02;455;364;16540;9537;7.3;4.2
65;2021-03-03;381;390;16921;9927;7.5;4.4
65;2021-03-04;696;332;17617;10259;7.8;4.5
65;2021-03-05;679;286;18296;10545;8.1;4.6
65;2021-03-06;1187;89;19483;10634;8.6;4.7
65;2021-03-07;257;12;19740;10646;8.7;4.7
65;2021-03-08;412;345;20152;10991;8.9;4.8
65;2021-03-09;670;339;20822;11330;9.2;5.0
65;2021-03-10;624;371;21446;11701;9.5;5.2
65;2021-03-11;778;362;22224;12063;9.8;5.3
65;2021-03-12;1060;192;23284;12255;10.3;5.4
65;2021-03-13;356;93;23640;12348;10.4;5.4
65;2021-03-14;3;30;23643;12378;10.4;5.5
65;2021-03-15;816;188;24459;12566;10.8;5.5
65;2021-03-16;694;221;25153;12787;11.1;5.6
65;2021-03-17;712;209;25865;12996;11.4;5.7
65;2021-03-18;537;236;26402;13232;11.6;5.8
65;2021-03-19;878;164;27280;13396;12.0;5.9
65;2021-03-20;245;46;27525;13442;12.1;5.9
65;2021-03-21;12;2;27537;13444;12.1;5.9
65;2021-03-22;734;154;28271;13598;12.5;6.0
65;2021-03-23;838;369;29109;13967;12.8;6.2
65;2021-03-24;868;254;29977;14221;13.2;6.3
65;2021-03-25;1253;191;31230;14412;13.8;6.4
65;2021-03-26;1225;148;32455;14560;14.3;6.4
65;2021-03-27;1357;95;33812;14655;14.9;6.5
65;2021-03-28;1;2;33813;14657;14.9;6.5
65;2021-03-29;1490;362;35303;15019;15.6;6.6
65;2021-03-30;1357;407;36660;15426;16.2;6.8
65;2021-03-31;1208;372;37868;15798;16.7;7.0
65;2021-04-01;1509;399;39377;16197;17.4;7.1
65;2021-04-02;1685;289;41062;16486;18.1;7.3
65;2021-04-03;247;45;41309;16531;18.2;7.3
65;2021-04-04;4;2;41313;16533;18.2;7.3
65;2021-04-05;159;44;41472;16577;18.3;7.3
65;2021-04-06;1294;494;42766;17071;18.9;7.5
65;2021-04-07;1958;461;44724;17532;19.7;7.7
65;2021-04-08;1644;421;46368;17953;20.4;7.9
65;2021-04-09;1643;472;48011;18425;21.2;8.1
65;2021-04-10;1592;153;49603;18578;21.9;8.2
65;2021-04-11;3;0;49606;18578;21.9;8.2
65;2021-04-12;1352;737;50958;19315;22.5;8.5
65;2021-04-13;1584;604;52542;19919;23.2;8.8
65;2021-04-14;1905;745;54447;20664;24.0;9.1
65;2021-04-15;1701;677;56148;21341;24.8;9.4
65;2021-04-16;1824;530;57972;21871;25.6;9.6
65;2021-04-17;2156;133;60128;22004;26.5;9.7
65;2021-04-18;7;27;60135;22031;26.5;9.7
65;2021-04-19;1337;776;61472;22807;27.1;10.1
65;2021-04-20;1530;711;63002;23518;27.8;10.4
65;2021-04-21;1052;1049;64054;24567;28.2;10.8
65;2021-04-22;1647;729;65701;25296;29.0;11.2
65;2021-04-23;1160;1149;66861;26445;29.5;11.7
65;2021-04-24;1265;612;68126;27057;30.0;11.9
65;2021-04-25;31;15;68157;27072;30.0;11.9
65;2021-04-26;1610;1299;69767;28371;30.8;12.5
65;2021-04-27;1423;1342;71190;29713;31.4;13.1
65;2021-04-28;1731;1026;72921;30739;32.1;13.6
65;2021-04-29;1959;1038;74880;31777;33.0;14.0
65;2021-04-30;1782;926;76662;32703;33.8;14.4
65;2021-05-01;1574;233;78236;32936;34.5;14.5
65;2021-05-02;671;25;78907;32961;34.8;14.5
65;2021-05-03;1280;1620;80187;34581;35.3;15.2
65;2021-05-04;1537;1245;81724;35826;36.0;15.8
65;2021-05-05;1374;1649;83098;37475;36.6;16.5
65;2021-05-06;1558;1177;84656;38652;37.3;17.0
65;2021-05-07;1275;1571;85931;40223;37.9;17.7
65;2021-05-08;1647;443;87578;40666;38.6;17.9
65;2021-05-09;0;88;87578;40754;38.6;18.0
65;2021-05-10;953;1883;88531;42637;39.0;18.8
65;2021-05-11;1061;1808;89592;44445;39.5;19.6
65;2021-05-12;1236;1637;90828;46082;40.0;20.3
65;2021-05-13;1345;171;92173;46253;40.6;20.4
65;2021-05-14;1575;1094;93748;47347;41.3;20.9
65;2021-05-15;1402;509;95150;47856;41.9;21.1
65;2021-05-16;1444;70;96594;47926;42.6;21.1
65;2021-05-17;1036;1614;97630;49540;43.0;21.8
65;2021-05-18;1612;1207;99242;50747;43.7;22.4
65;2021-05-19;1684;1010;100926;51757;44.5;22.8
65;2021-05-20;1845;1054;102771;52811;45.3;23.3
65;2021-05-21;1790;1230;104561;54041;46.1;23.8
65;2021-05-22;1287;638;105848;54679;46.7;24.1
65;2021-05-23;689;32;106537;54711;47.0;24.1
65;2021-05-24;703;77;107240;54788;47.3;24.2
65;2021-05-25;1359;1547;108599;56335;47.9;24.8
65;2021-05-26;1471;1354;110070;57689;48.5;25.4
65;2021-05-27;1622;1464;111692;59153;49.2;26.1
65;2021-05-28;1598;1673;113290;60826;49.9;26.8
65;2021-05-29;1188;1515;114478;62341;50.5;27.5
65;2021-05-30;7;10;114485;62351;50.5;27.5
65;2021-05-31;1323;1298;115808;63649;51.1;28.1
65;2021-06-01;1832;937;117640;64586;51.9;28.5
65;2021-06-02;1574;950;119214;65536;52.6;28.9
65;2021-06-03;1343;1105;120557;66641;53.1;29.4
65;2021-06-04;1790;1560;122347;68201;53.9;30.1
65;2021-06-05;432;1240;122779;69441;54.1;30.6
65;2021-06-06;3;13;122782;69454;54.1;30.6
65;2021-06-07;675;1984;123457;71438;54.4;31.5
65;2021-06-08;956;1534;124413;72972;54.8;32.2
65;2021-06-09;828;1548;125241;74520;55.2;32.9
65;2021-06-10;739;1155;125980;75675;55.5;33.4
65;2021-06-11;909;1802;126889;77477;55.9;34.2
65;2021-06-12;150;640;127039;78117;56.0;34.4
65;2021-06-13;5;7;127044;78124;56.0;34.4
65;2021-06-14;501;2421;127545;80545;56.2;35.5
65;2021-06-15;942;1802;128487;82347;56.6;36.3
65;2021-06-16;1063;1365;129550;83712;57.1;36.9
65;2021-06-17;814;1046;130364;84758;57.5;37.4
65;2021-06-18;1019;1633;131383;86391;57.9;38.1
65;2021-06-19;690;1689;132073;88080;58.2;38.8
65;2021-06-20;2;2;132075;88082;58.2;38.8
65;2021-06-21;735;1941;132810;90023;58.5;39.7
65;2021-06-22;1045;1479;133855;91502;59.0;40.3
65;2021-06-23;1063;1234;134918;92736;59.5;40.9
65;2021-06-24;975;1143;135893;93879;59.9;41.4
65;2021-06-25;831;1968;136724;95847;60.3;42.3
65;2021-06-26;168;1658;136892;97505;60.3;43.0
65;2021-06-27;15;1100;136907;98605;60.4;43.5
65;2021-06-28;444;2301;137351;100906;60.5;44.5
65;2021-06-29;683;1921;138034;102827;60.9;45.3
65;2021-06-30;934;1678;138968;104505;61.3;46.1
65;2021-07-01;605;750;139573;105255;61.5;46.4
65;2021-07-02;1166;1732;140739;106987;62.0;47.2
65;2021-07-03;197;1915;140936;108902;62.1;48.0
65;2021-07-04;416;186;141352;109088;62.3;48.1
65;2021-07-05;641;1992;141993;111080;62.6;49.0
65;2021-07-06;897;2127;142890;113207;63.0;49.9
65;2021-07-07;978;1516;143868;114723;63.4;50.6
65;2021-07-08;328;664;144196;115387;63.6;50.9
65;2021-07-09;550;1594;144746;116981;63.8;51.6
65;2021-07-10;304;956;145050;117937;63.9;52.0
65;2021-07-11;0;0;145050;117937;63.9;52.0
65;2021-07-12;480;2220;145530;120157;64.2;53.0
65;2021-07-13;700;2148;146230;122305;64.5;53.9
65;2021-07-14;214;52;146444;122357;64.6;53.9
65;2021-07-15;1097;1663;147541;124020;65.0;54.7
65;2021-07-16;1186;1884;148727;125904;65.6;55.5
65;2021-07-17;431;541;149158;126445;65.8;55.7
65;2021-07-18;22;11;149180;126456;65.8;55.7
65;2021-07-19;635;1494;149815;127950;66.0;56.4
65;2021-07-20;1447;1704;151262;129654;66.7;57.2
65;2021-07-21;1420;1663;152682;131317;67.3;57.9
65;2021-07-22;2198;1291;154880;132608;68.3;58.5
65;2021-07-23;1623;1791;156503;134399;69.0;59.2
65;2021-07-24;1041;649;157544;135048;69.5;59.5
65;2021-07-25;24;21;157568;135069;69.5;59.5
65;2021-07-26;1142;1246;158710;136315;70.0;60.1
65;2021-07-27;1793;1954;160503;138269;70.8;61.0
65;2021-07-28;1603;1323;162106;139592;71.5;61.5
65;2021-07-29;2899;1139;165005;140731;72.7;62.0
65;2021-07-30;2449;1399;167454;142130;73.8;62.7
65;2021-07-31;2305;356;169759;142486;74.8;62.8
65;2021-08-01;14;16;169773;142502;74.8;62.8
65;2021-08-02;994;835;170767;143337;75.3;63.2
65;2021-08-03;2103;1071;172870;144408;76.2;63.7
65;2021-08-04;1803;642;174673;145050;77.0;63.9
65;2021-08-05;1821;833;176494;145883;77.8;64.3
65;2021-08-06;1666;975;178160;146858;78.5;64.7
65;2021-08-07;730;487;178890;147345;78.9;65.0
65;2021-08-08;2;9;178892;147354;78.9;65.0
65;2021-08-09;705;944;179597;148298;79.2;65.4
65;2021-08-10;1195;1545;180792;149843;79.7;66.1
65;2021-08-11;731;1265;181523;151108;80.0;66.6
65;2021-08-12;777;1085;182300;152193;80.4;67.1
65;2021-08-13;428;1011;182728;153204;80.6;67.5
65;2021-08-14;602;567;183330;153771;80.8;67.8
65;2021-08-15;8;19;183338;153790;80.8;67.8
65;2021-08-16;404;1537;183742;155327;81.0;68.5
65;2021-08-17;738;2178;184480;157505;81.3;69.4
65;2021-08-18;605;1545;185085;159050;81.6;70.1
65;2021-08-19;731;1319;185816;160369;81.9;70.7
65;2021-08-20;459;1336;186275;161705;82.1;71.3
65;2021-08-21;44;105;186319;161810;82.1;71.3
65;2021-08-22;11;13;186330;161823;82.1;71.3
65;2021-08-23;273;1681;186603;163504;82.3;72.1
65;2021-08-24;551;2445;187154;165949;82.5;73.2
65;2021-08-25;418;1959;187572;167908;82.7;74.0
65;2021-08-26;468;2308;188040;170216;82.9;75.0
65;2021-08-27;447;1949;188487;172165;83.1;75.9
65;2021-08-28;163;195;188650;172360;83.2;76.0
65;2021-08-29;9;18;188659;172378;83.2;76.0
65;2021-08-30;260;1029;188919;173407;83.3;76.4
65;2021-08-31;467;1506;189386;174913;83.5;77.1
65;2021-09-01;459;1077;189845;175990;83.7;77.6
65;2021-09-02;374;883;190219;176873;83.9;78.0
65;2021-09-03;453;1107;190672;177980;84.1;78.5
65;2021-09-04;166;847;190838;178827;84.1;78.8
65;2021-09-05;19;15;190857;178842;84.1;78.8
65;2021-09-06;278;496;191135;179338;84.3;79.1
65;2021-09-07;325;809;191460;180147;84.4;79.4
65;2021-09-08;356;762;191816;180909;84.6;79.8
65;2021-09-09;286;564;192102;181473;84.7;80.0
65;2021-09-10;385;709;192487;182182;84.9;80.3
65;2021-09-11;54;129;192541;182311;84.9;80.4
65;2021-09-12;1;2;192542;182313;84.9;80.4
65;2021-09-13;210;307;192752;182620;85.0;80.5
65;2021-09-14;191;357;192943;182977;85.1;80.7
65;2021-09-15;250;639;193193;183616;85.2;80.9
65;2021-09-16;140;213;193333;183829;85.2;81.0
65;2021-09-17;280;525;193613;184354;85.4;81.3
65;2021-09-18;98;269;193711;184623;85.4;81.4
65;2021-09-19;2;13;193713;184636;85.4;81.4
65;2021-09-20;110;234;193823;184870;85.4;81.5
65;2021-09-21;110;258;193933;185128;85.5;81.6
65;2021-09-22;153;680;194086;185808;85.6;81.9
65;2021-09-23;65;158;194151;185966;85.6;82.0
65;2021-09-24;170;556;194321;186522;85.7;82.2
65;2021-09-25;73;218;194394;186740;85.7;82.3
65;2021-09-26;3;0;194397;186740;85.7;82.3
65;2021-09-27;62;263;194459;187003;85.7;82.4
65;2021-09-28;85;280;194544;187283;85.8;82.6
65;2021-09-29;131;419;194675;187702;85.8;82.7
65;2021-09-30;44;124;194719;187826;85.8;82.8
65;2021-10-01;166;399;194885;188225;85.9;83.0
65;2021-10-02;19;66;194904;188291;85.9;83.0
65;2021-10-03;0;7;194904;188298;85.9;83.0
65;2021-10-04;121;269;195025;188567;86.0;83.1
65;2021-10-05;63;179;195088;188746;86.0;83.2
65;2021-10-06;174;346;195262;189092;86.1;83.4
65;2021-10-07;73;177;195335;189269;86.1;83.4
65;2021-10-08;179;406;195514;189675;86.2;83.6
65;2021-10-09;17;23;195531;189698;86.2;83.6
65;2021-10-10;0;6;195531;189704;86.2;83.6
65;2021-10-11;100;205;195631;189909;86.2;83.7
66;2020-12-27;0;0;0;0;0.0;0.0
66;2020-12-28;2;0;2;0;0.0;0.0
66;2020-12-29;0;0;2;0;0.0;0.0
66;2020-12-30;0;0;2;0;0.0;0.0
66;2020-12-31;1;0;3;0;0.0;0.0
66;2021-01-01;3;0;6;0;0.0;0.0
66;2021-01-02;0;0;6;0;0.0;0.0
66;2021-01-03;0;0;6;0;0.0;0.0
66;2021-01-04;30;0;36;0;0.0;0.0
66;2021-01-05;135;0;171;0;0.0;0.0
66;2021-01-06;194;0;365;0;0.1;0.0
66;2021-01-07;182;0;547;0;0.1;0.0
66;2021-01-08;212;0;759;0;0.2;0.0
66;2021-01-09;233;0;992;0;0.2;0.0
66;2021-01-10;11;0;1003;0;0.2;0.0
66;2021-01-11;404;2;1407;2;0.3;0.0
66;2021-01-12;588;2;1995;4;0.4;0.0
66;2021-01-13;877;9;2872;13;0.6;0.0
66;2021-01-14;892;12;3764;25;0.8;0.0
66;2021-01-15;588;2;4352;27;0.9;0.0
66;2021-01-16;106;3;4458;30;0.9;0.0
66;2021-01-17;46;1;4504;31;0.9;0.0
66;2021-01-18;654;3;5158;34;1.1;0.0
66;2021-01-19;720;3;5878;37;1.2;0.0
66;2021-01-20;1169;4;7047;41;1.5;0.0
66;2021-01-21;2399;7;9446;48;2.0;0.0
66;2021-01-22;1438;10;10884;58;2.3;0.0
66;2021-01-23;399;4;11283;62;2.4;0.0
66;2021-01-24;225;9;11508;71;2.4;0.0
66;2021-01-25;739;40;12247;111;2.6;0.0
66;2021-01-26;787;66;13034;177;2.7;0.0
66;2021-01-27;867;104;13901;281;2.9;0.1
66;2021-01-28;878;130;14779;411;3.1;0.1
66;2021-01-29;820;129;15599;540;3.3;0.1
66;2021-01-30;481;68;16080;608;3.4;0.1
66;2021-01-31;202;27;16282;635;3.4;0.1
66;2021-02-01;562;188;16844;823;3.5;0.2
66;2021-02-02;622;289;17466;1112;3.6;0.2
66;2021-02-03;734;628;18200;1740;3.8;0.4
66;2021-02-04;688;620;18888;2360;3.9;0.5
66;2021-02-05;778;414;19666;2774;4.1;0.6
66;2021-02-06;420;147;20086;2921;4.2;0.6
66;2021-02-07;170;140;20256;3061;4.2;0.6
66;2021-02-08;502;391;20758;3452;4.3;0.7
66;2021-02-09;533;400;21291;3852;4.4;0.8
66;2021-02-10;621;769;21912;4621;4.6;1.0
66;2021-02-11;1104;1570;23016;6191;4.8;1.3
66;2021-02-12;1122;1202;24138;7393;5.0;1.5
66;2021-02-13;367;302;24505;7695;5.1;1.6
66;2021-02-14;111;196;24616;7891;5.1;1.6
66;2021-02-15;425;694;25041;8585;5.2;1.8
66;2021-02-16;304;785;25345;9370;5.3;2.0
66;2021-02-17;377;697;25722;10067;5.4;2.1
66;2021-02-18;366;769;26088;10836;5.4;2.3
66;2021-02-19;400;703;26488;11539;5.5;2.4
66;2021-02-20;184;408;26672;11947;5.6;2.5
66;2021-02-21;41;169;26713;12116;5.6;2.5
66;2021-02-22;415;638;27128;12754;5.7;2.7
66;2021-02-23;509;664;27637;13418;5.8;2.8
66;2021-02-24;347;754;27984;14172;5.8;3.0
66;2021-02-25;717;712;28701;14884;6.0;3.1
66;2021-02-26;954;746;29655;15630;6.2;3.3
66;2021-02-27;363;428;30018;16058;6.3;3.4
66;2021-02-28;59;172;30077;16230;6.3;3.4
66;2021-03-01;378;650;30455;16880;6.4;3.5
66;2021-03-02;336;658;30791;17538;6.4;3.7
66;2021-03-03;531;645;31322;18183;6.5;3.8
66;2021-03-04;991;1060;32313;19243;6.7;4.0
66;2021-03-05;1528;799;33841;20042;7.1;4.2
66;2021-03-06;1147;347;34988;20389;7.3;4.3
66;2021-03-07;1098;100;36086;20489;7.5;4.3
66;2021-03-08;696;545;36782;21034;7.7;4.4
66;2021-03-09;1228;597;38010;21631;7.9;4.5
66;2021-03-10;1303;505;39313;22136;8.2;4.6
66;2021-03-11;1474;592;40787;22728;8.5;4.7
66;2021-03-12;2396;580;43183;23308;9.0;4.9
66;2021-03-13;1081;308;44264;23616;9.2;4.9
66;2021-03-14;192;84;44456;23700;9.3;4.9
66;2021-03-15;1109;395;45565;24095;9.5;5.0
66;2021-03-16;953;259;46518;24354;9.7;5.1
66;2021-03-17;866;398;47384;24752;9.9;5.2
66;2021-03-18;970;346;48354;25098;10.1;5.2
66;2021-03-19;1293;322;49647;25420;10.4;5.3
66;2021-03-20;837;125;50484;25545;10.5;5.3
66;2021-03-21;186;45;50670;25590;10.6;5.3
66;2021-03-22;1115;396;51785;25986;10.8;5.4
66;2021-03-23;1756;389;53541;26375;11.2;5.5
66;2021-03-24;1797;521;55338;26896;11.6;5.6
66;2021-03-25;2537;474;57875;27370;12.1;5.7
66;2021-03-26;2577;370;60452;27740;12.6;5.8
66;2021-03-27;1211;303;61663;28043;12.9;5.9
66;2021-03-28;321;3;61984;28046;12.9;5.9
66;2021-03-29;1831;262;63815;28308;13.3;5.9
66;2021-03-30;2241;176;66056;28484;13.8;5.9
66;2021-03-31;1987;252;68043;28736;14.2;6.0
66;2021-04-01;2674;305;70717;29041;14.8;6.1
66;2021-04-02;2421;261;73138;29302;15.3;6.1
66;2021-04-03;1148;335;74286;29637;15.5;6.2
66;2021-04-04;107;125;74393;29762;15.5;6.2
66;2021-04-05;197;144;74590;29906;15.6;6.2
66;2021-04-06;1334;650;75924;30556;15.9;6.4
66;2021-04-07;1399;598;77323;31154;16.1;6.5
66;2021-04-08;2070;550;79393;31704;16.6;6.6
66;2021-04-09;3507;691;82900;32395;17.3;6.8
66;2021-04-10;2308;527;85208;32922;17.8;6.9
66;2021-04-11;1202;171;86410;33093;18.0;6.9
66;2021-04-12;2703;1026;89113;34119;18.6;7.1
66;2021-04-13;3609;1064;92722;35183;19.4;7.3
66;2021-04-14;3292;926;96014;36109;20.0;7.5
66;2021-04-15;3557;1054;99571;37163;20.8;7.8
66;2021-04-16;3592;1039;103163;38202;21.5;8.0
66;2021-04-17;2263;593;105426;38795;22.0;8.1
66;2021-04-18;1445;132;106871;38927;22.3;8.1
66;2021-04-19;2256;1125;109127;40052;22.8;8.4
66;2021-04-20;2373;1079;111500;41131;23.3;8.6
66;2021-04-21;2871;1181;114371;42312;23.9;8.8
66;2021-04-22;2662;1236;117033;43548;24.4;9.1
66;2021-04-23;2379;1236;119412;44784;24.9;9.3
66;2021-04-24;2743;882;122155;45666;25.5;9.5
66;2021-04-25;1206;267;123361;45933;25.8;9.6
66;2021-04-26;1998;1254;125359;47187;26.2;9.9
66;2021-04-27;2748;1311;128107;48498;26.7;10.1
66;2021-04-28;2420;1658;130527;50156;27.2;10.5
66;2021-04-29;2704;2133;133231;52289;27.8;10.9
66;2021-04-30;3053;1559;136284;53848;28.5;11.2
66;2021-05-01;2000;470;138284;54318;28.9;11.3
66;2021-05-02;1529;264;139813;54582;29.2;11.4
66;2021-05-03;2940;1112;142753;55694;29.8;11.6
66;2021-05-04;3169;1343;145922;57037;30.5;11.9
66;2021-05-05;3055;1549;148977;58586;31.1;12.2
66;2021-05-06;3755;2092;152732;60678;31.9;12.7
66;2021-05-07;2967;3080;155699;63758;32.5;13.3
66;2021-05-08;1730;1170;157429;64928;32.9;13.6
66;2021-05-09;886;1369;158315;66297;33.1;13.8
66;2021-05-10;1802;2970;160117;69267;33.4;14.5
66;2021-05-11;2741;3129;162858;72396;34.0;15.1
66;2021-05-12;2432;2569;165290;74965;34.5;15.7
66;2021-05-13;2259;1386;167549;76351;35.0;15.9
66;2021-05-14;2770;2119;170319;78470;35.6;16.4
66;2021-05-15;2326;1576;172645;80046;36.0;16.7
66;2021-05-16;2286;1246;174931;81292;36.5;17.0
66;2021-05-17;2051;1825;176982;83117;36.9;17.4
66;2021-05-18;3237;1808;180219;84925;37.6;17.7
66;2021-05-19;2876;1340;183095;86265;38.2;18.0
66;2021-05-20;4372;1445;187467;87710;39.1;18.3
66;2021-05-21;3268;1463;190735;89173;39.8;18.6
66;2021-05-22;3066;779;193801;89952;40.5;18.8
66;2021-05-23;1509;236;195310;90188;40.8;18.8
66;2021-05-24;1953;427;197263;90615;41.2;18.9
66;2021-05-25;2795;1689;200058;92304;41.8;19.3
66;2021-05-26;2778;1492;202836;93796;42.3;19.6
66;2021-05-27;3384;2248;206220;96044;43.1;20.1
66;2021-05-28;2683;3049;208903;99093;43.6;20.7
66;2021-05-29;2145;1520;211048;100613;44.1;21.0
66;2021-05-30;786;988;211834;101601;44.2;21.2
66;2021-05-31;2124;1774;213958;103375;44.7;21.6
66;2021-06-01;2636;2005;216594;105380;45.2;22.0
66;2021-06-02;2806;2338;219400;107718;45.8;22.5
66;2021-06-03;2488;2967;221888;110685;46.3;23.1
66;2021-06-04;1958;3355;223846;114040;46.7;23.8
66;2021-06-05;1409;2601;225255;116641;47.0;24.4
66;2021-06-06;294;1228;225549;117869;47.1;24.6
66;2021-06-07;1335;2956;226884;120825;47.4;25.2
66;2021-06-08;1736;3020;228620;123845;47.7;25.9
66;2021-06-09;2065;2787;230685;126632;48.2;26.4
66;2021-06-10;2085;2964;232770;129596;48.6;27.1
66;2021-06-11;2098;3859;234868;133455;49.0;27.9
66;2021-06-12;871;2411;235739;135866;49.2;28.4
66;2021-06-13;516;1333;236255;137199;49.3;28.6
66;2021-06-14;1360;3497;237615;140696;49.6;29.4
66;2021-06-15;2131;3573;239746;144269;50.1;30.1
66;2021-06-16;1792;3569;241538;147838;50.4;30.9
66;2021-06-17;2441;3608;243979;151446;50.9;31.6
66;2021-06-18;2225;3824;246204;155270;51.4;32.4
66;2021-06-19;1542;2320;247746;157590;51.7;32.9
66;2021-06-20;998;1267;248744;158857;51.9;33.2
66;2021-06-21;1163;2879;249907;161736;52.2;33.8
66;2021-06-22;1510;3762;251417;165498;52.5;34.6
66;2021-06-23;1325;3027;252742;168525;52.8;35.2
66;2021-06-24;1527;3227;254269;171752;53.1;35.9
66;2021-06-25;1404;3536;255673;175288;53.4;36.6
66;2021-06-26;962;2680;256635;177968;53.6;37.2
66;2021-06-27;677;1557;257312;179525;53.7;37.5
66;2021-06-28;980;2975;258292;182500;53.9;38.1
66;2021-06-29;1148;3797;259440;186297;54.2;38.9
66;2021-06-30;1278;3306;260718;189603;54.4;39.6
66;2021-07-01;1453;4047;262171;193650;54.7;40.4
66;2021-07-02;1349;3603;263520;197253;55.0;41.2
66;2021-07-03;1152;3899;264672;201152;55.3;42.0
66;2021-07-04;715;1790;265387;202942;55.4;42.4
66;2021-07-05;1293;3005;266680;205947;55.7;43.0
66;2021-07-06;1458;3785;268138;209732;56.0;43.8
66;2021-07-07;1430;3248;269568;212980;56.3;44.5
66;2021-07-08;1386;3384;270954;216364;56.6;45.2
66;2021-07-09;1450;3465;272404;219829;56.9;45.9
66;2021-07-10;1005;2403;273409;222232;57.1;46.4
66;2021-07-11;540;1540;273949;223772;57.2;46.7
66;2021-07-12;1021;3645;274970;227417;57.4;47.5
66;2021-07-13;2223;4263;277193;231680;57.9;48.4
66;2021-07-14;1953;1243;279146;232923;58.3;48.6
66;2021-07-15;2801;3111;281947;236034;58.9;49.3
66;2021-07-16;3410;3214;285357;239248;59.6;49.9
66;2021-07-17;2123;2033;287480;241281;60.0;50.4
66;2021-07-18;1197;1063;288677;242344;60.3;50.6
66;2021-07-19;2794;3083;291471;245427;60.8;51.2
66;2021-07-20;3654;2887;295125;248314;61.6;51.8
66;2021-07-21;3962;2955;299087;251269;62.4;52.5
66;2021-07-22;3917;2821;303004;254090;63.3;53.0
66;2021-07-23;3914;3033;306918;257123;64.1;53.7
66;2021-07-24;2584;1923;309502;259046;64.6;54.1
66;2021-07-25;2020;1241;311522;260287;65.0;54.3
66;2021-07-26;2865;2629;314387;262916;65.6;54.9
66;2021-07-27;3230;2889;317617;265805;66.3;55.5
66;2021-07-28;3355;2583;320972;268388;67.0;56.0
66;2021-07-29;3864;2536;324836;270924;67.8;56.6
66;2021-07-30;4233;2476;329069;273400;68.7;57.1
66;2021-07-31;2231;1716;331300;275116;69.2;57.4
66;2021-08-01;1821;900;333121;276016;69.5;57.6
66;2021-08-02;2391;1919;335512;277935;70.0;58.0
66;2021-08-03;2623;2075;338135;280010;70.6;58.5
66;2021-08-04;2646;1996;340781;282006;71.1;58.9
66;2021-08-05;2444;2439;343225;284445;71.7;59.4
66;2021-08-06;2339;2648;345564;287093;72.1;59.9
66;2021-08-07;1506;2099;347070;289192;72.5;60.4
66;2021-08-08;613;1458;347683;290650;72.6;60.7
66;2021-08-09;1356;2800;349039;293450;72.9;61.3
66;2021-08-10;1648;3075;350687;296525;73.2;61.9
66;2021-08-11;1628;3021;352315;299546;73.6;62.5
66;2021-08-12;1678;2991;353993;302537;73.9;63.2
66;2021-08-13;1473;2984;355466;305521;74.2;63.8
66;2021-08-14;658;2508;356124;308029;74.3;64.3
66;2021-08-15;136;1629;356260;309658;74.4;64.6
66;2021-08-16;1281;2594;357541;312252;74.6;65.2
66;2021-08-17;1496;2980;359037;315232;75.0;65.8
66;2021-08-18;1348;3073;360385;318305;75.2;66.5
66;2021-08-19;1113;2925;361498;321230;75.5;67.1
66;2021-08-20;1019;3324;362517;324554;75.7;67.8
66;2021-08-21;594;2014;363111;326568;75.8;68.2
66;2021-08-22;233;1352;363344;327920;75.9;68.5
66;2021-08-23;1158;2764;364502;330684;76.1;69.0
66;2021-08-24;1064;2952;365566;333636;76.3;69.7
66;2021-08-25;914;2301;366480;335937;76.5;70.1
66;2021-08-26;960;2186;367440;338123;76.7;70.6
66;2021-08-27;917;2366;368357;340489;76.9;71.1
66;2021-08-28;514;1137;368871;341626;77.0;71.3
66;2021-08-29;245;333;369116;341959;77.1;71.4
66;2021-08-30;838;2542;369954;344501;77.2;71.9
66;2021-08-31;835;2656;370789;347157;77.4;72.5
66;2021-09-01;734;1925;371523;349082;77.6;72.9
66;2021-09-02;671;1518;372194;350600;77.7;73.2
66;2021-09-03;717;1747;372911;352347;77.9;73.6
66;2021-09-04;722;1602;373633;353949;78.0;73.9
66;2021-09-05;205;261;373838;354210;78.0;73.9
66;2021-09-06;431;1338;374269;355548;78.1;74.2
66;2021-09-07;378;1177;374647;356725;78.2;74.5
66;2021-09-08;558;1310;375205;358035;78.3;74.7
66;2021-09-09;467;1107;375672;359142;78.4;75.0
66;2021-09-10;495;1159;376167;360301;78.5;75.2
66;2021-09-11;516;1172;376683;361473;78.6;75.5
66;2021-09-12;94;135;376777;361608;78.7;75.5
66;2021-09-13;339;1029;377116;362637;78.7;75.7
66;2021-09-14;385;904;377501;363541;78.8;75.9
66;2021-09-15;477;958;377978;364499;78.9;76.1
66;2021-09-16;390;795;378368;365294;79.0;76.3
66;2021-09-17;340;770;378708;366064;79.1;76.4
66;2021-09-18;358;1099;379066;367163;79.1;76.7
66;2021-09-19;77;241;379143;367404;79.2;76.7
66;2021-09-20;291;672;379434;368076;79.2;76.8
66;2021-09-21;306;585;379740;368661;79.3;77.0
66;2021-09-22;316;792;380056;369453;79.3;77.1
66;2021-09-23;236;508;380292;369961;79.4;77.2
66;2021-09-24;360;772;380652;370733;79.5;77.4
66;2021-09-25;217;941;380869;371674;79.5;77.6
66;2021-09-26;63;213;380932;371887;79.5;77.6
66;2021-09-27;186;498;381118;372385;79.6;77.7
66;2021-09-28;246;545;381364;372930;79.6;77.9
66;2021-09-29;232;576;381596;373506;79.7;78.0
66;2021-09-30;335;454;381931;373960;79.7;78.1
66;2021-10-01;293;519;382224;374479;79.8;78.2
66;2021-10-02;277;619;382501;375098;79.9;78.3
66;2021-10-03;81;125;382582;375223;79.9;78.3
66;2021-10-04;223;373;382805;375596;79.9;78.4
66;2021-10-05;241;444;383046;376040;80.0;78.5
66;2021-10-06;192;377;383238;376417;80.0;78.6
66;2021-10-07;234;457;383472;376874;80.1;78.7
66;2021-10-08;277;554;383749;377428;80.1;78.8
66;2021-10-09;313;538;384062;377966;80.2;78.9
66;2021-10-10;4;12;384066;377978;80.2;78.9
66;2021-10-11;190;395;384256;378373;80.2;79.0
67;2020-12-27;18;1;18;1;0.0;0.0
67;2020-12-28;4;0;22;1;0.0;0.0
67;2020-12-29;2;0;24;1;0.0;0.0
67;2020-12-30;0;0;24;1;0.0;0.0
67;2020-12-31;1;0;25;1;0.0;0.0
67;2021-01-01;6;1;31;2;0.0;0.0
67;2021-01-02;1;0;32;2;0.0;0.0
67;2021-01-03;1;0;33;2;0.0;0.0
67;2021-01-04;43;0;76;2;0.0;0.0
67;2021-01-05;167;7;243;9;0.0;0.0
67;2021-01-06;121;0;364;9;0.0;0.0
67;2021-01-07;235;1;599;10;0.1;0.0
67;2021-01-08;235;1;834;11;0.1;0.0
67;2021-01-09;113;1;947;12;0.1;0.0
67;2021-01-10;67;0;1014;12;0.1;0.0
67;2021-01-11;184;1;1198;13;0.1;0.0
67;2021-01-12;511;2;1709;15;0.2;0.0
67;2021-01-13;660;4;2369;19;0.2;0.0
67;2021-01-14;1096;14;3465;33;0.3;0.0
67;2021-01-15;942;8;4407;41;0.4;0.0
67;2021-01-16;199;4;4606;45;0.4;0.0
67;2021-01-17;101;2;4707;47;0.4;0.0
67;2021-01-18;903;4;5610;51;0.5;0.0
67;2021-01-19;1423;5;7033;56;0.6;0.0
67;2021-01-20;1855;14;8888;70;0.8;0.0
67;2021-01-21;2217;12;11105;82;1.0;0.0
67;2021-01-22;1994;11;13099;93;1.2;0.0
67;2021-01-23;814;6;13913;99;1.2;0.0
67;2021-01-24;380;1;14293;100;1.3;0.0
67;2021-01-25;526;31;14819;131;1.3;0.0
67;2021-01-26;164;110;14983;241;1.3;0.0
67;2021-01-27;1404;141;16387;382;1.4;0.0
67;2021-01-28;3060;233;19447;615;1.7;0.1
67;2021-01-29;2034;168;21481;783;1.9;0.1
67;2021-01-30;1098;82;22579;865;2.0;0.1
67;2021-01-31;1163;32;23742;897;2.1;0.1
67;2021-02-01;3398;253;27140;1150;2.4;0.1
67;2021-02-02;2695;429;29835;1579;2.6;0.1
67;2021-02-03;1578;401;31413;1980;2.8;0.2
67;2021-02-04;1197;755;32610;2735;2.9;0.2
67;2021-02-05;1195;638;33805;3373;3.0;0.3
67;2021-02-06;799;151;34604;3524;3.1;0.3
67;2021-02-07;292;44;34896;3568;3.1;0.3
67;2021-02-08;839;448;35735;4016;3.2;0.4
67;2021-02-09;963;730;36698;4746;3.2;0.4
67;2021-02-10;934;795;37632;5541;3.3;0.5
67;2021-02-11;1152;1130;38784;6671;3.4;0.6
67;2021-02-12;1245;780;40029;7451;3.5;0.7
67;2021-02-13;767;280;40796;7731;3.6;0.7
67;2021-02-14;244;94;41040;7825;3.6;0.7
67;2021-02-15;782;840;41822;8665;3.7;0.8
67;2021-02-16;932;1140;42754;9805;3.8;0.9
67;2021-02-17;786;1186;43540;10991;3.8;1.0
67;2021-02-18;1402;2568;44942;13559;4.0;1.2
67;2021-02-19;1376;2103;46318;15662;4.1;1.4
67;2021-02-20;634;898;46952;16560;4.1;1.5
67;2021-02-21;209;1195;47161;17755;4.2;1.6
67;2021-02-22;1401;2170;48562;19925;4.3;1.8
67;2021-02-23;1461;1561;50023;21486;4.4;1.9
67;2021-02-24;1439;1054;51462;22540;4.5;2.0
67;2021-02-25;1619;1474;53081;24014;4.7;2.1
67;2021-02-26;2227;1412;55308;25426;4.9;2.2
67;2021-02-27;1260;784;56568;26210;5.0;2.3
67;2021-02-28;148;365;56716;26575;5.0;2.3
67;2021-03-01;640;998;57356;27573;5.1;2.4
67;2021-03-02;898;1202;58254;28775;5.1;2.5
67;2021-03-03;1412;1279;59666;30054;5.3;2.7
67;2021-03-04;1963;1064;61629;31118;5.4;2.7
67;2021-03-05;3258;1110;64887;32228;5.7;2.8
67;2021-03-06;2337;775;67224;33003;5.9;2.9
67;2021-03-07;468;283;67692;33286;6.0;2.9
67;2021-03-08;1188;792;68880;34078;6.1;3.0
67;2021-03-09;2226;906;71106;34984;6.3;3.1
67;2021-03-10;2456;1191;73562;36175;6.5;3.2
67;2021-03-11;3208;1368;76770;37543;6.8;3.3
67;2021-03-12;5263;1391;82033;38934;7.2;3.4
67;2021-03-13;3998;902;86031;39836;7.6;3.5
67;2021-03-14;483;390;86514;40226;7.6;3.6
67;2021-03-15;2192;1162;88706;41388;7.8;3.7
67;2021-03-16;1552;1238;90258;42626;8.0;3.8
67;2021-03-17;2072;925;92330;43551;8.2;3.8
67;2021-03-18;2391;740;94721;44291;8.4;3.9
67;2021-03-19;3673;757;98394;45048;8.7;4.0
67;2021-03-20;3064;514;101458;45562;9.0;4.0
67;2021-03-21;338;17;101796;45579;9.0;4.0
67;2021-03-22;2332;781;104128;46360;9.2;4.1
67;2021-03-23;3401;779;107529;47139;9.5;4.2
67;2021-03-24;3911;813;111440;47952;9.8;4.2
67;2021-03-25;5315;543;116755;48495;10.3;4.3
67;2021-03-26;6870;484;123625;48979;10.9;4.3
67;2021-03-27;3927;348;127552;49327;11.3;4.4
67;2021-03-28;580;101;128132;49428;11.3;4.4
67;2021-03-29;3824;430;131956;49858;11.7;4.4
67;2021-03-30;4848;677;136804;50535;12.1;4.5
67;2021-03-31;4849;709;141653;51244;12.5;4.5
67;2021-04-01;5147;931;146800;52175;13.0;4.6
67;2021-04-02;1009;177;147809;52352;13.1;4.6
67;2021-04-03;1689;286;149498;52638;13.2;4.6
67;2021-04-04;328;6;149826;52644;13.2;4.6
67;2021-04-05;371;5;150197;52649;13.3;4.6
67;2021-04-06;3483;1189;153680;53838;13.6;4.8
67;2021-04-07;4533;1286;158213;55124;14.0;4.9
67;2021-04-08;5664;1414;163877;56538;14.5;5.0
67;2021-04-09;7111;1360;170988;57898;15.1;5.1
67;2021-04-10;4334;902;175322;58800;15.5;5.2
67;2021-04-11;857;428;176179;59228;15.6;5.2
67;2021-04-12;3886;1414;180065;60642;15.9;5.4
67;2021-04-13;4890;1583;184955;62225;16.3;5.5
67;2021-04-14;5297;1916;190252;64141;16.8;5.7
67;2021-04-15;6083;2112;196335;66253;17.3;5.8
67;2021-04-16;7836;2436;204171;68689;18.0;6.1
67;2021-04-17;4010;1582;208181;70271;18.4;6.2
67;2021-04-18;1111;646;209292;70917;18.5;6.3
67;2021-04-19;3630;2147;212922;73064;18.8;6.5
67;2021-04-20;4257;1930;217179;74994;19.2;6.6
67;2021-04-21;4071;2516;221250;77510;19.5;6.8
67;2021-04-22;4478;2926;225728;80436;19.9;7.1
67;2021-04-23;5256;3013;230984;83449;20.4;7.4
67;2021-04-24;3101;2023;234085;85472;20.7;7.5
67;2021-04-25;1027;452;235112;85924;20.8;7.6
67;2021-04-26;3190;2618;238302;88542;21.0;7.8
67;2021-04-27;4023;2928;242325;91470;21.4;8.1
67;2021-04-28;4254;3438;246579;94908;21.8;8.4
67;2021-04-29;5125;3518;251704;98426;22.2;8.7
67;2021-04-30;7183;2496;258887;100922;22.9;8.9
67;2021-05-01;2685;793;261572;101715;23.1;9.0
67;2021-05-02;2181;682;263753;102397;23.3;9.0
67;2021-05-03;5561;2619;269314;105016;23.8;9.3
67;2021-05-04;5854;3615;275168;108631;24.3;9.6
67;2021-05-05;5221;4206;280389;112837;24.8;10.0
67;2021-05-06;6714;4927;287103;117764;25.3;10.4
67;2021-05-07;6435;6930;293538;124694;25.9;11.0
67;2021-05-08;3575;1023;297113;125717;26.2;11.1
67;2021-05-09;3366;594;300479;126311;26.5;11.2
67;2021-05-10;4698;4532;305177;130843;26.9;11.6
67;2021-05-11;5649;4932;310826;135775;27.4;12.0
67;2021-05-12;6597;4847;317423;140622;28.0;12.4
67;2021-05-13;7310;1674;324733;142296;28.7;12.6
67;2021-05-14;8880;5358;333613;147654;29.5;13.0
67;2021-05-15;8198;3657;341811;151311;30.2;13.4
67;2021-05-16;6176;969;347987;152280;30.7;13.4
67;2021-05-17;5689;3884;353676;156164;31.2;13.8
67;2021-05-18;6896;3976;360572;160140;31.8;14.1
67;2021-05-19;7376;4167;367948;164307;32.5;14.5
67;2021-05-20;8681;4233;376629;168540;33.3;14.9
67;2021-05-21;8156;5859;384785;174399;34.0;15.4
67;2021-05-22;5933;3420;390718;177819;34.5;15.7
67;2021-05-23;2656;593;393374;178412;34.7;15.8
67;2021-05-24;4414;865;397788;179277;35.1;15.8
67;2021-05-25;5412;4767;403200;184044;35.6;16.2
67;2021-05-26;6063;4876;409263;188920;36.1;16.7
67;2021-05-27;7310;4900;416573;193820;36.8;17.1
67;2021-05-28;7965;6503;424538;200323;37.5;17.7
67;2021-05-29;6646;3871;431184;204194;38.1;18.0
67;2021-05-30;1147;809;432331;205003;38.2;18.1
67;2021-05-31;6405;4058;438736;209061;38.7;18.5
67;2021-06-01;7327;4407;446063;213468;39.4;18.8
67;2021-06-02;8066;4182;454129;217650;40.1;19.2
67;2021-06-03;8841;4866;462970;222516;40.9;19.6
67;2021-06-04;8594;6139;471564;228655;41.6;20.2
67;2021-06-05;6548;3983;478112;232638;42.2;20.5
67;2021-06-06;3468;875;481580;233513;42.5;20.6
67;2021-06-07;7407;4259;488987;237772;43.2;21.0
67;2021-06-08;8616;4931;497603;242703;43.9;21.4
67;2021-06-09;9258;4794;506861;247497;44.8;21.9
67;2021-06-10;9770;5021;516631;252518;45.6;22.3
67;2021-06-11;8065;8324;524696;260842;46.3;23.0
67;2021-06-12;6789;5203;531485;266045;46.9;23.5
67;2021-06-13;3105;1044;534590;267089;47.2;23.6
67;2021-06-14;5504;6460;540094;273549;47.7;24.2
67;2021-06-15;6688;6753;546782;280302;48.3;24.7
67;2021-06-16;6950;6698;553732;287000;48.9;25.3
67;2021-06-17;7275;9044;561007;296044;49.5;26.1
67;2021-06-18;7600;8506;568607;304550;50.2;26.9
67;2021-06-19;6386;5960;574993;310510;50.8;27.4
67;2021-06-20;1446;1411;576439;311921;50.9;27.5
67;2021-06-21;4266;6775;580705;318696;51.3;28.1
67;2021-06-22;4241;9093;584946;327789;51.6;28.9
67;2021-06-23;5292;8184;590238;335973;52.1;29.7
67;2021-06-24;4521;9101;594759;345074;52.5;30.5
67;2021-06-25;5333;9951;600092;355025;53.0;31.3
67;2021-06-26;3463;9104;603555;364129;53.3;32.1
67;2021-06-27;1023;3523;604578;367652;53.4;32.5
67;2021-06-28;2845;8722;607423;376374;53.6;33.2
67;2021-06-29;2898;8612;610321;384986;53.9;34.0
67;2021-06-30;3382;8742;613703;393728;54.2;34.8
67;2021-07-01;3668;8428;617371;402156;54.5;35.5
67;2021-07-02;3736;10938;621107;413094;54.8;36.5
67;2021-07-03;2981;7742;624088;420836;55.1;37.2
67;2021-07-04;764;1869;624852;422705;55.2;37.3
67;2021-07-05;2625;8250;627477;430955;55.4;38.0
67;2021-07-06;3110;8441;630587;439396;55.7;38.8
67;2021-07-07;3926;8741;634513;448137;56.0;39.6
67;2021-07-08;4204;7786;638717;455923;56.4;40.3
67;2021-07-09;3767;11369;642484;467292;56.7;41.3
67;2021-07-10;2859;8205;645343;475497;57.0;42.0
67;2021-07-11;945;1995;646288;477492;57.1;42.2
67;2021-07-12;2479;9725;648767;487217;57.3;43.0
67;2021-07-13;4122;9890;652889;497107;57.6;43.9
67;2021-07-14;3493;4407;656382;501514;58.0;44.3
67;2021-07-15;5142;12230;661524;513744;58.4;45.4
67;2021-07-16;4867;12293;666391;526037;58.8;46.4
67;2021-07-17;3734;8824;670125;534861;59.2;47.2
67;2021-07-18;1465;2550;671590;537411;59.3;47.4
67;2021-07-19;4649;9745;676239;547156;59.7;48.3
67;2021-07-20;5774;9824;682013;556980;60.2;49.2
67;2021-07-21;5869;10649;687882;567629;60.7;50.1
67;2021-07-22;6439;10227;694321;577856;61.3;51.0
67;2021-07-23;7395;11191;701716;589047;62.0;52.0
67;2021-07-24;5422;7581;707138;596628;62.4;52.7
67;2021-07-25;2316;1971;709454;598599;62.6;52.9
67;2021-07-26;5003;7250;714457;605849;63.1;53.5
67;2021-07-27;6623;7330;721080;613179;63.7;54.1
67;2021-07-28;7542;7210;728622;620389;64.3;54.8
67;2021-07-29;8394;6437;737016;626826;65.1;55.3
67;2021-07-30;8667;7312;745683;634138;65.8;56.0
67;2021-07-31;5113;4878;750796;639016;66.3;56.4
67;2021-08-01;2486;1434;753282;640450;66.5;56.5
67;2021-08-02;6419;5094;759701;645544;67.1;57.0
67;2021-08-03;7322;4718;767023;650262;67.7;57.4
67;2021-08-04;6909;4604;773932;654866;68.3;57.8
67;2021-08-05;5753;4231;779685;659097;68.8;58.2
67;2021-08-06;6333;5427;786018;664524;69.4;58.7
67;2021-08-07;4693;4279;790711;668803;69.8;59.0
67;2021-08-08;1311;1440;792022;670243;69.9;59.2
67;2021-08-09;3144;4479;795166;674722;70.2;59.6
67;2021-08-10;3254;4782;798420;679504;70.5;60.0
67;2021-08-11;3434;4677;801854;684181;70.8;60.4
67;2021-08-12;3146;4887;805000;689068;71.1;60.8
67;2021-08-13;3209;5385;808209;694453;71.4;61.3
67;2021-08-14;2198;5086;810407;699539;71.6;61.8
67;2021-08-15;713;1605;811120;701144;71.6;61.9
67;2021-08-16;2095;5242;813215;706386;71.8;62.4
67;2021-08-17;2108;5278;815323;711664;72.0;62.8
67;2021-08-18;2385;6345;817708;718009;72.2;63.4
67;2021-08-19;1903;6153;819611;724162;72.4;63.9
67;2021-08-20;2362;7459;821973;731621;72.6;64.6
67;2021-08-21;1531;5572;823504;737193;72.7;65.1
67;2021-08-22;390;2051;823894;739244;72.7;65.3
67;2021-08-23;1946;6851;825840;746095;72.9;65.9
67;2021-08-24;1999;6613;827839;752708;73.1;66.5
67;2021-08-25;2127;7217;829966;759925;73.3;67.1
67;2021-08-26;1855;5553;831821;765478;73.4;67.6
67;2021-08-27;2221;7057;834042;772535;73.6;68.2
67;2021-08-28;1707;6109;835749;778644;73.8;68.7
67;2021-08-29;439;1600;836188;780244;73.8;68.9
67;2021-08-30;1423;4273;837611;784517;74.0;69.3
67;2021-08-31;1448;3954;839059;788471;74.1;69.6
67;2021-09-01;1863;4058;840922;792529;74.2;70.0
67;2021-09-02;1086;2718;842008;795247;74.3;70.2
67;2021-09-03;1564;3921;843572;799168;74.5;70.6
67;2021-09-04;1483;3773;845055;802941;74.6;70.9
67;2021-09-05;259;842;845314;803783;74.6;71.0
67;2021-09-06;976;1936;846290;805719;74.7;71.1
67;2021-09-07;900;1847;847190;807566;74.8;71.3
67;2021-09-08;1210;2471;848400;810037;74.9;71.5
67;2021-09-09;1124;1794;849524;811831;75.0;71.7
67;2021-09-10;1439;2369;850963;814200;75.1;71.9
67;2021-09-11;1065;2756;852028;816956;75.2;72.1
67;2021-09-12;253;522;852281;817478;75.2;72.2
67;2021-09-13;751;1447;853032;818925;75.3;72.3
67;2021-09-14;948;1475;853980;820400;75.4;72.4
67;2021-09-15;1021;2107;855001;822507;75.5;72.6
67;2021-09-16;757;1306;855758;823813;75.6;72.7
67;2021-09-17;972;2230;856730;826043;75.6;72.9
67;2021-09-18;809;2423;857539;828466;75.7;73.1
67;2021-09-19;104;411;857643;828877;75.7;73.2
67;2021-09-20;601;1132;858244;830009;75.8;73.3
67;2021-09-21;490;1064;858734;831073;75.8;73.4
67;2021-09-22;669;1951;859403;833024;75.9;73.5
67;2021-09-23;567;942;859970;833966;75.9;73.6
67;2021-09-24;688;1674;860658;835640;76.0;73.8
67;2021-09-25;602;1868;861260;837508;76.0;73.9
67;2021-09-26;73;327;861333;837835;76.0;74.0
67;2021-09-27;399;950;861732;838785;76.1;74.1
67;2021-09-28;404;861;862136;839646;76.1;74.1
67;2021-09-29;619;1360;862755;841006;76.2;74.3
67;2021-09-30;422;932;863177;841938;76.2;74.3
67;2021-10-01;660;1437;863837;843375;76.3;74.5
67;2021-10-02;625;1287;864462;844662;76.3;74.6
67;2021-10-03;95;221;864557;844883;76.3;74.6
67;2021-10-04;312;675;864869;845558;76.4;74.7
67;2021-10-05;324;751;865193;846309;76.4;74.7
67;2021-10-06;578;1130;865771;847439;76.4;74.8
67;2021-10-07;443;770;866214;848209;76.5;74.9
67;2021-10-08;630;1269;866844;849478;76.5;75.0
67;2021-10-09;505;1019;867349;850497;76.6;75.1
67;2021-10-10;79;111;867428;850608;76.6;75.1
67;2021-10-11;325;605;867753;851213;76.6;75.2
68;2020-12-27;0;0;0;0;0.0;0.0
68;2020-12-28;0;0;0;0;0.0;0.0
68;2020-12-29;0;0;0;0;0.0;0.0
68;2020-12-30;2;0;2;0;0.0;0.0
68;2020-12-31;0;0;2;0;0.0;0.0
68;2021-01-01;0;0;2;0;0.0;0.0
68;2021-01-02;0;0;2;0;0.0;0.0
68;2021-01-03;1;0;3;0;0.0;0.0
68;2021-01-04;2;1;5;1;0.0;0.0
68;2021-01-05;11;0;16;1;0.0;0.0
68;2021-01-06;245;1;261;2;0.0;0.0
68;2021-01-07;75;0;336;2;0.0;0.0
68;2021-01-08;118;1;454;3;0.1;0.0
68;2021-01-09;20;0;474;3;0.1;0.0
68;2021-01-10;1;0;475;3;0.1;0.0
68;2021-01-11;82;0;557;3;0.1;0.0
68;2021-01-12;388;1;945;4;0.1;0.0
68;2021-01-13;704;3;1649;7;0.2;0.0
68;2021-01-14;372;2;2021;9;0.3;0.0
68;2021-01-15;204;1;2225;10;0.3;0.0
68;2021-01-16;1;0;2226;10;0.3;0.0
68;2021-01-17;0;0;2226;10;0.3;0.0
68;2021-01-18;379;5;2605;15;0.3;0.0
68;2021-01-19;559;5;3164;20;0.4;0.0
68;2021-01-20;707;10;3871;30;0.5;0.0
68;2021-01-21;1395;14;5266;44;0.7;0.0
68;2021-01-22;1498;15;6764;59;0.9;0.0
68;2021-01-23;215;3;6979;62;0.9;0.0
68;2021-01-24;699;2;7678;64;1.0;0.0
68;2021-01-25;1390;45;9068;109;1.2;0.0
68;2021-01-26;1555;80;10623;189;1.4;0.0
68;2021-01-27;2779;160;13402;349;1.8;0.0
68;2021-01-28;2358;62;15760;411;2.1;0.1
68;2021-01-29;1509;119;17269;530;2.3;0.1
68;2021-01-30;165;3;17434;533;2.3;0.1
68;2021-01-31;0;0;17434;533;2.3;0.1
68;2021-02-01;737;118;18171;651;2.4;0.1
68;2021-02-02;870;305;19041;956;2.5;0.1
68;2021-02-03;1001;616;20042;1572;2.6;0.2
68;2021-02-04;1001;323;21043;1895;2.8;0.2
68;2021-02-05;948;234;21991;2129;2.9;0.3
68;2021-02-06;140;2;22131;2131;2.9;0.3
68;2021-02-07;2;16;22133;2147;2.9;0.3
68;2021-02-08;893;24;23026;2171;3.0;0.3
68;2021-02-09;1357;47;24383;2218;3.2;0.3
68;2021-02-10;1453;65;25836;2283;3.4;0.3
68;2021-02-11;1486;469;27322;2752;3.6;0.4
68;2021-02-12;1551;446;28873;3198;3.8;0.4
68;2021-02-13;131;1;29004;3199;3.8;0.4
68;2021-02-14;58;232;29062;3431;3.8;0.4
68;2021-02-15;662;1087;29724;4518;3.9;0.6
68;2021-02-16;865;1370;30589;5888;4.0;0.8
68;2021-02-17;1288;2130;31877;8018;4.2;1.1
68;2021-02-18;1668;2066;33545;10084;4.4;1.3
68;2021-02-19;988;1370;34533;11454;4.5;1.5
68;2021-02-20;93;125;34626;11579;4.5;1.5
68;2021-02-21;1;40;34627;11619;4.5;1.5
68;2021-02-22;447;796;35074;12415;4.6;1.6
68;2021-02-23;639;1062;35713;13477;4.7;1.8
68;2021-02-24;854;1158;36567;14635;4.8;1.9
68;2021-02-25;1208;1250;37775;15885;4.9;2.1
68;2021-02-26;1199;990;38974;16875;5.1;2.2
68;2021-02-27;550;178;39524;17053;5.2;2.2
68;2021-02-28;12;1;39536;17054;5.2;2.2
68;2021-03-01;942;769;40478;17823;5.3;2.3
68;2021-03-02;1215;928;41693;18751;5.5;2.5
68;2021-03-03;1593;973;43286;19724;5.7;2.6
68;2021-03-04;1995;1052;45281;20776;5.9;2.7
68;2021-03-05;2355;1053;47636;21829;6.2;2.9
68;2021-03-06;2288;254;49924;22083;6.5;2.9
68;2021-03-07;838;108;50762;22191;6.7;2.9
68;2021-03-08;1476;978;52238;23169;6.8;3.0
68;2021-03-09;1698;1332;53936;24501;7.1;3.2
68;2021-03-10;1966;1805;55902;26306;7.3;3.4
68;2021-03-11;2637;1914;58539;28220;7.7;3.7
68;2021-03-12;2632;1425;61171;29645;8.0;3.9
68;2021-03-13;3342;264;64513;29909;8.5;3.9
68;2021-03-14;1541;68;66054;29977;8.7;3.9
68;2021-03-15;1797;624;67851;30601;8.9;4.0
68;2021-03-16;1998;603;69849;31204;9.2;4.1
68;2021-03-17;1958;736;71807;31940;9.4;4.2
68;2021-03-18;2220;951;74027;32891;9.7;4.3
68;2021-03-19;3084;741;77111;33632;10.1;4.4
68;2021-03-20;974;125;78085;33757;10.2;4.4
68;2021-03-21;68;2;78153;33759;10.2;4.4
68;2021-03-22;1964;598;80117;34357;10.5;4.5
68;2021-03-23;2861;621;82978;34978;10.9;4.6
68;2021-03-24;3177;819;86155;35797;11.3;4.7
68;2021-03-25;3501;795;89656;36592;11.7;4.8
68;2021-03-26;3894;738;93550;37330;12.3;4.9
68;2021-03-27;1101;169;94651;37499;12.4;4.9
68;2021-03-28;56;3;94707;37502;12.4;4.9
68;2021-03-29;2260;1368;96967;38870;12.7;5.1
68;2021-03-30;2933;1305;99900;40175;13.1;5.3
68;2021-03-31;2643;1368;102543;41543;13.4;5.4
68;2021-04-01;2748;1553;105291;43096;13.8;5.6
68;2021-04-02;244;88;105535;43184;13.8;5.7
68;2021-04-03;241;124;105776;43308;13.9;5.7
68;2021-04-04;5;0;105781;43308;13.9;5.7
68;2021-04-05;49;4;105830;43312;13.9;5.7
68;2021-04-06;1793;1327;107623;44639;14.1;5.8
68;2021-04-07;2585;1542;110208;46181;14.4;6.1
68;2021-04-08;3234;1509;113442;47690;14.9;6.2
68;2021-04-09;4200;1539;117642;49229;15.4;6.5
68;2021-04-10;1203;1974;118845;51203;15.6;6.7
68;2021-04-11;126;1317;118971;52520;15.6;6.9
68;2021-04-12;2666;1639;121637;54159;15.9;7.1
68;2021-04-13;2760;2117;124397;56276;16.3;7.4
68;2021-04-14;3606;2272;128003;58548;16.8;7.7
68;2021-04-15;4055;2167;132058;60715;17.3;8.0
68;2021-04-16;3942;2085;136000;62800;17.8;8.2
68;2021-04-17;1075;444;137075;63244;18.0;8.3
68;2021-04-18;85;9;137160;63253;18.0;8.3
68;2021-04-19;2358;1834;139518;65087;18.3;8.5
68;2021-04-20;2442;2330;141960;67417;18.6;8.8
68;2021-04-21;2829;2478;144789;69895;19.0;9.2
68;2021-04-22;3287;1974;148076;71869;19.4;9.4
68;2021-04-23;3412;2077;151488;73946;19.8;9.7
68;2021-04-24;842;489;152330;74435;20.0;9.8
68;2021-04-25;214;20;152544;74455;20.0;9.8
68;2021-04-26;2328;2107;154872;76562;20.3;10.0
68;2021-04-27;2599;2217;157471;78779;20.6;10.3
68;2021-04-28;3572;1767;161043;80546;21.1;10.6
68;2021-04-29;4164;1751;165207;82297;21.6;10.8
68;2021-04-30;4834;1376;170041;83673;22.3;11.0
68;2021-05-01;948;121;170989;83794;22.4;11.0
68;2021-05-02;732;70;171721;83864;22.5;11.0
68;2021-05-03;3620;1820;175341;85684;23.0;11.2
68;2021-05-04;3937;2363;179278;88047;23.5;11.5
68;2021-05-05;3632;3249;182910;91296;24.0;12.0
68;2021-05-06;4804;2864;187714;94160;24.6;12.3
68;2021-05-07;4518;2909;192232;97069;25.2;12.7
68;2021-05-08;1672;210;193904;97279;25.4;12.7
68;2021-05-09;1075;107;194979;97386;25.5;12.8
68;2021-05-10;3160;3721;198139;101107;26.0;13.2
68;2021-05-11;4715;3623;202854;104730;26.6;13.7
68;2021-05-12;5785;3295;208639;108025;27.3;14.2
68;2021-05-13;4766;840;213405;108865;28.0;14.3
68;2021-05-14;5959;2134;219364;110999;28.7;14.5
68;2021-05-15;3558;910;222922;111909;29.2;14.7
68;2021-05-16;670;119;223592;112028;29.3;14.7
68;2021-05-17;4449;2499;228041;114527;29.9;15.0
68;2021-05-18;6139;2307;234180;116834;30.7;15.3
68;2021-05-19;5867;2883;240047;119717;31.5;15.7
68;2021-05-20;5929;2413;245976;122130;32.2;16.0
68;2021-05-21;5778;2870;251754;125000;33.0;16.4
68;2021-05-22;2576;927;254330;125927;33.3;16.5
68;2021-05-23;15;16;254345;125943;33.3;16.5
68;2021-05-24;2304;970;256649;126913;33.6;16.6
68;2021-05-25;4343;3436;260992;130349;34.2;17.1
68;2021-05-26;4884;3384;265876;133733;34.8;17.5
68;2021-05-27;5400;3408;271276;137141;35.5;18.0
68;2021-05-28;5623;3729;276899;140870;36.3;18.5
68;2021-05-29;1540;1186;278439;142056;36.5;18.6
68;2021-05-30;41;46;278480;142102;36.5;18.6
68;2021-05-31;5158;2363;283638;144465;37.2;18.9
68;2021-06-01;5989;2797;289627;147262;37.9;19.3
68;2021-06-02;4886;3006;294513;150268;38.6;19.7
68;2021-06-03;5938;3099;300451;153367;39.4;20.1
68;2021-06-04;4896;3306;305347;156673;40.0;20.5
68;2021-06-05;781;1169;306128;157842;40.1;20.7
68;2021-06-06;69;114;306197;157956;40.1;20.7
68;2021-06-07;4753;3036;310950;160992;40.7;21.1
68;2021-06-08;4934;3556;315884;164548;41.4;21.6
68;2021-06-09;4994;3448;320878;167996;42.0;22.0
68;2021-06-10;5200;3145;326078;171141;42.7;22.4
68;2021-06-11;5055;4150;331133;175291;43.4;23.0
68;2021-06-12;3036;1771;334169;177062;43.8;23.2
68;2021-06-13;514;682;334683;177744;43.9;23.3
68;2021-06-14;2516;4390;337199;182134;44.2;23.9
68;2021-06-15;3112;4724;340311;186858;44.6;24.5
68;2021-06-16;3387;4442;343698;191300;45.0;25.1
68;2021-06-17;2359;4458;346057;195758;45.3;25.6
68;2021-06-18;3357;5172;349414;200930;45.8;26.3
68;2021-06-19;2253;2170;351667;203100;46.1;26.6
68;2021-06-20;258;891;351925;203991;46.1;26.7
68;2021-06-21;2059;5148;353984;209139;46.4;27.4
68;2021-06-22;1900;5174;355884;214313;46.6;28.1
68;2021-06-23;2318;5739;358202;220052;46.9;28.8
68;2021-06-24;2154;4897;360356;224949;47.2;29.5
68;2021-06-25;2287;6660;362643;231609;47.5;30.3
68;2021-06-26;1303;2608;363946;234217;47.7;30.7
68;2021-06-27;151;880;364097;235097;47.7;30.8
68;2021-06-28;1601;6444;365698;241541;47.9;31.6
68;2021-06-29;1539;6632;367237;248173;48.1;32.5
68;2021-06-30;1797;6554;369034;254727;48.4;33.4
68;2021-07-01;2105;5351;371139;260078;48.6;34.1
68;2021-07-02;2098;6482;373237;266560;48.9;34.9
68;2021-07-03;989;1934;374226;268494;49.0;35.2
68;2021-07-04;242;200;374468;268694;49.1;35.2
68;2021-07-05;1456;5513;375924;274207;49.3;35.9
68;2021-07-06;2001;5884;377925;280091;49.5;36.7
68;2021-07-07;2455;4974;380380;285065;49.8;37.4
68;2021-07-08;2434;4750;382814;289815;50.2;38.0
68;2021-07-09;2091;7364;384905;297179;50.4;38.9
68;2021-07-10;1028;2003;385933;299182;50.6;39.2
68;2021-07-11;147;156;386080;299338;50.6;39.2
68;2021-07-12;1646;6771;387726;306109;50.8;40.1
68;2021-07-13;2909;6550;390635;312659;51.2;41.0
68;2021-07-14;1840;984;392475;313643;51.4;41.1
68;2021-07-15;3188;6655;395663;320298;51.8;42.0
68;2021-07-16;3817;6762;399480;327060;52.3;42.9
68;2021-07-17;3361;2302;402841;329362;52.8;43.2
68;2021-07-18;1054;230;403895;329592;52.9;43.2
68;2021-07-19;3050;6081;406945;335673;53.3;44.0
68;2021-07-20;4002;5677;410947;341350;53.8;44.7
68;2021-07-21;4339;5831;415286;347181;54.4;45.5
68;2021-07-22;4188;4848;419474;352029;55.0;46.1
68;2021-07-23;5041;5761;424515;357790;55.6;46.9
68;2021-07-24;3349;2134;427864;359924;56.1;47.2
68;2021-07-25;825;537;428689;360461;56.2;47.2
68;2021-07-26;4835;4450;433524;364911;56.8;47.8
68;2021-07-27;6363;3756;439887;368667;57.6;48.3
68;2021-07-28;6848;3883;446735;372550;58.5;48.8
68;2021-07-29;6398;3428;453133;375978;59.4;49.3
68;2021-07-30;6342;4378;459475;380356;60.2;49.8
68;2021-07-31;3917;1426;463392;381782;60.7;50.0
68;2021-08-01;1651;494;465043;382276;60.9;50.1
68;2021-08-02;4606;3151;469649;385427;61.5;50.5
68;2021-08-03;3550;2453;473199;387880;62.0;50.8
68;2021-08-04;3135;2689;476334;390569;62.4;51.2
68;2021-08-05;2753;2641;479087;393210;62.8;51.5
68;2021-08-06;3995;4327;483082;397537;63.3;52.1
68;2021-08-07;1227;1305;484309;398842;63.5;52.3
68;2021-08-08;364;813;484673;399655;63.5;52.4
68;2021-08-09;2575;3683;487248;403338;63.8;52.8
68;2021-08-10;2217;2784;489465;406122;64.1;53.2
68;2021-08-11;1896;2728;491361;408850;64.4;53.6
68;2021-08-12;1752;2666;493113;411516;64.6;53.9
68;2021-08-13;2716;4759;495829;416275;65.0;54.5
68;2021-08-14;714;1443;496543;417718;65.1;54.7
68;2021-08-15;45;445;496588;418163;65.1;54.8
68;2021-08-16;2004;5062;498592;423225;65.3;55.5
68;2021-08-17;1802;4847;500394;428072;65.6;56.1
68;2021-08-18;1182;3697;501576;431769;65.7;56.6
68;2021-08-19;1367;3741;502943;435510;65.9;57.1
68;2021-08-20;2229;6065;505172;441575;66.2;57.9
68;2021-08-21;492;1382;505664;442957;66.3;58.0
68;2021-08-22;116;457;505780;443414;66.3;58.1
68;2021-08-23;1191;5425;506971;448839;66.4;58.8
68;2021-08-24;1407;5954;508378;454793;66.6;59.6
68;2021-08-25;1661;3752;510039;458545;66.8;60.1
68;2021-08-26;1991;4505;512030;463050;67.1;60.7
68;2021-08-27;1850;6281;513880;469331;67.3;61.5
68;2021-08-28;422;1070;514302;470401;67.4;61.6
68;2021-08-29;36;418;514338;470819;67.4;61.7
68;2021-08-30;1348;4519;515686;475338;67.6;62.3
68;2021-08-31;1304;4107;516990;479445;67.7;62.8
68;2021-09-01;889;2141;517879;481586;67.9;63.1
68;2021-09-02;878;1769;518757;483355;68.0;63.3
68;2021-09-03;1306;4320;520063;487675;68.1;63.9
68;2021-09-04;494;868;520557;488543;68.2;64.0
68;2021-09-05;209;120;520766;488663;68.2;64.0
68;2021-09-06;696;2137;521462;490800;68.3;64.3
68;2021-09-07;607;1262;522069;492062;68.4;64.5
68;2021-09-08;618;1330;522687;493392;68.5;64.6
68;2021-09-09;900;1241;523587;494633;68.6;64.8
68;2021-09-10;1485;3025;525072;497658;68.8;65.2
68;2021-09-11;470;619;525542;498277;68.9;65.3
68;2021-09-12;73;53;525615;498330;68.9;65.3
68;2021-09-13;812;1184;526427;499514;69.0;65.4
68;2021-09-14;973;1346;527400;500860;69.1;65.6
68;2021-09-15;694;1585;528094;502445;69.2;65.8
68;2021-09-16;631;1079;528725;503524;69.3;66.0
68;2021-09-17;986;2330;529711;505854;69.4;66.3
68;2021-09-18;444;765;530155;506619;69.5;66.4
68;2021-09-19;16;48;530171;506667;69.5;66.4
68;2021-09-20;552;966;530723;507633;69.5;66.5
68;2021-09-21;584;1327;531307;508960;69.6;66.7
68;2021-09-22;633;1155;531940;510115;69.7;66.8
68;2021-09-23;367;680;532307;510795;69.7;66.9
68;2021-09-24;646;1607;532953;512402;69.8;67.1
68;2021-09-25;276;668;533229;513070;69.9;67.2
68;2021-09-26;19;56;533248;513126;69.9;67.2
68;2021-09-27;339;688;533587;513814;69.9;67.3
68;2021-09-28;335;546;533922;514360;70.0;67.4
68;2021-09-29;538;877;534460;515237;70.0;67.5
68;2021-09-30;387;789;534847;516026;70.1;67.6
68;2021-10-01;505;1541;535352;517567;70.1;67.8
68;2021-10-02;267;571;535619;518138;70.2;67.9
68;2021-10-03;38;91;535657;518229;70.2;67.9
68;2021-10-04;213;424;535870;518653;70.2;68.0
68;2021-10-05;289;561;536159;519214;70.3;68.0
68;2021-10-06;383;876;536542;520090;70.3;68.1
68;2021-10-07;389;594;536931;520684;70.4;68.2
68;2021-10-08;694;1622;537625;522306;70.4;68.4
68;2021-10-09;306;614;537931;522920;70.5;68.5
68;2021-10-10;29;45;537960;522965;70.5;68.5
68;2021-10-11;234;463;538194;523428;70.5;68.6
69;2020-12-27;5;1;5;1;0.0;0.0
69;2020-12-28;13;3;18;4;0.0;0.0
69;2020-12-29;5;0;23;4;0.0;0.0
69;2020-12-30;6;1;29;5;0.0;0.0
69;2020-12-31;12;4;41;9;0.0;0.0
69;2021-01-01;2;0;43;9;0.0;0.0
69;2021-01-02;2;1;45;10;0.0;0.0
69;2021-01-03;3;2;48;12;0.0;0.0
69;2021-01-04;13;0;61;12;0.0;0.0
69;2021-01-05;218;9;279;21;0.0;0.0
69;2021-01-06;518;5;797;26;0.0;0.0
69;2021-01-07;813;5;1610;31;0.1;0.0
69;2021-01-08;829;1;2439;32;0.1;0.0
69;2021-01-09;42;3;2481;35;0.1;0.0
69;2021-01-10;3;1;2484;36;0.1;0.0
69;2021-01-11;1135;2;3619;38;0.2;0.0
69;2021-01-12;1399;10;5018;48;0.3;0.0
69;2021-01-13;1395;6;6413;54;0.3;0.0
69;2021-01-14;2286;27;8699;81;0.5;0.0
69;2021-01-15;1829;8;10528;89;0.6;0.0
69;2021-01-16;930;4;11458;93;0.6;0.0
69;2021-01-17;260;3;11718;96;0.6;0.0
69;2021-01-18;1695;20;13413;116;0.7;0.0
69;2021-01-19;3513;37;16926;153;0.9;0.0
69;2021-01-20;4457;34;21383;187;1.1;0.0
69;2021-01-21;4078;43;25461;230;1.4;0.0
69;2021-01-22;3185;30;28646;260;1.5;0.0
69;2021-01-23;1287;6;29933;266;1.6;0.0
69;2021-01-24;103;1;30036;267;1.6;0.0
69;2021-01-25;2245;45;32281;312;1.7;0.0
69;2021-01-26;2564;92;34845;404;1.9;0.0
69;2021-01-27;2360;176;37205;580;2.0;0.0
69;2021-01-28;2238;374;39443;954;2.1;0.1
69;2021-01-29;2111;291;41554;1245;2.2;0.1
69;2021-01-30;889;3;42443;1248;2.3;0.1
69;2021-01-31;65;0;42508;1248;2.3;0.1
69;2021-02-01;1112;401;43620;1649;2.3;0.1
69;2021-02-02;1560;426;45180;2075;2.4;0.1
69;2021-02-03;1444;537;46624;2612;2.5;0.1
69;2021-02-04;1797;954;48421;3566;2.6;0.2
69;2021-02-05;821;823;49242;4389;2.6;0.2
69;2021-02-06;370;53;49612;4442;2.6;0.2
69;2021-02-07;0;0;49612;4442;2.6;0.2
69;2021-02-08;1132;1075;50744;5517;2.7;0.3
69;2021-02-09;2052;2116;52796;7633;2.8;0.4
69;2021-02-10;1855;2657;54651;10290;2.9;0.5
69;2021-02-11;1860;3297;56511;13587;3.0;0.7
69;2021-02-12;1906;2101;58417;15688;3.1;0.8
69;2021-02-13;460;788;58877;16476;3.1;0.9
69;2021-02-14;89;39;58966;16515;3.1;0.9
69;2021-02-15;1016;1764;59982;18279;3.2;1.0
69;2021-02-16;984;2438;60966;20717;3.2;1.1
69;2021-02-17;1026;2390;61992;23107;3.3;1.2
69;2021-02-18;967;2302;62959;25409;3.4;1.4
69;2021-02-19;890;1873;63849;27282;3.4;1.5
69;2021-02-20;321;911;64170;28193;3.4;1.5
69;2021-02-21;53;70;64223;28263;3.4;1.5
69;2021-02-22;609;2100;64832;30363;3.5;1.6
69;2021-02-23;741;2221;65573;32584;3.5;1.7
69;2021-02-24;973;2251;66546;34835;3.5;1.9
69;2021-02-25;2214;2689;68760;37524;3.7;2.0
69;2021-02-26;2772;1932;71532;39456;3.8;2.1
69;2021-02-27;925;576;72457;40032;3.9;2.1
69;2021-02-28;148;104;72605;40136;3.9;2.1
69;2021-03-01;2170;914;74775;41050;4.0;2.2
69;2021-03-02;3299;1430;78074;42480;4.2;2.3
69;2021-03-03;3671;1246;81745;43726;4.4;2.3
69;2021-03-04;4887;1319;86632;45045;4.6;2.4
69;2021-03-05;5874;1280;92506;46325;4.9;2.5
69;2021-03-06;3417;434;95923;46759;5.1;2.5
69;2021-03-07;640;44;96563;46803;5.1;2.5
69;2021-03-08;2962;1134;99525;47937;5.3;2.6
69;2021-03-09;4607;1282;104132;49219;5.6;2.6
69;2021-03-10;5074;1071;109206;50290;5.8;2.7
69;2021-03-11;6603;1082;115809;51372;6.2;2.7
69;2021-03-12;8856;1251;124665;52623;6.6;2.8
69;2021-03-13;4928;256;129593;52879;6.9;2.8
69;2021-03-14;2741;158;132334;53037;7.1;2.8
69;2021-03-15;4804;742;137138;53779;7.3;2.9
69;2021-03-16;3820;677;140958;54456;7.5;2.9
69;2021-03-17;3953;906;144911;55362;7.7;3.0
69;2021-03-18;4965;1636;149876;56998;8.0;3.0
69;2021-03-19;6685;1087;156561;58085;8.3;3.1
69;2021-03-20;3593;286;160154;58371;8.5;3.1
69;2021-03-21;1975;104;162129;58475;8.6;3.1
69;2021-03-22;4550;830;166679;59305;8.9;3.2
69;2021-03-23;7364;852;174043;60157;9.3;3.2
69;2021-03-24;6456;1024;180499;61181;9.6;3.3
69;2021-03-25;8595;1144;189094;62325;10.1;3.3
69;2021-03-26;8813;1272;197907;63597;10.5;3.4
69;2021-03-27;3157;802;201064;64399;10.7;3.4
69;2021-03-28;2219;192;203283;64591;10.8;3.4
69;2021-03-29;4097;2200;207380;66791;11.1;3.6
69;2021-03-30;7640;2573;215020;69364;11.5;3.7
69;2021-03-31;6356;3200;221376;72564;11.8;3.9
69;2021-04-01;8463;2763;229839;75327;12.3;4.0
69;2021-04-02;8315;3150;238154;78477;12.7;4.2
69;2021-04-03;5424;2174;243578;80651;13.0;4.3
69;2021-04-04;6610;556;250188;81207;13.3;4.3
69;2021-04-05;6192;823;256380;82030;13.7;4.4
69;2021-04-06;5114;3498;261494;85528;13.9;4.6
69;2021-04-07;5168;3910;266662;89438;14.2;4.8
69;2021-04-08;6430;4060;273092;93498;14.6;5.0
69;2021-04-09;9165;3802;282257;97300;15.0;5.2
69;2021-04-10;3055;2512;285312;99812;15.2;5.3
69;2021-04-11;2035;1904;287347;101716;15.3;5.4
69;2021-04-12;5474;3592;292821;105308;15.6;5.6
69;2021-04-13;7068;4135;299889;109443;16.0;5.8
69;2021-04-14;6718;4170;306607;113613;16.3;6.1
69;2021-04-15;7943;4617;314550;118230;16.8;6.3
69;2021-04-16;7868;4520;322418;122750;17.2;6.5
69;2021-04-17;5036;2319;327454;125069;17.5;6.7
69;2021-04-18;1715;1796;329169;126865;17.5;6.8
69;2021-04-19;7020;3782;336189;130647;17.9;7.0
69;2021-04-20;6485;4779;342674;135426;18.3;7.2
69;2021-04-21;5691;4428;348365;139854;18.6;7.5
69;2021-04-22;6427;5457;354792;145311;18.9;7.7
69;2021-04-23;6737;4918;361529;150229;19.3;8.0
69;2021-04-24;3160;2037;364689;152266;19.4;8.1
69;2021-04-25;2120;1548;366809;153814;19.6;8.2
69;2021-04-26;4495;3886;371304;157700;19.8;8.4
69;2021-04-27;6516;5336;377820;163036;20.1;8.7
69;2021-04-28;6272;4875;384092;167911;20.5;9.0
69;2021-04-29;6706;5408;390798;173319;20.8;9.2
69;2021-04-30;6931;6193;397729;179512;21.2;9.6
69;2021-05-01;3301;646;401030;180158;21.4;9.6
69;2021-05-02;1628;5885;402658;186043;21.5;9.9
69;2021-05-03;5860;8256;408518;194299;21.8;10.4
69;2021-05-04;7608;8180;416126;202479;22.2;10.8
69;2021-05-05;11210;5666;427336;208145;22.8;11.1
69;2021-05-06;12470;6310;439806;214455;23.4;11.4
69;2021-05-07;11685;7173;451491;221628;24.1;11.8
69;2021-05-08;4303;1658;455794;223286;24.3;11.9
69;2021-05-09;6634;2684;462428;225970;24.6;12.0
69;2021-05-10;6935;6076;469363;232046;25.0;12.4
69;2021-05-11;9829;7048;479192;239094;25.5;12.7
69;2021-05-12;12450;6813;491642;245907;26.2;13.1
69;2021-05-13;10838;2562;502480;248469;26.8;13.2
69;2021-05-14;12599;5217;515079;253686;27.5;13.5
69;2021-05-15;9136;2591;524215;256277;27.9;13.7
69;2021-05-16;8403;1876;532618;258153;28.4;13.8
69;2021-05-17;11306;5651;543924;263804;29.0;14.1
69;2021-05-18;13226;6401;557150;270205;29.7;14.4
69;2021-05-19;13696;5888;570846;276093;30.4;14.7
69;2021-05-20;11387;6087;582233;282180;31.0;15.0
69;2021-05-21;11036;6559;593269;288739;31.6;15.4
69;2021-05-22;5574;2577;598843;291316;31.9;15.5
69;2021-05-23;4573;1543;603416;292859;32.2;15.6
69;2021-05-24;8420;1864;611836;294723;32.6;15.7
69;2021-05-25;9741;6179;621577;300902;33.1;16.0
69;2021-05-26;10281;6110;631858;307012;33.7;16.4
69;2021-05-27;10429;6788;642287;313800;34.2;16.7
69;2021-05-28;11609;8754;653896;322554;34.9;17.2
69;2021-05-29;7387;6047;661283;328601;35.2;17.5
69;2021-05-30;7387;3169;668670;331770;35.6;17.7
69;2021-05-31;10955;6380;679625;338150;36.2;18.0
69;2021-06-01;12844;7520;692469;345670;36.9;18.4
69;2021-06-02;14887;6724;707356;352394;37.7;18.8
69;2021-06-03;16641;7432;723997;359826;38.6;19.2
69;2021-06-04;16199;8565;740196;368391;39.5;19.6
69;2021-06-05;10105;3420;750301;371811;40.0;19.8
69;2021-06-06;7488;1720;757789;373531;40.4;19.9
69;2021-06-07;12815;7028;770604;380559;41.1;20.3
69;2021-06-08;16309;8282;786913;388841;41.9;20.7
69;2021-06-09;15212;7361;802125;396202;42.8;21.1
69;2021-06-10;16277;7337;818402;403539;43.6;21.5
69;2021-06-11;16635;9690;835037;413229;44.5;22.0
69;2021-06-12;8529;4188;843566;417417;45.0;22.2
69;2021-06-13;5620;2146;849186;419563;45.3;22.4
69;2021-06-14;8574;9085;857760;428648;45.7;22.8
69;2021-06-15;10932;11015;868692;439663;46.3;23.4
69;2021-06-16;11332;12321;880024;451984;46.9;24.1
69;2021-06-17;11454;13260;891478;465244;47.5;24.8
69;2021-06-18;12043;14775;903521;480019;48.2;25.6
69;2021-06-19;6813;8355;910334;488374;48.5;26.0
69;2021-06-20;5274;4768;915608;493142;48.8;26.3
69;2021-06-21;6537;12119;922145;505261;49.2;26.9
69;2021-06-22;7211;13836;929356;519097;49.5;27.7
69;2021-06-23;8347;13028;937703;532125;50.0;28.4
69;2021-06-24;9293;13744;946996;545869;50.5;29.1
69;2021-06-25;7079;16311;954075;562180;50.9;30.0
69;2021-06-26;3871;9073;957946;571253;51.1;30.4
69;2021-06-27;3291;7420;961237;578673;51.2;30.8
69;2021-06-28;4551;14893;965788;593566;51.5;31.6
69;2021-06-29;5367;15669;971155;609235;51.8;32.5
69;2021-06-30;6387;14452;977542;623687;52.1;33.2
69;2021-07-01;9054;11980;986596;635667;52.6;33.9
69;2021-07-02;10688;14130;997284;649797;53.2;34.6
69;2021-07-03;5994;7771;1003278;657568;53.5;35.1
69;2021-07-04;4126;5551;1007404;663119;53.7;35.3
69;2021-07-05;6229;13021;1013633;676140;54.0;36.0
69;2021-07-06;5914;14280;1019547;690420;54.3;36.8
69;2021-07-07;7318;13563;1026865;703983;54.7;37.5
69;2021-07-08;7587;13409;1034452;717392;55.1;38.2
69;2021-07-09;7583;16480;1042035;733872;55.5;39.1
69;2021-07-10;3124;10312;1045159;744184;55.7;39.7
69;2021-07-11;4331;5830;1049490;750014;55.9;40.0
69;2021-07-12;4212;16969;1053702;766983;56.2;40.9
69;2021-07-13;6451;20719;1060153;787702;56.5;42.0
69;2021-07-14;5054;8482;1065207;796184;56.8;42.4
69;2021-07-15;7498;22583;1072705;818767;57.2;43.6
69;2021-07-16;9963;20119;1082668;838886;57.7;44.7
69;2021-07-17;4882;12239;1087550;851125;58.0;45.4
69;2021-07-18;3411;8894;1090961;860019;58.2;45.8
69;2021-07-19;7071;16463;1098032;876482;58.5;46.7
69;2021-07-20;9581;19307;1107613;895789;59.0;47.7
69;2021-07-21;9387;17424;1117000;913213;59.5;48.7
69;2021-07-22;11472;16402;1128472;929615;60.2;49.6
69;2021-07-23;11140;17688;1139612;947303;60.7;50.5
69;2021-07-24;5706;11049;1145318;958352;61.0;51.1
69;2021-07-25;4706;6630;1150024;964982;61.3;51.4
69;2021-07-26;8927;12952;1158951;977934;61.8;52.1
69;2021-07-27;12939;12097;1171890;990031;62.5;52.8
69;2021-07-28;12092;12158;1183982;1002189;63.1;53.4
69;2021-07-29;14762;12263;1198744;1014452;63.9;54.1
69;2021-07-30;14417;12245;1213161;1026697;64.7;54.7
69;2021-07-31;8270;7255;1221431;1033952;65.1;55.1
69;2021-08-01;5187;5881;1226618;1039833;65.4;55.4
69;2021-08-02;13262;9640;1239880;1049473;66.1;55.9
69;2021-08-03;13290;8989;1253170;1058462;66.8;56.4
69;2021-08-04;14352;8141;1267522;1066603;67.6;56.9
69;2021-08-05;11531;7540;1279053;1074143;68.2;57.3
69;2021-08-06;10607;7798;1289660;1081941;68.7;57.7
69;2021-08-07;5006;4811;1294666;1086752;69.0;57.9
69;2021-08-08;4371;3565;1299037;1090317;69.2;58.1
69;2021-08-09;7778;9219;1306815;1099536;69.7;58.6
69;2021-08-10;8088;7041;1314903;1106577;70.1;59.0
69;2021-08-11;7898;8113;1322801;1114690;70.5;59.4
69;2021-08-12;7315;7333;1330116;1122023;70.9;59.8
69;2021-08-13;6746;8361;1336862;1130384;71.3;60.3
69;2021-08-14;4512;5210;1341374;1135594;71.5;60.5
69;2021-08-15;2490;2522;1343864;1138116;71.6;60.7
69;2021-08-16;5936;8882;1349800;1146998;71.9;61.1
69;2021-08-17;6418;8275;1356218;1155273;72.3;61.6
69;2021-08-18;6251;9473;1362469;1164746;72.6;62.1
69;2021-08-19;6336;9335;1368805;1174081;73.0;62.6
69;2021-08-20;6187;8845;1374992;1182926;73.3;63.1
69;2021-08-21;2862;3958;1377854;1186884;73.4;63.3
69;2021-08-22;1965;2420;1379819;1189304;73.5;63.4
69;2021-08-23;3947;12384;1383766;1201688;73.8;64.1
69;2021-08-24;5190;13643;1388956;1215331;74.0;64.8
69;2021-08-25;4554;12910;1393510;1228241;74.3;65.5
69;2021-08-26;4559;11736;1398069;1239977;74.5;66.1
69;2021-08-27;4308;14451;1402377;1254428;74.8;66.9
69;2021-08-28;1966;8635;1404343;1263063;74.9;67.3
69;2021-08-29;1339;6527;1405682;1269590;74.9;67.7
69;2021-08-30;3259;11733;1408941;1281323;75.1;68.3
69;2021-08-31;4199;9999;1413140;1291322;75.3;68.8
69;2021-09-01;4997;9452;1418137;1300774;75.6;69.3
69;2021-09-02;4429;8373;1422566;1309147;75.8;69.8
69;2021-09-03;4397;10433;1426963;1319580;76.1;70.3
69;2021-09-04;2972;8538;1429935;1328118;76.2;70.8
69;2021-09-05;1425;3618;1431360;1331736;76.3;71.0
69;2021-09-06;2345;6130;1433705;1337866;76.4;71.3
69;2021-09-07;2382;6052;1436087;1343918;76.5;71.6
69;2021-09-08;2686;6822;1438773;1350740;76.7;72.0
69;2021-09-09;2389;5809;1441162;1356549;76.8;72.3
69;2021-09-10;2636;6655;1443798;1363204;77.0;72.7
69;2021-09-11;1729;5063;1445527;1368267;77.1;72.9
69;2021-09-12;526;2225;1446053;1370492;77.1;73.1
69;2021-09-13;1674;4552;1447727;1375044;77.2;73.3
69;2021-09-14;1802;4216;1449529;1379260;77.3;73.5
69;2021-09-15;1860;5052;1451389;1384312;77.4;73.8
69;2021-09-16;1517;3492;1452906;1387804;77.4;74.0
69;2021-09-17;1793;4888;1454699;1392692;77.5;74.2
69;2021-09-18;1113;4090;1455812;1396782;77.6;74.5
69;2021-09-19;479;1523;1456291;1398305;77.6;74.5
69;2021-09-20;987;2993;1457278;1401298;77.7;74.7
69;2021-09-21;974;3513;1458252;1404811;77.7;74.9
69;2021-09-22;1146;4071;1459398;1408882;77.8;75.1
69;2021-09-23;905;3070;1460303;1411952;77.8;75.3
69;2021-09-24;1244;4186;1461547;1416138;77.9;75.5
69;2021-09-25;725;2738;1462272;1418876;77.9;75.6
69;2021-09-26;296;1213;1462568;1420089;78.0;75.7
69;2021-09-27;663;2043;1463231;1422132;78.0;75.8
69;2021-09-28;924;2106;1464155;1424238;78.0;75.9
69;2021-09-29;1142;3294;1465297;1427532;78.1;76.1
69;2021-09-30;936;2361;1466233;1429893;78.2;76.2
69;2021-10-01;1510;3538;1467743;1433431;78.2;76.4
69;2021-10-02;948;2268;1468691;1435699;78.3;76.5
69;2021-10-03;316;648;1469007;1436347;78.3;76.6
69;2021-10-04;779;2018;1469786;1438365;78.3;76.7
69;2021-10-05;772;1830;1470558;1440195;78.4;76.8
69;2021-10-06;1088;2424;1471646;1442619;78.4;76.9
69;2021-10-07;869;1791;1472515;1444410;78.5;77.0
69;2021-10-08;1249;3019;1473764;1447429;78.6;77.2
69;2021-10-09;732;1558;1474496;1448987;78.6;77.2
69;2021-10-10;54;415;1474550;1449402;78.6;77.3
69;2021-10-11;567;1769;1475117;1451171;78.6;77.4
70;2020-12-27;0;0;0;0;0.0;0.0
70;2020-12-28;0;0;0;0;0.0;0.0
70;2020-12-29;0;0;0;0;0.0;0.0
70;2020-12-30;0;0;0;0;0.0;0.0
70;2020-12-31;0;0;0;0;0.0;0.0
70;2021-01-01;0;0;0;0;0.0;0.0
70;2021-01-02;0;0;0;0;0.0;0.0
70;2021-01-03;0;0;0;0;0.0;0.0
70;2021-01-04;0;0;0;0;0.0;0.0
70;2021-01-05;1;1;1;1;0.0;0.0
70;2021-01-06;24;0;25;1;0.0;0.0
70;2021-01-07;121;0;146;1;0.1;0.0
70;2021-01-08;22;0;168;1;0.1;0.0
70;2021-01-09;0;0;168;1;0.1;0.0
70;2021-01-10;0;0;168;1;0.1;0.0
70;2021-01-11;148;1;316;2;0.1;0.0
70;2021-01-12;201;1;517;3;0.2;0.0
70;2021-01-13;172;2;689;5;0.3;0.0
70;2021-01-14;148;6;837;11;0.4;0.0
70;2021-01-15;153;1;990;12;0.4;0.0
70;2021-01-16;65;0;1055;12;0.5;0.0
70;2021-01-17;0;0;1055;12;0.5;0.0
70;2021-01-18;398;0;1453;12;0.6;0.0
70;2021-01-19;503;2;1956;14;0.8;0.0
70;2021-01-20;494;2;2450;16;1.1;0.0
70;2021-01-21;675;3;3125;19;1.3;0.0
70;2021-01-22;458;3;3583;22;1.5;0.0
70;2021-01-23;261;2;3844;24;1.6;0.0
70;2021-01-24;4;0;3848;24;1.7;0.0
70;2021-01-25;369;1;4217;25;1.8;0.0
70;2021-01-26;335;1;4552;26;2.0;0.0
70;2021-01-27;331;12;4883;38;2.1;0.0
70;2021-01-28;366;36;5249;74;2.3;0.0
70;2021-01-29;329;52;5578;126;2.4;0.1
70;2021-01-30;228;1;5806;127;2.5;0.1
70;2021-01-31;0;0;5806;127;2.5;0.1
70;2021-02-01;262;52;6068;179;2.6;0.1
70;2021-02-02;272;98;6340;277;2.7;0.1
70;2021-02-03;250;61;6590;338;2.8;0.1
70;2021-02-04;265;125;6855;463;2.9;0.2
70;2021-02-05;254;75;7109;538;3.0;0.2
70;2021-02-06;209;38;7318;576;3.1;0.2
70;2021-02-07;0;0;7318;576;3.1;0.2
70;2021-02-08;179;234;7497;810;3.2;0.3
70;2021-02-09;206;229;7703;1039;3.3;0.4
70;2021-02-10;196;305;7899;1344;3.4;0.6
70;2021-02-11;351;338;8250;1682;3.5;0.7
70;2021-02-12;239;492;8489;2174;3.6;0.9
70;2021-02-13;75;210;8564;2384;3.7;1.0
70;2021-02-14;0;29;8564;2413;3.7;1.0
70;2021-02-15;70;339;8634;2752;3.7;1.2
70;2021-02-16;113;362;8747;3114;3.8;1.3
70;2021-02-17;165;302;8912;3416;3.8;1.5
70;2021-02-18;205;257;9117;3673;3.9;1.6
70;2021-02-19;197;204;9314;3877;4.0;1.7
70;2021-02-20;192;69;9506;3946;4.1;1.7
70;2021-02-21;1;0;9507;3946;4.1;1.7
70;2021-02-22;106;238;9613;4184;4.1;1.8
70;2021-02-23;125;261;9738;4445;4.2;1.9
70;2021-02-24;132;234;9870;4679;4.2;2.0
70;2021-02-25;315;259;10185;4938;4.4;2.1
70;2021-02-26;395;151;10580;5089;4.5;2.2
70;2021-02-27;147;202;10727;5291;4.6;2.3
70;2021-02-28;0;0;10727;5291;4.6;2.3
70;2021-03-01;248;243;10975;5534;4.7;2.4
70;2021-03-02;487;278;11462;5812;4.9;2.5
70;2021-03-03;468;260;11930;6072;5.1;2.6
70;2021-03-04;693;278;12623;6350;5.4;2.7
70;2021-03-05;767;262;13390;6612;5.7;2.8
70;2021-03-06;539;118;13929;6730;6.0;2.9
70;2021-03-07;216;23;14145;6753;6.1;2.9
70;2021-03-08;554;214;14699;6967;6.3;3.0
70;2021-03-09;864;176;15563;7143;6.7;3.1
70;2021-03-10;659;179;16222;7322;7.0;3.1
70;2021-03-11;698;256;16920;7578;7.3;3.2
70;2021-03-12;985;181;17905;7759;7.7;3.3
70;2021-03-13;582;123;18487;7882;7.9;3.4
70;2021-03-14;20;1;18507;7883;7.9;3.4
70;2021-03-15;774;112;19281;7995;8.3;3.4
70;2021-03-16;655;99;19936;8094;8.5;3.5
70;2021-03-17;595;183;20531;8277;8.8;3.5
70;2021-03-18;633;141;21164;8418;9.1;3.6
70;2021-03-19;1019;143;22183;8561;9.5;3.7
70;2021-03-20;641;186;22824;8747;9.8;3.8
70;2021-03-21;9;0;22833;8747;9.8;3.8
70;2021-03-22;757;101;23590;8848;10.1;3.8
70;2021-03-23;1310;165;24900;9013;10.7;3.9
70;2021-03-24;1270;111;26170;9124;11.2;3.9
70;2021-03-25;1247;201;27417;9325;11.8;4.0
70;2021-03-26;1485;304;28902;9629;12.4;4.1
70;2021-03-27;956;129;29858;9758;12.8;4.2
70;2021-03-28;0;10;29858;9768;12.8;4.2
70;2021-03-29;721;417;30579;10185;13.1;4.4
70;2021-03-30;1093;317;31672;10502;13.6;4.5
70;2021-03-31;878;318;32550;10820;14.0;4.6
70;2021-04-01;1153;429;33703;11249;14.5;4.8
70;2021-04-02;1310;348;35013;11597;15.0;5.0
70;2021-04-03;639;323;35652;11920;15.3;5.1
70;2021-04-04;11;1;35663;11921;15.3;5.1
70;2021-04-05;4;2;35667;11923;15.3;5.1
70;2021-04-06;831;558;36498;12481;15.7;5.4
70;2021-04-07;858;590;37356;13071;16.0;5.6
70;2021-04-08;1319;567;38675;13638;16.6;5.8
70;2021-04-09;1402;541;40077;14179;17.2;6.1
70;2021-04-10;859;346;40936;14525;17.6;6.2
70;2021-04-11;23;1;40959;14526;17.6;6.2
70;2021-04-12;696;662;41655;15188;17.9;6.5
70;2021-04-13;921;770;42576;15958;18.3;6.8
70;2021-04-14;816;579;43392;16537;18.6;7.1
70;2021-04-15;1079;608;44471;17145;19.1;7.4
70;2021-04-16;1242;554;45713;17699;19.6;7.6
70;2021-04-17;688;469;46401;18168;19.9;7.8
70;2021-04-18;62;4;46463;18172;19.9;7.8
70;2021-04-19;540;810;47003;18982;20.2;8.1
70;2021-04-20;663;852;47666;19834;20.4;8.5
70;2021-04-21;483;932;48149;20766;20.6;8.9
70;2021-04-22;775;802;48924;21568;21.0;9.2
70;2021-04-23;875;743;49799;22311;21.4;9.6
70;2021-04-24;432;642;50231;22953;21.5;9.8
70;2021-04-25;11;0;50242;22953;21.5;9.8
70;2021-04-26;923;605;51165;23558;21.9;10.1
70;2021-04-27;1208;756;52373;24314;22.5;10.4
70;2021-04-28;889;811;53262;25125;22.8;10.8
70;2021-04-29;1342;935;54604;26060;23.4;11.2
70;2021-04-30;1533;876;56137;26936;24.1;11.6
70;2021-05-01;1694;121;57831;27057;24.8;11.6
70;2021-05-02;2;0;57833;27057;24.8;11.6
70;2021-05-03;1189;582;59022;27639;25.3;11.9
70;2021-05-04;1353;758;60375;28397;25.9;12.2
70;2021-05-05;1188;880;61563;29277;26.4;12.6
70;2021-05-06;1845;1271;63408;30548;27.2;13.1
70;2021-05-07;2127;1247;65535;31795;28.1;13.6
70;2021-05-08;1342;194;66877;31989;28.7;13.7
70;2021-05-09;9;58;66886;32047;28.7;13.7
70;2021-05-10;961;947;67847;32994;29.1;14.1
70;2021-05-11;1240;1080;69087;34074;29.6;14.6
70;2021-05-12;1175;866;70262;34940;30.1;15.0
70;2021-05-13;1544;147;71806;35087;30.8;15.0
70;2021-05-14;2062;757;73868;35844;31.7;15.4
70;2021-05-15;2656;531;76524;36375;32.8;15.6
70;2021-05-16;999;72;77523;36447;33.2;15.6
70;2021-05-17;1237;386;78760;36833;33.8;15.8
70;2021-05-18;1296;591;80056;37424;34.3;16.0
70;2021-05-19;1476;480;81532;37904;35.0;16.3
70;2021-05-20;1779;632;83311;38536;35.7;16.5
70;2021-05-21;1692;823;85003;39359;36.5;16.9
70;2021-05-22;1219;666;86222;40025;37.0;17.2
70;2021-05-23;8;14;86230;40039;37.0;17.2
70;2021-05-24;227;28;86457;40067;37.1;17.2
70;2021-05-25;837;926;87294;40993;37.4;17.6
70;2021-05-26;1048;946;88342;41939;37.9;18.0
70;2021-05-27;1263;998;89605;42937;38.4;18.4
70;2021-05-28;1546;1161;91151;44098;39.1;18.9
70;2021-05-29;1370;588;92521;44686;39.7;19.2
70;2021-05-30;1;8;92522;44694;39.7;19.2
70;2021-05-31;969;679;93491;45373;40.1;19.5
70;2021-06-01;1213;848;94704;46221;40.6;19.8
70;2021-06-02;1265;680;95969;46901;41.2;20.1
70;2021-06-03;1429;837;97398;47738;41.8;20.5
70;2021-06-04;1335;1111;98733;48849;42.3;20.9
70;2021-06-05;1024;663;99757;49512;42.8;21.2
70;2021-06-06;599;79;100356;49591;43.0;21.3
70;2021-06-07;941;848;101297;50439;43.4;21.6
70;2021-06-08;1216;1187;102513;51626;44.0;22.1
70;2021-06-09;1156;987;103669;52613;44.5;22.6
70;2021-06-10;1567;831;105236;53444;45.1;22.9
70;2021-06-11;1586;1959;106822;55403;45.8;23.8
70;2021-06-12;829;1970;107651;57373;46.2;24.6
70;2021-06-13;143;15;107794;57388;46.2;24.6
70;2021-06-14;559;1243;108353;58631;46.5;25.1
70;2021-06-15;451;1506;108804;60137;46.7;25.8
70;2021-06-16;798;1391;109602;61528;47.0;26.4
70;2021-06-17;1154;2098;110756;63626;47.5;27.3
70;2021-06-18;995;2254;111751;65880;47.9;28.3
70;2021-06-19;1092;1639;112843;67519;48.4;29.0
70;2021-06-20;1;3;112844;67522;48.4;29.0
70;2021-06-21;691;1453;113535;68975;48.7;29.6
70;2021-06-22;655;1513;114190;70488;49.0;30.2
70;2021-06-23;662;1569;114852;72057;49.3;30.9
70;2021-06-24;877;2049;115729;74106;49.6;31.8
70;2021-06-25;681;2649;116410;76755;49.9;32.9
70;2021-06-26;943;2136;117353;78891;50.3;33.8
70;2021-06-27;141;763;117494;79654;50.4;34.2
70;2021-06-28;335;1353;117829;81007;50.5;34.7
70;2021-06-29;411;1611;118240;82618;50.7;35.4
70;2021-06-30;390;1633;118630;84251;50.9;36.1
70;2021-07-01;642;1751;119272;86002;51.1;36.9
70;2021-07-02;815;1578;120087;87580;51.5;37.6
70;2021-07-03;841;1084;120928;88664;51.9;38.0
70;2021-07-04;29;70;120957;88734;51.9;38.1
70;2021-07-05;610;1037;121567;89771;52.1;38.5
70;2021-07-06;681;1274;122248;91045;52.4;39.0
70;2021-07-07;508;1425;122756;92470;52.6;39.7
70;2021-07-08;817;1574;123573;94044;53.0;40.3
70;2021-07-09;873;1662;124446;95706;53.4;41.0
70;2021-07-10;831;1033;125277;96739;53.7;41.5
70;2021-07-11;7;20;125284;96759;53.7;41.5
70;2021-07-12;432;1391;125716;98150;53.9;42.1
70;2021-07-13;907;1868;126623;100018;54.3;42.9
70;2021-07-14;33;6;126656;100024;54.3;42.9
70;2021-07-15;1382;1694;128038;101718;54.9;43.6
70;2021-07-16;1632;2061;129670;103779;55.6;44.5
70;2021-07-17;1501;1454;131171;105233;56.2;45.1
70;2021-07-18;1145;641;132316;105874;56.7;45.4
70;2021-07-19;883;976;133199;106850;57.1;45.8
70;2021-07-20;1349;1352;134548;108202;57.7;46.4
70;2021-07-21;1286;1402;135834;109604;58.2;47.0
70;2021-07-22;1867;1827;137701;111431;59.0;47.8
70;2021-07-23;1826;2491;139527;113922;59.8;48.9
70;2021-07-24;1364;1806;140891;115728;60.4;49.6
70;2021-07-25;27;3;140918;115731;60.4;49.6
70;2021-07-26;1055;975;141973;116706;60.9;50.0
70;2021-07-27;1398;976;143371;117682;61.5;50.5
70;2021-07-28;1404;1162;144775;118844;62.1;51.0
70;2021-07-29;1873;1387;146648;120231;62.9;51.6
70;2021-07-30;1975;1348;148623;121579;63.7;52.1
70;2021-07-31;1751;1166;150374;122745;64.5;52.6
70;2021-08-01;2;4;150376;122749;64.5;52.6
70;2021-08-02;776;737;151152;123486;64.8;53.0
70;2021-08-03;1296;1039;152448;124525;65.4;53.4
70;2021-08-04;1210;922;153658;125447;65.9;53.8
70;2021-08-05;1657;1191;155315;126638;66.6;54.3
70;2021-08-06;1795;1336;157110;127974;67.4;54.9
70;2021-08-07;1192;1032;158302;129006;67.9;55.3
70;2021-08-08;35;28;158337;129034;67.9;55.3
70;2021-08-09;533;704;158870;129738;68.1;55.6
70;2021-08-10;898;1131;159768;130869;68.5;56.1
70;2021-08-11;808;722;160576;131591;68.9;56.4
70;2021-08-12;906;1272;161482;132863;69.2;57.0
70;2021-08-13;1040;1621;162522;134484;69.7;57.7
70;2021-08-14;771;977;163293;135461;70.0;58.1
70;2021-08-15;36;28;163329;135489;70.0;58.1
70;2021-08-16;545;910;163874;136399;70.3;58.5
70;2021-08-17;680;1194;164554;137593;70.6;59.0
70;2021-08-18;535;939;165089;138532;70.8;59.4
70;2021-08-19;565;1385;165654;139917;71.0;60.0
70;2021-08-20;510;1900;166164;141817;71.3;60.8
70;2021-08-21;447;1163;166611;142980;71.4;61.3
70;2021-08-22;2;6;166613;142986;71.4;61.3
70;2021-08-23;282;879;166895;143865;71.6;61.7
70;2021-08-24;386;1373;167281;145238;71.7;62.3
70;2021-08-25;354;1344;167635;146582;71.9;62.9
70;2021-08-26;439;1560;168074;148142;72.1;63.5
70;2021-08-27;392;2127;168466;150269;72.2;64.4
70;2021-08-28;367;1706;168833;151975;72.4;65.2
70;2021-08-29;12;6;168845;151981;72.4;65.2
70;2021-08-30;298;831;169143;152812;72.5;65.5
70;2021-08-31;360;1121;169503;153933;72.7;66.0
70;2021-09-01;316;987;169819;154920;72.8;66.4
70;2021-09-02;305;1107;170124;156027;73.0;66.9
70;2021-09-03;280;1067;170404;157094;73.1;67.4
70;2021-09-04;455;1117;170859;158211;73.3;67.8
70;2021-09-05;21;22;170880;158233;73.3;67.9
70;2021-09-06;168;602;171048;158835;73.4;68.1
70;2021-09-07;186;746;171234;159581;73.4;68.4
70;2021-09-08;193;777;171427;160358;73.5;68.8
70;2021-09-09;182;734;171609;161092;73.6;69.1
70;2021-09-10;256;798;171865;161890;73.7;69.4
70;2021-09-11;297;891;172162;162781;73.8;69.8
70;2021-09-12;7;30;172169;162811;73.8;69.8
70;2021-09-13;155;354;172324;163165;73.9;70.0
70;2021-09-14;318;422;172642;163587;74.0;70.2
70;2021-09-15;171;533;172813;164120;74.1;70.4
70;2021-09-16;250;392;173063;164512;74.2;70.5
70;2021-09-17;195;457;173258;164969;74.3;70.7
70;2021-09-18;177;459;173435;165428;74.4;70.9
70;2021-09-19;3;14;173438;165442;74.4;70.9
70;2021-09-20;82;215;173520;165657;74.4;71.0
70;2021-09-21;163;279;173683;165936;74.5;71.2
70;2021-09-22;114;384;173797;166320;74.5;71.3
70;2021-09-23;66;229;173863;166549;74.6;71.4
70;2021-09-24;196;389;174059;166938;74.6;71.6
70;2021-09-25;139;504;174198;167442;74.7;71.8
70;2021-09-26;0;1;174198;167443;74.7;71.8
70;2021-09-27;51;201;174249;167644;74.7;71.9
70;2021-09-28;77;195;174326;167839;74.8;72.0
70;2021-09-29;91;240;174417;168079;74.8;72.1
70;2021-09-30;81;158;174498;168237;74.8;72.1
70;2021-10-01;122;250;174620;168487;74.9;72.3
70;2021-10-02;115;326;174735;168813;74.9;72.4
70;2021-10-03;1;1;174736;168814;74.9;72.4
70;2021-10-04;73;169;174809;168983;75.0;72.5
70;2021-10-05;82;289;174891;169272;75.0;72.6
70;2021-10-06;129;213;175020;169485;75.1;72.7
70;2021-10-07;98;225;175118;169710;75.1;72.8
70;2021-10-08;113;222;175231;169932;75.1;72.9
70;2021-10-09;137;302;175368;170234;75.2;73.0
70;2021-10-10;1;5;175369;170239;75.2;73.0
70;2021-10-11;50;109;175419;170348;75.2;73.0
71;2020-12-27;0;0;0;0;0.0;0.0
71;2020-12-28;1;0;1;0;0.0;0.0
71;2020-12-29;0;0;1;0;0.0;0.0
71;2020-12-30;0;0;1;0;0.0;0.0
71;2020-12-31;0;0;1;0;0.0;0.0
71;2021-01-01;1;0;2;0;0.0;0.0
71;2021-01-02;0;0;2;0;0.0;0.0
71;2021-01-03;2;1;4;1;0.0;0.0
71;2021-01-04;1;0;5;1;0.0;0.0
71;2021-01-05;13;0;18;1;0.0;0.0
71;2021-01-06;72;0;90;1;0.0;0.0
71;2021-01-07;67;2;157;3;0.0;0.0
71;2021-01-08;146;0;303;3;0.1;0.0
71;2021-01-09;117;0;420;3;0.1;0.0
71;2021-01-10;1;0;421;3;0.1;0.0
71;2021-01-11;245;1;666;4;0.1;0.0
71;2021-01-12;845;1;1511;5;0.3;0.0
71;2021-01-13;564;2;2075;7;0.4;0.0
71;2021-01-14;591;12;2666;19;0.5;0.0
71;2021-01-15;665;2;3331;21;0.6;0.0
71;2021-01-16;10;0;3341;21;0.6;0.0
71;2021-01-17;0;0;3341;21;0.6;0.0
71;2021-01-18;1095;8;4436;29;0.8;0.0
71;2021-01-19;1694;8;6130;37;1.1;0.0
71;2021-01-20;1517;7;7647;44;1.4;0.0
71;2021-01-21;2062;20;9709;64;1.8;0.0
71;2021-01-22;1414;6;11123;70;2.0;0.0
71;2021-01-23;816;6;11939;76;2.2;0.0
71;2021-01-24;1;1;11940;77;2.2;0.0
71;2021-01-25;1065;6;13005;83;2.4;0.0
71;2021-01-26;1505;29;14510;112;2.6;0.0
71;2021-01-27;1249;34;15759;146;2.9;0.0
71;2021-01-28;1082;99;16841;245;3.1;0.0
71;2021-01-29;1015;142;17856;387;3.3;0.1
71;2021-01-30;604;2;18460;389;3.4;0.1
71;2021-01-31;1;15;18461;404;3.4;0.1
71;2021-02-01;752;238;19213;642;3.5;0.1
71;2021-02-02;754;356;19967;998;3.6;0.2
71;2021-02-03;817;422;20784;1420;3.8;0.3
71;2021-02-04;784;573;21568;1993;3.9;0.4
71;2021-02-05;704;522;22272;2515;4.1;0.5
71;2021-02-06;539;10;22811;2525;4.2;0.5
71;2021-02-07;4;50;22815;2575;4.2;0.5
71;2021-02-08;603;696;23418;3271;4.3;0.6
71;2021-02-09;370;1009;23788;4280;4.3;0.8
71;2021-02-10;412;991;24200;5271;4.4;1.0
71;2021-02-11;477;1181;24677;6452;4.5;1.2
71;2021-02-12;535;1037;25212;7489;4.6;1.4
71;2021-02-13;124;500;25336;7989;4.6;1.5
71;2021-02-14;2;7;25338;7996;4.6;1.5
71;2021-02-15;322;908;25660;8904;4.7;1.6
71;2021-02-16;445;1353;26105;10257;4.8;1.9
71;2021-02-17;427;1128;26532;11385;4.8;2.1
71;2021-02-18;548;930;27080;12315;4.9;2.2
71;2021-02-19;571;844;27651;13159;5.0;2.4
71;2021-02-20;224;382;27875;13541;5.1;2.5
71;2021-02-21;4;13;27879;13554;5.1;2.5
71;2021-02-22;237;871;28116;14425;5.1;2.6
71;2021-02-23;452;929;28568;15354;5.2;2.8
71;2021-02-24;446;719;29014;16073;5.3;2.9
71;2021-02-25;533;724;29547;16797;5.4;3.1
71;2021-02-26;831;539;30378;17336;5.5;3.2
71;2021-02-27;456;335;30834;17671;5.6;3.2
71;2021-02-28;54;14;30888;17685;5.6;3.2
71;2021-03-01;1188;683;32076;18368;5.9;3.4
71;2021-03-02;1573;650;33649;19018;6.1;3.5
71;2021-03-03;1818;774;35467;19792;6.5;3.6
71;2021-03-04;2001;827;37468;20619;6.8;3.8
71;2021-03-05;2286;699;39754;21318;7.3;3.9
71;2021-03-06;754;66;40508;21384;7.4;3.9
71;2021-03-07;40;21;40548;21405;7.4;3.9
71;2021-03-08;1454;789;42002;22194;7.7;4.1
71;2021-03-09;2162;536;44164;22730;8.1;4.1
71;2021-03-10;2173;482;46337;23212;8.5;4.2
71;2021-03-11;2630;677;48967;23889;8.9;4.4
71;2021-03-12;2603;632;51570;24521;9.4;4.5
71;2021-03-13;995;102;52565;24623;9.6;4.5
71;2021-03-14;36;0;52601;24623;9.6;4.5
71;2021-03-15;1797;501;54398;25124;9.9;4.6
71;2021-03-16;1821;204;56219;25328;10.3;4.6
71;2021-03-17;2135;257;58354;25585;10.7;4.7
71;2021-03-18;1954;441;60308;26026;11.0;4.8
71;2021-03-19;2370;342;62678;26368;11.4;4.8
71;2021-03-20;1084;42;63762;26410;11.6;4.8
71;2021-03-21;17;5;63779;26415;11.6;4.8
71;2021-03-22;2575;385;66354;26800;12.1;4.9
71;2021-03-23;3347;509;69701;27309;12.7;5.0
71;2021-03-24;3349;473;73050;27782;13.3;5.1
71;2021-03-25;4029;606;77079;28388;14.1;5.2
71;2021-03-26;4057;347;81136;28735;14.8;5.2
71;2021-03-27;997;107;82133;28842;15.0;5.3
71;2021-03-28;57;8;82190;28850;15.0;5.3
71;2021-03-29;2408;1176;84598;30026;15.4;5.5
71;2021-03-30;2948;1359;87546;31385;16.0;5.7
71;2021-03-31;2546;1532;90092;32917;16.4;6.0
71;2021-04-01;2718;1305;92810;34222;16.9;6.2
71;2021-04-02;2501;1423;95311;35645;17.4;6.5
71;2021-04-03;268;34;95579;35679;17.4;6.5
71;2021-04-04;6;0;95585;35679;17.4;6.5
71;2021-04-05;61;2;95646;35681;17.5;6.5
71;2021-04-06;2257;1882;97903;37563;17.9;6.9
71;2021-04-07;2388;1797;100291;39360;18.3;7.2
71;2021-04-08;3283;1813;103574;41173;18.9;7.5
71;2021-04-09;4040;1678;107614;42851;19.6;7.8
71;2021-04-10;769;49;108383;42900;19.8;7.8
71;2021-04-11;97;4;108480;42904;19.8;7.8
71;2021-04-12;2352;1705;110832;44609;20.2;8.1
71;2021-04-13;2583;1894;113415;46503;20.7;8.5
71;2021-04-14;2375;1928;115790;48431;21.1;8.8
71;2021-04-15;2779;1696;118569;50127;21.6;9.2
71;2021-04-16;2628;1647;121197;51774;22.1;9.5
71;2021-04-17;952;347;122149;52121;22.3;9.5
71;2021-04-18;106;6;122255;52127;22.3;9.5
71;2021-04-19;1758;2573;124013;54700;22.6;10.0
71;2021-04-20;2220;2604;126233;57304;23.0;10.5
71;2021-04-21;2123;2594;128356;59898;23.4;10.9
71;2021-04-22;2512;2450;130868;62348;23.9;11.4
71;2021-04-23;2922;2271;133790;64619;24.4;11.8
71;2021-04-24;517;52;134307;64671;24.5;11.8
71;2021-04-25;26;0;134333;64671;24.5;11.8
71;2021-04-26;2565;2140;136898;66811;25.0;12.2
71;2021-04-27;2990;2274;139888;69085;25.5;12.6
71;2021-04-28;3073;2129;142961;71214;26.1;13.0
71;2021-04-29;3780;2233;146741;73447;26.8;13.4
71;2021-04-30;3926;1730;150667;75177;27.5;13.7
71;2021-05-01;39;53;150706;75230;27.5;13.7
71;2021-05-02;23;18;150729;75248;27.5;13.7
71;2021-05-03;4290;1385;155019;76633;28.3;14.0
71;2021-05-04;2955;2360;157974;78993;28.8;14.4
71;2021-05-05;3426;2089;161400;81082;29.5;14.8
71;2021-05-06;3467;2373;164867;83455;30.1;15.2
71;2021-05-07;3678;2813;168545;86268;30.8;15.7
71;2021-05-08;179;183;168724;86451;30.8;15.8
71;2021-05-09;44;47;168768;86498;30.8;15.8
71;2021-05-10;3696;2293;172464;88791;31.5;16.2
71;2021-05-11;4663;2361;177127;91152;32.3;16.6
71;2021-05-12;3978;2602;181105;93754;33.1;17.1
71;2021-05-13;1576;155;182681;93909;33.3;17.1
71;2021-05-14;3766;2197;186447;96106;34.0;17.5
71;2021-05-15;243;331;186690;96437;34.1;17.6
71;2021-05-16;2;0;186692;96437;34.1;17.6
71;2021-05-17;3864;1887;190556;98324;34.8;17.9
71;2021-05-18;3498;2429;194054;100753;35.4;18.4
71;2021-05-19;3719;2279;197773;103032;36.1;18.8
71;2021-05-20;4184;2300;201957;105332;36.9;19.2
71;2021-05-21;3721;2567;205678;107899;37.5;19.7
71;2021-05-22;169;304;205847;108203;37.6;19.8
71;2021-05-23;14;55;205861;108258;37.6;19.8
71;2021-05-24;21;96;205882;108354;37.6;19.8
71;2021-05-25;2689;3004;208571;111358;38.1;20.3
71;2021-05-26;2972;2434;211543;113792;38.6;20.8
71;2021-05-27;3387;2589;214930;116381;39.2;21.2
71;2021-05-28;2919;3160;217849;119541;39.8;21.8
71;2021-05-29;482;659;218331;120200;39.9;21.9
71;2021-05-30;76;58;218407;120258;39.9;22.0
71;2021-05-31;2774;3455;221181;123713;40.4;22.6
71;2021-06-01;3671;3543;224852;127256;41.0;23.2
71;2021-06-02;3997;2635;228849;129891;41.8;23.7
71;2021-06-03;4435;2524;233284;132415;42.6;24.2
71;2021-06-04;3716;3715;237000;136130;43.3;24.8
71;2021-06-05;684;647;237684;136777;43.4;25.0
71;2021-06-06;57;91;237741;136868;43.4;25.0
71;2021-06-07;3281;4151;241022;141019;44.0;25.7
71;2021-06-08;3894;4010;244916;145029;44.7;26.5
71;2021-06-09;4695;2753;249611;147782;45.6;27.0
71;2021-06-10;5265;2748;254876;150530;46.5;27.5
71;2021-06-11;4435;3722;259311;154252;47.3;28.2
71;2021-06-12;715;595;260026;154847;47.5;28.3
71;2021-06-13;104;187;260130;155034;47.5;28.3
71;2021-06-14;3510;3786;263640;158820;48.1;29.0
71;2021-06-15;4205;3555;267845;162375;48.9;29.6
71;2021-06-16;4595;2731;272440;165106;49.7;30.1
71;2021-06-17;4267;3001;276707;168107;50.5;30.7
71;2021-06-18;4325;3770;281032;171877;51.3;31.4
71;2021-06-19;1269;654;282301;172531;51.5;31.5
71;2021-06-20;37;27;282338;172558;51.5;31.5
71;2021-06-21;2271;4277;284609;176835;52.0;32.3
71;2021-06-22;2689;4356;287298;181191;52.4;33.1
71;2021-06-23;3061;3421;290359;184612;53.0;33.7
71;2021-06-24;3328;3023;293687;187635;53.6;34.3
71;2021-06-25;2652;4473;296339;192108;54.1;35.1
71;2021-06-26;372;551;296711;192659;54.2;35.2
71;2021-06-27;29;67;296740;192726;54.2;35.2
71;2021-06-28;1535;4624;298275;197350;54.4;36.0
71;2021-06-29;1992;4823;300267;202173;54.8;36.9
71;2021-06-30;2503;3937;302770;206110;55.3;37.6
71;2021-07-01;2826;3900;305596;210010;55.8;38.3
71;2021-07-02;3032;3987;308628;213997;56.3;39.1
71;2021-07-03;319;712;308947;214709;56.4;39.2
71;2021-07-04;28;132;308975;214841;56.4;39.2
71;2021-07-05;2474;4322;311449;219163;56.9;40.0
71;2021-07-06;2461;4562;313910;223725;57.3;40.8
71;2021-07-07;2983;3724;316893;227449;57.8;41.5
71;2021-07-08;2766;4111;319659;231560;58.4;42.3
71;2021-07-09;2383;5023;322042;236583;58.8;43.2
71;2021-07-10;212;656;322254;237239;58.8;43.3
71;2021-07-11;15;65;322269;237304;58.8;43.3
71;2021-07-12;1911;5304;324180;242608;59.2;44.3
71;2021-07-13;2537;5863;326717;248471;59.6;45.4
71;2021-07-14;950;401;327667;248872;59.8;45.4
71;2021-07-15;3024;5734;330691;254606;60.4;46.5
71;2021-07-16;3294;6010;333985;260616;61.0;47.6
71;2021-07-17;505;781;334490;261397;61.1;47.7
71;2021-07-18;89;93;334579;261490;61.1;47.7
71;2021-07-19;2865;5553;337444;267043;61.6;48.7
71;2021-07-20;3367;5914;340811;272957;62.2;49.8
71;2021-07-21;3413;5472;344224;278429;62.8;50.8
71;2021-07-22;3945;5334;348169;283763;63.6;51.8
71;2021-07-23;3233;6002;351402;289765;64.1;52.9
71;2021-07-24;715;601;352117;290366;64.3;53.0
71;2021-07-25;148;82;352265;290448;64.3;53.0
71;2021-07-26;3597;4892;355862;295340;65.0;53.9
71;2021-07-27;4090;5123;359952;300463;65.7;54.8
71;2021-07-28;4248;4813;364200;305276;66.5;55.7
71;2021-07-29;4213;4645;368413;309921;67.3;56.6
71;2021-07-30;4241;4926;372654;314847;68.0;57.5
71;2021-07-31;722;723;373376;315570;68.2;57.6
71;2021-08-01;108;35;373484;315605;68.2;57.6
71;2021-08-02;3967;3760;377451;319365;68.9;58.3
71;2021-08-03;4408;3823;381859;323188;69.7;59.0
71;2021-08-04;4391;2986;386250;326174;70.5;59.5
71;2021-08-05;4189;3271;390439;329445;71.3;60.1
71;2021-08-06;3700;4013;394139;333458;71.9;60.9
71;2021-08-07;495;329;394634;333787;72.0;60.9
71;2021-08-08;51;65;394685;333852;72.0;60.9
71;2021-08-09;3045;3410;397730;337262;72.6;61.6
71;2021-08-10;3074;3389;400804;340651;73.2;62.2
71;2021-08-11;3186;3082;403990;343733;73.7;62.7
71;2021-08-12;3016;3106;407006;346839;74.3;63.3
71;2021-08-13;2691;3334;409697;350173;74.8;63.9
71;2021-08-14;282;518;409979;350691;74.8;64.0
71;2021-08-15;49;110;410028;350801;74.8;64.0
71;2021-08-16;1709;3528;411737;354329;75.2;64.7
71;2021-08-17;1739;3433;413476;357762;75.5;65.3
71;2021-08-18;1453;3160;414929;360922;75.7;65.9
71;2021-08-19;1277;3117;416206;364039;76.0;66.5
71;2021-08-20;1290;3699;417496;367738;76.2;67.1
71;2021-08-21;148;413;417644;368151;76.2;67.2
71;2021-08-22;41;99;417685;368250;76.2;67.2
71;2021-08-23;1427;4543;419112;372793;76.5;68.0
71;2021-08-24;1335;3804;420447;376597;76.7;68.7
71;2021-08-25;950;3773;421397;380370;76.9;69.4
71;2021-08-26;958;3393;422355;383763;77.1;70.1
71;2021-08-27;1151;4462;423506;388225;77.3;70.9
71;2021-08-28;195;413;423701;388638;77.3;70.9
71;2021-08-29;29;106;423730;388744;77.3;71.0
71;2021-08-30;1250;3879;424980;392623;77.6;71.7
71;2021-08-31;1022;3479;426002;396102;77.8;72.3
71;2021-09-01;933;3271;426935;399373;77.9;72.9
71;2021-09-02;602;2837;427537;402210;78.0;73.4
71;2021-09-03;836;3680;428373;405890;78.2;74.1
71;2021-09-04;266;530;428639;406420;78.2;74.2
71;2021-09-05;23;52;428662;406472;78.2;74.2
71;2021-09-06;638;2377;429300;408849;78.4;74.6
71;2021-09-07;517;1712;429817;410561;78.5;74.9
71;2021-09-08;720;2188;430537;412749;78.6;75.3
71;2021-09-09;456;1274;430993;414023;78.7;75.6
71;2021-09-10;819;2147;431812;416170;78.8;76.0
71;2021-09-11;199;266;432011;416436;78.9;76.0
71;2021-09-12;19;37;432030;416473;78.9;76.0
71;2021-09-13;642;1283;432672;417756;79.0;76.3
71;2021-09-14;487;1076;433159;418832;79.1;76.5
71;2021-09-15;603;1497;433762;420329;79.2;76.7
71;2021-09-16;447;822;434209;421151;79.3;76.9
71;2021-09-17;534;1437;434743;422588;79.4;77.1
71;2021-09-18;144;262;434887;422850;79.4;77.2
71;2021-09-19;9;28;434896;422878;79.4;77.2
71;2021-09-20;486;924;435382;423802;79.5;77.4
71;2021-09-21;294;711;435676;424513;79.5;77.5
71;2021-09-22;341;1377;436017;425890;79.6;77.7
71;2021-09-23;306;578;436323;426468;79.6;77.8
71;2021-09-24;367;1029;436690;427497;79.7;78.0
71;2021-09-25;71;176;436761;427673;79.7;78.1
71;2021-09-26;11;35;436772;427708;79.7;78.1
71;2021-09-27;287;757;437059;428465;79.8;78.2
71;2021-09-28;288;477;437347;428942;79.8;78.3
71;2021-09-29;332;740;437679;429682;79.9;78.4
71;2021-09-30;208;500;437887;430182;79.9;78.5
71;2021-10-01;332;893;438219;431075;80.0;78.7
71;2021-10-02;108;226;438327;431301;80.0;78.7
71;2021-10-03;3;7;438330;431308;80.0;78.7
71;2021-10-04;252;554;438582;431862;80.1;78.8
71;2021-10-05;195;391;438777;432253;80.1;78.9
71;2021-10-06;380;656;439157;432909;80.2;79.0
71;2021-10-07;147;348;439304;433257;80.2;79.1
71;2021-10-08;321;647;439625;433904;80.2;79.2
71;2021-10-09;59;163;439684;434067;80.3;79.2
71;2021-10-10;5;17;439689;434084;80.3;79.2
71;2021-10-11;251;513;439940;434597;80.3;79.3
72;2020-12-27;0;0;0;0;0.0;0.0
72;2020-12-28;0;0;0;0;0.0;0.0
72;2020-12-29;0;0;0;0;0.0;0.0
72;2020-12-30;0;0;0;0;0.0;0.0
72;2020-12-31;0;0;0;0;0.0;0.0
72;2021-01-01;2;0;2;0;0.0;0.0
72;2021-01-02;0;0;2;0;0.0;0.0
72;2021-01-03;0;0;2;0;0.0;0.0
72;2021-01-04;0;0;2;0;0.0;0.0
72;2021-01-05;14;0;16;0;0.0;0.0
72;2021-01-06;27;0;43;0;0.0;0.0
72;2021-01-07;110;1;153;1;0.0;0.0
72;2021-01-08;232;1;385;2;0.1;0.0
72;2021-01-09;36;0;421;2;0.1;0.0
72;2021-01-10;0;0;421;2;0.1;0.0
72;2021-01-11;485;1;906;3;0.2;0.0
72;2021-01-12;614;1;1520;4;0.3;0.0
72;2021-01-13;500;1;2020;5;0.4;0.0
72;2021-01-14;644;3;2664;8;0.5;0.0
72;2021-01-15;478;1;3142;9;0.6;0.0
72;2021-01-16;94;0;3236;9;0.6;0.0
72;2021-01-17;0;0;3236;9;0.6;0.0
72;2021-01-18;294;1;3530;10;0.6;0.0
72;2021-01-19;779;4;4309;14;0.8;0.0
72;2021-01-20;1539;6;5848;20;1.0;0.0
72;2021-01-21;1778;6;7626;26;1.4;0.0
72;2021-01-22;1149;6;8775;32;1.6;0.0
72;2021-01-23;32;0;8807;32;1.6;0.0
72;2021-01-24;0;0;8807;32;1.6;0.0
72;2021-01-25;503;7;9310;39;1.7;0.0
72;2021-01-26;1166;21;10476;60;1.9;0.0
72;2021-01-27;883;22;11359;82;2.0;0.0
72;2021-01-28;776;67;12135;149;2.2;0.0
72;2021-01-29;712;68;12847;217;2.3;0.0
72;2021-01-30;58;0;12905;217;2.3;0.0
72;2021-01-31;1;0;12906;217;2.3;0.0
72;2021-02-01;499;228;13405;445;2.4;0.1
72;2021-02-02;506;294;13911;739;2.5;0.1
72;2021-02-03;487;230;14398;969;2.6;0.2
72;2021-02-04;477;341;14875;1310;2.7;0.2
72;2021-02-05;514;407;15389;1717;2.7;0.3
72;2021-02-06;83;14;15472;1731;2.8;0.3
72;2021-02-07;19;3;15491;1734;2.8;0.3
72;2021-02-08;310;401;15801;2135;2.8;0.4
72;2021-02-09;488;530;16289;2665;2.9;0.5
72;2021-02-10;567;929;16856;3594;3.0;0.6
72;2021-02-11;860;1344;17716;4938;3.2;0.9
72;2021-02-12;851;594;18567;5532;3.3;1.0
72;2021-02-13;111;38;18678;5570;3.3;1.0
72;2021-02-14;1;22;18679;5592;3.3;1.0
72;2021-02-15;220;502;18899;6094;3.4;1.1
72;2021-02-16;503;1027;19402;7121;3.5;1.3
72;2021-02-17;463;715;19865;7836;3.5;1.4
72;2021-02-18;595;635;20460;8471;3.7;1.5
72;2021-02-19;521;598;20981;9069;3.7;1.6
72;2021-02-20;81;57;21062;9126;3.8;1.6
72;2021-02-21;0;0;21062;9126;3.8;1.6
72;2021-02-22;329;578;21391;9704;3.8;1.7
72;2021-02-23;569;531;21960;10235;3.9;1.8
72;2021-02-24;435;472;22395;10707;4.0;1.9
72;2021-02-25;922;564;23317;11271;4.2;2.0
72;2021-02-26;599;512;23916;11783;4.3;2.1
72;2021-02-27;322;67;24238;11850;4.3;2.1
72;2021-02-28;15;17;24253;11867;4.3;2.1
72;2021-03-01;379;480;24632;12347;4.4;2.2
72;2021-03-02;503;605;25135;12952;4.5;2.3
72;2021-03-03;733;656;25868;13608;4.6;2.4
72;2021-03-04;742;787;26610;14395;4.7;2.6
72;2021-03-05;935;772;27545;15167;4.9;2.7
72;2021-03-06;761;136;28306;15303;5.1;2.7
72;2021-03-07;448;26;28754;15329;5.1;2.7
72;2021-03-08;561;447;29315;15776;5.2;2.8
72;2021-03-09;1045;644;30360;16420;5.4;2.9
72;2021-03-10;1134;662;31494;17082;5.6;3.0
72;2021-03-11;1610;498;33104;17580;5.9;3.1
72;2021-03-12;1364;520;34468;18100;6.2;3.2
72;2021-03-13;983;120;35451;18220;6.3;3.3
72;2021-03-14;14;10;35465;18230;6.3;3.3
72;2021-03-15;1159;225;36624;18455;6.5;3.3
72;2021-03-16;1052;191;37676;18646;6.7;3.3
72;2021-03-17;1035;263;38711;18909;6.9;3.4
72;2021-03-18;1089;371;39800;19280;7.1;3.4
72;2021-03-19;1276;292;41076;19572;7.3;3.5
72;2021-03-20;488;93;41564;19665;7.4;3.5
72;2021-03-21;19;0;41583;19665;7.4;3.5
72;2021-03-22;1347;345;42930;20010;7.7;3.6
72;2021-03-23;1724;486;44654;20496;8.0;3.7
72;2021-03-24;1842;307;46496;20803;8.3;3.7
72;2021-03-25;2448;468;48944;21271;8.7;3.8
72;2021-03-26;2336;374;51280;21645;9.2;3.9
72;2021-03-27;616;31;51896;21676;9.3;3.9
72;2021-03-28;22;0;51918;21676;9.3;3.9
72;2021-03-29;1616;383;53534;22059;9.6;3.9
72;2021-03-30;2496;390;56030;22449;10.0;4.0
72;2021-03-31;2145;375;58175;22824;10.4;4.1
72;2021-04-01;2850;354;61025;23178;10.9;4.1
72;2021-04-02;2247;405;63272;23583;11.3;4.2
72;2021-04-03;291;39;63563;23622;11.3;4.2
72;2021-04-04;16;5;63579;23627;11.3;4.2
72;2021-04-05;51;49;63630;23676;11.4;4.2
72;2021-04-06;1759;471;65389;24147;11.7;4.3
72;2021-04-07;2577;603;67966;24750;12.1;4.4
72;2021-04-08;2721;785;70687;25535;12.6;4.6
72;2021-04-09;3863;591;74550;26126;13.3;4.7
72;2021-04-10;1112;54;75662;26180;13.5;4.7
72;2021-04-11;8;1;75670;26181;13.5;4.7
72;2021-04-12;1846;906;77516;27087;13.8;4.8
72;2021-04-13;2372;1082;79888;28169;14.3;5.0
72;2021-04-14;2250;1099;82138;29268;14.7;5.2
72;2021-04-15;2420;1120;84558;30388;15.1;5.4
72;2021-04-16;2563;970;87121;31358;15.6;5.6
72;2021-04-17;707;145;87828;31503;15.7;5.6
72;2021-04-18;57;2;87885;31505;15.7;5.6
72;2021-04-19;1396;1098;89281;32603;15.9;5.8
72;2021-04-20;2996;1309;92277;33912;16.5;6.1
72;2021-04-21;2515;1567;94792;35479;16.9;6.3
72;2021-04-22;2814;1794;97606;37273;17.4;6.7
72;2021-04-23;3213;1461;100819;38734;18.0;6.9
72;2021-04-24;1400;270;102219;39004;18.2;7.0
72;2021-04-25;881;18;103100;39022;18.4;7.0
72;2021-04-26;3513;1482;106613;40504;19.0;7.2
72;2021-04-27;4088;1867;110701;42371;19.8;7.6
72;2021-04-28;3835;1880;114536;44251;20.4;7.9
72;2021-04-29;4161;1821;118697;46072;21.2;8.2
72;2021-04-30;3615;1714;122312;47786;21.8;8.5
72;2021-05-01;1641;227;123953;48013;22.1;8.6
72;2021-05-02;1533;161;125486;48174;22.4;8.6
72;2021-05-03;3456;1155;128942;49329;23.0;8.8
72;2021-05-04;4013;1807;132955;51136;23.7;9.1
72;2021-05-05;3866;2182;136821;53318;24.4;9.5
72;2021-05-06;3596;1947;140417;55265;25.1;9.9
72;2021-05-07;3544;2149;143961;57414;25.7;10.2
72;2021-05-08;1900;155;145861;57569;26.0;10.3
72;2021-05-09;2080;213;147941;57782;26.4;10.3
72;2021-05-10;3769;1527;151710;59309;27.1;10.6
72;2021-05-11;4597;1997;156307;61306;27.9;10.9
72;2021-05-12;4080;1819;160387;63125;28.6;11.3
72;2021-05-13;3031;273;163418;63398;29.2;11.3
72;2021-05-14;3663;1399;167081;64797;29.8;11.6
72;2021-05-15;3117;365;170198;65162;30.4;11.6
72;2021-05-16;2500;152;172698;65314;30.8;11.7
72;2021-05-17;3724;1289;176422;66603;31.5;11.9
72;2021-05-18;4330;1690;180752;68293;32.3;12.2
72;2021-05-19;3973;1513;184725;69806;33.0;12.5
72;2021-05-20;4261;1455;188986;71261;33.7;12.7
72;2021-05-21;3788;1392;192774;72653;34.4;13.0
72;2021-05-22;2561;506;195335;73159;34.9;13.1
72;2021-05-23;1391;163;196726;73322;35.1;13.1
72;2021-05-24;2353;295;199079;73617;35.5;13.1
72;2021-05-25;4076;1412;203155;75029;36.3;13.4
72;2021-05-26;4096;1414;207251;76443;37.0;13.6
72;2021-05-27;4345;2049;211596;78492;37.8;14.0
72;2021-05-28;4105;2017;215701;80509;38.5;14.4
72;2021-05-29;2668;811;218369;81320;39.0;14.5
72;2021-05-30;1142;871;219511;82191;39.2;14.7
72;2021-05-31;3121;2331;222632;84522;39.7;15.1
72;2021-06-01;3570;2670;226202;87192;40.4;15.6
72;2021-06-02;3611;2784;229813;89976;41.0;16.1
72;2021-06-03;4242;2996;234055;92972;41.8;16.6
72;2021-06-04;3891;2752;237946;95724;42.5;17.1
72;2021-06-05;1440;2567;239386;98291;42.7;17.5
72;2021-06-06;911;1541;240297;99832;42.9;17.8
72;2021-06-07;1744;3424;242041;103256;43.2;18.4
72;2021-06-08;2930;3835;244971;107091;43.7;19.1
72;2021-06-09;2646;3371;247617;110462;44.2;19.7
72;2021-06-10;2825;3319;250442;113781;44.7;20.3
72;2021-06-11;2840;3775;253282;117556;45.2;21.0
72;2021-06-12;1242;2603;254524;120159;45.4;21.4
72;2021-06-13;388;1860;254912;122019;45.5;21.8
72;2021-06-14;1336;4127;256248;126146;45.7;22.5
72;2021-06-15;2751;3516;258999;129662;46.2;23.1
72;2021-06-16;2428;3581;261427;133243;46.7;23.8
72;2021-06-17;2318;3877;263745;137120;47.1;24.5
72;2021-06-18;2310;4317;266055;141437;47.5;25.2
72;2021-06-19;1128;2763;267183;144200;47.7;25.7
72;2021-06-20;339;2055;267522;146255;47.8;26.1
72;2021-06-21;1564;4034;269086;150289;48.0;26.8
72;2021-06-22;1715;4993;270801;155282;48.3;27.7
72;2021-06-23;2008;4223;272809;159505;48.7;28.5
72;2021-06-24;2233;4013;275042;163518;49.1;29.2
72;2021-06-25;1774;4836;276816;168354;49.4;30.1
72;2021-06-26;1190;2876;278006;171230;49.6;30.6
72;2021-06-27;392;2111;278398;173341;49.7;30.9
72;2021-06-28;1439;4292;279837;177633;50.0;31.7
72;2021-06-29;1770;4741;281607;182374;50.3;32.6
72;2021-06-30;1980;4169;283587;186543;50.6;33.3
72;2021-07-01;1954;4417;285541;190960;51.0;34.1
72;2021-07-02;1853;4714;287394;195674;51.3;34.9
72;2021-07-03;1292;3124;288686;198798;51.5;35.5
72;2021-07-04;579;1948;289265;200746;51.6;35.8
72;2021-07-05;1193;4164;290458;204910;51.8;36.6
72;2021-07-06;1458;5159;291916;210069;52.1;37.5
72;2021-07-07;1582;4609;293498;214678;52.4;38.3
72;2021-07-08;1648;4326;295146;219004;52.7;39.1
72;2021-07-09;2107;4604;297253;223608;53.1;39.9
72;2021-07-10;1589;2691;298842;226299;53.3;40.4
72;2021-07-11;947;1587;299789;227886;53.5;40.7
72;2021-07-12;1592;3757;301381;231643;53.8;41.3
72;2021-07-13;2091;4774;303472;236417;54.2;42.2
72;2021-07-14;1325;2365;304797;238782;54.4;42.6
72;2021-07-15;3485;3422;308282;242204;55.0;43.2
72;2021-07-16;3175;4124;311457;246328;55.6;44.0
72;2021-07-17;2646;1760;314103;248088;56.1;44.3
72;2021-07-18;1710;824;315813;248912;56.4;44.4
72;2021-07-19;2918;3507;318731;252419;56.9;45.1
72;2021-07-20;3040;4284;321771;256703;57.4;45.8
72;2021-07-21;2884;3589;324655;260292;58.0;46.5
72;2021-07-22;3772;2918;328427;263210;58.6;47.0
72;2021-07-23;3478;3792;331905;267002;59.2;47.7
72;2021-07-24;2820;1462;334725;268464;59.7;47.9
72;2021-07-25;1453;1081;336178;269545;60.0;48.1
72;2021-07-26;2726;2918;338904;272463;60.5;48.6
72;2021-07-27;3859;3822;342763;276285;61.2;49.3
72;2021-07-28;3571;3122;346334;279407;61.8;49.9
72;2021-07-29;3572;2712;349906;282119;62.5;50.4
72;2021-07-30;3788;3385;353694;285504;63.1;51.0
72;2021-07-31;2546;1750;356240;287254;63.6;51.3
72;2021-08-01;1835;432;358075;287686;63.9;51.4
72;2021-08-02;3215;2285;361290;289971;64.5;51.8
72;2021-08-03;3236;3297;364526;293268;65.1;52.3
72;2021-08-04;3769;2554;368295;295822;65.7;52.8
72;2021-08-05;3770;2460;372065;298282;66.4;53.2
72;2021-08-06;3342;2695;375407;300977;67.0;53.7
72;2021-08-07;2347;1613;377754;302590;67.4;54.0
72;2021-08-08;1623;701;379377;303291;67.7;54.1
72;2021-08-09;2699;2670;382076;305961;68.2;54.6
72;2021-08-10;2915;2748;384991;308709;68.7;55.1
72;2021-08-11;2368;2204;387359;310913;69.1;55.5
72;2021-08-12;2381;2597;389740;313510;69.6;56.0
72;2021-08-13;2158;2295;391898;315805;70.0;56.4
72;2021-08-14;1167;1546;393065;317351;70.2;56.6
72;2021-08-15;623;614;393688;317965;70.3;56.8
72;2021-08-16;1649;2372;395337;320337;70.6;57.2
72;2021-08-17;1717;2889;397054;323226;70.9;57.7
72;2021-08-18;1709;2872;398763;326098;71.2;58.2
72;2021-08-19;1245;2914;400008;329012;71.4;58.7
72;2021-08-20;1656;3170;401664;332182;71.7;59.3
72;2021-08-21;699;2031;402363;334213;71.8;59.7
72;2021-08-22;261;1150;402624;335363;71.9;59.9
72;2021-08-23;1738;3422;404362;338785;72.2;60.5
72;2021-08-24;1532;4122;405894;342907;72.5;61.2
72;2021-08-25;1600;3453;407494;346360;72.7;61.8
72;2021-08-26;1264;4443;408758;350803;73.0;62.6
72;2021-08-27;1192;4112;409950;354915;73.2;63.4
72;2021-08-28;881;2656;410831;357571;73.3;63.8
72;2021-08-29;357;1683;411188;359254;73.4;64.1
72;2021-08-30;1130;3407;412318;362661;73.6;64.7
72;2021-08-31;1219;3911;413537;366572;73.8;65.4
72;2021-09-01;1070;3162;414607;369734;74.0;66.0
72;2021-09-02;901;3231;415508;372965;74.2;66.6
72;2021-09-03;928;3063;416436;376028;74.3;67.1
72;2021-09-04;702;2554;417138;378582;74.5;67.6
72;2021-09-05;256;1498;417394;380080;74.5;67.8
72;2021-09-06;585;2506;417979;382586;74.6;68.3
72;2021-09-07;506;2582;418485;385168;74.7;68.8
72;2021-09-08;617;2889;419102;388057;74.8;69.3
72;2021-09-09;396;1770;419498;389827;74.9;69.6
72;2021-09-10;625;2394;420123;392221;75.0;70.0
72;2021-09-11;402;2636;420525;394857;75.1;70.5
72;2021-09-12;170;923;420695;395780;75.1;70.6
72;2021-09-13;368;1302;421063;397082;75.2;70.9
72;2021-09-14;487;1223;421550;398305;75.2;71.1
72;2021-09-15;615;1994;422165;400299;75.4;71.5
72;2021-09-16;335;832;422500;401131;75.4;71.6
72;2021-09-17;443;1423;422943;402554;75.5;71.9
72;2021-09-18;355;1520;423298;404074;75.6;72.1
72;2021-09-19;89;359;423387;404433;75.6;72.2
72;2021-09-20;350;793;423737;405226;75.6;72.3
72;2021-09-21;317;787;424054;406013;75.7;72.5
72;2021-09-22;442;1526;424496;407539;75.8;72.7
72;2021-09-23;396;630;424892;408169;75.8;72.9
72;2021-09-24;601;1006;425493;409175;76.0;73.0
72;2021-09-25;259;1004;425752;410179;76.0;73.2
72;2021-09-26;73;215;425825;410394;76.0;73.3
72;2021-09-27;210;640;426035;411034;76.0;73.4
72;2021-09-28;206;427;426241;411461;76.1;73.4
72;2021-09-29;360;1013;426601;412474;76.1;73.6
72;2021-09-30;164;331;426765;412805;76.2;73.7
72;2021-10-01;287;707;427052;413512;76.2;73.8
72;2021-10-02;311;581;427363;414093;76.3;73.9
72;2021-10-03;91;161;427454;414254;76.3;73.9
72;2021-10-04;178;410;427632;414664;76.3;74.0
72;2021-10-05;268;331;427900;414995;76.4;74.1
72;2021-10-06;256;560;428156;415555;76.4;74.2
72;2021-10-07;220;352;428376;415907;76.5;74.2
72;2021-10-08;328;646;428704;416553;76.5;74.4
72;2021-10-09;217;436;428921;416989;76.6;74.4
72;2021-10-10;84;117;429005;417106;76.6;74.5
72;2021-10-11;172;259;429177;417365;76.6;74.5
73;2020-12-27;1;1;1;1;0.0;0.0
73;2020-12-28;1;0;2;1;0.0;0.0
73;2020-12-29;0;0;2;1;0.0;0.0
73;2020-12-30;0;0;2;1;0.0;0.0
73;2020-12-31;0;0;2;1;0.0;0.0
73;2021-01-01;0;0;2;1;0.0;0.0
73;2021-01-02;0;0;2;1;0.0;0.0
73;2021-01-03;0;0;2;1;0.0;0.0
73;2021-01-04;1;0;3;1;0.0;0.0
73;2021-01-05;0;0;3;1;0.0;0.0
73;2021-01-06;1;0;4;1;0.0;0.0
73;2021-01-07;30;0;34;1;0.0;0.0
73;2021-01-08;81;0;115;1;0.0;0.0
73;2021-01-09;0;0;115;1;0.0;0.0
73;2021-01-10;0;0;115;1;0.0;0.0
73;2021-01-11;101;1;216;2;0.0;0.0
73;2021-01-12;303;1;519;3;0.1;0.0
73;2021-01-13;362;1;881;4;0.2;0.0
73;2021-01-14;516;3;1397;7;0.3;0.0
73;2021-01-15;617;1;2014;8;0.5;0.0
73;2021-01-16;128;2;2142;10;0.5;0.0
73;2021-01-17;0;0;2142;10;0.5;0.0
73;2021-01-18;624;0;2766;10;0.6;0.0
73;2021-01-19;1240;4;4006;14;0.9;0.0
73;2021-01-20;950;2;4956;16;1.1;0.0
73;2021-01-21;984;5;5940;21;1.4;0.0
73;2021-01-22;947;0;6887;21;1.6;0.0
73;2021-01-23;389;0;7276;21;1.7;0.0
73;2021-01-24;0;0;7276;21;1.7;0.0
73;2021-01-25;656;6;7932;27;1.8;0.0
73;2021-01-26;761;2;8693;29;2.0;0.0
73;2021-01-27;1107;6;9800;35;2.3;0.0
73;2021-01-28;961;5;10761;40;2.5;0.0
73;2021-01-29;684;7;11445;47;2.6;0.0
73;2021-01-30;345;3;11790;50;2.7;0.0
73;2021-01-31;0;0;11790;50;2.7;0.0
73;2021-02-01;606;42;12396;92;2.9;0.0
73;2021-02-02;752;336;13148;428;3.0;0.1
73;2021-02-03;649;353;13797;781;3.2;0.2
73;2021-02-04;626;236;14423;1017;3.3;0.2
73;2021-02-05;680;408;15103;1425;3.5;0.3
73;2021-02-06;263;39;15366;1464;3.6;0.3
73;2021-02-07;1;0;15367;1464;3.6;0.3
73;2021-02-08;524;253;15891;1717;3.7;0.4
73;2021-02-09;793;454;16684;2171;3.9;0.5
73;2021-02-10;901;395;17585;2566;4.1;0.6
73;2021-02-11;963;718;18548;3284;4.3;0.8
73;2021-02-12;811;512;19359;3796;4.5;0.9
73;2021-02-13;263;59;19622;3855;4.5;0.9
73;2021-02-14;1;0;19623;3855;4.5;0.9
73;2021-02-15;346;528;19969;4383;4.6;1.0
73;2021-02-16;454;764;20423;5147;4.7;1.2
73;2021-02-17;451;966;20874;6113;4.8;1.4
73;2021-02-18;467;559;21341;6672;4.9;1.5
73;2021-02-19;445;640;21786;7312;5.0;1.7
73;2021-02-20;70;249;21856;7561;5.1;1.7
73;2021-02-21;0;0;21856;7561;5.1;1.7
73;2021-02-22;240;443;22096;8004;5.1;1.9
73;2021-02-23;327;523;22423;8527;5.2;2.0
73;2021-02-24;487;748;22910;9275;5.3;2.1
73;2021-02-25;504;515;23414;9790;5.4;2.3
73;2021-02-26;730;569;24144;10359;5.6;2.4
73;2021-02-27;330;237;24474;10596;5.7;2.4
73;2021-02-28;2;1;24476;10597;5.7;2.4
73;2021-03-01;557;509;25033;11106;5.8;2.6
73;2021-03-02;667;902;25700;12008;5.9;2.8
73;2021-03-03;643;1197;26343;13205;6.1;3.1
73;2021-03-04;1040;905;27383;14110;6.3;3.3
73;2021-03-05;1240;614;28623;14724;6.6;3.4
73;2021-03-06;1091;336;29714;15060;6.9;3.5
73;2021-03-07;455;94;30169;15154;7.0;3.5
73;2021-03-08;609;431;30778;15585;7.1;3.6
73;2021-03-09;985;543;31763;16128;7.3;3.7
73;2021-03-10;1035;874;32798;17002;7.6;3.9
73;2021-03-11;1559;663;34357;17665;7.9;4.1
73;2021-03-12;2018;539;36375;18204;8.4;4.2
73;2021-03-13;1179;206;37554;18410;8.7;4.3
73;2021-03-14;66;3;37620;18413;8.7;4.3
73;2021-03-15;1185;400;38805;18813;9.0;4.3
73;2021-03-16;795;400;39600;19213;9.2;4.4
73;2021-03-17;877;481;40477;19694;9.4;4.6
73;2021-03-18;1352;260;41829;19954;9.7;4.6
73;2021-03-19;1767;396;43596;20350;10.1;4.7
73;2021-03-20;888;131;44484;20481;10.3;4.7
73;2021-03-21;123;3;44607;20484;10.3;4.7
73;2021-03-22;1184;403;45791;20887;10.6;4.8
73;2021-03-23;1448;244;47239;21131;10.9;4.9
73;2021-03-24;1597;346;48836;21477;11.3;5.0
73;2021-03-25;2064;389;50900;21866;11.8;5.1
73;2021-03-26;2472;368;53372;22234;12.3;5.1
73;2021-03-27;885;148;54257;22382;12.5;5.2
73;2021-03-28;312;16;54569;22398;12.6;5.2
73;2021-03-29;1508;241;56077;22639;13.0;5.2
73;2021-03-30;2087;487;58164;23126;13.4;5.3
73;2021-03-31;2089;407;60253;23533;13.9;5.4
73;2021-04-01;2087;339;62340;23872;14.4;5.5
73;2021-04-02;2362;236;64702;24108;15.0;5.6
73;2021-04-03;848;147;65550;24255;15.2;5.6
73;2021-04-04;188;18;65738;24273;15.2;5.6
73;2021-04-05;212;26;65950;24299;15.2;5.6
73;2021-04-06;1506;513;67456;24812;15.6;5.7
73;2021-04-07;1947;654;69403;25466;16.0;5.9
73;2021-04-08;2492;826;71895;26292;16.6;6.1
73;2021-04-09;3059;532;74954;26824;17.3;6.2
73;2021-04-10;1134;322;76088;27146;17.6;6.3
73;2021-04-11;164;10;76252;27156;17.6;6.3
73;2021-04-12;1696;988;77948;28144;18.0;6.5
73;2021-04-13;1895;1131;79843;29275;18.5;6.8
73;2021-04-14;2012;1093;81855;30368;18.9;7.0
73;2021-04-15;2416;1192;84271;31560;19.5;7.3
73;2021-04-16;1893;936;86164;32496;19.9;7.5
73;2021-04-17;1173;561;87337;33057;20.2;7.6
73;2021-04-18;155;76;87492;33133;20.2;7.7
73;2021-04-19;1383;1066;88875;34199;20.5;7.9
73;2021-04-20;1790;1327;90665;35526;21.0;8.2
73;2021-04-21;1576;1305;92241;36831;21.3;8.5
73;2021-04-22;1812;1226;94053;38057;21.7;8.8
73;2021-04-23;1897;1254;95950;39311;22.2;9.1
73;2021-04-24;980;679;96930;39990;22.4;9.2
73;2021-04-25;79;97;97009;40087;22.4;9.3
73;2021-04-26;1164;1320;98173;41407;22.7;9.6
73;2021-04-27;1440;1475;99613;42882;23.0;9.9
73;2021-04-28;1731;1461;101344;44343;23.4;10.3
73;2021-04-29;2413;1565;103757;45908;24.0;10.6
73;2021-04-30;2396;1445;106153;47353;24.5;10.9
73;2021-05-01;1068;310;107221;47663;24.8;11.0
73;2021-05-02;34;165;107255;47828;24.8;11.1
73;2021-05-03;1392;1595;108647;49423;25.1;11.4
73;2021-05-04;1712;1835;110359;51258;25.5;11.9
73;2021-05-05;1974;1690;112333;52948;26.0;12.2
73;2021-05-06;2431;1698;114764;54646;26.5;12.6
73;2021-05-07;2259;1849;117023;56495;27.1;13.1
73;2021-05-08;1838;377;118861;56872;27.5;13.1
73;2021-05-09;127;127;118988;56999;27.5;13.2
73;2021-05-10;1608;1892;120596;58891;27.9;13.6
73;2021-05-11;2378;2368;122974;61259;28.4;14.2
73;2021-05-12;3555;2098;126529;63357;29.3;14.6
73;2021-05-13;1554;276;128083;63633;29.6;14.7
73;2021-05-14;1588;1493;129671;65126;30.0;15.1
73;2021-05-15;1447;943;131118;66069;30.3;15.3
73;2021-05-16;131;62;131249;66131;30.3;15.3
73;2021-05-17;1711;1953;132960;68084;30.7;15.7
73;2021-05-18;2495;1736;135455;69820;31.3;16.1
73;2021-05-19;2538;1622;137993;71442;31.9;16.5
73;2021-05-20;3162;1502;141155;72944;32.6;16.9
73;2021-05-21;2473;1850;143628;74794;33.2;17.3
73;2021-05-22;1989;923;145617;75717;33.7;17.5
73;2021-05-23;212;14;145829;75731;33.7;17.5
73;2021-05-24;2563;327;148392;76058;34.3;17.6
73;2021-05-25;2139;1741;150531;77799;34.8;18.0
73;2021-05-26;2342;2000;152873;79799;35.3;18.4
73;2021-05-27;3081;1715;155954;81514;36.1;18.8
73;2021-05-28;2918;2376;158872;83890;36.7;19.4
73;2021-05-29;2316;1322;161188;85212;37.3;19.7
73;2021-05-30;188;14;161376;85226;37.3;19.7
73;2021-05-31;2410;1632;163786;86858;37.9;20.1
73;2021-06-01;3178;1792;166964;88650;38.6;20.5
73;2021-06-02;3108;1459;170072;90109;39.3;20.8
73;2021-06-03;4422;1741;174494;91850;40.3;21.2
73;2021-06-04;4276;2184;178770;94034;41.3;21.7
73;2021-06-05;3165;1282;181935;95316;42.1;22.0
73;2021-06-06;1881;299;183816;95615;42.5;22.1
73;2021-06-07;2759;2149;186575;97764;43.1;22.6
73;2021-06-08;2685;1873;189260;99637;43.8;23.0
73;2021-06-09;2365;1790;191625;101427;44.3;23.4
73;2021-06-10;2005;1648;193630;103075;44.8;23.8
73;2021-06-11;2192;2441;195822;105516;45.3;24.4
73;2021-06-12;2245;1333;198067;106849;45.8;24.7
73;2021-06-13;44;82;198111;106931;45.8;24.7
73;2021-06-14;1347;2927;199458;109858;46.1;25.4
73;2021-06-15;1592;2755;201050;112613;46.5;26.0
73;2021-06-16;1466;2566;202516;115179;46.8;26.6
73;2021-06-17;947;1727;203463;116906;47.0;27.0
73;2021-06-18;1883;2932;205346;119838;47.5;27.7
73;2021-06-19;1424;1986;206770;121824;47.8;28.2
73;2021-06-20;448;307;207218;122131;47.9;28.2
73;2021-06-21;1111;2938;208329;125069;48.2;28.9
73;2021-06-22;1090;2870;209419;127939;48.4;29.6
73;2021-06-23;1086;3137;210505;131076;48.7;30.3
73;2021-06-24;883;1794;211388;132870;48.9;30.7
73;2021-06-25;1324;2796;212712;135666;49.2;31.4
73;2021-06-26;966;2399;213678;138065;49.4;31.9
73;2021-06-27;329;550;214007;138615;49.5;32.0
73;2021-06-28;971;3557;214978;142172;49.7;32.9
73;2021-06-29;1076;3340;216054;145512;49.9;33.6
73;2021-06-30;1239;3117;217293;148629;50.2;34.4
73;2021-07-01;1191;2363;218484;150992;50.5;34.9
73;2021-07-02;1203;3617;219687;154609;50.8;35.7
73;2021-07-03;961;2793;220648;157402;51.0;36.4
73;2021-07-04;301;619;220949;158021;51.1;36.5
73;2021-07-05;1157;3681;222106;161702;51.3;37.4
73;2021-07-06;1251;2952;223357;164654;51.6;38.1
73;2021-07-07;1443;2948;224800;167602;52.0;38.7
73;2021-07-08;1373;2297;226173;169899;52.3;39.3
73;2021-07-09;1431;4026;227604;173925;52.6;40.2
73;2021-07-10;891;3012;228495;176937;52.8;40.9
73;2021-07-11;561;1470;229056;178407;53.0;41.2
73;2021-07-12;1059;4196;230115;182603;53.2;42.2
73;2021-07-13;1729;4225;231844;186828;53.6;43.2
73;2021-07-14;1843;1920;233687;188748;54.0;43.6
73;2021-07-15;2747;3797;236434;192545;54.7;44.5
73;2021-07-16;2416;4016;238850;196561;55.2;45.4
73;2021-07-17;1515;2607;240365;199168;55.6;46.0
73;2021-07-18;1176;1218;241541;200386;55.8;46.3
73;2021-07-19;2449;3251;243990;203637;56.4;47.1
73;2021-07-20;3366;2856;247356;206493;57.2;47.7
73;2021-07-21;3382;2790;250738;209283;58.0;48.4
73;2021-07-22;2733;2216;253471;211499;58.6;48.9
73;2021-07-23;3417;2902;256888;214401;59.4;49.6
73;2021-07-24;2059;2280;258947;216681;59.9;50.1
73;2021-07-25;625;797;259572;217478;60.0;50.3
73;2021-07-26;2632;2496;262204;219974;60.6;50.9
73;2021-07-27;3813;2273;266017;222247;61.5;51.4
73;2021-07-28;3535;2097;269552;224344;62.3;51.9
73;2021-07-29;3980;2154;273532;226498;63.2;52.4
73;2021-07-30;3565;2477;277097;228975;64.1;52.9
73;2021-07-31;2477;1594;279574;230569;64.6;53.3
73;2021-08-01;834;620;280408;231189;64.8;53.4
73;2021-08-02;3104;2105;283512;233294;65.5;53.9
73;2021-08-03;3494;2000;287006;235294;66.4;54.4
73;2021-08-04;3299;2025;290305;237319;67.1;54.9
73;2021-08-05;2875;2233;293180;239552;67.8;55.4
73;2021-08-06;2509;2382;295689;241934;68.4;55.9
73;2021-08-07;1416;1482;297105;243416;68.7;56.3
73;2021-08-08;434;619;297539;244035;68.8;56.4
73;2021-08-09;1785;2396;299324;246431;69.2;57.0
73;2021-08-10;1897;2490;301221;248921;69.6;57.5
73;2021-08-11;1848;2535;303069;251456;70.1;58.1
73;2021-08-12;1682;2502;304751;253958;70.5;58.7
73;2021-08-13;1461;2842;306212;256800;70.8;59.4
73;2021-08-14;990;1534;307202;258334;71.0;59.7
73;2021-08-15;92;161;307294;258495;71.0;59.8
73;2021-08-16;952;1392;308246;259887;71.3;60.1
73;2021-08-17;964;1960;309210;261847;71.5;60.5
73;2021-08-18;1038;2841;310248;264688;71.7;61.2
73;2021-08-19;1045;3055;311293;267743;72.0;61.9
73;2021-08-20;852;3146;312145;270889;72.2;62.6
73;2021-08-21;463;1837;312608;272726;72.3;63.1
73;2021-08-22;268;936;312876;273662;72.3;63.3
73;2021-08-23;677;2970;313553;276632;72.5;64.0
73;2021-08-24;899;3160;314452;279792;72.7;64.7
73;2021-08-25;712;2907;315164;282699;72.9;65.4
73;2021-08-26;691;2424;315855;285123;73.0;65.9
73;2021-08-27;791;2748;316646;287871;73.2;66.6
73;2021-08-28;457;1749;317103;289620;73.3;67.0
73;2021-08-29;303;1018;317406;290638;73.4;67.2
73;2021-08-30;820;2569;318226;293207;73.6;67.8
73;2021-08-31;819;2359;319045;295566;73.8;68.3
73;2021-09-01;748;2098;319793;297664;73.9;68.8
73;2021-09-02;619;1762;320412;299426;74.1;69.2
73;2021-09-03;697;2025;321109;301451;74.2;69.7
73;2021-09-04;531;1371;321640;302822;74.4;70.0
73;2021-09-05;227;703;321867;303525;74.4;70.2
73;2021-09-06;351;1076;322218;304601;74.5;70.4
73;2021-09-07;414;875;322632;305476;74.6;70.6
73;2021-09-08;491;1016;323123;306492;74.7;70.9
73;2021-09-09;467;1020;323590;307512;74.8;71.1
73;2021-09-10;578;1268;324168;308780;74.9;71.4
73;2021-09-11;354;1002;324522;309782;75.0;71.6
73;2021-09-12;96;154;324618;309936;75.0;71.7
73;2021-09-13;343;714;324961;310650;75.1;71.8
73;2021-09-14;412;621;325373;311271;75.2;72.0
73;2021-09-15;427;815;325800;312086;75.3;72.2
73;2021-09-16;332;646;326132;312732;75.4;72.3
73;2021-09-17;377;870;326509;313602;75.5;72.5
73;2021-09-18;260;630;326769;314232;75.5;72.6
73;2021-09-19;46;205;326815;314437;75.6;72.7
73;2021-09-20;163;632;326978;315069;75.6;72.8
73;2021-09-21;298;538;327276;315607;75.7;73.0
73;2021-09-22;275;774;327551;316381;75.7;73.1
73;2021-09-23;282;477;327833;316858;75.8;73.3
73;2021-09-24;292;857;328125;317715;75.9;73.5
73;2021-09-25;189;724;328314;318439;75.9;73.6
73;2021-09-26;73;210;328387;318649;75.9;73.7
73;2021-09-27;243;498;328630;319147;76.0;73.8
73;2021-09-28;185;340;328815;319487;76.0;73.9
73;2021-09-29;220;675;329035;320162;76.1;74.0
73;2021-09-30;193;365;329228;320527;76.1;74.1
73;2021-10-01;211;564;329439;321091;76.2;74.2
73;2021-10-02;197;482;329636;321573;76.2;74.3
73;2021-10-03;8;11;329644;321584;76.2;74.3
73;2021-10-04;213;363;329857;321947;76.3;74.4
73;2021-10-05;166;312;330023;322259;76.3;74.5
73;2021-10-06;315;508;330338;322767;76.4;74.6
73;2021-10-07;161;301;330499;323068;76.4;74.7
73;2021-10-08;254;536;330753;323604;76.5;74.8
73;2021-10-09;158;347;330911;323951;76.5;74.9
73;2021-10-10;3;6;330914;323957;76.5;74.9
73;2021-10-11;191;315;331105;324272;76.5;75.0
74;2020-12-27;10;6;10;6;0.0;0.0
74;2020-12-28;10;1;20;7;0.0;0.0
74;2020-12-29;0;0;20;7;0.0;0.0
74;2020-12-30;5;2;25;9;0.0;0.0
74;2020-12-31;1;0;26;9;0.0;0.0
74;2021-01-01;1;0;27;9;0.0;0.0
74;2021-01-02;1;1;28;10;0.0;0.0
74;2021-01-03;0;0;28;10;0.0;0.0
74;2021-01-04;4;3;32;13;0.0;0.0
74;2021-01-05;4;1;36;14;0.0;0.0
74;2021-01-06;48;2;84;16;0.0;0.0
74;2021-01-07;220;1;304;17;0.0;0.0
74;2021-01-08;294;2;598;19;0.1;0.0
74;2021-01-09;79;0;677;19;0.1;0.0
74;2021-01-10;74;0;751;19;0.1;0.0
74;2021-01-11;375;1;1126;20;0.1;0.0
74;2021-01-12;408;3;1534;23;0.2;0.0
74;2021-01-13;396;0;1930;23;0.2;0.0
74;2021-01-14;482;5;2412;28;0.3;0.0
74;2021-01-15;645;4;3057;32;0.4;0.0
74;2021-01-16;254;1;3311;33;0.4;0.0
74;2021-01-17;136;2;3447;35;0.4;0.0
74;2021-01-18;527;3;3974;38;0.5;0.0
74;2021-01-19;814;3;4788;41;0.6;0.0
74;2021-01-20;1282;4;6070;45;0.7;0.0
74;2021-01-21;1570;3;7640;48;0.9;0.0
74;2021-01-22;1242;7;8882;55;1.1;0.0
74;2021-01-23;345;1;9227;56;1.1;0.0
74;2021-01-24;94;2;9321;58;1.1;0.0
74;2021-01-25;801;3;10122;61;1.2;0.0
74;2021-01-26;1371;26;11493;87;1.4;0.0
74;2021-01-27;1084;17;12577;104;1.5;0.0
74;2021-01-28;1003;42;13580;146;1.6;0.0
74;2021-01-29;883;43;14463;189;1.7;0.0
74;2021-01-30;305;2;14768;191;1.8;0.0
74;2021-01-31;87;1;14855;192;1.8;0.0
74;2021-02-01;632;45;15487;237;1.9;0.0
74;2021-02-02;645;154;16132;391;1.9;0.0
74;2021-02-03;606;121;16738;512;2.0;0.1
74;2021-02-04;617;136;17355;648;2.1;0.1
74;2021-02-05;557;224;17912;872;2.2;0.1
74;2021-02-06;276;136;18188;1008;2.2;0.1
74;2021-02-07;93;123;18281;1131;2.2;0.1
74;2021-02-08;620;349;18901;1480;2.3;0.2
74;2021-02-09;541;534;19442;2014;2.3;0.2
74;2021-02-10;692;518;20134;2532;2.4;0.3
74;2021-02-11;1082;1016;21216;3548;2.6;0.4
74;2021-02-12;917;617;22133;4165;2.7;0.5
74;2021-02-13;407;240;22540;4405;2.7;0.5
74;2021-02-14;320;112;22860;4517;2.8;0.5
74;2021-02-15;281;847;23141;5364;2.8;0.6
74;2021-02-16;492;1064;23633;6428;2.9;0.8
74;2021-02-17;530;1103;24163;7531;2.9;0.9
74;2021-02-18;473;987;24636;8518;3.0;1.0
74;2021-02-19;619;656;25255;9174;3.0;1.1
74;2021-02-20;114;187;25369;9361;3.1;1.1
74;2021-02-21;48;61;25417;9422;3.1;1.1
74;2021-02-22;320;787;25737;10209;3.1;1.2
74;2021-02-23;307;821;26044;11030;3.1;1.3
74;2021-02-24;242;680;26286;11710;3.2;1.4
74;2021-02-25;524;752;26810;12462;3.2;1.5
74;2021-02-26;972;702;27782;13164;3.4;1.6
74;2021-02-27;254;181;28036;13345;3.4;1.6
74;2021-02-28;125;71;28161;13416;3.4;1.6
74;2021-03-01;724;638;28885;14054;3.5;1.7
74;2021-03-02;1094;691;29979;14745;3.6;1.8
74;2021-03-03;1026;643;31005;15388;3.7;1.9
74;2021-03-04;1613;1028;32618;16416;3.9;2.0
74;2021-03-05;2095;898;34713;17314;4.2;2.1
74;2021-03-06;1762;339;36475;17653;4.4;2.1
74;2021-03-07;1388;109;37863;17762;4.6;2.1
74;2021-03-08;1198;961;39061;18723;4.7;2.3
74;2021-03-09;1958;677;41019;19400;5.0;2.3
74;2021-03-10;1749;923;42768;20323;5.2;2.5
74;2021-03-11;2451;738;45219;21061;5.5;2.5
74;2021-03-12;3246;1038;48465;22099;5.9;2.7
74;2021-03-13;2004;282;50469;22381;6.1;2.7
74;2021-03-14;609;105;51078;22486;6.2;2.7
74;2021-03-15;2129;571;53207;23057;6.4;2.8
74;2021-03-16;1963;423;55170;23480;6.7;2.8
74;2021-03-17;1975;325;57145;23805;6.9;2.9
74;2021-03-18;2137;296;59282;24101;7.2;2.9
74;2021-03-19;2637;305;61919;24406;7.5;2.9
74;2021-03-20;1374;105;63293;24511;7.6;3.0
74;2021-03-21;290;33;63583;24544;7.7;3.0
74;2021-03-22;2055;339;65638;24883;7.9;3.0
74;2021-03-23;2723;347;68361;25230;8.3;3.0
74;2021-03-24;2947;315;71308;25545;8.6;3.1
74;2021-03-25;3875;317;75183;25862;9.1;3.1
74;2021-03-26;4096;397;79279;26259;9.6;3.2
74;2021-03-27;1941;265;81220;26524;9.8;3.2
74;2021-03-28;437;78;81657;26602;9.9;3.2
74;2021-03-29;3035;728;84692;27330;10.2;3.3
74;2021-03-30;3543;785;88235;28115;10.7;3.4
74;2021-03-31;3144;747;91379;28862;11.0;3.5
74;2021-04-01;4235;911;95614;29773;11.5;3.6
74;2021-04-02;3711;807;99325;30580;12.0;3.7
74;2021-04-03;1697;547;101022;31127;12.2;3.8
74;2021-04-04;236;122;101258;31249;12.2;3.8
74;2021-04-05;433;17;101691;31266;12.3;3.8
74;2021-04-06;2623;1224;104314;32490;12.6;3.9
74;2021-04-07;3195;1266;107509;33756;13.0;4.1
74;2021-04-08;3864;1199;111373;34955;13.4;4.2
74;2021-04-09;4111;1200;115484;36155;13.9;4.4
74;2021-04-10;1944;1038;117428;37193;14.2;4.5
74;2021-04-11;253;184;117681;37377;14.2;4.5
74;2021-04-12;2724;1788;120405;39165;14.5;4.7
74;2021-04-13;3123;2117;123528;41282;14.9;5.0
74;2021-04-14;2903;1982;126431;43264;15.3;5.2
74;2021-04-15;3463;1928;129894;45192;15.7;5.5
74;2021-04-16;3386;1796;133280;46988;16.1;5.7
74;2021-04-17;1936;1041;135216;48029;16.3;5.8
74;2021-04-18;218;211;135434;48240;16.3;5.8
74;2021-04-19;2101;2107;137535;50347;16.6;6.1
74;2021-04-20;3068;2432;140603;52779;17.0;6.4
74;2021-04-21;2465;2382;143068;55161;17.3;6.7
74;2021-04-22;2629;2345;145697;57506;17.6;6.9
74;2021-04-23;2573;2261;148270;59767;17.9;7.2
74;2021-04-24;1485;1548;149755;61315;18.1;7.4
74;2021-04-25;229;150;149984;61465;18.1;7.4
74;2021-04-26;2396;2472;152380;63937;18.4;7.7
74;2021-04-27;3272;2919;155652;66856;18.8;8.1
74;2021-04-28;3465;2648;159117;69504;19.2;8.4
74;2021-04-29;3908;2701;163025;72205;19.7;8.7
74;2021-04-30;4076;2233;167101;74438;20.2;9.0
74;2021-05-01;2121;400;169222;74838;20.4;9.0
74;2021-05-02;206;239;169428;75077;20.5;9.1
74;2021-05-03;2596;3032;172024;78109;20.8;9.4
74;2021-05-04;3216;3118;175240;81227;21.2;9.8
74;2021-05-05;3392;3021;178632;84248;21.6;10.2
74;2021-05-06;3859;2639;182491;86887;22.0;10.5
74;2021-05-07;3595;3559;186086;90446;22.5;10.9
74;2021-05-08;1145;827;187231;91273;22.6;11.0
74;2021-05-09;195;247;187426;91520;22.6;11.0
74;2021-05-10;3466;3150;190892;94670;23.0;11.4
74;2021-05-11;4317;3426;195209;98096;23.6;11.8
74;2021-05-12;5306;2969;200515;101065;24.2;12.2
74;2021-05-13;2357;950;202872;102015;24.5;12.3
74;2021-05-14;5956;2407;208828;104422;25.2;12.6
74;2021-05-15;4514;1852;213342;106274;25.8;12.8
74;2021-05-16;3012;338;216354;106612;26.1;12.9
74;2021-05-17;5397;2890;221751;109502;26.8;13.2
74;2021-05-18;6792;2818;228543;112320;27.6;13.6
74;2021-05-19;6234;2297;234777;114617;28.3;13.8
74;2021-05-20;6643;2558;241420;117175;29.1;14.1
74;2021-05-21;6526;2994;247946;120169;29.9;14.5
74;2021-05-22;5293;1569;253239;121738;30.6;14.7
74;2021-05-23;2052;282;255291;122020;30.8;14.7
74;2021-05-24;2363;660;257654;122680;31.1;14.8
74;2021-05-25;5072;3334;262726;126014;31.7;15.2
74;2021-05-26;5255;2563;267981;128577;32.3;15.5
74;2021-05-27;6002;2975;273983;131552;33.1;15.9
74;2021-05-28;5656;3586;279639;135138;33.8;16.3
74;2021-05-29;3799;2156;283438;137294;34.2;16.6
74;2021-05-30;489;309;283927;137603;34.3;16.6
74;2021-05-31;5069;3549;288996;141152;34.9;17.0
74;2021-06-01;4931;3730;293927;144882;35.5;17.5
74;2021-06-02;5269;3207;299196;148089;36.1;17.9
74;2021-06-03;6890;3252;306086;151341;36.9;18.3
74;2021-06-04;6911;4432;312997;155773;37.8;18.8
74;2021-06-05;4610;2707;317607;158480;38.3;19.1
74;2021-06-06;124;112;317731;158592;38.4;19.1
74;2021-06-07;5032;4146;322763;162738;39.0;19.6
74;2021-06-08;5025;3951;327788;166689;39.6;20.1
74;2021-06-09;5081;3483;332869;170172;40.2;20.5
74;2021-06-10;5124;2879;337993;173051;40.8;20.9
74;2021-06-11;5214;3814;343207;176865;41.4;21.4
74;2021-06-12;3567;2378;346774;179243;41.9;21.6
74;2021-06-13;120;89;346894;179332;41.9;21.6
74;2021-06-14;3594;4482;350488;183814;42.3;22.2
74;2021-06-15;3671;3899;354159;187713;42.8;22.7
74;2021-06-16;4827;3126;358986;190839;43.3;23.0
74;2021-06-17;3816;2957;362802;193796;43.8;23.4
74;2021-06-18;4114;4669;366916;198465;44.3;24.0
74;2021-06-19;2993;3101;369909;201566;44.7;24.3
74;2021-06-20;125;97;370034;201663;44.7;24.3
74;2021-06-21;2382;5419;372416;207082;45.0;25.0
74;2021-06-22;2493;5313;374909;212395;45.3;25.6
74;2021-06-23;2974;4619;377883;217014;45.6;26.2
74;2021-06-24;2865;4627;380748;221641;46.0;26.8
74;2021-06-25;2930;6768;383678;228409;46.3;27.6
74;2021-06-26;1705;5400;385383;233809;46.5;28.2
74;2021-06-27;66;1664;385449;235473;46.5;28.4
74;2021-06-28;1915;7219;387364;242692;46.8;29.3
74;2021-06-29;2299;7422;389663;250114;47.0;30.2
74;2021-06-30;2747;6545;392410;256659;47.4;31.0
74;2021-07-01;3529;5426;395939;262085;47.8;31.6
74;2021-07-02;3120;6640;399059;268725;48.2;32.4
74;2021-07-03;1698;5085;400757;273810;48.4;33.1
74;2021-07-04;81;1022;400838;274832;48.4;33.2
74;2021-07-05;2078;6829;402916;281661;48.6;34.0
74;2021-07-06;2799;6490;405715;288151;49.0;34.8
74;2021-07-07;3094;5446;408809;293597;49.3;35.4
74;2021-07-08;3867;4924;412676;298521;49.8;36.0
74;2021-07-09;2671;6978;415347;305499;50.1;36.9
74;2021-07-10;1623;5132;416970;310631;50.3;37.5
74;2021-07-11;76;142;417046;310773;50.3;37.5
74;2021-07-12;2096;7899;419142;318672;50.6;38.5
74;2021-07-13;3967;7586;423109;326258;51.1;39.4
74;2021-07-14;1968;2238;425077;328496;51.3;39.7
74;2021-07-15;3593;6876;428670;335372;51.7;40.5
74;2021-07-16;4243;7741;432913;343113;52.3;41.4
74;2021-07-17;3004;5334;435917;348447;52.6;42.1
74;2021-07-18;156;155;436073;348602;52.6;42.1
74;2021-07-19;4295;7352;440368;355954;53.2;43.0
74;2021-07-20;5872;6469;446240;362423;53.9;43.7
74;2021-07-21;5668;6675;451908;369098;54.6;44.6
74;2021-07-22;4773;5323;456681;374421;55.1;45.2
74;2021-07-23;6227;6996;462908;381417;55.9;46.0
74;2021-07-24;3156;4316;466064;385733;56.3;46.6
74;2021-07-25;181;172;466245;385905;56.3;46.6
74;2021-07-26;5618;6135;471863;392040;57.0;47.3
74;2021-07-27;6852;5177;478715;397217;57.8;47.9
74;2021-07-28;6660;5102;485375;402319;58.6;48.6
74;2021-07-29;5280;3931;490655;406250;59.2;49.0
74;2021-07-30;6715;5504;497370;411754;60.0;49.7
74;2021-07-31;4378;3123;501748;414877;60.6;50.1
74;2021-08-01;184;149;501932;415026;60.6;50.1
74;2021-08-02;6273;4409;508205;419435;61.3;50.6
74;2021-08-03;6038;3860;514243;423295;62.1;51.1
74;2021-08-04;6325;3508;520568;426803;62.8;51.5
74;2021-08-05;4935;3270;525503;430073;63.4;51.9
74;2021-08-06;5069;4183;530572;434256;64.0;52.4
74;2021-08-07;3213;2899;533785;437155;64.4;52.8
74;2021-08-08;154;134;533939;437289;64.5;52.8
74;2021-08-09;4975;4828;538914;442117;65.1;53.4
74;2021-08-10;4991;4688;543905;446805;65.7;53.9
74;2021-08-11;4447;4891;548352;451696;66.2;54.5
74;2021-08-12;3626;3608;551978;455304;66.6;55.0
74;2021-08-13;3836;4625;555814;459929;67.1;55.5
74;2021-08-14;2184;3342;557998;463271;67.4;55.9
74;2021-08-15;66;103;558064;463374;67.4;55.9
74;2021-08-16;3913;5880;561977;469254;67.8;56.6
74;2021-08-17;3136;5486;565113;474740;68.2;57.3
74;2021-08-18;3091;5461;568204;480201;68.6;58.0
74;2021-08-19;2357;3897;570561;484098;68.9;58.4
74;2021-08-20;2638;5698;573199;489796;69.2;59.1
74;2021-08-21;1239;4273;574438;494069;69.3;59.6
74;2021-08-22;56;137;574494;494206;69.3;59.7
74;2021-08-23;2198;6697;576692;500903;69.6;60.5
74;2021-08-24;2219;5939;578911;506842;69.9;61.2
74;2021-08-25;1978;6295;580889;513137;70.1;61.9
74;2021-08-26;1564;3787;582453;516924;70.3;62.4
74;2021-08-27;1939;5510;584392;522434;70.5;63.1
74;2021-08-28;925;4042;585317;526476;70.7;63.6
74;2021-08-29;67;188;585384;526664;70.7;63.6
74;2021-08-30;1872;5353;587256;532017;70.9;64.2
74;2021-08-31;1678;4968;588934;536985;71.1;64.8
74;2021-09-01;1978;3878;590912;540863;71.3;65.3
74;2021-09-02;1225;2813;592137;543676;71.5;65.6
74;2021-09-03;1552;3835;593689;547511;71.7;66.1
74;2021-09-04;1158;2748;594847;550259;71.8;66.4
74;2021-09-05;49;92;594896;550351;71.8;66.4
74;2021-09-06;1260;3032;596156;553383;72.0;66.8
74;2021-09-07;1027;2745;597183;556128;72.1;67.1
74;2021-09-08;1309;2869;598492;558997;72.2;67.5
74;2021-09-09;1221;1936;599713;560933;72.4;67.7
74;2021-09-10;1123;2754;600836;563687;72.5;68.0
74;2021-09-11;765;2214;601601;565901;72.6;68.3
74;2021-09-12;40;74;601641;565975;72.6;68.3
74;2021-09-13;956;2069;602597;568044;72.7;68.6
74;2021-09-14;1057;1972;603654;570016;72.9;68.8
74;2021-09-15;1066;2274;604720;572290;73.0;69.1
74;2021-09-16;752;1031;605472;573321;73.1;69.2
74;2021-09-17;839;1848;606311;575169;73.2;69.4
74;2021-09-18;608;1671;606919;576840;73.3;69.6
74;2021-09-19;3;9;606922;576849;73.3;69.6
74;2021-09-20;810;1885;607732;578734;73.4;69.9
74;2021-09-21;638;1372;608370;580106;73.4;70.0
74;2021-09-22;618;2103;608988;582209;73.5;70.3
74;2021-09-23;638;998;609626;583207;73.6;70.4
74;2021-09-24;725;1970;610351;585177;73.7;70.6
74;2021-09-25;461;1621;610812;586798;73.7;70.8
74;2021-09-26;1;2;610813;586800;73.7;70.8
74;2021-09-27;574;1776;611387;588576;73.8;71.0
74;2021-09-28;397;961;611784;589537;73.9;71.2
74;2021-09-29;547;1564;612331;591101;73.9;71.4
74;2021-09-30;389;1060;612720;592161;74.0;71.5
74;2021-10-01;601;1120;613321;593281;74.0;71.6
74;2021-10-02;435;816;613756;594097;74.1;71.7
74;2021-10-03;5;11;613761;594108;74.1;71.7
74;2021-10-04;531;1110;614292;595218;74.2;71.9
74;2021-10-05;366;1089;614658;596307;74.2;72.0
74;2021-10-06;448;988;615106;597295;74.3;72.1
74;2021-10-07;301;630;615407;597925;74.3;72.2
74;2021-10-08;559;1155;615966;599080;74.4;72.3
74;2021-10-09;407;771;616373;599851;74.4;72.4
74;2021-10-10;5;15;616378;599866;74.4;72.4
74;2021-10-11;380;812;616758;600678;74.5;72.5
75;2020-12-27;77;11;77;11;0.0;0.0
75;2020-12-28;67;2;144;13;0.0;0.0
75;2020-12-29;33;3;177;16;0.0;0.0
75;2020-12-30;89;1;266;17;0.0;0.0
75;2020-12-31;48;4;314;21;0.0;0.0
75;2021-01-01;63;11;377;32;0.0;0.0
75;2021-01-02;67;4;444;36;0.0;0.0
75;2021-01-03;110;6;554;42;0.0;0.0
75;2021-01-04;323;11;877;53;0.0;0.0
75;2021-01-05;882;16;1759;69;0.1;0.0
75;2021-01-06;1372;23;3131;92;0.1;0.0
75;2021-01-07;2073;23;5204;115;0.2;0.0
75;2021-01-08;2881;34;8085;149;0.4;0.0
75;2021-01-09;1099;3;9184;152;0.4;0.0
75;2021-01-10;1100;4;10284;156;0.5;0.0
75;2021-01-11;3120;69;13404;225;0.6;0.0
75;2021-01-12;3493;64;16897;289;0.8;0.0
75;2021-01-13;3575;58;20472;347;1.0;0.0
75;2021-01-14;3803;105;24275;452;1.1;0.0
75;2021-01-15;3341;68;27616;520;1.3;0.0
75;2021-01-16;1148;27;28764;547;1.3;0.0
75;2021-01-17;564;19;29328;566;1.4;0.0
75;2021-01-18;3294;84;32622;650;1.5;0.0
75;2021-01-19;3881;61;36503;711;1.7;0.0
75;2021-01-20;4443;81;40946;792;1.9;0.0
75;2021-01-21;4953;103;45899;895;2.1;0.0
75;2021-01-22;4610;99;50509;994;2.4;0.0
75;2021-01-23;1771;16;52280;1010;2.4;0.0
75;2021-01-24;763;12;53043;1022;2.5;0.0
75;2021-01-25;1743;37;54786;1059;2.6;0.0
75;2021-01-26;2564;100;57350;1159;2.7;0.1
75;2021-01-27;3176;184;60526;1343;2.8;0.1
75;2021-01-28;4791;260;65317;1603;3.0;0.1
75;2021-01-29;4066;276;69383;1879;3.2;0.1
75;2021-01-30;1361;36;70744;1915;3.3;0.1
75;2021-01-31;225;3;70969;1918;3.3;0.1
75;2021-02-01;1637;382;72606;2300;3.4;0.1
75;2021-02-02;2155;653;74761;2953;3.5;0.1
75;2021-02-03;1899;692;76660;3645;3.6;0.2
75;2021-02-04;2155;1131;78815;4776;3.7;0.2
75;2021-02-05;2228;873;81043;5649;3.8;0.3
75;2021-02-06;1142;111;82185;5760;3.8;0.3
75;2021-02-07;179;9;82364;5769;3.8;0.3
75;2021-02-08;1270;1466;83634;7235;3.9;0.3
75;2021-02-09;1803;2388;85437;9623;4.0;0.4
75;2021-02-10;2430;2393;87867;12016;4.1;0.6
75;2021-02-11;2952;6306;90819;18322;4.2;0.9
75;2021-02-12;3141;2411;93960;20733;4.4;1.0
75;2021-02-13;863;1040;94823;21773;4.4;1.0
75;2021-02-14;214;47;95037;21820;4.4;1.0
75;2021-02-15;1011;2443;96048;24263;4.5;1.1
75;2021-02-16;1471;6481;97519;30744;4.5;1.4
75;2021-02-17;1347;3217;98866;33961;4.6;1.6
75;2021-02-18;1778;5815;100644;39776;4.7;1.9
75;2021-02-19;2233;4135;102877;43911;4.8;2.0
75;2021-02-20;485;1675;103362;45586;4.8;2.1
75;2021-02-21;201;167;103563;45753;4.8;2.1
75;2021-02-22;1230;1925;104793;47678;4.9;2.2
75;2021-02-23;1474;2718;106267;50396;4.9;2.3
75;2021-02-24;1703;2336;107970;52732;5.0;2.5
75;2021-02-25;2800;5305;110770;58037;5.2;2.7
75;2021-02-26;3387;2730;114157;60767;5.3;2.8
75;2021-02-27;1411;946;115568;61713;5.4;2.9
75;2021-02-28;330;147;115898;61860;5.4;2.9
75;2021-03-01;2613;1700;118511;63560;5.5;3.0
75;2021-03-02;4198;2241;122709;65801;5.7;3.1
75;2021-03-03;5446;2383;128155;68184;6.0;3.2
75;2021-03-04;8066;2654;136221;70838;6.3;3.3
75;2021-03-05;10588;2816;146809;73654;6.8;3.4
75;2021-03-06;11090;1141;157899;74795;7.4;3.5
75;2021-03-07;9513;1563;167412;76358;7.8;3.6
75;2021-03-08;5929;1617;173341;77975;8.1;3.6
75;2021-03-09;7546;2183;180887;80158;8.4;3.7
75;2021-03-10;7525;2189;188412;82347;8.8;3.8
75;2021-03-11;10370;2612;198782;84959;9.3;4.0
75;2021-03-12;12079;2639;210861;87598;9.8;4.1
75;2021-03-13;8563;818;219424;88416;10.2;4.1
75;2021-03-14;4180;272;223604;88688;10.4;4.1
75;2021-03-15;7483;1016;231087;89704;10.8;4.2
75;2021-03-16;5168;728;236255;90432;11.0;4.2
75;2021-03-17;5437;871;241692;91303;11.3;4.3
75;2021-03-18;6630;914;248322;92217;11.6;4.3
75;2021-03-19;9774;1049;258096;93266;12.0;4.3
75;2021-03-20;5945;626;264041;93892;12.3;4.4
75;2021-03-21;1596;437;265637;94329;12.4;4.4
75;2021-03-22;8668;1064;274305;95393;12.8;4.4
75;2021-03-23;10975;1314;285280;96707;13.3;4.5
75;2021-03-24;11022;1384;296302;98091;13.8;4.6
75;2021-03-25;14225;1610;310527;99701;14.5;4.6
75;2021-03-26;13996;1763;324523;101464;15.1;4.7
75;2021-03-27;7293;799;331816;102263;15.4;4.8
75;2021-03-28;1791;166;333607;102429;15.5;4.8
75;2021-03-29;7984;2238;341591;104667;15.9;4.9
75;2021-03-30;10950;3295;352541;107962;16.4;5.0
75;2021-03-31;9756;3657;362297;111619;16.9;5.2
75;2021-04-01;10720;5257;373017;116876;17.4;5.4
75;2021-04-02;9068;5633;382085;122509;17.8;5.7
75;2021-04-03;4129;4913;386214;127422;18.0;5.9
75;2021-04-04;1424;1502;387638;128924;18.0;6.0
75;2021-04-05;2263;1443;389901;130367;18.1;6.1
75;2021-04-06;6931;4347;396832;134714;18.5;6.3
75;2021-04-07;8110;4461;404942;139175;18.8;6.5
75;2021-04-08;11097;4230;416039;143405;19.4;6.7
75;2021-04-09;12221;4674;428260;148079;19.9;6.9
75;2021-04-10;5851;4295;434111;152374;20.2;7.1
75;2021-04-11;1951;1807;436062;154181;20.3;7.2
75;2021-04-12;7492;3821;443554;158002;20.6;7.4
75;2021-04-13;8577;6880;452131;164882;21.0;7.7
75;2021-04-14;8309;5263;460440;170145;21.4;7.9
75;2021-04-15;8937;6177;469377;176322;21.8;8.2
75;2021-04-16;9399;6150;478776;182472;22.3;8.5
75;2021-04-17;4822;3655;483598;186127;22.5;8.7
75;2021-04-18;1674;885;485272;187012;22.6;8.7
75;2021-04-19;5595;4982;490867;191994;22.8;8.9
75;2021-04-20;6475;5991;497342;197985;23.2;9.2
75;2021-04-21;6882;5602;504224;203587;23.5;9.5
75;2021-04-22;7550;5942;511774;209529;23.8;9.8
75;2021-04-23;8704;6509;520478;216038;24.2;10.1
75;2021-04-24;6185;3369;526663;219407;24.5;10.2
75;2021-04-25;2974;770;529637;220177;24.7;10.2
75;2021-04-26;7033;4736;536670;224913;25.0;10.5
75;2021-04-27;10600;6452;547270;231365;25.5;10.8
75;2021-04-28;12207;6053;559477;237418;26.0;11.1
75;2021-04-29;13765;6379;573242;243797;26.7;11.3
75;2021-04-30;13669;6217;586911;250014;27.3;11.6
75;2021-05-01;5081;1337;591992;251351;27.6;11.7
75;2021-05-02;2391;806;594383;252157;27.7;11.7
75;2021-05-03;10298;13515;604681;265672;28.1;12.4
75;2021-05-04;11200;8101;615881;273773;28.7;12.7
75;2021-05-05;13566;6735;629447;280508;29.3;13.1
75;2021-05-06;14010;8216;643457;288724;30.0;13.4
75;2021-05-07;13989;8602;657446;297326;30.6;13.8
75;2021-05-08;10087;5523;667533;302849;31.1;14.1
75;2021-05-09;3821;3194;671354;306043;31.3;14.2
75;2021-05-10;14301;6731;685655;312774;31.9;14.6
75;2021-05-11;16853;8414;702508;321188;32.7;15.0
75;2021-05-12;17966;8165;720474;329353;33.5;15.3
75;2021-05-13;13648;2495;734122;331848;34.2;15.4
75;2021-05-14;18397;5135;752519;336983;35.0;15.7
75;2021-05-15;12326;2660;764845;339643;35.6;15.8
75;2021-05-16;3862;760;768707;340403;35.8;15.8
75;2021-05-17;16013;4649;784720;345052;36.5;16.1
75;2021-05-18;19162;5324;803882;350376;37.4;16.3
75;2021-05-19;20733;10701;824615;361077;38.4;16.8
75;2021-05-20;21587;8663;846202;369740;39.4;17.2
75;2021-05-21;21033;6553;867235;376293;40.4;17.5
75;2021-05-22;15911;3300;883146;379593;41.1;17.7
75;2021-05-23;5639;1335;888785;380928;41.4;17.7
75;2021-05-24;15637;2559;904422;383487;42.1;17.9
75;2021-05-25;18037;9564;922459;393051;42.9;18.3
75;2021-05-26;18891;8203;941350;401254;43.8;18.7
75;2021-05-27;20148;9792;961498;411046;44.8;19.1
75;2021-05-28;19339;10841;980837;421887;45.7;19.6
75;2021-05-29;16115;5838;996952;427725;46.4;19.9
75;2021-05-30;7040;2157;1003992;429882;46.7;20.0
75;2021-05-31;18095;9438;1022087;439320;47.6;20.4
75;2021-06-01;18699;12980;1040786;452300;48.4;21.1
75;2021-06-02;18122;10303;1058908;462603;49.3;21.5
75;2021-06-03;20256;11956;1079164;474559;50.2;22.1
75;2021-06-04;18120;12841;1097284;487400;51.1;22.7
75;2021-06-05;11992;9614;1109276;497014;51.6;23.1
75;2021-06-06;6728;3162;1116004;500176;51.9;23.3
75;2021-06-07;13894;11827;1129898;512003;52.6;23.8
75;2021-06-08;14805;13966;1144703;525969;53.3;24.5
75;2021-06-09;16509;15235;1161212;541204;54.1;25.2
75;2021-06-10;18367;26293;1179579;567497;54.9;26.4
75;2021-06-11;15312;16458;1194891;583955;55.6;27.2
75;2021-06-12;13285;10004;1208176;593959;56.2;27.6
75;2021-06-13;6279;3794;1214455;597753;56.5;27.8
75;2021-06-14;11827;15398;1226282;613151;57.1;28.5
75;2021-06-15;12729;19548;1239011;632699;57.7;29.5
75;2021-06-16;12211;17240;1251222;649939;58.2;30.3
75;2021-06-17;12661;17677;1263883;667616;58.8;31.1
75;2021-06-18;11277;22608;1275160;690224;59.4;32.1
75;2021-06-19;7532;11821;1282692;702045;59.7;32.7
75;2021-06-20;2821;5477;1285513;707522;59.8;32.9
75;2021-06-21;8515;16331;1294028;723853;60.2;33.7
75;2021-06-22;8810;21793;1302838;745646;60.6;34.7
75;2021-06-23;10309;21430;1313147;767076;61.1;35.7
75;2021-06-24;11320;20640;1324467;787716;61.7;36.7
75;2021-06-25;9876;24685;1334343;812401;62.1;37.8
75;2021-06-26;7936;15419;1342279;827820;62.5;38.5
75;2021-06-27;2701;6325;1344980;834145;62.6;38.8
75;2021-06-28;8477;20153;1353457;854298;63.0;39.8
75;2021-06-29;9348;23831;1362805;878129;63.4;40.9
75;2021-06-30;10216;23625;1373021;901754;63.9;42.0
75;2021-07-01;11438;23516;1384459;925270;64.4;43.1
75;2021-07-02;10893;24771;1395352;950041;65.0;44.2
75;2021-07-03;7817;19806;1403169;969847;65.3;45.1
75;2021-07-04;3909;9556;1407078;979403;65.5;45.6
75;2021-07-05;9348;21583;1416426;1000986;65.9;46.6
75;2021-07-06;10173;24010;1426599;1024996;66.4;47.7
75;2021-07-07;10165;25091;1436764;1050087;66.9;48.9
75;2021-07-08;10672;25025;1447436;1075112;67.4;50.0
75;2021-07-09;10869;24039;1458305;1099151;67.9;51.2
75;2021-07-10;7953;18499;1466258;1117650;68.3;52.0
75;2021-07-11;4350;8528;1470608;1126178;68.5;52.4
75;2021-07-12;9863;23091;1480471;1149269;68.9;53.5
75;2021-07-13;14396;24812;1494867;1174081;69.6;54.7
75;2021-07-14;8353;9728;1503220;1183809;70.0;55.1
75;2021-07-15;15584;25665;1518804;1209474;70.7;56.3
75;2021-07-16;15826;22157;1534630;1231631;71.4;57.3
75;2021-07-17;12196;16912;1546826;1248543;72.0;58.1
75;2021-07-18;6267;6842;1553093;1255385;72.3;58.4
75;2021-07-19;14405;21302;1567498;1276687;73.0;59.4
75;2021-07-20;16074;21901;1583572;1298588;73.7;60.4
75;2021-07-21;15714;20712;1599286;1319300;74.4;61.4
75;2021-07-22;17152;20101;1616438;1339401;75.2;62.3
75;2021-07-23;17168;19110;1633606;1358511;76.0;63.2
75;2021-07-24;11199;14081;1644805;1372592;76.6;63.9
75;2021-07-25;5006;5071;1649811;1377663;76.8;64.1
75;2021-07-26;15183;16876;1664994;1394539;77.5;64.9
75;2021-07-27;18153;16672;1683147;1411211;78.3;65.7
75;2021-07-28;17153;15496;1700300;1426707;79.1;66.4
75;2021-07-29;16775;15098;1717075;1441805;79.9;67.1
75;2021-07-30;16838;14354;1733913;1456159;80.7;67.8
75;2021-07-31;9348;9868;1743261;1466027;81.1;68.2
75;2021-08-01;3726;3256;1746987;1469283;81.3;68.4
75;2021-08-02;10974;11987;1757961;1481270;81.8;69.0
75;2021-08-03;11137;10841;1769098;1492111;82.3;69.5
75;2021-08-04;9732;9484;1778830;1501595;82.8;69.9
75;2021-08-05;8726;9556;1787556;1511151;83.2;70.3
75;2021-08-06;8259;9994;1795815;1521145;83.6;70.8
75;2021-08-07;5713;7159;1801528;1528304;83.9;71.1
75;2021-08-08;1969;3282;1803497;1531586;84.0;71.3
75;2021-08-09;8612;11480;1812109;1543066;84.4;71.8
75;2021-08-10;9304;11592;1821413;1554658;84.8;72.4
75;2021-08-11;7793;10145;1829206;1564803;85.1;72.8
75;2021-08-12;6945;10599;1836151;1575402;85.5;73.3
75;2021-08-13;6262;8869;1842413;1584271;85.8;73.7
75;2021-08-14;4121;7200;1846534;1591471;86.0;74.1
75;2021-08-15;1032;1938;1847566;1593409;86.0;74.2
75;2021-08-16;6145;14033;1853711;1607442;86.3;74.8
75;2021-08-17;5819;13608;1859530;1621050;86.6;75.5
75;2021-08-18;5083;12012;1864613;1633062;86.8;76.0
75;2021-08-19;4777;12689;1869390;1645751;87.0;76.6
75;2021-08-20;4569;11791;1873959;1657542;87.2;77.2
75;2021-08-21;3191;8813;1877150;1666355;87.4;77.6
75;2021-08-22;998;3163;1878148;1669518;87.4;77.7
75;2021-08-23;4929;15307;1883077;1684825;87.7;78.4
75;2021-08-24;4811;14538;1887888;1699363;87.9;79.1
75;2021-08-25;4540;12335;1892428;1711698;88.1;79.7
75;2021-08-26;4093;10281;1896521;1721979;88.3;80.2
75;2021-08-27;4486;11684;1901007;1733663;88.5;80.7
75;2021-08-28;3073;8306;1904080;1741969;88.6;81.1
75;2021-08-29;755;2020;1904835;1743989;88.7;81.2
75;2021-08-30;4530;14025;1909365;1758014;88.9;81.8
75;2021-08-31;4428;12788;1913793;1770802;89.1;82.4
75;2021-09-01;4098;9851;1917891;1780653;89.3;82.9
75;2021-09-02;3312;7867;1921203;1788520;89.4;83.3
75;2021-09-03;3750;8707;1924953;1797227;89.6;83.7
75;2021-09-04;3592;7870;1928545;1805097;89.8;84.0
75;2021-09-05;709;1365;1929254;1806462;89.8;84.1
75;2021-09-06;2622;6564;1931876;1813026;89.9;84.4
75;2021-09-07;2415;6011;1934291;1819037;90.0;84.7
75;2021-09-08;2631;6032;1936922;1825069;90.2;85.0
75;2021-09-09;2477;5307;1939399;1830376;90.3;85.2
75;2021-09-10;2807;6200;1942206;1836576;90.4;85.5
75;2021-09-11;2440;6204;1944646;1842780;90.5;85.8
75;2021-09-12;507;1008;1945153;1843788;90.5;85.8
75;2021-09-13;2333;4918;1947486;1848706;90.7;86.1
75;2021-09-14;2290;4033;1949776;1852739;90.8;86.2
75;2021-09-15;2311;4654;1952087;1857393;90.9;86.5
75;2021-09-16;1899;3715;1953986;1861108;91.0;86.6
75;2021-09-17;2558;4766;1956544;1865874;91.1;86.9
75;2021-09-18;1574;4682;1958118;1870556;91.1;87.1
75;2021-09-19;285;739;1958403;1871295;91.2;87.1
75;2021-09-20;1724;3649;1960127;1874944;91.2;87.3
75;2021-09-21;1628;3205;1961755;1878149;91.3;87.4
75;2021-09-22;1587;3965;1963342;1882114;91.4;87.6
75;2021-09-23;1423;2850;1964765;1884964;91.5;87.7
75;2021-09-24;1799;4034;1966564;1888998;91.5;87.9
75;2021-09-25;1262;4351;1967826;1893349;91.6;88.1
75;2021-09-26;281;530;1968107;1893879;91.6;88.2
75;2021-09-27;1310;3018;1969417;1896897;91.7;88.3
75;2021-09-28;1405;2474;1970822;1899371;91.7;88.4
75;2021-09-29;1378;2875;1972200;1902246;91.8;88.5
75;2021-09-30;1263;2515;1973463;1904761;91.9;88.7
75;2021-10-01;1518;2681;1974981;1907442;91.9;88.8
75;2021-10-02;1412;2757;1976393;1910199;92.0;88.9
75;2021-10-03;223;424;1976616;1910623;92.0;88.9
75;2021-10-04;1351;2511;1977967;1913134;92.1;89.1
75;2021-10-05;1086;2165;1979053;1915299;92.1;89.2
75;2021-10-06;1213;2414;1980266;1917713;92.2;89.3
75;2021-10-07;1126;2068;1981392;1919781;92.2;89.4
75;2021-10-08;1483;3050;1982875;1922831;92.3;89.5
75;2021-10-09;1294;2238;1984169;1925069;92.4;89.6
75;2021-10-10;236;360;1984405;1925429;92.4;89.6
75;2021-10-11;1231;2208;1985636;1927637;92.4;89.7
76;2020-12-27;0;0;0;0;0.0;0.0
76;2020-12-28;1;1;1;1;0.0;0.0
76;2020-12-29;0;0;1;1;0.0;0.0
76;2020-12-30;0;0;1;1;0.0;0.0
76;2020-12-31;0;0;1;1;0.0;0.0
76;2021-01-01;0;0;1;1;0.0;0.0
76;2021-01-02;0;0;1;1;0.0;0.0
76;2021-01-03;0;0;1;1;0.0;0.0
76;2021-01-04;17;0;18;1;0.0;0.0
76;2021-01-05;138;0;156;1;0.0;0.0
76;2021-01-06;682;2;838;3;0.1;0.0
76;2021-01-07;1354;7;2192;10;0.2;0.0
76;2021-01-08;1537;2;3729;12;0.3;0.0
76;2021-01-09;736;2;4465;14;0.4;0.0
76;2021-01-10;492;2;4957;16;0.4;0.0
76;2021-01-11;1358;3;6315;19;0.5;0.0
76;2021-01-12;1358;3;7673;22;0.6;0.0
76;2021-01-13;1187;5;8860;27;0.7;0.0
76;2021-01-14;2178;24;11038;51;0.9;0.0
76;2021-01-15;1910;9;12948;60;1.0;0.0
76;2021-01-16;991;8;13939;68;1.1;0.0
76;2021-01-17;2898;23;16837;91;1.4;0.0
76;2021-01-18;4395;19;21232;110;1.7;0.0
76;2021-01-19;3021;11;24253;121;1.9;0.0
76;2021-01-20;2072;10;26325;131;2.1;0.0
76;2021-01-21;1773;4;28098;135;2.3;0.0
76;2021-01-22;1705;4;29803;139;2.4;0.0
76;2021-01-23;450;4;30253;143;2.4;0.0
76;2021-01-24;100;0;30353;143;2.4;0.0
76;2021-01-25;1476;139;31829;282;2.6;0.0
76;2021-01-26;1394;335;33223;617;2.7;0.0
76;2021-01-27;1341;433;34564;1050;2.8;0.1
76;2021-01-28;1286;385;35850;1435;2.9;0.1
76;2021-01-29;1155;458;37005;1893;3.0;0.2
76;2021-01-30;283;302;37288;2195;3.0;0.2
76;2021-01-31;4;98;37292;2293;3.0;0.2
76;2021-02-01;842;808;38134;3101;3.1;0.2
76;2021-02-02;1056;1017;39190;4118;3.2;0.3
76;2021-02-03;921;996;40111;5114;3.2;0.4
76;2021-02-04;976;1454;41087;6568;3.3;0.5
76;2021-02-05;975;1105;42062;7673;3.4;0.6
76;2021-02-06;264;878;42326;8551;3.4;0.7
76;2021-02-07;468;1654;42794;10205;3.4;0.8
76;2021-02-08;1924;3729;44718;13934;3.6;1.1
76;2021-02-09;1753;2990;46471;16924;3.7;1.4
76;2021-02-10;1488;1809;47959;18733;3.9;1.5
76;2021-02-11;1680;1529;49639;20262;4.0;1.6
76;2021-02-12;1706;1573;51345;21835;4.1;1.8
76;2021-02-13;230;337;51575;22172;4.1;1.8
76;2021-02-14;9;82;51584;22254;4.1;1.8
76;2021-02-15;552;1713;52136;23967;4.2;1.9
76;2021-02-16;742;1642;52878;25609;4.3;2.1
76;2021-02-17;626;1448;53504;27057;4.3;2.2
76;2021-02-18;780;1392;54284;28449;4.4;2.3
76;2021-02-19;870;1341;55154;29790;4.4;2.4
76;2021-02-20;270;287;55424;30077;4.5;2.4
76;2021-02-21;0;0;55424;30077;4.5;2.4
76;2021-02-22;371;1306;55795;31383;4.5;2.5
76;2021-02-23;576;1238;56371;32621;4.5;2.6
76;2021-02-24;601;1198;56972;33819;4.6;2.7
76;2021-02-25;1665;1265;58637;35084;4.7;2.8
76;2021-02-26;2171;1057;60808;36141;4.9;2.9
76;2021-02-27;1109;276;61917;36417;5.0;2.9
76;2021-02-28;27;196;61944;36613;5.0;2.9
76;2021-03-01;830;2087;62774;38700;5.0;3.1
76;2021-03-02;1383;1719;64157;40419;5.2;3.2
76;2021-03-03;1942;1391;66099;41810;5.3;3.4
76;2021-03-04;2819;1120;68918;42930;5.5;3.5
76;2021-03-05;4183;826;73101;43756;5.9;3.5
76;2021-03-06;3366;172;76467;43928;6.1;3.5
76;2021-03-07;1257;36;77724;43964;6.2;3.5
76;2021-03-08;2102;1262;79826;45226;6.4;3.6
76;2021-03-09;3575;1174;83401;46400;6.7;3.7
76;2021-03-10;3595;1073;86996;47473;7.0;3.8
76;2021-03-11;5635;952;92631;48425;7.4;3.9
76;2021-03-12;6830;620;99461;49045;8.0;3.9
76;2021-03-13;4646;158;104107;49203;8.4;4.0
76;2021-03-14;1068;28;105175;49231;8.5;4.0
76;2021-03-15;2919;245;108094;49476;8.7;4.0
76;2021-03-16;2557;403;110651;49879;8.9;4.0
76;2021-03-17;2696;319;113347;50198;9.1;4.0
76;2021-03-18;3003;318;116350;50516;9.4;4.1
76;2021-03-19;4397;441;120747;50957;9.7;4.1
76;2021-03-20;3974;301;124721;51258;10.0;4.1
76;2021-03-21;838;18;125559;51276;10.1;4.1
76;2021-03-22;3992;356;129551;51632;10.4;4.2
76;2021-03-23;5710;369;135261;52001;10.9;4.2
76;2021-03-24;5701;404;140962;52405;11.3;4.2
76;2021-03-25;7505;581;148467;52986;11.9;4.3
76;2021-03-26;8722;605;157189;53591;12.6;4.3
76;2021-03-27;4809;397;161998;53988;13.0;4.3
76;2021-03-28;1021;32;163019;54020;13.1;4.3
76;2021-03-29;5388;836;168407;54856;13.5;4.4
76;2021-03-30;6587;1068;174994;55924;14.1;4.5
76;2021-03-31;6462;1284;181456;57208;14.6;4.6
76;2021-04-01;6784;2045;188240;59253;15.1;4.8
76;2021-04-02;6485;2689;194725;61942;15.7;5.0
76;2021-04-03;2442;1083;197167;63025;15.9;5.1
76;2021-04-04;265;11;197432;63036;15.9;5.1
76;2021-04-05;869;379;198301;63415;15.9;5.1
76;2021-04-06;3557;2798;201858;66213;16.2;5.3
76;2021-04-07;4415;2412;206273;68625;16.6;5.5
76;2021-04-08;5841;2788;212114;71413;17.1;5.7
76;2021-04-09;8803;3083;220917;74496;17.8;6.0
76;2021-04-10;4876;1429;225793;75925;18.2;6.1
76;2021-04-11;814;535;226607;76460;18.2;6.1
76;2021-04-12;4726;2860;231333;79320;18.6;6.4
76;2021-04-13;5926;2874;237259;82194;19.1;6.6
76;2021-04-14;4803;3135;242062;85329;19.5;6.9
76;2021-04-15;5562;3363;247624;88692;19.9;7.1
76;2021-04-16;7356;3448;254980;92140;20.5;7.4
76;2021-04-17;4387;1436;259367;93576;20.9;7.5
76;2021-04-18;339;141;259706;93717;20.9;7.5
76;2021-04-19;3478;3779;263184;97496;21.2;7.8
76;2021-04-20;4344;4285;267528;101781;21.5;8.2
76;2021-04-21;4192;4697;271720;106478;21.8;8.6
76;2021-04-22;4564;5443;276284;111921;22.2;9.0
76;2021-04-23;5444;5981;281728;117902;22.7;9.5
76;2021-04-24;4165;2197;285893;120099;23.0;9.7
76;2021-04-25;894;269;286787;120368;23.1;9.7
76;2021-04-26;4484;4480;291271;124848;23.4;10.0
76;2021-04-27;5000;5010;296271;129858;23.8;10.4
76;2021-04-28;5348;4179;301619;134037;24.3;10.8
76;2021-04-29;6926;4177;308545;138214;24.8;11.1
76;2021-04-30;8219;4659;316764;142873;25.5;11.5
76;2021-05-01;4828;1017;321592;143890;25.9;11.6
76;2021-05-02;1842;265;323434;144155;26.0;11.6
76;2021-05-03;4703;3314;328137;147469;26.4;11.9
76;2021-05-04;4822;4563;332959;152032;26.8;12.2
76;2021-05-05;4783;5182;337742;157214;27.2;12.6
76;2021-05-06;5923;5590;343665;162804;27.6;13.1
76;2021-05-07;6137;6771;349802;169575;28.1;13.6
76;2021-05-08;5056;916;354858;170491;28.5;13.7
76;2021-05-09;2541;235;357399;170726;28.7;13.7
76;2021-05-10;4947;5069;362346;175795;29.1;14.1
76;2021-05-11;6519;5690;368865;181485;29.7;14.6
76;2021-05-12;6263;5085;375128;186570;30.2;15.0
76;2021-05-13;8842;1284;383970;187854;30.9;15.1
76;2021-05-14;10414;4664;394384;192518;31.7;15.5
76;2021-05-15;9119;2458;403503;194976;32.4;15.7
76;2021-05-16;6236;479;409739;195455;32.9;15.7
76;2021-05-17;7226;3279;416965;198734;33.5;16.0
76;2021-05-18;8304;2818;425269;201552;34.2;16.2
76;2021-05-19;8402;3200;433671;204752;34.9;16.5
76;2021-05-20;9650;3428;443321;208180;35.6;16.7
76;2021-05-21;8369;4097;451690;212277;36.3;17.1
76;2021-05-22;7163;2365;458853;214642;36.9;17.3
76;2021-05-23;6388;416;465241;215058;37.4;17.3
76;2021-05-24;6864;1529;472105;216587;38.0;17.4
76;2021-05-25;8024;4091;480129;220678;38.6;17.7
76;2021-05-26;7571;3611;487700;224289;39.2;18.0
76;2021-05-27;8340;4709;496040;228998;39.9;18.4
76;2021-05-28;8231;6572;504271;235570;40.5;18.9
76;2021-05-29;6225;3516;510496;239086;41.0;19.2
76;2021-05-30;3149;431;513645;239517;41.3;19.3
76;2021-05-31;8168;3973;521813;243490;42.0;19.6
76;2021-06-01;9209;5035;531022;248525;42.7;20.0
76;2021-06-02;7929;4447;538951;252972;43.3;20.3
76;2021-06-03;9540;5409;548491;258381;44.1;20.8
76;2021-06-04;9242;6699;557733;265080;44.8;21.3
76;2021-06-05;6285;3816;564018;268896;45.3;21.6
76;2021-06-06;2556;650;566574;269546;45.6;21.7
76;2021-06-07;6978;5455;573552;275001;46.1;22.1
76;2021-06-08;8661;6290;582213;281291;46.8;22.6
76;2021-06-09;7210;6083;589423;287374;47.4;23.1
76;2021-06-10;8000;6564;597423;293938;48.0;23.6
76;2021-06-11;7575;8240;604998;302178;48.6;24.3
76;2021-06-12;7166;5879;612164;308057;49.2;24.8
76;2021-06-13;2962;1295;615126;309352;49.5;24.9
76;2021-06-14;6487;6735;621613;316087;50.0;25.4
76;2021-06-15;6301;7478;627914;323565;50.5;26.0
76;2021-06-16;6651;7485;634565;331050;51.0;26.6
76;2021-06-17;7011;7759;641576;338809;51.6;27.2
76;2021-06-18;7687;9232;649263;348041;52.2;28.0
76;2021-06-19;5988;6260;655251;354301;52.7;28.5
76;2021-06-20;2809;1818;658060;356119;52.9;28.6
76;2021-06-21;5589;8176;663649;364295;53.4;29.3
76;2021-06-22;4923;9881;668572;374176;53.8;30.1
76;2021-06-23;4727;9434;673299;383610;54.1;30.8
76;2021-06-24;4796;9922;678095;393532;54.5;31.6
76;2021-06-25;5219;11584;683314;405116;54.9;32.6
76;2021-06-26;3454;7878;686768;412994;55.2;33.2
76;2021-06-27;1367;5162;688135;418156;55.3;33.6
76;2021-06-28;3612;9950;691747;428106;55.6;34.4
76;2021-06-29;3873;10227;695620;438333;55.9;35.2
76;2021-06-30;4267;9838;699887;448171;56.3;36.0
76;2021-07-01;4596;9909;704483;458080;56.6;36.8
76;2021-07-02;4368;12014;708851;470094;57.0;37.8
76;2021-07-03;3583;8450;712434;478544;57.3;38.5
76;2021-07-04;1487;5305;713921;483849;57.4;38.9
76;2021-07-05;3956;9332;717877;493181;57.7;39.7
76;2021-07-06;4055;10075;721932;503256;58.0;40.5
76;2021-07-07;4011;9327;725943;512583;58.4;41.2
76;2021-07-08;4465;9463;730408;522046;58.7;42.0
76;2021-07-09;4364;12413;734772;534459;59.1;43.0
76;2021-07-10;3138;8556;737910;543015;59.3;43.7
76;2021-07-11;1777;2821;739687;545836;59.5;43.9
76;2021-07-12;3155;11155;742842;556991;59.7;44.8
76;2021-07-13;4933;12264;747775;569255;60.1;45.8
76;2021-07-14;4803;5548;752578;574803;60.5;46.2
76;2021-07-15;5911;11790;758489;586593;61.0;47.2
76;2021-07-16;6720;12019;765209;598612;61.5;48.1
76;2021-07-17;5277;8709;770486;607321;61.9;48.8
76;2021-07-18;2257;3357;772743;610678;62.1;49.1
76;2021-07-19;5160;11155;777903;621833;62.5;50.0
76;2021-07-20;6276;11628;784179;633461;63.0;50.9
76;2021-07-21;6342;10571;790521;644032;63.6;51.8
76;2021-07-22;8240;9655;798761;653687;64.2;52.6
76;2021-07-23;7643;12003;806404;665690;64.8;53.5
76;2021-07-24;4992;7717;811396;673407;65.2;54.1
76;2021-07-25;2873;3139;814269;676546;65.5;54.4
76;2021-07-26;5432;10149;819701;686695;65.9;55.2
76;2021-07-27;8338;9557;828039;696252;66.6;56.0
76;2021-07-28;8270;7825;836309;704077;67.2;56.6
76;2021-07-29;9589;6991;845898;711068;68.0;57.2
76;2021-07-30;8011;7849;853909;718917;68.7;57.8
76;2021-07-31;6614;5333;860523;724250;69.2;58.2
76;2021-08-01;3863;2087;864386;726337;69.5;58.4
76;2021-08-02;6563;7101;870949;733438;70.0;59.0
76;2021-08-03;7972;6361;878921;739799;70.7;59.5
76;2021-08-04;7259;5847;886180;745646;71.2;59.9
76;2021-08-05;8100;5731;894280;751377;71.9;60.4
76;2021-08-06;6811;6875;901091;758252;72.4;61.0
76;2021-08-07;4792;4386;905883;762638;72.8;61.3
76;2021-08-08;2409;2158;908292;764796;73.0;61.5
76;2021-08-09;5638;6740;913930;771536;73.5;62.0
76;2021-08-10;6351;6557;920281;778093;74.0;62.6
76;2021-08-11;6452;5497;926733;783590;74.5;63.0
76;2021-08-12;6046;6063;932779;789653;75.0;63.5
76;2021-08-13;5058;6211;937837;795864;75.4;64.0
76;2021-08-14;3840;4599;941677;800463;75.7;64.4
76;2021-08-15;1579;2357;943256;802820;75.8;64.5
76;2021-08-16;3666;6719;946922;809539;76.1;65.1
76;2021-08-17;3919;6946;950841;816485;76.4;65.6
76;2021-08-18;3747;6738;954588;823223;76.7;66.2
76;2021-08-19;3390;7171;957978;830394;77.0;66.8
76;2021-08-20;3434;7831;961412;838225;77.3;67.4
76;2021-08-21;1825;4220;963237;842445;77.4;67.7
76;2021-08-22;871;3295;964108;845740;77.5;68.0
76;2021-08-23;2625;7761;966733;853501;77.7;68.6
76;2021-08-24;2824;7591;969557;861092;78.0;69.2
76;2021-08-25;2630;7079;972187;868171;78.2;69.8
76;2021-08-26;2074;5800;974261;873971;78.3;70.3
76;2021-08-27;2701;7952;976962;881923;78.5;70.9
76;2021-08-28;2137;6063;979099;887986;78.7;71.4
76;2021-08-29;698;3013;979797;890999;78.8;71.6
76;2021-08-30;2167;7348;981964;898347;78.9;72.2
76;2021-08-31;1944;7139;983908;905486;79.1;72.8
76;2021-09-01;1729;6410;985637;911896;79.2;73.3
76;2021-09-02;1306;4504;986943;916400;79.3;73.7
76;2021-09-03;1593;6603;988536;923003;79.5;74.2
76;2021-09-04;1618;5990;990154;928993;79.6;74.7
76;2021-09-05;636;1820;990790;930813;79.7;74.8
76;2021-09-06;1345;4372;992135;935185;79.8;75.2
76;2021-09-07;1169;3721;993304;938906;79.9;75.5
76;2021-09-08;1277;4458;994581;943364;80.0;75.8
76;2021-09-09;1094;2918;995675;946282;80.1;76.1
76;2021-09-10;1702;4032;997377;950314;80.2;76.4
76;2021-09-11;1167;3202;998544;953516;80.3;76.7
76;2021-09-12;286;828;998830;954344;80.3;76.7
76;2021-09-13;827;2193;999657;956537;80.4;76.9
76;2021-09-14;1379;2623;1001036;959160;80.5;77.1
76;2021-09-15;1173;3269;1002209;962429;80.6;77.4
76;2021-09-16;1272;1959;1003481;964388;80.7;77.5
76;2021-09-17;1412;2902;1004893;967290;80.8;77.8
76;2021-09-18;735;2511;1005628;969801;80.9;78.0
76;2021-09-19;197;777;1005825;970578;80.9;78.0
76;2021-09-20;843;1811;1006668;972389;80.9;78.2
76;2021-09-21;766;1597;1007434;973986;81.0;78.3
76;2021-09-22;676;2297;1008110;976283;81.1;78.5
76;2021-09-23;754;1169;1008864;977452;81.1;78.6
76;2021-09-24;1063;2043;1009927;979495;81.2;78.8
76;2021-09-25;574;2130;1010501;981625;81.2;78.9
76;2021-09-26;125;416;1010626;982041;81.3;79.0
76;2021-09-27;627;1347;1011253;983388;81.3;79.1
76;2021-09-28;504;1126;1011757;984514;81.3;79.2
76;2021-09-29;786;1589;1012543;986103;81.4;79.3
76;2021-09-30;425;884;1012968;986987;81.4;79.4
76;2021-10-01;856;1704;1013824;988691;81.5;79.5
76;2021-10-02;585;1311;1014409;990002;81.6;79.6
76;2021-10-03;129;386;1014538;990388;81.6;79.6
76;2021-10-04;599;1143;1015137;991531;81.6;79.7
76;2021-10-05;482;1020;1015619;992551;81.7;79.8
76;2021-10-06;459;898;1016078;993449;81.7;79.9
76;2021-10-07;386;842;1016464;994291;81.7;79.9
76;2021-10-08;893;1910;1017357;996201;81.8;80.1
76;2021-10-09;587;1003;1017944;997204;81.8;80.2
76;2021-10-10;71;77;1018015;997281;81.8;80.2
76;2021-10-11;486;1053;1018501;998334;81.9;80.3
77;2020-12-27;1;0;1;0;0.0;0.0
77;2020-12-28;2;0;3;0;0.0;0.0
77;2020-12-29;0;0;3;0;0.0;0.0
77;2020-12-30;0;0;3;0;0.0;0.0
77;2020-12-31;0;0;3;0;0.0;0.0
77;2021-01-01;4;0;7;0;0.0;0.0
77;2021-01-02;2;2;9;2;0.0;0.0
77;2021-01-03;0;0;9;2;0.0;0.0
77;2021-01-04;7;0;16;2;0.0;0.0
77;2021-01-05;200;0;216;2;0.0;0.0
77;2021-01-06;237;2;453;4;0.0;0.0
77;2021-01-07;521;4;974;8;0.1;0.0
77;2021-01-08;621;1;1595;9;0.1;0.0
77;2021-01-09;273;1;1868;10;0.1;0.0
77;2021-01-10;235;2;2103;12;0.1;0.0
77;2021-01-11;782;4;2885;16;0.2;0.0
77;2021-01-12;884;1;3769;17;0.3;0.0
77;2021-01-13;941;3;4710;20;0.3;0.0
77;2021-01-14;849;7;5559;27;0.4;0.0
77;2021-01-15;859;11;6418;38;0.5;0.0
77;2021-01-16;168;1;6586;39;0.5;0.0
77;2021-01-17;132;2;6718;41;0.5;0.0
77;2021-01-18;1196;5;7914;46;0.6;0.0
77;2021-01-19;1722;24;9636;70;0.7;0.0
77;2021-01-20;2541;13;12177;83;0.9;0.0
77;2021-01-21;2062;30;14239;113;1.0;0.0
77;2021-01-22;1148;8;15387;121;1.1;0.0
77;2021-01-23;348;0;15735;121;1.1;0.0
77;2021-01-24;45;0;15780;121;1.1;0.0
77;2021-01-25;940;25;16720;146;1.2;0.0
77;2021-01-26;1715;27;18435;173;1.3;0.0
77;2021-01-27;1364;29;19799;202;1.4;0.0
77;2021-01-28;1699;94;21498;296;1.5;0.0
77;2021-01-29;1289;148;22787;444;1.6;0.0
77;2021-01-30;211;2;22998;446;1.6;0.0
77;2021-01-31;1;0;22999;446;1.6;0.0
77;2021-02-01;570;211;23569;657;1.7;0.0
77;2021-02-02;872;266;24441;923;1.7;0.1
77;2021-02-03;794;524;25235;1447;1.8;0.1
77;2021-02-04;789;808;26024;2255;1.8;0.2
77;2021-02-05;858;850;26882;3105;1.9;0.2
77;2021-02-06;165;101;27047;3206;1.9;0.2
77;2021-02-07;17;93;27064;3299;1.9;0.2
77;2021-02-08;498;938;27562;4237;1.9;0.3
77;2021-02-09;590;1465;28152;5702;2.0;0.4
77;2021-02-10;1030;1838;29182;7540;2.0;0.5
77;2021-02-11;1060;1655;30242;9195;2.1;0.6
77;2021-02-12;1098;1173;31340;10368;2.2;0.7
77;2021-02-13;189;177;31529;10545;2.2;0.7
77;2021-02-14;12;56;31541;10601;2.2;0.7
77;2021-02-15;555;1023;32096;11624;2.3;0.8
77;2021-02-16;598;1532;32694;13156;2.3;0.9
77;2021-02-17;515;1186;33209;14342;2.3;1.0
77;2021-02-18;839;1617;34048;15959;2.4;1.1
77;2021-02-19;778;1102;34826;17061;2.4;1.2
77;2021-02-20;55;176;34881;17237;2.5;1.2
77;2021-02-21;7;31;34888;17268;2.5;1.2
77;2021-02-22;303;770;35191;18038;2.5;1.3
77;2021-02-23;360;1127;35551;19165;2.5;1.3
77;2021-02-24;513;896;36064;20061;2.5;1.4
77;2021-02-25;793;964;36857;21025;2.6;1.5
77;2021-02-26;840;838;37697;21863;2.6;1.5
77;2021-02-27;459;170;38156;22033;2.7;1.5
77;2021-02-28;33;5;38189;22038;2.7;1.5
77;2021-03-01;680;715;38869;22753;2.7;1.6
77;2021-03-02;1091;1025;39960;23778;2.8;1.7
77;2021-03-03;1958;1193;41918;24971;2.9;1.8
77;2021-03-04;2794;1146;44712;26117;3.1;1.8
77;2021-03-05;3374;1058;48086;27175;3.4;1.9
77;2021-03-06;4827;276;52913;27451;3.7;1.9
77;2021-03-07;3195;118;56108;27569;3.9;1.9
77;2021-03-08;1230;507;57338;28076;4.0;2.0
77;2021-03-09;2508;642;59846;28718;4.2;2.0
77;2021-03-10;2397;584;62243;29302;4.4;2.1
77;2021-03-11;3503;795;65746;30097;4.6;2.1
77;2021-03-12;3890;697;69636;30794;4.9;2.2
77;2021-03-13;4478;213;74114;31007;5.2;2.2
77;2021-03-14;2154;125;76268;31132;5.4;2.2
77;2021-03-15;2511;281;78779;31413;5.5;2.2
77;2021-03-16;2444;381;81223;31794;5.7;2.2
77;2021-03-17;2554;438;83777;32232;5.9;2.3
77;2021-03-18;3011;404;86788;32636;6.1;2.3
77;2021-03-19;3357;440;90145;33076;6.3;2.3
77;2021-03-20;1967;79;92112;33155;6.5;2.3
77;2021-03-21;243;14;92355;33169;6.5;2.3
77;2021-03-22;3019;408;95374;33577;6.7;2.4
77;2021-03-23;4520;537;99894;34114;7.0;2.4
77;2021-03-24;4156;623;104050;34737;7.3;2.4
77;2021-03-25;5907;414;109957;35151;7.7;2.5
77;2021-03-26;6267;455;116224;35606;8.2;2.5
77;2021-03-27;3323;127;119547;35733;8.4;2.5
77;2021-03-28;1730;50;121277;35783;8.5;2.5
77;2021-03-29;2654;691;123931;36474;8.7;2.6
77;2021-03-30;3995;1195;127926;37669;9.0;2.6
77;2021-03-31;3758;1231;131684;38900;9.3;2.7
77;2021-04-01;4141;1842;135825;40742;9.5;2.9
77;2021-04-02;3992;2022;139817;42764;9.8;3.0
77;2021-04-03;1743;2282;141560;45046;9.9;3.2
77;2021-04-04;420;1427;141980;46473;10.0;3.3
77;2021-04-05;161;163;142141;46636;10.0;3.3
77;2021-04-06;2723;1930;144864;48566;10.2;3.4
77;2021-04-07;3320;2091;148184;50657;10.4;3.6
77;2021-04-08;4532;2373;152716;53030;10.7;3.7
77;2021-04-09;4854;2097;157570;55127;11.1;3.9
77;2021-04-10;3074;2757;160644;57884;11.3;4.1
77;2021-04-11;586;721;161230;58605;11.3;4.1
77;2021-04-12;2230;1828;163460;60433;11.5;4.2
77;2021-04-13;3359;2645;166819;63078;11.7;4.4
77;2021-04-14;2519;2656;169338;65734;11.9;4.6
77;2021-04-15;3319;3123;172657;68857;12.1;4.8
77;2021-04-16;3575;2725;176232;71582;12.4;5.0
77;2021-04-17;1386;479;177618;72061;12.5;5.1
77;2021-04-18;150;11;177768;72072;12.5;5.1
77;2021-04-19;2083;2514;179851;74586;12.6;5.2
77;2021-04-20;2572;3384;182423;77970;12.8;5.5
77;2021-04-21;2195;3480;184618;81450;13.0;5.7
77;2021-04-22;3002;3865;187620;85315;13.2;6.0
77;2021-04-23;3531;3640;191151;88955;13.4;6.2
77;2021-04-24;4899;2519;196050;91474;13.8;6.4
77;2021-04-25;4078;1248;200128;92722;14.1;6.5
77;2021-04-26;3224;2045;203352;94767;14.3;6.7
77;2021-04-27;3996;2520;207348;97287;14.6;6.8
77;2021-04-28;4067;2621;211415;99908;14.9;7.0
77;2021-04-29;4480;3085;215895;102993;15.2;7.2
77;2021-04-30;4911;3346;220806;106339;15.5;7.5
77;2021-05-01;2466;600;223272;106939;15.7;7.5
77;2021-05-02;3141;278;226413;107217;15.9;7.5
77;2021-05-03;5991;2082;232404;109299;16.3;7.7
77;2021-05-04;6437;2995;238841;112294;16.8;7.9
77;2021-05-05;6018;3028;244859;115322;17.2;8.1
77;2021-05-06;6886;3599;251745;118921;17.7;8.4
77;2021-05-07;8204;3273;259949;122194;18.3;8.6
77;2021-05-08;5718;816;265667;123010;18.7;8.6
77;2021-05-09;4904;484;270571;123494;19.0;8.7
77;2021-05-10;8087;2330;278658;125824;19.6;8.8
77;2021-05-11;9576;2921;288234;128745;20.2;9.0
77;2021-05-12;8977;2284;297211;131029;20.9;9.2
77;2021-05-13;9302;884;306513;131913;21.5;9.3
77;2021-05-14;10437;1673;316950;133586;22.3;9.4
77;2021-05-15;8991;1248;325941;134834;22.9;9.5
77;2021-05-16;5152;470;331093;135304;23.3;9.5
77;2021-05-17;10371;1482;341464;136786;24.0;9.6
77;2021-05-18;11786;1805;353250;138591;24.8;9.7
77;2021-05-19;10918;1606;364168;140197;25.6;9.8
77;2021-05-20;12215;2157;376383;142354;26.4;10.0
77;2021-05-21;11652;2696;388035;145050;27.3;10.2
77;2021-05-22;9817;1741;397852;146791;27.9;10.3
77;2021-05-23;6978;818;404830;147609;28.4;10.4
77;2021-05-24;6762;779;411592;148388;28.9;10.4
77;2021-05-25;8315;2817;419907;151205;29.5;10.6
77;2021-05-26;7561;2980;427468;154185;30.0;10.8
77;2021-05-27;7551;3968;435019;158153;30.6;11.1
77;2021-05-28;7634;4010;442653;162163;31.1;11.4
77;2021-05-29;7353;2332;450006;164495;31.6;11.6
77;2021-05-30;4355;891;454361;165386;31.9;11.6
77;2021-05-31;8382;3836;462743;169222;32.5;11.9
77;2021-06-01;9645;4383;472388;173605;33.2;12.2
77;2021-06-02;9005;3931;481393;177536;33.8;12.5
77;2021-06-03;9001;5281;490394;182817;34.4;12.8
77;2021-06-04;9114;5495;499508;188312;35.1;13.2
77;2021-06-05;6660;4992;506168;193304;35.6;13.6
77;2021-06-06;4909;3210;511077;196514;35.9;13.8
77;2021-06-07;6421;4540;517498;201054;36.4;14.1
77;2021-06-08;5726;5228;523224;206282;36.8;14.5
77;2021-06-09;5059;4964;528283;211246;37.1;14.8
77;2021-06-10;5014;5459;533297;216705;37.5;15.2
77;2021-06-11;5752;6028;539049;222733;37.9;15.6
77;2021-06-12;6544;4752;545593;227485;38.3;16.0
77;2021-06-13;3507;3053;549100;230538;38.6;16.2
77;2021-06-14;3220;7933;552320;238471;38.8;16.8
77;2021-06-15;4127;8484;556447;246955;39.1;17.3
77;2021-06-16;4803;8378;561250;255333;39.4;17.9
77;2021-06-17;4467;9029;565717;264362;39.7;18.6
77;2021-06-18;4364;9790;570081;274152;40.0;19.3
77;2021-06-19;5306;6931;575387;281083;40.4;19.7
77;2021-06-20;2096;3801;577483;284884;40.6;20.0
77;2021-06-21;3228;9579;580711;294463;40.8;20.7
77;2021-06-22;3665;11377;584376;305840;41.0;21.5
77;2021-06-23;3443;10052;587819;315892;41.3;22.2
77;2021-06-24;3359;10923;591178;326815;41.5;23.0
77;2021-06-25;3623;10800;594801;337615;41.8;23.7
77;2021-06-26;4085;10070;598886;347685;42.1;24.4
77;2021-06-27;2124;6430;601010;354115;42.2;24.9
77;2021-06-28;2797;10831;603807;364946;42.4;25.6
77;2021-06-29;3415;12532;607222;377478;42.7;26.5
77;2021-06-30;3291;11452;610513;388930;42.9;27.3
77;2021-07-01;3296;11657;613809;400587;43.1;28.1
77;2021-07-02;3464;12256;617273;412843;43.4;29.0
77;2021-07-03;3182;10803;620455;423646;43.6;29.8
77;2021-07-04;1996;6491;622451;430137;43.7;30.2
77;2021-07-05;3584;9541;626035;439678;44.0;30.9
77;2021-07-06;3736;9530;629771;449208;44.2;31.6
77;2021-07-07;4051;8952;633822;458160;44.5;32.2
77;2021-07-08;3934;8760;637756;466920;44.8;32.8
77;2021-07-09;4712;10343;642468;477263;45.1;33.5
77;2021-07-10;4043;9842;646511;487105;45.4;34.2
77;2021-07-11;3090;5093;649601;492198;45.6;34.6
77;2021-07-12;3285;10870;652886;503068;45.9;35.3
77;2021-07-13;6162;12041;659048;515109;46.3;36.2
77;2021-07-14;3602;6448;662650;521557;46.5;36.6
77;2021-07-15;7189;11980;669839;533537;47.1;37.5
77;2021-07-16;7824;9893;677663;543430;47.6;38.2
77;2021-07-17;5792;9466;683455;552896;48.0;38.8
77;2021-07-18;4138;5330;687593;558226;48.3;39.2
77;2021-07-19;7516;8955;695109;567181;48.8;39.8
77;2021-07-20;9671;8047;704780;575228;49.5;40.4
77;2021-07-21;9524;7483;714304;582711;50.2;40.9
77;2021-07-22;10561;7559;724865;590270;50.9;41.5
77;2021-07-23;9877;8207;734742;598477;51.6;42.0
77;2021-07-24;7215;7879;741957;606356;52.1;42.6
77;2021-07-25;5897;4036;747854;610392;52.5;42.9
77;2021-07-26;9209;5971;757063;616363;53.2;43.3
77;2021-07-27;10953;6048;768016;622411;53.9;43.7
77;2021-07-28;9491;6429;777507;628840;54.6;44.2
77;2021-07-29;9538;5519;787045;634359;55.3;44.6
77;2021-07-30;9745;6370;796790;640729;56.0;45.0
77;2021-07-31;7264;6633;804054;647362;56.5;45.5
77;2021-08-01;2953;1216;807007;648578;56.7;45.6
77;2021-08-02;7134;5733;814141;654311;57.2;46.0
77;2021-08-03;5855;4527;819996;658838;57.6;46.3
77;2021-08-04;4740;4389;824736;663227;57.9;46.6
77;2021-08-05;3259;2973;827995;666200;58.2;46.8
77;2021-08-06;5981;5264;833976;671464;58.6;47.2
77;2021-08-07;5296;6795;839272;678259;59.0;47.6
77;2021-08-08;1977;1863;841249;680122;59.1;47.8
77;2021-08-09;5091;6584;846340;686706;59.5;48.2
77;2021-08-10;2713;3581;849053;690287;59.6;48.5
77;2021-08-11;3144;6241;852197;696528;59.9;48.9
77;2021-08-12;2281;3577;854478;700105;60.0;49.2
77;2021-08-13;2736;4896;857214;705001;60.2;49.5
77;2021-08-14;2959;7332;860173;712333;60.4;50.0
77;2021-08-15;789;773;860962;713106;60.5;50.1
77;2021-08-16;2478;6985;863440;720091;60.7;50.6
77;2021-08-17;2896;7215;866336;727306;60.9;51.1
77;2021-08-18;2685;6563;869021;733869;61.0;51.5
77;2021-08-19;2653;5105;871674;738974;61.2;51.9
77;2021-08-20;2711;5687;874385;744661;61.4;52.3
77;2021-08-21;2717;7339;877102;752000;61.6;52.8
77;2021-08-22;1735;5344;878837;757344;61.7;53.2
77;2021-08-23;2513;9619;881350;766963;61.9;53.9
77;2021-08-24;3068;9244;884418;776207;62.1;54.5
77;2021-08-25;2565;6541;886983;782748;62.3;55.0
77;2021-08-26;2559;6255;889542;789003;62.5;55.4
77;2021-08-27;2780;6995;892322;795998;62.7;55.9
77;2021-08-28;1973;7253;894295;803251;62.8;56.4
77;2021-08-29;1484;5151;895779;808402;62.9;56.8
77;2021-08-30;2526;8049;898305;816451;63.1;57.4
77;2021-08-31;2851;5600;901156;822051;63.3;57.7
77;2021-09-01;2282;3519;903438;825570;63.5;58.0
77;2021-09-02;1612;2812;905050;828382;63.6;58.2
77;2021-09-03;2136;4138;907186;832520;63.7;58.5
77;2021-09-04;2420;5583;909606;838103;63.9;58.9
77;2021-09-05;902;1371;910508;839474;64.0;59.0
77;2021-09-06;1067;1890;911575;841364;64.0;59.1
77;2021-09-07;844;2020;912419;843384;64.1;59.2
77;2021-09-08;1715;3072;914134;846456;64.2;59.5
77;2021-09-09;976;1842;915110;848298;64.3;59.6
77;2021-09-10;1194;2203;916304;850501;64.4;59.7
77;2021-09-11;2049;5403;918353;855904;64.5;60.1
77;2021-09-12;522;1353;918875;857257;64.5;60.2
77;2021-09-13;882;1723;919757;858980;64.6;60.3
77;2021-09-14;1025;1629;920782;860609;64.7;60.5
77;2021-09-15;1182;2528;921964;863137;64.8;60.6
77;2021-09-16;960;1497;922924;864634;64.8;60.7
77;2021-09-17;1157;2022;924081;866656;64.9;60.9
77;2021-09-18;1305;3581;925386;870237;65.0;61.1
77;2021-09-19;232;1182;925618;871419;65.0;61.2
77;2021-09-20;825;1625;926443;873044;65.1;61.3
77;2021-09-21;794;1502;927237;874546;65.1;61.4
77;2021-09-22;751;2486;927988;877032;65.2;61.6
77;2021-09-23;568;1509;928556;878541;65.2;61.7
77;2021-09-24;827;1950;929383;880491;65.3;61.8
77;2021-09-25;1002;3956;930385;884447;65.4;62.1
77;2021-09-26;205;758;930590;885205;65.4;62.2
77;2021-09-27;648;1312;931238;886517;65.4;62.3
77;2021-09-28;773;845;932011;887362;65.5;62.3
77;2021-09-29;936;1974;932947;889336;65.5;62.5
77;2021-09-30;587;937;933534;890273;65.6;62.5
77;2021-10-01;625;1025;934159;891298;65.6;62.6
77;2021-10-02;948;2104;935107;893402;65.7;62.8
77;2021-10-03;129;470;935236;893872;65.7;62.8
77;2021-10-04;412;720;935648;894592;65.7;62.8
77;2021-10-05;332;730;935980;895322;65.7;62.9
77;2021-10-06;536;1283;936516;896605;65.8;63.0
77;2021-10-07;385;723;936901;897328;65.8;63.0
77;2021-10-08;634;1219;937535;898547;65.9;63.1
77;2021-10-09;842;1985;938377;900532;65.9;63.3
77;2021-10-10;33;54;938410;900586;65.9;63.3
77;2021-10-11;559;851;938969;901437;66.0;63.3
78;2020-12-27;2;0;2;0;0.0;0.0
78;2020-12-28;1;1;3;1;0.0;0.0
78;2020-12-29;0;0;3;1;0.0;0.0
78;2020-12-30;1;0;4;1;0.0;0.0
78;2020-12-31;15;0;19;1;0.0;0.0
78;2021-01-01;1;0;20;1;0.0;0.0
78;2021-01-02;1;0;21;1;0.0;0.0
78;2021-01-03;3;1;24;2;0.0;0.0
78;2021-01-04;145;3;169;5;0.0;0.0
78;2021-01-05;175;1;344;6;0.0;0.0
78;2021-01-06;208;4;552;10;0.0;0.0
78;2021-01-07;469;2;1021;12;0.1;0.0
78;2021-01-08;651;5;1672;17;0.1;0.0
78;2021-01-09;22;0;1694;17;0.1;0.0
78;2021-01-10;2;0;1696;17;0.1;0.0
78;2021-01-11;791;4;2487;21;0.2;0.0
78;2021-01-12;945;5;3432;26;0.2;0.0
78;2021-01-13;741;10;4173;36;0.3;0.0
78;2021-01-14;812;10;4985;46;0.3;0.0
78;2021-01-15;848;11;5833;57;0.4;0.0
78;2021-01-16;32;1;5865;58;0.4;0.0
78;2021-01-17;0;0;5865;58;0.4;0.0
78;2021-01-18;1384;21;7249;79;0.5;0.0
78;2021-01-19;1841;28;9090;107;0.6;0.0
78;2021-01-20;1651;19;10741;126;0.7;0.0
78;2021-01-21;3258;18;13999;144;1.0;0.0
78;2021-01-22;2216;20;16215;164;1.1;0.0
78;2021-01-23;280;0;16495;164;1.1;0.0
78;2021-01-24;5;0;16500;164;1.1;0.0
78;2021-01-25;957;31;17457;195;1.2;0.0
78;2021-01-26;1560;22;19017;217;1.3;0.0
78;2021-01-27;2063;52;21080;269;1.5;0.0
78;2021-01-28;2439;112;23519;381;1.6;0.0
78;2021-01-29;1492;64;25011;445;1.7;0.0
78;2021-01-30;210;2;25221;447;1.7;0.0
78;2021-01-31;3;0;25224;447;1.7;0.0
78;2021-02-01;788;224;26012;671;1.8;0.0
78;2021-02-02;967;346;26979;1017;1.9;0.1
78;2021-02-03;976;240;27955;1257;1.9;0.1
78;2021-02-04;1117;446;29072;1703;2.0;0.1
78;2021-02-05;1191;504;30263;2207;2.1;0.2
78;2021-02-06;200;46;30463;2253;2.1;0.2
78;2021-02-07;139;14;30602;2267;2.1;0.2
78;2021-02-08;762;605;31364;2872;2.2;0.2
78;2021-02-09;1121;945;32485;3817;2.2;0.3
78;2021-02-10;1245;1179;33730;4996;2.3;0.3
78;2021-02-11;1820;1894;35550;6890;2.5;0.5
78;2021-02-12;1820;1388;37370;8278;2.6;0.6
78;2021-02-13;173;76;37543;8354;2.6;0.6
78;2021-02-14;27;26;37570;8380;2.6;0.6
78;2021-02-15;448;1432;38018;9812;2.6;0.7
78;2021-02-16;628;1562;38646;11374;2.7;0.8
78;2021-02-17;588;2221;39234;13595;2.7;0.9
78;2021-02-18;998;2278;40232;15873;2.8;1.1
78;2021-02-19;821;1722;41053;17595;2.8;1.2
78;2021-02-20;148;125;41201;17720;2.8;1.2
78;2021-02-21;0;12;41201;17732;2.8;1.2
78;2021-02-22;502;1060;41703;18792;2.9;1.3
78;2021-02-23;540;1126;42243;19918;2.9;1.4
78;2021-02-24;620;1245;42863;21163;3.0;1.5
78;2021-02-25;867;1154;43730;22317;3.0;1.5
78;2021-02-26;1131;1241;44861;23558;3.1;1.6
78;2021-02-27;740;151;45601;23709;3.1;1.6
78;2021-02-28;68;18;45669;23727;3.2;1.6
78;2021-03-01;966;908;46635;24635;3.2;1.7
78;2021-03-02;1727;1059;48362;25694;3.3;1.8
78;2021-03-03;1967;1243;50329;26937;3.5;1.9
78;2021-03-04;2952;1604;53281;28541;3.7;2.0
78;2021-03-05;3258;1674;56539;30215;3.9;2.1
78;2021-03-06;6243;325;62782;30540;4.3;2.1
78;2021-03-07;3444;108;66226;30648;4.6;2.1
78;2021-03-08;1462;764;67688;31412;4.7;2.2
78;2021-03-09;2944;917;70632;32329;4.9;2.2
78;2021-03-10;3079;1128;73711;33457;5.1;2.3
78;2021-03-11;4179;1321;77890;34778;5.4;2.4
78;2021-03-12;5371;1368;83261;36146;5.7;2.5
78;2021-03-13;4657;210;87918;36356;6.1;2.5
78;2021-03-14;1037;42;88955;36398;6.1;2.5
78;2021-03-15;3620;272;92575;36670;6.4;2.5
78;2021-03-16;2567;579;95142;37249;6.6;2.6
78;2021-03-17;2970;449;98112;37698;6.8;2.6
78;2021-03-18;3780;462;101892;38160;7.0;2.6
78;2021-03-19;5317;501;107209;38661;7.4;2.7
78;2021-03-20;2260;133;109469;38794;7.6;2.7
78;2021-03-21;167;7;109636;38801;7.6;2.7
78;2021-03-22;3530;384;113166;39185;7.8;2.7
78;2021-03-23;5231;554;118397;39739;8.2;2.7
78;2021-03-24;4892;562;123289;40301;8.5;2.8
78;2021-03-25;6940;581;130229;40882;9.0;2.8
78;2021-03-26;6944;730;137173;41612;9.5;2.9
78;2021-03-27;3746;202;140919;41814;9.7;2.9
78;2021-03-28;1918;56;142837;41870;9.9;2.9
78;2021-03-29;3863;769;146700;42639;10.1;2.9
78;2021-03-30;5526;1064;152226;43703;10.5;3.0
78;2021-03-31;5334;1307;157560;45010;10.9;3.1
78;2021-04-01;5590;2372;163150;47382;11.3;3.3
78;2021-04-02;5194;2637;168344;50019;11.6;3.5
78;2021-04-03;2197;2568;170541;52587;11.8;3.6
78;2021-04-04;174;14;170715;52601;11.8;3.6
78;2021-04-05;199;20;170914;52621;11.8;3.6
78;2021-04-06;3617;2311;174531;54932;12.0;3.8
78;2021-04-07;4357;2595;178888;57527;12.3;4.0
78;2021-04-08;5523;2679;184411;60206;12.7;4.2
78;2021-04-09;6907;2462;191318;62668;13.2;4.3
78;2021-04-10;3995;1912;195313;64580;13.5;4.5
78;2021-04-11;374;607;195687;65187;13.5;4.5
78;2021-04-12;3531;2370;199218;67557;13.8;4.7
78;2021-04-13;5461;2515;204679;70072;14.1;4.8
78;2021-04-14;4957;3404;209636;73476;14.5;5.1
78;2021-04-15;4616;3859;214252;77335;14.8;5.3
78;2021-04-16;5625;4036;219877;81371;15.2;5.6
78;2021-04-17;3610;720;223487;82091;15.4;5.7
78;2021-04-18;272;42;223759;82133;15.4;5.7
78;2021-04-19;3246;2817;227005;84950;15.7;5.9
78;2021-04-20;4709;3691;231714;88641;16.0;6.1
78;2021-04-21;4533;3511;236247;92152;16.3;6.4
78;2021-04-22;4567;4700;240814;96852;16.6;6.7
78;2021-04-23;5059;4435;245873;101287;17.0;7.0
78;2021-04-24;4865;2631;250738;103918;17.3;7.2
78;2021-04-25;3049;1732;253787;105650;17.5;7.3
78;2021-04-26;4768;3326;258555;108976;17.8;7.5
78;2021-04-27;5474;4320;264029;113296;18.2;7.8
78;2021-04-28;5649;4796;269678;118092;18.6;8.2
78;2021-04-29;6263;4086;275941;122178;19.0;8.4
78;2021-04-30;7207;4466;283148;126644;19.5;8.7
78;2021-05-01;612;255;283760;126899;19.6;8.8
78;2021-05-02;2009;166;285769;127065;19.7;8.8
78;2021-05-03;7465;1289;293234;128354;20.2;8.9
78;2021-05-04;6077;3984;299311;132338;20.7;9.1
78;2021-05-05;7296;4565;306607;136903;21.2;9.5
78;2021-05-06;6480;5179;313087;142082;21.6;9.8
78;2021-05-07;8309;5144;321396;147226;22.2;10.2
78;2021-05-08;2916;1454;324312;148680;22.4;10.3
78;2021-05-09;2820;356;327132;149036;22.6;10.3
78;2021-05-10;7344;4457;334476;153493;23.1;10.6
78;2021-05-11;8143;5422;342619;158915;23.7;11.0
78;2021-05-12;8729;3918;351348;162833;24.3;11.2
78;2021-05-13;6628;603;357976;163436;24.7;11.3
78;2021-05-14;10216;2217;368192;165653;25.4;11.4
78;2021-05-15;4934;2362;373126;168015;25.8;11.6
78;2021-05-16;3697;792;376823;168807;26.0;11.7
78;2021-05-17;8741;1348;385564;170155;26.6;11.7
78;2021-05-18;9886;1894;395450;172049;27.3;11.9
78;2021-05-19;11651;1711;407101;173760;28.1;12.0
78;2021-05-20;11596;2265;418697;176025;28.9;12.2
78;2021-05-21;12121;2629;430818;178654;29.7;12.3
78;2021-05-22;6537;1364;437355;180018;30.2;12.4
78;2021-05-23;3125;390;440480;180408;30.4;12.5
78;2021-05-24;3521;417;444001;180825;30.6;12.5
78;2021-05-25;9983;2508;453984;183333;31.3;12.7
78;2021-05-26;10159;3781;464143;187114;32.0;12.9
78;2021-05-27;10947;4645;475090;191759;32.8;13.2
78;2021-05-28;11405;6030;486495;197789;33.6;13.7
78;2021-05-29;4228;3385;490723;201174;33.9;13.9
78;2021-05-30;135;348;490858;201522;33.9;13.9
78;2021-05-31;7967;5360;498825;206882;34.4;14.3
78;2021-06-01;10023;6525;508848;213407;35.1;14.7
78;2021-06-02;8582;6204;517430;219611;35.7;15.2
78;2021-06-03;9892;6477;527322;226088;36.4;15.6
78;2021-06-04;9794;8144;537116;234232;37.1;16.2
78;2021-06-05;5519;6133;542635;240365;37.5;16.6
78;2021-06-06;2150;2010;544785;242375;37.6;16.7
78;2021-06-07;8113;6519;552898;248894;38.2;17.2
78;2021-06-08;8064;7322;560962;256216;38.7;17.7
78;2021-06-09;7325;6733;568287;262949;39.2;18.2
78;2021-06-10;7105;7106;575392;270055;39.7;18.6
78;2021-06-11;7584;8186;582976;278241;40.2;19.2
78;2021-06-12;6373;2921;589349;281162;40.7;19.4
78;2021-06-13;946;2458;590295;283620;40.7;19.6
78;2021-06-14;3415;9808;593710;293428;41.0;20.3
78;2021-06-15;5794;8287;599504;301715;41.4;20.8
78;2021-06-16;5430;8626;604934;310341;41.8;21.4
78;2021-06-17;5482;8537;610416;318878;42.1;22.0
78;2021-06-18;6103;9801;616519;328679;42.6;22.7
78;2021-06-19;5219;4820;621738;333499;42.9;23.0
78;2021-06-20;625;2838;622363;336337;43.0;23.2
78;2021-06-21;4092;9470;626455;345807;43.2;23.9
78;2021-06-22;3349;10317;629804;356124;43.5;24.6
78;2021-06-23;3839;10394;633643;366518;43.7;25.3
78;2021-06-24;3794;9977;637437;376495;44.0;26.0
78;2021-06-25;3995;13148;641432;389643;44.3;26.9
78;2021-06-26;4209;7951;645641;397594;44.6;27.4
78;2021-06-27;1041;2540;646682;400134;44.6;27.6
78;2021-06-28;3288;10900;649970;411034;44.9;28.4
78;2021-06-29;3535;11248;653505;422282;45.1;29.2
78;2021-06-30;4110;13225;657615;435507;45.4;30.1
78;2021-07-01;4106;12701;661721;448208;45.7;30.9
78;2021-07-02;4260;13938;665981;462146;46.0;31.9
78;2021-07-03;3159;8621;669140;470767;46.2;32.5
78;2021-07-04;778;1742;669918;472509;46.2;32.6
78;2021-07-05;3384;9693;673302;482202;46.5;33.3
78;2021-07-06;3525;12044;676827;494246;46.7;34.1
78;2021-07-07;3824;11606;680651;505852;47.0;34.9
78;2021-07-08;3927;11678;684578;517530;47.3;35.7
78;2021-07-09;4759;12743;689337;530273;47.6;36.6
78;2021-07-10;2626;6613;691963;536886;47.8;37.1
78;2021-07-11;748;2047;692711;538933;47.8;37.2
78;2021-07-12;3038;11745;695749;550678;48.0;38.0
78;2021-07-13;5351;11974;701100;562652;48.4;38.8
78;2021-07-14;2533;4989;703633;567641;48.6;39.2
78;2021-07-15;5662;11954;709295;579595;49.0;40.0
78;2021-07-16;7320;10787;716615;590382;49.5;40.8
78;2021-07-17;4725;4898;721340;595280;49.8;41.1
78;2021-07-18;1158;471;722498;595751;49.9;41.1
78;2021-07-19;3879;10350;726377;606101;50.1;41.8
78;2021-07-20;5616;9926;731993;616027;50.5;42.5
78;2021-07-21;5905;9859;737898;625886;50.9;43.2
78;2021-07-22;5972;9296;743870;635182;51.4;43.8
78;2021-07-23;6258;9230;750128;644412;51.8;44.5
78;2021-07-24;2937;4973;753065;649385;52.0;44.8
78;2021-07-25;987;376;754052;649761;52.1;44.9
78;2021-07-26;4868;6986;758920;656747;52.4;45.3
78;2021-07-27;7600;6915;766520;663662;52.9;45.8
78;2021-07-28;6976;5933;773496;669595;53.4;46.2
78;2021-07-29;7902;6008;781398;675603;53.9;46.6
78;2021-07-30;7740;7052;789138;682655;54.5;47.1
78;2021-07-31;2653;2734;791791;685389;54.7;47.3
78;2021-08-01;109;72;791900;685461;54.7;47.3
78;2021-08-02;2446;2131;794346;687592;54.8;47.5
78;2021-08-03;4270;4255;798616;691847;55.1;47.8
78;2021-08-04;4467;2809;803083;694656;55.4;48.0
78;2021-08-05;3887;3172;806970;697828;55.7;48.2
78;2021-08-06;3979;3719;810949;701547;56.0;48.4
78;2021-08-07;2819;3442;813768;704989;56.2;48.7
78;2021-08-08;483;343;814251;705332;56.2;48.7
78;2021-08-09;1880;1662;816131;706994;56.3;48.8
78;2021-08-10;3420;3983;819551;710977;56.6;49.1
78;2021-08-11;3053;3383;822604;714360;56.8;49.3
78;2021-08-12;2793;3535;825397;717895;57.0;49.6
78;2021-08-13;2866;3186;828263;721081;57.2;49.8
78;2021-08-14;2301;2978;830564;724059;57.3;50.0
78;2021-08-15;315;373;830879;724432;57.4;50.0
78;2021-08-16;942;2341;831821;726773;57.4;50.2
78;2021-08-17;2795;4422;834616;731195;57.6;50.5
78;2021-08-18;2476;3820;837092;735015;57.8;50.7
78;2021-08-19;2240;3583;839332;738598;57.9;51.0
78;2021-08-20;2101;4000;841433;742598;58.1;51.3
78;2021-08-21;1884;3587;843317;746185;58.2;51.5
78;2021-08-22;87;147;843404;746332;58.2;51.5
78;2021-08-23;2162;4248;845566;750580;58.4;51.8
78;2021-08-24;3630;6973;849196;757553;58.6;52.3
78;2021-08-25;3296;6593;852492;764146;58.8;52.7
78;2021-08-26;2980;7237;855472;771383;59.1;53.2
78;2021-08-27;2865;7370;858337;778753;59.3;53.8
78;2021-08-28;2443;5278;860780;784031;59.4;54.1
78;2021-08-29;369;351;861149;784382;59.4;54.1
78;2021-08-30;2859;4976;864008;789358;59.6;54.5
78;2021-08-31;3451;5676;867459;795034;59.9;54.9
78;2021-09-01;2829;4931;870288;799965;60.1;55.2
78;2021-09-02;2102;4008;872390;803973;60.2;55.5
78;2021-09-03;2261;4279;874651;808252;60.4;55.8
78;2021-09-04;2487;3951;877138;812203;60.5;56.1
78;2021-09-05;292;375;877430;812578;60.6;56.1
78;2021-09-06;1318;2497;878748;815075;60.7;56.3
78;2021-09-07;1363;2942;880111;818017;60.8;56.5
78;2021-09-08;1686;3308;881797;821325;60.9;56.7
78;2021-09-09;1095;2750;882892;824075;60.9;56.9
78;2021-09-10;1386;3012;884278;827087;61.0;57.1
78;2021-09-11;2054;3746;886332;830833;61.2;57.4
78;2021-09-12;73;139;886405;830972;61.2;57.4
78;2021-09-13;788;2020;887193;832992;61.2;57.5
78;2021-09-14;1072;2819;888265;835811;61.3;57.7
78;2021-09-15;1225;3532;889490;839343;61.4;57.9
78;2021-09-16;852;2090;890342;841433;61.5;58.1
78;2021-09-17;1186;2839;891528;844272;61.5;58.3
78;2021-09-18;1393;4071;892921;848343;61.6;58.6
78;2021-09-19;145;409;893066;848752;61.6;58.6
78;2021-09-20;671;1711;893737;850463;61.7;58.7
78;2021-09-21;820;1978;894557;852441;61.8;58.8
78;2021-09-22;957;3515;895514;855956;61.8;59.1
78;2021-09-23;885;1640;896399;857596;61.9;59.2
78;2021-09-24;1010;2386;897409;859982;61.9;59.4
78;2021-09-25;1056;3919;898465;863901;62.0;59.6
78;2021-09-26;59;155;898524;864056;62.0;59.6
78;2021-09-27;684;1508;899208;865564;62.1;59.8
78;2021-09-28;830;1498;900038;867062;62.1;59.9
78;2021-09-29;1009;2163;901047;869225;62.2;60.0
78;2021-09-30;560;928;901607;870153;62.2;60.1
78;2021-10-01;931;1822;902538;871975;62.3;60.2
78;2021-10-02;1246;2467;903784;874442;62.4;60.4
78;2021-10-03;54;70;903838;874512;62.4;60.4
78;2021-10-04;487;938;904325;875450;62.4;60.4
78;2021-10-05;436;731;904761;876181;62.5;60.5
78;2021-10-06;803;1564;905564;877745;62.5;60.6
78;2021-10-07;393;784;905957;878529;62.5;60.6
78;2021-10-08;894;1737;906851;880266;62.6;60.8
78;2021-10-09;974;1841;907825;882107;62.7;60.9
78;2021-10-10;100;114;907925;882221;62.7;60.9
78;2021-10-11;452;1004;908377;883225;62.7;61.0
79;2020-12-27;0;0;0;0;0.0;0.0
79;2020-12-28;4;0;4;0;0.0;0.0
79;2020-12-29;0;0;4;0;0.0;0.0
79;2020-12-30;0;0;4;0;0.0;0.0
79;2020-12-31;0;0;4;0;0.0;0.0
79;2021-01-01;0;0;4;0;0.0;0.0
79;2021-01-02;0;0;4;0;0.0;0.0
79;2021-01-03;0;0;4;0;0.0;0.0
79;2021-01-04;1;0;5;0;0.0;0.0
79;2021-01-05;0;0;5;0;0.0;0.0
79;2021-01-06;0;0;5;0;0.0;0.0
79;2021-01-07;158;0;163;0;0.0;0.0
79;2021-01-08;165;0;328;0;0.1;0.0
79;2021-01-09;100;1;428;1;0.1;0.0
79;2021-01-10;3;0;431;1;0.1;0.0
79;2021-01-11;184;1;615;2;0.2;0.0
79;2021-01-12;245;1;860;3;0.2;0.0
79;2021-01-13;258;0;1118;3;0.3;0.0
79;2021-01-14;506;9;1624;12;0.4;0.0
79;2021-01-15;618;7;2242;19;0.6;0.0
79;2021-01-16;66;0;2308;19;0.6;0.0
79;2021-01-17;0;0;2308;19;0.6;0.0
79;2021-01-18;478;2;2786;21;0.7;0.0
79;2021-01-19;1361;3;4147;24;1.1;0.0
79;2021-01-20;1678;2;5825;26;1.6;0.0
79;2021-01-21;1999;8;7824;34;2.1;0.0
79;2021-01-22;875;5;8699;39;2.3;0.0
79;2021-01-23;65;0;8764;39;2.4;0.0
79;2021-01-24;0;0;8764;39;2.4;0.0
79;2021-01-25;646;7;9410;46;2.5;0.0
79;2021-01-26;593;14;10003;60;2.7;0.0
79;2021-01-27;740;84;10743;144;2.9;0.0
79;2021-01-28;733;152;11476;296;3.1;0.1
79;2021-01-29;495;88;11971;384;3.2;0.1
79;2021-01-30;0;0;11971;384;3.2;0.1
79;2021-01-31;0;0;11971;384;3.2;0.1
79;2021-02-01;207;111;12178;495;3.3;0.1
79;2021-02-02;334;74;12512;569;3.4;0.2
79;2021-02-03;391;60;12903;629;3.5;0.2
79;2021-02-04;326;109;13229;738;3.6;0.2
79;2021-02-05;360;275;13589;1013;3.6;0.3
79;2021-02-06;6;1;13595;1014;3.6;0.3
79;2021-02-07;22;0;13617;1014;3.7;0.3
79;2021-02-08;283;167;13900;1181;3.7;0.3
79;2021-02-09;457;785;14357;1966;3.9;0.5
79;2021-02-10;619;1199;14976;3165;4.0;0.8
79;2021-02-11;777;1237;15753;4402;4.2;1.2
79;2021-02-12;471;767;16224;5169;4.4;1.4
79;2021-02-13;53;74;16277;5243;4.4;1.4
79;2021-02-14;0;0;16277;5243;4.4;1.4
79;2021-02-15;186;503;16463;5746;4.4;1.5
79;2021-02-16;333;731;16796;6477;4.5;1.7
79;2021-02-17;248;876;17044;7353;4.6;2.0
79;2021-02-18;353;945;17397;8298;4.7;2.2
79;2021-02-19;268;560;17665;8858;4.7;2.4
79;2021-02-20;5;22;17670;8880;4.7;2.4
79;2021-02-21;1;0;17671;8880;4.7;2.4
79;2021-02-22;137;462;17808;9342;4.8;2.5
79;2021-02-23;247;567;18055;9909;4.8;2.7
79;2021-02-24;246;544;18301;10453;4.9;2.8
79;2021-02-25;520;470;18821;10923;5.1;2.9
79;2021-02-26;599;399;19420;11322;5.2;3.0
79;2021-02-27;408;7;19828;11329;5.3;3.0
79;2021-02-28;35;0;19863;11329;5.3;3.0
79;2021-03-01;89;362;19952;11691;5.4;3.1
79;2021-03-02;302;508;20254;12199;5.4;3.3
79;2021-03-03;662;545;20916;12744;5.6;3.4
79;2021-03-04;904;572;21820;13316;5.9;3.6
79;2021-03-05;1218;449;23038;13765;6.2;3.7
79;2021-03-06;611;8;23649;13773;6.3;3.7
79;2021-03-07;77;1;23726;13774;6.4;3.7
79;2021-03-08;345;310;24071;14084;6.5;3.8
79;2021-03-09;842;342;24913;14426;6.7;3.9
79;2021-03-10;1146;405;26059;14831;7.0;4.0
79;2021-03-11;1641;328;27700;15159;7.4;4.1
79;2021-03-12;1721;122;29421;15281;7.9;4.1
79;2021-03-13;1135;13;30556;15294;8.2;4.1
79;2021-03-14;50;0;30606;15294;8.2;4.1
79;2021-03-15;497;158;31103;15452;8.3;4.1
79;2021-03-16;735;148;31838;15600;8.5;4.2
79;2021-03-17;578;109;32416;15709;8.7;4.2
79;2021-03-18;553;203;32969;15912;8.8;4.3
79;2021-03-19;661;261;33630;16173;9.0;4.3
79;2021-03-20;1007;15;34637;16188;9.3;4.3
79;2021-03-21;3;0;34640;16188;9.3;4.3
79;2021-03-22;957;209;35597;16397;9.6;4.4
79;2021-03-23;1595;172;37192;16569;10.0;4.4
79;2021-03-24;1831;167;39023;16736;10.5;4.5
79;2021-03-25;2499;195;41522;16931;11.1;4.5
79;2021-03-26;2406;138;43928;17069;11.8;4.6
79;2021-03-27;768;18;44696;17087;12.0;4.6
79;2021-03-28;1;0;44697;17087;12.0;4.6
79;2021-03-29;2148;116;46845;17203;12.6;4.6
79;2021-03-30;2817;67;49662;17270;13.3;4.6
79;2021-03-31;2777;381;52439;17651;14.1;4.7
79;2021-04-01;2698;387;55137;18038;14.8;4.8
79;2021-04-02;2822;397;57959;18435;15.6;4.9
79;2021-04-03;634;55;58593;18490;15.7;5.0
79;2021-04-04;3;0;58596;18490;15.7;5.0
79;2021-04-05;381;5;58977;18495;15.8;5.0
79;2021-04-06;1792;587;60769;19082;16.3;5.1
79;2021-04-07;3112;738;63881;19820;17.1;5.3
79;2021-04-08;2632;704;66513;20524;17.8;5.5
79;2021-04-09;3737;549;70250;21073;18.9;5.7
79;2021-04-10;1466;388;71716;21461;19.2;5.8
79;2021-04-11;4;0;71720;21461;19.2;5.8
79;2021-04-12;1753;355;73473;21816;19.7;5.9
79;2021-04-13;2174;756;75647;22572;20.3;6.1
79;2021-04-14;2480;681;78127;23253;21.0;6.2
79;2021-04-15;2216;670;80343;23923;21.6;6.4
79;2021-04-16;1413;445;81756;24368;21.9;6.5
79;2021-04-17;581;354;82337;24722;22.1;6.6
79;2021-04-18;1;14;82338;24736;22.1;6.6
79;2021-04-19;1088;842;83426;25578;22.4;6.9
79;2021-04-20;1506;1229;84932;26807;22.8;7.2
79;2021-04-21;1419;1440;86351;28247;23.2;7.6
79;2021-04-22;1572;1089;87923;29336;23.6;7.9
79;2021-04-23;1316;1192;89239;30528;23.9;8.2
79;2021-04-24;653;463;89892;30991;24.1;8.3
79;2021-04-25;1;0;89893;30991;24.1;8.3
79;2021-04-26;1343;1813;91236;32804;24.5;8.8
79;2021-04-27;1898;2352;93134;35156;25.0;9.4
79;2021-04-28;1458;2867;94592;38023;25.4;10.2
79;2021-04-29;2104;2254;96696;40277;25.9;10.8
79;2021-04-30;2115;2463;98811;42740;26.5;11.5
79;2021-05-01;521;381;99332;43121;26.7;11.6
79;2021-05-02;1;11;99333;43132;26.7;11.6
79;2021-05-03;1182;1293;100515;44425;27.0;11.9
79;2021-05-04;1732;2333;102247;46758;27.4;12.5
79;2021-05-05;1694;2482;103941;49240;27.9;13.2
79;2021-05-06;2326;2223;106267;51463;28.5;13.8
79;2021-05-07;2105;2803;108372;54266;29.1;14.6
79;2021-05-08;198;506;108570;54772;29.1;14.7
79;2021-05-09;0;0;108570;54772;29.1;14.7
79;2021-05-10;1582;1787;110152;56559;29.6;15.2
79;2021-05-11;2309;1653;112461;58212;30.2;15.6
79;2021-05-12;2000;2683;114461;60895;30.7;16.3
79;2021-05-13;640;290;115101;61185;30.9;16.4
79;2021-05-14;2100;674;117201;61859;31.5;16.6
79;2021-05-15;1399;499;118600;62358;31.8;16.7
79;2021-05-16;1;22;118601;62380;31.8;16.7
79;2021-05-17;1873;1087;120474;63467;32.3;17.0
79;2021-05-18;2971;1272;123445;64739;33.1;17.4
79;2021-05-19;2899;969;126344;65708;33.9;17.6
79;2021-05-20;3106;1248;129450;66956;34.7;18.0
79;2021-05-21;2768;1066;132218;68022;35.5;18.3
79;2021-05-22;1084;261;133302;68283;35.8;18.3
79;2021-05-23;1;0;133303;68283;35.8;18.3
79;2021-05-24;161;20;133464;68303;35.8;18.3
79;2021-05-25;3198;991;136662;69294;36.7;18.6
79;2021-05-26;3312;854;139974;70148;37.6;18.8
79;2021-05-27;3589;1719;143563;71867;38.5;19.3
79;2021-05-28;3331;1825;146894;73692;39.4;19.8
79;2021-05-29;1072;450;147966;74142;39.7;19.9
79;2021-05-30;3;1;147969;74143;39.7;19.9
79;2021-05-31;2382;735;150351;74878;40.3;20.1
79;2021-06-01;3021;1577;153372;76455;41.2;20.5
79;2021-06-02;4066;1165;157438;77620;42.3;20.8
79;2021-06-03;4089;1757;161527;79377;43.3;21.3
79;2021-06-04;4141;2037;165668;81414;44.5;21.8
79;2021-06-05;2801;759;168469;82173;45.2;22.1
79;2021-06-06;696;39;169165;82212;45.4;22.1
79;2021-06-07;2805;1414;171970;83626;46.2;22.4
79;2021-06-08;2982;2070;174952;85696;47.0;23.0
79;2021-06-09;3631;1937;178583;87633;47.9;23.5
79;2021-06-10;3020;1971;181603;89604;48.7;24.0
79;2021-06-11;3767;2316;185370;91920;49.7;24.7
79;2021-06-12;1707;612;187077;92532;50.2;24.8
79;2021-06-13;213;24;187290;92556;50.3;24.8
79;2021-06-14;1247;1690;188537;94246;50.6;25.3
79;2021-06-15;1883;2362;190420;96608;51.1;25.9
79;2021-06-16;2204;2247;192624;98855;51.7;26.5
79;2021-06-17;2237;2620;194861;101475;52.3;27.2
79;2021-06-18;2413;2324;197274;103799;52.9;27.9
79;2021-06-19;1246;580;198520;104379;53.3;28.0
79;2021-06-20;3;2;198523;104381;53.3;28.0
79;2021-06-21;1233;2282;199756;106663;53.6;28.6
79;2021-06-22;1547;2877;201303;109540;54.0;29.4
79;2021-06-23;1770;2550;203073;112090;54.5;30.1
79;2021-06-24;2105;2002;205178;114092;55.1;30.6
79;2021-06-25;1488;2840;206666;116932;55.5;31.4
79;2021-06-26;870;808;207536;117740;55.7;31.6
79;2021-06-27;13;6;207549;117746;55.7;31.6
79;2021-06-28;1056;2620;208605;120366;56.0;32.3
79;2021-06-29;1473;3552;210078;123918;56.4;33.3
79;2021-06-30;1354;3447;211432;127365;56.7;34.2
79;2021-07-01;1202;3786;212634;131151;57.1;35.2
79;2021-07-02;1487;3346;214121;134497;57.5;36.1
79;2021-07-03;399;1504;214520;136001;57.6;36.5
79;2021-07-04;2;9;214522;136010;57.6;36.5
79;2021-07-05;753;2119;215275;138129;57.8;37.1
79;2021-07-06;947;3666;216222;141795;58.0;38.1
79;2021-07-07;1332;4308;217554;146103;58.4;39.2
79;2021-07-08;1107;4042;218661;150145;58.7;40.3
79;2021-07-09;836;3718;219497;153863;58.9;41.3
79;2021-07-10;514;1315;220011;155178;59.0;41.6
79;2021-07-11;3;12;220014;155190;59.0;41.6
79;2021-07-12;545;3696;220559;158886;59.2;42.6
79;2021-07-13;999;5187;221558;164073;59.5;44.0
79;2021-07-14;134;874;221692;164947;59.5;44.3
79;2021-07-15;1235;4684;222927;169631;59.8;45.5
79;2021-07-16;1333;4365;224260;173996;60.2;46.7
79;2021-07-17;576;2425;224836;176421;60.3;47.3
79;2021-07-18;44;498;224880;176919;60.3;47.5
79;2021-07-19;737;3316;225617;180235;60.5;48.4
79;2021-07-20;1230;3947;226847;184182;60.9;49.4
79;2021-07-21;1177;4198;228024;188380;61.2;50.6
79;2021-07-22;1354;3975;229378;192355;61.6;51.6
79;2021-07-23;1349;4556;230727;196911;61.9;52.8
79;2021-07-24;865;1499;231592;198410;62.2;53.2
79;2021-07-25;55;327;231647;198737;62.2;53.3
79;2021-07-26;1372;2599;233019;201336;62.5;54.0
79;2021-07-27;2084;2996;235103;204332;63.1;54.8
79;2021-07-28;2497;2495;237600;206827;63.8;55.5
79;2021-07-29;3010;2862;240610;209689;64.6;56.3
79;2021-07-30;2138;2815;242748;212504;65.1;57.0
79;2021-07-31;888;1157;243636;213661;65.4;57.3
79;2021-08-01;5;3;243641;213664;65.4;57.3
79;2021-08-02;1796;1545;245437;215209;65.9;57.8
79;2021-08-03;2823;2052;248260;217261;66.6;58.3
79;2021-08-04;2985;1743;251245;219004;67.4;58.8
79;2021-08-05;2900;2214;254145;221218;68.2;59.4
79;2021-08-06;2529;1636;256674;222854;68.9;59.8
79;2021-08-07;872;813;257546;223667;69.1;60.0
79;2021-08-08;4;3;257550;223670;69.1;60.0
79;2021-08-09;2495;1086;260045;224756;69.8;60.3
79;2021-08-10;2977;1549;263022;226305;70.6;60.7
79;2021-08-11;2584;1661;265606;227966;71.3;61.2
79;2021-08-12;2767;1431;268373;229397;72.0;61.6
79;2021-08-13;2875;1059;271248;230456;72.8;61.8
79;2021-08-14;518;391;271766;230847;72.9;62.0
79;2021-08-15;8;5;271774;230852;72.9;62.0
79;2021-08-16;1766;1196;273540;232048;73.4;62.3
79;2021-08-17;2103;1591;275643;233639;74.0;62.7
79;2021-08-18;1922;1915;277565;235554;74.5;63.2
79;2021-08-19;1617;1709;279182;237263;74.9;63.7
79;2021-08-20;1513;2162;280695;239425;75.3;64.3
79;2021-08-21;243;543;280938;239968;75.4;64.4
79;2021-08-22;1;21;280939;239989;75.4;64.4
79;2021-08-23;864;2176;281803;242165;75.6;65.0
79;2021-08-24;1072;2484;282875;244649;75.9;65.7
79;2021-08-25;1051;2760;283926;247409;76.2;66.4
79;2021-08-26;1017;2330;284943;249739;76.5;67.0
79;2021-08-27;611;2059;285554;251798;76.6;67.6
79;2021-08-28;299;841;285853;252639;76.7;67.8
79;2021-08-29;7;5;285860;252644;76.7;67.8
79;2021-08-30;554;2342;286414;254986;76.9;68.4
79;2021-08-31;633;2505;287047;257491;77.0;69.1
79;2021-09-01;650;2615;287697;260106;77.2;69.8
79;2021-09-02;762;2414;288459;262520;77.4;70.5
79;2021-09-03;637;2689;289096;265209;77.6;71.2
79;2021-09-04;266;700;289362;265909;77.7;71.4
79;2021-09-05;13;17;289375;265926;77.7;71.4
79;2021-09-06;330;1792;289705;267718;77.7;71.8
79;2021-09-07;347;2018;290052;269736;77.8;72.4
79;2021-09-08;542;2120;290594;271856;78.0;73.0
79;2021-09-09;318;1636;290912;273492;78.1;73.4
79;2021-09-10;422;2065;291334;275557;78.2;73.9
79;2021-09-11;162;836;291496;276393;78.2;74.2
79;2021-09-12;0;0;291496;276393;78.2;74.2
79;2021-09-13;363;1060;291859;277453;78.3;74.5
79;2021-09-14;383;1184;292242;278637;78.4;74.8
79;2021-09-15;475;1432;292717;280069;78.6;75.2
79;2021-09-16;464;1095;293181;281164;78.7;75.5
79;2021-09-17;445;1406;293626;282570;78.8;75.8
79;2021-09-18;141;567;293767;283137;78.8;76.0
79;2021-09-19;1;4;293768;283141;78.8;76.0
79;2021-09-20;190;553;293958;283694;78.9;76.1
79;2021-09-21;351;720;294309;284414;79.0;76.3
79;2021-09-22;209;1102;294518;285516;79.0;76.6
79;2021-09-23;412;566;294930;286082;79.1;76.8
79;2021-09-24;243;1348;295173;287430;79.2;77.1
79;2021-09-25;75;325;295248;287755;79.2;77.2
79;2021-09-26;0;1;295248;287756;79.2;77.2
79;2021-09-27;205;527;295453;288283;79.3;77.4
79;2021-09-28;130;409;295583;288692;79.3;77.5
79;2021-09-29;325;743;295908;289435;79.4;77.7
79;2021-09-30;154;279;296062;289714;79.5;77.7
79;2021-10-01;247;541;296309;290255;79.5;77.9
79;2021-10-02;127;248;296436;290503;79.6;78.0
79;2021-10-03;0;0;296436;290503;79.6;78.0
79;2021-10-04;157;332;296593;290835;79.6;78.0
79;2021-10-05;115;260;296708;291095;79.6;78.1
79;2021-10-06;144;336;296852;291431;79.7;78.2
79;2021-10-07;92;223;296944;291654;79.7;78.3
79;2021-10-08;222;549;297166;292203;79.7;78.4
79;2021-10-09;89;151;297255;292354;79.8;78.5
79;2021-10-10;1;3;297256;292357;79.8;78.5
79;2021-10-11;124;282;297380;292639;79.8;78.5
80;2020-12-27;0;0;0;0;0.0;0.0
80;2020-12-28;0;0;0;0;0.0;0.0
80;2020-12-29;11;0;11;0;0.0;0.0
80;2020-12-30;0;0;11;0;0.0;0.0
80;2020-12-31;0;0;11;0;0.0;0.0
80;2021-01-01;0;0;11;0;0.0;0.0
80;2021-01-02;1;0;12;0;0.0;0.0
80;2021-01-03;1;0;13;0;0.0;0.0
80;2021-01-04;0;0;13;0;0.0;0.0
80;2021-01-05;1;0;14;0;0.0;0.0
80;2021-01-06;30;0;44;0;0.0;0.0
80;2021-01-07;276;2;320;2;0.1;0.0
80;2021-01-08;330;1;650;3;0.1;0.0
80;2021-01-09;108;0;758;3;0.1;0.0
80;2021-01-10;21;0;779;3;0.1;0.0
80;2021-01-11;276;0;1055;3;0.2;0.0
80;2021-01-12;430;1;1485;4;0.3;0.0
80;2021-01-13;514;4;1999;8;0.4;0.0
80;2021-01-14;454;4;2453;12;0.4;0.0
80;2021-01-15;331;1;2784;13;0.5;0.0
80;2021-01-16;103;1;2887;14;0.5;0.0
80;2021-01-17;102;1;2989;15;0.5;0.0
80;2021-01-18;412;2;3401;17;0.6;0.0
80;2021-01-19;963;17;4364;34;0.8;0.0
80;2021-01-20;1086;11;5450;45;1.0;0.0
80;2021-01-21;1013;9;6463;54;1.1;0.0
80;2021-01-22;1114;5;7577;59;1.3;0.0
80;2021-01-23;907;18;8484;77;1.5;0.0
80;2021-01-24;823;10;9307;87;1.6;0.0
80;2021-01-25;1544;21;10851;108;1.9;0.0
80;2021-01-26;1480;12;12331;120;2.2;0.0
80;2021-01-27;822;26;13153;146;2.3;0.0
80;2021-01-28;622;172;13775;318;2.4;0.1
80;2021-01-29;637;216;14412;534;2.5;0.1
80;2021-01-30;87;59;14499;593;2.5;0.1
80;2021-01-31;0;0;14499;593;2.5;0.1
80;2021-02-01;26;254;14525;847;2.5;0.1
80;2021-02-02;21;441;14546;1288;2.6;0.2
80;2021-02-03;28;542;14574;1830;2.6;0.3
80;2021-02-04;278;358;14852;2188;2.6;0.4
80;2021-02-05;347;213;15199;2401;2.7;0.4
80;2021-02-06;168;69;15367;2470;2.7;0.4
80;2021-02-07;1;0;15368;2470;2.7;0.4
80;2021-02-08;424;241;15792;2711;2.8;0.5
80;2021-02-09;686;245;16478;2956;2.9;0.5
80;2021-02-10;607;496;17085;3452;3.0;0.6
80;2021-02-11;862;353;17947;3805;3.1;0.7
80;2021-02-12;945;318;18892;4123;3.3;0.7
80;2021-02-13;197;428;19089;4551;3.4;0.8
80;2021-02-14;78;571;19167;5122;3.4;0.9
80;2021-02-15;606;1015;19773;6137;3.5;1.1
80;2021-02-16;688;1133;20461;7270;3.6;1.3
80;2021-02-17;484;1169;20945;8439;3.7;1.5
80;2021-02-18;571;1138;21516;9577;3.8;1.7
80;2021-02-19;502;853;22018;10430;3.9;1.8
80;2021-02-20;22;510;22040;10940;3.9;1.9
80;2021-02-21;47;46;22087;10986;3.9;1.9
80;2021-02-22;146;573;22233;11559;3.9;2.0
80;2021-02-23;471;688;22704;12247;4.0;2.1
80;2021-02-24;431;678;23135;12925;4.1;2.3
80;2021-02-25;814;534;23949;13459;4.2;2.4
80;2021-02-26;1063;522;25012;13981;4.4;2.5
80;2021-02-27;475;71;25487;14052;4.5;2.5
80;2021-02-28;49;24;25536;14076;4.5;2.5
80;2021-03-01;729;68;26265;14144;4.6;2.5
80;2021-03-02;1014;93;27279;14237;4.8;2.5
80;2021-03-03;981;56;28260;14293;5.0;2.5
80;2021-03-04;1389;239;29649;14532;5.2;2.6
80;2021-03-05;1874;335;31523;14867;5.5;2.6
80;2021-03-06;2916;338;34439;15205;6.0;2.7
80;2021-03-07;1842;84;36281;15289;6.4;2.7
80;2021-03-08;714;608;36995;15897;6.5;2.8
80;2021-03-09;1310;910;38305;16807;6.7;2.9
80;2021-03-10;1724;756;40029;17563;7.0;3.1
80;2021-03-11;1909;827;41938;18390;7.4;3.2
80;2021-03-12;3140;752;45078;19142;7.9;3.4
80;2021-03-13;4006;221;49084;19363;8.6;3.4
80;2021-03-14;350;14;49434;19377;8.7;3.4
80;2021-03-15;1014;249;50448;19626;8.9;3.4
80;2021-03-16;883;346;51331;19972;9.0;3.5
80;2021-03-17;665;279;51996;20251;9.1;3.6
80;2021-03-18;1002;297;52998;20548;9.3;3.6
80;2021-03-19;1738;385;54736;20933;9.6;3.7
80;2021-03-20;3821;117;58557;21050;10.3;3.7
80;2021-03-21;486;31;59043;21081;10.4;3.7
80;2021-03-22;903;291;59946;21372;10.5;3.8
80;2021-03-23;1713;418;61659;21790;10.8;3.8
80;2021-03-24;1755;468;63414;22258;11.1;3.9
80;2021-03-25;2714;453;66128;22711;11.6;4.0
80;2021-03-26;3105;424;69233;23135;12.2;4.1
80;2021-03-27;2237;231;71470;23366;12.5;4.1
80;2021-03-28;676;95;72146;23461;12.7;4.1
80;2021-03-29;1979;754;74125;24215;13.0;4.2
80;2021-03-30;1967;874;76092;25089;13.4;4.4
80;2021-03-31;1495;986;77587;26075;13.6;4.6
80;2021-04-01;1950;1490;79537;27565;14.0;4.8
80;2021-04-02;2811;1578;82348;29143;14.5;5.1
80;2021-04-03;3048;863;85396;30006;15.0;5.3
80;2021-04-04;134;8;85530;30014;15.0;5.3
80;2021-04-05;684;201;86214;30215;15.1;5.3
80;2021-04-06;1280;968;87494;31183;15.4;5.5
80;2021-04-07;1624;1202;89118;32385;15.6;5.7
80;2021-04-08;2154;845;91272;33230;16.0;5.8
80;2021-04-09;3533;1359;94805;34589;16.6;6.1
80;2021-04-10;2737;1952;97542;36541;17.1;6.4
80;2021-04-11;187;177;97729;36718;17.2;6.4
80;2021-04-12;1814;491;99543;37209;17.5;6.5
80;2021-04-13;2385;1037;101928;38246;17.9;6.7
80;2021-04-14;2769;1168;104697;39414;18.4;6.9
80;2021-04-15;3731;882;108428;40296;19.0;7.1
80;2021-04-16;3337;878;111765;41174;19.6;7.2
80;2021-04-17;1653;2299;113418;43473;19.9;7.6
80;2021-04-18;372;390;113790;43863;20.0;7.7
80;2021-04-19;951;772;114741;44635;20.1;7.8
80;2021-04-20;1613;823;116354;45458;20.4;8.0
80;2021-04-21;1612;999;117966;46457;20.7;8.2
80;2021-04-22;2167;1253;120133;47710;21.1;8.4
80;2021-04-23;2640;1252;122773;48962;21.5;8.6
80;2021-04-24;1357;1193;124130;50155;21.8;8.8
80;2021-04-25;209;531;124339;50686;21.8;8.9
80;2021-04-26;1295;1445;125634;52131;22.0;9.1
80;2021-04-27;2025;1398;127659;53529;22.4;9.4
80;2021-04-28;2199;1396;129858;54925;22.8;9.6
80;2021-04-29;3218;1888;133076;56813;23.4;10.0
80;2021-04-30;3081;2857;136157;59670;23.9;10.5
80;2021-05-01;987;660;137144;60330;24.1;10.6
80;2021-05-02;371;54;137515;60384;24.1;10.6
80;2021-05-03;2720;1189;140235;61573;24.6;10.8
80;2021-05-04;2494;1708;142729;63281;25.1;11.1
80;2021-05-05;3366;1899;146095;65180;25.6;11.4
80;2021-05-06;3168;2558;149263;67738;26.2;11.9
80;2021-05-07;3454;2699;152717;70437;26.8;12.4
80;2021-05-08;2784;927;155501;71364;27.3;12.5
80;2021-05-09;1407;269;156908;71633;27.5;12.6
80;2021-05-10;1880;1832;158788;73465;27.9;12.9
80;2021-05-11;3274;1806;162062;75271;28.4;13.2
80;2021-05-12;4703;1576;166765;76847;29.3;13.5
80;2021-05-13;3837;367;170602;77214;29.9;13.6
80;2021-05-14;5187;1407;175789;78621;30.9;13.8
80;2021-05-15;5917;1054;181706;79675;31.9;14.0
80;2021-05-16;2678;315;184384;79990;32.4;14.0
80;2021-05-17;2371;819;186755;80809;32.8;14.2
80;2021-05-18;3949;857;190704;81666;33.5;14.3
80;2021-05-19;4018;944;194722;82610;34.2;14.5
80;2021-05-20;4568;1221;199290;83831;35.0;14.7
80;2021-05-21;4890;1670;204180;85501;35.8;15.0
80;2021-05-22;5030;1159;209210;86660;36.7;15.2
80;2021-05-23;1783;242;210993;86902;37.0;15.3
80;2021-05-24;1469;160;212462;87062;37.3;15.3
80;2021-05-25;2622;1138;215084;88200;37.7;15.5
80;2021-05-26;4249;1707;219333;89907;38.5;15.8
80;2021-05-27;3977;2471;223310;92378;39.2;16.2
80;2021-05-28;3865;2978;227175;95356;39.9;16.7
80;2021-05-29;3697;1631;230872;96987;40.5;17.0
80;2021-05-30;1182;198;232054;97185;40.7;17.1
80;2021-05-31;2604;1372;234658;98557;41.2;17.3
80;2021-06-01;4031;2437;238689;100994;41.9;17.7
80;2021-06-02;3334;2009;242023;103003;42.5;18.1
80;2021-06-03;4264;2933;246287;105936;43.2;18.6
80;2021-06-04;4796;3086;251083;109022;44.1;19.1
80;2021-06-05;3554;2073;254637;111095;44.7;19.5
80;2021-06-06;803;211;255440;111306;44.8;19.5
80;2021-06-07;1750;1945;257190;113251;45.1;19.9
80;2021-06-08;2743;2560;259933;115811;45.6;20.3
80;2021-06-09;3012;2735;262945;118546;46.1;20.8
80;2021-06-10;3163;3171;266108;121717;46.7;21.4
80;2021-06-11;3216;3901;269324;125618;47.3;22.0
80;2021-06-12;3042;2329;272366;127947;47.8;22.5
80;2021-06-13;474;404;272840;128351;47.9;22.5
80;2021-06-14;1263;2852;274103;131203;48.1;23.0
80;2021-06-15;2315;3421;276418;134624;48.5;23.6
80;2021-06-16;1563;4212;277981;138836;48.8;24.4
80;2021-06-17;2359;3625;280340;142461;49.2;25.0
80;2021-06-18;2552;3907;282892;146368;49.7;25.7
80;2021-06-19;2986;4342;285878;150710;50.2;26.5
80;2021-06-20;203;1077;286081;151787;50.2;26.6
80;2021-06-21;1015;2620;287096;154407;50.4;27.1
80;2021-06-22;1149;3930;288245;158337;50.6;27.8
80;2021-06-23;1850;5291;290095;163628;50.9;28.7
80;2021-06-24;1695;4685;291790;168313;51.2;29.5
80;2021-06-25;1374;6126;293164;174439;51.5;30.6
80;2021-06-26;1934;6183;295098;180622;51.8;31.7
80;2021-06-27;333;2031;295431;182653;51.9;32.1
80;2021-06-28;903;3170;296334;185823;52.0;32.6
80;2021-06-29;1919;4624;298253;190447;52.3;33.4
80;2021-06-30;1245;4785;299498;195232;52.6;34.3
80;2021-07-01;1593;5000;301091;200232;52.8;35.1
80;2021-07-02;1856;5986;302947;206218;53.2;36.2
80;2021-07-03;1293;5265;304240;211483;53.4;37.1
80;2021-07-04;692;1471;304932;212954;53.5;37.4
80;2021-07-05;879;2963;305811;215917;53.7;37.9
80;2021-07-06;1852;3990;307663;219907;54.0;38.6
80;2021-07-07;1561;4506;309224;224413;54.3;39.4
80;2021-07-08;2082;5003;311306;229416;54.6;40.3
80;2021-07-09;2596;5473;313902;234889;55.1;41.2
80;2021-07-10;1617;4017;315519;238906;55.4;41.9
80;2021-07-11;406;805;315925;239711;55.4;42.1
80;2021-07-12;871;3379;316796;243090;55.6;42.7
80;2021-07-13;2087;5088;318883;248178;56.0;43.6
80;2021-07-14;2801;1749;321684;249927;56.5;43.9
80;2021-07-15;2792;5297;324476;255224;56.9;44.8
80;2021-07-16;3877;5893;328353;261117;57.6;45.8
80;2021-07-17;3368;4461;331721;265578;58.2;46.6
80;2021-07-18;874;896;332595;266474;58.4;46.8
80;2021-07-19;2158;2886;334753;269360;58.8;47.3
80;2021-07-20;3321;4903;338074;274263;59.3;48.1
80;2021-07-21;3497;4497;341571;278760;59.9;48.9
80;2021-07-22;4362;4572;345933;283332;60.7;49.7
80;2021-07-23;5399;4830;351332;288162;61.7;50.6
80;2021-07-24;4367;4346;355699;292508;62.4;51.3
80;2021-07-25;1185;650;356884;293158;62.6;51.5
80;2021-07-26;2681;2340;359565;295498;63.1;51.9
80;2021-07-27;4373;3706;363938;299204;63.9;52.5
80;2021-07-28;5101;2803;369039;302007;64.8;53.0
80;2021-07-29;4991;3231;374030;305238;65.6;53.6
80;2021-07-30;5024;3641;379054;308879;66.5;54.2
80;2021-07-31;4156;2927;383210;311806;67.3;54.7
80;2021-08-01;1288;363;384498;312169;67.5;54.8
80;2021-08-02;2059;1739;386557;313908;67.8;55.1
80;2021-08-03;3716;2363;390273;316271;68.5;55.5
80;2021-08-04;3367;2491;393640;318762;69.1;55.9
80;2021-08-05;3137;2579;396777;321341;69.6;56.4
80;2021-08-06;3248;2878;400025;324219;70.2;56.9
80;2021-08-07;2426;2670;402451;326889;70.6;57.4
80;2021-08-08;621;686;403072;327575;70.7;57.5
80;2021-08-09;1382;2078;404454;329653;71.0;57.9
80;2021-08-10;2353;2848;406807;332501;71.4;58.4
80;2021-08-11;1946;2383;408753;334884;71.7;58.8
80;2021-08-12;2236;2661;410989;337545;72.1;59.2
80;2021-08-13;1883;3154;412872;340699;72.5;59.8
80;2021-08-14;1411;2113;414283;342812;72.7;60.2
80;2021-08-15;318;663;414601;343475;72.8;60.3
80;2021-08-16;897;2419;415498;345894;72.9;60.7
80;2021-08-17;1709;3505;417207;349399;73.2;61.3
80;2021-08-18;1234;3714;418441;353113;73.4;62.0
80;2021-08-19;1569;3821;420010;356934;73.7;62.6
80;2021-08-20;1264;4434;421274;361368;73.9;63.4
80;2021-08-21;1078;2687;422352;364055;74.1;63.9
80;2021-08-22;145;680;422497;364735;74.2;64.0
80;2021-08-23;583;3000;423080;367735;74.3;64.5
80;2021-08-24;1092;4371;424172;372106;74.4;65.3
80;2021-08-25;973;3677;425145;375783;74.6;66.0
80;2021-08-26;956;3819;426101;379602;74.8;66.6
80;2021-08-27;1014;4458;427115;384060;75.0;67.4
80;2021-08-28;723;3347;427838;387407;75.1;68.0
80;2021-08-29;199;555;428037;387962;75.1;68.1
80;2021-08-30;500;2280;428537;390242;75.2;68.5
80;2021-08-31;750;3111;429287;393353;75.3;69.0
80;2021-09-01;675;2316;429962;395669;75.5;69.4
80;2021-09-02;527;2077;430489;397746;75.6;69.8
80;2021-09-03;761;2803;431250;400549;75.7;70.3
80;2021-09-04;958;2598;432208;403147;75.9;70.8
80;2021-09-05;166;341;432374;403488;75.9;70.8
80;2021-09-06;420;1305;432794;404793;76.0;71.0
80;2021-09-07;491;1581;433285;406374;76.0;71.3
80;2021-09-08;495;1549;433780;407923;76.1;71.6
80;2021-09-09;532;1515;434312;409438;76.2;71.9
80;2021-09-10;620;1704;434932;411142;76.3;72.2
80;2021-09-11;520;1959;435452;413101;76.4;72.5
80;2021-09-12;78;303;435530;413404;76.4;72.6
80;2021-09-13;312;784;435842;414188;76.5;72.7
80;2021-09-14;642;1085;436484;415273;76.6;72.9
80;2021-09-15;357;1089;436841;416362;76.7;73.1
80;2021-09-16;476;1030;437317;417392;76.8;73.3
80;2021-09-17;506;1237;437823;418629;76.8;73.5
80;2021-09-18;348;1277;438171;419906;76.9;73.7
80;2021-09-19;18;169;438189;420075;76.9;73.7
80;2021-09-20;326;445;438515;420520;77.0;73.8
80;2021-09-21;295;615;438810;421135;77.0;73.9
80;2021-09-22;284;709;439094;421844;77.1;74.0
80;2021-09-23;303;506;439397;422350;77.1;74.1
80;2021-09-24;371;897;439768;423247;77.2;74.3
80;2021-09-25;283;1132;440051;424379;77.2;74.5
80;2021-09-26;20;109;440071;424488;77.2;74.5
80;2021-09-27;190;536;440261;425024;77.3;74.6
80;2021-09-28;148;382;440409;425406;77.3;74.7
80;2021-09-29;257;511;440666;425917;77.3;74.8
80;2021-09-30;199;329;440865;426246;77.4;74.8
80;2021-10-01;305;720;441170;426966;77.4;74.9
80;2021-10-02;335;892;441505;427858;77.5;75.1
80;2021-10-03;18;64;441523;427922;77.5;75.1
80;2021-10-04;136;320;441659;428242;77.5;75.2
80;2021-10-05;166;460;441825;428702;77.5;75.2
80;2021-10-06;259;445;442084;429147;77.6;75.3
80;2021-10-07;195;427;442279;429574;77.6;75.4
80;2021-10-08;251;689;442530;430263;77.7;75.5
80;2021-10-09;283;479;442813;430742;77.7;75.6
80;2021-10-10;26;34;442839;430776;77.7;75.6
80;2021-10-11;138;219;442977;430995;77.7;75.6
81;2020-12-27;1;0;1;0;0.0;0.0
81;2020-12-28;0;0;1;0;0.0;0.0
81;2020-12-29;0;0;1;0;0.0;0.0
81;2020-12-30;1;0;2;0;0.0;0.0
81;2020-12-31;1;0;3;0;0.0;0.0
81;2021-01-01;0;0;3;0;0.0;0.0
81;2021-01-02;0;0;3;0;0.0;0.0
81;2021-01-03;0;0;3;0;0.0;0.0
81;2021-01-04;1;0;4;0;0.0;0.0
81;2021-01-05;0;0;4;0;0.0;0.0
81;2021-01-06;5;0;9;0;0.0;0.0
81;2021-01-07;265;0;274;0;0.1;0.0
81;2021-01-08;312;1;586;1;0.2;0.0
81;2021-01-09;74;1;660;2;0.2;0.0
81;2021-01-10;1;0;661;2;0.2;0.0
81;2021-01-11;133;0;794;2;0.2;0.0
81;2021-01-12;167;0;961;2;0.2;0.0
81;2021-01-13;234;1;1195;3;0.3;0.0
81;2021-01-14;963;7;2158;10;0.6;0.0
81;2021-01-15;523;3;2681;13;0.7;0.0
81;2021-01-16;71;1;2752;14;0.7;0.0
81;2021-01-17;0;0;2752;14;0.7;0.0
81;2021-01-18;581;3;3333;17;0.9;0.0
81;2021-01-19;662;4;3995;21;1.0;0.0
81;2021-01-20;754;2;4749;23;1.2;0.0
81;2021-01-21;1183;16;5932;39;1.5;0.0
81;2021-01-22;857;3;6789;42;1.8;0.0
81;2021-01-23;221;2;7010;44;1.8;0.0
81;2021-01-24;102;0;7112;44;1.8;0.0
81;2021-01-25;570;6;7682;50;2.0;0.0
81;2021-01-26;634;6;8316;56;2.1;0.0
81;2021-01-27;552;3;8868;59;2.3;0.0
81;2021-01-28;700;209;9568;268;2.5;0.1
81;2021-01-29;303;184;9871;452;2.5;0.1
81;2021-01-30;203;37;10074;489;2.6;0.1
81;2021-01-31;104;1;10178;490;2.6;0.1
81;2021-02-01;321;130;10499;620;2.7;0.2
81;2021-02-02;445;143;10944;763;2.8;0.2
81;2021-02-03;476;220;11420;983;2.9;0.3
81;2021-02-04;1449;725;12869;1708;3.3;0.4
81;2021-02-05;870;316;13739;2024;3.5;0.5
81;2021-02-06;274;19;14013;2043;3.6;0.5
81;2021-02-07;103;0;14116;2043;3.6;0.5
81;2021-02-08;275;219;14391;2262;3.7;0.6
81;2021-02-09;420;218;14811;2480;3.8;0.6
81;2021-02-10;371;286;15182;2766;3.9;0.7
81;2021-02-11;651;397;15833;3163;4.1;0.8
81;2021-02-12;581;544;16414;3707;4.2;1.0
81;2021-02-13;188;156;16602;3863;4.3;1.0
81;2021-02-14;100;1;16702;3864;4.3;1.0
81;2021-02-15;234;483;16936;4347;4.4;1.1
81;2021-02-16;282;617;17218;4964;4.4;1.3
81;2021-02-17;241;521;17459;5485;4.5;1.4
81;2021-02-18;483;671;17942;6156;4.6;1.6
81;2021-02-19;572;415;18514;6571;4.8;1.7
81;2021-02-20;322;282;18836;6853;4.9;1.8
81;2021-02-21;23;80;18859;6933;4.9;1.8
81;2021-02-22;233;535;19092;7468;4.9;1.9
81;2021-02-23;169;591;19261;8059;5.0;2.1
81;2021-02-24;291;629;19552;8688;5.0;2.2
81;2021-02-25;720;1054;20272;9742;5.2;2.5
81;2021-02-26;911;957;21183;10699;5.5;2.8
81;2021-02-27;275;242;21458;10941;5.5;2.8
81;2021-02-28;21;88;21479;11029;5.5;2.8
81;2021-03-01;208;410;21687;11439;5.6;2.9
81;2021-03-02;364;544;22051;11983;5.7;3.1
81;2021-03-03;462;422;22513;12405;5.8;3.2
81;2021-03-04;1061;460;23574;12865;6.1;3.3
81;2021-03-05;1406;397;24980;13262;6.4;3.4
81;2021-03-06;982;171;25962;13433;6.7;3.5
81;2021-03-07;154;102;26116;13535;6.7;3.5
81;2021-03-08;466;362;26582;13897;6.9;3.6
81;2021-03-09;816;373;27398;14270;7.1;3.7
81;2021-03-10;898;396;28296;14666;7.3;3.8
81;2021-03-11;1352;360;29648;15026;7.6;3.9
81;2021-03-12;1691;308;31339;15334;8.1;4.0
81;2021-03-13;1031;189;32370;15523;8.3;4.0
81;2021-03-14;66;82;32436;15605;8.4;4.0
81;2021-03-15;1093;225;33529;15830;8.6;4.1
81;2021-03-16;724;230;34253;16060;8.8;4.1
81;2021-03-17;893;280;35146;16340;9.1;4.2
81;2021-03-18;971;579;36117;16919;9.3;4.4
81;2021-03-19;1271;460;37388;17379;9.6;4.5
81;2021-03-20;677;285;38065;17664;9.8;4.6
81;2021-03-21;139;22;38204;17686;9.8;4.6
81;2021-03-22;932;279;39136;17965;10.1;4.6
81;2021-03-23;1420;224;40556;18189;10.5;4.7
81;2021-03-24;1606;267;42162;18456;10.9;4.8
81;2021-03-25;2028;327;44190;18783;11.4;4.8
81;2021-03-26;2100;289;46290;19072;11.9;4.9
81;2021-03-27;1091;38;47381;19110;12.2;4.9
81;2021-03-28;734;41;48115;19151;12.4;4.9
81;2021-03-29;2866;196;50981;19347;13.1;5.0
81;2021-03-30;3055;218;54036;19565;13.9;5.0
81;2021-03-31;2691;302;56727;19867;14.6;5.1
81;2021-04-01;3315;570;60042;20437;15.5;5.3
81;2021-04-02;2615;376;62657;20813;16.2;5.4
81;2021-04-03;1147;306;63804;21119;16.4;5.4
81;2021-04-04;1403;25;65207;21144;16.8;5.5
81;2021-04-05;718;21;65925;21165;17.0;5.5
81;2021-04-06;1599;520;67524;21685;17.4;5.6
81;2021-04-07;1817;585;69341;22270;17.9;5.7
81;2021-04-08;2619;829;71960;23099;18.6;6.0
81;2021-04-09;3052;479;75012;23578;19.3;6.1
81;2021-04-10;1475;519;76487;24097;19.7;6.2
81;2021-04-11;1299;71;77786;24168;20.1;6.2
81;2021-04-12;1220;685;79006;24853;20.4;6.4
81;2021-04-13;2528;795;81534;25648;21.0;6.6
81;2021-04-14;2505;836;84039;26484;21.7;6.8
81;2021-04-15;3099;1204;87138;27688;22.5;7.1
81;2021-04-16;2823;1097;89961;28785;23.2;7.4
81;2021-04-17;1145;300;91106;29085;23.5;7.5
81;2021-04-18;519;146;91625;29231;23.6;7.5
81;2021-04-19;913;824;92538;30055;23.9;7.7
81;2021-04-20;2270;1170;94808;31225;24.4;8.0
81;2021-04-21;2224;1007;97032;32232;25.0;8.3
81;2021-04-22;2816;1065;99848;33297;25.7;8.6
81;2021-04-23;2885;974;102733;34271;26.5;8.8
81;2021-04-24;1326;742;104059;35013;26.8;9.0
81;2021-04-25;454;716;104513;35729;26.9;9.2
81;2021-04-26;1061;2424;105574;38153;27.2;9.8
81;2021-04-27;1595;2362;107169;40515;27.6;10.4
81;2021-04-28;1427;2400;108596;42915;28.0;11.1
81;2021-04-29;1818;2749;110414;45664;28.5;11.8
81;2021-04-30;2013;2354;112427;48018;29.0;12.4
81;2021-05-01;362;686;112789;48704;29.1;12.6
81;2021-05-02;291;1379;113080;50083;29.2;12.9
81;2021-05-03;1115;1170;114195;51253;29.4;13.2
81;2021-05-04;2620;1912;116815;53165;30.1;13.7
81;2021-05-05;2016;1936;118831;55101;30.6;14.2
81;2021-05-06;2748;3458;121579;58559;31.3;15.1
81;2021-05-07;2128;2882;123707;61441;31.9;15.8
81;2021-05-08;962;878;124669;62319;32.1;16.1
81;2021-05-09;534;1350;125203;63669;32.3;16.4
81;2021-05-10;824;1600;126027;65269;32.5;16.8
81;2021-05-11;1661;2576;127688;67845;32.9;17.5
81;2021-05-12;1640;2464;129328;70309;33.3;18.1
81;2021-05-13;1216;564;130544;70873;33.7;18.3
81;2021-05-14;1890;1725;132434;72598;34.1;18.7
81;2021-05-15;1511;622;133945;73220;34.5;18.9
81;2021-05-16;1368;417;135313;73637;34.9;19.0
81;2021-05-17;1167;864;136480;74501;35.2;19.2
81;2021-05-18;1702;1429;138182;75930;35.6;19.6
81;2021-05-19;2641;1244;140823;77174;36.3;19.9
81;2021-05-20;2968;1351;143791;78525;37.1;20.2
81;2021-05-21;2739;1118;146530;79643;37.8;20.5
81;2021-05-22;2814;523;149344;80166;38.5;20.7
81;2021-05-23;1178;74;150522;80240;38.8;20.7
81;2021-05-24;837;83;151359;80323;39.0;20.7
81;2021-05-25;2490;1104;153849;81427;39.7;21.0
81;2021-05-26;1891;801;155740;82228;40.1;21.2
81;2021-05-27;2555;1547;158295;83775;40.8;21.6
81;2021-05-28;2566;1663;160861;85438;41.5;22.0
81;2021-05-29;1400;544;162261;85982;41.8;22.2
81;2021-05-30;935;219;163196;86201;42.1;22.2
81;2021-05-31;1183;1340;164379;87541;42.4;22.6
81;2021-06-01;1779;2695;166158;90236;42.8;23.3
81;2021-06-02;2006;2447;168164;92683;43.4;23.9
81;2021-06-03;2003;2532;170167;95215;43.9;24.5
81;2021-06-04;1844;2946;172011;98161;44.3;25.3
81;2021-06-05;1757;1307;173768;99468;44.8;25.6
81;2021-06-06;370;366;174138;99834;44.9;25.7
81;2021-06-07;1209;1540;175347;101374;45.2;26.1
81;2021-06-08;2369;2386;177716;103760;45.8;26.7
81;2021-06-09;2438;1868;180154;105628;46.4;27.2
81;2021-06-10;1278;1563;181432;107191;46.8;27.6
81;2021-06-11;2657;2200;184089;109391;47.5;28.2
81;2021-06-12;1659;1039;185748;110430;47.9;28.5
81;2021-06-13;444;476;186192;110906;48.0;28.6
81;2021-06-14;771;1418;186963;112324;48.2;29.0
81;2021-06-15;1677;3501;188640;115825;48.6;29.9
81;2021-06-16;1269;3013;189909;118838;49.0;30.6
81;2021-06-17;1344;2525;191253;121363;49.3;31.3
81;2021-06-18;1836;2770;193089;124133;49.8;32.0
81;2021-06-19;824;951;193913;125084;50.0;32.2
81;2021-06-20;405;536;194318;125620;50.1;32.4
81;2021-06-21;425;1039;194743;126659;50.2;32.7
81;2021-06-22;1061;2568;195804;129227;50.5;33.3
81;2021-06-23;1142;2159;196946;131386;50.8;33.9
81;2021-06-24;1115;1939;198061;133325;51.1;34.4
81;2021-06-25;1238;2866;199299;136191;51.4;35.1
81;2021-06-26;721;1713;200020;137904;51.6;35.6
81;2021-06-27;526;1646;200546;139550;51.7;36.0
81;2021-06-28;476;1540;201022;141090;51.8;36.4
81;2021-06-29;1079;2635;202101;143725;52.1;37.1
81;2021-06-30;1043;3153;203144;146878;52.4;37.9
81;2021-07-01;1101;2627;204245;149505;52.7;38.5
81;2021-07-02;1070;2860;205315;152365;52.9;39.3
81;2021-07-03;732;2829;206047;155194;53.1;40.0
81;2021-07-04;268;1010;206315;156204;53.2;40.3
81;2021-07-05;702;1626;207017;157830;53.4;40.7
81;2021-07-06;975;3176;207992;161006;53.6;41.5
81;2021-07-07;1059;2442;209051;163448;53.9;42.1
81;2021-07-08;1030;2236;210081;165684;54.2;42.7
81;2021-07-09;1147;2704;211228;168388;54.5;43.4
81;2021-07-10;806;1523;212034;169911;54.7;43.8
81;2021-07-11;436;1012;212470;170923;54.8;44.1
81;2021-07-12;785;1725;213255;172648;55.0;44.5
81;2021-07-13;2081;3144;215336;175792;55.5;45.3
81;2021-07-14;1443;1573;216779;177365;55.9;45.7
81;2021-07-15;2545;2765;219324;180130;56.5;46.4
81;2021-07-16;2032;3030;221356;183160;57.1;47.2
81;2021-07-17;1218;2454;222574;185614;57.4;47.9
81;2021-07-18;672;1131;223246;186745;57.6;48.1
81;2021-07-19;1256;1733;224502;188478;57.9;48.6
81;2021-07-20;3064;2807;227566;191285;58.7;49.3
81;2021-07-21;3488;2347;231054;193632;59.6;49.9
81;2021-07-22;3557;2096;234611;195728;60.5;50.5
81;2021-07-23;3172;3249;237783;198977;61.3;51.3
81;2021-07-24;2519;1723;240302;200700;61.9;51.7
81;2021-07-25;1684;711;241986;201411;62.4;51.9
81;2021-07-26;2014;1547;244000;202958;62.9;52.3
81;2021-07-27;3619;2544;247619;205502;63.8;53.0
81;2021-07-28;3052;2208;250671;207710;64.6;53.5
81;2021-07-29;3354;1782;254025;209492;65.5;54.0
81;2021-07-30;2828;2260;256853;211752;66.2;54.6
81;2021-07-31;1947;1015;258800;212767;66.7;54.9
81;2021-08-01;835;639;259635;213406;66.9;55.0
81;2021-08-02;1082;989;260717;214395;67.2;55.3
81;2021-08-03;2362;2116;263079;216511;67.8;55.8
81;2021-08-04;2031;1535;265110;218046;68.3;56.2
81;2021-08-05;1544;1877;266654;219923;68.7;56.7
81;2021-08-06;1725;1970;268379;221893;69.2;57.2
81;2021-08-07;985;1042;269364;222935;69.4;57.5
81;2021-08-08;437;708;269801;223643;69.6;57.7
81;2021-08-09;805;659;270606;224302;69.8;57.8
81;2021-08-10;1610;2757;272216;227059;70.2;58.5
81;2021-08-11;1110;2410;273326;229469;70.5;59.2
81;2021-08-12;1063;2249;274389;231718;70.7;59.7
81;2021-08-13;873;2473;275262;234191;71.0;60.4
81;2021-08-14;501;1873;275763;236064;71.1;60.9
81;2021-08-15;141;1100;275904;237164;71.1;61.1
81;2021-08-16;631;1816;276535;238980;71.3;61.6
81;2021-08-17;1347;3101;277882;242081;71.6;62.4
81;2021-08-18;1067;2360;278949;244441;71.9;63.0
81;2021-08-19;941;2267;279890;246708;72.2;63.6
81;2021-08-20;929;2354;280819;249062;72.4;64.2
81;2021-08-21;471;1538;281290;250600;72.5;64.6
81;2021-08-22;184;931;281474;251531;72.6;64.8
81;2021-08-23;487;1260;281961;252791;72.7;65.2
81;2021-08-24;852;2543;282813;255334;72.9;65.8
81;2021-08-25;718;2054;283531;257388;73.1;66.4
81;2021-08-26;855;2110;284386;259498;73.3;66.9
81;2021-08-27;853;2185;285239;261683;73.5;67.5
81;2021-08-28;484;1417;285723;263100;73.7;67.8
81;2021-08-29;163;832;285886;263932;73.7;68.0
81;2021-08-30;419;1183;286305;265115;73.8;68.3
81;2021-08-31;832;2020;287137;267135;74.0;68.9
81;2021-09-01;658;1232;287795;268367;74.2;69.2
81;2021-09-02;574;1076;288369;269443;74.3;69.5
81;2021-09-03;581;1272;288950;270715;74.5;69.8
81;2021-09-04;496;864;289446;271579;74.6;70.0
81;2021-09-05;97;222;289543;271801;74.6;70.1
81;2021-09-06;279;463;289822;272264;74.7;70.2
81;2021-09-07;387;1092;290209;273356;74.8;70.5
81;2021-09-08;438;1069;290647;274425;74.9;70.7
81;2021-09-09;367;808;291014;275233;75.0;71.0
81;2021-09-10;394;962;291408;276195;75.1;71.2
81;2021-09-11;407;853;291815;277048;75.2;71.4
81;2021-09-12;79;216;291894;277264;75.3;71.5
81;2021-09-13;231;461;292125;277725;75.3;71.6
81;2021-09-14;504;730;292629;278455;75.4;71.8
81;2021-09-15;452;765;293081;279220;75.6;72.0
81;2021-09-16;336;548;293417;279768;75.6;72.1
81;2021-09-17;412;841;293829;280609;75.7;72.3
81;2021-09-18;260;697;294089;281306;75.8;72.5
81;2021-09-19;52;164;294141;281470;75.8;72.6
81;2021-09-20;112;323;294253;281793;75.9;72.6
81;2021-09-21;264;596;294517;282389;75.9;72.8
81;2021-09-22;212;664;294729;283053;76.0;73.0
81;2021-09-23;163;662;294892;283715;76.0;73.1
81;2021-09-24;308;705;295200;284420;76.1;73.3
81;2021-09-25;173;674;295373;285094;76.1;73.5
81;2021-09-26;36;116;295409;285210;76.2;73.5
81;2021-09-27;136;272;295545;285482;76.2;73.6
81;2021-09-28;185;362;295730;285844;76.2;73.7
81;2021-09-29;248;517;295978;286361;76.3;73.8
81;2021-09-30;143;292;296121;286653;76.3;73.9
81;2021-10-01;244;426;296365;287079;76.4;74.0
81;2021-10-02;181;415;296546;287494;76.4;74.1
81;2021-10-03;44;105;296590;287599;76.5;74.1
81;2021-10-04;88;209;296678;287808;76.5;74.2
81;2021-10-05;135;320;296813;288128;76.5;74.3
81;2021-10-06;208;470;297021;288598;76.6;74.4
81;2021-10-07;139;305;297160;288903;76.6;74.5
81;2021-10-08;193;499;297353;289402;76.7;74.6
81;2021-10-09;150;320;297503;289722;76.7;74.7
81;2021-10-10;52;69;297555;289791;76.7;74.7
81;2021-10-11;107;181;297662;289972;76.7;74.8
82;2020-12-27;1;0;1;0;0.0;0.0
82;2020-12-28;2;0;3;0;0.0;0.0
82;2020-12-29;0;0;3;0;0.0;0.0
82;2020-12-30;0;0;3;0;0.0;0.0
82;2020-12-31;0;0;3;0;0.0;0.0
82;2021-01-01;0;0;3;0;0.0;0.0
82;2021-01-02;0;0;3;0;0.0;0.0
82;2021-01-03;0;0;3;0;0.0;0.0
82;2021-01-04;0;0;3;0;0.0;0.0
82;2021-01-05;86;0;89;0;0.0;0.0
82;2021-01-06;1;0;90;0;0.0;0.0
82;2021-01-07;75;0;165;0;0.1;0.0
82;2021-01-08;46;0;211;0;0.1;0.0
82;2021-01-09;77;0;288;0;0.1;0.0
82;2021-01-10;0;0;288;0;0.1;0.0
82;2021-01-11;94;0;382;0;0.1;0.0
82;2021-01-12;285;0;667;0;0.3;0.0
82;2021-01-13;336;1;1003;1;0.4;0.0
82;2021-01-14;443;5;1446;6;0.6;0.0
82;2021-01-15;612;3;2058;9;0.8;0.0
82;2021-01-16;230;3;2288;12;0.9;0.0
82;2021-01-17;89;0;2377;12;0.9;0.0
82;2021-01-18;432;0;2809;12;1.1;0.0
82;2021-01-19;482;1;3291;13;1.3;0.0
82;2021-01-20;663;4;3954;17;1.5;0.0
82;2021-01-21;447;2;4401;19;1.7;0.0
82;2021-01-22;483;2;4884;21;1.9;0.0
82;2021-01-23;151;0;5035;21;1.9;0.0
82;2021-01-24;0;0;5035;21;1.9;0.0
82;2021-01-25;375;0;5410;21;2.1;0.0
82;2021-01-26;468;0;5878;21;2.2;0.0
82;2021-01-27;520;1;6398;22;2.4;0.0
82;2021-01-28;587;35;6985;57;2.7;0.0
82;2021-01-29;405;108;7390;165;2.8;0.1
82;2021-01-30;44;22;7434;187;2.8;0.1
82;2021-01-31;2;0;7436;187;2.8;0.1
82;2021-02-01;292;56;7728;243;2.9;0.1
82;2021-02-02;344;102;8072;345;3.1;0.1
82;2021-02-03;462;66;8534;411;3.2;0.2
82;2021-02-04;768;216;9302;627;3.5;0.2
82;2021-02-05;480;145;9782;772;3.7;0.3
82;2021-02-06;93;39;9875;811;3.8;0.3
82;2021-02-07;29;79;9904;890;3.8;0.3
82;2021-02-08;151;225;10055;1115;3.8;0.4
82;2021-02-09;238;397;10293;1512;3.9;0.6
82;2021-02-10;271;599;10564;2111;4.0;0.8
82;2021-02-11;225;400;10789;2511;4.1;1.0
82;2021-02-12;190;608;10979;3119;4.2;1.2
82;2021-02-13;60;117;11039;3236;4.2;1.2
82;2021-02-14;5;80;11044;3316;4.2;1.3
82;2021-02-15;216;304;11260;3620;4.3;1.4
82;2021-02-16;280;391;11540;4011;4.4;1.5
82;2021-02-17;359;522;11899;4533;4.5;1.7
82;2021-02-18;508;506;12407;5039;4.7;1.9
82;2021-02-19;492;542;12899;5581;4.9;2.1
82;2021-02-20;78;139;12977;5720;4.9;2.2
82;2021-02-21;0;0;12977;5720;4.9;2.2
82;2021-02-22;200;407;13177;6127;5.0;2.3
82;2021-02-23;277;469;13454;6596;5.1;2.5
82;2021-02-24;285;456;13739;7052;5.2;2.7
82;2021-02-25;637;510;14376;7562;5.5;2.9
82;2021-02-26;648;398;15024;7960;5.7;3.0
82;2021-02-27;214;75;15238;8035;5.8;3.1
82;2021-02-28;30;7;15268;8042;5.8;3.1
82;2021-03-01;291;230;15559;8272;5.9;3.1
82;2021-03-02;495;405;16054;8677;6.1;3.3
82;2021-03-03;440;387;16494;9064;6.3;3.5
82;2021-03-04;600;301;17094;9365;6.5;3.6
82;2021-03-05;680;382;17774;9747;6.8;3.7
82;2021-03-06;693;47;18467;9794;7.0;3.7
82;2021-03-07;302;4;18769;9798;7.1;3.7
82;2021-03-08;603;154;19372;9952;7.4;3.8
82;2021-03-09;582;256;19954;10208;7.6;3.9
82;2021-03-10;779;248;20733;10456;7.9;4.0
82;2021-03-11;977;286;21710;10742;8.3;4.1
82;2021-03-12;992;105;22702;10847;8.6;4.1
82;2021-03-13;564;54;23266;10901;8.9;4.2
82;2021-03-14;61;5;23327;10906;8.9;4.2
82;2021-03-15;485;326;23812;11232;9.1;4.3
82;2021-03-16;197;332;24009;11564;9.1;4.4
82;2021-03-17;191;294;24200;11858;9.2;4.5
82;2021-03-18;279;350;24479;12208;9.3;4.6
82;2021-03-19;531;312;25010;12520;9.5;4.8
82;2021-03-20;251;58;25261;12578;9.6;4.8
82;2021-03-21;23;0;25284;12578;9.6;4.8
82;2021-03-22;406;323;25690;12901;9.8;4.9
82;2021-03-23;601;314;26291;13215;10.0;5.0
82;2021-03-24;621;332;26912;13547;10.2;5.2
82;2021-03-25;928;246;27840;13793;10.6;5.3
82;2021-03-26;1216;272;29056;14065;11.1;5.4
82;2021-03-27;479;79;29535;14144;11.2;5.4
82;2021-03-28;136;2;29671;14146;11.3;5.4
82;2021-03-29;925;379;30596;14525;11.7;5.5
82;2021-03-30;1188;280;31784;14805;12.1;5.6
82;2021-03-31;1018;263;32802;15068;12.5;5.7
82;2021-04-01;1070;199;33872;15267;12.9;5.8
82;2021-04-02;1213;286;35085;15553;13.4;5.9
82;2021-04-03;715;132;35800;15685;13.6;6.0
82;2021-04-04;276;14;36076;15699;13.7;6.0
82;2021-04-05;388;20;36464;15719;13.9;6.0
82;2021-04-06;953;512;37417;16231;14.2;6.2
82;2021-04-07;1016;498;38433;16729;14.6;6.4
82;2021-04-08;1454;418;39887;17147;15.2;6.5
82;2021-04-09;1656;474;41543;17621;15.8;6.7
82;2021-04-10;1716;103;43259;17724;16.5;6.7
82;2021-04-11;560;20;43819;17744;16.7;6.8
82;2021-04-12;1348;294;45167;18038;17.2;6.9
82;2021-04-13;1626;275;46793;18313;17.8;7.0
82;2021-04-14;1412;302;48205;18615;18.4;7.1
82;2021-04-15;1781;325;49986;18940;19.0;7.2
82;2021-04-16;1542;336;51528;19276;19.6;7.3
82;2021-04-17;1243;71;52771;19347;20.1;7.4
82;2021-04-18;560;15;53331;19362;20.3;7.4
82;2021-04-19;958;360;54289;19722;20.7;7.5
82;2021-04-20;1267;403;55556;20125;21.2;7.7
82;2021-04-21;1217;374;56773;20499;21.6;7.8
82;2021-04-22;1452;295;58225;20794;22.2;7.9
82;2021-04-23;1076;683;59301;21477;22.6;8.2
82;2021-04-24;1188;265;60489;21742;23.0;8.3
82;2021-04-25;736;49;61225;21791;23.3;8.3
82;2021-04-26;748;810;61973;22601;23.6;8.6
82;2021-04-27;905;925;62878;23526;23.9;9.0
82;2021-04-28;921;898;63799;24424;24.3;9.3
82;2021-04-29;1107;912;64906;25336;24.7;9.6
82;2021-04-30;1042;891;65948;26227;25.1;10.0
82;2021-05-01;1143;258;67091;26485;25.5;10.1
82;2021-05-02;697;145;67788;26630;25.8;10.1
82;2021-05-03;410;1217;68198;27847;26.0;10.6
82;2021-05-04;862;1170;69060;29017;26.3;11.0
82;2021-05-05;568;1176;69628;30193;26.5;11.5
82;2021-05-06;848;1420;70476;31613;26.8;12.0
82;2021-05-07;734;1459;71210;33072;27.1;12.6
82;2021-05-08;934;520;72144;33592;27.5;12.8
82;2021-05-09;753;578;72897;34170;27.8;13.0
82;2021-05-10;850;1366;73747;35536;28.1;13.5
82;2021-05-11;1157;1348;74904;36884;28.5;14.0
82;2021-05-12;1015;1345;75919;38229;28.9;14.6
82;2021-05-13;1454;432;77373;38661;29.5;14.7
82;2021-05-14;1690;1240;79063;39901;30.1;15.2
82;2021-05-15;1934;697;80997;40598;30.8;15.5
82;2021-05-16;558;114;81555;40712;31.1;15.5
82;2021-05-17;1090;1173;82645;41885;31.5;15.9
82;2021-05-18;1465;1190;84110;43075;32.0;16.4
82;2021-05-19;1272;974;85382;44049;32.5;16.8
82;2021-05-20;1408;1160;86790;45209;33.0;17.2
82;2021-05-21;1411;1219;88201;46428;33.6;17.7
82;2021-05-22;2067;631;90268;47059;34.4;17.9
82;2021-05-23;705;117;90973;47176;34.6;18.0
82;2021-05-24;1441;265;92414;47441;35.2;18.1
82;2021-05-25;1444;963;93858;48404;35.7;18.4
82;2021-05-26;1411;919;95269;49323;36.3;18.8
82;2021-05-27;1460;1025;96729;50348;36.8;19.2
82;2021-05-28;1540;1146;98269;51494;37.4;19.6
82;2021-05-29;1496;545;99765;52039;38.0;19.8
82;2021-05-30;402;101;100167;52140;38.1;19.9
82;2021-05-31;1490;991;101657;53131;38.7;20.2
82;2021-06-01;1750;1052;103407;54183;39.4;20.6
82;2021-06-02;1477;1007;104884;55190;39.9;21.0
82;2021-06-03;1489;1184;106373;56374;40.5;21.5
82;2021-06-04;2250;1306;108623;57680;41.4;22.0
82;2021-06-05;2267;987;110890;58667;42.2;22.3
82;2021-06-06;329;133;111219;58800;42.4;22.4
82;2021-06-07;957;1275;112176;60075;42.7;22.9
82;2021-06-08;1445;1138;113621;61213;43.3;23.3
82;2021-06-09;1707;1142;115328;62355;43.9;23.7
82;2021-06-10;1441;1208;116769;63563;44.5;24.2
82;2021-06-11;1922;1128;118691;64691;45.2;24.6
82;2021-06-12;2392;1395;121083;66086;46.1;25.2
82;2021-06-13;379;113;121462;66199;46.3;25.2
82;2021-06-14;1213;1082;122675;67281;46.7;25.6
82;2021-06-15;1462;1245;124137;68526;47.3;26.1
82;2021-06-16;1749;1168;125886;69694;47.9;26.5
82;2021-06-17;1219;1472;127105;71166;48.4;27.1
82;2021-06-18;1469;1439;128574;72605;49.0;27.6
82;2021-06-19;2269;981;130843;73586;49.8;28.0
82;2021-06-20;269;173;131112;73759;49.9;28.1
82;2021-06-21;484;1361;131596;75120;50.1;28.6
82;2021-06-22;893;1710;132489;76830;50.4;29.3
82;2021-06-23;1238;1587;133727;78417;50.9;29.9
82;2021-06-24;756;1904;134483;80321;51.2;30.6
82;2021-06-25;739;1936;135222;82257;51.5;31.3
82;2021-06-26;1239;2146;136461;84403;52.0;32.1
82;2021-06-27;195;440;136656;84843;52.0;32.3
82;2021-06-28;329;1411;136985;86254;52.2;32.8
82;2021-06-29;518;1842;137503;88096;52.4;33.5
82;2021-06-30;947;1912;138450;90008;52.7;34.3
82;2021-07-01;658;1633;139108;91641;53.0;34.9
82;2021-07-02;931;2295;140039;93936;53.3;35.8
82;2021-07-03;858;2340;140897;96276;53.7;36.7
82;2021-07-04;120;439;141017;96715;53.7;36.8
82;2021-07-05;445;1561;141462;98276;53.9;37.4
82;2021-07-06;513;1867;141975;100143;54.1;38.1
82;2021-07-07;793;1775;142768;101918;54.4;38.8
82;2021-07-08;504;1504;143272;103422;54.6;39.4
82;2021-07-09;781;2155;144053;105577;54.9;40.2
82;2021-07-10;706;2218;144759;107795;55.1;41.0
82;2021-07-11;39;380;144798;108175;55.1;41.2
82;2021-07-12;578;1884;145376;110059;55.4;41.9
82;2021-07-13;714;2003;146090;112062;55.6;42.7
82;2021-07-14;617;741;146707;112803;55.9;43.0
82;2021-07-15;858;1750;147565;114553;56.2;43.6
82;2021-07-16;1436;2638;149001;117191;56.7;44.6
82;2021-07-17;560;2182;149561;119373;57.0;45.5
82;2021-07-18;14;41;149575;119414;57.0;45.5
82;2021-07-19;736;2072;150311;121486;57.2;46.3
82;2021-07-20;920;1883;151231;123369;57.6;47.0
82;2021-07-21;1289;1762;152520;125131;58.1;47.6
82;2021-07-22;1083;1766;153603;126897;58.5;48.3
82;2021-07-23;1056;2990;154659;129887;58.9;49.5
82;2021-07-24;1102;1490;155761;131377;59.3;50.0
82;2021-07-25;303;74;156064;131451;59.4;50.1
82;2021-07-26;950;1896;157014;133347;59.8;50.8
82;2021-07-27;1324;1641;158338;134988;60.3;51.4
82;2021-07-28;1469;1499;159807;136487;60.9;52.0
82;2021-07-29;1331;1534;161138;138021;61.4;52.6
82;2021-07-30;1537;2477;162675;140498;61.9;53.5
82;2021-07-31;459;296;163134;140794;62.1;53.6
82;2021-08-01;273;50;163407;140844;62.2;53.6
82;2021-08-02;1271;879;164678;141723;62.7;54.0
82;2021-08-03;1435;832;166113;142555;63.3;54.3
82;2021-08-04;1363;1029;167476;143584;63.8;54.7
82;2021-08-05;1491;600;168967;144184;64.3;54.9
82;2021-08-06;996;648;169963;144832;64.7;55.1
82;2021-08-07;923;1197;170886;146029;65.1;55.6
82;2021-08-08;157;65;171043;146094;65.1;55.6
82;2021-08-09;1071;899;172114;146993;65.5;56.0
82;2021-08-10;1289;916;173403;147909;66.0;56.3
82;2021-08-11;1264;1123;174667;149032;66.5;56.7
82;2021-08-12;1473;946;176140;149978;67.1;57.1
82;2021-08-13;1413;997;177553;150975;67.6;57.5
82;2021-08-14;314;486;177867;151461;67.7;57.7
82;2021-08-15;61;38;177928;151499;67.8;57.7
82;2021-08-16;781;1459;178709;152958;68.0;58.2
82;2021-08-17;1064;1235;179773;154193;68.5;58.7
82;2021-08-18;616;848;180389;155041;68.7;59.0
82;2021-08-19;1012;1146;181401;156187;69.1;59.5
82;2021-08-20;1034;1907;182435;158094;69.5;60.2
82;2021-08-21;495;990;182930;159084;69.7;60.6
82;2021-08-22;21;55;182951;159139;69.7;60.6
82;2021-08-23;745;1292;183696;160431;69.9;61.1
82;2021-08-24;863;1117;184559;161548;70.3;61.5
82;2021-08-25;849;1538;185408;163086;70.6;62.1
82;2021-08-26;598;1108;186006;164194;70.8;62.5
82;2021-08-27;898;1685;186904;165879;71.2;63.2
82;2021-08-28;211;616;187115;166495;71.2;63.4
82;2021-08-29;44;49;187159;166544;71.3;63.4
82;2021-08-30;430;1015;187589;167559;71.4;63.8
82;2021-08-31;339;1004;187928;168563;71.6;64.2
82;2021-09-01;721;1356;188649;169919;71.8;64.7
82;2021-09-02;406;1235;189055;171154;72.0;65.2
82;2021-09-03;500;1738;189555;172892;72.2;65.8
82;2021-09-04;426;691;189981;173583;72.3;66.1
82;2021-09-05;6;23;189987;173606;72.3;66.1
82;2021-09-06;374;1141;190361;174747;72.5;66.5
82;2021-09-07;209;880;190570;175627;72.6;66.9
82;2021-09-08;495;1169;191065;176796;72.8;67.3
82;2021-09-09;249;930;191314;177726;72.8;67.7
82;2021-09-10;487;1249;191801;178975;73.0;68.2
82;2021-09-11;212;475;192013;179450;73.1;68.3
82;2021-09-12;12;29;192025;179479;73.1;68.3
82;2021-09-13;298;850;192323;180329;73.2;68.7
82;2021-09-14;210;802;192533;181131;73.3;69.0
82;2021-09-15;307;1166;192840;182297;73.4;69.4
82;2021-09-16;220;496;193060;182793;73.5;69.6
82;2021-09-17;188;495;193248;183288;73.6;69.8
82;2021-09-18;326;1082;193574;184370;73.7;70.2
82;2021-09-19;1;14;193575;184384;73.7;70.2
82;2021-09-20;141;416;193716;184800;73.8;70.4
82;2021-09-21;94;382;193810;185182;73.8;70.5
82;2021-09-22;136;455;193946;185637;73.9;70.7
82;2021-09-23;112;383;194058;186020;73.9;70.8
82;2021-09-24;211;599;194269;186619;74.0;71.1
82;2021-09-25;231;658;194500;187277;74.1;71.3
82;2021-09-26;5;10;194505;187287;74.1;71.3
82;2021-09-27;100;453;194605;187740;74.1;71.5
82;2021-09-28;90;229;194695;187969;74.1;71.6
82;2021-09-29;231;479;194926;188448;74.2;71.8
82;2021-09-30;111;250;195037;188698;74.3;71.9
82;2021-10-01;197;372;195234;189070;74.3;72.0
82;2021-10-02;133;273;195367;189343;74.4;72.1
82;2021-10-03;4;1;195371;189344;74.4;72.1
82;2021-10-04;120;415;195491;189759;74.4;72.3
82;2021-10-05;128;273;195619;190032;74.5;72.4
82;2021-10-06;167;343;195786;190375;74.6;72.5
82;2021-10-07;62;124;195848;190499;74.6;72.5
82;2021-10-08;291;386;196139;190885;74.7;72.7
82;2021-10-09;122;247;196261;191132;74.7;72.8
82;2021-10-10;2;14;196263;191146;74.7;72.8
82;2021-10-11;93;226;196356;191372;74.8;72.9
83;2020-12-27;2;0;2;0;0.0;0.0
83;2020-12-28;0;0;2;0;0.0;0.0
83;2020-12-29;2;0;4;0;0.0;0.0
83;2020-12-30;3;0;7;0;0.0;0.0
83;2020-12-31;0;0;7;0;0.0;0.0
83;2021-01-01;1;0;8;0;0.0;0.0
83;2021-01-02;0;0;8;0;0.0;0.0
83;2021-01-03;1;0;9;0;0.0;0.0
83;2021-01-04;1;0;10;0;0.0;0.0
83;2021-01-05;4;1;14;1;0.0;0.0
83;2021-01-06;69;0;83;1;0.0;0.0
83;2021-01-07;324;0;407;1;0.0;0.0
83;2021-01-08;421;1;828;2;0.1;0.0
83;2021-01-09;48;0;876;2;0.1;0.0
83;2021-01-10;1;0;877;2;0.1;0.0
83;2021-01-11;475;0;1352;2;0.1;0.0
83;2021-01-12;1015;5;2367;7;0.2;0.0
83;2021-01-13;963;8;3330;15;0.3;0.0
83;2021-01-14;848;9;4178;24;0.4;0.0
83;2021-01-15;714;3;4892;27;0.5;0.0
83;2021-01-16;42;1;4934;28;0.5;0.0
83;2021-01-17;1;0;4935;28;0.5;0.0
83;2021-01-18;1227;4;6162;32;0.6;0.0
83;2021-01-19;2021;8;8183;40;0.8;0.0
83;2021-01-20;1660;9;9843;49;0.9;0.0
83;2021-01-21;2101;8;11944;57;1.1;0.0
83;2021-01-22;1663;8;13607;65;1.3;0.0
83;2021-01-23;246;2;13853;67;1.3;0.0
83;2021-01-24;21;1;13874;68;1.3;0.0
83;2021-01-25;1556;7;15430;75;1.4;0.0
83;2021-01-26;1758;15;17188;90;1.6;0.0
83;2021-01-27;2154;87;19342;177;1.8;0.0
83;2021-01-28;5100;392;24442;569;2.3;0.1
83;2021-01-29;2949;355;27391;924;2.6;0.1
83;2021-01-30;237;47;27628;971;2.6;0.1
83;2021-01-31;46;0;27674;971;2.6;0.1
83;2021-02-01;1283;413;28957;1384;2.7;0.1
83;2021-02-02;1441;720;30398;2104;2.8;0.2
83;2021-02-03;1527;635;31925;2739;3.0;0.3
83;2021-02-04;1485;743;33410;3482;3.1;0.3
83;2021-02-05;1227;681;34637;4163;3.2;0.4
83;2021-02-06;24;15;34661;4178;3.2;0.4
83;2021-02-07;1;0;34662;4178;3.2;0.4
83;2021-02-08;1090;622;35752;4800;3.3;0.4
83;2021-02-09;1325;911;37077;5711;3.5;0.5
83;2021-02-10;1538;803;38615;6514;3.6;0.6
83;2021-02-11;1612;1028;40227;7542;3.7;0.7
83;2021-02-12;1352;825;41579;8367;3.9;0.8
83;2021-02-13;55;26;41634;8393;3.9;0.8
83;2021-02-14;0;0;41634;8393;3.9;0.8
83;2021-02-15;677;1050;42311;9443;3.9;0.9
83;2021-02-16;543;1371;42854;10814;4.0;1.0
83;2021-02-17;805;1831;43659;12645;4.1;1.2
83;2021-02-18;1630;3872;45289;16517;4.2;1.5
83;2021-02-19;1482;2331;46771;18848;4.4;1.8
83;2021-02-20;63;169;46834;19017;4.4;1.8
83;2021-02-21;25;36;46859;19053;4.4;1.8
83;2021-02-22;507;1748;47366;20801;4.4;1.9
83;2021-02-23;673;1441;48039;22242;4.5;2.1
83;2021-02-24;726;1484;48765;23726;4.5;2.2
83;2021-02-25;1250;1410;50015;25136;4.7;2.3
83;2021-02-26;1297;1255;51312;26391;4.8;2.5
83;2021-02-27;552;56;51864;26447;4.8;2.5
83;2021-02-28;10;15;51874;26462;4.8;2.5
83;2021-03-01;808;1239;52682;27701;4.9;2.6
83;2021-03-02;992;1310;53674;29011;5.0;2.7
83;2021-03-03;1440;1528;55114;30539;5.1;2.8
83;2021-03-04;1895;1392;57009;31931;5.3;3.0
83;2021-03-05;2221;1242;59230;33173;5.5;3.1
83;2021-03-06;3010;121;62240;33294;5.8;3.1
83;2021-03-07;2227;49;64467;33343;6.0;3.1
83;2021-03-08;851;1320;65318;34663;6.1;3.2
83;2021-03-09;1938;1230;67256;35893;6.3;3.3
83;2021-03-10;2382;1374;69638;37267;6.5;3.5
83;2021-03-11;3677;2216;73315;39483;6.8;3.7
83;2021-03-12;3662;1519;76977;41002;7.2;3.8
83;2021-03-13;4614;186;81591;41188;7.6;3.8
83;2021-03-14;2341;62;83932;41250;7.8;3.8
83;2021-03-15;3339;676;87271;41926;8.1;3.9
83;2021-03-16;2603;701;89874;42627;8.4;4.0
83;2021-03-17;2846;790;92720;43417;8.6;4.0
83;2021-03-18;3549;797;96269;44214;9.0;4.1
83;2021-03-19;4175;594;100444;44808;9.4;4.2
83;2021-03-20;3476;77;103920;44885;9.7;4.2
83;2021-03-21;2011;32;105931;44917;9.9;4.2
83;2021-03-22;3965;898;109896;45815;10.2;4.3
83;2021-03-23;4751;601;114647;46416;10.7;4.3
83;2021-03-24;5048;731;119695;47147;11.1;4.4
83;2021-03-25;6536;863;126231;48010;11.8;4.5
83;2021-03-26;7176;763;133407;48773;12.4;4.5
83;2021-03-27;3969;390;137376;49163;12.8;4.6
83;2021-03-28;2183;35;139559;49198;13.0;4.6
83;2021-03-29;4557;777;144116;49975;13.4;4.7
83;2021-03-30;5969;962;150085;50937;14.0;4.7
83;2021-03-31;5554;1083;155639;52020;14.5;4.8
83;2021-04-01;5980;1272;161619;53292;15.1;5.0
83;2021-04-02;5763;1078;167382;54370;15.6;5.1
83;2021-04-03;1800;636;169182;55006;15.8;5.1
83;2021-04-04;854;348;170036;55354;15.8;5.2
83;2021-04-05;190;67;170226;55421;15.9;5.2
83;2021-04-06;4733;1412;174959;56833;16.3;5.3
83;2021-04-07;5832;1666;180791;58499;16.8;5.4
83;2021-04-08;7893;2016;188684;60515;17.6;5.6
83;2021-04-09;7599;2213;196283;62728;18.3;5.8
83;2021-04-10;2948;2657;199231;65385;18.6;6.1
83;2021-04-11;1715;2143;200946;67528;18.7;6.3
83;2021-04-12;4951;2885;205897;70413;19.2;6.6
83;2021-04-13;5408;3007;211305;73420;19.7;6.8
83;2021-04-14;5896;2954;217201;76374;20.2;7.1
83;2021-04-15;6776;3045;223977;79419;20.9;7.4
83;2021-04-16;6127;3530;230104;82949;21.4;7.7
83;2021-04-17;3510;2194;233614;85143;21.8;7.9
83;2021-04-18;2179;1301;235793;86444;22.0;8.1
83;2021-04-19;4113;3909;239906;90353;22.3;8.4
83;2021-04-20;4360;3875;244266;94228;22.7;8.8
83;2021-04-21;4300;4157;248566;98385;23.1;9.2
83;2021-04-22;5009;4309;253575;102694;23.6;9.6
83;2021-04-23;4529;4572;258104;107266;24.0;10.0
83;2021-04-24;2629;2721;260733;109987;24.3;10.2
83;2021-04-25;1925;1572;262658;111559;24.5;10.4
83;2021-04-26;3568;3856;266226;115415;24.8;10.7
83;2021-04-27;4140;4560;270366;119975;25.2;11.2
83;2021-04-28;4314;4382;274680;124357;25.6;11.6
83;2021-04-29;5823;5139;280503;129496;26.1;12.1
83;2021-04-30;5786;4316;286289;133812;26.7;12.5
83;2021-05-01;1693;431;287982;134243;26.8;12.5
83;2021-05-02;1237;760;289219;135003;26.9;12.6
83;2021-05-03;3751;4287;292970;139290;27.3;13.0
83;2021-05-04;3345;5104;296315;144394;27.6;13.4
83;2021-05-05;3644;4977;299959;149371;27.9;13.9
83;2021-05-06;4678;4966;304637;154337;28.4;14.4
83;2021-05-07;4166;5315;308803;159652;28.8;14.9
83;2021-05-08;2764;1017;311567;160669;29.0;15.0
83;2021-05-09;2151;1237;313718;161906;29.2;15.1
83;2021-05-10;3201;5428;316919;167334;29.5;15.6
83;2021-05-11;5126;5691;322045;173025;30.0;16.1
83;2021-05-12;6292;4846;328337;177871;30.6;16.6
83;2021-05-13;6582;1345;334919;179216;31.2;16.7
83;2021-05-14;7422;4117;342341;183333;31.9;17.1
83;2021-05-15;7751;2210;350092;185543;32.6;17.3
83;2021-05-16;6624;1247;356716;186790;33.2;17.4
83;2021-05-17;4894;4211;361610;191001;33.7;17.8
83;2021-05-18;5533;3865;367143;194866;34.2;18.1
83;2021-05-19;6207;3410;373350;198276;34.8;18.5
83;2021-05-20;6753;3807;380103;202083;35.4;18.8
83;2021-05-21;7904;3870;388007;205953;36.1;19.2
83;2021-05-22;6087;1720;394094;207673;36.7;19.3
83;2021-05-23;4682;713;398776;208386;37.1;19.4
83;2021-05-24;5809;973;404585;209359;37.7;19.5
83;2021-05-25;5510;4757;410095;214116;38.2;19.9
83;2021-05-26;4858;4447;414953;218563;38.6;20.4
83;2021-05-27;5069;5259;420022;223822;39.1;20.8
83;2021-05-28;4504;5760;424526;229582;39.5;21.4
83;2021-05-29;2706;4271;427232;233853;39.8;21.8
83;2021-05-30;1256;1373;428488;235226;39.9;21.9
83;2021-05-31;5486;4765;433974;239991;40.4;22.3
83;2021-06-01;5732;5308;439706;245299;40.9;22.8
83;2021-06-02;5262;4584;444968;249883;41.4;23.3
83;2021-06-03;5744;5134;450712;255017;42.0;23.7
83;2021-06-04;5444;6042;456156;261059;42.5;24.3
83;2021-06-05;3919;3198;460075;264257;42.8;24.6
83;2021-06-06;1933;1383;462008;265640;43.0;24.7
83;2021-06-07;3912;5093;465920;270733;43.4;25.2
83;2021-06-08;4175;4821;470095;275554;43.8;25.7
83;2021-06-09;4007;4704;474102;280258;44.2;26.1
83;2021-06-10;3999;4264;478101;284522;44.5;26.5
83;2021-06-11;3659;5451;481760;289973;44.9;27.0
83;2021-06-12;2913;2985;484673;292958;45.1;27.3
83;2021-06-13;995;1390;485668;294348;45.2;27.4
83;2021-06-14;2854;5656;488522;300004;45.5;27.9
83;2021-06-15;3166;4861;491688;304865;45.8;28.4
83;2021-06-16;2963;4504;494651;309369;46.1;28.8
83;2021-06-17;2785;5291;497436;314660;46.3;29.3
83;2021-06-18;3160;5965;500596;320625;46.6;29.9
83;2021-06-19;2323;4100;502919;324725;46.8;30.2
83;2021-06-20;676;1889;503595;326614;46.9;30.4
83;2021-06-21;2109;7585;505704;334199;47.1;31.1
83;2021-06-22;2103;7167;507807;341366;47.3;31.8
83;2021-06-23;1935;6929;509742;348295;47.5;32.4
83;2021-06-24;1962;7367;511704;355662;47.7;33.1
83;2021-06-25;2111;8395;513815;364057;47.8;33.9
83;2021-06-26;1462;6808;515277;370865;48.0;34.5
83;2021-06-27;692;3184;515969;374049;48.0;34.8
83;2021-06-28;1570;7882;517539;381931;48.2;35.6
83;2021-06-29;1907;7809;519446;389740;48.4;36.3
83;2021-06-30;2240;7274;521686;397014;48.6;37.0
83;2021-07-01;2562;6567;524248;403581;48.8;37.6
83;2021-07-02;2265;7798;526513;411379;49.0;38.3
83;2021-07-03;1509;5685;528022;417064;49.2;38.8
83;2021-07-04;572;2752;528594;419816;49.2;39.1
83;2021-07-05;1925;7532;530519;427348;49.4;39.8
83;2021-07-06;2571;5941;533090;433289;49.6;40.3
83;2021-07-07;2686;4667;535776;437956;49.9;40.8
83;2021-07-08;3246;4477;539022;442433;50.2;41.2
83;2021-07-09;3045;6965;542067;449398;50.5;41.8
83;2021-07-10;1579;4929;543646;454327;50.6;42.3
83;2021-07-11;1009;1766;544655;456093;50.7;42.5
83;2021-07-12;2142;7689;546797;463782;50.9;43.2
83;2021-07-13;4042;7097;550839;470879;51.3;43.9
83;2021-07-14;2094;1322;552933;472201;51.5;44.0
83;2021-07-15;4580;6844;557513;479045;51.9;44.6
83;2021-07-16;5274;7123;562787;486168;52.4;45.3
83;2021-07-17;3650;5002;566437;491170;52.7;45.7
83;2021-07-18;1604;1311;568041;492481;52.9;45.9
83;2021-07-19;3954;6320;571995;498801;53.3;46.5
83;2021-07-20;5986;6196;577981;504997;53.8;47.0
83;2021-07-21;6031;5215;584012;510212;54.4;47.5
83;2021-07-22;7118;5543;591130;515755;55.0;48.0
83;2021-07-23;7097;5919;598227;521674;55.7;48.6
83;2021-07-24;4650;4567;602877;526241;56.1;49.0
83;2021-07-25;1329;737;604206;526978;56.3;49.1
83;2021-07-26;5546;4939;609752;531917;56.8;49.5
83;2021-07-27;6833;4906;616585;536823;57.4;50.0
83;2021-07-28;6601;4427;623186;541250;58.0;50.4
83;2021-07-29;7500;4862;630686;546112;58.7;50.9
83;2021-07-30;6968;4762;637654;550874;59.4;51.3
83;2021-07-31;4667;3218;642321;554092;59.8;51.6
83;2021-08-01;1066;849;643387;554941;59.9;51.7
83;2021-08-02;5771;3711;649158;558652;60.5;52.0
83;2021-08-03;6387;3998;655545;562650;61.0;52.4
83;2021-08-04;5915;3715;661460;566365;61.6;52.7
83;2021-08-05;6183;4090;667643;570455;62.2;53.1
83;2021-08-06;6162;4917;673805;575372;62.7;53.6
83;2021-08-07;3751;3557;677556;578929;63.1;53.9
83;2021-08-08;1064;823;678620;579752;63.2;54.0
83;2021-08-09;4718;4647;683338;584399;63.6;54.4
83;2021-08-10;5236;5147;688574;589546;64.1;54.9
83;2021-08-11;4593;5068;693167;594614;64.6;55.4
83;2021-08-12;4929;5569;698096;600183;65.0;55.9
83;2021-08-13;4938;5741;703034;605924;65.5;56.4
83;2021-08-14;3223;3892;706257;609816;65.8;56.8
83;2021-08-15;208;392;706465;610208;65.8;56.8
83;2021-08-16;3632;5482;710097;615690;66.1;57.3
83;2021-08-17;3577;5272;713674;620962;66.5;57.8
83;2021-08-18;3608;5004;717282;625966;66.8;58.3
83;2021-08-19;4179;6261;721461;632227;67.2;58.9
83;2021-08-20;3644;6516;725105;638743;67.5;59.5
83;2021-08-21;2348;4490;727453;643233;67.7;59.9
83;2021-08-22;635;1033;728088;644266;67.8;60.0
83;2021-08-23;2506;5787;730594;650053;68.0;60.5
83;2021-08-24;2924;5922;733518;655975;68.3;61.1
83;2021-08-25;2585;5294;736103;661269;68.5;61.6
83;2021-08-26;2799;5845;738902;667114;68.8;62.1
83;2021-08-27;2918;5925;741820;673039;69.1;62.7
83;2021-08-28;1934;4539;743754;677578;69.3;63.1
83;2021-08-29;476;1161;744230;678739;69.3;63.2
83;2021-08-30;2383;4883;746613;683622;69.5;63.7
83;2021-08-31;2509;5295;749122;688917;69.8;64.2
83;2021-09-01;2549;4593;751671;693510;70.0;64.6
83;2021-09-02;2484;4427;754155;697937;70.2;65.0
83;2021-09-03;2336;4647;756491;702584;70.4;65.4
83;2021-09-04;1946;4376;758437;706960;70.6;65.8
83;2021-09-05;568;415;759005;707375;70.7;65.9
83;2021-09-06;1657;3335;760662;710710;70.8;66.2
83;2021-09-07;1668;3166;762330;713876;71.0;66.5
83;2021-09-08;1935;3338;764265;717214;71.2;66.8
83;2021-09-09;1493;3300;765758;720514;71.3;67.1
83;2021-09-10;1778;3617;767536;724131;71.5;67.4
83;2021-09-11;1372;3630;768908;727761;71.6;67.8
83;2021-09-12;204;458;769112;728219;71.6;67.8
83;2021-09-13;1225;2516;770337;730735;71.7;68.0
83;2021-09-14;1327;2496;771664;733231;71.9;68.3
83;2021-09-15;1369;2538;773033;735769;72.0;68.5
83;2021-09-16;1042;2176;774075;737945;72.1;68.7
83;2021-09-17;1036;2525;775111;740470;72.2;69.0
83;2021-09-18;1023;3001;776134;743471;72.3;69.2
83;2021-09-19;97;399;776231;743870;72.3;69.3
83;2021-09-20;678;2034;776909;745904;72.3;69.5
83;2021-09-21;718;1809;777627;747713;72.4;69.6
83;2021-09-22;763;2494;778390;750207;72.5;69.9
83;2021-09-23;715;2112;779105;752319;72.6;70.1
83;2021-09-24;721;2196;779826;754515;72.6;70.3
83;2021-09-25;741;2666;780567;757181;72.7;70.5
83;2021-09-26;70;449;780637;757630;72.7;70.6
83;2021-09-27;593;1730;781230;759360;72.8;70.7
83;2021-09-28;542;1503;781772;760863;72.8;70.9
83;2021-09-29;715;1879;782487;762742;72.9;71.0
83;2021-09-30;635;1505;783122;764247;72.9;71.2
83;2021-10-01;746;1533;783868;765780;73.0;71.3
83;2021-10-02;688;1621;784556;767401;73.1;71.5
83;2021-10-03;108;254;784664;767655;73.1;71.5
83;2021-10-04;480;886;785144;768541;73.1;71.6
83;2021-10-05;586;1113;785730;769654;73.2;71.7
83;2021-10-06;741;1552;786471;771206;73.2;71.8
83;2021-10-07;519;1051;786990;772257;73.3;71.9
83;2021-10-08;723;1330;787713;773587;73.4;72.0
83;2021-10-09;505;982;788218;774569;73.4;72.1
83;2021-10-10;13;37;788231;774606;73.4;72.1
83;2021-10-11;626;1124;788857;775730;73.5;72.2
84;2020-12-27;1;1;1;1;0.0;0.0
84;2020-12-28;1;1;2;2;0.0;0.0
84;2020-12-29;3;1;5;3;0.0;0.0
84;2020-12-30;2;0;7;3;0.0;0.0
84;2020-12-31;2;0;9;3;0.0;0.0
84;2021-01-01;0;0;9;3;0.0;0.0
84;2021-01-02;0;0;9;3;0.0;0.0
84;2021-01-03;0;0;9;3;0.0;0.0
84;2021-01-04;0;0;9;3;0.0;0.0
84;2021-01-05;0;0;9;3;0.0;0.0
84;2021-01-06;0;0;9;3;0.0;0.0
84;2021-01-07;69;0;78;3;0.0;0.0
84;2021-01-08;84;0;162;3;0.0;0.0
84;2021-01-09;31;1;193;4;0.0;0.0
84;2021-01-10;0;0;193;4;0.0;0.0
84;2021-01-11;219;0;412;4;0.1;0.0
84;2021-01-12;624;2;1036;6;0.2;0.0
84;2021-01-13;359;1;1395;7;0.2;0.0
84;2021-01-14;960;17;2355;24;0.4;0.0
84;2021-01-15;619;11;2974;35;0.5;0.0
84;2021-01-16;167;1;3141;36;0.6;0.0
84;2021-01-17;29;1;3170;37;0.6;0.0
84;2021-01-18;697;3;3867;40;0.7;0.0
84;2021-01-19;881;6;4748;46;0.8;0.0
84;2021-01-20;1023;6;5771;52;1.0;0.0
84;2021-01-21;1050;6;6821;58;1.2;0.0
84;2021-01-22;1135;2;7956;60;1.4;0.0
84;2021-01-23;250;0;8206;60;1.5;0.0
84;2021-01-24;3;0;8209;60;1.5;0.0
84;2021-01-25;809;4;9018;64;1.6;0.0
84;2021-01-26;940;7;9958;71;1.8;0.0
84;2021-01-27;1072;4;11030;75;2.0;0.0
84;2021-01-28;1622;19;12652;94;2.3;0.0
84;2021-01-29;1202;63;13854;157;2.5;0.0
84;2021-01-30;171;21;14025;178;2.5;0.0
84;2021-01-31;7;0;14032;178;2.5;0.0
84;2021-02-01;662;146;14694;324;2.6;0.1
84;2021-02-02;789;268;15483;592;2.8;0.1
84;2021-02-03;762;243;16245;835;2.9;0.1
84;2021-02-04;913;400;17158;1235;3.1;0.2
84;2021-02-05;727;416;17885;1651;3.2;0.3
84;2021-02-06;127;49;18012;1700;3.2;0.3
84;2021-02-07;1;0;18013;1700;3.2;0.3
84;2021-02-08;569;274;18582;1974;3.3;0.4
84;2021-02-09;694;719;19276;2693;3.4;0.5
84;2021-02-10;560;565;19836;3258;3.5;0.6
84;2021-02-11;549;590;20385;3848;3.6;0.7
84;2021-02-12;562;680;20947;4528;3.7;0.8
84;2021-02-13;48;170;20995;4698;3.7;0.8
84;2021-02-14;3;0;20998;4698;3.7;0.8
84;2021-02-15;207;887;21205;5585;3.8;1.0
84;2021-02-16;223;823;21428;6408;3.8;1.1
84;2021-02-17;448;778;21876;7186;3.9;1.3
84;2021-02-18;557;1102;22433;8288;4.0;1.5
84;2021-02-19;739;1184;23172;9472;4.1;1.7
84;2021-02-20;68;153;23240;9625;4.1;1.7
84;2021-02-21;6;37;23246;9662;4.1;1.7
84;2021-02-22;369;744;23615;10406;4.2;1.9
84;2021-02-23;272;704;23887;11110;4.3;2.0
84;2021-02-24;395;736;24282;11846;4.3;2.1
84;2021-02-25;714;862;24996;12708;4.5;2.3
84;2021-02-26;823;682;25819;13390;4.6;2.4
84;2021-02-27;133;125;25952;13515;4.6;2.4
84;2021-02-28;18;0;25970;13515;4.6;2.4
84;2021-03-01;459;666;26429;14181;4.7;2.5
84;2021-03-02;634;809;27063;14990;4.8;2.7
84;2021-03-03;820;949;27883;15939;5.0;2.8
84;2021-03-04;1100;695;28983;16634;5.2;3.0
84;2021-03-05;1313;527;30296;17161;5.4;3.1
84;2021-03-06;1459;68;31755;17229;5.7;3.1
84;2021-03-07;481;17;32236;17246;5.7;3.1
84;2021-03-08;813;612;33049;17858;5.9;3.2
84;2021-03-09;1390;785;34439;18643;6.1;3.3
84;2021-03-10;1474;674;35913;19317;6.4;3.4
84;2021-03-11;1983;649;37896;19966;6.8;3.6
84;2021-03-12;2083;638;39979;20604;7.1;3.7
84;2021-03-13;747;37;40726;20641;7.3;3.7
84;2021-03-14;247;53;40973;20694;7.3;3.7
84;2021-03-15;1073;311;42046;21005;7.5;3.7
84;2021-03-16;1180;328;43226;21333;7.7;3.8
84;2021-03-17;1147;445;44373;21778;7.9;3.9
84;2021-03-18;1458;398;45831;22176;8.2;4.0
84;2021-03-19;2179;466;48010;22642;8.6;4.0
84;2021-03-20;841;28;48851;22670;8.7;4.0
84;2021-03-21;151;11;49002;22681;8.7;4.0
84;2021-03-22;1162;468;50164;23149;8.9;4.1
84;2021-03-23;1916;439;52080;23588;9.3;4.2
84;2021-03-24;2177;405;54257;23993;9.7;4.3
84;2021-03-25;3656;406;57913;24399;10.3;4.3
84;2021-03-26;3319;489;61232;24888;10.9;4.4
84;2021-03-27;915;60;62147;24948;11.1;4.4
84;2021-03-28;74;3;62221;24951;11.1;4.4
84;2021-03-29;1717;537;63938;25488;11.4;4.5
84;2021-03-30;2674;692;66612;26180;11.9;4.7
84;2021-03-31;2405;651;69017;26831;12.3;4.8
84;2021-04-01;3021;586;72038;27417;12.8;4.9
84;2021-04-02;2452;538;74490;27955;13.3;5.0
84;2021-04-03;511;29;75001;27984;13.4;5.0
84;2021-04-04;15;2;75016;27986;13.4;5.0
84;2021-04-05;814;105;75830;28091;13.5;5.0
84;2021-04-06;2146;850;77976;28941;13.9;5.2
84;2021-04-07;2406;871;80382;29812;14.3;5.3
84;2021-04-08;3652;1052;84034;30864;15.0;5.5
84;2021-04-09;4116;957;88150;31821;15.7;5.7
84;2021-04-10;1310;135;89460;31956;15.9;5.7
84;2021-04-11;37;12;89497;31968;16.0;5.7
84;2021-04-12;2095;814;91592;32782;16.3;5.8
84;2021-04-13;2940;1374;94532;34156;16.9;6.1
84;2021-04-14;2811;1363;97343;35519;17.4;6.3
84;2021-04-15;3271;1427;100614;36946;17.9;6.6
84;2021-04-16;3432;1556;104046;38502;18.5;6.9
84;2021-04-17;1666;202;105712;38704;18.8;6.9
84;2021-04-18;38;1;105750;38705;18.9;6.9
84;2021-04-19;2507;927;108257;39632;19.3;7.1
84;2021-04-20;2628;1535;110885;41167;19.8;7.3
84;2021-04-21;2651;1491;113536;42658;20.2;7.6
84;2021-04-22;3014;1744;116550;44402;20.8;7.9
84;2021-04-23;3042;1911;119592;46313;21.3;8.3
84;2021-04-24;1530;289;121122;46602;21.6;8.3
84;2021-04-25;27;2;121149;46604;21.6;8.3
84;2021-04-26;2198;1377;123347;47981;22.0;8.6
84;2021-04-27;2556;1987;125903;49968;22.4;8.9
84;2021-04-28;2818;1856;128721;51824;22.9;9.2
84;2021-04-29;3420;2057;132141;53881;23.6;9.6
84;2021-04-30;3134;2436;135275;56317;24.1;10.0
84;2021-05-01;457;259;135732;56576;24.2;10.1
84;2021-05-02;2;0;135734;56576;24.2;10.1
84;2021-05-03;2161;1634;137895;58210;24.6;10.4
84;2021-05-04;2487;2546;140382;60756;25.0;10.8
84;2021-05-05;2354;2231;142736;62987;25.4;11.2
84;2021-05-06;3223;2264;145959;65251;26.0;11.6
84;2021-05-07;2766;2565;148725;67816;26.5;12.1
84;2021-05-08;1158;527;149883;68343;26.7;12.2
84;2021-05-09;8;53;149891;68396;26.7;12.2
84;2021-05-10;2159;2467;152050;70863;27.1;12.6
84;2021-05-11;2905;3160;154955;74023;27.6;13.2
84;2021-05-12;2849;2923;157804;76946;28.1;13.7
84;2021-05-13;2160;849;159964;77795;28.5;13.9
84;2021-05-14;2728;2039;162692;79834;29.0;14.2
84;2021-05-15;2001;987;164693;80821;29.4;14.4
84;2021-05-16;1340;188;166033;81009;29.6;14.4
84;2021-05-17;2226;2157;168259;83166;30.0;14.8
84;2021-05-18;2904;2116;171163;85282;30.5;15.2
84;2021-05-19;3230;1666;174393;86948;31.1;15.5
84;2021-05-20;3698;2209;178091;89157;31.7;15.9
84;2021-05-21;3471;2335;181562;91492;32.4;16.3
84;2021-05-22;1582;684;183144;92176;32.6;16.4
84;2021-05-23;6;9;183150;92185;32.6;16.4
84;2021-05-24;1840;426;184990;92611;33.0;16.5
84;2021-05-25;2984;2191;187974;94802;33.5;16.9
84;2021-05-26;3075;2090;191049;96892;34.1;17.3
84;2021-05-27;3857;2320;194906;99212;34.7;17.7
84;2021-05-28;3179;3309;198085;102521;35.3;18.3
84;2021-05-29;1093;1653;199178;104174;35.5;18.6
84;2021-05-30;10;85;199188;104259;35.5;18.6
84;2021-05-31;2191;2642;201379;106901;35.9;19.1
84;2021-06-01;3141;3159;204520;110060;36.5;19.6
84;2021-06-02;3170;2631;207690;112691;37.0;20.1
84;2021-06-03;4115;3001;211805;115692;37.8;20.6
84;2021-06-04;3614;3036;215419;118728;38.4;21.2
84;2021-06-05;1781;1501;217200;120229;38.7;21.4
84;2021-06-06;984;208;218184;120437;38.9;21.5
84;2021-06-07;2451;2760;220635;123197;39.3;22.0
84;2021-06-08;3317;3056;223952;126253;39.9;22.5
84;2021-06-09;3033;2689;226985;128942;40.5;23.0
84;2021-06-10;3512;2798;230497;131740;41.1;23.5
84;2021-06-11;3031;3069;233528;134809;41.6;24.0
84;2021-06-12;1965;1313;235493;136122;42.0;24.3
84;2021-06-13;413;213;235906;136335;42.1;24.3
84;2021-06-14;1930;3155;237836;139490;42.4;24.9
84;2021-06-15;2573;3454;240409;142944;42.9;25.5
84;2021-06-16;2527;2963;242936;145907;43.3;26.0
84;2021-06-17;2994;3481;245930;149388;43.8;26.6
84;2021-06-18;2424;3555;248354;152943;44.3;27.3
84;2021-06-19;1287;1552;249641;154495;44.5;27.5
84;2021-06-20;546;354;250187;154849;44.6;27.6
84;2021-06-21;1570;3135;251757;157984;44.9;28.2
84;2021-06-22;2163;4011;253920;161995;45.3;28.9
84;2021-06-23;2117;3310;256037;165305;45.6;29.5
84;2021-06-24;2201;3483;258238;168788;46.0;30.1
84;2021-06-25;1836;3889;260074;172677;46.4;30.8
84;2021-06-26;1133;1818;261207;174495;46.6;31.1
84;2021-06-27;297;345;261504;174840;46.6;31.2
84;2021-06-28;1207;3224;262711;178064;46.8;31.7
84;2021-06-29;1477;4051;264188;182115;47.1;32.5
84;2021-06-30;1716;3969;265904;186084;47.4;33.2
84;2021-07-01;1819;3957;267723;190041;47.7;33.9
84;2021-07-02;1764;3900;269487;193941;48.0;34.6
84;2021-07-03;1102;2030;270589;195971;48.2;34.9
84;2021-07-04;395;417;270984;196388;48.3;35.0
84;2021-07-05;1550;3540;272534;199928;48.6;35.6
84;2021-07-06;1638;4165;274172;204093;48.9;36.4
84;2021-07-07;1676;3103;275848;207196;49.2;36.9
84;2021-07-08;2158;3743;278006;210939;49.6;37.6
84;2021-07-09;1874;3970;279880;214909;49.9;38.3
84;2021-07-10;1253;2162;281133;217071;50.1;38.7
84;2021-07-11;354;300;281487;217371;50.2;38.7
84;2021-07-12;1409;3836;282896;221207;50.4;39.4
84;2021-07-13;2334;5010;285230;226217;50.8;40.3
84;2021-07-14;1885;1249;287115;227466;51.2;40.5
84;2021-07-15;2708;4561;289823;232027;51.7;41.4
84;2021-07-16;2778;4605;292601;236632;52.2;42.2
84;2021-07-17;1588;2449;294189;239081;52.4;42.6
84;2021-07-18;1017;552;295206;239633;52.6;42.7
84;2021-07-19;2416;3746;297622;243379;53.1;43.4
84;2021-07-20;2954;4168;300576;247547;53.6;44.1
84;2021-07-21;3187;3654;303763;251201;54.1;44.8
84;2021-07-22;3777;3791;307540;254992;54.8;45.5
84;2021-07-23;3520;3681;311060;258673;55.4;46.1
84;2021-07-24;1470;2249;312530;260922;55.7;46.5
84;2021-07-25;1033;513;313563;261435;55.9;46.6
84;2021-07-26;2725;3040;316288;264475;56.4;47.1
84;2021-07-27;3443;3569;319731;268044;57.0;47.8
84;2021-07-28;3866;3308;323597;271352;57.7;48.4
84;2021-07-29;4224;3162;327821;274514;58.4;48.9
84;2021-07-30;4027;3330;331848;277844;59.2;49.5
84;2021-07-31;2000;1694;333848;279538;59.5;49.8
84;2021-08-01;819;437;334667;279975;59.7;49.9
84;2021-08-02;2993;2696;337660;282671;60.2;50.4
84;2021-08-03;4108;2797;341768;285468;60.9;50.9
84;2021-08-04;3918;2614;345686;288082;61.6;51.4
84;2021-08-05;3888;2589;349574;290671;62.3;51.8
84;2021-08-06;3694;2867;353268;293538;63.0;52.3
84;2021-08-07;2078;1746;355346;295284;63.3;52.6
84;2021-08-08;386;735;355732;296019;63.4;52.8
84;2021-08-09;2940;2604;358672;298623;63.9;53.2
84;2021-08-10;3748;2957;362420;301580;64.6;53.8
84;2021-08-11;3269;2677;365689;304257;65.2;54.2
84;2021-08-12;3173;2976;368862;307233;65.8;54.8
84;2021-08-13;2924;2702;371786;309935;66.3;55.2
84;2021-08-14;1736;1747;373522;311682;66.6;55.6
84;2021-08-15;314;227;373836;311909;66.6;55.6
84;2021-08-16;2452;3086;376288;314995;67.1;56.1
84;2021-08-17;2736;3260;379024;318255;67.6;56.7
84;2021-08-18;2418;2800;381442;321055;68.0;57.2
84;2021-08-19;2279;3120;383721;324175;68.4;57.8
84;2021-08-20;2199;3308;385920;327483;68.8;58.4
84;2021-08-21;1228;1886;387148;329369;69.0;58.7
84;2021-08-22;167;738;387315;330107;69.0;58.8
84;2021-08-23;1777;3298;389092;333405;69.4;59.4
84;2021-08-24;1924;3468;391016;336873;69.7;60.0
84;2021-08-25;1845;3352;392861;340225;70.0;60.6
84;2021-08-26;1640;3628;394501;343853;70.3;61.3
84;2021-08-27;1631;3815;396132;347668;70.6;62.0
84;2021-08-28;921;2181;397053;349849;70.8;62.4
84;2021-08-29;174;607;397227;350456;70.8;62.5
84;2021-08-30;1391;3227;398618;353683;71.1;63.0
84;2021-08-31;1366;4079;399984;357762;71.3;63.8
84;2021-09-01;1251;3459;401235;361221;71.5;64.4
84;2021-09-02;1210;2949;402445;364170;71.7;64.9
84;2021-09-03;1282;3364;403727;367534;72.0;65.5
84;2021-09-04;779;2103;404506;369637;72.1;65.9
84;2021-09-05;127;467;404633;370104;72.1;66.0
84;2021-09-06;816;2229;405449;372333;72.3;66.4
84;2021-09-07;1027;2420;406476;374753;72.5;66.8
84;2021-09-08;912;2680;407388;377433;72.6;67.3
84;2021-09-09;889;2064;408277;379497;72.8;67.6
84;2021-09-10;942;2583;409219;382080;72.9;68.1
84;2021-09-11;591;1797;409810;383877;73.1;68.4
84;2021-09-12;117;301;409927;384178;73.1;68.5
84;2021-09-13;703;1517;410630;385695;73.2;68.8
84;2021-09-14;817;1500;411447;387195;73.3;69.0
84;2021-09-15;825;1934;412272;389129;73.5;69.4
84;2021-09-16;610;1338;412882;390467;73.6;69.6
84;2021-09-17;617;1613;413499;392080;73.7;69.9
84;2021-09-18;516;1497;414015;393577;73.8;70.2
84;2021-09-19;46;177;414061;393754;73.8;70.2
84;2021-09-20;327;891;414388;394645;73.9;70.3
84;2021-09-21;363;1114;414751;395759;73.9;70.5
84;2021-09-22;419;1589;415170;397348;74.0;70.8
84;2021-09-23;398;1116;415568;398464;74.1;71.0
84;2021-09-24;396;1250;415964;399714;74.1;71.3
84;2021-09-25;323;1246;416287;400960;74.2;71.5
84;2021-09-26;53;142;416340;401102;74.2;71.5
84;2021-09-27;313;787;416653;401889;74.3;71.6
84;2021-09-28;310;756;416963;402645;74.3;71.8
84;2021-09-29;350;1221;417313;403866;74.4;72.0
84;2021-09-30;374;919;417687;404785;74.5;72.2
84;2021-10-01;439;852;418126;405637;74.5;72.3
84;2021-10-02;247;753;418373;406390;74.6;72.4
84;2021-10-03;37;94;418410;406484;74.6;72.5
84;2021-10-04;297;549;418707;407033;74.6;72.6
84;2021-10-05;331;524;419038;407557;74.7;72.6
84;2021-10-06;345;823;419383;408380;74.8;72.8
84;2021-10-07;356;662;419739;409042;74.8;72.9
84;2021-10-08;414;775;420153;409817;74.9;73.1
84;2021-10-09;222;632;420375;410449;74.9;73.2
84;2021-10-10;28;86;420403;410535;74.9;73.2
84;2021-10-11;241;379;420644;410914;75.0;73.2
85;2020-12-27;1;0;1;0;0.0;0.0
85;2020-12-28;0;0;1;0;0.0;0.0
85;2020-12-29;0;0;1;0;0.0;0.0
85;2020-12-30;0;0;1;0;0.0;0.0
85;2020-12-31;0;0;1;0;0.0;0.0
85;2021-01-01;0;0;1;0;0.0;0.0
85;2021-01-02;0;0;1;0;0.0;0.0
85;2021-01-03;1;0;2;0;0.0;0.0
85;2021-01-04;26;0;28;0;0.0;0.0
85;2021-01-05;62;0;90;0;0.0;0.0
85;2021-01-06;107;1;197;1;0.0;0.0
85;2021-01-07;203;0;400;1;0.1;0.0
85;2021-01-08;293;2;693;3;0.1;0.0
85;2021-01-09;288;1;981;4;0.1;0.0
85;2021-01-10;59;0;1040;4;0.2;0.0
85;2021-01-11;453;0;1493;4;0.2;0.0
85;2021-01-12;584;2;2077;6;0.3;0.0
85;2021-01-13;545;2;2622;8;0.4;0.0
85;2021-01-14;685;5;3307;13;0.5;0.0
85;2021-01-15;439;3;3746;16;0.5;0.0
85;2021-01-16;263;3;4009;19;0.6;0.0
85;2021-01-17;37;0;4046;19;0.6;0.0
85;2021-01-18;999;3;5045;22;0.7;0.0
85;2021-01-19;1429;17;6474;39;0.9;0.0
85;2021-01-20;1891;5;8365;44;1.2;0.0
85;2021-01-21;3221;14;11586;58;1.7;0.0
85;2021-01-22;1700;22;13286;80;1.9;0.0
85;2021-01-23;466;1;13752;81;2.0;0.0
85;2021-01-24;50;0;13802;81;2.0;0.0
85;2021-01-25;577;1;14379;82;2.1;0.0
85;2021-01-26;878;34;15257;116;2.2;0.0
85;2021-01-27;1809;34;17066;150;2.5;0.0
85;2021-01-28;1637;45;18703;195;2.7;0.0
85;2021-01-29;875;64;19578;259;2.9;0.0
85;2021-01-30;149;5;19727;264;2.9;0.0
85;2021-01-31;2;45;19729;309;2.9;0.0
85;2021-02-01;484;103;20213;412;3.0;0.1
85;2021-02-02;535;174;20748;586;3.0;0.1
85;2021-02-03;415;259;21163;845;3.1;0.1
85;2021-02-04;623;266;21786;1111;3.2;0.2
85;2021-02-05;624;264;22410;1375;3.3;0.2
85;2021-02-06;157;244;22567;1619;3.3;0.2
85;2021-02-07;1;0;22568;1619;3.3;0.2
85;2021-02-08;390;650;22958;2269;3.4;0.3
85;2021-02-09;663;1059;23621;3328;3.5;0.5
85;2021-02-10;583;1126;24204;4454;3.5;0.7
85;2021-02-11;1524;3040;25728;7494;3.8;1.1
85;2021-02-12;1015;1264;26743;8758;3.9;1.3
85;2021-02-13;251;501;26994;9259;4.0;1.4
85;2021-02-14;2;131;26996;9390;4.0;1.4
85;2021-02-15;336;807;27332;10197;4.0;1.5
85;2021-02-16;569;1180;27901;11377;4.1;1.7
85;2021-02-17;784;1577;28685;12954;4.2;1.9
85;2021-02-18;1277;1940;29962;14894;4.4;2.2
85;2021-02-19;956;1208;30918;16102;4.5;2.4
85;2021-02-20;174;260;31092;16362;4.6;2.4
85;2021-02-21;1;11;31093;16373;4.6;2.4
85;2021-02-22;815;886;31908;17259;4.7;2.5
85;2021-02-23;826;490;32734;17749;4.8;2.6
85;2021-02-24;757;312;33491;18061;4.9;2.6
85;2021-02-25;1336;401;34827;18462;5.1;2.7
85;2021-02-26;1229;332;36056;18794;5.3;2.8
85;2021-02-27;402;103;36458;18897;5.3;2.8
85;2021-02-28;7;1;36465;18898;5.3;2.8
85;2021-03-01;766;428;37231;19326;5.4;2.8
85;2021-03-02;1100;793;38331;20119;5.6;2.9
85;2021-03-03;844;516;39175;20635;5.7;3.0
85;2021-03-04;1577;1177;40752;21812;6.0;3.2
85;2021-03-05;1741;852;42493;22664;6.2;3.3
85;2021-03-06;1227;133;43720;22797;6.4;3.3
85;2021-03-07;333;36;44053;22833;6.4;3.3
85;2021-03-08;1741;466;45794;23299;6.7;3.4
85;2021-03-09;2239;581;48033;23880;7.0;3.5
85;2021-03-10;1862;652;49895;24532;7.3;3.6
85;2021-03-11;3118;1102;53013;25634;7.8;3.8
85;2021-03-12;2730;873;55743;26507;8.2;3.9
85;2021-03-13;1372;167;57115;26674;8.4;3.9
85;2021-03-14;182;3;57297;26677;8.4;3.9
85;2021-03-15;1919;519;59216;27196;8.7;4.0
85;2021-03-16;1631;523;60847;27719;8.9;4.1
85;2021-03-17;980;528;61827;28247;9.0;4.1
85;2021-03-18;1905;459;63732;28706;9.3;4.2
85;2021-03-19;2198;375;65930;29081;9.7;4.3
85;2021-03-20;1069;179;66999;29260;9.8;4.3
85;2021-03-21;272;5;67271;29265;9.8;4.3
85;2021-03-22;1764;562;69035;29827;10.1;4.4
85;2021-03-23;2420;741;71455;30568;10.5;4.5
85;2021-03-24;2206;532;73661;31100;10.8;4.6
85;2021-03-25;3649;602;77310;31702;11.3;4.6
85;2021-03-26;3357;655;80667;32357;11.8;4.7
85;2021-03-27;1729;124;82396;32481;12.1;4.8
85;2021-03-28;540;6;82936;32487;12.1;4.8
85;2021-03-29;2414;765;85350;33252;12.5;4.9
85;2021-03-30;2866;1028;88216;34280;12.9;5.0
85;2021-03-31;2199;680;90415;34960;13.2;5.1
85;2021-04-01;3880;922;94295;35882;13.8;5.3
85;2021-04-02;2711;1113;97006;36995;14.2;5.4
85;2021-04-03;1411;323;98417;37318;14.4;5.5
85;2021-04-04;324;29;98741;37347;14.5;5.5
85;2021-04-05;104;175;98845;37522;14.5;5.5
85;2021-04-06;2196;1599;101041;39121;14.8;5.7
85;2021-04-07;3093;1197;104134;40318;15.2;5.9
85;2021-04-08;4544;1612;108678;41930;15.9;6.1
85;2021-04-09;4604;1237;113282;43167;16.6;6.3
85;2021-04-10;1866;401;115148;43568;16.9;6.4
85;2021-04-11;27;10;115175;43578;16.9;6.4
85;2021-04-12;4284;1496;119459;45074;17.5;6.6
85;2021-04-13;4837;1885;124296;46959;18.2;6.9
85;2021-04-14;3960;1016;128256;47975;18.8;7.0
85;2021-04-15;5517;1746;133773;49721;19.6;7.3
85;2021-04-16;5241;1547;139014;51268;20.3;7.5
85;2021-04-17;1382;436;140396;51704;20.6;7.6
85;2021-04-18;351;12;140747;51716;20.6;7.6
85;2021-04-19;3368;1705;144115;53421;21.1;7.8
85;2021-04-20;3694;1930;147809;55351;21.6;8.1
85;2021-04-21;2693;1694;150502;57045;22.0;8.3
85;2021-04-22;3805;2238;154307;59283;22.6;8.7
85;2021-04-23;3903;2096;158210;61379;23.2;9.0
85;2021-04-24;1663;1535;159873;62914;23.4;9.2
85;2021-04-25;981;565;160854;63479;23.5;9.3
85;2021-04-26;3589;2357;164443;65836;24.1;9.6
85;2021-04-27;4392;2169;168835;68005;24.7;10.0
85;2021-04-28;5747;1262;174582;69267;25.6;10.1
85;2021-04-29;5635;2010;180217;71277;26.4;10.4
85;2021-04-30;5573;1678;185790;72955;27.2;10.7
85;2021-05-01;1736;638;187526;73593;27.4;10.8
85;2021-05-02;873;471;188399;74064;27.6;10.8
85;2021-05-03;3494;2389;191893;76453;28.1;11.2
85;2021-05-04;3487;3088;195380;79541;28.6;11.6
85;2021-05-05;4532;2170;199912;81711;29.3;12.0
85;2021-05-06;4922;2605;204834;84316;30.0;12.3
85;2021-05-07;3933;3861;208767;88177;30.6;12.9
85;2021-05-08;2246;232;211013;88409;30.9;12.9
85;2021-05-09;1507;183;212520;88592;31.1;13.0
85;2021-05-10;3209;4925;215729;93517;31.6;13.7
85;2021-05-11;4027;4973;219756;98490;32.2;14.4
85;2021-05-12;5019;3936;224775;102426;32.9;15.0
85;2021-05-13;5144;614;229919;103040;33.7;15.1
85;2021-05-14;4356;3167;234275;106207;34.3;15.5
85;2021-05-15;2325;776;236600;106983;34.6;15.7
85;2021-05-16;2212;162;238812;107145;35.0;15.7
85;2021-05-17;4145;3376;242957;110521;35.6;16.2
85;2021-05-18;5215;2854;248172;113375;36.3;16.6
85;2021-05-19;6493;1771;254665;115146;37.3;16.9
85;2021-05-20;6773;2177;261438;117323;38.3;17.2
85;2021-05-21;5497;2742;266935;120065;39.1;17.6
85;2021-05-22;2584;754;269519;120819;39.5;17.7
85;2021-05-23;1329;161;270848;120980;39.6;17.7
85;2021-05-24;4572;436;275420;121416;40.3;17.8
85;2021-05-25;4516;3569;279936;124985;41.0;18.3
85;2021-05-26;4945;2680;284881;127665;41.7;18.7
85;2021-05-27;4959;3695;289840;131360;42.4;19.2
85;2021-05-28;5252;4064;295092;135424;43.2;19.8
85;2021-05-29;3962;1533;299054;136957;43.8;20.0
85;2021-05-30;1291;126;300345;137083;44.0;20.1
85;2021-05-31;4689;3382;305034;140465;44.6;20.6
85;2021-06-01;5405;3400;310439;143865;45.4;21.1
85;2021-06-02;5554;2522;315993;146387;46.3;21.4
85;2021-06-03;5915;3235;321908;149622;47.1;21.9
85;2021-06-04;5837;3823;327745;153445;48.0;22.5
85;2021-06-05;2848;1939;330593;155384;48.4;22.7
85;2021-06-06;1511;804;332104;156188;48.6;22.9
85;2021-06-07;3236;4860;335340;161048;49.1;23.6
85;2021-06-08;4090;4529;339430;165577;49.7;24.2
85;2021-06-09;4844;3516;344274;169093;50.4;24.8
85;2021-06-10;5199;3703;349473;172796;51.2;25.3
85;2021-06-11;4506;4664;353979;177460;51.8;26.0
85;2021-06-12;1491;1800;355470;179260;52.0;26.2
85;2021-06-13;1219;672;356689;179932;52.2;26.3
85;2021-06-14;2682;5094;359371;185026;52.6;27.1
85;2021-06-15;3715;4935;363086;189961;53.1;27.8
85;2021-06-16;4083;3908;367169;193869;53.7;28.4
85;2021-06-17;3939;3902;371108;197771;54.3;28.9
85;2021-06-18;3625;5685;374733;203456;54.9;29.8
85;2021-06-19;1213;2030;375946;205486;55.0;30.1
85;2021-06-20;140;520;376086;206006;55.0;30.2
85;2021-06-21;2375;5811;378461;211817;55.4;31.0
85;2021-06-22;2849;5733;381310;217550;55.8;31.8
85;2021-06-23;3390;4499;384700;222049;56.3;32.5
85;2021-06-24;3642;4562;388342;226611;56.8;33.2
85;2021-06-25;2289;6181;390631;232792;57.2;34.1
85;2021-06-26;791;3757;391422;236549;57.3;34.6
85;2021-06-27;125;1369;391547;237918;57.3;34.8
85;2021-06-28;1186;6713;392733;244631;57.5;35.8
85;2021-06-29;1757;6876;394490;251507;57.7;36.8
85;2021-06-30;2212;6208;396702;257715;58.1;37.7
85;2021-07-01;2842;6056;399544;263771;58.5;38.6
85;2021-07-02;2268;7015;401812;270786;58.8;39.6
85;2021-07-03;618;3165;402430;273951;58.9;40.1
85;2021-07-04;145;1086;402575;275037;58.9;40.3
85;2021-07-05;1064;6649;403639;281686;59.1;41.2
85;2021-07-06;1582;6455;405221;288141;59.3;42.2
85;2021-07-07;1649;5864;406870;294005;59.6;43.0
85;2021-07-08;2165;5440;409035;299445;59.9;43.8
85;2021-07-09;1646;7096;410681;306541;60.1;44.9
85;2021-07-10;566;2835;411247;309376;60.2;45.3
85;2021-07-11;529;1287;411776;310663;60.3;45.5
85;2021-07-12;1408;7046;413184;317709;60.5;46.5
85;2021-07-13;2059;7388;415243;325097;60.8;47.6
85;2021-07-14;1451;2047;416694;327144;61.0;47.9
85;2021-07-15;2681;6943;419375;334087;61.4;48.9
85;2021-07-16;3432;6835;422807;340922;61.9;49.9
85;2021-07-17;1565;2153;424372;343075;62.1;50.2
85;2021-07-18;1150;1154;425522;344229;62.3;50.4
85;2021-07-19;3559;6229;429081;350458;62.8;51.3
85;2021-07-20;4300;6214;433381;356672;63.4;52.2
85;2021-07-21;3996;6199;437377;362871;64.0;53.1
85;2021-07-22;3908;6189;441285;369060;64.6;54.0
85;2021-07-23;4534;6707;445819;375767;65.3;55.0
85;2021-07-24;1045;2296;446864;378063;65.4;55.3
85;2021-07-25;491;303;447355;378366;65.5;55.4
85;2021-07-26;4514;5362;451869;383728;66.1;56.2
85;2021-07-27;5321;5396;457190;389124;66.9;57.0
85;2021-07-28;4962;4972;462152;394096;67.6;57.7
85;2021-07-29;5879;4736;468031;398832;68.5;58.4
85;2021-07-30;6028;4953;474059;403785;69.4;59.1
85;2021-07-31;1226;1577;475285;405362;69.6;59.3
85;2021-08-01;470;195;475755;405557;69.6;59.4
85;2021-08-02;4950;3954;480705;409511;70.4;59.9
85;2021-08-03;6523;3355;487228;412866;71.3;60.4
85;2021-08-04;6631;3425;493859;416291;72.3;60.9
85;2021-08-05;6200;3604;500059;419895;73.2;61.5
85;2021-08-06;5810;4515;505869;424410;74.0;62.1
85;2021-08-07;1505;1179;507374;425589;74.3;62.3
85;2021-08-08;332;232;507706;425821;74.3;62.3
85;2021-08-09;4154;3276;511860;429097;74.9;62.8
85;2021-08-10;4830;3420;516690;432517;75.6;63.3
85;2021-08-11;4673;4218;521363;436735;76.3;63.9
85;2021-08-12;4473;4298;525836;441033;77.0;64.6
85;2021-08-13;3898;3648;529734;444681;77.5;65.1
85;2021-08-14;1028;1088;530762;445769;77.7;65.2
85;2021-08-15;160;237;530922;446006;77.7;65.3
85;2021-08-16;2843;4775;533765;450781;78.1;66.0
85;2021-08-17;2977;4359;536742;455140;78.6;66.6
85;2021-08-18;3155;4107;539897;459247;79.0;67.2
85;2021-08-19;2730;4279;542627;463526;79.4;67.8
85;2021-08-20;2481;5229;545108;468755;79.8;68.6
85;2021-08-21;703;1398;545811;470153;79.9;68.8
85;2021-08-22;344;1019;546155;471172;79.9;69.0
85;2021-08-23;1873;5373;548028;476545;80.2;69.8
85;2021-08-24;1825;4873;549853;481418;80.5;70.5
85;2021-08-25;1648;4834;551501;486252;80.7;71.2
85;2021-08-26;1542;4765;553043;491017;81.0;71.9
85;2021-08-27;1703;5519;554746;496536;81.2;72.7
85;2021-08-28;573;1348;555319;497884;81.3;72.9
85;2021-08-29;128;989;555447;498873;81.3;73.0
85;2021-08-30;1121;4911;556568;503784;81.5;73.7
85;2021-08-31;1132;5361;557700;509145;81.6;74.5
85;2021-09-01;1138;4992;558838;514137;81.8;75.3
85;2021-09-02;993;4146;559831;518283;81.9;75.9
85;2021-09-03;1245;4232;561076;522515;82.1;76.5
85;2021-09-04;370;1294;561446;523809;82.2;76.7
85;2021-09-05;42;168;561488;523977;82.2;76.7
85;2021-09-06;851;3389;562339;527366;82.3;77.2
85;2021-09-07;843;2867;563182;530233;82.4;77.6
85;2021-09-08;869;3377;564051;533610;82.6;78.1
85;2021-09-09;651;2541;564702;536151;82.7;78.5
85;2021-09-10;793;3305;565495;539456;82.8;79.0
85;2021-09-11;243;1303;565738;540759;82.8;79.2
85;2021-09-12;17;34;565755;540793;82.8;79.2
85;2021-09-13;546;2121;566301;542914;82.9;79.5
85;2021-09-14;549;1631;566850;544545;83.0;79.7
85;2021-09-15;610;2529;567460;547074;83.1;80.1
85;2021-09-16;400;1363;567860;548437;83.1;80.3
85;2021-09-17;738;2387;568598;550824;83.2;80.6
85;2021-09-18;190;918;568788;551742;83.3;80.8
85;2021-09-19;5;22;568793;551764;83.3;80.8
85;2021-09-20;353;1355;569146;553119;83.3;81.0
85;2021-09-21;429;1069;569575;554188;83.4;81.1
85;2021-09-22;434;1903;570009;556091;83.4;81.4
85;2021-09-23;810;983;570819;557074;83.6;81.5
85;2021-09-24;591;1929;571410;559003;83.6;81.8
85;2021-09-25;153;882;571563;559885;83.7;82.0
85;2021-09-26;0;12;571563;559897;83.7;82.0
85;2021-09-27;364;929;571927;560826;83.7;82.1
85;2021-09-28;231;565;572158;561391;83.7;82.2
85;2021-09-29;396;1288;572554;562679;83.8;82.4
85;2021-09-30;366;801;572920;563480;83.9;82.5
85;2021-10-01;422;921;573342;564401;83.9;82.6
85;2021-10-02;179;508;573521;564909;83.9;82.7
85;2021-10-03;4;12;573525;564921;83.9;82.7
85;2021-10-04;199;685;573724;565606;84.0;82.8
85;2021-10-05;294;429;574018;566035;84.0;82.9
85;2021-10-06;359;866;574377;566901;84.1;83.0
85;2021-10-07;238;392;574615;567293;84.1;83.0
85;2021-10-08;338;1018;574953;568311;84.2;83.2
85;2021-10-09;104;309;575057;568620;84.2;83.2
85;2021-10-10;14;8;575071;568628;84.2;83.2
85;2021-10-11;202;478;575273;569106;84.2;83.3
86;2020-12-27;0;0;0;0;0.0;0.0
86;2020-12-28;2;0;2;0;0.0;0.0
86;2020-12-29;1;0;3;0;0.0;0.0
86;2020-12-30;0;0;3;0;0.0;0.0
86;2020-12-31;0;0;3;0;0.0;0.0
86;2021-01-01;0;0;3;0;0.0;0.0
86;2021-01-02;1;0;4;0;0.0;0.0
86;2021-01-03;2;0;6;0;0.0;0.0
86;2021-01-04;0;0;6;0;0.0;0.0
86;2021-01-05;1;0;7;0;0.0;0.0
86;2021-01-06;178;1;185;1;0.0;0.0
86;2021-01-07;672;0;857;1;0.2;0.0
86;2021-01-08;609;3;1466;4;0.3;0.0
86;2021-01-09;0;0;1466;4;0.3;0.0
86;2021-01-10;173;0;1639;4;0.4;0.0
86;2021-01-11;305;0;1944;4;0.4;0.0
86;2021-01-12;460;1;2404;5;0.5;0.0
86;2021-01-13;337;1;2741;6;0.6;0.0
86;2021-01-14;552;1;3293;7;0.8;0.0
86;2021-01-15;544;3;3837;10;0.9;0.0
86;2021-01-16;2;0;3839;10;0.9;0.0
86;2021-01-17;0;0;3839;10;0.9;0.0
86;2021-01-18;564;0;4403;10;1.0;0.0
86;2021-01-19;1918;1;6321;11;1.4;0.0
86;2021-01-20;1464;27;7785;38;1.8;0.0
86;2021-01-21;1291;2;9076;40;2.1;0.0
86;2021-01-22;836;0;9912;40;2.3;0.0
86;2021-01-23;314;2;10226;42;2.3;0.0
86;2021-01-24;0;0;10226;42;2.3;0.0
86;2021-01-25;587;109;10813;151;2.5;0.0
86;2021-01-26;751;124;11564;275;2.6;0.1
86;2021-01-27;765;156;12329;431;2.8;0.1
86;2021-01-28;1055;426;13384;857;3.1;0.2
86;2021-01-29;880;217;14264;1074;3.3;0.2
86;2021-01-30;276;103;14540;1177;3.3;0.3
86;2021-01-31;57;157;14597;1334;3.3;0.3
86;2021-02-01;434;209;15031;1543;3.4;0.4
86;2021-02-02;573;385;15604;1928;3.6;0.4
86;2021-02-03;525;224;16129;2152;3.7;0.5
86;2021-02-04;479;366;16608;2518;3.8;0.6
86;2021-02-05;437;739;17045;3257;3.9;0.7
86;2021-02-06;148;204;17193;3461;3.9;0.8
86;2021-02-07;120;8;17313;3469;4.0;0.8
86;2021-02-08;362;327;17675;3796;4.0;0.9
86;2021-02-09;755;1121;18430;4917;4.2;1.1
86;2021-02-10;972;939;19402;5856;4.4;1.3
86;2021-02-11;1009;977;20411;6833;4.7;1.6
86;2021-02-12;746;381;21157;7214;4.8;1.6
86;2021-02-13;193;96;21350;7310;4.9;1.7
86;2021-02-14;1;34;21351;7344;4.9;1.7
86;2021-02-15;243;507;21594;7851;4.9;1.8
86;2021-02-16;384;865;21978;8716;5.0;2.0
86;2021-02-17;453;894;22431;9610;5.1;2.2
86;2021-02-18;422;871;22853;10481;5.2;2.4
86;2021-02-19;602;640;23455;11121;5.4;2.5
86;2021-02-20;115;176;23570;11297;5.4;2.6
86;2021-02-21;1;0;23571;11297;5.4;2.6
86;2021-02-22;241;426;23812;11723;5.4;2.7
86;2021-02-23;369;603;24181;12326;5.5;2.8
86;2021-02-24;410;584;24591;12910;5.6;3.0
86;2021-02-25;903;668;25494;13578;5.8;3.1
86;2021-02-26;1029;538;26523;14116;6.1;3.2
86;2021-02-27;460;150;26983;14266;6.2;3.3
86;2021-02-28;3;2;26986;14268;6.2;3.3
86;2021-03-01;232;526;27218;14794;6.2;3.4
86;2021-03-02;1142;853;28360;15647;6.5;3.6
86;2021-03-03;794;632;29154;16279;6.7;3.7
86;2021-03-04;1496;633;30650;16912;7.0;3.9
86;2021-03-05;1577;315;32227;17227;7.4;3.9
86;2021-03-06;995;169;33222;17396;7.6;4.0
86;2021-03-07;371;32;33593;17428;7.7;4.0
86;2021-03-08;473;542;34066;17970;7.8;4.1
86;2021-03-09;1368;533;35434;18503;8.1;4.2
86;2021-03-10;949;612;36383;19115;8.3;4.4
86;2021-03-11;1798;481;38181;19596;8.7;4.5
86;2021-03-12;2208;443;40389;20039;9.2;4.6
86;2021-03-13;1444;103;41833;20142;9.6;4.6
86;2021-03-14;133;16;41966;20158;9.6;4.6
86;2021-03-15;784;162;42750;20320;9.8;4.6
86;2021-03-16;847;206;43597;20526;10.0;4.7
86;2021-03-17;786;207;44383;20733;10.1;4.7
86;2021-03-18;1005;104;45388;20837;10.4;4.8
86;2021-03-19;2146;330;47534;21167;10.9;4.8
86;2021-03-20;592;133;48126;21300;11.0;4.9
86;2021-03-21;10;0;48136;21300;11.0;4.9
86;2021-03-22;852;278;48988;21578;11.2;4.9
86;2021-03-23;2017;331;51005;21909;11.7;5.0
86;2021-03-24;1557;291;52562;22200;12.0;5.1
86;2021-03-25;2489;357;55051;22557;12.6;5.2
86;2021-03-26;3044;364;58095;22921;13.3;5.2
86;2021-03-27;733;143;58828;23064;13.4;5.3
86;2021-03-28;5;128;58833;23192;13.5;5.3
86;2021-03-29;1260;391;60093;23583;13.7;5.4
86;2021-03-30;2406;826;62499;24409;14.3;5.6
86;2021-03-31;1511;630;64010;25039;14.6;5.7
86;2021-04-01;2246;949;66256;25988;15.1;5.9
86;2021-04-02;1902;560;68158;26548;15.6;6.1
86;2021-04-03;826;327;68984;26875;15.8;6.1
86;2021-04-04;83;110;69067;26985;15.8;6.2
86;2021-04-05;314;5;69381;26990;15.9;6.2
86;2021-04-06;1531;963;70912;27953;16.2;6.4
86;2021-04-07;1633;630;72545;28583;16.6;6.5
86;2021-04-08;2569;764;75114;29347;17.2;6.7
86;2021-04-09;3250;657;78364;30004;17.9;6.9
86;2021-04-10;1662;196;80026;30200;18.3;6.9
86;2021-04-11;442;11;80468;30211;18.4;6.9
86;2021-04-12;820;766;81288;30977;18.6;7.1
86;2021-04-13;2454;941;83742;31918;19.1;7.3
86;2021-04-14;1870;883;85612;32801;19.6;7.5
86;2021-04-15;2276;732;87888;33533;20.1;7.7
86;2021-04-16;2471;1232;90359;34765;20.7;7.9
86;2021-04-17;1040;264;91399;35029;20.9;8.0
86;2021-04-18;119;4;91518;35033;20.9;8.0
86;2021-04-19;745;799;92263;35832;21.1;8.2
86;2021-04-20;2301;1508;94564;37340;21.6;8.5
86;2021-04-21;2108;1128;96672;38468;22.1;8.8
86;2021-04-22;2329;1447;99001;39915;22.6;9.1
86;2021-04-23;2392;1579;101393;41494;23.2;9.5
86;2021-04-24;1299;512;102692;42006;23.5;9.6
86;2021-04-25;825;28;103517;42034;23.7;9.6
86;2021-04-26;2079;895;105596;42929;24.1;9.8
86;2021-04-27;3155;1672;108751;44601;24.9;10.2
86;2021-04-28;3002;1522;111753;46123;25.5;10.5
86;2021-04-29;3558;1835;115311;47958;26.4;11.0
86;2021-04-30;2969;1488;118280;49446;27.0;11.3
86;2021-05-01;1580;200;119860;49646;27.4;11.4
86;2021-05-02;1279;45;121139;49691;27.7;11.4
86;2021-05-03;2563;1009;123702;50700;28.3;11.6
86;2021-05-04;3508;1903;127210;52603;29.1;12.0
86;2021-05-05;3989;1488;131199;54091;30.0;12.4
86;2021-05-06;4289;1658;135488;55749;31.0;12.7
86;2021-05-07;4043;1830;139531;57579;31.9;13.2
86;2021-05-08;1976;399;141507;57978;32.4;13.3
86;2021-05-09;1642;203;143149;58181;32.7;13.3
86;2021-05-10;1958;1176;145107;59357;33.2;13.6
86;2021-05-11;3603;2688;148710;62045;34.0;14.2
86;2021-05-12;2252;1649;150962;63694;34.5;14.6
86;2021-05-13;1687;299;152649;63993;34.9;14.6
86;2021-05-14;2097;789;154746;64782;35.4;14.8
86;2021-05-15;1466;503;156212;65285;35.7;14.9
86;2021-05-16;778;164;156990;65449;35.9;15.0
86;2021-05-17;3218;1060;160208;66509;36.6;15.2
86;2021-05-18;4305;1665;164513;68174;37.6;15.6
86;2021-05-19;3587;1438;168100;69612;38.4;15.9
86;2021-05-20;4370;1625;172470;71237;39.4;16.3
86;2021-05-21;3438;1772;175908;73009;40.2;16.7
86;2021-05-22;2076;665;177984;73674;40.7;16.8
86;2021-05-23;1437;183;179421;73857;41.0;16.9
86;2021-05-24;1845;204;181266;74061;41.4;16.9
86;2021-05-25;2851;1640;184117;75701;42.1;17.3
86;2021-05-26;2725;1530;186842;77231;42.7;17.7
86;2021-05-27;3546;1851;190388;79082;43.5;18.1
86;2021-05-28;2164;2539;192552;81621;44.0;18.7
86;2021-05-29;1527;1286;194079;82907;44.4;19.0
86;2021-05-30;934;133;195013;83040;44.6;19.0
86;2021-05-31;1922;1820;196935;84860;45.0;19.4
86;2021-06-01;2665;2588;199600;87448;45.6;20.0
86;2021-06-02;2306;2664;201906;90112;46.2;20.6
86;2021-06-03;3337;2414;205243;92526;46.9;21.2
86;2021-06-04;2237;2860;207480;95386;47.4;21.8
86;2021-06-05;1503;1582;208983;96968;47.8;22.2
86;2021-06-06;820;900;209803;97868;48.0;22.4
86;2021-06-07;1119;2464;210922;100332;48.2;22.9
86;2021-06-08;1990;3698;212912;104030;48.7;23.8
86;2021-06-09;1901;3319;214813;107349;49.1;24.5
86;2021-06-10;2349;3239;217162;110588;49.6;25.3
86;2021-06-11;1517;2796;218679;113384;50.0;25.9
86;2021-06-12;746;2244;219425;115628;50.2;26.4
86;2021-06-13;214;1477;219639;117105;50.2;26.8
86;2021-06-14;1158;2902;220797;120007;50.5;27.4
86;2021-06-15;1690;4260;222487;124267;50.9;28.4
86;2021-06-16;1808;3136;224295;127403;51.3;29.1
86;2021-06-17;1777;4445;226072;131848;51.7;30.1
86;2021-06-18;1882;4586;227954;136434;52.1;31.2
86;2021-06-19;636;2097;228590;138531;52.3;31.7
86;2021-06-20;172;1319;228762;139850;52.3;32.0
86;2021-06-21;1105;2236;229867;142086;52.6;32.5
86;2021-06-22;1298;3459;231165;145545;52.9;33.3
86;2021-06-23;1364;2403;232529;147948;53.2;33.8
86;2021-06-24;1590;2725;234119;150673;53.5;34.4
86;2021-06-25;1192;3546;235311;154219;53.8;35.3
86;2021-06-26;391;2651;235702;156870;53.9;35.9
86;2021-06-27;138;1633;235840;158503;53.9;36.2
86;2021-06-28;270;3338;236110;161841;54.0;37.0
86;2021-06-29;858;4604;236968;166445;54.2;38.1
86;2021-06-30;1051;2974;238019;169419;54.4;38.7
86;2021-07-01;1549;3004;239568;172423;54.8;39.4
86;2021-07-02;1111;3643;240679;176066;55.0;40.3
86;2021-07-03;517;2393;241196;178459;55.1;40.8
86;2021-07-04;115;1346;241311;179805;55.2;41.1
86;2021-07-05;472;2833;241783;182638;55.3;41.8
86;2021-07-06;988;4108;242771;186746;55.5;42.7
86;2021-07-07;1260;2627;244031;189373;55.8;43.3
86;2021-07-08;1618;3149;245649;192522;56.2;44.0
86;2021-07-09;1746;3083;247395;195605;56.6;44.7
86;2021-07-10;1304;1954;248699;197559;56.9;45.2
86;2021-07-11;482;839;249181;198398;57.0;45.4
86;2021-07-12;848;2403;250029;200801;57.2;45.9
86;2021-07-13;1780;3369;251809;204170;57.6;46.7
86;2021-07-14;785;1232;252594;205402;57.7;47.0
86;2021-07-15;1882;3292;254476;208694;58.2;47.7
86;2021-07-16;1671;2663;256147;211357;58.6;48.3
86;2021-07-17;1351;1600;257498;212957;58.9;48.7
86;2021-07-18;381;908;257879;213865;59.0;48.9
86;2021-07-19;1377;1887;259256;215752;59.3;49.3
86;2021-07-20;2352;2736;261608;218488;59.8;50.0
86;2021-07-21;2305;2165;263913;220653;60.3;50.4
86;2021-07-22;2903;2801;266816;223454;61.0;51.1
86;2021-07-23;2466;2166;269282;225620;61.6;51.6
86;2021-07-24;1546;1226;270828;226846;61.9;51.9
86;2021-07-25;718;322;271546;227168;62.1;51.9
86;2021-07-26;1588;2103;273134;229271;62.4;52.4
86;2021-07-27;3558;2757;276692;232028;63.3;53.0
86;2021-07-28;3284;2141;279976;234169;64.0;53.5
86;2021-07-29;3266;2547;283242;236716;64.8;54.1
86;2021-07-30;2247;2379;285489;239095;65.3;54.7
86;2021-07-31;1429;1059;286918;240154;65.6;54.9
86;2021-08-01;651;338;287569;240492;65.7;55.0
86;2021-08-02;1944;1679;289513;242171;66.2;55.4
86;2021-08-03;3290;1992;292803;244163;66.9;55.8
86;2021-08-04;2739;1789;295542;245952;67.6;56.2
86;2021-08-05;3571;2057;299113;248009;68.4;56.7
86;2021-08-06;2420;1764;301533;249773;68.9;57.1
86;2021-08-07;1576;997;303109;250770;69.3;57.3
86;2021-08-08;958;553;304067;251323;69.5;57.5
86;2021-08-09;1885;1305;305952;252628;69.9;57.8
86;2021-08-10;2683;1779;308635;254407;70.6;58.2
86;2021-08-11;2366;1436;311001;255843;71.1;58.5
86;2021-08-12;2486;1834;313487;257677;71.7;58.9
86;2021-08-13;1838;1488;315325;259165;72.1;59.3
86;2021-08-14;1331;1153;316656;260318;72.4;59.5
86;2021-08-15;562;623;317218;260941;72.5;59.7
86;2021-08-16;1143;1788;318361;262729;72.8;60.1
86;2021-08-17;1559;2215;319920;264944;73.1;60.6
86;2021-08-18;1266;1861;321186;266805;73.4;61.0
86;2021-08-19;1501;2634;322687;269439;73.8;61.6
86;2021-08-20;1257;2609;323944;272048;74.1;62.2
86;2021-08-21;889;2008;324833;274056;74.3;62.7
86;2021-08-22;350;721;325183;274777;74.3;62.8
86;2021-08-23;724;1824;325907;276601;74.5;63.2
86;2021-08-24;1081;2752;326988;279353;74.8;63.9
86;2021-08-25;935;2064;327923;281417;75.0;64.3
86;2021-08-26;919;2813;328842;284230;75.2;65.0
86;2021-08-27;862;2174;329704;286404;75.4;65.5
86;2021-08-28;556;1775;330260;288179;75.5;65.9
86;2021-08-29;114;828;330374;289007;75.5;66.1
86;2021-08-30;686;2101;331060;291108;75.7;66.6
86;2021-08-31;960;3156;332020;294264;75.9;67.3
86;2021-09-01;571;2583;332591;296847;76.0;67.9
86;2021-09-02;757;2610;333348;299457;76.2;68.5
86;2021-09-03;758;2251;334106;301708;76.4;69.0
86;2021-09-04;366;2127;334472;303835;76.5;69.5
86;2021-09-05;27;909;334499;304744;76.5;69.7
86;2021-09-06;359;1571;334858;306315;76.6;70.0
86;2021-09-07;510;1995;335368;308310;76.7;70.5
86;2021-09-08;566;2109;335934;310419;76.8;71.0
86;2021-09-09;577;1784;336511;312203;76.9;71.4
86;2021-09-10;525;1819;337036;314022;77.1;71.8
86;2021-09-11;358;1832;337394;315854;77.1;72.2
86;2021-09-12;102;764;337496;316618;77.2;72.4
86;2021-09-13;324;984;337820;317602;77.2;72.6
86;2021-09-14;407;1359;338227;318961;77.3;72.9
86;2021-09-15;474;1556;338701;320517;77.4;73.3
86;2021-09-16;437;1011;339138;321528;77.5;73.5
86;2021-09-17;490;1061;339628;322589;77.6;73.8
86;2021-09-18;294;1271;339922;323860;77.7;74.0
86;2021-09-19;85;415;340007;324275;77.7;74.1
86;2021-09-20;223;641;340230;324916;77.8;74.3
86;2021-09-21;266;826;340496;325742;77.8;74.5
86;2021-09-22;337;1185;340833;326927;77.9;74.7
86;2021-09-23;354;581;341187;327508;78.0;74.9
86;2021-09-24;309;841;341496;328349;78.1;75.1
86;2021-09-25;289;1063;341785;329412;78.1;75.3
86;2021-09-26;45;166;341830;329578;78.2;75.3
86;2021-09-27;160;359;341990;329937;78.2;75.4
86;2021-09-28;239;368;342229;330305;78.2;75.5
86;2021-09-29;229;686;342458;330991;78.3;75.7
86;2021-09-30;255;496;342713;331487;78.4;75.8
86;2021-10-01;258;524;342971;332011;78.4;75.9
86;2021-10-02;279;578;343250;332589;78.5;76.0
86;2021-10-03;19;73;343269;332662;78.5;76.1
86;2021-10-04;97;319;343366;332981;78.5;76.1
86;2021-10-05;130;275;343496;333256;78.5;76.2
86;2021-10-06;183;451;343679;333707;78.6;76.3
86;2021-10-07;188;448;343867;334155;78.6;76.4
86;2021-10-08;201;483;344068;334638;78.7;76.5
86;2021-10-09;230;450;344298;335088;78.7;76.6
86;2021-10-10;2;5;344300;335093;78.7;76.6
86;2021-10-11;144;301;344444;335394;78.7;76.7
87;2020-12-27;0;0;0;0;0.0;0.0
87;2020-12-28;3;2;3;2;0.0;0.0
87;2020-12-29;0;0;3;2;0.0;0.0
87;2020-12-30;0;0;3;2;0.0;0.0
87;2020-12-31;0;0;3;2;0.0;0.0
87;2021-01-01;0;0;3;2;0.0;0.0
87;2021-01-02;0;0;3;2;0.0;0.0
87;2021-01-03;0;0;3;2;0.0;0.0
87;2021-01-04;2;1;5;3;0.0;0.0
87;2021-01-05;1;0;6;3;0.0;0.0
87;2021-01-06;10;0;16;3;0.0;0.0
87;2021-01-07;301;1;317;4;0.1;0.0
87;2021-01-08;407;0;724;4;0.2;0.0
87;2021-01-09;65;0;789;4;0.2;0.0
87;2021-01-10;35;0;824;4;0.2;0.0
87;2021-01-11;424;0;1248;4;0.3;0.0
87;2021-01-12;654;0;1902;4;0.5;0.0
87;2021-01-13;660;3;2562;7;0.7;0.0
87;2021-01-14;517;11;3079;18;0.8;0.0
87;2021-01-15;534;3;3613;21;1.0;0.0
87;2021-01-16;204;1;3817;22;1.0;0.0
87;2021-01-17;1;0;3818;22;1.0;0.0
87;2021-01-18;645;6;4463;28;1.2;0.0
87;2021-01-19;657;1;5120;29;1.4;0.0
87;2021-01-20;674;4;5794;33;1.6;0.0
87;2021-01-21;717;2;6511;35;1.8;0.0
87;2021-01-22;757;4;7268;39;2.0;0.0
87;2021-01-23;287;1;7555;40;2.0;0.0
87;2021-01-24;1;0;7556;40;2.0;0.0
87;2021-01-25;620;10;8176;50;2.2;0.0
87;2021-01-26;570;52;8746;102;2.4;0.0
87;2021-01-27;572;40;9318;142;2.5;0.0
87;2021-01-28;856;110;10174;252;2.7;0.1
87;2021-01-29;741;273;10915;525;2.9;0.1
87;2021-01-30;325;72;11240;597;3.0;0.2
87;2021-01-31;34;71;11274;668;3.0;0.2
87;2021-02-01;413;309;11687;977;3.2;0.3
87;2021-02-02;452;482;12139;1459;3.3;0.4
87;2021-02-03;540;420;12679;1879;3.4;0.5
87;2021-02-04;613;595;13292;2474;3.6;0.7
87;2021-02-05;344;382;13636;2856;3.7;0.8
87;2021-02-06;55;156;13691;3012;3.7;0.8
87;2021-02-07;20;0;13711;3012;3.7;0.8
87;2021-02-08;246;444;13957;3456;3.8;0.9
87;2021-02-09;219;541;14176;3997;3.8;1.1
87;2021-02-10;262;623;14438;4620;3.9;1.2
87;2021-02-11;286;539;14724;5159;4.0;1.4
87;2021-02-12;287;556;15011;5715;4.0;1.5
87;2021-02-13;25;170;15036;5885;4.1;1.6
87;2021-02-14;0;3;15036;5888;4.1;1.6
87;2021-02-15;237;388;15273;6276;4.1;1.7
87;2021-02-16;332;330;15605;6606;4.2;1.8
87;2021-02-17;329;379;15934;6985;4.3;1.9
87;2021-02-18;478;646;16412;7631;4.4;2.1
87;2021-02-19;406;481;16818;8112;4.5;2.2
87;2021-02-20;124;195;16942;8307;4.6;2.2
87;2021-02-21;2;9;16944;8316;4.6;2.2
87;2021-02-22;440;576;17384;8892;4.7;2.4
87;2021-02-23;557;636;17941;9528;4.8;2.6
87;2021-02-24;451;598;18392;10126;5.0;2.7
87;2021-02-25;790;709;19182;10835;5.2;2.9
87;2021-02-26;842;480;20024;11315;5.4;3.1
87;2021-02-27;405;212;20429;11527;5.5;3.1
87;2021-02-28;3;0;20432;11527;5.5;3.1
87;2021-03-01;518;370;20950;11897;5.7;3.2
87;2021-03-02;1031;392;21981;12289;5.9;3.3
87;2021-03-03;1174;353;23155;12642;6.2;3.4
87;2021-03-04;1406;341;24561;12983;6.6;3.5
87;2021-03-05;1770;287;26331;13270;7.1;3.6
87;2021-03-06;1049;42;27380;13312;7.4;3.6
87;2021-03-07;257;6;27637;13318;7.5;3.6
87;2021-03-08;863;247;28500;13565;7.7;3.7
87;2021-03-09;1287;237;29787;13802;8.0;3.7
87;2021-03-10;1299;237;31086;14039;8.4;3.8
87;2021-03-11;1756;257;32842;14296;8.9;3.9
87;2021-03-12;2129;293;34971;14589;9.4;3.9
87;2021-03-13;1309;22;36280;14611;9.8;3.9
87;2021-03-14;80;1;36360;14612;9.8;3.9
87;2021-03-15;987;358;37347;14970;10.1;4.0
87;2021-03-16;1060;244;38407;15214;10.4;4.1
87;2021-03-17;1070;221;39477;15435;10.6;4.2
87;2021-03-18;1186;349;40663;15784;11.0;4.3
87;2021-03-19;1684;283;42347;16067;11.4;4.3
87;2021-03-20;926;92;43273;16159;11.7;4.4
87;2021-03-21;32;0;43305;16159;11.7;4.4
87;2021-03-22;1048;384;44353;16543;12.0;4.5
87;2021-03-23;1386;432;45739;16975;12.3;4.6
87;2021-03-24;1508;367;47247;17342;12.7;4.7
87;2021-03-25;2500;399;49747;17741;13.4;4.8
87;2021-03-26;2532;460;52279;18201;14.1;4.9
87;2021-03-27;891;126;53170;18327;14.3;4.9
87;2021-03-28;270;18;53440;18345;14.4;4.9
87;2021-03-29;1119;418;54559;18763;14.7;5.1
87;2021-03-30;1907;669;56466;19432;15.2;5.2
87;2021-03-31;1660;697;58126;20129;15.7;5.4
87;2021-04-01;2237;574;60363;20703;16.3;5.6
87;2021-04-02;1843;636;62206;21339;16.8;5.8
87;2021-04-03;455;266;62661;21605;16.9;5.8
87;2021-04-04;2;0;62663;21605;16.9;5.8
87;2021-04-05;82;1;62745;21606;16.9;5.8
87;2021-04-06;1005;911;63750;22517;17.2;6.1
87;2021-04-07;1487;927;65237;23444;17.6;6.3
87;2021-04-08;1785;1035;67022;24479;18.1;6.6
87;2021-04-09;2647;743;69669;25222;18.8;6.8
87;2021-04-10;1189;307;70858;25529;19.1;6.9
87;2021-04-11;69;1;70927;25530;19.1;6.9
87;2021-04-12;1619;830;72546;26360;19.6;7.1
87;2021-04-13;2288;1065;74834;27425;20.2;7.4
87;2021-04-14;2529;1192;77363;28617;20.9;7.7
87;2021-04-15;2223;1078;79586;29695;21.5;8.0
87;2021-04-16;2735;1071;82321;30766;22.2;8.3
87;2021-04-17;731;389;83052;31155;22.4;8.4
87;2021-04-18;111;141;83163;31296;22.4;8.4
87;2021-04-19;1662;839;84825;32135;22.9;8.7
87;2021-04-20;2084;885;86909;33020;23.4;8.9
87;2021-04-21;2295;996;89204;34016;24.1;9.2
87;2021-04-22;2564;1167;91768;35183;24.8;9.5
87;2021-04-23;1997;1184;93765;36367;25.3;9.8
87;2021-04-24;824;621;94589;36988;25.5;10.0
87;2021-04-25;66;103;94655;37091;25.5;10.0
87;2021-04-26;1356;916;96011;38007;25.9;10.3
87;2021-04-27;2398;1206;98409;39213;26.5;10.6
87;2021-04-28;3867;1445;102276;40658;27.6;11.0
87;2021-04-29;3078;1845;105354;42503;28.4;11.5
87;2021-04-30;3172;1363;108526;43866;29.3;11.8
87;2021-05-01;614;61;109140;43927;29.4;11.8
87;2021-05-02;361;5;109501;43932;29.5;11.8
87;2021-05-03;2323;940;111824;44872;30.2;12.1
87;2021-05-04;2902;1074;114726;45946;30.9;12.4
87;2021-05-05;2989;1511;117715;47457;31.7;12.8
87;2021-05-06;2531;1725;120246;49182;32.4;13.3
87;2021-05-07;2945;1725;123191;50907;33.2;13.7
87;2021-05-08;772;295;123963;51202;33.4;13.8
87;2021-05-09;18;133;123981;51335;33.4;13.8
87;2021-05-10;1938;1602;125919;52937;34.0;14.3
87;2021-05-11;2465;1908;128384;54845;34.6;14.8
87;2021-05-12;2623;2066;131007;56911;35.3;15.3
87;2021-05-13;1085;293;132092;57204;35.6;15.4
87;2021-05-14;2245;1775;134337;58979;36.2;15.9
87;2021-05-15;950;409;135287;59388;36.5;16.0
87;2021-05-16;141;73;135428;59461;36.5;16.0
87;2021-05-17;1628;1762;137056;61223;37.0;16.5
87;2021-05-18;2632;1821;139688;63044;37.7;17.0
87;2021-05-19;2822;1553;142510;64597;38.4;17.4
87;2021-05-20;3302;1724;145812;66321;39.3;17.9
87;2021-05-21;2764;1843;148576;68164;40.1;18.4
87;2021-05-22;1457;629;150033;68793;40.5;18.6
87;2021-05-23;211;92;150244;68885;40.5;18.6
87;2021-05-24;1055;143;151299;69028;40.8;18.6
87;2021-05-25;2117;1811;153416;70839;41.4;19.1
87;2021-05-26;3219;2478;156635;73317;42.2;19.8
87;2021-05-27;3022;2357;159657;75674;43.1;20.4
87;2021-05-28;2675;2522;162332;78196;43.8;21.1
87;2021-05-29;1061;1313;163393;79509;44.1;21.4
87;2021-05-30;258;60;163651;79569;44.1;21.5
87;2021-05-31;2287;1361;165938;80930;44.8;21.8
87;2021-06-01;2547;1865;168485;82795;45.4;22.3
87;2021-06-02;2525;1857;171010;84652;46.1;22.8
87;2021-06-03;3212;2529;174222;87181;47.0;23.5
87;2021-06-04;2838;2063;177060;89244;47.8;24.1
87;2021-06-05;1310;574;178370;89818;48.1;24.2
87;2021-06-06;261;95;178631;89913;48.2;24.3
87;2021-06-07;2098;1900;180729;91813;48.7;24.8
87;2021-06-08;2958;2603;183687;94416;49.5;25.5
87;2021-06-09;2303;2812;185990;97228;50.2;26.2
87;2021-06-10;2974;2552;188964;99780;51.0;26.9
87;2021-06-11;2363;3075;191327;102855;51.6;27.7
87;2021-06-12;1219;1103;192546;103958;51.9;28.0
87;2021-06-13;294;485;192840;104443;52.0;28.2
87;2021-06-14;980;2729;193820;107172;52.3;28.9
87;2021-06-15;1362;3318;195182;110490;52.6;29.8
87;2021-06-16;1650;3424;196832;113914;53.1;30.7
87;2021-06-17;2438;2314;199270;116228;53.7;31.3
87;2021-06-18;1791;3019;201061;119247;54.2;32.2
87;2021-06-19;1047;1177;202108;120424;54.5;32.5
87;2021-06-20;205;206;202313;120630;54.6;32.5
87;2021-06-21;1040;2647;203353;123277;54.8;33.2
87;2021-06-22;1029;2880;204382;126157;55.1;34.0
87;2021-06-23;1256;3081;205638;129238;55.5;34.9
87;2021-06-24;1616;2561;207254;131799;55.9;35.5
87;2021-06-25;1448;2710;208702;134509;56.3;36.3
87;2021-06-26;529;1201;209231;135710;56.4;36.6
87;2021-06-27;26;212;209257;135922;56.4;36.7
87;2021-06-28;717;2575;209974;138497;56.6;37.4
87;2021-06-29;1156;3417;211130;141914;56.9;38.3
87;2021-06-30;1125;2652;212255;144566;57.2;39.0
87;2021-07-01;1482;2552;213737;147118;57.6;39.7
87;2021-07-02;1204;3463;214941;150581;58.0;40.6
87;2021-07-03;415;1512;215356;152093;58.1;41.0
87;2021-07-04;24;384;215380;152477;58.1;41.1
87;2021-07-05;685;2393;216065;154870;58.3;41.8
87;2021-07-06;583;3220;216648;158090;58.4;42.6
87;2021-07-07;862;3344;217510;161434;58.7;43.5
87;2021-07-08;1119;3671;218629;165105;59.0;44.5
87;2021-07-09;1113;3702;219742;168807;59.3;45.5
87;2021-07-10;290;1360;220032;170167;59.3;45.9
87;2021-07-11;49;284;220081;170451;59.4;46.0
87;2021-07-12;559;3192;220640;173643;59.5;46.8
87;2021-07-13;833;3513;221473;177156;59.7;47.8
87;2021-07-14;517;538;221990;177694;59.9;47.9
87;2021-07-15;1361;3463;223351;181157;60.2;48.9
87;2021-07-16;1731;3597;225082;184754;60.7;49.8
87;2021-07-17;655;1373;225737;186127;60.9;50.2
87;2021-07-18;81;285;225818;186412;60.9;50.3
87;2021-07-19;1434;3400;227252;189812;61.3;51.2
87;2021-07-20;1805;3591;229057;193403;61.8;52.2
87;2021-07-21;1451;3153;230508;196556;62.2;53.0
87;2021-07-22;1877;3251;232385;199807;62.7;53.9
87;2021-07-23;1875;3172;234260;202979;63.2;54.7
87;2021-07-24;816;1284;235076;204263;63.4;55.1
87;2021-07-25;106;241;235182;204504;63.4;55.2
87;2021-07-26;1541;2329;236723;206833;63.8;55.8
87;2021-07-27;2556;2063;239279;208896;64.5;56.3
87;2021-07-28;2390;2007;241669;210903;65.2;56.9
87;2021-07-29;3011;1999;244680;212902;66.0;57.4
87;2021-07-30;2543;2077;247223;214979;66.7;58.0
87;2021-07-31;1103;837;248326;215816;67.0;58.2
87;2021-08-01;283;151;248609;215967;67.1;58.2
87;2021-08-02;2119;1520;250728;217487;67.6;58.7
87;2021-08-03;2496;1331;253224;218818;68.3;59.0
87;2021-08-04;2314;1063;255538;219881;68.9;59.3
87;2021-08-05;2528;1414;258066;221295;69.6;59.7
87;2021-08-06;2144;1659;260210;222954;70.2;60.1
87;2021-08-07;1110;783;261320;223737;70.5;60.3
87;2021-08-08;208;125;261528;223862;70.5;60.4
87;2021-08-09;1818;1526;263346;225388;71.0;60.8
87;2021-08-10;2201;1533;265547;226921;71.6;61.2
87;2021-08-11;1912;1273;267459;228194;72.1;61.5
87;2021-08-12;2106;1481;269565;229675;72.7;61.9
87;2021-08-13;1724;1621;271289;231296;73.2;62.4
87;2021-08-14;671;733;271960;232029;73.3;62.6
87;2021-08-15;72;104;272032;232133;73.4;62.6
87;2021-08-16;1505;1739;273537;233872;73.8;63.1
87;2021-08-17;1354;1669;274891;235541;74.1;63.5
87;2021-08-18;1246;1998;276137;237539;74.5;64.1
87;2021-08-19;1223;1798;277360;239337;74.8;64.6
87;2021-08-20;917;2207;278277;241544;75.1;65.1
87;2021-08-21;318;966;278595;242510;75.1;65.4
87;2021-08-22;92;235;278687;242745;75.2;65.5
87;2021-08-23;746;2393;279433;245138;75.4;66.1
87;2021-08-24;765;2135;280198;247273;75.6;66.7
87;2021-08-25;710;2062;280908;249335;75.8;67.2
87;2021-08-26;860;2156;281768;251491;76.0;67.8
87;2021-08-27;790;2668;282558;254159;76.2;68.5
87;2021-08-28;331;1300;282889;255459;76.3;68.9
87;2021-08-29;65;244;282954;255703;76.3;69.0
87;2021-08-30;472;2197;283426;257900;76.4;69.6
87;2021-08-31;608;1902;284034;259802;76.6;70.1
87;2021-09-01;750;2351;284784;262153;76.8;70.7
87;2021-09-02;557;2137;285341;264290;77.0;71.3
87;2021-09-03;650;2150;285991;266440;77.1;71.9
87;2021-09-04;277;1065;286268;267505;77.2;72.1
87;2021-09-05;9;6;286277;267511;77.2;72.1
87;2021-09-06;396;1601;286673;269112;77.3;72.6
87;2021-09-07;386;1241;287059;270353;77.4;72.9
87;2021-09-08;460;1467;287519;271820;77.5;73.3
87;2021-09-09;326;965;287845;272785;77.6;73.6
87;2021-09-10;466;1378;288311;274163;77.8;73.9
87;2021-09-11;320;894;288631;275057;77.8;74.2
87;2021-09-12;3;13;288634;275070;77.8;74.2
87;2021-09-13;311;764;288945;275834;77.9;74.4
87;2021-09-14;286;619;289231;276453;78.0;74.6
87;2021-09-15;367;964;289598;277417;78.1;74.8
87;2021-09-16;348;789;289946;278206;78.2;75.0
87;2021-09-17;408;885;290354;279091;78.3;75.3
87;2021-09-18;286;728;290640;279819;78.4;75.5
87;2021-09-19;4;14;290644;279833;78.4;75.5
87;2021-09-20;204;465;290848;280298;78.4;75.6
87;2021-09-21;261;508;291109;280806;78.5;75.7
87;2021-09-22;235;758;291344;281564;78.6;75.9
87;2021-09-23;218;529;291562;282093;78.6;76.1
87;2021-09-24;293;740;291855;282833;78.7;76.3
87;2021-09-25;167;511;292022;283344;78.8;76.4
87;2021-09-26;2;5;292024;283349;78.8;76.4
87;2021-09-27;195;402;292219;283751;78.8;76.5
87;2021-09-28;204;322;292423;284073;78.9;76.6
87;2021-09-29;172;399;292595;284472;78.9;76.7
87;2021-09-30;140;268;292735;284740;79.0;76.8
87;2021-10-01;205;513;292940;285253;79.0;76.9
87;2021-10-02;156;399;293096;285652;79.0;77.0
87;2021-10-03;3;3;293099;285655;79.1;77.0
87;2021-10-04;152;290;293251;285945;79.1;77.1
87;2021-10-05;112;212;293363;286157;79.1;77.2
87;2021-10-06;197;413;293560;286570;79.2;77.3
87;2021-10-07;110;259;293670;286829;79.2;77.4
87;2021-10-08;228;476;293898;287305;79.3;77.5
87;2021-10-09;177;353;294075;287658;79.3;77.6
87;2021-10-10;4;4;294079;287662;79.3;77.6
87;2021-10-11;135;267;294214;287929;79.4;77.7
88;2020-12-27;0;0;0;0;0.0;0.0
88;2020-12-28;0;0;0;0;0.0;0.0
88;2020-12-29;0;0;0;0;0.0;0.0
88;2020-12-30;0;0;0;0;0.0;0.0
88;2020-12-31;0;0;0;0;0.0;0.0
88;2021-01-01;2;0;2;0;0.0;0.0
88;2021-01-02;0;0;2;0;0.0;0.0
88;2021-01-03;0;0;2;0;0.0;0.0
88;2021-01-04;0;0;2;0;0.0;0.0
88;2021-01-05;1;0;3;0;0.0;0.0
88;2021-01-06;3;0;6;0;0.0;0.0
88;2021-01-07;71;1;77;1;0.0;0.0
88;2021-01-08;189;2;266;3;0.1;0.0
88;2021-01-09;190;3;456;6;0.1;0.0
88;2021-01-10;0;0;456;6;0.1;0.0
88;2021-01-11;227;0;683;6;0.2;0.0
88;2021-01-12;422;0;1105;6;0.3;0.0
88;2021-01-13;491;2;1596;8;0.4;0.0
88;2021-01-14;347;3;1943;11;0.5;0.0
88;2021-01-15;380;3;2323;14;0.6;0.0
88;2021-01-16;62;0;2385;14;0.7;0.0
88;2021-01-17;1;0;2386;14;0.7;0.0
88;2021-01-18;461;0;2847;14;0.8;0.0
88;2021-01-19;451;0;3298;14;0.9;0.0
88;2021-01-20;462;2;3760;16;1.0;0.0
88;2021-01-21;1547;6;5307;22;1.5;0.0
88;2021-01-22;1182;2;6489;24;1.8;0.0
88;2021-01-23;285;0;6774;24;1.9;0.0
88;2021-01-24;298;2;7072;26;2.0;0.0
88;2021-01-25;937;4;8009;30;2.2;0.0
88;2021-01-26;388;5;8397;35;2.3;0.0
88;2021-01-27;4;0;8401;35;2.3;0.0
88;2021-01-28;162;38;8563;73;2.4;0.0
88;2021-01-29;527;160;9090;233;2.5;0.1
88;2021-01-30;288;128;9378;361;2.6;0.1
88;2021-01-31;0;0;9378;361;2.6;0.1
88;2021-02-01;406;281;9784;642;2.7;0.2
88;2021-02-02;333;364;10117;1006;2.8;0.3
88;2021-02-03;437;241;10554;1247;2.9;0.3
88;2021-02-04;315;229;10869;1476;3.0;0.4
88;2021-02-05;457;252;11326;1728;3.2;0.5
88;2021-02-06;110;56;11436;1784;3.2;0.5
88;2021-02-07;0;0;11436;1784;3.2;0.5
88;2021-02-08;360;203;11796;1987;3.3;0.6
88;2021-02-09;291;288;12087;2275;3.4;0.6
88;2021-02-10;416;344;12503;2619;3.5;0.7
88;2021-02-11;850;1094;13353;3713;3.7;1.0
88;2021-02-12;939;707;14292;4420;4.0;1.2
88;2021-02-13;162;211;14454;4631;4.0;1.3
88;2021-02-14;81;216;14535;4847;4.0;1.3
88;2021-02-15;639;1076;15174;5923;4.2;1.6
88;2021-02-16;472;723;15646;6646;4.4;1.8
88;2021-02-17;455;437;16101;7083;4.5;2.0
88;2021-02-18;516;385;16617;7468;4.6;2.1
88;2021-02-19;536;462;17153;7930;4.8;2.2
88;2021-02-20;156;101;17309;8031;4.8;2.2
88;2021-02-21;1;25;17310;8056;4.8;2.2
88;2021-02-22;425;342;17735;8398;4.9;2.3
88;2021-02-23;403;233;18138;8631;5.0;2.4
88;2021-02-24;505;210;18643;8841;5.2;2.5
88;2021-02-25;674;286;19317;9127;5.4;2.5
88;2021-02-26;863;277;20180;9404;5.6;2.6
88;2021-02-27;269;34;20449;9438;5.7;2.6
88;2021-02-28;30;1;20479;9439;5.7;2.6
88;2021-03-01;358;463;20837;9902;5.8;2.8
88;2021-03-02;431;498;21268;10400;5.9;2.9
88;2021-03-03;650;466;21918;10866;6.1;3.0
88;2021-03-04;1045;768;22963;11634;6.4;3.2
88;2021-03-05;933;706;23896;12340;6.6;3.4
88;2021-03-06;1873;119;25769;12459;7.2;3.5
88;2021-03-07;1060;82;26829;12541;7.5;3.5
88;2021-03-08;726;692;27555;13233;7.7;3.7
88;2021-03-09;1095;541;28650;13774;8.0;3.8
88;2021-03-10;1083;498;29733;14272;8.3;4.0
88;2021-03-11;1441;404;31174;14676;8.7;4.1
88;2021-03-12;1309;490;32483;15166;9.0;4.2
88;2021-03-13;1210;131;33693;15297;9.4;4.3
88;2021-03-14;166;5;33859;15302;9.4;4.3
88;2021-03-15;928;447;34787;15749;9.7;4.4
88;2021-03-16;1023;345;35810;16094;10.0;4.5
88;2021-03-17;905;425;36715;16519;10.2;4.6
88;2021-03-18;1303;405;38018;16924;10.6;4.7
88;2021-03-19;1465;507;39483;17431;11.0;4.8
88;2021-03-20;1319;57;40802;17488;11.3;4.9
88;2021-03-21;37;0;40839;17488;11.4;4.9
88;2021-03-22;1233;546;42072;18034;11.7;5.0
88;2021-03-23;1780;448;43852;18482;12.2;5.1
88;2021-03-24;1877;474;45729;18956;12.7;5.3
88;2021-03-25;2497;497;48226;19453;13.4;5.4
88;2021-03-26;2480;462;50706;19915;14.1;5.5
88;2021-03-27;884;301;51590;20216;14.3;5.6
88;2021-03-28;61;4;51651;20220;14.4;5.6
88;2021-03-29;1305;449;52956;20669;14.7;5.7
88;2021-03-30;2062;395;55018;21064;15.3;5.9
88;2021-03-31;1619;578;56637;21642;15.8;6.0
88;2021-04-01;2117;721;58754;22363;16.3;6.2
88;2021-04-02;2812;648;61566;23011;17.1;6.4
88;2021-04-03;745;215;62311;23226;17.3;6.5
88;2021-04-04;16;1;62327;23227;17.3;6.5
88;2021-04-05;23;2;62350;23229;17.3;6.5
88;2021-04-06;1140;680;63490;23909;17.7;6.7
88;2021-04-07;1601;715;65091;24624;18.1;6.8
88;2021-04-08;1857;792;66948;25416;18.6;7.1
88;2021-04-09;3079;744;70027;26160;19.5;7.3
88;2021-04-10;724;650;70751;26810;19.7;7.5
88;2021-04-11;33;1;70784;26811;19.7;7.5
88;2021-04-12;1537;989;72321;27800;20.1;7.7
88;2021-04-13;2035;1092;74356;28892;20.7;8.0
88;2021-04-14;1910;952;76266;29844;21.2;8.3
88;2021-04-15;1967;1246;78233;31090;21.8;8.6
88;2021-04-16;2109;1050;80342;32140;22.3;8.9
88;2021-04-17;1430;766;81772;32906;22.7;9.2
88;2021-04-18;268;23;82040;32929;22.8;9.2
88;2021-04-19;1172;1239;83212;34168;23.1;9.5
88;2021-04-20;1190;1398;84402;35566;23.5;9.9
88;2021-04-21;1503;1300;85905;36866;23.9;10.3
88;2021-04-22;1900;1637;87805;38503;24.4;10.7
88;2021-04-23;1825;2047;89630;40550;24.9;11.3
88;2021-04-24;1184;788;90814;41338;25.3;11.5
88;2021-04-25;34;2;90848;41340;25.3;11.5
88;2021-04-26;1182;1176;92030;42516;25.6;11.8
88;2021-04-27;1277;1737;93307;44253;26.0;12.3
88;2021-04-28;1634;1498;94941;45751;26.4;12.7
88;2021-04-29;2082;1468;97023;47219;27.0;13.1
88;2021-04-30;2450;1634;99473;48853;27.7;13.6
88;2021-05-01;2008;290;101481;49143;28.2;13.7
88;2021-05-02;1301;120;102782;49263;28.6;13.7
88;2021-05-03;1559;1218;104341;50481;29.0;14.0
88;2021-05-04;1444;1469;105785;51950;29.4;14.4
88;2021-05-05;2426;1599;108211;53549;30.1;14.9
88;2021-05-06;3211;1214;111422;54763;31.0;15.2
88;2021-05-07;2938;1359;114360;56122;31.8;15.6
88;2021-05-08;1532;470;115892;56592;32.2;15.7
88;2021-05-09;1734;163;117626;56755;32.7;15.8
88;2021-05-10;1763;1571;119389;58326;33.2;16.2
88;2021-05-11;2655;1914;122044;60240;33.9;16.8
88;2021-05-12;2532;1853;124576;62093;34.7;17.3
88;2021-05-13;3258;683;127834;62776;35.6;17.5
88;2021-05-14;2500;1545;130334;64321;36.3;17.9
88;2021-05-15;1624;744;131958;65065;36.7;18.1
88;2021-05-16;1332;104;133290;65169;37.1;18.1
88;2021-05-17;1987;946;135277;66115;37.6;18.4
88;2021-05-18;2255;1116;137532;67231;38.3;18.7
88;2021-05-19;2721;1150;140253;68381;39.0;19.0
88;2021-05-20;3348;1239;143601;69620;39.9;19.4
88;2021-05-21;2875;1151;146476;70771;40.7;19.7
88;2021-05-22;1431;713;147907;71484;41.1;19.9
88;2021-05-23;558;74;148465;71558;41.3;19.9
88;2021-05-24;1675;435;150140;71993;41.8;20.0
88;2021-05-25;1646;1175;151786;73168;42.2;20.4
88;2021-05-26;2368;1140;154154;74308;42.9;20.7
88;2021-05-27;2200;1363;156354;75671;43.5;21.0
88;2021-05-28;1891;1988;158245;77659;44.0;21.6
88;2021-05-29;1230;1755;159475;79414;44.4;22.1
88;2021-05-30;587;418;160062;79832;44.5;22.2
88;2021-05-31;1327;1852;161389;81684;44.9;22.7
88;2021-06-01;1720;1986;163109;83670;45.4;23.3
88;2021-06-02;2076;1871;165185;85541;45.9;23.8
88;2021-06-03;2738;1622;167923;87163;46.7;24.2
88;2021-06-04;2042;1935;169965;89098;47.3;24.8
88;2021-06-05;1531;1139;171496;90237;47.7;25.1
88;2021-06-06;692;156;172188;90393;47.9;25.1
88;2021-06-07;1290;1710;173478;92103;48.3;25.6
88;2021-06-08;1666;1935;175144;94038;48.7;26.2
88;2021-06-09;1619;1911;176763;95949;49.2;26.7
88;2021-06-10;1781;2049;178544;97998;49.7;27.3
88;2021-06-11;1549;2218;180093;100216;50.1;27.9
88;2021-06-12;669;1657;180762;101873;50.3;28.3
88;2021-06-13;464;377;181226;102250;50.4;28.4
88;2021-06-14;1030;2251;182256;104501;50.7;29.1
88;2021-06-15;1927;2458;184183;106959;51.2;29.8
88;2021-06-16;1486;2873;185669;109832;51.6;30.5
88;2021-06-17;1601;2733;187270;112565;52.1;31.3
88;2021-06-18;1355;2461;188625;115026;52.5;32.0
88;2021-06-19;701;1090;189326;116116;52.7;32.3
88;2021-06-20;78;79;189404;116195;52.7;32.3
88;2021-06-21;672;2579;190076;118774;52.9;33.0
88;2021-06-22;869;3433;190945;122207;53.1;34.0
88;2021-06-23;1144;2877;192089;125084;53.4;34.8
88;2021-06-24;702;2604;192791;127688;53.6;35.5
88;2021-06-25;1436;3180;194227;130868;54.0;36.4
88;2021-06-26;903;2073;195130;132941;54.3;37.0
88;2021-06-27;543;635;195673;133576;54.4;37.2
88;2021-06-28;758;2514;196431;136090;54.6;37.9
88;2021-06-29;960;3353;197391;139443;54.9;38.8
88;2021-06-30;1137;3116;198528;142559;55.2;39.7
88;2021-07-01;1056;2686;199584;145245;55.5;40.4
88;2021-07-02;992;3150;200576;148395;55.8;41.3
88;2021-07-03;692;1699;201268;150094;56.0;41.7
88;2021-07-04;258;815;201526;150909;56.1;42.0
88;2021-07-05;993;2021;202519;152930;56.3;42.5
88;2021-07-06;1021;2415;203540;155345;56.6;43.2
88;2021-07-07;1177;2586;204717;157931;56.9;43.9
88;2021-07-08;1082;2063;205799;159994;57.2;44.5
88;2021-07-09;1583;2708;207382;162702;57.7;45.3
88;2021-07-10;721;1820;208103;164522;57.9;45.8
88;2021-07-11;468;696;208571;165218;58.0;46.0
88;2021-07-12;1056;2520;209627;167738;58.3;46.7
88;2021-07-13;1313;2655;210940;170393;58.7;47.4
88;2021-07-14;1207;802;212147;171195;59.0;47.6
88;2021-07-15;1744;3312;213891;174507;59.5;48.5
88;2021-07-16;1469;2964;215360;177471;59.9;49.4
88;2021-07-17;802;1587;216162;179058;60.1;49.8
88;2021-07-18;180;679;216342;179737;60.2;50.0
88;2021-07-19;1563;2232;217905;181969;60.6;50.6
88;2021-07-20;2144;2385;220049;184354;61.2;51.3
88;2021-07-21;1939;2218;221988;186572;61.7;51.9
88;2021-07-22;1699;2108;223687;188680;62.2;52.5
88;2021-07-23;2508;2784;226195;191464;62.9;53.3
88;2021-07-24;1059;1187;227254;192651;63.2;53.6
88;2021-07-25;432;608;227686;193259;63.3;53.8
88;2021-07-26;1715;2076;229401;195335;63.8;54.3
88;2021-07-27;2351;2061;231752;197396;64.5;54.9
88;2021-07-28;2210;2250;233962;199646;65.1;55.5
88;2021-07-29;3033;1636;236995;201282;65.9;56.0
88;2021-07-30;2272;2297;239267;203579;66.6;56.6
88;2021-07-31;1105;1037;240372;204616;66.9;56.9
88;2021-08-01;450;461;240822;205077;67.0;57.0
88;2021-08-02;2376;1770;243198;206847;67.6;57.5
88;2021-08-03;2875;1592;246073;208439;68.4;58.0
88;2021-08-04;2520;1530;248593;209969;69.1;58.4
88;2021-08-05;1994;1378;250587;211347;69.7;58.8
88;2021-08-06;2948;2010;253535;213357;70.5;59.3
88;2021-08-07;1176;912;254711;214269;70.8;59.6
88;2021-08-08;751;319;255462;214588;71.1;59.7
88;2021-08-09;1550;1650;257012;216238;71.5;60.1
88;2021-08-10;1941;2041;258953;218279;72.0;60.7
88;2021-08-11;1871;1759;260824;220038;72.5;61.2
88;2021-08-12;1670;1349;262494;221387;73.0;61.6
88;2021-08-13;1952;2137;264446;223524;73.6;62.2
88;2021-08-14;580;912;265026;224436;73.7;62.4
88;2021-08-15;337;520;265363;224956;73.8;62.6
88;2021-08-16;1149;1988;266512;226944;74.1;63.1
88;2021-08-17;1267;2058;267779;229002;74.5;63.7
88;2021-08-18;1209;1925;268988;230927;74.8;64.2
88;2021-08-19;1042;1582;270030;232509;75.1;64.7
88;2021-08-20;1020;2330;271050;234839;75.4;65.3
88;2021-08-21;405;1144;271455;235983;75.5;65.6
88;2021-08-22;100;479;271555;236462;75.5;65.8
88;2021-08-23;734;1640;272289;238102;75.7;66.2
88;2021-08-24;918;1973;273207;240075;76.0;66.8
88;2021-08-25;891;2459;274098;242534;76.2;67.5
88;2021-08-26;868;2049;274966;244583;76.5;68.0
88;2021-08-27;844;2711;275810;247294;76.7;68.8
88;2021-08-28;491;1351;276301;248645;76.9;69.2
88;2021-08-29;130;693;276431;249338;76.9;69.4
88;2021-08-30;699;2342;277130;251680;77.1;70.0
88;2021-08-31;782;2329;277912;254009;77.3;70.7
88;2021-09-01;686;1991;278598;256000;77.5;71.2
88;2021-09-02;666;1603;279264;257603;77.7;71.7
88;2021-09-03;728;2106;279992;259709;77.9;72.2
88;2021-09-04;429;1104;280421;260813;78.0;72.5
88;2021-09-05;188;370;280609;261183;78.1;72.6
88;2021-09-06;505;1208;281114;262391;78.2;73.0
88;2021-09-07;566;1225;281680;263616;78.3;73.3
88;2021-09-08;459;1330;282139;264946;78.5;73.7
88;2021-09-09;540;769;282679;265715;78.6;73.9
88;2021-09-10;591;1342;283270;267057;78.8;74.3
88;2021-09-11;349;781;283619;267838;78.9;74.5
88;2021-09-12;71;125;283690;267963;78.9;74.5
88;2021-09-13;429;701;284119;268664;79.0;74.7
88;2021-09-14;554;722;284673;269386;79.2;74.9
88;2021-09-15;425;970;285098;270356;79.3;75.2
88;2021-09-16;255;536;285353;270892;79.4;75.3
88;2021-09-17;434;1026;285787;271918;79.5;75.6
88;2021-09-18;237;680;286024;272598;79.6;75.8
88;2021-09-19;52;164;286076;272762;79.6;75.9
88;2021-09-20;222;565;286298;273327;79.6;76.0
88;2021-09-21;207;597;286505;273924;79.7;76.2
88;2021-09-22;206;780;286711;274704;79.7;76.4
88;2021-09-23;287;626;286998;275330;79.8;76.6
88;2021-09-24;280;802;287278;276132;79.9;76.8
88;2021-09-25;131;564;287409;276696;79.9;77.0
88;2021-09-26;18;159;287427;276855;79.9;77.0
88;2021-09-27;165;457;287592;277312;80.0;77.1
88;2021-09-28;175;523;287767;277835;80.0;77.3
88;2021-09-29;174;504;287941;278339;80.1;77.4
88;2021-09-30;127;459;288068;278798;80.1;77.5
88;2021-10-01;207;672;288275;279470;80.2;77.7
88;2021-10-02;129;359;288404;279829;80.2;77.8
88;2021-10-03;22;80;288426;279909;80.2;77.9
88;2021-10-04;137;467;288563;280376;80.3;78.0
88;2021-10-05;178;581;288741;280957;80.3;78.1
88;2021-10-06;198;398;288939;281355;80.4;78.3
88;2021-10-07;61;209;289000;281564;80.4;78.3
88;2021-10-08;265;630;289265;282194;80.5;78.5
88;2021-10-09;118;241;289383;282435;80.5;78.6
88;2021-10-10;19;46;289402;282481;80.5;78.6
88;2021-10-11;88;225;289490;282706;80.5;78.6
89;2020-12-27;0;0;0;0;0.0;0.0
89;2020-12-28;2;1;2;1;0.0;0.0
89;2020-12-29;0;0;2;1;0.0;0.0
89;2020-12-30;0;0;2;1;0.0;0.0
89;2020-12-31;0;0;2;1;0.0;0.0
89;2021-01-01;0;0;2;1;0.0;0.0
89;2021-01-02;0;0;2;1;0.0;0.0
89;2021-01-03;0;0;2;1;0.0;0.0
89;2021-01-04;0;0;2;1;0.0;0.0
89;2021-01-05;0;0;2;1;0.0;0.0
89;2021-01-06;48;0;50;1;0.0;0.0
89;2021-01-07;201;0;251;1;0.1;0.0
89;2021-01-08;48;0;299;1;0.1;0.0
89;2021-01-09;1;0;300;1;0.1;0.0
89;2021-01-10;0;0;300;1;0.1;0.0
89;2021-01-11;221;0;521;1;0.2;0.0
89;2021-01-12;349;0;870;1;0.3;0.0
89;2021-01-13;533;3;1403;4;0.4;0.0
89;2021-01-14;711;8;2114;12;0.6;0.0
89;2021-01-15;278;2;2392;14;0.7;0.0
89;2021-01-16;90;4;2482;18;0.7;0.0
89;2021-01-17;0;0;2482;18;0.7;0.0
89;2021-01-18;503;1;2985;19;0.9;0.0
89;2021-01-19;841;4;3826;23;1.2;0.0
89;2021-01-20;762;0;4588;23;1.4;0.0
89;2021-01-21;939;4;5527;27;1.7;0.0
89;2021-01-22;1020;1;6547;28;2.0;0.0
89;2021-01-23;200;0;6747;28;2.0;0.0
89;2021-01-24;107;1;6854;29;2.1;0.0
89;2021-01-25;483;4;7337;33;2.2;0.0
89;2021-01-26;582;14;7919;47;2.4;0.0
89;2021-01-27;473;38;8392;85;2.5;0.0
89;2021-01-28;551;127;8943;212;2.7;0.1
89;2021-01-29;959;43;9902;255;3.0;0.1
89;2021-01-30;184;67;10086;322;3.0;0.1
89;2021-01-31;24;2;10110;324;3.0;0.1
89;2021-02-01;255;152;10365;476;3.1;0.1
89;2021-02-02;283;333;10648;809;3.2;0.2
89;2021-02-03;292;344;10940;1153;3.3;0.3
89;2021-02-04;434;593;11374;1746;3.4;0.5
89;2021-02-05;387;204;11761;1950;3.5;0.6
89;2021-02-06;77;66;11838;2016;3.6;0.6
89;2021-02-07;0;0;11838;2016;3.6;0.6
89;2021-02-08;287;188;12125;2204;3.7;0.7
89;2021-02-09;284;441;12409;2645;3.7;0.8
89;2021-02-10;396;313;12805;2958;3.9;0.9
89;2021-02-11;332;548;13137;3506;4.0;1.1
89;2021-02-12;433;599;13570;4105;4.1;1.2
89;2021-02-13;51;130;13621;4235;4.1;1.3
89;2021-02-14;21;116;13642;4351;4.1;1.3
89;2021-02-15;217;403;13859;4754;4.2;1.4
89;2021-02-16;134;534;13993;5288;4.2;1.6
89;2021-02-17;263;438;14256;5726;4.3;1.7
89;2021-02-18;225;544;14481;6270;4.4;1.9
89;2021-02-19;246;652;14727;6922;4.4;2.1
89;2021-02-20;33;140;14760;7062;4.4;2.1
89;2021-02-21;0;10;14760;7072;4.4;2.1
89;2021-02-22;233;451;14993;7523;4.5;2.3
89;2021-02-23;170;490;15163;8013;4.6;2.4
89;2021-02-24;344;389;15507;8402;4.7;2.5
89;2021-02-25;370;464;15877;8866;4.8;2.7
89;2021-02-26;385;338;16262;9204;4.9;2.8
89;2021-02-27;138;82;16400;9286;4.9;2.8
89;2021-02-28;6;13;16406;9299;4.9;2.8
89;2021-03-01;541;237;16947;9536;5.1;2.9
89;2021-03-02;755;356;17702;9892;5.3;3.0
89;2021-03-03;647;277;18349;10169;5.5;3.1
89;2021-03-04;633;380;18982;10549;5.7;3.2
89;2021-03-05;728;506;19710;11055;5.9;3.3
89;2021-03-06;549;135;20259;11190;6.1;3.4
89;2021-03-07;288;40;20547;11230;6.2;3.4
89;2021-03-08;560;330;21107;11560;6.4;3.5
89;2021-03-09;1003;278;22110;11838;6.7;3.6
89;2021-03-10;984;257;23094;12095;7.0;3.6
89;2021-03-11;1077;304;24171;12399;7.3;3.7
89;2021-03-12;1280;338;25451;12737;7.7;3.8
89;2021-03-13;637;45;26088;12782;7.9;3.8
89;2021-03-14;1;0;26089;12782;7.9;3.8
89;2021-03-15;816;317;26905;13099;8.1;3.9
89;2021-03-16;948;229;27853;13328;8.4;4.0
89;2021-03-17;920;273;28773;13601;8.7;4.1
89;2021-03-18;885;258;29658;13859;8.9;4.2
89;2021-03-19;1149;197;30807;14056;9.3;4.2
89;2021-03-20;844;33;31651;14089;9.5;4.2
89;2021-03-21;173;6;31824;14095;9.6;4.2
89;2021-03-22;1044;227;32868;14322;9.9;4.3
89;2021-03-23;1744;263;34612;14585;10.4;4.4
89;2021-03-24;1968;333;36580;14918;11.0;4.5
89;2021-03-25;1821;174;38401;15092;11.6;4.5
89;2021-03-26;2628;190;41029;15282;12.4;4.6
89;2021-03-27;1775;52;42804;15334;12.9;4.6
89;2021-03-28;32;3;42836;15337;12.9;4.6
89;2021-03-29;965;579;43801;15916;13.2;4.8
89;2021-03-30;1156;574;44957;16490;13.5;5.0
89;2021-03-31;2004;474;46961;16964;14.1;5.1
89;2021-04-01;2120;463;49081;17427;14.8;5.2
89;2021-04-02;2140;450;51221;17877;15.4;5.4
89;2021-04-03;1004;243;52225;18120;15.7;5.5
89;2021-04-04;16;1;52241;18121;15.7;5.5
89;2021-04-05;92;4;52333;18125;15.8;5.5
89;2021-04-06;1032;758;53365;18883;16.1;5.7
89;2021-04-07;1027;806;54392;19689;16.4;5.9
89;2021-04-08;1731;728;56123;20417;16.9;6.1
89;2021-04-09;2164;772;58287;21189;17.6;6.4
89;2021-04-10;891;180;59178;21369;17.8;6.4
89;2021-04-11;38;51;59216;21420;17.8;6.4
89;2021-04-12;1010;795;60226;22215;18.1;6.7
89;2021-04-13;1356;1082;61582;23297;18.5;7.0
89;2021-04-14;1214;1040;62796;24337;18.9;7.3
89;2021-04-15;1412;948;64208;25285;19.3;7.6
89;2021-04-16;1330;941;65538;26226;19.7;7.9
89;2021-04-17;1070;456;66608;26682;20.1;8.0
89;2021-04-18;27;154;66635;26836;20.1;8.1
89;2021-04-19;748;1040;67383;27876;20.3;8.4
89;2021-04-20;1016;1535;68399;29411;20.6;8.9
89;2021-04-21;814;1107;69213;30518;20.8;9.2
89;2021-04-22;1107;1169;70320;31687;21.2;9.5
89;2021-04-23;1820;1966;72140;33653;21.7;10.1
89;2021-04-24;1173;1175;73313;34828;22.1;10.5
89;2021-04-25;139;6;73452;34834;22.1;10.5
89;2021-04-26;1503;778;74955;35612;22.6;10.7
89;2021-04-27;1733;1054;76688;36666;23.1;11.0
89;2021-04-28;1599;1856;78287;38522;23.6;11.6
89;2021-04-29;1970;1932;80257;40454;24.2;12.2
89;2021-04-30;1803;1770;82060;42224;24.7;12.7
89;2021-05-01;846;722;82906;42946;25.0;12.9
89;2021-05-02;134;31;83040;42977;25.0;12.9
89;2021-05-03;1606;766;84646;43743;25.5;13.2
89;2021-05-04;1619;1131;86265;44874;26.0;13.5
89;2021-05-05;2319;1267;88584;46141;26.7;13.9
89;2021-05-06;2411;1381;90995;47522;27.4;14.3
89;2021-05-07;2718;1318;93713;48840;28.2;14.7
89;2021-05-08;1786;535;95499;49375;28.8;14.9
89;2021-05-09;196;19;95695;49394;28.8;14.9
89;2021-05-10;1202;963;96897;50357;29.2;15.2
89;2021-05-11;2491;1466;99388;51823;29.9;15.6
89;2021-05-12;2060;1217;101448;53040;30.5;16.0
89;2021-05-13;415;332;101863;53372;30.7;16.1
89;2021-05-14;1880;1095;103743;54467;31.2;16.4
89;2021-05-15;2247;394;105990;54861;31.9;16.5
89;2021-05-16;10;35;106000;54896;31.9;16.5
89;2021-05-17;2091;638;108091;55534;32.5;16.7
89;2021-05-18;2324;832;110415;56366;33.2;17.0
89;2021-05-19;2860;882;113275;57248;34.1;17.2
89;2021-05-20;2927;886;116202;58134;35.0;17.5
89;2021-05-21;2481;879;118683;59013;35.7;17.8
89;2021-05-22;1431;572;120114;59585;36.2;17.9
89;2021-05-23;108;10;120222;59595;36.2;17.9
89;2021-05-24;288;226;120510;59821;36.3;18.0
89;2021-05-25;1558;982;122068;60803;36.8;18.3
89;2021-05-26;1815;1024;123883;61827;37.3;18.6
89;2021-05-27;2117;1358;126000;63185;37.9;19.0
89;2021-05-28;2143;1422;128143;64607;38.6;19.5
89;2021-05-29;541;658;128684;65265;38.7;19.7
89;2021-05-30;25;22;128709;65287;38.8;19.7
89;2021-05-31;1248;972;129957;66259;39.1;20.0
89;2021-06-01;1505;981;131462;67240;39.6;20.2
89;2021-06-02;1946;1279;133408;68519;40.2;20.6
89;2021-06-03;2432;1523;135840;70042;40.9;21.1
89;2021-06-04;2140;1888;137980;71930;41.5;21.7
89;2021-06-05;1185;1224;139165;73154;41.9;22.0
89;2021-06-06;24;37;139189;73191;41.9;22.0
89;2021-06-07;2107;1452;141296;74643;42.5;22.5
89;2021-06-08;2196;1452;143492;76095;43.2;22.9
89;2021-06-09;2326;1510;145818;77605;43.9;23.4
89;2021-06-10;2794;1600;148612;79205;44.7;23.9
89;2021-06-11;1951;1750;150563;80955;45.3;24.4
89;2021-06-12;1103;759;151666;81714;45.7;24.6
89;2021-06-13;156;423;151822;82137;45.7;24.7
89;2021-06-14;1313;1825;153135;83962;46.1;25.3
89;2021-06-15;1404;2011;154539;85973;46.5;25.9
89;2021-06-16;1129;2582;155668;88555;46.9;26.7
89;2021-06-17;1434;2335;157102;90890;47.3;27.4
89;2021-06-18;1624;2878;158726;93768;47.8;28.2
89;2021-06-19;686;1660;159412;95428;48.0;28.7
89;2021-06-20;55;127;159467;95555;48.0;28.8
89;2021-06-21;758;1528;160225;97083;48.2;29.2
89;2021-06-22;1049;2679;161274;99762;48.6;30.0
89;2021-06-23;1157;1800;162431;101562;48.9;30.6
89;2021-06-24;1077;1497;163508;103059;49.2;31.0
89;2021-06-25;1008;2425;164516;105484;49.5;31.8
89;2021-06-26;560;2482;165076;107966;49.7;32.5
89;2021-06-27;14;28;165090;107994;49.7;32.5
89;2021-06-28;1033;2495;166123;110489;50.0;33.3
89;2021-06-29;691;2403;166814;112892;50.2;34.0
89;2021-06-30;1083;3181;167897;116073;50.6;35.0
89;2021-07-01;1026;2989;168923;119062;50.9;35.9
89;2021-07-02;1109;2751;170032;121813;51.2;36.7
89;2021-07-03;554;1575;170586;123388;51.4;37.2
89;2021-07-04;11;36;170597;123424;51.4;37.2
89;2021-07-05;1296;1839;171893;125263;51.8;37.7
89;2021-07-06;1057;2312;172950;127575;52.1;38.4
89;2021-07-07;682;1787;173632;129362;52.3;39.0
89;2021-07-08;805;1873;174437;131235;52.5;39.5
89;2021-07-09;1146;2606;175583;133841;52.9;40.3
89;2021-07-10;719;816;176302;134657;53.1;40.5
89;2021-07-11;26;39;176328;134696;53.1;40.6
89;2021-07-12;1427;1900;177755;136596;53.5;41.1
89;2021-07-13;2145;2746;179900;139342;54.2;42.0
89;2021-07-14;322;326;180222;139668;54.3;42.1
89;2021-07-15;2253;3156;182475;142824;54.9;43.0
89;2021-07-16;2391;2865;184866;145689;55.7;43.9
89;2021-07-17;1235;1229;186101;146918;56.0;44.2
89;2021-07-18;277;97;186378;147015;56.1;44.3
89;2021-07-19;1566;2812;187944;149827;56.6;45.1
89;2021-07-20;1929;3283;189873;153110;57.2;46.1
89;2021-07-21;2081;2725;191954;155835;57.8;46.9
89;2021-07-22;2481;2994;194435;158829;58.5;47.8
89;2021-07-23;2474;3105;196909;161934;59.3;48.8
89;2021-07-24;1241;1247;198150;163181;59.7;49.1
89;2021-07-25;69;185;198219;163366;59.7;49.2
89;2021-07-26;1720;2322;199939;165688;60.2;49.9
89;2021-07-27;2345;1911;202284;167599;60.9;50.5
89;2021-07-28;2538;1339;204822;168938;61.7;50.9
89;2021-07-29;2526;1621;207348;170559;62.4;51.4
89;2021-07-30;2679;1627;210027;172186;63.2;51.8
89;2021-07-31;1121;1073;211148;173259;63.6;52.2
89;2021-08-01;69;33;211217;173292;63.6;52.2
89;2021-08-02;1805;1289;213022;174581;64.1;52.6
89;2021-08-03;2502;1255;215524;175836;64.9;52.9
89;2021-08-04;1556;1641;217080;177477;65.4;53.4
89;2021-08-05;1575;1693;218655;179170;65.8;54.0
89;2021-08-06;2219;1651;220874;180821;66.5;54.4
89;2021-08-07;931;1098;221805;181919;66.8;54.8
89;2021-08-08;56;48;221861;181967;66.8;54.8
89;2021-08-09;1119;1175;222980;183142;67.1;55.1
89;2021-08-10;1832;1816;224812;184958;67.7;55.7
89;2021-08-11;1594;1585;226406;186543;68.2;56.2
89;2021-08-12;1453;1393;227859;187936;68.6;56.6
89;2021-08-13;1352;1955;229211;189891;69.0;57.2
89;2021-08-14;529;1024;229740;190915;69.2;57.5
89;2021-08-15;20;43;229760;190958;69.2;57.5
89;2021-08-16;1034;1969;230794;192927;69.5;58.1
89;2021-08-17;862;1573;231656;194500;69.8;58.6
89;2021-08-18;643;1898;232299;196398;69.9;59.1
89;2021-08-19;695;1389;232994;197787;70.2;59.6
89;2021-08-20;1155;2266;234149;200053;70.5;60.2
89;2021-08-21;297;1003;234446;201056;70.6;60.5
89;2021-08-22;32;34;234478;201090;70.6;60.6
89;2021-08-23;835;2252;235313;203342;70.9;61.2
89;2021-08-24;869;2366;236182;205708;71.1;61.9
89;2021-08-25;595;1429;236777;207137;71.3;62.4
89;2021-08-26;617;2053;237394;209190;71.5;63.0
89;2021-08-27;874;2265;238268;211455;71.7;63.7
89;2021-08-28;380;1303;238648;212758;71.9;64.1
89;2021-08-29;30;70;238678;212828;71.9;64.1
89;2021-08-30;664;2210;239342;215038;72.1;64.8
89;2021-08-31;610;1578;239952;216616;72.3;65.2
89;2021-09-01;613;1299;240565;217915;72.4;65.6
89;2021-09-02;466;1326;241031;219241;72.6;66.0
89;2021-09-03;635;1908;241666;221149;72.8;66.6
89;2021-09-04;513;947;242179;222096;72.9;66.9
89;2021-09-05;21;11;242200;222107;72.9;66.9
89;2021-09-06;465;1545;242665;223652;73.1;67.3
89;2021-09-07;392;914;243057;224566;73.2;67.6
89;2021-09-08;348;857;243405;225423;73.3;67.9
89;2021-09-09;276;831;243681;226254;73.4;68.1
89;2021-09-10;472;1382;244153;227636;73.5;68.5
89;2021-09-11;271;763;244424;228399;73.6;68.8
89;2021-09-12;11;38;244435;228437;73.6;68.8
89;2021-09-13;386;1069;244821;229506;73.7;69.1
89;2021-09-14;372;660;245193;230166;73.8;69.3
89;2021-09-15;238;699;245431;230865;73.9;69.5
89;2021-09-16;248;571;245679;231436;74.0;69.7
89;2021-09-17;498;1117;246177;232553;74.1;70.0
89;2021-09-18;178;744;246355;233297;74.2;70.2
89;2021-09-19;4;17;246359;233314;74.2;70.3
89;2021-09-20;248;726;246607;234040;74.3;70.5
89;2021-09-21;297;480;246904;234520;74.3;70.6
89;2021-09-22;198;578;247102;235098;74.4;70.8
89;2021-09-23;232;474;247334;235572;74.5;70.9
89;2021-09-24;303;870;247637;236442;74.6;71.2
89;2021-09-25;108;465;247745;236907;74.6;71.3
89;2021-09-26;3;19;247748;236926;74.6;71.3
89;2021-09-27;195;506;247943;237432;74.7;71.5
89;2021-09-28;240;409;248183;237841;74.7;71.6
89;2021-09-29;184;423;248367;238264;74.8;71.7
89;2021-09-30;167;620;248534;238884;74.8;71.9
89;2021-10-01;253;659;248787;239543;74.9;72.1
89;2021-10-02;120;480;248907;240023;75.0;72.3
89;2021-10-03;8;8;248915;240031;75.0;72.3
89;2021-10-04;118;544;249033;240575;75.0;72.4
89;2021-10-05;138;573;249171;241148;75.0;72.6
89;2021-10-06;228;591;249399;241739;75.1;72.8
89;2021-10-07;87;337;249486;242076;75.1;72.9
89;2021-10-08;234;733;249720;242809;75.2;73.1
89;2021-10-09;109;280;249829;243089;75.2;73.2
89;2021-10-10;0;11;249829;243100;75.2;73.2
89;2021-10-11;123;318;249952;243418;75.3;73.3
90;2020-12-27;0;0;0;0;0.0;0.0
90;2020-12-28;0;0;0;0;0.0;0.0
90;2020-12-29;0;0;0;0;0.0;0.0
90;2020-12-30;1;0;1;0;0.0;0.0
90;2020-12-31;0;0;1;0;0.0;0.0
90;2021-01-01;0;0;1;0;0.0;0.0
90;2021-01-02;1;0;2;0;0.0;0.0
90;2021-01-03;0;0;2;0;0.0;0.0
90;2021-01-04;2;0;4;0;0.0;0.0
90;2021-01-05;0;0;4;0;0.0;0.0
90;2021-01-06;0;0;4;0;0.0;0.0
90;2021-01-07;1;0;5;0;0.0;0.0
90;2021-01-08;170;0;175;0;0.1;0.0
90;2021-01-09;46;0;221;0;0.2;0.0
90;2021-01-10;0;0;221;0;0.2;0.0
90;2021-01-11;200;0;421;0;0.3;0.0
90;2021-01-12;431;1;852;1;0.6;0.0
90;2021-01-13;467;2;1319;3;0.9;0.0
90;2021-01-14;414;2;1733;5;1.2;0.0
90;2021-01-15;404;9;2137;14;1.5;0.0
90;2021-01-16;111;2;2248;16;1.6;0.0
90;2021-01-17;1;0;2249;16;1.6;0.0
90;2021-01-18;365;2;2614;18;1.9;0.0
90;2021-01-19;462;6;3076;24;2.2;0.0
90;2021-01-20;393;2;3469;26;2.5;0.0
90;2021-01-21;351;1;3820;27;2.7;0.0
90;2021-01-22;345;2;4165;29;3.0;0.0
90;2021-01-23;98;0;4263;29;3.0;0.0
90;2021-01-24;0;0;4263;29;3.0;0.0
90;2021-01-25;322;3;4585;32;3.3;0.0
90;2021-01-26;224;0;4809;32;3.4;0.0
90;2021-01-27;254;0;5063;32;3.6;0.0
90;2021-01-28;328;33;5391;65;3.8;0.0
90;2021-01-29;291;163;5682;228;4.1;0.2
90;2021-01-30;175;45;5857;273;4.2;0.2
90;2021-01-31;118;0;5975;273;4.3;0.2
90;2021-02-01;275;116;6250;389;4.5;0.3
90;2021-02-02;290;163;6540;552;4.7;0.4
90;2021-02-03;256;368;6796;920;4.8;0.7
90;2021-02-04;257;306;7053;1226;5.0;0.9
90;2021-02-05;266;272;7319;1498;5.2;1.1
90;2021-02-06;90;68;7409;1566;5.3;1.1
90;2021-02-07;0;0;7409;1566;5.3;1.1
90;2021-02-08;170;217;7579;1783;5.4;1.3
90;2021-02-09;139;166;7718;1949;5.5;1.4
90;2021-02-10;182;32;7900;1981;5.6;1.4
90;2021-02-11;229;109;8129;2090;5.8;1.5
90;2021-02-12;126;239;8255;2329;5.9;1.7
90;2021-02-13;96;46;8351;2375;6.0;1.7
90;2021-02-14;0;0;8351;2375;6.0;1.7
90;2021-02-15;113;280;8464;2655;6.0;1.9
90;2021-02-16;92;275;8556;2930;6.1;2.1
90;2021-02-17;178;204;8734;3134;6.2;2.2
90;2021-02-18;128;242;8862;3376;6.3;2.4
90;2021-02-19;64;271;8926;3647;6.4;2.6
90;2021-02-20;40;72;8966;3719;6.4;2.7
90;2021-02-21;0;0;8966;3719;6.4;2.7
90;2021-02-22;77;334;9043;4053;6.5;2.9
90;2021-02-23;40;258;9083;4311;6.5;3.1
90;2021-02-24;109;290;9192;4601;6.6;3.3
90;2021-02-25;89;314;9281;4915;6.6;3.5
90;2021-02-26;89;393;9370;5308;6.7;3.8
90;2021-02-27;140;175;9510;5483;6.8;3.9
90;2021-02-28;8;113;9518;5596;6.8;4.0
90;2021-03-01;211;231;9729;5827;6.9;4.2
90;2021-03-02;178;284;9907;6111;7.1;4.4
90;2021-03-03;239;355;10146;6466;7.2;4.6
90;2021-03-04;260;278;10406;6744;7.4;4.8
90;2021-03-05;359;271;10765;7015;7.7;5.0
90;2021-03-06;291;104;11056;7119;7.9;5.1
90;2021-03-07;18;1;11074;7120;7.9;5.1
90;2021-03-08;246;249;11320;7369;8.1;5.3
90;2021-03-09;430;167;11750;7536;8.4;5.4
90;2021-03-10;348;197;12098;7733;8.6;5.5
90;2021-03-11;347;120;12445;7853;8.9;5.6
90;2021-03-12;519;130;12964;7983;9.3;5.7
90;2021-03-13;539;49;13503;8032;9.6;5.7
90;2021-03-14;21;0;13524;8032;9.7;5.7
90;2021-03-15;388;118;13912;8150;9.9;5.8
90;2021-03-16;401;102;14313;8252;10.2;5.9
90;2021-03-17;323;76;14636;8328;10.4;5.9
90;2021-03-18;349;84;14985;8412;10.7;6.0
90;2021-03-19;468;79;15453;8491;11.0;6.1
90;2021-03-20;427;48;15880;8539;11.3;6.1
90;2021-03-21;7;1;15887;8540;11.3;6.1
90;2021-03-22;399;31;16286;8571;11.6;6.1
90;2021-03-23;740;79;17026;8650;12.1;6.2
90;2021-03-24;817;47;17843;8697;12.7;6.2
90;2021-03-25;949;79;18792;8776;13.4;6.3
90;2021-03-26;1226;62;20018;8838;14.3;6.3
90;2021-03-27;439;34;20457;8872;14.6;6.3
90;2021-03-28;34;0;20491;8872;14.6;6.3
90;2021-03-29;712;144;21203;9016;15.1;6.4
90;2021-03-30;675;156;21878;9172;15.6;6.5
90;2021-03-31;728;87;22606;9259;16.1;6.6
90;2021-04-01;602;123;23208;9382;16.6;6.7
90;2021-04-02;657;98;23865;9480;17.0;6.8
90;2021-04-03;370;41;24235;9521;17.3;6.8
90;2021-04-04;1;0;24236;9521;17.3;6.8
90;2021-04-05;0;0;24236;9521;17.3;6.8
90;2021-04-06;528;252;24764;9773;17.7;7.0
90;2021-04-07;485;268;25249;10041;18.0;7.2
90;2021-04-08;510;246;25759;10287;18.4;7.3
90;2021-04-09;751;268;26510;10555;18.9;7.5
90;2021-04-10;224;9;26734;10564;19.1;7.5
90;2021-04-11;7;0;26741;10564;19.1;7.5
90;2021-04-12;557;482;27298;11046;19.5;7.9
90;2021-04-13;632;531;27930;11577;19.9;8.3
90;2021-04-14;525;354;28455;11931;20.3;8.5
90;2021-04-15;905;293;29360;12224;20.9;8.7
90;2021-04-16;370;406;29730;12630;21.2;9.0
90;2021-04-17;189;129;29919;12759;21.3;9.1
90;2021-04-18;21;0;29940;12759;21.4;9.1
90;2021-04-19;435;573;30375;13332;21.7;9.5
90;2021-04-20;493;620;30868;13952;22.0;10.0
90;2021-04-21;353;498;31221;14450;22.3;10.3
90;2021-04-22;569;602;31790;15052;22.7;10.7
90;2021-04-23;504;743;32294;15795;23.0;11.3
90;2021-04-24;305;202;32599;15997;23.3;11.4
90;2021-04-25;1;0;32600;15997;23.3;11.4
90;2021-04-26;509;751;33109;16748;23.6;12.0
90;2021-04-27;640;683;33749;17431;24.1;12.4
90;2021-04-28;765;448;34514;17879;24.6;12.8
90;2021-04-29;1003;455;35517;18334;25.3;13.1
90;2021-04-30;1120;460;36637;18794;26.1;13.4
90;2021-05-01;60;42;36697;18836;26.2;13.4
90;2021-05-02;4;0;36701;18836;26.2;13.4
90;2021-05-03;903;286;37604;19122;26.8;13.6
90;2021-05-04;784;638;38388;19760;27.4;14.1
90;2021-05-05;891;504;39279;20264;28.0;14.5
90;2021-05-06;851;626;40130;20890;28.6;14.9
90;2021-05-07;440;507;40570;21397;28.9;15.3
90;2021-05-08;26;27;40596;21424;29.0;15.3
90;2021-05-09;5;33;40601;21457;29.0;15.3
90;2021-05-10;506;585;41107;22042;29.3;15.7
90;2021-05-11;778;638;41885;22680;29.9;16.2
90;2021-05-12;531;598;42416;23278;30.3;16.6
90;2021-05-13;1113;265;43529;23543;31.1;16.8
90;2021-05-14;865;403;44394;23946;31.7;17.1
90;2021-05-15;14;125;44408;24071;31.7;17.2
90;2021-05-16;2;7;44410;24078;31.7;17.2
90;2021-05-17;792;290;45202;24368;32.3;17.4
90;2021-05-18;1024;472;46226;24840;33.0;17.7
90;2021-05-19;1264;384;47490;25224;33.9;18.0
90;2021-05-20;1201;270;48691;25494;34.7;18.2
90;2021-05-21;1265;436;49956;25930;35.6;18.5
90;2021-05-22;9;131;49965;26061;35.7;18.6
90;2021-05-23;4;0;49969;26061;35.7;18.6
90;2021-05-24;368;265;50337;26326;35.9;18.8
90;2021-05-25;635;791;50972;27117;36.4;19.3
90;2021-05-26;630;569;51602;27686;36.8;19.8
90;2021-05-27;962;383;52564;28069;37.5;20.0
90;2021-05-28;668;827;53232;28896;38.0;20.6
90;2021-05-29;93;296;53325;29192;38.0;20.8
90;2021-05-30;4;1;53329;29193;38.1;20.8
90;2021-05-31;808;713;54137;29906;38.6;21.3
90;2021-06-01;969;739;55106;30645;39.3;21.9
90;2021-06-02;760;676;55866;31321;39.9;22.3
90;2021-06-03;758;744;56624;32065;40.4;22.9
90;2021-06-04;833;972;57457;33037;41.0;23.6
90;2021-06-05;54;427;57511;33464;41.0;23.9
90;2021-06-06;1;16;57512;33480;41.0;23.9
90;2021-06-07;1265;1081;58777;34561;41.9;24.7
90;2021-06-08;1482;939;60259;35500;43.0;25.3
90;2021-06-09;964;659;61223;36159;43.7;25.8
90;2021-06-10;627;498;61850;36657;44.1;26.2
90;2021-06-11;787;1126;62637;37783;44.7;27.0
90;2021-06-12;806;297;63443;38080;45.3;27.2
90;2021-06-13;10;12;63453;38092;45.3;27.2
90;2021-06-14;264;972;63717;39064;45.5;27.9
90;2021-06-15;566;882;64283;39946;45.9;28.5
90;2021-06-16;509;548;64792;40494;46.2;28.9
90;2021-06-17;443;638;65235;41132;46.5;29.3
90;2021-06-18;623;997;65858;42129;47.0;30.1
90;2021-06-19;450;171;66308;42300;47.3;30.2
90;2021-06-20;0;28;66308;42328;47.3;30.2
90;2021-06-21;256;1176;66564;43504;47.5;31.0
90;2021-06-22;384;950;66948;44454;47.8;31.7
90;2021-06-23;415;633;67363;45087;48.1;32.2
90;2021-06-24;319;602;67682;45689;48.3;32.6
90;2021-06-25;431;1270;68113;46959;48.6;33.5
90;2021-06-26;420;560;68533;47519;48.9;33.9
90;2021-06-27;2;6;68535;47525;48.9;33.9
90;2021-06-28;381;1298;68916;48823;49.2;34.8
90;2021-06-29;305;1305;69221;50128;49.4;35.8
90;2021-06-30;485;1227;69706;51355;49.7;36.6
90;2021-07-01;355;920;70061;52275;50.0;37.3
90;2021-07-02;506;1205;70567;53480;50.4;38.2
90;2021-07-03;53;129;70620;53609;50.4;38.3
90;2021-07-04;0;21;70620;53630;50.4;38.3
90;2021-07-05;400;1014;71020;54644;50.7;39.0
90;2021-07-06;514;970;71534;55614;51.0;39.7
90;2021-07-07;381;998;71915;56612;51.3;40.4
90;2021-07-08;304;607;72219;57219;51.5;40.8
90;2021-07-09;439;950;72658;58169;51.8;41.5
90;2021-07-10;32;91;72690;58260;51.9;41.6
90;2021-07-11;7;17;72697;58277;51.9;41.6
90;2021-07-12;246;1075;72943;59352;52.0;42.4
90;2021-07-13;474;1162;73417;60514;52.4;43.2
90;2021-07-14;4;9;73421;60523;52.4;43.2
90;2021-07-15;789;1455;74210;61978;53.0;44.2
90;2021-07-16;826;1681;75036;63659;53.5;45.4
90;2021-07-17;484;955;75520;64614;53.9;46.1
90;2021-07-18;4;2;75524;64616;53.9;46.1
90;2021-07-19;1186;1460;76710;66076;54.7;47.1
90;2021-07-20;1339;1135;78049;67211;55.7;48.0
90;2021-07-21;1395;983;79444;68194;56.7;48.7
90;2021-07-22;1127;697;80571;68891;57.5;49.2
90;2021-07-23;968;1020;81539;69911;58.2;49.9
90;2021-07-24;121;66;81660;69977;58.3;49.9
90;2021-07-25;2;1;81662;69978;58.3;49.9
90;2021-07-26;1074;801;82736;70779;59.0;50.5
90;2021-07-27;1081;746;83817;71525;59.8;51.0
90;2021-07-28;825;712;84642;72237;60.4;51.5
90;2021-07-29;843;441;85485;72678;61.0;51.9
90;2021-07-30;786;506;86271;73184;61.6;52.2
90;2021-07-31;484;313;86755;73497;61.9;52.4
90;2021-08-01;0;3;86755;73500;61.9;52.4
90;2021-08-02;850;510;87605;74010;62.5;52.8
90;2021-08-03;929;494;88534;74504;63.2;53.2
90;2021-08-04;1067;460;89601;74964;63.9;53.5
90;2021-08-05;521;223;90122;75187;64.3;53.6
90;2021-08-06;649;388;90771;75575;64.8;53.9
90;2021-08-07;37;63;90808;75638;64.8;54.0
90;2021-08-08;18;3;90826;75641;64.8;54.0
90;2021-08-09;730;947;91556;76588;65.3;54.6
90;2021-08-10;536;1152;92092;77740;65.7;55.5
90;2021-08-11;537;948;92629;78688;66.1;56.1
90;2021-08-12;449;820;93078;79508;66.4;56.7
90;2021-08-13;545;898;93623;80406;66.8;57.4
90;2021-08-14;30;98;93653;80504;66.8;57.4
90;2021-08-15;2;7;93655;80511;66.8;57.4
90;2021-08-16;451;632;94106;81143;67.1;57.9
90;2021-08-17;347;1167;94453;82310;67.4;58.7
90;2021-08-18;275;881;94728;83191;67.6;59.4
90;2021-08-19;248;627;94976;83818;67.8;59.8
90;2021-08-20;361;771;95337;84589;68.0;60.4
90;2021-08-21;32;71;95369;84660;68.1;60.4
90;2021-08-22;0;7;95369;84667;68.1;60.4
90;2021-08-23;320;489;95689;85156;68.3;60.8
90;2021-08-24;337;959;96026;86115;68.5;61.4
90;2021-08-25;254;915;96280;87030;68.7;62.1
90;2021-08-26;247;675;96527;87705;68.9;62.6
90;2021-08-27;279;737;96806;88442;69.1;63.1
90;2021-08-28;21;64;96827;88506;69.1;63.2
90;2021-08-29;3;6;96830;88512;69.1;63.2
90;2021-08-30;328;628;97158;89140;69.3;63.6
90;2021-08-31;280;1010;97438;90150;69.5;64.3
90;2021-09-01;268;677;97706;90827;69.7;64.8
90;2021-09-02;159;385;97865;91212;69.8;65.1
90;2021-09-03;222;517;98087;91729;70.0;65.5
90;2021-09-04;55;139;98142;91868;70.0;65.6
90;2021-09-05;10;23;98152;91891;70.0;65.6
90;2021-09-06;135;722;98287;92613;70.1;66.1
90;2021-09-07;220;570;98507;93183;70.3;66.5
90;2021-09-08;224;575;98731;93758;70.4;66.9
90;2021-09-09;189;257;98920;94015;70.6;67.1
90;2021-09-10;192;471;99112;94486;70.7;67.4
90;2021-09-11;12;4;99124;94490;70.7;67.4
90;2021-09-12;0;7;99124;94497;70.7;67.4
90;2021-09-13;211;371;99335;94868;70.9;67.7
90;2021-09-14;161;337;99496;95205;71.0;67.9
90;2021-09-15;187;392;99683;95597;71.1;68.2
90;2021-09-16;154;238;99837;95835;71.2;68.4
90;2021-09-17;184;340;100021;96175;71.4;68.6
90;2021-09-18;17;24;100038;96199;71.4;68.6
90;2021-09-19;7;4;100045;96203;71.4;68.6
90;2021-09-20;153;250;100198;96453;71.5;68.8
90;2021-09-21;105;248;100303;96701;71.6;69.0
90;2021-09-22;105;353;100408;97054;71.6;69.3
90;2021-09-23;80;138;100488;97192;71.7;69.4
90;2021-09-24;102;285;100590;97477;71.8;69.6
90;2021-09-25;16;31;100606;97508;71.8;69.6
90;2021-09-26;0;7;100606;97515;71.8;69.6
90;2021-09-27;93;199;100699;97714;71.9;69.7
90;2021-09-28;90;140;100789;97854;71.9;69.8
90;2021-09-29;79;236;100868;98090;72.0;70.0
90;2021-09-30;61;131;100929;98221;72.0;70.1
90;2021-10-01;112;232;101041;98453;72.1;70.3
90;2021-10-02;10;28;101051;98481;72.1;70.3
90;2021-10-03;0;11;101051;98492;72.1;70.3
90;2021-10-04;140;209;101191;98701;72.2;70.4
90;2021-10-05;44;133;101235;98834;72.2;70.5
90;2021-10-06;91;186;101326;99020;72.3;70.7
90;2021-10-07;58;135;101384;99155;72.3;70.8
90;2021-10-08;112;239;101496;99394;72.4;70.9
90;2021-10-09;11;19;101507;99413;72.4;70.9
90;2021-10-10;0;4;101507;99417;72.4;70.9
90;2021-10-11;79;120;101586;99537;72.5;71.0
91;2020-12-27;0;0;0;0;0.0;0.0
91;2020-12-28;0;0;0;0;0.0;0.0
91;2020-12-29;1;0;1;0;0.0;0.0
91;2020-12-30;1;0;2;0;0.0;0.0
91;2020-12-31;0;0;2;0;0.0;0.0
91;2021-01-01;5;0;7;0;0.0;0.0
91;2021-01-02;0;0;7;0;0.0;0.0
91;2021-01-03;0;0;7;0;0.0;0.0
91;2021-01-04;1;0;8;0;0.0;0.0
91;2021-01-05;71;0;79;0;0.0;0.0
91;2021-01-06;189;2;268;2;0.0;0.0
91;2021-01-07;522;7;790;9;0.1;0.0
91;2021-01-08;394;1;1184;10;0.1;0.0
91;2021-01-09;89;3;1273;13;0.1;0.0
91;2021-01-10;1;0;1274;13;0.1;0.0
91;2021-01-11;595;2;1869;15;0.1;0.0
91;2021-01-12;899;8;2768;23;0.2;0.0
91;2021-01-13;703;8;3471;31;0.3;0.0
91;2021-01-14;721;12;4192;43;0.3;0.0
91;2021-01-15;570;4;4762;47;0.4;0.0
91;2021-01-16;316;7;5078;54;0.4;0.0
91;2021-01-17;118;2;5196;56;0.4;0.0
91;2021-01-18;991;3;6187;59;0.5;0.0
91;2021-01-19;1877;31;8064;90;0.6;0.0
91;2021-01-20;2377;42;10441;132;0.8;0.0
91;2021-01-21;2109;24;12550;156;1.0;0.0
91;2021-01-22;1863;11;14413;167;1.1;0.0
91;2021-01-23;413;1;14826;168;1.1;0.0
91;2021-01-24;53;0;14879;168;1.1;0.0
91;2021-01-25;1049;4;15928;172;1.2;0.0
91;2021-01-26;1576;54;17504;226;1.3;0.0
91;2021-01-27;2423;128;19927;354;1.5;0.0
91;2021-01-28;1987;230;21914;584;1.7;0.0
91;2021-01-29;1746;70;23660;654;1.8;0.0
91;2021-01-30;422;9;24082;663;1.8;0.1
91;2021-01-31;54;0;24136;663;1.8;0.1
91;2021-02-01;965;219;25101;882;1.9;0.1
91;2021-02-02;859;365;25960;1247;2.0;0.1
91;2021-02-03;938;570;26898;1817;2.0;0.1
91;2021-02-04;885;279;27783;2096;2.1;0.2
91;2021-02-05;1037;359;28820;2455;2.2;0.2
91;2021-02-06;341;92;29161;2547;2.2;0.2
91;2021-02-07;14;1;29175;2548;2.2;0.2
91;2021-02-08;905;607;30080;3155;2.3;0.2
91;2021-02-09;963;861;31043;4016;2.4;0.3
91;2021-02-10;1065;995;32108;5011;2.4;0.4
91;2021-02-11;1123;1020;33231;6031;2.5;0.5
91;2021-02-12;1064;839;34295;6870;2.6;0.5
91;2021-02-13;332;359;34627;7229;2.6;0.5
91;2021-02-14;18;113;34645;7342;2.6;0.6
91;2021-02-15;369;1252;35014;8594;2.7;0.7
91;2021-02-16;555;1745;35569;10339;2.7;0.8
91;2021-02-17;814;2682;36383;13021;2.8;1.0
91;2021-02-18;944;2017;37327;15038;2.8;1.1
91;2021-02-19;874;1380;38201;16418;2.9;1.2
91;2021-02-20;168;357;38369;16775;2.9;1.3
91;2021-02-21;13;49;38382;16824;2.9;1.3
91;2021-02-22;335;1196;38717;18020;2.9;1.4
91;2021-02-23;398;1068;39115;19088;3.0;1.4
91;2021-02-24;475;1055;39590;20143;3.0;1.5
91;2021-02-25;736;1020;40326;21163;3.1;1.6
91;2021-02-26;1096;1059;41422;22222;3.1;1.7
91;2021-02-27;613;329;42035;22551;3.2;1.7
91;2021-02-28;65;66;42100;22617;3.2;1.7
91;2021-03-01;933;1074;43033;23691;3.3;1.8
91;2021-03-02;1261;1091;44294;24782;3.4;1.9
91;2021-03-03;1467;1281;45761;26063;3.5;2.0
91;2021-03-04;2435;1138;48196;27201;3.7;2.1
91;2021-03-05;3358;1185;51554;28386;3.9;2.2
91;2021-03-06;4913;477;56467;28863;4.3;2.2
91;2021-03-07;3208;123;59675;28986;4.5;2.2
91;2021-03-08;1474;1068;61149;30054;4.6;2.3
91;2021-03-09;2625;1003;63774;31057;4.8;2.4
91;2021-03-10;2627;1055;66401;32112;5.0;2.4
91;2021-03-11;3785;1146;70186;33258;5.3;2.5
91;2021-03-12;4792;1064;74978;34322;5.7;2.6
91;2021-03-13;5258;359;80236;34681;6.1;2.6
91;2021-03-14;305;29;80541;34710;6.1;2.6
91;2021-03-15;2987;446;83528;35156;6.3;2.7
91;2021-03-16;2617;393;86145;35549;6.5;2.7
91;2021-03-17;2227;356;88372;35905;6.7;2.7
91;2021-03-18;2393;418;90765;36323;6.9;2.8
91;2021-03-19;4093;389;94858;36712;7.2;2.8
91;2021-03-20;3608;191;98466;36903;7.5;2.8
91;2021-03-21;138;30;98604;36933;7.5;2.8
91;2021-03-22;3150;609;101754;37542;7.7;2.8
91;2021-03-23;4139;706;105893;38248;8.0;2.9
91;2021-03-24;3937;509;109830;38757;8.3;2.9
91;2021-03-25;5060;538;114890;39295;8.7;3.0
91;2021-03-26;5550;560;120440;39855;9.1;3.0
91;2021-03-27;4982;352;125422;40207;9.5;3.0
91;2021-03-28;282;59;125704;40266;9.5;3.1
91;2021-03-29;3304;1046;129008;41312;9.8;3.1
91;2021-03-30;4426;1239;133434;42551;10.1;3.2
91;2021-03-31;3370;1349;136804;43900;10.4;3.3
91;2021-04-01;3739;1693;140543;45593;10.7;3.5
91;2021-04-02;3887;2321;144430;47914;10.9;3.6
91;2021-04-03;1874;2879;146304;50793;11.1;3.8
91;2021-04-04;647;1320;146951;52113;11.1;3.9
91;2021-04-05;562;135;147513;52248;11.2;4.0
91;2021-04-06;3403;1795;150916;54043;11.4;4.1
91;2021-04-07;3420;1946;154336;55989;11.7;4.2
91;2021-04-08;4664;2179;159000;58168;12.1;4.4
91;2021-04-09;5349;2170;164349;60338;12.5;4.6
91;2021-04-10;2734;2824;167083;63162;12.7;4.8
91;2021-04-11;191;141;167274;63303;12.7;4.8
91;2021-04-12;2854;2283;170128;65586;12.9;5.0
91;2021-04-13;3758;2657;173886;68243;13.2;5.2
91;2021-04-14;3707;2332;177593;70575;13.5;5.3
91;2021-04-15;4477;2527;182070;73102;13.8;5.5
91;2021-04-16;4548;2816;186618;75918;14.1;5.8
91;2021-04-17;2983;2084;189601;78002;14.4;5.9
91;2021-04-18;269;73;189870;78075;14.4;5.9
91;2021-04-19;2306;2743;192176;80818;14.6;6.1
91;2021-04-20;3178;2990;195354;83808;14.8;6.4
91;2021-04-21;2990;2904;198344;86712;15.0;6.6
91;2021-04-22;3171;3370;201515;90082;15.3;6.8
91;2021-04-23;3717;3361;205232;93443;15.6;7.1
91;2021-04-24;3480;3736;208712;97179;15.8;7.4
91;2021-04-25;2619;647;211331;97826;16.0;7.4
91;2021-04-26;3486;2812;214817;100638;16.3;7.6
91;2021-04-27;4486;2929;219303;103567;16.6;7.8
91;2021-04-28;4569;2709;223872;106276;17.0;8.1
91;2021-04-29;5745;3069;229617;109345;17.4;8.3
91;2021-04-30;5385;2857;235002;112202;17.8;8.5
91;2021-05-01;3517;528;238519;112730;18.1;8.5
91;2021-05-02;628;134;239147;112864;18.1;8.6
91;2021-05-03;5202;2292;244349;115156;18.5;8.7
91;2021-05-04;5589;3181;249938;118337;18.9;9.0
91;2021-05-05;4852;2878;254790;121215;19.3;9.2
91;2021-05-06;5245;3381;260035;124596;19.7;9.4
91;2021-05-07;6122;3751;266157;128347;20.2;9.7
91;2021-05-08;6519;968;272676;129315;20.7;9.8
91;2021-05-09;4804;570;277480;129885;21.0;9.8
91;2021-05-10;5901;3010;283381;132895;21.5;10.1
91;2021-05-11;6826;3835;290207;136730;22.0;10.4
91;2021-05-12;5895;3443;296102;140173;22.4;10.6
91;2021-05-13;4825;1083;300927;141256;22.8;10.7
91;2021-05-14;6549;2396;307476;143652;23.3;10.9
91;2021-05-15;7793;1931;315269;145583;23.9;11.0
91;2021-05-16;4584;373;319853;145956;24.2;11.1
91;2021-05-17;6952;1706;326805;147662;24.8;11.2
91;2021-05-18;8120;1743;334925;149405;25.4;11.3
91;2021-05-19;7098;1697;342023;151102;25.9;11.5
91;2021-05-20;8201;2143;350224;153245;26.5;11.6
91;2021-05-21;8146;2580;358370;155825;27.2;11.8
91;2021-05-22;7660;1538;366030;157363;27.7;11.9
91;2021-05-23;4792;535;370822;157898;28.1;12.0
91;2021-05-24;5014;597;375836;158495;28.5;12.0
91;2021-05-25;7621;2655;383457;161150;29.1;12.2
91;2021-05-26;6874;2946;390331;164096;29.6;12.4
91;2021-05-27;7972;3448;398303;167544;30.2;12.7
91;2021-05-28;7534;4326;405837;171870;30.8;13.0
91;2021-05-29;9301;3508;415138;175378;31.5;13.3
91;2021-05-30;5948;964;421086;176342;31.9;13.4
91;2021-05-31;6738;3698;427824;180040;32.4;13.6
91;2021-06-01;7787;4781;435611;184821;33.0;14.0
91;2021-06-02;7454;3961;443065;188782;33.6;14.3
91;2021-06-03;7859;4780;450924;193562;34.2;14.7
91;2021-06-04;7194;5724;458118;199286;34.7;15.1
91;2021-06-05;6385;5821;464503;205107;35.2;15.5
91;2021-06-06;4087;2512;468590;207619;35.5;15.7
91;2021-06-07;5878;5481;474468;213100;36.0;16.2
91;2021-06-08;7039;5795;481507;218895;36.5;16.6
91;2021-06-09;6469;5145;487976;224040;37.0;17.0
91;2021-06-10;7177;5779;495153;229819;37.5;17.4
91;2021-06-11;6546;7111;501699;236930;38.0;18.0
91;2021-06-12;6218;7368;507917;244298;38.5;18.5
91;2021-06-13;2846;2316;510763;246614;38.7;18.7
91;2021-06-14;4225;7198;514988;253812;39.0;19.2
91;2021-06-15;5575;7262;520563;261074;39.5;19.8
91;2021-06-16;5297;6446;525860;267520;39.9;20.3
91;2021-06-17;6251;7131;532111;274651;40.3;20.8
91;2021-06-18;4629;8740;536740;283391;40.7;21.5
91;2021-06-19;4190;7156;540930;290547;41.0;22.0
91;2021-06-20;1007;4212;541937;294759;41.1;22.3
91;2021-06-21;3232;7237;545169;301996;41.3;22.9
91;2021-06-22;4157;9229;549326;311225;41.6;23.6
91;2021-06-23;4315;7961;553641;319186;42.0;24.2
91;2021-06-24;4912;8483;558553;327669;42.3;24.8
91;2021-06-25;3477;9166;562030;336835;42.6;25.5
91;2021-06-26;2989;8034;565019;344869;42.8;26.1
91;2021-06-27;550;2996;565569;347865;42.9;26.4
91;2021-06-28;3129;8237;568698;356102;43.1;27.0
91;2021-06-29;3588;9634;572286;365736;43.4;27.7
91;2021-06-30;3954;8702;576240;374438;43.7;28.4
91;2021-07-01;4103;8873;580343;383311;44.0;29.1
91;2021-07-02;3775;9320;584118;392631;44.3;29.8
91;2021-07-03;2881;9789;586999;402420;44.5;30.5
91;2021-07-04;852;4726;587851;407146;44.6;30.9
91;2021-07-05;2662;7258;590513;414404;44.8;31.4
91;2021-07-06;3758;9431;594271;423835;45.0;32.1
91;2021-07-07;3806;8592;598077;432427;45.3;32.8
91;2021-07-08;4358;8992;602435;441419;45.7;33.5
91;2021-07-09;3968;9953;606403;451372;46.0;34.2
91;2021-07-10;3397;10236;609800;461608;46.2;35.0
91;2021-07-11;987;4804;610787;466412;46.3;35.4
91;2021-07-12;2804;8887;613591;475299;46.5;36.0
91;2021-07-13;4467;10393;618058;485692;46.8;36.8
91;2021-07-14;2304;3586;620362;489278;47.0;37.1
91;2021-07-15;4537;9824;624899;499102;47.4;37.8
91;2021-07-16;6287;9768;631186;508870;47.8;38.6
91;2021-07-17;5751;9069;636937;517939;48.3;39.3
91;2021-07-18;3402;3686;640339;521625;48.5;39.5
91;2021-07-19;3777;7538;644116;529163;48.8;40.1
91;2021-07-20;6074;9310;650190;538473;49.3;40.8
91;2021-07-21;6252;7740;656442;546213;49.8;41.4
91;2021-07-22;6497;8401;662939;554614;50.2;42.0
91;2021-07-23;6926;8288;669865;562902;50.8;42.7
91;2021-07-24;5013;6481;674878;569383;51.2;43.2
91;2021-07-25;3267;1408;678145;570791;51.4;43.3
91;2021-07-26;4935;6592;683080;577383;51.8;43.8
91;2021-07-27;7567;7084;690647;584467;52.3;44.3
91;2021-07-28;7365;5924;698012;590391;52.9;44.7
91;2021-07-29;7400;5915;705412;596306;53.5;45.2
91;2021-07-30;6914;5783;712326;602089;54.0;45.6
91;2021-07-31;4910;4790;717236;606879;54.4;46.0
91;2021-08-01;2659;1340;719895;608219;54.6;46.1
91;2021-08-02;4841;4237;724736;612456;54.9;46.4
91;2021-08-03;6172;4696;730908;617152;55.4;46.8
91;2021-08-04;5701;4143;736609;621295;55.8;47.1
91;2021-08-05;5607;4272;742216;625567;56.3;47.4
91;2021-08-06;5711;5630;747927;631197;56.7;47.8
91;2021-08-07;3084;2419;751011;633616;56.9;48.0
91;2021-08-08;622;1102;751633;634718;57.0;48.1
91;2021-08-09;3836;3978;755469;638696;57.3;48.4
91;2021-08-10;4650;4555;760119;643251;57.6;48.8
91;2021-08-11;4152;4487;764271;647738;57.9;49.1
91;2021-08-12;4091;4785;768362;652523;58.2;49.5
91;2021-08-13;4301;4866;772663;657389;58.6;49.8
91;2021-08-14;2246;2402;774909;659791;58.7;50.0
91;2021-08-15;95;171;775004;659962;58.7;50.0
91;2021-08-16;3105;4664;778109;664626;59.0;50.4
91;2021-08-17;3654;5822;781763;670448;59.3;50.8
91;2021-08-18;3029;5797;784792;676245;59.5;51.3
91;2021-08-19;3481;5775;788273;682020;59.7;51.7
91;2021-08-20;3220;6958;791493;688978;60.0;52.2
91;2021-08-21;2464;3355;793957;692333;60.2;52.5
91;2021-08-22;738;1297;794695;693630;60.2;52.6
91;2021-08-23;2429;5311;797124;698941;60.4;53.0
91;2021-08-24;2987;6963;800111;705904;60.6;53.5
91;2021-08-25;3437;6723;803548;712627;60.9;54.0
91;2021-08-26;2749;5953;806297;718580;61.1;54.5
91;2021-08-27;2836;7504;809133;726084;61.3;55.0
91;2021-08-28;2390;4836;811523;730920;61.5;55.4
91;2021-08-29;1782;2800;813305;733720;61.6;55.6
91;2021-08-30;1805;5547;815110;739267;61.8;56.0
91;2021-08-31;2258;5916;817368;745183;61.9;56.5
91;2021-09-01;2463;4377;819831;749560;62.1;56.8
91;2021-09-02;1948;3568;821779;753128;62.3;57.1
91;2021-09-03;2184;4652;823963;757780;62.4;57.4
91;2021-09-04;2085;4095;826048;761875;62.6;57.7
91;2021-09-05;748;879;826796;762754;62.7;57.8
91;2021-09-06;1707;2991;828503;765745;62.8;58.0
91;2021-09-07;1569;2793;830072;768538;62.9;58.2
91;2021-09-08;1795;3082;831867;771620;63.0;58.5
91;2021-09-09;1312;2814;833179;774434;63.1;58.7
91;2021-09-10;1804;3554;834983;777988;63.3;59.0
91;2021-09-11;1749;4286;836732;782274;63.4;59.3
91;2021-09-12;627;944;837359;783218;63.5;59.4
91;2021-09-13;1289;2290;838648;785508;63.6;59.5
91;2021-09-14;1829;2656;840477;788164;63.7;59.7
91;2021-09-15;1661;3286;842138;791450;63.8;60.0
91;2021-09-16;1497;2385;843635;793835;63.9;60.2
91;2021-09-17;1441;3000;845076;796835;64.0;60.4
91;2021-09-18;1388;3669;846464;800504;64.2;60.7
91;2021-09-19;460;1149;846924;801653;64.2;60.8
91;2021-09-20;771;1598;847695;803251;64.2;60.9
91;2021-09-21;884;1750;848579;805001;64.3;61.0
91;2021-09-22;926;2641;849505;807642;64.4;61.2
91;2021-09-23;928;1734;850433;809376;64.5;61.3
91;2021-09-24;897;2201;851330;811577;64.5;61.5
91;2021-09-25;1052;3483;852382;815060;64.6;61.8
91;2021-09-26;217;821;852599;815881;64.6;61.8
91;2021-09-27;729;1570;853328;817451;64.7;62.0
91;2021-09-28;899;1442;854227;818893;64.7;62.1
91;2021-09-29;1014;2226;855241;821119;64.8;62.2
91;2021-09-30;662;1131;855903;822250;64.9;62.3
91;2021-10-01;965;1875;856868;824125;64.9;62.5
91;2021-10-02;1106;2390;857974;826515;65.0;62.6
91;2021-10-03;266;613;858240;827128;65.0;62.7
91;2021-10-04;619;1167;858859;828295;65.1;62.8
91;2021-10-05;590;1113;859449;829408;65.1;62.9
91;2021-10-06;778;1925;860227;831333;65.2;63.0
91;2021-10-07;569;1125;860796;832458;65.2;63.1
91;2021-10-08;787;1752;861583;834210;65.3;63.2
91;2021-10-09;1075;1993;862658;836203;65.4;63.4
91;2021-10-10;281;515;862939;836718;65.4;63.4
91;2021-10-11;580;1143;863519;837861;65.4;63.5
92;2020-12-27;47;5;47;5;0.0;0.0
92;2020-12-28;30;1;77;6;0.0;0.0
92;2020-12-29;66;2;143;8;0.0;0.0
92;2020-12-30;53;5;196;13;0.0;0.0
92;2020-12-31;13;1;209;14;0.0;0.0
92;2021-01-01;38;3;247;17;0.0;0.0
92;2021-01-02;16;0;263;17;0.0;0.0
92;2021-01-03;19;1;282;18;0.0;0.0
92;2021-01-04;80;5;362;23;0.0;0.0
92;2021-01-05;237;4;599;27;0.0;0.0
92;2021-01-06;421;4;1020;31;0.1;0.0
92;2021-01-07;674;9;1694;40;0.1;0.0
92;2021-01-08;851;4;2545;44;0.2;0.0
92;2021-01-09;130;6;2675;50;0.2;0.0
92;2021-01-10;53;2;2728;52;0.2;0.0
92;2021-01-11;853;12;3581;64;0.2;0.0
92;2021-01-12;1309;13;4890;77;0.3;0.0
92;2021-01-13;1254;17;6144;94;0.4;0.0
92;2021-01-14;1245;32;7389;126;0.5;0.0
92;2021-01-15;986;11;8375;137;0.5;0.0
92;2021-01-16;187;4;8562;141;0.5;0.0
92;2021-01-17;35;2;8597;143;0.5;0.0
92;2021-01-18;1557;34;10154;177;0.6;0.0
92;2021-01-19;1578;31;11732;208;0.7;0.0
92;2021-01-20;1827;20;13559;228;0.8;0.0
92;2021-01-21;3455;36;17014;264;1.1;0.0
92;2021-01-22;2627;47;19641;311;1.2;0.0
92;2021-01-23;154;9;19795;320;1.2;0.0
92;2021-01-24;36;3;19831;323;1.2;0.0
92;2021-01-25;862;20;20693;343;1.3;0.0
92;2021-01-26;1220;14;21913;357;1.4;0.0
92;2021-01-27;2226;109;24139;466;1.5;0.0
92;2021-01-28;4201;209;28340;675;1.8;0.0
92;2021-01-29;2721;268;31061;943;1.9;0.1
92;2021-01-30;327;18;31388;961;1.9;0.1
92;2021-01-31;36;6;31424;967;1.9;0.1
92;2021-02-01;877;324;32301;1291;2.0;0.1
92;2021-02-02;1073;355;33374;1646;2.1;0.1
92;2021-02-03;1006;447;34380;2093;2.1;0.1
92;2021-02-04;1058;548;35438;2641;2.2;0.2
92;2021-02-05;1336;503;36774;3144;2.3;0.2
92;2021-02-06;128;24;36902;3168;2.3;0.2
92;2021-02-07;24;19;36926;3187;2.3;0.2
92;2021-02-08;589;733;37515;3920;2.3;0.2
92;2021-02-09;1074;1305;38589;5225;2.4;0.3
92;2021-02-10;1094;1313;39683;6538;2.5;0.4
92;2021-02-11;1520;1941;41203;8479;2.6;0.5
92;2021-02-12;1426;1486;42629;9965;2.6;0.6
92;2021-02-13;80;68;42709;10033;2.6;0.6
92;2021-02-14;31;6;42740;10039;2.6;0.6
92;2021-02-15;584;1653;43324;11692;2.7;0.7
92;2021-02-16;793;2047;44117;13739;2.7;0.9
92;2021-02-17;630;1761;44747;15500;2.8;1.0
92;2021-02-18;1583;3654;46330;19154;2.9;1.2
92;2021-02-19;1736;2665;48066;21819;3.0;1.4
92;2021-02-20;150;400;48216;22219;3.0;1.4
92;2021-02-21;51;55;48267;22274;3.0;1.4
92;2021-02-22;505;1214;48772;23488;3.0;1.5
92;2021-02-23;746;1364;49518;24852;3.1;1.5
92;2021-02-24;620;1291;50138;26143;3.1;1.6
92;2021-02-25;935;1797;51073;27940;3.2;1.7
92;2021-02-26;1468;1372;52541;29312;3.3;1.8
92;2021-02-27;507;190;53048;29502;3.3;1.8
92;2021-02-28;75;58;53123;29560;3.3;1.8
92;2021-03-01;1106;1058;54229;30618;3.4;1.9
92;2021-03-02;1986;1384;56215;32002;3.5;2.0
92;2021-03-03;2812;1110;59027;33112;3.7;2.1
92;2021-03-04;3607;1543;62634;34655;3.9;2.1
92;2021-03-05;4986;1746;67620;36401;4.2;2.3
92;2021-03-06;5727;350;73347;36751;4.5;2.3
92;2021-03-07;2908;242;76255;36993;4.7;2.3
92;2021-03-08;2430;833;78685;37826;4.9;2.3
92;2021-03-09;3449;1049;82134;38875;5.1;2.4
92;2021-03-10;3953;971;86087;39846;5.3;2.5
92;2021-03-11;5028;1432;91115;41278;5.6;2.6
92;2021-03-12;6779;1589;97894;42867;6.1;2.7
92;2021-03-13;5163;256;103057;43123;6.4;2.7
92;2021-03-14;1747;81;104804;43204;6.5;2.7
92;2021-03-15;3811;624;108615;43828;6.7;2.7
92;2021-03-16;3701;615;112316;44443;7.0;2.8
92;2021-03-17;3881;440;116197;44883;7.2;2.8
92;2021-03-18;4150;769;120347;45652;7.5;2.8
92;2021-03-19;5936;763;126283;46415;7.8;2.9
92;2021-03-20;2544;84;128827;46499;8.0;2.9
92;2021-03-21;156;33;128983;46532;8.0;2.9
92;2021-03-22;4120;494;133103;47026;8.2;2.9
92;2021-03-23;6112;896;139215;47922;8.6;3.0
92;2021-03-24;6385;677;145600;48599;9.0;3.0
92;2021-03-25;8446;675;154046;49274;9.5;3.1
92;2021-03-26;8363;914;162409;50188;10.1;3.1
92;2021-03-27;2838;286;165247;50474;10.2;3.1
92;2021-03-28;543;40;165790;50514;10.3;3.1
92;2021-03-29;4672;1076;170462;51590;10.6;3.2
92;2021-03-30;6396;1570;176858;53160;11.0;3.3
92;2021-03-31;5556;2275;182414;55435;11.3;3.4
92;2021-04-01;6280;3701;188694;59136;11.7;3.7
92;2021-04-02;5639;3448;194333;62584;12.0;3.9
92;2021-04-03;878;1425;195211;64009;12.1;4.0
92;2021-04-04;493;1065;195704;65074;12.1;4.0
92;2021-04-05;819;163;196523;65237;12.2;4.0
92;2021-04-06;3666;1975;200189;67212;12.4;4.2
92;2021-04-07;5005;2900;205194;70112;12.7;4.3
92;2021-04-08;5994;3206;211188;73318;13.1;4.5
92;2021-04-09;8039;3090;219227;76408;13.6;4.7
92;2021-04-10;2647;1305;221874;77713;13.7;4.8
92;2021-04-11;171;810;222045;78523;13.8;4.9
92;2021-04-12;3690;2529;225735;81052;14.0;5.0
92;2021-04-13;4389;4444;230124;85496;14.3;5.3
92;2021-04-14;4878;4053;235002;89549;14.6;5.5
92;2021-04-15;5305;3968;240307;93517;14.9;5.8
92;2021-04-16;5079;3876;245386;97393;15.2;6.0
92;2021-04-17;1807;1198;247193;98591;15.3;6.1
92;2021-04-18;351;97;247544;98688;15.3;6.1
92;2021-04-19;2821;2848;250365;101536;15.5;6.3
92;2021-04-20;4200;3764;254565;105300;15.8;6.5
92;2021-04-21;4620;4527;259185;109827;16.1;6.8
92;2021-04-22;4664;5135;263849;114962;16.3;7.1
92;2021-04-23;5262;4738;269111;119700;16.7;7.4
92;2021-04-24;4944;1919;274055;121619;17.0;7.5
92;2021-04-25;1798;153;275853;121772;17.1;7.5
92;2021-04-26;4004;3630;279857;125402;17.3;7.8
92;2021-04-27;6048;5276;285905;130678;17.7;8.1
92;2021-04-28;7385;4519;293290;135197;18.2;8.4
92;2021-04-29;7995;4806;301285;140003;18.7;8.7
92;2021-04-30;8847;4864;310132;144867;19.2;9.0
92;2021-05-01;1203;413;311335;145280;19.3;9.0
92;2021-05-02;670;141;312005;145421;19.3;9.0
92;2021-05-03;6790;3894;318795;149315;19.8;9.3
92;2021-05-04;10435;4381;329230;153696;20.4;9.5
92;2021-05-05;10078;5260;339308;158956;21.0;9.9
92;2021-05-06;11427;4911;350735;163867;21.7;10.2
92;2021-05-07;9867;5310;360602;169177;22.3;10.5
92;2021-05-08;7215;1925;367817;171102;22.8;10.6
92;2021-05-09;3786;601;371603;171703;23.0;10.6
92;2021-05-10;9547;4008;381150;175711;23.6;10.9
92;2021-05-11;13980;5699;395130;181410;24.5;11.2
92;2021-05-12;14287;4585;409417;185995;25.4;11.5
92;2021-05-13;9168;911;418585;186906;25.9;11.6
92;2021-05-14;12030;2313;430615;189219;26.7;11.7
92;2021-05-15;8393;1230;439008;190449;27.2;11.8
92;2021-05-16;4143;453;443151;190902;27.5;11.8
92;2021-05-17;10649;2216;453800;193118;28.1;12.0
92;2021-05-18;16410;3122;470210;196240;29.1;12.2
92;2021-05-19;16045;3718;486255;199958;30.1;12.4
92;2021-05-20;16840;3985;503095;203943;31.2;12.6
92;2021-05-21;14071;3622;517166;207565;32.0;12.9
92;2021-05-22;8318;1515;525484;209080;32.6;13.0
92;2021-05-23;4083;454;529567;209534;32.8;13.0
92;2021-05-24;6121;856;535688;210390;33.2;13.0
92;2021-05-25;13114;4566;548802;214956;34.0;13.3
92;2021-05-26;11925;5038;560727;219994;34.7;13.6
92;2021-05-27;12736;6327;573463;226321;35.5;14.0
92;2021-05-28;11234;6290;584697;232611;36.2;14.4
92;2021-05-29;5451;2304;590148;234915;36.6;14.6
92;2021-05-30;2252;389;592400;235304;36.7;14.6
92;2021-05-31;12049;5299;604449;240603;37.5;14.9
92;2021-06-01;12635;7639;617084;248242;38.2;15.4
92;2021-06-02;14380;7207;631464;255449;39.1;15.8
92;2021-06-03;14599;8031;646063;263480;40.0;16.3
92;2021-06-04;12237;8226;658300;271706;40.8;16.8
92;2021-06-05;7383;6232;665683;277938;41.3;17.2
92;2021-06-06;3597;1675;669280;279613;41.5;17.3
92;2021-06-07;11435;7637;680715;287250;42.2;17.8
92;2021-06-08;12766;9605;693481;296855;43.0;18.4
92;2021-06-09;11663;9474;705144;306329;43.7;19.0
92;2021-06-10;11968;10570;717112;316899;44.4;19.6
92;2021-06-11;8156;11038;725268;327937;44.9;20.3
92;2021-06-12;6364;5093;731632;333030;45.3;20.6
92;2021-06-13;3971;2720;735603;335750;45.6;20.8
92;2021-06-14;5213;11171;740816;346921;45.9;21.5
92;2021-06-15;6539;13128;747355;360049;46.3;22.3
92;2021-06-16;6954;12993;754309;373042;46.7;23.1
92;2021-06-17;7429;14003;761738;387045;47.2;24.0
92;2021-06-18;6907;14387;768645;401432;47.6;24.9
92;2021-06-19;3969;9107;772614;410539;47.9;25.4
92;2021-06-20;1968;5606;774582;416145;48.0;25.8
92;2021-06-21;4841;12276;779423;428421;48.3;26.5
92;2021-06-22;5880;17539;785303;445960;48.7;27.6
92;2021-06-23;5486;15992;790789;461952;49.0;28.6
92;2021-06-24;6210;15119;796999;477071;49.4;29.6
92;2021-06-25;5121;16098;802120;493169;49.7;30.6
92;2021-06-26;4070;10454;806190;503623;50.0;31.2
92;2021-06-27;1858;6046;808048;509669;50.1;31.6
92;2021-06-28;3674;12048;811722;521717;50.3;32.3
92;2021-06-29;4679;18154;816401;539871;50.6;33.5
92;2021-06-30;4455;16227;820856;556098;50.9;34.5
92;2021-07-01;5525;16306;826381;572404;51.2;35.5
92;2021-07-02;4943;15286;831324;587690;51.5;36.4
92;2021-07-03;3308;10185;834632;597875;51.7;37.0
92;2021-07-04;1125;4208;835757;602083;51.8;37.3
92;2021-07-05;4826;12332;840583;614415;52.1;38.1
92;2021-07-06;5288;15812;845871;630227;52.4;39.1
92;2021-07-07;4269;11463;850140;641690;52.7;39.8
92;2021-07-08;5409;14638;855549;656328;53.0;40.7
92;2021-07-09;5899;14205;861448;670533;53.4;41.6
92;2021-07-10;4378;8458;865826;678991;53.7;42.1
92;2021-07-11;1487;2617;867313;681608;53.7;42.2
92;2021-07-12;4418;14646;871731;696254;54.0;43.1
92;2021-07-13;7881;17460;879612;713714;54.5;44.2
92;2021-07-14;5115;5746;884727;719460;54.8;44.6
92;2021-07-15;9570;16256;894297;735716;55.4;45.6
92;2021-07-16;9065;14190;903362;749906;56.0;46.5
92;2021-07-17;6582;7605;909944;757511;56.4;46.9
92;2021-07-18;1842;2482;911786;759993;56.5;47.1
92;2021-07-19;6481;13204;918267;773197;56.9;47.9
92;2021-07-20;10094;14114;928361;787311;57.5;48.8
92;2021-07-21;10472;12124;938833;799435;58.2;49.5
92;2021-07-22;12060;12997;950893;812432;58.9;50.3
92;2021-07-23;11593;11359;962486;823791;59.6;51.0
92;2021-07-24;6733;6271;969219;830062;60.1;51.4
92;2021-07-25;2778;2329;971997;832391;60.2;51.6
92;2021-07-26;9491;9180;981488;841571;60.8;52.1
92;2021-07-27;11524;9624;993012;851195;61.5;52.7
92;2021-07-28;12946;8209;1005958;859404;62.3;53.3
92;2021-07-29;10456;8639;1016414;868043;63.0;53.8
92;2021-07-30;9131;8358;1025545;876401;63.5;54.3
92;2021-07-31;5703;4825;1031248;881226;63.9;54.6
92;2021-08-01;2220;1301;1033468;882527;64.0;54.7
92;2021-08-02;4800;4939;1038268;887466;64.3;55.0
92;2021-08-03;5144;6149;1043412;893615;64.7;55.4
92;2021-08-04;4779;4875;1048191;898490;65.0;55.7
92;2021-08-05;4532;5694;1052723;904184;65.2;56.0
92;2021-08-06;4553;5974;1057276;910158;65.5;56.4
92;2021-08-07;2839;4183;1060115;914341;65.7;56.7
92;2021-08-08;964;1082;1061079;915423;65.8;56.7
92;2021-08-09;3212;4255;1064291;919678;66.0;57.0
92;2021-08-10;3838;5613;1068129;925291;66.2;57.3
92;2021-08-11;3239;4436;1071368;929727;66.4;57.6
92;2021-08-12;3397;5602;1074765;935329;66.6;58.0
92;2021-08-13;2999;5148;1077764;940477;66.8;58.3
92;2021-08-14;1887;3931;1079651;944408;66.9;58.5
92;2021-08-15;592;839;1080243;945247;66.9;58.6
92;2021-08-16;2406;5326;1082649;950573;67.1;58.9
92;2021-08-17;2637;6993;1085286;957566;67.3;59.3
92;2021-08-18;2432;5256;1087718;962822;67.4;59.7
92;2021-08-19;2528;5745;1090246;968567;67.6;60.0
92;2021-08-20;2286;5199;1092532;973766;67.7;60.3
92;2021-08-21;1396;4224;1093928;977990;67.8;60.6
92;2021-08-22;427;1599;1094355;979589;67.8;60.7
92;2021-08-23;2496;6602;1096851;986191;68.0;61.1
92;2021-08-24;3156;8351;1100007;994542;68.2;61.6
92;2021-08-25;2865;7585;1102872;1002127;68.3;62.1
92;2021-08-26;3019;7579;1105891;1009706;68.5;62.6
92;2021-08-27;3105;7017;1108996;1016723;68.7;63.0
92;2021-08-28;1624;4517;1110620;1021240;68.8;63.3
92;2021-08-29;345;789;1110965;1022029;68.8;63.3
92;2021-08-30;2257;4704;1113222;1026733;69.0;63.6
92;2021-08-31;3097;6629;1116319;1033362;69.2;64.0
92;2021-09-01;3371;6891;1119690;1040253;69.4;64.5
92;2021-09-02;2668;6049;1122358;1046302;69.5;64.8
92;2021-09-03;2704;5787;1125062;1052089;69.7;65.2
92;2021-09-04;2351;4773;1127413;1056862;69.9;65.5
92;2021-09-05;445;921;1127858;1057783;69.9;65.5
92;2021-09-06;1335;2989;1129193;1060772;70.0;65.7
92;2021-09-07;1717;3329;1130910;1064101;70.1;65.9
92;2021-09-08;2186;3617;1133096;1067718;70.2;66.2
92;2021-09-09;1241;2617;1134337;1070335;70.3;66.3
92;2021-09-10;1801;3386;1136138;1073721;70.4;66.5
92;2021-09-11;1605;2714;1137743;1076435;70.5;66.7
92;2021-09-12;213;433;1137956;1076868;70.5;66.7
92;2021-09-13;1123;2224;1139079;1079092;70.6;66.9
92;2021-09-14;1240;2403;1140319;1081495;70.7;67.0
92;2021-09-15;1598;3631;1141917;1085126;70.8;67.2
92;2021-09-16;1092;2167;1143009;1087293;70.8;67.4
92;2021-09-17;1440;3100;1144449;1090393;70.9;67.6
92;2021-09-18;970;2235;1145419;1092628;71.0;67.7
92;2021-09-19;128;290;1145547;1092918;71.0;67.7
92;2021-09-20;782;1833;1146329;1094751;71.0;67.8
92;2021-09-21;780;1871;1147109;1096622;71.1;68.0
92;2021-09-22;1078;3817;1148187;1100439;71.1;68.2
92;2021-09-23;739;1824;1148926;1102263;71.2;68.3
92;2021-09-24;1094;2854;1150020;1105117;71.3;68.5
92;2021-09-25;620;2212;1150640;1107329;71.3;68.6
92;2021-09-26;95;249;1150735;1107578;71.3;68.6
92;2021-09-27;769;1631;1151504;1109209;71.4;68.7
92;2021-09-28;786;1571;1152290;1110780;71.4;68.8
92;2021-09-29;1136;2835;1153426;1113615;71.5;69.0
92;2021-09-30;850;1329;1154276;1114944;71.5;69.1
92;2021-10-01;1128;2099;1155404;1117043;71.6;69.2
92;2021-10-02;799;1805;1156203;1118848;71.6;69.3
92;2021-10-03;89;205;1156292;1119053;71.7;69.3
92;2021-10-04;700;1311;1156992;1120364;71.7;69.4
92;2021-10-05;731;1318;1157723;1121682;71.7;69.5
92;2021-10-06;1057;1988;1158780;1123670;71.8;69.6
92;2021-10-07;527;925;1159307;1124595;71.8;69.7
92;2021-10-08;1105;1855;1160412;1126450;71.9;69.8
92;2021-10-09;707;1365;1161119;1127815;72.0;69.9
92;2021-10-10;101;126;1161220;1127941;72.0;69.9
92;2021-10-11;654;971;1161874;1128912;72.0;70.0
93;2020-12-27;12;3;12;3;0.0;0.0
93;2020-12-28;6;2;18;5;0.0;0.0
93;2020-12-29;2;0;20;5;0.0;0.0
93;2020-12-30;44;1;64;6;0.0;0.0
93;2020-12-31;11;0;75;6;0.0;0.0
93;2021-01-01;5;0;80;6;0.0;0.0
93;2021-01-02;1;0;81;6;0.0;0.0
93;2021-01-03;4;0;85;6;0.0;0.0
93;2021-01-04;3;1;88;7;0.0;0.0
93;2021-01-05;66;3;154;10;0.0;0.0
93;2021-01-06;179;0;333;10;0.0;0.0
93;2021-01-07;381;3;714;13;0.0;0.0
93;2021-01-08;634;2;1348;15;0.1;0.0
93;2021-01-09;21;0;1369;15;0.1;0.0
93;2021-01-10;2;0;1371;15;0.1;0.0
93;2021-01-11;505;5;1876;20;0.1;0.0
93;2021-01-12;753;7;2629;27;0.2;0.0
93;2021-01-13;752;7;3381;34;0.2;0.0
93;2021-01-14;690;18;4071;52;0.2;0.0
93;2021-01-15;515;4;4586;56;0.3;0.0
93;2021-01-16;138;3;4724;59;0.3;0.0
93;2021-01-17;6;1;4730;60;0.3;0.0
93;2021-01-18;1198;13;5928;73;0.4;0.0
93;2021-01-19;1614;20;7542;93;0.5;0.0
93;2021-01-20;1557;20;9099;113;0.5;0.0
93;2021-01-21;1921;38;11020;151;0.7;0.0
93;2021-01-22;1391;18;12411;169;0.7;0.0
93;2021-01-23;713;8;13124;177;0.8;0.0
93;2021-01-24;0;0;13124;177;0.8;0.0
93;2021-01-25;1209;15;14333;192;0.9;0.0
93;2021-01-26;1297;35;15630;227;0.9;0.0
93;2021-01-27;2158;76;17788;303;1.1;0.0
93;2021-01-28;2268;213;20056;516;1.2;0.0
93;2021-01-29;1625;233;21681;749;1.3;0.0
93;2021-01-30;928;48;22609;797;1.4;0.0
93;2021-01-31;10;8;22619;805;1.4;0.0
93;2021-02-01;1187;175;23806;980;1.4;0.1
93;2021-02-02;1174;306;24980;1286;1.5;0.1
93;2021-02-03;1231;398;26211;1684;1.6;0.1
93;2021-02-04;926;566;27137;2250;1.6;0.1
93;2021-02-05;800;433;27937;2683;1.7;0.2
93;2021-02-06;694;73;28631;2756;1.7;0.2
93;2021-02-07;6;0;28637;2756;1.7;0.2
93;2021-02-08;915;645;29552;3401;1.8;0.2
93;2021-02-09;852;603;30404;4004;1.8;0.2
93;2021-02-10;883;677;31287;4681;1.9;0.3
93;2021-02-11;1244;839;32531;5520;1.9;0.3
93;2021-02-12;1041;641;33572;6161;2.0;0.4
93;2021-02-13;395;267;33967;6428;2.0;0.4
93;2021-02-14;13;59;33980;6487;2.0;0.4
93;2021-02-15;414;1261;34394;7748;2.1;0.5
93;2021-02-16;552;1232;34946;8980;2.1;0.5
93;2021-02-17;541;1751;35487;10731;2.1;0.6
93;2021-02-18;1136;1870;36623;12601;2.2;0.8
93;2021-02-19;994;1542;37617;14143;2.3;0.8
93;2021-02-20;304;665;37921;14808;2.3;0.9
93;2021-02-21;10;24;37931;14832;2.3;0.9
93;2021-02-22;602;1289;38533;16121;2.3;1.0
93;2021-02-23;560;1122;39093;17243;2.3;1.0
93;2021-02-24;646;1218;39739;18461;2.4;1.1
93;2021-02-25;901;1075;40640;19536;2.4;1.2
93;2021-02-26;1121;980;41761;20516;2.5;1.2
93;2021-02-27;543;623;42304;21139;2.5;1.3
93;2021-02-28;88;57;42392;21196;2.5;1.3
93;2021-03-01;1083;1073;43475;22269;2.6;1.3
93;2021-03-02;1448;1151;44923;23420;2.7;1.4
93;2021-03-03;1748;1198;46671;24618;2.8;1.5
93;2021-03-04;2718;1146;49389;25764;3.0;1.5
93;2021-03-05;3820;917;53209;26681;3.2;1.6
93;2021-03-06;5051;592;58260;27273;3.5;1.6
93;2021-03-07;4300;255;62560;27528;3.7;1.6
93;2021-03-08;2037;1277;64597;28805;3.9;1.7
93;2021-03-09;2915;984;67512;29789;4.0;1.8
93;2021-03-10;2861;1130;70373;30919;4.2;1.9
93;2021-03-11;3575;1284;73948;32203;4.4;1.9
93;2021-03-12;4124;1321;78072;33524;4.7;2.0
93;2021-03-13;4290;654;82362;34178;4.9;2.0
93;2021-03-14;884;80;83246;34258;5.0;2.1
93;2021-03-15;3556;703;86802;34961;5.2;2.1
93;2021-03-16;3157;627;89959;35588;5.4;2.1
93;2021-03-17;2656;607;92615;36195;5.5;2.2
93;2021-03-18;3319;739;95934;36934;5.7;2.2
93;2021-03-19;3767;667;99701;37601;6.0;2.3
93;2021-03-20;3460;309;103161;37910;6.2;2.3
93;2021-03-21;813;273;103974;38183;6.2;2.3
93;2021-03-22;3852;636;107826;38819;6.5;2.3
93;2021-03-23;4766;825;112592;39644;6.7;2.4
93;2021-03-24;4114;701;116706;40345;7.0;2.4
93;2021-03-25;5587;883;122293;41228;7.3;2.5
93;2021-03-26;5547;911;127840;42139;7.7;2.5
93;2021-03-27;4283;329;132123;42468;7.9;2.5
93;2021-03-28;613;44;132736;42512;7.9;2.5
93;2021-03-29;3851;977;136587;43489;8.2;2.6
93;2021-03-30;4726;1283;141313;44772;8.5;2.7
93;2021-03-31;3914;1265;145227;46037;8.7;2.8
93;2021-04-01;4055;3159;149282;49196;8.9;2.9
93;2021-04-02;3224;3572;152506;52768;9.1;3.2
93;2021-04-03;2517;2271;155023;55039;9.3;3.3
93;2021-04-04;765;166;155788;55205;9.3;3.3
93;2021-04-05;708;92;156496;55297;9.4;3.3
93;2021-04-06;4564;2369;161060;57666;9.6;3.5
93;2021-04-07;4903;2111;165963;59777;9.9;3.6
93;2021-04-08;5814;2704;171777;62481;10.3;3.7
93;2021-04-09;6097;3212;177874;65693;10.7;3.9
93;2021-04-10;4200;2500;182074;68193;10.9;4.1
93;2021-04-11;575;437;182649;68630;10.9;4.1
93;2021-04-12;4100;2929;186749;71559;11.2;4.3
93;2021-04-13;4606;3673;191355;75232;11.5;4.5
93;2021-04-14;4367;2492;195722;77724;11.7;4.7
93;2021-04-15;4560;3053;200282;80777;12.0;4.8
93;2021-04-16;4442;3008;204724;83785;12.3;5.0
93;2021-04-17;3517;2508;208241;86293;12.5;5.2
93;2021-04-18;289;434;208530;86727;12.5;5.2
93;2021-04-19;3775;2879;212305;89606;12.7;5.4
93;2021-04-20;4308;3284;216613;92890;13.0;5.6
93;2021-04-21;4145;2788;220758;95678;13.2;5.7
93;2021-04-22;4513;4033;225271;99711;13.5;6.0
93;2021-04-23;5628;3264;230899;102975;13.8;6.2
93;2021-04-24;5921;3338;236820;106313;14.2;6.4
93;2021-04-25;1733;599;238553;106912;14.3;6.4
93;2021-04-26;4864;3100;243417;110012;14.6;6.6
93;2021-04-27;6454;3637;249871;113649;15.0;6.8
93;2021-04-28;6071;3444;255942;117093;15.3;7.0
93;2021-04-29;7301;3258;263243;120351;15.8;7.2
93;2021-04-30;8267;3135;271510;123486;16.3;7.4
93;2021-05-01;4948;1198;276458;124684;16.6;7.5
93;2021-05-02;419;649;276877;125333;16.6;7.5
93;2021-05-03;8175;5134;285052;130467;17.1;7.8
93;2021-05-04;7824;5412;292876;135879;17.5;8.1
93;2021-05-05;7578;4818;300454;140697;18.0;8.4
93;2021-05-06;8252;4790;308706;145487;18.5;8.7
93;2021-05-07;7016;5439;315722;150926;18.9;9.0
93;2021-05-08;8363;2399;324085;153325;19.4;9.2
93;2021-05-09;6125;1373;330210;154698;19.8;9.3
93;2021-05-10;8259;4084;338469;158782;20.3;9.5
93;2021-05-11;9308;4814;347777;163596;20.8;9.8
93;2021-05-12;9194;3659;356971;167255;21.4;10.0
93;2021-05-13;8302;1654;365273;168909;21.9;10.1
93;2021-05-14;10421;3533;375694;172442;22.5;10.3
93;2021-05-15;11125;3011;386819;175453;23.2;10.5
93;2021-05-16;5558;728;392377;176181;23.5;10.5
93;2021-05-17;11903;2269;404280;178450;24.2;10.7
93;2021-05-18;14100;2388;418380;180838;25.1;10.8
93;2021-05-19;11433;2945;429813;183783;25.7;11.0
93;2021-05-20;12624;3487;442437;187270;26.5;11.2
93;2021-05-21;13015;2888;455452;190158;27.3;11.4
93;2021-05-22;12376;2202;467828;192360;28.0;11.5
93;2021-05-23;8478;1109;476306;193469;28.5;11.6
93;2021-05-24;11209;1944;487515;195413;29.2;11.7
93;2021-05-25;12292;4320;499807;199733;29.9;12.0
93;2021-05-26;11079;3758;510886;203491;30.6;12.2
93;2021-05-27;12708;3897;523594;207388;31.4;12.4
93;2021-05-28;12654;5261;536248;212649;32.1;12.7
93;2021-05-29;11395;4269;547643;216918;32.8;13.0
93;2021-05-30;8209;1380;555852;218298;33.3;13.1
93;2021-05-31;9180;5176;565032;223474;33.8;13.4
93;2021-06-01;11405;6281;576437;229755;34.5;13.8
93;2021-06-02;10720;5198;587157;234953;35.2;14.1
93;2021-06-03;10821;5517;597978;240470;35.8;14.4
93;2021-06-04;10598;7799;608576;248269;36.4;14.9
93;2021-06-05;9022;7361;617598;255630;37.0;15.3
93;2021-06-06;8403;1746;626001;257376;37.5;15.4
93;2021-06-07;10070;7517;636071;264893;38.1;15.9
93;2021-06-08;10367;7379;646438;272272;38.7;16.3
93;2021-06-09;10243;7296;656681;279568;39.3;16.7
93;2021-06-10;9010;8196;665691;287764;39.9;17.2
93;2021-06-11;8823;8818;674514;296582;40.4;17.8
93;2021-06-12;9862;6662;684376;303244;41.0;18.2
93;2021-06-13;7169;2132;691545;305376;41.4;18.3
93;2021-06-14;5401;9735;696946;315111;41.7;18.9
93;2021-06-15;6237;9663;703183;324774;42.1;19.4
93;2021-06-16;6648;9061;709831;333835;42.5;20.0
93;2021-06-17;5755;8473;715586;342308;42.8;20.5
93;2021-06-18;7226;11123;722812;353431;43.3;21.2
93;2021-06-19;7076;11101;729888;364532;43.7;21.8
93;2021-06-20;4945;6877;734833;371409;44.0;22.2
93;2021-06-21;4071;10729;738904;382138;44.2;22.9
93;2021-06-22;4696;11314;743600;393452;44.5;23.6
93;2021-06-23;4538;10597;748138;404049;44.8;24.2
93;2021-06-24;4200;10297;752338;414346;45.0;24.8
93;2021-06-25;5187;13052;757525;427398;45.4;25.6
93;2021-06-26;5299;13926;762824;441324;45.7;26.4
93;2021-06-27;3285;7105;766109;448429;45.9;26.8
93;2021-06-28;3700;12507;769809;460936;46.1;27.6
93;2021-06-29;4017;12355;773826;473291;46.3;28.3
93;2021-06-30;4145;11303;777971;484594;46.6;29.0
93;2021-07-01;6085;11162;784056;495756;46.9;29.7
93;2021-07-02;5809;12381;789865;508137;47.3;30.4
93;2021-07-03;5550;13464;795415;521601;47.6;31.2
93;2021-07-04;3078;7885;798493;529486;47.8;31.7
93;2021-07-05;4593;10848;803086;540334;48.1;32.4
93;2021-07-06;4866;11761;807952;552095;48.4;33.1
93;2021-07-07;5233;11417;813185;563512;48.7;33.7
93;2021-07-08;5063;10272;818248;573784;49.0;34.4
93;2021-07-09;5927;13037;824175;586821;49.3;35.1
93;2021-07-10;5921;14293;830096;601114;49.7;36.0
93;2021-07-11;3689;9094;833785;610208;49.9;36.5
93;2021-07-12;5607;12079;839392;622287;50.3;37.3
93;2021-07-13;11145;13312;850537;635599;50.9;38.1
93;2021-07-14;10671;6801;861208;642400;51.6;38.5
93;2021-07-15;12557;14140;873765;656540;52.3;39.3
93;2021-07-16;13245;13699;887010;670239;53.1;40.1
93;2021-07-17;11420;13919;898430;684158;53.8;41.0
93;2021-07-18;7401;8960;905831;693118;54.2;41.5
93;2021-07-19;9638;10930;915469;704048;54.8;42.2
93;2021-07-20;12668;10693;928137;714741;55.6;42.8
93;2021-07-21;14410;10955;942547;725696;56.4;43.5
93;2021-07-22;14181;9483;956728;735179;57.3;44.0
93;2021-07-23;14624;10664;971352;745843;58.2;44.7
93;2021-07-24;13924;10654;985276;756497;59.0;45.3
93;2021-07-25;9037;6364;994313;762861;59.5;45.7
93;2021-07-26;12795;7799;1007108;770660;60.3;46.1
93;2021-07-27;15186;7468;1022294;778128;61.2;46.6
93;2021-07-28;15033;8311;1037327;786439;62.1;47.1
93;2021-07-29;13606;7082;1050933;793521;62.9;47.5
93;2021-07-30;14191;7878;1065124;801399;63.8;48.0
93;2021-07-31;12255;7723;1077379;809122;64.5;48.4
93;2021-08-01;7668;4612;1085047;813734;65.0;48.7
93;2021-08-02;13063;5775;1098110;819509;65.7;49.1
93;2021-08-03;8431;6871;1106541;826380;66.3;49.5
93;2021-08-04;8171;8010;1114712;834390;66.7;50.0
93;2021-08-05;6292;6865;1121004;841255;67.1;50.4
93;2021-08-06;7369;8339;1128373;849594;67.6;50.9
93;2021-08-07;7480;9058;1135853;858652;68.0;51.4
93;2021-08-08;4603;5566;1140456;864218;68.3;51.7
93;2021-08-09;7626;8088;1148082;872306;68.7;52.2
93;2021-08-10;7473;8853;1155555;881159;69.2;52.8
93;2021-08-11;7663;9695;1163218;890854;69.6;53.3
93;2021-08-12;6633;9045;1169851;899899;70.0;53.9
93;2021-08-13;6840;9032;1176691;908931;70.5;54.4
93;2021-08-14;7393;10507;1184084;919438;70.9;55.1
93;2021-08-15;2960;3624;1187044;923062;71.1;55.3
93;2021-08-16;6569;11222;1193613;934284;71.5;55.9
93;2021-08-17;6293;10919;1199906;945203;71.8;56.6
93;2021-08-18;5721;11214;1205627;956417;72.2;57.3
93;2021-08-19;5027;9674;1210654;966091;72.5;57.8
93;2021-08-20;5321;11235;1215975;977326;72.8;58.5
93;2021-08-21;4557;11947;1220532;989273;73.1;59.2
93;2021-08-22;2264;7051;1222796;996324;73.2;59.7
93;2021-08-23;4555;9336;1227351;1005660;73.5;60.2
93;2021-08-24;4541;8435;1231892;1014095;73.8;60.7
93;2021-08-25;4316;8609;1236208;1022704;74.0;61.2
93;2021-08-26;3779;7109;1239987;1029813;74.2;61.7
93;2021-08-27;4099;8549;1244086;1038362;74.5;62.2
93;2021-08-28;3991;9593;1248077;1047955;74.7;62.7
93;2021-08-29;1820;4807;1249897;1052762;74.8;63.0
93;2021-08-30;3148;7540;1253045;1060302;75.0;63.5
93;2021-08-31;3122;7658;1256167;1067960;75.2;63.9
93;2021-09-01;5086;7507;1261253;1075467;75.5;64.4
93;2021-09-02;3787;5787;1265040;1081254;75.7;64.7
93;2021-09-03;2972;7045;1268012;1088299;75.9;65.2
93;2021-09-04;3456;8775;1271468;1097074;76.1;65.7
93;2021-09-05;1304;3623;1272772;1100697;76.2;65.9
93;2021-09-06;2010;5079;1274782;1105776;76.3;66.2
93;2021-09-07;1883;4636;1276665;1110412;76.4;66.5
93;2021-09-08;2320;5341;1278985;1115753;76.6;66.8
93;2021-09-09;2054;4608;1281039;1120361;76.7;67.1
93;2021-09-10;2817;5446;1283856;1125807;76.9;67.4
93;2021-09-11;2430;6867;1286286;1132674;77.0;67.8
93;2021-09-12;878;2819;1287164;1135493;77.1;68.0
93;2021-09-13;1902;4549;1289066;1140042;77.2;68.3
93;2021-09-14;1943;4058;1291009;1144100;77.3;68.5
93;2021-09-15;1919;4280;1292928;1148380;77.4;68.8
93;2021-09-16;1624;3047;1294552;1151427;77.5;68.9
93;2021-09-17;1996;4560;1296548;1155987;77.6;69.2
93;2021-09-18;1660;5568;1298208;1161555;77.7;69.5
93;2021-09-19;536;2106;1298744;1163661;77.8;69.7
93;2021-09-20;1342;2927;1300086;1166588;77.8;69.8
93;2021-09-21;1016;2490;1301102;1169078;77.9;70.0
93;2021-09-22;1488;3935;1302590;1173013;78.0;70.2
93;2021-09-23;1048;2432;1303638;1175445;78.1;70.4
93;2021-09-24;1352;3435;1304990;1178880;78.1;70.6
93;2021-09-25;1114;4526;1306104;1183406;78.2;70.9
93;2021-09-26;431;1677;1306535;1185083;78.2;71.0
93;2021-09-27;893;2227;1307428;1187310;78.3;71.1
93;2021-09-28;862;2029;1308290;1189339;78.3;71.2
93;2021-09-29;1228;3256;1309518;1192595;78.4;71.4
93;2021-09-30;889;2348;1310407;1194943;78.5;71.5
93;2021-10-01;1123;2737;1311530;1197680;78.5;71.7
93;2021-10-02;1153;2783;1312683;1200463;78.6;71.9
93;2021-10-03;302;831;1312985;1201294;78.6;71.9
93;2021-10-04;882;2202;1313867;1203496;78.7;72.1
93;2021-10-05;752;2044;1314619;1205540;78.7;72.2
93;2021-10-06;1048;2338;1315667;1207878;78.8;72.3
93;2021-10-07;867;2356;1316534;1210234;78.8;72.5
93;2021-10-08;1058;2573;1317592;1212807;78.9;72.6
93;2021-10-09;1312;2792;1318904;1215599;79.0;72.8
93;2021-10-10;311;991;1319215;1216590;79.0;72.8
93;2021-10-11;674;1963;1319889;1218553;79.0;73.0
94;2020-12-27;8;0;8;0;0.0;0.0
94;2020-12-28;11;1;19;1;0.0;0.0
94;2020-12-29;0;0;19;1;0.0;0.0
94;2020-12-30;1;0;20;1;0.0;0.0
94;2020-12-31;7;2;27;3;0.0;0.0
94;2021-01-01;5;0;32;3;0.0;0.0
94;2021-01-02;0;0;32;3;0.0;0.0
94;2021-01-03;3;1;35;4;0.0;0.0
94;2021-01-04;39;2;74;6;0.0;0.0
94;2021-01-05;233;2;307;8;0.0;0.0
94;2021-01-06;333;5;640;13;0.0;0.0
94;2021-01-07;694;11;1334;24;0.1;0.0
94;2021-01-08;925;11;2259;35;0.2;0.0
94;2021-01-09;47;0;2306;35;0.2;0.0
94;2021-01-10;18;0;2324;35;0.2;0.0
94;2021-01-11;1015;13;3339;48;0.2;0.0
94;2021-01-12;1343;26;4682;74;0.3;0.0
94;2021-01-13;1408;26;6090;100;0.4;0.0
94;2021-01-14;1544;31;7634;131;0.5;0.0
94;2021-01-15;1222;26;8856;157;0.6;0.0
94;2021-01-16;197;1;9053;158;0.6;0.0
94;2021-01-17;100;2;9153;160;0.7;0.0
94;2021-01-18;1501;29;10654;189;0.8;0.0
94;2021-01-19;1952;30;12606;219;0.9;0.0
94;2021-01-20;2190;28;14796;247;1.1;0.0
94;2021-01-21;3032;23;17828;270;1.3;0.0
94;2021-01-22;2193;30;20021;300;1.4;0.0
94;2021-01-23;735;4;20756;304;1.5;0.0
94;2021-01-24;286;0;21042;304;1.5;0.0
94;2021-01-25;1474;27;22516;331;1.6;0.0
94;2021-01-26;1581;29;24097;360;1.7;0.0
94;2021-01-27;1848;56;25945;416;1.8;0.0
94;2021-01-28;1558;141;27503;557;2.0;0.0
94;2021-01-29;1380;150;28883;707;2.1;0.1
94;2021-01-30;581;4;29464;711;2.1;0.1
94;2021-01-31;123;9;29587;720;2.1;0.1
94;2021-02-01;931;153;30518;873;2.2;0.1
94;2021-02-02;854;253;31372;1126;2.2;0.1
94;2021-02-03;763;368;32135;1494;2.3;0.1
94;2021-02-04;901;430;33036;1924;2.3;0.1
94;2021-02-05;875;574;33911;2498;2.4;0.2
94;2021-02-06;408;75;34319;2573;2.4;0.2
94;2021-02-07;123;1;34442;2574;2.4;0.2
94;2021-02-08;637;550;35079;3124;2.5;0.2
94;2021-02-09;1036;986;36115;4110;2.6;0.3
94;2021-02-10;1103;1364;37218;5474;2.6;0.4
94;2021-02-11;1430;1558;38648;7032;2.7;0.5
94;2021-02-12;1395;1657;40043;8689;2.8;0.6
94;2021-02-13;300;262;40343;8951;2.9;0.6
94;2021-02-14;30;72;40373;9023;2.9;0.6
94;2021-02-15;755;1768;41128;10791;2.9;0.8
94;2021-02-16;702;2745;41830;13536;3.0;1.0
94;2021-02-17;719;1593;42549;15129;3.0;1.1
94;2021-02-18;798;1704;43347;16833;3.1;1.2
94;2021-02-19;968;1463;44315;18296;3.2;1.3
94;2021-02-20;133;922;44448;19218;3.2;1.4
94;2021-02-21;21;184;44469;19402;3.2;1.4
94;2021-02-22;525;1350;44994;20752;3.2;1.5
94;2021-02-23;624;1278;45618;22030;3.2;1.6
94;2021-02-24;694;928;46312;22958;3.3;1.6
94;2021-02-25;1073;1568;47385;24526;3.4;1.7
94;2021-02-26;1322;1077;48707;25603;3.5;1.8
94;2021-02-27;518;557;49225;26160;3.5;1.9
94;2021-02-28;91;84;49316;26244;3.5;1.9
94;2021-03-01;887;950;50203;27194;3.6;1.9
94;2021-03-02;1568;1006;51771;28200;3.7;2.0
94;2021-03-03;1952;1030;53723;29230;3.8;2.1
94;2021-03-04;2858;1210;56581;30440;4.0;2.2
94;2021-03-05;3839;1375;60420;31815;4.3;2.3
94;2021-03-06;4823;607;65243;32422;4.6;2.3
94;2021-03-07;3689;583;68932;33005;4.9;2.3
94;2021-03-08;1919;821;70851;33826;5.0;2.4
94;2021-03-09;2560;954;73411;34780;5.2;2.5
94;2021-03-10;3201;1066;76612;35846;5.4;2.5
94;2021-03-11;3840;968;80452;36814;5.7;2.6
94;2021-03-12;4586;849;85038;37663;6.0;2.7
94;2021-03-13;4132;415;89170;38078;6.3;2.7
94;2021-03-14;2115;163;91285;38241;6.5;2.7
94;2021-03-15;3172;810;94457;39051;6.7;2.8
94;2021-03-16;2776;458;97233;39509;6.9;2.8
94;2021-03-17;2863;477;100096;39986;7.1;2.8
94;2021-03-18;3267;457;103363;40443;7.4;2.9
94;2021-03-19;4273;736;107636;41179;7.7;2.9
94;2021-03-20;3692;306;111328;41485;7.9;3.0
94;2021-03-21;1465;397;112793;41882;8.0;3.0
94;2021-03-22;3221;687;116014;42569;8.3;3.0
94;2021-03-23;4515;756;120529;43325;8.6;3.1
94;2021-03-24;4627;648;125156;43973;8.9;3.1
94;2021-03-25;6321;710;131477;44683;9.4;3.2
94;2021-03-26;6091;857;137568;45540;9.8;3.2
94;2021-03-27;4470;287;142038;45827;10.1;3.3
94;2021-03-28;1891;119;143929;45946;10.2;3.3
94;2021-03-29;4129;1253;148058;47199;10.5;3.4
94;2021-03-30;5298;1371;153356;48570;10.9;3.5
94;2021-03-31;4913;1844;158269;50414;11.3;3.6
94;2021-04-01;5834;2344;164103;52758;11.7;3.8
94;2021-04-02;5246;2344;169349;55102;12.0;3.9
94;2021-04-03;3087;2540;172436;57642;12.3;4.1
94;2021-04-04;1051;781;173487;58423;12.3;4.2
94;2021-04-05;837;163;174324;58586;12.4;4.2
94;2021-04-06;3582;2617;177906;61203;12.7;4.4
94;2021-04-07;3865;2283;181771;63486;12.9;4.5
94;2021-04-08;4629;2089;186400;65575;13.3;4.7
94;2021-04-09;5367;2504;191767;68079;13.6;4.8
94;2021-04-10;2957;3015;194724;71094;13.8;5.1
94;2021-04-11;1267;1771;195991;72865;13.9;5.2
94;2021-04-12;3441;2302;199432;75167;14.2;5.3
94;2021-04-13;4314;3440;203746;78607;14.5;5.6
94;2021-04-14;3904;2713;207650;81320;14.8;5.8
94;2021-04-15;4453;3014;212103;84334;15.1;6.0
94;2021-04-16;4710;2861;216813;87195;15.4;6.2
94;2021-04-17;2463;2777;219276;89972;15.6;6.4
94;2021-04-18;919;1249;220195;91221;15.7;6.5
94;2021-04-19;2977;2459;223172;93680;15.9;6.7
94;2021-04-20;3275;2723;226447;96403;16.1;6.9
94;2021-04-21;3221;3179;229668;99582;16.3;7.1
94;2021-04-22;3912;3659;233580;103241;16.6;7.3
94;2021-04-23;4121;4012;237701;107253;16.9;7.6
94;2021-04-24;4265;3417;241966;110670;17.2;7.9
94;2021-04-25;2408;1517;244374;112187;17.4;8.0
94;2021-04-26;4011;3291;248385;115478;17.7;8.2
94;2021-04-27;5098;3396;253483;118874;18.0;8.5
94;2021-04-28;4832;3654;258315;122528;18.4;8.7
94;2021-04-29;6415;3831;264730;126359;18.8;9.0
94;2021-04-30;6487;3965;271217;130324;19.3;9.3
94;2021-05-01;4057;1069;275274;131393;19.6;9.3
94;2021-05-02;3049;1478;278323;132871;19.8;9.5
94;2021-05-03;5734;5345;284057;138216;20.2;9.8
94;2021-05-04;6097;3587;290154;141803;20.6;10.1
94;2021-05-05;6183;3437;296337;145240;21.1;10.3
94;2021-05-06;7163;3545;303500;148785;21.6;10.6
94;2021-05-07;6673;4130;310173;152915;22.1;10.9
94;2021-05-08;4907;2563;315080;155478;22.4;11.1
94;2021-05-09;4226;2257;319306;157735;22.7;11.2
94;2021-05-10;7713;3135;327019;160870;23.3;11.4
94;2021-05-11;8970;3945;335989;164815;23.9;11.7
94;2021-05-12;9575;3612;345564;168427;24.6;12.0
94;2021-05-13;8675;1368;354239;169795;25.2;12.1
94;2021-05-14;9866;3315;364105;173110;25.9;12.3
94;2021-05-15;8941;2163;373046;175273;26.5;12.5
94;2021-05-16;5068;912;378114;176185;26.9;12.5
94;2021-05-17;10835;2257;388949;178442;27.7;12.7
94;2021-05-18;11296;2453;400245;180895;28.5;12.9
94;2021-05-19;11675;3601;411920;184496;29.3;13.1
94;2021-05-20;12156;4363;424076;188859;30.2;13.4
94;2021-05-21;11874;3166;435950;192025;31.0;13.7
94;2021-05-22;10283;1972;446233;193997;31.7;13.8
94;2021-05-23;4998;712;451231;194709;32.1;13.8
94;2021-05-24;9669;1349;460900;196058;32.8;13.9
94;2021-05-25;9998;4272;470898;200330;33.5;14.2
94;2021-05-26;10293;3313;481191;203643;34.2;14.5
94;2021-05-27;10863;4589;492054;208232;35.0;14.8
94;2021-05-28;10442;4953;502496;213185;35.7;15.2
94;2021-05-29;9868;3459;512364;216644;36.4;15.4
94;2021-05-30;4785;931;517149;217575;36.8;15.5
94;2021-05-31;9989;4240;527138;221815;37.5;15.8
94;2021-06-01;10307;5101;537445;226916;38.2;16.1
94;2021-06-02;9354;4588;546799;231504;38.9;16.5
94;2021-06-03;9561;5607;556360;237111;39.6;16.9
94;2021-06-04;10403;6541;566763;243652;40.3;17.3
94;2021-06-05;9182;6250;575945;249902;41.0;17.8
94;2021-06-06;3984;1849;579929;251751;41.2;17.9
94;2021-06-07;8664;5978;588593;257729;41.9;18.3
94;2021-06-08;8996;7520;597589;265249;42.5;18.9
94;2021-06-09;8954;8166;606543;273415;43.1;19.4
94;2021-06-10;8800;10973;615343;284388;43.8;20.2
94;2021-06-11;7848;8400;623191;292788;44.3;20.8
94;2021-06-12;10259;6855;633450;299643;45.1;21.3
94;2021-06-13;3469;3263;636919;302906;45.3;21.5
94;2021-06-14;6959;8203;643878;311109;45.8;22.1
94;2021-06-15;7735;8822;651613;319931;46.3;22.8
94;2021-06-16;7245;8271;658858;328202;46.9;23.3
94;2021-06-17;6698;9067;665556;337269;47.3;24.0
94;2021-06-18;6575;11960;672131;349229;47.8;24.8
94;2021-06-19;6001;9587;678132;358816;48.2;25.5
94;2021-06-20;1887;4008;680019;362824;48.4;25.8
94;2021-06-21;4528;11188;684547;374012;48.7;26.6
94;2021-06-22;4843;10812;689390;384824;49.0;27.4
94;2021-06-23;4180;11151;693570;395975;49.3;28.2
94;2021-06-24;4970;10336;698540;406311;49.7;28.9
94;2021-06-25;4285;13734;702825;420045;50.0;29.9
94;2021-06-26;3139;12007;705964;432052;50.2;30.7
94;2021-06-27;1059;4998;707023;437050;50.3;31.1
94;2021-06-28;3494;12075;710517;449125;50.5;31.9
94;2021-06-29;4052;12175;714569;461300;50.8;32.8
94;2021-06-30;4364;11649;718933;472949;51.1;33.6
94;2021-07-01;5671;11118;724604;484067;51.5;34.4
94;2021-07-02;5327;12196;729931;496263;51.9;35.3
94;2021-07-03;3710;11799;733641;508062;52.2;36.1
94;2021-07-04;1518;5092;735159;513154;52.3;36.5
94;2021-07-05;4492;11429;739651;524583;52.6;37.3
94;2021-07-06;4619;10893;744270;535476;52.9;38.1
94;2021-07-07;5042;11083;749312;546559;53.3;38.9
94;2021-07-08;5110;10032;754422;556591;53.7;39.6
94;2021-07-09;6109;11876;760531;568467;54.1;40.4
94;2021-07-10;4122;11358;764653;579825;54.4;41.2
94;2021-07-11;1555;4719;766208;584544;54.5;41.6
94;2021-07-12;4336;11965;770544;596509;54.8;42.4
94;2021-07-13;6490;12050;777034;608559;55.3;43.3
94;2021-07-14;4292;5297;781326;613856;55.6;43.7
94;2021-07-15;7321;12370;788647;626226;56.1;44.5
94;2021-07-16;7848;11325;796495;637551;56.6;45.3
94;2021-07-17;6106;11327;802601;648878;57.1;46.1
94;2021-07-18;2629;4024;805230;652902;57.3;46.4
94;2021-07-19;6915;10448;812145;663350;57.8;47.2
94;2021-07-20;8571;10385;820716;673735;58.4;47.9
94;2021-07-21;8804;9586;829520;683321;59.0;48.6
94;2021-07-22;9794;9432;839314;692753;59.7;49.3
94;2021-07-23;9433;9414;848747;702167;60.4;49.9
94;2021-07-24;7216;8885;855963;711052;60.9;50.6
94;2021-07-25;2191;2743;858154;713795;61.0;50.8
94;2021-07-26;7971;8046;866125;721841;61.6;51.3
94;2021-07-27;8621;7007;874746;728848;62.2;51.8
94;2021-07-28;8812;6324;883558;735172;62.8;52.3
94;2021-07-29;9059;6377;892617;741549;63.5;52.7
94;2021-07-30;8206;6600;900823;748149;64.1;53.2
94;2021-07-31;7215;6313;908038;754462;64.6;53.7
94;2021-08-01;3203;1783;911241;756245;64.8;53.8
94;2021-08-02;6665;5471;917906;761716;65.3;54.2
94;2021-08-03;6372;5212;924278;766928;65.7;54.5
94;2021-08-04;6309;5132;930587;772060;66.2;54.9
94;2021-08-05;5851;5473;936438;777533;66.6;55.3
94;2021-08-06;5812;5848;942250;783381;67.0;55.7
94;2021-08-07;4253;4483;946503;787864;67.3;56.0
94;2021-08-08;1371;1718;947874;789582;67.4;56.2
94;2021-08-09;4898;6531;952772;796113;67.8;56.6
94;2021-08-10;5406;6312;958178;802425;68.1;57.1
94;2021-08-11;4301;5725;962479;808150;68.5;57.5
94;2021-08-12;4421;6506;966900;814656;68.8;57.9
94;2021-08-13;3788;5755;970688;820411;69.0;58.3
94;2021-08-14;2904;5736;973592;826147;69.2;58.8
94;2021-08-15;459;736;974051;826883;69.3;58.8
94;2021-08-16;3507;8283;977558;835166;69.5;59.4
94;2021-08-17;3377;8130;980935;843296;69.8;60.0
94;2021-08-18;3273;8613;984208;851909;70.0;60.6
94;2021-08-19;3335;6911;987543;858820;70.2;61.1
94;2021-08-20;3391;7754;990934;866574;70.5;61.6
94;2021-08-21;2568;7151;993502;873725;70.7;62.1
94;2021-08-22;897;2737;994399;876462;70.7;62.3
94;2021-08-23;2848;8451;997247;884913;70.9;62.9
94;2021-08-24;3149;7516;1000396;892429;71.1;63.5
94;2021-08-25;2747;6746;1003143;899175;71.3;64.0
94;2021-08-26;2594;6146;1005737;905321;71.5;64.4
94;2021-08-27;2650;6572;1008387;911893;71.7;64.9
94;2021-08-28;2578;6494;1010965;918387;71.9;65.3
94;2021-08-29;868;2348;1011833;920735;72.0;65.5
94;2021-08-30;2839;7731;1014672;928466;72.2;66.0
94;2021-08-31;2606;7200;1017278;935666;72.4;66.5
94;2021-09-01;2515;5670;1019793;941336;72.5;66.9
94;2021-09-02;1978;4631;1021771;945967;72.7;67.3
94;2021-09-03;2102;5178;1023873;951145;72.8;67.6
94;2021-09-04;2396;5143;1026269;956288;73.0;68.0
94;2021-09-05;706;1130;1026975;957418;73.0;68.1
94;2021-09-06;1569;3445;1028544;960863;73.2;68.3
94;2021-09-07;1511;3182;1030055;964045;73.3;68.6
94;2021-09-08;1484;3292;1031539;967337;73.4;68.8
94;2021-09-09;1267;2860;1032806;970197;73.5;69.0
94;2021-09-10;1593;3407;1034399;973604;73.6;69.2
94;2021-09-11;1712;4248;1036111;977852;73.7;69.5
94;2021-09-12;420;1105;1036531;978957;73.7;69.6
94;2021-09-13;1052;2273;1037583;981230;73.8;69.8
94;2021-09-14;1333;2598;1038916;983828;73.9;70.0
94;2021-09-15;1307;3111;1040223;986939;74.0;70.2
94;2021-09-16;1038;2181;1041261;989120;74.1;70.3
94;2021-09-17;1165;2689;1042426;991809;74.1;70.5
94;2021-09-18;1109;3691;1043535;995500;74.2;70.8
94;2021-09-19;295;1039;1043830;996539;74.2;70.9
94;2021-09-20;783;1967;1044613;998506;74.3;71.0
94;2021-09-21;998;1785;1045611;1000291;74.4;71.1
94;2021-09-22;951;2367;1046562;1002658;74.4;71.3
94;2021-09-23;773;1698;1047335;1004356;74.5;71.4
94;2021-09-24;994;1979;1048329;1006335;74.6;71.6
94;2021-09-25;966;3064;1049295;1009399;74.6;71.8
94;2021-09-26;270;700;1049565;1010099;74.6;71.8
94;2021-09-27;680;1468;1050245;1011567;74.7;71.9
94;2021-09-28;661;1424;1050906;1012991;74.7;72.0
94;2021-09-29;851;1591;1051757;1014582;74.8;72.2
94;2021-09-30;993;1262;1052750;1015844;74.9;72.2
94;2021-10-01;1075;1799;1053825;1017643;74.9;72.4
94;2021-10-02;974;2162;1054799;1019805;75.0;72.5
94;2021-10-03;250;609;1055049;1020414;75.0;72.6
94;2021-10-04;585;1097;1055634;1021511;75.1;72.7
94;2021-10-05;651;1094;1056285;1022605;75.1;72.7
94;2021-10-06;686;1307;1056971;1023912;75.2;72.8
94;2021-10-07;634;1007;1057605;1024919;75.2;72.9
94;2021-10-08;912;1395;1058517;1026314;75.3;73.0
94;2021-10-09;811;1598;1059328;1027912;75.3;73.1
94;2021-10-10;236;407;1059564;1028319;75.4;73.1
94;2021-10-11;511;851;1060075;1029170;75.4;73.2
95;2020-12-27;3;0;3;0;0.0;0.0
95;2020-12-28;6;0;9;0;0.0;0.0
95;2020-12-29;0;0;9;0;0.0;0.0
95;2020-12-30;0;0;9;0;0.0;0.0
95;2020-12-31;2;0;11;0;0.0;0.0
95;2021-01-01;0;0;11;0;0.0;0.0
95;2021-01-02;13;0;24;0;0.0;0.0
95;2021-01-03;1;0;25;0;0.0;0.0
95;2021-01-04;50;0;75;0;0.0;0.0
95;2021-01-05;319;0;394;0;0.0;0.0
95;2021-01-06;191;0;585;0;0.0;0.0
95;2021-01-07;130;1;715;1;0.1;0.0
95;2021-01-08;279;2;994;3;0.1;0.0
95;2021-01-09;251;0;1245;3;0.1;0.0
95;2021-01-10;384;3;1629;6;0.1;0.0
95;2021-01-11;491;3;2120;9;0.2;0.0
95;2021-01-12;864;3;2984;12;0.2;0.0
95;2021-01-13;782;12;3766;24;0.3;0.0
95;2021-01-14;886;13;4652;37;0.4;0.0
95;2021-01-15;758;6;5410;43;0.4;0.0
95;2021-01-16;298;4;5708;47;0.5;0.0
95;2021-01-17;225;2;5933;49;0.5;0.0
95;2021-01-18;1338;7;7271;56;0.6;0.0
95;2021-01-19;1579;9;8850;65;0.7;0.0
95;2021-01-20;2039;6;10889;71;0.9;0.0
95;2021-01-21;1856;7;12745;78;1.0;0.0
95;2021-01-22;1326;7;14071;85;1.1;0.0
95;2021-01-23;648;0;14719;85;1.2;0.0
95;2021-01-24;182;0;14901;85;1.2;0.0
95;2021-01-25;796;37;15697;122;1.3;0.0
95;2021-01-26;989;163;16686;285;1.3;0.0
95;2021-01-27;1251;192;17937;477;1.4;0.0
95;2021-01-28;1720;37;19657;514;1.6;0.0
95;2021-01-29;1251;210;20908;724;1.7;0.1
95;2021-01-30;478;6;21386;730;1.7;0.1
95;2021-01-31;212;2;21598;732;1.7;0.1
95;2021-02-01;566;273;22164;1005;1.8;0.1
95;2021-02-02;528;270;22692;1275;1.8;0.1
95;2021-02-03;614;519;23306;1794;1.9;0.1
95;2021-02-04;1068;369;24374;2163;2.0;0.2
95;2021-02-05;734;306;25108;2469;2.0;0.2
95;2021-02-06;338;255;25446;2724;2.0;0.2
95;2021-02-07;142;407;25588;3131;2.0;0.3
95;2021-02-08;765;342;26353;3473;2.1;0.3
95;2021-02-09;1136;1101;27489;4574;2.2;0.4
95;2021-02-10;1262;1420;28751;5994;2.3;0.5
95;2021-02-11;1388;1149;30139;7143;2.4;0.6
95;2021-02-12;1031;986;31170;8129;2.5;0.7
95;2021-02-13;330;319;31500;8448;2.5;0.7
95;2021-02-14;43;186;31543;8634;2.5;0.7
95;2021-02-15;430;1061;31973;9695;2.6;0.8
95;2021-02-16;493;916;32466;10611;2.6;0.8
95;2021-02-17;654;1134;33120;11745;2.7;0.9
95;2021-02-18;725;1696;33845;13441;2.7;1.1
95;2021-02-19;783;1305;34628;14746;2.8;1.2
95;2021-02-20;306;492;34934;15238;2.8;1.2
95;2021-02-21;165;313;35099;15551;2.8;1.2
95;2021-02-22;327;1023;35426;16574;2.8;1.3
95;2021-02-23;368;727;35794;17301;2.9;1.4
95;2021-02-24;310;881;36104;18182;2.9;1.5
95;2021-02-25;729;1142;36833;19324;3.0;1.5
95;2021-02-26;991;887;37824;20211;3.0;1.6
95;2021-02-27;365;434;38189;20645;3.1;1.7
95;2021-02-28;61;235;38250;20880;3.1;1.7
95;2021-03-01;773;593;39023;21473;3.1;1.7
95;2021-03-02;1321;861;40344;22334;3.2;1.8
95;2021-03-03;1600;989;41944;23323;3.4;1.9
95;2021-03-04;3196;1225;45140;24548;3.6;2.0
95;2021-03-05;3647;1110;48787;25658;3.9;2.1
95;2021-03-06;4005;516;52792;26174;4.2;2.1
95;2021-03-07;4221;344;57013;26518;4.6;2.1
95;2021-03-08;1541;877;58554;27395;4.7;2.2
95;2021-03-09;2622;516;61176;27911;4.9;2.2
95;2021-03-10;2344;863;63520;28774;5.1;2.3
95;2021-03-11;3141;1172;66661;29946;5.3;2.4
95;2021-03-12;3519;821;70180;30767;5.6;2.5
95;2021-03-13;3516;435;73696;31202;5.9;2.5
95;2021-03-14;1981;315;75677;31517;6.1;2.5
95;2021-03-15;2371;330;78048;31847;6.3;2.6
95;2021-03-16;1575;427;79623;32274;6.4;2.6
95;2021-03-17;2103;427;81726;32701;6.5;2.6
95;2021-03-18;2800;384;84526;33085;6.8;2.7
95;2021-03-19;3474;375;88000;33460;7.0;2.7
95;2021-03-20;2592;211;90592;33671;7.3;2.7
95;2021-03-21;1205;257;91797;33928;7.4;2.7
95;2021-03-22;2936;374;94733;34302;7.6;2.7
95;2021-03-23;3439;473;98172;34775;7.9;2.8
95;2021-03-24;3946;531;102118;35306;8.2;2.8
95;2021-03-25;5861;672;107979;35978;8.6;2.9
95;2021-03-26;5429;704;113408;36682;9.1;2.9
95;2021-03-27;3748;230;117156;36912;9.4;3.0
95;2021-03-28;1536;129;118692;37041;9.5;3.0
95;2021-03-29;2894;581;121586;37622;9.7;3.0
95;2021-03-30;3887;1266;125473;38888;10.1;3.1
95;2021-03-31;3657;1693;129130;40581;10.3;3.3
95;2021-04-01;5483;2297;134613;42878;10.8;3.4
95;2021-04-02;3560;2777;138173;45655;11.1;3.7
95;2021-04-03;2096;2495;140269;48150;11.2;3.9
95;2021-04-04;1249;1213;141518;49363;11.3;4.0
95;2021-04-05;596;64;142114;49427;11.4;4.0
95;2021-04-06;1859;1545;143973;50972;11.5;4.1
95;2021-04-07;4953;2213;148926;53185;11.9;4.3
95;2021-04-08;4896;2482;153822;55667;12.3;4.5
95;2021-04-09;5434;2351;159256;58018;12.8;4.6
95;2021-04-10;3709;1443;162965;59461;13.1;4.8
95;2021-04-11;1567;1045;164532;60506;13.2;4.8
95;2021-04-12;3254;1630;167786;62136;13.4;5.0
95;2021-04-13;3141;1700;170927;63836;13.7;5.1
95;2021-04-14;2751;2005;173678;65841;13.9;5.3
95;2021-04-15;3901;3364;177579;69205;14.2;5.5
95;2021-04-16;4064;3044;181643;72249;14.6;5.8
95;2021-04-17;2376;1760;184019;74009;14.7;5.9
95;2021-04-18;1511;1028;185530;75037;14.9;6.0
95;2021-04-19;2570;2376;188100;77413;15.1;6.2
95;2021-04-20;2121;2460;190221;79873;15.2;6.4
95;2021-04-21;3931;2640;194152;82513;15.6;6.6
95;2021-04-22;3413;4639;197565;87152;15.8;7.0
95;2021-04-23;2765;3564;200330;90716;16.0;7.3
95;2021-04-24;3571;2597;203901;93313;16.3;7.5
95;2021-04-25;1959;1554;205860;94867;16.5;7.6
95;2021-04-26;2753;2713;208613;97580;16.7;7.8
95;2021-04-27;3852;2185;212465;99765;17.0;8.0
95;2021-04-28;3890;2677;216355;102442;17.3;8.2
95;2021-04-29;6142;4563;222497;107005;17.8;8.6
95;2021-04-30;6904;2951;229401;109956;18.4;8.8
95;2021-05-01;2371;923;231772;110879;18.6;8.9
95;2021-05-02;2447;1506;234219;112385;18.8;9.0
95;2021-05-03;5128;1939;239347;114324;19.2;9.2
95;2021-05-04;6351;2737;245698;117061;19.7;9.4
95;2021-05-05;5146;3811;250844;120872;20.1;9.7
95;2021-05-06;8206;4938;259050;125810;20.8;10.1
95;2021-05-07;5778;4761;264828;130571;21.2;10.5
95;2021-05-08;5742;1536;270570;132107;21.7;10.6
95;2021-05-09;2831;1596;273401;133703;21.9;10.7
95;2021-05-10;9972;3203;283373;136906;22.7;11.0
95;2021-05-11;8450;3470;291823;140376;23.4;11.2
95;2021-05-12;9465;3228;301288;143604;24.1;11.5
95;2021-05-13;7953;1204;309241;144808;24.8;11.6
95;2021-05-14;7014;1911;316255;146719;25.3;11.8
95;2021-05-15;4513;1071;320768;147790;25.7;11.8
95;2021-05-16;4825;848;325593;148638;26.1;11.9
95;2021-05-17;7738;1354;333331;149992;26.7;12.0
95;2021-05-18;9468;1861;342799;151853;27.5;12.2
95;2021-05-19;9243;2503;352042;154356;28.2;12.4
95;2021-05-20;12585;2447;364627;156803;29.2;12.6
95;2021-05-21;10172;2541;374799;159344;30.0;12.8
95;2021-05-22;9395;1575;384194;160919;30.8;12.9
95;2021-05-23;4145;962;388339;161881;31.1;13.0
95;2021-05-24;2396;535;390735;162416;31.3;13.0
95;2021-05-25;7212;2082;397947;164498;31.9;13.2
95;2021-05-26;8850;3125;406797;167623;32.6;13.4
95;2021-05-27;10361;4440;417158;172063;33.4;13.8
95;2021-05-28;7682;4419;424840;176482;34.0;14.1
95;2021-05-29;5264;2761;430104;179243;34.5;14.4
95;2021-05-30;3732;1710;433836;180953;34.8;14.5
95;2021-05-31;6424;3330;440260;184283;35.3;14.8
95;2021-06-01;8783;3811;449043;188094;36.0;15.1
95;2021-06-02;8729;4750;457772;192844;36.7;15.4
95;2021-06-03;8524;6564;466296;199408;37.4;16.0
95;2021-06-04;8882;4406;475178;203814;38.1;16.3
95;2021-06-05;8335;3747;483513;207561;38.7;16.6
95;2021-06-06;4836;1626;488349;209187;39.1;16.8
95;2021-06-07;6058;4547;494407;213734;39.6;17.1
95;2021-06-08;6550;5514;500957;219248;40.1;17.6
95;2021-06-09;6254;6478;507211;225726;40.6;18.1
95;2021-06-10;6428;6817;513639;232543;41.1;18.6
95;2021-06-11;7222;6444;520861;238987;41.7;19.1
95;2021-06-12;6001;4374;526862;243361;42.2;19.5
95;2021-06-13;2083;3290;528945;246651;42.4;19.8
95;2021-06-14;5372;5994;534317;252645;42.8;20.2
95;2021-06-15;5740;8074;540057;260719;43.3;20.9
95;2021-06-16;5491;7538;545548;268257;43.7;21.5
95;2021-06-17;6599;8165;552147;276422;44.2;22.1
95;2021-06-18;5822;7862;557969;284284;44.7;22.8
95;2021-06-19;4966;8927;562935;293211;45.1;23.5
95;2021-06-20;1426;3316;564361;296527;45.2;23.8
95;2021-06-21;3534;7715;567895;304242;45.5;24.4
95;2021-06-22;5066;9055;572961;313297;45.9;25.1
95;2021-06-23;4774;10877;577735;324174;46.3;26.0
95;2021-06-24;4941;10724;582676;334898;46.7;26.8
95;2021-06-25;4878;10357;587554;345255;47.1;27.7
95;2021-06-26;4320;8477;591874;353732;47.4;28.3
95;2021-06-27;1032;3995;592906;357727;47.5;28.7
95;2021-06-28;2742;9488;595648;367215;47.7;29.4
95;2021-06-29;2537;8788;598185;376003;47.9;30.1
95;2021-06-30;3952;9996;602137;385999;48.2;30.9
95;2021-07-01;4863;11166;607000;397165;48.6;31.8
95;2021-07-02;4260;10546;611260;407711;49.0;32.7
95;2021-07-03;3525;9155;614785;416866;49.2;33.4
95;2021-07-04;1279;3400;616064;420266;49.4;33.7
95;2021-07-05;2358;4375;618422;424641;49.5;34.0
95;2021-07-06;2773;7753;621195;432394;49.8;34.6
95;2021-07-07;3961;9620;625156;442014;50.1;35.4
95;2021-07-08;5313;9820;630469;451834;50.5;36.2
95;2021-07-09;4552;10079;635021;461913;50.9;37.0
95;2021-07-10;3400;7391;638421;469304;51.1;37.6
95;2021-07-11;1526;3603;639947;472907;51.3;37.9
95;2021-07-12;2990;9692;642937;482599;51.5;38.7
95;2021-07-13;5054;10073;647991;492672;51.9;39.5
95;2021-07-14;4428;5743;652419;498415;52.3;39.9
95;2021-07-15;7402;12370;659821;510785;52.9;40.9
95;2021-07-16;7985;12007;667806;522792;53.5;41.9
95;2021-07-17;5053;7822;672859;530614;53.9;42.5
95;2021-07-18;3482;2914;676341;533528;54.2;42.7
95;2021-07-19;4832;6867;681173;540395;54.6;43.3
95;2021-07-20;6960;8386;688133;548781;55.1;44.0
95;2021-07-21;9257;9452;697390;558233;55.9;44.7
95;2021-07-22;10149;9729;707539;567962;56.7;45.5
95;2021-07-23;10918;10207;718457;578169;57.6;46.3
95;2021-07-24;5259;6236;723716;584405;58.0;46.8
95;2021-07-25;2251;2284;725967;586689;58.2;47.0
95;2021-07-26;4522;4026;730489;590715;58.5;47.3
95;2021-07-27;8502;7045;738991;597760;59.2;47.9
95;2021-07-28;9717;7563;748708;605323;60.0;48.5
95;2021-07-29;8430;5474;757138;610797;60.7;48.9
95;2021-07-30;8517;7775;765655;618572;61.3;49.6
95;2021-07-31;4238;4104;769893;622676;61.7;49.9
95;2021-08-01;2337;1375;772230;624051;61.9;50.0
95;2021-08-02;4160;3918;776390;627969;62.2;50.3
95;2021-08-03;6154;5540;782544;633509;62.7;50.7
95;2021-08-04;6510;6088;789054;639597;63.2;51.2
95;2021-08-05;6867;5731;795921;645328;63.8;51.7
95;2021-08-06;6514;7066;802435;652394;64.3;52.3
95;2021-08-07;2843;3038;805278;655432;64.5;52.5
95;2021-08-08;1370;1888;806648;657320;64.6;52.7
95;2021-08-09;3927;5038;810575;662358;64.9;53.1
95;2021-08-10;5276;5844;815851;668202;65.4;53.5
95;2021-08-11;5370;6563;821221;674765;65.8;54.1
95;2021-08-12;5226;6365;826447;681130;66.2;54.6
95;2021-08-13;3914;5477;830361;686607;66.5;55.0
95;2021-08-14;3570;3323;833931;689930;66.8;55.3
95;2021-08-15;284;361;834215;690291;66.8;55.3
95;2021-08-16;2859;6054;837074;696345;67.1;55.8
95;2021-08-17;3622;7264;840696;703609;67.3;56.4
95;2021-08-18;4276;8074;844972;711683;67.7;57.0
95;2021-08-19;3797;6595;848769;718278;68.0;57.5
95;2021-08-20;3793;7930;852562;726208;68.3;58.2
95;2021-08-21;2717;4304;855279;730512;68.5;58.5
95;2021-08-22;857;2399;856136;732911;68.6;58.7
95;2021-08-23;2469;5652;858605;738563;68.8;59.2
95;2021-08-24;2966;6472;861571;745035;69.0;59.7
95;2021-08-25;3772;8294;865343;753329;69.3;60.3
95;2021-08-26;3165;7534;868508;760863;69.6;60.9
95;2021-08-27;3517;8722;872025;769585;69.9;61.6
95;2021-08-28;2802;5496;874827;775081;70.1;62.1
95;2021-08-29;638;1712;875465;776793;70.1;62.2
95;2021-08-30;2762;6100;878227;782893;70.4;62.7
95;2021-08-31;2819;6310;881046;789203;70.6;63.2
95;2021-09-01;2737;6039;883783;795242;70.8;63.7
95;2021-09-02;1691;4227;885474;799469;70.9;64.0
95;2021-09-03;2218;5359;887692;804828;71.1;64.5
95;2021-09-04;2525;5627;890217;810455;71.3;64.9
95;2021-09-05;421;628;890638;811083;71.3;65.0
95;2021-09-06;1230;3139;891868;814222;71.4;65.2
95;2021-09-07;1395;3143;893263;817365;71.6;65.5
95;2021-09-08;1663;3890;894926;821255;71.7;65.8
95;2021-09-09;1294;3245;896220;824500;71.8;66.0
95;2021-09-10;1569;3517;897789;828017;71.9;66.3
95;2021-09-11;1541;3564;899330;831581;72.0;66.6
95;2021-09-12;319;697;899649;832278;72.1;66.7
95;2021-09-13;878;2206;900527;834484;72.1;66.8
95;2021-09-14;1150;2273;901677;836757;72.2;67.0
95;2021-09-15;1391;3573;903068;840330;72.3;67.3
95;2021-09-16;912;1888;903980;842218;72.4;67.5
95;2021-09-17;1253;2882;905233;845100;72.5;67.7
95;2021-09-18;1277;4204;906510;849304;72.6;68.0
95;2021-09-19;237;584;906747;849888;72.6;68.1
95;2021-09-20;594;1415;907341;851303;72.7;68.2
95;2021-09-21;824;1805;908165;853108;72.7;68.3
95;2021-09-22;936;3081;909101;856189;72.8;68.6
95;2021-09-23;746;1193;909847;857382;72.9;68.7
95;2021-09-24;771;2047;910618;859429;72.9;68.8
95;2021-09-25;1012;3802;911630;863231;73.0;69.1
95;2021-09-26;136;411;911766;863642;73.0;69.2
95;2021-09-27;683;1195;912449;864837;73.1;69.3
95;2021-09-28;767;1410;913216;866247;73.2;69.4
95;2021-09-29;810;1903;914026;868150;73.2;69.5
95;2021-09-30;799;1131;914825;869281;73.3;69.6
95;2021-10-01;756;1405;915581;870686;73.3;69.7
95;2021-10-02;1219;2487;916800;873173;73.4;69.9
95;2021-10-03;132;262;916932;873435;73.5;70.0
95;2021-10-04;402;710;917334;874145;73.5;70.0
95;2021-10-05;594;1216;917928;875361;73.5;70.1
95;2021-10-06;715;1285;918643;876646;73.6;70.2
95;2021-10-07;499;813;919142;877459;73.6;70.3
95;2021-10-08;756;1404;919898;878863;73.7;70.4
95;2021-10-09;1011;1731;920909;880594;73.8;70.5
95;2021-10-10;132;247;921041;880841;73.8;70.6
95;2021-10-11;369;575;921410;881416;73.8;70.6
971;2020-12-27;0;0;0;0;0.0;0.0
971;2020-12-28;0;0;0;0;0.0;0.0
971;2020-12-29;0;0;0;0;0.0;0.0
971;2020-12-30;0;0;0;0;0.0;0.0
971;2020-12-31;0;0;0;0;0.0;0.0
971;2021-01-01;1;0;1;0;0.0;0.0
971;2021-01-02;0;0;1;0;0.0;0.0
971;2021-01-03;0;0;1;0;0.0;0.0
971;2021-01-04;1;0;2;0;0.0;0.0
971;2021-01-05;0;0;2;0;0.0;0.0
971;2021-01-06;1;0;3;0;0.0;0.0
971;2021-01-07;0;0;3;0;0.0;0.0
971;2021-01-08;59;1;62;1;0.0;0.0
971;2021-01-09;20;0;82;1;0.0;0.0
971;2021-01-10;0;0;82;1;0.0;0.0
971;2021-01-11;61;0;143;1;0.0;0.0
971;2021-01-12;46;0;189;1;0.1;0.0
971;2021-01-13;47;1;236;2;0.1;0.0
971;2021-01-14;63;0;299;2;0.1;0.0
971;2021-01-15;77;2;376;4;0.1;0.0
971;2021-01-16;0;0;376;4;0.1;0.0
971;2021-01-17;0;0;376;4;0.1;0.0
971;2021-01-18;82;2;458;6;0.1;0.0
971;2021-01-19;148;0;606;6;0.2;0.0
971;2021-01-20;134;0;740;6;0.2;0.0
971;2021-01-21;156;1;896;7;0.2;0.0
971;2021-01-22;135;0;1031;7;0.3;0.0
971;2021-01-23;1;0;1032;7;0.3;0.0
971;2021-01-24;0;0;1032;7;0.3;0.0
971;2021-01-25;204;3;1236;10;0.3;0.0
971;2021-01-26;218;4;1454;14;0.4;0.0
971;2021-01-27;237;2;1691;16;0.4;0.0
971;2021-01-28;242;6;1933;22;0.5;0.0
971;2021-01-29;200;3;2133;25;0.6;0.0
971;2021-01-30;25;1;2158;26;0.6;0.0
971;2021-01-31;1;0;2159;26;0.6;0.0
971;2021-02-01;231;5;2390;31;0.6;0.0
971;2021-02-02;247;27;2637;58;0.7;0.0
971;2021-02-03;228;4;2865;62;0.8;0.0
971;2021-02-04;307;26;3172;88;0.8;0.0
971;2021-02-05;289;36;3461;124;0.9;0.0
971;2021-02-06;49;1;3510;125;0.9;0.0
971;2021-02-07;0;0;3510;125;0.9;0.0
971;2021-02-08;260;23;3770;148;1.0;0.0
971;2021-02-09;323;29;4093;177;1.1;0.0
971;2021-02-10;255;31;4348;208;1.2;0.1
971;2021-02-11;302;113;4650;321;1.2;0.1
971;2021-02-12;291;33;4941;354;1.3;0.1
971;2021-02-13;51;7;4992;361;1.3;0.1
971;2021-02-14;19;36;5011;397;1.3;0.1
971;2021-02-15;85;45;5096;442;1.4;0.1
971;2021-02-16;16;1;5112;443;1.4;0.1
971;2021-02-17;17;1;5129;444;1.4;0.1
971;2021-02-18;256;19;5385;463;1.4;0.1
971;2021-02-19;250;22;5635;485;1.5;0.1
971;2021-02-20;49;0;5684;485;1.5;0.1
971;2021-02-21;2;0;5686;485;1.5;0.1
971;2021-02-22;197;69;5883;554;1.6;0.1
971;2021-02-23;206;78;6089;632;1.6;0.2
971;2021-02-24;347;127;6436;759;1.7;0.2
971;2021-02-25;385;80;6821;839;1.8;0.2
971;2021-02-26;236;86;7057;925;1.9;0.2
971;2021-02-27;65;0;7122;925;1.9;0.2
971;2021-02-28;1;0;7123;925;1.9;0.2
971;2021-03-01;179;87;7302;1012;1.9;0.3
971;2021-03-02;278;131;7580;1143;2.0;0.3
971;2021-03-03;244;122;7824;1265;2.1;0.3
971;2021-03-04;336;87;8160;1352;2.2;0.4
971;2021-03-05;377;150;8537;1502;2.3;0.4
971;2021-03-06;598;16;9135;1518;2.4;0.4
971;2021-03-07;2;0;9137;1518;2.4;0.4
971;2021-03-08;330;149;9467;1667;2.5;0.4
971;2021-03-09;392;164;9859;1831;2.6;0.5
971;2021-03-10;437;168;10296;1999;2.7;0.5
971;2021-03-11;122;46;10418;2045;2.8;0.5
971;2021-03-12;504;236;10922;2281;2.9;0.6
971;2021-03-13;139;4;11061;2285;2.9;0.6
971;2021-03-14;14;23;11075;2308;2.9;0.6
971;2021-03-15;424;49;11499;2357;3.1;0.6
971;2021-03-16;491;88;11990;2445;3.2;0.6
971;2021-03-17;471;79;12461;2524;3.3;0.7
971;2021-03-18;590;88;13051;2612;3.5;0.7
971;2021-03-19;583;98;13634;2710;3.6;0.7
971;2021-03-20;177;21;13811;2731;3.7;0.7
971;2021-03-21;8;0;13819;2731;3.7;0.7
971;2021-03-22;361;92;14180;2823;3.8;0.7
971;2021-03-23;541;160;14721;2983;3.9;0.8
971;2021-03-24;475;111;15196;3094;4.0;0.8
971;2021-03-25;758;186;15954;3280;4.2;0.9
971;2021-03-26;644;124;16598;3404;4.4;0.9
971;2021-03-27;296;40;16894;3444;4.5;0.9
971;2021-03-28;24;2;16918;3446;4.5;0.9
971;2021-03-29;384;85;17302;3531;4.6;0.9
971;2021-03-30;626;170;17928;3701;4.8;1.0
971;2021-03-31;545;134;18473;3835;4.9;1.0
971;2021-04-01;663;200;19136;4035;5.1;1.1
971;2021-04-02;41;37;19177;4072;5.1;1.1
971;2021-04-03;63;6;19240;4078;5.1;1.1
971;2021-04-04;4;19;19244;4097;5.1;1.1
971;2021-04-05;13;0;19257;4097;5.1;1.1
971;2021-04-06;489;200;19746;4297;5.2;1.1
971;2021-04-07;581;124;20327;4421;5.4;1.2
971;2021-04-08;527;164;20854;4585;5.5;1.2
971;2021-04-09;486;213;21340;4798;5.7;1.3
971;2021-04-10;101;5;21441;4803;5.7;1.3
971;2021-04-11;8;12;21449;4815;5.7;1.3
971;2021-04-12;307;266;21756;5081;5.8;1.3
971;2021-04-13;556;328;22312;5409;5.9;1.4
971;2021-04-14;448;232;22760;5641;6.0;1.5
971;2021-04-15;553;314;23313;5955;6.2;1.6
971;2021-04-16;563;275;23876;6230;6.3;1.7
971;2021-04-17;216;5;24092;6235;6.4;1.7
971;2021-04-18;6;14;24098;6249;6.4;1.7
971;2021-04-19;405;244;24503;6493;6.5;1.7
971;2021-04-20;726;348;25229;6841;6.7;1.8
971;2021-04-21;627;322;25856;7163;6.9;1.9
971;2021-04-22;819;341;26675;7504;7.1;2.0
971;2021-04-23;845;252;27520;7756;7.3;2.1
971;2021-04-24;390;82;27910;7838;7.4;2.1
971;2021-04-25;601;65;28511;7903;7.6;2.1
971;2021-04-26;982;232;29493;8135;7.8;2.2
971;2021-04-27;721;238;30214;8373;8.0;2.2
971;2021-04-28;865;273;31079;8646;8.2;2.3
971;2021-04-29;1203;219;32282;8865;8.6;2.4
971;2021-04-30;1269;197;33551;9062;8.9;2.4
971;2021-05-01;608;44;34159;9106;9.1;2.4
971;2021-05-02;357;20;34516;9126;9.2;2.4
971;2021-05-03;925;194;35441;9320;9.4;2.5
971;2021-05-04;961;212;36402;9532;9.7;2.5
971;2021-05-05;1022;252;37424;9784;9.9;2.6
971;2021-05-06;1146;179;38570;9963;10.2;2.6
971;2021-05-07;1266;274;39836;10237;10.6;2.7
971;2021-05-08;323;40;40159;10277;10.7;2.7
971;2021-05-09;183;11;40342;10288;10.7;2.7
971;2021-05-10;851;221;41193;10509;10.9;2.8
971;2021-05-11;964;314;42157;10823;11.2;2.9
971;2021-05-12;911;325;43068;11148;11.4;3.0
971;2021-05-13;212;78;43280;11226;11.5;3.0
971;2021-05-14;861;274;44141;11500;11.7;3.1
971;2021-05-15;486;15;44627;11515;11.8;3.1
971;2021-05-16;182;36;44809;11551;11.9;3.1
971;2021-05-17;721;276;45530;11827;12.1;3.1
971;2021-05-18;743;389;46273;12216;12.3;3.2
971;2021-05-19;705;529;46978;12745;12.5;3.4
971;2021-05-20;811;377;47789;13122;12.7;3.5
971;2021-05-21;827;405;48616;13527;12.9;3.6
971;2021-05-22;507;214;49123;13741;13.0;3.6
971;2021-05-23;199;114;49322;13855;13.1;3.7
971;2021-05-24;201;173;49523;14028;13.1;3.7
971;2021-05-25;551;660;50074;14688;13.3;3.9
971;2021-05-26;596;491;50670;15179;13.4;4.0
971;2021-05-27;133;179;50803;15358;13.5;4.1
971;2021-05-28;520;525;51323;15883;13.6;4.2
971;2021-05-29;238;140;51561;16023;13.7;4.3
971;2021-05-30;75;112;51636;16135;13.7;4.3
971;2021-05-31;452;535;52088;16670;13.8;4.4
971;2021-06-01;593;706;52681;17376;14.0;4.6
971;2021-06-02;576;705;53257;18081;14.1;4.8
971;2021-06-03;509;558;53766;18639;14.3;4.9
971;2021-06-04;834;799;54600;19438;14.5;5.2
971;2021-06-05;317;644;54917;20082;14.6;5.3
971;2021-06-06;139;528;55056;20610;14.6;5.5
971;2021-06-07;421;781;55477;21391;14.7;5.7
971;2021-06-08;485;886;55962;22277;14.8;5.9
971;2021-06-09;503;857;56465;23134;15.0;6.1
971;2021-06-10;538;848;57003;23982;15.1;6.4
971;2021-06-11;474;1233;57477;25215;15.3;6.7
971;2021-06-12;303;659;57780;25874;15.3;6.9
971;2021-06-13;126;312;57906;26186;15.4;6.9
971;2021-06-14;371;3678;58277;29864;15.5;7.9
971;2021-06-15;483;1981;58760;31845;15.6;8.4
971;2021-06-16;479;1431;59239;33276;15.7;8.8
971;2021-06-17;432;1009;59671;34285;15.8;9.1
971;2021-06-18;483;1020;60154;35305;16.0;9.4
971;2021-06-19;313;508;60467;35813;16.0;9.5
971;2021-06-20;111;231;60578;36044;16.1;9.6
971;2021-06-21;348;674;60926;36718;16.2;9.7
971;2021-06-22;333;870;61259;37588;16.3;10.0
971;2021-06-23;371;892;61630;38480;16.4;10.2
971;2021-06-24;417;731;62047;39211;16.5;10.4
971;2021-06-25;456;759;62503;39970;16.6;10.6
971;2021-06-26;301;512;62804;40482;16.7;10.7
971;2021-06-27;116;148;62920;40630;16.7;10.8
971;2021-06-28;304;682;63224;41312;16.8;11.0
971;2021-06-29;388;780;63612;42092;16.9;11.2
971;2021-06-30;441;924;64053;43016;17.0;11.4
971;2021-07-01;364;649;64417;43665;17.1;11.6
971;2021-07-02;434;693;64851;44358;17.2;11.8
971;2021-07-03;277;467;65128;44825;17.3;11.9
971;2021-07-04;112;238;65240;45063;17.3;12.0
971;2021-07-05;331;504;65571;45567;17.4;12.1
971;2021-07-06;388;769;65959;46336;17.5;12.3
971;2021-07-07;378;844;66337;47180;17.6;12.5
971;2021-07-08;416;791;66753;47971;17.7;12.7
971;2021-07-09;437;796;67190;48767;17.8;12.9
971;2021-07-10;245;295;67435;49062;17.9;13.0
971;2021-07-11;169;137;67604;49199;17.9;13.1
971;2021-07-12;477;603;68081;49802;18.1;13.2
971;2021-07-13;883;1001;68964;50803;18.3;13.5
971;2021-07-14;476;283;69440;51086;18.4;13.6
971;2021-07-15;885;842;70325;51928;18.7;13.8
971;2021-07-16;1095;1041;71420;52969;19.0;14.1
971;2021-07-17;647;445;72067;53414;19.1;14.2
971;2021-07-18;401;221;72468;53635;19.2;14.2
971;2021-07-19;579;579;73047;54214;19.4;14.4
971;2021-07-20;841;737;73888;54951;19.6;14.6
971;2021-07-21;767;501;74655;55452;19.8;14.7
971;2021-07-22;988;876;75643;56328;20.1;14.9
971;2021-07-23;1034;758;76677;57086;20.3;15.1
971;2021-07-24;426;387;77103;57473;20.5;15.2
971;2021-07-25;247;262;77350;57735;20.5;15.3
971;2021-07-26;636;566;77986;58301;20.7;15.5
971;2021-07-27;884;590;78870;58891;20.9;15.6
971;2021-07-28;797;655;79667;59546;21.1;15.8
971;2021-07-29;971;674;80638;60220;21.4;16.0
971;2021-07-30;1320;755;81958;60975;21.7;16.2
971;2021-07-31;557;412;82515;61387;21.9;16.3
971;2021-08-01;315;251;82830;61638;22.0;16.4
971;2021-08-02;765;422;83595;62060;22.2;16.5
971;2021-08-03;764;676;84359;62736;22.4;16.6
971;2021-08-04;694;675;85053;63411;22.6;16.8
971;2021-08-05;699;595;85752;64006;22.8;17.0
971;2021-08-06;933;644;86685;64650;23.0;17.2
971;2021-08-07;453;392;87138;65042;23.1;17.3
971;2021-08-08;279;313;87417;65355;23.2;17.3
971;2021-08-09;592;585;88009;65940;23.4;17.5
971;2021-08-10;762;796;88771;66736;23.6;17.7
971;2021-08-11;925;793;89696;67529;23.8;17.9
971;2021-08-12;1024;803;90720;68332;24.1;18.1
971;2021-08-13;980;444;91700;68776;24.3;18.2
971;2021-08-14;634;702;92334;69478;24.5;18.4
971;2021-08-15;437;413;92771;69891;24.6;18.5
971;2021-08-16;823;742;93594;70633;24.8;18.7
971;2021-08-17;908;871;94502;71504;25.1;19.0
971;2021-08-18;1277;977;95779;72481;25.4;19.2
971;2021-08-19;1349;928;97128;73409;25.8;19.5
971;2021-08-20;1534;1049;98662;74458;26.2;19.8
971;2021-08-21;732;518;99394;74976;26.4;19.9
971;2021-08-22;365;272;99759;75248;26.5;20.0
971;2021-08-23;876;630;100635;75878;26.7;20.1
971;2021-08-24;1293;795;101928;76673;27.0;20.3
971;2021-08-25;1392;801;103320;77474;27.4;20.6
971;2021-08-26;1404;775;104724;78249;27.8;20.8
971;2021-08-27;1506;1100;106230;79349;28.2;21.1
971;2021-08-28;939;580;107169;79929;28.4;21.2
971;2021-08-29;222;241;107391;80170;28.5;21.3
971;2021-08-30;932;720;108323;80890;28.7;21.5
971;2021-08-31;1255;863;109578;81753;29.1;21.7
971;2021-09-01;1128;878;110706;82631;29.4;21.9
971;2021-09-02;1073;850;111779;83481;29.7;22.2
971;2021-09-03;988;1098;112767;84579;29.9;22.4
971;2021-09-04;543;624;113310;85203;30.1;22.6
971;2021-09-05;129;238;113439;85441;30.1;22.7
971;2021-09-06;612;665;114051;86106;30.3;22.8
971;2021-09-07;637;699;114688;86805;30.4;23.0
971;2021-09-08;705;1003;115393;87808;30.6;23.3
971;2021-09-09;641;1069;116034;88877;30.8;23.6
971;2021-09-10;741;1288;116775;90165;31.0;23.9
971;2021-09-11;399;685;117174;90850;31.1;24.1
971;2021-09-12;86;357;117260;91207;31.1;24.2
971;2021-09-13;377;619;117637;91826;31.2;24.4
971;2021-09-14;549;1104;118186;92930;31.4;24.7
971;2021-09-15;552;1166;118738;94096;31.5;25.0
971;2021-09-16;454;1084;119192;95180;31.6;25.3
971;2021-09-17;562;1480;119754;96660;31.8;25.6
971;2021-09-18;279;1021;120033;97681;31.8;25.9
971;2021-09-19;92;336;120125;98017;31.9;26.0
971;2021-09-20;235;966;120360;98983;31.9;26.3
971;2021-09-21;274;1190;120634;100173;32.0;26.6
971;2021-09-22;380;1196;121014;101369;32.1;26.9
971;2021-09-23;369;1222;121383;102591;32.2;27.2
971;2021-09-24;451;1282;121834;103873;32.3;27.6
971;2021-09-25;233;777;122067;104650;32.4;27.8
971;2021-09-26;73;228;122140;104878;32.4;27.8
971;2021-09-27;248;665;122388;105543;32.5;28.0
971;2021-09-28;262;835;122650;106378;32.5;28.2
971;2021-09-29;312;890;122962;107268;32.6;28.5
971;2021-09-30;347;758;123309;108026;32.7;28.7
971;2021-10-01;384;863;123693;108889;32.8;28.9
971;2021-10-02;268;541;123961;109430;32.9;29.0
971;2021-10-03;71;167;124032;109597;32.9;29.1
971;2021-10-04;219;443;124251;110040;33.0;29.2
971;2021-10-05;336;609;124587;110649;33.1;29.4
971;2021-10-06;330;629;124917;111278;33.1;29.5
971;2021-10-07;362;575;125279;111853;33.2;29.7
971;2021-10-08;426;778;125705;112631;33.4;29.9
971;2021-10-09;316;448;126021;113079;33.4;30.0
971;2021-10-10;66;148;126087;113227;33.5;30.0
971;2021-10-11;221;349;126308;113576;33.5;30.1
972;2020-12-27;0;0;0;0;0.0;0.0
972;2020-12-28;0;0;0;0;0.0;0.0
972;2020-12-29;0;0;0;0;0.0;0.0
972;2020-12-30;0;0;0;0;0.0;0.0
972;2020-12-31;0;0;0;0;0.0;0.0
972;2021-01-01;0;0;0;0;0.0;0.0
972;2021-01-02;0;0;0;0;0.0;0.0
972;2021-01-03;0;0;0;0;0.0;0.0
972;2021-01-04;0;0;0;0;0.0;0.0
972;2021-01-05;0;0;0;0;0.0;0.0
972;2021-01-06;5;0;5;0;0.0;0.0
972;2021-01-07;31;0;36;0;0.0;0.0
972;2021-01-08;90;1;126;1;0.0;0.0
972;2021-01-09;20;0;146;1;0.0;0.0
972;2021-01-10;0;0;146;1;0.0;0.0
972;2021-01-11;122;0;268;1;0.1;0.0
972;2021-01-12;79;0;347;1;0.1;0.0
972;2021-01-13;65;0;412;1;0.1;0.0
972;2021-01-14;88;1;500;2;0.1;0.0
972;2021-01-15;171;7;671;9;0.2;0.0
972;2021-01-16;51;0;722;9;0.2;0.0
972;2021-01-17;0;0;722;9;0.2;0.0
972;2021-01-18;158;0;880;9;0.2;0.0
972;2021-01-19;168;1;1048;10;0.3;0.0
972;2021-01-20;170;0;1218;10;0.3;0.0
972;2021-01-21;181;2;1399;12;0.4;0.0
972;2021-01-22;173;0;1572;12;0.4;0.0
972;2021-01-23;58;0;1630;12;0.5;0.0
972;2021-01-24;0;0;1630;12;0.5;0.0
972;2021-01-25;161;1;1791;13;0.5;0.0
972;2021-01-26;138;1;1929;14;0.5;0.0
972;2021-01-27;163;5;2092;19;0.6;0.0
972;2021-01-28;152;12;2244;31;0.6;0.0
972;2021-01-29;143;41;2387;72;0.7;0.0
972;2021-01-30;96;16;2483;88;0.7;0.0
972;2021-01-31;0;0;2483;88;0.7;0.0
972;2021-02-01;119;73;2602;161;0.7;0.0
972;2021-02-02;184;94;2786;255;0.8;0.1
972;2021-02-03;132;76;2918;331;0.8;0.1
972;2021-02-04;160;70;3078;401;0.9;0.1
972;2021-02-05;123;93;3201;494;0.9;0.1
972;2021-02-06;63;26;3264;520;0.9;0.1
972;2021-02-07;1;0;3265;520;0.9;0.1
972;2021-02-08;137;79;3402;599;0.9;0.2
972;2021-02-09;177;77;3579;676;1.0;0.2
972;2021-02-10;153;90;3732;766;1.0;0.2
972;2021-02-11;149;101;3881;867;1.1;0.2
972;2021-02-12;152;131;4033;998;1.1;0.3
972;2021-02-13;47;37;4080;1035;1.1;0.3
972;2021-02-14;0;0;4080;1035;1.1;0.3
972;2021-02-15;51;67;4131;1102;1.2;0.3
972;2021-02-16;0;1;4131;1103;1.2;0.3
972;2021-02-17;1;3;4132;1106;1.2;0.3
972;2021-02-18;69;127;4201;1233;1.2;0.3
972;2021-02-19;69;129;4270;1362;1.2;0.4
972;2021-02-20;48;68;4318;1430;1.2;0.4
972;2021-02-21;0;0;4318;1430;1.2;0.4
972;2021-02-22;102;60;4420;1490;1.2;0.4
972;2021-02-23;113;235;4533;1725;1.3;0.5
972;2021-02-24;106;220;4639;1945;1.3;0.5
972;2021-02-25;93;150;4732;2095;1.3;0.6
972;2021-02-26;132;168;4864;2263;1.4;0.6
972;2021-02-27;69;52;4933;2315;1.4;0.6
972;2021-02-28;0;0;4933;2315;1.4;0.6
972;2021-03-01;138;143;5071;2458;1.4;0.7
972;2021-03-02;158;79;5229;2537;1.5;0.7
972;2021-03-03;179;145;5408;2682;1.5;0.7
972;2021-03-04;152;135;5560;2817;1.5;0.8
972;2021-03-05;236;128;5796;2945;1.6;0.8
972;2021-03-06;119;58;5915;3003;1.6;0.8
972;2021-03-07;100;3;6015;3006;1.7;0.8
972;2021-03-08;196;134;6211;3140;1.7;0.9
972;2021-03-09;283;101;6494;3241;1.8;0.9
972;2021-03-10;322;136;6816;3377;1.9;0.9
972;2021-03-11;337;81;7153;3458;2.0;1.0
972;2021-03-12;413;57;7566;3515;2.1;1.0
972;2021-03-13;155;21;7721;3536;2.2;1.0
972;2021-03-14;4;1;7725;3537;2.2;1.0
972;2021-03-15;277;91;8002;3628;2.2;1.0
972;2021-03-16;305;56;8307;3684;2.3;1.0
972;2021-03-17;388;48;8695;3732;2.4;1.0
972;2021-03-18;437;46;9132;3778;2.5;1.1
972;2021-03-19;402;63;9534;3841;2.7;1.1
972;2021-03-20;149;48;9683;3889;2.7;1.1
972;2021-03-21;25;1;9708;3890;2.7;1.1
972;2021-03-22;361;117;10069;4007;2.8;1.1
972;2021-03-23;404;124;10473;4131;2.9;1.2
972;2021-03-24;429;107;10902;4238;3.0;1.2
972;2021-03-25;492;105;11394;4343;3.2;1.2
972;2021-03-26;634;106;12028;4449;3.4;1.2
972;2021-03-27;154;71;12182;4520;3.4;1.3
972;2021-03-28;81;2;12263;4522;3.4;1.3
972;2021-03-29;423;166;12686;4688;3.5;1.3
972;2021-03-30;469;244;13155;4932;3.7;1.4
972;2021-03-31;1151;193;14306;5125;4.0;1.4
972;2021-04-01;955;174;15261;5299;4.3;1.5
972;2021-04-02;896;16;16157;5315;4.5;1.5
972;2021-04-03;789;57;16946;5372;4.7;1.5
972;2021-04-04;751;15;17697;5387;4.9;1.5
972;2021-04-05;828;44;18525;5431;5.2;1.5
972;2021-04-06;885;136;19410;5567;5.4;1.6
972;2021-04-07;1437;331;20847;5898;5.8;1.6
972;2021-04-08;1307;272;22154;6170;6.2;1.7
972;2021-04-09;1239;316;23393;6486;6.5;1.8
972;2021-04-10;838;165;24231;6651;6.8;1.9
972;2021-04-11;620;15;24851;6666;6.9;1.9
972;2021-04-12;869;318;25720;6984;7.2;1.9
972;2021-04-13;880;330;26600;7314;7.4;2.0
972;2021-04-14;959;324;27559;7638;7.7;2.1
972;2021-04-15;959;303;28518;7941;7.9;2.2
972;2021-04-16;997;301;29515;8242;8.2;2.3
972;2021-04-17;529;161;30044;8403;8.4;2.3
972;2021-04-18;339;56;30383;8459;8.5;2.4
972;2021-04-19;668;342;31051;8801;8.7;2.5
972;2021-04-20;865;309;31916;9110;8.9;2.5
972;2021-04-21;1002;354;32918;9464;9.2;2.6
972;2021-04-22;605;312;33523;9776;9.3;2.7
972;2021-04-23;614;465;34137;10241;9.5;2.9
972;2021-04-24;364;197;34501;10438;9.6;2.9
972;2021-04-25;168;200;34669;10638;9.7;3.0
972;2021-04-26;516;541;35185;11179;9.8;3.1
972;2021-04-27;568;607;35753;11786;10.0;3.3
972;2021-04-28;448;691;36201;12477;10.1;3.5
972;2021-04-29;654;643;36855;13120;10.3;3.7
972;2021-04-30;771;686;37626;13806;10.5;3.8
972;2021-05-01;244;246;37870;14052;10.6;3.9
972;2021-05-02;227;513;38097;14565;10.6;4.1
972;2021-05-03;569;770;38666;15335;10.8;4.3
972;2021-05-04;525;678;39191;16013;10.9;4.5
972;2021-05-05;548;896;39739;16909;11.1;4.7
972;2021-05-06;546;785;40285;17694;11.2;4.9
972;2021-05-07;629;1015;40914;18709;11.4;5.2
972;2021-05-08;225;526;41139;19235;11.5;5.4
972;2021-05-09;172;506;41311;19741;11.5;5.5
972;2021-05-10;519;856;41830;20597;11.7;5.7
972;2021-05-11;477;870;42307;21467;11.8;6.0
972;2021-05-12;560;910;42867;22377;11.9;6.2
972;2021-05-13;275;532;43142;22909;12.0;6.4
972;2021-05-14;388;748;43530;23657;12.1;6.6
972;2021-05-15;233;578;43763;24235;12.2;6.8
972;2021-05-16;155;442;43918;24677;12.2;6.9
972;2021-05-17;474;753;44392;25430;12.4;7.1
972;2021-05-18;445;678;44837;26108;12.5;7.3
972;2021-05-19;453;744;45290;26852;12.6;7.5
972;2021-05-20;594;500;45884;27352;12.8;7.6
972;2021-05-21;544;683;46428;28035;12.9;7.8
972;2021-05-22;186;359;46614;28394;13.0;7.9
972;2021-05-23;111;182;46725;28576;13.0;8.0
972;2021-05-24;135;241;46860;28817;13.1;8.0
972;2021-05-25;350;697;47210;29514;13.2;8.2
972;2021-05-26;381;712;47591;30226;13.3;8.4
972;2021-05-27;271;647;47862;30873;13.3;8.6
972;2021-05-28;280;815;48142;31688;13.4;8.8
972;2021-05-29;154;513;48296;32201;13.5;9.0
972;2021-05-30;17;33;48313;32234;13.5;9.0
972;2021-05-31;346;680;48659;32914;13.6;9.2
972;2021-06-01;299;543;48958;33457;13.6;9.3
972;2021-06-02;325;575;49283;34032;13.7;9.5
972;2021-06-03;247;424;49530;34456;13.8;9.6
972;2021-06-04;350;642;49880;35098;13.9;9.8
972;2021-06-05;260;371;50140;35469;14.0;9.9
972;2021-06-06;25;32;50165;35501;14.0;9.9
972;2021-06-07;260;735;50425;36236;14.1;10.1
972;2021-06-08;255;585;50680;36821;14.1;10.3
972;2021-06-09;303;697;50983;37518;14.2;10.5
972;2021-06-10;308;451;51291;37969;14.3;10.6
972;2021-06-11;358;533;51649;38502;14.4;10.7
972;2021-06-12;232;320;51881;38822;14.5;10.8
972;2021-06-13;32;29;51913;38851;14.5;10.8
972;2021-06-14;367;548;52280;39399;14.6;11.0
972;2021-06-15;409;486;52689;39885;14.7;11.1
972;2021-06-16;436;435;53125;40320;14.8;11.2
972;2021-06-17;354;573;53479;40893;14.9;11.4
972;2021-06-18;458;537;53937;41430;15.0;11.5
972;2021-06-19;225;196;54162;41626;15.1;11.6
972;2021-06-20;25;17;54187;41643;15.1;11.6
972;2021-06-21;332;579;54519;42222;15.2;11.8
972;2021-06-22;297;463;54816;42685;15.3;11.9
972;2021-06-23;421;562;55237;43247;15.4;12.1
972;2021-06-24;330;437;55567;43684;15.5;12.2
972;2021-06-25;313;387;55880;44071;15.6;12.3
972;2021-06-26;222;201;56102;44272;15.6;12.3
972;2021-06-27;16;23;56118;44295;15.6;12.3
972;2021-06-28;336;425;56454;44720;15.7;12.5
972;2021-06-29;329;430;56783;45150;15.8;12.6
972;2021-06-30;440;421;57223;45571;16.0;12.7
972;2021-07-01;351;394;57574;45965;16.0;12.8
972;2021-07-02;124;201;57698;46166;16.1;12.9
972;2021-07-03;100;118;57798;46284;16.1;12.9
972;2021-07-04;24;36;57822;46320;16.1;12.9
972;2021-07-05;494;580;58316;46900;16.3;13.1
972;2021-07-06;488;429;58804;47329;16.4;13.2
972;2021-07-07;613;496;59417;47825;16.6;13.3
972;2021-07-08;492;422;59909;48247;16.7;13.4
972;2021-07-09;629;583;60538;48830;16.9;13.6
972;2021-07-10;405;309;60943;49139;17.0;13.7
972;2021-07-11;52;38;60995;49177;17.0;13.7
972;2021-07-12;847;697;61842;49874;17.2;13.9
972;2021-07-13;1475;707;63317;50581;17.6;14.1
972;2021-07-14;133;65;63450;50646;17.7;14.1
972;2021-07-15;1603;680;65053;51326;18.1;14.3
972;2021-07-16;1632;663;66685;51989;18.6;14.5
972;2021-07-17;1094;367;67779;52356;18.9;14.6
972;2021-07-18;56;39;67835;52395;18.9;14.6
972;2021-07-19;1148;654;68983;53049;19.2;14.8
972;2021-07-20;1130;578;70113;53627;19.5;14.9
972;2021-07-21;1089;604;71202;54231;19.8;15.1
972;2021-07-22;906;519;72108;54750;20.1;15.3
972;2021-07-23;969;484;73077;55234;20.4;15.4
972;2021-07-24;506;224;73583;55458;20.5;15.5
972;2021-07-25;50;63;73633;55521;20.5;15.5
972;2021-07-26;685;525;74318;56046;20.7;15.6
972;2021-07-27;1029;515;75347;56561;21.0;15.8
972;2021-07-28;645;562;75992;57123;21.2;15.9
972;2021-07-29;842;548;76834;57671;21.4;16.1
972;2021-07-30;903;615;77737;58286;21.7;16.2
972;2021-07-31;561;275;78298;58561;21.8;16.3
972;2021-08-01;83;33;78381;58594;21.8;16.3
972;2021-08-02;812;815;79193;59409;22.1;16.6
972;2021-08-03;730;743;79923;60152;22.3;16.8
972;2021-08-04;788;572;80711;60724;22.5;16.9
972;2021-08-05;915;590;81626;61314;22.8;17.1
972;2021-08-06;1196;895;82822;62209;23.1;17.3
972;2021-08-07;667;571;83489;62780;23.3;17.5
972;2021-08-08;85;83;83574;62863;23.3;17.5
972;2021-08-09;1130;1064;84704;63927;23.6;17.8
972;2021-08-10;1199;1041;85903;64968;23.9;18.1
972;2021-08-11;1235;921;87138;65889;24.3;18.4
972;2021-08-12;1451;930;88589;66819;24.7;18.6
972;2021-08-13;1317;645;89906;67464;25.1;18.8
972;2021-08-14;850;322;90756;67786;25.3;18.9
972;2021-08-15;70;55;90826;67841;25.3;18.9
972;2021-08-16;1280;1047;92106;68888;25.7;19.2
972;2021-08-17;1177;1187;93283;70075;26.0;19.5
972;2021-08-18;1238;1174;94521;71249;26.3;19.9
972;2021-08-19;1286;892;95807;72141;26.7;20.1
972;2021-08-20;1329;893;97136;73034;27.1;20.4
972;2021-08-21;758;626;97894;73660;27.3;20.5
972;2021-08-22;47;82;97941;73742;27.3;20.6
972;2021-08-23;1182;859;99123;74601;27.6;20.8
972;2021-08-24;1379;880;100502;75481;28.0;21.0
972;2021-08-25;1079;769;101581;76250;28.3;21.3
972;2021-08-26;1279;807;102860;77057;28.7;21.5
972;2021-08-27;1286;1077;104146;78134;29.0;21.8
972;2021-08-28;779;756;104925;78890;29.2;22.0
972;2021-08-29;100;64;105025;78954;29.3;22.0
972;2021-08-30;1141;1111;106166;80065;29.6;22.3
972;2021-08-31;907;1099;107073;81164;29.8;22.6
972;2021-09-01;812;1118;107885;82282;30.1;22.9
972;2021-09-02;879;1189;108764;83471;30.3;23.3
972;2021-09-03;772;1279;109536;84750;30.5;23.6
972;2021-09-04;615;887;110151;85637;30.7;23.9
972;2021-09-05;144;128;110295;85765;30.7;23.9
972;2021-09-06;600;1026;110895;86791;30.9;24.2
972;2021-09-07;636;935;111531;87726;31.1;24.5
972;2021-09-08;593;1128;112124;88854;31.3;24.8
972;2021-09-09;521;1064;112645;89918;31.4;25.1
972;2021-09-10;588;1297;113233;91215;31.6;25.4
972;2021-09-11;490;893;113723;92108;31.7;25.7
972;2021-09-12;108;105;113831;92213;31.7;25.7
972;2021-09-13;488;1084;114319;93297;31.9;26.0
972;2021-09-14;482;1085;114801;94382;32.0;26.3
972;2021-09-15;392;1089;115193;95471;32.1;26.6
972;2021-09-16;386;1069;115579;96540;32.2;26.9
972;2021-09-17;592;1274;116171;97814;32.4;27.3
972;2021-09-18;428;931;116599;98745;32.5;27.5
972;2021-09-19;43;121;116642;98866;32.5;27.6
972;2021-09-20;363;921;117005;99787;32.6;27.8
972;2021-09-21;427;988;117432;100775;32.7;28.1
972;2021-09-22;362;856;117794;101631;32.8;28.3
972;2021-09-23;406;826;118200;102457;32.9;28.6
972;2021-09-24;459;979;118659;103436;33.1;28.8
972;2021-09-25;333;835;118992;104271;33.2;29.1
972;2021-09-26;30;183;119022;104454;33.2;29.1
972;2021-09-27;303;666;119325;105120;33.3;29.3
972;2021-09-28;409;670;119734;105790;33.4;29.5
972;2021-09-29;363;645;120097;106435;33.5;29.7
972;2021-09-30;475;666;120572;107101;33.6;29.9
972;2021-10-01;535;754;121107;107855;33.8;30.1
972;2021-10-02;366;607;121473;108462;33.9;30.2
972;2021-10-03;41;79;121514;108541;33.9;30.3
972;2021-10-04;367;454;121881;108995;34.0;30.4
972;2021-10-05;366;542;122247;109537;34.1;30.5
972;2021-10-06;391;511;122638;110048;34.2;30.7
972;2021-10-07;394;495;123032;110543;34.3;30.8
972;2021-10-08;514;624;123546;111167;34.4;31.0
972;2021-10-09;406;519;123952;111686;34.6;31.1
972;2021-10-10;32;64;123984;111750;34.6;31.1
972;2021-10-11;419;455;124403;112205;34.7;31.3
973;2020-12-27;0;0;0;0;0.0;0.0
973;2020-12-28;0;0;0;0;0.0;0.0
973;2020-12-29;0;0;0;0;0.0;0.0
973;2020-12-30;0;0;0;0;0.0;0.0
973;2020-12-31;0;0;0;0;0.0;0.0
973;2021-01-01;0;0;0;0;0.0;0.0
973;2021-01-02;1;1;1;1;0.0;0.0
973;2021-01-03;0;0;1;1;0.0;0.0
973;2021-01-04;0;0;1;1;0.0;0.0
973;2021-01-05;0;0;1;1;0.0;0.0
973;2021-01-06;0;0;1;1;0.0;0.0
973;2021-01-07;0;0;1;1;0.0;0.0
973;2021-01-08;0;0;1;1;0.0;0.0
973;2021-01-09;0;0;1;1;0.0;0.0
973;2021-01-10;0;0;1;1;0.0;0.0
973;2021-01-11;0;0;1;1;0.0;0.0
973;2021-01-12;0;0;1;1;0.0;0.0
973;2021-01-13;30;0;31;1;0.0;0.0
973;2021-01-14;46;0;77;1;0.0;0.0
973;2021-01-15;35;0;112;1;0.0;0.0
973;2021-01-16;18;1;130;2;0.0;0.0
973;2021-01-17;0;0;130;2;0.0;0.0
973;2021-01-18;63;0;193;2;0.1;0.0
973;2021-01-19;151;1;344;3;0.1;0.0
973;2021-01-20;134;0;478;3;0.2;0.0
973;2021-01-21;118;0;596;3;0.2;0.0
973;2021-01-22;76;0;672;3;0.2;0.0
973;2021-01-23;0;0;672;3;0.2;0.0
973;2021-01-24;0;0;672;3;0.2;0.0
973;2021-01-25;56;0;728;3;0.3;0.0
973;2021-01-26;100;2;828;5;0.3;0.0
973;2021-01-27;109;1;937;6;0.3;0.0
973;2021-01-28;96;3;1033;9;0.4;0.0
973;2021-01-29;104;3;1137;12;0.4;0.0
973;2021-01-30;0;0;1137;12;0.4;0.0
973;2021-01-31;0;0;1137;12;0.4;0.0
973;2021-02-01;54;0;1191;12;0.4;0.0
973;2021-02-02;122;5;1313;17;0.5;0.0
973;2021-02-03;119;7;1432;24;0.5;0.0
973;2021-02-04;79;25;1511;49;0.5;0.0
973;2021-02-05;66;8;1577;57;0.5;0.0
973;2021-02-06;0;0;1577;57;0.5;0.0
973;2021-02-07;0;0;1577;57;0.5;0.0
973;2021-02-08;52;12;1629;69;0.6;0.0
973;2021-02-09;92;39;1721;108;0.6;0.0
973;2021-02-10;101;41;1822;149;0.6;0.1
973;2021-02-11;105;93;1927;242;0.7;0.1
973;2021-02-12;89;63;2016;305;0.7;0.1
973;2021-02-13;0;0;2016;305;0.7;0.1
973;2021-02-14;0;0;2016;305;0.7;0.1
973;2021-02-15;27;65;2043;370;0.7;0.1
973;2021-02-16;123;52;2166;422;0.7;0.1
973;2021-02-17;145;119;2311;541;0.8;0.2
973;2021-02-18;103;139;2414;680;0.8;0.2
973;2021-02-19;122;72;2536;752;0.9;0.3
973;2021-02-20;0;0;2536;752;0.9;0.3
973;2021-02-21;0;0;2536;752;0.9;0.3
973;2021-02-22;78;48;2614;800;0.9;0.3
973;2021-02-23;158;103;2772;903;1.0;0.3
973;2021-02-24;189;124;2961;1027;1.0;0.4
973;2021-02-25;259;92;3220;1119;1.1;0.4
973;2021-02-26;264;71;3484;1190;1.2;0.4
973;2021-02-27;121;2;3605;1192;1.2;0.4
973;2021-02-28;0;0;3605;1192;1.2;0.4
973;2021-03-01;182;88;3787;1280;1.3;0.4
973;2021-03-02;257;107;4044;1387;1.4;0.5
973;2021-03-03;256;131;4300;1518;1.5;0.5
973;2021-03-04;281;87;4581;1605;1.6;0.6
973;2021-03-05;274;48;4855;1653;1.7;0.6
973;2021-03-06;118;2;4973;1655;1.7;0.6
973;2021-03-07;0;0;4973;1655;1.7;0.6
973;2021-03-08;188;42;5161;1697;1.8;0.6
973;2021-03-09;353;93;5514;1790;1.9;0.6
973;2021-03-10;360;120;5874;1910;2.0;0.7
973;2021-03-11;271;113;6145;2023;2.1;0.7
973;2021-03-12;288;96;6433;2119;2.2;0.7
973;2021-03-13;112;4;6545;2123;2.3;0.7
973;2021-03-14;0;0;6545;2123;2.3;0.7
973;2021-03-15;181;27;6726;2150;2.3;0.7
973;2021-03-16;243;142;6969;2292;2.4;0.8
973;2021-03-17;274;129;7243;2421;2.5;0.8
973;2021-03-18;249;157;7492;2578;2.6;0.9
973;2021-03-19;283;129;7775;2707;2.7;0.9
973;2021-03-20;259;22;8034;2729;2.8;0.9
973;2021-03-21;119;4;8153;2733;2.8;0.9
973;2021-03-22;219;109;8372;2842;2.9;1.0
973;2021-03-23;275;195;8647;3037;3.0;1.0
973;2021-03-24;236;214;8883;3251;3.1;1.1
973;2021-03-25;167;180;9050;3431;3.1;1.2
973;2021-03-26;189;307;9239;3738;3.2;1.3
973;2021-03-27;58;94;9297;3832;3.2;1.3
973;2021-03-28;0;0;9297;3832;3.2;1.3
973;2021-03-29;175;249;9472;4081;3.3;1.4
973;2021-03-30;446;239;9918;4320;3.4;1.5
973;2021-03-31;318;293;10236;4613;3.5;1.6
973;2021-04-01;446;263;10682;4876;3.7;1.7
973;2021-04-02;309;283;10991;5159;3.8;1.8
973;2021-04-03;159;126;11150;5285;3.8;1.8
973;2021-04-04;0;0;11150;5285;3.8;1.8
973;2021-04-05;118;14;11268;5299;3.9;1.8
973;2021-04-06;441;337;11709;5636;4.0;1.9
973;2021-04-07;502;345;12211;5981;4.2;2.1
973;2021-04-08;513;270;12724;6251;4.4;2.2
973;2021-04-09;498;227;13222;6478;4.5;2.2
973;2021-04-10;147;91;13369;6569;4.6;2.3
973;2021-04-11;2;0;13371;6569;4.6;2.3
973;2021-04-12;551;269;13922;6838;4.8;2.4
973;2021-04-13;673;245;14595;7083;5.0;2.4
973;2021-04-14;721;316;15316;7399;5.3;2.5
973;2021-04-15;776;248;16092;7647;5.5;2.6
973;2021-04-16;761;306;16853;7953;5.8;2.7
973;2021-04-17;499;138;17352;8091;6.0;2.8
973;2021-04-18;499;47;17851;8138;6.1;2.8
973;2021-04-19;715;254;18566;8392;6.4;2.9
973;2021-04-20;607;280;19173;8672;6.6;3.0
973;2021-04-21;873;251;20046;8923;6.9;3.1
973;2021-04-22;727;233;20773;9156;7.1;3.1
973;2021-04-23;705;234;21478;9390;7.4;3.2
973;2021-04-24;524;99;22002;9489;7.6;3.3
973;2021-04-25;611;50;22613;9539;7.8;3.3
973;2021-04-26;779;233;23392;9772;8.0;3.4
973;2021-04-27;817;349;24209;10121;8.3;3.5
973;2021-04-28;746;332;24955;10453;8.6;3.6
973;2021-04-29;666;287;25621;10740;8.8;3.7
973;2021-04-30;711;261;26332;11001;9.1;3.8
973;2021-05-01;211;29;26543;11030;9.1;3.8
973;2021-05-02;602;86;27145;11116;9.3;3.8
973;2021-05-03;554;395;27699;11511;9.5;4.0
973;2021-05-04;666;327;28365;11838;9.8;4.1
973;2021-05-05;700;457;29065;12295;10.0;4.2
973;2021-05-06;695;479;29760;12774;10.2;4.4
973;2021-05-07;594;474;30354;13248;10.4;4.6
973;2021-05-08;343;60;30697;13308;10.6;4.6
973;2021-05-09;262;72;30959;13380;10.7;4.6
973;2021-05-10;440;612;31399;13992;10.8;4.8
973;2021-05-11;399;497;31798;14489;10.9;5.0
973;2021-05-12;514;647;32312;15136;11.1;5.2
973;2021-05-13;333;99;32645;15235;11.2;5.2
973;2021-05-14;485;555;33130;15790;11.4;5.4
973;2021-05-15;257;348;33387;16138;11.5;5.6
973;2021-05-16;207;210;33594;16348;11.6;5.6
973;2021-05-17;447;599;34041;16947;11.7;5.8
973;2021-05-18;564;568;34605;17515;11.9;6.0
973;2021-05-19;534;552;35139;18067;12.1;6.2
973;2021-05-20;643;451;35782;18518;12.3;6.4
973;2021-05-21;505;609;36287;19127;12.5;6.6
973;2021-05-22;167;500;36454;19627;12.5;6.8
973;2021-05-23;271;475;36725;20102;12.6;6.9
973;2021-05-24;562;249;37287;20351;12.8;7.0
973;2021-05-25;501;745;37788;21096;13.0;7.3
973;2021-05-26;453;684;38241;21780;13.2;7.5
973;2021-05-27;712;528;38953;22308;13.4;7.7
973;2021-05-28;579;554;39532;22862;13.6;7.9
973;2021-05-29;257;360;39789;23222;13.7;8.0
973;2021-05-30;151;399;39940;23621;13.7;8.1
973;2021-05-31;356;573;40296;24194;13.9;8.3
973;2021-06-01;421;467;40717;24661;14.0;8.5
973;2021-06-02;566;554;41283;25215;14.2;8.7
973;2021-06-03;525;470;41808;25685;14.4;8.8
973;2021-06-04;601;496;42409;26181;14.6;9.0
973;2021-06-05;273;292;42682;26473;14.7;9.1
973;2021-06-06;211;301;42893;26774;14.8;9.2
973;2021-06-07;488;452;43381;27226;14.9;9.4
973;2021-06-08;544;315;43925;27541;15.1;9.5
973;2021-06-09;530;390;44455;27931;15.3;9.6
973;2021-06-10;359;290;44814;28221;15.4;9.7
973;2021-06-11;436;466;45250;28687;15.6;9.9
973;2021-06-12;170;283;45420;28970;15.6;10.0
973;2021-06-13;215;269;45635;29239;15.7;10.1
973;2021-06-14;384;549;46019;29788;15.8;10.2
973;2021-06-15;377;445;46396;30233;16.0;10.4
973;2021-06-16;491;459;46887;30692;16.1;10.6
973;2021-06-17;442;578;47329;31270;16.3;10.8
973;2021-06-18;390;562;47719;31832;16.4;11.0
973;2021-06-19;235;260;47954;32092;16.5;11.0
973;2021-06-20;126;270;48080;32362;16.5;11.1
973;2021-06-21;335;601;48415;32963;16.7;11.3
973;2021-06-22;376;462;48791;33425;16.8;11.5
973;2021-06-23;343;539;49134;33964;16.9;11.7
973;2021-06-24;446;500;49580;34464;17.1;11.9
973;2021-06-25;445;559;50025;35023;17.2;12.0
973;2021-06-26;172;320;50197;35343;17.3;12.2
973;2021-06-27;121;170;50318;35513;17.3;12.2
973;2021-06-28;314;593;50632;36106;17.4;12.4
973;2021-06-29;376;506;51008;36612;17.5;12.6
973;2021-06-30;410;680;51418;37292;17.7;12.8
973;2021-07-01;431;399;51849;37691;17.8;13.0
973;2021-07-02;511;524;52360;38215;18.0;13.1
973;2021-07-03;210;275;52570;38490;18.1;13.2
973;2021-07-04;86;243;52656;38733;18.1;13.3
973;2021-07-05;361;546;53017;39279;18.2;13.5
973;2021-07-06;373;474;53390;39753;18.4;13.7
973;2021-07-07;374;415;53764;40168;18.5;13.8
973;2021-07-08;316;328;54080;40496;18.6;13.9
973;2021-07-09;392;434;54472;40930;18.7;14.1
973;2021-07-10;168;278;54640;41208;18.8;14.2
973;2021-07-11;102;163;54742;41371;18.8;14.2
973;2021-07-12;403;497;55145;41868;19.0;14.4
973;2021-07-13;682;558;55827;42426;19.2;14.6
973;2021-07-14;394;161;56221;42587;19.3;14.7
973;2021-07-15;658;528;56879;43115;19.6;14.8
973;2021-07-16;602;485;57481;43600;19.8;15.0
973;2021-07-17;345;285;57826;43885;19.9;15.1
973;2021-07-18;251;124;58077;44009;20.0;15.1
973;2021-07-19;524;459;58601;44468;20.2;15.3
973;2021-07-20;585;494;59186;44962;20.4;15.5
973;2021-07-21;725;397;59911;45359;20.6;15.6
973;2021-07-22;660;452;60571;45811;20.8;15.8
973;2021-07-23;608;370;61179;46181;21.0;15.9
973;2021-07-24;326;241;61505;46422;21.2;16.0
973;2021-07-25;166;111;61671;46533;21.2;16.0
973;2021-07-26;446;345;62117;46878;21.4;16.1
973;2021-07-27;554;358;62671;47236;21.6;16.2
973;2021-07-28;468;370;63139;47606;21.7;16.4
973;2021-07-29;536;431;63675;48037;21.9;16.5
973;2021-07-30;541;408;64216;48445;22.1;16.7
973;2021-07-31;203;163;64419;48608;22.2;16.7
973;2021-08-01;139;132;64558;48740;22.2;16.8
973;2021-08-02;398;432;64956;49172;22.3;16.9
973;2021-08-03;432;402;65388;49574;22.5;17.1
973;2021-08-04;308;373;65696;49947;22.6;17.2
973;2021-08-05;343;363;66039;50310;22.7;17.3
973;2021-08-06;365;524;66404;50834;22.8;17.5
973;2021-08-07;164;266;66568;51100;22.9;17.6
973;2021-08-08;123;177;66691;51277;22.9;17.6
973;2021-08-09;332;473;67023;51750;23.1;17.8
973;2021-08-10;363;516;67386;52266;23.2;18.0
973;2021-08-11;584;519;67970;52785;23.4;18.2
973;2021-08-12;551;584;68521;53369;23.6;18.4
973;2021-08-13;367;234;68888;53603;23.7;18.4
973;2021-08-14;253;401;69141;54004;23.8;18.6
973;2021-08-15;122;138;69263;54142;23.8;18.6
973;2021-08-16;307;473;69570;54615;23.9;18.8
973;2021-08-17;372;401;69942;55016;24.1;18.9
973;2021-08-18;369;446;70311;55462;24.2;19.1
973;2021-08-19;331;482;70642;55944;24.3;19.2
973;2021-08-20;313;400;70955;56344;24.4;19.4
973;2021-08-21;161;257;71116;56601;24.5;19.5
973;2021-08-22;115;183;71231;56784;24.5;19.5
973;2021-08-23;286;384;71517;57168;24.6;19.7
973;2021-08-24;313;465;71830;57633;24.7;19.8
973;2021-08-25;293;350;72123;57983;24.8;19.9
973;2021-08-26;315;404;72438;58387;24.9;20.1
973;2021-08-27;365;426;72803;58813;25.0;20.2
973;2021-08-28;143;266;72946;59079;25.1;20.3
973;2021-08-29;87;187;73033;59266;25.1;20.4
973;2021-08-30;219;337;73252;59603;25.2;20.5
973;2021-08-31;299;370;73551;59973;25.3;20.6
973;2021-09-01;255;392;73806;60365;25.4;20.8
973;2021-09-02;298;385;74104;60750;25.5;20.9
973;2021-09-03;279;341;74383;61091;25.6;21.0
973;2021-09-04;147;197;74530;61288;25.6;21.1
973;2021-09-05;72;88;74602;61376;25.7;21.1
973;2021-09-06;178;232;74780;61608;25.7;21.2
973;2021-09-07;209;256;74989;61864;25.8;21.3
973;2021-09-08;220;397;75209;62261;25.9;21.4
973;2021-09-09;224;290;75433;62551;25.9;21.5
973;2021-09-10;228;314;75661;62865;26.0;21.6
973;2021-09-11;125;292;75786;63157;26.1;21.7
973;2021-09-12;59;95;75845;63252;26.1;21.8
973;2021-09-13;220;226;76065;63478;26.2;21.8
973;2021-09-14;265;296;76330;63774;26.3;21.9
973;2021-09-15;345;331;76675;64105;26.4;22.1
973;2021-09-16;265;240;76940;64345;26.5;22.1
973;2021-09-17;215;242;77155;64587;26.5;22.2
973;2021-09-18;114;244;77269;64831;26.6;22.3
973;2021-09-19;55;150;77324;64981;26.6;22.4
973;2021-09-20;147;186;77471;65167;26.7;22.4
973;2021-09-21;193;203;77664;65370;26.7;22.5
973;2021-09-22;186;350;77850;65720;26.8;22.6
973;2021-09-23;246;240;78096;65960;26.9;22.7
973;2021-09-24;257;307;78353;66267;27.0;22.8
973;2021-09-25;113;257;78466;66524;27.0;22.9
973;2021-09-26;39;94;78505;66618;27.0;22.9
973;2021-09-27;158;167;78663;66785;27.1;23.0
973;2021-09-28;159;205;78822;66990;27.1;23.0
973;2021-09-29;204;237;79026;67227;27.2;23.1
973;2021-09-30;291;304;79317;67531;27.3;23.2
973;2021-10-01;200;219;79517;67750;27.4;23.3
973;2021-10-02;104;169;79621;67919;27.4;23.4
973;2021-10-03;60;92;79681;68011;27.4;23.4
973;2021-10-04;193;208;79874;68219;27.5;23.5
973;2021-10-05;174;177;80048;68396;27.5;23.5
973;2021-10-06;197;203;80245;68599;27.6;23.6
973;2021-10-07;212;173;80457;68772;27.7;23.7
973;2021-10-08;226;201;80683;68973;27.8;23.7
973;2021-10-09;107;152;80790;69125;27.8;23.8
973;2021-10-10;46;73;80836;69198;27.8;23.8
973;2021-10-11;147;171;80983;69369;27.9;23.9
974;2020-12-27;0;0;0;0;0.0;0.0
974;2020-12-28;0;0;0;0;0.0;0.0
974;2020-12-29;0;0;0;0;0.0;0.0
974;2020-12-30;0;0;0;0;0.0;0.0
974;2020-12-31;0;0;0;0;0.0;0.0
974;2021-01-01;1;0;1;0;0.0;0.0
974;2021-01-02;0;0;1;0;0.0;0.0
974;2021-01-03;0;0;1;0;0.0;0.0
974;2021-01-04;0;0;1;0;0.0;0.0
974;2021-01-05;2;0;3;0;0.0;0.0
974;2021-01-06;0;0;3;0;0.0;0.0
974;2021-01-07;0;0;3;0;0.0;0.0
974;2021-01-08;0;0;3;0;0.0;0.0
974;2021-01-09;1;0;4;0;0.0;0.0
974;2021-01-10;0;0;4;0;0.0;0.0
974;2021-01-11;0;0;4;0;0.0;0.0
974;2021-01-12;0;0;4;0;0.0;0.0
974;2021-01-13;0;0;4;0;0.0;0.0
974;2021-01-14;0;0;4;0;0.0;0.0
974;2021-01-15;335;0;339;0;0.0;0.0
974;2021-01-16;28;0;367;0;0.0;0.0
974;2021-01-17;0;0;367;0;0.0;0.0
974;2021-01-18;49;1;416;1;0.0;0.0
974;2021-01-19;395;0;811;1;0.1;0.0
974;2021-01-20;485;1;1296;2;0.2;0.0
974;2021-01-21;614;2;1910;4;0.2;0.0
974;2021-01-22;414;1;2324;5;0.3;0.0
974;2021-01-23;75;0;2399;5;0.3;0.0
974;2021-01-24;0;0;2399;5;0.3;0.0
974;2021-01-25;274;2;2673;7;0.3;0.0
974;2021-01-26;428;0;3101;7;0.4;0.0
974;2021-01-27;316;0;3417;7;0.4;0.0
974;2021-01-28;409;1;3826;8;0.4;0.0
974;2021-01-29;422;3;4248;11;0.5;0.0
974;2021-01-30;421;1;4669;12;0.5;0.0
974;2021-01-31;0;0;4669;12;0.5;0.0
974;2021-02-01;373;4;5042;16;0.6;0.0
974;2021-02-02;503;3;5545;19;0.6;0.0
974;2021-02-03;602;14;6147;33;0.7;0.0
974;2021-02-04;629;21;6776;54;0.8;0.0
974;2021-02-05;564;97;7340;151;0.9;0.0
974;2021-02-06;501;6;7841;157;0.9;0.0
974;2021-02-07;0;8;7841;165;0.9;0.0
974;2021-02-08;470;34;8311;199;1.0;0.0
974;2021-02-09;787;93;9098;292;1.1;0.0
974;2021-02-10;820;87;9918;379;1.2;0.0
974;2021-02-11;795;89;10713;468;1.2;0.1
974;2021-02-12;638;95;11351;563;1.3;0.1
974;2021-02-13;655;76;12006;639;1.4;0.1
974;2021-02-14;1;0;12007;639;1.4;0.1
974;2021-02-15;526;129;12533;768;1.5;0.1
974;2021-02-16;651;533;13184;1301;1.5;0.2
974;2021-02-17;593;327;13777;1628;1.6;0.2
974;2021-02-18;495;409;14272;2037;1.7;0.2
974;2021-02-19;497;318;14769;2355;1.7;0.3
974;2021-02-20;577;116;15346;2471;1.8;0.3
974;2021-02-21;0;0;15346;2471;1.8;0.3
974;2021-02-22;403;237;15749;2708;1.8;0.3
974;2021-02-23;608;241;16357;2949;1.9;0.3
974;2021-02-24;583;254;16940;3203;2.0;0.4
974;2021-02-25;649;296;17589;3499;2.0;0.4
974;2021-02-26;485;468;18074;3967;2.1;0.5
974;2021-02-27;384;466;18458;4433;2.1;0.5
974;2021-02-28;0;0;18458;4433;2.1;0.5
974;2021-03-01;293;384;18751;4817;2.2;0.6
974;2021-03-02;487;500;19238;5317;2.2;0.6
974;2021-03-03;758;537;19996;5854;2.3;0.7
974;2021-03-04;778;492;20774;6346;2.4;0.7
974;2021-03-05;729;519;21503;6865;2.5;0.8
974;2021-03-06;814;526;22317;7391;2.6;0.9
974;2021-03-07;0;0;22317;7391;2.6;0.9
974;2021-03-08;435;554;22752;7945;2.6;0.9
974;2021-03-09;671;771;23423;8716;2.7;1.0
974;2021-03-10;644;837;24067;9553;2.8;1.1
974;2021-03-11;700;626;24767;10179;2.9;1.2
974;2021-03-12;732;656;25499;10835;3.0;1.3
974;2021-03-13;669;599;26168;11434;3.0;1.3
974;2021-03-14;2;0;26170;11434;3.0;1.3
974;2021-03-15;508;491;26678;11925;3.1;1.4
974;2021-03-16;681;693;27359;12618;3.2;1.5
974;2021-03-17;847;522;28206;13140;3.3;1.5
974;2021-03-18;1022;503;29228;13643;3.4;1.6
974;2021-03-19;786;528;30014;14171;3.5;1.6
974;2021-03-20;578;593;30592;14764;3.6;1.7
974;2021-03-21;0;0;30592;14764;3.6;1.7
974;2021-03-22;566;467;31158;15231;3.6;1.8
974;2021-03-23;780;635;31938;15866;3.7;1.8
974;2021-03-24;790;640;32728;16506;3.8;1.9
974;2021-03-25;934;539;33662;17045;3.9;2.0
974;2021-03-26;923;452;34585;17497;4.0;2.0
974;2021-03-27;781;335;35366;17832;4.1;2.1
974;2021-03-28;1;0;35367;17832;4.1;2.1
974;2021-03-29;960;272;36327;18104;4.2;2.1
974;2021-03-30;883;495;37210;18599;4.3;2.2
974;2021-03-31;736;657;37946;19256;4.4;2.2
974;2021-04-01;718;706;38664;19962;4.5;2.3
974;2021-04-02;688;756;39352;20718;4.6;2.4
974;2021-04-03;699;700;40051;21418;4.7;2.5
974;2021-04-04;0;0;40051;21418;4.7;2.5
974;2021-04-05;0;0;40051;21418;4.7;2.5
974;2021-04-06;796;634;40847;22052;4.7;2.6
974;2021-04-07;1367;783;42214;22835;4.9;2.7
974;2021-04-08;1792;772;44006;23607;5.1;2.7
974;2021-04-09;1508;777;45514;24384;5.3;2.8
974;2021-04-10;1137;650;46651;25034;5.4;2.9
974;2021-04-11;2;0;46653;25034;5.4;2.9
974;2021-04-12;1238;548;47891;25582;5.6;3.0
974;2021-04-13;1439;751;49330;26333;5.7;3.1
974;2021-04-14;2066;771;51396;27104;6.0;3.2
974;2021-04-15;2510;957;53906;28061;6.3;3.3
974;2021-04-16;1936;786;55842;28847;6.5;3.4
974;2021-04-17;1290;604;57132;29451;6.6;3.4
974;2021-04-18;0;0;57132;29451;6.6;3.4
974;2021-04-19;1374;564;58506;30015;6.8;3.5
974;2021-04-20;1651;805;60157;30820;7.0;3.6
974;2021-04-21;2124;626;62281;31446;7.2;3.7
974;2021-04-22;2952;822;65233;32268;7.6;3.8
974;2021-04-23;2311;822;67544;33090;7.9;3.8
974;2021-04-24;1111;805;68655;33895;8.0;3.9
974;2021-04-25;3;0;68658;33895;8.0;3.9
974;2021-04-26;1172;911;69830;34806;8.1;4.0
974;2021-04-27;1687;1029;71517;35835;8.3;4.2
974;2021-04-28;2901;752;74418;36587;8.7;4.3
974;2021-04-29;3947;819;78365;37406;9.1;4.3
974;2021-04-30;3450;912;81815;38318;9.5;4.5
974;2021-05-01;2106;231;83921;38549;9.8;4.5
974;2021-05-02;1;0;83922;38549;9.8;4.5
974;2021-05-03;1865;576;85787;39125;10.0;4.5
974;2021-05-04;2127;1093;87914;40218;10.2;4.7
974;2021-05-05;3119;1648;91033;41866;10.6;4.9
974;2021-05-06;4001;1590;95034;43456;11.1;5.1
974;2021-05-07;3228;1525;98262;44981;11.4;5.2
974;2021-05-08;1578;506;99840;45487;11.6;5.3
974;2021-05-09;2;1;99842;45488;11.6;5.3
974;2021-05-10;2412;1001;102254;46489;11.9;5.4
974;2021-05-11;3650;1640;105904;48129;12.3;5.6
974;2021-05-12;4721;2403;110625;50532;12.9;5.9
974;2021-05-13;3553;600;114178;51132;13.3;5.9
974;2021-05-14;5276;2521;119454;53653;13.9;6.2
974;2021-05-15;3157;1537;122611;55190;14.3;6.4
974;2021-05-16;17;19;122628;55209;14.3;6.4
974;2021-05-17;2995;1498;125623;56707;14.6;6.6
974;2021-05-18;3765;1802;129388;58509;15.0;6.8
974;2021-05-19;4687;2435;134075;60944;15.6;7.1
974;2021-05-20;5139;2853;139214;63797;16.2;7.4
974;2021-05-21;4996;2629;144210;66426;16.8;7.7
974;2021-05-22;3372;1256;147582;67682;17.2;7.9
974;2021-05-23;6;3;147588;67685;17.2;7.9
974;2021-05-24;3644;1078;151232;68763;17.6;8.0
974;2021-05-25;4248;1923;155480;70686;18.1;8.2
974;2021-05-26;4985;2993;160465;73679;18.7;8.6
974;2021-05-27;4620;4101;165085;77780;19.2;9.0
974;2021-05-28;4384;3837;169469;81617;19.7;9.5
974;2021-05-29;2554;2457;172023;84074;20.0;9.8
974;2021-05-30;8;14;172031;84088;20.0;9.8
974;2021-05-31;2347;2251;174378;86339;20.3;10.0
974;2021-06-01;3301;2762;177679;89101;20.7;10.4
974;2021-06-02;3968;3366;181647;92467;21.1;10.8
974;2021-06-03;4042;3653;185689;96120;21.6;11.2
974;2021-06-04;3849;3758;189538;99878;22.0;11.6
974;2021-06-05;2213;1931;191751;101809;22.3;11.8
974;2021-06-06;1074;135;192825;101944;22.4;11.9
974;2021-06-07;2012;2526;194837;104470;22.7;12.1
974;2021-06-08;2558;3339;197395;107809;23.0;12.5
974;2021-06-09;2982;4839;200377;112648;23.3;13.1
974;2021-06-10;3411;4466;203788;117114;23.7;13.6
974;2021-06-11;2840;4623;206628;121737;24.0;14.2
974;2021-06-12;1726;3379;208354;125116;24.2;14.5
974;2021-06-13;1324;246;209678;125362;24.4;14.6
974;2021-06-14;1489;3181;211167;128543;24.6;14.9
974;2021-06-15;2060;3617;213227;132160;24.8;15.4
974;2021-06-16;2748;4664;215975;136824;25.1;15.9
974;2021-06-17;2522;4896;218497;141720;25.4;16.5
974;2021-06-18;2597;4890;221094;146610;25.7;17.0
974;2021-06-19;1300;3516;222394;150126;25.9;17.5
974;2021-06-20;633;289;223027;150415;25.9;17.5
974;2021-06-21;1265;3235;224292;153650;26.1;17.9
974;2021-06-22;1618;3760;225910;157410;26.3;18.3
974;2021-06-23;2258;4994;228168;162404;26.5;18.9
974;2021-06-24;2280;4069;230448;166473;26.8;19.4
974;2021-06-25;2188;4107;232636;170580;27.1;19.8
974;2021-06-26;1401;2712;234037;173292;27.2;20.2
974;2021-06-27;664;268;234701;173560;27.3;20.2
974;2021-06-28;1307;2480;236008;176040;27.4;20.5
974;2021-06-29;1755;2846;237763;178886;27.6;20.8
974;2021-06-30;2561;3843;240324;182729;27.9;21.2
974;2021-07-01;2699;3826;243023;186555;28.3;21.7
974;2021-07-02;2511;3708;245534;190263;28.6;22.1
974;2021-07-03;1613;2457;247147;192720;28.7;22.4
974;2021-07-04;881;1039;248028;193759;28.8;22.5
974;2021-07-05;1698;2223;249726;195982;29.0;22.8
974;2021-07-06;2569;2545;252295;198527;29.3;23.1
974;2021-07-07;2665;3135;254960;201662;29.6;23.5
974;2021-07-08;2417;3173;257377;204835;29.9;23.8
974;2021-07-09;2761;3429;260138;208264;30.3;24.2
974;2021-07-10;1618;2192;261756;210456;30.4;24.5
974;2021-07-11;729;1017;262485;211473;30.5;24.6
974;2021-07-12;1745;2605;264230;214078;30.7;24.9
974;2021-07-13;4433;3348;268663;217426;31.2;25.3
974;2021-07-14;3300;608;271963;218034;31.6;25.4
974;2021-07-15;5556;4024;277519;222058;32.3;25.8
974;2021-07-16;6239;3301;283758;225359;33.0;26.2
974;2021-07-17;4374;1912;288132;227271;33.5;26.4
974;2021-07-18;2673;765;290805;228036;33.8;26.5
974;2021-07-19;4650;2030;295455;230066;34.4;26.8
974;2021-07-20;6232;2431;301687;232497;35.1;27.0
974;2021-07-21;6745;2863;308432;235360;35.9;27.4
974;2021-07-22;7140;2826;315572;238186;36.7;27.7
974;2021-07-23;6641;2982;322213;241168;37.5;28.0
974;2021-07-24;3800;2066;326013;243234;37.9;28.3
974;2021-07-25;2522;754;328535;243988;38.2;28.4
974;2021-07-26;4371;2098;332906;246086;38.7;28.6
974;2021-07-27;5442;2561;338348;248647;39.3;28.9
974;2021-07-28;5395;2909;343743;251556;40.0;29.3
974;2021-07-29;5743;2813;349486;254369;40.6;29.6
974;2021-07-30;5877;2582;355363;256951;41.3;29.9
974;2021-07-31;3936;1649;359299;258600;41.8;30.1
974;2021-08-01;1907;716;361206;259316;42.0;30.2
974;2021-08-02;3435;1869;364641;261185;42.4;30.4
974;2021-08-03;4300;4075;368941;265260;42.9;30.8
974;2021-08-04;4878;4232;373819;269492;43.5;31.3
974;2021-08-05;4446;4667;378265;274159;44.0;31.9
974;2021-08-06;4082;5104;382347;279263;44.5;32.5
974;2021-08-07;2748;4042;385095;283305;44.8;32.9
974;2021-08-08;1481;2265;386576;285570;45.0;33.2
974;2021-08-09;2574;4525;389150;290095;45.3;33.7
974;2021-08-10;3790;4964;392940;295059;45.7;34.3
974;2021-08-11;4644;5448;397584;300507;46.2;34.9
974;2021-08-12;4714;5917;402298;306424;46.8;35.6
974;2021-08-13;4458;5828;406756;312252;47.3;36.3
974;2021-08-14;2608;4329;409364;316581;47.6;36.8
974;2021-08-15;1573;2175;410937;318756;47.8;37.1
974;2021-08-16;2345;4181;413282;322937;48.1;37.6
974;2021-08-17;3187;4525;416469;327462;48.4;38.1
974;2021-08-18;3347;5900;419816;333362;48.8;38.8
974;2021-08-19;3311;4908;423127;338270;49.2;39.3
974;2021-08-20;3441;5274;426568;343544;49.6;39.9
974;2021-08-21;1832;4615;428400;348159;49.8;40.5
974;2021-08-22;1019;1944;429419;350103;49.9;40.7
974;2021-08-23;1815;3328;431234;353431;50.1;41.1
974;2021-08-24;2461;3774;433695;357205;50.4;41.5
974;2021-08-25;2907;5217;436602;362422;50.8;42.1
974;2021-08-26;2669;3870;439271;366292;51.1;42.6
974;2021-08-27;2780;4011;442051;370303;51.4;43.1
974;2021-08-28;1865;3884;443916;374187;51.6;43.5
974;2021-08-29;760;1574;444676;375761;51.7;43.7
974;2021-08-30;1565;2528;446241;378289;51.9;44.0
974;2021-08-31;1866;3333;448107;381622;52.1;44.4
974;2021-09-01;2407;4874;450514;386496;52.4;44.9
974;2021-09-02;2257;4280;452771;390776;52.7;45.4
974;2021-09-03;2339;4472;455110;395248;52.9;46.0
974;2021-09-04;1586;3890;456696;399138;53.1;46.4
974;2021-09-05;607;1309;457303;400447;53.2;46.6
974;2021-09-06;1215;2499;458518;402946;53.3;46.9
974;2021-09-07;1365;3110;459883;406056;53.5;47.2
974;2021-09-08;2120;3884;462003;409940;53.7;47.7
974;2021-09-09;1801;3329;463804;413269;53.9;48.1
974;2021-09-10;1931;3722;465735;416991;54.2;48.5
974;2021-09-11;1535;2469;467270;419460;54.3;48.8
974;2021-09-12;391;960;467661;420420;54.4;48.9
974;2021-09-13;1084;1847;468745;422267;54.5;49.1
974;2021-09-14;1514;2329;470259;424596;54.7;49.4
974;2021-09-15;1824;3031;472083;427627;54.9;49.7
974;2021-09-16;1400;2782;473483;430409;55.1;50.0
974;2021-09-17;1500;3063;474983;433472;55.2;50.4
974;2021-09-18;1203;1955;476186;435427;55.4;50.6
974;2021-09-19;291;716;476477;436143;55.4;50.7
974;2021-09-20;720;1632;477197;437775;55.5;50.9
974;2021-09-21;835;1816;478032;439591;55.6;51.1
974;2021-09-22;1256;2516;479288;442107;55.7;51.4
974;2021-09-23;846;2119;480134;444226;55.8;51.7
974;2021-09-24;1099;2475;481233;446701;56.0;51.9
974;2021-09-25;767;1879;482000;448580;56.0;52.2
974;2021-09-26;160;518;482160;449098;56.1;52.2
974;2021-09-27;607;1071;482767;450169;56.1;52.3
974;2021-09-28;850;1536;483617;451705;56.2;52.5
974;2021-09-29;1199;2329;484816;454034;56.4;52.8
974;2021-09-30;998;1753;485814;455787;56.5;53.0
974;2021-10-01;1278;1989;487092;457776;56.6;53.2
974;2021-10-02;946;1468;488038;459244;56.8;53.4
974;2021-10-03;265;387;488303;459631;56.8;53.4
974;2021-10-04;722;1150;489025;460781;56.9;53.6
974;2021-10-05;961;1345;489986;462126;57.0;53.7
974;2021-10-06;1195;1913;491181;464039;57.1;54.0
974;2021-10-07;991;1477;492172;465516;57.2;54.1
974;2021-10-08;1144;1807;493316;467323;57.4;54.3
974;2021-10-09;904;1326;494220;468649;57.5;54.5
974;2021-10-10;210;238;494430;468887;57.5;54.5
974;2021-10-11;1024;943;495454;469830;57.6;54.6
976;2020-12-27;0;0;0;0;0.0;0.0
976;2020-12-28;0;0;0;0;0.0;0.0
976;2020-12-29;0;0;0;0;0.0;0.0
976;2020-12-30;0;0;0;0;0.0;0.0
976;2020-12-31;0;0;0;0;0.0;0.0
976;2021-01-01;0;0;0;0;0.0;0.0
976;2021-01-02;0;0;0;0;0.0;0.0
976;2021-01-03;0;0;0;0;0.0;0.0
976;2021-01-04;0;0;0;0;0.0;0.0
976;2021-01-05;0;0;0;0;0.0;0.0
976;2021-01-06;0;0;0;0;0.0;0.0
976;2021-01-07;0;0;0;0;0.0;0.0
976;2021-01-08;0;0;0;0;0.0;0.0
976;2021-01-09;0;0;0;0;0.0;0.0
976;2021-01-10;0;0;0;0;0.0;0.0
976;2021-01-11;9;0;9;0;0.0;0.0
976;2021-01-12;0;0;9;0;0.0;0.0
976;2021-01-13;0;0;9;0;0.0;0.0
976;2021-01-14;0;0;9;0;0.0;0.0
976;2021-01-15;1;0;10;0;0.0;0.0
976;2021-01-16;1;0;11;0;0.0;0.0
976;2021-01-17;0;0;11;0;0.0;0.0
976;2021-01-18;1;0;12;0;0.0;0.0
976;2021-01-19;0;0;12;0;0.0;0.0
976;2021-01-20;0;0;12;0;0.0;0.0
976;2021-01-21;1;1;13;1;0.0;0.0
976;2021-01-22;0;0;13;1;0.0;0.0
976;2021-01-23;1;0;14;1;0.0;0.0
976;2021-01-24;0;0;14;1;0.0;0.0
976;2021-01-25;144;3;158;4;0.1;0.0
976;2021-01-26;167;3;325;7;0.1;0.0
976;2021-01-27;250;4;575;11;0.2;0.0
976;2021-01-28;104;9;679;20;0.2;0.0
976;2021-01-29;233;5;912;25;0.3;0.0
976;2021-01-30;286;11;1198;36;0.4;0.0
976;2021-01-31;1;0;1199;36;0.4;0.0
976;2021-02-01;161;2;1360;38;0.5;0.0
976;2021-02-02;328;11;1688;49;0.6;0.0
976;2021-02-03;227;4;1915;53;0.7;0.0
976;2021-02-04;215;10;2130;63;0.8;0.0
976;2021-02-05;213;1;2343;64;0.8;0.0
976;2021-02-06;83;10;2426;74;0.9;0.0
976;2021-02-07;0;0;2426;74;0.9;0.0
976;2021-02-08;82;4;2508;78;0.9;0.0
976;2021-02-09;194;2;2702;80;1.0;0.0
976;2021-02-10;187;5;2889;85;1.0;0.0
976;2021-02-11;236;5;3125;90;1.1;0.0
976;2021-02-12;288;7;3413;97;1.2;0.0
976;2021-02-13;56;0;3469;97;1.2;0.0
976;2021-02-14;2;0;3471;97;1.2;0.0
976;2021-02-15;358;11;3829;108;1.4;0.0
976;2021-02-16;266;10;4095;118;1.5;0.0
976;2021-02-17;167;9;4262;127;1.5;0.0
976;2021-02-18;217;16;4479;143;1.6;0.1
976;2021-02-19;237;24;4716;167;1.7;0.1
976;2021-02-20;138;9;4854;176;1.7;0.1
976;2021-02-21;0;0;4854;176;1.7;0.1
976;2021-02-22;130;121;4984;297;1.8;0.1
976;2021-02-23;185;156;5169;453;1.8;0.2
976;2021-02-24;176;146;5345;599;1.9;0.2
976;2021-02-25;227;278;5572;877;2.0;0.3
976;2021-02-26;242;247;5814;1124;2.1;0.4
976;2021-02-27;0;0;5814;1124;2.1;0.4
976;2021-02-28;0;0;5814;1124;2.1;0.4
976;2021-03-01;146;258;5960;1382;2.1;0.5
976;2021-03-02;228;260;6188;1642;2.2;0.6
976;2021-03-03;202;190;6390;1832;2.3;0.7
976;2021-03-04;205;145;6595;1977;2.4;0.7
976;2021-03-05;225;118;6820;2095;2.4;0.7
976;2021-03-06;1;0;6821;2095;2.4;0.7
976;2021-03-07;1;0;6822;2095;2.4;0.7
976;2021-03-08;189;112;7011;2207;2.5;0.8
976;2021-03-09;390;164;7401;2371;2.6;0.8
976;2021-03-10;179;178;7580;2549;2.7;0.9
976;2021-03-11;167;209;7747;2758;2.8;1.0
976;2021-03-12;237;294;7984;3052;2.9;1.1
976;2021-03-13;3;1;7987;3053;2.9;1.1
976;2021-03-14;0;0;7987;3053;2.9;1.1
976;2021-03-15;157;295;8144;3348;2.9;1.2
976;2021-03-16;238;227;8382;3575;3.0;1.3
976;2021-03-17;264;147;8646;3722;3.1;1.3
976;2021-03-18;174;235;8820;3957;3.2;1.4
976;2021-03-19;174;298;8994;4255;3.2;1.5
976;2021-03-20;0;0;8994;4255;3.2;1.5
976;2021-03-21;0;0;8994;4255;3.2;1.5
976;2021-03-22;97;136;9091;4391;3.3;1.6
976;2021-03-23;136;239;9227;4630;3.3;1.7
976;2021-03-24;160;147;9387;4777;3.4;1.7
976;2021-03-25;184;206;9571;4983;3.4;1.8
976;2021-03-26;160;212;9731;5195;3.5;1.9
976;2021-03-27;18;0;9749;5195;3.5;1.9
976;2021-03-28;1;0;9750;5195;3.5;1.9
976;2021-03-29;0;2;9750;5197;3.5;1.9
976;2021-03-30;272;337;10022;5534;3.6;2.0
976;2021-03-31;225;124;10247;5658;3.7;2.0
976;2021-04-01;246;105;10493;5763;3.8;2.1
976;2021-04-02;286;263;10779;6026;3.9;2.2
976;2021-04-03;905;310;11684;6336;4.2;2.3
976;2021-04-04;2;0;11686;6336;4.2;2.3
976;2021-04-05;1;0;11687;6336;4.2;2.3
976;2021-04-06;161;277;11848;6613;4.2;2.4
976;2021-04-07;236;267;12084;6880;4.3;2.5
976;2021-04-08;283;140;12367;7020;4.4;2.5
976;2021-04-09;248;172;12615;7192;4.5;2.6
976;2021-04-10;181;114;12796;7306;4.6;2.6
976;2021-04-11;7;0;12803;7306;4.6;2.6
976;2021-04-12;0;19;12803;7325;4.6;2.6
976;2021-04-13;395;346;13198;7671;4.7;2.7
976;2021-04-14;239;206;13437;7877;4.8;2.8
976;2021-04-15;209;117;13646;7994;4.9;2.9
976;2021-04-16;215;127;13861;8121;5.0;2.9
976;2021-04-17;225;130;14086;8251;5.0;3.0
976;2021-04-18;1;0;14087;8251;5.0;3.0
976;2021-04-19;7;1;14094;8252;5.0;3.0
976;2021-04-20;367;222;14461;8474;5.2;3.0
976;2021-04-21;412;151;14873;8625;5.3;3.1
976;2021-04-22;410;151;15283;8776;5.5;3.1
976;2021-04-23;366;166;15649;8942;5.6;3.2
976;2021-04-24;414;130;16063;9072;5.7;3.2
976;2021-04-25;3;0;16066;9072;5.7;3.2
976;2021-04-26;55;8;16121;9080;5.8;3.2
976;2021-04-27;350;292;16471;9372;5.9;3.4
976;2021-04-28;355;514;16826;9886;6.0;3.5
976;2021-04-29;559;344;17385;10230;6.2;3.7
976;2021-04-30;408;239;17793;10469;6.4;3.7
976;2021-05-01;672;288;18465;10757;6.6;3.8
976;2021-05-02;0;0;18465;10757;6.6;3.8
976;2021-05-03;140;6;18605;10763;6.7;3.9
976;2021-05-04;355;426;18960;11189;6.8;4.0
976;2021-05-05;447;318;19407;11507;6.9;4.1
976;2021-05-06;320;203;19727;11710;7.1;4.2
976;2021-05-07;341;133;20068;11843;7.2;4.2
976;2021-05-08;309;142;20377;11985;7.3;4.3
976;2021-05-09;0;0;20377;11985;7.3;4.3
976;2021-05-10;9;9;20386;11994;7.3;4.3
976;2021-05-11;363;492;20749;12486;7.4;4.5
976;2021-05-12;334;310;21083;12796;7.5;4.6
976;2021-05-13;126;96;21209;12892;7.6;4.6
976;2021-05-14;0;0;21209;12892;7.6;4.6
976;2021-05-15;485;282;21694;13174;7.8;4.7
976;2021-05-16;1;0;21695;13174;7.8;4.7
976;2021-05-17;124;51;21819;13225;7.8;4.7
976;2021-05-18;518;430;22337;13655;8.0;4.9
976;2021-05-19;651;663;22988;14318;8.2;5.1
976;2021-05-20;1056;499;24044;14817;8.6;5.3
976;2021-05-21;1045;313;25089;15130;9.0;5.4
976;2021-05-22;1241;298;26330;15428;9.4;5.5
976;2021-05-23;0;0;26330;15428;9.4;5.5
976;2021-05-24;1;0;26331;15428;9.4;5.5
976;2021-05-25;890;622;27221;16050;9.7;5.7
976;2021-05-26;1033;843;28254;16893;10.1;6.0
976;2021-05-27;1321;512;29575;17405;10.6;6.2
976;2021-05-28;956;375;30531;17780;10.9;6.4
976;2021-05-29;1130;392;31661;18172;11.3;6.5
976;2021-05-30;1;1;31662;18173;11.3;6.5
976;2021-05-31;107;6;31769;18179;11.4;6.5
976;2021-06-01;1149;652;32918;18831;11.8;6.7
976;2021-06-02;1244;532;34162;19363;12.2;6.9
976;2021-06-03;813;355;34975;19718;12.5;7.1
976;2021-06-04;1000;325;35975;20043;12.9;7.2
976;2021-06-05;680;299;36655;20342;13.1;7.3
976;2021-06-06;1;0;36656;20342;13.1;7.3
976;2021-06-07;93;12;36749;20354;13.1;7.3
976;2021-06-08;952;442;37701;20796;13.5;7.4
976;2021-06-09;969;550;38670;21346;13.8;7.6
976;2021-06-10;704;232;39374;21578;14.1;7.7
976;2021-06-11;850;365;40224;21943;14.4;7.9
976;2021-06-12;583;275;40807;22218;14.6;8.0
976;2021-06-13;2;0;40809;22218;14.6;8.0
976;2021-06-14;187;112;40996;22330;14.7;8.0
976;2021-06-15;413;838;41409;23168;14.8;8.3
976;2021-06-16;891;1440;42300;24608;15.1;8.8
976;2021-06-17;799;661;43099;25269;15.4;9.0
976;2021-06-18;705;620;43804;25889;15.7;9.3
976;2021-06-19;537;645;44341;26534;15.9;9.5
976;2021-06-20;1;0;44342;26534;15.9;9.5
976;2021-06-21;127;132;44469;26666;15.9;9.5
976;2021-06-22;429;1150;44898;27816;16.1;10.0
976;2021-06-23;695;1186;45593;29002;16.3;10.4
976;2021-06-24;480;544;46073;29546;16.5;10.6
976;2021-06-25;542;479;46615;30025;16.7;10.7
976;2021-06-26;386;692;47001;30717;16.8;11.0
976;2021-06-27;1;0;47002;30717;16.8;11.0
976;2021-06-28;109;191;47111;30908;16.9;11.1
976;2021-06-29;746;973;47857;31881;17.1;11.4
976;2021-06-30;714;948;48571;32829;17.4;11.7
976;2021-07-01;591;547;49162;33376;17.6;11.9
976;2021-07-02;451;432;49613;33808;17.8;12.1
976;2021-07-03;443;422;50056;34230;17.9;12.2
976;2021-07-04;2;0;50058;34230;17.9;12.2
976;2021-07-05;121;223;50179;34453;18.0;12.3
976;2021-07-06;498;865;50677;35318;18.1;12.6
976;2021-07-07;771;1014;51448;36332;18.4;13.0
976;2021-07-08;834;636;52282;36968;18.7;13.2
976;2021-07-09;786;519;53068;37487;19.0;13.4
976;2021-07-10;441;319;53509;37806;19.1;13.5
976;2021-07-11;0;0;53509;37806;19.1;13.5
976;2021-07-12;164;170;53673;37976;19.2;13.6
976;2021-07-13;847;1000;54520;38976;19.5;13.9
976;2021-07-14;1;5;54521;38981;19.5;13.9
976;2021-07-15;1221;812;55742;39793;19.9;14.2
976;2021-07-16;1291;656;57033;40449;20.4;14.5
976;2021-07-17;1033;377;58066;40826;20.8;14.6
976;2021-07-18;0;0;58066;40826;20.8;14.6
976;2021-07-19;206;134;58272;40960;20.9;14.7
976;2021-07-20;1155;877;59427;41837;21.3;15.0
976;2021-07-21;34;29;59461;41866;21.3;15.0
976;2021-07-22;1123;666;60584;42532;21.7;15.2
976;2021-07-23;1206;545;61790;43077;22.1;15.4
976;2021-07-24;855;440;62645;43517;22.4;15.6
976;2021-07-25;2;0;62647;43517;22.4;15.6
976;2021-07-26;180;37;62827;43554;22.5;15.6
976;2021-07-27;1139;827;63966;44381;22.9;15.9
976;2021-07-28;1043;634;65009;45015;23.3;16.1
976;2021-07-29;1234;566;66243;45581;23.7;16.3
976;2021-07-30;1218;412;67461;45993;24.1;16.5
976;2021-07-31;760;277;68221;46270;24.4;16.6
976;2021-08-01;5;3;68226;46273;24.4;16.6
976;2021-08-02;344;174;68570;46447;24.5;16.6
976;2021-08-03;1505;935;70075;47382;25.1;17.0
976;2021-08-04;1828;808;71903;48190;25.7;17.2
976;2021-08-05;1462;504;73365;48694;26.3;17.4
976;2021-08-06;1691;509;75056;49203;26.9;17.6
976;2021-08-07;912;358;75968;49561;27.2;17.7
976;2021-08-08;7;1;75975;49562;27.2;17.7
976;2021-08-09;529;236;76504;49798;27.4;17.8
976;2021-08-10;1641;1380;78145;51178;28.0;18.3
976;2021-08-11;2045;1239;80190;52417;28.7;18.8
976;2021-08-12;1712;621;81902;53038;29.3;19.0
976;2021-08-13;1573;536;83475;53574;29.9;19.2
976;2021-08-14;833;456;84308;54030;30.2;19.3
976;2021-08-15;0;0;84308;54030;30.2;19.3
976;2021-08-16;568;291;84876;54321;30.4;19.4
976;2021-08-17;1828;1301;86704;55622;31.0;19.9
976;2021-08-18;2233;1227;88937;56849;31.8;20.3
976;2021-08-19;1981;555;90918;57404;32.5;20.5
976;2021-08-20;1810;552;92728;57956;33.2;20.7
976;2021-08-21;1059;522;93787;58478;33.6;20.9
976;2021-08-22;15;0;93802;58478;33.6;20.9
976;2021-08-23;577;271;94379;58749;33.8;21.0
976;2021-08-24;1063;1009;95442;59758;34.2;21.4
976;2021-08-25;1083;1293;96525;61051;34.5;21.8
976;2021-08-26;911;574;97436;61625;34.9;22.1
976;2021-08-27;740;565;98176;62190;35.1;22.3
976;2021-08-28;472;857;98648;63047;35.3;22.6
976;2021-08-29;0;12;98648;63059;35.3;22.6
976;2021-08-30;161;253;98809;63312;35.4;22.7
976;2021-08-31;654;1160;99463;64472;35.6;23.1
976;2021-09-01;820;1392;100283;65864;35.9;23.6
976;2021-09-02;849;903;101132;66767;36.2;23.9
976;2021-09-03;909;1287;102041;68054;36.5;24.4
976;2021-09-04;433;1000;102474;69054;36.7;24.7
976;2021-09-05;0;1;102474;69055;36.7;24.7
976;2021-09-06;445;397;102919;69452;36.8;24.9
976;2021-09-07;742;699;103661;70151;37.1;25.1
976;2021-09-08;1111;1262;104772;71413;37.5;25.6
976;2021-09-09;889;1008;105661;72421;37.8;25.9
976;2021-09-10;1222;1081;106883;73502;38.2;26.3
976;2021-09-11;534;1033;107417;74535;38.4;26.7
976;2021-09-12;0;32;107417;74567;38.4;26.7
976;2021-09-13;707;616;108124;75183;38.7;26.9
976;2021-09-14;1097;719;109221;75902;39.1;27.2
976;2021-09-15;1687;1185;110908;77087;39.7;27.6
976;2021-09-16;1745;894;112653;77981;40.3;27.9
976;2021-09-17;1843;1062;114496;79043;41.0;28.3
976;2021-09-18;967;781;115463;79824;41.3;28.6
976;2021-09-19;1;52;115464;79876;41.3;28.6
976;2021-09-20;1020;543;116484;80419;41.7;28.8
976;2021-09-21;1649;772;118133;81191;42.3;29.1
976;2021-09-22;1443;964;119576;82155;42.8;29.4
976;2021-09-23;1021;879;120597;83034;43.2;29.7
976;2021-09-24;1084;1011;121681;84045;43.5;30.1
976;2021-09-25;489;479;122170;84524;43.7;30.2
976;2021-09-26;0;21;122170;84545;43.7;30.3
976;2021-09-27;691;423;122861;84968;44.0;30.4
976;2021-09-28;1166;924;124027;85892;44.4;30.7
976;2021-09-29;1330;1059;125357;86951;44.9;31.1
976;2021-09-30;995;687;126352;87638;45.2;31.4
976;2021-10-01;1261;1368;127613;89006;45.7;31.8
976;2021-10-02;456;649;128069;89655;45.8;32.1
976;2021-10-03;0;0;128069;89655;45.8;32.1
976;2021-10-04;744;618;128813;90273;46.1;32.3
976;2021-10-05;780;967;129593;91240;46.4;32.6
976;2021-10-06;1204;1405;130797;92645;46.8;33.2
976;2021-10-07;804;1125;131601;93770;47.1;33.6
976;2021-10-08;1258;1391;132859;95161;47.5;34.1
976;2021-10-09;463;855;133322;96016;47.7;34.4
976;2021-10-10;0;0;133322;96016;47.7;34.4
976;2021-10-11;1042;709;134364;96725;48.1;34.6
977;2020-12-27;0;0;0;0;0.0;0.0
977;2020-12-28;0;0;0;0;0.0;0.0
977;2020-12-29;0;0;0;0;0.0;0.0
977;2020-12-30;0;0;0;0;0.0;0.0
977;2020-12-31;0;0;0;0;0.0;0.0
977;2021-01-01;0;0;0;0;0.0;0.0
977;2021-01-02;0;0;0;0;0.0;0.0
977;2021-01-03;0;0;0;0;0.0;0.0
977;2021-01-04;0;0;0;0;0.0;0.0
977;2021-01-05;0;0;0;0;0.0;0.0
977;2021-01-06;0;0;0;0;0.0;0.0
977;2021-01-07;0;0;0;0;0.0;0.0
977;2021-01-08;0;0;0;0;0.0;0.0
977;2021-01-09;0;0;0;0;0.0;0.0
977;2021-01-10;0;0;0;0;0.0;0.0
977;2021-01-11;0;0;0;0;0.0;0.0
977;2021-01-12;0;0;0;0;0.0;0.0
977;2021-01-13;0;0;0;0;0.0;0.0
977;2021-01-14;0;0;0;0;0.0;0.0
977;2021-01-15;0;0;0;0;0.0;0.0
977;2021-01-16;0;0;0;0;0.0;0.0
977;2021-01-17;0;0;0;0;0.0;0.0
977;2021-01-18;1;0;1;0;0.0;0.0
977;2021-01-19;0;0;1;0;0.0;0.0
977;2021-01-20;0;0;1;0;0.0;0.0
977;2021-01-21;12;0;13;0;0.1;0.0
977;2021-01-22;12;0;25;0;0.3;0.0
977;2021-01-23;0;0;25;0;0.3;0.0
977;2021-01-24;0;0;25;0;0.3;0.0
977;2021-01-25;0;0;25;0;0.3;0.0
977;2021-01-26;0;0;25;0;0.3;0.0
977;2021-01-27;12;0;37;0;0.4;0.0
977;2021-01-28;1;0;38;0;0.4;0.0
977;2021-01-29;6;0;44;0;0.4;0.0
977;2021-01-30;0;0;44;0;0.4;0.0
977;2021-01-31;0;0;44;0;0.4;0.0
977;2021-02-01;0;0;44;0;0.4;0.0
977;2021-02-02;0;0;44;0;0.4;0.0
977;2021-02-03;11;0;55;0;0.6;0.0
977;2021-02-04;12;0;67;0;0.7;0.0
977;2021-02-05;11;0;78;0;0.8;0.0
977;2021-02-06;0;0;78;0;0.8;0.0
977;2021-02-07;0;0;78;0;0.8;0.0
977;2021-02-08;0;0;78;0;0.8;0.0
977;2021-02-09;14;0;92;0;0.9;0.0
977;2021-02-10;0;0;92;0;0.9;0.0
977;2021-02-11;18;0;110;0;1.1;0.0
977;2021-02-12;46;0;156;0;1.6;0.0
977;2021-02-13;0;0;156;0;1.6;0.0
977;2021-02-14;0;0;156;0;1.6;0.0
977;2021-02-15;0;0;156;0;1.6;0.0
977;2021-02-16;0;0;156;0;1.6;0.0
977;2021-02-17;0;0;156;0;1.6;0.0
977;2021-02-18;19;0;175;0;1.8;0.0
977;2021-02-19;35;0;210;0;2.1;0.0
977;2021-02-20;0;0;210;0;2.1;0.0
977;2021-02-21;0;0;210;0;2.1;0.0
977;2021-02-22;0;0;210;0;2.1;0.0
977;2021-02-23;0;21;210;21;2.1;0.2
977;2021-02-24;0;0;210;21;2.1;0.2
977;2021-02-25;15;9;225;30;2.3;0.3
977;2021-02-26;33;18;258;48;2.6;0.5
977;2021-02-27;0;0;258;48;2.6;0.5
977;2021-02-28;0;0;258;48;2.6;0.5
977;2021-03-01;0;0;258;48;2.6;0.5
977;2021-03-02;19;11;277;59;2.8;0.6
977;2021-03-03;0;0;277;59;2.8;0.6
977;2021-03-04;16;12;293;71;2.9;0.7
977;2021-03-05;35;18;328;89;3.3;0.9
977;2021-03-06;0;0;328;89;3.3;0.9
977;2021-03-07;0;0;328;89;3.3;0.9
977;2021-03-08;0;0;328;89;3.3;0.9
977;2021-03-09;1;0;329;89;3.3;0.9
977;2021-03-10;0;0;329;89;3.3;0.9
977;2021-03-11;20;30;349;119;3.5;1.2
977;2021-03-12;62;42;411;161;4.1;1.6
977;2021-03-13;0;0;411;161;4.1;1.6
977;2021-03-14;0;0;411;161;4.1;1.6
977;2021-03-15;0;0;411;161;4.1;1.6
977;2021-03-16;30;10;441;171;4.4;1.7
977;2021-03-17;0;0;441;171;4.4;1.7
977;2021-03-18;30;16;471;187;4.7;1.9
977;2021-03-19;58;28;529;215;5.3;2.2
977;2021-03-20;0;0;529;215;5.3;2.2
977;2021-03-21;0;0;529;215;5.3;2.2
977;2021-03-22;0;0;529;215;5.3;2.2
977;2021-03-23;0;0;529;215;5.3;2.2
977;2021-03-24;0;0;529;215;5.3;2.2
977;2021-03-25;65;17;594;232;6.0;2.3
977;2021-03-26;73;26;667;258;6.7;2.6
977;2021-03-27;0;0;667;258;6.7;2.6
977;2021-03-28;0;0;667;258;6.7;2.6
977;2021-03-29;0;0;667;258;6.7;2.6
977;2021-03-30;39;17;706;275;7.1;2.8
977;2021-03-31;26;15;732;290;7.3;2.9
977;2021-04-01;25;32;757;322;7.6;3.2
977;2021-04-02;0;0;757;322;7.6;3.2
977;2021-04-03;0;0;757;322;7.6;3.2
977;2021-04-04;0;0;757;322;7.6;3.2
977;2021-04-05;9;0;766;322;7.7;3.2
977;2021-04-06;0;0;766;322;7.7;3.2
977;2021-04-07;0;0;766;322;7.7;3.2
977;2021-04-08;57;46;823;368;8.3;3.7
977;2021-04-09;58;32;881;400;8.8;4.0
977;2021-04-10;0;0;881;400;8.8;4.0
977;2021-04-11;0;0;881;400;8.8;4.0
977;2021-04-12;0;0;881;400;8.8;4.0
977;2021-04-13;0;0;881;400;8.8;4.0
977;2021-04-14;5;5;886;405;8.9;4.1
977;2021-04-15;57;70;943;475;9.5;4.8
977;2021-04-16;89;35;1032;510;10.4;5.1
977;2021-04-17;0;1;1032;511;10.4;5.1
977;2021-04-18;0;0;1032;511;10.4;5.1
977;2021-04-19;1;0;1033;511;10.4;5.1
977;2021-04-20;335;62;1368;573;13.7;5.8
977;2021-04-21;337;30;1705;603;17.1;6.1
977;2021-04-22;284;48;1989;651;20.0;6.5
977;2021-04-23;260;43;2249;694;22.6;7.0
977;2021-04-24;231;1;2480;695;24.9;7.0
977;2021-04-25;0;0;2480;695;24.9;7.0
977;2021-04-26;284;20;2764;715;27.7;7.2
977;2021-04-27;224;68;2988;783;30.0;7.9
977;2021-04-28;192;26;3180;809;31.9;8.1
977;2021-04-29;170;23;3350;832;33.6;8.4
977;2021-04-30;171;17;3521;849;35.3;8.5
977;2021-05-01;202;12;3723;861;37.4;8.6
977;2021-05-02;0;0;3723;861;37.4;8.6
977;2021-05-03;135;9;3858;870;38.7;8.7
977;2021-05-04;161;54;4019;924;40.3;9.3
977;2021-05-05;221;28;4240;952;42.6;9.6
977;2021-05-06;175;33;4415;985;44.3;9.9
977;2021-05-07;149;32;4564;1017;45.8;10.2
977;2021-05-08;1;0;4565;1017;45.8;10.2
977;2021-05-09;0;0;4565;1017;45.8;10.2
977;2021-05-10;0;0;4565;1017;45.8;10.2
977;2021-05-11;3;41;4568;1058;45.9;10.6
977;2021-05-12;6;36;4574;1094;45.9;11.0
977;2021-05-13;0;0;4574;1094;45.9;11.0
977;2021-05-14;28;98;4602;1192;46.2;12.0
977;2021-05-15;0;0;4602;1192;46.2;12.0
977;2021-05-16;1;0;4603;1192;46.2;12.0
977;2021-05-17;1;14;4604;1206;46.2;12.1
977;2021-05-18;17;32;4621;1238;46.4;12.4
977;2021-05-19;1;2;4622;1240;46.4;12.4
977;2021-05-20;0;8;4622;1248;46.4;12.5
977;2021-05-21;12;31;4634;1279;46.5;12.8
977;2021-05-22;0;0;4634;1279;46.5;12.8
977;2021-05-23;0;0;4634;1279;46.5;12.8
977;2021-05-24;0;0;4634;1279;46.5;12.8
977;2021-05-25;50;331;4684;1610;47.0;16.2
977;2021-05-26;54;360;4738;1970;47.6;19.8
977;2021-05-27;34;317;4772;2287;47.9;23.0
977;2021-05-28;27;256;4799;2543;48.2;25.5
977;2021-05-29;35;375;4834;2918;48.5;29.3
977;2021-05-30;1;0;4835;2918;48.5;29.3
977;2021-05-31;45;216;4880;3134;49.0;31.5
977;2021-06-01;48;227;4928;3361;49.5;33.7
977;2021-06-02;69;273;4997;3634;50.2;36.5
977;2021-06-03;43;252;5040;3886;50.6;39.0
977;2021-06-04;82;270;5122;4156;51.4;41.7
977;2021-06-05;1;0;5123;4156;51.4;41.7
977;2021-06-06;0;0;5123;4156;51.4;41.7
977;2021-06-07;1;1;5124;4157;51.4;41.7
977;2021-06-08;8;2;5132;4159;51.5;41.8
977;2021-06-09;0;3;5132;4162;51.5;41.8
977;2021-06-10;8;4;5140;4166;51.6;41.8
977;2021-06-11;4;8;5144;4174;51.6;41.9
977;2021-06-12;15;59;5159;4233;51.8;42.5
977;2021-06-13;0;0;5159;4233;51.8;42.5
977;2021-06-14;0;0;5159;4233;51.8;42.5
977;2021-06-15;0;1;5159;4234;51.8;42.5
977;2021-06-16;0;0;5159;4234;51.8;42.5
977;2021-06-17;2;6;5161;4240;51.8;42.6
977;2021-06-18;0;2;5161;4242;51.8;42.6
977;2021-06-19;25;49;5186;4291;52.1;43.1
977;2021-06-20;0;0;5186;4291;52.1;43.1
977;2021-06-21;1;2;5187;4293;52.1;43.1
977;2021-06-22;9;0;5196;4293;52.2;43.1
977;2021-06-23;15;9;5211;4302;52.3;43.2
977;2021-06-24;10;5;5221;4307;52.4;43.2
977;2021-06-25;0;0;5221;4307;52.4;43.2
977;2021-06-26;25;45;5246;4352;52.7;43.7
977;2021-06-27;0;0;5246;4352;52.7;43.7
977;2021-06-28;0;0;5246;4352;52.7;43.7
977;2021-06-29;0;0;5246;4352;52.7;43.7
977;2021-06-30;0;0;5246;4352;52.7;43.7
977;2021-07-01;28;36;5274;4388;52.9;44.1
977;2021-07-02;26;31;5300;4419;53.2;44.4
977;2021-07-03;30;215;5330;4634;53.5;46.5
977;2021-07-04;0;0;5330;4634;53.5;46.5
977;2021-07-05;4;8;5334;4642;53.5;46.6
977;2021-07-06;0;0;5334;4642;53.5;46.6
977;2021-07-07;8;0;5342;4642;53.6;46.6
977;2021-07-08;33;23;5375;4665;54.0;46.8
977;2021-07-09;23;31;5398;4696;54.2;47.1
977;2021-07-10;33;45;5431;4741;54.5;47.6
977;2021-07-11;0;0;5431;4741;54.5;47.6
977;2021-07-12;0;1;5431;4742;54.5;47.6
977;2021-07-13;10;10;5441;4752;54.6;47.7
977;2021-07-14;0;0;5441;4752;54.6;47.7
977;2021-07-15;1;11;5442;4763;54.6;47.8
977;2021-07-16;44;51;5486;4814;55.1;48.3
977;2021-07-17;34;39;5520;4853;55.4;48.7
977;2021-07-18;1;0;5521;4853;55.4;48.7
977;2021-07-19;3;2;5524;4855;55.5;48.7
977;2021-07-20;3;1;5527;4856;55.5;48.8
977;2021-07-21;33;16;5560;4872;55.8;48.9
977;2021-07-22;36;33;5596;4905;56.2;49.2
977;2021-07-23;32;31;5628;4936;56.5;49.6
977;2021-07-24;42;25;5670;4961;56.9;49.8
977;2021-07-25;0;0;5670;4961;56.9;49.8
977;2021-07-26;13;10;5683;4971;57.1;49.9
977;2021-07-27;0;10;5683;4981;57.1;50.0
977;2021-07-28;31;14;5714;4995;57.4;50.1
977;2021-07-29;33;32;5747;5027;57.7;50.5
977;2021-07-30;31;28;5778;5055;58.0;50.7
977;2021-07-31;53;24;5831;5079;58.5;51.0
977;2021-08-01;0;0;5831;5079;58.5;51.0
977;2021-08-02;11;1;5842;5080;58.6;51.0
977;2021-08-03;0;0;5842;5080;58.6;51.0
977;2021-08-04;40;14;5882;5094;59.1;51.1
977;2021-08-05;28;30;5910;5124;59.3;51.4
977;2021-08-06;35;35;5945;5159;59.7;51.8
977;2021-08-07;56;25;6001;5184;60.2;52.0
977;2021-08-08;0;0;6001;5184;60.2;52.0
977;2021-08-09;7;5;6008;5189;60.3;52.1
977;2021-08-10;15;9;6023;5198;60.5;52.2
977;2021-08-11;36;18;6059;5216;60.8;52.4
977;2021-08-12;24;30;6083;5246;61.1;52.7
977;2021-08-13;32;14;6115;5260;61.4;52.8
977;2021-08-14;20;26;6135;5286;61.6;53.1
977;2021-08-15;0;0;6135;5286;61.6;53.1
977;2021-08-16;14;29;6149;5315;61.7;53.4
977;2021-08-17;15;8;6164;5323;61.9;53.4
977;2021-08-18;25;28;6189;5351;62.1;53.7
977;2021-08-19;31;36;6220;5387;62.4;54.1
977;2021-08-20;27;41;6247;5428;62.7;54.5
977;2021-08-21;35;41;6282;5469;63.1;54.9
977;2021-08-22;6;0;6288;5469;63.1;54.9
977;2021-08-23;3;11;6291;5480;63.2;55.0
977;2021-08-24;8;3;6299;5483;63.2;55.0
977;2021-08-25;20;37;6319;5520;63.4;55.4
977;2021-08-26;27;41;6346;5561;63.7;55.8
977;2021-08-27;27;35;6373;5596;64.0;56.2
977;2021-08-28;27;56;6400;5652;64.3;56.7
977;2021-08-29;0;0;6400;5652;64.3;56.7
977;2021-08-30;1;4;6401;5656;64.3;56.8
977;2021-08-31;1;2;6402;5658;64.3;56.8
977;2021-09-01;10;25;6412;5683;64.4;57.1
977;2021-09-02;22;32;6434;5715;64.6;57.4
977;2021-09-03;26;24;6460;5739;64.9;57.6
977;2021-09-04;37;44;6497;5783;65.2;58.1
977;2021-09-05;0;0;6497;5783;65.2;58.1
977;2021-09-06;4;16;6501;5799;65.3;58.2
977;2021-09-07;1;4;6502;5803;65.3;58.3
977;2021-09-08;12;11;6514;5814;65.4;58.4
977;2021-09-09;20;31;6534;5845;65.6;58.7
977;2021-09-10;7;31;6541;5876;65.7;59.0
977;2021-09-11;36;29;6577;5905;66.0;59.3
977;2021-09-12;0;6;6577;5911;66.0;59.3
977;2021-09-13;4;3;6581;5914;66.1;59.4
977;2021-09-14;1;0;6582;5914;66.1;59.4
977;2021-09-15;12;26;6594;5940;66.2;59.6
977;2021-09-16;15;31;6609;5971;66.3;59.9
977;2021-09-17;10;33;6619;6004;66.4;60.3
977;2021-09-18;20;39;6639;6043;66.6;60.7
977;2021-09-19;0;0;6639;6043;66.6;60.7
977;2021-09-20;0;2;6639;6045;66.6;60.7
977;2021-09-21;0;1;6639;6046;66.6;60.7
977;2021-09-22;10;11;6649;6057;66.8;60.8
977;2021-09-23;7;30;6656;6087;66.8;61.1
977;2021-09-24;0;0;6656;6087;66.8;61.1
977;2021-09-25;11;49;6667;6136;66.9;61.6
977;2021-09-26;0;0;6667;6136;66.9;61.6
977;2021-09-27;0;0;6667;6136;66.9;61.6
977;2021-09-28;0;1;6667;6137;66.9;61.6
977;2021-09-29;5;15;6672;6152;67.0;61.8
977;2021-09-30;18;19;6690;6171;67.2;62.0
977;2021-10-01;0;3;6690;6174;67.2;62.0
977;2021-10-02;10;39;6700;6213;67.3;62.4
977;2021-10-03;0;0;6700;6213;67.3;62.4
977;2021-10-04;0;0;6700;6213;67.3;62.4
977;2021-10-05;0;0;6700;6213;67.3;62.4
977;2021-10-06;15;23;6715;6236;67.4;62.6
977;2021-10-07;25;31;6740;6267;67.7;62.9
977;2021-10-08;3;2;6743;6269;67.7;62.9
977;2021-10-09;5;16;6748;6285;67.7;63.1
977;2021-10-10;0;0;6748;6285;67.7;63.1
977;2021-10-11;0;1;6748;6286;67.7;63.1
978;2020-12-27;0;0;0;0;0.0;0.0
978;2020-12-28;0;0;0;0;0.0;0.0
978;2020-12-29;0;0;0;0;0.0;0.0
978;2020-12-30;0;0;0;0;0.0;0.0
978;2020-12-31;0;0;0;0;0.0;0.0
978;2021-01-01;0;0;0;0;0.0;0.0
978;2021-01-02;0;0;0;0;0.0;0.0
978;2021-01-03;0;0;0;0;0.0;0.0
978;2021-01-04;0;0;0;0;0.0;0.0
978;2021-01-05;0;0;0;0;0.0;0.0
978;2021-01-06;0;0;0;0;0.0;0.0
978;2021-01-07;0;0;0;0;0.0;0.0
978;2021-01-08;0;0;0;0;0.0;0.0
978;2021-01-09;0;0;0;0;0.0;0.0
978;2021-01-10;0;0;0;0;0.0;0.0
978;2021-01-11;0;0;0;0;0.0;0.0
978;2021-01-12;0;0;0;0;0.0;0.0
978;2021-01-13;10;0;10;0;0.0;0.0
978;2021-01-14;12;1;22;1;0.1;0.0
978;2021-01-15;9;0;31;1;0.1;0.0
978;2021-01-16;0;0;31;1;0.1;0.0
978;2021-01-17;0;0;31;1;0.1;0.0
978;2021-01-18;0;0;31;1;0.1;0.0
978;2021-01-19;12;0;43;1;0.1;0.0
978;2021-01-20;13;0;56;1;0.2;0.0
978;2021-01-21;6;0;62;1;0.2;0.0
978;2021-01-22;0;0;62;1;0.2;0.0
978;2021-01-23;0;0;62;1;0.2;0.0
978;2021-01-24;0;0;62;1;0.2;0.0
978;2021-01-25;0;0;62;1;0.2;0.0
978;2021-01-26;9;0;71;1;0.2;0.0
978;2021-01-27;10;0;81;1;0.2;0.0
978;2021-01-28;6;1;87;2;0.2;0.0
978;2021-01-29;0;0;87;2;0.2;0.0
978;2021-01-30;0;0;87;2;0.2;0.0
978;2021-01-31;0;0;87;2;0.2;0.0
978;2021-02-01;1;0;88;2;0.2;0.0
978;2021-02-02;39;0;127;2;0.4;0.0
978;2021-02-03;11;0;138;2;0.4;0.0
978;2021-02-04;32;0;170;2;0.5;0.0
978;2021-02-05;6;0;176;2;0.5;0.0
978;2021-02-06;0;0;176;2;0.5;0.0
978;2021-02-07;0;0;176;2;0.5;0.0
978;2021-02-08;0;0;176;2;0.5;0.0
978;2021-02-09;38;0;214;2;0.6;0.0
978;2021-02-10;27;1;241;3;0.7;0.0
978;2021-02-11;0;0;241;3;0.7;0.0
978;2021-02-12;36;0;277;3;0.8;0.0
978;2021-02-13;0;0;277;3;0.8;0.0
978;2021-02-14;0;0;277;3;0.8;0.0
978;2021-02-15;50;1;327;4;0.9;0.0
978;2021-02-16;0;0;327;4;0.9;0.0
978;2021-02-17;0;0;327;4;0.9;0.0
978;2021-02-18;28;0;355;4;1.0;0.0
978;2021-02-19;44;0;399;4;1.1;0.0
978;2021-02-20;0;0;399;4;1.1;0.0
978;2021-02-21;0;0;399;4;1.1;0.0
978;2021-02-22;45;4;444;8;1.3;0.0
978;2021-02-23;41;29;485;37;1.4;0.1
978;2021-02-24;36;1;521;38;1.5;0.1
978;2021-02-25;55;36;576;74;1.6;0.2
978;2021-02-26;39;5;615;79;1.7;0.2
978;2021-02-27;0;0;615;79;1.7;0.2
978;2021-02-28;0;0;615;79;1.7;0.2
978;2021-03-01;50;5;665;84;1.9;0.2
978;2021-03-02;7;27;672;111;1.9;0.3
978;2021-03-03;53;29;725;140;2.1;0.4
978;2021-03-04;31;26;756;166;2.1;0.5
978;2021-03-05;46;10;802;176;2.3;0.5
978;2021-03-06;0;0;802;176;2.3;0.5
978;2021-03-07;0;0;802;176;2.3;0.5
978;2021-03-08;32;7;834;183;2.4;0.5
978;2021-03-09;21;27;855;210;2.4;0.6
978;2021-03-10;35;28;890;238;2.5;0.7
978;2021-03-11;2;0;892;238;2.5;0.7
978;2021-03-12;53;22;945;260;2.7;0.7
978;2021-03-13;13;0;958;260;2.7;0.7
978;2021-03-14;0;0;958;260;2.7;0.7
978;2021-03-15;31;41;989;301;2.8;0.9
978;2021-03-16;73;6;1062;307;3.0;0.9
978;2021-03-17;67;13;1129;320;3.2;0.9
978;2021-03-18;82;39;1211;359;3.4;1.0
978;2021-03-19;32;50;1243;409;3.5;1.2
978;2021-03-20;0;0;1243;409;3.5;1.2
978;2021-03-21;0;0;1243;409;3.5;1.2
978;2021-03-22;35;45;1278;454;3.6;1.3
978;2021-03-23;30;43;1308;497;3.7;1.4
978;2021-03-24;38;42;1346;539;3.8;1.5
978;2021-03-25;97;34;1443;573;4.1;1.6
978;2021-03-26;45;33;1488;606;4.2;1.7
978;2021-03-27;94;3;1582;609;4.5;1.7
978;2021-03-28;0;0;1582;609;4.5;1.7
978;2021-03-29;69;48;1651;657;4.7;1.9
978;2021-03-30;99;25;1750;682;5.0;1.9
978;2021-03-31;91;49;1841;731;5.2;2.1
978;2021-04-01;57;48;1898;779;5.4;2.2
978;2021-04-02;0;0;1898;779;5.4;2.2
978;2021-04-03;1;0;1899;779;5.4;2.2
978;2021-04-04;0;0;1899;779;5.4;2.2
978;2021-04-05;2;0;1901;779;5.4;2.2
978;2021-04-06;49;63;1950;842;5.5;2.4
978;2021-04-07;93;33;2043;875;5.8;2.5
978;2021-04-08;122;7;2165;882;6.1;2.5
978;2021-04-09;91;40;2256;922;6.4;2.6
978;2021-04-10;170;13;2426;935;6.9;2.6
978;2021-04-11;0;0;2426;935;6.9;2.6
978;2021-04-12;42;75;2468;1010;7.0;2.9
978;2021-04-13;49;71;2517;1081;7.1;3.1
978;2021-04-14;82;45;2599;1126;7.4;3.2
978;2021-04-15;92;22;2691;1148;7.6;3.2
978;2021-04-16;77;43;2768;1191;7.8;3.4
978;2021-04-17;165;5;2933;1196;8.3;3.4
978;2021-04-18;0;0;2933;1196;8.3;3.4
978;2021-04-19;52;67;2985;1263;8.4;3.6
978;2021-04-20;83;27;3068;1290;8.7;3.7
978;2021-04-21;91;28;3159;1318;8.9;3.7
978;2021-04-22;101;20;3260;1338;9.2;3.8
978;2021-04-23;45;66;3305;1404;9.4;4.0
978;2021-04-24;99;78;3404;1482;9.6;4.2
978;2021-04-25;0;0;3404;1482;9.6;4.2
978;2021-04-26;29;91;3433;1573;9.7;4.5
978;2021-04-27;59;63;3492;1636;9.9;4.6
978;2021-04-28;93;40;3585;1676;10.1;4.7
978;2021-04-29;89;31;3674;1707;10.4;4.8
978;2021-04-30;103;14;3777;1721;10.7;4.9
978;2021-05-01;0;8;3777;1729;10.7;4.9
978;2021-05-02;0;0;3777;1729;10.7;4.9
978;2021-05-03;25;99;3802;1828;10.8;5.2
978;2021-05-04;159;102;3961;1930;11.2;5.5
978;2021-05-05;142;59;4103;1989;11.6;5.6
978;2021-05-06;199;49;4302;2038;12.2;5.8
978;2021-05-07;127;71;4429;2109;12.5;6.0
978;2021-05-08;69;122;4498;2231;12.7;6.3
978;2021-05-09;0;0;4498;2231;12.7;6.3
978;2021-05-10;124;100;4622;2331;13.1;6.6
978;2021-05-11;132;72;4754;2403;13.5;6.8
978;2021-05-12;155;78;4909;2481;13.9;7.0
978;2021-05-13;83;6;4992;2487;14.1;7.0
978;2021-05-14;130;62;5122;2549;14.5;7.2
978;2021-05-15;86;4;5208;2553;14.7;7.2
978;2021-05-16;0;0;5208;2553;14.7;7.2
978;2021-05-17;146;115;5354;2668;15.2;7.6
978;2021-05-18;151;94;5505;2762;15.6;7.8
978;2021-05-19;84;69;5589;2831;15.8;8.0
978;2021-05-20;104;26;5693;2857;16.1;8.1
978;2021-05-21;98;52;5791;2909;16.4;8.2
978;2021-05-22;99;11;5890;2920;16.7;8.3
978;2021-05-23;0;0;5890;2920;16.7;8.3
978;2021-05-24;33;7;5923;2927;16.8;8.3
978;2021-05-25;119;78;6042;3005;17.1;8.5
978;2021-05-26;108;49;6150;3054;17.4;8.6
978;2021-05-27;112;42;6262;3096;17.7;8.8
978;2021-05-28;33;1;6295;3097;17.8;8.8
978;2021-05-29;60;213;6355;3310;18.0;9.4
978;2021-05-30;0;0;6355;3310;18.0;9.4
978;2021-05-31;111;63;6466;3373;18.3;9.5
978;2021-06-01;116;62;6582;3435;18.6;9.7
978;2021-06-02;131;33;6713;3468;19.0;9.8
978;2021-06-03;101;38;6814;3506;19.3;9.9
978;2021-06-04;128;70;6942;3576;19.6;10.1
978;2021-06-05;83;21;7025;3597;19.9;10.2
978;2021-06-06;0;0;7025;3597;19.9;10.2
978;2021-06-07;96;96;7121;3693;20.2;10.5
978;2021-06-08;82;89;7203;3782;20.4;10.7
978;2021-06-09;99;73;7302;3855;20.7;10.9
978;2021-06-10;112;63;7414;3918;21.0;11.1
978;2021-06-11;116;106;7530;4024;21.3;11.4
978;2021-06-12;57;30;7587;4054;21.5;11.5
978;2021-06-13;0;0;7587;4054;21.5;11.5
978;2021-06-14;105;127;7692;4181;21.8;11.8
978;2021-06-15;88;120;7780;4301;22.0;12.2
978;2021-06-16;105;148;7885;4449;22.3;12.6
978;2021-06-17;85;72;7970;4521;22.6;12.8
978;2021-06-18;67;98;8037;4619;22.7;13.1
978;2021-06-19;65;79;8102;4698;22.9;13.3
978;2021-06-20;0;0;8102;4698;22.9;13.3
978;2021-06-21;78;150;8180;4848;23.2;13.7
978;2021-06-22;71;103;8251;4951;23.4;14.0
978;2021-06-23;68;115;8319;5066;23.5;14.3
978;2021-06-24;43;75;8362;5141;23.7;14.5
978;2021-06-25;64;100;8426;5241;23.8;14.8
978;2021-06-26;35;61;8461;5302;23.9;15.0
978;2021-06-27;0;0;8461;5302;23.9;15.0
978;2021-06-28;73;131;8534;5433;24.2;15.4
978;2021-06-29;62;104;8596;5537;24.3;15.7
978;2021-06-30;56;110;8652;5647;24.5;16.0
978;2021-07-01;42;87;8694;5734;24.6;16.2
978;2021-07-02;52;90;8746;5824;24.8;16.5
978;2021-07-03;40;90;8786;5914;24.9;16.7
978;2021-07-04;0;1;8786;5915;24.9;16.7
978;2021-07-05;67;93;8853;6008;25.1;17.0
978;2021-07-06;55;74;8908;6082;25.2;17.2
978;2021-07-07;55;123;8963;6205;25.4;17.6
978;2021-07-08;54;107;9017;6312;25.5;17.9
978;2021-07-09;45;92;9062;6404;25.6;18.1
978;2021-07-10;38;85;9100;6489;25.8;18.4
978;2021-07-11;0;4;9100;6493;25.8;18.4
978;2021-07-12;71;130;9171;6623;26.0;18.7
978;2021-07-13;146;162;9317;6785;26.4;19.2
978;2021-07-14;3;0;9320;6785;26.4;19.2
978;2021-07-15;161;195;9481;6980;26.8;19.8
978;2021-07-16;113;113;9594;7093;27.2;20.1
978;2021-07-17;52;100;9646;7193;27.3;20.4
978;2021-07-18;0;0;9646;7193;27.3;20.4
978;2021-07-19;99;133;9745;7326;27.6;20.7
978;2021-07-20;80;74;9825;7400;27.8;20.9
978;2021-07-21;63;50;9888;7450;28.0;21.1
978;2021-07-22;97;114;9985;7564;28.3;21.4
978;2021-07-23;67;98;10052;7662;28.4;21.7
978;2021-07-24;20;35;10072;7697;28.5;21.8
978;2021-07-25;0;0;10072;7697;28.5;21.8
978;2021-07-26;99;116;10171;7813;28.8;22.1
978;2021-07-27;72;144;10243;7957;29.0;22.5
978;2021-07-28;72;126;10315;8083;29.2;22.9
978;2021-07-29;80;98;10395;8181;29.4;23.2
978;2021-07-30;82;115;10477;8296;29.7;23.5
978;2021-07-31;49;68;10526;8364;29.8;23.7
978;2021-08-01;0;0;10526;8364;29.8;23.7
978;2021-08-02;65;95;10591;8459;30.0;23.9
978;2021-08-03;60;94;10651;8553;30.1;24.2
978;2021-08-04;64;55;10715;8608;30.3;24.4
978;2021-08-05;48;70;10763;8678;30.5;24.6
978;2021-08-06;73;127;10836;8805;30.7;24.9
978;2021-08-07;44;46;10880;8851;30.8;25.0
978;2021-08-08;0;0;10880;8851;30.8;25.0
978;2021-08-09;138;150;11018;9001;31.2;25.5
978;2021-08-10;81;93;11099;9094;31.4;25.7
978;2021-08-11;106;99;11205;9193;31.7;26.0
978;2021-08-12;99;99;11304;9292;32.0;26.3
978;2021-08-13;132;75;11436;9367;32.4;26.5
978;2021-08-14;74;100;11510;9467;32.6;26.8
978;2021-08-15;0;0;11510;9467;32.6;26.8
978;2021-08-16;45;72;11555;9539;32.7;27.0
978;2021-08-17;33;33;11588;9572;32.8;27.1
978;2021-08-18;35;55;11623;9627;32.9;27.2
978;2021-08-19;34;26;11657;9653;33.0;27.3
978;2021-08-20;46;61;11703;9714;33.1;27.5
978;2021-08-21;0;0;11703;9714;33.1;27.5
978;2021-08-22;0;0;11703;9714;33.1;27.5
978;2021-08-23;51;87;11754;9801;33.3;27.7
978;2021-08-24;31;52;11785;9853;33.4;27.9
978;2021-08-25;26;51;11811;9904;33.4;28.0
978;2021-08-26;31;26;11842;9930;33.5;28.1
978;2021-08-27;47;88;11889;10018;33.6;28.4
978;2021-08-28;3;0;11892;10018;33.7;28.4
978;2021-08-29;0;0;11892;10018;33.7;28.4
978;2021-08-30;39;113;11931;10131;33.8;28.7
978;2021-08-31;46;80;11977;10211;33.9;28.9
978;2021-09-01;31;84;12008;10295;34.0;29.1
978;2021-09-02;39;70;12047;10365;34.1;29.3
978;2021-09-03;16;94;12063;10459;34.1;29.6
978;2021-09-04;0;0;12063;10459;34.1;29.6
978;2021-09-05;0;0;12063;10459;34.1;29.6
978;2021-09-06;32;77;12095;10536;34.2;29.8
978;2021-09-07;37;45;12132;10581;34.3;29.9
978;2021-09-08;21;42;12153;10623;34.4;30.1
978;2021-09-09;21;51;12174;10674;34.5;30.2
978;2021-09-10;43;75;12217;10749;34.6;30.4
978;2021-09-11;1;0;12218;10749;34.6;30.4
978;2021-09-12;5;1;12223;10750;34.6;30.4
978;2021-09-13;34;53;12257;10803;34.7;30.6
978;2021-09-14;23;27;12280;10830;34.8;30.7
978;2021-09-15;25;43;12305;10873;34.8;30.8
978;2021-09-16;8;33;12313;10906;34.8;30.9
978;2021-09-17;13;45;12326;10951;34.9;31.0
978;2021-09-18;0;0;12326;10951;34.9;31.0
978;2021-09-19;0;0;12326;10951;34.9;31.0
978;2021-09-20;10;35;12336;10986;34.9;31.1
978;2021-09-21;15;37;12351;11023;35.0;31.2
978;2021-09-22;13;34;12364;11057;35.0;31.3
978;2021-09-23;26;41;12390;11098;35.1;31.4
978;2021-09-24;19;27;12409;11125;35.1;31.5
978;2021-09-25;0;1;12409;11126;35.1;31.5
978;2021-09-26;0;0;12409;11126;35.1;31.5
978;2021-09-27;11;31;12420;11157;35.2;31.6
978;2021-09-28;19;25;12439;11182;35.2;31.6
978;2021-09-29;20;25;12459;11207;35.3;31.7
978;2021-09-30;23;23;12482;11230;35.3;31.8
978;2021-10-01;25;37;12507;11267;35.4;31.9
978;2021-10-02;0;0;12507;11267;35.4;31.9
978;2021-10-03;0;0;12507;11267;35.4;31.9
978;2021-10-04;22;27;12529;11294;35.5;32.0
978;2021-10-05;15;16;12544;11310;35.5;32.0
978;2021-10-06;12;16;12556;11326;35.5;32.1
978;2021-10-07;11;15;12567;11341;35.6;32.1
978;2021-10-08;16;15;12583;11356;35.6;32.1
978;2021-10-09;0;0;12583;11356;35.6;32.1
978;2021-10-10;0;0;12583;11356;35.6;32.1
978;2021-10-11;25;22;12608;11378;35.7;32.2
