dep;jour;n_dose1;n_complet;n_cum_dose1;n_cum_complet;couv_dose1;couv_complet
01;2020-12-27;1;0;1;0;0.0;0.0
01;2020-12-28;0;0;1;0;0.0;0.0
01;2020-12-29;0;0;1;0;0.0;0.0
01;2020-12-30;0;0;1;0;0.0;0.0
01;2020-12-31;0;0;1;0;0.0;0.0
01;2021-01-01;2;0;3;0;0.0;0.0
01;2021-01-02;0;0;3;0;0.0;0.0
01;2021-01-03;0;0;3;0;0.0;0.0
01;2021-01-04;2;0;5;0;0.0;0.0
01;2021-01-05;2;0;7;0;0.0;0.0
01;2021-01-06;1;0;8;0;0.0;0.0
01;2021-01-07;67;0;75;0;0.0;0.0
01;2021-01-08;159;0;234;0;0.0;0.0
01;2021-01-09;2;1;236;1;0.0;0.0
01;2021-01-10;1;0;237;1;0.0;0.0
01;2021-01-11;148;0;385;1;0.1;0.0
01;2021-01-12;318;2;703;3;0.1;0.0
01;2021-01-13;445;1;1148;4;0.2;0.0
01;2021-01-14;530;3;1678;7;0.3;0.0
01;2021-01-15;398;3;2076;10;0.3;0.0
01;2021-01-16;202;0;2278;10;0.3;0.0
01;2021-01-17;128;0;2406;10;0.4;0.0
01;2021-01-18;380;1;2786;11;0.4;0.0
01;2021-01-19;1041;1;3827;12;0.6;0.0
01;2021-01-20;1262;2;5089;14;0.8;0.0
01;2021-01-21;1101;4;6190;18;0.9;0.0
01;2021-01-22;650;0;6840;18;1.0;0.0
01;2021-01-23;223;0;7063;18;1.1;0.0
01;2021-01-24;70;1;7133;19;1.1;0.0
01;2021-01-25;485;1;7618;20;1.2;0.0
01;2021-01-26;745;3;8363;23;1.3;0.0
01;2021-01-27;516;3;8879;26;1.4;0.0
01;2021-01-28;681;51;9560;77;1.5;0.0
01;2021-01-29;640;98;10200;175;1.6;0.0
01;2021-01-30;237;15;10437;190;1.6;0.0
01;2021-01-31;62;0;10499;190;1.6;0.0
01;2021-02-01;459;70;10958;260;1.7;0.0
01;2021-02-02;519;171;11477;431;1.7;0.1
01;2021-02-03;376;232;11853;663;1.8;0.1
01;2021-02-04;480;372;12333;1035;1.9;0.2
01;2021-02-05;443;237;12776;1272;1.9;0.2
01;2021-02-06;264;105;13040;1377;2.0;0.2
01;2021-02-07;2;93;13042;1470;2.0;0.2
01;2021-02-08;506;325;13548;1795;2.1;0.3
01;2021-02-09;776;733;14324;2528;2.2;0.4
01;2021-02-10;957;622;15281;3150;2.3;0.5
01;2021-02-11;795;685;16076;3835;2.4;0.6
01;2021-02-12;640;481;16716;4316;2.5;0.7
01;2021-02-13;161;99;16877;4415;2.6;0.7
01;2021-02-14;2;9;16879;4424;2.6;0.7
01;2021-02-15;437;377;17316;4801;2.6;0.7
01;2021-02-16;658;340;17974;5141;2.7;0.8
01;2021-02-17;524;228;18498;5369;2.8;0.8
01;2021-02-18;592;498;19090;5867;2.9;0.9
01;2021-02-19;580;203;19670;6070;3.0;0.9
01;2021-02-20;201;124;19871;6194;3.0;0.9
01;2021-02-21;1;1;19872;6195;3.0;0.9
01;2021-02-22;429;448;20301;6643;3.1;1.0
01;2021-02-23;483;421;20784;7064;3.2;1.1
01;2021-02-24;435;367;21219;7431;3.2;1.1
01;2021-02-25;827;514;22046;7945;3.4;1.2
01;2021-02-26;873;435;22919;8380;3.5;1.3
01;2021-02-27;480;102;23399;8482;3.6;1.3
01;2021-02-28;20;3;23419;8485;3.6;1.3
01;2021-03-01;635;382;24054;8867;3.7;1.3
01;2021-03-02;964;479;25018;9346;3.8;1.4
01;2021-03-03;945;596;25963;9942;4.0;1.5
01;2021-03-04;1198;554;27161;10496;4.1;1.6
01;2021-03-05;1356;436;28517;10932;4.3;1.7
01;2021-03-06;781;91;29298;11023;4.5;1.7
01;2021-03-07;44;1;29342;11024;4.5;1.7
01;2021-03-08;668;571;30010;11595;4.6;1.8
01;2021-03-09;1340;537;31350;12132;4.8;1.8
01;2021-03-10;1163;537;32513;12669;4.9;1.9
01;2021-03-11;1686;603;34199;13272;5.2;2.0
01;2021-03-12;2006;605;36205;13877;5.5;2.1
01;2021-03-13;1502;95;37707;13972;5.7;2.1
01;2021-03-14;134;59;37841;14031;5.8;2.1
01;2021-03-15;1154;393;38995;14424;5.9;2.2
01;2021-03-16;1014;549;40009;14973;6.1;2.3
01;2021-03-17;839;337;40848;15310;6.2;2.3
01;2021-03-18;1295;463;42143;15773;6.4;2.4
01;2021-03-19;1750;529;43893;16302;6.7;2.5
01;2021-03-20;1447;133;45340;16435;6.9;2.5
01;2021-03-21;97;11;45437;16446;6.9;2.5
01;2021-03-22;1576;486;47013;16932;7.2;2.6
01;2021-03-23;2197;643;49210;17575;7.5;2.7
01;2021-03-24;1616;418;50826;17993;7.7;2.7
01;2021-03-25;2910;634;53736;18627;8.2;2.8
01;2021-03-26;2871;613;56607;19240;8.6;2.9
01;2021-03-27;1311;158;57918;19398;8.8;3.0
01;2021-03-28;22;1;57940;19399;8.8;3.0
01;2021-03-29;1930;537;59870;19936;9.1;3.0
01;2021-03-30;2514;771;62384;20707;9.5;3.2
01;2021-03-31;1869;623;64253;21330;9.8;3.2
01;2021-04-01;2569;851;66822;22181;10.2;3.4
01;2021-04-02;2818;725;69640;22906;10.6;3.5
01;2021-04-03;1256;135;70896;23041;10.8;3.5
01;2021-04-04;3;0;70899;23041;10.8;3.5
01;2021-04-05;1261;65;72160;23106;11.0;3.5
01;2021-04-06;2824;794;74984;23900;11.4;3.6
01;2021-04-07;2741;707;77725;24607;11.8;3.7
01;2021-04-08;3245;997;80970;25604;12.3;3.9
01;2021-04-09;3983;1333;84953;26937;12.9;4.1
01;2021-04-10;1823;301;86776;27238;13.2;4.1
01;2021-04-11;44;22;86820;27260;13.2;4.1
01;2021-04-12;2716;1223;89536;28483;13.6;4.3
01;2021-04-13;2944;1325;92480;29808;14.1;4.5
01;2021-04-14;3126;1082;95606;30890;14.6;4.7
01;2021-04-15;3075;1475;98681;32365;15.0;4.9
01;2021-04-16;2861;1579;101542;33944;15.5;5.2
01;2021-04-17;1654;681;103196;34625;15.7;5.3
01;2021-04-18;13;0;103209;34625;15.7;5.3
01;2021-04-19;2039;1521;105248;36146;16.0;5.5
01;2021-04-20;2667;1571;107915;37717;16.4;5.7
01;2021-04-21;2689;1349;110604;39066;16.8;5.9
01;2021-04-22;2835;1530;113439;40596;17.3;6.2
01;2021-04-23;2764;1533;116203;42129;17.7;6.4
01;2021-04-24;1448;653;117651;42782;17.9;6.5
01;2021-04-25;9;0;117660;42782;17.9;6.5
01;2021-04-26;1970;1730;119630;44512;18.2;6.8
01;2021-04-27;2572;1553;122202;46065;18.6;7.0
01;2021-04-28;2500;1568;124702;47633;19.0;7.3
01;2021-04-29;2716;1758;127418;49391;19.4;7.5
01;2021-04-30;2982;2242;130400;51633;19.8;7.9
01;2021-05-01;1473;856;131873;52489;20.1;8.0
01;2021-05-02;545;76;132418;52565;20.2;8.0
01;2021-05-03;2296;2477;134714;55042;20.5;8.4
01;2021-05-04;2539;2635;137253;57677;20.9;8.8
01;2021-05-05;2527;2496;139780;60173;21.3;9.2
01;2021-05-06;2995;2525;142775;62698;21.7;9.5
01;2021-05-07;3215;2774;145990;65472;22.2;10.0
01;2021-05-08;1645;922;147635;66394;22.5;10.1
01;2021-05-09;1022;162;148657;66556;22.6;10.1
01;2021-05-10;2500;3067;151157;69623;23.0;10.6
01;2021-05-11;3581;3055;154738;72678;23.6;11.1
01;2021-05-12;3652;3002;158390;75680;24.1;11.5
01;2021-05-13;4088;1503;162478;77183;24.7;11.7
01;2021-05-14;4272;2345;166750;79528;25.4;12.1
01;2021-05-15;3159;1435;169909;80963;25.9;12.3
01;2021-05-16;1413;150;171322;81113;26.1;12.3
01;2021-05-17;3445;2469;174767;83582;26.6;12.7
01;2021-05-18;4075;1959;178842;85541;27.2;13.0
01;2021-05-19;3974;1900;182816;87441;27.8;13.3
01;2021-05-20;4526;2010;187342;89451;28.5;13.6
01;2021-05-21;4621;2194;191963;91645;29.2;13.9
01;2021-05-22;3368;953;195331;92598;29.7;14.1
01;2021-05-23;834;83;196165;92681;29.9;14.1
01;2021-05-24;2765;500;198930;93181;30.3;14.2
01;2021-05-25;3559;2428;202489;95609;30.8;14.6
01;2021-05-26;3570;2249;206059;97858;31.4;14.9
01;2021-05-27;3853;2093;209912;99951;32.0;15.2
01;2021-05-28;3664;2631;213576;102582;32.5;15.6
01;2021-05-29;3055;1297;216631;103879;33.0;15.8
01;2021-05-30;613;88;217244;103967;33.1;15.8
01;2021-05-31;2406;2516;219650;106483;33.4;16.2
01;2021-06-01;2771;2583;222421;109066;33.9;16.6
01;2021-06-02;2883;2200;225304;111266;34.3;16.9
01;2021-06-03;3366;2441;228670;113707;34.8;17.3
01;2021-06-04;4500;3368;233170;117075;35.5;17.8
01;2021-06-05;3252;1732;236422;118807;36.0;18.1
01;2021-06-06;670;78;237092;118885;36.1;18.1
01;2021-06-07;3388;2875;240480;121760;36.6;18.5
01;2021-06-08;3649;2718;244129;124478;37.2;18.9
01;2021-06-09;2948;2635;247077;127113;37.6;19.3
01;2021-06-10;2767;2037;249844;129150;38.0;19.7
01;2021-06-11;3072;3365;252916;132515;38.5;20.2
01;2021-06-12;2402;2195;255318;134710;38.9;20.5
01;2021-06-13;201;479;255519;135189;38.9;20.6
01;2021-06-14;2119;3162;257638;138351;39.2;21.1
01;2021-06-15;2005;3367;259643;141718;39.5;21.6
01;2021-06-16;2176;3287;261819;145005;39.9;22.1
01;2021-06-17;1959;3171;263778;148176;40.2;22.6
01;2021-06-18;2634;4159;266412;152335;40.6;23.2
01;2021-06-19;1727;2555;268139;154890;40.8;23.6
01;2021-06-20;159;498;268298;155388;40.8;23.7
01;2021-06-21;1798;3703;270096;159091;41.1;24.2
01;2021-06-22;1551;4001;271647;163092;41.3;24.8
01;2021-06-23;1583;3754;273230;166846;41.6;25.4
01;2021-06-24;1471;3564;274701;170410;41.8;25.9
01;2021-06-25;1889;4565;276590;174975;42.1;26.6
01;2021-06-26;1209;2946;277799;177921;42.3;27.1
01;2021-06-27;171;339;277970;178260;42.3;27.1
01;2021-06-28;1382;4024;279352;182284;42.5;27.7
01;2021-06-29;1409;3849;280761;186133;42.7;28.3
01;2021-06-30;1381;4157;282142;190290;42.9;29.0
01;2021-07-01;1431;4087;283573;194377;43.2;29.6
01;2021-07-02;1587;4985;285160;199362;43.4;30.3
01;2021-07-03;858;3373;286018;202735;43.5;30.9
01;2021-07-04;105;499;286123;203234;43.6;30.9
01;2021-07-05;1486;4082;287609;207316;43.8;31.6
01;2021-07-06;1105;4275;288714;211591;43.9;32.2
01;2021-07-07;1757;3696;290471;215287;44.2;32.8
01;2021-07-08;1474;3676;291945;218963;44.4;33.3
01;2021-07-09;1885;4364;293830;223327;44.7;34.0
01;2021-07-10;1119;3438;294949;226765;44.9;34.5
01;2021-07-11;105;418;295054;227183;44.9;34.6
01;2021-07-12;1422;3844;296476;231027;45.1;35.2
01;2021-07-13;2058;4116;298534;235143;45.4;35.8
01;2021-07-14;148;179;298682;235322;45.5;35.8
01;2021-07-15;3104;4190;301786;239512;45.9;36.5
01;2021-07-16;3745;4838;305531;244350;46.5;37.2
01;2021-07-17;2203;3044;307734;247394;46.8;37.7
01;2021-07-18;290;551;308024;247945;46.9;37.7
01;2021-07-19;2915;3869;310939;251814;47.3;38.3
01;2021-07-20;3297;3691;314236;255505;47.8;38.9
01;2021-07-21;3935;3566;318171;259071;48.4;39.4
01;2021-07-22;4219;3494;322390;262565;49.1;40.0
01;2021-07-23;3941;4221;326331;266786;49.7;40.6
01;2021-07-24;2731;2712;329062;269498;50.1;41.0
01;2021-07-25;61;60;329123;269558;50.1;41.0
01;2021-07-26;3346;3240;332469;272798;50.6;41.5
01;2021-07-27;4105;2787;336574;275585;51.2;41.9
01;2021-07-28;3989;2651;340563;278236;51.8;42.4
01;2021-07-29;4696;2437;345259;280673;52.6;42.7
01;2021-07-30;4458;3429;349717;284102;53.2;43.2
01;2021-07-31;3641;1773;353358;285875;53.8;43.5
01;2021-08-01;397;75;353755;285950;53.8;43.5
01;2021-08-02;3077;2454;356832;288404;54.3;43.9
01;2021-08-03;3069;2454;359901;290858;54.8;44.3
01;2021-08-04;2543;1736;362444;292594;55.2;44.5
01;2021-08-05;2246;2363;364690;294957;55.5;44.9
01;2021-08-06;2748;3113;367438;298070;55.9;45.4
01;2021-08-07;2071;1837;369509;299907;56.2;45.7
01;2021-08-08;248;258;369757;300165;56.3;45.7
01;2021-08-09;1136;2633;370893;302798;56.5;46.1
01;2021-08-10;1445;2412;372338;305210;56.7;46.5
01;2021-08-11;1472;2596;373810;307806;56.9;46.9
01;2021-08-12;1626;2828;375436;310634;57.1;47.3
01;2021-08-13;1814;2728;377250;313362;57.4;47.7
01;2021-08-14;1392;2233;378642;315595;57.6;48.0
01;2021-08-15;18;21;378660;315616;57.6;48.0
01;2021-08-16;983;3012;379643;318628;57.8;48.5
01;2021-08-17;1355;2761;380998;321389;58.0;48.9
01;2021-08-18;1257;2907;382255;324296;58.2;49.4
01;2021-08-19;1300;2425;383555;326721;58.4;49.7
01;2021-08-20;1458;3951;385013;330672;58.6;50.3
01;2021-08-21;883;2848;385896;333520;58.7;50.8
01;2021-08-22;19;20;385915;333540;58.7;50.8
01;2021-08-23;1115;3018;387030;336558;58.9;51.2
01;2021-08-24;1228;3153;388258;339711;59.1;51.7
01;2021-08-25;1124;2993;389382;342704;59.3;52.2
01;2021-08-26;1649;2740;391031;345444;59.5;52.6
01;2021-08-27;1641;3652;392672;349096;59.8;53.1
01;2021-08-28;1044;2591;393716;351687;59.9;53.5
01;2021-08-29;16;31;393732;351718;59.9;53.5
01;2021-08-30;1187;2737;394919;354455;60.1;54.0
01;2021-08-31;1090;1946;396009;356401;60.3;54.3
01;2021-09-01;919;1872;396928;358273;60.4;54.5
01;2021-09-02;805;1763;397733;360036;60.5;54.8
01;2021-09-03;1130;2404;398863;362440;60.7;55.2
01;2021-09-04;796;2004;399659;364444;60.8;55.5
01;2021-09-05;97;82;399756;364526;60.8;55.5
01;2021-09-06;651;1400;400407;365926;60.9;55.7
01;2021-09-07;578;1205;400985;367131;61.0;55.9
01;2021-09-08;815;1585;401800;368716;61.2;56.1
01;2021-09-09;765;1284;402565;370000;61.3;56.3
01;2021-09-10;1044;1821;403609;371821;61.4;56.6
01;2021-09-11;736;1496;404345;373317;61.5;56.8
01;2021-09-12;23;41;404368;373358;61.6;56.8
01;2021-09-13;575;1343;404943;374701;61.6;57.0
01;2021-09-14;618;1411;405561;376112;61.7;57.3
01;2021-09-15;722;1447;406283;377559;61.8;57.5
01;2021-09-16;490;921;406773;378480;61.9;57.6
01;2021-09-17;755;1389;407528;379869;62.0;57.8
01;2021-09-18;376;1205;407904;381074;62.1;58.0
01;2021-09-19;7;10;407911;381084;62.1;58.0
01;2021-09-20;372;636;408283;381720;62.1;58.1
01;2021-09-21;383;701;408666;382421;62.2;58.2
01;2021-09-22;347;899;409013;383320;62.3;58.3
01;2021-09-23;295;658;409308;383978;62.3;58.4
01;2021-09-24;402;943;409710;384921;62.4;58.6
01;2021-09-25;307;955;410017;385876;62.4;58.7
01;2021-09-26;2;24;410019;385900;62.4;58.7
01;2021-09-27;174;556;410193;386456;62.4;58.8
01;2021-09-28;310;1194;410503;387650;62.5;59.0
01;2021-09-29;464;1281;410967;388931;62.6;59.2
01;2021-09-30;342;828;411309;389759;62.6;59.3
01;2021-10-01;463;1074;411772;390833;62.7;59.5
01;2021-10-02;396;1305;412168;392138;62.7;59.7
01;2021-10-03;0;0;412168;392138;62.7;59.7
01;2021-10-04;192;512;412360;392650;62.8;59.8
01;2021-10-05;204;534;412564;393184;62.8;59.8
01;2021-10-06;338;740;412902;393924;62.9;60.0
02;2020-12-27;0;0;0;0;0.0;0.0
02;2020-12-28;0;0;0;0;0.0;0.0
02;2020-12-29;0;0;0;0;0.0;0.0
02;2020-12-30;0;0;0;0;0.0;0.0
02;2020-12-31;0;0;0;0;0.0;0.0
02;2021-01-01;0;0;0;0;0.0;0.0
02;2021-01-02;0;0;0;0;0.0;0.0
02;2021-01-03;0;0;0;0;0.0;0.0
02;2021-01-04;0;0;0;0;0.0;0.0
02;2021-01-05;0;0;0;0;0.0;0.0
02;2021-01-06;22;0;22;0;0.0;0.0
02;2021-01-07;261;1;283;1;0.1;0.0
02;2021-01-08;489;3;772;4;0.1;0.0
02;2021-01-09;74;0;846;4;0.2;0.0
02;2021-01-10;49;0;895;4;0.2;0.0
02;2021-01-11;267;0;1162;4;0.2;0.0
02;2021-01-12;354;1;1516;5;0.3;0.0
02;2021-01-13;469;4;1985;9;0.4;0.0
02;2021-01-14;652;11;2637;20;0.5;0.0
02;2021-01-15;630;6;3267;26;0.6;0.0
02;2021-01-16;333;4;3600;30;0.7;0.0
02;2021-01-17;62;0;3662;30;0.7;0.0
02;2021-01-18;811;8;4473;38;0.9;0.0
02;2021-01-19;941;6;5414;44;1.0;0.0
02;2021-01-20;1431;5;6845;49;1.3;0.0
02;2021-01-21;2604;5;9449;54;1.8;0.0
02;2021-01-22;1420;5;10869;59;2.1;0.0
02;2021-01-23;290;1;11159;60;2.1;0.0
02;2021-01-24;67;0;11226;60;2.1;0.0
02;2021-01-25;432;8;11658;68;2.2;0.0
02;2021-01-26;704;15;12362;83;2.3;0.0
02;2021-01-27;162;2;12524;85;2.4;0.0
02;2021-01-28;69;226;12593;311;2.4;0.1
02;2021-01-29;119;376;12712;687;2.4;0.1
02;2021-01-30;4;13;12716;700;2.4;0.1
02;2021-01-31;0;10;12716;710;2.4;0.1
02;2021-02-01;11;202;12727;912;2.4;0.2
02;2021-02-02;45;314;12772;1226;2.4;0.2
02;2021-02-03;124;307;12896;1533;2.5;0.3
02;2021-02-04;226;325;13122;1858;2.5;0.4
02;2021-02-05;179;371;13301;2229;2.5;0.4
02;2021-02-06;69;149;13370;2378;2.5;0.5
02;2021-02-07;9;0;13379;2378;2.5;0.5
02;2021-02-08;306;398;13685;2776;2.6;0.5
02;2021-02-09;322;607;14007;3383;2.7;0.6
02;2021-02-10;485;939;14492;4322;2.8;0.8
02;2021-02-11;937;1727;15429;6049;2.9;1.1
02;2021-02-12;885;1017;16314;7066;3.1;1.3
02;2021-02-13;290;111;16604;7177;3.2;1.4
02;2021-02-14;1;5;16605;7182;3.2;1.4
02;2021-02-15;344;518;16949;7700;3.2;1.5
02;2021-02-16;414;425;17363;8125;3.3;1.5
02;2021-02-17;499;490;17862;8615;3.4;1.6
02;2021-02-18;507;356;18369;8971;3.5;1.7
02;2021-02-19;444;465;18813;9436;3.6;1.8
02;2021-02-20;372;194;19185;9630;3.6;1.8
02;2021-02-21;39;17;19224;9647;3.7;1.8
02;2021-02-22;377;255;19601;9902;3.7;1.9
02;2021-02-23;432;296;20033;10198;3.8;1.9
02;2021-02-24;600;126;20633;10324;3.9;2.0
02;2021-02-25;870;122;21503;10446;4.1;2.0
02;2021-02-26;808;72;22311;10518;4.2;2.0
02;2021-02-27;444;14;22755;10532;4.3;2.0
02;2021-02-28;55;2;22810;10534;4.3;2.0
02;2021-03-01;638;23;23448;10557;4.5;2.0
02;2021-03-02;1031;122;24479;10679;4.7;2.0
02;2021-03-03;754;198;25233;10877;4.8;2.1
02;2021-03-04;1161;608;26394;11485;5.0;2.2
02;2021-03-05;1048;494;27442;11979;5.2;2.3
02;2021-03-06;2141;96;29583;12075;5.6;2.3
02;2021-03-07;1504;51;31087;12126;5.9;2.3
02;2021-03-08;574;337;31661;12463;6.0;2.4
02;2021-03-09;997;375;32658;12838;6.2;2.4
02;2021-03-10;895;434;33553;13272;6.4;2.5
02;2021-03-11;1294;380;34847;13652;6.6;2.6
02;2021-03-12;1706;388;36553;14040;6.9;2.7
02;2021-03-13;2592;243;39145;14283;7.4;2.7
02;2021-03-14;1458;44;40603;14327;7.7;2.7
02;2021-03-15;612;442;41215;14769;7.8;2.8
02;2021-03-16;862;399;42077;15168;8.0;2.9
02;2021-03-17;759;436;42836;15604;8.1;3.0
02;2021-03-18;610;610;43446;16214;8.3;3.1
02;2021-03-19;1171;294;44617;16508;8.5;3.1
02;2021-03-20;2429;157;47046;16665;8.9;3.2
02;2021-03-21;1488;84;48534;16749;9.2;3.2
02;2021-03-22;762;486;49296;17235;9.4;3.3
02;2021-03-23;1195;541;50491;17776;9.6;3.4
02;2021-03-24;1582;499;52073;18275;9.9;3.5
02;2021-03-25;1693;591;53766;18866;10.2;3.6
02;2021-03-26;2412;491;56178;19357;10.7;3.7
02;2021-03-27;2494;141;58672;19498;11.2;3.7
02;2021-03-28;638;14;59310;19512;11.3;3.7
02;2021-03-29;1038;850;60348;20362;11.5;3.9
02;2021-03-30;1553;839;61901;21201;11.8;4.0
02;2021-03-31;1298;712;63199;21913;12.0;4.2
02;2021-04-01;1290;861;64489;22774;12.3;4.3
02;2021-04-02;1183;1222;65672;23996;12.5;4.6
02;2021-04-03;2644;847;68316;24843;13.0;4.7
02;2021-04-04;727;240;69043;25083;13.1;4.8
02;2021-04-05;1509;134;70552;25217;13.4;4.8
02;2021-04-06;1539;853;72091;26070;13.7;5.0
02;2021-04-07;1872;777;73963;26847;14.1;5.1
02;2021-04-08;1919;1105;75882;27952;14.4;5.3
02;2021-04-09;2432;1093;78314;29045;14.9;5.5
02;2021-04-10;2430;1211;80744;30256;15.3;5.8
02;2021-04-11;476;416;81220;30672;15.4;5.8
02;2021-04-12;1823;619;83043;31291;15.8;5.9
02;2021-04-13;1601;923;84644;32214;16.1;6.1
02;2021-04-14;2583;977;87227;33191;16.6;6.3
02;2021-04-15;2494;777;89721;33968;17.1;6.5
02;2021-04-16;2439;1131;92160;35099;17.5;6.7
02;2021-04-17;1890;2141;94050;37240;17.9;7.1
02;2021-04-18;270;811;94320;38051;17.9;7.2
02;2021-04-19;1158;633;95478;38684;18.1;7.4
02;2021-04-20;1674;765;97152;39449;18.5;7.5
02;2021-04-21;1550;994;98702;40443;18.8;7.7
02;2021-04-22;1748;705;100450;41148;19.1;7.8
02;2021-04-23;1930;1409;102380;42557;19.5;8.1
02;2021-04-24;1714;1638;104094;44195;19.8;8.4
02;2021-04-25;462;235;104556;44430;19.9;8.4
02;2021-04-26;1339;562;105895;44992;20.1;8.6
02;2021-04-27;1627;1092;107522;46084;20.4;8.8
02;2021-04-28;1592;1429;109114;47513;20.7;9.0
02;2021-04-29;1889;1170;111003;48683;21.1;9.3
02;2021-04-30;2716;1651;113719;50334;21.6;9.6
02;2021-05-01;1991;1228;115710;51562;22.0;9.8
02;2021-05-02;1982;422;117692;51984;22.4;9.9
02;2021-05-03;2224;981;119916;52965;22.8;10.1
02;2021-05-04;1522;1306;121438;54271;23.1;10.3
02;2021-05-05;2327;1842;123765;56113;23.5;10.7
02;2021-05-06;2122;1737;125887;57850;23.9;11.0
02;2021-05-07;2358;2171;128245;60021;24.4;11.4
02;2021-05-08;2917;950;131162;60971;24.9;11.6
02;2021-05-09;1823;423;132985;61394;25.3;11.7
02;2021-05-10;2375;1481;135360;62875;25.7;12.0
02;2021-05-11;2878;1570;138238;64445;26.3;12.3
02;2021-05-12;2675;1607;140913;66052;26.8;12.6
02;2021-05-13;2990;1039;143903;67091;27.4;12.8
02;2021-05-14;3381;1198;147284;68289;28.0;13.0
02;2021-05-15;4374;1082;151658;69371;28.8;13.2
02;2021-05-16;2795;212;154453;69583;29.4;13.2
02;2021-05-17;2147;664;156600;70247;29.8;13.4
02;2021-05-18;2634;971;159234;71218;30.3;13.5
02;2021-05-19;2852;999;162086;72217;30.8;13.7
02;2021-05-20;3553;1230;165639;73447;31.5;14.0
02;2021-05-21;3818;1067;169457;74514;32.2;14.2
02;2021-05-22;5845;969;175302;75483;33.3;14.3
02;2021-05-23;2658;240;177960;75723;33.8;14.4
02;2021-05-24;3541;544;181501;76267;34.5;14.5
02;2021-05-25;2257;1164;183758;77431;34.9;14.7
02;2021-05-26;3079;1498;186837;78929;35.5;15.0
02;2021-05-27;3649;1487;190486;80416;36.2;15.3
02;2021-05-28;3515;1577;194001;81993;36.9;15.6
02;2021-05-29;4078;1561;198079;83554;37.7;15.9
02;2021-05-30;1449;177;199528;83731;37.9;15.9
02;2021-05-31;2575;1187;202103;84918;38.4;16.1
02;2021-06-01;2870;1867;204973;86785;39.0;16.5
02;2021-06-02;3159;1652;208132;88437;39.6;16.8
02;2021-06-03;2854;1835;210986;90272;40.1;17.2
02;2021-06-04;3142;2054;214128;92326;40.7;17.6
02;2021-06-05;3441;1733;217569;94059;41.4;17.9
02;2021-06-06;1736;259;219305;94318;41.7;17.9
02;2021-06-07;1613;1500;220918;95818;42.0;18.2
02;2021-06-08;2061;1839;222979;97657;42.4;18.6
02;2021-06-09;2057;1646;225036;99303;42.8;18.9
02;2021-06-10;2011;1842;227047;101145;43.2;19.2
02;2021-06-11;2193;3073;229240;104218;43.6;19.8
02;2021-06-12;2311;2592;231551;106810;44.0;20.3
02;2021-06-13;683;1387;232234;108197;44.1;20.6
02;2021-06-14;1049;2391;233283;110588;44.3;21.0
02;2021-06-15;1518;2458;234801;113046;44.6;21.5
02;2021-06-16;1534;2749;236335;115795;44.9;22.0
02;2021-06-17;1782;2854;238117;118649;45.3;22.6
02;2021-06-18;2312;3570;240429;122219;45.7;23.2
02;2021-06-19;1841;3820;242270;126039;46.1;24.0
02;2021-06-20;645;1523;242915;127562;46.2;24.2
02;2021-06-21;806;3190;243721;130752;46.3;24.9
02;2021-06-22;1155;3667;244876;134419;46.5;25.6
02;2021-06-23;1226;3587;246102;138006;46.8;26.2
02;2021-06-24;1327;3149;247429;141155;47.0;26.8
02;2021-06-25;1399;4545;248828;145700;47.3;27.7
02;2021-06-26;1345;4228;250173;149928;47.6;28.5
02;2021-06-27;600;2333;250773;152261;47.7;28.9
02;2021-06-28;877;3021;251650;155282;47.8;29.5
02;2021-06-29;919;2929;252569;158211;48.0;30.1
02;2021-06-30;1509;3161;254078;161372;48.3;30.7
02;2021-07-01;1193;3591;255271;164963;48.5;31.4
02;2021-07-02;1358;5132;256629;170095;48.8;32.3
02;2021-07-03;999;5989;257628;176084;49.0;33.5
02;2021-07-04;509;2370;258137;178454;49.1;33.9
02;2021-07-05;661;3935;258798;182389;49.2;34.7
02;2021-07-06;675;3045;259473;185434;49.3;35.3
02;2021-07-07;1322;3727;260795;189161;49.6;36.0
02;2021-07-08;1393;3869;262188;193030;49.8;36.7
02;2021-07-09;1283;4216;263471;197246;50.1;37.5
02;2021-07-10;1332;4604;264803;201850;50.3;38.4
02;2021-07-11;480;1967;265283;203817;50.4;38.7
02;2021-07-12;1416;3726;266699;207543;50.7;39.5
02;2021-07-13;2065;3662;268764;211205;51.1;40.1
02;2021-07-14;1753;1599;270517;212804;51.4;40.5
02;2021-07-15;2727;3560;273244;216364;51.9;41.1
02;2021-07-16;3164;4217;276408;220581;52.5;41.9
02;2021-07-17;3561;4230;279969;224811;53.2;42.7
02;2021-07-18;2037;1616;282006;226427;53.6;43.0
02;2021-07-19;3440;3033;285446;229460;54.3;43.6
02;2021-07-20;3501;3303;288947;232763;54.9;44.2
02;2021-07-21;3910;2951;292857;235714;55.7;44.8
02;2021-07-22;3324;2801;296181;238515;56.3;45.3
02;2021-07-23;3205;3554;299386;242069;56.9;46.0
02;2021-07-24;4447;3724;303833;245793;57.8;46.7
02;2021-07-25;2192;1089;306025;246882;58.2;46.9
02;2021-07-26;3874;2252;309899;249134;58.9;47.4
02;2021-07-27;3660;2147;313559;251281;59.6;47.8
02;2021-07-28;3279;2096;316838;253377;60.2;48.2
02;2021-07-29;2583;2225;319421;255602;60.7;48.6
02;2021-07-30;3313;2308;322734;257910;61.4;49.0
02;2021-07-31;4183;2281;326917;260191;62.1;49.5
02;2021-08-01;1475;692;328392;260883;62.4;49.6
02;2021-08-02;2042;1601;330434;262484;62.8;49.9
02;2021-08-03;2530;1897;332964;264381;63.3;50.3
02;2021-08-04;2576;1711;335540;266092;63.8;50.6
02;2021-08-05;1849;2265;337389;268357;64.1;51.0
02;2021-08-06;2101;2741;339490;271098;64.5;51.5
02;2021-08-07;2522;2785;342012;273883;65.0;52.1
02;2021-08-08;1026;1572;343038;275455;65.2;52.4
02;2021-08-09;1909;2749;344947;278204;65.6;52.9
02;2021-08-10;1766;2462;346713;280666;65.9;53.4
02;2021-08-11;1481;2109;348194;282775;66.2;53.8
02;2021-08-12;1205;2332;349399;285107;66.4;54.2
02;2021-08-13;1611;2908;351010;288015;66.7;54.8
02;2021-08-14;1666;3696;352676;291711;67.0;55.5
02;2021-08-15;161;572;352837;292283;67.1;55.6
02;2021-08-16;1282;3755;354119;296038;67.3;56.3
02;2021-08-17;1421;2840;355540;298878;67.6;56.8
02;2021-08-18;1578;3183;357118;302061;67.9;57.4
02;2021-08-19;1134;3218;358252;305279;68.1;58.0
02;2021-08-20;1205;2951;359457;308230;68.3;58.6
02;2021-08-21;1449;4082;360906;312312;68.6;59.4
02;2021-08-22;407;1657;361313;313969;68.7;59.7
02;2021-08-23;1157;3080;362470;317049;68.9;60.3
02;2021-08-24;907;2184;363377;319233;69.1;60.7
02;2021-08-25;1021;2596;364398;321829;69.3;61.2
02;2021-08-26;913;2333;365311;324162;69.4;61.6
02;2021-08-27;965;2615;366276;326777;69.6;62.1
02;2021-08-28;1301;3429;367577;330206;69.9;62.8
02;2021-08-29;328;1170;367905;331376;69.9;63.0
02;2021-08-30;996;2473;368901;333849;70.1;63.5
02;2021-08-31;865;2259;369766;336108;70.3;63.9
02;2021-09-01;707;1551;370473;337659;70.4;64.2
02;2021-09-02;651;1726;371124;339385;70.5;64.5
02;2021-09-03;695;1947;371819;341332;70.7;64.9
02;2021-09-04;856;2836;372675;344168;70.8;65.4
02;2021-09-05;226;520;372901;344688;70.9;65.5
02;2021-09-06;405;1038;373306;345726;71.0;65.7
02;2021-09-07;454;1404;373760;347130;71.1;66.0
02;2021-09-08;516;1872;374276;349002;71.1;66.3
02;2021-09-09;441;1327;374717;350329;71.2;66.6
02;2021-09-10;563;1550;375280;351879;71.3;66.9
02;2021-09-11;724;2275;376004;354154;71.5;67.3
02;2021-09-12;91;287;376095;354441;71.5;67.4
02;2021-09-13;422;1209;376517;355650;71.6;67.6
02;2021-09-14;413;1169;376930;356819;71.7;67.8
02;2021-09-15;447;1306;377377;358125;71.7;68.1
02;2021-09-16;454;833;377831;358958;71.8;68.2
02;2021-09-17;581;932;378412;359890;71.9;68.4
02;2021-09-18;564;2029;378976;361919;72.0;68.8
02;2021-09-19;78;259;379054;362178;72.1;68.8
02;2021-09-20;296;651;379350;362829;72.1;69.0
02;2021-09-21;277;625;379627;363454;72.2;69.1
02;2021-09-22;361;906;379988;364360;72.2;69.3
02;2021-09-23;260;563;380248;364923;72.3;69.4
02;2021-09-24;296;762;380544;365685;72.3;69.5
02;2021-09-25;318;1209;380862;366894;72.4;69.7
02;2021-09-26;33;158;380895;367052;72.4;69.8
02;2021-09-27;138;367;381033;367419;72.4;69.8
02;2021-09-28;156;392;381189;367811;72.5;69.9
02;2021-09-29;228;418;381417;368229;72.5;70.0
02;2021-09-30;238;479;381655;368708;72.6;70.1
02;2021-10-01;350;657;382005;369365;72.6;70.2
02;2021-10-02;388;851;382393;370216;72.7;70.4
02;2021-10-03;36;59;382429;370275;72.7;70.4
02;2021-10-04;156;362;382585;370637;72.7;70.5
02;2021-10-05;171;318;382756;370955;72.8;70.5
02;2021-10-06;243;420;382999;371375;72.8;70.6
03;2020-12-27;0;0;0;0;0.0;0.0
03;2020-12-28;1;0;1;0;0.0;0.0
03;2020-12-29;0;0;1;0;0.0;0.0
03;2020-12-30;1;0;2;0;0.0;0.0
03;2020-12-31;0;0;2;0;0.0;0.0
03;2021-01-01;0;0;2;0;0.0;0.0
03;2021-01-02;0;0;2;0;0.0;0.0
03;2021-01-03;0;0;2;0;0.0;0.0
03;2021-01-04;0;0;2;0;0.0;0.0
03;2021-01-05;0;0;2;0;0.0;0.0
03;2021-01-06;10;0;12;0;0.0;0.0
03;2021-01-07;61;0;73;0;0.0;0.0
03;2021-01-08;146;1;219;1;0.1;0.0
03;2021-01-09;122;0;341;1;0.1;0.0
03;2021-01-10;6;0;347;1;0.1;0.0
03;2021-01-11;412;1;759;2;0.2;0.0
03;2021-01-12;631;0;1390;2;0.4;0.0
03;2021-01-13;669;2;2059;4;0.6;0.0
03;2021-01-14;861;4;2920;8;0.9;0.0
03;2021-01-15;387;2;3307;10;1.0;0.0
03;2021-01-16;278;0;3585;10;1.1;0.0
03;2021-01-17;42;0;3627;10;1.1;0.0
03;2021-01-18;878;0;4505;10;1.4;0.0
03;2021-01-19;1151;2;5656;12;1.7;0.0
03;2021-01-20;1292;3;6948;15;2.1;0.0
03;2021-01-21;1200;5;8148;20;2.5;0.0
03;2021-01-22;1117;4;9265;24;2.8;0.0
03;2021-01-23;465;0;9730;24;2.9;0.0
03;2021-01-24;0;0;9730;24;2.9;0.0
03;2021-01-25;187;0;9917;24;3.0;0.0
03;2021-01-26;680;7;10597;31;3.2;0.0
03;2021-01-27;696;10;11293;41;3.4;0.0
03;2021-01-28;1020;40;12313;81;3.7;0.0
03;2021-01-29;856;77;13169;158;4.0;0.0
03;2021-01-30;600;1;13769;159;4.2;0.0
03;2021-01-31;0;0;13769;159;4.2;0.0
03;2021-02-01;160;67;13929;226;4.2;0.1
03;2021-02-02;767;226;14696;452;4.4;0.1
03;2021-02-03;1056;422;15752;874;4.8;0.3
03;2021-02-04;1558;596;17310;1470;5.2;0.4
03;2021-02-05;948;297;18258;1767;5.5;0.5
03;2021-02-06;152;13;18410;1780;5.6;0.5
03;2021-02-07;5;0;18415;1780;5.6;0.5
03;2021-02-08;128;51;18543;1831;5.6;0.6
03;2021-02-09;612;420;19155;2251;5.8;0.7
03;2021-02-10;485;331;19640;2582;5.9;0.8
03;2021-02-11;1027;555;20667;3137;6.2;0.9
03;2021-02-12;1078;511;21745;3648;6.6;1.1
03;2021-02-13;126;151;21871;3799;6.6;1.1
03;2021-02-14;0;1;21871;3800;6.6;1.1
03;2021-02-15;309;606;22180;4406;6.7;1.3
03;2021-02-16;548;914;22728;5320;6.9;1.6
03;2021-02-17;452;1057;23180;6377;7.0;1.9
03;2021-02-18;368;1003;23548;7380;7.1;2.2
03;2021-02-19;497;658;24045;8038;7.3;2.4
03;2021-02-20;128;143;24173;8181;7.3;2.5
03;2021-02-21;2;1;24175;8182;7.3;2.5
03;2021-02-22;158;160;24333;8342;7.3;2.5
03;2021-02-23;720;767;25053;9109;7.6;2.7
03;2021-02-24;610;867;25663;9976;7.7;3.0
03;2021-02-25;1093;1560;26756;11536;8.1;3.5
03;2021-02-26;822;1215;27578;12751;8.3;3.8
03;2021-02-27;96;212;27674;12963;8.4;3.9
03;2021-02-28;0;14;27674;12977;8.4;3.9
03;2021-03-01;178;217;27852;13194;8.4;4.0
03;2021-03-02;818;586;28670;13780;8.7;4.2
03;2021-03-03;904;397;29574;14177;8.9;4.3
03;2021-03-04;1541;533;31115;14710;9.4;4.4
03;2021-03-05;1121;656;32236;15366;9.7;4.6
03;2021-03-06;915;107;33151;15473;10.0;4.7
03;2021-03-07;2;0;33153;15473;10.0;4.7
03;2021-03-08;240;232;33393;15705;10.1;4.7
03;2021-03-09;1016;419;34409;16124;10.4;4.9
03;2021-03-10;941;506;35350;16630;10.7;5.0
03;2021-03-11;1675;619;37025;17249;11.2;5.2
03;2021-03-12;1303;797;38328;18046;11.6;5.4
03;2021-03-13;864;113;39192;18159;11.8;5.5
03;2021-03-14;2;5;39194;18164;11.8;5.5
03;2021-03-15;250;194;39444;18358;11.9;5.5
03;2021-03-16;650;396;40094;18754;12.1;5.7
03;2021-03-17;1304;429;41398;19183;12.5;5.8
03;2021-03-18;1720;393;43118;19576;13.0;5.9
03;2021-03-19;1728;361;44846;19937;13.5;6.0
03;2021-03-20;301;27;45147;19964;13.6;6.0
03;2021-03-21;1;0;45148;19964;13.6;6.0
03;2021-03-22;223;387;45371;20351;13.7;6.1
03;2021-03-23;1355;351;46726;20702;14.1;6.2
03;2021-03-24;1824;350;48550;21052;14.7;6.4
03;2021-03-25;2367;567;50917;21619;15.4;6.5
03;2021-03-26;2240;444;53157;22063;16.0;6.7
03;2021-03-27;817;22;53974;22085;16.3;6.7
03;2021-03-28;1;39;53975;22124;16.3;6.7
03;2021-03-29;659;175;54634;22299;16.5;6.7
03;2021-03-30;1908;450;56542;22749;17.1;6.9
03;2021-03-31;1014;982;57556;23731;17.4;7.2
03;2021-04-01;1375;1094;58931;24825;17.8;7.5
03;2021-04-02;1705;614;60636;25439;18.3;7.7
03;2021-04-03;365;99;61001;25538;18.4;7.7
03;2021-04-04;3;0;61004;25538;18.4;7.7
03;2021-04-05;18;14;61022;25552;18.4;7.7
03;2021-04-06;1073;410;62095;25962;18.7;7.8
03;2021-04-07;1562;523;63657;26485;19.2;8.0
03;2021-04-08;2121;486;65778;26971;19.9;8.1
03;2021-04-09;2056;1160;67834;28131;20.5;8.5
03;2021-04-10;1013;73;68847;28204;20.8;8.5
03;2021-04-11;478;9;69325;28213;20.9;8.5
03;2021-04-12;986;228;70311;28441;21.2;8.6
03;2021-04-13;1873;986;72184;29427;21.8;8.9
03;2021-04-14;2334;1222;74518;30649;22.5;9.3
03;2021-04-15;2621;1400;77139;32049;23.3;9.7
03;2021-04-16;2834;1184;79973;33233;24.1;10.0
03;2021-04-17;1083;441;81056;33674;24.5;10.2
03;2021-04-18;0;0;81056;33674;24.5;10.2
03;2021-04-19;1191;586;82247;34260;24.8;10.3
03;2021-04-20;1747;1275;83994;35535;25.4;10.7
03;2021-04-21;1122;1293;85116;36828;25.7;11.1
03;2021-04-22;1675;1000;86791;37828;26.2;11.4
03;2021-04-23;2478;1274;89269;39102;26.9;11.8
03;2021-04-24;1301;923;90570;40025;27.3;12.1
03;2021-04-25;350;16;90920;40041;27.4;12.1
03;2021-04-26;1332;466;92252;40507;27.8;12.2
03;2021-04-27;1766;1522;94018;42029;28.4;12.7
03;2021-04-28;1930;1119;95948;43148;29.0;13.0
03;2021-04-29;2370;1238;98318;44386;29.7;13.4
03;2021-04-30;1931;807;100249;45193;30.3;13.6
03;2021-05-01;438;493;100687;45686;30.4;13.8
03;2021-05-02;2;1;100689;45687;30.4;13.8
03;2021-05-03;1912;773;102601;46460;31.0;14.0
03;2021-05-04;2845;1634;105446;48094;31.8;14.5
03;2021-05-05;2604;1332;108050;49426;32.6;14.9
03;2021-05-06;3095;2007;111145;51433;33.5;15.5
03;2021-05-07;4729;1791;115874;53224;35.0;16.1
03;2021-05-08;661;381;116535;53605;35.2;16.2
03;2021-05-09;49;511;116584;54116;35.2;16.3
03;2021-05-10;1892;1480;118476;55596;35.8;16.8
03;2021-05-11;3902;1838;122378;57434;36.9;17.3
03;2021-05-12;2972;1521;125350;58955;37.8;17.8
03;2021-05-13;4384;410;129734;59365;39.2;17.9
03;2021-05-14;3655;1698;133389;61063;40.3;18.4
03;2021-05-15;1943;490;135332;61553;40.8;18.6
03;2021-05-16;522;57;135854;61610;41.0;18.6
03;2021-05-17;1277;862;137131;62472;41.4;18.9
03;2021-05-18;3068;1505;140199;63977;42.3;19.3
03;2021-05-19;2623;967;142822;64944;43.1;19.6
03;2021-05-20;3334;1143;146156;66087;44.1;19.9
03;2021-05-21;4194;1281;150350;67368;45.4;20.3
03;2021-05-22;2012;359;152362;67727;46.0;20.4
03;2021-05-23;641;73;153003;67800;46.2;20.5
03;2021-05-24;2654;216;155657;68016;47.0;20.5
03;2021-05-25;3067;1689;158724;69705;47.9;21.0
03;2021-05-26;2336;1041;161060;70746;48.6;21.4
03;2021-05-27;2945;1126;164005;71872;49.5;21.7
03;2021-05-28;3848;2280;167853;74152;50.7;22.4
03;2021-05-29;1748;603;169601;74755;51.2;22.6
03;2021-05-30;242;23;169843;74778;51.3;22.6
03;2021-05-31;697;570;170540;75348;51.5;22.7
03;2021-06-01;2302;2346;172842;77694;52.2;23.5
03;2021-06-02;1534;1748;174376;79442;52.6;24.0
03;2021-06-03;2060;2753;176436;82195;53.3;24.8
03;2021-06-04;1698;2508;178134;84703;53.8;25.6
03;2021-06-05;1076;1143;179210;85846;54.1;25.9
03;2021-06-06;59;7;179269;85853;54.1;25.9
03;2021-06-07;785;1815;180054;87668;54.3;26.5
03;2021-06-08;1458;2557;181512;90225;54.8;27.2
03;2021-06-09;1267;1877;182779;92102;55.2;27.8
03;2021-06-10;1381;2124;184160;94226;55.6;28.4
03;2021-06-11;1503;3450;185663;97676;56.0;29.5
03;2021-06-12;831;823;186494;98499;56.3;29.7
03;2021-06-13;20;10;186514;98509;56.3;29.7
03;2021-06-14;381;2175;186895;100684;56.4;30.4
03;2021-06-15;1317;3835;188212;104519;56.8;31.5
03;2021-06-16;788;2890;189000;107409;57.0;32.4
03;2021-06-17;1083;3333;190083;110742;57.4;33.4
03;2021-06-18;1107;3979;191190;114721;57.7;34.6
03;2021-06-19;641;1618;191831;116339;57.9;35.1
03;2021-06-20;20;8;191851;116347;57.9;35.1
03;2021-06-21;461;2636;192312;118983;58.0;35.9
03;2021-06-22;1027;4003;193339;122986;58.4;37.1
03;2021-06-23;716;3285;194055;126271;58.6;38.1
03;2021-06-24;982;3862;195037;130133;58.9;39.3
03;2021-06-25;1016;3892;196053;134025;59.2;40.5
03;2021-06-26;513;2040;196566;136065;59.3;41.1
03;2021-06-27;65;486;196631;136551;59.3;41.2
03;2021-06-28;642;2097;197273;138648;59.5;41.8
03;2021-06-29;1028;3330;198301;141978;59.9;42.9
03;2021-06-30;831;3120;199132;145098;60.1;43.8
03;2021-07-01;987;2936;200119;148034;60.4;44.7
03;2021-07-02;920;4094;201039;152128;60.7;45.9
03;2021-07-03;487;1884;201526;154012;60.8;46.5
03;2021-07-04;20;332;201546;154344;60.8;46.6
03;2021-07-05;818;2381;202364;156725;61.1;47.3
03;2021-07-06;1171;3462;203535;160187;61.4;48.3
03;2021-07-07;804;2617;204339;162804;61.7;49.1
03;2021-07-08;1060;3042;205399;165846;62.0;50.1
03;2021-07-09;1470;3626;206869;169472;62.4;51.2
03;2021-07-10;508;1925;207377;171397;62.6;51.7
03;2021-07-11;61;492;207438;171889;62.6;51.9
03;2021-07-12;939;1148;208377;173037;62.9;52.2
03;2021-07-13;2612;3152;210989;176189;63.7;53.2
03;2021-07-14;195;25;211184;176214;63.7;53.2
03;2021-07-15;2613;2453;213797;178667;64.5;53.9
03;2021-07-16;2737;2274;216534;180941;65.4;54.6
03;2021-07-17;1032;1626;217566;182567;65.7;55.1
03;2021-07-18;33;6;217599;182573;65.7;55.1
03;2021-07-19;2391;1276;219990;183849;66.4;55.5
03;2021-07-20;3074;3033;223064;186882;67.3;56.4
03;2021-07-21;3214;1439;226278;188321;68.3;56.8
03;2021-07-22;2851;1886;229129;190207;69.2;57.4
03;2021-07-23;3205;1306;232334;191513;70.1;57.8
03;2021-07-24;590;581;232924;192094;70.3;58.0
03;2021-07-25;18;5;232942;192099;70.3;58.0
03;2021-07-26;2043;1576;234985;193675;70.9;58.5
03;2021-07-27;3321;2230;238306;195905;71.9;59.1
03;2021-07-28;2718;1118;241024;197023;72.7;59.5
03;2021-07-29;2549;1662;243573;198685;73.5;60.0
03;2021-07-30;2136;1455;245709;200140;74.2;60.4
03;2021-07-31;964;893;246673;201033;74.5;60.7
03;2021-08-01;13;20;246686;201053;74.5;60.7
03;2021-08-02;1679;1605;248365;202658;75.0;61.2
03;2021-08-03;2223;2775;250588;205433;75.6;62.0
03;2021-08-04;2195;893;252783;206326;76.3;62.3
03;2021-08-05;1266;1939;254049;208265;76.7;62.9
03;2021-08-06;1281;1024;255330;209289;77.1;63.2
03;2021-08-07;614;496;255944;209785;77.3;63.3
03;2021-08-08;66;29;256010;209814;77.3;63.3
03;2021-08-09;597;1304;256607;211118;77.5;63.7
03;2021-08-10;1676;3471;258283;214589;78.0;64.8
03;2021-08-11;1333;2529;259616;217118;78.4;65.5
03;2021-08-12;1137;3514;260753;220632;78.7;66.6
03;2021-08-13;776;1052;261529;221684;78.9;66.9
03;2021-08-14;380;566;261909;222250;79.1;67.1
03;2021-08-15;9;61;261918;222311;79.1;67.1
03;2021-08-16;725;2693;262643;225004;79.3;67.9
03;2021-08-17;1076;3218;263719;228222;79.6;68.9
03;2021-08-18;1164;2156;264883;230378;79.9;69.5
03;2021-08-19;1010;3049;265893;233427;80.3;70.5
03;2021-08-20;718;1138;266611;234565;80.5;70.8
03;2021-08-21;418;727;267029;235292;80.6;71.0
03;2021-08-22;8;6;267037;235298;80.6;71.0
03;2021-08-23;784;2289;267821;237587;80.8;71.7
03;2021-08-24;893;2406;268714;239993;81.1;72.4
03;2021-08-25;934;2029;269648;242022;81.4;73.0
03;2021-08-26;574;1436;270222;243458;81.6;73.5
03;2021-08-27;457;1581;270679;245039;81.7;74.0
03;2021-08-28;219;674;270898;245713;81.8;74.2
03;2021-08-29;4;0;270902;245713;81.8;74.2
03;2021-08-30;768;1469;271670;247182;82.0;74.6
03;2021-08-31;706;2055;272376;249237;82.2;75.2
03;2021-09-01;605;1513;272981;250750;82.4;75.7
03;2021-09-02;479;1238;273460;251988;82.5;76.1
03;2021-09-03;492;1186;273952;253174;82.7;76.4
03;2021-09-04;251;630;274203;253804;82.8;76.6
03;2021-09-05;7;14;274210;253818;82.8;76.6
03;2021-09-06;320;1097;274530;254915;82.9;76.9
03;2021-09-07;579;1596;275109;256511;83.0;77.4
03;2021-09-08;424;1546;275533;258057;83.2;77.9
03;2021-09-09;275;948;275808;259005;83.2;78.2
03;2021-09-10;413;1246;276221;260251;83.4;78.6
03;2021-09-11;209;688;276430;260939;83.4;78.8
03;2021-09-12;2;20;276432;260959;83.4;78.8
03;2021-09-13;285;943;276717;261902;83.5;79.0
03;2021-09-14;447;1421;277164;263323;83.7;79.5
03;2021-09-15;359;996;277523;264319;83.8;79.8
03;2021-09-16;219;556;277742;264875;83.8;79.9
03;2021-09-17;159;356;277901;265231;83.9;80.1
03;2021-09-18;132;311;278033;265542;83.9;80.1
03;2021-09-19;0;11;278033;265553;83.9;80.2
03;2021-09-20;187;424;278220;265977;84.0;80.3
03;2021-09-21;249;722;278469;266699;84.0;80.5
03;2021-09-22;267;684;278736;267383;84.1;80.7
03;2021-09-23;178;460;278914;267843;84.2;80.8
03;2021-09-24;148;321;279062;268164;84.2;80.9
03;2021-09-25;51;257;279113;268421;84.2;81.0
03;2021-09-26;3;0;279116;268421;84.2;81.0
03;2021-09-27;116;326;279232;268747;84.3;81.1
03;2021-09-28;193;617;279425;269364;84.3;81.3
03;2021-09-29;213;506;279638;269870;84.4;81.5
03;2021-09-30;120;251;279758;270121;84.4;81.5
03;2021-10-01;154;489;279912;270610;84.5;81.7
03;2021-10-02;79;176;279991;270786;84.5;81.7
03;2021-10-03;0;0;279991;270786;84.5;81.7
03;2021-10-04;42;101;280033;270887;84.5;81.8
03;2021-10-05;168;387;280201;271274;84.6;81.9
03;2021-10-06;271;545;280472;271819;84.7;82.0
04;2020-12-27;0;0;0;0;0.0;0.0
04;2020-12-28;1;0;1;0;0.0;0.0
04;2020-12-29;0;0;1;0;0.0;0.0
04;2020-12-30;0;0;1;0;0.0;0.0
04;2020-12-31;0;0;1;0;0.0;0.0
04;2021-01-01;0;0;1;0;0.0;0.0
04;2021-01-02;0;0;1;0;0.0;0.0
04;2021-01-03;0;0;1;0;0.0;0.0
04;2021-01-04;0;0;1;0;0.0;0.0
04;2021-01-05;4;0;5;0;0.0;0.0
04;2021-01-06;0;0;5;0;0.0;0.0
04;2021-01-07;61;0;66;0;0.0;0.0
04;2021-01-08;88;0;154;0;0.1;0.0
04;2021-01-09;57;0;211;0;0.1;0.0
04;2021-01-10;0;0;211;0;0.1;0.0
04;2021-01-11;77;0;288;0;0.2;0.0
04;2021-01-12;421;0;709;0;0.4;0.0
04;2021-01-13;244;2;953;2;0.6;0.0
04;2021-01-14;90;2;1043;4;0.6;0.0
04;2021-01-15;164;4;1207;8;0.7;0.0
04;2021-01-16;106;2;1313;10;0.8;0.0
04;2021-01-17;14;0;1327;10;0.8;0.0
04;2021-01-18;236;9;1563;19;0.9;0.0
04;2021-01-19;469;3;2032;22;1.2;0.0
04;2021-01-20;574;9;2606;31;1.6;0.0
04;2021-01-21;614;3;3220;34;1.9;0.0
04;2021-01-22;639;0;3859;34;2.3;0.0
04;2021-01-23;111;0;3970;34;2.4;0.0
04;2021-01-24;0;0;3970;34;2.4;0.0
04;2021-01-25;240;0;4210;34;2.5;0.0
04;2021-01-26;656;1;4866;35;2.9;0.0
04;2021-01-27;480;0;5346;35;3.2;0.0
04;2021-01-28;665;20;6011;55;3.6;0.0
04;2021-01-29;368;41;6379;96;3.9;0.1
04;2021-01-30;65;41;6444;137;3.9;0.1
04;2021-01-31;1;5;6445;142;3.9;0.1
04;2021-02-01;268;136;6713;278;4.1;0.2
04;2021-02-02;562;173;7275;451;4.4;0.3
04;2021-02-03;367;159;7642;610;4.6;0.4
04;2021-02-04;359;52;8001;662;4.8;0.4
04;2021-02-05;379;201;8380;863;5.1;0.5
04;2021-02-06;50;85;8430;948;5.1;0.6
04;2021-02-07;2;22;8432;970;5.1;0.6
04;2021-02-08;163;61;8595;1031;5.2;0.6
04;2021-02-09;196;112;8791;1143;5.3;0.7
04;2021-02-10;253;153;9044;1296;5.5;0.8
04;2021-02-11;363;244;9407;1540;5.7;0.9
04;2021-02-12;293;283;9700;1823;5.9;1.1
04;2021-02-13;27;86;9727;1909;5.9;1.2
04;2021-02-14;0;0;9727;1909;5.9;1.2
04;2021-02-15;31;135;9758;2044;5.9;1.2
04;2021-02-16;81;412;9839;2456;6.0;1.5
04;2021-02-17;67;365;9906;2821;6.0;1.7
04;2021-02-18;45;522;9951;3343;6.0;2.0
04;2021-02-19;53;306;10004;3649;6.1;2.2
04;2021-02-20;5;65;10009;3714;6.1;2.2
04;2021-02-21;0;0;10009;3714;6.1;2.2
04;2021-02-22;7;247;10016;3961;6.1;2.4
04;2021-02-23;19;500;10035;4461;6.1;2.7
04;2021-02-24;38;366;10073;4827;6.1;2.9
04;2021-02-25;73;323;10146;5150;6.1;3.1
04;2021-02-26;216;274;10362;5424;6.3;3.3
04;2021-02-27;179;66;10541;5490;6.4;3.3
04;2021-02-28;1;0;10542;5490;6.4;3.3
04;2021-03-01;18;64;10560;5554;6.4;3.4
04;2021-03-02;135;37;10695;5591;6.5;3.4
04;2021-03-03;375;557;11070;6148;6.7;3.7
04;2021-03-04;208;417;11278;6565;6.8;4.0
04;2021-03-05;236;318;11514;6883;7.0;4.2
04;2021-03-06;912;71;12426;6954;7.5;4.2
04;2021-03-07;498;25;12924;6979;7.8;4.2
04;2021-03-08;45;69;12969;7048;7.9;4.3
04;2021-03-09;215;229;13184;7277;8.0;4.4
04;2021-03-10;401;338;13585;7615;8.2;4.6
04;2021-03-11;495;314;14080;7929;8.5;4.8
04;2021-03-12;697;190;14777;8119;8.9;4.9
04;2021-03-13;1088;63;15865;8182;9.6;5.0
04;2021-03-14;460;3;16325;8185;9.9;5.0
04;2021-03-15;93;14;16418;8199;9.9;5.0
04;2021-03-16;74;8;16492;8207;10.0;5.0
04;2021-03-17;534;81;17026;8288;10.3;5.0
04;2021-03-18;815;24;17841;8312;10.8;5.0
04;2021-03-19;723;33;18564;8345;11.2;5.1
04;2021-03-20;159;3;18723;8348;11.3;5.1
04;2021-03-21;0;0;18723;8348;11.3;5.1
04;2021-03-22;105;13;18828;8361;11.4;5.1
04;2021-03-23;245;7;19073;8368;11.5;5.1
04;2021-03-24;1024;51;20097;8419;12.2;5.1
04;2021-03-25;1326;45;21423;8464;13.0;5.1
04;2021-03-26;1448;66;22871;8530;13.8;5.2
04;2021-03-27;266;19;23137;8549;14.0;5.2
04;2021-03-28;2;0;23139;8549;14.0;5.2
04;2021-03-29;680;13;23819;8562;14.4;5.2
04;2021-03-30;1086;142;24905;8704;15.1;5.3
04;2021-03-31;1327;107;26232;8811;15.9;5.3
04;2021-04-01;1133;133;27365;8944;16.6;5.4
04;2021-04-02;1185;113;28550;9057;17.3;5.5
04;2021-04-03;250;20;28800;9077;17.4;5.5
04;2021-04-04;1;0;28801;9077;17.4;5.5
04;2021-04-05;36;1;28837;9078;17.5;5.5
04;2021-04-06;929;150;29766;9228;18.0;5.6
04;2021-04-07;881;435;30647;9663;18.6;5.8
04;2021-04-08;926;696;31573;10359;19.1;6.3
04;2021-04-09;678;421;32251;10780;19.5;6.5
04;2021-04-10;231;191;32482;10971;19.7;6.6
04;2021-04-11;153;65;32635;11036;19.8;6.7
04;2021-04-12;593;101;33228;11137;20.1;6.7
04;2021-04-13;1189;240;34417;11377;20.8;6.9
04;2021-04-14;994;496;35411;11873;21.4;7.2
04;2021-04-15;921;672;36332;12545;22.0;7.6
04;2021-04-16;819;456;37151;13001;22.5;7.9
04;2021-04-17;209;69;37360;13070;22.6;7.9
04;2021-04-18;0;13;37360;13083;22.6;7.9
04;2021-04-19;338;287;37698;13370;22.8;8.1
04;2021-04-20;1003;446;38701;13816;23.4;8.4
04;2021-04-21;656;743;39357;14559;23.8;8.8
04;2021-04-22;758;853;40115;15412;24.3;9.3
04;2021-04-23;696;538;40811;15950;24.7;9.7
04;2021-04-24;165;65;40976;16015;24.8;9.7
04;2021-04-25;0;0;40976;16015;24.8;9.7
04;2021-04-26;172;611;41148;16626;24.9;10.1
04;2021-04-27;395;966;41543;17592;25.1;10.6
04;2021-04-28;431;1085;41974;18677;25.4;11.3
04;2021-04-29;688;1127;42662;19804;25.8;12.0
04;2021-04-30;436;847;43098;20651;26.1;12.5
04;2021-05-01;104;22;43202;20673;26.2;12.5
04;2021-05-02;8;131;43210;20804;26.2;12.6
04;2021-05-03;151;550;43361;21354;26.2;12.9
04;2021-05-04;564;835;43925;22189;26.6;13.4
04;2021-05-05;514;924;44439;23113;26.9;14.0
04;2021-05-06;1161;591;45600;23704;27.6;14.3
04;2021-05-07;656;753;46256;24457;28.0;14.8
04;2021-05-08;48;99;46304;24556;28.0;14.9
04;2021-05-09;0;0;46304;24556;28.0;14.9
04;2021-05-10;467;293;46771;24849;28.3;15.0
04;2021-05-11;1198;905;47969;25754;29.0;15.6
04;2021-05-12;1387;741;49356;26495;29.9;16.0
04;2021-05-13;378;131;49734;26626;30.1;16.1
04;2021-05-14;441;295;50175;26921;30.4;16.3
04;2021-05-15;99;161;50274;27082;30.4;16.4
04;2021-05-16;4;6;50278;27088;30.4;16.4
04;2021-05-17;155;297;50433;27385;30.5;16.6
04;2021-05-18;392;974;50825;28359;30.8;17.2
04;2021-05-19;773;688;51598;29047;31.2;17.6
04;2021-05-20;1256;548;52854;29595;32.0;17.9
04;2021-05-21;853;787;53707;30382;32.5;18.4
04;2021-05-22;105;146;53812;30528;32.6;18.5
04;2021-05-23;1;1;53813;30529;32.6;18.5
04;2021-05-24;2;36;53815;30565;32.6;18.5
04;2021-05-25;868;594;54683;31159;33.1;18.9
04;2021-05-26;1048;788;55731;31947;33.7;19.3
04;2021-05-27;1356;632;57087;32579;34.6;19.7
04;2021-05-28;1119;652;58206;33231;35.2;20.1
04;2021-05-29;90;398;58296;33629;35.3;20.4
04;2021-05-30;3;1;58299;33630;35.3;20.4
04;2021-05-31;420;416;58719;34046;35.5;20.6
04;2021-06-01;639;641;59358;34687;35.9;21.0
04;2021-06-02;871;1063;60229;35750;36.5;21.6
04;2021-06-03;1196;850;61425;36600;37.2;22.2
04;2021-06-04;978;777;62403;37377;37.8;22.6
04;2021-06-05;142;200;62545;37577;37.9;22.7
04;2021-06-06;7;13;62552;37590;37.9;22.8
04;2021-06-07;563;316;63115;37906;38.2;22.9
04;2021-06-08;839;594;63954;38500;38.7;23.3
04;2021-06-09;1146;685;65100;39185;39.4;23.7
04;2021-06-10;1142;585;66242;39770;40.1;24.1
04;2021-06-11;944;615;67186;40385;40.7;24.4
04;2021-06-12;212;144;67398;40529;40.8;24.5
04;2021-06-13;1;1;67399;40530;40.8;24.5
04;2021-06-14;478;303;67877;40833;41.1;24.7
04;2021-06-15;644;1003;68521;41836;41.5;25.3
04;2021-06-16;1022;786;69543;42622;42.1;25.8
04;2021-06-17;1001;959;70544;43581;42.7;26.4
04;2021-06-18;761;886;71305;44467;43.2;26.9
04;2021-06-19;40;85;71345;44552;43.2;27.0
04;2021-06-20;7;9;71352;44561;43.2;27.0
04;2021-06-21;305;614;71657;45175;43.4;27.3
04;2021-06-22;361;1308;72018;46483;43.6;28.1
04;2021-06-23;474;1311;72492;47794;43.9;28.9
04;2021-06-24;852;815;73344;48609;44.4;29.4
04;2021-06-25;461;639;73805;49248;44.7;29.8
04;2021-06-26;57;130;73862;49378;44.7;29.9
04;2021-06-27;4;4;73866;49382;44.7;29.9
04;2021-06-28;158;341;74024;49723;44.8;30.1
04;2021-06-29;370;839;74394;50562;45.0;30.6
04;2021-06-30;541;1121;74935;51683;45.4;31.3
04;2021-07-01;578;1219;75513;52902;45.7;32.0
04;2021-07-02;557;1090;76070;53992;46.0;32.7
04;2021-07-03;65;162;76135;54154;46.1;32.8
04;2021-07-04;6;6;76141;54160;46.1;32.8
04;2021-07-05;106;297;76247;54457;46.2;33.0
04;2021-07-06;503;1383;76750;55840;46.5;33.8
04;2021-07-07;494;1341;77244;57181;46.8;34.6
04;2021-07-08;725;1361;77969;58542;47.2;35.4
04;2021-07-09;580;1061;78549;59603;47.5;36.1
04;2021-07-10;92;177;78641;59780;47.6;36.2
04;2021-07-11;0;21;78641;59801;47.6;36.2
04;2021-07-12;128;652;78769;60453;47.7;36.6
04;2021-07-13;881;1540;79650;61993;48.2;37.5
04;2021-07-14;26;43;79676;62036;48.2;37.6
04;2021-07-15;1219;1736;80895;63772;49.0;38.6
04;2021-07-16;1082;1113;81977;64885;49.6;39.3
04;2021-07-17;446;235;82423;65120;49.9;39.4
04;2021-07-18;114;18;82537;65138;50.0;39.4
04;2021-07-19;484;655;83021;65793;50.3;39.8
04;2021-07-20;1313;1467;84334;67260;51.1;40.7
04;2021-07-21;1126;1165;85460;68425;51.7;41.4
04;2021-07-22;1500;1372;86960;69797;52.6;42.3
04;2021-07-23;1150;1140;88110;70937;53.3;42.9
04;2021-07-24;685;215;88795;71152;53.8;43.1
04;2021-07-25;42;16;88837;71168;53.8;43.1
04;2021-07-26;445;639;89282;71807;54.0;43.5
04;2021-07-27;1370;1045;90652;72852;54.9;44.1
04;2021-07-28;1073;1037;91725;73889;55.5;44.7
04;2021-07-29;1561;1302;93286;75191;56.5;45.5
04;2021-07-30;1245;924;94531;76115;57.2;46.1
04;2021-07-31;251;176;94782;76291;57.4;46.2
04;2021-08-01;48;19;94830;76310;57.4;46.2
04;2021-08-02;196;108;95026;76418;57.5;46.3
04;2021-08-03;1348;1116;96374;77534;58.3;46.9
04;2021-08-04;1178;864;97552;78398;59.1;47.5
04;2021-08-05;1194;738;98746;79136;59.8;47.9
04;2021-08-06;516;396;99262;79532;60.1;48.1
04;2021-08-07;162;162;99424;79694;60.2;48.2
04;2021-08-08;25;12;99449;79706;60.2;48.2
04;2021-08-09;102;116;99551;79822;60.3;48.3
04;2021-08-10;654;981;100205;80803;60.7;48.9
04;2021-08-11;1147;1020;101352;81823;61.4;49.5
04;2021-08-12;1124;1308;102476;83131;62.0;50.3
04;2021-08-13;443;386;102919;83517;62.3;50.6
04;2021-08-14;100;73;103019;83590;62.4;50.6
04;2021-08-15;1;0;103020;83590;62.4;50.6
04;2021-08-16;103;138;103123;83728;62.4;50.7
04;2021-08-17;496;1015;103619;84743;62.7;51.3
04;2021-08-18;719;1318;104338;86061;63.2;52.1
04;2021-08-19;740;1413;105078;87474;63.6;53.0
04;2021-08-20;748;1363;105826;88837;64.1;53.8
04;2021-08-21;66;111;105892;88948;64.1;53.8
04;2021-08-22;15;45;105907;88993;64.1;53.9
04;2021-08-23;55;110;105962;89103;64.1;53.9
04;2021-08-24;684;1493;106646;90596;64.6;54.8
04;2021-08-25;658;1182;107304;91778;65.0;55.6
04;2021-08-26;488;1217;107792;92995;65.3;56.3
04;2021-08-27;452;929;108244;93924;65.5;56.9
04;2021-08-28;132;245;108376;94169;65.6;57.0
04;2021-08-29;27;23;108403;94192;65.6;57.0
04;2021-08-30;122;244;108525;94436;65.7;57.2
04;2021-08-31;511;1008;109036;95444;66.0;57.8
04;2021-09-01;510;1253;109546;96697;66.3;58.5
04;2021-09-02;336;932;109882;97629;66.5;59.1
04;2021-09-03;288;819;110170;98448;66.7;59.6
04;2021-09-04;148;240;110318;98688;66.8;59.7
04;2021-09-05;14;9;110332;98697;66.8;59.7
04;2021-09-06;57;106;110389;98803;66.8;59.8
04;2021-09-07;371;1039;110760;99842;67.0;60.4
04;2021-09-08;328;894;111088;100736;67.2;61.0
04;2021-09-09;341;959;111429;101695;67.5;61.6
04;2021-09-10;277;813;111706;102508;67.6;62.1
04;2021-09-11;93;153;111799;102661;67.7;62.1
04;2021-09-12;18;30;111817;102691;67.7;62.2
04;2021-09-13;95;98;111912;102789;67.7;62.2
04;2021-09-14;334;967;112246;103756;67.9;62.8
04;2021-09-15;309;702;112555;104458;68.1;63.2
04;2021-09-16;310;522;112865;104980;68.3;63.5
04;2021-09-17;184;565;113049;105545;68.4;63.9
04;2021-09-18;48;123;113097;105668;68.5;64.0
04;2021-09-19;0;5;113097;105673;68.5;64.0
04;2021-09-20;79;51;113176;105724;68.5;64.0
04;2021-09-21;188;570;113364;106294;68.6;64.3
04;2021-09-22;162;677;113526;106971;68.7;64.8
04;2021-09-23;205;377;113731;107348;68.8;65.0
04;2021-09-24;143;436;113874;107784;68.9;65.2
04;2021-09-25;42;99;113916;107883;69.0;65.3
04;2021-09-26;6;26;113922;107909;69.0;65.3
04;2021-09-27;19;66;113941;107975;69.0;65.4
04;2021-09-28;139;277;114080;108252;69.1;65.5
04;2021-09-29;136;383;114216;108635;69.1;65.8
04;2021-09-30;116;270;114332;108905;69.2;65.9
04;2021-10-01;121;182;114453;109087;69.3;66.0
04;2021-10-02;60;135;114513;109222;69.3;66.1
04;2021-10-03;3;5;114516;109227;69.3;66.1
04;2021-10-04;35;45;114551;109272;69.3;66.1
04;2021-10-05;170;341;114721;109613;69.4;66.4
04;2021-10-06;180;337;114901;109950;69.6;66.6
05;2020-12-27;0;0;0;0;0.0;0.0
05;2020-12-28;1;0;1;0;0.0;0.0
05;2020-12-29;1;0;2;0;0.0;0.0
05;2020-12-30;2;0;4;0;0.0;0.0
05;2020-12-31;0;0;4;0;0.0;0.0
05;2021-01-01;2;0;6;0;0.0;0.0
05;2021-01-02;2;0;8;0;0.0;0.0
05;2021-01-03;1;0;9;0;0.0;0.0
05;2021-01-04;2;0;11;0;0.0;0.0
05;2021-01-05;0;0;11;0;0.0;0.0
05;2021-01-06;22;0;33;0;0.0;0.0
05;2021-01-07;128;0;161;0;0.1;0.0
05;2021-01-08;146;0;307;0;0.2;0.0
05;2021-01-09;11;0;318;0;0.2;0.0
05;2021-01-10;0;0;318;0;0.2;0.0
05;2021-01-11;44;0;362;0;0.3;0.0
05;2021-01-12;105;0;467;0;0.3;0.0
05;2021-01-13;139;0;606;0;0.4;0.0
05;2021-01-14;167;0;773;0;0.5;0.0
05;2021-01-15;127;1;900;1;0.6;0.0
05;2021-01-16;15;0;915;1;0.6;0.0
05;2021-01-17;0;0;915;1;0.6;0.0
05;2021-01-18;226;1;1141;2;0.8;0.0
05;2021-01-19;227;0;1368;2;1.0;0.0
05;2021-01-20;213;0;1581;2;1.1;0.0
05;2021-01-21;255;0;1836;2;1.3;0.0
05;2021-01-22;196;1;2032;3;1.4;0.0
05;2021-01-23;113;0;2145;3;1.5;0.0
05;2021-01-24;0;0;2145;3;1.5;0.0
05;2021-01-25;316;0;2461;3;1.7;0.0
05;2021-01-26;486;0;2947;3;2.1;0.0
05;2021-01-27;389;3;3336;6;2.4;0.0
05;2021-01-28;363;42;3699;48;2.6;0.0
05;2021-01-29;364;109;4063;157;2.9;0.1
05;2021-01-30;97;9;4160;166;2.9;0.1
05;2021-01-31;4;0;4164;166;2.9;0.1
05;2021-02-01;177;20;4341;186;3.1;0.1
05;2021-02-02;187;68;4528;254;3.2;0.2
05;2021-02-03;208;58;4736;312;3.3;0.2
05;2021-02-04;197;113;4933;425;3.5;0.3
05;2021-02-05;183;107;5116;532;3.6;0.4
05;2021-02-06;76;24;5192;556;3.7;0.4
05;2021-02-07;0;5;5192;561;3.7;0.4
05;2021-02-08;84;95;5276;656;3.7;0.5
05;2021-02-09;97;90;5373;746;3.8;0.5
05;2021-02-10;81;147;5454;893;3.8;0.6
05;2021-02-11;87;111;5541;1004;3.9;0.7
05;2021-02-12;85;121;5626;1125;4.0;0.8
05;2021-02-13;75;29;5701;1154;4.0;0.8
05;2021-02-14;0;0;5701;1154;4.0;0.8
05;2021-02-15;98;148;5799;1302;4.1;0.9
05;2021-02-16;111;233;5910;1535;4.2;1.1
05;2021-02-17;136;198;6046;1733;4.3;1.2
05;2021-02-18;154;265;6200;1998;4.4;1.4
05;2021-02-19;158;288;6358;2286;4.5;1.6
05;2021-02-20;31;73;6389;2359;4.5;1.7
05;2021-02-21;0;0;6389;2359;4.5;1.7
05;2021-02-22;70;204;6459;2563;4.6;1.8
05;2021-02-23;18;167;6477;2730;4.6;1.9
05;2021-02-24;20;142;6497;2872;4.6;2.0
05;2021-02-25;56;116;6553;2988;4.6;2.1
05;2021-02-26;145;170;6698;3158;4.7;2.2
05;2021-02-27;65;149;6763;3307;4.8;2.3
05;2021-02-28;11;0;6774;3307;4.8;2.3
05;2021-03-01;92;143;6866;3450;4.8;2.4
05;2021-03-02;92;157;6958;3607;4.9;2.5
05;2021-03-03;112;192;7070;3799;5.0;2.7
05;2021-03-04;242;138;7312;3937;5.2;2.8
05;2021-03-05;578;165;7890;4102;5.6;2.9
05;2021-03-06;668;49;8558;4151;6.0;2.9
05;2021-03-07;516;20;9074;4171;6.4;2.9
05;2021-03-08;556;127;9630;4298;6.8;3.0
05;2021-03-09;520;148;10150;4446;7.2;3.1
05;2021-03-10;498;125;10648;4571;7.5;3.2
05;2021-03-11;377;136;11025;4707;7.8;3.3
05;2021-03-12;435;87;11460;4794;8.1;3.4
05;2021-03-13;797;96;12257;4890;8.6;3.4
05;2021-03-14;670;11;12927;4901;9.1;3.5
05;2021-03-15;354;121;13281;5022;9.4;3.5
05;2021-03-16;149;135;13430;5157;9.5;3.6
05;2021-03-17;262;119;13692;5276;9.7;3.7
05;2021-03-18;364;35;14056;5311;9.9;3.7
05;2021-03-19;450;59;14506;5370;10.2;3.8
05;2021-03-20;167;28;14673;5398;10.4;3.8
05;2021-03-21;1;0;14674;5398;10.4;3.8
05;2021-03-22;718;37;15392;5435;10.9;3.8
05;2021-03-23;805;15;16197;5450;11.4;3.8
05;2021-03-24;788;76;16985;5526;12.0;3.9
05;2021-03-25;901;59;17886;5585;12.6;3.9
05;2021-03-26;1023;49;18909;5634;13.3;4.0
05;2021-03-27;467;33;19376;5667;13.7;4.0
05;2021-03-28;10;0;19386;5667;13.7;4.0
05;2021-03-29;905;63;20291;5730;14.3;4.0
05;2021-03-30;1142;78;21433;5808;15.1;4.1
05;2021-03-31;824;253;22257;6061;15.7;4.3
05;2021-04-01;901;239;23158;6300;16.3;4.4
05;2021-04-02;664;380;23822;6680;16.8;4.7
05;2021-04-03;551;183;24373;6863;17.2;4.8
05;2021-04-04;350;63;24723;6926;17.4;4.9
05;2021-04-05;158;12;24881;6938;17.6;4.9
05;2021-04-06;646;274;25527;7212;18.0;5.1
05;2021-04-07;773;324;26300;7536;18.6;5.3
05;2021-04-08;733;337;27033;7873;19.1;5.6
05;2021-04-09;883;407;27916;8280;19.7;5.8
05;2021-04-10;714;387;28630;8667;20.2;6.1
05;2021-04-11;191;172;28821;8839;20.3;6.2
05;2021-04-12;732;264;29553;9103;20.8;6.4
05;2021-04-13;921;248;30474;9351;21.5;6.6
05;2021-04-14;666;325;31140;9676;22.0;6.8
05;2021-04-15;768;399;31908;10075;22.5;7.1
05;2021-04-16;730;397;32638;10472;23.0;7.4
05;2021-04-17;671;239;33309;10711;23.5;7.6
05;2021-04-18;305;23;33614;10734;23.7;7.6
05;2021-04-19;363;536;33977;11270;24.0;8.0
05;2021-04-20;482;628;34459;11898;24.3;8.4
05;2021-04-21;494;626;34953;12524;24.7;8.8
05;2021-04-22;385;546;35338;13070;24.9;9.2
05;2021-04-23;523;655;35861;13725;25.3;9.7
05;2021-04-24;347;384;36208;14109;25.5;10.0
05;2021-04-25;288;23;36496;14132;25.7;10.0
05;2021-04-26;367;704;36863;14836;26.0;10.5
05;2021-04-27;657;750;37520;15586;26.5;11.0
05;2021-04-28;468;721;37988;16307;26.8;11.5
05;2021-04-29;702;749;38690;17056;27.3;12.0
05;2021-04-30;509;753;39199;17809;27.7;12.6
05;2021-05-01;138;110;39337;17919;27.7;12.6
05;2021-05-02;267;115;39604;18034;27.9;12.7
05;2021-05-03;458;492;40062;18526;28.3;13.1
05;2021-05-04;384;503;40446;19029;28.5;13.4
05;2021-05-05;461;670;40907;19699;28.9;13.9
05;2021-05-06;644;725;41551;20424;29.3;14.4
05;2021-05-07;595;799;42146;21223;29.7;15.0
05;2021-05-08;481;177;42627;21400;30.1;15.1
05;2021-05-09;208;57;42835;21457;30.2;15.1
05;2021-05-10;500;696;43335;22153;30.6;15.6
05;2021-05-11;669;905;44004;23058;31.0;16.3
05;2021-05-12;647;733;44651;23791;31.5;16.8
05;2021-05-13;960;116;45611;23907;32.2;16.9
05;2021-05-14;826;495;46437;24402;32.8;17.2
05;2021-05-15;1044;353;47481;24755;33.5;17.5
05;2021-05-16;235;52;47716;24807;33.7;17.5
05;2021-05-17;484;430;48200;25237;34.0;17.8
05;2021-05-18;519;419;48719;25656;34.4;18.1
05;2021-05-19;727;459;49446;26115;34.9;18.4
05;2021-05-20;747;434;50193;26549;35.4;18.7
05;2021-05-21;706;512;50899;27061;35.9;19.1
05;2021-05-22;607;239;51506;27300;36.3;19.3
05;2021-05-23;277;59;51783;27359;36.5;19.3
05;2021-05-24;510;157;52293;27516;36.9;19.4
05;2021-05-25;515;483;52808;27999;37.3;19.8
05;2021-05-26;695;362;53503;28361;37.7;20.0
05;2021-05-27;799;572;54302;28933;38.3;20.4
05;2021-05-28;666;648;54968;29581;38.8;20.9
05;2021-05-29;566;544;55534;30125;39.2;21.3
05;2021-05-30;212;82;55746;30207;39.3;21.3
05;2021-05-31;576;495;56322;30702;39.7;21.7
05;2021-06-01;590;586;56912;31288;40.1;22.1
05;2021-06-02;684;703;57596;31991;40.6;22.6
05;2021-06-03;716;649;58312;32640;41.1;23.0
05;2021-06-04;1017;815;59329;33455;41.9;23.6
05;2021-06-05;807;507;60136;33962;42.4;24.0
05;2021-06-06;202;89;60338;34051;42.6;24.0
05;2021-06-07;605;833;60943;34884;43.0;24.6
05;2021-06-08;702;661;61645;35545;43.5;25.1
05;2021-06-09;648;782;62293;36327;43.9;25.6
05;2021-06-10;545;718;62838;37045;44.3;26.1
05;2021-06-11;765;723;63603;37768;44.9;26.6
05;2021-06-12;593;485;64196;38253;45.3;27.0
05;2021-06-13;113;91;64309;38344;45.4;27.0
05;2021-06-14;403;669;64712;39013;45.7;27.5
05;2021-06-15;543;911;65255;39924;46.0;28.2
05;2021-06-16;433;671;65688;40595;46.3;28.6
05;2021-06-17;360;805;66048;41400;46.6;29.2
05;2021-06-18;400;724;66448;42124;46.9;29.7
05;2021-06-19;421;570;66869;42694;47.2;30.1
05;2021-06-20;64;77;66933;42771;47.2;30.2
05;2021-06-21;319;641;67252;43412;47.4;30.6
05;2021-06-22;356;829;67608;44241;47.7;31.2
05;2021-06-23;354;763;67962;45004;47.9;31.7
05;2021-06-24;388;1021;68350;46025;48.2;32.5
05;2021-06-25;229;892;68579;46917;48.4;33.1
05;2021-06-26;292;1074;68871;47991;48.6;33.9
05;2021-06-27;128;170;68999;48161;48.7;34.0
05;2021-06-28;254;792;69253;48953;48.9;34.5
05;2021-06-29;250;785;69503;49738;49.0;35.1
05;2021-06-30;329;788;69832;50526;49.3;35.6
05;2021-07-01;385;792;70217;51318;49.5;36.2
05;2021-07-02;369;871;70586;52189;49.8;36.8
05;2021-07-03;305;741;70891;52930;50.0;37.3
05;2021-07-04;179;175;71070;53105;50.1;37.5
05;2021-07-05;264;780;71334;53885;50.3;38.0
05;2021-07-06;336;858;71670;54743;50.6;38.6
05;2021-07-07;400;781;72070;55524;50.8;39.2
05;2021-07-08;431;848;72501;56372;51.1;39.8
05;2021-07-09;422;994;72923;57366;51.4;40.5
05;2021-07-10;314;729;73237;58095;51.7;41.0
05;2021-07-11;176;120;73413;58215;51.8;41.1
05;2021-07-12;416;1014;73829;59229;52.1;41.8
05;2021-07-13;482;869;74311;60098;52.4;42.4
05;2021-07-14;837;300;75148;60398;53.0;42.6
05;2021-07-15;709;992;75857;61390;53.5;43.3
05;2021-07-16;1027;1456;76884;62846;54.2;44.3
05;2021-07-17;672;1306;77556;64152;54.7;45.3
05;2021-07-18;286;132;77842;64284;54.9;45.3
05;2021-07-19;572;792;78414;65076;55.3;45.9
05;2021-07-20;763;801;79177;65877;55.9;46.5
05;2021-07-21;882;840;80059;66717;56.5;47.1
05;2021-07-22;812;870;80871;67587;57.0;47.7
05;2021-07-23;1446;1239;82317;68826;58.1;48.6
05;2021-07-24;864;836;83181;69662;58.7;49.1
05;2021-07-25;305;160;83486;69822;58.9;49.3
05;2021-07-26;778;561;84264;70383;59.4;49.7
05;2021-07-27;1259;755;85523;71138;60.3;50.2
05;2021-07-28;1523;720;87046;71858;61.4;50.7
05;2021-07-29;1346;724;88392;72582;62.4;51.2
05;2021-07-30;960;595;89352;73177;63.0;51.6
05;2021-07-31;782;526;90134;73703;63.6;52.0
05;2021-08-01;192;178;90326;73881;63.7;52.1
05;2021-08-02;835;549;91161;74430;64.3;52.5
05;2021-08-03;828;610;91989;75040;64.9;52.9
05;2021-08-04;992;758;92981;75798;65.6;53.5
05;2021-08-05;981;727;93962;76525;66.3;54.0
05;2021-08-06;873;793;94835;77318;66.9;54.5
05;2021-08-07;631;642;95466;77960;67.3;55.0
05;2021-08-08;196;270;95662;78230;67.5;55.2
05;2021-08-09;775;847;96437;79077;68.0;55.8
05;2021-08-10;651;700;97088;79777;68.5;56.3
05;2021-08-11;743;857;97831;80634;69.0;56.9
05;2021-08-12;795;786;98626;81420;69.6;57.4
05;2021-08-13;626;893;99252;82313;70.0;58.1
05;2021-08-14;410;781;99662;83094;70.3;58.6
05;2021-08-15;188;224;99850;83318;70.4;58.8
05;2021-08-16;488;1086;100338;84404;70.8;59.5
05;2021-08-17;433;880;100771;85284;71.1;60.2
05;2021-08-18;438;974;101209;86258;71.4;60.8
05;2021-08-19;500;964;101709;87222;71.7;61.5
05;2021-08-20;478;1115;102187;88337;72.1;62.3
05;2021-08-21;359;851;102546;89188;72.3;62.9
05;2021-08-22;117;254;102663;89442;72.4;63.1
05;2021-08-23;320;828;102983;90270;72.6;63.7
05;2021-08-24;404;781;103387;91051;72.9;64.2
05;2021-08-25;408;926;103795;91977;73.2;64.9
05;2021-08-26;307;816;104102;92793;73.4;65.5
05;2021-08-27;334;921;104436;93714;73.7;66.1
05;2021-08-28;246;655;104682;94369;73.8;66.6
05;2021-08-29;66;255;104748;94624;73.9;66.8
05;2021-08-30;268;804;105016;95428;74.1;67.3
05;2021-08-31;253;713;105269;96141;74.3;67.8
05;2021-09-01;271;655;105540;96796;74.5;68.3
05;2021-09-02;255;708;105795;97504;74.6;68.8
05;2021-09-03;253;617;106048;98121;74.8;69.2
05;2021-09-04;203;669;106251;98790;75.0;69.7
05;2021-09-05;55;178;106306;98968;75.0;69.8
05;2021-09-06;164;422;106470;99390;75.1;70.1
05;2021-09-07;218;618;106688;100008;75.3;70.5
05;2021-09-08;177;594;106865;100602;75.4;71.0
05;2021-09-09;195;524;107060;101126;75.5;71.3
05;2021-09-10;183;450;107243;101576;75.7;71.7
05;2021-09-11;148;462;107391;102038;75.8;72.0
05;2021-09-12;24;106;107415;102144;75.8;72.1
05;2021-09-13;170;418;107585;102562;75.9;72.4
05;2021-09-14;223;366;107808;102928;76.1;72.6
05;2021-09-15;177;376;107985;103304;76.2;72.9
05;2021-09-16;174;254;108159;103558;76.3;73.1
05;2021-09-17;147;319;108306;103877;76.4;73.3
05;2021-09-18;120;359;108426;104236;76.5;73.5
05;2021-09-19;16;38;108442;104274;76.5;73.6
05;2021-09-20;59;166;108501;104440;76.5;73.7
05;2021-09-21;81;246;108582;104686;76.6;73.8
05;2021-09-22;108;290;108690;104976;76.7;74.1
05;2021-09-23;99;237;108789;105213;76.7;74.2
05;2021-09-24;85;281;108874;105494;76.8;74.4
05;2021-09-25;85;225;108959;105719;76.9;74.6
05;2021-09-26;17;31;108976;105750;76.9;74.6
05;2021-09-27;63;144;109039;105894;76.9;74.7
05;2021-09-28;68;159;109107;106053;77.0;74.8
05;2021-09-29;85;199;109192;106252;77.0;75.0
05;2021-09-30;59;102;109251;106354;77.1;75.0
05;2021-10-01;116;240;109367;106594;77.2;75.2
05;2021-10-02;93;194;109460;106788;77.2;75.3
05;2021-10-03;14;31;109474;106819;77.2;75.4
05;2021-10-04;64;160;109538;106979;77.3;75.5
05;2021-10-05;65;180;109603;107159;77.3;75.6
05;2021-10-06;83;163;109686;107322;77.4;75.7
06;2020-12-27;16;0;16;0;0.0;0.0
06;2020-12-28;26;0;42;0;0.0;0.0
06;2020-12-29;12;0;54;0;0.0;0.0
06;2020-12-30;10;0;64;0;0.0;0.0
06;2020-12-31;30;0;94;0;0.0;0.0
06;2021-01-01;26;0;120;0;0.0;0.0
06;2021-01-02;9;0;129;0;0.0;0.0
06;2021-01-03;11;0;140;0;0.0;0.0
06;2021-01-04;159;1;299;1;0.0;0.0
06;2021-01-05;194;2;493;3;0.0;0.0
06;2021-01-06;253;2;746;5;0.1;0.0
06;2021-01-07;528;2;1274;7;0.1;0.0
06;2021-01-08;695;3;1969;10;0.2;0.0
06;2021-01-09;391;3;2360;13;0.2;0.0
06;2021-01-10;83;0;2443;13;0.2;0.0
06;2021-01-11;1166;1;3609;14;0.3;0.0
06;2021-01-12;2253;4;5862;18;0.5;0.0
06;2021-01-13;1757;7;7619;25;0.7;0.0
06;2021-01-14;2185;17;9804;42;0.9;0.0
06;2021-01-15;1893;5;11697;47;1.1;0.0
06;2021-01-16;995;5;12692;52;1.2;0.0
06;2021-01-17;248;0;12940;52;1.2;0.0
06;2021-01-18;2512;9;15452;61;1.4;0.0
06;2021-01-19;2781;13;18233;74;1.7;0.0
06;2021-01-20;3393;12;21626;86;2.0;0.0
06;2021-01-21;3063;22;24689;108;2.3;0.0
06;2021-01-22;3033;16;27722;124;2.6;0.0
06;2021-01-23;1310;3;29032;127;2.7;0.0
06;2021-01-24;34;0;29066;127;2.7;0.0
06;2021-01-25;2096;12;31162;139;2.9;0.0
06;2021-01-26;3416;43;34578;182;3.2;0.0
06;2021-01-27;2577;93;37155;275;3.4;0.0
06;2021-01-28;2832;183;39987;458;3.7;0.0
06;2021-01-29;2532;281;42519;739;3.9;0.1
06;2021-01-30;674;38;43193;777;4.0;0.1
06;2021-01-31;4;1;43197;778;4.0;0.1
06;2021-02-01;1030;412;44227;1190;4.1;0.1
06;2021-02-02;1517;364;45744;1554;4.2;0.1
06;2021-02-03;340;126;46084;1680;4.3;0.2
06;2021-02-04;727;773;46811;2453;4.3;0.2
06;2021-02-05;1016;947;47827;3400;4.4;0.3
06;2021-02-06;172;357;47999;3757;4.4;0.3
06;2021-02-07;14;49;48013;3806;4.4;0.4
06;2021-02-08;545;871;48558;4677;4.5;0.4
06;2021-02-09;327;682;48885;5359;4.5;0.5
06;2021-02-10;387;563;49272;5922;4.6;0.5
06;2021-02-11;486;897;49758;6819;4.6;0.6
06;2021-02-12;662;1077;50420;7896;4.7;0.7
06;2021-02-13;207;237;50627;8133;4.7;0.8
06;2021-02-14;19;2;50646;8135;4.7;0.8
06;2021-02-15;469;976;51115;9111;4.7;0.8
06;2021-02-16;877;1748;51992;10859;4.8;1.0
06;2021-02-17;847;1737;52839;12596;4.9;1.2
06;2021-02-18;1829;2200;54668;14796;5.1;1.4
06;2021-02-19;1776;1769;56444;16565;5.2;1.5
06;2021-02-20;291;415;56735;16980;5.3;1.6
06;2021-02-21;25;52;56760;17032;5.3;1.6
06;2021-02-22;1094;1220;57854;18252;5.4;1.7
06;2021-02-23;1777;1174;59631;19426;5.5;1.8
06;2021-02-24;2129;996;61760;20422;5.7;1.9
06;2021-02-25;3872;1367;65632;21789;6.1;2.0
06;2021-02-26;3415;1346;69047;23135;6.4;2.1
06;2021-02-27;1443;292;70490;23427;6.5;2.2
06;2021-02-28;104;23;70594;23450;6.5;2.2
06;2021-03-01;2439;669;73033;24119;6.8;2.2
06;2021-03-02;2474;808;75507;24927;7.0;2.3
06;2021-03-03;2880;462;78387;25389;7.3;2.4
06;2021-03-04;4646;502;83033;25891;7.7;2.4
06;2021-03-05;3930;900;86963;26791;8.1;2.5
06;2021-03-06;11982;343;98945;27134;9.2;2.5
06;2021-03-07;10223;311;109168;27445;10.1;2.5
06;2021-03-08;4188;981;113356;28426;10.5;2.6
06;2021-03-09;5022;791;118378;29217;11.0;2.7
06;2021-03-10;4740;655;123118;29872;11.4;2.8
06;2021-03-11;6746;825;129864;30697;12.0;2.8
06;2021-03-12;6898;976;136762;31673;12.7;2.9
06;2021-03-13;11278;347;148040;32020;13.7;3.0
06;2021-03-14;517;47;148557;32067;13.8;3.0
06;2021-03-15;4852;719;153409;32786;14.2;3.0
06;2021-03-16;3784;993;157193;33779;14.6;3.1
06;2021-03-17;6214;1729;163407;35508;15.1;3.3
06;2021-03-18;5137;1755;168544;37263;15.6;3.5
06;2021-03-19;6843;1960;175387;39223;16.2;3.6
06;2021-03-20;2380;511;177767;39734;16.5;3.7
06;2021-03-21;416;23;178183;39757;16.5;3.7
06;2021-03-22;3999;683;182182;40440;16.9;3.7
06;2021-03-23;5999;1185;188181;41625;17.4;3.9
06;2021-03-24;4235;3040;192416;44665;17.8;4.1
06;2021-03-25;5890;3086;198306;47751;18.4;4.4
06;2021-03-26;6374;1971;204680;49722;19.0;4.6
06;2021-03-27;2043;358;206723;50080;19.2;4.6
06;2021-03-28;219;5;206942;50085;19.2;4.6
06;2021-03-29;3212;2073;210154;52158;19.5;4.8
06;2021-03-30;5200;2483;215354;54641;20.0;5.1
06;2021-03-31;8063;1653;223417;56294;20.7;5.2
06;2021-04-01;7678;2457;231095;58751;21.4;5.4
06;2021-04-02;7255;2703;238350;61454;22.1;5.7
06;2021-04-03;2723;1374;241073;62828;22.3;5.8
06;2021-04-04;304;547;241377;63375;22.4;5.9
06;2021-04-05;1417;695;242794;64070;22.5;5.9
06;2021-04-06;6687;3311;249481;67381;23.1;6.2
06;2021-04-07;6240;3888;255721;71269;23.7;6.6
06;2021-04-08;5757;5647;261478;76916;24.2;7.1
06;2021-04-09;9400;5858;270878;82774;25.1;7.7
06;2021-04-10;2396;2778;273274;85552;25.3;7.9
06;2021-04-11;189;58;273463;85610;25.3;7.9
06;2021-04-12;4392;3503;277855;89113;25.7;8.3
06;2021-04-13;6395;5002;284250;94115;26.3;8.7
06;2021-04-14;5480;4431;289730;98546;26.8;9.1
06;2021-04-15;5560;4384;295290;102930;27.4;9.5
06;2021-04-16;7094;5190;302384;108120;28.0;10.0
06;2021-04-17;2789;3053;305173;111173;28.3;10.3
06;2021-04-18;272;223;305445;111396;28.3;10.3
06;2021-04-19;5505;4038;310950;115434;28.8;10.7
06;2021-04-20;5670;4872;316620;120306;29.3;11.1
06;2021-04-21;8339;4183;324959;124489;30.1;11.5
06;2021-04-22;8585;4202;333544;128691;30.9;11.9
06;2021-04-23;8855;4283;342399;132974;31.7;12.3
06;2021-04-24;2358;1495;344757;134469;31.9;12.5
06;2021-04-25;122;14;344879;134483;32.0;12.5
06;2021-04-26;4163;2318;349042;136801;32.3;12.7
06;2021-04-27;4595;4041;353637;140842;32.8;13.0
06;2021-04-28;4166;4574;357803;145416;33.1;13.5
06;2021-04-29;6096;5452;363899;150868;33.7;14.0
06;2021-04-30;6786;5168;370685;156036;34.3;14.5
06;2021-05-01;4168;838;374853;156874;34.7;14.5
06;2021-05-02;494;155;375347;157029;34.8;14.5
06;2021-05-03;6930;3562;382277;160591;35.4;14.9
06;2021-05-04;5757;5391;388034;165982;35.9;15.4
06;2021-05-05;4551;3909;392585;169891;36.4;15.7
06;2021-05-06;5235;4743;397820;174634;36.9;16.2
06;2021-05-07;5663;5673;403483;180307;37.4;16.7
06;2021-05-08;4875;1333;408358;181640;37.8;16.8
06;2021-05-09;206;308;408564;181948;37.9;16.9
06;2021-05-10;4834;5048;413398;186996;38.3;17.3
06;2021-05-11;4949;5558;418347;192554;38.8;17.8
06;2021-05-12;9113;4900;427460;197454;39.6;18.3
06;2021-05-13;9280;2146;436740;199600;40.5;18.5
06;2021-05-14;10863;3366;447603;202966;41.5;18.8
06;2021-05-15;9314;2225;456917;205191;42.3;19.0
06;2021-05-16;1506;288;458423;205479;42.5;19.0
06;2021-05-17;7525;3755;465948;209234;43.2;19.4
06;2021-05-18;9751;3233;475699;212467;44.1;19.7
06;2021-05-19;7716;2988;483415;215455;44.8;20.0
06;2021-05-20;7984;3681;491399;219136;45.5;20.3
06;2021-05-21;8834;3954;500233;223090;46.3;20.7
06;2021-05-22;3033;1326;503266;224416;46.6;20.8
06;2021-05-23;134;630;503400;225046;46.6;20.8
06;2021-05-24;3207;1002;506607;226048;46.9;20.9
06;2021-05-25;4765;4933;511372;230981;47.4;21.4
06;2021-05-26;5697;6631;517069;237612;47.9;22.0
06;2021-05-27;5594;6284;522663;243896;48.4;22.6
06;2021-05-28;4985;7291;527648;251187;48.9;23.3
06;2021-05-29;1638;2925;529286;254112;49.0;23.5
06;2021-05-30;258;1122;529544;255234;49.1;23.6
06;2021-05-31;4420;5121;533964;260355;49.5;24.1
06;2021-06-01;5759;7427;539723;267782;50.0;24.8
06;2021-06-02;3326;8549;543049;276331;50.3;25.6
06;2021-06-03;4551;8306;547600;284637;50.7;26.4
06;2021-06-04;5491;7726;553091;292363;51.2;27.1
06;2021-06-05;2468;3348;555559;295711;51.5;27.4
06;2021-06-06;184;235;555743;295946;51.5;27.4
06;2021-06-07;4149;5583;559892;301529;51.9;27.9
06;2021-06-08;4488;5219;564380;306748;52.3;28.4
06;2021-06-09;4125;7361;568505;314109;52.7;29.1
06;2021-06-10;4795;6871;573300;320980;53.1;29.7
06;2021-06-11;3929;8355;577229;329335;53.5;30.5
06;2021-06-12;1748;3751;578977;333086;53.6;30.9
06;2021-06-13;151;439;579128;333525;53.7;30.9
06;2021-06-14;2744;8606;581872;342131;53.9;31.7
06;2021-06-15;3297;9490;585169;351621;54.2;32.6
06;2021-06-16;3517;7023;588686;358644;54.5;33.2
06;2021-06-17;3685;7190;592371;365834;54.9;33.9
06;2021-06-18;2646;5928;595017;371762;55.1;34.4
06;2021-06-19;1320;1689;596337;373451;55.2;34.6
06;2021-06-20;211;349;596548;373800;55.3;34.6
06;2021-06-21;1738;6296;598286;380096;55.4;35.2
06;2021-06-22;2376;7362;600662;387458;55.6;35.9
06;2021-06-23;2098;6543;602760;394001;55.8;36.5
06;2021-06-24;3497;8967;606257;402968;56.2;37.3
06;2021-06-25;2309;9603;608566;412571;56.4;38.2
06;2021-06-26;893;2288;609459;414859;56.5;38.4
06;2021-06-27;379;1190;609838;416049;56.5;38.5
06;2021-06-28;2503;8123;612341;424172;56.7;39.3
06;2021-06-29;2396;7731;614737;431903;57.0;40.0
06;2021-06-30;1522;7693;616259;439596;57.1;40.7
06;2021-07-01;3573;7482;619832;447078;57.4;41.4
06;2021-07-02;4477;8280;624309;455358;57.8;42.2
06;2021-07-03;1240;4306;625549;459664;58.0;42.6
06;2021-07-04;318;303;625867;459967;58.0;42.6
06;2021-07-05;4078;5144;629945;465111;58.4;43.1
06;2021-07-06;2152;5814;632097;470925;58.6;43.6
06;2021-07-07;4188;5981;636285;476906;58.9;44.2
06;2021-07-08;3733;6334;640018;483240;59.3;44.8
06;2021-07-09;4868;6239;644886;489479;59.7;45.3
06;2021-07-10;1779;2331;646665;491810;59.9;45.6
06;2021-07-11;332;322;646997;492132;59.9;45.6
06;2021-07-12;4210;7150;651207;499282;60.3;46.3
06;2021-07-13;6126;9025;657333;508307;60.9;47.1
06;2021-07-14;1251;442;658584;508749;61.0;47.1
06;2021-07-15;6853;8039;665437;516788;61.6;47.9
06;2021-07-16;8542;9038;673979;525826;62.4;48.7
06;2021-07-17;3170;5477;677149;531303;62.7;49.2
06;2021-07-18;1079;5332;678228;536635;62.8;49.7
06;2021-07-19;6170;8031;684398;544666;63.4;50.5
06;2021-07-20;7602;10261;692000;554927;64.1;51.4
06;2021-07-21;8478;8717;700478;563644;64.9;52.2
06;2021-07-22;10455;7885;710933;571529;65.9;52.9
06;2021-07-23;9571;6931;720504;578460;66.8;53.6
06;2021-07-24;3305;3107;723809;581567;67.1;53.9
06;2021-07-25;1005;481;724814;582048;67.1;53.9
06;2021-07-26;7664;6892;732478;588940;67.9;54.6
06;2021-07-27;9276;5596;741754;594536;68.7;55.1
06;2021-07-28;7494;5407;749248;599943;69.4;55.6
06;2021-07-29;8892;5789;758140;605732;70.2;56.1
06;2021-07-30;8560;5561;766700;611293;71.0;56.6
06;2021-07-31;3831;3082;770531;614375;71.4;56.9
06;2021-08-01;901;436;771432;614811;71.5;57.0
06;2021-08-02;7146;4628;778578;619439;72.1;57.4
06;2021-08-03;6864;5504;785442;624943;72.8;57.9
06;2021-08-04;5836;3519;791278;628462;73.3;58.2
06;2021-08-05;6787;4475;798065;632937;73.9;58.6
06;2021-08-06;6118;6119;804183;639056;74.5;59.2
06;2021-08-07;2326;2474;806509;641530;74.7;59.4
06;2021-08-08;617;632;807126;642162;74.8;59.5
06;2021-08-09;4885;6040;812011;648202;75.2;60.1
06;2021-08-10;5520;6914;817531;655116;75.7;60.7
06;2021-08-11;4456;6215;821987;661331;76.2;61.3
06;2021-08-12;4742;6743;826729;668074;76.6;61.9
06;2021-08-13;3882;6455;830611;674529;77.0;62.5
06;2021-08-14;1599;2275;832210;676804;77.1;62.7
06;2021-08-15;419;639;832629;677443;77.1;62.8
06;2021-08-16;3299;6910;835928;684353;77.4;63.4
06;2021-08-17;3846;7780;839774;692133;77.8;64.1
06;2021-08-18;2999;6411;842773;698544;78.1;64.7
06;2021-08-19;4021;8127;846794;706671;78.5;65.5
06;2021-08-20;3309;6533;850103;713204;78.8;66.1
06;2021-08-21;1843;3594;851946;716798;78.9;66.4
06;2021-08-22;388;712;852334;717510;79.0;66.5
06;2021-08-23;2547;6531;854881;724041;79.2;67.1
06;2021-08-24;2893;6474;857774;730515;79.5;67.7
06;2021-08-25;2630;5682;860404;736197;79.7;68.2
06;2021-08-26;2739;6890;863143;743087;80.0;68.8
06;2021-08-27;2655;7078;865798;750165;80.2;69.5
06;2021-08-28;1296;3335;867094;753500;80.3;69.8
06;2021-08-29;296;826;867390;754326;80.4;69.9
06;2021-08-30;2465;6386;869855;760712;80.6;70.5
06;2021-08-31;2777;7145;872632;767857;80.8;71.1
06;2021-09-01;2860;5817;875492;773674;81.1;71.7
06;2021-09-02;2477;6439;877969;780113;81.3;72.3
06;2021-09-03;2176;6881;880145;786994;81.5;72.9
06;2021-09-04;1383;3664;881528;790658;81.7;73.3
06;2021-09-05;282;530;881810;791188;81.7;73.3
06;2021-09-06;1545;4914;883355;796102;81.8;73.8
06;2021-09-07;1632;5271;884987;801373;82.0;74.2
06;2021-09-08;1570;4476;886557;805849;82.1;74.7
06;2021-09-09;1447;4193;888004;810042;82.3;75.0
06;2021-09-10;1876;4278;889880;814320;82.4;75.4
06;2021-09-11;1085;2465;890965;816785;82.5;75.7
06;2021-09-12;145;337;891110;817122;82.6;75.7
06;2021-09-13;1310;3539;892420;820661;82.7;76.0
06;2021-09-14;1536;3150;893956;823811;82.8;76.3
06;2021-09-15;1487;2757;895443;826568;83.0;76.6
06;2021-09-16;1351;2423;896794;828991;83.1;76.8
06;2021-09-17;1472;2870;898266;831861;83.2;77.1
06;2021-09-18;686;1962;898952;833823;83.3;77.2
06;2021-09-19;108;289;899060;834112;83.3;77.3
06;2021-09-20;717;2134;899777;836246;83.4;77.5
06;2021-09-21;987;2478;900764;838724;83.5;77.7
06;2021-09-22;1046;2512;901810;841236;83.5;77.9
06;2021-09-23;815;2197;902625;843433;83.6;78.1
06;2021-09-24;919;2354;903544;845787;83.7;78.4
06;2021-09-25;490;1780;904034;847567;83.8;78.5
06;2021-09-26;97;219;904131;847786;83.8;78.5
06;2021-09-27;665;1615;904796;849401;83.8;78.7
06;2021-09-28;571;1599;905367;851000;83.9;78.8
06;2021-09-29;819;1790;906186;852790;84.0;79.0
06;2021-09-30;758;1707;906944;854497;84.0;79.2
06;2021-10-01;940;2080;907884;856577;84.1;79.4
06;2021-10-02;499;1346;908383;857923;84.2;79.5
06;2021-10-03;104;170;908487;858093;84.2;79.5
06;2021-10-04;416;1175;908903;859268;84.2;79.6
06;2021-10-05;604;1635;909507;860903;84.3;79.8
06;2021-10-06;713;1723;910220;862626;84.3;79.9
07;2020-12-27;0;0;0;0;0.0;0.0
07;2020-12-28;0;0;0;0;0.0;0.0
07;2020-12-29;0;0;0;0;0.0;0.0
07;2020-12-30;0;0;0;0;0.0;0.0
07;2020-12-31;0;0;0;0;0.0;0.0
07;2021-01-01;7;0;7;0;0.0;0.0
07;2021-01-02;0;0;7;0;0.0;0.0
07;2021-01-03;0;0;7;0;0.0;0.0
07;2021-01-04;0;0;7;0;0.0;0.0
07;2021-01-05;0;0;7;0;0.0;0.0
07;2021-01-06;31;0;38;0;0.0;0.0
07;2021-01-07;130;1;168;1;0.1;0.0
07;2021-01-08;45;1;213;2;0.1;0.0
07;2021-01-09;17;0;230;2;0.1;0.0
07;2021-01-10;0;0;230;2;0.1;0.0
07;2021-01-11;157;1;387;3;0.1;0.0
07;2021-01-12;310;0;697;3;0.2;0.0
07;2021-01-13;308;1;1005;4;0.3;0.0
07;2021-01-14;475;0;1480;4;0.5;0.0
07;2021-01-15;188;0;1668;4;0.5;0.0
07;2021-01-16;17;0;1685;4;0.5;0.0
07;2021-01-17;2;0;1687;4;0.5;0.0
07;2021-01-18;364;4;2051;8;0.6;0.0
07;2021-01-19;830;2;2881;10;0.9;0.0
07;2021-01-20;605;1;3486;11;1.1;0.0
07;2021-01-21;454;3;3940;14;1.2;0.0
07;2021-01-22;292;0;4232;14;1.3;0.0
07;2021-01-23;107;0;4339;14;1.3;0.0
07;2021-01-24;0;0;4339;14;1.3;0.0
07;2021-01-25;164;0;4503;14;1.4;0.0
07;2021-01-26;491;4;4994;18;1.5;0.0
07;2021-01-27;558;8;5552;26;1.7;0.0
07;2021-01-28;1207;102;6759;128;2.1;0.0
07;2021-01-29;714;17;7473;145;2.3;0.0
07;2021-01-30;212;4;7685;149;2.4;0.0
07;2021-01-31;7;0;7692;149;2.4;0.0
07;2021-02-01;267;17;7959;166;2.4;0.1
07;2021-02-02;664;194;8623;360;2.6;0.1
07;2021-02-03;1046;176;9669;536;3.0;0.2
07;2021-02-04;722;247;10391;783;3.2;0.2
07;2021-02-05;484;240;10875;1023;3.3;0.3
07;2021-02-06;98;2;10973;1025;3.4;0.3
07;2021-02-07;12;1;10985;1026;3.4;0.3
07;2021-02-08;239;143;11224;1169;3.4;0.4
07;2021-02-09;490;304;11714;1473;3.6;0.5
07;2021-02-10;538;366;12252;1839;3.7;0.6
07;2021-02-11;400;243;12652;2082;3.9;0.6
07;2021-02-12;266;146;12918;2228;4.0;0.7
07;2021-02-13;69;16;12987;2244;4.0;0.7
07;2021-02-14;1;0;12988;2244;4.0;0.7
07;2021-02-15;270;103;13258;2347;4.1;0.7
07;2021-02-16;352;310;13610;2657;4.2;0.8
07;2021-02-17;466;284;14076;2941;4.3;0.9
07;2021-02-18;564;719;14640;3660;4.5;1.1
07;2021-02-19;458;473;15098;4133;4.6;1.3
07;2021-02-20;109;58;15207;4191;4.7;1.3
07;2021-02-21;15;0;15222;4191;4.7;1.3
07;2021-02-22;425;178;15647;4369;4.8;1.3
07;2021-02-23;648;580;16295;4949;5.0;1.5
07;2021-02-24;927;655;17222;5604;5.3;1.7
07;2021-02-25;709;467;17931;6071;5.5;1.9
07;2021-02-26;844;242;18775;6313;5.7;1.9
07;2021-02-27;190;138;18965;6451;5.8;2.0
07;2021-02-28;1;0;18966;6451;5.8;2.0
07;2021-03-01;438;179;19404;6630;5.9;2.0
07;2021-03-02;657;523;20061;7153;6.1;2.2
07;2021-03-03;695;478;20756;7631;6.3;2.3
07;2021-03-04;1100;311;21856;7942;6.7;2.4
07;2021-03-05;1083;340;22939;8282;7.0;2.5
07;2021-03-06;1127;96;24066;8378;7.4;2.6
07;2021-03-07;717;20;24783;8398;7.6;2.6
07;2021-03-08;352;278;25135;8676;7.7;2.7
07;2021-03-09;1089;393;26224;9069;8.0;2.8
07;2021-03-10;869;502;27093;9571;8.3;2.9
07;2021-03-11;1373;444;28466;10015;8.7;3.1
07;2021-03-12;1618;542;30084;10557;9.2;3.2
07;2021-03-13;683;89;30767;10646;9.4;3.3
07;2021-03-14;4;0;30771;10646;9.4;3.3
07;2021-03-15;525;273;31296;10919;9.6;3.3
07;2021-03-16;1209;475;32505;11394;9.9;3.5
07;2021-03-17;1189;769;33694;12163;10.3;3.7
07;2021-03-18;1217;405;34911;12568;10.7;3.8
07;2021-03-19;1269;423;36180;12991;11.1;4.0
07;2021-03-20;467;106;36647;13097;11.2;4.0
07;2021-03-21;3;1;36650;13098;11.2;4.0
07;2021-03-22;790;530;37440;13628;11.5;4.2
07;2021-03-23;1519;710;38959;14338;11.9;4.4
07;2021-03-24;1280;660;40239;14998;12.3;4.6
07;2021-03-25;1852;508;42091;15506;12.9;4.7
07;2021-03-26;1834;436;43925;15942;13.4;4.9
07;2021-03-27;384;96;44309;16038;13.6;4.9
07;2021-03-28;6;1;44315;16039;13.6;4.9
07;2021-03-29;789;354;45104;16393;13.8;5.0
07;2021-03-30;1526;509;46630;16902;14.3;5.2
07;2021-03-31;1662;507;48292;17409;14.8;5.3
07;2021-04-01;1590;662;49882;18071;15.3;5.5
07;2021-04-02;1522;438;51404;18509;15.7;5.7
07;2021-04-03;230;106;51634;18615;15.8;5.7
07;2021-04-04;3;1;51637;18616;15.8;5.7
07;2021-04-05;0;66;51637;18682;15.8;5.7
07;2021-04-06;1159;760;52796;19442;16.2;5.9
07;2021-04-07;1316;900;54112;20342;16.6;6.2
07;2021-04-08;1969;1176;56081;21518;17.2;6.6
07;2021-04-09;2423;568;58504;22086;17.9;6.8
07;2021-04-10;807;163;59311;22249;18.1;6.8
07;2021-04-11;340;12;59651;22261;18.2;6.8
07;2021-04-12;1287;596;60938;22857;18.6;7.0
07;2021-04-13;1767;1338;62705;24195;19.2;7.4
07;2021-04-14;1687;1016;64392;25211;19.7;7.7
07;2021-04-15;1443;842;65835;26053;20.1;8.0
07;2021-04-16;1506;911;67341;26964;20.6;8.2
07;2021-04-17;870;216;68211;27180;20.9;8.3
07;2021-04-18;699;38;68910;27218;21.1;8.3
07;2021-04-19;1161;574;70071;27792;21.4;8.5
07;2021-04-20;1440;1318;71511;29110;21.9;8.9
07;2021-04-21;1719;917;73230;30027;22.4;9.2
07;2021-04-22;1816;967;75046;30994;23.0;9.5
07;2021-04-23;1411;969;76457;31963;23.4;9.8
07;2021-04-24;962;251;77419;32214;23.7;9.9
07;2021-04-25;717;69;78136;32283;23.9;9.9
07;2021-04-26;1137;678;79273;32961;24.3;10.1
07;2021-04-27;1394;1565;80667;34526;24.7;10.6
07;2021-04-28;1635;1755;82302;36281;25.2;11.1
07;2021-04-29;1938;1530;84240;37811;25.8;11.6
07;2021-04-30;1660;1479;85900;39290;26.3;12.0
07;2021-05-01;960;119;86860;39409;26.6;12.1
07;2021-05-02;844;155;87704;39564;26.8;12.1
07;2021-05-03;1280;434;88984;39998;27.2;12.2
07;2021-05-04;2170;1566;91154;41564;27.9;12.7
07;2021-05-05;1744;1387;92898;42951;28.4;13.1
07;2021-05-06;2101;1587;94999;44538;29.1;13.6
07;2021-05-07;1597;1553;96596;46091;29.6;14.1
07;2021-05-08;1230;403;97826;46494;29.9;14.2
07;2021-05-09;1030;326;98856;46820;30.2;14.3
07;2021-05-10;1406;1176;100262;47996;30.7;14.7
07;2021-05-11;2470;1693;102732;49689;31.4;15.2
07;2021-05-12;2164;1277;104896;50966;32.1;15.6
07;2021-05-13;1712;273;106608;51239;32.6;15.7
07;2021-05-14;1734;996;108342;52235;33.1;16.0
07;2021-05-15;1626;500;109968;52735;33.6;16.1
07;2021-05-16;1442;214;111410;52949;34.1;16.2
07;2021-05-17;1771;857;113181;53806;34.6;16.5
07;2021-05-18;2295;1302;115476;55108;35.3;16.9
07;2021-05-19;2375;1000;117851;56108;36.1;17.2
07;2021-05-20;2165;1308;120016;57416;36.7;17.6
07;2021-05-21;1757;1312;121773;58728;37.3;18.0
07;2021-05-22;935;542;122708;59270;37.5;18.1
07;2021-05-23;856;157;123564;59427;37.8;18.2
07;2021-05-24;1648;339;125212;59766;38.3;18.3
07;2021-05-25;2184;1477;127396;61243;39.0;18.7
07;2021-05-26;1526;1379;128922;62622;39.4;19.2
07;2021-05-27;2015;1412;130937;64034;40.1;19.6
07;2021-05-28;1771;2079;132708;66113;40.6;20.2
07;2021-05-29;942;683;133650;66796;40.9;20.4
07;2021-05-30;622;570;134272;67366;41.1;20.6
07;2021-05-31;1133;1281;135405;68647;41.4;21.0
07;2021-06-01;2153;2001;137558;70648;42.1;21.6
07;2021-06-02;1532;1653;139090;72301;42.6;22.1
07;2021-06-03;1712;1254;140802;73555;43.1;22.5
07;2021-06-04;1676;1593;142478;75148;43.6;23.0
07;2021-06-05;987;955;143465;76103;43.9;23.3
07;2021-06-06;598;624;144063;76727;44.1;23.5
07;2021-06-07;961;1193;145024;77920;44.4;23.8
07;2021-06-08;1547;1771;146571;79691;44.8;24.4
07;2021-06-09;1030;1419;147601;81110;45.2;24.8
07;2021-06-10;789;1388;148390;82498;45.4;25.2
07;2021-06-11;1154;2032;149544;84530;45.7;25.9
07;2021-06-12;643;1217;150187;85747;45.9;26.2
07;2021-06-13;395;444;150582;86191;46.1;26.4
07;2021-06-14;566;1958;151148;88149;46.2;27.0
07;2021-06-15;936;2550;152084;90699;46.5;27.7
07;2021-06-16;1023;1854;153107;92553;46.8;28.3
07;2021-06-17;885;1949;153992;94502;47.1;28.9
07;2021-06-18;868;2281;154860;96783;47.4;29.6
07;2021-06-19;603;1452;155463;98235;47.6;30.1
07;2021-06-20;369;729;155832;98964;47.7;30.3
07;2021-06-21;516;2143;156348;101107;47.8;30.9
07;2021-06-22;655;2661;157003;103768;48.0;31.7
07;2021-06-23;680;1960;157683;105728;48.2;32.3
07;2021-06-24;646;1849;158329;107577;48.4;32.9
07;2021-06-25;701;2175;159030;109752;48.7;33.6
07;2021-06-26;362;1430;159392;111182;48.8;34.0
07;2021-06-27;285;1073;159677;112255;48.8;34.3
07;2021-06-28;506;2241;160183;114496;49.0;35.0
07;2021-06-29;540;2986;160723;117482;49.2;35.9
07;2021-06-30;822;2278;161545;119760;49.4;36.6
07;2021-07-01;776;1951;162321;121711;49.7;37.2
07;2021-07-02;880;2294;163201;124005;49.9;37.9
07;2021-07-03;421;1137;163622;125142;50.1;38.3
07;2021-07-04;211;852;163833;125994;50.1;38.5
07;2021-07-05;670;1685;164503;127679;50.3;39.1
07;2021-07-06;880;2630;165383;130309;50.6;39.9
07;2021-07-07;969;1951;166352;132260;50.9;40.5
07;2021-07-08;928;1959;167280;134219;51.2;41.1
07;2021-07-09;994;2262;168274;136481;51.5;41.8
07;2021-07-10;598;1100;168872;137581;51.7;42.1
07;2021-07-11;239;614;169111;138195;51.7;42.3
07;2021-07-12;807;1769;169918;139964;52.0;42.8
07;2021-07-13;1770;3171;171688;143135;52.5;43.8
07;2021-07-14;167;133;171855;143268;52.6;43.8
07;2021-07-15;1960;2466;173815;145734;53.2;44.6
07;2021-07-16;2056;1987;175871;147721;53.8;45.2
07;2021-07-17;1484;1249;177355;148970;54.3;45.6
07;2021-07-18;771;480;178126;149450;54.5;45.7
07;2021-07-19;1515;1687;179641;151137;55.0;46.2
07;2021-07-20;2519;2678;182160;153815;55.7;47.1
07;2021-07-21;1856;1915;184016;155730;56.3;47.6
07;2021-07-22;1918;1375;185934;157105;56.9;48.1
07;2021-07-23;2264;1688;188198;158793;57.6;48.6
07;2021-07-24;1642;1112;189840;159905;58.1;48.9
07;2021-07-25;34;22;189874;159927;58.1;48.9
07;2021-07-26;2198;1541;192072;161468;58.8;49.4
07;2021-07-27;3016;1915;195088;163383;59.7;50.0
07;2021-07-28;1642;1308;196730;164691;60.2;50.4
07;2021-07-29;2541;1274;199271;165965;61.0;50.8
07;2021-07-30;1356;1415;200627;167380;61.4;51.2
07;2021-07-31;1506;922;202133;168302;61.8;51.5
07;2021-08-01;74;26;202207;168328;61.9;51.5
07;2021-08-02;1516;1133;203723;169461;62.3;51.8
07;2021-08-03;2417;1911;206140;171372;63.1;52.4
07;2021-08-04;1947;1033;208087;172405;63.7;52.7
07;2021-08-05;1893;1296;209980;173701;64.2;53.1
07;2021-08-06;2033;1709;212013;175410;64.9;53.7
07;2021-08-07;998;556;213011;175966;65.2;53.8
07;2021-08-08;12;23;213023;175989;65.2;53.8
07;2021-08-09;1258;1382;214281;177371;65.6;54.3
07;2021-08-10;1599;2259;215880;179630;66.0;55.0
07;2021-08-11;1399;1600;217279;181230;66.5;55.4
07;2021-08-12;1105;1485;218384;182715;66.8;55.9
07;2021-08-13;1182;1790;219566;184505;67.2;56.4
07;2021-08-14;512;766;220078;185271;67.3;56.7
07;2021-08-15;9;28;220087;185299;67.3;56.7
07;2021-08-16;754;1328;220841;186627;67.6;57.1
07;2021-08-17;1339;2278;222180;188905;68.0;57.8
07;2021-08-18;879;1517;223059;190422;68.2;58.3
07;2021-08-19;1148;1697;224207;192119;68.6;58.8
07;2021-08-20;899;2086;225106;194205;68.9;59.4
07;2021-08-21;364;549;225470;194754;69.0;59.6
07;2021-08-22;7;23;225477;194777;69.0;59.6
07;2021-08-23;467;1307;225944;196084;69.1;60.0
07;2021-08-24;1125;2312;227069;198396;69.5;60.7
07;2021-08-25;691;1838;227760;200234;69.7;61.3
07;2021-08-26;690;2021;228450;202255;69.9;61.9
07;2021-08-27;784;1830;229234;204085;70.1;62.4
07;2021-08-28;338;608;229572;204693;70.2;62.6
07;2021-08-29;1;33;229573;204726;70.2;62.6
07;2021-08-30;429;1326;230002;206052;70.4;63.0
07;2021-08-31;1094;2284;231096;208336;70.7;63.7
07;2021-09-01;543;1396;231639;209732;70.9;64.2
07;2021-09-02;605;1543;232244;211275;71.0;64.6
07;2021-09-03;741;1891;232985;213166;71.3;65.2
07;2021-09-04;309;716;233294;213882;71.4;65.4
07;2021-09-05;26;28;233320;213910;71.4;65.4
07;2021-09-06;403;1029;233723;214939;71.5;65.8
07;2021-09-07;523;1462;234246;216401;71.7;66.2
07;2021-09-08;442;1159;234688;217560;71.8;66.6
07;2021-09-09;476;1051;235164;218611;71.9;66.9
07;2021-09-10;518;1420;235682;220031;72.1;67.3
07;2021-09-11;167;660;235849;220691;72.2;67.5
07;2021-09-12;0;9;235849;220700;72.2;67.5
07;2021-09-13;351;617;236200;221317;72.3;67.7
07;2021-09-14;533;1125;236733;222442;72.4;68.1
07;2021-09-15;304;743;237037;223185;72.5;68.3
07;2021-09-16;426;566;237463;223751;72.6;68.5
07;2021-09-17;318;800;237781;224551;72.7;68.7
07;2021-09-18;100;454;237881;225005;72.8;68.8
07;2021-09-19;3;32;237884;225037;72.8;68.8
07;2021-09-20;238;365;238122;225402;72.8;69.0
07;2021-09-21;286;696;238408;226098;72.9;69.2
07;2021-09-22;172;725;238580;226823;73.0;69.4
07;2021-09-23;189;531;238769;227354;73.0;69.6
07;2021-09-24;278;838;239047;228192;73.1;69.8
07;2021-09-25;47;206;239094;228398;73.1;69.9
07;2021-09-26;6;17;239100;228415;73.1;69.9
07;2021-09-27;145;458;239245;228873;73.2;70.0
07;2021-09-28;178;522;239423;229395;73.2;70.2
07;2021-09-29;127;513;239550;229908;73.3;70.3
07;2021-09-30;174;451;239724;230359;73.3;70.5
07;2021-10-01;220;593;239944;230952;73.4;70.7
07;2021-10-02;76;137;240020;231089;73.4;70.7
07;2021-10-03;10;15;240030;231104;73.4;70.7
07;2021-10-04;161;366;240191;231470;73.5;70.8
07;2021-10-05;206;446;240397;231916;73.5;70.9
07;2021-10-06;159;329;240556;232245;73.6;71.1
08;2020-12-27;1;0;1;0;0.0;0.0
08;2020-12-28;0;0;1;0;0.0;0.0
08;2020-12-29;0;0;1;0;0.0;0.0
08;2020-12-30;0;0;1;0;0.0;0.0
08;2020-12-31;0;0;1;0;0.0;0.0
08;2021-01-01;0;0;1;0;0.0;0.0
08;2021-01-02;0;0;1;0;0.0;0.0
08;2021-01-03;2;0;3;0;0.0;0.0
08;2021-01-04;24;0;27;0;0.0;0.0
08;2021-01-05;1;0;28;0;0.0;0.0
08;2021-01-06;0;0;28;0;0.0;0.0
08;2021-01-07;188;0;216;0;0.1;0.0
08;2021-01-08;315;0;531;0;0.2;0.0
08;2021-01-09;115;0;646;0;0.2;0.0
08;2021-01-10;1;0;647;0;0.2;0.0
08;2021-01-11;66;0;713;0;0.3;0.0
08;2021-01-12;157;0;870;0;0.3;0.0
08;2021-01-13;480;1;1350;1;0.5;0.0
08;2021-01-14;538;9;1888;10;0.7;0.0
08;2021-01-15;288;2;2176;12;0.8;0.0
08;2021-01-16;107;0;2283;12;0.9;0.0
08;2021-01-17;2;0;2285;12;0.9;0.0
08;2021-01-18;371;2;2656;14;1.0;0.0
08;2021-01-19;873;1;3529;15;1.3;0.0
08;2021-01-20;909;4;4438;19;1.7;0.0
08;2021-01-21;743;1;5181;20;2.0;0.0
08;2021-01-22;678;1;5859;21;2.2;0.0
08;2021-01-23;237;0;6096;21;2.3;0.0
08;2021-01-24;0;0;6096;21;2.3;0.0
08;2021-01-25;209;0;6305;21;2.4;0.0
08;2021-01-26;303;1;6608;22;2.5;0.0
08;2021-01-27;410;1;7018;23;2.6;0.0
08;2021-01-28;565;176;7583;199;2.9;0.1
08;2021-01-29;588;172;8171;371;3.1;0.1
08;2021-01-30;222;59;8393;430;3.2;0.2
08;2021-01-31;0;0;8393;430;3.2;0.2
08;2021-02-01;80;43;8473;473;3.2;0.2
08;2021-02-02;192;160;8665;633;3.3;0.2
08;2021-02-03;140;162;8805;795;3.3;0.3
08;2021-02-04;309;274;9114;1069;3.4;0.4
08;2021-02-05;499;341;9613;1410;3.6;0.5
08;2021-02-06;149;66;9762;1476;3.7;0.6
08;2021-02-07;8;0;9770;1476;3.7;0.6
08;2021-02-08;40;155;9810;1631;3.7;0.6
08;2021-02-09;221;605;10031;2236;3.8;0.8
08;2021-02-10;334;585;10365;2821;3.9;1.1
08;2021-02-11;467;320;10832;3141;4.1;1.2
08;2021-02-12;676;334;11508;3475;4.3;1.3
08;2021-02-13;140;91;11648;3566;4.4;1.3
08;2021-02-14;3;60;11651;3626;4.4;1.4
08;2021-02-15;227;166;11878;3792;4.5;1.4
08;2021-02-16;130;303;12008;4095;4.5;1.5
08;2021-02-17;112;314;12120;4409;4.6;1.7
08;2021-02-18;215;415;12335;4824;4.6;1.8
08;2021-02-19;305;336;12640;5160;4.8;1.9
08;2021-02-20;7;185;12647;5345;4.8;2.0
08;2021-02-21;0;0;12647;5345;4.8;2.0
08;2021-02-22;131;148;12778;5493;4.8;2.1
08;2021-02-23;150;260;12928;5753;4.9;2.2
08;2021-02-24;163;331;13091;6084;4.9;2.3
08;2021-02-25;500;439;13591;6523;5.1;2.5
08;2021-02-26;603;535;14194;7058;5.3;2.7
08;2021-02-27;318;174;14512;7232;5.5;2.7
08;2021-02-28;19;1;14531;7233;5.5;2.7
08;2021-03-01;200;90;14731;7323;5.5;2.8
08;2021-03-02;654;256;15385;7579;5.8;2.9
08;2021-03-03;899;183;16284;7762;6.1;2.9
08;2021-03-04;735;279;17019;8041;6.4;3.0
08;2021-03-05;1021;475;18040;8516;6.8;3.2
08;2021-03-06;695;137;18735;8653;7.1;3.3
08;2021-03-07;75;2;18810;8655;7.1;3.3
08;2021-03-08;217;122;19027;8777;7.2;3.3
08;2021-03-09;688;148;19715;8925;7.4;3.4
08;2021-03-10;1038;115;20753;9040;7.8;3.4
08;2021-03-11;982;233;21735;9273;8.2;3.5
08;2021-03-12;1631;504;23366;9777;8.8;3.7
08;2021-03-13;798;122;24164;9899;9.1;3.7
08;2021-03-14;22;0;24186;9899;9.1;3.7
08;2021-03-15;291;72;24477;9971;9.2;3.8
08;2021-03-16;563;38;25040;10009;9.4;3.8
08;2021-03-17;804;64;25844;10073;9.7;3.8
08;2021-03-18;816;158;26660;10231;10.0;3.9
08;2021-03-19;1134;278;27794;10509;10.5;4.0
08;2021-03-20;511;16;28305;10525;10.7;4.0
08;2021-03-21;13;1;28318;10526;10.7;4.0
08;2021-03-22;367;45;28685;10571;10.8;4.0
08;2021-03-23;733;63;29418;10634;11.1;4.0
08;2021-03-24;1327;70;30745;10704;11.6;4.0
08;2021-03-25;1906;97;32651;10801;12.3;4.1
08;2021-03-26;2571;171;35222;10972;13.3;4.1
08;2021-03-27;898;123;36120;11095;13.6;4.2
08;2021-03-28;228;7;36348;11102;13.7;4.2
08;2021-03-29;261;183;36609;11285;13.8;4.2
08;2021-03-30;832;482;37441;11767;14.1;4.4
08;2021-03-31;852;529;38293;12296;14.4;4.6
08;2021-04-01;1687;447;39980;12743;15.1;4.8
08;2021-04-02;1497;513;41477;13256;15.6;5.0
08;2021-04-03;1329;203;42806;13459;16.1;5.1
08;2021-04-04;134;4;42940;13463;16.2;5.1
08;2021-04-05;17;0;42957;13463;16.2;5.1
08;2021-04-06;702;481;43659;13944;16.4;5.3
08;2021-04-07;909;701;44568;14645;16.8;5.5
08;2021-04-08;1745;521;46313;15166;17.4;5.7
08;2021-04-09;2348;729;48661;15895;18.3;6.0
08;2021-04-10;1445;226;50106;16121;18.9;6.1
08;2021-04-11;10;6;50116;16127;18.9;6.1
08;2021-04-12;671;212;50787;16339;19.1;6.2
08;2021-04-13;1309;610;52096;16949;19.6;6.4
08;2021-04-14;1280;867;53376;17816;20.1;6.7
08;2021-04-15;1606;806;54982;18622;20.7;7.0
08;2021-04-16;1873;882;56855;19504;21.4;7.3
08;2021-04-17;1112;402;57967;19906;21.8;7.5
08;2021-04-18;23;14;57990;19920;21.8;7.5
08;2021-04-19;1151;298;59141;20218;22.3;7.6
08;2021-04-20;1120;543;60261;20761;22.7;7.8
08;2021-04-21;1139;745;61400;21506;23.1;8.1
08;2021-04-22;1326;879;62726;22385;23.6;8.4
08;2021-04-23;1675;1171;64401;23556;24.3;8.9
08;2021-04-24;1325;646;65726;24202;24.8;9.1
08;2021-04-25;26;198;65752;24400;24.8;9.2
08;2021-04-26;1040;156;66792;24556;25.2;9.2
08;2021-04-27;1338;592;68130;25148;25.7;9.5
08;2021-04-28;1453;665;69583;25813;26.2;9.7
08;2021-04-29;1174;1305;70757;27118;26.6;10.2
08;2021-04-30;1769;1606;72526;28724;27.3;10.8
08;2021-05-01;1049;494;73575;29218;27.7;11.0
08;2021-05-02;627;183;74202;29401;27.9;11.1
08;2021-05-03;1172;372;75374;29773;28.4;11.2
08;2021-05-04;1328;872;76702;30645;28.9;11.5
08;2021-05-05;1567;1335;78269;31980;29.5;12.0
08;2021-05-06;1971;1653;80240;33633;30.2;12.7
08;2021-05-07;1860;2097;82100;35730;30.9;13.5
08;2021-05-08;922;767;83022;36497;31.3;13.7
08;2021-05-09;443;71;83465;36568;31.4;13.8
08;2021-05-10;1192;657;84657;37225;31.9;14.0
08;2021-05-11;1907;942;86564;38167;32.6;14.4
08;2021-05-12;1809;1238;88373;39405;33.3;14.8
08;2021-05-13;1306;616;89679;40021;33.8;15.1
08;2021-05-14;2535;1037;92214;41058;34.7;15.5
08;2021-05-15;1820;711;94034;41769;35.4;15.7
08;2021-05-16;820;102;94854;41871;35.7;15.8
08;2021-05-17;700;906;95554;42777;36.0;16.1
08;2021-05-18;1250;838;96804;43615;36.5;16.4
08;2021-05-19;1611;960;98415;44575;37.1;16.8
08;2021-05-20;2147;956;100562;45531;37.9;17.1
08;2021-05-21;2339;1274;102901;46805;38.8;17.6
08;2021-05-22;1817;762;104718;47567;39.4;17.9
08;2021-05-23;864;90;105582;47657;39.8;17.9
08;2021-05-24;716;106;106298;47763;40.0;18.0
08;2021-05-25;1456;669;107754;48432;40.6;18.2
08;2021-05-26;1528;1008;109282;49440;41.2;18.6
08;2021-05-27;2005;1143;111287;50583;41.9;19.0
08;2021-05-28;1973;1812;113260;52395;42.7;19.7
08;2021-05-29;1767;960;115027;53355;43.3;20.1
08;2021-05-30;836;102;115863;53457;43.6;20.1
08;2021-05-31;755;570;116618;54027;43.9;20.3
08;2021-06-01;1350;876;117968;54903;44.4;20.7
08;2021-06-02;1295;1192;119263;56095;44.9;21.1
08;2021-06-03;1386;1521;120649;57616;45.4;21.7
08;2021-06-04;1777;2418;122426;60034;46.1;22.6
08;2021-06-05;1176;1380;123602;61414;46.5;23.1
08;2021-06-06;907;106;124509;61520;46.9;23.2
08;2021-06-07;661;1174;125170;62694;47.1;23.6
08;2021-06-08;931;1496;126101;64190;47.5;24.2
08;2021-06-09;840;1386;126941;65576;47.8;24.7
08;2021-06-10;1718;1562;128659;67138;48.5;25.3
08;2021-06-11;1721;2206;130380;69344;49.1;26.1
08;2021-06-12;1417;1526;131797;70870;49.6;26.7
08;2021-06-13;385;598;132182;71468;49.8;26.9
08;2021-06-14;380;1304;132562;72772;49.9;27.4
08;2021-06-15;742;1548;133304;74320;50.2;28.0
08;2021-06-16;808;2052;134112;76372;50.5;28.8
08;2021-06-17;1285;1850;135397;78222;51.0;29.5
08;2021-06-18;1610;2591;137007;80813;51.6;30.4
08;2021-06-19;1324;1405;138331;82218;52.1;31.0
08;2021-06-20;117;422;138448;82640;52.1;31.1
08;2021-06-21;494;1395;138942;84035;52.3;31.6
08;2021-06-22;812;2022;139754;86057;52.6;32.4
08;2021-06-23;859;1672;140613;87729;53.0;33.0
08;2021-06-24;1038;1923;141651;89652;53.3;33.8
08;2021-06-25;1084;2729;142735;92381;53.8;34.8
08;2021-06-26;1010;1784;143745;94165;54.1;35.5
08;2021-06-27;351;642;144096;94807;54.3;35.7
08;2021-06-28;397;1323;144493;96130;54.4;36.2
08;2021-06-29;627;1472;145120;97602;54.7;36.8
08;2021-06-30;857;1688;145977;99290;55.0;37.4
08;2021-07-01;887;2194;146864;101484;55.3;38.2
08;2021-07-02;939;2645;147803;104129;55.7;39.2
08;2021-07-03;784;2145;148587;106274;56.0;40.0
08;2021-07-04;128;861;148715;107135;56.0;40.3
08;2021-07-05;104;1195;148819;108330;56.0;40.8
08;2021-07-06;425;1835;149244;110165;56.2;41.5
08;2021-07-07;364;1781;149608;111946;56.3;42.2
08;2021-07-08;716;2016;150324;113962;56.6;42.9
08;2021-07-09;732;2432;151056;116394;56.9;43.8
08;2021-07-10;652;1999;151708;118393;57.1;44.6
08;2021-07-11;238;725;151946;119118;57.2;44.9
08;2021-07-12;312;1192;152258;120310;57.3;45.3
08;2021-07-13;947;1787;153205;122097;57.7;46.0
08;2021-07-14;179;329;153384;122426;57.8;46.1
08;2021-07-15;759;2448;154143;124874;58.1;47.0
08;2021-07-16;1084;2404;155227;127278;58.5;47.9
08;2021-07-17;993;2105;156220;129383;58.8;48.7
08;2021-07-18;346;741;156566;130124;59.0;49.0
08;2021-07-19;458;918;157024;131042;59.1;49.4
08;2021-07-20;878;1435;157902;132477;59.5;49.9
08;2021-07-21;1237;1716;159139;134193;59.9;50.5
08;2021-07-22;1150;2167;160289;136360;60.4;51.4
08;2021-07-23;1584;2442;161873;138802;61.0;52.3
08;2021-07-24;1309;1922;163182;140724;61.5;53.0
08;2021-07-25;774;445;163956;141169;61.7;53.2
08;2021-07-26;1324;844;165280;142013;62.2;53.5
08;2021-07-27;2186;1405;167466;143418;63.1;54.0
08;2021-07-28;2413;1453;169879;144871;64.0;54.6
08;2021-07-29;2601;1346;172480;146217;65.0;55.1
08;2021-07-30;2601;1587;175081;147804;65.9;55.7
08;2021-07-31;1972;1075;177053;148879;66.7;56.1
08;2021-08-01;935;301;177988;149180;67.0;56.2
08;2021-08-02;1255;682;179243;149862;67.5;56.4
08;2021-08-03;1634;822;180877;150684;68.1;56.7
08;2021-08-04;1493;665;182370;151349;68.7;57.0
08;2021-08-05;1905;977;184275;152326;69.4;57.4
08;2021-08-06;2589;1099;186864;153425;70.4;57.8
08;2021-08-07;1673;1161;188537;154586;71.0;58.2
08;2021-08-08;585;373;189122;154959;71.2;58.4
08;2021-08-09;672;534;189794;155493;71.5;58.6
08;2021-08-10;879;750;190673;156243;71.8;58.8
08;2021-08-11;524;791;191197;157034;72.0;59.1
08;2021-08-12;1161;1080;192358;158114;72.4;59.5
08;2021-08-13;1157;1013;193515;159127;72.9;59.9
08;2021-08-14;587;913;194102;160040;73.1;60.3
08;2021-08-15;137;273;194239;160313;73.2;60.4
08;2021-08-16;218;1177;194457;161490;73.2;60.8
08;2021-08-17;514;1210;194971;162700;73.4;61.3
08;2021-08-18;281;1263;195252;163963;73.5;61.7
08;2021-08-19;606;1888;195858;165851;73.8;62.5
08;2021-08-20;685;2178;196543;168029;74.0;63.3
08;2021-08-21;272;1340;196815;169369;74.1;63.8
08;2021-08-22;104;900;196919;170269;74.2;64.1
08;2021-08-23;160;1448;197079;171717;74.2;64.7
08;2021-08-24;364;1752;197443;173469;74.4;65.3
08;2021-08-25;323;1248;197766;174717;74.5;65.8
08;2021-08-26;502;2064;198268;176781;74.7;66.6
08;2021-08-27;451;2324;198719;179105;74.8;67.5
08;2021-08-28;262;1289;198981;180394;74.9;67.9
08;2021-08-29;169;563;199150;180957;75.0;68.1
08;2021-08-30;302;1170;199452;182127;75.1;68.6
08;2021-08-31;360;1285;199812;183412;75.2;69.1
08;2021-09-01;417;1353;200229;184765;75.4;69.6
08;2021-09-02;465;1298;200694;186063;75.6;70.1
08;2021-09-03;464;1694;201158;187757;75.8;70.7
08;2021-09-04;349;1468;201507;189225;75.9;71.3
08;2021-09-05;106;207;201613;189432;75.9;71.3
08;2021-09-06;196;516;201809;189948;76.0;71.5
08;2021-09-07;205;612;202014;190560;76.1;71.8
08;2021-09-08;281;598;202295;191158;76.2;72.0
08;2021-09-09;344;745;202639;191903;76.3;72.3
08;2021-09-10;494;1030;203133;192933;76.5;72.7
08;2021-09-11;383;853;203516;193786;76.6;73.0
08;2021-09-12;52;91;203568;193877;76.7;73.0
08;2021-09-13;385;260;203953;194137;76.8;73.1
08;2021-09-14;247;401;204200;194538;76.9;73.3
08;2021-09-15;219;318;204419;194856;77.0;73.4
08;2021-09-16;230;422;204649;195278;77.1;73.5
08;2021-09-17;320;500;204969;195778;77.2;73.7
08;2021-09-18;173;430;205142;196208;77.3;73.9
08;2021-09-19;29;90;205171;196298;77.3;73.9
08;2021-09-20;54;235;205225;196533;77.3;74.0
08;2021-09-21;123;277;205348;196810;77.3;74.1
08;2021-09-22;130;368;205478;197178;77.4;74.3
08;2021-09-23;174;412;205652;197590;77.4;74.4
08;2021-09-24;162;516;205814;198106;77.5;74.6
08;2021-09-25;121;415;205935;198521;77.6;74.8
08;2021-09-26;23;105;205958;198626;77.6;74.8
08;2021-09-27;48;211;206006;198837;77.6;74.9
08;2021-09-28;80;226;206086;199063;77.6;75.0
08;2021-09-29;116;339;206202;199402;77.7;75.1
08;2021-09-30;146;376;206348;199778;77.7;75.2
08;2021-10-01;163;465;206511;200243;77.8;75.4
08;2021-10-02;141;288;206652;200531;77.8;75.5
08;2021-10-03;24;67;206676;200598;77.8;75.5
08;2021-10-04;58;347;206734;200945;77.9;75.7
08;2021-10-05;79;172;206813;201117;77.9;75.7
08;2021-10-06;88;241;206901;201358;77.9;75.8
09;2020-12-27;0;0;0;0;0.0;0.0
09;2020-12-28;1;0;1;0;0.0;0.0
09;2020-12-29;0;0;1;0;0.0;0.0
09;2020-12-30;0;0;1;0;0.0;0.0
09;2020-12-31;0;0;1;0;0.0;0.0
09;2021-01-01;0;0;1;0;0.0;0.0
09;2021-01-02;0;0;1;0;0.0;0.0
09;2021-01-03;0;0;1;0;0.0;0.0
09;2021-01-04;2;1;3;1;0.0;0.0
09;2021-01-05;0;0;3;1;0.0;0.0
09;2021-01-06;3;0;6;1;0.0;0.0
09;2021-01-07;257;2;263;3;0.2;0.0
09;2021-01-08;228;0;491;3;0.3;0.0
09;2021-01-09;103;0;594;3;0.4;0.0
09;2021-01-10;59;0;653;3;0.4;0.0
09;2021-01-11;176;0;829;3;0.5;0.0
09;2021-01-12;303;0;1132;3;0.7;0.0
09;2021-01-13;196;0;1328;3;0.9;0.0
09;2021-01-14;432;7;1760;10;1.2;0.0
09;2021-01-15;223;1;1983;11;1.3;0.0
09;2021-01-16;192;2;2175;13;1.4;0.0
09;2021-01-17;123;0;2298;13;1.5;0.0
09;2021-01-18;263;2;2561;15;1.7;0.0
09;2021-01-19;255;1;2816;16;1.8;0.0
09;2021-01-20;346;1;3162;17;2.1;0.0
09;2021-01-21;330;1;3492;18;2.3;0.0
09;2021-01-22;328;1;3820;19;2.5;0.0
09;2021-01-23;237;0;4057;19;2.7;0.0
09;2021-01-24;85;1;4142;20;2.7;0.0
09;2021-01-25;207;10;4349;30;2.9;0.0
09;2021-01-26;629;25;4978;55;3.3;0.0
09;2021-01-27;472;45;5450;100;3.6;0.1
09;2021-01-28;286;140;5736;240;3.8;0.2
09;2021-01-29;251;121;5987;361;3.9;0.2
09;2021-01-30;143;50;6130;411;4.0;0.3
09;2021-01-31;56;10;6186;421;4.1;0.3
09;2021-02-01;81;128;6267;549;4.1;0.4
09;2021-02-02;58;276;6325;825;4.2;0.5
09;2021-02-03;87;187;6412;1012;4.2;0.7
09;2021-02-04;49;260;6461;1272;4.2;0.8
09;2021-02-05;90;117;6551;1389;4.3;0.9
09;2021-02-06;68;31;6619;1420;4.3;0.9
09;2021-02-07;6;48;6625;1468;4.3;1.0
09;2021-02-08;23;139;6648;1607;4.4;1.1
09;2021-02-09;55;215;6703;1822;4.4;1.2
09;2021-02-10;14;121;6717;1943;4.4;1.3
09;2021-02-11;6;156;6723;2099;4.4;1.4
09;2021-02-12;147;100;6870;2199;4.5;1.4
09;2021-02-13;8;117;6878;2316;4.5;1.5
09;2021-02-14;0;35;6878;2351;4.5;1.5
09;2021-02-15;76;105;6954;2456;4.6;1.6
09;2021-02-16;227;424;7181;2880;4.7;1.9
09;2021-02-17;83;317;7264;3197;4.8;2.1
09;2021-02-18;87;350;7351;3547;4.8;2.3
09;2021-02-19;63;188;7414;3735;4.9;2.5
09;2021-02-20;58;143;7472;3878;4.9;2.5
09;2021-02-21;0;37;7472;3915;4.9;2.6
09;2021-02-22;127;165;7599;4080;5.0;2.7
09;2021-02-23;161;102;7760;4182;5.1;2.7
09;2021-02-24;74;141;7834;4323;5.1;2.8
09;2021-02-25;211;143;8045;4466;5.3;2.9
09;2021-02-26;162;140;8207;4606;5.4;3.0
09;2021-02-27;65;45;8272;4651;5.4;3.1
09;2021-02-28;44;13;8316;4664;5.5;3.1
09;2021-03-01;248;83;8564;4747;5.6;3.1
09;2021-03-02;282;63;8846;4810;5.8;3.2
09;2021-03-03;252;120;9098;4930;6.0;3.2
09;2021-03-04;414;29;9512;4959;6.2;3.3
09;2021-03-05;331;48;9843;5007;6.5;3.3
09;2021-03-06;397;41;10240;5048;6.7;3.3
09;2021-03-07;124;4;10364;5052;6.8;3.3
09;2021-03-08;379;60;10743;5112;7.0;3.4
09;2021-03-09;437;130;11180;5242;7.3;3.4
09;2021-03-10;562;71;11742;5313;7.7;3.5
09;2021-03-11;695;77;12437;5390;8.2;3.5
09;2021-03-12;661;31;13098;5421;8.6;3.6
09;2021-03-13;384;3;13482;5424;8.8;3.6
09;2021-03-14;120;4;13602;5428;8.9;3.6
09;2021-03-15;465;50;14067;5478;9.2;3.6
09;2021-03-16;370;77;14437;5555;9.5;3.6
09;2021-03-17;399;71;14836;5626;9.7;3.7
09;2021-03-18;454;42;15290;5668;10.0;3.7
09;2021-03-19;526;55;15816;5723;10.4;3.8
09;2021-03-20;314;39;16130;5762;10.6;3.8
09;2021-03-21;105;0;16235;5762;10.7;3.8
09;2021-03-22;424;117;16659;5879;10.9;3.9
09;2021-03-23;566;164;17225;6043;11.3;4.0
09;2021-03-24;710;43;17935;6086;11.8;4.0
09;2021-03-25;869;134;18804;6220;12.3;4.1
09;2021-03-26;751;47;19555;6267;12.8;4.1
09;2021-03-27;620;70;20175;6337;13.2;4.2
09;2021-03-28;132;24;20307;6361;13.3;4.2
09;2021-03-29;498;273;20805;6634;13.7;4.4
09;2021-03-30;729;153;21534;6787;14.1;4.5
09;2021-03-31;803;182;22337;6969;14.7;4.6
09;2021-04-01;734;253;23071;7222;15.1;4.7
09;2021-04-02;692;264;23763;7486;15.6;4.9
09;2021-04-03;772;116;24535;7602;16.1;5.0
09;2021-04-04;122;57;24657;7659;16.2;5.0
09;2021-04-05;237;61;24894;7720;16.3;5.1
09;2021-04-06;1059;390;25953;8110;17.0;5.3
09;2021-04-07;1207;361;27160;8471;17.8;5.6
09;2021-04-08;1470;409;28630;8880;18.8;5.8
09;2021-04-09;1137;417;29767;9297;19.5;6.1
09;2021-04-10;1349;196;31116;9493;20.4;6.2
09;2021-04-11;173;101;31289;9594;20.5;6.3
09;2021-04-12;737;345;32026;9939;21.0;6.5
09;2021-04-13;1047;413;33073;10352;21.7;6.8
09;2021-04-14;1332;510;34405;10862;22.6;7.1
09;2021-04-15;1148;502;35553;11364;23.3;7.5
09;2021-04-16;1032;405;36585;11769;24.0;7.7
09;2021-04-17;1192;356;37777;12125;24.8;8.0
09;2021-04-18;102;96;37879;12221;24.9;8.0
09;2021-04-19;697;407;38576;12628;25.3;8.3
09;2021-04-20;766;528;39342;13156;25.8;8.6
09;2021-04-21;938;587;40280;13743;26.4;9.0
09;2021-04-22;666;605;40946;14348;26.9;9.4
09;2021-04-23;773;431;41719;14779;27.4;9.7
09;2021-04-24;741;669;42460;15448;27.9;10.1
09;2021-04-25;75;112;42535;15560;27.9;10.2
09;2021-04-26;382;529;42917;16089;28.2;10.6
09;2021-04-27;444;719;43361;16808;28.5;11.0
09;2021-04-28;806;794;44167;17602;29.0;11.6
09;2021-04-29;550;775;44717;18377;29.3;12.1
09;2021-04-30;622;722;45339;19099;29.8;12.5
09;2021-05-01;478;455;45817;19554;30.1;12.8
09;2021-05-02;51;100;45868;19654;30.1;12.9
09;2021-05-03;521;662;46389;20316;30.4;13.3
09;2021-05-04;554;1347;46943;21663;30.8;14.2
09;2021-05-05;822;1348;47765;23011;31.3;15.1
09;2021-05-06;848;1031;48613;24042;31.9;15.8
09;2021-05-07;977;822;49590;24864;32.5;16.3
09;2021-05-08;395;461;49985;25325;32.8;16.6
09;2021-05-09;265;85;50250;25410;33.0;16.7
09;2021-05-10;504;966;50754;26376;33.3;17.3
09;2021-05-11;741;1052;51495;27428;33.8;18.0
09;2021-05-12;1535;1401;53030;28829;34.8;18.9
09;2021-05-13;1383;425;54413;29254;35.7;19.2
09;2021-05-14;987;653;55400;29907;36.4;19.6
09;2021-05-15;1236;789;56636;30696;37.2;20.1
09;2021-05-16;296;48;56932;30744;37.4;20.2
09;2021-05-17;873;412;57805;31156;37.9;20.4
09;2021-05-18;1290;395;59095;31551;38.8;20.7
09;2021-05-19;1495;371;60590;31922;39.8;20.9
09;2021-05-20;1379;404;61969;32326;40.7;21.2
09;2021-05-21;1162;495;63131;32821;41.4;21.5
09;2021-05-22;1544;364;64675;33185;42.4;21.8
09;2021-05-23;272;24;64947;33209;42.6;21.8
09;2021-05-24;177;100;65124;33309;42.7;21.9
09;2021-05-25;998;500;66122;33809;43.4;22.2
09;2021-05-26;1285;448;67407;34257;44.2;22.5
09;2021-05-27;965;403;68372;34660;44.9;22.7
09;2021-05-28;958;511;69330;35171;45.5;23.1
09;2021-05-29;1794;601;71124;35772;46.7;23.5
09;2021-05-30;541;197;71665;35969;47.0;23.6
09;2021-05-31;716;592;72381;36561;47.5;24.0
09;2021-06-01;970;639;73351;37200;48.1;24.4
09;2021-06-02;1009;897;74360;38097;48.8;25.0
09;2021-06-03;809;681;75169;38778;49.3;25.4
09;2021-06-04;877;797;76046;39575;49.9;26.0
09;2021-06-05;1320;875;77366;40450;50.8;26.5
09;2021-06-06;304;108;77670;40558;51.0;26.6
09;2021-06-07;623;517;78293;41075;51.4;27.0
09;2021-06-08;821;488;79114;41563;51.9;27.3
09;2021-06-09;805;834;79919;42397;52.4;27.8
09;2021-06-10;642;534;80561;42931;52.9;28.2
09;2021-06-11;831;762;81392;43693;53.4;28.7
09;2021-06-12;635;808;82027;44501;53.8;29.2
09;2021-06-13;94;130;82121;44631;53.9;29.3
09;2021-06-14;628;708;82749;45339;54.3;29.8
09;2021-06-15;824;889;83573;46228;54.8;30.3
09;2021-06-16;627;1079;84200;47307;55.3;31.0
09;2021-06-17;779;852;84979;48159;55.8;31.6
09;2021-06-18;636;1145;85615;49304;56.2;32.4
09;2021-06-19;516;1580;86131;50884;56.5;33.4
09;2021-06-20;8;279;86139;51163;56.5;33.6
09;2021-06-21;473;698;86612;51861;56.8;34.0
09;2021-06-22;463;1066;87075;52927;57.1;34.7
09;2021-06-23;435;1224;87510;54151;57.4;35.5
09;2021-06-24;581;769;88091;54920;57.8;36.0
09;2021-06-25;410;1064;88501;55984;58.1;36.7
09;2021-06-26;443;1087;88944;57071;58.4;37.4
09;2021-06-27;2;275;88946;57346;58.4;37.6
09;2021-06-28;239;1046;89185;58392;58.5;38.3
09;2021-06-29;314;1228;89499;59620;58.7;39.1
09;2021-06-30;455;1491;89954;61111;59.0;40.1
09;2021-07-01;384;1428;90338;62539;59.3;41.0
09;2021-07-02;308;1162;90646;63701;59.5;41.8
09;2021-07-03;210;1617;90856;65318;59.6;42.9
09;2021-07-04;4;253;90860;65571;59.6;43.0
09;2021-07-05;188;712;91048;66283;59.7;43.5
09;2021-07-06;293;1221;91341;67504;59.9;44.3
09;2021-07-07;419;1399;91760;68903;60.2;45.2
09;2021-07-08;325;1057;92085;69960;60.4;45.9
09;2021-07-09;292;1153;92377;71113;60.6;46.7
09;2021-07-10;345;1725;92722;72838;60.8;47.8
09;2021-07-11;147;392;92869;73230;60.9;48.1
09;2021-07-12;187;1074;93056;74304;61.1;48.8
09;2021-07-13;641;1308;93697;75612;61.5;49.6
09;2021-07-14;490;220;94187;75832;61.8;49.8
09;2021-07-15;818;1166;95005;76998;62.3;50.5
09;2021-07-16;610;1189;95615;78187;62.7;51.3
09;2021-07-17;1015;1444;96630;79631;63.4;52.3
09;2021-07-18;302;221;96932;79852;63.6;52.4
09;2021-07-19;483;973;97415;80825;63.9;53.0
09;2021-07-20;830;1256;98245;82081;64.5;53.9
09;2021-07-21;1016;1165;99261;83246;65.1;54.6
09;2021-07-22;846;910;100107;84156;65.7;55.2
09;2021-07-23;724;910;100831;85066;66.2;55.8
09;2021-07-24;927;463;101758;85529;66.8;56.1
09;2021-07-25;560;134;102318;85663;67.1;56.2
09;2021-07-26;647;765;102965;86428;67.6;56.7
09;2021-07-27;1177;948;104142;87376;68.3;57.3
09;2021-07-28;1197;988;105339;88364;69.1;58.0
09;2021-07-29;1042;739;106381;89103;69.8;58.5
09;2021-07-30;779;623;107160;89726;70.3;58.9
09;2021-07-31;1378;419;108538;90145;71.2;59.2
09;2021-08-01;141;125;108679;90270;71.3;59.2
09;2021-08-02;614;478;109293;90748;71.7;59.5
09;2021-08-03;1254;767;110547;91515;72.5;60.1
09;2021-08-04;1400;654;111947;92169;73.5;60.5
09;2021-08-05;997;677;112944;92846;74.1;60.9
09;2021-08-06;1017;641;113961;93487;74.8;61.3
09;2021-08-07;825;430;114786;93917;75.3;61.6
09;2021-08-08;129;131;114915;94048;75.4;61.7
09;2021-08-09;690;648;115605;94696;75.9;62.1
09;2021-08-10;940;694;116545;95390;76.5;62.6
09;2021-08-11;896;866;117441;96256;77.1;63.2
09;2021-08-12;631;730;118072;96986;77.5;63.6
09;2021-08-13;465;645;118537;97631;77.8;64.1
09;2021-08-14;311;828;118848;98459;78.0;64.6
09;2021-08-15;67;138;118915;98597;78.0;64.7
09;2021-08-16;547;620;119462;99217;78.4;65.1
09;2021-08-17;674;777;120136;99994;78.8;65.6
09;2021-08-18;620;931;120756;100925;79.2;66.2
09;2021-08-19;432;722;121188;101647;79.5;66.7
09;2021-08-20;363;749;121551;102396;79.8;67.2
09;2021-08-21;343;1384;121894;103780;80.0;68.1
09;2021-08-22;67;168;121961;103948;80.0;68.2
09;2021-08-23;341;758;122302;104706;80.3;68.7
09;2021-08-24;407;955;122709;105661;80.5;69.3
09;2021-08-25;283;1003;122992;106664;80.7;70.0
09;2021-08-26;316;928;123308;107592;80.9;70.6
09;2021-08-27;226;740;123534;108332;81.1;71.1
09;2021-08-28;257;970;123791;109302;81.2;71.7
09;2021-08-29;15;144;123806;109446;81.2;71.8
09;2021-08-30;275;749;124081;110195;81.4;72.3
09;2021-08-31;314;1150;124395;111345;81.6;73.1
09;2021-09-01;360;977;124755;112322;81.9;73.7
09;2021-09-02;159;605;124914;112927;82.0;74.1
09;2021-09-03;221;879;125135;113806;82.1;74.7
09;2021-09-04;166;539;125301;114345;82.2;75.0
09;2021-09-05;25;104;125326;114449;82.2;75.1
09;2021-09-06;182;651;125508;115100;82.4;75.5
09;2021-09-07;157;696;125665;115796;82.5;76.0
09;2021-09-08;204;920;125869;116716;82.6;76.6
09;2021-09-09;160;557;126029;117273;82.7;77.0
09;2021-09-10;130;475;126159;117748;82.8;77.3
09;2021-09-11;175;506;126334;118254;82.9;77.6
09;2021-09-12;27;80;126361;118334;82.9;77.6
09;2021-09-13;129;524;126490;118858;83.0;78.0
09;2021-09-14;143;689;126633;119547;83.1;78.4
09;2021-09-15;188;603;126821;120150;83.2;78.8
09;2021-09-16;130;324;126951;120474;83.3;79.1
09;2021-09-17;146;404;127097;120878;83.4;79.3
09;2021-09-18;158;345;127255;121223;83.5;79.5
09;2021-09-19;2;0;127257;121223;83.5;79.5
09;2021-09-20;71;290;127328;121513;83.5;79.7
09;2021-09-21;101;205;127429;121718;83.6;79.9
09;2021-09-22;141;471;127570;122189;83.7;80.2
09;2021-09-23;71;164;127641;122353;83.8;80.3
09;2021-09-24;117;289;127758;122642;83.8;80.5
09;2021-09-25;60;193;127818;122835;83.9;80.6
09;2021-09-26;0;17;127818;122852;83.9;80.6
09;2021-09-27;82;326;127900;123178;83.9;80.8
09;2021-09-28;74;175;127974;123353;84.0;80.9
09;2021-09-29;97;235;128071;123588;84.0;81.1
09;2021-09-30;43;118;128114;123706;84.1;81.2
09;2021-10-01;82;125;128196;123831;84.1;81.3
09;2021-10-02;83;230;128279;124061;84.2;81.4
09;2021-10-03;2;8;128281;124069;84.2;81.4
09;2021-10-04;53;114;128334;124183;84.2;81.5
09;2021-10-05;70;125;128404;124308;84.3;81.6
09;2021-10-06;122;221;128526;124529;84.3;81.7
10;2020-12-27;0;0;0;0;0.0;0.0
10;2020-12-28;0;0;0;0;0.0;0.0
10;2020-12-29;0;0;0;0;0.0;0.0
10;2020-12-30;0;0;0;0;0.0;0.0
10;2020-12-31;0;0;0;0;0.0;0.0
10;2021-01-01;0;0;0;0;0.0;0.0
10;2021-01-02;1;0;1;0;0.0;0.0
10;2021-01-03;0;0;1;0;0.0;0.0
10;2021-01-04;0;0;1;0;0.0;0.0
10;2021-01-05;1;0;2;0;0.0;0.0
10;2021-01-06;0;0;2;0;0.0;0.0
10;2021-01-07;84;0;86;0;0.0;0.0
10;2021-01-08;255;0;341;0;0.1;0.0
10;2021-01-09;0;0;341;0;0.1;0.0
10;2021-01-10;1;0;342;0;0.1;0.0
10;2021-01-11;118;0;460;0;0.1;0.0
10;2021-01-12;195;0;655;0;0.2;0.0
10;2021-01-13;314;0;969;0;0.3;0.0
10;2021-01-14;392;8;1361;8;0.4;0.0
10;2021-01-15;359;3;1720;11;0.6;0.0
10;2021-01-16;56;0;1776;11;0.6;0.0
10;2021-01-17;0;0;1776;11;0.6;0.0
10;2021-01-18;702;0;2478;11;0.8;0.0
10;2021-01-19;1391;2;3869;13;1.2;0.0
10;2021-01-20;1085;7;4954;20;1.6;0.0
10;2021-01-21;1152;2;6106;22;2.0;0.0
10;2021-01-22;818;2;6924;24;2.2;0.0
10;2021-01-23;309;0;7233;24;2.3;0.0
10;2021-01-24;0;0;7233;24;2.3;0.0
10;2021-01-25;445;8;7678;32;2.5;0.0
10;2021-01-26;487;17;8165;49;2.6;0.0
10;2021-01-27;458;14;8623;63;2.8;0.0
10;2021-01-28;358;38;8981;101;2.9;0.0
10;2021-01-29;430;132;9411;233;3.0;0.1
10;2021-01-30;30;0;9441;233;3.0;0.1
10;2021-01-31;0;0;9441;233;3.0;0.1
10;2021-02-01;409;118;9850;351;3.2;0.1
10;2021-02-02;182;133;10032;484;3.2;0.2
10;2021-02-03;361;211;10393;695;3.4;0.2
10;2021-02-04;342;233;10735;928;3.5;0.3
10;2021-02-05;328;264;11063;1192;3.6;0.4
10;2021-02-06;3;35;11066;1227;3.6;0.4
10;2021-02-07;0;0;11066;1227;3.6;0.4
10;2021-02-08;190;310;11256;1537;3.6;0.5
10;2021-02-09;485;442;11741;1979;3.8;0.6
10;2021-02-10;667;455;12408;2434;4.0;0.8
10;2021-02-11;781;572;13189;3006;4.3;1.0
10;2021-02-12;580;516;13769;3522;4.4;1.1
10;2021-02-13;37;93;13806;3615;4.5;1.2
10;2021-02-14;0;0;13806;3615;4.5;1.2
10;2021-02-15;143;298;13949;3913;4.5;1.3
10;2021-02-16;116;411;14065;4324;4.5;1.4
10;2021-02-17;129;466;14194;4790;4.6;1.5
10;2021-02-18;217;413;14411;5203;4.7;1.7
10;2021-02-19;188;389;14599;5592;4.7;1.8
10;2021-02-20;24;151;14623;5743;4.7;1.9
10;2021-02-21;0;0;14623;5743;4.7;1.9
10;2021-02-22;77;343;14700;6086;4.7;2.0
10;2021-02-23;76;452;14776;6538;4.8;2.1
10;2021-02-24;114;305;14890;6843;4.8;2.2
10;2021-02-25;322;317;15212;7160;4.9;2.3
10;2021-02-26;351;257;15563;7417;5.0;2.4
10;2021-02-27;275;109;15838;7526;5.1;2.4
10;2021-02-28;0;0;15838;7526;5.1;2.4
10;2021-03-01;257;281;16095;7807;5.2;2.5
10;2021-03-02;435;321;16530;8128;5.3;2.6
10;2021-03-03;454;518;16984;8646;5.5;2.8
10;2021-03-04;636;462;17620;9108;5.7;2.9
10;2021-03-05;677;228;18297;9336;5.9;3.0
10;2021-03-06;950;42;19247;9378;6.2;3.0
10;2021-03-07;769;6;20016;9384;6.5;3.0
10;2021-03-08;502;398;20518;9782;6.6;3.2
10;2021-03-09;673;378;21191;10160;6.8;3.3
10;2021-03-10;661;333;21852;10493;7.1;3.4
10;2021-03-11;1174;224;23026;10717;7.4;3.5
10;2021-03-12;1338;231;24364;10948;7.9;3.5
10;2021-03-13;891;38;25255;10986;8.1;3.5
10;2021-03-14;1381;15;26636;11001;8.6;3.5
10;2021-03-15;821;77;27457;11078;8.9;3.6
10;2021-03-16;688;61;28145;11139;9.1;3.6
10;2021-03-17;831;68;28976;11207;9.3;3.6
10;2021-03-18;885;80;29861;11287;9.6;3.6
10;2021-03-19;952;64;30813;11351;9.9;3.7
10;2021-03-20;552;19;31365;11370;10.1;3.7
10;2021-03-21;1849;42;33214;11412;10.7;3.7
10;2021-03-22;879;74;34093;11486;11.0;3.7
10;2021-03-23;1244;89;35337;11575;11.4;3.7
10;2021-03-24;1311;58;36648;11633;11.8;3.8
10;2021-03-25;1676;227;38324;11860;12.4;3.8
10;2021-03-26;1432;115;39756;11975;12.8;3.9
10;2021-03-27;762;78;40518;12053;13.1;3.9
10;2021-03-28;1221;31;41739;12084;13.5;3.9
10;2021-03-29;648;303;42387;12387;13.7;4.0
10;2021-03-30;927;373;43314;12760;14.0;4.1
10;2021-03-31;617;358;43931;13118;14.2;4.2
10;2021-04-01;883;683;44814;13801;14.5;4.5
10;2021-04-02;1069;587;45883;14388;14.8;4.6
10;2021-04-03;540;603;46423;14991;15.0;4.8
10;2021-04-04;1826;263;48249;15254;15.6;4.9
10;2021-04-05;1843;43;50092;15297;16.2;4.9
10;2021-04-06;514;650;50606;15947;16.3;5.1
10;2021-04-07;592;540;51198;16487;16.5;5.3
10;2021-04-08;1060;606;52258;17093;16.9;5.5
10;2021-04-09;1130;612;53388;17705;17.2;5.7
10;2021-04-10;1769;350;55157;18055;17.8;5.8
10;2021-04-11;55;1220;55212;19275;17.8;6.2
10;2021-04-12;1001;807;56213;20082;18.1;6.5
10;2021-04-13;1506;894;57719;20976;18.6;6.8
10;2021-04-14;824;601;58543;21577;18.9;7.0
10;2021-04-15;1454;891;59997;22468;19.4;7.2
10;2021-04-16;1109;697;61106;23165;19.7;7.5
10;2021-04-17;2391;362;63497;23527;20.5;7.6
10;2021-04-18;1422;1785;64919;25312;20.9;8.2
10;2021-04-19;837;833;65756;26145;21.2;8.4
10;2021-04-20;546;1034;66302;27179;21.4;8.8
10;2021-04-21;636;973;66938;28152;21.6;9.1
10;2021-04-22;932;963;67870;29115;21.9;9.4
10;2021-04-23;2172;777;70042;29892;22.6;9.6
10;2021-04-24;2296;376;72338;30268;23.3;9.8
10;2021-04-25;1991;1214;74329;31482;24.0;10.2
10;2021-04-26;773;620;75102;32102;24.2;10.4
10;2021-04-27;895;536;75997;32638;24.5;10.5
10;2021-04-28;873;405;76870;33043;24.8;10.7
10;2021-04-29;1433;669;78303;33712;25.3;10.9
10;2021-04-30;2172;769;80475;34481;26.0;11.1
10;2021-05-01;1988;2167;82463;36648;26.6;11.8
10;2021-05-02;1948;1897;84411;38545;27.2;12.4
10;2021-05-03;622;447;85033;38992;27.4;12.6
10;2021-05-04;1144;1247;86177;40239;27.8;13.0
10;2021-05-05;1753;1021;87930;41260;28.4;13.3
10;2021-05-06;2257;948;90187;42208;29.1;13.6
10;2021-05-07;2218;1134;92405;43342;29.8;14.0
10;2021-05-08;2270;858;94675;44200;30.5;14.3
10;2021-05-09;2004;100;96679;44300;31.2;14.3
10;2021-05-10;531;1092;97210;45392;31.4;14.6
10;2021-05-11;1052;1027;98262;46419;31.7;15.0
10;2021-05-12;2062;883;100324;47302;32.4;15.3
10;2021-05-13;2181;435;102505;47737;33.1;15.4
10;2021-05-14;2728;673;105233;48410;34.0;15.6
10;2021-05-15;2423;2051;107656;50461;34.7;16.3
10;2021-05-16;2080;1448;109736;51909;35.4;16.7
10;2021-05-17;1451;442;111187;52351;35.9;16.9
10;2021-05-18;2510;640;113697;52991;36.7;17.1
10;2021-05-19;1554;639;115251;53630;37.2;17.3
10;2021-05-20;1892;847;117143;54477;37.8;17.6
10;2021-05-21;2318;618;119461;55095;38.5;17.8
10;2021-05-22;2179;421;121640;55516;39.3;17.9
10;2021-05-23;1816;138;123456;55654;39.8;18.0
10;2021-05-24;1968;177;125424;55831;40.5;18.0
10;2021-05-25;2195;491;127619;56322;41.2;18.2
10;2021-05-26;1679;419;129298;56741;41.7;18.3
10;2021-05-27;1659;753;130957;57494;42.3;18.6
10;2021-05-28;1720;1181;132677;58675;42.8;18.9
10;2021-05-29;2170;643;134847;59318;43.5;19.1
10;2021-05-30;1029;134;135876;59452;43.8;19.2
10;2021-05-31;1039;741;136915;60193;44.2;19.4
10;2021-06-01;1135;885;138050;61078;44.5;19.7
10;2021-06-02;1035;720;139085;61798;44.9;19.9
10;2021-06-03;1473;1066;140558;62864;45.4;20.3
10;2021-06-04;1768;2598;142326;65462;45.9;21.1
10;2021-06-05;1518;2450;143844;67912;46.4;21.9
10;2021-06-06;1005;1874;144849;69786;46.7;22.5
10;2021-06-07;700;1110;145549;70896;47.0;22.9
10;2021-06-08;896;1172;146445;72068;47.3;23.3
10;2021-06-09;880;911;147325;72979;47.5;23.5
10;2021-06-10;678;1070;148003;74049;47.8;23.9
10;2021-06-11;1199;2197;149202;76246;48.1;24.6
10;2021-06-12;856;2388;150058;78634;48.4;25.4
10;2021-06-13;401;1834;150459;80468;48.5;26.0
10;2021-06-14;538;742;150997;81210;48.7;26.2
10;2021-06-15;741;2130;151738;83340;49.0;26.9
10;2021-06-16;741;1858;152479;85198;49.2;27.5
10;2021-06-17;851;2457;153330;87655;49.5;28.3
10;2021-06-18;1030;2473;154360;90128;49.8;29.1
10;2021-06-19;981;2595;155341;92723;50.1;29.9
10;2021-06-20;549;1597;155890;94320;50.3;30.4
10;2021-06-21;684;1044;156574;95364;50.5;30.8
10;2021-06-22;745;1526;157319;96890;50.8;31.3
10;2021-06-23;653;2405;157972;99295;51.0;32.0
10;2021-06-24;786;2617;158758;101912;51.2;32.9
10;2021-06-25;730;3047;159488;104959;51.5;33.9
10;2021-06-26;514;2745;160002;107704;51.6;34.8
10;2021-06-27;402;1940;160404;109644;51.8;35.4
10;2021-06-28;683;1784;161087;111428;52.0;36.0
10;2021-06-29;616;2698;161703;114126;52.2;36.8
10;2021-06-30;534;1523;162237;115649;52.4;37.3
10;2021-07-01;555;2172;162792;117821;52.5;38.0
10;2021-07-02;664;2726;163456;120547;52.7;38.9
10;2021-07-03;529;2600;163985;123147;52.9;39.7
10;2021-07-04;411;1726;164396;124873;53.0;40.3
10;2021-07-05;667;2224;165063;127097;53.3;41.0
10;2021-07-06;651;2188;165714;129285;53.5;41.7
10;2021-07-07;639;1703;166353;130988;53.7;42.3
10;2021-07-08;751;1458;167104;132446;53.9;42.7
10;2021-07-09;820;1949;167924;134395;54.2;43.4
10;2021-07-10;632;2096;168556;136491;54.4;44.0
10;2021-07-11;500;1384;169056;137875;54.6;44.5
10;2021-07-12;783;1620;169839;139495;54.8;45.0
10;2021-07-13;1126;1874;170965;141369;55.2;45.6
10;2021-07-14;1169;1054;172134;142423;55.5;46.0
10;2021-07-15;1477;1980;173611;144403;56.0;46.6
10;2021-07-16;1241;2274;174852;146677;56.4;47.3
10;2021-07-17;1287;1738;176139;148415;56.8;47.9
10;2021-07-18;942;1225;177081;149640;57.1;48.3
10;2021-07-19;1361;1622;178442;151262;57.6;48.8
10;2021-07-20;1685;1431;180127;152693;58.1;49.3
10;2021-07-21;1395;1483;181522;154176;58.6;49.7
10;2021-07-22;1941;1597;183463;155773;59.2;50.3
10;2021-07-23;1606;1544;185069;157317;59.7;50.8
10;2021-07-24;1389;1227;186458;158544;60.2;51.2
10;2021-07-25;1251;789;187709;159333;60.6;51.4
10;2021-07-26;1914;1316;189623;160649;61.2;51.8
10;2021-07-27;2139;1070;191762;161719;61.9;52.2
10;2021-07-28;2094;1016;193856;162735;62.6;52.5
10;2021-07-29;2444;1205;196300;163940;63.3;52.9
10;2021-07-30;2176;1311;198476;165251;64.0;53.3
10;2021-07-31;1680;938;200156;166189;64.6;53.6
10;2021-08-01;1236;570;201392;166759;65.0;53.8
10;2021-08-02;1463;1337;202855;168096;65.5;54.2
10;2021-08-03;1635;897;204490;168993;66.0;54.5
10;2021-08-04;1370;1066;205860;170059;66.4;54.9
10;2021-08-05;1654;1345;207514;171404;67.0;55.3
10;2021-08-06;1835;1333;209349;172737;67.6;55.7
10;2021-08-07;1156;1133;210505;173870;67.9;56.1
10;2021-08-08;660;751;211165;174621;68.1;56.3
10;2021-08-09;1311;1542;212476;176163;68.6;56.8
10;2021-08-10;1670;1352;214146;177515;69.1;57.3
10;2021-08-11;854;1108;215000;178623;69.4;57.6
10;2021-08-12;1055;1225;216055;179848;69.7;58.0
10;2021-08-13;739;1075;216794;180923;70.0;58.4
10;2021-08-14;587;1235;217381;182158;70.1;58.8
10;2021-08-15;317;781;217698;182939;70.2;59.0
10;2021-08-16;725;1618;218423;184557;70.5;59.6
10;2021-08-17;877;1776;219300;186333;70.8;60.1
10;2021-08-18;723;1620;220023;187953;71.0;60.6
10;2021-08-19;551;1571;220574;189524;71.2;61.2
10;2021-08-20;644;1733;221218;191257;71.4;61.7
10;2021-08-21;452;1419;221670;192676;71.5;62.2
10;2021-08-22;188;1061;221858;193737;71.6;62.5
10;2021-08-23;481;1562;222339;195299;71.7;63.0
10;2021-08-24;669;1771;223008;197070;72.0;63.6
10;2021-08-25;460;1381;223468;198451;72.1;64.0
10;2021-08-26;432;1486;223900;199937;72.2;64.5
10;2021-08-27;626;1588;224526;201525;72.4;65.0
10;2021-08-28;396;1333;224922;202858;72.6;65.5
10;2021-08-29;225;946;225147;203804;72.6;65.8
10;2021-08-30;433;1395;225580;205199;72.8;66.2
10;2021-08-31;466;1451;226046;206650;72.9;66.7
10;2021-09-01;298;1202;226344;207852;73.0;67.1
10;2021-09-02;272;1149;226616;209001;73.1;67.4
10;2021-09-03;404;1219;227020;210220;73.3;67.8
10;2021-09-04;338;1095;227358;211315;73.4;68.2
10;2021-09-05;174;468;227532;211783;73.4;68.3
10;2021-09-06;272;757;227804;212540;73.5;68.6
10;2021-09-07;303;760;228107;213300;73.6;68.8
10;2021-09-08;255;765;228362;214065;73.7;69.1
10;2021-09-09;331;969;228693;215034;73.8;69.4
10;2021-09-10;433;907;229126;215941;73.9;69.7
10;2021-09-11;259;718;229385;216659;74.0;69.9
10;2021-09-12;93;229;229478;216888;74.0;70.0
10;2021-09-13;226;685;229704;217573;74.1;70.2
10;2021-09-14;245;990;229949;218563;74.2;70.5
10;2021-09-15;238;637;230187;219200;74.3;70.7
10;2021-09-16;282;597;230469;219797;74.4;70.9
10;2021-09-17;270;857;230739;220654;74.5;71.2
10;2021-09-18;197;610;230936;221264;74.5;71.4
10;2021-09-19;62;224;230998;221488;74.5;71.5
10;2021-09-20;139;627;231137;222115;74.6;71.7
10;2021-09-21;151;554;231288;222669;74.6;71.9
10;2021-09-22;132;305;231420;222974;74.7;71.9
10;2021-09-23;215;353;231635;223327;74.7;72.1
10;2021-09-24;211;547;231846;223874;74.8;72.2
10;2021-09-25;112;420;231958;224294;74.8;72.4
10;2021-09-26;58;215;232016;224509;74.9;72.4
10;2021-09-27;220;267;232236;224776;74.9;72.5
10;2021-09-28;204;362;232440;225138;75.0;72.6
10;2021-09-29;190;291;232630;225429;75.1;72.7
10;2021-09-30;156;220;232786;225649;75.1;72.8
10;2021-10-01;202;446;232988;226095;75.2;73.0
10;2021-10-02;145;284;233133;226379;75.2;73.0
10;2021-10-03;58;128;233191;226507;75.2;73.1
10;2021-10-04;98;193;233289;226700;75.3;73.2
10;2021-10-05;107;216;233396;226916;75.3;73.2
10;2021-10-06;136;225;233532;227141;75.4;73.3
11;2020-12-27;0;0;0;0;0.0;0.0
11;2020-12-28;1;0;1;0;0.0;0.0
11;2020-12-29;1;0;2;0;0.0;0.0
11;2020-12-30;0;0;2;0;0.0;0.0
11;2020-12-31;0;0;2;0;0.0;0.0
11;2021-01-01;0;0;2;0;0.0;0.0
11;2021-01-02;5;0;7;0;0.0;0.0
11;2021-01-03;0;0;7;0;0.0;0.0
11;2021-01-04;1;0;8;0;0.0;0.0
11;2021-01-05;95;0;103;0;0.0;0.0
11;2021-01-06;26;0;129;0;0.0;0.0
11;2021-01-07;119;0;248;0;0.1;0.0
11;2021-01-08;91;1;339;1;0.1;0.0
11;2021-01-09;86;0;425;1;0.1;0.0
11;2021-01-10;67;0;492;1;0.1;0.0
11;2021-01-11;136;0;628;1;0.2;0.0
11;2021-01-12;545;3;1173;4;0.3;0.0
11;2021-01-13;409;1;1582;5;0.4;0.0
11;2021-01-14;645;8;2227;13;0.6;0.0
11;2021-01-15;342;3;2569;16;0.7;0.0
11;2021-01-16;77;1;2646;17;0.7;0.0
11;2021-01-17;47;1;2693;18;0.7;0.0
11;2021-01-18;388;0;3081;18;0.8;0.0
11;2021-01-19;539;4;3620;22;1.0;0.0
11;2021-01-20;693;7;4313;29;1.2;0.0
11;2021-01-21;650;5;4963;34;1.3;0.0
11;2021-01-22;524;2;5487;36;1.5;0.0
11;2021-01-23;165;0;5652;36;1.5;0.0
11;2021-01-24;139;0;5791;36;1.6;0.0
11;2021-01-25;377;18;6168;54;1.7;0.0
11;2021-01-26;850;85;7018;139;1.9;0.0
11;2021-01-27;804;23;7822;162;2.1;0.0
11;2021-01-28;652;53;8474;215;2.3;0.1
11;2021-01-29;442;120;8916;335;2.4;0.1
11;2021-01-30;138;0;9054;335;2.4;0.1
11;2021-01-31;82;0;9136;335;2.5;0.1
11;2021-02-01;344;187;9480;522;2.5;0.1
11;2021-02-02;412;361;9892;883;2.7;0.2
11;2021-02-03;392;346;10284;1229;2.8;0.3
11;2021-02-04;376;487;10660;1716;2.9;0.5
11;2021-02-05;318;327;10978;2043;2.9;0.5
11;2021-02-06;210;56;11188;2099;3.0;0.6
11;2021-02-07;109;13;11297;2112;3.0;0.6
11;2021-02-08;317;127;11614;2239;3.1;0.6
11;2021-02-09;300;244;11914;2483;3.2;0.7
11;2021-02-10;343;386;12257;2869;3.3;0.8
11;2021-02-11;609;527;12866;3396;3.5;0.9
11;2021-02-12;407;339;13273;3735;3.6;1.0
11;2021-02-13;195;88;13468;3823;3.6;1.0
11;2021-02-14;73;22;13541;3845;3.6;1.0
11;2021-02-15;241;173;13782;4018;3.7;1.1
11;2021-02-16;264;458;14046;4476;3.8;1.2
11;2021-02-17;454;535;14500;5011;3.9;1.3
11;2021-02-18;456;470;14956;5481;4.0;1.5
11;2021-02-19;300;449;15256;5930;4.1;1.6
11;2021-02-20;148;61;15404;5991;4.1;1.6
11;2021-02-21;59;32;15463;6023;4.1;1.6
11;2021-02-22;124;272;15587;6295;4.2;1.7
11;2021-02-23;283;264;15870;6559;4.3;1.8
11;2021-02-24;252;319;16122;6878;4.3;1.8
11;2021-02-25;563;283;16685;7161;4.5;1.9
11;2021-02-26;523;268;17208;7429;4.6;2.0
11;2021-02-27;319;89;17527;7518;4.7;2.0
11;2021-02-28;95;20;17622;7538;4.7;2.0
11;2021-03-01;339;259;17961;7797;4.8;2.1
11;2021-03-02;562;341;18523;8138;5.0;2.2
11;2021-03-03;601;381;19124;8519;5.1;2.3
11;2021-03-04;1078;368;20202;8887;5.4;2.4
11;2021-03-05;1003;372;21205;9259;5.7;2.5
11;2021-03-06;1096;179;22301;9438;6.0;2.5
11;2021-03-07;658;30;22959;9468;6.2;2.5
11;2021-03-08;369;308;23328;9776;6.3;2.6
11;2021-03-09;997;357;24325;10133;6.5;2.7
11;2021-03-10;1176;508;25501;10641;6.8;2.9
11;2021-03-11;1572;407;27073;11048;7.3;3.0
11;2021-03-12;1457;417;28530;11465;7.7;3.1
11;2021-03-13;1160;222;29690;11687;8.0;3.1
11;2021-03-14;523;49;30213;11736;8.1;3.1
11;2021-03-15;651;226;30864;11962;8.3;3.2
11;2021-03-16;853;196;31717;12158;8.5;3.3
11;2021-03-17;907;210;32624;12368;8.8;3.3
11;2021-03-18;1172;281;33796;12649;9.1;3.4
11;2021-03-19;1372;239;35168;12888;9.4;3.5
11;2021-03-20;790;172;35958;13060;9.6;3.5
11;2021-03-21;225;65;36183;13125;9.7;3.5
11;2021-03-22;809;219;36992;13344;9.9;3.6
11;2021-03-23;1807;386;38799;13730;10.4;3.7
11;2021-03-24;1847;315;40646;14045;10.9;3.8
11;2021-03-25;2190;372;42836;14417;11.5;3.9
11;2021-03-26;2125;421;44961;14838;12.1;4.0
11;2021-03-27;1178;145;46139;14983;12.4;4.0
11;2021-03-28;265;42;46404;15025;12.5;4.0
11;2021-03-29;1182;222;47586;15247;12.8;4.1
11;2021-03-30;1995;321;49581;15568;13.3;4.2
11;2021-03-31;1614;383;51195;15951;13.7;4.3
11;2021-04-01;2145;425;53340;16376;14.3;4.4
11;2021-04-02;1643;428;54983;16804;14.8;4.5
11;2021-04-03;720;145;55703;16949;14.9;4.5
11;2021-04-04;198;75;55901;17024;15.0;4.6
11;2021-04-05;257;4;56158;17028;15.1;4.6
11;2021-04-06;1574;551;57732;17579;15.5;4.7
11;2021-04-07;1778;573;59510;18152;16.0;4.9
11;2021-04-08;1785;680;61295;18832;16.4;5.1
11;2021-04-09;2261;603;63556;19435;17.1;5.2
11;2021-04-10;1168;178;64724;19613;17.4;5.3
11;2021-04-11;551;105;65275;19718;17.5;5.3
11;2021-04-12;1614;541;66889;20259;17.9;5.4
11;2021-04-13;2262;884;69151;21143;18.6;5.7
11;2021-04-14;1661;1018;70812;22161;19.0;5.9
11;2021-04-15;1843;1130;72655;23291;19.5;6.2
11;2021-04-16;1837;849;74492;24140;20.0;6.5
11;2021-04-17;1772;561;76264;24701;20.5;6.6
11;2021-04-18;114;155;76378;24856;20.5;6.7
11;2021-04-19;1384;735;77762;25591;20.9;6.9
11;2021-04-20;1729;1277;79491;26868;21.3;7.2
11;2021-04-21;1780;1323;81271;28191;21.8;7.6
11;2021-04-22;1749;1323;83020;29514;22.3;7.9
11;2021-04-23;2014;1237;85034;30751;22.8;8.3
11;2021-04-24;1735;468;86769;31219;23.3;8.4
11;2021-04-25;659;177;87428;31396;23.5;8.4
11;2021-04-26;1380;838;88808;32234;23.8;8.6
11;2021-04-27;1839;1550;90647;33784;24.3;9.1
11;2021-04-28;2008;1465;92655;35249;24.9;9.5
11;2021-04-29;2247;1637;94902;36886;25.5;9.9
11;2021-04-30;2158;1424;97060;38310;26.0;10.3
11;2021-05-01;1338;344;98398;38654;26.4;10.4
11;2021-05-02;588;336;98986;38990;26.6;10.5
11;2021-05-03;1487;735;100473;39725;27.0;10.7
11;2021-05-04;1878;1427;102351;41152;27.5;11.0
11;2021-05-05;1895;1441;104246;42593;28.0;11.4
11;2021-05-06;2191;1475;106437;44068;28.6;11.8
11;2021-05-07;2106;1548;108543;45616;29.1;12.2
11;2021-05-08;898;726;109441;46342;29.4;12.4
11;2021-05-09;628;543;110069;46885;29.5;12.6
11;2021-05-10;1327;1651;111396;48536;29.9;13.0
11;2021-05-11;2041;1871;113437;50407;30.4;13.5
11;2021-05-12;1848;1649;115285;52056;30.9;14.0
11;2021-05-13;1405;414;116690;52470;31.3;14.1
11;2021-05-14;1718;1182;118408;53652;31.8;14.4
11;2021-05-15;1158;897;119566;54549;32.1;14.6
11;2021-05-16;808;164;120374;54713;32.3;14.7
11;2021-05-17;1470;1046;121844;55759;32.7;15.0
11;2021-05-18;1898;1190;123742;56949;33.2;15.3
11;2021-05-19;1846;1123;125588;58072;33.7;15.6
11;2021-05-20;1971;1091;127559;59163;34.2;15.9
11;2021-05-21;2276;1089;129835;60252;34.8;16.2
11;2021-05-22;1485;726;131320;60978;35.2;16.4
11;2021-05-23;768;72;132088;61050;35.4;16.4
11;2021-05-24;1411;224;133499;61274;35.8;16.4
11;2021-05-25;1811;1353;135310;62627;36.3;16.8
11;2021-05-26;1934;1297;137244;63924;36.8;17.2
11;2021-05-27;1989;1720;139233;65644;37.4;17.6
11;2021-05-28;1755;1901;140988;67545;37.8;18.1
11;2021-05-29;1428;1599;142416;69144;38.2;18.6
11;2021-05-30;486;392;142902;69536;38.3;18.7
11;2021-05-31;1261;1615;144163;71151;38.7;19.1
11;2021-06-01;1856;1903;146019;73054;39.2;19.6
11;2021-06-02;1761;2068;147780;75122;39.7;20.2
11;2021-06-03;2597;2409;150377;77531;40.3;20.8
11;2021-06-04;2147;2664;152524;80195;40.9;21.5
11;2021-06-05;1588;1902;154112;82097;41.3;22.0
11;2021-06-06;877;857;154989;82954;41.6;22.3
11;2021-06-07;1527;1708;156516;84662;42.0;22.7
11;2021-06-08;2042;1990;158558;86652;42.5;23.2
11;2021-06-09;1786;2182;160344;88834;43.0;23.8
11;2021-06-10;1806;2426;162150;91260;43.5;24.5
11;2021-06-11;1864;2493;164014;93753;44.0;25.2
11;2021-06-12;1455;1622;165469;95375;44.4;25.6
11;2021-06-13;713;723;166182;96098;44.6;25.8
11;2021-06-14;1032;1968;167214;98066;44.9;26.3
11;2021-06-15;1395;2685;168609;100751;45.2;27.0
11;2021-06-16;1335;2527;169944;103278;45.6;27.7
11;2021-06-17;1474;2520;171418;105798;46.0;28.4
11;2021-06-18;1518;2487;172936;108285;46.4;29.1
11;2021-06-19;1236;1410;174172;109695;46.7;29.4
11;2021-06-20;299;599;174471;110294;46.8;29.6
11;2021-06-21;838;2122;175309;112416;47.0;30.2
11;2021-06-22;1016;2604;176325;115020;47.3;30.9
11;2021-06-23;1095;2089;177420;117109;47.6;31.4
11;2021-06-24;909;2244;178329;119353;47.8;32.0
11;2021-06-25;993;2547;179322;121900;48.1;32.7
11;2021-06-26;773;1655;180095;123555;48.3;33.2
11;2021-06-27;210;688;180305;124243;48.4;33.3
11;2021-06-28;697;2297;181002;126540;48.6;34.0
11;2021-06-29;963;2599;181965;129139;48.8;34.6
11;2021-06-30;906;2520;182871;131659;49.1;35.3
11;2021-07-01;1004;1889;183875;133548;49.3;35.8
11;2021-07-02;966;2539;184841;136087;49.6;36.5
11;2021-07-03;729;1807;185570;137894;49.8;37.0
11;2021-07-04;340;1109;185910;139003;49.9;37.3
11;2021-07-05;695;2132;186605;141135;50.1;37.9
11;2021-07-06;973;2519;187578;143654;50.3;38.5
11;2021-07-07;945;2507;188523;146161;50.6;39.2
11;2021-07-08;1191;1910;189714;148071;50.9;39.7
11;2021-07-09;824;1795;190538;149866;51.1;40.2
11;2021-07-10;369;1302;190907;151168;51.2;40.6
11;2021-07-11;313;564;191220;151732;51.3;40.7
11;2021-07-12;505;2672;191725;154404;51.4;41.4
11;2021-07-13;1304;3063;193029;157467;51.8;42.2
11;2021-07-14;210;233;193239;157700;51.8;42.3
11;2021-07-15;1450;2961;194689;160661;52.2;43.1
11;2021-07-16;1876;2730;196565;163391;52.7;43.8
11;2021-07-17;1075;2161;197640;165552;53.0;44.4
11;2021-07-18;652;946;198292;166498;53.2;44.7
11;2021-07-19;1355;2088;199647;168586;53.6;45.2
11;2021-07-20;1997;2403;201644;170989;54.1;45.9
11;2021-07-21;2015;2437;203659;173426;54.6;46.5
11;2021-07-22;2415;1883;206074;175309;55.3;47.0
11;2021-07-23;2231;2282;208305;177591;55.9;47.6
11;2021-07-24;1274;1628;209579;179219;56.2;48.1
11;2021-07-25;749;692;210328;179911;56.4;48.3
11;2021-07-26;1667;1427;211995;181338;56.9;48.7
11;2021-07-27;2342;1998;214337;183336;57.5;49.2
11;2021-07-28;2480;1990;216817;185326;58.2;49.7
11;2021-07-29;2771;1794;219588;187120;58.9;50.2
11;2021-07-30;2575;1803;222163;188923;59.6;50.7
11;2021-07-31;2008;1141;224171;190064;60.1;51.0
11;2021-08-01;1011;482;225182;190546;60.4;51.1
11;2021-08-02;1929;1151;227111;191697;60.9;51.4
11;2021-08-03;2442;1601;229553;193298;61.6;51.9
11;2021-08-04;2560;1267;232113;194565;62.3;52.2
11;2021-08-05;2382;1333;234495;195898;62.9;52.6
11;2021-08-06;2252;1661;236747;197559;63.5;53.0
11;2021-08-07;1665;1167;238412;198726;64.0;53.3
11;2021-08-08;599;210;239011;198936;64.1;53.4
11;2021-08-09;1032;1434;240043;200370;64.4;53.8
11;2021-08-10;1747;1987;241790;202357;64.9;54.3
11;2021-08-11;1717;1689;243507;204046;65.3;54.7
11;2021-08-12;1716;1858;245223;205904;65.8;55.2
11;2021-08-13;1348;1655;246571;207559;66.2;55.7
11;2021-08-14;984;1596;247555;209155;66.4;56.1
11;2021-08-15;138;125;247693;209280;66.5;56.2
11;2021-08-16;731;1914;248424;211194;66.7;56.7
11;2021-08-17;1046;2391;249470;213585;66.9;57.3
11;2021-08-18;1108;2032;250578;215617;67.2;57.9
11;2021-08-19;1006;2291;251584;217908;67.5;58.5
11;2021-08-20;976;2291;252560;220199;67.8;59.1
11;2021-08-21;576;1838;253136;222037;67.9;59.6
11;2021-08-22;192;512;253328;222549;68.0;59.7
11;2021-08-23;522;1817;253850;224366;68.1;60.2
11;2021-08-24;799;2255;254649;226621;68.3;60.8
11;2021-08-25;795;2158;255444;228779;68.5;61.4
11;2021-08-26;759;2001;256203;230780;68.7;61.9
11;2021-08-27;701;2222;256904;233002;68.9;62.5
11;2021-08-28;436;1745;257340;234747;69.0;63.0
11;2021-08-29;143;514;257483;235261;69.1;63.1
11;2021-08-30;455;1347;257938;236608;69.2;63.5
11;2021-08-31;584;1949;258522;238557;69.4;64.0
11;2021-09-01;607;1813;259129;240370;69.5;64.5
11;2021-09-02;555;1701;259684;242071;69.7;64.9
11;2021-09-03;537;1711;260221;243782;69.8;65.4
11;2021-09-04;488;1554;260709;245336;70.0;65.8
11;2021-09-05;153;271;260862;245607;70.0;65.9
11;2021-09-06;299;856;261161;246463;70.1;66.1
11;2021-09-07;355;1122;261516;247585;70.2;66.4
11;2021-09-08;478;1308;261994;248893;70.3;66.8
11;2021-09-09;394;1037;262388;249930;70.4;67.1
11;2021-09-10;381;1137;262769;251067;70.5;67.4
11;2021-09-11;377;1053;263146;252120;70.6;67.6
11;2021-09-12;61;146;263207;252266;70.6;67.7
11;2021-09-13;238;1041;263445;253307;70.7;68.0
11;2021-09-14;349;963;263794;254270;70.8;68.2
11;2021-09-15;360;973;264154;255243;70.9;68.5
11;2021-09-16;301;585;264455;255828;71.0;68.6
11;2021-09-17;313;682;264768;256510;71.0;68.8
11;2021-09-18;267;730;265035;257240;71.1;69.0
11;2021-09-19;59;123;265094;257363;71.1;69.1
11;2021-09-20;166;332;265260;257695;71.2;69.1
11;2021-09-21;288;417;265548;258112;71.2;69.3
11;2021-09-22;227;768;265775;258880;71.3;69.5
11;2021-09-23;179;398;265954;259278;71.4;69.6
11;2021-09-24;275;520;266229;259798;71.4;69.7
11;2021-09-25;235;674;266464;260472;71.5;69.9
11;2021-09-26;35;131;266499;260603;71.5;69.9
11;2021-09-27;105;385;266604;260988;71.5;70.0
11;2021-09-28;212;354;266816;261342;71.6;70.1
11;2021-09-29;221;537;267037;261879;71.6;70.3
11;2021-09-30;194;360;267231;262239;71.7;70.4
11;2021-10-01;226;389;267457;262628;71.8;70.5
11;2021-10-02;232;445;267689;263073;71.8;70.6
11;2021-10-03;2;1;267691;263074;71.8;70.6
11;2021-10-04;137;292;267828;263366;71.9;70.7
11;2021-10-05;177;321;268005;263687;71.9;70.7
11;2021-10-06;260;446;268265;264133;72.0;70.9
12;2020-12-27;0;0;0;0;0.0;0.0
12;2020-12-28;0;0;0;0;0.0;0.0
12;2020-12-29;0;0;0;0;0.0;0.0
12;2020-12-30;0;0;0;0;0.0;0.0
12;2020-12-31;0;0;0;0;0.0;0.0
12;2021-01-01;0;0;0;0;0.0;0.0
12;2021-01-02;0;0;0;0;0.0;0.0
12;2021-01-03;2;0;2;0;0.0;0.0
12;2021-01-04;1;0;3;0;0.0;0.0
12;2021-01-05;1;0;4;0;0.0;0.0
12;2021-01-06;12;0;16;0;0.0;0.0
12;2021-01-07;202;0;218;0;0.1;0.0
12;2021-01-08;65;0;283;0;0.1;0.0
12;2021-01-09;0;0;283;0;0.1;0.0
12;2021-01-10;1;0;284;0;0.1;0.0
12;2021-01-11;101;0;385;0;0.1;0.0
12;2021-01-12;361;0;746;0;0.3;0.0
12;2021-01-13;285;0;1031;0;0.4;0.0
12;2021-01-14;600;12;1631;12;0.6;0.0
12;2021-01-15;367;8;1998;20;0.7;0.0
12;2021-01-16;138;1;2136;21;0.8;0.0
12;2021-01-17;1;0;2137;21;0.8;0.0
12;2021-01-18;452;0;2589;21;0.9;0.0
12;2021-01-19;609;3;3198;24;1.1;0.0
12;2021-01-20;879;3;4077;27;1.5;0.0
12;2021-01-21;736;0;4813;27;1.7;0.0
12;2021-01-22;799;1;5612;28;2.0;0.0
12;2021-01-23;382;0;5994;28;2.2;0.0
12;2021-01-24;0;0;5994;28;2.2;0.0
12;2021-01-25;453;0;6447;28;2.3;0.0
12;2021-01-26;650;0;7097;28;2.5;0.0
12;2021-01-27;1886;38;8983;66;3.2;0.0
12;2021-01-28;1886;225;10869;291;3.9;0.1
12;2021-01-29;1331;41;12200;332;4.4;0.1
12;2021-01-30;359;2;12559;334;4.5;0.1
12;2021-01-31;0;0;12559;334;4.5;0.1
12;2021-02-01;335;85;12894;419;4.6;0.2
12;2021-02-02;459;233;13353;652;4.8;0.2
12;2021-02-03;457;164;13810;816;5.0;0.3
12;2021-02-04;459;510;14269;1326;5.1;0.5
12;2021-02-05;449;170;14718;1496;5.3;0.5
12;2021-02-06;220;42;14938;1538;5.4;0.6
12;2021-02-07;8;0;14946;1538;5.4;0.6
12;2021-02-08;104;281;15050;1819;5.4;0.7
12;2021-02-09;209;293;15259;2112;5.5;0.8
12;2021-02-10;466;394;15725;2506;5.6;0.9
12;2021-02-11;539;293;16264;2799;5.8;1.0
12;2021-02-12;570;265;16834;3064;6.0;1.1
12;2021-02-13;175;110;17009;3174;6.1;1.1
12;2021-02-14;1;0;17010;3174;6.1;1.1
12;2021-02-15;175;295;17185;3469;6.2;1.2
12;2021-02-16;171;424;17356;3893;6.2;1.4
12;2021-02-17;366;1301;17722;5194;6.4;1.9
12;2021-02-18;677;1508;18399;6702;6.6;2.4
12;2021-02-19;594;891;18993;7593;6.8;2.7
12;2021-02-20;103;355;19096;7948;6.9;2.9
12;2021-02-21;0;0;19096;7948;6.9;2.9
12;2021-02-22;150;323;19246;8271;6.9;3.0
12;2021-02-23;157;469;19403;8740;7.0;3.1
12;2021-02-24;156;542;19559;9282;7.0;3.3
12;2021-02-25;201;642;19760;9924;7.1;3.6
12;2021-02-26;320;544;20080;10468;7.2;3.8
12;2021-02-27;190;301;20270;10769;7.3;3.9
12;2021-02-28;13;0;20283;10769;7.3;3.9
12;2021-03-01;51;318;20334;11087;7.3;4.0
12;2021-03-02;190;453;20524;11540;7.4;4.1
12;2021-03-03;244;347;20768;11887;7.5;4.3
12;2021-03-04;278;323;21046;12210;7.6;4.4
12;2021-03-05;421;330;21467;12540;7.7;4.5
12;2021-03-06;793;120;22260;12660;8.0;4.5
12;2021-03-07;140;32;22400;12692;8.0;4.6
12;2021-03-08;233;192;22633;12884;8.1;4.6
12;2021-03-09;716;220;23349;13104;8.4;4.7
12;2021-03-10;785;722;24134;13826;8.7;5.0
12;2021-03-11;919;642;25053;14468;9.0;5.2
12;2021-03-12;1259;511;26312;14979;9.5;5.4
12;2021-03-13;896;134;27208;15113;9.8;5.4
12;2021-03-14;45;2;27253;15115;9.8;5.4
12;2021-03-15;559;154;27812;15269;10.0;5.5
12;2021-03-16;818;159;28630;15428;10.3;5.5
12;2021-03-17;1504;165;30134;15593;10.8;5.6
12;2021-03-18;997;246;31131;15839;11.2;5.7
12;2021-03-19;1383;278;32514;16117;11.7;5.8
12;2021-03-20;725;79;33239;16196;11.9;5.8
12;2021-03-21;264;10;33503;16206;12.0;5.8
12;2021-03-22;606;174;34109;16380;12.3;5.9
12;2021-03-23;1214;176;35323;16556;12.7;5.9
12;2021-03-24;1422;206;36745;16762;13.2;6.0
12;2021-03-25;1843;205;38588;16967;13.9;6.1
12;2021-03-26;1978;231;40566;17198;14.6;6.2
12;2021-03-27;981;68;41547;17266;14.9;6.2
12;2021-03-28;60;1;41607;17267;14.9;6.2
12;2021-03-29;963;85;42570;17352;15.3;6.2
12;2021-03-30;1737;123;44307;17475;15.9;6.3
12;2021-03-31;1460;104;45767;17579;16.4;6.3
12;2021-04-01;1957;166;47724;17745;17.1;6.4
12;2021-04-02;1614;344;49338;18089;17.7;6.5
12;2021-04-03;882;96;50220;18185;18.0;6.5
12;2021-04-04;1;0;50221;18185;18.0;6.5
12;2021-04-05;645;14;50866;18199;18.3;6.5
12;2021-04-06;1151;536;52017;18735;18.7;6.7
12;2021-04-07;1651;637;53668;19372;19.3;7.0
12;2021-04-08;2098;570;55766;19942;20.0;7.2
12;2021-04-09;2112;652;57878;20594;20.8;7.4
12;2021-04-10;1427;219;59305;20813;21.3;7.5
12;2021-04-11;120;1;59425;20814;21.3;7.5
12;2021-04-12;1836;502;61261;21316;22.0;7.7
12;2021-04-13;1907;774;63168;22090;22.7;7.9
12;2021-04-14;1832;1318;65000;23408;23.4;8.4
12;2021-04-15;1937;896;66937;24304;24.0;8.7
12;2021-04-16;1675;1204;68612;25508;24.6;9.2
12;2021-04-17;1553;568;70165;26076;25.2;9.4
12;2021-04-18;0;0;70165;26076;25.2;9.4
12;2021-04-19;1687;549;71852;26625;25.8;9.6
12;2021-04-20;1546;984;73398;27609;26.4;9.9
12;2021-04-21;1693;1183;75091;28792;27.0;10.3
12;2021-04-22;1690;1092;76781;29884;27.6;10.7
12;2021-04-23;1382;1335;78163;31219;28.1;11.2
12;2021-04-24;1450;719;79613;31938;28.6;11.5
12;2021-04-25;60;0;79673;31938;28.6;11.5
12;2021-04-26;1459;898;81132;32836;29.1;11.8
12;2021-04-27;1321;1279;82453;34115;29.6;12.3
12;2021-04-28;1113;1869;83566;35984;30.0;12.9
12;2021-04-29;1571;1910;85137;37894;30.6;13.6
12;2021-04-30;1815;1836;86952;39730;31.2;14.3
12;2021-05-01;1617;261;88569;39991;31.8;14.4
12;2021-05-02;9;0;88578;39991;31.8;14.4
12;2021-05-03;1713;1252;90291;41243;32.4;14.8
12;2021-05-04;1482;1393;91773;42636;33.0;15.3
12;2021-05-05;1296;1673;93069;44309;33.4;15.9
12;2021-05-06;1753;1376;94822;45685;34.1;16.4
12;2021-05-07;1483;1777;96305;47462;34.6;17.1
12;2021-05-08;1330;461;97635;47923;35.1;17.2
12;2021-05-09;13;34;97648;47957;35.1;17.2
12;2021-05-10;829;2215;98477;50172;35.4;18.0
12;2021-05-11;928;1846;99405;52018;35.7;18.7
12;2021-05-12;948;1820;100353;53838;36.1;19.3
12;2021-05-13;1587;811;101940;54649;36.6;19.6
12;2021-05-14;1235;1534;103175;56183;37.1;20.2
12;2021-05-15;1067;1115;104242;57298;37.4;20.6
12;2021-05-16;2;19;104244;57317;37.4;20.6
12;2021-05-17;1082;1810;105326;59127;37.8;21.2
12;2021-05-18;1427;1534;106753;60661;38.4;21.8
12;2021-05-19;1915;1330;108668;61991;39.0;22.3
12;2021-05-20;2119;876;110787;62867;39.8;22.6
12;2021-05-21;1821;1253;112608;64120;40.5;23.0
12;2021-05-22;1207;1016;113815;65136;40.9;23.4
12;2021-05-23;7;12;113822;65148;40.9;23.4
12;2021-05-24;1956;536;115778;65684;41.6;23.6
12;2021-05-25;1742;1157;117520;66841;42.2;24.0
12;2021-05-26;1998;780;119518;67621;42.9;24.3
12;2021-05-27;2165;744;121683;68365;43.7;24.6
12;2021-05-28;1927;1025;123610;69390;44.4;24.9
12;2021-05-29;1637;805;125247;70195;45.0;25.2
12;2021-05-30;9;43;125256;70238;45.0;25.2
12;2021-05-31;1699;810;126955;71048;45.6;25.5
12;2021-06-01;1887;1026;128842;72074;46.3;25.9
12;2021-06-02;1979;1052;130821;73126;47.0;26.3
12;2021-06-03;2123;824;132944;73950;47.8;26.6
12;2021-06-04;1967;1417;134911;75367;48.5;27.1
12;2021-06-05;1738;985;136649;76352;49.1;27.4
12;2021-06-06;6;6;136655;76358;49.1;27.4
12;2021-06-07;1092;1811;137747;78169;49.5;28.1
12;2021-06-08;1332;1201;139079;79370;50.0;28.5
12;2021-06-09;895;1292;139974;80662;50.3;29.0
12;2021-06-10;1022;920;140996;81582;50.7;29.3
12;2021-06-11;1204;2076;142200;83658;51.1;30.1
12;2021-06-12;1033;1320;143233;84978;51.5;30.5
12;2021-06-13;6;47;143239;85025;51.5;30.5
12;2021-06-14;662;1830;143901;86855;51.7;31.2
12;2021-06-15;745;1877;144646;88732;52.0;31.9
12;2021-06-16;820;1818;145466;90550;52.3;32.5
12;2021-06-17;678;995;146144;91545;52.5;32.9
12;2021-06-18;1134;1840;147278;93385;52.9;33.5
12;2021-06-19;914;1406;148192;94791;53.2;34.1
12;2021-06-20;4;10;148196;94801;53.2;34.1
12;2021-06-21;511;1737;148707;96538;53.4;34.7
12;2021-06-22;502;1474;149209;98012;53.6;35.2
12;2021-06-23;579;1306;149788;99318;53.8;35.7
12;2021-06-24;249;541;150037;99859;53.9;35.9
12;2021-06-25;876;1842;150913;101701;54.2;36.5
12;2021-06-26;673;1527;151586;103228;54.5;37.1
12;2021-06-27;1;9;151587;103237;54.5;37.1
12;2021-06-28;467;2453;152054;105690;54.6;38.0
12;2021-06-29;565;1957;152619;107647;54.8;38.7
12;2021-06-30;828;2132;153447;109779;55.1;39.4
12;2021-07-01;345;1086;153792;110865;55.2;39.8
12;2021-07-02;796;2629;154588;113494;55.5;40.8
12;2021-07-03;565;1872;155153;115366;55.7;41.4
12;2021-07-04;1;0;155154;115366;55.7;41.4
12;2021-07-05;440;2406;155594;117772;55.9;42.3
12;2021-07-06;640;2495;156234;120267;56.1;43.2
12;2021-07-07;688;2116;156922;122383;56.4;44.0
12;2021-07-08;295;913;157217;123296;56.5;44.3
12;2021-07-09;724;2587;157941;125883;56.7;45.2
12;2021-07-10;445;2077;158386;127960;56.9;46.0
12;2021-07-11;0;0;158386;127960;56.9;46.0
12;2021-07-12;587;2439;158973;130399;57.1;46.8
12;2021-07-13;840;2592;159813;132991;57.4;47.8
12;2021-07-14;44;25;159857;133016;57.4;47.8
12;2021-07-15;795;2107;160652;135123;57.7;48.5
12;2021-07-16;1247;2556;161899;137679;58.2;49.5
12;2021-07-17;790;2007;162689;139686;58.4;50.2
12;2021-07-18;25;11;162714;139697;58.5;50.2
12;2021-07-19;1319;2005;164033;141702;58.9;50.9
12;2021-07-20;1422;1475;165455;143177;59.4;51.4
12;2021-07-21;1022;941;166477;144118;59.8;51.8
12;2021-07-22;2236;1308;168713;145426;60.6;52.2
12;2021-07-23;1865;2056;170578;147482;61.3;53.0
12;2021-07-24;1604;1566;172182;149048;61.9;53.5
12;2021-07-25;97;28;172279;149076;61.9;53.6
12;2021-07-26;1930;1438;174209;150514;62.6;54.1
12;2021-07-27;2236;1009;176445;151523;63.4;54.4
12;2021-07-28;1715;675;178160;152198;64.0;54.7
12;2021-07-29;1189;807;179349;153005;64.4;55.0
12;2021-07-30;2507;1284;181856;154289;65.3;55.4
12;2021-07-31;1967;1005;183823;155294;66.0;55.8
12;2021-08-01;225;38;184048;155332;66.1;55.8
12;2021-08-02;1815;832;185863;156164;66.8;56.1
12;2021-08-03;1960;776;187823;156940;67.5;56.4
12;2021-08-04;1694;833;189517;157773;68.1;56.7
12;2021-08-05;1636;683;191153;158456;68.7;56.9
12;2021-08-06;1706;1314;192859;159770;69.3;57.4
12;2021-08-07;1448;744;194307;160514;69.8;57.7
12;2021-08-08;0;3;194307;160517;69.8;57.7
12;2021-08-09;1351;1415;195658;161932;70.3;58.2
12;2021-08-10;1343;1247;197001;163179;70.8;58.6
12;2021-08-11;820;1195;197821;164374;71.1;59.1
12;2021-08-12;737;1070;198558;165444;71.3;59.4
12;2021-08-13;1075;1335;199633;166779;71.7;59.9
12;2021-08-14;739;1354;200372;168133;72.0;60.4
12;2021-08-15;255;75;200627;168208;72.1;60.4
12;2021-08-16;670;1817;201297;170025;72.3;61.1
12;2021-08-17;905;1991;202202;172016;72.6;61.8
12;2021-08-18;448;1522;202650;173538;72.8;62.3
12;2021-08-19;641;1115;203291;174653;73.0;62.7
12;2021-08-20;797;1888;204088;176541;73.3;63.4
12;2021-08-21;473;1526;204561;178067;73.5;64.0
12;2021-08-22;93;27;204654;178094;73.5;64.0
12;2021-08-23;453;1921;205107;180015;73.7;64.7
12;2021-08-24;486;1917;205593;181932;73.9;65.4
12;2021-08-25;333;1579;205926;183511;74.0;65.9
12;2021-08-26;487;1607;206413;185118;74.2;66.5
12;2021-08-27;598;1699;207011;186817;74.4;67.1
12;2021-08-28;332;1553;207343;188370;74.5;67.7
12;2021-08-29;176;143;207519;188513;74.6;67.7
12;2021-08-30;562;1908;208081;190421;74.8;68.4
12;2021-08-31;417;1392;208498;191813;74.9;68.9
12;2021-09-01;425;1020;208923;192833;75.1;69.3
12;2021-09-02;266;822;209189;193655;75.2;69.6
12;2021-09-03;490;1378;209679;195033;75.3;70.1
12;2021-09-04;432;1209;210111;196242;75.5;70.5
12;2021-09-05;52;206;210163;196448;75.5;70.6
12;2021-09-06;214;806;210377;197254;75.6;70.9
12;2021-09-07;270;671;210647;197925;75.7;71.1
12;2021-09-08;245;618;210892;198543;75.8;71.3
12;2021-09-09;174;448;211066;198991;75.8;71.5
12;2021-09-10;499;1278;211565;200269;76.0;71.9
12;2021-09-11;386;1087;211951;201356;76.1;72.3
12;2021-09-12;17;120;211968;201476;76.1;72.4
12;2021-09-13;157;625;212125;202101;76.2;72.6
12;2021-09-14;280;513;212405;202614;76.3;72.8
12;2021-09-15;246;407;212651;203021;76.4;72.9
12;2021-09-16;384;411;213035;203432;76.5;73.1
12;2021-09-17;343;505;213378;203937;76.7;73.3
12;2021-09-18;242;688;213620;204625;76.7;73.5
12;2021-09-19;0;4;213620;204629;76.7;73.5
12;2021-09-20;106;432;213726;205061;76.8;73.7
12;2021-09-21;112;220;213838;205281;76.8;73.7
12;2021-09-22;132;578;213970;205859;76.9;74.0
12;2021-09-23;106;161;214076;206020;76.9;74.0
12;2021-09-24;216;535;214292;206555;77.0;74.2
12;2021-09-25;161;667;214453;207222;77.0;74.4
12;2021-09-26;0;1;214453;207223;77.0;74.4
12;2021-09-27;82;242;214535;207465;77.1;74.5
12;2021-09-28;96;252;214631;207717;77.1;74.6
12;2021-09-29;112;325;214743;208042;77.1;74.7
12;2021-09-30;51;123;214794;208165;77.2;74.8
12;2021-10-01;161;404;214955;208569;77.2;74.9
12;2021-10-02;182;477;215137;209046;77.3;75.1
12;2021-10-03;0;2;215137;209048;77.3;75.1
12;2021-10-04;83;168;215220;209216;77.3;75.2
12;2021-10-05;67;191;215287;209407;77.3;75.2
12;2021-10-06;116;265;215403;209672;77.4;75.3
13;2020-12-27;5;0;5;0;0.0;0.0
13;2020-12-28;6;0;11;0;0.0;0.0
13;2020-12-29;1;0;12;0;0.0;0.0
13;2020-12-30;3;0;15;0;0.0;0.0
13;2020-12-31;6;0;21;0;0.0;0.0
13;2021-01-01;4;0;25;0;0.0;0.0
13;2021-01-02;4;0;29;0;0.0;0.0
13;2021-01-03;11;0;40;0;0.0;0.0
13;2021-01-04;1;0;41;0;0.0;0.0
13;2021-01-05;80;1;121;1;0.0;0.0
13;2021-01-06;122;0;243;1;0.0;0.0
13;2021-01-07;174;1;417;2;0.0;0.0
13;2021-01-08;189;0;606;2;0.0;0.0
13;2021-01-09;13;0;619;2;0.0;0.0
13;2021-01-10;3;0;622;2;0.0;0.0
13;2021-01-11;482;1;1104;3;0.1;0.0
13;2021-01-12;813;2;1917;5;0.1;0.0
13;2021-01-13;1087;1;3004;6;0.1;0.0
13;2021-01-14;1588;16;4592;22;0.2;0.0
13;2021-01-15;1538;7;6130;29;0.3;0.0
13;2021-01-16;406;3;6536;32;0.3;0.0
13;2021-01-17;44;0;6580;32;0.3;0.0
13;2021-01-18;2388;9;8968;41;0.4;0.0
13;2021-01-19;7419;33;16387;74;0.8;0.0
13;2021-01-20;5584;18;21971;92;1.1;0.0
13;2021-01-21;5362;29;27333;121;1.3;0.0
13;2021-01-22;4006;22;31339;143;1.5;0.0
13;2021-01-23;1359;6;32698;149;1.6;0.0
13;2021-01-24;491;5;33189;154;1.6;0.0
13;2021-01-25;2340;27;35529;181;1.7;0.0
13;2021-01-26;2951;84;38480;265;1.9;0.0
13;2021-01-27;3122;119;41602;384;2.0;0.0
13;2021-01-28;3250;175;44852;559;2.2;0.0
13;2021-01-29;2513;122;47365;681;2.3;0.0
13;2021-01-30;1025;11;48390;692;2.4;0.0
13;2021-01-31;252;0;48642;692;2.4;0.0
13;2021-02-01;1864;260;50506;952;2.5;0.0
13;2021-02-02;2258;569;52764;1521;2.6;0.1
13;2021-02-03;1869;538;54633;2059;2.7;0.1
13;2021-02-04;1907;880;56540;2939;2.8;0.1
13;2021-02-05;2629;1457;59169;4396;2.9;0.2
13;2021-02-06;857;272;60026;4668;3.0;0.2
13;2021-02-07;278;5;60304;4673;3.0;0.2
13;2021-02-08;1907;1396;62211;6069;3.1;0.3
13;2021-02-09;3319;3962;65530;10031;3.2;0.5
13;2021-02-10;3247;3170;68777;13201;3.4;0.6
13;2021-02-11;3584;3188;72361;16389;3.6;0.8
13;2021-02-12;2839;2725;75200;19114;3.7;0.9
13;2021-02-13;734;524;75934;19638;3.7;1.0
13;2021-02-14;73;324;76007;19962;3.7;1.0
13;2021-02-15;971;1764;76978;21726;3.8;1.1
13;2021-02-16;1396;2302;78374;24028;3.9;1.2
13;2021-02-17;1350;2598;79724;26626;3.9;1.3
13;2021-02-18;1904;2338;81628;28964;4.0;1.4
13;2021-02-19;1514;1917;83142;30881;4.1;1.5
13;2021-02-20;458;648;83600;31529;4.1;1.5
13;2021-02-21;33;238;83633;31767;4.1;1.6
13;2021-02-22;1023;1921;84656;33688;4.2;1.7
13;2021-02-23;1289;2234;85945;35922;4.2;1.8
13;2021-02-24;1519;2263;87464;38185;4.3;1.9
13;2021-02-25;2384;1836;89848;40021;4.4;2.0
13;2021-02-26;2458;1864;92306;41885;4.5;2.1
13;2021-02-27;983;658;93289;42543;4.6;2.1
13;2021-02-28;195;186;93484;42729;4.6;2.1
13;2021-03-01;1927;1356;95411;44085;4.7;2.2
13;2021-03-02;3012;2323;98423;46408;4.8;2.3
13;2021-03-03;3490;2364;101913;48772;5.0;2.4
13;2021-03-04;4208;2846;106121;51618;5.2;2.5
13;2021-03-05;4043;2549;110164;54167;5.4;2.7
13;2021-03-06;5304;748;115468;54915;5.7;2.7
13;2021-03-07;4295;363;119763;55278;5.9;2.7
13;2021-03-08;3930;1794;123693;57072;6.1;2.8
13;2021-03-09;5082;2073;128775;59145;6.3;2.9
13;2021-03-10;5180;1869;133955;61014;6.6;3.0
13;2021-03-11;7308;2024;141263;63038;6.9;3.1
13;2021-03-12;8334;2003;149597;65041;7.4;3.2
13;2021-03-13;6380;705;155977;65746;7.7;3.2
13;2021-03-14;2313;162;158290;65908;7.8;3.2
13;2021-03-15;6358;1290;164648;67198;8.1;3.3
13;2021-03-16;5078;1493;169726;68691;8.3;3.4
13;2021-03-17;5174;1404;174900;70095;8.6;3.4
13;2021-03-18;5816;1829;180716;71924;8.9;3.5
13;2021-03-19;6811;1599;187527;73523;9.2;3.6
13;2021-03-20;4045;690;191572;74213;9.4;3.6
13;2021-03-21;726;84;192298;74297;9.5;3.7
13;2021-03-22;7297;1535;199595;75832;9.8;3.7
13;2021-03-23;9132;1741;208727;77573;10.3;3.8
13;2021-03-24;8867;2174;217594;79747;10.7;3.9
13;2021-03-25;10917;2099;228511;81846;11.2;4.0
13;2021-03-26;10718;1902;239229;83748;11.8;4.1
13;2021-03-27;4869;824;244098;84572;12.0;4.2
13;2021-03-28;1120;81;245218;84653;12.1;4.2
13;2021-03-29;7579;1985;252797;86638;12.4;4.3
13;2021-03-30;12617;2509;265414;89147;13.0;4.4
13;2021-03-31;10812;3157;276226;92304;13.6;4.5
13;2021-04-01;12276;3081;288502;95385;14.2;4.7
13;2021-04-02;9791;3887;298293;99272;14.7;4.9
13;2021-04-03;4006;2802;302299;102074;14.9;5.0
13;2021-04-04;630;306;302929;102380;14.9;5.0
13;2021-04-05;3537;729;306466;103109;15.1;5.1
13;2021-04-06;8520;4243;314986;107352;15.5;5.3
13;2021-04-07;10079;4681;325065;112033;16.0;5.5
13;2021-04-08;10118;5456;335183;117489;16.5;5.8
13;2021-04-09;11281;5111;346464;122600;17.0;6.0
13;2021-04-10;7300;2096;353764;124696;17.4;6.1
13;2021-04-11;1380;534;355144;125230;17.5;6.2
13;2021-04-12;7984;4789;363128;130019;17.8;6.4
13;2021-04-13;9146;5487;372274;135506;18.3;6.7
13;2021-04-14;9535;5816;381809;141322;18.8;6.9
13;2021-04-15;9880;5951;391689;147273;19.3;7.2
13;2021-04-16;9968;5564;401657;152837;19.7;7.5
13;2021-04-17;4079;2022;405736;154859;19.9;7.6
13;2021-04-18;2527;1425;408263;156284;20.1;7.7
13;2021-04-19;6457;6398;414720;162682;20.4;8.0
13;2021-04-20;7402;7585;422122;170267;20.7;8.4
13;2021-04-21;7772;7378;429894;177645;21.1;8.7
13;2021-04-22;8461;7912;438355;185557;21.5;9.1
13;2021-04-23;8395;6829;446750;192386;22.0;9.5
13;2021-04-24;4625;3811;451375;196197;22.2;9.6
13;2021-04-25;877;521;452252;196718;22.2;9.7
13;2021-04-26;6167;7109;458419;203827;22.5;10.0
13;2021-04-27;7264;8021;465683;211848;22.9;10.4
13;2021-04-28;9452;7706;475135;219554;23.4;10.8
13;2021-04-29;11408;7592;486543;227146;23.9;11.2
13;2021-04-30;10918;7362;497461;234508;24.5;11.5
13;2021-05-01;5365;3795;502826;238303;24.7;11.7
13;2021-05-02;2100;747;504926;239050;24.8;11.7
13;2021-05-03;7297;7865;512223;246915;25.2;12.1
13;2021-05-04;8456;8505;520679;255420;25.6;12.6
13;2021-05-05;8226;8966;528905;264386;26.0;13.0
13;2021-05-06;10143;8582;539048;272968;26.5;13.4
13;2021-05-07;8852;10022;547900;282990;26.9;13.9
13;2021-05-08;4569;3936;552469;286926;27.2;14.1
13;2021-05-09;939;687;553408;287613;27.2;14.1
13;2021-05-10;7709;8752;561117;296365;27.6;14.6
13;2021-05-11;10978;9555;572095;305920;28.1;15.0
13;2021-05-12;12841;8727;584936;314647;28.8;15.5
13;2021-05-13;9508;3637;594444;318284;29.2;15.6
13;2021-05-14;13656;6446;608100;324730;29.9;16.0
13;2021-05-15;10196;4536;618296;329266;30.4;16.2
13;2021-05-16;3127;791;621423;330057;30.5;16.2
13;2021-05-17;10844;6800;632267;336857;31.1;16.6
13;2021-05-18;11919;6480;644186;343337;31.7;16.9
13;2021-05-19;12157;6358;656343;349695;32.3;17.2
13;2021-05-20;13443;6468;669786;356163;32.9;17.5
13;2021-05-21;12990;6782;682776;362945;33.6;17.8
13;2021-05-22;7514;3635;690290;366580;33.9;18.0
13;2021-05-23;862;637;691152;367217;34.0;18.0
13;2021-05-24;6761;2469;697913;369686;34.3;18.2
13;2021-05-25;9270;7594;707183;377280;34.8;18.5
13;2021-05-26;10142;7837;717325;385117;35.3;18.9
13;2021-05-27;10337;8421;727662;393538;35.8;19.3
13;2021-05-28;9005;9162;736667;402700;36.2;19.8
13;2021-05-29;7173;4621;743840;407321;36.6;20.0
13;2021-05-30;891;527;744731;407848;36.6;20.0
13;2021-05-31;8184;8022;752915;415870;37.0;20.4
13;2021-06-01;9578;9284;762493;425154;37.5;20.9
13;2021-06-02;10082;8777;772575;433931;38.0;21.3
13;2021-06-03;12295;9488;784870;443419;38.6;21.8
13;2021-06-04;12025;10030;796895;453449;39.2;22.3
13;2021-06-05;7821;5595;804716;459044;39.6;22.6
13;2021-06-06;1671;886;806387;459930;39.6;22.6
13;2021-06-07;6686;9875;813073;469805;40.0;23.1
13;2021-06-08;8317;9984;821390;479789;40.4;23.6
13;2021-06-09;8397;9732;829787;489521;40.8;24.1
13;2021-06-10;8953;9774;838740;499295;41.2;24.5
13;2021-06-11;8230;12710;846970;512005;41.6;25.2
13;2021-06-12;5778;6705;852748;518710;41.9;25.5
13;2021-06-13;950;1216;853698;519926;42.0;25.6
13;2021-06-14;5994;11141;859692;531067;42.3;26.1
13;2021-06-15;7284;11402;866976;542469;42.6;26.7
13;2021-06-16;7340;9867;874316;552336;43.0;27.1
13;2021-06-17;7443;10710;881759;563046;43.3;27.7
13;2021-06-18;7549;11072;889308;574118;43.7;28.2
13;2021-06-19;4616;7496;893924;581614;43.9;28.6
13;2021-06-20;1276;1045;895200;582659;44.0;28.6
13;2021-06-21;4462;12259;899662;594918;44.2;29.2
13;2021-06-22;4941;13876;904603;608794;44.5;29.9
13;2021-06-23;5148;13579;909751;622373;44.7;30.6
13;2021-06-24;5341;12852;915092;635225;45.0;31.2
13;2021-06-25;5242;14680;920334;649905;45.2;31.9
13;2021-06-26;3016;9681;923350;659586;45.4;32.4
13;2021-06-27;537;931;923887;660517;45.4;32.5
13;2021-06-28;3732;12562;927619;673079;45.6;33.1
13;2021-06-29;4500;12900;932119;685979;45.8;33.7
13;2021-06-30;4904;12695;937023;698674;46.1;34.3
13;2021-07-01;5580;11494;942603;710168;46.3;34.9
13;2021-07-02;5570;12393;948173;722561;46.6;35.5
13;2021-07-03;3503;9161;951676;731722;46.8;36.0
13;2021-07-04;476;867;952152;732589;46.8;36.0
13;2021-07-05;3872;11769;956024;744358;47.0;36.6
13;2021-07-06;5461;11676;961485;756034;47.3;37.2
13;2021-07-07;5821;10706;967306;766740;47.5;37.7
13;2021-07-08;6231;10327;973537;777067;47.9;38.2
13;2021-07-09;5932;11934;979469;789001;48.1;38.8
13;2021-07-10;3163;8637;982632;797638;48.3;39.2
13;2021-07-11;435;1012;983067;798650;48.3;39.3
13;2021-07-12;4493;10944;987560;809594;48.5;39.8
13;2021-07-13;8981;13183;996541;822777;49.0;40.4
13;2021-07-14;5610;4862;1002151;827639;49.3;40.7
13;2021-07-15;11438;12945;1013589;840584;49.8;41.3
13;2021-07-16;12195;12928;1025784;853512;50.4;42.0
13;2021-07-17;6584;8492;1032368;862004;50.7;42.4
13;2021-07-18;727;1062;1033095;863066;50.8;42.4
13;2021-07-19;9809;11147;1042904;874213;51.3;43.0
13;2021-07-20;12272;11662;1055176;885875;51.9;43.5
13;2021-07-21;12689;10359;1067865;896234;52.5;44.1
13;2021-07-22;14558;10464;1082423;906698;53.2;44.6
13;2021-07-23;14486;10970;1096909;917668;53.9;45.1
13;2021-07-24;8343;7978;1105252;925646;54.3;45.5
13;2021-07-25;1017;784;1106269;926430;54.4;45.5
13;2021-07-26;11648;9116;1117917;935546;54.9;46.0
13;2021-07-27;13610;9421;1131527;944967;55.6;46.4
13;2021-07-28;12340;8187;1143867;953154;56.2;46.9
13;2021-07-29;13765;8093;1157632;961247;56.9;47.2
13;2021-07-30;13716;8638;1171348;969885;57.6;47.7
13;2021-07-31;8678;5833;1180026;975718;58.0;48.0
13;2021-08-01;1107;729;1181133;976447;58.1;48.0
13;2021-08-02;10053;6728;1191186;983175;58.6;48.3
13;2021-08-03;11073;7299;1202259;990474;59.1;48.7
13;2021-08-04;9426;6571;1211685;997045;59.6;49.0
13;2021-08-05;9523;7583;1221208;1004628;60.0;49.4
13;2021-08-06;9194;9002;1230402;1013630;60.5;49.8
13;2021-08-07;5441;5586;1235843;1019216;60.7;50.1
13;2021-08-08;905;805;1236748;1020021;60.8;50.1
13;2021-08-09;8398;9079;1245146;1029100;61.2;50.6
13;2021-08-10;9149;8912;1254295;1038012;61.7;51.0
13;2021-08-11;7909;8545;1262204;1046557;62.0;51.4
13;2021-08-12;7791;9673;1269995;1056230;62.4;51.9
13;2021-08-13;6958;9189;1276953;1065419;62.8;52.4
13;2021-08-14;3692;6456;1280645;1071875;62.9;52.7
13;2021-08-15;485;731;1281130;1072606;63.0;52.7
13;2021-08-16;6579;11080;1287709;1083686;63.3;53.3
13;2021-08-17;6672;10616;1294381;1094302;63.6;53.8
13;2021-08-18;6338;10178;1300719;1104480;63.9;54.3
13;2021-08-19;6669;10618;1307388;1115098;64.3;54.8
13;2021-08-20;5828;11236;1313216;1126334;64.5;55.4
13;2021-08-21;2617;7568;1315833;1133902;64.7;55.7
13;2021-08-22;369;1090;1316202;1134992;64.7;55.8
13;2021-08-23;4972;11221;1321174;1146213;64.9;56.3
13;2021-08-24;5443;10915;1326617;1157128;65.2;56.9
13;2021-08-25;5212;10097;1331829;1167225;65.5;57.4
13;2021-08-26;5118;9782;1336947;1177007;65.7;57.9
13;2021-08-27;5086;10635;1342033;1187642;66.0;58.4
13;2021-08-28;2360;6460;1344393;1194102;66.1;58.7
13;2021-08-29;338;1139;1344731;1195241;66.1;58.7
13;2021-08-30;4243;9860;1348974;1205101;66.3;59.2
13;2021-08-31;4870;10118;1353844;1215219;66.5;59.7
13;2021-09-01;4596;8597;1358440;1223816;66.8;60.2
13;2021-09-02;4632;8478;1363072;1232294;67.0;60.6
13;2021-09-03;4269;9294;1367341;1241588;67.2;61.0
13;2021-09-04;2171;5563;1369512;1247151;67.3;61.3
13;2021-09-05;185;393;1369697;1247544;67.3;61.3
13;2021-09-06;3102;6714;1372799;1254258;67.5;61.7
13;2021-09-07;3218;7282;1376017;1261540;67.6;62.0
13;2021-09-08;3508;7165;1379525;1268705;67.8;62.4
13;2021-09-09;3162;6709;1382687;1275414;68.0;62.7
13;2021-09-10;3663;7762;1386350;1283176;68.1;63.1
13;2021-09-11;2291;5475;1388641;1288651;68.3;63.3
13;2021-09-12;227;334;1388868;1288985;68.3;63.4
13;2021-09-13;2494;5228;1391362;1294213;68.4;63.6
13;2021-09-14;3192;6344;1394554;1300557;68.5;63.9
13;2021-09-15;2879;5515;1397433;1306072;68.7;64.2
13;2021-09-16;2209;3900;1399642;1309972;68.8;64.4
13;2021-09-17;2315;4874;1401957;1314846;68.9;64.6
13;2021-09-18;1523;4245;1403480;1319091;69.0;64.8
13;2021-09-19;123;176;1403603;1319267;69.0;64.8
13;2021-09-20;1532;3306;1405135;1322573;69.1;65.0
13;2021-09-21;1471;2923;1406606;1325496;69.1;65.2
13;2021-09-22;1682;4541;1408288;1330037;69.2;65.4
13;2021-09-23;1644;3534;1409932;1333571;69.3;65.5
13;2021-09-24;1618;4271;1411550;1337842;69.4;65.8
13;2021-09-25;1223;3965;1412773;1341807;69.4;66.0
13;2021-09-26;87;258;1412860;1342065;69.4;66.0
13;2021-09-27;1247;3152;1414107;1345217;69.5;66.1
13;2021-09-28;1326;2637;1415433;1347854;69.6;66.3
13;2021-09-29;1601;3551;1417034;1351405;69.7;66.4
13;2021-09-30;1349;3193;1418383;1354598;69.7;66.6
13;2021-10-01;1549;3557;1419932;1358155;69.8;66.8
13;2021-10-02;1172;2809;1421104;1360964;69.9;66.9
13;2021-10-03;97;416;1421201;1361380;69.9;66.9
13;2021-10-04;606;1580;1421807;1362960;69.9;67.0
13;2021-10-05;1109;2451;1422916;1365411;69.9;67.1
13;2021-10-06;1218;3123;1424134;1368534;70.0;67.3
14;2020-12-27;0;0;0;0;0.0;0.0
14;2020-12-28;1;1;1;1;0.0;0.0
14;2020-12-29;1;0;2;1;0.0;0.0
14;2020-12-30;0;0;2;1;0.0;0.0
14;2020-12-31;3;0;5;1;0.0;0.0
14;2021-01-01;2;0;7;1;0.0;0.0
14;2021-01-02;1;0;8;1;0.0;0.0
14;2021-01-03;0;0;8;1;0.0;0.0
14;2021-01-04;10;0;18;1;0.0;0.0
14;2021-01-05;24;0;42;1;0.0;0.0
14;2021-01-06;352;0;394;1;0.1;0.0
14;2021-01-07;402;2;796;3;0.1;0.0
14;2021-01-08;631;2;1427;5;0.2;0.0
14;2021-01-09;127;0;1554;5;0.2;0.0
14;2021-01-10;41;0;1595;5;0.2;0.0
14;2021-01-11;674;1;2269;6;0.3;0.0
14;2021-01-12;954;2;3223;8;0.5;0.0
14;2021-01-13;850;1;4073;9;0.6;0.0
14;2021-01-14;2840;14;6913;23;1.0;0.0
14;2021-01-15;1898;17;8811;40;1.3;0.0
14;2021-01-16;271;3;9082;43;1.3;0.0
14;2021-01-17;145;7;9227;50;1.3;0.0
14;2021-01-18;1086;5;10313;55;1.5;0.0
14;2021-01-19;1154;2;11467;57;1.7;0.0
14;2021-01-20;1987;2;13454;59;1.9;0.0
14;2021-01-21;1817;6;15271;65;2.2;0.0
14;2021-01-22;1494;5;16765;70;2.4;0.0
14;2021-01-23;297;1;17062;71;2.5;0.0
14;2021-01-24;73;1;17135;72;2.5;0.0
14;2021-01-25;911;10;18046;82;2.6;0.0
14;2021-01-26;848;35;18894;117;2.7;0.0
14;2021-01-27;884;156;19778;273;2.9;0.0
14;2021-01-28;782;103;20560;376;3.0;0.1
14;2021-01-29;786;220;21346;596;3.1;0.1
14;2021-01-30;270;11;21616;607;3.1;0.1
14;2021-01-31;58;1;21674;608;3.1;0.1
14;2021-02-01;729;219;22403;827;3.2;0.1
14;2021-02-02;830;412;23233;1239;3.4;0.2
14;2021-02-03;761;369;23994;1608;3.5;0.2
14;2021-02-04;1170;1850;25164;3458;3.6;0.5
14;2021-02-05;1296;1271;26460;4729;3.8;0.7
14;2021-02-06;398;210;26858;4939;3.9;0.7
14;2021-02-07;180;58;27038;4997;3.9;0.7
14;2021-02-08;773;677;27811;5674;4.0;0.8
14;2021-02-09;723;851;28534;6525;4.1;0.9
14;2021-02-10;825;1411;29359;7936;4.2;1.1
14;2021-02-11;1351;1339;30710;9275;4.4;1.3
14;2021-02-12;1383;961;32093;10236;4.6;1.5
14;2021-02-13;308;152;32401;10388;4.7;1.5
14;2021-02-14;84;44;32485;10432;4.7;1.5
14;2021-02-15;443;869;32928;11301;4.8;1.6
14;2021-02-16;679;708;33607;12009;4.9;1.7
14;2021-02-17;405;758;34012;12767;4.9;1.8
14;2021-02-18;707;688;34719;13455;5.0;1.9
14;2021-02-19;733;599;35452;14054;5.1;2.0
14;2021-02-20;91;209;35543;14263;5.1;2.1
14;2021-02-21;6;79;35549;14342;5.1;2.1
14;2021-02-22;432;798;35981;15140;5.2;2.2
14;2021-02-23;487;695;36468;15835;5.3;2.3
14;2021-02-24;441;689;36909;16524;5.3;2.4
14;2021-02-25;1224;978;38133;17502;5.5;2.5
14;2021-02-26;1576;1014;39709;18516;5.7;2.7
14;2021-02-27;507;226;40216;18742;5.8;2.7
14;2021-02-28;27;32;40243;18774;5.8;2.7
14;2021-03-01;522;750;40765;19524;5.9;2.8
14;2021-03-02;966;665;41731;20189;6.0;2.9
14;2021-03-03;1080;721;42811;20910;6.2;3.0
14;2021-03-04;1950;723;44761;21633;6.5;3.1
14;2021-03-05;2433;782;47194;22415;6.8;3.2
14;2021-03-06;3078;176;50272;22591;7.3;3.3
14;2021-03-07;1196;59;51468;22650;7.4;3.3
14;2021-03-08;1253;710;52721;23360;7.6;3.4
14;2021-03-09;1742;645;54463;24005;7.9;3.5
14;2021-03-10;1835;533;56298;24538;8.1;3.5
14;2021-03-11;2759;433;59057;24971;8.5;3.6
14;2021-03-12;4047;540;63104;25511;9.1;3.7
14;2021-03-13;1852;169;64956;25680;9.4;3.7
14;2021-03-14;31;38;64987;25718;9.4;3.7
14;2021-03-15;2006;142;66993;25860;9.7;3.7
14;2021-03-16;1401;265;68394;26125;9.9;3.8
14;2021-03-17;1155;194;69549;26319;10.1;3.8
14;2021-03-18;1481;295;71030;26614;10.3;3.8
14;2021-03-19;2608;260;73638;26874;10.6;3.9
14;2021-03-20;2658;41;76296;26915;11.0;3.9
14;2021-03-21;454;8;76750;26923;11.1;3.9
14;2021-03-22;1872;360;78622;27283;11.4;3.9
14;2021-03-23;2179;320;80801;27603;11.7;4.0
14;2021-03-24;2432;191;83233;27794;12.0;4.0
14;2021-03-25;3292;317;86525;28111;12.5;4.1
14;2021-03-26;4609;475;91134;28586;13.2;4.1
14;2021-03-27;2230;225;93364;28811;13.5;4.2
14;2021-03-28;36;1;93400;28812;13.5;4.2
14;2021-03-29;1614;478;95014;29290;13.7;4.2
14;2021-03-30;2722;515;97736;29805;14.1;4.3
14;2021-03-31;2326;922;100062;30727;14.5;4.4
14;2021-04-01;4175;1681;104237;32408;15.1;4.7
14;2021-04-02;3867;1266;108104;33674;15.6;4.9
14;2021-04-03;1126;1199;109230;34873;15.8;5.0
14;2021-04-04;25;482;109255;35355;15.8;5.1
14;2021-04-05;1218;324;110473;35679;16.0;5.2
14;2021-04-06;2383;996;112856;36675;16.3;5.3
14;2021-04-07;2730;1032;115586;37707;16.7;5.5
14;2021-04-08;4303;1118;119889;38825;17.3;5.6
14;2021-04-09;6030;1184;125919;40009;18.2;5.8
14;2021-04-10;2896;440;128815;40449;18.6;5.8
14;2021-04-11;629;121;129444;40570;18.7;5.9
14;2021-04-12;2915;1583;132359;42153;19.1;6.1
14;2021-04-13;3471;1442;135830;43595;19.6;6.3
14;2021-04-14;3123;1166;138953;44761;20.1;6.5
14;2021-04-15;4398;1506;143351;46267;20.7;6.7
14;2021-04-16;4598;1567;147949;47834;21.4;6.9
14;2021-04-17;2311;1667;150260;49501;21.7;7.2
14;2021-04-18;539;327;150799;49828;21.8;7.2
14;2021-04-19;2759;1684;153558;51512;22.2;7.4
14;2021-04-20;3389;1816;156947;53328;22.7;7.7
14;2021-04-21;3015;1468;159962;54796;23.1;7.9
14;2021-04-22;4230;2088;164192;56884;23.7;8.2
14;2021-04-23;4651;2302;168843;59186;24.4;8.6
14;2021-04-24;1851;1747;170694;60933;24.7;8.8
14;2021-04-25;456;29;171150;60962;24.8;8.8
14;2021-04-26;3379;1564;174529;62526;25.2;9.0
14;2021-04-27;3503;2561;178032;65087;25.7;9.4
14;2021-04-28;3245;1897;181277;66984;26.2;9.7
14;2021-04-29;4544;2306;185821;69290;26.9;10.0
14;2021-04-30;5124;2630;190945;71920;27.6;10.4
14;2021-05-01;3554;201;194499;72121;28.1;10.4
14;2021-05-02;1238;55;195737;72176;28.3;10.4
14;2021-05-03;2482;2763;198219;74939;28.7;10.8
14;2021-05-04;3128;2892;201347;77831;29.1;11.3
14;2021-05-05;3687;2742;205034;80573;29.7;11.7
14;2021-05-06;4929;3474;209963;84047;30.4;12.2
14;2021-05-07;4868;3835;214831;87882;31.1;12.7
14;2021-05-08;2728;1263;217559;89145;31.5;12.9
14;2021-05-09;1914;671;219473;89816;31.7;13.0
14;2021-05-10;3637;3145;223110;92961;32.3;13.4
14;2021-05-11;4346;3599;227456;96560;32.9;14.0
14;2021-05-12;4053;3215;231509;99775;33.5;14.4
14;2021-05-13;4688;1131;236197;100906;34.2;14.6
14;2021-05-14;6674;2626;242871;103532;35.1;15.0
14;2021-05-15;5148;778;248019;104310;35.9;15.1
14;2021-05-16;2319;120;250338;104430;36.2;15.1
14;2021-05-17;2820;2257;253158;106687;36.6;15.4
14;2021-05-18;4089;2236;257247;108923;37.2;15.8
14;2021-05-19;3752;2023;260999;110946;37.7;16.0
14;2021-05-20;4482;2763;265481;113709;38.4;16.4
14;2021-05-21;4276;3522;269757;117231;39.0;17.0
14;2021-05-22;1669;863;271426;118094;39.3;17.1
14;2021-05-23;649;71;272075;118165;39.3;17.1
14;2021-05-24;2845;751;274920;118916;39.8;17.2
14;2021-05-25;3635;3382;278555;122298;40.3;17.7
14;2021-05-26;3438;2406;281993;124704;40.8;18.0
14;2021-05-27;4771;3233;286764;127937;41.5;18.5
14;2021-05-28;5090;3864;291854;131801;42.2;19.1
14;2021-05-29;2342;2454;294196;134255;42.5;19.4
14;2021-05-30;759;237;294955;134492;42.7;19.5
14;2021-05-31;4091;2964;299046;137456;43.2;19.9
14;2021-06-01;5738;3202;304784;140658;44.1;20.3
14;2021-06-02;5024;2861;309808;143519;44.8;20.8
14;2021-06-03;6658;4017;316466;147536;45.8;21.3
14;2021-06-04;6445;5133;322911;152669;46.7;22.1
14;2021-06-05;4359;1860;327270;154529;47.3;22.3
14;2021-06-06;2043;83;329313;154612;47.6;22.4
14;2021-06-07;4253;3447;333566;158059;48.2;22.9
14;2021-06-08;5234;3128;338800;161187;49.0;23.3
14;2021-06-09;4270;2964;343070;164151;49.6;23.7
14;2021-06-10;5080;2968;348150;167119;50.4;24.2
14;2021-06-11;4840;4875;352990;171994;51.1;24.9
14;2021-06-12;3677;4520;356667;176514;51.6;25.5
14;2021-06-13;848;1089;357515;177603;51.7;25.7
14;2021-06-14;2185;3790;359700;181393;52.0;26.2
14;2021-06-15;3314;3970;363014;185363;52.5;26.8
14;2021-06-16;3446;4554;366460;189917;53.0;27.5
14;2021-06-17;4230;5264;370690;195181;53.6;28.2
14;2021-06-18;3732;6119;374422;201300;54.2;29.1
14;2021-06-19;2591;2951;377013;204251;54.5;29.5
14;2021-06-20;581;1556;377594;205807;54.6;29.8
14;2021-06-21;2121;4355;379715;210162;54.9;30.4
14;2021-06-22;2582;5179;382297;215341;55.3;31.1
14;2021-06-23;2503;4348;384800;219689;55.7;31.8
14;2021-06-24;3450;5810;388250;225499;56.1;32.6
14;2021-06-25;2752;7272;391002;232771;56.5;33.7
14;2021-06-26;2176;4539;393178;237310;56.9;34.3
14;2021-06-27;440;1828;393618;239138;56.9;34.6
14;2021-06-28;1311;3963;394929;243101;57.1;35.2
14;2021-06-29;1789;5362;396718;248463;57.4;35.9
14;2021-06-30;2024;4618;398742;253081;57.7;36.6
14;2021-07-01;2931;5068;401673;258149;58.1;37.3
14;2021-07-02;2600;6666;404273;264815;58.5;38.3
14;2021-07-03;1430;2646;405703;267461;58.7;38.7
14;2021-07-04;422;713;406125;268174;58.7;38.8
14;2021-07-05;1191;4777;407316;272951;58.9;39.5
14;2021-07-06;2090;6000;409406;278951;59.2;40.3
14;2021-07-07;2256;4577;411662;283528;59.5;41.0
14;2021-07-08;2912;5525;414574;289053;60.0;41.8
14;2021-07-09;2771;6431;417345;295484;60.4;42.7
14;2021-07-10;2038;3203;419383;298687;60.7;43.2
14;2021-07-11;900;871;420283;299558;60.8;43.3
14;2021-07-12;1634;5903;421917;305461;61.0;44.2
14;2021-07-13;3081;7338;424998;312799;61.5;45.2
14;2021-07-14;2260;3064;427258;315863;61.8;45.7
14;2021-07-15;4172;7653;431430;323516;62.4;46.8
14;2021-07-16;4708;7695;436138;331211;63.1;47.9
14;2021-07-17;2114;4211;438252;335422;63.4;48.5
14;2021-07-18;821;1870;439073;337292;63.5;48.8
14;2021-07-19;2599;6123;441672;343415;63.9;49.7
14;2021-07-20;3247;7253;444919;350668;64.3;50.7
14;2021-07-21;4105;5842;449024;356510;64.9;51.6
14;2021-07-22;4852;6602;453876;363112;65.6;52.5
14;2021-07-23;5384;6769;459260;369881;66.4;53.5
14;2021-07-24;3084;3790;462344;373671;66.9;54.0
14;2021-07-25;1504;1249;463848;374920;67.1;54.2
14;2021-07-26;4682;4186;468530;379106;67.8;54.8
14;2021-07-27;5404;4359;473934;383465;68.5;55.5
14;2021-07-28;5117;3973;479051;387438;69.3;56.0
14;2021-07-29;6446;4884;485497;392322;70.2;56.7
14;2021-07-30;5841;5169;491338;397491;71.1;57.5
14;2021-07-31;2774;2509;494112;400000;71.5;57.8
14;2021-08-01;1895;934;496007;400934;71.7;58.0
14;2021-08-02;3947;4290;499954;405224;72.3;58.6
14;2021-08-03;4482;4173;504436;409397;73.0;59.2
14;2021-08-04;4650;3537;509086;412934;73.6;59.7
14;2021-08-05;4658;4039;513744;416973;74.3;60.3
14;2021-08-06;4432;4808;518176;421781;74.9;61.0
14;2021-08-07;2133;2294;520309;424075;75.2;61.3
14;2021-08-08;638;854;520947;424929;75.3;61.5
14;2021-08-09;2129;2877;523076;427806;75.6;61.9
14;2021-08-10;3661;4171;526737;431977;76.2;62.5
14;2021-08-11;3076;3450;529813;435427;76.6;63.0
14;2021-08-12;3481;4351;533294;439778;77.1;63.6
14;2021-08-13;2638;4139;535932;443917;77.5;64.2
14;2021-08-14;1423;2009;537355;445926;77.7;64.5
14;2021-08-15;389;1484;537744;447410;77.8;64.7
14;2021-08-16;1833;2785;539577;450195;78.0;65.1
14;2021-08-17;2263;4570;541840;454765;78.4;65.8
14;2021-08-18;2063;4527;543903;459292;78.7;66.4
14;2021-08-19;2336;5086;546239;464378;79.0;67.2
14;2021-08-20;2189;5403;548428;469781;79.3;67.9
14;2021-08-21;1016;2837;549444;472618;79.5;68.4
14;2021-08-22;170;1564;549614;474182;79.5;68.6
14;2021-08-23;1269;4170;550883;478352;79.7;69.2
14;2021-08-24;1347;4302;552230;482654;79.9;69.8
14;2021-08-25;1400;4398;553630;487052;80.1;70.4
14;2021-08-26;1432;5081;555062;492133;80.3;71.2
14;2021-08-27;1467;5289;556529;497422;80.5;71.9
14;2021-08-28;735;3004;557264;500426;80.6;72.4
14;2021-08-29;185;1014;557449;501440;80.6;72.5
14;2021-08-30;1016;3631;558465;505071;80.8;73.0
14;2021-08-31;1330;4805;559795;509876;81.0;73.7
14;2021-09-01;1068;3986;560863;513862;81.1;74.3
14;2021-09-02;864;3351;561727;517213;81.2;74.8
14;2021-09-03;1182;4353;562909;521566;81.4;75.4
14;2021-09-04;665;2372;563574;523938;81.5;75.8
14;2021-09-05;126;413;563700;524351;81.5;75.8
14;2021-09-06;468;2223;564168;526574;81.6;76.2
14;2021-09-07;497;2200;564665;528774;81.7;76.5
14;2021-09-08;680;3173;565345;531947;81.8;76.9
14;2021-09-09;594;2213;565939;534160;81.8;77.3
14;2021-09-10;771;2869;566710;537029;82.0;77.7
14;2021-09-11;521;1626;567231;538655;82.0;77.9
14;2021-09-12;75;295;567306;538950;82.0;77.9
14;2021-09-13;311;1601;567617;540551;82.1;78.2
14;2021-09-14;656;1904;568273;542455;82.2;78.5
14;2021-09-15;716;1997;568989;544452;82.3;78.7
14;2021-09-16;589;1339;569578;545791;82.4;78.9
14;2021-09-17;629;1453;570207;547244;82.5;79.1
14;2021-09-18;217;970;570424;548214;82.5;79.3
14;2021-09-19;41;137;570465;548351;82.5;79.3
14;2021-09-20;331;810;570796;549161;82.6;79.4
14;2021-09-21;538;847;571334;550008;82.6;79.5
14;2021-09-22;483;1754;571817;551762;82.7;79.8
14;2021-09-23;445;784;572262;552546;82.8;79.9
14;2021-09-24;404;1309;572666;553855;82.8;80.1
14;2021-09-25;191;690;572857;554545;82.8;80.2
14;2021-09-26;41;140;572898;554685;82.9;80.2
14;2021-09-27;276;710;573174;555395;82.9;80.3
14;2021-09-28;358;673;573532;556068;82.9;80.4
14;2021-09-29;305;918;573837;556986;83.0;80.6
14;2021-09-30;338;686;574175;557672;83.0;80.7
14;2021-10-01;449;829;574624;558501;83.1;80.8
14;2021-10-02;246;514;574870;559015;83.1;80.8
14;2021-10-03;37;61;574907;559076;83.1;80.9
14;2021-10-04;280;507;575187;559583;83.2;80.9
14;2021-10-05;268;445;575455;560028;83.2;81.0
14;2021-10-06;386;792;575841;560820;83.3;81.1
15;2020-12-27;2;0;2;0;0.0;0.0
15;2020-12-28;0;0;2;0;0.0;0.0
15;2020-12-29;0;0;2;0;0.0;0.0
15;2020-12-30;0;0;2;0;0.0;0.0
15;2020-12-31;0;0;2;0;0.0;0.0
15;2021-01-01;1;0;3;0;0.0;0.0
15;2021-01-02;0;0;3;0;0.0;0.0
15;2021-01-03;0;0;3;0;0.0;0.0
15;2021-01-04;0;0;3;0;0.0;0.0
15;2021-01-05;0;0;3;0;0.0;0.0
15;2021-01-06;0;0;3;0;0.0;0.0
15;2021-01-07;72;0;75;0;0.1;0.0
15;2021-01-08;110;0;185;0;0.1;0.0
15;2021-01-09;0;0;185;0;0.1;0.0
15;2021-01-10;2;0;187;0;0.1;0.0
15;2021-01-11;99;0;286;0;0.2;0.0
15;2021-01-12;94;0;380;0;0.3;0.0
15;2021-01-13;230;0;610;0;0.4;0.0
15;2021-01-14;313;1;923;1;0.6;0.0
15;2021-01-15;138;0;1061;1;0.7;0.0
15;2021-01-16;90;0;1151;1;0.8;0.0
15;2021-01-17;0;0;1151;1;0.8;0.0
15;2021-01-18;404;2;1555;3;1.1;0.0
15;2021-01-19;550;0;2105;3;1.5;0.0
15;2021-01-20;629;1;2734;4;1.9;0.0
15;2021-01-21;576;4;3310;8;2.3;0.0
15;2021-01-22;503;1;3813;9;2.7;0.0
15;2021-01-23;432;1;4245;10;3.0;0.0
15;2021-01-24;6;0;4251;10;3.0;0.0
15;2021-01-25;401;0;4652;10;3.3;0.0
15;2021-01-26;437;0;5089;10;3.6;0.0
15;2021-01-27;736;7;5825;17;4.1;0.0
15;2021-01-28;623;51;6448;68;4.5;0.0
15;2021-01-29;336;80;6784;148;4.8;0.1
15;2021-01-30;218;3;7002;151;4.9;0.1
15;2021-01-31;1;1;7003;152;4.9;0.1
15;2021-02-01;239;81;7242;233;5.1;0.2
15;2021-02-02;189;80;7431;313;5.2;0.2
15;2021-02-03;267;145;7698;458;5.4;0.3
15;2021-02-04;663;164;8361;622;5.9;0.4
15;2021-02-05;296;200;8657;822;6.1;0.6
15;2021-02-06;98;52;8755;874;6.1;0.6
15;2021-02-07;0;0;8755;874;6.1;0.6
15;2021-02-08;233;85;8988;959;6.3;0.7
15;2021-02-09;206;105;9194;1064;6.4;0.7
15;2021-02-10;338;288;9532;1352;6.7;0.9
15;2021-02-11;117;225;9649;1577;6.8;1.1
15;2021-02-12;136;145;9785;1722;6.9;1.2
15;2021-02-13;92;75;9877;1797;6.9;1.3
15;2021-02-14;0;0;9877;1797;6.9;1.3
15;2021-02-15;64;177;9941;1974;7.0;1.4
15;2021-02-16;52;253;9993;2227;7.0;1.6
15;2021-02-17;134;383;10127;2610;7.1;1.8
15;2021-02-18;87;684;10214;3294;7.2;2.3
15;2021-02-19;90;381;10304;3675;7.2;2.6
15;2021-02-20;20;219;10324;3894;7.2;2.7
15;2021-02-21;0;0;10324;3894;7.2;2.7
15;2021-02-22;23;406;10347;4300;7.2;3.0
15;2021-02-23;180;391;10527;4691;7.4;3.3
15;2021-02-24;31;402;10558;5093;7.4;3.6
15;2021-02-25;228;829;10786;5922;7.6;4.1
15;2021-02-26;186;430;10972;6352;7.7;4.4
15;2021-02-27;145;77;11117;6429;7.8;4.5
15;2021-02-28;1;0;11118;6429;7.8;4.5
15;2021-03-01;121;197;11239;6626;7.9;4.6
15;2021-03-02;251;278;11490;6904;8.0;4.8
15;2021-03-03;207;26;11697;6930;8.2;4.9
15;2021-03-04;246;227;11943;7157;8.4;5.0
15;2021-03-05;348;164;12291;7321;8.6;5.1
15;2021-03-06;680;11;12971;7332;9.1;5.1
15;2021-03-07;81;2;13052;7334;9.1;5.1
15;2021-03-08;93;101;13145;7435;9.2;5.2
15;2021-03-09;281;269;13426;7704;9.4;5.4
15;2021-03-10;417;167;13843;7871;9.7;5.5
15;2021-03-11;434;279;14277;8150;10.0;5.7
15;2021-03-12;525;90;14802;8240;10.4;5.8
15;2021-03-13;355;7;15157;8247;10.6;5.8
15;2021-03-14;18;0;15175;8247;10.6;5.8
15;2021-03-15;542;64;15717;8311;11.0;5.8
15;2021-03-16;328;22;16045;8333;11.2;5.8
15;2021-03-17;130;53;16175;8386;11.3;5.9
15;2021-03-18;250;93;16425;8479;11.5;5.9
15;2021-03-19;669;31;17094;8510;12.0;6.0
15;2021-03-20;148;38;17242;8548;12.1;6.0
15;2021-03-21;6;0;17248;8548;12.1;6.0
15;2021-03-22;574;79;17822;8627;12.5;6.0
15;2021-03-23;776;101;18598;8728;13.0;6.1
15;2021-03-24;936;36;19534;8764;13.7;6.1
15;2021-03-25;1282;33;20816;8797;14.6;6.2
15;2021-03-26;1010;62;21826;8859;15.3;6.2
15;2021-03-27;301;7;22127;8866;15.5;6.2
15;2021-03-28;20;0;22147;8866;15.5;6.2
15;2021-03-29;782;18;22929;8884;16.1;6.2
15;2021-03-30;1135;203;24064;9087;16.9;6.4
15;2021-03-31;941;26;25005;9113;17.5;6.4
15;2021-04-01;1233;62;26238;9175;18.4;6.4
15;2021-04-02;1141;61;27379;9236;19.2;6.5
15;2021-04-03;120;18;27499;9254;19.3;6.5
15;2021-04-04;0;0;27499;9254;19.3;6.5
15;2021-04-05;33;3;27532;9257;19.3;6.5
15;2021-04-06;834;86;28366;9343;19.9;6.5
15;2021-04-07;663;108;29029;9451;20.3;6.6
15;2021-04-08;1246;150;30275;9601;21.2;6.7
15;2021-04-09;1277;106;31552;9707;22.1;6.8
15;2021-04-10;364;20;31916;9727;22.3;6.8
15;2021-04-11;14;0;31930;9727;22.4;6.8
15;2021-04-12;644;457;32574;10184;22.8;7.1
15;2021-04-13;1124;321;33698;10505;23.6;7.4
15;2021-04-14;1038;199;34736;10704;24.3;7.5
15;2021-04-15;1183;311;35919;11015;25.2;7.7
15;2021-04-16;1038;552;36957;11567;25.9;8.1
15;2021-04-17;445;14;37402;11581;26.2;8.1
15;2021-04-18;0;10;37402;11591;26.2;8.1
15;2021-04-19;537;513;37939;12104;26.6;8.5
15;2021-04-20;847;615;38786;12719;27.2;8.9
15;2021-04-21;593;651;39379;13370;27.6;9.4
15;2021-04-22;728;775;40107;14145;28.1;9.9
15;2021-04-23;730;676;40837;14821;28.6;10.4
15;2021-04-24;363;123;41200;14944;28.8;10.5
15;2021-04-25;1;3;41201;14947;28.9;10.5
15;2021-04-26;325;632;41526;15579;29.1;10.9
15;2021-04-27;467;938;41993;16517;29.4;11.6
15;2021-04-28;383;785;42376;17302;29.7;12.1
15;2021-04-29;587;1005;42963;18307;30.1;12.8
15;2021-04-30;547;1070;43510;19377;30.5;13.6
15;2021-05-01;283;29;43793;19406;30.7;13.6
15;2021-05-02;0;0;43793;19406;30.7;13.6
15;2021-05-03;881;331;44674;19737;31.3;13.8
15;2021-05-04;801;854;45475;20591;31.8;14.4
15;2021-05-05;676;680;46151;21271;32.3;14.9
15;2021-05-06;826;967;46977;22238;32.9;15.6
15;2021-05-07;1154;903;48131;23141;33.7;16.2
15;2021-05-08;491;55;48622;23196;34.0;16.2
15;2021-05-09;24;9;48646;23205;34.1;16.2
15;2021-05-10;704;910;49350;24115;34.6;16.9
15;2021-05-11;1186;1182;50536;25297;35.4;17.7
15;2021-05-12;1147;837;51683;26134;36.2;18.3
15;2021-05-13;1165;440;52848;26574;37.0;18.6
15;2021-05-14;1503;582;54351;27156;38.1;19.0
15;2021-05-15;1410;418;55761;27574;39.0;19.3
15;2021-05-16;1;10;55762;27584;39.0;19.3
15;2021-05-17;999;605;56761;28189;39.7;19.7
15;2021-05-18;1221;970;57982;29159;40.6;20.4
15;2021-05-19;1020;459;59002;29618;41.3;20.7
15;2021-05-20;1239;781;60241;30399;42.2;21.3
15;2021-05-21;1348;749;61589;31148;43.1;21.8
15;2021-05-22;527;188;62116;31336;43.5;21.9
15;2021-05-23;2;11;62118;31347;43.5;21.9
15;2021-05-24;693;257;62811;31604;44.0;22.1
15;2021-05-25;1151;620;63962;32224;44.8;22.6
15;2021-05-26;1093;459;65055;32683;45.6;22.9
15;2021-05-27;1271;660;66326;33343;46.4;23.3
15;2021-05-28;1509;883;67835;34226;47.5;24.0
15;2021-05-29;984;360;68819;34586;48.2;24.2
15;2021-05-30;14;25;68833;34611;48.2;24.2
15;2021-05-31;1200;480;70033;35091;49.0;24.6
15;2021-06-01;1398;570;71431;35661;50.0;25.0
15;2021-06-02;864;417;72295;36078;50.6;25.3
15;2021-06-03;932;701;73227;36779;51.3;25.8
15;2021-06-04;1076;713;74303;37492;52.0;26.3
15;2021-06-05;651;262;74954;37754;52.5;26.4
15;2021-06-06;16;20;74970;37774;52.5;26.5
15;2021-06-07;797;350;75767;38124;53.1;26.7
15;2021-06-08;477;394;76244;38518;53.4;27.0
15;2021-06-09;375;376;76619;38894;53.7;27.2
15;2021-06-10;276;423;76895;39317;53.8;27.5
15;2021-06-11;660;1099;77555;40416;54.3;28.3
15;2021-06-12;377;467;77932;40883;54.6;28.6
15;2021-06-13;11;6;77943;40889;54.6;28.6
15;2021-06-14;542;977;78485;41866;55.0;29.3
15;2021-06-15;450;1164;78935;43030;55.3;30.1
15;2021-06-16;543;899;79478;43929;55.7;30.8
15;2021-06-17;292;934;79770;44863;55.9;31.4
15;2021-06-18;740;1205;80510;46068;56.4;32.3
15;2021-06-19;542;704;81052;46772;56.8;32.8
15;2021-06-20;11;1;81063;46773;56.8;32.8
15;2021-06-21;279;1042;81342;47815;57.0;33.5
15;2021-06-22;232;1480;81574;49295;57.1;34.5
15;2021-06-23;346;1445;81920;50740;57.4;35.5
15;2021-06-24;291;1094;82211;51834;57.6;36.3
15;2021-06-25;379;1640;82590;53474;57.8;37.4
15;2021-06-26;164;908;82754;54382;57.9;38.1
15;2021-06-27;0;0;82754;54382;57.9;38.1
15;2021-06-28;176;1228;82930;55610;58.1;38.9
15;2021-06-29;302;1264;83232;56874;58.3;39.8
15;2021-06-30;268;981;83500;57855;58.5;40.5
15;2021-07-01;380;1220;83880;59075;58.7;41.4
15;2021-07-02;410;1348;84290;60423;59.0;42.3
15;2021-07-03;252;707;84542;61130;59.2;42.8
15;2021-07-04;1;1;84543;61131;59.2;42.8
15;2021-07-05;248;1257;84791;62388;59.4;43.7
15;2021-07-06;275;1468;85066;63856;59.6;44.7
15;2021-07-07;255;1343;85321;65199;59.7;45.7
15;2021-07-08;489;1353;85810;66552;60.1;46.6
15;2021-07-09;488;1783;86298;68335;60.4;47.8
15;2021-07-10;215;862;86513;69197;60.6;48.5
15;2021-07-11;9;5;86522;69202;60.6;48.5
15;2021-07-12;278;1484;86800;70686;60.8;49.5
15;2021-07-13;587;1776;87387;72462;61.2;50.7
15;2021-07-14;16;130;87403;72592;61.2;50.8
15;2021-07-15;1132;729;88535;73321;62.0;51.3
15;2021-07-16;1139;1336;89674;74657;62.8;52.3
15;2021-07-17;819;953;90493;75610;63.4;52.9
15;2021-07-18;0;3;90493;75613;63.4;52.9
15;2021-07-19;1074;1270;91567;76883;64.1;53.8
15;2021-07-20;1612;547;93179;77430;65.2;54.2
15;2021-07-21;1189;603;94368;78033;66.1;54.6
15;2021-07-22;894;511;95262;78544;66.7;55.0
15;2021-07-23;1341;1064;96603;79608;67.6;55.7
15;2021-07-24;628;769;97231;80377;68.1;56.3
15;2021-07-25;1;24;97232;80401;68.1;56.3
15;2021-07-26;1247;594;98479;80995;69.0;56.7
15;2021-07-27;1691;576;100170;81571;70.1;57.1
15;2021-07-28;1238;581;101408;82152;71.0;57.5
15;2021-07-29;838;399;102246;82551;71.6;57.8
15;2021-07-30;1007;1130;103253;83681;72.3;58.6
15;2021-07-31;604;637;103857;84318;72.7;59.0
15;2021-08-01;21;12;103878;84330;72.7;59.1
15;2021-08-02;1143;543;105021;84873;73.5;59.4
15;2021-08-03;1162;383;106183;85256;74.4;59.7
15;2021-08-04;788;408;106971;85664;74.9;60.0
15;2021-08-05;383;284;107354;85948;75.2;60.2
15;2021-08-06;788;1235;108142;87183;75.7;61.0
15;2021-08-07;265;1160;108407;88343;75.9;61.9
15;2021-08-08;3;6;108410;88349;75.9;61.9
15;2021-08-09;511;1164;108921;89513;76.3;62.7
15;2021-08-10;435;725;109356;90238;76.6;63.2
15;2021-08-11;411;1007;109767;91245;76.9;63.9
15;2021-08-12;520;1182;110287;92427;77.2;64.7
15;2021-08-13;682;1137;110969;93564;77.7;65.5
15;2021-08-14;179;552;111148;94116;77.8;65.9
15;2021-08-15;17;9;111165;94125;77.8;65.9
15;2021-08-16;387;1134;111552;95259;78.1;66.7
15;2021-08-17;402;1140;111954;96399;78.4;67.5
15;2021-08-18;368;803;112322;97202;78.7;68.1
15;2021-08-19;300;878;112622;98080;78.9;68.7
15;2021-08-20;601;1215;113223;99295;79.3;69.5
15;2021-08-21;218;867;113441;100162;79.4;70.1
15;2021-08-22;12;26;113453;100188;79.4;70.2
15;2021-08-23;229;611;113682;100799;79.6;70.6
15;2021-08-24;245;590;113927;101389;79.8;71.0
15;2021-08-25;155;493;114082;101882;79.9;71.3
15;2021-08-26;136;363;114218;102245;80.0;71.6
15;2021-08-27;366;1337;114584;103582;80.2;72.5
15;2021-08-28;214;857;114798;104439;80.4;73.1
15;2021-08-29;7;13;114805;104452;80.4;73.1
15;2021-08-30;225;1062;115030;105514;80.5;73.9
15;2021-08-31;404;667;115434;106181;80.8;74.4
15;2021-09-01;182;445;115616;106626;81.0;74.7
15;2021-09-02;97;275;115713;106901;81.0;74.9
15;2021-09-03;202;1007;115915;107908;81.2;75.6
15;2021-09-04;157;422;116072;108330;81.3;75.9
15;2021-09-05;0;2;116072;108332;81.3;75.9
15;2021-09-06;98;490;116170;108822;81.3;76.2
15;2021-09-07;100;230;116270;109052;81.4;76.4
15;2021-09-08;201;589;116471;109641;81.6;76.8
15;2021-09-09;100;353;116571;109994;81.6;77.0
15;2021-09-10;232;997;116803;110991;81.8;77.7
15;2021-09-11;95;365;116898;111356;81.9;78.0
15;2021-09-12;0;0;116898;111356;81.9;78.0
15;2021-09-13;102;386;117000;111742;81.9;78.2
15;2021-09-14;124;254;117124;111996;82.0;78.4
15;2021-09-15;69;247;117193;112243;82.1;78.6
15;2021-09-16;33;101;117226;112344;82.1;78.7
15;2021-09-17;265;604;117491;112948;82.3;79.1
15;2021-09-18;79;380;117570;113328;82.3;79.4
15;2021-09-19;0;0;117570;113328;82.3;79.4
15;2021-09-20;123;217;117693;113545;82.4;79.5
15;2021-09-21;41;107;117734;113652;82.4;79.6
15;2021-09-22;84;355;117818;114007;82.5;79.8
15;2021-09-23;37;108;117855;114115;82.5;79.9
15;2021-09-24;138;334;117993;114449;82.6;80.1
15;2021-09-25;42;217;118035;114666;82.7;80.3
15;2021-09-26;1;5;118036;114671;82.7;80.3
15;2021-09-27;88;133;118124;114804;82.7;80.4
15;2021-09-28;74;131;118198;114935;82.8;80.5
15;2021-09-29;69;191;118267;115126;82.8;80.6
15;2021-09-30;37;93;118304;115219;82.8;80.7
15;2021-10-01;117;216;118421;115435;82.9;80.8
15;2021-10-02;30;143;118451;115578;82.9;80.9
15;2021-10-03;0;2;118451;115580;82.9;80.9
15;2021-10-04;57;59;118508;115639;83.0;81.0
15;2021-10-05;31;51;118539;115690;83.0;81.0
15;2021-10-06;79;105;118618;115795;83.1;81.1
16;2020-12-27;0;0;0;0;0.0;0.0
16;2020-12-28;2;0;2;0;0.0;0.0
16;2020-12-29;0;0;2;0;0.0;0.0
16;2020-12-30;1;0;3;0;0.0;0.0
16;2020-12-31;0;0;3;0;0.0;0.0
16;2021-01-01;0;0;3;0;0.0;0.0
16;2021-01-02;0;0;3;0;0.0;0.0
16;2021-01-03;0;0;3;0;0.0;0.0
16;2021-01-04;1;0;4;0;0.0;0.0
16;2021-01-05;1;0;5;0;0.0;0.0
16;2021-01-06;88;0;93;0;0.0;0.0
16;2021-01-07;240;0;333;0;0.1;0.0
16;2021-01-08;465;2;798;2;0.2;0.0
16;2021-01-09;1;0;799;2;0.2;0.0
16;2021-01-10;1;0;800;2;0.2;0.0
16;2021-01-11;304;0;1104;2;0.3;0.0
16;2021-01-12;437;1;1541;3;0.4;0.0
16;2021-01-13;480;0;2021;3;0.6;0.0
16;2021-01-14;601;6;2622;9;0.8;0.0
16;2021-01-15;504;3;3126;12;0.9;0.0
16;2021-01-16;0;0;3126;12;0.9;0.0
16;2021-01-17;0;0;3126;12;0.9;0.0
16;2021-01-18;432;2;3558;14;1.0;0.0
16;2021-01-19;834;2;4392;16;1.3;0.0
16;2021-01-20;1188;2;5580;18;1.6;0.0
16;2021-01-21;1383;3;6963;21;2.0;0.0
16;2021-01-22;1115;0;8078;21;2.3;0.0
16;2021-01-23;183;0;8261;21;2.4;0.0
16;2021-01-24;0;0;8261;21;2.4;0.0
16;2021-01-25;641;2;8902;23;2.6;0.0
16;2021-01-26;1025;1;9927;24;2.9;0.0
16;2021-01-27;1406;105;11333;129;3.3;0.0
16;2021-01-28;1276;53;12609;182;3.6;0.1
16;2021-01-29;742;125;13351;307;3.8;0.1
16;2021-01-30;36;0;13387;307;3.8;0.1
16;2021-01-31;0;0;13387;307;3.8;0.1
16;2021-02-01;395;197;13782;504;4.0;0.1
16;2021-02-02;576;161;14358;665;4.1;0.2
16;2021-02-03;621;342;14979;1007;4.3;0.3
16;2021-02-04;465;254;15444;1261;4.4;0.4
16;2021-02-05;505;261;15949;1522;4.6;0.4
16;2021-02-06;4;80;15953;1602;4.6;0.5
16;2021-02-07;41;3;15994;1605;4.6;0.5
16;2021-02-08;357;188;16351;1793;4.7;0.5
16;2021-02-09;649;248;17000;2041;4.9;0.6
16;2021-02-10;694;596;17694;2637;5.1;0.8
16;2021-02-11;803;516;18497;3153;5.3;0.9
16;2021-02-12;622;792;19119;3945;5.5;1.1
16;2021-02-13;43;77;19162;4022;5.5;1.2
16;2021-02-14;2;5;19164;4027;5.5;1.2
16;2021-02-15;217;570;19381;4597;5.6;1.3
16;2021-02-16;375;791;19756;5388;5.7;1.5
16;2021-02-17;346;1155;20102;6543;5.8;1.9
16;2021-02-18;511;1048;20613;7591;5.9;2.2
16;2021-02-19;389;637;21002;8228;6.0;2.4
16;2021-02-20;2;8;21004;8236;6.0;2.4
16;2021-02-21;2;0;21006;8236;6.0;2.4
16;2021-02-22;136;407;21142;8643;6.1;2.5
16;2021-02-23;207;677;21349;9320;6.1;2.7
16;2021-02-24;277;770;21626;10090;6.2;2.9
16;2021-02-25;395;528;22021;10618;6.3;3.0
16;2021-02-26;479;423;22500;11041;6.5;3.2
16;2021-02-27;249;1;22749;11042;6.5;3.2
16;2021-02-28;5;1;22754;11043;6.5;3.2
16;2021-03-01;152;237;22906;11280;6.6;3.2
16;2021-03-02;271;515;23177;11795;6.7;3.4
16;2021-03-03;391;621;23568;12416;6.8;3.6
16;2021-03-04;804;509;24372;12925;7.0;3.7
16;2021-03-05;1143;490;25515;13415;7.3;3.9
16;2021-03-06;753;13;26268;13428;7.5;3.9
16;2021-03-07;94;18;26362;13446;7.6;3.9
16;2021-03-08;437;272;26799;13718;7.7;3.9
16;2021-03-09;774;553;27573;14271;7.9;4.1
16;2021-03-10;606;593;28179;14864;8.1;4.3
16;2021-03-11;1448;507;29627;15371;8.5;4.4
16;2021-03-12;1164;422;30791;15793;8.8;4.5
16;2021-03-13;765;15;31556;15808;9.1;4.5
16;2021-03-14;1;0;31557;15808;9.1;4.5
16;2021-03-15;462;170;32019;15978;9.2;4.6
16;2021-03-16;860;401;32879;16379;9.4;4.7
16;2021-03-17;591;280;33470;16659;9.6;4.8
16;2021-03-18;1033;267;34503;16926;9.9;4.9
16;2021-03-19;1103;232;35606;17158;10.2;4.9
16;2021-03-20;396;5;36002;17163;10.3;4.9
16;2021-03-21;9;0;36011;17163;10.3;4.9
16;2021-03-22;728;96;36739;17259;10.6;5.0
16;2021-03-23;1464;101;38203;17360;11.0;5.0
16;2021-03-24;1123;182;39326;17542;11.3;5.0
16;2021-03-25;2047;87;41373;17629;11.9;5.1
16;2021-03-26;1916;98;43289;17727;12.4;5.1
16;2021-03-27;432;21;43721;17748;12.6;5.1
16;2021-03-28;0;0;43721;17748;12.6;5.1
16;2021-03-29;923;60;44644;17808;12.8;5.1
16;2021-03-30;1882;175;46526;17983;13.4;5.2
16;2021-03-31;1513;134;48039;18117;13.8;5.2
16;2021-04-01;2009;399;50048;18516;14.4;5.3
16;2021-04-02;1442;378;51490;18894;14.8;5.4
16;2021-04-03;288;5;51778;18899;14.9;5.4
16;2021-04-04;1;0;51779;18899;14.9;5.4
16;2021-04-05;2;0;51781;18899;14.9;5.4
16;2021-04-06;2013;547;53794;19446;15.5;5.6
16;2021-04-07;1953;404;55747;19850;16.0;5.7
16;2021-04-08;2823;583;58570;20433;16.8;5.9
16;2021-04-09;2695;552;61265;20985;17.6;6.0
16;2021-04-10;1290;37;62555;21022;18.0;6.0
16;2021-04-11;2;0;62557;21022;18.0;6.0
16;2021-04-12;1430;316;63987;21338;18.4;6.1
16;2021-04-13;2124;838;66111;22176;19.0;6.4
16;2021-04-14;1951;630;68062;22806;19.5;6.6
16;2021-04-15;2102;979;70164;23785;20.2;6.8
16;2021-04-16;2043;786;72207;24571;20.7;7.1
16;2021-04-17;1507;92;73714;24663;21.2;7.1
16;2021-04-18;197;3;73911;24666;21.2;7.1
16;2021-04-19;1440;523;75351;25189;21.6;7.2
16;2021-04-20;2053;1231;77404;26420;22.2;7.6
16;2021-04-21;1776;750;79180;27170;22.7;7.8
16;2021-04-22;2290;1007;81470;28177;23.4;8.1
16;2021-04-23;2362;1167;83832;29344;24.1;8.4
16;2021-04-24;829;38;84661;29382;24.3;8.4
16;2021-04-25;117;5;84778;29387;24.3;8.4
16;2021-04-26;1400;808;86178;30195;24.8;8.7
16;2021-04-27;2055;1409;88233;31604;25.3;9.1
16;2021-04-28;1592;1123;89825;32727;25.8;9.4
16;2021-04-29;2250;1483;92075;34210;26.4;9.8
16;2021-04-30;2856;1338;94931;35548;27.3;10.2
16;2021-05-01;353;60;95284;35608;27.4;10.2
16;2021-05-02;155;13;95439;35621;27.4;10.2
16;2021-05-03;2611;528;98050;36149;28.2;10.4
16;2021-05-04;2057;2040;100107;38189;28.8;11.0
16;2021-05-05;1688;1826;101795;40015;29.2;11.5
16;2021-05-06;1886;2237;103681;42252;29.8;12.1
16;2021-05-07;3072;2115;106753;44367;30.7;12.7
16;2021-05-08;1197;466;107950;44833;31.0;12.9
16;2021-05-09;530;27;108480;44860;31.2;12.9
16;2021-05-10;1930;1622;110410;46482;31.7;13.3
16;2021-05-11;2354;1959;112764;48441;32.4;13.9
16;2021-05-12;1734;1792;114498;50233;32.9;14.4
16;2021-05-13;1461;354;115959;50587;33.3;14.5
16;2021-05-14;1988;1551;117947;52138;33.9;15.0
16;2021-05-15;596;895;118543;53033;34.0;15.2
16;2021-05-16;132;6;118675;53039;34.1;15.2
16;2021-05-17;1609;1285;120284;54324;34.5;15.6
16;2021-05-18;2756;1422;123040;55746;35.3;16.0
16;2021-05-19;2006;1241;125046;56987;35.9;16.4
16;2021-05-20;2832;1389;127878;58376;36.7;16.8
16;2021-05-21;2943;1387;130821;59763;37.6;17.2
16;2021-05-22;411;711;131232;60474;37.7;17.4
16;2021-05-23;210;11;131442;60485;37.8;17.4
16;2021-05-24;1262;234;132704;60719;38.1;17.4
16;2021-05-25;2759;1461;135463;62180;38.9;17.9
16;2021-05-26;1833;1184;137296;63364;39.4;18.2
16;2021-05-27;2416;1583;139712;64947;40.1;18.7
16;2021-05-28;2899;1556;142611;66503;41.0;19.1
16;2021-05-29;814;883;143425;67386;41.2;19.4
16;2021-05-30;1;4;143426;67390;41.2;19.4
16;2021-05-31;1984;1100;145410;68490;41.8;19.7
16;2021-06-01;2344;1703;147754;70193;42.4;20.2
16;2021-06-02;1820;1502;149574;71695;43.0;20.6
16;2021-06-03;2622;1758;152196;73453;43.7;21.1
16;2021-06-04;2833;2028;155029;75481;44.5;21.7
16;2021-06-05;1006;546;156035;76027;44.8;21.8
16;2021-06-06;161;29;156196;76056;44.9;21.8
16;2021-06-07;1991;1281;158187;77337;45.4;22.2
16;2021-06-08;2394;1991;160581;79328;46.1;22.8
16;2021-06-09;2528;1616;163109;80944;46.8;23.2
16;2021-06-10;2569;1995;165678;82939;47.6;23.8
16;2021-06-11;2152;2730;167830;85669;48.2;24.6
16;2021-06-12;1613;517;169443;86186;48.7;24.8
16;2021-06-13;260;72;169703;86258;48.7;24.8
16;2021-06-14;797;2795;170500;89053;49.0;25.6
16;2021-06-15;1866;2623;172366;91676;49.5;26.3
16;2021-06-16;1575;2083;173941;93759;50.0;26.9
16;2021-06-17;2040;2496;175981;96255;50.5;27.6
16;2021-06-18;2060;3214;178041;99469;51.1;28.6
16;2021-06-19;1351;1311;179392;100780;51.5;28.9
16;2021-06-20;243;28;179635;100808;51.6;29.0
16;2021-06-21;1411;2166;181046;102974;52.0;29.6
16;2021-06-22;1675;2943;182721;105917;52.5;30.4
16;2021-06-23;1562;2015;184283;107932;52.9;31.0
16;2021-06-24;1928;2167;186211;110099;53.5;31.6
16;2021-06-25;1984;2726;188195;112825;54.1;32.4
16;2021-06-26;1060;725;189255;113550;54.4;32.6
16;2021-06-27;132;25;189387;113575;54.4;32.6
16;2021-06-28;1164;1962;190551;115537;54.7;33.2
16;2021-06-29;1282;3361;191833;118898;55.1;34.1
16;2021-06-30;1337;2714;193170;121612;55.5;34.9
16;2021-07-01;1866;3153;195036;124765;56.0;35.8
16;2021-07-02;1423;3578;196459;128343;56.4;36.9
16;2021-07-03;696;1108;197155;129451;56.6;37.2
16;2021-07-04;3;15;197158;129466;56.6;37.2
16;2021-07-05;815;2297;197973;131763;56.9;37.8
16;2021-07-06;1278;3364;199251;135127;57.2;38.8
16;2021-07-07;871;2275;200122;137402;57.5;39.5
16;2021-07-08;1234;2732;201356;140134;57.8;40.2
16;2021-07-09;1113;3707;202469;143841;58.2;41.3
16;2021-07-10;338;1337;202807;145178;58.2;41.7
16;2021-07-11;2;13;202809;145191;58.2;41.7
16;2021-07-12;634;2432;203443;147623;58.4;42.4
16;2021-07-13;1385;3527;204828;151150;58.8;43.4
16;2021-07-14;797;877;205625;152027;59.1;43.7
16;2021-07-15;1249;3406;206874;155433;59.4;44.6
16;2021-07-16;1498;3377;208372;158810;59.8;45.6
16;2021-07-17;539;1188;208911;159998;60.0;46.0
16;2021-07-18;14;6;208925;160004;60.0;46.0
16;2021-07-19;618;2850;209543;162854;60.2;46.8
16;2021-07-20;1125;3281;210668;166135;60.5;47.7
16;2021-07-21;1117;2619;211785;168754;60.8;48.5
16;2021-07-22;1871;2853;213656;171607;61.4;49.3
16;2021-07-23;1552;3544;215208;175151;61.8;50.3
16;2021-07-24;639;1206;215847;176357;62.0;50.7
16;2021-07-25;11;11;215858;176368;62.0;50.7
16;2021-07-26;1529;2128;217387;178496;62.4;51.3
16;2021-07-27;1865;2819;219252;181315;63.0;52.1
16;2021-07-28;1864;2307;221116;183622;63.5;52.7
16;2021-07-29;2241;2473;223357;186095;64.1;53.4
16;2021-07-30;2355;3103;225712;189198;64.8;54.3
16;2021-07-31;960;1353;226672;190551;65.1;54.7
16;2021-08-01;192;22;226864;190573;65.2;54.7
16;2021-08-02;2121;1827;228985;192400;65.8;55.3
16;2021-08-03;2121;2323;231106;194723;66.4;55.9
16;2021-08-04;2121;1886;233227;196609;67.0;56.5
16;2021-08-05;2775;1655;236002;198264;67.8;56.9
16;2021-08-06;2512;2365;238514;200629;68.5;57.6
16;2021-08-07;828;559;239342;201188;68.7;57.8
16;2021-08-08;36;33;239378;201221;68.8;57.8
16;2021-08-09;2182;1061;241560;202282;69.4;58.1
16;2021-08-10;2886;1585;244446;203867;70.2;58.6
16;2021-08-11;2603;1232;247049;205099;71.0;58.9
16;2021-08-12;2012;1734;249061;206833;71.5;59.4
16;2021-08-13;2686;1467;251747;208300;72.3;59.8
16;2021-08-14;758;455;252505;208755;72.5;60.0
16;2021-08-15;29;4;252534;208759;72.5;60.0
16;2021-08-16;1339;1582;253873;210341;72.9;60.4
16;2021-08-17;1837;1628;255710;211969;73.4;60.9
16;2021-08-18;1591;1471;257301;213440;73.9;61.3
16;2021-08-19;1517;1777;258818;215217;74.3;61.8
16;2021-08-20;1601;1902;260419;217119;74.8;62.4
16;2021-08-21;564;827;260983;217946;75.0;62.6
16;2021-08-22;4;5;260987;217951;75.0;62.6
16;2021-08-23;993;2064;261980;220015;75.2;63.2
16;2021-08-24;1040;2376;263020;222391;75.5;63.9
16;2021-08-25;887;1781;263907;224172;75.8;64.4
16;2021-08-26;880;2531;264787;226703;76.0;65.1
16;2021-08-27;853;2408;265640;229111;76.3;65.8
16;2021-08-28;261;771;265901;229882;76.4;66.0
16;2021-08-29;2;15;265903;229897;76.4;66.0
16;2021-08-30;638;2397;266541;232294;76.6;66.7
16;2021-08-31;668;2631;267209;234925;76.7;67.5
16;2021-09-01;468;2544;267677;237469;76.9;68.2
16;2021-09-02;544;2366;268221;239835;77.0;68.9
16;2021-09-03;541;2812;268762;242647;77.2;69.7
16;2021-09-04;361;965;269123;243612;77.3;70.0
16;2021-09-05;5;29;269128;243641;77.3;70.0
16;2021-09-06;318;1760;269446;245401;77.4;70.5
16;2021-09-07;354;1990;269800;247391;77.5;71.1
16;2021-09-08;392;2212;270192;249603;77.6;71.7
16;2021-09-09;346;1711;270538;251314;77.7;72.2
16;2021-09-10;440;2099;270978;253413;77.8;72.8
16;2021-09-11;185;847;271163;254260;77.9;73.0
16;2021-09-12;6;23;271169;254283;77.9;73.0
16;2021-09-13;256;1350;271425;255633;78.0;73.4
16;2021-09-14;371;1441;271796;257074;78.1;73.8
16;2021-09-15;349;1347;272145;258421;78.2;74.2
16;2021-09-16;303;887;272448;259308;78.2;74.5
16;2021-09-17;498;1375;272946;260683;78.4;74.9
16;2021-09-18;100;535;273046;261218;78.4;75.0
16;2021-09-19;0;9;273046;261227;78.4;75.0
16;2021-09-20;190;720;273236;261947;78.5;75.2
16;2021-09-21;183;673;273419;262620;78.5;75.4
16;2021-09-22;187;990;273606;263610;78.6;75.7
16;2021-09-23;170;559;273776;264169;78.6;75.9
16;2021-09-24;338;1049;274114;265218;78.7;76.2
16;2021-09-25;64;439;274178;265657;78.7;76.3
16;2021-09-26;1;6;274179;265663;78.7;76.3
16;2021-09-27;193;581;274372;266244;78.8;76.5
16;2021-09-28;145;536;274517;266780;78.8;76.6
16;2021-09-29;197;606;274714;267386;78.9;76.8
16;2021-09-30;115;481;274829;267867;78.9;76.9
16;2021-10-01;241;540;275070;268407;79.0;77.1
16;2021-10-02;81;324;275151;268731;79.0;77.2
16;2021-10-03;0;7;275151;268738;79.0;77.2
16;2021-10-04;117;356;275268;269094;79.1;77.3
16;2021-10-05;121;375;275389;269469;79.1;77.4
16;2021-10-06;182;510;275571;269979;79.1;77.5
17;2020-12-27;0;0;0;0;0.0;0.0
17;2020-12-28;0;0;0;0;0.0;0.0
17;2020-12-29;0;0;0;0;0.0;0.0
17;2020-12-30;1;0;1;0;0.0;0.0
17;2020-12-31;0;0;1;0;0.0;0.0
17;2021-01-01;1;0;2;0;0.0;0.0
17;2021-01-02;1;0;3;0;0.0;0.0
17;2021-01-03;0;0;3;0;0.0;0.0
17;2021-01-04;56;0;59;0;0.0;0.0
17;2021-01-05;98;0;157;0;0.0;0.0
17;2021-01-06;132;0;289;0;0.0;0.0
17;2021-01-07;484;1;773;1;0.1;0.0
17;2021-01-08;418;0;1191;1;0.2;0.0
17;2021-01-09;0;0;1191;1;0.2;0.0
17;2021-01-10;1;0;1192;1;0.2;0.0
17;2021-01-11;381;1;1573;2;0.2;0.0
17;2021-01-12;751;1;2324;3;0.4;0.0
17;2021-01-13;654;2;2978;5;0.5;0.0
17;2021-01-14;616;8;3594;13;0.6;0.0
17;2021-01-15;681;1;4275;14;0.7;0.0
17;2021-01-16;129;2;4404;16;0.7;0.0
17;2021-01-17;19;0;4423;16;0.7;0.0
17;2021-01-18;887;2;5310;18;0.8;0.0
17;2021-01-19;1910;3;7220;21;1.1;0.0
17;2021-01-20;2396;2;9616;23;1.5;0.0
17;2021-01-21;2500;3;12116;26;1.9;0.0
17;2021-01-22;1893;6;14009;32;2.2;0.0
17;2021-01-23;738;1;14747;33;2.3;0.0
17;2021-01-24;50;0;14797;33;2.3;0.0
17;2021-01-25;1383;5;16180;38;2.5;0.0
17;2021-01-26;2110;2;18290;40;2.8;0.0
17;2021-01-27;1676;32;19966;72;3.1;0.0
17;2021-01-28;2476;217;22442;289;3.5;0.0
17;2021-01-29;1740;157;24182;446;3.7;0.1
17;2021-01-30;528;3;24710;449;3.8;0.1
17;2021-01-31;37;2;24747;451;3.8;0.1
17;2021-02-01;741;186;25488;637;3.9;0.1
17;2021-02-02;1202;320;26690;957;4.1;0.1
17;2021-02-03;1298;375;27988;1332;4.3;0.2
17;2021-02-04;1162;436;29150;1768;4.5;0.3
17;2021-02-05;603;695;29753;2463;4.6;0.4
17;2021-02-06;24;39;29777;2502;4.6;0.4
17;2021-02-07;31;13;29808;2515;4.6;0.4
17;2021-02-08;706;348;30514;2863;4.7;0.4
17;2021-02-09;1102;1082;31616;3945;4.9;0.6
17;2021-02-10;866;1219;32482;5164;5.0;0.8
17;2021-02-11;1241;1296;33723;6460;5.2;1.0
17;2021-02-12;773;881;34496;7341;5.3;1.1
17;2021-02-13;43;93;34539;7434;5.3;1.1
17;2021-02-14;1;10;34540;7444;5.3;1.2
17;2021-02-15;621;925;35161;8369;5.4;1.3
17;2021-02-16;751;1431;35912;9800;5.5;1.5
17;2021-02-17;795;999;36707;10799;5.7;1.7
17;2021-02-18;965;1714;37672;12513;5.8;1.9
17;2021-02-19;1069;1248;38741;13761;6.0;2.1
17;2021-02-20;105;258;38846;14019;6.0;2.2
17;2021-02-21;9;2;38855;14021;6.0;2.2
17;2021-02-22;648;1246;39503;15267;6.1;2.4
17;2021-02-23;782;1216;40285;16483;6.2;2.5
17;2021-02-24;1080;1293;41365;17776;6.4;2.7
17;2021-02-25;1087;1458;42452;19234;6.6;3.0
17;2021-02-26;1308;1047;43760;20281;6.8;3.1
17;2021-02-27;527;212;44287;20493;6.8;3.2
17;2021-02-28;19;9;44306;20502;6.8;3.2
17;2021-03-01;638;868;44944;21370;6.9;3.3
17;2021-03-02;1095;741;46039;22111;7.1;3.4
17;2021-03-03;1618;684;47657;22795;7.4;3.5
17;2021-03-04;2426;1010;50083;23805;7.7;3.7
17;2021-03-05;2662;566;52745;24371;8.2;3.8
17;2021-03-06;1027;28;53772;24399;8.3;3.8
17;2021-03-07;183;17;53955;24416;8.3;3.8
17;2021-03-08;1019;748;54974;25164;8.5;3.9
17;2021-03-09;1745;521;56719;25685;8.8;4.0
17;2021-03-10;2048;592;58767;26277;9.1;4.1
17;2021-03-11;3227;921;61994;27198;9.6;4.2
17;2021-03-12;3356;567;65350;27765;10.1;4.3
17;2021-03-13;1202;11;66552;27776;10.3;4.3
17;2021-03-14;33;0;66585;27776;10.3;4.3
17;2021-03-15;1243;961;67828;28737;10.5;4.4
17;2021-03-16;892;517;68720;29254;10.6;4.5
17;2021-03-17;1460;689;70180;29943;10.8;4.6
17;2021-03-18;1683;757;71863;30700;11.1;4.7
17;2021-03-19;2096;535;73959;31235;11.4;4.8
17;2021-03-20;1086;58;75045;31293;11.6;4.8
17;2021-03-21;37;41;75082;31334;11.6;4.8
17;2021-03-22;1577;682;76659;32016;11.8;4.9
17;2021-03-23;2491;573;79150;32589;12.2;5.0
17;2021-03-24;3545;842;82695;33431;12.8;5.2
17;2021-03-25;4713;639;87408;34070;13.5;5.3
17;2021-03-26;4943;468;92351;34538;14.3;5.3
17;2021-03-27;1737;68;94088;34606;14.5;5.3
17;2021-03-28;369;45;94457;34651;14.6;5.4
17;2021-03-29;2361;566;96818;35217;15.0;5.4
17;2021-03-30;2654;977;99472;36194;15.4;5.6
17;2021-03-31;3843;899;103315;37093;16.0;5.7
17;2021-04-01;4013;1158;107328;38251;16.6;5.9
17;2021-04-02;3709;831;111037;39082;17.2;6.0
17;2021-04-03;1152;187;112189;39269;17.3;6.1
17;2021-04-04;501;6;112690;39275;17.4;6.1
17;2021-04-05;445;128;113135;39403;17.5;6.1
17;2021-04-06;3479;1024;116614;40427;18.0;6.2
17;2021-04-07;4131;1149;120745;41576;18.7;6.4
17;2021-04-08;4567;1476;125312;43052;19.4;6.7
17;2021-04-09;6499;842;131811;43894;20.4;6.8
17;2021-04-10;2582;68;134393;43962;20.8;6.8
17;2021-04-11;790;16;135183;43978;20.9;6.8
17;2021-04-12;2889;1610;138072;45588;21.3;7.0
17;2021-04-13;4152;1281;142224;46869;22.0;7.2
17;2021-04-14;4420;1207;146644;48076;22.7;7.4
17;2021-04-15;4601;1134;151245;49210;23.4;7.6
17;2021-04-16;4298;1153;155543;50363;24.0;7.8
17;2021-04-17;1682;382;157225;50745;24.3;7.8
17;2021-04-18;471;81;157696;50826;24.4;7.9
17;2021-04-19;2336;2053;160032;52879;24.7;8.2
17;2021-04-20;2927;2547;162959;55426;25.2;8.6
17;2021-04-21;2974;1940;165933;57366;25.6;8.9
17;2021-04-22;3121;2357;169054;59723;26.1;9.2
17;2021-04-23;2446;2723;171500;62446;26.5;9.7
17;2021-04-24;1669;923;173169;63369;26.8;9.8
17;2021-04-25;664;244;173833;63613;26.9;9.8
17;2021-04-26;2578;2610;176411;66223;27.3;10.2
17;2021-04-27;3150;2657;179561;68880;27.7;10.6
17;2021-04-28;3102;2915;182663;71795;28.2;11.1
17;2021-04-29;4149;2835;186812;74630;28.9;11.5
17;2021-04-30;4355;2619;191167;77249;29.5;11.9
17;2021-05-01;849;539;192016;77788;29.7;12.0
17;2021-05-02;553;837;192569;78625;29.8;12.2
17;2021-05-03;2546;2953;195115;81578;30.2;12.6
17;2021-05-04;2315;3709;197430;85287;30.5;13.2
17;2021-05-05;2907;3698;200337;88985;31.0;13.8
17;2021-05-06;4120;3391;204457;92376;31.6;14.3
17;2021-05-07;4359;3618;208816;95994;32.3;14.8
17;2021-05-08;1306;751;210122;96745;32.5;15.0
17;2021-05-09;1311;705;211433;97450;32.7;15.1
17;2021-05-10;2726;3674;214159;101124;33.1;15.6
17;2021-05-11;3500;3986;217659;105110;33.6;16.2
17;2021-05-12;3529;3797;221188;108907;34.2;16.8
17;2021-05-13;2542;693;223730;109600;34.6;16.9
17;2021-05-14;3031;2392;226761;111992;35.0;17.3
17;2021-05-15;2127;654;228888;112646;35.4;17.4
17;2021-05-16;1733;316;230621;112962;35.6;17.5
17;2021-05-17;4288;1997;234909;114959;36.3;17.8
17;2021-05-18;4746;1630;239655;116589;37.0;18.0
17;2021-05-19;5071;1281;244726;117870;37.8;18.2
17;2021-05-20;4940;1935;249666;119805;38.6;18.5
17;2021-05-21;4994;1943;254660;121748;39.4;18.8
17;2021-05-22;2390;529;257050;122277;39.7;18.9
17;2021-05-23;1900;128;258950;122405;40.0;18.9
17;2021-05-24;1426;210;260376;122615;40.2;18.9
17;2021-05-25;4031;1767;264407;124382;40.9;19.2
17;2021-05-26;4368;2035;268775;126417;41.5;19.5
17;2021-05-27;5211;2137;273986;128554;42.3;19.9
17;2021-05-28;4467;3412;278453;131966;43.0;20.4
17;2021-05-29;1559;1696;280012;133662;43.3;20.7
17;2021-05-30;857;410;280869;134072;43.4;20.7
17;2021-05-31;2947;2999;283816;137071;43.9;21.2
17;2021-06-01;4296;2915;288112;139986;44.5;21.6
17;2021-06-02;4203;3167;292315;143153;45.2;22.1
17;2021-06-03;5058;3144;297373;146297;46.0;22.6
17;2021-06-04;4513;3850;301886;150147;46.7;23.2
17;2021-06-05;1991;1594;303877;151741;47.0;23.5
17;2021-06-06;852;734;304729;152475;47.1;23.6
17;2021-06-07;3138;4339;307867;156814;47.6;24.2
17;2021-06-08;3790;4494;311657;161308;48.2;24.9
17;2021-06-09;4344;3048;316001;164356;48.8;25.4
17;2021-06-10;4927;2782;320928;167138;49.6;25.8
17;2021-06-11;4793;3679;325721;170817;50.3;26.4
17;2021-06-12;1813;1388;327534;172205;50.6;26.6
17;2021-06-13;612;415;328146;172620;50.7;26.7
17;2021-06-14;2834;4533;330980;177153;51.1;27.4
17;2021-06-15;3625;4368;334605;181521;51.7;28.1
17;2021-06-16;4127;3692;338732;185213;52.3;28.6
17;2021-06-17;4367;4110;343099;189323;53.0;29.3
17;2021-06-18;4059;4435;347158;193758;53.6;29.9
17;2021-06-19;1450;1975;348608;195733;53.9;30.2
17;2021-06-20;595;1036;349203;196769;54.0;30.4
17;2021-06-21;2559;4369;351762;201138;54.4;31.1
17;2021-06-22;3532;4451;355294;205589;54.9;31.8
17;2021-06-23;3795;3995;359089;209584;55.5;32.4
17;2021-06-24;3599;3952;362688;213536;56.0;33.0
17;2021-06-25;2718;4984;365406;218520;56.5;33.8
17;2021-06-26;905;2333;366311;220853;56.6;34.1
17;2021-06-27;397;1904;366708;222757;56.7;34.4
17;2021-06-28;1523;5415;368231;228172;56.9;35.3
17;2021-06-29;1684;5889;369915;234061;57.2;36.2
17;2021-06-30;2030;5547;371945;239608;57.5;37.0
17;2021-07-01;2267;5560;374212;245168;57.8;37.9
17;2021-07-02;2485;5980;376697;251148;58.2;38.8
17;2021-07-03;627;2533;377324;253681;58.3;39.2
17;2021-07-04;155;1250;377479;254931;58.3;39.4
17;2021-07-05;1887;5176;379366;260107;58.6;40.2
17;2021-07-06;2129;5595;381495;265702;59.0;41.1
17;2021-07-07;2406;5498;383901;271200;59.3;41.9
17;2021-07-08;2915;5442;386816;276642;59.8;42.8
17;2021-07-09;2526;6073;389342;282715;60.2;43.7
17;2021-07-10;826;2469;390168;285184;60.3;44.1
17;2021-07-11;379;906;390547;286090;60.4;44.2
17;2021-07-12;2002;5617;392549;291707;60.7;45.1
17;2021-07-13;2372;6717;394921;298424;61.0;46.1
17;2021-07-14;71;71;394992;298495;61.0;46.1
17;2021-07-15;2191;6861;397183;305356;61.4;47.2
17;2021-07-16;2777;6964;399960;312320;61.8;48.3
17;2021-07-17;1051;2271;401011;314591;62.0;48.6
17;2021-07-18;312;1036;401323;315627;62.0;48.8
17;2021-07-19;2635;5903;403958;321530;62.4;49.7
17;2021-07-20;3314;6312;407272;327842;62.9;50.7
17;2021-07-21;3802;6023;411074;333865;63.5;51.6
17;2021-07-22;4248;6264;415322;340129;64.2;52.6
17;2021-07-23;3903;6562;419225;346691;64.8;53.6
17;2021-07-24;2067;1392;421292;348083;65.1;53.8
17;2021-07-25;1040;417;422332;348500;65.3;53.9
17;2021-07-26;3735;5425;426067;353925;65.8;54.7
17;2021-07-27;4728;5439;430795;359364;66.6;55.5
17;2021-07-28;5215;5162;436010;364526;67.4;56.3
17;2021-07-29;5166;5339;441176;369865;68.2;57.2
17;2021-07-30;5511;5572;446687;375437;69.0;58.0
17;2021-07-31;2116;1213;448803;376650;69.4;58.2
17;2021-08-01;1095;359;449898;377009;69.5;58.3
17;2021-08-02;4621;4392;454519;381401;70.2;58.9
17;2021-08-03;5762;4160;460281;385561;71.1;59.6
17;2021-08-04;6202;3379;466483;388940;72.1;60.1
17;2021-08-05;6389;3148;472872;392088;73.1;60.6
17;2021-08-06;5888;3600;478760;395688;74.0;61.1
17;2021-08-07;1992;867;480752;396555;74.3;61.3
17;2021-08-08;978;219;481730;396774;74.4;61.3
17;2021-08-09;3923;3689;485653;400463;75.1;61.9
17;2021-08-10;5087;3486;490740;403949;75.8;62.4
17;2021-08-11;4918;3812;495658;407761;76.6;63.0
17;2021-08-12;4896;3959;500554;411720;77.4;63.6
17;2021-08-13;4520;4142;505074;415862;78.1;64.3
17;2021-08-14;1239;1383;506313;417245;78.2;64.5
17;2021-08-15;407;375;506720;417620;78.3;64.5
17;2021-08-16;2854;4066;509574;421686;78.7;65.2
17;2021-08-17;3052;4291;512626;425977;79.2;65.8
17;2021-08-18;2622;4555;515248;430532;79.6;66.5
17;2021-08-19;2733;4372;517981;434904;80.0;67.2
17;2021-08-20;2501;5025;520482;439929;80.4;68.0
17;2021-08-21;684;1355;521166;441284;80.5;68.2
17;2021-08-22;217;457;521383;441741;80.6;68.3
17;2021-08-23;1987;4955;523370;446696;80.9;69.0
17;2021-08-24;1941;5091;525311;451787;81.2;69.8
17;2021-08-25;1659;5505;526970;457292;81.4;70.7
17;2021-08-26;1603;5761;528573;463053;81.7;71.6
17;2021-08-27;1551;5954;530124;469007;81.9;72.5
17;2021-08-28;521;1455;530645;470462;82.0;72.7
17;2021-08-29;87;575;530732;471037;82.0;72.8
17;2021-08-30;1436;5108;532168;476145;82.2;73.6
17;2021-08-31;1327;5356;533495;481501;82.4;74.4
17;2021-09-01;1196;5117;534691;486618;82.6;75.2
17;2021-09-02;1139;4548;535830;491166;82.8;75.9
17;2021-09-03;1168;5336;536998;496502;83.0;76.7
17;2021-09-04;287;971;537285;497473;83.0;76.9
17;2021-09-05;55;140;537340;497613;83.0;76.9
17;2021-09-06;729;3734;538069;501347;83.2;77.5
17;2021-09-07;717;3259;538786;504606;83.3;78.0
17;2021-09-08;822;4141;539608;508747;83.4;78.6
17;2021-09-09;816;3193;540424;511940;83.5;79.1
17;2021-09-10;800;3949;541224;515889;83.6;79.7
17;2021-09-11;304;1003;541528;516892;83.7;79.9
17;2021-09-12;10;23;541538;516915;83.7;79.9
17;2021-09-13;652;2800;542190;519715;83.8;80.3
17;2021-09-14;616;2749;542806;522464;83.9;80.7
17;2021-09-15;942;2376;543748;524840;84.0;81.1
17;2021-09-16;540;1453;544288;526293;84.1;81.3
17;2021-09-17;612;1921;544900;528214;84.2;81.6
17;2021-09-18;192;582;545092;528796;84.2;81.7
17;2021-09-19;12;6;545104;528802;84.2;81.7
17;2021-09-20;429;1226;545533;530028;84.3;81.9
17;2021-09-21;324;892;545857;530920;84.4;82.0
17;2021-09-22;419;1694;546276;532614;84.4;82.3
17;2021-09-23;357;971;546633;533585;84.5;82.5
17;2021-09-24;385;1821;547018;535406;84.5;82.7
17;2021-09-25;127;472;547145;535878;84.6;82.8
17;2021-09-26;0;16;547145;535894;84.6;82.8
17;2021-09-27;437;1176;547582;537070;84.6;83.0
17;2021-09-28;275;686;547857;537756;84.7;83.1
17;2021-09-29;453;1213;548310;538969;84.7;83.3
17;2021-09-30;372;714;548682;539683;84.8;83.4
17;2021-10-01;358;741;549040;540424;84.8;83.5
17;2021-10-02;107;309;549147;540733;84.9;83.6
17;2021-10-03;4;28;549151;540761;84.9;83.6
17;2021-10-04;365;859;549516;541620;84.9;83.7
17;2021-10-05;375;579;549891;542199;85.0;83.8
17;2021-10-06;419;1130;550310;543329;85.0;84.0
18;2020-12-27;0;0;0;0;0.0;0.0
18;2020-12-28;0;0;0;0;0.0;0.0
18;2020-12-29;0;0;0;0;0.0;0.0
18;2020-12-30;1;0;1;0;0.0;0.0
18;2020-12-31;0;0;1;0;0.0;0.0
18;2021-01-01;0;0;1;0;0.0;0.0
18;2021-01-02;0;0;1;0;0.0;0.0
18;2021-01-03;0;0;1;0;0.0;0.0
18;2021-01-04;3;0;4;0;0.0;0.0
18;2021-01-05;0;0;4;0;0.0;0.0
18;2021-01-06;1;0;5;0;0.0;0.0
18;2021-01-07;30;1;35;1;0.0;0.0
18;2021-01-08;65;0;100;1;0.0;0.0
18;2021-01-09;225;0;325;1;0.1;0.0
18;2021-01-10;146;0;471;1;0.2;0.0
18;2021-01-11;169;0;640;1;0.2;0.0
18;2021-01-12;371;0;1011;1;0.3;0.0
18;2021-01-13;270;1;1281;2;0.4;0.0
18;2021-01-14;269;2;1550;4;0.5;0.0
18;2021-01-15;332;2;1882;6;0.6;0.0
18;2021-01-16;288;2;2170;8;0.7;0.0
18;2021-01-17;1;0;2171;8;0.7;0.0
18;2021-01-18;291;0;2462;8;0.8;0.0
18;2021-01-19;1373;2;3835;10;1.3;0.0
18;2021-01-20;1239;2;5074;12;1.7;0.0
18;2021-01-21;965;0;6039;12;2.0;0.0
18;2021-01-22;780;2;6819;14;2.3;0.0
18;2021-01-23;249;2;7068;16;2.4;0.0
18;2021-01-24;0;0;7068;16;2.4;0.0
18;2021-01-25;509;0;7577;16;2.6;0.0
18;2021-01-26;395;1;7972;17;2.7;0.0
18;2021-01-27;390;2;8362;19;2.8;0.0
18;2021-01-28;566;8;8928;27;3.0;0.0
18;2021-01-29;491;73;9419;100;3.2;0.0
18;2021-01-30;431;135;9850;235;3.3;0.1
18;2021-01-31;82;97;9932;332;3.4;0.1
18;2021-02-01;328;119;10260;451;3.5;0.2
18;2021-02-02;507;227;10767;678;3.6;0.2
18;2021-02-03;398;201;11165;879;3.8;0.3
18;2021-02-04;630;226;11795;1105;4.0;0.4
18;2021-02-05;448;181;12243;1286;4.1;0.4
18;2021-02-06;283;88;12526;1374;4.2;0.5
18;2021-02-07;108;1;12634;1375;4.3;0.5
18;2021-02-08;268;189;12902;1564;4.4;0.5
18;2021-02-09;583;760;13485;2324;4.5;0.8
18;2021-02-10;741;628;14226;2952;4.8;1.0
18;2021-02-11;655;412;14881;3364;5.0;1.1
18;2021-02-12;502;303;15383;3667;5.2;1.2
18;2021-02-13;286;107;15669;3774;5.3;1.3
18;2021-02-14;364;97;16033;3871;5.4;1.3
18;2021-02-15;378;308;16411;4179;5.5;1.4
18;2021-02-16;399;327;16810;4506;5.7;1.5
18;2021-02-17;403;385;17213;4891;5.8;1.7
18;2021-02-18;344;456;17557;5347;5.9;1.8
18;2021-02-19;471;244;18028;5591;6.1;1.9
18;2021-02-20;721;191;18749;5782;6.3;2.0
18;2021-02-21;317;4;19066;5786;6.4;2.0
18;2021-02-22;218;293;19284;6079;6.5;2.1
18;2021-02-23;204;270;19488;6349;6.6;2.1
18;2021-02-24;241;200;19729;6549;6.7;2.2
18;2021-02-25;294;453;20023;7002;6.8;2.4
18;2021-02-26;583;191;20606;7193;7.0;2.4
18;2021-02-27;510;346;21116;7539;7.1;2.5
18;2021-02-28;7;66;21123;7605;7.1;2.6
18;2021-03-01;237;345;21360;7950;7.2;2.7
18;2021-03-02;284;462;21644;8412;7.3;2.8
18;2021-03-03;346;526;21990;8938;7.4;3.0
18;2021-03-04;475;520;22465;9458;7.6;3.2
18;2021-03-05;524;335;22989;9793;7.8;3.3
18;2021-03-06;1071;307;24060;10100;8.1;3.4
18;2021-03-07;7;131;24067;10231;8.1;3.5
18;2021-03-08;336;314;24403;10545;8.2;3.6
18;2021-03-09;411;328;24814;10873;8.4;3.7
18;2021-03-10;422;414;25236;11287;8.5;3.8
18;2021-03-11;518;384;25754;11671;8.7;3.9
18;2021-03-12;705;283;26459;11954;8.9;4.0
18;2021-03-13;1164;241;27623;12195;9.3;4.1
18;2021-03-14;301;214;27924;12409;9.4;4.2
18;2021-03-15;492;365;28416;12774;9.6;4.3
18;2021-03-16;392;302;28808;13076;9.7;4.4
18;2021-03-17;383;407;29191;13483;9.8;4.5
18;2021-03-18;512;220;29703;13703;10.0;4.6
18;2021-03-19;755;221;30458;13924;10.3;4.7
18;2021-03-20;986;614;31444;14538;10.6;4.9
18;2021-03-21;308;305;31752;14843;10.7;5.0
18;2021-03-22;602;292;32354;15135;10.9;5.1
18;2021-03-23;707;288;33061;15423;11.2;5.2
18;2021-03-24;1052;295;34113;15718;11.5;5.3
18;2021-03-25;1049;299;35162;16017;11.9;5.4
18;2021-03-26;1208;347;36370;16364;12.3;5.5
18;2021-03-27;1488;317;37858;16681;12.8;5.6
18;2021-03-28;215;0;38073;16681;12.8;5.6
18;2021-03-29;1102;197;39175;16878;13.2;5.7
18;2021-03-30;1084;302;40259;17180;13.6;5.8
18;2021-03-31;1305;252;41564;17432;14.0;5.9
18;2021-04-01;1375;348;42939;17780;14.5;6.0
18;2021-04-02;1229;309;44168;18089;14.9;6.1
18;2021-04-03;581;181;44749;18270;15.1;6.2
18;2021-04-04;71;5;44820;18275;15.1;6.2
18;2021-04-05;199;0;45019;18275;15.2;6.2
18;2021-04-06;1027;350;46046;18625;15.5;6.3
18;2021-04-07;1322;364;47368;18989;16.0;6.4
18;2021-04-08;1692;347;49060;19336;16.6;6.5
18;2021-04-09;1833;281;50893;19617;17.2;6.6
18;2021-04-10;2632;652;53525;20269;18.1;6.8
18;2021-04-11;1986;319;55511;20588;18.7;6.9
18;2021-04-12;1401;404;56912;20992;19.2;7.1
18;2021-04-13;1785;470;58697;21462;19.8;7.2
18;2021-04-14;1378;517;60075;21979;20.3;7.4
18;2021-04-15;1532;530;61607;22509;20.8;7.6
18;2021-04-16;1614;590;63221;23099;21.3;7.8
18;2021-04-17;1599;520;64820;23619;21.9;8.0
18;2021-04-18;377;232;65197;23851;22.0;8.0
18;2021-04-19;1317;592;66514;24443;22.4;8.2
18;2021-04-20;1446;715;67960;25158;22.9;8.5
18;2021-04-21;1270;908;69230;26066;23.4;8.8
18;2021-04-22;1403;703;70633;26769;23.8;9.0
18;2021-04-23;1387;734;72020;27503;24.3;9.3
18;2021-04-24;1355;1271;73375;28774;24.8;9.7
18;2021-04-25;287;217;73662;28991;24.9;9.8
18;2021-04-26;1205;955;74867;29946;25.3;10.1
18;2021-04-27;1544;765;76411;30711;25.8;10.4
18;2021-04-28;1358;876;77769;31587;26.2;10.7
18;2021-04-29;1851;735;79620;32322;26.9;10.9
18;2021-04-30;1569;992;81189;33314;27.4;11.2
18;2021-05-01;788;210;81977;33524;27.7;11.3
18;2021-05-02;806;61;82783;33585;27.9;11.3
18;2021-05-03;1627;1013;84410;34598;28.5;11.7
18;2021-05-04;1729;1283;86139;35881;29.1;12.1
18;2021-05-05;1735;1213;87874;37094;29.6;12.5
18;2021-05-06;2162;1363;90036;38457;30.4;13.0
18;2021-05-07;1234;1398;91270;39855;30.8;13.4
18;2021-05-08;994;1464;92264;41319;31.1;13.9
18;2021-05-09;500;2258;92764;43577;31.3;14.7
18;2021-05-10;1157;1508;93921;45085;31.7;15.2
18;2021-05-11;1696;1748;95617;46833;32.3;15.8
18;2021-05-12;1806;1495;97423;48328;32.9;16.3
18;2021-05-13;1061;370;98484;48698;33.2;16.4
18;2021-05-14;1345;942;99829;49640;33.7;16.7
18;2021-05-15;1809;1163;101638;50803;34.3;17.1
18;2021-05-16;537;581;102175;51384;34.5;17.3
18;2021-05-17;1245;1091;103420;52475;34.9;17.7
18;2021-05-18;2146;933;105566;53408;35.6;18.0
18;2021-05-19;2162;920;107728;54328;36.3;18.3
18;2021-05-20;2275;983;110003;55311;37.1;18.7
18;2021-05-21;1495;764;111498;56075;37.6;18.9
18;2021-05-22;1724;1072;113222;57147;38.2;19.3
18;2021-05-23;486;336;113708;57483;38.4;19.4
18;2021-05-24;461;293;114169;57776;38.5;19.5
18;2021-05-25;1841;1057;116010;58833;39.1;19.8
18;2021-05-26;2153;846;118163;59679;39.9;20.1
18;2021-05-27;2209;1228;120372;60907;40.6;20.5
18;2021-05-28;1712;1306;122084;62213;41.2;21.0
18;2021-05-29;2621;1661;124705;63874;42.1;21.5
18;2021-05-30;1482;504;126187;64378;42.6;21.7
18;2021-05-31;1785;693;127972;65071;43.2;22.0
18;2021-06-01;2039;947;130011;66018;43.9;22.3
18;2021-06-02;2010;1015;132021;67033;44.5;22.6
18;2021-06-03;2283;1199;134304;68232;45.3;23.0
18;2021-06-04;1912;1122;136216;69354;46.0;23.4
18;2021-06-05;2800;1445;139016;70799;46.9;23.9
18;2021-06-06;364;381;139380;71180;47.0;24.0
18;2021-06-07;1294;1232;140674;72412;47.5;24.4
18;2021-06-08;1490;1394;142164;73806;48.0;24.9
18;2021-06-09;1329;1068;143493;74874;48.4;25.3
18;2021-06-10;1631;1408;145124;76282;49.0;25.7
18;2021-06-11;1496;1404;146620;77686;49.5;26.2
18;2021-06-12;1245;2510;147865;80196;49.9;27.1
18;2021-06-13;126;262;147991;80458;49.9;27.1
18;2021-06-14;656;1828;148647;82286;50.2;27.8
18;2021-06-15;1093;1823;149740;84109;50.5;28.4
18;2021-06-16;1255;1441;150995;85550;50.9;28.9
18;2021-06-17;1205;1671;152200;87221;51.3;29.4
18;2021-06-18;1290;1665;153490;88886;51.8;30.0
18;2021-06-19;1564;1251;155054;90137;52.3;30.4
18;2021-06-20;246;159;155300;90296;52.4;30.5
18;2021-06-21;665;1601;155965;91897;52.6;31.0
18;2021-06-22;1068;1645;157033;93542;53.0;31.6
18;2021-06-23;944;1642;157977;95184;53.3;32.1
18;2021-06-24;1033;1062;159010;96246;53.6;32.5
18;2021-06-25;892;1745;159902;97991;53.9;33.1
18;2021-06-26;1097;1474;160999;99465;54.3;33.6
18;2021-06-27;31;372;161030;99837;54.3;33.7
18;2021-06-28;422;1922;161452;101759;54.5;34.3
18;2021-06-29;597;2378;162049;104137;54.7;35.1
18;2021-06-30;600;2543;162649;106680;54.9;36.0
18;2021-07-01;964;2155;163613;108835;55.2;36.7
18;2021-07-02;614;1685;164227;110520;55.4;37.3
18;2021-07-03;754;2572;164981;113092;55.7;38.2
18;2021-07-04;164;1032;165145;114124;55.7;38.5
18;2021-07-05;765;1877;165910;116001;56.0;39.1
18;2021-07-06;559;2300;166469;118301;56.2;39.9
18;2021-07-07;766;2115;167235;120416;56.4;40.6
18;2021-07-08;1032;1984;168267;122400;56.8;41.3
18;2021-07-09;703;2305;168970;124705;57.0;42.1
18;2021-07-10;781;3172;169751;127877;57.3;43.1
18;2021-07-11;84;667;169835;128544;57.3;43.4
18;2021-07-12;223;2253;170058;130797;57.4;44.1
18;2021-07-13;619;2904;170677;133701;57.6;45.1
18;2021-07-14;194;936;170871;134637;57.6;45.4
18;2021-07-15;1396;2815;172267;137452;58.1;46.4
18;2021-07-16;1185;2122;173452;139574;58.5;47.1
18;2021-07-17;1130;2470;174582;142044;58.9;47.9
18;2021-07-18;228;332;174810;142376;59.0;48.0
18;2021-07-19;1055;1657;175865;144033;59.3;48.6
18;2021-07-20;1625;2269;177490;146302;59.9;49.4
18;2021-07-21;1901;2061;179391;148363;60.5;50.1
18;2021-07-22;2211;1900;181602;150263;61.3;50.7
18;2021-07-23;1395;1612;182997;151875;61.7;51.2
18;2021-07-24;891;1532;183888;153407;62.0;51.8
18;2021-07-25;192;396;184080;153803;62.1;51.9
18;2021-07-26;1397;1502;185477;155305;62.6;52.4
18;2021-07-27;1824;1535;187301;156840;63.2;52.9
18;2021-07-28;2198;1796;189499;158636;63.9;53.5
18;2021-07-29;2140;1816;191639;160452;64.7;54.1
18;2021-07-30;1585;1344;193224;161796;65.2;54.6
18;2021-07-31;1237;1280;194461;163076;65.6;55.0
18;2021-08-01;90;34;194551;163110;65.6;55.0
18;2021-08-02;1410;765;195961;163875;66.1;55.3
18;2021-08-03;1719;1630;197680;165505;66.7;55.8
18;2021-08-04;2441;1102;200121;166607;67.5;56.2
18;2021-08-05;1529;1247;201650;167854;68.0;56.6
18;2021-08-06;1582;1140;203232;168994;68.6;57.0
18;2021-08-07;609;764;203841;169758;68.8;57.3
18;2021-08-08;49;60;203890;169818;68.8;57.3
18;2021-08-09;1105;874;204995;170692;69.2;57.6
18;2021-08-10;1208;1511;206203;172203;69.6;58.1
18;2021-08-11;1608;1510;207811;173713;70.1;58.6
18;2021-08-12;1554;1594;209365;175307;70.6;59.1
18;2021-08-13;1087;1172;210452;176479;71.0;59.5
18;2021-08-14;759;603;211211;177082;71.3;59.7
18;2021-08-15;35;17;211246;177099;71.3;59.7
18;2021-08-16;830;1201;212076;178300;71.5;60.2
18;2021-08-17;979;1999;213055;180299;71.9;60.8
18;2021-08-18;1158;1961;214213;182260;72.3;61.5
18;2021-08-19;1105;1612;215318;183872;72.6;62.0
18;2021-08-20;911;1758;216229;185630;73.0;62.6
18;2021-08-21;419;705;216648;186335;73.1;62.9
18;2021-08-22;22;73;216670;186408;73.1;62.9
18;2021-08-23;487;1680;217157;188088;73.3;63.5
18;2021-08-24;903;1494;218060;189582;73.6;64.0
18;2021-08-25;840;1864;218900;191446;73.9;64.6
18;2021-08-26;772;1532;219672;192978;74.1;65.1
18;2021-08-27;575;1995;220247;194973;74.3;65.8
18;2021-08-28;501;873;220748;195846;74.5;66.1
18;2021-08-29;92;176;220840;196022;74.5;66.1
18;2021-08-30;528;1443;221368;197465;74.7;66.6
18;2021-08-31;507;1443;221875;198908;74.9;67.1
18;2021-09-01;578;1643;222453;200551;75.1;67.7
18;2021-09-02;398;1268;222851;201819;75.2;68.1
18;2021-09-03;455;1305;223306;203124;75.3;68.5
18;2021-09-04;357;810;223663;203934;75.5;68.8
18;2021-09-05;29;80;223692;204014;75.5;68.8
18;2021-09-06;279;1090;223971;205104;75.6;69.2
18;2021-09-07;280;992;224251;206096;75.7;69.5
18;2021-09-08;403;1137;224654;207233;75.8;69.9
18;2021-09-09;356;1148;225010;208381;75.9;70.3
18;2021-09-10;411;1092;225421;209473;76.1;70.7
18;2021-09-11;262;866;225683;210339;76.1;71.0
18;2021-09-12;8;32;225691;210371;76.1;71.0
18;2021-09-13;310;860;226001;211231;76.2;71.3
18;2021-09-14;281;1015;226282;212246;76.3;71.6
18;2021-09-15;321;1053;226603;213299;76.5;72.0
18;2021-09-16;469;877;227072;214176;76.6;72.3
18;2021-09-17;337;737;227409;214913;76.7;72.5
18;2021-09-18;177;617;227586;215530;76.8;72.7
18;2021-09-19;6;4;227592;215534;76.8;72.7
18;2021-09-20;156;550;227748;216084;76.8;72.9
18;2021-09-21;111;423;227859;216507;76.9;73.0
18;2021-09-22;192;870;228051;217377;76.9;73.3
18;2021-09-23;249;466;228300;217843;77.0;73.5
18;2021-09-24;141;489;228441;218332;77.1;73.7
18;2021-09-25;159;690;228600;219022;77.1;73.9
18;2021-09-26;15;89;228615;219111;77.1;73.9
18;2021-09-27;109;315;228724;219426;77.2;74.0
18;2021-09-28;70;273;228794;219699;77.2;74.1
18;2021-09-29;68;280;228862;219979;77.2;74.2
18;2021-09-30;116;280;228978;220259;77.3;74.3
18;2021-10-01;142;289;229120;220548;77.3;74.4
18;2021-10-02;62;163;229182;220711;77.3;74.5
18;2021-10-03;6;10;229188;220721;77.3;74.5
18;2021-10-04;141;457;229329;221178;77.4;74.6
18;2021-10-05;161;335;229490;221513;77.4;74.7
18;2021-10-06;133;442;229623;221955;77.5;74.9
19;2020-12-27;0;0;0;0;0.0;0.0
19;2020-12-28;0;0;0;0;0.0;0.0
19;2020-12-29;1;0;1;0;0.0;0.0
19;2020-12-30;0;0;1;0;0.0;0.0
19;2020-12-31;0;0;1;0;0.0;0.0
19;2021-01-01;0;0;1;0;0.0;0.0
19;2021-01-02;0;0;1;0;0.0;0.0
19;2021-01-03;0;0;1;0;0.0;0.0
19;2021-01-04;0;0;1;0;0.0;0.0
19;2021-01-05;0;0;1;0;0.0;0.0
19;2021-01-06;0;0;1;0;0.0;0.0
19;2021-01-07;344;1;345;1;0.1;0.0
19;2021-01-08;248;1;593;2;0.2;0.0
19;2021-01-09;1;0;594;2;0.2;0.0
19;2021-01-10;1;0;595;2;0.2;0.0
19;2021-01-11;38;0;633;2;0.3;0.0
19;2021-01-12;416;1;1049;3;0.4;0.0
19;2021-01-13;429;3;1478;6;0.6;0.0
19;2021-01-14;475;0;1953;6;0.8;0.0
19;2021-01-15;226;0;2179;6;0.9;0.0
19;2021-01-16;0;0;2179;6;0.9;0.0
19;2021-01-17;1;0;2180;6;0.9;0.0
19;2021-01-18;251;2;2431;8;1.0;0.0
19;2021-01-19;521;0;2952;8;1.2;0.0
19;2021-01-20;921;7;3873;15;1.6;0.0
19;2021-01-21;507;4;4380;19;1.8;0.0
19;2021-01-22;1318;5;5698;24;2.4;0.0
19;2021-01-23;281;0;5979;24;2.5;0.0
19;2021-01-24;37;0;6016;24;2.5;0.0
19;2021-01-25;233;0;6249;24;2.6;0.0
19;2021-01-26;608;3;6857;27;2.9;0.0
19;2021-01-27;334;3;7191;30;3.0;0.0
19;2021-01-28;297;153;7488;183;3.1;0.1
19;2021-01-29;347;54;7835;237;3.3;0.1
19;2021-01-30;130;24;7965;261;3.3;0.1
19;2021-01-31;41;0;8006;261;3.3;0.1
19;2021-02-01;158;94;8164;355;3.4;0.1
19;2021-02-02;303;424;8467;779;3.5;0.3
19;2021-02-03;285;235;8752;1014;3.6;0.4
19;2021-02-04;255;363;9007;1377;3.7;0.6
19;2021-02-05;311;74;9318;1451;3.9;0.6
19;2021-02-06;215;2;9533;1453;4.0;0.6
19;2021-02-07;48;2;9581;1455;4.0;0.6
19;2021-02-08;177;92;9758;1547;4.1;0.6
19;2021-02-09;333;178;10091;1725;4.2;0.7
19;2021-02-10;517;222;10608;1947;4.4;0.8
19;2021-02-11;414;299;11022;2246;4.6;0.9
19;2021-02-12;799;1124;11821;3370;4.9;1.4
19;2021-02-13;352;140;12173;3510;5.1;1.5
19;2021-02-14;98;5;12271;3515;5.1;1.5
19;2021-02-15;200;213;12471;3728;5.2;1.6
19;2021-02-16;386;149;12857;3877;5.3;1.6
19;2021-02-17;306;392;13163;4269;5.5;1.8
19;2021-02-18;174;422;13337;4691;5.5;2.0
19;2021-02-19;469;257;13806;4948;5.7;2.1
19;2021-02-20;133;158;13939;5106;5.8;2.1
19;2021-02-21;20;33;13959;5139;5.8;2.1
19;2021-02-22;221;190;14180;5329;5.9;2.2
19;2021-02-23;268;311;14448;5640;6.0;2.3
19;2021-02-24;361;179;14809;5819;6.2;2.4
19;2021-02-25;519;342;15328;6161;6.4;2.6
19;2021-02-26;395;270;15723;6431;6.5;2.7
19;2021-02-27;348;133;16071;6564;6.7;2.7
19;2021-02-28;68;32;16139;6596;6.7;2.7
19;2021-03-01;266;196;16405;6792;6.8;2.8
19;2021-03-02;428;224;16833;7016;7.0;2.9
19;2021-03-03;692;303;17525;7319;7.3;3.0
19;2021-03-04;826;325;18351;7644;7.6;3.2
19;2021-03-05;891;667;19242;8311;8.0;3.5
19;2021-03-06;1072;174;20314;8485;8.5;3.5
19;2021-03-07;463;32;20777;8517;8.6;3.5
19;2021-03-08;640;135;21417;8652;8.9;3.6
19;2021-03-09;836;227;22253;8879;9.3;3.7
19;2021-03-10;1155;276;23408;9155;9.7;3.8
19;2021-03-11;1274;291;24682;9446;10.3;3.9
19;2021-03-12;1136;379;25818;9825;10.7;4.1
19;2021-03-13;1110;160;26928;9985;11.2;4.2
19;2021-03-14;161;80;27089;10065;11.3;4.2
19;2021-03-15;699;131;27788;10196;11.6;4.2
19;2021-03-16;688;298;28476;10494;11.8;4.4
19;2021-03-17;839;277;29315;10771;12.2;4.5
19;2021-03-18;767;279;30082;11050;12.5;4.6
19;2021-03-19;1014;484;31096;11534;12.9;4.8
19;2021-03-20;784;131;31880;11665;13.3;4.9
19;2021-03-21;128;3;32008;11668;13.3;4.9
19;2021-03-22;548;174;32556;11842;13.5;4.9
19;2021-03-23;1045;229;33601;12071;14.0;5.0
19;2021-03-24;1172;371;34773;12442;14.5;5.2
19;2021-03-25;1189;404;35962;12846;15.0;5.3
19;2021-03-26;1325;274;37287;13120;15.5;5.5
19;2021-03-27;854;185;38141;13305;15.9;5.5
19;2021-03-28;63;60;38204;13365;15.9;5.6
19;2021-03-29;612;176;38816;13541;16.2;5.6
19;2021-03-30;971;343;39787;13884;16.6;5.8
19;2021-03-31;1157;490;40944;14374;17.0;6.0
19;2021-04-01;1491;425;42435;14799;17.7;6.2
19;2021-04-02;1008;522;43443;15321;18.1;6.4
19;2021-04-03;597;283;44040;15604;18.3;6.5
19;2021-04-04;130;3;44170;15607;18.4;6.5
19;2021-04-05;40;75;44210;15682;18.4;6.5
19;2021-04-06;734;602;44944;16284;18.7;6.8
19;2021-04-07;976;732;45920;17016;19.1;7.1
19;2021-04-08;1116;1016;47036;18032;19.6;7.5
19;2021-04-09;1641;615;48677;18647;20.3;7.8
19;2021-04-10;946;557;49623;19204;20.6;8.0
19;2021-04-11;557;74;50180;19278;20.9;8.0
19;2021-04-12;681;521;50861;19799;21.2;8.2
19;2021-04-13;915;575;51776;20374;21.5;8.5
19;2021-04-14;1333;844;53109;21218;22.1;8.8
19;2021-04-15;1229;871;54338;22089;22.6;9.2
19;2021-04-16;1506;819;55844;22908;23.2;9.5
19;2021-04-17;761;479;56605;23387;23.6;9.7
19;2021-04-18;661;69;57266;23456;23.8;9.8
19;2021-04-19;730;439;57996;23895;24.1;9.9
19;2021-04-20;979;748;58975;24643;24.5;10.3
19;2021-04-21;1271;698;60246;25341;25.1;10.5
19;2021-04-22;1188;898;61434;26239;25.6;10.9
19;2021-04-23;1127;1020;62561;27259;26.0;11.3
19;2021-04-24;678;676;63239;27935;26.3;11.6
19;2021-04-25;675;70;63914;28005;26.6;11.7
19;2021-04-26;1056;332;64970;28337;27.0;11.8
19;2021-04-27;1027;568;65997;28905;27.5;12.0
19;2021-04-28;1553;555;67550;29460;28.1;12.3
19;2021-04-29;1453;1181;69003;30641;28.7;12.7
19;2021-04-30;1876;1056;70879;31697;29.5;13.2
19;2021-05-01;671;173;71550;31870;29.8;13.3
19;2021-05-02;551;152;72101;32022;30.0;13.3
19;2021-05-03;854;547;72955;32569;30.4;13.6
19;2021-05-04;1025;707;73980;33276;30.8;13.8
19;2021-05-05;1256;741;75236;34017;31.3;14.2
19;2021-05-06;1127;1194;76363;35211;31.8;14.7
19;2021-05-07;1663;1190;78026;36401;32.5;15.1
19;2021-05-08;712;205;78738;36606;32.8;15.2
19;2021-05-09;487;547;79225;37153;33.0;15.5
19;2021-05-10;1164;665;80389;37818;33.4;15.7
19;2021-05-11;1639;856;82028;38674;34.1;16.1
19;2021-05-12;1945;1319;83973;39993;34.9;16.6
19;2021-05-13;571;242;84544;40235;35.2;16.7
19;2021-05-14;1646;987;86190;41222;35.9;17.2
19;2021-05-15;1443;592;87633;41814;36.5;17.4
19;2021-05-16;350;82;87983;41896;36.6;17.4
19;2021-05-17;1498;559;89481;42455;37.2;17.7
19;2021-05-18;1669;498;91150;42953;37.9;17.9
19;2021-05-19;2009;822;93159;43775;38.8;18.2
19;2021-05-20;1722;892;94881;44667;39.5;18.6
19;2021-05-21;1964;814;96845;45481;40.3;18.9
19;2021-05-22;1271;651;98116;46132;40.8;19.2
19;2021-05-23;324;131;98440;46263;41.0;19.2
19;2021-05-24;139;46;98579;46309;41.0;19.3
19;2021-05-25;1503;492;100082;46801;41.6;19.5
19;2021-05-26;1924;666;102006;47467;42.4;19.8
19;2021-05-27;1786;835;103792;48302;43.2;20.1
19;2021-05-28;1937;990;105729;49292;44.0;20.5
19;2021-05-29;1375;705;107104;49997;44.6;20.8
19;2021-05-30;191;495;107295;50492;44.6;21.0
19;2021-05-31;1199;537;108494;51029;45.1;21.2
19;2021-06-01;1284;886;109778;51915;45.7;21.6
19;2021-06-02;1816;952;111594;52867;46.4;22.0
19;2021-06-03;1447;1251;113041;54118;47.0;22.5
19;2021-06-04;1848;1349;114889;55467;47.8;23.1
19;2021-06-05;1210;815;116099;56282;48.3;23.4
19;2021-06-06;87;648;116186;56930;48.3;23.7
19;2021-06-07;922;934;117108;57864;48.7;24.1
19;2021-06-08;1103;906;118211;58770;49.2;24.5
19;2021-06-09;1328;1459;119539;60229;49.7;25.1
19;2021-06-10;1283;1580;120822;61809;50.3;25.7
19;2021-06-11;1306;1917;122128;63726;50.8;26.5
19;2021-06-12;1356;1314;123484;65040;51.4;27.1
19;2021-06-13;542;424;124026;65464;51.6;27.2
19;2021-06-14;736;1016;124762;66480;51.9;27.7
19;2021-06-15;979;1143;125741;67623;52.3;28.1
19;2021-06-16;1222;1363;126963;68986;52.8;28.7
19;2021-06-17;868;1788;127831;70774;53.2;29.4
19;2021-06-18;1056;2134;128887;72908;53.6;30.3
19;2021-06-19;919;1302;129806;74210;54.0;30.9
19;2021-06-20;395;327;130201;74537;54.2;31.0
19;2021-06-21;500;1074;130701;75611;54.4;31.5
19;2021-06-22;698;1490;131399;77101;54.7;32.1
19;2021-06-23;744;1989;132143;79090;55.0;32.9
19;2021-06-24;687;1663;132830;80753;55.3;33.6
19;2021-06-25;562;2216;133392;82969;55.5;34.5
19;2021-06-26;474;1741;133866;84710;55.7;35.2
19;2021-06-27;289;446;134155;85156;55.8;35.4
19;2021-06-28;315;1499;134470;86655;56.0;36.1
19;2021-06-29;353;1893;134823;88548;56.1;36.8
19;2021-06-30;795;2152;135618;90700;56.4;37.7
19;2021-07-01;361;2322;135979;93022;56.6;38.7
19;2021-07-02;798;2316;136777;95338;56.9;39.7
19;2021-07-03;513;1744;137290;97082;57.1;40.4
19;2021-07-04;1;73;137291;97155;57.1;40.4
19;2021-07-05;600;1015;137891;98170;57.4;40.8
19;2021-07-06;504;1539;138395;99709;57.6;41.5
19;2021-07-07;706;2046;139101;101755;57.9;42.3
19;2021-07-08;770;2148;139871;103903;58.2;43.2
19;2021-07-09;716;2659;140587;106562;58.5;44.3
19;2021-07-10;586;1705;141173;108267;58.7;45.0
19;2021-07-11;45;212;141218;108479;58.8;45.1
19;2021-07-12;445;1486;141663;109965;58.9;45.8
19;2021-07-13;687;1828;142350;111793;59.2;46.5
19;2021-07-14;201;272;142551;112065;59.3;46.6
19;2021-07-15;870;2050;143421;114115;59.7;47.5
19;2021-07-16;1228;2445;144649;116560;60.2;48.5
19;2021-07-17;703;1718;145352;118278;60.5;49.2
19;2021-07-18;365;672;145717;118950;60.6;49.5
19;2021-07-19;968;1398;146685;120348;61.0;50.1
19;2021-07-20;967;1674;147652;122022;61.4;50.8
19;2021-07-21;1083;1710;148735;123732;61.9;51.5
19;2021-07-22;1392;1854;150127;125586;62.5;52.3
19;2021-07-23;1784;1995;151911;127581;63.2;53.1
19;2021-07-24;908;1753;152819;129334;63.6;53.8
19;2021-07-25;164;513;152983;129847;63.7;54.0
19;2021-07-26;911;911;153894;130758;64.0;54.4
19;2021-07-27;1425;1116;155319;131874;64.6;54.9
19;2021-07-28;2045;1221;157364;133095;65.5;55.4
19;2021-07-29;1623;1204;158987;134299;66.2;55.9
19;2021-07-30;1909;1027;160896;135326;66.9;56.3
19;2021-07-31;1129;1018;162025;136344;67.4;56.7
19;2021-08-01;347;372;162372;136716;67.6;56.9
19;2021-08-02;1194;809;163566;137525;68.1;57.2
19;2021-08-03;1453;1055;165019;138580;68.7;57.7
19;2021-08-04;1983;763;167002;139343;69.5;58.0
19;2021-08-05;1630;958;168632;140301;70.2;58.4
19;2021-08-06;1962;1217;170594;141518;71.0;58.9
19;2021-08-07;1335;1001;171929;142519;71.5;59.3
19;2021-08-08;187;234;172116;142753;71.6;59.4
19;2021-08-09;1008;784;173124;143537;72.0;59.7
19;2021-08-10;1280;1013;174404;144550;72.6;60.1
19;2021-08-11;1356;1006;175760;145556;73.1;60.6
19;2021-08-12;1016;1275;176776;146831;73.6;61.1
19;2021-08-13;1181;1275;177957;148106;74.0;61.6
19;2021-08-14;979;1164;178936;149270;74.5;62.1
19;2021-08-15;30;54;178966;149324;74.5;62.1
19;2021-08-16;592;1029;179558;150353;74.7;62.6
19;2021-08-17;633;1167;180191;151520;75.0;63.0
19;2021-08-18;656;979;180847;152499;75.2;63.5
19;2021-08-19;438;1258;181285;153757;75.4;64.0
19;2021-08-20;867;1927;182152;155684;75.8;64.8
19;2021-08-21;495;1376;182647;157060;76.0;65.4
19;2021-08-22;52;93;182699;157153;76.0;65.4
19;2021-08-23;226;1158;182925;158311;76.1;65.9
19;2021-08-24;538;1317;183463;159628;76.3;66.4
19;2021-08-25;649;1557;184112;161185;76.6;67.1
19;2021-08-26;477;1463;184589;162648;76.8;67.7
19;2021-08-27;502;1690;185091;164338;77.0;68.4
19;2021-08-28;360;1277;185451;165615;77.2;68.9
19;2021-08-29;60;182;185511;165797;77.2;69.0
19;2021-08-30;225;1095;185736;166892;77.3;69.4
19;2021-08-31;326;1454;186062;168346;77.4;70.0
19;2021-09-01;365;1480;186427;169826;77.6;70.7
19;2021-09-02;346;1318;186773;171144;77.7;71.2
19;2021-09-03;412;1515;187185;172659;77.9;71.8
19;2021-09-04;302;1395;187487;174054;78.0;72.4
19;2021-09-05;32;245;187519;174299;78.0;72.5
19;2021-09-06;197;697;187716;174996;78.1;72.8
19;2021-09-07;229;822;187945;175818;78.2;73.2
19;2021-09-08;287;934;188232;176752;78.3;73.5
19;2021-09-09;253;618;188485;177370;78.4;73.8
19;2021-09-10;252;853;188737;178223;78.5;74.2
19;2021-09-11;294;1156;189031;179379;78.7;74.6
19;2021-09-12;42;151;189073;179530;78.7;74.7
19;2021-09-13;106;437;189179;179967;78.7;74.9
19;2021-09-14;170;614;189349;180581;78.8;75.1
19;2021-09-15;244;669;189593;181250;78.9;75.4
19;2021-09-16;230;411;189823;181661;79.0;75.6
19;2021-09-17;254;531;190077;182192;79.1;75.8
19;2021-09-18;183;689;190260;182881;79.2;76.1
19;2021-09-19;17;34;190277;182915;79.2;76.1
19;2021-09-20;112;205;190389;183120;79.2;76.2
19;2021-09-21;143;295;190532;183415;79.3;76.3
19;2021-09-22;152;398;190684;183813;79.3;76.5
19;2021-09-23;87;300;190771;184113;79.4;76.6
19;2021-09-24;123;360;190894;184473;79.4;76.8
19;2021-09-25;140;568;191034;185041;79.5;77.0
19;2021-09-26;14;25;191048;185066;79.5;77.0
19;2021-09-27;43;215;191091;185281;79.5;77.1
19;2021-09-28;67;202;191158;185483;79.5;77.2
19;2021-09-29;82;341;191240;185824;79.6;77.3
19;2021-09-30;104;272;191344;186096;79.6;77.4
19;2021-10-01;115;233;191459;186329;79.7;77.5
19;2021-10-02;151;340;191610;186669;79.7;77.7
19;2021-10-03;9;11;191619;186680;79.7;77.7
19;2021-10-04;56;134;191675;186814;79.8;77.7
19;2021-10-05;99;186;191774;187000;79.8;77.8
19;2021-10-06;106;248;191880;187248;79.8;77.9
21;2020-12-27;4;0;4;0;0.0;0.0
21;2020-12-28;2;0;6;0;0.0;0.0
21;2020-12-29;19;0;25;0;0.0;0.0
21;2020-12-30;22;0;47;0;0.0;0.0
21;2020-12-31;0;0;47;0;0.0;0.0
21;2021-01-01;0;0;47;0;0.0;0.0
21;2021-01-02;1;0;48;0;0.0;0.0
21;2021-01-03;1;0;49;0;0.0;0.0
21;2021-01-04;22;0;71;0;0.0;0.0
21;2021-01-05;250;2;321;2;0.1;0.0
21;2021-01-06;300;0;621;2;0.1;0.0
21;2021-01-07;389;0;1010;2;0.2;0.0
21;2021-01-08;455;2;1465;4;0.3;0.0
21;2021-01-09;252;0;1717;4;0.3;0.0
21;2021-01-10;2;0;1719;4;0.3;0.0
21;2021-01-11;624;1;2343;5;0.4;0.0
21;2021-01-12;655;0;2998;5;0.6;0.0
21;2021-01-13;706;2;3704;7;0.7;0.0
21;2021-01-14;1190;6;4894;13;0.9;0.0
21;2021-01-15;719;5;5613;18;1.1;0.0
21;2021-01-16;162;0;5775;18;1.1;0.0
21;2021-01-17;5;0;5780;18;1.1;0.0
21;2021-01-18;1318;4;7098;22;1.3;0.0
21;2021-01-19;1370;1;8468;23;1.6;0.0
21;2021-01-20;1301;45;9769;68;1.8;0.0
21;2021-01-21;1544;4;11313;72;2.1;0.0
21;2021-01-22;1246;5;12559;77;2.4;0.0
21;2021-01-23;490;0;13049;77;2.4;0.0
21;2021-01-24;124;0;13173;77;2.5;0.0
21;2021-01-25;928;18;14101;95;2.6;0.0
21;2021-01-26;1542;135;15643;230;2.9;0.0
21;2021-01-27;2061;145;17704;375;3.3;0.1
21;2021-01-28;1460;216;19164;591;3.6;0.1
21;2021-01-29;1022;209;20186;800;3.8;0.2
21;2021-01-30;470;26;20656;826;3.9;0.2
21;2021-01-31;97;3;20753;829;3.9;0.2
21;2021-02-01;453;280;21206;1109;4.0;0.2
21;2021-02-02;456;428;21662;1537;4.1;0.3
21;2021-02-03;446;271;22108;1808;4.1;0.3
21;2021-02-04;417;524;22525;2332;4.2;0.4
21;2021-02-05;489;448;23014;2780;4.3;0.5
21;2021-02-06;162;218;23176;2998;4.3;0.6
21;2021-02-07;2;2;23178;3000;4.3;0.6
21;2021-02-08;433;367;23611;3367;4.4;0.6
21;2021-02-09;515;466;24126;3833;4.5;0.7
21;2021-02-10;461;541;24587;4374;4.6;0.8
21;2021-02-11;486;713;25073;5087;4.7;1.0
21;2021-02-12;356;825;25429;5912;4.8;1.1
21;2021-02-13;365;243;25794;6155;4.8;1.2
21;2021-02-14;239;130;26033;6285;4.9;1.2
21;2021-02-15;120;1096;26153;7381;4.9;1.4
21;2021-02-16;207;1307;26360;8688;4.9;1.6
21;2021-02-17;402;1760;26762;10448;5.0;2.0
21;2021-02-18;604;1179;27366;11627;5.1;2.2
21;2021-02-19;218;990;27584;12617;5.2;2.4
21;2021-02-20;121;326;27705;12943;5.2;2.4
21;2021-02-21;1;83;27706;13026;5.2;2.4
21;2021-02-22;84;654;27790;13680;5.2;2.6
21;2021-02-23;170;884;27960;14564;5.2;2.7
21;2021-02-24;226;609;28186;15173;5.3;2.8
21;2021-02-25;647;715;28833;15888;5.4;3.0
21;2021-02-26;926;601;29759;16489;5.6;3.1
21;2021-02-27;532;241;30291;16730;5.7;3.1
21;2021-02-28;24;111;30315;16841;5.7;3.2
21;2021-03-01;679;522;30994;17363;5.8;3.3
21;2021-03-02;1055;490;32049;17853;6.0;3.4
21;2021-03-03;1169;381;33218;18234;6.2;3.4
21;2021-03-04;1689;472;34907;18706;6.6;3.5
21;2021-03-05;2196;626;37103;19332;7.0;3.6
21;2021-03-06;1595;189;38698;19521;7.3;3.7
21;2021-03-07;4;15;38702;19536;7.3;3.7
21;2021-03-08;772;411;39474;19947;7.4;3.7
21;2021-03-09;1571;527;41045;20474;7.7;3.8
21;2021-03-10;1627;524;42672;20998;8.0;3.9
21;2021-03-11;2197;670;44869;21668;8.4;4.1
21;2021-03-12;2905;430;47774;22098;9.0;4.1
21;2021-03-13;1932;155;49706;22253;9.3;4.2
21;2021-03-14;38;41;49744;22294;9.3;4.2
21;2021-03-15;1415;87;51159;22381;9.6;4.2
21;2021-03-16;1883;152;53042;22533;10.0;4.2
21;2021-03-17;1810;112;54852;22645;10.3;4.2
21;2021-03-18;2127;260;56979;22905;10.7;4.3
21;2021-03-19;1964;148;58943;23053;11.1;4.3
21;2021-03-20;1228;38;60171;23091;11.3;4.3
21;2021-03-21;2;0;60173;23091;11.3;4.3
21;2021-03-22;1556;92;61729;23183;11.6;4.4
21;2021-03-23;2696;105;64425;23288;12.1;4.4
21;2021-03-24;2895;163;67320;23451;12.6;4.4
21;2021-03-25;3731;246;71051;23697;13.3;4.4
21;2021-03-26;3655;197;74706;23894;14.0;4.5
21;2021-03-27;1732;60;76438;23954;14.3;4.5
21;2021-03-28;200;38;76638;23992;14.4;4.5
21;2021-03-29;1788;511;78426;24503;14.7;4.6
21;2021-03-30;2347;797;80773;25300;15.2;4.7
21;2021-03-31;2718;644;83491;25944;15.7;4.9
21;2021-04-01;2694;720;86185;26664;16.2;5.0
21;2021-04-02;2249;742;88434;27406;16.6;5.1
21;2021-04-03;1018;280;89452;27686;16.8;5.2
21;2021-04-04;2;12;89454;27698;16.8;5.2
21;2021-04-05;9;0;89463;27698;16.8;5.2
21;2021-04-06;1357;1135;90820;28833;17.0;5.4
21;2021-04-07;1750;968;92570;29801;17.4;5.6
21;2021-04-08;3217;1144;95787;30945;18.0;5.8
21;2021-04-09;3481;1185;99268;32130;18.6;6.0
21;2021-04-10;1374;729;100642;32859;18.9;6.2
21;2021-04-11;145;3;100787;32862;18.9;6.2
21;2021-04-12;1117;1344;101904;34206;19.1;6.4
21;2021-04-13;1655;1778;103559;35984;19.4;6.8
21;2021-04-14;1484;1467;105043;37451;19.7;7.0
21;2021-04-15;1900;1590;106943;39041;20.1;7.3
21;2021-04-16;2322;1310;109265;40351;20.5;7.6
21;2021-04-17;1020;973;110285;41324;20.7;7.8
21;2021-04-18;15;4;110300;41328;20.7;7.8
21;2021-04-19;1110;1318;111410;42646;20.9;8.0
21;2021-04-20;1244;1833;112654;44479;21.1;8.3
21;2021-04-21;1095;1720;113749;46199;21.3;8.7
21;2021-04-22;1275;2210;115024;48409;21.6;9.1
21;2021-04-23;1984;1723;117008;50132;22.0;9.4
21;2021-04-24;1001;871;118009;51003;22.1;9.6
21;2021-04-25;9;168;118018;51171;22.1;9.6
21;2021-04-26;1013;1592;119031;52763;22.3;9.9
21;2021-04-27;1842;1932;120873;54695;22.7;10.3
21;2021-04-28;2230;2221;123103;56916;23.1;10.7
21;2021-04-29;3135;2251;126238;59167;23.7;11.1
21;2021-04-30;3563;1821;129801;60988;24.4;11.4
21;2021-05-01;962;225;130763;61213;24.5;11.5
21;2021-05-02;2;5;130765;61218;24.5;11.5
21;2021-05-03;2081;1350;132846;62568;24.9;11.7
21;2021-05-04;2577;1639;135423;64207;25.4;12.0
21;2021-05-05;2247;1691;137670;65898;25.8;12.4
21;2021-05-06;3015;2246;140685;68144;26.4;12.8
21;2021-05-07;2805;2169;143490;70313;26.9;13.2
21;2021-05-08;1067;271;144557;70584;27.1;13.2
21;2021-05-09;26;177;144583;70761;27.1;13.3
21;2021-05-10;3169;1728;147752;72489;27.7;13.6
21;2021-05-11;4923;2002;152675;74491;28.7;14.0
21;2021-05-12;4805;1747;157480;76238;29.6;14.3
21;2021-05-13;3845;368;161325;76606;30.3;14.4
21;2021-05-14;5197;1469;166522;78075;31.2;14.7
21;2021-05-15;3428;647;169950;78722;31.9;14.8
21;2021-05-16;49;4;169999;78726;31.9;14.8
21;2021-05-17;4128;1255;174127;79981;32.7;15.0
21;2021-05-18;4359;1500;178486;81481;33.5;15.3
21;2021-05-19;3470;1124;181956;82605;34.1;15.5
21;2021-05-20;3898;1359;185854;83964;34.9;15.8
21;2021-05-21;3628;2154;189482;86118;35.6;16.2
21;2021-05-22;1669;768;191151;86886;35.9;16.3
21;2021-05-23;4;17;191155;86903;35.9;16.3
21;2021-05-24;1815;266;192970;87169;36.2;16.4
21;2021-05-25;2648;1960;195618;89129;36.7;16.7
21;2021-05-26;2604;2000;198222;91129;37.2;17.1
21;2021-05-27;4014;2087;202236;93216;38.0;17.5
21;2021-05-28;3572;2813;205808;96029;38.6;18.0
21;2021-05-29;1932;1468;207740;97497;39.0;18.3
21;2021-05-30;98;13;207838;97510;39.0;18.3
21;2021-05-31;2501;1776;210339;99286;39.5;18.6
21;2021-06-01;3449;2248;213788;101534;40.1;19.1
21;2021-06-02;2617;1757;216405;103291;40.6;19.4
21;2021-06-03;3146;2075;219551;105366;41.2;19.8
21;2021-06-04;3286;2586;222837;107952;41.8;20.3
21;2021-06-05;2922;1654;225759;109606;42.4;20.6
21;2021-06-06;51;85;225810;109691;42.4;20.6
21;2021-06-07;4314;1344;230124;111035;43.2;20.8
21;2021-06-08;4935;2144;235059;113179;44.1;21.2
21;2021-06-09;4500;1625;239559;114804;45.0;21.5
21;2021-06-10;3933;2595;243492;117399;45.7;22.0
21;2021-06-11;4164;3095;247656;120494;46.5;22.6
21;2021-06-12;2199;1606;249855;122100;46.9;22.9
21;2021-06-13;29;11;249884;122111;46.9;22.9
21;2021-06-14;2197;2563;252081;124674;47.3;23.4
21;2021-06-15;2958;3088;255039;127762;47.9;24.0
21;2021-06-16;2850;2609;257889;130371;48.4;24.5
21;2021-06-17;3422;3040;261311;133411;49.0;25.0
21;2021-06-18;2424;3796;263735;137207;49.5;25.7
21;2021-06-19;2045;1863;265780;139070;49.9;26.1
21;2021-06-20;26;13;265806;139083;49.9;26.1
21;2021-06-21;1840;3404;267646;142487;50.2;26.7
21;2021-06-22;1885;5828;269531;148315;50.6;27.8
21;2021-06-23;2030;5011;271561;153326;51.0;28.8
21;2021-06-24;2367;4663;273928;157989;51.4;29.6
21;2021-06-25;1530;5894;275458;163883;51.7;30.8
21;2021-06-26;1441;3898;276899;167781;52.0;31.5
21;2021-06-27;18;125;276917;167906;52.0;31.5
21;2021-06-28;1397;4014;278314;171920;52.2;32.3
21;2021-06-29;1633;4172;279947;176092;52.5;33.0
21;2021-06-30;1568;3372;281515;179464;52.8;33.7
21;2021-07-01;1663;4147;283178;183611;53.1;34.5
21;2021-07-02;2179;4229;285357;187840;53.5;35.2
21;2021-07-03;1096;2101;286453;189941;53.8;35.6
21;2021-07-04;37;55;286490;189996;53.8;35.7
21;2021-07-05;1611;3627;288101;193623;54.1;36.3
21;2021-07-06;1349;3580;289450;197203;54.3;37.0
21;2021-07-07;1455;3240;290905;200443;54.6;37.6
21;2021-07-08;1884;4159;292789;204602;54.9;38.4
21;2021-07-09;2081;4346;294870;208948;55.3;39.2
21;2021-07-10;1089;2546;295959;211494;55.5;39.7
21;2021-07-11;21;74;295980;211568;55.5;39.7
21;2021-07-12;1656;3727;297636;215295;55.9;40.4
21;2021-07-13;2343;4885;299979;220180;56.3;41.3
21;2021-07-14;2874;2017;302853;222197;56.8;41.7
21;2021-07-15;3814;4550;306667;226747;57.5;42.6
21;2021-07-16;3890;5250;310557;231997;58.3;43.5
21;2021-07-17;2775;4168;313332;236165;58.8;44.3
21;2021-07-18;157;82;313489;236247;58.8;44.3
21;2021-07-19;2375;4624;315864;240871;59.3;45.2
21;2021-07-20;2760;5485;318624;246356;59.8;46.2
21;2021-07-21;2908;4786;321532;251142;60.3;47.1
21;2021-07-22;3026;4719;324558;255861;60.9;48.0
21;2021-07-23;4352;4896;328910;260757;61.7;48.9
21;2021-07-24;3034;3020;331944;263777;62.3;49.5
21;2021-07-25;68;40;332012;263817;62.3;49.5
21;2021-07-26;2663;3588;334675;267405;62.8;50.2
21;2021-07-27;3412;3772;338087;271177;63.4;50.9
21;2021-07-28;3574;3354;341661;274531;64.1;51.5
21;2021-07-29;4135;3364;345796;277895;64.9;52.1
21;2021-07-30;4622;3346;350418;281241;65.8;52.8
21;2021-07-31;3427;2378;353845;283619;66.4;53.2
21;2021-08-01;331;57;354176;283676;66.5;53.2
21;2021-08-02;2540;3167;356716;286843;66.9;53.8
21;2021-08-03;2624;2761;359340;289604;67.4;54.3
21;2021-08-04;2364;2487;361704;292091;67.9;54.8
21;2021-08-05;2219;3078;363923;295169;68.3;55.4
21;2021-08-06;2590;3308;366513;298477;68.8;56.0
21;2021-08-07;1905;2660;368418;301137;69.1;56.5
21;2021-08-08;75;70;368493;301207;69.2;56.5
21;2021-08-09;1650;2930;370143;304137;69.5;57.1
21;2021-08-10;1413;2715;371556;306852;69.7;57.6
21;2021-08-11;1666;2446;373222;309298;70.0;58.0
21;2021-08-12;1176;2419;374398;311717;70.3;58.5
21;2021-08-13;1523;2747;375921;314464;70.5;59.0
21;2021-08-14;860;2435;376781;316899;70.7;59.5
21;2021-08-15;51;64;376832;316963;70.7;59.5
21;2021-08-16;1400;2823;378232;319786;71.0;60.0
21;2021-08-17;1205;2775;379437;322561;71.2;60.5
21;2021-08-18;1029;2872;380466;325433;71.4;61.1
21;2021-08-19;957;3068;381423;328501;71.6;61.6
21;2021-08-20;1064;4192;382487;332693;71.8;62.4
21;2021-08-21;844;3143;383331;335836;71.9;63.0
21;2021-08-22;35;117;383366;335953;71.9;63.0
21;2021-08-23;938;3220;384304;339173;72.1;63.6
21;2021-08-24;988;2877;385292;342050;72.3;64.2
21;2021-08-25;870;2551;386162;344601;72.5;64.7
21;2021-08-26;728;2426;386890;347027;72.6;65.1
21;2021-08-27;1035;3398;387925;350425;72.8;65.8
21;2021-08-28;711;2757;388636;353182;72.9;66.3
21;2021-08-29;48;215;388684;353397;72.9;66.3
21;2021-08-30;790;2270;389474;355667;73.1;66.7
21;2021-08-31;944;2107;390418;357774;73.3;67.1
21;2021-09-01;625;1783;391043;359557;73.4;67.5
21;2021-09-02;548;1462;391591;361019;73.5;67.7
21;2021-09-03;787;2034;392378;363053;73.6;68.1
21;2021-09-04;751;1676;393129;364729;73.8;68.4
21;2021-09-05;69;107;393198;364836;73.8;68.5
21;2021-09-06;410;1478;393608;366314;73.9;68.7
21;2021-09-07;391;1311;393999;367625;73.9;69.0
21;2021-09-08;554;1606;394553;369231;74.0;69.3
21;2021-09-09;399;1382;394952;370613;74.1;69.5
21;2021-09-10;669;1766;395621;372379;74.2;69.9
21;2021-09-11;472;1462;396093;373841;74.3;70.2
21;2021-09-12;20;36;396113;373877;74.3;70.2
21;2021-09-13;253;892;396366;374769;74.4;70.3
21;2021-09-14;467;1320;396833;376089;74.5;70.6
21;2021-09-15;485;905;397318;376994;74.6;70.7
21;2021-09-16;339;759;397657;377753;74.6;70.9
21;2021-09-17;549;1056;398206;378809;74.7;71.1
21;2021-09-18;327;1005;398533;379814;74.8;71.3
21;2021-09-19;5;21;398538;379835;74.8;71.3
21;2021-09-20;249;620;398787;380455;74.8;71.4
21;2021-09-21;366;664;399153;381119;74.9;71.5
21;2021-09-22;336;905;399489;382024;75.0;71.7
21;2021-09-23;273;521;399762;382545;75.0;71.8
21;2021-09-24;359;806;400121;383351;75.1;71.9
21;2021-09-25;216;866;400337;384217;75.1;72.1
21;2021-09-26;6;21;400343;384238;75.1;72.1
21;2021-09-27;242;447;400585;384685;75.2;72.2
21;2021-09-28;209;487;400794;385172;75.2;72.3
21;2021-09-29;244;533;401038;385705;75.3;72.4
21;2021-09-30;289;403;401327;386108;75.3;72.5
21;2021-10-01;361;831;401688;386939;75.4;72.6
21;2021-10-02;221;572;401909;387511;75.4;72.7
21;2021-10-03;6;22;401915;387533;75.4;72.7
21;2021-10-04;195;328;402110;387861;75.5;72.8
21;2021-10-05;151;462;402261;388323;75.5;72.9
21;2021-10-06;236;506;402497;388829;75.5;73.0
22;2020-12-27;0;0;0;0;0.0;0.0
22;2020-12-28;0;0;0;0;0.0;0.0
22;2020-12-29;0;0;0;0;0.0;0.0
22;2020-12-30;0;0;0;0;0.0;0.0
22;2020-12-31;0;0;0;0;0.0;0.0
22;2021-01-01;0;0;0;0;0.0;0.0
22;2021-01-02;2;0;2;0;0.0;0.0
22;2021-01-03;0;0;2;0;0.0;0.0
22;2021-01-04;5;0;7;0;0.0;0.0
22;2021-01-05;61;0;68;0;0.0;0.0
22;2021-01-06;114;1;182;1;0.0;0.0
22;2021-01-07;67;0;249;1;0.0;0.0
22;2021-01-08;174;0;423;1;0.1;0.0
22;2021-01-09;1;0;424;1;0.1;0.0
22;2021-01-10;0;0;424;1;0.1;0.0
22;2021-01-11;234;1;658;2;0.1;0.0
22;2021-01-12;627;0;1285;2;0.2;0.0
22;2021-01-13;677;1;1962;3;0.3;0.0
22;2021-01-14;717;8;2679;11;0.4;0.0
22;2021-01-15;529;2;3208;13;0.5;0.0
22;2021-01-16;96;0;3304;13;0.6;0.0
22;2021-01-17;1;0;3305;13;0.6;0.0
22;2021-01-18;312;1;3617;14;0.6;0.0
22;2021-01-19;686;0;4303;14;0.7;0.0
22;2021-01-20;598;1;4901;15;0.8;0.0
22;2021-01-21;947;1;5848;16;1.0;0.0
22;2021-01-22;840;2;6688;18;1.1;0.0
22;2021-01-23;219;0;6907;18;1.2;0.0
22;2021-01-24;2;0;6909;18;1.2;0.0
22;2021-01-25;751;9;7660;27;1.3;0.0
22;2021-01-26;1018;59;8678;86;1.5;0.0
22;2021-01-27;3858;109;12536;195;2.1;0.0
22;2021-01-28;4511;84;17047;279;2.9;0.0
22;2021-01-29;1898;120;18945;399;3.2;0.1
22;2021-01-30;289;0;19234;399;3.2;0.1
22;2021-01-31;3;0;19237;399;3.2;0.1
22;2021-02-01;642;75;19879;474;3.3;0.1
22;2021-02-02;903;414;20782;888;3.5;0.1
22;2021-02-03;691;472;21473;1360;3.6;0.2
22;2021-02-04;964;611;22437;1971;3.8;0.3
22;2021-02-05;723;512;23160;2483;3.9;0.4
22;2021-02-06;256;0;23416;2483;3.9;0.4
22;2021-02-07;0;0;23416;2483;3.9;0.4
22;2021-02-08;531;112;23947;2595;4.0;0.4
22;2021-02-09;614;264;24561;2859;4.1;0.5
22;2021-02-10;425;180;24986;3039;4.2;0.5
22;2021-02-11;1085;299;26071;3338;4.4;0.6
22;2021-02-12;594;296;26665;3634;4.5;0.6
22;2021-02-13;319;70;26984;3704;4.5;0.6
22;2021-02-14;0;4;26984;3708;4.5;0.6
22;2021-02-15;672;363;27656;4071;4.6;0.7
22;2021-02-16;1042;597;28698;4668;4.8;0.8
22;2021-02-17;1203;2311;29901;6979;5.0;1.2
22;2021-02-18;2147;2695;32048;9674;5.4;1.6
22;2021-02-19;1637;1754;33685;11428;5.7;1.9
22;2021-02-20;480;157;34165;11585;5.7;1.9
22;2021-02-21;6;49;34171;11634;5.7;2.0
22;2021-02-22;401;570;34572;12204;5.8;2.0
22;2021-02-23;665;766;35237;12970;5.9;2.2
22;2021-02-24;695;767;35932;13737;6.0;2.3
22;2021-02-25;1200;1003;37132;14740;6.2;2.5
22;2021-02-26;1066;601;38198;15341;6.4;2.6
22;2021-02-27;564;219;38762;15560;6.5;2.6
22;2021-02-28;16;8;38778;15568;6.5;2.6
22;2021-03-01;958;455;39736;16023;6.7;2.7
22;2021-03-02;1207;748;40943;16771;6.9;2.8
22;2021-03-03;1325;736;42268;17507;7.1;2.9
22;2021-03-04;1602;796;43870;18303;7.4;3.1
22;2021-03-05;2108;693;45978;18996;7.7;3.2
22;2021-03-06;1114;244;47092;19240;7.9;3.2
22;2021-03-07;219;1;47311;19241;7.9;3.2
22;2021-03-08;1291;585;48602;19826;8.2;3.3
22;2021-03-09;1824;670;50426;20496;8.5;3.4
22;2021-03-10;1988;927;52414;21423;8.8;3.6
22;2021-03-11;2375;1550;54789;22973;9.2;3.9
22;2021-03-12;3101;908;57890;23881;9.7;4.0
22;2021-03-13;1721;277;59611;24158;10.0;4.1
22;2021-03-14;245;23;59856;24181;10.0;4.1
22;2021-03-15;1620;555;61476;24736;10.3;4.1
22;2021-03-16;1603;837;63079;25573;10.6;4.3
22;2021-03-17;2651;689;65730;26262;11.0;4.4
22;2021-03-18;2552;1095;68282;27357;11.5;4.6
22;2021-03-19;3281;792;71563;28149;12.0;4.7
22;2021-03-20;2208;282;73771;28431;12.4;4.8
22;2021-03-21;16;0;73787;28431;12.4;4.8
22;2021-03-22;2363;359;76150;28790;12.8;4.8
22;2021-03-23;3142;780;79292;29570;13.3;5.0
22;2021-03-24;3485;682;82777;30252;13.9;5.1
22;2021-03-25;3961;606;86738;30858;14.5;5.2
22;2021-03-26;4003;483;90741;31341;15.2;5.3
22;2021-03-27;2092;179;92833;31520;15.6;5.3
22;2021-03-28;67;1;92900;31521;15.6;5.3
22;2021-03-29;2766;905;95666;32426;16.0;5.4
22;2021-03-30;3567;1149;99233;33575;16.6;5.6
22;2021-03-31;3673;1080;102906;34655;17.3;5.8
22;2021-04-01;4944;1129;107850;35784;18.1;6.0
22;2021-04-02;4391;1034;112241;36818;18.8;6.2
22;2021-04-03;1998;403;114239;37221;19.2;6.2
22;2021-04-04;37;0;114276;37221;19.2;6.2
22;2021-04-05;15;0;114291;37221;19.2;6.2
22;2021-04-06;3288;1135;117579;38356;19.7;6.4
22;2021-04-07;3429;1364;121008;39720;20.3;6.7
22;2021-04-08;4447;1322;125455;41042;21.0;6.9
22;2021-04-09;5183;1361;130638;42403;21.9;7.1
22;2021-04-10;2447;365;133085;42768;22.3;7.2
22;2021-04-11;485;10;133570;42778;22.4;7.2
22;2021-04-12;2988;1007;136558;43785;22.9;7.3
22;2021-04-13;3318;1517;139876;45302;23.5;7.6
22;2021-04-14;3167;2483;143043;47785;24.0;8.0
22;2021-04-15;3600;2431;146643;50216;24.6;8.4
22;2021-04-16;3633;2486;150276;52702;25.2;8.8
22;2021-04-17;1920;1792;152196;54494;25.5;9.1
22;2021-04-18;17;0;152213;54494;25.5;9.1
22;2021-04-19;3021;2145;155234;56639;26.0;9.5
22;2021-04-20;3310;2793;158544;59432;26.6;10.0
22;2021-04-21;3223;2731;161767;62163;27.1;10.4
22;2021-04-22;3593;3128;165360;65291;27.7;11.0
22;2021-04-23;3726;3172;169086;68463;28.4;11.5
22;2021-04-24;2005;1962;171091;70425;28.7;11.8
22;2021-04-25;17;0;171108;70425;28.7;11.8
22;2021-04-26;3213;2854;174321;73279;29.2;12.3
22;2021-04-27;3371;3128;177692;76407;29.8;12.8
22;2021-04-28;3488;3149;181180;79556;30.4;13.3
22;2021-04-29;4080;3245;185260;82801;31.1;13.9
22;2021-04-30;3906;3216;189166;86017;31.7;14.4
22;2021-05-01;60;69;189226;86086;31.7;14.4
22;2021-05-02;1237;59;190463;86145;31.9;14.4
22;2021-05-03;2029;2711;192492;88856;32.3;14.9
22;2021-05-04;2155;2894;194647;91750;32.6;15.4
22;2021-05-05;2049;3005;196696;94755;33.0;15.9
22;2021-05-06;2508;3488;199204;98243;33.4;16.5
22;2021-05-07;2829;3383;202033;101626;33.9;17.0
22;2021-05-08;45;120;202078;101746;33.9;17.1
22;2021-05-09;602;438;202680;102184;34.0;17.1
22;2021-05-10;4473;2728;207153;104912;34.7;17.6
22;2021-05-11;5106;2889;212259;107801;35.6;18.1
22;2021-05-12;6599;1016;218858;108817;36.7;18.3
22;2021-05-13;528;35;219386;108852;36.8;18.3
22;2021-05-14;6407;1074;225793;109926;37.9;18.4
22;2021-05-15;3988;419;229781;110345;38.5;18.5
22;2021-05-16;419;37;230200;110382;38.6;18.5
22;2021-05-17;5668;518;235868;110900;39.6;18.6
22;2021-05-18;6011;947;241879;111847;40.6;18.8
22;2021-05-19;6131;705;248010;112552;41.6;18.9
22;2021-05-20;6587;1369;254597;113921;42.7;19.1
22;2021-05-21;5899;1449;260496;115370;43.7;19.4
22;2021-05-22;4093;768;264589;116138;44.4;19.5
22;2021-05-23;407;17;264996;116155;44.4;19.5
22;2021-05-24;5315;226;270311;116381;45.3;19.5
22;2021-05-25;5638;1170;275949;117551;46.3;19.7
22;2021-05-26;4226;2808;280175;120359;47.0;20.2
22;2021-05-27;4503;3830;284678;124189;47.7;20.8
22;2021-05-28;4384;4417;289062;128606;48.5;21.6
22;2021-05-29;3046;1770;292108;130376;49.0;21.9
22;2021-05-30;19;7;292127;130383;49.0;21.9
22;2021-05-31;3653;3148;295780;133531;49.6;22.4
22;2021-06-01;3520;3685;299300;137216;50.2;23.0
22;2021-06-02;3085;3375;302385;140591;50.7;23.6
22;2021-06-03;3196;4085;305581;144676;51.3;24.3
22;2021-06-04;3371;4535;308952;149211;51.8;25.0
22;2021-06-05;3543;2025;312495;151236;52.4;25.4
22;2021-06-06;214;30;312709;151266;52.5;25.4
22;2021-06-07;3042;3254;315751;154520;53.0;25.9
22;2021-06-08;2798;3525;318549;158045;53.4;26.5
22;2021-06-09;2543;3506;321092;161551;53.9;27.1
22;2021-06-10;2516;4242;323608;165793;54.3;27.8
22;2021-06-11;2551;4226;326159;170019;54.7;28.5
22;2021-06-12;2411;1453;328570;171472;55.1;28.8
22;2021-06-13;134;1093;328704;172565;55.1;28.9
22;2021-06-14;2644;2462;331348;175027;55.6;29.4
22;2021-06-15;3095;2995;334443;178022;56.1;29.9
22;2021-06-16;3008;2806;337451;180828;56.6;30.3
22;2021-06-17;2560;3174;340011;184002;57.0;30.9
22;2021-06-18;3102;4112;343113;188114;57.6;31.6
22;2021-06-19;2984;1453;346097;189567;58.1;31.8
22;2021-06-20;157;8;346254;189575;58.1;31.8
22;2021-06-21;1783;5020;348037;194595;58.4;32.6
22;2021-06-22;2403;5547;350440;200142;58.8;33.6
22;2021-06-23;1285;6202;351725;206344;59.0;34.6
22;2021-06-24;2578;3912;354303;210256;59.4;35.3
22;2021-06-25;1568;6808;355871;217064;59.7;36.4
22;2021-06-26;783;3853;356654;220917;59.8;37.1
22;2021-06-27;4;511;356658;221428;59.8;37.1
22;2021-06-28;1051;5586;357709;227014;60.0;38.1
22;2021-06-29;1375;5949;359084;232963;60.2;39.1
22;2021-06-30;1129;5736;360213;238699;60.4;40.0
22;2021-07-01;1383;6034;361596;244733;60.7;41.0
22;2021-07-02;1708;6089;363304;250822;60.9;42.1
22;2021-07-03;1009;3818;364313;254640;61.1;42.7
22;2021-07-04;149;365;364462;255005;61.1;42.8
22;2021-07-05;1598;5804;366060;260809;61.4;43.7
22;2021-07-06;2312;5992;368372;266801;61.8;44.8
22;2021-07-07;2291;4933;370663;271734;62.2;45.6
22;2021-07-08;2503;5096;373166;276830;62.6;46.4
22;2021-07-09;2496;5377;375662;282207;63.0;47.3
22;2021-07-10;1808;3356;377470;285563;63.3;47.9
22;2021-07-11;484;75;377954;285638;63.4;47.9
22;2021-07-12;2334;4723;380288;290361;63.8;48.7
22;2021-07-13;3782;5054;384070;295415;64.4;49.6
22;2021-07-14;700;2494;384770;297909;64.5;50.0
22;2021-07-15;3869;4619;388639;302528;65.2;50.7
22;2021-07-16;3835;5290;392474;307818;65.8;51.6
22;2021-07-17;2558;3410;395032;311228;66.3;52.2
22;2021-07-18;570;88;395602;311316;66.4;52.2
22;2021-07-19;2773;4103;398375;315419;66.8;52.9
22;2021-07-20;3923;4129;402298;319548;67.5;53.6
22;2021-07-21;3998;3406;406296;322954;68.1;54.2
22;2021-07-22;4860;3704;411156;326658;69.0;54.8
22;2021-07-23;4452;4219;415608;330877;69.7;55.5
22;2021-07-24;2260;2614;417868;333491;70.1;55.9
22;2021-07-25;118;150;417986;333641;70.1;56.0
22;2021-07-26;3022;3918;421008;337559;70.6;56.6
22;2021-07-27;3725;4912;424733;342471;71.2;57.4
22;2021-07-28;3706;3662;428439;346133;71.9;58.1
22;2021-07-29;4294;3779;432733;349912;72.6;58.7
22;2021-07-30;4039;3971;436772;353883;73.3;59.4
22;2021-07-31;2402;2805;439174;356688;73.7;59.8
22;2021-08-01;118;150;439292;356838;73.7;59.9
22;2021-08-02;4670;2552;443962;359390;74.5;60.3
22;2021-08-03;4787;3426;448749;362816;75.3;60.9
22;2021-08-04;5773;2495;454522;365311;76.2;61.3
22;2021-08-05;4128;3802;458650;369113;76.9;61.9
22;2021-08-06;3654;3810;462304;372923;77.5;62.6
22;2021-08-07;2355;2269;464659;375192;77.9;62.9
22;2021-08-08;427;71;465086;375263;78.0;62.9
22;2021-08-09;2722;2707;467808;377970;78.5;63.4
22;2021-08-10;2735;3513;470543;381483;78.9;64.0
22;2021-08-11;2428;3114;472971;384597;79.3;64.5
22;2021-08-12;2216;3476;475187;388073;79.7;65.1
22;2021-08-13;1936;2970;477123;391043;80.0;65.6
22;2021-08-14;1343;1911;478466;392954;80.3;65.9
22;2021-08-15;87;199;478553;393153;80.3;65.9
22;2021-08-16;1470;3177;480023;396330;80.5;66.5
22;2021-08-17;1757;3459;481780;399789;80.8;67.1
22;2021-08-18;1406;3302;483186;403091;81.0;67.6
22;2021-08-19;1349;3609;484535;406700;81.3;68.2
22;2021-08-20;1462;3605;485997;410305;81.5;68.8
22;2021-08-21;816;2261;486813;412566;81.7;69.2
22;2021-08-22;151;308;486964;412874;81.7;69.3
22;2021-08-23;1967;3609;488931;416483;82.0;69.9
22;2021-08-24;1431;3246;490362;419729;82.2;70.4
22;2021-08-25;844;2507;491206;422236;82.4;70.8
22;2021-08-26;1055;4294;492261;426530;82.6;71.5
22;2021-08-27;1326;4602;493587;431132;82.8;72.3
22;2021-08-28;738;2517;494325;433649;82.9;72.7
22;2021-08-29;35;26;494360;433675;82.9;72.7
22;2021-08-30;925;2964;495285;436639;83.1;73.2
22;2021-08-31;968;3799;496253;440438;83.2;73.9
22;2021-09-01;970;3419;497223;443857;83.4;74.4
22;2021-09-02;839;3062;498062;446919;83.5;75.0
22;2021-09-03;943;3067;499005;449986;83.7;75.5
22;2021-09-04;782;2737;499787;452723;83.8;75.9
22;2021-09-05;97;47;499884;452770;83.8;75.9
22;2021-09-06;489;2184;500373;454954;83.9;76.3
22;2021-09-07;515;2302;500888;457256;84.0;76.7
22;2021-09-08;632;2189;501520;459445;84.1;77.1
22;2021-09-09;678;2314;502198;461759;84.2;77.5
22;2021-09-10;705;2438;502903;464197;84.4;77.9
22;2021-09-11;584;1821;503487;466018;84.5;78.2
22;2021-09-12;31;85;503518;466103;84.5;78.2
22;2021-09-13;483;2539;504001;468642;84.5;78.6
22;2021-09-14;588;2311;504589;470953;84.6;79.0
22;2021-09-15;457;1703;505046;472656;84.7;79.3
22;2021-09-16;550;1041;505596;473697;84.8;79.5
22;2021-09-17;619;1630;506215;475327;84.9;79.7
22;2021-09-18;283;2161;506498;477488;85.0;80.1
22;2021-09-19;1;8;506499;477496;85.0;80.1
22;2021-09-20;362;708;506861;478204;85.0;80.2
22;2021-09-21;363;956;507224;479160;85.1;80.4
22;2021-09-22;298;1160;507522;480320;85.1;80.6
22;2021-09-23;398;718;507920;481038;85.2;80.7
22;2021-09-24;362;1099;508282;482137;85.3;80.9
22;2021-09-25;218;1386;508500;483523;85.3;81.1
22;2021-09-26;12;70;508512;483593;85.3;81.1
22;2021-09-27;333;744;508845;484337;85.4;81.2
22;2021-09-28;203;576;509048;484913;85.4;81.3
22;2021-09-29;231;887;509279;485800;85.4;81.5
22;2021-09-30;271;740;509550;486540;85.5;81.6
22;2021-10-01;278;777;509828;487317;85.5;81.7
22;2021-10-02;332;915;510160;488232;85.6;81.9
22;2021-10-03;1;1;510161;488233;85.6;81.9
22;2021-10-04;111;425;510272;488658;85.6;82.0
22;2021-10-05;209;644;510481;489302;85.6;82.1
22;2021-10-06;211;369;510692;489671;85.7;82.1
23;2020-12-27;0;0;0;0;0.0;0.0
23;2020-12-28;2;0;2;0;0.0;0.0
23;2020-12-29;0;0;2;0;0.0;0.0
23;2020-12-30;0;0;2;0;0.0;0.0
23;2020-12-31;0;0;2;0;0.0;0.0
23;2021-01-01;0;0;2;0;0.0;0.0
23;2021-01-02;1;0;3;0;0.0;0.0
23;2021-01-03;1;0;4;0;0.0;0.0
23;2021-01-04;1;0;5;0;0.0;0.0
23;2021-01-05;3;0;8;0;0.0;0.0
23;2021-01-06;10;0;18;0;0.0;0.0
23;2021-01-07;116;1;134;1;0.1;0.0
23;2021-01-08;117;0;251;1;0.2;0.0
23;2021-01-09;36;0;287;1;0.2;0.0
23;2021-01-10;1;0;288;1;0.2;0.0
23;2021-01-11;176;1;464;2;0.4;0.0
23;2021-01-12;237;3;701;5;0.6;0.0
23;2021-01-13;310;0;1011;5;0.9;0.0
23;2021-01-14;293;4;1304;9;1.1;0.0
23;2021-01-15;334;5;1638;14;1.4;0.0
23;2021-01-16;163;1;1801;15;1.5;0.0
23;2021-01-17;0;0;1801;15;1.5;0.0
23;2021-01-18;342;3;2143;18;1.8;0.0
23;2021-01-19;498;2;2641;20;2.3;0.0
23;2021-01-20;363;1;3004;21;2.6;0.0
23;2021-01-21;700;1;3704;22;3.2;0.0
23;2021-01-22;481;0;4185;22;3.6;0.0
23;2021-01-23;368;1;4553;23;3.9;0.0
23;2021-01-24;0;0;4553;23;3.9;0.0
23;2021-01-25;382;16;4935;39;4.2;0.0
23;2021-01-26;301;5;5236;44;4.5;0.0
23;2021-01-27;226;2;5462;46;4.7;0.0
23;2021-01-28;232;30;5694;76;4.9;0.1
23;2021-01-29;304;98;5998;174;5.2;0.1
23;2021-01-30;100;24;6098;198;5.2;0.2
23;2021-01-31;2;33;6100;231;5.2;0.2
23;2021-02-01;148;80;6248;311;5.4;0.3
23;2021-02-02;157;107;6405;418;5.5;0.4
23;2021-02-03;105;178;6510;596;5.6;0.5
23;2021-02-04;77;247;6587;843;5.7;0.7
23;2021-02-05;117;274;6704;1117;5.8;1.0
23;2021-02-06;14;127;6718;1244;5.8;1.1
23;2021-02-07;1;0;6719;1244;5.8;1.1
23;2021-02-08;123;166;6842;1410;5.9;1.2
23;2021-02-09;89;254;6931;1664;6.0;1.4
23;2021-02-10;92;227;7023;1891;6.0;1.6
23;2021-02-11;246;513;7269;2404;6.3;2.1
23;2021-02-12;174;258;7443;2662;6.4;2.3
23;2021-02-13;8;178;7451;2840;6.4;2.4
23;2021-02-14;8;0;7459;2840;6.4;2.4
23;2021-02-15;157;300;7616;3140;6.6;2.7
23;2021-02-16;103;368;7719;3508;6.6;3.0
23;2021-02-17;65;403;7784;3911;6.7;3.4
23;2021-02-18;142;304;7926;4215;6.8;3.6
23;2021-02-19;109;203;8035;4418;6.9;3.8
23;2021-02-20;2;81;8037;4499;6.9;3.9
23;2021-02-21;0;0;8037;4499;6.9;3.9
23;2021-02-22;104;178;8141;4677;7.0;4.0
23;2021-02-23;108;174;8249;4851;7.1;4.2
23;2021-02-24;176;140;8425;4991;7.2;4.3
23;2021-02-25;184;86;8609;5077;7.4;4.4
23;2021-02-26;287;149;8896;5226;7.7;4.5
23;2021-02-27;112;11;9008;5237;7.7;4.5
23;2021-02-28;1;31;9009;5268;7.7;4.5
23;2021-03-01;88;172;9097;5440;7.8;4.7
23;2021-03-02;229;115;9326;5555;8.0;4.8
23;2021-03-03;133;79;9459;5634;8.1;4.8
23;2021-03-04;307;129;9766;5763;8.4;5.0
23;2021-03-05;517;104;10283;5867;8.8;5.0
23;2021-03-06;495;6;10778;5873;9.3;5.1
23;2021-03-07;313;3;11091;5876;9.5;5.1
23;2021-03-08;197;70;11288;5946;9.7;5.1
23;2021-03-09;421;102;11709;6048;10.1;5.2
23;2021-03-10;348;37;12057;6085;10.4;5.2
23;2021-03-11;324;44;12381;6129;10.6;5.3
23;2021-03-12;621;34;13002;6163;11.2;5.3
23;2021-03-13;287;12;13289;6175;11.4;5.3
23;2021-03-14;47;34;13336;6209;11.5;5.3
23;2021-03-15;220;124;13556;6333;11.7;5.4
23;2021-03-16;192;80;13748;6413;11.8;5.5
23;2021-03-17;131;99;13879;6512;11.9;5.6
23;2021-03-18;192;93;14071;6605;12.1;5.7
23;2021-03-19;207;117;14278;6722;12.3;5.8
23;2021-03-20;631;37;14909;6759;12.8;5.8
23;2021-03-21;128;0;15037;6759;12.9;5.8
23;2021-03-22;274;156;15311;6915;13.2;5.9
23;2021-03-23;504;101;15815;7016;13.6;6.0
23;2021-03-24;422;124;16237;7140;14.0;6.1
23;2021-03-25;821;188;17058;7328;14.7;6.3
23;2021-03-26;735;193;17793;7521;15.3;6.5
23;2021-03-27;507;50;18300;7571;15.7;6.5
23;2021-03-28;3;9;18303;7580;15.7;6.5
23;2021-03-29;358;108;18661;7688;16.0;6.6
23;2021-03-30;537;178;19198;7866;16.5;6.8
23;2021-03-31;411;171;19609;8037;16.9;6.9
23;2021-04-01;600;172;20209;8209;17.4;7.1
23;2021-04-02;498;296;20707;8505;17.8;7.3
23;2021-04-03;715;44;21422;8549;18.4;7.4
23;2021-04-04;4;0;21426;8549;18.4;7.4
23;2021-04-05;2;3;21428;8552;18.4;7.4
23;2021-04-06;382;293;21810;8845;18.8;7.6
23;2021-04-07;706;309;22516;9154;19.4;7.9
23;2021-04-08;805;237;23321;9391;20.1;8.1
23;2021-04-09;940;366;24261;9757;20.9;8.4
23;2021-04-10;1097;111;25358;9868;21.8;8.5
23;2021-04-11;21;2;25379;9870;21.8;8.5
23;2021-04-12;692;236;26071;10106;22.4;8.7
23;2021-04-13;670;302;26741;10408;23.0;9.0
23;2021-04-14;586;178;27327;10586;23.5;9.1
23;2021-04-15;929;185;28256;10771;24.3;9.3
23;2021-04-16;905;213;29161;10984;25.1;9.4
23;2021-04-17;996;553;30157;11537;25.9;9.9
23;2021-04-18;3;136;30160;11673;25.9;10.0
23;2021-04-19;613;297;30773;11970;26.5;10.3
23;2021-04-20;720;295;31493;12265;27.1;10.5
23;2021-04-21;733;397;32226;12662;27.7;10.9
23;2021-04-22;655;472;32881;13134;28.3;11.3
23;2021-04-23;596;346;33477;13480;28.8;11.6
23;2021-04-24;855;449;34332;13929;29.5;12.0
23;2021-04-25;0;0;34332;13929;29.5;12.0
23;2021-04-26;615;253;34947;14182;30.1;12.2
23;2021-04-27;675;419;35622;14601;30.6;12.6
23;2021-04-28;628;276;36250;14877;31.2;12.8
23;2021-04-29;883;379;37133;15256;31.9;13.1
23;2021-04-30;719;784;37852;16040;32.6;13.8
23;2021-05-01;1229;42;39081;16082;33.6;13.8
23;2021-05-02;14;0;39095;16082;33.6;13.8
23;2021-05-03;430;520;39525;16602;34.0;14.3
23;2021-05-04;617;513;40142;17115;34.5;14.7
23;2021-05-05;540;713;40682;17828;35.0;15.3
23;2021-05-06;728;698;41410;18526;35.6;15.9
23;2021-05-07;685;643;42095;19169;36.2;16.5
23;2021-05-08;1411;588;43506;19757;37.4;17.0
23;2021-05-09;4;0;43510;19757;37.4;17.0
23;2021-05-10;555;656;44065;20413;37.9;17.6
23;2021-05-11;560;764;44625;21177;38.4;18.2
23;2021-05-12;720;662;45345;21839;39.0;18.8
23;2021-05-13;538;56;45883;21895;39.5;18.8
23;2021-05-14;787;458;46670;22353;40.1;19.2
23;2021-05-15;995;235;47665;22588;41.0;19.4
23;2021-05-16;0;0;47665;22588;41.0;19.4
23;2021-05-17;566;448;48231;23036;41.5;19.8
23;2021-05-18;777;292;49008;23328;42.2;20.1
23;2021-05-19;1051;259;50059;23587;43.1;20.3
23;2021-05-20;838;314;50897;23901;43.8;20.6
23;2021-05-21;1108;311;52005;24212;44.7;20.8
23;2021-05-22;740;125;52745;24337;45.4;20.9
23;2021-05-23;3;20;52748;24357;45.4;20.9
23;2021-05-24;363;166;53111;24523;45.7;21.1
23;2021-05-25;908;336;54019;24859;46.5;21.4
23;2021-05-26;1077;227;55096;25086;47.4;21.6
23;2021-05-27;931;437;56027;25523;48.2;22.0
23;2021-05-28;781;743;56808;26266;48.9;22.6
23;2021-05-29;638;1099;57446;27365;49.4;23.5
23;2021-05-30;6;63;57452;27428;49.4;23.6
23;2021-05-31;433;539;57885;27967;49.8;24.1
23;2021-06-01;582;826;58467;28793;50.3;24.8
23;2021-06-02;624;515;59091;29308;50.8;25.2
23;2021-06-03;708;551;59799;29859;51.4;25.7
23;2021-06-04;778;614;60577;30473;52.1;26.2
23;2021-06-05;543;777;61120;31250;52.6;26.9
23;2021-06-06;0;0;61120;31250;52.6;26.9
23;2021-06-07;393;696;61513;31946;52.9;27.5
23;2021-06-08;323;776;61836;32722;53.2;28.1
23;2021-06-09;287;648;62123;33370;53.4;28.7
23;2021-06-10;374;690;62497;34060;53.8;29.3
23;2021-06-11;384;807;62881;34867;54.1;30.0
23;2021-06-12;376;1265;63257;36132;54.4;31.1
23;2021-06-13;13;5;63270;36137;54.4;31.1
23;2021-06-14;235;589;63505;36726;54.6;31.6
23;2021-06-15;229;860;63734;37586;54.8;32.3
23;2021-06-16;362;579;64096;38165;55.1;32.8
23;2021-06-17;339;810;64435;38975;55.4;33.5
23;2021-06-18;356;767;64791;39742;55.7;34.2
23;2021-06-19;493;1523;65284;41265;56.1;35.5
23;2021-06-20;2;11;65286;41276;56.2;35.5
23;2021-06-21;205;620;65491;41896;56.3;36.0
23;2021-06-22;216;687;65707;42583;56.5;36.6
23;2021-06-23;221;750;65928;43333;56.7;37.3
23;2021-06-24;200;606;66128;43939;56.9;37.8
23;2021-06-25;302;815;66430;44754;57.1;38.5
23;2021-06-26;221;999;66651;45753;57.3;39.4
23;2021-06-27;3;0;66654;45753;57.3;39.4
23;2021-06-28;115;690;66769;46443;57.4;39.9
23;2021-06-29;189;823;66958;47266;57.6;40.7
23;2021-06-30;169;944;67127;48210;57.7;41.5
23;2021-07-01;168;870;67295;49080;57.9;42.2
23;2021-07-02;192;1069;67487;50149;58.0;43.1
23;2021-07-03;250;979;67737;51128;58.3;44.0
23;2021-07-04;1;0;67738;51128;58.3;44.0
23;2021-07-05;160;804;67898;51932;58.4;44.7
23;2021-07-06;215;1043;68113;52975;58.6;45.6
23;2021-07-07;210;848;68323;53823;58.8;46.3
23;2021-07-08;254;740;68577;54563;59.0;46.9
23;2021-07-09;275;1012;68852;55575;59.2;47.8
23;2021-07-10;234;644;69086;56219;59.4;48.4
23;2021-07-11;0;0;69086;56219;59.4;48.4
23;2021-07-12;232;702;69318;56921;59.6;49.0
23;2021-07-13;471;917;69789;57838;60.0;49.7
23;2021-07-14;212;320;70001;58158;60.2;50.0
23;2021-07-15;483;810;70484;58968;60.6;50.7
23;2021-07-16;764;566;71248;59534;61.3;51.2
23;2021-07-17;220;478;71468;60012;61.5;51.6
23;2021-07-18;0;1;71468;60013;61.5;51.6
23;2021-07-19;704;628;72172;60641;62.1;52.2
23;2021-07-20;633;569;72805;61210;62.6;52.6
23;2021-07-21;702;636;73507;61846;63.2;53.2
23;2021-07-22;945;438;74452;62284;64.0;53.6
23;2021-07-23;841;508;75293;62792;64.8;54.0
23;2021-07-24;1013;439;76306;63231;65.6;54.4
23;2021-07-25;13;16;76319;63247;65.6;54.4
23;2021-07-26;788;563;77107;63810;66.3;54.9
23;2021-07-27;928;436;78035;64246;67.1;55.3
23;2021-07-28;877;411;78912;64657;67.9;55.6
23;2021-07-29;1049;400;79961;65057;68.8;56.0
23;2021-07-30;947;521;80908;65578;69.6;56.4
23;2021-07-31;1165;306;82073;65884;70.6;56.7
23;2021-08-01;19;8;82092;65892;70.6;56.7
23;2021-08-02;674;506;82766;66398;71.2;57.1
23;2021-08-03;767;458;83533;66856;71.8;57.5
23;2021-08-04;613;298;84146;67154;72.4;57.8
23;2021-08-05;692;365;84838;67519;73.0;58.1
23;2021-08-06;421;482;85259;68001;73.3;58.5
23;2021-08-07;299;188;85558;68189;73.6;58.6
23;2021-08-08;146;38;85704;68227;73.7;58.7
23;2021-08-09;492;492;86196;68719;74.1;59.1
23;2021-08-10;467;608;86663;69327;74.5;59.6
23;2021-08-11;428;487;87091;69814;74.9;60.0
23;2021-08-12;514;567;87605;70381;75.3;60.5
23;2021-08-13;420;578;88025;70959;75.7;61.0
23;2021-08-14;287;390;88312;71349;76.0;61.4
23;2021-08-15;27;9;88339;71358;76.0;61.4
23;2021-08-16;276;710;88615;72068;76.2;62.0
23;2021-08-17;277;732;88892;72800;76.5;62.6
23;2021-08-18;180;637;89072;73437;76.6;63.2
23;2021-08-19;257;726;89329;74163;76.8;63.8
23;2021-08-20;215;682;89544;74845;77.0;64.4
23;2021-08-21;140;500;89684;75345;77.1;64.8
23;2021-08-22;54;48;89738;75393;77.2;64.8
23;2021-08-23;149;816;89887;76209;77.3;65.5
23;2021-08-24;265;911;90152;77120;77.5;66.3
23;2021-08-25;187;791;90339;77911;77.7;67.0
23;2021-08-26;220;744;90559;78655;77.9;67.6
23;2021-08-27;213;639;90772;79294;78.1;68.2
23;2021-08-28;221;454;90993;79748;78.3;68.6
23;2021-08-29;15;88;91008;79836;78.3;68.7
23;2021-08-30;187;665;91195;80501;78.4;69.2
23;2021-08-31;229;672;91424;81173;78.6;69.8
23;2021-09-01;160;429;91584;81602;78.8;70.2
23;2021-09-02;118;346;91702;81948;78.9;70.5
23;2021-09-03;209;583;91911;82531;79.0;71.0
23;2021-09-04;178;846;92089;83377;79.2;71.7
23;2021-09-05;5;7;92094;83384;79.2;71.7
23;2021-09-06;132;489;92226;83873;79.3;72.1
23;2021-09-07;98;527;92324;84400;79.4;72.6
23;2021-09-08;121;486;92445;84886;79.5;73.0
23;2021-09-09;115;393;92560;85279;79.6;73.3
23;2021-09-10;150;450;92710;85729;79.7;73.7
23;2021-09-11;102;224;92812;85953;79.8;73.9
23;2021-09-12;5;16;92817;85969;79.8;73.9
23;2021-09-13;112;401;92929;86370;79.9;74.3
23;2021-09-14;111;463;93040;86833;80.0;74.7
23;2021-09-15;97;242;93137;87075;80.1;74.9
23;2021-09-16;127;152;93264;87227;80.2;75.0
23;2021-09-17;140;227;93404;87454;80.3;75.2
23;2021-09-18;44;224;93448;87678;80.4;75.4
23;2021-09-19;0;1;93448;87679;80.4;75.4
23;2021-09-20;59;217;93507;87896;80.4;75.6
23;2021-09-21;85;184;93592;88080;80.5;75.8
23;2021-09-22;71;260;93663;88340;80.6;76.0
23;2021-09-23;58;133;93721;88473;80.6;76.1
23;2021-09-24;64;234;93785;88707;80.7;76.3
23;2021-09-25;27;138;93812;88845;80.7;76.4
23;2021-09-26;0;1;93812;88846;80.7;76.4
23;2021-09-27;34;159;93846;89005;80.7;76.6
23;2021-09-28;34;133;93880;89138;80.7;76.7
23;2021-09-29;64;156;93944;89294;80.8;76.8
23;2021-09-30;43;64;93987;89358;80.8;76.9
23;2021-10-01;82;178;94069;89536;80.9;77.0
23;2021-10-02;22;97;94091;89633;80.9;77.1
23;2021-10-03;1;4;94092;89637;80.9;77.1
23;2021-10-04;41;93;94133;89730;81.0;77.2
23;2021-10-05;33;83;94166;89813;81.0;77.2
23;2021-10-06;56;97;94222;89910;81.0;77.3
24;2020-12-27;1;0;1;0;0.0;0.0
24;2020-12-28;1;0;2;0;0.0;0.0
24;2020-12-29;2;0;4;0;0.0;0.0
24;2020-12-30;1;0;5;0;0.0;0.0
24;2020-12-31;1;0;6;0;0.0;0.0
24;2021-01-01;2;0;8;0;0.0;0.0
24;2021-01-02;1;0;9;0;0.0;0.0
24;2021-01-03;0;0;9;0;0.0;0.0
24;2021-01-04;1;0;10;0;0.0;0.0
24;2021-01-05;1;0;11;0;0.0;0.0
24;2021-01-06;2;0;13;0;0.0;0.0
24;2021-01-07;190;0;203;0;0.0;0.0
24;2021-01-08;282;0;485;0;0.1;0.0
24;2021-01-09;185;13;670;13;0.2;0.0
24;2021-01-10;35;0;705;13;0.2;0.0
24;2021-01-11;269;0;974;13;0.2;0.0
24;2021-01-12;280;0;1254;13;0.3;0.0
24;2021-01-13;233;0;1487;13;0.4;0.0
24;2021-01-14;1023;21;2510;34;0.6;0.0
24;2021-01-15;607;4;3117;38;0.8;0.0
24;2021-01-16;88;0;3205;38;0.8;0.0
24;2021-01-17;2;1;3207;39;0.8;0.0
24;2021-01-18;300;0;3507;39;0.9;0.0
24;2021-01-19;467;1;3974;40;1.0;0.0
24;2021-01-20;557;0;4531;40;1.1;0.0
24;2021-01-21;646;6;5177;46;1.3;0.0
24;2021-01-22;517;1;5694;47;1.4;0.0
24;2021-01-23;154;1;5848;48;1.4;0.0
24;2021-01-24;4;0;5852;48;1.4;0.0
24;2021-01-25;443;0;6295;48;1.5;0.0
24;2021-01-26;638;65;6933;113;1.7;0.0
24;2021-01-27;1267;14;8200;127;2.0;0.0
24;2021-01-28;986;126;9186;253;2.2;0.1
24;2021-01-29;933;128;10119;381;2.5;0.1
24;2021-01-30;282;1;10401;382;2.5;0.1
24;2021-01-31;0;0;10401;382;2.5;0.1
24;2021-02-01;379;164;10780;546;2.6;0.1
24;2021-02-02;616;289;11396;835;2.8;0.2
24;2021-02-03;654;435;12050;1270;3.0;0.3
24;2021-02-04;978;382;13028;1652;3.2;0.4
24;2021-02-05;689;355;13717;2007;3.4;0.5
24;2021-02-06;141;35;13858;2042;3.4;0.5
24;2021-02-07;33;1;13891;2043;3.4;0.5
24;2021-02-08;310;222;14201;2265;3.5;0.6
24;2021-02-09;454;230;14655;2495;3.6;0.6
24;2021-02-10;378;101;15033;2596;3.7;0.6
24;2021-02-11;561;487;15594;3083;3.8;0.8
24;2021-02-12;498;373;16092;3456;3.9;0.8
24;2021-02-13;202;41;16294;3497;4.0;0.9
24;2021-02-14;89;0;16383;3497;4.0;0.9
24;2021-02-15;188;197;16571;3694;4.1;0.9
24;2021-02-16;336;450;16907;4144;4.1;1.0
24;2021-02-17;586;784;17493;4928;4.3;1.2
24;2021-02-18;446;648;17939;5576;4.4;1.4
24;2021-02-19;463;640;18402;6216;4.5;1.5
24;2021-02-20;164;107;18566;6323;4.5;1.5
24;2021-02-21;111;0;18677;6323;4.6;1.5
24;2021-02-22;427;453;19104;6776;4.7;1.7
24;2021-02-23;565;598;19669;7374;4.8;1.8
24;2021-02-24;539;734;20208;8108;4.9;2.0
24;2021-02-25;727;771;20935;8879;5.1;2.2
24;2021-02-26;978;831;21913;9710;5.4;2.4
24;2021-02-27;363;228;22276;9938;5.5;2.4
24;2021-02-28;25;4;22301;9942;5.5;2.4
24;2021-03-01;291;318;22592;10260;5.5;2.5
24;2021-03-02;541;380;23133;10640;5.7;2.6
24;2021-03-03;681;297;23814;10937;5.8;2.7
24;2021-03-04;914;468;24728;11405;6.1;2.8
24;2021-03-05;1067;519;25795;11924;6.3;2.9
24;2021-03-06;1125;126;26920;12050;6.6;3.0
24;2021-03-07;232;63;27152;12113;6.6;3.0
24;2021-03-08;530;217;27682;12330;6.8;3.0
24;2021-03-09;1174;395;28856;12725;7.1;3.1
24;2021-03-10;1142;413;29998;13138;7.3;3.2
24;2021-03-11;1609;443;31607;13581;7.7;3.3
24;2021-03-12;2058;429;33665;14010;8.2;3.4
24;2021-03-13;1348;181;35013;14191;8.6;3.5
24;2021-03-14;141;88;35154;14279;8.6;3.5
24;2021-03-15;953;163;36107;14442;8.8;3.5
24;2021-03-16;1144;228;37251;14670;9.1;3.6
24;2021-03-17;1217;281;38468;14951;9.4;3.7
24;2021-03-18;1054;550;39522;15501;9.7;3.8
24;2021-03-19;1251;526;40773;16027;10.0;3.9
24;2021-03-20;1054;143;41827;16170;10.2;4.0
24;2021-03-21;25;11;41852;16181;10.2;4.0
24;2021-03-22;1224;406;43076;16587;10.5;4.1
24;2021-03-23;1878;388;44954;16975;11.0;4.2
24;2021-03-24;1892;379;46846;17354;11.5;4.2
24;2021-03-25;1991;468;48837;17822;12.0;4.4
24;2021-03-26;2374;278;51211;18100;12.5;4.4
24;2021-03-27;1349;42;52560;18142;12.9;4.4
24;2021-03-28;63;9;52623;18151;12.9;4.4
24;2021-03-29;1673;327;54296;18478;13.3;4.5
24;2021-03-30;2410;390;56706;18868;13.9;4.6
24;2021-03-31;2187;308;58893;19176;14.4;4.7
24;2021-04-01;2195;309;61088;19485;15.0;4.8
24;2021-04-02;2072;390;63160;19875;15.5;4.9
24;2021-04-03;1376;121;64536;19996;15.8;4.9
24;2021-04-04;74;1;64610;19997;15.8;4.9
24;2021-04-05;948;60;65558;20057;16.1;4.9
24;2021-04-06;2355;700;67913;20757;16.6;5.1
24;2021-04-07;2716;691;70629;21448;17.3;5.3
24;2021-04-08;3001;959;73630;22407;18.0;5.5
24;2021-04-09;3488;1004;77118;23411;18.9;5.7
24;2021-04-10;2596;313;79714;23724;19.5;5.8
24;2021-04-11;1103;20;80817;23744;19.8;5.8
24;2021-04-12;2498;808;83315;24552;20.4;6.0
24;2021-04-13;2902;1201;86217;25753;21.1;6.3
24;2021-04-14;2939;1196;89156;26949;21.8;6.6
24;2021-04-15;2790;1104;91946;28053;22.5;6.9
24;2021-04-16;3266;976;95212;29029;23.3;7.1
24;2021-04-17;2272;500;97484;29529;23.9;7.2
24;2021-04-18;424;6;97908;29535;24.0;7.2
24;2021-04-19;1598;1010;99506;30545;24.4;7.5
24;2021-04-20;2268;1432;101774;31977;24.9;7.8
24;2021-04-21;2146;1443;103920;33420;25.4;8.2
24;2021-04-22;2061;1258;105981;34678;26.0;8.5
24;2021-04-23;1960;1336;107941;36014;26.4;8.8
24;2021-04-24;863;724;108804;36738;26.6;9.0
24;2021-04-25;54;4;108858;36742;26.7;9.0
24;2021-04-26;1295;1476;110153;38218;27.0;9.4
24;2021-04-27;1848;1879;112001;40097;27.4;9.8
24;2021-04-28;1507;1942;113508;42039;27.8;10.3
24;2021-04-29;1730;1883;115238;43922;28.2;10.8
24;2021-04-30;2271;1768;117509;45690;28.8;11.2
24;2021-05-01;2059;1062;119568;46752;29.3;11.4
24;2021-05-02;1925;218;121493;46970;29.7;11.5
24;2021-05-03;1475;1830;122968;48800;30.1;11.9
24;2021-05-04;2227;2295;125195;51095;30.7;12.5
24;2021-05-05;1891;2716;127086;53811;31.1;13.2
24;2021-05-06;1890;2795;128976;56606;31.6;13.9
24;2021-05-07;2263;2787;131239;59393;32.1;14.5
24;2021-05-08;1285;1150;132524;60543;32.5;14.8
24;2021-05-09;1169;903;133693;61446;32.7;15.0
24;2021-05-10;1097;2622;134790;64068;33.0;15.7
24;2021-05-11;2037;2783;136827;66851;33.5;16.4
24;2021-05-12;1924;2246;138751;69097;34.0;16.9
24;2021-05-13;1465;1215;140216;70312;34.3;17.2
24;2021-05-14;2378;1333;142594;71645;34.9;17.5
24;2021-05-15;2048;816;144642;72461;35.4;17.7
24;2021-05-16;1171;346;145813;72807;35.7;17.8
24;2021-05-17;2240;1250;148053;74057;36.3;18.1
24;2021-05-18;2485;1817;150538;75874;36.9;18.6
24;2021-05-19;2283;1376;152821;77250;37.4;18.9
24;2021-05-20;2376;1572;155197;78822;38.0;19.3
24;2021-05-21;2434;1415;157631;80237;38.6;19.6
24;2021-05-22;1719;409;159350;80646;39.0;19.7
24;2021-05-23;952;72;160302;80718;39.3;19.8
24;2021-05-24;1518;331;161820;81049;39.6;19.8
24;2021-05-25;2297;1383;164117;82432;40.2;20.2
24;2021-05-26;2148;1319;166265;83751;40.7;20.5
24;2021-05-27;1750;2192;168015;85943;41.1;21.0
24;2021-05-28;2144;2000;170159;87943;41.7;21.5
24;2021-05-29;1153;2082;171312;90025;41.9;22.0
24;2021-05-30;1418;169;172730;90194;42.3;22.1
24;2021-05-31;1740;1363;174470;91557;42.7;22.4
24;2021-06-01;2581;1977;177051;93534;43.4;22.9
24;2021-06-02;2654;1782;179705;95316;44.0;23.3
24;2021-06-03;2289;1458;181994;96774;44.6;23.7
24;2021-06-04;2378;1899;184372;98673;45.1;24.2
24;2021-06-05;2007;1413;186379;100086;45.6;24.5
24;2021-06-06;766;222;187145;100308;45.8;24.6
24;2021-06-07;1432;1497;188577;101805;46.2;24.9
24;2021-06-08;1677;1905;190254;103710;46.6;25.4
24;2021-06-09;1322;1596;191576;105306;46.9;25.8
24;2021-06-10;1579;1909;193155;107215;47.3;26.3
24;2021-06-11;1334;2077;194489;109292;47.6;26.8
24;2021-06-12;1118;2538;195607;111830;47.9;27.4
24;2021-06-13;1238;921;196845;112751;48.2;27.6
24;2021-06-14;1166;1857;198011;114608;48.5;28.1
24;2021-06-15;1488;2991;199499;117599;48.8;28.8
24;2021-06-16;1670;2732;201169;120331;49.3;29.5
24;2021-06-17;1544;2176;202713;122507;49.6;30.0
24;2021-06-18;1400;2859;204113;125366;50.0;30.7
24;2021-06-19;1273;1522;205386;126888;50.3;31.1
24;2021-06-20;514;501;205900;127389;50.4;31.2
24;2021-06-21;931;1833;206831;129222;50.6;31.6
24;2021-06-22;1451;2591;208282;131813;51.0;32.3
24;2021-06-23;1425;2418;209707;134231;51.3;32.9
24;2021-06-24;1137;1916;210844;136147;51.6;33.3
24;2021-06-25;968;2817;211812;138964;51.9;34.0
24;2021-06-26;866;2099;212678;141063;52.1;34.5
24;2021-06-27;402;979;213080;142042;52.2;34.8
24;2021-06-28;818;2482;213898;144524;52.4;35.4
24;2021-06-29;938;2867;214836;147391;52.6;36.1
24;2021-06-30;1111;2455;215947;149846;52.9;36.7
24;2021-07-01;1131;2303;217078;152149;53.2;37.3
24;2021-07-02;1096;2745;218174;154894;53.4;37.9
24;2021-07-03;811;1903;218985;156797;53.6;38.4
24;2021-07-04;411;1013;219396;157810;53.7;38.6
24;2021-07-05;793;2316;220189;160126;53.9;39.2
24;2021-07-06;879;3354;221068;163480;54.1;40.0
24;2021-07-07;1086;3041;222154;166521;54.4;40.8
24;2021-07-08;1339;2118;223493;168639;54.7;41.3
24;2021-07-09;1177;3216;224670;171855;55.0;42.1
24;2021-07-10;481;1963;225151;173818;55.1;42.6
24;2021-07-11;587;1189;225738;175007;55.3;42.9
24;2021-07-12;907;2516;226645;177523;55.5;43.5
24;2021-07-13;1323;3217;227968;180740;55.8;44.3
24;2021-07-14;619;1189;228587;181929;56.0;44.5
24;2021-07-15;1697;2776;230284;184705;56.4;45.2
24;2021-07-16;2149;2598;232433;187303;56.9;45.9
24;2021-07-17;1528;2239;233961;189542;57.3;46.4
24;2021-07-18;709;887;234670;190429;57.5;46.6
24;2021-07-19;1580;2187;236250;192616;57.8;47.2
24;2021-07-20;2017;2435;238267;195051;58.3;47.8
24;2021-07-21;1875;2329;240142;197380;58.8;48.3
24;2021-07-22;2351;2441;242493;199821;59.4;48.9
24;2021-07-23;2303;2623;244796;202444;59.9;49.6
24;2021-07-24;1807;1545;246603;203989;60.4;49.9
24;2021-07-25;816;875;247419;204864;60.6;50.2
24;2021-07-26;1572;2015;248991;206879;61.0;50.7
24;2021-07-27;2848;2289;251839;209168;61.7;51.2
24;2021-07-28;2765;1936;254604;211104;62.3;51.7
24;2021-07-29;3063;2239;257667;213343;63.1;52.2
24;2021-07-30;2466;1919;260133;215262;63.7;52.7
24;2021-07-31;1654;1566;261787;216828;64.1;53.1
24;2021-08-01;1117;658;262904;217486;64.4;53.3
24;2021-08-02;1946;1623;264850;219109;64.9;53.7
24;2021-08-03;2887;1908;267737;221017;65.6;54.1
24;2021-08-04;3077;1631;270814;222648;66.3;54.5
24;2021-08-05;3049;1440;273863;224088;67.1;54.9
24;2021-08-06;2537;1540;276400;225628;67.7;55.2
24;2021-08-07;1792;1120;278192;226748;68.1;55.5
24;2021-08-08;1108;687;279300;227435;68.4;55.7
24;2021-08-09;1740;1383;281040;228818;68.8;56.0
24;2021-08-10;2266;1786;283306;230604;69.4;56.5
24;2021-08-11;2279;1698;285585;232302;69.9;56.9
24;2021-08-12;1916;1956;287501;234258;70.4;57.4
24;2021-08-13;1530;1625;289031;235883;70.8;57.8
24;2021-08-14;1171;1242;290202;237125;71.1;58.1
24;2021-08-15;741;583;290943;237708;71.2;58.2
24;2021-08-16;1123;1705;292066;239413;71.5;58.6
24;2021-08-17;1632;2108;293698;241521;71.9;59.1
24;2021-08-18;1562;1925;295260;243446;72.3;59.6
24;2021-08-19;1125;2635;296385;246081;72.6;60.3
24;2021-08-20;1107;2429;297492;248510;72.8;60.9
24;2021-08-21;874;1634;298366;250144;73.1;61.3
24;2021-08-22;350;1101;298716;251245;73.1;61.5
24;2021-08-23;673;2036;299389;253281;73.3;62.0
24;2021-08-24;818;2395;300207;255676;73.5;62.6
24;2021-08-25;813;2323;301020;257999;73.7;63.2
24;2021-08-26;747;2839;301767;260838;73.9;63.9
24;2021-08-27;801;2765;302568;263603;74.1;64.5
24;2021-08-28;522;1909;303090;265512;74.2;65.0
24;2021-08-29;171;1029;303261;266541;74.3;65.3
24;2021-08-30;376;1965;303637;268506;74.3;65.7
24;2021-08-31;592;2489;304229;270995;74.5;66.4
24;2021-09-01;626;2480;304855;273475;74.6;67.0
24;2021-09-02;465;1900;305320;275375;74.8;67.4
24;2021-09-03;550;2236;305870;277611;74.9;68.0
24;2021-09-04;365;1996;306235;279607;75.0;68.5
24;2021-09-05;245;974;306480;280581;75.0;68.7
24;2021-09-06;344;1622;306824;282203;75.1;69.1
24;2021-09-07;478;1893;307302;284096;75.2;69.6
24;2021-09-08;401;1928;307703;286024;75.3;70.0
24;2021-09-09;335;1345;308038;287369;75.4;70.4
24;2021-09-10;386;1785;308424;289154;75.5;70.8
24;2021-09-11;317;1686;308741;290840;75.6;71.2
24;2021-09-12;92;432;308833;291272;75.6;71.3
24;2021-09-13;294;1233;309127;292505;75.7;71.6
24;2021-09-14;430;1134;309557;293639;75.8;71.9
24;2021-09-15;412;1267;309969;294906;75.9;72.2
24;2021-09-16;247;890;310216;295796;76.0;72.4
24;2021-09-17;409;1037;310625;296833;76.1;72.7
24;2021-09-18;311;1111;310936;297944;76.1;73.0
24;2021-09-19;45;347;310981;298291;76.1;73.0
24;2021-09-20;154;577;311135;298868;76.2;73.2
24;2021-09-21;379;407;311514;299275;76.3;73.3
24;2021-09-22;226;697;311740;299972;76.3;73.5
24;2021-09-23;135;389;311875;300361;76.4;73.5
24;2021-09-24;248;812;312123;301173;76.4;73.7
24;2021-09-25;215;592;312338;301765;76.5;73.9
24;2021-09-26;32;106;312370;301871;76.5;73.9
24;2021-09-27;179;494;312549;302365;76.5;74.0
24;2021-09-28;209;328;312758;302693;76.6;74.1
24;2021-09-29;227;586;312985;303279;76.6;74.3
24;2021-09-30;253;439;313238;303718;76.7;74.4
24;2021-10-01;229;487;313467;304205;76.8;74.5
24;2021-10-02;193;483;313660;304688;76.8;74.6
24;2021-10-03;17;39;313677;304727;76.8;74.6
24;2021-10-04;112;287;313789;305014;76.8;74.7
24;2021-10-05;102;340;313891;305354;76.9;74.8
24;2021-10-06;194;437;314085;305791;76.9;74.9
25;2020-12-27;0;0;0;0;0.0;0.0
25;2020-12-28;1;0;1;0;0.0;0.0
25;2020-12-29;0;0;1;0;0.0;0.0
25;2020-12-30;0;0;1;0;0.0;0.0
25;2020-12-31;3;0;4;0;0.0;0.0
25;2021-01-01;0;0;4;0;0.0;0.0
25;2021-01-02;1;0;5;0;0.0;0.0
25;2021-01-03;0;0;5;0;0.0;0.0
25;2021-01-04;1;0;6;0;0.0;0.0
25;2021-01-05;1;0;7;0;0.0;0.0
25;2021-01-06;75;1;82;1;0.0;0.0
25;2021-01-07;235;1;317;2;0.1;0.0
25;2021-01-08;345;1;662;3;0.1;0.0
25;2021-01-09;102;0;764;3;0.1;0.0
25;2021-01-10;0;0;764;3;0.1;0.0
25;2021-01-11;503;5;1267;8;0.2;0.0
25;2021-01-12;682;2;1949;10;0.4;0.0
25;2021-01-13;627;2;2576;12;0.5;0.0
25;2021-01-14;896;12;3472;24;0.6;0.0
25;2021-01-15;786;9;4258;33;0.8;0.0
25;2021-01-16;206;0;4464;33;0.8;0.0
25;2021-01-17;112;0;4576;33;0.8;0.0
25;2021-01-18;1298;6;5874;39;1.1;0.0
25;2021-01-19;1414;5;7288;44;1.4;0.0
25;2021-01-20;1421;4;8709;48;1.6;0.0
25;2021-01-21;1843;3;10552;51;2.0;0.0
25;2021-01-22;1509;5;12061;56;2.2;0.0
25;2021-01-23;499;0;12560;56;2.3;0.0
25;2021-01-24;119;0;12679;56;2.4;0.0
25;2021-01-25;990;0;13669;56;2.5;0.0
25;2021-01-26;1490;41;15159;97;2.8;0.0
25;2021-01-27;1248;67;16407;164;3.0;0.0
25;2021-01-28;1090;74;17497;238;3.2;0.0
25;2021-01-29;906;200;18403;438;3.4;0.1
25;2021-01-30;293;82;18696;520;3.5;0.1
25;2021-01-31;2;0;18698;520;3.5;0.1
25;2021-02-01;613;201;19311;721;3.6;0.1
25;2021-02-02;674;363;19985;1084;3.7;0.2
25;2021-02-03;758;214;20743;1298;3.8;0.2
25;2021-02-04;715;365;21458;1663;4.0;0.3
25;2021-02-05;521;425;21979;2088;4.1;0.4
25;2021-02-06;197;138;22176;2226;4.1;0.4
25;2021-02-07;2;34;22178;2260;4.1;0.4
25;2021-02-08;612;454;22790;2714;4.2;0.5
25;2021-02-09;615;422;23405;3136;4.3;0.6
25;2021-02-10;818;427;24223;3563;4.5;0.7
25;2021-02-11;589;734;24812;4297;4.6;0.8
25;2021-02-12;413;466;25225;4763;4.7;0.9
25;2021-02-13;97;113;25322;4876;4.7;0.9
25;2021-02-14;0;0;25322;4876;4.7;0.9
25;2021-02-15;186;811;25508;5687;4.7;1.1
25;2021-02-16;213;1178;25721;6865;4.8;1.3
25;2021-02-17;107;1027;25828;7892;4.8;1.5
25;2021-02-18;147;1139;25975;9031;4.8;1.7
25;2021-02-19;102;999;26077;10030;4.8;1.9
25;2021-02-20;27;364;26104;10394;4.8;1.9
25;2021-02-21;1;102;26105;10496;4.8;1.9
25;2021-02-22;83;875;26188;11371;4.9;2.1
25;2021-02-23;195;862;26383;12233;4.9;2.3
25;2021-02-24;104;804;26487;13037;4.9;2.4
25;2021-02-25;522;798;27009;13835;5.0;2.6
25;2021-02-26;607;817;27616;14652;5.1;2.7
25;2021-02-27;228;313;27844;14965;5.2;2.8
25;2021-02-28;6;1;27850;14966;5.2;2.8
25;2021-03-01;442;532;28292;15498;5.2;2.9
25;2021-03-02;654;709;28946;16207;5.4;3.0
25;2021-03-03;544;657;29490;16864;5.5;3.1
25;2021-03-04;1159;601;30649;17465;5.7;3.2
25;2021-03-05;1854;350;32503;17815;6.0;3.3
25;2021-03-06;1170;208;33673;18023;6.2;3.3
25;2021-03-07;9;7;33682;18030;6.2;3.3
25;2021-03-08;548;632;34230;18662;6.3;3.5
25;2021-03-09;1040;713;35270;19375;6.5;3.6
25;2021-03-10;1150;595;36420;19970;6.8;3.7
25;2021-03-11;1657;547;38077;20517;7.1;3.8
25;2021-03-12;1996;443;40073;20960;7.4;3.9
25;2021-03-13;1121;97;41194;21057;7.6;3.9
25;2021-03-14;35;0;41229;21057;7.6;3.9
25;2021-03-15;1125;138;42354;21195;7.9;3.9
25;2021-03-16;1288;123;43642;21318;8.1;4.0
25;2021-03-17;1413;137;45055;21455;8.4;4.0
25;2021-03-18;1526;85;46581;21540;8.6;4.0
25;2021-03-19;1595;127;48176;21667;8.9;4.0
25;2021-03-20;822;38;48998;21705;9.1;4.0
25;2021-03-21;24;0;49022;21705;9.1;4.0
25;2021-03-22;1485;85;50507;21790;9.4;4.0
25;2021-03-23;2161;160;52668;21950;9.8;4.1
25;2021-03-24;2418;97;55086;22047;10.2;4.1
25;2021-03-25;2837;195;57923;22242;10.7;4.1
25;2021-03-26;3160;182;61083;22424;11.3;4.2
25;2021-03-27;1112;89;62195;22513;11.5;4.2
25;2021-03-28;121;65;62316;22578;11.6;4.2
25;2021-03-29;1791;276;64107;22854;11.9;4.2
25;2021-03-30;2214;397;66321;23251;12.3;4.3
25;2021-03-31;2220;359;68541;23610;12.7;4.4
25;2021-04-01;2451;524;70992;24134;13.2;4.5
25;2021-04-02;2026;608;73018;24742;13.5;4.6
25;2021-04-03;447;110;73465;24852;13.6;4.6
25;2021-04-04;39;19;73504;24871;13.6;4.6
25;2021-04-05;145;4;73649;24875;13.7;4.6
25;2021-04-06;1937;686;75586;25561;14.0;4.7
25;2021-04-07;1878;850;77464;26411;14.4;4.9
25;2021-04-08;2435;822;79899;27233;14.8;5.0
25;2021-04-09;2597;997;82496;28230;15.3;5.2
25;2021-04-10;978;288;83474;28518;15.5;5.3
25;2021-04-11;105;28;83579;28546;15.5;5.3
25;2021-04-12;1556;966;85135;29512;15.8;5.5
25;2021-04-13;1988;1320;87123;30832;16.2;5.7
25;2021-04-14;1750;1215;88873;32047;16.5;5.9
25;2021-04-15;1997;1326;90870;33373;16.8;6.2
25;2021-04-16;2085;1007;92955;34380;17.2;6.4
25;2021-04-17;1104;415;94059;34795;17.4;6.5
25;2021-04-18;118;18;94177;34813;17.5;6.5
25;2021-04-19;1327;1243;95504;36056;17.7;6.7
25;2021-04-20;1615;1460;97119;37516;18.0;7.0
25;2021-04-21;1717;1631;98836;39147;18.3;7.3
25;2021-04-22;1855;1709;100691;40856;18.7;7.6
25;2021-04-23;1903;1771;102594;42627;19.0;7.9
25;2021-04-24;1278;703;103872;43330;19.3;8.0
25;2021-04-25;140;114;104012;43444;19.3;8.1
25;2021-04-26;1722;1686;105734;45130;19.6;8.4
25;2021-04-27;2804;1521;108538;46651;20.1;8.6
25;2021-04-28;2425;1554;110963;48205;20.6;8.9
25;2021-04-29;2648;1822;113611;50027;21.1;9.3
25;2021-04-30;3107;1559;116718;51586;21.6;9.6
25;2021-05-01;1789;334;118507;51920;22.0;9.6
25;2021-05-02;442;22;118949;51942;22.1;9.6
25;2021-05-03;2901;847;121850;52789;22.6;9.8
25;2021-05-04;2639;1881;124489;54670;23.1;10.1
25;2021-05-05;2597;1666;127086;56336;23.6;10.4
25;2021-05-06;2927;2165;130013;58501;24.1;10.8
25;2021-05-07;3063;2116;133076;60617;24.7;11.2
25;2021-05-08;1334;229;134410;60846;24.9;11.3
25;2021-05-09;244;87;134654;60933;25.0;11.3
25;2021-05-10;3129;1635;137783;62568;25.5;11.6
25;2021-05-11;3747;2037;141530;64605;26.2;12.0
25;2021-05-12;3688;1789;145218;66394;26.9;12.3
25;2021-05-13;3523;598;148741;66992;27.6;12.4
25;2021-05-14;4482;1304;153223;68296;28.4;12.7
25;2021-05-15;3282;710;156505;69006;29.0;12.8
25;2021-05-16;723;93;157228;69099;29.1;12.8
25;2021-05-17;4089;1098;161317;70197;29.9;13.0
25;2021-05-18;5205;1194;166522;71391;30.9;13.2
25;2021-05-19;5247;1134;171769;72525;31.8;13.4
25;2021-05-20;5134;1451;176903;73976;32.8;13.7
25;2021-05-21;5764;1982;182667;75958;33.9;14.1
25;2021-05-22;3174;722;185841;76680;34.5;14.2
25;2021-05-23;781;157;186622;76837;34.6;14.2
25;2021-05-24;1529;152;188151;76989;34.9;14.3
25;2021-05-25;3513;1651;191664;78640;35.5;14.6
25;2021-05-26;3974;1560;195638;80200;36.3;14.9
25;2021-05-27;4519;1895;200157;82095;37.1;15.2
25;2021-05-28;3994;2651;204151;84746;37.8;15.7
25;2021-05-29;2016;1021;206167;85767;38.2;15.9
25;2021-05-30;174;96;206341;85863;38.3;15.9
25;2021-05-31;2672;1705;209013;87568;38.7;16.2
25;2021-06-01;2729;2155;211742;89723;39.3;16.6
25;2021-06-02;2608;2247;214350;91970;39.7;17.0
25;2021-06-03;3274;2045;217624;94015;40.3;17.4
25;2021-06-04;3209;2409;220833;96424;40.9;17.9
25;2021-06-05;1491;1402;222324;97826;41.2;18.1
25;2021-06-06;987;259;223311;98085;41.4;18.2
25;2021-06-07;2782;2575;226093;100660;41.9;18.7
25;2021-06-08;2603;2761;228696;103421;42.4;19.2
25;2021-06-09;2382;2763;231078;106184;42.8;19.7
25;2021-06-10;2325;2653;233403;108837;43.3;20.2
25;2021-06-11;2709;3302;236112;112139;43.8;20.8
25;2021-06-12;1571;1855;237683;113994;44.1;21.1
25;2021-06-13;497;257;238180;114251;44.2;21.2
25;2021-06-14;1421;3753;239601;118004;44.4;21.9
25;2021-06-15;1643;3567;241244;121571;44.7;22.5
25;2021-06-16;1954;3273;243198;124844;45.1;23.1
25;2021-06-17;1474;3321;244672;128165;45.4;23.8
25;2021-06-18;2286;4297;246958;132462;45.8;24.6
25;2021-06-19;1349;1978;248307;134440;46.0;24.9
25;2021-06-20;59;239;248366;134679;46.0;25.0
25;2021-06-21;1139;4139;249505;138818;46.3;25.7
25;2021-06-22;1151;4672;250656;143490;46.5;26.6
25;2021-06-23;1404;4072;252060;147562;46.7;27.4
25;2021-06-24;1191;4085;253251;151647;46.9;28.1
25;2021-06-25;1640;5603;254891;157250;47.3;29.2
25;2021-06-26;626;3384;255517;160634;47.4;29.8
25;2021-06-27;451;877;255968;161511;47.4;29.9
25;2021-06-28;907;4476;256875;165987;47.6;30.8
25;2021-06-29;1130;5469;258005;171456;47.8;31.8
25;2021-06-30;1311;5371;259316;176827;48.1;32.8
25;2021-07-01;1706;5230;261022;182057;48.4;33.7
25;2021-07-02;1748;5061;262770;187118;48.7;34.7
25;2021-07-03;1042;2692;263812;189810;48.9;35.2
25;2021-07-04;409;722;264221;190532;49.0;35.3
25;2021-07-05;1299;2579;265520;193111;49.2;35.8
25;2021-07-06;1568;4746;267088;197857;49.5;36.7
25;2021-07-07;1597;4501;268685;202358;49.8;37.5
25;2021-07-08;1554;3932;270239;206290;50.1;38.2
25;2021-07-09;1796;4589;272035;210879;50.4;39.1
25;2021-07-10;781;2371;272816;213250;50.6;39.5
25;2021-07-11;127;307;272943;213557;50.6;39.6
25;2021-07-12;1404;3859;274347;217416;50.9;40.3
25;2021-07-13;2470;4769;276817;222185;51.3;41.2
25;2021-07-14;379;561;277196;222746;51.4;41.3
25;2021-07-15;2402;3656;279598;226402;51.8;42.0
25;2021-07-16;3485;3831;283083;230233;52.5;42.7
25;2021-07-17;2207;2040;285290;232273;52.9;43.1
25;2021-07-18;808;1300;286098;233573;53.0;43.3
25;2021-07-19;2543;4207;288641;237780;53.5;44.1
25;2021-07-20;3384;3714;292025;241494;54.1;44.8
25;2021-07-21;3300;3368;295325;244862;54.7;45.4
25;2021-07-22;3351;2984;298676;247846;55.4;45.9
25;2021-07-23;3566;3357;302242;251203;56.0;46.6
25;2021-07-24;1413;2270;303655;253473;56.3;47.0
25;2021-07-25;679;710;304334;254183;56.4;47.1
25;2021-07-26;3056;3009;307390;257192;57.0;47.7
25;2021-07-27;3835;2124;311225;259316;57.7;48.1
25;2021-07-28;3692;2120;314917;261436;58.4;48.5
25;2021-07-29;4320;2093;319237;263529;59.2;48.9
25;2021-07-30;4291;2490;323528;266019;60.0;49.3
25;2021-07-31;1821;1469;325349;267488;60.3;49.6
25;2021-08-01;1352;201;326701;267689;60.6;49.6
25;2021-08-02;2743;2211;329444;269900;61.1;50.0
25;2021-08-03;2839;2203;332283;272103;61.6;50.4
25;2021-08-04;2941;1429;335224;273532;62.1;50.7
25;2021-08-05;2205;1732;337429;275264;62.6;51.0
25;2021-08-06;2289;2349;339718;277613;63.0;51.5
25;2021-08-07;1294;1206;341012;278819;63.2;51.7
25;2021-08-08;325;477;341337;279296;63.3;51.8
25;2021-08-09;2025;2230;343362;281526;63.7;52.2
25;2021-08-10;1975;2524;345337;284050;64.0;52.7
25;2021-08-11;1832;2033;347169;286083;64.4;53.0
25;2021-08-12;2148;2503;349317;288586;64.8;53.5
25;2021-08-13;1712;2023;351029;290609;65.1;53.9
25;2021-08-14;969;1791;351998;292400;65.3;54.2
25;2021-08-15;9;45;352007;292445;65.3;54.2
25;2021-08-16;1262;3261;353269;295706;65.5;54.8
25;2021-08-17;1458;3285;354727;298991;65.8;55.4
25;2021-08-18;1235;2804;355962;301795;66.0;55.9
25;2021-08-19;987;2867;356949;304662;66.2;56.5
25;2021-08-20;1433;3693;358382;308355;66.4;57.2
25;2021-08-21;568;1782;358950;310137;66.5;57.5
25;2021-08-22;212;1273;359162;311410;66.6;57.7
25;2021-08-23;1116;3335;360278;314745;66.8;58.3
25;2021-08-24;1071;3234;361349;317979;67.0;58.9
25;2021-08-25;1018;3061;362367;321040;67.2;59.5
25;2021-08-26;1144;3006;363511;324046;67.4;60.1
25;2021-08-27;1204;3064;364715;327110;67.6;60.6
25;2021-08-28;588;1791;365303;328901;67.7;61.0
25;2021-08-29;161;513;365464;329414;67.7;61.1
25;2021-08-30;939;2824;366403;332238;67.9;61.6
25;2021-08-31;969;2420;367372;334658;68.1;62.0
25;2021-09-01;842;2575;368214;337233;68.3;62.5
25;2021-09-02;775;1954;368989;339187;68.4;62.9
25;2021-09-03;798;2216;369787;341403;68.5;63.3
25;2021-09-04;692;1556;370479;342959;68.7;63.6
25;2021-09-05;128;234;370607;343193;68.7;63.6
25;2021-09-06;632;1845;371239;345038;68.8;64.0
25;2021-09-07;490;1418;371729;346456;68.9;64.2
25;2021-09-08;623;2000;372352;348456;69.0;64.6
25;2021-09-09;425;1366;372777;349822;69.1;64.8
25;2021-09-10;847;2070;373624;351892;69.3;65.2
25;2021-09-11;375;1144;373999;353036;69.3;65.4
25;2021-09-12;111;231;374110;353267;69.4;65.5
25;2021-09-13;726;1341;374836;354608;69.5;65.7
25;2021-09-14;626;1325;375462;355933;69.6;66.0
25;2021-09-15;759;1480;376221;357413;69.7;66.3
25;2021-09-16;500;829;376721;358242;69.8;66.4
25;2021-09-17;740;1338;377461;359580;70.0;66.7
25;2021-09-18;319;870;377780;360450;70.0;66.8
25;2021-09-19;77;163;377857;360613;70.0;66.8
25;2021-09-20;455;742;378312;361355;70.1;67.0
25;2021-09-21;202;591;378514;361946;70.2;67.1
25;2021-09-22;450;1192;378964;363138;70.3;67.3
25;2021-09-23;252;456;379216;363594;70.3;67.4
25;2021-09-24;491;1052;379707;364646;70.4;67.6
25;2021-09-25;282;895;379989;365541;70.4;67.8
25;2021-09-26;8;5;379997;365546;70.4;67.8
25;2021-09-27;293;586;380290;366132;70.5;67.9
25;2021-09-28;209;442;380499;366574;70.5;68.0
25;2021-09-29;458;821;380957;367395;70.6;68.1
25;2021-09-30;224;362;381181;367757;70.7;68.2
25;2021-10-01;424;887;381605;368644;70.7;68.3
25;2021-10-02;276;578;381881;369222;70.8;68.4
25;2021-10-03;9;6;381890;369228;70.8;68.4
25;2021-10-04;323;728;382213;369956;70.9;68.6
25;2021-10-05;115;366;382328;370322;70.9;68.6
25;2021-10-06;403;758;382731;371080;70.9;68.8
26;2020-12-27;0;0;0;0;0.0;0.0
26;2020-12-28;0;0;0;0;0.0;0.0
26;2020-12-29;0;0;0;0;0.0;0.0
26;2020-12-30;0;0;0;0;0.0;0.0
26;2020-12-31;0;0;0;0;0.0;0.0
26;2021-01-01;1;0;1;0;0.0;0.0
26;2021-01-02;0;0;1;0;0.0;0.0
26;2021-01-03;0;0;1;0;0.0;0.0
26;2021-01-04;0;0;1;0;0.0;0.0
26;2021-01-05;0;0;1;0;0.0;0.0
26;2021-01-06;0;0;1;0;0.0;0.0
26;2021-01-07;168;0;169;0;0.0;0.0
26;2021-01-08;125;0;294;0;0.1;0.0
26;2021-01-09;2;0;296;0;0.1;0.0
26;2021-01-10;0;0;296;0;0.1;0.0
26;2021-01-11;266;2;562;2;0.1;0.0
26;2021-01-12;176;1;738;3;0.1;0.0
26;2021-01-13;418;1;1156;4;0.2;0.0
26;2021-01-14;489;0;1645;4;0.3;0.0
26;2021-01-15;563;1;2208;5;0.4;0.0
26;2021-01-16;250;1;2458;6;0.5;0.0
26;2021-01-17;0;0;2458;6;0.5;0.0
26;2021-01-18;637;1;3095;7;0.6;0.0
26;2021-01-19;786;2;3881;9;0.7;0.0
26;2021-01-20;742;0;4623;9;0.9;0.0
26;2021-01-21;807;2;5430;11;1.0;0.0
26;2021-01-22;787;4;6217;15;1.2;0.0
26;2021-01-23;563;3;6780;18;1.3;0.0
26;2021-01-24;24;0;6804;18;1.3;0.0
26;2021-01-25;696;2;7500;20;1.4;0.0
26;2021-01-26;800;4;8300;24;1.6;0.0
26;2021-01-27;823;6;9123;30;1.8;0.0
26;2021-01-28;1330;104;10453;134;2.0;0.0
26;2021-01-29;971;63;11424;197;2.2;0.0
26;2021-01-30;606;5;12030;202;2.3;0.0
26;2021-01-31;24;0;12054;202;2.3;0.0
26;2021-02-01;709;175;12763;377;2.5;0.1
26;2021-02-02;1276;199;14039;576;2.7;0.1
26;2021-02-03;1265;245;15304;821;2.9;0.2
26;2021-02-04;985;402;16289;1223;3.1;0.2
26;2021-02-05;674;291;16963;1514;3.3;0.3
26;2021-02-06;407;170;17370;1684;3.3;0.3
26;2021-02-07;57;2;17427;1686;3.3;0.3
26;2021-02-08;545;351;17972;2037;3.5;0.4
26;2021-02-09;617;405;18589;2442;3.6;0.5
26;2021-02-10;665;288;19254;2730;3.7;0.5
26;2021-02-11;753;252;20007;2982;3.8;0.6
26;2021-02-12;591;387;20598;3369;4.0;0.6
26;2021-02-13;388;237;20986;3606;4.0;0.7
26;2021-02-14;36;0;21022;3606;4.0;0.7
26;2021-02-15;414;397;21436;4003;4.1;0.8
26;2021-02-16;294;436;21730;4439;4.2;0.9
26;2021-02-17;194;579;21924;5018;4.2;1.0
26;2021-02-18;337;754;22261;5772;4.3;1.1
26;2021-02-19;341;691;22602;6463;4.3;1.2
26;2021-02-20;95;371;22697;6834;4.4;1.3
26;2021-02-21;3;17;22700;6851;4.4;1.3
26;2021-02-22;144;531;22844;7382;4.4;1.4
26;2021-02-23;398;879;23242;8261;4.5;1.6
26;2021-02-24;346;1082;23588;9343;4.5;1.8
26;2021-02-25;746;912;24334;10255;4.7;2.0
26;2021-02-26;925;531;25259;10786;4.9;2.1
26;2021-02-27;278;417;25537;11203;4.9;2.2
26;2021-02-28;3;28;25540;11231;4.9;2.2
26;2021-03-01;459;566;25999;11797;5.0;2.3
26;2021-03-02;742;534;26741;12331;5.1;2.4
26;2021-03-03;731;604;27472;12935;5.3;2.5
26;2021-03-04;1045;504;28517;13439;5.5;2.6
26;2021-03-05;1710;474;30227;13913;5.8;2.7
26;2021-03-06;2773;427;33000;14340;6.3;2.8
26;2021-03-07;2989;218;35989;14558;6.9;2.8
26;2021-03-08;908;582;36897;15140;7.1;2.9
26;2021-03-09;1325;501;38222;15641;7.3;3.0
26;2021-03-10;1218;470;39440;16111;7.6;3.1
26;2021-03-11;1610;613;41050;16724;7.9;3.2
26;2021-03-12;2215;458;43265;17182;8.3;3.3
26;2021-03-13;1886;317;45151;17499;8.7;3.4
26;2021-03-14;69;39;45220;17538;8.7;3.4
26;2021-03-15;1653;245;46873;17783;9.0;3.4
26;2021-03-16;1232;510;48105;18293;9.2;3.5
26;2021-03-17;1369;295;49474;18588;9.5;3.6
26;2021-03-18;1587;277;51061;18865;9.8;3.6
26;2021-03-19;2444;343;53505;19208;10.3;3.7
26;2021-03-20;1290;152;54795;19360;10.5;3.7
26;2021-03-21;61;20;54856;19380;10.5;3.7
26;2021-03-22;1847;196;56703;19576;10.9;3.8
26;2021-03-23;2474;277;59177;19853;11.4;3.8
26;2021-03-24;2551;245;61728;20098;11.9;3.9
26;2021-03-25;3044;339;64772;20437;12.4;3.9
26;2021-03-26;3053;356;67825;20793;13.0;4.0
26;2021-03-27;1243;162;69068;20955;13.3;4.0
26;2021-03-28;94;7;69162;20962;13.3;4.0
26;2021-03-29;1908;406;71070;21368;13.7;4.1
26;2021-03-30;2383;548;73453;21916;14.1;4.2
26;2021-03-31;2229;582;75682;22498;14.5;4.3
26;2021-04-01;2279;780;77961;23278;15.0;4.5
26;2021-04-02;2213;988;80174;24266;15.4;4.7
26;2021-04-03;551;1199;80725;25465;15.5;4.9
26;2021-04-04;215;883;80940;26348;15.5;5.1
26;2021-04-05;557;52;81497;26400;15.7;5.1
26;2021-04-06;1486;832;82983;27232;15.9;5.2
26;2021-04-07;1793;895;84776;28127;16.3;5.4
26;2021-04-08;3008;937;87784;29064;16.9;5.6
26;2021-04-09;3415;1009;91199;30073;17.5;5.8
26;2021-04-10;1356;924;92555;30997;17.8;6.0
26;2021-04-11;88;35;92643;31032;17.8;6.0
26;2021-04-12;1713;1125;94356;32157;18.1;6.2
26;2021-04-13;2797;1450;97153;33607;18.7;6.5
26;2021-04-14;2204;1484;99357;35091;19.1;6.7
26;2021-04-15;2282;1589;101639;36680;19.5;7.0
26;2021-04-16;2272;1589;103911;38269;20.0;7.4
26;2021-04-17;1095;840;105006;39109;20.2;7.5
26;2021-04-18;36;52;105042;39161;20.2;7.5
26;2021-04-19;1547;1570;106589;40731;20.5;7.8
26;2021-04-20;1796;1724;108385;42455;20.8;8.2
26;2021-04-21;2012;1509;110397;43964;21.2;8.4
26;2021-04-22;2289;1599;112686;45563;21.6;8.8
26;2021-04-23;2012;1638;114698;47201;22.0;9.1
26;2021-04-24;1655;844;116353;48045;22.4;9.2
26;2021-04-25;629;97;116982;48142;22.5;9.2
26;2021-04-26;1377;1595;118359;49737;22.7;9.6
26;2021-04-27;1986;1684;120345;51421;23.1;9.9
26;2021-04-28;1865;1540;122210;52961;23.5;10.2
26;2021-04-29;2866;1892;125076;54853;24.0;10.5
26;2021-04-30;2626;1762;127702;56615;24.5;10.9
26;2021-05-01;1538;380;129240;56995;24.8;10.9
26;2021-05-02;1084;118;130324;57113;25.0;11.0
26;2021-05-03;2200;1786;132524;58899;25.5;11.3
26;2021-05-04;2614;2363;135138;61262;26.0;11.8
26;2021-05-05;2772;2196;137910;63458;26.5;12.2
26;2021-05-06;3322;2225;141232;65683;27.1;12.6
26;2021-05-07;2860;2257;144092;67940;27.7;13.1
26;2021-05-08;1960;619;146052;68559;28.1;13.2
26;2021-05-09;713;123;146765;68682;28.2;13.2
26;2021-05-10;3022;1827;149787;70509;28.8;13.5
26;2021-05-11;4445;2182;154232;72691;29.6;14.0
26;2021-05-12;4828;1694;159060;74385;30.6;14.3
26;2021-05-13;4363;617;163423;75002;31.4;14.4
26;2021-05-14;4640;1549;168063;76551;32.3;14.7
26;2021-05-15;4468;625;172531;77176;33.1;14.8
26;2021-05-16;3629;344;176160;77520;33.8;14.9
26;2021-05-17;3657;1486;179817;79006;34.5;15.2
26;2021-05-18;4474;1741;184291;80747;35.4;15.5
26;2021-05-19;4486;1450;188777;82197;36.3;15.8
26;2021-05-20;4685;1767;193462;83964;37.2;16.1
26;2021-05-21;4729;1798;198191;85762;38.1;16.5
26;2021-05-22;3189;690;201380;86452;38.7;16.6
26;2021-05-23;1597;183;202977;86635;39.0;16.6
26;2021-05-24;3788;743;206765;87378;39.7;16.8
26;2021-05-25;3591;2345;210356;89723;40.4;17.2
26;2021-05-26;4177;2271;214533;91994;41.2;17.7
26;2021-05-27;4211;2459;218744;94453;42.0;18.1
26;2021-05-28;3776;2766;222520;97219;42.7;18.7
26;2021-05-29;3088;1654;225608;98873;43.3;19.0
26;2021-05-30;320;70;225928;98943;43.4;19.0
26;2021-05-31;3082;1854;229010;100797;44.0;19.4
26;2021-06-01;3110;2308;232120;103105;44.6;19.8
26;2021-06-02;2869;2219;234989;105324;45.1;20.2
26;2021-06-03;2850;2487;237839;107811;45.7;20.7
26;2021-06-04;2658;2908;240497;110719;46.2;21.3
26;2021-06-05;1806;1694;242303;112413;46.5;21.6
26;2021-06-06;9;0;242312;112413;46.5;21.6
26;2021-06-07;2346;2430;244658;114843;47.0;22.1
26;2021-06-08;2453;2293;247111;117136;47.5;22.5
26;2021-06-09;2096;2387;249207;119523;47.9;23.0
26;2021-06-10;1981;2763;251188;122286;48.3;23.5
26;2021-06-11;1896;3273;253084;125559;48.6;24.1
26;2021-06-12;1219;1790;254303;127349;48.9;24.5
26;2021-06-13;97;214;254400;127563;48.9;24.5
26;2021-06-14;1415;3498;255815;131061;49.1;25.2
26;2021-06-15;1586;3963;257401;135024;49.4;25.9
26;2021-06-16;1784;3472;259185;138496;49.8;26.6
26;2021-06-17;1509;3166;260694;141662;50.1;27.2
26;2021-06-18;1797;4368;262491;146030;50.4;28.1
26;2021-06-19;933;3177;263424;149207;50.6;28.7
26;2021-06-20;263;876;263687;150083;50.7;28.8
26;2021-06-21;1005;4557;264692;154640;50.8;29.7
26;2021-06-22;1061;5119;265753;159759;51.1;30.7
26;2021-06-23;1168;5072;266921;164831;51.3;31.7
26;2021-06-24;1258;4544;268179;169375;51.5;32.5
26;2021-06-25;1014;5541;269193;174916;51.7;33.6
26;2021-06-26;662;3823;269855;178739;51.8;34.3
26;2021-06-27;299;1273;270154;180012;51.9;34.6
26;2021-06-28;778;4757;270932;184769;52.0;35.5
26;2021-06-29;1097;4955;272029;189724;52.3;36.4
26;2021-06-30;1411;4890;273440;194614;52.5;37.4
26;2021-07-01;1651;4388;275091;199002;52.8;38.2
26;2021-07-02;1333;5163;276424;204165;53.1;39.2
26;2021-07-03;769;3321;277193;207486;53.2;39.9
26;2021-07-04;331;633;277524;208119;53.3;40.0
26;2021-07-05;887;4673;278411;212792;53.5;40.9
26;2021-07-06;1266;4199;279677;216991;53.7;41.7
26;2021-07-07;1440;3796;281117;220787;54.0;42.4
26;2021-07-08;2387;3330;283504;224117;54.5;43.1
26;2021-07-09;1558;4787;285062;228904;54.8;44.0
26;2021-07-10;910;2913;285972;231817;54.9;44.5
26;2021-07-11;332;347;286304;232164;55.0;44.6
26;2021-07-12;1113;4218;287417;236382;55.2;45.4
26;2021-07-13;2301;4343;289718;240725;55.7;46.2
26;2021-07-14;1060;814;290778;241539;55.9;46.4
26;2021-07-15;3166;3656;293944;245195;56.5;47.1
26;2021-07-16;3000;3688;296944;248883;57.0;47.8
26;2021-07-17;1876;1814;298820;250697;57.4;48.2
26;2021-07-18;20;24;298840;250721;57.4;48.2
26;2021-07-19;2724;3264;301564;253985;57.9;48.8
26;2021-07-20;3706;3370;305270;257355;58.6;49.4
26;2021-07-21;3588;3087;308858;260442;59.3;50.0
26;2021-07-22;4119;2971;312977;263413;60.1;50.6
26;2021-07-23;3860;3401;316837;266814;60.9;51.3
26;2021-07-24;2344;1363;319181;268177;61.3;51.5
26;2021-07-25;608;97;319789;268274;61.4;51.5
26;2021-07-26;3429;2581;323218;270855;62.1;52.0
26;2021-07-27;4838;2621;328056;273476;63.0;52.5
26;2021-07-28;4533;2387;332589;275863;63.9;53.0
26;2021-07-29;3902;2897;336491;278760;64.6;53.6
26;2021-07-30;3484;2671;339975;281431;65.3;54.1
26;2021-07-31;1144;1008;341119;282439;65.5;54.3
26;2021-08-01;419;108;341538;282547;65.6;54.3
26;2021-08-02;2953;2362;344491;284909;66.2;54.7
26;2021-08-03;3298;2296;347789;287205;66.8;55.2
26;2021-08-04;3999;2016;351788;289221;67.6;55.6
26;2021-08-05;3154;2205;354942;291426;68.2;56.0
26;2021-08-06;3174;2639;358116;294065;68.8;56.5
26;2021-08-07;640;845;358756;294910;68.9;56.7
26;2021-08-08;29;13;358785;294923;68.9;56.7
26;2021-08-09;2191;3062;360976;297985;69.3;57.2
26;2021-08-10;2341;3049;363317;301034;69.8;57.8
26;2021-08-11;2078;2719;365395;303753;70.2;58.4
26;2021-08-12;1775;2586;367170;306339;70.5;58.8
26;2021-08-13;1742;2424;368912;308763;70.9;59.3
26;2021-08-14;272;872;369184;309635;70.9;59.5
26;2021-08-15;6;8;369190;309643;70.9;59.5
26;2021-08-16;1190;3291;370380;312934;71.2;60.1
26;2021-08-17;1523;3154;371903;316088;71.4;60.7
26;2021-08-18;1631;3376;373534;319464;71.8;61.4
26;2021-08-19;1552;3069;375086;322533;72.1;62.0
26;2021-08-20;1446;2980;376532;325513;72.3;62.5
26;2021-08-21;599;1090;377131;326603;72.4;62.7
26;2021-08-22;58;379;377189;326982;72.5;62.8
26;2021-08-23;1601;3621;378790;330603;72.8;63.5
26;2021-08-24;1748;3595;380538;334198;73.1;64.2
26;2021-08-25;1605;3660;382143;337858;73.4;64.9
26;2021-08-26;1494;3160;383637;341018;73.7;65.5
26;2021-08-27;1570;3606;385207;344624;74.0;66.2
26;2021-08-28;395;1104;385602;345728;74.1;66.4
26;2021-08-29;10;25;385612;345753;74.1;66.4
26;2021-08-30;1466;3441;387078;349194;74.4;67.1
26;2021-08-31;1286;3434;388364;352628;74.6;67.7
26;2021-09-01;1374;2815;389738;355443;74.9;68.3
26;2021-09-02;1116;2154;390854;357597;75.1;68.7
26;2021-09-03;1103;2753;391957;360350;75.3;69.2
26;2021-09-04;430;740;392387;361090;75.4;69.4
26;2021-09-05;25;24;392412;361114;75.4;69.4
26;2021-09-06;734;1777;393146;362891;75.5;69.7
26;2021-09-07;760;1695;393906;364586;75.7;70.0
26;2021-09-08;851;1926;394757;366512;75.8;70.4
26;2021-09-09;518;1607;395275;368119;75.9;70.7
26;2021-09-10;836;2058;396111;370177;76.1;71.1
26;2021-09-11;305;800;396416;370977;76.2;71.3
26;2021-09-12;0;5;396416;370982;76.2;71.3
26;2021-09-13;543;1730;396959;372712;76.3;71.6
26;2021-09-14;724;1701;397683;374413;76.4;71.9
26;2021-09-15;713;1829;398396;376242;76.5;72.3
26;2021-09-16;497;1007;398893;377249;76.6;72.5
26;2021-09-17;613;1731;399506;378980;76.7;72.8
26;2021-09-18;271;742;399777;379722;76.8;72.9
26;2021-09-19;3;13;399780;379735;76.8;72.9
26;2021-09-20;333;1095;400113;380830;76.9;73.2
26;2021-09-21;415;1013;400528;381843;76.9;73.4
26;2021-09-22;424;1518;400952;383361;77.0;73.6
26;2021-09-23;360;780;401312;384141;77.1;73.8
26;2021-09-24;441;1431;401753;385572;77.2;74.1
26;2021-09-25;180;598;401933;386170;77.2;74.2
26;2021-09-26;2;19;401935;386189;77.2;74.2
26;2021-09-27;312;811;402247;387000;77.3;74.3
26;2021-09-28;245;610;402492;387610;77.3;74.5
26;2021-09-29;385;1010;402877;388620;77.4;74.7
26;2021-09-30;226;515;403103;389135;77.4;74.8
26;2021-10-01;446;999;403549;390134;77.5;74.9
26;2021-10-02;189;340;403738;390474;77.6;75.0
26;2021-10-03;5;4;403743;390478;77.6;75.0
26;2021-10-04;320;629;404063;391107;77.6;75.1
26;2021-10-05;152;501;404215;391608;77.7;75.2
26;2021-10-06;377;795;404592;392403;77.7;75.4
27;2020-12-27;2;0;2;0;0.0;0.0
27;2020-12-28;1;0;3;0;0.0;0.0
27;2020-12-29;2;0;5;0;0.0;0.0
27;2020-12-30;0;0;5;0;0.0;0.0
27;2020-12-31;0;0;5;0;0.0;0.0
27;2021-01-01;0;0;5;0;0.0;0.0
27;2021-01-02;0;0;5;0;0.0;0.0
27;2021-01-03;2;0;7;0;0.0;0.0
27;2021-01-04;0;0;7;0;0.0;0.0
27;2021-01-05;15;0;22;0;0.0;0.0
27;2021-01-06;161;0;183;0;0.0;0.0
27;2021-01-07;371;1;554;1;0.1;0.0
27;2021-01-08;443;0;997;1;0.2;0.0
27;2021-01-09;72;1;1069;2;0.2;0.0
27;2021-01-10;100;0;1169;2;0.2;0.0
27;2021-01-11;384;0;1553;2;0.3;0.0
27;2021-01-12;409;2;1962;4;0.3;0.0
27;2021-01-13;840;1;2802;5;0.5;0.0
27;2021-01-14;1629;25;4431;30;0.7;0.0
27;2021-01-15;1222;3;5653;33;0.9;0.0
27;2021-01-16;332;1;5985;34;1.0;0.0
27;2021-01-17;205;0;6190;34;1.0;0.0
27;2021-01-18;800;2;6990;36;1.2;0.0
27;2021-01-19;772;3;7762;39;1.3;0.0
27;2021-01-20;871;1;8633;40;1.4;0.0
27;2021-01-21;654;4;9287;44;1.5;0.0
27;2021-01-22;778;4;10065;48;1.7;0.0
27;2021-01-23;350;0;10415;48;1.7;0.0
27;2021-01-24;169;2;10584;50;1.8;0.0
27;2021-01-25;635;13;11219;63;1.9;0.0
27;2021-01-26;462;16;11681;79;1.9;0.0
27;2021-01-27;506;98;12187;177;2.0;0.0
27;2021-01-28;517;235;12704;412;2.1;0.1
27;2021-01-29;509;99;13213;511;2.2;0.1
27;2021-01-30;242;23;13455;534;2.2;0.1
27;2021-01-31;27;18;13482;552;2.2;0.1
27;2021-02-01;348;178;13830;730;2.3;0.1
27;2021-02-02;308;237;14138;967;2.4;0.2
27;2021-02-03;487;350;14625;1317;2.4;0.2
27;2021-02-04;717;795;15342;2112;2.6;0.4
27;2021-02-05;664;963;16006;3075;2.7;0.5
27;2021-02-06;126;190;16132;3265;2.7;0.5
27;2021-02-07;25;35;16157;3300;2.7;0.5
27;2021-02-08;312;299;16469;3599;2.7;0.6
27;2021-02-09;341;410;16810;4009;2.8;0.7
27;2021-02-10;305;445;17115;4454;2.8;0.7
27;2021-02-11;318;365;17433;4819;2.9;0.8
27;2021-02-12;230;436;17663;5255;2.9;0.9
27;2021-02-13;151;101;17814;5356;3.0;0.9
27;2021-02-14;6;64;17820;5420;3.0;0.9
27;2021-02-15;389;442;18209;5862;3.0;1.0
27;2021-02-16;296;522;18505;6384;3.1;1.1
27;2021-02-17;247;464;18752;6848;3.1;1.1
27;2021-02-18;363;493;19115;7341;3.2;1.2
27;2021-02-19;218;531;19333;7872;3.2;1.3
27;2021-02-20;129;202;19462;8074;3.2;1.3
27;2021-02-21;12;96;19474;8170;3.2;1.4
27;2021-02-22;482;446;19956;8616;3.3;1.4
27;2021-02-23;496;515;20452;9131;3.4;1.5
27;2021-02-24;543;530;20995;9661;3.5;1.6
27;2021-02-25;847;627;21842;10288;3.6;1.7
27;2021-02-26;955;600;22797;10888;3.8;1.8
27;2021-02-27;408;131;23205;11019;3.9;1.8
27;2021-02-28;174;24;23379;11043;3.9;1.8
27;2021-03-01;488;375;23867;11418;4.0;1.9
27;2021-03-02;765;282;24632;11700;4.1;1.9
27;2021-03-03;853;283;25485;11983;4.2;2.0
27;2021-03-04;886;206;26371;12189;4.4;2.0
27;2021-03-05;1304;203;27675;12392;4.6;2.1
27;2021-03-06;1637;100;29312;12492;4.9;2.1
27;2021-03-07;619;17;29931;12509;5.0;2.1
27;2021-03-08;1204;265;31135;12774;5.2;2.1
27;2021-03-09;1828;230;32963;13004;5.5;2.2
27;2021-03-10;2116;326;35079;13330;5.8;2.2
27;2021-03-11;2162;200;37241;13530;6.2;2.3
27;2021-03-12;2817;192;40058;13722;6.7;2.3
27;2021-03-13;1919;120;41977;13842;7.0;2.3
27;2021-03-14;655;16;42632;13858;7.1;2.3
27;2021-03-15;1558;212;44190;14070;7.4;2.3
27;2021-03-16;1489;236;45679;14306;7.6;2.4
27;2021-03-17;1856;361;47535;14667;7.9;2.4
27;2021-03-18;1687;344;49222;15011;8.2;2.5
27;2021-03-19;1834;161;51056;15172;8.5;2.5
27;2021-03-20;905;41;51961;15213;8.7;2.5
27;2021-03-21;258;3;52219;15216;8.7;2.5
27;2021-03-22;1235;534;53454;15750;8.9;2.6
27;2021-03-23;1627;439;55081;16189;9.2;2.7
27;2021-03-24;1523;469;56604;16658;9.4;2.8
27;2021-03-25;2165;508;58769;17166;9.8;2.9
27;2021-03-26;2531;433;61300;17599;10.2;2.9
27;2021-03-27;1568;200;62868;17799;10.5;3.0
27;2021-03-28;1149;50;64017;17849;10.7;3.0
27;2021-03-29;1375;820;65392;18669;10.9;3.1
27;2021-03-30;1391;835;66783;19504;11.1;3.2
27;2021-03-31;1485;866;68268;20370;11.4;3.4
27;2021-04-01;1956;808;70224;21178;11.7;3.5
27;2021-04-02;1999;1170;72223;22348;12.0;3.7
27;2021-04-03;1563;732;73786;23080;12.3;3.8
27;2021-04-04;979;176;74765;23256;12.4;3.9
27;2021-04-05;283;6;75048;23262;12.5;3.9
27;2021-04-06;1413;1791;76461;25053;12.7;4.2
27;2021-04-07;1322;1742;77783;26795;12.9;4.5
27;2021-04-08;1684;1677;79467;28472;13.2;4.7
27;2021-04-09;2945;1558;82412;30030;13.7;5.0
27;2021-04-10;2033;985;84445;31015;14.1;5.2
27;2021-04-11;946;211;85391;31226;14.2;5.2
27;2021-04-12;2434;1507;87825;32733;14.6;5.4
27;2021-04-13;2394;1547;90219;34280;15.0;5.7
27;2021-04-14;2085;1623;92304;35903;15.4;6.0
27;2021-04-15;1874;1658;94178;37561;15.7;6.3
27;2021-04-16;2751;1109;96929;38670;16.1;6.4
27;2021-04-17;2168;496;99097;39166;16.5;6.5
27;2021-04-18;452;16;99549;39182;16.6;6.5
27;2021-04-19;1712;1174;101261;40356;16.9;6.7
27;2021-04-20;2387;1300;103648;41656;17.3;6.9
27;2021-04-21;2210;1081;105858;42737;17.6;7.1
27;2021-04-22;2180;1420;108038;44157;18.0;7.4
27;2021-04-23;2446;1174;110484;45331;18.4;7.5
27;2021-04-24;3260;1147;113744;46478;18.9;7.7
27;2021-04-25;1130;1051;114874;47529;19.1;7.9
27;2021-04-26;1925;1147;116799;48676;19.4;8.1
27;2021-04-27;2528;1082;119327;49758;19.9;8.3
27;2021-04-28;2395;1310;121722;51068;20.3;8.5
27;2021-04-29;2491;1472;124213;52540;20.7;8.7
27;2021-04-30;2371;1604;126584;54144;21.1;9.0
27;2021-05-01;2638;890;129222;55034;21.5;9.2
27;2021-05-02;1952;897;131174;55931;21.8;9.3
27;2021-05-03;3064;872;134238;56803;22.3;9.5
27;2021-05-04;2782;1650;137020;58453;22.8;9.7
27;2021-05-05;2816;1649;139836;60102;23.3;10.0
27;2021-05-06;3184;1280;143020;61382;23.8;10.2
27;2021-05-07;3322;1979;146342;63361;24.4;10.5
27;2021-05-08;2805;1329;149147;64690;24.8;10.8
27;2021-05-09;1696;297;150843;64987;25.1;10.8
27;2021-05-10;2950;2269;153793;67256;25.6;11.2
27;2021-05-11;3358;1752;157151;69008;26.2;11.5
27;2021-05-12;3463;1726;160614;70734;26.7;11.8
27;2021-05-13;1892;254;162506;70988;27.1;11.8
27;2021-05-14;3884;1784;166390;72772;27.7;12.1
27;2021-05-15;6601;951;172991;73723;28.8;12.3
27;2021-05-16;3668;438;176659;74161;29.4;12.3
27;2021-05-17;2774;1161;179433;75322;29.9;12.5
27;2021-05-18;3845;1296;183278;76618;30.5;12.8
27;2021-05-19;3967;1154;187245;77772;31.2;12.9
27;2021-05-20;3874;1171;191119;78943;31.8;13.1
27;2021-05-21;3968;1790;195087;80733;32.5;13.4
27;2021-05-22;4367;802;199454;81535;33.2;13.6
27;2021-05-23;799;173;200253;81708;33.3;13.6
27;2021-05-24;1489;342;201742;82050;33.6;13.7
27;2021-05-25;3511;1606;205253;83656;34.2;13.9
27;2021-05-26;3855;1740;209108;85396;34.8;14.2
27;2021-05-27;3789;1478;212897;86874;35.4;14.5
27;2021-05-28;3403;2621;216300;89495;36.0;14.9
27;2021-05-29;4822;2294;221122;91789;36.8;15.3
27;2021-05-30;1117;247;222239;92036;37.0;15.3
27;2021-05-31;3465;2272;225704;94308;37.6;15.7
27;2021-06-01;3813;2240;229517;96548;38.2;16.1
27;2021-06-02;3341;2173;232858;98721;38.8;16.4
27;2021-06-03;4430;2116;237288;100837;39.5;16.8
27;2021-06-04;3603;2963;240891;103800;40.1;17.3
27;2021-06-05;3207;3347;244098;107147;40.6;17.8
27;2021-06-06;2004;1005;246102;108152;41.0;18.0
27;2021-06-07;2570;2353;248672;110505;41.4;18.4
27;2021-06-08;3126;2371;251798;112876;41.9;18.8
27;2021-06-09;2305;2470;254103;115346;42.3;19.2
27;2021-06-10;2431;2038;256534;117384;42.7;19.5
27;2021-06-11;2889;3766;259423;121150;43.2;20.2
27;2021-06-12;1982;4191;261405;125341;43.5;20.9
27;2021-06-13;1084;2687;262489;128028;43.7;21.3
27;2021-06-14;1995;3110;264484;131138;44.0;21.8
27;2021-06-15;2688;3018;267172;134156;44.5;22.3
27;2021-06-16;2501;3254;269673;137410;44.9;22.9
27;2021-06-17;2297;3291;271970;140701;45.3;23.4
27;2021-06-18;2746;4418;274716;145119;45.7;24.2
27;2021-06-19;1863;3392;276579;148511;46.0;24.7
27;2021-06-20;607;710;277186;149221;46.1;24.8
27;2021-06-21;1703;3495;278889;152716;46.4;25.4
27;2021-06-22;2385;3710;281274;156426;46.8;26.0
27;2021-06-23;2073;3568;283347;159994;47.2;26.6
27;2021-06-24;2256;3412;285603;163406;47.5;27.2
27;2021-06-25;1936;4459;287539;167865;47.9;27.9
27;2021-06-26;884;5352;288423;173217;48.0;28.8
27;2021-06-27;377;1427;288800;174644;48.1;29.1
27;2021-06-28;1129;3403;289929;178047;48.3;29.6
27;2021-06-29;1703;4363;291632;182410;48.5;30.4
27;2021-06-30;2115;4096;293747;186506;48.9;31.0
27;2021-07-01;2224;3908;295971;190414;49.3;31.7
27;2021-07-02;1589;4620;297560;195034;49.5;32.5
27;2021-07-03;1309;4773;298869;199807;49.8;33.3
27;2021-07-04;504;1403;299373;201210;49.8;33.5
27;2021-07-05;1417;3528;300790;204738;50.1;34.1
27;2021-07-06;1366;4180;302156;208918;50.3;34.8
27;2021-07-07;1756;4901;303912;213819;50.6;35.6
27;2021-07-08;2089;4351;306001;218170;50.9;36.3
27;2021-07-09;1984;5287;307985;223457;51.3;37.2
27;2021-07-10;1167;4179;309152;227636;51.5;37.9
27;2021-07-11;426;1139;309578;228775;51.5;38.1
27;2021-07-12;1253;4372;310831;233147;51.7;38.8
27;2021-07-13;2759;5345;313590;238492;52.2;39.7
27;2021-07-14;1518;1753;315108;240245;52.5;40.0
27;2021-07-15;3033;5464;318141;245709;53.0;40.9
27;2021-07-16;3820;5286;321961;250995;53.6;41.8
27;2021-07-17;2732;3878;324693;254873;54.1;42.4
27;2021-07-18;552;1266;325245;256139;54.1;42.6
27;2021-07-19;3687;3787;328932;259926;54.8;43.3
27;2021-07-20;3459;3591;332391;263517;55.3;43.9
27;2021-07-21;4251;3900;336642;267417;56.0;44.5
27;2021-07-22;4750;3714;341392;271131;56.8;45.1
27;2021-07-23;3592;3398;344984;274529;57.4;45.7
27;2021-07-24;3114;2325;348098;276854;57.9;46.1
27;2021-07-25;493;545;348591;277399;58.0;46.2
27;2021-07-26;3071;3175;351662;280574;58.5;46.7
27;2021-07-27;3596;3101;355258;283675;59.1;47.2
27;2021-07-28;3592;3241;358850;286916;59.7;47.8
27;2021-07-29;4590;3510;363440;290426;60.5;48.3
27;2021-07-30;3816;3143;367256;293569;61.1;48.9
27;2021-07-31;3062;2585;370318;296154;61.6;49.3
27;2021-08-01;539;498;370857;296652;61.7;49.4
27;2021-08-02;3319;2584;374176;299236;62.3;49.8
27;2021-08-03;3427;2770;377603;302006;62.9;50.3
27;2021-08-04;3059;2334;380662;304340;63.4;50.7
27;2021-08-05;2676;2358;383338;306698;63.8;51.1
27;2021-08-06;3270;3244;386608;309942;64.4;51.6
27;2021-08-07;1801;2553;388409;312495;64.7;52.0
27;2021-08-08;218;197;388627;312692;64.7;52.1
27;2021-08-09;2210;2807;390837;315499;65.1;52.5
27;2021-08-10;2811;3512;393648;319011;65.5;53.1
27;2021-08-11;2637;3099;396285;322110;66.0;53.6
27;2021-08-12;2363;3905;398648;326015;66.4;54.3
27;2021-08-13;1745;2572;400393;328587;66.7;54.7
27;2021-08-14;1163;2889;401556;331476;66.8;55.2
27;2021-08-15;18;23;401574;331499;66.9;55.2
27;2021-08-16;1811;3816;403385;335315;67.2;55.8
27;2021-08-17;2046;3442;405431;338757;67.5;56.4
27;2021-08-18;1457;2986;406888;341743;67.7;56.9
27;2021-08-19;1711;3356;408599;345099;68.0;57.5
27;2021-08-20;1636;3440;410235;348539;68.3;58.0
27;2021-08-21;987;2842;411222;351381;68.5;58.5
27;2021-08-22;184;162;411406;351543;68.5;58.5
27;2021-08-23;1080;4008;412486;355551;68.7;59.2
27;2021-08-24;1440;3969;413926;359520;68.9;59.9
27;2021-08-25;1717;3414;415643;362934;69.2;60.4
27;2021-08-26;1157;2932;416800;365866;69.4;60.9
27;2021-08-27;1266;3222;418066;369088;69.6;61.4
27;2021-08-28;912;2870;418978;371958;69.7;61.9
27;2021-08-29;87;135;419065;372093;69.8;61.9
27;2021-08-30;906;3315;419971;375408;69.9;62.5
27;2021-08-31;1225;3206;421196;378614;70.1;63.0
27;2021-09-01;997;3178;422193;381792;70.3;63.6
27;2021-09-02;872;2490;423065;384282;70.4;64.0
27;2021-09-03;847;2468;423912;386750;70.6;64.4
27;2021-09-04;729;2086;424641;388836;70.7;64.7
27;2021-09-05;36;162;424677;388998;70.7;64.8
27;2021-09-06;538;1805;425215;390803;70.8;65.1
27;2021-09-07;697;2368;425912;393171;70.9;65.5
27;2021-09-08;770;2404;426682;395575;71.0;65.9
27;2021-09-09;682;1933;427364;397508;71.1;66.2
27;2021-09-10;899;2372;428263;399880;71.3;66.6
27;2021-09-11;608;1945;428871;401825;71.4;66.9
27;2021-09-12;42;184;428913;402009;71.4;66.9
27;2021-09-13;351;1336;429264;403345;71.5;67.1
27;2021-09-14;593;1479;429857;404824;71.6;67.4
27;2021-09-15;556;1669;430413;406493;71.7;67.7
27;2021-09-16;595;1132;431008;407625;71.8;67.9
27;2021-09-17;790;1289;431798;408914;71.9;68.1
27;2021-09-18;365;1248;432163;410162;71.9;68.3
27;2021-09-19;56;161;432219;410323;72.0;68.3
27;2021-09-20;260;773;432479;411096;72.0;68.4
27;2021-09-21;428;963;432907;412059;72.1;68.6
27;2021-09-22;299;1030;433206;413089;72.1;68.8
27;2021-09-23;344;757;433550;413846;72.2;68.9
27;2021-09-24;577;1244;434127;415090;72.3;69.1
27;2021-09-25;291;1122;434418;416212;72.3;69.3
27;2021-09-26;4;12;434422;416224;72.3;69.3
27;2021-09-27;190;474;434612;416698;72.4;69.4
27;2021-09-28;313;725;434925;417423;72.4;69.5
27;2021-09-29;242;726;435167;418149;72.4;69.6
27;2021-09-30;162;521;435329;418670;72.5;69.7
27;2021-10-01;343;999;435672;419669;72.5;69.9
27;2021-10-02;359;797;436031;420466;72.6;70.0
27;2021-10-03;13;12;436044;420478;72.6;70.0
27;2021-10-04;177;374;436221;420852;72.6;70.1
27;2021-10-05;260;464;436481;421316;72.7;70.1
27;2021-10-06;274;692;436755;422008;72.7;70.3
28;2020-12-27;0;0;0;0;0.0;0.0
28;2020-12-28;0;0;0;0;0.0;0.0
28;2020-12-29;0;0;0;0;0.0;0.0
28;2020-12-30;0;0;0;0;0.0;0.0
28;2020-12-31;0;0;0;0;0.0;0.0
28;2021-01-01;1;0;1;0;0.0;0.0
28;2021-01-02;0;0;1;0;0.0;0.0
28;2021-01-03;0;0;1;0;0.0;0.0
28;2021-01-04;0;0;1;0;0.0;0.0
28;2021-01-05;5;0;6;0;0.0;0.0
28;2021-01-06;84;0;90;0;0.0;0.0
28;2021-01-07;102;0;192;0;0.0;0.0
28;2021-01-08;134;2;326;2;0.1;0.0
28;2021-01-09;79;0;405;2;0.1;0.0
28;2021-01-10;1;0;406;2;0.1;0.0
28;2021-01-11;204;0;610;2;0.1;0.0
28;2021-01-12;265;1;875;3;0.2;0.0
28;2021-01-13;398;3;1273;6;0.3;0.0
28;2021-01-14;451;5;1724;11;0.4;0.0
28;2021-01-15;374;3;2098;14;0.5;0.0
28;2021-01-16;206;2;2304;16;0.5;0.0
28;2021-01-17;21;0;2325;16;0.5;0.0
28;2021-01-18;373;2;2698;18;0.6;0.0
28;2021-01-19;503;4;3201;22;0.7;0.0
28;2021-01-20;636;1;3837;23;0.9;0.0
28;2021-01-21;796;3;4633;26;1.1;0.0
28;2021-01-22;478;1;5111;27;1.2;0.0
28;2021-01-23;353;0;5464;27;1.3;0.0
28;2021-01-24;1;0;5465;27;1.3;0.0
28;2021-01-25;456;4;5921;31;1.4;0.0
28;2021-01-26;717;4;6638;35;1.5;0.0
28;2021-01-27;1211;50;7849;85;1.8;0.0
28;2021-01-28;1587;89;9436;174;2.2;0.0
28;2021-01-29;896;87;10332;261;2.4;0.1
28;2021-01-30;249;46;10581;307;2.5;0.1
28;2021-01-31;2;22;10583;329;2.5;0.1
28;2021-02-01;325;115;10908;444;2.5;0.1
28;2021-02-02;368;197;11276;641;2.6;0.1
28;2021-02-03;473;247;11749;888;2.7;0.2
28;2021-02-04;525;263;12274;1151;2.9;0.3
28;2021-02-05;436;210;12710;1361;3.0;0.3
28;2021-02-06;201;128;12911;1489;3.0;0.3
28;2021-02-07;0;0;12911;1489;3.0;0.3
28;2021-02-08;331;207;13242;1696;3.1;0.4
28;2021-02-09;281;262;13523;1958;3.1;0.5
28;2021-02-10;443;324;13966;2282;3.3;0.5
28;2021-02-11;562;412;14528;2694;3.4;0.6
28;2021-02-12;453;332;14981;3026;3.5;0.7
28;2021-02-13;181;157;15162;3183;3.5;0.7
28;2021-02-14;0;2;15162;3185;3.5;0.7
28;2021-02-15;280;341;15442;3526;3.6;0.8
28;2021-02-16;396;594;15838;4120;3.7;1.0
28;2021-02-17;584;1036;16422;5156;3.8;1.2
28;2021-02-18;665;1295;17087;6451;4.0;1.5
28;2021-02-19;548;661;17635;7112;4.1;1.7
28;2021-02-20;114;116;17749;7228;4.1;1.7
28;2021-02-21;7;32;17756;7260;4.1;1.7
28;2021-02-22;223;424;17979;7684;4.2;1.8
28;2021-02-23;203;311;18182;7995;4.2;1.9
28;2021-02-24;244;377;18426;8372;4.3;1.9
28;2021-02-25;574;345;19000;8717;4.4;2.0
28;2021-02-26;764;306;19764;9023;4.6;2.1
28;2021-02-27;265;74;20029;9097;4.7;2.1
28;2021-02-28;23;17;20052;9114;4.7;2.1
28;2021-03-01;292;180;20344;9294;4.7;2.2
28;2021-03-02;396;246;20740;9540;4.8;2.2
28;2021-03-03;369;339;21109;9879;4.9;2.3
28;2021-03-04;720;424;21829;10303;5.1;2.4
28;2021-03-05;1319;368;23148;10671;5.4;2.5
28;2021-03-06;1998;81;25146;10752;5.9;2.5
28;2021-03-07;974;31;26120;10783;6.1;2.5
28;2021-03-08;398;262;26518;11045;6.2;2.6
28;2021-03-09;981;329;27499;11374;6.4;2.6
28;2021-03-10;1358;486;28857;11860;6.7;2.8
28;2021-03-11;1535;663;30392;12523;7.1;2.9
28;2021-03-12;2255;607;32647;13130;7.6;3.1
28;2021-03-13;1235;114;33882;13244;7.9;3.1
28;2021-03-14;519;17;34401;13261;8.0;3.1
28;2021-03-15;755;225;35156;13486;8.2;3.1
28;2021-03-16;716;217;35872;13703;8.4;3.2
28;2021-03-17;746;283;36618;13986;8.5;3.3
28;2021-03-18;1203;265;37821;14251;8.8;3.3
28;2021-03-19;1558;321;39379;14572;9.2;3.4
28;2021-03-20;639;21;40018;14593;9.3;3.4
28;2021-03-21;29;8;40047;14601;9.3;3.4
28;2021-03-22;766;317;40813;14918;9.5;3.5
28;2021-03-23;1027;189;41840;15107;9.7;3.5
28;2021-03-24;1315;274;43155;15381;10.0;3.6
28;2021-03-25;1796;286;44951;15667;10.5;3.6
28;2021-03-26;2084;346;47035;16013;11.0;3.7
28;2021-03-27;402;38;47437;16051;11.0;3.7
28;2021-03-28;12;0;47449;16051;11.0;3.7
28;2021-03-29;1139;349;48588;16400;11.3;3.8
28;2021-03-30;1711;252;50299;16652;11.7;3.9
28;2021-03-31;2017;474;52316;17126;12.2;4.0
28;2021-04-01;1796;586;54112;17712;12.6;4.1
28;2021-04-02;1583;1315;55695;19027;13.0;4.4
28;2021-04-03;607;1070;56302;20097;13.1;4.7
28;2021-04-04;33;299;56335;20396;13.1;4.7
28;2021-04-05;40;3;56375;20399;13.1;4.8
28;2021-04-06;1222;459;57597;20858;13.4;4.9
28;2021-04-07;1890;1005;59487;21863;13.9;5.1
28;2021-04-08;2086;1070;61573;22933;14.3;5.3
28;2021-04-09;3230;916;64803;23849;15.1;5.6
28;2021-04-10;1581;201;66384;24050;15.5;5.6
28;2021-04-11;141;450;66525;24500;15.5;5.7
28;2021-04-12;1672;558;68197;25058;15.9;5.8
28;2021-04-13;1875;673;70072;25731;16.3;6.0
28;2021-04-14;2771;903;72843;26634;17.0;6.2
28;2021-04-15;2557;1147;75400;27781;17.6;6.5
28;2021-04-16;2554;806;77954;28587;18.2;6.7
28;2021-04-17;2309;133;80263;28720;18.7;6.7
28;2021-04-18;45;8;80308;28728;18.7;6.7
28;2021-04-19;1576;648;81884;29376;19.1;6.8
28;2021-04-20;1836;596;83720;29972;19.5;7.0
28;2021-04-21;2680;962;86400;30934;20.1;7.2
28;2021-04-22;1783;1218;88183;32152;20.5;7.5
28;2021-04-23;2325;1104;90508;33256;21.1;7.7
28;2021-04-24;3656;137;94164;33393;21.9;7.8
28;2021-04-25;1012;37;95176;33430;22.2;7.8
28;2021-04-26;1331;929;96507;34359;22.5;8.0
28;2021-04-27;1436;1268;97943;35627;22.8;8.3
28;2021-04-28;2373;1828;100316;37455;23.4;8.7
28;2021-04-29;2130;1511;102446;38966;23.9;9.1
28;2021-04-30;2973;1225;105419;40191;24.5;9.4
28;2021-05-01;127;115;105546;40306;24.6;9.4
28;2021-05-02;2;65;105548;40371;24.6;9.4
28;2021-05-03;1048;1015;106596;41386;24.8;9.6
28;2021-05-04;1359;1671;107955;43057;25.1;10.0
28;2021-05-05;2830;1649;110785;44706;25.8;10.4
28;2021-05-06;2456;1473;113241;46179;26.4;10.8
28;2021-05-07;2311;1923;115552;48102;26.9;11.2
28;2021-05-08;1078;112;116630;48214;27.2;11.2
28;2021-05-09;105;610;116735;48824;27.2;11.4
28;2021-05-10;1308;1891;118043;50715;27.5;11.8
28;2021-05-11;2024;2328;120067;53043;28.0;12.4
28;2021-05-12;2620;3233;122687;56276;28.6;13.1
28;2021-05-13;289;451;122976;56727;28.6;13.2
28;2021-05-14;1900;1612;124876;58339;29.1;13.6
28;2021-05-15;1433;1673;126309;60012;29.4;14.0
28;2021-05-16;1986;131;128295;60143;29.9;14.0
28;2021-05-17;2874;1485;131169;61628;30.5;14.4
28;2021-05-18;3382;1379;134551;63007;31.3;14.7
28;2021-05-19;5090;1279;139641;64286;32.5;15.0
28;2021-05-20;4149;1231;143790;65517;33.5;15.3
28;2021-05-21;3464;1579;147254;67096;34.3;15.6
28;2021-05-22;729;1161;147983;68257;34.5;15.9
28;2021-05-23;1956;137;149939;68394;34.9;15.9
28;2021-05-24;1428;395;151367;68789;35.2;16.0
28;2021-05-25;1876;1403;153243;70192;35.7;16.3
28;2021-05-26;2765;1341;156008;71533;36.3;16.7
28;2021-05-27;2754;1233;158762;72766;37.0;16.9
28;2021-05-28;3080;1726;161842;74492;37.7;17.3
28;2021-05-29;1868;872;163710;75364;38.1;17.5
28;2021-05-30;16;47;163726;75411;38.1;17.6
28;2021-05-31;2014;934;165740;76345;38.6;17.8
28;2021-06-01;2133;1653;167873;77998;39.1;18.2
28;2021-06-02;2077;2457;169950;80455;39.6;18.7
28;2021-06-03;2498;1560;172448;82015;40.2;19.1
28;2021-06-04;2608;2353;175056;84368;40.8;19.6
28;2021-06-05;1909;2519;176965;86887;41.2;20.2
28;2021-06-06;1060;1046;178025;87933;41.5;20.5
28;2021-06-07;3575;1574;181600;89507;42.3;20.8
28;2021-06-08;3196;1519;184796;91026;43.0;21.2
28;2021-06-09;3675;2123;188471;93149;43.9;21.7
28;2021-06-10;3140;1257;191611;94406;44.6;22.0
28;2021-06-11;3790;2130;195401;96536;45.5;22.5
28;2021-06-12;1304;560;196705;97096;45.8;22.6
28;2021-06-13;385;108;197090;97204;45.9;22.6
28;2021-06-14;2207;1992;199297;99196;46.4;23.1
28;2021-06-15;2092;2224;201389;101420;46.9;23.6
28;2021-06-16;2508;3972;203897;105392;47.5;24.5
28;2021-06-17;1940;3135;205837;108527;47.9;25.3
28;2021-06-18;2487;3788;208324;112315;48.5;26.2
28;2021-06-19;776;1612;209100;113927;48.7;26.5
28;2021-06-20;23;24;209123;113951;48.7;26.5
28;2021-06-21;1682;1989;210805;115940;49.1;27.0
28;2021-06-22;1372;2107;212177;118047;49.4;27.5
28;2021-06-23;1782;3164;213959;121211;49.8;28.2
28;2021-06-24;734;929;214693;122140;50.0;28.4
28;2021-06-25;1888;3025;216581;125165;50.4;29.1
28;2021-06-26;310;2110;216891;127275;50.5;29.6
28;2021-06-27;588;1284;217479;128559;50.6;29.9
28;2021-06-28;1225;3654;218704;132213;50.9;30.8
28;2021-06-29;1342;3790;220046;136003;51.2;31.7
28;2021-06-30;1493;4261;221539;140264;51.6;32.7
28;2021-07-01;1277;3500;222816;143764;51.9;33.5
28;2021-07-02;1313;4651;224129;148415;52.2;34.6
28;2021-07-03;1131;2371;225260;150786;52.5;35.1
28;2021-07-04;145;1325;225405;152111;52.5;35.4
28;2021-07-05;1360;2511;226765;154622;52.8;36.0
28;2021-07-06;1508;2868;228273;157490;53.2;36.7
28;2021-07-07;1636;4140;229909;161630;53.5;37.6
28;2021-07-08;1467;3240;231376;164870;53.9;38.4
28;2021-07-09;1393;4516;232769;169386;54.2;39.4
28;2021-07-10;528;2205;233297;171591;54.3;40.0
28;2021-07-11;2;1;233299;171592;54.3;40.0
28;2021-07-12;1526;3928;234825;175520;54.7;40.9
28;2021-07-13;2261;4143;237086;179663;55.2;41.8
28;2021-07-14;1328;1395;238414;181058;55.5;42.2
28;2021-07-15;2985;3974;241399;185032;56.2;43.1
28;2021-07-16;2444;4751;243843;189783;56.8;44.2
28;2021-07-17;1263;2430;245106;192213;57.1;44.8
28;2021-07-18;368;945;245474;193158;57.2;45.0
28;2021-07-19;1806;4331;247280;197489;57.6;46.0
28;2021-07-20;2476;4090;249756;201579;58.2;46.9
28;2021-07-21;2959;4285;252715;205864;58.8;47.9
28;2021-07-22;3670;3430;256385;209294;59.7;48.7
28;2021-07-23;2960;3996;259345;213290;60.4;49.7
28;2021-07-24;1715;1484;261060;214774;60.8;50.0
28;2021-07-25;67;60;261127;214834;60.8;50.0
28;2021-07-26;2930;3386;264057;218220;61.5;50.8
28;2021-07-27;3885;2621;267942;220841;62.4;51.4
28;2021-07-28;3947;2745;271889;223586;63.3;52.1
28;2021-07-29;4466;2091;276355;225677;64.4;52.6
28;2021-07-30;3825;2845;280180;228522;65.2;53.2
28;2021-07-31;763;822;280943;229344;65.4;53.4
28;2021-08-01;378;65;281321;229409;65.5;53.4
28;2021-08-02;1793;1520;283114;230929;65.9;53.8
28;2021-08-03;2684;2167;285798;233096;66.6;54.3
28;2021-08-04;1932;2300;287730;235396;67.0;54.8
28;2021-08-05;1663;1730;289393;237126;67.4;55.2
28;2021-08-06;1618;1969;291011;239095;67.8;55.7
28;2021-08-07;798;1001;291809;240096;68.0;55.9
28;2021-08-08;22;33;291831;240129;68.0;55.9
28;2021-08-09;1388;1102;293219;241231;68.3;56.2
28;2021-08-10;1714;2027;294933;243258;68.7;56.6
28;2021-08-11;1273;1572;296206;244830;69.0;57.0
28;2021-08-12;1165;1881;297371;246711;69.2;57.5
28;2021-08-13;1321;1649;298692;248360;69.6;57.8
28;2021-08-14;659;844;299351;249204;69.7;58.0
28;2021-08-15;264;59;299615;249263;69.8;58.0
28;2021-08-16;862;2145;300477;251408;70.0;58.5
28;2021-08-17;1126;2798;301603;254206;70.2;59.2
28;2021-08-18;891;2412;302494;256618;70.4;59.8
28;2021-08-19;889;2616;303383;259234;70.6;60.4
28;2021-08-20;939;2753;304322;261987;70.9;61.0
28;2021-08-21;381;1001;304703;262988;71.0;61.2
28;2021-08-22;9;31;304712;263019;71.0;61.2
28;2021-08-23;1041;2148;305753;265167;71.2;61.7
28;2021-08-24;867;2582;306620;267749;71.4;62.4
28;2021-08-25;1075;2208;307695;269957;71.7;62.9
28;2021-08-26;701;1817;308396;271774;71.8;63.3
28;2021-08-27;749;2368;309145;274142;72.0;63.8
28;2021-08-28;524;1097;309669;275239;72.1;64.1
28;2021-08-29;7;23;309676;275262;72.1;64.1
28;2021-08-30;994;2184;310670;277446;72.3;64.6
28;2021-08-31;798;2248;311468;279694;72.5;65.1
28;2021-09-01;748;2604;312216;282298;72.7;65.7
28;2021-09-02;542;2112;312758;284410;72.8;66.2
28;2021-09-03;664;2564;313422;286974;73.0;66.8
28;2021-09-04;585;2603;314007;289577;73.1;67.4
28;2021-09-05;210;247;314217;289824;73.2;67.5
28;2021-09-06;405;1619;314622;291443;73.3;67.9
28;2021-09-07;352;1452;314974;292895;73.3;68.2
28;2021-09-08;544;1588;315518;294483;73.5;68.6
28;2021-09-09;319;1143;315837;295626;73.5;68.8
28;2021-09-10;589;1660;316426;297286;73.7;69.2
28;2021-09-11;298;1330;316724;298616;73.8;69.5
28;2021-09-12;39;32;316763;298648;73.8;69.5
28;2021-09-13;312;1033;317075;299681;73.8;69.8
28;2021-09-14;322;1272;317397;300953;73.9;70.1
28;2021-09-15;526;1026;317923;301979;74.0;70.3
28;2021-09-16;251;687;318174;302666;74.1;70.5
28;2021-09-17;301;1046;318475;303712;74.2;70.7
28;2021-09-18;124;237;318599;303949;74.2;70.8
28;2021-09-19;7;17;318606;303966;74.2;70.8
28;2021-09-20;154;458;318760;304424;74.2;70.9
28;2021-09-21;393;935;319153;305359;74.3;71.1
28;2021-09-22;328;1067;319481;306426;74.4;71.4
28;2021-09-23;190;507;319671;306933;74.4;71.5
28;2021-09-24;255;968;319926;307901;74.5;71.7
28;2021-09-25;98;326;320024;308227;74.5;71.8
28;2021-09-26;21;34;320045;308261;74.5;71.8
28;2021-09-27;167;665;320212;308926;74.6;71.9
28;2021-09-28;172;440;320384;309366;74.6;72.0
28;2021-09-29;352;687;320736;310053;74.7;72.2
28;2021-09-30;233;451;320969;310504;74.7;72.3
28;2021-10-01;247;725;321216;311229;74.8;72.5
28;2021-10-02;76;151;321292;311380;74.8;72.5
28;2021-10-03;0;6;321292;311386;74.8;72.5
28;2021-10-04;132;254;321424;311640;74.8;72.6
28;2021-10-05;159;368;321583;312008;74.9;72.7
28;2021-10-06;187;608;321770;312616;74.9;72.8
29;2020-12-27;0;0;0;0;0.0;0.0
29;2020-12-28;1;0;1;0;0.0;0.0
29;2020-12-29;0;0;1;0;0.0;0.0
29;2020-12-30;0;0;1;0;0.0;0.0
29;2020-12-31;0;0;1;0;0.0;0.0
29;2021-01-01;3;0;4;0;0.0;0.0
29;2021-01-02;2;0;6;0;0.0;0.0
29;2021-01-03;1;0;7;0;0.0;0.0
29;2021-01-04;33;0;40;0;0.0;0.0
29;2021-01-05;32;0;72;0;0.0;0.0
29;2021-01-06;43;0;115;0;0.0;0.0
29;2021-01-07;139;0;254;0;0.0;0.0
29;2021-01-08;408;0;662;0;0.1;0.0
29;2021-01-09;2;0;664;0;0.1;0.0
29;2021-01-10;2;0;666;0;0.1;0.0
29;2021-01-11;668;0;1334;0;0.1;0.0
29;2021-01-12;1121;0;2455;0;0.3;0.0
29;2021-01-13;1101;1;3556;1;0.4;0.0
29;2021-01-14;895;4;4451;5;0.5;0.0
29;2021-01-15;1221;6;5672;11;0.6;0.0
29;2021-01-16;168;1;5840;12;0.6;0.0
29;2021-01-17;111;1;5951;13;0.7;0.0
29;2021-01-18;842;3;6793;16;0.7;0.0
29;2021-01-19;1314;1;8107;17;0.9;0.0
29;2021-01-20;2394;2;10501;19;1.2;0.0
29;2021-01-21;5660;8;16161;27;1.8;0.0
29;2021-01-22;3806;4;19967;31;2.2;0.0
29;2021-01-23;539;0;20506;31;2.3;0.0
29;2021-01-24;200;1;20706;32;2.3;0.0
29;2021-01-25;574;7;21280;39;2.3;0.0
29;2021-01-26;951;34;22231;73;2.5;0.0
29;2021-01-27;1286;51;23517;124;2.6;0.0
29;2021-01-28;803;134;24320;258;2.7;0.0
29;2021-01-29;781;195;25101;453;2.8;0.0
29;2021-01-30;282;4;25383;457;2.8;0.1
29;2021-01-31;80;5;25463;462;2.8;0.1
29;2021-02-01;429;370;25892;832;2.9;0.1
29;2021-02-02;879;661;26771;1493;3.0;0.2
29;2021-02-03;810;807;27581;2300;3.0;0.3
29;2021-02-04;870;603;28451;2903;3.1;0.3
29;2021-02-05;676;569;29127;3472;3.2;0.4
29;2021-02-06;249;86;29376;3558;3.2;0.4
29;2021-02-07;78;91;29454;3649;3.2;0.4
29;2021-02-08;384;420;29838;4069;3.3;0.4
29;2021-02-09;864;813;30702;4882;3.4;0.5
29;2021-02-10;1150;945;31852;5827;3.5;0.6
29;2021-02-11;1802;3851;33654;9678;3.7;1.1
29;2021-02-12;2326;2428;35980;12106;4.0;1.3
29;2021-02-13;639;388;36619;12494;4.0;1.4
29;2021-02-14;12;201;36631;12695;4.0;1.4
29;2021-02-15;267;763;36898;13458;4.1;1.5
29;2021-02-16;887;868;37785;14326;4.2;1.6
29;2021-02-17;800;648;38585;14974;4.3;1.7
29;2021-02-18;1530;696;40115;15670;4.4;1.7
29;2021-02-19;1417;798;41532;16468;4.6;1.8
29;2021-02-20;204;268;41736;16736;4.6;1.8
29;2021-02-21;163;139;41899;16875;4.6;1.9
29;2021-02-22;773;441;42672;17316;4.7;1.9
29;2021-02-23;1270;704;43942;18020;4.8;2.0
29;2021-02-24;1473;629;45415;18649;5.0;2.1
29;2021-02-25;2511;695;47926;19344;5.3;2.1
29;2021-02-26;2678;557;50604;19901;5.6;2.2
29;2021-02-27;1285;209;51889;20110;5.7;2.2
29;2021-02-28;200;56;52089;20166;5.7;2.2
29;2021-03-01;946;375;53035;20541;5.9;2.3
29;2021-03-02;1816;651;54851;21192;6.1;2.3
29;2021-03-03;2094;857;56945;22049;6.3;2.4
29;2021-03-04;2843;1400;59788;23449;6.6;2.6
29;2021-03-05;3539;1537;63327;24986;7.0;2.8
29;2021-03-06;2000;397;65327;25383;7.2;2.8
29;2021-03-07;412;73;65739;25456;7.3;2.8
29;2021-03-08;1273;519;67012;25975;7.4;2.9
29;2021-03-09;2603;866;69615;26841;7.7;3.0
29;2021-03-10;2426;777;72041;27618;7.9;3.0
29;2021-03-11;4520;906;76561;28524;8.4;3.1
29;2021-03-12;5272;894;81833;29418;9.0;3.2
29;2021-03-13;2825;384;84658;29802;9.3;3.3
29;2021-03-14;367;3;85025;29805;9.4;3.3
29;2021-03-15;2050;266;87075;30071;9.6;3.3
29;2021-03-16;1825;726;88900;30797;9.8;3.4
29;2021-03-17;1862;692;90762;31489;10.0;3.5
29;2021-03-18;1866;1019;92628;32508;10.2;3.6
29;2021-03-19;3270;870;95898;33378;10.6;3.7
29;2021-03-20;1914;214;97812;33592;10.8;3.7
29;2021-03-21;132;11;97944;33603;10.8;3.7
29;2021-03-22;1647;550;99591;34153;11.0;3.8
29;2021-03-23;3443;1028;103034;35181;11.4;3.9
29;2021-03-24;3781;1017;106815;36198;11.8;4.0
29;2021-03-25;4822;1061;111637;37259;12.3;4.1
29;2021-03-26;5423;1157;117060;38416;12.9;4.2
29;2021-03-27;2429;331;119489;38747;13.2;4.3
29;2021-03-28;198;50;119687;38797;13.2;4.3
29;2021-03-29;2042;813;121729;39610;13.4;4.4
29;2021-03-30;3977;1325;125706;40935;13.9;4.5
29;2021-03-31;3937;1152;129643;42087;14.3;4.6
29;2021-04-01;5029;1139;134672;43226;14.9;4.8
29;2021-04-02;4765;1167;139437;44393;15.4;4.9
29;2021-04-03;2500;535;141937;44928;15.7;5.0
29;2021-04-04;146;33;142083;44961;15.7;5.0
29;2021-04-05;972;331;143055;45292;15.8;5.0
29;2021-04-06;3199;1234;146254;46526;16.1;5.1
29;2021-04-07;3653;941;149907;47467;16.5;5.2
29;2021-04-08;5285;2053;155192;49520;17.1;5.5
29;2021-04-09;6759;1562;161951;51082;17.9;5.6
29;2021-04-10;3503;710;165454;51792;18.3;5.7
29;2021-04-11;120;80;165574;51872;18.3;5.7
29;2021-04-12;3853;1480;169427;53352;18.7;5.9
29;2021-04-13;5865;1753;175292;55105;19.3;6.1
29;2021-04-14;4759;1742;180051;56847;19.9;6.3
29;2021-04-15;7174;1730;187225;58577;20.7;6.5
29;2021-04-16;6703;1353;193928;59930;21.4;6.6
29;2021-04-17;3829;968;197757;60898;21.8;6.7
29;2021-04-18;489;40;198246;60938;21.9;6.7
29;2021-04-19;3881;1464;202127;62402;22.3;6.9
29;2021-04-20;4397;2136;206524;64538;22.8;7.1
29;2021-04-21;4378;2195;210902;66733;23.3;7.4
29;2021-04-22;6638;2848;217540;69581;24.0;7.7
29;2021-04-23;6050;2195;223590;71776;24.7;7.9
29;2021-04-24;4008;1310;227598;73086;25.1;8.1
29;2021-04-25;435;169;228033;73255;25.2;8.1
29;2021-04-26;5260;1859;233293;75114;25.7;8.3
29;2021-04-27;5336;3176;238629;78290;26.3;8.6
29;2021-04-28;5359;2890;243988;81180;26.9;9.0
29;2021-04-29;6593;3304;250581;84484;27.6;9.3
29;2021-04-30;6265;3848;256846;88332;28.3;9.7
29;2021-05-01;1986;978;258832;89310;28.6;9.9
29;2021-05-02;1249;192;260081;89502;28.7;9.9
29;2021-05-03;4540;2278;264621;91780;29.2;10.1
29;2021-05-04;4108;3727;268729;95507;29.6;10.5
29;2021-05-05;4521;3402;273250;98909;30.1;10.9
29;2021-05-06;6240;3713;279490;102622;30.8;11.3
29;2021-05-07;5985;4562;285475;107184;31.5;11.8
29;2021-05-08;2097;561;287572;107745;31.7;11.9
29;2021-05-09;1731;136;289303;107881;31.9;11.9
29;2021-05-10;4767;3751;294070;111632;32.4;12.3
29;2021-05-11;4708;4965;298778;116597;33.0;12.9
29;2021-05-12;5023;4358;303801;120955;33.5;13.3
29;2021-05-13;3441;1498;307242;122453;33.9;13.5
29;2021-05-14;5649;3980;312891;126433;34.5;13.9
29;2021-05-15;4049;2294;316940;128727;35.0;14.2
29;2021-05-16;1588;294;318528;129021;35.1;14.2
29;2021-05-17;5562;3120;324090;132141;35.7;14.6
29;2021-05-18;5732;3070;329822;135211;36.4;14.9
29;2021-05-19;6214;2956;336036;138167;37.1;15.2
29;2021-05-20;7172;4546;343208;142713;37.9;15.7
29;2021-05-21;7212;3797;350420;146510;38.7;16.2
29;2021-05-22;5342;2123;355762;148633;39.2;16.4
29;2021-05-23;1631;65;357393;148698;39.4;16.4
29;2021-05-24;3485;534;360878;149232;39.8;16.5
29;2021-05-25;5835;3027;366713;152259;40.5;16.8
29;2021-05-26;5889;2987;372602;155246;41.1;17.1
29;2021-05-27;6824;3951;379426;159197;41.9;17.6
29;2021-05-28;6544;4389;385970;163586;42.6;18.0
29;2021-05-29;4382;2797;390352;166383;43.1;18.4
29;2021-05-30;1113;360;391465;166743;43.2;18.4
29;2021-05-31;6384;3434;397849;170177;43.9;18.8
29;2021-06-01;6603;4311;404452;174488;44.6;19.2
29;2021-06-02;6162;4125;410614;178613;45.3;19.7
29;2021-06-03;7689;4494;418303;183107;46.1;20.2
29;2021-06-04;6812;6136;425115;189243;46.9;20.9
29;2021-06-05;5350;3023;430465;192266;47.5;21.2
29;2021-06-06;1284;538;431749;192804;47.6;21.3
29;2021-06-07;4659;5562;436408;198366;48.1;21.9
29;2021-06-08;7172;5187;443580;203553;48.9;22.5
29;2021-06-09;6403;4743;449983;208296;49.6;23.0
29;2021-06-10;7775;5046;457758;213342;50.5;23.5
29;2021-06-11;8473;5860;466231;219202;51.4;24.2
29;2021-06-12;6562;2812;472793;222014;52.2;24.5
29;2021-06-13;2351;1370;475144;223384;52.4;24.6
29;2021-06-14;4034;6306;479178;229690;52.9;25.3
29;2021-06-15;5477;6180;484655;235870;53.5;26.0
29;2021-06-16;5571;5622;490226;241492;54.1;26.6
29;2021-06-17;6370;6310;496596;247802;54.8;27.3
29;2021-06-18;6116;7486;502712;255288;55.5;28.2
29;2021-06-19;4619;3522;507331;258810;56.0;28.5
29;2021-06-20;891;1452;508222;260262;56.1;28.7
29;2021-06-21;3761;6491;511983;266753;56.5;29.4
29;2021-06-22;4490;6421;516473;273174;57.0;30.1
29;2021-06-23;4673;6128;521146;279302;57.5;30.8
29;2021-06-24;4810;6744;525956;286046;58.0;31.6
29;2021-06-25;3598;7530;529554;293576;58.4;32.4
29;2021-06-26;2131;4093;531685;297669;58.6;32.8
29;2021-06-27;967;1631;532652;299300;58.8;33.0
29;2021-06-28;2844;6862;535496;306162;59.1;33.8
29;2021-06-29;2813;7723;538309;313885;59.4;34.6
29;2021-06-30;3048;7505;541357;321390;59.7;35.5
29;2021-07-01;3790;8421;545147;329811;60.1;36.4
29;2021-07-02;3607;9651;548754;339462;60.5;37.4
29;2021-07-03;2327;6050;551081;345512;60.8;38.1
29;2021-07-04;814;1771;551895;347283;60.9;38.3
29;2021-07-05;1914;7154;553809;354437;61.1;39.1
29;2021-07-06;1543;8004;555352;362441;61.3;40.0
29;2021-07-07;1707;7035;557059;369476;61.4;40.8
29;2021-07-08;2454;8200;559513;377676;61.7;41.7
29;2021-07-09;2627;9061;562140;386737;62.0;42.7
29;2021-07-10;1917;6102;564057;392839;62.2;43.3
29;2021-07-11;449;1064;564506;393903;62.3;43.5
29;2021-07-12;1983;8376;566489;402279;62.5;44.4
29;2021-07-13;2754;8660;569243;410939;62.8;45.3
29;2021-07-14;2086;3372;571329;414311;63.0;45.7
29;2021-07-15;3859;9723;575188;424034;63.4;46.8
29;2021-07-16;4620;9186;579808;433220;64.0;47.8
29;2021-07-17;3223;6109;583031;439329;64.3;48.5
29;2021-07-18;668;1079;583699;440408;64.4;48.6
29;2021-07-19;3157;7541;586856;447949;64.7;49.4
29;2021-07-20;3556;9432;590412;457381;65.1;50.5
29;2021-07-21;3664;7706;594076;465087;65.5;51.3
29;2021-07-22;3429;8535;597505;473622;65.9;52.2
29;2021-07-23;4066;10700;601571;484322;66.4;53.4
29;2021-07-24;2536;5956;604107;490278;66.6;54.1
29;2021-07-25;655;2359;604762;492637;66.7;54.3
29;2021-07-26;3400;7278;608162;499915;67.1;55.1
29;2021-07-27;3721;7110;611883;507025;67.5;55.9
29;2021-07-28;4207;6031;616090;513056;68.0;56.6
29;2021-07-29;5706;6361;621796;519417;68.6;57.3
29;2021-07-30;5472;6536;627268;525953;69.2;58.0
29;2021-07-31;2938;4931;630206;530884;69.5;58.6
29;2021-08-01;658;921;630864;531805;69.6;58.7
29;2021-08-02;4308;5213;635172;537018;70.1;59.2
29;2021-08-03;5490;4408;640662;541426;70.7;59.7
29;2021-08-04;5744;3610;646406;545036;71.3;60.1
29;2021-08-05;6655;4110;653061;549146;72.0;60.6
29;2021-08-06;6216;4334;659277;553480;72.7;61.1
29;2021-08-07;4294;2954;663571;556434;73.2;61.4
29;2021-08-08;854;754;664425;557188;73.3;61.5
29;2021-08-09;3084;4739;667509;561927;73.6;62.0
29;2021-08-10;4494;3865;672003;565792;74.1;62.4
29;2021-08-11;3975;3189;675978;568981;74.6;62.8
29;2021-08-12;4652;4500;680630;573481;75.1;63.3
29;2021-08-13;4239;3718;684869;577199;75.5;63.7
29;2021-08-14;2968;2845;687837;580044;75.9;64.0
29;2021-08-15;338;405;688175;580449;75.9;64.0
29;2021-08-16;3288;4375;691463;584824;76.3;64.5
29;2021-08-17;4411;3421;695874;588245;76.8;64.9
29;2021-08-18;3683;3620;699557;591865;77.2;65.3
29;2021-08-19;3916;4719;703473;596584;77.6;65.8
29;2021-08-20;3512;4599;706985;601183;78.0;66.3
29;2021-08-21;2277;3164;709262;604347;78.2;66.7
29;2021-08-22;217;415;709479;604762;78.3;66.7
29;2021-08-23;2504;4627;711983;609389;78.5;67.2
29;2021-08-24;2468;4954;714451;614343;78.8;67.8
29;2021-08-25;2170;4230;716621;618573;79.0;68.2
29;2021-08-26;2360;5340;718981;623913;79.3;68.8
29;2021-08-27;2065;5914;721046;629827;79.5;69.5
29;2021-08-28;1474;4001;722520;633828;79.7;69.9
29;2021-08-29;453;1318;722973;635146;79.7;70.1
29;2021-08-30;1458;4232;724431;639378;79.9;70.5
29;2021-08-31;1630;4536;726061;643914;80.1;71.0
29;2021-09-01;1342;4005;727403;647919;80.2;71.5
29;2021-09-02;1176;4426;728579;652345;80.4;72.0
29;2021-09-03;1438;5292;730017;657637;80.5;72.5
29;2021-09-04;1419;4064;731436;661701;80.7;73.0
29;2021-09-05;227;741;731663;662442;80.7;73.1
29;2021-09-06;741;3761;732404;666203;80.8;73.5
29;2021-09-07;928;4019;733332;670222;80.9;73.9
29;2021-09-08;914;3904;734246;674126;81.0;74.4
29;2021-09-09;957;3922;735203;678048;81.1;74.8
29;2021-09-10;1197;5082;736400;683130;81.2;75.4
29;2021-09-11;732;3667;737132;686797;81.3;75.8
29;2021-09-12;116;443;737248;687240;81.3;75.8
29;2021-09-13;837;3942;738085;691182;81.4;76.2
29;2021-09-14;723;3914;738808;695096;81.5;76.7
29;2021-09-15;715;3225;739523;698321;81.6;77.0
29;2021-09-16;838;2790;740361;701111;81.7;77.3
29;2021-09-17;922;3243;741283;704354;81.8;77.7
29;2021-09-18;596;3449;741879;707803;81.8;78.1
29;2021-09-19;84;443;741963;708246;81.8;78.1
29;2021-09-20;490;2169;742453;710415;81.9;78.4
29;2021-09-21;474;1917;742927;712332;82.0;78.6
29;2021-09-22;365;2241;743292;714573;82.0;78.8
29;2021-09-23;465;1754;743757;716327;82.0;79.0
29;2021-09-24;485;2230;744242;718557;82.1;79.3
29;2021-09-25;340;2732;744582;721289;82.1;79.6
29;2021-09-26;56;239;744638;721528;82.1;79.6
29;2021-09-27;328;1638;744966;723166;82.2;79.8
29;2021-09-28;258;1567;745224;724733;82.2;79.9
29;2021-09-29;399;1677;745623;726410;82.2;80.1
29;2021-09-30;321;1327;745944;727737;82.3;80.3
29;2021-10-01;460;1536;746404;729273;82.3;80.4
29;2021-10-02;360;1673;746764;730946;82.4;80.6
29;2021-10-03;7;30;746771;730976;82.4;80.6
29;2021-10-04;298;1318;747069;732294;82.4;80.8
29;2021-10-05;238;1065;747307;733359;82.4;80.9
29;2021-10-06;296;1175;747603;734534;82.5;81.0
2A;2020-12-27;0;0;0;0;0.0;0.0
2A;2020-12-28;0;0;0;0;0.0;0.0
2A;2020-12-29;0;0;0;0;0.0;0.0
2A;2020-12-30;0;0;0;0;0.0;0.0
2A;2020-12-31;0;0;0;0;0.0;0.0
2A;2021-01-01;0;0;0;0;0.0;0.0
2A;2021-01-02;1;0;1;0;0.0;0.0
2A;2021-01-03;0;0;1;0;0.0;0.0
2A;2021-01-04;0;0;1;0;0.0;0.0
2A;2021-01-05;0;0;1;0;0.0;0.0
2A;2021-01-06;6;0;7;0;0.0;0.0
2A;2021-01-07;122;1;129;1;0.1;0.0
2A;2021-01-08;114;0;243;1;0.1;0.0
2A;2021-01-09;39;0;282;1;0.2;0.0
2A;2021-01-10;33;0;315;1;0.2;0.0
2A;2021-01-11;78;0;393;1;0.2;0.0
2A;2021-01-12;85;0;478;1;0.3;0.0
2A;2021-01-13;113;0;591;1;0.4;0.0
2A;2021-01-14;191;1;782;2;0.5;0.0
2A;2021-01-15;149;0;931;2;0.6;0.0
2A;2021-01-16;160;1;1091;3;0.7;0.0
2A;2021-01-17;86;1;1177;4;0.7;0.0
2A;2021-01-18;201;2;1378;6;0.8;0.0
2A;2021-01-19;488;1;1866;7;1.1;0.0
2A;2021-01-20;356;0;2222;7;1.4;0.0
2A;2021-01-21;453;1;2675;8;1.6;0.0
2A;2021-01-22;367;0;3042;8;1.9;0.0
2A;2021-01-23;183;0;3225;8;2.0;0.0
2A;2021-01-24;118;1;3343;9;2.1;0.0
2A;2021-01-25;215;0;3558;9;2.2;0.0
2A;2021-01-26;402;7;3960;16;2.4;0.0
2A;2021-01-27;325;5;4285;21;2.6;0.0
2A;2021-01-28;335;73;4620;94;2.8;0.1
2A;2021-01-29;342;59;4962;153;3.1;0.1
2A;2021-01-30;128;34;5090;187;3.1;0.1
2A;2021-01-31;92;11;5182;198;3.2;0.1
2A;2021-02-01;230;42;5412;240;3.3;0.1
2A;2021-02-02;288;107;5700;347;3.5;0.2
2A;2021-02-03;265;72;5965;419;3.7;0.3
2A;2021-02-04;256;113;6221;532;3.8;0.3
2A;2021-02-05;267;95;6488;627;4.0;0.4
2A;2021-02-06;121;54;6609;681;4.1;0.4
2A;2021-02-07;68;39;6677;720;4.1;0.4
2A;2021-02-08;92;169;6769;889;4.2;0.5
2A;2021-02-09;128;263;6897;1152;4.2;0.7
2A;2021-02-10;167;208;7064;1360;4.3;0.8
2A;2021-02-11;299;308;7363;1668;4.5;1.0
2A;2021-02-12;345;240;7708;1908;4.7;1.2
2A;2021-02-13;225;49;7933;1957;4.9;1.2
2A;2021-02-14;135;58;8068;2015;5.0;1.2
2A;2021-02-15;198;152;8266;2167;5.1;1.3
2A;2021-02-16;384;265;8650;2432;5.3;1.5
2A;2021-02-17;297;151;8947;2583;5.5;1.6
2A;2021-02-18;340;164;9287;2747;5.7;1.7
2A;2021-02-19;145;251;9432;2998;5.8;1.8
2A;2021-02-20;243;104;9675;3102;6.0;1.9
2A;2021-02-21;58;42;9733;3144;6.0;1.9
2A;2021-02-22;77;193;9810;3337;6.0;2.1
2A;2021-02-23;122;238;9932;3575;6.1;2.2
2A;2021-02-24;82;244;10014;3819;6.2;2.4
2A;2021-02-25;104;210;10118;4029;6.2;2.5
2A;2021-02-26;123;216;10241;4245;6.3;2.6
2A;2021-02-27;308;52;10549;4297;6.5;2.6
2A;2021-02-28;69;55;10618;4352;6.5;2.7
2A;2021-03-01;117;129;10735;4481;6.6;2.8
2A;2021-03-02;199;237;10934;4718;6.7;2.9
2A;2021-03-03;249;236;11183;4954;6.9;3.1
2A;2021-03-04;508;205;11691;5159;7.2;3.2
2A;2021-03-05;973;260;12664;5419;7.8;3.3
2A;2021-03-06;1167;73;13831;5492;8.5;3.4
2A;2021-03-07;1021;43;14852;5535;9.1;3.4
2A;2021-03-08;933;80;15785;5615;9.7;3.5
2A;2021-03-09;938;140;16723;5755;10.3;3.5
2A;2021-03-10;634;135;17357;5890;10.7;3.6
2A;2021-03-11;723;258;18080;6148;11.1;3.8
2A;2021-03-12;561;310;18641;6458;11.5;4.0
2A;2021-03-13;613;189;19254;6647;11.9;4.1
2A;2021-03-14;312;125;19566;6772;12.0;4.2
2A;2021-03-15;377;197;19943;6969;12.3;4.3
2A;2021-03-16;498;366;20441;7335;12.6;4.5
2A;2021-03-17;703;267;21144;7602;13.0;4.7
2A;2021-03-18;447;299;21591;7901;13.3;4.9
2A;2021-03-19;489;152;22080;8053;13.6;5.0
2A;2021-03-20;1079;258;23159;8311;14.3;5.1
2A;2021-03-21;695;53;23854;8364;14.7;5.1
2A;2021-03-22;347;65;24201;8429;14.9;5.2
2A;2021-03-23;518;56;24719;8485;15.2;5.2
2A;2021-03-24;864;92;25583;8577;15.8;5.3
2A;2021-03-25;930;140;26513;8717;16.3;5.4
2A;2021-03-26;1080;164;27593;8881;17.0;5.5
2A;2021-03-27;1189;199;28782;9080;17.7;5.6
2A;2021-03-28;241;95;29023;9175;17.9;5.6
2A;2021-03-29;283;138;29306;9313;18.0;5.7
2A;2021-03-30;383;232;29689;9545;18.3;5.9
2A;2021-03-31;445;224;30134;9769;18.6;6.0
2A;2021-04-01;638;451;30772;10220;18.9;6.3
2A;2021-04-02;903;780;31675;11000;19.5;6.8
2A;2021-04-03;645;981;32320;11981;19.9;7.4
2A;2021-04-04;578;783;32898;12764;20.3;7.9
2A;2021-04-05;525;691;33423;13455;20.6;8.3
2A;2021-04-06;548;559;33971;14014;20.9;8.6
2A;2021-04-07;795;428;34766;14442;21.4;8.9
2A;2021-04-08;1047;358;35813;14800;22.0;9.1
2A;2021-04-09;934;389;36747;15189;22.6;9.4
2A;2021-04-10;1058;382;37805;15571;23.3;9.6
2A;2021-04-11;362;256;38167;15827;23.5;9.7
2A;2021-04-12;669;339;38836;16166;23.9;10.0
2A;2021-04-13;329;378;39165;16544;24.1;10.2
2A;2021-04-14;1045;587;40210;17131;24.8;10.5
2A;2021-04-15;1044;524;41254;17655;25.4;10.9
2A;2021-04-16;872;392;42126;18047;25.9;11.1
2A;2021-04-17;1369;934;43495;18981;26.8;11.7
2A;2021-04-18;981;948;44476;19929;27.4;12.3
2A;2021-04-19;270;343;44746;20272;27.5;12.5
2A;2021-04-20;354;344;45100;20616;27.8;12.7
2A;2021-04-21;729;734;45829;21350;28.2;13.1
2A;2021-04-22;897;646;46726;21996;28.8;13.5
2A;2021-04-23;986;776;47712;22772;29.4;14.0
2A;2021-04-24;1750;984;49462;23756;30.5;14.6
2A;2021-04-25;976;306;50438;24062;31.1;14.8
2A;2021-04-26;308;226;50746;24288;31.2;15.0
2A;2021-04-27;343;347;51089;24635;31.5;15.2
2A;2021-04-28;1676;424;52765;25059;32.5;15.4
2A;2021-04-29;1053;361;53818;25420;33.1;15.7
2A;2021-04-30;1131;1062;54949;26482;33.8;16.3
2A;2021-05-01;970;575;55919;27057;34.4;16.7
2A;2021-05-02;674;708;56593;27765;34.8;17.1
2A;2021-05-03;583;575;57176;28340;35.2;17.4
2A;2021-05-04;752;535;57928;28875;35.7;17.8
2A;2021-05-05;1011;983;58939;29858;36.3;18.4
2A;2021-05-06;904;911;59843;30769;36.8;18.9
2A;2021-05-07;1156;834;60999;31603;37.6;19.5
2A;2021-05-08;422;501;61421;32104;37.8;19.8
2A;2021-05-09;783;636;62204;32740;38.3;20.2
2A;2021-05-10;454;741;62658;33481;38.6;20.6
2A;2021-05-11;652;417;63310;33898;39.0;20.9
2A;2021-05-12;925;488;64235;34386;39.5;21.2
2A;2021-05-13;920;138;65155;34524;40.1;21.3
2A;2021-05-14;797;678;65952;35202;40.6;21.7
2A;2021-05-15;778;649;66730;35851;41.1;22.1
2A;2021-05-16;740;500;67470;36351;41.5;22.4
2A;2021-05-17;584;557;68054;36908;41.9;22.7
2A;2021-05-18;614;475;68668;37383;42.3;23.0
2A;2021-05-19;787;481;69455;37864;42.8;23.3
2A;2021-05-20;692;539;70147;38403;43.2;23.6
2A;2021-05-21;536;483;70683;38886;43.5;23.9
2A;2021-05-22;440;310;71123;39196;43.8;24.1
2A;2021-05-23;533;282;71656;39478;44.1;24.3
2A;2021-05-24;125;33;71781;39511;44.2;24.3
2A;2021-05-25;421;503;72202;40014;44.5;24.6
2A;2021-05-26;425;1166;72627;41180;44.7;25.4
2A;2021-05-27;435;1111;73062;42291;45.0;26.0
2A;2021-05-28;298;915;73360;43206;45.2;26.6
2A;2021-05-29;334;900;73694;44106;45.4;27.2
2A;2021-05-30;181;507;73875;44613;45.5;27.5
2A;2021-05-31;191;413;74066;45026;45.6;27.7
2A;2021-06-01;342;727;74408;45753;45.8;28.2
2A;2021-06-02;285;940;74693;46693;46.0;28.7
2A;2021-06-03;306;850;74999;47543;46.2;29.3
2A;2021-06-04;271;1091;75270;48634;46.3;29.9
2A;2021-06-05;319;1443;75589;50077;46.5;30.8
2A;2021-06-06;173;907;75762;50984;46.6;31.4
2A;2021-06-07;171;658;75933;51642;46.8;31.8
2A;2021-06-08;324;706;76257;52348;47.0;32.2
2A;2021-06-09;304;1320;76561;53668;47.1;33.0
2A;2021-06-10;329;857;76890;54525;47.3;33.6
2A;2021-06-11;277;1019;77167;55544;47.5;34.2
2A;2021-06-12;232;657;77399;56201;47.7;34.6
2A;2021-06-13;189;797;77588;56998;47.8;35.1
2A;2021-06-14;251;922;77839;57920;47.9;35.7
2A;2021-06-15;217;507;78056;58427;48.1;36.0
2A;2021-06-16;213;776;78269;59203;48.2;36.5
2A;2021-06-17;235;591;78504;59794;48.3;36.8
2A;2021-06-18;246;912;78750;60706;48.5;37.4
2A;2021-06-19;208;689;78958;61395;48.6;37.8
2A;2021-06-20;150;692;79108;62087;48.7;38.2
2A;2021-06-21;184;795;79292;62882;48.8;38.7
2A;2021-06-22;236;841;79528;63723;49.0;39.2
2A;2021-06-23;217;568;79745;64291;49.1;39.6
2A;2021-06-24;149;369;79894;64660;49.2;39.8
2A;2021-06-25;167;470;80061;65130;49.3;40.1
2A;2021-06-26;203;872;80264;66002;49.4;40.6
2A;2021-06-27;175;794;80439;66796;49.5;41.1
2A;2021-06-28;194;704;80633;67500;49.6;41.6
2A;2021-06-29;216;689;80849;68189;49.8;42.0
2A;2021-06-30;242;490;81091;68679;49.9;42.3
2A;2021-07-01;211;483;81302;69162;50.1;42.6
2A;2021-07-02;294;368;81596;69530;50.2;42.8
2A;2021-07-03;211;617;81807;70147;50.4;43.2
2A;2021-07-04;179;664;81986;70811;50.5;43.6
2A;2021-07-05;163;235;82149;71046;50.6;43.7
2A;2021-07-06;252;389;82401;71435;50.7;44.0
2A;2021-07-07;433;611;82834;72046;51.0;44.4
2A;2021-07-08;592;705;83426;72751;51.4;44.8
2A;2021-07-09;384;420;83810;73171;51.6;45.1
2A;2021-07-10;281;346;84091;73517;51.8;45.3
2A;2021-07-11;92;151;84183;73668;51.8;45.4
2A;2021-07-12;317;346;84500;74014;52.0;45.6
2A;2021-07-13;1178;534;85678;74548;52.8;45.9
2A;2021-07-14;1623;342;87301;74890;53.7;46.1
2A;2021-07-15;1436;836;88737;75726;54.6;46.6
2A;2021-07-16;1168;464;89905;76190;55.4;46.9
2A;2021-07-17;1096;348;91001;76538;56.0;47.1
2A;2021-07-18;635;135;91636;76673;56.4;47.2
2A;2021-07-19;918;425;92554;77098;57.0;47.5
2A;2021-07-20;1283;469;93837;77567;57.8;47.8
2A;2021-07-21;1426;724;95263;78291;58.7;48.2
2A;2021-07-22;1400;764;96663;79055;59.5;48.7
2A;2021-07-23;1439;463;98102;79518;60.4;49.0
2A;2021-07-24;896;290;98998;79808;61.0;49.1
2A;2021-07-25;451;81;99449;79889;61.2;49.2
2A;2021-07-26;1198;507;100647;80396;62.0;49.5
2A;2021-07-27;1297;513;101944;80909;62.8;49.8
2A;2021-07-28;1199;593;103143;81502;63.5;50.2
2A;2021-07-29;1230;656;104373;82158;64.3;50.6
2A;2021-07-30;961;609;105334;82767;64.9;51.0
2A;2021-07-31;548;340;105882;83107;65.2;51.2
2A;2021-08-01;570;124;106452;83231;65.5;51.2
2A;2021-08-02;451;494;106903;83725;65.8;51.5
2A;2021-08-03;814;881;107717;84606;66.3;52.1
2A;2021-08-04;724;1161;108441;85767;66.8;52.8
2A;2021-08-05;956;1348;109397;87115;67.4;53.6
2A;2021-08-06;390;815;109787;87930;67.6;54.1
2A;2021-08-07;352;888;110139;88818;67.8;54.7
2A;2021-08-08;78;185;110217;89003;67.9;54.8
2A;2021-08-09;663;1142;110880;90145;68.3;55.5
2A;2021-08-10;642;1209;111522;91354;68.7;56.2
2A;2021-08-11;593;1064;112115;92418;69.0;56.9
2A;2021-08-12;742;1491;112857;93909;69.5;57.8
2A;2021-08-13;486;1066;113343;94975;69.8;58.5
2A;2021-08-14;414;766;113757;95741;70.0;58.9
2A;2021-08-15;27;26;113784;95767;70.1;59.0
2A;2021-08-16;482;1292;114266;97059;70.4;59.8
2A;2021-08-17;940;1556;115206;98615;70.9;60.7
2A;2021-08-18;525;1123;115731;99738;71.3;61.4
2A;2021-08-19;431;1010;116162;100748;71.5;62.0
2A;2021-08-20;328;574;116490;101322;71.7;62.4
2A;2021-08-21;240;535;116730;101857;71.9;62.7
2A;2021-08-22;197;617;116927;102474;72.0;63.1
2A;2021-08-23;325;744;117252;103218;72.2;63.5
2A;2021-08-24;326;858;117578;104076;72.4;64.1
2A;2021-08-25;401;881;117979;104957;72.6;64.6
2A;2021-08-26;343;769;118322;105726;72.8;65.1
2A;2021-08-27;244;716;118566;106442;73.0;65.5
2A;2021-08-28;256;352;118822;106794;73.2;65.8
2A;2021-08-29;97;115;118919;106909;73.2;65.8
2A;2021-08-30;244;652;119163;107561;73.4;66.2
2A;2021-08-31;172;520;119335;108081;73.5;66.5
2A;2021-09-01;344;837;119679;108918;73.7;67.1
2A;2021-09-02;314;734;119993;109652;73.9;67.5
2A;2021-09-03;242;633;120235;110285;74.0;67.9
2A;2021-09-04;151;453;120386;110738;74.1;68.2
2A;2021-09-05;29;32;120415;110770;74.1;68.2
2A;2021-09-06;111;425;120526;111195;74.2;68.5
2A;2021-09-07;191;793;120717;111988;74.3;68.9
2A;2021-09-08;221;794;120938;112782;74.5;69.4
2A;2021-09-09;201;592;121139;113374;74.6;69.8
2A;2021-09-10;155;465;121294;113839;74.7;70.1
2A;2021-09-11;135;345;121429;114184;74.8;70.3
2A;2021-09-12;41;143;121470;114327;74.8;70.4
2A;2021-09-13;101;227;121571;114554;74.8;70.5
2A;2021-09-14;225;429;121796;114983;75.0;70.8
2A;2021-09-15;191;541;121987;115524;75.1;71.1
2A;2021-09-16;214;364;122201;115888;75.2;71.4
2A;2021-09-17;133;176;122334;116064;75.3;71.5
2A;2021-09-18;104;302;122438;116366;75.4;71.6
2A;2021-09-19;10;49;122448;116415;75.4;71.7
2A;2021-09-20;37;130;122485;116545;75.4;71.8
2A;2021-09-21;89;246;122574;116791;75.5;71.9
2A;2021-09-22;99;448;122673;117239;75.5;72.2
2A;2021-09-23;90;325;122763;117564;75.6;72.4
2A;2021-09-24;59;258;122822;117822;75.6;72.5
2A;2021-09-25;63;143;122885;117965;75.7;72.6
2A;2021-09-26;10;29;122895;117994;75.7;72.6
2A;2021-09-27;43;104;122938;118098;75.7;72.7
2A;2021-09-28;102;172;123040;118270;75.8;72.8
2A;2021-09-29;109;297;123149;118567;75.8;73.0
2A;2021-09-30;73;209;123222;118776;75.9;73.1
2A;2021-10-01;81;119;123303;118895;75.9;73.2
2A;2021-10-02;78;137;123381;119032;76.0;73.3
2A;2021-10-03;18;33;123399;119065;76.0;73.3
2A;2021-10-04;42;79;123441;119144;76.0;73.4
2A;2021-10-05;31;114;123472;119258;76.0;73.4
2A;2021-10-06;56;119;123528;119377;76.1;73.5
2B;2020-12-27;0;0;0;0;0.0;0.0
2B;2020-12-28;0;0;0;0;0.0;0.0
2B;2020-12-29;0;0;0;0;0.0;0.0
2B;2020-12-30;0;0;0;0;0.0;0.0
2B;2020-12-31;0;0;0;0;0.0;0.0
2B;2021-01-01;0;0;0;0;0.0;0.0
2B;2021-01-02;0;0;0;0;0.0;0.0
2B;2021-01-03;0;0;0;0;0.0;0.0
2B;2021-01-04;2;0;2;0;0.0;0.0
2B;2021-01-05;0;0;2;0;0.0;0.0
2B;2021-01-06;48;1;50;1;0.0;0.0
2B;2021-01-07;210;0;260;1;0.1;0.0
2B;2021-01-08;197;2;457;3;0.3;0.0
2B;2021-01-09;40;0;497;3;0.3;0.0
2B;2021-01-10;1;0;498;3;0.3;0.0
2B;2021-01-11;74;0;572;3;0.3;0.0
2B;2021-01-12;128;1;700;4;0.4;0.0
2B;2021-01-13;93;0;793;4;0.4;0.0
2B;2021-01-14;72;0;865;4;0.5;0.0
2B;2021-01-15;259;0;1124;4;0.6;0.0
2B;2021-01-16;44;0;1168;4;0.6;0.0
2B;2021-01-17;8;0;1176;4;0.6;0.0
2B;2021-01-18;271;0;1447;4;0.8;0.0
2B;2021-01-19;507;0;1954;4;1.1;0.0
2B;2021-01-20;462;3;2416;7;1.3;0.0
2B;2021-01-21;358;0;2774;7;1.5;0.0
2B;2021-01-22;382;0;3156;7;1.7;0.0
2B;2021-01-23;61;0;3217;7;1.8;0.0
2B;2021-01-24;29;0;3246;7;1.8;0.0
2B;2021-01-25;210;2;3456;9;1.9;0.0
2B;2021-01-26;392;1;3848;10;2.1;0.0
2B;2021-01-27;341;30;4189;40;2.3;0.0
2B;2021-01-28;365;118;4554;158;2.5;0.1
2B;2021-01-29;296;135;4850;293;2.7;0.2
2B;2021-01-30;80;32;4930;325;2.7;0.2
2B;2021-01-31;60;0;4990;325;2.7;0.2
2B;2021-02-01;233;84;5223;409;2.9;0.2
2B;2021-02-02;358;72;5581;481;3.1;0.3
2B;2021-02-03;521;86;6102;567;3.3;0.3
2B;2021-02-04;458;110;6560;677;3.6;0.4
2B;2021-02-05;394;85;6954;762;3.8;0.4
2B;2021-02-06;87;11;7041;773;3.9;0.4
2B;2021-02-07;60;0;7101;773;3.9;0.4
2B;2021-02-08;231;121;7332;894;4.0;0.5
2B;2021-02-09;586;252;7918;1146;4.3;0.6
2B;2021-02-10;485;161;8403;1307;4.6;0.7
2B;2021-02-11;382;108;8785;1415;4.8;0.8
2B;2021-02-12;299;110;9084;1525;5.0;0.8
2B;2021-02-13;77;10;9161;1535;5.0;0.8
2B;2021-02-14;62;1;9223;1536;5.1;0.8
2B;2021-02-15;190;100;9413;1636;5.2;0.9
2B;2021-02-16;249;217;9662;1853;5.3;1.0
2B;2021-02-17;312;253;9974;2106;5.5;1.2
2B;2021-02-18;215;278;10189;2384;5.6;1.3
2B;2021-02-19;163;267;10352;2651;5.7;1.5
2B;2021-02-20;32;38;10384;2689;5.7;1.5
2B;2021-02-21;28;23;10412;2712;5.7;1.5
2B;2021-02-22;133;154;10545;2866;5.8;1.6
2B;2021-02-23;232;300;10777;3166;5.9;1.7
2B;2021-02-24;229;266;11006;3432;6.0;1.9
2B;2021-02-25;245;280;11251;3712;6.2;2.0
2B;2021-02-26;301;241;11552;3953;6.3;2.2
2B;2021-02-27;60;71;11612;4024;6.4;2.2
2B;2021-02-28;1;44;11613;4068;6.4;2.2
2B;2021-03-01;246;238;11859;4306;6.5;2.4
2B;2021-03-02;352;354;12211;4660;6.7;2.6
2B;2021-03-03;299;395;12510;5055;6.9;2.8
2B;2021-03-04;447;376;12957;5431;7.1;3.0
2B;2021-03-05;619;351;13576;5782;7.4;3.2
2B;2021-03-06;682;90;14258;5872;7.8;3.2
2B;2021-03-07;361;57;14619;5929;8.0;3.3
2B;2021-03-08;301;220;14920;6149;8.2;3.4
2B;2021-03-09;384;472;15304;6621;8.4;3.6
2B;2021-03-10;631;420;15935;7041;8.7;3.9
2B;2021-03-11;584;333;16519;7374;9.1;4.0
2B;2021-03-12;967;219;17486;7593;9.6;4.2
2B;2021-03-13;511;97;17997;7690;9.9;4.2
2B;2021-03-14;226;63;18223;7753;10.0;4.3
2B;2021-03-15;516;198;18739;7951;10.3;4.4
2B;2021-03-16;571;271;19310;8222;10.6;4.5
2B;2021-03-17;530;258;19840;8480;10.9;4.7
2B;2021-03-18;551;221;20391;8701;11.2;4.8
2B;2021-03-19;805;192;21196;8893;11.6;4.9
2B;2021-03-20;656;37;21852;8930;12.0;4.9
2B;2021-03-21;428;36;22280;8966;12.2;4.9
2B;2021-03-22;546;122;22826;9088;12.5;5.0
2B;2021-03-23;788;255;23614;9343;13.0;5.1
2B;2021-03-24;832;214;24446;9557;13.4;5.2
2B;2021-03-25;825;163;25271;9720;13.9;5.3
2B;2021-03-26;958;189;26229;9909;14.4;5.4
2B;2021-03-27;1092;36;27321;9945;15.0;5.5
2B;2021-03-28;830;122;28151;10067;15.4;5.5
2B;2021-03-29;745;177;28896;10244;15.9;5.6
2B;2021-03-30;971;323;29867;10567;16.4;5.8
2B;2021-03-31;981;266;30848;10833;16.9;5.9
2B;2021-04-01;1003;226;31851;11059;17.5;6.1
2B;2021-04-02;966;408;32817;11467;18.0;6.3
2B;2021-04-03;1247;154;34064;11621;18.7;6.4
2B;2021-04-04;197;60;34261;11681;18.8;6.4
2B;2021-04-05;109;113;34370;11794;18.9;6.5
2B;2021-04-06;1032;359;35402;12153;19.4;6.7
2B;2021-04-07;1231;421;36633;12574;20.1;6.9
2B;2021-04-08;1129;408;37762;12982;20.7;7.1
2B;2021-04-09;1166;566;38928;13548;21.4;7.4
2B;2021-04-10;1352;265;40280;13813;22.1;7.6
2B;2021-04-11;815;65;41095;13878;22.5;7.6
2B;2021-04-12;853;558;41948;14436;23.0;7.9
2B;2021-04-13;1063;630;43011;15066;23.6;8.3
2B;2021-04-14;1046;494;44057;15560;24.2;8.5
2B;2021-04-15;886;517;44943;16077;24.7;8.8
2B;2021-04-16;910;647;45853;16724;25.2;9.2
2B;2021-04-17;386;447;46239;17171;25.4;9.4
2B;2021-04-18;253;343;46492;17514;25.5;9.6
2B;2021-04-19;822;436;47314;17950;26.0;9.8
2B;2021-04-20;898;843;48212;18793;26.5;10.3
2B;2021-04-21;1055;608;49267;19401;27.0;10.6
2B;2021-04-22;937;732;50204;20133;27.5;11.0
2B;2021-04-23;662;628;50866;20761;27.9;11.4
2B;2021-04-24;288;772;51154;21533;28.1;11.8
2B;2021-04-25;285;477;51439;22010;28.2;12.1
2B;2021-04-26;708;918;52147;22928;28.6;12.6
2B;2021-04-27;965;873;53112;23801;29.1;13.1
2B;2021-04-28;918;862;54030;24663;29.6;13.5
2B;2021-04-29;925;867;54955;25530;30.2;14.0
2B;2021-04-30;1133;831;56088;26361;30.8;14.5
2B;2021-05-01;460;1116;56548;27477;31.0;15.1
2B;2021-05-02;335;244;56883;27721;31.2;15.2
2B;2021-05-03;1017;495;57900;28216;31.8;15.5
2B;2021-05-04;811;1152;58711;29368;32.2;16.1
2B;2021-05-05;800;1376;59511;30744;32.7;16.9
2B;2021-05-06;1286;905;60797;31649;33.4;17.4
2B;2021-05-07;1062;987;61859;32636;33.9;17.9
2B;2021-05-08;459;852;62318;33488;34.2;18.4
2B;2021-05-09;392;683;62710;34171;34.4;18.7
2B;2021-05-10;924;802;63634;34973;34.9;19.2
2B;2021-05-11;933;1163;64567;36136;35.4;19.8
2B;2021-05-12;859;893;65426;37029;35.9;20.3
2B;2021-05-13;1028;376;66454;37405;36.5;20.5
2B;2021-05-14;719;577;67173;37982;36.9;20.8
2B;2021-05-15;702;353;67875;38335;37.2;21.0
2B;2021-05-16;300;180;68175;38515;37.4;21.1
2B;2021-05-17;1003;405;69178;38920;38.0;21.4
2B;2021-05-18;990;382;70168;39302;38.5;21.6
2B;2021-05-19;773;416;70941;39718;38.9;21.8
2B;2021-05-20;668;359;71609;40077;39.3;22.0
2B;2021-05-21;707;502;72316;40579;39.7;22.3
2B;2021-05-22;576;392;72892;40971;40.0;22.5
2B;2021-05-23;170;46;73062;41017;40.1;22.5
2B;2021-05-24;40;115;73102;41132;40.1;22.6
2B;2021-05-25;548;352;73650;41484;40.4;22.8
2B;2021-05-26;545;787;74195;42271;40.7;23.2
2B;2021-05-27;407;1131;74602;43402;40.9;23.8
2B;2021-05-28;550;905;75152;44307;41.2;24.3
2B;2021-05-29;311;353;75463;44660;41.4;24.5
2B;2021-05-30;46;45;75509;44705;41.4;24.5
2B;2021-05-31;375;831;75884;45536;41.6;25.0
2B;2021-06-01;414;1037;76298;46573;41.9;25.6
2B;2021-06-02;363;988;76661;47561;42.1;26.1
2B;2021-06-03;498;806;77159;48367;42.3;26.5
2B;2021-06-04;343;1253;77502;49620;42.5;27.2
2B;2021-06-05;257;491;77759;50111;42.7;27.5
2B;2021-06-06;51;129;77810;50240;42.7;27.6
2B;2021-06-07;280;949;78090;51189;42.8;28.1
2B;2021-06-08;399;1167;78489;52356;43.1;28.7
2B;2021-06-09;519;1177;79008;53533;43.3;29.4
2B;2021-06-10;369;939;79377;54472;43.6;29.9
2B;2021-06-11;432;1272;79809;55744;43.8;30.6
2B;2021-06-12;152;544;79961;56288;43.9;30.9
2B;2021-06-13;27;59;79988;56347;43.9;30.9
2B;2021-06-14;195;1111;80183;57458;44.0;31.5
2B;2021-06-15;344;1217;80527;58675;44.2;32.2
2B;2021-06-16;383;935;80910;59610;44.4;32.7
2B;2021-06-17;402;1049;81312;60659;44.6;33.3
2B;2021-06-18;348;960;81660;61619;44.8;33.8
2B;2021-06-19;144;330;81804;61949;44.9;34.0
2B;2021-06-20;44;194;81848;62143;44.9;34.1
2B;2021-06-21;265;962;82113;63105;45.1;34.6
2B;2021-06-22;317;1115;82430;64220;45.2;35.2
2B;2021-06-23;209;871;82639;65091;45.3;35.7
2B;2021-06-24;337;758;82976;65849;45.5;36.1
2B;2021-06-25;210;1074;83186;66923;45.6;36.7
2B;2021-06-26;105;550;83291;67473;45.7;37.0
2B;2021-06-27;31;214;83322;67687;45.7;37.1
2B;2021-06-28;329;954;83651;68641;45.9;37.7
2B;2021-06-29;270;985;83921;69626;46.0;38.2
2B;2021-06-30;380;948;84301;70574;46.3;38.7
2B;2021-07-01;226;507;84527;71081;46.4;39.0
2B;2021-07-02;219;557;84746;71638;46.5;39.3
2B;2021-07-03;91;397;84837;72035;46.5;39.5
2B;2021-07-04;2;0;84839;72035;46.5;39.5
2B;2021-07-05;263;666;85102;72701;46.7;39.9
2B;2021-07-06;450;707;85552;73408;46.9;40.3
2B;2021-07-07;380;910;85932;74318;47.1;40.8
2B;2021-07-08;183;351;86115;74669;47.2;41.0
2B;2021-07-09;250;376;86365;75045;47.4;41.2
2B;2021-07-10;197;199;86562;75244;47.5;41.3
2B;2021-07-11;13;14;86575;75258;47.5;41.3
2B;2021-07-12;497;746;87072;76004;47.8;41.7
2B;2021-07-13;822;1020;87894;77024;48.2;42.3
2B;2021-07-14;344;100;88238;77124;48.4;42.3
2B;2021-07-15;1270;589;89508;77713;49.1;42.6
2B;2021-07-16;1120;564;90628;78277;49.7;42.9
2B;2021-07-17;710;318;91338;78595;50.1;43.1
2B;2021-07-18;179;49;91517;78644;50.2;43.1
2B;2021-07-19;857;708;92374;79352;50.7;43.5
2B;2021-07-20;1210;681;93584;80033;51.3;43.9
2B;2021-07-21;1396;725;94980;80758;52.1;44.3
2B;2021-07-22;1330;604;96310;81362;52.8;44.6
2B;2021-07-23;1330;502;97640;81864;53.6;44.9
2B;2021-07-24;534;315;98174;82179;53.9;45.1
2B;2021-07-25;203;71;98377;82250;54.0;45.1
2B;2021-07-26;913;634;99290;82884;54.5;45.5
2B;2021-07-27;1578;704;100868;83588;55.3;45.9
2B;2021-07-28;1177;633;102045;84221;56.0;46.2
2B;2021-07-29;1144;449;103189;84670;56.6;46.5
2B;2021-07-30;763;349;103952;85019;57.0;46.6
2B;2021-07-31;539;234;104491;85253;57.3;46.8
2B;2021-08-01;230;57;104721;85310;57.5;46.8
2B;2021-08-02;799;471;105520;85781;57.9;47.1
2B;2021-08-03;1137;786;106657;86567;58.5;47.5
2B;2021-08-04;810;454;107467;87021;59.0;47.7
2B;2021-08-05;1025;560;108492;87581;59.5;48.1
2B;2021-08-06;704;526;109196;88107;59.9;48.3
2B;2021-08-07;306;408;109502;88515;60.1;48.6
2B;2021-08-08;93;142;109595;88657;60.1;48.6
2B;2021-08-09;536;747;110131;89404;60.4;49.1
2B;2021-08-10;739;1131;110870;90535;60.8;49.7
2B;2021-08-11;752;901;111622;91436;61.2;50.2
2B;2021-08-12;692;1045;112314;92481;61.6;50.7
2B;2021-08-13;494;948;112808;93429;61.9;51.3
2B;2021-08-14;200;437;113008;93866;62.0;51.5
2B;2021-08-15;117;173;113125;94039;62.1;51.6
2B;2021-08-16;509;1063;113634;95102;62.3;52.2
2B;2021-08-17;587;1308;114221;96410;62.7;52.9
2B;2021-08-18;506;1193;114727;97603;62.9;53.6
2B;2021-08-19;433;900;115160;98503;63.2;54.0
2B;2021-08-20;369;813;115529;99316;63.4;54.5
2B;2021-08-21;158;474;115687;99790;63.5;54.8
2B;2021-08-22;79;208;115766;99998;63.5;54.9
2B;2021-08-23;376;945;116142;100943;63.7;55.4
2B;2021-08-24;498;1214;116640;102157;64.0;56.1
2B;2021-08-25;347;971;116987;103128;64.2;56.6
2B;2021-08-26;401;817;117388;103945;64.4;57.0
2B;2021-08-27;262;572;117650;104517;64.6;57.3
2B;2021-08-28;168;442;117818;104959;64.6;57.6
2B;2021-08-29;53;126;117871;105085;64.7;57.7
2B;2021-08-30;364;851;118235;105936;64.9;58.1
2B;2021-08-31;380;922;118615;106858;65.1;58.6
2B;2021-09-01;368;986;118983;107844;65.3;59.2
2B;2021-09-02;306;737;119289;108581;65.5;59.6
2B;2021-09-03;220;507;119509;109088;65.6;59.9
2B;2021-09-04;123;352;119632;109440;65.6;60.0
2B;2021-09-05;17;137;119649;109577;65.6;60.1
2B;2021-09-06;163;655;119812;110232;65.7;60.5
2B;2021-09-07;259;989;120071;111221;65.9;61.0
2B;2021-09-08;203;746;120274;111967;66.0;61.4
2B;2021-09-09;183;520;120457;112487;66.1;61.7
2B;2021-09-10;201;488;120658;112975;66.2;62.0
2B;2021-09-11;130;312;120788;113287;66.3;62.2
2B;2021-09-12;17;114;120805;113401;66.3;62.2
2B;2021-09-13;191;535;120996;113936;66.4;62.5
2B;2021-09-14;279;928;121275;114864;66.5;63.0
2B;2021-09-15;159;598;121434;115462;66.6;63.4
2B;2021-09-16;215;301;121649;115763;66.7;63.5
2B;2021-09-17;114;194;121763;115957;66.8;63.6
2B;2021-09-18;51;157;121814;116114;66.8;63.7
2B;2021-09-19;15;18;121829;116132;66.8;63.7
2B;2021-09-20;106;409;121935;116541;66.9;63.9
2B;2021-09-21;100;410;122035;116951;67.0;64.2
2B;2021-09-22;116;404;122151;117355;67.0;64.4
2B;2021-09-23;103;228;122254;117583;67.1;64.5
2B;2021-09-24;87;213;122341;117796;67.1;64.6
2B;2021-09-25;36;123;122377;117919;67.1;64.7
2B;2021-09-26;2;23;122379;117942;67.1;64.7
2B;2021-09-27;71;229;122450;118171;67.2;64.8
2B;2021-09-28;97;193;122547;118364;67.2;64.9
2B;2021-09-29;120;345;122667;118709;67.3;65.1
2B;2021-09-30;70;132;122737;118841;67.3;65.2
2B;2021-10-01;113;163;122850;119004;67.4;65.3
2B;2021-10-02;52;114;122902;119118;67.4;65.4
2B;2021-10-03;13;15;122915;119133;67.4;65.4
2B;2021-10-04;84;156;122999;119289;67.5;65.5
2B;2021-10-05;85;224;123084;119513;67.5;65.6
2B;2021-10-06;125;285;123209;119798;67.6;65.7
30;2020-12-27;1;0;1;0;0.0;0.0
30;2020-12-28;2;0;3;0;0.0;0.0
30;2020-12-29;0;0;3;0;0.0;0.0
30;2020-12-30;0;0;3;0;0.0;0.0
30;2020-12-31;0;0;3;0;0.0;0.0
30;2021-01-01;0;0;3;0;0.0;0.0
30;2021-01-02;0;0;3;0;0.0;0.0
30;2021-01-03;0;0;3;0;0.0;0.0
30;2021-01-04;0;0;3;0;0.0;0.0
30;2021-01-05;4;0;7;0;0.0;0.0
30;2021-01-06;128;0;135;0;0.0;0.0
30;2021-01-07;314;0;449;0;0.1;0.0
30;2021-01-08;532;0;981;0;0.1;0.0
30;2021-01-09;270;0;1251;0;0.2;0.0
30;2021-01-10;0;0;1251;0;0.2;0.0
30;2021-01-11;536;0;1787;0;0.2;0.0
30;2021-01-12;801;3;2588;3;0.3;0.0
30;2021-01-13;641;0;3229;3;0.4;0.0
30;2021-01-14;653;5;3882;8;0.5;0.0
30;2021-01-15;756;2;4638;10;0.6;0.0
30;2021-01-16;313;0;4951;10;0.7;0.0
30;2021-01-17;4;0;4955;10;0.7;0.0
30;2021-01-18;947;5;5902;15;0.8;0.0
30;2021-01-19;1735;5;7637;20;1.0;0.0
30;2021-01-20;1303;2;8940;22;1.2;0.0
30;2021-01-21;1230;2;10170;24;1.4;0.0
30;2021-01-22;1078;6;11248;30;1.5;0.0
30;2021-01-23;634;2;11882;32;1.6;0.0
30;2021-01-24;0;0;11882;32;1.6;0.0
30;2021-01-25;830;5;12712;37;1.7;0.0
30;2021-01-26;1060;15;13772;52;1.8;0.0
30;2021-01-27;983;104;14755;156;2.0;0.0
30;2021-01-28;714;246;15469;402;2.1;0.1
30;2021-01-29;671;418;16140;820;2.2;0.1
30;2021-01-30;473;261;16613;1081;2.2;0.1
30;2021-01-31;3;6;16616;1087;2.2;0.1
30;2021-02-01;816;404;17432;1491;2.3;0.2
30;2021-02-02;1875;634;19307;2125;2.6;0.3
30;2021-02-03;1185;455;20492;2580;2.7;0.3
30;2021-02-04;970;589;21462;3169;2.9;0.4
30;2021-02-05;599;699;22061;3868;2.9;0.5
30;2021-02-06;296;203;22357;4071;3.0;0.5
30;2021-02-07;3;8;22360;4079;3.0;0.5
30;2021-02-08;574;604;22934;4683;3.1;0.6
30;2021-02-09;985;908;23919;5591;3.2;0.7
30;2021-02-10;985;979;24904;6570;3.3;0.9
30;2021-02-11;929;936;25833;7506;3.5;1.0
30;2021-02-12;620;875;26453;8381;3.5;1.1
30;2021-02-13;435;296;26888;8677;3.6;1.2
30;2021-02-14;3;19;26891;8696;3.6;1.2
30;2021-02-15;450;473;27341;9169;3.7;1.2
30;2021-02-16;460;712;27801;9881;3.7;1.3
30;2021-02-17;683;518;28484;10399;3.8;1.4
30;2021-02-18;797;429;29281;10828;3.9;1.4
30;2021-02-19;577;563;29858;11391;4.0;1.5
30;2021-02-20;224;177;30082;11568;4.0;1.5
30;2021-02-21;5;3;30087;11571;4.0;1.5
30;2021-02-22;502;652;30589;12223;4.1;1.6
30;2021-02-23;973;1340;31562;13563;4.2;1.8
30;2021-02-24;931;1015;32493;14578;4.3;1.9
30;2021-02-25;1211;778;33704;15356;4.5;2.1
30;2021-02-26;1336;491;35040;15847;4.7;2.1
30;2021-02-27;564;442;35604;16289;4.8;2.2
30;2021-02-28;6;7;35610;16296;4.8;2.2
30;2021-03-01;1342;739;36952;17035;4.9;2.3
30;2021-03-02;1714;807;38666;17842;5.2;2.4
30;2021-03-03;2311;656;40977;18498;5.5;2.5
30;2021-03-04;2638;799;43615;19297;5.8;2.6
30;2021-03-05;2766;558;46381;19855;6.2;2.7
30;2021-03-06;2998;318;49379;20173;6.6;2.7
30;2021-03-07;1862;47;51241;20220;6.8;2.7
30;2021-03-08;1556;708;52797;20928;7.1;2.8
30;2021-03-09;2276;796;55073;21724;7.4;2.9
30;2021-03-10;2360;607;57433;22331;7.7;3.0
30;2021-03-11;3053;661;60486;22992;8.1;3.1
30;2021-03-12;3114;364;63600;23356;8.5;3.1
30;2021-03-13;2227;277;65827;23633;8.8;3.2
30;2021-03-14;83;3;65910;23636;8.8;3.2
30;2021-03-15;1580;547;67490;24183;9.0;3.2
30;2021-03-16;1297;1013;68787;25196;9.2;3.4
30;2021-03-17;1456;625;70243;25821;9.4;3.4
30;2021-03-18;1648;703;71891;26524;9.6;3.5
30;2021-03-19;2250;533;74141;27057;9.9;3.6
30;2021-03-20;1400;142;75541;27199;10.1;3.6
30;2021-03-21;58;8;75599;27207;10.1;3.6
30;2021-03-22;2394;712;77993;27919;10.4;3.7
30;2021-03-23;3512;798;81505;28717;10.9;3.8
30;2021-03-24;3637;810;85142;29527;11.4;3.9
30;2021-03-25;4406;839;89548;30366;12.0;4.1
30;2021-03-26;4361;644;93909;31010;12.5;4.1
30;2021-03-27;1971;374;95880;31384;12.8;4.2
30;2021-03-28;35;29;95915;31413;12.8;4.2
30;2021-03-29;2816;1641;98731;33054;13.2;4.4
30;2021-03-30;3777;1870;102508;34924;13.7;4.7
30;2021-03-31;3505;1636;106013;36560;14.2;4.9
30;2021-04-01;4016;1466;110029;38026;14.7;5.1
30;2021-04-02;3605;1221;113634;39247;15.2;5.2
30;2021-04-03;1061;1216;114695;40463;15.3;5.4
30;2021-04-04;30;188;114725;40651;15.3;5.4
30;2021-04-05;765;291;115490;40942;15.4;5.5
30;2021-04-06;3045;1576;118535;42518;15.8;5.7
30;2021-04-07;2718;1626;121253;44144;16.2;5.9
30;2021-04-08;3922;1486;125175;45630;16.7;6.1
30;2021-04-09;4889;1512;130064;47142;17.4;6.3
30;2021-04-10;2426;1176;132490;48318;17.7;6.5
30;2021-04-11;951;59;133441;48377;17.8;6.5
30;2021-04-12;3142;1490;136583;49867;18.2;6.7
30;2021-04-13;4019;1930;140602;51797;18.8;6.9
30;2021-04-14;3387;1543;143989;53340;19.2;7.1
30;2021-04-15;3827;1470;147816;54810;19.7;7.3
30;2021-04-16;3704;1544;151520;56354;20.2;7.5
30;2021-04-17;1493;952;153013;57306;20.4;7.7
30;2021-04-18;961;67;153974;57373;20.6;7.7
30;2021-04-19;2447;2297;156421;59670;20.9;8.0
30;2021-04-20;2817;2830;159238;62500;21.3;8.4
30;2021-04-21;2599;2569;161837;65069;21.6;8.7
30;2021-04-22;3525;2317;165362;67386;22.1;9.0
30;2021-04-23;3580;2299;168942;69685;22.6;9.3
30;2021-04-24;1347;1231;170289;70916;22.8;9.5
30;2021-04-25;748;91;171037;71007;22.9;9.5
30;2021-04-26;2015;2388;173052;73395;23.1;9.8
30;2021-04-27;2952;2593;176004;75988;23.5;10.2
30;2021-04-28;2839;2486;178843;78474;23.9;10.5
30;2021-04-29;3621;2319;182464;80793;24.4;10.8
30;2021-04-30;3409;2014;185873;82807;24.8;11.1
30;2021-05-01;1746;600;187619;83407;25.1;11.1
30;2021-05-02;665;245;188284;83652;25.2;11.2
30;2021-05-03;3750;2505;192034;86157;25.7;11.5
30;2021-05-04;3976;3538;196010;89695;26.2;12.0
30;2021-05-05;3941;3117;199951;92812;26.7;12.4
30;2021-05-06;4202;3366;204153;96178;27.3;12.8
30;2021-05-07;4079;3062;208232;99240;27.8;13.3
30;2021-05-08;1606;721;209838;99961;28.0;13.4
30;2021-05-09;372;613;210210;100574;28.1;13.4
30;2021-05-10;2921;3114;213131;103688;28.5;13.9
30;2021-05-11;5388;3647;218519;107335;29.2;14.3
30;2021-05-12;5303;3214;223822;110549;29.9;14.8
30;2021-05-13;3230;1029;227052;111578;30.3;14.9
30;2021-05-14;4890;2461;231942;114039;31.0;15.2
30;2021-05-15;3407;1206;235349;115245;31.4;15.4
30;2021-05-16;397;338;235746;115583;31.5;15.4
30;2021-05-17;3793;3030;239539;118613;32.0;15.8
30;2021-05-18;4826;3033;244365;121646;32.6;16.3
30;2021-05-19;4774;2547;249139;124193;33.3;16.6
30;2021-05-20;5014;2571;254153;126764;34.0;16.9
30;2021-05-21;4884;2472;259037;129236;34.6;17.3
30;2021-05-22;3155;1282;262192;130518;35.0;17.4
30;2021-05-23;289;344;262481;130862;35.1;17.5
30;2021-05-24;785;766;263266;131628;35.2;17.6
30;2021-05-25;2654;3157;265920;134785;35.5;18.0
30;2021-05-26;2887;2570;268807;137355;35.9;18.4
30;2021-05-27;3757;2708;272564;140063;36.4;18.7
30;2021-05-28;3325;3247;275889;143310;36.9;19.1
30;2021-05-29;1687;1793;277576;145103;37.1;19.4
30;2021-05-30;360;584;277936;145687;37.1;19.5
30;2021-05-31;2829;2293;280765;147980;37.5;19.8
30;2021-06-01;3657;2791;284422;150771;38.0;20.1
30;2021-06-02;3320;2449;287742;153220;38.4;20.5
30;2021-06-03;4129;3344;291871;156564;39.0;20.9
30;2021-06-04;3896;3392;295767;159956;39.5;21.4
30;2021-06-05;1904;1313;297671;161269;39.8;21.5
30;2021-06-06;684;264;298355;161533;39.9;21.6
30;2021-06-07;4720;2524;303075;164057;40.5;21.9
30;2021-06-08;4830;3324;307905;167381;41.1;22.4
30;2021-06-09;4151;2988;312056;170369;41.7;22.8
30;2021-06-10;4613;3353;316669;173722;42.3;23.2
30;2021-06-11;4583;3807;321252;177529;42.9;23.7
30;2021-06-12;2485;1709;323737;179238;43.3;23.9
30;2021-06-13;493;344;324230;179582;43.3;24.0
30;2021-06-14;2470;4710;326700;184292;43.6;24.6
30;2021-06-15;3198;5309;329898;189601;44.1;25.3
30;2021-06-16;3107;4643;333005;194244;44.5;26.0
30;2021-06-17;3922;4374;336927;198618;45.0;26.5
30;2021-06-18;3713;4694;340640;203312;45.5;27.2
30;2021-06-19;1441;2004;342081;205316;45.7;27.4
30;2021-06-20;357;491;342438;205807;45.8;27.5
30;2021-06-21;2379;4910;344817;210717;46.1;28.2
30;2021-06-22;2365;5740;347182;216457;46.4;28.9
30;2021-06-23;2528;5342;349710;221799;46.7;29.6
30;2021-06-24;2336;4706;352046;226505;47.0;30.3
30;2021-06-25;2611;5603;354657;232108;47.4;31.0
30;2021-06-26;909;2940;355566;235048;47.5;31.4
30;2021-06-27;222;527;355788;235575;47.5;31.5
30;2021-06-28;1670;6022;357458;241597;47.8;32.3
30;2021-06-29;1837;6022;359295;247619;48.0;33.1
30;2021-06-30;2001;5253;361296;252872;48.3;33.8
30;2021-07-01;3105;4715;364401;257587;48.7;34.4
30;2021-07-02;2833;4625;367234;262212;49.1;35.0
30;2021-07-03;1154;3047;368388;265259;49.2;35.4
30;2021-07-04;116;393;368504;265652;49.2;35.5
30;2021-07-05;2025;4028;370529;269680;49.5;36.0
30;2021-07-06;2663;4974;373192;274654;49.9;36.7
30;2021-07-07;2538;4222;375730;278876;50.2;37.3
30;2021-07-08;2012;3418;377742;282294;50.5;37.7
30;2021-07-09;2410;5312;380152;287606;50.8;38.4
30;2021-07-10;1504;2157;381656;289763;51.0;38.7
30;2021-07-11;47;415;381703;290178;51.0;38.8
30;2021-07-12;2527;5152;384230;295330;51.3;39.5
30;2021-07-13;3300;6029;387530;301359;51.8;40.3
30;2021-07-14;502;550;388032;301909;51.8;40.3
30;2021-07-15;4127;5475;392159;307384;52.4;41.1
30;2021-07-16;5036;5727;397195;313111;53.1;41.8
30;2021-07-17;1706;2466;398901;315577;53.3;42.2
30;2021-07-18;146;602;399047;316179;53.3;42.2
30;2021-07-19;3374;6314;402421;322493;53.8;43.1
30;2021-07-20;4640;6521;407061;329014;54.4;44.0
30;2021-07-21;4063;5413;411124;334427;54.9;44.7
30;2021-07-22;4900;5740;416024;340167;55.6;45.4
30;2021-07-23;4998;5866;421022;346033;56.3;46.2
30;2021-07-24;2240;3257;423262;349290;56.6;46.7
30;2021-07-25;137;309;423399;349599;56.6;46.7
30;2021-07-26;4414;4132;427813;353731;57.2;47.3
30;2021-07-27;4856;4650;432669;358381;57.8;47.9
30;2021-07-28;4877;4024;437546;362405;58.5;48.4
30;2021-07-29;5929;4140;443475;366545;59.3;49.0
30;2021-07-30;5341;4390;448816;370935;60.0;49.6
30;2021-07-31;2655;1965;451471;372900;60.3;49.8
30;2021-08-01;735;311;452206;373211;60.4;49.9
30;2021-08-02;3685;4011;455891;377222;60.9;50.4
30;2021-08-03;4887;3955;460778;381177;61.6;50.9
30;2021-08-04;5285;3052;466063;384229;62.3;51.3
30;2021-08-05;4617;3795;470680;388024;62.9;51.8
30;2021-08-06;4333;4064;475013;392088;63.5;52.4
30;2021-08-07;1841;1953;476854;394041;63.7;52.6
30;2021-08-08;619;280;477473;394321;63.8;52.7
30;2021-08-09;3342;3762;480815;398083;64.2;53.2
30;2021-08-10;3926;4400;484741;402483;64.8;53.8
30;2021-08-11;3402;3481;488143;405964;65.2;54.2
30;2021-08-12;3763;4223;491906;410187;65.7;54.8
30;2021-08-13;3306;3340;495212;413527;66.2;55.2
30;2021-08-14;1134;2048;496346;415575;66.3;55.5
30;2021-08-15;270;175;496616;415750;66.4;55.5
30;2021-08-16;2201;4864;498817;420614;66.6;56.2
30;2021-08-17;2745;4197;501562;424811;67.0;56.8
30;2021-08-18;2841;3836;504403;428647;67.4;57.3
30;2021-08-19;2858;4318;507261;432965;67.8;57.8
30;2021-08-20;2608;4468;509869;437433;68.1;58.4
30;2021-08-21;1018;2888;510887;440321;68.3;58.8
30;2021-08-22;227;516;511114;440837;68.3;58.9
30;2021-08-23;1687;4476;512801;445313;68.5;59.5
30;2021-08-24;1955;4526;514756;449839;68.8;60.1
30;2021-08-25;1689;4345;516445;454184;69.0;60.7
30;2021-08-26;1851;4256;518296;458440;69.2;61.3
30;2021-08-27;1776;4358;520072;462798;69.5;61.8
30;2021-08-28;681;2476;520753;465274;69.6;62.2
30;2021-08-29;182;614;520935;465888;69.6;62.2
30;2021-08-30;1407;4308;522342;470196;69.8;62.8
30;2021-08-31;1334;4190;523676;474386;70.0;63.4
30;2021-09-01;1239;3626;524915;478012;70.1;63.9
30;2021-09-02;1396;3591;526311;481603;70.3;64.3
30;2021-09-03;1503;4189;527814;485792;70.5;64.9
30;2021-09-04;686;1963;528500;487755;70.6;65.2
30;2021-09-05;136;527;528636;488282;70.6;65.2
30;2021-09-06;742;2742;529378;491024;70.7;65.6
30;2021-09-07;698;2647;530076;493671;70.8;66.0
30;2021-09-08;869;2863;530945;496534;70.9;66.3
30;2021-09-09;907;2492;531852;499026;71.1;66.7
30;2021-09-10;940;3002;532792;502028;71.2;67.1
30;2021-09-11;553;1668;533345;503696;71.3;67.3
30;2021-09-12;95;225;533440;503921;71.3;67.3
30;2021-09-13;689;2015;534129;505936;71.4;67.6
30;2021-09-14;649;2049;534778;507985;71.4;67.9
30;2021-09-15;727;1838;535505;509823;71.5;68.1
30;2021-09-16;745;1479;536250;511302;71.6;68.3
30;2021-09-17;802;2029;537052;513331;71.8;68.6
30;2021-09-18;400;1010;537452;514341;71.8;68.7
30;2021-09-19;69;158;537521;514499;71.8;68.7
30;2021-09-20;396;1201;537917;515700;71.9;68.9
30;2021-09-21;451;1160;538368;516860;71.9;69.1
30;2021-09-22;481;1382;538849;518242;72.0;69.2
30;2021-09-23;624;1200;539473;519442;72.1;69.4
30;2021-09-24;555;1630;540028;521072;72.2;69.6
30;2021-09-25;323;857;540351;521929;72.2;69.7
30;2021-09-26;55;168;540406;522097;72.2;69.8
30;2021-09-27;378;891;540784;522988;72.3;69.9
30;2021-09-28;575;893;541359;523881;72.3;70.0
30;2021-09-29;456;1065;541815;524946;72.4;70.1
30;2021-09-30;405;911;542220;525857;72.4;70.3
30;2021-10-01;494;999;542714;526856;72.5;70.4
30;2021-10-02;268;581;542982;527437;72.5;70.5
30;2021-10-03;20;45;543002;527482;72.5;70.5
30;2021-10-04;328;786;543330;528268;72.6;70.6
30;2021-10-05;308;658;543638;528926;72.6;70.7
30;2021-10-06;372;849;544010;529775;72.7;70.8
31;2020-12-27;0;0;0;0;0.0;0.0
31;2020-12-28;2;0;2;0;0.0;0.0
31;2020-12-29;0;0;2;0;0.0;0.0
31;2020-12-30;0;0;2;0;0.0;0.0
31;2020-12-31;1;0;3;0;0.0;0.0
31;2021-01-01;4;0;7;0;0.0;0.0
31;2021-01-02;1;0;8;0;0.0;0.0
31;2021-01-03;2;0;10;0;0.0;0.0
31;2021-01-04;5;0;15;0;0.0;0.0
31;2021-01-05;50;0;65;0;0.0;0.0
31;2021-01-06;211;1;276;1;0.0;0.0
31;2021-01-07;284;1;560;2;0.0;0.0
31;2021-01-08;546;1;1106;3;0.1;0.0
31;2021-01-09;275;0;1381;3;0.1;0.0
31;2021-01-10;286;0;1667;3;0.1;0.0
31;2021-01-11;983;3;2650;6;0.2;0.0
31;2021-01-12;1192;1;3842;7;0.3;0.0
31;2021-01-13;1158;3;5000;10;0.4;0.0
31;2021-01-14;1179;18;6179;28;0.4;0.0
31;2021-01-15;1048;3;7227;31;0.5;0.0
31;2021-01-16;243;1;7470;32;0.5;0.0
31;2021-01-17;176;0;7646;32;0.5;0.0
31;2021-01-18;1616;5;9262;37;0.7;0.0
31;2021-01-19;2937;10;12199;47;0.9;0.0
31;2021-01-20;3683;12;15882;59;1.1;0.0
31;2021-01-21;2998;7;18880;66;1.3;0.0
31;2021-01-22;2275;4;21155;70;1.5;0.0
31;2021-01-23;728;2;21883;72;1.6;0.0
31;2021-01-24;212;1;22095;73;1.6;0.0
31;2021-01-25;1744;9;23839;82;1.7;0.0
31;2021-01-26;1839;36;25678;118;1.8;0.0
31;2021-01-27;1573;139;27251;257;1.9;0.0
31;2021-01-28;1385;282;28636;539;2.0;0.0
31;2021-01-29;1360;315;29996;854;2.1;0.1
31;2021-01-30;446;168;30442;1022;2.2;0.1
31;2021-01-31;61;191;30503;1213;2.2;0.1
31;2021-02-01;1183;664;31686;1877;2.3;0.1
31;2021-02-02;3056;760;34742;2637;2.5;0.2
31;2021-02-03;1922;736;36664;3373;2.6;0.2
31;2021-02-04;1813;791;38477;4164;2.7;0.3
31;2021-02-05;1342;542;39819;4706;2.8;0.3
31;2021-02-06;385;52;40204;4758;2.9;0.3
31;2021-02-07;37;37;40241;4795;2.9;0.3
31;2021-02-08;1116;608;41357;5403;3.0;0.4
31;2021-02-09;1680;1480;43037;6883;3.1;0.5
31;2021-02-10;1964;2269;45001;9152;3.2;0.7
31;2021-02-11;1814;1744;46815;10896;3.3;0.8
31;2021-02-12;1540;747;48355;11643;3.5;0.8
31;2021-02-13;504;211;48859;11854;3.5;0.8
31;2021-02-14;56;191;48915;12045;3.5;0.9
31;2021-02-15;444;1063;49359;13108;3.5;0.9
31;2021-02-16;463;1265;49822;14373;3.6;1.0
31;2021-02-17;472;1326;50294;15699;3.6;1.1
31;2021-02-18;476;1401;50770;17100;3.6;1.2
31;2021-02-19;393;1289;51163;18389;3.7;1.3
31;2021-02-20;69;415;51232;18804;3.7;1.3
31;2021-02-21;77;145;51309;18949;3.7;1.4
31;2021-02-22;434;1455;51743;20404;3.7;1.5
31;2021-02-23;864;2661;52607;23065;3.8;1.6
31;2021-02-24;652;1932;53259;24997;3.8;1.8
31;2021-02-25;1435;1616;54694;26613;3.9;1.9
31;2021-02-26;1711;989;56405;27602;4.0;2.0
31;2021-02-27;638;306;57043;27908;4.1;2.0
31;2021-02-28;78;54;57121;27962;4.1;2.0
31;2021-03-01;875;943;57996;28905;4.1;2.1
31;2021-03-02;1239;1437;59235;30342;4.2;2.2
31;2021-03-03;1356;1627;60591;31969;4.3;2.3
31;2021-03-04;2424;1319;63015;33288;4.5;2.4
31;2021-03-05;3054;1438;66069;34726;4.7;2.5
31;2021-03-06;2834;355;68903;35081;4.9;2.5
31;2021-03-07;5368;108;74271;35189;5.3;2.5
31;2021-03-08;1598;966;75869;36155;5.4;2.6
31;2021-03-09;2792;1042;78661;37197;5.6;2.7
31;2021-03-10;2574;994;81235;38191;5.8;2.7
31;2021-03-11;4382;1061;85617;39252;6.1;2.8
31;2021-03-12;5320;1102;90937;40354;6.5;2.9
31;2021-03-13;2839;472;93776;40826;6.7;2.9
31;2021-03-14;235;49;94011;40875;6.7;2.9
31;2021-03-15;2584;414;96595;41289;6.9;2.9
31;2021-03-16;1746;778;98341;42067;7.0;3.0
31;2021-03-17;1656;541;99997;42608;7.1;3.0
31;2021-03-18;1988;697;101985;43305;7.3;3.1
31;2021-03-19;3185;521;105170;43826;7.5;3.1
31;2021-03-20;1797;137;106967;43963;7.6;3.1
31;2021-03-21;211;24;107178;43987;7.7;3.1
31;2021-03-22;2580;355;109758;44342;7.8;3.2
31;2021-03-23;4057;317;113815;44659;8.1;3.2
31;2021-03-24;4356;288;118171;44947;8.4;3.2
31;2021-03-25;6042;514;124213;45461;8.9;3.2
31;2021-03-26;5466;508;129679;45969;9.3;3.3
31;2021-03-27;4350;209;134029;46178;9.6;3.3
31;2021-03-28;2291;48;136320;46226;9.7;3.3
31;2021-03-29;4206;430;140526;46656;10.0;3.3
31;2021-03-30;6595;553;147121;47209;10.5;3.4
31;2021-03-31;5650;382;152771;47591;10.9;3.4
31;2021-04-01;6968;552;159739;48143;11.4;3.4
31;2021-04-02;6101;574;165840;48717;11.8;3.5
31;2021-04-03;3927;151;169767;48868;12.1;3.5
31;2021-04-04;2060;113;171827;48981;12.3;3.5
31;2021-04-05;481;70;172308;49051;12.3;3.5
31;2021-04-06;4165;1145;176473;50196;12.6;3.6
31;2021-04-07;5988;982;182461;51178;13.0;3.7
31;2021-04-08;7568;1037;190029;52215;13.6;3.7
31;2021-04-09;8384;1257;198413;53472;14.2;3.8
31;2021-04-10;4716;543;203129;54015;14.5;3.9
31;2021-04-11;2069;136;205198;54151;14.6;3.9
31;2021-04-12;6001;1834;211199;55985;15.1;4.0
31;2021-04-13;8047;2014;219246;57999;15.6;4.1
31;2021-04-14;6655;1900;225901;59899;16.1;4.3
31;2021-04-15;7771;2239;233672;62138;16.7;4.4
31;2021-04-16;7177;2092;240849;64230;17.2;4.6
31;2021-04-17;4414;904;245263;65134;17.5;4.6
31;2021-04-18;2513;355;247776;65489;17.7;4.7
31;2021-04-19;5220;2020;252996;67509;18.1;4.8
31;2021-04-20;6073;2836;259069;70345;18.5;5.0
31;2021-04-21;5974;2786;265043;73131;18.9;5.2
31;2021-04-22;6379;3236;271422;76367;19.4;5.5
31;2021-04-23;6283;2551;277705;78918;19.8;5.6
31;2021-04-24;1616;3137;279321;82055;19.9;5.9
31;2021-04-25;688;2092;280009;84147;20.0;6.0
31;2021-04-26;3794;3212;283803;87359;20.3;6.2
31;2021-04-27;4517;3875;288320;91234;20.6;6.5
31;2021-04-28;4544;3550;292864;94784;20.9;6.8
31;2021-04-29;5183;4056;298047;98840;21.3;7.1
31;2021-04-30;5037;4122;303084;102962;21.6;7.3
31;2021-05-01;1487;3114;304571;106076;21.7;7.6
31;2021-05-02;1415;1979;305986;108055;21.8;7.7
31;2021-05-03;5658;2415;311644;110470;22.2;7.9
31;2021-05-04;4780;4739;316424;115209;22.6;8.2
31;2021-05-05;2994;5714;319418;120923;22.8;8.6
31;2021-05-06;3635;7376;323053;128299;23.1;9.2
31;2021-05-07;5257;7148;328310;135447;23.4;9.7
31;2021-05-08;3633;3102;331943;138549;23.7;9.9
31;2021-05-09;3760;2307;335703;140856;24.0;10.1
31;2021-05-10;5683;5471;341386;146327;24.4;10.4
31;2021-05-11;6605;6680;347991;153007;24.8;10.9
31;2021-05-12;6171;5927;354162;158934;25.3;11.3
31;2021-05-13;4642;2067;358804;161001;25.6;11.5
31;2021-05-14;6911;3974;365715;164975;26.1;11.8
31;2021-05-15;5145;1753;370860;166728;26.5;11.9
31;2021-05-16;3300;634;374160;167362;26.7;11.9
31;2021-05-17;5143;4148;379303;171510;27.1;12.2
31;2021-05-18;5589;4271;384892;175781;27.5;12.5
31;2021-05-19;5782;3762;390674;179543;27.9;12.8
31;2021-05-20;6473;4787;397147;184330;28.3;13.2
31;2021-05-21;5985;4594;403132;188924;28.8;13.5
31;2021-05-22;4081;1628;407213;190552;29.1;13.6
31;2021-05-23;3583;342;410796;190894;29.3;13.6
31;2021-05-24;3881;706;414677;191600;29.6;13.7
31;2021-05-25;6190;3607;420867;195207;30.0;13.9
31;2021-05-26;5608;4643;426475;199850;30.4;14.3
31;2021-05-27;4788;6183;431263;206033;30.8;14.7
31;2021-05-28;4116;6344;435379;212377;31.1;15.2
31;2021-05-29;1917;4024;437296;216401;31.2;15.4
31;2021-05-30;751;2361;438047;218762;31.3;15.6
31;2021-05-31;4397;5072;442444;223834;31.6;16.0
31;2021-06-01;5954;6559;448398;230393;32.0;16.4
31;2021-06-02;5803;6296;454201;236689;32.4;16.9
31;2021-06-03;7309;8133;461510;244822;32.9;17.5
31;2021-06-04;7541;7149;469051;251971;33.5;18.0
31;2021-06-05;9078;2773;478129;254744;34.1;18.2
31;2021-06-06;8106;1579;486235;256323;34.7;18.3
31;2021-06-07;7987;5472;494222;261795;35.3;18.7
31;2021-06-08;9106;6043;503328;267838;35.9;19.1
31;2021-06-09;8917;5553;512245;273391;36.6;19.5
31;2021-06-10;9779;6351;522024;279742;37.3;20.0
31;2021-06-11;10049;6626;532073;286368;38.0;20.4
31;2021-06-12;8788;3023;540861;289391;38.6;20.7
31;2021-06-13;8378;2018;549239;291409;39.2;20.8
31;2021-06-14;8428;6729;557667;298138;39.8;21.3
31;2021-06-15;9774;7445;567441;305583;40.5;21.8
31;2021-06-16;8735;5257;576176;310840;41.1;22.2
31;2021-06-17;8277;6603;584453;317443;41.7;22.7
31;2021-06-18;8551;7754;593004;325197;42.3;23.2
31;2021-06-19;7364;5440;600368;330637;42.9;23.6
31;2021-06-20;5572;3727;605940;334364;43.3;23.9
31;2021-06-21;5373;6915;611313;341279;43.6;24.4
31;2021-06-22;4987;8229;616300;349508;44.0;24.9
31;2021-06-23;5105;7283;621405;356791;44.4;25.5
31;2021-06-24;4633;8324;626038;365115;44.7;26.1
31;2021-06-25;5014;9309;631052;374424;45.0;26.7
31;2021-06-26;4282;6398;635334;380822;45.4;27.2
31;2021-06-27;3596;4106;638930;384928;45.6;27.5
31;2021-06-28;4097;6641;643027;391569;45.9;28.0
31;2021-06-29;3798;7559;646825;399128;46.2;28.5
31;2021-06-30;4280;7819;651105;406947;46.5;29.0
31;2021-07-01;4121;8462;655226;415409;46.8;29.7
31;2021-07-02;4112;9327;659338;424736;47.1;30.3
31;2021-07-03;4100;6111;663438;430847;47.4;30.8
31;2021-07-04;3205;4812;666643;435659;47.6;31.1
31;2021-07-05;4057;7094;670700;442753;47.9;31.6
31;2021-07-06;3889;8362;674589;451115;48.2;32.2
31;2021-07-07;3964;7960;678553;459075;48.4;32.8
31;2021-07-08;4054;8536;682607;467611;48.7;33.4
31;2021-07-09;4461;8798;687068;476409;49.0;34.0
31;2021-07-10;3918;5495;690986;481904;49.3;34.4
31;2021-07-11;3137;4138;694123;486042;49.5;34.7
31;2021-07-12;3825;8636;697948;494678;49.8;35.3
31;2021-07-13;6919;9446;704867;504124;50.3;36.0
31;2021-07-14;6167;3938;711034;508062;50.8;36.3
31;2021-07-15;8516;9451;719550;517513;51.4;36.9
31;2021-07-16;7775;9909;727325;527422;51.9;37.6
31;2021-07-17;8357;10555;735682;537977;52.5;38.4
31;2021-07-18;6620;9472;742302;547449;53.0;39.1
31;2021-07-19;4794;10775;747096;558224;53.3;39.8
31;2021-07-20;7159;11480;754255;569704;53.8;40.7
31;2021-07-21;7040;11530;761295;581234;54.3;41.5
31;2021-07-22;8165;11759;769460;592993;54.9;42.3
31;2021-07-23;7474;11811;776934;604804;55.5;43.2
31;2021-07-24;10310;10573;787244;615377;56.2;43.9
31;2021-07-25;7560;8802;794804;624179;56.7;44.6
31;2021-07-26;5513;9543;800317;633722;57.1;45.2
31;2021-07-27;7962;9197;808279;642919;57.7;45.9
31;2021-07-28;8677;8283;816956;651202;58.3;46.5
31;2021-07-29;8854;8047;825810;659249;58.9;47.1
31;2021-07-30;7672;7987;833482;667236;59.5;47.6
31;2021-07-31;6015;7394;839497;674630;59.9;48.2
31;2021-08-01;4431;4303;843928;678933;60.2;48.5
31;2021-08-02;5490;5419;849418;684352;60.6;48.8
31;2021-08-03;5896;5187;855314;689539;61.1;49.2
31;2021-08-04;5925;4805;861239;694344;61.5;49.6
31;2021-08-05;5586;7230;866825;701574;61.9;50.1
31;2021-08-06;5301;7343;872126;708917;62.3;50.6
31;2021-08-07;4596;6651;876722;715568;62.6;51.1
31;2021-08-08;3385;5579;880107;721147;62.8;51.5
31;2021-08-09;4396;7010;884503;728157;63.1;52.0
31;2021-08-10;4686;6285;889189;734442;63.5;52.4
31;2021-08-11;4526;5859;893715;740301;63.8;52.8
31;2021-08-12;4524;6758;898239;747059;64.1;53.3
31;2021-08-13;4170;6203;902409;753262;64.4;53.8
31;2021-08-14;3033;6461;905442;759723;64.6;54.2
31;2021-08-15;1309;4097;906751;763820;64.7;54.5
31;2021-08-16;3219;8118;909970;771938;65.0;55.1
31;2021-08-17;3435;7098;913405;779036;65.2;55.6
31;2021-08-18;3313;7007;916718;786043;65.4;56.1
31;2021-08-19;2987;6994;919705;793037;65.6;56.6
31;2021-08-20;3022;7396;922727;800433;65.9;57.1
31;2021-08-21;1980;6800;924707;807233;66.0;57.6
31;2021-08-22;1486;5637;926193;812870;66.1;58.0
31;2021-08-23;2385;7728;928578;820598;66.3;58.6
31;2021-08-24;2608;6174;931186;826772;66.5;59.0
31;2021-08-25;2416;5728;933602;832500;66.6;59.4
31;2021-08-26;2279;5800;935881;838300;66.8;59.8
31;2021-08-27;2362;6663;938243;844963;67.0;60.3
31;2021-08-28;1844;6789;940087;851752;67.1;60.8
31;2021-08-29;1282;5066;941369;856818;67.2;61.2
31;2021-08-30;2190;6631;943559;863449;67.4;61.6
31;2021-08-31;2257;5573;945816;869022;67.5;62.0
31;2021-09-01;1754;5062;947570;874084;67.6;62.4
31;2021-09-02;1769;4524;949339;878608;67.8;62.7
31;2021-09-03;1811;5201;951150;883809;67.9;63.1
31;2021-09-04;2006;5941;953156;889750;68.0;63.5
31;2021-09-05;1129;2400;954285;892150;68.1;63.7
31;2021-09-06;1363;3585;955648;895735;68.2;63.9
31;2021-09-07;1260;3342;956908;899077;68.3;64.2
31;2021-09-08;1421;3957;958329;903034;68.4;64.5
31;2021-09-09;1105;3119;959434;906153;68.5;64.7
31;2021-09-10;1671;3961;961105;910114;68.6;65.0
31;2021-09-11;1290;3991;962395;914105;68.7;65.2
31;2021-09-12;540;1815;962935;915920;68.7;65.4
31;2021-09-13;1014;2629;963949;918549;68.8;65.6
31;2021-09-14;1241;2800;965190;921349;68.9;65.8
31;2021-09-15;1086;2690;966276;924039;69.0;66.0
31;2021-09-16;895;1676;967171;925715;69.0;66.1
31;2021-09-17;1072;2506;968243;928221;69.1;66.3
31;2021-09-18;851;2798;969094;931019;69.2;66.5
31;2021-09-19;321;1241;969415;932260;69.2;66.5
31;2021-09-20;605;1598;970020;933858;69.2;66.7
31;2021-09-21;822;1561;970842;935419;69.3;66.8
31;2021-09-22;833;2060;971675;937479;69.4;66.9
31;2021-09-23;773;1547;972448;939026;69.4;67.0
31;2021-09-24;830;2006;973278;941032;69.5;67.2
31;2021-09-25;663;2533;973941;943565;69.5;67.4
31;2021-09-26;249;1127;974190;944692;69.5;67.4
31;2021-09-27;689;1508;974879;946200;69.6;67.5
31;2021-09-28;727;1348;975606;947548;69.6;67.6
31;2021-09-29;755;1664;976361;949212;69.7;67.8
31;2021-09-30;719;1244;977080;950456;69.7;67.8
31;2021-10-01;824;1848;977904;952304;69.8;68.0
31;2021-10-02;764;1761;978668;954065;69.9;68.1
31;2021-10-03;107;349;978775;954414;69.9;68.1
31;2021-10-04;388;695;979163;955109;69.9;68.2
31;2021-10-05;534;1318;979697;956427;69.9;68.3
31;2021-10-06;597;1187;980294;957614;70.0;68.4
32;2020-12-27;0;0;0;0;0.0;0.0
32;2020-12-28;0;0;0;0;0.0;0.0
32;2020-12-29;0;0;0;0;0.0;0.0
32;2020-12-30;0;0;0;0;0.0;0.0
32;2020-12-31;0;0;0;0;0.0;0.0
32;2021-01-01;0;0;0;0;0.0;0.0
32;2021-01-02;0;0;0;0;0.0;0.0
32;2021-01-03;1;0;1;0;0.0;0.0
32;2021-01-04;3;0;4;0;0.0;0.0
32;2021-01-05;2;0;6;0;0.0;0.0
32;2021-01-06;3;0;9;0;0.0;0.0
32;2021-01-07;155;0;164;0;0.1;0.0
32;2021-01-08;70;0;234;0;0.1;0.0
32;2021-01-09;5;0;239;0;0.1;0.0
32;2021-01-10;0;0;239;0;0.1;0.0
32;2021-01-11;11;0;250;0;0.1;0.0
32;2021-01-12;96;0;346;0;0.2;0.0
32;2021-01-13;325;1;671;1;0.4;0.0
32;2021-01-14;389;3;1060;4;0.6;0.0
32;2021-01-15;449;2;1509;6;0.8;0.0
32;2021-01-16;17;2;1526;8;0.8;0.0
32;2021-01-17;1;0;1527;8;0.8;0.0
32;2021-01-18;345;1;1872;9;1.0;0.0
32;2021-01-19;420;0;2292;9;1.2;0.0
32;2021-01-20;358;0;2650;9;1.4;0.0
32;2021-01-21;582;0;3232;9;1.7;0.0
32;2021-01-22;372;0;3604;9;1.9;0.0
32;2021-01-23;189;0;3793;9;2.0;0.0
32;2021-01-24;5;0;3798;9;2.0;0.0
32;2021-01-25;468;1;4266;10;2.2;0.0
32;2021-01-26;611;0;4877;10;2.6;0.0
32;2021-01-27;703;4;5580;14;2.9;0.0
32;2021-01-28;688;12;6268;26;3.3;0.0
32;2021-01-29;461;50;6729;76;3.5;0.0
32;2021-01-30;260;0;6989;76;3.7;0.0
32;2021-01-31;4;5;6993;81;3.7;0.0
32;2021-02-01;289;57;7282;138;3.8;0.1
32;2021-02-02;640;135;7922;273;4.2;0.1
32;2021-02-03;338;196;8260;469;4.3;0.2
32;2021-02-04;426;271;8686;740;4.6;0.4
32;2021-02-05;347;354;9033;1094;4.8;0.6
32;2021-02-06;148;0;9181;1094;4.8;0.6
32;2021-02-07;0;36;9181;1130;4.8;0.6
32;2021-02-08;278;108;9459;1238;5.0;0.7
32;2021-02-09;310;225;9769;1463;5.1;0.8
32;2021-02-10;272;242;10041;1705;5.3;0.9
32;2021-02-11;383;301;10424;2006;5.5;1.1
32;2021-02-12;298;226;10722;2232;5.6;1.2
32;2021-02-13;249;1;10971;2233;5.8;1.2
32;2021-02-14;0;28;10971;2261;5.8;1.2
32;2021-02-15;25;183;10996;2444;5.8;1.3
32;2021-02-16;395;339;11391;2783;6.0;1.5
32;2021-02-17;191;437;11582;3220;6.1;1.7
32;2021-02-18;333;422;11915;3642;6.3;1.9
32;2021-02-19;184;264;12099;3906;6.4;2.1
32;2021-02-20;1;70;12100;3976;6.4;2.1
32;2021-02-21;0;0;12100;3976;6.4;2.1
32;2021-02-22;158;332;12258;4308;6.5;2.3
32;2021-02-23;432;517;12690;4825;6.7;2.5
32;2021-02-24;277;336;12967;5161;6.8;2.7
32;2021-02-25;481;478;13448;5639;7.1;3.0
32;2021-02-26;444;360;13892;5999;7.3;3.2
32;2021-02-27;157;214;14049;6213;7.4;3.3
32;2021-02-28;4;0;14053;6213;7.4;3.3
32;2021-03-01;51;277;14104;6490;7.4;3.4
32;2021-03-02;414;406;14518;6896;7.6;3.6
32;2021-03-03;276;268;14794;7164;7.8;3.8
32;2021-03-04;542;320;15336;7484;8.1;3.9
32;2021-03-05;438;228;15774;7712;8.3;4.1
32;2021-03-06;520;150;16294;7862;8.6;4.1
32;2021-03-07;25;5;16319;7867;8.6;4.1
32;2021-03-08;234;278;16553;8145;8.7;4.3
32;2021-03-09;644;312;17197;8457;9.0;4.5
32;2021-03-10;482;318;17679;8775;9.3;4.6
32;2021-03-11;855;283;18534;9058;9.8;4.8
32;2021-03-12;881;335;19415;9393;10.2;4.9
32;2021-03-13;492;232;19907;9625;10.5;5.1
32;2021-03-14;1;0;19908;9625;10.5;5.1
32;2021-03-15;264;25;20172;9650;10.6;5.1
32;2021-03-16;314;303;20486;9953;10.8;5.2
32;2021-03-17;150;153;20636;10106;10.9;5.3
32;2021-03-18;375;304;21011;10410;11.1;5.5
32;2021-03-19;405;179;21416;10589;11.3;5.6
32;2021-03-20;136;33;21552;10622;11.3;5.6
32;2021-03-21;0;0;21552;10622;11.3;5.6
32;2021-03-22;340;167;21892;10789;11.5;5.7
32;2021-03-23;560;397;22452;11186;11.8;5.9
32;2021-03-24;643;267;23095;11453;12.2;6.0
32;2021-03-25;899;413;23994;11866;12.6;6.2
32;2021-03-26;657;293;24651;12159;13.0;6.4
32;2021-03-27;165;3;24816;12162;13.1;6.4
32;2021-03-28;1;1;24817;12163;13.1;6.4
32;2021-03-29;371;48;25188;12211;13.3;6.4
32;2021-03-30;766;287;25954;12498;13.7;6.6
32;2021-03-31;654;170;26608;12668;14.0;6.7
32;2021-04-01;1237;318;27845;12986;14.7;6.8
32;2021-04-02;575;167;28420;13153;15.0;6.9
32;2021-04-03;114;0;28534;13153;15.0;6.9
32;2021-04-04;0;0;28534;13153;15.0;6.9
32;2021-04-05;0;0;28534;13153;15.0;6.9
32;2021-04-06;2650;310;31184;13463;16.4;7.1
32;2021-04-07;1178;202;32362;13665;17.0;7.2
32;2021-04-08;1736;406;34098;14071;17.9;7.4
32;2021-04-09;883;218;34981;14289;18.4;7.5
32;2021-04-10;809;29;35790;14318;18.8;7.5
32;2021-04-11;14;0;35804;14318;18.8;7.5
32;2021-04-12;477;23;36281;14341;19.1;7.5
32;2021-04-13;2469;389;38750;14730;20.4;7.8
32;2021-04-14;1226;263;39976;14993;21.0;7.9
32;2021-04-15;1704;392;41680;15385;21.9;8.1
32;2021-04-16;638;282;42318;15667;22.3;8.2
32;2021-04-17;783;39;43101;15706;22.7;8.3
32;2021-04-18;13;1;43114;15707;22.7;8.3
32;2021-04-19;502;45;43616;15752;23.0;8.3
32;2021-04-20;2472;393;46088;16145;24.3;8.5
32;2021-04-21;1009;302;47097;16447;24.8;8.7
32;2021-04-22;1662;319;48759;16766;25.7;8.8
32;2021-04-23;549;158;49308;16924;25.9;8.9
32;2021-04-24;1392;57;50700;16981;26.7;8.9
32;2021-04-25;0;11;50700;16992;26.7;8.9
32;2021-04-26;387;359;51087;17351;26.9;9.1
32;2021-04-27;2551;556;53638;17907;28.2;9.4
32;2021-04-28;972;354;54610;18261;28.7;9.6
32;2021-04-29;1008;883;55618;19144;29.3;10.1
32;2021-04-30;453;363;56071;19507;29.5;10.3
32;2021-05-01;2607;97;58678;19604;30.9;10.3
32;2021-05-02;0;0;58678;19604;30.9;10.3
32;2021-05-03;170;321;58848;19925;31.0;10.5
32;2021-05-04;785;2490;59633;22415;31.4;11.8
32;2021-05-05;2360;1099;61993;23514;32.6;12.4
32;2021-05-06;516;1656;62509;25170;32.9;13.2
32;2021-05-07;2286;538;64795;25708;34.1;13.5
32;2021-05-08;70;516;64865;26224;34.1;13.8
32;2021-05-09;21;179;64886;26403;34.1;13.9
32;2021-05-10;1994;549;66880;26952;35.2;14.2
32;2021-05-11;651;2276;67531;29228;35.5;15.4
32;2021-05-12;2313;1137;69844;30365;36.8;16.0
32;2021-05-13;280;1417;70124;31782;36.9;16.7
32;2021-05-14;2223;328;72347;32110;38.1;16.9
32;2021-05-15;134;712;72481;32822;38.1;17.3
32;2021-05-16;2;0;72483;32822;38.1;17.3
32;2021-05-17;353;169;72836;32991;38.3;17.4
32;2021-05-18;1642;298;74478;33289;39.2;17.5
32;2021-05-19;2474;272;76952;33561;40.5;17.7
32;2021-05-20;2885;470;79837;34031;42.0;17.9
32;2021-05-21;2532;499;82369;34530;43.3;18.2
32;2021-05-22;334;110;82703;34640;43.5;18.2
32;2021-05-23;2;13;82705;34653;43.5;18.2
32;2021-05-24;3;0;82708;34653;43.5;18.2
32;2021-05-25;1982;373;84690;35026;44.6;18.4
32;2021-05-26;2547;556;87237;35582;45.9;18.7
32;2021-05-27;2876;626;90113;36208;47.4;19.1
32;2021-05-28;2308;766;92421;36974;48.6;19.5
32;2021-05-29;372;313;92793;37287;48.8;19.6
32;2021-05-30;4;6;92797;37293;48.8;19.6
32;2021-05-31;1413;626;94210;37919;49.6;20.0
32;2021-06-01;567;2887;94777;40806;49.9;21.5
32;2021-06-02;1580;1351;96357;42157;50.7;22.2
32;2021-06-03;395;2084;96752;44241;50.9;23.3
32;2021-06-04;1836;831;98588;45072;51.9;23.7
32;2021-06-05;206;1660;98794;46732;52.0;24.6
32;2021-06-06;8;14;98802;46746;52.0;24.6
32;2021-06-07;102;418;98904;47164;52.0;24.8
32;2021-06-08;663;2536;99567;49700;52.4;26.2
32;2021-06-09;1191;1056;100758;50756;53.0;26.7
32;2021-06-10;684;1225;101442;51981;53.4;27.4
32;2021-06-11;926;663;102368;52644;53.9;27.7
32;2021-06-12;150;2679;102518;55323;53.9;29.1
32;2021-06-13;1;1;102519;55324;53.9;29.1
32;2021-06-14;528;210;103047;55534;54.2;29.2
32;2021-06-15;1733;1025;104780;56559;55.1;29.8
32;2021-06-16;850;2777;105630;59336;55.6;31.2
32;2021-06-17;859;829;106489;60165;56.0;31.7
32;2021-06-18;315;2723;106804;62888;56.2;33.1
32;2021-06-19;914;437;107718;63325;56.7;33.3
32;2021-06-20;5;13;107723;63338;56.7;33.3
32;2021-06-21;67;1994;107790;65332;56.7;34.4
32;2021-06-22;1042;970;108832;66302;57.3;34.9
32;2021-06-23;517;2183;109349;68485;57.5;36.0
32;2021-06-24;528;517;109877;69002;57.8;36.3
32;2021-06-25;501;2360;110378;71362;58.1;37.6
32;2021-06-26;108;171;110486;71533;58.1;37.6
32;2021-06-27;2;5;110488;71538;58.1;37.6
32;2021-06-28;630;603;111118;72141;58.5;38.0
32;2021-06-29;800;1982;111918;74123;58.9;39.0
32;2021-06-30;757;2726;112675;76849;59.3;40.4
32;2021-07-01;538;2638;113213;79487;59.6;41.8
32;2021-07-02;641;2335;113854;81822;59.9;43.1
32;2021-07-03;481;506;114335;82328;60.2;43.3
32;2021-07-04;2;12;114337;82340;60.2;43.3
32;2021-07-05;76;390;114413;82730;60.2;43.5
32;2021-07-06;878;2083;115291;84813;60.7;44.6
32;2021-07-07;781;2756;116072;87569;61.1;46.1
32;2021-07-08;479;2268;116551;89837;61.3;47.3
32;2021-07-09;615;2226;117166;92063;61.7;48.4
32;2021-07-10;536;520;117702;92583;61.9;48.7
32;2021-07-11;0;5;117702;92588;61.9;48.7
32;2021-07-12;526;1244;118228;93832;62.2;49.4
32;2021-07-13;1695;1817;119923;95649;63.1;50.3
32;2021-07-14;492;35;120415;95684;63.4;50.3
32;2021-07-15;2096;892;122511;96576;64.5;50.8
32;2021-07-16;1170;1914;123681;98490;65.1;51.8
32;2021-07-17;78;129;123759;98619;65.1;51.9
32;2021-07-18;2;5;123761;98624;65.1;51.9
32;2021-07-19;1997;147;125758;98771;66.2;52.0
32;2021-07-20;2036;1272;127794;100043;67.2;52.6
32;2021-07-21;1614;1692;129408;101735;68.1;53.5
32;2021-07-22;1946;513;131354;102248;69.1;53.8
32;2021-07-23;1408;1731;132762;103979;69.9;54.7
32;2021-07-24;139;117;132901;104096;69.9;54.8
32;2021-07-25;34;10;132935;104106;70.0;54.8
32;2021-07-26;1071;1070;134006;105176;70.5;55.3
32;2021-07-27;1730;2099;135736;107275;71.4;56.4
32;2021-07-28;694;975;136430;108250;71.8;57.0
32;2021-07-29;1694;1607;138124;109857;72.7;57.8
32;2021-07-30;363;348;138487;110205;72.9;58.0
32;2021-07-31;186;350;138673;110555;73.0;58.2
32;2021-08-01;18;4;138691;110559;73.0;58.2
32;2021-08-02;82;76;138773;110635;73.0;58.2
32;2021-08-03;1174;1792;139947;112427;73.6;59.2
32;2021-08-04;633;652;140580;113079;74.0;59.5
32;2021-08-05;1105;1943;141685;115022;74.6;60.5
32;2021-08-06;563;495;142248;115517;74.9;60.8
32;2021-08-07;148;92;142396;115609;74.9;60.8
32;2021-08-08;1;0;142397;115609;74.9;60.8
32;2021-08-09;263;1826;142660;117435;75.1;61.8
32;2021-08-10;715;2077;143375;119512;75.4;62.9
32;2021-08-11;579;446;143954;119958;75.7;63.1
32;2021-08-12;931;2102;144885;122060;76.2;64.2
32;2021-08-13;178;249;145063;122309;76.3;64.4
32;2021-08-14;113;117;145176;122426;76.4;64.4
32;2021-08-15;13;21;145189;122447;76.4;64.4
32;2021-08-16;41;40;145230;122487;76.4;64.5
32;2021-08-17;573;2301;145803;124788;76.7;65.7
32;2021-08-18;310;559;146113;125347;76.9;66.0
32;2021-08-19;954;1410;147067;126757;77.4;66.7
32;2021-08-20;158;166;147225;126923;77.5;66.8
32;2021-08-21;150;192;147375;127115;77.5;66.9
32;2021-08-22;8;3;147383;127118;77.6;66.9
32;2021-08-23;42;101;147425;127219;77.6;66.9
32;2021-08-24;585;1449;148010;128668;77.9;67.7
32;2021-08-25;94;191;148104;128859;77.9;67.8
32;2021-08-26;320;2260;148424;131119;78.1;69.0
32;2021-08-27;274;553;148698;131672;78.2;69.3
32;2021-08-28;70;109;148768;131781;78.3;69.3
32;2021-08-29;1;8;148769;131789;78.3;69.3
32;2021-08-30;19;50;148788;131839;78.3;69.4
32;2021-08-31;194;1536;148982;133375;78.4;70.2
32;2021-09-01;649;829;149631;134204;78.7;70.6
32;2021-09-02;318;1734;149949;135938;78.9;71.5
32;2021-09-03;188;314;150137;136252;79.0;71.7
32;2021-09-04;49;106;150186;136358;79.0;71.8
32;2021-09-05;12;15;150198;136373;79.0;71.8
32;2021-09-06;38;103;150236;136476;79.1;71.8
32;2021-09-07;438;949;150674;137425;79.3;72.3
32;2021-09-08;255;552;150929;137977;79.4;72.6
32;2021-09-09;226;1063;151155;139040;79.5;73.2
32;2021-09-10;203;241;151358;139281;79.6;73.3
32;2021-09-11;88;160;151446;139441;79.7;73.4
32;2021-09-12;7;11;151453;139452;79.7;73.4
32;2021-09-13;4;12;151457;139464;79.7;73.4
32;2021-09-14;321;846;151778;140310;79.9;73.8
32;2021-09-15;200;145;151978;140455;80.0;73.9
32;2021-09-16;181;215;152159;140670;80.1;74.0
32;2021-09-17;199;345;152358;141015;80.2;74.2
32;2021-09-18;40;62;152398;141077;80.2;74.2
32;2021-09-19;0;2;152398;141079;80.2;74.2
32;2021-09-20;4;18;152402;141097;80.2;74.2
32;2021-09-21;241;458;152643;141555;80.3;74.5
32;2021-09-22;233;547;152876;142102;80.4;74.8
32;2021-09-23;132;219;153008;142321;80.5;74.9
32;2021-09-24;101;288;153109;142609;80.6;75.0
32;2021-09-25;28;51;153137;142660;80.6;75.1
32;2021-09-26;3;5;153140;142665;80.6;75.1
32;2021-09-27;9;29;153149;142694;80.6;75.1
32;2021-09-28;112;515;153261;143209;80.6;75.4
32;2021-09-29;88;334;153349;143543;80.7;75.5
32;2021-09-30;170;201;153519;143744;80.8;75.6
32;2021-10-01;100;242;153619;143986;80.8;75.8
32;2021-10-02;27;102;153646;144088;80.8;75.8
32;2021-10-03;0;8;153646;144096;80.8;75.8
32;2021-10-04;7;13;153653;144109;80.9;75.8
32;2021-10-05;59;287;153712;144396;80.9;76.0
32;2021-10-06;41;259;153753;144655;80.9;76.1
33;2020-12-27;4;0;4;0;0.0;0.0
33;2020-12-28;4;0;8;0;0.0;0.0
33;2020-12-29;0;0;8;0;0.0;0.0
33;2020-12-30;0;0;8;0;0.0;0.0
33;2020-12-31;1;0;9;0;0.0;0.0
33;2021-01-01;0;0;9;0;0.0;0.0
33;2021-01-02;2;0;11;0;0.0;0.0
33;2021-01-03;2;0;13;0;0.0;0.0
33;2021-01-04;2;0;15;0;0.0;0.0
33;2021-01-05;2;0;17;0;0.0;0.0
33;2021-01-06;135;0;152;0;0.0;0.0
33;2021-01-07;1309;1;1461;1;0.1;0.0
33;2021-01-08;1200;2;2661;3;0.2;0.0
33;2021-01-09;298;0;2959;3;0.2;0.0
33;2021-01-10;229;0;3188;3;0.2;0.0
33;2021-01-11;628;0;3816;3;0.2;0.0
33;2021-01-12;1415;2;5231;5;0.3;0.0
33;2021-01-13;1313;9;6544;14;0.4;0.0
33;2021-01-14;1293;12;7837;26;0.5;0.0
33;2021-01-15;1610;11;9447;37;0.6;0.0
33;2021-01-16;568;6;10015;43;0.6;0.0
33;2021-01-17;406;2;10421;45;0.6;0.0
33;2021-01-18;1225;9;11646;54;0.7;0.0
33;2021-01-19;2936;8;14582;62;0.9;0.0
33;2021-01-20;3423;13;18005;75;1.1;0.0
33;2021-01-21;2864;3;20869;78;1.3;0.0
33;2021-01-22;2328;7;23197;85;1.4;0.0
33;2021-01-23;853;2;24050;87;1.5;0.0
33;2021-01-24;532;2;24582;89;1.5;0.0
33;2021-01-25;2173;55;26755;144;1.6;0.0
33;2021-01-26;2263;145;29018;289;1.8;0.0
33;2021-01-27;2263;188;31281;477;1.9;0.0
33;2021-01-28;2160;409;33441;886;2.0;0.1
33;2021-01-29;1825;633;35266;1519;2.2;0.1
33;2021-01-30;705;155;35971;1674;2.2;0.1
33;2021-01-31;390;133;36361;1807;2.2;0.1
33;2021-02-01;1457;603;37818;2410;2.3;0.1
33;2021-02-02;2646;1033;40464;3443;2.5;0.2
33;2021-02-03;2942;829;43406;4272;2.7;0.3
33;2021-02-04;4031;1276;47437;5548;2.9;0.3
33;2021-02-05;2193;1095;49630;6643;3.0;0.4
33;2021-02-06;648;172;50278;6815;3.1;0.4
33;2021-02-07;219;182;50497;6997;3.1;0.4
33;2021-02-08;1265;681;51762;7678;3.2;0.5
33;2021-02-09;1326;1431;53088;9109;3.3;0.6
33;2021-02-10;1266;1526;54354;10635;3.3;0.7
33;2021-02-11;1305;1296;55659;11931;3.4;0.7
33;2021-02-12;1121;1076;56780;13007;3.5;0.8
33;2021-02-13;204;241;56984;13248;3.5;0.8
33;2021-02-14;47;192;57031;13440;3.5;0.8
33;2021-02-15;685;1338;57716;14778;3.5;0.9
33;2021-02-16;816;1673;58532;16451;3.6;1.0
33;2021-02-17;668;1672;59200;18123;3.6;1.1
33;2021-02-18;899;1778;60099;19901;3.7;1.2
33;2021-02-19;918;1666;61017;21567;3.7;1.3
33;2021-02-20;78;458;61095;22025;3.7;1.3
33;2021-02-21;37;349;61132;22374;3.7;1.4
33;2021-02-22;709;1475;61841;23849;3.8;1.5
33;2021-02-23;1235;2147;63076;25996;3.9;1.6
33;2021-02-24;1405;2048;64481;28044;3.9;1.7
33;2021-02-25;2839;3206;67320;31250;4.1;1.9
33;2021-02-26;4059;1986;71379;33236;4.4;2.0
33;2021-02-27;1360;558;72739;33794;4.5;2.1
33;2021-02-28;127;424;72866;34218;4.5;2.1
33;2021-03-01;1537;1563;74403;35781;4.6;2.2
33;2021-03-02;2325;1494;76728;37275;4.7;2.3
33;2021-03-03;2312;1474;79040;38749;4.8;2.4
33;2021-03-04;3938;1461;82978;40210;5.1;2.5
33;2021-03-05;5762;1516;88740;41726;5.4;2.6
33;2021-03-06;3416;501;92156;42227;5.6;2.6
33;2021-03-07;741;139;92897;42366;5.7;2.6
33;2021-03-08;2712;992;95609;43358;5.9;2.7
33;2021-03-09;4404;1155;100013;44513;6.1;2.7
33;2021-03-10;5121;1126;105134;45639;6.4;2.8
33;2021-03-11;7545;1143;112679;46782;6.9;2.9
33;2021-03-12;10119;1098;122798;47880;7.5;2.9
33;2021-03-13;5155;205;127953;48085;7.8;2.9
33;2021-03-14;714;28;128667;48113;7.9;2.9
33;2021-03-15;4445;660;133112;48773;8.1;3.0
33;2021-03-16;3582;814;136694;49587;8.4;3.0
33;2021-03-17;3644;921;140338;50508;8.6;3.1
33;2021-03-18;4037;1389;144375;51897;8.8;3.2
33;2021-03-19;6270;1013;150645;52910;9.2;3.2
33;2021-03-20;3368;105;154013;53015;9.4;3.2
33;2021-03-21;462;29;154475;53044;9.5;3.2
33;2021-03-22;4901;442;159376;53486;9.8;3.3
33;2021-03-23;6324;601;165700;54087;10.1;3.3
33;2021-03-24;7077;526;172777;54613;10.6;3.3
33;2021-03-25;8843;646;181620;55259;11.1;3.4
33;2021-03-26;10038;845;191658;56104;11.7;3.4
33;2021-03-27;3619;83;195277;56187;12.0;3.4
33;2021-03-28;577;33;195854;56220;12.0;3.4
33;2021-03-29;6766;699;202620;56919;12.4;3.5
33;2021-03-30;8102;1033;210722;57952;12.9;3.5
33;2021-03-31;7577;1044;218299;58996;13.4;3.6
33;2021-04-01;8823;1191;227122;60187;13.9;3.7
33;2021-04-02;8412;1547;235534;61734;14.4;3.8
33;2021-04-03;2832;519;238366;62253;14.6;3.8
33;2021-04-04;218;160;238584;62413;14.6;3.8
33;2021-04-05;693;123;239277;62536;14.6;3.8
33;2021-04-06;6048;2679;245325;65215;15.0;4.0
33;2021-04-07;7422;2519;252747;67734;15.5;4.1
33;2021-04-08;10328;2772;263075;70506;16.1;4.3
33;2021-04-09;12687;3085;275762;73591;16.9;4.5
33;2021-04-10;5357;1391;281119;74982;17.2;4.6
33;2021-04-11;1002;351;282121;75333;17.3;4.6
33;2021-04-12;7425;3274;289546;78607;17.7;4.8
33;2021-04-13;9321;3476;298867;82083;18.3;5.0
33;2021-04-14;9038;3640;307905;85723;18.9;5.2
33;2021-04-15;10110;3875;318015;89598;19.5;5.5
33;2021-04-16;9718;4224;327733;93822;20.1;5.7
33;2021-04-17;4651;1657;332384;95479;20.3;5.8
33;2021-04-18;929;411;333313;95890;20.4;5.9
33;2021-04-19;5616;3833;338929;99723;20.7;6.1
33;2021-04-20;7294;4259;346223;103982;21.2;6.4
33;2021-04-21;6594;4341;352817;108323;21.6;6.6
33;2021-04-22;7349;4480;360166;112803;22.0;6.9
33;2021-04-23;7705;4819;367871;117622;22.5;7.2
33;2021-04-24;4500;1797;372371;119419;22.8;7.3
33;2021-04-25;1652;418;374023;119837;22.9;7.3
33;2021-04-26;5270;5075;379293;124912;23.2;7.6
33;2021-04-27;6579;5582;385872;130494;23.6;8.0
33;2021-04-28;6783;5555;392655;136049;24.0;8.3
33;2021-04-29;8425;6213;401080;142262;24.6;8.7
33;2021-04-30;8740;6091;409820;148353;25.1;9.1
33;2021-05-01;2902;513;412722;148866;25.3;9.1
33;2021-05-02;1835;346;414557;149212;25.4;9.1
33;2021-05-03;7018;5203;421575;154415;25.8;9.5
33;2021-05-04;6826;6651;428401;161066;26.2;9.9
33;2021-05-05;7140;7562;435541;168628;26.7;10.3
33;2021-05-06;8705;8219;444246;176847;27.2;10.8
33;2021-05-07;8610;8867;452856;185714;27.7;11.4
33;2021-05-08;3543;1586;456399;187300;27.9;11.5
33;2021-05-09;1118;969;457517;188269;28.0;11.5
33;2021-05-10;6874;7288;464391;195557;28.4;12.0
33;2021-05-11;8634;7852;473025;203409;29.0;12.5
33;2021-05-12;9175;6698;482200;210107;29.5;12.9
33;2021-05-13;5211;2109;487411;212216;29.8;13.0
33;2021-05-14;8128;5350;495539;217566;30.3;13.3
33;2021-05-15;5179;2865;500718;220431;30.7;13.5
33;2021-05-16;1842;804;502560;221235;30.8;13.5
33;2021-05-17;8861;5108;511421;226343;31.3;13.9
33;2021-05-18;10625;4872;522046;231215;32.0;14.2
33;2021-05-19;10900;4775;532946;235990;32.6;14.4
33;2021-05-20;10907;5581;543853;241571;33.3;14.8
33;2021-05-21;10915;6235;554768;247806;34.0;15.2
33;2021-05-22;5121;2749;559889;250555;34.3;15.3
33;2021-05-23;1751;385;561640;250940;34.4;15.4
33;2021-05-24;5412;1001;567052;251941;34.7;15.4
33;2021-05-25;9391;5763;576443;257704;35.3;15.8
33;2021-05-26;9676;6032;586119;263736;35.9;16.1
33;2021-05-27;10901;7705;597020;271441;36.5;16.6
33;2021-05-28;10062;9479;607082;280920;37.2;17.2
33;2021-05-29;5042;4115;612124;285035;37.5;17.4
33;2021-05-30;1703;667;613827;285702;37.6;17.5
33;2021-05-31;8551;6404;622378;292106;38.1;17.9
33;2021-06-01;11803;8693;634181;300799;38.8;18.4
33;2021-06-02;11710;8195;645891;308994;39.5;18.9
33;2021-06-03;12715;9185;658606;318179;40.3;19.5
33;2021-06-04;12933;10931;671539;329110;41.1;20.1
33;2021-06-05;5272;5053;676811;334163;41.4;20.5
33;2021-06-06;2525;1193;679336;335356;41.6;20.5
33;2021-06-07;9759;8495;689095;343851;42.2;21.1
33;2021-06-08;11938;9442;701033;353293;42.9;21.6
33;2021-06-09;11775;8515;712808;361808;43.6;22.2
33;2021-06-10;12950;8382;725758;370190;44.4;22.7
33;2021-06-11;12516;11150;738274;381340;45.2;23.3
33;2021-06-12;6185;4477;744459;385817;45.6;23.6
33;2021-06-13;2613;1283;747072;387100;45.7;23.7
33;2021-06-14;8580;10151;755652;397251;46.3;24.3
33;2021-06-15;12053;10253;767705;407504;47.0;24.9
33;2021-06-16;12058;8864;779763;416368;47.7;25.5
33;2021-06-17;13116;9605;792879;425973;48.5;26.1
33;2021-06-18;11797;11430;804676;437403;49.3;26.8
33;2021-06-19;5610;4819;810286;442222;49.6;27.1
33;2021-06-20;2946;1475;813232;443697;49.8;27.2
33;2021-06-21;7875;10164;821107;453861;50.3;27.8
33;2021-06-22;9065;11074;830172;464935;50.8;28.5
33;2021-06-23;8671;10840;838843;475775;51.4;29.1
33;2021-06-24;9743;9979;848586;485754;52.0;29.7
33;2021-06-25;8047;13709;856633;499463;52.4;30.6
33;2021-06-26;4345;5917;860978;505380;52.7;30.9
33;2021-06-27;2467;1959;863445;507339;52.9;31.1
33;2021-06-28;4871;12754;868316;520093;53.2;31.8
33;2021-06-29;6443;13653;874759;533746;53.6;32.7
33;2021-06-30;6681;13387;881440;547133;54.0;33.5
33;2021-07-01;8046;11807;889486;558940;54.5;34.2
33;2021-07-02;6844;15106;896330;574046;54.9;35.1
33;2021-07-03;3227;6783;899557;580829;55.1;35.6
33;2021-07-04;2065;2379;901622;583208;55.2;35.7
33;2021-07-05;4398;12903;906020;596111;55.5;36.5
33;2021-07-06;6147;14588;912167;610699;55.8;37.4
33;2021-07-07;6895;13041;919062;623740;56.3;38.2
33;2021-07-08;7972;12757;927034;636497;56.8;39.0
33;2021-07-09;6471;15110;933505;651607;57.1;39.9
33;2021-07-10;3114;7159;936619;658766;57.3;40.3
33;2021-07-11;1844;2303;938463;661069;57.5;40.5
33;2021-07-12;3951;14702;942414;675771;57.7;41.4
33;2021-07-13;7153;16099;949567;691870;58.1;42.4
33;2021-07-14;3689;5315;953256;697185;58.4;42.7
33;2021-07-15;7627;15979;960883;713164;58.8;43.7
33;2021-07-16;8588;15138;969471;728302;59.4;44.6
33;2021-07-17;3156;6430;972627;734732;59.5;45.0
33;2021-07-18;1702;3205;974329;737937;59.6;45.2
33;2021-07-19;5871;15088;980200;753025;60.0;46.1
33;2021-07-20;7432;16118;987632;769143;60.5;47.1
33;2021-07-21;8370;14532;996002;783675;61.0;48.0
33;2021-07-22;9365;15097;1005367;798772;61.5;48.9
33;2021-07-23;9666;16347;1015033;815119;62.1;49.9
33;2021-07-24;3836;7550;1018869;822669;62.4;50.4
33;2021-07-25;2093;2667;1020962;825336;62.5;50.5
33;2021-07-26;6966;13413;1027928;838749;62.9;51.3
33;2021-07-27;10090;13392;1038018;852141;63.5;52.2
33;2021-07-28;10929;11966;1048947;864107;64.2;52.9
33;2021-07-29;11673;11904;1060620;876011;64.9;53.6
33;2021-07-30;11400;12206;1072020;888217;65.6;54.4
33;2021-07-31;4761;5647;1076781;893864;65.9;54.7
33;2021-08-01;2484;1951;1079265;895815;66.1;54.8
33;2021-08-02;8418;9891;1087683;905706;66.6;55.4
33;2021-08-03;11560;9023;1099243;914729;67.3;56.0
33;2021-08-04;12284;7366;1111527;922095;68.0;56.5
33;2021-08-05;11934;8044;1123461;930139;68.8;56.9
33;2021-08-06;11230;9056;1134691;939195;69.5;57.5
33;2021-08-07;5929;4517;1140620;943712;69.8;57.8
33;2021-08-08;3201;1820;1143821;945532;70.0;57.9
33;2021-08-09;8662;8721;1152483;954253;70.6;58.4
33;2021-08-10;9373;8452;1161856;962705;71.1;58.9
33;2021-08-11;8114;7587;1169970;970292;71.6;59.4
33;2021-08-12;7980;8020;1177950;978312;72.1;59.9
33;2021-08-13;7846;7680;1185796;985992;72.6;60.4
33;2021-08-14;3526;4332;1189322;990324;72.8;60.6
33;2021-08-15;1211;1881;1190533;992205;72.9;60.7
33;2021-08-16;6428;8628;1196961;1000833;73.3;61.3
33;2021-08-17;6637;9069;1203598;1009902;73.7;61.8
33;2021-08-18;5630;8771;1209228;1018673;74.0;62.4
33;2021-08-19;5505;9120;1214733;1027793;74.4;62.9
33;2021-08-20;4961;9836;1219694;1037629;74.7;63.5
33;2021-08-21;2208;5037;1221902;1042666;74.8;63.8
33;2021-08-22;565;2366;1222467;1045032;74.8;64.0
33;2021-08-23;3922;10289;1226389;1055321;75.1;64.6
33;2021-08-24;4141;11094;1230530;1066415;75.3;65.3
33;2021-08-25;3721;10489;1234251;1076904;75.6;65.9
33;2021-08-26;3660;11057;1237911;1087961;75.8;66.6
33;2021-08-27;3826;12587;1241737;1100548;76.0;67.4
33;2021-08-28;1580;6639;1243317;1107187;76.1;67.8
33;2021-08-29;454;2426;1243771;1109613;76.1;67.9
33;2021-08-30;2358;10537;1246129;1120150;76.3;68.6
33;2021-08-31;3250;11072;1249379;1131222;76.5;69.3
33;2021-09-01;2838;8819;1252217;1140041;76.7;69.8
33;2021-09-02;2704;8397;1254921;1148438;76.8;70.3
33;2021-09-03;3115;10139;1258036;1158577;77.0;70.9
33;2021-09-04;1654;6085;1259690;1164662;77.1;71.3
33;2021-09-05;413;1517;1260103;1166179;77.1;71.4
33;2021-09-06;1598;7182;1261701;1173361;77.2;71.8
33;2021-09-07;2070;6583;1263771;1179944;77.4;72.2
33;2021-09-08;1760;6598;1265531;1186542;77.5;72.6
33;2021-09-09;1893;6743;1267424;1193285;77.6;73.1
33;2021-09-10;2094;7285;1269518;1200570;77.7;73.5
33;2021-09-11;997;4495;1270515;1205065;77.8;73.8
33;2021-09-12;131;611;1270646;1205676;77.8;73.8
33;2021-09-13;1467;4786;1272113;1210462;77.9;74.1
33;2021-09-14;1565;5146;1273678;1215608;78.0;74.4
33;2021-09-15;1539;4443;1275217;1220051;78.1;74.7
33;2021-09-16;1471;3347;1276688;1223398;78.2;74.9
33;2021-09-17;1791;4516;1278479;1227914;78.3;75.2
33;2021-09-18;605;3050;1279084;1230964;78.3;75.4
33;2021-09-19;115;398;1279199;1231362;78.3;75.4
33;2021-09-20;1047;2159;1280246;1233521;78.4;75.5
33;2021-09-21;956;2450;1281202;1235971;78.4;75.7
33;2021-09-22;959;3445;1282161;1239416;78.5;75.9
33;2021-09-23;902;2305;1283063;1241721;78.5;76.0
33;2021-09-24;1289;3720;1284352;1245441;78.6;76.2
33;2021-09-25;515;2354;1284867;1247795;78.7;76.4
33;2021-09-26;64;333;1284931;1248128;78.7;76.4
33;2021-09-27;666;2013;1285597;1250141;78.7;76.5
33;2021-09-28;826;2149;1286423;1252290;78.8;76.7
33;2021-09-29;888;2212;1287311;1254502;78.8;76.8
33;2021-09-30;688;1683;1287999;1256185;78.9;76.9
33;2021-10-01;1057;2683;1289056;1258868;78.9;77.1
33;2021-10-02;557;1350;1289613;1260218;79.0;77.2
33;2021-10-03;10;45;1289623;1260263;79.0;77.2
33;2021-10-04;644;1399;1290267;1261662;79.0;77.2
33;2021-10-05;544;1422;1290811;1263084;79.0;77.3
33;2021-10-06;782;1684;1291593;1264768;79.1;77.4
34;2020-12-27;1;0;1;0;0.0;0.0
34;2020-12-28;3;0;4;0;0.0;0.0
34;2020-12-29;0;0;4;0;0.0;0.0
34;2020-12-30;0;0;4;0;0.0;0.0
34;2020-12-31;0;0;4;0;0.0;0.0
34;2021-01-01;1;0;5;0;0.0;0.0
34;2021-01-02;2;0;7;0;0.0;0.0
34;2021-01-03;0;0;7;0;0.0;0.0
34;2021-01-04;23;0;30;0;0.0;0.0
34;2021-01-05;108;2;138;2;0.0;0.0
34;2021-01-06;199;1;337;3;0.0;0.0
34;2021-01-07;364;0;701;3;0.1;0.0
34;2021-01-08;606;0;1307;3;0.1;0.0
34;2021-01-09;244;0;1551;3;0.1;0.0
34;2021-01-10;94;1;1645;4;0.1;0.0
34;2021-01-11;567;2;2212;6;0.2;0.0
34;2021-01-12;1009;1;3221;7;0.3;0.0
34;2021-01-13;1098;6;4319;13;0.4;0.0
34;2021-01-14;1954;12;6273;25;0.5;0.0
34;2021-01-15;1471;4;7744;29;0.7;0.0
34;2021-01-16;332;7;8076;36;0.7;0.0
34;2021-01-17;235;1;8311;37;0.7;0.0
34;2021-01-18;1125;3;9436;40;0.8;0.0
34;2021-01-19;1610;8;11046;48;0.9;0.0
34;2021-01-20;2090;8;13136;56;1.1;0.0
34;2021-01-21;4234;11;17370;67;1.5;0.0
34;2021-01-22;2556;8;19926;75;1.7;0.0
34;2021-01-23;600;2;20526;77;1.7;0.0
34;2021-01-24;3;0;20529;77;1.7;0.0
34;2021-01-25;1242;5;21771;82;1.9;0.0
34;2021-01-26;1461;17;23232;99;2.0;0.0
34;2021-01-27;1471;23;24703;122;2.1;0.0
34;2021-01-28;1393;120;26096;242;2.2;0.0
34;2021-01-29;1260;124;27356;366;2.3;0.0
34;2021-01-30;479;12;27835;378;2.4;0.0
34;2021-01-31;4;0;27839;378;2.4;0.0
34;2021-02-01;1028;220;28867;598;2.5;0.1
34;2021-02-02;1464;400;30331;998;2.6;0.1
34;2021-02-03;2654;484;32985;1482;2.8;0.1
34;2021-02-04;2318;835;35303;2317;3.0;0.2
34;2021-02-05;1891;1070;37194;3387;3.2;0.3
34;2021-02-06;497;209;37691;3596;3.2;0.3
34;2021-02-07;34;95;37725;3691;3.2;0.3
34;2021-02-08;860;955;38585;4646;3.3;0.4
34;2021-02-09;1035;1185;39620;5831;3.4;0.5
34;2021-02-10;1296;1338;40916;7169;3.5;0.6
34;2021-02-11;1794;2423;42710;9592;3.6;0.8
34;2021-02-12;1922;1459;44632;11051;3.8;0.9
34;2021-02-13;357;435;44989;11486;3.8;1.0
34;2021-02-14;22;271;45011;11757;3.8;1.0
34;2021-02-15;673;846;45684;12603;3.9;1.1
34;2021-02-16;666;1131;46350;13734;3.9;1.2
34;2021-02-17;714;1164;47064;14898;4.0;1.3
34;2021-02-18;837;1114;47901;16012;4.1;1.4
34;2021-02-19;816;902;48717;16914;4.1;1.4
34;2021-02-20;300;336;49017;17250;4.2;1.5
34;2021-02-21;64;18;49081;17268;4.2;1.5
34;2021-02-22;630;979;49711;18247;4.2;1.6
34;2021-02-23;565;1107;50276;19354;4.3;1.6
34;2021-02-24;943;1926;51219;21280;4.4;1.8
34;2021-02-25;1608;1885;52827;23165;4.5;2.0
34;2021-02-26;1850;1332;54677;24497;4.6;2.1
34;2021-02-27;702;316;55379;24813;4.7;2.1
34;2021-02-28;86;61;55465;24874;4.7;2.1
34;2021-03-01;932;938;56397;25812;4.8;2.2
34;2021-03-02;1592;1047;57989;26859;4.9;2.3
34;2021-03-03;1834;1129;59823;27988;5.1;2.4
34;2021-03-04;2867;1386;62690;29374;5.3;2.5
34;2021-03-05;3686;1359;66376;30733;5.6;2.6
34;2021-03-06;2640;175;69016;30908;5.9;2.6
34;2021-03-07;1242;56;70258;30964;6.0;2.6
34;2021-03-08;2781;840;73039;31804;6.2;2.7
34;2021-03-09;4020;1248;77059;33052;6.6;2.8
34;2021-03-10;3991;1182;81050;34234;6.9;2.9
34;2021-03-11;5436;1191;86486;35425;7.4;3.0
34;2021-03-12;6492;853;92978;36278;7.9;3.1
34;2021-03-13;3138;164;96116;36442;8.2;3.1
34;2021-03-14;1003;54;97119;36496;8.3;3.1
34;2021-03-15;3307;551;100426;37047;8.5;3.1
34;2021-03-16;2912;639;103338;37686;8.8;3.2
34;2021-03-17;3305;735;106643;38421;9.1;3.3
34;2021-03-18;3450;906;110093;39327;9.4;3.3
34;2021-03-19;4692;786;114785;40113;9.8;3.4
34;2021-03-20;3148;65;117933;40178;10.0;3.4
34;2021-03-21;1997;60;119930;40238;10.2;3.4
34;2021-03-22;3683;460;123613;40698;10.5;3.5
34;2021-03-23;4961;534;128574;41232;10.9;3.5
34;2021-03-24;5221;627;133795;41859;11.4;3.6
34;2021-03-25;7197;715;140992;42574;12.0;3.6
34;2021-03-26;7169;573;148161;43147;12.6;3.7
34;2021-03-27;2373;85;150534;43232;12.8;3.7
34;2021-03-28;700;21;151234;43253;12.9;3.7
34;2021-03-29;4187;752;155421;44005;13.2;3.7
34;2021-03-30;5221;961;160642;44966;13.7;3.8
34;2021-03-31;5069;1203;165711;46169;14.1;3.9
34;2021-04-01;7030;1036;172741;47205;14.7;4.0
34;2021-04-02;5822;1191;178563;48396;15.2;4.1
34;2021-04-03;1137;85;179700;48481;15.3;4.1
34;2021-04-04;166;5;179866;48486;15.3;4.1
34;2021-04-05;433;26;180299;48512;15.3;4.1
34;2021-04-06;3136;2440;183435;50952;15.6;4.3
34;2021-04-07;3387;2631;186822;53583;15.9;4.6
34;2021-04-08;5251;2802;192073;56385;16.3;4.8
34;2021-04-09;8074;2493;200147;58878;17.0;5.0
34;2021-04-10;3164;1373;203311;60251;17.3;5.1
34;2021-04-11;1715;805;205026;61056;17.4;5.2
34;2021-04-12;4500;2518;209526;63574;17.8;5.4
34;2021-04-13;5240;3050;214766;66624;18.3;5.7
34;2021-04-14;5621;3238;220387;69862;18.7;5.9
34;2021-04-15;6996;3166;227383;73028;19.3;6.2
34;2021-04-16;6580;3158;233963;76186;19.9;6.5
34;2021-04-17;2378;2068;236341;78254;20.1;6.7
34;2021-04-18;988;1717;237329;79971;20.2;6.8
34;2021-04-19;3421;3120;240750;83091;20.5;7.1
34;2021-04-20;3767;3656;244517;86747;20.8;7.4
34;2021-04-21;4241;3717;248758;90464;21.2;7.7
34;2021-04-22;4490;4595;253248;95059;21.5;8.1
34;2021-04-23;5378;3515;258626;98574;22.0;8.4
34;2021-04-24;3164;1579;261790;100153;22.3;8.5
34;2021-04-25;1919;644;263709;100797;22.4;8.6
34;2021-04-26;4223;3469;267932;104266;22.8;8.9
34;2021-04-27;5128;4005;273060;108271;23.2;9.2
34;2021-04-28;5771;3538;278831;111809;23.7;9.5
34;2021-04-29;6421;3926;285252;115735;24.3;9.8
34;2021-04-30;7870;3257;293122;118992;24.9;10.1
34;2021-05-01;2405;499;295527;119491;25.1;10.2
34;2021-05-02;3260;322;298787;119813;25.4;10.2
34;2021-05-03;6577;2904;305364;122717;26.0;10.4
34;2021-05-04;7109;3792;312473;126509;26.6;10.8
34;2021-05-05;6498;4528;318971;131037;27.1;11.1
34;2021-05-06;6945;5191;325916;136228;27.7;11.6
34;2021-05-07;6928;5657;332844;141885;28.3;12.1
34;2021-05-08;3609;1172;336453;143057;28.6;12.2
34;2021-05-09;2178;1288;338631;144345;28.8;12.3
34;2021-05-10;5853;4798;344484;149143;29.3;12.7
34;2021-05-11;7411;5307;351895;154450;29.9;13.1
34;2021-05-12;7756;4454;359651;158904;30.6;13.5
34;2021-05-13;6128;785;365779;159689;31.1;13.6
34;2021-05-14;7491;3734;373270;163423;31.7;13.9
34;2021-05-15;4863;1686;378133;165109;32.2;14.0
34;2021-05-16;4949;460;383082;165569;32.6;14.1
34;2021-05-17;8693;1983;391775;167552;33.3;14.2
34;2021-05-18;9143;1973;400918;169525;34.1;14.4
34;2021-05-19;8625;1811;409543;171336;34.8;14.6
34;2021-05-20;8866;2518;418409;173854;35.6;14.8
34;2021-05-21;8784;3204;427193;177058;36.3;15.1
34;2021-05-22;5787;1153;432980;178211;36.8;15.2
34;2021-05-23;3883;549;436863;178760;37.1;15.2
34;2021-05-24;1898;852;438761;179612;37.3;15.3
34;2021-05-25;7142;3811;445903;183423;37.9;15.6
34;2021-05-26;8319;3033;454222;186456;38.6;15.9
34;2021-05-27;8316;4307;462538;190763;39.3;16.2
34;2021-05-28;8063;5439;470601;196202;40.0;16.7
34;2021-05-29;4006;3101;474607;199303;40.4;16.9
34;2021-05-30;1985;1389;476592;200692;40.5;17.1
34;2021-05-31;5878;5247;482470;205939;41.0;17.5
34;2021-06-01;6948;6091;489418;212030;41.6;18.0
34;2021-06-02;6136;5810;495554;217840;42.1;18.5
34;2021-06-03;7705;6478;503259;224318;42.8;19.1
34;2021-06-04;7651;7582;510910;231900;43.4;19.7
34;2021-06-05;4140;3679;515050;235579;43.8;20.0
34;2021-06-06;3266;1865;518316;237444;44.1;20.2
34;2021-06-07;4414;6759;522730;244203;44.4;20.8
34;2021-06-08;5854;6826;528584;251029;44.9;21.3
34;2021-06-09;5826;6840;534410;257869;45.4;21.9
34;2021-06-10;6322;6865;540732;264734;46.0;22.5
34;2021-06-11;5400;9275;546132;274009;46.4;23.3
34;2021-06-12;3166;4726;549298;278735;46.7;23.7
34;2021-06-13;1081;1905;550379;280640;46.8;23.9
34;2021-06-14;3443;7810;553822;288450;47.1;24.5
34;2021-06-15;3951;8789;557773;297239;47.4;25.3
34;2021-06-16;4619;7856;562392;305095;47.8;25.9
34;2021-06-17;4228;7951;566620;313046;48.2;26.6
34;2021-06-18;4350;9327;570970;322373;48.5;27.4
34;2021-06-19;2729;4403;573699;326776;48.8;27.8
34;2021-06-20;888;2873;574587;329649;48.9;28.0
34;2021-06-21;2180;8553;576767;338202;49.0;28.8
34;2021-06-22;2974;9405;579741;347607;49.3;29.6
34;2021-06-23;3528;8963;583269;356570;49.6;30.3
34;2021-06-24;3559;8671;586828;365241;49.9;31.1
34;2021-06-25;3374;10440;590202;375681;50.2;31.9
34;2021-06-26;1641;6190;591843;381871;50.3;32.5
34;2021-06-27;308;4268;592151;386139;50.3;32.8
34;2021-06-28;2265;9426;594416;395565;50.5;33.6
34;2021-06-29;2682;10295;597098;405860;50.8;34.5
34;2021-06-30;3356;9542;600454;415402;51.1;35.3
34;2021-07-01;3531;9446;603985;424848;51.4;36.1
34;2021-07-02;3434;9740;607419;434588;51.6;37.0
34;2021-07-03;1682;6158;609101;440746;51.8;37.5
34;2021-07-04;312;2763;609413;443509;51.8;37.7
34;2021-07-05;3234;7997;612647;451506;52.1;38.4
34;2021-07-06;3532;9175;616179;460681;52.4;39.2
34;2021-07-07;3273;8652;619452;469333;52.7;39.9
34;2021-07-08;4303;8869;623755;478202;53.0;40.7
34;2021-07-09;4010;9348;627765;487550;53.4;41.5
34;2021-07-10;2140;5717;629905;493267;53.6;41.9
34;2021-07-11;923;2576;630828;495843;53.6;42.2
34;2021-07-12;2929;8967;633757;504810;53.9;42.9
34;2021-07-13;4657;10041;638414;514851;54.3;43.8
34;2021-07-14;784;356;639198;515207;54.3;43.8
34;2021-07-15;5910;10396;645108;525603;54.8;44.7
34;2021-07-16;5861;10726;650969;536329;55.3;45.6
34;2021-07-17;4499;4415;655468;540744;55.7;46.0
34;2021-07-18;235;195;655703;540939;55.8;46.0
34;2021-07-19;5117;8329;660820;549268;56.2;46.7
34;2021-07-20;6896;8386;667716;557654;56.8;47.4
34;2021-07-21;7650;7828;675366;565482;57.4;48.1
34;2021-07-22;7442;8177;682808;573659;58.1;48.8
34;2021-07-23;7843;8160;690651;581819;58.7;49.5
34;2021-07-24;6150;3058;696801;584877;59.2;49.7
34;2021-07-25;3210;548;700011;585425;59.5;49.8
34;2021-07-26;6238;6429;706249;591854;60.0;50.3
34;2021-07-27;8755;6056;715004;597910;60.8;50.8
34;2021-07-28;9711;5923;724715;603833;61.6;51.3
34;2021-07-29;11326;6053;736041;609886;62.6;51.9
34;2021-07-30;9848;6540;745889;616426;63.4;52.4
34;2021-07-31;6445;2197;752334;618623;64.0;52.6
34;2021-08-01;3316;620;755650;619243;64.2;52.7
34;2021-08-02;7360;5069;763010;624312;64.9;53.1
34;2021-08-03;8143;5400;771153;629712;65.6;53.5
34;2021-08-04;8445;4568;779598;634280;66.3;53.9
34;2021-08-05;7136;5031;786734;639311;66.9;54.4
34;2021-08-06;6197;5231;792931;644542;67.4;54.8
34;2021-08-07;3110;2438;796041;646980;67.7;55.0
34;2021-08-08;202;204;796243;647184;67.7;55.0
34;2021-08-09;4781;6180;801024;653364;68.1;55.6
34;2021-08-10;5398;6485;806422;659849;68.6;56.1
34;2021-08-11;4831;6544;811253;666393;69.0;56.7
34;2021-08-12;4576;6201;815829;672594;69.4;57.2
34;2021-08-13;4109;5738;819938;678332;69.7;57.7
34;2021-08-14;1797;2881;821735;681213;69.9;57.9
34;2021-08-15;209;194;821944;681407;69.9;57.9
34;2021-08-16;2904;7549;824848;688956;70.1;58.6
34;2021-08-17;3594;8282;828442;697238;70.4;59.3
34;2021-08-18;3207;7564;831649;704802;70.7;59.9
34;2021-08-19;3268;7785;834917;712587;71.0;60.6
34;2021-08-20;2725;7721;837642;720308;71.2;61.2
34;2021-08-21;1399;3563;839041;723871;71.3;61.5
34;2021-08-22;163;308;839204;724179;71.4;61.6
34;2021-08-23;2330;8655;841534;732834;71.6;62.3
34;2021-08-24;2729;8962;844263;741796;71.8;63.1
34;2021-08-25;2346;8543;846609;750339;72.0;63.8
34;2021-08-26;2607;7888;849216;758227;72.2;64.5
34;2021-08-27;2197;7572;851413;765799;72.4;65.1
34;2021-08-28;1117;3561;852530;769360;72.5;65.4
34;2021-08-29;368;1357;852898;770717;72.5;65.5
34;2021-08-30;2054;6885;854952;777602;72.7;66.1
34;2021-08-31;2122;6841;857074;784443;72.9;66.7
34;2021-09-01;2053;6428;859127;790871;73.0;67.2
34;2021-09-02;1666;4829;860793;795700;73.2;67.7
34;2021-09-03;1774;5561;862567;801261;73.3;68.1
34;2021-09-04;1361;3378;863928;804639;73.5;68.4
34;2021-09-05;141;241;864069;804880;73.5;68.4
34;2021-09-06;1153;4057;865222;808937;73.6;68.8
34;2021-09-07;1353;4125;866575;813062;73.7;69.1
34;2021-09-08;1629;4777;868204;817839;73.8;69.5
34;2021-09-09;1185;3858;869389;821697;73.9;69.9
34;2021-09-10;1522;4094;870911;825791;74.0;70.2
34;2021-09-11;1280;2073;872191;827864;74.2;70.4
34;2021-09-12;90;88;872281;827952;74.2;70.4
34;2021-09-13;1000;3310;873281;831262;74.2;70.7
34;2021-09-14;1235;3269;874516;834531;74.4;71.0
34;2021-09-15;1482;2951;875998;837482;74.5;71.2
34;2021-09-16;880;1876;876878;839358;74.6;71.4
34;2021-09-17;1118;2418;877996;841776;74.7;71.6
34;2021-09-18;782;1762;878778;843538;74.7;71.7
34;2021-09-19;36;59;878814;843597;74.7;71.7
34;2021-09-20;611;1909;879425;845506;74.8;71.9
34;2021-09-21;611;1779;880036;847285;74.8;72.0
34;2021-09-22;829;2528;880865;849813;74.9;72.3
34;2021-09-23;670;1658;881535;851471;75.0;72.4
34;2021-09-24;842;2220;882377;853691;75.0;72.6
34;2021-09-25;492;1555;882869;855246;75.1;72.7
34;2021-09-26;51;142;882920;855388;75.1;72.7
34;2021-09-27;620;1476;883540;856864;75.1;72.9
34;2021-09-28;630;1127;884170;857991;75.2;72.9
34;2021-09-29;856;1810;885026;859801;75.2;73.1
34;2021-09-30;605;1344;885631;861145;75.3;73.2
34;2021-10-01;717;1498;886348;862643;75.4;73.3
34;2021-10-02;652;1386;887000;864029;75.4;73.5
34;2021-10-03;60;162;887060;864191;75.4;73.5
34;2021-10-04;598;1082;887658;865273;75.5;73.6
34;2021-10-05;522;1034;888180;866307;75.5;73.7
34;2021-10-06;837;1708;889017;868015;75.6;73.8
35;2020-12-27;0;0;0;0;0.0;0.0
35;2020-12-28;0;0;0;0;0.0;0.0
35;2020-12-29;2;0;2;0;0.0;0.0
35;2020-12-30;0;0;2;0;0.0;0.0
35;2020-12-31;3;0;5;0;0.0;0.0
35;2021-01-01;3;0;8;0;0.0;0.0
35;2021-01-02;1;0;9;0;0.0;0.0
35;2021-01-03;0;0;9;0;0.0;0.0
35;2021-01-04;10;0;19;0;0.0;0.0
35;2021-01-05;110;0;129;0;0.0;0.0
35;2021-01-06;175;0;304;0;0.0;0.0
35;2021-01-07;440;1;744;1;0.1;0.0
35;2021-01-08;513;1;1257;2;0.1;0.0
35;2021-01-09;31;0;1288;2;0.1;0.0
35;2021-01-10;2;0;1290;2;0.1;0.0
35;2021-01-11;538;0;1828;2;0.2;0.0
35;2021-01-12;886;2;2714;4;0.3;0.0
35;2021-01-13;970;1;3684;5;0.3;0.0
35;2021-01-14;1261;17;4945;22;0.5;0.0
35;2021-01-15;732;2;5677;24;0.5;0.0
35;2021-01-16;189;3;5866;27;0.5;0.0
35;2021-01-17;44;0;5910;27;0.5;0.0
35;2021-01-18;1222;0;7132;27;0.7;0.0
35;2021-01-19;5406;12;12538;39;1.2;0.0
35;2021-01-20;3238;9;15776;48;1.5;0.0
35;2021-01-21;3643;5;19419;53;1.8;0.0
35;2021-01-22;2087;9;21506;62;2.0;0.0
35;2021-01-23;421;1;21927;63;2.0;0.0
35;2021-01-24;51;0;21978;63;2.0;0.0
35;2021-01-25;918;15;22896;78;2.1;0.0
35;2021-01-26;1130;126;24026;204;2.2;0.0
35;2021-01-27;1029;115;25055;319;2.3;0.0
35;2021-01-28;916;272;25971;591;2.4;0.1
35;2021-01-29;725;255;26696;846;2.5;0.1
35;2021-01-30;140;15;26836;861;2.5;0.1
35;2021-01-31;0;0;26836;861;2.5;0.1
35;2021-02-01;673;282;27509;1143;2.5;0.1
35;2021-02-02;725;409;28234;1552;2.6;0.1
35;2021-02-03;662;467;28896;2019;2.7;0.2
35;2021-02-04;590;582;29486;2601;2.7;0.2
35;2021-02-05;624;509;30110;3110;2.8;0.3
35;2021-02-06;175;4;30285;3114;2.8;0.3
35;2021-02-07;1;0;30286;3114;2.8;0.3
35;2021-02-08;446;538;30732;3652;2.8;0.3
35;2021-02-09;1715;3233;32447;6885;3.0;0.6
35;2021-02-10;1370;2517;33817;9402;3.1;0.9
35;2021-02-11;1944;3007;35761;12409;3.3;1.1
35;2021-02-12;1663;1551;37424;13960;3.5;1.3
35;2021-02-13;58;230;37482;14190;3.5;1.3
35;2021-02-14;8;46;37490;14236;3.5;1.3
35;2021-02-15;771;822;38261;15058;3.5;1.4
35;2021-02-16;919;780;39180;15838;3.6;1.5
35;2021-02-17;895;871;40075;16709;3.7;1.5
35;2021-02-18;1020;803;41095;17512;3.8;1.6
35;2021-02-19;1013;752;42108;18264;3.9;1.7
35;2021-02-20;143;38;42251;18302;3.9;1.7
35;2021-02-21;5;0;42256;18302;3.9;1.7
35;2021-02-22;776;652;43032;18954;4.0;1.8
35;2021-02-23;1288;693;44320;19647;4.1;1.8
35;2021-02-24;1404;678;45724;20325;4.2;1.9
35;2021-02-25;2249;658;47973;20983;4.4;1.9
35;2021-02-26;2599;594;50572;21577;4.7;2.0
35;2021-02-27;869;78;51441;21655;4.8;2.0
35;2021-02-28;10;0;51451;21655;4.8;2.0
35;2021-03-01;959;566;52410;22221;4.8;2.1
35;2021-03-02;1634;1805;54044;24026;5.0;2.2
35;2021-03-03;1914;861;55958;24887;5.2;2.3
35;2021-03-04;2917;1292;58875;26179;5.4;2.4
35;2021-03-05;3716;1254;62591;27433;5.8;2.5
35;2021-03-06;1337;79;63928;27512;5.9;2.5
35;2021-03-07;1;36;63929;27548;5.9;2.5
35;2021-03-08;1475;539;65404;28087;6.0;2.6
35;2021-03-09;3238;545;68642;28632;6.3;2.6
35;2021-03-10;2902;517;71544;29149;6.6;2.7
35;2021-03-11;4199;653;75743;29802;7.0;2.8
35;2021-03-12;6049;520;81792;30322;7.6;2.8
35;2021-03-13;2427;124;84219;30446;7.8;2.8
35;2021-03-14;18;25;84237;30471;7.8;2.8
35;2021-03-15;1966;659;86203;31130;8.0;2.9
35;2021-03-16;2505;714;88708;31844;8.2;2.9
35;2021-03-17;2397;588;91105;32432;8.4;3.0
35;2021-03-18;2334;580;93439;33012;8.6;3.1
35;2021-03-19;3546;496;96985;33508;9.0;3.1
35;2021-03-20;1543;108;98528;33616;9.1;3.1
35;2021-03-21;38;1;98566;33617;9.1;3.1
35;2021-03-22;1749;835;100315;34452;9.3;3.2
35;2021-03-23;3626;1168;103941;35620;9.6;3.3
35;2021-03-24;3730;982;107671;36602;10.0;3.4
35;2021-03-25;5328;980;112999;37582;10.4;3.5
35;2021-03-26;5852;801;118851;38383;11.0;3.5
35;2021-03-27;1416;208;120267;38591;11.1;3.6
35;2021-03-28;4;0;120271;38591;11.1;3.6
35;2021-03-29;2778;902;123049;39493;11.4;3.6
35;2021-03-30;4292;1311;127341;40804;11.8;3.8
35;2021-03-31;3471;1331;130812;42135;12.1;3.9
35;2021-04-01;4250;1237;135062;43372;12.5;4.0
35;2021-04-02;4861;1205;139923;44577;12.9;4.1
35;2021-04-03;763;214;140686;44791;13.0;4.1
35;2021-04-04;6;0;140692;44791;13.0;4.1
35;2021-04-05;24;1;140716;44792;13.0;4.1
35;2021-04-06;3279;2022;143995;46814;13.3;4.3
35;2021-04-07;3966;1839;147961;48653;13.7;4.5
35;2021-04-08;5803;1590;153764;50243;14.2;4.6
35;2021-04-09;7429;1413;161193;51656;14.9;4.8
35;2021-04-10;1860;250;163053;51906;15.1;4.8
35;2021-04-11;35;23;163088;51929;15.1;4.8
35;2021-04-12;5137;1593;168225;53522;15.5;4.9
35;2021-04-13;7624;2782;175849;56304;16.3;5.2
35;2021-04-14;6314;2299;182163;58603;16.8;5.4
35;2021-04-15;7565;2178;189728;60781;17.5;5.6
35;2021-04-16;8081;1761;197809;62542;18.3;5.8
35;2021-04-17;1571;222;199380;62764;18.4;5.8
35;2021-04-18;10;4;199390;62768;18.4;5.8
35;2021-04-19;4819;1667;204209;64435;18.9;6.0
35;2021-04-20;5165;2636;209374;67071;19.3;6.2
35;2021-04-21;5134;2208;214508;69279;19.8;6.4
35;2021-04-22;6429;2326;220937;71605;20.4;6.6
35;2021-04-23;6821;2365;227758;73970;21.0;6.8
35;2021-04-24;1132;262;228890;74232;21.2;6.9
35;2021-04-25;8;16;228898;74248;21.2;6.9
35;2021-04-26;5099;2153;233997;76401;21.6;7.1
35;2021-04-27;6090;3190;240087;79591;22.2;7.4
35;2021-04-28;6173;2548;246260;82139;22.8;7.6
35;2021-04-29;7117;2732;253377;84871;23.4;7.8
35;2021-04-30;7564;2521;260941;87392;24.1;8.1
35;2021-05-01;618;239;261559;87631;24.2;8.1
35;2021-05-02;15;21;261574;87652;24.2;8.1
35;2021-05-03;5307;2327;266881;89979;24.7;8.3
35;2021-05-04;5068;5315;271949;95294;25.1;8.8
35;2021-05-05;4883;4435;276832;99729;25.6;9.2
35;2021-05-06;6176;5257;283008;104986;26.2;9.7
35;2021-05-07;5620;5218;288628;110204;26.7;10.2
35;2021-05-08;1719;135;290347;110339;26.8;10.2
35;2021-05-09;698;75;291045;110414;26.9;10.2
35;2021-05-10;3719;4951;294764;115365;27.2;10.7
35;2021-05-11;4774;5795;299538;121160;27.7;11.2
35;2021-05-12;5292;5491;304830;126651;28.2;11.7
35;2021-05-13;2699;1424;307529;128075;28.4;11.8
35;2021-05-14;5460;4327;312989;132402;28.9;12.2
35;2021-05-15;2929;718;315918;133120;29.2;12.3
35;2021-05-16;997;61;316915;133181;29.3;12.3
35;2021-05-17;4474;3870;321389;137051;29.7;12.7
35;2021-05-18;5838;4315;327227;141366;30.2;13.1
35;2021-05-19;5866;3632;333093;144998;30.8;13.4
35;2021-05-20;6448;3992;339541;148990;31.4;13.8
35;2021-05-21;6140;4755;345681;153745;31.9;14.2
35;2021-05-22;2118;727;347799;154472;32.1;14.3
35;2021-05-23;688;46;348487;154518;32.2;14.3
35;2021-05-24;3206;1298;351693;155816;32.5;14.4
35;2021-05-25;5542;4271;357235;160087;33.0;14.8
35;2021-05-26;5720;4151;362955;164238;33.5;15.2
35;2021-05-27;6527;4750;369482;168988;34.1;15.6
35;2021-05-28;6330;5544;375812;174532;34.7;16.1
35;2021-05-29;2873;1137;378685;175669;35.0;16.2
35;2021-05-30;878;39;379563;175708;35.1;16.2
35;2021-05-31;6309;4380;385872;180088;35.7;16.6
35;2021-06-01;7365;5103;393237;185191;36.3;17.1
35;2021-06-02;7219;3789;400456;188980;37.0;17.5
35;2021-06-03;8156;4982;408612;193962;37.8;17.9
35;2021-06-04;7274;7442;415886;201404;38.4;18.6
35;2021-06-05;4138;1584;420024;202988;38.8;18.8
35;2021-06-06;3053;146;423077;203134;39.1;18.8
35;2021-06-07;5782;5773;428859;208907;39.6;19.3
35;2021-06-08;7604;5948;436463;214855;40.3;19.9
35;2021-06-09;8461;4807;444924;219662;41.1;20.3
35;2021-06-10;9346;4735;454270;224397;42.0;20.7
35;2021-06-11;8632;7461;462902;231858;42.8;21.4
35;2021-06-12;4684;1208;467586;233066;43.2;21.5
35;2021-06-13;3386;227;470972;233293;43.5;21.6
35;2021-06-14;6231;6517;477203;239810;44.1;22.2
35;2021-06-15;7505;6963;484708;246773;44.8;22.8
35;2021-06-16;8323;5623;493031;252396;45.6;23.3
35;2021-06-17;8898;5907;501929;258303;46.4;23.9
35;2021-06-18;8716;8088;510645;266391;47.2;24.6
35;2021-06-19;1504;2510;512149;268901;47.3;24.9
35;2021-06-20;2953;883;515102;269784;47.6;24.9
35;2021-06-21;5930;6373;521032;276157;48.2;25.5
35;2021-06-22;6841;7499;527873;283656;48.8;26.2
35;2021-06-23;7254;6144;535127;289800;49.5;26.8
35;2021-06-24;8367;5922;543494;295722;50.2;27.3
35;2021-06-25;6627;8478;550121;304200;50.8;28.1
35;2021-06-26;1107;3076;551228;307276;50.9;28.4
35;2021-06-27;2635;1031;553863;308307;51.2;28.5
35;2021-06-28;4298;7758;558161;316065;51.6;29.2
35;2021-06-29;5089;7970;563250;324035;52.1;29.9
35;2021-06-30;5601;7891;568851;331926;52.6;30.7
35;2021-07-01;6587;7542;575438;339468;53.2;31.4
35;2021-07-02;5331;9859;580769;349327;53.7;32.3
35;2021-07-03;1083;2839;581852;352166;53.8;32.5
35;2021-07-04;2149;1554;584001;353720;54.0;32.7
35;2021-07-05;3735;8209;587736;361929;54.3;33.4
35;2021-07-06;4787;9470;592523;371399;54.8;34.3
35;2021-07-07;5057;8316;597580;379715;55.2;35.1
35;2021-07-08;5387;8486;602967;388201;55.7;35.9
35;2021-07-09;3907;11545;606874;399746;56.1;36.9
35;2021-07-10;892;3148;607766;402894;56.2;37.2
35;2021-07-11;1300;2355;609066;405249;56.3;37.5
35;2021-07-12;3121;9145;612187;414394;56.6;38.3
35;2021-07-13;3981;10747;616168;425141;56.9;39.3
35;2021-07-14;2153;4451;618321;429592;57.1;39.7
35;2021-07-15;4293;10177;622614;439769;57.5;40.6
35;2021-07-16;4802;10998;627416;450767;58.0;41.7
35;2021-07-17;1988;4064;629404;454831;58.2;42.0
35;2021-07-18;844;2571;630248;457402;58.2;42.3
35;2021-07-19;3251;8972;633499;466374;58.5;43.1
35;2021-07-20;4244;10590;637743;476964;58.9;44.1
35;2021-07-21;4370;9386;642113;486350;59.3;44.9
35;2021-07-22;4852;9651;646965;496001;59.8;45.8
35;2021-07-23;4564;11009;651529;507010;60.2;46.9
35;2021-07-24;1587;4263;653116;511273;60.4;47.2
35;2021-07-25;815;2846;653931;514119;60.4;47.5
35;2021-07-26;3891;8734;657822;522853;60.8;48.3
35;2021-07-27;5281;9653;663103;532506;61.3;49.2
35;2021-07-28;5318;8670;668421;541176;61.8;50.0
35;2021-07-29;6114;8333;674535;549509;62.3;50.8
35;2021-07-30;5904;9084;680439;558593;62.9;51.6
35;2021-07-31;2322;3654;682761;562247;63.1;52.0
35;2021-08-01;1526;2415;684287;564662;63.2;52.2
35;2021-08-02;4757;6949;689044;571611;63.7;52.8
35;2021-08-03;6712;7581;695756;579192;64.3;53.5
35;2021-08-04;6714;6592;702470;585784;64.9;54.1
35;2021-08-05;6685;6982;709155;592766;65.5;54.8
35;2021-08-06;6067;7320;715222;600086;66.1;55.5
35;2021-08-07;2109;3151;717331;603237;66.3;55.7
35;2021-08-08;1523;2257;718854;605494;66.4;56.0
35;2021-08-09;4617;5534;723471;611028;66.9;56.5
35;2021-08-10;6565;6381;730036;617409;67.5;57.1
35;2021-08-11;6474;5865;736510;623274;68.1;57.6
35;2021-08-12;7014;5583;743524;628857;68.7;58.1
35;2021-08-13;6696;5066;750220;633923;69.3;58.6
35;2021-08-14;3049;1985;753269;635908;69.6;58.8
35;2021-08-15;2471;1261;755740;637169;69.8;58.9
35;2021-08-16;4872;5296;760612;642465;70.3;59.4
35;2021-08-17;6406;6081;767018;648546;70.9;59.9
35;2021-08-18;6487;5631;773505;654177;71.5;60.5
35;2021-08-19;6302;5764;779807;659941;72.1;61.0
35;2021-08-20;5134;6349;784941;666290;72.5;61.6
35;2021-08-21;2384;2633;787325;668923;72.8;61.8
35;2021-08-22;1765;1796;789090;670719;72.9;62.0
35;2021-08-23;3104;6012;792194;676731;73.2;62.5
35;2021-08-24;3502;7221;795696;683952;73.5;63.2
35;2021-08-25;3313;6616;799009;690568;73.8;63.8
35;2021-08-26;2640;6893;801649;697461;74.1;64.5
35;2021-08-27;2783;7260;804432;704721;74.3;65.1
35;2021-08-28;1178;2953;805610;707674;74.5;65.4
35;2021-08-29;517;1759;806127;709433;74.5;65.6
35;2021-08-30;1977;5496;808104;714929;74.7;66.1
35;2021-08-31;2388;6524;810492;721453;74.9;66.7
35;2021-09-01;1924;6095;812416;727548;75.1;67.2
35;2021-09-02;1843;6172;814259;733720;75.2;67.8
35;2021-09-03;2032;7046;816291;740766;75.4;68.5
35;2021-09-04;1130;4096;817421;744862;75.5;68.8
35;2021-09-05;516;2076;817937;746938;75.6;69.0
35;2021-09-06;1136;5010;819073;751948;75.7;69.5
35;2021-09-07;1324;5417;820397;757365;75.8;70.0
35;2021-09-08;1333;6263;821730;763628;75.9;70.6
35;2021-09-09;1258;5311;822988;768939;76.1;71.1
35;2021-09-10;1582;6594;824570;775533;76.2;71.7
35;2021-09-11;624;3899;825194;779432;76.3;72.0
35;2021-09-12;285;2373;825479;781805;76.3;72.3
35;2021-09-13;1323;4312;826802;786117;76.4;72.6
35;2021-09-14;1374;4453;828176;790570;76.5;73.1
35;2021-09-15;1227;4594;829403;795164;76.6;73.5
35;2021-09-16;1119;2844;830522;798008;76.8;73.7
35;2021-09-17;1267;3894;831789;801902;76.9;74.1
35;2021-09-18;513;2876;832302;804778;76.9;74.4
35;2021-09-19;167;1020;832469;805798;76.9;74.5
35;2021-09-20;1150;2648;833619;808446;77.0;74.7
35;2021-09-21;663;1927;834282;810373;77.1;74.9
35;2021-09-22;857;3623;835139;813996;77.2;75.2
35;2021-09-23;564;1532;835703;815528;77.2;75.4
35;2021-09-24;972;3039;836675;818567;77.3;75.6
35;2021-09-25;421;1958;837096;820525;77.4;75.8
35;2021-09-26;16;164;837112;820689;77.4;75.8
35;2021-09-27;519;1626;837631;822315;77.4;76.0
35;2021-09-28;460;1185;838091;823500;77.5;76.1
35;2021-09-29;610;1981;838701;825481;77.5;76.3
35;2021-09-30;351;834;839052;826315;77.5;76.4
35;2021-10-01;800;2158;839852;828473;77.6;76.6
35;2021-10-02;360;1134;840212;829607;77.6;76.7
35;2021-10-03;1;12;840213;829619;77.6;76.7
35;2021-10-04;513;1011;840726;830630;77.7;76.8
35;2021-10-05;432;985;841158;831615;77.7;76.9
35;2021-10-06;604;1329;841762;832944;77.8;77.0
36;2020-12-27;0;0;0;0;0.0;0.0
36;2020-12-28;0;0;0;0;0.0;0.0
36;2020-12-29;0;0;0;0;0.0;0.0
36;2020-12-30;0;0;0;0;0.0;0.0
36;2020-12-31;0;0;0;0;0.0;0.0
36;2021-01-01;0;0;0;0;0.0;0.0
36;2021-01-02;0;0;0;0;0.0;0.0
36;2021-01-03;0;0;0;0;0.0;0.0
36;2021-01-04;2;0;2;0;0.0;0.0
36;2021-01-05;0;0;2;0;0.0;0.0
36;2021-01-06;24;0;26;0;0.0;0.0
36;2021-01-07;51;0;77;0;0.0;0.0
36;2021-01-08;111;0;188;0;0.1;0.0
36;2021-01-09;84;0;272;0;0.1;0.0
36;2021-01-10;142;0;414;0;0.2;0.0
36;2021-01-11;240;1;654;1;0.3;0.0
36;2021-01-12;282;0;936;1;0.4;0.0
36;2021-01-13;198;1;1134;2;0.5;0.0
36;2021-01-14;506;3;1640;5;0.8;0.0
36;2021-01-15;179;1;1819;6;0.8;0.0
36;2021-01-16;24;1;1843;7;0.8;0.0
36;2021-01-17;19;1;1862;8;0.9;0.0
36;2021-01-18;612;3;2474;11;1.1;0.0
36;2021-01-19;1173;1;3647;12;1.7;0.0
36;2021-01-20;1102;2;4749;14;2.2;0.0
36;2021-01-21;721;1;5470;15;2.5;0.0
36;2021-01-22;858;2;6328;17;2.9;0.0
36;2021-01-23;294;0;6622;17;3.0;0.0
36;2021-01-24;185;0;6807;17;3.1;0.0
36;2021-01-25;640;4;7447;21;3.4;0.0
36;2021-01-26;609;1;8056;22;3.7;0.0
36;2021-01-27;853;19;8909;41;4.1;0.0
36;2021-01-28;478;34;9387;75;4.3;0.0
36;2021-01-29;573;88;9960;163;4.6;0.1
36;2021-01-30;288;61;10248;224;4.7;0.1
36;2021-01-31;115;116;10363;340;4.8;0.2
36;2021-02-01;379;88;10742;428;4.9;0.2
36;2021-02-02;410;168;11152;596;5.1;0.3
36;2021-02-03;473;240;11625;836;5.4;0.4
36;2021-02-04;275;246;11900;1082;5.5;0.5
36;2021-02-05;301;151;12201;1233;5.6;0.6
36;2021-02-06;1;0;12202;1233;5.6;0.6
36;2021-02-07;1;0;12203;1233;5.6;0.6
36;2021-02-08;280;198;12483;1431;5.7;0.7
36;2021-02-09;328;536;12811;1967;5.9;0.9
36;2021-02-10;489;601;13300;2568;6.1;1.2
36;2021-02-11;384;566;13684;3134;6.3;1.4
36;2021-02-12;303;356;13987;3490;6.4;1.6
36;2021-02-13;126;54;14113;3544;6.5;1.6
36;2021-02-14;22;22;14135;3566;6.5;1.6
36;2021-02-15;42;443;14177;4009;6.5;1.8
36;2021-02-16;107;309;14284;4318;6.6;2.0
36;2021-02-17;117;480;14401;4798;6.6;2.2
36;2021-02-18;161;520;14562;5318;6.7;2.4
36;2021-02-19;181;408;14743;5726;6.8;2.6
36;2021-02-20;86;194;14829;5920;6.8;2.7
36;2021-02-21;87;127;14916;6047;6.9;2.8
36;2021-02-22;162;393;15078;6440;6.9;3.0
36;2021-02-23;62;498;15140;6938;7.0;3.2
36;2021-02-24;110;558;15250;7496;7.0;3.5
36;2021-02-25;251;226;15501;7722;7.1;3.6
36;2021-02-26;339;397;15840;8119;7.3;3.7
36;2021-02-27;73;216;15913;8335;7.3;3.8
36;2021-02-28;13;79;15926;8414;7.3;3.9
36;2021-03-01;218;301;16144;8715;7.4;4.0
36;2021-03-02;352;323;16496;9038;7.6;4.2
36;2021-03-03;394;482;16890;9520;7.8;4.4
36;2021-03-04;662;326;17552;9846;8.1;4.5
36;2021-03-05;800;271;18352;10117;8.5;4.7
36;2021-03-06;410;17;18762;10134;8.6;4.7
36;2021-03-07;339;8;19101;10142;8.8;4.7
36;2021-03-08;251;290;19352;10432;8.9;4.8
36;2021-03-09;449;241;19801;10673;9.1;4.9
36;2021-03-10;724;389;20525;11062;9.5;5.1
36;2021-03-11;840;237;21365;11299;9.8;5.2
36;2021-03-12;1446;295;22811;11594;10.5;5.3
36;2021-03-13;576;124;23387;11718;10.8;5.4
36;2021-03-14;113;1;23500;11719;10.8;5.4
36;2021-03-15;648;154;24148;11873;11.1;5.5
36;2021-03-16;445;67;24593;11940;11.3;5.5
36;2021-03-17;766;90;25359;12030;11.7;5.5
36;2021-03-18;414;72;25773;12102;11.9;5.6
36;2021-03-19;737;40;26510;12142;12.2;5.6
36;2021-03-20;450;26;26960;12168;12.4;5.6
36;2021-03-21;0;0;26960;12168;12.4;5.6
36;2021-03-22;497;59;27457;12227;12.6;5.6
36;2021-03-23;777;59;28234;12286;13.0;5.7
36;2021-03-24;1089;76;29323;12362;13.5;5.7
36;2021-03-25;1338;89;30661;12451;14.1;5.7
36;2021-03-26;1419;140;32080;12591;14.8;5.8
36;2021-03-27;475;43;32555;12634;15.0;5.8
36;2021-03-28;68;56;32623;12690;15.0;5.8
36;2021-03-29;462;183;33085;12873;15.2;5.9
36;2021-03-30;583;263;33668;13136;15.5;6.0
36;2021-03-31;1262;172;34930;13308;16.1;6.1
36;2021-04-01;1086;431;36016;13739;16.6;6.3
36;2021-04-02;966;143;36982;13882;17.0;6.4
36;2021-04-03;282;176;37264;14058;17.2;6.5
36;2021-04-04;42;2;37306;14060;17.2;6.5
36;2021-04-05;15;46;37321;14106;17.2;6.5
36;2021-04-06;820;361;38141;14467;17.6;6.7
36;2021-04-07;1072;539;39213;15006;18.1;6.9
36;2021-04-08;1347;480;40560;15486;18.7;7.1
36;2021-04-09;1936;402;42496;15888;19.6;7.3
36;2021-04-10;592;243;43088;16131;19.8;7.4
36;2021-04-11;256;90;43344;16221;20.0;7.5
36;2021-04-12;848;560;44192;16781;20.4;7.7
36;2021-04-13;1140;516;45332;17297;20.9;8.0
36;2021-04-14;1582;865;46914;18162;21.6;8.4
36;2021-04-15;1654;473;48568;18635;22.4;8.6
36;2021-04-16;1485;468;50053;19103;23.1;8.8
36;2021-04-17;893;250;50946;19353;23.5;8.9
36;2021-04-18;383;7;51329;19360;23.6;8.9
36;2021-04-19;874;443;52203;19803;24.0;9.1
36;2021-04-20;1145;520;53348;20323;24.6;9.4
36;2021-04-21;1240;879;54588;21202;25.1;9.8
36;2021-04-22;1593;869;56181;22071;25.9;10.2
36;2021-04-23;1329;614;57510;22685;26.5;10.4
36;2021-04-24;677;380;58187;23065;26.8;10.6
36;2021-04-25;413;94;58600;23159;27.0;10.7
36;2021-04-26;1134;446;59734;23605;27.5;10.9
36;2021-04-27;1278;551;61012;24156;28.1;11.1
36;2021-04-28;1488;1061;62500;25217;28.8;11.6
36;2021-04-29;2016;703;64516;25920;29.7;11.9
36;2021-04-30;1553;457;66069;26377;30.4;12.1
36;2021-05-01;724;62;66793;26439;30.8;12.2
36;2021-05-02;498;64;67291;26503;31.0;12.2
36;2021-05-03;1293;314;68584;26817;31.6;12.4
36;2021-05-04;780;803;69364;27620;31.9;12.7
36;2021-05-05;1282;1303;70646;28923;32.5;13.3
36;2021-05-06;2137;795;72783;29718;33.5;13.7
36;2021-05-07;1469;766;74252;30484;34.2;14.0
36;2021-05-08;306;105;74558;30589;34.3;14.1
36;2021-05-09;174;343;74732;30932;34.4;14.2
36;2021-05-10;1216;814;75948;31746;35.0;14.6
36;2021-05-11;1725;1244;77673;32990;35.8;15.2
36;2021-05-12;1827;1484;79500;34474;36.6;15.9
36;2021-05-13;548;304;80048;34778;36.9;16.0
36;2021-05-14;701;1035;80749;35813;37.2;16.5
36;2021-05-15;635;591;81384;36404;37.5;16.8
36;2021-05-16;337;377;81721;36781;37.6;16.9
36;2021-05-17;615;943;82336;37724;37.9;17.4
36;2021-05-18;874;935;83210;38659;38.3;17.8
36;2021-05-19;1333;845;84543;39504;38.9;18.2
36;2021-05-20;1611;1200;86154;40704;39.7;18.7
36;2021-05-21;1106;1064;87260;41768;40.2;19.2
36;2021-05-22;678;342;87938;42110;40.5;19.4
36;2021-05-23;428;297;88366;42407;40.7;19.5
36;2021-05-24;506;469;88872;42876;40.9;19.7
36;2021-05-25;1045;685;89917;43561;41.4;20.1
36;2021-05-26;1472;1158;91389;44719;42.1;20.6
36;2021-05-27;1397;975;92786;45694;42.7;21.0
36;2021-05-28;921;1480;93707;47174;43.2;21.7
36;2021-05-29;700;507;94407;47681;43.5;22.0
36;2021-05-30;111;572;94518;48253;43.5;22.2
36;2021-05-31;1137;763;95655;49016;44.1;22.6
36;2021-06-01;1413;829;97068;49845;44.7;23.0
36;2021-06-02;2062;614;99130;50459;45.7;23.2
36;2021-06-03;1902;1199;101032;51658;46.5;23.8
36;2021-06-04;1772;1038;102804;52696;47.3;24.3
36;2021-06-05;693;657;103497;53353;47.7;24.6
36;2021-06-06;336;272;103833;53625;47.8;24.7
36;2021-06-07;983;806;104816;54431;48.3;25.1
36;2021-06-08;957;981;105773;55412;48.7;25.5
36;2021-06-09;1675;1061;107448;56473;49.5;26.0
36;2021-06-10;1530;1381;108978;57854;50.2;26.6
36;2021-06-11;1288;1489;110266;59343;50.8;27.3
36;2021-06-12;920;779;111186;60122;51.2;27.7
36;2021-06-13;343;269;111529;60391;51.4;27.8
36;2021-06-14;605;1268;112134;61659;51.6;28.4
36;2021-06-15;733;1215;112867;62874;52.0;29.0
36;2021-06-16;903;1519;113770;64393;52.4;29.7
36;2021-06-17;749;1899;114519;66292;52.7;30.5
36;2021-06-18;706;1878;115225;68170;53.1;31.4
36;2021-06-19;295;395;115520;68565;53.2;31.6
36;2021-06-20;235;327;115755;68892;53.3;31.7
36;2021-06-21;692;1449;116447;70341;53.6;32.4
36;2021-06-22;841;1552;117288;71893;54.0;33.1
36;2021-06-23;774;1786;118062;73679;54.4;33.9
36;2021-06-24;855;1522;118917;75201;54.8;34.6
36;2021-06-25;942;1218;119859;76419;55.2;35.2
36;2021-06-26;324;602;120183;77021;55.3;35.5
36;2021-06-27;105;267;120288;77288;55.4;35.6
36;2021-06-28;696;922;120984;78210;55.7;36.0
36;2021-06-29;688;1459;121672;79669;56.0;36.7
36;2021-06-30;836;2149;122508;81818;56.4;37.7
36;2021-07-01;353;1081;122861;82899;56.6;38.2
36;2021-07-02;749;1843;123610;84742;56.9;39.0
36;2021-07-03;465;885;124075;85627;57.1;39.4
36;2021-07-04;185;325;124260;85952;57.2;39.6
36;2021-07-05;493;1335;124753;87287;57.5;40.2
36;2021-07-06;491;1220;125244;88507;57.7;40.8
36;2021-07-07;586;1791;125830;90298;57.9;41.6
36;2021-07-08;550;1706;126380;92004;58.2;42.4
36;2021-07-09;786;1651;127166;93655;58.6;43.1
36;2021-07-10;470;1119;127636;94774;58.8;43.6
36;2021-07-11;257;154;127893;94928;58.9;43.7
36;2021-07-12;332;1628;128225;96556;59.1;44.5
36;2021-07-13;311;1936;128536;98492;59.2;45.4
36;2021-07-14;376;763;128912;99255;59.4;45.7
36;2021-07-15;917;2161;129829;101416;59.8;46.7
36;2021-07-16;628;1869;130457;103285;60.1;47.6
36;2021-07-17;400;859;130857;104144;60.3;48.0
36;2021-07-18;199;408;131056;104552;60.4;48.1
36;2021-07-19;552;1456;131608;106008;60.6;48.8
36;2021-07-20;776;1406;132384;107414;61.0;49.5
36;2021-07-21;713;1984;133097;109398;61.3;50.4
36;2021-07-22;1138;1686;134235;111084;61.8;51.2
36;2021-07-23;968;1739;135203;112823;62.3;52.0
36;2021-07-24;605;800;135808;113623;62.5;52.3
36;2021-07-25;148;404;135956;114027;62.6;52.5
36;2021-07-26;948;1085;136904;115112;63.0;53.0
36;2021-07-27;816;1355;137720;116467;63.4;53.6
36;2021-07-28;1385;1401;139105;117868;64.1;54.3
36;2021-07-29;1708;1310;140813;119178;64.8;54.9
36;2021-07-30;1445;1322;142258;120500;65.5;55.5
36;2021-07-31;933;537;143191;121037;65.9;55.7
36;2021-08-01;210;239;143401;121276;66.0;55.9
36;2021-08-02;1116;891;144517;122167;66.6;56.3
36;2021-08-03;1271;998;145788;123165;67.1;56.7
36;2021-08-04;1695;940;147483;124105;67.9;57.2
36;2021-08-05;1824;910;149307;125015;68.8;57.6
36;2021-08-06;1418;877;150725;125892;69.4;58.0
36;2021-08-07;541;527;151266;126419;69.7;58.2
36;2021-08-08;292;153;151558;126572;69.8;58.3
36;2021-08-09;818;846;152376;127418;70.2;58.7
36;2021-08-10;1067;1012;153443;128430;70.7;59.1
36;2021-08-11;1356;857;154799;129287;71.3;59.5
36;2021-08-12;1161;854;155960;130141;71.8;59.9
36;2021-08-13;1193;778;157153;130919;72.4;60.3
36;2021-08-14;426;836;157579;131755;72.6;60.7
36;2021-08-15;365;113;157944;131868;72.7;60.7
36;2021-08-16;606;954;158550;132822;73.0;61.2
36;2021-08-17;766;1001;159316;133823;73.4;61.6
36;2021-08-18;1039;1164;160355;134987;73.8;62.2
36;2021-08-19;840;1178;161195;136165;74.2;62.7
36;2021-08-20;488;1480;161683;137645;74.5;63.4
36;2021-08-21;309;468;161992;138113;74.6;63.6
36;2021-08-22;27;65;162019;138178;74.6;63.6
36;2021-08-23;551;1179;162570;139357;74.9;64.2
36;2021-08-24;589;1204;163159;140561;75.1;64.7
36;2021-08-25;466;1093;163625;141654;75.4;65.2
36;2021-08-26;666;1480;164291;143134;75.7;65.9
36;2021-08-27;529;1409;164820;144543;75.9;66.6
36;2021-08-28;368;580;165188;145123;76.1;66.8
36;2021-08-29;222;241;165410;145364;76.2;66.9
36;2021-08-30;246;749;165656;146113;76.3;67.3
36;2021-08-31;387;935;166043;147048;76.5;67.7
36;2021-09-01;388;1220;166431;148268;76.6;68.3
36;2021-09-02;324;1055;166755;149323;76.8;68.8
36;2021-09-03;297;1496;167052;150819;76.9;69.5
36;2021-09-04;248;864;167300;151683;77.0;69.9
36;2021-09-05;119;384;167419;152067;77.1;70.0
36;2021-09-06;150;1041;167569;153108;77.2;70.5
36;2021-09-07;191;855;167760;153963;77.3;70.9
36;2021-09-08;236;1304;167996;155267;77.4;71.5
36;2021-09-09;293;1010;168289;156277;77.5;72.0
36;2021-09-10;270;1141;168559;157418;77.6;72.5
36;2021-09-11;164;761;168723;158179;77.7;72.8
36;2021-09-12;82;235;168805;158414;77.7;73.0
36;2021-09-13;168;734;168973;159148;77.8;73.3
36;2021-09-14;170;791;169143;159939;77.9;73.7
36;2021-09-15;301;568;169444;160507;78.0;73.9
36;2021-09-16;248;669;169692;161176;78.1;74.2
36;2021-09-17;256;567;169948;161743;78.3;74.5
36;2021-09-18;122;427;170070;162170;78.3;74.7
36;2021-09-19;43;214;170113;162384;78.3;74.8
36;2021-09-20;131;325;170244;162709;78.4;74.9
36;2021-09-21;132;300;170376;163009;78.5;75.1
36;2021-09-22;118;674;170494;163683;78.5;75.4
36;2021-09-23;135;438;170629;164121;78.6;75.6
36;2021-09-24;128;497;170757;164618;78.6;75.8
36;2021-09-25;119;502;170876;165120;78.7;76.0
36;2021-09-26;15;318;170891;165438;78.7;76.2
36;2021-09-27;66;224;170957;165662;78.7;76.3
36;2021-09-28;69;233;171026;165895;78.8;76.4
36;2021-09-29;107;387;171133;166282;78.8;76.6
36;2021-09-30;110;252;171243;166534;78.9;76.7
36;2021-10-01;163;308;171406;166842;78.9;76.8
36;2021-10-02;43;180;171449;167022;79.0;76.9
36;2021-10-03;4;23;171453;167045;79.0;76.9
36;2021-10-04;54;195;171507;167240;79.0;77.0
36;2021-10-05;113;163;171620;167403;79.0;77.1
36;2021-10-06;99;293;171719;167696;79.1;77.2
37;2020-12-27;1;0;1;0;0.0;0.0
37;2020-12-28;17;0;18;0;0.0;0.0
37;2020-12-29;10;0;28;0;0.0;0.0
37;2020-12-30;0;0;28;0;0.0;0.0
37;2020-12-31;0;0;28;0;0.0;0.0
37;2021-01-01;0;0;28;0;0.0;0.0
37;2021-01-02;0;0;28;0;0.0;0.0
37;2021-01-03;2;0;30;0;0.0;0.0
37;2021-01-04;23;0;53;0;0.0;0.0
37;2021-01-05;47;0;100;0;0.0;0.0
37;2021-01-06;79;0;179;0;0.0;0.0
37;2021-01-07;116;0;295;0;0.0;0.0
37;2021-01-08;442;1;737;1;0.1;0.0
37;2021-01-09;80;1;817;2;0.1;0.0
37;2021-01-10;83;0;900;2;0.1;0.0
37;2021-01-11;281;0;1181;2;0.2;0.0
37;2021-01-12;658;4;1839;6;0.3;0.0
37;2021-01-13;560;1;2399;7;0.4;0.0
37;2021-01-14;523;3;2922;10;0.5;0.0
37;2021-01-15;628;1;3550;11;0.6;0.0
37;2021-01-16;304;2;3854;13;0.6;0.0
37;2021-01-17;263;1;4117;14;0.7;0.0
37;2021-01-18;733;9;4850;23;0.8;0.0
37;2021-01-19;1244;11;6094;34;1.0;0.0
37;2021-01-20;1039;5;7133;39;1.2;0.0
37;2021-01-21;858;1;7991;40;1.3;0.0
37;2021-01-22;767;2;8758;42;1.4;0.0
37;2021-01-23;173;0;8931;42;1.5;0.0
37;2021-01-24;2;0;8933;42;1.5;0.0
37;2021-01-25;542;15;9475;57;1.6;0.0
37;2021-01-26;1814;63;11289;120;1.9;0.0
37;2021-01-27;1523;67;12812;187;2.1;0.0
37;2021-01-28;1535;87;14347;274;2.4;0.0
37;2021-01-29;634;304;14981;578;2.5;0.1
37;2021-01-30;204;53;15185;631;2.5;0.1
37;2021-01-31;15;52;15200;683;2.5;0.1
37;2021-02-01;333;182;15533;865;2.6;0.1
37;2021-02-02;523;494;16056;1359;2.7;0.2
37;2021-02-03;659;330;16715;1689;2.8;0.3
37;2021-02-04;549;385;17264;2074;2.9;0.3
37;2021-02-05;468;406;17732;2480;2.9;0.4
37;2021-02-06;191;2;17923;2482;3.0;0.4
37;2021-02-07;21;1;17944;2483;3.0;0.4
37;2021-02-08;333;279;18277;2762;3.0;0.5
37;2021-02-09;627;620;18904;3382;3.1;0.6
37;2021-02-10;664;462;19568;3844;3.2;0.6
37;2021-02-11;613;522;20181;4366;3.3;0.7
37;2021-02-12;489;514;20670;4880;3.4;0.8
37;2021-02-13;156;169;20826;5049;3.4;0.8
37;2021-02-14;2;70;20828;5119;3.4;0.8
37;2021-02-15;427;389;21255;5508;3.5;0.9
37;2021-02-16;841;1317;22096;6825;3.6;1.1
37;2021-02-17;634;1218;22730;8043;3.8;1.3
37;2021-02-18;913;1289;23643;9332;3.9;1.5
37;2021-02-19;797;729;24440;10061;4.0;1.7
37;2021-02-20;245;155;24685;10216;4.1;1.7
37;2021-02-21;5;1;24690;10217;4.1;1.7
37;2021-02-22;335;465;25025;10682;4.1;1.8
37;2021-02-23;606;491;25631;11173;4.2;1.8
37;2021-02-24;573;482;26204;11655;4.3;1.9
37;2021-02-25;875;481;27079;12136;4.5;2.0
37;2021-02-26;1118;472;28197;12608;4.7;2.1
37;2021-02-27;585;131;28782;12739;4.8;2.1
37;2021-02-28;23;0;28805;12739;4.8;2.1
37;2021-03-01;603;307;29408;13046;4.9;2.2
37;2021-03-02;1090;457;30498;13503;5.0;2.2
37;2021-03-03;972;439;31470;13942;5.2;2.3
37;2021-03-04;1608;414;33078;14356;5.5;2.4
37;2021-03-05;2131;475;35209;14831;5.8;2.4
37;2021-03-06;1165;174;36374;15005;6.0;2.5
37;2021-03-07;472;66;36846;15071;6.1;2.5
37;2021-03-08;670;361;37516;15432;6.2;2.5
37;2021-03-09;1654;621;39170;16053;6.5;2.7
37;2021-03-10;1608;681;40778;16734;6.7;2.8
37;2021-03-11;2051;641;42829;17375;7.1;2.9
37;2021-03-12;3210;458;46039;17833;7.6;2.9
37;2021-03-13;1948;179;47987;18012;7.9;3.0
37;2021-03-14;206;4;48193;18016;8.0;3.0
37;2021-03-15;1069;243;49262;18259;8.1;3.0
37;2021-03-16;1050;522;50312;18781;8.3;3.1
37;2021-03-17;937;278;51249;19059;8.5;3.1
37;2021-03-18;1036;516;52285;19575;8.6;3.2
37;2021-03-19;2219;340;54504;19915;9.0;3.3
37;2021-03-20;1336;141;55840;20056;9.2;3.3
37;2021-03-21;205;3;56045;20059;9.3;3.3
37;2021-03-22;1288;238;57333;20297;9.5;3.4
37;2021-03-23;2257;563;59590;20860;9.8;3.4
37;2021-03-24;2245;463;61835;21323;10.2;3.5
37;2021-03-25;2985;440;64820;21763;10.7;3.6
37;2021-03-26;3524;402;68344;22165;11.3;3.7
37;2021-03-27;1176;126;69520;22291;11.5;3.7
37;2021-03-28;139;1;69659;22292;11.5;3.7
37;2021-03-29;1606;344;71265;22636;11.8;3.7
37;2021-03-30;2524;618;73789;23254;12.2;3.8
37;2021-03-31;2050;482;75839;23736;12.5;3.9
37;2021-04-01;2601;966;78440;24702;13.0;4.1
37;2021-04-02;2808;667;81248;25369;13.4;4.2
37;2021-04-03;818;222;82066;25591;13.6;4.2
37;2021-04-04;104;1;82170;25592;13.6;4.2
37;2021-04-05;4;0;82174;25592;13.6;4.2
37;2021-04-06;2242;782;84416;26374;13.9;4.4
37;2021-04-07;3173;876;87589;27250;14.5;4.5
37;2021-04-08;4045;964;91634;28214;15.1;4.7
37;2021-04-09;4544;947;96178;29161;15.9;4.8
37;2021-04-10;1329;429;97507;29590;16.1;4.9
37;2021-04-11;104;1;97611;29591;16.1;4.9
37;2021-04-12;2642;676;100253;30267;16.6;5.0
37;2021-04-13;4114;1163;104367;31430;17.2;5.2
37;2021-04-14;3043;895;107410;32325;17.7;5.3
37;2021-04-15;3757;1018;111167;33343;18.4;5.5
37;2021-04-16;4358;1229;115525;34572;19.1;5.7
37;2021-04-17;1147;223;116672;34795;19.3;5.7
37;2021-04-18;97;3;116769;34798;19.3;5.7
37;2021-04-19;2481;847;119250;35645;19.7;5.9
37;2021-04-20;3233;1339;122483;36984;20.2;6.1
37;2021-04-21;2928;1155;125411;38139;20.7;6.3
37;2021-04-22;3456;1401;128867;39540;21.3;6.5
37;2021-04-23;3694;1814;132561;41354;21.9;6.8
37;2021-04-24;1007;385;133568;41739;22.1;6.9
37;2021-04-25;46;2;133614;41741;22.1;6.9
37;2021-04-26;2971;1337;136585;43078;22.6;7.1
37;2021-04-27;4186;1799;140771;44877;23.3;7.4
37;2021-04-28;3464;1951;144235;46828;23.8;7.7
37;2021-04-29;4586;2002;148821;48830;24.6;8.1
37;2021-04-30;5056;1951;153877;50781;25.4;8.4
37;2021-05-01;638;209;154515;50990;25.5;8.4
37;2021-05-02;104;15;154619;51005;25.5;8.4
37;2021-05-03;2672;1957;157291;52962;26.0;8.7
37;2021-05-04;3731;2703;161022;55665;26.6;9.2
37;2021-05-05;3498;2071;164520;57736;27.2;9.5
37;2021-05-06;4992;1945;169512;59681;28.0;9.9
37;2021-05-07;4685;2868;174197;62549;28.8;10.3
37;2021-05-08;538;312;174735;62861;28.9;10.4
37;2021-05-09;63;41;174798;62902;28.9;10.4
37;2021-05-10;2160;3480;176958;66382;29.2;11.0
37;2021-05-11;3868;3869;180826;70251;29.9;11.6
37;2021-05-12;4041;2538;184867;72789;30.5;12.0
37;2021-05-13;1139;515;186006;73304;30.7;12.1
37;2021-05-14;4046;2675;190052;75979;31.4;12.6
37;2021-05-15;2322;743;192374;76722;31.8;12.7
37;2021-05-16;22;70;192396;76792;31.8;12.7
37;2021-05-17;2765;2038;195161;78830;32.2;13.0
37;2021-05-18;3875;2359;199036;81189;32.9;13.4
37;2021-05-19;3495;1808;202531;82997;33.5;13.7
37;2021-05-20;4751;1769;207282;84766;34.2;14.0
37;2021-05-21;4525;2569;211807;87335;35.0;14.4
37;2021-05-22;1078;751;212885;88086;35.2;14.6
37;2021-05-23;73;89;212958;88175;35.2;14.6
37;2021-05-24;513;107;213471;88282;35.3;14.6
37;2021-05-25;5123;2176;218594;90458;36.1;14.9
37;2021-05-26;4930;2099;223524;92557;36.9;15.3
37;2021-05-27;5983;2355;229507;94912;37.9;15.7
37;2021-05-28;6019;3248;235526;98160;38.9;16.2
37;2021-05-29;1520;1164;237046;99324;39.2;16.4
37;2021-05-30;55;160;237101;99484;39.2;16.4
37;2021-05-31;3647;2519;240748;102003;39.8;16.8
37;2021-06-01;5841;3611;246589;105614;40.7;17.4
37;2021-06-02;5079;2450;251668;108064;41.6;17.9
37;2021-06-03;6086;2876;257754;110940;42.6;18.3
37;2021-06-04;5510;4202;263264;115142;43.5;19.0
37;2021-06-05;1853;1300;265117;116442;43.8;19.2
37;2021-06-06;49;197;265166;116639;43.8;19.3
37;2021-06-07;3021;4164;268187;120803;44.3;20.0
37;2021-06-08;4201;4644;272388;125447;45.0;20.7
37;2021-06-09;3883;3566;276271;129013;45.6;21.3
37;2021-06-10;5271;3615;281542;132628;46.5;21.9
37;2021-06-11;4972;4821;286514;137449;47.3;22.7
37;2021-06-12;3552;1347;290066;138796;47.9;22.9
37;2021-06-13;15;164;290081;138960;47.9;23.0
37;2021-06-14;2666;4032;292747;142992;48.4;23.6
37;2021-06-15;3898;4778;296645;147770;49.0;24.4
37;2021-06-16;3261;3599;299906;151369;49.5;25.0
37;2021-06-17;4013;4492;303919;155861;50.2;25.7
37;2021-06-18;4704;5068;308623;160929;51.0;26.6
37;2021-06-19;2519;1098;311142;162027;51.4;26.8
37;2021-06-20;10;183;311152;162210;51.4;26.8
37;2021-06-21;2417;3827;313569;166037;51.8;27.4
37;2021-06-22;2968;5003;316537;171040;52.3;28.3
37;2021-06-23;2625;3642;319162;174682;52.7;28.9
37;2021-06-24;2872;3540;322034;178222;53.2;29.4
37;2021-06-25;3308;4877;325342;183099;53.7;30.2
37;2021-06-26;1238;3084;326580;186183;53.9;30.8
37;2021-06-27;23;142;326603;186325;54.0;30.8
37;2021-06-28;1703;4508;328306;190833;54.2;31.5
37;2021-06-29;1904;6223;330210;197056;54.5;32.6
37;2021-06-30;1870;4441;332080;201497;54.9;33.3
37;2021-07-01;2124;4793;334204;206290;55.2;34.1
37;2021-07-02;2681;5589;336885;211879;55.6;35.0
37;2021-07-03;945;2138;337830;214017;55.8;35.4
37;2021-07-04;5;105;337835;214122;55.8;35.4
37;2021-07-05;1708;5132;339543;219254;56.1;36.2
37;2021-07-06;2003;6757;341546;226011;56.4;37.3
37;2021-07-07;1944;5465;343490;231476;56.7;38.2
37;2021-07-08;2465;6662;345955;238138;57.1;39.3
37;2021-07-09;1986;7640;347941;245778;57.5;40.6
37;2021-07-10;1016;2618;348957;248396;57.6;41.0
37;2021-07-11;26;96;348983;248492;57.6;41.0
37;2021-07-12;1130;5982;350113;254474;57.8;42.0
37;2021-07-13;1614;7815;351727;262289;58.1;43.3
37;2021-07-14;525;408;352252;262697;58.2;43.4
37;2021-07-15;2625;7498;354877;270195;58.6;44.6
37;2021-07-16;2757;7796;357634;277991;59.1;45.9
37;2021-07-17;1202;2444;358836;280435;59.3;46.3
37;2021-07-18;50;53;358886;280488;59.3;46.3
37;2021-07-19;1652;6127;360538;286615;59.6;47.3
37;2021-07-20;2906;7060;363444;293675;60.0;48.5
37;2021-07-21;2981;5783;366425;299458;60.5;49.5
37;2021-07-22;4057;6531;370482;305989;61.2;50.5
37;2021-07-23;3808;7102;374290;313091;61.8;51.7
37;2021-07-24;1775;3306;376065;316397;62.1;52.3
37;2021-07-25;66;77;376131;316474;62.1;52.3
37;2021-07-26;3236;4318;379367;320792;62.7;53.0
37;2021-07-27;4429;4960;383796;325752;63.4;53.8
37;2021-07-28;4138;3661;387934;329413;64.1;54.4
37;2021-07-29;5086;4196;393020;333609;64.9;55.1
37;2021-07-30;5247;4937;398267;338546;65.8;55.9
37;2021-07-31;1920;1845;400187;340391;66.1;56.2
37;2021-08-01;31;52;400218;340443;66.1;56.2
37;2021-08-02;3292;3291;403510;343734;66.7;56.8
37;2021-08-03;5262;3144;408772;346878;67.5;57.3
37;2021-08-04;4559;1925;413331;348803;68.3;57.6
37;2021-08-05;4788;2599;418119;351402;69.1;58.0
37;2021-08-06;4852;3305;422971;354707;69.9;58.6
37;2021-08-07;1626;1125;424597;355832;70.1;58.8
37;2021-08-08;34;177;424631;356009;70.1;58.8
37;2021-08-09;2435;2259;427066;358268;70.5;59.2
37;2021-08-10;3027;2639;430093;360907;71.0;59.6
37;2021-08-11;2099;2108;432192;363015;71.4;60.0
37;2021-08-12;2613;2692;434805;365707;71.8;60.4
37;2021-08-13;2484;2776;437289;368483;72.2;60.9
37;2021-08-14;755;814;438044;369297;72.4;61.0
37;2021-08-15;12;57;438056;369354;72.4;61.0
37;2021-08-16;1466;3160;439522;372514;72.6;61.5
37;2021-08-17;1796;3974;441318;376488;72.9;62.2
37;2021-08-18;1399;3141;442717;379629;73.1;62.7
37;2021-08-19;1598;3842;444315;383471;73.4;63.3
37;2021-08-20;1598;4553;445913;388024;73.7;64.1
37;2021-08-21;610;1201;446523;389225;73.8;64.3
37;2021-08-22;3;31;446526;389256;73.8;64.3
37;2021-08-23;1291;3985;447817;393241;74.0;65.0
37;2021-08-24;1541;4851;449358;398092;74.2;65.8
37;2021-08-25;1054;4223;450412;402315;74.4;66.5
37;2021-08-26;1278;4513;451690;406828;74.6;67.2
37;2021-08-27;1455;5663;453145;412491;74.9;68.1
37;2021-08-28;408;1462;453553;413953;74.9;68.4
37;2021-08-29;1;18;453554;413971;74.9;68.4
37;2021-08-30;1076;3945;454630;417916;75.1;69.0
37;2021-08-31;1280;3831;455910;421747;75.3;69.7
37;2021-09-01;977;2688;456887;424435;75.5;70.1
37;2021-09-02;896;2810;457783;427245;75.6;70.6
37;2021-09-03;1046;3962;458829;431207;75.8;71.2
37;2021-09-04;667;1463;459496;432670;75.9;71.5
37;2021-09-05;1;30;459497;432700;75.9;71.5
37;2021-09-06;377;1314;459874;434014;76.0;71.7
37;2021-09-07;536;1508;460410;435522;76.1;71.9
37;2021-09-08;819;2083;461229;437605;76.2;72.3
37;2021-09-09;556;1537;461785;439142;76.3;72.5
37;2021-09-10;816;1912;462601;441054;76.4;72.9
37;2021-09-11;400;1008;463001;442062;76.5;73.0
37;2021-09-12;15;24;463016;442086;76.5;73.0
37;2021-09-13;450;1405;463466;443491;76.6;73.3
37;2021-09-14;508;1520;463974;445011;76.6;73.5
37;2021-09-15;624;1478;464598;446489;76.7;73.8
37;2021-09-16;352;770;464950;447259;76.8;73.9
37;2021-09-17;633;1470;465583;448729;76.9;74.1
37;2021-09-18;306;841;465889;449570;77.0;74.3
37;2021-09-19;16;42;465905;449612;77.0;74.3
37;2021-09-20;270;681;466175;450293;77.0;74.4
37;2021-09-21;438;1323;466613;451616;77.1;74.6
37;2021-09-22;426;1288;467039;452904;77.1;74.8
37;2021-09-23;427;1046;467466;453950;77.2;75.0
37;2021-09-24;501;1406;467967;455356;77.3;75.2
37;2021-09-25;231;769;468198;456125;77.3;75.3
37;2021-09-26;1;22;468199;456147;77.3;75.3
37;2021-09-27;288;692;468487;456839;77.4;75.5
37;2021-09-28;396;661;468883;457500;77.5;75.6
37;2021-09-29;366;940;469249;458440;77.5;75.7
37;2021-09-30;371;494;469620;458934;77.6;75.8
37;2021-10-01;438;803;470058;459737;77.6;75.9
37;2021-10-02;222;560;470280;460297;77.7;76.0
37;2021-10-03;19;22;470299;460319;77.7;76.0
37;2021-10-04;259;519;470558;460838;77.7;76.1
37;2021-10-05;320;433;470878;461271;77.8;76.2
37;2021-10-06;369;698;471247;461969;77.8;76.3
38;2020-12-27;1;0;1;0;0.0;0.0
38;2020-12-28;1;0;2;0;0.0;0.0
38;2020-12-29;0;0;2;0;0.0;0.0
38;2020-12-30;2;0;4;0;0.0;0.0
38;2020-12-31;5;0;9;0;0.0;0.0
38;2021-01-01;4;0;13;0;0.0;0.0
38;2021-01-02;1;0;14;0;0.0;0.0
38;2021-01-03;3;0;17;0;0.0;0.0
38;2021-01-04;163;0;180;0;0.0;0.0
38;2021-01-05;258;1;438;1;0.0;0.0
38;2021-01-06;364;0;802;1;0.1;0.0
38;2021-01-07;636;1;1438;2;0.1;0.0
38;2021-01-08;695;0;2133;2;0.2;0.0
38;2021-01-09;30;0;2163;2;0.2;0.0
38;2021-01-10;2;0;2165;2;0.2;0.0
38;2021-01-11;801;1;2966;3;0.2;0.0
38;2021-01-12;1471;4;4437;7;0.4;0.0
38;2021-01-13;1084;5;5521;12;0.4;0.0
38;2021-01-14;1683;12;7204;24;0.6;0.0
38;2021-01-15;1675;7;8879;31;0.7;0.0
38;2021-01-16;307;1;9186;32;0.7;0.0
38;2021-01-17;3;0;9189;32;0.7;0.0
38;2021-01-18;1178;3;10367;35;0.8;0.0
38;2021-01-19;2242;5;12609;40;1.0;0.0
38;2021-01-20;1889;4;14498;44;1.1;0.0
38;2021-01-21;1644;7;16142;51;1.3;0.0
38;2021-01-22;1401;8;17543;59;1.4;0.0
38;2021-01-23;379;3;17922;62;1.4;0.0
38;2021-01-24;1;0;17923;62;1.4;0.0
38;2021-01-25;795;86;18718;148;1.5;0.0
38;2021-01-26;855;143;19573;291;1.5;0.0
38;2021-01-27;1093;230;20666;521;1.6;0.0
38;2021-01-28;1175;431;21841;952;1.7;0.1
38;2021-01-29;954;341;22795;1293;1.8;0.1
38;2021-01-30;304;0;23099;1293;1.8;0.1
38;2021-01-31;0;0;23099;1293;1.8;0.1
38;2021-02-01;703;550;23802;1843;1.9;0.1
38;2021-02-02;964;886;24766;2729;2.0;0.2
38;2021-02-03;1230;606;25996;3335;2.1;0.3
38;2021-02-04;1278;869;27274;4204;2.2;0.3
38;2021-02-05;1400;813;28674;5017;2.3;0.4
38;2021-02-06;188;80;28862;5097;2.3;0.4
38;2021-02-07;3;47;28865;5144;2.3;0.4
38;2021-02-08;862;644;29727;5788;2.3;0.5
38;2021-02-09;1537;1160;31264;6948;2.5;0.5
38;2021-02-10;1581;1152;32845;8100;2.6;0.6
38;2021-02-11;1871;1018;34716;9118;2.7;0.7
38;2021-02-12;1509;976;36225;10094;2.9;0.8
38;2021-02-13;467;164;36692;10258;2.9;0.8
38;2021-02-14;1;3;36693;10261;2.9;0.8
38;2021-02-15;976;749;37669;11010;3.0;0.9
38;2021-02-16;1379;801;39048;11811;3.1;0.9
38;2021-02-17;1376;872;40424;12683;3.2;1.0
38;2021-02-18;1791;899;42215;13582;3.3;1.1
38;2021-02-19;1255;680;43470;14262;3.4;1.1
38;2021-02-20;470;238;43940;14500;3.5;1.1
38;2021-02-21;1;0;43941;14500;3.5;1.1
38;2021-02-22;1075;708;45016;15208;3.6;1.2
38;2021-02-23;1542;799;46558;16007;3.7;1.3
38;2021-02-24;1741;972;48299;16979;3.8;1.3
38;2021-02-25;2500;889;50799;17868;4.0;1.4
38;2021-02-26;3311;839;54110;18707;4.3;1.5
38;2021-02-27;1511;352;55621;19059;4.4;1.5
38;2021-02-28;33;2;55654;19061;4.4;1.5
38;2021-03-01;2512;680;58166;19741;4.6;1.6
38;2021-03-02;4048;977;62214;20718;4.9;1.6
38;2021-03-03;3368;1129;65582;21847;5.2;1.7
38;2021-03-04;4489;1293;70071;23140;5.5;1.8
38;2021-03-05;5233;1081;75304;24221;6.0;1.9
38;2021-03-06;3043;261;78347;24482;6.2;1.9
38;2021-03-07;115;2;78462;24484;6.2;1.9
38;2021-03-08;2440;791;80902;25275;6.4;2.0
38;2021-03-09;4029;1204;84931;26479;6.7;2.1
38;2021-03-10;3508;996;88439;27475;7.0;2.2
38;2021-03-11;5142;1448;93581;28923;7.4;2.3
38;2021-03-12;7095;1129;100676;30052;8.0;2.4
38;2021-03-13;3771;224;104447;30276;8.3;2.4
38;2021-03-14;544;15;104991;30291;8.3;2.4
38;2021-03-15;2702;982;107693;31273;8.5;2.5
38;2021-03-16;2081;1274;109774;32547;8.7;2.6
38;2021-03-17;2025;1179;111799;33726;8.8;2.7
38;2021-03-18;2641;1340;114440;35066;9.0;2.8
38;2021-03-19;4008;1036;118448;36102;9.4;2.9
38;2021-03-20;1826;243;120274;36345;9.5;2.9
38;2021-03-21;132;8;120406;36353;9.5;2.9
38;2021-03-22;2866;984;123272;37337;9.7;3.0
38;2021-03-23;4780;1471;128052;38808;10.1;3.1
38;2021-03-24;3708;1539;131760;40347;10.4;3.2
38;2021-03-25;5791;1534;137551;41881;10.9;3.3
38;2021-03-26;6599;1738;144150;43619;11.4;3.4
38;2021-03-27;2513;756;146663;44375;11.6;3.5
38;2021-03-28;926;48;147589;44423;11.7;3.5
38;2021-03-29;2679;1835;150268;46258;11.9;3.7
38;2021-03-30;4564;2530;154832;48788;12.2;3.9
38;2021-03-31;3665;2219;158497;51007;12.5;4.0
38;2021-04-01;5136;2521;163633;53528;12.9;4.2
38;2021-04-02;3873;2517;167506;56045;13.2;4.4
38;2021-04-03;1418;938;168924;56983;13.4;4.5
38;2021-04-04;430;46;169354;57029;13.4;4.5
38;2021-04-05;2177;347;171531;57376;13.6;4.5
38;2021-04-06;4346;2399;175877;59775;13.9;4.7
38;2021-04-07;4415;2732;180292;62507;14.3;4.9
38;2021-04-08;5651;2665;185943;65172;14.7;5.2
38;2021-04-09;8562;2730;194505;67902;15.4;5.4
38;2021-04-10;3597;1479;198102;69381;15.7;5.5
38;2021-04-11;1048;100;199150;69481;15.7;5.5
38;2021-04-12;4203;2250;203353;71731;16.1;5.7
38;2021-04-13;6123;2469;209476;74200;16.6;5.9
38;2021-04-14;5116;2456;214592;76656;17.0;6.1
38;2021-04-15;6362;2767;220954;79423;17.5;6.3
38;2021-04-16;6213;2704;227167;82127;18.0;6.5
38;2021-04-17;2588;993;229755;83120;18.2;6.6
38;2021-04-18;1331;72;231086;83192;18.3;6.6
38;2021-04-19;3949;2836;235035;86028;18.6;6.8
38;2021-04-20;5425;2854;240460;88882;19.0;7.0
38;2021-04-21;4976;2705;245436;91587;19.4;7.2
38;2021-04-22;5790;2830;251226;94417;19.9;7.5
38;2021-04-23;6040;2821;257266;97238;20.3;7.7
38;2021-04-24;2665;1350;259931;98588;20.5;7.8
38;2021-04-25;805;590;260736;99178;20.6;7.8
38;2021-04-26;4487;2475;265223;101653;21.0;8.0
38;2021-04-27;6040;2719;271263;104372;21.4;8.3
38;2021-04-28;6198;2505;277461;106877;21.9;8.4
38;2021-04-29;8332;3064;285793;109941;22.6;8.7
38;2021-04-30;7674;4042;293467;113983;23.2;9.0
38;2021-05-01;1546;195;295013;114178;23.3;9.0
38;2021-05-02;847;74;295860;114252;23.4;9.0
38;2021-05-03;5300;3588;301160;117840;23.8;9.3
38;2021-05-04;6203;5082;307363;122922;24.3;9.7
38;2021-05-05;6067;4602;313430;127524;24.8;10.1
38;2021-05-06;6708;5328;320138;132852;25.3;10.5
38;2021-05-07;7284;6437;327422;139289;25.9;11.0
38;2021-05-08;3778;721;331200;140010;26.2;11.1
38;2021-05-09;2853;1931;334053;141941;26.4;11.2
38;2021-05-10;6157;5302;340210;147243;26.9;11.6
38;2021-05-11;8226;6016;348436;153259;27.5;12.1
38;2021-05-12;9044;4704;357480;157963;28.3;12.5
38;2021-05-13;6635;1417;364115;159380;28.8;12.6
38;2021-05-14;9566;3423;373681;162803;29.5;12.9
38;2021-05-15;6864;1450;380545;164253;30.1;13.0
38;2021-05-16;5474;650;386019;164903;30.5;13.0
38;2021-05-17;7671;3002;393690;167905;31.1;13.3
38;2021-05-18;8622;4032;402312;171937;31.8;13.6
38;2021-05-19;8157;3348;410469;175285;32.4;13.9
38;2021-05-20;8978;4492;419447;179777;33.2;14.2
38;2021-05-21;9960;4584;429407;184361;33.9;14.6
38;2021-05-22;7457;1907;436864;186268;34.5;14.7
38;2021-05-23;5589;580;442453;186848;35.0;14.8
38;2021-05-24;7503;1626;449956;188474;35.6;14.9
38;2021-05-25;9544;4850;459500;193324;36.3;15.3
38;2021-05-26;8126;4725;467626;198049;37.0;15.7
38;2021-05-27;9134;5657;476760;203706;37.7;16.1
38;2021-05-28;8786;6483;485546;210189;38.4;16.6
38;2021-05-29;5821;3246;491367;213435;38.8;16.9
38;2021-05-30;2695;1593;494062;215028;39.1;17.0
38;2021-05-31;8271;5131;502333;220159;39.7;17.4
38;2021-06-01;7964;6422;510297;226581;40.3;17.9
38;2021-06-02;7141;5615;517438;232196;40.9;18.4
38;2021-06-03;7393;6822;524831;239018;41.5;18.9
38;2021-06-04;8130;7610;532961;246628;42.1;19.5
38;2021-06-05;5794;3946;538755;250574;42.6;19.8
38;2021-06-06;2509;1463;541264;252037;42.8;19.9
38;2021-06-07;5554;6864;546818;258901;43.2;20.5
38;2021-06-08;5879;7523;552697;266424;43.7;21.1
38;2021-06-09;5048;6465;557745;272889;44.1;21.6
38;2021-06-10;5427;6789;563172;279678;44.5;22.1
38;2021-06-11;5888;7783;569060;287461;45.0;22.7
38;2021-06-12;3945;3259;573005;290720;45.3;23.0
38;2021-06-13;1256;1299;574261;292019;45.4;23.1
38;2021-06-14;3868;7661;578129;299680;45.7;23.7
38;2021-06-15;5233;8145;583362;307825;46.1;24.3
38;2021-06-16;5125;7403;588487;315228;46.5;24.9
38;2021-06-17;4523;7057;593010;322285;46.9;25.5
38;2021-06-18;6163;9227;599173;331512;47.4;26.2
38;2021-06-19;3596;4971;602769;336483;47.7;26.6
38;2021-06-20;1038;2901;603807;339384;47.7;26.8
38;2021-06-21;3748;8709;607555;348093;48.0;27.5
38;2021-06-22;3790;10103;611345;358196;48.3;28.3
38;2021-06-23;3155;9544;614500;367740;48.6;29.1
38;2021-06-24;3380;8587;617880;376327;48.8;29.7
38;2021-06-25;3786;11486;621666;387813;49.1;30.7
38;2021-06-26;2229;7851;623895;395664;49.3;31.3
38;2021-06-27;1098;4356;624993;400020;49.4;31.6
38;2021-06-28;2952;10302;627945;410322;49.6;32.4
38;2021-06-29;3784;10450;631729;420772;49.9;33.3
38;2021-06-30;4061;9943;635790;430715;50.3;34.0
38;2021-07-01;3547;9007;639337;439722;50.5;34.8
38;2021-07-02;3726;11616;643063;451338;50.8;35.7
38;2021-07-03;1739;8785;644802;460123;51.0;36.4
38;2021-07-04;1244;3209;646046;463332;51.1;36.6
38;2021-07-05;3058;10543;649104;473875;51.3;37.5
38;2021-07-06;3460;10236;652564;484111;51.6;38.3
38;2021-07-07;3569;9399;656133;493510;51.9;39.0
38;2021-07-08;3548;8221;659681;501731;52.1;39.7
38;2021-07-09;3897;10738;663578;512469;52.5;40.5
38;2021-07-10;2405;7801;665983;520270;52.6;41.1
38;2021-07-11;777;2030;666760;522300;52.7;41.3
38;2021-07-12;3483;10676;670243;532976;53.0;42.1
38;2021-07-13;6600;10932;676843;543908;53.5;43.0
38;2021-07-14;4670;3332;681513;547240;53.9;43.3
38;2021-07-15;8733;9667;690246;556907;54.6;44.0
38;2021-07-16;8759;10701;699005;567608;55.3;44.9
38;2021-07-17;4739;7485;703744;575093;55.6;45.5
38;2021-07-18;2570;2488;706314;577581;55.8;45.7
38;2021-07-19;5824;9220;712138;586801;56.3;46.4
38;2021-07-20;6289;8304;718427;595105;56.8;47.0
38;2021-07-21;7864;8027;726291;603132;57.4;47.7
38;2021-07-22;7599;6995;733890;610127;58.0;48.2
38;2021-07-23;8942;9043;742832;619170;58.7;48.9
38;2021-07-24;5577;5534;748409;624704;59.2;49.4
38;2021-07-25;2869;1654;751278;626358;59.4;49.5
38;2021-07-26;7869;7500;759147;633858;60.0;50.1
38;2021-07-27;7628;6275;766775;640133;60.6;50.6
38;2021-07-28;8621;5711;775396;645844;61.3;51.1
38;2021-07-29;7685;4682;783081;650526;61.9;51.4
38;2021-07-30;7810;6665;790891;657191;62.5;52.0
38;2021-07-31;4359;3604;795250;660795;62.9;52.2
38;2021-08-01;1298;1084;796548;661879;63.0;52.3
38;2021-08-02;3939;4453;800487;666332;63.3;52.7
38;2021-08-03;4590;4555;805077;670887;63.6;53.0
38;2021-08-04;4637;4354;809714;675241;64.0;53.4
38;2021-08-05;3741;4641;813455;679882;64.3;53.7
38;2021-08-06;4159;5949;817614;685831;64.6;54.2
38;2021-08-07;2319;3532;819933;689363;64.8;54.5
38;2021-08-08;791;2015;820724;691378;64.9;54.7
38;2021-08-09;3606;5576;824330;696954;65.2;55.1
38;2021-08-10;4918;6254;829248;703208;65.6;55.6
38;2021-08-11;3973;4665;833221;707873;65.9;56.0
38;2021-08-12;3394;4607;836615;712480;66.1;56.3
38;2021-08-13;4202;6033;840817;718513;66.5;56.8
38;2021-08-14;1784;4020;842601;722533;66.6;57.1
38;2021-08-15;538;1917;843139;724450;66.7;57.3
38;2021-08-16;2979;7924;846118;732374;66.9;57.9
38;2021-08-17;3445;5963;849563;738337;67.2;58.4
38;2021-08-18;2996;7140;852559;745477;67.4;58.9
38;2021-08-19;2614;4829;855173;750306;67.6;59.3
38;2021-08-20;2909;8429;858082;758735;67.8;60.0
38;2021-08-21;1206;5014;859288;763749;67.9;60.4
38;2021-08-22;509;1510;859797;765259;68.0;60.5
38;2021-08-23;2591;7627;862388;772886;68.2;61.1
38;2021-08-24;2568;5329;864956;778215;68.4;61.5
38;2021-08-25;2617;5876;867573;784091;68.6;62.0
38;2021-08-26;2280;4244;869853;788335;68.8;62.3
38;2021-08-27;2506;5931;872359;794266;69.0;62.8
38;2021-08-28;1423;3688;873782;797954;69.1;63.1
38;2021-08-29;376;1084;874158;799038;69.1;63.2
38;2021-08-30;2333;5783;876491;804821;69.3;63.6
38;2021-08-31;2221;4730;878712;809551;69.5;64.0
38;2021-09-01;2210;4376;880922;813927;69.6;64.3
38;2021-09-02;1669;3385;882591;817312;69.8;64.6
38;2021-09-03;2028;5076;884619;822388;69.9;65.0
38;2021-09-04;1153;2825;885772;825213;70.0;65.2
38;2021-09-05;391;724;886163;825937;70.1;65.3
38;2021-09-06;1196;3417;887359;829354;70.1;65.6
38;2021-09-07;1303;3374;888662;832728;70.3;65.8
38;2021-09-08;1728;3657;890390;836385;70.4;66.1
38;2021-09-09;1120;2361;891510;838746;70.5;66.3
38;2021-09-10;1592;3912;893102;842658;70.6;66.6
38;2021-09-11;1040;2396;894142;845054;70.7;66.8
38;2021-09-12;215;548;894357;845602;70.7;66.8
38;2021-09-13;908;2790;895265;848392;70.8;67.1
38;2021-09-14;915;2615;896180;851007;70.8;67.3
38;2021-09-15;1331;2761;897511;853768;71.0;67.5
38;2021-09-16;680;1554;898191;855322;71.0;67.6
38;2021-09-17;891;2501;899082;857823;71.1;67.8
38;2021-09-18;705;2220;899787;860043;71.1;68.0
38;2021-09-19;101;372;899888;860415;71.1;68.0
38;2021-09-20;598;1720;900486;862135;71.2;68.2
38;2021-09-21;491;1399;900977;863534;71.2;68.3
38;2021-09-22;688;2733;901665;866267;71.3;68.5
38;2021-09-23;446;1398;902111;867665;71.3;68.6
38;2021-09-24;772;2195;902883;869860;71.4;68.8
38;2021-09-25;493;1935;903376;871795;71.4;68.9
38;2021-09-26;94;378;903470;872173;71.4;68.9
38;2021-09-27;428;1228;903898;873401;71.5;69.0
38;2021-09-28;508;1116;904406;874517;71.5;69.1
38;2021-09-29;680;1905;905086;876422;71.5;69.3
38;2021-09-30;443;825;905529;877247;71.6;69.3
38;2021-10-01;606;1412;906135;878659;71.6;69.5
38;2021-10-02;481;1160;906616;879819;71.7;69.6
38;2021-10-03;94;193;906710;880012;71.7;69.6
38;2021-10-04;458;952;907168;880964;71.7;69.6
38;2021-10-05;405;870;907573;881834;71.7;69.7
38;2021-10-06;617;1248;908190;883082;71.8;69.8
39;2020-12-27;0;0;0;0;0.0;0.0
39;2020-12-28;0;0;0;0;0.0;0.0
39;2020-12-29;0;0;0;0;0.0;0.0
39;2020-12-30;0;0;0;0;0.0;0.0
39;2020-12-31;0;0;0;0;0.0;0.0
39;2021-01-01;0;0;0;0;0.0;0.0
39;2021-01-02;0;0;0;0;0.0;0.0
39;2021-01-03;0;0;0;0;0.0;0.0
39;2021-01-04;3;0;3;0;0.0;0.0
39;2021-01-05;3;0;6;0;0.0;0.0
39;2021-01-06;57;3;63;3;0.0;0.0
39;2021-01-07;333;2;396;5;0.2;0.0
39;2021-01-08;657;2;1053;7;0.4;0.0
39;2021-01-09;169;0;1222;7;0.5;0.0
39;2021-01-10;1;0;1223;7;0.5;0.0
39;2021-01-11;474;1;1697;8;0.7;0.0
39;2021-01-12;431;1;2128;9;0.8;0.0
39;2021-01-13;408;2;2536;11;1.0;0.0
39;2021-01-14;575;3;3111;14;1.2;0.0
39;2021-01-15;471;1;3582;15;1.4;0.0
39;2021-01-16;141;1;3723;16;1.4;0.0
39;2021-01-17;0;1;3723;17;1.4;0.0
39;2021-01-18;924;7;4647;24;1.8;0.0
39;2021-01-19;1181;6;5828;30;2.3;0.0
39;2021-01-20;905;4;6733;34;2.6;0.0
39;2021-01-21;1179;2;7912;36;3.1;0.0
39;2021-01-22;985;2;8897;38;3.5;0.0
39;2021-01-23;383;1;9280;39;3.6;0.0
39;2021-01-24;0;0;9280;39;3.6;0.0
39;2021-01-25;642;2;9922;41;3.8;0.0
39;2021-01-26;1123;11;11045;52;4.3;0.0
39;2021-01-27;928;16;11973;68;4.6;0.0
39;2021-01-28;741;232;12714;300;4.9;0.1
39;2021-01-29;583;410;13297;710;5.2;0.3
39;2021-01-30;265;105;13562;815;5.3;0.3
39;2021-01-31;1;0;13563;815;5.3;0.3
39;2021-02-01;562;251;14125;1066;5.5;0.4
39;2021-02-02;753;278;14878;1344;5.8;0.5
39;2021-02-03;531;497;15409;1841;6.0;0.7
39;2021-02-04;556;429;15965;2270;6.2;0.9
39;2021-02-05;438;403;16403;2673;6.4;1.0
39;2021-02-06;265;107;16668;2780;6.5;1.1
39;2021-02-07;0;1;16668;2781;6.5;1.1
39;2021-02-08;321;345;16989;3126;6.6;1.2
39;2021-02-09;383;464;17372;3590;6.7;1.4
39;2021-02-10;253;315;17625;3905;6.8;1.5
39;2021-02-11;586;500;18211;4405;7.1;1.7
39;2021-02-12;385;412;18596;4817;7.2;1.9
39;2021-02-13;100;62;18696;4879;7.3;1.9
39;2021-02-14;0;0;18696;4879;7.3;1.9
39;2021-02-15;99;663;18795;5542;7.3;2.1
39;2021-02-16;99;845;18894;6387;7.3;2.5
39;2021-02-17;58;630;18952;7017;7.4;2.7
39;2021-02-18;109;785;19061;7802;7.4;3.0
39;2021-02-19;100;438;19161;8240;7.4;3.2
39;2021-02-20;18;336;19179;8576;7.4;3.3
39;2021-02-21;0;0;19179;8576;7.4;3.3
39;2021-02-22;100;667;19279;9243;7.5;3.6
39;2021-02-23;4;716;19283;9959;7.5;3.9
39;2021-02-24;125;789;19408;10748;7.5;4.2
39;2021-02-25;214;700;19622;11448;7.6;4.4
39;2021-02-26;218;437;19840;11885;7.7;4.6
39;2021-02-27;169;264;20009;12149;7.8;4.7
39;2021-02-28;1;0;20010;12149;7.8;4.7
39;2021-03-01;218;606;20228;12755;7.8;4.9
39;2021-03-02;329;790;20557;13545;8.0;5.3
39;2021-03-03;602;513;21159;14058;8.2;5.5
39;2021-03-04;658;444;21817;14502;8.5;5.6
39;2021-03-05;670;307;22487;14809;8.7;5.7
39;2021-03-06;775;229;23262;15038;9.0;5.8
39;2021-03-07;242;84;23504;15122;9.1;5.9
39;2021-03-08;285;438;23789;15560;9.2;6.0
39;2021-03-09;844;448;24633;16008;9.6;6.2
39;2021-03-10;985;333;25618;16341;9.9;6.3
39;2021-03-11;829;449;26447;16790;10.3;6.5
39;2021-03-12;805;280;27252;17070;10.6;6.6
39;2021-03-13;789;103;28041;17173;10.9;6.7
39;2021-03-14;35;10;28076;17183;10.9;6.7
39;2021-03-15;513;107;28589;17290;11.1;6.7
39;2021-03-16;555;68;29144;17358;11.3;6.7
39;2021-03-17;611;56;29755;17414;11.5;6.8
39;2021-03-18;600;71;30355;17485;11.8;6.8
39;2021-03-19;393;68;30748;17553;11.9;6.8
39;2021-03-20;312;12;31060;17565;12.0;6.8
39;2021-03-21;3;0;31063;17565;12.0;6.8
39;2021-03-22;755;115;31818;17680;12.3;6.9
39;2021-03-23;1129;44;32947;17724;12.8;6.9
39;2021-03-24;1179;99;34126;17823;13.2;6.9
39;2021-03-25;2042;135;36168;17958;14.0;7.0
39;2021-03-26;797;115;36965;18073;14.3;7.0
39;2021-03-27;345;7;37310;18080;14.5;7.0
39;2021-03-28;36;4;37346;18084;14.5;7.0
39;2021-03-29;1036;194;38382;18278;14.9;7.1
39;2021-03-30;1400;268;39782;18546;15.4;7.2
39;2021-03-31;658;527;40440;19073;15.7;7.4
39;2021-04-01;1310;317;41750;19390;16.2;7.5
39;2021-04-02;626;129;42376;19519;16.4;7.6
39;2021-04-03;180;8;42556;19527;16.5;7.6
39;2021-04-04;4;1;42560;19528;16.5;7.6
39;2021-04-05;1;0;42561;19528;16.5;7.6
39;2021-04-06;824;634;43385;20162;16.8;7.8
39;2021-04-07;1134;681;44519;20843;17.3;8.1
39;2021-04-08;1790;580;46309;21423;18.0;8.3
39;2021-04-09;1675;293;47984;21716;18.6;8.4
39;2021-04-10;347;187;48331;21903;18.7;8.5
39;2021-04-11;2;0;48333;21903;18.7;8.5
39;2021-04-12;680;398;49013;22301;19.0;8.6
39;2021-04-13;1200;579;50213;22880;19.5;8.9
39;2021-04-14;845;640;51058;23520;19.8;9.1
39;2021-04-15;1479;722;52537;24242;20.4;9.4
39;2021-04-16;1090;176;53627;24418;20.8;9.5
39;2021-04-17;197;61;53824;24479;20.9;9.5
39;2021-04-18;0;0;53824;24479;20.9;9.5
39;2021-04-19;523;696;54347;25175;21.1;9.8
39;2021-04-20;766;547;55113;25722;21.4;10.0
39;2021-04-21;1143;723;56256;26445;21.8;10.3
39;2021-04-22;1012;1129;57268;27574;22.2;10.7
39;2021-04-23;457;364;57725;27938;22.4;10.8
39;2021-04-24;275;149;58000;28087;22.5;10.9
39;2021-04-25;12;3;58012;28090;22.5;10.9
39;2021-04-26;568;1040;58580;29130;22.7;11.3
39;2021-04-27;788;983;59368;30113;23.0;11.7
39;2021-04-28;1720;418;61088;30531;23.7;11.8
39;2021-04-29;2570;972;63658;31503;24.7;12.2
39;2021-04-30;2473;392;66131;31895;25.6;12.4
39;2021-05-01;41;53;66172;31948;25.7;12.4
39;2021-05-02;0;0;66172;31948;25.7;12.4
39;2021-05-03;917;811;67089;32759;26.0;12.7
39;2021-05-04;948;1122;68037;33881;26.4;13.1
39;2021-05-05;1954;882;69991;34763;27.1;13.5
39;2021-05-06;2425;1343;72416;36106;28.1;14.0
39;2021-05-07;1286;573;73702;36679;28.6;14.2
39;2021-05-08;179;55;73881;36734;28.7;14.2
39;2021-05-09;10;8;73891;36742;28.7;14.2
39;2021-05-10;1762;850;75653;37592;29.3;14.6
39;2021-05-11;1774;1514;77427;39106;30.0;15.2
39;2021-05-12;1810;1493;79237;40599;30.7;15.7
39;2021-05-13;246;23;79483;40622;30.8;15.8
39;2021-05-14;2392;335;81875;40957;31.8;15.9
39;2021-05-15;1848;255;83723;41212;32.5;16.0
39;2021-05-16;0;0;83723;41212;32.5;16.0
39;2021-05-17;1986;726;85709;41938;33.2;16.3
39;2021-05-18;1690;1180;87399;43118;33.9;16.7
39;2021-05-19;2496;555;89895;43673;34.9;16.9
39;2021-05-20;2465;756;92360;44429;35.8;17.2
39;2021-05-21;1800;561;94160;44990;36.5;17.4
39;2021-05-22;322;218;94482;45208;36.6;17.5
39;2021-05-23;8;36;94490;45244;36.6;17.5
39;2021-05-24;8;28;94498;45272;36.6;17.6
39;2021-05-25;1725;1197;96223;46469;37.3;18.0
39;2021-05-26;1643;1376;97866;47845;38.0;18.6
39;2021-05-27;1485;1623;99351;49468;38.5;19.2
39;2021-05-28;856;1219;100207;50687;38.9;19.7
39;2021-05-29;261;273;100468;50960;39.0;19.8
39;2021-05-30;2;40;100470;51000;39.0;19.8
39;2021-05-31;1625;1245;102095;52245;39.6;20.3
39;2021-06-01;1893;1321;103988;53566;40.3;20.8
39;2021-06-02;1706;1166;105694;54732;41.0;21.2
39;2021-06-03;1326;1158;107020;55890;41.5;21.7
39;2021-06-04;940;1070;107960;56960;41.9;22.1
39;2021-06-05;766;514;108726;57474;42.2;22.3
39;2021-06-06;1;36;108727;57510;42.2;22.3
39;2021-06-07;2106;918;110833;58428;43.0;22.7
39;2021-06-08;2209;1153;113042;59581;43.8;23.1
39;2021-06-09;1733;1240;114775;60821;44.5;23.6
39;2021-06-10;1616;2080;116391;62901;45.1;24.4
39;2021-06-11;1568;1270;117959;64171;45.7;24.9
39;2021-06-12;1264;350;119223;64521;46.2;25.0
39;2021-06-13;11;18;119234;64539;46.2;25.0
39;2021-06-14;1335;1889;120569;66428;46.8;25.8
39;2021-06-15;1386;1259;121955;67687;47.3;26.3
39;2021-06-16;1171;1532;123126;69219;47.8;26.8
39;2021-06-17;1044;1718;124170;70937;48.2;27.5
39;2021-06-18;1638;1180;125808;72117;48.8;28.0
39;2021-06-19;249;404;126057;72521;48.9;28.1
39;2021-06-20;2;18;126059;72539;48.9;28.1
39;2021-06-21;351;2495;126410;75034;49.0;29.1
39;2021-06-22;814;2293;127224;77327;49.3;30.0
39;2021-06-23;1200;1301;128424;78628;49.8;30.5
39;2021-06-24;736;1043;129160;79671;50.1;30.9
39;2021-06-25;679;2961;129839;82632;50.4;32.0
39;2021-06-26;206;1564;130045;84196;50.4;32.7
39;2021-06-27;0;0;130045;84196;50.4;32.7
39;2021-06-28;305;2743;130350;86939;50.6;33.7
39;2021-06-29;497;2697;130847;89636;50.7;34.8
39;2021-06-30;895;2424;131742;92060;51.1;35.7
39;2021-07-01;645;1939;132387;93999;51.3;36.5
39;2021-07-02;1111;1406;133498;95405;51.8;37.0
39;2021-07-03;554;524;134052;95929;52.0;37.2
39;2021-07-04;2;1;134054;95930;52.0;37.2
39;2021-07-05;602;2589;134656;98519;52.2;38.2
39;2021-07-06;835;1887;135491;100406;52.5;38.9
39;2021-07-07;591;1386;136082;101792;52.8;39.5
39;2021-07-08;700;906;136782;102698;53.0;39.8
39;2021-07-09;1078;1585;137860;104283;53.5;40.4
39;2021-07-10;739;476;138599;104759;53.8;40.6
39;2021-07-11;28;8;138627;104767;53.8;40.6
39;2021-07-12;577;2599;139204;107366;54.0;41.6
39;2021-07-13;1638;2660;140842;110026;54.6;42.7
39;2021-07-14;17;21;140859;110047;54.6;42.7
39;2021-07-15;1906;1838;142765;111885;55.4;43.4
39;2021-07-16;3226;2052;145991;113937;56.6;44.2
39;2021-07-17;2225;1163;148216;115100;57.5;44.6
39;2021-07-18;164;52;148380;115152;57.5;44.7
39;2021-07-19;1399;2950;149779;118102;58.1;45.8
39;2021-07-20;1842;2812;151621;120914;58.8;46.9
39;2021-07-21;2587;2581;154208;123495;59.8;47.9
39;2021-07-22;1934;1844;156142;125339;60.6;48.6
39;2021-07-23;1814;1933;157956;127272;61.3;49.4
39;2021-07-24;1400;1428;159356;128700;61.8;49.9
39;2021-07-25;0;1;159356;128701;61.8;49.9
39;2021-07-26;1318;2001;160674;130702;62.3;50.7
39;2021-07-27;2343;1905;163017;132607;63.2;51.4
39;2021-07-28;2688;1475;165705;134082;64.3;52.0
39;2021-07-29;2200;1743;167905;135825;65.1;52.7
39;2021-07-30;2045;1466;169950;137291;65.9;53.2
39;2021-07-31;1367;657;171317;137948;66.4;53.5
39;2021-08-01;10;18;171327;137966;66.4;53.5
39;2021-08-02;1205;1401;172532;139367;66.9;54.0
39;2021-08-03;1920;1486;174452;140853;67.7;54.6
39;2021-08-04;1047;659;175499;141512;68.1;54.9
39;2021-08-05;1242;740;176741;142252;68.5;55.2
39;2021-08-06;1375;2289;178116;144541;69.1;56.1
39;2021-08-07;1069;1213;179185;145754;69.5;56.5
39;2021-08-08;26;10;179211;145764;69.5;56.5
39;2021-08-09;436;304;179647;146068;69.7;56.6
39;2021-08-10;1230;931;180877;146999;70.1;57.0
39;2021-08-11;893;1532;181770;148531;70.5;57.6
39;2021-08-12;1596;2170;183366;150701;71.1;58.4
39;2021-08-13;1334;2119;184700;152820;71.6;59.3
39;2021-08-14;361;1106;185061;153926;71.8;59.7
39;2021-08-15;1;1;185062;153927;71.8;59.7
39;2021-08-16;488;736;185550;154663;72.0;60.0
39;2021-08-17;574;1443;186124;156106;72.2;60.5
39;2021-08-18;862;1727;186986;157833;72.5;61.2
39;2021-08-19;906;1593;187892;159426;72.9;61.8
39;2021-08-20;639;2500;188531;161926;73.1;62.8
39;2021-08-21;467;1291;188998;163217;73.3;63.3
39;2021-08-22;7;11;189005;163228;73.3;63.3
39;2021-08-23;267;972;189272;164200;73.4;63.7
39;2021-08-24;456;1607;189728;165807;73.6;64.3
39;2021-08-25;630;1604;190358;167411;73.8;64.9
39;2021-08-26;717;1860;191075;169271;74.1;65.6
39;2021-08-27;405;2060;191480;171331;74.3;66.4
39;2021-08-28;325;1369;191805;172700;74.4;67.0
39;2021-08-29;0;1;191805;172701;74.4;67.0
39;2021-08-30;345;1018;192150;173719;74.5;67.4
39;2021-08-31;399;1036;192549;174755;74.7;67.8
39;2021-09-01;512;1580;193061;176335;74.9;68.4
39;2021-09-02;332;1418;193393;177753;75.0;68.9
39;2021-09-03;476;2312;193869;180065;75.2;69.8
39;2021-09-04;148;198;194017;180263;75.2;69.9
39;2021-09-05;0;1;194017;180264;75.2;69.9
39;2021-09-06;239;502;194256;180766;75.3;70.1
39;2021-09-07;228;344;194484;181110;75.4;70.2
39;2021-09-08;441;779;194925;181889;75.6;70.5
39;2021-09-09;431;1119;195356;183008;75.8;71.0
39;2021-09-10;198;737;195554;183745;75.8;71.3
39;2021-09-11;282;889;195836;184634;75.9;71.6
39;2021-09-12;0;32;195836;184666;75.9;71.6
39;2021-09-13;142;221;195978;184887;76.0;71.7
39;2021-09-14;182;414;196160;185301;76.1;71.9
39;2021-09-15;266;585;196426;185886;76.2;72.1
39;2021-09-16;468;1052;196894;186938;76.4;72.5
39;2021-09-17;420;667;197314;187605;76.5;72.8
39;2021-09-18;96;237;197410;187842;76.6;72.8
39;2021-09-19;3;3;197413;187845;76.6;72.9
39;2021-09-20;70;128;197483;187973;76.6;72.9
39;2021-09-21;87;125;197570;188098;76.6;72.9
39;2021-09-22;268;777;197838;188875;76.7;73.3
39;2021-09-23;173;312;198011;189187;76.8;73.4
39;2021-09-24;206;584;198217;189771;76.9;73.6
39;2021-09-25;65;250;198282;190021;76.9;73.7
39;2021-09-26;0;0;198282;190021;76.9;73.7
39;2021-09-27;131;318;198413;190339;76.9;73.8
39;2021-09-28;55;138;198468;190477;77.0;73.9
39;2021-09-29;195;511;198663;190988;77.0;74.1
39;2021-09-30;201;448;198864;191436;77.1;74.2
39;2021-10-01;104;199;198968;191635;77.2;74.3
39;2021-10-02;97;228;199065;191863;77.2;74.4
39;2021-10-03;2;1;199067;191864;77.2;74.4
39;2021-10-04;39;131;199106;191995;77.2;74.5
39;2021-10-05;55;125;199161;192120;77.2;74.5
39;2021-10-06;180;345;199341;192465;77.3;74.6
40;2020-12-27;0;0;0;0;0.0;0.0
40;2020-12-28;0;0;0;0;0.0;0.0
40;2020-12-29;0;0;0;0;0.0;0.0
40;2020-12-30;0;0;0;0;0.0;0.0
40;2020-12-31;1;0;1;0;0.0;0.0
40;2021-01-01;0;0;1;0;0.0;0.0
40;2021-01-02;1;0;2;0;0.0;0.0
40;2021-01-03;0;0;2;0;0.0;0.0
40;2021-01-04;0;0;2;0;0.0;0.0
40;2021-01-05;0;0;2;0;0.0;0.0
40;2021-01-06;1;0;3;0;0.0;0.0
40;2021-01-07;212;0;215;0;0.1;0.0
40;2021-01-08;391;2;606;2;0.1;0.0
40;2021-01-09;0;0;606;2;0.1;0.0
40;2021-01-10;1;0;607;2;0.1;0.0
40;2021-01-11;111;0;718;2;0.2;0.0
40;2021-01-12;0;0;718;2;0.2;0.0
40;2021-01-13;681;5;1399;7;0.3;0.0
40;2021-01-14;901;7;2300;14;0.6;0.0
40;2021-01-15;811;3;3111;17;0.8;0.0
40;2021-01-16;157;0;3268;17;0.8;0.0
40;2021-01-17;1;1;3269;18;0.8;0.0
40;2021-01-18;406;0;3675;18;0.9;0.0
40;2021-01-19;1203;3;4878;21;1.2;0.0
40;2021-01-20;881;2;5759;23;1.4;0.0
40;2021-01-21;1265;5;7024;28;1.7;0.0
40;2021-01-22;811;2;7835;30;1.9;0.0
40;2021-01-23;289;0;8124;30;2.0;0.0
40;2021-01-24;2;0;8126;30;2.0;0.0
40;2021-01-25;394;2;8520;32;2.1;0.0
40;2021-01-26;802;5;9322;37;2.3;0.0
40;2021-01-27;1118;11;10440;48;2.5;0.0
40;2021-01-28;709;109;11149;157;2.7;0.0
40;2021-01-29;601;225;11750;382;2.9;0.1
40;2021-01-30;237;3;11987;385;2.9;0.1
40;2021-01-31;1;0;11988;385;2.9;0.1
40;2021-02-01;359;127;12347;512;3.0;0.1
40;2021-02-02;922;50;13269;562;3.2;0.1
40;2021-02-03;895;294;14164;856;3.4;0.2
40;2021-02-04;1059;543;15223;1399;3.7;0.3
40;2021-02-05;794;333;16017;1732;3.9;0.4
40;2021-02-06;382;81;16399;1813;4.0;0.4
40;2021-02-07;10;0;16409;1813;4.0;0.4
40;2021-02-08;375;103;16784;1916;4.1;0.5
40;2021-02-09;813;499;17597;2415;4.3;0.6
40;2021-02-10;749;394;18346;2809;4.5;0.7
40;2021-02-11;739;556;19085;3365;4.6;0.8
40;2021-02-12;627;570;19712;3935;4.8;1.0
40;2021-02-13;400;82;20112;4017;4.9;1.0
40;2021-02-14;0;0;20112;4017;4.9;1.0
40;2021-02-15;48;318;20160;4335;4.9;1.1
40;2021-02-16;284;487;20444;4822;5.0;1.2
40;2021-02-17;359;804;20803;5626;5.0;1.4
40;2021-02-18;383;587;21186;6213;5.1;1.5
40;2021-02-19;145;551;21331;6764;5.2;1.6
40;2021-02-20;39;80;21370;6844;5.2;1.7
40;2021-02-21;1;63;21371;6907;5.2;1.7
40;2021-02-22;53;453;21424;7360;5.2;1.8
40;2021-02-23;180;688;21604;8048;5.2;2.0
40;2021-02-24;283;570;21887;8618;5.3;2.1
40;2021-02-25;726;861;22613;9479;5.5;2.3
40;2021-02-26;656;518;23269;9997;5.6;2.4
40;2021-02-27;384;91;23653;10088;5.7;2.4
40;2021-02-28;2;0;23655;10088;5.7;2.4
40;2021-03-01;418;443;24073;10531;5.8;2.6
40;2021-03-02;733;863;24806;11394;6.0;2.8
40;2021-03-03;934;760;25740;12154;6.2;3.0
40;2021-03-04;1326;722;27066;12876;6.6;3.1
40;2021-03-05;1233;645;28299;13521;6.9;3.3
40;2021-03-06;868;338;29167;13859;7.1;3.4
40;2021-03-07;92;2;29259;13861;7.1;3.4
40;2021-03-08;838;435;30097;14296;7.3;3.5
40;2021-03-09;1506;555;31603;14851;7.7;3.6
40;2021-03-10;1754;672;33357;15523;8.1;3.8
40;2021-03-11;1986;631;35343;16154;8.6;3.9
40;2021-03-12;2051;519;37394;16673;9.1;4.0
40;2021-03-13;972;245;38366;16918;9.3;4.1
40;2021-03-14;98;0;38464;16918;9.3;4.1
40;2021-03-15;924;87;39388;17005;9.6;4.1
40;2021-03-16;988;260;40376;17265;9.8;4.2
40;2021-03-17;1577;335;41953;17600;10.2;4.3
40;2021-03-18;1559;332;43512;17932;10.6;4.4
40;2021-03-19;1808;140;45320;18072;11.0;4.4
40;2021-03-20;706;14;46026;18086;11.2;4.4
40;2021-03-21;52;1;46078;18087;11.2;4.4
40;2021-03-22;1174;35;47252;18122;11.5;4.4
40;2021-03-23;2325;167;49577;18289;12.0;4.4
40;2021-03-24;2327;232;51904;18521;12.6;4.5
40;2021-03-25;2768;380;54672;18901;13.3;4.6
40;2021-03-26;3123;202;57795;19103;14.0;4.6
40;2021-03-27;923;47;58718;19150;14.3;4.6
40;2021-03-28;178;47;58896;19197;14.3;4.7
40;2021-03-29;1153;374;60049;19571;14.6;4.8
40;2021-03-30;2298;387;62347;19958;15.1;4.8
40;2021-03-31;1994;300;64341;20258;15.6;4.9
40;2021-04-01;2413;333;66754;20591;16.2;5.0
40;2021-04-02;2361;219;69115;20810;16.8;5.1
40;2021-04-03;741;120;69856;20930;17.0;5.1
40;2021-04-04;362;8;70218;20938;17.0;5.1
40;2021-04-05;523;40;70741;20978;17.2;5.1
40;2021-04-06;2095;802;72836;21780;17.7;5.3
40;2021-04-07;2664;869;75500;22649;18.3;5.5
40;2021-04-08;3063;896;78563;23545;19.1;5.7
40;2021-04-09;3826;604;82389;24149;20.0;5.9
40;2021-04-10;1599;341;83988;24490;20.4;5.9
40;2021-04-11;52;6;84040;24496;20.4;5.9
40;2021-04-12;2178;728;86218;25224;20.9;6.1
40;2021-04-13;2567;1089;88785;26313;21.6;6.4
40;2021-04-14;2571;1375;91356;27688;22.2;6.7
40;2021-04-15;2987;1505;94343;29193;22.9;7.1
40;2021-04-16;2878;1180;97221;30373;23.6;7.4
40;2021-04-17;1464;345;98685;30718;24.0;7.5
40;2021-04-18;57;24;98742;30742;24.0;7.5
40;2021-04-19;1056;1019;99798;31761;24.2;7.7
40;2021-04-20;1622;1743;101420;33504;24.6;8.1
40;2021-04-21;1777;1734;103197;35238;25.0;8.6
40;2021-04-22;2112;1771;105309;37009;25.6;9.0
40;2021-04-23;2163;1390;107472;38399;26.1;9.3
40;2021-04-24;1329;623;108801;39022;26.4;9.5
40;2021-04-25;37;57;108838;39079;26.4;9.5
40;2021-04-26;1251;1133;110089;40212;26.7;9.8
40;2021-04-27;1487;2030;111576;42242;27.1;10.3
40;2021-04-28;2052;1365;113628;43607;27.6;10.6
40;2021-04-29;2609;1888;116237;45495;28.2;11.0
40;2021-04-30;2701;1613;118938;47108;28.9;11.4
40;2021-05-01;1228;781;120166;47889;29.2;11.6
40;2021-05-02;143;322;120309;48211;29.2;11.7
40;2021-05-03;1857;1498;122166;49709;29.7;12.1
40;2021-05-04;1880;2465;124046;52174;30.1;12.7
40;2021-05-05;2187;2668;126233;54842;30.6;13.3
40;2021-05-06;2237;2864;128470;57706;31.2;14.0
40;2021-05-07;1902;3003;130372;60709;31.6;14.7
40;2021-05-08;675;469;131047;61178;31.8;14.8
40;2021-05-09;316;22;131363;61200;31.9;14.9
40;2021-05-10;1400;2040;132763;63240;32.2;15.4
40;2021-05-11;2196;2504;134959;65744;32.8;16.0
40;2021-05-12;2731;1943;137690;67687;33.4;16.4
40;2021-05-13;1984;511;139674;68198;33.9;16.6
40;2021-05-14;2324;1657;141998;69855;34.5;17.0
40;2021-05-15;1340;961;143338;70816;34.8;17.2
40;2021-05-16;434;24;143772;70840;34.9;17.2
40;2021-05-17;2119;1305;145891;72145;35.4;17.5
40;2021-05-18;2508;1404;148399;73549;36.0;17.9
40;2021-05-19;2954;1105;151353;74654;36.7;18.1
40;2021-05-20;3584;1159;154937;75813;37.6;18.4
40;2021-05-21;2925;1319;157862;77132;38.3;18.7
40;2021-05-22;1146;794;159008;77926;38.6;18.9
40;2021-05-23;631;29;159639;77955;38.7;18.9
40;2021-05-24;1212;332;160851;78287;39.0;19.0
40;2021-05-25;2168;1310;163019;79597;39.6;19.3
40;2021-05-26;2614;1562;165633;81159;40.2;19.7
40;2021-05-27;2733;1998;168366;83157;40.9;20.2
40;2021-05-28;2567;2270;170933;85427;41.5;20.7
40;2021-05-29;1558;1252;172491;86679;41.9;21.0
40;2021-05-30;4;52;172495;86731;41.9;21.1
40;2021-05-31;2567;1207;175062;87938;42.5;21.3
40;2021-06-01;3011;1766;178073;89704;43.2;21.8
40;2021-06-02;3170;1988;181243;91692;44.0;22.3
40;2021-06-03;3589;2329;184832;94021;44.9;22.8
40;2021-06-04;3015;2802;187847;96823;45.6;23.5
40;2021-06-05;1780;1395;189627;98218;46.0;23.8
40;2021-06-06;458;79;190085;98297;46.1;23.9
40;2021-06-07;2184;2021;192269;100318;46.7;24.4
40;2021-06-08;2954;2096;195223;102414;47.4;24.9
40;2021-06-09;3212;2266;198435;104680;48.2;25.4
40;2021-06-10;2993;2097;201428;106777;48.9;25.9
40;2021-06-11;3142;2793;204570;109570;49.7;26.6
40;2021-06-12;1963;1634;206533;111204;50.1;27.0
40;2021-06-13;645;162;207178;111366;50.3;27.0
40;2021-06-14;1457;2494;208635;113860;50.6;27.6
40;2021-06-15;2235;2818;210870;116678;51.2;28.3
40;2021-06-16;2608;2459;213478;119137;51.8;28.9
40;2021-06-17;2431;2439;215909;121576;52.4;29.5
40;2021-06-18;2326;2902;218235;124478;53.0;30.2
40;2021-06-19;1798;1225;220033;125703;53.4;30.5
40;2021-06-20;346;276;220379;125979;53.5;30.6
40;2021-06-21;1395;2317;221774;128296;53.8;31.1
40;2021-06-22;1690;2995;223464;131291;54.2;31.9
40;2021-06-23;1603;3343;225067;134634;54.6;32.7
40;2021-06-24;1733;2384;226800;137018;55.1;33.3
40;2021-06-25;1757;3258;228557;140276;55.5;34.0
40;2021-06-26;1328;1712;229885;141988;55.8;34.5
40;2021-06-27;262;354;230147;142342;55.9;34.6
40;2021-06-28;1334;2818;231481;145160;56.2;35.2
40;2021-06-29;1712;3392;233193;148552;56.6;36.1
40;2021-06-30;1773;3638;234966;152190;57.0;36.9
40;2021-07-01;1714;3952;236680;156142;57.4;37.9
40;2021-07-02;1561;3809;238241;159951;57.8;38.8
40;2021-07-03;676;1919;238917;161870;58.0;39.3
40;2021-07-04;219;483;239136;162353;58.0;39.4
40;2021-07-05;1477;3020;240613;165373;58.4;40.1
40;2021-07-06;1768;3613;242381;168986;58.8;41.0
40;2021-07-07;1973;3847;244354;172833;59.3;42.0
40;2021-07-08;2099;3408;246453;176241;59.8;42.8
40;2021-07-09;2108;3946;248561;180187;60.3;43.7
40;2021-07-10;1004;2156;249565;182343;60.6;44.3
40;2021-07-11;207;294;249772;182637;60.6;44.3
40;2021-07-12;1314;4046;251086;186683;60.9;45.3
40;2021-07-13;2428;4697;253514;191380;61.5;46.5
40;2021-07-14;2198;2060;255712;193440;62.1;47.0
40;2021-07-15;2842;4860;258554;198300;62.8;48.1
40;2021-07-16;3311;3943;261865;202243;63.6;49.1
40;2021-07-17;2110;2595;263975;204838;64.1;49.7
40;2021-07-18;472;542;264447;205380;64.2;49.9
40;2021-07-19;2565;3697;267012;209077;64.8;50.7
40;2021-07-20;3065;4050;270077;213127;65.6;51.7
40;2021-07-21;3204;3887;273281;217014;66.3;52.7
40;2021-07-22;3857;3933;277138;220947;67.3;53.6
40;2021-07-23;4092;4110;281230;225057;68.3;54.6
40;2021-07-24;2795;2113;284025;227170;68.9;55.1
40;2021-07-25;958;491;284983;227661;69.2;55.3
40;2021-07-26;2943;3076;287926;230737;69.9;56.0
40;2021-07-27;3526;3602;291452;234339;70.7;56.9
40;2021-07-28;3379;3396;294831;237735;71.6;57.7
40;2021-07-29;3546;3432;298377;241167;72.4;58.5
40;2021-07-30;3137;3405;301514;244572;73.2;59.4
40;2021-07-31;1781;1907;303295;246479;73.6;59.8
40;2021-08-01;342;287;303637;246766;73.7;59.9
40;2021-08-02;2004;2382;305641;249148;74.2;60.5
40;2021-08-03;2335;2695;307976;251843;74.8;61.1
40;2021-08-04;2094;2323;310070;254166;75.3;61.7
40;2021-08-05;1971;2669;312041;256835;75.7;62.3
40;2021-08-06;1886;3067;313927;259902;76.2;63.1
40;2021-08-07;1218;1746;315145;261648;76.5;63.5
40;2021-08-08;84;154;315229;261802;76.5;63.5
40;2021-08-09;1600;3124;316829;264926;76.9;64.3
40;2021-08-10;1429;3159;318258;268085;77.3;65.1
40;2021-08-11;1421;2844;319679;270929;77.6;65.8
40;2021-08-12;1277;3102;320956;274031;77.9;66.5
40;2021-08-13;1139;2980;322095;277011;78.2;67.2
40;2021-08-14;618;2033;322713;279044;78.3;67.7
40;2021-08-15;5;172;322718;279216;78.3;67.8
40;2021-08-16;1108;3383;323826;282599;78.6;68.6
40;2021-08-17;1159;3418;324985;286017;78.9;69.4
40;2021-08-18;989;3258;325974;289275;79.1;70.2
40;2021-08-19;855;2972;326829;292247;79.3;70.9
40;2021-08-20;811;3033;327640;295280;79.5;71.7
40;2021-08-21;523;1901;328163;297181;79.7;72.1
40;2021-08-22;71;464;328234;297645;79.7;72.2
40;2021-08-23;730;2818;328964;300463;79.8;72.9
40;2021-08-24;697;2540;329661;303003;80.0;73.5
40;2021-08-25;678;2002;330339;305005;80.2;74.0
40;2021-08-26;493;1674;330832;306679;80.3;74.4
40;2021-08-27;638;2468;331470;309147;80.5;75.0
40;2021-08-28;328;1215;331798;310362;80.5;75.3
40;2021-08-29;1;9;331799;310371;80.5;75.3
40;2021-08-30;600;2160;332399;312531;80.7;75.9
40;2021-08-31;469;1466;332868;313997;80.8;76.2
40;2021-09-01;449;1548;333317;315545;80.9;76.6
40;2021-09-02;403;1501;333720;317046;81.0;77.0
40;2021-09-03;441;1631;334161;318677;81.1;77.4
40;2021-09-04;369;1187;334530;319864;81.2;77.6
40;2021-09-05;4;26;334534;319890;81.2;77.6
40;2021-09-06;244;880;334778;320770;81.3;77.9
40;2021-09-07;293;977;335071;321747;81.3;78.1
40;2021-09-08;422;1237;335493;322984;81.4;78.4
40;2021-09-09;263;1038;335756;324022;81.5;78.7
40;2021-09-10;358;1279;336114;325301;81.6;79.0
40;2021-09-11;248;887;336362;326188;81.6;79.2
40;2021-09-12;8;8;336370;326196;81.6;79.2
40;2021-09-13;371;951;336741;327147;81.7;79.4
40;2021-09-14;292;885;337033;328032;81.8;79.6
40;2021-09-15;444;895;337477;328927;81.9;79.8
40;2021-09-16;238;348;337715;329275;82.0;79.9
40;2021-09-17;365;788;338080;330063;82.1;80.1
40;2021-09-18;179;634;338259;330697;82.1;80.3
40;2021-09-19;0;9;338259;330706;82.1;80.3
40;2021-09-20;151;382;338410;331088;82.1;80.4
40;2021-09-21;149;286;338559;331374;82.2;80.4
40;2021-09-22;229;559;338788;331933;82.2;80.6
40;2021-09-23;164;297;338952;332230;82.3;80.6
40;2021-09-24;237;606;339189;332836;82.3;80.8
40;2021-09-25;134;427;339323;333263;82.4;80.9
40;2021-09-26;0;2;339323;333265;82.4;80.9
40;2021-09-27;86;224;339409;333489;82.4;80.9
40;2021-09-28;82;229;339491;333718;82.4;81.0
40;2021-09-29;204;584;339695;334302;82.5;81.1
40;2021-09-30;98;221;339793;334523;82.5;81.2
40;2021-10-01;225;437;340018;334960;82.5;81.3
40;2021-10-02;180;321;340198;335281;82.6;81.4
40;2021-10-03;0;2;340198;335283;82.6;81.4
40;2021-10-04;122;241;340320;335524;82.6;81.4
40;2021-10-05;75;200;340395;335724;82.6;81.5
40;2021-10-06;248;456;340643;336180;82.7;81.6
41;2020-12-27;0;0;0;0;0.0;0.0
41;2020-12-28;0;0;0;0;0.0;0.0
41;2020-12-29;0;0;0;0;0.0;0.0
41;2020-12-30;0;0;0;0;0.0;0.0
41;2020-12-31;0;0;0;0;0.0;0.0
41;2021-01-01;0;0;0;0;0.0;0.0
41;2021-01-02;2;0;2;0;0.0;0.0
41;2021-01-03;0;0;2;0;0.0;0.0
41;2021-01-04;0;0;2;0;0.0;0.0
41;2021-01-05;35;0;37;0;0.0;0.0
41;2021-01-06;71;0;108;0;0.0;0.0
41;2021-01-07;21;0;129;0;0.0;0.0
41;2021-01-08;1;0;130;0;0.0;0.0
41;2021-01-09;0;0;130;0;0.0;0.0
41;2021-01-10;0;0;130;0;0.0;0.0
41;2021-01-11;133;0;263;0;0.1;0.0
41;2021-01-12;321;1;584;1;0.2;0.0
41;2021-01-13;271;0;855;1;0.3;0.0
41;2021-01-14;284;1;1139;2;0.3;0.0
41;2021-01-15;215;1;1354;3;0.4;0.0
41;2021-01-16;0;0;1354;3;0.4;0.0
41;2021-01-17;0;0;1354;3;0.4;0.0
41;2021-01-18;397;2;1751;5;0.5;0.0
41;2021-01-19;857;2;2608;7;0.8;0.0
41;2021-01-20;1059;3;3667;10;1.1;0.0
41;2021-01-21;1568;2;5235;12;1.6;0.0
41;2021-01-22;840;1;6075;13;1.9;0.0
41;2021-01-23;92;0;6167;13;1.9;0.0
41;2021-01-24;0;0;6167;13;1.9;0.0
41;2021-01-25;421;1;6588;14;2.0;0.0
41;2021-01-26;473;3;7061;17;2.2;0.0
41;2021-01-27;441;2;7502;19;2.3;0.0
41;2021-01-28;604;56;8106;75;2.5;0.0
41;2021-01-29;260;13;8366;88;2.6;0.0
41;2021-01-30;0;0;8366;88;2.6;0.0
41;2021-01-31;0;0;8366;88;2.6;0.0
41;2021-02-01;349;121;8715;209;2.7;0.1
41;2021-02-02;470;216;9185;425;2.8;0.1
41;2021-02-03;342;200;9527;625;2.9;0.2
41;2021-02-04;559;136;10086;761;3.1;0.2
41;2021-02-05;329;167;10415;928;3.2;0.3
41;2021-02-06;5;0;10420;928;3.2;0.3
41;2021-02-07;2;0;10422;928;3.2;0.3
41;2021-02-08;305;273;10727;1201;3.3;0.4
41;2021-02-09;599;410;11326;1611;3.5;0.5
41;2021-02-10;486;671;11812;2282;3.6;0.7
41;2021-02-11;1066;1152;12878;3434;3.9;1.0
41;2021-02-12;688;355;13566;3789;4.1;1.2
41;2021-02-13;9;5;13575;3794;4.1;1.2
41;2021-02-14;3;27;13578;3821;4.1;1.2
41;2021-02-15;314;259;13892;4080;4.2;1.2
41;2021-02-16;354;468;14246;4548;4.3;1.4
41;2021-02-17;317;400;14563;4948;4.4;1.5
41;2021-02-18;617;267;15180;5215;4.6;1.6
41;2021-02-19;456;279;15636;5494;4.8;1.7
41;2021-02-20;68;37;15704;5531;4.8;1.7
41;2021-02-21;0;0;15704;5531;4.8;1.7
41;2021-02-22;311;332;16015;5863;4.9;1.8
41;2021-02-23;454;270;16469;6133;5.0;1.9
41;2021-02-24;282;365;16751;6498;5.1;2.0
41;2021-02-25;675;383;17426;6881;5.3;2.1
41;2021-02-26;630;220;18056;7101;5.5;2.2
41;2021-02-27;161;4;18217;7105;5.6;2.2
41;2021-02-28;4;31;18221;7136;5.6;2.2
41;2021-03-01;311;260;18532;7396;5.7;2.3
41;2021-03-02;649;336;19181;7732;5.9;2.4
41;2021-03-03;496;366;19677;8098;6.0;2.5
41;2021-03-04;785;749;20462;8847;6.2;2.7
41;2021-03-05;840;638;21302;9485;6.5;2.9
41;2021-03-06;715;22;22017;9507;6.7;2.9
41;2021-03-07;498;18;22515;9525;6.9;2.9
41;2021-03-08;301;333;22816;9858;7.0;3.0
41;2021-03-09;1042;401;23858;10259;7.3;3.1
41;2021-03-10;721;440;24579;10699;7.5;3.3
41;2021-03-11;1181;636;25760;11335;7.9;3.5
41;2021-03-12;1115;398;26875;11733;8.2;3.6
41;2021-03-13;1224;19;28099;11752;8.6;3.6
41;2021-03-14;392;7;28491;11759;8.7;3.6
41;2021-03-15;798;340;29289;12099;8.9;3.7
41;2021-03-16;1061;402;30350;12501;9.3;3.8
41;2021-03-17;586;236;30936;12737;9.4;3.9
41;2021-03-18;926;395;31862;13132;9.7;4.0
41;2021-03-19;911;328;32773;13460;10.0;4.1
41;2021-03-20;543;16;33316;13476;10.2;4.1
41;2021-03-21;1;0;33317;13476;10.2;4.1
41;2021-03-22;810;271;34127;13747;10.4;4.2
41;2021-03-23;1309;482;35436;14229;10.8;4.3
41;2021-03-24;1231;363;36667;14592;11.2;4.5
41;2021-03-25;2026;436;38693;15028;11.8;4.6
41;2021-03-26;1655;325;40348;15353;12.3;4.7
41;2021-03-27;451;58;40799;15411;12.4;4.7
41;2021-03-28;1;0;40800;15411;12.4;4.7
41;2021-03-29;939;306;41739;15717;12.7;4.8
41;2021-03-30;1496;593;43235;16310;13.2;5.0
41;2021-03-31;1148;490;44383;16800;13.5;5.1
41;2021-04-01;2252;565;46635;17365;14.2;5.3
41;2021-04-02;1242;473;47877;17838;14.6;5.4
41;2021-04-03;321;5;48198;17843;14.7;5.4
41;2021-04-04;39;0;48237;17843;14.7;5.4
41;2021-04-05;140;2;48377;17845;14.8;5.4
41;2021-04-06;1302;622;49679;18467;15.2;5.6
41;2021-04-07;1852;704;51531;19171;15.7;5.8
41;2021-04-08;2294;914;53825;20085;16.4;6.1
41;2021-04-09;2568;612;56393;20697;17.2;6.3
41;2021-04-10;954;496;57347;21193;17.5;6.5
41;2021-04-11;279;376;57626;21569;17.6;6.6
41;2021-04-12;1689;656;59315;22225;18.1;6.8
41;2021-04-13;2259;987;61574;23212;18.8;7.1
41;2021-04-14;1794;547;63368;23759;19.3;7.2
41;2021-04-15;2384;975;65752;24734;20.1;7.5
41;2021-04-16;1929;625;67681;25359;20.6;7.7
41;2021-04-17;647;137;68328;25496;20.8;7.8
41;2021-04-18;5;0;68333;25496;20.8;7.8
41;2021-04-19;1260;744;69593;26240;21.2;8.0
41;2021-04-20;2004;1197;71597;27437;21.8;8.4
41;2021-04-21;1503;919;73100;28356;22.3;8.6
41;2021-04-22;2236;1600;75336;29956;23.0;9.1
41;2021-04-23;1736;1078;77072;31034;23.5;9.5
41;2021-04-24;1544;283;78616;31317;24.0;9.6
41;2021-04-25;1007;21;79623;31338;24.3;9.6
41;2021-04-26;1355;625;80978;31963;24.7;9.7
41;2021-04-27;2092;1033;83070;32996;25.3;10.1
41;2021-04-28;1562;859;84632;33855;25.8;10.3
41;2021-04-29;2210;1376;86842;35231;26.5;10.7
41;2021-04-30;1963;863;88805;36094;27.1;11.0
41;2021-05-01;189;12;88994;36106;27.1;11.0
41;2021-05-02;107;17;89101;36123;27.2;11.0
41;2021-05-03;1864;892;90965;37015;27.7;11.3
41;2021-05-04;2091;1542;93056;38557;28.4;11.8
41;2021-05-05;1882;1188;94938;39745;29.0;12.1
41;2021-05-06;2448;1692;97386;41437;29.7;12.6
41;2021-05-07;2016;1802;99402;43239;30.3;13.2
41;2021-05-08;202;154;99604;43393;30.4;13.2
41;2021-05-09;11;354;99615;43747;30.4;13.3
41;2021-05-10;1590;1556;101205;45303;30.9;13.8
41;2021-05-11;2085;2100;103290;47403;31.5;14.5
41;2021-05-12;1951;1678;105241;49081;32.1;15.0
41;2021-05-13;1485;948;106726;50029;32.6;15.3
41;2021-05-14;1576;1305;108302;51334;33.0;15.7
41;2021-05-15;206;294;108508;51628;33.1;15.7
41;2021-05-16;4;0;108512;51628;33.1;15.7
41;2021-05-17;2484;564;110996;52192;33.9;15.9
41;2021-05-18;3138;1029;114134;53221;34.8;16.2
41;2021-05-19;2553;673;116687;53894;35.6;16.4
41;2021-05-20;3349;1148;120036;55042;36.6;16.8
41;2021-05-21;2727;967;122763;56009;37.4;17.1
41;2021-05-22;396;237;123159;56246;37.6;17.2
41;2021-05-23;6;2;123165;56248;37.6;17.2
41;2021-05-24;2605;150;125770;56398;38.4;17.2
41;2021-05-25;2991;577;128761;56975;39.3;17.4
41;2021-05-26;3036;650;131797;57625;40.2;17.6
41;2021-05-27;3294;1109;135091;58734;41.2;17.9
41;2021-05-28;3144;971;138235;59705;42.2;18.2
41;2021-05-29;2073;429;140308;60134;42.8;18.3
41;2021-05-30;344;22;140652;60156;42.9;18.3
41;2021-05-31;1710;1499;142362;61655;43.4;18.8
41;2021-06-01;2263;2010;144625;63665;44.1;19.4
41;2021-06-02;1832;1288;146457;64953;44.7;19.8
41;2021-06-03;2597;1940;149054;66893;45.5;20.4
41;2021-06-04;2303;1958;151357;68851;46.2;21.0
41;2021-06-05;611;1583;151968;70434;46.4;21.5
41;2021-06-06;109;927;152077;71361;46.4;21.8
41;2021-06-07;1515;1530;153592;72891;46.9;22.2
41;2021-06-08;1712;2409;155304;75300;47.4;23.0
41;2021-06-09;1615;1635;156919;76935;47.9;23.5
41;2021-06-10;1917;1813;158836;78748;48.4;24.0
41;2021-06-11;1572;1790;160408;80538;48.9;24.6
41;2021-06-12;664;648;161072;81186;49.1;24.8
41;2021-06-13;13;77;161085;81263;49.1;24.8
41;2021-06-14;1269;1962;162354;83225;49.5;25.4
41;2021-06-15;1834;2757;164188;85982;50.1;26.2
41;2021-06-16;1724;2308;165912;88290;50.6;26.9
41;2021-06-17;1810;2573;167722;90863;51.2;27.7
41;2021-06-18;1662;2399;169384;93262;51.7;28.4
41;2021-06-19;412;529;169796;93791;51.8;28.6
41;2021-06-20;11;32;169807;93823;51.8;28.6
41;2021-06-21;1325;1779;171132;95602;52.2;29.2
41;2021-06-22;1619;2561;172751;98163;52.7;29.9
41;2021-06-23;1375;2038;174126;100201;53.1;30.6
41;2021-06-24;1483;2307;175609;102508;53.6;31.3
41;2021-06-25;1294;2617;176903;105125;54.0;32.1
41;2021-06-26;433;614;177336;105739;54.1;32.3
41;2021-06-27;1;4;177337;105743;54.1;32.3
41;2021-06-28;404;2696;177741;108439;54.2;33.1
41;2021-06-29;664;3442;178405;111881;54.4;34.1
41;2021-06-30;552;3067;178957;114948;54.6;35.1
41;2021-07-01;765;3098;179722;118046;54.8;36.0
41;2021-07-02;589;3501;180311;121547;55.0;37.1
41;2021-07-03;158;646;180469;122193;55.0;37.3
41;2021-07-04;2;2;180471;122195;55.0;37.3
41;2021-07-05;285;2818;180756;125013;55.1;38.1
41;2021-07-06;666;3633;181422;128646;55.3;39.2
41;2021-07-07;479;3137;181901;131783;55.5;40.2
41;2021-07-08;940;3365;182841;135148;55.8;41.2
41;2021-07-09;540;3641;183381;138789;55.9;42.3
41;2021-07-10;247;2087;183628;140876;56.0;43.0
41;2021-07-11;5;280;183633;141156;56.0;43.1
41;2021-07-12;861;2291;184494;143447;56.3;43.8
41;2021-07-13;1198;3282;185692;146729;56.6;44.8
41;2021-07-14;141;1080;185833;147809;56.7;45.1
41;2021-07-15;1333;3318;187166;151127;57.1;46.1
41;2021-07-16;1091;3389;188257;154516;57.4;47.1
41;2021-07-17;344;807;188601;155323;57.5;47.4
41;2021-07-18;24;32;188625;155355;57.5;47.4
41;2021-07-19;1191;2319;189816;157674;57.9;48.1
41;2021-07-20;1643;2743;191459;160417;58.4;48.9
41;2021-07-21;1709;2083;193168;162500;58.9;49.6
41;2021-07-22;2263;2290;195431;164790;59.6;50.3
41;2021-07-23;2104;2468;197535;167258;60.3;51.0
41;2021-07-24;329;841;197864;168099;60.4;51.3
41;2021-07-25;19;23;197883;168122;60.4;51.3
41;2021-07-26;1902;1677;199785;169799;60.9;51.8
41;2021-07-27;2534;2342;202319;172141;61.7;52.5
41;2021-07-28;2161;1829;204480;173970;62.4;53.1
41;2021-07-29;2345;2026;206825;175996;63.1;53.7
41;2021-07-30;2151;2084;208976;178080;63.7;54.3
41;2021-07-31;380;581;209356;178661;63.9;54.5
41;2021-08-01;21;7;209377;178668;63.9;54.5
41;2021-08-02;1550;1605;210927;180273;64.3;55.0
41;2021-08-03;2517;1857;213444;182130;65.1;55.6
41;2021-08-04;2302;1199;215746;183329;65.8;55.9
41;2021-08-05;3046;1265;218792;184594;66.7;56.3
41;2021-08-06;2214;1303;221006;185897;67.4;56.7
41;2021-08-07;511;347;221517;186244;67.6;56.8
41;2021-08-08;13;20;221530;186264;67.6;56.8
41;2021-08-09;1689;1357;223219;187621;68.1;57.2
41;2021-08-10;2563;1422;225782;189043;68.9;57.7
41;2021-08-11;1593;1440;227375;190483;69.4;58.1
41;2021-08-12;1942;1339;229317;191822;69.9;58.5
41;2021-08-13;1474;1697;230791;193519;70.4;59.0
41;2021-08-14;364;209;231155;193728;70.5;59.1
41;2021-08-15;0;16;231155;193744;70.5;59.1
41;2021-08-16;864;2069;232019;195813;70.8;59.7
41;2021-08-17;1498;1634;233517;197447;71.2;60.2
41;2021-08-18;1135;1971;234652;199418;71.6;60.8
41;2021-08-19;1311;1554;235963;200972;72.0;61.3
41;2021-08-20;915;2313;236878;203285;72.3;62.0
41;2021-08-21;120;227;236998;203512;72.3;62.1
41;2021-08-22;1;32;236999;203544;72.3;62.1
41;2021-08-23;694;2295;237693;205839;72.5;62.8
41;2021-08-24;1415;2313;239108;208152;72.9;63.5
41;2021-08-25;620;2200;239728;210352;73.1;64.2
41;2021-08-26;843;2821;240571;213173;73.4;65.0
41;2021-08-27;621;2763;241192;215936;73.6;65.9
41;2021-08-28;99;622;241291;216558;73.6;66.1
41;2021-08-29;46;24;241337;216582;73.6;66.1
41;2021-08-30;668;2118;242005;218700;73.8;66.7
41;2021-08-31;765;2597;242770;221297;74.1;67.5
41;2021-09-01;500;1831;243270;223128;74.2;68.1
41;2021-09-02;628;2155;243898;225283;74.4;68.7
41;2021-09-03;650;2228;244548;227511;74.6;69.4
41;2021-09-04;194;592;244742;228103;74.7;69.6
41;2021-09-05;3;1;244745;228104;74.7;69.6
41;2021-09-06;291;1094;245036;229198;74.7;69.9
41;2021-09-07;415;1355;245451;230553;74.9;70.3
41;2021-09-08;314;1276;245765;231829;75.0;70.7
41;2021-09-09;295;1297;246060;233126;75.1;71.1
41;2021-09-10;381;1373;246441;234499;75.2;71.5
41;2021-09-11;85;392;246526;234891;75.2;71.6
41;2021-09-12;0;9;246526;234900;75.2;71.7
41;2021-09-13;200;912;246726;235812;75.3;71.9
41;2021-09-14;364;1056;247090;236868;75.4;72.3
41;2021-09-15;279;1070;247369;237938;75.5;72.6
41;2021-09-16;236;833;247605;238771;75.5;72.8
41;2021-09-17;360;713;247965;239484;75.6;73.1
41;2021-09-18;78;169;248043;239653;75.7;73.1
41;2021-09-19;0;7;248043;239660;75.7;73.1
41;2021-09-20;176;513;248219;240173;75.7;73.3
41;2021-09-21;181;515;248400;240688;75.8;73.4
41;2021-09-22;268;801;248668;241489;75.9;73.7
41;2021-09-23;237;662;248905;242151;75.9;73.9
41;2021-09-24;313;630;249218;242781;76.0;74.1
41;2021-09-25;70;233;249288;243014;76.0;74.1
41;2021-09-26;0;3;249288;243017;76.0;74.1
41;2021-09-27;165;342;249453;243359;76.1;74.2
41;2021-09-28;156;421;249609;243780;76.1;74.4
41;2021-09-29;178;490;249787;244270;76.2;74.5
41;2021-09-30;112;337;249899;244607;76.2;74.6
41;2021-10-01;210;390;250109;244997;76.3;74.7
41;2021-10-02;80;140;250189;245137;76.3;74.8
41;2021-10-03;0;0;250189;245137;76.3;74.8
41;2021-10-04;106;264;250295;245401;76.3;74.9
41;2021-10-05;117;297;250412;245698;76.4;74.9
41;2021-10-06;224;410;250636;246108;76.5;75.1
42;2020-12-27;1;0;1;0;0.0;0.0
42;2020-12-28;0;0;1;0;0.0;0.0
42;2020-12-29;0;0;1;0;0.0;0.0
42;2020-12-30;0;0;1;0;0.0;0.0
42;2020-12-31;0;0;1;0;0.0;0.0
42;2021-01-01;0;0;1;0;0.0;0.0
42;2021-01-02;0;0;1;0;0.0;0.0
42;2021-01-03;0;0;1;0;0.0;0.0
42;2021-01-04;1;0;2;0;0.0;0.0
42;2021-01-05;1;0;3;0;0.0;0.0
42;2021-01-06;178;1;181;1;0.0;0.0
42;2021-01-07;256;0;437;1;0.1;0.0
42;2021-01-08;264;1;701;2;0.1;0.0
42;2021-01-09;136;0;837;2;0.1;0.0
42;2021-01-10;0;0;837;2;0.1;0.0
42;2021-01-11;293;2;1130;4;0.1;0.0
42;2021-01-12;412;1;1542;5;0.2;0.0
42;2021-01-13;527;2;2069;7;0.3;0.0
42;2021-01-14;775;2;2844;9;0.4;0.0
42;2021-01-15;707;4;3551;13;0.5;0.0
42;2021-01-16;298;2;3849;15;0.5;0.0
42;2021-01-17;219;0;4068;15;0.5;0.0
42;2021-01-18;967;1;5035;16;0.7;0.0
42;2021-01-19;1329;8;6364;24;0.8;0.0
42;2021-01-20;956;3;7320;27;1.0;0.0
42;2021-01-21;1023;6;8343;33;1.1;0.0
42;2021-01-22;992;6;9335;39;1.2;0.0
42;2021-01-23;401;0;9736;39;1.3;0.0
42;2021-01-24;359;0;10095;39;1.3;0.0
42;2021-01-25;1099;12;11194;51;1.5;0.0
42;2021-01-26;1750;18;12944;69;1.7;0.0
42;2021-01-27;1456;118;14400;187;1.9;0.0
42;2021-01-28;1667;133;16067;320;2.1;0.0
42;2021-01-29;946;109;17013;429;2.2;0.1
42;2021-01-30;257;96;17270;525;2.3;0.1
42;2021-01-31;258;2;17528;527;2.3;0.1
42;2021-02-01;738;58;18266;585;2.4;0.1
42;2021-02-02;1854;265;20120;850;2.6;0.1
42;2021-02-03;1518;456;21638;1306;2.8;0.2
42;2021-02-04;1279;556;22917;1862;3.0;0.2
42;2021-02-05;684;482;23601;2344;3.1;0.3
42;2021-02-06;304;128;23905;2472;3.1;0.3
42;2021-02-07;276;134;24181;2606;3.2;0.3
42;2021-02-08;507;492;24688;3098;3.2;0.4
42;2021-02-09;703;629;25391;3727;3.3;0.5
42;2021-02-10;742;553;26133;4280;3.4;0.6
42;2021-02-11;773;553;26906;4833;3.5;0.6
42;2021-02-12;675;602;27581;5435;3.6;0.7
42;2021-02-13;428;242;28009;5677;3.7;0.7
42;2021-02-14;186;172;28195;5849;3.7;0.8
42;2021-02-15;520;623;28715;6472;3.8;0.8
42;2021-02-16;490;996;29205;7468;3.8;1.0
42;2021-02-17;518;1334;29723;8802;3.9;1.2
42;2021-02-18;756;1165;30479;9967;4.0;1.3
42;2021-02-19;768;847;31247;10814;4.1;1.4
42;2021-02-20;248;332;31495;11146;4.1;1.5
42;2021-02-21;63;254;31558;11400;4.1;1.5
42;2021-02-22;574;804;32132;12204;4.2;1.6
42;2021-02-23;1211;1301;33343;13505;4.4;1.8
42;2021-02-24;1244;1036;34587;14541;4.5;1.9
42;2021-02-25;1667;1306;36254;15847;4.7;2.1
42;2021-02-26;1646;824;37900;16671;5.0;2.2
42;2021-02-27;580;243;38480;16914;5.0;2.2
42;2021-02-28;167;98;38647;17012;5.1;2.2
42;2021-03-01;807;753;39454;17765;5.2;2.3
42;2021-03-02;1275;724;40729;18489;5.3;2.4
42;2021-03-03;1368;715;42097;19204;5.5;2.5
42;2021-03-04;1705;650;43802;19854;5.7;2.6
42;2021-03-05;2623;619;46425;20473;6.1;2.7
42;2021-03-06;1933;246;48358;20719;6.3;2.7
42;2021-03-07;1491;94;49849;20813;6.5;2.7
42;2021-03-08;1405;487;51254;21300;6.7;2.8
42;2021-03-09;1983;435;53237;21735;7.0;2.8
42;2021-03-10;2053;491;55290;22226;7.2;2.9
42;2021-03-11;3048;607;58338;22833;7.6;3.0
42;2021-03-12;3008;810;61346;23643;8.0;3.1
42;2021-03-13;1479;352;62825;23995;8.2;3.1
42;2021-03-14;472;161;63297;24156;8.3;3.2
42;2021-03-15;1572;590;64869;24746;8.5;3.2
42;2021-03-16;1472;757;66341;25503;8.7;3.3
42;2021-03-17;1723;1070;68064;26573;8.9;3.5
42;2021-03-18;1803;1024;69867;27597;9.1;3.6
42;2021-03-19;2566;678;72433;28275;9.5;3.7
42;2021-03-20;1672;232;74105;28507;9.7;3.7
42;2021-03-21;526;99;74631;28606;9.8;3.7
42;2021-03-22;1426;730;76057;29336;9.9;3.8
42;2021-03-23;2507;856;78564;30192;10.3;3.9
42;2021-03-24;2783;785;81347;30977;10.6;4.1
42;2021-03-25;3720;934;85067;31911;11.1;4.2
42;2021-03-26;3759;783;88826;32694;11.6;4.3
42;2021-03-27;1806;452;90632;33146;11.9;4.3
42;2021-03-28;1039;216;91671;33362;12.0;4.4
42;2021-03-29;2064;922;93735;34284;12.3;4.5
42;2021-03-30;3146;866;96881;35150;12.7;4.6
42;2021-03-31;2444;1073;99325;36223;13.0;4.7
42;2021-04-01;3391;1054;102716;37277;13.4;4.9
42;2021-04-02;2849;1231;105565;38508;13.8;5.0
42;2021-04-03;1418;609;106983;39117;14.0;5.1
42;2021-04-04;1403;393;108386;39510;14.2;5.2
42;2021-04-05;1901;298;110287;39808;14.4;5.2
42;2021-04-06;2292;1408;112579;41216;14.7;5.4
42;2021-04-07;2761;1832;115340;43048;15.1;5.6
42;2021-04-08;4025;1588;119365;44636;15.6;5.8
42;2021-04-09;5134;1562;124499;46198;16.3;6.0
42;2021-04-10;2591;768;127090;46966;16.6;6.1
42;2021-04-11;1957;432;129047;47398;16.9;6.2
42;2021-04-12;3699;1550;132746;48948;17.4;6.4
42;2021-04-13;4659;1808;137405;50756;18.0;6.6
42;2021-04-14;4308;1904;141713;52660;18.5;6.9
42;2021-04-15;4809;1838;146522;54498;19.2;7.1
42;2021-04-16;4621;1891;151143;56389;19.8;7.4
42;2021-04-17;2982;1071;154125;57460;20.2;7.5
42;2021-04-18;1887;413;156012;57873;20.4;7.6
42;2021-04-19;3090;1537;159102;59410;20.8;7.8
42;2021-04-20;3468;1956;162570;61366;21.3;8.0
42;2021-04-21;3479;1749;166049;63115;21.7;8.3
42;2021-04-22;3768;1953;169817;65068;22.2;8.5
42;2021-04-23;3842;2017;173659;67085;22.7;8.8
42;2021-04-24;2363;1518;176022;68603;23.0;9.0
42;2021-04-25;1658;944;177680;69547;23.2;9.1
42;2021-04-26;3280;1734;180960;71281;23.7;9.3
42;2021-04-27;3253;2208;184213;73489;24.1;9.6
42;2021-04-28;3463;2619;187676;76108;24.5;10.0
42;2021-04-29;3768;2803;191444;78911;25.0;10.3
42;2021-04-30;3360;3024;194804;81935;25.5;10.7
42;2021-05-01;2968;1053;197772;82988;25.9;10.9
42;2021-05-02;1934;1261;199706;84249;26.1;11.0
42;2021-05-03;2868;2768;202574;87017;26.5;11.4
42;2021-05-04;3416;3127;205990;90144;26.9;11.8
42;2021-05-05;3328;3398;209318;93542;27.4;12.2
42;2021-05-06;3888;3772;213206;97314;27.9;12.7
42;2021-05-07;3732;4039;216938;101353;28.4;13.3
42;2021-05-08;3164;1071;220102;102424;28.8;13.4
42;2021-05-09;1505;2213;221607;104637;29.0;13.7
42;2021-05-10;3250;3828;224857;108465;29.4;14.2
42;2021-05-11;5574;3899;230431;112364;30.1;14.7
42;2021-05-12;5339;3568;235770;115932;30.8;15.2
42;2021-05-13;5451;1150;241221;117082;31.5;15.3
42;2021-05-14;5237;2927;246458;120009;32.2;15.7
42;2021-05-15;4880;2127;251338;122136;32.9;16.0
42;2021-05-16;2873;1036;254211;123172;33.2;16.1
42;2021-05-17;5885;2840;260096;126012;34.0;16.5
42;2021-05-18;6251;2979;266347;128991;34.8;16.9
42;2021-05-19;6523;2752;272870;131743;35.7;17.2
42;2021-05-20;7103;2893;279973;134636;36.6;17.6
42;2021-05-21;6351;3276;286324;137912;37.4;18.0
42;2021-05-22;5834;2134;292158;140046;38.2;18.3
42;2021-05-23;2832;874;294990;140920;38.6;18.4
42;2021-05-24;5246;1433;300236;142353;39.3;18.6
42;2021-05-25;5152;3940;305388;146293;39.9;19.1
42;2021-05-26;5160;3459;310548;149752;40.6;19.6
42;2021-05-27;5366;3632;315914;153384;41.3;20.1
42;2021-05-28;5043;4189;320957;157573;42.0;20.6
42;2021-05-29;4340;2984;325297;160557;42.5;21.0
42;2021-05-30;1983;1205;327280;161762;42.8;21.2
42;2021-05-31;4241;3419;331521;165181;43.4;21.6
42;2021-06-01;4592;3562;336113;168743;44.0;22.1
42;2021-06-02;4481;3006;340594;171749;44.5;22.5
42;2021-06-03;4930;3839;345524;175588;45.2;23.0
42;2021-06-04;4766;4213;350290;179801;45.8;23.5
42;2021-06-05;3689;2424;353979;182225;46.3;23.8
42;2021-06-06;1445;1293;355424;183518;46.5;24.0
42;2021-06-07;3992;3377;359416;186895;47.0;24.4
42;2021-06-08;3466;3242;362882;190137;47.5;24.9
42;2021-06-09;2964;3206;365846;193343;47.8;25.3
42;2021-06-10;3242;2932;369088;196275;48.3;25.7
42;2021-06-11;3585;4114;372673;200389;48.7;26.2
42;2021-06-12;2863;2881;375536;203270;49.1;26.6
42;2021-06-13;944;1278;376480;204548;49.2;26.7
42;2021-06-14;2313;4061;378793;208609;49.5;27.3
42;2021-06-15;2830;4070;381623;212679;49.9;27.8
42;2021-06-16;2920;3551;384543;216230;50.3;28.3
42;2021-06-17;2635;3734;387178;219964;50.6;28.8
42;2021-06-18;3093;5143;390271;225107;51.0;29.4
42;2021-06-19;2845;4243;393116;229350;51.4;30.0
42;2021-06-20;857;1844;393973;231194;51.5;30.2
42;2021-06-21;1909;6277;395882;237471;51.8;31.1
42;2021-06-22;1875;5891;397757;243362;52.0;31.8
42;2021-06-23;1845;5321;399602;248683;52.3;32.5
42;2021-06-24;1785;4682;401387;253365;52.5;33.1
42;2021-06-25;2037;6951;403424;260316;52.8;34.0
42;2021-06-26;1408;5818;404832;266134;52.9;34.8
42;2021-06-27;756;2858;405588;268992;53.0;35.2
42;2021-06-28;1746;7063;407334;276055;53.3;36.1
42;2021-06-29;1526;6566;408860;282621;53.5;37.0
42;2021-06-30;1969;5765;410829;288386;53.7;37.7
42;2021-07-01;1779;5119;412608;293505;54.0;38.4
42;2021-07-02;2046;6739;414654;300244;54.2;39.3
42;2021-07-03;1760;5978;416414;306222;54.5;40.0
42;2021-07-04;853;2514;417267;308736;54.6;40.4
42;2021-07-05;1716;6286;418983;315022;54.8;41.2
42;2021-07-06;2106;5576;421089;320598;55.1;41.9
42;2021-07-07;2338;4657;423427;325255;55.4;42.5
42;2021-07-08;2272;3956;425699;329211;55.7;43.0
42;2021-07-09;2416;6096;428115;335307;56.0;43.8
42;2021-07-10;1693;5581;429808;340888;56.2;44.6
42;2021-07-11;921;2304;430729;343192;56.3;44.9
42;2021-07-12;1776;6288;432505;349480;56.6;45.7
42;2021-07-13;3610;6290;436115;355770;57.0;46.5
42;2021-07-14;4479;2053;440594;357823;57.6;46.8
42;2021-07-15;4558;5626;445152;363449;58.2;47.5
42;2021-07-16;4442;6197;449594;369646;58.8;48.3
42;2021-07-17;3219;4709;452813;374355;59.2;49.0
42;2021-07-18;1838;1743;454651;376098;59.5;49.2
42;2021-07-19;3806;5073;458457;381171;59.9;49.8
42;2021-07-20;4719;4821;463176;385992;60.6;50.5
42;2021-07-21;5176;4718;468352;390710;61.2;51.1
42;2021-07-22;5501;3935;473853;394645;62.0;51.6
42;2021-07-23;5500;5120;479353;399765;62.7;52.3
42;2021-07-24;4037;3833;483390;403598;63.2;52.8
42;2021-07-25;1656;1389;485046;404987;63.4;53.0
42;2021-07-26;4731;4312;489777;409299;64.0;53.5
42;2021-07-27;5333;3956;495110;413255;64.7;54.0
42;2021-07-28;5782;3676;500892;416931;65.5;54.5
42;2021-07-29;5678;3433;506570;420364;66.2;55.0
42;2021-07-30;5141;3776;511711;424140;66.9;55.5
42;2021-07-31;4765;3057;516476;427197;67.5;55.9
42;2021-08-01;2498;1318;518974;428515;67.9;56.0
42;2021-08-02;4366;3106;523340;431621;68.4;56.4
42;2021-08-03;3826;3284;527166;434905;68.9;56.9
42;2021-08-04;3473;3223;530639;438128;69.4;57.3
42;2021-08-05;3402;3313;534041;441441;69.8;57.7
42;2021-08-06;3640;3995;537681;445436;70.3;58.2
42;2021-08-07;3022;3067;540703;448503;70.7;58.6
42;2021-08-08;1200;1717;541903;450220;70.9;58.9
42;2021-08-09;2809;3860;544712;454080;71.2;59.4
42;2021-08-10;3275;3909;547987;457989;71.7;59.9
42;2021-08-11;2593;3521;550580;461510;72.0;60.3
42;2021-08-12;2517;3569;553097;465079;72.3;60.8
42;2021-08-13;2334;3908;555431;468987;72.6;61.3
42;2021-08-14;1652;3269;557083;472256;72.8;61.8
42;2021-08-15;600;1027;557683;473283;72.9;61.9
42;2021-08-16;2077;4572;559760;477855;73.2;62.5
42;2021-08-17;2246;4174;562006;482029;73.5;63.0
42;2021-08-18;2053;4146;564059;486175;73.8;63.6
42;2021-08-19;1932;3369;565991;489544;74.0;64.0
42;2021-08-20;2270;4612;568261;494156;74.3;64.6
42;2021-08-21;1083;3865;569344;498021;74.4;65.1
42;2021-08-22;501;2020;569845;500041;74.5;65.4
42;2021-08-23;1625;4667;571470;504708;74.7;66.0
42;2021-08-24;1748;4043;573218;508751;75.0;66.5
42;2021-08-25;1748;3898;574966;512649;75.2;67.0
42;2021-08-26;1445;3048;576411;515697;75.4;67.4
42;2021-08-27;1776;4563;578187;520260;75.6;68.0
42;2021-08-28;1311;3707;579498;523967;75.8;68.5
42;2021-08-29;377;1428;579875;525395;75.8;68.7
42;2021-08-30;1284;3434;581159;528829;76.0;69.2
42;2021-08-31;1238;2860;582397;531689;76.2;69.5
42;2021-09-01;1252;3018;583649;534707;76.3;69.9
42;2021-09-02;1321;2935;584970;537642;76.5;70.3
42;2021-09-03;1571;3304;586541;540946;76.7;70.7
42;2021-09-04;1046;2984;587587;543930;76.8;71.1
42;2021-09-05;381;874;587968;544804;76.9;71.2
42;2021-09-06;763;2167;588731;546971;77.0;71.5
42;2021-09-07;823;1934;589554;548905;77.1;71.8
42;2021-09-08;918;2232;590472;551137;77.2;72.1
42;2021-09-09;658;1779;591130;552916;77.3;72.3
42;2021-09-10;926;2280;592056;555196;77.4;72.6
42;2021-09-11;723;2400;592779;557596;77.5;72.9
42;2021-09-12;163;553;592942;558149;77.5;73.0
42;2021-09-13;548;1620;593490;559769;77.6;73.2
42;2021-09-14;773;1980;594263;561749;77.7;73.5
42;2021-09-15;702;1569;594965;563318;77.8;73.7
42;2021-09-16;525;824;595490;564142;77.9;73.8
42;2021-09-17;732;1636;596222;565778;78.0;74.0
42;2021-09-18;575;1799;596797;567577;78.0;74.2
42;2021-09-19;99;366;596896;567943;78.1;74.3
42;2021-09-20;399;850;597295;568793;78.1;74.4
42;2021-09-21;340;738;597635;569531;78.1;74.5
42;2021-09-22;472;1382;598107;570913;78.2;74.7
42;2021-09-23;372;907;598479;571820;78.3;74.8
42;2021-09-24;471;1563;598950;573383;78.3;75.0
42;2021-09-25;388;1274;599338;574657;78.4;75.1
42;2021-09-26;61;289;599399;574946;78.4;75.2
42;2021-09-27;332;792;599731;575738;78.4;75.3
42;2021-09-28;342;705;600073;576443;78.5;75.4
42;2021-09-29;405;957;600478;577400;78.5;75.5
42;2021-09-30;358;689;600836;578089;78.6;75.6
42;2021-10-01;487;1018;601323;579107;78.6;75.7
42;2021-10-02;378;780;601701;579887;78.7;75.8
42;2021-10-03;89;176;601790;580063;78.7;75.9
42;2021-10-04;269;523;602059;580586;78.7;75.9
42;2021-10-05;286;464;602345;581050;78.8;76.0
42;2021-10-06;409;797;602754;581847;78.8;76.1
43;2020-12-27;0;0;0;0;0.0;0.0
43;2020-12-28;0;0;0;0;0.0;0.0
43;2020-12-29;0;0;0;0;0.0;0.0
43;2020-12-30;0;0;0;0;0.0;0.0
43;2020-12-31;0;0;0;0;0.0;0.0
43;2021-01-01;0;0;0;0;0.0;0.0
43;2021-01-02;0;0;0;0;0.0;0.0
43;2021-01-03;0;0;0;0;0.0;0.0
43;2021-01-04;2;0;2;0;0.0;0.0
43;2021-01-05;0;0;2;0;0.0;0.0
43;2021-01-06;0;0;2;0;0.0;0.0
43;2021-01-07;167;0;169;0;0.1;0.0
43;2021-01-08;151;1;320;1;0.1;0.0
43;2021-01-09;0;0;320;1;0.1;0.0
43;2021-01-10;0;0;320;1;0.1;0.0
43;2021-01-11;137;0;457;1;0.2;0.0
43;2021-01-12;244;0;701;1;0.3;0.0
43;2021-01-13;244;2;945;3;0.4;0.0
43;2021-01-14;294;2;1239;5;0.5;0.0
43;2021-01-15;303;2;1542;7;0.7;0.0
43;2021-01-16;32;0;1574;7;0.7;0.0
43;2021-01-17;0;0;1574;7;0.7;0.0
43;2021-01-18;760;5;2334;12;1.0;0.0
43;2021-01-19;776;5;3110;17;1.4;0.0
43;2021-01-20;519;2;3629;19;1.6;0.0
43;2021-01-21;447;2;4076;21;1.8;0.0
43;2021-01-22;467;6;4543;27;2.0;0.0
43;2021-01-23;1;0;4544;27;2.0;0.0
43;2021-01-24;2;0;4546;27;2.0;0.0
43;2021-01-25;539;0;5085;27;2.2;0.0
43;2021-01-26;614;5;5699;32;2.5;0.0
43;2021-01-27;740;0;6439;32;2.8;0.0
43;2021-01-28;747;30;7186;62;3.2;0.0
43;2021-01-29;722;81;7908;143;3.5;0.1
43;2021-01-30;109;0;8017;143;3.5;0.1
43;2021-01-31;0;0;8017;143;3.5;0.1
43;2021-02-01;403;99;8420;242;3.7;0.1
43;2021-02-02;717;145;9137;387;4.0;0.2
43;2021-02-03;690;41;9827;428;4.3;0.2
43;2021-02-04;525;157;10352;585;4.6;0.3
43;2021-02-05;544;147;10896;732;4.8;0.3
43;2021-02-06;165;16;11061;748;4.9;0.3
43;2021-02-07;0;0;11061;748;4.9;0.3
43;2021-02-08;411;281;11472;1029;5.1;0.5
43;2021-02-09;368;414;11840;1443;5.2;0.6
43;2021-02-10;401;348;12241;1791;5.4;0.8
43;2021-02-11;388;312;12629;2103;5.6;0.9
43;2021-02-12;425;187;13054;2290;5.8;1.0
43;2021-02-13;570;41;13624;2331;6.0;1.0
43;2021-02-14;0;0;13624;2331;6.0;1.0
43;2021-02-15;69;385;13693;2716;6.0;1.2
43;2021-02-16;41;318;13734;3034;6.1;1.3
43;2021-02-17;87;426;13821;3460;6.1;1.5
43;2021-02-18;147;324;13968;3784;6.2;1.7
43;2021-02-19;278;459;14246;4243;6.3;1.9
43;2021-02-20;22;4;14268;4247;6.3;1.9
43;2021-02-21;0;0;14268;4247;6.3;1.9
43;2021-02-22;16;424;14284;4671;6.3;2.1
43;2021-02-23;202;709;14486;5380;6.4;2.4
43;2021-02-24;147;679;14633;6059;6.4;2.7
43;2021-02-25;228;618;14861;6677;6.5;2.9
43;2021-02-26;222;576;15083;7253;6.6;3.2
43;2021-02-27;139;60;15222;7313;6.7;3.2
43;2021-02-28;1;0;15223;7313;6.7;3.2
43;2021-03-01;210;438;15433;7751;6.8;3.4
43;2021-03-02;342;540;15775;8291;7.0;3.7
43;2021-03-03;338;548;16113;8839;7.1;3.9
43;2021-03-04;551;435;16664;9274;7.3;4.1
43;2021-03-05;566;427;17230;9701;7.6;4.3
43;2021-03-06;489;175;17719;9876;7.8;4.4
43;2021-03-07;12;0;17731;9876;7.8;4.4
43;2021-03-08;447;413;18178;10289;8.0;4.5
43;2021-03-09;621;350;18799;10639;8.3;4.7
43;2021-03-10;674;476;19473;11115;8.6;4.9
43;2021-03-11;953;429;20426;11544;9.0;5.1
43;2021-03-12;944;414;21370;11958;9.4;5.3
43;2021-03-13;792;108;22162;12066;9.8;5.3
43;2021-03-14;2;0;22164;12066;9.8;5.3
43;2021-03-15;706;143;22870;12209;10.1;5.4
43;2021-03-16;847;283;23717;12492;10.5;5.5
43;2021-03-17;638;138;24355;12630;10.7;5.6
43;2021-03-18;676;140;25031;12770;11.0;5.6
43;2021-03-19;839;91;25870;12861;11.4;5.7
43;2021-03-20;450;60;26320;12921;11.6;5.7
43;2021-03-21;0;0;26320;12921;11.6;5.7
43;2021-03-22;742;39;27062;12960;11.9;5.7
43;2021-03-23;872;49;27934;13009;12.3;5.7
43;2021-03-24;1174;96;29108;13105;12.8;5.8
43;2021-03-25;1594;161;30702;13266;13.5;5.8
43;2021-03-26;1609;192;32311;13458;14.2;5.9
43;2021-03-27;1449;79;33760;13537;14.9;6.0
43;2021-03-28;420;20;34180;13557;15.1;6.0
43;2021-03-29;1096;171;35276;13728;15.5;6.1
43;2021-03-30;1314;235;36590;13963;16.1;6.2
43;2021-03-31;1306;266;37896;14229;16.7;6.3
43;2021-04-01;1348;340;39244;14569;17.3;6.4
43;2021-04-02;1052;352;40296;14921;17.8;6.6
43;2021-04-03;340;198;40636;15119;17.9;6.7
43;2021-04-04;0;0;40636;15119;17.9;6.7
43;2021-04-05;3;0;40639;15119;17.9;6.7
43;2021-04-06;688;607;41327;15726;18.2;6.9
43;2021-04-07;868;576;42195;16302;18.6;7.2
43;2021-04-08;1086;463;43281;16765;19.1;7.4
43;2021-04-09;1147;662;44428;17427;19.6;7.7
43;2021-04-10;626;264;45054;17691;19.9;7.8
43;2021-04-11;0;0;45054;17691;19.9;7.8
43;2021-04-12;681;649;45735;18340;20.2;8.1
43;2021-04-13;917;726;46652;19066;20.6;8.4
43;2021-04-14;723;669;47375;19735;20.9;8.7
43;2021-04-15;959;701;48334;20436;21.3;9.0
43;2021-04-16;1008;694;49342;21130;21.7;9.3
43;2021-04-17;423;301;49765;21431;21.9;9.4
43;2021-04-18;3;5;49768;21436;21.9;9.4
43;2021-04-19;628;567;50396;22003;22.2;9.7
43;2021-04-20;839;675;51235;22678;22.6;10.0
43;2021-04-21;320;987;51555;23665;22.7;10.4
43;2021-04-22;680;1016;52235;24681;23.0;10.9
43;2021-04-23;401;1102;52636;25783;23.2;11.4
43;2021-04-24;347;1039;52983;26822;23.4;11.8
43;2021-04-25;23;403;53006;27225;23.4;12.0
43;2021-04-26;385;964;53391;28189;23.5;12.4
43;2021-04-27;825;984;54216;29173;23.9;12.9
43;2021-04-28;794;1108;55010;30281;24.2;13.3
43;2021-04-29;1236;1139;56246;31420;24.8;13.8
43;2021-04-30;1199;1067;57445;32487;25.3;14.3
43;2021-05-01;400;27;57845;32514;25.5;14.3
43;2021-05-02;1;0;57846;32514;25.5;14.3
43;2021-05-03;1218;408;59064;32922;26.0;14.5
43;2021-05-04;1237;956;60301;33878;26.6;14.9
43;2021-05-05;1143;848;61444;34726;27.1;15.3
43;2021-05-06;1405;938;62849;35664;27.7;15.7
43;2021-05-07;1089;1172;63938;36836;28.2;16.2
43;2021-05-08;521;136;64459;36972;28.4;16.3
43;2021-05-09;0;2;64459;36974;28.4;16.3
43;2021-05-10;1084;725;65543;37699;28.9;16.6
43;2021-05-11;1553;1010;67096;38709;29.6;17.1
43;2021-05-12;1482;809;68578;39518;30.2;17.4
43;2021-05-13;936;378;69514;39896;30.6;17.6
43;2021-05-14;2204;1110;71718;41006;31.6;18.1
43;2021-05-15;1271;315;72989;41321;32.2;18.2
43;2021-05-16;272;47;73261;41368;32.3;18.2
43;2021-05-17;1625;631;74886;41999;33.0;18.5
43;2021-05-18;1966;675;76852;42674;33.9;18.8
43;2021-05-19;2065;571;78917;43245;34.8;19.1
43;2021-05-20;2338;805;81255;44050;35.8;19.4
43;2021-05-21;2385;709;83640;44759;36.9;19.7
43;2021-05-22;1207;341;84847;45100;37.4;19.9
43;2021-05-23;1;0;84848;45100;37.4;19.9
43;2021-05-24;382;99;85230;45199;37.6;19.9
43;2021-05-25;1407;654;86637;45853;38.2;20.2
43;2021-05-26;1347;559;87984;46412;38.8;20.5
43;2021-05-27;1388;713;89372;47125;39.4;20.8
43;2021-05-28;1348;727;90720;47852;40.0;21.1
43;2021-05-29;1135;604;91855;48456;40.5;21.4
43;2021-05-30;149;17;92004;48473;40.5;21.4
43;2021-05-31;1207;442;93211;48915;41.1;21.6
43;2021-06-01;1280;985;94491;49900;41.6;22.0
43;2021-06-02;1086;700;95577;50600;42.1;22.3
43;2021-06-03;1192;856;96769;51456;42.6;22.7
43;2021-06-04;1351;859;98120;52315;43.2;23.1
43;2021-06-05;823;452;98943;52767;43.6;23.3
43;2021-06-06;10;5;98953;52772;43.6;23.3
43;2021-06-07;748;516;99701;53288;43.9;23.5
43;2021-06-08;664;706;100365;53994;44.2;23.8
43;2021-06-09;538;760;100903;54754;44.5;24.1
43;2021-06-10;807;1120;101710;55874;44.8;24.6
43;2021-06-11;761;1348;102471;57222;45.2;25.2
43;2021-06-12;914;514;103385;57736;45.6;25.4
43;2021-06-13;3;27;103388;57763;45.6;25.5
43;2021-06-14;446;1087;103834;58850;45.8;25.9
43;2021-06-15;629;1191;104463;60041;46.0;26.5
43;2021-06-16;549;974;105012;61015;46.3;26.9
43;2021-06-17;601;1500;105613;62515;46.5;27.6
43;2021-06-18;898;1464;106511;63979;46.9;28.2
43;2021-06-19;447;781;106958;64760;47.1;28.5
43;2021-06-20;0;12;106958;64772;47.1;28.5
43;2021-06-21;424;1306;107382;66078;47.3;29.1
43;2021-06-22;533;1958;107915;68036;47.6;30.0
43;2021-06-23;343;1743;108258;69779;47.7;30.8
43;2021-06-24;511;1492;108769;71271;47.9;31.4
43;2021-06-25;597;2345;109366;73616;48.2;32.4
43;2021-06-26;505;1245;109871;74861;48.4;33.0
43;2021-06-27;10;20;109881;74881;48.4;33.0
43;2021-06-28;341;1785;110222;76666;48.6;33.8
43;2021-06-29;525;2381;110747;79047;48.8;34.8
43;2021-06-30;460;2276;111207;81323;49.0;35.8
43;2021-07-01;473;1910;111680;83233;49.2;36.7
43;2021-07-02;500;1964;112180;85197;49.4;37.5
43;2021-07-03;258;1108;112438;86305;49.6;38.0
43;2021-07-04;1;0;112439;86305;49.6;38.0
43;2021-07-05;526;1202;112965;87507;49.8;38.6
43;2021-07-06;633;1681;113598;89188;50.1;39.3
43;2021-07-07;524;1423;114122;90611;50.3;39.9
43;2021-07-08;837;1417;114959;92028;50.7;40.6
43;2021-07-09;549;1500;115508;93528;50.9;41.2
43;2021-07-10;401;1337;115909;94865;51.1;41.8
43;2021-07-11;23;99;115932;94964;51.1;41.9
43;2021-07-12;604;1684;116536;96648;51.4;42.6
43;2021-07-13;1186;1849;117722;98497;51.9;43.4
43;2021-07-14;848;161;118570;98658;52.3;43.5
43;2021-07-15;1932;1841;120502;100499;53.1;44.3
43;2021-07-16;1752;1616;122254;102115;53.9;45.0
43;2021-07-17;1544;1202;123798;103317;54.6;45.5
43;2021-07-18;4;19;123802;103336;54.6;45.5
43;2021-07-19;1441;1257;125243;104593;55.2;46.1
43;2021-07-20;1895;1451;127138;106044;56.0;46.7
43;2021-07-21;1854;1113;128992;107157;56.8;47.2
43;2021-07-22;2110;1333;131102;108490;57.8;47.8
43;2021-07-23;1619;1325;132721;109815;58.5;48.4
43;2021-07-24;576;1000;133297;110815;58.7;48.8
43;2021-07-25;0;1;133297;110816;58.7;48.8
43;2021-07-26;1643;1071;134940;111887;59.5;49.3
43;2021-07-27;2284;1228;137224;113115;60.5;49.9
43;2021-07-28;1954;1093;139178;114208;61.3;50.3
43;2021-07-29;1986;1016;141164;115224;62.2;50.8
43;2021-07-30;1867;1337;143031;116561;63.0;51.4
43;2021-07-31;706;611;143737;117172;63.3;51.6
43;2021-08-01;13;21;143750;117193;63.4;51.6
43;2021-08-02;1534;969;145284;118162;64.0;52.1
43;2021-08-03;1405;1170;146689;119332;64.6;52.6
43;2021-08-04;1263;1109;147952;120441;65.2;53.1
43;2021-08-05;1254;1285;149206;121726;65.8;53.6
43;2021-08-06;1129;1465;150335;123191;66.3;54.3
43;2021-08-07;758;759;151093;123950;66.6;54.6
43;2021-08-08;5;0;151098;123950;66.6;54.6
43;2021-08-09;822;1636;151920;125586;67.0;55.3
43;2021-08-10;1023;1585;152943;127171;67.4;56.0
43;2021-08-11;680;1340;153623;128511;67.7;56.6
43;2021-08-12;875;1605;154498;130116;68.1;57.3
43;2021-08-13;681;1179;155179;131295;68.4;57.9
43;2021-08-14;364;557;155543;131852;68.6;58.1
43;2021-08-15;5;9;155548;131861;68.6;58.1
43;2021-08-16;686;1675;156234;133536;68.9;58.9
43;2021-08-17;712;1511;156946;135047;69.2;59.5
43;2021-08-18;558;1513;157504;136560;69.4;60.2
43;2021-08-19;641;1613;158145;138173;69.7;60.9
43;2021-08-20;518;1596;158663;139769;69.9;61.6
43;2021-08-21;239;555;158902;140324;70.0;61.8
43;2021-08-22;7;7;158909;140331;70.0;61.8
43;2021-08-23;500;1588;159409;141919;70.3;62.5
43;2021-08-24;518;1398;159927;143317;70.5;63.2
43;2021-08-25;521;1298;160448;144615;70.7;63.7
43;2021-08-26;475;1138;160923;145753;70.9;64.2
43;2021-08-27;529;1360;161452;147113;71.2;64.8
43;2021-08-28;176;499;161628;147612;71.2;65.1
43;2021-08-29;0;1;161628;147613;71.2;65.1
43;2021-08-30;483;1062;162111;148675;71.4;65.5
43;2021-08-31;382;890;162493;149565;71.6;65.9
43;2021-09-01;307;962;162800;150527;71.7;66.3
43;2021-09-02;308;969;163108;151496;71.9;66.8
43;2021-09-03;503;1017;163611;152513;72.1;67.2
43;2021-09-04;319;569;163930;153082;72.2;67.5
43;2021-09-05;39;24;163969;153106;72.3;67.5
43;2021-09-06;250;762;164219;153868;72.4;67.8
43;2021-09-07;237;715;164456;154583;72.5;68.1
43;2021-09-08;207;803;164663;155386;72.6;68.5
43;2021-09-09;268;810;164931;156196;72.7;68.8
43;2021-09-10;328;709;165259;156905;72.8;69.2
43;2021-09-11;266;457;165525;157362;73.0;69.4
43;2021-09-12;0;4;165525;157366;73.0;69.4
43;2021-09-13;148;517;165673;157883;73.0;69.6
43;2021-09-14;210;634;165883;158517;73.1;69.9
43;2021-09-15;222;498;166105;159015;73.2;70.1
43;2021-09-16;196;354;166301;159369;73.3;70.2
43;2021-09-17;234;530;166535;159899;73.4;70.5
43;2021-09-18;157;346;166692;160245;73.5;70.6
43;2021-09-19;2;4;166694;160249;73.5;70.6
43;2021-09-20;102;306;166796;160555;73.5;70.8
43;2021-09-21;149;321;166945;160876;73.6;70.9
43;2021-09-22;124;393;167069;161269;73.6;71.1
43;2021-09-23;71;292;167140;161561;73.7;71.2
43;2021-09-24;170;487;167310;162048;73.7;71.4
43;2021-09-25;102;295;167412;162343;73.8;71.5
43;2021-09-26;0;0;167412;162343;73.8;71.5
43;2021-09-27;152;340;167564;162683;73.8;71.7
43;2021-09-28;388;218;167952;162901;74.0;71.8
43;2021-09-29;145;302;168097;163203;74.1;71.9
43;2021-09-30;79;181;168176;163384;74.1;72.0
43;2021-10-01;139;321;168315;163705;74.2;72.1
43;2021-10-02;102;244;168417;163949;74.2;72.3
43;2021-10-03;3;7;168420;163956;74.2;72.3
43;2021-10-04;113;176;168533;164132;74.3;72.3
43;2021-10-05;108;181;168641;164313;74.3;72.4
43;2021-10-06;121;224;168762;164537;74.4;72.5
44;2020-12-27;1;0;1;0;0.0;0.0
44;2020-12-28;3;0;4;0;0.0;0.0
44;2020-12-29;1;0;5;0;0.0;0.0
44;2020-12-30;2;0;7;0;0.0;0.0
44;2020-12-31;1;0;8;0;0.0;0.0
44;2021-01-01;2;0;10;0;0.0;0.0
44;2021-01-02;0;0;10;0;0.0;0.0
44;2021-01-03;4;0;14;0;0.0;0.0
44;2021-01-04;0;0;14;0;0.0;0.0
44;2021-01-05;2;0;16;0;0.0;0.0
44;2021-01-06;20;1;36;1;0.0;0.0
44;2021-01-07;187;0;223;1;0.0;0.0
44;2021-01-08;528;0;751;1;0.1;0.0
44;2021-01-09;473;0;1224;1;0.1;0.0
44;2021-01-10;456;1;1680;2;0.1;0.0
44;2021-01-11;800;1;2480;3;0.2;0.0
44;2021-01-12;910;1;3390;4;0.2;0.0
44;2021-01-13;1086;1;4476;5;0.3;0.0
44;2021-01-14;1116;6;5592;11;0.4;0.0
44;2021-01-15;987;1;6579;12;0.5;0.0
44;2021-01-16;336;2;6915;14;0.5;0.0
44;2021-01-17;328;1;7243;15;0.5;0.0
44;2021-01-18;856;3;8099;18;0.6;0.0
44;2021-01-19;2625;6;10724;24;0.7;0.0
44;2021-01-20;2746;4;13470;28;0.9;0.0
44;2021-01-21;4538;8;18008;36;1.3;0.0
44;2021-01-22;2415;7;20423;43;1.4;0.0
44;2021-01-23;767;1;21190;44;1.5;0.0
44;2021-01-24;120;0;21310;44;1.5;0.0
44;2021-01-25;840;0;22150;44;1.5;0.0
44;2021-01-26;2563;16;24713;60;1.7;0.0
44;2021-01-27;2103;55;26816;115;1.9;0.0
44;2021-01-28;3732;187;30548;302;2.1;0.0
44;2021-01-29;2370;440;32918;742;2.3;0.1
44;2021-01-30;628;190;33546;932;2.3;0.1
44;2021-01-31;14;176;33560;1108;2.3;0.1
44;2021-02-01;594;502;34154;1610;2.4;0.1
44;2021-02-02;878;696;35032;2306;2.4;0.2
44;2021-02-03;888;814;35920;3120;2.5;0.2
44;2021-02-04;938;661;36858;3781;2.6;0.3
44;2021-02-05;897;561;37755;4342;2.6;0.3
44;2021-02-06;471;230;38226;4572;2.7;0.3
44;2021-02-07;72;174;38298;4746;2.7;0.3
44;2021-02-08;522;385;38820;5131;2.7;0.4
44;2021-02-09;993;1108;39813;6239;2.8;0.4
44;2021-02-10;1144;1143;40957;7382;2.8;0.5
44;2021-02-11;2292;2941;43249;10323;3.0;0.7
44;2021-02-12;1662;1648;44911;11971;3.1;0.8
44;2021-02-13;433;407;45344;12378;3.2;0.9
44;2021-02-14;10;158;45354;12536;3.2;0.9
44;2021-02-15;505;831;45859;13367;3.2;0.9
44;2021-02-16;1439;2148;47298;15515;3.3;1.1
44;2021-02-17;1106;1855;48404;17370;3.4;1.2
44;2021-02-18;1959;3278;50363;20648;3.5;1.4
44;2021-02-19;1580;2289;51943;22937;3.6;1.6
44;2021-02-20;409;489;52352;23426;3.6;1.6
44;2021-02-21;6;171;52358;23597;3.6;1.6
44;2021-02-22;717;682;53075;24279;3.7;1.7
44;2021-02-23;1246;898;54321;25177;3.8;1.8
44;2021-02-24;1238;896;55559;26073;3.9;1.8
44;2021-02-25;2445;819;58004;26892;4.0;1.9
44;2021-02-26;2291;778;60295;27670;4.2;1.9
44;2021-02-27;975;343;61270;28013;4.3;1.9
44;2021-02-28;7;31;61277;28044;4.3;2.0
44;2021-03-01;988;456;62265;28500;4.3;2.0
44;2021-03-02;1814;874;64079;29374;4.5;2.0
44;2021-03-03;1860;976;65939;30350;4.6;2.1
44;2021-03-04;2881;1391;68820;31741;4.8;2.2
44;2021-03-05;3481;1225;72301;32966;5.0;2.3
44;2021-03-06;2507;408;74808;33374;5.2;2.3
44;2021-03-07;988;87;75796;33461;5.3;2.3
44;2021-03-08;1783;524;77579;33985;5.4;2.4
44;2021-03-09;3352;1002;80931;34987;5.6;2.4
44;2021-03-10;3079;1019;84010;36006;5.8;2.5
44;2021-03-11;4439;1693;88449;37699;6.2;2.6
44;2021-03-12;5892;1279;94341;38978;6.6;2.7
44;2021-03-13;3629;281;97970;39259;6.8;2.7
44;2021-03-14;431;62;98401;39321;6.8;2.7
44;2021-03-15;2687;360;101088;39681;7.0;2.8
44;2021-03-16;2149;619;103237;40300;7.2;2.8
44;2021-03-17;1960;653;105197;40953;7.3;2.8
44;2021-03-18;2169;632;107366;41585;7.5;2.9
44;2021-03-19;3785;362;111151;41947;7.7;2.9
44;2021-03-20;3213;298;114364;42245;8.0;2.9
44;2021-03-21;914;21;115278;42266;8.0;2.9
44;2021-03-22;2462;438;117740;42704;8.2;3.0
44;2021-03-23;3960;700;121700;43404;8.5;3.0
44;2021-03-24;4303;628;126003;44032;8.8;3.1
44;2021-03-25;5636;920;131639;44952;9.2;3.1
44;2021-03-26;6510;752;138149;45704;9.6;3.2
44;2021-03-27;3216;401;141365;46105;9.8;3.2
44;2021-03-28;1244;28;142609;46133;9.9;3.2
44;2021-03-29;3120;785;145729;46918;10.1;3.3
44;2021-03-30;5139;1102;150868;48020;10.5;3.3
44;2021-03-31;4612;1295;155480;49315;10.8;3.4
44;2021-04-01;6140;1008;161620;50323;11.2;3.5
44;2021-04-02;5795;951;167415;51274;11.6;3.6
44;2021-04-03;2435;650;169850;51924;11.8;3.6
44;2021-04-04;667;21;170517;51945;11.9;3.6
44;2021-04-05;692;288;171209;52233;11.9;3.6
44;2021-04-06;4216;1373;175425;53606;12.2;3.7
44;2021-04-07;5075;1649;180500;55255;12.6;3.8
44;2021-04-08;7182;1668;187682;56923;13.1;4.0
44;2021-04-09;10065;1815;197747;58738;13.8;4.1
44;2021-04-10;4563;1454;202310;60192;14.1;4.2
44;2021-04-11;2148;424;204458;60616;14.2;4.2
44;2021-04-12;5463;1588;209921;62204;14.6;4.3
44;2021-04-13;6728;2257;216649;64461;15.1;4.5
44;2021-04-14;5912;2239;222561;66700;15.5;4.6
44;2021-04-15;6709;2208;229270;68908;16.0;4.8
44;2021-04-16;7785;2048;237055;70956;16.5;4.9
44;2021-04-17;4300;1383;241355;72339;16.8;5.0
44;2021-04-18;2253;819;243608;73158;17.0;5.1
44;2021-04-19;5042;1901;248650;75059;17.3;5.2
44;2021-04-20;6282;2643;254932;77702;17.7;5.4
44;2021-04-21;6006;2788;260938;80490;18.2;5.6
44;2021-04-22;6958;2509;267896;82999;18.6;5.8
44;2021-04-23;7335;3184;275231;86183;19.2;6.0
44;2021-04-24;3971;2045;279202;88228;19.4;6.1
44;2021-04-25;2076;1058;281278;89286;19.6;6.2
44;2021-04-26;5648;2751;286926;92037;20.0;6.4
44;2021-04-27;7415;4076;294341;96113;20.5;6.7
44;2021-04-28;7608;3773;301949;99886;21.0;7.0
44;2021-04-29;8964;4269;310913;104155;21.6;7.2
44;2021-04-30;9569;4681;320482;108836;22.3;7.6
44;2021-05-01;2848;919;323330;109755;22.5;7.6
44;2021-05-02;1903;618;325233;110373;22.6;7.7
44;2021-05-03;5548;4060;330781;114433;23.0;8.0
44;2021-05-04;6327;5111;337108;119544;23.5;8.3
44;2021-05-05;6071;4607;343179;124151;23.9;8.6
44;2021-05-06;7255;4871;350434;129022;24.4;9.0
44;2021-05-07;7451;5691;357885;134713;24.9;9.4
44;2021-05-08;2583;1262;360468;135975;25.1;9.5
44;2021-05-09;1801;1810;362269;137785;25.2;9.6
44;2021-05-10;6573;5768;368842;143553;25.7;10.0
44;2021-05-11;7787;6253;376629;149806;26.2;10.4
44;2021-05-12;8195;5705;384824;155511;26.8;10.8
44;2021-05-13;5304;1193;390128;156704;27.1;10.9
44;2021-05-14;7587;3969;397715;160673;27.7;11.2
44;2021-05-15;5008;2233;402723;162906;28.0;11.3
44;2021-05-16;2791;739;405514;163645;28.2;11.4
44;2021-05-17;6744;5138;412258;168783;28.7;11.7
44;2021-05-18;7962;5209;420220;173992;29.2;12.1
44;2021-05-19;8165;4270;428385;178262;29.8;12.4
44;2021-05-20;8367;4646;436752;182908;30.4;12.7
44;2021-05-21;8844;5189;445596;188097;31.0;13.1
44;2021-05-22;5097;2231;450693;190328;31.4;13.2
44;2021-05-23;1759;824;452452;191152;31.5;13.3
44;2021-05-24;4884;1616;457336;192768;31.8;13.4
44;2021-05-25;7740;5542;465076;198310;32.4;13.8
44;2021-05-26;8181;5042;473257;203352;32.9;14.1
44;2021-05-27;9659;5339;482916;208691;33.6;14.5
44;2021-05-28;9182;6890;492098;215581;34.2;15.0
44;2021-05-29;5883;3310;497981;218891;34.7;15.2
44;2021-05-30;1775;705;499756;219596;34.8;15.3
44;2021-05-31;8059;6169;507815;225765;35.3;15.7
44;2021-06-01;9905;6543;517720;232308;36.0;16.2
44;2021-06-02;9534;5681;527254;237989;36.7;16.6
44;2021-06-03;10852;5865;538106;243854;37.4;17.0
44;2021-06-04;9959;8068;548065;251922;38.1;17.5
44;2021-06-05;5780;4331;553845;256253;38.5;17.8
44;2021-06-06;2361;1130;556206;257383;38.7;17.9
44;2021-06-07;9548;6927;565754;264310;39.4;18.4
44;2021-06-08;10908;7501;576662;271811;40.1;18.9
44;2021-06-09;10552;6312;587214;278123;40.9;19.4
44;2021-06-10;11424;6037;598638;284160;41.7;19.8
44;2021-06-11;11959;8631;610597;292791;42.5;20.4
44;2021-06-12;7761;4094;618358;296885;43.0;20.7
44;2021-06-13;2792;1004;621150;297889;43.2;20.7
44;2021-06-14;8761;8413;629911;306302;43.8;21.3
44;2021-06-15;11705;8254;641616;314556;44.6;21.9
44;2021-06-16;10976;7658;652592;322214;45.4;22.4
44;2021-06-17;11725;8682;664317;330896;46.2;23.0
44;2021-06-18;10900;10114;675217;341010;47.0;23.7
44;2021-06-19;5883;4318;681100;345328;47.4;24.0
44;2021-06-20;2535;1338;683635;346666;47.6;24.1
44;2021-06-21;7349;10011;690984;356677;48.1;24.8
44;2021-06-22;8469;10623;699453;367300;48.7;25.6
44;2021-06-23;8554;9139;708007;376439;49.3;26.2
44;2021-06-24;9122;8563;717129;385002;49.9;26.8
44;2021-06-25;7643;10815;724772;395817;50.4;27.5
44;2021-06-26;2958;6464;727730;402281;50.6;28.0
44;2021-06-27;816;2403;728546;404684;50.7;28.2
44;2021-06-28;5229;10054;733775;414738;51.1;28.9
44;2021-06-29;6179;12079;739954;426817;51.5;29.7
44;2021-06-30;6184;10446;746138;437263;51.9;30.4
44;2021-07-01;6930;10475;753068;447738;52.4;31.2
44;2021-07-02;6693;12549;759761;460287;52.9;32.0
44;2021-07-03;2584;7002;762345;467289;53.0;32.5
44;2021-07-04;995;2235;763340;469524;53.1;32.7
44;2021-07-05;5315;11868;768655;481392;53.5;33.5
44;2021-07-06;6058;12598;774713;493990;53.9;34.4
44;2021-07-07;6513;11099;781226;505089;54.4;35.1
44;2021-07-08;7391;11953;788617;517042;54.9;36.0
44;2021-07-09;6260;14246;794877;531288;55.3;37.0
44;2021-07-10;2446;7007;797323;538295;55.5;37.5
44;2021-07-11;731;2262;798054;540557;55.5;37.6
44;2021-07-12;4395;14050;802449;554607;55.8;38.6
44;2021-07-13;5767;14846;808216;569453;56.2;39.6
44;2021-07-14;3688;5809;811904;575262;56.5;40.0
44;2021-07-15;7228;14281;819132;589543;57.0;41.0
44;2021-07-16;8233;14988;827365;604531;57.6;42.1
44;2021-07-17;3371;7576;830736;612107;57.8;42.6
44;2021-07-18;1433;2548;832169;614655;57.9;42.8
44;2021-07-19;4869;14695;837038;629350;58.2;43.8
44;2021-07-20;6034;15668;843072;645018;58.7;44.9
44;2021-07-21;5843;13987;848915;659005;59.1;45.9
44;2021-07-22;6722;13746;855637;672751;59.5;46.8
44;2021-07-23;6160;15625;861797;688376;60.0;47.9
44;2021-07-24;2856;8716;864653;697092;60.2;48.5
44;2021-07-25;945;3088;865598;700180;60.2;48.7
44;2021-07-26;6082;12680;871680;712860;60.7;49.6
44;2021-07-27;9714;12190;881394;725050;61.3;50.5
44;2021-07-28;9263;10844;890657;735894;62.0;51.2
44;2021-07-29;10287;10839;900944;746733;62.7;52.0
44;2021-07-30;9183;10924;910127;757657;63.3;52.7
44;2021-07-31;4791;5652;914918;763309;63.7;53.1
44;2021-08-01;2573;1409;917491;764718;63.8;53.2
44;2021-08-02;6631;9472;924122;774190;64.3;53.9
44;2021-08-03;8467;8536;932589;782726;64.9;54.5
44;2021-08-04;9128;6987;941717;789713;65.5;55.0
44;2021-08-05;11570;7521;953287;797234;66.3;55.5
44;2021-08-06;9699;8201;962986;805435;67.0;56.0
44;2021-08-07;4609;3702;967595;809137;67.3;56.3
44;2021-08-08;2540;1727;970135;810864;67.5;56.4
44;2021-08-09;8907;7979;979042;818843;68.1;57.0
44;2021-08-10;10272;7623;989314;826466;68.8;57.5
44;2021-08-11;10421;6789;999735;833255;69.6;58.0
44;2021-08-12;10421;7346;1010156;840601;70.3;58.5
44;2021-08-13;8463;6166;1018619;846767;70.9;58.9
44;2021-08-14;3233;3221;1021852;849988;71.1;59.1
44;2021-08-15;716;933;1022568;850921;71.2;59.2
44;2021-08-16;5855;8306;1028423;859227;71.6;59.8
44;2021-08-17;5606;8180;1034029;867407;72.0;60.4
44;2021-08-18;4820;7621;1038849;875028;72.3;60.9
44;2021-08-19;4974;8351;1043823;883379;72.6;61.5
44;2021-08-20;4501;8922;1048324;892301;72.9;62.1
44;2021-08-21;1960;4612;1050284;896913;73.1;62.4
44;2021-08-22;712;2441;1050996;899354;73.1;62.6
44;2021-08-23;3675;9433;1054671;908787;73.4;63.2
44;2021-08-24;3644;8698;1058315;917485;73.6;63.8
44;2021-08-25;3145;8586;1061460;926071;73.9;64.4
44;2021-08-26;2967;10340;1064427;936411;74.1;65.2
44;2021-08-27;3084;10452;1067511;946863;74.3;65.9
44;2021-08-28;1386;5849;1068897;952712;74.4;66.3
44;2021-08-29;565;2706;1069462;955418;74.4;66.5
44;2021-08-30;2666;10967;1072128;966385;74.6;67.2
44;2021-08-31;2826;11228;1074954;977613;74.8;68.0
44;2021-09-01;2709;9936;1077663;987549;75.0;68.7
44;2021-09-02;2261;8741;1079924;996290;75.1;69.3
44;2021-09-03;2147;10205;1082071;1006495;75.3;70.0
44;2021-09-04;1448;6025;1083519;1012520;75.4;70.5
44;2021-09-05;442;1434;1083961;1013954;75.4;70.6
44;2021-09-06;1648;6625;1085609;1020579;75.5;71.0
44;2021-09-07;1483;5776;1087092;1026355;75.6;71.4
44;2021-09-08;1901;6521;1088993;1032876;75.8;71.9
44;2021-09-09;1511;5153;1090504;1038029;75.9;72.2
44;2021-09-10;1835;6492;1092339;1044521;76.0;72.7
44;2021-09-11;1089;4164;1093428;1048685;76.1;73.0
44;2021-09-12;234;850;1093662;1049535;76.1;73.0
44;2021-09-13;1203;4389;1094865;1053924;76.2;73.3
44;2021-09-14;1121;4391;1095986;1058315;76.3;73.6
44;2021-09-15;1449;4490;1097435;1062805;76.4;74.0
44;2021-09-16;990;2381;1098425;1065186;76.4;74.1
44;2021-09-17;1258;3848;1099683;1069034;76.5;74.4
44;2021-09-18;776;3131;1100459;1072165;76.6;74.6
44;2021-09-19;215;703;1100674;1072868;76.6;74.7
44;2021-09-20;916;2207;1101590;1075075;76.7;74.8
44;2021-09-21;750;1869;1102340;1076944;76.7;74.9
44;2021-09-22;940;3546;1103280;1080490;76.8;75.2
44;2021-09-23;832;1932;1104112;1082422;76.8;75.3
44;2021-09-24;1106;2999;1105218;1085421;76.9;75.5
44;2021-09-25;499;2292;1105717;1087713;76.9;75.7
44;2021-09-26;185;486;1105902;1088199;77.0;75.7
44;2021-09-27;770;1788;1106672;1089987;77.0;75.8
44;2021-09-28;658;1676;1107330;1091663;77.1;76.0
44;2021-09-29;964;2506;1108294;1094169;77.1;76.1
44;2021-09-30;721;1516;1109015;1095685;77.2;76.2
44;2021-10-01;913;2269;1109928;1097954;77.2;76.4
44;2021-10-02;475;1319;1110403;1099273;77.3;76.5
44;2021-10-03;219;362;1110622;1099635;77.3;76.5
44;2021-10-04;504;963;1111126;1100598;77.3;76.6
44;2021-10-05;462;966;1111588;1101564;77.3;76.6
44;2021-10-06;712;1528;1112300;1103092;77.4;76.8
45;2020-12-27;0;0;0;0;0.0;0.0
45;2020-12-28;1;0;1;0;0.0;0.0
45;2020-12-29;0;0;1;0;0.0;0.0
45;2020-12-30;0;0;1;0;0.0;0.0
45;2020-12-31;1;0;2;0;0.0;0.0
45;2021-01-01;0;0;2;0;0.0;0.0
45;2021-01-02;0;0;2;0;0.0;0.0
45;2021-01-03;0;0;2;0;0.0;0.0
45;2021-01-04;0;0;2;0;0.0;0.0
45;2021-01-05;76;0;78;0;0.0;0.0
45;2021-01-06;68;0;146;0;0.0;0.0
45;2021-01-07;216;0;362;0;0.1;0.0
45;2021-01-08;199;1;561;1;0.1;0.0
45;2021-01-09;42;0;603;1;0.1;0.0
45;2021-01-10;23;0;626;1;0.1;0.0
45;2021-01-11;254;0;880;1;0.1;0.0
45;2021-01-12;680;3;1560;4;0.2;0.0
45;2021-01-13;496;1;2056;5;0.3;0.0
45;2021-01-14;494;39;2550;44;0.4;0.0
45;2021-01-15;391;3;2941;47;0.4;0.0
45;2021-01-16;39;1;2980;48;0.4;0.0
45;2021-01-17;24;0;3004;48;0.4;0.0
45;2021-01-18;816;1;3820;49;0.6;0.0
45;2021-01-19;1197;5;5017;54;0.7;0.0
45;2021-01-20;2119;12;7136;66;1.0;0.0
45;2021-01-21;2521;6;9657;72;1.4;0.0
45;2021-01-22;1409;6;11066;78;1.6;0.0
45;2021-01-23;124;0;11190;78;1.6;0.0
45;2021-01-24;39;0;11229;78;1.6;0.0
45;2021-01-25;557;3;11786;81;1.7;0.0
45;2021-01-26;870;16;12656;97;1.9;0.0
45;2021-01-27;650;42;13306;139;1.9;0.0
45;2021-01-28;881;197;14187;336;2.1;0.0
45;2021-01-29;578;109;14765;445;2.2;0.1
45;2021-01-30;40;35;14805;480;2.2;0.1
45;2021-01-31;37;22;14842;502;2.2;0.1
45;2021-02-01;461;192;15303;694;2.2;0.1
45;2021-02-02;761;436;16064;1130;2.4;0.2
45;2021-02-03;773;443;16837;1573;2.5;0.2
45;2021-02-04;715;257;17552;1830;2.6;0.3
45;2021-02-05;418;149;17970;1979;2.6;0.3
45;2021-02-06;39;25;18009;2004;2.6;0.3
45;2021-02-07;7;24;18016;2028;2.6;0.3
45;2021-02-08;455;175;18471;2203;2.7;0.3
45;2021-02-09;1006;356;19477;2559;2.9;0.4
45;2021-02-10;1279;766;20756;3325;3.0;0.5
45;2021-02-11;1385;1441;22141;4766;3.2;0.7
45;2021-02-12;1052;1069;23193;5835;3.4;0.9
45;2021-02-13;85;148;23278;5983;3.4;0.9
45;2021-02-14;40;11;23318;5994;3.4;0.9
45;2021-02-15;524;451;23842;6445;3.5;0.9
45;2021-02-16;757;721;24599;7166;3.6;1.0
45;2021-02-17;642;803;25241;7969;3.7;1.2
45;2021-02-18;841;649;26082;8618;3.8;1.3
45;2021-02-19;827;635;26909;9253;3.9;1.4
45;2021-02-20;59;75;26968;9328;3.9;1.4
45;2021-02-21;17;33;26985;9361;4.0;1.4
45;2021-02-22;409;466;27394;9827;4.0;1.4
45;2021-02-23;816;574;28210;10401;4.1;1.5
45;2021-02-24;655;695;28865;11096;4.2;1.6
45;2021-02-25;963;587;29828;11683;4.4;1.7
45;2021-02-26;1044;519;30872;12202;4.5;1.8
45;2021-02-27;290;33;31162;12235;4.6;1.8
45;2021-02-28;28;2;31190;12237;4.6;1.8
45;2021-03-01;536;249;31726;12486;4.6;1.8
45;2021-03-02;668;570;32394;13056;4.7;1.9
45;2021-03-03;981;742;33375;13798;4.9;2.0
45;2021-03-04;1108;912;34483;14710;5.0;2.2
45;2021-03-05;1445;774;35928;15484;5.3;2.3
45;2021-03-06;2021;126;37949;15610;5.6;2.3
45;2021-03-07;143;53;38092;15663;5.6;2.3
45;2021-03-08;754;766;38846;16429;5.7;2.4
45;2021-03-09;1256;591;40102;17020;5.9;2.5
45;2021-03-10;1591;809;41693;17829;6.1;2.6
45;2021-03-11;1722;685;43415;18514;6.4;2.7
45;2021-03-12;2072;567;45487;19081;6.7;2.8
45;2021-03-13;988;44;46475;19125;6.8;2.8
45;2021-03-14;24;39;46499;19164;6.8;2.8
45;2021-03-15;810;572;47309;19736;6.9;2.9
45;2021-03-16;942;811;48251;20547;7.1;3.0
45;2021-03-17;1054;652;49305;21199;7.2;3.1
45;2021-03-18;997;572;50302;21771;7.4;3.2
45;2021-03-19;1619;418;51921;22189;7.6;3.2
45;2021-03-20;498;80;52419;22269;7.7;3.3
45;2021-03-21;20;35;52439;22304;7.7;3.3
45;2021-03-22;915;519;53354;22823;7.8;3.3
45;2021-03-23;1985;710;55339;23533;8.1;3.4
45;2021-03-24;1897;541;57236;24074;8.4;3.5
45;2021-03-25;2983;452;60219;24526;8.8;3.6
45;2021-03-26;3390;483;63609;25009;9.3;3.7
45;2021-03-27;1796;123;65405;25132;9.6;3.7
45;2021-03-28;89;40;65494;25172;9.6;3.7
45;2021-03-29;1531;538;67025;25710;9.8;3.8
45;2021-03-30;2785;779;69810;26489;10.2;3.9
45;2021-03-31;2134;578;71944;27067;10.5;4.0
45;2021-04-01;2968;565;74912;27632;11.0;4.0
45;2021-04-02;2827;513;77739;28145;11.4;4.1
45;2021-04-03;810;71;78549;28216;11.5;4.1
45;2021-04-04;113;33;78662;28249;11.5;4.1
45;2021-04-05;15;2;78677;28251;11.5;4.1
45;2021-04-06;1735;792;80412;29043;11.8;4.3
45;2021-04-07;1775;1112;82187;30155;12.0;4.4
45;2021-04-08;2772;1021;84959;31176;12.4;4.6
45;2021-04-09;3676;647;88635;31823;13.0;4.7
45;2021-04-10;2323;118;90958;31941;13.3;4.7
45;2021-04-11;153;24;91111;31965;13.3;4.7
45;2021-04-12;2606;671;93717;32636;13.7;4.8
45;2021-04-13;3848;1091;97565;33727;14.3;4.9
45;2021-04-14;2930;1218;100495;34945;14.7;5.1
45;2021-04-15;3518;1040;104013;35985;15.2;5.3
45;2021-04-16;3775;691;107788;36676;15.8;5.4
45;2021-04-17;1614;112;109402;36788;16.0;5.4
45;2021-04-18;200;42;109602;36830;16.0;5.4
45;2021-04-19;1938;940;111540;37770;16.3;5.5
45;2021-04-20;3074;1694;114614;39464;16.8;5.8
45;2021-04-21;2726;1304;117340;40768;17.2;6.0
45;2021-04-22;3420;1844;120760;42612;17.7;6.2
45;2021-04-23;3278;1784;124038;44396;18.2;6.5
45;2021-04-24;2023;867;126061;45263;18.5;6.6
45;2021-04-25;291;86;126352;45349;18.5;6.6
45;2021-04-26;2228;1163;128580;46512;18.8;6.8
45;2021-04-27;3351;2350;131931;48862;19.3;7.2
45;2021-04-28;2802;1936;134733;50798;19.7;7.4
45;2021-04-29;3854;2320;138587;53118;20.3;7.8
45;2021-04-30;4391;1801;142978;54919;20.9;8.0
45;2021-05-01;451;61;143429;54980;21.0;8.1
45;2021-05-02;627;122;144056;55102;21.1;8.1
45;2021-05-03;2821;992;146877;56094;21.5;8.2
45;2021-05-04;3157;2349;150034;58443;22.0;8.6
45;2021-05-05;2715;2161;152749;60604;22.4;8.9
45;2021-05-06;3330;2539;156079;63143;22.9;9.2
45;2021-05-07;2871;3183;158950;66326;23.3;9.7
45;2021-05-08;613;244;159563;66570;23.4;9.7
45;2021-05-09;1498;132;161061;66702;23.6;9.8
45;2021-05-10;4139;2968;165200;69670;24.2;10.2
45;2021-05-11;5030;2969;170230;72639;24.9;10.6
45;2021-05-12;6078;2773;176308;75412;25.8;11.0
45;2021-05-13;2449;598;178757;76010;26.2;11.1
45;2021-05-14;4965;1629;183722;77639;26.9;11.4
45;2021-05-15;4064;616;187786;78255;27.5;11.5
45;2021-05-16;289;33;188075;78288;27.5;11.5
45;2021-05-17;3359;1528;191434;79816;28.0;11.7
45;2021-05-18;5117;1681;196551;81497;28.8;11.9
45;2021-05-19;4494;2064;201045;83561;29.4;12.2
45;2021-05-20;5268;2137;206313;85698;30.2;12.5
45;2021-05-21;5141;2224;211454;87922;31.0;12.9
45;2021-05-22;3042;632;214496;88554;31.4;13.0
45;2021-05-23;15;94;214511;88648;31.4;13.0
45;2021-05-24;2826;215;217337;88863;31.8;13.0
45;2021-05-25;4961;3030;222298;91893;32.6;13.5
45;2021-05-26;5108;2337;227406;94230;33.3;13.8
45;2021-05-27;5306;3229;232712;97459;34.1;14.3
45;2021-05-28;5665;3590;238377;101049;34.9;14.8
45;2021-05-29;3671;1288;242048;102337;35.4;15.0
45;2021-05-30;33;182;242081;102519;35.4;15.0
45;2021-05-31;4331;2513;246412;105032;36.1;15.4
45;2021-06-01;6090;3003;252502;108035;37.0;15.8
45;2021-06-02;4937;3107;257439;111142;37.7;16.3
45;2021-06-03;5615;3199;263054;114341;38.5;16.7
45;2021-06-04;5895;3178;268949;117519;39.4;17.2
45;2021-06-05;2035;1332;270984;118851;39.7;17.4
45;2021-06-06;88;198;271072;119049;39.7;17.4
45;2021-06-07;4081;2722;275153;121771;40.3;17.8
45;2021-06-08;4646;4071;279799;125842;41.0;18.4
45;2021-06-09;4356;3343;284155;129185;41.6;18.9
45;2021-06-10;4646;2687;288801;131872;42.3;19.3
45;2021-06-11;4121;3661;292922;135533;42.9;19.8
45;2021-06-12;2440;1504;295362;137037;43.3;20.1
45;2021-06-13;21;424;295383;137461;43.3;20.1
45;2021-06-14;3142;4151;298525;141612;43.7;20.7
45;2021-06-15;3389;4324;301914;145936;44.2;21.4
45;2021-06-16;3905;3453;305819;149389;44.8;21.9
45;2021-06-17;3523;3538;309342;152927;45.3;22.4
45;2021-06-18;3799;5028;313141;157955;45.9;23.1
45;2021-06-19;2393;1761;315534;159716;46.2;23.4
45;2021-06-20;48;142;315582;159858;46.2;23.4
45;2021-06-21;2164;5851;317746;165709;46.5;24.3
45;2021-06-22;2417;6529;320163;172238;46.9;25.2
45;2021-06-23;2282;5598;322445;177836;47.2;26.0
45;2021-06-24;2136;3531;324581;181367;47.5;26.6
45;2021-06-25;2444;6446;327025;187813;47.9;27.5
45;2021-06-26;1948;3094;328973;190907;48.2;28.0
45;2021-06-27;53;138;329026;191045;48.2;28.0
45;2021-06-28;2083;4828;331109;195873;48.5;28.7
45;2021-06-29;2847;6816;333956;202689;48.9;29.7
45;2021-06-30;2888;5852;336844;208541;49.3;30.5
45;2021-07-01;2398;5038;339242;213579;49.7;31.3
45;2021-07-02;2378;6282;341620;219861;50.0;32.2
45;2021-07-03;754;2540;342374;222401;50.1;32.6
45;2021-07-04;6;12;342380;222413;50.1;32.6
45;2021-07-05;2143;4992;344523;227405;50.5;33.3
45;2021-07-06;2806;6776;347329;234181;50.9;34.3
45;2021-07-07;2447;6061;349776;240242;51.2;35.2
45;2021-07-08;2826;5376;352602;245618;51.6;36.0
45;2021-07-09;2146;6984;354748;252602;51.9;37.0
45;2021-07-10;1552;3862;356300;256464;52.2;37.6
45;2021-07-11;24;31;356324;256495;52.2;37.6
45;2021-07-12;1591;5996;357915;262491;52.4;38.4
45;2021-07-13;3042;8236;360957;270727;52.9;39.6
45;2021-07-14;1480;1519;362437;272246;53.1;39.9
45;2021-07-15;3734;7290;366171;279536;53.6;40.9
45;2021-07-16;3255;7446;369426;286982;54.1;42.0
45;2021-07-17;1285;2332;370711;289314;54.3;42.4
45;2021-07-18;15;19;370726;289333;54.3;42.4
45;2021-07-19;1870;5935;372596;295268;54.6;43.2
45;2021-07-20;4757;6900;377353;302168;55.3;44.2
45;2021-07-21;5176;5478;382529;307646;56.0;45.1
45;2021-07-22;6178;4904;388707;312550;56.9;45.8
45;2021-07-23;4260;5479;392967;318029;57.5;46.6
45;2021-07-24;1863;2824;394830;320853;57.8;47.0
45;2021-07-25;5;14;394835;320867;57.8;47.0
45;2021-07-26;2913;4983;397748;325850;58.2;47.7
45;2021-07-27;5465;5084;403213;330934;59.0;48.5
45;2021-07-28;4989;4181;408202;335115;59.8;49.1
45;2021-07-29;5280;3255;413482;338370;60.5;49.5
45;2021-07-30;4761;4708;418243;343078;61.2;50.2
45;2021-07-31;849;1950;419092;345028;61.4;50.5
45;2021-08-01;2;4;419094;345032;61.4;50.5
45;2021-08-02;3640;3244;422734;348276;61.9;51.0
45;2021-08-03;4877;3011;427611;351287;62.6;51.4
45;2021-08-04;3744;2235;431355;353522;63.2;51.8
45;2021-08-05;3327;2637;434682;356159;63.7;52.2
45;2021-08-06;3747;3271;438429;359430;64.2;52.6
45;2021-08-07;1679;1050;440108;360480;64.4;52.8
45;2021-08-08;9;18;440117;360498;64.4;52.8
45;2021-08-09;2627;3014;442744;363512;64.8;53.2
45;2021-08-10;3516;3807;446260;367319;65.3;53.8
45;2021-08-11;2701;3719;448961;371038;65.7;54.3
45;2021-08-12;2093;3431;451054;374469;66.1;54.8
45;2021-08-13;1744;4224;452798;378693;66.3;55.5
45;2021-08-14;682;956;453480;379649;66.4;55.6
45;2021-08-15;62;31;453542;379680;66.4;55.6
45;2021-08-16;1159;2319;454701;381999;66.6;55.9
45;2021-08-17;1858;3448;456559;385447;66.9;56.4
45;2021-08-18;1782;4050;458341;389497;67.1;57.0
45;2021-08-19;1445;4268;459786;393765;67.3;57.7
45;2021-08-20;1424;3681;461210;397446;67.5;58.2
45;2021-08-21;905;1154;462115;398600;67.7;58.4
45;2021-08-22;4;8;462119;398608;67.7;58.4
45;2021-08-23;1333;4246;463452;402854;67.9;59.0
45;2021-08-24;1736;4522;465188;407376;68.1;59.7
45;2021-08-25;1585;3725;466773;411101;68.4;60.2
45;2021-08-26;1010;3450;467783;414551;68.5;60.7
45;2021-08-27;1432;4981;469215;419532;68.7;61.4
45;2021-08-28;878;2030;470093;421562;68.8;61.7
45;2021-08-29;100;38;470193;421600;68.9;61.7
45;2021-08-30;1221;4117;471414;425717;69.0;62.3
45;2021-08-31;1076;4514;472490;430231;69.2;63.0
45;2021-09-01;1105;3550;473595;433781;69.4;63.5
45;2021-09-02;925;3355;474520;437136;69.5;64.0
45;2021-09-03;1089;3845;475609;440981;69.6;64.6
45;2021-09-04;495;1318;476104;442299;69.7;64.8
45;2021-09-05;1;16;476105;442315;69.7;64.8
45;2021-09-06;884;2822;476989;445137;69.8;65.2
45;2021-09-07;712;2232;477701;447369;70.0;65.5
45;2021-09-08;856;2621;478557;449990;70.1;65.9
45;2021-09-09;798;1681;479355;451671;70.2;66.1
45;2021-09-10;785;1883;480140;453554;70.3;66.4
45;2021-09-11;442;1607;480582;455161;70.4;66.7
45;2021-09-12;372;369;480954;455530;70.4;66.7
45;2021-09-13;436;1297;481390;456827;70.5;66.9
45;2021-09-14;757;2079;482147;458906;70.6;67.2
45;2021-09-15;800;1827;482947;460733;70.7;67.5
45;2021-09-16;802;960;483749;461693;70.8;67.6
45;2021-09-17;766;1654;484515;463347;71.0;67.9
45;2021-09-18;481;992;484996;464339;71.0;68.0
45;2021-09-19;2;29;484998;464368;71.0;68.0
45;2021-09-20;412;980;485410;465348;71.1;68.1
45;2021-09-21;446;749;485856;466097;71.1;68.3
45;2021-09-22;439;1702;486295;467799;71.2;68.5
45;2021-09-23;528;839;486823;468638;71.3;68.6
45;2021-09-24;578;1375;487401;470013;71.4;68.8
45;2021-09-25;351;782;487752;470795;71.4;68.9
45;2021-09-26;2;11;487754;470806;71.4;68.9
45;2021-09-27;435;757;488189;471563;71.5;69.1
45;2021-09-28;450;754;488639;472317;71.6;69.2
45;2021-09-29;477;967;489116;473284;71.6;69.3
45;2021-09-30;357;822;489473;474106;71.7;69.4
45;2021-10-01;317;767;489790;474873;71.7;69.5
45;2021-10-02;293;544;490083;475417;71.8;69.6
45;2021-10-03;98;369;490181;475786;71.8;69.7
45;2021-10-04;219;341;490400;476127;71.8;69.7
45;2021-10-05;347;654;490747;476781;71.9;69.8
45;2021-10-06;434;717;491181;477498;71.9;69.9
46;2020-12-27;4;0;4;0;0.0;0.0
46;2020-12-28;0;0;4;0;0.0;0.0
46;2020-12-29;0;0;4;0;0.0;0.0
46;2020-12-30;0;0;4;0;0.0;0.0
46;2020-12-31;0;0;4;0;0.0;0.0
46;2021-01-01;0;0;4;0;0.0;0.0
46;2021-01-02;0;0;4;0;0.0;0.0
46;2021-01-03;1;0;5;0;0.0;0.0
46;2021-01-04;0;0;5;0;0.0;0.0
46;2021-01-05;0;0;5;0;0.0;0.0
46;2021-01-06;3;0;8;0;0.0;0.0
46;2021-01-07;136;0;144;0;0.1;0.0
46;2021-01-08;181;0;325;0;0.2;0.0
46;2021-01-09;1;0;326;0;0.2;0.0
46;2021-01-10;2;0;328;0;0.2;0.0
46;2021-01-11;118;0;446;0;0.3;0.0
46;2021-01-12;140;0;586;0;0.3;0.0
46;2021-01-13;235;0;821;0;0.5;0.0
46;2021-01-14;243;2;1064;2;0.6;0.0
46;2021-01-15;306;2;1370;4;0.8;0.0
46;2021-01-16;18;0;1388;4;0.8;0.0
46;2021-01-17;0;0;1388;4;0.8;0.0
46;2021-01-18;276;2;1664;6;1.0;0.0
46;2021-01-19;390;0;2054;6;1.2;0.0
46;2021-01-20;939;2;2993;8;1.7;0.0
46;2021-01-21;997;0;3990;8;2.3;0.0
46;2021-01-22;391;2;4381;10;2.5;0.0
46;2021-01-23;0;0;4381;10;2.5;0.0
46;2021-01-24;0;0;4381;10;2.5;0.0
46;2021-01-25;204;1;4585;11;2.6;0.0
46;2021-01-26;264;1;4849;12;2.8;0.0
46;2021-01-27;276;0;5125;12;3.0;0.0
46;2021-01-28;279;43;5404;55;3.1;0.0
46;2021-01-29;233;61;5637;116;3.3;0.1
46;2021-01-30;1;0;5638;116;3.3;0.1
46;2021-01-31;1;0;5639;116;3.3;0.1
46;2021-02-01;234;141;5873;257;3.4;0.1
46;2021-02-02;210;201;6083;458;3.5;0.3
46;2021-02-03;227;90;6310;548;3.6;0.3
46;2021-02-04;372;73;6682;621;3.9;0.4
46;2021-02-05;226;153;6908;774;4.0;0.4
46;2021-02-06;9;0;6917;774;4.0;0.4
46;2021-02-07;43;0;6960;774;4.0;0.4
46;2021-02-08;197;125;7157;899;4.1;0.5
46;2021-02-09;271;202;7428;1101;4.3;0.6
46;2021-02-10;280;482;7708;1583;4.5;0.9
46;2021-02-11;655;509;8363;2092;4.8;1.2
46;2021-02-12;324;313;8687;2405;5.0;1.4
46;2021-02-13;2;0;8689;2405;5.0;1.4
46;2021-02-14;0;62;8689;2467;5.0;1.4
46;2021-02-15;195;223;8884;2690;5.1;1.6
46;2021-02-16;217;214;9101;2904;5.3;1.7
46;2021-02-17;201;276;9302;3180;5.4;1.8
46;2021-02-18;337;227;9639;3407;5.6;2.0
46;2021-02-19;277;199;9916;3606;5.7;2.1
46;2021-02-20;0;0;9916;3606;5.7;2.1
46;2021-02-21;1;0;9917;3606;5.7;2.1
46;2021-02-22;131;156;10048;3762;5.8;2.2
46;2021-02-23;225;130;10273;3892;5.9;2.2
46;2021-02-24;179;262;10452;4154;6.0;2.4
46;2021-02-25;247;288;10699;4442;6.2;2.6
46;2021-02-26;403;313;11102;4755;6.4;2.7
46;2021-02-27;120;1;11222;4756;6.5;2.7
46;2021-02-28;0;3;11222;4759;6.5;2.7
46;2021-03-01;169;157;11391;4916;6.6;2.8
46;2021-03-02;406;198;11797;5114;6.8;3.0
46;2021-03-03;460;309;12257;5423;7.1;3.1
46;2021-03-04;607;413;12864;5836;7.4;3.4
46;2021-03-05;808;335;13672;6171;7.9;3.6
46;2021-03-06;476;15;14148;6186;8.2;3.6
46;2021-03-07;101;19;14249;6205;8.2;3.6
46;2021-03-08;348;223;14597;6428;8.4;3.7
46;2021-03-09;746;255;15343;6683;8.9;3.9
46;2021-03-10;686;234;16029;6917;9.3;4.0
46;2021-03-11;851;247;16880;7164;9.7;4.1
46;2021-03-12;927;205;17807;7369;10.3;4.3
46;2021-03-13;512;4;18319;7373;10.6;4.3
46;2021-03-14;0;0;18319;7373;10.6;4.3
46;2021-03-15;505;153;18824;7526;10.9;4.3
46;2021-03-16;752;165;19576;7691;11.3;4.4
46;2021-03-17;674;188;20250;7879;11.7;4.5
46;2021-03-18;758;204;21008;8083;12.1;4.7
46;2021-03-19;811;147;21819;8230;12.6;4.8
46;2021-03-20;294;4;22113;8234;12.8;4.8
46;2021-03-21;2;0;22115;8234;12.8;4.8
46;2021-03-22;555;238;22670;8472;13.1;4.9
46;2021-03-23;702;209;23372;8681;13.5;5.0
46;2021-03-24;673;237;24045;8918;13.9;5.1
46;2021-03-25;1135;177;25180;9095;14.5;5.3
46;2021-03-26;1023;338;26203;9433;15.1;5.4
46;2021-03-27;420;50;26623;9483;15.4;5.5
46;2021-03-28;127;1;26750;9484;15.4;5.5
46;2021-03-29;733;251;27483;9735;15.9;5.6
46;2021-03-30;767;364;28250;10099;16.3;5.8
46;2021-03-31;865;415;29115;10514;16.8;6.1
46;2021-04-01;1172;345;30287;10859;17.5;6.3
46;2021-04-02;922;393;31209;11252;18.0;6.5
46;2021-04-03;167;165;31376;11417;18.1;6.6
46;2021-04-04;0;71;31376;11488;18.1;6.6
46;2021-04-05;3;0;31379;11488;18.1;6.6
46;2021-04-06;544;517;31923;12005;18.4;6.9
46;2021-04-07;784;644;32707;12649;18.9;7.3
46;2021-04-08;960;540;33667;13189;19.4;7.6
46;2021-04-09;1018;506;34685;13695;20.0;7.9
46;2021-04-10;506;208;35191;13903;20.3;8.0
46;2021-04-11;232;1;35423;13904;20.5;8.0
46;2021-04-12;845;546;36268;14450;20.9;8.3
46;2021-04-13;1187;718;37455;15168;21.6;8.8
46;2021-04-14;1533;612;38988;15780;22.5;9.1
46;2021-04-15;1504;661;40492;16441;23.4;9.5
46;2021-04-16;1584;566;42076;17007;24.3;9.8
46;2021-04-17;995;136;43071;17143;24.9;9.9
46;2021-04-18;517;9;43588;17152;25.2;9.9
46;2021-04-19;1070;570;44658;17722;25.8;10.2
46;2021-04-20;1229;729;45887;18451;26.5;10.7
46;2021-04-21;1230;711;47117;19162;27.2;11.1
46;2021-04-22;1391;726;48508;19888;28.0;11.5
46;2021-04-23;1132;732;49640;20620;28.7;11.9
46;2021-04-24;472;19;50112;20639;28.9;11.9
46;2021-04-25;351;11;50463;20650;29.1;11.9
46;2021-04-26;852;730;51315;21380;29.6;12.3
46;2021-04-27;1221;665;52536;22045;30.3;12.7
46;2021-04-28;1289;668;53825;22713;31.1;13.1
46;2021-04-29;1417;522;55242;23235;31.9;13.4
46;2021-04-30;1438;566;56680;23801;32.7;13.7
46;2021-05-01;697;73;57377;23874;33.1;13.8
46;2021-05-02;346;4;57723;23878;33.3;13.8
46;2021-05-03;853;568;58576;24446;33.8;14.1
46;2021-05-04;1037;1061;59613;25507;34.4;14.7
46;2021-05-05;1374;787;60987;26294;35.2;15.2
46;2021-05-06;1377;741;62364;27035;36.0;15.6
46;2021-05-07;1396;792;63760;27827;36.8;16.1
46;2021-05-08;280;410;64040;28237;37.0;16.3
46;2021-05-09;23;225;64063;28462;37.0;16.4
46;2021-05-10;516;1136;64579;29598;37.3;17.1
46;2021-05-11;1031;1254;65610;30852;37.9;17.8
46;2021-05-12;993;1556;66603;32408;38.5;18.7
46;2021-05-13;598;143;67201;32551;38.8;18.8
46;2021-05-14;958;1097;68159;33648;39.4;19.4
46;2021-05-15;254;654;68413;34302;39.5;19.8
46;2021-05-16;77;297;68490;34599;39.6;20.0
46;2021-05-17;652;960;69142;35559;39.9;20.5
46;2021-05-18;1402;1024;70544;36583;40.7;21.1
46;2021-05-19;1305;904;71849;37487;41.5;21.6
46;2021-05-20;1453;810;73302;38297;42.3;22.1
46;2021-05-21;997;1158;74299;39455;42.9;22.8
46;2021-05-22;146;367;74445;39822;43.0;23.0
46;2021-05-23;451;26;74896;39848;43.3;23.0
46;2021-05-24;411;113;75307;39961;43.5;23.1
46;2021-05-25;960;1333;76267;41294;44.0;23.8
46;2021-05-26;1237;1149;77504;42443;44.8;24.5
46;2021-05-27;1432;1192;78936;43635;45.6;25.2
46;2021-05-28;1428;1208;80364;44843;46.4;25.9
46;2021-05-29;1049;397;81413;45240;47.0;26.1
46;2021-05-30;409;39;81822;45279;47.3;26.1
46;2021-05-31;968;976;82790;46255;47.8;26.7
46;2021-06-01;1277;996;84067;47251;48.5;27.3
46;2021-06-02;1319;1116;85386;48367;49.3;27.9
46;2021-06-03;1415;1011;86801;49378;50.1;28.5
46;2021-06-04;1329;977;88130;50355;50.9;29.1
46;2021-06-05;381;414;88511;50769;51.1;29.3
46;2021-06-06;209;96;88720;50865;51.2;29.4
46;2021-06-07;814;616;89534;51481;51.7;29.7
46;2021-06-08;1020;895;90554;52376;52.3;30.2
46;2021-06-09;1504;974;92058;53350;53.2;30.8
46;2021-06-10;981;850;93039;54200;53.7;31.3
46;2021-06-11;969;1321;94008;55521;54.3;32.1
46;2021-06-12;459;545;94467;56066;54.6;32.4
46;2021-06-13;27;86;94494;56152;54.6;32.4
46;2021-06-14;593;1138;95087;57290;54.9;33.1
46;2021-06-15;751;1245;95838;58535;55.3;33.8
46;2021-06-16;1002;1113;96840;59648;55.9;34.4
46;2021-06-17;527;895;97367;60543;56.2;35.0
46;2021-06-18;656;1253;98023;61796;56.6;35.7
46;2021-06-19;457;313;98480;62109;56.9;35.9
46;2021-06-20;39;161;98519;62270;56.9;36.0
46;2021-06-21;429;946;98948;63216;57.1;36.5
46;2021-06-22;350;1177;99298;64393;57.3;37.2
46;2021-06-23;519;1074;99817;65467;57.6;37.8
46;2021-06-24;251;820;100068;66287;57.8;38.3
46;2021-06-25;491;1118;100559;67405;58.1;38.9
46;2021-06-26;398;553;100957;67958;58.3;39.2
46;2021-06-27;3;4;100960;67962;58.3;39.2
46;2021-06-28;315;1340;101275;69302;58.5;40.0
46;2021-06-29;375;1680;101650;70982;58.7;41.0
46;2021-06-30;510;1577;102160;72559;59.0;41.9
46;2021-07-01;487;1153;102647;73712;59.3;42.6
46;2021-07-02;455;1087;103102;74799;59.5;43.2
46;2021-07-03;120;454;103222;75253;59.6;43.5
46;2021-07-04;57;127;103279;75380;59.6;43.5
46;2021-07-05;347;1186;103626;76566;59.8;44.2
46;2021-07-06;449;1457;104075;78023;60.1;45.1
46;2021-07-07;583;1726;104658;79749;60.4;46.1
46;2021-07-08;340;1164;104998;80913;60.6;46.7
46;2021-07-09;395;1706;105393;82619;60.9;47.7
46;2021-07-10;285;1039;105678;83658;61.0;48.3
46;2021-07-11;15;375;105693;84033;61.0;48.5
46;2021-07-12;248;1259;105941;85292;61.2;49.3
46;2021-07-13;626;1670;106567;86962;61.5;50.2
46;2021-07-14;73;144;106640;87106;61.6;50.3
46;2021-07-15;917;1464;107557;88570;62.1;51.1
46;2021-07-16;766;1394;108323;89964;62.6;52.0
46;2021-07-17;364;539;108687;90503;62.8;52.3
46;2021-07-18;2;0;108689;90503;62.8;52.3
46;2021-07-19;729;1188;109418;91691;63.2;52.9
46;2021-07-20;983;1438;110401;93129;63.8;53.8
46;2021-07-21;1001;1379;111402;94508;64.3;54.6
46;2021-07-22;1404;1118;112806;95626;65.1;55.2
46;2021-07-23;768;1322;113574;96948;65.6;56.0
46;2021-07-24;956;662;114530;97610;66.1;56.4
46;2021-07-25;136;17;114666;97627;66.2;56.4
46;2021-07-26;881;879;115547;98506;66.7;56.9
46;2021-07-27;1220;978;116767;99484;67.4;57.5
46;2021-07-28;1284;1114;118051;100598;68.2;58.1
46;2021-07-29;1580;849;119631;101447;69.1;58.6
46;2021-07-30;1933;956;121564;102403;70.2;59.1
46;2021-07-31;958;662;122522;103065;70.8;59.5
46;2021-08-01;12;3;122534;103068;70.8;59.5
46;2021-08-02;974;591;123508;103659;71.3;59.9
46;2021-08-03;1365;679;124873;104338;72.1;60.3
46;2021-08-04;1735;586;126608;104924;73.1;60.6
46;2021-08-05;1382;842;127990;105766;73.9;61.1
46;2021-08-06;1422;848;129412;106614;74.7;61.6
46;2021-08-07;707;543;130119;107157;75.1;61.9
46;2021-08-08;152;66;130271;107223;75.2;61.9
46;2021-08-09;1016;694;131287;107917;75.8;62.3
46;2021-08-10;1206;892;132493;108809;76.5;62.8
46;2021-08-11;1260;1064;133753;109873;77.2;63.4
46;2021-08-12;990;800;134743;110673;77.8;63.9
46;2021-08-13;953;1005;135696;111678;78.4;64.5
46;2021-08-14;588;774;136284;112452;78.7;64.9
46;2021-08-15;8;27;136292;112479;78.7;65.0
46;2021-08-16;795;811;137087;113290;79.2;65.4
46;2021-08-17;889;1288;137976;114578;79.7;66.2
46;2021-08-18;769;1051;138745;115629;80.1;66.8
46;2021-08-19;672;1363;139417;116992;80.5;67.6
46;2021-08-20;519;1557;139936;118549;80.8;68.5
46;2021-08-21;378;649;140314;119198;81.0;68.8
46;2021-08-22;2;31;140316;119229;81.0;68.9
46;2021-08-23;424;1204;140740;120433;81.3;69.5
46;2021-08-24;554;1338;141294;121771;81.6;70.3
46;2021-08-25;530;1398;141824;123169;81.9;71.1
46;2021-08-26;392;1095;142216;124264;82.1;71.8
46;2021-08-27;436;1912;142652;126176;82.4;72.9
46;2021-08-28;272;652;142924;126828;82.5;73.2
46;2021-08-29;5;11;142929;126839;82.5;73.2
46;2021-08-30;294;1133;143223;127972;82.7;73.9
46;2021-08-31;340;1278;143563;129250;82.9;74.6
46;2021-09-01;393;1147;143956;130397;83.1;75.3
46;2021-09-02;271;1024;144227;131421;83.3;75.9
46;2021-09-03;322;1293;144549;132714;83.5;76.6
46;2021-09-04;188;664;144737;133378;83.6;77.0
46;2021-09-05;8;16;144745;133394;83.6;77.0
46;2021-09-06;219;756;144964;134150;83.7;77.5
46;2021-09-07;252;817;145216;134967;83.9;77.9
46;2021-09-08;277;891;145493;135858;84.0;78.5
46;2021-09-09;200;640;145693;136498;84.1;78.8
46;2021-09-10;277;1025;145970;137523;84.3;79.4
46;2021-09-11;150;389;146120;137912;84.4;79.6
46;2021-09-12;8;23;146128;137935;84.4;79.7
46;2021-09-13;178;693;146306;138628;84.5;80.1
46;2021-09-14;265;735;146571;139363;84.6;80.5
46;2021-09-15;257;677;146828;140040;84.8;80.9
46;2021-09-16;132;265;146960;140305;84.9;81.0
46;2021-09-17;232;555;147192;140860;85.0;81.3
46;2021-09-18;101;364;147293;141224;85.1;81.6
46;2021-09-19;3;9;147296;141233;85.1;81.6
46;2021-09-20;69;350;147365;141583;85.1;81.8
46;2021-09-21;70;237;147435;141820;85.1;81.9
46;2021-09-22;128;482;147563;142302;85.2;82.2
46;2021-09-23;83;225;147646;142527;85.3;82.3
46;2021-09-24;76;400;147722;142927;85.3;82.5
46;2021-09-25;69;221;147791;143148;85.3;82.7
46;2021-09-26;3;8;147794;143156;85.3;82.7
46;2021-09-27;76;229;147870;143385;85.4;82.8
46;2021-09-28;48;225;147918;143610;85.4;82.9
46;2021-09-29;82;290;148000;143900;85.5;83.1
46;2021-09-30;63;146;148063;144046;85.5;83.2
46;2021-10-01;98;296;148161;144342;85.6;83.4
46;2021-10-02;80;191;148241;144533;85.6;83.5
46;2021-10-03;0;0;148241;144533;85.6;83.5
46;2021-10-04;64;189;148305;144722;85.6;83.6
46;2021-10-05;66;220;148371;144942;85.7;83.7
46;2021-10-06;72;219;148443;145161;85.7;83.8
47;2020-12-27;0;0;0;0;0.0;0.0
47;2020-12-28;0;0;0;0;0.0;0.0
47;2020-12-29;0;0;0;0;0.0;0.0
47;2020-12-30;0;0;0;0;0.0;0.0
47;2020-12-31;0;0;0;0;0.0;0.0
47;2021-01-01;4;0;4;0;0.0;0.0
47;2021-01-02;0;0;4;0;0.0;0.0
47;2021-01-03;0;0;4;0;0.0;0.0
47;2021-01-04;0;0;4;0;0.0;0.0
47;2021-01-05;1;0;5;0;0.0;0.0
47;2021-01-06;0;0;5;0;0.0;0.0
47;2021-01-07;71;0;76;0;0.0;0.0
47;2021-01-08;314;0;390;0;0.1;0.0
47;2021-01-09;113;0;503;0;0.2;0.0
47;2021-01-10;0;0;503;0;0.2;0.0
47;2021-01-11;249;1;752;1;0.2;0.0
47;2021-01-12;327;0;1079;1;0.3;0.0
47;2021-01-13;349;0;1428;1;0.4;0.0
47;2021-01-14;370;4;1798;5;0.5;0.0
47;2021-01-15;287;1;2085;6;0.6;0.0
47;2021-01-16;176;3;2261;9;0.7;0.0
47;2021-01-17;0;0;2261;9;0.7;0.0
47;2021-01-18;487;1;2748;10;0.8;0.0
47;2021-01-19;469;2;3217;12;1.0;0.0
47;2021-01-20;516;0;3733;12;1.1;0.0
47;2021-01-21;586;1;4319;13;1.3;0.0
47;2021-01-22;471;0;4790;13;1.5;0.0
47;2021-01-23;390;0;5180;13;1.6;0.0
47;2021-01-24;0;0;5180;13;1.6;0.0
47;2021-01-25;434;0;5614;13;1.7;0.0
47;2021-01-26;792;4;6406;17;1.9;0.0
47;2021-01-27;731;0;7137;17;2.2;0.0
47;2021-01-28;575;60;7712;77;2.3;0.0
47;2021-01-29;461;161;8173;238;2.5;0.1
47;2021-01-30;301;37;8474;275;2.6;0.1
47;2021-01-31;0;0;8474;275;2.6;0.1
47;2021-02-01;372;113;8846;388;2.7;0.1
47;2021-02-02;759;308;9605;696;2.9;0.2
47;2021-02-03;426;149;10031;845;3.0;0.3
47;2021-02-04;370;303;10401;1148;3.1;0.3
47;2021-02-05;300;302;10701;1450;3.2;0.4
47;2021-02-06;297;84;10998;1534;3.3;0.5
47;2021-02-07;0;0;10998;1534;3.3;0.5
47;2021-02-08;183;201;11181;1735;3.4;0.5
47;2021-02-09;232;199;11413;1934;3.5;0.6
47;2021-02-10;254;199;11667;2133;3.5;0.6
47;2021-02-11;356;319;12023;2452;3.6;0.7
47;2021-02-12;243;373;12266;2825;3.7;0.9
47;2021-02-13;226;89;12492;2914;3.8;0.9
47;2021-02-14;0;0;12492;2914;3.8;0.9
47;2021-02-15;194;312;12686;3226;3.8;1.0
47;2021-02-16;303;524;12989;3750;3.9;1.1
47;2021-02-17;326;385;13315;4135;4.0;1.3
47;2021-02-18;201;483;13516;4618;4.1;1.4
47;2021-02-19;193;307;13709;4925;4.2;1.5
47;2021-02-20;117;216;13826;5141;4.2;1.6
47;2021-02-21;0;0;13826;5141;4.2;1.6
47;2021-02-22;75;323;13901;5464;4.2;1.7
47;2021-02-23;149;541;14050;6005;4.3;1.8
47;2021-02-24;261;492;14311;6497;4.3;2.0
47;2021-02-25;304;361;14615;6858;4.4;2.1
47;2021-02-26;467;288;15082;7146;4.6;2.2
47;2021-02-27;324;175;15406;7321;4.7;2.2
47;2021-02-28;0;0;15406;7321;4.7;2.2
47;2021-03-01;124;364;15530;7685;4.7;2.3
47;2021-03-02;199;322;15729;8007;4.8;2.4
47;2021-03-03;244;303;15973;8310;4.8;2.5
47;2021-03-04;593;297;16566;8607;5.0;2.6
47;2021-03-05;844;255;17410;8862;5.3;2.7
47;2021-03-06;505;168;17915;9030;5.4;2.7
47;2021-03-07;331;6;18246;9036;5.5;2.7
47;2021-03-08;459;200;18705;9236;5.7;2.8
47;2021-03-09;508;454;19213;9690;5.8;2.9
47;2021-03-10;666;281;19879;9971;6.0;3.0
47;2021-03-11;940;359;20819;10330;6.3;3.1
47;2021-03-12;1373;267;22192;10597;6.7;3.2
47;2021-03-13;950;108;23142;10705;7.0;3.2
47;2021-03-14;51;0;23193;10705;7.0;3.2
47;2021-03-15;593;151;23786;10856;7.2;3.3
47;2021-03-16;750;158;24536;11014;7.4;3.3
47;2021-03-17;861;203;25397;11217;7.7;3.4
47;2021-03-18;917;174;26314;11391;8.0;3.4
47;2021-03-19;1272;128;27586;11519;8.4;3.5
47;2021-03-20;1088;59;28674;11578;8.7;3.5
47;2021-03-21;344;1;29018;11579;8.8;3.5
47;2021-03-22;1009;94;30027;11673;9.1;3.5
47;2021-03-23;1146;144;31173;11817;9.4;3.6
47;2021-03-24;1214;129;32387;11946;9.8;3.6
47;2021-03-25;1567;150;33954;12096;10.3;3.7
47;2021-03-26;1882;198;35836;12294;10.8;3.7
47;2021-03-27;980;130;36816;12424;11.1;3.8
47;2021-03-28;699;5;37515;12429;11.4;3.8
47;2021-03-29;1511;79;39026;12508;11.8;3.8
47;2021-03-30;1645;127;40671;12635;12.3;3.8
47;2021-03-31;1605;153;42276;12788;12.8;3.9
47;2021-04-01;1682;269;43958;13057;13.3;4.0
47;2021-04-02;1932;452;45890;13509;13.9;4.1
47;2021-04-03;1202;182;47092;13691;14.3;4.1
47;2021-04-04;475;13;47567;13704;14.4;4.1
47;2021-04-05;1297;59;48864;13763;14.8;4.2
47;2021-04-06;1386;388;50250;14151;15.2;4.3
47;2021-04-07;1697;592;51947;14743;15.7;4.5
47;2021-04-08;1834;469;53781;15212;16.3;4.6
47;2021-04-09;2085;542;55866;15754;16.9;4.8
47;2021-04-10;1565;324;57431;16078;17.4;4.9
47;2021-04-11;530;9;57961;16087;17.5;4.9
47;2021-04-12;1438;614;59399;16701;18.0;5.1
47;2021-04-13;1813;763;61212;17464;18.5;5.3
47;2021-04-14;1750;720;62962;18184;19.1;5.5
47;2021-04-15;2012;844;64974;19028;19.7;5.8
47;2021-04-16;1768;890;66742;19918;20.2;6.0
47;2021-04-17;1471;969;68213;20887;20.6;6.3
47;2021-04-18;23;0;68236;20887;20.7;6.3
47;2021-04-19;1331;930;69567;21817;21.1;6.6
47;2021-04-20;1626;910;71193;22727;21.6;6.9
47;2021-04-21;1623;774;72816;23501;22.0;7.1
47;2021-04-22;1880;1056;74696;24557;22.6;7.4
47;2021-04-23;1729;1075;76425;25632;23.1;7.8
47;2021-04-24;1549;803;77974;26435;23.6;8.0
47;2021-04-25;242;345;78216;26780;23.7;8.1
47;2021-04-26;1491;1359;79707;28139;24.1;8.5
47;2021-04-27;1921;1466;81628;29605;24.7;9.0
47;2021-04-28;2090;1589;83718;31194;25.3;9.4
47;2021-04-29;2532;1503;86250;32697;26.1;9.9
47;2021-04-30;2044;1778;88294;34475;26.7;10.4
47;2021-05-01;2263;984;90557;35459;27.4;10.7
47;2021-05-02;21;358;90578;35817;27.4;10.8
47;2021-05-03;1596;1420;92174;37237;27.9;11.3
47;2021-05-04;1645;1729;93819;38966;28.4;11.8
47;2021-05-05;1926;1639;95745;40605;29.0;12.3
47;2021-05-06;2105;1507;97850;42112;29.6;12.7
47;2021-05-07;2001;1621;99851;43733;30.2;13.2
47;2021-05-08;2097;464;101948;44197;30.9;13.4
47;2021-05-09;24;359;101972;44556;30.9;13.5
47;2021-05-10;1202;1670;103174;46226;31.2;14.0
47;2021-05-11;2172;1982;105346;48208;31.9;14.6
47;2021-05-12;2624;1445;107970;49653;32.7;15.0
47;2021-05-13;2380;656;110350;50309;33.4;15.2
47;2021-05-14;2061;859;112411;51168;34.0;15.5
47;2021-05-15;1934;865;114345;52033;34.6;15.8
47;2021-05-16;367;9;114712;52042;34.7;15.8
47;2021-05-17;1884;1124;116596;53166;35.3;16.1
47;2021-05-18;2359;1139;118955;54305;36.0;16.4
47;2021-05-19;2344;759;121299;55064;36.7;16.7
47;2021-05-20;2589;968;123888;56032;37.5;17.0
47;2021-05-21;1538;1133;125426;57165;38.0;17.3
47;2021-05-22;2369;839;127795;58004;38.7;17.6
47;2021-05-23;25;186;127820;58190;38.7;17.6
47;2021-05-24;1549;237;129369;58427;39.2;17.7
47;2021-05-25;1481;1318;130850;59745;39.6;18.1
47;2021-05-26;1599;1091;132449;60836;40.1;18.4
47;2021-05-27;1944;1269;134393;62105;40.7;18.8
47;2021-05-28;1459;1535;135852;63640;41.1;19.3
47;2021-05-29;1153;1120;137005;64760;41.5;19.6
47;2021-05-30;12;45;137017;64805;41.5;19.6
47;2021-05-31;1868;1416;138885;66221;42.0;20.0
47;2021-06-01;1921;1342;140806;67563;42.6;20.5
47;2021-06-02;2100;1332;142906;68895;43.3;20.9
47;2021-06-03;2486;1610;145392;70505;44.0;21.3
47;2021-06-04;1965;2117;147357;72622;44.6;22.0
47;2021-06-05;1640;1470;148997;74092;45.1;22.4
47;2021-06-06;211;70;149208;74162;45.2;22.5
47;2021-06-07;1659;2238;150867;76400;45.7;23.1
47;2021-06-08;1629;1903;152496;78303;46.2;23.7
47;2021-06-09;1824;2122;154320;80425;46.7;24.3
47;2021-06-10;2377;1618;156697;82043;47.4;24.8
47;2021-06-11;1826;2099;158523;84142;48.0;25.5
47;2021-06-12;1351;2102;159874;86244;48.4;26.1
47;2021-06-13;4;10;159878;86254;48.4;26.1
47;2021-06-14;1281;2440;161159;88694;48.8;26.8
47;2021-06-15;1464;2033;162623;90727;49.2;27.5
47;2021-06-16;1203;2183;163826;92910;49.6;28.1
47;2021-06-17;1657;1523;165483;94433;50.1;28.6
47;2021-06-18;1439;2496;166922;96929;50.5;29.3
47;2021-06-19;1542;2452;168464;99381;51.0;30.1
47;2021-06-20;5;33;168469;99414;51.0;30.1
47;2021-06-21;1136;2513;169605;101927;51.3;30.9
47;2021-06-22;762;2506;170367;104433;51.6;31.6
47;2021-06-23;999;2015;171366;106448;51.9;32.2
47;2021-06-24;1211;1936;172577;108384;52.2;32.8
47;2021-06-25;1006;2608;173583;110992;52.5;33.6
47;2021-06-26;986;2789;174569;113781;52.8;34.4
47;2021-06-27;16;349;174585;114130;52.9;34.5
47;2021-06-28;875;2407;175460;116537;53.1;35.3
47;2021-06-29;797;2314;176257;118851;53.4;36.0
47;2021-06-30;730;2303;176987;121154;53.6;36.7
47;2021-07-01;923;2105;177910;123259;53.9;37.3
47;2021-07-02;885;2274;178795;125533;54.1;38.0
47;2021-07-03;726;3042;179521;128575;54.3;38.9
47;2021-07-04;34;12;179555;128587;54.4;38.9
47;2021-07-05;978;2147;180533;130734;54.7;39.6
47;2021-07-06;1007;1957;181540;132691;55.0;40.2
47;2021-07-07;1298;2064;182838;134755;55.3;40.8
47;2021-07-08;1142;2192;183980;136947;55.7;41.5
47;2021-07-09;1047;2404;185027;139351;56.0;42.2
47;2021-07-10;951;2131;185978;141482;56.3;42.8
47;2021-07-11;1;6;185979;141488;56.3;42.8
47;2021-07-12;556;2580;186535;144068;56.5;43.6
47;2021-07-13;1094;2585;187629;146653;56.8;44.4
47;2021-07-14;1165;1577;188794;148230;57.2;44.9
47;2021-07-15;1717;3135;190511;151365;57.7;45.8
47;2021-07-16;1722;2676;192233;154041;58.2;46.6
47;2021-07-17;1201;2458;193434;156499;58.6;47.4
47;2021-07-18;36;188;193470;156687;58.6;47.4
47;2021-07-19;1113;2557;194583;159244;58.9;48.2
47;2021-07-20;1638;2341;196221;161585;59.4;48.9
47;2021-07-21;2193;2240;198414;163825;60.1;49.6
47;2021-07-22;2157;2298;200571;166123;60.7;50.3
47;2021-07-23;2124;2250;202695;168373;61.4;51.0
47;2021-07-24;1114;1915;203809;170288;61.7;51.5
47;2021-07-25;20;1;203829;170289;61.7;51.6
47;2021-07-26;1236;1945;205065;172234;62.1;52.1
47;2021-07-27;2123;1633;207188;173867;62.7;52.6
47;2021-07-28;1880;1606;209068;175473;63.3;53.1
47;2021-07-29;2340;1603;211408;177076;64.0;53.6
47;2021-07-30;1865;1625;213273;178701;64.6;54.1
47;2021-07-31;1486;1668;214759;180369;65.0;54.6
47;2021-08-01;18;8;214777;180377;65.0;54.6
47;2021-08-02;2053;1219;216830;181596;65.6;55.0
47;2021-08-03;2159;1106;218989;182702;66.3;55.3
47;2021-08-04;2192;1527;221181;184229;67.0;55.8
47;2021-08-05;2408;1447;223589;185676;67.7;56.2
47;2021-08-06;1999;1841;225588;187517;68.3;56.8
47;2021-08-07;1628;1418;227216;188935;68.8;57.2
47;2021-08-08;24;22;227240;188957;68.8;57.2
47;2021-08-09;1883;1214;229123;190171;69.4;57.6
47;2021-08-10;1920;1298;231043;191469;69.9;58.0
47;2021-08-11;1804;1401;232847;192870;70.5;58.4
47;2021-08-12;2060;1339;234907;194209;71.1;58.8
47;2021-08-13;1424;1668;236331;195877;71.5;59.3
47;2021-08-14;1349;1443;237680;197320;72.0;59.7
47;2021-08-15;11;18;237691;197338;72.0;59.7
47;2021-08-16;1436;1445;239127;198783;72.4;60.2
47;2021-08-17;1124;1684;240251;200467;72.7;60.7
47;2021-08-18;1181;1714;241432;202181;73.1;61.2
47;2021-08-19;1038;1813;242470;203994;73.4;61.8
47;2021-08-20;972;1708;243442;205702;73.7;62.3
47;2021-08-21;828;1277;244270;206979;73.9;62.7
47;2021-08-22;19;31;244289;207010;74.0;62.7
47;2021-08-23;614;1826;244903;208836;74.1;63.2
47;2021-08-24;811;1622;245714;210458;74.4;63.7
47;2021-08-25;811;1787;246525;212245;74.6;64.3
47;2021-08-26;741;2080;247266;214325;74.9;64.9
47;2021-08-27;700;1978;247966;216303;75.1;65.5
47;2021-08-28;568;1670;248534;217973;75.2;66.0
47;2021-08-29;2;16;248536;217989;75.2;66.0
47;2021-08-30;459;1926;248995;219915;75.4;66.6
47;2021-08-31;583;1816;249578;221731;75.6;67.1
47;2021-09-01;422;2020;250000;223751;75.7;67.7
47;2021-09-02;436;2018;250436;225769;75.8;68.3
47;2021-09-03;504;1954;250940;227723;76.0;68.9
47;2021-09-04;478;1821;251418;229544;76.1;69.5
47;2021-09-05;12;37;251430;229581;76.1;69.5
47;2021-09-06;341;1407;251771;230988;76.2;69.9
47;2021-09-07;478;1268;252249;232256;76.4;70.3
47;2021-09-08;419;1622;252668;233878;76.5;70.8
47;2021-09-09;410;1348;253078;235226;76.6;71.2
47;2021-09-10;472;1331;253550;236557;76.8;71.6
47;2021-09-11;437;1429;253987;237986;76.9;72.0
47;2021-09-12;3;7;253990;237993;76.9;72.0
47;2021-09-13;253;956;254243;238949;77.0;72.3
47;2021-09-14;401;1047;254644;239996;77.1;72.7
47;2021-09-15;342;940;254986;240936;77.2;72.9
47;2021-09-16;323;558;255309;241494;77.3;73.1
47;2021-09-17;391;645;255700;242139;77.4;73.3
47;2021-09-18;263;956;255963;243095;77.5;73.6
47;2021-09-19;4;4;255967;243099;77.5;73.6
47;2021-09-20;164;470;256131;243569;77.5;73.7
47;2021-09-21;285;454;256416;244023;77.6;73.9
47;2021-09-22;214;616;256630;244639;77.7;74.1
47;2021-09-23;209;378;256839;245017;77.8;74.2
47;2021-09-24;283;613;257122;245630;77.8;74.4
47;2021-09-25;215;628;257337;246258;77.9;74.5
47;2021-09-26;6;6;257343;246264;77.9;74.5
47;2021-09-27;112;377;257455;246641;77.9;74.7
47;2021-09-28;127;374;257582;247015;78.0;74.8
47;2021-09-29;148;473;257730;247488;78.0;74.9
47;2021-09-30;159;355;257889;247843;78.1;75.0
47;2021-10-01;182;519;258071;248362;78.1;75.2
47;2021-10-02;194;483;258265;248845;78.2;75.3
47;2021-10-03;0;5;258265;248850;78.2;75.3
47;2021-10-04;132;361;258397;249211;78.2;75.4
47;2021-10-05;110;307;258507;249518;78.3;75.5
47;2021-10-06;226;458;258733;249976;78.3;75.7
48;2020-12-27;0;0;0;0;0.0;0.0
48;2020-12-28;0;0;0;0;0.0;0.0
48;2020-12-29;0;0;0;0;0.0;0.0
48;2020-12-30;0;0;0;0;0.0;0.0
48;2020-12-31;0;0;0;0;0.0;0.0
48;2021-01-01;0;0;0;0;0.0;0.0
48;2021-01-02;0;0;0;0;0.0;0.0
48;2021-01-03;0;0;0;0;0.0;0.0
48;2021-01-04;0;0;0;0;0.0;0.0
48;2021-01-05;0;0;0;0;0.0;0.0
48;2021-01-06;0;0;0;0;0.0;0.0
48;2021-01-07;56;0;56;0;0.1;0.0
48;2021-01-08;88;0;144;0;0.2;0.0
48;2021-01-09;1;0;145;0;0.2;0.0
48;2021-01-10;0;0;145;0;0.2;0.0
48;2021-01-11;13;0;158;0;0.2;0.0
48;2021-01-12;20;1;178;1;0.2;0.0
48;2021-01-13;104;0;282;1;0.4;0.0
48;2021-01-14;90;1;372;2;0.5;0.0
48;2021-01-15;63;0;435;2;0.6;0.0
48;2021-01-16;0;0;435;2;0.6;0.0
48;2021-01-17;0;0;435;2;0.6;0.0
48;2021-01-18;117;0;552;2;0.7;0.0
48;2021-01-19;345;2;897;4;1.2;0.0
48;2021-01-20;364;0;1261;4;1.7;0.0
48;2021-01-21;466;1;1727;5;2.3;0.0
48;2021-01-22;269;0;1996;5;2.6;0.0
48;2021-01-23;36;0;2032;5;2.7;0.0
48;2021-01-24;0;0;2032;5;2.7;0.0
48;2021-01-25;109;2;2141;7;2.8;0.0
48;2021-01-26;261;0;2402;7;3.1;0.0
48;2021-01-27;257;1;2659;8;3.5;0.0
48;2021-01-28;273;10;2932;18;3.8;0.0
48;2021-01-29;175;59;3107;77;4.1;0.1
48;2021-01-30;1;7;3108;84;4.1;0.1
48;2021-01-31;0;6;3108;90;4.1;0.1
48;2021-02-01;100;45;3208;135;4.2;0.2
48;2021-02-02;194;32;3402;167;4.5;0.2
48;2021-02-03;177;81;3579;248;4.7;0.3
48;2021-02-04;234;12;3813;260;5.0;0.3
48;2021-02-05;145;33;3958;293;5.2;0.4
48;2021-02-06;34;1;3992;294;5.2;0.4
48;2021-02-07;0;0;3992;294;5.2;0.4
48;2021-02-08;50;57;4042;351;5.3;0.5
48;2021-02-09;66;151;4108;502;5.4;0.7
48;2021-02-10;64;297;4172;799;5.5;1.0
48;2021-02-11;165;379;4337;1178;5.7;1.5
48;2021-02-12;120;143;4457;1321;5.8;1.7
48;2021-02-13;8;54;4465;1375;5.9;1.8
48;2021-02-14;0;0;4465;1375;5.9;1.8
48;2021-02-15;51;84;4516;1459;5.9;1.9
48;2021-02-16;43;132;4559;1591;6.0;2.1
48;2021-02-17;35;267;4594;1858;6.0;2.4
48;2021-02-18;252;91;4846;1949;6.4;2.6
48;2021-02-19;60;149;4906;2098;6.4;2.8
48;2021-02-20;0;1;4906;2099;6.4;2.8
48;2021-02-21;0;14;4906;2113;6.4;2.8
48;2021-02-22;24;85;4930;2198;6.5;2.9
48;2021-02-23;74;199;5004;2397;6.6;3.1
48;2021-02-24;68;238;5072;2635;6.6;3.5
48;2021-02-25;148;212;5220;2847;6.8;3.7
48;2021-02-26;51;185;5271;3032;6.9;4.0
48;2021-02-27;28;1;5299;3033;6.9;4.0
48;2021-02-28;3;14;5302;3047;7.0;4.0
48;2021-03-01;102;77;5404;3124;7.1;4.1
48;2021-03-02;199;71;5603;3195;7.3;4.2
48;2021-03-03;153;94;5756;3289;7.5;4.3
48;2021-03-04;194;171;5950;3460;7.8;4.5
48;2021-03-05;136;122;6086;3582;8.0;4.7
48;2021-03-06;180;52;6266;3634;8.2;4.8
48;2021-03-07;75;2;6341;3636;8.3;4.8
48;2021-03-08;352;120;6693;3756;8.8;4.9
48;2021-03-09;377;93;7070;3849;9.3;5.0
48;2021-03-10;263;57;7333;3906;9.6;5.1
48;2021-03-11;334;82;7667;3988;10.1;5.2
48;2021-03-12;256;138;7923;4126;10.4;5.4
48;2021-03-13;301;5;8224;4131;10.8;5.4
48;2021-03-14;8;0;8232;4131;10.8;5.4
48;2021-03-15;174;55;8406;4186;11.0;5.5
48;2021-03-16;167;65;8573;4251;11.2;5.6
48;2021-03-17;156;110;8729;4361;11.4;5.7
48;2021-03-18;191;104;8920;4465;11.7;5.9
48;2021-03-19;116;95;9036;4560;11.8;6.0
48;2021-03-20;101;0;9137;4560;12.0;6.0
48;2021-03-21;0;0;9137;4560;12.0;6.0
48;2021-03-22;160;18;9297;4578;12.2;6.0
48;2021-03-23;329;100;9626;4678;12.6;6.1
48;2021-03-24;284;100;9910;4778;13.0;6.3
48;2021-03-25;757;117;10667;4895;14.0;6.4
48;2021-03-26;269;59;10936;4954;14.3;6.5
48;2021-03-27;104;1;11040;4955;14.5;6.5
48;2021-03-28;80;20;11120;4975;14.6;6.5
48;2021-03-29;305;78;11425;5053;15.0;6.6
48;2021-03-30;364;131;11789;5184;15.5;6.8
48;2021-03-31;448;85;12237;5269;16.0;6.9
48;2021-04-01;731;73;12968;5342;17.0;7.0
48;2021-04-02;487;134;13455;5476;17.6;7.2
48;2021-04-03;140;83;13595;5559;17.8;7.3
48;2021-04-04;0;0;13595;5559;17.8;7.3
48;2021-04-05;43;1;13638;5560;17.9;7.3
48;2021-04-06;465;160;14103;5720;18.5;7.5
48;2021-04-07;465;141;14568;5861;19.1;7.7
48;2021-04-08;620;188;15188;6049;19.9;7.9
48;2021-04-09;446;122;15634;6171;20.5;8.1
48;2021-04-10;95;60;15729;6231;20.6;8.2
48;2021-04-11;2;0;15731;6231;20.6;8.2
48;2021-04-12;364;71;16095;6302;21.1;8.3
48;2021-04-13;361;92;16456;6394;21.6;8.4
48;2021-04-14;624;187;17080;6581;22.4;8.6
48;2021-04-15;701;358;17781;6939;23.3;9.1
48;2021-04-16;538;225;18319;7164;24.0;9.4
48;2021-04-17;89;71;18408;7235;24.1;9.5
48;2021-04-18;0;0;18408;7235;24.1;9.5
48;2021-04-19;196;105;18604;7340;24.4;9.6
48;2021-04-20;216;180;18820;7520;24.7;9.9
48;2021-04-21;284;207;19104;7727;25.0;10.1
48;2021-04-22;306;480;19410;8207;25.4;10.8
48;2021-04-23;255;242;19665;8449;25.8;11.1
48;2021-04-24;97;95;19762;8544;25.9;11.2
48;2021-04-25;1;9;19763;8553;25.9;11.2
48;2021-04-26;87;210;19850;8763;26.0;11.5
48;2021-04-27;172;292;20022;9055;26.2;11.9
48;2021-04-28;149;415;20171;9470;26.4;12.4
48;2021-04-29;203;488;20374;9958;26.7;13.1
48;2021-04-30;172;223;20546;10181;26.9;13.3
48;2021-05-01;0;0;20546;10181;26.9;13.3
48;2021-05-02;0;0;20546;10181;26.9;13.3
48;2021-05-03;106;386;20652;10567;27.1;13.9
48;2021-05-04;227;420;20879;10987;27.4;14.4
48;2021-05-05;84;486;20963;11473;27.5;15.0
48;2021-05-06;775;640;21738;12113;28.5;15.9
48;2021-05-07;96;503;21834;12616;28.6;16.5
48;2021-05-08;309;43;22143;12659;29.0;16.6
48;2021-05-09;285;9;22428;12668;29.4;16.6
48;2021-05-10;55;325;22483;12993;29.5;17.0
48;2021-05-11;221;289;22704;13282;29.8;17.4
48;2021-05-12;249;313;22953;13595;30.1;17.8
48;2021-05-13;472;157;23425;13752;30.7;18.0
48;2021-05-14;244;222;23669;13974;31.0;18.3
48;2021-05-15;84;46;23753;14020;31.1;18.4
48;2021-05-16;1;6;23754;14026;31.1;18.4
48;2021-05-17;474;267;24228;14293;31.8;18.7
48;2021-05-18;263;229;24491;14522;32.1;19.0
48;2021-05-19;207;277;24698;14799;32.4;19.4
48;2021-05-20;318;256;25016;15055;32.8;19.7
48;2021-05-21;174;267;25190;15322;33.0;20.1
48;2021-05-22;25;50;25215;15372;33.1;20.2
48;2021-05-23;0;6;25215;15378;33.1;20.2
48;2021-05-24;0;14;25215;15392;33.1;20.2
48;2021-05-25;181;265;25396;15657;33.3;20.5
48;2021-05-26;416;298;25812;15955;33.8;20.9
48;2021-05-27;1178;380;26990;16335;35.4;21.4
48;2021-05-28;315;350;27305;16685;35.8;21.9
48;2021-05-29;79;50;27384;16735;35.9;21.9
48;2021-05-30;0;1;27384;16736;35.9;21.9
48;2021-05-31;624;263;28008;16999;36.7;22.3
48;2021-06-01;272;305;28280;17304;37.1;22.7
48;2021-06-02;407;424;28687;17728;37.6;23.2
48;2021-06-03;629;431;29316;18159;38.4;23.8
48;2021-06-04;291;283;29607;18442;38.8;24.2
48;2021-06-05;121;77;29728;18519;39.0;24.3
48;2021-06-06;1;1;29729;18520;39.0;24.3
48;2021-06-07;440;161;30169;18681;39.5;24.5
48;2021-06-08;615;309;30784;18990;40.4;24.9
48;2021-06-09;379;190;31163;19180;40.9;25.1
48;2021-06-10;1003;242;32166;19422;42.2;25.5
48;2021-06-11;371;161;32537;19583;42.7;25.7
48;2021-06-12;74;57;32611;19640;42.7;25.7
48;2021-06-13;0;2;32611;19642;42.7;25.7
48;2021-06-14;124;115;32735;19757;42.9;25.9
48;2021-06-15;407;386;33142;20143;43.4;26.4
48;2021-06-16;260;144;33402;20287;43.8;26.6
48;2021-06-17;486;575;33888;20862;44.4;27.3
48;2021-06-18;254;314;34142;21176;44.8;27.8
48;2021-06-19;35;291;34177;21467;44.8;28.1
48;2021-06-20;123;224;34300;21691;45.0;28.4
48;2021-06-21;125;134;34425;21825;45.1;28.6
48;2021-06-22;258;335;34683;22160;45.5;29.0
48;2021-06-23;111;545;34794;22705;45.6;29.8
48;2021-06-24;364;610;35158;23315;46.1;30.6
48;2021-06-25;154;276;35312;23591;46.3;30.9
48;2021-06-26;15;45;35327;23636;46.3;31.0
48;2021-06-27;1;1;35328;23637;46.3;31.0
48;2021-06-28;81;177;35409;23814;46.4;31.2
48;2021-06-29;297;415;35706;24229;46.8;31.8
48;2021-06-30;98;465;35804;24694;46.9;32.4
48;2021-07-01;194;669;35998;25363;47.2;33.2
48;2021-07-02;148;369;36146;25732;47.4;33.7
48;2021-07-03;42;89;36188;25821;47.4;33.8
48;2021-07-04;7;0;36195;25821;47.4;33.8
48;2021-07-05;40;117;36235;25938;47.5;34.0
48;2021-07-06;277;598;36512;26536;47.9;34.8
48;2021-07-07;201;489;36713;27025;48.1;35.4
48;2021-07-08;223;1189;36936;28214;48.4;37.0
48;2021-07-09;159;553;37095;28767;48.6;37.7
48;2021-07-10;95;147;37190;28914;48.8;37.9
48;2021-07-11;0;4;37190;28918;48.8;37.9
48;2021-07-12;139;672;37329;29590;48.9;38.8
48;2021-07-13;211;430;37540;30020;49.2;39.4
48;2021-07-14;179;145;37719;30165;49.4;39.5
48;2021-07-15;187;459;37906;30624;49.7;40.1
48;2021-07-16;234;314;38140;30938;50.0;40.6
48;2021-07-17;129;118;38269;31056;50.2;40.7
48;2021-07-18;4;5;38273;31061;50.2;40.7
48;2021-07-19;105;306;38378;31367;50.3;41.1
48;2021-07-20;678;993;39056;32360;51.2;42.4
48;2021-07-21;68;371;39124;32731;51.3;42.9
48;2021-07-22;777;1125;39901;33856;52.3;44.4
48;2021-07-23;367;439;40268;34295;52.8;45.0
48;2021-07-24;509;170;40777;34465;53.5;45.2
48;2021-07-25;138;46;40915;34511;53.6;45.2
48;2021-07-26;101;199;41016;34710;53.8;45.5
48;2021-07-27;1195;644;42211;35354;55.3;46.3
48;2021-07-28;177;316;42388;35670;55.6;46.8
48;2021-07-29;716;646;43104;36316;56.5;47.6
48;2021-07-30;200;292;43304;36608;56.8;48.0
48;2021-07-31;339;178;43643;36786;57.2;48.2
48;2021-08-01;18;55;43661;36841;57.2;48.3
48;2021-08-02;228;164;43889;37005;57.5;48.5
48;2021-08-03;925;575;44814;37580;58.7;49.3
48;2021-08-04;328;220;45142;37800;59.2;49.6
48;2021-08-05;674;475;45816;38275;60.1;50.2
48;2021-08-06;442;275;46258;38550;60.6;50.5
48;2021-08-07;249;125;46507;38675;61.0;50.7
48;2021-08-08;2;5;46509;38680;61.0;50.7
48;2021-08-09;170;141;46679;38821;61.2;50.9
48;2021-08-10;726;555;47405;39376;62.1;51.6
48;2021-08-11;295;238;47700;39614;62.5;51.9
48;2021-08-12;419;414;48119;40028;63.1;52.5
48;2021-08-13;229;212;48348;40240;63.4;52.7
48;2021-08-14;137;165;48485;40405;63.6;53.0
48;2021-08-15;131;81;48616;40486;63.7;53.1
48;2021-08-16;121;192;48737;40678;63.9;53.3
48;2021-08-17;364;1188;49101;41866;64.4;54.9
48;2021-08-18;211;201;49312;42067;64.6;55.1
48;2021-08-19;240;325;49552;42392;65.0;55.6
48;2021-08-20;215;284;49767;42676;65.2;55.9
48;2021-08-21;85;232;49852;42908;65.3;56.2
48;2021-08-22;0;0;49852;42908;65.3;56.2
48;2021-08-23;65;153;49917;43061;65.4;56.4
48;2021-08-24;308;952;50225;44013;65.8;57.7
48;2021-08-25;156;351;50381;44364;66.0;58.2
48;2021-08-26;180;499;50561;44863;66.3;58.8
48;2021-08-27;153;338;50714;45201;66.5;59.3
48;2021-08-28;127;303;50841;45504;66.6;59.6
48;2021-08-29;0;1;50841;45505;66.6;59.7
48;2021-08-30;54;146;50895;45651;66.7;59.8
48;2021-08-31;257;1071;51152;46722;67.1;61.2
48;2021-09-01;125;347;51277;47069;67.2;61.7
48;2021-09-02;131;406;51408;47475;67.4;62.2
48;2021-09-03;138;328;51546;47803;67.6;62.7
48;2021-09-04;121;244;51667;48047;67.7;63.0
48;2021-09-05;3;26;51670;48073;67.7;63.0
48;2021-09-06;34;190;51704;48263;67.8;63.3
48;2021-09-07;159;392;51863;48655;68.0;63.8
48;2021-09-08;96;225;51959;48880;68.1;64.1
48;2021-09-09;96;303;52055;49183;68.2;64.5
48;2021-09-10;128;401;52183;49584;68.4;65.0
48;2021-09-11;89;221;52272;49805;68.5;65.3
48;2021-09-12;1;3;52273;49808;68.5;65.3
48;2021-09-13;78;153;52351;49961;68.6;65.5
48;2021-09-14;204;384;52555;50345;68.9;66.0
48;2021-09-15;68;164;52623;50509;69.0;66.2
48;2021-09-16;121;219;52744;50728;69.1;66.5
48;2021-09-17;101;182;52845;50910;69.3;66.7
48;2021-09-18;31;90;52876;51000;69.3;66.9
48;2021-09-19;0;0;52876;51000;69.3;66.9
48;2021-09-20;29;87;52905;51087;69.4;67.0
48;2021-09-21;63;183;52968;51270;69.4;67.2
48;2021-09-22;49;151;53017;51421;69.5;67.4
48;2021-09-23;28;100;53045;51521;69.5;67.5
48;2021-09-24;43;118;53088;51639;69.6;67.7
48;2021-09-25;27;78;53115;51717;69.6;67.8
48;2021-09-26;1;0;53116;51717;69.6;67.8
48;2021-09-27;11;43;53127;51760;69.6;67.8
48;2021-09-28;66;155;53193;51915;69.7;68.1
48;2021-09-29;51;133;53244;52048;69.8;68.2
48;2021-09-30;40;87;53284;52135;69.8;68.3
48;2021-10-01;56;141;53340;52276;69.9;68.5
48;2021-10-02;33;51;53373;52327;70.0;68.6
48;2021-10-03;0;1;53373;52328;70.0;68.6
48;2021-10-04;19;62;53392;52390;70.0;68.7
48;2021-10-05;48;151;53440;52541;70.1;68.9
48;2021-10-06;65;94;53505;52635;70.1;69.0
49;2020-12-27;0;0;0;0;0.0;0.0
49;2020-12-28;2;0;2;0;0.0;0.0
49;2020-12-29;0;0;2;0;0.0;0.0
49;2020-12-30;0;0;2;0;0.0;0.0
49;2020-12-31;0;0;2;0;0.0;0.0
49;2021-01-01;2;0;4;0;0.0;0.0
49;2021-01-02;1;1;5;1;0.0;0.0
49;2021-01-03;0;0;5;1;0.0;0.0
49;2021-01-04;10;0;15;1;0.0;0.0
49;2021-01-05;92;0;107;1;0.0;0.0
49;2021-01-06;233;0;340;1;0.0;0.0
49;2021-01-07;367;0;707;1;0.1;0.0
49;2021-01-08;328;1;1035;2;0.1;0.0
49;2021-01-09;118;0;1153;2;0.1;0.0
49;2021-01-10;114;0;1267;2;0.2;0.0
49;2021-01-11;287;0;1554;2;0.2;0.0
49;2021-01-12;623;0;2177;2;0.3;0.0
49;2021-01-13;602;2;2779;4;0.3;0.0
49;2021-01-14;590;5;3369;9;0.4;0.0
49;2021-01-15;775;1;4144;10;0.5;0.0
49;2021-01-16;148;0;4292;10;0.5;0.0
49;2021-01-17;111;2;4403;12;0.5;0.0
49;2021-01-18;691;0;5094;12;0.6;0.0
49;2021-01-19;1203;2;6297;14;0.8;0.0
49;2021-01-20;1512;3;7809;17;1.0;0.0
49;2021-01-21;1943;4;9752;21;1.2;0.0
49;2021-01-22;1321;5;11073;26;1.4;0.0
49;2021-01-23;263;0;11336;26;1.4;0.0
49;2021-01-24;1;0;11337;26;1.4;0.0
49;2021-01-25;552;3;11889;29;1.5;0.0
49;2021-01-26;989;74;12878;103;1.6;0.0
49;2021-01-27;1860;35;14738;138;1.8;0.0
49;2021-01-28;2877;75;17615;213;2.2;0.0
49;2021-01-29;1589;83;19204;296;2.4;0.0
49;2021-01-30;300;41;19504;337;2.4;0.0
49;2021-01-31;62;45;19566;382;2.4;0.0
49;2021-02-01;661;148;20227;530;2.5;0.1
49;2021-02-02;744;360;20971;890;2.6;0.1
49;2021-02-03;677;310;21648;1200;2.7;0.1
49;2021-02-04;758;408;22406;1608;2.7;0.2
49;2021-02-05;708;533;23114;2141;2.8;0.3
49;2021-02-06;228;101;23342;2242;2.9;0.3
49;2021-02-07;59;68;23401;2310;2.9;0.3
49;2021-02-08;549;414;23950;2724;2.9;0.3
49;2021-02-09;716;543;24666;3267;3.0;0.4
49;2021-02-10;807;793;25473;4060;3.1;0.5
49;2021-02-11;1028;1311;26501;5371;3.2;0.7
49;2021-02-12;870;895;27371;6266;3.4;0.8
49;2021-02-13;266;99;27637;6365;3.4;0.8
49;2021-02-14;9;90;27646;6455;3.4;0.8
49;2021-02-15;730;590;28376;7045;3.5;0.9
49;2021-02-16;1106;1040;29482;8085;3.6;1.0
49;2021-02-17;1160;1723;30642;9808;3.8;1.2
49;2021-02-18;1811;2343;32453;12151;4.0;1.5
49;2021-02-19;1397;1043;33850;13194;4.1;1.6
49;2021-02-20;232;330;34082;13524;4.2;1.7
49;2021-02-21;0;64;34082;13588;4.2;1.7
49;2021-02-22;647;468;34729;14056;4.3;1.7
49;2021-02-23;734;737;35463;14793;4.3;1.8
49;2021-02-24;824;525;36287;15318;4.4;1.9
49;2021-02-25;1208;674;37495;15992;4.6;2.0
49;2021-02-26;1678;723;39173;16715;4.8;2.0
49;2021-02-27;435;223;39608;16938;4.9;2.1
49;2021-02-28;49;30;39657;16968;4.9;2.1
49;2021-03-01;768;494;40425;17462;5.0;2.1
49;2021-03-02;1082;603;41507;18065;5.1;2.2
49;2021-03-03;1559;598;43066;18663;5.3;2.3
49;2021-03-04;1769;839;44835;19502;5.5;2.4
49;2021-03-05;2214;622;47049;20124;5.8;2.5
49;2021-03-06;717;161;47766;20285;5.9;2.5
49;2021-03-07;627;13;48393;20298;5.9;2.5
49;2021-03-08;1398;657;49791;20955;6.1;2.6
49;2021-03-09;2052;686;51843;21641;6.4;2.7
49;2021-03-10;2530;836;54373;22477;6.7;2.8
49;2021-03-11;3195;1431;57568;23908;7.1;2.9
49;2021-03-12;3766;978;61334;24886;7.5;3.1
49;2021-03-13;1501;198;62835;25084;7.7;3.1
49;2021-03-14;6;0;62841;25084;7.7;3.1
49;2021-03-15;2083;528;64924;25612;8.0;3.1
49;2021-03-16;1732;955;66656;26567;8.2;3.3
49;2021-03-17;1810;674;68466;27241;8.4;3.3
49;2021-03-18;2205;720;70671;27961;8.7;3.4
49;2021-03-19;3333;558;74004;28519;9.1;3.5
49;2021-03-20;1743;204;75747;28723;9.3;3.5
49;2021-03-21;499;22;76246;28745;9.3;3.5
49;2021-03-22;2248;544;78494;29289;9.6;3.6
49;2021-03-23;3406;675;81900;29964;10.0;3.7
49;2021-03-24;3603;497;85503;30461;10.5;3.7
49;2021-03-25;4225;651;89728;31112;11.0;3.8
49;2021-03-26;4886;502;94614;31614;11.6;3.9
49;2021-03-27;1675;99;96289;31713;11.8;3.9
49;2021-03-28;400;28;96689;31741;11.9;3.9
49;2021-03-29;2371;606;99060;32347;12.1;4.0
49;2021-03-30;3267;938;102327;33285;12.5;4.1
49;2021-03-31;2980;748;105307;34033;12.9;4.2
49;2021-04-01;4117;870;109424;34903;13.4;4.3
49;2021-04-02;4297;955;113721;35858;13.9;4.4
49;2021-04-03;971;193;114692;36051;14.1;4.4
49;2021-04-04;315;3;115007;36054;14.1;4.4
49;2021-04-05;944;22;115951;36076;14.2;4.4
49;2021-04-06;2330;1318;118281;37394;14.5;4.6
49;2021-04-07;3309;1365;121590;38759;14.9;4.8
49;2021-04-08;5185;1424;126775;40183;15.5;4.9
49;2021-04-09;6207;1439;132982;41622;16.3;5.1
49;2021-04-10;2065;500;135047;42122;16.6;5.2
49;2021-04-11;390;9;135437;42131;16.6;5.2
49;2021-04-12;4073;1575;139510;43706;17.1;5.4
49;2021-04-13;5380;1912;144890;45618;17.8;5.6
49;2021-04-14;4542;1877;149432;47495;18.3;5.8
49;2021-04-15;5381;1880;154813;49375;19.0;6.1
49;2021-04-16;5761;2137;160574;51512;19.7;6.3
49;2021-04-17;3335;852;163909;52364;20.1;6.4
49;2021-04-18;381;476;164290;52840;20.1;6.5
49;2021-04-19;3710;2058;168000;54898;20.6;6.7
49;2021-04-20;4371;2111;172371;57009;21.1;7.0
49;2021-04-21;3955;2203;176326;59212;21.6;7.3
49;2021-04-22;4837;2111;181163;61323;22.2;7.5
49;2021-04-23;4814;2335;185977;63658;22.8;7.8
49;2021-04-24;2938;1154;188915;64812;23.2;7.9
49;2021-04-25;40;282;188955;65094;23.2;8.0
49;2021-04-26;3744;2109;192699;67203;23.6;8.2
49;2021-04-27;4472;2496;197171;69699;24.2;8.5
49;2021-04-28;4615;2497;201786;72196;24.7;8.8
49;2021-04-29;5206;3014;206992;75210;25.4;9.2
49;2021-04-30;5558;3196;212550;78406;26.1;9.6
49;2021-05-01;2365;666;214915;79072;26.3;9.7
49;2021-05-02;5;40;214920;79112;26.3;9.7
49;2021-05-03;5012;2406;219932;81518;27.0;10.0
49;2021-05-04;4972;3037;224904;84555;27.6;10.4
49;2021-05-05;4789;3005;229693;87560;28.2;10.7
49;2021-05-06;5328;3094;235021;90654;28.8;11.1
49;2021-05-07;4281;5008;239302;95662;29.3;11.7
49;2021-05-08;3577;438;242879;96100;29.8;11.8
49;2021-05-09;10;41;242889;96141;29.8;11.8
49;2021-05-10;4829;4271;247718;100412;30.4;12.3
49;2021-05-11;5397;5083;253115;105495;31.0;12.9
49;2021-05-12;4800;4590;257915;110085;31.6;13.5
49;2021-05-13;4778;691;262693;110776;32.2;13.6
49;2021-05-14;5170;3269;267863;114045;32.8;14.0
49;2021-05-15;4157;1806;272020;115851;33.3;14.2
49;2021-05-16;2786;117;274806;115968;33.7;14.2
49;2021-05-17;4835;3683;279641;119651;34.3;14.7
49;2021-05-18;5473;3768;285114;123419;34.9;15.1
49;2021-05-19;5916;3229;291030;126648;35.7;15.5
49;2021-05-20;6807;2965;297837;129613;36.5;15.9
49;2021-05-21;6450;3744;304287;133357;37.3;16.3
49;2021-05-22;5183;1193;309470;134550;37.9;16.5
49;2021-05-23;1;12;309471;134562;37.9;16.5
49;2021-05-24;4212;448;313683;135010;38.4;16.5
49;2021-05-25;6326;3294;320009;138304;39.2;17.0
49;2021-05-26;6273;2664;326282;140968;40.0;17.3
49;2021-05-27;7114;2725;333396;143693;40.9;17.6
49;2021-05-28;6875;4006;340271;147699;41.7;18.1
49;2021-05-29;5023;1895;345294;149594;42.3;18.3
49;2021-05-30;21;14;345315;149608;42.3;18.3
49;2021-05-31;6036;3216;351351;152824;43.1;18.7
49;2021-06-01;6592;3979;357943;156803;43.9;19.2
49;2021-06-02;5794;3738;363737;160541;44.6;19.7
49;2021-06-03;6603;3415;370340;163956;45.4;20.1
49;2021-06-04;6470;4862;376810;168818;46.2;20.7
49;2021-06-05;4385;2695;381195;171513;46.7;21.0
49;2021-06-06;38;48;381233;171561;46.7;21.0
49;2021-06-07;4634;4759;385867;176320;47.3;21.6
49;2021-06-08;5185;5104;391052;181424;47.9;22.2
49;2021-06-09;5325;4504;396377;185928;48.6;22.8
49;2021-06-10;6005;3781;402382;189709;49.3;23.3
49;2021-06-11;4873;6030;407255;195739;49.9;24.0
49;2021-06-12;4097;3200;411352;198939;50.4;24.4
49;2021-06-13;20;989;411372;199928;50.4;24.5
49;2021-06-14;3410;6015;414782;205943;50.8;25.2
49;2021-06-15;4241;6392;419023;212335;51.4;26.0
49;2021-06-16;4150;5677;423173;218012;51.9;26.7
49;2021-06-17;5069;5076;428242;223088;52.5;27.3
49;2021-06-18;4134;6885;432376;229973;53.0;28.2
49;2021-06-19;3525;3971;435901;233944;53.4;28.7
49;2021-06-20;33;25;435934;233969;53.4;28.7
49;2021-06-21;2828;6509;438762;240478;53.8;29.5
49;2021-06-22;3208;7004;441970;247482;54.2;30.3
49;2021-06-23;3253;6311;445223;253793;54.6;31.1
49;2021-06-24;4316;4975;449539;258768;55.1;31.7
49;2021-06-25;3325;7446;452864;266214;55.5;32.6
49;2021-06-26;2570;4625;455434;270839;55.8;33.2
49;2021-06-27;15;1544;455449;272383;55.8;33.4
49;2021-06-28;2234;7181;457683;279564;56.1;34.3
49;2021-06-29;3028;7269;460711;286833;56.5;35.2
49;2021-06-30;2824;6803;463535;293636;56.8;36.0
49;2021-07-01;3393;6273;466928;299909;57.2;36.8
49;2021-07-02;3063;8066;469991;307975;57.6;37.7
49;2021-07-03;2007;5486;471998;313461;57.9;38.4
49;2021-07-04;7;53;472005;313514;57.9;38.4
49;2021-07-05;1738;7078;473743;320592;58.1;39.3
49;2021-07-06;1894;7549;475637;328141;58.3;40.2
49;2021-07-07;2100;6622;477737;334763;58.6;41.0
49;2021-07-08;2689;6357;480426;341120;58.9;41.8
49;2021-07-09;2361;8246;482787;349366;59.2;42.8
49;2021-07-10;1802;5344;484589;354710;59.4;43.5
49;2021-07-11;12;35;484601;354745;59.4;43.5
49;2021-07-12;1947;7713;486548;362458;59.6;44.4
49;2021-07-13;2572;8301;489120;370759;59.9;45.4
49;2021-07-14;2893;3373;492013;374132;60.3;45.9
49;2021-07-15;3165;7552;495178;381684;60.7;46.8
49;2021-07-16;3396;8293;498574;389977;61.1;47.8
49;2021-07-17;2103;5479;500677;395456;61.4;48.5
49;2021-07-18;3751;583;504428;396039;61.8;48.5
49;2021-07-19;2666;7450;507094;403489;62.2;49.5
49;2021-07-20;3588;7481;510682;410970;62.6;50.4
49;2021-07-21;4228;6463;514910;417433;63.1;51.2
49;2021-07-22;4815;5865;519725;423298;63.7;51.9
49;2021-07-23;5111;6624;524836;429922;64.3;52.7
49;2021-07-24;3690;5002;528526;434924;64.8;53.3
49;2021-07-25;67;33;528593;434957;64.8;53.3
49;2021-07-26;4517;5901;533110;440858;65.3;54.0
49;2021-07-27;5753;5443;538863;446301;66.0;54.7
49;2021-07-28;6019;4360;544882;450661;66.8;55.2
49;2021-07-29;6702;4155;551584;454816;67.6;55.7
49;2021-07-30;6173;4789;557757;459605;68.4;56.3
49;2021-07-31;3959;3421;561716;463026;68.8;56.8
49;2021-08-01;21;22;561737;463048;68.9;56.8
49;2021-08-02;4271;4658;566008;467706;69.4;57.3
49;2021-08-03;5434;3801;571442;471507;70.0;57.8
49;2021-08-04;5276;3719;576718;475226;70.7;58.2
49;2021-08-05;5307;3289;582025;478515;71.3;58.7
49;2021-08-06;5718;4283;587743;482798;72.0;59.2
49;2021-08-07;3925;3044;591668;485842;72.5;59.5
49;2021-08-08;24;36;591692;485878;72.5;59.6
49;2021-08-09;3501;4682;595193;490560;73.0;60.1
49;2021-08-10;4251;3900;599444;494460;73.5;60.6
49;2021-08-11;4007;3653;603451;498113;74.0;61.1
49;2021-08-12;2665;3055;606116;501168;74.3;61.4
49;2021-08-13;3926;4271;610042;505439;74.8;62.0
49;2021-08-14;2279;3149;612321;508588;75.1;62.3
49;2021-08-15;30;26;612351;508614;75.1;62.3
49;2021-08-16;2831;5061;615182;513675;75.4;63.0
49;2021-08-17;3275;4911;618457;518586;75.8;63.6
49;2021-08-18;2977;4114;621434;522700;76.2;64.1
49;2021-08-19;1549;3663;622983;526363;76.4;64.5
49;2021-08-20;2733;5772;625716;532135;76.7;65.2
49;2021-08-21;1399;4150;627115;536285;76.9;65.7
49;2021-08-22;6;41;627121;536326;76.9;65.7
49;2021-08-23;2257;5627;629378;541953;77.1;66.4
49;2021-08-24;2747;5787;632125;547740;77.5;67.1
49;2021-08-25;2330;5431;634455;553171;77.8;67.8
49;2021-08-26;1716;4827;636171;557998;78.0;68.4
49;2021-08-27;2456;6813;638627;564811;78.3;69.2
49;2021-08-28;906;4302;639533;569113;78.4;69.8
49;2021-08-29;5;94;639538;569207;78.4;69.8
49;2021-08-30;1154;4294;640692;573501;78.5;70.3
49;2021-08-31;2249;6003;642941;579504;78.8;71.0
49;2021-09-01;1684;4454;644625;583958;79.0;71.6
49;2021-09-02;1063;2807;645688;586765;79.1;71.9
49;2021-09-03;1460;4186;647148;590951;79.3;72.4
49;2021-09-04;1210;3574;648358;594525;79.5;72.9
49;2021-09-05;5;9;648363;594534;79.5;72.9
49;2021-09-06;1098;2945;649461;597479;79.6;73.2
49;2021-09-07;1190;2881;650651;600360;79.7;73.6
49;2021-09-08;986;3323;651637;603683;79.9;74.0
49;2021-09-09;771;1777;652408;605460;80.0;74.2
49;2021-09-10;972;3069;653380;608529;80.1;74.6
49;2021-09-11;726;2643;654106;611172;80.2;74.9
49;2021-09-12;12;8;654118;611180;80.2;74.9
49;2021-09-13;745;2542;654863;613722;80.3;75.2
49;2021-09-14;644;2302;655507;616024;80.3;75.5
49;2021-09-15;621;2227;656128;618251;80.4;75.8
49;2021-09-16;522;1288;656650;619539;80.5;75.9
49;2021-09-17;929;2517;657579;622056;80.6;76.2
49;2021-09-18;541;2005;658120;624061;80.7;76.5
49;2021-09-19;2;8;658122;624069;80.7;76.5
49;2021-09-20;512;1245;658634;625314;80.7;76.6
49;2021-09-21;432;1598;659066;626912;80.8;76.8
49;2021-09-22;336;1996;659402;628908;80.8;77.1
49;2021-09-23;328;1168;659730;630076;80.9;77.2
49;2021-09-24;566;2242;660296;632318;80.9;77.5
49;2021-09-25;197;1014;660493;633332;81.0;77.6
49;2021-09-26;0;0;660493;633332;81.0;77.6
49;2021-09-27;384;1374;660877;634706;81.0;77.8
49;2021-09-28;413;1062;661290;635768;81.1;77.9
49;2021-09-29;377;1241;661667;637009;81.1;78.1
49;2021-09-30;318;707;661985;637716;81.1;78.2
49;2021-10-01;546;1504;662531;639220;81.2;78.3
49;2021-10-02;354;1133;662885;640353;81.2;78.5
49;2021-10-03;4;13;662889;640366;81.2;78.5
49;2021-10-04;311;759;663200;641125;81.3;78.6
49;2021-10-05;188;553;663388;641678;81.3;78.6
49;2021-10-06;395;746;663783;642424;81.4;78.7
50;2020-12-27;0;0;0;0;0.0;0.0
50;2020-12-28;0;0;0;0;0.0;0.0
50;2020-12-29;1;0;1;0;0.0;0.0
50;2020-12-30;0;0;1;0;0.0;0.0
50;2020-12-31;0;0;1;0;0.0;0.0
50;2021-01-01;0;0;1;0;0.0;0.0
50;2021-01-02;0;0;1;0;0.0;0.0
50;2021-01-03;0;0;1;0;0.0;0.0
50;2021-01-04;1;0;2;0;0.0;0.0
50;2021-01-05;0;0;2;0;0.0;0.0
50;2021-01-06;126;0;128;0;0.0;0.0
50;2021-01-07;324;0;452;0;0.1;0.0
50;2021-01-08;436;2;888;2;0.2;0.0
50;2021-01-09;236;0;1124;2;0.2;0.0
50;2021-01-10;23;0;1147;2;0.2;0.0
50;2021-01-11;391;1;1538;3;0.3;0.0
50;2021-01-12;599;0;2137;3;0.4;0.0
50;2021-01-13;695;5;2832;8;0.6;0.0
50;2021-01-14;1051;11;3883;19;0.8;0.0
50;2021-01-15;710;3;4593;22;0.9;0.0
50;2021-01-16;215;3;4808;25;1.0;0.0
50;2021-01-17;1;0;4809;25;1.0;0.0
50;2021-01-18;620;1;5429;26;1.1;0.0
50;2021-01-19;902;3;6331;29;1.3;0.0
50;2021-01-20;964;0;7295;29;1.5;0.0
50;2021-01-21;917;4;8212;33;1.7;0.0
50;2021-01-22;716;2;8928;35;1.8;0.0
50;2021-01-23;668;4;9596;39;2.0;0.0
50;2021-01-24;882;2;10478;41;2.1;0.0
50;2021-01-25;2708;8;13186;49;2.7;0.0
50;2021-01-26;1336;14;14522;63;3.0;0.0
50;2021-01-27;769;56;15291;119;3.1;0.0
50;2021-01-28;716;161;16007;280;3.3;0.1
50;2021-01-29;581;290;16588;570;3.4;0.1
50;2021-01-30;381;137;16969;707;3.5;0.1
50;2021-01-31;0;0;16969;707;3.5;0.1
50;2021-02-01;451;209;17420;916;3.6;0.2
50;2021-02-02;417;224;17837;1140;3.6;0.2
50;2021-02-03;391;366;18228;1506;3.7;0.3
50;2021-02-04;486;421;18714;1927;3.8;0.4
50;2021-02-05;426;425;19140;2352;3.9;0.5
50;2021-02-06;179;104;19319;2456;3.9;0.5
50;2021-02-07;0;0;19319;2456;3.9;0.5
50;2021-02-08;254;432;19573;2888;4.0;0.6
50;2021-02-09;246;548;19819;3436;4.0;0.7
50;2021-02-10;571;469;20390;3905;4.2;0.8
50;2021-02-11;436;830;20826;4735;4.2;1.0
50;2021-02-12;329;576;21155;5311;4.3;1.1
50;2021-02-13;306;413;21461;5724;4.4;1.2
50;2021-02-14;185;732;21646;6456;4.4;1.3
50;2021-02-15;664;1772;22310;8228;4.5;1.7
50;2021-02-16;746;1452;23056;9680;4.7;2.0
50;2021-02-17;632;673;23688;10353;4.8;2.1
50;2021-02-18;569;686;24257;11039;4.9;2.2
50;2021-02-19;631;393;24888;11432;5.1;2.3
50;2021-02-20;423;128;25311;11560;5.2;2.4
50;2021-02-21;85;21;25396;11581;5.2;2.4
50;2021-02-22;291;569;25687;12150;5.2;2.5
50;2021-02-23;503;431;26190;12581;5.3;2.6
50;2021-02-24;624;489;26814;13070;5.5;2.7
50;2021-02-25;780;478;27594;13548;5.6;2.8
50;2021-02-26;998;318;28592;13866;5.8;2.8
50;2021-02-27;887;97;29479;13963;6.0;2.8
50;2021-02-28;111;0;29590;13963;6.0;2.8
50;2021-03-01;488;447;30078;14410;6.1;2.9
50;2021-03-02;651;431;30729;14841;6.3;3.0
50;2021-03-03;798;381;31527;15222;6.4;3.1
50;2021-03-04;1247;289;32774;15511;6.7;3.2
50;2021-03-05;1553;296;34327;15807;7.0;3.2
50;2021-03-06;1321;137;35648;15944;7.3;3.2
50;2021-03-07;550;39;36198;15983;7.4;3.3
50;2021-03-08;1025;572;37223;16555;7.6;3.4
50;2021-03-09;1555;544;38778;17099;7.9;3.5
50;2021-03-10;1607;293;40385;17392;8.2;3.5
50;2021-03-11;2352;338;42737;17730;8.7;3.6
50;2021-03-12;2865;239;45602;17969;9.3;3.7
50;2021-03-13;1995;125;47597;18094;9.7;3.7
50;2021-03-14;280;41;47877;18135;9.8;3.7
50;2021-03-15;1378;291;49255;18426;10.0;3.8
50;2021-03-16;1341;275;50596;18701;10.3;3.8
50;2021-03-17;1296;404;51892;19105;10.6;3.9
50;2021-03-18;1162;427;53054;19532;10.8;4.0
50;2021-03-19;1733;576;54787;20108;11.2;4.1
50;2021-03-20;1688;230;56475;20338;11.5;4.1
50;2021-03-21;794;12;57269;20350;11.7;4.1
50;2021-03-22;1508;334;58777;20684;12.0;4.2
50;2021-03-23;2078;399;60855;21083;12.4;4.3
50;2021-03-24;2281;551;63136;21634;12.9;4.4
50;2021-03-25;2813;472;65949;22106;13.4;4.5
50;2021-03-26;3205;470;69154;22576;14.1;4.6
50;2021-03-27;1823;373;70977;22949;14.5;4.7
50;2021-03-28;403;20;71380;22969;14.5;4.7
50;2021-03-29;2139;717;73519;23686;15.0;4.8
50;2021-03-30;2283;641;75802;24327;15.4;5.0
50;2021-03-31;2479;570;78281;24897;16.0;5.1
50;2021-04-01;3104;867;81385;25764;16.6;5.3
50;2021-04-02;2960;928;84345;26692;17.2;5.4
50;2021-04-03;1245;674;85590;27366;17.4;5.6
50;2021-04-04;321;134;85911;27500;17.5;5.6
50;2021-04-05;400;27;86311;27527;17.6;5.6
50;2021-04-06;2127;1222;88438;28749;18.0;5.9
50;2021-04-07;2557;1175;90995;29924;18.5;6.1
50;2021-04-08;3597;1207;94592;31131;19.3;6.3
50;2021-04-09;3936;1300;98528;32431;20.1;6.6
50;2021-04-10;2534;873;101062;33304;20.6;6.8
50;2021-04-11;411;145;101473;33449;20.7;6.8
50;2021-04-12;2438;1377;103911;34826;21.2;7.1
50;2021-04-13;2678;1511;106589;36337;21.7;7.4
50;2021-04-14;2608;1355;109197;37692;22.3;7.7
50;2021-04-15;3161;1115;112358;38807;22.9;7.9
50;2021-04-16;3363;1103;115721;39910;23.6;8.1
50;2021-04-17;2397;1185;118118;41095;24.1;8.4
50;2021-04-18;425;665;118543;41760;24.2;8.5
50;2021-04-19;1996;1469;120539;43229;24.6;8.8
50;2021-04-20;2273;1589;122812;44818;25.0;9.1
50;2021-04-21;2548;1759;125360;46577;25.5;9.5
50;2021-04-22;3078;1825;128438;48402;26.2;9.9
50;2021-04-23;2757;1917;131195;50319;26.7;10.3
50;2021-04-24;1900;1429;133095;51748;27.1;10.5
50;2021-04-25;470;272;133565;52020;27.2;10.6
50;2021-04-26;2119;1878;135684;53898;27.7;11.0
50;2021-04-27;2412;1996;138096;55894;28.1;11.4
50;2021-04-28;2708;1972;140804;57866;28.7;11.8
50;2021-04-29;3285;2041;144089;59907;29.4;12.2
50;2021-04-30;2999;1923;147088;61830;30.0;12.6
50;2021-05-01;1015;596;148103;62426;30.2;12.7
50;2021-05-02;523;448;148626;62874;30.3;12.8
50;2021-05-03;1771;1805;150397;64679;30.7;13.2
50;2021-05-04;1771;2329;152168;67008;31.0;13.7
50;2021-05-05;1659;2951;153827;69959;31.4;14.3
50;2021-05-06;2530;2579;156357;72538;31.9;14.8
50;2021-05-07;2150;2850;158507;75388;32.3;15.4
50;2021-05-08;1170;792;159677;76180;32.5;15.5
50;2021-05-09;624;361;160301;76541;32.7;15.6
50;2021-05-10;1705;2602;162006;79143;33.0;16.1
50;2021-05-11;2542;2836;164548;81979;33.5;16.7
50;2021-05-12;3179;2438;167727;84417;34.2;17.2
50;2021-05-13;3382;613;171109;85030;34.9;17.3
50;2021-05-14;3568;2274;174677;87304;35.6;17.8
50;2021-05-15;4001;1870;178678;89174;36.4;18.2
50;2021-05-16;947;267;179625;89441;36.6;18.2
50;2021-05-17;2140;1878;181765;91319;37.0;18.6
50;2021-05-18;2523;1614;184288;92933;37.6;18.9
50;2021-05-19;2503;1447;186791;94380;38.1;19.2
50;2021-05-20;3261;1624;190052;96004;38.7;19.6
50;2021-05-21;3156;1908;193208;97912;39.4;20.0
50;2021-05-22;2651;1323;195859;99235;39.9;20.2
50;2021-05-23;603;284;196462;99519;40.0;20.3
50;2021-05-24;1527;490;197989;100009;40.4;20.4
50;2021-05-25;2450;1668;200439;101677;40.9;20.7
50;2021-05-26;3002;1458;203441;103135;41.5;21.0
50;2021-05-27;3036;1969;206477;105104;42.1;21.4
50;2021-05-28;2941;2111;209418;107215;42.7;21.9
50;2021-05-29;2760;1402;212178;108617;43.2;22.1
50;2021-05-30;812;327;212990;108944;43.4;22.2
50;2021-05-31;2652;1815;215642;110759;43.9;22.6
50;2021-06-01;3333;2066;218975;112825;44.6;23.0
50;2021-06-02;3259;1782;222234;114607;45.3;23.4
50;2021-06-03;3914;2059;226148;116666;46.1;23.8
50;2021-06-04;3822;2874;229970;119540;46.9;24.4
50;2021-06-05;2958;1838;232928;121378;47.5;24.7
50;2021-06-06;813;442;233741;121820;47.6;24.8
50;2021-06-07;3512;2078;237253;123898;48.4;25.3
50;2021-06-08;4073;2228;241326;126126;49.2;25.7
50;2021-06-09;4253;1987;245579;128113;50.0;26.1
50;2021-06-10;4193;2113;249772;130226;50.9;26.5
50;2021-06-11;4224;2712;253996;132938;51.8;27.1
50;2021-06-12;3738;1613;257734;134551;52.5;27.4
50;2021-06-13;1143;451;258877;135002;52.8;27.5
50;2021-06-14;2693;2967;261570;137969;53.3;28.1
50;2021-06-15;3016;2599;264586;140568;53.9;28.6
50;2021-06-16;3096;1970;267682;142538;54.6;29.0
50;2021-06-17;2798;2484;270480;145022;55.1;29.6
50;2021-06-18;3239;3051;273719;148073;55.8;30.2
50;2021-06-19;3176;1925;276895;149998;56.4;30.6
50;2021-06-20;731;710;277626;150708;56.6;30.7
50;2021-06-21;1819;3129;279445;153837;57.0;31.4
50;2021-06-22;2064;3389;281509;157226;57.4;32.0
50;2021-06-23;1872;3875;283381;161101;57.8;32.8
50;2021-06-24;1711;4007;285092;165108;58.1;33.6
50;2021-06-25;2134;4009;287226;169117;58.5;34.5
50;2021-06-26;2147;3692;289373;172809;59.0;35.2
50;2021-06-27;615;895;289988;173704;59.1;35.4
50;2021-06-28;1927;3349;291915;177053;59.5;36.1
50;2021-06-29;1881;3406;293796;180459;59.9;36.8
50;2021-06-30;2179;3408;295975;183867;60.3;37.5
50;2021-07-01;1944;3283;297919;187150;60.7;38.1
50;2021-07-02;1898;3934;299817;191084;61.1;38.9
50;2021-07-03;1448;3445;301265;194529;61.4;39.6
50;2021-07-04;445;1066;301710;195595;61.5;39.9
50;2021-07-05;1262;3412;302972;199007;61.7;40.6
50;2021-07-06;1573;3896;304545;202903;62.1;41.4
50;2021-07-07;1804;3617;306349;206520;62.4;42.1
50;2021-07-08;1374;4101;307723;210621;62.7;42.9
50;2021-07-09;1394;4570;309117;215191;63.0;43.9
50;2021-07-10;1023;3599;310140;218790;63.2;44.6
50;2021-07-11;373;1018;310513;219808;63.3;44.8
50;2021-07-12;1317;4623;311830;224431;63.6;45.7
50;2021-07-13;1624;4856;313454;229287;63.9;46.7
50;2021-07-14;1476;2358;314930;231645;64.2;47.2
50;2021-07-15;1687;5048;316617;236693;64.5;48.2
50;2021-07-16;2992;5241;319609;241934;65.1;49.3
50;2021-07-17;2149;3733;321758;245667;65.6;50.1
50;2021-07-18;402;1089;322160;246756;65.7;50.3
50;2021-07-19;1571;5185;323731;251941;66.0;51.3
50;2021-07-20;1924;5405;325655;257346;66.4;52.4
50;2021-07-21;1802;5256;327457;262602;66.7;53.5
50;2021-07-22;1947;5002;329404;267604;67.1;54.5
50;2021-07-23;2072;5373;331476;272977;67.6;55.6
50;2021-07-24;1311;3836;332787;276813;67.8;56.4
50;2021-07-25;274;1037;333061;277850;67.9;56.6
50;2021-07-26;2290;3487;335351;281337;68.3;57.3
50;2021-07-27;2899;3346;338250;284683;68.9;58.0
50;2021-07-28;2998;3687;341248;288370;69.5;58.8
50;2021-07-29;3581;3220;344829;291590;70.3;59.4
50;2021-07-30;3075;3005;347904;294595;70.9;60.0
50;2021-07-31;2406;2672;350310;297267;71.4;60.6
50;2021-08-01;484;686;350794;297953;71.5;60.7
50;2021-08-02;2475;2739;353269;300692;72.0;61.3
50;2021-08-03;3404;2470;356673;303162;72.7;61.8
50;2021-08-04;3602;2322;360275;305484;73.4;62.3
50;2021-08-05;3189;2159;363464;307643;74.1;62.7
50;2021-08-06;3658;2800;367122;310443;74.8;63.3
50;2021-08-07;2462;2156;369584;312599;75.3;63.7
50;2021-08-08;511;712;370095;313311;75.4;63.9
50;2021-08-09;2494;2135;372589;315446;75.9;64.3
50;2021-08-10;2987;1989;375576;317435;76.5;64.7
50;2021-08-11;2852;2018;378428;319453;77.1;65.1
50;2021-08-12;2596;2438;381024;321891;77.7;65.6
50;2021-08-13;2506;1979;383530;323870;78.2;66.0
50;2021-08-14;1810;1748;385340;325618;78.5;66.4
50;2021-08-15;399;334;385739;325952;78.6;66.4
50;2021-08-16;1720;2228;387459;328180;79.0;66.9
50;2021-08-17;1973;2704;389432;330884;79.4;67.4
50;2021-08-18;1844;2389;391276;333273;79.7;67.9
50;2021-08-19;1710;2578;392986;335851;80.1;68.4
50;2021-08-20;1621;2739;394607;338590;80.4;69.0
50;2021-08-21;1016;2727;395623;341317;80.6;69.6
50;2021-08-22;384;519;396007;341836;80.7;69.7
50;2021-08-23;1138;2906;397145;344742;80.9;70.3
50;2021-08-24;1246;3222;398391;347964;81.2;70.9
50;2021-08-25;1091;2649;399482;350613;81.4;71.5
50;2021-08-26;866;3156;400348;353769;81.6;72.1
50;2021-08-27;936;3181;401284;356950;81.8;72.7
50;2021-08-28;793;2887;402077;359837;81.9;73.3
50;2021-08-29;283;575;402360;360412;82.0;73.5
50;2021-08-30;773;2948;403133;363360;82.2;74.1
50;2021-08-31;821;3034;403954;366394;82.3;74.7
50;2021-09-01;686;2889;404640;369283;82.5;75.3
50;2021-09-02;528;2541;405168;371824;82.6;75.8
50;2021-09-03;695;2878;405863;374702;82.7;76.4
50;2021-09-04;621;2992;406484;377694;82.8;77.0
50;2021-09-05;194;741;406678;378435;82.9;77.1
50;2021-09-06;433;2192;407111;380627;83.0;77.6
50;2021-09-07;329;1753;407440;382380;83.0;77.9
50;2021-09-08;500;2131;407940;384511;83.1;78.4
50;2021-09-09;385;1493;408325;386004;83.2;78.7
50;2021-09-10;496;2019;408821;388023;83.3;79.1
50;2021-09-11;365;2427;409186;390450;83.4;79.6
50;2021-09-12;71;387;409257;390837;83.4;79.7
50;2021-09-13;412;1386;409669;392223;83.5;79.9
50;2021-09-14;413;1382;410082;393605;83.6;80.2
50;2021-09-15;417;1087;410499;394692;83.7;80.4
50;2021-09-16;461;747;410960;395439;83.8;80.6
50;2021-09-17;457;1031;411417;396470;83.8;80.8
50;2021-09-18;313;1467;411730;397937;83.9;81.1
50;2021-09-19;46;276;411776;398213;83.9;81.2
50;2021-09-20;382;589;412158;398802;84.0;81.3
50;2021-09-21;431;625;412589;399427;84.1;81.4
50;2021-09-22;216;867;412805;400294;84.1;81.6
50;2021-09-23;267;450;413072;400744;84.2;81.7
50;2021-09-24;253;819;413325;401563;84.2;81.8
50;2021-09-25;213;934;413538;402497;84.3;82.0
50;2021-09-26;20;181;413558;402678;84.3;82.1
50;2021-09-27;106;388;413664;403066;84.3;82.1
50;2021-09-28;159;385;413823;403451;84.3;82.2
50;2021-09-29;156;524;413979;403975;84.4;82.3
50;2021-09-30;163;422;414142;404397;84.4;82.4
50;2021-10-01;205;592;414347;404989;84.4;82.5
50;2021-10-02;224;540;414571;405529;84.5;82.6
50;2021-10-03;2;5;414573;405534;84.5;82.6
50;2021-10-04;178;482;414751;406016;84.5;82.7
50;2021-10-05;134;398;414885;406414;84.6;82.8
50;2021-10-06;187;489;415072;406903;84.6;82.9
51;2020-12-27;0;0;0;0;0.0;0.0
51;2020-12-28;0;0;0;0;0.0;0.0
51;2020-12-29;0;0;0;0;0.0;0.0
51;2020-12-30;0;0;0;0;0.0;0.0
51;2020-12-31;1;0;1;0;0.0;0.0
51;2021-01-01;0;0;1;0;0.0;0.0
51;2021-01-02;0;0;1;0;0.0;0.0
51;2021-01-03;0;0;1;0;0.0;0.0
51;2021-01-04;1;0;2;0;0.0;0.0
51;2021-01-05;1;0;3;0;0.0;0.0
51;2021-01-06;6;0;9;0;0.0;0.0
51;2021-01-07;262;1;271;1;0.0;0.0
51;2021-01-08;508;1;779;2;0.1;0.0
51;2021-01-09;91;0;870;2;0.2;0.0
51;2021-01-10;0;0;870;2;0.2;0.0
51;2021-01-11;545;2;1415;4;0.3;0.0
51;2021-01-12;1542;4;2957;8;0.5;0.0
51;2021-01-13;1289;5;4246;13;0.8;0.0
51;2021-01-14;1475;6;5721;19;1.0;0.0
51;2021-01-15;607;3;6328;22;1.1;0.0
51;2021-01-16;177;1;6505;23;1.2;0.0
51;2021-01-17;102;0;6607;23;1.2;0.0
51;2021-01-18;845;3;7452;26;1.3;0.0
51;2021-01-19;997;2;8449;28;1.5;0.0
51;2021-01-20;955;7;9404;35;1.7;0.0
51;2021-01-21;790;2;10194;37;1.8;0.0
51;2021-01-22;394;2;10588;39;1.9;0.0
51;2021-01-23;294;0;10882;39;1.9;0.0
51;2021-01-24;130;1;11012;40;2.0;0.0
51;2021-01-25;712;3;11724;43;2.1;0.0
51;2021-01-26;779;5;12503;48;2.2;0.0
51;2021-01-27;656;2;13159;50;2.3;0.0
51;2021-01-28;646;54;13805;104;2.4;0.0
51;2021-01-29;474;141;14279;245;2.5;0.0
51;2021-01-30;126;5;14405;250;2.6;0.0
51;2021-01-31;83;0;14488;250;2.6;0.0
51;2021-02-01;275;58;14763;308;2.6;0.1
51;2021-02-02;738;622;15501;930;2.7;0.2
51;2021-02-03;642;454;16143;1384;2.9;0.2
51;2021-02-04;968;733;17111;2117;3.0;0.4
51;2021-02-05;973;473;18084;2590;3.2;0.5
51;2021-02-06;30;136;18114;2726;3.2;0.5
51;2021-02-07;0;18;18114;2744;3.2;0.5
51;2021-02-08;115;392;18229;3136;3.2;0.6
51;2021-02-09;222;454;18451;3590;3.3;0.6
51;2021-02-10;220;599;18671;4189;3.3;0.7
51;2021-02-11;302;491;18973;4680;3.4;0.8
51;2021-02-12;341;489;19314;5169;3.4;0.9
51;2021-02-13;8;94;19322;5263;3.4;0.9
51;2021-02-14;8;119;19330;5382;3.4;1.0
51;2021-02-15;266;592;19596;5974;3.5;1.1
51;2021-02-16;402;762;19998;6736;3.5;1.2
51;2021-02-17;367;694;20365;7430;3.6;1.3
51;2021-02-18;437;469;20802;7899;3.7;1.4
51;2021-02-19;529;380;21331;8279;3.8;1.5
51;2021-02-20;205;264;21536;8543;3.8;1.5
51;2021-02-21;10;93;21546;8636;3.8;1.5
51;2021-02-22;195;544;21741;9180;3.9;1.6
51;2021-02-23;262;915;22003;10095;3.9;1.8
51;2021-02-24;414;554;22417;10649;4.0;1.9
51;2021-02-25;1049;779;23466;11428;4.2;2.0
51;2021-02-26;1228;601;24694;12029;4.4;2.1
51;2021-02-27;590;96;25284;12125;4.5;2.2
51;2021-02-28;7;52;25291;12177;4.5;2.2
51;2021-03-01;768;280;26059;12457;4.6;2.2
51;2021-03-02;1128;415;27187;12872;4.8;2.3
51;2021-03-03;1194;388;28381;13260;5.0;2.4
51;2021-03-04;1061;631;29442;13891;5.2;2.5
51;2021-03-05;1560;567;31002;14458;5.5;2.6
51;2021-03-06;1434;56;32436;14514;5.8;2.6
51;2021-03-07;251;5;32687;14519;5.8;2.6
51;2021-03-08;992;98;33679;14617;6.0;2.6
51;2021-03-09;1666;180;35345;14797;6.3;2.6
51;2021-03-10;1999;104;37344;14901;6.6;2.6
51;2021-03-11;2371;168;39715;15069;7.0;2.7
51;2021-03-12;3255;148;42970;15217;7.6;2.7
51;2021-03-13;2550;49;45520;15266;8.1;2.7
51;2021-03-14;190;5;45710;15271;8.1;2.7
51;2021-03-15;1580;150;47290;15421;8.4;2.7
51;2021-03-16;1478;182;48768;15603;8.6;2.8
51;2021-03-17;1497;206;50265;15809;8.9;2.8
51;2021-03-18;1615;287;51880;16096;9.2;2.9
51;2021-03-19;2311;296;54191;16392;9.6;2.9
51;2021-03-20;1661;216;55852;16608;9.9;2.9
51;2021-03-21;133;4;55985;16612;9.9;2.9
51;2021-03-22;1416;125;57401;16737;10.2;3.0
51;2021-03-23;2469;160;59870;16897;10.6;3.0
51;2021-03-24;2846;131;62716;17028;11.1;3.0
51;2021-03-25;3254;331;65970;17359;11.7;3.1
51;2021-03-26;3411;501;69381;17860;12.3;3.2
51;2021-03-27;1842;249;71223;18109;12.6;3.2
51;2021-03-28;213;3;71436;18112;12.7;3.2
51;2021-03-29;991;629;72427;18741;12.8;3.3
51;2021-03-30;1748;851;74175;19592;13.2;3.5
51;2021-03-31;1738;748;75913;20340;13.5;3.6
51;2021-04-01;2282;449;78195;20789;13.9;3.7
51;2021-04-02;2425;641;80620;21430;14.3;3.8
51;2021-04-03;1301;411;81921;21841;14.5;3.9
51;2021-04-04;106;2;82027;21843;14.5;3.9
51;2021-04-05;72;138;82099;21981;14.6;3.9
51;2021-04-06;763;1230;82862;23211;14.7;4.1
51;2021-04-07;1312;1408;84174;24619;14.9;4.4
51;2021-04-08;2207;1775;86381;26394;15.3;4.7
51;2021-04-09;2862;1724;89243;28118;15.8;5.0
51;2021-04-10;2219;496;91462;28614;16.2;5.1
51;2021-04-11;105;85;91567;28699;16.2;5.1
51;2021-04-12;1450;1338;93017;30037;16.5;5.3
51;2021-04-13;1936;1670;94953;31707;16.8;5.6
51;2021-04-14;2460;1549;97413;33256;17.3;5.9
51;2021-04-15;2856;1672;100269;34928;17.8;6.2
51;2021-04-16;3214;1600;103483;36528;18.4;6.5
51;2021-04-17;1966;775;105449;37303;18.7;6.6
51;2021-04-18;296;114;105745;37417;18.8;6.6
51;2021-04-19;1561;1157;107306;38574;19.0;6.8
51;2021-04-20;1791;1661;109097;40235;19.3;7.1
51;2021-04-21;2002;1741;111099;41976;19.7;7.4
51;2021-04-22;2407;1661;113506;43637;20.1;7.7
51;2021-04-23;2982;1824;116488;45461;20.7;8.1
51;2021-04-24;1749;952;118237;46413;21.0;8.2
51;2021-04-25;123;160;118360;46573;21.0;8.3
51;2021-04-26;1851;761;120211;47334;21.3;8.4
51;2021-04-27;2442;1214;122653;48548;21.8;8.6
51;2021-04-28;2552;1291;125205;49839;22.2;8.8
51;2021-04-29;2676;1460;127881;51299;22.7;9.1
51;2021-04-30;2975;1660;130856;52959;23.2;9.4
51;2021-05-01;1453;411;132309;53370;23.5;9.5
51;2021-05-02;107;99;132416;53469;23.5;9.5
51;2021-05-03;2484;754;134900;54223;23.9;9.6
51;2021-05-04;2788;1351;137688;55574;24.4;9.9
51;2021-05-05;2860;1639;140548;57213;24.9;10.1
51;2021-05-06;5344;1951;145892;59164;25.9;10.5
51;2021-05-07;3705;1902;149597;61066;26.5;10.8
51;2021-05-08;2862;815;152459;61881;27.0;11.0
51;2021-05-09;212;92;152671;61973;27.1;11.0
51;2021-05-10;3214;1860;155885;63833;27.6;11.3
51;2021-05-11;3643;2032;159528;65865;28.3;11.7
51;2021-05-12;4182;2233;163710;68098;29.0;12.1
51;2021-05-13;1777;505;165487;68603;29.4;12.2
51;2021-05-14;5401;1740;170888;70343;30.3;12.5
51;2021-05-15;4227;1351;175115;71694;31.1;12.7
51;2021-05-16;284;46;175399;71740;31.1;12.7
51;2021-05-17;3131;1520;178530;73260;31.7;13.0
51;2021-05-18;3918;1760;182448;75020;32.4;13.3
51;2021-05-19;4031;1722;186479;76742;33.1;13.6
51;2021-05-20;4649;1966;191128;78708;33.9;14.0
51;2021-05-21;3597;2463;194725;81171;34.5;14.4
51;2021-05-22;2075;1548;196800;82719;34.9;14.7
51;2021-05-23;308;210;197108;82929;35.0;14.7
51;2021-05-24;2018;720;199126;83649;35.3;14.8
51;2021-05-25;3130;1828;202256;85477;35.9;15.2
51;2021-05-26;3296;1711;205552;87188;36.5;15.5
51;2021-05-27;3267;2056;208819;89244;37.0;15.8
51;2021-05-28;3606;2796;212425;92040;37.7;16.3
51;2021-05-29;2401;1990;214826;94030;38.1;16.7
51;2021-05-30;401;133;215227;94163;38.2;16.7
51;2021-05-31;3348;1767;218575;95930;38.8;17.0
51;2021-06-01;3854;2322;222429;98252;39.5;17.4
51;2021-06-02;6096;2329;228525;100581;40.5;17.8
51;2021-06-03;3580;2424;232105;103005;41.2;18.3
51;2021-06-04;6346;2935;238451;105940;42.3;18.8
51;2021-06-05;2596;1814;241047;107754;42.8;19.1
51;2021-06-06;172;157;241219;107911;42.8;19.1
51;2021-06-07;4302;2164;245521;110075;43.5;19.5
51;2021-06-08;3925;2529;249446;112604;44.2;20.0
51;2021-06-09;4016;2748;253462;115352;45.0;20.5
51;2021-06-10;3207;2485;256669;117837;45.5;20.9
51;2021-06-11;3358;3426;260027;121263;46.1;21.5
51;2021-06-12;2165;2170;262192;123433;46.5;21.9
51;2021-06-13;191;149;262383;123582;46.5;21.9
51;2021-06-14;1627;3327;264010;126909;46.8;22.5
51;2021-06-15;3189;3577;267199;130486;47.4;23.1
51;2021-06-16;2208;3683;269407;134169;47.8;23.8
51;2021-06-17;2609;5399;272016;139568;48.2;24.8
51;2021-06-18;2355;5211;274371;144779;48.7;25.7
51;2021-06-19;1683;4425;276054;149204;49.0;26.5
51;2021-06-20;184;228;276238;149432;49.0;26.5
51;2021-06-21;1231;4436;277469;153868;49.2;27.3
51;2021-06-22;1558;4043;279027;157911;49.5;28.0
51;2021-06-23;3670;4236;282697;162147;50.1;28.8
51;2021-06-24;2246;3224;284943;165371;50.5;29.3
51;2021-06-25;1905;6526;286848;171897;50.9;30.5
51;2021-06-26;1203;5063;288051;176960;51.1;31.4
51;2021-06-27;103;336;288154;177296;51.1;31.4
51;2021-06-28;1401;4413;289555;181709;51.4;32.2
51;2021-06-29;1174;4463;290729;186172;51.6;33.0
51;2021-06-30;1687;6044;292416;192216;51.9;34.1
51;2021-07-01;1978;3765;294394;195981;52.2;34.8
51;2021-07-02;1838;6885;296232;202866;52.5;36.0
51;2021-07-03;1003;3197;297235;206063;52.7;36.5
51;2021-07-04;171;254;297406;206317;52.7;36.6
51;2021-07-05;770;5529;298176;211846;52.9;37.6
51;2021-07-06;1247;4778;299423;216624;53.1;38.4
51;2021-07-07;1617;4934;301040;221558;53.4;39.3
51;2021-07-08;2067;3430;303107;224988;53.8;39.9
51;2021-07-09;1854;5056;304961;230044;54.1;40.8
51;2021-07-10;1238;3205;306199;233249;54.3;41.4
51;2021-07-11;190;281;306389;233530;54.3;41.4
51;2021-07-12;996;4379;307385;237909;54.5;42.2
51;2021-07-13;1480;4770;308865;242679;54.8;43.0
51;2021-07-14;1071;1691;309936;244370;55.0;43.3
51;2021-07-15;2938;4911;312874;249281;55.5;44.2
51;2021-07-16;2365;5273;315239;254554;55.9;45.1
51;2021-07-17;1821;3477;317060;258031;56.2;45.8
51;2021-07-18;163;330;317223;258361;56.3;45.8
51;2021-07-19;1892;3973;319115;262334;56.6;46.5
51;2021-07-20;2585;5143;321700;267477;57.1;47.4
51;2021-07-21;3611;4067;325311;271544;57.7;48.2
51;2021-07-22;4412;3758;329723;275302;58.5;48.8
51;2021-07-23;3640;4377;333363;279679;59.1;49.6
51;2021-07-24;2086;2724;335449;282403;59.5;50.1
51;2021-07-25;356;258;335805;282661;59.6;50.1
51;2021-07-26;3113;2808;338918;285469;60.1;50.6
51;2021-07-27;5863;3275;344781;288744;61.2;51.2
51;2021-07-28;4138;4320;348919;293064;61.9;52.0
51;2021-07-29;4701;2717;353620;295781;62.7;52.5
51;2021-07-30;3628;3155;357248;298936;63.4;53.0
51;2021-07-31;2526;2131;359774;301067;63.8;53.4
51;2021-08-01;375;236;360149;301303;63.9;53.4
51;2021-08-02;3287;2310;363436;303613;64.5;53.8
51;2021-08-03;3775;1912;367211;305525;65.1;54.2
51;2021-08-04;4450;2124;371661;307649;65.9;54.6
51;2021-08-05;2655;1534;374316;309183;66.4;54.8
51;2021-08-06;3044;2550;377360;311733;66.9;55.3
51;2021-08-07;2161;1698;379521;313431;67.3;55.6
51;2021-08-08;368;208;379889;313639;67.4;55.6
51;2021-08-09;2604;1851;382493;315490;67.8;56.0
51;2021-08-10;2372;1983;384865;317473;68.3;56.3
51;2021-08-11;2917;2341;387782;319814;68.8;56.7
51;2021-08-12;1754;1958;389536;321772;69.1;57.1
51;2021-08-13;2066;2670;391602;324442;69.5;57.5
51;2021-08-14;1583;2027;393185;326469;69.7;57.9
51;2021-08-15;149;150;393334;326619;69.8;57.9
51;2021-08-16;1356;3016;394690;329635;70.0;58.5
51;2021-08-17;1560;3283;396250;332918;70.3;59.0
51;2021-08-18;1899;3693;398149;336611;70.6;59.7
51;2021-08-19;1408;2548;399557;339159;70.9;60.2
51;2021-08-20;1707;3974;401264;343133;71.2;60.9
51;2021-08-21;988;2497;402252;345630;71.3;61.3
51;2021-08-22;101;343;402353;345973;71.4;61.4
51;2021-08-23;1111;3607;403464;349580;71.6;62.0
51;2021-08-24;1174;3643;404638;353223;71.8;62.6
51;2021-08-25;1320;4487;405958;357710;72.0;63.4
51;2021-08-26;1057;2547;407015;360257;72.2;63.9
51;2021-08-27;1214;4178;408229;364435;72.4;64.6
51;2021-08-28;655;2632;408884;367067;72.5;65.1
51;2021-08-29;84;360;408968;367427;72.5;65.2
51;2021-08-30;1332;4830;410300;372257;72.8;66.0
51;2021-08-31;778;3011;411078;375268;72.9;66.6
51;2021-09-01;738;3374;411816;378642;73.0;67.2
51;2021-09-02;799;2216;412615;380858;73.2;67.5
51;2021-09-03;904;2911;413519;383769;73.3;68.1
51;2021-09-04;619;2807;414138;386576;73.5;68.6
51;2021-09-05;122;225;414260;386801;73.5;68.6
51;2021-09-06;433;1791;414693;388592;73.6;68.9
51;2021-09-07;519;1670;415212;390262;73.6;69.2
51;2021-09-08;627;2175;415839;392437;73.8;69.6
51;2021-09-09;466;1348;416305;393785;73.8;69.8
51;2021-09-10;669;2089;416974;395874;74.0;70.2
51;2021-09-11;559;1934;417533;397808;74.1;70.6
51;2021-09-12;19;82;417552;397890;74.1;70.6
51;2021-09-13;427;1090;417979;398980;74.1;70.8
51;2021-09-14;594;1331;418573;400311;74.2;71.0
51;2021-09-15;490;1423;419063;401734;74.3;71.3
51;2021-09-16;306;658;419369;402392;74.4;71.4
51;2021-09-17;541;1127;419910;403519;74.5;71.6
51;2021-09-18;469;1418;420379;404937;74.6;71.8
51;2021-09-19;13;64;420392;405001;74.6;71.8
51;2021-09-20;280;535;420672;405536;74.6;71.9
51;2021-09-21;255;489;420927;406025;74.7;72.0
51;2021-09-22;318;1352;421245;407377;74.7;72.3
51;2021-09-23;195;602;421440;407979;74.7;72.4
51;2021-09-24;366;978;421806;408957;74.8;72.5
51;2021-09-25;283;984;422089;409941;74.9;72.7
51;2021-09-26;7;129;422096;410070;74.9;72.7
51;2021-09-27;259;445;422355;410515;74.9;72.8
51;2021-09-28;298;363;422653;410878;75.0;72.9
51;2021-09-29;348;775;423001;411653;75.0;73.0
51;2021-09-30;263;415;423264;412068;75.1;73.1
51;2021-10-01;353;717;423617;412785;75.1;73.2
51;2021-10-02;371;761;423988;413546;75.2;73.3
51;2021-10-03;0;1;423988;413547;75.2;73.3
51;2021-10-04;180;445;424168;413992;75.2;73.4
51;2021-10-05;204;431;424372;414423;75.3;73.5
51;2021-10-06;309;553;424681;414976;75.3;73.6
52;2020-12-27;0;0;0;0;0.0;0.0
52;2020-12-28;1;0;1;0;0.0;0.0
52;2020-12-29;0;0;1;0;0.0;0.0
52;2020-12-30;0;0;1;0;0.0;0.0
52;2020-12-31;0;0;1;0;0.0;0.0
52;2021-01-01;0;0;1;0;0.0;0.0
52;2021-01-02;1;0;2;0;0.0;0.0
52;2021-01-03;0;0;2;0;0.0;0.0
52;2021-01-04;0;0;2;0;0.0;0.0
52;2021-01-05;0;0;2;0;0.0;0.0
52;2021-01-06;2;0;4;0;0.0;0.0
52;2021-01-07;0;0;4;0;0.0;0.0
52;2021-01-08;200;1;204;1;0.1;0.0
52;2021-01-09;93;0;297;1;0.2;0.0
52;2021-01-10;0;0;297;1;0.2;0.0
52;2021-01-11;207;0;504;1;0.3;0.0
52;2021-01-12;171;0;675;1;0.4;0.0
52;2021-01-13;564;2;1239;3;0.7;0.0
52;2021-01-14;677;10;1916;13;1.1;0.0
52;2021-01-15;411;1;2327;14;1.4;0.0
52;2021-01-16;16;0;2343;14;1.4;0.0
52;2021-01-17;0;0;2343;14;1.4;0.0
52;2021-01-18;427;0;2770;14;1.6;0.0
52;2021-01-19;440;0;3210;14;1.9;0.0
52;2021-01-20;422;0;3632;14;2.1;0.0
52;2021-01-21;423;1;4055;15;2.4;0.0
52;2021-01-22;320;2;4375;17;2.6;0.0
52;2021-01-23;73;1;4448;18;2.6;0.0
52;2021-01-24;0;0;4448;18;2.6;0.0
52;2021-01-25;236;0;4684;18;2.8;0.0
52;2021-01-26;308;0;4992;18;2.9;0.0
52;2021-01-27;238;1;5230;19;3.1;0.0
52;2021-01-28;174;4;5404;23;3.2;0.0
52;2021-01-29;74;114;5478;137;3.2;0.1
52;2021-01-30;91;92;5569;229;3.3;0.1
52;2021-01-31;0;0;5569;229;3.3;0.1
52;2021-02-01;117;178;5686;407;3.4;0.2
52;2021-02-02;61;167;5747;574;3.4;0.3
52;2021-02-03;89;387;5836;961;3.4;0.6
52;2021-02-04;231;534;6067;1495;3.6;0.9
52;2021-02-05;113;421;6180;1916;3.7;1.1
52;2021-02-06;22;0;6202;1916;3.7;1.1
52;2021-02-07;0;1;6202;1917;3.7;1.1
52;2021-02-08;34;163;6236;2080;3.7;1.2
52;2021-02-09;47;174;6283;2254;3.7;1.3
52;2021-02-10;88;162;6371;2416;3.8;1.4
52;2021-02-11;129;123;6500;2539;3.8;1.5
52;2021-02-12;187;106;6687;2645;4.0;1.6
52;2021-02-13;5;1;6692;2646;4.0;1.6
52;2021-02-14;0;16;6692;2662;4.0;1.6
52;2021-02-15;79;226;6771;2888;4.0;1.7
52;2021-02-16;50;282;6821;3170;4.0;1.9
52;2021-02-17;38;254;6859;3424;4.1;2.0
52;2021-02-18;82;237;6941;3661;4.1;2.2
52;2021-02-19;50;151;6991;3812;4.1;2.3
52;2021-02-20;14;89;7005;3901;4.1;2.3
52;2021-02-21;0;0;7005;3901;4.1;2.3
52;2021-02-22;42;322;7047;4223;4.2;2.5
52;2021-02-23;56;224;7103;4447;4.2;2.6
52;2021-02-24;81;212;7184;4659;4.2;2.8
52;2021-02-25;161;224;7345;4883;4.3;2.9
52;2021-02-26;296;174;7641;5057;4.5;3.0
52;2021-02-27;149;49;7790;5106;4.6;3.0
52;2021-02-28;0;0;7790;5106;4.6;3.0
52;2021-03-01;162;13;7952;5119;4.7;3.0
52;2021-03-02;228;45;8180;5164;4.8;3.1
52;2021-03-03;356;35;8536;5199;5.0;3.1
52;2021-03-04;381;58;8917;5257;5.3;3.1
52;2021-03-05;531;52;9448;5309;5.6;3.1
52;2021-03-06;409;35;9857;5344;5.8;3.2
52;2021-03-07;0;0;9857;5344;5.8;3.2
52;2021-03-08;398;102;10255;5446;6.1;3.2
52;2021-03-09;549;104;10804;5550;6.4;3.3
52;2021-03-10;308;102;11112;5652;6.6;3.3
52;2021-03-11;587;34;11699;5686;6.9;3.4
52;2021-03-12;586;68;12285;5754;7.3;3.4
52;2021-03-13;494;10;12779;5764;7.6;3.4
52;2021-03-14;15;3;12794;5767;7.6;3.4
52;2021-03-15;318;27;13112;5794;7.7;3.4
52;2021-03-16;203;15;13315;5809;7.9;3.4
52;2021-03-17;369;15;13684;5824;8.1;3.4
52;2021-03-18;442;10;14126;5834;8.3;3.4
52;2021-03-19;453;53;14579;5887;8.6;3.5
52;2021-03-20;259;12;14838;5899;8.8;3.5
52;2021-03-21;15;1;14853;5900;8.8;3.5
52;2021-03-22;375;49;15228;5949;9.0;3.5
52;2021-03-23;686;123;15914;6072;9.4;3.6
52;2021-03-24;771;71;16685;6143;9.9;3.6
52;2021-03-25;1144;88;17829;6231;10.5;3.7
52;2021-03-26;1036;135;18865;6366;11.1;3.8
52;2021-03-27;477;75;19342;6441;11.4;3.8
52;2021-03-28;53;0;19395;6441;11.5;3.8
52;2021-03-29;507;182;19902;6623;11.8;3.9
52;2021-03-30;868;320;20770;6943;12.3;4.1
52;2021-03-31;956;291;21726;7234;12.8;4.3
52;2021-04-01;1145;183;22871;7417;13.5;4.4
52;2021-04-02;958;109;23829;7526;14.1;4.4
52;2021-04-03;462;2;24291;7528;14.4;4.4
52;2021-04-04;1;1;24292;7529;14.4;4.4
52;2021-04-05;1;0;24293;7529;14.4;4.4
52;2021-04-06;434;293;24727;7822;14.6;4.6
52;2021-04-07;506;450;25233;8272;14.9;4.9
52;2021-04-08;860;208;26093;8480;15.4;5.0
52;2021-04-09;1058;131;27151;8611;16.0;5.1
52;2021-04-10;850;102;28001;8713;16.5;5.1
52;2021-04-11;96;1;28097;8714;16.6;5.1
52;2021-04-12;933;277;29030;8991;17.2;5.3
52;2021-04-13;1251;380;30281;9371;17.9;5.5
52;2021-04-14;1345;455;31626;9826;18.7;5.8
52;2021-04-15;1505;441;33131;10267;19.6;6.1
52;2021-04-16;1569;359;34700;10626;20.5;6.3
52;2021-04-17;1312;135;36012;10761;21.3;6.4
52;2021-04-18;510;29;36522;10790;21.6;6.4
52;2021-04-19;697;611;37219;11401;22.0;6.7
52;2021-04-20;1079;679;38298;12080;22.6;7.1
52;2021-04-21;1058;673;39356;12753;23.3;7.5
52;2021-04-22;1468;734;40824;13487;24.1;8.0
52;2021-04-23;1250;669;42074;14156;24.9;8.4
52;2021-04-24;477;293;42551;14449;25.1;8.5
52;2021-04-25;3;77;42554;14526;25.1;8.6
52;2021-04-26;631;561;43185;15087;25.5;8.9
52;2021-04-27;932;668;44117;15755;26.1;9.3
52;2021-04-28;1443;568;45560;16323;26.9;9.6
52;2021-04-29;1452;583;47012;16906;27.8;10.0
52;2021-04-30;1316;611;48328;17517;28.6;10.3
52;2021-05-01;8;230;48336;17747;28.6;10.5
52;2021-05-02;0;1;48336;17748;28.6;10.5
52;2021-05-03;1159;628;49495;18376;29.2;10.9
52;2021-05-04;1445;719;50940;19095;30.1;11.3
52;2021-05-05;1768;647;52708;19742;31.1;11.7
52;2021-05-06;1963;537;54671;20279;32.3;12.0
52;2021-05-07;1441;1168;56112;21447;33.2;12.7
52;2021-05-08;587;317;56699;21764;33.5;12.9
52;2021-05-09;1;47;56700;21811;33.5;12.9
52;2021-05-10;792;1100;57492;22911;34.0;13.5
52;2021-05-11;868;1389;58360;24300;34.5;14.4
52;2021-05-12;1206;1382;59566;25682;35.2;15.2
52;2021-05-13;67;184;59633;25866;35.2;15.3
52;2021-05-14;1185;1366;60818;27232;35.9;16.1
52;2021-05-15;492;929;61310;28161;36.2;16.6
52;2021-05-16;8;43;61318;28204;36.2;16.7
52;2021-05-17;1141;705;62459;28909;36.9;17.1
52;2021-05-18;1218;677;63677;29586;37.6;17.5
52;2021-05-19;1541;415;65218;30001;38.5;17.7
52;2021-05-20;1546;418;66764;30419;39.4;18.0
52;2021-05-21;1625;611;68389;31030;40.4;18.3
52;2021-05-22;1089;210;69478;31240;41.1;18.5
52;2021-05-23;1;0;69479;31240;41.1;18.5
52;2021-05-24;405;33;69884;31273;41.3;18.5
52;2021-05-25;1351;385;71235;31658;42.1;18.7
52;2021-05-26;1476;672;72711;32330;43.0;19.1
52;2021-05-27;1564;786;74275;33116;43.9;19.6
52;2021-05-28;1493;668;75768;33784;44.8;20.0
52;2021-05-29;695;834;76463;34618;45.2;20.5
52;2021-05-30;16;551;76479;35169;45.2;20.8
52;2021-05-31;825;829;77304;35998;45.7;21.3
52;2021-06-01;956;816;78260;36814;46.2;21.8
52;2021-06-02;896;754;79156;37568;46.8;22.2
52;2021-06-03;825;825;79981;38393;47.3;22.7
52;2021-06-04;883;1340;80864;39733;47.8;23.5
52;2021-06-05;581;637;81445;40370;48.1;23.9
52;2021-06-06;27;55;81472;40425;48.1;23.9
52;2021-06-07;359;931;81831;41356;48.3;24.4
52;2021-06-08;556;1470;82387;42826;48.7;25.3
52;2021-06-09;611;1474;82998;44300;49.0;26.2
52;2021-06-10;794;1159;83792;45459;49.5;26.9
52;2021-06-11;830;1347;84622;46806;50.0;27.7
52;2021-06-12;423;586;85045;47392;50.2;28.0
52;2021-06-13;2;6;85047;47398;50.2;28.0
52;2021-06-14;170;1413;85217;48811;50.3;28.8
52;2021-06-15;221;1807;85438;50618;50.5;29.9
52;2021-06-16;351;1996;85789;52614;50.7;31.1
52;2021-06-17;265;1156;86054;53770;50.8;31.8
52;2021-06-18;308;1553;86362;55323;51.0;32.7
52;2021-06-19;502;684;86864;56007;51.3;33.1
52;2021-06-20;1;17;86865;56024;51.3;33.1
52;2021-06-21;523;898;87388;56922;51.6;33.6
52;2021-06-22;503;1047;87891;57969;51.9;34.3
52;2021-06-23;563;1041;88454;59010;52.3;34.9
52;2021-06-24;610;715;89064;59725;52.6;35.3
52;2021-06-25;661;1314;89725;61039;53.0;36.1
52;2021-06-26;264;722;89989;61761;53.2;36.5
52;2021-06-27;1;8;89990;61769;53.2;36.5
52;2021-06-28;184;1442;90174;63211;53.3;37.3
52;2021-06-29;163;1414;90337;64625;53.4;38.2
52;2021-06-30;221;1467;90558;66092;53.5;39.0
52;2021-07-01;320;1020;90878;67112;53.7;39.7
52;2021-07-02;430;1454;91308;68566;53.9;40.5
52;2021-07-03;302;1148;91610;69714;54.1;41.2
52;2021-07-04;0;11;91610;69725;54.1;41.2
52;2021-07-05;175;1448;91785;71173;54.2;42.1
52;2021-07-06;284;1449;92069;72622;54.4;42.9
52;2021-07-07;309;1163;92378;73785;54.6;43.6
52;2021-07-08;473;1166;92851;74951;54.9;44.3
52;2021-07-09;288;1620;93139;76571;55.0;45.2
52;2021-07-10;155;822;93294;77393;55.1;45.7
52;2021-07-11;13;12;93307;77405;55.1;45.7
52;2021-07-12;299;1467;93606;78872;55.3;46.6
52;2021-07-13;590;1367;94196;80239;55.7;47.4
52;2021-07-14;437;153;94633;80392;55.9;47.5
52;2021-07-15;614;1428;95247;81820;56.3;48.3
52;2021-07-16;899;1337;96146;83157;56.8;49.1
52;2021-07-17;530;343;96676;83500;57.1;49.3
52;2021-07-18;3;12;96679;83512;57.1;49.3
52;2021-07-19;691;987;97370;84499;57.5;49.9
52;2021-07-20;1110;831;98480;85330;58.2;50.4
52;2021-07-21;1161;737;99641;86067;58.9;50.9
52;2021-07-22;1447;865;101088;86932;59.7;51.4
52;2021-07-23;1399;956;102487;87888;60.6;51.9
52;2021-07-24;873;487;103360;88375;61.1;52.2
52;2021-07-25;22;21;103382;88396;61.1;52.2
52;2021-07-26;1010;613;104392;89009;61.7;52.6
52;2021-07-27;1342;657;105734;89666;62.5;53.0
52;2021-07-28;1382;643;107116;90309;63.3;53.4
52;2021-07-29;1263;622;108379;90931;64.0;53.7
52;2021-07-30;1365;713;109744;91644;64.8;54.1
52;2021-07-31;873;549;110617;92193;65.4;54.5
52;2021-08-01;1;14;110618;92207;65.4;54.5
52;2021-08-02;1185;562;111803;92769;66.1;54.8
52;2021-08-03;1363;540;113166;93309;66.9;55.1
52;2021-08-04;1157;579;114323;93888;67.5;55.5
52;2021-08-05;1026;574;115349;94462;68.2;55.8
52;2021-08-06;1057;697;116406;95159;68.8;56.2
52;2021-08-07;519;422;116925;95581;69.1;56.5
52;2021-08-08;0;6;116925;95587;69.1;56.5
52;2021-08-09;469;871;117394;96458;69.4;57.0
52;2021-08-10;717;748;118111;97206;69.8;57.4
52;2021-08-11;535;837;118646;98043;70.1;57.9
52;2021-08-12;623;750;119269;98793;70.5;58.4
52;2021-08-13;420;1029;119689;99822;70.7;59.0
52;2021-08-14;421;360;120110;100182;71.0;59.2
52;2021-08-15;13;13;120123;100195;71.0;59.2
52;2021-08-16;327;934;120450;101129;71.2;59.8
52;2021-08-17;416;911;120866;102040;71.4;60.3
52;2021-08-18;489;944;121355;102984;71.7;60.8
52;2021-08-19;461;836;121816;103820;72.0;61.3
52;2021-08-20;384;1210;122200;105030;72.2;62.1
52;2021-08-21;394;605;122594;105635;72.4;62.4
52;2021-08-22;5;11;122599;105646;72.4;62.4
52;2021-08-23;431;1058;123030;106704;72.7;63.0
52;2021-08-24;307;1077;123337;107781;72.9;63.7
52;2021-08-25;254;1061;123591;108842;73.0;64.3
52;2021-08-26;302;914;123893;109756;73.2;64.8
52;2021-08-27;429;1276;124322;111032;73.5;65.6
52;2021-08-28;243;495;124565;111527;73.6;65.9
52;2021-08-29;3;25;124568;111552;73.6;65.9
52;2021-08-30;204;998;124772;112550;73.7;66.5
52;2021-08-31;205;1054;124977;113604;73.8;67.1
52;2021-09-01;183;1066;125160;114670;73.9;67.8
52;2021-09-02;194;762;125354;115432;74.1;68.2
52;2021-09-03;243;936;125597;116368;74.2;68.8
52;2021-09-04;189;556;125786;116924;74.3;69.1
52;2021-09-05;2;14;125788;116938;74.3;69.1
52;2021-09-06;126;543;125914;117481;74.4;69.4
52;2021-09-07;163;519;126077;118000;74.5;69.7
52;2021-09-08;143;616;126220;118616;74.6;70.1
52;2021-09-09;139;432;126359;119048;74.7;70.3
52;2021-09-10;256;741;126615;119789;74.8;70.8
52;2021-09-11;151;321;126766;120110;74.9;71.0
52;2021-09-12;2;12;126768;120122;74.9;71.0
52;2021-09-13;174;621;126942;120743;75.0;71.3
52;2021-09-14;145;463;127087;121206;75.1;71.6
52;2021-09-15;148;447;127235;121653;75.2;71.9
52;2021-09-16;136;309;127371;121962;75.3;72.1
52;2021-09-17;232;543;127603;122505;75.4;72.4
52;2021-09-18;134;242;127737;122747;75.5;72.5
52;2021-09-19;4;18;127741;122765;75.5;72.5
52;2021-09-20;106;354;127847;123119;75.5;72.7
52;2021-09-21;94;208;127941;123327;75.6;72.9
52;2021-09-22;107;319;128048;123646;75.7;73.1
52;2021-09-23;138;207;128186;123853;75.7;73.2
52;2021-09-24;127;284;128313;124137;75.8;73.3
52;2021-09-25;93;250;128406;124387;75.9;73.5
52;2021-09-26;0;0;128406;124387;75.9;73.5
52;2021-09-27;116;181;128522;124568;75.9;73.6
52;2021-09-28;120;144;128642;124712;76.0;73.7
52;2021-09-29;93;207;128735;124919;76.1;73.8
52;2021-09-30;117;124;128852;125043;76.1;73.9
52;2021-10-01;117;226;128969;125269;76.2;74.0
52;2021-10-02;63;150;129032;125419;76.2;74.1
52;2021-10-03;0;6;129032;125425;76.2;74.1
52;2021-10-04;82;179;129114;125604;76.3;74.2
52;2021-10-05;57;133;129171;125737;76.3;74.3
52;2021-10-06;120;170;129291;125907;76.4;74.4
53;2020-12-27;0;0;0;0;0.0;0.0
53;2020-12-28;0;0;0;0;0.0;0.0
53;2020-12-29;0;0;0;0;0.0;0.0
53;2020-12-30;0;0;0;0;0.0;0.0
53;2020-12-31;0;0;0;0;0.0;0.0
53;2021-01-01;0;0;0;0;0.0;0.0
53;2021-01-02;1;0;1;0;0.0;0.0
53;2021-01-03;0;0;1;0;0.0;0.0
53;2021-01-04;1;0;2;0;0.0;0.0
53;2021-01-05;0;0;2;0;0.0;0.0
53;2021-01-06;0;0;2;0;0.0;0.0
53;2021-01-07;102;0;104;0;0.0;0.0
53;2021-01-08;284;1;388;1;0.1;0.0
53;2021-01-09;134;1;522;2;0.2;0.0
53;2021-01-10;15;0;537;2;0.2;0.0
53;2021-01-11;176;0;713;2;0.2;0.0
53;2021-01-12;456;0;1169;2;0.4;0.0
53;2021-01-13;254;0;1423;2;0.5;0.0
53;2021-01-14;290;7;1713;9;0.6;0.0
53;2021-01-15;343;4;2056;13;0.7;0.0
53;2021-01-16;60;0;2116;13;0.7;0.0
53;2021-01-17;25;0;2141;13;0.7;0.0
53;2021-01-18;364;0;2505;13;0.8;0.0
53;2021-01-19;594;0;3099;13;1.0;0.0
53;2021-01-20;742;0;3841;13;1.3;0.0
53;2021-01-21;773;2;4614;15;1.5;0.0
53;2021-01-22;705;5;5319;20;1.7;0.0
53;2021-01-23;160;0;5479;20;1.8;0.0
53;2021-01-24;6;0;5485;20;1.8;0.0
53;2021-01-25;550;0;6035;20;2.0;0.0
53;2021-01-26;1199;7;7234;27;2.4;0.0
53;2021-01-27;696;4;7930;31;2.6;0.0
53;2021-01-28;737;94;8667;125;2.8;0.0
53;2021-01-29;422;177;9089;302;3.0;0.1
53;2021-01-30;130;0;9219;302;3.0;0.1
53;2021-01-31;0;0;9219;302;3.0;0.1
53;2021-02-01;298;143;9517;445;3.1;0.1
53;2021-02-02;309;226;9826;671;3.2;0.2
53;2021-02-03;228;358;10054;1029;3.3;0.3
53;2021-02-04;184;303;10238;1332;3.4;0.4
53;2021-02-05;234;289;10472;1621;3.4;0.5
53;2021-02-06;153;23;10625;1644;3.5;0.5
53;2021-02-07;0;0;10625;1644;3.5;0.5
53;2021-02-08;168;89;10793;1733;3.5;0.6
53;2021-02-09;369;206;11162;1939;3.7;0.6
53;2021-02-10;266;397;11428;2336;3.7;0.8
53;2021-02-11;433;397;11861;2733;3.9;0.9
53;2021-02-12;318;486;12179;3219;4.0;1.1
53;2021-02-13;96;53;12275;3272;4.0;1.1
53;2021-02-14;0;99;12275;3371;4.0;1.1
53;2021-02-15;239;334;12514;3705;4.1;1.2
53;2021-02-16;528;697;13042;4402;4.3;1.4
53;2021-02-17;391;518;13433;4920;4.4;1.6
53;2021-02-18;547;505;13980;5425;4.6;1.8
53;2021-02-19;895;359;14875;5784;4.9;1.9
53;2021-02-20;139;83;15014;5867;4.9;1.9
53;2021-02-21;1;20;15015;5887;4.9;1.9
53;2021-02-22;161;433;15176;6320;5.0;2.1
53;2021-02-23;59;506;15235;6826;5.0;2.2
53;2021-02-24;137;393;15372;7219;5.0;2.4
53;2021-02-25;457;268;15829;7487;5.2;2.5
53;2021-02-26;437;217;16266;7704;5.3;2.5
53;2021-02-27;86;85;16352;7789;5.4;2.6
53;2021-02-28;0;0;16352;7789;5.4;2.6
53;2021-03-01;231;223;16583;8012;5.4;2.6
53;2021-03-02;246;210;16829;8222;5.5;2.7
53;2021-03-03;321;366;17150;8588;5.6;2.8
53;2021-03-04;859;333;18009;8921;5.9;2.9
53;2021-03-05;660;270;18669;9191;6.1;3.0
53;2021-03-06;447;184;19116;9375;6.3;3.1
53;2021-03-07;276;5;19392;9380;6.4;3.1
53;2021-03-08;375;160;19767;9540;6.5;3.1
53;2021-03-09;878;242;20645;9782;6.8;3.2
53;2021-03-10;807;106;21452;9888;7.0;3.2
53;2021-03-11;1247;228;22699;10116;7.4;3.3
53;2021-03-12;1603;145;24302;10261;8.0;3.4
53;2021-03-13;824;14;25126;10275;8.2;3.4
53;2021-03-14;1;0;25127;10275;8.2;3.4
53;2021-03-15;1001;288;26128;10563;8.6;3.5
53;2021-03-16;1035;331;27163;10894;8.9;3.6
53;2021-03-17;687;257;27850;11151;9.1;3.7
53;2021-03-18;972;345;28822;11496;9.4;3.8
53;2021-03-19;1346;590;30168;12086;9.9;4.0
53;2021-03-20;592;17;30760;12103;10.1;4.0
53;2021-03-21;3;0;30763;12103;10.1;4.0
53;2021-03-22;1213;155;31976;12258;10.5;4.0
53;2021-03-23;1699;71;33675;12329;11.0;4.0
53;2021-03-24;1323;117;34998;12446;11.5;4.1
53;2021-03-25;2323;243;37321;12689;12.2;4.2
53;2021-03-26;1882;152;39203;12841;12.8;4.2
53;2021-03-27;339;3;39542;12844;12.9;4.2
53;2021-03-28;2;0;39544;12844;12.9;4.2
53;2021-03-29;1474;213;41018;13057;13.4;4.3
53;2021-03-30;1944;202;42962;13259;14.1;4.3
53;2021-03-31;1791;224;44753;13483;14.7;4.4
53;2021-04-01;1948;671;46701;14154;15.3;4.6
53;2021-04-02;2075;226;48776;14380;16.0;4.7
53;2021-04-03;414;1;49190;14381;16.1;4.7
53;2021-04-04;11;0;49201;14381;16.1;4.7
53;2021-04-05;9;15;49210;14396;16.1;4.7
53;2021-04-06;1305;504;50515;14900;16.5;4.9
53;2021-04-07;1172;925;51687;15825;16.9;5.2
53;2021-04-08;1663;1006;53350;16831;17.5;5.5
53;2021-04-09;1959;407;55309;17238;18.1;5.6
53;2021-04-10;543;13;55852;17251;18.3;5.6
53;2021-04-11;13;0;55865;17251;18.3;5.6
53;2021-04-12;694;1067;56559;18318;18.5;6.0
53;2021-04-13;1470;1106;58029;19424;19.0;6.4
53;2021-04-14;1022;734;59051;20158;19.3;6.6
53;2021-04-15;1156;1105;60207;21263;19.7;7.0
53;2021-04-16;1271;815;61478;22078;20.1;7.2
53;2021-04-17;279;273;61757;22351;20.2;7.3
53;2021-04-18;0;0;61757;22351;20.2;7.3
53;2021-04-19;681;1061;62438;23412;20.4;7.7
53;2021-04-20;936;1452;63374;24864;20.8;8.1
53;2021-04-21;852;1009;64226;25873;21.0;8.5
53;2021-04-22;1045;1614;65271;27487;21.4;9.0
53;2021-04-23;1329;1054;66600;28541;21.8;9.3
53;2021-04-24;68;7;66668;28548;21.8;9.3
53;2021-04-25;6;39;66674;28587;21.8;9.4
53;2021-04-26;368;1230;67042;29817;22.0;9.8
53;2021-04-27;723;1969;67765;31786;22.2;10.4
53;2021-04-28;977;1393;68742;33179;22.5;10.9
53;2021-04-29;1052;1711;69794;34890;22.9;11.4
53;2021-04-30;1366;1315;71160;36205;23.3;11.9
53;2021-05-01;36;50;71196;36255;23.3;11.9
53;2021-05-02;0;0;71196;36255;23.3;11.9
53;2021-05-03;1570;703;72766;36958;23.8;12.1
53;2021-05-04;1303;1440;74069;38398;24.3;12.6
53;2021-05-05;1611;825;75680;39223;24.8;12.8
53;2021-05-06;1390;1399;77070;40622;25.2;13.3
53;2021-05-07;1537;1301;78607;41923;25.7;13.7
53;2021-05-08;939;36;79546;41959;26.0;13.7
53;2021-05-09;11;2;79557;41961;26.1;13.7
53;2021-05-10;2414;815;81971;42776;26.8;14.0
53;2021-05-11;3097;1281;85068;44057;27.9;14.4
53;2021-05-12;2751;1093;87819;45150;28.8;14.8
53;2021-05-13;350;27;88169;45177;28.9;14.8
53;2021-05-14;2021;677;90190;45854;29.5;15.0
53;2021-05-15;1058;63;91248;45917;29.9;15.0
53;2021-05-16;3;0;91251;45917;29.9;15.0
53;2021-05-17;1701;1196;92952;47113;30.4;15.4
53;2021-05-18;1880;1550;94832;48663;31.1;15.9
53;2021-05-19;2302;747;97134;49410;31.8;16.2
53;2021-05-20;3216;866;100350;50276;32.9;16.5
53;2021-05-21;2798;828;103148;51104;33.8;16.7
53;2021-05-22;21;59;103169;51163;33.8;16.8
53;2021-05-23;1;0;103170;51163;33.8;16.8
53;2021-05-24;8;6;103178;51169;33.8;16.8
53;2021-05-25;1820;802;104998;51971;34.4;17.0
53;2021-05-26;1853;908;106851;52879;35.0;17.3
53;2021-05-27;3072;1079;109923;53958;36.0;17.7
53;2021-05-28;2562;876;112485;54834;36.8;18.0
53;2021-05-29;846;240;113331;55074;37.1;18.0
53;2021-05-30;18;6;113349;55080;37.1;18.0
53;2021-05-31;2565;802;115914;55882;38.0;18.3
53;2021-06-01;3489;1254;119403;57136;39.1;18.7
53;2021-06-02;3183;520;122586;57656;40.1;18.9
53;2021-06-03;4198;784;126784;58440;41.5;19.1
53;2021-06-04;3179;1265;129963;59705;42.6;19.6
53;2021-06-05;137;245;130100;59950;42.6;19.6
53;2021-06-06;1;4;130101;59954;42.6;19.6
53;2021-06-07;2629;922;132730;60876;43.5;19.9
53;2021-06-08;3588;1128;136318;62004;44.6;20.3
53;2021-06-09;2455;943;138773;62947;45.4;20.6
53;2021-06-10;3521;842;142294;63789;46.6;20.9
53;2021-06-11;2964;1210;145258;64999;47.6;21.3
53;2021-06-12;108;138;145366;65137;47.6;21.3
53;2021-06-13;10;2;145376;65139;47.6;21.3
53;2021-06-14;1600;1788;146976;66927;48.1;21.9
53;2021-06-15;1898;2264;148874;69191;48.8;22.7
53;2021-06-16;1828;1733;150702;70924;49.4;23.2
53;2021-06-17;3011;1651;153713;72575;50.3;23.8
53;2021-06-18;2705;1805;156418;74380;51.2;24.4
53;2021-06-19;761;1164;157179;75544;51.5;24.7
53;2021-06-20;3;479;157182;76023;51.5;24.9
53;2021-06-21;918;2523;158100;78546;51.8;25.7
53;2021-06-22;1299;3452;159399;81998;52.2;26.9
53;2021-06-23;1362;2892;160761;84890;52.6;27.8
53;2021-06-24;1802;2033;162563;86923;53.2;28.5
53;2021-06-25;1785;2044;164348;88967;53.8;29.1
53;2021-06-26;977;351;165325;89318;54.1;29.2
53;2021-06-27;8;8;165333;89326;54.1;29.3
53;2021-06-28;662;2899;165995;92225;54.4;30.2
53;2021-06-29;858;3645;166853;95870;54.6;31.4
53;2021-06-30;749;1518;167602;97388;54.9;31.9
53;2021-07-01;1507;2630;169109;100018;55.4;32.8
53;2021-07-02;1528;2025;170637;102043;55.9;33.4
53;2021-07-03;858;574;171495;102617;56.2;33.6
53;2021-07-04;0;4;171495;102621;56.2;33.6
53;2021-07-05;542;2057;172037;104678;56.3;34.3
53;2021-07-06;859;3615;172896;108293;56.6;35.5
53;2021-07-07;1024;2652;173920;110945;57.0;36.3
53;2021-07-08;1313;3116;175233;114061;57.4;37.4
53;2021-07-09;1131;3399;176364;117460;57.8;38.5
53;2021-07-10;422;1001;176786;118461;57.9;38.8
53;2021-07-11;12;20;176798;118481;57.9;38.8
53;2021-07-12;503;3706;177301;122187;58.1;40.0
53;2021-07-13;894;4762;178195;126949;58.4;41.6
53;2021-07-14;104;284;178299;127233;58.4;41.7
53;2021-07-15;1112;4342;179411;131575;58.8;43.1
53;2021-07-16;1248;3847;180659;135422;59.2;44.3
53;2021-07-17;1318;300;181977;135722;59.6;44.4
53;2021-07-18;27;20;182004;135742;59.6;44.5
53;2021-07-19;734;3426;182738;139168;59.8;45.6
53;2021-07-20;985;4122;183723;143290;60.2;46.9
53;2021-07-21;686;3273;184409;146563;60.4;48.0
53;2021-07-22;1512;3522;185921;150085;60.9;49.1
53;2021-07-23;1603;3758;187524;153843;61.4;50.4
53;2021-07-24;956;280;188480;154123;61.7;50.5
53;2021-07-25;60;24;188540;154147;61.7;50.5
53;2021-07-26;1727;1941;190267;156088;62.3;51.1
53;2021-07-27;2356;2820;192623;158908;63.1;52.0
53;2021-07-28;2145;2813;194768;161721;63.8;53.0
53;2021-07-29;2491;2546;197259;164267;64.6;53.8
53;2021-07-30;1828;2647;199087;166914;65.2;54.7
53;2021-07-31;626;229;199713;167143;65.4;54.7
53;2021-08-01;37;25;199750;167168;65.4;54.7
53;2021-08-02;2082;1732;201832;168900;66.1;55.3
53;2021-08-03;2415;1905;204247;170805;66.9;55.9
53;2021-08-04;2475;1863;206722;172668;67.7;56.5
53;2021-08-05;2869;1541;209591;174209;68.6;57.0
53;2021-08-06;2517;1719;212108;175928;69.5;57.6
53;2021-08-07;483;272;212591;176200;69.6;57.7
53;2021-08-08;6;19;212597;176219;69.6;57.7
53;2021-08-09;1839;1649;214436;177868;70.2;58.2
53;2021-08-10;2324;1748;216760;179616;71.0;58.8
53;2021-08-11;1681;867;218441;180483;71.5;59.1
53;2021-08-12;2007;984;220448;181467;72.2;59.4
53;2021-08-13;2039;1315;222487;182782;72.9;59.9
53;2021-08-14;66;63;222553;182845;72.9;59.9
53;2021-08-15;1;2;222554;182847;72.9;59.9
53;2021-08-16;1337;1596;223891;184443;73.3;60.4
53;2021-08-17;1548;1657;225439;186100;73.8;60.9
53;2021-08-18;1515;1600;226954;187700;74.3;61.5
53;2021-08-19;1374;1972;228328;189672;74.8;62.1
53;2021-08-20;1099;2082;229427;191754;75.1;62.8
53;2021-08-21;189;341;229616;192095;75.2;62.9
53;2021-08-22;0;0;229616;192095;75.2;62.9
53;2021-08-23;843;1915;230459;194010;75.5;63.5
53;2021-08-24;903;2117;231362;196127;75.8;64.2
53;2021-08-25;915;2272;232277;198399;76.1;65.0
53;2021-08-26;666;2614;232943;201013;76.3;65.8
53;2021-08-27;754;2645;233697;203658;76.5;66.7
53;2021-08-28;48;133;233745;203791;76.5;66.7
53;2021-08-29;12;31;233757;203822;76.6;66.7
53;2021-08-30;620;2107;234377;205929;76.8;67.4
53;2021-08-31;762;2920;235139;208849;77.0;68.4
53;2021-09-01;342;1637;235481;210486;77.1;68.9
53;2021-09-02;441;1823;235922;212309;77.3;69.5
53;2021-09-03;449;2494;236371;214803;77.4;70.3
53;2021-09-04;115;213;236486;215016;77.4;70.4
53;2021-09-05;1;12;236487;215028;77.4;70.4
53;2021-09-06;299;1664;236786;216692;77.5;71.0
53;2021-09-07;287;1944;237073;218636;77.6;71.6
53;2021-09-08;421;2157;237494;220793;77.8;72.3
53;2021-09-09;237;1461;237731;222254;77.9;72.8
53;2021-09-10;383;2091;238114;224345;78.0;73.5
53;2021-09-11;39;137;238153;224482;78.0;73.5
53;2021-09-12;0;1;238153;224483;78.0;73.5
53;2021-09-13;231;1197;238384;225680;78.1;73.9
53;2021-09-14;243;1048;238627;226728;78.1;74.2
53;2021-09-15;332;1071;238959;227799;78.3;74.6
53;2021-09-16;305;380;239264;228179;78.4;74.7
53;2021-09-17;429;1057;239693;229236;78.5;75.1
53;2021-09-18;44;70;239737;229306;78.5;75.1
53;2021-09-19;8;14;239745;229320;78.5;75.1
53;2021-09-20;122;382;239867;229702;78.6;75.2
53;2021-09-21;248;651;240115;230353;78.6;75.4
53;2021-09-22;193;665;240308;231018;78.7;75.7
53;2021-09-23;132;395;240440;231413;78.7;75.8
53;2021-09-24;197;639;240637;232052;78.8;76.0
53;2021-09-25;27;50;240664;232102;78.8;76.0
53;2021-09-26;0;0;240664;232102;78.8;76.0
53;2021-09-27;160;374;240824;232476;78.9;76.1
53;2021-09-28;163;281;240987;232757;78.9;76.2
53;2021-09-29;159;488;241146;233245;79.0;76.4
53;2021-09-30;87;213;241233;233458;79.0;76.5
53;2021-10-01;267;621;241500;234079;79.1;76.7
53;2021-10-02;28;52;241528;234131;79.1;76.7
53;2021-10-03;3;7;241531;234138;79.1;76.7
53;2021-10-04;132;276;241663;234414;79.1;76.8
53;2021-10-05;109;210;241772;234624;79.2;76.8
53;2021-10-06;187;345;241959;234969;79.2;76.9
54;2020-12-27;0;0;0;0;0.0;0.0
54;2020-12-28;1;0;1;0;0.0;0.0
54;2020-12-29;0;0;1;0;0.0;0.0
54;2020-12-30;1;0;2;0;0.0;0.0
54;2020-12-31;10;0;12;0;0.0;0.0
54;2021-01-01;0;0;12;0;0.0;0.0
54;2021-01-02;0;0;12;0;0.0;0.0
54;2021-01-03;2;0;14;0;0.0;0.0
54;2021-01-04;163;0;177;0;0.0;0.0
54;2021-01-05;396;0;573;0;0.1;0.0
54;2021-01-06;650;1;1223;1;0.2;0.0
54;2021-01-07;816;2;2039;3;0.3;0.0
54;2021-01-08;706;3;2745;6;0.4;0.0
54;2021-01-09;81;0;2826;6;0.4;0.0
54;2021-01-10;78;0;2904;6;0.4;0.0
54;2021-01-11;974;3;3878;9;0.5;0.0
54;2021-01-12;1181;1;5059;10;0.7;0.0
54;2021-01-13;2427;7;7486;17;1.0;0.0
54;2021-01-14;3401;23;10887;40;1.5;0.0
54;2021-01-15;2717;13;13604;53;1.9;0.0
54;2021-01-16;815;4;14419;57;2.0;0.0
54;2021-01-17;209;0;14628;57;2.0;0.0
54;2021-01-18;1557;5;16185;62;2.2;0.0
54;2021-01-19;1707;0;17892;62;2.4;0.0
54;2021-01-20;1525;4;19417;66;2.7;0.0
54;2021-01-21;1371;4;20788;70;2.8;0.0
54;2021-01-22;1092;8;21880;78;3.0;0.0
54;2021-01-23;477;1;22357;79;3.1;0.0
54;2021-01-24;66;0;22423;79;3.1;0.0
54;2021-01-25;946;28;23369;107;3.2;0.0
54;2021-01-26;142;0;23511;107;3.2;0.0
54;2021-01-27;12;148;23523;255;3.2;0.0
54;2021-01-28;32;205;23555;460;3.2;0.1
54;2021-01-29;19;234;23574;694;3.2;0.1
54;2021-01-30;7;0;23581;694;3.2;0.1
54;2021-01-31;1;0;23582;694;3.2;0.1
54;2021-02-01;13;740;23595;1434;3.2;0.2
54;2021-02-02;24;914;23619;2348;3.2;0.3
54;2021-02-03;363;1390;23982;3738;3.3;0.5
54;2021-02-04;739;2230;24721;5968;3.4;0.8
54;2021-02-05;799;1663;25520;7631;3.5;1.0
54;2021-02-06;204;249;25724;7880;3.5;1.1
54;2021-02-07;4;100;25728;7980;3.5;1.1
54;2021-02-08;117;849;25845;8829;3.5;1.2
54;2021-02-09;306;932;26151;9761;3.6;1.3
54;2021-02-10;386;688;26537;10449;3.6;1.4
54;2021-02-11;294;710;26831;11159;3.7;1.5
54;2021-02-12;446;1098;27277;12257;3.7;1.7
54;2021-02-13;148;217;27425;12474;3.8;1.7
54;2021-02-14;9;8;27434;12482;3.8;1.7
54;2021-02-15;428;961;27862;13443;3.8;1.8
54;2021-02-16;401;1067;28263;14510;3.9;2.0
54;2021-02-17;518;820;28781;15330;3.9;2.1
54;2021-02-18;595;679;29376;16009;4.0;2.2
54;2021-02-19;519;642;29895;16651;4.1;2.3
54;2021-02-20;34;247;29929;16898;4.1;2.3
54;2021-02-21;3;20;29932;16918;4.1;2.3
54;2021-02-22;484;530;30416;17448;4.2;2.4
54;2021-02-23;679;506;31095;17954;4.3;2.5
54;2021-02-24;728;336;31823;18290;4.4;2.5
54;2021-02-25;1474;663;33297;18953;4.6;2.6
54;2021-02-26;1776;745;35073;19698;4.8;2.7
54;2021-02-27;698;108;35771;19806;4.9;2.7
54;2021-02-28;11;26;35782;19832;4.9;2.7
54;2021-03-01;629;192;36411;20024;5.0;2.7
54;2021-03-02;1475;146;37886;20170;5.2;2.8
54;2021-03-03;1747;61;39633;20231;5.4;2.8
54;2021-03-04;2015;98;41648;20329;5.7;2.8
54;2021-03-05;2797;144;44445;20473;6.1;2.8
54;2021-03-06;4032;108;48477;20581;6.6;2.8
54;2021-03-07;2626;70;51103;20651;7.0;2.8
54;2021-03-08;1337;63;52440;20714;7.2;2.8
54;2021-03-09;2644;104;55084;20818;7.5;2.9
54;2021-03-10;3190;106;58274;20924;8.0;2.9
54;2021-03-11;3386;98;61660;21022;8.4;2.9
54;2021-03-12;4974;184;66634;21206;9.1;2.9
54;2021-03-13;4204;112;70838;21318;9.7;2.9
54;2021-03-14;543;40;71381;21358;9.8;2.9
54;2021-03-15;1719;103;73100;21461;10.0;2.9
54;2021-03-16;1732;151;74832;21612;10.2;3.0
54;2021-03-17;2081;136;76913;21748;10.5;3.0
54;2021-03-18;2063;163;78976;21911;10.8;3.0
54;2021-03-19;3319;262;82295;22173;11.3;3.0
54;2021-03-20;2309;72;84604;22245;11.6;3.0
54;2021-03-21;295;14;84899;22259;11.6;3.0
54;2021-03-22;1034;302;85933;22561;11.8;3.1
54;2021-03-23;1938;462;87871;23023;12.0;3.2
54;2021-03-24;2194;695;90065;23718;12.3;3.2
54;2021-03-25;3172;714;93237;24432;12.8;3.3
54;2021-03-26;3513;797;96750;25229;13.2;3.5
54;2021-03-27;2419;277;99169;25506;13.6;3.5
54;2021-03-28;280;6;99449;25512;13.6;3.5
54;2021-03-29;1668;362;101117;25874;13.8;3.5
54;2021-03-30;2558;921;103675;26795;14.2;3.7
54;2021-03-31;2599;1125;106274;27920;14.6;3.8
54;2021-04-01;3237;1266;109511;29186;15.0;4.0
54;2021-04-02;2962;1667;112473;30853;15.4;4.2
54;2021-04-03;1264;1302;113737;32155;15.6;4.4
54;2021-04-04;137;418;113874;32573;15.6;4.5
54;2021-04-05;144;572;114018;33145;15.6;4.5
54;2021-04-06;1268;1640;115286;34785;15.8;4.8
54;2021-04-07;924;2244;116210;37029;15.9;5.1
54;2021-04-08;2325;2423;118535;39452;16.2;5.4
54;2021-04-09;4116;3124;122651;42576;16.8;5.8
54;2021-04-10;3208;1676;125859;44252;17.2;6.1
54;2021-04-11;206;944;126065;45196;17.3;6.2
54;2021-04-12;2198;1527;128263;46723;17.6;6.4
54;2021-04-13;3001;1969;131264;48692;18.0;6.7
54;2021-04-14;3263;1862;134527;50554;18.4;6.9
54;2021-04-15;2877;2296;137404;52850;18.8;7.2
54;2021-04-16;3141;2599;140545;55449;19.2;7.6
54;2021-04-17;3475;1485;144020;56934;19.7;7.8
54;2021-04-18;64;245;144084;57179;19.7;7.8
54;2021-04-19;2464;1081;146548;58260;20.1;8.0
54;2021-04-20;3011;1244;149559;59504;20.5;8.1
54;2021-04-21;4401;1629;153960;61133;21.1;8.4
54;2021-04-22;3722;2385;157682;63518;21.6;8.7
54;2021-04-23;3866;2084;161548;65602;22.1;9.0
54;2021-04-24;2347;1039;163895;66641;22.4;9.1
54;2021-04-25;284;277;164179;66918;22.5;9.2
54;2021-04-26;2306;1271;166485;68189;22.8;9.3
54;2021-04-27;3288;1438;169773;69627;23.2;9.5
54;2021-04-28;2974;1940;172747;71567;23.7;9.8
54;2021-04-29;3796;2073;176543;73640;24.2;10.1
54;2021-04-30;4493;1953;181036;75593;24.8;10.3
54;2021-05-01;2265;804;183301;76397;25.1;10.5
54;2021-05-02;229;68;183530;76465;25.1;10.5
54;2021-05-03;3097;938;186627;77403;25.6;10.6
54;2021-05-04;3514;1454;190141;78857;26.0;10.8
54;2021-05-05;4895;1409;195036;80266;26.7;11.0
54;2021-05-06;4434;2797;199470;83063;27.3;11.4
54;2021-05-07;4823;3397;204293;86460;28.0;11.8
54;2021-05-08;2030;644;206323;87104;28.2;11.9
54;2021-05-09;375;136;206698;87240;28.3;11.9
54;2021-05-10;3207;2234;209905;89474;28.7;12.3
54;2021-05-11;5492;2932;215397;92406;29.5;12.7
54;2021-05-12;4145;3386;219542;95792;30.1;13.1
54;2021-05-13;2648;492;222190;96284;30.4;13.2
54;2021-05-14;6883;2003;229073;98287;31.4;13.5
54;2021-05-15;5484;1323;234557;99610;32.1;13.6
54;2021-05-16;944;108;235501;99718;32.2;13.7
54;2021-05-17;3799;829;239300;100547;32.8;13.8
54;2021-05-18;3288;1104;242588;101651;33.2;13.9
54;2021-05-19;3464;1514;246052;103165;33.7;14.1
54;2021-05-20;4538;1617;250590;104782;34.3;14.3
54;2021-05-21;6753;2503;257343;107285;35.2;14.7
54;2021-05-22;5661;1376;263004;108661;36.0;14.9
54;2021-05-23;504;55;263508;108716;36.1;14.9
54;2021-05-24;1444;343;264952;109059;36.3;14.9
54;2021-05-25;4200;1535;269152;110594;36.9;15.1
54;2021-05-26;3535;2214;272687;112808;37.3;15.4
54;2021-05-27;4180;2419;276867;115227;37.9;15.8
54;2021-05-28;4989;3554;281856;118781;38.6;16.3
54;2021-05-29;3844;3996;285700;122777;39.1;16.8
54;2021-05-30;127;83;285827;122860;39.1;16.8
54;2021-05-31;2940;3059;288767;125919;39.5;17.2
54;2021-06-01;2622;4191;291389;130110;39.9;17.8
54;2021-06-02;2165;4086;293554;134196;40.2;18.4
54;2021-06-03;3146;5647;296700;139843;40.6;19.1
54;2021-06-04;5103;5468;301803;145311;41.3;19.9
54;2021-06-05;2342;3280;304145;148591;41.6;20.3
54;2021-06-06;72;236;304217;148827;41.7;20.4
54;2021-06-07;3705;2935;307922;151762;42.2;20.8
54;2021-06-08;4543;4266;312465;156028;42.8;21.4
54;2021-06-09;6003;3311;318468;159339;43.6;21.8
54;2021-06-10;5296;4445;323764;163784;44.3;22.4
54;2021-06-11;5023;4919;328787;168703;45.0;23.1
54;2021-06-12;4242;3226;333029;171929;45.6;23.5
54;2021-06-13;54;210;333083;172139;45.6;23.6
54;2021-06-14;2334;3594;335417;175733;45.9;24.1
54;2021-06-15;2831;4727;338248;180460;46.3;24.7
54;2021-06-16;3490;5657;341738;186117;46.8;25.5
54;2021-06-17;3138;5221;344876;191338;47.2;26.2
54;2021-06-18;4157;6238;349033;197576;47.8;27.1
54;2021-06-19;2648;3126;351681;200702;48.1;27.5
54;2021-06-20;101;339;351782;201041;48.2;27.5
54;2021-06-21;2557;4767;354339;205808;48.5;28.2
54;2021-06-22;2047;6221;356386;212029;48.8;29.0
54;2021-06-23;2245;5593;358631;217622;49.1;29.8
54;2021-06-24;2090;3454;360721;221076;49.4;30.3
54;2021-06-25;2196;7056;362917;228132;49.7;31.2
54;2021-06-26;2383;5672;365300;233804;50.0;32.0
54;2021-06-27;134;607;365434;234411;50.0;32.1
54;2021-06-28;1959;4354;367393;238765;50.3;32.7
54;2021-06-29;1941;5204;369334;243969;50.6;33.4
54;2021-06-30;1982;5123;371316;249092;50.8;34.1
54;2021-07-01;2143;5983;373459;255075;51.1;34.9
54;2021-07-02;2815;7563;376274;262638;51.5;36.0
54;2021-07-03;2837;4096;379111;266734;51.9;36.5
54;2021-07-04;196;499;379307;267233;51.9;36.6
54;2021-07-05;1667;4250;380974;271483;52.2;37.2
54;2021-07-06;2000;5079;382974;276562;52.4;37.9
54;2021-07-07;1905;4845;384879;281407;52.7;38.5
54;2021-07-08;1679;4111;386558;285518;52.9;39.1
54;2021-07-09;3204;6025;389762;291543;53.4;39.9
54;2021-07-10;2546;4375;392308;295918;53.7;40.5
54;2021-07-11;9;103;392317;296021;53.7;40.5
54;2021-07-12;2100;4697;394417;300718;54.0;41.2
54;2021-07-13;2619;4971;397036;305689;54.4;41.9
54;2021-07-14;1535;1506;398571;307195;54.6;42.1
54;2021-07-15;3172;4834;401743;312029;55.0;42.7
54;2021-07-16;4666;6216;406409;318245;55.6;43.6
54;2021-07-17;4005;4767;410414;323012;56.2;44.2
54;2021-07-18;1804;1687;412218;324699;56.4;44.5
54;2021-07-19;2592;4043;414810;328742;56.8;45.0
54;2021-07-20;2910;4813;417720;333555;57.2;45.7
54;2021-07-21;3134;6333;420854;339888;57.6;46.5
54;2021-07-22;3283;5730;424137;345618;58.1;47.3
54;2021-07-23;3982;6976;428119;352594;58.6;48.3
54;2021-07-24;2945;5322;431064;357916;59.0;49.0
54;2021-07-25;71;50;431135;357966;59.0;49.0
54;2021-07-26;2982;4174;434117;362140;59.4;49.6
54;2021-07-27;3717;4008;437834;366148;59.9;50.1
54;2021-07-28;5210;3877;443044;370025;60.7;50.7
54;2021-07-29;5158;3207;448202;373232;61.4;51.1
54;2021-07-30;5133;5003;453335;378235;62.1;51.8
54;2021-07-31;4538;3233;457873;381468;62.7;52.2
54;2021-08-01;257;73;458130;381541;62.7;52.2
54;2021-08-02;3098;3704;461228;385245;63.1;52.7
54;2021-08-03;4109;2919;465337;388164;63.7;53.1
54;2021-08-04;4428;2707;469765;390871;64.3;53.5
54;2021-08-05;4622;2434;474387;393305;64.9;53.8
54;2021-08-06;5455;3990;479842;397295;65.7;54.4
54;2021-08-07;3675;2829;483517;400124;66.2;54.8
54;2021-08-08;248;114;483765;400238;66.2;54.8
54;2021-08-09;2980;2694;486745;402932;66.6;55.2
54;2021-08-10;2564;3767;489309;406699;67.0;55.7
54;2021-08-11;2336;2565;491645;409264;67.3;56.0
54;2021-08-12;2191;3007;493836;412271;67.6;56.4
54;2021-08-13;2633;4449;496469;416720;68.0;57.1
54;2021-08-14;1436;2077;497905;418797;68.2;57.3
54;2021-08-15;31;43;497936;418840;68.2;57.3
54;2021-08-16;1864;3432;499800;422272;68.4;57.8
54;2021-08-17;1950;3312;501750;425584;68.7;58.3
54;2021-08-18;1500;4107;503250;429691;68.9;58.8
54;2021-08-19;1258;2790;504508;432481;69.1;59.2
54;2021-08-20;1876;4933;506384;437414;69.3;59.9
54;2021-08-21;1471;4016;507855;441430;69.5;60.4
54;2021-08-22;63;28;507918;441458;69.5;60.4
54;2021-08-23;1224;3859;509142;445317;69.7;61.0
54;2021-08-24;1141;3157;510283;448474;69.9;61.4
54;2021-08-25;1427;4382;511710;452856;70.1;62.0
54;2021-08-26;1006;3110;512716;455966;70.2;62.4
54;2021-08-27;1530;5325;514246;461291;70.4;63.2
54;2021-08-28;1146;4281;515392;465572;70.6;63.7
54;2021-08-29;17;50;515409;465622;70.6;63.7
54;2021-08-30;1214;4202;516623;469824;70.7;64.3
54;2021-08-31;1069;4708;517692;474532;70.9;65.0
54;2021-09-01;1108;3757;518800;478289;71.0;65.5
54;2021-09-02;730;2168;519530;480457;71.1;65.8
54;2021-09-03;986;3218;520516;483675;71.3;66.2
54;2021-09-04;1175;3430;521691;487105;71.4;66.7
54;2021-09-05;27;32;521718;487137;71.4;66.7
54;2021-09-06;495;1469;522213;488606;71.5;66.9
54;2021-09-07;604;1597;522817;490203;71.6;67.1
54;2021-09-08;632;1890;523449;492093;71.7;67.4
54;2021-09-09;939;2080;524388;494173;71.8;67.7
54;2021-09-10;1013;2785;525401;496958;71.9;68.0
54;2021-09-11;743;2695;526144;499653;72.0;68.4
54;2021-09-12;91;118;526235;499771;72.0;68.4
54;2021-09-13;641;1260;526876;501031;72.1;68.6
54;2021-09-14;620;1475;527496;502506;72.2;68.8
54;2021-09-15;630;1746;528126;504252;72.3;69.0
54;2021-09-16;633;713;528759;504965;72.4;69.1
54;2021-09-17;874;1531;529633;506496;72.5;69.3
54;2021-09-18;480;1437;530113;507933;72.6;69.5
54;2021-09-19;28;38;530141;507971;72.6;69.5
54;2021-09-20;371;659;530512;508630;72.6;69.6
54;2021-09-21;441;939;530953;509569;72.7;69.8
54;2021-09-22;405;1120;531358;510689;72.7;69.9
54;2021-09-23;323;845;531681;511534;72.8;70.0
54;2021-09-24;517;1179;532198;512713;72.9;70.2
54;2021-09-25;341;1077;532539;513790;72.9;70.3
54;2021-09-26;9;30;532548;513820;72.9;70.3
54;2021-09-27;231;677;532779;514497;72.9;70.4
54;2021-09-28;334;630;533113;515127;73.0;70.5
54;2021-09-29;388;805;533501;515932;73.0;70.6
54;2021-09-30;227;466;533728;516398;73.1;70.7
54;2021-10-01;480;1011;534208;517409;73.1;70.8
54;2021-10-02;392;958;534600;518367;73.2;71.0
54;2021-10-03;2;10;534602;518377;73.2;71.0
54;2021-10-04;200;527;534802;518904;73.2;71.0
54;2021-10-05;299;942;535101;519846;73.3;71.2
54;2021-10-06;356;802;535457;520648;73.3;71.3
55;2020-12-27;0;0;0;0;0.0;0.0
55;2020-12-28;2;0;2;0;0.0;0.0
55;2020-12-29;0;0;2;0;0.0;0.0
55;2020-12-30;0;0;2;0;0.0;0.0
55;2020-12-31;0;0;2;0;0.0;0.0
55;2021-01-01;0;0;2;0;0.0;0.0
55;2021-01-02;0;0;2;0;0.0;0.0
55;2021-01-03;0;0;2;0;0.0;0.0
55;2021-01-04;1;0;3;0;0.0;0.0
55;2021-01-05;0;0;3;0;0.0;0.0
55;2021-01-06;0;0;3;0;0.0;0.0
55;2021-01-07;122;0;125;0;0.1;0.0
55;2021-01-08;127;0;252;0;0.1;0.0
55;2021-01-09;52;0;304;0;0.2;0.0
55;2021-01-10;0;0;304;0;0.2;0.0
55;2021-01-11;128;1;432;1;0.2;0.0
55;2021-01-12;119;0;551;1;0.3;0.0
55;2021-01-13;134;0;685;1;0.4;0.0
55;2021-01-14;645;7;1330;8;0.7;0.0
55;2021-01-15;237;0;1567;8;0.9;0.0
55;2021-01-16;62;0;1629;8;0.9;0.0
55;2021-01-17;1;0;1630;8;0.9;0.0
55;2021-01-18;414;1;2044;9;1.1;0.0
55;2021-01-19;352;3;2396;12;1.3;0.0
55;2021-01-20;456;2;2852;14;1.6;0.0
55;2021-01-21;430;0;3282;14;1.8;0.0
55;2021-01-22;390;0;3672;14;2.0;0.0
55;2021-01-23;49;0;3721;14;2.0;0.0
55;2021-01-24;0;0;3721;14;2.0;0.0
55;2021-01-25;436;0;4157;14;2.3;0.0
55;2021-01-26;431;0;4588;14;2.5;0.0
55;2021-01-27;424;0;5012;14;2.8;0.0
55;2021-01-28;486;97;5498;111;3.0;0.1
55;2021-01-29;159;50;5657;161;3.1;0.1
55;2021-01-30;92;27;5749;188;3.2;0.1
55;2021-01-31;0;0;5749;188;3.2;0.1
55;2021-02-01;153;155;5902;343;3.2;0.2
55;2021-02-02;159;133;6061;476;3.3;0.3
55;2021-02-03;53;139;6114;615;3.4;0.3
55;2021-02-04;235;378;6349;993;3.5;0.5
55;2021-02-05;174;138;6523;1131;3.6;0.6
55;2021-02-06;62;56;6585;1187;3.6;0.7
55;2021-02-07;2;53;6587;1240;3.6;0.7
55;2021-02-08;0;17;6587;1257;3.6;0.7
55;2021-02-09;92;115;6679;1372;3.7;0.8
55;2021-02-10;65;23;6744;1395;3.7;0.8
55;2021-02-11;175;93;6919;1488;3.8;0.8
55;2021-02-12;94;27;7013;1515;3.9;0.8
55;2021-02-13;0;0;7013;1515;3.9;0.8
55;2021-02-14;0;0;7013;1515;3.9;0.8
55;2021-02-15;15;306;7028;1821;3.9;1.0
55;2021-02-16;143;277;7171;2098;3.9;1.2
55;2021-02-17;26;388;7197;2486;4.0;1.4
55;2021-02-18;20;258;7217;2744;4.0;1.5
55;2021-02-19;125;245;7342;2989;4.0;1.6
55;2021-02-20;11;0;7353;2989;4.0;1.6
55;2021-02-21;0;0;7353;2989;4.0;1.6
55;2021-02-22;55;365;7408;3354;4.1;1.8
55;2021-02-23;85;366;7493;3720;4.1;2.0
55;2021-02-24;72;347;7565;4067;4.2;2.2
55;2021-02-25;270;621;7835;4688;4.3;2.6
55;2021-02-26;324;205;8159;4893;4.5;2.7
55;2021-02-27;125;85;8284;4978;4.6;2.7
55;2021-02-28;2;8;8286;4986;4.6;2.7
55;2021-03-01;77;118;8363;5104;4.6;2.8
55;2021-03-02;125;136;8488;5240;4.7;2.9
55;2021-03-03;198;3;8686;5243;4.8;2.9
55;2021-03-04;238;40;8924;5283;4.9;2.9
55;2021-03-05;362;43;9286;5326;5.1;2.9
55;2021-03-06;224;6;9510;5332;5.2;2.9
55;2021-03-07;74;1;9584;5333;5.3;2.9
55;2021-03-08;329;49;9913;5382;5.5;3.0
55;2021-03-09;635;48;10548;5430;5.8;3.0
55;2021-03-10;397;24;10945;5454;6.0;3.0
55;2021-03-11;597;139;11542;5593;6.4;3.1
55;2021-03-12;816;89;12358;5682;6.8;3.1
55;2021-03-13;522;12;12880;5694;7.1;3.1
55;2021-03-14;14;0;12894;5694;7.1;3.1
55;2021-03-15;393;23;13287;5717;7.3;3.1
55;2021-03-16;568;105;13855;5822;7.6;3.2
55;2021-03-17;683;21;14538;5843;8.0;3.2
55;2021-03-18;323;23;14861;5866;8.2;3.2
55;2021-03-19;471;59;15332;5925;8.4;3.3
55;2021-03-20;254;15;15586;5940;8.6;3.3
55;2021-03-21;1;1;15587;5941;8.6;3.3
55;2021-03-22;474;20;16061;5961;8.8;3.3
55;2021-03-23;972;65;17033;6026;9.4;3.3
55;2021-03-24;802;43;17835;6069;9.8;3.3
55;2021-03-25;1097;81;18932;6150;10.4;3.4
55;2021-03-26;602;36;19534;6186;10.8;3.4
55;2021-03-27;256;23;19790;6209;10.9;3.4
55;2021-03-28;0;0;19790;6209;10.9;3.4
55;2021-03-29;944;41;20734;6250;11.4;3.4
55;2021-03-30;1425;73;22159;6323;12.2;3.5
55;2021-03-31;1483;70;23642;6393;13.0;3.5
55;2021-04-01;1207;129;24849;6522;13.7;3.6
55;2021-04-02;902;69;25751;6591;14.2;3.6
55;2021-04-03;93;12;25844;6603;14.2;3.6
55;2021-04-04;2;0;25846;6603;14.2;3.6
55;2021-04-05;6;12;25852;6615;14.2;3.6
55;2021-04-06;933;276;26785;6891;14.7;3.8
55;2021-04-07;993;240;27778;7131;15.3;3.9
55;2021-04-08;1649;420;29427;7551;16.2;4.2
55;2021-04-09;1431;262;30858;7813;17.0;4.3
55;2021-04-10;243;175;31101;7988;17.1;4.4
55;2021-04-11;452;22;31553;8010;17.4;4.4
55;2021-04-12;855;328;32408;8338;17.8;4.6
55;2021-04-13;1355;526;33763;8864;18.6;4.9
55;2021-04-14;1372;726;35135;9590;19.3;5.3
55;2021-04-15;1637;458;36772;10048;20.2;5.5
55;2021-04-16;704;379;37476;10427;20.6;5.7
55;2021-04-17;677;31;38153;10458;21.0;5.8
55;2021-04-18;38;18;38191;10476;21.0;5.8
55;2021-04-19;961;346;39152;10822;21.6;6.0
55;2021-04-20;1173;772;40325;11594;22.2;6.4
55;2021-04-21;990;640;41315;12234;22.7;6.7
55;2021-04-22;1099;674;42414;12908;23.4;7.1
55;2021-04-23;1424;598;43838;13506;24.1;7.4
55;2021-04-24;313;124;44151;13630;24.3;7.5
55;2021-04-25;384;51;44535;13681;24.5;7.5
55;2021-04-26;478;815;45013;14496;24.8;8.0
55;2021-04-27;570;994;45583;15490;25.1;8.5
55;2021-04-28;931;815;46514;16305;25.6;9.0
55;2021-04-29;1118;857;47632;17162;26.2;9.4
55;2021-04-30;1280;620;48912;17782;26.9;9.8
55;2021-05-01;153;131;49065;17913;27.0;9.9
55;2021-05-02;2;3;49067;17916;27.0;9.9
55;2021-05-03;1209;629;50276;18545;27.7;10.2
55;2021-05-04;683;1178;50959;19723;28.1;10.9
55;2021-05-05;656;1070;51615;20793;28.4;11.4
55;2021-05-06;1350;1157;52965;21950;29.2;12.1
55;2021-05-07;1433;554;54398;22504;29.9;12.4
55;2021-05-08;156;77;54554;22581;30.0;12.4
55;2021-05-09;62;522;54616;23103;30.1;12.7
55;2021-05-10;860;1029;55476;24132;30.5;13.3
55;2021-05-11;1072;1372;56548;25504;31.1;14.0
55;2021-05-12;1031;1760;57579;27264;31.7;15.0
55;2021-05-13;99;75;57678;27339;31.8;15.1
55;2021-05-14;352;555;58030;27894;31.9;15.4
55;2021-05-15;291;486;58321;28380;32.1;15.6
55;2021-05-16;3;10;58324;28390;32.1;15.6
55;2021-05-17;1028;841;59352;29231;32.7;16.1
55;2021-05-18;1567;886;60919;30117;33.5;16.6
55;2021-05-19;1809;777;62728;30894;34.5;17.0
55;2021-05-20;2215;730;64943;31624;35.8;17.4
55;2021-05-21;2010;799;66953;32423;36.9;17.9
55;2021-05-22;198;167;67151;32590;37.0;17.9
55;2021-05-23;23;120;67174;32710;37.0;18.0
55;2021-05-24;0;0;67174;32710;37.0;18.0
55;2021-05-25;1347;651;68521;33361;37.7;18.4
55;2021-05-26;1675;1017;70196;34378;38.6;18.9
55;2021-05-27;1322;982;71518;35360;39.4;19.5
55;2021-05-28;1521;928;73039;36288;40.2;20.0
55;2021-05-29;1403;695;74442;36983;41.0;20.4
55;2021-05-30;15;205;74457;37188;41.0;20.5
55;2021-05-31;1048;1130;75505;38318;41.6;21.1
55;2021-06-01;919;955;76424;39273;42.1;21.6
55;2021-06-02;1162;979;77586;40252;42.7;22.2
55;2021-06-03;703;538;78289;40790;43.1;22.5
55;2021-06-04;1388;1098;79677;41888;43.9;23.1
55;2021-06-05;1366;278;81043;42166;44.6;23.2
55;2021-06-06;0;2;81043;42168;44.6;23.2
55;2021-06-07;791;714;81834;42882;45.1;23.6
55;2021-06-08;700;1073;82534;43955;45.4;24.2
55;2021-06-09;852;868;83386;44823;45.9;24.7
55;2021-06-10;378;275;83764;45098;46.1;24.8
55;2021-06-11;528;1285;84292;46383;46.4;25.5
55;2021-06-12;761;518;85053;46901;46.8;25.8
55;2021-06-13;265;33;85318;46934;47.0;25.8
55;2021-06-14;391;1362;85709;48296;47.2;26.6
55;2021-06-15;574;1212;86283;49508;47.5;27.3
55;2021-06-16;735;832;87018;50340;47.9;27.7
55;2021-06-17;425;858;87443;51198;48.1;28.2
55;2021-06-18;667;1473;88110;52671;48.5;29.0
55;2021-06-19;593;454;88703;53125;48.8;29.2
55;2021-06-20;0;0;88703;53125;48.8;29.2
55;2021-06-21;441;1023;89144;54148;49.1;29.8
55;2021-06-22;335;1012;89479;55160;49.3;30.4
55;2021-06-23;626;1209;90105;56369;49.6;31.0
55;2021-06-24;163;433;90268;56802;49.7;31.3
55;2021-06-25;642;1227;90910;58029;50.0;31.9
55;2021-06-26;418;341;91328;58370;50.3;32.1
55;2021-06-27;1;2;91329;58372;50.3;32.1
55;2021-06-28;149;1379;91478;59751;50.4;32.9
55;2021-06-29;201;1287;91679;61038;50.5;33.6
55;2021-06-30;272;1927;91951;62965;50.6;34.7
55;2021-07-01;388;1977;92339;64942;50.8;35.8
55;2021-07-02;392;1719;92731;66661;51.1;36.7
55;2021-07-03;107;262;92838;66923;51.1;36.8
55;2021-07-04;12;19;92850;66942;51.1;36.9
55;2021-07-05;222;1508;93072;68450;51.2;37.7
55;2021-07-06;327;898;93399;69348;51.4;38.2
55;2021-07-07;388;1801;93787;71149;51.6;39.2
55;2021-07-08;534;1594;94321;72743;51.9;40.0
55;2021-07-09;456;1478;94777;74221;52.2;40.9
55;2021-07-10;356;1112;95133;75333;52.4;41.5
55;2021-07-11;0;9;95133;75342;52.4;41.5
55;2021-07-12;608;1166;95741;76508;52.7;42.1
55;2021-07-13;599;1487;96340;77995;53.0;42.9
55;2021-07-14;1;13;96341;78008;53.0;42.9
55;2021-07-15;782;1645;97123;79653;53.5;43.9
55;2021-07-16;1255;1807;98378;81460;54.2;44.8
55;2021-07-17;1283;821;99661;82281;54.9;45.3
55;2021-07-18;1;2;99662;82283;54.9;45.3
55;2021-07-19;597;785;100259;83068;55.2;45.7
55;2021-07-20;1001;1020;101260;84088;55.7;46.3
55;2021-07-21;1482;1370;102742;85458;56.6;47.0
55;2021-07-22;1174;565;103916;86023;57.2;47.4
55;2021-07-23;1113;1354;105029;87377;57.8;48.1
55;2021-07-24;819;760;105848;88137;58.3;48.5
55;2021-07-25;120;229;105968;88366;58.3;48.6
55;2021-07-26;668;444;106636;88810;58.7;48.9
55;2021-07-27;1166;479;107802;89289;59.3;49.2
55;2021-07-28;1039;1063;108841;90352;59.9;49.7
55;2021-07-29;670;446;109511;90798;60.3;50.0
55;2021-07-30;1272;966;110783;91764;61.0;50.5
55;2021-07-31;714;613;111497;92377;61.4;50.9
55;2021-08-01;9;5;111506;92382;61.4;50.9
55;2021-08-02;820;443;112326;92825;61.8;51.1
55;2021-08-03;792;417;113118;93242;62.3;51.3
55;2021-08-04;1248;950;114366;94192;63.0;51.9
55;2021-08-05;1055;324;115421;94516;63.5;52.0
55;2021-08-06;819;1095;116240;95611;64.0;52.6
55;2021-08-07;596;336;116836;95947;64.3;52.8
55;2021-08-08;0;0;116836;95947;64.3;52.8
55;2021-08-09;402;306;117238;96253;64.5;53.0
55;2021-08-10;447;776;117685;97029;64.8;53.4
55;2021-08-11;595;640;118280;97669;65.1;53.8
55;2021-08-12;327;489;118607;98158;65.3;54.0
55;2021-08-13;439;1110;119046;99268;65.5;54.7
55;2021-08-14;144;190;119190;99458;65.6;54.8
55;2021-08-15;11;5;119201;99463;65.6;54.8
55;2021-08-16;246;739;119447;100202;65.8;55.2
55;2021-08-17;259;289;119706;100491;65.9;55.3
55;2021-08-18;547;1241;120253;101732;66.2;56.0
55;2021-08-19;450;960;120703;102692;66.5;56.5
55;2021-08-20;623;1012;121326;103704;66.8;57.1
55;2021-08-21;292;772;121618;104476;67.0;57.5
55;2021-08-22;8;6;121626;104482;67.0;57.5
55;2021-08-23;357;612;121983;105094;67.2;57.9
55;2021-08-24;338;833;122321;105927;67.3;58.3
55;2021-08-25;678;1173;122999;107100;67.7;59.0
55;2021-08-26;473;1253;123472;108353;68.0;59.7
55;2021-08-27;335;1247;123807;109600;68.2;60.3
55;2021-08-28;388;578;124195;110178;68.4;60.7
55;2021-08-29;216;59;124411;110237;68.5;60.7
55;2021-08-30;135;677;124546;110914;68.6;61.1
55;2021-08-31;285;824;124831;111738;68.7;61.5
55;2021-09-01;699;1269;125530;113007;69.1;62.2
55;2021-09-02;208;896;125738;113903;69.2;62.7
55;2021-09-03;408;1275;126146;115178;69.4;63.4
55;2021-09-04;289;601;126435;115779;69.6;63.7
55;2021-09-05;18;91;126453;115870;69.6;63.8
55;2021-09-06;60;127;126513;115997;69.7;63.9
55;2021-09-07;283;595;126796;116592;69.8;64.2
55;2021-09-08;275;339;127071;116931;70.0;64.4
55;2021-09-09;198;595;127269;117526;70.1;64.7
55;2021-09-10;254;550;127523;118076;70.2;65.0
55;2021-09-11;97;319;127620;118395;70.3;65.2
55;2021-09-12;1;2;127621;118397;70.3;65.2
55;2021-09-13;98;431;127719;118828;70.3;65.4
55;2021-09-14;231;284;127950;119112;70.4;65.6
55;2021-09-15;293;637;128243;119749;70.6;65.9
55;2021-09-16;96;181;128339;119930;70.7;66.0
55;2021-09-17;87;123;128426;120053;70.7;66.1
55;2021-09-18;138;391;128564;120444;70.8;66.3
55;2021-09-19;1;59;128565;120503;70.8;66.3
55;2021-09-20;65;193;128630;120696;70.8;66.4
55;2021-09-21;100;332;128730;121028;70.9;66.6
55;2021-09-22;109;395;128839;121423;70.9;66.8
55;2021-09-23;95;427;128934;121850;71.0;67.1
55;2021-09-24;88;370;129022;122220;71.0;67.3
55;2021-09-25;56;159;129078;122379;71.1;67.4
55;2021-09-26;0;34;129078;122413;71.1;67.4
55;2021-09-27;46;127;129124;122540;71.1;67.5
55;2021-09-28;51;124;129175;122664;71.1;67.5
55;2021-09-29;157;861;129332;123525;71.2;68.0
55;2021-09-30;58;331;129390;123856;71.2;68.2
55;2021-10-01;56;272;129446;124128;71.3;68.3
55;2021-10-02;90;371;129536;124499;71.3;68.5
55;2021-10-03;0;59;129536;124558;71.3;68.6
55;2021-10-04;105;389;129641;124947;71.4;68.8
55;2021-10-05;71;259;129712;125206;71.4;68.9
55;2021-10-06;101;378;129813;125584;71.5;69.1
56;2020-12-27;0;0;0;0;0.0;0.0
56;2020-12-28;1;0;1;0;0.0;0.0
56;2020-12-29;0;0;1;0;0.0;0.0
56;2020-12-30;0;0;1;0;0.0;0.0
56;2020-12-31;0;0;1;0;0.0;0.0
56;2021-01-01;0;0;1;0;0.0;0.0
56;2021-01-02;1;0;2;0;0.0;0.0
56;2021-01-03;2;0;4;0;0.0;0.0
56;2021-01-04;2;0;6;0;0.0;0.0
56;2021-01-05;1;0;7;0;0.0;0.0
56;2021-01-06;2;0;9;0;0.0;0.0
56;2021-01-07;198;0;207;0;0.0;0.0
56;2021-01-08;119;0;326;0;0.0;0.0
56;2021-01-09;1;0;327;0;0.0;0.0
56;2021-01-10;1;0;328;0;0.0;0.0
56;2021-01-11;242;0;570;0;0.1;0.0
56;2021-01-12;755;1;1325;1;0.2;0.0
56;2021-01-13;638;1;1963;2;0.3;0.0
56;2021-01-14;970;2;2933;4;0.4;0.0
56;2021-01-15;844;5;3777;9;0.5;0.0
56;2021-01-16;235;3;4012;12;0.5;0.0
56;2021-01-17;27;0;4039;12;0.5;0.0
56;2021-01-18;1006;1;5045;13;0.7;0.0
56;2021-01-19;866;0;5911;13;0.8;0.0
56;2021-01-20;885;1;6796;14;0.9;0.0
56;2021-01-21;1450;1;8246;15;1.1;0.0
56;2021-01-22;1183;3;9429;18;1.2;0.0
56;2021-01-23;319;2;9748;20;1.3;0.0
56;2021-01-24;6;0;9754;20;1.3;0.0
56;2021-01-25;830;0;10584;20;1.4;0.0
56;2021-01-26;1034;4;11618;24;1.5;0.0
56;2021-01-27;1081;59;12699;83;1.7;0.0
56;2021-01-28;975;119;13674;202;1.8;0.0
56;2021-01-29;875;100;14549;302;1.9;0.0
56;2021-01-30;139;18;14688;320;1.9;0.0
56;2021-01-31;0;0;14688;320;1.9;0.0
56;2021-02-01;480;113;15168;433;2.0;0.1
56;2021-02-02;941;246;16109;679;2.1;0.1
56;2021-02-03;1025;254;17134;933;2.3;0.1
56;2021-02-04;4702;332;21836;1265;2.9;0.2
56;2021-02-05;3595;418;25431;1683;3.4;0.2
56;2021-02-06;551;162;25982;1845;3.4;0.2
56;2021-02-07;136;26;26118;1871;3.5;0.2
56;2021-02-08;297;257;26415;2128;3.5;0.3
56;2021-02-09;795;406;27210;2534;3.6;0.3
56;2021-02-10;864;637;28074;3171;3.7;0.4
56;2021-02-11;973;999;29047;4170;3.8;0.6
56;2021-02-12;1153;567;30200;4737;4.0;0.6
56;2021-02-13;220;76;30420;4813;4.0;0.6
56;2021-02-14;6;45;30426;4858;4.0;0.6
56;2021-02-15;623;835;31049;5693;4.1;0.8
56;2021-02-16;1219;586;32268;6279;4.3;0.8
56;2021-02-17;1189;771;33457;7050;4.4;0.9
56;2021-02-18;1351;707;34808;7757;4.6;1.0
56;2021-02-19;1323;706;36131;8463;4.8;1.1
56;2021-02-20;365;193;36496;8656;4.8;1.1
56;2021-02-21;2;0;36498;8656;4.8;1.1
56;2021-02-22;376;581;36874;9237;4.9;1.2
56;2021-02-23;742;737;37616;9974;5.0;1.3
56;2021-02-24;918;907;38534;10881;5.1;1.4
56;2021-02-25;2032;3831;40566;14712;5.4;1.9
56;2021-02-26;2356;2100;42922;16812;5.7;2.2
56;2021-02-27;748;366;43670;17178;5.8;2.3
56;2021-02-28;15;112;43685;17290;5.8;2.3
56;2021-03-01;649;449;44334;17739;5.9;2.3
56;2021-03-02;980;655;45314;18394;6.0;2.4
56;2021-03-03;1150;765;46464;19159;6.1;2.5
56;2021-03-04;1965;925;48429;20084;6.4;2.7
56;2021-03-05;2584;1322;51013;21406;6.8;2.8
56;2021-03-06;1209;193;52222;21599;6.9;2.9
56;2021-03-07;282;24;52504;21623;6.9;2.9
56;2021-03-08;1141;349;53645;21972;7.1;2.9
56;2021-03-09;2042;541;55687;22513;7.4;3.0
56;2021-03-10;2000;850;57687;23363;7.6;3.1
56;2021-03-11;3251;695;60938;24058;8.1;3.2
56;2021-03-12;4208;774;65146;24832;8.6;3.3
56;2021-03-13;1885;146;67031;24978;8.9;3.3
56;2021-03-14;195;4;67226;24982;8.9;3.3
56;2021-03-15;1285;521;68511;25503;9.1;3.4
56;2021-03-16;1088;998;69599;26501;9.2;3.5
56;2021-03-17;1371;757;70970;27258;9.4;3.6
56;2021-03-18;2001;1840;72971;29098;9.7;3.9
56;2021-03-19;2947;1366;75918;30464;10.0;4.0
56;2021-03-20;1492;202;77410;30666;10.2;4.1
56;2021-03-21;209;22;77619;30688;10.3;4.1
56;2021-03-22;1612;400;79231;31088;10.5;4.1
56;2021-03-23;2810;677;82041;31765;10.9;4.2
56;2021-03-24;3450;520;85491;32285;11.3;4.3
56;2021-03-25;4238;715;89729;33000;11.9;4.4
56;2021-03-26;5092;762;94821;33762;12.5;4.5
56;2021-03-27;1502;288;96323;34050;12.7;4.5
56;2021-03-28;264;11;96587;34061;12.8;4.5
56;2021-03-29;2236;501;98823;34562;13.1;4.6
56;2021-03-30;3519;785;102342;35347;13.5;4.7
56;2021-03-31;3116;719;105458;36066;14.0;4.8
56;2021-04-01;4079;818;109537;36884;14.5;4.9
56;2021-04-02;3925;945;113462;37829;15.0;5.0
56;2021-04-03;1186;270;114648;38099;15.2;5.0
56;2021-04-04;233;4;114881;38103;15.2;5.0
56;2021-04-05;244;8;115125;38111;15.2;5.0
56;2021-04-06;2828;1233;117953;39344;15.6;5.2
56;2021-04-07;4023;1193;121976;40537;16.1;5.4
56;2021-04-08;5295;1164;127271;41701;16.8;5.5
56;2021-04-09;7396;1281;134667;42982;17.8;5.7
56;2021-04-10;2576;428;137243;43410;18.2;5.7
56;2021-04-11;194;101;137437;43511;18.2;5.8
56;2021-04-12;3932;832;141369;44343;18.7;5.9
56;2021-04-13;5965;1263;147334;45606;19.5;6.0
56;2021-04-14;5168;1433;152502;47039;20.2;6.2
56;2021-04-15;7153;1775;159655;48814;21.1;6.5
56;2021-04-16;7842;2012;167497;50826;22.2;6.7
56;2021-04-17;3130;648;170627;51474;22.6;6.8
56;2021-04-18;528;110;171155;51584;22.7;6.8
56;2021-04-19;3719;1261;174874;52845;23.1;7.0
56;2021-04-20;4107;1975;178981;54820;23.7;7.3
56;2021-04-21;4059;2321;183040;57141;24.2;7.6
56;2021-04-22;5173;1919;188213;59060;24.9;7.8
56;2021-04-23;5172;2414;193385;61474;25.6;8.1
56;2021-04-24;2899;639;196284;62113;26.0;8.2
56;2021-04-25;465;149;196749;62262;26.0;8.2
56;2021-04-26;4710;1658;201459;63920;26.7;8.5
56;2021-04-27;5097;2538;206556;66458;27.3;8.8
56;2021-04-28;4966;2243;211522;68701;28.0;9.1
56;2021-04-29;5842;2925;217364;71626;28.8;9.5
56;2021-04-30;6246;2786;223610;74412;29.6;9.8
56;2021-05-01;2489;363;226099;74775;29.9;9.9
56;2021-05-02;307;254;226406;75029;30.0;9.9
56;2021-05-03;3863;2050;230269;77079;30.5;10.2
56;2021-05-04;4379;3899;234648;80978;31.1;10.7
56;2021-05-05;3522;3871;238170;84849;31.5;11.2
56;2021-05-06;4377;5431;242547;90280;32.1;11.9
56;2021-05-07;4267;4991;246814;95271;32.7;12.6
56;2021-05-08;1645;320;248459;95591;32.9;12.7
56;2021-05-09;494;227;248953;95818;32.9;12.7
56;2021-05-10;3751;3802;252704;99620;33.4;13.2
56;2021-05-11;4169;5041;256873;104661;34.0;13.9
56;2021-05-12;4342;4771;261215;109432;34.6;14.5
56;2021-05-13;2397;1014;263612;110446;34.9;14.6
56;2021-05-14;4227;4347;267839;114793;35.4;15.2
56;2021-05-15;2488;1895;270327;116688;35.8;15.4
56;2021-05-16;237;488;270564;117176;35.8;15.5
56;2021-05-17;2513;3664;273077;120840;36.1;16.0
56;2021-05-18;3522;4092;276599;124932;36.6;16.5
56;2021-05-19;3527;3391;280126;128323;37.1;17.0
56;2021-05-20;3805;4808;283931;133131;37.6;17.6
56;2021-05-21;3748;5218;287679;138349;38.1;18.3
56;2021-05-22;1697;2207;289376;140556;38.3;18.6
56;2021-05-23;284;197;289660;140753;38.3;18.6
56;2021-05-24;2058;497;291718;141250;38.6;18.7
56;2021-05-25;3141;4471;294859;145721;39.0;19.3
56;2021-05-26;3735;3933;298594;149654;39.5;19.8
56;2021-05-27;4362;4863;302956;154517;40.1;20.5
56;2021-05-28;4638;5938;307594;160455;40.7;21.2
56;2021-05-29;1886;1632;309480;162087;41.0;21.5
56;2021-05-30;318;67;309798;162154;41.0;21.5
56;2021-05-31;4502;3212;314300;165366;41.6;21.9
56;2021-06-01;5664;3379;319964;168745;42.3;22.3
56;2021-06-02;5631;2946;325595;171691;43.1;22.7
56;2021-06-03;6189;3292;331784;174983;43.9;23.2
56;2021-06-04;5813;4401;337597;179384;44.7;23.7
56;2021-06-05;4346;2372;341943;181756;45.3;24.1
56;2021-06-06;496;615;342439;182371;45.3;24.1
56;2021-06-07;5101;3167;347540;185538;46.0;24.6
56;2021-06-08;6070;3365;353610;188903;46.8;25.0
56;2021-06-09;6429;2811;360039;191714;47.7;25.4
56;2021-06-10;7478;2873;367517;194587;48.6;25.8
56;2021-06-11;6768;3864;374285;198451;49.5;26.3
56;2021-06-12;5103;2062;379388;200513;50.2;26.5
56;2021-06-13;1978;439;381366;200952;50.5;26.6
56;2021-06-14;3313;4589;384679;205541;50.9;27.2
56;2021-06-15;4201;4878;388880;210419;51.5;27.8
56;2021-06-16;4495;4501;393375;214920;52.1;28.4
56;2021-06-17;4257;4748;397632;219668;52.6;29.1
56;2021-06-18;4513;5967;402145;225635;53.2;29.9
56;2021-06-19;3832;2144;405977;227779;53.7;30.1
56;2021-06-20;1503;340;407480;228119;53.9;30.2
56;2021-06-21;3306;4461;410786;232580;54.4;30.8
56;2021-06-22;3483;5433;414269;238013;54.8;31.5
56;2021-06-23;3763;5061;418032;243074;55.3;32.2
56;2021-06-24;3478;5318;421510;248392;55.8;32.9
56;2021-06-25;3884;6280;425394;254672;56.3;33.7
56;2021-06-26;3202;2915;428596;257587;56.7;34.1
56;2021-06-27;305;163;428901;257750;56.8;34.1
56;2021-06-28;1575;3982;430476;261732;57.0;34.6
56;2021-06-29;2433;5761;432909;267493;57.3;35.4
56;2021-06-30;2499;5560;435408;273053;57.6;36.1
56;2021-07-01;2735;4956;438143;278009;58.0;36.8
56;2021-07-02;2656;6201;440799;284210;58.3;37.6
56;2021-07-03;2203;2677;443002;286887;58.6;38.0
56;2021-07-04;778;811;443780;287698;58.7;38.1
56;2021-07-05;1872;5442;445652;293140;59.0;38.8
56;2021-07-06;2190;5931;447842;299071;59.3;39.6
56;2021-07-07;2844;5642;450686;304713;59.6;40.3
56;2021-07-08;3086;6035;453772;310748;60.1;41.1
56;2021-07-09;2213;7097;455985;317845;60.4;42.1
56;2021-07-10;1126;3000;457111;320845;60.5;42.5
56;2021-07-11;256;344;457367;321189;60.5;42.5
56;2021-07-12;2181;6605;459548;327794;60.8;43.4
56;2021-07-13;3259;7466;462807;335260;61.3;44.4
56;2021-07-14;1785;2591;464592;337851;61.5;44.7
56;2021-07-15;3820;7068;468412;344919;62.0;45.7
56;2021-07-16;4076;8083;472488;353002;62.5;46.7
56;2021-07-17;2320;3525;474808;356527;62.8;47.2
56;2021-07-18;256;478;475064;357005;62.9;47.3
56;2021-07-19;2868;6357;477932;363362;63.3;48.1
56;2021-07-20;3722;7910;481654;371272;63.7;49.1
56;2021-07-21;3095;7516;484749;378788;64.2;50.1
56;2021-07-22;4391;8027;489140;386815;64.7;51.2
56;2021-07-23;4389;8407;493529;395222;65.3;52.3
56;2021-07-24;1687;4600;495216;399822;65.5;52.9
56;2021-07-25;551;1916;495767;401738;65.6;53.2
56;2021-07-26;3680;5451;499447;407189;66.1;53.9
56;2021-07-27;5375;6194;504822;413383;66.8;54.7
56;2021-07-28;4688;5463;509510;418846;67.4;55.4
56;2021-07-29;5378;5627;514888;424473;68.1;56.2
56;2021-07-30;5383;5863;520271;430336;68.9;57.0
56;2021-07-31;2157;2690;522428;433026;69.1;57.3
56;2021-08-01;1254;977;523682;434003;69.3;57.4
56;2021-08-02;4535;4598;528217;438601;69.9;58.0
56;2021-08-03;6384;4957;534601;443558;70.8;58.7
56;2021-08-04;5953;4363;540554;447921;71.5;59.3
56;2021-08-05;6097;4605;546651;452526;72.3;59.9
56;2021-08-06;5855;4926;552506;457452;73.1;60.5
56;2021-08-07;2859;2228;555365;459680;73.5;60.8
56;2021-08-08;1830;566;557195;460246;73.7;60.9
56;2021-08-09;3936;4267;561131;464513;74.3;61.5
56;2021-08-10;4927;4612;566058;469125;74.9;62.1
56;2021-08-11;4565;4137;570623;473262;75.5;62.6
56;2021-08-12;4488;4547;575111;477809;76.1;63.2
56;2021-08-13;4214;4814;579325;482623;76.7;63.9
56;2021-08-14;1792;2136;581117;484759;76.9;64.2
56;2021-08-15;348;485;581465;485244;77.0;64.2
56;2021-08-16;3065;4521;584530;489765;77.4;64.8
56;2021-08-17;3761;5055;588291;494820;77.9;65.5
56;2021-08-18;3738;4609;592029;499429;78.4;66.1
56;2021-08-19;3069;4992;595098;504421;78.8;66.8
56;2021-08-20;2903;5260;598001;509681;79.1;67.5
56;2021-08-21;1159;2399;599160;512080;79.3;67.8
56;2021-08-22;129;503;599289;512583;79.3;67.8
56;2021-08-23;1930;4969;601219;517552;79.6;68.5
56;2021-08-24;1924;5513;603143;523065;79.8;69.2
56;2021-08-25;1710;5056;604853;528121;80.1;69.9
56;2021-08-26;1409;5326;606262;533447;80.2;70.6
56;2021-08-27;1753;5878;608015;539325;80.5;71.4
56;2021-08-28;604;2802;608619;542127;80.6;71.8
56;2021-08-29;79;476;608698;542603;80.6;71.8
56;2021-08-30;1381;4746;610079;547349;80.7;72.4
56;2021-08-31;1473;4793;611552;552142;80.9;73.1
56;2021-09-01;1319;4198;612871;556340;81.1;73.6
56;2021-09-02;1081;4037;613952;560377;81.3;74.2
56;2021-09-03;1101;4597;615053;564974;81.4;74.8
56;2021-09-04;766;2445;615819;567419;81.5;75.1
56;2021-09-05;128;371;615947;567790;81.5;75.1
56;2021-09-06;885;3623;616832;571413;81.6;75.6
56;2021-09-07;818;3471;617650;574884;81.7;76.1
56;2021-09-08;966;3468;618616;578352;81.9;76.5
56;2021-09-09;797;3023;619413;581375;82.0;76.9
56;2021-09-10;938;3489;620351;584864;82.1;77.4
56;2021-09-11;474;2109;620825;586973;82.2;77.7
56;2021-09-12;34;171;620859;587144;82.2;77.7
56;2021-09-13;761;2677;621620;589821;82.3;78.1
56;2021-09-14;697;2777;622317;592598;82.4;78.4
56;2021-09-15;711;2499;623028;595097;82.5;78.8
56;2021-09-16;702;1591;623730;596688;82.6;79.0
56;2021-09-17;756;2148;624486;598836;82.7;79.3
56;2021-09-18;305;1706;624791;600542;82.7;79.5
56;2021-09-19;32;112;624823;600654;82.7;79.5
56;2021-09-20;426;1288;625249;601942;82.8;79.7
56;2021-09-21;500;1165;625749;603107;82.8;79.8
56;2021-09-22;464;1704;626213;604811;82.9;80.0
56;2021-09-23;543;1048;626756;605859;83.0;80.2
56;2021-09-24;580;1613;627336;607472;83.0;80.4
56;2021-09-25;256;1029;627592;608501;83.1;80.5
56;2021-09-26;12;79;627604;608580;83.1;80.5
56;2021-09-27;475;1000;628079;609580;83.1;80.7
56;2021-09-28;436;958;628515;610538;83.2;80.8
56;2021-09-29;386;1168;628901;611706;83.2;81.0
56;2021-09-30;331;606;629232;612312;83.3;81.0
56;2021-10-01;513;1256;629745;613568;83.3;81.2
56;2021-10-02;159;401;629904;613969;83.4;81.3
56;2021-10-03;5;77;629909;614046;83.4;81.3
56;2021-10-04;294;761;630203;614807;83.4;81.4
56;2021-10-05;237;619;630440;615426;83.4;81.5
56;2021-10-06;403;944;630843;616370;83.5;81.6
57;2020-12-27;2;0;2;0;0.0;0.0
57;2020-12-28;0;0;2;0;0.0;0.0
57;2020-12-29;2;0;4;0;0.0;0.0
57;2020-12-30;1;0;5;0;0.0;0.0
57;2020-12-31;0;0;5;0;0.0;0.0
57;2021-01-01;1;0;6;0;0.0;0.0
57;2021-01-02;3;0;9;0;0.0;0.0
57;2021-01-03;0;0;9;0;0.0;0.0
57;2021-01-04;17;0;26;0;0.0;0.0
57;2021-01-05;199;0;225;0;0.0;0.0
57;2021-01-06;226;1;451;1;0.0;0.0
57;2021-01-07;586;2;1037;3;0.1;0.0
57;2021-01-08;509;2;1546;5;0.1;0.0
57;2021-01-09;203;0;1749;5;0.2;0.0
57;2021-01-10;109;1;1858;6;0.2;0.0
57;2021-01-11;470;1;2328;7;0.2;0.0
57;2021-01-12;612;5;2940;12;0.3;0.0
57;2021-01-13;696;2;3636;14;0.4;0.0
57;2021-01-14;708;6;4344;20;0.4;0.0
57;2021-01-15;636;5;4980;25;0.5;0.0
57;2021-01-16;452;1;5432;26;0.5;0.0
57;2021-01-17;493;1;5925;27;0.6;0.0
57;2021-01-18;2715;20;8640;47;0.8;0.0
57;2021-01-19;2567;20;11207;67;1.1;0.0
57;2021-01-20;2770;17;13977;84;1.3;0.0
57;2021-01-21;1802;5;15779;89;1.5;0.0
57;2021-01-22;1325;6;17104;95;1.7;0.0
57;2021-01-23;543;15;17647;110;1.7;0.0
57;2021-01-24;1;0;17648;110;1.7;0.0
57;2021-01-25;869;174;18517;284;1.8;0.0
57;2021-01-26;1112;202;19629;486;1.9;0.0
57;2021-01-27;1070;160;20699;646;2.0;0.1
57;2021-01-28;1040;241;21739;887;2.1;0.1
57;2021-01-29;983;368;22722;1255;2.2;0.1
57;2021-01-30;440;82;23162;1337;2.2;0.1
57;2021-01-31;11;16;23173;1353;2.2;0.1
57;2021-02-01;828;321;24001;1674;2.3;0.2
57;2021-02-02;989;334;24990;2008;2.4;0.2
57;2021-02-03;986;294;25976;2302;2.5;0.2
57;2021-02-04;1138;773;27114;3075;2.6;0.3
57;2021-02-05;927;324;28041;3399;2.7;0.3
57;2021-02-06;482;308;28523;3707;2.8;0.4
57;2021-02-07;103;333;28626;4040;2.8;0.4
57;2021-02-08;1258;1395;29884;5435;2.9;0.5
57;2021-02-09;1763;1574;31647;7009;3.1;0.7
57;2021-02-10;1712;1957;33359;8966;3.2;0.9
57;2021-02-11;1488;1264;34847;10230;3.4;1.0
57;2021-02-12;1227;612;36074;10842;3.5;1.0
57;2021-02-13;1152;133;37226;10975;3.6;1.1
57;2021-02-14;1211;27;38437;11002;3.7;1.1
57;2021-02-15;766;698;39203;11700;3.8;1.1
57;2021-02-16;1076;655;40279;12355;3.9;1.2
57;2021-02-17;1008;790;41287;13145;4.0;1.3
57;2021-02-18;976;968;42263;14113;4.1;1.4
57;2021-02-19;956;730;43219;14843;4.2;1.4
57;2021-02-20;1172;487;44391;15330;4.3;1.5
57;2021-02-21;323;13;44714;15343;4.3;1.5
57;2021-02-22;1230;735;45944;16078;4.4;1.6
57;2021-02-23;2234;917;48178;16995;4.7;1.6
57;2021-02-24;2287;822;50465;17817;4.9;1.7
57;2021-02-25;3297;945;53762;18762;5.2;1.8
57;2021-02-26;3594;826;57356;19588;5.5;1.9
57;2021-02-27;3697;478;61053;20066;5.9;1.9
57;2021-02-28;1897;58;62950;20124;6.1;1.9
57;2021-03-01;2078;1202;65028;21326;6.3;2.1
57;2021-03-02;2861;1421;67889;22747;6.6;2.2
57;2021-03-03;2824;1464;70713;24211;6.8;2.3
57;2021-03-04;3285;1182;73998;25393;7.1;2.5
57;2021-03-05;4460;1140;78458;26533;7.6;2.6
57;2021-03-06;7256;696;85714;27229;8.3;2.6
57;2021-03-07;6070;256;91784;27485;8.9;2.7
57;2021-03-08;2300;909;94084;28394;9.1;2.7
57;2021-03-09;3390;1195;97474;29589;9.4;2.9
57;2021-03-10;3587;893;101061;30482;9.8;2.9
57;2021-03-11;4041;1175;105102;31657;10.1;3.1
57;2021-03-12;5114;1125;110216;32782;10.6;3.2
57;2021-03-13;6285;941;116501;33723;11.2;3.3
57;2021-03-14;2425;423;118926;34146;11.5;3.3
57;2021-03-15;2966;864;121892;35010;11.8;3.4
57;2021-03-16;3061;1276;124953;36286;12.1;3.5
57;2021-03-17;3050;1143;128003;37429;12.4;3.6
57;2021-03-18;3402;1062;131405;38491;12.7;3.7
57;2021-03-19;4626;1042;136031;39533;13.1;3.8
57;2021-03-20;4702;1025;140733;40558;13.6;3.9
57;2021-03-21;1895;250;142628;40808;13.8;3.9
57;2021-03-22;2479;1476;145107;42284;14.0;4.1
57;2021-03-23;3442;2340;148549;44624;14.3;4.3
57;2021-03-24;3898;2141;152447;46765;14.7;4.5
57;2021-03-25;4743;2590;157190;49355;15.2;4.8
57;2021-03-26;4841;2264;162031;51619;15.6;5.0
57;2021-03-27;3710;3140;165741;54759;16.0;5.3
57;2021-03-28;1398;1827;167139;56586;16.1;5.5
57;2021-03-29;1932;2178;169071;58764;16.3;5.7
57;2021-03-30;3299;2482;172370;61246;16.6;5.9
57;2021-03-31;2826;2295;175196;63541;16.9;6.1
57;2021-04-01;3223;3176;178419;66717;17.2;6.4
57;2021-04-02;2392;2573;180811;69290;17.5;6.7
57;2021-04-03;2565;2649;183376;71939;17.7;6.9
57;2021-04-04;596;968;183972;72907;17.8;7.0
57;2021-04-05;1922;674;185894;73581;17.9;7.1
57;2021-04-06;2451;2834;188345;76415;18.2;7.4
57;2021-04-07;3815;3097;192160;79512;18.6;7.7
57;2021-04-08;5613;2902;197773;82414;19.1;8.0
57;2021-04-09;5013;2730;202786;85144;19.6;8.2
57;2021-04-10;2353;3637;205139;88781;19.8;8.6
57;2021-04-11;1099;1890;206238;90671;19.9;8.8
57;2021-04-12;1795;2746;208033;93417;20.1;9.0
57;2021-04-13;1976;3022;210009;96439;20.3;9.3
57;2021-04-14;1922;2985;211931;99424;20.5;9.6
57;2021-04-15;2364;3425;214295;102849;20.7;9.9
57;2021-04-16;2700;3290;216995;106139;20.9;10.2
57;2021-04-17;2474;3179;219469;109318;21.2;10.6
57;2021-04-18;1241;1771;220710;111089;21.3;10.7
57;2021-04-19;2142;2257;222852;113346;21.5;10.9
57;2021-04-20;2513;2780;225365;116126;21.8;11.2
57;2021-04-21;2568;2379;227933;118505;22.0;11.4
57;2021-04-22;3208;2250;231141;120755;22.3;11.7
57;2021-04-23;4058;2575;235199;123330;22.7;11.9
57;2021-04-24;3396;2561;238595;125891;23.0;12.2
57;2021-04-25;757;1126;239352;127017;23.1;12.3
57;2021-04-26;2972;1992;242324;129009;23.4;12.5
57;2021-04-27;3898;2375;246222;131384;23.8;12.7
57;2021-04-28;4213;2589;250435;133973;24.2;12.9
57;2021-04-29;5260;3444;255695;137417;24.7;13.3
57;2021-04-30;4729;3530;260424;140947;25.1;13.6
57;2021-05-01;2356;1685;262780;142632;25.4;13.8
57;2021-05-02;790;912;263570;143544;25.4;13.9
57;2021-05-03;3561;2990;267131;146534;25.8;14.1
57;2021-05-04;4871;3161;272002;149695;26.3;14.5
57;2021-05-05;6123;3157;278125;152852;26.8;14.8
57;2021-05-06;5990;3271;284115;156123;27.4;15.1
57;2021-05-07;6852;3438;290967;159561;28.1;15.4
57;2021-05-08;4051;1605;295018;161166;28.5;15.6
57;2021-05-09;2048;1114;297066;162280;28.7;15.7
57;2021-05-10;5129;3063;302195;165343;29.2;16.0
57;2021-05-11;7452;2848;309647;168191;29.9;16.2
57;2021-05-12;7843;3242;317490;171433;30.6;16.5
57;2021-05-13;4509;915;321999;172348;31.1;16.6
57;2021-05-14;7839;2628;329838;174976;31.8;16.9
57;2021-05-15;5965;2045;335803;177021;32.4;17.1
57;2021-05-16;3307;578;339110;177599;32.7;17.1
57;2021-05-17;3867;2063;342977;179662;33.1;17.3
57;2021-05-18;6292;2104;349269;181766;33.7;17.5
57;2021-05-19;7019;2328;356288;184094;34.4;17.8
57;2021-05-20;6046;2172;362334;186266;35.0;18.0
57;2021-05-21;7564;2923;369898;189189;35.7;18.3
57;2021-05-22;4895;2171;374793;191360;36.2;18.5
57;2021-05-23;1964;430;376757;191790;36.4;18.5
57;2021-05-24;3027;1056;379784;192846;36.7;18.6
57;2021-05-25;5571;2804;385355;195650;37.2;18.9
57;2021-05-26;6374;3177;391729;198827;37.8;19.2
57;2021-05-27;5794;3120;397523;201947;38.4;19.5
57;2021-05-28;7024;4731;404547;206678;39.1;20.0
57;2021-05-29;5220;4243;409767;210921;39.6;20.4
57;2021-05-30;1968;1743;411735;212664;39.7;20.5
57;2021-05-31;4315;3339;416050;216003;40.2;20.9
57;2021-06-01;5934;3714;421984;219717;40.7;21.2
57;2021-06-02;6340;3898;428324;223615;41.3;21.6
57;2021-06-03;6209;3692;434533;227307;41.9;21.9
57;2021-06-04;7569;4991;442102;232298;42.7;22.4
57;2021-06-05;4764;4030;446866;236328;43.1;22.8
57;2021-06-06;1992;889;448858;237217;43.3;22.9
57;2021-06-07;4316;4034;453174;241251;43.7;23.3
57;2021-06-08;6721;4314;459895;245565;44.4;23.7
57;2021-06-09;6876;4154;466771;249719;45.1;24.1
57;2021-06-10;6218;4595;472989;254314;45.7;24.6
57;2021-06-11;5361;5363;478350;259677;46.2;25.1
57;2021-06-12;5741;4448;484091;264125;46.7;25.5
57;2021-06-13;1500;1142;485591;265267;46.9;25.6
57;2021-06-14;3381;4697;488972;269964;47.2;26.1
57;2021-06-15;3815;6023;492787;275987;47.6;26.6
57;2021-06-16;4400;6599;497187;282586;48.0;27.3
57;2021-06-17;4200;6072;501387;288658;48.4;27.9
57;2021-06-18;4273;7306;505660;295964;48.8;28.6
57;2021-06-19;4158;6291;509818;302255;49.2;29.2
57;2021-06-20;986;1665;510804;303920;49.3;29.3
57;2021-06-21;2065;5966;512869;309886;49.5;29.9
57;2021-06-22;2644;7986;515513;317872;49.8;30.7
57;2021-06-23;3071;8385;518584;326257;50.1;31.5
57;2021-06-24;2457;5284;521041;331541;50.3;32.0
57;2021-06-25;2856;7825;523897;339366;50.6;32.8
57;2021-06-26;2872;7255;526769;346621;50.9;33.5
57;2021-06-27;752;2985;527521;349606;50.9;33.8
57;2021-06-28;1591;5078;529112;354684;51.1;34.2
57;2021-06-29;2082;6830;531194;361514;51.3;34.9
57;2021-06-30;3067;7321;534261;368835;51.6;35.6
57;2021-07-01;2706;5957;536967;374792;51.8;36.2
57;2021-07-02;2697;8072;539664;382864;52.1;37.0
57;2021-07-03;3238;6528;542902;389392;52.4;37.6
57;2021-07-04;942;2467;543844;391859;52.5;37.8
57;2021-07-05;1713;4607;545557;396466;52.7;38.3
57;2021-07-06;2425;6480;547982;402946;52.9;38.9
57;2021-07-07;2732;7089;550714;410035;53.2;39.6
57;2021-07-08;2495;5875;553209;415910;53.4;40.2
57;2021-07-09;3424;8413;556633;424323;53.7;41.0
57;2021-07-10;3097;6941;559730;431264;54.0;41.6
57;2021-07-11;854;2233;560584;433497;54.1;41.8
57;2021-07-12;2441;6434;563025;439931;54.4;42.5
57;2021-07-13;4415;7505;567440;447436;54.8;43.2
57;2021-07-14;2823;3842;570263;451278;55.1;43.6
57;2021-07-15;3962;7790;574225;459068;55.4;44.3
57;2021-07-16;5642;9829;579867;468897;56.0;45.3
57;2021-07-17;5823;7281;585690;476178;56.5;46.0
57;2021-07-18;1491;2660;587181;478838;56.7;46.2
57;2021-07-19;2373;6201;589554;485039;56.9;46.8
57;2021-07-20;4331;6914;593885;491953;57.3;47.5
57;2021-07-21;5302;6906;599187;498859;57.8;48.2
57;2021-07-22;5982;5955;605169;504814;58.4;48.7
57;2021-07-23;7016;6406;612185;511220;59.1;49.4
57;2021-07-24;4537;7037;616722;518257;59.5;50.0
57;2021-07-25;1334;1770;618056;520027;59.7;50.2
57;2021-07-26;3724;4492;621780;524519;60.0;50.6
57;2021-07-27;6867;4953;628647;529472;60.7;51.1
57;2021-07-28;7487;4565;636134;534037;61.4;51.6
57;2021-07-29;7635;4600;643769;538637;62.1;52.0
57;2021-07-30;6873;4899;650642;543536;62.8;52.5
57;2021-07-31;5707;5022;656349;548558;63.4;53.0
57;2021-08-01;2027;1116;658376;549674;63.6;53.1
57;2021-08-02;3543;3181;661919;552855;63.9;53.4
57;2021-08-03;5804;4283;667723;557138;64.5;53.8
57;2021-08-04;5228;3461;672951;560599;65.0;54.1
57;2021-08-05;5375;3778;678326;564377;65.5;54.5
57;2021-08-06;5624;4852;683950;569229;66.0;55.0
57;2021-08-07;4586;5169;688536;574398;66.5;55.5
57;2021-08-08;1479;1508;690015;575906;66.6;55.6
57;2021-08-09;2623;3175;692638;579081;66.9;55.9
57;2021-08-10;3520;3787;696158;582868;67.2;56.3
57;2021-08-11;3724;4023;699882;586891;67.6;56.7
57;2021-08-12;3160;5217;703042;592108;67.9;57.2
57;2021-08-13;3497;4734;706539;596842;68.2;57.6
57;2021-08-14;2165;5186;708704;602028;68.4;58.1
57;2021-08-15;529;1093;709233;603121;68.5;58.2
57;2021-08-16;1790;3567;711023;606688;68.6;58.6
57;2021-08-17;2380;5355;713403;612043;68.9;59.1
57;2021-08-18;2472;5374;715875;617417;69.1;59.6
57;2021-08-19;2214;5486;718089;622903;69.3;60.1
57;2021-08-20;2058;6033;720147;628936;69.5;60.7
57;2021-08-21;1875;5395;722022;634331;69.7;61.2
57;2021-08-22;454;1530;722476;635861;69.7;61.4
57;2021-08-23;1144;3719;723620;639580;69.9;61.7
57;2021-08-24;1817;5614;725437;645194;70.0;62.3
57;2021-08-25;1618;5318;727055;650512;70.2;62.8
57;2021-08-26;1607;4674;728662;655186;70.3;63.3
57;2021-08-27;1768;5897;730430;661083;70.5;63.8
57;2021-08-28;2013;5385;732443;666468;70.7;64.3
57;2021-08-29;342;1090;732785;667558;70.7;64.4
57;2021-08-30;1032;3259;733817;670817;70.8;64.8
57;2021-08-31;1553;4425;735370;675242;71.0;65.2
57;2021-09-01;1460;4156;736830;679398;71.1;65.6
57;2021-09-02;1178;3401;738008;682799;71.2;65.9
57;2021-09-03;1567;4351;739575;687150;71.4;66.3
57;2021-09-04;1683;4004;741258;691154;71.6;66.7
57;2021-09-05;383;941;741641;692095;71.6;66.8
57;2021-09-06;771;2131;742412;694226;71.7;67.0
57;2021-09-07;698;2248;743110;696474;71.7;67.2
57;2021-09-08;925;2919;744035;699393;71.8;67.5
57;2021-09-09;602;2364;744637;701757;71.9;67.7
57;2021-09-10;1082;2973;745719;704730;72.0;68.0
57;2021-09-11;1179;3251;746898;707981;72.1;68.3
57;2021-09-12;246;548;747144;708529;72.1;68.4
57;2021-09-13;587;1791;747731;710320;72.2;68.6
57;2021-09-14;780;2344;748511;712664;72.3;68.8
57;2021-09-15;769;1994;749280;714658;72.3;69.0
57;2021-09-16;709;1227;749989;715885;72.4;69.1
57;2021-09-17;1107;1789;751096;717674;72.5;69.3
57;2021-09-18;805;2586;751901;720260;72.6;69.5
57;2021-09-19;119;346;752020;720606;72.6;69.6
57;2021-09-20;408;867;752428;721473;72.6;69.6
57;2021-09-21;500;827;752928;722300;72.7;69.7
57;2021-09-22;491;1306;753419;723606;72.7;69.9
57;2021-09-23;465;1213;753884;724819;72.8;70.0
57;2021-09-24;739;1433;754623;726252;72.8;70.1
57;2021-09-25;503;1997;755126;728249;72.9;70.3
57;2021-09-26;121;326;755247;728575;72.9;70.3
57;2021-09-27;440;844;755687;729419;73.0;70.4
57;2021-09-28;314;597;756001;730016;73.0;70.5
57;2021-09-29;554;1109;756555;731125;73.0;70.6
57;2021-09-30;289;615;756844;731740;73.1;70.6
57;2021-10-01;521;1326;757365;733066;73.1;70.8
57;2021-10-02;661;1561;758026;734627;73.2;70.9
57;2021-10-03;121;232;758147;734859;73.2;70.9
57;2021-10-04;363;617;758510;735476;73.2;71.0
57;2021-10-05;283;575;758793;736051;73.3;71.1
57;2021-10-06;454;768;759247;736819;73.3;71.1
58;2020-12-27;0;0;0;0;0.0;0.0
58;2020-12-28;0;0;0;0;0.0;0.0
58;2020-12-29;1;0;1;0;0.0;0.0
58;2020-12-30;0;0;1;0;0.0;0.0
58;2020-12-31;0;0;1;0;0.0;0.0
58;2021-01-01;0;0;1;0;0.0;0.0
58;2021-01-02;0;0;1;0;0.0;0.0
58;2021-01-03;1;0;2;0;0.0;0.0
58;2021-01-04;0;0;2;0;0.0;0.0
58;2021-01-05;2;0;4;0;0.0;0.0
58;2021-01-06;145;0;149;0;0.1;0.0
58;2021-01-07;241;0;390;0;0.2;0.0
58;2021-01-08;63;0;453;0;0.2;0.0
58;2021-01-09;1;0;454;0;0.2;0.0
58;2021-01-10;0;0;454;0;0.2;0.0
58;2021-01-11;54;0;508;0;0.3;0.0
58;2021-01-12;260;0;768;0;0.4;0.0
58;2021-01-13;412;3;1180;3;0.6;0.0
58;2021-01-14;292;1;1472;4;0.7;0.0
58;2021-01-15;142;0;1614;4;0.8;0.0
58;2021-01-16;10;1;1624;5;0.8;0.0
58;2021-01-17;0;0;1624;5;0.8;0.0
58;2021-01-18;413;1;2037;6;1.0;0.0
58;2021-01-19;987;2;3024;8;1.5;0.0
58;2021-01-20;1206;2;4230;10;2.1;0.0
58;2021-01-21;962;4;5192;14;2.6;0.0
58;2021-01-22;779;3;5971;17;3.0;0.0
58;2021-01-23;253;0;6224;17;3.1;0.0
58;2021-01-24;2;0;6226;17;3.1;0.0
58;2021-01-25;439;0;6665;17;3.3;0.0
58;2021-01-26;650;3;7315;20;3.7;0.0
58;2021-01-27;604;44;7919;64;4.0;0.0
58;2021-01-28;758;65;8677;129;4.3;0.1
58;2021-01-29;838;5;9515;134;4.8;0.1
58;2021-01-30;281;0;9796;134;4.9;0.1
58;2021-01-31;10;0;9806;134;4.9;0.1
58;2021-02-01;200;71;10006;205;5.0;0.1
58;2021-02-02;566;79;10572;284;5.3;0.1
58;2021-02-03;279;135;10851;419;5.4;0.2
58;2021-02-04;284;85;11135;504;5.6;0.3
58;2021-02-05;184;86;11319;590;5.7;0.3
58;2021-02-06;89;0;11408;590;5.7;0.3
58;2021-02-07;0;0;11408;590;5.7;0.3
58;2021-02-08;306;60;11714;650;5.9;0.3
58;2021-02-09;503;294;12217;944;6.1;0.5
58;2021-02-10;350;358;12567;1302;6.3;0.7
58;2021-02-11;286;365;12853;1667;6.4;0.8
58;2021-02-12;243;191;13096;1858;6.6;0.9
58;2021-02-13;83;29;13179;1887;6.6;0.9
58;2021-02-14;0;3;13179;1890;6.6;0.9
58;2021-02-15;114;366;13293;2256;6.7;1.1
58;2021-02-16;208;701;13501;2957;6.8;1.5
58;2021-02-17;221;600;13722;3557;6.9;1.8
58;2021-02-18;187;570;13909;4127;7.0;2.1
58;2021-02-19;238;586;14147;4713;7.1;2.4
58;2021-02-20;63;170;14210;4883;7.1;2.4
58;2021-02-21;0;30;14210;4913;7.1;2.5
58;2021-02-22;78;298;14288;5211;7.2;2.6
58;2021-02-23;49;483;14337;5694;7.2;2.9
58;2021-02-24;39;495;14376;6189;7.2;3.1
58;2021-02-25;252;591;14628;6780;7.3;3.4
58;2021-02-26;246;484;14874;7264;7.5;3.6
58;2021-02-27;104;142;14978;7406;7.5;3.7
58;2021-02-28;11;8;14989;7414;7.5;3.7
58;2021-03-01;145;183;15134;7597;7.6;3.8
58;2021-03-02;416;527;15550;8124;7.8;4.1
58;2021-03-03;523;248;16073;8372;8.1;4.2
58;2021-03-04;725;257;16798;8629;8.4;4.3
58;2021-03-05;866;192;17664;8821;8.8;4.4
58;2021-03-06;577;77;18241;8898;9.1;4.5
58;2021-03-07;63;10;18304;8908;9.2;4.5
58;2021-03-08;156;269;18460;9177;9.2;4.6
58;2021-03-09;545;476;19005;9653;9.5;4.8
58;2021-03-10;838;215;19843;9868;9.9;4.9
58;2021-03-11;858;248;20701;10116;10.4;5.1
58;2021-03-12;862;185;21563;10301;10.8;5.2
58;2021-03-13;506;64;22069;10365;11.1;5.2
58;2021-03-14;34;1;22103;10366;11.1;5.2
58;2021-03-15;530;108;22633;10474;11.3;5.2
58;2021-03-16;725;219;23358;10693;11.7;5.4
58;2021-03-17;755;190;24113;10883;12.1;5.5
58;2021-03-18;584;172;24697;11055;12.4;5.5
58;2021-03-19;540;98;25237;11153;12.6;5.6
58;2021-03-20;322;64;25559;11217;12.8;5.6
58;2021-03-21;17;0;25576;11217;12.8;5.6
58;2021-03-22;797;25;26373;11242;13.2;5.6
58;2021-03-23;1636;42;28009;11284;14.0;5.7
58;2021-03-24;1370;76;29379;11360;14.7;5.7
58;2021-03-25;1840;47;31219;11407;15.6;5.7
58;2021-03-26;1414;56;32633;11463;16.3;5.7
58;2021-03-27;358;8;32991;11471;16.5;5.7
58;2021-03-28;20;0;33011;11471;16.5;5.7
58;2021-03-29;636;148;33647;11619;16.9;5.8
58;2021-03-30;1187;254;34834;11873;17.5;5.9
58;2021-03-31;1116;390;35950;12263;18.0;6.1
58;2021-04-01;1547;400;37497;12663;18.8;6.3
58;2021-04-02;1463;360;38960;13023;19.5;6.5
58;2021-04-03;568;148;39528;13171;19.8;6.6
58;2021-04-04;1;1;39529;13172;19.8;6.6
58;2021-04-05;48;0;39577;13172;19.8;6.6
58;2021-04-06;823;343;40400;13515;20.2;6.8
58;2021-04-07;697;550;41097;14065;20.6;7.0
58;2021-04-08;1493;427;42590;14492;21.3;7.3
58;2021-04-09;1775;486;44365;14978;22.2;7.5
58;2021-04-10;650;201;45015;15179;22.6;7.6
58;2021-04-11;17;3;45032;15182;22.6;7.6
58;2021-04-12;1117;502;46149;15684;23.1;7.9
58;2021-04-13;1435;629;47584;16313;23.8;8.2
58;2021-04-14;1358;695;48942;17008;24.5;8.5
58;2021-04-15;1441;609;50383;17617;25.2;8.8
58;2021-04-16;1734;515;52117;18132;26.1;9.1
58;2021-04-17;721;233;52838;18365;26.5;9.2
58;2021-04-18;20;7;52858;18372;26.5;9.2
58;2021-04-19;530;602;53388;18974;26.7;9.5
58;2021-04-20;487;1119;53875;20093;27.0;10.1
58;2021-04-21;628;967;54503;21060;27.3;10.6
58;2021-04-22;768;1519;55271;22579;27.7;11.3
58;2021-04-23;919;784;56190;23363;28.2;11.7
58;2021-04-24;211;206;56401;23569;28.3;11.8
58;2021-04-25;109;9;56510;23578;28.3;11.8
58;2021-04-26;762;248;57272;23826;28.7;11.9
58;2021-04-27;1499;1106;58771;24932;29.4;12.5
58;2021-04-28;1536;1041;60307;25973;30.2;13.0
58;2021-04-29;1444;1039;61751;27012;30.9;13.5
58;2021-04-30;1258;936;63009;27948;31.6;14.0
58;2021-05-01;6;17;63015;27965;31.6;14.0
58;2021-05-02;4;2;63019;27967;31.6;14.0
58;2021-05-03;1042;407;64061;28374;32.1;14.2
58;2021-05-04;1073;1344;65134;29718;32.6;14.9
58;2021-05-05;955;1092;66089;30810;33.1;15.4
58;2021-05-06;1363;1053;67452;31863;33.8;16.0
58;2021-05-07;1111;1088;68563;32951;34.4;16.5
58;2021-05-08;59;60;68622;33011;34.4;16.5
58;2021-05-09;7;21;68629;33032;34.4;16.5
58;2021-05-10;875;989;69504;34021;34.8;17.0
58;2021-05-11;1184;1981;70688;36002;35.4;18.0
58;2021-05-12;1660;1558;72348;37560;36.2;18.8
58;2021-05-13;49;183;72397;37743;36.3;18.9
58;2021-05-14;2311;907;74708;38650;37.4;19.4
58;2021-05-15;1726;456;76434;39106;38.3;19.6
58;2021-05-16;118;33;76552;39139;38.4;19.6
58;2021-05-17;793;611;77345;39750;38.8;19.9
58;2021-05-18;1333;1181;78678;40931;39.4;20.5
58;2021-05-19;1738;548;80416;41479;40.3;20.8
58;2021-05-20;1701;674;82117;42153;41.1;21.1
58;2021-05-21;854;720;82971;42873;41.6;21.5
58;2021-05-22;304;237;83275;43110;41.7;21.6
58;2021-05-23;2;21;83277;43131;41.7;21.6
58;2021-05-24;21;41;83298;43172;41.7;21.6
58;2021-05-25;1386;1155;84684;44327;42.4;22.2
58;2021-05-26;845;832;85529;45159;42.9;22.6
58;2021-05-27;753;935;86282;46094;43.2;23.1
58;2021-05-28;429;905;86711;46999;43.4;23.5
58;2021-05-29;151;209;86862;47208;43.5;23.7
58;2021-05-30;21;19;86883;47227;43.5;23.7
58;2021-05-31;757;385;87640;47612;43.9;23.9
58;2021-06-01;1372;1644;89012;49256;44.6;24.7
58;2021-06-02;1467;1048;90479;50304;45.3;25.2
58;2021-06-03;1024;956;91503;51260;45.8;25.7
58;2021-06-04;842;902;92345;52162;46.3;26.1
58;2021-06-05;272;263;92617;52425;46.4;26.3
58;2021-06-06;26;44;92643;52469;46.4;26.3
58;2021-06-07;712;792;93355;53261;46.8;26.7
58;2021-06-08;1321;1758;94676;55019;47.4;27.6
58;2021-06-09;1417;1007;96093;56026;48.1;28.1
58;2021-06-10;1106;974;97199;57000;48.7;28.6
58;2021-06-11;1023;907;98222;57907;49.2;29.0
58;2021-06-12;1056;415;99278;58322;49.7;29.2
58;2021-06-13;36;33;99314;58355;49.8;29.2
58;2021-06-14;516;1016;99830;59371;50.0;29.7
58;2021-06-15;1592;1757;101422;61128;50.8;30.6
58;2021-06-16;1806;992;103228;62120;51.7;31.1
58;2021-06-17;2023;1101;105251;63221;52.7;31.7
58;2021-06-18;986;1061;106237;64282;53.2;32.2
58;2021-06-19;581;320;106818;64602;53.5;32.4
58;2021-06-20;9;2;106827;64604;53.5;32.4
58;2021-06-21;472;553;107299;65157;53.8;32.6
58;2021-06-22;1028;1960;108327;67117;54.3;33.6
58;2021-06-23;1477;1504;109804;68621;55.0;34.4
58;2021-06-24;729;1022;110533;69643;55.4;34.9
58;2021-06-25;824;1719;111357;71362;55.8;35.8
58;2021-06-26;554;1228;111911;72590;56.1;36.4
58;2021-06-27;18;22;111929;72612;56.1;36.4
58;2021-06-28;463;987;112392;73599;56.3;36.9
58;2021-06-29;623;2161;113015;75760;56.6;38.0
58;2021-06-30;999;1624;114014;77384;57.1;38.8
58;2021-07-01;760;1670;114774;79054;57.5;39.6
58;2021-07-02;444;849;115218;79903;57.7;40.0
58;2021-07-03;249;512;115467;80415;57.9;40.3
58;2021-07-04;12;30;115479;80445;57.9;40.3
58;2021-07-05;510;763;115989;81208;58.1;40.7
58;2021-07-06;695;2121;116684;83329;58.5;41.7
58;2021-07-07;388;947;117072;84276;58.7;42.2
58;2021-07-08;399;1016;117471;85292;58.9;42.7
58;2021-07-09;709;1419;118180;86711;59.2;43.4
58;2021-07-10;260;412;118440;87123;59.3;43.6
58;2021-07-11;175;52;118615;87175;59.4;43.7
58;2021-07-12;197;965;118812;88140;59.5;44.2
58;2021-07-13;933;2503;119745;90643;60.0;45.4
58;2021-07-14;27;58;119772;90701;60.0;45.4
58;2021-07-15;1135;1935;120907;92636;60.6;46.4
58;2021-07-16;1411;1441;122318;94077;61.3;47.1
58;2021-07-17;463;288;122781;94365;61.5;47.3
58;2021-07-18;102;21;122883;94386;61.6;47.3
58;2021-07-19;1655;987;124538;95373;62.4;47.8
58;2021-07-20;1408;2455;125946;97828;63.1;49.0
58;2021-07-21;1178;2010;127124;99838;63.7;50.0
58;2021-07-22;1143;1670;128267;101508;64.3;50.9
58;2021-07-23;1268;1444;129535;102952;64.9;51.6
58;2021-07-24;1000;1272;130535;104224;65.4;52.2
58;2021-07-25;89;40;130624;104264;65.4;52.2
58;2021-07-26;980;858;131604;105122;65.9;52.7
58;2021-07-27;1566;2569;133170;107691;66.7;54.0
58;2021-07-28;1570;1971;134740;109662;67.5;54.9
58;2021-07-29;1581;1621;136321;111283;68.3;55.8
58;2021-07-30;1466;1428;137787;112711;69.0;56.5
58;2021-07-31;568;524;138355;113235;69.3;56.7
58;2021-08-01;35;13;138390;113248;69.3;56.7
58;2021-08-02;1590;854;139980;114102;70.1;57.2
58;2021-08-03;2051;1779;142031;115881;71.2;58.1
58;2021-08-04;1307;1184;143338;117065;71.8;58.7
58;2021-08-05;1621;1175;144959;118240;72.6;59.2
58;2021-08-06;1359;1032;146318;119272;73.3;59.8
58;2021-08-07;318;401;146636;119673;73.5;60.0
58;2021-08-08;30;58;146666;119731;73.5;60.0
58;2021-08-09;1083;1388;147749;121119;74.0;60.7
58;2021-08-10;1779;1387;149528;122506;74.9;61.4
58;2021-08-11;1134;780;150662;123286;75.5;61.8
58;2021-08-12;1067;1109;151729;124395;76.0;62.3
58;2021-08-13;930;955;152659;125350;76.5;62.8
58;2021-08-14;232;317;152891;125667;76.6;63.0
58;2021-08-15;14;27;152905;125694;76.6;63.0
58;2021-08-16;311;1402;153216;127096;76.8;63.7
58;2021-08-17;805;1337;154021;128433;77.2;64.3
58;2021-08-18;766;1171;154787;129604;77.6;64.9
58;2021-08-19;731;1342;155518;130946;77.9;65.6
58;2021-08-20;707;1298;156225;132244;78.3;66.3
58;2021-08-21;254;476;156479;132720;78.4;66.5
58;2021-08-22;9;86;156488;132806;78.4;66.5
58;2021-08-23;418;815;156906;133621;78.6;66.9
58;2021-08-24;513;1481;157419;135102;78.9;67.7
58;2021-08-25;436;1542;157855;136644;79.1;68.5
58;2021-08-26;553;1731;158408;138375;79.4;69.3
58;2021-08-27;494;1565;158902;139940;79.6;70.1
58;2021-08-28;244;640;159146;140580;79.7;70.4
58;2021-08-29;9;42;159155;140622;79.7;70.5
58;2021-08-30;356;808;159511;141430;79.9;70.9
58;2021-08-31;493;1608;160004;143038;80.2;71.7
58;2021-09-01;428;1676;160432;144714;80.4;72.5
58;2021-09-02;291;1361;160723;146075;80.5;73.2
58;2021-09-03;364;1564;161087;147639;80.7;74.0
58;2021-09-04;206;700;161293;148339;80.8;74.3
58;2021-09-05;3;27;161296;148366;80.8;74.3
58;2021-09-06;117;561;161413;148927;80.9;74.6
58;2021-09-07;320;985;161733;149912;81.0;75.1
58;2021-09-08;240;1331;161973;151243;81.2;75.8
58;2021-09-09;248;704;162221;151947;81.3;76.1
58;2021-09-10;260;963;162481;152910;81.4;76.6
58;2021-09-11;129;526;162610;153436;81.5;76.9
58;2021-09-12;5;17;162615;153453;81.5;76.9
58;2021-09-13;207;750;162822;154203;81.6;77.3
58;2021-09-14;290;973;163112;155176;81.7;77.7
58;2021-09-15;189;573;163301;155749;81.8;78.0
58;2021-09-16;205;451;163506;156200;81.9;78.3
58;2021-09-17;197;376;163703;156576;82.0;78.4
58;2021-09-18;118;362;163821;156938;82.1;78.6
58;2021-09-19;5;4;163826;156942;82.1;78.6
58;2021-09-20;174;229;164000;157171;82.2;78.7
58;2021-09-21;139;421;164139;157592;82.2;79.0
58;2021-09-22;159;535;164298;158127;82.3;79.2
58;2021-09-23;135;288;164433;158415;82.4;79.4
58;2021-09-24;113;391;164546;158806;82.4;79.6
58;2021-09-25;93;374;164639;159180;82.5;79.8
58;2021-09-26;6;13;164645;159193;82.5;79.8
58;2021-09-27;91;232;164736;159425;82.5;79.9
58;2021-09-28;126;330;164862;159755;82.6;80.0
58;2021-09-29;99;345;164961;160100;82.6;80.2
58;2021-09-30;67;217;165028;160317;82.7;80.3
58;2021-10-01;89;220;165117;160537;82.7;80.4
58;2021-10-02;85;220;165202;160757;82.8;80.5
58;2021-10-03;0;6;165202;160763;82.8;80.5
58;2021-10-04;61;203;165263;160966;82.8;80.6
58;2021-10-05;134;324;165397;161290;82.9;80.8
58;2021-10-06;65;309;165462;161599;82.9;81.0
59;2020-12-27;1;0;1;0;0.0;0.0
59;2020-12-28;27;0;28;0;0.0;0.0
59;2020-12-29;0;0;28;0;0.0;0.0
59;2020-12-30;0;0;28;0;0.0;0.0
59;2020-12-31;2;0;30;0;0.0;0.0
59;2021-01-01;3;0;33;0;0.0;0.0
59;2021-01-02;4;0;37;0;0.0;0.0
59;2021-01-03;4;0;41;0;0.0;0.0
59;2021-01-04;79;0;120;0;0.0;0.0
59;2021-01-05;217;0;337;0;0.0;0.0
59;2021-01-06;428;1;765;1;0.0;0.0
59;2021-01-07;1314;0;2079;1;0.1;0.0
59;2021-01-08;1262;5;3341;6;0.1;0.0
59;2021-01-09;608;3;3949;9;0.2;0.0
59;2021-01-10;430;0;4379;9;0.2;0.0
59;2021-01-11;1846;5;6225;14;0.2;0.0
59;2021-01-12;2471;2;8696;16;0.3;0.0
59;2021-01-13;2369;2;11065;18;0.4;0.0
59;2021-01-14;2759;21;13824;39;0.5;0.0
59;2021-01-15;2276;15;16100;54;0.6;0.0
59;2021-01-16;771;1;16871;55;0.7;0.0
59;2021-01-17;560;2;17431;57;0.7;0.0
59;2021-01-18;3511;13;20942;70;0.8;0.0
59;2021-01-19;4758;8;25700;78;1.0;0.0
59;2021-01-20;4135;11;29835;89;1.2;0.0
59;2021-01-21;4731;31;34566;120;1.3;0.0
59;2021-01-22;4026;10;38592;130;1.5;0.0
59;2021-01-23;1217;3;39809;133;1.5;0.0
59;2021-01-24;170;0;39979;133;1.5;0.0
59;2021-01-25;2729;50;42708;183;1.6;0.0
59;2021-01-26;2824;127;45532;310;1.8;0.0
59;2021-01-27;1736;286;47268;596;1.8;0.0
59;2021-01-28;3398;714;50666;1310;2.0;0.1
59;2021-01-29;2544;717;53210;2027;2.1;0.1
59;2021-01-30;288;142;53498;2169;2.1;0.1
59;2021-01-31;24;0;53522;2169;2.1;0.1
59;2021-02-01;79;761;53601;2930;2.1;0.1
59;2021-02-02;691;1329;54292;4259;2.1;0.2
59;2021-02-03;3755;1340;58047;5599;2.2;0.2
59;2021-02-04;2966;1600;61013;7199;2.4;0.3
59;2021-02-05;1071;1278;62084;8477;2.4;0.3
59;2021-02-06;207;298;62291;8775;2.4;0.3
59;2021-02-07;268;49;62559;8824;2.4;0.3
59;2021-02-08;684;1364;63243;10188;2.4;0.4
59;2021-02-09;1015;1538;64258;11726;2.5;0.5
59;2021-02-10;975;1390;65233;13116;2.5;0.5
59;2021-02-11;1349;1590;66582;14706;2.6;0.6
59;2021-02-12;1415;1413;67997;16119;2.6;0.6
59;2021-02-13;207;594;68204;16713;2.6;0.6
59;2021-02-14;13;39;68217;16752;2.6;0.6
59;2021-02-15;1397;2175;69614;18927;2.7;0.7
59;2021-02-16;1436;2653;71050;21580;2.7;0.8
59;2021-02-17;1623;2732;72673;24312;2.8;0.9
59;2021-02-18;3106;4154;75779;28466;2.9;1.1
59;2021-02-19;3208;3031;78987;31497;3.1;1.2
59;2021-02-20;1413;1235;80400;32732;3.1;1.3
59;2021-02-21;242;236;80642;32968;3.1;1.3
59;2021-02-22;1430;1997;82072;34965;3.2;1.4
59;2021-02-23;2659;2277;84731;37242;3.3;1.4
59;2021-02-24;4108;3610;88839;40852;3.4;1.6
59;2021-02-25;6920;3446;95759;44298;3.7;1.7
59;2021-02-26;6499;1691;102258;45989;3.9;1.8
59;2021-02-27;3095;181;105353;46170;4.1;1.8
59;2021-02-28;208;59;105561;46229;4.1;1.8
59;2021-03-01;3691;577;109252;46806;4.2;1.8
59;2021-03-02;4794;514;114046;47320;4.4;1.8
59;2021-03-03;5748;926;119794;48246;4.6;1.9
59;2021-03-04;7084;876;126878;49122;4.9;1.9
59;2021-03-05;7837;900;134715;50022;5.2;1.9
59;2021-03-06;11562;484;146277;50506;5.6;2.0
59;2021-03-07;7586;322;153863;50828;5.9;2.0
59;2021-03-08;4498;1006;158361;51834;6.1;2.0
59;2021-03-09;6577;1283;164938;53117;6.4;2.1
59;2021-03-10;7028;1074;171966;54191;6.6;2.1
59;2021-03-11;9476;1776;181442;55967;7.0;2.2
59;2021-03-12;12158;1488;193600;57455;7.5;2.2
59;2021-03-13;16558;1065;210158;58520;8.1;2.3
59;2021-03-14;6964;327;217122;58847;8.4;2.3
59;2021-03-15;5613;1439;222735;60286;8.6;2.3
59;2021-03-16;3740;1271;226475;61557;8.7;2.4
59;2021-03-17;3856;2043;230331;63600;8.9;2.5
59;2021-03-18;3957;2431;234288;66031;9.0;2.6
59;2021-03-19;7743;1752;242031;67783;9.3;2.6
59;2021-03-20;16023;1267;258054;69050;10.0;2.7
59;2021-03-21;6318;445;264372;69495;10.2;2.7
59;2021-03-22;5449;1743;269821;71238;10.4;2.8
59;2021-03-23;7772;2777;277593;74015;10.7;2.9
59;2021-03-24;6861;2936;284454;76951;11.0;3.0
59;2021-03-25;10534;2538;294988;79489;11.4;3.1
59;2021-03-26;12254;2806;307242;82295;11.9;3.2
59;2021-03-27;15275;1149;322517;83444;12.5;3.2
59;2021-03-28;7985;358;330502;83802;12.8;3.2
59;2021-03-29;5495;3170;335997;86972;13.0;3.4
59;2021-03-30;7540;3726;343537;90698;13.3;3.5
59;2021-03-31;6156;4069;349693;94767;13.5;3.7
59;2021-04-01;7494;4899;357187;99666;13.8;3.8
59;2021-04-02;7645;5496;364832;105162;14.1;4.1
59;2021-04-03;13019;4293;377851;109455;14.6;4.2
59;2021-04-04;5348;2175;383199;111630;14.8;4.3
59;2021-04-05;6021;1530;389220;113160;15.0;4.4
59;2021-04-06;5405;4476;394625;117636;15.2;4.5
59;2021-04-07;7622;5417;402247;123053;15.5;4.8
59;2021-04-08;10393;5737;412640;128790;15.9;5.0
59;2021-04-09;13422;5922;426062;134712;16.5;5.2
59;2021-04-10;11479;6127;437541;140839;16.9;5.4
59;2021-04-11;4636;3554;442177;144393;17.1;5.6
59;2021-04-12;6304;4341;448481;148734;17.3;5.7
59;2021-04-13;8934;4785;457415;153519;17.7;5.9
59;2021-04-14;8789;4341;466204;157860;18.0;6.1
59;2021-04-15;10306;4842;476510;162702;18.4;6.3
59;2021-04-16;10879;5496;487389;168198;18.8;6.5
59;2021-04-17;7296;9068;494685;177266;19.1;6.8
59;2021-04-18;3234;4158;497919;181424;19.2;7.0
59;2021-04-19;5044;4287;502963;185711;19.4;7.2
59;2021-04-20;6898;4207;509861;189918;19.7;7.3
59;2021-04-21;6271;4421;516132;194339;19.9;7.5
59;2021-04-22;8612;5516;524744;199855;20.3;7.7
59;2021-04-23;8458;5678;533202;205533;20.6;7.9
59;2021-04-24;5537;8046;538739;213579;20.8;8.2
59;2021-04-25;3242;6075;541981;219654;20.9;8.5
59;2021-04-26;6493;3776;548474;223430;21.2;8.6
59;2021-04-27;8367;5155;556841;228585;21.5;8.8
59;2021-04-28;8766;6529;565607;235114;21.8;9.1
59;2021-04-29;9417;8489;575024;243603;22.2;9.4
59;2021-04-30;10605;8464;585629;252067;22.6;9.7
59;2021-05-01;11998;7598;597627;259665;23.1;10.0
59;2021-05-02;8641;5990;606268;265655;23.4;10.3
59;2021-05-03;9553;5043;615821;270698;23.8;10.5
59;2021-05-04;11426;5965;627247;276663;24.2;10.7
59;2021-05-05;10294;6189;637541;282852;24.6;10.9
59;2021-05-06;11197;8427;648738;291279;25.1;11.3
59;2021-05-07;13297;9561;662035;300840;25.6;11.6
59;2021-05-08;14742;4169;676777;305009;26.1;11.8
59;2021-05-09;11492;3329;688269;308338;26.6;11.9
59;2021-05-10;12746;6623;701015;314961;27.1;12.2
59;2021-05-11;15112;8297;716127;323258;27.7;12.5
59;2021-05-12;16626;8627;732753;331885;28.3;12.8
59;2021-05-13;18441;3457;751194;335342;29.0;13.0
59;2021-05-14;15782;6960;766976;342302;29.6;13.2
59;2021-05-15;23443;5281;790419;347583;30.5;13.4
59;2021-05-16;21176;2416;811595;349999;31.3;13.5
59;2021-05-17;15066;5257;826661;355256;31.9;13.7
59;2021-05-18;16924;5657;843585;360913;32.6;13.9
59;2021-05-19;18319;5108;861904;366021;33.3;14.1
59;2021-05-20;17934;6983;879838;373004;34.0;14.4
59;2021-05-21;18370;8262;898208;381266;34.7;14.7
59;2021-05-22;23812;5670;922020;386936;35.6;14.9
59;2021-05-23;17921;2276;939941;389212;36.3;15.0
59;2021-05-24;16691;2145;956632;391357;37.0;15.1
59;2021-05-25;14990;6651;971622;398008;37.5;15.4
59;2021-05-26;15892;7030;987514;405038;38.1;15.6
59;2021-05-27;16151;9154;1003665;414192;38.8;16.0
59;2021-05-28;15884;11419;1019549;425611;39.4;16.4
59;2021-05-29;14370;8686;1033919;434297;39.9;16.8
59;2021-05-30;8406;1840;1042325;436137;40.3;16.8
59;2021-05-31;14203;7947;1056528;444084;40.8;17.2
59;2021-06-01;15086;10360;1071614;454444;41.4;17.6
59;2021-06-02;14769;9902;1086383;464346;42.0;17.9
59;2021-06-03;15630;12102;1102013;476448;42.6;18.4
59;2021-06-04;15608;13438;1117621;489886;43.2;18.9
59;2021-06-05;14978;9336;1132599;499222;43.7;19.3
59;2021-06-06;8826;3204;1141425;502426;44.1;19.4
59;2021-06-07;10527;9415;1151952;511841;44.5;19.8
59;2021-06-08;11759;11072;1163711;522913;44.9;20.2
59;2021-06-09;10758;11879;1174469;534792;45.4;20.7
59;2021-06-10;11503;12306;1185972;547098;45.8;21.1
59;2021-06-11;10973;15970;1196945;563068;46.2;21.7
59;2021-06-12;11068;13674;1208013;576742;46.7;22.3
59;2021-06-13;6344;7028;1214357;583770;46.9;22.5
59;2021-06-14;6505;12675;1220862;596445;47.2;23.0
59;2021-06-15;8231;15946;1229093;612391;47.5;23.7
59;2021-06-16;9203;13541;1238296;625932;47.8;24.2
59;2021-06-17;9187;15644;1247483;641576;48.2;24.8
59;2021-06-18;9081;20059;1256564;661635;48.5;25.6
59;2021-06-19;8952;17489;1265516;679124;48.9;26.2
59;2021-06-20;4900;10189;1270416;689313;49.1;26.6
59;2021-06-21;5280;15964;1275696;705277;49.3;27.2
59;2021-06-22;6336;18672;1282032;723949;49.5;28.0
59;2021-06-23;6168;19082;1288200;743031;49.8;28.7
59;2021-06-24;7338;20517;1295538;763548;50.0;29.5
59;2021-06-25;6507;21190;1302045;784738;50.3;30.3
59;2021-06-26;6489;23744;1308534;808482;50.5;31.2
59;2021-06-27;4752;17078;1313286;825560;50.7;31.9
59;2021-06-28;5003;19812;1318289;845372;50.9;32.7
59;2021-06-29;5549;20377;1323838;865749;51.1;33.4
59;2021-06-30;6132;20098;1329970;885847;51.4;34.2
59;2021-07-01;6772;20838;1336742;906685;51.6;35.0
59;2021-07-02;6837;23238;1343579;929923;51.9;35.9
59;2021-07-03;5563;24605;1349142;954528;52.1;36.9
59;2021-07-04;4416;15976;1353558;970504;52.3;37.5
59;2021-07-05;5671;17486;1359229;987990;52.5;38.2
59;2021-07-06;6610;18797;1365839;1006787;52.8;38.9
59;2021-07-07;6939;17448;1372778;1024235;53.0;39.6
59;2021-07-08;8027;17683;1380805;1041918;53.3;40.2
59;2021-07-09;7705;20297;1388510;1062215;53.6;41.0
59;2021-07-10;7450;18538;1395960;1080753;53.9;41.7
59;2021-07-11;4448;10230;1400408;1090983;54.1;42.1
59;2021-07-12;5917;18043;1406325;1109026;54.3;42.8
59;2021-07-13;9910;20748;1416235;1129774;54.7;43.6
59;2021-07-14;9782;8454;1426017;1138228;55.1;44.0
59;2021-07-15;11638;20387;1437655;1158615;55.5;44.8
59;2021-07-16;13216;20490;1450871;1179105;56.0;45.5
59;2021-07-17;12400;17469;1463271;1196574;56.5;46.2
59;2021-07-18;7962;8683;1471233;1205257;56.8;46.6
59;2021-07-19;10404;16445;1481637;1221702;57.2;47.2
59;2021-07-20;13409;17120;1495046;1238822;57.7;47.8
59;2021-07-21;14526;15599;1509572;1254421;58.3;48.5
59;2021-07-22;17062;15205;1526634;1269626;59.0;49.0
59;2021-07-23;15728;15825;1542362;1285451;59.6;49.7
59;2021-07-24;16356;12299;1558718;1297750;60.2;50.1
59;2021-07-25;11916;7340;1570634;1305090;60.7;50.4
59;2021-07-26;13041;12614;1583675;1317704;61.2;50.9
59;2021-07-27;16228;11961;1599903;1329665;61.8;51.4
59;2021-07-28;17457;11668;1617360;1341333;62.5;51.8
59;2021-07-29;17423;11676;1634783;1353009;63.1;52.3
59;2021-07-30;15922;11607;1650705;1364616;63.8;52.7
59;2021-07-31;14021;9209;1664726;1373825;64.3;53.1
59;2021-08-01;9959;4572;1674685;1378397;64.7;53.2
59;2021-08-02;12213;10033;1686898;1388430;65.2;53.6
59;2021-08-03;13453;10057;1700351;1398487;65.7;54.0
59;2021-08-04;11240;8286;1711591;1406773;66.1;54.3
59;2021-08-05;12722;9786;1724313;1416559;66.6;54.7
59;2021-08-06;12562;11041;1736875;1427600;67.1;55.1
59;2021-08-07;9739;9300;1746614;1436900;67.5;55.5
59;2021-08-08;6960;5268;1753574;1442168;67.7;55.7
59;2021-08-09;8410;10829;1761984;1452997;68.1;56.1
59;2021-08-10;10405;10755;1772389;1463752;68.5;56.5
59;2021-08-11;8675;9320;1781064;1473072;68.8;56.9
59;2021-08-12;9001;12076;1790065;1485148;69.1;57.4
59;2021-08-13;8639;11750;1798704;1496898;69.5;57.8
59;2021-08-14;5952;10393;1804656;1507291;69.7;58.2
59;2021-08-15;3376;4666;1808032;1511957;69.8;58.4
59;2021-08-16;5876;13866;1813908;1525823;70.1;58.9
59;2021-08-17;6988;12764;1820896;1538587;70.3;59.4
59;2021-08-18;5956;11468;1826852;1550055;70.6;59.9
59;2021-08-19;6354;13874;1833206;1563929;70.8;60.4
59;2021-08-20;5836;14587;1839042;1578516;71.0;61.0
59;2021-08-21;4188;10295;1843230;1588811;71.2;61.4
59;2021-08-22;2852;7651;1846082;1596462;71.3;61.7
59;2021-08-23;4786;15732;1850868;1612194;71.5;62.3
59;2021-08-24;5301;15193;1856169;1627387;71.7;62.9
59;2021-08-25;4665;13087;1860834;1640474;71.9;63.4
59;2021-08-26;5209;14349;1866043;1654823;72.1;63.9
59;2021-08-27;5005;15430;1871048;1670253;72.3;64.5
59;2021-08-28;3808;12372;1874856;1682625;72.4;65.0
59;2021-08-29;1945;8435;1876801;1691060;72.5;65.3
59;2021-08-30;3893;12946;1880694;1704006;72.6;65.8
59;2021-08-31;3826;12946;1884520;1716952;72.8;66.3
59;2021-09-01;3301;10715;1887821;1727667;72.9;66.7
59;2021-09-02;3207;10952;1891028;1738619;73.0;67.2
59;2021-09-03;3804;12129;1894832;1750748;73.2;67.6
59;2021-09-04;3397;9965;1898229;1760713;73.3;68.0
59;2021-09-05;1238;3654;1899467;1764367;73.4;68.1
59;2021-09-06;2158;7320;1901625;1771687;73.5;68.4
59;2021-09-07;2256;7050;1903881;1778737;73.5;68.7
59;2021-09-08;2579;7508;1906460;1786245;73.6;69.0
59;2021-09-09;2434;6705;1908894;1792950;73.7;69.3
59;2021-09-10;3292;8103;1912186;1801053;73.9;69.6
59;2021-09-11;2595;7518;1914781;1808571;74.0;69.9
59;2021-09-12;913;2923;1915694;1811494;74.0;70.0
59;2021-09-13;1952;5504;1917646;1816998;74.1;70.2
59;2021-09-14;2333;5958;1919979;1822956;74.2;70.4
59;2021-09-15;2271;5362;1922250;1828318;74.2;70.6
59;2021-09-16;2173;4257;1924423;1832575;74.3;70.8
59;2021-09-17;2909;5448;1927332;1838023;74.4;71.0
59;2021-09-18;1779;5920;1929111;1843943;74.5;71.2
59;2021-09-19;382;1302;1929493;1845245;74.5;71.3
59;2021-09-20;1357;3300;1930850;1848545;74.6;71.4
59;2021-09-21;1335;2938;1932185;1851483;74.6;71.5
59;2021-09-22;1409;4740;1933594;1856223;74.7;71.7
59;2021-09-23;1515;2822;1935109;1859045;74.7;71.8
59;2021-09-24;1901;4237;1937010;1863282;74.8;72.0
59;2021-09-25;1156;4018;1938166;1867300;74.9;72.1
59;2021-09-26;314;1208;1938480;1868508;74.9;72.2
59;2021-09-27;1089;2533;1939569;1871041;74.9;72.3
59;2021-09-28;1075;2193;1940644;1873234;75.0;72.4
59;2021-09-29;1287;2957;1941931;1876191;75.0;72.5
59;2021-09-30;1236;2259;1943167;1878450;75.1;72.6
59;2021-10-01;1663;3375;1944830;1881825;75.1;72.7
59;2021-10-02;1459;3245;1946289;1885070;75.2;72.8
59;2021-10-03;262;630;1946551;1885700;75.2;72.8
59;2021-10-04;1076;1973;1947627;1887673;75.2;72.9
59;2021-10-05;1138;2161;1948765;1889834;75.3;73.0
59;2021-10-06;1252;2496;1950017;1892330;75.3;73.1
60;2020-12-27;0;0;0;0;0.0;0.0
60;2020-12-28;0;0;0;0;0.0;0.0
60;2020-12-29;1;0;1;0;0.0;0.0
60;2020-12-30;1;0;2;0;0.0;0.0
60;2020-12-31;0;0;2;0;0.0;0.0
60;2021-01-01;0;0;2;0;0.0;0.0
60;2021-01-02;5;0;7;0;0.0;0.0
60;2021-01-03;1;0;8;0;0.0;0.0
60;2021-01-04;1;0;9;0;0.0;0.0
60;2021-01-05;37;0;46;0;0.0;0.0
60;2021-01-06;188;3;234;3;0.0;0.0
60;2021-01-07;235;4;469;7;0.1;0.0
60;2021-01-08;380;4;849;11;0.1;0.0
60;2021-01-09;3;0;852;11;0.1;0.0
60;2021-01-10;60;0;912;11;0.1;0.0
60;2021-01-11;345;2;1257;13;0.2;0.0
60;2021-01-12;537;2;1794;15;0.2;0.0
60;2021-01-13;475;5;2269;20;0.3;0.0
60;2021-01-14;508;6;2777;26;0.3;0.0
60;2021-01-15;704;7;3481;33;0.4;0.0
60;2021-01-16;124;1;3605;34;0.4;0.0
60;2021-01-17;32;0;3637;34;0.4;0.0
60;2021-01-18;860;7;4497;41;0.5;0.0
60;2021-01-19;1207;11;5704;52;0.7;0.0
60;2021-01-20;1719;11;7423;63;0.9;0.0
60;2021-01-21;2265;8;9688;71;1.2;0.0
60;2021-01-22;1547;14;11235;85;1.4;0.0
60;2021-01-23;499;4;11734;89;1.4;0.0
60;2021-01-24;61;1;11795;90;1.4;0.0
60;2021-01-25;897;14;12692;104;1.5;0.0
60;2021-01-26;950;16;13642;120;1.7;0.0
60;2021-01-27;646;6;14288;126;1.7;0.0
60;2021-01-28;396;164;14684;290;1.8;0.0
60;2021-01-29;77;98;14761;388;1.8;0.0
60;2021-01-30;0;1;14761;389;1.8;0.0
60;2021-01-31;22;57;14783;446;1.8;0.1
60;2021-02-01;41;102;14824;548;1.8;0.1
60;2021-02-02;26;143;14850;691;1.8;0.1
60;2021-02-03;165;228;15015;919;1.8;0.1
60;2021-02-04;170;331;15185;1250;1.8;0.2
60;2021-02-05;314;462;15499;1712;1.9;0.2
60;2021-02-06;65;76;15564;1788;1.9;0.2
60;2021-02-07;31;30;15595;1818;1.9;0.2
60;2021-02-08;329;486;15924;2304;1.9;0.3
60;2021-02-09;319;427;16243;2731;2.0;0.3
60;2021-02-10;557;945;16800;3676;2.0;0.4
60;2021-02-11;942;1059;17742;4735;2.2;0.6
60;2021-02-12;917;807;18659;5542;2.3;0.7
60;2021-02-13;91;289;18750;5831;2.3;0.7
60;2021-02-14;25;81;18775;5912;2.3;0.7
60;2021-02-15;614;633;19389;6545;2.3;0.8
60;2021-02-16;580;781;19969;7326;2.4;0.9
60;2021-02-17;633;757;20602;8083;2.5;1.0
60;2021-02-18;684;696;21286;8779;2.6;1.1
60;2021-02-19;641;624;21927;9403;2.7;1.1
60;2021-02-20;104;155;22031;9558;2.7;1.2
60;2021-02-21;23;99;22054;9657;2.7;1.2
60;2021-02-22;461;736;22515;10393;2.7;1.3
60;2021-02-23;535;656;23050;11049;2.8;1.3
60;2021-02-24;794;465;23844;11514;2.9;1.4
60;2021-02-25;1095;249;24939;11763;3.0;1.4
60;2021-02-26;1298;168;26237;11931;3.2;1.4
60;2021-02-27;668;35;26905;11966;3.3;1.5
60;2021-02-28;7;10;26912;11976;3.3;1.5
60;2021-03-01;895;47;27807;12023;3.4;1.5
60;2021-03-02;1012;158;28819;12181;3.5;1.5
60;2021-03-03;1321;424;30140;12605;3.7;1.5
60;2021-03-04;1725;472;31865;13077;3.9;1.6
60;2021-03-05;1822;283;33687;13360;4.1;1.6
60;2021-03-06;1919;143;35606;13503;4.3;1.6
60;2021-03-07;885;33;36491;13536;4.4;1.6
60;2021-03-08;978;292;37469;13828;4.5;1.7
60;2021-03-09;1643;327;39112;14155;4.7;1.7
60;2021-03-10;1938;397;41050;14552;5.0;1.8
60;2021-03-11;2325;363;43375;14915;5.3;1.8
60;2021-03-12;2596;526;45971;15441;5.6;1.9
60;2021-03-13;3839;207;49810;15648;6.0;1.9
60;2021-03-14;1782;63;51592;15711;6.3;1.9
60;2021-03-15;2090;484;53682;16195;6.5;2.0
60;2021-03-16;1584;616;55266;16811;6.7;2.0
60;2021-03-17;1658;600;56924;17411;6.9;2.1
60;2021-03-18;1759;728;58683;18139;7.1;2.2
60;2021-03-19;2591;521;61274;18660;7.4;2.3
60;2021-03-20;3241;192;64515;18852;7.8;2.3
60;2021-03-21;2124;97;66639;18949;8.1;2.3
60;2021-03-22;2132;705;68771;19654;8.3;2.4
60;2021-03-23;3310;712;72081;20366;8.7;2.5
60;2021-03-24;3070;863;75151;21229;9.1;2.6
60;2021-03-25;3848;842;78999;22071;9.6;2.7
60;2021-03-26;4217;869;83216;22940;10.1;2.8
60;2021-03-27;4142;321;87358;23261;10.6;2.8
60;2021-03-28;2450;83;89808;23344;10.9;2.8
60;2021-03-29;2612;1079;92420;24423;11.2;3.0
60;2021-03-30;3286;1067;95706;25490;11.6;3.1
60;2021-03-31;2668;1134;98374;26624;11.9;3.2
60;2021-04-01;2562;1102;100936;27726;12.2;3.4
60;2021-04-02;3310;1112;104246;28838;12.6;3.5
60;2021-04-03;3171;1010;107417;29848;13.0;3.6
60;2021-04-04;874;485;108291;30333;13.1;3.7
60;2021-04-05;458;81;108749;30414;13.2;3.7
60;2021-04-06;1969;1619;110718;32033;13.4;3.9
60;2021-04-07;1984;1745;112702;33778;13.7;4.1
60;2021-04-08;2611;1496;115313;35274;14.0;4.3
60;2021-04-09;2999;1523;118312;36797;14.3;4.5
60;2021-04-10;2927;1586;121239;38383;14.7;4.7
60;2021-04-11;1045;998;122284;39381;14.8;4.8
60;2021-04-12;2045;1721;124329;41102;15.1;5.0
60;2021-04-13;2749;1785;127078;42887;15.4;5.2
60;2021-04-14;3143;1823;130221;44710;15.8;5.4
60;2021-04-15;3563;1891;133784;46601;16.2;5.6
60;2021-04-16;3288;1952;137072;48553;16.6;5.9
60;2021-04-17;2848;2168;139920;50721;17.0;6.1
60;2021-04-18;573;1833;140493;52554;17.0;6.4
60;2021-04-19;1743;2213;142236;54767;17.2;6.6
60;2021-04-20;2129;2677;144365;57444;17.5;7.0
60;2021-04-21;2653;2208;147018;59652;17.8;7.2
60;2021-04-22;2628;2509;149646;62161;18.1;7.5
60;2021-04-23;2651;2500;152297;64661;18.5;7.8
60;2021-04-24;2470;3450;154767;68111;18.8;8.3
60;2021-04-25;1159;1959;155926;70070;18.9;8.5
60;2021-04-26;1890;2522;157816;72592;19.1;8.8
60;2021-04-27;2311;2836;160127;75428;19.4;9.1
60;2021-04-28;3061;2392;163188;77820;19.8;9.4
60;2021-04-29;3154;2622;166342;80442;20.2;9.7
60;2021-04-30;3459;2957;169801;83399;20.6;10.1
60;2021-05-01;2353;1124;172154;84523;20.9;10.2
60;2021-05-02;2147;846;174301;85369;21.1;10.3
60;2021-05-03;2955;1857;177256;87226;21.5;10.6
60;2021-05-04;3016;2352;180272;89578;21.8;10.9
60;2021-05-05;3260;2810;183532;92388;22.2;11.2
60;2021-05-06;3649;2478;187181;94866;22.7;11.5
60;2021-05-07;3985;2515;191166;97381;23.2;11.8
60;2021-05-08;3582;969;194748;98350;23.6;11.9
60;2021-05-09;3458;959;198206;99309;24.0;12.0
60;2021-05-10;2391;2294;200597;101603;24.3;12.3
60;2021-05-11;3671;2464;204268;104067;24.8;12.6
60;2021-05-12;4717;2554;208985;106621;25.3;12.9
60;2021-05-13;5292;1131;214277;107752;26.0;13.1
60;2021-05-14;5602;1807;219879;109559;26.6;13.3
60;2021-05-15;6172;1720;226051;111279;27.4;13.5
60;2021-05-16;4858;690;230909;111969;28.0;13.6
60;2021-05-17;3715;1674;234624;113643;28.4;13.8
60;2021-05-18;4045;2074;238669;115717;28.9;14.0
60;2021-05-19;5097;1857;243766;117574;29.5;14.3
60;2021-05-20;5460;1803;249226;119377;30.2;14.5
60;2021-05-21;5969;1970;255195;121347;30.9;14.7
60;2021-05-22;5354;1974;260549;123321;31.6;14.9
60;2021-05-23;4263;658;264812;123979;32.1;15.0
60;2021-05-24;2950;534;267762;124513;32.5;15.1
60;2021-05-25;4138;2005;271900;126518;33.0;15.3
60;2021-05-26;4466;1833;276366;128351;33.5;15.6
60;2021-05-27;4611;1995;280977;130346;34.1;15.8
60;2021-05-28;4626;2492;285603;132838;34.6;16.1
60;2021-05-29;4612;2268;290215;135106;35.2;16.4
60;2021-05-30;1086;347;291301;135453;35.3;16.4
60;2021-05-31;3831;2084;295132;137537;35.8;16.7
60;2021-06-01;4445;2844;299577;140381;36.3;17.0
60;2021-06-02;3916;2444;303493;142825;36.8;17.3
60;2021-06-03;3903;2370;307396;145195;37.3;17.6
60;2021-06-04;4651;2906;312047;148101;37.8;17.9
60;2021-06-05;4302;3418;316349;151519;38.3;18.4
60;2021-06-06;2159;795;318508;152314;38.6;18.5
60;2021-06-07;2778;2762;321286;155076;38.9;18.8
60;2021-06-08;3802;3001;325088;158077;39.4;19.2
60;2021-06-09;3249;3400;328337;161477;39.8;19.6
60;2021-06-10;3454;3365;331791;164842;40.2;20.0
60;2021-06-11;3881;4188;335672;169030;40.7;20.5
60;2021-06-12;3780;4280;339452;173310;41.1;21.0
60;2021-06-13;1154;2225;340606;175535;41.3;21.3
60;2021-06-14;1911;3307;342517;178842;41.5;21.7
60;2021-06-15;3015;4160;345532;183002;41.9;22.2
60;2021-06-16;3250;4487;348782;187489;42.3;22.7
60;2021-06-17;2978;4782;351760;192271;42.6;23.3
60;2021-06-18;2982;4603;354742;196874;43.0;23.9
60;2021-06-19;3144;4725;357886;201599;43.4;24.4
60;2021-06-20;1431;1936;359317;203535;43.5;24.7
60;2021-06-21;1408;4042;360725;207577;43.7;25.2
60;2021-06-22;1758;5286;362483;212863;43.9;25.8
60;2021-06-23;1860;5232;364343;218095;44.2;26.4
60;2021-06-24;1803;5600;366146;223695;44.4;27.1
60;2021-06-25;1906;5729;368052;229424;44.6;27.8
60;2021-06-26;1860;6972;369912;236396;44.8;28.7
60;2021-06-27;713;2593;370625;238989;44.9;29.0
60;2021-06-28;1781;4141;372406;243130;45.1;29.5
60;2021-06-29;2010;5460;374416;248590;45.4;30.1
60;2021-06-30;2296;5358;376712;253948;45.7;30.8
60;2021-07-01;1888;4919;378600;258867;45.9;31.4
60;2021-07-02;2370;5875;380970;264742;46.2;32.1
60;2021-07-03;2400;6157;383370;270899;46.5;32.8
60;2021-07-04;792;2724;384162;273623;46.6;33.2
60;2021-07-05;1659;4406;385821;278029;46.8;33.7
60;2021-07-06;2146;4494;387967;282523;47.0;34.2
60;2021-07-07;2174;5116;390141;287639;47.3;34.9
60;2021-07-08;2672;4689;392813;292328;47.6;35.4
60;2021-07-09;2640;5566;395453;297894;47.9;36.1
60;2021-07-10;2579;5874;398032;303768;48.2;36.8
60;2021-07-11;1212;1942;399244;305710;48.4;37.1
60;2021-07-12;1445;4736;400689;310446;48.6;37.6
60;2021-07-13;2912;5018;403601;315464;48.9;38.2
60;2021-07-14;2584;1408;406185;316872;49.2;38.4
60;2021-07-15;3429;4871;409614;321743;49.6;39.0
60;2021-07-16;3698;5238;413312;326981;50.1;39.6
60;2021-07-17;4079;5132;417391;332113;50.6;40.3
60;2021-07-18;2186;2131;419577;334244;50.9;40.5
60;2021-07-19;2542;3890;422119;338134;51.2;41.0
60;2021-07-20;4197;4896;426316;343030;51.7;41.6
60;2021-07-21;4352;4284;430668;347314;52.2;42.1
60;2021-07-22;4627;4331;435295;351645;52.8;42.6
60;2021-07-23;4980;4900;440275;356545;53.4;43.2
60;2021-07-24;4314;4674;444589;361219;53.9;43.8
60;2021-07-25;2604;1831;447193;363050;54.2;44.0
60;2021-07-26;3376;3756;450569;366806;54.6;44.5
60;2021-07-27;4437;4627;455006;371433;55.1;45.0
60;2021-07-28;4553;3769;459559;375202;55.7;45.5
60;2021-07-29;4901;3709;464460;378911;56.3;45.9
60;2021-07-30;5026;4260;469486;383171;56.9;46.4
60;2021-07-31;4063;3968;473549;387139;57.4;46.9
60;2021-08-01;1684;862;475233;388001;57.6;47.0
60;2021-08-02;3197;2754;478430;390755;58.0;47.4
60;2021-08-03;3605;2893;482035;393648;58.4;47.7
60;2021-08-04;3316;2796;485351;396444;58.8;48.0
60;2021-08-05;3032;2259;488383;398703;59.2;48.3
60;2021-08-06;3830;3055;492213;401758;59.7;48.7
60;2021-08-07;3369;3076;495582;404834;60.1;49.1
60;2021-08-08;1534;910;497116;405744;60.3;49.2
60;2021-08-09;2206;2873;499322;408617;60.5;49.5
60;2021-08-10;3276;3311;502598;411928;60.9;49.9
60;2021-08-11;2787;3238;505385;415166;61.3;50.3
60;2021-08-12;2355;2665;507740;417831;61.5;50.6
60;2021-08-13;2751;2998;510491;420829;61.9;51.0
60;2021-08-14;2541;2734;513032;423563;62.2;51.3
60;2021-08-15;1362;553;514394;424116;62.3;51.4
60;2021-08-16;2040;3774;516434;427890;62.6;51.9
60;2021-08-17;2346;3820;518780;431710;62.9;52.3
60;2021-08-18;1945;3284;520725;434994;63.1;52.7
60;2021-08-19;1647;3074;522372;438068;63.3;53.1
60;2021-08-20;1865;3999;524237;442067;63.5;53.6
60;2021-08-21;1612;3491;525849;445558;63.7;54.0
60;2021-08-22;576;1339;526425;446897;63.8;54.2
60;2021-08-23;1104;3223;527529;450120;63.9;54.6
60;2021-08-24;1371;4494;528900;454614;64.1;55.1
60;2021-08-25;1431;3586;530331;458200;64.3;55.5
60;2021-08-26;1432;3458;531763;461658;64.5;56.0
60;2021-08-27;1436;4174;533199;465832;64.6;56.5
60;2021-08-28;1378;4479;534577;470311;64.8;57.0
60;2021-08-29;550;2041;535127;472352;64.9;57.2
60;2021-08-30;1231;3001;536358;475353;65.0;57.6
60;2021-08-31;1641;3854;537999;479207;65.2;58.1
60;2021-09-01;1237;2796;539236;482003;65.4;58.4
60;2021-09-02;1058;2717;540294;484720;65.5;58.7
60;2021-09-03;1024;3179;541318;487899;65.6;59.1
60;2021-09-04;1520;3737;542838;491636;65.8;59.6
60;2021-09-05;365;1364;543203;493000;65.8;59.8
60;2021-09-06;797;2580;544000;495580;65.9;60.1
60;2021-09-07;839;2985;544839;498565;66.0;60.4
60;2021-09-08;886;2960;545725;501525;66.1;60.8
60;2021-09-09;681;2362;546406;503887;66.2;61.1
60;2021-09-10;1050;3011;547456;506898;66.4;61.4
60;2021-09-11;1059;3486;548515;510384;66.5;61.9
60;2021-09-12;307;1138;548822;511522;66.5;62.0
60;2021-09-13;609;1939;549431;513461;66.6;62.2
60;2021-09-14;758;1849;550189;515310;66.7;62.5
60;2021-09-15;565;1242;550754;516552;66.8;62.6
60;2021-09-16;913;1328;551667;517880;66.9;62.8
60;2021-09-17;712;1465;552379;519345;66.9;62.9
60;2021-09-18;818;2607;553197;521952;67.0;63.3
60;2021-09-19;189;497;553386;522449;67.1;63.3
60;2021-09-20;456;1097;553842;523546;67.1;63.5
60;2021-09-21;499;985;554341;524531;67.2;63.6
60;2021-09-22;442;1306;554783;525837;67.2;63.7
60;2021-09-23;626;899;555409;526736;67.3;63.8
60;2021-09-24;489;1195;555898;527931;67.4;64.0
60;2021-09-25;493;1874;556391;529805;67.4;64.2
60;2021-09-26;78;294;556469;530099;67.4;64.2
60;2021-09-27;335;765;556804;530864;67.5;64.3
60;2021-09-28;320;882;557124;531746;67.5;64.4
60;2021-09-29;403;1043;557527;532789;67.6;64.6
60;2021-09-30;366;735;557893;533524;67.6;64.7
60;2021-10-01;411;1035;558304;534559;67.7;64.8
60;2021-10-02;587;1462;558891;536021;67.7;65.0
60;2021-10-03;80;305;558971;536326;67.7;65.0
60;2021-10-04;358;680;559329;537006;67.8;65.1
60;2021-10-05;262;533;559591;537539;67.8;65.2
60;2021-10-06;348;760;559939;538299;67.9;65.2
61;2020-12-27;0;0;0;0;0.0;0.0
61;2020-12-28;0;0;0;0;0.0;0.0
61;2020-12-29;0;0;0;0;0.0;0.0
61;2020-12-30;0;0;0;0;0.0;0.0
61;2020-12-31;0;0;0;0;0.0;0.0
61;2021-01-01;2;0;2;0;0.0;0.0
61;2021-01-02;1;0;3;0;0.0;0.0
61;2021-01-03;0;0;3;0;0.0;0.0
61;2021-01-04;1;0;4;0;0.0;0.0
61;2021-01-05;3;0;7;0;0.0;0.0
61;2021-01-06;77;0;84;0;0.0;0.0
61;2021-01-07;175;2;259;2;0.1;0.0
61;2021-01-08;405;1;664;3;0.2;0.0
61;2021-01-09;165;1;829;4;0.3;0.0
61;2021-01-10;49;0;878;4;0.3;0.0
61;2021-01-11;396;1;1274;5;0.5;0.0
61;2021-01-12;681;2;1955;7;0.7;0.0
61;2021-01-13;740;1;2695;8;1.0;0.0
61;2021-01-14;530;7;3225;15;1.2;0.0
61;2021-01-15;537;4;3762;19;1.4;0.0
61;2021-01-16;289;1;4051;20;1.5;0.0
61;2021-01-17;889;7;4940;27;1.8;0.0
61;2021-01-18;1915;2;6855;29;2.5;0.0
61;2021-01-19;1327;3;8182;32;3.0;0.0
61;2021-01-20;685;0;8867;32;3.2;0.0
61;2021-01-21;848;1;9715;33;3.5;0.0
61;2021-01-22;764;0;10479;33;3.8;0.0
61;2021-01-23;257;2;10736;35;3.9;0.0
61;2021-01-24;229;0;10965;35;4.0;0.0
61;2021-01-25;578;1;11543;36;4.2;0.0
61;2021-01-26;566;0;12109;36;4.4;0.0
61;2021-01-27;572;13;12681;49;4.6;0.0
61;2021-01-28;465;50;13146;99;4.7;0.0
61;2021-01-29;479;131;13625;230;4.9;0.1
61;2021-01-30;212;3;13837;233;5.0;0.1
61;2021-01-31;109;0;13946;233;5.0;0.1
61;2021-02-01;430;178;14376;411;5.2;0.1
61;2021-02-02;389;287;14765;698;5.3;0.3
61;2021-02-03;412;382;15177;1080;5.5;0.4
61;2021-02-04;390;261;15567;1341;5.6;0.5
61;2021-02-05;536;333;16103;1674;5.8;0.6
61;2021-02-06;205;78;16308;1752;5.9;0.6
61;2021-02-07;45;199;16353;1951;5.9;0.7
61;2021-02-08;541;1196;16894;3147;6.1;1.1
61;2021-02-09;404;739;17298;3886;6.2;1.4
61;2021-02-10;280;511;17578;4397;6.3;1.6
61;2021-02-11;432;449;18010;4846;6.5;1.8
61;2021-02-12;401;627;18411;5473;6.6;2.0
61;2021-02-13;133;331;18544;5804;6.7;2.1
61;2021-02-14;3;245;18547;6049;6.7;2.2
61;2021-02-15;169;605;18716;6654;6.8;2.4
61;2021-02-16;203;513;18919;7167;6.8;2.6
61;2021-02-17;44;459;18963;7626;6.8;2.8
61;2021-02-18;161;394;19124;8020;6.9;2.9
61;2021-02-19;101;303;19225;8323;6.9;3.0
61;2021-02-20;40;194;19265;8517;7.0;3.1
61;2021-02-21;2;119;19267;8636;7.0;3.1
61;2021-02-22;88;437;19355;9073;7.0;3.3
61;2021-02-23;104;379;19459;9452;7.0;3.4
61;2021-02-24;173;428;19632;9880;7.1;3.6
61;2021-02-25;265;323;19897;10203;7.2;3.7
61;2021-02-26;266;378;20163;10581;7.3;3.8
61;2021-02-27;110;182;20273;10763;7.3;3.9
61;2021-02-28;4;117;20277;10880;7.3;3.9
61;2021-03-01;215;520;20492;11400;7.4;4.1
61;2021-03-02;148;619;20640;12019;7.5;4.3
61;2021-03-03;143;376;20783;12395;7.5;4.5
61;2021-03-04;429;389;21212;12784;7.7;4.6
61;2021-03-05;702;266;21914;13050;7.9;4.7
61;2021-03-06;436;213;22350;13263;8.1;4.8
61;2021-03-07;155;2;22505;13265;8.1;4.8
61;2021-03-08;295;287;22800;13552;8.2;4.9
61;2021-03-09;622;159;23422;13711;8.5;5.0
61;2021-03-10;672;163;24094;13874;8.7;5.0
61;2021-03-11;1120;119;25214;13993;9.1;5.1
61;2021-03-12;1467;89;26681;14082;9.6;5.1
61;2021-03-13;775;53;27456;14135;9.9;5.1
61;2021-03-14;226;6;27682;14141;10.0;5.1
61;2021-03-15;814;35;28496;14176;10.3;5.1
61;2021-03-16;723;19;29219;14195;10.6;5.1
61;2021-03-17;761;12;29980;14207;10.8;5.1
61;2021-03-18;858;26;30838;14233;11.1;5.1
61;2021-03-19;1026;50;31864;14283;11.5;5.2
61;2021-03-20;478;15;32342;14298;11.7;5.2
61;2021-03-21;72;2;32414;14300;11.7;5.2
61;2021-03-22;797;92;33211;14392;12.0;5.2
61;2021-03-23;920;39;34131;14431;12.3;5.2
61;2021-03-24;1373;70;35504;14501;12.8;5.2
61;2021-03-25;1876;67;37380;14568;13.5;5.3
61;2021-03-26;1800;47;39180;14615;14.1;5.3
61;2021-03-27;1083;18;40263;14633;14.5;5.3
61;2021-03-28;359;9;40622;14642;14.7;5.3
61;2021-03-29;1273;182;41895;14824;15.1;5.4
61;2021-03-30;1470;98;43365;14922;15.7;5.4
61;2021-03-31;1687;52;45052;14974;16.3;5.4
61;2021-04-01;2051;231;47103;15205;17.0;5.5
61;2021-04-02;1519;432;48622;15637;17.6;5.6
61;2021-04-03;640;285;49262;15922;17.8;5.8
61;2021-04-04;193;1;49455;15923;17.9;5.8
61;2021-04-05;533;8;49988;15931;18.1;5.8
61;2021-04-06;1350;618;51338;16549;18.5;6.0
61;2021-04-07;1697;657;53035;17206;19.2;6.2
61;2021-04-08;2266;833;55301;18039;20.0;6.5
61;2021-04-09;2135;831;57436;18870;20.7;6.8
61;2021-04-10;1534;484;58970;19354;21.3;7.0
61;2021-04-11;238;199;59208;19553;21.4;7.1
61;2021-04-12;1284;734;60492;20287;21.8;7.3
61;2021-04-13;1740;705;62232;20992;22.5;7.6
61;2021-04-14;1734;784;63966;21776;23.1;7.9
61;2021-04-15;2268;782;66234;22558;23.9;8.1
61;2021-04-16;2227;689;68461;23247;24.7;8.4
61;2021-04-17;1483;320;69944;23567;25.3;8.5
61;2021-04-18;538;99;70482;23666;25.5;8.5
61;2021-04-19;936;750;71418;24416;25.8;8.8
61;2021-04-20;1523;786;72941;25202;26.3;9.1
61;2021-04-21;1351;1040;74292;26242;26.8;9.5
61;2021-04-22;1292;1218;75584;27460;27.3;9.9
61;2021-04-23;1213;1148;76797;28608;27.7;10.3
61;2021-04-24;1437;819;78234;29427;28.3;10.6
61;2021-04-25;361;331;78595;29758;28.4;10.7
61;2021-04-26;670;1143;79265;30901;28.6;11.2
61;2021-04-27;1465;1138;80730;32039;29.2;11.6
61;2021-04-28;1386;1390;82116;33429;29.7;12.1
61;2021-04-29;1246;1858;83362;35287;30.1;12.7
61;2021-04-30;1719;1174;85081;36461;30.7;13.2
61;2021-05-01;789;322;85870;36783;31.0;13.3
61;2021-05-02;439;226;86309;37009;31.2;13.4
61;2021-05-03;843;1250;87152;38259;31.5;13.8
61;2021-05-04;1323;1749;88475;40008;32.0;14.4
61;2021-05-05;1008;2027;89483;42035;32.3;15.2
61;2021-05-06;1772;2211;91255;44246;33.0;16.0
61;2021-05-07;1376;1971;92631;46217;33.5;16.7
61;2021-05-08;929;472;93560;46689;33.8;16.9
61;2021-05-09;395;293;93955;46982;33.9;17.0
61;2021-05-10;987;1746;94942;48728;34.3;17.6
61;2021-05-11;1377;1515;96319;50243;34.8;18.1
61;2021-05-12;1869;1592;98188;51835;35.5;18.7
61;2021-05-13;889;491;99077;52326;35.8;18.9
61;2021-05-14;1851;1186;100928;53512;36.4;19.3
61;2021-05-15;2108;1117;103036;54629;37.2;19.7
61;2021-05-16;984;300;104020;54929;37.6;19.8
61;2021-05-17;1312;914;105332;55843;38.0;20.2
61;2021-05-18;2423;894;107755;56737;38.9;20.5
61;2021-05-19;2400;804;110155;57541;39.8;20.8
61;2021-05-20;2212;816;112367;58357;40.6;21.1
61;2021-05-21;2150;861;114517;59218;41.4;21.4
61;2021-05-22;1780;718;116297;59936;42.0;21.6
61;2021-05-23;714;54;117011;59990;42.3;21.7
61;2021-05-24;914;112;117925;60102;42.6;21.7
61;2021-05-25;1991;920;119916;61022;43.3;22.0
61;2021-05-26;2046;932;121962;61954;44.0;22.4
61;2021-05-27;2041;1089;124003;63043;44.8;22.8
61;2021-05-28;2052;1374;126055;64417;45.5;23.3
61;2021-05-29;1466;557;127521;64974;46.1;23.5
61;2021-05-30;450;44;127971;65018;46.2;23.5
61;2021-05-31;1559;936;129530;65954;46.8;23.8
61;2021-06-01;1875;1387;131405;67341;47.5;24.3
61;2021-06-02;1676;1133;133081;68474;48.1;24.7
61;2021-06-03;2250;1110;135331;69584;48.9;25.1
61;2021-06-04;1897;1344;137228;70928;49.6;25.6
61;2021-06-05;1669;1240;138897;72168;50.2;26.1
61;2021-06-06;318;230;139215;72398;50.3;26.1
61;2021-06-07;2189;867;141404;73265;51.1;26.5
61;2021-06-08;1847;1566;143251;74831;51.7;27.0
61;2021-06-09;1975;1185;145226;76016;52.4;27.5
61;2021-06-10;1974;1192;147200;77208;53.2;27.9
61;2021-06-11;1823;1579;149023;78787;53.8;28.5
61;2021-06-12;1424;999;150447;79786;54.3;28.8
61;2021-06-13;340;377;150787;80163;54.5;28.9
61;2021-06-14;1107;1187;151894;81350;54.9;29.4
61;2021-06-15;1214;1694;153108;83044;55.3;30.0
61;2021-06-16;1114;1363;154222;84407;55.7;30.5
61;2021-06-17;1020;1730;155242;86137;56.1;31.1
61;2021-06-18;1523;1671;156765;87808;56.6;31.7
61;2021-06-19;1245;1302;158010;89110;57.1;32.2
61;2021-06-20;289;345;158299;89455;57.2;32.3
61;2021-06-21;807;1627;159106;91082;57.5;32.9
61;2021-06-22;1024;1680;160130;92762;57.8;33.5
61;2021-06-23;967;2436;161097;95198;58.2;34.4
61;2021-06-24;650;1361;161747;96559;58.4;34.9
61;2021-06-25;839;2166;162586;98725;58.7;35.7
61;2021-06-26;623;1955;163209;100680;58.9;36.4
61;2021-06-27;139;799;163348;101479;59.0;36.6
61;2021-06-28;478;2245;163826;103724;59.2;37.5
61;2021-06-29;699;2858;164525;106582;59.4;38.5
61;2021-06-30;771;2463;165296;109045;59.7;39.4
61;2021-07-01;633;1697;165929;110742;59.9;40.0
61;2021-07-02;842;2496;166771;113238;60.2;40.9
61;2021-07-03;417;1910;167188;115148;60.4;41.6
61;2021-07-04;75;638;167263;115786;60.4;41.8
61;2021-07-05;682;1774;167945;117560;60.7;42.5
61;2021-07-06;991;2792;168936;120352;61.0;43.5
61;2021-07-07;734;2360;169670;122712;61.3;44.3
61;2021-07-08;840;1944;170510;124656;61.6;45.0
61;2021-07-09;723;2375;171233;127031;61.8;45.9
61;2021-07-10;463;1767;171696;128798;62.0;46.5
61;2021-07-11;244;489;171940;129287;62.1;46.7
61;2021-07-12;438;2290;172378;131577;62.3;47.5
61;2021-07-13;643;2486;173021;134063;62.5;48.4
61;2021-07-14;150;334;173171;134397;62.5;48.5
61;2021-07-15;815;2814;173986;137211;62.8;49.6
61;2021-07-16;967;2569;174953;139780;63.2;50.5
61;2021-07-17;708;2232;175661;142012;63.4;51.3
61;2021-07-18;339;368;176000;142380;63.6;51.4
61;2021-07-19;934;2399;176934;144779;63.9;52.3
61;2021-07-20;1327;2354;178261;147133;64.4;53.1
61;2021-07-21;1503;2181;179764;149314;64.9;53.9
61;2021-07-22;1750;2188;181514;151502;65.6;54.7
61;2021-07-23;1793;2306;183307;153808;66.2;55.5
61;2021-07-24;1457;2008;184764;155816;66.7;56.3
61;2021-07-25;323;393;185087;156209;66.8;56.4
61;2021-07-26;1252;1933;186339;158142;67.3;57.1
61;2021-07-27;2420;1583;188759;159725;68.2;57.7
61;2021-07-28;2457;1355;191216;161080;69.1;58.2
61;2021-07-29;2563;1576;193779;162656;70.0;58.7
61;2021-07-30;2396;1388;196175;164044;70.8;59.2
61;2021-07-31;1282;1301;197457;165345;71.3;59.7
61;2021-08-01;504;259;197961;165604;71.5;59.8
61;2021-08-02;1913;1122;199874;166726;72.2;60.2
61;2021-08-03;2451;915;202325;167641;73.1;60.5
61;2021-08-04;2344;781;204669;168422;73.9;60.8
61;2021-08-05;1901;990;206570;169412;74.6;61.2
61;2021-08-06;2164;1163;208734;170575;75.4;61.6
61;2021-08-07;1422;799;210156;171374;75.9;61.9
61;2021-08-08;447;263;210603;171637;76.1;62.0
61;2021-08-09;1310;1112;211913;172749;76.5;62.4
61;2021-08-10;1315;1107;213228;173856;77.0;62.8
61;2021-08-11;1117;1257;214345;175113;77.4;63.2
61;2021-08-12;1038;1321;215383;176434;77.8;63.7
61;2021-08-13;879;1610;216262;178044;78.1;64.3
61;2021-08-14;717;864;216979;178908;78.4;64.6
61;2021-08-15;94;183;217073;179091;78.4;64.7
61;2021-08-16;913;1541;217986;180632;78.7;65.2
61;2021-08-17;1152;1701;219138;182333;79.1;65.8
61;2021-08-18;811;1479;219949;183812;79.4;66.4
61;2021-08-19;745;1570;220694;185382;79.7;66.9
61;2021-08-20;800;2131;221494;187513;80.0;67.7
61;2021-08-21;491;1344;221985;188857;80.2;68.2
61;2021-08-22;137;447;222122;189304;80.2;68.4
61;2021-08-23;415;1702;222537;191006;80.4;69.0
61;2021-08-24;528;1899;223065;192905;80.6;69.7
61;2021-08-25;412;1735;223477;194640;80.7;70.3
61;2021-08-26;429;1598;223906;196238;80.9;70.9
61;2021-08-27;515;1889;224421;198127;81.0;71.6
61;2021-08-28;285;1365;224706;199492;81.1;72.0
61;2021-08-29;50;417;224756;199909;81.2;72.2
61;2021-08-30;400;1625;225156;201534;81.3;72.8
61;2021-08-31;505;1713;225661;203247;81.5;73.4
61;2021-09-01;454;1499;226115;204746;81.7;73.9
61;2021-09-02;421;1341;226536;206087;81.8;74.4
61;2021-09-03;476;1580;227012;207667;82.0;75.0
61;2021-09-04;348;1337;227360;209004;82.1;75.5
61;2021-09-05;76;225;227436;209229;82.1;75.6
61;2021-09-06;286;1232;227722;210461;82.2;76.0
61;2021-09-07;363;1568;228085;212029;82.4;76.6
61;2021-09-08;274;1432;228359;213461;82.5;77.1
61;2021-09-09;288;1206;228647;214667;82.6;77.5
61;2021-09-10;366;1169;229013;215836;82.7;77.9
61;2021-09-11;270;1101;229283;216937;82.8;78.3
61;2021-09-12;37;127;229320;217064;82.8;78.4
61;2021-09-13;208;866;229528;217930;82.9;78.7
61;2021-09-14;196;693;229724;218623;83.0;79.0
61;2021-09-15;256;595;229980;219218;83.1;79.2
61;2021-09-16;220;269;230200;219487;83.1;79.3
61;2021-09-17;241;533;230441;220020;83.2;79.5
61;2021-09-18;217;611;230658;220631;83.3;79.7
61;2021-09-19;1;0;230659;220631;83.3;79.7
61;2021-09-20;177;267;230836;220898;83.4;79.8
61;2021-09-21;236;187;231072;221085;83.4;79.8
61;2021-09-22;158;692;231230;221777;83.5;80.1
61;2021-09-23;163;228;231393;222005;83.6;80.2
61;2021-09-24;135;378;231528;222383;83.6;80.3
61;2021-09-25;171;596;231699;222979;83.7;80.5
61;2021-09-26;9;16;231708;222995;83.7;80.5
61;2021-09-27;124;293;231832;223288;83.7;80.6
61;2021-09-28;96;247;231928;223535;83.8;80.7
61;2021-09-29;106;216;232034;223751;83.8;80.8
61;2021-09-30;204;237;232238;223988;83.9;80.9
61;2021-10-01;85;265;232323;224253;83.9;81.0
61;2021-10-02;197;565;232520;224818;84.0;81.2
61;2021-10-03;1;8;232521;224826;84.0;81.2
61;2021-10-04;107;287;232628;225113;84.0;81.3
61;2021-10-05;112;289;232740;225402;84.1;81.4
61;2021-10-06;152;320;232892;225722;84.1;81.5
62;2020-12-27;2;0;2;0;0.0;0.0
62;2020-12-28;1;0;3;0;0.0;0.0
62;2020-12-29;0;0;3;0;0.0;0.0
62;2020-12-30;0;0;3;0;0.0;0.0
62;2020-12-31;0;0;3;0;0.0;0.0
62;2021-01-01;0;0;3;0;0.0;0.0
62;2021-01-02;3;0;6;0;0.0;0.0
62;2021-01-03;0;0;6;0;0.0;0.0
62;2021-01-04;3;0;9;0;0.0;0.0
62;2021-01-05;47;0;56;0;0.0;0.0
62;2021-01-06;123;0;179;0;0.0;0.0
62;2021-01-07;351;0;530;0;0.0;0.0
62;2021-01-08;713;7;1243;7;0.1;0.0
62;2021-01-09;164;1;1407;8;0.1;0.0
62;2021-01-10;84;0;1491;8;0.1;0.0
62;2021-01-11;557;1;2048;9;0.1;0.0
62;2021-01-12;1260;3;3308;12;0.2;0.0
62;2021-01-13;1139;6;4447;18;0.3;0.0
62;2021-01-14;1385;8;5832;26;0.4;0.0
62;2021-01-15;1300;8;7132;34;0.5;0.0
62;2021-01-16;309;2;7441;36;0.5;0.0
62;2021-01-17;107;0;7548;36;0.5;0.0
62;2021-01-18;1666;8;9214;44;0.6;0.0
62;2021-01-19;2104;4;11318;48;0.8;0.0
62;2021-01-20;2055;5;13373;53;0.9;0.0
62;2021-01-21;2244;5;15617;58;1.1;0.0
62;2021-01-22;1835;7;17452;65;1.2;0.0
62;2021-01-23;512;1;17964;66;1.2;0.0
62;2021-01-24;0;0;17964;66;1.2;0.0
62;2021-01-25;1286;6;19250;72;1.3;0.0
62;2021-01-26;1546;13;20796;85;1.4;0.0
62;2021-01-27;1518;139;22314;224;1.5;0.0
62;2021-01-28;4181;344;26495;568;1.8;0.0
62;2021-01-29;2048;304;28543;872;2.0;0.1
62;2021-01-30;159;128;28702;1000;2.0;0.1
62;2021-01-31;22;3;28724;1003;2.0;0.1
62;2021-02-01;46;317;28770;1320;2.0;0.1
62;2021-02-02;59;736;28829;2056;2.0;0.1
62;2021-02-03;44;574;28873;2630;2.0;0.2
62;2021-02-04;81;744;28954;3374;2.0;0.2
62;2021-02-05;81;635;29035;4009;2.0;0.3
62;2021-02-06;32;155;29067;4164;2.0;0.3
62;2021-02-07;236;30;29303;4194;2.0;0.3
62;2021-02-08;133;675;29436;4869;2.0;0.3
62;2021-02-09;227;912;29663;5781;2.0;0.4
62;2021-02-10;385;996;30048;6777;2.1;0.5
62;2021-02-11;726;846;30774;7623;2.1;0.5
62;2021-02-12;967;640;31741;8263;2.2;0.6
62;2021-02-13;162;209;31903;8472;2.2;0.6
62;2021-02-14;0;0;31903;8472;2.2;0.6
62;2021-02-15;665;926;32568;9398;2.2;0.6
62;2021-02-16;923;1376;33491;10774;2.3;0.7
62;2021-02-17;1082;1619;34573;12393;2.4;0.9
62;2021-02-18;2227;3409;36800;15802;2.5;1.1
62;2021-02-19;2312;2263;39112;18065;2.7;1.2
62;2021-02-20;616;372;39728;18437;2.7;1.3
62;2021-02-21;88;26;39816;18463;2.7;1.3
62;2021-02-22;849;713;40665;19176;2.8;1.3
62;2021-02-23;1419;995;42084;20171;2.9;1.4
62;2021-02-24;1547;537;43631;20708;3.0;1.4
62;2021-02-25;3169;371;46800;21079;3.2;1.5
62;2021-02-26;2912;302;49712;21381;3.4;1.5
62;2021-02-27;1829;85;51541;21466;3.5;1.5
62;2021-02-28;52;42;51593;21508;3.6;1.5
62;2021-03-01;1322;103;52915;21611;3.6;1.5
62;2021-03-02;3156;161;56071;21772;3.9;1.5
62;2021-03-03;3274;131;59345;21903;4.1;1.5
62;2021-03-04;3809;216;63154;22119;4.3;1.5
62;2021-03-05;4647;230;67801;22349;4.7;1.5
62;2021-03-06;9619;266;77420;22615;5.3;1.6
62;2021-03-07;8074;226;85494;22841;5.9;1.6
62;2021-03-08;2195;234;87689;23075;6.0;1.6
62;2021-03-09;3810;352;91499;23427;6.3;1.6
62;2021-03-10;4233;565;95732;23992;6.6;1.7
62;2021-03-11;5993;1484;101725;25476;7.0;1.8
62;2021-03-12;6639;1380;108364;26856;7.5;1.8
62;2021-03-13;14723;800;123087;27656;8.5;1.9
62;2021-03-14;9583;411;132670;28067;9.1;1.9
62;2021-03-15;3762;996;136432;29063;9.4;2.0
62;2021-03-16;2736;834;139168;29897;9.6;2.1
62;2021-03-17;2805;724;141973;30621;9.8;2.1
62;2021-03-18;2725;941;144698;31562;10.0;2.2
62;2021-03-19;4784;910;149482;32472;10.3;2.2
62;2021-03-20;11066;620;160548;33092;11.1;2.3
62;2021-03-21;9447;374;169995;33466;11.7;2.3
62;2021-03-22;2943;1089;172938;34555;11.9;2.4
62;2021-03-23;4997;1473;177935;36028;12.2;2.5
62;2021-03-24;4696;1363;182631;37391;12.6;2.6
62;2021-03-25;6553;1463;189184;38854;13.0;2.7
62;2021-03-26;7048;1489;196232;40343;13.5;2.8
62;2021-03-27;12593;753;208825;41096;14.4;2.8
62;2021-03-28;6941;289;215766;41385;14.9;2.8
62;2021-03-29;3470;1202;219236;42587;15.1;2.9
62;2021-03-30;4549;2204;223785;44791;15.4;3.1
62;2021-03-31;4225;2461;228010;47252;15.7;3.3
62;2021-04-01;4977;2762;232987;50014;16.0;3.4
62;2021-04-02;5067;3231;238054;53245;16.4;3.7
62;2021-04-03;8208;3347;246262;56592;17.0;3.9
62;2021-04-04;4582;1934;250844;58526;17.3;4.0
62;2021-04-05;944;461;251788;58987;17.3;4.1
62;2021-04-06;4122;3010;255910;61997;17.6;4.3
62;2021-04-07;5071;3520;260981;65517;18.0;4.5
62;2021-04-08;6493;3988;267474;69505;18.4;4.8
62;2021-04-09;7628;3478;275102;72983;18.9;5.0
62;2021-04-10;6636;8071;281738;81054;19.4;5.6
62;2021-04-11;2804;6881;284542;87935;19.6;6.1
62;2021-04-12;3419;2385;287961;90320;19.8;6.2
62;2021-04-13;6171;3165;294132;93485;20.2;6.4
62;2021-04-14;5307;3065;299439;96550;20.6;6.6
62;2021-04-15;5733;2987;305172;99537;21.0;6.9
62;2021-04-16;5418;3200;310590;102737;21.4;7.1
62;2021-04-17;4355;7355;314945;110092;21.7;7.6
62;2021-04-18;1957;6847;316902;116939;21.8;8.0
62;2021-04-19;2777;1934;319679;118873;22.0;8.2
62;2021-04-20;4148;3887;323827;122760;22.3;8.5
62;2021-04-21;3746;3985;327573;126745;22.5;8.7
62;2021-04-22;3948;5189;331521;131934;22.8;9.1
62;2021-04-23;4064;5322;335585;137256;23.1;9.4
62;2021-04-24;4401;6726;339986;143982;23.4;9.9
62;2021-04-25;1911;3498;341897;147480;23.5;10.2
62;2021-04-26;2223;2420;344120;149900;23.7;10.3
62;2021-04-27;4408;3743;348528;153643;24.0;10.6
62;2021-04-28;4591;4399;353119;158042;24.3;10.9
62;2021-04-29;4787;5849;357906;163891;24.6;11.3
62;2021-04-30;5215;5687;363121;169578;25.0;11.7
62;2021-05-01;5725;3473;368846;173051;25.4;11.9
62;2021-05-02;7826;3147;376672;176198;25.9;12.1
62;2021-05-03;4509;2337;381181;178535;26.2;12.3
62;2021-05-04;5396;4964;386577;183499;26.6;12.6
62;2021-05-05;4736;4823;391313;188322;26.9;13.0
62;2021-05-06;5619;4937;396932;193259;27.3;13.3
62;2021-05-07;7691;4657;404623;197916;27.9;13.6
62;2021-05-08;10659;2329;415282;200245;28.6;13.8
62;2021-05-09;8625;1642;423907;201887;29.2;13.9
62;2021-05-10;4867;4018;428774;205905;29.5;14.2
62;2021-05-11;6414;5039;435188;210944;30.0;14.5
62;2021-05-12;8624;4589;443812;215533;30.5;14.8
62;2021-05-13;9998;1491;453810;217024;31.2;14.9
62;2021-05-14;11880;3392;465690;220416;32.1;15.2
62;2021-05-15;19781;3296;485471;223712;33.4;15.4
62;2021-05-16;16399;1422;501870;225134;34.5;15.5
62;2021-05-17;8180;2657;510050;227791;35.1;15.7
62;2021-05-18;9326;3128;519376;230919;35.8;15.9
62;2021-05-19;8615;2927;527991;233846;36.3;16.1
62;2021-05-20;8341;3840;536332;237686;36.9;16.4
62;2021-05-21;9397;4215;545729;241901;37.6;16.7
62;2021-05-22;17874;3526;563603;245427;38.8;16.9
62;2021-05-23;12373;1162;575976;246589;39.6;17.0
62;2021-05-24;3911;586;579887;247175;39.9;17.0
62;2021-05-25;7221;4097;587108;251272;40.4;17.3
62;2021-05-26;6782;4913;593890;256185;40.9;17.6
62;2021-05-27;6382;5686;600272;261871;41.3;18.0
62;2021-05-28;6518;6730;606790;268601;41.8;18.5
62;2021-05-29;10849;5536;617639;274137;42.5;18.9
62;2021-05-30;4036;982;621675;275119;42.8;18.9
62;2021-05-31;4794;3947;626469;279066;43.1;19.2
62;2021-06-01;6520;6507;632989;285573;43.6;19.7
62;2021-06-02;7444;5810;640433;291383;44.1;20.1
62;2021-06-03;7854;5878;648287;297261;44.6;20.5
62;2021-06-04;7903;6239;656190;303500;45.2;20.9
62;2021-06-05;8273;6225;664463;309725;45.7;21.3
62;2021-06-06;3128;1290;667591;311015;46.0;21.4
62;2021-06-07;4625;3764;672216;314779;46.3;21.7
62;2021-06-08;6207;5902;678423;320681;46.7;22.1
62;2021-06-09;5498;4763;683921;325444;47.1;22.4
62;2021-06-10;5207;5863;689128;331307;47.4;22.8
62;2021-06-11;6208;8867;695336;340174;47.9;23.4
62;2021-06-12;5935;8644;701271;348818;48.3;24.0
62;2021-06-13;3225;3793;704496;352611;48.5;24.3
62;2021-06-14;2610;6771;707106;359382;48.7;24.7
62;2021-06-15;4675;8529;711781;367911;49.0;25.3
62;2021-06-16;5081;7429;716862;375340;49.3;25.8
62;2021-06-17;5235;8041;722097;383381;49.7;26.4
62;2021-06-18;4825;10491;726922;393872;50.0;27.1
62;2021-06-19;5794;13435;732716;407307;50.4;28.0
62;2021-06-20;2101;4369;734817;411676;50.6;28.3
62;2021-06-21;2976;8923;737793;420599;50.8;29.0
62;2021-06-22;3431;10169;741224;430768;51.0;29.7
62;2021-06-23;3387;10315;744611;441083;51.3;30.4
62;2021-06-24;3346;11784;747957;452867;51.5;31.2
62;2021-06-25;3724;15762;751681;468629;51.7;32.3
62;2021-06-26;3549;18423;755230;487052;52.0;33.5
62;2021-06-27;1121;9814;756351;496866;52.1;34.2
62;2021-06-28;1923;8866;758274;505732;52.2;34.8
62;2021-06-29;2973;11461;761247;517193;52.4;35.6
62;2021-06-30;4142;10809;765389;528002;52.7;36.3
62;2021-07-01;4483;10483;769872;538485;53.0;37.1
62;2021-07-02;4161;11979;774033;550464;53.3;37.9
62;2021-07-03;2997;18052;777030;568516;53.5;39.1
62;2021-07-04;1451;9196;778481;577712;53.6;39.8
62;2021-07-05;2416;6913;780897;584625;53.8;40.2
62;2021-07-06;3821;10012;784718;594637;54.0;40.9
62;2021-07-07;3917;8913;788635;603550;54.3;41.5
62;2021-07-08;5247;9082;793882;612632;54.6;42.2
62;2021-07-09;4472;10842;798354;623474;55.0;42.9
62;2021-07-10;4975;11890;803329;635364;55.3;43.7
62;2021-07-11;1337;2088;804666;637452;55.4;43.9
62;2021-07-12;2327;7133;806993;644585;55.5;44.4
62;2021-07-13;5175;12153;812168;656738;55.9;45.2
62;2021-07-14;3634;3164;815802;659902;56.2;45.4
62;2021-07-15;7587;11492;823389;671394;56.7;46.2
62;2021-07-16;7625;11044;831014;682438;57.2;47.0
62;2021-07-17;9719;10330;840733;692768;57.9;47.7
62;2021-07-18;2712;3457;843445;696225;58.1;47.9
62;2021-07-19;6013;7013;849458;703238;58.5;48.4
62;2021-07-20;7935;10721;857393;713959;59.0;49.1
62;2021-07-21;9776;9406;867169;723365;59.7;49.8
62;2021-07-22;9800;9013;876969;732378;60.4;50.4
62;2021-07-23;10629;8405;887598;740783;61.1;51.0
62;2021-07-24;9664;10318;897262;751101;61.8;51.7
62;2021-07-25;5549;1877;902811;752978;62.1;51.8
62;2021-07-26;6239;5385;909050;758363;62.6;52.2
62;2021-07-27;9851;8125;918901;766488;63.3;52.8
62;2021-07-28;10405;7488;929306;773976;64.0;53.3
62;2021-07-29;12006;7657;941312;781633;64.8;53.8
62;2021-07-30;9092;6290;950404;787923;65.4;54.2
62;2021-07-31;6639;4023;957043;791946;65.9;54.5
62;2021-08-01;2342;1103;959385;793049;66.0;54.6
62;2021-08-02;6866;4759;966251;797808;66.5;54.9
62;2021-08-03;8629;7473;974880;805281;67.1;55.4
62;2021-08-04;9491;5483;984371;810764;67.8;55.8
62;2021-08-05;8376;5633;992747;816397;68.3;56.2
62;2021-08-06;7321;5932;1000068;822329;68.8;56.6
62;2021-08-07;5493;4958;1005561;827287;69.2;56.9
62;2021-08-08;1875;1301;1007436;828588;69.3;57.0
62;2021-08-09;5262;5031;1012698;833619;69.7;57.4
62;2021-08-10;6221;7358;1018919;840977;70.1;57.9
62;2021-08-11;5415;7381;1024334;848358;70.5;58.4
62;2021-08-12;6008;7002;1030342;855360;70.9;58.9
62;2021-08-13;4522;6061;1034864;861421;71.2;59.3
62;2021-08-14;3838;6868;1038702;868289;71.5;59.8
62;2021-08-15;1141;1212;1039843;869501;71.6;59.9
62;2021-08-16;3188;5864;1043031;875365;71.8;60.3
62;2021-08-17;4172;7347;1047203;882712;72.1;60.8
62;2021-08-18;4361;7244;1051564;889956;72.4;61.3
62;2021-08-19;4392;8581;1055956;898537;72.7;61.8
62;2021-08-20;3445;8464;1059401;907001;72.9;62.4
62;2021-08-21;2459;9765;1061860;916766;73.1;63.1
62;2021-08-22;392;2816;1062252;919582;73.1;63.3
62;2021-08-23;2746;7830;1064998;927412;73.3;63.8
62;2021-08-24;3840;10408;1068838;937820;73.6;64.6
62;2021-08-25;3509;9197;1072347;947017;73.8;65.2
62;2021-08-26;3193;9773;1075540;956790;74.0;65.9
62;2021-08-27;2598;8826;1078138;965616;74.2;66.5
62;2021-08-28;2043;7997;1080181;973613;74.4;67.0
62;2021-08-29;864;2253;1081045;975866;74.4;67.2
62;2021-08-30;2047;7387;1083092;983253;74.6;67.7
62;2021-08-31;2141;8022;1085233;991275;74.7;68.2
62;2021-09-01;1825;6169;1087058;997444;74.8;68.7
62;2021-09-02;1853;6851;1088911;1004295;75.0;69.1
62;2021-09-03;2071;7443;1090982;1011738;75.1;69.6
62;2021-09-04;2123;6680;1093105;1018418;75.2;70.1
62;2021-09-05;319;1265;1093424;1019683;75.3;70.2
62;2021-09-06;1030;3811;1094454;1023494;75.3;70.5
62;2021-09-07;1234;4350;1095688;1027844;75.4;70.8
62;2021-09-08;1286;4558;1096974;1032402;75.5;71.1
62;2021-09-09;1274;4713;1098248;1037115;75.6;71.4
62;2021-09-10;1591;4965;1099839;1042080;75.7;71.7
62;2021-09-11;1272;4291;1101111;1046371;75.8;72.0
62;2021-09-12;201;547;1101312;1046918;75.8;72.1
62;2021-09-13;775;2755;1102087;1049673;75.9;72.3
62;2021-09-14;1269;4267;1103356;1053940;75.9;72.5
62;2021-09-15;1337;4219;1104693;1058159;76.0;72.8
62;2021-09-16;1373;2913;1106066;1061072;76.1;73.0
62;2021-09-17;1327;2416;1107393;1063488;76.2;73.2
62;2021-09-18;1080;2882;1108473;1066370;76.3;73.4
62;2021-09-19;136;448;1108609;1066818;76.3;73.4
62;2021-09-20;600;1475;1109209;1068293;76.4;73.5
62;2021-09-21;885;2423;1110094;1070716;76.4;73.7
62;2021-09-22;790;2672;1110884;1073388;76.5;73.9
62;2021-09-23;724;1837;1111608;1075225;76.5;74.0
62;2021-09-24;812;1985;1112420;1077210;76.6;74.1
62;2021-09-25;716;2669;1113136;1079879;76.6;74.3
62;2021-09-26;73;373;1113209;1080252;76.6;74.4
62;2021-09-27;317;1055;1113526;1081307;76.6;74.4
62;2021-09-28;584;1704;1114110;1083011;76.7;74.5
62;2021-09-29;760;1901;1114870;1084912;76.7;74.7
62;2021-09-30;446;1005;1115316;1085917;76.8;74.7
62;2021-10-01;697;1657;1116013;1087574;76.8;74.9
62;2021-10-02;697;1496;1116710;1089070;76.9;75.0
62;2021-10-03;81;236;1116791;1089306;76.9;75.0
62;2021-10-04;373;788;1117164;1090094;76.9;75.0
62;2021-10-05;593;1452;1117757;1091546;76.9;75.1
62;2021-10-06;558;1241;1118315;1092787;77.0;75.2
63;2020-12-27;0;0;0;0;0.0;0.0
63;2020-12-28;1;0;1;0;0.0;0.0
63;2020-12-29;0;0;1;0;0.0;0.0
63;2020-12-30;0;0;1;0;0.0;0.0
63;2020-12-31;0;0;1;0;0.0;0.0
63;2021-01-01;1;0;2;0;0.0;0.0
63;2021-01-02;0;0;2;0;0.0;0.0
63;2021-01-03;1;0;3;0;0.0;0.0
63;2021-01-04;0;0;3;0;0.0;0.0
63;2021-01-05;1;0;4;0;0.0;0.0
63;2021-01-06;4;1;8;1;0.0;0.0
63;2021-01-07;310;0;318;1;0.0;0.0
63;2021-01-08;217;0;535;1;0.1;0.0
63;2021-01-09;91;0;626;1;0.1;0.0
63;2021-01-10;82;0;708;1;0.1;0.0
63;2021-01-11;432;2;1140;3;0.2;0.0
63;2021-01-12;661;1;1801;4;0.3;0.0
63;2021-01-13;873;2;2674;6;0.4;0.0
63;2021-01-14;547;8;3221;14;0.5;0.0
63;2021-01-15;432;3;3653;17;0.6;0.0
63;2021-01-16;157;0;3810;17;0.6;0.0
63;2021-01-17;133;0;3943;17;0.6;0.0
63;2021-01-18;634;2;4577;19;0.7;0.0
63;2021-01-19;868;2;5445;21;0.8;0.0
63;2021-01-20;1069;1;6514;22;1.0;0.0
63;2021-01-21;1018;3;7532;25;1.1;0.0
63;2021-01-22;970;3;8502;28;1.3;0.0
63;2021-01-23;192;0;8694;28;1.3;0.0
63;2021-01-24;165;2;8859;30;1.3;0.0
63;2021-01-25;829;0;9688;30;1.5;0.0
63;2021-01-26;974;2;10662;32;1.6;0.0
63;2021-01-27;1003;4;11665;36;1.8;0.0
63;2021-01-28;1322;67;12987;103;2.0;0.0
63;2021-01-29;1066;62;14053;165;2.1;0.0
63;2021-01-30;68;0;14121;165;2.1;0.0
63;2021-01-31;6;0;14127;165;2.1;0.0
63;2021-02-01;575;162;14702;327;2.2;0.0
63;2021-02-02;886;219;15588;546;2.4;0.1
63;2021-02-03;1475;269;17063;815;2.6;0.1
63;2021-02-04;2120;489;19183;1304;2.9;0.2
63;2021-02-05;1144;253;20327;1557;3.1;0.2
63;2021-02-06;116;0;20443;1557;3.1;0.2
63;2021-02-07;9;1;20452;1558;3.1;0.2
63;2021-02-08;538;345;20990;1903;3.2;0.3
63;2021-02-09;671;359;21661;2262;3.3;0.3
63;2021-02-10;609;508;22270;2770;3.4;0.4
63;2021-02-11;751;404;23021;3174;3.5;0.5
63;2021-02-12;820;732;23841;3906;3.6;0.6
63;2021-02-13;82;1;23923;3907;3.6;0.6
63;2021-02-14;0;57;23923;3964;3.6;0.6
63;2021-02-15;202;620;24125;4584;3.7;0.7
63;2021-02-16;409;952;24534;5536;3.7;0.8
63;2021-02-17;359;666;24893;6202;3.8;0.9
63;2021-02-18;608;659;25501;6861;3.9;1.0
63;2021-02-19;449;764;25950;7625;3.9;1.2
63;2021-02-20;35;17;25985;7642;3.9;1.2
63;2021-02-21;2;9;25987;7651;3.9;1.2
63;2021-02-22;291;689;26278;8340;4.0;1.3
63;2021-02-23;580;881;26858;9221;4.1;1.4
63;2021-02-24;696;1202;27554;10423;4.2;1.6
63;2021-02-25;1603;1437;29157;11860;4.4;1.8
63;2021-02-26;1623;1195;30780;13055;4.7;2.0
63;2021-02-27;641;66;31421;13121;4.8;2.0
63;2021-02-28;4;177;31425;13298;4.8;2.0
63;2021-03-01;586;403;32011;13701;4.8;2.1
63;2021-03-02;907;652;32918;14353;5.0;2.2
63;2021-03-03;1036;591;33954;14944;5.1;2.3
63;2021-03-04;1754;424;35708;15368;5.4;2.3
63;2021-03-05;2612;621;38320;15989;5.8;2.4
63;2021-03-06;1551;53;39871;16042;6.0;2.4
63;2021-03-07;513;19;40384;16061;6.1;2.4
63;2021-03-08;967;564;41351;16625;6.3;2.5
63;2021-03-09;1539;904;42890;17529;6.5;2.7
63;2021-03-10;1654;544;44544;18073;6.7;2.7
63;2021-03-11;3056;854;47600;18927;7.2;2.9
63;2021-03-12;3513;380;51113;19307;7.7;2.9
63;2021-03-13;2048;81;53161;19388;8.1;2.9
63;2021-03-14;61;21;53222;19409;8.1;2.9
63;2021-03-15;1770;359;54992;19768;8.3;3.0
63;2021-03-16;1747;390;56739;20158;8.6;3.1
63;2021-03-17;1642;652;58381;20810;8.8;3.2
63;2021-03-18;1945;730;60326;21540;9.1;3.3
63;2021-03-19;2741;482;63067;22022;9.6;3.3
63;2021-03-20;1122;67;64189;22089;9.7;3.3
63;2021-03-21;50;45;64239;22134;9.7;3.4
63;2021-03-22;1984;253;66223;22387;10.0;3.4
63;2021-03-23;2885;343;69108;22730;10.5;3.4
63;2021-03-24;3224;347;72332;23077;11.0;3.5
63;2021-03-25;4597;392;76929;23469;11.7;3.6
63;2021-03-26;4693;545;81622;24014;12.4;3.6
63;2021-03-27;2457;232;84079;24246;12.7;3.7
63;2021-03-28;1047;83;85126;24329;12.9;3.7
63;2021-03-29;2480;515;87606;24844;13.3;3.8
63;2021-03-30;3283;627;90889;25471;13.8;3.9
63;2021-03-31;2968;746;93857;26217;14.2;4.0
63;2021-04-01;3844;522;97701;26739;14.8;4.0
63;2021-04-02;3484;711;101185;27450;15.3;4.2
63;2021-04-03;1174;181;102359;27631;15.5;4.2
63;2021-04-04;877;29;103236;27660;15.6;4.2
63;2021-04-05;801;85;104037;27745;15.8;4.2
63;2021-04-06;2482;940;106519;28685;16.1;4.3
63;2021-04-07;3208;873;109727;29558;16.6;4.5
63;2021-04-08;4720;1221;114447;30779;17.3;4.7
63;2021-04-09;5314;999;119761;31778;18.1;4.8
63;2021-04-10;2221;481;121982;32259;18.5;4.9
63;2021-04-11;835;40;122817;32299;18.6;4.9
63;2021-04-12;1593;1309;124410;33608;18.8;5.1
63;2021-04-13;1986;1962;126396;35570;19.1;5.4
63;2021-04-14;2631;1438;129027;37008;19.5;5.6
63;2021-04-15;3809;1540;132836;38548;20.1;5.8
63;2021-04-16;2840;2157;135676;40705;20.5;6.2
63;2021-04-17;1233;672;136909;41377;20.7;6.3
63;2021-04-18;803;64;137712;41441;20.9;6.3
63;2021-04-19;1657;2100;139369;43541;21.1;6.6
63;2021-04-20;1702;2298;141071;45839;21.4;6.9
63;2021-04-21;1514;2407;142585;48246;21.6;7.3
63;2021-04-22;1916;2259;144501;50505;21.9;7.6
63;2021-04-23;2019;3109;146520;53614;22.2;8.1
63;2021-04-24;1192;1127;147712;54741;22.4;8.3
63;2021-04-25;554;412;148266;55153;22.5;8.4
63;2021-04-26;1438;2240;149704;57393;22.7;8.7
63;2021-04-27;2326;2607;152030;60000;23.0;9.1
63;2021-04-28;2346;3157;154376;63157;23.4;9.6
63;2021-04-29;2882;2805;157258;65962;23.8;10.0
63;2021-04-30;2862;2802;160120;68764;24.3;10.4
63;2021-05-01;1127;1051;161247;69815;24.4;10.6
63;2021-05-02;897;639;162144;70454;24.6;10.7
63;2021-05-03;2685;2233;164829;72687;25.0;11.0
63;2021-05-04;2878;2689;167707;75376;25.4;11.4
63;2021-05-05;2938;3118;170645;78494;25.8;11.9
63;2021-05-06;3673;3051;174318;81545;26.4;12.4
63;2021-05-07;4032;3526;178350;85071;27.0;12.9
63;2021-05-08;2002;654;180352;85725;27.3;13.0
63;2021-05-09;1802;606;182154;86331;27.6;13.1
63;2021-05-10;4194;2761;186348;89092;28.2;13.5
63;2021-05-11;5338;2759;191686;91851;29.0;13.9
63;2021-05-12;5274;2905;196960;94756;29.8;14.4
63;2021-05-13;4136;699;201096;95455;30.5;14.5
63;2021-05-14;4772;1509;205868;96964;31.2;14.7
63;2021-05-15;3727;986;209595;97950;31.7;14.8
63;2021-05-16;3521;447;213116;98397;32.3;14.9
63;2021-05-17;3902;1992;217018;100389;32.9;15.2
63;2021-05-18;5124;1610;222142;101999;33.6;15.4
63;2021-05-19;5228;1628;227370;103627;34.4;15.7
63;2021-05-20;6806;2090;234176;105717;35.5;16.0
63;2021-05-21;6256;2329;240432;108046;36.4;16.4
63;2021-05-22;3352;848;243784;108894;36.9;16.5
63;2021-05-23;2388;245;246172;109139;37.3;16.5
63;2021-05-24;2643;581;248815;109720;37.7;16.6
63;2021-05-25;4270;2642;253085;112362;38.3;17.0
63;2021-05-26;5452;2421;258537;114783;39.2;17.4
63;2021-05-27;6502;2799;265039;117582;40.1;17.8
63;2021-05-28;5422;3878;270461;121460;41.0;18.4
63;2021-05-29;3361;1500;273822;122960;41.5;18.6
63;2021-05-30;1579;217;275401;123177;41.7;18.7
63;2021-05-31;4157;2284;279558;125461;42.3;19.0
63;2021-06-01;3805;2946;283363;128407;42.9;19.4
63;2021-06-02;3886;2524;287249;130931;43.5;19.8
63;2021-06-03;4902;3134;292151;134065;44.2;20.3
63;2021-06-04;5100;3619;297251;137684;45.0;20.9
63;2021-06-05;2816;1742;300067;139426;45.4;21.1
63;2021-06-06;1309;698;301376;140124;45.6;21.2
63;2021-06-07;3163;2514;304539;142638;46.1;21.6
63;2021-06-08;2882;2746;307421;145384;46.6;22.0
63;2021-06-09;3025;2265;310446;147649;47.0;22.4
63;2021-06-10;3226;2688;313672;150337;47.5;22.8
63;2021-06-11;3099;4043;316771;154380;48.0;23.4
63;2021-06-12;1640;1969;318411;156349;48.2;23.7
63;2021-06-13;482;1098;318893;157447;48.3;23.8
63;2021-06-14;1824;3472;320717;160919;48.6;24.4
63;2021-06-15;2210;3477;322927;164396;48.9;24.9
63;2021-06-16;2576;3313;325503;167709;49.3;25.4
63;2021-06-17;2398;4314;327901;172023;49.7;26.1
63;2021-06-18;2480;5824;330381;177847;50.0;26.9
63;2021-06-19;1643;2835;332024;180682;50.3;27.4
63;2021-06-20;678;2441;332702;183123;50.4;27.7
63;2021-06-21;1272;5386;333974;188509;50.6;28.6
63;2021-06-22;1233;5537;335207;194046;50.8;29.4
63;2021-06-23;1531;4766;336738;198812;51.0;30.1
63;2021-06-24;1925;5383;338663;204195;51.3;30.9
63;2021-06-25;1751;5894;340414;210089;51.6;31.8
63;2021-06-26;1073;3352;341487;213441;51.7;32.3
63;2021-06-27;712;3487;342199;216928;51.8;32.9
63;2021-06-28;1136;5663;343335;222591;52.0;33.7
63;2021-06-29;1225;5159;344560;227750;52.2;34.5
63;2021-06-30;1606;5292;346166;233042;52.4;35.3
63;2021-07-01;1927;8064;348093;241106;52.7;36.5
63;2021-07-02;2061;6539;350154;247645;53.0;37.5
63;2021-07-03;965;2926;351119;250571;53.2;38.0
63;2021-07-04;1066;1885;352185;252456;53.3;38.2
63;2021-07-05;1540;6280;353725;258736;53.6;39.2
63;2021-07-06;1607;4808;355332;263544;53.8;39.9
63;2021-07-07;1973;4087;357305;267631;54.1;40.5
63;2021-07-08;2205;4578;359510;272209;54.5;41.2
63;2021-07-09;1911;5719;361421;277928;54.7;42.1
63;2021-07-10;1534;3415;362955;281343;55.0;42.6
63;2021-07-11;910;1537;363865;282880;55.1;42.8
63;2021-07-12;1597;8701;365462;291581;55.4;44.2
63;2021-07-13;3598;6131;369060;297712;55.9;45.1
63;2021-07-14;3618;1790;372678;299502;56.4;45.4
63;2021-07-15;4415;5028;377093;304530;57.1;46.1
63;2021-07-16;4693;5782;381786;310312;57.8;47.0
63;2021-07-17;3011;2473;384797;312785;58.3;47.4
63;2021-07-18;2825;1090;387622;313875;58.7;47.5
63;2021-07-19;4002;4844;391624;318719;59.3;48.3
63;2021-07-20;4737;5457;396361;324176;60.0;49.1
63;2021-07-21;4789;3975;401150;328151;60.8;49.7
63;2021-07-22;5509;4397;406659;332548;61.6;50.4
63;2021-07-23;5161;4650;411820;337198;62.4;51.1
63;2021-07-24;3677;1951;415497;339149;62.9;51.4
63;2021-07-25;3065;1438;418562;340587;63.4;51.6
63;2021-07-26;4040;3228;422602;343815;64.0;52.1
63;2021-07-27;3933;3162;426535;346977;64.6;52.6
63;2021-07-28;3852;2717;430387;349694;65.2;53.0
63;2021-07-29;4452;3157;434839;352851;65.9;53.4
63;2021-07-30;3807;3574;438646;356425;66.4;54.0
63;2021-07-31;2162;1718;440808;358143;66.8;54.2
63;2021-08-01;1197;836;442005;358979;66.9;54.4
63;2021-08-02;2226;3067;444231;362046;67.3;54.8
63;2021-08-03;2728;3252;446959;365298;67.7;55.3
63;2021-08-04;2809;3246;449768;368544;68.1;55.8
63;2021-08-05;2444;3478;452212;372022;68.5;56.3
63;2021-08-06;2352;4150;454564;376172;68.8;57.0
63;2021-08-07;1305;2808;455869;378980;69.0;57.4
63;2021-08-08;324;1205;456193;380185;69.1;57.6
63;2021-08-09;1849;4209;458042;384394;69.4;58.2
63;2021-08-10;2218;3993;460260;388387;69.7;58.8
63;2021-08-11;2100;3628;462360;392015;70.0;59.4
63;2021-08-12;1855;4620;464215;396635;70.3;60.1
63;2021-08-13;1677;4009;465892;400644;70.6;60.7
63;2021-08-14;841;3239;466733;403883;70.7;61.2
63;2021-08-15;184;1451;466917;405334;70.7;61.4
63;2021-08-16;1171;4396;468088;409730;70.9;62.1
63;2021-08-17;1601;4052;469689;413782;71.1;62.7
63;2021-08-18;1453;3305;471142;417087;71.4;63.2
63;2021-08-19;1322;3443;472464;420530;71.6;63.7
63;2021-08-20;1384;3712;473848;424242;71.8;64.3
63;2021-08-21;674;2165;474522;426407;71.9;64.6
63;2021-08-22;212;1092;474734;427499;71.9;64.7
63;2021-08-23;1075;3591;475809;431090;72.1;65.3
63;2021-08-24;1090;2990;476899;434080;72.2;65.7
63;2021-08-25;1005;2786;477904;436866;72.4;66.2
63;2021-08-26;1129;2707;479033;439573;72.6;66.6
63;2021-08-27;1148;3162;480181;442735;72.7;67.1
63;2021-08-28;698;1709;480879;444444;72.8;67.3
63;2021-08-29;107;577;480986;445021;72.9;67.4
63;2021-08-30;789;2446;481775;447467;73.0;67.8
63;2021-08-31;992;2567;482767;450034;73.1;68.2
63;2021-09-01;919;2135;483686;452169;73.3;68.5
63;2021-09-02;820;2082;484506;454251;73.4;68.8
63;2021-09-03;905;2659;485411;456910;73.5;69.2
63;2021-09-04;709;1537;486120;458447;73.6;69.4
63;2021-09-05;80;273;486200;458720;73.6;69.5
63;2021-09-06;559;1519;486759;460239;73.7;69.7
63;2021-09-07;659;1706;487418;461945;73.8;70.0
63;2021-09-08;705;1730;488123;463675;73.9;70.2
63;2021-09-09;594;1512;488717;465187;74.0;70.5
63;2021-09-10;730;2091;489447;467278;74.1;70.8
63;2021-09-11;459;1121;489906;468399;74.2;70.9
63;2021-09-12;50;159;489956;468558;74.2;71.0
63;2021-09-13;456;1420;490412;469978;74.3;71.2
63;2021-09-14;529;1410;490941;471388;74.4;71.4
63;2021-09-15;580;1288;491521;472676;74.4;71.6
63;2021-09-16;472;872;491993;473548;74.5;71.7
63;2021-09-17;474;1261;492467;474809;74.6;71.9
63;2021-09-18;316;991;492783;475800;74.6;72.1
63;2021-09-19;41;97;492824;475897;74.6;72.1
63;2021-09-20;363;708;493187;476605;74.7;72.2
63;2021-09-21;410;662;493597;477267;74.8;72.3
63;2021-09-22;400;1113;493997;478380;74.8;72.5
63;2021-09-23;299;665;494296;479045;74.9;72.6
63;2021-09-24;484;1179;494780;480224;74.9;72.7
63;2021-09-25;253;816;495033;481040;75.0;72.9
63;2021-09-26;26;100;495059;481140;75.0;72.9
63;2021-09-27;317;643;495376;481783;75.0;73.0
63;2021-09-28;292;617;495668;482400;75.1;73.1
63;2021-09-29;304;734;495972;483134;75.1;73.2
63;2021-09-30;293;657;496265;483791;75.2;73.3
63;2021-10-01;472;853;496737;484644;75.2;73.4
63;2021-10-02;273;557;497010;485201;75.3;73.5
63;2021-10-03;37;69;497047;485270;75.3;73.5
63;2021-10-04;208;401;497255;485671;75.3;73.6
63;2021-10-05;258;454;497513;486125;75.4;73.6
63;2021-10-06;330;602;497843;486727;75.4;73.7
64;2020-12-27;1;0;1;0;0.0;0.0
64;2020-12-28;2;0;3;0;0.0;0.0
64;2020-12-29;0;0;3;0;0.0;0.0
64;2020-12-30;1;0;4;0;0.0;0.0
64;2020-12-31;0;0;4;0;0.0;0.0
64;2021-01-01;1;0;5;0;0.0;0.0
64;2021-01-02;0;0;5;0;0.0;0.0
64;2021-01-03;0;0;5;0;0.0;0.0
64;2021-01-04;29;0;34;0;0.0;0.0
64;2021-01-05;25;0;59;0;0.0;0.0
64;2021-01-06;189;0;248;0;0.0;0.0
64;2021-01-07;842;1;1090;1;0.2;0.0
64;2021-01-08;880;2;1970;3;0.3;0.0
64;2021-01-09;54;0;2024;3;0.3;0.0
64;2021-01-10;2;0;2026;3;0.3;0.0
64;2021-01-11;543;0;2569;3;0.4;0.0
64;2021-01-12;760;3;3329;6;0.5;0.0
64;2021-01-13;866;2;4195;8;0.6;0.0
64;2021-01-14;1046;3;5241;11;0.8;0.0
64;2021-01-15;929;3;6170;14;0.9;0.0
64;2021-01-16;70;0;6240;14;0.9;0.0
64;2021-01-17;5;0;6245;14;0.9;0.0
64;2021-01-18;942;5;7187;19;1.1;0.0
64;2021-01-19;1448;2;8635;21;1.3;0.0
64;2021-01-20;1618;3;10253;24;1.5;0.0
64;2021-01-21;2603;1;12856;25;1.9;0.0
64;2021-01-22;1652;3;14508;28;2.1;0.0
64;2021-01-23;525;1;15033;29;2.2;0.0
64;2021-01-24;89;0;15122;29;2.2;0.0
64;2021-01-25;974;7;16096;36;2.4;0.0
64;2021-01-26;1358;21;17454;57;2.6;0.0
64;2021-01-27;1242;115;18696;172;2.7;0.0
64;2021-01-28;1652;603;20348;775;3.0;0.1
64;2021-01-29;975;604;21323;1379;3.1;0.2
64;2021-01-30;469;54;21792;1433;3.2;0.2
64;2021-01-31;93;0;21885;1433;3.2;0.2
64;2021-02-01;675;287;22560;1720;3.3;0.3
64;2021-02-02;1134;523;23694;2243;3.5;0.3
64;2021-02-03;1044;603;24738;2846;3.6;0.4
64;2021-02-04;1028;510;25766;3356;3.8;0.5
64;2021-02-05;869;445;26635;3801;3.9;0.6
64;2021-02-06;501;31;27136;3832;4.0;0.6
64;2021-02-07;131;3;27267;3835;4.0;0.6
64;2021-02-08;769;276;28036;4111;4.1;0.6
64;2021-02-09;949;658;28985;4769;4.2;0.7
64;2021-02-10;916;709;29901;5478;4.4;0.8
64;2021-02-11;1199;1240;31100;6718;4.6;1.0
64;2021-02-12;1076;963;32176;7681;4.7;1.1
64;2021-02-13;223;213;32399;7894;4.7;1.2
64;2021-02-14;38;26;32437;7920;4.7;1.2
64;2021-02-15;223;856;32660;8776;4.8;1.3
64;2021-02-16;261;1136;32921;9912;4.8;1.5
64;2021-02-17;291;992;33212;10904;4.9;1.6
64;2021-02-18;509;1461;33721;12365;4.9;1.8
64;2021-02-19;413;1037;34134;13402;5.0;2.0
64;2021-02-20;119;317;34253;13719;5.0;2.0
64;2021-02-21;20;66;34273;13785;5.0;2.0
64;2021-02-22;479;773;34752;14558;5.1;2.1
64;2021-02-23;722;922;35474;15480;5.2;2.3
64;2021-02-24;731;821;36205;16301;5.3;2.4
64;2021-02-25;1094;772;37299;17073;5.5;2.5
64;2021-02-26;1216;742;38515;17815;5.6;2.6
64;2021-02-27;864;303;39379;18118;5.8;2.7
64;2021-02-28;42;58;39421;18176;5.8;2.7
64;2021-03-01;767;631;40188;18807;5.9;2.8
64;2021-03-02;1077;755;41265;19562;6.0;2.9
64;2021-03-03;1251;861;42516;20423;6.2;3.0
64;2021-03-04;1882;1065;44398;21488;6.5;3.1
64;2021-03-05;2199;923;46597;22411;6.8;3.3
64;2021-03-06;1543;457;48140;22868;7.0;3.3
64;2021-03-07;595;86;48735;22954;7.1;3.4
64;2021-03-08;1534;678;50269;23632;7.4;3.5
64;2021-03-09;2069;760;52338;24392;7.7;3.6
64;2021-03-10;2082;690;54420;25082;8.0;3.7
64;2021-03-11;2976;994;57396;26076;8.4;3.8
64;2021-03-12;3489;565;60885;26641;8.9;3.9
64;2021-03-13;2258;159;63143;26800;9.2;3.9
64;2021-03-14;233;15;63376;26815;9.3;3.9
64;2021-03-15;2337;226;65713;27041;9.6;4.0
64;2021-03-16;2001;259;67714;27300;9.9;4.0
64;2021-03-17;2071;237;69785;27537;10.2;4.0
64;2021-03-18;2463;203;72248;27740;10.6;4.1
64;2021-03-19;3014;277;75262;28017;11.0;4.1
64;2021-03-20;2470;93;77732;28110;11.4;4.1
64;2021-03-21;1282;27;79014;28137;11.6;4.1
64;2021-03-22;2588;540;81602;28677;11.9;4.2
64;2021-03-23;3197;644;84799;29321;12.4;4.3
64;2021-03-24;3564;697;88363;30018;12.9;4.4
64;2021-03-25;4350;792;92713;30810;13.6;4.5
64;2021-03-26;4429;696;97142;31506;14.2;4.6
64;2021-03-27;2974;429;100116;31935;14.7;4.7
64;2021-03-28;521;55;100637;31990;14.7;4.7
64;2021-03-29;3028;873;103665;32863;15.2;4.8
64;2021-03-30;4135;862;107800;33725;15.8;4.9
64;2021-03-31;3594;787;111394;34512;16.3;5.1
64;2021-04-01;4787;935;116181;35447;17.0;5.2
64;2021-04-02;4444;743;120625;36190;17.7;5.3
64;2021-04-03;2061;584;122686;36774;18.0;5.4
64;2021-04-04;309;48;122995;36822;18.0;5.4
64;2021-04-05;1689;144;124684;36966;18.3;5.4
64;2021-04-06;3647;1387;128331;38353;18.8;5.6
64;2021-04-07;3947;1508;132278;39861;19.4;5.8
64;2021-04-08;5192;1592;137470;41453;20.1;6.1
64;2021-04-09;5899;1637;143369;43090;21.0;6.3
64;2021-04-10;3222;1048;146591;44138;21.5;6.5
64;2021-04-11;448;250;147039;44388;21.5;6.5
64;2021-04-12;4047;1865;151086;46253;22.1;6.8
64;2021-04-13;4466;2158;155552;48411;22.8;7.1
64;2021-04-14;4090;2134;159642;50545;23.4;7.4
64;2021-04-15;4394;2292;164036;52837;24.0;7.7
64;2021-04-16;4300;2253;168336;55090;24.6;8.1
64;2021-04-17;2479;1498;170815;56588;25.0;8.3
64;2021-04-18;1096;1181;171911;57769;25.2;8.5
64;2021-04-19;2736;2440;174647;60209;25.6;8.8
64;2021-04-20;3208;2425;177855;62634;26.0;9.2
64;2021-04-21;3224;2559;181079;65193;26.5;9.5
64;2021-04-22;3389;2775;184468;67968;27.0;9.9
64;2021-04-23;3435;2615;187903;70583;27.5;10.3
64;2021-04-24;2068;1586;189971;72169;27.8;10.6
64;2021-04-25;290;235;190261;72404;27.8;10.6
64;2021-04-26;2660;2645;192921;75049;28.2;11.0
64;2021-04-27;3060;3127;195981;78176;28.7;11.4
64;2021-04-28;3604;3053;199585;81229;29.2;11.9
64;2021-04-29;4650;3455;204235;84684;29.9;12.4
64;2021-04-30;4085;3598;208320;88282;30.5;12.9
64;2021-05-01;1486;1030;209806;89312;30.7;13.1
64;2021-05-02;446;325;210252;89637;30.8;13.1
64;2021-05-03;2910;3520;213162;93157;31.2;13.6
64;2021-05-04;3646;3983;216808;97140;31.7;14.2
64;2021-05-05;3358;4007;220166;101147;32.2;14.8
64;2021-05-06;4110;3989;224276;105136;32.8;15.4
64;2021-05-07;3921;4186;228197;109322;33.4;16.0
64;2021-05-08;2623;1235;230820;110557;33.8;16.2
64;2021-05-09;722;305;231542;110862;33.9;16.2
64;2021-05-10;2862;4232;234404;115094;34.3;16.8
64;2021-05-11;4183;4140;238587;119234;34.9;17.5
64;2021-05-12;4489;3942;243076;123176;35.6;18.0
64;2021-05-13;3198;885;246274;124061;36.0;18.2
64;2021-05-14;5153;3150;251427;127211;36.8;18.6
64;2021-05-15;3526;1865;254953;129076;37.3;18.9
64;2021-05-16;498;225;255451;129301;37.4;18.9
64;2021-05-17;4190;2389;259641;131690;38.0;19.3
64;2021-05-18;5163;2298;264804;133988;38.8;19.6
64;2021-05-19;4980;2165;269784;136153;39.5;19.9
64;2021-05-20;5567;2158;275351;138311;40.3;20.2
64;2021-05-21;5268;2246;280619;140557;41.1;20.6
64;2021-05-22;3581;1508;284200;142065;41.6;20.8
64;2021-05-23;431;206;284631;142271;41.7;20.8
64;2021-05-24;2996;1232;287627;143503;42.1;21.0
64;2021-05-25;4332;2851;291959;146354;42.7;21.4
64;2021-05-26;4357;2713;296316;149067;43.4;21.8
64;2021-05-27;5283;3156;301599;152223;44.1;22.3
64;2021-05-28;4620;3433;306219;155656;44.8;22.8
64;2021-05-29;2810;2112;309029;157768;45.2;23.1
64;2021-05-30;439;203;309468;157971;45.3;23.1
64;2021-05-31;3889;3657;313357;161628;45.9;23.7
64;2021-06-01;5335;3566;318692;165194;46.6;24.2
64;2021-06-02;4931;3174;323623;168368;47.4;24.6
64;2021-06-03;6365;3254;329988;171622;48.3;25.1
64;2021-06-04;5149;4551;335137;176173;49.1;25.8
64;2021-06-05;3482;2520;338619;178693;49.6;26.2
64;2021-06-06;2014;328;340633;179021;49.9;26.2
64;2021-06-07;4128;4333;344761;183354;50.5;26.8
64;2021-06-08;5151;4118;349912;187472;51.2;27.4
64;2021-06-09;5150;3656;355062;191128;52.0;28.0
64;2021-06-10;6181;3145;361243;194273;52.9;28.4
64;2021-06-11;5584;4874;366827;199147;53.7;29.2
64;2021-06-12;3949;2332;370776;201479;54.3;29.5
64;2021-06-13;1555;393;372331;201872;54.5;29.5
64;2021-06-14;3669;4792;376000;206664;55.0;30.3
64;2021-06-15;4572;4707;380572;211371;55.7;30.9
64;2021-06-16;4470;4664;385042;216035;56.4;31.6
64;2021-06-17;3641;4306;388683;220341;56.9;32.3
64;2021-06-18;4421;5166;393104;225507;57.5;33.0
64;2021-06-19;2984;3279;396088;228786;58.0;33.5
64;2021-06-20;881;539;396969;229325;58.1;33.6
64;2021-06-21;2314;5125;399283;234450;58.4;34.3
64;2021-06-22;2555;5726;401838;240176;58.8;35.2
64;2021-06-23;3104;5480;404942;245656;59.3;36.0
64;2021-06-24;2719;3810;407661;249466;59.7;36.5
64;2021-06-25;2900;6436;410561;255902;60.1;37.5
64;2021-06-26;1798;3835;412359;259737;60.4;38.0
64;2021-06-27;493;713;412852;260450;60.4;38.1
64;2021-06-28;1935;6070;414787;266520;60.7;39.0
64;2021-06-29;1967;6265;416754;272785;61.0;39.9
64;2021-06-30;2255;6000;419009;278785;61.3;40.8
64;2021-07-01;2407;5341;421416;284126;61.7;41.6
64;2021-07-02;2306;6403;423722;290529;62.0;42.5
64;2021-07-03;1263;3782;424985;294311;62.2;43.1
64;2021-07-04;411;847;425396;295158;62.3;43.2
64;2021-07-05;1376;5403;426772;300561;62.5;44.0
64;2021-07-06;1994;6151;428766;306712;62.8;44.9
64;2021-07-07;2063;5751;430829;312463;63.1;45.7
64;2021-07-08;1803;4396;432632;316859;63.3;46.4
64;2021-07-09;1825;6536;434457;323395;63.6;47.3
64;2021-07-10;1171;3879;435628;327274;63.8;47.9
64;2021-07-11;253;860;435881;328134;63.8;48.0
64;2021-07-12;1500;6086;437381;334220;64.0;48.9
64;2021-07-13;2366;7247;439747;341467;64.4;50.0
64;2021-07-14;2368;3405;442115;344872;64.7;50.5
64;2021-07-15;2104;5480;444219;350352;65.0;51.3
64;2021-07-16;2848;6770;447067;357122;65.4;52.3
64;2021-07-17;2338;4585;449405;361707;65.8;52.9
64;2021-07-18;716;2051;450121;363758;65.9;53.2
64;2021-07-19;2348;6121;452469;369879;66.2;54.1
64;2021-07-20;3130;6560;455599;376439;66.7;55.1
64;2021-07-21;3345;6044;458944;382483;67.2;56.0
64;2021-07-22;3808;5716;462752;388199;67.7;56.8
64;2021-07-23;3725;5618;466477;393817;68.3;57.6
64;2021-07-24;2553;4429;469030;398246;68.7;58.3
64;2021-07-25;753;1062;469783;399308;68.8;58.4
64;2021-07-26;3085;5131;472868;404439;69.2;59.2
64;2021-07-27;4260;5146;477128;409585;69.8;60.0
64;2021-07-28;4315;4597;481443;414182;70.5;60.6
64;2021-07-29;5518;3904;486961;418086;71.3;61.2
64;2021-07-30;5146;4229;492107;422315;72.0;61.8
64;2021-07-31;3171;3346;495278;425661;72.5;62.3
64;2021-08-01;1145;589;496423;426250;72.7;62.4
64;2021-08-02;4369;2631;500792;428881;73.3;62.8
64;2021-08-03;4556;3176;505348;432057;74.0;63.2
64;2021-08-04;4132;2999;509480;435056;74.6;63.7
64;2021-08-05;4037;2614;513517;437670;75.2;64.1
64;2021-08-06;3844;3335;517361;441005;75.7;64.6
64;2021-08-07;2481;2701;519842;443706;76.1;64.9
64;2021-08-08;492;609;520334;444315;76.2;65.0
64;2021-08-09;2739;3201;523073;447516;76.6;65.5
64;2021-08-10;3352;3436;526425;450952;77.1;66.0
64;2021-08-11;3068;3264;529493;454216;77.5;66.5
64;2021-08-12;3190;3307;532683;457523;78.0;67.0
64;2021-08-13;2575;3660;535258;461183;78.3;67.5
64;2021-08-14;1632;2683;536890;463866;78.6;67.9
64;2021-08-15;208;691;537098;464557;78.6;68.0
64;2021-08-16;2102;3236;539200;467793;78.9;68.5
64;2021-08-17;2299;3709;541499;471502;79.3;69.0
64;2021-08-18;2043;3520;543542;475022;79.6;69.5
64;2021-08-19;1938;3525;545480;478547;79.8;70.0
64;2021-08-20;1578;3975;547058;482522;80.1;70.6
64;2021-08-21;975;2882;548033;485404;80.2;71.1
64;2021-08-22;160;895;548193;486299;80.2;71.2
64;2021-08-23;1269;3238;549462;489537;80.4;71.7
64;2021-08-24;1378;4596;550840;494133;80.6;72.3
64;2021-08-25;1260;3747;552100;497880;80.8;72.9
64;2021-08-26;1111;3532;553211;501412;81.0;73.4
64;2021-08-27;1189;4229;554400;505641;81.2;74.0
64;2021-08-28;735;2496;555135;508137;81.3;74.4
64;2021-08-29;90;533;555225;508670;81.3;74.5
64;2021-08-30;989;3615;556214;512285;81.4;75.0
64;2021-08-31;990;3973;557204;516258;81.6;75.6
64;2021-09-01;925;3196;558129;519454;81.7;76.0
64;2021-09-02;898;3260;559027;522714;81.8;76.5
64;2021-09-03;872;3202;559899;525916;82.0;77.0
64;2021-09-04;698;2246;560597;528162;82.1;77.3
64;2021-09-05;74;267;560671;528429;82.1;77.3
64;2021-09-06;532;2582;561203;531011;82.1;77.7
64;2021-09-07;717;2337;561920;533348;82.3;78.1
64;2021-09-08;735;2832;562655;536180;82.4;78.5
64;2021-09-09;475;2166;563130;538346;82.4;78.8
64;2021-09-10;744;2473;563874;540819;82.5;79.2
64;2021-09-11;592;2136;564466;542955;82.6;79.5
64;2021-09-12;60;211;564526;543166;82.6;79.5
64;2021-09-13;441;1899;564967;545065;82.7;79.8
64;2021-09-14;489;1927;565456;546992;82.8;80.1
64;2021-09-15;688;1747;566144;548739;82.9;80.3
64;2021-09-16;484;843;566628;549582;82.9;80.4
64;2021-09-17;564;1354;567192;550936;83.0;80.6
64;2021-09-18;331;1258;567523;552194;83.1;80.8
64;2021-09-19;18;42;567541;552236;83.1;80.8
64;2021-09-20;248;480;567789;552716;83.1;80.9
64;2021-09-21;430;951;568219;553667;83.2;81.0
64;2021-09-22;380;1426;568599;555093;83.2;81.3
64;2021-09-23;278;730;568877;555823;83.3;81.4
64;2021-09-24;398;986;569275;556809;83.3;81.5
64;2021-09-25;298;1033;569573;557842;83.4;81.7
64;2021-09-26;0;4;569573;557846;83.4;81.7
64;2021-09-27;234;567;569807;558413;83.4;81.7
64;2021-09-28;260;671;570067;559084;83.4;81.8
64;2021-09-29;341;984;570408;560068;83.5;82.0
64;2021-09-30;257;441;570665;560509;83.5;82.0
64;2021-10-01;308;726;570973;561235;83.6;82.2
64;2021-10-02;214;566;571187;561801;83.6;82.2
64;2021-10-03;0;2;571187;561803;83.6;82.2
64;2021-10-04;238;425;571425;562228;83.6;82.3
64;2021-10-05;311;633;571736;562861;83.7;82.4
64;2021-10-06;399;908;572135;563769;83.7;82.5
65;2020-12-27;0;0;0;0;0.0;0.0
65;2020-12-28;1;0;1;0;0.0;0.0
65;2020-12-29;0;0;1;0;0.0;0.0
65;2020-12-30;0;0;1;0;0.0;0.0
65;2020-12-31;0;0;1;0;0.0;0.0
65;2021-01-01;1;0;2;0;0.0;0.0
65;2021-01-02;0;0;2;0;0.0;0.0
65;2021-01-03;0;0;2;0;0.0;0.0
65;2021-01-04;0;0;2;0;0.0;0.0
65;2021-01-05;1;0;3;0;0.0;0.0
65;2021-01-06;3;0;6;0;0.0;0.0
65;2021-01-07;168;0;174;0;0.1;0.0
65;2021-01-08;253;1;427;1;0.2;0.0
65;2021-01-09;177;1;604;2;0.3;0.0
65;2021-01-10;1;0;605;2;0.3;0.0
65;2021-01-11;275;3;880;5;0.4;0.0
65;2021-01-12;271;1;1151;6;0.5;0.0
65;2021-01-13;587;1;1738;7;0.8;0.0
65;2021-01-14;581;5;2319;12;1.0;0.0
65;2021-01-15;527;2;2846;14;1.3;0.0
65;2021-01-16;221;2;3067;16;1.4;0.0
65;2021-01-17;0;0;3067;16;1.4;0.0
65;2021-01-18;554;4;3621;20;1.6;0.0
65;2021-01-19;571;2;4192;22;1.8;0.0
65;2021-01-20;585;5;4777;27;2.1;0.0
65;2021-01-21;585;0;5362;27;2.4;0.0
65;2021-01-22;598;0;5960;27;2.6;0.0
65;2021-01-23;174;1;6134;28;2.7;0.0
65;2021-01-24;3;1;6137;29;2.7;0.0
65;2021-01-25;551;4;6688;33;2.9;0.0
65;2021-01-26;883;2;7571;35;3.3;0.0
65;2021-01-27;592;10;8163;45;3.6;0.0
65;2021-01-28;509;70;8672;115;3.8;0.1
65;2021-01-29;426;135;9098;250;4.0;0.1
65;2021-01-30;182;42;9280;292;4.1;0.1
65;2021-01-31;15;0;9295;292;4.1;0.1
65;2021-02-01;351;78;9646;370;4.3;0.2
65;2021-02-02;432;146;10078;516;4.4;0.2
65;2021-02-03;463;207;10541;723;4.6;0.3
65;2021-02-04;310;267;10851;990;4.8;0.4
65;2021-02-05;284;311;11135;1301;4.9;0.6
65;2021-02-06;99;72;11234;1373;5.0;0.6
65;2021-02-07;10;0;11244;1373;5.0;0.6
65;2021-02-08;425;184;11669;1557;5.1;0.7
65;2021-02-09;272;308;11941;1865;5.3;0.8
65;2021-02-10;298;202;12239;2067;5.4;0.9
65;2021-02-11;320;226;12559;2293;5.5;1.0
65;2021-02-12;277;175;12836;2468;5.7;1.1
65;2021-02-13;125;78;12961;2546;5.7;1.1
65;2021-02-14;3;15;12964;2561;5.7;1.1
65;2021-02-15;203;314;13167;2875;5.8;1.3
65;2021-02-16;488;449;13655;3324;6.0;1.5
65;2021-02-17;231;405;13886;3729;6.1;1.6
65;2021-02-18;284;467;14170;4196;6.2;1.8
65;2021-02-19;156;365;14326;4561;6.3;2.0
65;2021-02-20;53;140;14379;4701;6.3;2.1
65;2021-02-21;3;48;14382;4749;6.3;2.1
65;2021-02-22;167;437;14549;5186;6.4;2.3
65;2021-02-23;249;426;14798;5612;6.5;2.5
65;2021-02-24;231;536;15029;6148;6.6;2.7
65;2021-02-25;215;157;15244;6305;6.7;2.8
65;2021-02-26;349;636;15593;6941;6.9;3.1
65;2021-02-27;109;166;15702;7107;6.9;3.1
65;2021-02-28;1;0;15703;7107;6.9;3.1
65;2021-03-01;379;316;16082;7423;7.1;3.3
65;2021-03-02;455;281;16537;7704;7.3;3.4
65;2021-03-03;381;334;16918;8038;7.5;3.5
65;2021-03-04;696;286;17614;8324;7.8;3.7
65;2021-03-05;679;261;18293;8585;8.1;3.8
65;2021-03-06;1187;78;19480;8663;8.6;3.8
65;2021-03-07;257;12;19737;8675;8.7;3.8
65;2021-03-08;412;315;20149;8990;8.9;4.0
65;2021-03-09;670;310;20819;9300;9.2;4.1
65;2021-03-10;624;347;21443;9647;9.5;4.3
65;2021-03-11;778;337;22221;9984;9.8;4.4
65;2021-03-12;1060;184;23281;10168;10.3;4.5
65;2021-03-13;356;88;23637;10256;10.4;4.5
65;2021-03-14;3;30;23640;10286;10.4;4.5
65;2021-03-15;816;182;24456;10468;10.8;4.6
65;2021-03-16;694;212;25150;10680;11.1;4.7
65;2021-03-17;712;201;25862;10881;11.4;4.8
65;2021-03-18;537;228;26399;11109;11.6;4.9
65;2021-03-19;878;158;27277;11267;12.0;5.0
65;2021-03-20;245;42;27522;11309;12.1;5.0
65;2021-03-21;12;2;27534;11311;12.1;5.0
65;2021-03-22;734;147;28268;11458;12.5;5.1
65;2021-03-23;838;359;29106;11817;12.8;5.2
65;2021-03-24;868;248;29974;12065;13.2;5.3
65;2021-03-25;1253;188;31227;12253;13.8;5.4
65;2021-03-26;1225;141;32452;12394;14.3;5.5
65;2021-03-27;1357;92;33809;12486;14.9;5.5
65;2021-03-28;1;1;33810;12487;14.9;5.5
65;2021-03-29;1490;357;35300;12844;15.6;5.7
65;2021-03-30;1357;405;36657;13249;16.2;5.8
65;2021-03-31;1208;366;37865;13615;16.7;6.0
65;2021-04-01;1509;393;39374;14008;17.4;6.2
65;2021-04-02;1685;286;41059;14294;18.1;6.3
65;2021-04-03;247;45;41306;14339;18.2;6.3
65;2021-04-04;4;2;41310;14341;18.2;6.3
65;2021-04-05;158;44;41468;14385;18.3;6.3
65;2021-04-06;1294;494;42762;14879;18.9;6.6
65;2021-04-07;1958;456;44720;15335;19.7;6.8
65;2021-04-08;1644;416;46364;15751;20.4;6.9
65;2021-04-09;1643;471;48007;16222;21.2;7.2
65;2021-04-10;1591;150;49598;16372;21.9;7.2
65;2021-04-11;3;0;49601;16372;21.9;7.2
65;2021-04-12;1352;732;50953;17104;22.5;7.5
65;2021-04-13;1584;589;52537;17693;23.2;7.8
65;2021-04-14;1905;744;54442;18437;24.0;8.1
65;2021-04-15;1701;669;56143;19106;24.8;8.4
65;2021-04-16;1824;527;57967;19633;25.6;8.7
65;2021-04-17;2156;131;60123;19764;26.5;8.7
65;2021-04-18;7;27;60130;19791;26.5;8.7
65;2021-04-19;1337;767;61467;20558;27.1;9.1
65;2021-04-20;1530;706;62997;21264;27.8;9.4
65;2021-04-21;1052;1041;64049;22305;28.2;9.8
65;2021-04-22;1647;725;65696;23030;29.0;10.2
65;2021-04-23;1160;1146;66856;24176;29.5;10.7
65;2021-04-24;1265;610;68121;24786;30.0;10.9
65;2021-04-25;31;15;68152;24801;30.0;10.9
65;2021-04-26;1610;1289;69762;26090;30.8;11.5
65;2021-04-27;1423;1336;71185;27426;31.4;12.1
65;2021-04-28;1731;1021;72916;28447;32.1;12.5
65;2021-04-29;1959;1032;74875;29479;33.0;13.0
65;2021-04-30;1782;922;76657;30401;33.8;13.4
65;2021-05-01;1574;230;78231;30631;34.5;13.5
65;2021-05-02;671;25;78902;30656;34.8;13.5
65;2021-05-03;1280;1618;80182;32274;35.3;14.2
65;2021-05-04;1535;1239;81717;33513;36.0;14.8
65;2021-05-05;1374;1640;83091;35153;36.6;15.5
65;2021-05-06;1558;1171;84649;36324;37.3;16.0
65;2021-05-07;1275;1566;85924;37890;37.9;16.7
65;2021-05-08;1647;442;87571;38332;38.6;16.9
65;2021-05-09;0;87;87571;38419;38.6;16.9
65;2021-05-10;953;1883;88524;40302;39.0;17.8
65;2021-05-11;1061;1808;89585;42110;39.5;18.6
65;2021-05-12;1236;1637;90821;43747;40.0;19.3
65;2021-05-13;1345;171;92166;43918;40.6;19.4
65;2021-05-14;1575;1094;93741;45012;41.3;19.8
65;2021-05-15;1402;509;95143;45521;41.9;20.1
65;2021-05-16;1444;69;96587;45590;42.6;20.1
65;2021-05-17;1036;1614;97623;47204;43.0;20.8
65;2021-05-18;1612;1207;99235;48411;43.7;21.3
65;2021-05-19;1684;1010;100919;49421;44.5;21.8
65;2021-05-20;1845;1054;102764;50475;45.3;22.3
65;2021-05-21;1790;1230;104554;51705;46.1;22.8
65;2021-05-22;1287;638;105841;52343;46.7;23.1
65;2021-05-23;689;32;106530;52375;47.0;23.1
65;2021-05-24;703;77;107233;52452;47.3;23.1
65;2021-05-25;1359;1547;108592;53999;47.9;23.8
65;2021-05-26;1471;1352;110063;55351;48.5;24.4
65;2021-05-27;1622;1461;111685;56812;49.2;25.0
65;2021-05-28;1598;1671;113283;58483;49.9;25.8
65;2021-05-29;1188;1515;114471;59998;50.5;26.4
65;2021-05-30;7;10;114478;60008;50.5;26.5
65;2021-05-31;1323;1297;115801;61305;51.0;27.0
65;2021-06-01;1832;938;117633;62243;51.9;27.4
65;2021-06-02;1574;950;119207;63193;52.6;27.9
65;2021-06-03;1343;1105;120550;64298;53.1;28.3
65;2021-06-04;1790;1559;122340;65857;53.9;29.0
65;2021-06-05;432;1240;122772;67097;54.1;29.6
65;2021-06-06;3;13;122775;67110;54.1;29.6
65;2021-06-07;675;1984;123450;69094;54.4;30.5
65;2021-06-08;956;1533;124406;70627;54.8;31.1
65;2021-06-09;828;1546;125234;72173;55.2;31.8
65;2021-06-10;739;1153;125973;73326;55.5;32.3
65;2021-06-11;909;1801;126882;75127;55.9;33.1
65;2021-06-12;150;640;127032;75767;56.0;33.4
65;2021-06-13;5;7;127037;75774;56.0;33.4
65;2021-06-14;501;2421;127538;78195;56.2;34.5
65;2021-06-15;942;1801;128480;79996;56.6;35.3
65;2021-06-16;1063;1365;129543;81361;57.1;35.9
65;2021-06-17;814;1046;130357;82407;57.5;36.3
65;2021-06-18;1019;1633;131376;84040;57.9;37.0
65;2021-06-19;690;1689;132066;85729;58.2;37.8
65;2021-06-20;2;2;132068;85731;58.2;37.8
65;2021-06-21;735;1941;132803;87672;58.5;38.6
65;2021-06-22;1045;1479;133848;89151;59.0;39.3
65;2021-06-23;1063;1234;134911;90385;59.5;39.8
65;2021-06-24;973;1143;135884;91528;59.9;40.3
65;2021-06-25;831;1967;136715;93495;60.3;41.2
65;2021-06-26;168;1658;136883;95153;60.3;41.9
65;2021-06-27;15;1100;136898;96253;60.4;42.4
65;2021-06-28;444;2301;137342;98554;60.5;43.4
65;2021-06-29;683;1921;138025;100475;60.8;44.3
65;2021-06-30;933;1678;138958;102153;61.3;45.0
65;2021-07-01;605;750;139563;102903;61.5;45.4
65;2021-07-02;1166;1732;140729;104635;62.0;46.1
65;2021-07-03;197;1915;140926;106550;62.1;47.0
65;2021-07-04;416;186;141342;106736;62.3;47.1
65;2021-07-05;641;1992;141983;108728;62.6;47.9
65;2021-07-06;897;2127;142880;110855;63.0;48.9
65;2021-07-07;977;1516;143857;112371;63.4;49.5
65;2021-07-08;328;664;144185;113035;63.6;49.8
65;2021-07-09;550;1592;144735;114627;63.8;50.5
65;2021-07-10;304;956;145039;115583;63.9;51.0
65;2021-07-11;0;0;145039;115583;63.9;51.0
65;2021-07-12;480;2220;145519;117803;64.2;51.9
65;2021-07-13;700;2148;146219;119951;64.5;52.9
65;2021-07-14;214;52;146433;120003;64.6;52.9
65;2021-07-15;1097;1663;147530;121666;65.0;53.6
65;2021-07-16;1186;1885;148716;123551;65.6;54.5
65;2021-07-17;431;541;149147;124092;65.8;54.7
65;2021-07-18;22;11;149169;124103;65.8;54.7
65;2021-07-19;635;1494;149804;125597;66.0;55.4
65;2021-07-20;1447;1704;151251;127301;66.7;56.1
65;2021-07-21;1420;1662;152671;128963;67.3;56.9
65;2021-07-22;2197;1289;154868;130252;68.3;57.4
65;2021-07-23;1623;1789;156491;132041;69.0;58.2
65;2021-07-24;1042;649;157533;132690;69.4;58.5
65;2021-07-25;24;21;157557;132711;69.5;58.5
65;2021-07-26;1142;1246;158699;133957;70.0;59.1
65;2021-07-27;1792;1954;160491;135911;70.8;59.9
65;2021-07-28;1603;1322;162094;137233;71.5;60.5
65;2021-07-29;2899;1136;164993;138369;72.7;61.0
65;2021-07-30;2449;1398;167442;139767;73.8;61.6
65;2021-07-31;2305;355;169747;140122;74.8;61.8
65;2021-08-01;14;16;169761;140138;74.8;61.8
65;2021-08-02;994;835;170755;140973;75.3;62.1
65;2021-08-03;2103;1071;172858;142044;76.2;62.6
65;2021-08-04;1803;642;174661;142686;77.0;62.9
65;2021-08-05;1820;833;176481;143519;77.8;63.3
65;2021-08-06;1666;972;178147;144491;78.5;63.7
65;2021-08-07;730;487;178877;144978;78.9;63.9
65;2021-08-08;2;9;178879;144987;78.9;63.9
65;2021-08-09;705;944;179584;145931;79.2;64.3
65;2021-08-10;1194;1545;180778;147476;79.7;65.0
65;2021-08-11;731;1264;181509;148740;80.0;65.6
65;2021-08-12;777;1085;182286;149825;80.4;66.0
65;2021-08-13;428;1010;182714;150835;80.5;66.5
65;2021-08-14;602;567;183316;151402;80.8;66.7
65;2021-08-15;8;19;183324;151421;80.8;66.8
65;2021-08-16;403;1537;183727;152958;81.0;67.4
65;2021-08-17;739;2177;184466;155135;81.3;68.4
65;2021-08-18;604;1545;185070;156680;81.6;69.1
65;2021-08-19;731;1316;185801;157996;81.9;69.7
65;2021-08-20;459;1336;186260;159332;82.1;70.2
65;2021-08-21;44;105;186304;159437;82.1;70.3
65;2021-08-22;11;13;186315;159450;82.1;70.3
65;2021-08-23;273;1681;186588;161131;82.3;71.0
65;2021-08-24;550;2445;187138;163576;82.5;72.1
65;2021-08-25;417;1959;187555;165535;82.7;73.0
65;2021-08-26;468;2308;188023;167843;82.9;74.0
65;2021-08-27;447;1947;188470;169790;83.1;74.9
65;2021-08-28;163;195;188633;169985;83.2;74.9
65;2021-08-29;9;18;188642;170003;83.2;74.9
65;2021-08-30;260;1056;188902;171059;83.3;75.4
65;2021-08-31;468;1588;189370;172647;83.5;76.1
65;2021-09-01;459;1162;189829;173809;83.7;76.6
65;2021-09-02;373;1009;190202;174818;83.8;77.1
65;2021-09-03;453;1245;190655;176063;84.0;77.6
65;2021-09-04;166;909;190821;176972;84.1;78.0
65;2021-09-05;18;35;190839;177007;84.1;78.0
65;2021-09-06;278;794;191117;177801;84.3;78.4
65;2021-09-07;323;1194;191440;178995;84.4;78.9
65;2021-09-08;356;1038;191796;180033;84.6;79.4
65;2021-09-09;262;785;192058;180818;84.7;79.7
65;2021-09-10;383;925;192441;181743;84.8;80.1
65;2021-09-11;54;167;192495;181910;84.9;80.2
65;2021-09-12;1;2;192496;181912;84.9;80.2
65;2021-09-13;209;490;192705;182402;85.0;80.4
65;2021-09-14;191;593;192896;182995;85.0;80.7
65;2021-09-15;249;639;193145;183634;85.1;81.0
65;2021-09-16;139;213;193284;183847;85.2;81.0
65;2021-09-17;275;524;193559;184371;85.3;81.3
65;2021-09-18;98;269;193657;184640;85.4;81.4
65;2021-09-19;2;13;193659;184653;85.4;81.4
65;2021-09-20;109;234;193768;184887;85.4;81.5
65;2021-09-21;110;258;193878;185145;85.5;81.6
65;2021-09-22;153;680;194031;185825;85.5;81.9
65;2021-09-23;65;158;194096;185983;85.6;82.0
65;2021-09-24;170;556;194266;186539;85.6;82.2
65;2021-09-25;73;218;194339;186757;85.7;82.3
65;2021-09-26;3;0;194342;186757;85.7;82.3
65;2021-09-27;62;263;194404;187020;85.7;82.4
65;2021-09-28;83;279;194487;187299;85.7;82.6
65;2021-09-29;130;418;194617;187717;85.8;82.8
65;2021-09-30;44;123;194661;187840;85.8;82.8
65;2021-10-01;165;399;194826;188239;85.9;83.0
65;2021-10-02;19;66;194845;188305;85.9;83.0
65;2021-10-03;0;7;194845;188312;85.9;83.0
65;2021-10-04;122;269;194967;188581;85.9;83.1
65;2021-10-05;63;179;195030;188760;86.0;83.2
65;2021-10-06;162;342;195192;189102;86.0;83.4
66;2020-12-27;0;0;0;0;0.0;0.0
66;2020-12-28;2;0;2;0;0.0;0.0
66;2020-12-29;0;0;2;0;0.0;0.0
66;2020-12-30;0;0;2;0;0.0;0.0
66;2020-12-31;1;0;3;0;0.0;0.0
66;2021-01-01;3;0;6;0;0.0;0.0
66;2021-01-02;0;0;6;0;0.0;0.0
66;2021-01-03;0;0;6;0;0.0;0.0
66;2021-01-04;30;0;36;0;0.0;0.0
66;2021-01-05;135;0;171;0;0.0;0.0
66;2021-01-06;194;0;365;0;0.1;0.0
66;2021-01-07;182;0;547;0;0.1;0.0
66;2021-01-08;212;0;759;0;0.2;0.0
66;2021-01-09;233;0;992;0;0.2;0.0
66;2021-01-10;11;0;1003;0;0.2;0.0
66;2021-01-11;404;2;1407;2;0.3;0.0
66;2021-01-12;588;2;1995;4;0.4;0.0
66;2021-01-13;877;7;2872;11;0.6;0.0
66;2021-01-14;892;11;3764;22;0.8;0.0
66;2021-01-15;588;1;4352;23;0.9;0.0
66;2021-01-16;106;3;4458;26;0.9;0.0
66;2021-01-17;46;1;4504;27;0.9;0.0
66;2021-01-18;654;3;5158;30;1.1;0.0
66;2021-01-19;720;3;5878;33;1.2;0.0
66;2021-01-20;1169;3;7047;36;1.5;0.0
66;2021-01-21;2400;5;9447;41;2.0;0.0
66;2021-01-22;1438;6;10885;47;2.3;0.0
66;2021-01-23;399;4;11284;51;2.4;0.0
66;2021-01-24;225;9;11509;60;2.4;0.0
66;2021-01-25;739;31;12248;91;2.6;0.0
66;2021-01-26;787;56;13035;147;2.7;0.0
66;2021-01-27;867;75;13902;222;2.9;0.0
66;2021-01-28;878;116;14780;338;3.1;0.1
66;2021-01-29;820;110;15600;448;3.3;0.1
66;2021-01-30;481;50;16081;498;3.4;0.1
66;2021-01-31;202;17;16283;515;3.4;0.1
66;2021-02-01;562;151;16845;666;3.5;0.1
66;2021-02-02;622;266;17467;932;3.6;0.2
66;2021-02-03;734;545;18201;1477;3.8;0.3
66;2021-02-04;688;508;18889;1985;3.9;0.4
66;2021-02-05;778;369;19667;2354;4.1;0.5
66;2021-02-06;420;129;20087;2483;4.2;0.5
66;2021-02-07;170;124;20257;2607;4.2;0.5
66;2021-02-08;502;296;20759;2903;4.3;0.6
66;2021-02-09;533;295;21292;3198;4.4;0.7
66;2021-02-10;620;614;21912;3812;4.6;0.8
66;2021-02-11;1104;1383;23016;5195;4.8;1.1
66;2021-02-12;1122;1061;24138;6256;5.0;1.3
66;2021-02-13;367;221;24505;6477;5.1;1.4
66;2021-02-14;111;154;24616;6631;5.1;1.4
66;2021-02-15;425;519;25041;7150;5.2;1.5
66;2021-02-16;304;578;25345;7728;5.3;1.6
66;2021-02-17;377;558;25722;8286;5.4;1.7
66;2021-02-18;366;620;26088;8906;5.4;1.9
66;2021-02-19;400;574;26488;9480;5.5;2.0
66;2021-02-20;184;318;26672;9798;5.6;2.0
66;2021-02-21;41;123;26713;9921;5.6;2.1
66;2021-02-22;415;479;27128;10400;5.7;2.2
66;2021-02-23;509;501;27637;10901;5.8;2.3
66;2021-02-24;347;575;27984;11476;5.8;2.4
66;2021-02-25;717;537;28701;12013;6.0;2.5
66;2021-02-26;954;599;29655;12612;6.2;2.6
66;2021-02-27;363;321;30018;12933;6.3;2.7
66;2021-02-28;59;105;30077;13038;6.3;2.7
66;2021-03-01;378;512;30455;13550;6.4;2.8
66;2021-03-02;335;537;30790;14087;6.4;2.9
66;2021-03-03;530;515;31320;14602;6.5;3.0
66;2021-03-04;991;913;32311;15515;6.7;3.2
66;2021-03-05;1528;697;33839;16212;7.1;3.4
66;2021-03-06;1147;303;34986;16515;7.3;3.4
66;2021-03-07;1098;77;36084;16592;7.5;3.5
66;2021-03-08;696;471;36780;17063;7.7;3.6
66;2021-03-09;1228;526;38008;17589;7.9;3.7
66;2021-03-10;1302;445;39310;18034;8.2;3.8
66;2021-03-11;1474;539;40784;18573;8.5;3.9
66;2021-03-12;2396;543;43180;19116;9.0;4.0
66;2021-03-13;1081;287;44261;19403;9.2;4.1
66;2021-03-14;192;78;44453;19481;9.3;4.1
66;2021-03-15;1109;383;45562;19864;9.5;4.1
66;2021-03-16;953;253;46515;20117;9.7;4.2
66;2021-03-17;866;383;47381;20500;9.9;4.3
66;2021-03-18;969;338;48350;20838;10.1;4.4
66;2021-03-19;1293;314;49643;21152;10.4;4.4
66;2021-03-20;837;122;50480;21274;10.5;4.4
66;2021-03-21;186;43;50666;21317;10.6;4.5
66;2021-03-22;1115;379;51781;21696;10.8;4.5
66;2021-03-23;1757;389;53538;22085;11.2;4.6
66;2021-03-24;1797;511;55335;22596;11.6;4.7
66;2021-03-25;2537;461;57872;23057;12.1;4.8
66;2021-03-26;2577;363;60449;23420;12.6;4.9
66;2021-03-27;1211;293;61660;23713;12.9;5.0
66;2021-03-28;321;3;61981;23716;12.9;5.0
66;2021-03-29;1831;253;63812;23969;13.3;5.0
66;2021-03-30;2241;172;66053;24141;13.8;5.0
66;2021-03-31;1987;251;68040;24392;14.2;5.1
66;2021-04-01;2674;302;70714;24694;14.8;5.2
66;2021-04-02;2421;259;73135;24953;15.3;5.2
66;2021-04-03;1148;331;74283;25284;15.5;5.3
66;2021-04-04;107;124;74390;25408;15.5;5.3
66;2021-04-05;197;140;74587;25548;15.6;5.3
66;2021-04-06;1334;647;75921;26195;15.8;5.5
66;2021-04-07;1399;597;77320;26792;16.1;5.6
66;2021-04-08;2070;548;79390;27340;16.6;5.7
66;2021-04-09;3507;662;82897;28002;17.3;5.8
66;2021-04-10;2308;524;85205;28526;17.8;6.0
66;2021-04-11;1201;169;86406;28695;18.0;6.0
66;2021-04-12;2703;1022;89109;29717;18.6;6.2
66;2021-04-13;3609;1055;92718;30772;19.4;6.4
66;2021-04-14;3292;921;96010;31693;20.0;6.6
66;2021-04-15;3557;1048;99567;32741;20.8;6.8
66;2021-04-16;3592;1034;103159;33775;21.5;7.1
66;2021-04-17;2263;592;105422;34367;22.0;7.2
66;2021-04-18;1445;132;106867;34499;22.3;7.2
66;2021-04-19;2256;1120;109123;35619;22.8;7.4
66;2021-04-20;2373;1075;111496;36694;23.3;7.7
66;2021-04-21;2871;1175;114367;37869;23.9;7.9
66;2021-04-22;2662;1232;117029;39101;24.4;8.2
66;2021-04-23;2379;1233;119408;40334;24.9;8.4
66;2021-04-24;2743;882;122151;41216;25.5;8.6
66;2021-04-25;1206;266;123357;41482;25.8;8.7
66;2021-04-26;1998;1251;125355;42733;26.2;8.9
66;2021-04-27;2748;1303;128103;44036;26.7;9.2
66;2021-04-28;2420;1654;130523;45690;27.2;9.5
66;2021-04-29;2704;2126;133227;47816;27.8;10.0
66;2021-04-30;3053;1551;136280;49367;28.5;10.3
66;2021-05-01;2000;470;138280;49837;28.9;10.4
66;2021-05-02;1529;264;139809;50101;29.2;10.5
66;2021-05-03;2940;1109;142749;51210;29.8;10.7
66;2021-05-04;3169;1339;145918;52549;30.5;11.0
66;2021-05-05;3055;1548;148973;54097;31.1;11.3
66;2021-05-06;3755;2084;152728;56181;31.9;11.7
66;2021-05-07;2968;3064;155696;59245;32.5;12.4
66;2021-05-08;1730;1169;157426;60414;32.9;12.6
66;2021-05-09;886;1369;158312;61783;33.1;12.9
66;2021-05-10;1802;2967;160114;64750;33.4;13.5
66;2021-05-11;2741;3126;162855;67876;34.0;14.2
66;2021-05-12;2432;2569;165287;70445;34.5;14.7
66;2021-05-13;2259;1386;167546;71831;35.0;15.0
66;2021-05-14;2770;2118;170316;73949;35.6;15.4
66;2021-05-15;2326;1574;172642;75523;36.0;15.8
66;2021-05-16;2286;1246;174928;76769;36.5;16.0
66;2021-05-17;2051;1826;176979;78595;36.9;16.4
66;2021-05-18;3237;1808;180216;80403;37.6;16.8
66;2021-05-19;2876;1340;183092;81743;38.2;17.1
66;2021-05-20;4372;1444;187464;83187;39.1;17.4
66;2021-05-21;3268;1463;190732;84650;39.8;17.7
66;2021-05-22;3065;779;193797;85429;40.5;17.8
66;2021-05-23;1509;236;195306;85665;40.8;17.9
66;2021-05-24;1953;427;197259;86092;41.2;18.0
66;2021-05-25;2796;1688;200055;87780;41.8;18.3
66;2021-05-26;2778;1491;202833;89271;42.3;18.6
66;2021-05-27;3384;2247;206217;91518;43.1;19.1
66;2021-05-28;2683;3034;208900;94552;43.6;19.7
66;2021-05-29;2145;1518;211045;96070;44.1;20.1
66;2021-05-30;786;988;211831;97058;44.2;20.3
66;2021-05-31;2124;1771;213955;98829;44.7;20.6
66;2021-06-01;2636;2002;216591;100831;45.2;21.1
66;2021-06-02;2806;2334;219397;103165;45.8;21.5
66;2021-06-03;2488;2958;221885;106123;46.3;22.2
66;2021-06-04;1958;3351;223843;109474;46.7;22.9
66;2021-06-05;1409;2599;225252;112073;47.0;23.4
66;2021-06-06;294;1228;225546;113301;47.1;23.7
66;2021-06-07;1335;2955;226881;116256;47.4;24.3
66;2021-06-08;1736;3019;228617;119275;47.7;24.9
66;2021-06-09;2066;2787;230683;122062;48.2;25.5
66;2021-06-10;2086;2962;232769;125024;48.6;26.1
66;2021-06-11;2098;3856;234867;128880;49.0;26.9
66;2021-06-12;871;2411;235738;131291;49.2;27.4
66;2021-06-13;516;1333;236254;132624;49.3;27.7
66;2021-06-14;1361;3495;237615;136119;49.6;28.4
66;2021-06-15;2131;3572;239746;139691;50.1;29.2
66;2021-06-16;1792;3568;241538;143259;50.4;29.9
66;2021-06-17;2441;3605;243979;146864;50.9;30.7
66;2021-06-18;2225;3822;246204;150686;51.4;31.5
66;2021-06-19;1542;2320;247746;153006;51.7;31.9
66;2021-06-20;998;1267;248744;154273;51.9;32.2
66;2021-06-21;1163;2879;249907;157152;52.2;32.8
66;2021-06-22;1510;3761;251417;160913;52.5;33.6
66;2021-06-23;1325;3027;252742;163940;52.8;34.2
66;2021-06-24;1527;3226;254269;167166;53.1;34.9
66;2021-06-25;1404;3534;255673;170700;53.4;35.6
66;2021-06-26;962;2680;256635;173380;53.6;36.2
66;2021-06-27;677;1557;257312;174937;53.7;36.5
66;2021-06-28;980;2975;258292;177912;53.9;37.1
66;2021-06-29;1148;3797;259440;181709;54.2;37.9
66;2021-06-30;1278;3306;260718;185015;54.4;38.6
66;2021-07-01;1453;4047;262171;189062;54.7;39.5
66;2021-07-02;1349;3600;263520;192662;55.0;40.2
66;2021-07-03;1152;3898;264672;196560;55.3;41.0
66;2021-07-04;715;1789;265387;198349;55.4;41.4
66;2021-07-05;1293;3005;266680;201354;55.7;42.0
66;2021-07-06;1458;3785;268138;205139;56.0;42.8
66;2021-07-07;1430;3247;269568;208386;56.3;43.5
66;2021-07-08;1387;3384;270955;211770;56.6;44.2
66;2021-07-09;1450;3464;272405;215234;56.9;44.9
66;2021-07-10;1005;2403;273410;217637;57.1;45.4
66;2021-07-11;540;1540;273950;219177;57.2;45.8
66;2021-07-12;1021;3645;274971;222822;57.4;46.5
66;2021-07-13;2223;4261;277194;227083;57.9;47.4
66;2021-07-14;1953;1243;279147;228326;58.3;47.7
66;2021-07-15;2801;3110;281948;231436;58.9;48.3
66;2021-07-16;3410;3211;285358;234647;59.6;49.0
66;2021-07-17;2123;2033;287481;236680;60.0;49.4
66;2021-07-18;1197;1063;288678;237743;60.3;49.6
66;2021-07-19;2793;3083;291471;240826;60.8;50.3
66;2021-07-20;3654;2883;295125;243709;61.6;50.9
66;2021-07-21;3962;2954;299087;246663;62.4;51.5
66;2021-07-22;3917;2820;303004;249483;63.3;52.1
66;2021-07-23;3914;3029;306918;252512;64.1;52.7
66;2021-07-24;2584;1923;309502;254435;64.6;53.1
66;2021-07-25;2020;1241;311522;255676;65.0;53.4
66;2021-07-26;2865;2627;314387;258303;65.6;53.9
66;2021-07-27;3230;2888;317617;261191;66.3;54.5
66;2021-07-28;3355;2582;320972;263773;67.0;55.1
66;2021-07-29;3864;2536;324836;266309;67.8;55.6
66;2021-07-30;4233;2472;329069;268781;68.7;56.1
66;2021-07-31;2231;1716;331300;270497;69.2;56.5
66;2021-08-01;1820;900;333120;271397;69.5;56.7
66;2021-08-02;2390;1919;335510;273316;70.0;57.1
66;2021-08-03;2624;2071;338134;275387;70.6;57.5
66;2021-08-04;2645;1994;340779;277381;71.1;57.9
66;2021-08-05;2444;2438;343223;279819;71.7;58.4
66;2021-08-06;2339;2647;345562;282466;72.1;59.0
66;2021-08-07;1506;2098;347068;284564;72.5;59.4
66;2021-08-08;613;1456;347681;286020;72.6;59.7
66;2021-08-09;1356;2800;349037;288820;72.9;60.3
66;2021-08-10;1648;3074;350685;291894;73.2;60.9
66;2021-08-11;1628;3021;352313;294915;73.6;61.6
66;2021-08-12;1678;2991;353991;297906;73.9;62.2
66;2021-08-13;1473;2984;355464;300890;74.2;62.8
66;2021-08-14;658;2508;356122;303398;74.3;63.3
66;2021-08-15;136;1629;356258;305027;74.4;63.7
66;2021-08-16;1280;2594;357538;307621;74.6;64.2
66;2021-08-17;1496;2980;359034;310601;75.0;64.8
66;2021-08-18;1348;3073;360382;313674;75.2;65.5
66;2021-08-19;1113;2925;361495;316599;75.5;66.1
66;2021-08-20;1006;3322;362501;319921;75.7;66.8
66;2021-08-21;594;2014;363095;321935;75.8;67.2
66;2021-08-22;233;1352;363328;323287;75.9;67.5
66;2021-08-23;1150;2764;364478;326051;76.1;68.1
66;2021-08-24;1064;2952;365542;329003;76.3;68.7
66;2021-08-25;914;2302;366456;331305;76.5;69.2
66;2021-08-26;960;2186;367416;333491;76.7;69.6
66;2021-08-27;915;2366;368331;335857;76.9;70.1
66;2021-08-28;514;1137;368845;336994;77.0;70.4
66;2021-08-29;245;333;369090;337327;77.1;70.4
66;2021-08-30;837;2593;369927;339920;77.2;71.0
66;2021-08-31;835;2726;370762;342646;77.4;71.5
66;2021-09-01;729;2161;371491;344807;77.6;72.0
66;2021-09-02;669;1767;372160;346574;77.7;72.4
66;2021-09-03;716;2043;372876;348617;77.8;72.8
66;2021-09-04;721;1750;373597;350367;78.0;73.1
66;2021-09-05;203;311;373800;350678;78.0;73.2
66;2021-09-06;428;1877;374228;352555;78.1;73.6
66;2021-09-07;377;1637;374605;354192;78.2;73.9
66;2021-09-08;556;1768;375161;355960;78.3;74.3
66;2021-09-09;466;1594;375627;357554;78.4;74.6
66;2021-09-10;495;1531;376122;359085;78.5;75.0
66;2021-09-11;514;1307;376636;360392;78.6;75.2
66;2021-09-12;94;178;376730;360570;78.6;75.3
66;2021-09-13;339;1694;377069;362264;78.7;75.6
66;2021-09-14;384;1459;377453;363723;78.8;75.9
66;2021-09-15;477;959;377930;364682;78.9;76.1
66;2021-09-16;382;795;378312;365477;79.0;76.3
66;2021-09-17;325;771;378637;366248;79.0;76.5
66;2021-09-18;356;1098;378993;367346;79.1;76.7
66;2021-09-19;77;241;379070;367587;79.1;76.7
66;2021-09-20;290;672;379360;368259;79.2;76.9
66;2021-09-21;306;585;379666;368844;79.3;77.0
66;2021-09-22;316;792;379982;369636;79.3;77.2
66;2021-09-23;236;509;380218;370145;79.4;77.3
66;2021-09-24;360;772;380578;370917;79.5;77.4
66;2021-09-25;217;940;380795;371857;79.5;77.6
66;2021-09-26;63;213;380858;372070;79.5;77.7
66;2021-09-27;186;498;381044;372568;79.5;77.8
66;2021-09-28;246;545;381290;373113;79.6;77.9
66;2021-09-29;230;576;381520;373689;79.6;78.0
66;2021-09-30;335;454;381855;374143;79.7;78.1
66;2021-10-01;292;519;382147;374662;79.8;78.2
66;2021-10-02;272;617;382419;375279;79.8;78.3
66;2021-10-03;81;125;382500;375404;79.9;78.4
66;2021-10-04;223;373;382723;375777;79.9;78.5
66;2021-10-05;242;444;382965;376221;80.0;78.5
66;2021-10-06;185;377;383150;376598;80.0;78.6
67;2020-12-27;15;0;15;0;0.0;0.0
67;2020-12-28;4;0;19;0;0.0;0.0
67;2020-12-29;2;0;21;0;0.0;0.0
67;2020-12-30;0;0;21;0;0.0;0.0
67;2020-12-31;1;0;22;0;0.0;0.0
67;2021-01-01;6;0;28;0;0.0;0.0
67;2021-01-02;1;0;29;0;0.0;0.0
67;2021-01-03;1;0;30;0;0.0;0.0
67;2021-01-04;41;0;71;0;0.0;0.0
67;2021-01-05;167;0;238;0;0.0;0.0
67;2021-01-06;121;0;359;0;0.0;0.0
67;2021-01-07;235;1;594;1;0.1;0.0
67;2021-01-08;235;1;829;2;0.1;0.0
67;2021-01-09;113;1;942;3;0.1;0.0
67;2021-01-10;67;0;1009;3;0.1;0.0
67;2021-01-11;184;1;1193;4;0.1;0.0
67;2021-01-12;511;1;1704;5;0.2;0.0
67;2021-01-13;660;2;2364;7;0.2;0.0
67;2021-01-14;1092;7;3456;14;0.3;0.0
67;2021-01-15;942;6;4398;20;0.4;0.0
67;2021-01-16;199;3;4597;23;0.4;0.0
67;2021-01-17;101;0;4698;23;0.4;0.0
67;2021-01-18;903;3;5601;26;0.5;0.0
67;2021-01-19;1423;5;7024;31;0.6;0.0
67;2021-01-20;1854;12;8878;43;0.8;0.0
67;2021-01-21;2217;10;11095;53;1.0;0.0
67;2021-01-22;1993;7;13088;60;1.2;0.0
67;2021-01-23;814;5;13902;65;1.2;0.0
67;2021-01-24;380;1;14282;66;1.3;0.0
67;2021-01-25;526;29;14808;95;1.3;0.0
67;2021-01-26;161;101;14969;196;1.3;0.0
67;2021-01-27;1404;79;16373;275;1.4;0.0
67;2021-01-28;3058;205;19431;480;1.7;0.0
67;2021-01-29;2034;139;21465;619;1.9;0.1
67;2021-01-30;1098;65;22563;684;2.0;0.1
67;2021-01-31;1163;24;23726;708;2.1;0.1
67;2021-02-01;3398;235;27124;943;2.4;0.1
67;2021-02-02;2695;390;29819;1333;2.6;0.1
67;2021-02-03;1577;371;31396;1704;2.8;0.2
67;2021-02-04;1196;713;32592;2417;2.9;0.2
67;2021-02-05;1195;588;33787;3005;3.0;0.3
67;2021-02-06;799;122;34586;3127;3.1;0.3
67;2021-02-07;292;37;34878;3164;3.1;0.3
67;2021-02-08;839;383;35717;3547;3.2;0.3
67;2021-02-09;963;652;36680;4199;3.2;0.4
67;2021-02-10;934;699;37614;4898;3.3;0.4
67;2021-02-11;1151;1059;38765;5957;3.4;0.5
67;2021-02-12;1245;671;40010;6628;3.5;0.6
67;2021-02-13;767;240;40777;6868;3.6;0.6
67;2021-02-14;244;91;41021;6959;3.6;0.6
67;2021-02-15;782;655;41803;7614;3.7;0.7
67;2021-02-16;931;865;42734;8479;3.8;0.7
67;2021-02-17;786;936;43520;9415;3.8;0.8
67;2021-02-18;1402;2333;44922;11748;4.0;1.0
67;2021-02-19;1376;1789;46298;13537;4.1;1.2
67;2021-02-20;634;748;46932;14285;4.1;1.3
67;2021-02-21;209;1074;47141;15359;4.2;1.4
67;2021-02-22;1401;1959;48542;17318;4.3;1.5
67;2021-02-23;1461;1309;50003;18627;4.4;1.6
67;2021-02-24;1439;896;51442;19523;4.5;1.7
67;2021-02-25;1618;1208;53060;20731;4.7;1.8
67;2021-02-26;2227;1162;55287;21893;4.9;1.9
67;2021-02-27;1260;620;56547;22513;5.0;2.0
67;2021-02-28;147;261;56694;22774;5.0;2.0
67;2021-03-01;640;843;57334;23617;5.1;2.1
67;2021-03-02;897;1040;58231;24657;5.1;2.2
67;2021-03-03;1410;1111;59641;25768;5.3;2.3
67;2021-03-04;1963;932;61604;26700;5.4;2.4
67;2021-03-05;3258;999;64862;27699;5.7;2.4
67;2021-03-06;2337;679;67199;28378;5.9;2.5
67;2021-03-07;468;239;67667;28617;6.0;2.5
67;2021-03-08;1188;719;68855;29336;6.1;2.6
67;2021-03-09;2226;821;71081;30157;6.3;2.7
67;2021-03-10;2455;1095;73536;31252;6.5;2.8
67;2021-03-11;3208;1297;76744;32549;6.8;2.9
67;2021-03-12;5262;1313;82006;33862;7.2;3.0
67;2021-03-13;3998;862;86004;34724;7.6;3.1
67;2021-03-14;483;369;86487;35093;7.6;3.1
67;2021-03-15;2192;1123;88679;36216;7.8;3.2
67;2021-03-16;1552;1199;90231;37415;8.0;3.3
67;2021-03-17;2071;893;92302;38308;8.1;3.4
67;2021-03-18;2390;721;94692;39029;8.4;3.4
67;2021-03-19;3673;739;98365;39768;8.7;3.5
67;2021-03-20;3064;503;101429;40271;9.0;3.6
67;2021-03-21;338;17;101767;40288;9.0;3.6
67;2021-03-22;2332;756;104099;41044;9.2;3.6
67;2021-03-23;3401;768;107500;41812;9.5;3.7
67;2021-03-24;3909;796;111409;42608;9.8;3.8
67;2021-03-25;5315;535;116724;43143;10.3;3.8
67;2021-03-26;6869;466;123593;43609;10.9;3.9
67;2021-03-27;3927;344;127520;43953;11.3;3.9
67;2021-03-28;579;98;128099;44051;11.3;3.9
67;2021-03-29;3824;422;131923;44473;11.6;3.9
67;2021-03-30;4848;665;136771;45138;12.1;4.0
67;2021-03-31;4848;692;141619;45830;12.5;4.0
67;2021-04-01;5147;924;146766;46754;13.0;4.1
67;2021-04-02;1009;171;147775;46925;13.0;4.1
67;2021-04-03;1689;282;149464;47207;13.2;4.2
67;2021-04-04;328;5;149792;47212;13.2;4.2
67;2021-04-05;371;5;150163;47217;13.3;4.2
67;2021-04-06;3483;1176;153646;48393;13.6;4.3
67;2021-04-07;4533;1280;158179;49673;14.0;4.4
67;2021-04-08;5664;1405;163843;51078;14.5;4.5
67;2021-04-09;7110;1346;170953;52424;15.1;4.6
67;2021-04-10;4332;888;175285;53312;15.5;4.7
67;2021-04-11;857;425;176142;53737;15.6;4.7
67;2021-04-12;3885;1402;180027;55139;15.9;4.9
67;2021-04-13;4890;1575;184917;56714;16.3;5.0
67;2021-04-14;5297;1898;190214;58612;16.8;5.2
67;2021-04-15;6082;2107;196296;60719;17.3;5.4
67;2021-04-16;7836;2420;204132;63139;18.0;5.6
67;2021-04-17;4010;1575;208142;64714;18.4;5.7
67;2021-04-18;1111;644;209253;65358;18.5;5.8
67;2021-04-19;3630;2140;212883;67498;18.8;6.0
67;2021-04-20;4257;1919;217140;69417;19.2;6.1
67;2021-04-21;4071;2513;221211;71930;19.5;6.4
67;2021-04-22;4478;2917;225689;74847;19.9;6.6
67;2021-04-23;5254;3005;230943;77852;20.4;6.9
67;2021-04-24;3101;2021;234044;79873;20.7;7.1
67;2021-04-25;1027;449;235071;80322;20.8;7.1
67;2021-04-26;3190;2614;238261;82936;21.0;7.3
67;2021-04-27;4023;2903;242284;85839;21.4;7.6
67;2021-04-28;4254;3408;246538;89247;21.8;7.9
67;2021-04-29;5125;3493;251663;92740;22.2;8.2
67;2021-04-30;7182;2458;258845;95198;22.9;8.4
67;2021-05-01;2685;780;261530;95978;23.1;8.5
67;2021-05-02;2181;677;263711;96655;23.3;8.5
67;2021-05-03;5561;2615;269272;99270;23.8;8.8
67;2021-05-04;5854;3601;275126;102871;24.3;9.1
67;2021-05-05;5221;4189;280347;107060;24.8;9.5
67;2021-05-06;6715;4914;287062;111974;25.3;9.9
67;2021-05-07;6435;6896;293497;118870;25.9;10.5
67;2021-05-08;3574;1018;297071;119888;26.2;10.6
67;2021-05-09;3366;592;300437;120480;26.5;10.6
67;2021-05-10;4698;4524;305135;125004;26.9;11.0
67;2021-05-11;5648;4910;310783;129914;27.4;11.5
67;2021-05-12;6597;4832;317380;134746;28.0;11.9
67;2021-05-13;7310;1668;324690;136414;28.7;12.0
67;2021-05-14;8878;5353;333568;141767;29.5;12.5
67;2021-05-15;8198;3655;341766;145422;30.2;12.8
67;2021-05-16;6176;969;347942;146391;30.7;12.9
67;2021-05-17;5689;3878;353631;150269;31.2;13.3
67;2021-05-18;6894;3975;360525;154244;31.8;13.6
67;2021-05-19;7376;4164;367901;158408;32.5;14.0
67;2021-05-20;8681;4229;376582;162637;33.2;14.4
67;2021-05-21;8156;5848;384738;168485;34.0;14.9
67;2021-05-22;5933;3416;390671;171901;34.5;15.2
67;2021-05-23;2656;593;393327;172494;34.7;15.2
67;2021-05-24;4414;863;397741;173357;35.1;15.3
67;2021-05-25;5412;4766;403153;178123;35.6;15.7
67;2021-05-26;6063;4868;409216;182991;36.1;16.2
67;2021-05-27;7310;4884;416526;187875;36.8;16.6
67;2021-05-28;7965;6487;424491;194362;37.5;17.2
67;2021-05-29;6646;3860;431137;198222;38.1;17.5
67;2021-05-30;1147;809;432284;199031;38.2;17.6
67;2021-05-31;6405;4054;438689;203085;38.7;17.9
67;2021-06-01;7326;4393;446015;207478;39.4;18.3
67;2021-06-02;8066;4176;454081;211654;40.1;18.7
67;2021-06-03;8841;4858;462922;216512;40.9;19.1
67;2021-06-04;8594;6119;471516;222631;41.6;19.7
67;2021-06-05;6548;3981;478064;226612;42.2;20.0
67;2021-06-06;3468;875;481532;227487;42.5;20.1
67;2021-06-07;7407;4252;488939;231739;43.2;20.5
67;2021-06-08;8616;4928;497555;236667;43.9;20.9
67;2021-06-09;9258;4785;506813;241452;44.7;21.3
67;2021-06-10;9770;5011;516583;246463;45.6;21.8
67;2021-06-11;8065;8307;524648;254770;46.3;22.5
67;2021-06-12;6789;5199;531437;259969;46.9;23.0
67;2021-06-13;3105;1044;534542;261013;47.2;23.0
67;2021-06-14;5504;6455;540046;267468;47.7;23.6
67;2021-06-15;6688;6750;546734;274218;48.3;24.2
67;2021-06-16;6950;6694;553684;280912;48.9;24.8
67;2021-06-17;7274;9039;560958;289951;49.5;25.6
67;2021-06-18;7601;8499;568559;298450;50.2;26.4
67;2021-06-19;6386;5959;574945;304409;50.8;26.9
67;2021-06-20;1446;1411;576391;305820;50.9;27.0
67;2021-06-21;4266;6775;580657;312595;51.3;27.6
67;2021-06-22;4241;9091;584898;321686;51.6;28.4
67;2021-06-23;5292;8181;590190;329867;52.1;29.1
67;2021-06-24;4521;9098;594711;338965;52.5;29.9
67;2021-06-25;5333;9949;600044;348914;53.0;30.8
67;2021-06-26;3463;9100;603507;358014;53.3;31.6
67;2021-06-27;1023;3523;604530;361537;53.4;31.9
67;2021-06-28;2845;8723;607375;370260;53.6;32.7
67;2021-06-29;2897;8610;610272;378870;53.9;33.5
67;2021-06-30;3381;8742;613653;387612;54.2;34.2
67;2021-07-01;3668;8420;617321;396032;54.5;35.0
67;2021-07-02;3736;10934;621057;406966;54.8;35.9
67;2021-07-03;2981;7742;624038;414708;55.1;36.6
67;2021-07-04;764;1869;624802;416577;55.2;36.8
67;2021-07-05;2625;8250;627427;424827;55.4;37.5
67;2021-07-06;3108;8437;630535;433264;55.7;38.3
67;2021-07-07;3925;8741;634460;442005;56.0;39.0
67;2021-07-08;4203;7785;638663;449790;56.4;39.7
67;2021-07-09;3767;11367;642430;461157;56.7;40.7
67;2021-07-10;2859;8204;645289;469361;57.0;41.4
67;2021-07-11;944;1995;646233;471356;57.1;41.6
67;2021-07-12;2478;9724;648711;481080;57.3;42.5
67;2021-07-13;4122;9886;652833;490966;57.6;43.3
67;2021-07-14;3492;4406;656325;495372;57.9;43.7
67;2021-07-15;5142;12226;661467;507598;58.4;44.8
67;2021-07-16;4867;12290;666334;519888;58.8;45.9
67;2021-07-17;3734;8820;670068;528708;59.2;46.7
67;2021-07-18;1465;2550;671533;531258;59.3;46.9
67;2021-07-19;4649;9739;676182;540997;59.7;47.8
67;2021-07-20;5774;9824;681956;550821;60.2;48.6
67;2021-07-21;5872;10650;687828;561471;60.7;49.6
67;2021-07-22;6439;10223;694267;571694;61.3;50.5
67;2021-07-23;7395;11186;701662;582880;62.0;51.5
67;2021-07-24;5422;7578;707084;590458;62.4;52.1
67;2021-07-25;2316;1971;709400;592429;62.6;52.3
67;2021-07-26;5003;7248;714403;599677;63.1;52.9
67;2021-07-27;6623;7325;721026;607002;63.7;53.6
67;2021-07-28;7542;7208;728568;614210;64.3;54.2
67;2021-07-29;8394;6432;736962;620642;65.1;54.8
67;2021-07-30;8667;7313;745629;627955;65.8;55.4
67;2021-07-31;5112;4878;750741;632833;66.3;55.9
67;2021-08-01;2486;1434;753227;634267;66.5;56.0
67;2021-08-02;6417;5093;759644;639360;67.1;56.5
67;2021-08-03;7323;4714;766967;644074;67.7;56.9
67;2021-08-04;6907;4603;773874;648677;68.3;57.3
67;2021-08-05;5751;4231;779625;652908;68.8;57.6
67;2021-08-06;6333;5426;785958;658334;69.4;58.1
67;2021-08-07;4691;4278;790649;662612;69.8;58.5
67;2021-08-08;1311;1440;791960;664052;69.9;58.6
67;2021-08-09;3144;4480;795104;668532;70.2;59.0
67;2021-08-10;3253;4782;798357;673314;70.5;59.4
67;2021-08-11;3434;4676;801791;677990;70.8;59.9
67;2021-08-12;3146;4887;804937;682877;71.1;60.3
67;2021-08-13;3209;5384;808146;688261;71.4;60.8
67;2021-08-14;2198;5086;810344;693347;71.5;61.2
67;2021-08-15;713;1605;811057;694952;71.6;61.4
67;2021-08-16;2095;5242;813152;700194;71.8;61.8
67;2021-08-17;2107;5278;815259;705472;72.0;62.3
67;2021-08-18;2385;6345;817644;711817;72.2;62.8
67;2021-08-19;1903;6153;819547;717970;72.4;63.4
67;2021-08-20;2362;7460;821909;725430;72.6;64.0
67;2021-08-21;1530;5572;823439;731002;72.7;64.5
67;2021-08-22;390;2050;823829;733052;72.7;64.7
67;2021-08-23;1945;6850;825774;739902;72.9;65.3
67;2021-08-24;1999;6613;827773;746515;73.1;65.9
67;2021-08-25;2127;7217;829900;753732;73.3;66.5
67;2021-08-26;1854;5551;831754;759283;73.4;67.0
67;2021-08-27;2218;7056;833972;766339;73.6;67.7
67;2021-08-28;1705;6106;835677;772445;73.8;68.2
67;2021-08-29;439;1600;836116;774045;73.8;68.3
67;2021-08-30;1424;4444;837540;778489;73.9;68.7
67;2021-08-31;1440;4207;838980;782696;74.1;69.1
67;2021-09-01;1850;4557;840830;787253;74.2;69.5
67;2021-09-02;1086;3131;841916;790384;74.3;69.8
67;2021-09-03;1563;4439;843479;794823;74.5;70.2
67;2021-09-04;1481;4094;844960;798917;74.6;70.5
67;2021-09-05;259;936;845219;799853;74.6;70.6
67;2021-09-06;975;2344;846194;802197;74.7;70.8
67;2021-09-07;898;2238;847092;804435;74.8;71.0
67;2021-09-08;1210;2997;848302;807432;74.9;71.3
67;2021-09-09;1119;2288;849421;809720;75.0;71.5
67;2021-09-10;1436;2892;850857;812612;75.1;71.7
67;2021-09-11;1064;3104;851921;815716;75.2;72.0
67;2021-09-12;253;612;852174;816328;75.2;72.1
67;2021-09-13;701;2049;852875;818377;75.3;72.3
67;2021-09-14;941;2012;853816;820389;75.4;72.4
67;2021-09-15;1020;2106;854836;822495;75.5;72.6
67;2021-09-16;751;1305;855587;823800;75.5;72.7
67;2021-09-17;969;2229;856556;826029;75.6;72.9
67;2021-09-18;806;2422;857362;828451;75.7;73.1
67;2021-09-19;103;411;857465;828862;75.7;73.2
67;2021-09-20;601;1131;858066;829993;75.8;73.3
67;2021-09-21;490;1064;858556;831057;75.8;73.4
67;2021-09-22;669;1950;859225;833007;75.9;73.5
67;2021-09-23;567;942;859792;833949;75.9;73.6
67;2021-09-24;686;1671;860478;835620;76.0;73.8
67;2021-09-25;601;1868;861079;837488;76.0;73.9
67;2021-09-26;73;327;861152;837815;76.0;74.0
67;2021-09-27;398;949;861550;838764;76.1;74.1
67;2021-09-28;404;861;861954;839625;76.1;74.1
67;2021-09-29;619;1358;862573;840983;76.2;74.3
67;2021-09-30;421;931;862994;841914;76.2;74.3
67;2021-10-01;654;1435;863648;843349;76.3;74.5
67;2021-10-02;625;1286;864273;844635;76.3;74.6
67;2021-10-03;90;216;864363;844851;76.3;74.6
67;2021-10-04;313;675;864676;845526;76.3;74.7
67;2021-10-05;318;749;864994;846275;76.4;74.7
67;2021-10-06;565;1123;865559;847398;76.4;74.8
68;2020-12-27;0;0;0;0;0.0;0.0
68;2020-12-28;0;0;0;0;0.0;0.0
68;2020-12-29;0;0;0;0;0.0;0.0
68;2020-12-30;2;0;2;0;0.0;0.0
68;2020-12-31;0;0;2;0;0.0;0.0
68;2021-01-01;0;0;2;0;0.0;0.0
68;2021-01-02;0;0;2;0;0.0;0.0
68;2021-01-03;1;0;3;0;0.0;0.0
68;2021-01-04;2;0;5;0;0.0;0.0
68;2021-01-05;11;0;16;0;0.0;0.0
68;2021-01-06;245;1;261;1;0.0;0.0
68;2021-01-07;75;0;336;1;0.0;0.0
68;2021-01-08;118;1;454;2;0.1;0.0
68;2021-01-09;20;0;474;2;0.1;0.0
68;2021-01-10;1;0;475;2;0.1;0.0
68;2021-01-11;82;0;557;2;0.1;0.0
68;2021-01-12;388;1;945;3;0.1;0.0
68;2021-01-13;704;2;1649;5;0.2;0.0
68;2021-01-14;372;2;2021;7;0.3;0.0
68;2021-01-15;204;1;2225;8;0.3;0.0
68;2021-01-16;1;0;2226;8;0.3;0.0
68;2021-01-17;0;0;2226;8;0.3;0.0
68;2021-01-18;379;5;2605;13;0.3;0.0
68;2021-01-19;559;5;3164;18;0.4;0.0
68;2021-01-20;707;10;3871;28;0.5;0.0
68;2021-01-21;1394;13;5265;41;0.7;0.0
68;2021-01-22;1498;12;6763;53;0.9;0.0
68;2021-01-23;215;3;6978;56;0.9;0.0
68;2021-01-24;699;1;7677;57;1.0;0.0
68;2021-01-25;1390;41;9067;98;1.2;0.0
68;2021-01-26;1555;79;10622;177;1.4;0.0
68;2021-01-27;2779;151;13401;328;1.8;0.0
68;2021-01-28;2358;58;15759;386;2.1;0.1
68;2021-01-29;1509;116;17268;502;2.3;0.1
68;2021-01-30;165;3;17433;505;2.3;0.1
68;2021-01-31;0;0;17433;505;2.3;0.1
68;2021-02-01;737;106;18170;611;2.4;0.1
68;2021-02-02;869;293;19039;904;2.5;0.1
68;2021-02-03;1001;596;20040;1500;2.6;0.2
68;2021-02-04;1001;307;21041;1807;2.8;0.2
68;2021-02-05;947;220;21988;2027;2.9;0.3
68;2021-02-06;140;2;22128;2029;2.9;0.3
68;2021-02-07;2;16;22130;2045;2.9;0.3
68;2021-02-08;893;23;23023;2068;3.0;0.3
68;2021-02-09;1357;42;24380;2110;3.2;0.3
68;2021-02-10;1453;64;25833;2174;3.4;0.3
68;2021-02-11;1486;461;27319;2635;3.6;0.3
68;2021-02-12;1551;435;28870;3070;3.8;0.4
68;2021-02-13;131;1;29001;3071;3.8;0.4
68;2021-02-14;58;232;29059;3303;3.8;0.4
68;2021-02-15;662;969;29721;4272;3.9;0.6
68;2021-02-16;865;1197;30586;5469;4.0;0.7
68;2021-02-17;1288;2010;31874;7479;4.2;1.0
68;2021-02-18;1668;1930;33542;9409;4.4;1.2
68;2021-02-19;988;1247;34530;10656;4.5;1.4
68;2021-02-20;93;118;34623;10774;4.5;1.4
68;2021-02-21;1;38;34624;10812;4.5;1.4
68;2021-02-22;447;683;35071;11495;4.6;1.5
68;2021-02-23;639;968;35710;12463;4.7;1.6
68;2021-02-24;854;1042;36564;13505;4.8;1.8
68;2021-02-25;1208;1135;37772;14640;4.9;1.9
68;2021-02-26;1199;847;38971;15487;5.1;2.0
68;2021-02-27;550;158;39521;15645;5.2;2.0
68;2021-02-28;12;1;39533;15646;5.2;2.1
68;2021-03-01;942;678;40475;16324;5.3;2.1
68;2021-03-02;1215;857;41690;17181;5.5;2.3
68;2021-03-03;1593;896;43283;18077;5.7;2.4
68;2021-03-04;1995;943;45278;19020;5.9;2.5
68;2021-03-05;2355;952;47633;19972;6.2;2.6
68;2021-03-06;2288;237;49921;20209;6.5;2.6
68;2021-03-07;838;104;50759;20313;6.7;2.7
68;2021-03-08;1476;886;52235;21199;6.8;2.8
68;2021-03-09;1698;1236;53933;22435;7.1;2.9
68;2021-03-10;1966;1713;55899;24148;7.3;3.2
68;2021-03-11;2637;1833;58536;25981;7.7;3.4
68;2021-03-12;2631;1350;61167;27331;8.0;3.6
68;2021-03-13;3342;257;64509;27588;8.5;3.6
68;2021-03-14;1541;65;66050;27653;8.7;3.6
68;2021-03-15;1797;606;67847;28259;8.9;3.7
68;2021-03-16;1998;590;69845;28849;9.2;3.8
68;2021-03-17;1958;721;71803;29570;9.4;3.9
68;2021-03-18;2220;934;74023;30504;9.7;4.0
68;2021-03-19;3084;720;77107;31224;10.1;4.1
68;2021-03-20;974;122;78081;31346;10.2;4.1
68;2021-03-21;68;2;78149;31348;10.2;4.1
68;2021-03-22;1964;588;80113;31936;10.5;4.2
68;2021-03-23;2861;614;82974;32550;10.9;4.3
68;2021-03-24;3177;808;86151;33358;11.3;4.4
68;2021-03-25;3502;781;89653;34139;11.7;4.5
68;2021-03-26;3894;723;93547;34862;12.3;4.6
68;2021-03-27;1102;168;94649;35030;12.4;4.6
68;2021-03-28;56;3;94705;35033;12.4;4.6
68;2021-03-29;2260;1354;96965;36387;12.7;4.8
68;2021-03-30;2933;1289;99898;37676;13.1;4.9
68;2021-03-31;2643;1348;102541;39024;13.4;5.1
68;2021-04-01;2748;1540;105289;40564;13.8;5.3
68;2021-04-02;244;88;105533;40652;13.8;5.3
68;2021-04-03;241;123;105774;40775;13.9;5.3
68;2021-04-04;5;0;105779;40775;13.9;5.3
68;2021-04-05;49;3;105828;40778;13.9;5.3
68;2021-04-06;1793;1320;107621;42098;14.1;5.5
68;2021-04-07;2585;1537;110206;43635;14.4;5.7
68;2021-04-08;3234;1504;113440;45139;14.9;5.9
68;2021-04-09;4200;1528;117640;46667;15.4;6.1
68;2021-04-10;1204;1968;118844;48635;15.6;6.4
68;2021-04-11;126;1317;118970;49952;15.6;6.5
68;2021-04-12;2666;1631;121636;51583;15.9;6.8
68;2021-04-13;2760;2108;124396;53691;16.3;7.0
68;2021-04-14;3606;2266;128002;55957;16.8;7.3
68;2021-04-15;4055;2160;132057;58117;17.3;7.6
68;2021-04-16;3942;2080;135999;60197;17.8;7.9
68;2021-04-17;1075;440;137074;60637;18.0;7.9
68;2021-04-18;85;9;137159;60646;18.0;7.9
68;2021-04-19;2358;1829;139517;62475;18.3;8.2
68;2021-04-20;2442;2323;141959;64798;18.6;8.5
68;2021-04-21;2829;2473;144788;67271;19.0;8.8
68;2021-04-22;3287;1972;148075;69243;19.4;9.1
68;2021-04-23;3412;2073;151487;71316;19.8;9.3
68;2021-04-24;842;487;152329;71803;20.0;9.4
68;2021-04-25;214;20;152543;71823;20.0;9.4
68;2021-04-26;2328;2102;154871;73925;20.3;9.7
68;2021-04-27;2599;2212;157470;76137;20.6;10.0
68;2021-04-28;3572;1760;161042;77897;21.1;10.2
68;2021-04-29;4164;1747;165206;79644;21.6;10.4
68;2021-04-30;4834;1369;170040;81013;22.3;10.6
68;2021-05-01;948;119;170988;81132;22.4;10.6
68;2021-05-02;732;69;171720;81201;22.5;10.6
68;2021-05-03;3620;1820;175340;83021;23.0;10.9
68;2021-05-04;3937;2357;179277;85378;23.5;11.2
68;2021-05-05;3632;3240;182909;88618;24.0;11.6
68;2021-05-06;4804;2858;187713;91476;24.6;12.0
68;2021-05-07;4518;2900;192231;94376;25.2;12.4
68;2021-05-08;1672;210;193903;94586;25.4;12.4
68;2021-05-09;1075;107;194978;94693;25.5;12.4
68;2021-05-10;3159;3720;198137;98413;26.0;12.9
68;2021-05-11;4715;3614;202852;102027;26.6;13.4
68;2021-05-12;5785;3292;208637;105319;27.3;13.8
68;2021-05-13;4766;840;213403;106159;28.0;13.9
68;2021-05-14;5959;2131;219362;108290;28.7;14.2
68;2021-05-15;3558;909;222920;109199;29.2;14.3
68;2021-05-16;670;118;223590;109317;29.3;14.3
68;2021-05-17;4449;2498;228039;111815;29.9;14.7
68;2021-05-18;6139;2306;234178;114121;30.7;15.0
68;2021-05-19;5867;2882;240045;117003;31.5;15.3
68;2021-05-20;5928;2410;245973;119413;32.2;15.6
68;2021-05-21;5775;2866;251748;122279;33.0;16.0
68;2021-05-22;2576;925;254324;123204;33.3;16.1
68;2021-05-23;15;16;254339;123220;33.3;16.1
68;2021-05-24;2303;970;256642;124190;33.6;16.3
68;2021-05-25;4343;3435;260985;127625;34.2;16.7
68;2021-05-26;4883;3383;265868;131008;34.8;17.2
68;2021-05-27;5400;3402;271268;134410;35.5;17.6
68;2021-05-28;5623;3717;276891;138127;36.3;18.1
68;2021-05-29;1540;1185;278431;139312;36.5;18.3
68;2021-05-30;41;46;278472;139358;36.5;18.3
68;2021-05-31;5158;2363;283630;141721;37.2;18.6
68;2021-06-01;5989;2790;289619;144511;37.9;18.9
68;2021-06-02;4886;3005;294505;147516;38.6;19.3
68;2021-06-03;5938;3097;300443;150613;39.4;19.7
68;2021-06-04;4896;3299;305339;153912;40.0;20.2
68;2021-06-05;781;1168;306120;155080;40.1;20.3
68;2021-06-06;69;114;306189;155194;40.1;20.3
68;2021-06-07;4753;3035;310942;158229;40.7;20.7
68;2021-06-08;4934;3554;315876;161783;41.4;21.2
68;2021-06-09;4994;3446;320870;165229;42.0;21.6
68;2021-06-10;5200;3144;326070;168373;42.7;22.1
68;2021-06-11;5055;4145;331125;172518;43.4;22.6
68;2021-06-12;3036;1770;334161;174288;43.8;22.8
68;2021-06-13;514;682;334675;174970;43.9;22.9
68;2021-06-14;2516;4390;337191;179360;44.2;23.5
68;2021-06-15;3112;4718;340303;184078;44.6;24.1
68;2021-06-16;3387;4442;343690;188520;45.0;24.7
68;2021-06-17;2359;4453;346049;192973;45.3;25.3
68;2021-06-18;3358;5171;349407;198144;45.8;26.0
68;2021-06-19;2253;2170;351660;200314;46.1;26.2
68;2021-06-20;258;891;351918;201205;46.1;26.4
68;2021-06-21;2059;5148;353977;206353;46.4;27.0
68;2021-06-22;1900;5174;355877;211527;46.6;27.7
68;2021-06-23;2318;5739;358195;217266;46.9;28.5
68;2021-06-24;2153;4897;360348;222163;47.2;29.1
68;2021-06-25;2287;6656;362635;228819;47.5;30.0
68;2021-06-26;1303;2608;363938;231427;47.7;30.3
68;2021-06-27;151;880;364089;232307;47.7;30.4
68;2021-06-28;1601;6444;365690;238751;47.9;31.3
68;2021-06-29;1539;6631;367229;245382;48.1;32.2
68;2021-06-30;1797;6554;369026;251936;48.4;33.0
68;2021-07-01;2105;5351;371131;257287;48.6;33.7
68;2021-07-02;2098;6482;373229;263769;48.9;34.6
68;2021-07-03;989;1934;374218;265703;49.0;34.8
68;2021-07-04;242;200;374460;265903;49.1;34.8
68;2021-07-05;1456;5513;375916;271416;49.3;35.6
68;2021-07-06;2001;5883;377917;277299;49.5;36.3
68;2021-07-07;2455;4974;380372;282273;49.8;37.0
68;2021-07-08;2434;4746;382806;287019;50.2;37.6
68;2021-07-09;2091;7364;384897;294383;50.4;38.6
68;2021-07-10;1028;2002;385925;296385;50.6;38.8
68;2021-07-11;147;156;386072;296541;50.6;38.9
68;2021-07-12;1646;6771;387718;303312;50.8;39.7
68;2021-07-13;2909;6549;390627;309861;51.2;40.6
68;2021-07-14;1840;984;392467;310845;51.4;40.7
68;2021-07-15;3188;6651;395655;317496;51.8;41.6
68;2021-07-16;3817;6761;399472;324257;52.3;42.5
68;2021-07-17;3360;2301;402832;326558;52.8;42.8
68;2021-07-18;1054;230;403886;326788;52.9;42.8
68;2021-07-19;3050;6079;406936;332867;53.3;43.6
68;2021-07-20;4002;5666;410938;338533;53.8;44.4
68;2021-07-21;4339;5831;415277;344364;54.4;45.1
68;2021-07-22;4187;4847;419464;349211;55.0;45.8
68;2021-07-23;5041;5761;424505;354972;55.6;46.5
68;2021-07-24;3349;2131;427854;357103;56.1;46.8
68;2021-07-25;825;537;428679;357640;56.2;46.9
68;2021-07-26;4835;4450;433514;362090;56.8;47.4
68;2021-07-27;6363;3755;439877;365845;57.6;47.9
68;2021-07-28;6848;3882;446725;369727;58.5;48.4
68;2021-07-29;6398;3426;453123;373153;59.4;48.9
68;2021-07-30;6342;4377;459465;377530;60.2;49.5
68;2021-07-31;3917;1426;463382;378956;60.7;49.7
68;2021-08-01;1651;494;465033;379450;60.9;49.7
68;2021-08-02;4606;3150;469639;382600;61.5;50.1
68;2021-08-03;3550;2448;473189;385048;62.0;50.5
68;2021-08-04;3135;2689;476324;387737;62.4;50.8
68;2021-08-05;2753;2639;479077;390376;62.8;51.1
68;2021-08-06;3995;4326;483072;394702;63.3;51.7
68;2021-08-07;1227;1305;484299;396007;63.5;51.9
68;2021-08-08;364;813;484663;396820;63.5;52.0
68;2021-08-09;2574;3683;487237;400503;63.8;52.5
68;2021-08-10;2217;2784;489454;403287;64.1;52.8
68;2021-08-11;1896;2728;491350;406015;64.4;53.2
68;2021-08-12;1752;2666;493102;408681;64.6;53.5
68;2021-08-13;2715;4757;495817;413438;65.0;54.2
68;2021-08-14;714;1443;496531;414881;65.1;54.4
68;2021-08-15;45;445;496576;415326;65.1;54.4
68;2021-08-16;2003;5062;498579;420388;65.3;55.1
68;2021-08-17;1802;4847;500381;425235;65.6;55.7
68;2021-08-18;1182;3697;501563;428932;65.7;56.2
68;2021-08-19;1367;3741;502930;432673;65.9;56.7
68;2021-08-20;2229;6065;505159;438738;66.2;57.5
68;2021-08-21;492;1382;505651;440120;66.3;57.7
68;2021-08-22;116;457;505767;440577;66.3;57.7
68;2021-08-23;1192;5425;506959;446002;66.4;58.4
68;2021-08-24;1407;5953;508366;451955;66.6;59.2
68;2021-08-25;1661;3752;510027;455707;66.8;59.7
68;2021-08-26;1991;4505;512018;460212;67.1;60.3
68;2021-08-27;1850;6281;513868;466493;67.3;61.1
68;2021-08-28;422;1070;514290;467563;67.4;61.3
68;2021-08-29;36;418;514326;467981;67.4;61.3
68;2021-08-30;1346;4555;515672;472536;67.6;61.9
68;2021-08-31;1304;4238;516976;476774;67.7;62.5
68;2021-09-01;883;2281;517859;479055;67.9;62.8
68;2021-09-02;878;1983;518737;481038;68.0;63.0
68;2021-09-03;1306;4621;520043;485659;68.1;63.6
68;2021-09-04;493;955;520536;486614;68.2;63.8
68;2021-09-05;209;176;520745;486790;68.2;63.8
68;2021-09-06;691;2386;521436;489176;68.3;64.1
68;2021-09-07;607;1451;522043;490627;68.4;64.3
68;2021-09-08;618;1487;522661;492114;68.5;64.5
68;2021-09-09;900;1572;523561;493686;68.6;64.7
68;2021-09-10;1483;3346;525044;497032;68.8;65.1
68;2021-09-11;471;675;525515;497707;68.9;65.2
68;2021-09-12;73;63;525588;497770;68.9;65.2
68;2021-09-13;812;1391;526400;499161;69.0;65.4
68;2021-09-14;973;1728;527373;500889;69.1;65.6
68;2021-09-15;692;1584;528065;502473;69.2;65.8
68;2021-09-16;630;1077;528695;503550;69.3;66.0
68;2021-09-17;982;2329;529677;505879;69.4;66.3
68;2021-09-18;435;762;530112;506641;69.5;66.4
68;2021-09-19;16;48;530128;506689;69.5;66.4
68;2021-09-20;546;966;530674;507655;69.5;66.5
68;2021-09-21;583;1327;531257;508982;69.6;66.7
68;2021-09-22;633;1154;531890;510136;69.7;66.8
68;2021-09-23;367;679;532257;510815;69.7;66.9
68;2021-09-24;644;1606;532901;512421;69.8;67.1
68;2021-09-25;276;668;533177;513089;69.9;67.2
68;2021-09-26;19;56;533196;513145;69.9;67.2
68;2021-09-27;338;686;533534;513831;69.9;67.3
68;2021-09-28;335;545;533869;514376;70.0;67.4
68;2021-09-29;538;875;534407;515251;70.0;67.5
68;2021-09-30;386;789;534793;516040;70.1;67.6
68;2021-10-01;500;1536;535293;517576;70.1;67.8
68;2021-10-02;246;570;535539;518146;70.2;67.9
68;2021-10-03;36;89;535575;518235;70.2;67.9
68;2021-10-04;213;424;535788;518659;70.2;68.0
68;2021-10-05;289;560;536077;519219;70.2;68.0
68;2021-10-06;373;872;536450;520091;70.3;68.1
69;2020-12-27;5;0;5;0;0.0;0.0
69;2020-12-28;13;0;18;0;0.0;0.0
69;2020-12-29;5;0;23;0;0.0;0.0
69;2020-12-30;6;0;29;0;0.0;0.0
69;2020-12-31;12;0;41;0;0.0;0.0
69;2021-01-01;2;0;43;0;0.0;0.0
69;2021-01-02;2;0;45;0;0.0;0.0
69;2021-01-03;3;0;48;0;0.0;0.0
69;2021-01-04;13;0;61;0;0.0;0.0
69;2021-01-05;218;0;279;0;0.0;0.0
69;2021-01-06;518;0;797;0;0.0;0.0
69;2021-01-07;813;0;1610;0;0.1;0.0
69;2021-01-08;829;1;2439;1;0.1;0.0
69;2021-01-09;41;1;2480;2;0.1;0.0
69;2021-01-10;3;1;2483;3;0.1;0.0
69;2021-01-11;1135;2;3618;5;0.2;0.0
69;2021-01-12;1399;8;5017;13;0.3;0.0
69;2021-01-13;1395;3;6412;16;0.3;0.0
69;2021-01-14;2285;17;8697;33;0.5;0.0
69;2021-01-15;1829;8;10526;41;0.6;0.0
69;2021-01-16;930;3;11456;44;0.6;0.0
69;2021-01-17;260;2;11716;46;0.6;0.0
69;2021-01-18;1695;18;13411;64;0.7;0.0
69;2021-01-19;3512;36;16923;100;0.9;0.0
69;2021-01-20;4456;29;21379;129;1.1;0.0
69;2021-01-21;4078;26;25457;155;1.4;0.0
69;2021-01-22;3184;19;28641;174;1.5;0.0
69;2021-01-23;1287;5;29928;179;1.6;0.0
69;2021-01-24;102;1;30030;180;1.6;0.0
69;2021-01-25;2245;36;32275;216;1.7;0.0
69;2021-01-26;2563;88;34838;304;1.9;0.0
69;2021-01-27;2359;169;37197;473;2.0;0.0
69;2021-01-28;2238;351;39435;824;2.1;0.0
69;2021-01-29;2111;273;41546;1097;2.2;0.1
69;2021-01-30;889;3;42435;1100;2.3;0.1
69;2021-01-31;65;0;42500;1100;2.3;0.1
69;2021-02-01;1112;383;43612;1483;2.3;0.1
69;2021-02-02;1559;382;45171;1865;2.4;0.1
69;2021-02-03;1444;518;46615;2383;2.5;0.1
69;2021-02-04;1795;898;48410;3281;2.6;0.2
69;2021-02-05;821;797;49231;4078;2.6;0.2
69;2021-02-06;370;41;49601;4119;2.6;0.2
69;2021-02-07;0;0;49601;4119;2.6;0.2
69;2021-02-08;1133;938;50734;5057;2.7;0.3
69;2021-02-09;2052;1795;52786;6852;2.8;0.4
69;2021-02-10;1855;2407;54641;9259;2.9;0.5
69;2021-02-11;1860;2960;56501;12219;3.0;0.7
69;2021-02-12;1905;1797;58406;14016;3.1;0.7
69;2021-02-13;460;564;58866;14580;3.1;0.8
69;2021-02-14;89;32;58955;14612;3.1;0.8
69;2021-02-15;1016;1407;59971;16019;3.2;0.9
69;2021-02-16;984;1859;60955;17878;3.2;1.0
69;2021-02-17;1026;1896;61981;19774;3.3;1.1
69;2021-02-18;967;1834;62948;21608;3.4;1.2
69;2021-02-19;890;1485;63838;23093;3.4;1.2
69;2021-02-20;321;672;64159;23765;3.4;1.3
69;2021-02-21;53;53;64212;23818;3.4;1.3
69;2021-02-22;609;1697;64821;25515;3.5;1.4
69;2021-02-23;741;1835;65562;27350;3.5;1.5
69;2021-02-24;973;1857;66535;29207;3.5;1.6
69;2021-02-25;2214;2314;68749;31521;3.7;1.7
69;2021-02-26;2772;1652;71521;33173;3.8;1.8
69;2021-02-27;925;496;72446;33669;3.9;1.8
69;2021-02-28;148;98;72594;33767;3.9;1.8
69;2021-03-01;2168;748;74762;34515;4.0;1.8
69;2021-03-02;3299;1184;78061;35699;4.2;1.9
69;2021-03-03;3670;1134;81731;36833;4.4;2.0
69;2021-03-04;4887;1210;86618;38043;4.6;2.0
69;2021-03-05;5875;1117;92493;39160;4.9;2.1
69;2021-03-06;3417;369;95910;39529;5.1;2.1
69;2021-03-07;640;44;96550;39573;5.1;2.1
69;2021-03-08;2960;992;99510;40565;5.3;2.2
69;2021-03-09;4607;1108;104117;41673;5.5;2.2
69;2021-03-10;5072;968;109189;42641;5.8;2.3
69;2021-03-11;6603;982;115792;43623;6.2;2.3
69;2021-03-12;8856;1114;124648;44737;6.6;2.4
69;2021-03-13;4928;242;129576;44979;6.9;2.4
69;2021-03-14;2741;150;132317;45129;7.1;2.4
69;2021-03-15;4803;675;137120;45804;7.3;2.4
69;2021-03-16;3819;656;140939;46460;7.5;2.5
69;2021-03-17;3953;868;144892;47328;7.7;2.5
69;2021-03-18;4965;1534;149857;48862;8.0;2.6
69;2021-03-19;6684;971;156541;49833;8.3;2.7
69;2021-03-20;3593;278;160134;50111;8.5;2.7
69;2021-03-21;1975;101;162109;50212;8.6;2.7
69;2021-03-22;4550;742;166659;50954;8.9;2.7
69;2021-03-23;7364;808;174023;51762;9.3;2.8
69;2021-03-24;6456;994;180479;52756;9.6;2.8
69;2021-03-25;8595;1123;189074;53879;10.1;2.9
69;2021-03-26;8814;1247;197888;55126;10.5;2.9
69;2021-03-27;3157;789;201045;55915;10.7;3.0
69;2021-03-28;2219;186;203264;56101;10.8;3.0
69;2021-03-29;4097;2168;207361;58269;11.1;3.1
69;2021-03-30;7640;2532;215001;60801;11.5;3.2
69;2021-03-31;6355;3100;221356;63901;11.8;3.4
69;2021-04-01;8462;2721;229818;66622;12.3;3.6
69;2021-04-02;8315;3106;238133;69728;12.7;3.7
69;2021-04-03;5424;2115;243557;71843;13.0;3.8
69;2021-04-04;6610;543;250167;72386;13.3;3.9
69;2021-04-05;6190;816;256357;73202;13.7;3.9
69;2021-04-06;5114;3466;261471;76668;13.9;4.1
69;2021-04-07;5168;3865;266639;80533;14.2;4.3
69;2021-04-08;6431;3999;273070;84532;14.6;4.5
69;2021-04-09;9165;3736;282235;88268;15.0;4.7
69;2021-04-10;3054;2492;285289;90760;15.2;4.8
69;2021-04-11;2036;1895;287325;92655;15.3;4.9
69;2021-04-12;5474;3557;292799;96212;15.6;5.1
69;2021-04-13;7068;4113;299867;100325;16.0;5.3
69;2021-04-14;6718;4157;306585;104482;16.3;5.6
69;2021-04-15;7943;4595;314528;109077;16.8;5.8
69;2021-04-16;7868;4488;322396;113565;17.2;6.1
69;2021-04-17;5036;2310;327432;115875;17.5;6.2
69;2021-04-18;1715;1790;329147;117665;17.5;6.3
69;2021-04-19;7020;3774;336167;121439;17.9;6.5
69;2021-04-20;6485;4761;342652;126200;18.3;6.7
69;2021-04-21;5688;4415;348340;130615;18.6;7.0
69;2021-04-22;6427;5438;354767;136053;18.9;7.3
69;2021-04-23;6735;4900;361502;140953;19.3;7.5
69;2021-04-24;3160;2031;364662;142984;19.4;7.6
69;2021-04-25;2120;1544;366782;144528;19.6;7.7
69;2021-04-26;4495;3869;371277;148397;19.8;7.9
69;2021-04-27;6516;5305;377793;153702;20.1;8.2
69;2021-04-28;6272;4859;384065;158561;20.5;8.5
69;2021-04-29;6706;5361;390771;163922;20.8;8.7
69;2021-04-30;6931;6141;397702;170063;21.2;9.1
69;2021-05-01;3301;643;401003;170706;21.4;9.1
69;2021-05-02;1628;5880;402631;176586;21.5;9.4
69;2021-05-03;5860;8240;408491;184826;21.8;9.9
69;2021-05-04;7608;8152;416099;192978;22.2;10.3
69;2021-05-05;11210;5657;427309;198635;22.8;10.6
69;2021-05-06;12470;6296;439779;204931;23.4;10.9
69;2021-05-07;11685;7134;451464;212065;24.1;11.3
69;2021-05-08;4303;1652;455767;213717;24.3;11.4
69;2021-05-09;6634;2679;462401;216396;24.6;11.5
69;2021-05-10;6935;6066;469336;222462;25.0;11.9
69;2021-05-11;9829;7032;479165;229494;25.5;12.2
69;2021-05-12;12450;6784;491615;236278;26.2;12.6
69;2021-05-13;10839;2561;502454;238839;26.8;12.7
69;2021-05-14;12598;5209;515052;244048;27.5;13.0
69;2021-05-15;9136;2591;524188;246639;27.9;13.1
69;2021-05-16;8403;1875;532591;248514;28.4;13.2
69;2021-05-17;11306;5649;543897;254163;29.0;13.5
69;2021-05-18;13226;6398;557123;260561;29.7;13.9
69;2021-05-19;13696;5888;570819;266449;30.4;14.2
69;2021-05-20;11387;6077;582206;272526;31.0;14.5
69;2021-05-21;11036;6545;593242;279071;31.6;14.9
69;2021-05-22;5574;2575;598816;281646;31.9;15.0
69;2021-05-23;4573;1544;603389;283190;32.2;15.1
69;2021-05-24;8420;1864;611809;285054;32.6;15.2
69;2021-05-25;9741;6175;621550;291229;33.1;15.5
69;2021-05-26;10282;6105;631832;297334;33.7;15.8
69;2021-05-27;10429;6781;642261;304115;34.2;16.2
69;2021-05-28;11609;8734;653870;312849;34.9;16.7
69;2021-05-29;7387;6045;661257;318894;35.2;17.0
69;2021-05-30;7387;3169;668644;322063;35.6;17.2
69;2021-05-31;10955;6374;679599;328437;36.2;17.5
69;2021-06-01;12843;7499;692442;335936;36.9;17.9
69;2021-06-02;14887;6721;707329;342657;37.7;18.3
69;2021-06-03;16641;7424;723970;350081;38.6;18.7
69;2021-06-04;16199;8550;740169;358631;39.5;19.1
69;2021-06-05;10104;3416;750273;362047;40.0;19.3
69;2021-06-06;7488;1719;757761;363766;40.4;19.4
69;2021-06-07;12815;7019;770576;370785;41.1;19.8
69;2021-06-08;16309;8276;786885;379061;41.9;20.2
69;2021-06-09;15212;7351;802097;386412;42.8;20.6
69;2021-06-10;16276;7327;818373;393739;43.6;21.0
69;2021-06-11;16635;9676;835008;403415;44.5;21.5
69;2021-06-12;8529;4188;843537;407603;45.0;21.7
69;2021-06-13;5620;2146;849157;409749;45.3;21.8
69;2021-06-14;8574;9082;857731;418831;45.7;22.3
69;2021-06-15;10932;11013;868663;429844;46.3;22.9
69;2021-06-16;11332;12317;879995;442161;46.9;23.6
69;2021-06-17;11454;13255;891449;455416;47.5;24.3
69;2021-06-18;12044;14769;903493;470185;48.2;25.1
69;2021-06-19;6813;8354;910306;478539;48.5;25.5
69;2021-06-20;5273;4768;915579;483307;48.8;25.8
69;2021-06-21;6537;12118;922116;495425;49.2;26.4
69;2021-06-22;7210;13823;929326;509248;49.5;27.1
69;2021-06-23;8347;13025;937673;522273;50.0;27.8
69;2021-06-24;9293;13741;946966;536014;50.5;28.6
69;2021-06-25;7079;16307;954045;552321;50.9;29.4
69;2021-06-26;3871;9070;957916;561391;51.1;29.9
69;2021-06-27;3291;7420;961207;568811;51.2;30.3
69;2021-06-28;4550;14891;965757;583702;51.5;31.1
69;2021-06-29;5367;15667;971124;599369;51.8;31.9
69;2021-06-30;6387;14447;977511;613816;52.1;32.7
69;2021-07-01;9044;11978;986555;625794;52.6;33.4
69;2021-07-02;10686;14127;997241;639921;53.2;34.1
69;2021-07-03;5993;7771;1003234;647692;53.5;34.5
69;2021-07-04;4126;5550;1007360;653242;53.7;34.8
69;2021-07-05;6229;13021;1013589;666263;54.0;35.5
69;2021-07-06;5914;14276;1019503;680539;54.3;36.3
69;2021-07-07;7317;13561;1026820;694100;54.7;37.0
69;2021-07-08;7587;13408;1034407;707508;55.1;37.7
69;2021-07-09;7584;16470;1041991;723978;55.5;38.6
69;2021-07-10;3124;10312;1045115;734290;55.7;39.1
69;2021-07-11;4331;5830;1049446;740120;55.9;39.5
69;2021-07-12;4212;16969;1053658;757089;56.2;40.4
69;2021-07-13;6451;20717;1060109;777806;56.5;41.5
69;2021-07-14;5056;8482;1065165;786288;56.8;41.9
69;2021-07-15;7497;22576;1072662;808864;57.2;43.1
69;2021-07-16;9962;20109;1082624;828973;57.7;44.2
69;2021-07-17;4882;12237;1087506;841210;58.0;44.8
69;2021-07-18;3411;8894;1090917;850104;58.1;45.3
69;2021-07-19;7067;16456;1097984;866560;58.5;46.2
69;2021-07-20;9578;19305;1107562;885865;59.0;47.2
69;2021-07-21;9386;17421;1116948;903286;59.5;48.1
69;2021-07-22;11470;16394;1128418;919680;60.1;49.0
69;2021-07-23;11138;17683;1139556;937363;60.7;50.0
69;2021-07-24;5705;11049;1145261;948412;61.0;50.6
69;2021-07-25;4706;6631;1149967;955043;61.3;50.9
69;2021-07-26;8927;12951;1158894;967994;61.8;51.6
69;2021-07-27;12938;12094;1171832;980088;62.5;52.2
69;2021-07-28;12091;12155;1183923;992243;63.1;52.9
69;2021-07-29;14761;12262;1198684;1004505;63.9;53.5
69;2021-07-30;14417;12244;1213101;1016749;64.7;54.2
69;2021-07-31;8270;7254;1221371;1024003;65.1;54.6
69;2021-08-01;5185;5880;1226556;1029883;65.4;54.9
69;2021-08-02;13235;9637;1239791;1039520;66.1;55.4
69;2021-08-03;13289;8984;1253080;1048504;66.8;55.9
69;2021-08-04;14347;8139;1267427;1056643;67.6;56.3
69;2021-08-05;11529;7539;1278956;1064182;68.2;56.7
69;2021-08-06;10595;7798;1289551;1071980;68.7;57.1
69;2021-08-07;5004;4811;1294555;1076791;69.0;57.4
69;2021-08-08;4371;3564;1298926;1080355;69.2;57.6
69;2021-08-09;7776;9219;1306702;1089574;69.7;58.1
69;2021-08-10;8082;7036;1314784;1096610;70.1;58.5
69;2021-08-11;7898;8113;1322682;1104723;70.5;58.9
69;2021-08-12;7313;7333;1329995;1112056;70.9;59.3
69;2021-08-13;6743;8361;1336738;1120417;71.3;59.7
69;2021-08-14;4511;5210;1341249;1125627;71.5;60.0
69;2021-08-15;2490;2522;1343739;1128149;71.6;60.1
69;2021-08-16;5932;8882;1349671;1137031;71.9;60.6
69;2021-08-17;6418;8275;1356089;1145306;72.3;61.0
69;2021-08-18;6251;9473;1362340;1154779;72.6;61.6
69;2021-08-19;6336;9335;1368676;1164114;73.0;62.1
69;2021-08-20;6153;8845;1374829;1172959;73.3;62.5
69;2021-08-21;2862;3958;1377691;1176917;73.4;62.7
69;2021-08-22;1964;2420;1379655;1179337;73.5;62.9
69;2021-08-23;3943;12384;1383598;1191721;73.8;63.5
69;2021-08-24;5183;13643;1388781;1205364;74.0;64.3
69;2021-08-25;4554;12909;1393335;1218273;74.3;64.9
69;2021-08-26;4553;11735;1397888;1230008;74.5;65.6
69;2021-08-27;4305;14452;1402193;1244460;74.7;66.3
69;2021-08-28;1964;8635;1404157;1253095;74.8;66.8
69;2021-08-29;1336;6527;1405493;1259622;74.9;67.1
69;2021-08-30;3256;11814;1408749;1271436;75.1;67.8
69;2021-08-31;4192;10192;1412941;1281628;75.3;68.3
69;2021-09-01;4301;9793;1417242;1291421;75.5;68.8
69;2021-09-02;4330;9245;1421572;1300666;75.8;69.3
69;2021-09-03;4121;11258;1425693;1311924;76.0;69.9
69;2021-09-04;2568;8721;1428261;1320645;76.1;70.4
69;2021-09-05;1420;3854;1429681;1324499;76.2;70.6
69;2021-09-06;2221;6916;1431902;1331415;76.3;71.0
69;2021-09-07;2321;6981;1434223;1338396;76.4;71.3
69;2021-09-08;2655;7516;1436878;1345912;76.6;71.7
69;2021-09-09;2371;6775;1439249;1352687;76.7;72.1
69;2021-09-10;2579;7624;1441828;1360311;76.9;72.5
69;2021-09-11;1627;5282;1443455;1365593;76.9;72.8
69;2021-09-12;526;2339;1443981;1367932;77.0;72.9
69;2021-09-13;1613;5475;1445594;1373407;77.1;73.2
69;2021-09-14;1795;5517;1447389;1378924;77.2;73.5
69;2021-09-15;1843;5051;1449232;1383975;77.2;73.8
69;2021-09-16;1512;3490;1450744;1387465;77.3;74.0
69;2021-09-17;1767;4883;1452511;1392348;77.4;74.2
69;2021-09-18;1094;4089;1453605;1396437;77.5;74.4
69;2021-09-19;478;1523;1454083;1397960;77.5;74.5
69;2021-09-20;941;2992;1455024;1400952;77.6;74.7
69;2021-09-21;974;3513;1455998;1404465;77.6;74.9
69;2021-09-22;1143;4069;1457141;1408534;77.7;75.1
69;2021-09-23;906;3070;1458047;1411604;77.7;75.2
69;2021-09-24;1243;4183;1459290;1415787;77.8;75.5
69;2021-09-25;715;2731;1460005;1418518;77.8;75.6
69;2021-09-26;296;1212;1460301;1419730;77.8;75.7
69;2021-09-27;659;2037;1460960;1421767;77.9;75.8
69;2021-09-28;922;2103;1461882;1423870;77.9;75.9
69;2021-09-29;1137;3288;1463019;1427158;78.0;76.1
69;2021-09-30;933;2358;1463952;1429516;78.0;76.2
69;2021-10-01;1492;3521;1465444;1433037;78.1;76.4
69;2021-10-02;939;2256;1466383;1435293;78.2;76.5
69;2021-10-03;316;645;1466699;1435938;78.2;76.5
69;2021-10-04;772;2009;1467471;1437947;78.2;76.6
69;2021-10-05;770;1832;1468241;1439779;78.3;76.7
69;2021-10-06;1082;2423;1469323;1442202;78.3;76.9
70;2020-12-27;0;0;0;0;0.0;0.0
70;2020-12-28;0;0;0;0;0.0;0.0
70;2020-12-29;0;0;0;0;0.0;0.0
70;2020-12-30;0;0;0;0;0.0;0.0
70;2020-12-31;0;0;0;0;0.0;0.0
70;2021-01-01;0;0;0;0;0.0;0.0
70;2021-01-02;0;0;0;0;0.0;0.0
70;2021-01-03;0;0;0;0;0.0;0.0
70;2021-01-04;0;0;0;0;0.0;0.0
70;2021-01-05;1;0;1;0;0.0;0.0
70;2021-01-06;24;0;25;0;0.0;0.0
70;2021-01-07;121;0;146;0;0.1;0.0
70;2021-01-08;22;0;168;0;0.1;0.0
70;2021-01-09;0;0;168;0;0.1;0.0
70;2021-01-10;0;0;168;0;0.1;0.0
70;2021-01-11;148;1;316;1;0.1;0.0
70;2021-01-12;201;1;517;2;0.2;0.0
70;2021-01-13;172;2;689;4;0.3;0.0
70;2021-01-14;148;5;837;9;0.4;0.0
70;2021-01-15;153;1;990;10;0.4;0.0
70;2021-01-16;65;0;1055;10;0.5;0.0
70;2021-01-17;0;0;1055;10;0.5;0.0
70;2021-01-18;398;0;1453;10;0.6;0.0
70;2021-01-19;503;2;1956;12;0.8;0.0
70;2021-01-20;494;2;2450;14;1.1;0.0
70;2021-01-21;675;2;3125;16;1.3;0.0
70;2021-01-22;458;2;3583;18;1.5;0.0
70;2021-01-23;261;2;3844;20;1.6;0.0
70;2021-01-24;4;0;3848;20;1.7;0.0
70;2021-01-25;369;1;4217;21;1.8;0.0
70;2021-01-26;335;1;4552;22;2.0;0.0
70;2021-01-27;331;10;4883;32;2.1;0.0
70;2021-01-28;366;35;5249;67;2.3;0.0
70;2021-01-29;329;52;5578;119;2.4;0.1
70;2021-01-30;228;0;5806;119;2.5;0.1
70;2021-01-31;0;0;5806;119;2.5;0.1
70;2021-02-01;262;32;6068;151;2.6;0.1
70;2021-02-02;272;92;6340;243;2.7;0.1
70;2021-02-03;251;54;6591;297;2.8;0.1
70;2021-02-04;265;120;6856;417;2.9;0.2
70;2021-02-05;254;72;7110;489;3.0;0.2
70;2021-02-06;209;37;7319;526;3.1;0.2
70;2021-02-07;0;0;7319;526;3.1;0.2
70;2021-02-08;179;150;7498;676;3.2;0.3
70;2021-02-09;206;140;7704;816;3.3;0.3
70;2021-02-10;196;216;7900;1032;3.4;0.4
70;2021-02-11;351;270;8251;1302;3.5;0.6
70;2021-02-12;239;406;8490;1708;3.6;0.7
70;2021-02-13;75;145;8565;1853;3.7;0.8
70;2021-02-14;0;29;8565;1882;3.7;0.8
70;2021-02-15;70;271;8635;2153;3.7;0.9
70;2021-02-16;113;279;8748;2432;3.8;1.0
70;2021-02-17;164;272;8912;2704;3.8;1.2
70;2021-02-18;205;225;9117;2929;3.9;1.3
70;2021-02-19;197;180;9314;3109;4.0;1.3
70;2021-02-20;192;56;9506;3165;4.1;1.4
70;2021-02-21;1;0;9507;3165;4.1;1.4
70;2021-02-22;106;181;9613;3346;4.1;1.4
70;2021-02-23;125;206;9738;3552;4.2;1.5
70;2021-02-24;132;178;9870;3730;4.2;1.6
70;2021-02-25;315;199;10185;3929;4.4;1.7
70;2021-02-26;395;122;10580;4051;4.5;1.7
70;2021-02-27;147;146;10727;4197;4.6;1.8
70;2021-02-28;0;0;10727;4197;4.6;1.8
70;2021-03-01;248;206;10975;4403;4.7;1.9
70;2021-03-02;487;232;11462;4635;4.9;2.0
70;2021-03-03;468;219;11930;4854;5.1;2.1
70;2021-03-04;693;236;12623;5090;5.4;2.2
70;2021-03-05;767;225;13390;5315;5.7;2.3
70;2021-03-06;539;99;13929;5414;6.0;2.3
70;2021-03-07;216;23;14145;5437;6.1;2.3
70;2021-03-08;554;194;14699;5631;6.3;2.4
70;2021-03-09;864;165;15563;5796;6.7;2.5
70;2021-03-10;659;171;16222;5967;7.0;2.6
70;2021-03-11;698;244;16920;6211;7.3;2.7
70;2021-03-12;985;173;17905;6384;7.7;2.7
70;2021-03-13;583;117;18488;6501;7.9;2.8
70;2021-03-14;20;1;18508;6502;7.9;2.8
70;2021-03-15;774;104;19282;6606;8.3;2.8
70;2021-03-16;655;97;19937;6703;8.5;2.9
70;2021-03-17;595;179;20532;6882;8.8;3.0
70;2021-03-18;633;138;21165;7020;9.1;3.0
70;2021-03-19;1019;139;22184;7159;9.5;3.1
70;2021-03-20;641;186;22825;7345;9.8;3.1
70;2021-03-21;9;0;22834;7345;9.8;3.1
70;2021-03-22;757;98;23591;7443;10.1;3.2
70;2021-03-23;1310;156;24901;7599;10.7;3.3
70;2021-03-24;1270;106;26171;7705;11.2;3.3
70;2021-03-25;1247;198;27418;7903;11.8;3.4
70;2021-03-26;1485;300;28903;8203;12.4;3.5
70;2021-03-27;957;128;29860;8331;12.8;3.6
70;2021-03-28;0;10;29860;8341;12.8;3.6
70;2021-03-29;721;413;30581;8754;13.1;3.8
70;2021-03-30;1093;315;31674;9069;13.6;3.9
70;2021-03-31;878;317;32552;9386;14.0;4.0
70;2021-04-01;1153;428;33705;9814;14.5;4.2
70;2021-04-02;1310;345;35015;10159;15.0;4.4
70;2021-04-03;639;321;35654;10480;15.3;4.5
70;2021-04-04;11;0;35665;10480;15.3;4.5
70;2021-04-05;4;2;35669;10482;15.3;4.5
70;2021-04-06;831;555;36500;11037;15.7;4.7
70;2021-04-07;858;588;37358;11625;16.0;5.0
70;2021-04-08;1319;561;38677;12186;16.6;5.2
70;2021-04-09;1402;537;40079;12723;17.2;5.5
70;2021-04-10;859;346;40938;13069;17.6;5.6
70;2021-04-11;23;1;40961;13070;17.6;5.6
70;2021-04-12;696;660;41657;13730;17.9;5.9
70;2021-04-13;921;769;42578;14499;18.3;6.2
70;2021-04-14;816;576;43394;15075;18.6;6.5
70;2021-04-15;1079;604;44473;15679;19.1;6.7
70;2021-04-16;1242;551;45715;16230;19.6;7.0
70;2021-04-17;689;468;46404;16698;19.9;7.2
70;2021-04-18;62;4;46466;16702;19.9;7.2
70;2021-04-19;540;809;47006;17511;20.2;7.5
70;2021-04-20;663;852;47669;18363;20.4;7.9
70;2021-04-21;483;926;48152;19289;20.6;8.3
70;2021-04-22;775;801;48927;20090;21.0;8.6
70;2021-04-23;875;740;49802;20830;21.4;8.9
70;2021-04-24;432;642;50234;21472;21.5;9.2
70;2021-04-25;11;0;50245;21472;21.5;9.2
70;2021-04-26;923;604;51168;22076;21.9;9.5
70;2021-04-27;1208;753;52376;22829;22.5;9.8
70;2021-04-28;889;811;53265;23640;22.8;10.1
70;2021-04-29;1342;928;54607;24568;23.4;10.5
70;2021-04-30;1533;871;56140;25439;24.1;10.9
70;2021-05-01;1694;120;57834;25559;24.8;11.0
70;2021-05-02;2;0;57836;25559;24.8;11.0
70;2021-05-03;1189;580;59025;26139;25.3;11.2
70;2021-05-04;1353;754;60378;26893;25.9;11.5
70;2021-05-05;1188;879;61566;27772;26.4;11.9
70;2021-05-06;1845;1270;63411;29042;27.2;12.5
70;2021-05-07;2127;1239;65538;30281;28.1;13.0
70;2021-05-08;1342;194;66880;30475;28.7;13.1
70;2021-05-09;9;57;66889;30532;28.7;13.1
70;2021-05-10;961;946;67850;31478;29.1;13.5
70;2021-05-11;1240;1076;69090;32554;29.6;14.0
70;2021-05-12;1175;862;70265;33416;30.1;14.3
70;2021-05-13;1544;147;71809;33563;30.8;14.4
70;2021-05-14;2062;754;73871;34317;31.7;14.7
70;2021-05-15;2657;531;76528;34848;32.8;14.9
70;2021-05-16;999;72;77527;34920;33.2;15.0
70;2021-05-17;1237;386;78764;35306;33.8;15.1
70;2021-05-18;1296;591;80060;35897;34.3;15.4
70;2021-05-19;1476;480;81536;36377;35.0;15.6
70;2021-05-20;1779;630;83315;37007;35.7;15.9
70;2021-05-21;1692;817;85007;37824;36.5;16.2
70;2021-05-22;1219;666;86226;38490;37.0;16.5
70;2021-05-23;8;14;86234;38504;37.0;16.5
70;2021-05-24;227;27;86461;38531;37.1;16.5
70;2021-05-25;837;926;87298;39457;37.4;16.9
70;2021-05-26;1048;946;88346;40403;37.9;17.3
70;2021-05-27;1263;996;89609;41399;38.4;17.8
70;2021-05-28;1546;1158;91155;42557;39.1;18.2
70;2021-05-29;1370;587;92525;43144;39.7;18.5
70;2021-05-30;1;8;92526;43152;39.7;18.5
70;2021-05-31;969;679;93495;43831;40.1;18.8
70;2021-06-01;1213;848;94708;44679;40.6;19.2
70;2021-06-02;1265;678;95973;45357;41.2;19.5
70;2021-06-03;1429;837;97402;46194;41.8;19.8
70;2021-06-04;1335;1111;98737;47305;42.3;20.3
70;2021-06-05;1024;663;99761;47968;42.8;20.6
70;2021-06-06;599;79;100360;48047;43.0;20.6
70;2021-06-07;941;848;101301;48895;43.4;21.0
70;2021-06-08;1216;1187;102517;50082;44.0;21.5
70;2021-06-09;1156;987;103673;51069;44.5;21.9
70;2021-06-10;1567;831;105240;51900;45.1;22.3
70;2021-06-11;1585;1957;106825;53857;45.8;23.1
70;2021-06-12;829;1970;107654;55827;46.2;23.9
70;2021-06-13;143;15;107797;55842;46.2;23.9
70;2021-06-14;559;1243;108356;57085;46.5;24.5
70;2021-06-15;451;1506;108807;58591;46.7;25.1
70;2021-06-16;798;1391;109605;59982;47.0;25.7
70;2021-06-17;1154;2098;110759;62080;47.5;26.6
70;2021-06-18;995;2254;111754;64334;47.9;27.6
70;2021-06-19;1091;1639;112845;65973;48.4;28.3
70;2021-06-20;1;3;112846;65976;48.4;28.3
70;2021-06-21;691;1452;113537;67428;48.7;28.9
70;2021-06-22;655;1513;114192;68941;49.0;29.6
70;2021-06-23;662;1569;114854;70510;49.3;30.2
70;2021-06-24;877;2049;115731;72559;49.6;31.1
70;2021-06-25;681;2648;116412;75207;49.9;32.3
70;2021-06-26;942;2134;117354;77341;50.3;33.2
70;2021-06-27;141;763;117495;78104;50.4;33.5
70;2021-06-28;335;1353;117830;79457;50.5;34.1
70;2021-06-29;411;1610;118241;81067;50.7;34.8
70;2021-06-30;390;1633;118631;82700;50.9;35.5
70;2021-07-01;642;1751;119273;84451;51.1;36.2
70;2021-07-02;815;1576;120088;86027;51.5;36.9
70;2021-07-03;841;1084;120929;87111;51.9;37.4
70;2021-07-04;29;70;120958;87181;51.9;37.4
70;2021-07-05;610;1037;121568;88218;52.1;37.8
70;2021-07-06;681;1273;122249;89491;52.4;38.4
70;2021-07-07;508;1425;122757;90916;52.6;39.0
70;2021-07-08;817;1574;123574;92490;53.0;39.7
70;2021-07-09;873;1662;124447;94152;53.4;40.4
70;2021-07-10;831;1033;125278;95185;53.7;40.8
70;2021-07-11;7;20;125285;95205;53.7;40.8
70;2021-07-12;432;1391;125717;96596;53.9;41.4
70;2021-07-13;907;1868;126624;98464;54.3;42.2
70;2021-07-14;33;6;126657;98470;54.3;42.2
70;2021-07-15;1382;1691;128039;100161;54.9;43.0
70;2021-07-16;1632;2056;129671;102217;55.6;43.8
70;2021-07-17;1501;1454;131172;103671;56.3;44.5
70;2021-07-18;1145;641;132317;104312;56.7;44.7
70;2021-07-19;883;976;133200;105288;57.1;45.2
70;2021-07-20;1349;1352;134549;106640;57.7;45.7
70;2021-07-21;1286;1402;135835;108042;58.2;46.3
70;2021-07-22;1867;1827;137702;109869;59.1;47.1
70;2021-07-23;1826;2491;139528;112360;59.8;48.2
70;2021-07-24;1364;1806;140892;114166;60.4;49.0
70;2021-07-25;27;3;140919;114169;60.4;49.0
70;2021-07-26;1055;975;141974;115144;60.9;49.4
70;2021-07-27;1398;976;143372;116120;61.5;49.8
70;2021-07-28;1404;1162;144776;117282;62.1;50.3
70;2021-07-29;1873;1387;146649;118669;62.9;50.9
70;2021-07-30;1975;1347;148624;120016;63.7;51.5
70;2021-07-31;1751;1166;150375;121182;64.5;52.0
70;2021-08-01;2;4;150377;121186;64.5;52.0
70;2021-08-02;775;737;151152;121923;64.8;52.3
70;2021-08-03;1296;1037;152448;122960;65.4;52.7
70;2021-08-04;1210;922;153658;123882;65.9;53.1
70;2021-08-05;1657;1191;155315;125073;66.6;53.6
70;2021-08-06;1796;1335;157111;126408;67.4;54.2
70;2021-08-07;1192;1030;158303;127438;67.9;54.6
70;2021-08-08;35;28;158338;127466;67.9;54.7
70;2021-08-09;533;704;158871;128170;68.1;55.0
70;2021-08-10;898;1131;159769;129301;68.5;55.4
70;2021-08-11;808;722;160577;130023;68.9;55.8
70;2021-08-12;906;1271;161483;131294;69.2;56.3
70;2021-08-13;1040;1622;162523;132916;69.7;57.0
70;2021-08-14;771;976;163294;133892;70.0;57.4
70;2021-08-15;36;28;163330;133920;70.0;57.4
70;2021-08-16;545;910;163875;134830;70.3;57.8
70;2021-08-17;680;1194;164555;136024;70.6;58.3
70;2021-08-18;535;939;165090;136963;70.8;58.7
70;2021-08-19;565;1385;165655;138348;71.0;59.3
70;2021-08-20;510;1900;166165;140248;71.3;60.1
70;2021-08-21;447;1163;166612;141411;71.4;60.6
70;2021-08-22;2;6;166614;141417;71.4;60.6
70;2021-08-23;282;879;166896;142296;71.6;61.0
70;2021-08-24;386;1373;167282;143669;71.7;61.6
70;2021-08-25;354;1343;167636;145012;71.9;62.2
70;2021-08-26;439;1560;168075;146572;72.1;62.9
70;2021-08-27;392;2127;168467;148699;72.2;63.8
70;2021-08-28;367;1706;168834;150405;72.4;64.5
70;2021-08-29;12;6;168846;150411;72.4;64.5
70;2021-08-30;298;835;169144;151246;72.5;64.9
70;2021-08-31;360;1130;169504;152376;72.7;65.3
70;2021-09-01;316;1195;169820;153571;72.8;65.9
70;2021-09-02;303;1296;170123;154867;73.0;66.4
70;2021-09-03;280;1245;170403;156112;73.1;66.9
70;2021-09-04;455;1263;170858;157375;73.3;67.5
70;2021-09-05;21;31;170879;157406;73.3;67.5
70;2021-09-06;168;702;171047;158108;73.3;67.8
70;2021-09-07;186;880;171233;158988;73.4;68.2
70;2021-09-08;193;877;171426;159865;73.5;68.6
70;2021-09-09;182;862;171608;160727;73.6;68.9
70;2021-09-10;254;914;171862;161641;73.7;69.3
70;2021-09-11;292;976;172154;162617;73.8;69.7
70;2021-09-12;7;37;172161;162654;73.8;69.8
70;2021-09-13;153;442;172314;163096;73.9;69.9
70;2021-09-14;318;565;172632;163661;74.0;70.2
70;2021-09-15;171;533;172803;164194;74.1;70.4
70;2021-09-16;250;391;173053;164585;74.2;70.6
70;2021-09-17;194;457;173247;165042;74.3;70.8
70;2021-09-18;177;459;173424;165501;74.4;71.0
70;2021-09-19;3;14;173427;165515;74.4;71.0
70;2021-09-20;82;215;173509;165730;74.4;71.1
70;2021-09-21;163;279;173672;166009;74.5;71.2
70;2021-09-22;114;384;173786;166393;74.5;71.4
70;2021-09-23;66;229;173852;166622;74.6;71.5
70;2021-09-24;196;389;174048;167011;74.6;71.6
70;2021-09-25;139;504;174187;167515;74.7;71.8
70;2021-09-26;0;1;174187;167516;74.7;71.8
70;2021-09-27;51;201;174238;167717;74.7;71.9
70;2021-09-28;77;195;174315;167912;74.8;72.0
70;2021-09-29;91;240;174406;168152;74.8;72.1
70;2021-09-30;81;158;174487;168310;74.8;72.2
70;2021-10-01;122;250;174609;168560;74.9;72.3
70;2021-10-02;115;326;174724;168886;74.9;72.4
70;2021-10-03;1;1;174725;168887;74.9;72.4
70;2021-10-04;73;169;174798;169056;75.0;72.5
70;2021-10-05;82;289;174880;169345;75.0;72.6
70;2021-10-06;129;213;175009;169558;75.0;72.7
71;2020-12-27;0;0;0;0;0.0;0.0
71;2020-12-28;1;0;1;0;0.0;0.0
71;2020-12-29;0;0;1;0;0.0;0.0
71;2020-12-30;0;0;1;0;0.0;0.0
71;2020-12-31;0;0;1;0;0.0;0.0
71;2021-01-01;1;0;2;0;0.0;0.0
71;2021-01-02;0;0;2;0;0.0;0.0
71;2021-01-03;2;0;4;0;0.0;0.0
71;2021-01-04;1;0;5;0;0.0;0.0
71;2021-01-05;13;0;18;0;0.0;0.0
71;2021-01-06;72;0;90;0;0.0;0.0
71;2021-01-07;67;0;157;0;0.0;0.0
71;2021-01-08;146;0;303;0;0.1;0.0
71;2021-01-09;117;0;420;0;0.1;0.0
71;2021-01-10;1;0;421;0;0.1;0.0
71;2021-01-11;245;1;666;1;0.1;0.0
71;2021-01-12;845;1;1511;2;0.3;0.0
71;2021-01-13;564;2;2075;4;0.4;0.0
71;2021-01-14;591;9;2666;13;0.5;0.0
71;2021-01-15;665;2;3331;15;0.6;0.0
71;2021-01-16;10;0;3341;15;0.6;0.0
71;2021-01-17;0;0;3341;15;0.6;0.0
71;2021-01-18;1095;7;4436;22;0.8;0.0
71;2021-01-19;1694;7;6130;29;1.1;0.0
71;2021-01-20;1517;6;7647;35;1.4;0.0
71;2021-01-21;2061;15;9708;50;1.8;0.0
71;2021-01-22;1414;6;11122;56;2.0;0.0
71;2021-01-23;815;6;11937;62;2.2;0.0
71;2021-01-24;1;0;11938;62;2.2;0.0
71;2021-01-25;1065;5;13003;67;2.4;0.0
71;2021-01-26;1505;25;14508;92;2.6;0.0
71;2021-01-27;1249;33;15757;125;2.9;0.0
71;2021-01-28;1082;78;16839;203;3.1;0.0
71;2021-01-29;1016;132;17855;335;3.3;0.1
71;2021-01-30;604;1;18459;336;3.4;0.1
71;2021-01-31;1;14;18460;350;3.4;0.1
71;2021-02-01;752;226;19212;576;3.5;0.1
71;2021-02-02;754;337;19966;913;3.6;0.2
71;2021-02-03;817;395;20783;1308;3.8;0.2
71;2021-02-04;784;541;21567;1849;3.9;0.3
71;2021-02-05;704;477;22271;2326;4.1;0.4
71;2021-02-06;539;8;22810;2334;4.2;0.4
71;2021-02-07;4;49;22814;2383;4.2;0.4
71;2021-02-08;603;501;23417;2884;4.3;0.5
71;2021-02-09;370;805;23787;3689;4.3;0.7
71;2021-02-10;412;781;24199;4470;4.4;0.8
71;2021-02-11;475;943;24674;5413;4.5;1.0
71;2021-02-12;535;843;25209;6256;4.6;1.1
71;2021-02-13;124;353;25333;6609;4.6;1.2
71;2021-02-14;2;7;25335;6616;4.6;1.2
71;2021-02-15;322;701;25657;7317;4.7;1.3
71;2021-02-16;445;1085;26102;8402;4.8;1.5
71;2021-02-17;427;968;26529;9370;4.8;1.7
71;2021-02-18;548;754;27077;10124;4.9;1.8
71;2021-02-19;571;662;27648;10786;5.0;2.0
71;2021-02-20;224;283;27872;11069;5.1;2.0
71;2021-02-21;4;13;27876;11082;5.1;2.0
71;2021-02-22;237;731;28113;11813;5.1;2.2
71;2021-02-23;452;784;28565;12597;5.2;2.3
71;2021-02-24;446;572;29011;13169;5.3;2.4
71;2021-02-25;533;596;29544;13765;5.4;2.5
71;2021-02-26;831;476;30375;14241;5.5;2.6
71;2021-02-27;456;262;30831;14503;5.6;2.6
71;2021-02-28;54;14;30885;14517;5.6;2.6
71;2021-03-01;1188;558;32073;15075;5.9;2.8
71;2021-03-02;1574;541;33647;15616;6.1;2.9
71;2021-03-03;1818;683;35465;16299;6.5;3.0
71;2021-03-04;2000;723;37465;17022;6.8;3.1
71;2021-03-05;2288;610;39753;17632;7.3;3.2
71;2021-03-06;754;61;40507;17693;7.4;3.2
71;2021-03-07;40;20;40547;17713;7.4;3.2
71;2021-03-08;1454;712;42001;18425;7.7;3.4
71;2021-03-09;2160;485;44161;18910;8.1;3.5
71;2021-03-10;2173;449;46334;19359;8.5;3.5
71;2021-03-11;2630;643;48964;20002;8.9;3.7
71;2021-03-12;2603;591;51567;20593;9.4;3.8
71;2021-03-13;995;94;52562;20687;9.6;3.8
71;2021-03-14;36;0;52598;20687;9.6;3.8
71;2021-03-15;1797;489;54395;21176;9.9;3.9
71;2021-03-16;1821;201;56216;21377;10.3;3.9
71;2021-03-17;2135;248;58351;21625;10.7;3.9
71;2021-03-18;1954;430;60305;22055;11.0;4.0
71;2021-03-19;2370;336;62675;22391;11.4;4.1
71;2021-03-20;1083;40;63758;22431;11.6;4.1
71;2021-03-21;17;5;63775;22436;11.6;4.1
71;2021-03-22;2576;381;66351;22817;12.1;4.2
71;2021-03-23;3346;502;69697;23319;12.7;4.3
71;2021-03-24;3349;469;73046;23788;13.3;4.3
71;2021-03-25;4029;600;77075;24388;14.1;4.5
71;2021-03-26;4057;339;81132;24727;14.8;4.5
71;2021-03-27;997;107;82129;24834;15.0;4.5
71;2021-03-28;57;8;82186;24842;15.0;4.5
71;2021-03-29;2408;1161;84594;26003;15.4;4.7
71;2021-03-30;2948;1351;87542;27354;16.0;5.0
71;2021-03-31;2546;1519;90088;28873;16.4;5.3
71;2021-04-01;2718;1297;92806;30170;16.9;5.5
71;2021-04-02;2501;1415;95307;31585;17.4;5.8
71;2021-04-03;268;34;95575;31619;17.4;5.8
71;2021-04-04;6;0;95581;31619;17.4;5.8
71;2021-04-05;61;2;95642;31621;17.5;5.8
71;2021-04-06;2257;1878;97899;33499;17.9;6.1
71;2021-04-07;2388;1782;100287;35281;18.3;6.4
71;2021-04-08;3283;1801;103570;37082;18.9;6.8
71;2021-04-09;4040;1664;107610;38746;19.6;7.1
71;2021-04-10;769;47;108379;38793;19.8;7.1
71;2021-04-11;97;4;108476;38797;19.8;7.1
71;2021-04-12;2352;1694;110828;40491;20.2;7.4
71;2021-04-13;2583;1882;113411;42373;20.7;7.7
71;2021-04-14;2375;1918;115786;44291;21.1;8.1
71;2021-04-15;2779;1690;118565;45981;21.6;8.4
71;2021-04-16;2628;1647;121193;47628;22.1;8.7
71;2021-04-17;952;344;122145;47972;22.3;8.8
71;2021-04-18;106;6;122251;47978;22.3;8.8
71;2021-04-19;1758;2565;124009;50543;22.6;9.2
71;2021-04-20;2220;2599;126229;53142;23.0;9.7
71;2021-04-21;2123;2590;128352;55732;23.4;10.2
71;2021-04-22;2512;2442;130864;58174;23.9;10.6
71;2021-04-23;2922;2265;133786;60439;24.4;11.0
71;2021-04-24;517;52;134303;60491;24.5;11.0
71;2021-04-25;26;0;134329;60491;24.5;11.0
71;2021-04-26;2565;2136;136894;62627;25.0;11.4
71;2021-04-27;2990;2268;139884;64895;25.5;11.8
71;2021-04-28;3073;2122;142957;67017;26.1;12.2
71;2021-04-29;3780;2203;146737;69220;26.8;12.6
71;2021-04-30;3926;1714;150663;70934;27.5;12.9
71;2021-05-01;39;53;150702;70987;27.5;13.0
71;2021-05-02;23;18;150725;71005;27.5;13.0
71;2021-05-03;4290;1381;155015;72386;28.3;13.2
71;2021-05-04;2955;2354;157970;74740;28.8;13.6
71;2021-05-05;3426;2080;161396;76820;29.5;14.0
71;2021-05-06;3467;2360;164863;79180;30.1;14.5
71;2021-05-07;3678;2803;168541;81983;30.8;15.0
71;2021-05-08;179;183;168720;82166;30.8;15.0
71;2021-05-09;44;47;168764;82213;30.8;15.0
71;2021-05-10;3696;2285;172460;84498;31.5;15.4
71;2021-05-11;4663;2359;177123;86857;32.3;15.9
71;2021-05-12;3978;2594;181101;89451;33.1;16.3
71;2021-05-13;1576;155;182677;89606;33.3;16.4
71;2021-05-14;3766;2194;186443;91800;34.0;16.8
71;2021-05-15;243;330;186686;92130;34.1;16.8
71;2021-05-16;2;0;186688;92130;34.1;16.8
71;2021-05-17;3864;1887;190552;94017;34.8;17.2
71;2021-05-18;3498;2425;194050;96442;35.4;17.6
71;2021-05-19;3719;2278;197769;98720;36.1;18.0
71;2021-05-20;4184;2286;201953;101006;36.9;18.4
71;2021-05-21;3721;2560;205674;103566;37.5;18.9
71;2021-05-22;169;304;205843;103870;37.6;19.0
71;2021-05-23;14;55;205857;103925;37.6;19.0
71;2021-05-24;21;96;205878;104021;37.6;19.0
71;2021-05-25;2689;3003;208567;107024;38.1;19.5
71;2021-05-26;2972;2432;211539;109456;38.6;20.0
71;2021-05-27;3387;2588;214926;112044;39.2;20.5
71;2021-05-28;2919;3149;217845;115193;39.8;21.0
71;2021-05-29;482;656;218327;115849;39.9;21.1
71;2021-05-30;76;58;218403;115907;39.9;21.2
71;2021-05-31;2774;3449;221177;119356;40.4;21.8
71;2021-06-01;3671;3539;224848;122895;41.0;22.4
71;2021-06-02;3997;2631;228845;125526;41.8;22.9
71;2021-06-03;4435;2521;233280;128047;42.6;23.4
71;2021-06-04;3716;3701;236996;131748;43.3;24.0
71;2021-06-05;684;647;237680;132395;43.4;24.2
71;2021-06-06;57;91;237737;132486;43.4;24.2
71;2021-06-07;3281;4150;241018;136636;44.0;24.9
71;2021-06-08;3894;4010;244912;140646;44.7;25.7
71;2021-06-09;4694;2752;249606;143398;45.6;26.2
71;2021-06-10;5265;2745;254871;146143;46.5;26.7
71;2021-06-11;4435;3722;259306;149865;47.3;27.4
71;2021-06-12;715;593;260021;150458;47.5;27.5
71;2021-06-13;104;187;260125;150645;47.5;27.5
71;2021-06-14;3510;3785;263635;154430;48.1;28.2
71;2021-06-15;4205;3550;267840;157980;48.9;28.8
71;2021-06-16;4595;2731;272435;160711;49.7;29.3
71;2021-06-17;4267;2989;276702;163700;50.5;29.9
71;2021-06-18;4325;3770;281027;167470;51.3;30.6
71;2021-06-19;1269;654;282296;168124;51.5;30.7
71;2021-06-20;37;27;282333;168151;51.5;30.7
71;2021-06-21;2270;4276;284603;172427;52.0;31.5
71;2021-06-22;2689;4354;287292;176781;52.4;32.3
71;2021-06-23;3061;3421;290353;180202;53.0;32.9
71;2021-06-24;3328;3022;293681;183224;53.6;33.4
71;2021-06-25;2652;4471;296333;187695;54.1;34.3
71;2021-06-26;372;551;296705;188246;54.2;34.4
71;2021-06-27;29;67;296734;188313;54.2;34.4
71;2021-06-28;1535;4624;298269;192937;54.4;35.2
71;2021-06-29;1992;4820;300261;197757;54.8;36.1
71;2021-06-30;2503;3934;302764;201691;55.3;36.8
71;2021-07-01;2826;3899;305590;205590;55.8;37.5
71;2021-07-02;3031;3987;308621;209577;56.3;38.3
71;2021-07-03;319;712;308940;210289;56.4;38.4
71;2021-07-04;28;132;308968;210421;56.4;38.4
71;2021-07-05;2474;4322;311442;214743;56.9;39.2
71;2021-07-06;2461;4560;313903;219303;57.3;40.0
71;2021-07-07;2983;3724;316886;223027;57.8;40.7
71;2021-07-08;2766;4109;319652;227136;58.3;41.5
71;2021-07-09;2383;5022;322035;232158;58.8;42.4
71;2021-07-10;212;656;322247;232814;58.8;42.5
71;2021-07-11;15;65;322262;232879;58.8;42.5
71;2021-07-12;1911;5304;324173;238183;59.2;43.5
71;2021-07-13;2537;5863;326710;244046;59.6;44.5
71;2021-07-14;950;401;327660;244447;59.8;44.6
71;2021-07-15;3024;5733;330684;250180;60.4;45.7
71;2021-07-16;3294;6002;333978;256182;61.0;46.8
71;2021-07-17;505;779;334483;256961;61.1;46.9
71;2021-07-18;89;86;334572;257047;61.1;46.9
71;2021-07-19;2864;5551;337436;262598;61.6;47.9
71;2021-07-20;3367;5913;340803;268511;62.2;49.0
71;2021-07-21;3413;5470;344216;273981;62.8;50.0
71;2021-07-22;3945;5331;348161;279312;63.6;51.0
71;2021-07-23;3233;5999;351394;285311;64.1;52.1
71;2021-07-24;715;597;352109;285908;64.3;52.2
71;2021-07-25;148;82;352257;285990;64.3;52.2
71;2021-07-26;3597;4891;355854;290881;65.0;53.1
71;2021-07-27;4090;5122;359944;296003;65.7;54.0
71;2021-07-28;4248;4808;364192;300811;66.5;54.9
71;2021-07-29;4213;4645;368405;305456;67.2;55.8
71;2021-07-30;4241;4925;372646;310381;68.0;56.7
71;2021-07-31;722;722;373368;311103;68.2;56.8
71;2021-08-01;108;35;373476;311138;68.2;56.8
71;2021-08-02;3967;3759;377443;314897;68.9;57.5
71;2021-08-03;4408;3821;381851;318718;69.7;58.2
71;2021-08-04;4391;2983;386242;321701;70.5;58.7
71;2021-08-05;4188;3267;390430;324968;71.3;59.3
71;2021-08-06;3700;4010;394130;328978;71.9;60.1
71;2021-08-07;495;329;394625;329307;72.0;60.1
71;2021-08-08;51;65;394676;329372;72.0;60.1
71;2021-08-09;3044;3408;397720;332780;72.6;60.7
71;2021-08-10;3074;3389;400794;336169;73.2;61.4
71;2021-08-11;3186;3081;403980;339250;73.7;61.9
71;2021-08-12;3016;3106;406996;342356;74.3;62.5
71;2021-08-13;2691;3334;409687;345690;74.8;63.1
71;2021-08-14;282;518;409969;346208;74.8;63.2
71;2021-08-15;49;110;410018;346318;74.8;63.2
71;2021-08-16;1709;3527;411727;349845;75.2;63.9
71;2021-08-17;1738;3433;413465;353278;75.5;64.5
71;2021-08-18;1453;3160;414918;356438;75.7;65.1
71;2021-08-19;1276;3116;416194;359554;76.0;65.6
71;2021-08-20;1290;3699;417484;363253;76.2;66.3
71;2021-08-21;148;413;417632;363666;76.2;66.4
71;2021-08-22;41;99;417673;363765;76.2;66.4
71;2021-08-23;1427;4543;419100;368308;76.5;67.2
71;2021-08-24;1335;3804;420435;372112;76.7;67.9
71;2021-08-25;950;3773;421385;375885;76.9;68.6
71;2021-08-26;958;3393;422343;379278;77.1;69.2
71;2021-08-27;1149;4462;423492;383740;77.3;70.0
71;2021-08-28;195;413;423687;384153;77.3;70.1
71;2021-08-29;29;106;423716;384259;77.3;70.1
71;2021-08-30;1250;3940;424966;388199;77.6;70.9
71;2021-08-31;1021;3628;425987;391827;77.8;71.5
71;2021-09-01;933;3587;426920;395414;77.9;72.2
71;2021-09-02;600;3118;427520;398532;78.0;72.7
71;2021-09-03;836;4030;428356;402562;78.2;73.5
71;2021-09-04;264;587;428620;403149;78.2;73.6
71;2021-09-05;23;58;428643;403207;78.2;73.6
71;2021-09-06;638;2786;429281;405993;78.4;74.1
71;2021-09-07;517;2270;429798;408263;78.5;74.5
71;2021-09-08;719;2604;430517;410867;78.6;75.0
71;2021-09-09;455;1795;430972;412662;78.7;75.3
71;2021-09-10;817;2760;431789;415422;78.8;75.8
71;2021-09-11;199;323;431988;415745;78.9;75.9
71;2021-09-12;19;49;432007;415794;78.9;75.9
71;2021-09-13;642;1625;432649;417419;79.0;76.2
71;2021-09-14;486;1568;433135;418987;79.1;76.5
71;2021-09-15;603;1497;433738;420484;79.2;76.8
71;2021-09-16;446;821;434184;421305;79.3;76.9
71;2021-09-17;533;1436;434717;422741;79.4;77.2
71;2021-09-18;142;262;434859;423003;79.4;77.2
71;2021-09-19;9;28;434868;423031;79.4;77.2
71;2021-09-20;484;924;435352;423955;79.5;77.4
71;2021-09-21;294;711;435646;424666;79.5;77.5
71;2021-09-22;341;1377;435987;426043;79.6;77.8
71;2021-09-23;306;578;436293;426621;79.6;77.9
71;2021-09-24;367;1029;436660;427650;79.7;78.1
71;2021-09-25;71;176;436731;427826;79.7;78.1
71;2021-09-26;11;35;436742;427861;79.7;78.1
71;2021-09-27;287;757;437029;428618;79.8;78.2
71;2021-09-28;288;477;437317;429095;79.8;78.3
71;2021-09-29;332;740;437649;429835;79.9;78.5
71;2021-09-30;206;500;437855;430335;79.9;78.6
71;2021-10-01;332;892;438187;431227;80.0;78.7
71;2021-10-02;108;226;438295;431453;80.0;78.8
71;2021-10-03;3;7;438298;431460;80.0;78.8
71;2021-10-04;252;554;438550;432014;80.1;78.9
71;2021-10-05;194;390;438744;432404;80.1;78.9
71;2021-10-06;376;655;439120;433059;80.2;79.1
72;2020-12-27;0;0;0;0;0.0;0.0
72;2020-12-28;0;0;0;0;0.0;0.0
72;2020-12-29;0;0;0;0;0.0;0.0
72;2020-12-30;0;0;0;0;0.0;0.0
72;2020-12-31;0;0;0;0;0.0;0.0
72;2021-01-01;2;0;2;0;0.0;0.0
72;2021-01-02;0;0;2;0;0.0;0.0
72;2021-01-03;0;0;2;0;0.0;0.0
72;2021-01-04;0;0;2;0;0.0;0.0
72;2021-01-05;14;0;16;0;0.0;0.0
72;2021-01-06;27;0;43;0;0.0;0.0
72;2021-01-07;110;0;153;0;0.0;0.0
72;2021-01-08;232;0;385;0;0.1;0.0
72;2021-01-09;36;0;421;0;0.1;0.0
72;2021-01-10;0;0;421;0;0.1;0.0
72;2021-01-11;485;1;906;1;0.2;0.0
72;2021-01-12;614;1;1520;2;0.3;0.0
72;2021-01-13;500;1;2020;3;0.4;0.0
72;2021-01-14;644;3;2664;6;0.5;0.0
72;2021-01-15;478;1;3142;7;0.6;0.0
72;2021-01-16;94;0;3236;7;0.6;0.0
72;2021-01-17;0;0;3236;7;0.6;0.0
72;2021-01-18;294;0;3530;7;0.6;0.0
72;2021-01-19;779;4;4309;11;0.8;0.0
72;2021-01-20;1539;6;5848;17;1.0;0.0
72;2021-01-21;1778;5;7626;22;1.4;0.0
72;2021-01-22;1149;5;8775;27;1.6;0.0
72;2021-01-23;32;0;8807;27;1.6;0.0
72;2021-01-24;0;0;8807;27;1.6;0.0
72;2021-01-25;503;7;9310;34;1.7;0.0
72;2021-01-26;1166;21;10476;55;1.9;0.0
72;2021-01-27;883;20;11359;75;2.0;0.0
72;2021-01-28;776;65;12135;140;2.2;0.0
72;2021-01-29;712;59;12847;199;2.3;0.0
72;2021-01-30;58;0;12905;199;2.3;0.0
72;2021-01-31;1;0;12906;199;2.3;0.0
72;2021-02-01;499;195;13405;394;2.4;0.1
72;2021-02-02;506;287;13911;681;2.5;0.1
72;2021-02-03;487;216;14398;897;2.6;0.2
72;2021-02-04;477;327;14875;1224;2.7;0.2
72;2021-02-05;514;304;15389;1528;2.7;0.3
72;2021-02-06;83;7;15472;1535;2.8;0.3
72;2021-02-07;19;1;15491;1536;2.8;0.3
72;2021-02-08;310;319;15801;1855;2.8;0.3
72;2021-02-09;488;500;16289;2355;2.9;0.4
72;2021-02-10;567;848;16856;3203;3.0;0.6
72;2021-02-11;860;1246;17716;4449;3.2;0.8
72;2021-02-12;851;564;18567;5013;3.3;0.9
72;2021-02-13;111;34;18678;5047;3.3;0.9
72;2021-02-14;1;22;18679;5069;3.3;0.9
72;2021-02-15;220;389;18899;5458;3.4;1.0
72;2021-02-16;503;934;19402;6392;3.5;1.1
72;2021-02-17;463;577;19865;6969;3.5;1.2
72;2021-02-18;595;539;20460;7508;3.7;1.3
72;2021-02-19;521;491;20981;7999;3.7;1.4
72;2021-02-20;81;50;21062;8049;3.8;1.4
72;2021-02-21;0;0;21062;8049;3.8;1.4
72;2021-02-22;329;457;21391;8506;3.8;1.5
72;2021-02-23;569;372;21960;8878;3.9;1.6
72;2021-02-24;435;408;22395;9286;4.0;1.7
72;2021-02-25;922;468;23317;9754;4.2;1.7
72;2021-02-26;599;394;23916;10148;4.3;1.8
72;2021-02-27;322;32;24238;10180;4.3;1.8
72;2021-02-28;15;17;24253;10197;4.3;1.8
72;2021-03-01;379;371;24632;10568;4.4;1.9
72;2021-03-02;502;514;25134;11082;4.5;2.0
72;2021-03-03;733;540;25867;11622;4.6;2.1
72;2021-03-04;742;672;26609;12294;4.7;2.2
72;2021-03-05;936;691;27545;12985;4.9;2.3
72;2021-03-06;761;111;28306;13096;5.1;2.3
72;2021-03-07;448;26;28754;13122;5.1;2.3
72;2021-03-08;561;393;29315;13515;5.2;2.4
72;2021-03-09;1045;558;30360;14073;5.4;2.5
72;2021-03-10;1134;613;31494;14686;5.6;2.6
72;2021-03-11;1610;427;33104;15113;5.9;2.7
72;2021-03-12;1364;480;34468;15593;6.2;2.8
72;2021-03-13;983;103;35451;15696;6.3;2.8
72;2021-03-14;14;10;35465;15706;6.3;2.8
72;2021-03-15;1159;212;36624;15918;6.5;2.8
72;2021-03-16;1052;181;37676;16099;6.7;2.9
72;2021-03-17;1035;253;38711;16352;6.9;2.9
72;2021-03-18;1089;362;39800;16714;7.1;3.0
72;2021-03-19;1276;286;41076;17000;7.3;3.0
72;2021-03-20;488;88;41564;17088;7.4;3.1
72;2021-03-21;19;0;41583;17088;7.4;3.1
72;2021-03-22;1347;340;42930;17428;7.7;3.1
72;2021-03-23;1723;472;44653;17900;8.0;3.2
72;2021-03-24;1842;297;46495;18197;8.3;3.2
72;2021-03-25;2448;459;48943;18656;8.7;3.3
72;2021-03-26;2336;365;51279;19021;9.2;3.4
72;2021-03-27;614;31;51893;19052;9.3;3.4
72;2021-03-28;22;0;51915;19052;9.3;3.4
72;2021-03-29;1616;381;53531;19433;9.6;3.5
72;2021-03-30;2496;385;56027;19818;10.0;3.5
72;2021-03-31;2145;365;58172;20183;10.4;3.6
72;2021-04-01;2849;349;61021;20532;10.9;3.7
72;2021-04-02;2247;398;63268;20930;11.3;3.7
72;2021-04-03;291;39;63559;20969;11.3;3.7
72;2021-04-04;16;3;63575;20972;11.3;3.7
72;2021-04-05;51;49;63626;21021;11.4;3.8
72;2021-04-06;1759;469;65385;21490;11.7;3.8
72;2021-04-07;2577;599;67962;22089;12.1;3.9
72;2021-04-08;2721;782;70683;22871;12.6;4.1
72;2021-04-09;3863;583;74546;23454;13.3;4.2
72;2021-04-10;1112;52;75658;23506;13.5;4.2
72;2021-04-11;8;1;75666;23507;13.5;4.2
72;2021-04-12;1846;902;77512;24409;13.8;4.4
72;2021-04-13;2372;1072;79884;25481;14.3;4.5
72;2021-04-14;2250;1096;82134;26577;14.7;4.7
72;2021-04-15;2420;1117;84554;27694;15.1;4.9
72;2021-04-16;2563;959;87117;28653;15.6;5.1
72;2021-04-17;707;144;87824;28797;15.7;5.1
72;2021-04-18;57;2;87881;28799;15.7;5.1
72;2021-04-19;1396;1089;89277;29888;15.9;5.3
72;2021-04-20;2996;1304;92273;31192;16.5;5.6
72;2021-04-21;2515;1561;94788;32753;16.9;5.8
72;2021-04-22;2814;1790;97602;34543;17.4;6.2
72;2021-04-23;3213;1457;100815;36000;18.0;6.4
72;2021-04-24;1400;268;102215;36268;18.2;6.5
72;2021-04-25;881;18;103096;36286;18.4;6.5
72;2021-04-26;3513;1474;106609;37760;19.0;6.7
72;2021-04-27;4088;1852;110697;39612;19.8;7.1
72;2021-04-28;3835;1871;114532;41483;20.4;7.4
72;2021-04-29;4161;1781;118693;43264;21.2;7.7
72;2021-04-30;3615;1705;122308;44969;21.8;8.0
72;2021-05-01;1641;225;123949;45194;22.1;8.1
72;2021-05-02;1533;161;125482;45355;22.4;8.1
72;2021-05-03;3456;1153;128938;46508;23.0;8.3
72;2021-05-04;4013;1799;132951;48307;23.7;8.6
72;2021-05-05;3866;2173;136817;50480;24.4;9.0
72;2021-05-06;3596;1930;140413;52410;25.1;9.4
72;2021-05-07;3543;2139;143956;54549;25.7;9.7
72;2021-05-08;1900;152;145856;54701;26.0;9.8
72;2021-05-09;2080;214;147936;54915;26.4;9.8
72;2021-05-10;3769;1525;151705;56440;27.1;10.1
72;2021-05-11;4597;1994;156302;58434;27.9;10.4
72;2021-05-12;4080;1817;160382;60251;28.6;10.8
72;2021-05-13;3031;273;163413;60524;29.2;10.8
72;2021-05-14;3663;1397;167076;61921;29.8;11.1
72;2021-05-15;3117;365;170193;62286;30.4;11.1
72;2021-05-16;2500;151;172693;62437;30.8;11.1
72;2021-05-17;3724;1286;176417;63723;31.5;11.4
72;2021-05-18;4330;1688;180747;65411;32.3;11.7
72;2021-05-19;3973;1510;184720;66921;33.0;11.9
72;2021-05-20;4261;1452;188981;68373;33.7;12.2
72;2021-05-21;3788;1388;192769;69761;34.4;12.5
72;2021-05-22;2561;506;195330;70267;34.9;12.5
72;2021-05-23;1391;163;196721;70430;35.1;12.6
72;2021-05-24;2352;296;199073;70726;35.5;12.6
72;2021-05-25;4076;1412;203149;72138;36.3;12.9
72;2021-05-26;4096;1413;207245;73551;37.0;13.1
72;2021-05-27;4345;2049;211590;75600;37.8;13.5
72;2021-05-28;4105;2003;215695;77603;38.5;13.9
72;2021-05-29;2668;805;218363;78408;39.0;14.0
72;2021-05-30;1142;871;219505;79279;39.2;14.2
72;2021-05-31;3122;2326;222627;81605;39.7;14.6
72;2021-06-01;3570;2669;226197;84274;40.4;15.0
72;2021-06-02;3611;2777;229808;87051;41.0;15.5
72;2021-06-03;4242;2996;234050;90047;41.8;16.1
72;2021-06-04;3891;2750;237941;92797;42.5;16.6
72;2021-06-05;1440;2567;239381;95364;42.7;17.0
72;2021-06-06;911;1541;240292;96905;42.9;17.3
72;2021-06-07;1744;3424;242036;100329;43.2;17.9
72;2021-06-08;2930;3832;244966;104161;43.7;18.6
72;2021-06-09;2646;3371;247612;107532;44.2;19.2
72;2021-06-10;2825;3316;250437;110848;44.7;19.8
72;2021-06-11;2840;3771;253277;114619;45.2;20.5
72;2021-06-12;1242;2599;254519;117218;45.4;20.9
72;2021-06-13;388;1860;254907;119078;45.5;21.3
72;2021-06-14;1336;4127;256243;123205;45.7;22.0
72;2021-06-15;2751;3507;258994;126712;46.2;22.6
72;2021-06-16;2428;3579;261422;130291;46.7;23.3
72;2021-06-17;2318;3871;263740;134162;47.1;23.9
72;2021-06-18;2310;4312;266050;138474;47.5;24.7
72;2021-06-19;1128;2762;267178;141236;47.7;25.2
72;2021-06-20;339;2055;267517;143291;47.8;25.6
72;2021-06-21;1563;4029;269080;147320;48.0;26.3
72;2021-06-22;1711;4989;270791;152309;48.3;27.2
72;2021-06-23;2008;4223;272799;156532;48.7;27.9
72;2021-06-24;2232;4011;275031;160543;49.1;28.7
72;2021-06-25;1773;4832;276804;165375;49.4;29.5
72;2021-06-26;1190;2876;277994;168251;49.6;30.0
72;2021-06-27;392;2111;278386;170362;49.7;30.4
72;2021-06-28;1439;4292;279825;174654;49.9;31.2
72;2021-06-29;1770;4740;281595;179394;50.3;32.0
72;2021-06-30;1980;4168;283575;183562;50.6;32.8
72;2021-07-01;1954;4417;285529;187979;51.0;33.6
72;2021-07-02;1853;4713;287382;192692;51.3;34.4
72;2021-07-03;1292;3123;288674;195815;51.5;35.0
72;2021-07-04;579;1948;289253;197763;51.6;35.3
72;2021-07-05;1193;4164;290446;201927;51.8;36.0
72;2021-07-06;1458;5148;291904;207075;52.1;37.0
72;2021-07-07;1582;4608;293486;211683;52.4;37.8
72;2021-07-08;1648;4324;295134;216007;52.7;38.6
72;2021-07-09;2107;4604;297241;220611;53.1;39.4
72;2021-07-10;1589;2690;298830;223301;53.3;39.9
72;2021-07-11;947;1587;299777;224888;53.5;40.1
72;2021-07-12;1592;3753;301369;228641;53.8;40.8
72;2021-07-13;2091;4774;303460;233415;54.2;41.7
72;2021-07-14;1325;2365;304785;235780;54.4;42.1
72;2021-07-15;3485;3419;308270;239199;55.0;42.7
72;2021-07-16;3175;4120;311445;243319;55.6;43.4
72;2021-07-17;2646;1758;314091;245077;56.1;43.7
72;2021-07-18;1710;824;315801;245901;56.4;43.9
72;2021-07-19;2918;3507;318719;249408;56.9;44.5
72;2021-07-20;3040;4280;321759;253688;57.4;45.3
72;2021-07-21;2884;3586;324643;257274;57.9;45.9
72;2021-07-22;3772;2911;328415;260185;58.6;46.4
72;2021-07-23;3478;3792;331893;263977;59.2;47.1
72;2021-07-24;2820;1460;334713;265437;59.7;47.4
72;2021-07-25;1453;1081;336166;266518;60.0;47.6
72;2021-07-26;2726;2918;338892;269436;60.5;48.1
72;2021-07-27;3859;3819;342751;273255;61.2;48.8
72;2021-07-28;3571;3122;346322;276377;61.8;49.3
72;2021-07-29;3572;2712;349894;279089;62.5;49.8
72;2021-07-30;3788;3382;353682;282471;63.1;50.4
72;2021-07-31;2546;1749;356228;284220;63.6;50.7
72;2021-08-01;1835;432;358063;284652;63.9;50.8
72;2021-08-02;3215;2285;361278;286937;64.5;51.2
72;2021-08-03;3236;3297;364514;290234;65.1;51.8
72;2021-08-04;3768;2551;368282;292785;65.7;52.3
72;2021-08-05;3770;2460;372052;295245;66.4;52.7
72;2021-08-06;3342;2695;375394;297940;67.0;53.2
72;2021-08-07;2347;1613;377741;299553;67.4;53.5
72;2021-08-08;1623;701;379364;300254;67.7;53.6
72;2021-08-09;2699;2668;382063;302922;68.2;54.1
72;2021-08-10;2915;2747;384978;305669;68.7;54.6
72;2021-08-11;2367;2204;387345;307873;69.1;55.0
72;2021-08-12;2380;2597;389725;310470;69.6;55.4
72;2021-08-13;2158;2295;391883;312765;70.0;55.8
72;2021-08-14;1167;1546;393050;314311;70.2;56.1
72;2021-08-15;623;614;393673;314925;70.3;56.2
72;2021-08-16;1649;2372;395322;317297;70.6;56.6
72;2021-08-17;1717;2889;397039;320186;70.9;57.2
72;2021-08-18;1709;2872;398748;323058;71.2;57.7
72;2021-08-19;1245;2914;399993;325972;71.4;58.2
72;2021-08-20;1656;3170;401649;329142;71.7;58.8
72;2021-08-21;701;2031;402350;331173;71.8;59.1
72;2021-08-22;261;1150;402611;332323;71.9;59.3
72;2021-08-23;1739;3422;404350;335745;72.2;59.9
72;2021-08-24;1532;4122;405882;339867;72.4;60.7
72;2021-08-25;1599;3452;407481;343319;72.7;61.3
72;2021-08-26;1264;4443;408745;347762;73.0;62.1
72;2021-08-27;1192;4112;409937;351874;73.2;62.8
72;2021-08-28;881;2656;410818;354530;73.3;63.3
72;2021-08-29;357;1683;411175;356213;73.4;63.6
72;2021-08-30;1130;3464;412305;359677;73.6;64.2
72;2021-08-31;1219;4015;413524;363692;73.8;64.9
72;2021-09-01;1070;3310;414594;367002;74.0;65.5
72;2021-09-02;902;3459;415496;370461;74.2;66.1
72;2021-09-03;927;3305;416423;373766;74.3;66.7
72;2021-09-04;702;2657;417125;376423;74.5;67.2
72;2021-09-05;256;1555;417381;377978;74.5;67.5
72;2021-09-06;585;2812;417966;380790;74.6;68.0
72;2021-09-07;505;2952;418471;383742;74.7;68.5
72;2021-09-08;617;3173;419088;386915;74.8;69.1
72;2021-09-09;396;2094;419484;389009;74.9;69.4
72;2021-09-10;624;2712;420108;391721;75.0;69.9
72;2021-09-11;402;2719;420510;394440;75.1;70.4
72;2021-09-12;170;954;420680;395394;75.1;70.6
72;2021-09-13;368;1614;421048;397008;75.2;70.9
72;2021-09-14;487;1662;421535;398670;75.2;71.2
72;2021-09-15;614;1995;422149;400665;75.4;71.5
72;2021-09-16;336;831;422485;401496;75.4;71.7
72;2021-09-17;442;1423;422927;402919;75.5;71.9
72;2021-09-18;355;1520;423282;404439;75.6;72.2
72;2021-09-19;89;359;423371;404798;75.6;72.3
72;2021-09-20;350;793;423721;405591;75.6;72.4
72;2021-09-21;317;786;424038;406377;75.7;72.5
72;2021-09-22;442;1526;424480;407903;75.8;72.8
72;2021-09-23;396;630;424876;408533;75.8;72.9
72;2021-09-24;601;1006;425477;409539;75.9;73.1
72;2021-09-25;259;1004;425736;410543;76.0;73.3
72;2021-09-26;73;215;425809;410758;76.0;73.3
72;2021-09-27;210;639;426019;411397;76.0;73.4
72;2021-09-28;205;427;426224;411824;76.1;73.5
72;2021-09-29;360;1013;426584;412837;76.1;73.7
72;2021-09-30;164;330;426748;413167;76.2;73.7
72;2021-10-01;287;706;427035;413873;76.2;73.9
72;2021-10-02;311;576;427346;414449;76.3;74.0
72;2021-10-03;91;161;427437;414610;76.3;74.0
72;2021-10-04;178;409;427615;415019;76.3;74.1
72;2021-10-05;268;330;427883;415349;76.4;74.1
72;2021-10-06;251;559;428134;415908;76.4;74.2
73;2020-12-27;1;0;1;0;0.0;0.0
73;2020-12-28;1;0;2;0;0.0;0.0
73;2020-12-29;0;0;2;0;0.0;0.0
73;2020-12-30;0;0;2;0;0.0;0.0
73;2020-12-31;0;0;2;0;0.0;0.0
73;2021-01-01;0;0;2;0;0.0;0.0
73;2021-01-02;0;0;2;0;0.0;0.0
73;2021-01-03;0;0;2;0;0.0;0.0
73;2021-01-04;1;0;3;0;0.0;0.0
73;2021-01-05;0;0;3;0;0.0;0.0
73;2021-01-06;1;0;4;0;0.0;0.0
73;2021-01-07;30;0;34;0;0.0;0.0
73;2021-01-08;81;0;115;0;0.0;0.0
73;2021-01-09;0;0;115;0;0.0;0.0
73;2021-01-10;0;0;115;0;0.0;0.0
73;2021-01-11;101;0;216;0;0.0;0.0
73;2021-01-12;303;1;519;1;0.1;0.0
73;2021-01-13;360;1;879;2;0.2;0.0
73;2021-01-14;516;2;1395;4;0.3;0.0
73;2021-01-15;617;1;2012;5;0.5;0.0
73;2021-01-16;128;0;2140;5;0.5;0.0
73;2021-01-17;0;0;2140;5;0.5;0.0
73;2021-01-18;624;0;2764;5;0.6;0.0
73;2021-01-19;1240;2;4004;7;0.9;0.0
73;2021-01-20;951;2;4955;9;1.1;0.0
73;2021-01-21;984;4;5939;13;1.4;0.0
73;2021-01-22;947;0;6886;13;1.6;0.0
73;2021-01-23;389;0;7275;13;1.7;0.0
73;2021-01-24;0;0;7275;13;1.7;0.0
73;2021-01-25;656;4;7931;17;1.8;0.0
73;2021-01-26;761;2;8692;19;2.0;0.0
73;2021-01-27;1107;5;9799;24;2.3;0.0
73;2021-01-28;961;5;10760;29;2.5;0.0
73;2021-01-29;684;5;11444;34;2.6;0.0
73;2021-01-30;345;2;11789;36;2.7;0.0
73;2021-01-31;0;0;11789;36;2.7;0.0
73;2021-02-01;606;37;12395;73;2.9;0.0
73;2021-02-02;752;327;13147;400;3.0;0.1
73;2021-02-03;650;344;13797;744;3.2;0.2
73;2021-02-04;626;224;14423;968;3.3;0.2
73;2021-02-05;680;398;15103;1366;3.5;0.3
73;2021-02-06;262;38;15365;1404;3.6;0.3
73;2021-02-07;1;0;15366;1404;3.6;0.3
73;2021-02-08;524;227;15890;1631;3.7;0.4
73;2021-02-09;793;400;16683;2031;3.9;0.5
73;2021-02-10;901;363;17584;2394;4.1;0.6
73;2021-02-11;963;675;18547;3069;4.3;0.7
73;2021-02-12;811;462;19358;3531;4.5;0.8
73;2021-02-13;263;46;19621;3577;4.5;0.8
73;2021-02-14;1;0;19622;3577;4.5;0.8
73;2021-02-15;346;387;19968;3964;4.6;0.9
73;2021-02-16;454;619;20422;4583;4.7;1.1
73;2021-02-17;451;829;20873;5412;4.8;1.3
73;2021-02-18;467;429;21340;5841;4.9;1.4
73;2021-02-19;445;528;21785;6369;5.0;1.5
73;2021-02-20;70;189;21855;6558;5.1;1.5
73;2021-02-21;0;0;21855;6558;5.1;1.5
73;2021-02-22;240;356;22095;6914;5.1;1.6
73;2021-02-23;327;434;22422;7348;5.2;1.7
73;2021-02-24;487;619;22909;7967;5.3;1.8
73;2021-02-25;504;410;23413;8377;5.4;1.9
73;2021-02-26;730;491;24143;8868;5.6;2.1
73;2021-02-27;330;200;24473;9068;5.7;2.1
73;2021-02-28;2;1;24475;9069;5.7;2.1
73;2021-03-01;557;441;25032;9510;5.8;2.2
73;2021-03-02;667;771;25699;10281;5.9;2.4
73;2021-03-03;643;1036;26342;11317;6.1;2.6
73;2021-03-04;1040;809;27382;12126;6.3;2.8
73;2021-03-05;1240;539;28622;12665;6.6;2.9
73;2021-03-06;1091;296;29713;12961;6.9;3.0
73;2021-03-07;455;88;30168;13049;7.0;3.0
73;2021-03-08;608;394;30776;13443;7.1;3.1
73;2021-03-09;983;468;31759;13911;7.3;3.2
73;2021-03-10;1035;760;32794;14671;7.6;3.4
73;2021-03-11;1559;586;34353;15257;7.9;3.5
73;2021-03-12;2018;507;36371;15764;8.4;3.6
73;2021-03-13;1179;192;37550;15956;8.7;3.7
73;2021-03-14;66;3;37616;15959;8.7;3.7
73;2021-03-15;1185;368;38801;16327;9.0;3.8
73;2021-03-16;795;388;39596;16715;9.2;3.9
73;2021-03-17;877;457;40473;17172;9.4;4.0
73;2021-03-18;1351;258;41824;17430;9.7;4.0
73;2021-03-19;1767;385;43591;17815;10.1;4.1
73;2021-03-20;888;127;44479;17942;10.3;4.1
73;2021-03-21;123;2;44602;17944;10.3;4.1
73;2021-03-22;1184;399;45786;18343;10.6;4.2
73;2021-03-23;1448;241;47234;18584;10.9;4.3
73;2021-03-24;1594;342;48828;18926;11.3;4.4
73;2021-03-25;2064;386;50892;19312;11.8;4.5
73;2021-03-26;2471;366;53363;19678;12.3;4.5
73;2021-03-27;885;148;54248;19826;12.5;4.6
73;2021-03-28;312;16;54560;19842;12.6;4.6
73;2021-03-29;1508;238;56068;20080;13.0;4.6
73;2021-03-30;2087;486;58155;20566;13.4;4.8
73;2021-03-31;2089;401;60244;20967;13.9;4.8
73;2021-04-01;2087;335;62331;21302;14.4;4.9
73;2021-04-02;2361;230;64692;21532;15.0;5.0
73;2021-04-03;849;147;65541;21679;15.2;5.0
73;2021-04-04;188;17;65729;21696;15.2;5.0
73;2021-04-05;212;26;65941;21722;15.2;5.0
73;2021-04-06;1506;511;67447;22233;15.6;5.1
73;2021-04-07;1947;650;69394;22883;16.0;5.3
73;2021-04-08;2491;821;71885;23704;16.6;5.5
73;2021-04-09;3059;524;74944;24228;17.3;5.6
73;2021-04-10;1134;320;76078;24548;17.6;5.7
73;2021-04-11;164;10;76242;24558;17.6;5.7
73;2021-04-12;1696;983;77938;25541;18.0;5.9
73;2021-04-13;1895;1129;79833;26670;18.5;6.2
73;2021-04-14;2014;1092;81847;27762;18.9;6.4
73;2021-04-15;2416;1190;84263;28952;19.5;6.7
73;2021-04-16;1893;934;86156;29886;19.9;6.9
73;2021-04-17;1173;560;87329;30446;20.2;7.0
73;2021-04-18;155;76;87484;30522;20.2;7.1
73;2021-04-19;1383;1057;88867;31579;20.5;7.3
73;2021-04-20;1790;1321;90657;32900;21.0;7.6
73;2021-04-21;1576;1301;92233;34201;21.3;7.9
73;2021-04-22;1812;1224;94045;35425;21.7;8.2
73;2021-04-23;1897;1254;95942;36679;22.2;8.5
73;2021-04-24;980;673;96922;37352;22.4;8.6
73;2021-04-25;79;96;97001;37448;22.4;8.7
73;2021-04-26;1164;1319;98165;38767;22.7;9.0
73;2021-04-27;1440;1468;99605;40235;23.0;9.3
73;2021-04-28;1731;1457;101336;41692;23.4;9.6
73;2021-04-29;2413;1562;103749;43254;24.0;10.0
73;2021-04-30;2396;1430;106145;44684;24.5;10.3
73;2021-05-01;1068;309;107213;44993;24.8;10.4
73;2021-05-02;34;165;107247;45158;24.8;10.4
73;2021-05-03;1392;1593;108639;46751;25.1;10.8
73;2021-05-04;1712;1828;110351;48579;25.5;11.2
73;2021-05-05;1975;1684;112326;50263;26.0;11.6
73;2021-05-06;2431;1695;114757;51958;26.5;12.0
73;2021-05-07;2259;1835;117016;53793;27.1;12.4
73;2021-05-08;1838;377;118854;54170;27.5;12.5
73;2021-05-09;127;126;118981;54296;27.5;12.6
73;2021-05-10;1608;1890;120589;56186;27.9;13.0
73;2021-05-11;2379;2367;122968;58553;28.4;13.5
73;2021-05-12;3556;2097;126524;60650;29.3;14.0
73;2021-05-13;1554;275;128078;60925;29.6;14.1
73;2021-05-14;1588;1492;129666;62417;30.0;14.4
73;2021-05-15;1447;943;131113;63360;30.3;14.6
73;2021-05-16;131;62;131244;63422;30.3;14.7
73;2021-05-17;1711;1950;132955;65372;30.7;15.1
73;2021-05-18;2495;1735;135450;67107;31.3;15.5
73;2021-05-19;2539;1623;137989;68730;31.9;15.9
73;2021-05-20;3162;1502;141151;70232;32.6;16.2
73;2021-05-21;2473;1849;143624;72081;33.2;16.7
73;2021-05-22;1989;923;145613;73004;33.7;16.9
73;2021-05-23;212;14;145825;73018;33.7;16.9
73;2021-05-24;2563;324;148388;73342;34.3;17.0
73;2021-05-25;2139;1741;150527;75083;34.8;17.4
73;2021-05-26;2342;1999;152869;77082;35.3;17.8
73;2021-05-27;3080;1713;155949;78795;36.1;18.2
73;2021-05-28;2918;2372;158867;81167;36.7;18.8
73;2021-05-29;2316;1321;161183;82488;37.3;19.1
73;2021-05-30;188;14;161371;82502;37.3;19.1
73;2021-05-31;2410;1632;163781;84134;37.9;19.5
73;2021-06-01;3178;1792;166959;85926;38.6;19.9
73;2021-06-02;3108;1454;170067;87380;39.3;20.2
73;2021-06-03;4422;1740;174489;89120;40.3;20.6
73;2021-06-04;4276;2184;178765;91304;41.3;21.1
73;2021-06-05;3165;1281;181930;92585;42.1;21.4
73;2021-06-06;1881;299;183811;92884;42.5;21.5
73;2021-06-07;2759;2148;186570;95032;43.1;22.0
73;2021-06-08;2684;1873;189254;96905;43.8;22.4
73;2021-06-09;2365;1790;191619;98695;44.3;22.8
73;2021-06-10;2005;1644;193624;100339;44.8;23.2
73;2021-06-11;2192;2441;195816;102780;45.3;23.8
73;2021-06-12;2245;1331;198061;104111;45.8;24.1
73;2021-06-13;44;82;198105;104193;45.8;24.1
73;2021-06-14;1347;2926;199452;107119;46.1;24.8
73;2021-06-15;1592;2754;201044;109873;46.5;25.4
73;2021-06-16;1466;2564;202510;112437;46.8;26.0
73;2021-06-17;947;1727;203457;114164;47.0;26.4
73;2021-06-18;1883;2930;205340;117094;47.5;27.1
73;2021-06-19;1424;1986;206764;119080;47.8;27.5
73;2021-06-20;448;307;207212;119387;47.9;27.6
73;2021-06-21;1111;2938;208323;122325;48.2;28.3
73;2021-06-22;1090;2870;209413;125195;48.4;28.9
73;2021-06-23;1086;3137;210499;128332;48.7;29.7
73;2021-06-24;883;1794;211382;130126;48.9;30.1
73;2021-06-25;1324;2794;212706;132920;49.2;30.7
73;2021-06-26;966;2398;213672;135318;49.4;31.3
73;2021-06-27;329;549;214001;135867;49.5;31.4
73;2021-06-28;971;3557;214972;139424;49.7;32.2
73;2021-06-29;1076;3340;216048;142764;49.9;33.0
73;2021-06-30;1239;3116;217287;145880;50.2;33.7
73;2021-07-01;1191;2362;218478;148242;50.5;34.3
73;2021-07-02;1203;3616;219681;151858;50.8;35.1
73;2021-07-03;961;2793;220642;154651;51.0;35.8
73;2021-07-04;301;619;220943;155270;51.1;35.9
73;2021-07-05;1157;3681;222100;158951;51.3;36.7
73;2021-07-06;1251;2951;223351;161902;51.6;37.4
73;2021-07-07;1443;2948;224794;164850;52.0;38.1
73;2021-07-08;1373;2296;226167;167146;52.3;38.6
73;2021-07-09;1431;4026;227598;171172;52.6;39.6
73;2021-07-10;891;3012;228489;174184;52.8;40.3
73;2021-07-11;561;1470;229050;175654;53.0;40.6
73;2021-07-12;1059;4194;230109;179848;53.2;41.6
73;2021-07-13;1729;4225;231838;184073;53.6;42.6
73;2021-07-14;1843;1919;233681;185992;54.0;43.0
73;2021-07-15;2747;3797;236428;189789;54.7;43.9
73;2021-07-16;2416;4015;238844;193804;55.2;44.8
73;2021-07-17;1515;2607;240359;196411;55.6;45.4
73;2021-07-18;1176;1218;241535;197629;55.8;45.7
73;2021-07-19;2449;3250;243984;200879;56.4;46.4
73;2021-07-20;3366;2855;247350;203734;57.2;47.1
73;2021-07-21;3382;2790;250732;206524;58.0;47.7
73;2021-07-22;2733;2216;253465;208740;58.6;48.3
73;2021-07-23;3417;2902;256882;211642;59.4;48.9
73;2021-07-24;2059;2280;258941;213922;59.9;49.5
73;2021-07-25;625;797;259566;214719;60.0;49.6
73;2021-07-26;2632;2496;262198;217215;60.6;50.2
73;2021-07-27;3813;2273;266011;219488;61.5;50.7
73;2021-07-28;3535;2095;269546;221583;62.3;51.2
73;2021-07-29;3980;2153;273526;223736;63.2;51.7
73;2021-07-30;3565;2475;277091;226211;64.1;52.3
73;2021-07-31;2477;1591;279568;227802;64.6;52.7
73;2021-08-01;834;620;280402;228422;64.8;52.8
73;2021-08-02;3104;2104;283506;230526;65.5;53.3
73;2021-08-03;3494;1999;287000;232525;66.4;53.8
73;2021-08-04;3299;2026;290299;234551;67.1;54.2
73;2021-08-05;2874;2233;293173;236784;67.8;54.7
73;2021-08-06;2509;2382;295682;239166;68.4;55.3
73;2021-08-07;1417;1482;297099;240648;68.7;55.6
73;2021-08-08;434;619;297533;241267;68.8;55.8
73;2021-08-09;1785;2396;299318;243663;69.2;56.3
73;2021-08-10;1897;2489;301215;246152;69.6;56.9
73;2021-08-11;1848;2535;303063;248687;70.1;57.5
73;2021-08-12;1682;2502;304745;251189;70.5;58.1
73;2021-08-13;1460;2842;306205;254031;70.8;58.7
73;2021-08-14;990;1534;307195;255565;71.0;59.1
73;2021-08-15;92;161;307287;255726;71.0;59.1
73;2021-08-16;952;1392;308239;257118;71.3;59.4
73;2021-08-17;963;1960;309202;259078;71.5;59.9
73;2021-08-18;1038;2841;310240;261919;71.7;60.6
73;2021-08-19;1045;3055;311285;264974;72.0;61.3
73;2021-08-20;852;3146;312137;268120;72.2;62.0
73;2021-08-21;463;1837;312600;269957;72.3;62.4
73;2021-08-22;268;936;312868;270893;72.3;62.6
73;2021-08-23;677;2970;313545;273863;72.5;63.3
73;2021-08-24;899;3160;314444;277023;72.7;64.0
73;2021-08-25;712;2907;315156;279930;72.9;64.7
73;2021-08-26;691;2424;315847;282354;73.0;65.3
73;2021-08-27;791;2748;316638;285102;73.2;65.9
73;2021-08-28;457;1749;317095;286851;73.3;66.3
73;2021-08-29;302;1016;317397;287867;73.4;66.6
73;2021-08-30;819;2590;318216;290457;73.6;67.2
73;2021-08-31;818;2392;319034;292849;73.8;67.7
73;2021-09-01;748;2243;319782;295092;73.9;68.2
73;2021-09-02;619;2018;320401;297110;74.1;68.7
73;2021-09-03;695;2210;321096;299320;74.2;69.2
73;2021-09-04;530;1463;321626;300783;74.4;69.5
73;2021-09-05;227;752;321853;301535;74.4;69.7
73;2021-09-06;349;1290;322202;302825;74.5;70.0
73;2021-09-07;414;1094;322616;303919;74.6;70.3
73;2021-09-08;490;1184;323106;305103;74.7;70.5
73;2021-09-09;467;1285;323573;306388;74.8;70.8
73;2021-09-10;574;1527;324147;307915;74.9;71.2
73;2021-09-11;354;1092;324501;309007;75.0;71.4
73;2021-09-12;96;163;324597;309170;75.0;71.5
73;2021-09-13;342;1029;324939;310199;75.1;71.7
73;2021-09-14;412;956;325351;311155;75.2;71.9
73;2021-09-15;424;814;325775;311969;75.3;72.1
73;2021-09-16;330;646;326105;312615;75.4;72.3
73;2021-09-17;376;868;326481;313483;75.5;72.5
73;2021-09-18;257;630;326738;314113;75.5;72.6
73;2021-09-19;46;205;326784;314318;75.5;72.7
73;2021-09-20;163;632;326947;314950;75.6;72.8
73;2021-09-21;298;538;327245;315488;75.7;72.9
73;2021-09-22;275;774;327520;316262;75.7;73.1
73;2021-09-23;281;476;327801;316738;75.8;73.2
73;2021-09-24;292;857;328093;317595;75.9;73.4
73;2021-09-25;189;723;328282;318318;75.9;73.6
73;2021-09-26;73;210;328355;318528;75.9;73.6
73;2021-09-27;243;499;328598;319027;76.0;73.8
73;2021-09-28;185;340;328783;319367;76.0;73.8
73;2021-09-29;220;675;329003;320042;76.1;74.0
73;2021-09-30;191;364;329194;320406;76.1;74.1
73;2021-10-01;211;564;329405;320970;76.2;74.2
73;2021-10-02;197;482;329602;321452;76.2;74.3
73;2021-10-03;8;11;329610;321463;76.2;74.3
73;2021-10-04;209;362;329819;321825;76.3;74.4
73;2021-10-05;166;311;329985;322136;76.3;74.5
73;2021-10-06;311;507;330296;322643;76.4;74.6
74;2020-12-27;10;0;10;0;0.0;0.0
74;2020-12-28;9;0;19;0;0.0;0.0
74;2020-12-29;0;0;19;0;0.0;0.0
74;2020-12-30;5;0;24;0;0.0;0.0
74;2020-12-31;1;0;25;0;0.0;0.0
74;2021-01-01;0;0;25;0;0.0;0.0
74;2021-01-02;1;1;26;1;0.0;0.0
74;2021-01-03;0;0;26;1;0.0;0.0
74;2021-01-04;3;0;29;1;0.0;0.0
74;2021-01-05;4;0;33;1;0.0;0.0
74;2021-01-06;48;0;81;1;0.0;0.0
74;2021-01-07;220;1;301;2;0.0;0.0
74;2021-01-08;294;2;595;4;0.1;0.0
74;2021-01-09;79;0;674;4;0.1;0.0
74;2021-01-10;74;0;748;4;0.1;0.0
74;2021-01-11;375;0;1123;4;0.1;0.0
74;2021-01-12;408;3;1531;7;0.2;0.0
74;2021-01-13;396;0;1927;7;0.2;0.0
74;2021-01-14;482;1;2409;8;0.3;0.0
74;2021-01-15;645;4;3054;12;0.4;0.0
74;2021-01-16;254;1;3308;13;0.4;0.0
74;2021-01-17;134;1;3442;14;0.4;0.0
74;2021-01-18;527;0;3969;14;0.5;0.0
74;2021-01-19;814;2;4783;16;0.6;0.0
74;2021-01-20;1282;4;6065;20;0.7;0.0
74;2021-01-21;1570;2;7635;22;0.9;0.0
74;2021-01-22;1242;6;8877;28;1.1;0.0
74;2021-01-23;345;1;9222;29;1.1;0.0
74;2021-01-24;94;1;9316;30;1.1;0.0
74;2021-01-25;801;2;10117;32;1.2;0.0
74;2021-01-26;1371;14;11488;46;1.4;0.0
74;2021-01-27;1083;11;12571;57;1.5;0.0
74;2021-01-28;1003;28;13574;85;1.6;0.0
74;2021-01-29;882;35;14456;120;1.7;0.0
74;2021-01-30;305;1;14761;121;1.8;0.0
74;2021-01-31;87;1;14848;122;1.8;0.0
74;2021-02-01;632;44;15480;166;1.9;0.0
74;2021-02-02;645;147;16125;313;1.9;0.0
74;2021-02-03;606;114;16731;427;2.0;0.1
74;2021-02-04;617;122;17348;549;2.1;0.1
74;2021-02-05;556;186;17904;735;2.2;0.1
74;2021-02-06;276;111;18180;846;2.2;0.1
74;2021-02-07;93;102;18273;948;2.2;0.1
74;2021-02-08;620;310;18893;1258;2.3;0.2
74;2021-02-09;541;422;19434;1680;2.3;0.2
74;2021-02-10;689;468;20123;2148;2.4;0.3
74;2021-02-11;1082;933;21205;3081;2.6;0.4
74;2021-02-12;917;569;22122;3650;2.7;0.4
74;2021-02-13;407;212;22529;3862;2.7;0.5
74;2021-02-14;320;98;22849;3960;2.8;0.5
74;2021-02-15;281;634;23130;4594;2.8;0.6
74;2021-02-16;492;840;23622;5434;2.9;0.7
74;2021-02-17;530;896;24152;6330;2.9;0.8
74;2021-02-18;473;840;24625;7170;3.0;0.9
74;2021-02-19;619;567;25244;7737;3.0;0.9
74;2021-02-20;114;135;25358;7872;3.1;1.0
74;2021-02-21;48;49;25406;7921;3.1;1.0
74;2021-02-22;320;598;25726;8519;3.1;1.0
74;2021-02-23;307;674;26033;9193;3.1;1.1
74;2021-02-24;241;549;26274;9742;3.2;1.2
74;2021-02-25;524;600;26798;10342;3.2;1.2
74;2021-02-26;973;571;27771;10913;3.4;1.3
74;2021-02-27;254;138;28025;11051;3.4;1.3
74;2021-02-28;125;65;28150;11116;3.4;1.3
74;2021-03-01;724;552;28874;11668;3.5;1.4
74;2021-03-02;1093;567;29967;12235;3.6;1.5
74;2021-03-03;1025;544;30992;12779;3.7;1.5
74;2021-03-04;1613;894;32605;13673;3.9;1.7
74;2021-03-05;2095;792;34700;14465;4.2;1.7
74;2021-03-06;1761;302;36461;14767;4.4;1.8
74;2021-03-07;1386;103;37847;14870;4.6;1.8
74;2021-03-08;1198;849;39045;15719;4.7;1.9
74;2021-03-09;1957;592;41002;16311;4.9;2.0
74;2021-03-10;1749;789;42751;17100;5.2;2.1
74;2021-03-11;2451;663;45202;17763;5.5;2.1
74;2021-03-12;3246;971;48448;18734;5.8;2.3
74;2021-03-13;2002;267;50450;19001;6.1;2.3
74;2021-03-14;609;101;51059;19102;6.2;2.3
74;2021-03-15;2129;539;53188;19641;6.4;2.4
74;2021-03-16;1963;404;55151;20045;6.7;2.4
74;2021-03-17;1975;310;57126;20355;6.9;2.5
74;2021-03-18;2137;283;59263;20638;7.2;2.5
74;2021-03-19;2636;296;61899;20934;7.5;2.5
74;2021-03-20;1375;104;63274;21038;7.6;2.5
74;2021-03-21;290;32;63564;21070;7.7;2.5
74;2021-03-22;2054;317;65618;21387;7.9;2.6
74;2021-03-23;2723;339;68341;21726;8.2;2.6
74;2021-03-24;2948;306;71289;22032;8.6;2.7
74;2021-03-25;3875;309;75164;22341;9.1;2.7
74;2021-03-26;4095;386;79259;22727;9.6;2.7
74;2021-03-27;1941;261;81200;22988;9.8;2.8
74;2021-03-28;437;78;81637;23066;9.9;2.8
74;2021-03-29;3035;702;84672;23768;10.2;2.9
74;2021-03-30;3543;760;88215;24528;10.6;3.0
74;2021-03-31;3144;738;91359;25266;11.0;3.0
74;2021-04-01;4236;902;95595;26168;11.5;3.2
74;2021-04-02;3711;794;99306;26962;12.0;3.3
74;2021-04-03;1697;537;101003;27499;12.2;3.3
74;2021-04-04;236;122;101239;27621;12.2;3.3
74;2021-04-05;433;16;101672;27637;12.3;3.3
74;2021-04-06;2623;1206;104295;28843;12.6;3.5
74;2021-04-07;3195;1253;107490;30096;13.0;3.6
74;2021-04-08;3865;1191;111355;31287;13.4;3.8
74;2021-04-09;4111;1183;115466;32470;13.9;3.9
74;2021-04-10;1944;1027;117410;33497;14.2;4.0
74;2021-04-11;253;184;117663;33681;14.2;4.1
74;2021-04-12;2724;1778;120387;35459;14.5;4.3
74;2021-04-13;3123;2105;123510;37564;14.9;4.5
74;2021-04-14;2903;1972;126413;39536;15.3;4.8
74;2021-04-15;3463;1910;129876;41446;15.7;5.0
74;2021-04-16;3386;1789;133262;43235;16.1;5.2
74;2021-04-17;1936;1034;135198;44269;16.3;5.3
74;2021-04-18;218;211;135416;44480;16.3;5.4
74;2021-04-19;2100;2094;137516;46574;16.6;5.6
74;2021-04-20;3068;2415;140584;48989;17.0;5.9
74;2021-04-21;2464;2375;143048;51364;17.3;6.2
74;2021-04-22;2629;2338;145677;53702;17.6;6.5
74;2021-04-23;2573;2247;148250;55949;17.9;6.8
74;2021-04-24;1485;1540;149735;57489;18.1;6.9
74;2021-04-25;229;149;149964;57638;18.1;7.0
74;2021-04-26;2396;2462;152360;60100;18.4;7.3
74;2021-04-27;3272;2906;155632;63006;18.8;7.6
74;2021-04-28;3465;2628;159097;65634;19.2;7.9
74;2021-04-29;3908;2696;163005;68330;19.7;8.2
74;2021-04-30;4076;2224;167081;70554;20.2;8.5
74;2021-05-01;2121;397;169202;70951;20.4;8.6
74;2021-05-02;205;238;169407;71189;20.4;8.6
74;2021-05-03;2596;3021;172003;74210;20.8;9.0
74;2021-05-04;3216;3116;175219;77326;21.2;9.3
74;2021-05-05;3392;3021;178611;80347;21.6;9.7
74;2021-05-06;3859;2633;182470;82980;22.0;10.0
74;2021-05-07;3595;3541;186065;86521;22.5;10.4
74;2021-05-08;1145;827;187210;87348;22.6;10.5
74;2021-05-09;195;246;187405;87594;22.6;10.6
74;2021-05-10;3466;3145;190871;90739;23.0;11.0
74;2021-05-11;4317;3418;195188;94157;23.6;11.4
74;2021-05-12;5305;2963;200493;97120;24.2;11.7
74;2021-05-13;2357;950;202850;98070;24.5;11.8
74;2021-05-14;5956;2402;208806;100472;25.2;12.1
74;2021-05-15;4513;1848;213319;102320;25.8;12.4
74;2021-05-16;3012;338;216331;102658;26.1;12.4
74;2021-05-17;5397;2890;221728;105548;26.8;12.7
74;2021-05-18;6792;2818;228520;108366;27.6;13.1
74;2021-05-19;6234;2297;234754;110663;28.3;13.4
74;2021-05-20;6643;2558;241397;113221;29.1;13.7
74;2021-05-21;6526;2993;247923;116214;29.9;14.0
74;2021-05-22;5293;1568;253216;117782;30.6;14.2
74;2021-05-23;2052;282;255268;118064;30.8;14.3
74;2021-05-24;2362;660;257630;118724;31.1;14.3
74;2021-05-25;5072;3334;262702;122058;31.7;14.7
74;2021-05-26;5255;2563;267957;124621;32.3;15.0
74;2021-05-27;6002;2976;273959;127597;33.1;15.4
74;2021-05-28;5656;3575;279615;131172;33.8;15.8
74;2021-05-29;3799;2156;283414;133328;34.2;16.1
74;2021-05-30;488;309;283902;133637;34.3;16.1
74;2021-05-31;5069;3549;288971;137186;34.9;16.6
74;2021-06-01;4931;3727;293902;140913;35.5;17.0
74;2021-06-02;5269;3207;299171;144120;36.1;17.4
74;2021-06-03;6891;3251;306062;147371;36.9;17.8
74;2021-06-04;6911;4431;312973;151802;37.8;18.3
74;2021-06-05;4610;2707;317583;154509;38.3;18.7
74;2021-06-06;124;112;317707;154621;38.4;18.7
74;2021-06-07;5032;4144;322739;158765;39.0;19.2
74;2021-06-08;5025;3949;327764;162714;39.6;19.6
74;2021-06-09;5081;3481;332845;166195;40.2;20.1
74;2021-06-10;5124;2877;337969;169072;40.8;20.4
74;2021-06-11;5214;3812;343183;172884;41.4;20.9
74;2021-06-12;3567;2378;346750;175262;41.9;21.2
74;2021-06-13;120;89;346870;175351;41.9;21.2
74;2021-06-14;3594;4482;350464;179833;42.3;21.7
74;2021-06-15;3671;3896;354135;183729;42.7;22.2
74;2021-06-16;4827;3123;358962;186852;43.3;22.6
74;2021-06-17;3816;2953;362778;189805;43.8;22.9
74;2021-06-18;4114;4669;366892;194474;44.3;23.5
74;2021-06-19;2993;3101;369885;197575;44.7;23.9
74;2021-06-20;125;97;370010;197672;44.7;23.9
74;2021-06-21;2382;5419;372392;203091;45.0;24.5
74;2021-06-22;2493;5312;374885;208403;45.3;25.2
74;2021-06-23;2974;4618;377859;213021;45.6;25.7
74;2021-06-24;2865;4625;380724;217646;46.0;26.3
74;2021-06-25;2930;6768;383654;224414;46.3;27.1
74;2021-06-26;1705;5400;385359;229814;46.5;27.7
74;2021-06-27;66;1664;385425;231478;46.5;27.9
74;2021-06-28;1915;7219;387340;238697;46.8;28.8
74;2021-06-29;2298;7421;389638;246118;47.0;29.7
74;2021-06-30;2747;6544;392385;252662;47.4;30.5
74;2021-07-01;3526;5426;395911;258088;47.8;31.2
74;2021-07-02;3121;6639;399032;264727;48.2;32.0
74;2021-07-03;1698;5085;400730;269812;48.4;32.6
74;2021-07-04;81;1022;400811;270834;48.4;32.7
74;2021-07-05;2078;6828;402889;277662;48.6;33.5
74;2021-07-06;2799;6487;405688;284149;49.0;34.3
74;2021-07-07;3094;5446;408782;289595;49.3;35.0
74;2021-07-08;3866;4923;412648;294518;49.8;35.6
74;2021-07-09;2671;6974;415319;301492;50.1;36.4
74;2021-07-10;1622;5132;416941;306624;50.3;37.0
74;2021-07-11;76;142;417017;306766;50.3;37.0
74;2021-07-12;2095;7899;419112;314665;50.6;38.0
74;2021-07-13;3967;7586;423079;322251;51.1;38.9
74;2021-07-14;1968;2238;425047;324489;51.3;39.2
74;2021-07-15;3592;6876;428639;331365;51.7;40.0
74;2021-07-16;4242;7741;432881;339106;52.3;40.9
74;2021-07-17;3004;5330;435885;344436;52.6;41.6
74;2021-07-18;156;155;436041;344591;52.6;41.6
74;2021-07-19;4295;7351;440336;351942;53.2;42.5
74;2021-07-20;5873;6468;446209;358410;53.9;43.3
74;2021-07-21;5668;6674;451877;365084;54.5;44.1
74;2021-07-22;4773;5323;456650;370407;55.1;44.7
74;2021-07-23;6226;6994;462876;377401;55.9;45.6
74;2021-07-24;3156;4316;466032;381717;56.3;46.1
74;2021-07-25;181;171;466213;381888;56.3;46.1
74;2021-07-26;5617;6134;471830;388022;57.0;46.8
74;2021-07-27;6852;5176;478682;393198;57.8;47.5
74;2021-07-28;6660;5102;485342;398300;58.6;48.1
74;2021-07-29;5280;3930;490622;402230;59.2;48.6
74;2021-07-30;6715;5503;497337;407733;60.0;49.2
74;2021-07-31;4377;3123;501714;410856;60.6;49.6
74;2021-08-01;184;149;501898;411005;60.6;49.6
74;2021-08-02;6273;4409;508171;415414;61.3;50.1
74;2021-08-03;6038;3860;514209;419274;62.1;50.6
74;2021-08-04;6325;3508;520534;422782;62.8;51.0
74;2021-08-05;4936;3266;525470;426048;63.4;51.4
74;2021-08-06;5068;4182;530538;430230;64.0;51.9
74;2021-08-07;3210;2899;533748;433129;64.4;52.3
74;2021-08-08;154;134;533902;433263;64.4;52.3
74;2021-08-09;4975;4828;538877;438091;65.0;52.9
74;2021-08-10;4989;4687;543866;442778;65.7;53.4
74;2021-08-11;4447;4891;548313;447669;66.2;54.0
74;2021-08-12;3626;3607;551939;451276;66.6;54.5
74;2021-08-13;3836;4625;555775;455901;67.1;55.0
74;2021-08-14;2184;3342;557959;459243;67.4;55.4
74;2021-08-15;65;102;558024;459345;67.4;55.4
74;2021-08-16;3913;5879;561937;465224;67.8;56.2
74;2021-08-17;3135;5486;565072;470710;68.2;56.8
74;2021-08-18;3093;5461;568165;476171;68.6;57.5
74;2021-08-19;2359;3897;570524;480068;68.9;58.0
74;2021-08-20;2637;5699;573161;485767;69.2;58.6
74;2021-08-21;1239;4273;574400;490040;69.3;59.2
74;2021-08-22;56;137;574456;490177;69.3;59.2
74;2021-08-23;2198;6697;576654;496874;69.6;60.0
74;2021-08-24;2219;5938;578873;502812;69.9;60.7
74;2021-08-25;1978;6295;580851;509107;70.1;61.5
74;2021-08-26;1564;3786;582415;512893;70.3;61.9
74;2021-08-27;1938;5509;584353;518402;70.5;62.6
74;2021-08-28;927;4042;585280;522444;70.7;63.1
74;2021-08-29;67;188;585347;522632;70.7;63.1
74;2021-08-30;1870;5484;587217;528116;70.9;63.8
74;2021-08-31;1677;5127;588894;533243;71.1;64.4
74;2021-09-01;1972;4156;590866;537399;71.3;64.9
74;2021-09-02;1223;3035;592089;540434;71.5;65.2
74;2021-09-03;1549;4185;593638;544619;71.7;65.7
74;2021-09-04;1158;2848;594796;547467;71.8;66.1
74;2021-09-05;48;96;594844;547563;71.8;66.1
74;2021-09-06;1260;3377;596104;550940;72.0;66.5
74;2021-09-07;1026;3053;597130;553993;72.1;66.9
74;2021-09-08;1309;3179;598439;557172;72.2;67.3
74;2021-09-09;1221;2215;599660;559387;72.4;67.5
74;2021-09-10;1122;3112;600782;562499;72.5;67.9
74;2021-09-11;764;2325;601546;564824;72.6;68.2
74;2021-09-12;40;80;601586;564904;72.6;68.2
74;2021-09-13;958;2638;602544;567542;72.7;68.5
74;2021-09-14;1058;2480;603602;570022;72.9;68.8
74;2021-09-15;1064;2271;604666;572293;73.0;69.1
74;2021-09-16;749;1031;605415;573324;73.1;69.2
74;2021-09-17;832;1848;606247;575172;73.2;69.4
74;2021-09-18;604;1671;606851;576843;73.3;69.6
74;2021-09-19;3;9;606854;576852;73.3;69.6
74;2021-09-20;798;1885;607652;578737;73.4;69.9
74;2021-09-21;638;1371;608290;580108;73.4;70.0
74;2021-09-22;618;2102;608908;582210;73.5;70.3
74;2021-09-23;638;998;609546;583208;73.6;70.4
74;2021-09-24;724;1970;610270;585178;73.7;70.6
74;2021-09-25;461;1621;610731;586799;73.7;70.8
74;2021-09-26;1;2;610732;586801;73.7;70.8
74;2021-09-27;573;1775;611305;588576;73.8;71.0
74;2021-09-28;395;960;611700;589536;73.8;71.2
74;2021-09-29;547;1564;612247;591100;73.9;71.4
74;2021-09-30;390;1060;612637;592160;74.0;71.5
74;2021-10-01;601;1119;613238;593279;74.0;71.6
74;2021-10-02;435;815;613673;594094;74.1;71.7
74;2021-10-03;5;11;613678;594105;74.1;71.7
74;2021-10-04;531;1110;614209;595215;74.1;71.9
74;2021-10-05;366;1094;614575;596309;74.2;72.0
74;2021-10-06;446;985;615021;597294;74.2;72.1
75;2020-12-27;76;1;76;1;0.0;0.0
75;2020-12-28;67;0;143;1;0.0;0.0
75;2020-12-29;33;0;176;1;0.0;0.0
75;2020-12-30;87;0;263;1;0.0;0.0
75;2020-12-31;48;1;311;2;0.0;0.0
75;2021-01-01;63;3;374;5;0.0;0.0
75;2021-01-02;66;1;440;6;0.0;0.0
75;2021-01-03;109;1;549;7;0.0;0.0
75;2021-01-04;323;1;872;8;0.0;0.0
75;2021-01-05;882;10;1754;18;0.1;0.0
75;2021-01-06;1371;16;3125;34;0.1;0.0
75;2021-01-07;2073;19;5198;53;0.2;0.0
75;2021-01-08;2881;30;8079;83;0.4;0.0
75;2021-01-09;1097;2;9176;85;0.4;0.0
75;2021-01-10;1101;4;10277;89;0.5;0.0
75;2021-01-11;3120;45;13397;134;0.6;0.0
75;2021-01-12;3491;52;16888;186;0.8;0.0
75;2021-01-13;3575;44;20463;230;1.0;0.0
75;2021-01-14;3797;61;24260;291;1.1;0.0
75;2021-01-15;3341;46;27601;337;1.3;0.0
75;2021-01-16;1147;14;28748;351;1.3;0.0
75;2021-01-17;564;14;29312;365;1.4;0.0
75;2021-01-18;3294;69;32606;434;1.5;0.0
75;2021-01-19;3877;47;36483;481;1.7;0.0
75;2021-01-20;4441;59;40924;540;1.9;0.0
75;2021-01-21;4952;71;45876;611;2.1;0.0
75;2021-01-22;4609;69;50485;680;2.4;0.0
75;2021-01-23;1769;12;52254;692;2.4;0.0
75;2021-01-24;763;7;53017;699;2.5;0.0
75;2021-01-25;1741;24;54758;723;2.5;0.0
75;2021-01-26;2564;80;57322;803;2.7;0.0
75;2021-01-27;3176;148;60498;951;2.8;0.0
75;2021-01-28;4790;229;65288;1180;3.0;0.1
75;2021-01-29;4064;237;69352;1417;3.2;0.1
75;2021-01-30;1361;18;70713;1435;3.3;0.1
75;2021-01-31;226;3;70939;1438;3.3;0.1
75;2021-02-01;1637;339;72576;1777;3.4;0.1
75;2021-02-02;2155;583;74731;2360;3.5;0.1
75;2021-02-03;1894;632;76625;2992;3.6;0.1
75;2021-02-04;2154;1034;78779;4026;3.7;0.2
75;2021-02-05;2226;755;81005;4781;3.8;0.2
75;2021-02-06;1139;73;82144;4854;3.8;0.2
75;2021-02-07;179;6;82323;4860;3.8;0.2
75;2021-02-08;1268;1273;83591;6133;3.9;0.3
75;2021-02-09;1803;2187;85394;8320;4.0;0.4
75;2021-02-10;2431;2169;87825;10489;4.1;0.5
75;2021-02-11;2952;4878;90777;15367;4.2;0.7
75;2021-02-12;3137;2223;93914;17590;4.4;0.8
75;2021-02-13;861;821;94775;18411;4.4;0.9
75;2021-02-14;212;39;94987;18450;4.4;0.9
75;2021-02-15;1011;1888;95998;20338;4.5;0.9
75;2021-02-16;1469;5125;97467;25463;4.5;1.2
75;2021-02-17;1345;2435;98812;27898;4.6;1.3
75;2021-02-18;1778;4500;100590;32398;4.7;1.5
75;2021-02-19;2232;3260;102822;35658;4.8;1.7
75;2021-02-20;485;1280;103307;36938;4.8;1.7
75;2021-02-21;201;112;103508;37050;4.8;1.7
75;2021-02-22;1230;1475;104738;38525;4.9;1.8
75;2021-02-23;1474;1974;106212;40499;4.9;1.9
75;2021-02-24;1700;1739;107912;42238;5.0;2.0
75;2021-02-25;2799;4291;110711;46529;5.2;2.2
75;2021-02-26;3387;2051;114098;48580;5.3;2.3
75;2021-02-27;1409;690;115507;49270;5.4;2.3
75;2021-02-28;330;99;115837;49369;5.4;2.3
75;2021-03-01;2613;1338;118450;50707;5.5;2.4
75;2021-03-02;4195;1671;122645;52378;5.7;2.4
75;2021-03-03;5445;1874;128090;54252;6.0;2.5
75;2021-03-04;8063;2132;136153;56384;6.3;2.6
75;2021-03-05;10587;2271;146740;58655;6.8;2.7
75;2021-03-06;11087;954;157827;59609;7.3;2.8
75;2021-03-07;9513;1406;167340;61015;7.8;2.8
75;2021-03-08;5927;1379;173267;62394;8.1;2.9
75;2021-03-09;7541;1893;180808;64287;8.4;3.0
75;2021-03-10;7526;1953;188334;66240;8.8;3.1
75;2021-03-11;10366;2344;198700;68584;9.2;3.2
75;2021-03-12;12074;2409;210774;70993;9.8;3.3
75;2021-03-13;8563;750;219337;71743;10.2;3.3
75;2021-03-14;4179;262;223516;72005;10.4;3.4
75;2021-03-15;7478;965;230994;72970;10.8;3.4
75;2021-03-16;5168;681;236162;73651;11.0;3.4
75;2021-03-17;5435;822;241597;74473;11.2;3.5
75;2021-03-18;6630;853;248227;75326;11.6;3.5
75;2021-03-19;9771;986;257998;76312;12.0;3.6
75;2021-03-20;5941;598;263939;76910;12.3;3.6
75;2021-03-21;1596;424;265535;77334;12.4;3.6
75;2021-03-22;8668;1017;274203;78351;12.8;3.6
75;2021-03-23;10970;1255;285173;79606;13.3;3.7
75;2021-03-24;11019;1328;296192;80934;13.8;3.8
75;2021-03-25;14225;1541;310417;82475;14.4;3.8
75;2021-03-26;13992;1702;324409;84177;15.1;3.9
75;2021-03-27;7290;765;331699;84942;15.4;4.0
75;2021-03-28;1791;151;333490;85093;15.5;4.0
75;2021-03-29;7980;2171;341470;87264;15.9;4.1
75;2021-03-30;10949;3205;352419;90469;16.4;4.2
75;2021-03-31;9755;3564;362174;94033;16.9;4.4
75;2021-04-01;10717;5172;372891;99205;17.4;4.6
75;2021-04-02;9067;5534;381958;104739;17.8;4.9
75;2021-04-03;4129;4848;386087;109587;18.0;5.1
75;2021-04-04;1424;1455;387511;111042;18.0;5.2
75;2021-04-05;2261;1316;389772;112358;18.1;5.2
75;2021-04-06;6929;4252;396701;116610;18.5;5.4
75;2021-04-07;8108;4376;404809;120986;18.8;5.6
75;2021-04-08;11096;4167;415905;125153;19.4;5.8
75;2021-04-09;12219;4616;428124;129769;19.9;6.0
75;2021-04-10;5850;4237;433974;134006;20.2;6.2
75;2021-04-11;1951;1784;435925;135790;20.3;6.3
75;2021-04-12;7490;3785;443415;139575;20.6;6.5
75;2021-04-13;8575;6780;451990;146355;21.0;6.8
75;2021-04-14;8307;5214;460297;151569;21.4;7.1
75;2021-04-15;8932;6126;469229;157695;21.8;7.3
75;2021-04-16;9397;6104;478626;163799;22.3;7.6
75;2021-04-17;4821;3636;483447;167435;22.5;7.8
75;2021-04-18;1674;876;485121;168311;22.6;7.8
75;2021-04-19;5595;4940;490716;173251;22.8;8.1
75;2021-04-20;6473;5944;497189;179195;23.1;8.3
75;2021-04-21;6881;5562;504070;184757;23.5;8.6
75;2021-04-22;7550;5898;511620;190655;23.8;8.9
75;2021-04-23;8692;6442;520312;197097;24.2;9.2
75;2021-04-24;6185;3346;526497;200443;24.5;9.3
75;2021-04-25;2973;760;529470;201203;24.6;9.4
75;2021-04-26;7032;4700;536502;205903;25.0;9.6
75;2021-04-27;10601;6387;547103;212290;25.5;9.9
75;2021-04-28;12205;5982;559308;218272;26.0;10.2
75;2021-04-29;13765;6317;573073;224589;26.7;10.5
75;2021-04-30;13669;6144;586742;230733;27.3;10.7
75;2021-05-01;5081;1324;591823;232057;27.5;10.8
75;2021-05-02;2391;789;594214;232846;27.7;10.8
75;2021-05-03;10298;13447;604512;246293;28.1;11.5
75;2021-05-04;11198;8061;615710;254354;28.7;11.8
75;2021-05-05;13566;6695;629276;261049;29.3;12.2
75;2021-05-06;14010;8175;643286;269224;29.9;12.5
75;2021-05-07;13987;8557;657273;277781;30.6;12.9
75;2021-05-08;10086;5508;667359;283289;31.1;13.2
75;2021-05-09;3821;3179;671180;286468;31.2;13.3
75;2021-05-10;14299;6704;685479;293172;31.9;13.6
75;2021-05-11;16853;8383;702332;301555;32.7;14.0
75;2021-05-12;17964;8130;720296;309685;33.5;14.4
75;2021-05-13;13646;2488;733942;312173;34.2;14.5
75;2021-05-14;18397;5119;752339;317292;35.0;14.8
75;2021-05-15;12326;2656;764665;319948;35.6;14.9
75;2021-05-16;3860;759;768525;320707;35.8;14.9
75;2021-05-17;16011;4645;784536;325352;36.5;15.1
75;2021-05-18;19160;5309;803696;330661;37.4;15.4
75;2021-05-19;20730;10693;824426;341354;38.4;15.9
75;2021-05-20;21585;8656;846011;350010;39.4;16.3
75;2021-05-21;21032;6545;867043;356555;40.4;16.6
75;2021-05-22;15909;3293;882952;359848;41.1;16.8
75;2021-05-23;5639;1335;888591;361183;41.4;16.8
75;2021-05-24;15636;2559;904227;363742;42.1;16.9
75;2021-05-25;18035;9558;922262;373300;42.9;17.4
75;2021-05-26;18890;8195;941152;381495;43.8;17.8
75;2021-05-27;20147;9792;961299;391287;44.7;18.2
75;2021-05-28;19340;10828;980639;402115;45.6;18.7
75;2021-05-29;16116;5836;996755;407951;46.4;19.0
75;2021-05-30;7040;2157;1003795;410108;46.7;19.1
75;2021-05-31;18094;9428;1021889;419536;47.6;19.5
75;2021-06-01;18698;12964;1040587;432500;48.4;20.1
75;2021-06-02;18122;10297;1058709;442797;49.3;20.6
75;2021-06-03;20255;11947;1078964;454744;50.2;21.2
75;2021-06-04;18119;12828;1097083;467572;51.1;21.8
75;2021-06-05;11990;9612;1109073;477184;51.6;22.2
75;2021-06-06;6726;3158;1115799;480342;51.9;22.4
75;2021-06-07;13892;11815;1129691;492157;52.6;22.9
75;2021-06-08;14801;13954;1144492;506111;53.3;23.6
75;2021-06-09;16509;15233;1161001;521344;54.0;24.3
75;2021-06-10;18364;26285;1179365;547629;54.9;25.5
75;2021-06-11;15312;16454;1194677;564083;55.6;26.3
75;2021-06-12;13284;10002;1207961;574085;56.2;26.7
75;2021-06-13;6277;3794;1214238;577879;56.5;26.9
75;2021-06-14;11824;15390;1226062;593269;57.1;27.6
75;2021-06-15;12729;19544;1238791;612813;57.7;28.5
75;2021-06-16;12209;17232;1251000;630045;58.2;29.3
75;2021-06-17;12661;17669;1263661;647714;58.8;30.2
75;2021-06-18;11275;22601;1274936;670315;59.3;31.2
75;2021-06-19;7532;11820;1282468;682135;59.7;31.8
75;2021-06-20;2820;5473;1285288;687608;59.8;32.0
75;2021-06-21;8514;16327;1293802;703935;60.2;32.8
75;2021-06-22;8810;21790;1302612;725725;60.6;33.8
75;2021-06-23;10309;21425;1312921;747150;61.1;34.8
75;2021-06-24;11319;20638;1324240;767788;61.6;35.7
75;2021-06-25;9874;24682;1334114;792470;62.1;36.9
75;2021-06-26;7936;15420;1342050;807890;62.5;37.6
75;2021-06-27;2701;6325;1344751;814215;62.6;37.9
75;2021-06-28;8475;20145;1353226;834360;63.0;38.8
75;2021-06-29;9348;23821;1362574;858181;63.4;39.9
75;2021-06-30;10214;23622;1372788;881803;63.9;41.0
75;2021-07-01;11436;23512;1384224;905315;64.4;42.1
75;2021-07-02;10893;24770;1395117;930085;64.9;43.3
75;2021-07-03;7817;19804;1402934;949889;65.3;44.2
75;2021-07-04;3907;9556;1406841;959445;65.5;44.7
75;2021-07-05;9345;21582;1416186;981027;65.9;45.7
75;2021-07-06;10168;24009;1426354;1005036;66.4;46.8
75;2021-07-07;10163;25090;1436517;1030126;66.9;48.0
75;2021-07-08;10673;25024;1447190;1055150;67.4;49.1
75;2021-07-09;10865;24031;1458055;1079181;67.9;50.2
75;2021-07-10;7950;18499;1466005;1097680;68.2;51.1
75;2021-07-11;4351;8528;1470356;1106208;68.4;51.5
75;2021-07-12;9861;23087;1480217;1129295;68.9;52.6
75;2021-07-13;14394;24804;1494611;1154099;69.6;53.7
75;2021-07-14;8353;9727;1502964;1163826;70.0;54.2
75;2021-07-15;15584;25660;1518548;1189486;70.7;55.4
75;2021-07-16;15825;22149;1534373;1211635;71.4;56.4
75;2021-07-17;12199;16910;1546572;1228545;72.0;57.2
75;2021-07-18;6268;6841;1552840;1235386;72.3;57.5
75;2021-07-19;14402;21296;1567242;1256682;73.0;58.5
75;2021-07-20;16073;21900;1583315;1278582;73.7;59.5
75;2021-07-21;15712;20706;1599027;1299288;74.4;60.5
75;2021-07-22;17149;20093;1616176;1319381;75.2;61.4
75;2021-07-23;17167;19107;1633343;1338488;76.0;62.3
75;2021-07-24;11197;14081;1644540;1352569;76.6;63.0
75;2021-07-25;5005;5070;1649545;1357639;76.8;63.2
75;2021-07-26;15183;16872;1664728;1374511;77.5;64.0
75;2021-07-27;18150;16664;1682878;1391175;78.3;64.8
75;2021-07-28;17148;15489;1700026;1406664;79.1;65.5
75;2021-07-29;16773;15094;1716799;1421758;79.9;66.2
75;2021-07-30;16723;14352;1733522;1436110;80.7;66.8
75;2021-07-31;9346;9866;1742868;1445976;81.1;67.3
75;2021-08-01;3724;3256;1746592;1449232;81.3;67.5
75;2021-08-02;10960;11981;1757552;1461213;81.8;68.0
75;2021-08-03;11132;10839;1768684;1472052;82.3;68.5
75;2021-08-04;9733;9485;1778417;1481537;82.8;69.0
75;2021-08-05;8726;9555;1787143;1491092;83.2;69.4
75;2021-08-06;8253;9992;1795396;1501084;83.6;69.9
75;2021-08-07;5708;7159;1801104;1508243;83.8;70.2
75;2021-08-08;1963;3282;1803067;1511525;83.9;70.4
75;2021-08-09;8609;11476;1811676;1523001;84.3;70.9
75;2021-08-10;9299;11587;1820975;1534588;84.8;71.4
75;2021-08-11;7790;10144;1828765;1544732;85.1;71.9
75;2021-08-12;6940;10597;1835705;1555329;85.5;72.4
75;2021-08-13;6259;8869;1841964;1564198;85.7;72.8
75;2021-08-14;4119;7200;1846083;1571398;85.9;73.1
75;2021-08-15;1031;1936;1847114;1573334;86.0;73.2
75;2021-08-16;6140;14033;1853254;1587367;86.3;73.9
75;2021-08-17;5814;13606;1859068;1600973;86.5;74.5
75;2021-08-18;5082;12012;1864150;1612985;86.8;75.1
75;2021-08-19;4773;12686;1868923;1625671;87.0;75.7
75;2021-08-20;4564;11789;1873487;1637460;87.2;76.2
75;2021-08-21;3188;8813;1876675;1646273;87.4;76.6
75;2021-08-22;997;3163;1877672;1649436;87.4;76.8
75;2021-08-23;4922;15305;1882594;1664741;87.6;77.5
75;2021-08-24;4807;14538;1887401;1679279;87.9;78.2
75;2021-08-25;4533;12335;1891934;1691614;88.1;78.7
75;2021-08-26;4089;10281;1896023;1701895;88.3;79.2
75;2021-08-27;4472;11680;1900495;1713575;88.5;79.8
75;2021-08-28;3074;8307;1903569;1721882;88.6;80.2
75;2021-08-29;754;2020;1904323;1723902;88.6;80.2
75;2021-08-30;4525;14668;1908848;1738570;88.9;80.9
75;2021-08-31;4425;13818;1913273;1752388;89.1;81.6
75;2021-09-01;4023;11413;1917296;1763801;89.2;82.1
75;2021-09-02;3267;9621;1920563;1773422;89.4;82.6
75;2021-09-03;3737;10406;1924300;1783828;89.6;83.0
75;2021-09-04;3567;8921;1927867;1792749;89.7;83.5
75;2021-09-05;704;1717;1928571;1794466;89.8;83.5
75;2021-09-06;2606;8079;1931177;1802545;89.9;83.9
75;2021-09-07;2400;7384;1933577;1809929;90.0;84.3
75;2021-09-08;2611;7338;1936188;1817267;90.1;84.6
75;2021-09-09;2429;6842;1938617;1824109;90.2;84.9
75;2021-09-10;2725;8037;1941342;1832146;90.4;85.3
75;2021-09-11;2367;6974;1943709;1839120;90.5;85.6
75;2021-09-12;504;1197;1944213;1840317;90.5;85.7
75;2021-09-13;2296;6500;1946509;1846817;90.6;86.0
75;2021-09-14;2260;5662;1948769;1852479;90.7;86.2
75;2021-09-15;2287;4650;1951056;1857129;90.8;86.4
75;2021-09-16;1883;3712;1952939;1860841;90.9;86.6
75;2021-09-17;2531;4761;1955470;1865602;91.0;86.8
75;2021-09-18;1559;4679;1957029;1870281;91.1;87.1
75;2021-09-19;284;738;1957313;1871019;91.1;87.1
75;2021-09-20;1696;3644;1959009;1874663;91.2;87.3
75;2021-09-21;1624;3203;1960633;1877866;91.3;87.4
75;2021-09-22;1587;3964;1962220;1881830;91.3;87.6
75;2021-09-23;1422;2849;1963642;1884679;91.4;87.7
75;2021-09-24;1794;4030;1965436;1888709;91.5;87.9
75;2021-09-25;1263;4350;1966699;1893059;91.5;88.1
75;2021-09-26;276;525;1966975;1893584;91.6;88.1
75;2021-09-27;1310;3018;1968285;1896602;91.6;88.3
75;2021-09-28;1401;2468;1969686;1899070;91.7;88.4
75;2021-09-29;1375;2873;1971061;1901943;91.8;88.5
75;2021-09-30;1250;2509;1972311;1904452;91.8;88.7
75;2021-10-01;1509;2670;1973820;1907122;91.9;88.8
75;2021-10-02;1404;2750;1975224;1909872;91.9;88.9
75;2021-10-03;223;425;1975447;1910297;92.0;88.9
75;2021-10-04;1344;2503;1976791;1912800;92.0;89.0
75;2021-10-05;1080;2162;1977871;1914962;92.1;89.1
75;2021-10-06;1200;2405;1979071;1917367;92.1;89.3
76;2020-12-27;0;0;0;0;0.0;0.0
76;2020-12-28;1;0;1;0;0.0;0.0
76;2020-12-29;0;0;1;0;0.0;0.0
76;2020-12-30;0;0;1;0;0.0;0.0
76;2020-12-31;0;0;1;0;0.0;0.0
76;2021-01-01;0;0;1;0;0.0;0.0
76;2021-01-02;0;0;1;0;0.0;0.0
76;2021-01-03;0;0;1;0;0.0;0.0
76;2021-01-04;17;0;18;0;0.0;0.0
76;2021-01-05;138;0;156;0;0.0;0.0
76;2021-01-06;682;2;838;2;0.1;0.0
76;2021-01-07;1354;7;2192;9;0.2;0.0
76;2021-01-08;1537;2;3729;11;0.3;0.0
76;2021-01-09;736;2;4465;13;0.4;0.0
76;2021-01-10;492;1;4957;14;0.4;0.0
76;2021-01-11;1358;2;6315;16;0.5;0.0
76;2021-01-12;1358;2;7673;18;0.6;0.0
76;2021-01-13;1187;4;8860;22;0.7;0.0
76;2021-01-14;2178;23;11038;45;0.9;0.0
76;2021-01-15;1910;9;12948;54;1.0;0.0
76;2021-01-16;990;7;13938;61;1.1;0.0
76;2021-01-17;2898;19;16836;80;1.4;0.0
76;2021-01-18;4395;16;21231;96;1.7;0.0
76;2021-01-19;3021;8;24252;104;1.9;0.0
76;2021-01-20;2072;6;26324;110;2.1;0.0
76;2021-01-21;1773;4;28097;114;2.3;0.0
76;2021-01-22;1705;4;29802;118;2.4;0.0
76;2021-01-23;450;2;30252;120;2.4;0.0
76;2021-01-24;99;0;30351;120;2.4;0.0
76;2021-01-25;1476;135;31827;255;2.6;0.0
76;2021-01-26;1394;323;33221;578;2.7;0.0
76;2021-01-27;1341;411;34562;989;2.8;0.1
76;2021-01-28;1286;366;35848;1355;2.9;0.1
76;2021-01-29;1156;429;37004;1784;3.0;0.1
76;2021-01-30;283;274;37287;2058;3.0;0.2
76;2021-01-31;4;91;37291;2149;3.0;0.2
76;2021-02-01;841;738;38132;2887;3.1;0.2
76;2021-02-02;1055;941;39187;3828;3.2;0.3
76;2021-02-03;921;901;40108;4729;3.2;0.4
76;2021-02-04;976;1366;41084;6095;3.3;0.5
76;2021-02-05;975;1036;42059;7131;3.4;0.6
76;2021-02-06;264;770;42323;7901;3.4;0.6
76;2021-02-07;468;1481;42791;9382;3.4;0.8
76;2021-02-08;1924;3328;44715;12710;3.6;1.0
76;2021-02-09;1753;2600;46468;15310;3.7;1.2
76;2021-02-10;1488;1610;47956;16920;3.9;1.4
76;2021-02-11;1680;1297;49636;18217;4.0;1.5
76;2021-02-12;1705;1349;51341;19566;4.1;1.6
76;2021-02-13;230;278;51571;19844;4.1;1.6
76;2021-02-14;9;80;51580;19924;4.1;1.6
76;2021-02-15;552;1337;52132;21261;4.2;1.7
76;2021-02-16;742;1276;52874;22537;4.3;1.8
76;2021-02-17;626;1101;53500;23638;4.3;1.9
76;2021-02-18;780;1050;54280;24688;4.4;2.0
76;2021-02-19;870;1019;55150;25707;4.4;2.1
76;2021-02-20;270;228;55420;25935;4.5;2.1
76;2021-02-21;0;0;55420;25935;4.5;2.1
76;2021-02-22;371;943;55791;26878;4.5;2.2
76;2021-02-23;576;908;56367;27786;4.5;2.2
76;2021-02-24;601;902;56968;28688;4.6;2.3
76;2021-02-25;1665;956;58633;29644;4.7;2.4
76;2021-02-26;2171;817;60804;30461;4.9;2.4
76;2021-02-27;1109;229;61913;30690;5.0;2.5
76;2021-02-28;27;182;61940;30872;5.0;2.5
76;2021-03-01;830;1782;62770;32654;5.0;2.6
76;2021-03-02;1382;1464;64152;34118;5.2;2.7
76;2021-03-03;1942;1163;66094;35281;5.3;2.8
76;2021-03-04;2819;939;68913;36220;5.5;2.9
76;2021-03-05;4183;697;73096;36917;5.9;3.0
76;2021-03-06;3366;155;76462;37072;6.1;3.0
76;2021-03-07;1257;31;77719;37103;6.2;3.0
76;2021-03-08;2102;1101;79821;38204;6.4;3.1
76;2021-03-09;3575;1017;83396;39221;6.7;3.2
76;2021-03-10;3595;955;86991;40176;7.0;3.2
76;2021-03-11;5635;876;92626;41052;7.4;3.3
76;2021-03-12;6829;575;99455;41627;8.0;3.3
76;2021-03-13;4646;148;104101;41775;8.4;3.4
76;2021-03-14;1068;26;105169;41801;8.5;3.4
76;2021-03-15;2919;234;108088;42035;8.7;3.4
76;2021-03-16;2557;393;110645;42428;8.9;3.4
76;2021-03-17;2696;308;113341;42736;9.1;3.4
76;2021-03-18;3003;306;116344;43042;9.4;3.5
76;2021-03-19;4398;429;120742;43471;9.7;3.5
76;2021-03-20;3974;287;124716;43758;10.0;3.5
76;2021-03-21;838;16;125554;43774;10.1;3.5
76;2021-03-22;3992;350;129546;44124;10.4;3.5
76;2021-03-23;5711;355;135257;44479;10.9;3.6
76;2021-03-24;5701;394;140958;44873;11.3;3.6
76;2021-03-25;7505;575;148463;45448;11.9;3.7
76;2021-03-26;8722;591;157185;46039;12.6;3.7
76;2021-03-27;4809;392;161994;46431;13.0;3.7
76;2021-03-28;1021;32;163015;46463;13.1;3.7
76;2021-03-29;5388;817;168403;47280;13.5;3.8
76;2021-03-30;6587;1055;174990;48335;14.1;3.9
76;2021-03-31;6462;1256;181452;49591;14.6;4.0
76;2021-04-01;6784;2012;188236;51603;15.1;4.1
76;2021-04-02;6485;2677;194721;54280;15.7;4.4
76;2021-04-03;2442;1077;197163;55357;15.9;4.5
76;2021-04-04;265;10;197428;55367;15.9;4.5
76;2021-04-05;869;377;198297;55744;15.9;4.5
76;2021-04-06;3556;2780;201853;58524;16.2;4.7
76;2021-04-07;4415;2392;206268;60916;16.6;4.9
76;2021-04-08;5841;2776;212109;63692;17.1;5.1
76;2021-04-09;8803;3070;220912;66762;17.8;5.4
76;2021-04-10;4876;1425;225788;68187;18.2;5.5
76;2021-04-11;814;535;226602;68722;18.2;5.5
76;2021-04-12;4726;2846;231328;71568;18.6;5.8
76;2021-04-13;5925;2854;237253;74422;19.1;6.0
76;2021-04-14;4802;3126;242055;77548;19.5;6.2
76;2021-04-15;5562;3352;247617;80900;19.9;6.5
76;2021-04-16;7355;3440;254972;84340;20.5;6.8
76;2021-04-17;4387;1430;259359;85770;20.9;6.9
76;2021-04-18;339;141;259698;85911;20.9;6.9
76;2021-04-19;3478;3768;263176;89679;21.2;7.2
76;2021-04-20;4344;4276;267520;93955;21.5;7.6
76;2021-04-21;4192;4680;271712;98635;21.8;7.9
76;2021-04-22;4564;5435;276276;104070;22.2;8.4
76;2021-04-23;5444;5969;281720;110039;22.7;8.8
76;2021-04-24;4165;2190;285885;112229;23.0;9.0
76;2021-04-25;894;268;286779;112497;23.1;9.0
76;2021-04-26;4484;4461;291263;116958;23.4;9.4
76;2021-04-27;5000;4982;296263;121940;23.8;9.8
76;2021-04-28;5348;4144;301611;126084;24.2;10.1
76;2021-04-29;6926;4143;308537;130227;24.8;10.5
76;2021-04-30;8219;4606;316756;134833;25.5;10.8
76;2021-05-01;4827;1013;321583;135846;25.9;10.9
76;2021-05-02;1842;265;323425;136111;26.0;10.9
76;2021-05-03;4703;3297;328128;139408;26.4;11.2
76;2021-05-04;4821;4535;332949;143943;26.8;11.6
76;2021-05-05;4783;5167;337732;149110;27.2;12.0
76;2021-05-06;5923;5565;343655;154675;27.6;12.4
76;2021-05-07;6137;6738;349792;161413;28.1;13.0
76;2021-05-08;5056;909;354848;162322;28.5;13.1
76;2021-05-09;2541;235;357389;162557;28.7;13.1
76;2021-05-10;4947;5060;362336;167617;29.1;13.5
76;2021-05-11;6519;5674;368855;173291;29.7;13.9
76;2021-05-12;6263;5081;375118;178372;30.2;14.3
76;2021-05-13;8842;1284;383960;179656;30.9;14.4
76;2021-05-14;10415;4659;394375;184315;31.7;14.8
76;2021-05-15;9119;2457;403494;186772;32.4;15.0
76;2021-05-16;6236;479;409730;187251;32.9;15.1
76;2021-05-17;7226;3272;416956;190523;33.5;15.3
76;2021-05-18;8304;2815;425260;193338;34.2;15.5
76;2021-05-19;8402;3200;433662;196538;34.9;15.8
76;2021-05-20;9650;3425;443312;199963;35.6;16.1
76;2021-05-21;8369;4087;451681;204050;36.3;16.4
76;2021-05-22;7163;2358;458844;206408;36.9;16.6
76;2021-05-23;6388;416;465232;206824;37.4;16.6
76;2021-05-24;6864;1524;472096;208348;38.0;16.8
76;2021-05-25;8024;4084;480120;212432;38.6;17.1
76;2021-05-26;7571;3608;487691;216040;39.2;17.4
76;2021-05-27;8340;4694;496031;220734;39.9;17.7
76;2021-05-28;8231;6537;504262;227271;40.5;18.3
76;2021-05-29;6225;3511;510487;230782;41.0;18.6
76;2021-05-30;3149;431;513636;231213;41.3;18.6
76;2021-05-31;8166;3951;521802;235164;42.0;18.9
76;2021-06-01;9209;5018;531011;240182;42.7;19.3
76;2021-06-02;7929;4442;538940;244624;43.3;19.7
76;2021-06-03;9540;5392;548480;250016;44.1;20.1
76;2021-06-04;9240;6663;557720;256679;44.8;20.6
76;2021-06-05;6285;3800;564005;260479;45.3;20.9
76;2021-06-06;2556;650;566561;261129;45.6;21.0
76;2021-06-07;6978;5445;573539;266574;46.1;21.4
76;2021-06-08;8661;6266;582200;272840;46.8;21.9
76;2021-06-09;7210;6072;589410;278912;47.4;22.4
76;2021-06-10;8000;6557;597410;285469;48.0;23.0
76;2021-06-11;7575;8229;604985;293698;48.6;23.6
76;2021-06-12;7166;5876;612151;299574;49.2;24.1
76;2021-06-13;2962;1295;615113;300869;49.5;24.2
76;2021-06-14;6486;6719;621599;307588;50.0;24.7
76;2021-06-15;6300;7471;627899;315059;50.5;25.3
76;2021-06-16;6651;7483;634550;322542;51.0;25.9
76;2021-06-17;7011;7751;641561;330293;51.6;26.6
76;2021-06-18;7687;9225;649248;339518;52.2;27.3
76;2021-06-19;5987;6256;655235;345774;52.7;27.8
76;2021-06-20;2809;1818;658044;347592;52.9;27.9
76;2021-06-21;5589;8176;663633;355768;53.4;28.6
76;2021-06-22;4923;9866;668556;365634;53.8;29.4
76;2021-06-23;4727;9433;673283;375067;54.1;30.2
76;2021-06-24;4796;9913;678079;384980;54.5;31.0
76;2021-06-25;5219;11579;683298;396559;54.9;31.9
76;2021-06-26;3454;7874;686752;404433;55.2;32.5
76;2021-06-27;1367;5162;688119;409595;55.3;32.9
76;2021-06-28;3612;9947;691731;419542;55.6;33.7
76;2021-06-29;3873;10219;695604;429761;55.9;34.6
76;2021-06-30;4267;9836;699871;439597;56.3;35.3
76;2021-07-01;4596;9906;704467;449503;56.6;36.1
76;2021-07-02;4368;12005;708835;461508;57.0;37.1
76;2021-07-03;3584;8447;712419;469955;57.3;37.8
76;2021-07-04;1487;5305;713906;475260;57.4;38.2
76;2021-07-05;3956;9330;717862;484590;57.7;39.0
76;2021-07-06;4055;10073;721917;494663;58.0;39.8
76;2021-07-07;4011;9322;725928;503985;58.4;40.5
76;2021-07-08;4465;9457;730393;513442;58.7;41.3
76;2021-07-09;4364;12409;734757;525851;59.1;42.3
76;2021-07-10;3138;8548;737895;534399;59.3;43.0
76;2021-07-11;1777;2821;739672;537220;59.5;43.2
76;2021-07-12;3155;11148;742827;548368;59.7;44.1
76;2021-07-13;4934;12261;747761;560629;60.1;45.1
76;2021-07-14;4803;5547;752564;566176;60.5;45.5
76;2021-07-15;5911;11786;758475;577962;61.0;46.5
76;2021-07-16;6720;12008;765195;589970;61.5;47.4
76;2021-07-17;5277;8708;770472;598678;61.9;48.1
76;2021-07-18;2257;3357;772729;602035;62.1;48.4
76;2021-07-19;5160;11147;777889;613182;62.5;49.3
76;2021-07-20;6276;11617;784165;624799;63.0;50.2
76;2021-07-21;6342;10565;790507;635364;63.6;51.1
76;2021-07-22;8240;9651;798747;645015;64.2;51.9
76;2021-07-23;7643;11998;806390;657013;64.8;52.8
76;2021-07-24;4992;7716;811382;664729;65.2;53.4
76;2021-07-25;2873;3139;814255;667868;65.5;53.7
76;2021-07-26;5433;10144;819688;678012;65.9;54.5
76;2021-07-27;8337;9551;828025;687563;66.6;55.3
76;2021-07-28;8270;7824;836295;695387;67.2;55.9
76;2021-07-29;9589;6991;845884;702378;68.0;56.5
76;2021-07-30;8012;7847;853896;710225;68.7;57.1
76;2021-07-31;6614;5333;860510;715558;69.2;57.5
76;2021-08-01;3863;2086;864373;717644;69.5;57.7
76;2021-08-02;6562;7099;870935;724743;70.0;58.3
76;2021-08-03;7972;6359;878907;731102;70.7;58.8
76;2021-08-04;7258;5841;886165;736943;71.2;59.2
76;2021-08-05;8099;5727;894264;742670;71.9;59.7
76;2021-08-06;6810;6875;901074;749545;72.4;60.3
76;2021-08-07;4792;4384;905866;753929;72.8;60.6
76;2021-08-08;2409;2157;908275;756086;73.0;60.8
76;2021-08-09;5638;6738;913913;762824;73.5;61.3
76;2021-08-10;6351;6555;920264;769379;74.0;61.9
76;2021-08-11;6452;5495;926716;774874;74.5;62.3
76;2021-08-12;6045;6061;932761;780935;75.0;62.8
76;2021-08-13;5058;6207;937819;787142;75.4;63.3
76;2021-08-14;3839;4599;941658;791741;75.7;63.7
76;2021-08-15;1578;2357;943236;794098;75.8;63.8
76;2021-08-16;3666;6719;946902;800817;76.1;64.4
76;2021-08-17;3919;6947;950821;807764;76.4;64.9
76;2021-08-18;3747;6737;954568;814501;76.7;65.5
76;2021-08-19;3390;7171;957958;821672;77.0;66.1
76;2021-08-20;3434;7831;961392;829503;77.3;66.7
76;2021-08-21;1823;4220;963215;833723;77.4;67.0
76;2021-08-22;871;3295;964086;837018;77.5;67.3
76;2021-08-23;2624;7760;966710;844778;77.7;67.9
76;2021-08-24;2825;7591;969535;852369;78.0;68.5
76;2021-08-25;2629;7079;972164;859448;78.2;69.1
76;2021-08-26;2075;5800;974239;865248;78.3;69.6
76;2021-08-27;2697;7951;976936;873199;78.5;70.2
76;2021-08-28;2137;6063;979073;879262;78.7;70.7
76;2021-08-29;698;3013;979771;882275;78.8;70.9
76;2021-08-30;2167;7447;981938;889722;78.9;71.5
76;2021-08-31;1944;7336;983882;897058;79.1;72.1
76;2021-09-01;1729;6892;985611;903950;79.2;72.7
76;2021-09-02;1306;4994;986917;908944;79.3;73.1
76;2021-09-03;1593;7210;988510;916154;79.5;73.7
76;2021-09-04;1617;6345;990127;922499;79.6;74.2
76;2021-09-05;636;1948;990763;924447;79.7;74.3
76;2021-09-06;1345;5067;992108;929514;79.8;74.7
76;2021-09-07;1165;4405;993273;933919;79.9;75.1
76;2021-09-08;1277;5081;994550;939000;80.0;75.5
76;2021-09-09;1092;3579;995642;942579;80.0;75.8
76;2021-09-10;1701;4838;997343;947417;80.2;76.2
76;2021-09-11;1167;3608;998510;951025;80.3;76.5
76;2021-09-12;286;893;998796;951918;80.3;76.5
76;2021-09-13;827;3186;999623;955104;80.4;76.8
76;2021-09-14;1376;3681;1000999;958785;80.5;77.1
76;2021-09-15;1172;3269;1002171;962054;80.6;77.3
76;2021-09-16;1268;1954;1003439;964008;80.7;77.5
76;2021-09-17;1403;2897;1004842;966905;80.8;77.7
76;2021-09-18;733;2510;1005575;969415;80.8;77.9
76;2021-09-19;195;777;1005770;970192;80.9;78.0
76;2021-09-20;841;1810;1006611;972002;80.9;78.1
76;2021-09-21;765;1596;1007376;973598;81.0;78.3
76;2021-09-22;675;2297;1008051;975895;81.0;78.5
76;2021-09-23;754;1169;1008805;977064;81.1;78.6
76;2021-09-24;1060;2042;1009865;979106;81.2;78.7
76;2021-09-25;574;2130;1010439;981236;81.2;78.9
76;2021-09-26;125;416;1010564;981652;81.2;78.9
76;2021-09-27;627;1347;1011191;982999;81.3;79.0
76;2021-09-28;505;1124;1011696;984123;81.3;79.1
76;2021-09-29;786;1588;1012482;985711;81.4;79.3
76;2021-09-30;423;881;1012905;986592;81.4;79.3
76;2021-10-01;856;1700;1013761;988292;81.5;79.5
76;2021-10-02;585;1306;1014346;989598;81.6;79.6
76;2021-10-03;129;386;1014475;989984;81.6;79.6
76;2021-10-04;596;1139;1015071;991123;81.6;79.7
76;2021-10-05;482;1019;1015553;992142;81.7;79.8
76;2021-10-06;455;897;1016008;993039;81.7;79.8
77;2020-12-27;1;0;1;0;0.0;0.0
77;2020-12-28;2;0;3;0;0.0;0.0
77;2020-12-29;0;0;3;0;0.0;0.0
77;2020-12-30;0;0;3;0;0.0;0.0
77;2020-12-31;0;0;3;0;0.0;0.0
77;2021-01-01;4;0;7;0;0.0;0.0
77;2021-01-02;2;0;9;0;0.0;0.0
77;2021-01-03;0;0;9;0;0.0;0.0
77;2021-01-04;7;0;16;0;0.0;0.0
77;2021-01-05;199;0;215;0;0.0;0.0
77;2021-01-06;237;2;452;2;0.0;0.0
77;2021-01-07;521;4;973;6;0.1;0.0
77;2021-01-08;621;0;1594;6;0.1;0.0
77;2021-01-09;273;1;1867;7;0.1;0.0
77;2021-01-10;235;2;2102;9;0.1;0.0
77;2021-01-11;782;3;2884;12;0.2;0.0
77;2021-01-12;884;1;3768;13;0.3;0.0
77;2021-01-13;941;1;4709;14;0.3;0.0
77;2021-01-14;849;7;5558;21;0.4;0.0
77;2021-01-15;859;10;6417;31;0.5;0.0
77;2021-01-16;168;1;6585;32;0.5;0.0
77;2021-01-17;132;2;6717;34;0.5;0.0
77;2021-01-18;1196;4;7913;38;0.6;0.0
77;2021-01-19;1722;13;9635;51;0.7;0.0
77;2021-01-20;2541;9;12176;60;0.9;0.0
77;2021-01-21;2062;25;14238;85;1.0;0.0
77;2021-01-22;1148;7;15386;92;1.1;0.0
77;2021-01-23;350;0;15736;92;1.1;0.0
77;2021-01-24;45;0;15781;92;1.1;0.0
77;2021-01-25;940;22;16721;114;1.2;0.0
77;2021-01-26;1715;24;18436;138;1.3;0.0
77;2021-01-27;1364;23;19800;161;1.4;0.0
77;2021-01-28;1699;89;21499;250;1.5;0.0
77;2021-01-29;1289;139;22788;389;1.6;0.0
77;2021-01-30;211;2;22999;391;1.6;0.0
77;2021-01-31;1;0;23000;391;1.6;0.0
77;2021-02-01;570;191;23570;582;1.7;0.0
77;2021-02-02;871;243;24441;825;1.7;0.1
77;2021-02-03;795;491;25236;1316;1.8;0.1
77;2021-02-04;789;758;26025;2074;1.8;0.1
77;2021-02-05;857;765;26882;2839;1.9;0.2
77;2021-02-06;165;95;27047;2934;1.9;0.2
77;2021-02-07;17;87;27064;3021;1.9;0.2
77;2021-02-08;498;826;27562;3847;1.9;0.3
77;2021-02-09;590;1351;28152;5198;2.0;0.4
77;2021-02-10;1030;1673;29182;6871;2.0;0.5
77;2021-02-11;1060;1504;30242;8375;2.1;0.6
77;2021-02-12;1098;1036;31340;9411;2.2;0.7
77;2021-02-13;189;167;31529;9578;2.2;0.7
77;2021-02-14;12;56;31541;9634;2.2;0.7
77;2021-02-15;555;723;32096;10357;2.3;0.7
77;2021-02-16;598;1176;32694;11533;2.3;0.8
77;2021-02-17;515;961;33209;12494;2.3;0.9
77;2021-02-18;839;1344;34048;13838;2.4;1.0
77;2021-02-19;777;904;34825;14742;2.4;1.0
77;2021-02-20;55;131;34880;14873;2.5;1.0
77;2021-02-21;7;31;34887;14904;2.5;1.0
77;2021-02-22;303;540;35190;15444;2.5;1.1
77;2021-02-23;360;817;35550;16261;2.5;1.1
77;2021-02-24;513;657;36063;16918;2.5;1.2
77;2021-02-25;794;737;36857;17655;2.6;1.2
77;2021-02-26;840;661;37697;18316;2.6;1.3
77;2021-02-27;459;119;38156;18435;2.7;1.3
77;2021-02-28;33;5;38189;18440;2.7;1.3
77;2021-03-01;679;575;38868;19015;2.7;1.3
77;2021-03-02;1091;871;39959;19886;2.8;1.4
77;2021-03-03;1958;1039;41917;20925;2.9;1.5
77;2021-03-04;2795;995;44712;21920;3.1;1.5
77;2021-03-05;3374;906;48086;22826;3.4;1.6
77;2021-03-06;4827;248;52913;23074;3.7;1.6
77;2021-03-07;3195;111;56108;23185;3.9;1.6
77;2021-03-08;1230;461;57338;23646;4.0;1.7
77;2021-03-09;2508;569;59846;24215;4.2;1.7
77;2021-03-10;2397;529;62243;24744;4.4;1.7
77;2021-03-11;3502;748;65745;25492;4.6;1.8
77;2021-03-12;3890;655;69635;26147;4.9;1.8
77;2021-03-13;4478;199;74113;26346;5.2;1.9
77;2021-03-14;2153;111;76266;26457;5.4;1.9
77;2021-03-15;2511;269;78777;26726;5.5;1.9
77;2021-03-16;2445;371;81222;27097;5.7;1.9
77;2021-03-17;2554;418;83776;27515;5.9;1.9
77;2021-03-18;3011;387;86787;27902;6.1;2.0
77;2021-03-19;3358;427;90145;28329;6.3;2.0
77;2021-03-20;1967;77;92112;28406;6.5;2.0
77;2021-03-21;243;14;92355;28420;6.5;2.0
77;2021-03-22;3019;393;95374;28813;6.7;2.0
77;2021-03-23;4520;522;99894;29335;7.0;2.1
77;2021-03-24;4156;612;104050;29947;7.3;2.1
77;2021-03-25;5907;400;109957;30347;7.7;2.1
77;2021-03-26;6267;450;116224;30797;8.2;2.2
77;2021-03-27;3323;123;119547;30920;8.4;2.2
77;2021-03-28;1730;49;121277;30969;8.5;2.2
77;2021-03-29;2654;684;123931;31653;8.7;2.2
77;2021-03-30;3995;1179;127926;32832;9.0;2.3
77;2021-03-31;3756;1218;131682;34050;9.2;2.4
77;2021-04-01;4142;1797;135824;35847;9.5;2.5
77;2021-04-02;3992;2008;139816;37855;9.8;2.7
77;2021-04-03;1743;2271;141559;40126;9.9;2.8
77;2021-04-04;420;1424;141979;41550;10.0;2.9
77;2021-04-05;161;163;142140;41713;10.0;2.9
77;2021-04-06;2723;1923;144863;43636;10.2;3.1
77;2021-04-07;3320;2085;148183;45721;10.4;3.2
77;2021-04-08;4532;2363;152715;48084;10.7;3.4
77;2021-04-09;4854;2086;157569;50170;11.1;3.5
77;2021-04-10;3074;2750;160643;52920;11.3;3.7
77;2021-04-11;586;717;161229;53637;11.3;3.8
77;2021-04-12;2230;1820;163459;55457;11.5;3.9
77;2021-04-13;3359;2634;166818;58091;11.7;4.1
77;2021-04-14;2519;2651;169337;60742;11.9;4.3
77;2021-04-15;3319;3114;172656;63856;12.1;4.5
77;2021-04-16;3575;2718;176231;66574;12.4;4.7
77;2021-04-17;1386;477;177617;67051;12.5;4.7
77;2021-04-18;150;11;177767;67062;12.5;4.7
77;2021-04-19;2083;2512;179850;69574;12.6;4.9
77;2021-04-20;2572;3379;182422;72953;12.8;5.1
77;2021-04-21;2194;3472;184616;76425;13.0;5.4
77;2021-04-22;3002;3855;187618;80280;13.2;5.6
77;2021-04-23;3531;3634;191149;83914;13.4;5.9
77;2021-04-24;4899;2498;196048;86412;13.8;6.1
77;2021-04-25;4078;1239;200126;87651;14.1;6.2
77;2021-04-26;3224;2040;203350;89691;14.3;6.3
77;2021-04-27;3996;2506;207346;92197;14.6;6.5
77;2021-04-28;4067;2606;211413;94803;14.9;6.7
77;2021-04-29;4482;3063;215895;97866;15.2;6.9
77;2021-04-30;4911;3328;220806;101194;15.5;7.1
77;2021-05-01;2466;593;223272;101787;15.7;7.1
77;2021-05-02;3141;276;226413;102063;15.9;7.2
77;2021-05-03;5991;2070;232404;104133;16.3;7.3
77;2021-05-04;6437;2990;238841;107123;16.8;7.5
77;2021-05-05;6018;3022;244859;110145;17.2;7.7
77;2021-05-06;6886;3590;251745;113735;17.7;8.0
77;2021-05-07;8204;3257;259949;116992;18.3;8.2
77;2021-05-08;5718;810;265667;117802;18.7;8.3
77;2021-05-09;4904;482;270571;118284;19.0;8.3
77;2021-05-10;8087;2327;278658;120611;19.6;8.5
77;2021-05-11;9577;2912;288235;123523;20.2;8.7
77;2021-05-12;8977;2277;297212;125800;20.9;8.8
77;2021-05-13;9302;879;306514;126679;21.5;8.9
77;2021-05-14;10437;1668;316951;128347;22.3;9.0
77;2021-05-15;8991;1247;325942;129594;22.9;9.1
77;2021-05-16;5152;470;331094;130064;23.3;9.1
77;2021-05-17;10371;1477;341465;131541;24.0;9.2
77;2021-05-18;11786;1803;353251;133344;24.8;9.4
77;2021-05-19;10918;1600;364169;134944;25.6;9.5
77;2021-05-20;12215;2155;376384;137099;26.4;9.6
77;2021-05-21;11652;2695;388036;139794;27.3;9.8
77;2021-05-22;9817;1737;397853;141531;27.9;9.9
77;2021-05-23;6978;815;404831;142346;28.4;10.0
77;2021-05-24;6762;778;411593;143124;28.9;10.1
77;2021-05-25;8315;2817;419908;145941;29.5;10.3
77;2021-05-26;7561;2978;427469;148919;30.0;10.5
77;2021-05-27;7552;3968;435021;152887;30.6;10.7
77;2021-05-28;7633;3996;442654;156883;31.1;11.0
77;2021-05-29;7353;2319;450007;159202;31.6;11.2
77;2021-05-30;4355;891;454362;160093;31.9;11.2
77;2021-05-31;8382;3833;462744;163926;32.5;11.5
77;2021-06-01;9645;4373;472389;168299;33.2;11.8
77;2021-06-02;9005;3929;481394;172228;33.8;12.1
77;2021-06-03;9001;5258;490395;177486;34.4;12.5
77;2021-06-04;9114;5491;499509;182977;35.1;12.9
77;2021-06-05;6660;4982;506169;187959;35.6;13.2
77;2021-06-06;4909;3210;511078;191169;35.9;13.4
77;2021-06-07;6421;4535;517499;195704;36.4;13.7
77;2021-06-08;5726;5223;523225;200927;36.8;14.1
77;2021-06-09;5059;4956;528284;205883;37.1;14.5
77;2021-06-10;5014;5455;533298;211338;37.5;14.8
77;2021-06-11;5752;6025;539050;217363;37.9;15.3
77;2021-06-12;6543;4752;545593;222115;38.3;15.6
77;2021-06-13;3507;3053;549100;225168;38.6;15.8
77;2021-06-14;3218;7932;552318;233100;38.8;16.4
77;2021-06-15;4128;8477;556446;241577;39.1;17.0
77;2021-06-16;4803;8377;561249;249954;39.4;17.6
77;2021-06-17;4467;9022;565716;258976;39.7;18.2
77;2021-06-18;4364;9786;570080;268762;40.0;18.9
77;2021-06-19;5306;6931;575386;275693;40.4;19.4
77;2021-06-20;2096;3801;577482;279494;40.6;19.6
77;2021-06-21;3227;9579;580709;289073;40.8;20.3
77;2021-06-22;3665;11371;584374;300444;41.0;21.1
77;2021-06-23;3443;10050;587817;310494;41.3;21.8
77;2021-06-24;3359;10911;591176;321405;41.5;22.6
77;2021-06-25;3623;10799;594799;332204;41.8;23.3
77;2021-06-26;4085;10070;598884;342274;42.1;24.0
77;2021-06-27;2123;6428;601007;348702;42.2;24.5
77;2021-06-28;2797;10831;603804;359533;42.4;25.3
77;2021-06-29;3415;12524;607219;372057;42.7;26.1
77;2021-06-30;3291;11450;610510;383507;42.9;26.9
77;2021-07-01;3296;11649;613806;395156;43.1;27.8
77;2021-07-02;3464;12254;617270;407410;43.4;28.6
77;2021-07-03;3182;10801;620452;418211;43.6;29.4
77;2021-07-04;1996;6490;622448;424701;43.7;29.8
77;2021-07-05;3584;9541;626032;434242;44.0;30.5
77;2021-07-06;3736;9525;629768;443767;44.2;31.2
77;2021-07-07;4051;8950;633819;452717;44.5;31.8
77;2021-07-08;3934;8760;637753;461477;44.8;32.4
77;2021-07-09;4712;10340;642465;471817;45.1;33.1
77;2021-07-10;4043;9841;646508;481658;45.4;33.8
77;2021-07-11;3090;5093;649598;486751;45.6;34.2
77;2021-07-12;3285;10870;652883;497621;45.9;35.0
77;2021-07-13;6161;12036;659044;509657;46.3;35.8
77;2021-07-14;3602;6447;662646;516104;46.5;36.3
77;2021-07-15;7189;11973;669835;528077;47.1;37.1
77;2021-07-16;7824;9891;677659;537968;47.6;37.8
77;2021-07-17;5792;9464;683451;547432;48.0;38.5
77;2021-07-18;4137;5330;687588;552762;48.3;38.8
77;2021-07-19;7516;8955;695104;561717;48.8;39.5
77;2021-07-20;9667;8042;704771;569759;49.5;40.0
77;2021-07-21;9524;7482;714295;577241;50.2;40.5
77;2021-07-22;10560;7552;724855;584793;50.9;41.1
77;2021-07-23;9877;8207;734732;593000;51.6;41.7
77;2021-07-24;7215;7877;741947;600877;52.1;42.2
77;2021-07-25;5898;4037;747845;604914;52.5;42.5
77;2021-07-26;9210;5968;757055;610882;53.2;42.9
77;2021-07-27;10953;6047;768008;616929;53.9;43.3
77;2021-07-28;9491;6428;777499;623357;54.6;43.8
77;2021-07-29;9538;5513;787037;628870;55.3;44.2
77;2021-07-30;9744;6368;796781;635238;56.0;44.6
77;2021-07-31;7264;6632;804045;641870;56.5;45.1
77;2021-08-01;2953;1216;806998;643086;56.7;45.2
77;2021-08-02;7134;5733;814132;648819;57.2;45.6
77;2021-08-03;5855;4526;819987;653345;57.6;45.9
77;2021-08-04;4740;4388;824727;657733;57.9;46.2
77;2021-08-05;3260;2973;827987;660706;58.2;46.4
77;2021-08-06;5981;5263;833968;665969;58.6;46.8
77;2021-08-07;5296;6793;839264;672762;59.0;47.3
77;2021-08-08;1976;1863;841240;674625;59.1;47.4
77;2021-08-09;5091;6583;846331;681208;59.4;47.9
77;2021-08-10;2713;3581;849044;684789;59.6;48.1
77;2021-08-11;3143;6241;852187;691030;59.9;48.5
77;2021-08-12;2281;3576;854468;694606;60.0;48.8
77;2021-08-13;2736;4896;857204;699502;60.2;49.1
77;2021-08-14;2958;7331;860162;706833;60.4;49.7
77;2021-08-15;789;773;860951;707606;60.5;49.7
77;2021-08-16;2478;6986;863429;714592;60.7;50.2
77;2021-08-17;2896;7215;866325;721807;60.9;50.7
77;2021-08-18;2685;6563;869010;728370;61.0;51.2
77;2021-08-19;2653;5105;871663;733475;61.2;51.5
77;2021-08-20;2710;5686;874373;739161;61.4;51.9
77;2021-08-21;2716;7339;877089;746500;61.6;52.4
77;2021-08-22;1735;5344;878824;751844;61.7;52.8
77;2021-08-23;2513;9618;881337;761462;61.9;53.5
77;2021-08-24;3068;9244;884405;770706;62.1;54.1
77;2021-08-25;2564;6539;886969;777245;62.3;54.6
77;2021-08-26;2559;6255;889528;783500;62.5;55.0
77;2021-08-27;2781;6996;892309;790496;62.7;55.5
77;2021-08-28;1974;7250;894283;797746;62.8;56.0
77;2021-08-29;1483;5150;895766;802896;62.9;56.4
77;2021-08-30;2526;8152;898292;811048;63.1;57.0
77;2021-08-31;2851;5736;901143;816784;63.3;57.4
77;2021-09-01;2260;3853;903403;820637;63.5;57.6
77;2021-09-02;1611;3148;905014;823785;63.6;57.9
77;2021-09-03;2136;4562;907150;828347;63.7;58.2
77;2021-09-04;2420;5778;909570;834125;63.9;58.6
77;2021-09-05;901;1558;910471;835683;64.0;58.7
77;2021-09-06;1063;2318;911534;838001;64.0;58.9
77;2021-09-07;844;2291;912378;840292;64.1;59.0
77;2021-09-08;1715;3581;914093;843873;64.2;59.3
77;2021-09-09;974;2211;915067;846084;64.3;59.4
77;2021-09-10;1194;2567;916261;848651;64.4;59.6
77;2021-09-11;2044;5708;918305;854359;64.5;60.0
77;2021-09-12;521;1425;918826;855784;64.5;60.1
77;2021-09-13;881;2313;919707;858097;64.6;60.3
77;2021-09-14;1022;2155;920729;860252;64.7;60.4
77;2021-09-15;1175;2527;921904;862779;64.8;60.6
77;2021-09-16;954;1499;922858;864278;64.8;60.7
77;2021-09-17;1151;2020;924009;866298;64.9;60.9
77;2021-09-18;1296;3580;925305;869878;65.0;61.1
77;2021-09-19;232;1182;925537;871060;65.0;61.2
77;2021-09-20;822;1625;926359;872685;65.1;61.3
77;2021-09-21;794;1501;927153;874186;65.1;61.4
77;2021-09-22;751;2483;927904;876669;65.2;61.6
77;2021-09-23;568;1508;928472;878177;65.2;61.7
77;2021-09-24;806;1942;929278;880119;65.3;61.8
77;2021-09-25;1002;3956;930280;884075;65.3;62.1
77;2021-09-26;205;758;930485;884833;65.4;62.2
77;2021-09-27;646;1309;931131;886142;65.4;62.2
77;2021-09-28;772;844;931903;886986;65.5;62.3
77;2021-09-29;936;1975;932839;888961;65.5;62.4
77;2021-09-30;586;935;933425;889896;65.6;62.5
77;2021-10-01;623;1022;934048;890918;65.6;62.6
77;2021-10-02;948;2099;934996;893017;65.7;62.7
77;2021-10-03;128;470;935124;893487;65.7;62.8
77;2021-10-04;412;719;935536;894206;65.7;62.8
77;2021-10-05;326;729;935862;894935;65.7;62.9
77;2021-10-06;534;1284;936396;896219;65.8;63.0
78;2020-12-27;2;0;2;0;0.0;0.0
78;2020-12-28;1;1;3;1;0.0;0.0
78;2020-12-29;0;0;3;1;0.0;0.0
78;2020-12-30;1;0;4;1;0.0;0.0
78;2020-12-31;15;0;19;1;0.0;0.0
78;2021-01-01;1;0;20;1;0.0;0.0
78;2021-01-02;1;0;21;1;0.0;0.0
78;2021-01-03;3;0;24;1;0.0;0.0
78;2021-01-04;145;3;169;4;0.0;0.0
78;2021-01-05;175;1;344;5;0.0;0.0
78;2021-01-06;208;3;552;8;0.0;0.0
78;2021-01-07;470;2;1022;10;0.1;0.0
78;2021-01-08;651;3;1673;13;0.1;0.0
78;2021-01-09;22;0;1695;13;0.1;0.0
78;2021-01-10;2;0;1697;13;0.1;0.0
78;2021-01-11;791;3;2488;16;0.2;0.0
78;2021-01-12;945;5;3433;21;0.2;0.0
78;2021-01-13;741;8;4174;29;0.3;0.0
78;2021-01-14;812;9;4986;38;0.3;0.0
78;2021-01-15;848;10;5834;48;0.4;0.0
78;2021-01-16;32;0;5866;48;0.4;0.0
78;2021-01-17;0;0;5866;48;0.4;0.0
78;2021-01-18;1384;21;7250;69;0.5;0.0
78;2021-01-19;1841;28;9091;97;0.6;0.0
78;2021-01-20;1651;15;10742;112;0.7;0.0
78;2021-01-21;3259;16;14001;128;1.0;0.0
78;2021-01-22;2216;17;16217;145;1.1;0.0
78;2021-01-23;280;0;16497;145;1.1;0.0
78;2021-01-24;5;0;16502;145;1.1;0.0
78;2021-01-25;957;26;17459;171;1.2;0.0
78;2021-01-26;1560;19;19019;190;1.3;0.0
78;2021-01-27;2063;38;21082;228;1.5;0.0
78;2021-01-28;2439;89;23521;317;1.6;0.0
78;2021-01-29;1492;57;25013;374;1.7;0.0
78;2021-01-30;210;2;25223;376;1.7;0.0
78;2021-01-31;3;0;25226;376;1.7;0.0
78;2021-02-01;788;210;26014;586;1.8;0.0
78;2021-02-02;967;318;26981;904;1.9;0.1
78;2021-02-03;975;217;27956;1121;1.9;0.1
78;2021-02-04;1117;414;29073;1535;2.0;0.1
78;2021-02-05;1191;447;30264;1982;2.1;0.1
78;2021-02-06;200;44;30464;2026;2.1;0.1
78;2021-02-07;139;13;30603;2039;2.1;0.1
78;2021-02-08;760;538;31363;2577;2.2;0.2
78;2021-02-09;1121;860;32484;3437;2.2;0.2
78;2021-02-10;1245;1067;33729;4504;2.3;0.3
78;2021-02-11;1820;1680;35549;6184;2.5;0.4
78;2021-02-12;1820;1242;37369;7426;2.6;0.5
78;2021-02-13;173;63;37542;7489;2.6;0.5
78;2021-02-14;27;23;37569;7512;2.6;0.5
78;2021-02-15;448;1131;38017;8643;2.6;0.6
78;2021-02-16;628;1298;38645;9941;2.7;0.7
78;2021-02-17;588;1926;39233;11867;2.7;0.8
78;2021-02-18;998;1911;40231;13778;2.8;1.0
78;2021-02-19;820;1441;41051;15219;2.8;1.1
78;2021-02-20;148;102;41199;15321;2.8;1.1
78;2021-02-21;0;12;41199;15333;2.8;1.1
78;2021-02-22;502;811;41701;16144;2.9;1.1
78;2021-02-23;540;895;42241;17039;2.9;1.2
78;2021-02-24;619;1031;42860;18070;3.0;1.2
78;2021-02-25;867;916;43727;18986;3.0;1.3
78;2021-02-26;1131;1016;44858;20002;3.1;1.4
78;2021-02-27;740;115;45598;20117;3.1;1.4
78;2021-02-28;68;18;45666;20135;3.2;1.4
78;2021-03-01;966;702;46632;20837;3.2;1.4
78;2021-03-02;1727;885;48359;21722;3.3;1.5
78;2021-03-03;1967;1053;50326;22775;3.5;1.6
78;2021-03-04;2952;1413;53278;24188;3.7;1.7
78;2021-03-05;3256;1470;56534;25658;3.9;1.8
78;2021-03-06;6243;285;62777;25943;4.3;1.8
78;2021-03-07;3444;104;66221;26047;4.6;1.8
78;2021-03-08;1462;669;67683;26716;4.7;1.8
78;2021-03-09;2940;832;70623;27548;4.9;1.9
78;2021-03-10;3078;1034;73701;28582;5.1;2.0
78;2021-03-11;4177;1237;77878;29819;5.4;2.1
78;2021-03-12;5371;1285;83249;31104;5.7;2.1
78;2021-03-13;4657;199;87906;31303;6.1;2.2
78;2021-03-14;1037;41;88943;31344;6.1;2.2
78;2021-03-15;3620;266;92563;31610;6.4;2.2
78;2021-03-16;2567;561;95130;32171;6.6;2.2
78;2021-03-17;2969;435;98099;32606;6.8;2.3
78;2021-03-18;3780;443;101879;33049;7.0;2.3
78;2021-03-19;5317;485;107196;33534;7.4;2.3
78;2021-03-20;2260;130;109456;33664;7.6;2.3
78;2021-03-21;167;7;109623;33671;7.6;2.3
78;2021-03-22;3530;378;113153;34049;7.8;2.4
78;2021-03-23;5231;538;118384;34587;8.2;2.4
78;2021-03-24;4892;551;123276;35138;8.5;2.4
78;2021-03-25;6940;565;130216;35703;9.0;2.5
78;2021-03-26;6944;708;137160;36411;9.5;2.5
78;2021-03-27;3746;198;140906;36609;9.7;2.5
78;2021-03-28;1918;55;142824;36664;9.9;2.5
78;2021-03-29;3863;759;146687;37423;10.1;2.6
78;2021-03-30;5526;1049;152213;38472;10.5;2.7
78;2021-03-31;5334;1288;157547;39760;10.9;2.7
78;2021-04-01;5590;2348;163137;42108;11.3;2.9
78;2021-04-02;5194;2622;168331;44730;11.6;3.1
78;2021-04-03;2198;2560;170529;47290;11.8;3.3
78;2021-04-04;174;14;170703;47304;11.8;3.3
78;2021-04-05;199;19;170902;47323;11.8;3.3
78;2021-04-06;3619;2299;174521;49622;12.0;3.4
78;2021-04-07;4357;2583;178878;52205;12.3;3.6
78;2021-04-08;5523;2665;184401;54870;12.7;3.8
78;2021-04-09;6907;2441;191308;57311;13.2;4.0
78;2021-04-10;3995;1903;195303;59214;13.5;4.1
78;2021-04-11;374;606;195677;59820;13.5;4.1
78;2021-04-12;3531;2356;199208;62176;13.8;4.3
78;2021-04-13;5461;2500;204669;64676;14.1;4.5
78;2021-04-14;4955;3382;209624;68058;14.5;4.7
78;2021-04-15;4616;3853;214240;71911;14.8;5.0
78;2021-04-16;5625;4016;219865;75927;15.2;5.2
78;2021-04-17;3610;718;223475;76645;15.4;5.3
78;2021-04-18;272;42;223747;76687;15.4;5.3
78;2021-04-19;3246;2812;226993;79499;15.7;5.5
78;2021-04-20;4709;3683;231702;83182;16.0;5.7
78;2021-04-21;4533;3502;236235;86684;16.3;6.0
78;2021-04-22;4566;4693;240801;91377;16.6;6.3
78;2021-04-23;5059;4429;245860;95806;17.0;6.6
78;2021-04-24;4865;2614;250725;98420;17.3;6.8
78;2021-04-25;3049;1732;253774;100152;17.5;6.9
78;2021-04-26;4768;3317;258542;103469;17.8;7.1
78;2021-04-27;5474;4295;264016;107764;18.2;7.4
78;2021-04-28;5649;4773;269665;112537;18.6;7.8
78;2021-04-29;6263;4055;275928;116592;19.0;8.0
78;2021-04-30;7207;4444;283135;121036;19.5;8.4
78;2021-05-01;612;254;283747;121290;19.6;8.4
78;2021-05-02;2009;164;285756;121454;19.7;8.4
78;2021-05-03;7465;1272;293221;122726;20.2;8.5
78;2021-05-04;6075;3968;299296;126694;20.7;8.7
78;2021-05-05;7296;4545;306592;131239;21.2;9.1
78;2021-05-06;6480;5163;313072;136402;21.6;9.4
78;2021-05-07;8309;5112;321381;141514;22.2;9.8
78;2021-05-08;2916;1446;324297;142960;22.4;9.9
78;2021-05-09;2820;351;327117;143311;22.6;9.9
78;2021-05-10;7344;4448;334461;147759;23.1;10.2
78;2021-05-11;8143;5405;342604;153164;23.7;10.6
78;2021-05-12;8729;3912;351333;157076;24.3;10.8
78;2021-05-13;6628;600;357961;157676;24.7;10.9
78;2021-05-14;10216;2216;368177;159892;25.4;11.0
78;2021-05-15;4934;2359;373111;162251;25.8;11.2
78;2021-05-16;3697;792;376808;163043;26.0;11.3
78;2021-05-17;8741;1348;385549;164391;26.6;11.3
78;2021-05-18;9886;1893;395435;166284;27.3;11.5
78;2021-05-19;11651;1712;407086;167996;28.1;11.6
78;2021-05-20;11596;2262;418682;170258;28.9;11.8
78;2021-05-21;12120;2618;430802;172876;29.7;11.9
78;2021-05-22;6537;1357;437339;174233;30.2;12.0
78;2021-05-23;3125;390;440464;174623;30.4;12.1
78;2021-05-24;3521;417;443985;175040;30.6;12.1
78;2021-05-25;9983;2505;453968;177545;31.3;12.3
78;2021-05-26;10159;3776;464127;181321;32.0;12.5
78;2021-05-27;10947;4638;475074;185959;32.8;12.8
78;2021-05-28;11405;6013;486479;191972;33.6;13.3
78;2021-05-29;4228;3381;490707;195353;33.9;13.5
78;2021-05-30;135;345;490842;195698;33.9;13.5
78;2021-05-31;7967;5350;498809;201048;34.4;13.9
78;2021-06-01;10022;6515;508831;207563;35.1;14.3
78;2021-06-02;8581;6195;517412;213758;35.7;14.8
78;2021-06-03;9892;6470;527304;220228;36.4;15.2
78;2021-06-04;9794;8143;537098;228371;37.1;15.8
78;2021-06-05;5519;6129;542617;234500;37.5;16.2
78;2021-06-06;2150;2009;544767;236509;37.6;16.3
78;2021-06-07;8113;6513;552880;243022;38.2;16.8
78;2021-06-08;8064;7322;560944;250344;38.7;17.3
78;2021-06-09;7327;6724;568271;257068;39.2;17.7
78;2021-06-10;7105;7097;575376;264165;39.7;18.2
78;2021-06-11;7584;8182;582960;272347;40.2;18.8
78;2021-06-12;6373;2920;589333;275267;40.7;19.0
78;2021-06-13;946;2458;590279;277725;40.7;19.2
78;2021-06-14;3415;9807;593694;287532;41.0;19.8
78;2021-06-15;5794;8283;599488;295815;41.4;20.4
78;2021-06-16;5430;8619;604918;304434;41.8;21.0
78;2021-06-17;5481;8533;610399;312967;42.1;21.6
78;2021-06-18;6103;9801;616502;322768;42.6;22.3
78;2021-06-19;5219;4817;621721;327585;42.9;22.6
78;2021-06-20;625;2838;622346;330423;43.0;22.8
78;2021-06-21;4092;9469;626438;339892;43.2;23.5
78;2021-06-22;3349;10317;629787;350209;43.5;24.2
78;2021-06-23;3839;10392;633626;360601;43.7;24.9
78;2021-06-24;3794;9970;637420;370571;44.0;25.6
78;2021-06-25;3995;13143;641415;383714;44.3;26.5
78;2021-06-26;4209;7947;645624;391661;44.6;27.0
78;2021-06-27;1041;2540;646665;394201;44.6;27.2
78;2021-06-28;3286;10899;649951;405100;44.9;28.0
78;2021-06-29;3535;11247;653486;416347;45.1;28.7
78;2021-06-30;4110;13225;657596;429572;45.4;29.7
78;2021-07-01;4106;12701;661702;442273;45.7;30.5
78;2021-07-02;4260;13935;665962;456208;46.0;31.5
78;2021-07-03;3159;8618;669121;464826;46.2;32.1
78;2021-07-04;778;1742;669899;466568;46.2;32.2
78;2021-07-05;3383;9692;673282;476260;46.5;32.9
78;2021-07-06;3525;12039;676807;488299;46.7;33.7
78;2021-07-07;3821;11605;680628;499904;47.0;34.5
78;2021-07-08;3927;11677;684555;511581;47.3;35.3
78;2021-07-09;4759;12741;689314;524322;47.6;36.2
78;2021-07-10;2626;6611;691940;530933;47.8;36.7
78;2021-07-11;748;2047;692688;532980;47.8;36.8
78;2021-07-12;3038;11742;695726;544722;48.0;37.6
78;2021-07-13;5351;11972;701077;556694;48.4;38.4
78;2021-07-14;2532;4989;703609;561683;48.6;38.8
78;2021-07-15;5662;11953;709271;573636;49.0;39.6
78;2021-07-16;7320;10783;716591;584419;49.5;40.3
78;2021-07-17;4725;4889;721316;589308;49.8;40.7
78;2021-07-18;1158;471;722474;589779;49.9;40.7
78;2021-07-19;3877;10348;726351;600127;50.1;41.4
78;2021-07-20;5616;9923;731967;610050;50.5;42.1
78;2021-07-21;5905;9858;737872;619908;50.9;42.8
78;2021-07-22;5972;9292;743844;629200;51.3;43.4
78;2021-07-23;6259;9229;750103;638429;51.8;44.1
78;2021-07-24;2937;4966;753040;643395;52.0;44.4
78;2021-07-25;987;376;754027;643771;52.1;44.4
78;2021-07-26;4868;6986;758895;650757;52.4;44.9
78;2021-07-27;7598;6914;766493;657671;52.9;45.4
78;2021-07-28;6976;5933;773469;663604;53.4;45.8
78;2021-07-29;7901;6008;781370;669612;53.9;46.2
78;2021-07-30;7740;7049;789110;676661;54.5;46.7
78;2021-07-31;2653;2732;791763;679393;54.7;46.9
78;2021-08-01;109;72;791872;679465;54.7;46.9
78;2021-08-02;2444;2129;794316;681594;54.8;47.1
78;2021-08-03;4268;4252;798584;685846;55.1;47.3
78;2021-08-04;4462;2809;803046;688655;55.4;47.5
78;2021-08-05;3885;3172;806931;691827;55.7;47.8
78;2021-08-06;3978;3713;810909;695540;56.0;48.0
78;2021-08-07;2819;3442;813728;698982;56.2;48.3
78;2021-08-08;483;343;814211;699325;56.2;48.3
78;2021-08-09;1877;1662;816088;700987;56.3;48.4
78;2021-08-10;3413;3983;819501;704970;56.6;48.7
78;2021-08-11;2982;3383;822483;708353;56.8;48.9
78;2021-08-12;2746;3534;825229;711887;57.0;49.1
78;2021-08-13;2865;3186;828094;715073;57.2;49.4
78;2021-08-14;2301;2979;830395;718052;57.3;49.6
78;2021-08-15;315;373;830710;718425;57.3;49.6
78;2021-08-16;910;2339;831620;720764;57.4;49.8
78;2021-08-17;2795;4422;834415;725186;57.6;50.1
78;2021-08-18;2471;3819;836886;729005;57.8;50.3
78;2021-08-19;2238;3583;839124;732588;57.9;50.6
78;2021-08-20;2100;4000;841224;736588;58.1;50.8
78;2021-08-21;1884;3587;843108;740175;58.2;51.1
78;2021-08-22;87;147;843195;740322;58.2;51.1
78;2021-08-23;2154;4248;845349;744570;58.4;51.4
78;2021-08-24;3630;6972;848979;751542;58.6;51.9
78;2021-08-25;3296;6593;852275;758135;58.8;52.3
78;2021-08-26;2979;7237;855254;765372;59.0;52.8
78;2021-08-27;2862;7370;858116;772742;59.2;53.3
78;2021-08-28;2441;5277;860557;778019;59.4;53.7
78;2021-08-29;368;352;860925;778371;59.4;53.7
78;2021-08-30;2859;5071;863784;783442;59.6;54.1
78;2021-08-31;3453;5828;867237;789270;59.9;54.5
78;2021-09-01;2778;5289;870015;794559;60.1;54.8
78;2021-09-02;2096;4439;872111;798998;60.2;55.2
78;2021-09-03;2257;4721;874368;803719;60.4;55.5
78;2021-09-04;2476;4251;876844;807970;60.5;55.8
78;2021-09-05;292;383;877136;808353;60.5;55.8
78;2021-09-06;1288;3005;878424;811358;60.6;56.0
78;2021-09-07;1352;3510;879776;814868;60.7;56.3
78;2021-09-08;1679;3793;881455;818661;60.8;56.5
78;2021-09-09;1079;3312;882534;821973;60.9;56.7
78;2021-09-10;1373;3469;883907;825442;61.0;57.0
78;2021-09-11;2054;4199;885961;829641;61.2;57.3
78;2021-09-12;73;165;886034;829806;61.2;57.3
78;2021-09-13;780;2570;886814;832376;61.2;57.5
78;2021-09-14;1069;3818;887883;836194;61.3;57.7
78;2021-09-15;1206;3532;889089;839726;61.4;58.0
78;2021-09-16;841;2087;889930;841813;61.4;58.1
78;2021-09-17;1177;2839;891107;844652;61.5;58.3
78;2021-09-18;1392;4071;892499;848723;61.6;58.6
78;2021-09-19;145;407;892644;849130;61.6;58.6
78;2021-09-20;669;1708;893313;850838;61.7;58.7
78;2021-09-21;820;1978;894133;852816;61.7;58.9
78;2021-09-22;955;3513;895088;856329;61.8;59.1
78;2021-09-23;883;1636;895971;857965;61.8;59.2
78;2021-09-24;1010;2384;896981;860349;61.9;59.4
78;2021-09-25;1055;3917;898036;864266;62.0;59.7
78;2021-09-26;59;155;898095;864421;62.0;59.7
78;2021-09-27;678;1502;898773;865923;62.0;59.8
78;2021-09-28;828;1496;899601;867419;62.1;59.9
78;2021-09-29;1007;2160;900608;869579;62.2;60.0
78;2021-09-30;560;927;901168;870506;62.2;60.1
78;2021-10-01;928;1822;902096;872328;62.3;60.2
78;2021-10-02;1243;2465;903339;874793;62.4;60.4
78;2021-10-03;54;70;903393;874863;62.4;60.4
78;2021-10-04;478;931;903871;875794;62.4;60.5
78;2021-10-05;420;727;904291;876521;62.4;60.5
78;2021-10-06;781;1557;905072;878078;62.5;60.6
79;2020-12-27;0;0;0;0;0.0;0.0
79;2020-12-28;4;0;4;0;0.0;0.0
79;2020-12-29;0;0;4;0;0.0;0.0
79;2020-12-30;0;0;4;0;0.0;0.0
79;2020-12-31;0;0;4;0;0.0;0.0
79;2021-01-01;0;0;4;0;0.0;0.0
79;2021-01-02;0;0;4;0;0.0;0.0
79;2021-01-03;0;0;4;0;0.0;0.0
79;2021-01-04;1;0;5;0;0.0;0.0
79;2021-01-05;0;0;5;0;0.0;0.0
79;2021-01-06;0;0;5;0;0.0;0.0
79;2021-01-07;158;0;163;0;0.0;0.0
79;2021-01-08;165;0;328;0;0.1;0.0
79;2021-01-09;100;0;428;0;0.1;0.0
79;2021-01-10;3;0;431;0;0.1;0.0
79;2021-01-11;184;1;615;1;0.2;0.0
79;2021-01-12;245;1;860;2;0.2;0.0
79;2021-01-13;258;0;1118;2;0.3;0.0
79;2021-01-14;506;8;1624;10;0.4;0.0
79;2021-01-15;618;5;2242;15;0.6;0.0
79;2021-01-16;66;0;2308;15;0.6;0.0
79;2021-01-17;0;0;2308;15;0.6;0.0
79;2021-01-18;477;2;2785;17;0.7;0.0
79;2021-01-19;1361;2;4146;19;1.1;0.0
79;2021-01-20;1678;1;5824;20;1.6;0.0
79;2021-01-21;1999;7;7823;27;2.1;0.0
79;2021-01-22;875;4;8698;31;2.3;0.0
79;2021-01-23;65;0;8763;31;2.4;0.0
79;2021-01-24;0;0;8763;31;2.4;0.0
79;2021-01-25;646;7;9409;38;2.5;0.0
79;2021-01-26;593;13;10002;51;2.7;0.0
79;2021-01-27;740;81;10742;132;2.9;0.0
79;2021-01-28;735;128;11477;260;3.1;0.1
79;2021-01-29;495;81;11972;341;3.2;0.1
79;2021-01-30;0;0;11972;341;3.2;0.1
79;2021-01-31;0;0;11972;341;3.2;0.1
79;2021-02-01;207;105;12179;446;3.3;0.1
79;2021-02-02;334;73;12513;519;3.4;0.1
79;2021-02-03;391;56;12904;575;3.5;0.2
79;2021-02-04;326;107;13230;682;3.6;0.2
79;2021-02-05;360;273;13590;955;3.6;0.3
79;2021-02-06;6;0;13596;955;3.6;0.3
79;2021-02-07;22;0;13618;955;3.7;0.3
79;2021-02-08;283;159;13901;1114;3.7;0.3
79;2021-02-09;457;744;14358;1858;3.9;0.5
79;2021-02-10;619;1148;14977;3006;4.0;0.8
79;2021-02-11;777;1192;15754;4198;4.2;1.1
79;2021-02-12;471;711;16225;4909;4.4;1.3
79;2021-02-13;53;61;16278;4970;4.4;1.3
79;2021-02-14;0;0;16278;4970;4.4;1.3
79;2021-02-15;186;426;16464;5396;4.4;1.4
79;2021-02-16;333;642;16797;6038;4.5;1.6
79;2021-02-17;248;754;17045;6792;4.6;1.8
79;2021-02-18;353;848;17398;7640;4.7;2.1
79;2021-02-19;268;507;17666;8147;4.7;2.2
79;2021-02-20;5;18;17671;8165;4.7;2.2
79;2021-02-21;1;0;17672;8165;4.7;2.2
79;2021-02-22;137;400;17809;8565;4.8;2.3
79;2021-02-23;248;498;18057;9063;4.8;2.4
79;2021-02-24;246;461;18303;9524;4.9;2.6
79;2021-02-25;520;416;18823;9940;5.1;2.7
79;2021-02-26;599;348;19422;10288;5.2;2.8
79;2021-02-27;408;7;19830;10295;5.3;2.8
79;2021-02-28;35;0;19865;10295;5.3;2.8
79;2021-03-01;89;295;19954;10590;5.4;2.8
79;2021-03-02;302;453;20256;11043;5.4;3.0
79;2021-03-03;662;482;20918;11525;5.6;3.1
79;2021-03-04;904;524;21822;12049;5.9;3.2
79;2021-03-05;1218;409;23040;12458;6.2;3.3
79;2021-03-06;611;6;23651;12464;6.3;3.3
79;2021-03-07;77;1;23728;12465;6.4;3.3
79;2021-03-08;344;279;24072;12744;6.5;3.4
79;2021-03-09;842;311;24914;13055;6.7;3.5
79;2021-03-10;1146;374;26060;13429;7.0;3.6
79;2021-03-11;1641;306;27701;13735;7.4;3.7
79;2021-03-12;1721;111;29422;13846;7.9;3.7
79;2021-03-13;1135;13;30557;13859;8.2;3.7
79;2021-03-14;50;0;30607;13859;8.2;3.7
79;2021-03-15;497;157;31104;14016;8.3;3.8
79;2021-03-16;735;146;31839;14162;8.5;3.8
79;2021-03-17;578;107;32417;14269;8.7;3.8
79;2021-03-18;553;199;32970;14468;8.8;3.9
79;2021-03-19;661;256;33631;14724;9.0;4.0
79;2021-03-20;1007;14;34638;14738;9.3;4.0
79;2021-03-21;3;0;34641;14738;9.3;4.0
79;2021-03-22;957;204;35598;14942;9.6;4.0
79;2021-03-23;1595;169;37193;15111;10.0;4.1
79;2021-03-24;1831;161;39024;15272;10.5;4.1
79;2021-03-25;2499;192;41523;15464;11.1;4.1
79;2021-03-26;2406;137;43929;15601;11.8;4.2
79;2021-03-27;768;18;44697;15619;12.0;4.2
79;2021-03-28;1;0;44698;15619;12.0;4.2
79;2021-03-29;2148;115;46846;15734;12.6;4.2
79;2021-03-30;2817;64;49663;15798;13.3;4.2
79;2021-03-31;2777;381;52440;16179;14.1;4.3
79;2021-04-01;2698;383;55138;16562;14.8;4.4
79;2021-04-02;2822;394;57960;16956;15.6;4.6
79;2021-04-03;634;53;58594;17009;15.7;4.6
79;2021-04-04;3;0;58597;17009;15.7;4.6
79;2021-04-05;381;4;58978;17013;15.8;4.6
79;2021-04-06;1792;583;60770;17596;16.3;4.7
79;2021-04-07;3112;726;63882;18322;17.1;4.9
79;2021-04-08;2632;698;66514;19020;17.9;5.1
79;2021-04-09;3737;541;70251;19561;18.9;5.2
79;2021-04-10;1466;387;71717;19948;19.2;5.4
79;2021-04-11;4;0;71721;19948;19.2;5.4
79;2021-04-12;1753;353;73474;20301;19.7;5.4
79;2021-04-13;2174;748;75648;21049;20.3;5.6
79;2021-04-14;2480;678;78128;21727;21.0;5.8
79;2021-04-15;2216;666;80344;22393;21.6;6.0
79;2021-04-16;1412;443;81756;22836;21.9;6.1
79;2021-04-17;581;353;82337;23189;22.1;6.2
79;2021-04-18;1;14;82338;23203;22.1;6.2
79;2021-04-19;1088;838;83426;24041;22.4;6.5
79;2021-04-20;1506;1229;84932;25270;22.8;6.8
79;2021-04-21;1419;1438;86351;26708;23.2;7.2
79;2021-04-22;1572;1085;87923;27793;23.6;7.5
79;2021-04-23;1316;1187;89239;28980;23.9;7.8
79;2021-04-24;653;458;89892;29438;24.1;7.9
79;2021-04-25;1;0;89893;29438;24.1;7.9
79;2021-04-26;1343;1813;91236;31251;24.5;8.4
79;2021-04-27;1898;2336;93134;33587;25.0;9.0
79;2021-04-28;1458;2865;94592;36452;25.4;9.8
79;2021-04-29;2104;2237;96696;38689;25.9;10.4
79;2021-04-30;2115;2453;98811;41142;26.5;11.0
79;2021-05-01;521;378;99332;41520;26.7;11.1
79;2021-05-02;1;11;99333;41531;26.7;11.1
79;2021-05-03;1182;1291;100515;42822;27.0;11.5
79;2021-05-04;1732;2324;102247;45146;27.4;12.1
79;2021-05-05;1694;2479;103941;47625;27.9;12.8
79;2021-05-06;2326;2222;106267;49847;28.5;13.4
79;2021-05-07;2105;2795;108372;52642;29.1;14.1
79;2021-05-08;198;506;108570;53148;29.1;14.3
79;2021-05-09;0;0;108570;53148;29.1;14.3
79;2021-05-10;1582;1785;110152;54933;29.6;14.7
79;2021-05-11;2309;1651;112461;56584;30.2;15.2
79;2021-05-12;2000;2680;114461;59264;30.7;15.9
79;2021-05-13;640;289;115101;59553;30.9;16.0
79;2021-05-14;2100;673;117201;60226;31.5;16.2
79;2021-05-15;1399;498;118600;60724;31.8;16.3
79;2021-05-16;1;22;118601;60746;31.8;16.3
79;2021-05-17;1873;1085;120474;61831;32.3;16.6
79;2021-05-18;2971;1272;123445;63103;33.1;16.9
79;2021-05-19;2898;969;126343;64072;33.9;17.2
79;2021-05-20;3106;1244;129449;65316;34.7;17.5
79;2021-05-21;2768;1066;132217;66382;35.5;17.8
79;2021-05-22;1084;261;133301;66643;35.8;17.9
79;2021-05-23;1;0;133302;66643;35.8;17.9
79;2021-05-24;161;20;133463;66663;35.8;17.9
79;2021-05-25;3198;991;136661;67654;36.7;18.2
79;2021-05-26;3312;853;139973;68507;37.6;18.4
79;2021-05-27;3589;1719;143562;70226;38.5;18.8
79;2021-05-28;3331;1815;146893;72041;39.4;19.3
79;2021-05-29;1072;446;147965;72487;39.7;19.5
79;2021-05-30;3;1;147968;72488;39.7;19.5
79;2021-05-31;2382;731;150350;73219;40.3;19.6
79;2021-06-01;3021;1568;153371;74787;41.2;20.1
79;2021-06-02;4066;1164;157437;75951;42.3;20.4
79;2021-06-03;4089;1754;161526;77705;43.3;20.9
79;2021-06-04;4141;2032;165667;79737;44.5;21.4
79;2021-06-05;2801;758;168468;80495;45.2;21.6
79;2021-06-06;696;39;169164;80534;45.4;21.6
79;2021-06-07;2805;1413;171969;81947;46.2;22.0
79;2021-06-08;2982;2069;174951;84016;47.0;22.5
79;2021-06-09;3631;1936;178582;85952;47.9;23.1
79;2021-06-10;3020;1964;181602;87916;48.7;23.6
79;2021-06-11;3767;2315;185369;90231;49.7;24.2
79;2021-06-12;1707;611;187076;90842;50.2;24.4
79;2021-06-13;213;24;187289;90866;50.3;24.4
79;2021-06-14;1247;1690;188536;92556;50.6;24.8
79;2021-06-15;1881;2358;190417;94914;51.1;25.5
79;2021-06-16;2204;2247;192621;97161;51.7;26.1
79;2021-06-17;2237;2616;194858;99777;52.3;26.8
79;2021-06-18;2413;2313;197271;102090;52.9;27.4
79;2021-06-19;1246;579;198517;102669;53.3;27.6
79;2021-06-20;3;2;198520;102671;53.3;27.6
79;2021-06-21;1233;2282;199753;104953;53.6;28.2
79;2021-06-22;1547;2870;201300;107823;54.0;28.9
79;2021-06-23;1770;2550;203070;110373;54.5;29.6
79;2021-06-24;2105;2000;205175;112373;55.1;30.2
79;2021-06-25;1488;2838;206663;115211;55.5;30.9
79;2021-06-26;870;808;207533;116019;55.7;31.1
79;2021-06-27;13;6;207546;116025;55.7;31.1
79;2021-06-28;1056;2620;208602;118645;56.0;31.8
79;2021-06-29;1473;3550;210075;122195;56.4;32.8
79;2021-06-30;1354;3447;211429;125642;56.7;33.7
79;2021-07-01;1202;3785;212631;129427;57.1;34.7
79;2021-07-02;1487;3346;214118;132773;57.5;35.6
79;2021-07-03;399;1504;214517;134277;57.6;36.0
79;2021-07-04;2;9;214519;134286;57.6;36.0
79;2021-07-05;753;2119;215272;136405;57.8;36.6
79;2021-07-06;947;3661;216219;140066;58.0;37.6
79;2021-07-07;1332;4308;217551;144374;58.4;38.7
79;2021-07-08;1107;4041;218658;148415;58.7;39.8
79;2021-07-09;836;3717;219494;152132;58.9;40.8
79;2021-07-10;514;1315;220008;153447;59.0;41.2
79;2021-07-11;3;12;220011;153459;59.0;41.2
79;2021-07-12;545;3695;220556;157154;59.2;42.2
79;2021-07-13;999;5185;221555;162339;59.5;43.6
79;2021-07-14;134;874;221689;163213;59.5;43.8
79;2021-07-15;1235;4682;222924;167895;59.8;45.1
79;2021-07-16;1333;4363;224257;172258;60.2;46.2
79;2021-07-17;576;2424;224833;174682;60.3;46.9
79;2021-07-18;44;498;224877;175180;60.3;47.0
79;2021-07-19;736;3315;225613;178495;60.5;47.9
79;2021-07-20;1230;3944;226843;182439;60.9;49.0
79;2021-07-21;1177;4195;228020;186634;61.2;50.1
79;2021-07-22;1354;3972;229374;190606;61.6;51.2
79;2021-07-23;1349;4553;230723;195159;61.9;52.4
79;2021-07-24;865;1499;231588;196658;62.2;52.8
79;2021-07-25;55;327;231643;196985;62.2;52.9
79;2021-07-26;1370;2598;233013;199583;62.5;53.6
79;2021-07-27;2084;2993;235097;202576;63.1;54.4
79;2021-07-28;2498;2492;237595;205068;63.8;55.0
79;2021-07-29;3010;2862;240605;207930;64.6;55.8
79;2021-07-30;2138;2814;242743;210744;65.1;56.6
79;2021-07-31;888;1157;243631;211901;65.4;56.9
79;2021-08-01;5;3;243636;211904;65.4;56.9
79;2021-08-02;1796;1545;245432;213449;65.9;57.3
79;2021-08-03;2823;2052;248255;215501;66.6;57.8
79;2021-08-04;2985;1742;251240;217243;67.4;58.3
79;2021-08-05;2900;2211;254140;219454;68.2;58.9
79;2021-08-06;2529;1633;256669;221087;68.9;59.3
79;2021-08-07;872;813;257541;221900;69.1;59.6
79;2021-08-08;4;3;257545;221903;69.1;59.6
79;2021-08-09;2495;1086;260040;222989;69.8;59.8
79;2021-08-10;2977;1548;263017;224537;70.6;60.3
79;2021-08-11;2583;1660;265600;226197;71.3;60.7
79;2021-08-12;2766;1430;268366;227627;72.0;61.1
79;2021-08-13;2875;1059;271241;228686;72.8;61.4
79;2021-08-14;518;391;271759;229077;72.9;61.5
79;2021-08-15;8;5;271767;229082;72.9;61.5
79;2021-08-16;1766;1196;273533;230278;73.4;61.8
79;2021-08-17;2103;1591;275636;231869;74.0;62.2
79;2021-08-18;1922;1915;277558;233784;74.5;62.7
79;2021-08-19;1617;1709;279175;235493;74.9;63.2
79;2021-08-20;1513;2162;280688;237655;75.3;63.8
79;2021-08-21;243;543;280931;238198;75.4;63.9
79;2021-08-22;1;21;280932;238219;75.4;63.9
79;2021-08-23;864;2176;281796;240395;75.6;64.5
79;2021-08-24;1072;2484;282868;242879;75.9;65.2
79;2021-08-25;1051;2760;283919;245639;76.2;65.9
79;2021-08-26;1016;2330;284935;247969;76.5;66.5
79;2021-08-27;611;2059;285546;250028;76.6;67.1
79;2021-08-28;299;841;285845;250869;76.7;67.3
79;2021-08-29;7;5;285852;250874;76.7;67.3
79;2021-08-30;554;2366;286406;253240;76.9;68.0
79;2021-08-31;633;2537;287039;255777;77.0;68.6
79;2021-09-01;649;2694;287688;258471;77.2;69.4
79;2021-09-02;761;2513;288449;260984;77.4;70.0
79;2021-09-03;637;2797;289086;263781;77.6;70.8
79;2021-09-04;266;721;289352;264502;77.7;71.0
79;2021-09-05;13;24;289365;264526;77.7;71.0
79;2021-09-06;329;1900;289694;266426;77.7;71.5
79;2021-09-07;347;2140;290041;268566;77.8;72.1
79;2021-09-08;542;2235;290583;270801;78.0;72.7
79;2021-09-09;318;1762;290901;272563;78.1;73.1
79;2021-09-10;422;2290;291323;274853;78.2;73.8
79;2021-09-11;162;868;291485;275721;78.2;74.0
79;2021-09-12;0;0;291485;275721;78.2;74.0
79;2021-09-13;363;1291;291848;277012;78.3;74.3
79;2021-09-14;371;1556;292219;278568;78.4;74.8
79;2021-09-15;475;1432;292694;280000;78.5;75.1
79;2021-09-16;461;1095;293155;281095;78.7;75.4
79;2021-09-17;443;1406;293598;282501;78.8;75.8
79;2021-09-18;139;567;293737;283068;78.8;76.0
79;2021-09-19;1;4;293738;283072;78.8;76.0
79;2021-09-20;190;553;293928;283625;78.9;76.1
79;2021-09-21;351;720;294279;284345;79.0;76.3
79;2021-09-22;209;1102;294488;285447;79.0;76.6
79;2021-09-23;412;566;294900;286013;79.1;76.8
79;2021-09-24;243;1348;295143;287361;79.2;77.1
79;2021-09-25;75;325;295218;287686;79.2;77.2
79;2021-09-26;0;1;295218;287687;79.2;77.2
79;2021-09-27;205;525;295423;288212;79.3;77.3
79;2021-09-28;130;409;295553;288621;79.3;77.5
79;2021-09-29;325;742;295878;289363;79.4;77.7
79;2021-09-30;154;279;296032;289642;79.4;77.7
79;2021-10-01;247;541;296279;290183;79.5;77.9
79;2021-10-02;127;248;296406;290431;79.5;77.9
79;2021-10-03;0;0;296406;290431;79.5;77.9
79;2021-10-04;157;332;296563;290763;79.6;78.0
79;2021-10-05;114;260;296677;291023;79.6;78.1
79;2021-10-06;142;336;296819;291359;79.7;78.2
80;2020-12-27;0;0;0;0;0.0;0.0
80;2020-12-28;0;0;0;0;0.0;0.0
80;2020-12-29;11;0;11;0;0.0;0.0
80;2020-12-30;0;0;11;0;0.0;0.0
80;2020-12-31;0;0;11;0;0.0;0.0
80;2021-01-01;0;0;11;0;0.0;0.0
80;2021-01-02;1;0;12;0;0.0;0.0
80;2021-01-03;1;0;13;0;0.0;0.0
80;2021-01-04;0;0;13;0;0.0;0.0
80;2021-01-05;1;0;14;0;0.0;0.0
80;2021-01-06;30;0;44;0;0.0;0.0
80;2021-01-07;276;2;320;2;0.1;0.0
80;2021-01-08;330;0;650;2;0.1;0.0
80;2021-01-09;108;0;758;2;0.1;0.0
80;2021-01-10;21;0;779;2;0.1;0.0
80;2021-01-11;276;0;1055;2;0.2;0.0
80;2021-01-12;430;1;1485;3;0.3;0.0
80;2021-01-13;514;4;1999;7;0.4;0.0
80;2021-01-14;454;4;2453;11;0.4;0.0
80;2021-01-15;331;1;2784;12;0.5;0.0
80;2021-01-16;103;1;2887;13;0.5;0.0
80;2021-01-17;102;1;2989;14;0.5;0.0
80;2021-01-18;412;2;3401;16;0.6;0.0
80;2021-01-19;963;16;4364;32;0.8;0.0
80;2021-01-20;1086;11;5450;43;1.0;0.0
80;2021-01-21;1013;9;6463;52;1.1;0.0
80;2021-01-22;1113;3;7576;55;1.3;0.0
80;2021-01-23;907;3;8483;58;1.5;0.0
80;2021-01-24;823;5;9306;63;1.6;0.0
80;2021-01-25;1543;10;10849;73;1.9;0.0
80;2021-01-26;1480;11;12329;84;2.2;0.0
80;2021-01-27;822;22;13151;106;2.3;0.0
80;2021-01-28;622;157;13773;263;2.4;0.0
80;2021-01-29;637;190;14410;453;2.5;0.1
80;2021-01-30;87;54;14497;507;2.5;0.1
80;2021-01-31;0;0;14497;507;2.5;0.1
80;2021-02-01;26;230;14523;737;2.5;0.1
80;2021-02-02;21;407;14544;1144;2.6;0.2
80;2021-02-03;28;480;14572;1624;2.6;0.3
80;2021-02-04;278;312;14850;1936;2.6;0.3
80;2021-02-05;347;196;15197;2132;2.7;0.4
80;2021-02-06;168;56;15365;2188;2.7;0.4
80;2021-02-07;1;0;15366;2188;2.7;0.4
80;2021-02-08;425;205;15791;2393;2.8;0.4
80;2021-02-09;686;230;16477;2623;2.9;0.5
80;2021-02-10;607;425;17084;3048;3.0;0.5
80;2021-02-11;862;301;17946;3349;3.1;0.6
80;2021-02-12;945;284;18891;3633;3.3;0.6
80;2021-02-13;197;372;19088;4005;3.4;0.7
80;2021-02-14;78;480;19166;4485;3.4;0.8
80;2021-02-15;606;943;19772;5428;3.5;1.0
80;2021-02-16;688;980;20460;6408;3.6;1.1
80;2021-02-17;484;977;20944;7385;3.7;1.3
80;2021-02-18;569;892;21513;8277;3.8;1.5
80;2021-02-19;502;678;22015;8955;3.9;1.6
80;2021-02-20;22;365;22037;9320;3.9;1.6
80;2021-02-21;47;38;22084;9358;3.9;1.6
80;2021-02-22;147;455;22231;9813;3.9;1.7
80;2021-02-23;471;572;22702;10385;4.0;1.8
80;2021-02-24;431;526;23133;10911;4.1;1.9
80;2021-02-25;814;414;23947;11325;4.2;2.0
80;2021-02-26;1063;411;25010;11736;4.4;2.1
80;2021-02-27;475;54;25485;11790;4.5;2.1
80;2021-02-28;49;22;25534;11812;4.5;2.1
80;2021-03-01;729;61;26263;11873;4.6;2.1
80;2021-03-02;1013;89;27276;11962;4.8;2.1
80;2021-03-03;982;51;28258;12013;5.0;2.1
80;2021-03-04;1389;192;29647;12205;5.2;2.1
80;2021-03-05;1874;307;31521;12512;5.5;2.2
80;2021-03-06;2916;330;34437;12842;6.0;2.3
80;2021-03-07;1842;74;36279;12916;6.4;2.3
80;2021-03-08;714;550;36993;13466;6.5;2.4
80;2021-03-09;1310;797;38303;14263;6.7;2.5
80;2021-03-10;1724;695;40027;14958;7.0;2.6
80;2021-03-11;1909;760;41936;15718;7.4;2.8
80;2021-03-12;3140;702;45076;16420;7.9;2.9
80;2021-03-13;4006;205;49082;16625;8.6;2.9
80;2021-03-14;350;12;49432;16637;8.7;2.9
80;2021-03-15;1014;239;50446;16876;8.9;3.0
80;2021-03-16;882;330;51328;17206;9.0;3.0
80;2021-03-17;665;269;51993;17475;9.1;3.1
80;2021-03-18;1002;286;52995;17761;9.3;3.1
80;2021-03-19;1739;370;54734;18131;9.6;3.2
80;2021-03-20;3821;117;58555;18248;10.3;3.2
80;2021-03-21;486;31;59041;18279;10.4;3.2
80;2021-03-22;903;288;59944;18567;10.5;3.3
80;2021-03-23;1713;411;61657;18978;10.8;3.3
80;2021-03-24;1755;464;63412;19442;11.1;3.4
80;2021-03-25;2714;443;66126;19885;11.6;3.5
80;2021-03-26;3105;405;69231;20290;12.2;3.6
80;2021-03-27;2237;226;71468;20516;12.5;3.6
80;2021-03-28;676;93;72144;20609;12.7;3.6
80;2021-03-29;1979;739;74123;21348;13.0;3.7
80;2021-03-30;1967;861;76090;22209;13.4;3.9
80;2021-03-31;1495;981;77585;23190;13.6;4.1
80;2021-04-01;1950;1480;79535;24670;14.0;4.3
80;2021-04-02;2811;1550;82346;26220;14.5;4.6
80;2021-04-03;3048;853;85394;27073;15.0;4.8
80;2021-04-04;134;8;85528;27081;15.0;4.8
80;2021-04-05;684;195;86212;27276;15.1;4.8
80;2021-04-06;1280;959;87492;28235;15.4;5.0
80;2021-04-07;1624;1193;89116;29428;15.6;5.2
80;2021-04-08;2154;842;91270;30270;16.0;5.3
80;2021-04-09;3533;1351;94803;31621;16.6;5.5
80;2021-04-10;2737;1946;97540;33567;17.1;5.9
80;2021-04-11;188;176;97728;33743;17.2;5.9
80;2021-04-12;1814;483;99542;34226;17.5;6.0
80;2021-04-13;2385;1031;101927;35257;17.9;6.2
80;2021-04-14;2769;1163;104696;36420;18.4;6.4
80;2021-04-15;3731;878;108427;37298;19.0;6.5
80;2021-04-16;3337;871;111764;38169;19.6;6.7
80;2021-04-17;1653;2291;113417;40460;19.9;7.1
80;2021-04-18;372;390;113789;40850;20.0;7.2
80;2021-04-19;951;771;114740;41621;20.1;7.3
80;2021-04-20;1613;820;116353;42441;20.4;7.4
80;2021-04-21;1612;996;117965;43437;20.7;7.6
80;2021-04-22;2167;1251;120132;44688;21.1;7.8
80;2021-04-23;2640;1245;122772;45933;21.5;8.1
80;2021-04-24;1357;1190;124129;47123;21.8;8.3
80;2021-04-25;209;531;124338;47654;21.8;8.4
80;2021-04-26;1295;1438;125633;49092;22.0;8.6
80;2021-04-27;2025;1396;127658;50488;22.4;8.9
80;2021-04-28;2199;1379;129857;51867;22.8;9.1
80;2021-04-29;3218;1867;133075;53734;23.4;9.4
80;2021-04-30;3081;2839;136156;56573;23.9;9.9
80;2021-05-01;987;658;137143;57231;24.1;10.0
80;2021-05-02;371;53;137514;57284;24.1;10.1
80;2021-05-03;2720;1186;140234;58470;24.6;10.3
80;2021-05-04;2494;1697;142728;60167;25.1;10.6
80;2021-05-05;3366;1895;146094;62062;25.6;10.9
80;2021-05-06;3169;2546;149263;64608;26.2;11.3
80;2021-05-07;3454;2685;152717;67293;26.8;11.8
80;2021-05-08;2784;924;155501;68217;27.3;12.0
80;2021-05-09;1407;268;156908;68485;27.5;12.0
80;2021-05-10;1880;1828;158788;70313;27.9;12.3
80;2021-05-11;3274;1793;162062;72106;28.4;12.7
80;2021-05-12;4703;1574;166765;73680;29.3;12.9
80;2021-05-13;3837;367;170602;74047;29.9;13.0
80;2021-05-14;5188;1392;175790;75439;30.9;13.2
80;2021-05-15;5917;1053;181707;76492;31.9;13.4
80;2021-05-16;2678;312;184385;76804;32.4;13.5
80;2021-05-17;2371;819;186756;77623;32.8;13.6
80;2021-05-18;3949;850;190705;78473;33.5;13.8
80;2021-05-19;4018;940;194723;79413;34.2;13.9
80;2021-05-20;4568;1215;199291;80628;35.0;14.2
80;2021-05-21;4890;1650;204181;82278;35.8;14.4
80;2021-05-22;5030;1156;209211;83434;36.7;14.6
80;2021-05-23;1783;237;210994;83671;37.0;14.7
80;2021-05-24;1469;160;212463;83831;37.3;14.7
80;2021-05-25;2622;1138;215085;84969;37.7;14.9
80;2021-05-26;4249;1704;219334;86673;38.5;15.2
80;2021-05-27;3977;2467;223311;89140;39.2;15.6
80;2021-05-28;3865;2968;227176;92108;39.9;16.2
80;2021-05-29;3697;1627;230873;93735;40.5;16.5
80;2021-05-30;1182;198;232055;93933;40.7;16.5
80;2021-05-31;2604;1369;234659;95302;41.2;16.7
80;2021-06-01;4031;2434;238690;97736;41.9;17.2
80;2021-06-02;3334;2005;242024;99741;42.5;17.5
80;2021-06-03;4264;2924;246288;102665;43.2;18.0
80;2021-06-04;4796;3082;251084;105747;44.1;18.6
80;2021-06-05;3554;2065;254638;107812;44.7;18.9
80;2021-06-06;802;211;255440;108023;44.8;19.0
80;2021-06-07;1750;1945;257190;109968;45.1;19.3
80;2021-06-08;2743;2552;259933;112520;45.6;19.7
80;2021-06-09;3012;2735;262945;115255;46.1;20.2
80;2021-06-10;3163;3167;266108;118422;46.7;20.8
80;2021-06-11;3216;3893;269324;122315;47.3;21.5
80;2021-06-12;3042;2326;272366;124641;47.8;21.9
80;2021-06-13;474;404;272840;125045;47.9;21.9
80;2021-06-14;1263;2852;274103;127897;48.1;22.4
80;2021-06-15;2315;3418;276418;131315;48.5;23.0
80;2021-06-16;1563;4212;277981;135527;48.8;23.8
80;2021-06-17;2359;3622;280340;139149;49.2;24.4
80;2021-06-18;2552;3903;282892;143052;49.7;25.1
80;2021-06-19;2986;4340;285878;147392;50.2;25.9
80;2021-06-20;203;1077;286081;148469;50.2;26.1
80;2021-06-21;1015;2619;287096;151088;50.4;26.5
80;2021-06-22;1149;3928;288245;155016;50.6;27.2
80;2021-06-23;1850;5289;290095;160305;50.9;28.1
80;2021-06-24;1695;4683;291790;164988;51.2;29.0
80;2021-06-25;1374;6125;293164;171113;51.5;30.0
80;2021-06-26;1933;6183;295097;177296;51.8;31.1
80;2021-06-27;333;2031;295430;179327;51.9;31.5
80;2021-06-28;903;3169;296333;182496;52.0;32.0
80;2021-06-29;1919;4622;298252;187118;52.3;32.8
80;2021-06-30;1245;4785;299497;191903;52.6;33.7
80;2021-07-01;1593;5000;301090;196903;52.8;34.6
80;2021-07-02;1856;5984;302946;202887;53.2;35.6
80;2021-07-03;1293;5265;304239;208152;53.4;36.5
80;2021-07-04;692;1471;304931;209623;53.5;36.8
80;2021-07-05;879;2963;305810;212586;53.7;37.3
80;2021-07-06;1852;3990;307662;216576;54.0;38.0
80;2021-07-07;1560;4504;309222;221080;54.3;38.8
80;2021-07-08;2082;5003;311304;226083;54.6;39.7
80;2021-07-09;2596;5473;313900;231556;55.1;40.6
80;2021-07-10;1617;4015;315517;235571;55.4;41.3
80;2021-07-11;406;805;315923;236376;55.4;41.5
80;2021-07-12;871;3378;316794;239754;55.6;42.1
80;2021-07-13;2087;5084;318881;244838;56.0;43.0
80;2021-07-14;2801;1749;321682;246587;56.5;43.3
80;2021-07-15;2792;5296;324474;251883;56.9;44.2
80;2021-07-16;3878;5890;328352;257773;57.6;45.2
80;2021-07-17;3368;4460;331720;262233;58.2;46.0
80;2021-07-18;874;896;332594;263129;58.4;46.2
80;2021-07-19;2158;2885;334752;266014;58.8;46.7
80;2021-07-20;3321;4903;338073;270917;59.3;47.5
80;2021-07-21;3497;4496;341570;275413;59.9;48.3
80;2021-07-22;4362;4569;345932;279982;60.7;49.1
80;2021-07-23;5399;4825;351331;284807;61.7;50.0
80;2021-07-24;4369;4344;355700;289151;62.4;50.7
80;2021-07-25;1185;650;356885;289801;62.6;50.9
80;2021-07-26;2681;2340;359566;292141;63.1;51.3
80;2021-07-27;4373;3706;363939;295847;63.9;51.9
80;2021-07-28;5101;2803;369040;298650;64.8;52.4
80;2021-07-29;4991;3230;374031;301880;65.6;53.0
80;2021-07-30;5024;3638;379055;305518;66.5;53.6
80;2021-07-31;4156;2927;383211;308445;67.3;54.1
80;2021-08-01;1288;363;384499;308808;67.5;54.2
80;2021-08-02;2059;1739;386558;310547;67.8;54.5
80;2021-08-03;3716;2363;390274;312910;68.5;54.9
80;2021-08-04;3367;2491;393641;315401;69.1;55.4
80;2021-08-05;3137;2576;396778;317977;69.6;55.8
80;2021-08-06;3248;2877;400026;320854;70.2;56.3
80;2021-08-07;2426;2667;402452;323521;70.6;56.8
80;2021-08-08;621;686;403073;324207;70.7;56.9
80;2021-08-09;1382;2078;404455;326285;71.0;57.3
80;2021-08-10;2353;2849;406808;329134;71.4;57.8
80;2021-08-11;1946;2383;408754;331517;71.7;58.2
80;2021-08-12;2236;2659;410990;334176;72.1;58.7
80;2021-08-13;1882;3154;412872;337330;72.5;59.2
80;2021-08-14;1411;2113;414283;339443;72.7;59.6
80;2021-08-15;318;663;414601;340106;72.8;59.7
80;2021-08-16;897;2419;415498;342525;72.9;60.1
80;2021-08-17;1709;3505;417207;346030;73.2;60.7
80;2021-08-18;1234;3714;418441;349744;73.4;61.4
80;2021-08-19;1569;3821;420010;353565;73.7;62.1
80;2021-08-20;1264;4434;421274;357999;73.9;62.8
80;2021-08-21;1078;2687;422352;360686;74.1;63.3
80;2021-08-22;145;680;422497;361366;74.2;63.4
80;2021-08-23;583;2999;423080;364365;74.3;63.9
80;2021-08-24;1092;4371;424172;368736;74.4;64.7
80;2021-08-25;973;3677;425145;372413;74.6;65.4
80;2021-08-26;956;3819;426101;376232;74.8;66.0
80;2021-08-27;1014;4457;427115;380689;75.0;66.8
80;2021-08-28;723;3347;427838;384036;75.1;67.4
80;2021-08-29;199;555;428037;384591;75.1;67.5
80;2021-08-30;500;2307;428537;386898;75.2;67.9
80;2021-08-31;750;3185;429287;390083;75.3;68.5
80;2021-09-01;675;2481;429962;392564;75.5;68.9
80;2021-09-02;527;2277;430489;394841;75.6;69.3
80;2021-09-03;761;3116;431250;397957;75.7;69.8
80;2021-09-04;956;2755;432206;400712;75.9;70.3
80;2021-09-05;166;374;432372;401086;75.9;70.4
80;2021-09-06;420;1562;432792;402648;76.0;70.7
80;2021-09-07;490;1841;433282;404489;76.0;71.0
80;2021-09-08;495;1873;433777;406362;76.1;71.3
80;2021-09-09;530;1754;434307;408116;76.2;71.6
80;2021-09-10;619;2078;434926;410194;76.3;72.0
80;2021-09-11;520;2118;435446;412312;76.4;72.4
80;2021-09-12;78;327;435524;412639;76.4;72.4
80;2021-09-13;312;1101;435836;413740;76.5;72.6
80;2021-09-14;641;1473;436477;415213;76.6;72.9
80;2021-09-15;357;1089;436834;416302;76.7;73.1
80;2021-09-16;474;1030;437308;417332;76.8;73.2
80;2021-09-17;506;1238;437814;418570;76.8;73.5
80;2021-09-18;348;1277;438162;419847;76.9;73.7
80;2021-09-19;17;169;438179;420016;76.9;73.7
80;2021-09-20;325;446;438504;420462;77.0;73.8
80;2021-09-21;295;615;438799;421077;77.0;73.9
80;2021-09-22;284;709;439083;421786;77.1;74.0
80;2021-09-23;302;505;439385;422291;77.1;74.1
80;2021-09-24;371;897;439756;423188;77.2;74.3
80;2021-09-25;283;1132;440039;424320;77.2;74.5
80;2021-09-26;20;109;440059;424429;77.2;74.5
80;2021-09-27;189;536;440248;424965;77.3;74.6
80;2021-09-28;148;380;440396;425345;77.3;74.7
80;2021-09-29;257;511;440653;425856;77.3;74.7
80;2021-09-30;199;329;440852;426185;77.4;74.8
80;2021-10-01;304;719;441156;426904;77.4;74.9
80;2021-10-02;335;892;441491;427796;77.5;75.1
80;2021-10-03;18;64;441509;427860;77.5;75.1
80;2021-10-04;136;320;441645;428180;77.5;75.1
80;2021-10-05;166;460;441811;428640;77.5;75.2
80;2021-10-06;254;444;442065;429084;77.6;75.3
81;2020-12-27;1;0;1;0;0.0;0.0
81;2020-12-28;0;0;1;0;0.0;0.0
81;2020-12-29;0;0;1;0;0.0;0.0
81;2020-12-30;1;0;2;0;0.0;0.0
81;2020-12-31;1;0;3;0;0.0;0.0
81;2021-01-01;0;0;3;0;0.0;0.0
81;2021-01-02;0;0;3;0;0.0;0.0
81;2021-01-03;0;0;3;0;0.0;0.0
81;2021-01-04;1;0;4;0;0.0;0.0
81;2021-01-05;0;0;4;0;0.0;0.0
81;2021-01-06;5;0;9;0;0.0;0.0
81;2021-01-07;265;0;274;0;0.1;0.0
81;2021-01-08;312;1;586;1;0.2;0.0
81;2021-01-09;74;1;660;2;0.2;0.0
81;2021-01-10;1;0;661;2;0.2;0.0
81;2021-01-11;133;0;794;2;0.2;0.0
81;2021-01-12;167;0;961;2;0.2;0.0
81;2021-01-13;234;1;1195;3;0.3;0.0
81;2021-01-14;963;5;2158;8;0.6;0.0
81;2021-01-15;523;3;2681;11;0.7;0.0
81;2021-01-16;71;1;2752;12;0.7;0.0
81;2021-01-17;0;0;2752;12;0.7;0.0
81;2021-01-18;581;2;3333;14;0.9;0.0
81;2021-01-19;662;4;3995;18;1.0;0.0
81;2021-01-20;754;2;4749;20;1.2;0.0
81;2021-01-21;1183;4;5932;24;1.5;0.0
81;2021-01-22;857;2;6789;26;1.8;0.0
81;2021-01-23;221;2;7010;28;1.8;0.0
81;2021-01-24;102;0;7112;28;1.8;0.0
81;2021-01-25;570;1;7682;29;2.0;0.0
81;2021-01-26;635;2;8317;31;2.1;0.0
81;2021-01-27;552;1;8869;32;2.3;0.0
81;2021-01-28;700;203;9569;235;2.5;0.1
81;2021-01-29;303;171;9872;406;2.5;0.1
81;2021-01-30;204;34;10076;440;2.6;0.1
81;2021-01-31;104;0;10180;440;2.6;0.1
81;2021-02-01;321;111;10501;551;2.7;0.1
81;2021-02-02;445;116;10946;667;2.8;0.2
81;2021-02-03;476;204;11422;871;2.9;0.2
81;2021-02-04;1449;628;12871;1499;3.3;0.4
81;2021-02-05;870;298;13741;1797;3.5;0.5
81;2021-02-06;274;17;14015;1814;3.6;0.5
81;2021-02-07;103;0;14118;1814;3.6;0.5
81;2021-02-08;275;194;14393;2008;3.7;0.5
81;2021-02-09;420;187;14813;2195;3.8;0.6
81;2021-02-10;371;262;15184;2457;3.9;0.6
81;2021-02-11;651;340;15835;2797;4.1;0.7
81;2021-02-12;580;465;16415;3262;4.2;0.8
81;2021-02-13;188;104;16603;3366;4.3;0.9
81;2021-02-14;100;1;16703;3367;4.3;0.9
81;2021-02-15;234;324;16937;3691;4.4;1.0
81;2021-02-16;281;459;17218;4150;4.4;1.1
81;2021-02-17;241;378;17459;4528;4.5;1.2
81;2021-02-18;482;540;17941;5068;4.6;1.3
81;2021-02-19;572;303;18513;5371;4.8;1.4
81;2021-02-20;322;223;18835;5594;4.9;1.4
81;2021-02-21;23;66;18858;5660;4.9;1.5
81;2021-02-22;233;419;19091;6079;4.9;1.6
81;2021-02-23;169;480;19260;6559;5.0;1.7
81;2021-02-24;291;513;19551;7072;5.0;1.8
81;2021-02-25;720;920;20271;7992;5.2;2.1
81;2021-02-26;911;843;21182;8835;5.5;2.3
81;2021-02-27;275;221;21457;9056;5.5;2.3
81;2021-02-28;21;61;21478;9117;5.5;2.4
81;2021-03-01;208;354;21686;9471;5.6;2.4
81;2021-03-02;364;458;22050;9929;5.7;2.6
81;2021-03-03;463;370;22513;10299;5.8;2.7
81;2021-03-04;1061;403;23574;10702;6.1;2.8
81;2021-03-05;1406;352;24980;11054;6.4;2.8
81;2021-03-06;982;158;25962;11212;6.7;2.9
81;2021-03-07;154;91;26116;11303;6.7;2.9
81;2021-03-08;466;319;26582;11622;6.9;3.0
81;2021-03-09;816;332;27398;11954;7.1;3.1
81;2021-03-10;898;360;28296;12314;7.3;3.2
81;2021-03-11;1350;325;29646;12639;7.6;3.3
81;2021-03-12;1690;296;31336;12935;8.1;3.3
81;2021-03-13;1031;171;32367;13106;8.3;3.4
81;2021-03-14;66;79;32433;13185;8.4;3.4
81;2021-03-15;1093;219;33526;13404;8.6;3.5
81;2021-03-16;724;215;34250;13619;8.8;3.5
81;2021-03-17;893;275;35143;13894;9.1;3.6
81;2021-03-18;971;573;36114;14467;9.3;3.7
81;2021-03-19;1271;456;37385;14923;9.6;3.8
81;2021-03-20;677;285;38062;15208;9.8;3.9
81;2021-03-21;139;22;38201;15230;9.8;3.9
81;2021-03-22;932;267;39133;15497;10.1;4.0
81;2021-03-23;1420;219;40553;15716;10.5;4.1
81;2021-03-24;1606;262;42159;15978;10.9;4.1
81;2021-03-25;2028;323;44187;16301;11.4;4.2
81;2021-03-26;2100;270;46287;16571;11.9;4.3
81;2021-03-27;1091;37;47378;16608;12.2;4.3
81;2021-03-28;734;38;48112;16646;12.4;4.3
81;2021-03-29;2866;189;50978;16835;13.1;4.3
81;2021-03-30;3055;215;54033;17050;13.9;4.4
81;2021-03-31;2691;298;56724;17348;14.6;4.5
81;2021-04-01;3314;569;60038;17917;15.5;4.6
81;2021-04-02;2615;369;62653;18286;16.2;4.7
81;2021-04-03;1147;304;63800;18590;16.4;4.8
81;2021-04-04;1403;24;65203;18614;16.8;4.8
81;2021-04-05;718;20;65921;18634;17.0;4.8
81;2021-04-06;1599;516;67520;19150;17.4;4.9
81;2021-04-07;1817;581;69337;19731;17.9;5.1
81;2021-04-08;2619;822;71956;20553;18.6;5.3
81;2021-04-09;3052;476;75008;21029;19.3;5.4
81;2021-04-10;1475;516;76483;21545;19.7;5.6
81;2021-04-11;1299;70;77782;21615;20.1;5.6
81;2021-04-12;1220;682;79002;22297;20.4;5.7
81;2021-04-13;2528;792;81530;23089;21.0;6.0
81;2021-04-14;2506;834;84036;23923;21.7;6.2
81;2021-04-15;3099;1198;87135;25121;22.5;6.5
81;2021-04-16;2822;1090;89957;26211;23.2;6.8
81;2021-04-17;1145;297;91102;26508;23.5;6.8
81;2021-04-18;519;145;91621;26653;23.6;6.9
81;2021-04-19;913;819;92534;27472;23.9;7.1
81;2021-04-20;2270;1168;94804;28640;24.4;7.4
81;2021-04-21;2224;1004;97028;29644;25.0;7.6
81;2021-04-22;2816;1060;99844;30704;25.7;7.9
81;2021-04-23;2885;969;102729;31673;26.5;8.2
81;2021-04-24;1326;741;104055;32414;26.8;8.4
81;2021-04-25;454;715;104509;33129;26.9;8.5
81;2021-04-26;1061;2421;105570;35550;27.2;9.2
81;2021-04-27;1596;2352;107166;37902;27.6;9.8
81;2021-04-28;1427;2393;108593;40295;28.0;10.4
81;2021-04-29;1818;2739;110411;43034;28.5;11.1
81;2021-04-30;2013;2348;112424;45382;29.0;11.7
81;2021-05-01;362;686;112786;46068;29.1;11.9
81;2021-05-02;291;1376;113077;47444;29.2;12.2
81;2021-05-03;1115;1168;114192;48612;29.4;12.5
81;2021-05-04;2620;1908;116812;50520;30.1;13.0
81;2021-05-05;2016;1931;118828;52451;30.6;13.5
81;2021-05-06;2748;3455;121576;55906;31.3;14.4
81;2021-05-07;2128;2878;123704;58784;31.9;15.2
81;2021-05-08;962;878;124666;59662;32.1;15.4
81;2021-05-09;534;1350;125200;61012;32.3;15.7
81;2021-05-10;824;1599;126024;62611;32.5;16.1
81;2021-05-11;1661;2571;127685;65182;32.9;16.8
81;2021-05-12;1640;2459;129325;67641;33.3;17.4
81;2021-05-13;1216;564;130541;68205;33.7;17.6
81;2021-05-14;1890;1723;132431;69928;34.1;18.0
81;2021-05-15;1511;618;133942;70546;34.5;18.2
81;2021-05-16;1368;417;135310;70963;34.9;18.3
81;2021-05-17;1167;864;136477;71827;35.2;18.5
81;2021-05-18;1702;1419;138179;73246;35.6;18.9
81;2021-05-19;2641;1244;140820;74490;36.3;19.2
81;2021-05-20;2968;1351;143788;75841;37.1;19.6
81;2021-05-21;2739;1115;146527;76956;37.8;19.8
81;2021-05-22;2814;520;149341;77476;38.5;20.0
81;2021-05-23;1178;74;150519;77550;38.8;20.0
81;2021-05-24;837;83;151356;77633;39.0;20.0
81;2021-05-25;2490;1100;153846;78733;39.7;20.3
81;2021-05-26;1891;800;155737;79533;40.1;20.5
81;2021-05-27;2555;1542;158292;81075;40.8;20.9
81;2021-05-28;2566;1660;160858;82735;41.5;21.3
81;2021-05-29;1400;544;162258;83279;41.8;21.5
81;2021-05-30;935;219;163193;83498;42.1;21.5
81;2021-05-31;1183;1336;164376;84834;42.4;21.9
81;2021-06-01;1779;2695;166155;87529;42.8;22.6
81;2021-06-02;2006;2444;168161;89973;43.4;23.2
81;2021-06-03;2003;2529;170164;92502;43.9;23.8
81;2021-06-04;1844;2942;172008;95444;44.3;24.6
81;2021-06-05;1757;1307;173765;96751;44.8;24.9
81;2021-06-06;370;366;174135;97117;44.9;25.0
81;2021-06-07;1209;1540;175344;98657;45.2;25.4
81;2021-06-08;2369;2382;177713;101039;45.8;26.0
81;2021-06-09;2438;1867;180151;102906;46.4;26.5
81;2021-06-10;1278;1560;181429;104466;46.8;26.9
81;2021-06-11;2657;2198;184086;106664;47.5;27.5
81;2021-06-12;1659;1038;185745;107702;47.9;27.8
81;2021-06-13;444;476;186189;108178;48.0;27.9
81;2021-06-14;771;1415;186960;109593;48.2;28.3
81;2021-06-15;1677;3500;188637;113093;48.6;29.2
81;2021-06-16;1269;3013;189906;116106;49.0;29.9
81;2021-06-17;1344;2525;191250;118631;49.3;30.6
81;2021-06-18;1836;2770;193086;121401;49.8;31.3
81;2021-06-19;824;951;193910;122352;50.0;31.5
81;2021-06-20;405;536;194315;122888;50.1;31.7
81;2021-06-21;425;1038;194740;123926;50.2;31.9
81;2021-06-22;1061;2567;195801;126493;50.5;32.6
81;2021-06-23;1142;2159;196943;128652;50.8;33.2
81;2021-06-24;1115;1937;198058;130589;51.1;33.7
81;2021-06-25;1238;2864;199296;133453;51.4;34.4
81;2021-06-26;721;1713;200017;135166;51.6;34.8
81;2021-06-27;526;1646;200543;136812;51.7;35.3
81;2021-06-28;476;1538;201019;138350;51.8;35.7
81;2021-06-29;1079;2634;202098;140984;52.1;36.3
81;2021-06-30;1043;3153;203141;144137;52.4;37.2
81;2021-07-01;1101;2627;204242;146764;52.7;37.8
81;2021-07-02;1070;2860;205312;149624;52.9;38.6
81;2021-07-03;732;2829;206044;152453;53.1;39.3
81;2021-07-04;268;1010;206312;153463;53.2;39.6
81;2021-07-05;702;1625;207014;155088;53.4;40.0
81;2021-07-06;975;3176;207989;158264;53.6;40.8
81;2021-07-07;1059;2437;209048;160701;53.9;41.4
81;2021-07-08;1030;2232;210078;162933;54.2;42.0
81;2021-07-09;1147;2702;211225;165635;54.5;42.7
81;2021-07-10;806;1523;212031;167158;54.7;43.1
81;2021-07-11;436;1012;212467;168170;54.8;43.4
81;2021-07-12;785;1725;213252;169895;55.0;43.8
81;2021-07-13;2081;3144;215333;173039;55.5;44.6
81;2021-07-14;1443;1573;216776;174612;55.9;45.0
81;2021-07-15;2545;2760;219321;177372;56.5;45.7
81;2021-07-16;2032;3027;221353;180399;57.1;46.5
81;2021-07-17;1218;2452;222571;182851;57.4;47.1
81;2021-07-18;672;1131;223243;183982;57.6;47.4
81;2021-07-19;1256;1734;224499;185716;57.9;47.9
81;2021-07-20;3064;2806;227563;188522;58.7;48.6
81;2021-07-21;3488;2346;231051;190868;59.6;49.2
81;2021-07-22;3557;2092;234608;192960;60.5;49.7
81;2021-07-23;3172;3245;237780;196205;61.3;50.6
81;2021-07-24;2519;1723;240299;197928;61.9;51.0
81;2021-07-25;1684;711;241983;198639;62.4;51.2
81;2021-07-26;2014;1547;243997;200186;62.9;51.6
81;2021-07-27;3619;2544;247616;202730;63.8;52.3
81;2021-07-28;3052;2206;250668;204936;64.6;52.8
81;2021-07-29;3354;1781;254022;206717;65.5;53.3
81;2021-07-30;2829;2261;256851;208978;66.2;53.9
81;2021-07-31;1947;1015;258798;209993;66.7;54.1
81;2021-08-01;835;639;259633;210632;66.9;54.3
81;2021-08-02;1082;989;260715;211621;67.2;54.6
81;2021-08-03;2362;2116;263077;213737;67.8;55.1
81;2021-08-04;2031;1535;265108;215272;68.3;55.5
81;2021-08-05;1544;1877;266652;217149;68.7;56.0
81;2021-08-06;1725;1970;268377;219119;69.2;56.5
81;2021-08-07;985;1042;269362;220161;69.4;56.8
81;2021-08-08;437;708;269799;220869;69.6;56.9
81;2021-08-09;805;659;270604;221528;69.8;57.1
81;2021-08-10;1610;2757;272214;224285;70.2;57.8
81;2021-08-11;1110;2410;273324;226695;70.5;58.4
81;2021-08-12;1063;2250;274387;228945;70.7;59.0
81;2021-08-13;873;2473;275260;231418;71.0;59.7
81;2021-08-14;501;1873;275761;233291;71.1;60.1
81;2021-08-15;141;1100;275902;234391;71.1;60.4
81;2021-08-16;631;1816;276533;236207;71.3;60.9
81;2021-08-17;1347;3101;277880;239308;71.6;61.7
81;2021-08-18;1067;2359;278947;241667;71.9;62.3
81;2021-08-19;941;2267;279888;243934;72.2;62.9
81;2021-08-20;929;2354;280817;246288;72.4;63.5
81;2021-08-21;471;1538;281288;247826;72.5;63.9
81;2021-08-22;184;931;281472;248757;72.6;64.1
81;2021-08-23;487;1260;281959;250017;72.7;64.5
81;2021-08-24;852;2543;282811;252560;72.9;65.1
81;2021-08-25;718;2054;283529;254614;73.1;65.6
81;2021-08-26;855;2110;284384;256724;73.3;66.2
81;2021-08-27;853;2185;285237;258909;73.5;66.7
81;2021-08-28;484;1417;285721;260326;73.7;67.1
81;2021-08-29;163;832;285884;261158;73.7;67.3
81;2021-08-30;420;1211;286304;262369;73.8;67.6
81;2021-08-31;832;2117;287136;264486;74.0;68.2
81;2021-09-01;658;1410;287794;265896;74.2;68.5
81;2021-09-02;574;1304;288368;267200;74.3;68.9
81;2021-09-03;581;1467;288949;268667;74.5;69.3
81;2021-09-04;496;932;289445;269599;74.6;69.5
81;2021-09-05;97;245;289542;269844;74.6;69.6
81;2021-09-06;279;678;289821;270522;74.7;69.7
81;2021-09-07;387;1380;290208;271902;74.8;70.1
81;2021-09-08;438;1268;290646;273170;74.9;70.4
81;2021-09-09;367;1040;291013;274210;75.0;70.7
81;2021-09-10;394;1247;291407;275457;75.1;71.0
81;2021-09-11;407;926;291814;276383;75.2;71.3
81;2021-09-12;79;244;291893;276627;75.2;71.3
81;2021-09-13;230;729;292123;277356;75.3;71.5
81;2021-09-14;503;1196;292626;278552;75.4;71.8
81;2021-09-15;452;765;293078;279317;75.6;72.0
81;2021-09-16;335;548;293413;279865;75.6;72.1
81;2021-09-17;411;841;293824;280706;75.7;72.4
81;2021-09-18;258;697;294082;281403;75.8;72.5
81;2021-09-19;50;164;294132;281567;75.8;72.6
81;2021-09-20;107;324;294239;281891;75.9;72.7
81;2021-09-21;265;596;294504;282487;75.9;72.8
81;2021-09-22;212;664;294716;283151;76.0;73.0
81;2021-09-23;163;662;294879;283813;76.0;73.2
81;2021-09-24;308;705;295187;284518;76.1;73.3
81;2021-09-25;173;673;295360;285191;76.1;73.5
81;2021-09-26;36;116;295396;285307;76.2;73.6
81;2021-09-27;136;272;295532;285579;76.2;73.6
81;2021-09-28;185;362;295717;285941;76.2;73.7
81;2021-09-29;248;517;295965;286458;76.3;73.8
81;2021-09-30;140;292;296105;286750;76.3;73.9
81;2021-10-01;244;426;296349;287176;76.4;74.0
81;2021-10-02;180;415;296529;287591;76.4;74.1
81;2021-10-03;44;104;296573;287695;76.5;74.2
81;2021-10-04;88;209;296661;287904;76.5;74.2
81;2021-10-05;135;319;296796;288223;76.5;74.3
81;2021-10-06;199;469;296995;288692;76.6;74.4
82;2020-12-27;1;0;1;0;0.0;0.0
82;2020-12-28;2;0;3;0;0.0;0.0
82;2020-12-29;0;0;3;0;0.0;0.0
82;2020-12-30;0;0;3;0;0.0;0.0
82;2020-12-31;0;0;3;0;0.0;0.0
82;2021-01-01;0;0;3;0;0.0;0.0
82;2021-01-02;0;0;3;0;0.0;0.0
82;2021-01-03;0;0;3;0;0.0;0.0
82;2021-01-04;0;0;3;0;0.0;0.0
82;2021-01-05;86;0;89;0;0.0;0.0
82;2021-01-06;1;0;90;0;0.0;0.0
82;2021-01-07;75;0;165;0;0.1;0.0
82;2021-01-08;46;0;211;0;0.1;0.0
82;2021-01-09;77;0;288;0;0.1;0.0
82;2021-01-10;0;0;288;0;0.1;0.0
82;2021-01-11;94;0;382;0;0.1;0.0
82;2021-01-12;285;0;667;0;0.3;0.0
82;2021-01-13;336;1;1003;1;0.4;0.0
82;2021-01-14;443;2;1446;3;0.6;0.0
82;2021-01-15;612;2;2058;5;0.8;0.0
82;2021-01-16;230;3;2288;8;0.9;0.0
82;2021-01-17;89;0;2377;8;0.9;0.0
82;2021-01-18;432;0;2809;8;1.1;0.0
82;2021-01-19;482;1;3291;9;1.3;0.0
82;2021-01-20;663;2;3954;11;1.5;0.0
82;2021-01-21;446;2;4400;13;1.7;0.0
82;2021-01-22;483;2;4883;15;1.9;0.0
82;2021-01-23;151;0;5034;15;1.9;0.0
82;2021-01-24;0;0;5034;15;1.9;0.0
82;2021-01-25;375;0;5409;15;2.1;0.0
82;2021-01-26;468;0;5877;15;2.2;0.0
82;2021-01-27;520;0;6397;15;2.4;0.0
82;2021-01-28;587;34;6984;49;2.7;0.0
82;2021-01-29;405;108;7389;157;2.8;0.1
82;2021-01-30;44;20;7433;177;2.8;0.1
82;2021-01-31;2;0;7435;177;2.8;0.1
82;2021-02-01;292;53;7727;230;2.9;0.1
82;2021-02-02;344;97;8071;327;3.1;0.1
82;2021-02-03;462;65;8533;392;3.2;0.1
82;2021-02-04;768;208;9301;600;3.5;0.2
82;2021-02-05;480;132;9781;732;3.7;0.3
82;2021-02-06;93;36;9874;768;3.8;0.3
82;2021-02-07;29;79;9903;847;3.8;0.3
82;2021-02-08;151;185;10054;1032;3.8;0.4
82;2021-02-09;238;330;10292;1362;3.9;0.5
82;2021-02-10;271;542;10563;1904;4.0;0.7
82;2021-02-11;225;346;10788;2250;4.1;0.9
82;2021-02-12;190;520;10978;2770;4.2;1.1
82;2021-02-13;60;97;11038;2867;4.2;1.1
82;2021-02-14;5;61;11043;2928;4.2;1.1
82;2021-02-15;216;246;11259;3174;4.3;1.2
82;2021-02-16;280;326;11539;3500;4.4;1.3
82;2021-02-17;359;463;11898;3963;4.5;1.5
82;2021-02-18;507;430;12405;4393;4.7;1.7
82;2021-02-19;490;500;12895;4893;4.9;1.9
82;2021-02-20;78;119;12973;5012;4.9;1.9
82;2021-02-21;0;0;12973;5012;4.9;1.9
82;2021-02-22;200;332;13173;5344;5.0;2.0
82;2021-02-23;277;411;13450;5755;5.1;2.2
82;2021-02-24;284;363;13734;6118;5.2;2.3
82;2021-02-25;637;466;14371;6584;5.5;2.5
82;2021-02-26;648;382;15019;6966;5.7;2.7
82;2021-02-27;214;63;15233;7029;5.8;2.7
82;2021-02-28;30;7;15263;7036;5.8;2.7
82;2021-03-01;291;197;15554;7233;5.9;2.8
82;2021-03-02;494;356;16048;7589;6.1;2.9
82;2021-03-03;440;342;16488;7931;6.3;3.0
82;2021-03-04;600;280;17088;8211;6.5;3.1
82;2021-03-05;680;359;17768;8570;6.8;3.3
82;2021-03-06;693;36;18461;8606;7.0;3.3
82;2021-03-07;302;3;18763;8609;7.1;3.3
82;2021-03-08;603;141;19366;8750;7.4;3.3
82;2021-03-09;582;229;19948;8979;7.6;3.4
82;2021-03-10;779;223;20727;9202;7.9;3.5
82;2021-03-11;977;267;21704;9469;8.3;3.6
82;2021-03-12;992;99;22696;9568;8.6;3.6
82;2021-03-13;564;54;23260;9622;8.9;3.7
82;2021-03-14;61;5;23321;9627;8.9;3.7
82;2021-03-15;485;312;23806;9939;9.1;3.8
82;2021-03-16;197;324;24003;10263;9.1;3.9
82;2021-03-17;191;285;24194;10548;9.2;4.0
82;2021-03-18;279;344;24473;10892;9.3;4.1
82;2021-03-19;533;303;25006;11195;9.5;4.3
82;2021-03-20;251;56;25257;11251;9.6;4.3
82;2021-03-21;23;0;25280;11251;9.6;4.3
82;2021-03-22;406;317;25686;11568;9.8;4.4
82;2021-03-23;601;312;26287;11880;10.0;4.5
82;2021-03-24;621;321;26908;12201;10.2;4.6
82;2021-03-25;928;244;27836;12445;10.6;4.7
82;2021-03-26;1216;264;29052;12709;11.1;4.8
82;2021-03-27;479;78;29531;12787;11.2;4.9
82;2021-03-28;136;2;29667;12789;11.3;4.9
82;2021-03-29;925;375;30592;13164;11.6;5.0
82;2021-03-30;1188;279;31780;13443;12.1;5.1
82;2021-03-31;1018;260;32798;13703;12.5;5.2
82;2021-04-01;1070;196;33868;13899;12.9;5.3
82;2021-04-02;1213;284;35081;14183;13.4;5.4
82;2021-04-03;715;129;35796;14312;13.6;5.4
82;2021-04-04;276;14;36072;14326;13.7;5.5
82;2021-04-05;388;20;36460;14346;13.9;5.5
82;2021-04-06;953;510;37413;14856;14.2;5.7
82;2021-04-07;1016;495;38429;15351;14.6;5.8
82;2021-04-08;1454;418;39883;15769;15.2;6.0
82;2021-04-09;1656;470;41539;16239;15.8;6.2
82;2021-04-10;1716;103;43255;16342;16.5;6.2
82;2021-04-11;560;19;43815;16361;16.7;6.2
82;2021-04-12;1348;294;45163;16655;17.2;6.3
82;2021-04-13;1626;271;46789;16926;17.8;6.4
82;2021-04-14;1411;299;48200;17225;18.4;6.6
82;2021-04-15;1781;324;49981;17549;19.0;6.7
82;2021-04-16;1542;335;51523;17884;19.6;6.8
82;2021-04-17;1243;70;52766;17954;20.1;6.8
82;2021-04-18;560;15;53326;17969;20.3;6.8
82;2021-04-19;958;358;54284;18327;20.7;7.0
82;2021-04-20;1267;401;55551;18728;21.2;7.1
82;2021-04-21;1217;373;56768;19101;21.6;7.3
82;2021-04-22;1452;294;58220;19395;22.2;7.4
82;2021-04-23;1076;682;59296;20077;22.6;7.6
82;2021-04-24;1188;265;60484;20342;23.0;7.7
82;2021-04-25;736;49;61220;20391;23.3;7.8
82;2021-04-26;748;808;61968;21199;23.6;8.1
82;2021-04-27;905;921;62873;22120;23.9;8.4
82;2021-04-28;921;896;63794;23016;24.3;8.8
82;2021-04-29;1107;912;64901;23928;24.7;9.1
82;2021-04-30;1042;884;65943;24812;25.1;9.4
82;2021-05-01;1143;258;67086;25070;25.5;9.5
82;2021-05-02;697;145;67783;25215;25.8;9.6
82;2021-05-03;410;1216;68193;26431;26.0;10.1
82;2021-05-04;862;1167;69055;27598;26.3;10.5
82;2021-05-05;568;1172;69623;28770;26.5;11.0
82;2021-05-06;848;1409;70471;30179;26.8;11.5
82;2021-05-07;734;1456;71205;31635;27.1;12.0
82;2021-05-08;934;518;72139;32153;27.5;12.2
82;2021-05-09;753;578;72892;32731;27.8;12.5
82;2021-05-10;850;1363;73742;34094;28.1;13.0
82;2021-05-11;1157;1347;74899;35441;28.5;13.5
82;2021-05-12;1015;1344;75914;36785;28.9;14.0
82;2021-05-13;1454;432;77368;37217;29.5;14.2
82;2021-05-14;1690;1239;79058;38456;30.1;14.6
82;2021-05-15;1934;696;80992;39152;30.8;14.9
82;2021-05-16;558;114;81550;39266;31.1;15.0
82;2021-05-17;1090;1172;82640;40438;31.5;15.4
82;2021-05-18;1465;1189;84105;41627;32.0;15.9
82;2021-05-19;1272;974;85377;42601;32.5;16.2
82;2021-05-20;1408;1160;86785;43761;33.0;16.7
82;2021-05-21;1411;1218;88196;44979;33.6;17.1
82;2021-05-22;2067;623;90263;45602;34.4;17.4
82;2021-05-23;705;117;90968;45719;34.6;17.4
82;2021-05-24;1441;265;92409;45984;35.2;17.5
82;2021-05-25;1444;963;93853;46947;35.7;17.9
82;2021-05-26;1411;919;95264;47866;36.3;18.2
82;2021-05-27;1460;1025;96724;48891;36.8;18.6
82;2021-05-28;1540;1139;98264;50030;37.4;19.1
82;2021-05-29;1496;543;99760;50573;38.0;19.3
82;2021-05-30;402;101;100162;50674;38.1;19.3
82;2021-05-31;1490;990;101652;51664;38.7;19.7
82;2021-06-01;1750;1048;103402;52712;39.4;20.1
82;2021-06-02;1477;1005;104879;53717;39.9;20.5
82;2021-06-03;1489;1181;106368;54898;40.5;20.9
82;2021-06-04;2250;1305;108618;56203;41.4;21.4
82;2021-06-05;2267;984;110885;57187;42.2;21.8
82;2021-06-06;329;133;111214;57320;42.3;21.8
82;2021-06-07;957;1275;112171;58595;42.7;22.3
82;2021-06-08;1445;1138;113616;59733;43.3;22.7
82;2021-06-09;1707;1142;115323;60875;43.9;23.2
82;2021-06-10;1441;1208;116764;62083;44.5;23.6
82;2021-06-11;1922;1128;118686;63211;45.2;24.1
82;2021-06-12;2392;1393;121078;64604;46.1;24.6
82;2021-06-13;379;113;121457;64717;46.2;24.6
82;2021-06-14;1213;1082;122670;65799;46.7;25.1
82;2021-06-15;1462;1245;124132;67044;47.3;25.5
82;2021-06-16;1749;1168;125881;68212;47.9;26.0
82;2021-06-17;1219;1472;127100;69684;48.4;26.5
82;2021-06-18;1469;1439;128569;71123;49.0;27.1
82;2021-06-19;2269;981;130838;72104;49.8;27.5
82;2021-06-20;269;173;131107;72277;49.9;27.5
82;2021-06-21;484;1361;131591;73638;50.1;28.0
82;2021-06-22;892;1710;132483;75348;50.4;28.7
82;2021-06-23;1238;1586;133721;76934;50.9;29.3
82;2021-06-24;756;1904;134477;78838;51.2;30.0
82;2021-06-25;739;1936;135216;80774;51.5;30.8
82;2021-06-26;1239;2145;136455;82919;52.0;31.6
82;2021-06-27;195;440;136650;83359;52.0;31.7
82;2021-06-28;329;1411;136979;84770;52.2;32.3
82;2021-06-29;518;1840;137497;86610;52.4;33.0
82;2021-06-30;947;1912;138444;88522;52.7;33.7
82;2021-07-01;658;1632;139102;90154;53.0;34.3
82;2021-07-02;931;2293;140033;92447;53.3;35.2
82;2021-07-03;858;2340;140891;94787;53.6;36.1
82;2021-07-04;120;439;141011;95226;53.7;36.3
82;2021-07-05;445;1561;141456;96787;53.9;36.9
82;2021-07-06;513;1866;141969;98653;54.1;37.6
82;2021-07-07;793;1772;142762;100425;54.4;38.2
82;2021-07-08;504;1504;143266;101929;54.6;38.8
82;2021-07-09;781;2154;144047;104083;54.9;39.6
82;2021-07-10;706;2217;144753;106300;55.1;40.5
82;2021-07-11;39;380;144792;106680;55.1;40.6
82;2021-07-12;578;1884;145370;108564;55.4;41.3
82;2021-07-13;714;2003;146084;110567;55.6;42.1
82;2021-07-14;617;741;146701;111308;55.9;42.4
82;2021-07-15;858;1748;147559;113056;56.2;43.0
82;2021-07-16;1436;2636;148995;115692;56.7;44.1
82;2021-07-17;560;2182;149555;117874;56.9;44.9
82;2021-07-18;14;41;149569;117915;57.0;44.9
82;2021-07-19;736;2072;150305;119987;57.2;45.7
82;2021-07-20;920;1883;151225;121870;57.6;46.4
82;2021-07-21;1289;1759;152514;123629;58.1;47.1
82;2021-07-22;1083;1765;153597;125394;58.5;47.7
82;2021-07-23;1056;2990;154653;128384;58.9;48.9
82;2021-07-24;1102;1490;155755;129874;59.3;49.5
82;2021-07-25;303;73;156058;129947;59.4;49.5
82;2021-07-26;950;1896;157008;131843;59.8;50.2
82;2021-07-27;1324;1640;158332;133483;60.3;50.8
82;2021-07-28;1469;1499;159801;134982;60.8;51.4
82;2021-07-29;1331;1534;161132;136516;61.4;52.0
82;2021-07-30;1537;2474;162669;138990;61.9;52.9
82;2021-07-31;459;296;163128;139286;62.1;53.0
82;2021-08-01;273;50;163401;139336;62.2;53.1
82;2021-08-02;1271;879;164672;140215;62.7;53.4
82;2021-08-03;1435;832;166107;141047;63.3;53.7
82;2021-08-04;1363;1029;167470;142076;63.8;54.1
82;2021-08-05;1491;600;168961;142676;64.3;54.3
82;2021-08-06;996;646;169957;143322;64.7;54.6
82;2021-08-07;923;1196;170880;144518;65.1;55.0
82;2021-08-08;157;65;171037;144583;65.1;55.1
82;2021-08-09;1071;899;172108;145482;65.5;55.4
82;2021-08-10;1290;917;173398;146399;66.0;55.7
82;2021-08-11;1264;1123;174662;147522;66.5;56.2
82;2021-08-12;1473;946;176135;148468;67.1;56.5
82;2021-08-13;1413;997;177548;149465;67.6;56.9
82;2021-08-14;314;486;177862;149951;67.7;57.1
82;2021-08-15;61;38;177923;149989;67.7;57.1
82;2021-08-16;781;1459;178704;151448;68.0;57.7
82;2021-08-17;1064;1236;179768;152684;68.5;58.1
82;2021-08-18;616;848;180384;153532;68.7;58.5
82;2021-08-19;1012;1146;181396;154678;69.1;58.9
82;2021-08-20;1034;1907;182430;156585;69.5;59.6
82;2021-08-21;495;990;182925;157575;69.7;60.0
82;2021-08-22;21;55;182946;157630;69.7;60.0
82;2021-08-23;745;1292;183691;158922;69.9;60.5
82;2021-08-24;863;1117;184554;160039;70.3;60.9
82;2021-08-25;849;1538;185403;161577;70.6;61.5
82;2021-08-26;598;1108;186001;162685;70.8;61.9
82;2021-08-27;898;1685;186899;164370;71.2;62.6
82;2021-08-28;211;616;187110;164986;71.2;62.8
82;2021-08-29;44;49;187154;165035;71.3;62.8
82;2021-08-30;430;1024;187584;166059;71.4;63.2
82;2021-08-31;339;1028;187923;167087;71.6;63.6
82;2021-09-01;721;1405;188644;168492;71.8;64.2
82;2021-09-02;406;1294;189050;169786;72.0;64.7
82;2021-09-03;500;1882;189550;171668;72.2;65.4
82;2021-09-04;426;741;189976;172409;72.3;65.7
82;2021-09-05;6;23;189982;172432;72.3;65.7
82;2021-09-06;373;1290;190355;173722;72.5;66.2
82;2021-09-07;209;962;190564;174684;72.6;66.5
82;2021-09-08;495;1259;191059;175943;72.8;67.0
82;2021-09-09;249;1045;191308;176988;72.8;67.4
82;2021-09-10;487;1459;191795;178447;73.0;67.9
82;2021-09-11;212;520;192007;178967;73.1;68.1
82;2021-09-12;10;29;192017;178996;73.1;68.2
82;2021-09-13;298;1114;192315;180110;73.2;68.6
82;2021-09-14;210;945;192525;181055;73.3;68.9
82;2021-09-15;307;1166;192832;182221;73.4;69.4
82;2021-09-16;220;495;193052;182716;73.5;69.6
82;2021-09-17;187;495;193239;183211;73.6;69.8
82;2021-09-18;326;1082;193565;184293;73.7;70.2
82;2021-09-19;1;14;193566;184307;73.7;70.2
82;2021-09-20;140;415;193706;184722;73.8;70.3
82;2021-09-21;94;382;193800;185104;73.8;70.5
82;2021-09-22;136;455;193936;185559;73.8;70.7
82;2021-09-23;112;382;194048;185941;73.9;70.8
82;2021-09-24;211;599;194259;186540;74.0;71.0
82;2021-09-25;231;658;194490;187198;74.1;71.3
82;2021-09-26;5;10;194495;187208;74.1;71.3
82;2021-09-27;100;453;194595;187661;74.1;71.5
82;2021-09-28;90;229;194685;187890;74.1;71.5
82;2021-09-29;231;479;194916;188369;74.2;71.7
82;2021-09-30;110;250;195026;188619;74.3;71.8
82;2021-10-01;196;372;195222;188991;74.3;72.0
82;2021-10-02;132;272;195354;189263;74.4;72.1
82;2021-10-03;1;1;195355;189264;74.4;72.1
82;2021-10-04;120;415;195475;189679;74.4;72.2
82;2021-10-05;128;273;195603;189952;74.5;72.3
82;2021-10-06;166;342;195769;190294;74.5;72.5
83;2020-12-27;1;0;1;0;0.0;0.0
83;2020-12-28;0;0;1;0;0.0;0.0
83;2020-12-29;2;0;3;0;0.0;0.0
83;2020-12-30;3;0;6;0;0.0;0.0
83;2020-12-31;0;0;6;0;0.0;0.0
83;2021-01-01;1;0;7;0;0.0;0.0
83;2021-01-02;0;0;7;0;0.0;0.0
83;2021-01-03;1;0;8;0;0.0;0.0
83;2021-01-04;1;0;9;0;0.0;0.0
83;2021-01-05;4;0;13;0;0.0;0.0
83;2021-01-06;69;0;82;0;0.0;0.0
83;2021-01-07;324;0;406;0;0.0;0.0
83;2021-01-08;421;0;827;0;0.1;0.0
83;2021-01-09;48;0;875;0;0.1;0.0
83;2021-01-10;1;0;876;0;0.1;0.0
83;2021-01-11;475;0;1351;0;0.1;0.0
83;2021-01-12;1015;4;2366;4;0.2;0.0
83;2021-01-13;963;7;3329;11;0.3;0.0
83;2021-01-14;847;5;4176;16;0.4;0.0
83;2021-01-15;714;2;4890;18;0.5;0.0
83;2021-01-16;42;1;4932;19;0.5;0.0
83;2021-01-17;1;0;4933;19;0.5;0.0
83;2021-01-18;1227;4;6160;23;0.6;0.0
83;2021-01-19;2020;6;8180;29;0.8;0.0
83;2021-01-20;1660;7;9840;36;0.9;0.0
83;2021-01-21;2099;7;11939;43;1.1;0.0
83;2021-01-22;1662;6;13601;49;1.3;0.0
83;2021-01-23;246;0;13847;49;1.3;0.0
83;2021-01-24;21;1;13868;50;1.3;0.0
83;2021-01-25;1556;7;15424;57;1.4;0.0
83;2021-01-26;1758;12;17182;69;1.6;0.0
83;2021-01-27;2154;79;19336;148;1.8;0.0
83;2021-01-28;5100;342;24436;490;2.3;0.0
83;2021-01-29;2951;317;27387;807;2.6;0.1
83;2021-01-30;237;42;27624;849;2.6;0.1
83;2021-01-31;46;0;27670;849;2.6;0.1
83;2021-02-01;1283;380;28953;1229;2.7;0.1
83;2021-02-02;1440;682;30393;1911;2.8;0.2
83;2021-02-03;1527;587;31920;2498;3.0;0.2
83;2021-02-04;1485;702;33405;3200;3.1;0.3
83;2021-02-05;1226;610;34631;3810;3.2;0.4
83;2021-02-06;24;12;34655;3822;3.2;0.4
83;2021-02-07;1;0;34656;3822;3.2;0.4
83;2021-02-08;1090;550;35746;4372;3.3;0.4
83;2021-02-09;1325;757;37071;5129;3.5;0.5
83;2021-02-10;1537;722;38608;5851;3.6;0.5
83;2021-02-11;1612;976;40220;6827;3.7;0.6
83;2021-02-12;1350;768;41570;7595;3.9;0.7
83;2021-02-13;55;21;41625;7616;3.9;0.7
83;2021-02-14;0;0;41625;7616;3.9;0.7
83;2021-02-15;677;768;42302;8384;3.9;0.8
83;2021-02-16;543;1073;42845;9457;4.0;0.9
83;2021-02-17;804;1501;43649;10958;4.1;1.0
83;2021-02-18;1630;3349;45279;14307;4.2;1.3
83;2021-02-19;1482;1999;46761;16306;4.4;1.5
83;2021-02-20;63;155;46824;16461;4.4;1.5
83;2021-02-21;25;33;46849;16494;4.4;1.5
83;2021-02-22;507;1382;47356;17876;4.4;1.7
83;2021-02-23;671;1133;48027;19009;4.5;1.8
83;2021-02-24;725;1175;48752;20184;4.5;1.9
83;2021-02-25;1250;1105;50002;21289;4.7;2.0
83;2021-02-26;1298;979;51300;22268;4.8;2.1
83;2021-02-27;552;50;51852;22318;4.8;2.1
83;2021-02-28;10;12;51862;22330;4.8;2.1
83;2021-03-01;808;986;52670;23316;4.9;2.2
83;2021-03-02;992;1067;53662;24383;5.0;2.3
83;2021-03-03;1440;1282;55102;25665;5.1;2.4
83;2021-03-04;1894;1165;56996;26830;5.3;2.5
83;2021-03-05;2221;1064;59217;27894;5.5;2.6
83;2021-03-06;3010;111;62227;28005;5.8;2.6
83;2021-03-07;2227;44;64454;28049;6.0;2.6
83;2021-03-08;851;1104;65305;29153;6.1;2.7
83;2021-03-09;1938;1037;67243;30190;6.3;2.8
83;2021-03-10;2381;1230;69624;31420;6.5;2.9
83;2021-03-11;3677;2041;73301;33461;6.8;3.1
83;2021-03-12;3661;1379;76962;34840;7.2;3.2
83;2021-03-13;4614;174;81576;35014;7.6;3.3
83;2021-03-14;2341;55;83917;35069;7.8;3.3
83;2021-03-15;3339;650;87256;35719;8.1;3.3
83;2021-03-16;2601;663;89857;36382;8.4;3.4
83;2021-03-17;2846;740;92703;37122;8.6;3.5
83;2021-03-18;3549;782;96252;37904;9.0;3.5
83;2021-03-19;4175;582;100427;38486;9.4;3.6
83;2021-03-20;3477;71;103904;38557;9.7;3.6
83;2021-03-21;2011;32;105915;38589;9.9;3.6
83;2021-03-22;3965;886;109880;39475;10.2;3.7
83;2021-03-23;4751;579;114631;40054;10.7;3.7
83;2021-03-24;5050;708;119681;40762;11.1;3.8
83;2021-03-25;6534;844;126215;41606;11.8;3.9
83;2021-03-26;7174;749;133389;42355;12.4;3.9
83;2021-03-27;3969;383;137358;42738;12.8;4.0
83;2021-03-28;2183;34;139541;42772;13.0;4.0
83;2021-03-29;4557;760;144098;43532;13.4;4.1
83;2021-03-30;5969;940;150067;44472;14.0;4.1
83;2021-03-31;5554;1070;155621;45542;14.5;4.2
83;2021-04-01;5980;1250;161601;46792;15.0;4.4
83;2021-04-02;5762;1068;167363;47860;15.6;4.5
83;2021-04-03;1800;628;169163;48488;15.8;4.5
83;2021-04-04;854;345;170017;48833;15.8;4.5
83;2021-04-05;190;64;170207;48897;15.9;4.6
83;2021-04-06;4731;1394;174938;50291;16.3;4.7
83;2021-04-07;5832;1657;180770;51948;16.8;4.8
83;2021-04-08;7893;2001;188663;53949;17.6;5.0
83;2021-04-09;7599;2200;196262;56149;18.3;5.2
83;2021-04-10;2948;2643;199210;58792;18.6;5.5
83;2021-04-11;1715;2131;200925;60923;18.7;5.7
83;2021-04-12;4951;2855;205876;63778;19.2;5.9
83;2021-04-13;5408;2992;211284;66770;19.7;6.2
83;2021-04-14;5896;2935;217180;69705;20.2;6.5
83;2021-04-15;6774;3034;223954;72739;20.9;6.8
83;2021-04-16;6127;3516;230081;76255;21.4;7.1
83;2021-04-17;3510;2185;233591;78440;21.8;7.3
83;2021-04-18;2179;1292;235770;79732;22.0;7.4
83;2021-04-19;4113;3898;239883;83630;22.3;7.8
83;2021-04-20;4360;3866;244243;87496;22.7;8.1
83;2021-04-21;4300;4144;248543;91640;23.1;8.5
83;2021-04-22;5009;4292;253552;95932;23.6;8.9
83;2021-04-23;4528;4562;258080;100494;24.0;9.4
83;2021-04-24;2629;2711;260709;103205;24.3;9.6
83;2021-04-25;1925;1571;262634;104776;24.5;9.8
83;2021-04-26;3568;3849;266202;108625;24.8;10.1
83;2021-04-27;4140;4534;270342;113159;25.2;10.5
83;2021-04-28;4314;4358;274656;117517;25.6;10.9
83;2021-04-29;5822;5108;280478;122625;26.1;11.4
83;2021-04-30;5786;4288;286264;126913;26.7;11.8
83;2021-05-01;1693;430;287957;127343;26.8;11.9
83;2021-05-02;1237;758;289194;128101;26.9;11.9
83;2021-05-03;3750;4282;292944;132383;27.3;12.3
83;2021-05-04;3345;5095;296289;137478;27.6;12.8
83;2021-05-05;3643;4972;299932;142450;27.9;13.3
83;2021-05-06;4678;4950;304610;147400;28.4;13.7
83;2021-05-07;4165;5307;308775;152707;28.8;14.2
83;2021-05-08;2764;1012;311539;153719;29.0;14.3
83;2021-05-09;2151;1236;313690;154955;29.2;14.4
83;2021-05-10;3201;5416;316891;160371;29.5;14.9
83;2021-05-11;5126;5684;322017;166055;30.0;15.5
83;2021-05-12;6292;4846;328309;170901;30.6;15.9
83;2021-05-13;6582;1343;334891;172244;31.2;16.0
83;2021-05-14;7422;4116;342313;176360;31.9;16.4
83;2021-05-15;7751;2205;350064;178565;32.6;16.6
83;2021-05-16;6625;1248;356689;179813;33.2;16.7
83;2021-05-17;4893;4209;361582;184022;33.7;17.1
83;2021-05-18;5533;3862;367115;187884;34.2;17.5
83;2021-05-19;6205;3410;373320;191294;34.8;17.8
83;2021-05-20;6752;3805;380072;195099;35.4;18.2
83;2021-05-21;7904;3864;387976;198963;36.1;18.5
83;2021-05-22;6087;1719;394063;200682;36.7;18.7
83;2021-05-23;4682;713;398745;201395;37.1;18.8
83;2021-05-24;5809;973;404554;202368;37.7;18.8
83;2021-05-25;5510;4755;410064;207123;38.2;19.3
83;2021-05-26;4858;4447;414922;211570;38.6;19.7
83;2021-05-27;5068;5250;419990;216820;39.1;20.2
83;2021-05-28;4503;5755;424493;222575;39.5;20.7
83;2021-05-29;2706;4266;427199;226841;39.8;21.1
83;2021-05-30;1256;1372;428455;228213;39.9;21.3
83;2021-05-31;5487;4763;433942;232976;40.4;21.7
83;2021-06-01;5732;5290;439674;238266;40.9;22.2
83;2021-06-02;5262;4581;444936;242847;41.4;22.6
83;2021-06-03;5744;5128;450680;247975;42.0;23.1
83;2021-06-04;5444;6040;456124;254015;42.5;23.7
83;2021-06-05;3919;3197;460043;257212;42.8;24.0
83;2021-06-06;1933;1383;461976;258595;43.0;24.1
83;2021-06-07;3913;5088;465889;263683;43.4;24.6
83;2021-06-08;4174;4816;470063;268499;43.8;25.0
83;2021-06-09;4007;4700;474070;273199;44.1;25.4
83;2021-06-10;3999;4261;478069;277460;44.5;25.8
83;2021-06-11;3657;5447;481726;282907;44.9;26.3
83;2021-06-12;2913;2982;484639;285889;45.1;26.6
83;2021-06-13;995;1390;485634;287279;45.2;26.8
83;2021-06-14;2853;5651;488487;292930;45.5;27.3
83;2021-06-15;3166;4859;491653;297789;45.8;27.7
83;2021-06-16;2963;4503;494616;302292;46.1;28.2
83;2021-06-17;2784;5287;497400;307579;46.3;28.6
83;2021-06-18;3160;5965;500560;313544;46.6;29.2
83;2021-06-19;2323;4100;502883;317644;46.8;29.6
83;2021-06-20;676;1889;503559;319533;46.9;29.8
83;2021-06-21;2109;7585;505668;327118;47.1;30.5
83;2021-06-22;2103;7162;507771;334280;47.3;31.1
83;2021-06-23;1935;6929;509706;341209;47.5;31.8
83;2021-06-24;1962;7364;511668;348573;47.6;32.5
83;2021-06-25;2111;8394;513779;356967;47.8;33.2
83;2021-06-26;1462;6808;515241;363775;48.0;33.9
83;2021-06-27;692;3184;515933;366959;48.0;34.2
83;2021-06-28;1570;7880;517503;374839;48.2;34.9
83;2021-06-29;1907;7808;519410;382647;48.4;35.6
83;2021-06-30;2240;7274;521650;389921;48.6;36.3
83;2021-07-01;2562;6565;524212;396486;48.8;36.9
83;2021-07-02;2265;7798;526477;404284;49.0;37.6
83;2021-07-03;1509;5685;527986;409969;49.2;38.2
83;2021-07-04;572;2752;528558;412721;49.2;38.4
83;2021-07-05;1925;7531;530483;420252;49.4;39.1
83;2021-07-06;2571;5940;533054;426192;49.6;39.7
83;2021-07-07;2686;4667;535740;430859;49.9;40.1
83;2021-07-08;3246;4472;538986;435331;50.2;40.5
83;2021-07-09;3045;6964;542031;442295;50.5;41.2
83;2021-07-10;1579;4926;543610;447221;50.6;41.6
83;2021-07-11;1009;1766;544619;448987;50.7;41.8
83;2021-07-12;2142;7688;546761;456675;50.9;42.5
83;2021-07-13;4042;7093;550803;463768;51.3;43.2
83;2021-07-14;2094;1321;552897;465089;51.5;43.3
83;2021-07-15;4578;6843;557475;471932;51.9;43.9
83;2021-07-16;5274;7118;562749;479050;52.4;44.6
83;2021-07-17;3648;4999;566397;484049;52.7;45.1
83;2021-07-18;1604;1311;568001;485360;52.9;45.2
83;2021-07-19;3954;6316;571955;491676;53.3;45.8
83;2021-07-20;5986;6189;577941;497865;53.8;46.4
83;2021-07-21;6031;5215;583972;503080;54.4;46.8
83;2021-07-22;7118;5539;591090;508619;55.0;47.4
83;2021-07-23;7097;5918;598187;514537;55.7;47.9
83;2021-07-24;4650;4561;602837;519098;56.1;48.3
83;2021-07-25;1329;737;604166;519835;56.3;48.4
83;2021-07-26;5545;4937;609711;524772;56.8;48.9
83;2021-07-27;6833;4903;616544;529675;57.4;49.3
83;2021-07-28;6601;4426;623145;534101;58.0;49.7
83;2021-07-29;7500;4859;630645;538960;58.7;50.2
83;2021-07-30;6968;4761;637613;543721;59.4;50.6
83;2021-07-31;4667;3217;642280;546938;59.8;50.9
83;2021-08-01;1066;849;643346;547787;59.9;51.0
83;2021-08-02;5771;3707;649117;551494;60.4;51.4
83;2021-08-03;6385;3997;655502;555491;61.0;51.7
83;2021-08-04;5915;3712;661417;559203;61.6;52.1
83;2021-08-05;6182;4088;667599;563291;62.2;52.5
83;2021-08-06;6162;4915;673761;568206;62.7;52.9
83;2021-08-07;3751;3557;677512;571763;63.1;53.2
83;2021-08-08;1064;823;678576;572586;63.2;53.3
83;2021-08-09;4718;4647;683294;577233;63.6;53.8
83;2021-08-10;5235;5146;688529;582379;64.1;54.2
83;2021-08-11;4592;5067;693121;587446;64.5;54.7
83;2021-08-12;4928;5568;698049;593014;65.0;55.2
83;2021-08-13;4938;5741;702987;598755;65.5;55.8
83;2021-08-14;3223;3892;706210;602647;65.8;56.1
83;2021-08-15;208;392;706418;603039;65.8;56.2
83;2021-08-16;3629;5482;710047;608521;66.1;56.7
83;2021-08-17;3577;5271;713624;613792;66.5;57.2
83;2021-08-18;3605;5003;717229;618795;66.8;57.6
83;2021-08-19;4178;6261;721407;625056;67.2;58.2
83;2021-08-20;3642;6516;725049;631572;67.5;58.8
83;2021-08-21;2347;4489;727396;636061;67.7;59.2
83;2021-08-22;635;1033;728031;637094;67.8;59.3
83;2021-08-23;2506;5787;730537;642881;68.0;59.9
83;2021-08-24;2924;5922;733461;648803;68.3;60.4
83;2021-08-25;2583;5294;736044;654097;68.5;60.9
83;2021-08-26;2797;5844;738841;659941;68.8;61.5
83;2021-08-27;2918;5924;741759;665865;69.1;62.0
83;2021-08-28;1935;4539;743694;670404;69.3;62.4
83;2021-08-29;476;1161;744170;671565;69.3;62.5
83;2021-08-30;2383;4976;746553;676541;69.5;63.0
83;2021-08-31;2509;5481;749062;682022;69.8;63.5
83;2021-09-01;2546;5084;751608;687106;70.0;64.0
83;2021-09-02;2483;4971;754091;692077;70.2;64.4
83;2021-09-03;2327;5251;756418;697328;70.4;64.9
83;2021-09-04;1924;4644;758342;701972;70.6;65.4
83;2021-09-05;568;543;758910;702515;70.7;65.4
83;2021-09-06;1643;4111;760553;706626;70.8;65.8
83;2021-09-07;1664;3876;762217;710502;71.0;66.2
83;2021-09-08;1932;3861;764149;714363;71.2;66.5
83;2021-09-09;1493;3924;765642;718287;71.3;66.9
83;2021-09-10;1776;4337;767418;722624;71.5;67.3
83;2021-09-11;1371;3885;768789;726509;71.6;67.7
83;2021-09-12;204;498;768993;727007;71.6;67.7
83;2021-09-13;1212;3369;770205;730376;71.7;68.0
83;2021-09-14;1319;3488;771524;733864;71.8;68.3
83;2021-09-15;1360;2537;772884;736401;72.0;68.6
83;2021-09-16;1036;2175;773920;738576;72.1;68.8
83;2021-09-17;1031;2523;774951;741099;72.2;69.0
83;2021-09-18;1020;3000;775971;744099;72.3;69.3
83;2021-09-19;97;399;776068;744498;72.3;69.3
83;2021-09-20;673;2034;776741;746532;72.3;69.5
83;2021-09-21;718;1808;777459;748340;72.4;69.7
83;2021-09-22;760;2493;778219;750833;72.5;69.9
83;2021-09-23;715;2112;778934;752945;72.5;70.1
83;2021-09-24;721;2194;779655;755139;72.6;70.3
83;2021-09-25;736;2665;780391;757804;72.7;70.6
83;2021-09-26;71;449;780462;758253;72.7;70.6
83;2021-09-27;592;1729;781054;759982;72.7;70.8
83;2021-09-28;542;1504;781596;761486;72.8;70.9
83;2021-09-29;714;1879;782310;763365;72.9;71.1
83;2021-09-30;635;1505;782945;764870;72.9;71.2
83;2021-10-01;743;1529;783688;766399;73.0;71.4
83;2021-10-02;687;1617;784375;768016;73.0;71.5
83;2021-10-03;108;254;784483;768270;73.1;71.5
83;2021-10-04;478;886;784961;769156;73.1;71.6
83;2021-10-05;578;1109;785539;770265;73.2;71.7
83;2021-10-06;731;1545;786270;771810;73.2;71.9
84;2020-12-27;1;0;1;0;0.0;0.0
84;2020-12-28;1;0;2;0;0.0;0.0
84;2020-12-29;3;0;5;0;0.0;0.0
84;2020-12-30;2;0;7;0;0.0;0.0
84;2020-12-31;2;0;9;0;0.0;0.0
84;2021-01-01;0;0;9;0;0.0;0.0
84;2021-01-02;0;0;9;0;0.0;0.0
84;2021-01-03;0;0;9;0;0.0;0.0
84;2021-01-04;0;0;9;0;0.0;0.0
84;2021-01-05;0;0;9;0;0.0;0.0
84;2021-01-06;0;0;9;0;0.0;0.0
84;2021-01-07;69;0;78;0;0.0;0.0
84;2021-01-08;84;0;162;0;0.0;0.0
84;2021-01-09;31;0;193;0;0.0;0.0
84;2021-01-10;0;0;193;0;0.0;0.0
84;2021-01-11;219;0;412;0;0.1;0.0
84;2021-01-12;624;2;1036;2;0.2;0.0
84;2021-01-13;359;0;1395;2;0.2;0.0
84;2021-01-14;959;12;2354;14;0.4;0.0
84;2021-01-15;619;9;2973;23;0.5;0.0
84;2021-01-16;167;0;3140;23;0.6;0.0
84;2021-01-17;29;1;3169;24;0.6;0.0
84;2021-01-18;697;2;3866;26;0.7;0.0
84;2021-01-19;881;2;4747;28;0.8;0.0
84;2021-01-20;1023;3;5770;31;1.0;0.0
84;2021-01-21;1050;5;6820;36;1.2;0.0
84;2021-01-22;1135;1;7955;37;1.4;0.0
84;2021-01-23;250;0;8205;37;1.5;0.0
84;2021-01-24;3;0;8208;37;1.5;0.0
84;2021-01-25;809;0;9017;37;1.6;0.0
84;2021-01-26;940;4;9957;41;1.8;0.0
84;2021-01-27;1073;2;11030;43;2.0;0.0
84;2021-01-28;1622;17;12652;60;2.3;0.0
84;2021-01-29;1203;57;13855;117;2.5;0.0
84;2021-01-30;171;16;14026;133;2.5;0.0
84;2021-01-31;7;0;14033;133;2.5;0.0
84;2021-02-01;660;124;14693;257;2.6;0.0
84;2021-02-02;789;245;15482;502;2.8;0.1
84;2021-02-03;762;228;16244;730;2.9;0.1
84;2021-02-04;912;370;17156;1100;3.1;0.2
84;2021-02-05;727;377;17883;1477;3.2;0.3
84;2021-02-06;127;40;18010;1517;3.2;0.3
84;2021-02-07;1;0;18011;1517;3.2;0.3
84;2021-02-08;569;231;18580;1748;3.3;0.3
84;2021-02-09;694;610;19274;2358;3.4;0.4
84;2021-02-10;560;491;19834;2849;3.5;0.5
84;2021-02-11;549;491;20383;3340;3.6;0.6
84;2021-02-12;562;592;20945;3932;3.7;0.7
84;2021-02-13;48;138;20993;4070;3.7;0.7
84;2021-02-14;3;0;20996;4070;3.7;0.7
84;2021-02-15;207;717;21203;4787;3.8;0.9
84;2021-02-16;223;672;21426;5459;3.8;1.0
84;2021-02-17;448;651;21874;6110;3.9;1.1
84;2021-02-18;557;936;22431;7046;4.0;1.3
84;2021-02-19;739;979;23170;8025;4.1;1.4
84;2021-02-20;68;114;23238;8139;4.1;1.5
84;2021-02-21;6;35;23244;8174;4.1;1.5
84;2021-02-22;369;613;23613;8787;4.2;1.6
84;2021-02-23;272;604;23885;9391;4.3;1.7
84;2021-02-24;395;603;24280;9994;4.3;1.8
84;2021-02-25;714;699;24994;10693;4.5;1.9
84;2021-02-26;823;568;25817;11261;4.6;2.0
84;2021-02-27;133;100;25950;11361;4.6;2.0
84;2021-02-28;18;0;25968;11361;4.6;2.0
84;2021-03-01;458;548;26426;11909;4.7;2.1
84;2021-03-02;633;696;27059;12605;4.8;2.2
84;2021-03-03;820;815;27879;13420;5.0;2.4
84;2021-03-04;1099;612;28978;14032;5.2;2.5
84;2021-03-05;1313;475;30291;14507;5.4;2.6
84;2021-03-06;1459;64;31750;14571;5.7;2.6
84;2021-03-07;481;16;32231;14587;5.7;2.6
84;2021-03-08;813;539;33044;15126;5.9;2.7
84;2021-03-09;1389;700;34433;15826;6.1;2.8
84;2021-03-10;1475;605;35908;16431;6.4;2.9
84;2021-03-11;1983;600;37891;17031;6.8;3.0
84;2021-03-12;2083;576;39974;17607;7.1;3.1
84;2021-03-13;747;36;40721;17643;7.3;3.1
84;2021-03-14;247;53;40968;17696;7.3;3.2
84;2021-03-15;1071;300;42039;17996;7.5;3.2
84;2021-03-16;1178;313;43217;18309;7.7;3.3
84;2021-03-17;1147;423;44364;18732;7.9;3.3
84;2021-03-18;1458;387;45822;19119;8.2;3.4
84;2021-03-19;2179;454;48001;19573;8.6;3.5
84;2021-03-20;841;27;48842;19600;8.7;3.5
84;2021-03-21;151;11;48993;19611;8.7;3.5
84;2021-03-22;1162;461;50155;20072;8.9;3.6
84;2021-03-23;1914;429;52069;20501;9.3;3.7
84;2021-03-24;2177;394;54246;20895;9.7;3.7
84;2021-03-25;3655;392;57901;21287;10.3;3.8
84;2021-03-26;3319;473;61220;21760;10.9;3.9
84;2021-03-27;915;59;62135;21819;11.1;3.9
84;2021-03-28;74;2;62209;21821;11.1;3.9
84;2021-03-29;1717;528;63926;22349;11.4;4.0
84;2021-03-30;2674;688;66600;23037;11.9;4.1
84;2021-03-31;2405;638;69005;23675;12.3;4.2
84;2021-04-01;3021;575;72026;24250;12.8;4.3
84;2021-04-02;2452;526;74478;24776;13.3;4.4
84;2021-04-03;510;29;74988;24805;13.4;4.4
84;2021-04-04;14;0;75002;24805;13.4;4.4
84;2021-04-05;814;100;75816;24905;13.5;4.4
84;2021-04-06;2145;840;77961;25745;13.9;4.6
84;2021-04-07;2405;862;80366;26607;14.3;4.7
84;2021-04-08;3652;1042;84018;27649;15.0;4.9
84;2021-04-09;4116;947;88134;28596;15.7;5.1
84;2021-04-10;1308;131;89442;28727;15.9;5.1
84;2021-04-11;37;12;89479;28739;15.9;5.1
84;2021-04-12;2093;806;91572;29545;16.3;5.3
84;2021-04-13;2940;1364;94512;30909;16.8;5.5
84;2021-04-14;2811;1350;97323;32259;17.3;5.8
84;2021-04-15;3270;1417;100593;33676;17.9;6.0
84;2021-04-16;3431;1551;104024;35227;18.5;6.3
84;2021-04-17;1666;201;105690;35428;18.8;6.3
84;2021-04-18;38;1;105728;35429;18.8;6.3
84;2021-04-19;2507;922;108235;36351;19.3;6.5
84;2021-04-20;2628;1527;110863;37878;19.8;6.8
84;2021-04-21;2651;1482;113514;39360;20.2;7.0
84;2021-04-22;3014;1741;116528;41101;20.8;7.3
84;2021-04-23;3042;1909;119570;43010;21.3;7.7
84;2021-04-24;1530;288;121100;43298;21.6;7.7
84;2021-04-25;27;2;121127;43300;21.6;7.7
84;2021-04-26;2198;1364;123325;44664;22.0;8.0
84;2021-04-27;2556;1977;125881;46641;22.4;8.3
84;2021-04-28;2818;1843;128699;48484;22.9;8.6
84;2021-04-29;3420;2047;132119;50531;23.6;9.0
84;2021-04-30;3134;2424;135253;52955;24.1;9.4
84;2021-05-01;457;259;135710;53214;24.2;9.5
84;2021-05-02;2;0;135712;53214;24.2;9.5
84;2021-05-03;2161;1626;137873;54840;24.6;9.8
84;2021-05-04;2488;2537;140361;57377;25.0;10.2
84;2021-05-05;2353;2225;142714;59602;25.4;10.6
84;2021-05-06;3223;2258;145937;61860;26.0;11.0
84;2021-05-07;2766;2559;148703;64419;26.5;11.5
84;2021-05-08;1158;527;149861;64946;26.7;11.6
84;2021-05-09;8;53;149869;64999;26.7;11.6
84;2021-05-10;2159;2466;152028;67465;27.1;12.0
84;2021-05-11;2905;3153;154933;70618;27.6;12.6
84;2021-05-12;2849;2920;157782;73538;28.1;13.1
84;2021-05-13;2160;848;159942;74386;28.5;13.3
84;2021-05-14;2728;2037;162670;76423;29.0;13.6
84;2021-05-15;2001;986;164671;77409;29.4;13.8
84;2021-05-16;1340;188;166011;77597;29.6;13.8
84;2021-05-17;2224;2156;168235;79753;30.0;14.2
84;2021-05-18;2904;2113;171139;81866;30.5;14.6
84;2021-05-19;3230;1665;174369;83531;31.1;14.9
84;2021-05-20;3698;2208;178067;85739;31.7;15.3
84;2021-05-21;3471;2332;181538;88071;32.4;15.7
84;2021-05-22;1582;684;183120;88755;32.6;15.8
84;2021-05-23;6;9;183126;88764;32.6;15.8
84;2021-05-24;1840;425;184966;89189;33.0;15.9
84;2021-05-25;2984;2187;187950;91376;33.5;16.3
84;2021-05-26;3075;2090;191025;93466;34.1;16.7
84;2021-05-27;3857;2314;194882;95780;34.7;17.1
84;2021-05-28;3179;3303;198061;99083;35.3;17.7
84;2021-05-29;1093;1648;199154;100731;35.5;18.0
84;2021-05-30;10;85;199164;100816;35.5;18.0
84;2021-05-31;2191;2638;201355;103454;35.9;18.4
84;2021-06-01;3141;3158;204496;106612;36.5;19.0
84;2021-06-02;3170;2630;207666;109242;37.0;19.5
84;2021-06-03;4115;2999;211781;112241;37.8;20.0
84;2021-06-04;3614;3022;215395;115263;38.4;20.5
84;2021-06-05;1781;1501;217176;116764;38.7;20.8
84;2021-06-06;984;208;218160;116972;38.9;20.9
84;2021-06-07;2451;2758;220611;119730;39.3;21.3
84;2021-06-08;3317;3055;223928;122785;39.9;21.9
84;2021-06-09;3033;2688;226961;125473;40.5;22.4
84;2021-06-10;3512;2794;230473;128267;41.1;22.9
84;2021-06-11;3031;3069;233504;131336;41.6;23.4
84;2021-06-12;1965;1308;235469;132644;42.0;23.6
84;2021-06-13;413;213;235882;132857;42.0;23.7
84;2021-06-14;1930;3153;237812;136010;42.4;24.2
84;2021-06-15;2573;3453;240385;139463;42.8;24.9
84;2021-06-16;2527;2962;242912;142425;43.3;25.4
84;2021-06-17;2992;3479;245904;145904;43.8;26.0
84;2021-06-18;2424;3553;248328;149457;44.3;26.6
84;2021-06-19;1287;1552;249615;151009;44.5;26.9
84;2021-06-20;546;354;250161;151363;44.6;27.0
84;2021-06-21;1570;3135;251731;154498;44.9;27.5
84;2021-06-22;2163;4010;253894;158508;45.3;28.3
84;2021-06-23;2117;3306;256011;161814;45.6;28.8
84;2021-06-24;2201;3483;258212;165297;46.0;29.5
84;2021-06-25;1836;3889;260048;169186;46.4;30.2
84;2021-06-26;1133;1817;261181;171003;46.6;30.5
84;2021-06-27;297;345;261478;171348;46.6;30.5
84;2021-06-28;1207;3224;262685;174572;46.8;31.1
84;2021-06-29;1477;4051;264162;178623;47.1;31.8
84;2021-06-30;1716;3969;265878;182592;47.4;32.5
84;2021-07-01;1819;3956;267697;186548;47.7;33.3
84;2021-07-02;1764;3898;269461;190446;48.0;33.9
84;2021-07-03;1102;2030;270563;192476;48.2;34.3
84;2021-07-04;395;417;270958;192893;48.3;34.4
84;2021-07-05;1550;3540;272508;196433;48.6;35.0
84;2021-07-06;1638;4164;274146;200597;48.9;35.8
84;2021-07-07;1676;3102;275822;203699;49.2;36.3
84;2021-07-08;2158;3742;277980;207441;49.6;37.0
84;2021-07-09;1874;3970;279854;211411;49.9;37.7
84;2021-07-10;1253;2162;281107;213573;50.1;38.1
84;2021-07-11;354;300;281461;213873;50.2;38.1
84;2021-07-12;1409;3836;282870;217709;50.4;38.8
84;2021-07-13;2334;5008;285204;222717;50.8;39.7
84;2021-07-14;1885;1249;287089;223966;51.2;39.9
84;2021-07-15;2708;4557;289797;228523;51.7;40.7
84;2021-07-16;2778;4603;292575;233126;52.2;41.6
84;2021-07-17;1588;2449;294163;235575;52.4;42.0
84;2021-07-18;1017;552;295180;236127;52.6;42.1
84;2021-07-19;2416;3743;297596;239870;53.0;42.8
84;2021-07-20;2954;4167;300550;244037;53.6;43.5
84;2021-07-21;3187;3653;303737;247690;54.1;44.2
84;2021-07-22;3777;3791;307514;251481;54.8;44.8
84;2021-07-23;3520;3680;311034;255161;55.4;45.5
84;2021-07-24;1470;2249;312504;257410;55.7;45.9
84;2021-07-25;1033;513;313537;257923;55.9;46.0
84;2021-07-26;2725;3038;316262;260961;56.4;46.5
84;2021-07-27;3443;3568;319705;264529;57.0;47.2
84;2021-07-28;3866;3307;323571;267836;57.7;47.7
84;2021-07-29;4224;3158;327795;270994;58.4;48.3
84;2021-07-30;4027;3326;331822;274320;59.1;48.9
84;2021-07-31;2000;1694;333822;276014;59.5;49.2
84;2021-08-01;819;437;334641;276451;59.7;49.3
84;2021-08-02;2992;2695;337633;279146;60.2;49.8
84;2021-08-03;4108;2795;341741;281941;60.9;50.3
84;2021-08-04;3919;2612;345660;284553;61.6;50.7
84;2021-08-05;3888;2586;349548;287139;62.3;51.2
84;2021-08-06;3695;2868;353243;290007;63.0;51.7
84;2021-08-07;2078;1744;355321;291751;63.3;52.0
84;2021-08-08;386;735;355707;292486;63.4;52.1
84;2021-08-09;2939;2604;358646;295090;63.9;52.6
84;2021-08-10;3745;2957;362391;298047;64.6;53.1
84;2021-08-11;3269;2676;365660;300723;65.2;53.6
84;2021-08-12;3173;2977;368833;303700;65.7;54.1
84;2021-08-13;2924;2702;371757;306402;66.3;54.6
84;2021-08-14;1736;1746;373493;308148;66.6;54.9
84;2021-08-15;314;227;373807;308375;66.6;55.0
84;2021-08-16;2452;3086;376259;311461;67.1;55.5
84;2021-08-17;2736;3260;378995;314721;67.6;56.1
84;2021-08-18;2418;2800;381413;317521;68.0;56.6
84;2021-08-19;2278;3120;383691;320641;68.4;57.2
84;2021-08-20;2199;3307;385890;323948;68.8;57.7
84;2021-08-21;1228;1886;387118;325834;69.0;58.1
84;2021-08-22;167;738;387285;326572;69.0;58.2
84;2021-08-23;1776;3297;389061;329869;69.4;58.8
84;2021-08-24;1924;3469;390985;333338;69.7;59.4
84;2021-08-25;1845;3352;392830;336690;70.0;60.0
84;2021-08-26;1640;3628;394470;340318;70.3;60.7
84;2021-08-27;1630;3814;396100;344132;70.6;61.3
84;2021-08-28;921;2181;397021;346313;70.8;61.7
84;2021-08-29;174;607;397195;346920;70.8;61.8
84;2021-08-30;1390;3278;398585;350198;71.0;62.4
84;2021-08-31;1366;4153;399951;354351;71.3;63.2
84;2021-09-01;1250;3595;401201;357946;71.5;63.8
84;2021-09-02;1210;3209;402411;361155;71.7;64.4
84;2021-09-03;1280;3551;403691;364706;72.0;65.0
84;2021-09-04;777;2178;404468;366884;72.1;65.4
84;2021-09-05;124;475;404592;367359;72.1;65.5
84;2021-09-06;815;2476;405407;369835;72.3;65.9
84;2021-09-07;1027;2752;406434;372587;72.4;66.4
84;2021-09-08;911;2915;407345;375502;72.6;66.9
84;2021-09-09;887;2439;408232;377941;72.8;67.4
84;2021-09-10;939;2909;409171;380850;72.9;67.9
84;2021-09-11;575;1915;409746;382765;73.0;68.2
84;2021-09-12;117;302;409863;383067;73.1;68.3
84;2021-09-13;700;1936;410563;385003;73.2;68.6
84;2021-09-14;816;2041;411379;387044;73.3;69.0
84;2021-09-15;823;1933;412202;388977;73.5;69.3
84;2021-09-16;601;1334;412803;390311;73.6;69.6
84;2021-09-17;612;1613;413415;391924;73.7;69.9
84;2021-09-18;516;1497;413931;393421;73.8;70.1
84;2021-09-19;46;177;413977;393598;73.8;70.2
84;2021-09-20;326;891;414303;394489;73.9;70.3
84;2021-09-21;363;1113;414666;395602;73.9;70.5
84;2021-09-22;419;1589;415085;397191;74.0;70.8
84;2021-09-23;398;1116;415483;398307;74.1;71.0
84;2021-09-24;396;1250;415879;399557;74.1;71.2
84;2021-09-25;323;1246;416202;400803;74.2;71.4
84;2021-09-26;53;142;416255;400945;74.2;71.5
84;2021-09-27;313;787;416568;401732;74.3;71.6
84;2021-09-28;310;756;416878;402488;74.3;71.7
84;2021-09-29;350;1221;417228;403709;74.4;72.0
84;2021-09-30;371;918;417599;404627;74.4;72.1
84;2021-10-01;439;852;418038;405479;74.5;72.3
84;2021-10-02;249;752;418287;406231;74.6;72.4
84;2021-10-03;37;94;418324;406325;74.6;72.4
84;2021-10-04;296;548;418620;406873;74.6;72.5
84;2021-10-05;329;523;418949;407396;74.7;72.6
84;2021-10-06;345;821;419294;408217;74.7;72.8
85;2020-12-27;1;0;1;0;0.0;0.0
85;2020-12-28;0;0;1;0;0.0;0.0
85;2020-12-29;0;0;1;0;0.0;0.0
85;2020-12-30;0;0;1;0;0.0;0.0
85;2020-12-31;0;0;1;0;0.0;0.0
85;2021-01-01;0;0;1;0;0.0;0.0
85;2021-01-02;0;0;1;0;0.0;0.0
85;2021-01-03;1;0;2;0;0.0;0.0
85;2021-01-04;26;0;28;0;0.0;0.0
85;2021-01-05;62;0;90;0;0.0;0.0
85;2021-01-06;107;1;197;1;0.0;0.0
85;2021-01-07;203;0;400;1;0.1;0.0
85;2021-01-08;293;2;693;3;0.1;0.0
85;2021-01-09;288;1;981;4;0.1;0.0
85;2021-01-10;59;0;1040;4;0.2;0.0
85;2021-01-11;453;0;1493;4;0.2;0.0
85;2021-01-12;584;1;2077;5;0.3;0.0
85;2021-01-13;545;2;2622;7;0.4;0.0
85;2021-01-14;685;4;3307;11;0.5;0.0
85;2021-01-15;439;2;3746;13;0.5;0.0
85;2021-01-16;263;2;4009;15;0.6;0.0
85;2021-01-17;37;0;4046;15;0.6;0.0
85;2021-01-18;999;1;5045;16;0.7;0.0
85;2021-01-19;1429;10;6474;26;0.9;0.0
85;2021-01-20;1891;2;8365;28;1.2;0.0
85;2021-01-21;3221;7;11586;35;1.7;0.0
85;2021-01-22;1700;17;13286;52;1.9;0.0
85;2021-01-23;466;1;13752;53;2.0;0.0
85;2021-01-24;50;0;13802;53;2.0;0.0
85;2021-01-25;577;0;14379;53;2.1;0.0
85;2021-01-26;878;33;15257;86;2.2;0.0
85;2021-01-27;1809;32;17066;118;2.5;0.0
85;2021-01-28;1637;39;18703;157;2.7;0.0
85;2021-01-29;875;63;19578;220;2.9;0.0
85;2021-01-30;149;5;19727;225;2.9;0.0
85;2021-01-31;2;40;19729;265;2.9;0.0
85;2021-02-01;484;98;20213;363;3.0;0.1
85;2021-02-02;535;170;20748;533;3.0;0.1
85;2021-02-03;415;248;21163;781;3.1;0.1
85;2021-02-04;623;252;21786;1033;3.2;0.2
85;2021-02-05;624;253;22410;1286;3.3;0.2
85;2021-02-06;157;211;22567;1497;3.3;0.2
85;2021-02-07;1;0;22568;1497;3.3;0.2
85;2021-02-08;390;497;22958;1994;3.4;0.3
85;2021-02-09;663;981;23621;2975;3.5;0.4
85;2021-02-10;583;1035;24204;4010;3.5;0.6
85;2021-02-11;1524;2784;25728;6794;3.8;1.0
85;2021-02-12;1015;1162;26743;7956;3.9;1.2
85;2021-02-13;251;432;26994;8388;4.0;1.2
85;2021-02-14;2;84;26996;8472;4.0;1.2
85;2021-02-15;336;646;27332;9118;4.0;1.3
85;2021-02-16;569;957;27901;10075;4.1;1.5
85;2021-02-17;784;1451;28685;11526;4.2;1.7
85;2021-02-18;1277;1719;29962;13245;4.4;1.9
85;2021-02-19;956;1087;30918;14332;4.5;2.1
85;2021-02-20;174;186;31092;14518;4.6;2.1
85;2021-02-21;1;11;31093;14529;4.6;2.1
85;2021-02-22;815;745;31908;15274;4.7;2.2
85;2021-02-23;826;373;32734;15647;4.8;2.3
85;2021-02-24;757;237;33491;15884;4.9;2.3
85;2021-02-25;1336;313;34827;16197;5.1;2.4
85;2021-02-26;1229;248;36056;16445;5.3;2.4
85;2021-02-27;402;77;36458;16522;5.3;2.4
85;2021-02-28;7;1;36465;16523;5.3;2.4
85;2021-03-01;766;350;37231;16873;5.4;2.5
85;2021-03-02;1099;669;38330;17542;5.6;2.6
85;2021-03-03;844;438;39174;17980;5.7;2.6
85;2021-03-04;1577;1081;40751;19061;6.0;2.8
85;2021-03-05;1741;742;42492;19803;6.2;2.9
85;2021-03-06;1227;116;43719;19919;6.4;2.9
85;2021-03-07;333;28;44052;19947;6.4;2.9
85;2021-03-08;1741;405;45793;20352;6.7;3.0
85;2021-03-09;2239;516;48032;20868;7.0;3.1
85;2021-03-10;1862;617;49894;21485;7.3;3.1
85;2021-03-11;3118;1031;53012;22516;7.8;3.3
85;2021-03-12;2730;818;55742;23334;8.2;3.4
85;2021-03-13;1372;156;57114;23490;8.4;3.4
85;2021-03-14;182;3;57296;23493;8.4;3.4
85;2021-03-15;1919;507;59215;24000;8.7;3.5
85;2021-03-16;1631;513;60846;24513;8.9;3.6
85;2021-03-17;980;525;61826;25038;9.0;3.7
85;2021-03-18;1904;449;63730;25487;9.3;3.7
85;2021-03-19;2198;364;65928;25851;9.7;3.8
85;2021-03-20;1069;178;66997;26029;9.8;3.8
85;2021-03-21;272;5;67269;26034;9.8;3.8
85;2021-03-22;1764;555;69033;26589;10.1;3.9
85;2021-03-23;2420;729;71453;27318;10.5;4.0
85;2021-03-24;2206;520;73659;27838;10.8;4.1
85;2021-03-25;3649;595;77308;28433;11.3;4.2
85;2021-03-26;3357;645;80665;29078;11.8;4.3
85;2021-03-27;1729;124;82394;29202;12.1;4.3
85;2021-03-28;540;4;82934;29206;12.1;4.3
85;2021-03-29;2414;757;85348;29963;12.5;4.4
85;2021-03-30;2866;1022;88214;30985;12.9;4.5
85;2021-03-31;2200;676;90414;31661;13.2;4.6
85;2021-04-01;3880;913;94294;32574;13.8;4.8
85;2021-04-02;2710;1104;97004;33678;14.2;4.9
85;2021-04-03;1411;322;98415;34000;14.4;5.0
85;2021-04-04;324;29;98739;34029;14.5;5.0
85;2021-04-05;104;175;98843;34204;14.5;5.0
85;2021-04-06;2196;1592;101039;35796;14.8;5.2
85;2021-04-07;3093;1188;104132;36984;15.2;5.4
85;2021-04-08;4544;1602;108676;38586;15.9;5.6
85;2021-04-09;4604;1225;113280;39811;16.6;5.8
85;2021-04-10;1866;401;115146;40212;16.9;5.9
85;2021-04-11;27;10;115173;40222;16.9;5.9
85;2021-04-12;4284;1490;119457;41712;17.5;6.1
85;2021-04-13;4837;1869;124294;43581;18.2;6.4
85;2021-04-14;3960;1010;128254;44591;18.8;6.5
85;2021-04-15;5517;1740;133771;46331;19.6;6.8
85;2021-04-16;5240;1541;139011;47872;20.3;7.0
85;2021-04-17;1382;436;140393;48308;20.5;7.1
85;2021-04-18;351;12;140744;48320;20.6;7.1
85;2021-04-19;3368;1698;144112;50018;21.1;7.3
85;2021-04-20;3694;1928;147806;51946;21.6;7.6
85;2021-04-21;2693;1693;150499;53639;22.0;7.9
85;2021-04-22;3805;2231;154304;55870;22.6;8.2
85;2021-04-23;3903;2091;158207;57961;23.2;8.5
85;2021-04-24;1663;1532;159870;59493;23.4;8.7
85;2021-04-25;981;565;160851;60058;23.5;8.8
85;2021-04-26;3589;2353;164440;62411;24.1;9.1
85;2021-04-27;4393;2152;168833;64563;24.7;9.5
85;2021-04-28;5747;1255;174580;65818;25.6;9.6
85;2021-04-29;5635;1996;180215;67814;26.4;9.9
85;2021-04-30;5574;1663;185789;69477;27.2;10.2
85;2021-05-01;1736;638;187525;70115;27.4;10.3
85;2021-05-02;873;471;188398;70586;27.6;10.3
85;2021-05-03;3494;2387;191892;72973;28.1;10.7
85;2021-05-04;3487;3082;195379;76055;28.6;11.1
85;2021-05-05;4532;2166;199911;78221;29.3;11.4
85;2021-05-06;4922;2598;204833;80819;30.0;11.8
85;2021-05-07;3933;3850;208766;84669;30.6;12.4
85;2021-05-08;2246;232;211012;84901;30.9;12.4
85;2021-05-09;1507;183;212519;85084;31.1;12.5
85;2021-05-10;3209;4914;215728;89998;31.6;13.2
85;2021-05-11;4027;4964;219755;94962;32.2;13.9
85;2021-05-12;5019;3933;224774;98895;32.9;14.5
85;2021-05-13;5144;613;229918;99508;33.7;14.6
85;2021-05-14;4356;3166;234274;102674;34.3;15.0
85;2021-05-15;2325;771;236599;103445;34.6;15.1
85;2021-05-16;2212;162;238811;103607;35.0;15.2
85;2021-05-17;4145;3376;242956;106983;35.6;15.7
85;2021-05-18;5215;2853;248171;109836;36.3;16.1
85;2021-05-19;6493;1770;254664;111606;37.3;16.3
85;2021-05-20;6773;2175;261437;113781;38.3;16.7
85;2021-05-21;5497;2733;266934;116514;39.1;17.1
85;2021-05-22;2584;749;269518;117263;39.5;17.2
85;2021-05-23;1329;161;270847;117424;39.6;17.2
85;2021-05-24;4572;436;275419;117860;40.3;17.3
85;2021-05-25;4516;3564;279935;121424;41.0;17.8
85;2021-05-26;4945;2678;284880;124102;41.7;18.2
85;2021-05-27;4959;3694;289839;127796;42.4;18.7
85;2021-05-28;5251;4053;295090;131849;43.2;19.3
85;2021-05-29;3962;1530;299052;133379;43.8;19.5
85;2021-05-30;1291;126;300343;133505;44.0;19.5
85;2021-05-31;4689;3378;305032;136883;44.6;20.0
85;2021-06-01;5405;3397;310437;140280;45.4;20.5
85;2021-06-02;5554;2515;315991;142795;46.3;20.9
85;2021-06-03;5915;3231;321906;146026;47.1;21.4
85;2021-06-04;5837;3808;327743;149834;48.0;21.9
85;2021-06-05;2848;1934;330591;151768;48.4;22.2
85;2021-06-06;1511;804;332102;152572;48.6;22.3
85;2021-06-07;3236;4859;335338;157431;49.1;23.0
85;2021-06-08;4090;4523;339428;161954;49.7;23.7
85;2021-06-09;4844;3502;344272;165456;50.4;24.2
85;2021-06-10;5199;3698;349471;169154;51.2;24.8
85;2021-06-11;4506;4658;353977;173812;51.8;25.4
85;2021-06-12;1491;1795;355468;175607;52.0;25.7
85;2021-06-13;1219;672;356687;176279;52.2;25.8
85;2021-06-14;2682;5093;359369;181372;52.6;26.5
85;2021-06-15;3715;4928;363084;186300;53.1;27.3
85;2021-06-16;4083;3907;367167;190207;53.7;27.8
85;2021-06-17;3940;3902;371107;194109;54.3;28.4
85;2021-06-18;3625;5684;374732;199793;54.9;29.2
85;2021-06-19;1213;2029;375945;201822;55.0;29.5
85;2021-06-20;140;520;376085;202342;55.0;29.6
85;2021-06-21;2375;5810;378460;208152;55.4;30.5
85;2021-06-22;2849;5728;381309;213880;55.8;31.3
85;2021-06-23;3390;4499;384699;218379;56.3;32.0
85;2021-06-24;3642;4561;388341;222940;56.8;32.6
85;2021-06-25;2289;6180;390630;229120;57.2;33.5
85;2021-06-26;791;3757;391421;232877;57.3;34.1
85;2021-06-27;125;1369;391546;234246;57.3;34.3
85;2021-06-28;1186;6713;392732;240959;57.5;35.3
85;2021-06-29;1757;6870;394489;247829;57.7;36.3
85;2021-06-30;2212;6208;396701;254037;58.1;37.2
85;2021-07-01;2842;6056;399543;260093;58.5;38.1
85;2021-07-02;2268;7015;401811;267108;58.8;39.1
85;2021-07-03;618;3165;402429;270273;58.9;39.6
85;2021-07-04;145;1084;402574;271357;58.9;39.7
85;2021-07-05;1064;6649;403638;278006;59.1;40.7
85;2021-07-06;1582;6453;405220;284459;59.3;41.6
85;2021-07-07;1649;5859;406869;290318;59.6;42.5
85;2021-07-08;2164;5435;409033;295753;59.9;43.3
85;2021-07-09;1646;7094;410679;302847;60.1;44.3
85;2021-07-10;566;2835;411245;305682;60.2;44.7
85;2021-07-11;529;1287;411774;306969;60.3;44.9
85;2021-07-12;1408;7046;413182;314015;60.5;46.0
85;2021-07-13;2059;7383;415241;321398;60.8;47.0
85;2021-07-14;1451;2047;416692;323445;61.0;47.3
85;2021-07-15;2681;6937;419373;330382;61.4;48.4
85;2021-07-16;3432;6829;422805;337211;61.9;49.4
85;2021-07-17;1565;2148;424370;339359;62.1;49.7
85;2021-07-18;1150;1154;425520;340513;62.3;49.8
85;2021-07-19;3559;6221;429079;346734;62.8;50.8
85;2021-07-20;4300;6213;433379;352947;63.4;51.7
85;2021-07-21;3996;6192;437375;359139;64.0;52.6
85;2021-07-22;3908;6189;441283;365328;64.6;53.5
85;2021-07-23;4530;6703;445813;372031;65.3;54.5
85;2021-07-24;1045;2293;446858;374324;65.4;54.8
85;2021-07-25;491;303;447349;374627;65.5;54.8
85;2021-07-26;4514;5361;451863;379988;66.1;55.6
85;2021-07-27;5320;5396;457183;385384;66.9;56.4
85;2021-07-28;4963;4969;462146;390353;67.6;57.1
85;2021-07-29;5879;4730;468025;395083;68.5;57.8
85;2021-07-30;6028;4952;474053;400035;69.4;58.6
85;2021-07-31;1226;1576;475279;401611;69.6;58.8
85;2021-08-01;470;195;475749;401806;69.6;58.8
85;2021-08-02;4949;3950;480698;405756;70.4;59.4
85;2021-08-03;6523;3352;487221;409108;71.3;59.9
85;2021-08-04;6631;3421;493852;412529;72.3;60.4
85;2021-08-05;6199;3600;500051;416129;73.2;60.9
85;2021-08-06;5810;4513;505861;420642;74.0;61.6
85;2021-08-07;1505;1179;507366;421821;74.3;61.7
85;2021-08-08;331;232;507697;422053;74.3;61.8
85;2021-08-09;4154;3275;511851;425328;74.9;62.3
85;2021-08-10;4830;3420;516681;428748;75.6;62.8
85;2021-08-11;4673;4216;521354;432964;76.3;63.4
85;2021-08-12;4473;4298;525827;437262;77.0;64.0
85;2021-08-13;3898;3648;529725;440910;77.5;64.5
85;2021-08-14;1028;1088;530753;441998;77.7;64.7
85;2021-08-15;160;237;530913;442235;77.7;64.7
85;2021-08-16;2843;4775;533756;447010;78.1;65.4
85;2021-08-17;2977;4359;536733;451369;78.6;66.1
85;2021-08-18;3154;4107;539887;455476;79.0;66.7
85;2021-08-19;2730;4279;542617;459755;79.4;67.3
85;2021-08-20;2481;5229;545098;464984;79.8;68.1
85;2021-08-21;702;1398;545800;466382;79.9;68.3
85;2021-08-22;344;1019;546144;467401;79.9;68.4
85;2021-08-23;1874;5373;548018;472774;80.2;69.2
85;2021-08-24;1825;4873;549843;477647;80.5;69.9
85;2021-08-25;1648;4833;551491;482480;80.7;70.6
85;2021-08-26;1542;4765;553033;487245;80.9;71.3
85;2021-08-27;1702;5519;554735;492764;81.2;72.1
85;2021-08-28;573;1348;555308;494112;81.3;72.3
85;2021-08-29;128;989;555436;495101;81.3;72.5
85;2021-08-30;1121;4948;556557;500049;81.5;73.2
85;2021-08-31;1132;5439;557689;505488;81.6;74.0
85;2021-09-01;1138;5169;558827;510657;81.8;74.7
85;2021-09-02;992;4372;559819;515029;81.9;75.4
85;2021-09-03;1244;4537;561063;519566;82.1;76.1
85;2021-09-04;370;1385;561433;520951;82.2;76.3
85;2021-09-05;42;195;561475;521146;82.2;76.3
85;2021-09-06;851;3826;562326;524972;82.3;76.8
85;2021-09-07;843;3314;563169;528286;82.4;77.3
85;2021-09-08;869;3658;564038;531944;82.6;77.9
85;2021-09-09;651;2981;564689;534925;82.7;78.3
85;2021-09-10;794;3644;565483;538569;82.8;78.8
85;2021-09-11;244;1403;565727;539972;82.8;79.0
85;2021-09-12;17;58;565744;540030;82.8;79.0
85;2021-09-13;546;2609;566290;542639;82.9;79.4
85;2021-09-14;547;2375;566837;545014;83.0;79.8
85;2021-09-15;610;2529;567447;547543;83.1;80.1
85;2021-09-16;400;1362;567847;548905;83.1;80.3
85;2021-09-17;736;2387;568583;551292;83.2;80.7
85;2021-09-18;189;915;568772;552207;83.3;80.8
85;2021-09-19;5;22;568777;552229;83.3;80.8
85;2021-09-20;352;1355;569129;553584;83.3;81.0
85;2021-09-21;429;1068;569558;554652;83.4;81.2
85;2021-09-22;434;1903;569992;556555;83.4;81.5
85;2021-09-23;810;983;570802;557538;83.5;81.6
85;2021-09-24;591;1928;571393;559466;83.6;81.9
85;2021-09-25;153;879;571546;560345;83.7;82.0
85;2021-09-26;0;12;571546;560357;83.7;82.0
85;2021-09-27;364;929;571910;561286;83.7;82.2
85;2021-09-28;231;565;572141;561851;83.7;82.2
85;2021-09-29;396;1288;572537;563139;83.8;82.4
85;2021-09-30;366;799;572903;563938;83.9;82.5
85;2021-10-01;422;919;573325;564857;83.9;82.7
85;2021-10-02;179;508;573504;565365;83.9;82.8
85;2021-10-03;4;12;573508;565377;83.9;82.8
85;2021-10-04;199;682;573707;566059;84.0;82.9
85;2021-10-05;294;429;574001;566488;84.0;82.9
85;2021-10-06;359;865;574360;567353;84.1;83.0
86;2020-12-27;0;0;0;0;0.0;0.0
86;2020-12-28;1;0;1;0;0.0;0.0
86;2020-12-29;1;0;2;0;0.0;0.0
86;2020-12-30;0;0;2;0;0.0;0.0
86;2020-12-31;0;0;2;0;0.0;0.0
86;2021-01-01;0;0;2;0;0.0;0.0
86;2021-01-02;1;0;3;0;0.0;0.0
86;2021-01-03;2;0;5;0;0.0;0.0
86;2021-01-04;0;0;5;0;0.0;0.0
86;2021-01-05;1;0;6;0;0.0;0.0
86;2021-01-06;178;0;184;0;0.0;0.0
86;2021-01-07;672;0;856;0;0.2;0.0
86;2021-01-08;609;2;1465;2;0.3;0.0
86;2021-01-09;0;0;1465;2;0.3;0.0
86;2021-01-10;173;0;1638;2;0.4;0.0
86;2021-01-11;305;0;1943;2;0.4;0.0
86;2021-01-12;460;0;2403;2;0.5;0.0
86;2021-01-13;337;0;2740;2;0.6;0.0
86;2021-01-14;552;1;3292;3;0.8;0.0
86;2021-01-15;544;0;3836;3;0.9;0.0
86;2021-01-16;2;0;3838;3;0.9;0.0
86;2021-01-17;0;0;3838;3;0.9;0.0
86;2021-01-18;564;0;4402;3;1.0;0.0
86;2021-01-19;1917;1;6319;4;1.4;0.0
86;2021-01-20;1464;10;7783;14;1.8;0.0
86;2021-01-21;1292;0;9075;14;2.1;0.0
86;2021-01-22;836;0;9911;14;2.3;0.0
86;2021-01-23;314;0;10225;14;2.3;0.0
86;2021-01-24;0;0;10225;14;2.3;0.0
86;2021-01-25;586;102;10811;116;2.5;0.0
86;2021-01-26;751;108;11562;224;2.6;0.1
86;2021-01-27;765;141;12327;365;2.8;0.1
86;2021-01-28;1055;381;13382;746;3.1;0.2
86;2021-01-29;880;195;14262;941;3.3;0.2
86;2021-01-30;276;94;14538;1035;3.3;0.2
86;2021-01-31;57;157;14595;1192;3.3;0.3
86;2021-02-01;434;194;15029;1386;3.4;0.3
86;2021-02-02;573;368;15602;1754;3.6;0.4
86;2021-02-03;525;213;16127;1967;3.7;0.4
86;2021-02-04;479;349;16606;2316;3.8;0.5
86;2021-02-05;437;664;17043;2980;3.9;0.7
86;2021-02-06;148;171;17191;3151;3.9;0.7
86;2021-02-07;120;8;17311;3159;4.0;0.7
86;2021-02-08;362;246;17673;3405;4.0;0.8
86;2021-02-09;754;957;18427;4362;4.2;1.0
86;2021-02-10;972;819;19399;5181;4.4;1.2
86;2021-02-11;1009;871;20408;6052;4.7;1.4
86;2021-02-12;746;308;21154;6360;4.8;1.5
86;2021-02-13;193;69;21347;6429;4.9;1.5
86;2021-02-14;1;34;21348;6463;4.9;1.5
86;2021-02-15;243;346;21591;6809;4.9;1.6
86;2021-02-16;384;629;21975;7438;5.0;1.7
86;2021-02-17;453;774;22428;8212;5.1;1.9
86;2021-02-18;422;761;22850;8973;5.2;2.1
86;2021-02-19;602;509;23452;9482;5.4;2.2
86;2021-02-20;115;132;23567;9614;5.4;2.2
86;2021-02-21;1;0;23568;9614;5.4;2.2
86;2021-02-22;241;333;23809;9947;5.4;2.3
86;2021-02-23;369;497;24178;10444;5.5;2.4
86;2021-02-24;410;487;24588;10931;5.6;2.5
86;2021-02-25;903;569;25491;11500;5.8;2.6
86;2021-02-26;1029;466;26520;11966;6.1;2.7
86;2021-02-27;460;126;26980;12092;6.2;2.8
86;2021-02-28;3;2;26983;12094;6.2;2.8
86;2021-03-01;232;450;27215;12544;6.2;2.9
86;2021-03-02;1142;742;28357;13286;6.5;3.0
86;2021-03-03;794;552;29151;13838;6.7;3.2
86;2021-03-04;1496;588;30647;14426;7.0;3.3
86;2021-03-05;1577;292;32224;14718;7.4;3.4
86;2021-03-06;995;150;33219;14868;7.6;3.4
86;2021-03-07;371;29;33590;14897;7.7;3.4
86;2021-03-08;473;494;34063;15391;7.8;3.5
86;2021-03-09;1368;485;35431;15876;8.1;3.6
86;2021-03-10;949;571;36380;16447;8.3;3.8
86;2021-03-11;1798;450;38178;16897;8.7;3.9
86;2021-03-12;2208;414;40386;17311;9.2;4.0
86;2021-03-13;1444;97;41830;17408;9.6;4.0
86;2021-03-14;133;16;41963;17424;9.6;4.0
86;2021-03-15;784;151;42747;17575;9.8;4.0
86;2021-03-16;847;194;43594;17769;10.0;4.1
86;2021-03-17;786;200;44380;17969;10.1;4.1
86;2021-03-18;1005;101;45385;18070;10.4;4.1
86;2021-03-19;2146;309;47531;18379;10.9;4.2
86;2021-03-20;592;130;48123;18509;11.0;4.2
86;2021-03-21;10;0;48133;18509;11.0;4.2
86;2021-03-22;852;273;48985;18782;11.2;4.3
86;2021-03-23;2017;324;51002;19106;11.7;4.4
86;2021-03-24;1557;287;52559;19393;12.0;4.4
86;2021-03-25;2489;343;55048;19736;12.6;4.5
86;2021-03-26;3044;362;58092;20098;13.3;4.6
86;2021-03-27;733;142;58825;20240;13.4;4.6
86;2021-03-28;5;124;58830;20364;13.4;4.7
86;2021-03-29;1260;383;60090;20747;13.7;4.7
86;2021-03-30;2405;820;62495;21567;14.3;4.9
86;2021-03-31;1511;624;64006;22191;14.6;5.1
86;2021-04-01;2246;939;66252;23130;15.1;5.3
86;2021-04-02;1902;552;68154;23682;15.6;5.4
86;2021-04-03;826;325;68980;24007;15.8;5.5
86;2021-04-04;83;109;69063;24116;15.8;5.5
86;2021-04-05;314;5;69377;24121;15.9;5.5
86;2021-04-06;1531;960;70908;25081;16.2;5.7
86;2021-04-07;1633;620;72541;25701;16.6;5.9
86;2021-04-08;2569;761;75110;26462;17.2;6.0
86;2021-04-09;3250;650;78360;27112;17.9;6.2
86;2021-04-10;1662;193;80022;27305;18.3;6.2
86;2021-04-11;442;11;80464;27316;18.4;6.2
86;2021-04-12;820;762;81284;28078;18.6;6.4
86;2021-04-13;2454;938;83738;29016;19.1;6.6
86;2021-04-14;1870;875;85608;29891;19.6;6.8
86;2021-04-15;2276;726;87884;30617;20.1;7.0
86;2021-04-16;2471;1227;90355;31844;20.7;7.3
86;2021-04-17;1040;264;91395;32108;20.9;7.3
86;2021-04-18;119;4;91514;32112;20.9;7.3
86;2021-04-19;745;797;92259;32909;21.1;7.5
86;2021-04-20;2301;1503;94560;34412;21.6;7.9
86;2021-04-21;2108;1126;96668;35538;22.1;8.1
86;2021-04-22;2329;1438;98997;36976;22.6;8.5
86;2021-04-23;2392;1577;101389;38553;23.2;8.8
86;2021-04-24;1299;511;102688;39064;23.5;8.9
86;2021-04-25;825;27;103513;39091;23.7;8.9
86;2021-04-26;2080;889;105593;39980;24.1;9.1
86;2021-04-27;3155;1660;108748;41640;24.9;9.5
86;2021-04-28;3002;1508;111750;43148;25.5;9.9
86;2021-04-29;3558;1829;115308;44977;26.4;10.3
86;2021-04-30;2969;1478;118277;46455;27.0;10.6
86;2021-05-01;1580;197;119857;46652;27.4;10.7
86;2021-05-02;1279;45;121136;46697;27.7;10.7
86;2021-05-03;2563;1006;123699;47703;28.3;10.9
86;2021-05-04;3508;1894;127207;49597;29.1;11.3
86;2021-05-05;3989;1484;131196;51081;30.0;11.7
86;2021-05-06;4289;1650;135485;52731;31.0;12.1
86;2021-05-07;4043;1825;139528;54556;31.9;12.5
86;2021-05-08;1976;396;141504;54952;32.4;12.6
86;2021-05-09;1642;203;143146;55155;32.7;12.6
86;2021-05-10;1958;1174;145104;56329;33.2;12.9
86;2021-05-11;3603;2682;148707;59011;34.0;13.5
86;2021-05-12;2252;1649;150959;60660;34.5;13.9
86;2021-05-13;1687;299;152646;60959;34.9;13.9
86;2021-05-14;2097;788;154743;61747;35.4;14.1
86;2021-05-15;1466;499;156209;62246;35.7;14.2
86;2021-05-16;778;164;156987;62410;35.9;14.3
86;2021-05-17;3218;1056;160205;63466;36.6;14.5
86;2021-05-18;4305;1661;164510;65127;37.6;14.9
86;2021-05-19;3587;1435;168097;66562;38.4;15.2
86;2021-05-20;4370;1619;172467;68181;39.4;15.6
86;2021-05-21;3438;1771;175905;69952;40.2;16.0
86;2021-05-22;2076;665;177981;70617;40.7;16.1
86;2021-05-23;1437;183;179418;70800;41.0;16.2
86;2021-05-24;1845;204;181263;71004;41.4;16.2
86;2021-05-25;2851;1640;184114;72644;42.1;16.6
86;2021-05-26;2725;1529;186839;74173;42.7;17.0
86;2021-05-27;3546;1848;190385;76021;43.5;17.4
86;2021-05-28;2164;2532;192549;78553;44.0;18.0
86;2021-05-29;1527;1286;194076;79839;44.4;18.3
86;2021-05-30;934;132;195010;79971;44.6;18.3
86;2021-05-31;1922;1818;196932;81789;45.0;18.7
86;2021-06-01;2665;2579;199597;84368;45.6;19.3
86;2021-06-02;2306;2659;201903;87027;46.2;19.9
86;2021-06-03;3337;2407;205240;89434;46.9;20.4
86;2021-06-04;2237;2857;207477;92291;47.4;21.1
86;2021-06-05;1503;1575;208980;93866;47.8;21.5
86;2021-06-06;820;900;209800;94766;48.0;21.7
86;2021-06-07;1119;2464;210919;97230;48.2;22.2
86;2021-06-08;1990;3695;212909;100925;48.7;23.1
86;2021-06-09;1901;3314;214810;104239;49.1;23.8
86;2021-06-10;2349;3240;217159;107479;49.6;24.6
86;2021-06-11;1517;2783;218676;110262;50.0;25.2
86;2021-06-12;746;2242;219422;112504;50.2;25.7
86;2021-06-13;214;1477;219636;113981;50.2;26.1
86;2021-06-14;1158;2902;220794;116883;50.5;26.7
86;2021-06-15;1690;4258;222484;121141;50.9;27.7
86;2021-06-16;1808;3135;224292;124276;51.3;28.4
86;2021-06-17;1777;4445;226069;128721;51.7;29.4
86;2021-06-18;1882;4585;227951;133306;52.1;30.5
86;2021-06-19;636;2097;228587;135403;52.3;31.0
86;2021-06-20;172;1319;228759;136722;52.3;31.3
86;2021-06-21;1105;2234;229864;138956;52.6;31.8
86;2021-06-22;1298;3458;231162;142414;52.8;32.6
86;2021-06-23;1364;2399;232526;144813;53.2;33.1
86;2021-06-24;1590;2725;234116;147538;53.5;33.7
86;2021-06-25;1192;3543;235308;151081;53.8;34.5
86;2021-06-26;391;2650;235699;153731;53.9;35.1
86;2021-06-27;138;1633;235837;155364;53.9;35.5
86;2021-06-28;270;3339;236107;158703;54.0;36.3
86;2021-06-29;858;4602;236965;163305;54.2;37.3
86;2021-06-30;1051;2974;238016;166279;54.4;38.0
86;2021-07-01;1549;3003;239565;169282;54.8;38.7
86;2021-07-02;1111;3637;240676;172919;55.0;39.5
86;2021-07-03;516;2393;241192;175312;55.1;40.1
86;2021-07-04;115;1346;241307;176658;55.2;40.4
86;2021-07-05;472;2832;241779;179490;55.3;41.0
86;2021-07-06;988;4108;242767;183598;55.5;42.0
86;2021-07-07;1260;2627;244027;186225;55.8;42.6
86;2021-07-08;1618;3149;245645;189374;56.2;43.3
86;2021-07-09;1746;3080;247391;192454;56.6;44.0
86;2021-07-10;1304;1954;248695;194408;56.9;44.4
86;2021-07-11;482;839;249177;195247;57.0;44.6
86;2021-07-12;848;2400;250025;197647;57.2;45.2
86;2021-07-13;1780;3367;251805;201014;57.6;46.0
86;2021-07-14;785;1232;252590;202246;57.7;46.2
86;2021-07-15;1882;3289;254472;205535;58.2;47.0
86;2021-07-16;1671;2660;256143;208195;58.6;47.6
86;2021-07-17;1352;1601;257495;209796;58.9;48.0
86;2021-07-18;381;908;257876;210704;59.0;48.2
86;2021-07-19;1377;1887;259253;212591;59.3;48.6
86;2021-07-20;2352;2732;261605;215323;59.8;49.2
86;2021-07-21;2305;2162;263910;217485;60.3;49.7
86;2021-07-22;2902;2799;266812;220284;61.0;50.4
86;2021-07-23;2465;2163;269277;222447;61.6;50.9
86;2021-07-24;1546;1225;270823;223672;61.9;51.1
86;2021-07-25;718;322;271541;223994;62.1;51.2
86;2021-07-26;1588;2103;273129;226097;62.4;51.7
86;2021-07-27;3558;2755;276687;228852;63.3;52.3
86;2021-07-28;3284;2140;279971;230992;64.0;52.8
86;2021-07-29;3266;2544;283237;233536;64.8;53.4
86;2021-07-30;2247;2370;285484;235906;65.3;53.9
86;2021-07-31;1429;1059;286913;236965;65.6;54.2
86;2021-08-01;651;338;287564;237303;65.7;54.3
86;2021-08-02;1944;1679;289508;238982;66.2;54.6
86;2021-08-03;3290;1992;292798;240974;66.9;55.1
86;2021-08-04;2739;1787;295537;242761;67.6;55.5
86;2021-08-05;3571;2056;299108;244817;68.4;56.0
86;2021-08-06;2420;1761;301528;246578;68.9;56.4
86;2021-08-07;1576;997;303104;247575;69.3;56.6
86;2021-08-08;958;553;304062;248128;69.5;56.7
86;2021-08-09;1885;1305;305947;249433;69.9;57.0
86;2021-08-10;2683;1779;308630;251212;70.6;57.4
86;2021-08-11;2366;1436;310996;252648;71.1;57.8
86;2021-08-12;2485;1832;313481;254480;71.7;58.2
86;2021-08-13;1838;1487;315319;255967;72.1;58.5
86;2021-08-14;1331;1153;316650;257120;72.4;58.8
86;2021-08-15;562;623;317212;257743;72.5;58.9
86;2021-08-16;1142;1788;318354;259531;72.8;59.3
86;2021-08-17;1559;2215;319913;261746;73.1;59.8
86;2021-08-18;1266;1861;321179;263607;73.4;60.3
86;2021-08-19;1501;2634;322680;266241;73.8;60.9
86;2021-08-20;1257;2609;323937;268850;74.1;61.5
86;2021-08-21;889;2008;324826;270858;74.3;61.9
86;2021-08-22;350;721;325176;271579;74.3;62.1
86;2021-08-23;724;1824;325900;273403;74.5;62.5
86;2021-08-24;1081;2752;326981;276155;74.8;63.1
86;2021-08-25;935;2064;327916;278219;75.0;63.6
86;2021-08-26;919;2813;328835;281032;75.2;64.3
86;2021-08-27;862;2174;329697;283206;75.4;64.7
86;2021-08-28;555;1775;330252;284981;75.5;65.2
86;2021-08-29;114;828;330366;285809;75.5;65.3
86;2021-08-30;686;2123;331052;287932;75.7;65.8
86;2021-08-31;961;3204;332013;291136;75.9;66.6
86;2021-09-01;570;2750;332583;293886;76.0;67.2
86;2021-09-02;757;2830;333340;296716;76.2;67.8
86;2021-09-03;758;2404;334098;299120;76.4;68.4
86;2021-09-04;366;2220;334464;301340;76.5;68.9
86;2021-09-05;27;918;334491;302258;76.5;69.1
86;2021-09-06;358;1753;334849;304011;76.6;69.5
86;2021-09-07;510;2207;335359;306218;76.7;70.0
86;2021-09-08;561;2400;335920;308618;76.8;70.6
86;2021-09-09;576;2028;336496;310646;76.9;71.0
86;2021-09-10;522;2135;337018;312781;77.1;71.5
86;2021-09-11;357;1893;337375;314674;77.1;71.9
86;2021-09-12;102;797;337477;315471;77.2;72.1
86;2021-09-13;323;1432;337800;316903;77.2;72.5
86;2021-09-14;402;2011;338202;318914;77.3;72.9
86;2021-09-15;473;1555;338675;320469;77.4;73.3
86;2021-09-16;437;1011;339112;321480;77.5;73.5
86;2021-09-17;488;1062;339600;322542;77.6;73.7
86;2021-09-18;294;1271;339894;323813;77.7;74.0
86;2021-09-19;85;415;339979;324228;77.7;74.1
86;2021-09-20;223;641;340202;324869;77.8;74.3
86;2021-09-21;266;825;340468;325694;77.8;74.5
86;2021-09-22;336;1185;340804;326879;77.9;74.7
86;2021-09-23;354;580;341158;327459;78.0;74.9
86;2021-09-24;308;841;341466;328300;78.1;75.1
86;2021-09-25;289;1063;341755;329363;78.1;75.3
86;2021-09-26;45;166;341800;329529;78.1;75.3
86;2021-09-27;159;359;341959;329888;78.2;75.4
86;2021-09-28;239;368;342198;330256;78.2;75.5
86;2021-09-29;229;686;342427;330942;78.3;75.7
86;2021-09-30;255;496;342682;331438;78.3;75.8
86;2021-10-01;258;524;342940;331962;78.4;75.9
86;2021-10-02;279;578;343219;332540;78.5;76.0
86;2021-10-03;19;73;343238;332613;78.5;76.0
86;2021-10-04;96;317;343334;332930;78.5;76.1
86;2021-10-05;130;275;343464;333205;78.5;76.2
86;2021-10-06;183;451;343647;333656;78.6;76.3
87;2020-12-27;0;0;0;0;0.0;0.0
87;2020-12-28;3;0;3;0;0.0;0.0
87;2020-12-29;0;0;3;0;0.0;0.0
87;2020-12-30;0;0;3;0;0.0;0.0
87;2020-12-31;0;0;3;0;0.0;0.0
87;2021-01-01;0;0;3;0;0.0;0.0
87;2021-01-02;0;0;3;0;0.0;0.0
87;2021-01-03;0;0;3;0;0.0;0.0
87;2021-01-04;2;0;5;0;0.0;0.0
87;2021-01-05;1;0;6;0;0.0;0.0
87;2021-01-06;10;0;16;0;0.0;0.0
87;2021-01-07;301;0;317;0;0.1;0.0
87;2021-01-08;407;0;724;0;0.2;0.0
87;2021-01-09;65;0;789;0;0.2;0.0
87;2021-01-10;35;0;824;0;0.2;0.0
87;2021-01-11;424;0;1248;0;0.3;0.0
87;2021-01-12;653;0;1901;0;0.5;0.0
87;2021-01-13;660;2;2561;2;0.7;0.0
87;2021-01-14;517;10;3078;12;0.8;0.0
87;2021-01-15;534;3;3612;15;1.0;0.0
87;2021-01-16;204;1;3816;16;1.0;0.0
87;2021-01-17;1;0;3817;16;1.0;0.0
87;2021-01-18;645;5;4462;21;1.2;0.0
87;2021-01-19;657;1;5119;22;1.4;0.0
87;2021-01-20;674;3;5793;25;1.6;0.0
87;2021-01-21;717;0;6510;25;1.8;0.0
87;2021-01-22;758;4;7268;29;2.0;0.0
87;2021-01-23;287;0;7555;29;2.0;0.0
87;2021-01-24;1;0;7556;29;2.0;0.0
87;2021-01-25;620;10;8176;39;2.2;0.0
87;2021-01-26;570;47;8746;86;2.4;0.0
87;2021-01-27;572;36;9318;122;2.5;0.0
87;2021-01-28;856;91;10174;213;2.7;0.1
87;2021-01-29;741;239;10915;452;2.9;0.1
87;2021-01-30;325;67;11240;519;3.0;0.1
87;2021-01-31;34;71;11274;590;3.0;0.2
87;2021-02-01;413;280;11687;870;3.2;0.2
87;2021-02-02;451;407;12138;1277;3.3;0.3
87;2021-02-03;540;350;12678;1627;3.4;0.4
87;2021-02-04;613;528;13291;2155;3.6;0.6
87;2021-02-05;344;352;13635;2507;3.7;0.7
87;2021-02-06;55;109;13690;2616;3.7;0.7
87;2021-02-07;20;0;13710;2616;3.7;0.7
87;2021-02-08;246;369;13956;2985;3.8;0.8
87;2021-02-09;219;439;14175;3424;3.8;0.9
87;2021-02-10;262;462;14437;3886;3.9;1.0
87;2021-02-11;286;408;14723;4294;4.0;1.2
87;2021-02-12;287;402;15010;4696;4.0;1.3
87;2021-02-13;25;135;15035;4831;4.1;1.3
87;2021-02-14;0;2;15035;4833;4.1;1.3
87;2021-02-15;237;300;15272;5133;4.1;1.4
87;2021-02-16;332;235;15604;5368;4.2;1.4
87;2021-02-17;329;296;15933;5664;4.3;1.5
87;2021-02-18;478;537;16411;6201;4.4;1.7
87;2021-02-19;406;390;16817;6591;4.5;1.8
87;2021-02-20;124;143;16941;6734;4.6;1.8
87;2021-02-21;2;9;16943;6743;4.6;1.8
87;2021-02-22;440;444;17383;7187;4.7;1.9
87;2021-02-23;557;492;17940;7679;4.8;2.1
87;2021-02-24;451;465;18391;8144;5.0;2.2
87;2021-02-25;790;581;19181;8725;5.2;2.4
87;2021-02-26;842;379;20023;9104;5.4;2.5
87;2021-02-27;405;150;20428;9254;5.5;2.5
87;2021-02-28;3;0;20431;9254;5.5;2.5
87;2021-03-01;518;303;20949;9557;5.7;2.6
87;2021-03-02;1031;318;21980;9875;5.9;2.7
87;2021-03-03;1174;281;23154;10156;6.2;2.7
87;2021-03-04;1406;307;24560;10463;6.6;2.8
87;2021-03-05;1770;241;26330;10704;7.1;2.9
87;2021-03-06;1049;37;27379;10741;7.4;2.9
87;2021-03-07;257;6;27636;10747;7.5;2.9
87;2021-03-08;863;207;28499;10954;7.7;3.0
87;2021-03-09;1288;207;29787;11161;8.0;3.0
87;2021-03-10;1299;215;31086;11376;8.4;3.1
87;2021-03-11;1755;236;32841;11612;8.9;3.1
87;2021-03-12;2129;254;34970;11866;9.4;3.2
87;2021-03-13;1309;22;36279;11888;9.8;3.2
87;2021-03-14;80;1;36359;11889;9.8;3.2
87;2021-03-15;987;348;37346;12237;10.1;3.3
87;2021-03-16;1060;231;38406;12468;10.4;3.4
87;2021-03-17;1070;219;39476;12687;10.6;3.4
87;2021-03-18;1186;336;40662;13023;11.0;3.5
87;2021-03-19;1684;278;42346;13301;11.4;3.6
87;2021-03-20;926;86;43272;13387;11.7;3.6
87;2021-03-21;32;0;43304;13387;11.7;3.6
87;2021-03-22;1048;365;44352;13752;12.0;3.7
87;2021-03-23;1386;426;45738;14178;12.3;3.8
87;2021-03-24;1508;363;47246;14541;12.7;3.9
87;2021-03-25;2500;397;49746;14938;13.4;4.0
87;2021-03-26;2532;451;52278;15389;14.1;4.2
87;2021-03-27;891;123;53169;15512;14.3;4.2
87;2021-03-28;270;18;53439;15530;14.4;4.2
87;2021-03-29;1119;412;54558;15942;14.7;4.3
87;2021-03-30;1907;661;56465;16603;15.2;4.5
87;2021-03-31;1660;692;58125;17295;15.7;4.7
87;2021-04-01;2237;572;60362;17867;16.3;4.8
87;2021-04-02;1843;628;62205;18495;16.8;5.0
87;2021-04-03;455;266;62660;18761;16.9;5.1
87;2021-04-04;2;0;62662;18761;16.9;5.1
87;2021-04-05;82;1;62744;18762;16.9;5.1
87;2021-04-06;1004;904;63748;19666;17.2;5.3
87;2021-04-07;1487;923;65235;20589;17.6;5.6
87;2021-04-08;1785;1030;67020;21619;18.1;5.8
87;2021-04-09;2647;740;69667;22359;18.8;6.0
87;2021-04-10;1189;307;70856;22666;19.1;6.1
87;2021-04-11;69;0;70925;22666;19.1;6.1
87;2021-04-12;1619;827;72544;23493;19.6;6.3
87;2021-04-13;2288;1064;74832;24557;20.2;6.6
87;2021-04-14;2529;1185;77361;25742;20.9;6.9
87;2021-04-15;2223;1073;79584;26815;21.5;7.2
87;2021-04-16;2735;1067;82319;27882;22.2;7.5
87;2021-04-17;731;388;83050;28270;22.4;7.6
87;2021-04-18;111;139;83161;28409;22.4;7.7
87;2021-04-19;1661;837;84822;29246;22.9;7.9
87;2021-04-20;2084;884;86906;30130;23.4;8.1
87;2021-04-21;2295;990;89201;31120;24.1;8.4
87;2021-04-22;2564;1164;91765;32284;24.7;8.7
87;2021-04-23;1997;1180;93762;33464;25.3;9.0
87;2021-04-24;824;619;94586;34083;25.5;9.2
87;2021-04-25;64;103;94650;34186;25.5;9.2
87;2021-04-26;1356;910;96006;35096;25.9;9.5
87;2021-04-27;2398;1196;98404;36292;26.5;9.8
87;2021-04-28;3867;1431;102271;37723;27.6;10.2
87;2021-04-29;3079;1827;105350;39550;28.4;10.7
87;2021-04-30;3172;1345;108522;40895;29.3;11.0
87;2021-05-01;614;59;109136;40954;29.4;11.0
87;2021-05-02;361;5;109497;40959;29.5;11.0
87;2021-05-03;2323;931;111820;41890;30.2;11.3
87;2021-05-04;2902;1067;114722;42957;30.9;11.6
87;2021-05-05;2989;1505;117711;44462;31.7;12.0
87;2021-05-06;2531;1699;120242;46161;32.4;12.4
87;2021-05-07;2945;1710;123187;47871;33.2;12.9
87;2021-05-08;772;291;123959;48162;33.4;13.0
87;2021-05-09;18;133;123977;48295;33.4;13.0
87;2021-05-10;1938;1584;125915;49879;34.0;13.5
87;2021-05-11;2465;1902;128380;51781;34.6;14.0
87;2021-05-12;2623;2062;131003;53843;35.3;14.5
87;2021-05-13;1085;292;132088;54135;35.6;14.6
87;2021-05-14;2245;1773;134333;55908;36.2;15.1
87;2021-05-15;950;409;135283;56317;36.5;15.2
87;2021-05-16;141;73;135424;56390;36.5;15.2
87;2021-05-17;1628;1761;137052;58151;37.0;15.7
87;2021-05-18;2632;1818;139684;59969;37.7;16.2
87;2021-05-19;2822;1553;142506;61522;38.4;16.6
87;2021-05-20;3302;1724;145808;63246;39.3;17.1
87;2021-05-21;2764;1841;148572;65087;40.1;17.6
87;2021-05-22;1457;628;150029;65715;40.5;17.7
87;2021-05-23;211;92;150240;65807;40.5;17.7
87;2021-05-24;1055;141;151295;65948;40.8;17.8
87;2021-05-25;2117;1810;153412;67758;41.4;18.3
87;2021-05-26;3219;2476;156631;70234;42.2;18.9
87;2021-05-27;3022;2354;159653;72588;43.1;19.6
87;2021-05-28;2675;2511;162328;75099;43.8;20.3
87;2021-05-29;1061;1306;163389;76405;44.1;20.6
87;2021-05-30;258;60;163647;76465;44.1;20.6
87;2021-05-31;2287;1358;165934;77823;44.8;21.0
87;2021-06-01;2547;1858;168481;79681;45.4;21.5
87;2021-06-02;2525;1851;171006;81532;46.1;22.0
87;2021-06-03;3212;2525;174218;84057;47.0;22.7
87;2021-06-04;2838;2053;177056;86110;47.8;23.2
87;2021-06-05;1310;569;178366;86679;48.1;23.4
87;2021-06-06;261;95;178627;86774;48.2;23.4
87;2021-06-07;2098;1894;180725;88668;48.7;23.9
87;2021-06-08;2958;2597;183683;91265;49.5;24.6
87;2021-06-09;2303;2809;185986;94074;50.2;25.4
87;2021-06-10;2974;2552;188960;96626;51.0;26.1
87;2021-06-11;2363;3062;191323;99688;51.6;26.9
87;2021-06-12;1219;1100;192542;100788;51.9;27.2
87;2021-06-13;294;485;192836;101273;52.0;27.3
87;2021-06-14;980;2729;193816;104002;52.3;28.0
87;2021-06-15;1361;3317;195177;107319;52.6;28.9
87;2021-06-16;1650;3424;196827;110743;53.1;29.9
87;2021-06-17;2438;2313;199265;113056;53.7;30.5
87;2021-06-18;1791;3013;201056;116069;54.2;31.3
87;2021-06-19;1047;1177;202103;117246;54.5;31.6
87;2021-06-20;205;206;202308;117452;54.6;31.7
87;2021-06-21;1040;2647;203348;120099;54.8;32.4
87;2021-06-22;1029;2879;204377;122978;55.1;33.2
87;2021-06-23;1256;3081;205633;126059;55.5;34.0
87;2021-06-24;1616;2561;207249;128620;55.9;34.7
87;2021-06-25;1448;2708;208697;131328;56.3;35.4
87;2021-06-26;529;1199;209226;132527;56.4;35.7
87;2021-06-27;26;212;209252;132739;56.4;35.8
87;2021-06-28;717;2575;209969;135314;56.6;36.5
87;2021-06-29;1156;3415;211125;138729;56.9;37.4
87;2021-06-30;1125;2651;212250;141380;57.2;38.1
87;2021-07-01;1482;2552;213732;143932;57.6;38.8
87;2021-07-02;1204;3461;214936;147393;58.0;39.8
87;2021-07-03;415;1512;215351;148905;58.1;40.2
87;2021-07-04;24;384;215375;149289;58.1;40.3
87;2021-07-05;685;2391;216060;151680;58.3;40.9
87;2021-07-06;583;3220;216643;154900;58.4;41.8
87;2021-07-07;862;3343;217505;158243;58.7;42.7
87;2021-07-08;1119;3671;218624;161914;59.0;43.7
87;2021-07-09;1113;3701;219737;165615;59.3;44.7
87;2021-07-10;290;1360;220027;166975;59.3;45.0
87;2021-07-11;49;284;220076;167259;59.4;45.1
87;2021-07-12;559;3192;220635;170451;59.5;46.0
87;2021-07-13;833;3509;221468;173960;59.7;46.9
87;2021-07-14;517;538;221985;174498;59.9;47.1
87;2021-07-15;1361;3461;223346;177959;60.2;48.0
87;2021-07-16;1731;3593;225077;181552;60.7;49.0
87;2021-07-17;655;1373;225732;182925;60.9;49.3
87;2021-07-18;81;285;225813;183210;60.9;49.4
87;2021-07-19;1434;3400;227247;186610;61.3;50.3
87;2021-07-20;1805;3590;229052;190200;61.8;51.3
87;2021-07-21;1451;3149;230503;193349;62.2;52.1
87;2021-07-22;1877;3244;232380;196593;62.7;53.0
87;2021-07-23;1875;3171;234255;199764;63.2;53.9
87;2021-07-24;816;1284;235071;201048;63.4;54.2
87;2021-07-25;106;241;235177;201289;63.4;54.3
87;2021-07-26;1541;2328;236718;203617;63.8;54.9
87;2021-07-27;2556;2062;239274;205679;64.5;55.5
87;2021-07-28;2390;2005;241664;207684;65.2;56.0
87;2021-07-29;3011;1998;244675;209682;66.0;56.6
87;2021-07-30;2543;2072;247218;211754;66.7;57.1
87;2021-07-31;1103;837;248321;212591;67.0;57.3
87;2021-08-01;283;151;248604;212742;67.1;57.4
87;2021-08-02;2119;1520;250723;214262;67.6;57.8
87;2021-08-03;2496;1331;253219;215593;68.3;58.1
87;2021-08-04;2314;1061;255533;216654;68.9;58.4
87;2021-08-05;2528;1413;258061;218067;69.6;58.8
87;2021-08-06;2144;1659;260205;219726;70.2;59.3
87;2021-08-07;1110;783;261315;220509;70.5;59.5
87;2021-08-08;208;125;261523;220634;70.5;59.5
87;2021-08-09;1818;1526;263341;222160;71.0;59.9
87;2021-08-10;2200;1533;265541;223693;71.6;60.3
87;2021-08-11;1912;1273;267453;224966;72.1;60.7
87;2021-08-12;2106;1481;269559;226447;72.7;61.1
87;2021-08-13;1724;1621;271283;228068;73.2;61.5
87;2021-08-14;671;733;271954;228801;73.3;61.7
87;2021-08-15;72;104;272026;228905;73.4;61.7
87;2021-08-16;1505;1739;273531;230644;73.8;62.2
87;2021-08-17;1354;1669;274885;232313;74.1;62.7
87;2021-08-18;1246;1998;276131;234311;74.5;63.2
87;2021-08-19;1223;1798;277354;236109;74.8;63.7
87;2021-08-20;917;2205;278271;238314;75.1;64.3
87;2021-08-21;318;966;278589;239280;75.1;64.5
87;2021-08-22;92;235;278681;239515;75.2;64.6
87;2021-08-23;746;2393;279427;241908;75.4;65.2
87;2021-08-24;765;2135;280192;244043;75.6;65.8
87;2021-08-25;710;2062;280902;246105;75.8;66.4
87;2021-08-26;860;2156;281762;248261;76.0;67.0
87;2021-08-27;789;2668;282551;250929;76.2;67.7
87;2021-08-28;331;1300;282882;252229;76.3;68.0
87;2021-08-29;65;244;282947;252473;76.3;68.1
87;2021-08-30;472;2215;283419;254688;76.4;68.7
87;2021-08-31;608;1933;284027;256621;76.6;69.2
87;2021-09-01;749;2469;284776;259090;76.8;69.9
87;2021-09-02;557;2342;285333;261432;77.0;70.5
87;2021-09-03;650;2485;285983;263917;77.1;71.2
87;2021-09-04;277;1129;286260;265046;77.2;71.5
87;2021-09-05;9;7;286269;265053;77.2;71.5
87;2021-09-06;395;1986;286664;267039;77.3;72.0
87;2021-09-07;385;1523;287049;268562;77.4;72.4
87;2021-09-08;459;1820;287508;270382;77.5;72.9
87;2021-09-09;325;1285;287833;271667;77.6;73.3
87;2021-09-10;466;1695;288299;273362;77.8;73.7
87;2021-09-11;320;973;288619;274335;77.8;74.0
87;2021-09-12;3;13;288622;274348;77.8;74.0
87;2021-09-13;310;1106;288932;275454;77.9;74.3
87;2021-09-14;286;1020;289218;276474;78.0;74.6
87;2021-09-15;367;963;289585;277437;78.1;74.8
87;2021-09-16;347;789;289932;278226;78.2;75.0
87;2021-09-17;404;884;290336;279110;78.3;75.3
87;2021-09-18;286;727;290622;279837;78.4;75.5
87;2021-09-19;4;14;290626;279851;78.4;75.5
87;2021-09-20;203;465;290829;280316;78.4;75.6
87;2021-09-21;261;508;291090;280824;78.5;75.7
87;2021-09-22;235;758;291325;281582;78.6;75.9
87;2021-09-23;218;529;291543;282111;78.6;76.1
87;2021-09-24;293;740;291836;282851;78.7;76.3
87;2021-09-25;167;511;292003;283362;78.8;76.4
87;2021-09-26;1;5;292004;283367;78.8;76.4
87;2021-09-27;195;401;292199;283768;78.8;76.5
87;2021-09-28;204;322;292403;284090;78.9;76.6
87;2021-09-29;171;398;292574;284488;78.9;76.7
87;2021-09-30;140;268;292714;284756;78.9;76.8
87;2021-10-01;205;513;292919;285269;79.0;76.9
87;2021-10-02;156;399;293075;285668;79.0;77.0
87;2021-10-03;3;3;293078;285671;79.0;77.0
87;2021-10-04;152;290;293230;285961;79.1;77.1
87;2021-10-05;110;212;293340;286173;79.1;77.2
87;2021-10-06;196;412;293536;286585;79.2;77.3
88;2020-12-27;0;0;0;0;0.0;0.0
88;2020-12-28;0;0;0;0;0.0;0.0
88;2020-12-29;0;0;0;0;0.0;0.0
88;2020-12-30;0;0;0;0;0.0;0.0
88;2020-12-31;0;0;0;0;0.0;0.0
88;2021-01-01;2;0;2;0;0.0;0.0
88;2021-01-02;0;0;2;0;0.0;0.0
88;2021-01-03;0;0;2;0;0.0;0.0
88;2021-01-04;0;0;2;0;0.0;0.0
88;2021-01-05;1;0;3;0;0.0;0.0
88;2021-01-06;3;0;6;0;0.0;0.0
88;2021-01-07;71;1;77;1;0.0;0.0
88;2021-01-08;189;2;266;3;0.1;0.0
88;2021-01-09;190;2;456;5;0.1;0.0
88;2021-01-10;0;0;456;5;0.1;0.0
88;2021-01-11;227;0;683;5;0.2;0.0
88;2021-01-12;422;0;1105;5;0.3;0.0
88;2021-01-13;491;2;1596;7;0.4;0.0
88;2021-01-14;347;3;1943;10;0.5;0.0
88;2021-01-15;380;1;2323;11;0.6;0.0
88;2021-01-16;62;0;2385;11;0.7;0.0
88;2021-01-17;1;0;2386;11;0.7;0.0
88;2021-01-18;461;0;2847;11;0.8;0.0
88;2021-01-19;451;0;3298;11;0.9;0.0
88;2021-01-20;462;1;3760;12;1.0;0.0
88;2021-01-21;1547;5;5307;17;1.5;0.0
88;2021-01-22;1182;2;6489;19;1.8;0.0
88;2021-01-23;285;0;6774;19;1.9;0.0
88;2021-01-24;298;2;7072;21;2.0;0.0
88;2021-01-25;937;4;8009;25;2.2;0.0
88;2021-01-26;388;5;8397;30;2.3;0.0
88;2021-01-27;4;0;8401;30;2.3;0.0
88;2021-01-28;162;35;8563;65;2.4;0.0
88;2021-01-29;527;145;9090;210;2.5;0.1
88;2021-01-30;288;79;9378;289;2.6;0.1
88;2021-01-31;0;0;9378;289;2.6;0.1
88;2021-02-01;406;261;9784;550;2.7;0.2
88;2021-02-02;333;346;10117;896;2.8;0.2
88;2021-02-03;437;223;10554;1119;2.9;0.3
88;2021-02-04;315;210;10869;1329;3.0;0.4
88;2021-02-05;457;236;11326;1565;3.2;0.4
88;2021-02-06;110;49;11436;1614;3.2;0.4
88;2021-02-07;0;0;11436;1614;3.2;0.4
88;2021-02-08;361;160;11797;1774;3.3;0.5
88;2021-02-09;291;237;12088;2011;3.4;0.6
88;2021-02-10;416;299;12504;2310;3.5;0.6
88;2021-02-11;850;953;13354;3263;3.7;0.9
88;2021-02-12;939;658;14293;3921;4.0;1.1
88;2021-02-13;162;202;14455;4123;4.0;1.1
88;2021-02-14;81;195;14536;4318;4.0;1.2
88;2021-02-15;639;891;15175;5209;4.2;1.4
88;2021-02-16;472;532;15647;5741;4.4;1.6
88;2021-02-17;455;341;16102;6082;4.5;1.7
88;2021-02-18;516;270;16618;6352;4.6;1.8
88;2021-02-19;536;383;17154;6735;4.8;1.9
88;2021-02-20;156;86;17310;6821;4.8;1.9
88;2021-02-21;1;25;17311;6846;4.8;1.9
88;2021-02-22;425;252;17736;7098;4.9;2.0
88;2021-02-23;403;187;18139;7285;5.0;2.0
88;2021-02-24;505;168;18644;7453;5.2;2.1
88;2021-02-25;674;220;19318;7673;5.4;2.1
88;2021-02-26;863;230;20181;7903;5.6;2.2
88;2021-02-27;269;31;20450;7934;5.7;2.2
88;2021-02-28;30;1;20480;7935;5.7;2.2
88;2021-03-01;358;379;20838;8314;5.8;2.3
88;2021-03-02;431;389;21269;8703;5.9;2.4
88;2021-03-03;650;364;21919;9067;6.1;2.5
88;2021-03-04;1045;660;22964;9727;6.4;2.7
88;2021-03-05;933;626;23897;10353;6.6;2.9
88;2021-03-06;1873;112;25770;10465;7.2;2.9
88;2021-03-07;1060;77;26830;10542;7.5;2.9
88;2021-03-08;726;625;27556;11167;7.7;3.1
88;2021-03-09;1095;468;28651;11635;8.0;3.2
88;2021-03-10;1083;451;29734;12086;8.3;3.4
88;2021-03-11;1441;362;31175;12448;8.7;3.5
88;2021-03-12;1309;460;32484;12908;9.0;3.6
88;2021-03-13;1210;129;33694;13037;9.4;3.6
88;2021-03-14;166;5;33860;13042;9.4;3.6
88;2021-03-15;928;436;34788;13478;9.7;3.7
88;2021-03-16;1024;337;35812;13815;10.0;3.8
88;2021-03-17;905;415;36717;14230;10.2;4.0
88;2021-03-18;1303;398;38020;14628;10.6;4.1
88;2021-03-19;1465;500;39485;15128;11.0;4.2
88;2021-03-20;1319;55;40804;15183;11.3;4.2
88;2021-03-21;37;0;40841;15183;11.4;4.2
88;2021-03-22;1233;542;42074;15725;11.7;4.4
88;2021-03-23;1780;443;43854;16168;12.2;4.5
88;2021-03-24;1877;466;45731;16634;12.7;4.6
88;2021-03-25;2497;490;48228;17124;13.4;4.8
88;2021-03-26;2480;443;50708;17567;14.1;4.9
88;2021-03-27;884;297;51592;17864;14.4;5.0
88;2021-03-28;61;3;51653;17867;14.4;5.0
88;2021-03-29;1305;436;52958;18303;14.7;5.1
88;2021-03-30;2062;392;55020;18695;15.3;5.2
88;2021-03-31;1619;575;56639;19270;15.8;5.4
88;2021-04-01;2117;718;58756;19988;16.3;5.6
88;2021-04-02;2812;647;61568;20635;17.1;5.7
88;2021-04-03;745;215;62313;20850;17.3;5.8
88;2021-04-04;16;1;62329;20851;17.3;5.8
88;2021-04-05;23;2;62352;20853;17.3;5.8
88;2021-04-06;1140;678;63492;21531;17.7;6.0
88;2021-04-07;1600;714;65092;22245;18.1;6.2
88;2021-04-08;1857;788;66949;23033;18.6;6.4
88;2021-04-09;3078;741;70027;23774;19.5;6.6
88;2021-04-10;724;648;70751;24422;19.7;6.8
88;2021-04-11;33;1;70784;24423;19.7;6.8
88;2021-04-12;1537;987;72321;25410;20.1;7.1
88;2021-04-13;2035;1088;74356;26498;20.7;7.4
88;2021-04-14;1910;949;76266;27447;21.2;7.6
88;2021-04-15;1967;1244;78233;28691;21.8;8.0
88;2021-04-16;2109;1047;80342;29738;22.3;8.3
88;2021-04-17;1430;765;81772;30503;22.7;8.5
88;2021-04-18;268;23;82040;30526;22.8;8.5
88;2021-04-19;1172;1238;83212;31764;23.1;8.8
88;2021-04-20;1190;1396;84402;33160;23.5;9.2
88;2021-04-21;1503;1296;85905;34456;23.9;9.6
88;2021-04-22;1900;1633;87805;36089;24.4;10.0
88;2021-04-23;1825;2046;89630;38135;24.9;10.6
88;2021-04-24;1184;783;90814;38918;25.3;10.8
88;2021-04-25;34;2;90848;38920;25.3;10.8
88;2021-04-26;1182;1170;92030;40090;25.6;11.2
88;2021-04-27;1277;1727;93307;41817;26.0;11.6
88;2021-04-28;1634;1496;94941;43313;26.4;12.0
88;2021-04-29;2082;1456;97023;44769;27.0;12.5
88;2021-04-30;2450;1625;99473;46394;27.7;12.9
88;2021-05-01;2008;290;101481;46684;28.2;13.0
88;2021-05-02;1301;119;102782;46803;28.6;13.0
88;2021-05-03;1559;1218;104341;48021;29.0;13.4
88;2021-05-04;1444;1464;105785;49485;29.4;13.8
88;2021-05-05;2426;1598;108211;51083;30.1;14.2
88;2021-05-06;3211;1205;111422;52288;31.0;14.5
88;2021-05-07;2938;1345;114360;53633;31.8;14.9
88;2021-05-08;1532;467;115892;54100;32.2;15.0
88;2021-05-09;1734;163;117626;54263;32.7;15.1
88;2021-05-10;1763;1568;119389;55831;33.2;15.5
88;2021-05-11;2655;1909;122044;57740;33.9;16.1
88;2021-05-12;2532;1853;124576;59593;34.7;16.6
88;2021-05-13;3258;683;127834;60276;35.6;16.8
88;2021-05-14;2500;1540;130334;61816;36.3;17.2
88;2021-05-15;1624;744;131958;62560;36.7;17.4
88;2021-05-16;1332;103;133290;62663;37.1;17.4
88;2021-05-17;1987;944;135277;63607;37.6;17.7
88;2021-05-18;2255;1116;137532;64723;38.3;18.0
88;2021-05-19;2721;1148;140253;65871;39.0;18.3
88;2021-05-20;3348;1237;143601;67108;39.9;18.7
88;2021-05-21;2875;1149;146476;68257;40.7;19.0
88;2021-05-22;1431;713;147907;68970;41.1;19.2
88;2021-05-23;558;74;148465;69044;41.3;19.2
88;2021-05-24;1675;435;150140;69479;41.8;19.3
88;2021-05-25;1646;1174;151786;70653;42.2;19.7
88;2021-05-26;2368;1140;154154;71793;42.9;20.0
88;2021-05-27;2200;1361;156354;73154;43.5;20.3
88;2021-05-28;1891;1963;158245;75117;44.0;20.9
88;2021-05-29;1230;1755;159475;76872;44.4;21.4
88;2021-05-30;587;418;160062;77290;44.5;21.5
88;2021-05-31;1327;1849;161389;79139;44.9;22.0
88;2021-06-01;1720;1983;163109;81122;45.4;22.6
88;2021-06-02;2076;1871;165185;82993;45.9;23.1
88;2021-06-03;2738;1612;167923;84605;46.7;23.5
88;2021-06-04;2042;1926;169965;86531;47.3;24.1
88;2021-06-05;1531;1135;171496;87666;47.7;24.4
88;2021-06-06;692;156;172188;87822;47.9;24.4
88;2021-06-07;1290;1710;173478;89532;48.3;24.9
88;2021-06-08;1666;1933;175144;91465;48.7;25.4
88;2021-06-09;1619;1909;176763;93374;49.2;26.0
88;2021-06-10;1781;2047;178544;95421;49.7;26.5
88;2021-06-11;1549;2211;180093;97632;50.1;27.2
88;2021-06-12;669;1657;180762;99289;50.3;27.6
88;2021-06-13;464;377;181226;99666;50.4;27.7
88;2021-06-14;1030;2249;182256;101915;50.7;28.3
88;2021-06-15;1927;2458;184183;104373;51.2;29.0
88;2021-06-16;1486;2873;185669;107246;51.6;29.8
88;2021-06-17;1602;2734;187271;109980;52.1;30.6
88;2021-06-18;1355;2460;188626;112440;52.5;31.3
88;2021-06-19;701;1089;189327;113529;52.7;31.6
88;2021-06-20;78;79;189405;113608;52.7;31.6
88;2021-06-21;672;2578;190077;116186;52.9;32.3
88;2021-06-22;869;3433;190946;119619;53.1;33.3
88;2021-06-23;1144;2876;192090;122495;53.4;34.1
88;2021-06-24;702;2604;192792;125099;53.6;34.8
88;2021-06-25;1436;3180;194228;128279;54.0;35.7
88;2021-06-26;903;2073;195131;130352;54.3;36.3
88;2021-06-27;543;635;195674;130987;54.4;36.4
88;2021-06-28;758;2514;196432;133501;54.6;37.1
88;2021-06-29;960;3353;197392;136854;54.9;38.1
88;2021-06-30;1136;3114;198528;139968;55.2;38.9
88;2021-07-01;1056;2686;199584;142654;55.5;39.7
88;2021-07-02;992;3144;200576;145798;55.8;40.6
88;2021-07-03;692;1699;201268;147497;56.0;41.0
88;2021-07-04;258;815;201526;148312;56.1;41.3
88;2021-07-05;993;2020;202519;150332;56.3;41.8
88;2021-07-06;1021;2414;203540;152746;56.6;42.5
88;2021-07-07;1177;2586;204717;155332;56.9;43.2
88;2021-07-08;1082;2063;205799;157395;57.2;43.8
88;2021-07-09;1583;2704;207382;160099;57.7;44.5
88;2021-07-10;721;1818;208103;161917;57.9;45.0
88;2021-07-11;468;696;208571;162613;58.0;45.2
88;2021-07-12;1055;2520;209626;165133;58.3;45.9
88;2021-07-13;1313;2655;210939;167788;58.7;46.7
88;2021-07-14;1207;799;212146;168587;59.0;46.9
88;2021-07-15;1744;3307;213890;171894;59.5;47.8
88;2021-07-16;1469;2960;215359;174854;59.9;48.6
88;2021-07-17;802;1587;216161;176441;60.1;49.1
88;2021-07-18;180;679;216341;177120;60.2;49.3
88;2021-07-19;1563;2232;217904;179352;60.6;49.9
88;2021-07-20;2144;2385;220048;181737;61.2;50.5
88;2021-07-21;1939;2217;221987;183954;61.7;51.2
88;2021-07-22;1699;2107;223686;186061;62.2;51.8
88;2021-07-23;2508;2778;226194;188839;62.9;52.5
88;2021-07-24;1059;1186;227253;190025;63.2;52.9
88;2021-07-25;432;608;227685;190633;63.3;53.0
88;2021-07-26;1715;2075;229400;192708;63.8;53.6
88;2021-07-27;2351;2060;231751;194768;64.5;54.2
88;2021-07-28;2210;2248;233961;197016;65.1;54.8
88;2021-07-29;3033;1635;236994;198651;65.9;55.3
88;2021-07-30;2272;2294;239266;200945;66.6;55.9
88;2021-07-31;1105;1036;240371;201981;66.9;56.2
88;2021-08-01;450;461;240821;202442;67.0;56.3
88;2021-08-02;2376;1770;243197;204212;67.6;56.8
88;2021-08-03;2875;1591;246072;205803;68.4;57.2
88;2021-08-04;2520;1530;248592;207333;69.1;57.7
88;2021-08-05;1994;1378;250586;208711;69.7;58.1
88;2021-08-06;2948;2010;253534;210721;70.5;58.6
88;2021-08-07;1176;912;254710;211633;70.8;58.9
88;2021-08-08;751;319;255461;211952;71.1;59.0
88;2021-08-09;1550;1649;257011;213601;71.5;59.4
88;2021-08-10;1941;2040;258952;215641;72.0;60.0
88;2021-08-11;1871;1759;260823;217400;72.5;60.5
88;2021-08-12;1670;1349;262493;218749;73.0;60.8
88;2021-08-13;1952;2137;264445;220886;73.6;61.4
88;2021-08-14;580;912;265025;221798;73.7;61.7
88;2021-08-15;337;520;265362;222318;73.8;61.8
88;2021-08-16;1149;1988;266511;224306;74.1;62.4
88;2021-08-17;1267;2058;267778;226364;74.5;63.0
88;2021-08-18;1208;1925;268986;228289;74.8;63.5
88;2021-08-19;1042;1582;270028;229871;75.1;63.9
88;2021-08-20;1020;2330;271048;232201;75.4;64.6
88;2021-08-21;405;1144;271453;233345;75.5;64.9
88;2021-08-22;100;479;271553;233824;75.5;65.0
88;2021-08-23;734;1640;272287;235464;75.7;65.5
88;2021-08-24;918;1973;273205;237437;76.0;66.0
88;2021-08-25;891;2459;274096;239896;76.2;66.7
88;2021-08-26;868;2049;274964;241945;76.5;67.3
88;2021-08-27;844;2711;275808;244656;76.7;68.1
88;2021-08-28;490;1351;276298;246007;76.9;68.4
88;2021-08-29;130;693;276428;246700;76.9;68.6
88;2021-08-30;699;2383;277127;249083;77.1;69.3
88;2021-08-31;782;2374;277909;251457;77.3;69.9
88;2021-09-01;686;2075;278595;253532;77.5;70.5
88;2021-09-02;666;1746;279261;255278;77.7;71.0
88;2021-09-03;728;2259;279989;257537;77.9;71.6
88;2021-09-04;428;1159;280417;258696;78.0;72.0
88;2021-09-05;188;425;280605;259121;78.0;72.1
88;2021-09-06;505;1362;281110;260483;78.2;72.5
88;2021-09-07;566;1412;281676;261895;78.3;72.8
88;2021-09-08;459;1491;282135;263386;78.5;73.3
88;2021-09-09;540;1102;282675;264488;78.6;73.6
88;2021-09-10;590;1582;283265;266070;78.8;74.0
88;2021-09-11;349;851;283614;266921;78.9;74.2
88;2021-09-12;71;142;283685;267063;78.9;74.3
88;2021-09-13;429;1075;284114;268138;79.0;74.6
88;2021-09-14;554;1260;284668;269398;79.2;74.9
88;2021-09-15;425;970;285093;270368;79.3;75.2
88;2021-09-16;255;536;285348;270904;79.4;75.4
88;2021-09-17;432;1026;285780;271930;79.5;75.6
88;2021-09-18;233;680;286013;272610;79.6;75.8
88;2021-09-19;51;164;286064;272774;79.6;75.9
88;2021-09-20;222;564;286286;273338;79.6;76.0
88;2021-09-21;207;597;286493;273935;79.7;76.2
88;2021-09-22;206;780;286699;274715;79.7;76.4
88;2021-09-23;287;626;286986;275341;79.8;76.6
88;2021-09-24;280;802;287266;276143;79.9;76.8
88;2021-09-25;131;564;287397;276707;79.9;77.0
88;2021-09-26;18;159;287415;276866;79.9;77.0
88;2021-09-27;165;457;287580;277323;80.0;77.1
88;2021-09-28;175;523;287755;277846;80.0;77.3
88;2021-09-29;174;504;287929;278350;80.1;77.4
88;2021-09-30;127;459;288056;278809;80.1;77.6
88;2021-10-01;207;672;288263;279481;80.2;77.7
88;2021-10-02;129;359;288392;279840;80.2;77.8
88;2021-10-03;22;80;288414;279920;80.2;77.9
88;2021-10-04;137;465;288551;280385;80.3;78.0
88;2021-10-05;178;579;288729;280964;80.3;78.1
88;2021-10-06;196;396;288925;281360;80.4;78.3
89;2020-12-27;0;0;0;0;0.0;0.0
89;2020-12-28;2;0;2;0;0.0;0.0
89;2020-12-29;0;0;2;0;0.0;0.0
89;2020-12-30;0;0;2;0;0.0;0.0
89;2020-12-31;0;0;2;0;0.0;0.0
89;2021-01-01;0;0;2;0;0.0;0.0
89;2021-01-02;0;0;2;0;0.0;0.0
89;2021-01-03;0;0;2;0;0.0;0.0
89;2021-01-04;0;0;2;0;0.0;0.0
89;2021-01-05;0;0;2;0;0.0;0.0
89;2021-01-06;48;0;50;0;0.0;0.0
89;2021-01-07;201;0;251;0;0.1;0.0
89;2021-01-08;48;0;299;0;0.1;0.0
89;2021-01-09;1;0;300;0;0.1;0.0
89;2021-01-10;0;0;300;0;0.1;0.0
89;2021-01-11;221;0;521;0;0.2;0.0
89;2021-01-12;349;0;870;0;0.3;0.0
89;2021-01-13;533;3;1403;3;0.4;0.0
89;2021-01-14;711;7;2114;10;0.6;0.0
89;2021-01-15;278;2;2392;12;0.7;0.0
89;2021-01-16;90;3;2482;15;0.7;0.0
89;2021-01-17;0;0;2482;15;0.7;0.0
89;2021-01-18;503;1;2985;16;0.9;0.0
89;2021-01-19;841;3;3826;19;1.2;0.0
89;2021-01-20;762;0;4588;19;1.4;0.0
89;2021-01-21;939;3;5527;22;1.7;0.0
89;2021-01-22;1020;1;6547;23;2.0;0.0
89;2021-01-23;200;0;6747;23;2.0;0.0
89;2021-01-24;107;0;6854;23;2.1;0.0
89;2021-01-25;483;3;7337;26;2.2;0.0
89;2021-01-26;582;13;7919;39;2.4;0.0
89;2021-01-27;473;37;8392;76;2.5;0.0
89;2021-01-28;551;123;8943;199;2.7;0.1
89;2021-01-29;958;39;9901;238;3.0;0.1
89;2021-01-30;184;13;10085;251;3.0;0.1
89;2021-01-31;24;1;10109;252;3.0;0.1
89;2021-02-01;255;138;10364;390;3.1;0.1
89;2021-02-02;283;312;10647;702;3.2;0.2
89;2021-02-03;292;318;10939;1020;3.3;0.3
89;2021-02-04;434;559;11373;1579;3.4;0.5
89;2021-02-05;387;178;11760;1757;3.5;0.5
89;2021-02-06;77;66;11837;1823;3.6;0.5
89;2021-02-07;0;0;11837;1823;3.6;0.5
89;2021-02-08;287;158;12124;1981;3.7;0.6
89;2021-02-09;284;397;12408;2378;3.7;0.7
89;2021-02-10;396;277;12804;2655;3.9;0.8
89;2021-02-11;332;526;13136;3181;4.0;1.0
89;2021-02-12;432;561;13568;3742;4.1;1.1
89;2021-02-13;51;122;13619;3864;4.1;1.2
89;2021-02-14;21;116;13640;3980;4.1;1.2
89;2021-02-15;217;306;13857;4286;4.2;1.3
89;2021-02-16;134;426;13991;4712;4.2;1.4
89;2021-02-17;263;334;14254;5046;4.3;1.5
89;2021-02-18;225;420;14479;5466;4.4;1.6
89;2021-02-19;246;569;14725;6035;4.4;1.8
89;2021-02-20;33;126;14758;6161;4.4;1.9
89;2021-02-21;0;10;14758;6171;4.4;1.9
89;2021-02-22;233;355;14991;6526;4.5;2.0
89;2021-02-23;170;383;15161;6909;4.6;2.1
89;2021-02-24;343;290;15504;7199;4.7;2.2
89;2021-02-25;370;371;15874;7570;4.8;2.3
89;2021-02-26;385;279;16259;7849;4.9;2.4
89;2021-02-27;138;62;16397;7911;4.9;2.4
89;2021-02-28;6;12;16403;7923;4.9;2.4
89;2021-03-01;541;198;16944;8121;5.1;2.4
89;2021-03-02;754;307;17698;8428;5.3;2.5
89;2021-03-03;647;231;18345;8659;5.5;2.6
89;2021-03-04;633;335;18978;8994;5.7;2.7
89;2021-03-05;728;454;19706;9448;5.9;2.8
89;2021-03-06;549;121;20255;9569;6.1;2.9
89;2021-03-07;288;40;20543;9609;6.2;2.9
89;2021-03-08;559;300;21102;9909;6.4;3.0
89;2021-03-09;1003;241;22105;10150;6.7;3.1
89;2021-03-10;984;232;23089;10382;7.0;3.1
89;2021-03-11;1077;285;24166;10667;7.3;3.2
89;2021-03-12;1280;308;25446;10975;7.7;3.3
89;2021-03-13;637;44;26083;11019;7.9;3.3
89;2021-03-14;1;0;26084;11019;7.9;3.3
89;2021-03-15;816;310;26900;11329;8.1;3.4
89;2021-03-16;948;218;27848;11547;8.4;3.5
89;2021-03-17;920;266;28768;11813;8.7;3.6
89;2021-03-18;885;253;29653;12066;8.9;3.6
89;2021-03-19;1148;196;30801;12262;9.3;3.7
89;2021-03-20;844;30;31645;12292;9.5;3.7
89;2021-03-21;173;6;31818;12298;9.6;3.7
89;2021-03-22;1044;221;32862;12519;9.9;3.8
89;2021-03-23;1744;257;34606;12776;10.4;3.8
89;2021-03-24;1968;325;36574;13101;11.0;3.9
89;2021-03-25;1821;170;38395;13271;11.6;4.0
89;2021-03-26;2628;184;41023;13455;12.4;4.1
89;2021-03-27;1775;49;42798;13504;12.9;4.1
89;2021-03-28;32;3;42830;13507;12.9;4.1
89;2021-03-29;965;570;43795;14077;13.2;4.2
89;2021-03-30;1156;568;44951;14645;13.5;4.4
89;2021-03-31;2004;471;46955;15116;14.1;4.6
89;2021-04-01;2121;459;49076;15575;14.8;4.7
89;2021-04-02;2140;446;51216;16021;15.4;4.8
89;2021-04-03;1004;243;52220;16264;15.7;4.9
89;2021-04-04;16;1;52236;16265;15.7;4.9
89;2021-04-05;92;4;52328;16269;15.8;4.9
89;2021-04-06;1032;754;53360;17023;16.1;5.1
89;2021-04-07;1027;799;54387;17822;16.4;5.4
89;2021-04-08;1731;728;56118;18550;16.9;5.6
89;2021-04-09;2164;767;58282;19317;17.5;5.8
89;2021-04-10;891;180;59173;19497;17.8;5.9
89;2021-04-11;38;51;59211;19548;17.8;5.9
89;2021-04-12;1010;791;60221;20339;18.1;6.1
89;2021-04-13;1356;1081;61577;21420;18.5;6.4
89;2021-04-14;1214;1036;62791;22456;18.9;6.8
89;2021-04-15;1412;942;64203;23398;19.3;7.0
89;2021-04-16;1330;938;65533;24336;19.7;7.3
89;2021-04-17;1070;455;66603;24791;20.1;7.5
89;2021-04-18;27;154;66630;24945;20.1;7.5
89;2021-04-19;748;1039;67378;25984;20.3;7.8
89;2021-04-20;1016;1533;68394;27517;20.6;8.3
89;2021-04-21;814;1100;69208;28617;20.8;8.6
89;2021-04-22;1107;1164;70315;29781;21.2;9.0
89;2021-04-23;1820;1964;72135;31745;21.7;9.6
89;2021-04-24;1173;1173;73308;32918;22.1;9.9
89;2021-04-25;139;6;73447;32924;22.1;9.9
89;2021-04-26;1503;775;74950;33699;22.6;10.1
89;2021-04-27;1733;1053;76683;34752;23.1;10.5
89;2021-04-28;1598;1853;78281;36605;23.6;11.0
89;2021-04-29;1970;1924;80251;38529;24.2;11.6
89;2021-04-30;1803;1767;82054;40296;24.7;12.1
89;2021-05-01;846;721;82900;41017;25.0;12.4
89;2021-05-02;134;31;83034;41048;25.0;12.4
89;2021-05-03;1606;761;84640;41809;25.5;12.6
89;2021-05-04;1619;1125;86259;42934;26.0;12.9
89;2021-05-05;2319;1265;88578;44199;26.7;13.3
89;2021-05-06;2411;1382;90989;45581;27.4;13.7
89;2021-05-07;2718;1313;93707;46894;28.2;14.1
89;2021-05-08;1787;534;95494;47428;28.8;14.3
89;2021-05-09;196;18;95690;47446;28.8;14.3
89;2021-05-10;1201;960;96891;48406;29.2;14.6
89;2021-05-11;2491;1463;99382;49869;29.9;15.0
89;2021-05-12;2058;1216;101440;51085;30.5;15.4
89;2021-05-13;415;332;101855;51417;30.7;15.5
89;2021-05-14;1880;1095;103735;52512;31.2;15.8
89;2021-05-15;2247;394;105982;52906;31.9;15.9
89;2021-05-16;10;35;105992;52941;31.9;15.9
89;2021-05-17;2091;635;108083;53576;32.5;16.1
89;2021-05-18;2324;830;110407;54406;33.2;16.4
89;2021-05-19;2860;882;113267;55288;34.1;16.6
89;2021-05-20;2927;886;116194;56174;35.0;16.9
89;2021-05-21;2481;877;118675;57051;35.7;17.2
89;2021-05-22;1431;561;120106;57612;36.2;17.3
89;2021-05-23;108;10;120214;57622;36.2;17.4
89;2021-05-24;288;226;120502;57848;36.3;17.4
89;2021-05-25;1558;982;122060;58830;36.8;17.7
89;2021-05-26;1815;1024;123875;59854;37.3;18.0
89;2021-05-27;2118;1358;125993;61212;37.9;18.4
89;2021-05-28;2143;1418;128136;62630;38.6;18.9
89;2021-05-29;541;658;128677;63288;38.7;19.1
89;2021-05-30;25;22;128702;63310;38.8;19.1
89;2021-05-31;1248;971;129950;64281;39.1;19.4
89;2021-06-01;1505;979;131455;65260;39.6;19.7
89;2021-06-02;1945;1278;133400;66538;40.2;20.0
89;2021-06-03;2429;1522;135829;68060;40.9;20.5
89;2021-06-04;2140;1884;137969;69944;41.5;21.1
89;2021-06-05;1185;1223;139154;71167;41.9;21.4
89;2021-06-06;24;37;139178;71204;41.9;21.4
89;2021-06-07;2107;1448;141285;72652;42.5;21.9
89;2021-06-08;2196;1447;143481;74099;43.2;22.3
89;2021-06-09;2321;1510;145802;75609;43.9;22.8
89;2021-06-10;2792;1598;148594;77207;44.7;23.2
89;2021-06-11;1950;1746;150544;78953;45.3;23.8
89;2021-06-12;1103;757;151647;79710;45.7;24.0
89;2021-06-13;156;417;151803;80127;45.7;24.1
89;2021-06-14;1311;1824;153114;81951;46.1;24.7
89;2021-06-15;1403;2011;154517;83962;46.5;25.3
89;2021-06-16;1128;2582;155645;86544;46.9;26.1
89;2021-06-17;1434;2335;157079;88879;47.3;26.8
89;2021-06-18;1624;2877;158703;91756;47.8;27.6
89;2021-06-19;686;1660;159389;93416;48.0;28.1
89;2021-06-20;55;125;159444;93541;48.0;28.2
89;2021-06-21;758;1528;160202;95069;48.2;28.6
89;2021-06-22;1049;2679;161251;97748;48.6;29.4
89;2021-06-23;1154;1797;162405;99545;48.9;30.0
89;2021-06-24;1077;1497;163482;101042;49.2;30.4
89;2021-06-25;1008;2425;164490;103467;49.5;31.2
89;2021-06-26;560;2482;165050;105949;49.7;31.9
89;2021-06-27;14;28;165064;105977;49.7;31.9
89;2021-06-28;1033;2494;166097;108471;50.0;32.7
89;2021-06-29;691;2403;166788;110874;50.2;33.4
89;2021-06-30;1083;3181;167871;114055;50.5;34.3
89;2021-07-01;1023;2989;168894;117044;50.9;35.2
89;2021-07-02;1108;2748;170002;119792;51.2;36.1
89;2021-07-03;554;1575;170556;121367;51.4;36.5
89;2021-07-04;11;36;170567;121403;51.4;36.6
89;2021-07-05;1296;1838;171863;123241;51.8;37.1
89;2021-07-06;1053;2312;172916;125553;52.1;37.8
89;2021-07-07;674;1787;173590;127340;52.3;38.3
89;2021-07-08;800;1873;174390;129213;52.5;38.9
89;2021-07-09;1144;2606;175534;131819;52.9;39.7
89;2021-07-10;719;816;176253;132635;53.1;39.9
89;2021-07-11;26;39;176279;132674;53.1;40.0
89;2021-07-12;1426;1899;177705;134573;53.5;40.5
89;2021-07-13;2143;2746;179848;137319;54.2;41.3
89;2021-07-14;318;324;180166;137643;54.3;41.4
89;2021-07-15;2253;3156;182419;140799;54.9;42.4
89;2021-07-16;2391;2864;184810;143663;55.6;43.3
89;2021-07-17;1235;1229;186045;144892;56.0;43.6
89;2021-07-18;277;97;186322;144989;56.1;43.7
89;2021-07-19;1566;2812;187888;147801;56.6;44.5
89;2021-07-20;1929;3283;189817;151084;57.2;45.5
89;2021-07-21;2081;2725;191898;153809;57.8;46.3
89;2021-07-22;2480;2992;194378;156801;58.5;47.2
89;2021-07-23;2474;3105;196852;159906;59.3;48.2
89;2021-07-24;1241;1247;198093;161153;59.6;48.5
89;2021-07-25;69;185;198162;161338;59.7;48.6
89;2021-07-26;1720;2322;199882;163660;60.2;49.3
89;2021-07-27;2345;1911;202227;165571;60.9;49.9
89;2021-07-28;2538;1339;204765;166910;61.7;50.3
89;2021-07-29;2526;1621;207291;168531;62.4;50.7
89;2021-07-30;2679;1625;209970;170156;63.2;51.2
89;2021-07-31;1121;1073;211091;171229;63.6;51.6
89;2021-08-01;69;31;211160;171260;63.6;51.6
89;2021-08-02;1802;1288;212962;172548;64.1;52.0
89;2021-08-03;2501;1255;215463;173803;64.9;52.3
89;2021-08-04;1541;1641;217004;175444;65.3;52.8
89;2021-08-05;1558;1693;218562;177137;65.8;53.3
89;2021-08-06;2207;1652;220769;178789;66.5;53.8
89;2021-08-07;930;1098;221699;179887;66.8;54.2
89;2021-08-08;56;48;221755;179935;66.8;54.2
89;2021-08-09;1119;1175;222874;181110;67.1;54.5
89;2021-08-10;1829;1816;224703;182926;67.7;55.1
89;2021-08-11;1576;1585;226279;184511;68.1;55.6
89;2021-08-12;1424;1391;227703;185902;68.6;56.0
89;2021-08-13;1345;1955;229048;187857;69.0;56.6
89;2021-08-14;527;1024;229575;188881;69.1;56.9
89;2021-08-15;20;43;229595;188924;69.1;56.9
89;2021-08-16;1033;1969;230628;190893;69.4;57.5
89;2021-08-17;862;1573;231490;192466;69.7;58.0
89;2021-08-18;643;1897;232133;194363;69.9;58.5
89;2021-08-19;692;1389;232825;195752;70.1;58.9
89;2021-08-20;1142;2265;233967;198017;70.5;59.6
89;2021-08-21;297;1003;234264;199020;70.5;59.9
89;2021-08-22;32;34;234296;199054;70.6;59.9
89;2021-08-23;833;2252;235129;201306;70.8;60.6
89;2021-08-24;868;2366;235997;203672;71.1;61.3
89;2021-08-25;594;1429;236591;205101;71.2;61.8
89;2021-08-26;615;2053;237206;207154;71.4;62.4
89;2021-08-27;869;2264;238075;209418;71.7;63.1
89;2021-08-28;380;1303;238455;210721;71.8;63.5
89;2021-08-29;30;70;238485;210791;71.8;63.5
89;2021-08-30;663;2234;239148;213025;72.0;64.1
89;2021-08-31;608;1624;239756;214649;72.2;64.6
89;2021-09-01;608;1374;240364;216023;72.4;65.0
89;2021-09-02;467;1458;240831;217481;72.5;65.5
89;2021-09-03;634;2092;241465;219573;72.7;66.1
89;2021-09-04;513;997;241978;220570;72.9;66.4
89;2021-09-05;21;18;241999;220588;72.9;66.4
89;2021-09-06;447;1859;242446;222447;73.0;67.0
89;2021-09-07;364;1150;242810;223597;73.1;67.3
89;2021-09-08;337;1020;243147;224617;73.2;67.6
89;2021-09-09;273;962;243420;225579;73.3;67.9
89;2021-09-10;469;1560;243889;227139;73.4;68.4
89;2021-09-11;273;824;244162;227963;73.5;68.6
89;2021-09-12;11;45;244173;228008;73.5;68.7
89;2021-09-13;384;1287;244557;229295;73.6;69.0
89;2021-09-14;370;843;244927;230138;73.8;69.3
89;2021-09-15;229;694;245156;230832;73.8;69.5
89;2021-09-16;244;569;245400;231401;73.9;69.7
89;2021-09-17;496;1117;245896;232518;74.0;70.0
89;2021-09-18;178;744;246074;233262;74.1;70.2
89;2021-09-19;4;17;246078;233279;74.1;70.2
89;2021-09-20;248;724;246326;234003;74.2;70.5
89;2021-09-21;293;480;246619;234483;74.3;70.6
89;2021-09-22;198;578;246817;235061;74.3;70.8
89;2021-09-23;229;472;247046;235533;74.4;70.9
89;2021-09-24;303;869;247349;236402;74.5;71.2
89;2021-09-25;107;465;247456;236867;74.5;71.3
89;2021-09-26;3;19;247459;236886;74.5;71.3
89;2021-09-27;195;506;247654;237392;74.6;71.5
89;2021-09-28;240;409;247894;237801;74.6;71.6
89;2021-09-29;184;423;248078;238224;74.7;71.7
89;2021-09-30;163;619;248241;238843;74.7;71.9
89;2021-10-01;249;656;248490;239499;74.8;72.1
89;2021-10-02;120;480;248610;239979;74.9;72.3
89;2021-10-03;8;8;248618;239987;74.9;72.3
89;2021-10-04;117;544;248735;240531;74.9;72.4
89;2021-10-05;131;573;248866;241104;74.9;72.6
89;2021-10-06;221;587;249087;241691;75.0;72.8
90;2020-12-27;0;0;0;0;0.0;0.0
90;2020-12-28;0;0;0;0;0.0;0.0
90;2020-12-29;0;0;0;0;0.0;0.0
90;2020-12-30;1;0;1;0;0.0;0.0
90;2020-12-31;0;0;1;0;0.0;0.0
90;2021-01-01;0;0;1;0;0.0;0.0
90;2021-01-02;1;0;2;0;0.0;0.0
90;2021-01-03;0;0;2;0;0.0;0.0
90;2021-01-04;2;0;4;0;0.0;0.0
90;2021-01-05;0;0;4;0;0.0;0.0
90;2021-01-06;0;0;4;0;0.0;0.0
90;2021-01-07;1;0;5;0;0.0;0.0
90;2021-01-08;170;0;175;0;0.1;0.0
90;2021-01-09;46;0;221;0;0.2;0.0
90;2021-01-10;0;0;221;0;0.2;0.0
90;2021-01-11;200;0;421;0;0.3;0.0
90;2021-01-12;431;1;852;1;0.6;0.0
90;2021-01-13;467;2;1319;3;0.9;0.0
90;2021-01-14;414;2;1733;5;1.2;0.0
90;2021-01-15;404;8;2137;13;1.5;0.0
90;2021-01-16;111;2;2248;15;1.6;0.0
90;2021-01-17;1;0;2249;15;1.6;0.0
90;2021-01-18;365;2;2614;17;1.9;0.0
90;2021-01-19;462;5;3076;22;2.2;0.0
90;2021-01-20;393;2;3469;24;2.5;0.0
90;2021-01-21;351;1;3820;25;2.7;0.0
90;2021-01-22;345;2;4165;27;3.0;0.0
90;2021-01-23;98;0;4263;27;3.0;0.0
90;2021-01-24;0;0;4263;27;3.0;0.0
90;2021-01-25;322;1;4585;28;3.3;0.0
90;2021-01-26;224;0;4809;28;3.4;0.0
90;2021-01-27;254;0;5063;28;3.6;0.0
90;2021-01-28;328;29;5391;57;3.8;0.0
90;2021-01-29;291;155;5682;212;4.1;0.2
90;2021-01-30;175;40;5857;252;4.2;0.2
90;2021-01-31;118;0;5975;252;4.3;0.2
90;2021-02-01;275;103;6250;355;4.5;0.3
90;2021-02-02;290;151;6540;506;4.7;0.4
90;2021-02-03;256;242;6796;748;4.8;0.5
90;2021-02-04;257;293;7053;1041;5.0;0.7
90;2021-02-05;266;262;7319;1303;5.2;0.9
90;2021-02-06;90;59;7409;1362;5.3;1.0
90;2021-02-07;0;0;7409;1362;5.3;1.0
90;2021-02-08;170;204;7579;1566;5.4;1.1
90;2021-02-09;139;157;7718;1723;5.5;1.2
90;2021-02-10;182;28;7900;1751;5.6;1.2
90;2021-02-11;229;95;8129;1846;5.8;1.3
90;2021-02-12;126;231;8255;2077;5.9;1.5
90;2021-02-13;96;40;8351;2117;6.0;1.5
90;2021-02-14;0;0;8351;2117;6.0;1.5
90;2021-02-15;113;244;8464;2361;6.0;1.7
90;2021-02-16;92;249;8556;2610;6.1;1.9
90;2021-02-17;178;169;8734;2779;6.2;2.0
90;2021-02-18;128;198;8862;2977;6.3;2.1
90;2021-02-19;64;211;8926;3188;6.4;2.3
90;2021-02-20;40;62;8966;3250;6.4;2.3
90;2021-02-21;0;0;8966;3250;6.4;2.3
90;2021-02-22;77;270;9043;3520;6.5;2.5
90;2021-02-23;40;197;9083;3717;6.5;2.7
90;2021-02-24;109;251;9192;3968;6.6;2.8
90;2021-02-25;89;254;9281;4222;6.6;3.0
90;2021-02-26;89;334;9370;4556;6.7;3.3
90;2021-02-27;140;146;9510;4702;6.8;3.4
90;2021-02-28;8;98;9518;4800;6.8;3.4
90;2021-03-01;211;205;9729;5005;6.9;3.6
90;2021-03-02;178;246;9907;5251;7.1;3.7
90;2021-03-03;239;323;10146;5574;7.2;4.0
90;2021-03-04;260;255;10406;5829;7.4;4.2
90;2021-03-05;359;252;10765;6081;7.7;4.3
90;2021-03-06;291;97;11056;6178;7.9;4.4
90;2021-03-07;18;1;11074;6179;7.9;4.4
90;2021-03-08;246;224;11320;6403;8.1;4.6
90;2021-03-09;430;154;11750;6557;8.4;4.7
90;2021-03-10;348;193;12098;6750;8.6;4.8
90;2021-03-11;347;116;12445;6866;8.9;4.9
90;2021-03-12;519;129;12964;6995;9.3;5.0
90;2021-03-13;539;48;13503;7043;9.6;5.0
90;2021-03-14;21;0;13524;7043;9.7;5.0
90;2021-03-15;388;117;13912;7160;9.9;5.1
90;2021-03-16;401;101;14313;7261;10.2;5.2
90;2021-03-17;323;76;14636;7337;10.4;5.2
90;2021-03-18;349;79;14985;7416;10.7;5.3
90;2021-03-19;468;78;15453;7494;11.0;5.3
90;2021-03-20;427;48;15880;7542;11.3;5.4
90;2021-03-21;7;1;15887;7543;11.3;5.4
90;2021-03-22;399;30;16286;7573;11.6;5.4
90;2021-03-23;740;78;17026;7651;12.1;5.5
90;2021-03-24;817;46;17843;7697;12.7;5.5
90;2021-03-25;949;75;18792;7772;13.4;5.5
90;2021-03-26;1226;62;20018;7834;14.3;5.6
90;2021-03-27;439;34;20457;7868;14.6;5.6
90;2021-03-28;34;0;20491;7868;14.6;5.6
90;2021-03-29;712;142;21203;8010;15.1;5.7
90;2021-03-30;675;155;21878;8165;15.6;5.8
90;2021-03-31;728;85;22606;8250;16.1;5.9
90;2021-04-01;602;123;23208;8373;16.6;6.0
90;2021-04-02;657;98;23865;8471;17.0;6.0
90;2021-04-03;370;40;24235;8511;17.3;6.1
90;2021-04-04;1;0;24236;8511;17.3;6.1
90;2021-04-05;0;0;24236;8511;17.3;6.1
90;2021-04-06;529;250;24765;8761;17.7;6.3
90;2021-04-07;485;267;25250;9028;18.0;6.4
90;2021-04-08;510;246;25760;9274;18.4;6.6
90;2021-04-09;751;266;26511;9540;18.9;6.8
90;2021-04-10;224;8;26735;9548;19.1;6.8
90;2021-04-11;7;0;26742;9548;19.1;6.8
90;2021-04-12;557;481;27299;10029;19.5;7.2
90;2021-04-13;632;531;27931;10560;19.9;7.5
90;2021-04-14;526;351;28457;10911;20.3;7.8
90;2021-04-15;905;292;29362;11203;21.0;8.0
90;2021-04-16;370;404;29732;11607;21.2;8.3
90;2021-04-17;189;128;29921;11735;21.4;8.4
90;2021-04-18;21;0;29942;11735;21.4;8.4
90;2021-04-19;435;572;30377;12307;21.7;8.8
90;2021-04-20;493;617;30870;12924;22.0;9.2
90;2021-04-21;353;497;31223;13421;22.3;9.6
90;2021-04-22;569;602;31792;14023;22.7;10.0
90;2021-04-23;504;742;32296;14765;23.0;10.5
90;2021-04-24;305;202;32601;14967;23.3;10.7
90;2021-04-25;1;0;32602;14967;23.3;10.7
90;2021-04-26;509;750;33111;15717;23.6;11.2
90;2021-04-27;640;680;33751;16397;24.1;11.7
90;2021-04-28;765;446;34516;16843;24.6;12.0
90;2021-04-29;1003;449;35519;17292;25.3;12.3
90;2021-04-30;1120;460;36639;17752;26.1;12.7
90;2021-05-01;60;42;36699;17794;26.2;12.7
90;2021-05-02;4;0;36703;17794;26.2;12.7
90;2021-05-03;903;285;37606;18079;26.8;12.9
90;2021-05-04;784;637;38390;18716;27.4;13.4
90;2021-05-05;891;504;39281;19220;28.0;13.7
90;2021-05-06;851;626;40132;19846;28.6;14.2
90;2021-05-07;440;507;40572;20353;29.0;14.5
90;2021-05-08;26;27;40598;20380;29.0;14.5
90;2021-05-09;5;33;40603;20413;29.0;14.6
90;2021-05-10;506;582;41109;20995;29.3;15.0
90;2021-05-11;778;638;41887;21633;29.9;15.4
90;2021-05-12;531;598;42418;22231;30.3;15.9
90;2021-05-13;1113;265;43531;22496;31.1;16.1
90;2021-05-14;865;403;44396;22899;31.7;16.3
90;2021-05-15;14;125;44410;23024;31.7;16.4
90;2021-05-16;2;7;44412;23031;31.7;16.4
90;2021-05-17;792;290;45204;23321;32.3;16.6
90;2021-05-18;1024;472;46228;23793;33.0;17.0
90;2021-05-19;1264;384;47492;24177;33.9;17.3
90;2021-05-20;1201;270;48693;24447;34.7;17.4
90;2021-05-21;1265;435;49958;24882;35.6;17.8
90;2021-05-22;9;131;49967;25013;35.7;17.8
90;2021-05-23;4;0;49971;25013;35.7;17.8
90;2021-05-24;368;265;50339;25278;35.9;18.0
90;2021-05-25;635;791;50974;26069;36.4;18.6
90;2021-05-26;630;569;51604;26638;36.8;19.0
90;2021-05-27;962;380;52566;27018;37.5;19.3
90;2021-05-28;668;827;53234;27845;38.0;19.9
90;2021-05-29;93;296;53327;28141;38.1;20.1
90;2021-05-30;4;1;53331;28142;38.1;20.1
90;2021-05-31;808;713;54139;28855;38.6;20.6
90;2021-06-01;969;739;55108;29594;39.3;21.1
90;2021-06-02;760;676;55868;30270;39.9;21.6
90;2021-06-03;758;744;56626;31014;40.4;22.1
90;2021-06-04;833;971;57459;31985;41.0;22.8
90;2021-06-05;54;427;57513;32412;41.0;23.1
90;2021-06-06;1;16;57514;32428;41.0;23.1
90;2021-06-07;1265;1081;58779;33509;41.9;23.9
90;2021-06-08;1482;939;60261;34448;43.0;24.6
90;2021-06-09;964;659;61225;35107;43.7;25.1
90;2021-06-10;627;498;61852;35605;44.1;25.4
90;2021-06-11;787;1126;62639;36731;44.7;26.2
90;2021-06-12;806;297;63445;37028;45.3;26.4
90;2021-06-13;10;12;63455;37040;45.3;26.4
90;2021-06-14;264;972;63719;38012;45.5;27.1
90;2021-06-15;566;882;64285;38894;45.9;27.8
90;2021-06-16;509;548;64794;39442;46.2;28.1
90;2021-06-17;443;638;65237;40080;46.5;28.6
90;2021-06-18;623;997;65860;41077;47.0;29.3
90;2021-06-19;450;170;66310;41247;47.3;29.4
90;2021-06-20;0;28;66310;41275;47.3;29.5
90;2021-06-21;256;1176;66566;42451;47.5;30.3
90;2021-06-22;384;950;66950;43401;47.8;31.0
90;2021-06-23;415;633;67365;44034;48.1;31.4
90;2021-06-24;319;599;67684;44633;48.3;31.8
90;2021-06-25;431;1270;68115;45903;48.6;32.8
90;2021-06-26;420;561;68535;46464;48.9;33.2
90;2021-06-27;2;6;68537;46470;48.9;33.2
90;2021-06-28;381;1298;68918;47768;49.2;34.1
90;2021-06-29;305;1305;69223;49073;49.4;35.0
90;2021-06-30;485;1227;69708;50300;49.7;35.9
90;2021-07-01;355;920;70063;51220;50.0;36.5
90;2021-07-02;506;1205;70569;52425;50.4;37.4
90;2021-07-03;53;129;70622;52554;50.4;37.5
90;2021-07-04;0;21;70622;52575;50.4;37.5
90;2021-07-05;400;1014;71022;53589;50.7;38.2
90;2021-07-06;514;970;71536;54559;51.0;38.9
90;2021-07-07;381;998;71917;55557;51.3;39.6
90;2021-07-08;304;607;72221;56164;51.5;40.1
90;2021-07-09;439;948;72660;57112;51.8;40.8
90;2021-07-10;32;91;72692;57203;51.9;40.8
90;2021-07-11;7;17;72699;57220;51.9;40.8
90;2021-07-12;246;1074;72945;58294;52.0;41.6
90;2021-07-13;474;1162;73419;59456;52.4;42.4
90;2021-07-14;4;9;73423;59465;52.4;42.4
90;2021-07-15;789;1455;74212;60920;53.0;43.5
90;2021-07-16;826;1681;75038;62601;53.5;44.7
90;2021-07-17;484;955;75522;63556;53.9;45.4
90;2021-07-18;4;2;75526;63558;53.9;45.4
90;2021-07-19;1186;1460;76712;65018;54.7;46.4
90;2021-07-20;1339;1135;78051;66153;55.7;47.2
90;2021-07-21;1395;983;79446;67136;56.7;47.9
90;2021-07-22;1127;697;80573;67833;57.5;48.4
90;2021-07-23;968;1020;81541;68853;58.2;49.1
90;2021-07-24;121;66;81662;68919;58.3;49.2
90;2021-07-25;2;1;81664;68920;58.3;49.2
90;2021-07-26;1074;801;82738;69721;59.0;49.7
90;2021-07-27;1081;746;83819;70467;59.8;50.3
90;2021-07-28;825;712;84644;71179;60.4;50.8
90;2021-07-29;843;441;85487;71620;61.0;51.1
90;2021-07-30;786;506;86273;72126;61.6;51.5
90;2021-07-31;484;313;86757;72439;61.9;51.7
90;2021-08-01;0;3;86757;72442;61.9;51.7
90;2021-08-02;850;510;87607;72952;62.5;52.1
90;2021-08-03;929;494;88536;73446;63.2;52.4
90;2021-08-04;1067;460;89603;73906;63.9;52.7
90;2021-08-05;521;223;90124;74129;64.3;52.9
90;2021-08-06;649;388;90773;74517;64.8;53.2
90;2021-08-07;37;63;90810;74580;64.8;53.2
90;2021-08-08;18;3;90828;74583;64.8;53.2
90;2021-08-09;730;947;91558;75530;65.3;53.9
90;2021-08-10;536;1152;92094;76682;65.7;54.7
90;2021-08-11;537;948;92631;77630;66.1;55.4
90;2021-08-12;449;820;93080;78450;66.4;56.0
90;2021-08-13;544;898;93624;79348;66.8;56.6
90;2021-08-14;30;98;93654;79446;66.8;56.7
90;2021-08-15;2;7;93656;79453;66.8;56.7
90;2021-08-16;451;632;94107;80085;67.1;57.1
90;2021-08-17;347;1167;94454;81252;67.4;58.0
90;2021-08-18;275;881;94729;82133;67.6;58.6
90;2021-08-19;248;627;94977;82760;67.8;59.1
90;2021-08-20;361;771;95338;83531;68.0;59.6
90;2021-08-21;32;71;95370;83602;68.1;59.7
90;2021-08-22;0;7;95370;83609;68.1;59.7
90;2021-08-23;319;489;95689;84098;68.3;60.0
90;2021-08-24;337;959;96026;85057;68.5;60.7
90;2021-08-25;254;915;96280;85972;68.7;61.3
90;2021-08-26;244;675;96524;86647;68.9;61.8
90;2021-08-27;274;737;96798;87384;69.1;62.4
90;2021-08-28;21;64;96819;87448;69.1;62.4
90;2021-08-29;3;6;96822;87454;69.1;62.4
90;2021-08-30;322;640;97144;88094;69.3;62.9
90;2021-08-31;276;1021;97420;89115;69.5;63.6
90;2021-09-01;267;787;97687;89902;69.7;64.1
90;2021-09-02;159;408;97846;90310;69.8;64.4
90;2021-09-03;222;534;98068;90844;70.0;64.8
90;2021-09-04;55;157;98123;91001;70.0;64.9
90;2021-09-05;10;25;98133;91026;70.0;65.0
90;2021-09-06;134;741;98267;91767;70.1;65.5
90;2021-09-07;220;675;98487;92442;70.3;66.0
90;2021-09-08;224;654;98711;93096;70.4;66.4
90;2021-09-09;189;320;98900;93416;70.6;66.7
90;2021-09-10;191;551;99091;93967;70.7;67.0
90;2021-09-11;12;12;99103;93979;70.7;67.1
90;2021-09-12;0;7;99103;93986;70.7;67.1
90;2021-09-13;211;514;99314;94500;70.9;67.4
90;2021-09-14;158;454;99472;94954;71.0;67.8
90;2021-09-15;183;392;99655;95346;71.1;68.0
90;2021-09-16;154;238;99809;95584;71.2;68.2
90;2021-09-17;183;340;99992;95924;71.3;68.4
90;2021-09-18;17;24;100009;95948;71.4;68.5
90;2021-09-19;7;4;100016;95952;71.4;68.5
90;2021-09-20;153;250;100169;96202;71.5;68.6
90;2021-09-21;105;248;100274;96450;71.6;68.8
90;2021-09-22;104;353;100378;96803;71.6;69.1
90;2021-09-23;80;138;100458;96941;71.7;69.2
90;2021-09-24;102;285;100560;97226;71.8;69.4
90;2021-09-25;16;31;100576;97257;71.8;69.4
90;2021-09-26;0;7;100576;97264;71.8;69.4
90;2021-09-27;93;199;100669;97463;71.8;69.5
90;2021-09-28;90;140;100759;97603;71.9;69.6
90;2021-09-29;79;236;100838;97839;72.0;69.8
90;2021-09-30;61;131;100899;97970;72.0;69.9
90;2021-10-01;112;232;101011;98202;72.1;70.1
90;2021-10-02;10;28;101021;98230;72.1;70.1
90;2021-10-03;0;11;101021;98241;72.1;70.1
90;2021-10-04;140;209;101161;98450;72.2;70.2
90;2021-10-05;44;133;101205;98583;72.2;70.3
90;2021-10-06;90;187;101295;98770;72.3;70.5
91;2020-12-27;0;0;0;0;0.0;0.0
91;2020-12-28;0;0;0;0;0.0;0.0
91;2020-12-29;1;0;1;0;0.0;0.0
91;2020-12-30;1;0;2;0;0.0;0.0
91;2020-12-31;0;0;2;0;0.0;0.0
91;2021-01-01;5;0;7;0;0.0;0.0
91;2021-01-02;0;0;7;0;0.0;0.0
91;2021-01-03;0;0;7;0;0.0;0.0
91;2021-01-04;1;0;8;0;0.0;0.0
91;2021-01-05;71;0;79;0;0.0;0.0
91;2021-01-06;188;2;267;2;0.0;0.0
91;2021-01-07;522;6;789;8;0.1;0.0
91;2021-01-08;394;1;1183;9;0.1;0.0
91;2021-01-09;89;2;1272;11;0.1;0.0
91;2021-01-10;1;0;1273;11;0.1;0.0
91;2021-01-11;595;2;1868;13;0.1;0.0
91;2021-01-12;899;8;2767;21;0.2;0.0
91;2021-01-13;703;7;3470;28;0.3;0.0
91;2021-01-14;721;11;4191;39;0.3;0.0
91;2021-01-15;570;4;4761;43;0.4;0.0
91;2021-01-16;316;7;5077;50;0.4;0.0
91;2021-01-17;118;1;5195;51;0.4;0.0
91;2021-01-18;991;3;6186;54;0.5;0.0
91;2021-01-19;1875;13;8061;67;0.6;0.0
91;2021-01-20;2377;17;10438;84;0.8;0.0
91;2021-01-21;2109;16;12547;100;1.0;0.0
91;2021-01-22;1863;10;14410;110;1.1;0.0
91;2021-01-23;413;1;14823;111;1.1;0.0
91;2021-01-24;53;0;14876;111;1.1;0.0
91;2021-01-25;1049;3;15925;114;1.2;0.0
91;2021-01-26;1575;35;17500;149;1.3;0.0
91;2021-01-27;2423;90;19923;239;1.5;0.0
91;2021-01-28;1987;177;21910;416;1.7;0.0
91;2021-01-29;1747;60;23657;476;1.8;0.0
91;2021-01-30;422;6;24079;482;1.8;0.0
91;2021-01-31;54;0;24133;482;1.8;0.0
91;2021-02-01;965;213;25098;695;1.9;0.1
91;2021-02-02;859;346;25957;1041;2.0;0.1
91;2021-02-03;938;541;26895;1582;2.0;0.1
91;2021-02-04;885;267;27780;1849;2.1;0.1
91;2021-02-05;1037;330;28817;2179;2.2;0.2
91;2021-02-06;340;83;29157;2262;2.2;0.2
91;2021-02-07;14;0;29171;2262;2.2;0.2
91;2021-02-08;905;532;30076;2794;2.3;0.2
91;2021-02-09;963;700;31039;3494;2.4;0.3
91;2021-02-10;1065;935;32104;4429;2.4;0.3
91;2021-02-11;1124;939;33228;5368;2.5;0.4
91;2021-02-12;1064;744;34292;6112;2.6;0.5
91;2021-02-13;332;317;34624;6429;2.6;0.5
91;2021-02-14;18;102;34642;6531;2.6;0.5
91;2021-02-15;369;887;35011;7418;2.7;0.6
91;2021-02-16;555;1425;35566;8843;2.7;0.7
91;2021-02-17;814;2256;36380;11099;2.8;0.8
91;2021-02-18;942;1718;37322;12817;2.8;1.0
91;2021-02-19;872;1143;38194;13960;2.9;1.1
91;2021-02-20;168;256;38362;14216;2.9;1.1
91;2021-02-21;13;39;38375;14255;2.9;1.1
91;2021-02-22;335;897;38710;15152;2.9;1.1
91;2021-02-23;398;833;39108;15985;3.0;1.2
91;2021-02-24;475;819;39583;16804;3.0;1.3
91;2021-02-25;736;803;40319;17607;3.1;1.3
91;2021-02-26;1096;832;41415;18439;3.1;1.4
91;2021-02-27;613;243;42028;18682;3.2;1.4
91;2021-02-28;65;59;42093;18741;3.2;1.4
91;2021-03-01;932;846;43025;19587;3.3;1.5
91;2021-03-02;1260;919;44285;20506;3.4;1.6
91;2021-03-03;1467;1101;45752;21607;3.5;1.6
91;2021-03-04;2436;1005;48188;22612;3.7;1.7
91;2021-03-05;3357;993;51545;23605;3.9;1.8
91;2021-03-06;4913;409;56458;24014;4.3;1.8
91;2021-03-07;3208;119;59666;24133;4.5;1.8
91;2021-03-08;1474;912;61140;25045;4.6;1.9
91;2021-03-09;2625;884;63765;25929;4.8;2.0
91;2021-03-10;2627;959;66392;26888;5.0;2.0
91;2021-03-11;3786;1064;70178;27952;5.3;2.1
91;2021-03-12;4792;989;74970;28941;5.7;2.2
91;2021-03-13;5258;331;80228;29272;6.1;2.2
91;2021-03-14;304;28;80532;29300;6.1;2.2
91;2021-03-15;2986;427;83518;29727;6.3;2.3
91;2021-03-16;2617;376;86135;30103;6.5;2.3
91;2021-03-17;2227;341;88362;30444;6.7;2.3
91;2021-03-18;2394;407;90756;30851;6.9;2.3
91;2021-03-19;4093;383;94849;31234;7.2;2.4
91;2021-03-20;3608;182;98457;31416;7.5;2.4
91;2021-03-21;138;21;98595;31437;7.5;2.4
91;2021-03-22;3149;592;101744;32029;7.7;2.4
91;2021-03-23;4139;685;105883;32714;8.0;2.5
91;2021-03-24;3937;498;109820;33212;8.3;2.5
91;2021-03-25;5060;524;114880;33736;8.7;2.6
91;2021-03-26;5550;552;120430;34288;9.1;2.6
91;2021-03-27;4982;343;125412;34631;9.5;2.6
91;2021-03-28;282;57;125694;34688;9.5;2.6
91;2021-03-29;3305;1023;128999;35711;9.8;2.7
91;2021-03-30;4426;1214;133425;36925;10.1;2.8
91;2021-03-31;3368;1329;136793;38254;10.4;2.9
91;2021-04-01;3740;1684;140533;39938;10.7;3.0
91;2021-04-02;3886;2309;144419;42247;10.9;3.2
91;2021-04-03;1874;2856;146293;45103;11.1;3.4
91;2021-04-04;647;1318;146940;46421;11.1;3.5
91;2021-04-05;562;132;147502;46553;11.2;3.5
91;2021-04-06;3403;1779;150905;48332;11.4;3.7
91;2021-04-07;3420;1926;154325;50258;11.7;3.8
91;2021-04-08;4665;2154;158990;52412;12.1;4.0
91;2021-04-09;5349;2161;164339;54573;12.5;4.1
91;2021-04-10;2734;2808;167073;57381;12.7;4.3
91;2021-04-11;191;141;167264;57522;12.7;4.4
91;2021-04-12;2854;2278;170118;59800;12.9;4.5
91;2021-04-13;3758;2643;173876;62443;13.2;4.7
91;2021-04-14;3707;2319;177583;64762;13.5;4.9
91;2021-04-15;4476;2518;182059;67280;13.8;5.1
91;2021-04-16;4549;2801;186608;70081;14.1;5.3
91;2021-04-17;2983;2071;189591;72152;14.4;5.5
91;2021-04-18;269;73;189860;72225;14.4;5.5
91;2021-04-19;2306;2731;192166;74956;14.6;5.7
91;2021-04-20;3178;2978;195344;77934;14.8;5.9
91;2021-04-21;2990;2894;198334;80828;15.0;6.1
91;2021-04-22;3170;3363;201504;84191;15.3;6.4
91;2021-04-23;3717;3329;205221;87520;15.6;6.6
91;2021-04-24;3480;3732;208701;91252;15.8;6.9
91;2021-04-25;2618;643;211319;91895;16.0;7.0
91;2021-04-26;3486;2800;214805;94695;16.3;7.2
91;2021-04-27;4486;2922;219291;97617;16.6;7.4
91;2021-04-28;4569;2693;223860;100310;17.0;7.6
91;2021-04-29;5745;3057;229605;103367;17.4;7.8
91;2021-04-30;5385;2846;234990;106213;17.8;8.1
91;2021-05-01;3517;520;238507;106733;18.1;8.1
91;2021-05-02;628;131;239135;106864;18.1;8.1
91;2021-05-03;5201;2287;244336;109151;18.5;8.3
91;2021-05-04;5589;3170;249925;112321;18.9;8.5
91;2021-05-05;4852;2873;254777;115194;19.3;8.7
91;2021-05-06;5245;3373;260022;118567;19.7;9.0
91;2021-05-07;6122;3740;266144;122307;20.2;9.3
91;2021-05-08;6518;965;272662;123272;20.7;9.3
91;2021-05-09;4804;564;277466;123836;21.0;9.4
91;2021-05-10;5901;3001;283367;126837;21.5;9.6
91;2021-05-11;6826;3833;290193;130670;22.0;9.9
91;2021-05-12;5895;3441;296088;134111;22.4;10.2
91;2021-05-13;4825;1082;300913;135193;22.8;10.2
91;2021-05-14;6549;2395;307462;137588;23.3;10.4
91;2021-05-15;7792;1929;315254;139517;23.9;10.6
91;2021-05-16;4583;372;319837;139889;24.2;10.6
91;2021-05-17;6952;1703;326789;141592;24.8;10.7
91;2021-05-18;8120;1740;334909;143332;25.4;10.9
91;2021-05-19;7098;1695;342007;145027;25.9;11.0
91;2021-05-20;8201;2141;350208;147168;26.5;11.2
91;2021-05-21;8144;2580;358352;149748;27.2;11.3
91;2021-05-22;7660;1538;366012;151286;27.7;11.5
91;2021-05-23;4792;534;370804;151820;28.1;11.5
91;2021-05-24;5014;595;375818;152415;28.5;11.6
91;2021-05-25;7621;2653;383439;155068;29.1;11.8
91;2021-05-26;6874;2943;390313;158011;29.6;12.0
91;2021-05-27;7971;3439;398284;161450;30.2;12.2
91;2021-05-28;7534;4323;405818;165773;30.8;12.6
91;2021-05-29;9301;3499;415119;169272;31.5;12.8
91;2021-05-30;5948;963;421067;170235;31.9;12.9
91;2021-05-31;6738;3696;427805;173931;32.4;13.2
91;2021-06-01;7787;4765;435592;178696;33.0;13.5
91;2021-06-02;7454;3949;443046;182645;33.6;13.8
91;2021-06-03;7859;4777;450905;187422;34.2;14.2
91;2021-06-04;7193;5718;458098;193140;34.7;14.6
91;2021-06-05;6385;5820;464483;198960;35.2;15.1
91;2021-06-06;4087;2512;468570;201472;35.5;15.3
91;2021-06-07;5878;5478;474448;206950;36.0;15.7
91;2021-06-08;7039;5794;481487;212744;36.5;16.1
91;2021-06-09;6469;5141;487956;217885;37.0;16.5
91;2021-06-10;7177;5779;495133;223664;37.5;17.0
91;2021-06-11;6546;7109;501679;230773;38.0;17.5
91;2021-06-12;6218;7367;507897;238140;38.5;18.0
91;2021-06-13;2846;2314;510743;240454;38.7;18.2
91;2021-06-14;4225;7195;514968;247649;39.0;18.8
91;2021-06-15;5575;7259;520543;254908;39.5;19.3
91;2021-06-16;5297;6445;525840;261353;39.9;19.8
91;2021-06-17;6251;7129;532091;268482;40.3;20.3
91;2021-06-18;4629;8738;536720;277220;40.7;21.0
91;2021-06-19;4190;7153;540910;284373;41.0;21.6
91;2021-06-20;1007;4211;541917;288584;41.1;21.9
91;2021-06-21;3232;7237;545149;295821;41.3;22.4
91;2021-06-22;4157;9229;549306;305050;41.6;23.1
91;2021-06-23;4315;7957;553621;313007;42.0;23.7
91;2021-06-24;4912;8482;558533;321489;42.3;24.4
91;2021-06-25;3477;9166;562010;330655;42.6;25.1
91;2021-06-26;2989;8032;564999;338687;42.8;25.7
91;2021-06-27;550;2996;565549;341683;42.9;25.9
91;2021-06-28;3129;8237;568678;349920;43.1;26.5
91;2021-06-29;3588;9633;572266;359553;43.4;27.3
91;2021-06-30;3954;8700;576220;368253;43.7;27.9
91;2021-07-01;4102;8871;580322;377124;44.0;28.6
91;2021-07-02;3775;9319;584097;386443;44.3;29.3
91;2021-07-03;2880;9789;586977;396232;44.5;30.0
91;2021-07-04;852;4726;587829;400958;44.6;30.4
91;2021-07-05;2662;7257;590491;408215;44.8;30.9
91;2021-07-06;3758;9430;594249;417645;45.0;31.7
91;2021-07-07;3806;8591;598055;426236;45.3;32.3
91;2021-07-08;4358;8991;602413;435227;45.7;33.0
91;2021-07-09;3968;9950;606381;445177;46.0;33.7
91;2021-07-10;3397;10236;609778;455413;46.2;34.5
91;2021-07-11;987;4804;610765;460217;46.3;34.9
91;2021-07-12;2803;8887;613568;469104;46.5;35.6
91;2021-07-13;4467;10392;618035;479496;46.8;36.3
91;2021-07-14;2303;3585;620338;483081;47.0;36.6
91;2021-07-15;4537;9824;624875;492905;47.4;37.4
91;2021-07-16;6287;9767;631162;502672;47.8;38.1
91;2021-07-17;5749;9067;636911;511739;48.3;38.8
91;2021-07-18;3402;3685;640313;515424;48.5;39.1
91;2021-07-19;3777;7537;644090;522961;48.8;39.6
91;2021-07-20;6074;9309;650164;532270;49.3;40.3
91;2021-07-21;6251;7733;656415;540003;49.8;40.9
91;2021-07-22;6498;8400;662913;548403;50.2;41.6
91;2021-07-23;6926;8286;669839;556689;50.8;42.2
91;2021-07-24;5013;6478;674852;563167;51.1;42.7
91;2021-07-25;3267;1408;678119;564575;51.4;42.8
91;2021-07-26;4934;6592;683053;571167;51.8;43.3
91;2021-07-27;7566;7083;690619;578250;52.3;43.8
91;2021-07-28;7365;5923;697984;584173;52.9;44.3
91;2021-07-29;7397;5912;705381;590085;53.5;44.7
91;2021-07-30;6914;5784;712295;595869;54.0;45.2
91;2021-07-31;4910;4789;717205;600658;54.4;45.5
91;2021-08-01;2659;1338;719864;601996;54.6;45.6
91;2021-08-02;4774;4236;724638;606232;54.9;45.9
91;2021-08-03;5942;4695;730580;610927;55.4;46.3
91;2021-08-04;5700;4141;736280;615068;55.8;46.6
91;2021-08-05;5605;4271;741885;619339;56.2;46.9
91;2021-08-06;5712;5628;747597;624967;56.7;47.4
91;2021-08-07;3084;2419;750681;627386;56.9;47.6
91;2021-08-08;622;1102;751303;628488;56.9;47.6
91;2021-08-09;3835;3976;755138;632464;57.2;47.9
91;2021-08-10;4650;4554;759788;637018;57.6;48.3
91;2021-08-11;4150;4486;763938;641504;57.9;48.6
91;2021-08-12;4089;4785;768027;646289;58.2;49.0
91;2021-08-13;4302;4865;772329;651154;58.5;49.4
91;2021-08-14;2246;2402;774575;653556;58.7;49.5
91;2021-08-15;95;171;774670;653727;58.7;49.5
91;2021-08-16;3103;4664;777773;658391;58.9;49.9
91;2021-08-17;3653;5819;781426;664210;59.2;50.3
91;2021-08-18;3029;5797;784455;670007;59.5;50.8
91;2021-08-19;3480;5775;787935;675782;59.7;51.2
91;2021-08-20;3218;6958;791153;682740;60.0;51.7
91;2021-08-21;2464;3355;793617;686095;60.1;52.0
91;2021-08-22;738;1297;794355;687392;60.2;52.1
91;2021-08-23;2426;5311;796781;692703;60.4;52.5
91;2021-08-24;2987;6962;799768;699665;60.6;53.0
91;2021-08-25;3436;6723;803204;706388;60.9;53.5
91;2021-08-26;2749;5953;805953;712341;61.1;54.0
91;2021-08-27;2837;7503;808790;719844;61.3;54.6
91;2021-08-28;2390;4836;811180;724680;61.5;54.9
91;2021-08-29;1776;2798;812956;727478;61.6;55.1
91;2021-08-30;1802;5610;814758;733088;61.8;55.6
91;2021-08-31;2258;6100;817016;739188;61.9;56.0
91;2021-09-01;2443;4612;819459;743800;62.1;56.4
91;2021-09-02;1912;3900;821371;747700;62.3;56.7
91;2021-09-03;2167;4977;823538;752677;62.4;57.0
91;2021-09-04;2079;4236;825617;756913;62.6;57.4
91;2021-09-05;749;944;826366;757857;62.6;57.4
91;2021-09-06;1692;3506;828058;761363;62.8;57.7
91;2021-09-07;1566;3288;829624;764651;62.9;58.0
91;2021-09-08;1793;3553;831417;768204;63.0;58.2
91;2021-09-09;1304;3366;832721;771570;63.1;58.5
91;2021-09-10;1794;4034;834515;775604;63.2;58.8
91;2021-09-11;1746;4480;836261;780084;63.4;59.1
91;2021-09-12;626;1035;836887;781119;63.4;59.2
91;2021-09-13;1274;2909;838161;784028;63.5;59.4
91;2021-09-14;1823;3504;839984;787532;63.7;59.7
91;2021-09-15;1656;3287;841640;790819;63.8;59.9
91;2021-09-16;1472;2383;843112;793202;63.9;60.1
91;2021-09-17;1436;2999;844548;796201;64.0;60.3
91;2021-09-18;1384;3667;845932;799868;64.1;60.6
91;2021-09-19;455;1147;846387;801015;64.1;60.7
91;2021-09-20;753;1599;847140;802614;64.2;60.8
91;2021-09-21;883;1748;848023;804362;64.3;61.0
91;2021-09-22;926;2641;848949;807003;64.3;61.2
91;2021-09-23;925;1733;849874;808736;64.4;61.3
91;2021-09-24;897;2200;850771;810936;64.5;61.5
91;2021-09-25;1051;3482;851822;814418;64.6;61.7
91;2021-09-26;219;821;852041;815239;64.6;61.8
91;2021-09-27;726;1570;852767;816809;64.6;61.9
91;2021-09-28;898;1443;853665;818252;64.7;62.0
91;2021-09-29;1014;2225;854679;820477;64.8;62.2
91;2021-09-30;657;1130;855336;821607;64.8;62.3
91;2021-10-01;964;1870;856300;823477;64.9;62.4
91;2021-10-02;1107;2390;857407;825867;65.0;62.6
91;2021-10-03;266;613;857673;826480;65.0;62.6
91;2021-10-04;616;1165;858289;827645;65.1;62.7
91;2021-10-05;588;1112;858877;828757;65.1;62.8
91;2021-10-06;773;1924;859650;830681;65.2;63.0
92;2020-12-27;46;0;46;0;0.0;0.0
92;2020-12-28;29;0;75;0;0.0;0.0
92;2020-12-29;65;0;140;0;0.0;0.0
92;2020-12-30;52;0;192;0;0.0;0.0
92;2020-12-31;13;0;205;0;0.0;0.0
92;2021-01-01;38;0;243;0;0.0;0.0
92;2021-01-02;15;0;258;0;0.0;0.0
92;2021-01-03;19;0;277;0;0.0;0.0
92;2021-01-04;79;1;356;1;0.0;0.0
92;2021-01-05;236;1;592;2;0.0;0.0
92;2021-01-06;419;3;1011;5;0.1;0.0
92;2021-01-07;673;4;1684;9;0.1;0.0
92;2021-01-08;850;4;2534;13;0.2;0.0
92;2021-01-09;130;1;2664;14;0.2;0.0
92;2021-01-10;52;0;2716;14;0.2;0.0
92;2021-01-11;853;5;3569;19;0.2;0.0
92;2021-01-12;1308;9;4877;28;0.3;0.0
92;2021-01-13;1254;13;6131;41;0.4;0.0
92;2021-01-14;1243;17;7374;58;0.5;0.0
92;2021-01-15;986;7;8360;65;0.5;0.0
92;2021-01-16;187;1;8547;66;0.5;0.0
92;2021-01-17;33;0;8580;66;0.5;0.0
92;2021-01-18;1557;20;10137;86;0.6;0.0
92;2021-01-19;1578;20;11715;106;0.7;0.0
92;2021-01-20;1825;11;13540;117;0.8;0.0
92;2021-01-21;3455;21;16995;138;1.1;0.0
92;2021-01-22;2625;40;19620;178;1.2;0.0
92;2021-01-23;153;0;19773;178;1.2;0.0
92;2021-01-24;34;0;19807;178;1.2;0.0
92;2021-01-25;862;13;20669;191;1.3;0.0
92;2021-01-26;1220;10;21889;201;1.4;0.0
92;2021-01-27;2226;90;24115;291;1.5;0.0
92;2021-01-28;4201;175;28316;466;1.8;0.0
92;2021-01-29;2719;232;31035;698;1.9;0.0
92;2021-01-30;327;11;31362;709;1.9;0.0
92;2021-01-31;35;1;31397;710;1.9;0.0
92;2021-02-01;877;290;32274;1000;2.0;0.1
92;2021-02-02;1071;320;33345;1320;2.1;0.1
92;2021-02-03;1006;412;34351;1732;2.1;0.1
92;2021-02-04;1058;485;35409;2217;2.2;0.1
92;2021-02-05;1336;457;36745;2674;2.3;0.2
92;2021-02-06;127;18;36872;2692;2.3;0.2
92;2021-02-07;23;13;36895;2705;2.3;0.2
92;2021-02-08;589;624;37484;3329;2.3;0.2
92;2021-02-09;1073;1146;38557;4475;2.4;0.3
92;2021-02-10;1093;1190;39650;5665;2.5;0.4
92;2021-02-11;1520;1690;41170;7355;2.6;0.5
92;2021-02-12;1424;1373;42594;8728;2.6;0.5
92;2021-02-13;80;58;42674;8786;2.6;0.5
92;2021-02-14;30;0;42704;8786;2.6;0.5
92;2021-02-15;584;1227;43288;10013;2.7;0.6
92;2021-02-16;793;1614;44081;11627;2.7;0.7
92;2021-02-17;628;1475;44709;13102;2.8;0.8
92;2021-02-18;1584;2919;46293;16021;2.9;1.0
92;2021-02-19;1736;2268;48029;18289;3.0;1.1
92;2021-02-20;149;337;48178;18626;3.0;1.2
92;2021-02-21;49;49;48227;18675;3.0;1.2
92;2021-02-22;505;964;48732;19639;3.0;1.2
92;2021-02-23;743;1069;49475;20708;3.1;1.3
92;2021-02-24;618;1016;50093;21724;3.1;1.3
92;2021-02-25;935;1422;51028;23146;3.2;1.4
92;2021-02-26;1467;1119;52495;24265;3.3;1.5
92;2021-02-27;507;167;53002;24432;3.3;1.5
92;2021-02-28;75;44;53077;24476;3.3;1.5
92;2021-03-01;1105;814;54182;25290;3.4;1.6
92;2021-03-02;1985;1081;56167;26371;3.5;1.6
92;2021-03-03;2811;898;58978;27269;3.7;1.7
92;2021-03-04;3606;1268;62584;28537;3.9;1.8
92;2021-03-05;4985;1452;67569;29989;4.2;1.9
92;2021-03-06;5725;322;73294;30311;4.5;1.9
92;2021-03-07;2908;228;76202;30539;4.7;1.9
92;2021-03-08;2430;691;78632;31230;4.9;1.9
92;2021-03-09;3449;874;82081;32104;5.1;2.0
92;2021-03-10;3952;873;86033;32977;5.3;2.0
92;2021-03-11;5027;1296;91060;34273;5.6;2.1
92;2021-03-12;6779;1471;97839;35744;6.1;2.2
92;2021-03-13;5163;236;103002;35980;6.4;2.2
92;2021-03-14;1747;76;104749;36056;6.5;2.2
92;2021-03-15;3810;587;108559;36643;6.7;2.3
92;2021-03-16;3700;564;112259;37207;7.0;2.3
92;2021-03-17;3880;421;116139;37628;7.2;2.3
92;2021-03-18;4149;738;120288;38366;7.5;2.4
92;2021-03-19;5936;719;126224;39085;7.8;2.4
92;2021-03-20;2542;76;128766;39161;8.0;2.4
92;2021-03-21;156;29;128922;39190;8.0;2.4
92;2021-03-22;4119;476;133041;39666;8.2;2.5
92;2021-03-23;6113;862;139154;40528;8.6;2.5
92;2021-03-24;6385;657;145539;41185;9.0;2.6
92;2021-03-25;8446;644;153985;41829;9.5;2.6
92;2021-03-26;8363;892;162348;42721;10.1;2.6
92;2021-03-27;2838;282;165186;43003;10.2;2.7
92;2021-03-28;543;39;165729;43042;10.3;2.7
92;2021-03-29;4672;1055;170401;44097;10.6;2.7
92;2021-03-30;6396;1544;176797;45641;11.0;2.8
92;2021-03-31;5556;2233;182353;47874;11.3;3.0
92;2021-04-01;6278;3659;188631;51533;11.7;3.2
92;2021-04-02;5640;3414;194271;54947;12.0;3.4
92;2021-04-03;877;1409;195148;56356;12.1;3.5
92;2021-04-04;492;1053;195640;57409;12.1;3.6
92;2021-04-05;817;158;196457;57567;12.2;3.6
92;2021-04-06;3666;1945;200123;59512;12.4;3.7
92;2021-04-07;5004;2887;205127;62399;12.7;3.9
92;2021-04-08;5993;3183;211120;65582;13.1;4.1
92;2021-04-09;8037;3048;219157;68630;13.6;4.3
92;2021-04-10;2643;1290;221800;69920;13.7;4.3
92;2021-04-11;167;805;221967;70725;13.8;4.4
92;2021-04-12;3688;2511;225655;73236;14.0;4.5
92;2021-04-13;4388;4422;230043;77658;14.3;4.8
92;2021-04-14;4877;4037;234920;81695;14.6;5.1
92;2021-04-15;5303;3951;240223;85646;14.9;5.3
92;2021-04-16;5079;3856;245302;89502;15.2;5.5
92;2021-04-17;1807;1188;247109;90690;15.3;5.6
92;2021-04-18;351;94;247460;90784;15.3;5.6
92;2021-04-19;2820;2842;250280;93626;15.5;5.8
92;2021-04-20;4200;3757;254480;97383;15.8;6.0
92;2021-04-21;4618;4514;259098;101897;16.1;6.3
92;2021-04-22;4663;5121;263761;107018;16.3;6.6
92;2021-04-23;5260;4704;269021;111722;16.7;6.9
92;2021-04-24;4943;1902;273964;113624;17.0;7.0
92;2021-04-25;1797;148;275761;113772;17.1;7.1
92;2021-04-26;4003;3618;279764;117390;17.3;7.3
92;2021-04-27;6048;5253;285812;122643;17.7;7.6
92;2021-04-28;7385;4490;293197;127133;18.2;7.9
92;2021-04-29;7994;4767;301191;131900;18.7;8.2
92;2021-04-30;8845;4838;310036;136738;19.2;8.5
92;2021-05-01;1202;405;311238;137143;19.3;8.5
92;2021-05-02;669;139;311907;137282;19.3;8.5
92;2021-05-03;6789;3879;318696;141161;19.7;8.7
92;2021-05-04;10435;4355;329131;145516;20.4;9.0
92;2021-05-05;10077;5242;339208;150758;21.0;9.3
92;2021-05-06;11427;4897;350635;155655;21.7;9.6
92;2021-05-07;9867;5292;360502;160947;22.3;10.0
92;2021-05-08;7214;1921;367716;162868;22.8;10.1
92;2021-05-09;3786;600;371502;163468;23.0;10.1
92;2021-05-10;9547;3995;381049;167463;23.6;10.4
92;2021-05-11;13978;5682;395027;173145;24.5;10.7
92;2021-05-12;14287;4577;409314;177722;25.4;11.0
92;2021-05-13;9168;903;418482;178625;25.9;11.1
92;2021-05-14;12030;2303;430512;180928;26.7;11.2
92;2021-05-15;8393;1227;438905;182155;27.2;11.3
92;2021-05-16;4142;453;443047;182608;27.5;11.3
92;2021-05-17;10649;2216;453696;184824;28.1;11.5
92;2021-05-18;16410;3117;470106;187941;29.1;11.6
92;2021-05-19;16045;3715;486151;191656;30.1;11.9
92;2021-05-20;16840;3981;502991;195637;31.2;12.1
92;2021-05-21;14071;3612;517062;199249;32.0;12.3
92;2021-05-22;8318;1512;525380;200761;32.6;12.4
92;2021-05-23;4082;454;529462;201215;32.8;12.5
92;2021-05-24;6121;856;535583;202071;33.2;12.5
92;2021-05-25;13113;4563;548696;206634;34.0;12.8
92;2021-05-26;11924;5037;560620;211671;34.7;13.1
92;2021-05-27;12737;6326;573357;217997;35.5;13.5
92;2021-05-28;11234;6277;584591;224274;36.2;13.9
92;2021-05-29;5451;2304;590042;226578;36.6;14.0
92;2021-05-30;2252;389;592294;226967;36.7;14.1
92;2021-05-31;12049;5297;604343;232264;37.4;14.4
92;2021-06-01;12634;7634;616977;239898;38.2;14.9
92;2021-06-02;14380;7203;631357;247101;39.1;15.3
92;2021-06-03;14598;8022;645955;255123;40.0;15.8
92;2021-06-04;12236;8221;658191;263344;40.8;16.3
92;2021-06-05;7383;6229;665574;269573;41.2;16.7
92;2021-06-06;3597;1675;669171;271248;41.5;16.8
92;2021-06-07;11435;7637;680606;278885;42.2;17.3
92;2021-06-08;12765;9603;693371;288488;43.0;17.9
92;2021-06-09;11662;9474;705033;297962;43.7;18.5
92;2021-06-10;11967;10566;717000;308528;44.4;19.1
92;2021-06-11;8155;11032;725155;319560;44.9;19.8
92;2021-06-12;6364;5092;731519;324652;45.3;20.1
92;2021-06-13;3971;2720;735490;327372;45.6;20.3
92;2021-06-14;5212;11171;740702;338543;45.9;21.0
92;2021-06-15;6537;13122;747239;351665;46.3;21.8
92;2021-06-16;6953;12991;754192;364656;46.7;22.6
92;2021-06-17;7429;14000;761621;378656;47.2;23.5
92;2021-06-18;6907;14385;768528;393041;47.6;24.4
92;2021-06-19;3965;9106;772493;402147;47.9;24.9
92;2021-06-20;1968;5606;774461;407753;48.0;25.3
92;2021-06-21;4841;12275;779302;420028;48.3;26.0
92;2021-06-22;5880;17535;785182;437563;48.7;27.1
92;2021-06-23;5484;15991;790666;453554;49.0;28.1
92;2021-06-24;6210;15119;796876;468673;49.4;29.0
92;2021-06-25;5120;16098;801996;484771;49.7;30.0
92;2021-06-26;4070;10454;806066;495225;49.9;30.7
92;2021-06-27;1858;6046;807924;501271;50.1;31.1
92;2021-06-28;3673;12047;811597;513318;50.3;31.8
92;2021-06-29;4679;18154;816276;531472;50.6;32.9
92;2021-06-30;4455;16226;820731;547698;50.9;33.9
92;2021-07-01;5527;16306;826258;564004;51.2;34.9
92;2021-07-02;4942;15278;831200;579282;51.5;35.9
92;2021-07-03;3308;10185;834508;589467;51.7;36.5
92;2021-07-04;1125;4208;835633;593675;51.8;36.8
92;2021-07-05;4826;12332;840459;606007;52.1;37.6
92;2021-07-06;5288;15811;845747;621818;52.4;38.5
92;2021-07-07;4267;11461;850014;633279;52.7;39.2
92;2021-07-08;5408;14638;855422;647917;53.0;40.1
92;2021-07-09;5899;14204;861321;662121;53.4;41.0
92;2021-07-10;4378;8457;865699;670578;53.6;41.6
92;2021-07-11;1487;2615;867186;673193;53.7;41.7
92;2021-07-12;4418;14643;871604;687836;54.0;42.6
92;2021-07-13;7881;17457;879485;705293;54.5;43.7
92;2021-07-14;5115;5746;884600;711039;54.8;44.1
92;2021-07-15;9570;16256;894170;727295;55.4;45.1
92;2021-07-16;9065;14188;903235;741483;56.0;45.9
92;2021-07-17;6582;7604;909817;749087;56.4;46.4
92;2021-07-18;1841;2482;911658;751569;56.5;46.6
92;2021-07-19;6480;13198;918138;764767;56.9;47.4
92;2021-07-20;10091;14105;928229;778872;57.5;48.3
92;2021-07-21;10471;12123;938700;790995;58.2;49.0
92;2021-07-22;12059;12994;950759;803989;58.9;49.8
92;2021-07-23;11592;11357;962351;815346;59.6;50.5
92;2021-07-24;6733;6268;969084;821614;60.1;50.9
92;2021-07-25;2778;2329;971862;823943;60.2;51.1
92;2021-07-26;9491;9180;981353;833123;60.8;51.6
92;2021-07-27;11523;9623;992876;842746;61.5;52.2
92;2021-07-28;12951;8208;1005827;850954;62.3;52.7
92;2021-07-29;10455;8637;1016282;859591;63.0;53.3
92;2021-07-30;9132;8358;1025414;867949;63.5;53.8
92;2021-07-31;5703;4824;1031117;872773;63.9;54.1
92;2021-08-01;2217;1301;1033334;874074;64.0;54.2
92;2021-08-02;4781;4936;1038115;879010;64.3;54.5
92;2021-08-03;5144;6147;1043259;885157;64.6;54.9
92;2021-08-04;4778;4875;1048037;890032;64.9;55.2
92;2021-08-05;4531;5693;1052568;895725;65.2;55.5
92;2021-08-06;4552;5973;1057120;901698;65.5;55.9
92;2021-08-07;2839;4183;1059959;905881;65.7;56.1
92;2021-08-08;963;1082;1060922;906963;65.7;56.2
92;2021-08-09;3212;4254;1064134;911217;65.9;56.5
92;2021-08-10;3836;5613;1067970;916830;66.2;56.8
92;2021-08-11;3239;4436;1071209;921266;66.4;57.1
92;2021-08-12;3396;5602;1074605;926868;66.6;57.4
92;2021-08-13;2999;5148;1077604;932016;66.8;57.8
92;2021-08-14;1886;3930;1079490;935946;66.9;58.0
92;2021-08-15;590;839;1080080;936785;66.9;58.0
92;2021-08-16;2404;5326;1082484;942111;67.1;58.4
92;2021-08-17;2637;6992;1085121;949103;67.2;58.8
92;2021-08-18;2431;5256;1087552;954359;67.4;59.1
92;2021-08-19;2526;5745;1090078;960104;67.5;59.5
92;2021-08-20;2283;5199;1092361;965303;67.7;59.8
92;2021-08-21;1392;4223;1093753;969526;67.8;60.1
92;2021-08-22;428;1599;1094181;971125;67.8;60.2
92;2021-08-23;2495;6600;1096676;977725;68.0;60.6
92;2021-08-24;3156;8352;1099832;986077;68.2;61.1
92;2021-08-25;2864;7584;1102696;993661;68.3;61.6
92;2021-08-26;3018;7578;1105714;1001239;68.5;62.0
92;2021-08-27;3100;7017;1108814;1008256;68.7;62.5
92;2021-08-28;1620;4517;1110434;1012773;68.8;62.8
92;2021-08-29;345;789;1110779;1013562;68.8;62.8
92;2021-08-30;2254;4900;1113033;1018462;69.0;63.1
92;2021-08-31;3093;7048;1116126;1025510;69.2;63.5
92;2021-09-01;3361;7607;1119487;1033117;69.4;64.0
92;2021-09-02;2664;6831;1122151;1039948;69.5;64.4
92;2021-09-03;2700;6598;1124851;1046546;69.7;64.9
92;2021-09-04;2338;5056;1127189;1051602;69.8;65.2
92;2021-09-05;445;1051;1127634;1052653;69.9;65.2
92;2021-09-06;1331;3706;1128965;1056359;70.0;65.5
92;2021-09-07;1709;4197;1130674;1060556;70.1;65.7
92;2021-09-08;2181;4318;1132855;1064874;70.2;66.0
92;2021-09-09;1233;3274;1134088;1068148;70.3;66.2
92;2021-09-10;1789;4252;1135877;1072400;70.4;66.5
92;2021-09-11;1576;2943;1137453;1075343;70.5;66.6
92;2021-09-12;210;466;1137663;1075809;70.5;66.7
92;2021-09-13;1115;3090;1138778;1078899;70.6;66.9
92;2021-09-14;1238;3595;1140016;1082494;70.6;67.1
92;2021-09-15;1594;3627;1141610;1086121;70.7;67.3
92;2021-09-16;1080;2158;1142690;1088279;70.8;67.4
92;2021-09-17;1430;3096;1144120;1091375;70.9;67.6
92;2021-09-18;931;2232;1145051;1093607;71.0;67.8
92;2021-09-19;128;291;1145179;1093898;71.0;67.8
92;2021-09-20;773;1831;1145952;1095729;71.0;67.9
92;2021-09-21;780;1870;1146732;1097599;71.1;68.0
92;2021-09-22;1078;3817;1147810;1101416;71.1;68.3
92;2021-09-23;737;1823;1148547;1103239;71.2;68.4
92;2021-09-24;1095;2850;1149642;1106089;71.2;68.5
92;2021-09-25;620;2212;1150262;1108301;71.3;68.7
92;2021-09-26;95;249;1150357;1108550;71.3;68.7
92;2021-09-27;768;1627;1151125;1110177;71.3;68.8
92;2021-09-28;786;1570;1151911;1111747;71.4;68.9
92;2021-09-29;1133;2835;1153044;1114582;71.5;69.1
92;2021-09-30;848;1327;1153892;1115909;71.5;69.1
92;2021-10-01;1126;2095;1155018;1118004;71.6;69.3
92;2021-10-02;798;1803;1155816;1119807;71.6;69.4
92;2021-10-03;89;205;1155905;1120012;71.6;69.4
92;2021-10-04;699;1311;1156604;1121323;71.7;69.5
92;2021-10-05;729;1318;1157333;1122641;71.7;69.6
92;2021-10-06;1055;1978;1158388;1124619;71.8;69.7
93;2020-12-27;12;3;12;3;0.0;0.0
93;2020-12-28;6;0;18;3;0.0;0.0
93;2020-12-29;2;0;20;3;0.0;0.0
93;2020-12-30;44;1;64;4;0.0;0.0
93;2020-12-31;11;0;75;4;0.0;0.0
93;2021-01-01;5;0;80;4;0.0;0.0
93;2021-01-02;1;0;81;4;0.0;0.0
93;2021-01-03;4;0;85;4;0.0;0.0
93;2021-01-04;3;0;88;4;0.0;0.0
93;2021-01-05;66;1;154;5;0.0;0.0
93;2021-01-06;179;0;333;5;0.0;0.0
93;2021-01-07;381;1;714;6;0.0;0.0
93;2021-01-08;632;1;1346;7;0.1;0.0
93;2021-01-09;21;0;1367;7;0.1;0.0
93;2021-01-10;2;0;1369;7;0.1;0.0
93;2021-01-11;505;3;1874;10;0.1;0.0
93;2021-01-12;753;7;2627;17;0.2;0.0
93;2021-01-13;751;6;3378;23;0.2;0.0
93;2021-01-14;689;18;4067;41;0.2;0.0
93;2021-01-15;515;3;4582;44;0.3;0.0
93;2021-01-16;138;3;4720;47;0.3;0.0
93;2021-01-17;6;1;4726;48;0.3;0.0
93;2021-01-18;1198;11;5924;59;0.4;0.0
93;2021-01-19;1614;17;7538;76;0.5;0.0
93;2021-01-20;1557;18;9095;94;0.5;0.0
93;2021-01-21;1921;35;11016;129;0.7;0.0
93;2021-01-22;1391;14;12407;143;0.7;0.0
93;2021-01-23;713;4;13120;147;0.8;0.0
93;2021-01-24;0;0;13120;147;0.8;0.0
93;2021-01-25;1208;13;14328;160;0.9;0.0
93;2021-01-26;1296;28;15624;188;0.9;0.0
93;2021-01-27;2159;63;17783;251;1.1;0.0
93;2021-01-28;2267;172;20050;423;1.2;0.0
93;2021-01-29;1625;206;21675;629;1.3;0.0
93;2021-01-30;927;36;22602;665;1.4;0.0
93;2021-01-31;9;5;22611;670;1.4;0.0
93;2021-02-01;1187;146;23798;816;1.4;0.0
93;2021-02-02;1174;283;24972;1099;1.5;0.1
93;2021-02-03;1231;389;26203;1488;1.6;0.1
93;2021-02-04;926;538;27129;2026;1.6;0.1
93;2021-02-05;800;396;27929;2422;1.7;0.1
93;2021-02-06;694;65;28623;2487;1.7;0.1
93;2021-02-07;6;0;28629;2487;1.7;0.1
93;2021-02-08;913;546;29542;3033;1.8;0.2
93;2021-02-09;852;553;30394;3586;1.8;0.2
93;2021-02-10;882;616;31276;4202;1.9;0.3
93;2021-02-11;1244;719;32520;4921;1.9;0.3
93;2021-02-12;1041;565;33561;5486;2.0;0.3
93;2021-02-13;395;209;33956;5695;2.0;0.3
93;2021-02-14;13;58;33969;5753;2.0;0.3
93;2021-02-15;414;908;34383;6661;2.1;0.4
93;2021-02-16;553;989;34936;7650;2.1;0.5
93;2021-02-17;542;1323;35478;8973;2.1;0.5
93;2021-02-18;1136;1630;36614;10603;2.2;0.6
93;2021-02-19;994;1290;37608;11893;2.3;0.7
93;2021-02-20;304;529;37912;12422;2.3;0.7
93;2021-02-21;10;24;37922;12446;2.3;0.7
93;2021-02-22;602;985;38524;13431;2.3;0.8
93;2021-02-23;561;873;39085;14304;2.3;0.9
93;2021-02-24;646;959;39731;15263;2.4;0.9
93;2021-02-25;901;863;40632;16126;2.4;1.0
93;2021-02-26;1121;819;41753;16945;2.5;1.0
93;2021-02-27;543;515;42296;17460;2.5;1.0
93;2021-02-28;88;57;42384;17517;2.5;1.0
93;2021-03-01;1083;854;43467;18371;2.6;1.1
93;2021-03-02;1447;949;44914;19320;2.7;1.2
93;2021-03-03;1747;1017;46661;20337;2.8;1.2
93;2021-03-04;2718;1021;49379;21358;3.0;1.3
93;2021-03-05;3820;801;53199;22159;3.2;1.3
93;2021-03-06;5050;527;58249;22686;3.5;1.4
93;2021-03-07;4300;238;62549;22924;3.7;1.4
93;2021-03-08;2036;1118;64585;24042;3.9;1.4
93;2021-03-09;2914;885;67499;24927;4.0;1.5
93;2021-03-10;2860;1032;70359;25959;4.2;1.6
93;2021-03-11;3575;1186;73934;27145;4.4;1.6
93;2021-03-12;4124;1248;78058;28393;4.7;1.7
93;2021-03-13;4290;613;82348;29006;4.9;1.7
93;2021-03-14;884;70;83232;29076;5.0;1.7
93;2021-03-15;3556;660;86788;29736;5.2;1.8
93;2021-03-16;3159;606;89947;30342;5.4;1.8
93;2021-03-17;2656;597;92603;30939;5.5;1.9
93;2021-03-18;3317;716;95920;31655;5.7;1.9
93;2021-03-19;3767;634;99687;32289;6.0;1.9
93;2021-03-20;3459;299;103146;32588;6.2;2.0
93;2021-03-21;813;266;103959;32854;6.2;2.0
93;2021-03-22;3851;617;107810;33471;6.5;2.0
93;2021-03-23;4766;809;112576;34280;6.7;2.1
93;2021-03-24;4114;685;116690;34965;7.0;2.1
93;2021-03-25;5586;872;122276;35837;7.3;2.1
93;2021-03-26;5547;893;127823;36730;7.7;2.2
93;2021-03-27;4283;320;132106;37050;7.9;2.2
93;2021-03-28;613;42;132719;37092;7.9;2.2
93;2021-03-29;3851;964;136570;38056;8.2;2.3
93;2021-03-30;4726;1269;141296;39325;8.5;2.4
93;2021-03-31;3914;1249;145210;40574;8.7;2.4
93;2021-04-01;4055;3139;149265;43713;8.9;2.6
93;2021-04-02;3224;3549;152489;47262;9.1;2.8
93;2021-04-03;2518;2258;155007;49520;9.3;3.0
93;2021-04-04;765;164;155772;49684;9.3;3.0
93;2021-04-05;708;87;156480;49771;9.4;3.0
93;2021-04-06;4563;2353;161043;52124;9.6;3.1
93;2021-04-07;4903;2093;165946;54217;9.9;3.2
93;2021-04-08;5814;2684;171760;56901;10.3;3.4
93;2021-04-09;6096;3179;177856;60080;10.6;3.6
93;2021-04-10;4198;2484;182054;62564;10.9;3.7
93;2021-04-11;575;434;182629;62998;10.9;3.8
93;2021-04-12;4100;2913;186729;65911;11.2;3.9
93;2021-04-13;4606;3651;191335;69562;11.5;4.2
93;2021-04-14;4366;2478;195701;72040;11.7;4.3
93;2021-04-15;4559;3036;200260;75076;12.0;4.5
93;2021-04-16;4442;2990;204702;78066;12.3;4.7
93;2021-04-17;3517;2500;208219;80566;12.5;4.8
93;2021-04-18;289;433;208508;80999;12.5;4.8
93;2021-04-19;3776;2864;212284;83863;12.7;5.0
93;2021-04-20;4308;3261;216592;87124;13.0;5.2
93;2021-04-21;4145;2770;220737;89894;13.2;5.4
93;2021-04-22;4513;4022;225250;93916;13.5;5.6
93;2021-04-23;5628;3245;230878;97161;13.8;5.8
93;2021-04-24;5921;3329;236799;100490;14.2;6.0
93;2021-04-25;1733;598;238532;101088;14.3;6.1
93;2021-04-26;4864;3075;243396;104163;14.6;6.2
93;2021-04-27;6453;3623;249849;107786;15.0;6.5
93;2021-04-28;6071;3431;255920;111217;15.3;6.7
93;2021-04-29;7301;3244;263221;114461;15.8;6.9
93;2021-04-30;8267;3113;271488;117574;16.3;7.0
93;2021-05-01;4948;1191;276436;118765;16.6;7.1
93;2021-05-02;419;646;276855;119411;16.6;7.1
93;2021-05-03;8173;5116;285028;124527;17.1;7.5
93;2021-05-04;7824;5395;292852;129922;17.5;7.8
93;2021-05-05;7576;4805;300428;134727;18.0;8.1
93;2021-05-06;8251;4777;308679;139504;18.5;8.4
93;2021-05-07;7015;5427;315694;144931;18.9;8.7
93;2021-05-08;8363;2393;324057;147324;19.4;8.8
93;2021-05-09;6125;1369;330182;148693;19.8;8.9
93;2021-05-10;8257;4072;338439;152765;20.3;9.1
93;2021-05-11;9307;4798;347746;157563;20.8;9.4
93;2021-05-12;9194;3656;356940;161219;21.4;9.7
93;2021-05-13;8300;1650;365240;162869;21.9;9.8
93;2021-05-14;10421;3527;375661;166396;22.5;10.0
93;2021-05-15;11125;3008;386786;169404;23.2;10.1
93;2021-05-16;5558;727;392344;170131;23.5;10.2
93;2021-05-17;11904;2270;404248;172401;24.2;10.3
93;2021-05-18;14098;2387;418346;174788;25.0;10.5
93;2021-05-19;11433;2943;429779;177731;25.7;10.6
93;2021-05-20;12624;3486;442403;181217;26.5;10.9
93;2021-05-21;13015;2886;455418;184103;27.3;11.0
93;2021-05-22;12376;2199;467794;186302;28.0;11.2
93;2021-05-23;8478;1108;476272;187410;28.5;11.2
93;2021-05-24;11209;1943;487481;189353;29.2;11.3
93;2021-05-25;12292;4318;499773;193671;29.9;11.6
93;2021-05-26;11080;3758;510853;197429;30.6;11.8
93;2021-05-27;12708;3894;523561;201323;31.3;12.1
93;2021-05-28;12653;5254;536214;206577;32.1;12.4
93;2021-05-29;11395;4264;547609;210841;32.8;12.6
93;2021-05-30;8209;1380;555818;212221;33.3;12.7
93;2021-05-31;9179;5174;564997;217395;33.8;13.0
93;2021-06-01;11405;6277;576402;223672;34.5;13.4
93;2021-06-02;10719;5195;587121;228867;35.2;13.7
93;2021-06-03;10817;5517;597938;234384;35.8;14.0
93;2021-06-04;10592;7789;608530;242173;36.4;14.5
93;2021-06-05;9018;7358;617548;249531;37.0;14.9
93;2021-06-06;8403;1746;625951;251277;37.5;15.0
93;2021-06-07;10068;7512;636019;258789;38.1;15.5
93;2021-06-08;10367;7378;646386;266167;38.7;15.9
93;2021-06-09;10242;7293;656628;273460;39.3;16.4
93;2021-06-10;9011;8195;665639;281655;39.9;16.9
93;2021-06-11;8824;8815;674463;290470;40.4;17.4
93;2021-06-12;9862;6658;684325;297128;41.0;17.8
93;2021-06-13;7168;2130;691493;299258;41.4;17.9
93;2021-06-14;5400;9733;696893;308991;41.7;18.5
93;2021-06-15;6237;9661;703130;318652;42.1;19.1
93;2021-06-16;6647;9059;709777;327711;42.5;19.6
93;2021-06-17;5753;8464;715530;336175;42.8;20.1
93;2021-06-18;7226;11120;722756;347295;43.3;20.8
93;2021-06-19;7075;11101;729831;358396;43.7;21.5
93;2021-06-20;4945;6877;734776;365273;44.0;21.9
93;2021-06-21;4071;10728;738847;376001;44.2;22.5
93;2021-06-22;4696;11314;743543;387315;44.5;23.2
93;2021-06-23;4538;10595;748081;397910;44.8;23.8
93;2021-06-24;4200;10297;752281;408207;45.0;24.4
93;2021-06-25;5187;13052;757468;421259;45.4;25.2
93;2021-06-26;5300;13927;762768;435186;45.7;26.1
93;2021-06-27;3285;7104;766053;442290;45.9;26.5
93;2021-06-28;3699;12507;769752;454797;46.1;27.2
93;2021-06-29;4016;12354;773768;467151;46.3;28.0
93;2021-06-30;4145;11302;777913;478453;46.6;28.6
93;2021-07-01;6092;11162;784005;489615;46.9;29.3
93;2021-07-02;5807;12380;789812;501995;47.3;30.1
93;2021-07-03;5550;13464;795362;515459;47.6;30.9
93;2021-07-04;3081;7888;798443;523347;47.8;31.3
93;2021-07-05;4592;10848;803035;534195;48.1;32.0
93;2021-07-06;4850;11760;807885;545955;48.4;32.7
93;2021-07-07;5229;11415;813114;557370;48.7;33.4
93;2021-07-08;5062;10268;818176;567638;49.0;34.0
93;2021-07-09;5924;13034;824100;580672;49.3;34.8
93;2021-07-10;5920;14293;830020;594965;49.7;35.6
93;2021-07-11;3689;9092;833709;604057;49.9;36.2
93;2021-07-12;5606;12079;839315;616136;50.3;36.9
93;2021-07-13;11144;13311;850459;629447;50.9;37.7
93;2021-07-14;10671;6797;861130;636244;51.6;38.1
93;2021-07-15;12557;14138;873687;650382;52.3;38.9
93;2021-07-16;13242;13698;886929;664080;53.1;39.8
93;2021-07-17;11370;13918;898299;677998;53.8;40.6
93;2021-07-18;7399;8959;905698;686957;54.2;41.1
93;2021-07-19;9637;10930;915335;697887;54.8;41.8
93;2021-07-20;12664;10690;927999;708577;55.6;42.4
93;2021-07-21;14410;10956;942409;719533;56.4;43.1
93;2021-07-22;14181;9482;956590;729015;57.3;43.6
93;2021-07-23;14622;10662;971212;739677;58.2;44.3
93;2021-07-24;13924;10649;985136;750326;59.0;44.9
93;2021-07-25;9036;6364;994172;756690;59.5;45.3
93;2021-07-26;12795;7798;1006967;764488;60.3;45.8
93;2021-07-27;15186;7467;1022153;771955;61.2;46.2
93;2021-07-28;15026;8310;1037179;780265;62.1;46.7
93;2021-07-29;13606;7081;1050785;787346;62.9;47.1
93;2021-07-30;14190;7875;1064975;795221;63.8;47.6
93;2021-07-31;12254;7722;1077229;802943;64.5;48.1
93;2021-08-01;7512;4605;1084741;807548;64.9;48.4
93;2021-08-02;12339;5750;1097080;813298;65.7;48.7
93;2021-08-03;8429;6871;1105509;820169;66.2;49.1
93;2021-08-04;8166;8009;1113675;828178;66.7;49.6
93;2021-08-05;6288;6865;1119963;835043;67.1;50.0
93;2021-08-06;7364;8339;1127327;843382;67.5;50.5
93;2021-08-07;7478;9055;1134805;852437;67.9;51.0
93;2021-08-08;4546;5566;1139351;858003;68.2;51.4
93;2021-08-09;7619;8088;1146970;866091;68.7;51.9
93;2021-08-10;7471;8849;1154441;874940;69.1;52.4
93;2021-08-11;7660;9692;1162101;884632;69.6;53.0
93;2021-08-12;6629;9045;1168730;893677;70.0;53.5
93;2021-08-13;6838;9031;1175568;902708;70.4;54.0
93;2021-08-14;7216;10501;1182784;913209;70.8;54.7
93;2021-08-15;2956;3623;1185740;916832;71.0;54.9
93;2021-08-16;6562;11220;1192302;928052;71.4;55.6
93;2021-08-17;6287;10918;1198589;938970;71.8;56.2
93;2021-08-18;5714;11214;1204303;950184;72.1;56.9
93;2021-08-19;5023;9674;1209326;959858;72.4;57.5
93;2021-08-20;5254;11235;1214580;971093;72.7;58.1
93;2021-08-21;4560;11948;1219140;983041;73.0;58.9
93;2021-08-22;2263;7052;1221403;990093;73.1;59.3
93;2021-08-23;4550;9335;1225953;999428;73.4;59.8
93;2021-08-24;4499;8434;1230452;1007862;73.7;60.3
93;2021-08-25;4314;8608;1234766;1016470;73.9;60.9
93;2021-08-26;3779;7109;1238545;1023579;74.2;61.3
93;2021-08-27;4098;8548;1242643;1032127;74.4;61.8
93;2021-08-28;3986;9590;1246629;1041717;74.6;62.4
93;2021-08-29;1820;4804;1248449;1046521;74.8;62.7
93;2021-08-30;3060;7616;1251509;1054137;74.9;63.1
93;2021-08-31;3114;7809;1254623;1061946;75.1;63.6
93;2021-09-01;4306;7773;1258929;1069719;75.4;64.0
93;2021-09-02;3297;6023;1262226;1075742;75.6;64.4
93;2021-09-03;2955;7314;1265181;1083056;75.8;64.8
93;2021-09-04;3442;8967;1268623;1092023;76.0;65.4
93;2021-09-05;1302;3709;1269925;1095732;76.0;65.6
93;2021-09-06;1907;5329;1271832;1101061;76.2;65.9
93;2021-09-07;1862;4850;1273694;1105911;76.3;66.2
93;2021-09-08;2285;5642;1275979;1111553;76.4;66.6
93;2021-09-09;2031;4926;1278010;1116479;76.5;66.8
93;2021-09-10;2774;5779;1280784;1122258;76.7;67.2
93;2021-09-11;2390;7038;1283174;1129296;76.8;67.6
93;2021-09-12;874;2890;1284048;1132186;76.9;67.8
93;2021-09-13;1778;4964;1285826;1137150;77.0;68.1
93;2021-09-14;1928;4609;1287754;1141759;77.1;68.4
93;2021-09-15;1871;4260;1289625;1146019;77.2;68.6
93;2021-09-16;1560;3038;1291185;1149057;77.3;68.8
93;2021-09-17;1956;4553;1293141;1153610;77.4;69.1
93;2021-09-18;1651;5577;1294792;1159187;77.5;69.4
93;2021-09-19;533;2104;1295325;1161291;77.6;69.5
93;2021-09-20;1262;2913;1296587;1164204;77.6;69.7
93;2021-09-21;1012;2486;1297599;1166690;77.7;69.9
93;2021-09-22;1494;3935;1299093;1170625;77.8;70.1
93;2021-09-23;1041;2428;1300134;1173053;77.8;70.2
93;2021-09-24;1347;3430;1301481;1176483;77.9;70.4
93;2021-09-25;1110;4525;1302591;1181008;78.0;70.7
93;2021-09-26;429;1675;1303020;1182683;78.0;70.8
93;2021-09-27;892;2225;1303912;1184908;78.1;70.9
93;2021-09-28;863;2031;1304775;1186939;78.1;71.1
93;2021-09-29;1228;3253;1306003;1190192;78.2;71.3
93;2021-09-30;877;2337;1306880;1192529;78.2;71.4
93;2021-10-01;1085;2698;1307965;1195227;78.3;71.6
93;2021-10-02;1132;2769;1309097;1197996;78.4;71.7
93;2021-10-03;298;830;1309395;1198826;78.4;71.8
93;2021-10-04;864;2179;1310259;1201005;78.5;71.9
93;2021-10-05;736;2038;1310995;1203043;78.5;72.0
93;2021-10-06;1026;2335;1312021;1205378;78.6;72.2
94;2020-12-27;8;0;8;0;0.0;0.0
94;2020-12-28;11;0;19;0;0.0;0.0
94;2020-12-29;0;0;19;0;0.0;0.0
94;2020-12-30;1;0;20;0;0.0;0.0
94;2020-12-31;7;0;27;0;0.0;0.0
94;2021-01-01;4;0;31;0;0.0;0.0
94;2021-01-02;0;0;31;0;0.0;0.0
94;2021-01-03;3;0;34;0;0.0;0.0
94;2021-01-04;39;2;73;2;0.0;0.0
94;2021-01-05;233;2;306;4;0.0;0.0
94;2021-01-06;332;4;638;8;0.0;0.0
94;2021-01-07;694;11;1332;19;0.1;0.0
94;2021-01-08;925;10;2257;29;0.2;0.0
94;2021-01-09;47;0;2304;29;0.2;0.0
94;2021-01-10;18;0;2322;29;0.2;0.0
94;2021-01-11;1015;10;3337;39;0.2;0.0
94;2021-01-12;1343;25;4680;64;0.3;0.0
94;2021-01-13;1408;26;6088;90;0.4;0.0
94;2021-01-14;1544;27;7632;117;0.5;0.0
94;2021-01-15;1222;23;8854;140;0.6;0.0
94;2021-01-16;197;1;9051;141;0.6;0.0
94;2021-01-17;100;0;9151;141;0.7;0.0
94;2021-01-18;1501;25;10652;166;0.8;0.0
94;2021-01-19;1952;27;12604;193;0.9;0.0
94;2021-01-20;2188;26;14792;219;1.1;0.0
94;2021-01-21;3032;17;17824;236;1.3;0.0
94;2021-01-22;2193;26;20017;262;1.4;0.0
94;2021-01-23;735;3;20752;265;1.5;0.0
94;2021-01-24;285;0;21037;265;1.5;0.0
94;2021-01-25;1474;21;22511;286;1.6;0.0
94;2021-01-26;1581;19;24092;305;1.7;0.0
94;2021-01-27;1847;31;25939;336;1.8;0.0
94;2021-01-28;1558;128;27497;464;2.0;0.0
94;2021-01-29;1380;137;28877;601;2.1;0.0
94;2021-01-30;581;4;29458;605;2.1;0.0
94;2021-01-31;123;8;29581;613;2.1;0.0
94;2021-02-01;931;140;30512;753;2.2;0.1
94;2021-02-02;854;225;31366;978;2.2;0.1
94;2021-02-03;763;342;32129;1320;2.3;0.1
94;2021-02-04;901;389;33030;1709;2.3;0.1
94;2021-02-05;875;521;33905;2230;2.4;0.2
94;2021-02-06;408;60;34313;2290;2.4;0.2
94;2021-02-07;123;0;34436;2290;2.4;0.2
94;2021-02-08;636;463;35072;2753;2.5;0.2
94;2021-02-09;1035;931;36107;3684;2.6;0.3
94;2021-02-10;1103;1259;37210;4943;2.6;0.4
94;2021-02-11;1430;1468;38640;6411;2.7;0.5
94;2021-02-12;1394;1540;40034;7951;2.8;0.6
94;2021-02-13;299;194;40333;8145;2.9;0.6
94;2021-02-14;30;70;40363;8215;2.9;0.6
94;2021-02-15;755;1476;41118;9691;2.9;0.7
94;2021-02-16;702;2317;41820;12008;3.0;0.9
94;2021-02-17;719;1265;42539;13273;3.0;0.9
94;2021-02-18;798;1406;43337;14679;3.1;1.0
94;2021-02-19;968;1178;44305;15857;3.2;1.1
94;2021-02-20;133;719;44438;16576;3.2;1.2
94;2021-02-21;21;144;44459;16720;3.2;1.2
94;2021-02-22;525;1024;44984;17744;3.2;1.3
94;2021-02-23;624;992;45608;18736;3.2;1.3
94;2021-02-24;694;664;46302;19400;3.3;1.4
94;2021-02-25;1073;1303;47375;20703;3.4;1.5
94;2021-02-26;1322;825;48697;21528;3.5;1.5
94;2021-02-27;518;431;49215;21959;3.5;1.6
94;2021-02-28;91;72;49306;22031;3.5;1.6
94;2021-03-01;887;767;50193;22798;3.6;1.6
94;2021-03-02;1568;798;51761;23596;3.7;1.7
94;2021-03-03;1952;866;53713;24462;3.8;1.7
94;2021-03-04;2857;1015;56570;25477;4.0;1.8
94;2021-03-05;3838;1230;60408;26707;4.3;1.9
94;2021-03-06;4822;526;65230;27233;4.6;1.9
94;2021-03-07;3689;533;68919;27766;4.9;2.0
94;2021-03-08;1919;684;70838;28450;5.0;2.0
94;2021-03-09;2558;801;73396;29251;5.2;2.1
94;2021-03-10;3201;947;76597;30198;5.4;2.1
94;2021-03-11;3840;897;80437;31095;5.7;2.2
94;2021-03-12;4586;771;85023;31866;6.0;2.3
94;2021-03-13;4132;390;89155;32256;6.3;2.3
94;2021-03-14;2115;154;91270;32410;6.5;2.3
94;2021-03-15;3172;757;94442;33167;6.7;2.4
94;2021-03-16;2776;435;97218;33602;6.9;2.4
94;2021-03-17;2862;459;100080;34061;7.1;2.4
94;2021-03-18;3266;444;103346;34505;7.4;2.5
94;2021-03-19;4273;706;107619;35211;7.7;2.5
94;2021-03-20;3692;300;111311;35511;7.9;2.5
94;2021-03-21;1465;383;112776;35894;8.0;2.6
94;2021-03-22;3220;657;115996;36551;8.2;2.6
94;2021-03-23;4516;731;120512;37282;8.6;2.7
94;2021-03-24;4627;625;125139;37907;8.9;2.7
94;2021-03-25;6321;691;131460;38598;9.3;2.7
94;2021-03-26;6091;812;137551;39410;9.8;2.8
94;2021-03-27;4470;280;142021;39690;10.1;2.8
94;2021-03-28;1891;114;143912;39804;10.2;2.8
94;2021-03-29;4130;1218;148042;41022;10.5;2.9
94;2021-03-30;5298;1354;153340;42376;10.9;3.0
94;2021-03-31;4913;1785;158253;44161;11.3;3.1
94;2021-04-01;5833;2311;164086;46472;11.7;3.3
94;2021-04-02;5246;2311;169332;48783;12.0;3.5
94;2021-04-03;3087;2497;172419;51280;12.3;3.6
94;2021-04-04;1051;764;173470;52044;12.3;3.7
94;2021-04-05;837;142;174307;52186;12.4;3.7
94;2021-04-06;3583;2529;177890;54715;12.7;3.9
94;2021-04-07;3865;2257;181755;56972;12.9;4.1
94;2021-04-08;4629;2064;186384;59036;13.3;4.2
94;2021-04-09;5367;2473;191751;61509;13.6;4.4
94;2021-04-10;2957;3004;194708;64513;13.8;4.6
94;2021-04-11;1268;1766;195976;66279;13.9;4.7
94;2021-04-12;3440;2275;199416;68554;14.2;4.9
94;2021-04-13;4313;3406;203729;71960;14.5;5.1
94;2021-04-14;3904;2699;207633;74659;14.8;5.3
94;2021-04-15;4453;2997;212086;77656;15.1;5.5
94;2021-04-16;4709;2849;216795;80505;15.4;5.7
94;2021-04-17;2462;2774;219257;83279;15.6;5.9
94;2021-04-18;919;1244;220176;84523;15.7;6.0
94;2021-04-19;2977;2447;223153;86970;15.9;6.2
94;2021-04-20;3275;2715;226428;89685;16.1;6.4
94;2021-04-21;3222;3166;229650;92851;16.3;6.6
94;2021-04-22;3912;3655;233562;96506;16.6;6.9
94;2021-04-23;4121;3998;237683;100504;16.9;7.1
94;2021-04-24;4265;3401;241948;103905;17.2;7.4
94;2021-04-25;2408;1512;244356;105417;17.4;7.5
94;2021-04-26;4011;3280;248367;108697;17.7;7.7
94;2021-04-27;5098;3369;253465;112066;18.0;8.0
94;2021-04-28;4832;3640;258297;115706;18.4;8.2
94;2021-04-29;6415;3808;264712;119514;18.8;8.5
94;2021-04-30;6487;3925;271199;123439;19.3;8.8
94;2021-05-01;4057;1066;275256;124505;19.6;8.9
94;2021-05-02;3049;1474;278305;125979;19.8;9.0
94;2021-05-03;5734;5327;284039;131306;20.2;9.3
94;2021-05-04;6097;3566;290136;134872;20.6;9.6
94;2021-05-05;6183;3428;296319;138300;21.1;9.8
94;2021-05-06;7163;3529;303482;141829;21.6;10.1
94;2021-05-07;6673;4119;310155;145948;22.1;10.4
94;2021-05-08;4907;2558;315062;148506;22.4;10.6
94;2021-05-09;4226;2252;319288;150758;22.7;10.7
94;2021-05-10;7713;3126;327001;153884;23.3;10.9
94;2021-05-11;8969;3934;335970;157818;23.9;11.2
94;2021-05-12;9575;3599;345545;161417;24.6;11.5
94;2021-05-13;8675;1366;354220;162783;25.2;11.6
94;2021-05-14;9867;3310;364087;166093;25.9;11.8
94;2021-05-15;8940;2163;373027;168256;26.5;12.0
94;2021-05-16;5067;911;378094;169167;26.9;12.0
94;2021-05-17;10835;2249;388929;171416;27.7;12.2
94;2021-05-18;11295;2449;400224;173865;28.5;12.4
94;2021-05-19;11675;3597;411899;177462;29.3;12.6
94;2021-05-20;12156;4361;424055;181823;30.2;12.9
94;2021-05-21;11873;3164;435928;184987;31.0;13.2
94;2021-05-22;10283;1972;446211;186959;31.7;13.3
94;2021-05-23;4998;711;451209;187670;32.1;13.3
94;2021-05-24;9669;1348;460878;189018;32.8;13.4
94;2021-05-25;9996;4268;470874;193286;33.5;13.7
94;2021-05-26;10293;3311;481167;196597;34.2;14.0
94;2021-05-27;10863;4589;492030;201186;35.0;14.3
94;2021-05-28;10443;4950;502473;206136;35.7;14.7
94;2021-05-29;9868;3456;512341;209592;36.4;14.9
94;2021-05-30;4785;931;517126;210523;36.8;15.0
94;2021-05-31;9988;4237;527114;214760;37.5;15.3
94;2021-06-01;10307;5092;537421;219852;38.2;15.6
94;2021-06-02;9354;4587;546775;224439;38.9;16.0
94;2021-06-03;9562;5604;556337;230043;39.6;16.4
94;2021-06-04;10403;6539;566740;236582;40.3;16.8
94;2021-06-05;9181;6250;575921;242832;41.0;17.3
94;2021-06-06;3984;1848;579905;244680;41.2;17.4
94;2021-06-07;8663;5972;588568;250652;41.9;17.8
94;2021-06-08;8995;7515;597563;258167;42.5;18.4
94;2021-06-09;8955;8166;606518;266333;43.1;18.9
94;2021-06-10;8800;10971;615318;277304;43.8;19.7
94;2021-06-11;7847;8394;623165;285698;44.3;20.3
94;2021-06-12;10259;6853;633424;292551;45.1;20.8
94;2021-06-13;3469;3263;636893;295814;45.3;21.0
94;2021-06-14;6958;8203;643851;304017;45.8;21.6
94;2021-06-15;7736;8820;651587;312837;46.3;22.2
94;2021-06-16;7245;8270;658832;321107;46.9;22.8
94;2021-06-17;6698;9060;665530;330167;47.3;23.5
94;2021-06-18;6575;11960;672105;342127;47.8;24.3
94;2021-06-19;6001;9586;678106;351713;48.2;25.0
94;2021-06-20;1888;4009;679994;355722;48.4;25.3
94;2021-06-21;4528;11185;684522;366907;48.7;26.1
94;2021-06-22;4843;10812;689365;377719;49.0;26.9
94;2021-06-23;4180;11150;693545;388869;49.3;27.7
94;2021-06-24;4970;10335;698515;399204;49.7;28.4
94;2021-06-25;4285;13732;702800;412936;50.0;29.4
94;2021-06-26;3139;12007;705939;424943;50.2;30.2
94;2021-06-27;1059;4998;706998;429941;50.3;30.6
94;2021-06-28;3494;12075;710492;442016;50.5;31.4
94;2021-06-29;4052;12175;714544;454191;50.8;32.3
94;2021-06-30;4364;11643;718908;465834;51.1;33.1
94;2021-07-01;5672;11117;724580;476951;51.5;33.9
94;2021-07-02;5327;12191;729907;489142;51.9;34.8
94;2021-07-03;3710;11799;733617;500941;52.2;35.6
94;2021-07-04;1518;5092;735135;506033;52.3;36.0
94;2021-07-05;4491;11426;739626;517459;52.6;36.8
94;2021-07-06;4618;10892;744244;528351;52.9;37.6
94;2021-07-07;5042;11083;749286;539434;53.3;38.4
94;2021-07-08;5104;10023;754390;549457;53.7;39.1
94;2021-07-09;6107;11876;760497;561333;54.1;39.9
94;2021-07-10;4122;11358;764619;572691;54.4;40.7
94;2021-07-11;1555;4719;766174;577410;54.5;41.1
94;2021-07-12;4335;11965;770509;589375;54.8;41.9
94;2021-07-13;6491;12047;777000;601422;55.3;42.8
94;2021-07-14;4294;5297;781294;606719;55.6;43.2
94;2021-07-15;7321;12368;788615;619087;56.1;44.0
94;2021-07-16;7848;11322;796463;630409;56.6;44.8
94;2021-07-17;6105;11326;802568;641735;57.1;45.6
94;2021-07-18;2629;4024;805197;645759;57.3;45.9
94;2021-07-19;6913;10448;812110;656207;57.8;46.7
94;2021-07-20;8568;10384;820678;666591;58.4;47.4
94;2021-07-21;8804;9586;829482;676177;59.0;48.1
94;2021-07-22;9793;9431;839275;685608;59.7;48.8
94;2021-07-23;9432;9412;848707;695020;60.4;49.4
94;2021-07-24;7215;8881;855922;703901;60.9;50.1
94;2021-07-25;2191;2743;858113;706644;61.0;50.3
94;2021-07-26;7972;8045;866085;714689;61.6;50.8
94;2021-07-27;8621;7008;874706;721697;62.2;51.3
94;2021-07-28;8812;6323;883518;728020;62.8;51.8
94;2021-07-29;9058;6377;892576;734397;63.5;52.2
94;2021-07-30;8209;6598;900785;740995;64.1;52.7
94;2021-07-31;7214;6311;907999;747306;64.6;53.1
94;2021-08-01;3203;1783;911202;749089;64.8;53.3
94;2021-08-02;6667;5471;917869;754560;65.3;53.7
94;2021-08-03;6372;5212;924241;759772;65.7;54.0
94;2021-08-04;6308;5131;930549;764903;66.2;54.4
94;2021-08-05;5850;5472;936399;770375;66.6;54.8
94;2021-08-06;5810;5845;942209;776220;67.0;55.2
94;2021-08-07;4252;4481;946461;780701;67.3;55.5
94;2021-08-08;1371;1718;947832;782419;67.4;55.6
94;2021-08-09;4897;6531;952729;788950;67.8;56.1
94;2021-08-10;5405;6311;958134;795261;68.1;56.6
94;2021-08-11;4298;5724;962432;800985;68.4;57.0
94;2021-08-12;4420;6504;966852;807489;68.8;57.4
94;2021-08-13;3789;5755;970641;813244;69.0;57.8
94;2021-08-14;2905;5737;973546;818981;69.2;58.2
94;2021-08-15;459;736;974005;819717;69.3;58.3
94;2021-08-16;3506;8282;977511;827999;69.5;58.9
94;2021-08-17;3376;8130;980887;836129;69.8;59.5
94;2021-08-18;3273;8613;984160;844742;70.0;60.1
94;2021-08-19;3335;6910;987495;851652;70.2;60.6
94;2021-08-20;3391;7754;990886;859406;70.5;61.1
94;2021-08-21;2568;7151;993454;866557;70.7;61.6
94;2021-08-22;896;2737;994350;869294;70.7;61.8
94;2021-08-23;2846;8451;997196;877745;70.9;62.4
94;2021-08-24;3147;7517;1000343;885262;71.1;63.0
94;2021-08-25;2745;6746;1003088;892008;71.3;63.4
94;2021-08-26;2594;6146;1005682;898154;71.5;63.9
94;2021-08-27;2650;6572;1008332;904726;71.7;64.3
94;2021-08-28;2575;6494;1010907;911220;71.9;64.8
94;2021-08-29;868;2348;1011775;913568;72.0;65.0
94;2021-08-30;2838;7889;1014613;921457;72.2;65.5
94;2021-08-31;2605;7450;1017218;928907;72.3;66.1
94;2021-09-01;2508;6204;1019726;935111;72.5;66.5
94;2021-09-02;1976;5218;1021702;940329;72.7;66.9
94;2021-09-03;2101;5812;1023803;946141;72.8;67.3
94;2021-09-04;2396;5417;1026199;951558;73.0;67.7
94;2021-09-05;705;1287;1026904;952845;73.0;67.8
94;2021-09-06;1564;4082;1028468;956927;73.1;68.1
94;2021-09-07;1461;3741;1029929;960668;73.3;68.3
94;2021-09-08;1483;3726;1031412;964394;73.4;68.6
94;2021-09-09;1263;3447;1032675;967841;73.4;68.8
94;2021-09-10;1573;4074;1034248;971915;73.6;69.1
94;2021-09-11;1692;4505;1035940;976420;73.7;69.4
94;2021-09-12;420;1186;1036360;977606;73.7;69.5
94;2021-09-13;1049;2817;1037409;980423;73.8;69.7
94;2021-09-14;1327;3363;1038736;983786;73.9;70.0
94;2021-09-15;1301;3114;1040037;986900;74.0;70.2
94;2021-09-16;1039;2186;1041076;989086;74.0;70.3
94;2021-09-17;1156;2689;1042232;991775;74.1;70.5
94;2021-09-18;1106;3690;1043338;995465;74.2;70.8
94;2021-09-19;295;1039;1043633;996504;74.2;70.9
94;2021-09-20;781;1965;1044414;998469;74.3;71.0
94;2021-09-21;998;1784;1045412;1000253;74.4;71.1
94;2021-09-22;951;2367;1046363;1002620;74.4;71.3
94;2021-09-23;770;1696;1047133;1004316;74.5;71.4
94;2021-09-24;994;1976;1048127;1006292;74.5;71.6
94;2021-09-25;956;3055;1049083;1009347;74.6;71.8
94;2021-09-26;270;699;1049353;1010046;74.6;71.8
94;2021-09-27;679;1468;1050032;1011514;74.7;71.9
94;2021-09-28;661;1425;1050693;1012939;74.7;72.0
94;2021-09-29;851;1590;1051544;1014529;74.8;72.2
94;2021-09-30;989;1258;1052533;1015787;74.9;72.2
94;2021-10-01;1068;1791;1053601;1017578;74.9;72.4
94;2021-10-02;973;2159;1054574;1019737;75.0;72.5
94;2021-10-03;250;610;1054824;1020347;75.0;72.6
94;2021-10-04;576;1087;1055400;1021434;75.1;72.6
94;2021-10-05;643;1092;1056043;1022526;75.1;72.7
94;2021-10-06;677;1301;1056720;1023827;75.2;72.8
95;2020-12-27;3;0;3;0;0.0;0.0
95;2020-12-28;6;0;9;0;0.0;0.0
95;2020-12-29;0;0;9;0;0.0;0.0
95;2020-12-30;0;0;9;0;0.0;0.0
95;2020-12-31;2;0;11;0;0.0;0.0
95;2021-01-01;0;0;11;0;0.0;0.0
95;2021-01-02;13;0;24;0;0.0;0.0
95;2021-01-03;1;0;25;0;0.0;0.0
95;2021-01-04;50;0;75;0;0.0;0.0
95;2021-01-05;319;0;394;0;0.0;0.0
95;2021-01-06;191;0;585;0;0.0;0.0
95;2021-01-07;130;1;715;1;0.1;0.0
95;2021-01-08;279;2;994;3;0.1;0.0
95;2021-01-09;251;0;1245;3;0.1;0.0
95;2021-01-10;384;1;1629;4;0.1;0.0
95;2021-01-11;491;1;2120;5;0.2;0.0
95;2021-01-12;864;1;2984;6;0.2;0.0
95;2021-01-13;782;11;3766;17;0.3;0.0
95;2021-01-14;886;12;4652;29;0.4;0.0
95;2021-01-15;758;5;5410;34;0.4;0.0
95;2021-01-16;298;2;5708;36;0.5;0.0
95;2021-01-17;225;0;5933;36;0.5;0.0
95;2021-01-18;1338;5;7271;41;0.6;0.0
95;2021-01-19;1576;5;8847;46;0.7;0.0
95;2021-01-20;2039;3;10886;49;0.9;0.0
95;2021-01-21;1855;5;12741;54;1.0;0.0
95;2021-01-22;1325;6;14066;60;1.1;0.0
95;2021-01-23;648;0;14714;60;1.2;0.0
95;2021-01-24;182;0;14896;60;1.2;0.0
95;2021-01-25;796;32;15692;92;1.3;0.0
95;2021-01-26;989;160;16681;252;1.3;0.0
95;2021-01-27;1251;154;17932;406;1.4;0.0
95;2021-01-28;1720;20;19652;426;1.6;0.0
95;2021-01-29;1251;177;20903;603;1.7;0.0
95;2021-01-30;478;4;21381;607;1.7;0.0
95;2021-01-31;212;1;21593;608;1.7;0.0
95;2021-02-01;566;245;22159;853;1.8;0.1
95;2021-02-02;528;262;22687;1115;1.8;0.1
95;2021-02-03;614;489;23301;1604;1.9;0.1
95;2021-02-04;1068;350;24369;1954;2.0;0.2
95;2021-02-05;733;276;25102;2230;2.0;0.2
95;2021-02-06;338;211;25440;2441;2.0;0.2
95;2021-02-07;142;346;25582;2787;2.0;0.2
95;2021-02-08;765;307;26347;3094;2.1;0.2
95;2021-02-09;1136;1000;27483;4094;2.2;0.3
95;2021-02-10;1261;1316;28744;5410;2.3;0.4
95;2021-02-11;1387;1079;30131;6489;2.4;0.5
95;2021-02-12;1031;903;31162;7392;2.5;0.6
95;2021-02-13;330;261;31492;7653;2.5;0.6
95;2021-02-14;43;148;31535;7801;2.5;0.6
95;2021-02-15;430;786;31965;8587;2.6;0.7
95;2021-02-16;493;626;32458;9213;2.6;0.7
95;2021-02-17;654;909;33112;10122;2.7;0.8
95;2021-02-18;725;1312;33837;11434;2.7;0.9
95;2021-02-19;783;1050;34620;12484;2.8;1.0
95;2021-02-20;306;374;34926;12858;2.8;1.0
95;2021-02-21;165;252;35091;13110;2.8;1.1
95;2021-02-22;327;780;35418;13890;2.8;1.1
95;2021-02-23;368;549;35786;14439;2.9;1.2
95;2021-02-24;310;696;36096;15135;2.9;1.2
95;2021-02-25;729;880;36825;16015;2.9;1.3
95;2021-02-26;991;683;37816;16698;3.0;1.3
95;2021-02-27;365;356;38181;17054;3.1;1.4
95;2021-02-28;61;192;38242;17246;3.1;1.4
95;2021-03-01;773;479;39015;17725;3.1;1.4
95;2021-03-02;1321;758;40336;18483;3.2;1.5
95;2021-03-03;1599;834;41935;19317;3.4;1.5
95;2021-03-04;3196;1053;45131;20370;3.6;1.6
95;2021-03-05;3647;1005;48778;21375;3.9;1.7
95;2021-03-06;4005;459;52783;21834;4.2;1.7
95;2021-03-07;4218;304;57001;22138;4.6;1.8
95;2021-03-08;1541;777;58542;22915;4.7;1.8
95;2021-03-09;2622;465;61164;23380;4.9;1.9
95;2021-03-10;2344;788;63508;24168;5.1;1.9
95;2021-03-11;3141;1092;66649;25260;5.3;2.0
95;2021-03-12;3519;774;70168;26034;5.6;2.1
95;2021-03-13;3516;413;73684;26447;5.9;2.1
95;2021-03-14;1981;293;75665;26740;6.1;2.1
95;2021-03-15;2371;304;78036;27044;6.3;2.2
95;2021-03-16;1575;407;79611;27451;6.4;2.2
95;2021-03-17;2103;410;81714;27861;6.5;2.2
95;2021-03-18;2799;372;84513;28233;6.8;2.3
95;2021-03-19;3475;362;87988;28595;7.0;2.3
95;2021-03-20;2592;205;90580;28800;7.3;2.3
95;2021-03-21;1205;246;91785;29046;7.4;2.3
95;2021-03-22;2936;365;94721;29411;7.6;2.4
95;2021-03-23;3439;459;98160;29870;7.9;2.4
95;2021-03-24;3946;520;102106;30390;8.2;2.4
95;2021-03-25;5859;654;107965;31044;8.6;2.5
95;2021-03-26;5429;688;113394;31732;9.1;2.5
95;2021-03-27;3748;227;117142;31959;9.4;2.6
95;2021-03-28;1535;122;118677;32081;9.5;2.6
95;2021-03-29;2894;573;121571;32654;9.7;2.6
95;2021-03-30;3887;1238;125458;33892;10.0;2.7
95;2021-03-31;3657;1675;129115;35567;10.3;2.8
95;2021-04-01;5483;2272;134598;37839;10.8;3.0
95;2021-04-02;3560;2749;138158;40588;11.1;3.3
95;2021-04-03;2095;2476;140253;43064;11.2;3.4
95;2021-04-04;1248;1198;141501;44262;11.3;3.5
95;2021-04-05;596;64;142097;44326;11.4;3.6
95;2021-04-06;1859;1538;143956;45864;11.5;3.7
95;2021-04-07;4953;2193;148909;48057;11.9;3.8
95;2021-04-08;4896;2468;153805;50525;12.3;4.0
95;2021-04-09;5434;2338;159239;52863;12.8;4.2
95;2021-04-10;3709;1435;162948;54298;13.1;4.3
95;2021-04-11;1567;1039;164515;55337;13.2;4.4
95;2021-04-12;3254;1610;167769;56947;13.4;4.6
95;2021-04-13;3141;1691;170910;58638;13.7;4.7
95;2021-04-14;2751;1990;173661;60628;13.9;4.9
95;2021-04-15;3901;3348;177562;63976;14.2;5.1
95;2021-04-16;4064;3036;181626;67012;14.5;5.4
95;2021-04-17;2375;1757;184001;68769;14.7;5.5
95;2021-04-18;1511;1022;185512;69791;14.9;5.6
95;2021-04-19;2570;2371;188082;72162;15.1;5.8
95;2021-04-20;2121;2456;190203;74618;15.2;6.0
95;2021-04-21;3931;2630;194134;77248;15.6;6.2
95;2021-04-22;3413;4632;197547;81880;15.8;6.6
95;2021-04-23;2765;3555;200312;85435;16.0;6.8
95;2021-04-24;3571;2587;203883;88022;16.3;7.1
95;2021-04-25;1959;1550;205842;89572;16.5;7.2
95;2021-04-26;2753;2701;208595;92273;16.7;7.4
95;2021-04-27;3852;2180;212447;94453;17.0;7.6
95;2021-04-28;3890;2661;216337;97114;17.3;7.8
95;2021-04-29;6142;4543;222479;101657;17.8;8.1
95;2021-04-30;6904;2934;229383;104591;18.4;8.4
95;2021-05-01;2370;918;231753;105509;18.6;8.5
95;2021-05-02;2448;1502;234201;107011;18.8;8.6
95;2021-05-03;5128;1929;239329;108940;19.2;8.7
95;2021-05-04;6352;2724;245681;111664;19.7;8.9
95;2021-05-05;5146;3801;250827;115465;20.1;9.2
95;2021-05-06;8206;4925;259033;120390;20.7;9.6
95;2021-05-07;5778;4748;264811;125138;21.2;10.0
95;2021-05-08;5742;1535;270553;126673;21.7;10.1
95;2021-05-09;2830;1592;273383;128265;21.9;10.3
95;2021-05-10;9971;3191;283354;131456;22.7;10.5
95;2021-05-11;8450;3455;291804;134911;23.4;10.8
95;2021-05-12;9465;3223;301269;138134;24.1;11.1
95;2021-05-13;7953;1202;309222;139336;24.8;11.2
95;2021-05-14;7014;1910;316236;141246;25.3;11.3
95;2021-05-15;4511;1063;320747;142309;25.7;11.4
95;2021-05-16;4825;848;325572;143157;26.1;11.5
95;2021-05-17;7738;1354;333310;144511;26.7;11.6
95;2021-05-18;9468;1857;342778;146368;27.5;11.7
95;2021-05-19;9243;2496;352021;148864;28.2;11.9
95;2021-05-20;12585;2446;364606;151310;29.2;12.1
95;2021-05-21;10172;2538;374778;153848;30.0;12.3
95;2021-05-22;9395;1572;384173;155420;30.8;12.4
95;2021-05-23;4144;960;388317;156380;31.1;12.5
95;2021-05-24;2396;535;390713;156915;31.3;12.6
95;2021-05-25;7212;2082;397925;158997;31.9;12.7
95;2021-05-26;8850;3119;406775;162116;32.6;13.0
95;2021-05-27;10361;4430;417136;166546;33.4;13.3
95;2021-05-28;7683;4413;424819;170959;34.0;13.7
95;2021-05-29;5263;2759;430082;173718;34.5;13.9
95;2021-05-30;3732;1710;433814;175428;34.8;14.1
95;2021-05-31;6424;3327;440238;178755;35.3;14.3
95;2021-06-01;8782;3811;449020;182566;36.0;14.6
95;2021-06-02;8730;4749;457750;187315;36.7;15.0
95;2021-06-03;8524;6562;466274;193877;37.4;15.5
95;2021-06-04;8882;4404;475156;198281;38.1;15.9
95;2021-06-05;8335;3747;483491;202028;38.7;16.2
95;2021-06-06;4836;1625;488327;203653;39.1;16.3
95;2021-06-07;6058;4544;494385;208197;39.6;16.7
95;2021-06-08;6550;5514;500935;213711;40.1;17.1
95;2021-06-09;6253;6477;507188;220188;40.6;17.6
95;2021-06-10;6428;6813;513616;227001;41.1;18.2
95;2021-06-11;7222;6442;520838;233443;41.7;18.7
95;2021-06-12;6001;4373;526839;237816;42.2;19.1
95;2021-06-13;2082;3290;528921;241106;42.4;19.3
95;2021-06-14;5372;5989;534293;247095;42.8;19.8
95;2021-06-15;5739;8070;540032;255165;43.3;20.4
95;2021-06-16;5491;7536;545523;262701;43.7;21.0
95;2021-06-17;6599;8162;552122;270863;44.2;21.7
95;2021-06-18;5822;7862;557944;278725;44.7;22.3
95;2021-06-19;4967;8927;562911;287652;45.1;23.0
95;2021-06-20;1425;3316;564336;290968;45.2;23.3
95;2021-06-21;3534;7712;567870;298680;45.5;23.9
95;2021-06-22;5066;9055;572936;307735;45.9;24.7
95;2021-06-23;4774;10875;577710;318610;46.3;25.5
95;2021-06-24;4941;10723;582651;329333;46.7;26.4
95;2021-06-25;4878;10357;587529;339690;47.1;27.2
95;2021-06-26;4320;8477;591849;348167;47.4;27.9
95;2021-06-27;1032;3994;592881;352161;47.5;28.2
95;2021-06-28;2740;9486;595621;361647;47.7;29.0
95;2021-06-29;2537;8786;598158;370433;47.9;29.7
95;2021-06-30;3952;9996;602110;380429;48.2;30.5
95;2021-07-01;4864;11166;606974;391595;48.6;31.4
95;2021-07-02;4260;10546;611234;402141;49.0;32.2
95;2021-07-03;3525;9155;614759;411296;49.2;32.9
95;2021-07-04;1279;3400;616038;414696;49.3;33.2
95;2021-07-05;2358;4375;618396;419071;49.5;33.6
95;2021-07-06;2773;7752;621169;426823;49.8;34.2
95;2021-07-07;3961;9620;625130;436443;50.1;35.0
95;2021-07-08;5312;9820;630442;446263;50.5;35.7
95;2021-07-09;4552;10076;634994;456339;50.9;36.6
95;2021-07-10;3400;7391;638394;463730;51.1;37.1
95;2021-07-11;1526;3603;639920;467333;51.3;37.4
95;2021-07-12;2990;9692;642910;477025;51.5;38.2
95;2021-07-13;5054;10071;647964;487096;51.9;39.0
95;2021-07-14;4427;5741;652391;492837;52.3;39.5
95;2021-07-15;7401;12366;659792;505203;52.9;40.5
95;2021-07-16;7985;12004;667777;517207;53.5;41.4
95;2021-07-17;5054;7823;672831;525030;53.9;42.1
95;2021-07-18;3482;2912;676313;527942;54.2;42.3
95;2021-07-19;4832;6866;681145;534808;54.6;42.8
95;2021-07-20;6960;8384;688105;543192;55.1;43.5
95;2021-07-21;9258;9453;697363;552645;55.9;44.3
95;2021-07-22;10147;9727;707510;562372;56.7;45.0
95;2021-07-23;10918;10206;718428;572578;57.6;45.9
95;2021-07-24;5259;6235;723687;578813;58.0;46.4
95;2021-07-25;2251;2284;725938;581097;58.2;46.5
95;2021-07-26;4522;4022;730460;585119;58.5;46.9
95;2021-07-27;8502;7045;738962;592164;59.2;47.4
95;2021-07-28;9717;7558;748679;599722;60.0;48.0
95;2021-07-29;8430;5471;757109;605193;60.6;48.5
95;2021-07-30;8517;7774;765626;612967;61.3;49.1
95;2021-07-31;4238;4104;769864;617071;61.7;49.4
95;2021-08-01;2336;1375;772200;618446;61.9;49.5
95;2021-08-02;4158;3918;776358;622364;62.2;49.9
95;2021-08-03;6154;5540;782512;627904;62.7;50.3
95;2021-08-04;6509;6088;789021;633992;63.2;50.8
95;2021-08-05;6868;5731;795889;639723;63.8;51.2
95;2021-08-06;6514;7066;802403;646789;64.3;51.8
95;2021-08-07;2843;3038;805246;649827;64.5;52.1
95;2021-08-08;1370;1888;806616;651715;64.6;52.2
95;2021-08-09;3926;5038;810542;656753;64.9;52.6
95;2021-08-10;5277;5843;815819;662596;65.4;53.1
95;2021-08-11;5368;6562;821187;669158;65.8;53.6
95;2021-08-12;5226;6364;826413;675522;66.2;54.1
95;2021-08-13;3910;5476;830323;680998;66.5;54.6
95;2021-08-14;3568;3323;833891;684321;66.8;54.8
95;2021-08-15;283;361;834174;684682;66.8;54.8
95;2021-08-16;2857;6054;837031;690736;67.1;55.3
95;2021-08-17;3622;7264;840653;698000;67.3;55.9
95;2021-08-18;4276;8074;844929;706074;67.7;56.6
95;2021-08-19;3796;6595;848725;712669;68.0;57.1
95;2021-08-20;3792;7929;852517;720598;68.3;57.7
95;2021-08-21;2716;4303;855233;724901;68.5;58.1
95;2021-08-22;858;2400;856091;727301;68.6;58.3
95;2021-08-23;2468;5651;858559;732952;68.8;58.7
95;2021-08-24;2964;6467;861523;739419;69.0;59.2
95;2021-08-25;3771;8293;865294;747712;69.3;59.9
95;2021-08-26;3164;7534;868458;755246;69.6;60.5
95;2021-08-27;3517;8722;871975;763968;69.8;61.2
95;2021-08-28;2801;5496;874776;769464;70.1;61.6
95;2021-08-29;638;1712;875414;771176;70.1;61.8
95;2021-08-30;2762;6189;878176;777365;70.3;62.3
95;2021-08-31;2817;6505;880993;783870;70.6;62.8
95;2021-09-01;2715;6486;883708;790356;70.8;63.3
95;2021-09-02;1684;4635;885392;794991;70.9;63.7
95;2021-09-03;2217;5837;887609;800828;71.1;64.2
95;2021-09-04;2524;5857;890133;806685;71.3;64.6
95;2021-09-05;418;641;890551;807326;71.3;64.7
95;2021-09-06;1230;3544;891781;810870;71.4;65.0
95;2021-09-07;1395;3460;893176;814330;71.5;65.2
95;2021-09-08;1657;4249;894833;818579;71.7;65.6
95;2021-09-09;1292;3695;896125;822274;71.8;65.9
95;2021-09-10;1564;4002;897689;826276;71.9;66.2
95;2021-09-11;1538;3827;899227;830103;72.0;66.5
95;2021-09-12;318;795;899545;830898;72.1;66.6
95;2021-09-13;876;2575;900421;833473;72.1;66.8
95;2021-09-14;1145;2758;901566;836231;72.2;67.0
95;2021-09-15;1333;3572;902899;839803;72.3;67.3
95;2021-09-16;892;1887;903791;841690;72.4;67.4
95;2021-09-17;1162;2878;904953;844568;72.5;67.7
95;2021-09-18;1265;4202;906218;848770;72.6;68.0
95;2021-09-19;232;584;906450;849354;72.6;68.0
95;2021-09-20;594;1414;907044;850768;72.7;68.2
95;2021-09-21;824;1804;907868;852572;72.7;68.3
95;2021-09-22;935;3079;908803;855651;72.8;68.5
95;2021-09-23;744;1192;909547;856843;72.9;68.6
95;2021-09-24;758;2046;910305;858889;72.9;68.8
95;2021-09-25;1013;3801;911318;862690;73.0;69.1
95;2021-09-26;135;411;911453;863101;73.0;69.1
95;2021-09-27;681;1193;912134;864294;73.1;69.2
95;2021-09-28;767;1406;912901;865700;73.1;69.3
95;2021-09-29;800;1900;913701;867600;73.2;69.5
95;2021-09-30;800;1131;914501;868731;73.3;69.6
95;2021-10-01;753;1402;915254;870133;73.3;69.7
95;2021-10-02;1219;2484;916473;872617;73.4;69.9
95;2021-10-03;128;258;916601;872875;73.4;69.9
95;2021-10-04;401;708;917002;873583;73.5;70.0
95;2021-10-05;594;1214;917596;874797;73.5;70.1
95;2021-10-06;714;1278;918310;876075;73.6;70.2
971;2020-12-27;0;0;0;0;0.0;0.0
971;2020-12-28;0;0;0;0;0.0;0.0
971;2020-12-29;0;0;0;0;0.0;0.0
971;2020-12-30;0;0;0;0;0.0;0.0
971;2020-12-31;0;0;0;0;0.0;0.0
971;2021-01-01;1;0;1;0;0.0;0.0
971;2021-01-02;0;0;1;0;0.0;0.0
971;2021-01-03;0;0;1;0;0.0;0.0
971;2021-01-04;1;0;2;0;0.0;0.0
971;2021-01-05;0;0;2;0;0.0;0.0
971;2021-01-06;1;0;3;0;0.0;0.0
971;2021-01-07;0;0;3;0;0.0;0.0
971;2021-01-08;58;1;61;1;0.0;0.0
971;2021-01-09;20;0;81;1;0.0;0.0
971;2021-01-10;0;0;81;1;0.0;0.0
971;2021-01-11;61;0;142;1;0.0;0.0
971;2021-01-12;46;0;188;1;0.0;0.0
971;2021-01-13;47;1;235;2;0.1;0.0
971;2021-01-14;63;0;298;2;0.1;0.0
971;2021-01-15;77;0;375;2;0.1;0.0
971;2021-01-16;0;0;375;2;0.1;0.0
971;2021-01-17;0;0;375;2;0.1;0.0
971;2021-01-18;82;1;457;3;0.1;0.0
971;2021-01-19;147;0;604;3;0.2;0.0
971;2021-01-20;134;0;738;3;0.2;0.0
971;2021-01-21;155;1;893;4;0.2;0.0
971;2021-01-22;135;0;1028;4;0.3;0.0
971;2021-01-23;1;0;1029;4;0.3;0.0
971;2021-01-24;0;0;1029;4;0.3;0.0
971;2021-01-25;203;1;1232;5;0.3;0.0
971;2021-01-26;218;1;1450;6;0.4;0.0
971;2021-01-27;237;0;1687;6;0.4;0.0
971;2021-01-28;242;2;1929;8;0.5;0.0
971;2021-01-29;201;2;2130;10;0.6;0.0
971;2021-01-30;25;0;2155;10;0.6;0.0
971;2021-01-31;1;0;2156;10;0.6;0.0
971;2021-02-01;229;3;2385;13;0.6;0.0
971;2021-02-02;247;13;2632;26;0.7;0.0
971;2021-02-03;228;3;2860;29;0.8;0.0
971;2021-02-04;306;21;3166;50;0.8;0.0
971;2021-02-05;289;25;3455;75;0.9;0.0
971;2021-02-06;49;1;3504;76;0.9;0.0
971;2021-02-07;0;0;3504;76;0.9;0.0
971;2021-02-08;260;18;3764;94;1.0;0.0
971;2021-02-09;323;25;4087;119;1.1;0.0
971;2021-02-10;255;21;4342;140;1.2;0.0
971;2021-02-11;302;99;4644;239;1.2;0.1
971;2021-02-12;291;26;4935;265;1.3;0.1
971;2021-02-13;51;4;4986;269;1.3;0.1
971;2021-02-14;19;36;5005;305;1.3;0.1
971;2021-02-15;85;45;5090;350;1.4;0.1
971;2021-02-16;16;1;5106;351;1.4;0.1
971;2021-02-17;17;1;5123;352;1.4;0.1
971;2021-02-18;254;11;5377;363;1.4;0.1
971;2021-02-19;250;15;5627;378;1.5;0.1
971;2021-02-20;49;0;5676;378;1.5;0.1
971;2021-02-21;2;0;5678;378;1.5;0.1
971;2021-02-22;195;47;5873;425;1.6;0.1
971;2021-02-23;206;59;6079;484;1.6;0.1
971;2021-02-24;345;113;6424;597;1.7;0.2
971;2021-02-25;385;65;6809;662;1.8;0.2
971;2021-02-26;235;72;7044;734;1.9;0.2
971;2021-02-27;65;0;7109;734;1.9;0.2
971;2021-02-28;1;0;7110;734;1.9;0.2
971;2021-03-01;179;76;7289;810;1.9;0.2
971;2021-03-02;278;115;7567;925;2.0;0.2
971;2021-03-03;245;99;7812;1024;2.1;0.3
971;2021-03-04;336;74;8148;1098;2.2;0.3
971;2021-03-05;376;133;8524;1231;2.3;0.3
971;2021-03-06;598;9;9122;1240;2.4;0.3
971;2021-03-07;1;0;9123;1240;2.4;0.3
971;2021-03-08;330;132;9453;1372;2.5;0.4
971;2021-03-09;391;135;9844;1507;2.6;0.4
971;2021-03-10;436;155;10280;1662;2.7;0.4
971;2021-03-11;122;43;10402;1705;2.8;0.5
971;2021-03-12;502;218;10904;1923;2.9;0.5
971;2021-03-13;139;4;11043;1927;2.9;0.5
971;2021-03-14;14;21;11057;1948;2.9;0.5
971;2021-03-15;424;45;11481;1993;3.0;0.5
971;2021-03-16;490;81;11971;2074;3.2;0.6
971;2021-03-17;471;70;12442;2144;3.3;0.6
971;2021-03-18;590;82;13032;2226;3.5;0.6
971;2021-03-19;584;91;13616;2317;3.6;0.6
971;2021-03-20;177;15;13793;2332;3.7;0.6
971;2021-03-21;8;0;13801;2332;3.7;0.6
971;2021-03-22;361;87;14162;2419;3.8;0.6
971;2021-03-23;540;155;14702;2574;3.9;0.7
971;2021-03-24;474;97;15176;2671;4.0;0.7
971;2021-03-25;758;180;15934;2851;4.2;0.8
971;2021-03-26;644;120;16578;2971;4.4;0.8
971;2021-03-27;296;33;16874;3004;4.5;0.8
971;2021-03-28;24;2;16898;3006;4.5;0.8
971;2021-03-29;383;85;17281;3091;4.6;0.8
971;2021-03-30;626;164;17907;3255;4.8;0.9
971;2021-03-31;545;132;18452;3387;4.9;0.9
971;2021-04-01;663;197;19115;3584;5.1;1.0
971;2021-04-02;41;35;19156;3619;5.1;1.0
971;2021-04-03;63;2;19219;3621;5.1;1.0
971;2021-04-04;4;17;19223;3638;5.1;1.0
971;2021-04-05;13;0;19236;3638;5.1;1.0
971;2021-04-06;488;196;19724;3834;5.2;1.0
971;2021-04-07;581;118;20305;3952;5.4;1.0
971;2021-04-08;526;156;20831;4108;5.5;1.1
971;2021-04-09;486;210;21317;4318;5.7;1.1
971;2021-04-10;101;5;21418;4323;5.7;1.1
971;2021-04-11;8;9;21426;4332;5.7;1.1
971;2021-04-12;305;260;21731;4592;5.8;1.2
971;2021-04-13;556;325;22287;4917;5.9;1.3
971;2021-04-14;448;228;22735;5145;6.0;1.4
971;2021-04-15;553;311;23288;5456;6.2;1.4
971;2021-04-16;563;274;23851;5730;6.3;1.5
971;2021-04-17;216;4;24067;5734;6.4;1.5
971;2021-04-18;6;13;24073;5747;6.4;1.5
971;2021-04-19;405;243;24478;5990;6.5;1.6
971;2021-04-20;726;344;25204;6334;6.7;1.7
971;2021-04-21;627;320;25831;6654;6.9;1.8
971;2021-04-22;819;323;26650;6977;7.1;1.9
971;2021-04-23;845;249;27495;7226;7.3;1.9
971;2021-04-24;390;68;27885;7294;7.4;1.9
971;2021-04-25;601;63;28486;7357;7.6;2.0
971;2021-04-26;982;220;29468;7577;7.8;2.0
971;2021-04-27;717;235;30185;7812;8.0;2.1
971;2021-04-28;865;269;31050;8081;8.2;2.1
971;2021-04-29;1203;204;32253;8285;8.6;2.2
971;2021-04-30;1269;188;33522;8473;8.9;2.2
971;2021-05-01;607;39;34129;8512;9.1;2.3
971;2021-05-02;357;19;34486;8531;9.2;2.3
971;2021-05-03;926;191;35412;8722;9.4;2.3
971;2021-05-04;960;209;36372;8931;9.7;2.4
971;2021-05-05;1022;251;37394;9182;9.9;2.4
971;2021-05-06;1146;174;38540;9356;10.2;2.5
971;2021-05-07;1266;271;39806;9627;10.6;2.6
971;2021-05-08;324;38;40130;9665;10.6;2.6
971;2021-05-09;183;11;40313;9676;10.7;2.6
971;2021-05-10;851;218;41164;9894;10.9;2.6
971;2021-05-11;964;314;42128;10208;11.2;2.7
971;2021-05-12;908;325;43036;10533;11.4;2.8
971;2021-05-13;212;78;43248;10611;11.5;2.8
971;2021-05-14;861;271;44109;10882;11.7;2.9
971;2021-05-15;486;15;44595;10897;11.8;2.9
971;2021-05-16;182;35;44777;10932;11.9;2.9
971;2021-05-17;721;276;45498;11208;12.1;3.0
971;2021-05-18;743;389;46241;11597;12.3;3.1
971;2021-05-19;705;529;46946;12126;12.5;3.2
971;2021-05-20;811;376;47757;12502;12.7;3.3
971;2021-05-21;827;405;48584;12907;12.9;3.4
971;2021-05-22;508;214;49092;13121;13.0;3.5
971;2021-05-23;200;114;49292;13235;13.1;3.5
971;2021-05-24;201;173;49493;13408;13.1;3.6
971;2021-05-25;551;661;50044;14069;13.3;3.7
971;2021-05-26;595;491;50639;14560;13.4;3.9
971;2021-05-27;133;179;50772;14739;13.5;3.9
971;2021-05-28;520;525;51292;15264;13.6;4.1
971;2021-05-29;238;140;51530;15404;13.7;4.1
971;2021-05-30;75;112;51605;15516;13.7;4.1
971;2021-05-31;453;535;52058;16051;13.8;4.3
971;2021-06-01;592;706;52650;16757;14.0;4.4
971;2021-06-02;576;705;53226;17462;14.1;4.6
971;2021-06-03;509;558;53735;18020;14.3;4.8
971;2021-06-04;834;799;54569;18819;14.5;5.0
971;2021-06-05;317;644;54886;19463;14.6;5.2
971;2021-06-06;139;528;55025;19991;14.6;5.3
971;2021-06-07;421;781;55446;20772;14.7;5.5
971;2021-06-08;488;885;55934;21657;14.8;5.7
971;2021-06-09;503;857;56437;22514;15.0;6.0
971;2021-06-10;537;848;56974;23362;15.1;6.2
971;2021-06-11;473;1233;57447;24595;15.2;6.5
971;2021-06-12;303;659;57750;25254;15.3;6.7
971;2021-06-13;126;312;57876;25566;15.4;6.8
971;2021-06-14;371;3678;58247;29244;15.5;7.8
971;2021-06-15;483;1981;58730;31225;15.6;8.3
971;2021-06-16;478;1431;59208;32656;15.7;8.7
971;2021-06-17;432;1008;59640;33664;15.8;8.9
971;2021-06-18;483;1020;60123;34684;16.0;9.2
971;2021-06-19;313;509;60436;35193;16.0;9.3
971;2021-06-20;111;231;60547;35424;16.1;9.4
971;2021-06-21;348;674;60895;36098;16.2;9.6
971;2021-06-22;333;870;61228;36968;16.2;9.8
971;2021-06-23;371;892;61599;37860;16.3;10.0
971;2021-06-24;417;731;62016;38591;16.5;10.2
971;2021-06-25;456;759;62472;39350;16.6;10.4
971;2021-06-26;301;512;62773;39862;16.7;10.6
971;2021-06-27;116;148;62889;40010;16.7;10.6
971;2021-06-28;304;682;63193;40692;16.8;10.8
971;2021-06-29;388;780;63581;41472;16.9;11.0
971;2021-06-30;441;924;64022;42396;17.0;11.2
971;2021-07-01;364;649;64386;43045;17.1;11.4
971;2021-07-02;433;693;64819;43738;17.2;11.6
971;2021-07-03;275;465;65094;44203;17.3;11.7
971;2021-07-04;112;238;65206;44441;17.3;11.8
971;2021-07-05;331;504;65537;44945;17.4;11.9
971;2021-07-06;388;769;65925;45714;17.5;12.1
971;2021-07-07;378;844;66303;46558;17.6;12.4
971;2021-07-08;416;791;66719;47349;17.7;12.6
971;2021-07-09;436;796;67155;48145;17.8;12.8
971;2021-07-10;245;295;67400;48440;17.9;12.9
971;2021-07-11;170;138;67570;48578;17.9;12.9
971;2021-07-12;477;603;68047;49181;18.1;13.0
971;2021-07-13;882;1001;68929;50182;18.3;13.3
971;2021-07-14;476;283;69405;50465;18.4;13.4
971;2021-07-15;885;842;70290;51307;18.7;13.6
971;2021-07-16;1095;1041;71385;52348;18.9;13.9
971;2021-07-17;647;445;72032;52793;19.1;14.0
971;2021-07-18;401;221;72433;53014;19.2;14.1
971;2021-07-19;579;579;73012;53593;19.4;14.2
971;2021-07-20;841;737;73853;54330;19.6;14.4
971;2021-07-21;767;501;74620;54831;19.8;14.5
971;2021-07-22;988;875;75608;55706;20.1;14.8
971;2021-07-23;1033;758;76641;56464;20.3;15.0
971;2021-07-24;426;387;77067;56851;20.4;15.1
971;2021-07-25;247;262;77314;57113;20.5;15.2
971;2021-07-26;636;565;77950;57678;20.7;15.3
971;2021-07-27;884;589;78834;58267;20.9;15.5
971;2021-07-28;795;655;79629;58922;21.1;15.6
971;2021-07-29;971;674;80600;59596;21.4;15.8
971;2021-07-30;1321;755;81921;60351;21.7;16.0
971;2021-07-31;557;412;82478;60763;21.9;16.1
971;2021-08-01;315;251;82793;61014;22.0;16.2
971;2021-08-02;765;422;83558;61436;22.2;16.3
971;2021-08-03;764;676;84322;62112;22.4;16.5
971;2021-08-04;690;674;85012;62786;22.6;16.7
971;2021-08-05;698;594;85710;63380;22.7;16.8
971;2021-08-06;933;644;86643;64024;23.0;17.0
971;2021-08-07;453;392;87096;64416;23.1;17.1
971;2021-08-08;279;313;87375;64729;23.2;17.2
971;2021-08-09;592;584;87967;65313;23.3;17.3
971;2021-08-10;762;796;88729;66109;23.5;17.5
971;2021-08-11;925;793;89654;66902;23.8;17.8
971;2021-08-12;1022;803;90676;67705;24.1;18.0
971;2021-08-13;980;443;91656;68148;24.3;18.1
971;2021-08-14;634;702;92290;68850;24.5;18.3
971;2021-08-15;437;413;92727;69263;24.6;18.4
971;2021-08-16;823;742;93550;70005;24.8;18.6
971;2021-08-17;907;871;94457;70876;25.1;18.8
971;2021-08-18;1276;976;95733;71852;25.4;19.1
971;2021-08-19;1344;928;97077;72780;25.8;19.3
971;2021-08-20;1532;1048;98609;73828;26.2;19.6
971;2021-08-21;732;518;99341;74346;26.4;19.7
971;2021-08-22;364;272;99705;74618;26.5;19.8
971;2021-08-23;876;630;100581;75248;26.7;20.0
971;2021-08-24;1292;795;101873;76043;27.0;20.2
971;2021-08-25;1393;801;103266;76844;27.4;20.4
971;2021-08-26;1404;775;104670;77619;27.8;20.6
971;2021-08-27;1503;1100;106173;78719;28.2;20.9
971;2021-08-28;937;580;107110;79299;28.4;21.0
971;2021-08-29;222;241;107332;79540;28.5;21.1
971;2021-08-30;932;749;108264;80289;28.7;21.3
971;2021-08-31;1255;900;109519;81189;29.1;21.5
971;2021-09-01;1128;914;110647;82103;29.4;21.8
971;2021-09-02;1070;886;111717;82989;29.6;22.0
971;2021-09-03;984;1136;112701;84125;29.9;22.3
971;2021-09-04;542;630;113243;84755;30.0;22.5
971;2021-09-05;128;240;113371;84995;30.1;22.6
971;2021-09-06;609;707;113980;85702;30.2;22.7
971;2021-09-07;630;744;114610;86446;30.4;22.9
971;2021-09-08;703;1055;115313;87501;30.6;23.2
971;2021-09-09;641;1139;115954;88640;30.8;23.5
971;2021-09-10;739;1342;116693;89982;31.0;23.9
971;2021-09-11;399;697;117092;90679;31.1;24.1
971;2021-09-12;84;360;117176;91039;31.1;24.2
971;2021-09-13;377;656;117553;91695;31.2;24.3
971;2021-09-14;546;1146;118099;92841;31.3;24.6
971;2021-09-15;552;1167;118651;94008;31.5;24.9
971;2021-09-16;440;1084;119091;95092;31.6;25.2
971;2021-09-17;542;1478;119633;96570;31.7;25.6
971;2021-09-18;279;1019;119912;97589;31.8;25.9
971;2021-09-19;92;336;120004;97925;31.8;26.0
971;2021-09-20;233;966;120237;98891;31.9;26.2
971;2021-09-21;274;1190;120511;100081;32.0;26.6
971;2021-09-22;380;1195;120891;101276;32.1;26.9
971;2021-09-23;368;1222;121259;102498;32.2;27.2
971;2021-09-24;450;1281;121709;103779;32.3;27.5
971;2021-09-25;233;777;121942;104556;32.4;27.7
971;2021-09-26;73;228;122015;104784;32.4;27.8
971;2021-09-27;248;665;122263;105449;32.4;28.0
971;2021-09-28;261;833;122524;106282;32.5;28.2
971;2021-09-29;310;889;122834;107171;32.6;28.4
971;2021-09-30;343;753;123177;107924;32.7;28.6
971;2021-10-01;384;863;123561;108787;32.8;28.9
971;2021-10-02;260;540;123821;109327;32.9;29.0
971;2021-10-03;69;167;123890;109494;32.9;29.1
971;2021-10-04;206;439;124096;109933;32.9;29.2
971;2021-10-05;332;609;124428;110542;33.0;29.3
971;2021-10-06;313;623;124741;111165;33.1;29.5
972;2020-12-27;0;0;0;0;0.0;0.0
972;2020-12-28;0;0;0;0;0.0;0.0
972;2020-12-29;0;0;0;0;0.0;0.0
972;2020-12-30;0;0;0;0;0.0;0.0
972;2020-12-31;0;0;0;0;0.0;0.0
972;2021-01-01;0;0;0;0;0.0;0.0
972;2021-01-02;0;0;0;0;0.0;0.0
972;2021-01-03;0;0;0;0;0.0;0.0
972;2021-01-04;0;0;0;0;0.0;0.0
972;2021-01-05;0;0;0;0;0.0;0.0
972;2021-01-06;5;0;5;0;0.0;0.0
972;2021-01-07;31;0;36;0;0.0;0.0
972;2021-01-08;90;0;126;0;0.0;0.0
972;2021-01-09;20;0;146;0;0.0;0.0
972;2021-01-10;0;0;146;0;0.0;0.0
972;2021-01-11;122;0;268;0;0.1;0.0
972;2021-01-12;79;0;347;0;0.1;0.0
972;2021-01-13;65;0;412;0;0.1;0.0
972;2021-01-14;88;1;500;1;0.1;0.0
972;2021-01-15;171;0;671;1;0.2;0.0
972;2021-01-16;51;0;722;1;0.2;0.0
972;2021-01-17;0;0;722;1;0.2;0.0
972;2021-01-18;158;0;880;1;0.2;0.0
972;2021-01-19;168;1;1048;2;0.3;0.0
972;2021-01-20;170;0;1218;2;0.3;0.0
972;2021-01-21;181;2;1399;4;0.4;0.0
972;2021-01-22;173;0;1572;4;0.4;0.0
972;2021-01-23;58;0;1630;4;0.5;0.0
972;2021-01-24;0;0;1630;4;0.5;0.0
972;2021-01-25;161;1;1791;5;0.5;0.0
972;2021-01-26;138;1;1929;6;0.5;0.0
972;2021-01-27;163;4;2092;10;0.6;0.0
972;2021-01-28;152;10;2244;20;0.6;0.0
972;2021-01-29;143;39;2387;59;0.7;0.0
972;2021-01-30;96;16;2483;75;0.7;0.0
972;2021-01-31;0;0;2483;75;0.7;0.0
972;2021-02-01;119;56;2602;131;0.7;0.0
972;2021-02-02;184;74;2786;205;0.8;0.1
972;2021-02-03;132;63;2918;268;0.8;0.1
972;2021-02-04;160;58;3078;326;0.9;0.1
972;2021-02-05;123;74;3201;400;0.9;0.1
972;2021-02-06;63;18;3264;418;0.9;0.1
972;2021-02-07;1;0;3265;418;0.9;0.1
972;2021-02-08;137;54;3402;472;0.9;0.1
972;2021-02-09;177;58;3579;530;1.0;0.1
972;2021-02-10;153;66;3732;596;1.0;0.2
972;2021-02-11;149;74;3881;670;1.1;0.2
972;2021-02-12;152;99;4033;769;1.1;0.2
972;2021-02-13;47;26;4080;795;1.1;0.2
972;2021-02-14;0;0;4080;795;1.1;0.2
972;2021-02-15;51;63;4131;858;1.2;0.2
972;2021-02-16;0;0;4131;858;1.2;0.2
972;2021-02-17;1;3;4132;861;1.2;0.2
972;2021-02-18;69;101;4201;962;1.2;0.3
972;2021-02-19;69;106;4270;1068;1.2;0.3
972;2021-02-20;48;50;4318;1118;1.2;0.3
972;2021-02-21;0;0;4318;1118;1.2;0.3
972;2021-02-22;102;52;4420;1170;1.2;0.3
972;2021-02-23;113;203;4533;1373;1.3;0.4
972;2021-02-24;106;192;4639;1565;1.3;0.4
972;2021-02-25;93;123;4732;1688;1.3;0.5
972;2021-02-26;132;144;4864;1832;1.4;0.5
972;2021-02-27;69;46;4933;1878;1.4;0.5
972;2021-02-28;0;0;4933;1878;1.4;0.5
972;2021-03-01;138;124;5071;2002;1.4;0.6
972;2021-03-02;158;63;5229;2065;1.5;0.6
972;2021-03-03;179;129;5408;2194;1.5;0.6
972;2021-03-04;152;122;5560;2316;1.5;0.6
972;2021-03-05;236;105;5796;2421;1.6;0.7
972;2021-03-06;119;52;5915;2473;1.6;0.7
972;2021-03-07;100;3;6015;2476;1.7;0.7
972;2021-03-08;196;124;6211;2600;1.7;0.7
972;2021-03-09;283;94;6494;2694;1.8;0.8
972;2021-03-10;322;122;6816;2816;1.9;0.8
972;2021-03-11;337;70;7153;2886;2.0;0.8
972;2021-03-12;413;52;7566;2938;2.1;0.8
972;2021-03-13;155;16;7721;2954;2.2;0.8
972;2021-03-14;4;1;7725;2955;2.2;0.8
972;2021-03-15;277;88;8002;3043;2.2;0.8
972;2021-03-16;305;54;8307;3097;2.3;0.9
972;2021-03-17;388;44;8695;3141;2.4;0.9
972;2021-03-18;437;44;9132;3185;2.5;0.9
972;2021-03-19;401;58;9533;3243;2.7;0.9
972;2021-03-20;149;47;9682;3290;2.7;0.9
972;2021-03-21;25;1;9707;3291;2.7;0.9
972;2021-03-22;361;114;10068;3405;2.8;0.9
972;2021-03-23;404;121;10472;3526;2.9;1.0
972;2021-03-24;429;104;10901;3630;3.0;1.0
972;2021-03-25;491;97;11392;3727;3.2;1.0
972;2021-03-26;634;105;12026;3832;3.4;1.1
972;2021-03-27;154;69;12180;3901;3.4;1.1
972;2021-03-28;81;0;12261;3901;3.4;1.1
972;2021-03-29;423;164;12684;4065;3.5;1.1
972;2021-03-30;469;239;13153;4304;3.7;1.2
972;2021-03-31;1151;189;14304;4493;4.0;1.3
972;2021-04-01;955;169;15259;4662;4.3;1.3
972;2021-04-02;896;15;16155;4677;4.5;1.3
972;2021-04-03;789;57;16944;4734;4.7;1.3
972;2021-04-04;751;13;17695;4747;4.9;1.3
972;2021-04-05;828;44;18523;4791;5.2;1.3
972;2021-04-06;885;136;19408;4927;5.4;1.4
972;2021-04-07;1437;327;20845;5254;5.8;1.5
972;2021-04-08;1307;272;22152;5526;6.2;1.5
972;2021-04-09;1239;316;23391;5842;6.5;1.6
972;2021-04-10;838;164;24229;6006;6.8;1.7
972;2021-04-11;620;14;24849;6020;6.9;1.7
972;2021-04-12;869;318;25718;6338;7.2;1.8
972;2021-04-13;880;327;26598;6665;7.4;1.9
972;2021-04-14;959;321;27557;6986;7.7;1.9
972;2021-04-15;959;299;28516;7285;7.9;2.0
972;2021-04-16;997;296;29513;7581;8.2;2.1
972;2021-04-17;530;161;30043;7742;8.4;2.2
972;2021-04-18;339;56;30382;7798;8.5;2.2
972;2021-04-19;668;342;31050;8140;8.7;2.3
972;2021-04-20;865;307;31915;8447;8.9;2.4
972;2021-04-21;1002;353;32917;8800;9.2;2.5
972;2021-04-22;605;308;33522;9108;9.3;2.5
972;2021-04-23;614;463;34136;9571;9.5;2.7
972;2021-04-24;364;197;34500;9768;9.6;2.7
972;2021-04-25;168;199;34668;9967;9.7;2.8
972;2021-04-26;516;540;35184;10507;9.8;2.9
972;2021-04-27;568;606;35752;11113;10.0;3.1
972;2021-04-28;448;690;36200;11803;10.1;3.3
972;2021-04-29;654;640;36854;12443;10.3;3.5
972;2021-04-30;771;682;37625;13125;10.5;3.7
972;2021-05-01;244;246;37869;13371;10.6;3.7
972;2021-05-02;227;512;38096;13883;10.6;3.9
972;2021-05-03;569;769;38665;14652;10.8;4.1
972;2021-05-04;525;678;39190;15330;10.9;4.3
972;2021-05-05;548;896;39738;16226;11.1;4.5
972;2021-05-06;546;785;40284;17011;11.2;4.7
972;2021-05-07;629;1015;40913;18026;11.4;5.0
972;2021-05-08;225;525;41138;18551;11.5;5.2
972;2021-05-09;172;505;41310;19056;11.5;5.3
972;2021-05-10;519;856;41829;19912;11.7;5.6
972;2021-05-11;477;869;42306;20781;11.8;5.8
972;2021-05-12;560;910;42866;21691;11.9;6.0
972;2021-05-13;275;532;43141;22223;12.0;6.2
972;2021-05-14;388;746;43529;22969;12.1;6.4
972;2021-05-15;233;578;43762;23547;12.2;6.6
972;2021-05-16;155;442;43917;23989;12.2;6.7
972;2021-05-17;474;753;44391;24742;12.4;6.9
972;2021-05-18;445;678;44836;25420;12.5;7.1
972;2021-05-19;453;744;45289;26164;12.6;7.3
972;2021-05-20;594;498;45883;26662;12.8;7.4
972;2021-05-21;544;683;46427;27345;12.9;7.6
972;2021-05-22;186;359;46613;27704;13.0;7.7
972;2021-05-23;111;182;46724;27886;13.0;7.8
972;2021-05-24;135;241;46859;28127;13.1;7.8
972;2021-05-25;350;697;47209;28824;13.2;8.0
972;2021-05-26;381;712;47590;29536;13.3;8.2
972;2021-05-27;271;647;47861;30183;13.3;8.4
972;2021-05-28;280;815;48141;30998;13.4;8.6
972;2021-05-29;154;513;48295;31511;13.5;8.8
972;2021-05-30;17;33;48312;31544;13.5;8.8
972;2021-05-31;346;678;48658;32222;13.6;9.0
972;2021-06-01;299;543;48957;32765;13.6;9.1
972;2021-06-02;325;575;49282;33340;13.7;9.3
972;2021-06-03;247;424;49529;33764;13.8;9.4
972;2021-06-04;350;642;49879;34406;13.9;9.6
972;2021-06-05;260;371;50139;34777;14.0;9.7
972;2021-06-06;25;32;50164;34809;14.0;9.7
972;2021-06-07;260;735;50424;35544;14.1;9.9
972;2021-06-08;255;585;50679;36129;14.1;10.1
972;2021-06-09;303;697;50982;36826;14.2;10.3
972;2021-06-10;308;450;51290;37276;14.3;10.4
972;2021-06-11;358;533;51648;37809;14.4;10.5
972;2021-06-12;232;320;51880;38129;14.5;10.6
972;2021-06-13;32;29;51912;38158;14.5;10.6
972;2021-06-14;367;547;52279;38705;14.6;10.8
972;2021-06-15;410;487;52689;39192;14.7;10.9
972;2021-06-16;436;435;53125;39627;14.8;11.0
972;2021-06-17;354;573;53479;40200;14.9;11.2
972;2021-06-18;458;537;53937;40737;15.0;11.4
972;2021-06-19;225;196;54162;40933;15.1;11.4
972;2021-06-20;25;17;54187;40950;15.1;11.4
972;2021-06-21;332;579;54519;41529;15.2;11.6
972;2021-06-22;297;462;54816;41991;15.3;11.7
972;2021-06-23;421;562;55237;42553;15.4;11.9
972;2021-06-24;330;437;55567;42990;15.5;12.0
972;2021-06-25;313;387;55880;43377;15.6;12.1
972;2021-06-26;222;201;56102;43578;15.6;12.1
972;2021-06-27;16;23;56118;43601;15.6;12.2
972;2021-06-28;336;421;56454;44022;15.7;12.3
972;2021-06-29;329;430;56783;44452;15.8;12.4
972;2021-06-30;440;420;57223;44872;16.0;12.5
972;2021-07-01;351;394;57574;45266;16.0;12.6
972;2021-07-02;124;200;57698;45466;16.1;12.7
972;2021-07-03;100;118;57798;45584;16.1;12.7
972;2021-07-04;24;36;57822;45620;16.1;12.7
972;2021-07-05;494;580;58316;46200;16.3;12.9
972;2021-07-06;488;429;58804;46629;16.4;13.0
972;2021-07-07;612;494;59416;47123;16.6;13.1
972;2021-07-08;492;422;59908;47545;16.7;13.3
972;2021-07-09;629;582;60537;48127;16.9;13.4
972;2021-07-10;405;309;60942;48436;17.0;13.5
972;2021-07-11;52;38;60994;48474;17.0;13.5
972;2021-07-12;847;697;61841;49171;17.2;13.7
972;2021-07-13;1475;706;63316;49877;17.6;13.9
972;2021-07-14;133;65;63449;49942;17.7;13.9
972;2021-07-15;1603;680;65052;50622;18.1;14.1
972;2021-07-16;1632;661;66684;51283;18.6;14.3
972;2021-07-17;1094;367;67778;51650;18.9;14.4
972;2021-07-18;56;39;67834;51689;18.9;14.4
972;2021-07-19;1148;654;68982;52343;19.2;14.6
972;2021-07-20;1130;578;70112;52921;19.5;14.8
972;2021-07-21;1089;603;71201;53524;19.8;14.9
972;2021-07-22;906;519;72107;54043;20.1;15.1
972;2021-07-23;967;484;73074;54527;20.4;15.2
972;2021-07-24;506;223;73580;54750;20.5;15.3
972;2021-07-25;50;63;73630;54813;20.5;15.3
972;2021-07-26;685;525;74315;55338;20.7;15.4
972;2021-07-27;1029;515;75344;55853;21.0;15.6
972;2021-07-28;645;561;75989;56414;21.2;15.7
972;2021-07-29;842;548;76831;56962;21.4;15.9
972;2021-07-30;902;615;77733;57577;21.7;16.0
972;2021-07-31;560;275;78293;57852;21.8;16.1
972;2021-08-01;83;33;78376;57885;21.8;16.1
972;2021-08-02;812;815;79188;58700;22.1;16.4
972;2021-08-03;730;743;79918;59443;22.3;16.6
972;2021-08-04;788;572;80706;60015;22.5;16.7
972;2021-08-05;915;590;81621;60605;22.8;16.9
972;2021-08-06;1196;895;82817;61500;23.1;17.1
972;2021-08-07;667;571;83484;62071;23.3;17.3
972;2021-08-08;85;83;83569;62154;23.3;17.3
972;2021-08-09;1130;1064;84699;63218;23.6;17.6
972;2021-08-10;1199;1040;85898;64258;23.9;17.9
972;2021-08-11;1234;921;87132;65179;24.3;18.2
972;2021-08-12;1450;930;88582;66109;24.7;18.4
972;2021-08-13;1318;645;89900;66754;25.1;18.6
972;2021-08-14;849;322;90749;67076;25.3;18.7
972;2021-08-15;70;55;90819;67131;25.3;18.7
972;2021-08-16;1280;1046;92099;68177;25.7;19.0
972;2021-08-17;1177;1187;93276;69364;26.0;19.3
972;2021-08-18;1237;1174;94513;70538;26.3;19.7
972;2021-08-19;1286;892;95799;71430;26.7;19.9
972;2021-08-20;1329;893;97128;72323;27.1;20.2
972;2021-08-21;758;626;97886;72949;27.3;20.3
972;2021-08-22;47;82;97933;73031;27.3;20.4
972;2021-08-23;1182;859;99115;73890;27.6;20.6
972;2021-08-24;1374;880;100489;74770;28.0;20.8
972;2021-08-25;1079;768;101568;75538;28.3;21.1
972;2021-08-26;1279;806;102847;76344;28.7;21.3
972;2021-08-27;1285;1077;104132;77421;29.0;21.6
972;2021-08-28;779;756;104911;78177;29.2;21.8
972;2021-08-29;100;64;105011;78241;29.3;21.8
972;2021-08-30;1141;1127;106152;79368;29.6;22.1
972;2021-08-31;907;1106;107059;80474;29.8;22.4
972;2021-09-01;812;1135;107871;81609;30.1;22.7
972;2021-09-02;878;1215;108749;82824;30.3;23.1
972;2021-09-03;770;1315;109519;84139;30.5;23.5
972;2021-09-04;615;910;110134;85049;30.7;23.7
972;2021-09-05;145;137;110279;85186;30.7;23.7
972;2021-09-06;600;1065;110879;86251;30.9;24.0
972;2021-09-07;633;985;111512;87236;31.1;24.3
972;2021-09-08;592;1147;112104;88383;31.2;24.6
972;2021-09-09;520;1119;112624;89502;31.4;24.9
972;2021-09-10;587;1347;113211;90849;31.6;25.3
972;2021-09-11;489;921;113700;91770;31.7;25.6
972;2021-09-12;107;113;113807;91883;31.7;25.6
972;2021-09-13;483;1129;114290;93012;31.9;25.9
972;2021-09-14;479;1151;114769;94163;32.0;26.2
972;2021-09-15;388;1088;115157;95251;32.1;26.6
972;2021-09-16;383;1069;115540;96320;32.2;26.8
972;2021-09-17;590;1272;116130;97592;32.4;27.2
972;2021-09-18;422;929;116552;98521;32.5;27.5
972;2021-09-19;43;120;116595;98641;32.5;27.5
972;2021-09-20;363;921;116958;99562;32.6;27.8
972;2021-09-21;427;987;117385;100549;32.7;28.0
972;2021-09-22;361;856;117746;101405;32.8;28.3
972;2021-09-23;406;825;118152;102230;32.9;28.5
972;2021-09-24;457;978;118609;103208;33.1;28.8
972;2021-09-25;333;835;118942;104043;33.2;29.0
972;2021-09-26;30;184;118972;104227;33.2;29.1
972;2021-09-27;303;666;119275;104893;33.2;29.2
972;2021-09-28;409;670;119684;105563;33.4;29.4
972;2021-09-29;365;646;120049;106209;33.5;29.6
972;2021-09-30;465;666;120514;106875;33.6;29.8
972;2021-10-01;532;753;121046;107628;33.7;30.0
972;2021-10-02;365;607;121411;108235;33.8;30.2
972;2021-10-03;41;79;121452;108314;33.9;30.2
972;2021-10-04;365;452;121817;108766;34.0;30.3
972;2021-10-05;364;541;122181;109307;34.1;30.5
972;2021-10-06;358;505;122539;109812;34.2;30.6
973;2020-12-27;0;0;0;0;0.0;0.0
973;2020-12-28;0;0;0;0;0.0;0.0
973;2020-12-29;0;0;0;0;0.0;0.0
973;2020-12-30;0;0;0;0;0.0;0.0
973;2020-12-31;0;0;0;0;0.0;0.0
973;2021-01-01;0;0;0;0;0.0;0.0
973;2021-01-02;1;1;1;1;0.0;0.0
973;2021-01-03;0;0;1;1;0.0;0.0
973;2021-01-04;0;0;1;1;0.0;0.0
973;2021-01-05;0;0;1;1;0.0;0.0
973;2021-01-06;0;0;1;1;0.0;0.0
973;2021-01-07;0;0;1;1;0.0;0.0
973;2021-01-08;0;0;1;1;0.0;0.0
973;2021-01-09;0;0;1;1;0.0;0.0
973;2021-01-10;0;0;1;1;0.0;0.0
973;2021-01-11;0;0;1;1;0.0;0.0
973;2021-01-12;0;0;1;1;0.0;0.0
973;2021-01-13;30;0;31;1;0.0;0.0
973;2021-01-14;46;0;77;1;0.0;0.0
973;2021-01-15;35;0;112;1;0.0;0.0
973;2021-01-16;18;1;130;2;0.0;0.0
973;2021-01-17;0;0;130;2;0.0;0.0
973;2021-01-18;63;0;193;2;0.1;0.0
973;2021-01-19;151;1;344;3;0.1;0.0
973;2021-01-20;134;0;478;3;0.2;0.0
973;2021-01-21;118;0;596;3;0.2;0.0
973;2021-01-22;76;0;672;3;0.2;0.0
973;2021-01-23;0;0;672;3;0.2;0.0
973;2021-01-24;0;0;672;3;0.2;0.0
973;2021-01-25;56;0;728;3;0.3;0.0
973;2021-01-26;100;2;828;5;0.3;0.0
973;2021-01-27;109;1;937;6;0.3;0.0
973;2021-01-28;96;3;1033;9;0.4;0.0
973;2021-01-29;104;3;1137;12;0.4;0.0
973;2021-01-30;0;0;1137;12;0.4;0.0
973;2021-01-31;0;0;1137;12;0.4;0.0
973;2021-02-01;54;0;1191;12;0.4;0.0
973;2021-02-02;122;5;1313;17;0.5;0.0
973;2021-02-03;119;6;1432;23;0.5;0.0
973;2021-02-04;79;25;1511;48;0.5;0.0
973;2021-02-05;65;8;1576;56;0.5;0.0
973;2021-02-06;0;0;1576;56;0.5;0.0
973;2021-02-07;0;0;1576;56;0.5;0.0
973;2021-02-08;52;12;1628;68;0.6;0.0
973;2021-02-09;92;38;1720;106;0.6;0.0
973;2021-02-10;101;37;1821;143;0.6;0.0
973;2021-02-11;105;90;1926;233;0.7;0.1
973;2021-02-12;89;59;2015;292;0.7;0.1
973;2021-02-13;0;0;2015;292;0.7;0.1
973;2021-02-14;0;0;2015;292;0.7;0.1
973;2021-02-15;27;57;2042;349;0.7;0.1
973;2021-02-16;123;45;2165;394;0.7;0.1
973;2021-02-17;145;111;2310;505;0.8;0.2
973;2021-02-18;103;125;2413;630;0.8;0.2
973;2021-02-19;122;70;2535;700;0.9;0.2
973;2021-02-20;0;0;2535;700;0.9;0.2
973;2021-02-21;0;0;2535;700;0.9;0.2
973;2021-02-22;78;46;2613;746;0.9;0.3
973;2021-02-23;158;99;2771;845;1.0;0.3
973;2021-02-24;189;119;2960;964;1.0;0.3
973;2021-02-25;259;86;3219;1050;1.1;0.4
973;2021-02-26;264;63;3483;1113;1.2;0.4
973;2021-02-27;121;1;3604;1114;1.2;0.4
973;2021-02-28;0;0;3604;1114;1.2;0.4
973;2021-03-01;182;84;3786;1198;1.3;0.4
973;2021-03-02;256;103;4042;1301;1.4;0.4
973;2021-03-03;255;122;4297;1423;1.5;0.5
973;2021-03-04;281;85;4578;1508;1.6;0.5
973;2021-03-05;274;46;4852;1554;1.7;0.5
973;2021-03-06;118;2;4970;1556;1.7;0.5
973;2021-03-07;0;0;4970;1556;1.7;0.5
973;2021-03-08;188;39;5158;1595;1.8;0.5
973;2021-03-09;353;87;5511;1682;1.9;0.6
973;2021-03-10;360;105;5871;1787;2.0;0.6
973;2021-03-11;271;110;6142;1897;2.1;0.7
973;2021-03-12;288;96;6430;1993;2.2;0.7
973;2021-03-13;112;4;6542;1997;2.3;0.7
973;2021-03-14;0;0;6542;1997;2.3;0.7
973;2021-03-15;181;27;6723;2024;2.3;0.7
973;2021-03-16;243;140;6966;2164;2.4;0.7
973;2021-03-17;274;127;7240;2291;2.5;0.8
973;2021-03-18;249;154;7489;2445;2.6;0.8
973;2021-03-19;283;128;7772;2573;2.7;0.9
973;2021-03-20;259;17;8031;2590;2.8;0.9
973;2021-03-21;119;3;8150;2593;2.8;0.9
973;2021-03-22;219;109;8369;2702;2.9;0.9
973;2021-03-23;275;194;8644;2896;3.0;1.0
973;2021-03-24;236;214;8880;3110;3.1;1.1
973;2021-03-25;167;179;9047;3289;3.1;1.1
973;2021-03-26;189;301;9236;3590;3.2;1.2
973;2021-03-27;58;93;9294;3683;3.2;1.3
973;2021-03-28;0;0;9294;3683;3.2;1.3
973;2021-03-29;175;246;9469;3929;3.3;1.4
973;2021-03-30;446;237;9915;4166;3.4;1.4
973;2021-03-31;318;291;10233;4457;3.5;1.5
973;2021-04-01;446;260;10679;4717;3.7;1.6
973;2021-04-02;309;277;10988;4994;3.8;1.7
973;2021-04-03;159;121;11147;5115;3.8;1.8
973;2021-04-04;0;0;11147;5115;3.8;1.8
973;2021-04-05;118;14;11265;5129;3.9;1.8
973;2021-04-06;441;334;11706;5463;4.0;1.9
973;2021-04-07;502;344;12208;5807;4.2;2.0
973;2021-04-08;513;269;12721;6076;4.4;2.1
973;2021-04-09;498;226;13219;6302;4.5;2.2
973;2021-04-10;147;90;13366;6392;4.6;2.2
973;2021-04-11;2;0;13368;6392;4.6;2.2
973;2021-04-12;551;267;13919;6659;4.8;2.3
973;2021-04-13;673;244;14592;6903;5.0;2.4
973;2021-04-14;721;313;15313;7216;5.3;2.5
973;2021-04-15;776;248;16089;7464;5.5;2.6
973;2021-04-16;761;304;16850;7768;5.8;2.7
973;2021-04-17;499;137;17349;7905;6.0;2.7
973;2021-04-18;499;46;17848;7951;6.1;2.7
973;2021-04-19;715;252;18563;8203;6.4;2.8
973;2021-04-20;607;280;19170;8483;6.6;2.9
973;2021-04-21;873;250;20043;8733;6.9;3.0
973;2021-04-22;727;231;20770;8964;7.1;3.1
973;2021-04-23;705;232;21475;9196;7.4;3.2
973;2021-04-24;524;97;21999;9293;7.6;3.2
973;2021-04-25;611;50;22610;9343;7.8;3.2
973;2021-04-26;779;233;23389;9576;8.0;3.3
973;2021-04-27;817;344;24206;9920;8.3;3.4
973;2021-04-28;746;331;24952;10251;8.6;3.5
973;2021-04-29;666;286;25618;10537;8.8;3.6
973;2021-04-30;711;260;26329;10797;9.1;3.7
973;2021-05-01;211;29;26540;10826;9.1;3.7
973;2021-05-02;602;85;27142;10911;9.3;3.8
973;2021-05-03;554;390;27696;11301;9.5;3.9
973;2021-05-04;665;327;28361;11628;9.8;4.0
973;2021-05-05;700;455;29061;12083;10.0;4.2
973;2021-05-06;695;477;29756;12560;10.2;4.3
973;2021-05-07;594;474;30350;13034;10.4;4.5
973;2021-05-08;343;59;30693;13093;10.6;4.5
973;2021-05-09;262;72;30955;13165;10.6;4.5
973;2021-05-10;440;611;31395;13776;10.8;4.7
973;2021-05-11;398;497;31793;14273;10.9;4.9
973;2021-05-12;514;647;32307;14920;11.1;5.1
973;2021-05-13;333;99;32640;15019;11.2;5.2
973;2021-05-14;485;555;33125;15574;11.4;5.4
973;2021-05-15;256;348;33381;15922;11.5;5.5
973;2021-05-16;207;210;33588;16132;11.6;5.5
973;2021-05-17;446;599;34034;16731;11.7;5.8
973;2021-05-18;564;568;34598;17299;11.9;6.0
973;2021-05-19;534;552;35132;17851;12.1;6.1
973;2021-05-20;643;451;35775;18302;12.3;6.3
973;2021-05-21;505;609;36280;18911;12.5;6.5
973;2021-05-22;167;500;36447;19411;12.5;6.7
973;2021-05-23;271;475;36718;19886;12.6;6.8
973;2021-05-24;562;249;37280;20135;12.8;6.9
973;2021-05-25;501;745;37781;20880;13.0;7.2
973;2021-05-26;453;684;38234;21564;13.2;7.4
973;2021-05-27;712;528;38946;22092;13.4;7.6
973;2021-05-28;579;554;39525;22646;13.6;7.8
973;2021-05-29;257;360;39782;23006;13.7;7.9
973;2021-05-30;151;399;39933;23405;13.7;8.1
973;2021-05-31;356;573;40289;23978;13.9;8.2
973;2021-06-01;421;467;40710;24445;14.0;8.4
973;2021-06-02;566;554;41276;24999;14.2;8.6
973;2021-06-03;525;470;41801;25469;14.4;8.8
973;2021-06-04;601;496;42402;25965;14.6;8.9
973;2021-06-05;273;292;42675;26257;14.7;9.0
973;2021-06-06;211;301;42886;26558;14.8;9.1
973;2021-06-07;488;452;43374;27010;14.9;9.3
973;2021-06-08;544;315;43918;27325;15.1;9.4
973;2021-06-09;530;390;44448;27715;15.3;9.5
973;2021-06-10;358;290;44806;28005;15.4;9.6
973;2021-06-11;436;466;45242;28471;15.6;9.8
973;2021-06-12;170;283;45412;28754;15.6;9.9
973;2021-06-13;215;269;45627;29023;15.7;10.0
973;2021-06-14;384;549;46011;29572;15.8;10.2
973;2021-06-15;377;445;46388;30017;16.0;10.3
973;2021-06-16;491;459;46879;30476;16.1;10.5
973;2021-06-17;442;578;47321;31054;16.3;10.7
973;2021-06-18;390;562;47711;31616;16.4;10.9
973;2021-06-19;235;260;47946;31876;16.5;11.0
973;2021-06-20;126;270;48072;32146;16.5;11.1
973;2021-06-21;335;601;48407;32747;16.7;11.3
973;2021-06-22;376;462;48783;33209;16.8;11.4
973;2021-06-23;343;539;49126;33748;16.9;11.6
973;2021-06-24;446;500;49572;34248;17.1;11.8
973;2021-06-25;445;559;50017;34807;17.2;12.0
973;2021-06-26;172;320;50189;35127;17.3;12.1
973;2021-06-27;121;170;50310;35297;17.3;12.1
973;2021-06-28;314;593;50624;35890;17.4;12.3
973;2021-06-29;376;506;51000;36396;17.5;12.5
973;2021-06-30;410;680;51410;37076;17.7;12.8
973;2021-07-01;431;399;51841;37475;17.8;12.9
973;2021-07-02;511;524;52352;37999;18.0;13.1
973;2021-07-03;210;275;52562;38274;18.1;13.2
973;2021-07-04;86;243;52648;38517;18.1;13.3
973;2021-07-05;361;546;53009;39063;18.2;13.4
973;2021-07-06;373;474;53382;39537;18.4;13.6
973;2021-07-07;375;415;53757;39952;18.5;13.7
973;2021-07-08;316;328;54073;40280;18.6;13.9
973;2021-07-09;392;434;54465;40714;18.7;14.0
973;2021-07-10;168;278;54633;40992;18.8;14.1
973;2021-07-11;102;163;54735;41155;18.8;14.2
973;2021-07-12;403;497;55138;41652;19.0;14.3
973;2021-07-13;682;559;55820;42211;19.2;14.5
973;2021-07-14;394;161;56214;42372;19.3;14.6
973;2021-07-15;658;528;56872;42900;19.6;14.8
973;2021-07-16;602;485;57474;43385;19.8;14.9
973;2021-07-17;345;285;57819;43670;19.9;15.0
973;2021-07-18;251;124;58070;43794;20.0;15.1
973;2021-07-19;524;459;58594;44253;20.2;15.2
973;2021-07-20;585;494;59179;44747;20.4;15.4
973;2021-07-21;725;397;59904;45144;20.6;15.5
973;2021-07-22;660;452;60564;45596;20.8;15.7
973;2021-07-23;608;370;61172;45966;21.0;15.8
973;2021-07-24;326;241;61498;46207;21.2;15.9
973;2021-07-25;166;111;61664;46318;21.2;15.9
973;2021-07-26;446;345;62110;46663;21.4;16.1
973;2021-07-27;554;358;62664;47021;21.6;16.2
973;2021-07-28;467;370;63131;47391;21.7;16.3
973;2021-07-29;536;431;63667;47822;21.9;16.5
973;2021-07-30;541;408;64208;48230;22.1;16.6
973;2021-07-31;203;163;64411;48393;22.2;16.6
973;2021-08-01;139;132;64550;48525;22.2;16.7
973;2021-08-02;398;432;64948;48957;22.3;16.8
973;2021-08-03;432;402;65380;49359;22.5;17.0
973;2021-08-04;308;373;65688;49732;22.6;17.1
973;2021-08-05;343;363;66031;50095;22.7;17.2
973;2021-08-06;365;524;66396;50619;22.8;17.4
973;2021-08-07;164;266;66560;50885;22.9;17.5
973;2021-08-08;123;177;66683;51062;22.9;17.6
973;2021-08-09;332;473;67015;51535;23.1;17.7
973;2021-08-10;362;516;67377;52051;23.2;17.9
973;2021-08-11;584;519;67961;52570;23.4;18.1
973;2021-08-12;550;584;68511;53154;23.6;18.3
973;2021-08-13;367;234;68878;53388;23.7;18.4
973;2021-08-14;253;401;69131;53789;23.8;18.5
973;2021-08-15;122;138;69253;53927;23.8;18.6
973;2021-08-16;307;472;69560;54399;23.9;18.7
973;2021-08-17;372;401;69932;54800;24.1;18.9
973;2021-08-18;369;446;70301;55246;24.2;19.0
973;2021-08-19;331;481;70632;55727;24.3;19.2
973;2021-08-20;313;400;70945;56127;24.4;19.3
973;2021-08-21;161;257;71106;56384;24.5;19.4
973;2021-08-22;115;183;71221;56567;24.5;19.5
973;2021-08-23;286;384;71507;56951;24.6;19.6
973;2021-08-24;312;465;71819;57416;24.7;19.8
973;2021-08-25;284;347;72103;57763;24.8;19.9
973;2021-08-26;314;404;72417;58167;24.9;20.0
973;2021-08-27;365;426;72782;58593;25.0;20.2
973;2021-08-28;143;266;72925;58859;25.1;20.2
973;2021-08-29;87;187;73012;59046;25.1;20.3
973;2021-08-30;219;349;73231;59395;25.2;20.4
973;2021-08-31;299;377;73530;59772;25.3;20.6
973;2021-09-01;255;400;73785;60172;25.4;20.7
973;2021-09-02;298;411;74083;60583;25.5;20.8
973;2021-09-03;278;354;74361;60937;25.6;21.0
973;2021-09-04;147;202;74508;61139;25.6;21.0
973;2021-09-05;72;93;74580;61232;25.7;21.1
973;2021-09-06;177;239;74757;61471;25.7;21.1
973;2021-09-07;204;265;74961;61736;25.8;21.2
973;2021-09-08;218;420;75179;62156;25.9;21.4
973;2021-09-09;217;313;75396;62469;25.9;21.5
973;2021-09-10;225;325;75621;62794;26.0;21.6
973;2021-09-11;125;296;75746;63090;26.1;21.7
973;2021-09-12;60;98;75806;63188;26.1;21.7
973;2021-09-13;219;234;76025;63422;26.2;21.8
973;2021-09-14;265;307;76290;63729;26.2;21.9
973;2021-09-15;345;331;76635;64060;26.4;22.0
973;2021-09-16;264;239;76899;64299;26.5;22.1
973;2021-09-17;215;242;77114;64541;26.5;22.2
973;2021-09-18;113;243;77227;64784;26.6;22.3
973;2021-09-19;55;150;77282;64934;26.6;22.3
973;2021-09-20;147;186;77429;65120;26.6;22.4
973;2021-09-21;193;203;77622;65323;26.7;22.5
973;2021-09-22;186;350;77808;65673;26.8;22.6
973;2021-09-23;246;240;78054;65913;26.9;22.7
973;2021-09-24;257;307;78311;66220;26.9;22.8
973;2021-09-25;113;257;78424;66477;27.0;22.9
973;2021-09-26;39;94;78463;66571;27.0;22.9
973;2021-09-27;158;167;78621;66738;27.0;23.0
973;2021-09-28;159;205;78780;66943;27.1;23.0
973;2021-09-29;204;237;78984;67180;27.2;23.1
973;2021-09-30;291;303;79275;67483;27.3;23.2
973;2021-10-01;199;217;79474;67700;27.3;23.3
973;2021-10-02;104;169;79578;67869;27.4;23.3
973;2021-10-03;60;92;79638;67961;27.4;23.4
973;2021-10-04;193;208;79831;68169;27.5;23.5
973;2021-10-05;174;176;80005;68345;27.5;23.5
973;2021-10-06;193;201;80198;68546;27.6;23.6
974;2020-12-27;0;0;0;0;0.0;0.0
974;2020-12-28;0;0;0;0;0.0;0.0
974;2020-12-29;0;0;0;0;0.0;0.0
974;2020-12-30;0;0;0;0;0.0;0.0
974;2020-12-31;0;0;0;0;0.0;0.0
974;2021-01-01;1;0;1;0;0.0;0.0
974;2021-01-02;0;0;1;0;0.0;0.0
974;2021-01-03;0;0;1;0;0.0;0.0
974;2021-01-04;0;0;1;0;0.0;0.0
974;2021-01-05;2;0;3;0;0.0;0.0
974;2021-01-06;0;0;3;0;0.0;0.0
974;2021-01-07;0;0;3;0;0.0;0.0
974;2021-01-08;0;0;3;0;0.0;0.0
974;2021-01-09;1;0;4;0;0.0;0.0
974;2021-01-10;0;0;4;0;0.0;0.0
974;2021-01-11;0;0;4;0;0.0;0.0
974;2021-01-12;0;0;4;0;0.0;0.0
974;2021-01-13;0;0;4;0;0.0;0.0
974;2021-01-14;0;0;4;0;0.0;0.0
974;2021-01-15;335;0;339;0;0.0;0.0
974;2021-01-16;27;0;366;0;0.0;0.0
974;2021-01-17;0;0;366;0;0.0;0.0
974;2021-01-18;49;1;415;1;0.0;0.0
974;2021-01-19;395;0;810;1;0.1;0.0
974;2021-01-20;485;1;1295;2;0.2;0.0
974;2021-01-21;614;2;1909;4;0.2;0.0
974;2021-01-22;414;1;2323;5;0.3;0.0
974;2021-01-23;75;0;2398;5;0.3;0.0
974;2021-01-24;0;0;2398;5;0.3;0.0
974;2021-01-25;274;2;2672;7;0.3;0.0
974;2021-01-26;429;0;3101;7;0.4;0.0
974;2021-01-27;316;0;3417;7;0.4;0.0
974;2021-01-28;409;0;3826;7;0.4;0.0
974;2021-01-29;422;3;4248;10;0.5;0.0
974;2021-01-30;421;1;4669;11;0.5;0.0
974;2021-01-31;0;0;4669;11;0.5;0.0
974;2021-02-01;373;4;5042;15;0.6;0.0
974;2021-02-02;503;3;5545;18;0.6;0.0
974;2021-02-03;602;9;6147;27;0.7;0.0
974;2021-02-04;629;16;6776;43;0.8;0.0
974;2021-02-05;564;97;7340;140;0.9;0.0
974;2021-02-06;501;6;7841;146;0.9;0.0
974;2021-02-07;0;8;7841;154;0.9;0.0
974;2021-02-08;470;32;8311;186;1.0;0.0
974;2021-02-09;787;63;9098;249;1.1;0.0
974;2021-02-10;820;86;9918;335;1.2;0.0
974;2021-02-11;795;86;10713;421;1.2;0.0
974;2021-02-12;638;92;11351;513;1.3;0.1
974;2021-02-13;655;75;12006;588;1.4;0.1
974;2021-02-14;1;0;12007;588;1.4;0.1
974;2021-02-15;526;123;12533;711;1.5;0.1
974;2021-02-16;651;524;13184;1235;1.5;0.1
974;2021-02-17;593;311;13777;1546;1.6;0.2
974;2021-02-18;495;384;14272;1930;1.7;0.2
974;2021-02-19;497;305;14769;2235;1.7;0.3
974;2021-02-20;577;105;15346;2340;1.8;0.3
974;2021-02-21;0;0;15346;2340;1.8;0.3
974;2021-02-22;403;208;15749;2548;1.8;0.3
974;2021-02-23;607;201;16356;2749;1.9;0.3
974;2021-02-24;583;220;16939;2969;2.0;0.3
974;2021-02-25;649;247;17588;3216;2.0;0.4
974;2021-02-26;485;407;18073;3623;2.1;0.4
974;2021-02-27;384;396;18457;4019;2.1;0.5
974;2021-02-28;0;0;18457;4019;2.1;0.5
974;2021-03-01;293;327;18750;4346;2.2;0.5
974;2021-03-02;487;434;19237;4780;2.2;0.6
974;2021-03-03;757;487;19994;5267;2.3;0.6
974;2021-03-04;778;450;20772;5717;2.4;0.7
974;2021-03-05;729;470;21501;6187;2.5;0.7
974;2021-03-06;813;496;22314;6683;2.6;0.8
974;2021-03-07;0;0;22314;6683;2.6;0.8
974;2021-03-08;435;494;22749;7177;2.6;0.8
974;2021-03-09;671;743;23420;7920;2.7;0.9
974;2021-03-10;644;795;24064;8715;2.8;1.0
974;2021-03-11;700;603;24764;9318;2.9;1.1
974;2021-03-12;731;644;25495;9962;3.0;1.2
974;2021-03-13;669;577;26164;10539;3.0;1.2
974;2021-03-14;2;0;26166;10539;3.0;1.2
974;2021-03-15;508;485;26674;11024;3.1;1.3
974;2021-03-16;681;675;27355;11699;3.2;1.4
974;2021-03-17;847;517;28202;12216;3.3;1.4
974;2021-03-18;1022;491;29224;12707;3.4;1.5
974;2021-03-19;786;524;30010;13231;3.5;1.5
974;2021-03-20;578;585;30588;13816;3.6;1.6
974;2021-03-21;0;0;30588;13816;3.6;1.6
974;2021-03-22;566;459;31154;14275;3.6;1.7
974;2021-03-23;780;632;31934;14907;3.7;1.7
974;2021-03-24;791;640;32725;15547;3.8;1.8
974;2021-03-25;934;531;33659;16078;3.9;1.9
974;2021-03-26;923;447;34582;16525;4.0;1.9
974;2021-03-27;781;334;35363;16859;4.1;2.0
974;2021-03-28;1;0;35364;16859;4.1;2.0
974;2021-03-29;960;270;36324;17129;4.2;2.0
974;2021-03-30;883;493;37207;17622;4.3;2.0
974;2021-03-31;736;652;37943;18274;4.4;2.1
974;2021-04-01;718;705;38661;18979;4.5;2.2
974;2021-04-02;688;753;39349;19732;4.6;2.3
974;2021-04-03;699;698;40048;20430;4.7;2.4
974;2021-04-04;0;0;40048;20430;4.7;2.4
974;2021-04-05;0;0;40048;20430;4.7;2.4
974;2021-04-06;796;634;40844;21064;4.7;2.4
974;2021-04-07;1367;781;42211;21845;4.9;2.5
974;2021-04-08;1792;771;44003;22616;5.1;2.6
974;2021-04-09;1508;775;45511;23391;5.3;2.7
974;2021-04-10;1137;643;46648;24034;5.4;2.8
974;2021-04-11;2;0;46650;24034;5.4;2.8
974;2021-04-12;1238;547;47888;24581;5.6;2.9
974;2021-04-13;1439;750;49327;25331;5.7;2.9
974;2021-04-14;2068;769;51395;26100;6.0;3.0
974;2021-04-15;2507;955;53902;27055;6.3;3.1
974;2021-04-16;1936;783;55838;27838;6.5;3.2
974;2021-04-17;1290;603;57128;28441;6.6;3.3
974;2021-04-18;0;0;57128;28441;6.6;3.3
974;2021-04-19;1374;562;58502;29003;6.8;3.4
974;2021-04-20;1651;804;60153;29807;7.0;3.5
974;2021-04-21;2124;626;62277;30433;7.2;3.5
974;2021-04-22;2952;821;65229;31254;7.6;3.6
974;2021-04-23;2311;820;67540;32074;7.9;3.7
974;2021-04-24;1111;803;68651;32877;8.0;3.8
974;2021-04-25;3;0;68654;32877;8.0;3.8
974;2021-04-26;1172;912;69826;33789;8.1;3.9
974;2021-04-27;1687;1027;71513;34816;8.3;4.0
974;2021-04-28;2901;747;74414;35563;8.7;4.1
974;2021-04-29;3947;813;78361;36376;9.1;4.2
974;2021-04-30;3450;905;81811;37281;9.5;4.3
974;2021-05-01;2106;227;83917;37508;9.8;4.4
974;2021-05-02;1;0;83918;37508;9.8;4.4
974;2021-05-03;1865;575;85783;38083;10.0;4.4
974;2021-05-04;2127;1092;87910;39175;10.2;4.6
974;2021-05-05;3119;1643;91029;40818;10.6;4.7
974;2021-05-06;4001;1587;95030;42405;11.1;4.9
974;2021-05-07;3228;1524;98258;43929;11.4;5.1
974;2021-05-08;1578;504;99836;44433;11.6;5.2
974;2021-05-09;2;1;99838;44434;11.6;5.2
974;2021-05-10;2412;1001;102250;45435;11.9;5.3
974;2021-05-11;3650;1640;105900;47075;12.3;5.5
974;2021-05-12;4721;2402;110621;49477;12.9;5.8
974;2021-05-13;3553;597;114174;50074;13.3;5.8
974;2021-05-14;5276;2522;119450;52596;13.9;6.1
974;2021-05-15;3157;1537;122607;54133;14.3;6.3
974;2021-05-16;17;18;122624;54151;14.3;6.3
974;2021-05-17;2995;1497;125619;55648;14.6;6.5
974;2021-05-18;3765;1802;129384;57450;15.0;6.7
974;2021-05-19;4687;2433;134071;59883;15.6;7.0
974;2021-05-20;5139;2853;139210;62736;16.2;7.3
974;2021-05-21;4996;2629;144206;65365;16.8;7.6
974;2021-05-22;3371;1256;147577;66621;17.2;7.7
974;2021-05-23;6;3;147583;66624;17.2;7.7
974;2021-05-24;3644;1078;151227;67702;17.6;7.9
974;2021-05-25;4248;1921;155475;69623;18.1;8.1
974;2021-05-26;4986;2993;160461;72616;18.7;8.4
974;2021-05-27;4620;4101;165081;76717;19.2;8.9
974;2021-05-28;4385;3837;169466;80554;19.7;9.4
974;2021-05-29;2554;2456;172020;83010;20.0;9.7
974;2021-05-30;8;14;172028;83024;20.0;9.7
974;2021-05-31;2347;2247;174375;85271;20.3;9.9
974;2021-06-01;3302;2762;177677;88033;20.7;10.2
974;2021-06-02;3968;3363;181645;91396;21.1;10.6
974;2021-06-03;4042;3652;185687;95048;21.6;11.1
974;2021-06-04;3849;3758;189536;98806;22.0;11.5
974;2021-06-05;2213;1931;191749;100737;22.3;11.7
974;2021-06-06;1074;134;192823;100871;22.4;11.7
974;2021-06-07;2012;2526;194835;103397;22.7;12.0
974;2021-06-08;2558;3338;197393;106735;23.0;12.4
974;2021-06-09;2982;4836;200375;111571;23.3;13.0
974;2021-06-10;3411;4464;203786;116035;23.7;13.5
974;2021-06-11;2840;4622;206626;120657;24.0;14.0
974;2021-06-12;1726;3376;208352;124033;24.2;14.4
974;2021-06-13;1324;246;209676;124279;24.4;14.5
974;2021-06-14;1489;3182;211165;127461;24.6;14.8
974;2021-06-15;2060;3617;213225;131078;24.8;15.2
974;2021-06-16;2748;4663;215973;135741;25.1;15.8
974;2021-06-17;2521;4895;218494;140636;25.4;16.4
974;2021-06-18;2597;4890;221091;145526;25.7;16.9
974;2021-06-19;1300;3516;222391;149042;25.9;17.3
974;2021-06-20;633;289;223024;149331;25.9;17.4
974;2021-06-21;1265;3235;224289;152566;26.1;17.7
974;2021-06-22;1619;3759;225908;156325;26.3;18.2
974;2021-06-23;2257;4993;228165;161318;26.5;18.8
974;2021-06-24;2280;4069;230445;165387;26.8;19.2
974;2021-06-25;2188;4106;232633;169493;27.1;19.7
974;2021-06-26;1401;2712;234034;172205;27.2;20.0
974;2021-06-27;664;268;234698;172473;27.3;20.1
974;2021-06-28;1307;2480;236005;174953;27.4;20.3
974;2021-06-29;1755;2846;237760;177799;27.6;20.7
974;2021-06-30;2561;3843;240321;181642;27.9;21.1
974;2021-07-01;2699;3826;243020;185468;28.3;21.6
974;2021-07-02;2511;3708;245531;189176;28.6;22.0
974;2021-07-03;1613;2456;247144;191632;28.7;22.3
974;2021-07-04;881;1038;248025;192670;28.8;22.4
974;2021-07-05;1696;2222;249721;194892;29.0;22.7
974;2021-07-06;2569;2545;252290;197437;29.3;23.0
974;2021-07-07;2664;3135;254954;200572;29.6;23.3
974;2021-07-08;2417;3172;257371;203744;29.9;23.7
974;2021-07-09;2761;3427;260132;207171;30.2;24.1
974;2021-07-10;1618;2192;261750;209363;30.4;24.3
974;2021-07-11;729;1017;262479;210380;30.5;24.5
974;2021-07-12;1745;2604;264224;212984;30.7;24.8
974;2021-07-13;4432;3346;268656;216330;31.2;25.2
974;2021-07-14;3300;608;271956;216938;31.6;25.2
974;2021-07-15;5556;4023;277512;220961;32.3;25.7
974;2021-07-16;6240;3299;283752;224260;33.0;26.1
974;2021-07-17;4373;1912;288125;226172;33.5;26.3
974;2021-07-18;2673;765;290798;226937;33.8;26.4
974;2021-07-19;4650;2030;295448;228967;34.4;26.6
974;2021-07-20;6232;2429;301680;231396;35.1;26.9
974;2021-07-21;6746;2861;308426;234257;35.9;27.2
974;2021-07-22;7140;2826;315566;237083;36.7;27.6
974;2021-07-23;6641;2978;322207;240061;37.5;27.9
974;2021-07-24;3800;2066;326007;242127;37.9;28.2
974;2021-07-25;2522;754;328529;242881;38.2;28.2
974;2021-07-26;4371;2097;332900;244978;38.7;28.5
974;2021-07-27;5442;2561;338342;247539;39.3;28.8
974;2021-07-28;5396;2906;343738;250445;40.0;29.1
974;2021-07-29;5744;2809;349482;253254;40.6;29.4
974;2021-07-30;5877;2582;355359;255836;41.3;29.7
974;2021-07-31;3936;1648;359295;257484;41.8;29.9
974;2021-08-01;1907;716;361202;258200;42.0;30.0
974;2021-08-02;3434;1868;364636;260068;42.4;30.2
974;2021-08-03;4301;4074;368937;264142;42.9;30.7
974;2021-08-04;4878;4233;373815;268375;43.5;31.2
974;2021-08-05;4446;4667;378261;273042;44.0;31.8
974;2021-08-06;4082;5104;382343;278146;44.5;32.3
974;2021-08-07;2748;4042;385091;282188;44.8;32.8
974;2021-08-08;1481;2265;386572;284453;45.0;33.1
974;2021-08-09;2574;4525;389146;288978;45.3;33.6
974;2021-08-10;3790;4962;392936;293940;45.7;34.2
974;2021-08-11;4634;5448;397570;299388;46.2;34.8
974;2021-08-12;4715;5917;402285;305305;46.8;35.5
974;2021-08-13;4458;5828;406743;311133;47.3;36.2
974;2021-08-14;2607;4329;409350;315462;47.6;36.7
974;2021-08-15;1573;2175;410923;317637;47.8;36.9
974;2021-08-16;2345;4181;413268;321818;48.1;37.4
974;2021-08-17;3187;4525;416455;326343;48.4;37.9
974;2021-08-18;3348;5901;419803;332244;48.8;38.6
974;2021-08-19;3310;4908;423113;337152;49.2;39.2
974;2021-08-20;3441;5274;426554;342426;49.6;39.8
974;2021-08-21;1834;4615;428388;347041;49.8;40.4
974;2021-08-22;1019;1944;429407;348985;49.9;40.6
974;2021-08-23;1816;3326;431223;352311;50.1;41.0
974;2021-08-24;2461;3773;433684;356084;50.4;41.4
974;2021-08-25;2908;5217;436592;361301;50.8;42.0
974;2021-08-26;2669;3870;439261;365171;51.1;42.5
974;2021-08-27;2780;4011;442041;369182;51.4;42.9
974;2021-08-28;1865;3884;443906;373066;51.6;43.4
974;2021-08-29;760;1574;444666;374640;51.7;43.6
974;2021-08-30;1565;2533;446231;377173;51.9;43.9
974;2021-08-31;1866;3350;448097;380523;52.1;44.2
974;2021-09-01;2407;4910;450504;385433;52.4;44.8
974;2021-09-02;2254;4317;452758;389750;52.6;45.3
974;2021-09-03;2339;4539;455097;394289;52.9;45.8
974;2021-09-04;1586;3921;456683;398210;53.1;46.3
974;2021-09-05;607;1338;457290;399548;53.2;46.5
974;2021-09-06;1215;2552;458505;402100;53.3;46.8
974;2021-09-07;1366;3203;459871;405303;53.5;47.1
974;2021-09-08;2119;3968;461990;409271;53.7;47.6
974;2021-09-09;1794;3435;463784;412706;53.9;48.0
974;2021-09-10;1928;3819;465712;416525;54.2;48.4
974;2021-09-11;1534;2510;467246;419035;54.3;48.7
974;2021-09-12;391;972;467637;420007;54.4;48.8
974;2021-09-13;1083;1941;468720;421948;54.5;49.1
974;2021-09-14;1512;2458;470232;424406;54.7;49.4
974;2021-09-15;1821;3030;472053;427436;54.9;49.7
974;2021-09-16;1383;2782;473436;430218;55.1;50.0
974;2021-09-17;1482;3064;474918;433282;55.2;50.4
974;2021-09-18;1196;1957;476114;435239;55.4;50.6
974;2021-09-19;290;717;476404;435956;55.4;50.7
974;2021-09-20;716;1631;477120;437587;55.5;50.9
974;2021-09-21;837;1815;477957;439402;55.6;51.1
974;2021-09-22;1255;2516;479212;441918;55.7;51.4
974;2021-09-23;845;2119;480057;444037;55.8;51.6
974;2021-09-24;1097;2475;481154;446512;56.0;51.9
974;2021-09-25;767;1879;481921;448391;56.0;52.1
974;2021-09-26;160;518;482081;448909;56.1;52.2
974;2021-09-27;607;1071;482688;449980;56.1;52.3
974;2021-09-28;850;1535;483538;451515;56.2;52.5
974;2021-09-29;1199;2325;484737;453840;56.4;52.8
974;2021-09-30;997;1753;485734;455593;56.5;53.0
974;2021-10-01;1277;1988;487011;457581;56.6;53.2
974;2021-10-02;946;1468;487957;459049;56.7;53.4
974;2021-10-03;265;387;488222;459436;56.8;53.4
974;2021-10-04;719;1148;488941;460584;56.9;53.6
974;2021-10-05;961;1344;489902;461928;57.0;53.7
974;2021-10-06;1178;1908;491080;463836;57.1;53.9
976;2020-12-27;0;0;0;0;0.0;0.0
976;2020-12-28;0;0;0;0;0.0;0.0
976;2020-12-29;0;0;0;0;0.0;0.0
976;2020-12-30;0;0;0;0;0.0;0.0
976;2020-12-31;0;0;0;0;0.0;0.0
976;2021-01-01;0;0;0;0;0.0;0.0
976;2021-01-02;0;0;0;0;0.0;0.0
976;2021-01-03;0;0;0;0;0.0;0.0
976;2021-01-04;0;0;0;0;0.0;0.0
976;2021-01-05;0;0;0;0;0.0;0.0
976;2021-01-06;0;0;0;0;0.0;0.0
976;2021-01-07;0;0;0;0;0.0;0.0
976;2021-01-08;0;0;0;0;0.0;0.0
976;2021-01-09;0;0;0;0;0.0;0.0
976;2021-01-10;0;0;0;0;0.0;0.0
976;2021-01-11;9;0;9;0;0.0;0.0
976;2021-01-12;0;0;9;0;0.0;0.0
976;2021-01-13;0;0;9;0;0.0;0.0
976;2021-01-14;0;0;9;0;0.0;0.0
976;2021-01-15;1;0;10;0;0.0;0.0
976;2021-01-16;1;0;11;0;0.0;0.0
976;2021-01-17;0;0;11;0;0.0;0.0
976;2021-01-18;1;0;12;0;0.0;0.0
976;2021-01-19;0;0;12;0;0.0;0.0
976;2021-01-20;0;0;12;0;0.0;0.0
976;2021-01-21;1;1;13;1;0.0;0.0
976;2021-01-22;0;0;13;1;0.0;0.0
976;2021-01-23;1;0;14;1;0.0;0.0
976;2021-01-24;0;0;14;1;0.0;0.0
976;2021-01-25;144;3;158;4;0.1;0.0
976;2021-01-26;167;2;325;6;0.1;0.0
976;2021-01-27;250;3;575;9;0.2;0.0
976;2021-01-28;104;8;679;17;0.2;0.0
976;2021-01-29;233;3;912;20;0.3;0.0
976;2021-01-30;286;11;1198;31;0.4;0.0
976;2021-01-31;1;0;1199;31;0.4;0.0
976;2021-02-01;161;2;1360;33;0.5;0.0
976;2021-02-02;328;11;1688;44;0.6;0.0
976;2021-02-03;227;4;1915;48;0.7;0.0
976;2021-02-04;215;9;2130;57;0.8;0.0
976;2021-02-05;213;1;2343;58;0.8;0.0
976;2021-02-06;83;10;2426;68;0.9;0.0
976;2021-02-07;0;0;2426;68;0.9;0.0
976;2021-02-08;82;3;2508;71;0.9;0.0
976;2021-02-09;194;2;2702;73;1.0;0.0
976;2021-02-10;187;5;2889;78;1.0;0.0
976;2021-02-11;236;4;3125;82;1.1;0.0
976;2021-02-12;288;4;3413;86;1.2;0.0
976;2021-02-13;56;0;3469;86;1.2;0.0
976;2021-02-14;2;0;3471;86;1.2;0.0
976;2021-02-15;358;9;3829;95;1.4;0.0
976;2021-02-16;266;10;4095;105;1.5;0.0
976;2021-02-17;167;9;4262;114;1.5;0.0
976;2021-02-18;217;15;4479;129;1.6;0.0
976;2021-02-19;237;24;4716;153;1.7;0.1
976;2021-02-20;138;9;4854;162;1.7;0.1
976;2021-02-21;0;0;4854;162;1.7;0.1
976;2021-02-22;130;117;4984;279;1.8;0.1
976;2021-02-23;185;152;5169;431;1.8;0.2
976;2021-02-24;176;146;5345;577;1.9;0.2
976;2021-02-25;227;273;5572;850;2.0;0.3
976;2021-02-26;242;245;5814;1095;2.1;0.4
976;2021-02-27;0;0;5814;1095;2.1;0.4
976;2021-02-28;0;0;5814;1095;2.1;0.4
976;2021-03-01;146;255;5960;1350;2.1;0.5
976;2021-03-02;228;257;6188;1607;2.2;0.6
976;2021-03-03;202;190;6390;1797;2.3;0.6
976;2021-03-04;205;143;6595;1940;2.4;0.7
976;2021-03-05;225;116;6820;2056;2.4;0.7
976;2021-03-06;1;0;6821;2056;2.4;0.7
976;2021-03-07;1;0;6822;2056;2.4;0.7
976;2021-03-08;189;112;7011;2168;2.5;0.8
976;2021-03-09;390;163;7401;2331;2.6;0.8
976;2021-03-10;179;178;7580;2509;2.7;0.9
976;2021-03-11;167;208;7747;2717;2.8;1.0
976;2021-03-12;237;293;7984;3010;2.9;1.1
976;2021-03-13;3;0;7987;3010;2.9;1.1
976;2021-03-14;0;0;7987;3010;2.9;1.1
976;2021-03-15;157;295;8144;3305;2.9;1.2
976;2021-03-16;238;226;8382;3531;3.0;1.3
976;2021-03-17;264;145;8646;3676;3.1;1.3
976;2021-03-18;174;235;8820;3911;3.2;1.4
976;2021-03-19;174;296;8994;4207;3.2;1.5
976;2021-03-20;0;0;8994;4207;3.2;1.5
976;2021-03-21;0;0;8994;4207;3.2;1.5
976;2021-03-22;97;136;9091;4343;3.3;1.6
976;2021-03-23;136;238;9227;4581;3.3;1.6
976;2021-03-24;160;146;9387;4727;3.4;1.7
976;2021-03-25;184;206;9571;4933;3.4;1.8
976;2021-03-26;160;212;9731;5145;3.5;1.8
976;2021-03-27;18;0;9749;5145;3.5;1.8
976;2021-03-28;1;0;9750;5145;3.5;1.8
976;2021-03-29;0;2;9750;5147;3.5;1.8
976;2021-03-30;272;337;10022;5484;3.6;2.0
976;2021-03-31;225;124;10247;5608;3.7;2.0
976;2021-04-01;246;104;10493;5712;3.8;2.0
976;2021-04-02;286;262;10779;5974;3.9;2.1
976;2021-04-03;905;310;11684;6284;4.2;2.2
976;2021-04-04;2;0;11686;6284;4.2;2.2
976;2021-04-05;1;0;11687;6284;4.2;2.2
976;2021-04-06;161;277;11848;6561;4.2;2.3
976;2021-04-07;237;266;12085;6827;4.3;2.4
976;2021-04-08;283;140;12368;6967;4.4;2.5
976;2021-04-09;248;172;12616;7139;4.5;2.6
976;2021-04-10;181;114;12797;7253;4.6;2.6
976;2021-04-11;7;0;12804;7253;4.6;2.6
976;2021-04-12;0;18;12804;7271;4.6;2.6
976;2021-04-13;395;345;13199;7616;4.7;2.7
976;2021-04-14;239;205;13438;7821;4.8;2.8
976;2021-04-15;209;117;13647;7938;4.9;2.8
976;2021-04-16;214;127;13861;8065;5.0;2.9
976;2021-04-17;225;130;14086;8195;5.0;2.9
976;2021-04-18;1;0;14087;8195;5.0;2.9
976;2021-04-19;7;1;14094;8196;5.0;2.9
976;2021-04-20;367;221;14461;8417;5.2;3.0
976;2021-04-21;411;150;14872;8567;5.3;3.1
976;2021-04-22;410;150;15282;8717;5.5;3.1
976;2021-04-23;366;166;15648;8883;5.6;3.2
976;2021-04-24;414;129;16062;9012;5.7;3.2
976;2021-04-25;3;0;16065;9012;5.7;3.2
976;2021-04-26;55;8;16120;9020;5.8;3.2
976;2021-04-27;351;292;16471;9312;5.9;3.3
976;2021-04-28;355;512;16826;9824;6.0;3.5
976;2021-04-29;559;343;17385;10167;6.2;3.6
976;2021-04-30;408;238;17793;10405;6.4;3.7
976;2021-05-01;671;286;18464;10691;6.6;3.8
976;2021-05-02;0;0;18464;10691;6.6;3.8
976;2021-05-03;140;6;18604;10697;6.7;3.8
976;2021-05-04;355;425;18959;11122;6.8;4.0
976;2021-05-05;447;318;19406;11440;6.9;4.1
976;2021-05-06;320;202;19726;11642;7.1;4.2
976;2021-05-07;341;133;20067;11775;7.2;4.2
976;2021-05-08;309;141;20376;11916;7.3;4.3
976;2021-05-09;0;0;20376;11916;7.3;4.3
976;2021-05-10;9;9;20385;11925;7.3;4.3
976;2021-05-11;363;492;20748;12417;7.4;4.4
976;2021-05-12;334;310;21082;12727;7.5;4.6
976;2021-05-13;126;96;21208;12823;7.6;4.6
976;2021-05-14;0;0;21208;12823;7.6;4.6
976;2021-05-15;485;282;21693;13105;7.8;4.7
976;2021-05-16;1;0;21694;13105;7.8;4.7
976;2021-05-17;124;51;21818;13156;7.8;4.7
976;2021-05-18;518;430;22336;13586;8.0;4.9
976;2021-05-19;651;663;22987;14249;8.2;5.1
976;2021-05-20;1057;499;24044;14748;8.6;5.3
976;2021-05-21;1046;313;25090;15061;9.0;5.4
976;2021-05-22;1241;298;26331;15359;9.4;5.5
976;2021-05-23;0;0;26331;15359;9.4;5.5
976;2021-05-24;1;0;26332;15359;9.4;5.5
976;2021-05-25;890;622;27222;15981;9.7;5.7
976;2021-05-26;1033;843;28255;16824;10.1;6.0
976;2021-05-27;1321;512;29576;17336;10.6;6.2
976;2021-05-28;956;375;30532;17711;10.9;6.3
976;2021-05-29;1130;392;31662;18103;11.3;6.5
976;2021-05-30;1;1;31663;18104;11.3;6.5
976;2021-05-31;107;6;31770;18110;11.4;6.5
976;2021-06-01;1149;651;32919;18761;11.8;6.7
976;2021-06-02;1243;531;34162;19292;12.2;6.9
976;2021-06-03;813;355;34975;19647;12.5;7.0
976;2021-06-04;1000;325;35975;19972;12.9;7.1
976;2021-06-05;680;299;36655;20271;13.1;7.3
976;2021-06-06;1;0;36656;20271;13.1;7.3
976;2021-06-07;92;12;36748;20283;13.1;7.3
976;2021-06-08;952;442;37700;20725;13.5;7.4
976;2021-06-09;969;550;38669;21275;13.8;7.6
976;2021-06-10;704;232;39373;21507;14.1;7.7
976;2021-06-11;850;365;40223;21872;14.4;7.8
976;2021-06-12;583;275;40806;22147;14.6;7.9
976;2021-06-13;2;0;40808;22147;14.6;7.9
976;2021-06-14;187;112;40995;22259;14.7;8.0
976;2021-06-15;412;838;41407;23097;14.8;8.3
976;2021-06-16;891;1440;42298;24537;15.1;8.8
976;2021-06-17;798;661;43096;25198;15.4;9.0
976;2021-06-18;705;620;43801;25818;15.7;9.2
976;2021-06-19;537;645;44338;26463;15.9;9.5
976;2021-06-20;1;0;44339;26463;15.9;9.5
976;2021-06-21;127;132;44466;26595;15.9;9.5
976;2021-06-22;429;1150;44895;27745;16.1;9.9
976;2021-06-23;691;1186;45586;28931;16.3;10.4
976;2021-06-24;480;544;46066;29475;16.5;10.5
976;2021-06-25;542;479;46608;29954;16.7;10.7
976;2021-06-26;386;692;46994;30646;16.8;11.0
976;2021-06-27;1;0;46995;30646;16.8;11.0
976;2021-06-28;108;191;47103;30837;16.9;11.0
976;2021-06-29;742;973;47845;31810;17.1;11.4
976;2021-06-30;710;948;48555;32758;17.4;11.7
976;2021-07-01;589;547;49144;33305;17.6;11.9
976;2021-07-02;451;432;49595;33737;17.7;12.1
976;2021-07-03;443;422;50038;34159;17.9;12.2
976;2021-07-04;2;0;50040;34159;17.9;12.2
976;2021-07-05;121;223;50161;34382;17.9;12.3
976;2021-07-06;498;865;50659;35247;18.1;12.6
976;2021-07-07;770;1014;51429;36261;18.4;13.0
976;2021-07-08;834;636;52263;36897;18.7;13.2
976;2021-07-09;786;519;53049;37416;19.0;13.4
976;2021-07-10;441;319;53490;37735;19.1;13.5
976;2021-07-11;0;0;53490;37735;19.1;13.5
976;2021-07-12;164;170;53654;37905;19.2;13.6
976;2021-07-13;847;1000;54501;38905;19.5;13.9
976;2021-07-14;0;5;54501;38910;19.5;13.9
976;2021-07-15;1220;812;55721;39722;19.9;14.2
976;2021-07-16;1292;657;57013;40379;20.4;14.4
976;2021-07-17;1033;377;58046;40756;20.8;14.6
976;2021-07-18;0;0;58046;40756;20.8;14.6
976;2021-07-19;206;134;58252;40890;20.8;14.6
976;2021-07-20;1155;877;59407;41767;21.3;14.9
976;2021-07-21;34;29;59441;41796;21.3;15.0
976;2021-07-22;1123;666;60564;42462;21.7;15.2
976;2021-07-23;1206;545;61770;43007;22.1;15.4
976;2021-07-24;855;440;62625;43447;22.4;15.5
976;2021-07-25;2;0;62627;43447;22.4;15.5
976;2021-07-26;180;37;62807;43484;22.5;15.6
976;2021-07-27;1138;826;63945;44310;22.9;15.9
976;2021-07-28;1043;634;64988;44944;23.3;16.1
976;2021-07-29;1233;566;66221;45510;23.7;16.3
976;2021-07-30;1218;412;67439;45922;24.1;16.4
976;2021-07-31;760;277;68199;46199;24.4;16.5
976;2021-08-01;5;3;68204;46202;24.4;16.5
976;2021-08-02;344;174;68548;46376;24.5;16.6
976;2021-08-03;1504;935;70052;47311;25.1;16.9
976;2021-08-04;1828;808;71880;48119;25.7;17.2
976;2021-08-05;1462;504;73342;48623;26.2;17.4
976;2021-08-06;1691;509;75033;49132;26.8;17.6
976;2021-08-07;912;358;75945;49490;27.2;17.7
976;2021-08-08;7;1;75952;49491;27.2;17.7
976;2021-08-09;529;236;76481;49727;27.4;17.8
976;2021-08-10;1641;1380;78122;51107;28.0;18.3
976;2021-08-11;2043;1239;80165;52346;28.7;18.7
976;2021-08-12;1710;621;81875;52967;29.3;19.0
976;2021-08-13;1573;534;83448;53501;29.9;19.1
976;2021-08-14;833;456;84281;53957;30.2;19.3
976;2021-08-15;0;0;84281;53957;30.2;19.3
976;2021-08-16;568;291;84849;54248;30.4;19.4
976;2021-08-17;1828;1301;86677;55549;31.0;19.9
976;2021-08-18;2230;1226;88907;56775;31.8;20.3
976;2021-08-19;1981;555;90888;57330;32.5;20.5
976;2021-08-20;1803;551;92691;57881;33.2;20.7
976;2021-08-21;1057;521;93748;58402;33.5;20.9
976;2021-08-22;15;0;93763;58402;33.6;20.9
976;2021-08-23;576;271;94339;58673;33.8;21.0
976;2021-08-24;1063;1009;95402;59682;34.1;21.4
976;2021-08-25;1083;1293;96485;60975;34.5;21.8
976;2021-08-26;910;574;97395;61549;34.8;22.0
976;2021-08-27;739;565;98134;62114;35.1;22.2
976;2021-08-28;472;857;98606;62971;35.3;22.5
976;2021-08-29;0;12;98606;62983;35.3;22.5
976;2021-08-30;150;256;98756;63239;35.3;22.6
976;2021-08-31;655;1162;99411;64401;35.6;23.0
976;2021-09-01;815;1396;100226;65797;35.9;23.5
976;2021-09-02;848;904;101074;66701;36.2;23.9
976;2021-09-03;909;1296;101983;67997;36.5;24.3
976;2021-09-04;432;999;102415;68996;36.6;24.7
976;2021-09-05;0;1;102415;68997;36.6;24.7
976;2021-09-06;445;402;102860;69399;36.8;24.8
976;2021-09-07;740;703;103600;70102;37.1;25.1
976;2021-09-08;1107;1265;104707;71367;37.5;25.5
976;2021-09-09;886;1016;105593;72383;37.8;25.9
976;2021-09-10;1216;1085;106809;73468;38.2;26.3
976;2021-09-11;532;1037;107341;74505;38.4;26.7
976;2021-09-12;0;32;107341;74537;38.4;26.7
976;2021-09-13;700;620;108041;75157;38.7;26.9
976;2021-09-14;1080;722;109121;75879;39.0;27.2
976;2021-09-15;1685;1183;110806;77062;39.6;27.6
976;2021-09-16;1738;893;112544;77955;40.3;27.9
976;2021-09-17;1842;1061;114386;79016;40.9;28.3
976;2021-09-18;952;783;115338;79799;41.3;28.6
976;2021-09-19;1;52;115339;79851;41.3;28.6
976;2021-09-20;1014;543;116353;80394;41.6;28.8
976;2021-09-21;1649;770;118002;81164;42.2;29.0
976;2021-09-22;1438;964;119440;82128;42.7;29.4
976;2021-09-23;1021;879;120461;83007;43.1;29.7
976;2021-09-24;1085;1011;121546;84018;43.5;30.1
976;2021-09-25;489;479;122035;84497;43.7;30.2
976;2021-09-26;0;21;122035;84518;43.7;30.2
976;2021-09-27;691;423;122726;84941;43.9;30.4
976;2021-09-28;1167;924;123893;85865;44.3;30.7
976;2021-09-29;1331;1059;125224;86924;44.8;31.1
976;2021-09-30;995;684;126219;87608;45.2;31.3
976;2021-10-01;1260;1367;127479;88975;45.6;31.8
976;2021-10-02;456;651;127935;89626;45.8;32.1
976;2021-10-03;0;0;127935;89626;45.8;32.1
976;2021-10-04;689;618;128624;90244;46.0;32.3
976;2021-10-05;780;966;129404;91210;46.3;32.6
976;2021-10-06;1204;1405;130608;92615;46.7;33.1
977;2020-12-27;0;0;0;0;0.0;0.0
977;2020-12-28;0;0;0;0;0.0;0.0
977;2020-12-29;0;0;0;0;0.0;0.0
977;2020-12-30;0;0;0;0;0.0;0.0
977;2020-12-31;0;0;0;0;0.0;0.0
977;2021-01-01;0;0;0;0;0.0;0.0
977;2021-01-02;0;0;0;0;0.0;0.0
977;2021-01-03;0;0;0;0;0.0;0.0
977;2021-01-04;0;0;0;0;0.0;0.0
977;2021-01-05;0;0;0;0;0.0;0.0
977;2021-01-06;0;0;0;0;0.0;0.0
977;2021-01-07;0;0;0;0;0.0;0.0
977;2021-01-08;0;0;0;0;0.0;0.0
977;2021-01-09;0;0;0;0;0.0;0.0
977;2021-01-10;0;0;0;0;0.0;0.0
977;2021-01-11;0;0;0;0;0.0;0.0
977;2021-01-12;0;0;0;0;0.0;0.0
977;2021-01-13;0;0;0;0;0.0;0.0
977;2021-01-14;0;0;0;0;0.0;0.0
977;2021-01-15;0;0;0;0;0.0;0.0
977;2021-01-16;0;0;0;0;0.0;0.0
977;2021-01-17;0;0;0;0;0.0;0.0
977;2021-01-18;1;0;1;0;0.0;0.0
977;2021-01-19;0;0;1;0;0.0;0.0
977;2021-01-20;0;0;1;0;0.0;0.0
977;2021-01-21;12;0;13;0;0.1;0.0
977;2021-01-22;12;0;25;0;0.3;0.0
977;2021-01-23;0;0;25;0;0.3;0.0
977;2021-01-24;0;0;25;0;0.3;0.0
977;2021-01-25;0;0;25;0;0.3;0.0
977;2021-01-26;0;0;25;0;0.3;0.0
977;2021-01-27;12;0;37;0;0.4;0.0
977;2021-01-28;1;0;38;0;0.4;0.0
977;2021-01-29;6;0;44;0;0.4;0.0
977;2021-01-30;0;0;44;0;0.4;0.0
977;2021-01-31;0;0;44;0;0.4;0.0
977;2021-02-01;0;0;44;0;0.4;0.0
977;2021-02-02;0;0;44;0;0.4;0.0
977;2021-02-03;11;0;55;0;0.6;0.0
977;2021-02-04;12;0;67;0;0.7;0.0
977;2021-02-05;11;0;78;0;0.8;0.0
977;2021-02-06;0;0;78;0;0.8;0.0
977;2021-02-07;0;0;78;0;0.8;0.0
977;2021-02-08;0;0;78;0;0.8;0.0
977;2021-02-09;14;0;92;0;0.9;0.0
977;2021-02-10;0;0;92;0;0.9;0.0
977;2021-02-11;18;0;110;0;1.1;0.0
977;2021-02-12;46;0;156;0;1.6;0.0
977;2021-02-13;0;0;156;0;1.6;0.0
977;2021-02-14;0;0;156;0;1.6;0.0
977;2021-02-15;0;0;156;0;1.6;0.0
977;2021-02-16;0;0;156;0;1.6;0.0
977;2021-02-17;0;0;156;0;1.6;0.0
977;2021-02-18;19;0;175;0;1.8;0.0
977;2021-02-19;35;0;210;0;2.1;0.0
977;2021-02-20;0;0;210;0;2.1;0.0
977;2021-02-21;0;0;210;0;2.1;0.0
977;2021-02-22;0;0;210;0;2.1;0.0
977;2021-02-23;0;18;210;18;2.1;0.2
977;2021-02-24;0;0;210;18;2.1;0.2
977;2021-02-25;15;3;225;21;2.3;0.2
977;2021-02-26;33;17;258;38;2.6;0.4
977;2021-02-27;0;0;258;38;2.6;0.4
977;2021-02-28;0;0;258;38;2.6;0.4
977;2021-03-01;0;0;258;38;2.6;0.4
977;2021-03-02;19;11;277;49;2.8;0.5
977;2021-03-03;0;0;277;49;2.8;0.5
977;2021-03-04;16;9;293;58;2.9;0.6
977;2021-03-05;35;16;328;74;3.3;0.7
977;2021-03-06;0;0;328;74;3.3;0.7
977;2021-03-07;0;0;328;74;3.3;0.7
977;2021-03-08;0;0;328;74;3.3;0.7
977;2021-03-09;1;0;329;74;3.3;0.7
977;2021-03-10;0;0;329;74;3.3;0.7
977;2021-03-11;20;26;349;100;3.5;1.0
977;2021-03-12;62;42;411;142;4.1;1.4
977;2021-03-13;0;0;411;142;4.1;1.4
977;2021-03-14;0;0;411;142;4.1;1.4
977;2021-03-15;0;0;411;142;4.1;1.4
977;2021-03-16;30;10;441;152;4.4;1.5
977;2021-03-17;0;0;441;152;4.4;1.5
977;2021-03-18;30;16;471;168;4.7;1.7
977;2021-03-19;58;27;529;195;5.3;2.0
977;2021-03-20;0;0;529;195;5.3;2.0
977;2021-03-21;0;0;529;195;5.3;2.0
977;2021-03-22;0;0;529;195;5.3;2.0
977;2021-03-23;0;0;529;195;5.3;2.0
977;2021-03-24;0;0;529;195;5.3;2.0
977;2021-03-25;65;17;594;212;6.0;2.1
977;2021-03-26;73;25;667;237;6.7;2.4
977;2021-03-27;0;0;667;237;6.7;2.4
977;2021-03-28;0;0;667;237;6.7;2.4
977;2021-03-29;0;0;667;237;6.7;2.4
977;2021-03-30;39;16;706;253;7.1;2.5
977;2021-03-31;26;14;732;267;7.3;2.7
977;2021-04-01;25;32;757;299;7.6;3.0
977;2021-04-02;0;0;757;299;7.6;3.0
977;2021-04-03;0;0;757;299;7.6;3.0
977;2021-04-04;0;0;757;299;7.6;3.0
977;2021-04-05;9;0;766;299;7.7;3.0
977;2021-04-06;0;0;766;299;7.7;3.0
977;2021-04-07;0;0;766;299;7.7;3.0
977;2021-04-08;57;46;823;345;8.3;3.5
977;2021-04-09;58;31;881;376;8.8;3.8
977;2021-04-10;0;0;881;376;8.8;3.8
977;2021-04-11;0;0;881;376;8.8;3.8
977;2021-04-12;0;0;881;376;8.8;3.8
977;2021-04-13;0;0;881;376;8.8;3.8
977;2021-04-14;5;5;886;381;8.9;3.8
977;2021-04-15;57;70;943;451;9.5;4.5
977;2021-04-16;89;35;1032;486;10.4;4.9
977;2021-04-17;0;1;1032;487;10.4;4.9
977;2021-04-18;0;0;1032;487;10.4;4.9
977;2021-04-19;1;0;1033;487;10.4;4.9
977;2021-04-20;335;62;1368;549;13.7;5.5
977;2021-04-21;337;30;1705;579;17.1;5.8
977;2021-04-22;284;47;1989;626;20.0;6.3
977;2021-04-23;260;42;2249;668;22.6;6.7
977;2021-04-24;231;1;2480;669;24.9;6.7
977;2021-04-25;0;0;2480;669;24.9;6.7
977;2021-04-26;283;19;2763;688;27.7;6.9
977;2021-04-27;224;67;2987;755;30.0;7.6
977;2021-04-28;192;26;3179;781;31.9;7.8
977;2021-04-29;170;23;3349;804;33.6;8.1
977;2021-04-30;171;16;3520;820;35.3;8.2
977;2021-05-01;202;11;3722;831;37.4;8.3
977;2021-05-02;0;0;3722;831;37.4;8.3
977;2021-05-03;135;9;3857;840;38.7;8.4
977;2021-05-04;161;54;4018;894;40.3;9.0
977;2021-05-05;221;28;4239;922;42.6;9.3
977;2021-05-06;175;33;4414;955;44.3;9.6
977;2021-05-07;149;32;4563;987;45.8;9.9
977;2021-05-08;1;0;4564;987;45.8;9.9
977;2021-05-09;0;0;4564;987;45.8;9.9
977;2021-05-10;0;0;4564;987;45.8;9.9
977;2021-05-11;3;41;4567;1028;45.8;10.3
977;2021-05-12;6;36;4573;1064;45.9;10.7
977;2021-05-13;0;0;4573;1064;45.9;10.7
977;2021-05-14;28;98;4601;1162;46.2;11.7
977;2021-05-15;0;0;4601;1162;46.2;11.7
977;2021-05-16;1;0;4602;1162;46.2;11.7
977;2021-05-17;1;14;4603;1176;46.2;11.8
977;2021-05-18;17;32;4620;1208;46.4;12.1
977;2021-05-19;1;2;4621;1210;46.4;12.1
977;2021-05-20;0;8;4621;1218;46.4;12.2
977;2021-05-21;12;31;4633;1249;46.5;12.5
977;2021-05-22;0;0;4633;1249;46.5;12.5
977;2021-05-23;0;0;4633;1249;46.5;12.5
977;2021-05-24;0;0;4633;1249;46.5;12.5
977;2021-05-25;50;331;4683;1580;47.0;15.9
977;2021-05-26;54;360;4737;1940;47.6;19.5
977;2021-05-27;34;317;4771;2257;47.9;22.7
977;2021-05-28;27;256;4798;2513;48.2;25.2
977;2021-05-29;35;375;4833;2888;48.5;29.0
977;2021-05-30;1;0;4834;2888;48.5;29.0
977;2021-05-31;45;216;4879;3104;49.0;31.2
977;2021-06-01;48;227;4927;3331;49.5;33.4
977;2021-06-02;69;273;4996;3604;50.2;36.2
977;2021-06-03;43;252;5039;3856;50.6;38.7
977;2021-06-04;82;270;5121;4126;51.4;41.4
977;2021-06-05;1;0;5122;4126;51.4;41.4
977;2021-06-06;0;0;5122;4126;51.4;41.4
977;2021-06-07;1;1;5123;4127;51.4;41.4
977;2021-06-08;8;2;5131;4129;51.5;41.5
977;2021-06-09;0;3;5131;4132;51.5;41.5
977;2021-06-10;8;4;5139;4136;51.6;41.5
977;2021-06-11;4;8;5143;4144;51.6;41.6
977;2021-06-12;15;59;5158;4203;51.8;42.2
977;2021-06-13;0;0;5158;4203;51.8;42.2
977;2021-06-14;0;0;5158;4203;51.8;42.2
977;2021-06-15;0;1;5158;4204;51.8;42.2
977;2021-06-16;0;0;5158;4204;51.8;42.2
977;2021-06-17;2;6;5160;4210;51.8;42.3
977;2021-06-18;0;2;5160;4212;51.8;42.3
977;2021-06-19;25;49;5185;4261;52.1;42.8
977;2021-06-20;0;0;5185;4261;52.1;42.8
977;2021-06-21;1;2;5186;4263;52.1;42.8
977;2021-06-22;9;0;5195;4263;52.2;42.8
977;2021-06-23;15;9;5210;4272;52.3;42.9
977;2021-06-24;10;5;5220;4277;52.4;42.9
977;2021-06-25;0;0;5220;4277;52.4;42.9
977;2021-06-26;25;45;5245;4322;52.7;43.4
977;2021-06-27;0;0;5245;4322;52.7;43.4
977;2021-06-28;0;0;5245;4322;52.7;43.4
977;2021-06-29;0;0;5245;4322;52.7;43.4
977;2021-06-30;0;0;5245;4322;52.7;43.4
977;2021-07-01;28;36;5273;4358;52.9;43.8
977;2021-07-02;26;31;5299;4389;53.2;44.1
977;2021-07-03;30;215;5329;4604;53.5;46.2
977;2021-07-04;0;0;5329;4604;53.5;46.2
977;2021-07-05;4;8;5333;4612;53.5;46.3
977;2021-07-06;0;0;5333;4612;53.5;46.3
977;2021-07-07;8;0;5341;4612;53.6;46.3
977;2021-07-08;33;23;5374;4635;54.0;46.5
977;2021-07-09;23;31;5397;4666;54.2;46.8
977;2021-07-10;33;45;5430;4711;54.5;47.3
977;2021-07-11;0;0;5430;4711;54.5;47.3
977;2021-07-12;0;1;5430;4712;54.5;47.3
977;2021-07-13;10;10;5440;4722;54.6;47.4
977;2021-07-14;0;0;5440;4722;54.6;47.4
977;2021-07-15;1;11;5441;4733;54.6;47.5
977;2021-07-16;44;51;5485;4784;55.1;48.0
977;2021-07-17;34;39;5519;4823;55.4;48.4
977;2021-07-18;1;0;5520;4823;55.4;48.4
977;2021-07-19;3;2;5523;4825;55.4;48.4
977;2021-07-20;3;1;5526;4826;55.5;48.4
977;2021-07-21;33;16;5559;4842;55.8;48.6
977;2021-07-22;36;33;5595;4875;56.2;48.9
977;2021-07-23;32;31;5627;4906;56.5;49.3
977;2021-07-24;42;25;5669;4931;56.9;49.5
977;2021-07-25;0;0;5669;4931;56.9;49.5
977;2021-07-26;13;10;5682;4941;57.0;49.6
977;2021-07-27;0;10;5682;4951;57.0;49.7
977;2021-07-28;31;14;5713;4965;57.4;49.8
977;2021-07-29;33;32;5746;4997;57.7;50.2
977;2021-07-30;31;28;5777;5025;58.0;50.4
977;2021-07-31;53;24;5830;5049;58.5;50.7
977;2021-08-01;0;0;5830;5049;58.5;50.7
977;2021-08-02;11;1;5841;5050;58.6;50.7
977;2021-08-03;0;0;5841;5050;58.6;50.7
977;2021-08-04;40;14;5881;5064;59.0;50.8
977;2021-08-05;28;30;5909;5094;59.3;51.1
977;2021-08-06;35;35;5944;5129;59.7;51.5
977;2021-08-07;56;25;6000;5154;60.2;51.7
977;2021-08-08;0;0;6000;5154;60.2;51.7
977;2021-08-09;7;5;6007;5159;60.3;51.8
977;2021-08-10;15;9;6022;5168;60.5;51.9
977;2021-08-11;36;18;6058;5186;60.8;52.1
977;2021-08-12;24;30;6082;5216;61.1;52.4
977;2021-08-13;32;14;6114;5230;61.4;52.5
977;2021-08-14;20;26;6134;5256;61.6;52.8
977;2021-08-15;0;0;6134;5256;61.6;52.8
977;2021-08-16;14;29;6148;5285;61.7;53.1
977;2021-08-17;15;8;6163;5293;61.9;53.1
977;2021-08-18;25;28;6188;5321;62.1;53.4
977;2021-08-19;31;36;6219;5357;62.4;53.8
977;2021-08-20;27;41;6246;5398;62.7;54.2
977;2021-08-21;35;41;6281;5439;63.1;54.6
977;2021-08-22;6;0;6287;5439;63.1;54.6
977;2021-08-23;3;11;6290;5450;63.1;54.7
977;2021-08-24;8;3;6298;5453;63.2;54.7
977;2021-08-25;20;37;6318;5490;63.4;55.1
977;2021-08-26;27;41;6345;5531;63.7;55.5
977;2021-08-27;27;35;6372;5566;64.0;55.9
977;2021-08-28;27;56;6399;5622;64.2;56.4
977;2021-08-29;0;0;6399;5622;64.2;56.4
977;2021-08-30;1;4;6400;5626;64.3;56.5
977;2021-08-31;1;2;6401;5628;64.3;56.5
977;2021-09-01;10;28;6411;5656;64.4;56.8
977;2021-09-02;22;35;6433;5691;64.6;57.1
977;2021-09-03;26;25;6459;5716;64.8;57.4
977;2021-09-04;37;49;6496;5765;65.2;57.9
977;2021-09-05;0;0;6496;5765;65.2;57.9
977;2021-09-06;4;16;6500;5781;65.3;58.0
977;2021-09-07;1;4;6501;5785;65.3;58.1
977;2021-09-08;12;13;6513;5798;65.4;58.2
977;2021-09-09;20;36;6533;5834;65.6;58.6
977;2021-09-10;7;31;6540;5865;65.7;58.9
977;2021-09-11;36;31;6576;5896;66.0;59.2
977;2021-09-12;0;6;6576;5902;66.0;59.3
977;2021-09-13;4;4;6580;5906;66.1;59.3
977;2021-09-14;1;0;6581;5906;66.1;59.3
977;2021-09-15;12;26;6593;5932;66.2;59.6
977;2021-09-16;15;31;6608;5963;66.3;59.9
977;2021-09-17;10;32;6618;5995;66.4;60.2
977;2021-09-18;20;39;6638;6034;66.6;60.6
977;2021-09-19;0;0;6638;6034;66.6;60.6
977;2021-09-20;0;2;6638;6036;66.6;60.6
977;2021-09-21;0;1;6638;6037;66.6;60.6
977;2021-09-22;10;11;6648;6048;66.7;60.7
977;2021-09-23;7;30;6655;6078;66.8;61.0
977;2021-09-24;0;0;6655;6078;66.8;61.0
977;2021-09-25;11;49;6666;6127;66.9;61.5
977;2021-09-26;0;0;6666;6127;66.9;61.5
977;2021-09-27;0;0;6666;6127;66.9;61.5
977;2021-09-28;0;1;6666;6128;66.9;61.5
977;2021-09-29;5;15;6671;6143;67.0;61.7
977;2021-09-30;18;19;6689;6162;67.2;61.9
977;2021-10-01;0;3;6689;6165;67.2;61.9
977;2021-10-02;10;39;6699;6204;67.3;62.3
977;2021-10-03;0;0;6699;6204;67.3;62.3
977;2021-10-04;0;0;6699;6204;67.3;62.3
977;2021-10-05;0;0;6699;6204;67.3;62.3
977;2021-10-06;14;22;6713;6226;67.4;62.5
978;2020-12-27;0;0;0;0;0.0;0.0
978;2020-12-28;0;0;0;0;0.0;0.0
978;2020-12-29;0;0;0;0;0.0;0.0
978;2020-12-30;0;0;0;0;0.0;0.0
978;2020-12-31;0;0;0;0;0.0;0.0
978;2021-01-01;0;0;0;0;0.0;0.0
978;2021-01-02;0;0;0;0;0.0;0.0
978;2021-01-03;0;0;0;0;0.0;0.0
978;2021-01-04;0;0;0;0;0.0;0.0
978;2021-01-05;0;0;0;0;0.0;0.0
978;2021-01-06;0;0;0;0;0.0;0.0
978;2021-01-07;0;0;0;0;0.0;0.0
978;2021-01-08;0;0;0;0;0.0;0.0
978;2021-01-09;0;0;0;0;0.0;0.0
978;2021-01-10;0;0;0;0;0.0;0.0
978;2021-01-11;0;0;0;0;0.0;0.0
978;2021-01-12;0;0;0;0;0.0;0.0
978;2021-01-13;10;0;10;0;0.0;0.0
978;2021-01-14;12;0;22;0;0.1;0.0
978;2021-01-15;9;0;31;0;0.1;0.0
978;2021-01-16;0;0;31;0;0.1;0.0
978;2021-01-17;0;0;31;0;0.1;0.0
978;2021-01-18;0;0;31;0;0.1;0.0
978;2021-01-19;12;0;43;0;0.1;0.0
978;2021-01-20;13;0;56;0;0.2;0.0
978;2021-01-21;6;0;62;0;0.2;0.0
978;2021-01-22;0;0;62;0;0.2;0.0
978;2021-01-23;0;0;62;0;0.2;0.0
978;2021-01-24;0;0;62;0;0.2;0.0
978;2021-01-25;0;0;62;0;0.2;0.0
978;2021-01-26;9;0;71;0;0.2;0.0
978;2021-01-27;10;0;81;0;0.2;0.0
978;2021-01-28;6;1;87;1;0.2;0.0
978;2021-01-29;0;0;87;1;0.2;0.0
978;2021-01-30;0;0;87;1;0.2;0.0
978;2021-01-31;0;0;87;1;0.2;0.0
978;2021-02-01;1;0;88;1;0.2;0.0
978;2021-02-02;39;0;127;1;0.4;0.0
978;2021-02-03;11;0;138;1;0.4;0.0
978;2021-02-04;32;0;170;1;0.5;0.0
978;2021-02-05;6;0;176;1;0.5;0.0
978;2021-02-06;0;0;176;1;0.5;0.0
978;2021-02-07;0;0;176;1;0.5;0.0
978;2021-02-08;0;0;176;1;0.5;0.0
978;2021-02-09;38;0;214;1;0.6;0.0
978;2021-02-10;27;1;241;2;0.7;0.0
978;2021-02-11;0;0;241;2;0.7;0.0
978;2021-02-12;36;0;277;2;0.8;0.0
978;2021-02-13;0;0;277;2;0.8;0.0
978;2021-02-14;0;0;277;2;0.8;0.0
978;2021-02-15;50;1;327;3;0.9;0.0
978;2021-02-16;0;0;327;3;0.9;0.0
978;2021-02-17;0;0;327;3;0.9;0.0
978;2021-02-18;28;0;355;3;1.0;0.0
978;2021-02-19;44;0;399;3;1.1;0.0
978;2021-02-20;0;0;399;3;1.1;0.0
978;2021-02-21;0;0;399;3;1.1;0.0
978;2021-02-22;45;4;444;7;1.3;0.0
978;2021-02-23;41;25;485;32;1.4;0.1
978;2021-02-24;36;1;521;33;1.5;0.1
978;2021-02-25;55;34;576;67;1.6;0.2
978;2021-02-26;39;5;615;72;1.7;0.2
978;2021-02-27;0;0;615;72;1.7;0.2
978;2021-02-28;0;0;615;72;1.7;0.2
978;2021-03-01;50;4;665;76;1.9;0.2
978;2021-03-02;7;19;672;95;1.9;0.3
978;2021-03-03;53;23;725;118;2.1;0.3
978;2021-03-04;31;18;756;136;2.1;0.4
978;2021-03-05;46;10;802;146;2.3;0.4
978;2021-03-06;0;0;802;146;2.3;0.4
978;2021-03-07;0;0;802;146;2.3;0.4
978;2021-03-08;32;5;834;151;2.4;0.4
978;2021-03-09;21;23;855;174;2.4;0.5
978;2021-03-10;35;25;890;199;2.5;0.6
978;2021-03-11;2;0;892;199;2.5;0.6
978;2021-03-12;53;20;945;219;2.7;0.6
978;2021-03-13;13;0;958;219;2.7;0.6
978;2021-03-14;0;0;958;219;2.7;0.6
978;2021-03-15;31;41;989;260;2.8;0.7
978;2021-03-16;73;5;1062;265;3.0;0.7
978;2021-03-17;67;13;1129;278;3.2;0.8
978;2021-03-18;82;38;1211;316;3.4;0.9
978;2021-03-19;32;50;1243;366;3.5;1.0
978;2021-03-20;0;0;1243;366;3.5;1.0
978;2021-03-21;0;0;1243;366;3.5;1.0
978;2021-03-22;35;45;1278;411;3.6;1.2
978;2021-03-23;30;43;1308;454;3.7;1.3
978;2021-03-24;38;42;1346;496;3.8;1.4
978;2021-03-25;97;34;1443;530;4.1;1.5
978;2021-03-26;45;33;1488;563;4.2;1.6
978;2021-03-27;94;3;1582;566;4.5;1.6
978;2021-03-28;0;0;1582;566;4.5;1.6
978;2021-03-29;69;46;1651;612;4.7;1.7
978;2021-03-30;99;24;1750;636;5.0;1.8
978;2021-03-31;91;49;1841;685;5.2;1.9
978;2021-04-01;57;48;1898;733;5.4;2.1
978;2021-04-02;0;0;1898;733;5.4;2.1
978;2021-04-03;1;0;1899;733;5.4;2.1
978;2021-04-04;0;0;1899;733;5.4;2.1
978;2021-04-05;2;0;1901;733;5.4;2.1
978;2021-04-06;49;63;1950;796;5.5;2.3
978;2021-04-07;93;33;2043;829;5.8;2.3
978;2021-04-08;122;7;2165;836;6.1;2.4
978;2021-04-09;91;39;2256;875;6.4;2.5
978;2021-04-10;170;13;2426;888;6.9;2.5
978;2021-04-11;0;0;2426;888;6.9;2.5
978;2021-04-12;42;74;2468;962;7.0;2.7
978;2021-04-13;49;71;2517;1033;7.1;2.9
978;2021-04-14;82;45;2599;1078;7.4;3.1
978;2021-04-15;92;22;2691;1100;7.6;3.1
978;2021-04-16;77;42;2768;1142;7.8;3.2
978;2021-04-17;165;5;2933;1147;8.3;3.2
978;2021-04-18;0;0;2933;1147;8.3;3.2
978;2021-04-19;52;67;2985;1214;8.4;3.4
978;2021-04-20;83;27;3068;1241;8.7;3.5
978;2021-04-21;91;28;3159;1269;8.9;3.6
978;2021-04-22;101;20;3260;1289;9.2;3.6
978;2021-04-23;45;65;3305;1354;9.4;3.8
978;2021-04-24;99;78;3404;1432;9.6;4.1
978;2021-04-25;0;0;3404;1432;9.6;4.1
978;2021-04-26;29;91;3433;1523;9.7;4.3
978;2021-04-27;59;63;3492;1586;9.9;4.5
978;2021-04-28;93;40;3585;1626;10.1;4.6
978;2021-04-29;89;31;3674;1657;10.4;4.7
978;2021-04-30;103;14;3777;1671;10.7;4.7
978;2021-05-01;0;8;3777;1679;10.7;4.8
978;2021-05-02;0;0;3777;1679;10.7;4.8
978;2021-05-03;25;99;3802;1778;10.8;5.0
978;2021-05-04;159;101;3961;1879;11.2;5.3
978;2021-05-05;142;59;4103;1938;11.6;5.5
978;2021-05-06;199;49;4302;1987;12.2;5.6
978;2021-05-07;127;71;4429;2058;12.5;5.8
978;2021-05-08;69;122;4498;2180;12.7;6.2
978;2021-05-09;0;0;4498;2180;12.7;6.2
978;2021-05-10;124;100;4622;2280;13.1;6.5
978;2021-05-11;132;72;4754;2352;13.5;6.7
978;2021-05-12;155;78;4909;2430;13.9;6.9
978;2021-05-13;83;6;4992;2436;14.1;6.9
978;2021-05-14;130;62;5122;2498;14.5;7.1
978;2021-05-15;86;4;5208;2502;14.7;7.1
978;2021-05-16;0;0;5208;2502;14.7;7.1
978;2021-05-17;146;115;5354;2617;15.2;7.4
978;2021-05-18;151;94;5505;2711;15.6;7.7
978;2021-05-19;84;69;5589;2780;15.8;7.9
978;2021-05-20;104;26;5693;2806;16.1;7.9
978;2021-05-21;98;52;5791;2858;16.4;8.1
978;2021-05-22;99;11;5890;2869;16.7;8.1
978;2021-05-23;0;0;5890;2869;16.7;8.1
978;2021-05-24;33;7;5923;2876;16.8;8.1
978;2021-05-25;119;78;6042;2954;17.1;8.4
978;2021-05-26;108;49;6150;3003;17.4;8.5
978;2021-05-27;112;42;6262;3045;17.7;8.6
978;2021-05-28;33;1;6295;3046;17.8;8.6
978;2021-05-29;60;213;6355;3259;18.0;9.2
978;2021-05-30;0;0;6355;3259;18.0;9.2
978;2021-05-31;111;63;6466;3322;18.3;9.4
978;2021-06-01;116;62;6582;3384;18.6;9.6
978;2021-06-02;131;33;6713;3417;19.0;9.7
978;2021-06-03;101;38;6814;3455;19.3;9.8
978;2021-06-04;128;70;6942;3525;19.6;10.0
978;2021-06-05;83;21;7025;3546;19.9;10.0
978;2021-06-06;0;0;7025;3546;19.9;10.0
978;2021-06-07;96;96;7121;3642;20.2;10.3
978;2021-06-08;82;89;7203;3731;20.4;10.6
978;2021-06-09;99;73;7302;3804;20.7;10.8
978;2021-06-10;112;63;7414;3867;21.0;10.9
978;2021-06-11;116;106;7530;3973;21.3;11.2
978;2021-06-12;57;30;7587;4003;21.5;11.3
978;2021-06-13;0;0;7587;4003;21.5;11.3
978;2021-06-14;105;127;7692;4130;21.8;11.7
978;2021-06-15;88;120;7780;4250;22.0;12.0
978;2021-06-16;105;148;7885;4398;22.3;12.4
978;2021-06-17;85;72;7970;4470;22.6;12.7
978;2021-06-18;67;98;8037;4568;22.7;12.9
978;2021-06-19;65;79;8102;4647;22.9;13.2
978;2021-06-20;0;0;8102;4647;22.9;13.2
978;2021-06-21;78;150;8180;4797;23.2;13.6
978;2021-06-22;71;103;8251;4900;23.4;13.9
978;2021-06-23;68;115;8319;5015;23.5;14.2
978;2021-06-24;43;75;8362;5090;23.7;14.4
978;2021-06-25;64;100;8426;5190;23.8;14.7
978;2021-06-26;35;61;8461;5251;23.9;14.9
978;2021-06-27;0;0;8461;5251;23.9;14.9
978;2021-06-28;73;131;8534;5382;24.2;15.2
978;2021-06-29;62;104;8596;5486;24.3;15.5
978;2021-06-30;56;110;8652;5596;24.5;15.8
978;2021-07-01;42;87;8694;5683;24.6;16.1
978;2021-07-02;52;90;8746;5773;24.8;16.3
978;2021-07-03;40;90;8786;5863;24.9;16.6
978;2021-07-04;0;1;8786;5864;24.9;16.6
978;2021-07-05;67;93;8853;5957;25.1;16.9
978;2021-07-06;55;74;8908;6031;25.2;17.1
978;2021-07-07;55;123;8963;6154;25.4;17.4
978;2021-07-08;54;107;9017;6261;25.5;17.7
978;2021-07-09;45;92;9062;6353;25.6;18.0
978;2021-07-10;38;85;9100;6438;25.8;18.2
978;2021-07-11;0;4;9100;6442;25.8;18.2
978;2021-07-12;71;130;9171;6572;26.0;18.6
978;2021-07-13;146;162;9317;6734;26.4;19.1
978;2021-07-14;3;0;9320;6734;26.4;19.1
978;2021-07-15;161;195;9481;6929;26.8;19.6
978;2021-07-16;113;113;9594;7042;27.2;19.9
978;2021-07-17;52;100;9646;7142;27.3;20.2
978;2021-07-18;0;0;9646;7142;27.3;20.2
978;2021-07-19;99;133;9745;7275;27.6;20.6
978;2021-07-20;80;74;9825;7349;27.8;20.8
978;2021-07-21;63;50;9888;7399;28.0;20.9
978;2021-07-22;97;114;9985;7513;28.3;21.3
978;2021-07-23;67;98;10052;7611;28.4;21.5
978;2021-07-24;20;35;10072;7646;28.5;21.6
978;2021-07-25;0;0;10072;7646;28.5;21.6
978;2021-07-26;99;116;10171;7762;28.8;22.0
978;2021-07-27;72;144;10243;7906;29.0;22.4
978;2021-07-28;72;126;10315;8032;29.2;22.7
978;2021-07-29;80;98;10395;8130;29.4;23.0
978;2021-07-30;82;115;10477;8245;29.7;23.3
978;2021-07-31;49;68;10526;8313;29.8;23.5
978;2021-08-01;0;0;10526;8313;29.8;23.5
978;2021-08-02;65;95;10591;8408;30.0;23.8
978;2021-08-03;60;94;10651;8502;30.1;24.1
978;2021-08-04;64;55;10715;8557;30.3;24.2
978;2021-08-05;48;70;10763;8627;30.5;24.4
978;2021-08-06;73;127;10836;8754;30.7;24.8
978;2021-08-07;44;46;10880;8800;30.8;24.9
978;2021-08-08;0;0;10880;8800;30.8;24.9
978;2021-08-09;138;150;11018;8950;31.2;25.3
978;2021-08-10;81;93;11099;9043;31.4;25.6
978;2021-08-11;106;99;11205;9142;31.7;25.9
978;2021-08-12;99;99;11304;9241;32.0;26.2
978;2021-08-13;132;75;11436;9316;32.4;26.4
978;2021-08-14;74;100;11510;9416;32.6;26.6
978;2021-08-15;0;0;11510;9416;32.6;26.6
978;2021-08-16;45;72;11555;9488;32.7;26.9
978;2021-08-17;33;33;11588;9521;32.8;26.9
978;2021-08-18;35;55;11623;9576;32.9;27.1
978;2021-08-19;34;26;11657;9602;33.0;27.2
978;2021-08-20;46;61;11703;9663;33.1;27.3
978;2021-08-21;0;0;11703;9663;33.1;27.3
978;2021-08-22;0;0;11703;9663;33.1;27.3
978;2021-08-23;51;87;11754;9750;33.3;27.6
978;2021-08-24;31;52;11785;9802;33.4;27.7
978;2021-08-25;26;51;11811;9853;33.4;27.9
978;2021-08-26;31;26;11842;9879;33.5;28.0
978;2021-08-27;47;88;11889;9967;33.6;28.2
978;2021-08-28;3;0;11892;9967;33.7;28.2
978;2021-08-29;0;0;11892;9967;33.7;28.2
978;2021-08-30;39;113;11931;10080;33.8;28.5
978;2021-08-31;46;81;11977;10161;33.9;28.8
978;2021-09-01;31;85;12008;10246;34.0;29.0
978;2021-09-02;38;70;12046;10316;34.1;29.2
978;2021-09-03;16;96;12062;10412;34.1;29.5
978;2021-09-04;0;0;12062;10412;34.1;29.5
978;2021-09-05;0;0;12062;10412;34.1;29.5
978;2021-09-06;32;80;12094;10492;34.2;29.7
978;2021-09-07;37;51;12131;10543;34.3;29.8
978;2021-09-08;21;45;12152;10588;34.4;30.0
978;2021-09-09;21;58;12173;10646;34.5;30.1
978;2021-09-10;43;82;12216;10728;34.6;30.4
978;2021-09-11;1;0;12217;10728;34.6;30.4
978;2021-09-12;5;1;12222;10729;34.6;30.4
978;2021-09-13;34;56;12256;10785;34.7;30.5
978;2021-09-14;23;33;12279;10818;34.8;30.6
978;2021-09-15;25;43;12304;10861;34.8;30.7
978;2021-09-16;8;33;12312;10894;34.8;30.8
978;2021-09-17;13;45;12325;10939;34.9;31.0
978;2021-09-18;0;0;12325;10939;34.9;31.0
978;2021-09-19;0;0;12325;10939;34.9;31.0
978;2021-09-20;10;35;12335;10974;34.9;31.1
978;2021-09-21;15;37;12350;11011;35.0;31.2
978;2021-09-22;13;34;12363;11045;35.0;31.3
978;2021-09-23;26;41;12389;11086;35.1;31.4
978;2021-09-24;19;27;12408;11113;35.1;31.5
978;2021-09-25;0;1;12408;11114;35.1;31.5
978;2021-09-26;0;0;12408;11114;35.1;31.5
978;2021-09-27;11;31;12419;11145;35.1;31.5
978;2021-09-28;19;25;12438;11170;35.2;31.6
978;2021-09-29;20;25;12458;11195;35.3;31.7
978;2021-09-30;23;23;12481;11218;35.3;31.7
978;2021-10-01;25;36;12506;11254;35.4;31.9
978;2021-10-02;0;0;12506;11254;35.4;31.9
978;2021-10-03;0;0;12506;11254;35.4;31.9
978;2021-10-04;22;27;12528;11281;35.5;31.9
978;2021-10-05;15;16;12543;11297;35.5;32.0
978;2021-10-06;12;16;12555;11313;35.5;32.0
