dep;jour;n_dose1;n_complet;n_cum_dose1;n_cum_complet;couv_dose1;couv_complet
01;2020-12-27;1;0;1;0;0.0;0.0
01;2020-12-28;0;0;1;0;0.0;0.0
01;2020-12-29;0;0;1;0;0.0;0.0
01;2020-12-30;0;0;1;0;0.0;0.0
01;2020-12-31;0;0;1;0;0.0;0.0
01;2021-01-01;2;0;3;0;0.0;0.0
01;2021-01-02;0;0;3;0;0.0;0.0
01;2021-01-03;0;0;3;0;0.0;0.0
01;2021-01-04;2;0;5;0;0.0;0.0
01;2021-01-05;2;0;7;0;0.0;0.0
01;2021-01-06;1;0;8;0;0.0;0.0
01;2021-01-07;67;0;75;0;0.0;0.0
01;2021-01-08;159;0;234;0;0.0;0.0
01;2021-01-09;2;1;236;1;0.0;0.0
01;2021-01-10;1;0;237;1;0.0;0.0
01;2021-01-11;148;0;385;1;0.1;0.0
01;2021-01-12;318;2;703;3;0.1;0.0
01;2021-01-13;445;1;1148;4;0.2;0.0
01;2021-01-14;531;3;1679;7;0.3;0.0
01;2021-01-15;398;3;2077;10;0.3;0.0
01;2021-01-16;202;0;2279;10;0.3;0.0
01;2021-01-17;128;0;2407;10;0.4;0.0
01;2021-01-18;379;1;2786;11;0.4;0.0
01;2021-01-19;1041;1;3827;12;0.6;0.0
01;2021-01-20;1262;2;5089;14;0.8;0.0
01;2021-01-21;1101;4;6190;18;0.9;0.0
01;2021-01-22;649;0;6839;18;1.0;0.0
01;2021-01-23;223;0;7062;18;1.1;0.0
01;2021-01-24;70;1;7132;19;1.1;0.0
01;2021-01-25;485;1;7617;20;1.2;0.0
01;2021-01-26;743;3;8360;23;1.3;0.0
01;2021-01-27;516;3;8876;26;1.4;0.0
01;2021-01-28;681;51;9557;77;1.5;0.0
01;2021-01-29;637;98;10194;175;1.6;0.0
01;2021-01-30;237;15;10431;190;1.6;0.0
01;2021-01-31;62;0;10493;190;1.6;0.0
01;2021-02-01;458;70;10951;260;1.7;0.0
01;2021-02-02;519;171;11470;431;1.7;0.1
01;2021-02-03;376;232;11846;663;1.8;0.1
01;2021-02-04;480;372;12326;1035;1.9;0.2
01;2021-02-05;441;237;12767;1272;1.9;0.2
01;2021-02-06;264;105;13031;1377;2.0;0.2
01;2021-02-07;2;93;13033;1470;2.0;0.2
01;2021-02-08;506;325;13539;1795;2.1;0.3
01;2021-02-09;776;733;14315;2528;2.2;0.4
01;2021-02-10;957;622;15272;3150;2.3;0.5
01;2021-02-11;795;685;16067;3835;2.4;0.6
01;2021-02-12;639;481;16706;4316;2.5;0.7
01;2021-02-13;161;99;16867;4415;2.6;0.7
01;2021-02-14;0;9;16867;4424;2.6;0.7
01;2021-02-15;437;377;17304;4801;2.6;0.7
01;2021-02-16;658;340;17962;5141;2.7;0.8
01;2021-02-17;523;228;18485;5369;2.8;0.8
01;2021-02-18;591;498;19076;5867;2.9;0.9
01;2021-02-19;580;203;19656;6070;3.0;0.9
01;2021-02-20;201;124;19857;6194;3.0;0.9
01;2021-02-21;1;1;19858;6195;3.0;0.9
01;2021-02-22;429;448;20287;6643;3.1;1.0
01;2021-02-23;483;421;20770;7064;3.2;1.1
01;2021-02-24;434;367;21204;7431;3.2;1.1
01;2021-02-25;827;514;22031;7945;3.4;1.2
01;2021-02-26;874;435;22905;8380;3.5;1.3
01;2021-02-27;480;102;23385;8482;3.6;1.3
01;2021-02-28;20;3;23405;8485;3.6;1.3
01;2021-03-01;632;381;24037;8866;3.7;1.3
01;2021-03-02;964;479;25001;9345;3.8;1.4
01;2021-03-03;942;596;25943;9941;3.9;1.5
01;2021-03-04;1197;554;27140;10495;4.1;1.6
01;2021-03-05;1354;436;28494;10931;4.3;1.7
01;2021-03-06;781;91;29275;11022;4.5;1.7
01;2021-03-07;44;1;29319;11023;4.5;1.7
01;2021-03-08;669;571;29988;11594;4.6;1.8
01;2021-03-09;1340;537;31328;12131;4.8;1.8
01;2021-03-10;1162;537;32490;12668;4.9;1.9
01;2021-03-11;1686;604;34176;13272;5.2;2.0
01;2021-03-12;2003;605;36179;13877;5.5;2.1
01;2021-03-13;1502;95;37681;13972;5.7;2.1
01;2021-03-14;134;59;37815;14031;5.8;2.1
01;2021-03-15;1154;393;38969;14424;5.9;2.2
01;2021-03-16;1012;549;39981;14973;6.1;2.3
01;2021-03-17;839;336;40820;15309;6.2;2.3
01;2021-03-18;1295;463;42115;15772;6.4;2.4
01;2021-03-19;1750;529;43865;16301;6.7;2.5
01;2021-03-20;1447;133;45312;16434;6.9;2.5
01;2021-03-21;97;11;45409;16445;6.9;2.5
01;2021-03-22;1576;486;46985;16931;7.2;2.6
01;2021-03-23;2197;643;49182;17574;7.5;2.7
01;2021-03-24;1616;417;50798;17991;7.7;2.7
01;2021-03-25;2910;634;53708;18625;8.2;2.8
01;2021-03-26;2871;613;56579;19238;8.6;2.9
01;2021-03-27;1311;158;57890;19396;8.8;3.0
01;2021-03-28;22;1;57912;19397;8.8;3.0
01;2021-03-29;1929;537;59841;19934;9.1;3.0
01;2021-03-30;2514;767;62355;20701;9.5;3.2
01;2021-03-31;1869;622;64224;21323;9.8;3.2
01;2021-04-01;2569;851;66793;22174;10.2;3.4
01;2021-04-02;2818;724;69611;22898;10.6;3.5
01;2021-04-03;1256;135;70867;23033;10.8;3.5
01;2021-04-04;3;0;70870;23033;10.8;3.5
01;2021-04-05;1261;65;72131;23098;11.0;3.5
01;2021-04-06;2823;794;74954;23892;11.4;3.6
01;2021-04-07;2741;707;77695;24599;11.8;3.7
01;2021-04-08;3245;997;80940;25596;12.3;3.9
01;2021-04-09;3984;1332;84924;26928;12.9;4.1
01;2021-04-10;1823;301;86747;27229;13.2;4.1
01;2021-04-11;44;22;86791;27251;13.2;4.1
01;2021-04-12;2716;1223;89507;28474;13.6;4.3
01;2021-04-13;2944;1325;92451;29799;14.1;4.5
01;2021-04-14;3126;1082;95577;30881;14.5;4.7
01;2021-04-15;3075;1475;98652;32356;15.0;4.9
01;2021-04-16;2861;1577;101513;33933;15.5;5.2
01;2021-04-17;1654;682;103167;34615;15.7;5.3
01;2021-04-18;13;0;103180;34615;15.7;5.3
01;2021-04-19;2039;1521;105219;36136;16.0;5.5
01;2021-04-20;2667;1571;107886;37707;16.4;5.7
01;2021-04-21;2689;1349;110575;39056;16.8;5.9
01;2021-04-22;2835;1530;113410;40586;17.3;6.2
01;2021-04-23;2765;1532;116175;42118;17.7;6.4
01;2021-04-24;1448;653;117623;42771;17.9;6.5
01;2021-04-25;9;0;117632;42771;17.9;6.5
01;2021-04-26;1970;1730;119602;44501;18.2;6.8
01;2021-04-27;2572;1553;122174;46054;18.6;7.0
01;2021-04-28;2500;1568;124674;47622;19.0;7.2
01;2021-04-29;2716;1758;127390;49380;19.4;7.5
01;2021-04-30;2982;2242;130372;51622;19.8;7.9
01;2021-05-01;1473;856;131845;52478;20.1;8.0
01;2021-05-02;545;76;132390;52554;20.2;8.0
01;2021-05-03;2295;2477;134685;55031;20.5;8.4
01;2021-05-04;2539;2635;137224;57666;20.9;8.8
01;2021-05-05;2527;2496;139751;60162;21.3;9.2
01;2021-05-06;2994;2525;142745;62687;21.7;9.5
01;2021-05-07;3216;2774;145961;65461;22.2;10.0
01;2021-05-08;1646;922;147607;66383;22.5;10.1
01;2021-05-09;1022;162;148629;66545;22.6;10.1
01;2021-05-10;2499;3067;151128;69612;23.0;10.6
01;2021-05-11;3580;3055;154708;72667;23.5;11.1
01;2021-05-12;3652;3002;158360;75669;24.1;11.5
01;2021-05-13;4088;1503;162448;77172;24.7;11.7
01;2021-05-14;4271;2344;166719;79516;25.4;12.1
01;2021-05-15;3159;1435;169878;80951;25.9;12.3
01;2021-05-16;1413;150;171291;81101;26.1;12.3
01;2021-05-17;3445;2469;174736;83570;26.6;12.7
01;2021-05-18;4075;1959;178811;85529;27.2;13.0
01;2021-05-19;3974;1900;182785;87429;27.8;13.3
01;2021-05-20;4526;2010;187311;89439;28.5;13.6
01;2021-05-21;4621;2194;191932;91633;29.2;13.9
01;2021-05-22;3367;952;195299;92585;29.7;14.1
01;2021-05-23;834;83;196133;92668;29.9;14.1
01;2021-05-24;2764;500;198897;93168;30.3;14.2
01;2021-05-25;3559;2428;202456;95596;30.8;14.6
01;2021-05-26;3570;2248;206026;97844;31.4;14.9
01;2021-05-27;3853;2093;209879;99937;31.9;15.2
01;2021-05-28;3664;2631;213543;102568;32.5;15.6
01;2021-05-29;3054;1297;216597;103865;33.0;15.8
01;2021-05-30;613;88;217210;103953;33.1;15.8
01;2021-05-31;2406;2516;219616;106469;33.4;16.2
01;2021-06-01;2771;2583;222387;109052;33.9;16.6
01;2021-06-02;2882;2200;225269;111252;34.3;16.9
01;2021-06-03;3365;2439;228634;113691;34.8;17.3
01;2021-06-04;4500;3368;233134;117059;35.5;17.8
01;2021-06-05;3252;1733;236386;118792;36.0;18.1
01;2021-06-06;670;78;237056;118870;36.1;18.1
01;2021-06-07;3387;2875;240443;121745;36.6;18.5
01;2021-06-08;3649;2718;244092;124463;37.2;18.9
01;2021-06-09;2948;2634;247040;127097;37.6;19.3
01;2021-06-10;2767;2037;249807;129134;38.0;19.7
01;2021-06-11;3071;3364;252878;132498;38.5;20.2
01;2021-06-12;2401;2195;255279;134693;38.9;20.5
01;2021-06-13;201;479;255480;135172;38.9;20.6
01;2021-06-14;2119;3162;257599;138334;39.2;21.1
01;2021-06-15;2004;3367;259603;141701;39.5;21.6
01;2021-06-16;2176;3287;261779;144988;39.8;22.1
01;2021-06-17;1959;3172;263738;148160;40.1;22.6
01;2021-06-18;2634;4159;266372;152319;40.5;23.2
01;2021-06-19;1726;2555;268098;154874;40.8;23.6
01;2021-06-20;159;498;268257;155372;40.8;23.7
01;2021-06-21;1798;3703;270055;159075;41.1;24.2
01;2021-06-22;1551;4001;271606;163076;41.3;24.8
01;2021-06-23;1583;3754;273189;166830;41.6;25.4
01;2021-06-24;1471;3564;274660;170394;41.8;25.9
01;2021-06-25;1889;4564;276549;174958;42.1;26.6
01;2021-06-26;1209;2946;277758;177904;42.3;27.1
01;2021-06-27;171;339;277929;178243;42.3;27.1
01;2021-06-28;1382;4024;279311;182267;42.5;27.7
01;2021-06-29;1409;3849;280720;186116;42.7;28.3
01;2021-06-30;1381;4157;282101;190273;42.9;29.0
01;2021-07-01;1430;4086;283531;194359;43.2;29.6
01;2021-07-02;1587;4985;285118;199344;43.4;30.3
01;2021-07-03;858;3373;285976;202717;43.5;30.9
01;2021-07-04;105;499;286081;203216;43.5;30.9
01;2021-07-05;1486;4082;287567;207298;43.8;31.6
01;2021-07-06;1105;4275;288672;211573;43.9;32.2
01;2021-07-07;1757;3696;290429;215269;44.2;32.8
01;2021-07-08;1474;3676;291903;218945;44.4;33.3
01;2021-07-09;1885;4362;293788;223307;44.7;34.0
01;2021-07-10;1119;3438;294907;226745;44.9;34.5
01;2021-07-11;104;418;295011;227163;44.9;34.6
01;2021-07-12;1421;3843;296432;231006;45.1;35.2
01;2021-07-13;2058;4116;298490;235122;45.4;35.8
01;2021-07-14;148;179;298638;235301;45.5;35.8
01;2021-07-15;3104;4189;301742;239490;45.9;36.5
01;2021-07-16;3745;4838;305487;244328;46.5;37.2
01;2021-07-17;2202;3044;307689;247372;46.8;37.7
01;2021-07-18;290;551;307979;247923;46.9;37.7
01;2021-07-19;2915;3869;310894;251792;47.3;38.3
01;2021-07-20;3297;3691;314191;255483;47.8;38.9
01;2021-07-21;3935;3566;318126;259049;48.4;39.4
01;2021-07-22;4217;3493;322343;262542;49.1;40.0
01;2021-07-23;3940;4221;326283;266763;49.7;40.6
01;2021-07-24;2731;2712;329014;269475;50.1;41.0
01;2021-07-25;61;60;329075;269535;50.1;41.0
01;2021-07-26;3346;3236;332421;272771;50.6;41.5
01;2021-07-27;4102;2787;336523;275558;51.2;41.9
01;2021-07-28;3990;2651;340513;278209;51.8;42.3
01;2021-07-29;4695;2437;345208;280646;52.5;42.7
01;2021-07-30;4456;3429;349664;284075;53.2;43.2
01;2021-07-31;3641;1773;353305;285848;53.8;43.5
01;2021-08-01;397;75;353702;285923;53.8;43.5
01;2021-08-02;3079;2455;356781;288378;54.3;43.9
01;2021-08-03;3069;2453;359850;290831;54.8;44.3
01;2021-08-04;2542;1735;362392;292566;55.2;44.5
01;2021-08-05;2246;2363;364638;294929;55.5;44.9
01;2021-08-06;2748;3111;367386;298040;55.9;45.4
01;2021-08-07;2071;1837;369457;299877;56.2;45.6
01;2021-08-08;247;258;369704;300135;56.3;45.7
01;2021-08-09;1136;2633;370840;302768;56.4;46.1
01;2021-08-10;1445;2411;372285;305179;56.7;46.5
01;2021-08-11;1472;2596;373757;307775;56.9;46.8
01;2021-08-12;1626;2824;375383;310599;57.1;47.3
01;2021-08-13;1814;2728;377197;313327;57.4;47.7
01;2021-08-14;1392;2233;378589;315560;57.6;48.0
01;2021-08-15;18;21;378607;315581;57.6;48.0
01;2021-08-16;982;3011;379589;318592;57.8;48.5
01;2021-08-17;1354;2761;380943;321353;58.0;48.9
01;2021-08-18;1257;2906;382200;324259;58.2;49.4
01;2021-08-19;1300;2424;383500;326683;58.4;49.7
01;2021-08-20;1458;3951;384958;330634;58.6;50.3
01;2021-08-21;882;2848;385840;333482;58.7;50.8
01;2021-08-22;19;20;385859;333502;58.7;50.8
01;2021-08-23;1116;3018;386975;336520;58.9;51.2
01;2021-08-24;1228;3151;388203;339671;59.1;51.7
01;2021-08-25;1124;2992;389327;342663;59.3;52.2
01;2021-08-26;1647;2736;390974;345399;59.5;52.6
01;2021-08-27;1641;3652;392615;349051;59.8;53.1
01;2021-08-28;1043;2590;393658;351641;59.9;53.5
01;2021-08-29;16;31;393674;351672;59.9;53.5
01;2021-08-30;1187;2737;394861;354409;60.1;53.9
01;2021-08-31;1089;1945;395950;356354;60.3;54.2
01;2021-09-01;916;1871;396866;358225;60.4;54.5
01;2021-09-02;798;1759;397664;359984;60.5;54.8
01;2021-09-03;1130;2402;398794;362386;60.7;55.2
01;2021-09-04;795;2004;399589;364390;60.8;55.5
01;2021-09-05;97;82;399686;364472;60.8;55.5
01;2021-09-06;650;1399;400336;365871;60.9;55.7
01;2021-09-07;576;1202;400912;367073;61.0;55.9
01;2021-09-08;814;1582;401726;368655;61.1;56.1
01;2021-09-09;740;1279;402466;369934;61.3;56.3
01;2021-09-10;1038;1820;403504;371754;61.4;56.6
01;2021-09-11;734;1497;404238;373251;61.5;56.8
01;2021-09-12;23;41;404261;373292;61.5;56.8
01;2021-09-13;573;1343;404834;374635;61.6;57.0
01;2021-09-14;617;1412;405451;376047;61.7;57.2
01;2021-09-15;719;1443;406170;377490;61.8;57.5
01;2021-09-16;488;920;406658;378410;61.9;57.6
01;2021-09-17;755;1388;407413;379798;62.0;57.8
01;2021-09-18;376;1205;407789;381003;62.1;58.0
01;2021-09-19;7;10;407796;381013;62.1;58.0
01;2021-09-20;370;631;408166;381644;62.1;58.1
01;2021-09-21;384;701;408550;382345;62.2;58.2
01;2021-09-22;347;899;408897;383244;62.2;58.3
01;2021-09-23;295;658;409192;383902;62.3;58.4
01;2021-09-24;401;942;409593;384844;62.3;58.6
01;2021-09-25;307;955;409900;385799;62.4;58.7
01;2021-09-26;2;24;409902;385823;62.4;58.7
01;2021-09-27;174;556;410076;386379;62.4;58.8
01;2021-09-28;308;1193;410384;387572;62.5;59.0
01;2021-09-29;463;1278;410847;388850;62.5;59.2
02;2020-12-27;0;0;0;0;0.0;0.0
02;2020-12-28;0;0;0;0;0.0;0.0
02;2020-12-29;0;0;0;0;0.0;0.0
02;2020-12-30;0;0;0;0;0.0;0.0
02;2020-12-31;0;0;0;0;0.0;0.0
02;2021-01-01;0;0;0;0;0.0;0.0
02;2021-01-02;0;0;0;0;0.0;0.0
02;2021-01-03;0;0;0;0;0.0;0.0
02;2021-01-04;0;0;0;0;0.0;0.0
02;2021-01-05;0;0;0;0;0.0;0.0
02;2021-01-06;22;0;22;0;0.0;0.0
02;2021-01-07;261;1;283;1;0.1;0.0
02;2021-01-08;489;3;772;4;0.1;0.0
02;2021-01-09;74;0;846;4;0.2;0.0
02;2021-01-10;49;0;895;4;0.2;0.0
02;2021-01-11;267;0;1162;4;0.2;0.0
02;2021-01-12;354;1;1516;5;0.3;0.0
02;2021-01-13;468;4;1984;9;0.4;0.0
02;2021-01-14;652;11;2636;20;0.5;0.0
02;2021-01-15;630;6;3266;26;0.6;0.0
02;2021-01-16;333;4;3599;30;0.7;0.0
02;2021-01-17;62;0;3661;30;0.7;0.0
02;2021-01-18;811;8;4472;38;0.9;0.0
02;2021-01-19;941;6;5413;44;1.0;0.0
02;2021-01-20;1431;5;6844;49;1.3;0.0
02;2021-01-21;2604;5;9448;54;1.8;0.0
02;2021-01-22;1420;5;10868;59;2.1;0.0
02;2021-01-23;290;1;11158;60;2.1;0.0
02;2021-01-24;67;0;11225;60;2.1;0.0
02;2021-01-25;432;8;11657;68;2.2;0.0
02;2021-01-26;704;15;12361;83;2.3;0.0
02;2021-01-27;162;2;12523;85;2.4;0.0
02;2021-01-28;69;226;12592;311;2.4;0.1
02;2021-01-29;119;376;12711;687;2.4;0.1
02;2021-01-30;4;13;12715;700;2.4;0.1
02;2021-01-31;0;10;12715;710;2.4;0.1
02;2021-02-01;11;202;12726;912;2.4;0.2
02;2021-02-02;45;314;12771;1226;2.4;0.2
02;2021-02-03;124;307;12895;1533;2.5;0.3
02;2021-02-04;226;325;13121;1858;2.5;0.4
02;2021-02-05;178;371;13299;2229;2.5;0.4
02;2021-02-06;69;149;13368;2378;2.5;0.5
02;2021-02-07;9;0;13377;2378;2.5;0.5
02;2021-02-08;306;398;13683;2776;2.6;0.5
02;2021-02-09;322;607;14005;3383;2.7;0.6
02;2021-02-10;485;939;14490;4322;2.8;0.8
02;2021-02-11;936;1727;15426;6049;2.9;1.1
02;2021-02-12;885;1017;16311;7066;3.1;1.3
02;2021-02-13;290;111;16601;7177;3.2;1.4
02;2021-02-14;1;5;16602;7182;3.2;1.4
02;2021-02-15;344;518;16946;7700;3.2;1.5
02;2021-02-16;414;425;17360;8125;3.3;1.5
02;2021-02-17;499;490;17859;8615;3.4;1.6
02;2021-02-18;507;356;18366;8971;3.5;1.7
02;2021-02-19;444;465;18810;9436;3.6;1.8
02;2021-02-20;372;194;19182;9630;3.6;1.8
02;2021-02-21;39;17;19221;9647;3.7;1.8
02;2021-02-22;377;255;19598;9902;3.7;1.9
02;2021-02-23;432;296;20030;10198;3.8;1.9
02;2021-02-24;600;126;20630;10324;3.9;2.0
02;2021-02-25;870;122;21500;10446;4.1;2.0
02;2021-02-26;808;72;22308;10518;4.2;2.0
02;2021-02-27;444;14;22752;10532;4.3;2.0
02;2021-02-28;55;2;22807;10534;4.3;2.0
02;2021-03-01;638;23;23445;10557;4.5;2.0
02;2021-03-02;1031;122;24476;10679;4.7;2.0
02;2021-03-03;754;198;25230;10877;4.8;2.1
02;2021-03-04;1161;608;26391;11485;5.0;2.2
02;2021-03-05;1048;494;27439;11979;5.2;2.3
02;2021-03-06;2141;95;29580;12074;5.6;2.3
02;2021-03-07;1505;51;31085;12125;5.9;2.3
02;2021-03-08;574;337;31659;12462;6.0;2.4
02;2021-03-09;997;374;32656;12836;6.2;2.4
02;2021-03-10;895;434;33551;13270;6.4;2.5
02;2021-03-11;1294;380;34845;13650;6.6;2.6
02;2021-03-12;1706;387;36551;14037;6.9;2.7
02;2021-03-13;2592;243;39143;14280;7.4;2.7
02;2021-03-14;1458;44;40601;14324;7.7;2.7
02;2021-03-15;612;442;41213;14766;7.8;2.8
02;2021-03-16;862;399;42075;15165;8.0;2.9
02;2021-03-17;759;436;42834;15601;8.1;3.0
02;2021-03-18;608;608;43442;16209;8.3;3.1
02;2021-03-19;1171;294;44613;16503;8.5;3.1
02;2021-03-20;2429;157;47042;16660;8.9;3.2
02;2021-03-21;1488;84;48530;16744;9.2;3.2
02;2021-03-22;762;486;49292;17230;9.4;3.3
02;2021-03-23;1195;541;50487;17771;9.6;3.4
02;2021-03-24;1582;499;52069;18270;9.9;3.5
02;2021-03-25;1693;591;53762;18861;10.2;3.6
02;2021-03-26;2412;491;56174;19352;10.7;3.7
02;2021-03-27;2494;141;58668;19493;11.2;3.7
02;2021-03-28;638;14;59306;19507;11.3;3.7
02;2021-03-29;1038;850;60344;20357;11.5;3.9
02;2021-03-30;1553;840;61897;21197;11.8;4.0
02;2021-03-31;1298;712;63195;21909;12.0;4.2
02;2021-04-01;1290;861;64485;22770;12.3;4.3
02;2021-04-02;1183;1222;65668;23992;12.5;4.6
02;2021-04-03;2644;848;68312;24840;13.0;4.7
02;2021-04-04;727;240;69039;25080;13.1;4.8
02;2021-04-05;1509;134;70548;25214;13.4;4.8
02;2021-04-06;1539;852;72087;26066;13.7;5.0
02;2021-04-07;1872;777;73959;26843;14.1;5.1
02;2021-04-08;1919;1104;75878;27947;14.4;5.3
02;2021-04-09;2432;1093;78310;29040;14.9;5.5
02;2021-04-10;2430;1211;80740;30251;15.3;5.8
02;2021-04-11;476;416;81216;30667;15.4;5.8
02;2021-04-12;1823;619;83039;31286;15.8;5.9
02;2021-04-13;1601;923;84640;32209;16.1;6.1
02;2021-04-14;2583;977;87223;33186;16.6;6.3
02;2021-04-15;2494;777;89717;33963;17.1;6.5
02;2021-04-16;2439;1131;92156;35094;17.5;6.7
02;2021-04-17;1890;2141;94046;37235;17.9;7.1
02;2021-04-18;270;811;94316;38046;17.9;7.2
02;2021-04-19;1158;632;95474;38678;18.1;7.4
02;2021-04-20;1674;765;97148;39443;18.5;7.5
02;2021-04-21;1550;994;98698;40437;18.8;7.7
02;2021-04-22;1748;705;100446;41142;19.1;7.8
02;2021-04-23;1930;1408;102376;42550;19.5;8.1
02;2021-04-24;1714;1638;104090;44188;19.8;8.4
02;2021-04-25;462;235;104552;44423;19.9;8.4
02;2021-04-26;1339;562;105891;44985;20.1;8.6
02;2021-04-27;1627;1092;107518;46077;20.4;8.8
02;2021-04-28;1592;1429;109110;47506;20.7;9.0
02;2021-04-29;1888;1169;110998;48675;21.1;9.3
02;2021-04-30;2716;1651;113714;50326;21.6;9.6
02;2021-05-01;1991;1228;115705;51554;22.0;9.8
02;2021-05-02;1982;422;117687;51976;22.4;9.9
02;2021-05-03;2224;981;119911;52957;22.8;10.1
02;2021-05-04;1522;1306;121433;54263;23.1;10.3
02;2021-05-05;2327;1842;123760;56105;23.5;10.7
02;2021-05-06;2122;1737;125882;57842;23.9;11.0
02;2021-05-07;2358;2171;128240;60013;24.4;11.4
02;2021-05-08;2917;950;131157;60963;24.9;11.6
02;2021-05-09;1823;423;132980;61386;25.3;11.7
02;2021-05-10;2375;1481;135355;62867;25.7;12.0
02;2021-05-11;2877;1569;138232;64436;26.3;12.2
02;2021-05-12;2675;1607;140907;66043;26.8;12.6
02;2021-05-13;2990;1039;143897;67082;27.4;12.8
02;2021-05-14;3381;1198;147278;68280;28.0;13.0
02;2021-05-15;4374;1082;151652;69362;28.8;13.2
02;2021-05-16;2795;212;154447;69574;29.4;13.2
02;2021-05-17;2147;664;156594;70238;29.8;13.4
02;2021-05-18;2634;971;159228;71209;30.3;13.5
02;2021-05-19;2852;999;162080;72208;30.8;13.7
02;2021-05-20;3553;1230;165633;73438;31.5;14.0
02;2021-05-21;3818;1066;169451;74504;32.2;14.2
02;2021-05-22;5845;969;175296;75473;33.3;14.3
02;2021-05-23;2658;240;177954;75713;33.8;14.4
02;2021-05-24;3541;544;181495;76257;34.5;14.5
02;2021-05-25;2258;1164;183753;77421;34.9;14.7
02;2021-05-26;3079;1498;186832;78919;35.5;15.0
02;2021-05-27;3649;1487;190481;80406;36.2;15.3
02;2021-05-28;3515;1576;193996;81982;36.9;15.6
02;2021-05-29;4079;1561;198075;83543;37.7;15.9
02;2021-05-30;1449;177;199524;83720;37.9;15.9
02;2021-05-31;2575;1187;202099;84907;38.4;16.1
02;2021-06-01;2870;1868;204969;86775;39.0;16.5
02;2021-06-02;3159;1652;208128;88427;39.6;16.8
02;2021-06-03;2854;1835;210982;90262;40.1;17.2
02;2021-06-04;3142;2054;214124;92316;40.7;17.5
02;2021-06-05;3441;1733;217565;94049;41.4;17.9
02;2021-06-06;1736;259;219301;94308;41.7;17.9
02;2021-06-07;1613;1499;220914;95807;42.0;18.2
02;2021-06-08;2061;1839;222975;97646;42.4;18.6
02;2021-06-09;2057;1646;225032;99292;42.8;18.9
02;2021-06-10;2010;1841;227042;101133;43.2;19.2
02;2021-06-11;2193;3073;229235;104206;43.6;19.8
02;2021-06-12;2311;2592;231546;106798;44.0;20.3
02;2021-06-13;683;1387;232229;108185;44.1;20.6
02;2021-06-14;1049;2392;233278;110577;44.3;21.0
02;2021-06-15;1518;2458;234796;113035;44.6;21.5
02;2021-06-16;1534;2749;236330;115784;44.9;22.0
02;2021-06-17;1782;2854;238112;118638;45.3;22.6
02;2021-06-18;2312;3570;240424;122208;45.7;23.2
02;2021-06-19;1841;3820;242265;126028;46.1;24.0
02;2021-06-20;644;1522;242909;127550;46.2;24.2
02;2021-06-21;806;3190;243715;130740;46.3;24.9
02;2021-06-22;1155;3667;244870;134407;46.5;25.6
02;2021-06-23;1226;3586;246096;137993;46.8;26.2
02;2021-06-24;1327;3149;247423;141142;47.0;26.8
02;2021-06-25;1399;4545;248822;145687;47.3;27.7
02;2021-06-26;1345;4228;250167;149915;47.6;28.5
02;2021-06-27;600;2333;250767;152248;47.7;28.9
02;2021-06-28;877;3021;251644;155269;47.8;29.5
02;2021-06-29;919;2929;252563;158198;48.0;30.1
02;2021-06-30;1509;3161;254072;161359;48.3;30.7
02;2021-07-01;1193;3591;255265;164950;48.5;31.4
02;2021-07-02;1359;5132;256624;170082;48.8;32.3
02;2021-07-03;999;5988;257623;176070;49.0;33.5
02;2021-07-04;509;2370;258132;178440;49.1;33.9
02;2021-07-05;661;3935;258793;182375;49.2;34.7
02;2021-07-06;675;3045;259468;185420;49.3;35.2
02;2021-07-07;1322;3726;260790;189146;49.6;36.0
02;2021-07-08;1393;3869;262183;193015;49.8;36.7
02;2021-07-09;1283;4215;263466;197230;50.1;37.5
02;2021-07-10;1332;4604;264798;201834;50.3;38.4
02;2021-07-11;480;1967;265278;203801;50.4;38.7
02;2021-07-12;1415;3726;266693;207527;50.7;39.5
02;2021-07-13;2065;3662;268758;211189;51.1;40.1
02;2021-07-14;1753;1599;270511;212788;51.4;40.5
02;2021-07-15;2727;3557;273238;216345;51.9;41.1
02;2021-07-16;3164;4217;276402;220562;52.5;41.9
02;2021-07-17;3561;4230;279963;224792;53.2;42.7
02;2021-07-18;2037;1615;282000;226407;53.6;43.0
02;2021-07-19;3440;3033;285440;229440;54.3;43.6
02;2021-07-20;3501;3303;288941;232743;54.9;44.2
02;2021-07-21;3910;2952;292851;235695;55.7;44.8
02;2021-07-22;3324;2801;296175;238496;56.3;45.3
02;2021-07-23;3205;3554;299380;242050;56.9;46.0
02;2021-07-24;4447;3724;303827;245774;57.8;46.7
02;2021-07-25;2191;1089;306018;246863;58.2;46.9
02;2021-07-26;3874;2252;309892;249115;58.9;47.4
02;2021-07-27;3660;2147;313552;251262;59.6;47.8
02;2021-07-28;3279;2096;316831;253358;60.2;48.2
02;2021-07-29;2583;2224;319414;255582;60.7;48.6
02;2021-07-30;3313;2306;322727;257888;61.3;49.0
02;2021-07-31;4183;2280;326910;260168;62.1;49.5
02;2021-08-01;1475;692;328385;260860;62.4;49.6
02;2021-08-02;2042;1601;330427;262461;62.8;49.9
02;2021-08-03;2530;1897;332957;264358;63.3;50.3
02;2021-08-04;2574;1710;335531;266068;63.8;50.6
02;2021-08-05;1849;2264;337380;268332;64.1;51.0
02;2021-08-06;2101;2741;339481;271073;64.5;51.5
02;2021-08-07;2522;2785;342003;273858;65.0;52.1
02;2021-08-08;1026;1572;343029;275430;65.2;52.4
02;2021-08-09;1909;2750;344938;278180;65.6;52.9
02;2021-08-10;1765;2461;346703;280641;65.9;53.3
02;2021-08-11;1481;2109;348184;282750;66.2;53.7
02;2021-08-12;1205;2332;349389;285082;66.4;54.2
02;2021-08-13;1611;2908;351000;287990;66.7;54.7
02;2021-08-14;1666;3696;352666;291686;67.0;55.4
02;2021-08-15;161;572;352827;292258;67.1;55.6
02;2021-08-16;1282;3755;354109;296013;67.3;56.3
02;2021-08-17;1421;2840;355530;298853;67.6;56.8
02;2021-08-18;1578;3182;357108;302035;67.9;57.4
02;2021-08-19;1134;3218;358242;305253;68.1;58.0
02;2021-08-20;1205;2950;359447;308203;68.3;58.6
02;2021-08-21;1449;4082;360896;312285;68.6;59.4
02;2021-08-22;407;1656;361303;313941;68.7;59.7
02;2021-08-23;1155;3079;362458;317020;68.9;60.3
02;2021-08-24;907;2184;363365;319204;69.1;60.7
02;2021-08-25;1022;2596;364387;321800;69.3;61.2
02;2021-08-26;913;2333;365300;324133;69.4;61.6
02;2021-08-27;965;2615;366265;326748;69.6;62.1
02;2021-08-28;1301;3428;367566;330176;69.9;62.8
02;2021-08-29;328;1170;367894;331346;69.9;63.0
02;2021-08-30;996;2471;368890;333817;70.1;63.5
02;2021-08-31;865;2259;369755;336076;70.3;63.9
02;2021-09-01;700;1551;370455;337627;70.4;64.2
02;2021-09-02;648;1725;371103;339352;70.5;64.5
02;2021-09-03;695;1946;371798;341298;70.7;64.9
02;2021-09-04;852;2836;372650;344134;70.8;65.4
02;2021-09-05;226;520;372876;344654;70.9;65.5
02;2021-09-06;404;1036;373280;345690;71.0;65.7
02;2021-09-07;453;1404;373733;347094;71.0;66.0
02;2021-09-08;515;1871;374248;348965;71.1;66.3
02;2021-09-09;439;1328;374687;350293;71.2;66.6
02;2021-09-10;563;1550;375250;351843;71.3;66.9
02;2021-09-11;719;2275;375969;354118;71.5;67.3
02;2021-09-12;91;286;376060;354404;71.5;67.4
02;2021-09-13;423;1208;376483;355612;71.6;67.6
02;2021-09-14;412;1169;376895;356781;71.6;67.8
02;2021-09-15;446;1306;377341;358087;71.7;68.1
02;2021-09-16;454;833;377795;358920;71.8;68.2
02;2021-09-17;581;931;378376;359851;71.9;68.4
02;2021-09-18;564;2029;378940;361880;72.0;68.8
02;2021-09-19;78;259;379018;362139;72.0;68.8
02;2021-09-20;296;651;379314;362790;72.1;69.0
02;2021-09-21;277;623;379591;363413;72.2;69.1
02;2021-09-22;360;904;379951;364317;72.2;69.3
02;2021-09-23;259;561;380210;364878;72.3;69.4
02;2021-09-24;296;762;380506;365640;72.3;69.5
02;2021-09-25;316;1206;380822;366846;72.4;69.7
02;2021-09-26;33;158;380855;367004;72.4;69.8
02;2021-09-27;138;367;380993;367371;72.4;69.8
02;2021-09-28;156;392;381149;367763;72.5;69.9
02;2021-09-29;228;417;381377;368180;72.5;70.0
03;2020-12-27;0;0;0;0;0.0;0.0
03;2020-12-28;1;0;1;0;0.0;0.0
03;2020-12-29;0;0;1;0;0.0;0.0
03;2020-12-30;1;0;2;0;0.0;0.0
03;2020-12-31;0;0;2;0;0.0;0.0
03;2021-01-01;0;0;2;0;0.0;0.0
03;2021-01-02;0;0;2;0;0.0;0.0
03;2021-01-03;0;0;2;0;0.0;0.0
03;2021-01-04;0;0;2;0;0.0;0.0
03;2021-01-05;0;0;2;0;0.0;0.0
03;2021-01-06;10;0;12;0;0.0;0.0
03;2021-01-07;61;0;73;0;0.0;0.0
03;2021-01-08;146;1;219;1;0.1;0.0
03;2021-01-09;122;0;341;1;0.1;0.0
03;2021-01-10;6;0;347;1;0.1;0.0
03;2021-01-11;412;1;759;2;0.2;0.0
03;2021-01-12;631;0;1390;2;0.4;0.0
03;2021-01-13;669;2;2059;4;0.6;0.0
03;2021-01-14;861;4;2920;8;0.9;0.0
03;2021-01-15;387;2;3307;10;1.0;0.0
03;2021-01-16;278;0;3585;10;1.1;0.0
03;2021-01-17;42;0;3627;10;1.1;0.0
03;2021-01-18;878;0;4505;10;1.4;0.0
03;2021-01-19;1151;2;5656;12;1.7;0.0
03;2021-01-20;1292;3;6948;15;2.1;0.0
03;2021-01-21;1200;5;8148;20;2.5;0.0
03;2021-01-22;1117;4;9265;24;2.8;0.0
03;2021-01-23;465;0;9730;24;2.9;0.0
03;2021-01-24;0;0;9730;24;2.9;0.0
03;2021-01-25;187;0;9917;24;3.0;0.0
03;2021-01-26;680;7;10597;31;3.2;0.0
03;2021-01-27;696;10;11293;41;3.4;0.0
03;2021-01-28;1020;40;12313;81;3.7;0.0
03;2021-01-29;856;77;13169;158;4.0;0.0
03;2021-01-30;600;1;13769;159;4.2;0.0
03;2021-01-31;0;0;13769;159;4.2;0.0
03;2021-02-01;160;67;13929;226;4.2;0.1
03;2021-02-02;767;226;14696;452;4.4;0.1
03;2021-02-03;1056;422;15752;874;4.8;0.3
03;2021-02-04;1557;596;17309;1470;5.2;0.4
03;2021-02-05;948;297;18257;1767;5.5;0.5
03;2021-02-06;152;13;18409;1780;5.6;0.5
03;2021-02-07;5;0;18414;1780;5.6;0.5
03;2021-02-08;128;51;18542;1831;5.6;0.6
03;2021-02-09;612;420;19154;2251;5.8;0.7
03;2021-02-10;485;331;19639;2582;5.9;0.8
03;2021-02-11;1026;555;20665;3137;6.2;0.9
03;2021-02-12;1078;511;21743;3648;6.6;1.1
03;2021-02-13;126;151;21869;3799;6.6;1.1
03;2021-02-14;0;1;21869;3800;6.6;1.1
03;2021-02-15;309;606;22178;4406;6.7;1.3
03;2021-02-16;548;914;22726;5320;6.9;1.6
03;2021-02-17;452;1057;23178;6377;7.0;1.9
03;2021-02-18;368;1003;23546;7380;7.1;2.2
03;2021-02-19;497;658;24043;8038;7.3;2.4
03;2021-02-20;128;143;24171;8181;7.3;2.5
03;2021-02-21;2;1;24173;8182;7.3;2.5
03;2021-02-22;158;160;24331;8342;7.3;2.5
03;2021-02-23;720;767;25051;9109;7.6;2.7
03;2021-02-24;610;867;25661;9976;7.7;3.0
03;2021-02-25;1093;1560;26754;11536;8.1;3.5
03;2021-02-26;822;1215;27576;12751;8.3;3.8
03;2021-02-27;96;212;27672;12963;8.4;3.9
03;2021-02-28;0;14;27672;12977;8.4;3.9
03;2021-03-01;178;217;27850;13194;8.4;4.0
03;2021-03-02;818;586;28668;13780;8.7;4.2
03;2021-03-03;904;395;29572;14175;8.9;4.3
03;2021-03-04;1541;533;31113;14708;9.4;4.4
03;2021-03-05;1121;656;32234;15364;9.7;4.6
03;2021-03-06;915;107;33149;15471;10.0;4.7
03;2021-03-07;2;0;33151;15471;10.0;4.7
03;2021-03-08;239;232;33390;15703;10.1;4.7
03;2021-03-09;1016;419;34406;16122;10.4;4.9
03;2021-03-10;941;506;35347;16628;10.7;5.0
03;2021-03-11;1676;619;37023;17247;11.2;5.2
03;2021-03-12;1303;798;38326;18045;11.6;5.4
03;2021-03-13;864;113;39190;18158;11.8;5.5
03;2021-03-14;2;5;39192;18163;11.8;5.5
03;2021-03-15;250;194;39442;18357;11.9;5.5
03;2021-03-16;650;396;40092;18753;12.1;5.7
03;2021-03-17;1304;429;41396;19182;12.5;5.8
03;2021-03-18;1720;393;43116;19575;13.0;5.9
03;2021-03-19;1728;361;44844;19936;13.5;6.0
03;2021-03-20;301;27;45145;19963;13.6;6.0
03;2021-03-21;1;0;45146;19963;13.6;6.0
03;2021-03-22;222;387;45368;20350;13.7;6.1
03;2021-03-23;1355;351;46723;20701;14.1;6.2
03;2021-03-24;1824;349;48547;21050;14.7;6.4
03;2021-03-25;2368;565;50915;21615;15.4;6.5
03;2021-03-26;2240;444;53155;22059;16.0;6.7
03;2021-03-27;817;21;53972;22080;16.3;6.7
03;2021-03-28;1;39;53973;22119;16.3;6.7
03;2021-03-29;659;175;54632;22294;16.5;6.7
03;2021-03-30;1908;450;56540;22744;17.1;6.9
03;2021-03-31;1014;982;57554;23726;17.4;7.2
03;2021-04-01;1375;1093;58929;24819;17.8;7.5
03;2021-04-02;1705;614;60634;25433;18.3;7.7
03;2021-04-03;365;99;60999;25532;18.4;7.7
03;2021-04-04;3;0;61002;25532;18.4;7.7
03;2021-04-05;18;14;61020;25546;18.4;7.7
03;2021-04-06;1073;410;62093;25956;18.7;7.8
03;2021-04-07;1562;523;63655;26479;19.2;8.0
03;2021-04-08;2121;485;65776;26964;19.9;8.1
03;2021-04-09;2056;1160;67832;28124;20.5;8.5
03;2021-04-10;1013;73;68845;28197;20.8;8.5
03;2021-04-11;478;9;69323;28206;20.9;8.5
03;2021-04-12;986;227;70309;28433;21.2;8.6
03;2021-04-13;1873;986;72182;29419;21.8;8.9
03;2021-04-14;2334;1222;74516;30641;22.5;9.2
03;2021-04-15;2621;1400;77137;32041;23.3;9.7
03;2021-04-16;2835;1184;79972;33225;24.1;10.0
03;2021-04-17;1083;441;81055;33666;24.5;10.2
03;2021-04-18;0;0;81055;33666;24.5;10.2
03;2021-04-19;1191;586;82246;34252;24.8;10.3
03;2021-04-20;1748;1274;83994;35526;25.4;10.7
03;2021-04-21;1122;1293;85116;36819;25.7;11.1
03;2021-04-22;1675;1000;86791;37819;26.2;11.4
03;2021-04-23;2478;1272;89269;39091;26.9;11.8
03;2021-04-24;1301;922;90570;40013;27.3;12.1
03;2021-04-25;350;16;90920;40029;27.4;12.1
03;2021-04-26;1332;466;92252;40495;27.8;12.2
03;2021-04-27;1766;1522;94018;42017;28.4;12.7
03;2021-04-28;1930;1119;95948;43136;29.0;13.0
03;2021-04-29;2370;1238;98318;44374;29.7;13.4
03;2021-04-30;1931;807;100249;45181;30.3;13.6
03;2021-05-01;438;493;100687;45674;30.4;13.8
03;2021-05-02;2;1;100689;45675;30.4;13.8
03;2021-05-03;1912;773;102601;46448;31.0;14.0
03;2021-05-04;2845;1634;105446;48082;31.8;14.5
03;2021-05-05;2604;1332;108050;49414;32.6;14.9
03;2021-05-06;3095;2007;111145;51421;33.5;15.5
03;2021-05-07;4729;1791;115874;53212;35.0;16.1
03;2021-05-08;661;381;116535;53593;35.2;16.2
03;2021-05-09;49;511;116584;54104;35.2;16.3
03;2021-05-10;1892;1480;118476;55584;35.8;16.8
03;2021-05-11;3899;1837;122375;57421;36.9;17.3
03;2021-05-12;2972;1521;125347;58942;37.8;17.8
03;2021-05-13;4384;410;129731;59352;39.2;17.9
03;2021-05-14;3655;1698;133386;61050;40.3;18.4
03;2021-05-15;1943;490;135329;61540;40.8;18.6
03;2021-05-16;522;57;135851;61597;41.0;18.6
03;2021-05-17;1277;862;137128;62459;41.4;18.9
03;2021-05-18;3068;1505;140196;63964;42.3;19.3
03;2021-05-19;2623;967;142819;64931;43.1;19.6
03;2021-05-20;3334;1143;146153;66074;44.1;19.9
03;2021-05-21;4194;1281;150347;67355;45.4;20.3
03;2021-05-22;2012;359;152359;67714;46.0;20.4
03;2021-05-23;641;73;153000;67787;46.2;20.5
03;2021-05-24;2654;216;155654;68003;47.0;20.5
03;2021-05-25;3068;1689;158722;69692;47.9;21.0
03;2021-05-26;2336;1041;161058;70733;48.6;21.3
03;2021-05-27;2945;1126;164003;71859;49.5;21.7
03;2021-05-28;3848;2280;167851;74139;50.7;22.4
03;2021-05-29;1748;603;169599;74742;51.2;22.6
03;2021-05-30;242;23;169841;74765;51.3;22.6
03;2021-05-31;697;570;170538;75335;51.5;22.7
03;2021-06-01;2302;2346;172840;77681;52.2;23.4
03;2021-06-02;1534;1748;174374;79429;52.6;24.0
03;2021-06-03;2060;2753;176434;82182;53.3;24.8
03;2021-06-04;1698;2508;178132;84690;53.8;25.6
03;2021-06-05;1076;1143;179208;85833;54.1;25.9
03;2021-06-06;59;7;179267;85840;54.1;25.9
03;2021-06-07;785;1815;180052;87655;54.3;26.5
03;2021-06-08;1458;2557;181510;90212;54.8;27.2
03;2021-06-09;1267;1877;182777;92089;55.2;27.8
03;2021-06-10;1381;2124;184158;94213;55.6;28.4
03;2021-06-11;1503;3450;185661;97663;56.0;29.5
03;2021-06-12;831;823;186492;98486;56.3;29.7
03;2021-06-13;20;10;186512;98496;56.3;29.7
03;2021-06-14;381;2175;186893;100671;56.4;30.4
03;2021-06-15;1317;3835;188210;104506;56.8;31.5
03;2021-06-16;788;2890;188998;107396;57.0;32.4
03;2021-06-17;1083;3333;190081;110729;57.4;33.4
03;2021-06-18;1107;3979;191188;114708;57.7;34.6
03;2021-06-19;641;1618;191829;116326;57.9;35.1
03;2021-06-20;20;8;191849;116334;57.9;35.1
03;2021-06-21;461;2636;192310;118970;58.0;35.9
03;2021-06-22;1027;4003;193337;122973;58.4;37.1
03;2021-06-23;716;3285;194053;126258;58.6;38.1
03;2021-06-24;982;3862;195035;130120;58.9;39.3
03;2021-06-25;1016;3892;196051;134012;59.2;40.4
03;2021-06-26;513;2040;196564;136052;59.3;41.1
03;2021-06-27;65;486;196629;136538;59.3;41.2
03;2021-06-28;642;2097;197271;138635;59.5;41.8
03;2021-06-29;1028;3330;198299;141965;59.9;42.8
03;2021-06-30;831;3120;199130;145085;60.1;43.8
03;2021-07-01;987;2936;200117;148021;60.4;44.7
03;2021-07-02;920;4094;201037;152115;60.7;45.9
03;2021-07-03;487;1884;201524;153999;60.8;46.5
03;2021-07-04;20;332;201544;154331;60.8;46.6
03;2021-07-05;817;2381;202361;156712;61.1;47.3
03;2021-07-06;1171;3462;203532;160174;61.4;48.3
03;2021-07-07;804;2617;204336;162791;61.7;49.1
03;2021-07-08;1060;3042;205396;165833;62.0;50.1
03;2021-07-09;1470;3626;206866;169459;62.4;51.1
03;2021-07-10;508;1925;207374;171384;62.6;51.7
03;2021-07-11;61;492;207435;171876;62.6;51.9
03;2021-07-12;939;1149;208374;173025;62.9;52.2
03;2021-07-13;2612;3152;210986;176177;63.7;53.2
03;2021-07-14;195;25;211181;176202;63.7;53.2
03;2021-07-15;2613;2454;213794;178656;64.5;53.9
03;2021-07-16;2737;2274;216531;180930;65.4;54.6
03;2021-07-17;1032;1626;217563;182556;65.7;55.1
03;2021-07-18;33;6;217596;182562;65.7;55.1
03;2021-07-19;2392;1276;219988;183838;66.4;55.5
03;2021-07-20;3074;3033;223062;186871;67.3;56.4
03;2021-07-21;3213;1438;226275;188309;68.3;56.8
03;2021-07-22;2851;1885;229126;190194;69.2;57.4
03;2021-07-23;3205;1307;232331;191501;70.1;57.8
03;2021-07-24;590;581;232921;192082;70.3;58.0
03;2021-07-25;18;5;232939;192087;70.3;58.0
03;2021-07-26;2044;1576;234983;193663;70.9;58.5
03;2021-07-27;3321;2230;238304;195893;71.9;59.1
03;2021-07-28;2718;1118;241022;197011;72.7;59.5
03;2021-07-29;2549;1662;243571;198673;73.5;60.0
03;2021-07-30;2136;1454;245707;200127;74.2;60.4
03;2021-07-31;964;893;246671;201020;74.5;60.7
03;2021-08-01;13;20;246684;201040;74.5;60.7
03;2021-08-02;1680;1605;248364;202645;75.0;61.2
03;2021-08-03;2223;2774;250587;205419;75.6;62.0
03;2021-08-04;2195;893;252782;206312;76.3;62.3
03;2021-08-05;1266;1939;254048;208251;76.7;62.9
03;2021-08-06;1281;1024;255329;209275;77.1;63.2
03;2021-08-07;614;496;255943;209771;77.3;63.3
03;2021-08-08;66;29;256009;209800;77.3;63.3
03;2021-08-09;597;1304;256606;211104;77.5;63.7
03;2021-08-10;1676;3471;258282;214575;78.0;64.8
03;2021-08-11;1335;2530;259617;217105;78.4;65.5
03;2021-08-12;1137;3514;260754;220619;78.7;66.6
03;2021-08-13;776;1052;261530;221671;78.9;66.9
03;2021-08-14;379;566;261909;222237;79.1;67.1
03;2021-08-15;9;61;261918;222298;79.1;67.1
03;2021-08-16;724;2693;262642;224991;79.3;67.9
03;2021-08-17;1076;3218;263718;228209;79.6;68.9
03;2021-08-18;1164;2156;264882;230365;79.9;69.5
03;2021-08-19;1010;3049;265892;233414;80.3;70.5
03;2021-08-20;718;1138;266610;234552;80.5;70.8
03;2021-08-21;418;727;267028;235279;80.6;71.0
03;2021-08-22;8;6;267036;235285;80.6;71.0
03;2021-08-23;784;2289;267820;237574;80.8;71.7
03;2021-08-24;893;2406;268713;239980;81.1;72.4
03;2021-08-25;934;2029;269647;242009;81.4;73.0
03;2021-08-26;574;1436;270221;243445;81.6;73.5
03;2021-08-27;457;1580;270678;245025;81.7;74.0
03;2021-08-28;219;674;270897;245699;81.8;74.2
03;2021-08-29;4;0;270901;245699;81.8;74.2
03;2021-08-30;768;1469;271669;247168;82.0;74.6
03;2021-08-31;706;2055;272375;249223;82.2;75.2
03;2021-09-01;604;1513;272979;250736;82.4;75.7
03;2021-09-02;477;1238;273456;251974;82.5;76.1
03;2021-09-03;492;1186;273948;253160;82.7;76.4
03;2021-09-04;251;630;274199;253790;82.8;76.6
03;2021-09-05;7;14;274206;253804;82.8;76.6
03;2021-09-06;320;1097;274526;254901;82.9;76.9
03;2021-09-07;576;1597;275102;256498;83.0;77.4
03;2021-09-08;424;1545;275526;258043;83.2;77.9
03;2021-09-09;273;948;275799;258991;83.2;78.2
03;2021-09-10;411;1245;276210;260236;83.4;78.5
03;2021-09-11;209;688;276419;260924;83.4;78.8
03;2021-09-12;2;20;276421;260944;83.4;78.8
03;2021-09-13;285;943;276706;261887;83.5;79.0
03;2021-09-14;440;1422;277146;263309;83.7;79.5
03;2021-09-15;356;996;277502;264305;83.8;79.8
03;2021-09-16;219;556;277721;264861;83.8;79.9
03;2021-09-17;158;356;277879;265217;83.9;80.0
03;2021-09-18;132;311;278011;265528;83.9;80.1
03;2021-09-19;0;11;278011;265539;83.9;80.1
03;2021-09-20;187;424;278198;265963;84.0;80.3
03;2021-09-21;248;721;278446;266684;84.0;80.5
03;2021-09-22;267;684;278713;267368;84.1;80.7
03;2021-09-23;177;461;278890;267829;84.2;80.8
03;2021-09-24;146;321;279036;268150;84.2;80.9
03;2021-09-25;51;257;279087;268407;84.2;81.0
03;2021-09-26;3;0;279090;268407;84.2;81.0
03;2021-09-27;116;326;279206;268733;84.3;81.1
03;2021-09-28;190;614;279396;269347;84.3;81.3
03;2021-09-29;212;505;279608;269852;84.4;81.4
04;2020-12-27;0;0;0;0;0.0;0.0
04;2020-12-28;1;0;1;0;0.0;0.0
04;2020-12-29;0;0;1;0;0.0;0.0
04;2020-12-30;0;0;1;0;0.0;0.0
04;2020-12-31;0;0;1;0;0.0;0.0
04;2021-01-01;0;0;1;0;0.0;0.0
04;2021-01-02;0;0;1;0;0.0;0.0
04;2021-01-03;0;0;1;0;0.0;0.0
04;2021-01-04;0;0;1;0;0.0;0.0
04;2021-01-05;4;0;5;0;0.0;0.0
04;2021-01-06;0;0;5;0;0.0;0.0
04;2021-01-07;61;0;66;0;0.0;0.0
04;2021-01-08;88;0;154;0;0.1;0.0
04;2021-01-09;57;0;211;0;0.1;0.0
04;2021-01-10;0;0;211;0;0.1;0.0
04;2021-01-11;77;0;288;0;0.2;0.0
04;2021-01-12;421;0;709;0;0.4;0.0
04;2021-01-13;244;2;953;2;0.6;0.0
04;2021-01-14;90;2;1043;4;0.6;0.0
04;2021-01-15;165;4;1208;8;0.7;0.0
04;2021-01-16;106;2;1314;10;0.8;0.0
04;2021-01-17;14;0;1328;10;0.8;0.0
04;2021-01-18;236;9;1564;19;0.9;0.0
04;2021-01-19;468;3;2032;22;1.2;0.0
04;2021-01-20;574;9;2606;31;1.6;0.0
04;2021-01-21;614;3;3220;34;1.9;0.0
04;2021-01-22;639;0;3859;34;2.3;0.0
04;2021-01-23;111;0;3970;34;2.4;0.0
04;2021-01-24;0;0;3970;34;2.4;0.0
04;2021-01-25;240;0;4210;34;2.5;0.0
04;2021-01-26;656;1;4866;35;2.9;0.0
04;2021-01-27;480;0;5346;35;3.2;0.0
04;2021-01-28;665;20;6011;55;3.6;0.0
04;2021-01-29;368;41;6379;96;3.9;0.1
04;2021-01-30;65;41;6444;137;3.9;0.1
04;2021-01-31;1;5;6445;142;3.9;0.1
04;2021-02-01;268;136;6713;278;4.1;0.2
04;2021-02-02;561;173;7274;451;4.4;0.3
04;2021-02-03;367;159;7641;610;4.6;0.4
04;2021-02-04;358;52;7999;662;4.8;0.4
04;2021-02-05;379;201;8378;863;5.1;0.5
04;2021-02-06;50;85;8428;948;5.1;0.6
04;2021-02-07;2;22;8430;970;5.1;0.6
04;2021-02-08;163;61;8593;1031;5.2;0.6
04;2021-02-09;196;112;8789;1143;5.3;0.7
04;2021-02-10;253;153;9042;1296;5.5;0.8
04;2021-02-11;364;244;9406;1540;5.7;0.9
04;2021-02-12;293;283;9699;1823;5.9;1.1
04;2021-02-13;27;86;9726;1909;5.9;1.2
04;2021-02-14;0;0;9726;1909;5.9;1.2
04;2021-02-15;31;135;9757;2044;5.9;1.2
04;2021-02-16;81;412;9838;2456;6.0;1.5
04;2021-02-17;67;365;9905;2821;6.0;1.7
04;2021-02-18;44;522;9949;3343;6.0;2.0
04;2021-02-19;53;306;10002;3649;6.1;2.2
04;2021-02-20;5;65;10007;3714;6.1;2.2
04;2021-02-21;0;0;10007;3714;6.1;2.2
04;2021-02-22;7;247;10014;3961;6.1;2.4
04;2021-02-23;19;500;10033;4461;6.1;2.7
04;2021-02-24;38;365;10071;4826;6.1;2.9
04;2021-02-25;73;323;10144;5149;6.1;3.1
04;2021-02-26;216;274;10360;5423;6.3;3.3
04;2021-02-27;179;66;10539;5489;6.4;3.3
04;2021-02-28;1;0;10540;5489;6.4;3.3
04;2021-03-01;18;64;10558;5553;6.4;3.4
04;2021-03-02;135;37;10693;5590;6.5;3.4
04;2021-03-03;375;557;11068;6147;6.7;3.7
04;2021-03-04;208;417;11276;6564;6.8;4.0
04;2021-03-05;236;318;11512;6882;7.0;4.2
04;2021-03-06;912;71;12424;6953;7.5;4.2
04;2021-03-07;498;25;12922;6978;7.8;4.2
04;2021-03-08;45;69;12967;7047;7.8;4.3
04;2021-03-09;215;229;13182;7276;8.0;4.4
04;2021-03-10;401;338;13583;7614;8.2;4.6
04;2021-03-11;495;314;14078;7928;8.5;4.8
04;2021-03-12;697;190;14775;8118;8.9;4.9
04;2021-03-13;1088;63;15863;8181;9.6;5.0
04;2021-03-14;460;3;16323;8184;9.9;5.0
04;2021-03-15;93;14;16416;8198;9.9;5.0
04;2021-03-16;74;8;16490;8206;10.0;5.0
04;2021-03-17;534;81;17024;8287;10.3;5.0
04;2021-03-18;815;24;17839;8311;10.8;5.0
04;2021-03-19;723;33;18562;8344;11.2;5.1
04;2021-03-20;159;3;18721;8347;11.3;5.1
04;2021-03-21;0;0;18721;8347;11.3;5.1
04;2021-03-22;105;13;18826;8360;11.4;5.1
04;2021-03-23;245;7;19071;8367;11.5;5.1
04;2021-03-24;1024;51;20095;8418;12.2;5.1
04;2021-03-25;1326;45;21421;8463;13.0;5.1
04;2021-03-26;1448;66;22869;8529;13.8;5.2
04;2021-03-27;266;19;23135;8548;14.0;5.2
04;2021-03-28;2;0;23137;8548;14.0;5.2
04;2021-03-29;680;13;23817;8561;14.4;5.2
04;2021-03-30;1086;142;24903;8703;15.1;5.3
04;2021-03-31;1327;107;26230;8810;15.9;5.3
04;2021-04-01;1133;133;27363;8943;16.6;5.4
04;2021-04-02;1185;113;28548;9056;17.3;5.5
04;2021-04-03;250;20;28798;9076;17.4;5.5
04;2021-04-04;1;0;28799;9076;17.4;5.5
04;2021-04-05;36;1;28835;9077;17.5;5.5
04;2021-04-06;929;150;29764;9227;18.0;5.6
04;2021-04-07;881;435;30645;9662;18.6;5.8
04;2021-04-08;926;696;31571;10358;19.1;6.3
04;2021-04-09;678;421;32249;10779;19.5;6.5
04;2021-04-10;231;191;32480;10970;19.7;6.6
04;2021-04-11;153;65;32633;11035;19.8;6.7
04;2021-04-12;593;101;33226;11136;20.1;6.7
04;2021-04-13;1189;240;34415;11376;20.8;6.9
04;2021-04-14;994;496;35409;11872;21.4;7.2
04;2021-04-15;921;672;36330;12544;22.0;7.6
04;2021-04-16;819;456;37149;13000;22.5;7.9
04;2021-04-17;209;69;37358;13069;22.6;7.9
04;2021-04-18;0;13;37358;13082;22.6;7.9
04;2021-04-19;338;287;37696;13369;22.8;8.1
04;2021-04-20;1003;446;38699;13815;23.4;8.4
04;2021-04-21;656;743;39355;14558;23.8;8.8
04;2021-04-22;758;853;40113;15411;24.3;9.3
04;2021-04-23;695;537;40808;15948;24.7;9.7
04;2021-04-24;165;65;40973;16013;24.8;9.7
04;2021-04-25;0;0;40973;16013;24.8;9.7
04;2021-04-26;172;611;41145;16624;24.9;10.1
04;2021-04-27;395;966;41540;17590;25.1;10.6
04;2021-04-28;431;1085;41971;18675;25.4;11.3
04;2021-04-29;688;1126;42659;19801;25.8;12.0
04;2021-04-30;436;847;43095;20648;26.1;12.5
04;2021-05-01;104;22;43199;20670;26.1;12.5
04;2021-05-02;8;131;43207;20801;26.2;12.6
04;2021-05-03;151;550;43358;21351;26.2;12.9
04;2021-05-04;564;835;43922;22186;26.6;13.4
04;2021-05-05;514;924;44436;23110;26.9;14.0
04;2021-05-06;1162;591;45598;23701;27.6;14.3
04;2021-05-07;656;753;46254;24454;28.0;14.8
04;2021-05-08;48;98;46302;24552;28.0;14.9
04;2021-05-09;0;0;46302;24552;28.0;14.9
04;2021-05-10;467;293;46769;24845;28.3;15.0
04;2021-05-11;1198;905;47967;25750;29.0;15.6
04;2021-05-12;1387;741;49354;26491;29.9;16.0
04;2021-05-13;378;131;49732;26622;30.1;16.1
04;2021-05-14;441;295;50173;26917;30.4;16.3
04;2021-05-15;99;161;50272;27078;30.4;16.4
04;2021-05-16;4;6;50276;27084;30.4;16.4
04;2021-05-17;155;297;50431;27381;30.5;16.6
04;2021-05-18;392;974;50823;28355;30.8;17.2
04;2021-05-19;773;688;51596;29043;31.2;17.6
04;2021-05-20;1256;548;52852;29591;32.0;17.9
04;2021-05-21;853;787;53705;30378;32.5;18.4
04;2021-05-22;105;146;53810;30524;32.6;18.5
04;2021-05-23;1;1;53811;30525;32.6;18.5
04;2021-05-24;2;36;53813;30561;32.6;18.5
04;2021-05-25;867;594;54680;31155;33.1;18.9
04;2021-05-26;1048;788;55728;31943;33.7;19.3
04;2021-05-27;1356;632;57084;32575;34.6;19.7
04;2021-05-28;1119;652;58203;33227;35.2;20.1
04;2021-05-29;90;398;58293;33625;35.3;20.4
04;2021-05-30;3;1;58296;33626;35.3;20.4
04;2021-05-31;420;416;58716;34042;35.5;20.6
04;2021-06-01;639;641;59355;34683;35.9;21.0
04;2021-06-02;871;1063;60226;35746;36.5;21.6
04;2021-06-03;1196;850;61422;36596;37.2;22.2
04;2021-06-04;978;777;62400;37373;37.8;22.6
04;2021-06-05;142;200;62542;37573;37.9;22.7
04;2021-06-06;7;13;62549;37586;37.9;22.8
04;2021-06-07;563;316;63112;37902;38.2;22.9
04;2021-06-08;839;594;63951;38496;38.7;23.3
04;2021-06-09;1145;685;65096;39181;39.4;23.7
04;2021-06-10;1142;585;66238;39766;40.1;24.1
04;2021-06-11;944;615;67182;40381;40.7;24.4
04;2021-06-12;212;144;67394;40525;40.8;24.5
04;2021-06-13;1;1;67395;40526;40.8;24.5
04;2021-06-14;478;303;67873;40829;41.1;24.7
04;2021-06-15;644;1003;68517;41832;41.5;25.3
04;2021-06-16;1022;786;69539;42618;42.1;25.8
04;2021-06-17;1001;959;70540;43577;42.7;26.4
04;2021-06-18;760;886;71300;44463;43.2;26.9
04;2021-06-19;40;85;71340;44548;43.2;27.0
04;2021-06-20;7;9;71347;44557;43.2;27.0
04;2021-06-21;305;614;71652;45171;43.4;27.3
04;2021-06-22;361;1308;72013;46479;43.6;28.1
04;2021-06-23;474;1311;72487;47790;43.9;28.9
04;2021-06-24;852;815;73339;48605;44.4;29.4
04;2021-06-25;461;639;73800;49244;44.7;29.8
04;2021-06-26;57;130;73857;49374;44.7;29.9
04;2021-06-27;4;4;73861;49378;44.7;29.9
04;2021-06-28;158;341;74019;49719;44.8;30.1
04;2021-06-29;370;839;74389;50558;45.0;30.6
04;2021-06-30;541;1121;74930;51679;45.4;31.3
04;2021-07-01;578;1219;75508;52898;45.7;32.0
04;2021-07-02;557;1090;76065;53988;46.0;32.7
04;2021-07-03;65;162;76130;54150;46.1;32.8
04;2021-07-04;6;6;76136;54156;46.1;32.8
04;2021-07-05;106;297;76242;54453;46.2;33.0
04;2021-07-06;503;1383;76745;55836;46.5;33.8
04;2021-07-07;494;1341;77239;57177;46.8;34.6
04;2021-07-08;725;1361;77964;58538;47.2;35.4
04;2021-07-09;580;1061;78544;59599;47.5;36.1
04;2021-07-10;92;177;78636;59776;47.6;36.2
04;2021-07-11;0;21;78636;59797;47.6;36.2
04;2021-07-12;128;652;78764;60449;47.7;36.6
04;2021-07-13;881;1540;79645;61989;48.2;37.5
04;2021-07-14;26;43;79671;62032;48.2;37.6
04;2021-07-15;1219;1736;80890;63768;49.0;38.6
04;2021-07-16;1082;1113;81972;64881;49.6;39.3
04;2021-07-17;446;235;82418;65116;49.9;39.4
04;2021-07-18;114;18;82532;65134;50.0;39.4
04;2021-07-19;484;655;83016;65789;50.3;39.8
04;2021-07-20;1313;1465;84329;67254;51.0;40.7
04;2021-07-21;1126;1165;85455;68419;51.7;41.4
04;2021-07-22;1500;1372;86955;69791;52.6;42.2
04;2021-07-23;1150;1140;88105;70931;53.3;42.9
04;2021-07-24;685;214;88790;71145;53.7;43.1
04;2021-07-25;42;16;88832;71161;53.8;43.1
04;2021-07-26;445;639;89277;71800;54.0;43.5
04;2021-07-27;1370;1045;90647;72845;54.9;44.1
04;2021-07-28;1072;1037;91719;73882;55.5;44.7
04;2021-07-29;1561;1301;93280;75183;56.5;45.5
04;2021-07-30;1245;924;94525;76107;57.2;46.1
04;2021-07-31;251;176;94776;76283;57.4;46.2
04;2021-08-01;48;19;94824;76302;57.4;46.2
04;2021-08-02;197;108;95021;76410;57.5;46.3
04;2021-08-03;1348;1116;96369;77526;58.3;46.9
04;2021-08-04;1178;864;97547;78390;59.0;47.5
04;2021-08-05;1194;737;98741;79127;59.8;47.9
04;2021-08-06;516;396;99257;79523;60.1;48.1
04;2021-08-07;162;162;99419;79685;60.2;48.2
04;2021-08-08;25;12;99444;79697;60.2;48.2
04;2021-08-09;103;117;99547;79814;60.3;48.3
04;2021-08-10;655;981;100202;80795;60.7;48.9
04;2021-08-11;1147;1020;101349;81815;61.4;49.5
04;2021-08-12;1124;1307;102473;83122;62.0;50.3
04;2021-08-13;443;385;102916;83507;62.3;50.5
04;2021-08-14;100;73;103016;83580;62.4;50.6
04;2021-08-15;1;0;103017;83580;62.4;50.6
04;2021-08-16;103;138;103120;83718;62.4;50.7
04;2021-08-17;495;1014;103615;84732;62.7;51.3
04;2021-08-18;719;1318;104334;86050;63.2;52.1
04;2021-08-19;740;1412;105074;87462;63.6;52.9
04;2021-08-20;748;1363;105822;88825;64.1;53.8
04;2021-08-21;66;111;105888;88936;64.1;53.8
04;2021-08-22;15;45;105903;88981;64.1;53.9
04;2021-08-23;55;110;105958;89091;64.1;53.9
04;2021-08-24;684;1493;106642;90584;64.6;54.8
04;2021-08-25;656;1182;107298;91766;65.0;55.5
04;2021-08-26;488;1214;107786;92980;65.2;56.3
04;2021-08-27;451;929;108237;93909;65.5;56.8
04;2021-08-28;131;244;108368;94153;65.6;57.0
04;2021-08-29;27;23;108395;94176;65.6;57.0
04;2021-08-30;122;244;108517;94420;65.7;57.2
04;2021-08-31;511;1008;109028;95428;66.0;57.8
04;2021-09-01;509;1253;109537;96681;66.3;58.5
04;2021-09-02;336;932;109873;97613;66.5;59.1
04;2021-09-03;288;819;110161;98432;66.7;59.6
04;2021-09-04;148;240;110309;98672;66.8;59.7
04;2021-09-05;14;9;110323;98681;66.8;59.7
04;2021-09-06;57;106;110380;98787;66.8;59.8
04;2021-09-07;370;1037;110750;99824;67.0;60.4
04;2021-09-08;328;893;111078;100717;67.2;61.0
04;2021-09-09;340;959;111418;101676;67.4;61.5
04;2021-09-10;277;812;111695;102488;67.6;62.0
04;2021-09-11;93;153;111788;102641;67.7;62.1
04;2021-09-12;16;30;111804;102671;67.7;62.2
04;2021-09-13;94;98;111898;102769;67.7;62.2
04;2021-09-14;329;965;112227;103734;67.9;62.8
04;2021-09-15;306;702;112533;104436;68.1;63.2
04;2021-09-16;310;521;112843;104957;68.3;63.5
04;2021-09-17;184;566;113027;105523;68.4;63.9
04;2021-09-18;48;123;113075;105646;68.4;64.0
04;2021-09-19;0;5;113075;105651;68.4;64.0
04;2021-09-20;79;51;113154;105702;68.5;64.0
04;2021-09-21;188;570;113342;106272;68.6;64.3
04;2021-09-22;162;677;113504;106949;68.7;64.7
04;2021-09-23;205;377;113709;107326;68.8;65.0
04;2021-09-24;143;435;113852;107761;68.9;65.2
04;2021-09-25;42;98;113894;107859;68.9;65.3
04;2021-09-26;5;25;113899;107884;68.9;65.3
04;2021-09-27;19;66;113918;107950;69.0;65.3
04;2021-09-28;139;277;114057;108227;69.0;65.5
04;2021-09-29;135;381;114192;108608;69.1;65.7
05;2020-12-27;0;0;0;0;0.0;0.0
05;2020-12-28;1;0;1;0;0.0;0.0
05;2020-12-29;1;0;2;0;0.0;0.0
05;2020-12-30;2;0;4;0;0.0;0.0
05;2020-12-31;0;0;4;0;0.0;0.0
05;2021-01-01;2;0;6;0;0.0;0.0
05;2021-01-02;2;0;8;0;0.0;0.0
05;2021-01-03;1;0;9;0;0.0;0.0
05;2021-01-04;2;0;11;0;0.0;0.0
05;2021-01-05;0;0;11;0;0.0;0.0
05;2021-01-06;22;0;33;0;0.0;0.0
05;2021-01-07;128;0;161;0;0.1;0.0
05;2021-01-08;146;0;307;0;0.2;0.0
05;2021-01-09;11;0;318;0;0.2;0.0
05;2021-01-10;0;0;318;0;0.2;0.0
05;2021-01-11;44;0;362;0;0.3;0.0
05;2021-01-12;105;0;467;0;0.3;0.0
05;2021-01-13;139;0;606;0;0.4;0.0
05;2021-01-14;167;0;773;0;0.5;0.0
05;2021-01-15;127;1;900;1;0.6;0.0
05;2021-01-16;15;0;915;1;0.6;0.0
05;2021-01-17;0;0;915;1;0.6;0.0
05;2021-01-18;226;1;1141;2;0.8;0.0
05;2021-01-19;227;0;1368;2;1.0;0.0
05;2021-01-20;213;0;1581;2;1.1;0.0
05;2021-01-21;255;0;1836;2;1.3;0.0
05;2021-01-22;196;1;2032;3;1.4;0.0
05;2021-01-23;112;0;2144;3;1.5;0.0
05;2021-01-24;0;0;2144;3;1.5;0.0
05;2021-01-25;316;0;2460;3;1.7;0.0
05;2021-01-26;486;0;2946;3;2.1;0.0
05;2021-01-27;389;3;3335;6;2.4;0.0
05;2021-01-28;363;42;3698;48;2.6;0.0
05;2021-01-29;364;109;4062;157;2.9;0.1
05;2021-01-30;97;9;4159;166;2.9;0.1
05;2021-01-31;4;0;4163;166;2.9;0.1
05;2021-02-01;177;20;4340;186;3.1;0.1
05;2021-02-02;187;68;4527;254;3.2;0.2
05;2021-02-03;208;58;4735;312;3.3;0.2
05;2021-02-04;197;113;4932;425;3.5;0.3
05;2021-02-05;183;107;5115;532;3.6;0.4
05;2021-02-06;76;24;5191;556;3.7;0.4
05;2021-02-07;0;5;5191;561;3.7;0.4
05;2021-02-08;84;95;5275;656;3.7;0.5
05;2021-02-09;97;90;5372;746;3.8;0.5
05;2021-02-10;81;147;5453;893;3.8;0.6
05;2021-02-11;87;111;5540;1004;3.9;0.7
05;2021-02-12;85;121;5625;1125;4.0;0.8
05;2021-02-13;75;29;5700;1154;4.0;0.8
05;2021-02-14;0;0;5700;1154;4.0;0.8
05;2021-02-15;98;148;5798;1302;4.1;0.9
05;2021-02-16;111;233;5909;1535;4.2;1.1
05;2021-02-17;136;198;6045;1733;4.3;1.2
05;2021-02-18;154;265;6199;1998;4.4;1.4
05;2021-02-19;158;288;6357;2286;4.5;1.6
05;2021-02-20;31;73;6388;2359;4.5;1.7
05;2021-02-21;0;0;6388;2359;4.5;1.7
05;2021-02-22;70;204;6458;2563;4.6;1.8
05;2021-02-23;18;167;6476;2730;4.6;1.9
05;2021-02-24;20;142;6496;2872;4.6;2.0
05;2021-02-25;56;116;6552;2988;4.6;2.1
05;2021-02-26;145;169;6697;3157;4.7;2.2
05;2021-02-27;65;149;6762;3306;4.8;2.3
05;2021-02-28;11;0;6773;3306;4.8;2.3
05;2021-03-01;92;143;6865;3449;4.8;2.4
05;2021-03-02;92;157;6957;3606;4.9;2.5
05;2021-03-03;112;192;7069;3798;5.0;2.7
05;2021-03-04;242;138;7311;3936;5.2;2.8
05;2021-03-05;578;165;7889;4101;5.6;2.9
05;2021-03-06;668;49;8557;4150;6.0;2.9
05;2021-03-07;516;20;9073;4170;6.4;2.9
05;2021-03-08;556;128;9629;4298;6.8;3.0
05;2021-03-09;520;148;10149;4446;7.2;3.1
05;2021-03-10;498;125;10647;4571;7.5;3.2
05;2021-03-11;377;136;11024;4707;7.8;3.3
05;2021-03-12;435;87;11459;4794;8.1;3.4
05;2021-03-13;797;96;12256;4890;8.6;3.4
05;2021-03-14;670;11;12926;4901;9.1;3.5
05;2021-03-15;354;121;13280;5022;9.4;3.5
05;2021-03-16;149;135;13429;5157;9.5;3.6
05;2021-03-17;262;119;13691;5276;9.7;3.7
05;2021-03-18;364;35;14055;5311;9.9;3.7
05;2021-03-19;450;59;14505;5370;10.2;3.8
05;2021-03-20;167;28;14672;5398;10.4;3.8
05;2021-03-21;1;0;14673;5398;10.4;3.8
05;2021-03-22;718;37;15391;5435;10.9;3.8
05;2021-03-23;805;15;16196;5450;11.4;3.8
05;2021-03-24;788;77;16984;5527;12.0;3.9
05;2021-03-25;901;59;17885;5586;12.6;3.9
05;2021-03-26;1023;49;18908;5635;13.3;4.0
05;2021-03-27;467;33;19375;5668;13.7;4.0
05;2021-03-28;10;0;19385;5668;13.7;4.0
05;2021-03-29;905;63;20290;5731;14.3;4.0
05;2021-03-30;1142;78;21432;5809;15.1;4.1
05;2021-03-31;824;253;22256;6062;15.7;4.3
05;2021-04-01;901;239;23157;6301;16.3;4.4
05;2021-04-02;664;380;23821;6681;16.8;4.7
05;2021-04-03;551;183;24372;6864;17.2;4.8
05;2021-04-04;350;63;24722;6927;17.4;4.9
05;2021-04-05;158;12;24880;6939;17.6;4.9
05;2021-04-06;646;274;25526;7213;18.0;5.1
05;2021-04-07;773;324;26299;7537;18.6;5.3
05;2021-04-08;734;337;27033;7874;19.1;5.6
05;2021-04-09;883;406;27916;8280;19.7;5.8
05;2021-04-10;714;387;28630;8667;20.2;6.1
05;2021-04-11;191;172;28821;8839;20.3;6.2
05;2021-04-12;732;264;29553;9103;20.8;6.4
05;2021-04-13;921;248;30474;9351;21.5;6.6
05;2021-04-14;666;325;31140;9676;22.0;6.8
05;2021-04-15;768;399;31908;10075;22.5;7.1
05;2021-04-16;730;397;32638;10472;23.0;7.4
05;2021-04-17;671;239;33309;10711;23.5;7.6
05;2021-04-18;305;23;33614;10734;23.7;7.6
05;2021-04-19;363;536;33977;11270;24.0;8.0
05;2021-04-20;482;628;34459;11898;24.3;8.4
05;2021-04-21;494;626;34953;12524;24.7;8.8
05;2021-04-22;385;546;35338;13070;24.9;9.2
05;2021-04-23;523;655;35861;13725;25.3;9.7
05;2021-04-24;347;384;36208;14109;25.5;10.0
05;2021-04-25;288;23;36496;14132;25.7;10.0
05;2021-04-26;367;704;36863;14836;26.0;10.5
05;2021-04-27;657;750;37520;15586;26.5;11.0
05;2021-04-28;468;721;37988;16307;26.8;11.5
05;2021-04-29;702;747;38690;17054;27.3;12.0
05;2021-04-30;509;753;39199;17807;27.7;12.6
05;2021-05-01;138;110;39337;17917;27.7;12.6
05;2021-05-02;267;115;39604;18032;27.9;12.7
05;2021-05-03;458;492;40062;18524;28.3;13.1
05;2021-05-04;384;503;40446;19027;28.5;13.4
05;2021-05-05;461;670;40907;19697;28.9;13.9
05;2021-05-06;644;725;41551;20422;29.3;14.4
05;2021-05-07;595;799;42146;21221;29.7;15.0
05;2021-05-08;481;177;42627;21398;30.1;15.1
05;2021-05-09;208;57;42835;21455;30.2;15.1
05;2021-05-10;500;696;43335;22151;30.6;15.6
05;2021-05-11;669;905;44004;23056;31.0;16.3
05;2021-05-12;647;733;44651;23789;31.5;16.8
05;2021-05-13;960;116;45611;23905;32.2;16.9
05;2021-05-14;826;495;46437;24400;32.8;17.2
05;2021-05-15;1043;353;47480;24753;33.5;17.5
05;2021-05-16;235;52;47715;24805;33.7;17.5
05;2021-05-17;484;430;48199;25235;34.0;17.8
05;2021-05-18;519;419;48718;25654;34.4;18.1
05;2021-05-19;727;459;49445;26113;34.9;18.4
05;2021-05-20;747;434;50192;26547;35.4;18.7
05;2021-05-21;706;512;50898;27059;35.9;19.1
05;2021-05-22;607;239;51505;27298;36.3;19.3
05;2021-05-23;277;59;51782;27357;36.5;19.3
05;2021-05-24;510;157;52292;27514;36.9;19.4
05;2021-05-25;515;483;52807;27997;37.3;19.8
05;2021-05-26;695;362;53502;28359;37.7;20.0
05;2021-05-27;799;572;54301;28931;38.3;20.4
05;2021-05-28;666;648;54967;29579;38.8;20.9
05;2021-05-29;566;544;55533;30123;39.2;21.2
05;2021-05-30;212;82;55745;30205;39.3;21.3
05;2021-05-31;576;495;56321;30700;39.7;21.7
05;2021-06-01;590;586;56911;31286;40.1;22.1
05;2021-06-02;684;703;57595;31989;40.6;22.6
05;2021-06-03;716;649;58311;32638;41.1;23.0
05;2021-06-04;1017;815;59328;33453;41.9;23.6
05;2021-06-05;807;507;60135;33960;42.4;24.0
05;2021-06-06;202;89;60337;34049;42.6;24.0
05;2021-06-07;605;833;60942;34882;43.0;24.6
05;2021-06-08;702;659;61644;35541;43.5;25.1
05;2021-06-09;648;782;62292;36323;43.9;25.6
05;2021-06-10;545;718;62837;37041;44.3;26.1
05;2021-06-11;765;723;63602;37764;44.9;26.6
05;2021-06-12;593;485;64195;38249;45.3;27.0
05;2021-06-13;113;91;64308;38340;45.4;27.0
05;2021-06-14;403;669;64711;39009;45.6;27.5
05;2021-06-15;543;911;65254;39920;46.0;28.2
05;2021-06-16;433;671;65687;40591;46.3;28.6
05;2021-06-17;360;805;66047;41396;46.6;29.2
05;2021-06-18;400;724;66447;42120;46.9;29.7
05;2021-06-19;421;570;66868;42690;47.2;30.1
05;2021-06-20;64;77;66932;42767;47.2;30.2
05;2021-06-21;319;641;67251;43408;47.4;30.6
05;2021-06-22;356;829;67607;44237;47.7;31.2
05;2021-06-23;354;763;67961;45000;47.9;31.7
05;2021-06-24;388;1021;68349;46021;48.2;32.5
05;2021-06-25;229;892;68578;46913;48.4;33.1
05;2021-06-26;292;1074;68870;47987;48.6;33.9
05;2021-06-27;128;170;68998;48157;48.7;34.0
05;2021-06-28;254;792;69252;48949;48.9;34.5
05;2021-06-29;250;785;69502;49734;49.0;35.1
05;2021-06-30;329;788;69831;50522;49.3;35.6
05;2021-07-01;385;791;70216;51313;49.5;36.2
05;2021-07-02;369;871;70585;52184;49.8;36.8
05;2021-07-03;305;741;70890;52925;50.0;37.3
05;2021-07-04;179;177;71069;53102;50.1;37.5
05;2021-07-05;264;780;71333;53882;50.3;38.0
05;2021-07-06;336;858;71669;54740;50.6;38.6
05;2021-07-07;400;781;72069;55521;50.8;39.2
05;2021-07-08;431;848;72500;56369;51.1;39.8
05;2021-07-09;422;994;72922;57363;51.4;40.5
05;2021-07-10;314;729;73236;58092;51.7;41.0
05;2021-07-11;176;120;73412;58212;51.8;41.1
05;2021-07-12;416;1014;73828;59226;52.1;41.8
05;2021-07-13;482;869;74310;60095;52.4;42.4
05;2021-07-14;837;300;75147;60395;53.0;42.6
05;2021-07-15;708;992;75855;61387;53.5;43.3
05;2021-07-16;1027;1456;76882;62843;54.2;44.3
05;2021-07-17;672;1306;77554;64149;54.7;45.3
05;2021-07-18;285;131;77839;64280;54.9;45.3
05;2021-07-19;572;792;78411;65072;55.3;45.9
05;2021-07-20;763;801;79174;65873;55.9;46.5
05;2021-07-21;882;840;80056;66713;56.5;47.1
05;2021-07-22;812;870;80868;67583;57.0;47.7
05;2021-07-23;1446;1239;82314;68822;58.1;48.5
05;2021-07-24;864;836;83178;69658;58.7;49.1
05;2021-07-25;305;160;83483;69818;58.9;49.3
05;2021-07-26;778;561;84261;70379;59.4;49.6
05;2021-07-27;1259;755;85520;71134;60.3;50.2
05;2021-07-28;1523;720;87043;71854;61.4;50.7
05;2021-07-29;1346;724;88389;72578;62.4;51.2
05;2021-07-30;960;595;89349;73173;63.0;51.6
05;2021-07-31;782;526;90131;73699;63.6;52.0
05;2021-08-01;192;178;90323;73877;63.7;52.1
05;2021-08-02;835;549;91158;74426;64.3;52.5
05;2021-08-03;828;610;91986;75036;64.9;52.9
05;2021-08-04;991;758;92977;75794;65.6;53.5
05;2021-08-05;982;725;93959;76519;66.3;54.0
05;2021-08-06;873;793;94832;77312;66.9;54.5
05;2021-08-07;631;642;95463;77954;67.3;55.0
05;2021-08-08;196;270;95659;78224;67.5;55.2
05;2021-08-09;774;847;96433;79071;68.0;55.8
05;2021-08-10;651;700;97084;79771;68.5;56.3
05;2021-08-11;743;857;97827;80628;69.0;56.9
05;2021-08-12;794;785;98621;81413;69.6;57.4
05;2021-08-13;626;893;99247;82306;70.0;58.1
05;2021-08-14;410;781;99657;83087;70.3;58.6
05;2021-08-15;188;224;99845;83311;70.4;58.8
05;2021-08-16;488;1086;100333;84397;70.8;59.5
05;2021-08-17;433;880;100766;85277;71.1;60.2
05;2021-08-18;438;974;101204;86251;71.4;60.8
05;2021-08-19;500;964;101704;87215;71.7;61.5
05;2021-08-20;478;1115;102182;88330;72.1;62.3
05;2021-08-21;359;851;102541;89181;72.3;62.9
05;2021-08-22;117;254;102658;89435;72.4;63.1
05;2021-08-23;320;828;102978;90263;72.6;63.7
05;2021-08-24;403;781;103381;91044;72.9;64.2
05;2021-08-25;408;925;103789;91969;73.2;64.9
05;2021-08-26;307;814;104096;92783;73.4;65.5
05;2021-08-27;334;921;104430;93704;73.7;66.1
05;2021-08-28;245;655;104675;94359;73.8;66.6
05;2021-08-29;66;255;104741;94614;73.9;66.7
05;2021-08-30;268;804;105009;95418;74.1;67.3
05;2021-08-31;252;713;105261;96131;74.3;67.8
05;2021-09-01;271;655;105532;96786;74.4;68.3
05;2021-09-02;255;708;105787;97494;74.6;68.8
05;2021-09-03;253;617;106040;98111;74.8;69.2
05;2021-09-04;202;669;106242;98780;74.9;69.7
05;2021-09-05;55;178;106297;98958;75.0;69.8
05;2021-09-06;164;422;106461;99380;75.1;70.1
05;2021-09-07;218;618;106679;99998;75.3;70.5
05;2021-09-08;177;594;106856;100592;75.4;71.0
05;2021-09-09;191;524;107047;101116;75.5;71.3
05;2021-09-10;182;448;107229;101564;75.6;71.6
05;2021-09-11;148;462;107377;102026;75.7;72.0
05;2021-09-12;24;106;107401;102132;75.8;72.0
05;2021-09-13;169;418;107570;102550;75.9;72.3
05;2021-09-14;218;365;107788;102915;76.0;72.6
05;2021-09-15;176;376;107964;103291;76.2;72.9
05;2021-09-16;174;254;108138;103545;76.3;73.0
05;2021-09-17;147;319;108285;103864;76.4;73.3
05;2021-09-18;120;359;108405;104223;76.5;73.5
05;2021-09-19;16;38;108421;104261;76.5;73.5
05;2021-09-20;58;166;108479;104427;76.5;73.7
05;2021-09-21;81;246;108560;104673;76.6;73.8
05;2021-09-22;109;291;108669;104964;76.7;74.0
05;2021-09-23;99;237;108768;105201;76.7;74.2
05;2021-09-24;85;281;108853;105482;76.8;74.4
05;2021-09-25;85;225;108938;105707;76.8;74.6
05;2021-09-26;17;31;108955;105738;76.9;74.6
05;2021-09-27;63;144;109018;105882;76.9;74.7
05;2021-09-28;68;159;109086;106041;77.0;74.8
05;2021-09-29;85;199;109171;106240;77.0;74.9
06;2020-12-27;16;0;16;0;0.0;0.0
06;2020-12-28;25;0;41;0;0.0;0.0
06;2020-12-29;12;0;53;0;0.0;0.0
06;2020-12-30;10;0;63;0;0.0;0.0
06;2020-12-31;30;0;93;0;0.0;0.0
06;2021-01-01;26;0;119;0;0.0;0.0
06;2021-01-02;9;0;128;0;0.0;0.0
06;2021-01-03;11;0;139;0;0.0;0.0
06;2021-01-04;158;1;297;1;0.0;0.0
06;2021-01-05;193;2;490;3;0.0;0.0
06;2021-01-06;253;2;743;5;0.1;0.0
06;2021-01-07;524;2;1267;7;0.1;0.0
06;2021-01-08;692;3;1959;10;0.2;0.0
06;2021-01-09;391;3;2350;13;0.2;0.0
06;2021-01-10;82;0;2432;13;0.2;0.0
06;2021-01-11;1163;1;3595;14;0.3;0.0
06;2021-01-12;2252;4;5847;18;0.5;0.0
06;2021-01-13;1756;7;7603;25;0.7;0.0
06;2021-01-14;2180;17;9783;42;0.9;0.0
06;2021-01-15;1891;5;11674;47;1.1;0.0
06;2021-01-16;993;5;12667;52;1.2;0.0
06;2021-01-17;246;0;12913;52;1.2;0.0
06;2021-01-18;2511;9;15424;61;1.4;0.0
06;2021-01-19;2780;12;18204;73;1.7;0.0
06;2021-01-20;3390;12;21594;85;2.0;0.0
06;2021-01-21;3060;22;24654;107;2.3;0.0
06;2021-01-22;3025;16;27679;123;2.6;0.0
06;2021-01-23;1310;3;28989;126;2.7;0.0
06;2021-01-24;34;0;29023;126;2.7;0.0
06;2021-01-25;2091;12;31114;138;2.9;0.0
06;2021-01-26;3415;44;34529;182;3.2;0.0
06;2021-01-27;2576;93;37105;275;3.4;0.0
06;2021-01-28;2829;183;39934;458;3.7;0.0
06;2021-01-29;2525;281;42459;739;3.9;0.1
06;2021-01-30;674;38;43133;777;4.0;0.1
06;2021-01-31;4;1;43137;778;4.0;0.1
06;2021-02-01;1030;412;44167;1190;4.1;0.1
06;2021-02-02;1517;363;45684;1553;4.2;0.1
06;2021-02-03;339;126;46023;1679;4.3;0.2
06;2021-02-04;727;774;46750;2453;4.3;0.2
06;2021-02-05;1015;946;47765;3399;4.4;0.3
06;2021-02-06;172;357;47937;3756;4.4;0.3
06;2021-02-07;14;49;47951;3805;4.4;0.4
06;2021-02-08;542;871;48493;4676;4.5;0.4
06;2021-02-09;326;682;48819;5358;4.5;0.5
06;2021-02-10;387;563;49206;5921;4.6;0.5
06;2021-02-11;485;898;49691;6819;4.6;0.6
06;2021-02-12;662;1077;50353;7896;4.7;0.7
06;2021-02-13;207;237;50560;8133;4.7;0.8
06;2021-02-14;19;2;50579;8135;4.7;0.8
06;2021-02-15;470;976;51049;9111;4.7;0.8
06;2021-02-16;877;1748;51926;10859;4.8;1.0
06;2021-02-17;842;1737;52768;12596;4.9;1.2
06;2021-02-18;1826;2200;54594;14796;5.1;1.4
06;2021-02-19;1774;1769;56368;16565;5.2;1.5
06;2021-02-20;288;416;56656;16981;5.2;1.6
06;2021-02-21;25;52;56681;17033;5.3;1.6
06;2021-02-22;1093;1220;57774;18253;5.4;1.7
06;2021-02-23;1768;1174;59542;19427;5.5;1.8
06;2021-02-24;2126;997;61668;20424;5.7;1.9
06;2021-02-25;3870;1367;65538;21791;6.1;2.0
06;2021-02-26;3414;1346;68952;23137;6.4;2.1
06;2021-02-27;1442;292;70394;23429;6.5;2.2
06;2021-02-28;103;23;70497;23452;6.5;2.2
06;2021-03-01;2435;669;72932;24121;6.8;2.2
06;2021-03-02;2470;808;75402;24929;7.0;2.3
06;2021-03-03;2877;460;78279;25389;7.3;2.4
06;2021-03-04;4640;502;82919;25891;7.7;2.4
06;2021-03-05;3925;900;86844;26791;8.0;2.5
06;2021-03-06;11973;341;98817;27132;9.2;2.5
06;2021-03-07;10222;310;109039;27442;10.1;2.5
06;2021-03-08;4185;981;113224;28423;10.5;2.6
06;2021-03-09;5018;791;118242;29214;11.0;2.7
06;2021-03-10;4739;655;122981;29869;11.4;2.8
06;2021-03-11;6745;825;129726;30694;12.0;2.8
06;2021-03-12;6897;975;136623;31669;12.7;2.9
06;2021-03-13;11275;344;147898;32013;13.7;3.0
06;2021-03-14;516;47;148414;32060;13.7;3.0
06;2021-03-15;4850;719;153264;32779;14.2;3.0
06;2021-03-16;3784;992;157048;33771;14.5;3.1
06;2021-03-17;6211;1729;163259;35500;15.1;3.3
06;2021-03-18;5136;1755;168395;37255;15.6;3.5
06;2021-03-19;6841;1960;175236;39215;16.2;3.6
06;2021-03-20;2380;511;177616;39726;16.5;3.7
06;2021-03-21;416;23;178032;39749;16.5;3.7
06;2021-03-22;3997;683;182029;40432;16.9;3.7
06;2021-03-23;5996;1184;188025;41616;17.4;3.9
06;2021-03-24;4232;3040;192257;44656;17.8;4.1
06;2021-03-25;5888;3086;198145;47742;18.4;4.4
06;2021-03-26;6372;1972;204517;49714;18.9;4.6
06;2021-03-27;2042;358;206559;50072;19.1;4.6
06;2021-03-28;216;5;206775;50077;19.2;4.6
06;2021-03-29;3212;2073;209987;52150;19.5;4.8
06;2021-03-30;5200;2482;215187;54632;19.9;5.1
06;2021-03-31;8061;1651;223248;56283;20.7;5.2
06;2021-04-01;7675;2456;230923;58739;21.4;5.4
06;2021-04-02;7251;2703;238174;61442;22.1;5.7
06;2021-04-03;2723;1374;240897;62816;22.3;5.8
06;2021-04-04;303;547;241200;63363;22.3;5.9
06;2021-04-05;1417;696;242617;64059;22.5;5.9
06;2021-04-06;6682;3310;249299;67369;23.1;6.2
06;2021-04-07;6238;3886;255537;71255;23.7;6.6
06;2021-04-08;5758;5647;261295;76902;24.2;7.1
06;2021-04-09;9396;5857;270691;82759;25.1;7.7
06;2021-04-10;2396;2779;273087;85538;25.3;7.9
06;2021-04-11;189;58;273276;85596;25.3;7.9
06;2021-04-12;4391;3503;277667;89099;25.7;8.3
06;2021-04-13;6394;5002;284061;94101;26.3;8.7
06;2021-04-14;5479;4431;289540;98532;26.8;9.1
06;2021-04-15;5561;4385;295101;102917;27.3;9.5
06;2021-04-16;7091;5190;302192;108107;28.0;10.0
06;2021-04-17;2787;3053;304979;111160;28.3;10.3
06;2021-04-18;272;223;305251;111383;28.3;10.3
06;2021-04-19;5505;4038;310756;115421;28.8;10.7
06;2021-04-20;5667;4872;316423;120293;29.3;11.1
06;2021-04-21;8338;4182;324761;124475;30.1;11.5
06;2021-04-22;8583;4200;333344;128675;30.9;11.9
06;2021-04-23;8854;4282;342198;132957;31.7;12.3
06;2021-04-24;2358;1495;344556;134452;31.9;12.5
06;2021-04-25;122;14;344678;134466;31.9;12.5
06;2021-04-26;4163;2318;348841;136784;32.3;12.7
06;2021-04-27;4593;4040;353434;140824;32.7;13.0
06;2021-04-28;4163;4574;357597;145398;33.1;13.5
06;2021-04-29;6095;5452;363692;150850;33.7;14.0
06;2021-04-30;6785;5167;370477;156017;34.3;14.5
06;2021-05-01;4168;838;374645;156855;34.7;14.5
06;2021-05-02;494;155;375139;157010;34.8;14.5
06;2021-05-03;6929;3560;382068;160570;35.4;14.9
06;2021-05-04;5757;5390;387825;165960;35.9;15.4
06;2021-05-05;4550;3909;392375;169869;36.4;15.7
06;2021-05-06;5233;4740;397608;174609;36.8;16.2
06;2021-05-07;5663;5673;403271;180282;37.4;16.7
06;2021-05-08;4874;1333;408145;181615;37.8;16.8
06;2021-05-09;205;308;408350;181923;37.8;16.9
06;2021-05-10;4834;5048;413184;186971;38.3;17.3
06;2021-05-11;4948;5558;418132;192529;38.7;17.8
06;2021-05-12;9110;4899;427242;197428;39.6;18.3
06;2021-05-13;9278;2146;436520;199574;40.4;18.5
06;2021-05-14;10863;3366;447383;202940;41.4;18.8
06;2021-05-15;9314;2224;456697;205164;42.3;19.0
06;2021-05-16;1506;288;458203;205452;42.4;19.0
06;2021-05-17;7524;3754;465727;209206;43.1;19.4
06;2021-05-18;9750;3232;475477;212438;44.1;19.7
06;2021-05-19;7715;2988;483192;215426;44.8;20.0
06;2021-05-20;7983;3680;491175;219106;45.5;20.3
06;2021-05-21;8832;3952;500007;223058;46.3;20.7
06;2021-05-22;3033;1326;503040;224384;46.6;20.8
06;2021-05-23;134;630;503174;225014;46.6;20.8
06;2021-05-24;3207;1002;506381;226016;46.9;20.9
06;2021-05-25;4762;4933;511143;230949;47.4;21.4
06;2021-05-26;5696;6631;516839;237580;47.9;22.0
06;2021-05-27;5594;6283;522433;243863;48.4;22.6
06;2021-05-28;4985;7291;527418;251154;48.9;23.3
06;2021-05-29;1638;2925;529056;254079;49.0;23.5
06;2021-05-30;258;1122;529314;255201;49.0;23.6
06;2021-05-31;4418;5120;533732;260321;49.4;24.1
06;2021-06-01;5755;7427;539487;267748;50.0;24.8
06;2021-06-02;3326;8549;542813;276297;50.3;25.6
06;2021-06-03;4551;8306;547364;284603;50.7;26.4
06;2021-06-04;5491;7726;552855;292329;51.2;27.1
06;2021-06-05;2467;3348;555322;295677;51.4;27.4
06;2021-06-06;183;235;555505;295912;51.5;27.4
06;2021-06-07;4149;5582;559654;301494;51.8;27.9
06;2021-06-08;4487;5218;564141;306712;52.3;28.4
06;2021-06-09;4124;7361;568265;314073;52.6;29.1
06;2021-06-10;4793;6870;573058;320943;53.1;29.7
06;2021-06-11;3928;8354;576986;329297;53.5;30.5
06;2021-06-12;1748;3751;578734;333048;53.6;30.9
06;2021-06-13;150;439;578884;333487;53.6;30.9
06;2021-06-14;2741;8602;581625;342089;53.9;31.7
06;2021-06-15;3291;9485;584916;351574;54.2;32.6
06;2021-06-16;3517;7022;588433;358596;54.5;33.2
06;2021-06-17;3683;7188;592116;365784;54.9;33.9
06;2021-06-18;2645;5929;594761;371713;55.1;34.4
06;2021-06-19;1319;1688;596080;373401;55.2;34.6
06;2021-06-20;211;349;596291;373750;55.2;34.6
06;2021-06-21;1737;6296;598028;380046;55.4;35.2
06;2021-06-22;2372;7358;600400;387404;55.6;35.9
06;2021-06-23;2095;6542;602495;393946;55.8;36.5
06;2021-06-24;3495;8968;605990;402914;56.1;37.3
06;2021-06-25;2308;9603;608298;412517;56.4;38.2
06;2021-06-26;893;2288;609191;414805;56.4;38.4
06;2021-06-27;379;1190;609570;415995;56.5;38.5
06;2021-06-28;2502;8123;612072;424118;56.7;39.3
06;2021-06-29;2395;7729;614467;431847;56.9;40.0
06;2021-06-30;1522;7691;615989;439538;57.1;40.7
06;2021-07-01;3570;7480;619559;447018;57.4;41.4
06;2021-07-02;4476;8279;624035;455297;57.8;42.2
06;2021-07-03;1240;4306;625275;459603;57.9;42.6
06;2021-07-04;318;303;625593;459906;58.0;42.6
06;2021-07-05;4079;5142;629672;465048;58.3;43.1
06;2021-07-06;2147;5813;631819;470861;58.5;43.6
06;2021-07-07;4188;5980;636007;476841;58.9;44.2
06;2021-07-08;3732;6335;639739;483176;59.3;44.8
06;2021-07-09;4869;6239;644608;489415;59.7;45.3
06;2021-07-10;1776;2330;646384;491745;59.9;45.6
06;2021-07-11;332;322;646716;492067;59.9;45.6
06;2021-07-12;4210;7150;650926;499217;60.3;46.2
06;2021-07-13;6129;9024;657055;508241;60.9;47.1
06;2021-07-14;1251;442;658306;508683;61.0;47.1
06;2021-07-15;6852;8036;665158;516719;61.6;47.9
06;2021-07-16;8541;9035;673699;525754;62.4;48.7
06;2021-07-17;3170;5477;676869;531231;62.7;49.2
06;2021-07-18;1079;5332;677948;536563;62.8;49.7
06;2021-07-19;6168;8030;684116;544593;63.4;50.5
06;2021-07-20;7600;10259;691716;554852;64.1;51.4
06;2021-07-21;8478;8715;700194;563567;64.9;52.2
06;2021-07-22;10455;7883;710649;571450;65.8;52.9
06;2021-07-23;9566;6931;720215;578381;66.7;53.6
06;2021-07-24;3303;3105;723518;581486;67.0;53.9
06;2021-07-25;1002;480;724520;581966;67.1;53.9
06;2021-07-26;7664;6891;732184;588857;67.8;54.6
06;2021-07-27;9276;5593;741460;594450;68.7;55.1
06;2021-07-28;7491;5406;748951;599856;69.4;55.6
06;2021-07-29;8892;5786;757843;605642;70.2;56.1
06;2021-07-30;8556;5558;766399;611200;71.0;56.6
06;2021-07-31;3829;3082;770228;614282;71.4;56.9
06;2021-08-01;900;436;771128;614718;71.4;57.0
06;2021-08-02;7141;4627;778269;619345;72.1;57.4
06;2021-08-03;6860;5499;785129;624844;72.7;57.9
06;2021-08-04;5835;3518;790964;628362;73.3;58.2
06;2021-08-05;6785;4472;797749;632834;73.9;58.6
06;2021-08-06;6113;6118;803862;638952;74.5;59.2
06;2021-08-07;2322;2474;806184;641426;74.7;59.4
06;2021-08-08;614;630;806798;642056;74.7;59.5
06;2021-08-09;4875;6036;811673;648092;75.2;60.0
06;2021-08-10;5518;6914;817191;655006;75.7;60.7
06;2021-08-11;4455;6216;821646;661222;76.1;61.3
06;2021-08-12;4738;6741;826384;667963;76.6;61.9
06;2021-08-13;3875;6456;830259;674419;76.9;62.5
06;2021-08-14;1598;2275;831857;676694;77.1;62.7
06;2021-08-15;417;639;832274;677333;77.1;62.8
06;2021-08-16;3290;6910;835564;684243;77.4;63.4
06;2021-08-17;3836;7781;839400;692024;77.8;64.1
06;2021-08-18;2993;6410;842393;698434;78.0;64.7
06;2021-08-19;4015;8127;846408;706561;78.4;65.5
06;2021-08-20;3277;6530;849685;713091;78.7;66.1
06;2021-08-21;1838;3593;851523;716684;78.9;66.4
06;2021-08-22;389;712;851912;717396;78.9;66.5
06;2021-08-23;2465;6531;854377;723927;79.2;67.1
06;2021-08-24;2870;6472;857247;730399;79.4;67.7
06;2021-08-25;2618;5680;859865;736079;79.7;68.2
06;2021-08-26;2730;6888;862595;742967;79.9;68.8
06;2021-08-27;2643;7077;865238;750044;80.2;69.5
06;2021-08-28;1293;3334;866531;753378;80.3;69.8
06;2021-08-29;295;826;866826;754204;80.3;69.9
06;2021-08-30;2461;6384;869287;760588;80.5;70.5
06;2021-08-31;2764;7144;872051;767732;80.8;71.1
06;2021-09-01;2313;5811;874364;773543;81.0;71.7
06;2021-09-02;2434;6433;876798;779976;81.2;72.3
06;2021-09-03;2156;6880;878954;786856;81.4;72.9
06;2021-09-04;1366;3656;880320;790512;81.6;73.2
06;2021-09-05;277;530;880597;791042;81.6;73.3
06;2021-09-06;1439;4913;882036;795955;81.7;73.7
06;2021-09-07;1605;5269;883641;801224;81.9;74.2
06;2021-09-08;1551;4467;885192;805691;82.0;74.6
06;2021-09-09;1409;4189;886601;809880;82.1;75.0
06;2021-09-10;1777;4268;888378;814148;82.3;75.4
06;2021-09-11;1057;2462;889435;816610;82.4;75.7
06;2021-09-12;141;337;889576;816947;82.4;75.7
06;2021-09-13;1280;3535;890856;820482;82.5;76.0
06;2021-09-14;1515;3145;892371;823627;82.7;76.3
06;2021-09-15;1467;2754;893838;826381;82.8;76.6
06;2021-09-16;1341;2418;895179;828799;82.9;76.8
06;2021-09-17;1474;2867;896653;831666;83.1;77.0
06;2021-09-18;686;1961;897339;833627;83.1;77.2
06;2021-09-19;108;289;897447;833916;83.1;77.3
06;2021-09-20;715;2135;898162;836051;83.2;77.5
06;2021-09-21;985;2475;899147;838526;83.3;77.7
06;2021-09-22;1044;2511;900191;841037;83.4;77.9
06;2021-09-23;806;2191;900997;843228;83.5;78.1
06;2021-09-24;907;2350;901904;845578;83.6;78.3
06;2021-09-25;483;1776;902387;847354;83.6;78.5
06;2021-09-26;96;217;902483;847571;83.6;78.5
06;2021-09-27;649;1605;903132;849176;83.7;78.7
06;2021-09-28;532;1592;903664;850768;83.7;78.8
06;2021-09-29;798;1783;904462;852551;83.8;79.0
07;2020-12-27;0;0;0;0;0.0;0.0
07;2020-12-28;0;0;0;0;0.0;0.0
07;2020-12-29;0;0;0;0;0.0;0.0
07;2020-12-30;0;0;0;0;0.0;0.0
07;2020-12-31;0;0;0;0;0.0;0.0
07;2021-01-01;7;0;7;0;0.0;0.0
07;2021-01-02;0;0;7;0;0.0;0.0
07;2021-01-03;0;0;7;0;0.0;0.0
07;2021-01-04;0;0;7;0;0.0;0.0
07;2021-01-05;0;0;7;0;0.0;0.0
07;2021-01-06;31;0;38;0;0.0;0.0
07;2021-01-07;130;1;168;1;0.1;0.0
07;2021-01-08;45;1;213;2;0.1;0.0
07;2021-01-09;17;0;230;2;0.1;0.0
07;2021-01-10;0;0;230;2;0.1;0.0
07;2021-01-11;157;1;387;3;0.1;0.0
07;2021-01-12;310;0;697;3;0.2;0.0
07;2021-01-13;308;1;1005;4;0.3;0.0
07;2021-01-14;476;0;1481;4;0.5;0.0
07;2021-01-15;188;0;1669;4;0.5;0.0
07;2021-01-16;17;0;1686;4;0.5;0.0
07;2021-01-17;2;0;1688;4;0.5;0.0
07;2021-01-18;364;4;2052;8;0.6;0.0
07;2021-01-19;830;2;2882;10;0.9;0.0
07;2021-01-20;605;1;3487;11;1.1;0.0
07;2021-01-21;452;3;3939;14;1.2;0.0
07;2021-01-22;292;0;4231;14;1.3;0.0
07;2021-01-23;107;0;4338;14;1.3;0.0
07;2021-01-24;0;0;4338;14;1.3;0.0
07;2021-01-25;164;0;4502;14;1.4;0.0
07;2021-01-26;491;4;4993;18;1.5;0.0
07;2021-01-27;557;8;5550;26;1.7;0.0
07;2021-01-28;1207;102;6757;128;2.1;0.0
07;2021-01-29;707;17;7464;145;2.3;0.0
07;2021-01-30;212;4;7676;149;2.3;0.0
07;2021-01-31;7;0;7683;149;2.4;0.0
07;2021-02-01;267;17;7950;166;2.4;0.1
07;2021-02-02;664;194;8614;360;2.6;0.1
07;2021-02-03;1046;176;9660;536;3.0;0.2
07;2021-02-04;722;248;10382;784;3.2;0.2
07;2021-02-05;484;240;10866;1024;3.3;0.3
07;2021-02-06;97;2;10963;1026;3.4;0.3
07;2021-02-07;12;1;10975;1027;3.4;0.3
07;2021-02-08;239;143;11214;1170;3.4;0.4
07;2021-02-09;490;304;11704;1474;3.6;0.5
07;2021-02-10;538;366;12242;1840;3.7;0.6
07;2021-02-11;400;243;12642;2083;3.9;0.6
07;2021-02-12;266;146;12908;2229;3.9;0.7
07;2021-02-13;69;16;12977;2245;4.0;0.7
07;2021-02-14;1;0;12978;2245;4.0;0.7
07;2021-02-15;270;103;13248;2348;4.1;0.7
07;2021-02-16;350;310;13598;2658;4.2;0.8
07;2021-02-17;466;284;14064;2942;4.3;0.9
07;2021-02-18;564;719;14628;3661;4.5;1.1
07;2021-02-19;457;474;15085;4135;4.6;1.3
07;2021-02-20;109;58;15194;4193;4.6;1.3
07;2021-02-21;15;0;15209;4193;4.7;1.3
07;2021-02-22;425;178;15634;4371;4.8;1.3
07;2021-02-23;646;581;16280;4952;5.0;1.5
07;2021-02-24;927;655;17207;5607;5.3;1.7
07;2021-02-25;710;468;17917;6075;5.5;1.9
07;2021-02-26;844;243;18761;6318;5.7;1.9
07;2021-02-27;190;138;18951;6456;5.8;2.0
07;2021-02-28;1;0;18952;6456;5.8;2.0
07;2021-03-01;438;179;19390;6635;5.9;2.0
07;2021-03-02;657;523;20047;7158;6.1;2.2
07;2021-03-03;693;477;20740;7635;6.3;2.3
07;2021-03-04;1100;311;21840;7946;6.7;2.4
07;2021-03-05;1084;340;22924;8286;7.0;2.5
07;2021-03-06;1125;96;24049;8382;7.4;2.6
07;2021-03-07;717;20;24766;8402;7.6;2.6
07;2021-03-08;352;278;25118;8680;7.7;2.7
07;2021-03-09;1089;393;26207;9073;8.0;2.8
07;2021-03-10;867;501;27074;9574;8.3;2.9
07;2021-03-11;1373;442;28447;10016;8.7;3.1
07;2021-03-12;1618;542;30065;10558;9.2;3.2
07;2021-03-13;683;89;30748;10647;9.4;3.3
07;2021-03-14;4;0;30752;10647;9.4;3.3
07;2021-03-15;525;274;31277;10921;9.6;3.3
07;2021-03-16;1209;475;32486;11396;9.9;3.5
07;2021-03-17;1189;769;33675;12165;10.3;3.7
07;2021-03-18;1217;405;34892;12570;10.7;3.8
07;2021-03-19;1268;422;36160;12992;11.1;4.0
07;2021-03-20;467;106;36627;13098;11.2;4.0
07;2021-03-21;3;1;36630;13099;11.2;4.0
07;2021-03-22;790;530;37420;13629;11.4;4.2
07;2021-03-23;1517;710;38937;14339;11.9;4.4
07;2021-03-24;1278;660;40215;14999;12.3;4.6
07;2021-03-25;1852;508;42067;15507;12.9;4.7
07;2021-03-26;1834;436;43901;15943;13.4;4.9
07;2021-03-27;384;96;44285;16039;13.5;4.9
07;2021-03-28;6;1;44291;16040;13.5;4.9
07;2021-03-29;789;354;45080;16394;13.8;5.0
07;2021-03-30;1526;509;46606;16903;14.3;5.2
07;2021-03-31;1662;507;48268;17410;14.8;5.3
07;2021-04-01;1589;661;49857;18071;15.3;5.5
07;2021-04-02;1522;439;51379;18510;15.7;5.7
07;2021-04-03;230;106;51609;18616;15.8;5.7
07;2021-04-04;3;1;51612;18617;15.8;5.7
07;2021-04-05;0;66;51612;18683;15.8;5.7
07;2021-04-06;1159;759;52771;19442;16.1;5.9
07;2021-04-07;1316;900;54087;20342;16.5;6.2
07;2021-04-08;1969;1176;56056;21518;17.1;6.6
07;2021-04-09;2423;566;58479;22084;17.9;6.8
07;2021-04-10;807;162;59286;22246;18.1;6.8
07;2021-04-11;339;12;59625;22258;18.2;6.8
07;2021-04-12;1287;596;60912;22854;18.6;7.0
07;2021-04-13;1767;1338;62679;24192;19.2;7.4
07;2021-04-14;1685;1015;64364;25207;19.7;7.7
07;2021-04-15;1443;842;65807;26049;20.1;8.0
07;2021-04-16;1506;911;67313;26960;20.6;8.2
07;2021-04-17;870;216;68183;27176;20.9;8.3
07;2021-04-18;699;38;68882;27214;21.1;8.3
07;2021-04-19;1161;574;70043;27788;21.4;8.5
07;2021-04-20;1441;1318;71484;29106;21.9;8.9
07;2021-04-21;1719;916;73203;30022;22.4;9.2
07;2021-04-22;1817;965;75020;30987;23.0;9.5
07;2021-04-23;1411;969;76431;31956;23.4;9.8
07;2021-04-24;962;251;77393;32207;23.7;9.9
07;2021-04-25;717;69;78110;32276;23.9;9.9
07;2021-04-26;1137;678;79247;32954;24.2;10.1
07;2021-04-27;1394;1565;80641;34519;24.7;10.6
07;2021-04-28;1635;1755;82276;36274;25.2;11.1
07;2021-04-29;1938;1531;84214;37805;25.8;11.6
07;2021-04-30;1661;1479;85875;39284;26.3;12.0
07;2021-05-01;960;119;86835;39403;26.6;12.1
07;2021-05-02;844;155;87679;39558;26.8;12.1
07;2021-05-03;1280;434;88959;39992;27.2;12.2
07;2021-05-04;2170;1566;91129;41558;27.9;12.7
07;2021-05-05;1744;1386;92873;42944;28.4;13.1
07;2021-05-06;2101;1587;94974;44531;29.1;13.6
07;2021-05-07;1597;1553;96571;46084;29.5;14.1
07;2021-05-08;1230;403;97801;46487;29.9;14.2
07;2021-05-09;1030;326;98831;46813;30.2;14.3
07;2021-05-10;1406;1176;100237;47989;30.7;14.7
07;2021-05-11;2470;1693;102707;49682;31.4;15.2
07;2021-05-12;2164;1277;104871;50959;32.1;15.6
07;2021-05-13;1712;273;106583;51232;32.6;15.7
07;2021-05-14;1734;996;108317;52228;33.1;16.0
07;2021-05-15;1626;500;109943;52728;33.6;16.1
07;2021-05-16;1442;213;111385;52941;34.1;16.2
07;2021-05-17;1771;857;113156;53798;34.6;16.5
07;2021-05-18;2295;1302;115451;55100;35.3;16.9
07;2021-05-19;2375;1000;117826;56100;36.0;17.2
07;2021-05-20;2165;1308;119991;57408;36.7;17.6
07;2021-05-21;1757;1312;121748;58720;37.2;18.0
07;2021-05-22;935;542;122683;59262;37.5;18.1
07;2021-05-23;856;157;123539;59419;37.8;18.2
07;2021-05-24;1648;338;125187;59757;38.3;18.3
07;2021-05-25;2184;1477;127371;61234;39.0;18.7
07;2021-05-26;1526;1379;128897;62613;39.4;19.2
07;2021-05-27;2015;1411;130912;64024;40.0;19.6
07;2021-05-28;1770;2078;132682;66102;40.6;20.2
07;2021-05-29;942;683;133624;66785;40.9;20.4
07;2021-05-30;622;570;134246;67355;41.1;20.6
07;2021-05-31;1133;1281;135379;68636;41.4;21.0
07;2021-06-01;2153;2001;137532;70637;42.1;21.6
07;2021-06-02;1531;1653;139063;72290;42.5;22.1
07;2021-06-03;1712;1254;140775;73544;43.1;22.5
07;2021-06-04;1676;1593;142451;75137;43.6;23.0
07;2021-06-05;987;955;143438;76092;43.9;23.3
07;2021-06-06;598;624;144036;76716;44.1;23.5
07;2021-06-07;961;1193;144997;77909;44.4;23.8
07;2021-06-08;1548;1771;146545;79680;44.8;24.4
07;2021-06-09;1030;1418;147575;81098;45.1;24.8
07;2021-06-10;789;1388;148364;82486;45.4;25.2
07;2021-06-11;1154;2032;149518;84518;45.7;25.9
07;2021-06-12;643;1217;150161;85735;45.9;26.2
07;2021-06-13;395;444;150556;86179;46.1;26.4
07;2021-06-14;566;1958;151122;88137;46.2;27.0
07;2021-06-15;936;2550;152058;90687;46.5;27.7
07;2021-06-16;1023;1852;153081;92539;46.8;28.3
07;2021-06-17;885;1949;153966;94488;47.1;28.9
07;2021-06-18;868;2281;154834;96769;47.4;29.6
07;2021-06-19;603;1452;155437;98221;47.6;30.0
07;2021-06-20;369;728;155806;98949;47.7;30.3
07;2021-06-21;516;2143;156322;101092;47.8;30.9
07;2021-06-22;655;2661;156977;103753;48.0;31.7
07;2021-06-23;680;1960;157657;105713;48.2;32.3
07;2021-06-24;646;1849;158303;107562;48.4;32.9
07;2021-06-25;701;2175;159004;109737;48.6;33.6
07;2021-06-26;362;1430;159366;111167;48.8;34.0
07;2021-06-27;285;1073;159651;112240;48.8;34.3
07;2021-06-28;506;2241;160157;114481;49.0;35.0
07;2021-06-29;540;2986;160697;117467;49.2;35.9
07;2021-06-30;822;2279;161519;119746;49.4;36.6
07;2021-07-01;776;1951;162295;121697;49.7;37.2
07;2021-07-02;880;2294;163175;123991;49.9;37.9
07;2021-07-03;421;1137;163596;125128;50.0;38.3
07;2021-07-04;211;852;163807;125980;50.1;38.5
07;2021-07-05;670;1685;164477;127665;50.3;39.1
07;2021-07-06;880;2630;165357;130295;50.6;39.9
07;2021-07-07;969;1951;166326;132246;50.9;40.5
07;2021-07-08;928;1959;167254;134205;51.2;41.1
07;2021-07-09;994;2262;168248;136467;51.5;41.7
07;2021-07-10;598;1100;168846;137567;51.7;42.1
07;2021-07-11;239;614;169085;138181;51.7;42.3
07;2021-07-12;807;1769;169892;139950;52.0;42.8
07;2021-07-13;1770;3171;171662;143121;52.5;43.8
07;2021-07-14;167;133;171829;143254;52.6;43.8
07;2021-07-15;1960;2466;173789;145720;53.2;44.6
07;2021-07-16;2056;1987;175845;147707;53.8;45.2
07;2021-07-17;1484;1249;177329;148956;54.2;45.6
07;2021-07-18;771;480;178100;149436;54.5;45.7
07;2021-07-19;1515;1687;179615;151123;54.9;46.2
07;2021-07-20;2519;2679;182134;153802;55.7;47.1
07;2021-07-21;1856;1915;183990;155717;56.3;47.6
07;2021-07-22;1919;1375;185909;157092;56.9;48.1
07;2021-07-23;2266;1688;188175;158780;57.6;48.6
07;2021-07-24;1642;1112;189817;159892;58.1;48.9
07;2021-07-25;34;22;189851;159914;58.1;48.9
07;2021-07-26;2198;1541;192049;161455;58.8;49.4
07;2021-07-27;3016;1915;195065;163370;59.7;50.0
07;2021-07-28;1642;1308;196707;164678;60.2;50.4
07;2021-07-29;2541;1274;199248;165952;61.0;50.8
07;2021-07-30;1356;1415;200604;167367;61.4;51.2
07;2021-07-31;1506;922;202110;168289;61.8;51.5
07;2021-08-01;74;26;202184;168315;61.9;51.5
07;2021-08-02;1515;1133;203699;169448;62.3;51.8
07;2021-08-03;2417;1911;206116;171359;63.1;52.4
07;2021-08-04;1947;1031;208063;172390;63.7;52.7
07;2021-08-05;1893;1296;209956;173686;64.2;53.1
07;2021-08-06;2033;1709;211989;175395;64.9;53.7
07;2021-08-07;998;556;212987;175951;65.2;53.8
07;2021-08-08;12;23;212999;175974;65.2;53.8
07;2021-08-09;1258;1382;214257;177356;65.5;54.3
07;2021-08-10;1601;2259;215858;179615;66.0;54.9
07;2021-08-11;1400;1600;217258;181215;66.5;55.4
07;2021-08-12;1104;1485;218362;182700;66.8;55.9
07;2021-08-13;1182;1790;219544;184490;67.2;56.4
07;2021-08-14;512;766;220056;185256;67.3;56.7
07;2021-08-15;9;28;220065;185284;67.3;56.7
07;2021-08-16;755;1328;220820;186612;67.6;57.1
07;2021-08-17;1338;2278;222158;188890;68.0;57.8
07;2021-08-18;879;1516;223037;190406;68.2;58.3
07;2021-08-19;1147;1697;224184;192103;68.6;58.8
07;2021-08-20;899;2086;225083;194189;68.9;59.4
07;2021-08-21;364;549;225447;194738;69.0;59.6
07;2021-08-22;7;23;225454;194761;69.0;59.6
07;2021-08-23;467;1307;225921;196068;69.1;60.0
07;2021-08-24;1124;2312;227045;198380;69.5;60.7
07;2021-08-25;691;1837;227736;200217;69.7;61.3
07;2021-08-26;688;2021;228424;202238;69.9;61.9
07;2021-08-27;784;1829;229208;204067;70.1;62.4
07;2021-08-28;338;608;229546;204675;70.2;62.6
07;2021-08-29;1;33;229547;204708;70.2;62.6
07;2021-08-30;429;1325;229976;206033;70.4;63.0
07;2021-08-31;1093;2284;231069;208317;70.7;63.7
07;2021-09-01;543;1396;231612;209713;70.9;64.2
07;2021-09-02;603;1543;232215;211256;71.0;64.6
07;2021-09-03;740;1891;232955;213147;71.3;65.2
07;2021-09-04;308;716;233263;213863;71.4;65.4
07;2021-09-05;26;28;233289;213891;71.4;65.4
07;2021-09-06;403;1029;233692;214920;71.5;65.7
07;2021-09-07;520;1462;234212;216382;71.7;66.2
07;2021-09-08;442;1159;234654;217541;71.8;66.6
07;2021-09-09;475;1051;235129;218592;71.9;66.9
07;2021-09-10;518;1419;235647;220011;72.1;67.3
07;2021-09-11;167;660;235814;220671;72.1;67.5
07;2021-09-12;0;9;235814;220680;72.1;67.5
07;2021-09-13;347;617;236161;221297;72.2;67.7
07;2021-09-14;529;1125;236690;222422;72.4;68.0
07;2021-09-15;303;743;236993;223165;72.5;68.3
07;2021-09-16;426;566;237419;223731;72.6;68.4
07;2021-09-17;319;800;237738;224531;72.7;68.7
07;2021-09-18;100;454;237838;224985;72.8;68.8
07;2021-09-19;3;32;237841;225017;72.8;68.8
07;2021-09-20;238;365;238079;225382;72.8;69.0
07;2021-09-21;279;696;238358;226078;72.9;69.2
07;2021-09-22;172;724;238530;226802;73.0;69.4
07;2021-09-23;189;531;238719;227333;73.0;69.5
07;2021-09-24;277;838;238996;228171;73.1;69.8
07;2021-09-25;47;206;239043;228377;73.1;69.9
07;2021-09-26;5;17;239048;228394;73.1;69.9
07;2021-09-27;145;457;239193;228851;73.2;70.0
07;2021-09-28;177;522;239370;229373;73.2;70.2
07;2021-09-29;123;511;239493;229884;73.3;70.3
08;2020-12-27;1;0;1;0;0.0;0.0
08;2020-12-28;0;0;1;0;0.0;0.0
08;2020-12-29;0;0;1;0;0.0;0.0
08;2020-12-30;0;0;1;0;0.0;0.0
08;2020-12-31;0;0;1;0;0.0;0.0
08;2021-01-01;0;0;1;0;0.0;0.0
08;2021-01-02;0;0;1;0;0.0;0.0
08;2021-01-03;2;0;3;0;0.0;0.0
08;2021-01-04;24;0;27;0;0.0;0.0
08;2021-01-05;1;0;28;0;0.0;0.0
08;2021-01-06;0;0;28;0;0.0;0.0
08;2021-01-07;188;0;216;0;0.1;0.0
08;2021-01-08;315;0;531;0;0.2;0.0
08;2021-01-09;115;0;646;0;0.2;0.0
08;2021-01-10;1;0;647;0;0.2;0.0
08;2021-01-11;67;0;714;0;0.3;0.0
08;2021-01-12;157;0;871;0;0.3;0.0
08;2021-01-13;480;1;1351;1;0.5;0.0
08;2021-01-14;538;9;1889;10;0.7;0.0
08;2021-01-15;288;2;2177;12;0.8;0.0
08;2021-01-16;107;0;2284;12;0.9;0.0
08;2021-01-17;2;0;2286;12;0.9;0.0
08;2021-01-18;371;2;2657;14;1.0;0.0
08;2021-01-19;873;1;3530;15;1.3;0.0
08;2021-01-20;909;4;4439;19;1.7;0.0
08;2021-01-21;743;1;5182;20;2.0;0.0
08;2021-01-22;678;1;5860;21;2.2;0.0
08;2021-01-23;237;0;6097;21;2.3;0.0
08;2021-01-24;0;0;6097;21;2.3;0.0
08;2021-01-25;209;0;6306;21;2.4;0.0
08;2021-01-26;303;1;6609;22;2.5;0.0
08;2021-01-27;410;1;7019;23;2.6;0.0
08;2021-01-28;565;176;7584;199;2.9;0.1
08;2021-01-29;588;172;8172;371;3.1;0.1
08;2021-01-30;222;59;8394;430;3.2;0.2
08;2021-01-31;0;0;8394;430;3.2;0.2
08;2021-02-01;80;43;8474;473;3.2;0.2
08;2021-02-02;192;160;8666;633;3.3;0.2
08;2021-02-03;140;162;8806;795;3.3;0.3
08;2021-02-04;309;275;9115;1070;3.4;0.4
08;2021-02-05;499;341;9614;1411;3.6;0.5
08;2021-02-06;149;66;9763;1477;3.7;0.6
08;2021-02-07;8;0;9771;1477;3.7;0.6
08;2021-02-08;40;155;9811;1632;3.7;0.6
08;2021-02-09;220;605;10031;2237;3.8;0.8
08;2021-02-10;334;585;10365;2822;3.9;1.1
08;2021-02-11;466;320;10831;3142;4.1;1.2
08;2021-02-12;676;335;11507;3477;4.3;1.3
08;2021-02-13;140;91;11647;3568;4.4;1.3
08;2021-02-14;3;60;11650;3628;4.4;1.4
08;2021-02-15;227;166;11877;3794;4.5;1.4
08;2021-02-16;130;303;12007;4097;4.5;1.5
08;2021-02-17;112;314;12119;4411;4.6;1.7
08;2021-02-18;215;415;12334;4826;4.6;1.8
08;2021-02-19;305;336;12639;5162;4.8;1.9
08;2021-02-20;7;185;12646;5347;4.8;2.0
08;2021-02-21;0;0;12646;5347;4.8;2.0
08;2021-02-22;131;148;12777;5495;4.8;2.1
08;2021-02-23;150;260;12927;5755;4.9;2.2
08;2021-02-24;163;331;13090;6086;4.9;2.3
08;2021-02-25;500;439;13590;6525;5.1;2.5
08;2021-02-26;603;535;14193;7060;5.3;2.7
08;2021-02-27;318;174;14511;7234;5.5;2.7
08;2021-02-28;19;1;14530;7235;5.5;2.7
08;2021-03-01;200;90;14730;7325;5.5;2.8
08;2021-03-02;654;256;15384;7581;5.8;2.9
08;2021-03-03;898;183;16282;7764;6.1;2.9
08;2021-03-04;734;279;17016;8043;6.4;3.0
08;2021-03-05;1022;475;18038;8518;6.8;3.2
08;2021-03-06;695;137;18733;8655;7.1;3.3
08;2021-03-07;75;2;18808;8657;7.1;3.3
08;2021-03-08;217;122;19025;8779;7.2;3.3
08;2021-03-09;688;147;19713;8926;7.4;3.4
08;2021-03-10;1038;115;20751;9041;7.8;3.4
08;2021-03-11;982;232;21733;9273;8.2;3.5
08;2021-03-12;1631;504;23364;9777;8.8;3.7
08;2021-03-13;798;122;24162;9899;9.1;3.7
08;2021-03-14;22;0;24184;9899;9.1;3.7
08;2021-03-15;291;72;24475;9971;9.2;3.8
08;2021-03-16;563;38;25038;10009;9.4;3.8
08;2021-03-17;804;64;25842;10073;9.7;3.8
08;2021-03-18;816;157;26658;10230;10.0;3.9
08;2021-03-19;1135;277;27793;10507;10.5;4.0
08;2021-03-20;511;16;28304;10523;10.7;4.0
08;2021-03-21;13;1;28317;10524;10.7;4.0
08;2021-03-22;367;45;28684;10569;10.8;4.0
08;2021-03-23;733;63;29417;10632;11.1;4.0
08;2021-03-24;1327;70;30744;10702;11.6;4.0
08;2021-03-25;1906;97;32650;10799;12.3;4.1
08;2021-03-26;2571;171;35221;10970;13.3;4.1
08;2021-03-27;898;123;36119;11093;13.6;4.2
08;2021-03-28;228;7;36347;11100;13.7;4.2
08;2021-03-29;261;183;36608;11283;13.8;4.2
08;2021-03-30;832;482;37440;11765;14.1;4.4
08;2021-03-31;852;529;38292;12294;14.4;4.6
08;2021-04-01;1683;446;39975;12740;15.1;4.8
08;2021-04-02;1498;514;41473;13254;15.6;5.0
08;2021-04-03;1329;203;42802;13457;16.1;5.1
08;2021-04-04;134;4;42936;13461;16.2;5.1
08;2021-04-05;17;0;42953;13461;16.2;5.1
08;2021-04-06;702;481;43655;13942;16.4;5.3
08;2021-04-07;909;701;44564;14643;16.8;5.5
08;2021-04-08;1745;521;46309;15164;17.4;5.7
08;2021-04-09;2348;728;48657;15892;18.3;6.0
08;2021-04-10;1445;226;50102;16118;18.9;6.1
08;2021-04-11;10;6;50112;16124;18.9;6.1
08;2021-04-12;671;211;50783;16335;19.1;6.2
08;2021-04-13;1309;610;52092;16945;19.6;6.4
08;2021-04-14;1280;867;53372;17812;20.1;6.7
08;2021-04-15;1606;806;54978;18618;20.7;7.0
08;2021-04-16;1873;883;56851;19501;21.4;7.3
08;2021-04-17;1112;402;57963;19903;21.8;7.5
08;2021-04-18;23;14;57986;19917;21.8;7.5
08;2021-04-19;1151;298;59137;20215;22.3;7.6
08;2021-04-20;1120;543;60257;20758;22.7;7.8
08;2021-04-21;1139;745;61396;21503;23.1;8.1
08;2021-04-22;1326;879;62722;22382;23.6;8.4
08;2021-04-23;1675;1171;64397;23553;24.3;8.9
08;2021-04-24;1325;646;65722;24199;24.8;9.1
08;2021-04-25;26;198;65748;24397;24.8;9.2
08;2021-04-26;1040;156;66788;24553;25.2;9.2
08;2021-04-27;1338;592;68126;25145;25.7;9.5
08;2021-04-28;1453;665;69579;25810;26.2;9.7
08;2021-04-29;1173;1305;70752;27115;26.6;10.2
08;2021-04-30;1769;1606;72521;28721;27.3;10.8
08;2021-05-01;1049;494;73570;29215;27.7;11.0
08;2021-05-02;627;183;74197;29398;27.9;11.1
08;2021-05-03;1172;372;75369;29770;28.4;11.2
08;2021-05-04;1328;872;76697;30642;28.9;11.5
08;2021-05-05;1567;1335;78264;31977;29.5;12.0
08;2021-05-06;1971;1652;80235;33629;30.2;12.7
08;2021-05-07;1860;2097;82095;35726;30.9;13.5
08;2021-05-08;922;767;83017;36493;31.3;13.7
08;2021-05-09;443;71;83460;36564;31.4;13.8
08;2021-05-10;1192;657;84652;37221;31.9;14.0
08;2021-05-11;1907;942;86559;38163;32.6;14.4
08;2021-05-12;1809;1238;88368;39401;33.3;14.8
08;2021-05-13;1306;616;89674;40017;33.8;15.1
08;2021-05-14;2534;1036;92208;41053;34.7;15.5
08;2021-05-15;1820;711;94028;41764;35.4;15.7
08;2021-05-16;820;102;94848;41866;35.7;15.8
08;2021-05-17;700;906;95548;42772;36.0;16.1
08;2021-05-18;1250;838;96798;43610;36.5;16.4
08;2021-05-19;1611;960;98409;44570;37.1;16.8
08;2021-05-20;2147;956;100556;45526;37.9;17.1
08;2021-05-21;2339;1274;102895;46800;38.8;17.6
08;2021-05-22;1817;762;104712;47562;39.4;17.9
08;2021-05-23;864;90;105576;47652;39.8;17.9
08;2021-05-24;716;106;106292;47758;40.0;18.0
08;2021-05-25;1456;669;107748;48427;40.6;18.2
08;2021-05-26;1527;1008;109275;49435;41.2;18.6
08;2021-05-27;2005;1144;111280;50579;41.9;19.0
08;2021-05-28;1973;1812;113253;52391;42.7;19.7
08;2021-05-29;1767;960;115020;53351;43.3;20.1
08;2021-05-30;836;102;115856;53453;43.6;20.1
08;2021-05-31;755;569;116611;54022;43.9;20.3
08;2021-06-01;1350;876;117961;54898;44.4;20.7
08;2021-06-02;1295;1192;119256;56090;44.9;21.1
08;2021-06-03;1386;1521;120642;57611;45.4;21.7
08;2021-06-04;1777;2418;122419;60029;46.1;22.6
08;2021-06-05;1176;1380;123595;61409;46.5;23.1
08;2021-06-06;907;106;124502;61515;46.9;23.2
08;2021-06-07;661;1174;125163;62689;47.1;23.6
08;2021-06-08;931;1496;126094;64185;47.5;24.2
08;2021-06-09;840;1386;126934;65571;47.8;24.7
08;2021-06-10;1718;1562;128652;67133;48.5;25.3
08;2021-06-11;1721;2206;130373;69339;49.1;26.1
08;2021-06-12;1417;1526;131790;70865;49.6;26.7
08;2021-06-13;385;598;132175;71463;49.8;26.9
08;2021-06-14;380;1304;132555;72767;49.9;27.4
08;2021-06-15;742;1548;133297;74315;50.2;28.0
08;2021-06-16;808;2052;134105;76367;50.5;28.8
08;2021-06-17;1285;1850;135390;78217;51.0;29.5
08;2021-06-18;1610;2591;137000;80808;51.6;30.4
08;2021-06-19;1324;1405;138324;82213;52.1;31.0
08;2021-06-20;117;422;138441;82635;52.1;31.1
08;2021-06-21;494;1395;138935;84030;52.3;31.6
08;2021-06-22;810;2022;139745;86052;52.6;32.4
08;2021-06-23;859;1672;140604;87724;53.0;33.0
08;2021-06-24;1038;1923;141642;89647;53.3;33.8
08;2021-06-25;1084;2729;142726;92376;53.8;34.8
08;2021-06-26;1010;1784;143736;94160;54.1;35.5
08;2021-06-27;351;642;144087;94802;54.3;35.7
08;2021-06-28;397;1324;144484;96126;54.4;36.2
08;2021-06-29;627;1472;145111;97598;54.6;36.8
08;2021-06-30;857;1688;145968;99286;55.0;37.4
08;2021-07-01;887;2194;146855;101480;55.3;38.2
08;2021-07-02;939;2644;147794;104124;55.7;39.2
08;2021-07-03;784;2145;148578;106269;56.0;40.0
08;2021-07-04;128;861;148706;107130;56.0;40.3
08;2021-07-05;104;1195;148810;108325;56.0;40.8
08;2021-07-06;425;1834;149235;110159;56.2;41.5
08;2021-07-07;364;1781;149599;111940;56.3;42.2
08;2021-07-08;716;2016;150315;113956;56.6;42.9
08;2021-07-09;732;2432;151047;116388;56.9;43.8
08;2021-07-10;652;1998;151699;118386;57.1;44.6
08;2021-07-11;238;726;151937;119112;57.2;44.9
08;2021-07-12;312;1192;152249;120304;57.3;45.3
08;2021-07-13;947;1787;153196;122091;57.7;46.0
08;2021-07-14;179;329;153375;122420;57.8;46.1
08;2021-07-15;759;2448;154134;124868;58.0;47.0
08;2021-07-16;1084;2404;155218;127272;58.5;47.9
08;2021-07-17;992;2105;156210;129377;58.8;48.7
08;2021-07-18;346;741;156556;130118;59.0;49.0
08;2021-07-19;458;918;157014;131036;59.1;49.3
08;2021-07-20;878;1435;157892;132471;59.5;49.9
08;2021-07-21;1237;1716;159129;134187;59.9;50.5
08;2021-07-22;1149;2167;160278;136354;60.4;51.4
08;2021-07-23;1585;2442;161863;138796;61.0;52.3
08;2021-07-24;1309;1922;163172;140718;61.5;53.0
08;2021-07-25;774;445;163946;141163;61.7;53.2
08;2021-07-26;1323;844;165269;142007;62.2;53.5
08;2021-07-27;2186;1405;167455;143412;63.1;54.0
08;2021-07-28;2412;1453;169867;144865;64.0;54.6
08;2021-07-29;2601;1346;172468;146211;65.0;55.1
08;2021-07-30;2601;1587;175069;147798;65.9;55.7
08;2021-07-31;1972;1075;177041;148873;66.7;56.1
08;2021-08-01;935;301;177976;149174;67.0;56.2
08;2021-08-02;1255;682;179231;149856;67.5;56.4
08;2021-08-03;1635;822;180866;150678;68.1;56.7
08;2021-08-04;1493;665;182359;151343;68.7;57.0
08;2021-08-05;1905;977;184264;152320;69.4;57.4
08;2021-08-06;2589;1099;186853;153419;70.4;57.8
08;2021-08-07;1673;1161;188526;154580;71.0;58.2
08;2021-08-08;585;373;189111;154953;71.2;58.4
08;2021-08-09;672;534;189783;155487;71.5;58.6
08;2021-08-10;879;750;190662;156237;71.8;58.8
08;2021-08-11;523;791;191185;157028;72.0;59.1
08;2021-08-12;1161;1080;192346;158108;72.4;59.5
08;2021-08-13;1157;1012;193503;159120;72.9;59.9
08;2021-08-14;587;912;194090;160032;73.1;60.3
08;2021-08-15;137;273;194227;160305;73.1;60.4
08;2021-08-16;218;1177;194445;161482;73.2;60.8
08;2021-08-17;514;1210;194959;162692;73.4;61.3
08;2021-08-18;281;1263;195240;163955;73.5;61.7
08;2021-08-19;605;1888;195845;165843;73.8;62.5
08;2021-08-20;685;2178;196530;168021;74.0;63.3
08;2021-08-21;273;1340;196803;169361;74.1;63.8
08;2021-08-22;105;900;196908;170261;74.2;64.1
08;2021-08-23;160;1448;197068;171709;74.2;64.7
08;2021-08-24;364;1752;197432;173461;74.4;65.3
08;2021-08-25;322;1248;197754;174709;74.5;65.8
08;2021-08-26;502;2064;198256;176773;74.7;66.6
08;2021-08-27;450;2324;198706;179097;74.8;67.4
08;2021-08-28;260;1289;198966;180386;74.9;67.9
08;2021-08-29;169;562;199135;180948;75.0;68.1
08;2021-08-30;302;1170;199437;182118;75.1;68.6
08;2021-08-31;360;1284;199797;183402;75.2;69.1
08;2021-09-01;415;1353;200212;184755;75.4;69.6
08;2021-09-02;465;1297;200677;186052;75.6;70.1
08;2021-09-03;463;1695;201140;187747;75.8;70.7
08;2021-09-04;349;1468;201489;189215;75.9;71.3
08;2021-09-05;106;207;201595;189422;75.9;71.3
08;2021-09-06;196;516;201791;189938;76.0;71.5
08;2021-09-07;205;612;201996;190550;76.1;71.8
08;2021-09-08;280;598;202276;191148;76.2;72.0
08;2021-09-09;344;744;202620;191892;76.3;72.3
08;2021-09-10;494;1030;203114;192922;76.5;72.7
08;2021-09-11;383;852;203497;193774;76.6;73.0
08;2021-09-12;52;91;203549;193865;76.7;73.0
08;2021-09-13;381;255;203930;194120;76.8;73.1
08;2021-09-14;247;399;204177;194519;76.9;73.3
08;2021-09-15;219;316;204396;194835;77.0;73.4
08;2021-09-16;230;421;204626;195256;77.1;73.5
08;2021-09-17;320;500;204946;195756;77.2;73.7
08;2021-09-18;173;429;205119;196185;77.2;73.9
08;2021-09-19;29;90;205148;196275;77.3;73.9
08;2021-09-20;54;235;205202;196510;77.3;74.0
08;2021-09-21;123;277;205325;196787;77.3;74.1
08;2021-09-22;130;368;205455;197155;77.4;74.2
08;2021-09-23;170;412;205625;197567;77.4;74.4
08;2021-09-24;162;516;205787;198083;77.5;74.6
08;2021-09-25;122;414;205909;198497;77.5;74.8
08;2021-09-26;23;105;205932;198602;77.6;74.8
08;2021-09-27;47;211;205979;198813;77.6;74.9
08;2021-09-28;78;226;206057;199039;77.6;75.0
08;2021-09-29;116;339;206173;199378;77.6;75.1
09;2020-12-27;0;0;0;0;0.0;0.0
09;2020-12-28;1;0;1;0;0.0;0.0
09;2020-12-29;0;0;1;0;0.0;0.0
09;2020-12-30;0;0;1;0;0.0;0.0
09;2020-12-31;0;0;1;0;0.0;0.0
09;2021-01-01;0;0;1;0;0.0;0.0
09;2021-01-02;0;0;1;0;0.0;0.0
09;2021-01-03;0;0;1;0;0.0;0.0
09;2021-01-04;2;1;3;1;0.0;0.0
09;2021-01-05;0;0;3;1;0.0;0.0
09;2021-01-06;3;0;6;1;0.0;0.0
09;2021-01-07;257;2;263;3;0.2;0.0
09;2021-01-08;228;0;491;3;0.3;0.0
09;2021-01-09;103;0;594;3;0.4;0.0
09;2021-01-10;59;0;653;3;0.4;0.0
09;2021-01-11;175;0;828;3;0.5;0.0
09;2021-01-12;303;0;1131;3;0.7;0.0
09;2021-01-13;196;0;1327;3;0.9;0.0
09;2021-01-14;432;7;1759;10;1.2;0.0
09;2021-01-15;223;1;1982;11;1.3;0.0
09;2021-01-16;192;2;2174;13;1.4;0.0
09;2021-01-17;123;0;2297;13;1.5;0.0
09;2021-01-18;263;2;2560;15;1.7;0.0
09;2021-01-19;255;1;2815;16;1.8;0.0
09;2021-01-20;346;1;3161;17;2.1;0.0
09;2021-01-21;330;1;3491;18;2.3;0.0
09;2021-01-22;328;1;3819;19;2.5;0.0
09;2021-01-23;237;0;4056;19;2.7;0.0
09;2021-01-24;85;1;4141;20;2.7;0.0
09;2021-01-25;206;10;4347;30;2.9;0.0
09;2021-01-26;630;25;4977;55;3.3;0.0
09;2021-01-27;472;45;5449;100;3.6;0.1
09;2021-01-28;286;140;5735;240;3.8;0.2
09;2021-01-29;251;121;5986;361;3.9;0.2
09;2021-01-30;143;50;6129;411;4.0;0.3
09;2021-01-31;56;10;6185;421;4.1;0.3
09;2021-02-01;81;128;6266;549;4.1;0.4
09;2021-02-02;58;276;6324;825;4.1;0.5
09;2021-02-03;87;187;6411;1012;4.2;0.7
09;2021-02-04;49;260;6460;1272;4.2;0.8
09;2021-02-05;90;117;6550;1389;4.3;0.9
09;2021-02-06;68;31;6618;1420;4.3;0.9
09;2021-02-07;6;48;6624;1468;4.3;1.0
09;2021-02-08;22;139;6646;1607;4.4;1.1
09;2021-02-09;55;215;6701;1822;4.4;1.2
09;2021-02-10;14;121;6715;1943;4.4;1.3
09;2021-02-11;6;156;6721;2099;4.4;1.4
09;2021-02-12;147;100;6868;2199;4.5;1.4
09;2021-02-13;8;117;6876;2316;4.5;1.5
09;2021-02-14;0;35;6876;2351;4.5;1.5
09;2021-02-15;75;105;6951;2456;4.6;1.6
09;2021-02-16;227;424;7178;2880;4.7;1.9
09;2021-02-17;83;317;7261;3197;4.8;2.1
09;2021-02-18;87;351;7348;3548;4.8;2.3
09;2021-02-19;63;188;7411;3736;4.9;2.5
09;2021-02-20;58;143;7469;3879;4.9;2.5
09;2021-02-21;0;37;7469;3916;4.9;2.6
09;2021-02-22;127;165;7596;4081;5.0;2.7
09;2021-02-23;161;102;7757;4183;5.1;2.7
09;2021-02-24;74;141;7831;4324;5.1;2.8
09;2021-02-25;211;143;8042;4467;5.3;2.9
09;2021-02-26;162;140;8204;4607;5.4;3.0
09;2021-02-27;65;45;8269;4652;5.4;3.1
09;2021-02-28;44;13;8313;4665;5.5;3.1
09;2021-03-01;248;83;8561;4748;5.6;3.1
09;2021-03-02;282;63;8843;4811;5.8;3.2
09;2021-03-03;252;120;9095;4931;6.0;3.2
09;2021-03-04;414;29;9509;4960;6.2;3.3
09;2021-03-05;331;48;9840;5008;6.5;3.3
09;2021-03-06;397;41;10237;5049;6.7;3.3
09;2021-03-07;124;4;10361;5053;6.8;3.3
09;2021-03-08;380;60;10741;5113;7.0;3.4
09;2021-03-09;437;130;11178;5243;7.3;3.4
09;2021-03-10;562;71;11740;5314;7.7;3.5
09;2021-03-11;695;77;12435;5391;8.2;3.5
09;2021-03-12;660;31;13095;5422;8.6;3.6
09;2021-03-13;384;3;13479;5425;8.8;3.6
09;2021-03-14;120;4;13599;5429;8.9;3.6
09;2021-03-15;465;50;14064;5479;9.2;3.6
09;2021-03-16;370;77;14434;5556;9.5;3.6
09;2021-03-17;399;71;14833;5627;9.7;3.7
09;2021-03-18;454;42;15287;5669;10.0;3.7
09;2021-03-19;525;56;15812;5725;10.4;3.8
09;2021-03-20;314;39;16126;5764;10.6;3.8
09;2021-03-21;105;0;16231;5764;10.7;3.8
09;2021-03-22;424;117;16655;5881;10.9;3.9
09;2021-03-23;566;164;17221;6045;11.3;4.0
09;2021-03-24;710;43;17931;6088;11.8;4.0
09;2021-03-25;869;134;18800;6222;12.3;4.1
09;2021-03-26;751;47;19551;6269;12.8;4.1
09;2021-03-27;620;70;20171;6339;13.2;4.2
09;2021-03-28;132;24;20303;6363;13.3;4.2
09;2021-03-29;498;273;20801;6636;13.6;4.4
09;2021-03-30;729;153;21530;6789;14.1;4.5
09;2021-03-31;803;182;22333;6971;14.7;4.6
09;2021-04-01;734;253;23067;7224;15.1;4.7
09;2021-04-02;693;264;23760;7488;15.6;4.9
09;2021-04-03;772;117;24532;7605;16.1;5.0
09;2021-04-04;122;57;24654;7662;16.2;5.0
09;2021-04-05;237;61;24891;7723;16.3;5.1
09;2021-04-06;1059;390;25950;8113;17.0;5.3
09;2021-04-07;1207;360;27157;8473;17.8;5.6
09;2021-04-08;1470;409;28627;8882;18.8;5.8
09;2021-04-09;1137;416;29764;9298;19.5;6.1
09;2021-04-10;1349;196;31113;9494;20.4;6.2
09;2021-04-11;173;101;31286;9595;20.5;6.3
09;2021-04-12;737;345;32023;9940;21.0;6.5
09;2021-04-13;1047;413;33070;10353;21.7;6.8
09;2021-04-14;1332;510;34402;10863;22.6;7.1
09;2021-04-15;1148;502;35550;11365;23.3;7.5
09;2021-04-16;1032;405;36582;11770;24.0;7.7
09;2021-04-17;1192;356;37774;12126;24.8;8.0
09;2021-04-18;102;96;37876;12222;24.9;8.0
09;2021-04-19;697;407;38573;12629;25.3;8.3
09;2021-04-20;766;528;39339;13157;25.8;8.6
09;2021-04-21;938;587;40277;13744;26.4;9.0
09;2021-04-22;666;605;40943;14349;26.9;9.4
09;2021-04-23;773;431;41716;14780;27.4;9.7
09;2021-04-24;741;669;42457;15449;27.9;10.1
09;2021-04-25;75;112;42532;15561;27.9;10.2
09;2021-04-26;382;529;42914;16090;28.2;10.6
09;2021-04-27;444;719;43358;16809;28.5;11.0
09;2021-04-28;806;794;44164;17603;29.0;11.6
09;2021-04-29;550;776;44714;18379;29.3;12.1
09;2021-04-30;622;722;45336;19101;29.7;12.5
09;2021-05-01;478;455;45814;19556;30.1;12.8
09;2021-05-02;51;100;45865;19656;30.1;12.9
09;2021-05-03;521;662;46386;20318;30.4;13.3
09;2021-05-04;554;1347;46940;21665;30.8;14.2
09;2021-05-05;822;1348;47762;23013;31.3;15.1
09;2021-05-06;848;1031;48610;24044;31.9;15.8
09;2021-05-07;977;822;49587;24866;32.5;16.3
09;2021-05-08;395;461;49982;25327;32.8;16.6
09;2021-05-09;265;85;50247;25412;33.0;16.7
09;2021-05-10;504;966;50751;26378;33.3;17.3
09;2021-05-11;741;1052;51492;27430;33.8;18.0
09;2021-05-12;1535;1401;53027;28831;34.8;18.9
09;2021-05-13;1383;425;54410;29256;35.7;19.2
09;2021-05-14;987;653;55397;29909;36.4;19.6
09;2021-05-15;1236;789;56633;30698;37.2;20.1
09;2021-05-16;296;48;56929;30746;37.4;20.2
09;2021-05-17;873;412;57802;31158;37.9;20.4
09;2021-05-18;1290;395;59092;31553;38.8;20.7
09;2021-05-19;1495;371;60587;31924;39.8;20.9
09;2021-05-20;1379;404;61966;32328;40.7;21.2
09;2021-05-21;1162;495;63128;32823;41.4;21.5
09;2021-05-22;1544;364;64672;33187;42.4;21.8
09;2021-05-23;272;24;64944;33211;42.6;21.8
09;2021-05-24;177;100;65121;33311;42.7;21.9
09;2021-05-25;998;500;66119;33811;43.4;22.2
09;2021-05-26;1285;448;67404;34259;44.2;22.5
09;2021-05-27;965;403;68369;34662;44.9;22.7
09;2021-05-28;958;511;69327;35173;45.5;23.1
09;2021-05-29;1794;601;71121;35774;46.7;23.5
09;2021-05-30;541;197;71662;35971;47.0;23.6
09;2021-05-31;716;592;72378;36563;47.5;24.0
09;2021-06-01;970;639;73348;37202;48.1;24.4
09;2021-06-02;1009;897;74357;38099;48.8;25.0
09;2021-06-03;809;681;75166;38780;49.3;25.4
09;2021-06-04;877;797;76043;39577;49.9;26.0
09;2021-06-05;1320;875;77363;40452;50.8;26.5
09;2021-06-06;304;108;77667;40560;51.0;26.6
09;2021-06-07;623;517;78290;41077;51.4;27.0
09;2021-06-08;821;488;79111;41565;51.9;27.3
09;2021-06-09;805;834;79916;42399;52.4;27.8
09;2021-06-10;642;534;80558;42933;52.9;28.2
09;2021-06-11;831;762;81389;43695;53.4;28.7
09;2021-06-12;635;808;82024;44503;53.8;29.2
09;2021-06-13;94;130;82118;44633;53.9;29.3
09;2021-06-14;628;708;82746;45341;54.3;29.8
09;2021-06-15;824;889;83570;46230;54.8;30.3
09;2021-06-16;627;1079;84197;47309;55.2;31.0
09;2021-06-17;779;852;84976;48161;55.8;31.6
09;2021-06-18;635;1145;85611;49306;56.2;32.4
09;2021-06-19;516;1580;86127;50886;56.5;33.4
09;2021-06-20;8;279;86135;51165;56.5;33.6
09;2021-06-21;473;698;86608;51863;56.8;34.0
09;2021-06-22;463;1066;87071;52929;57.1;34.7
09;2021-06-23;435;1224;87506;54153;57.4;35.5
09;2021-06-24;581;769;88087;54922;57.8;36.0
09;2021-06-25;410;1064;88497;55986;58.1;36.7
09;2021-06-26;443;1087;88940;57073;58.4;37.4
09;2021-06-27;2;275;88942;57348;58.4;37.6
09;2021-06-28;239;1046;89181;58394;58.5;38.3
09;2021-06-29;314;1228;89495;59622;58.7;39.1
09;2021-06-30;455;1491;89950;61113;59.0;40.1
09;2021-07-01;384;1428;90334;62541;59.3;41.0
09;2021-07-02;308;1162;90642;63703;59.5;41.8
09;2021-07-03;210;1617;90852;65320;59.6;42.9
09;2021-07-04;4;253;90856;65573;59.6;43.0
09;2021-07-05;189;712;91045;66285;59.7;43.5
09;2021-07-06;293;1221;91338;67506;59.9;44.3
09;2021-07-07;419;1399;91757;68905;60.2;45.2
09;2021-07-08;325;1057;92082;69962;60.4;45.9
09;2021-07-09;292;1153;92374;71115;60.6;46.7
09;2021-07-10;345;1725;92719;72840;60.8;47.8
09;2021-07-11;147;392;92866;73232;60.9;48.1
09;2021-07-12;187;1074;93053;74306;61.1;48.8
09;2021-07-13;641;1308;93694;75614;61.5;49.6
09;2021-07-14;490;220;94184;75834;61.8;49.8
09;2021-07-15;818;1165;95002;76999;62.3;50.5
09;2021-07-16;610;1189;95612;78188;62.7;51.3
09;2021-07-17;1015;1444;96627;79632;63.4;52.3
09;2021-07-18;302;221;96929;79853;63.6;52.4
09;2021-07-19;483;973;97412;80826;63.9;53.0
09;2021-07-20;830;1256;98242;82082;64.5;53.9
09;2021-07-21;1016;1165;99258;83247;65.1;54.6
09;2021-07-22;846;910;100104;84157;65.7;55.2
09;2021-07-23;724;910;100828;85067;66.2;55.8
09;2021-07-24;927;463;101755;85530;66.8;56.1
09;2021-07-25;560;134;102315;85664;67.1;56.2
09;2021-07-26;647;765;102962;86429;67.6;56.7
09;2021-07-27;1177;949;104139;87378;68.3;57.3
09;2021-07-28;1197;987;105336;88365;69.1;58.0
09;2021-07-29;1042;738;106378;89103;69.8;58.5
09;2021-07-30;779;623;107157;89726;70.3;58.9
09;2021-07-31;1378;419;108535;90145;71.2;59.2
09;2021-08-01;141;125;108676;90270;71.3;59.2
09;2021-08-02;613;478;109289;90748;71.7;59.5
09;2021-08-03;1254;767;110543;91515;72.5;60.1
09;2021-08-04;1400;654;111943;92169;73.5;60.5
09;2021-08-05;997;677;112940;92846;74.1;60.9
09;2021-08-06;1017;641;113957;93487;74.8;61.3
09;2021-08-07;825;430;114782;93917;75.3;61.6
09;2021-08-08;129;131;114911;94048;75.4;61.7
09;2021-08-09;690;648;115601;94696;75.9;62.1
09;2021-08-10;940;694;116541;95390;76.5;62.6
09;2021-08-11;896;866;117437;96256;77.1;63.2
09;2021-08-12;631;730;118068;96986;77.5;63.6
09;2021-08-13;465;645;118533;97631;77.8;64.1
09;2021-08-14;311;828;118844;98459;78.0;64.6
09;2021-08-15;67;138;118911;98597;78.0;64.7
09;2021-08-16;547;620;119458;99217;78.4;65.1
09;2021-08-17;674;777;120132;99994;78.8;65.6
09;2021-08-18;620;931;120752;100925;79.2;66.2
09;2021-08-19;432;722;121184;101647;79.5;66.7
09;2021-08-20;363;749;121547;102396;79.8;67.2
09;2021-08-21;343;1384;121890;103780;80.0;68.1
09;2021-08-22;67;168;121957;103948;80.0;68.2
09;2021-08-23;341;758;122298;104706;80.2;68.7
09;2021-08-24;406;955;122704;105661;80.5;69.3
09;2021-08-25;283;1003;122987;106664;80.7;70.0
09;2021-08-26;316;928;123303;107592;80.9;70.6
09;2021-08-27;225;740;123528;108332;81.1;71.1
09;2021-08-28;257;970;123785;109302;81.2;71.7
09;2021-08-29;15;144;123800;109446;81.2;71.8
09;2021-08-30;275;749;124075;110195;81.4;72.3
09;2021-08-31;314;1150;124389;111345;81.6;73.1
09;2021-09-01;360;977;124749;112322;81.9;73.7
09;2021-09-02;159;605;124908;112927;82.0;74.1
09;2021-09-03;223;879;125131;113806;82.1;74.7
09;2021-09-04;166;539;125297;114345;82.2;75.0
09;2021-09-05;25;104;125322;114449;82.2;75.1
09;2021-09-06;182;651;125504;115100;82.4;75.5
09;2021-09-07;156;694;125660;115794;82.5;76.0
09;2021-09-08;202;919;125862;116713;82.6;76.6
09;2021-09-09;160;557;126022;117270;82.7;76.9
09;2021-09-10;130;475;126152;117745;82.8;77.3
09;2021-09-11;174;506;126326;118251;82.9;77.6
09;2021-09-12;27;80;126353;118331;82.9;77.6
09;2021-09-13;129;524;126482;118855;83.0;78.0
09;2021-09-14;142;689;126624;119544;83.1;78.4
09;2021-09-15;188;602;126812;120146;83.2;78.8
09;2021-09-16;130;324;126942;120470;83.3;79.0
09;2021-09-17;146;404;127088;120874;83.4;79.3
09;2021-09-18;158;345;127246;121219;83.5;79.5
09;2021-09-19;2;0;127248;121219;83.5;79.5
09;2021-09-20;71;290;127319;121509;83.5;79.7
09;2021-09-21;101;205;127420;121714;83.6;79.9
09;2021-09-22;141;471;127561;122185;83.7;80.2
09;2021-09-23;71;164;127632;122349;83.7;80.3
09;2021-09-24;117;289;127749;122638;83.8;80.5
09;2021-09-25;60;193;127809;122831;83.9;80.6
09;2021-09-26;0;17;127809;122848;83.9;80.6
09;2021-09-27;82;326;127891;123174;83.9;80.8
09;2021-09-28;74;175;127965;123349;84.0;80.9
09;2021-09-29;97;235;128062;123584;84.0;81.1
10;2020-12-27;0;0;0;0;0.0;0.0
10;2020-12-28;0;0;0;0;0.0;0.0
10;2020-12-29;0;0;0;0;0.0;0.0
10;2020-12-30;0;0;0;0;0.0;0.0
10;2020-12-31;0;0;0;0;0.0;0.0
10;2021-01-01;0;0;0;0;0.0;0.0
10;2021-01-02;1;0;1;0;0.0;0.0
10;2021-01-03;0;0;1;0;0.0;0.0
10;2021-01-04;0;0;1;0;0.0;0.0
10;2021-01-05;1;0;2;0;0.0;0.0
10;2021-01-06;0;0;2;0;0.0;0.0
10;2021-01-07;84;0;86;0;0.0;0.0
10;2021-01-08;255;0;341;0;0.1;0.0
10;2021-01-09;0;0;341;0;0.1;0.0
10;2021-01-10;1;0;342;0;0.1;0.0
10;2021-01-11;118;0;460;0;0.1;0.0
10;2021-01-12;195;0;655;0;0.2;0.0
10;2021-01-13;314;0;969;0;0.3;0.0
10;2021-01-14;392;8;1361;8;0.4;0.0
10;2021-01-15;359;3;1720;11;0.6;0.0
10;2021-01-16;56;0;1776;11;0.6;0.0
10;2021-01-17;0;0;1776;11;0.6;0.0
10;2021-01-18;702;0;2478;11;0.8;0.0
10;2021-01-19;1391;2;3869;13;1.2;0.0
10;2021-01-20;1082;7;4951;20;1.6;0.0
10;2021-01-21;1152;2;6103;22;2.0;0.0
10;2021-01-22;819;2;6922;24;2.2;0.0
10;2021-01-23;309;0;7231;24;2.3;0.0
10;2021-01-24;0;0;7231;24;2.3;0.0
10;2021-01-25;445;8;7676;32;2.5;0.0
10;2021-01-26;487;17;8163;49;2.6;0.0
10;2021-01-27;458;14;8621;63;2.8;0.0
10;2021-01-28;358;38;8979;101;2.9;0.0
10;2021-01-29;430;132;9409;233;3.0;0.1
10;2021-01-30;30;0;9439;233;3.0;0.1
10;2021-01-31;0;0;9439;233;3.0;0.1
10;2021-02-01;409;118;9848;351;3.2;0.1
10;2021-02-02;182;133;10030;484;3.2;0.2
10;2021-02-03;361;211;10391;695;3.4;0.2
10;2021-02-04;342;233;10733;928;3.5;0.3
10;2021-02-05;328;264;11061;1192;3.6;0.4
10;2021-02-06;3;35;11064;1227;3.6;0.4
10;2021-02-07;0;0;11064;1227;3.6;0.4
10;2021-02-08;190;310;11254;1537;3.6;0.5
10;2021-02-09;485;442;11739;1979;3.8;0.6
10;2021-02-10;667;455;12406;2434;4.0;0.8
10;2021-02-11;781;572;13187;3006;4.3;1.0
10;2021-02-12;580;517;13767;3523;4.4;1.1
10;2021-02-13;37;93;13804;3616;4.5;1.2
10;2021-02-14;0;0;13804;3616;4.5;1.2
10;2021-02-15;143;298;13947;3914;4.5;1.3
10;2021-02-16;116;411;14063;4325;4.5;1.4
10;2021-02-17;129;467;14192;4792;4.6;1.5
10;2021-02-18;217;413;14409;5205;4.6;1.7
10;2021-02-19;188;389;14597;5594;4.7;1.8
10;2021-02-20;24;151;14621;5745;4.7;1.9
10;2021-02-21;0;0;14621;5745;4.7;1.9
10;2021-02-22;77;343;14698;6088;4.7;2.0
10;2021-02-23;76;452;14774;6540;4.8;2.1
10;2021-02-24;114;305;14888;6845;4.8;2.2
10;2021-02-25;322;317;15210;7162;4.9;2.3
10;2021-02-26;351;257;15561;7419;5.0;2.4
10;2021-02-27;275;109;15836;7528;5.1;2.4
10;2021-02-28;0;0;15836;7528;5.1;2.4
10;2021-03-01;257;281;16093;7809;5.2;2.5
10;2021-03-02;435;322;16528;8131;5.3;2.6
10;2021-03-03;454;518;16982;8649;5.5;2.8
10;2021-03-04;636;462;17618;9111;5.7;2.9
10;2021-03-05;677;227;18295;9338;5.9;3.0
10;2021-03-06;950;42;19245;9380;6.2;3.0
10;2021-03-07;769;6;20014;9386;6.5;3.0
10;2021-03-08;502;398;20516;9784;6.6;3.2
10;2021-03-09;673;378;21189;10162;6.8;3.3
10;2021-03-10;661;333;21850;10495;7.1;3.4
10;2021-03-11;1174;225;23024;10720;7.4;3.5
10;2021-03-12;1338;231;24362;10951;7.9;3.5
10;2021-03-13;891;38;25253;10989;8.1;3.5
10;2021-03-14;1381;15;26634;11004;8.6;3.6
10;2021-03-15;821;77;27455;11081;8.9;3.6
10;2021-03-16;688;61;28143;11142;9.1;3.6
10;2021-03-17;831;68;28974;11210;9.3;3.6
10;2021-03-18;885;80;29859;11290;9.6;3.6
10;2021-03-19;952;64;30811;11354;9.9;3.7
10;2021-03-20;552;19;31363;11373;10.1;3.7
10;2021-03-21;1849;42;33212;11415;10.7;3.7
10;2021-03-22;879;74;34091;11489;11.0;3.7
10;2021-03-23;1244;89;35335;11578;11.4;3.7
10;2021-03-24;1311;58;36646;11636;11.8;3.8
10;2021-03-25;1676;227;38322;11863;12.4;3.8
10;2021-03-26;1432;115;39754;11978;12.8;3.9
10;2021-03-27;762;78;40516;12056;13.1;3.9
10;2021-03-28;1221;29;41737;12085;13.5;3.9
10;2021-03-29;648;303;42385;12388;13.7;4.0
10;2021-03-30;927;374;43312;12762;14.0;4.1
10;2021-03-31;617;358;43929;13120;14.2;4.2
10;2021-04-01;883;683;44812;13803;14.5;4.5
10;2021-04-02;1069;587;45881;14390;14.8;4.6
10;2021-04-03;540;603;46421;14993;15.0;4.8
10;2021-04-04;1826;263;48247;15256;15.6;4.9
10;2021-04-05;1843;43;50090;15299;16.2;4.9
10;2021-04-06;514;650;50604;15949;16.3;5.1
10;2021-04-07;592;540;51196;16489;16.5;5.3
10;2021-04-08;1060;606;52256;17095;16.9;5.5
10;2021-04-09;1130;612;53386;17707;17.2;5.7
10;2021-04-10;1769;350;55155;18057;17.8;5.8
10;2021-04-11;55;1220;55210;19277;17.8;6.2
10;2021-04-12;1001;807;56211;20084;18.1;6.5
10;2021-04-13;1506;894;57717;20978;18.6;6.8
10;2021-04-14;824;601;58541;21579;18.9;7.0
10;2021-04-15;1454;891;59995;22470;19.4;7.3
10;2021-04-16;1109;697;61104;23167;19.7;7.5
10;2021-04-17;2391;362;63495;23529;20.5;7.6
10;2021-04-18;1422;1785;64917;25314;20.9;8.2
10;2021-04-19;837;833;65754;26147;21.2;8.4
10;2021-04-20;546;1033;66300;27180;21.4;8.8
10;2021-04-21;636;973;66936;28153;21.6;9.1
10;2021-04-22;932;963;67868;29116;21.9;9.4
10;2021-04-23;2172;777;70040;29893;22.6;9.6
10;2021-04-24;2296;376;72336;30269;23.3;9.8
10;2021-04-25;1991;1214;74327;31483;24.0;10.2
10;2021-04-26;773;620;75100;32103;24.2;10.4
10;2021-04-27;895;536;75995;32639;24.5;10.5
10;2021-04-28;873;405;76868;33044;24.8;10.7
10;2021-04-29;1433;669;78301;33713;25.3;10.9
10;2021-04-30;2172;769;80473;34482;26.0;11.1
10;2021-05-01;1988;2167;82461;36649;26.6;11.8
10;2021-05-02;1948;1897;84409;38546;27.2;12.4
10;2021-05-03;622;447;85031;38993;27.4;12.6
10;2021-05-04;1144;1246;86175;40239;27.8;13.0
10;2021-05-05;1753;1021;87928;41260;28.4;13.3
10;2021-05-06;2257;948;90185;42208;29.1;13.6
10;2021-05-07;2218;1134;92403;43342;29.8;14.0
10;2021-05-08;2270;858;94673;44200;30.5;14.3
10;2021-05-09;2004;100;96677;44300;31.2;14.3
10;2021-05-10;531;1092;97208;45392;31.4;14.6
10;2021-05-11;1052;1027;98260;46419;31.7;15.0
10;2021-05-12;2062;883;100322;47302;32.4;15.3
10;2021-05-13;2181;435;102503;47737;33.1;15.4
10;2021-05-14;2728;673;105231;48410;34.0;15.6
10;2021-05-15;2423;2051;107654;50461;34.7;16.3
10;2021-05-16;2080;1448;109734;51909;35.4;16.7
10;2021-05-17;1451;442;111185;52351;35.9;16.9
10;2021-05-18;2510;640;113695;52991;36.7;17.1
10;2021-05-19;1553;639;115248;53630;37.2;17.3
10;2021-05-20;1892;847;117140;54477;37.8;17.6
10;2021-05-21;2318;618;119458;55095;38.5;17.8
10;2021-05-22;2179;421;121637;55516;39.2;17.9
10;2021-05-23;1816;138;123453;55654;39.8;18.0
10;2021-05-24;1968;177;125421;55831;40.5;18.0
10;2021-05-25;2195;491;127616;56322;41.2;18.2
10;2021-05-26;1679;419;129295;56741;41.7;18.3
10;2021-05-27;1659;752;130954;57493;42.3;18.6
10;2021-05-28;1720;1181;132674;58674;42.8;18.9
10;2021-05-29;2170;643;134844;59317;43.5;19.1
10;2021-05-30;1029;134;135873;59451;43.8;19.2
10;2021-05-31;1039;741;136912;60192;44.2;19.4
10;2021-06-01;1135;885;138047;61077;44.5;19.7
10;2021-06-02;1035;720;139082;61797;44.9;19.9
10;2021-06-03;1473;1066;140555;62863;45.4;20.3
10;2021-06-04;1768;2598;142323;65461;45.9;21.1
10;2021-06-05;1518;2450;143841;67911;46.4;21.9
10;2021-06-06;1005;1874;144846;69785;46.7;22.5
10;2021-06-07;700;1110;145546;70895;47.0;22.9
10;2021-06-08;896;1172;146442;72067;47.3;23.3
10;2021-06-09;880;911;147322;72978;47.5;23.5
10;2021-06-10;678;1070;148000;74048;47.8;23.9
10;2021-06-11;1199;2197;149199;76245;48.1;24.6
10;2021-06-12;856;2388;150055;78633;48.4;25.4
10;2021-06-13;401;1834;150456;80467;48.5;26.0
10;2021-06-14;538;742;150994;81209;48.7;26.2
10;2021-06-15;741;2129;151735;83338;49.0;26.9
10;2021-06-16;741;1858;152476;85196;49.2;27.5
10;2021-06-17;851;2457;153327;87653;49.5;28.3
10;2021-06-18;1030;2473;154357;90126;49.8;29.1
10;2021-06-19;981;2595;155338;92721;50.1;29.9
10;2021-06-20;549;1597;155887;94318;50.3;30.4
10;2021-06-21;684;1044;156571;95362;50.5;30.8
10;2021-06-22;745;1526;157316;96888;50.8;31.3
10;2021-06-23;653;2405;157969;99293;51.0;32.0
10;2021-06-24;786;2617;158755;101910;51.2;32.9
10;2021-06-25;730;3047;159485;104957;51.5;33.9
10;2021-06-26;514;2745;159999;107702;51.6;34.8
10;2021-06-27;402;1940;160401;109642;51.8;35.4
10;2021-06-28;683;1785;161084;111427;52.0;36.0
10;2021-06-29;616;2697;161700;114124;52.2;36.8
10;2021-06-30;534;1523;162234;115647;52.3;37.3
10;2021-07-01;555;2172;162789;117819;52.5;38.0
10;2021-07-02;664;2726;163453;120545;52.7;38.9
10;2021-07-03;529;2600;163982;123145;52.9;39.7
10;2021-07-04;411;1726;164393;124871;53.0;40.3
10;2021-07-05;667;2224;165060;127095;53.3;41.0
10;2021-07-06;651;2188;165711;129283;53.5;41.7
10;2021-07-07;639;1703;166350;130986;53.7;42.3
10;2021-07-08;751;1459;167101;132445;53.9;42.7
10;2021-07-09;820;1949;167921;134394;54.2;43.4
10;2021-07-10;632;2096;168553;136490;54.4;44.0
10;2021-07-11;500;1384;169053;137874;54.5;44.5
10;2021-07-12;783;1620;169836;139494;54.8;45.0
10;2021-07-13;1126;1874;170962;141368;55.2;45.6
10;2021-07-14;1169;1054;172131;142422;55.5;46.0
10;2021-07-15;1477;1980;173608;144402;56.0;46.6
10;2021-07-16;1241;2274;174849;146676;56.4;47.3
10;2021-07-17;1287;1738;176136;148414;56.8;47.9
10;2021-07-18;942;1225;177078;149639;57.1;48.3
10;2021-07-19;1361;1621;178439;151260;57.6;48.8
10;2021-07-20;1685;1431;180124;152691;58.1;49.3
10;2021-07-21;1395;1483;181519;154174;58.6;49.7
10;2021-07-22;1941;1598;183460;155772;59.2;50.3
10;2021-07-23;1606;1544;185066;157316;59.7;50.8
10;2021-07-24;1389;1227;186455;158543;60.2;51.2
10;2021-07-25;1251;789;187706;159332;60.6;51.4
10;2021-07-26;1914;1316;189620;160648;61.2;51.8
10;2021-07-27;2139;1070;191759;161718;61.9;52.2
10;2021-07-28;2094;1016;193853;162734;62.6;52.5
10;2021-07-29;2444;1205;196297;163939;63.3;52.9
10;2021-07-30;2176;1311;198473;165250;64.0;53.3
10;2021-07-31;1680;937;200153;166187;64.6;53.6
10;2021-08-01;1236;570;201389;166757;65.0;53.8
10;2021-08-02;1463;1337;202852;168094;65.5;54.2
10;2021-08-03;1635;897;204487;168991;66.0;54.5
10;2021-08-04;1370;1066;205857;170057;66.4;54.9
10;2021-08-05;1654;1345;207511;171402;67.0;55.3
10;2021-08-06;1835;1333;209346;172735;67.6;55.7
10;2021-08-07;1156;1133;210502;173868;67.9;56.1
10;2021-08-08;660;751;211162;174619;68.1;56.3
10;2021-08-09;1311;1542;212473;176161;68.6;56.8
10;2021-08-10;1670;1352;214143;177513;69.1;57.3
10;2021-08-11;854;1107;214997;178620;69.4;57.6
10;2021-08-12;1055;1225;216052;179845;69.7;58.0
10;2021-08-13;738;1075;216790;180920;70.0;58.4
10;2021-08-14;587;1235;217377;182155;70.1;58.8
10;2021-08-15;317;781;217694;182936;70.2;59.0
10;2021-08-16;725;1618;218419;184554;70.5;59.6
10;2021-08-17;877;1776;219296;186330;70.8;60.1
10;2021-08-18;722;1619;220018;187949;71.0;60.6
10;2021-08-19;551;1571;220569;189520;71.2;61.2
10;2021-08-20;644;1733;221213;191253;71.4;61.7
10;2021-08-21;452;1418;221665;192671;71.5;62.2
10;2021-08-22;188;1061;221853;193732;71.6;62.5
10;2021-08-23;481;1562;222334;195294;71.7;63.0
10;2021-08-24;669;1771;223003;197065;72.0;63.6
10;2021-08-25;460;1381;223463;198446;72.1;64.0
10;2021-08-26;432;1486;223895;199932;72.2;64.5
10;2021-08-27;626;1588;224521;201520;72.4;65.0
10;2021-08-28;396;1333;224917;202853;72.6;65.5
10;2021-08-29;225;946;225142;203799;72.6;65.8
10;2021-08-30;433;1395;225575;205194;72.8;66.2
10;2021-08-31;466;1451;226041;206645;72.9;66.7
10;2021-09-01;298;1202;226339;207847;73.0;67.1
10;2021-09-02;272;1149;226611;208996;73.1;67.4
10;2021-09-03;404;1219;227015;210215;73.3;67.8
10;2021-09-04;338;1095;227353;211310;73.4;68.2
10;2021-09-05;174;468;227527;211778;73.4;68.3
10;2021-09-06;272;757;227799;212535;73.5;68.6
10;2021-09-07;303;760;228102;213295;73.6;68.8
10;2021-09-08;255;765;228357;214060;73.7;69.1
10;2021-09-09;330;969;228687;215029;73.8;69.4
10;2021-09-10;411;907;229098;215936;73.9;69.7
10;2021-09-11;259;717;229357;216653;74.0;69.9
10;2021-09-12;93;227;229450;216880;74.0;70.0
10;2021-09-13;225;685;229675;217565;74.1;70.2
10;2021-09-14;244;990;229919;218555;74.2;70.5
10;2021-09-15;212;637;230131;219192;74.3;70.7
10;2021-09-16;282;596;230413;219788;74.3;70.9
10;2021-09-17;271;854;230684;220642;74.4;71.2
10;2021-09-18;199;610;230883;221252;74.5;71.4
10;2021-09-19;62;224;230945;221476;74.5;71.5
10;2021-09-20;139;627;231084;222103;74.6;71.7
10;2021-09-21;151;554;231235;222657;74.6;71.8
10;2021-09-22;132;305;231367;222962;74.7;71.9
10;2021-09-23;214;351;231581;223313;74.7;72.1
10;2021-09-24;210;546;231791;223859;74.8;72.2
10;2021-09-25;112;420;231903;224279;74.8;72.4
10;2021-09-26;58;215;231961;224494;74.8;72.4
10;2021-09-27;219;266;232180;224760;74.9;72.5
10;2021-09-28;204;362;232384;225122;75.0;72.6
10;2021-09-29;189;291;232573;225413;75.0;72.7
11;2020-12-27;0;0;0;0;0.0;0.0
11;2020-12-28;1;0;1;0;0.0;0.0
11;2020-12-29;1;0;2;0;0.0;0.0
11;2020-12-30;0;0;2;0;0.0;0.0
11;2020-12-31;0;0;2;0;0.0;0.0
11;2021-01-01;0;0;2;0;0.0;0.0
11;2021-01-02;5;0;7;0;0.0;0.0
11;2021-01-03;0;0;7;0;0.0;0.0
11;2021-01-04;1;0;8;0;0.0;0.0
11;2021-01-05;95;0;103;0;0.0;0.0
11;2021-01-06;25;0;128;0;0.0;0.0
11;2021-01-07;119;0;247;0;0.1;0.0
11;2021-01-08;91;1;338;1;0.1;0.0
11;2021-01-09;86;0;424;1;0.1;0.0
11;2021-01-10;67;0;491;1;0.1;0.0
11;2021-01-11;136;0;627;1;0.2;0.0
11;2021-01-12;545;3;1172;4;0.3;0.0
11;2021-01-13;410;1;1582;5;0.4;0.0
11;2021-01-14;645;8;2227;13;0.6;0.0
11;2021-01-15;342;3;2569;16;0.7;0.0
11;2021-01-16;77;1;2646;17;0.7;0.0
11;2021-01-17;47;1;2693;18;0.7;0.0
11;2021-01-18;388;0;3081;18;0.8;0.0
11;2021-01-19;539;4;3620;22;1.0;0.0
11;2021-01-20;693;7;4313;29;1.2;0.0
11;2021-01-21;649;5;4962;34;1.3;0.0
11;2021-01-22;524;2;5486;36;1.5;0.0
11;2021-01-23;164;0;5650;36;1.5;0.0
11;2021-01-24;139;0;5789;36;1.6;0.0
11;2021-01-25;376;18;6165;54;1.7;0.0
11;2021-01-26;848;86;7013;140;1.9;0.0
11;2021-01-27;803;23;7816;163;2.1;0.0
11;2021-01-28;652;53;8468;216;2.3;0.1
11;2021-01-29;442;120;8910;336;2.4;0.1
11;2021-01-30;137;0;9047;336;2.4;0.1
11;2021-01-31;82;0;9129;336;2.4;0.1
11;2021-02-01;345;187;9474;523;2.5;0.1
11;2021-02-02;412;361;9886;884;2.7;0.2
11;2021-02-03;392;346;10278;1230;2.8;0.3
11;2021-02-04;376;487;10654;1717;2.9;0.5
11;2021-02-05;318;327;10972;2044;2.9;0.5
11;2021-02-06;210;56;11182;2100;3.0;0.6
11;2021-02-07;108;13;11290;2113;3.0;0.6
11;2021-02-08;317;127;11607;2240;3.1;0.6
11;2021-02-09;300;244;11907;2484;3.2;0.7
11;2021-02-10;342;386;12249;2870;3.3;0.8
11;2021-02-11;609;527;12858;3397;3.4;0.9
11;2021-02-12;407;340;13265;3737;3.6;1.0
11;2021-02-13;195;87;13460;3824;3.6;1.0
11;2021-02-14;72;22;13532;3846;3.6;1.0
11;2021-02-15;241;173;13773;4019;3.7;1.1
11;2021-02-16;264;458;14037;4477;3.8;1.2
11;2021-02-17;454;535;14491;5012;3.9;1.3
11;2021-02-18;456;470;14947;5482;4.0;1.5
11;2021-02-19;300;449;15247;5931;4.1;1.6
11;2021-02-20;147;61;15394;5992;4.1;1.6
11;2021-02-21;59;32;15453;6024;4.1;1.6
11;2021-02-22;124;272;15577;6296;4.2;1.7
11;2021-02-23;283;264;15860;6560;4.3;1.8
11;2021-02-24;252;317;16112;6877;4.3;1.8
11;2021-02-25;563;281;16675;7158;4.5;1.9
11;2021-02-26;523;268;17198;7426;4.6;2.0
11;2021-02-27;319;89;17517;7515;4.7;2.0
11;2021-02-28;95;20;17612;7535;4.7;2.0
11;2021-03-01;339;260;17951;7795;4.8;2.1
11;2021-03-02;562;341;18513;8136;5.0;2.2
11;2021-03-03;600;381;19113;8517;5.1;2.3
11;2021-03-04;1078;368;20191;8885;5.4;2.4
11;2021-03-05;1003;372;21194;9257;5.7;2.5
11;2021-03-06;1094;179;22288;9436;6.0;2.5
11;2021-03-07;658;30;22946;9466;6.2;2.5
11;2021-03-08;369;308;23315;9774;6.3;2.6
11;2021-03-09;997;357;24312;10131;6.5;2.7
11;2021-03-10;1176;507;25488;10638;6.8;2.9
11;2021-03-11;1572;407;27060;11045;7.3;3.0
11;2021-03-12;1457;417;28517;11462;7.7;3.1
11;2021-03-13;1160;222;29677;11684;8.0;3.1
11;2021-03-14;523;49;30200;11733;8.1;3.1
11;2021-03-15;651;226;30851;11959;8.3;3.2
11;2021-03-16;853;196;31704;12155;8.5;3.3
11;2021-03-17;907;210;32611;12365;8.7;3.3
11;2021-03-18;1172;281;33783;12646;9.1;3.4
11;2021-03-19;1372;239;35155;12885;9.4;3.5
11;2021-03-20;790;172;35945;13057;9.6;3.5
11;2021-03-21;225;65;36170;13122;9.7;3.5
11;2021-03-22;809;219;36979;13341;9.9;3.6
11;2021-03-23;1806;386;38785;13727;10.4;3.7
11;2021-03-24;1846;315;40631;14042;10.9;3.8
11;2021-03-25;2190;372;42821;14414;11.5;3.9
11;2021-03-26;2125;421;44946;14835;12.1;4.0
11;2021-03-27;1178;145;46124;14980;12.4;4.0
11;2021-03-28;265;42;46389;15022;12.4;4.0
11;2021-03-29;1182;222;47571;15244;12.8;4.1
11;2021-03-30;1994;321;49565;15565;13.3;4.2
11;2021-03-31;1615;384;51180;15949;13.7;4.3
11;2021-04-01;2145;425;53325;16374;14.3;4.4
11;2021-04-02;1643;428;54968;16802;14.7;4.5
11;2021-04-03;720;145;55688;16947;14.9;4.5
11;2021-04-04;198;75;55886;17022;15.0;4.6
11;2021-04-05;257;4;56143;17026;15.1;4.6
11;2021-04-06;1574;551;57717;17577;15.5;4.7
11;2021-04-07;1778;573;59495;18150;16.0;4.9
11;2021-04-08;1785;680;61280;18830;16.4;5.1
11;2021-04-09;2261;603;63541;19433;17.0;5.2
11;2021-04-10;1169;178;64710;19611;17.4;5.3
11;2021-04-11;551;105;65261;19716;17.5;5.3
11;2021-04-12;1614;541;66875;20257;17.9;5.4
11;2021-04-13;2262;884;69137;21141;18.6;5.7
11;2021-04-14;1661;1018;70798;22159;19.0;5.9
11;2021-04-15;1843;1130;72641;23289;19.5;6.2
11;2021-04-16;1837;849;74478;24138;20.0;6.5
11;2021-04-17;1772;561;76250;24699;20.5;6.6
11;2021-04-18;114;155;76364;24854;20.5;6.7
11;2021-04-19;1384;735;77748;25589;20.9;6.9
11;2021-04-20;1729;1277;79477;26866;21.3;7.2
11;2021-04-21;1780;1323;81257;28189;21.8;7.6
11;2021-04-22;1749;1323;83006;29512;22.3;7.9
11;2021-04-23;2012;1235;85018;30747;22.8;8.2
11;2021-04-24;1735;468;86753;31215;23.3;8.4
11;2021-04-25;659;177;87412;31392;23.5;8.4
11;2021-04-26;1380;838;88792;32230;23.8;8.6
11;2021-04-27;1839;1550;90631;33780;24.3;9.1
11;2021-04-28;2008;1465;92639;35245;24.9;9.5
11;2021-04-29;2247;1637;94886;36882;25.5;9.9
11;2021-04-30;2158;1424;97044;38306;26.0;10.3
11;2021-05-01;1338;344;98382;38650;26.4;10.4
11;2021-05-02;588;336;98970;38986;26.6;10.5
11;2021-05-03;1487;735;100457;39721;27.0;10.7
11;2021-05-04;1878;1427;102335;41148;27.5;11.0
11;2021-05-05;1895;1441;104230;42589;28.0;11.4
11;2021-05-06;2191;1475;106421;44064;28.6;11.8
11;2021-05-07;2106;1548;108527;45612;29.1;12.2
11;2021-05-08;898;726;109425;46338;29.4;12.4
11;2021-05-09;628;543;110053;46881;29.5;12.6
11;2021-05-10;1328;1652;111381;48533;29.9;13.0
11;2021-05-11;2041;1871;113422;50404;30.4;13.5
11;2021-05-12;1847;1649;115269;52053;30.9;14.0
11;2021-05-13;1405;414;116674;52467;31.3;14.1
11;2021-05-14;1718;1182;118392;53649;31.8;14.4
11;2021-05-15;1158;897;119550;54546;32.1;14.6
11;2021-05-16;808;164;120358;54710;32.3;14.7
11;2021-05-17;1470;1047;121828;55757;32.7;15.0
11;2021-05-18;1897;1190;123725;56947;33.2;15.3
11;2021-05-19;1846;1123;125571;58070;33.7;15.6
11;2021-05-20;1971;1091;127542;59161;34.2;15.9
11;2021-05-21;2276;1089;129818;60250;34.8;16.2
11;2021-05-22;1485;726;131303;60976;35.2;16.4
11;2021-05-23;767;71;132070;61047;35.4;16.4
11;2021-05-24;1411;224;133481;61271;35.8;16.4
11;2021-05-25;1811;1353;135292;62624;36.3;16.8
11;2021-05-26;1934;1297;137226;63921;36.8;17.2
11;2021-05-27;1988;1720;139214;65641;37.4;17.6
11;2021-05-28;1755;1900;140969;67541;37.8;18.1
11;2021-05-29;1428;1599;142397;69140;38.2;18.6
11;2021-05-30;486;392;142883;69532;38.3;18.7
11;2021-05-31;1261;1615;144144;71147;38.7;19.1
11;2021-06-01;1856;1903;146000;73050;39.2;19.6
11;2021-06-02;1761;2068;147761;75118;39.6;20.2
11;2021-06-03;2597;2409;150358;77527;40.3;20.8
11;2021-06-04;2146;2663;152504;80190;40.9;21.5
11;2021-06-05;1588;1902;154092;82092;41.3;22.0
11;2021-06-06;877;857;154969;82949;41.6;22.3
11;2021-06-07;1526;1707;156495;84656;42.0;22.7
11;2021-06-08;2038;1987;158533;86643;42.5;23.2
11;2021-06-09;1786;2181;160319;88824;43.0;23.8
11;2021-06-10;1806;2426;162125;91250;43.5;24.5
11;2021-06-11;1864;2493;163989;93743;44.0;25.2
11;2021-06-12;1455;1621;165444;95364;44.4;25.6
11;2021-06-13;713;723;166157;96087;44.6;25.8
11;2021-06-14;1032;1968;167189;98055;44.9;26.3
11;2021-06-15;1395;2685;168584;100740;45.2;27.0
11;2021-06-16;1335;2527;169919;103267;45.6;27.7
11;2021-06-17;1474;2520;171393;105787;46.0;28.4
11;2021-06-18;1518;2486;172911;108273;46.4;29.1
11;2021-06-19;1236;1410;174147;109683;46.7;29.4
11;2021-06-20;299;599;174446;110282;46.8;29.6
11;2021-06-21;838;2122;175284;112404;47.0;30.2
11;2021-06-22;1016;2604;176300;115008;47.3;30.9
11;2021-06-23;1095;2089;177395;117097;47.6;31.4
11;2021-06-24;909;2244;178304;119341;47.8;32.0
11;2021-06-25;993;2547;179297;121888;48.1;32.7
11;2021-06-26;773;1655;180070;123543;48.3;33.1
11;2021-06-27;210;688;180280;124231;48.4;33.3
11;2021-06-28;697;2297;180977;126528;48.6;33.9
11;2021-06-29;962;2598;181939;129126;48.8;34.6
11;2021-06-30;906;2520;182845;131646;49.1;35.3
11;2021-07-01;1003;1888;183848;133534;49.3;35.8
11;2021-07-02;966;2539;184814;136073;49.6;36.5
11;2021-07-03;728;1806;185542;137879;49.8;37.0
11;2021-07-04;340;1109;185882;138988;49.9;37.3
11;2021-07-05;695;2132;186577;141120;50.1;37.9
11;2021-07-06;973;2519;187550;143639;50.3;38.5
11;2021-07-07;946;2508;188496;146147;50.6;39.2
11;2021-07-08;1191;1910;189687;148057;50.9;39.7
11;2021-07-09;823;1794;190510;149851;51.1;40.2
11;2021-07-10;369;1302;190879;151153;51.2;40.6
11;2021-07-11;313;564;191192;151717;51.3;40.7
11;2021-07-12;505;2671;191697;154388;51.4;41.4
11;2021-07-13;1304;3063;193001;157451;51.8;42.2
11;2021-07-14;210;233;193211;157684;51.8;42.3
11;2021-07-15;1450;2961;194661;160645;52.2;43.1
11;2021-07-16;1876;2730;196537;163375;52.7;43.8
11;2021-07-17;1075;2161;197612;165536;53.0;44.4
11;2021-07-18;652;946;198264;166482;53.2;44.7
11;2021-07-19;1355;2088;199619;168570;53.6;45.2
11;2021-07-20;1997;2403;201616;170973;54.1;45.9
11;2021-07-21;2015;2437;203631;173410;54.6;46.5
11;2021-07-22;2414;1882;206045;175292;55.3;47.0
11;2021-07-23;2230;2282;208275;177574;55.9;47.6
11;2021-07-24;1274;1628;209549;179202;56.2;48.1
11;2021-07-25;749;692;210298;179894;56.4;48.3
11;2021-07-26;1667;1427;211965;181321;56.9;48.7
11;2021-07-27;2342;1998;214307;183319;57.5;49.2
11;2021-07-28;2480;1989;216787;185308;58.2;49.7
11;2021-07-29;2771;1794;219558;187102;58.9;50.2
11;2021-07-30;2575;1803;222133;188905;59.6;50.7
11;2021-07-31;2008;1140;224141;190045;60.1;51.0
11;2021-08-01;1011;482;225152;190527;60.4;51.1
11;2021-08-02;1929;1151;227081;191678;60.9;51.4
11;2021-08-03;2441;1602;229522;193280;61.6;51.9
11;2021-08-04;2559;1266;232081;194546;62.3;52.2
11;2021-08-05;2382;1333;234463;195879;62.9;52.6
11;2021-08-06;2252;1660;236715;197539;63.5;53.0
11;2021-08-07;1665;1167;238380;198706;64.0;53.3
11;2021-08-08;599;210;238979;198916;64.1;53.4
11;2021-08-09;1031;1434;240010;200350;64.4;53.8
11;2021-08-10;1746;1986;241756;202336;64.9;54.3
11;2021-08-11;1717;1690;243473;204026;65.3;54.7
11;2021-08-12;1716;1857;245189;205883;65.8;55.2
11;2021-08-13;1348;1655;246537;207538;66.1;55.7
11;2021-08-14;984;1596;247521;209134;66.4;56.1
11;2021-08-15;138;125;247659;209259;66.4;56.1
11;2021-08-16;731;1914;248390;211173;66.6;56.7
11;2021-08-17;1046;2391;249436;213564;66.9;57.3
11;2021-08-18;1108;2032;250544;215596;67.2;57.8
11;2021-08-19;1005;2290;251549;217886;67.5;58.5
11;2021-08-20;976;2291;252525;220177;67.8;59.1
11;2021-08-21;576;1838;253101;222015;67.9;59.6
11;2021-08-22;192;512;253293;222527;68.0;59.7
11;2021-08-23;522;1817;253815;224344;68.1;60.2
11;2021-08-24;797;2255;254612;226599;68.3;60.8
11;2021-08-25;794;2153;255406;228752;68.5;61.4
11;2021-08-26;759;2001;256165;230753;68.7;61.9
11;2021-08-27;698;2222;256863;232975;68.9;62.5
11;2021-08-28;435;1744;257298;234719;69.0;63.0
11;2021-08-29;143;514;257441;235233;69.1;63.1
11;2021-08-30;455;1347;257896;236580;69.2;63.5
11;2021-08-31;584;1949;258480;238529;69.4;64.0
11;2021-09-01;606;1812;259086;240341;69.5;64.5
11;2021-09-02;551;1701;259637;242042;69.7;64.9
11;2021-09-03;535;1710;260172;243752;69.8;65.4
11;2021-09-04;487;1554;260659;245306;69.9;65.8
11;2021-09-05;153;271;260812;245577;70.0;65.9
11;2021-09-06;298;856;261110;246433;70.1;66.1
11;2021-09-07;355;1124;261465;247557;70.2;66.4
11;2021-09-08;478;1308;261943;248865;70.3;66.8
11;2021-09-09;394;1037;262337;249902;70.4;67.1
11;2021-09-10;381;1137;262718;251039;70.5;67.4
11;2021-09-11;378;1053;263096;252092;70.6;67.6
11;2021-09-12;61;146;263157;252238;70.6;67.7
11;2021-09-13;238;1041;263395;253279;70.7;68.0
11;2021-09-14;343;963;263738;254242;70.8;68.2
11;2021-09-15;360;973;264098;255215;70.9;68.5
11;2021-09-16;301;585;264399;255800;70.9;68.6
11;2021-09-17;313;681;264712;256481;71.0;68.8
11;2021-09-18;267;730;264979;257211;71.1;69.0
11;2021-09-19;59;123;265038;257334;71.1;69.0
11;2021-09-20;166;332;265204;257666;71.2;69.1
11;2021-09-21;288;417;265492;258083;71.2;69.2
11;2021-09-22;224;768;265716;258851;71.3;69.5
11;2021-09-23;178;397;265894;259248;71.3;69.6
11;2021-09-24;273;520;266167;259768;71.4;69.7
11;2021-09-25;235;673;266402;260441;71.5;69.9
11;2021-09-26;35;131;266437;260572;71.5;69.9
11;2021-09-27;105;385;266542;260957;71.5;70.0
11;2021-09-28;212;354;266754;261311;71.6;70.1
11;2021-09-29;220;537;266974;261848;71.6;70.3
12;2020-12-27;0;0;0;0;0.0;0.0
12;2020-12-28;0;0;0;0;0.0;0.0
12;2020-12-29;0;0;0;0;0.0;0.0
12;2020-12-30;0;0;0;0;0.0;0.0
12;2020-12-31;0;0;0;0;0.0;0.0
12;2021-01-01;0;0;0;0;0.0;0.0
12;2021-01-02;0;0;0;0;0.0;0.0
12;2021-01-03;2;0;2;0;0.0;0.0
12;2021-01-04;1;0;3;0;0.0;0.0
12;2021-01-05;1;0;4;0;0.0;0.0
12;2021-01-06;12;0;16;0;0.0;0.0
12;2021-01-07;202;0;218;0;0.1;0.0
12;2021-01-08;65;0;283;0;0.1;0.0
12;2021-01-09;0;0;283;0;0.1;0.0
12;2021-01-10;1;0;284;0;0.1;0.0
12;2021-01-11;101;0;385;0;0.1;0.0
12;2021-01-12;361;0;746;0;0.3;0.0
12;2021-01-13;285;0;1031;0;0.4;0.0
12;2021-01-14;600;12;1631;12;0.6;0.0
12;2021-01-15;367;8;1998;20;0.7;0.0
12;2021-01-16;138;1;2136;21;0.8;0.0
12;2021-01-17;1;0;2137;21;0.8;0.0
12;2021-01-18;452;0;2589;21;0.9;0.0
12;2021-01-19;609;3;3198;24;1.1;0.0
12;2021-01-20;879;3;4077;27;1.5;0.0
12;2021-01-21;736;0;4813;27;1.7;0.0
12;2021-01-22;798;1;5611;28;2.0;0.0
12;2021-01-23;382;0;5993;28;2.2;0.0
12;2021-01-24;0;0;5993;28;2.2;0.0
12;2021-01-25;453;0;6446;28;2.3;0.0
12;2021-01-26;650;0;7096;28;2.5;0.0
12;2021-01-27;1886;37;8982;65;3.2;0.0
12;2021-01-28;1886;225;10868;290;3.9;0.1
12;2021-01-29;1331;41;12199;331;4.4;0.1
12;2021-01-30;359;2;12558;333;4.5;0.1
12;2021-01-31;0;0;12558;333;4.5;0.1
12;2021-02-01;335;85;12893;418;4.6;0.2
12;2021-02-02;457;233;13350;651;4.8;0.2
12;2021-02-03;457;164;13807;815;5.0;0.3
12;2021-02-04;459;510;14266;1325;5.1;0.5
12;2021-02-05;449;170;14715;1495;5.3;0.5
12;2021-02-06;220;42;14935;1537;5.4;0.6
12;2021-02-07;8;0;14943;1537;5.4;0.6
12;2021-02-08;104;281;15047;1818;5.4;0.7
12;2021-02-09;209;293;15256;2111;5.5;0.8
12;2021-02-10;465;394;15721;2505;5.6;0.9
12;2021-02-11;539;293;16260;2798;5.8;1.0
12;2021-02-12;570;264;16830;3062;6.0;1.1
12;2021-02-13;175;110;17005;3172;6.1;1.1
12;2021-02-14;1;0;17006;3172;6.1;1.1
12;2021-02-15;175;295;17181;3467;6.2;1.2
12;2021-02-16;171;424;17352;3891;6.2;1.4
12;2021-02-17;366;1301;17718;5192;6.4;1.9
12;2021-02-18;676;1508;18394;6700;6.6;2.4
12;2021-02-19;594;891;18988;7591;6.8;2.7
12;2021-02-20;103;355;19091;7946;6.9;2.9
12;2021-02-21;0;0;19091;7946;6.9;2.9
12;2021-02-22;150;323;19241;8269;6.9;3.0
12;2021-02-23;157;469;19398;8738;7.0;3.1
12;2021-02-24;156;542;19554;9280;7.0;3.3
12;2021-02-25;201;642;19755;9922;7.1;3.6
12;2021-02-26;320;544;20075;10466;7.2;3.8
12;2021-02-27;190;301;20265;10767;7.3;3.9
12;2021-02-28;13;0;20278;10767;7.3;3.9
12;2021-03-01;51;318;20329;11085;7.3;4.0
12;2021-03-02;190;453;20519;11538;7.4;4.1
12;2021-03-03;244;347;20763;11885;7.5;4.3
12;2021-03-04;278;323;21041;12208;7.6;4.4
12;2021-03-05;421;330;21462;12538;7.7;4.5
12;2021-03-06;793;120;22255;12658;8.0;4.5
12;2021-03-07;140;32;22395;12690;8.0;4.6
12;2021-03-08;233;192;22628;12882;8.1;4.6
12;2021-03-09;716;219;23344;13101;8.4;4.7
12;2021-03-10;784;722;24128;13823;8.7;5.0
12;2021-03-11;919;642;25047;14465;9.0;5.2
12;2021-03-12;1259;511;26306;14976;9.5;5.4
12;2021-03-13;896;134;27202;15110;9.8;5.4
12;2021-03-14;45;2;27247;15112;9.8;5.4
12;2021-03-15;559;154;27806;15266;10.0;5.5
12;2021-03-16;818;159;28624;15425;10.3;5.5
12;2021-03-17;1504;165;30128;15590;10.8;5.6
12;2021-03-18;997;246;31125;15836;11.2;5.7
12;2021-03-19;1383;278;32508;16114;11.7;5.8
12;2021-03-20;725;78;33233;16192;11.9;5.8
12;2021-03-21;264;10;33497;16202;12.0;5.8
12;2021-03-22;606;174;34103;16376;12.3;5.9
12;2021-03-23;1214;176;35317;16552;12.7;5.9
12;2021-03-24;1422;206;36739;16758;13.2;6.0
12;2021-03-25;1844;205;38583;16963;13.9;6.1
12;2021-03-26;1978;230;40561;17193;14.6;6.2
12;2021-03-27;981;68;41542;17261;14.9;6.2
12;2021-03-28;60;1;41602;17262;14.9;6.2
12;2021-03-29;963;84;42565;17346;15.3;6.2
12;2021-03-30;1737;123;44302;17469;15.9;6.3
12;2021-03-31;1461;105;45763;17574;16.4;6.3
12;2021-04-01;1957;166;47720;17740;17.1;6.4
12;2021-04-02;1614;344;49334;18084;17.7;6.5
12;2021-04-03;882;96;50216;18180;18.0;6.5
12;2021-04-04;1;0;50217;18180;18.0;6.5
12;2021-04-05;645;14;50862;18194;18.3;6.5
12;2021-04-06;1151;536;52013;18730;18.7;6.7
12;2021-04-07;1651;637;53664;19367;19.3;7.0
12;2021-04-08;2098;570;55762;19937;20.0;7.2
12;2021-04-09;2112;651;57874;20588;20.8;7.4
12;2021-04-10;1427;219;59301;20807;21.3;7.5
12;2021-04-11;120;1;59421;20808;21.3;7.5
12;2021-04-12;1837;502;61258;21310;22.0;7.7
12;2021-04-13;1907;774;63165;22084;22.7;7.9
12;2021-04-14;1832;1318;64997;23402;23.3;8.4
12;2021-04-15;1937;896;66934;24298;24.0;8.7
12;2021-04-16;1675;1204;68609;25502;24.6;9.2
12;2021-04-17;1553;567;70162;26069;25.2;9.4
12;2021-04-18;0;0;70162;26069;25.2;9.4
12;2021-04-19;1687;549;71849;26618;25.8;9.6
12;2021-04-20;1546;984;73395;27602;26.4;9.9
12;2021-04-21;1693;1183;75088;28785;27.0;10.3
12;2021-04-22;1690;1092;76778;29877;27.6;10.7
12;2021-04-23;1382;1335;78160;31212;28.1;11.2
12;2021-04-24;1450;719;79610;31931;28.6;11.5
12;2021-04-25;60;0;79670;31931;28.6;11.5
12;2021-04-26;1459;898;81129;32829;29.1;11.8
12;2021-04-27;1321;1279;82450;34108;29.6;12.3
12;2021-04-28;1113;1870;83563;35978;30.0;12.9
12;2021-04-29;1571;1910;85134;37888;30.6;13.6
12;2021-04-30;1813;1836;86947;39724;31.2;14.3
12;2021-05-01;1617;261;88564;39985;31.8;14.4
12;2021-05-02;9;0;88573;39985;31.8;14.4
12;2021-05-03;1713;1251;90286;41236;32.4;14.8
12;2021-05-04;1483;1393;91769;42629;33.0;15.3
12;2021-05-05;1296;1673;93065;44302;33.4;15.9
12;2021-05-06;1753;1376;94818;45678;34.1;16.4
12;2021-05-07;1483;1777;96301;47455;34.6;17.0
12;2021-05-08;1330;461;97631;47916;35.1;17.2
12;2021-05-09;13;34;97644;47950;35.1;17.2
12;2021-05-10;829;2215;98473;50165;35.4;18.0
12;2021-05-11;928;1847;99401;52012;35.7;18.7
12;2021-05-12;948;1820;100349;53832;36.1;19.3
12;2021-05-13;1587;811;101936;54643;36.6;19.6
12;2021-05-14;1235;1534;103171;56177;37.1;20.2
12;2021-05-15;1067;1115;104238;57292;37.4;20.6
12;2021-05-16;2;19;104240;57311;37.4;20.6
12;2021-05-17;1082;1810;105322;59121;37.8;21.2
12;2021-05-18;1426;1533;106748;60654;38.3;21.8
12;2021-05-19;1915;1330;108663;61984;39.0;22.3
12;2021-05-20;2119;876;110782;62860;39.8;22.6
12;2021-05-21;1821;1253;112603;64113;40.5;23.0
12;2021-05-22;1206;1015;113809;65128;40.9;23.4
12;2021-05-23;7;12;113816;65140;40.9;23.4
12;2021-05-24;1956;536;115772;65676;41.6;23.6
12;2021-05-25;1742;1157;117514;66833;42.2;24.0
12;2021-05-26;1998;780;119512;67613;42.9;24.3
12;2021-05-27;2165;744;121677;68357;43.7;24.6
12;2021-05-28;1927;1025;123604;69382;44.4;24.9
12;2021-05-29;1637;805;125241;70187;45.0;25.2
12;2021-05-30;9;43;125250;70230;45.0;25.2
12;2021-05-31;1699;810;126949;71040;45.6;25.5
12;2021-06-01;1887;1026;128836;72066;46.3;25.9
12;2021-06-02;1979;1052;130815;73118;47.0;26.3
12;2021-06-03;2123;824;132938;73942;47.8;26.6
12;2021-06-04;1967;1417;134905;75359;48.5;27.1
12;2021-06-05;1738;985;136643;76344;49.1;27.4
12;2021-06-06;6;6;136649;76350;49.1;27.4
12;2021-06-07;1092;1811;137741;78161;49.5;28.1
12;2021-06-08;1332;1201;139073;79362;50.0;28.5
12;2021-06-09;895;1291;139968;80653;50.3;29.0
12;2021-06-10;1022;920;140990;81573;50.7;29.3
12;2021-06-11;1204;2076;142194;83649;51.1;30.1
12;2021-06-12;1033;1320;143227;84969;51.5;30.5
12;2021-06-13;6;47;143233;85016;51.5;30.5
12;2021-06-14;662;1829;143895;86845;51.7;31.2
12;2021-06-15;745;1877;144640;88722;52.0;31.9
12;2021-06-16;820;1818;145460;90540;52.3;32.5
12;2021-06-17;678;995;146138;91535;52.5;32.9
12;2021-06-18;1134;1840;147272;93375;52.9;33.5
12;2021-06-19;914;1406;148186;94781;53.2;34.0
12;2021-06-20;4;10;148190;94791;53.2;34.1
12;2021-06-21;512;1737;148702;96528;53.4;34.7
12;2021-06-22;502;1475;149204;98003;53.6;35.2
12;2021-06-23;579;1306;149783;99309;53.8;35.7
12;2021-06-24;249;541;150032;99850;53.9;35.9
12;2021-06-25;876;1842;150908;101692;54.2;36.5
12;2021-06-26;673;1527;151581;103219;54.5;37.1
12;2021-06-27;1;9;151582;103228;54.5;37.1
12;2021-06-28;467;2453;152049;105681;54.6;38.0
12;2021-06-29;565;1957;152614;107638;54.8;38.7
12;2021-06-30;828;2132;153442;109770;55.1;39.4
12;2021-07-01;344;1086;153786;110856;55.2;39.8
12;2021-07-02;796;2627;154582;113483;55.5;40.8
12;2021-07-03;565;1872;155147;115355;55.7;41.4
12;2021-07-04;1;0;155148;115355;55.7;41.4
12;2021-07-05;440;2406;155588;117761;55.9;42.3
12;2021-07-06;640;2495;156228;120256;56.1;43.2
12;2021-07-07;688;2116;156916;122372;56.4;44.0
12;2021-07-08;295;913;157211;123285;56.5;44.3
12;2021-07-09;724;2587;157935;125872;56.7;45.2
12;2021-07-10;445;2077;158380;127949;56.9;46.0
12;2021-07-11;0;0;158380;127949;56.9;46.0
12;2021-07-12;587;2440;158967;130389;57.1;46.8
12;2021-07-13;840;2592;159807;132981;57.4;47.8
12;2021-07-14;44;25;159851;133006;57.4;47.8
12;2021-07-15;794;2107;160645;135113;57.7;48.5
12;2021-07-16;1247;2556;161892;137669;58.2;49.5
12;2021-07-17;790;2007;162682;139676;58.4;50.2
12;2021-07-18;25;11;162707;139687;58.5;50.2
12;2021-07-19;1319;2005;164026;141692;58.9;50.9
12;2021-07-20;1422;1475;165448;143167;59.4;51.4
12;2021-07-21;1022;941;166470;144108;59.8;51.8
12;2021-07-22;2236;1308;168706;145416;60.6;52.2
12;2021-07-23;1866;2056;170572;147472;61.3;53.0
12;2021-07-24;1604;1566;172176;149038;61.9;53.5
12;2021-07-25;97;28;172273;149066;61.9;53.6
12;2021-07-26;1930;1438;174203;150504;62.6;54.1
12;2021-07-27;2236;1007;176439;151511;63.4;54.4
12;2021-07-28;1715;675;178154;152186;64.0;54.7
12;2021-07-29;1189;807;179343;152993;64.4;55.0
12;2021-07-30;2507;1283;181850;154276;65.3;55.4
12;2021-07-31;1967;1005;183817;155281;66.0;55.8
12;2021-08-01;225;38;184042;155319;66.1;55.8
12;2021-08-02;1815;832;185857;156151;66.8;56.1
12;2021-08-03;1960;776;187817;156927;67.5;56.4
12;2021-08-04;1693;832;189510;157759;68.1;56.7
12;2021-08-05;1636;683;191146;158442;68.7;56.9
12;2021-08-06;1706;1313;192852;159755;69.3;57.4
12;2021-08-07;1447;744;194299;160499;69.8;57.7
12;2021-08-08;0;3;194299;160502;69.8;57.7
12;2021-08-09;1351;1415;195650;161917;70.3;58.2
12;2021-08-10;1343;1247;196993;163164;70.8;58.6
12;2021-08-11;820;1195;197813;164359;71.1;59.0
12;2021-08-12;737;1070;198550;165429;71.3;59.4
12;2021-08-13;1075;1335;199625;166764;71.7;59.9
12;2021-08-14;739;1354;200364;168118;72.0;60.4
12;2021-08-15;255;75;200619;168193;72.1;60.4
12;2021-08-16;670;1817;201289;170010;72.3;61.1
12;2021-08-17;905;1991;202194;172001;72.6;61.8
12;2021-08-18;448;1522;202642;173523;72.8;62.3
12;2021-08-19;641;1115;203283;174638;73.0;62.7
12;2021-08-20;797;1888;204080;176526;73.3;63.4
12;2021-08-21;473;1526;204553;178052;73.5;64.0
12;2021-08-22;93;27;204646;178079;73.5;64.0
12;2021-08-23;453;1921;205099;180000;73.7;64.7
12;2021-08-24;486;1917;205585;181917;73.9;65.4
12;2021-08-25;333;1579;205918;183496;74.0;65.9
12;2021-08-26;487;1606;206405;185102;74.2;66.5
12;2021-08-27;597;1699;207002;186801;74.4;67.1
12;2021-08-28;332;1553;207334;188354;74.5;67.7
12;2021-08-29;176;143;207510;188497;74.5;67.7
12;2021-08-30;561;1908;208071;190405;74.7;68.4
12;2021-08-31;417;1392;208488;191797;74.9;68.9
12;2021-09-01;425;1020;208913;192817;75.1;69.3
12;2021-09-02;266;822;209179;193639;75.1;69.6
12;2021-09-03;490;1378;209669;195017;75.3;70.1
12;2021-09-04;432;1209;210101;196226;75.5;70.5
12;2021-09-05;52;206;210153;196432;75.5;70.6
12;2021-09-06;214;806;210367;197238;75.6;70.9
12;2021-09-07;270;671;210637;197909;75.7;71.1
12;2021-09-08;245;618;210882;198527;75.8;71.3
12;2021-09-09;174;448;211056;198975;75.8;71.5
12;2021-09-10;496;1276;211552;200251;76.0;71.9
12;2021-09-11;385;1083;211937;201334;76.1;72.3
12;2021-09-12;17;120;211954;201454;76.1;72.4
12;2021-09-13;157;625;212111;202079;76.2;72.6
12;2021-09-14;277;513;212388;202592;76.3;72.8
12;2021-09-15;242;407;212630;202999;76.4;72.9
12;2021-09-16;383;411;213013;203410;76.5;73.1
12;2021-09-17;342;505;213355;203915;76.6;73.3
12;2021-09-18;241;688;213596;204603;76.7;73.5
12;2021-09-19;0;4;213596;204607;76.7;73.5
12;2021-09-20;106;432;213702;205039;76.8;73.7
12;2021-09-21;111;220;213813;205259;76.8;73.7
12;2021-09-22;132;577;213945;205836;76.9;73.9
12;2021-09-23;106;160;214051;205996;76.9;74.0
12;2021-09-24;216;535;214267;206531;77.0;74.2
12;2021-09-25;161;664;214428;207195;77.0;74.4
12;2021-09-26;0;1;214428;207196;77.0;74.4
12;2021-09-27;82;241;214510;207437;77.1;74.5
12;2021-09-28;95;251;214605;207688;77.1;74.6
12;2021-09-29;112;325;214717;208013;77.1;74.7
13;2020-12-27;4;0;4;0;0.0;0.0
13;2020-12-28;6;0;10;0;0.0;0.0
13;2020-12-29;1;0;11;0;0.0;0.0
13;2020-12-30;2;0;13;0;0.0;0.0
13;2020-12-31;6;0;19;0;0.0;0.0
13;2021-01-01;4;0;23;0;0.0;0.0
13;2021-01-02;4;0;27;0;0.0;0.0
13;2021-01-03;11;0;38;0;0.0;0.0
13;2021-01-04;1;0;39;0;0.0;0.0
13;2021-01-05;79;1;118;1;0.0;0.0
13;2021-01-06;122;0;240;1;0.0;0.0
13;2021-01-07;174;1;414;2;0.0;0.0
13;2021-01-08;189;0;603;2;0.0;0.0
13;2021-01-09;13;0;616;2;0.0;0.0
13;2021-01-10;3;0;619;2;0.0;0.0
13;2021-01-11;482;1;1101;3;0.1;0.0
13;2021-01-12;813;2;1914;5;0.1;0.0
13;2021-01-13;1086;1;3000;6;0.1;0.0
13;2021-01-14;1587;16;4587;22;0.2;0.0
13;2021-01-15;1538;7;6125;29;0.3;0.0
13;2021-01-16;406;3;6531;32;0.3;0.0
13;2021-01-17;44;0;6575;32;0.3;0.0
13;2021-01-18;2385;9;8960;41;0.4;0.0
13;2021-01-19;7418;33;16378;74;0.8;0.0
13;2021-01-20;5580;17;21958;91;1.1;0.0
13;2021-01-21;5364;29;27322;120;1.3;0.0
13;2021-01-22;4006;22;31328;142;1.5;0.0
13;2021-01-23;1357;6;32685;148;1.6;0.0
13;2021-01-24;491;5;33176;153;1.6;0.0
13;2021-01-25;2340;27;35516;180;1.7;0.0
13;2021-01-26;2952;84;38468;264;1.9;0.0
13;2021-01-27;3122;119;41590;383;2.0;0.0
13;2021-01-28;3251;175;44841;558;2.2;0.0
13;2021-01-29;2512;122;47353;680;2.3;0.0
13;2021-01-30;1025;11;48378;691;2.4;0.0
13;2021-01-31;252;0;48630;691;2.4;0.0
13;2021-02-01;1864;260;50494;951;2.5;0.0
13;2021-02-02;2257;569;52751;1520;2.6;0.1
13;2021-02-03;1868;538;54619;2058;2.7;0.1
13;2021-02-04;1907;880;56526;2938;2.8;0.1
13;2021-02-05;2627;1458;59153;4396;2.9;0.2
13;2021-02-06;856;272;60009;4668;2.9;0.2
13;2021-02-07;278;5;60287;4673;3.0;0.2
13;2021-02-08;1905;1396;62192;6069;3.1;0.3
13;2021-02-09;3321;3962;65513;10031;3.2;0.5
13;2021-02-10;3240;3169;68753;13200;3.4;0.6
13;2021-02-11;3583;3188;72336;16388;3.6;0.8
13;2021-02-12;2839;2726;75175;19114;3.7;0.9
13;2021-02-13;734;523;75909;19637;3.7;1.0
13;2021-02-14;72;324;75981;19961;3.7;1.0
13;2021-02-15;970;1764;76951;21725;3.8;1.1
13;2021-02-16;1395;2302;78346;24027;3.9;1.2
13;2021-02-17;1349;2598;79695;26625;3.9;1.3
13;2021-02-18;1903;2338;81598;28963;4.0;1.4
13;2021-02-19;1514;1917;83112;30880;4.1;1.5
13;2021-02-20;458;648;83570;31528;4.1;1.5
13;2021-02-21;33;238;83603;31766;4.1;1.6
13;2021-02-22;1023;1921;84626;33687;4.2;1.7
13;2021-02-23;1289;2234;85915;35921;4.2;1.8
13;2021-02-24;1519;2263;87434;38184;4.3;1.9
13;2021-02-25;2384;1836;89818;40020;4.4;2.0
13;2021-02-26;2458;1863;92276;41883;4.5;2.1
13;2021-02-27;982;659;93258;42542;4.6;2.1
13;2021-02-28;195;186;93453;42728;4.6;2.1
13;2021-03-01;1923;1356;95376;44084;4.7;2.2
13;2021-03-02;3012;2323;98388;46407;4.8;2.3
13;2021-03-03;3488;2364;101876;48771;5.0;2.4
13;2021-03-04;4210;2846;106086;51617;5.2;2.5
13;2021-03-05;4044;2549;110130;54166;5.4;2.7
13;2021-03-06;5302;748;115432;54914;5.7;2.7
13;2021-03-07;4295;363;119727;55277;5.9;2.7
13;2021-03-08;3930;1794;123657;57071;6.1;2.8
13;2021-03-09;5078;2074;128735;59145;6.3;2.9
13;2021-03-10;5180;1868;133915;61013;6.6;3.0
13;2021-03-11;7308;2023;141223;63036;6.9;3.1
13;2021-03-12;8332;2002;149555;65038;7.4;3.2
13;2021-03-13;6379;701;155934;65739;7.7;3.2
13;2021-03-14;2312;161;158246;65900;7.8;3.2
13;2021-03-15;6358;1290;164604;67190;8.1;3.3
13;2021-03-16;5078;1493;169682;68683;8.3;3.4
13;2021-03-17;5174;1402;174856;70085;8.6;3.4
13;2021-03-18;5816;1829;180672;71914;8.9;3.5
13;2021-03-19;6811;1599;187483;73513;9.2;3.6
13;2021-03-20;4044;690;191527;74203;9.4;3.6
13;2021-03-21;725;84;192252;74287;9.4;3.7
13;2021-03-22;7297;1534;199549;75821;9.8;3.7
13;2021-03-23;9132;1742;208681;77563;10.3;3.8
13;2021-03-24;8867;2173;217548;79736;10.7;3.9
13;2021-03-25;10914;2100;228462;81836;11.2;4.0
13;2021-03-26;10717;1902;239179;83738;11.8;4.1
13;2021-03-27;4870;824;244049;84562;12.0;4.2
13;2021-03-28;1120;80;245169;84642;12.1;4.2
13;2021-03-29;7577;1986;252746;86628;12.4;4.3
13;2021-03-30;12617;2507;265363;89135;13.0;4.4
13;2021-03-31;10811;3155;276174;92290;13.6;4.5
13;2021-04-01;12279;3080;288453;95370;14.2;4.7
13;2021-04-02;9790;3887;298243;99257;14.7;4.9
13;2021-04-03;4006;2802;302249;102059;14.9;5.0
13;2021-04-04;631;305;302880;102364;14.9;5.0
13;2021-04-05;3536;728;306416;103092;15.1;5.1
13;2021-04-06;8520;4242;314936;107334;15.5;5.3
13;2021-04-07;10079;4680;325015;112014;16.0;5.5
13;2021-04-08;10117;5457;335132;117471;16.5;5.8
13;2021-04-09;11281;5111;346413;122582;17.0;6.0
13;2021-04-10;7300;2094;353713;124676;17.4;6.1
13;2021-04-11;1379;534;355092;125210;17.5;6.2
13;2021-04-12;7984;4784;363076;129994;17.8;6.4
13;2021-04-13;9146;5485;372222;135479;18.3;6.7
13;2021-04-14;9535;5816;381757;141295;18.8;6.9
13;2021-04-15;9880;5951;391637;147246;19.3;7.2
13;2021-04-16;9966;5564;401603;152810;19.7;7.5
13;2021-04-17;4079;2022;405682;154832;19.9;7.6
13;2021-04-18;2526;1425;408208;156257;20.1;7.7
13;2021-04-19;6456;6398;414664;162655;20.4;8.0
13;2021-04-20;7402;7583;422066;170238;20.7;8.4
13;2021-04-21;7772;7378;429838;177616;21.1;8.7
13;2021-04-22;8462;7912;438300;185528;21.5;9.1
13;2021-04-23;8395;6830;446695;192358;22.0;9.5
13;2021-04-24;4625;3811;451320;196169;22.2;9.6
13;2021-04-25;877;521;452197;196690;22.2;9.7
13;2021-04-26;6167;7108;458364;203798;22.5;10.0
13;2021-04-27;7263;8021;465627;211819;22.9;10.4
13;2021-04-28;9451;7706;475078;219525;23.4;10.8
13;2021-04-29;11407;7592;486485;227117;23.9;11.2
13;2021-04-30;10916;7361;497401;234478;24.4;11.5
13;2021-05-01;5365;3795;502766;238273;24.7;11.7
13;2021-05-02;2100;747;504866;239020;24.8;11.7
13;2021-05-03;7297;7865;512163;246885;25.2;12.1
13;2021-05-04;8453;8505;520616;255390;25.6;12.6
13;2021-05-05;8224;8965;528840;264355;26.0;13.0
13;2021-05-06;10142;8582;538982;272937;26.5;13.4
13;2021-05-07;8852;10021;547834;282958;26.9;13.9
13;2021-05-08;4569;3936;552403;286894;27.2;14.1
13;2021-05-09;938;687;553341;287581;27.2;14.1
13;2021-05-10;7709;8752;561050;296333;27.6;14.6
13;2021-05-11;10978;9554;572028;305887;28.1;15.0
13;2021-05-12;12841;8727;584869;314614;28.7;15.5
13;2021-05-13;9507;3637;594376;318251;29.2;15.6
13;2021-05-14;13657;6445;608033;324696;29.9;16.0
13;2021-05-15;10196;4534;618229;329230;30.4;16.2
13;2021-05-16;3125;789;621354;330019;30.5;16.2
13;2021-05-17;10844;6800;632198;336819;31.1;16.6
13;2021-05-18;11918;6479;644116;343298;31.7;16.9
13;2021-05-19;12157;6357;656273;349655;32.3;17.2
13;2021-05-20;13443;6467;669716;356122;32.9;17.5
13;2021-05-21;12991;6782;682707;362904;33.6;17.8
13;2021-05-22;7517;3635;690224;366539;33.9;18.0
13;2021-05-23;862;637;691086;367176;34.0;18.0
13;2021-05-24;6761;2469;697847;369645;34.3;18.2
13;2021-05-25;9271;7594;707118;377239;34.8;18.5
13;2021-05-26;10142;7837;717260;385076;35.3;18.9
13;2021-05-27;10339;8421;727599;393497;35.8;19.3
13;2021-05-28;9003;9163;736602;402660;36.2;19.8
13;2021-05-29;7173;4621;743775;407281;36.6;20.0
13;2021-05-30;890;527;744665;407808;36.6;20.0
13;2021-05-31;8184;8022;752849;415830;37.0;20.4
13;2021-06-01;9578;9283;762427;425113;37.5;20.9
13;2021-06-02;10080;8776;772507;433889;38.0;21.3
13;2021-06-03;12295;9487;784802;443376;38.6;21.8
13;2021-06-04;12025;10031;796827;453407;39.2;22.3
13;2021-06-05;7820;5592;804647;458999;39.6;22.6
13;2021-06-06;1670;886;806317;459885;39.6;22.6
13;2021-06-07;6686;9874;813003;469759;40.0;23.1
13;2021-06-08;8317;9982;821320;479741;40.4;23.6
13;2021-06-09;8396;9732;829716;489473;40.8;24.1
13;2021-06-10;8952;9771;838668;499244;41.2;24.5
13;2021-06-11;8230;12710;846898;511954;41.6;25.2
13;2021-06-12;5778;6705;852676;518659;41.9;25.5
13;2021-06-13;950;1216;853626;519875;42.0;25.6
13;2021-06-14;5993;11141;859619;531016;42.3;26.1
13;2021-06-15;7284;11402;866903;542418;42.6;26.7
13;2021-06-16;7340;9867;874243;552285;43.0;27.1
13;2021-06-17;7442;10711;881685;562996;43.3;27.7
13;2021-06-18;7549;11071;889234;574067;43.7;28.2
13;2021-06-19;4615;7496;893849;581563;43.9;28.6
13;2021-06-20;990;1045;894839;582608;44.0;28.6
13;2021-06-21;4462;12258;899301;594866;44.2;29.2
13;2021-06-22;4940;13876;904241;608742;44.4;29.9
13;2021-06-23;5148;13577;909389;622319;44.7;30.6
13;2021-06-24;5341;12852;914730;635171;45.0;31.2
13;2021-06-25;5242;14680;919972;649851;45.2;31.9
13;2021-06-26;3016;9681;922988;659532;45.4;32.4
13;2021-06-27;537;931;923525;660463;45.4;32.5
13;2021-06-28;3731;12561;927256;673024;45.6;33.1
13;2021-06-29;4499;12898;931755;685922;45.8;33.7
13;2021-06-30;4903;12695;936658;698617;46.0;34.3
13;2021-07-01;5578;11493;942236;710110;46.3;34.9
13;2021-07-02;5567;12392;947803;722502;46.6;35.5
13;2021-07-03;3503;9161;951306;731663;46.8;36.0
13;2021-07-04;475;867;951781;732530;46.8;36.0
13;2021-07-05;3872;11769;955653;744299;47.0;36.6
13;2021-07-06;5461;11677;961114;755976;47.2;37.2
13;2021-07-07;5821;10705;966935;766681;47.5;37.7
13;2021-07-08;6230;10326;973165;777007;47.8;38.2
13;2021-07-09;5932;11931;979097;788938;48.1;38.8
13;2021-07-10;3163;8637;982260;797575;48.3;39.2
13;2021-07-11;435;1012;982695;798587;48.3;39.3
13;2021-07-12;4493;10944;987188;809531;48.5;39.8
13;2021-07-13;8980;13179;996168;822710;49.0;40.4
13;2021-07-14;5611;4862;1001779;827572;49.2;40.7
13;2021-07-15;11438;12946;1013217;840518;49.8;41.3
13;2021-07-16;12196;12926;1025413;853444;50.4;41.9
13;2021-07-17;6584;8494;1031997;861938;50.7;42.4
13;2021-07-18;727;1062;1032724;863000;50.8;42.4
13;2021-07-19;9807;11145;1042531;874145;51.2;43.0
13;2021-07-20;12271;11661;1054802;885806;51.8;43.5
13;2021-07-21;12688;10358;1067490;896164;52.5;44.0
13;2021-07-22;14557;10458;1082047;906622;53.2;44.6
13;2021-07-23;14486;10970;1096533;917592;53.9;45.1
13;2021-07-24;8342;7979;1104875;925571;54.3;45.5
13;2021-07-25;1016;784;1105891;926355;54.4;45.5
13;2021-07-26;11648;9116;1117539;935471;54.9;46.0
13;2021-07-27;13611;9418;1131150;944889;55.6;46.4
13;2021-07-28;12341;8182;1143491;953071;56.2;46.8
13;2021-07-29;13762;8090;1157253;961161;56.9;47.2
13;2021-07-30;13715;8636;1170968;969797;57.6;47.7
13;2021-07-31;8678;5833;1179646;975630;58.0;48.0
13;2021-08-01;1107;729;1180753;976359;58.0;48.0
13;2021-08-02;10050;6727;1190803;983086;58.5;48.3
13;2021-08-03;11070;7295;1201873;990381;59.1;48.7
13;2021-08-04;9427;6570;1211300;996951;59.5;49.0
13;2021-08-05;9520;7582;1220820;1004533;60.0;49.4
13;2021-08-06;9191;8998;1230011;1013531;60.5;49.8
13;2021-08-07;5441;5584;1235452;1019115;60.7;50.1
13;2021-08-08;905;804;1236357;1019919;60.8;50.1
13;2021-08-09;8396;9077;1244753;1028996;61.2;50.6
13;2021-08-10;9077;8910;1253830;1037906;61.6;51.0
13;2021-08-11;7839;8543;1261669;1046449;62.0;51.4
13;2021-08-12;7743;9671;1269412;1056120;62.4;51.9
13;2021-08-13;6958;9188;1276370;1065308;62.7;52.4
13;2021-08-14;3690;6455;1280060;1071763;62.9;52.7
13;2021-08-15;483;731;1280543;1072494;62.9;52.7
13;2021-08-16;6575;11078;1287118;1083572;63.3;53.3
13;2021-08-17;6670;10610;1293788;1094182;63.6;53.8
13;2021-08-18;6335;10175;1300123;1104357;63.9;54.3
13;2021-08-19;6671;10617;1306794;1114974;64.2;54.8
13;2021-08-20;5829;11235;1312623;1126209;64.5;55.4
13;2021-08-21;2617;7567;1315240;1133776;64.6;55.7
13;2021-08-22;369;1090;1315609;1134866;64.7;55.8
13;2021-08-23;4960;11215;1320569;1146081;64.9;56.3
13;2021-08-24;5438;10913;1326007;1156994;65.2;56.9
13;2021-08-25;5182;10092;1331189;1167086;65.4;57.4
13;2021-08-26;5115;9778;1336304;1176864;65.7;57.8
13;2021-08-27;5058;10635;1341362;1187499;65.9;58.4
13;2021-08-28;2355;6460;1343717;1193959;66.0;58.7
13;2021-08-29;338;1135;1344055;1195094;66.1;58.7
13;2021-08-30;4236;9860;1348291;1204954;66.3;59.2
13;2021-08-31;4865;10113;1353156;1215067;66.5;59.7
13;2021-09-01;4367;8589;1357523;1223656;66.7;60.1
13;2021-09-02;4230;8474;1361753;1232130;66.9;60.6
13;2021-09-03;4253;9294;1366006;1241424;67.1;61.0
13;2021-09-04;2161;5561;1368167;1246985;67.2;61.3
13;2021-09-05;183;393;1368350;1247378;67.3;61.3
13;2021-09-06;3093;6713;1371443;1254091;67.4;61.6
13;2021-09-07;3204;7280;1374647;1261371;67.6;62.0
13;2021-09-08;3490;7161;1378137;1268532;67.7;62.4
13;2021-09-09;3128;6699;1381265;1275231;67.9;62.7
13;2021-09-10;3567;7750;1384832;1282981;68.1;63.1
13;2021-09-11;2285;5469;1387117;1288450;68.2;63.3
13;2021-09-12;226;333;1387343;1288783;68.2;63.3
13;2021-09-13;2470;5226;1389813;1294009;68.3;63.6
13;2021-09-14;3154;6335;1392967;1300344;68.5;63.9
13;2021-09-15;2859;5508;1395826;1305852;68.6;64.2
13;2021-09-16;2203;3890;1398029;1309742;68.7;64.4
13;2021-09-17;2311;4873;1400340;1314615;68.8;64.6
13;2021-09-18;1522;4242;1401862;1318857;68.9;64.8
13;2021-09-19;123;173;1401985;1319030;68.9;64.8
13;2021-09-20;1530;3304;1403515;1322334;69.0;65.0
13;2021-09-21;1468;2916;1404983;1325250;69.1;65.1
13;2021-09-22;1635;4541;1406618;1329791;69.1;65.4
13;2021-09-23;1598;3529;1408216;1333320;69.2;65.5
13;2021-09-24;1614;4263;1409830;1337583;69.3;65.7
13;2021-09-25;1219;3964;1411049;1341547;69.4;65.9
13;2021-09-26;87;258;1411136;1341805;69.4;66.0
13;2021-09-27;1241;3147;1412377;1344952;69.4;66.1
13;2021-09-28;1312;2629;1413689;1347581;69.5;66.2
13;2021-09-29;1554;3537;1415243;1351118;69.6;66.4
14;2020-12-27;0;0;0;0;0.0;0.0
14;2020-12-28;1;1;1;1;0.0;0.0
14;2020-12-29;1;0;2;1;0.0;0.0
14;2020-12-30;0;0;2;1;0.0;0.0
14;2020-12-31;3;0;5;1;0.0;0.0
14;2021-01-01;1;0;6;1;0.0;0.0
14;2021-01-02;1;0;7;1;0.0;0.0
14;2021-01-03;0;0;7;1;0.0;0.0
14;2021-01-04;10;0;17;1;0.0;0.0
14;2021-01-05;24;0;41;1;0.0;0.0
14;2021-01-06;350;0;391;1;0.1;0.0
14;2021-01-07;402;2;793;3;0.1;0.0
14;2021-01-08;631;2;1424;5;0.2;0.0
14;2021-01-09;127;0;1551;5;0.2;0.0
14;2021-01-10;41;0;1592;5;0.2;0.0
14;2021-01-11;673;1;2265;6;0.3;0.0
14;2021-01-12;954;2;3219;8;0.5;0.0
14;2021-01-13;849;1;4068;9;0.6;0.0
14;2021-01-14;2839;14;6907;23;1.0;0.0
14;2021-01-15;1898;17;8805;40;1.3;0.0
14;2021-01-16;271;3;9076;43;1.3;0.0
14;2021-01-17;145;7;9221;50;1.3;0.0
14;2021-01-18;1086;5;10307;55;1.5;0.0
14;2021-01-19;1154;2;11461;57;1.7;0.0
14;2021-01-20;1988;2;13449;59;1.9;0.0
14;2021-01-21;1817;6;15266;65;2.2;0.0
14;2021-01-22;1494;5;16760;70;2.4;0.0
14;2021-01-23;297;1;17057;71;2.5;0.0
14;2021-01-24;72;0;17129;71;2.5;0.0
14;2021-01-25;911;10;18040;81;2.6;0.0
14;2021-01-26;848;35;18888;116;2.7;0.0
14;2021-01-27;884;156;19772;272;2.9;0.0
14;2021-01-28;782;103;20554;375;3.0;0.1
14;2021-01-29;786;220;21340;595;3.1;0.1
14;2021-01-30;270;11;21610;606;3.1;0.1
14;2021-01-31;58;1;21668;607;3.1;0.1
14;2021-02-01;729;219;22397;826;3.2;0.1
14;2021-02-02;830;412;23227;1238;3.4;0.2
14;2021-02-03;761;369;23988;1607;3.5;0.2
14;2021-02-04;1171;1850;25159;3457;3.6;0.5
14;2021-02-05;1296;1271;26455;4728;3.8;0.7
14;2021-02-06;396;210;26851;4938;3.9;0.7
14;2021-02-07;179;58;27030;4996;3.9;0.7
14;2021-02-08;774;677;27804;5673;4.0;0.8
14;2021-02-09;723;851;28527;6524;4.1;0.9
14;2021-02-10;825;1411;29352;7935;4.2;1.1
14;2021-02-11;1351;1339;30703;9274;4.4;1.3
14;2021-02-12;1383;961;32086;10235;4.6;1.5
14;2021-02-13;308;152;32394;10387;4.7;1.5
14;2021-02-14;84;44;32478;10431;4.7;1.5
14;2021-02-15;443;869;32921;11300;4.8;1.6
14;2021-02-16;679;708;33600;12008;4.9;1.7
14;2021-02-17;405;759;34005;12767;4.9;1.8
14;2021-02-18;707;688;34712;13455;5.0;1.9
14;2021-02-19;733;600;35445;14055;5.1;2.0
14;2021-02-20;91;209;35536;14264;5.1;2.1
14;2021-02-21;6;79;35542;14343;5.1;2.1
14;2021-02-22;432;798;35974;15141;5.2;2.2
14;2021-02-23;487;695;36461;15836;5.3;2.3
14;2021-02-24;439;689;36900;16525;5.3;2.4
14;2021-02-25;1224;978;38124;17503;5.5;2.5
14;2021-02-26;1576;1014;39700;18517;5.7;2.7
14;2021-02-27;507;226;40207;18743;5.8;2.7
14;2021-02-28;27;32;40234;18775;5.8;2.7
14;2021-03-01;522;750;40756;19525;5.9;2.8
14;2021-03-02;966;665;41722;20190;6.0;2.9
14;2021-03-03;1080;721;42802;20911;6.2;3.0
14;2021-03-04;1949;723;44751;21634;6.5;3.1
14;2021-03-05;2435;782;47186;22416;6.8;3.2
14;2021-03-06;3078;176;50264;22592;7.3;3.3
14;2021-03-07;1196;59;51460;22651;7.4;3.3
14;2021-03-08;1253;710;52713;23361;7.6;3.4
14;2021-03-09;1741;645;54454;24006;7.9;3.5
14;2021-03-10;1835;533;56289;24539;8.1;3.5
14;2021-03-11;2759;433;59048;24972;8.5;3.6
14;2021-03-12;4047;539;63095;25511;9.1;3.7
14;2021-03-13;1852;169;64947;25680;9.4;3.7
14;2021-03-14;31;38;64978;25718;9.4;3.7
14;2021-03-15;2006;142;66984;25860;9.7;3.7
14;2021-03-16;1401;265;68385;26125;9.9;3.8
14;2021-03-17;1155;194;69540;26319;10.1;3.8
14;2021-03-18;1481;295;71021;26614;10.3;3.8
14;2021-03-19;2608;260;73629;26874;10.6;3.9
14;2021-03-20;2659;41;76288;26915;11.0;3.9
14;2021-03-21;454;8;76742;26923;11.1;3.9
14;2021-03-22;1872;360;78614;27283;11.4;3.9
14;2021-03-23;2179;320;80793;27603;11.7;4.0
14;2021-03-24;2432;191;83225;27794;12.0;4.0
14;2021-03-25;3292;317;86517;28111;12.5;4.1
14;2021-03-26;4606;474;91123;28585;13.2;4.1
14;2021-03-27;2230;225;93353;28810;13.5;4.2
14;2021-03-28;36;1;93389;28811;13.5;4.2
14;2021-03-29;1614;478;95003;29289;13.7;4.2
14;2021-03-30;2722;514;97725;29803;14.1;4.3
14;2021-03-31;2326;922;100051;30725;14.5;4.4
14;2021-04-01;4174;1680;104225;32405;15.1;4.7
14;2021-04-02;3867;1266;108092;33671;15.6;4.9
14;2021-04-03;1126;1200;109218;34871;15.8;5.0
14;2021-04-04;25;482;109243;35353;15.8;5.1
14;2021-04-05;1218;324;110461;35677;16.0;5.2
14;2021-04-06;2383;996;112844;36673;16.3;5.3
14;2021-04-07;2730;1032;115574;37705;16.7;5.5
14;2021-04-08;4303;1118;119877;38823;17.3;5.6
14;2021-04-09;6030;1184;125907;40007;18.2;5.8
14;2021-04-10;2896;440;128803;40447;18.6;5.8
14;2021-04-11;629;121;129432;40568;18.7;5.9
14;2021-04-12;2915;1583;132347;42151;19.1;6.1
14;2021-04-13;3471;1442;135818;43593;19.6;6.3
14;2021-04-14;3123;1165;138941;44758;20.1;6.5
14;2021-04-15;4398;1504;143339;46262;20.7;6.7
14;2021-04-16;4598;1566;147937;47828;21.4;6.9
14;2021-04-17;2311;1668;150248;49496;21.7;7.2
14;2021-04-18;539;327;150787;49823;21.8;7.2
14;2021-04-19;2759;1684;153546;51507;22.2;7.4
14;2021-04-20;3389;1816;156935;53323;22.7;7.7
14;2021-04-21;3015;1467;159950;54790;23.1;7.9
14;2021-04-22;4229;2088;164179;56878;23.7;8.2
14;2021-04-23;4651;2302;168830;59180;24.4;8.6
14;2021-04-24;1851;1747;170681;60927;24.7;8.8
14;2021-04-25;456;29;171137;60956;24.8;8.8
14;2021-04-26;3378;1565;174515;62521;25.2;9.0
14;2021-04-27;3504;2560;178019;65081;25.7;9.4
14;2021-04-28;3245;1897;181264;66978;26.2;9.7
14;2021-04-29;4544;2307;185808;69285;26.9;10.0
14;2021-04-30;5124;2629;190932;71914;27.6;10.4
14;2021-05-01;3554;201;194486;72115;28.1;10.4
14;2021-05-02;1237;55;195723;72170;28.3;10.4
14;2021-05-03;2482;2763;198205;74933;28.7;10.8
14;2021-05-04;3128;2892;201333;77825;29.1;11.3
14;2021-05-05;3687;2742;205020;80567;29.7;11.7
14;2021-05-06;4929;3474;209949;84041;30.4;12.2
14;2021-05-07;4868;3834;214817;87875;31.1;12.7
14;2021-05-08;2728;1263;217545;89138;31.5;12.9
14;2021-05-09;1914;671;219459;89809;31.7;13.0
14;2021-05-10;3637;3145;223096;92954;32.3;13.4
14;2021-05-11;4346;3599;227442;96553;32.9;14.0
14;2021-05-12;4053;3215;231495;99768;33.5;14.4
14;2021-05-13;4688;1131;236183;100899;34.2;14.6
14;2021-05-14;6674;2626;242857;103525;35.1;15.0
14;2021-05-15;5148;778;248005;104303;35.9;15.1
14;2021-05-16;2319;120;250324;104423;36.2;15.1
14;2021-05-17;2820;2257;253144;106680;36.6;15.4
14;2021-05-18;4089;2236;257233;108916;37.2;15.8
14;2021-05-19;3752;2022;260985;110938;37.7;16.0
14;2021-05-20;4482;2765;265467;113703;38.4;16.4
14;2021-05-21;4275;3522;269742;117225;39.0;17.0
14;2021-05-22;1669;863;271411;118088;39.3;17.1
14;2021-05-23;649;71;272060;118159;39.3;17.1
14;2021-05-24;2845;751;274905;118910;39.8;17.2
14;2021-05-25;3637;3382;278542;122292;40.3;17.7
14;2021-05-26;3438;2406;281980;124698;40.8;18.0
14;2021-05-27;4771;3232;286751;127930;41.5;18.5
14;2021-05-28;5090;3864;291841;131794;42.2;19.1
14;2021-05-29;2342;2454;294183;134248;42.5;19.4
14;2021-05-30;759;237;294942;134485;42.7;19.4
14;2021-05-31;4091;2964;299033;137449;43.2;19.9
14;2021-06-01;5738;3202;304771;140651;44.1;20.3
14;2021-06-02;5024;2861;309795;143512;44.8;20.8
14;2021-06-03;6658;4017;316453;147529;45.8;21.3
14;2021-06-04;6445;5133;322898;152662;46.7;22.1
14;2021-06-05;4359;1860;327257;154522;47.3;22.3
14;2021-06-06;2043;83;329300;154605;47.6;22.4
14;2021-06-07;4253;3447;333553;158052;48.2;22.9
14;2021-06-08;5234;3128;338787;161180;49.0;23.3
14;2021-06-09;4270;2964;343057;164144;49.6;23.7
14;2021-06-10;5080;2968;348137;167112;50.3;24.2
14;2021-06-11;4840;4875;352977;171987;51.0;24.9
14;2021-06-12;3677;4519;356654;176506;51.6;25.5
14;2021-06-13;848;1089;357502;177595;51.7;25.7
14;2021-06-14;2185;3790;359687;181385;52.0;26.2
14;2021-06-15;3314;3970;363001;185355;52.5;26.8
14;2021-06-16;3446;4553;366447;189908;53.0;27.5
14;2021-06-17;4230;5264;370677;195172;53.6;28.2
14;2021-06-18;3732;6118;374409;201290;54.1;29.1
14;2021-06-19;2591;2951;377000;204241;54.5;29.5
14;2021-06-20;581;1556;377581;205797;54.6;29.8
14;2021-06-21;2121;4355;379702;210152;54.9;30.4
14;2021-06-22;2582;5179;382284;215331;55.3;31.1
14;2021-06-23;2503;4348;384787;219679;55.6;31.8
14;2021-06-24;3450;5809;388237;225488;56.1;32.6
14;2021-06-25;2751;7272;390988;232760;56.5;33.7
14;2021-06-26;2176;4539;393164;237299;56.9;34.3
14;2021-06-27;440;1828;393604;239127;56.9;34.6
14;2021-06-28;1311;3962;394915;243089;57.1;35.2
14;2021-06-29;1790;5363;396705;248452;57.4;35.9
14;2021-06-30;2024;4618;398729;253070;57.7;36.6
14;2021-07-01;2931;5066;401660;258136;58.1;37.3
14;2021-07-02;2600;6666;404260;264802;58.5;38.3
14;2021-07-03;1430;2646;405690;267448;58.7;38.7
14;2021-07-04;422;713;406112;268161;58.7;38.8
14;2021-07-05;1191;4778;407303;272939;58.9;39.5
14;2021-07-06;2090;6000;409393;278939;59.2;40.3
14;2021-07-07;2256;4577;411649;283516;59.5;41.0
14;2021-07-08;2912;5525;414561;289041;60.0;41.8
14;2021-07-09;2771;6431;417332;295472;60.4;42.7
14;2021-07-10;2038;3203;419370;298675;60.7;43.2
14;2021-07-11;900;871;420270;299546;60.8;43.3
14;2021-07-12;1634;5902;421904;305448;61.0;44.2
14;2021-07-13;3081;7338;424985;312786;61.5;45.2
14;2021-07-14;2259;3064;427244;315850;61.8;45.7
14;2021-07-15;4172;7652;431416;323502;62.4;46.8
14;2021-07-16;4709;7696;436125;331198;63.1;47.9
14;2021-07-17;2114;4211;438239;335409;63.4;48.5
14;2021-07-18;821;1869;439060;337278;63.5;48.8
14;2021-07-19;2599;6123;441659;343401;63.9;49.7
14;2021-07-20;3247;7253;444906;350654;64.3;50.7
14;2021-07-21;4105;5842;449011;356496;64.9;51.6
14;2021-07-22;4852;6602;453863;363098;65.6;52.5
14;2021-07-23;5384;6769;459247;369867;66.4;53.5
14;2021-07-24;3084;3790;462331;373657;66.9;54.0
14;2021-07-25;1504;1249;463835;374906;67.1;54.2
14;2021-07-26;4682;4186;468517;379092;67.8;54.8
14;2021-07-27;5405;4359;473922;383451;68.5;55.5
14;2021-07-28;5117;3973;479039;387424;69.3;56.0
14;2021-07-29;6446;4884;485485;392308;70.2;56.7
14;2021-07-30;5842;5169;491327;397477;71.1;57.5
14;2021-07-31;2774;2509;494101;399986;71.5;57.8
14;2021-08-01;1895;934;495996;400920;71.7;58.0
14;2021-08-02;3947;4290;499943;405210;72.3;58.6
14;2021-08-03;4482;4172;504425;409382;73.0;59.2
14;2021-08-04;4649;3536;509074;412918;73.6;59.7
14;2021-08-05;4658;4036;513732;416954;74.3;60.3
14;2021-08-06;4431;4808;518163;421762;74.9;61.0
14;2021-08-07;2133;2294;520296;424056;75.2;61.3
14;2021-08-08;638;854;520934;424910;75.3;61.5
14;2021-08-09;2129;2877;523063;427787;75.6;61.9
14;2021-08-10;3661;4171;526724;431958;76.2;62.5
14;2021-08-11;3074;3449;529798;435407;76.6;63.0
14;2021-08-12;3482;4350;533280;439757;77.1;63.6
14;2021-08-13;2638;4139;535918;443896;77.5;64.2
14;2021-08-14;1424;2009;537342;445905;77.7;64.5
14;2021-08-15;389;1484;537731;447389;77.8;64.7
14;2021-08-16;1833;2784;539564;450173;78.0;65.1
14;2021-08-17;2263;4570;541827;454743;78.4;65.8
14;2021-08-18;2063;4527;543890;459270;78.7;66.4
14;2021-08-19;2336;5086;546226;464356;79.0;67.2
14;2021-08-20;2188;5403;548414;469759;79.3;67.9
14;2021-08-21;1016;2837;549430;472596;79.5;68.3
14;2021-08-22;170;1564;549600;474160;79.5;68.6
14;2021-08-23;1269;4170;550869;478330;79.7;69.2
14;2021-08-24;1347;4302;552216;482632;79.9;69.8
14;2021-08-25;1400;4399;553616;487031;80.1;70.4
14;2021-08-26;1432;5081;555048;492112;80.3;71.2
14;2021-08-27;1468;5289;556516;497401;80.5;71.9
14;2021-08-28;734;3003;557250;500404;80.6;72.4
14;2021-08-29;185;1014;557435;501418;80.6;72.5
14;2021-08-30;1017;3629;558452;505047;80.8;73.0
14;2021-08-31;1329;4805;559781;509852;81.0;73.7
14;2021-09-01;1068;3986;560849;513838;81.1;74.3
14;2021-09-02;862;3350;561711;517188;81.2;74.8
14;2021-09-03;1178;4354;562889;521542;81.4;75.4
14;2021-09-04;663;2371;563552;523913;81.5;75.8
14;2021-09-05;126;413;563678;524326;81.5;75.8
14;2021-09-06;468;2223;564146;526549;81.6;76.2
14;2021-09-07;496;2200;564642;528749;81.7;76.5
14;2021-09-08;679;3173;565321;531922;81.8;76.9
14;2021-09-09;590;2212;565911;534134;81.8;77.2
14;2021-09-10;768;2868;566679;537002;82.0;77.7
14;2021-09-11;521;1626;567200;538628;82.0;77.9
14;2021-09-12;75;295;567275;538923;82.0;77.9
14;2021-09-13;311;1601;567586;540524;82.1;78.2
14;2021-09-14;655;1903;568241;542427;82.2;78.4
14;2021-09-15;715;1998;568956;544425;82.3;78.7
14;2021-09-16;586;1338;569542;545763;82.4;78.9
14;2021-09-17;628;1453;570170;547216;82.5;79.1
14;2021-09-18;217;969;570387;548185;82.5;79.3
14;2021-09-19;41;137;570428;548322;82.5;79.3
14;2021-09-20;331;810;570759;549132;82.5;79.4
14;2021-09-21;538;847;571297;549979;82.6;79.5
14;2021-09-22;483;1754;571780;551733;82.7;79.8
14;2021-09-23;446;783;572226;552516;82.8;79.9
14;2021-09-24;403;1308;572629;553824;82.8;80.1
14;2021-09-25;188;687;572817;554511;82.8;80.2
14;2021-09-26;41;139;572858;554650;82.8;80.2
14;2021-09-27;276;710;573134;555360;82.9;80.3
14;2021-09-28;358;673;573492;556033;82.9;80.4
14;2021-09-29;304;918;573796;556951;83.0;80.5
15;2020-12-27;2;0;2;0;0.0;0.0
15;2020-12-28;0;0;2;0;0.0;0.0
15;2020-12-29;0;0;2;0;0.0;0.0
15;2020-12-30;0;0;2;0;0.0;0.0
15;2020-12-31;0;0;2;0;0.0;0.0
15;2021-01-01;1;0;3;0;0.0;0.0
15;2021-01-02;0;0;3;0;0.0;0.0
15;2021-01-03;0;0;3;0;0.0;0.0
15;2021-01-04;0;0;3;0;0.0;0.0
15;2021-01-05;0;0;3;0;0.0;0.0
15;2021-01-06;0;0;3;0;0.0;0.0
15;2021-01-07;72;0;75;0;0.1;0.0
15;2021-01-08;110;0;185;0;0.1;0.0
15;2021-01-09;0;0;185;0;0.1;0.0
15;2021-01-10;2;0;187;0;0.1;0.0
15;2021-01-11;99;0;286;0;0.2;0.0
15;2021-01-12;94;0;380;0;0.3;0.0
15;2021-01-13;230;0;610;0;0.4;0.0
15;2021-01-14;313;1;923;1;0.6;0.0
15;2021-01-15;138;0;1061;1;0.7;0.0
15;2021-01-16;90;0;1151;1;0.8;0.0
15;2021-01-17;0;0;1151;1;0.8;0.0
15;2021-01-18;404;2;1555;3;1.1;0.0
15;2021-01-19;550;0;2105;3;1.5;0.0
15;2021-01-20;629;1;2734;4;1.9;0.0
15;2021-01-21;576;4;3310;8;2.3;0.0
15;2021-01-22;503;1;3813;9;2.7;0.0
15;2021-01-23;432;1;4245;10;3.0;0.0
15;2021-01-24;6;0;4251;10;3.0;0.0
15;2021-01-25;401;0;4652;10;3.3;0.0
15;2021-01-26;437;0;5089;10;3.6;0.0
15;2021-01-27;736;7;5825;17;4.1;0.0
15;2021-01-28;624;51;6449;68;4.5;0.0
15;2021-01-29;336;80;6785;148;4.8;0.1
15;2021-01-30;218;3;7003;151;4.9;0.1
15;2021-01-31;1;1;7004;152;4.9;0.1
15;2021-02-01;239;81;7243;233;5.1;0.2
15;2021-02-02;189;80;7432;313;5.2;0.2
15;2021-02-03;267;145;7699;458;5.4;0.3
15;2021-02-04;663;166;8362;624;5.9;0.4
15;2021-02-05;296;200;8658;824;6.1;0.6
15;2021-02-06;98;52;8756;876;6.1;0.6
15;2021-02-07;0;0;8756;876;6.1;0.6
15;2021-02-08;233;85;8989;961;6.3;0.7
15;2021-02-09;206;105;9195;1066;6.4;0.7
15;2021-02-10;338;288;9533;1354;6.7;0.9
15;2021-02-11;117;225;9650;1579;6.8;1.1
15;2021-02-12;136;145;9786;1724;6.9;1.2
15;2021-02-13;92;76;9878;1800;6.9;1.3
15;2021-02-14;0;0;9878;1800;6.9;1.3
15;2021-02-15;64;177;9942;1977;7.0;1.4
15;2021-02-16;52;253;9994;2230;7.0;1.6
15;2021-02-17;134;383;10128;2613;7.1;1.8
15;2021-02-18;87;684;10215;3297;7.2;2.3
15;2021-02-19;90;381;10305;3678;7.2;2.6
15;2021-02-20;20;219;10325;3897;7.2;2.7
15;2021-02-21;0;0;10325;3897;7.2;2.7
15;2021-02-22;23;406;10348;4303;7.2;3.0
15;2021-02-23;180;391;10528;4694;7.4;3.3
15;2021-02-24;31;402;10559;5096;7.4;3.6
15;2021-02-25;228;830;10787;5926;7.6;4.1
15;2021-02-26;186;430;10973;6356;7.7;4.5
15;2021-02-27;145;77;11118;6433;7.8;4.5
15;2021-02-28;1;0;11119;6433;7.8;4.5
15;2021-03-01;121;196;11240;6629;7.9;4.6
15;2021-03-02;250;278;11490;6907;8.0;4.8
15;2021-03-03;207;26;11697;6933;8.2;4.9
15;2021-03-04;246;227;11943;7160;8.4;5.0
15;2021-03-05;348;164;12291;7324;8.6;5.1
15;2021-03-06;680;11;12971;7335;9.1;5.1
15;2021-03-07;81;2;13052;7337;9.1;5.1
15;2021-03-08;93;101;13145;7438;9.2;5.2
15;2021-03-09;281;269;13426;7707;9.4;5.4
15;2021-03-10;417;167;13843;7874;9.7;5.5
15;2021-03-11;434;279;14277;8153;10.0;5.7
15;2021-03-12;525;90;14802;8243;10.4;5.8
15;2021-03-13;355;7;15157;8250;10.6;5.8
15;2021-03-14;18;0;15175;8250;10.6;5.8
15;2021-03-15;542;64;15717;8314;11.0;5.8
15;2021-03-16;328;22;16045;8336;11.2;5.8
15;2021-03-17;130;53;16175;8389;11.3;5.9
15;2021-03-18;250;93;16425;8482;11.5;5.9
15;2021-03-19;669;31;17094;8513;12.0;6.0
15;2021-03-20;148;38;17242;8551;12.1;6.0
15;2021-03-21;6;0;17248;8551;12.1;6.0
15;2021-03-22;575;79;17823;8630;12.5;6.0
15;2021-03-23;776;101;18599;8731;13.0;6.1
15;2021-03-24;936;36;19535;8767;13.7;6.1
15;2021-03-25;1282;33;20817;8800;14.6;6.2
15;2021-03-26;1009;62;21826;8862;15.3;6.2
15;2021-03-27;301;7;22127;8869;15.5;6.2
15;2021-03-28;20;0;22147;8869;15.5;6.2
15;2021-03-29;782;18;22929;8887;16.1;6.2
15;2021-03-30;1135;203;24064;9090;16.9;6.4
15;2021-03-31;941;26;25005;9116;17.5;6.4
15;2021-04-01;1233;61;26238;9177;18.4;6.4
15;2021-04-02;1141;61;27379;9238;19.2;6.5
15;2021-04-03;120;18;27499;9256;19.3;6.5
15;2021-04-04;0;0;27499;9256;19.3;6.5
15;2021-04-05;33;3;27532;9259;19.3;6.5
15;2021-04-06;834;86;28366;9345;19.9;6.5
15;2021-04-07;663;108;29029;9453;20.3;6.6
15;2021-04-08;1246;150;30275;9603;21.2;6.7
15;2021-04-09;1277;106;31552;9709;22.1;6.8
15;2021-04-10;364;20;31916;9729;22.3;6.8
15;2021-04-11;14;0;31930;9729;22.4;6.8
15;2021-04-12;644;457;32574;10186;22.8;7.1
15;2021-04-13;1124;321;33698;10507;23.6;7.4
15;2021-04-14;1038;199;34736;10706;24.3;7.5
15;2021-04-15;1183;311;35919;11017;25.2;7.7
15;2021-04-16;1038;552;36957;11569;25.9;8.1
15;2021-04-17;445;14;37402;11583;26.2;8.1
15;2021-04-18;0;10;37402;11593;26.2;8.1
15;2021-04-19;537;514;37939;12107;26.6;8.5
15;2021-04-20;847;615;38786;12722;27.2;8.9
15;2021-04-21;593;651;39379;13373;27.6;9.4
15;2021-04-22;728;775;40107;14148;28.1;9.9
15;2021-04-23;730;676;40837;14824;28.6;10.4
15;2021-04-24;363;123;41200;14947;28.8;10.5
15;2021-04-25;1;3;41201;14950;28.9;10.5
15;2021-04-26;325;632;41526;15582;29.1;10.9
15;2021-04-27;467;938;41993;16520;29.4;11.6
15;2021-04-28;383;785;42376;17305;29.7;12.1
15;2021-04-29;587;1005;42963;18310;30.1;12.8
15;2021-04-30;547;1070;43510;19380;30.5;13.6
15;2021-05-01;283;30;43793;19410;30.7;13.6
15;2021-05-02;0;0;43793;19410;30.7;13.6
15;2021-05-03;881;331;44674;19741;31.3;13.8
15;2021-05-04;801;854;45475;20595;31.8;14.4
15;2021-05-05;676;680;46151;21275;32.3;14.9
15;2021-05-06;826;967;46977;22242;32.9;15.6
15;2021-05-07;1154;903;48131;23145;33.7;16.2
15;2021-05-08;491;55;48622;23200;34.0;16.2
15;2021-05-09;24;9;48646;23209;34.1;16.3
15;2021-05-10;704;910;49350;24119;34.6;16.9
15;2021-05-11;1186;1182;50536;25301;35.4;17.7
15;2021-05-12;1147;837;51683;26138;36.2;18.3
15;2021-05-13;1165;440;52848;26578;37.0;18.6
15;2021-05-14;1503;582;54351;27160;38.1;19.0
15;2021-05-15;1410;417;55761;27577;39.0;19.3
15;2021-05-16;1;10;55762;27587;39.0;19.3
15;2021-05-17;999;605;56761;28192;39.7;19.7
15;2021-05-18;1221;970;57982;29162;40.6;20.4
15;2021-05-19;1020;459;59002;29621;41.3;20.7
15;2021-05-20;1239;781;60241;30402;42.2;21.3
15;2021-05-21;1348;749;61589;31151;43.1;21.8
15;2021-05-22;527;188;62116;31339;43.5;21.9
15;2021-05-23;2;11;62118;31350;43.5;22.0
15;2021-05-24;693;257;62811;31607;44.0;22.1
15;2021-05-25;1151;620;63962;32227;44.8;22.6
15;2021-05-26;1093;459;65055;32686;45.6;22.9
15;2021-05-27;1271;660;66326;33346;46.4;23.3
15;2021-05-28;1509;883;67835;34229;47.5;24.0
15;2021-05-29;984;360;68819;34589;48.2;24.2
15;2021-05-30;14;25;68833;34614;48.2;24.2
15;2021-05-31;1200;480;70033;35094;49.0;24.6
15;2021-06-01;1398;570;71431;35664;50.0;25.0
15;2021-06-02;864;417;72295;36081;50.6;25.3
15;2021-06-03;932;701;73227;36782;51.3;25.8
15;2021-06-04;1076;713;74303;37495;52.0;26.3
15;2021-06-05;651;262;74954;37757;52.5;26.4
15;2021-06-06;16;20;74970;37777;52.5;26.5
15;2021-06-07;797;350;75767;38127;53.1;26.7
15;2021-06-08;477;394;76244;38521;53.4;27.0
15;2021-06-09;375;376;76619;38897;53.7;27.2
15;2021-06-10;276;423;76895;39320;53.8;27.5
15;2021-06-11;660;1099;77555;40419;54.3;28.3
15;2021-06-12;377;467;77932;40886;54.6;28.6
15;2021-06-13;11;6;77943;40892;54.6;28.6
15;2021-06-14;542;977;78485;41869;55.0;29.3
15;2021-06-15;450;1164;78935;43033;55.3;30.1
15;2021-06-16;543;899;79478;43932;55.7;30.8
15;2021-06-17;292;934;79770;44866;55.9;31.4
15;2021-06-18;740;1205;80510;46071;56.4;32.3
15;2021-06-19;542;704;81052;46775;56.8;32.8
15;2021-06-20;11;1;81063;46776;56.8;32.8
15;2021-06-21;279;1042;81342;47818;57.0;33.5
15;2021-06-22;232;1479;81574;49297;57.1;34.5
15;2021-06-23;346;1445;81920;50742;57.4;35.5
15;2021-06-24;291;1094;82211;51836;57.6;36.3
15;2021-06-25;379;1640;82590;53476;57.8;37.4
15;2021-06-26;164;908;82754;54384;57.9;38.1
15;2021-06-27;0;0;82754;54384;57.9;38.1
15;2021-06-28;176;1228;82930;55612;58.1;38.9
15;2021-06-29;302;1264;83232;56876;58.3;39.8
15;2021-06-30;268;981;83500;57857;58.5;40.5
15;2021-07-01;380;1220;83880;59077;58.7;41.4
15;2021-07-02;410;1348;84290;60425;59.0;42.3
15;2021-07-03;252;707;84542;61132;59.2;42.8
15;2021-07-04;1;1;84543;61133;59.2;42.8
15;2021-07-05;248;1257;84791;62390;59.4;43.7
15;2021-07-06;275;1467;85066;63857;59.6;44.7
15;2021-07-07;255;1343;85321;65200;59.7;45.7
15;2021-07-08;489;1353;85810;66553;60.1;46.6
15;2021-07-09;488;1783;86298;68336;60.4;47.9
15;2021-07-10;215;862;86513;69198;60.6;48.5
15;2021-07-11;9;5;86522;69203;60.6;48.5
15;2021-07-12;278;1484;86800;70687;60.8;49.5
15;2021-07-13;587;1775;87387;72462;61.2;50.7
15;2021-07-14;16;130;87403;72592;61.2;50.8
15;2021-07-15;1132;728;88535;73320;62.0;51.3
15;2021-07-16;1139;1336;89674;74656;62.8;52.3
15;2021-07-17;819;953;90493;75609;63.4;52.9
15;2021-07-18;0;3;90493;75612;63.4;52.9
15;2021-07-19;1074;1270;91567;76882;64.1;53.8
15;2021-07-20;1613;547;93180;77429;65.2;54.2
15;2021-07-21;1190;603;94370;78032;66.1;54.6
15;2021-07-22;894;511;95264;78543;66.7;55.0
15;2021-07-23;1341;1064;96605;79607;67.6;55.7
15;2021-07-24;628;769;97233;80376;68.1;56.3
15;2021-07-25;1;24;97234;80400;68.1;56.3
15;2021-07-26;1247;594;98481;80994;69.0;56.7
15;2021-07-27;1691;575;100172;81569;70.1;57.1
15;2021-07-28;1238;581;101410;82150;71.0;57.5
15;2021-07-29;838;399;102248;82549;71.6;57.8
15;2021-07-30;1007;1130;103255;83679;72.3;58.6
15;2021-07-31;604;637;103859;84316;72.7;59.0
15;2021-08-01;21;12;103880;84328;72.7;59.0
15;2021-08-02;1143;542;105023;84870;73.5;59.4
15;2021-08-03;1162;383;106185;85253;74.4;59.7
15;2021-08-04;788;408;106973;85661;74.9;60.0
15;2021-08-05;383;284;107356;85945;75.2;60.2
15;2021-08-06;789;1235;108145;87180;75.7;61.0
15;2021-08-07;265;1160;108410;88340;75.9;61.9
15;2021-08-08;3;6;108413;88346;75.9;61.9
15;2021-08-09;511;1164;108924;89510;76.3;62.7
15;2021-08-10;435;725;109359;90235;76.6;63.2
15;2021-08-11;411;1007;109770;91242;76.9;63.9
15;2021-08-12;520;1182;110290;92424;77.2;64.7
15;2021-08-13;682;1137;110972;93561;77.7;65.5
15;2021-08-14;179;552;111151;94113;77.8;65.9
15;2021-08-15;17;9;111168;94122;77.8;65.9
15;2021-08-16;387;1134;111555;95256;78.1;66.7
15;2021-08-17;402;1140;111957;96396;78.4;67.5
15;2021-08-18;368;803;112325;97199;78.7;68.1
15;2021-08-19;300;878;112625;98077;78.9;68.7
15;2021-08-20;601;1215;113226;99292;79.3;69.5
15;2021-08-21;218;867;113444;100159;79.4;70.1
15;2021-08-22;12;26;113456;100185;79.4;70.2
15;2021-08-23;229;611;113685;100796;79.6;70.6
15;2021-08-24;246;590;113931;101386;79.8;71.0
15;2021-08-25;155;493;114086;101879;79.9;71.3
15;2021-08-26;136;362;114222;102241;80.0;71.6
15;2021-08-27;366;1337;114588;103578;80.2;72.5
15;2021-08-28;214;857;114802;104435;80.4;73.1
15;2021-08-29;7;13;114809;104448;80.4;73.1
15;2021-08-30;225;1062;115034;105510;80.5;73.9
15;2021-08-31;404;667;115438;106177;80.8;74.3
15;2021-09-01;181;445;115619;106622;81.0;74.7
15;2021-09-02;94;276;115713;106898;81.0;74.9
15;2021-09-03;202;1007;115915;107905;81.2;75.6
15;2021-09-04;157;422;116072;108327;81.3;75.9
15;2021-09-05;0;2;116072;108329;81.3;75.9
15;2021-09-06;98;490;116170;108819;81.3;76.2
15;2021-09-07;100;230;116270;109049;81.4;76.4
15;2021-09-08;199;589;116469;109638;81.6;76.8
15;2021-09-09;100;353;116569;109991;81.6;77.0
15;2021-09-10;231;997;116800;110988;81.8;77.7
15;2021-09-11;95;365;116895;111353;81.9;78.0
15;2021-09-12;0;0;116895;111353;81.9;78.0
15;2021-09-13;102;386;116997;111739;81.9;78.2
15;2021-09-14;122;254;117119;111993;82.0;78.4
15;2021-09-15;69;247;117188;112240;82.1;78.6
15;2021-09-16;33;101;117221;112341;82.1;78.7
15;2021-09-17;265;604;117486;112945;82.3;79.1
15;2021-09-18;79;380;117565;113325;82.3;79.4
15;2021-09-19;0;0;117565;113325;82.3;79.4
15;2021-09-20;123;217;117688;113542;82.4;79.5
15;2021-09-21;41;107;117729;113649;82.4;79.6
15;2021-09-22;84;355;117813;114004;82.5;79.8
15;2021-09-23;37;108;117850;114112;82.5;79.9
15;2021-09-24;135;334;117985;114446;82.6;80.1
15;2021-09-25;42;217;118027;114663;82.6;80.3
15;2021-09-26;0;5;118027;114668;82.6;80.3
15;2021-09-27;88;133;118115;114801;82.7;80.4
15;2021-09-28;65;131;118180;114932;82.8;80.5
15;2021-09-29;68;190;118248;115122;82.8;80.6
16;2020-12-27;0;0;0;0;0.0;0.0
16;2020-12-28;2;0;2;0;0.0;0.0
16;2020-12-29;0;0;2;0;0.0;0.0
16;2020-12-30;1;0;3;0;0.0;0.0
16;2020-12-31;0;0;3;0;0.0;0.0
16;2021-01-01;0;0;3;0;0.0;0.0
16;2021-01-02;0;0;3;0;0.0;0.0
16;2021-01-03;0;0;3;0;0.0;0.0
16;2021-01-04;1;0;4;0;0.0;0.0
16;2021-01-05;1;0;5;0;0.0;0.0
16;2021-01-06;88;0;93;0;0.0;0.0
16;2021-01-07;240;0;333;0;0.1;0.0
16;2021-01-08;465;2;798;2;0.2;0.0
16;2021-01-09;1;0;799;2;0.2;0.0
16;2021-01-10;1;0;800;2;0.2;0.0
16;2021-01-11;304;0;1104;2;0.3;0.0
16;2021-01-12;437;1;1541;3;0.4;0.0
16;2021-01-13;480;0;2021;3;0.6;0.0
16;2021-01-14;601;6;2622;9;0.8;0.0
16;2021-01-15;504;3;3126;12;0.9;0.0
16;2021-01-16;0;0;3126;12;0.9;0.0
16;2021-01-17;0;0;3126;12;0.9;0.0
16;2021-01-18;432;2;3558;14;1.0;0.0
16;2021-01-19;835;2;4393;16;1.3;0.0
16;2021-01-20;1187;2;5580;18;1.6;0.0
16;2021-01-21;1383;3;6963;21;2.0;0.0
16;2021-01-22;1115;0;8078;21;2.3;0.0
16;2021-01-23;183;0;8261;21;2.4;0.0
16;2021-01-24;0;0;8261;21;2.4;0.0
16;2021-01-25;641;2;8902;23;2.6;0.0
16;2021-01-26;1025;1;9927;24;2.9;0.0
16;2021-01-27;1406;105;11333;129;3.3;0.0
16;2021-01-28;1276;53;12609;182;3.6;0.1
16;2021-01-29;742;125;13351;307;3.8;0.1
16;2021-01-30;36;0;13387;307;3.8;0.1
16;2021-01-31;0;0;13387;307;3.8;0.1
16;2021-02-01;394;197;13781;504;4.0;0.1
16;2021-02-02;576;161;14357;665;4.1;0.2
16;2021-02-03;621;342;14978;1007;4.3;0.3
16;2021-02-04;464;254;15442;1261;4.4;0.4
16;2021-02-05;505;261;15947;1522;4.6;0.4
16;2021-02-06;3;80;15950;1602;4.6;0.5
16;2021-02-07;41;3;15991;1605;4.6;0.5
16;2021-02-08;356;188;16347;1793;4.7;0.5
16;2021-02-09;650;248;16997;2041;4.9;0.6
16;2021-02-10;693;597;17690;2638;5.1;0.8
16;2021-02-11;802;515;18492;3153;5.3;0.9
16;2021-02-12;622;792;19114;3945;5.5;1.1
16;2021-02-13;43;77;19157;4022;5.5;1.2
16;2021-02-14;2;5;19159;4027;5.5;1.2
16;2021-02-15;217;570;19376;4597;5.6;1.3
16;2021-02-16;373;791;19749;5388;5.7;1.5
16;2021-02-17;346;1155;20095;6543;5.8;1.9
16;2021-02-18;511;1048;20606;7591;5.9;2.2
16;2021-02-19;389;637;20995;8228;6.0;2.4
16;2021-02-20;2;8;20997;8236;6.0;2.4
16;2021-02-21;2;0;20999;8236;6.0;2.4
16;2021-02-22;136;407;21135;8643;6.1;2.5
16;2021-02-23;206;677;21341;9320;6.1;2.7
16;2021-02-24;277;770;21618;10090;6.2;2.9
16;2021-02-25;395;528;22013;10618;6.3;3.0
16;2021-02-26;479;423;22492;11041;6.5;3.2
16;2021-02-27;249;1;22741;11042;6.5;3.2
16;2021-02-28;5;1;22746;11043;6.5;3.2
16;2021-03-01;152;237;22898;11280;6.6;3.2
16;2021-03-02;271;513;23169;11793;6.7;3.4
16;2021-03-03;391;622;23560;12415;6.8;3.6
16;2021-03-04;803;509;24363;12924;7.0;3.7
16;2021-03-05;1143;489;25506;13413;7.3;3.9
16;2021-03-06;753;13;26259;13426;7.5;3.9
16;2021-03-07;94;18;26353;13444;7.6;3.9
16;2021-03-08;437;272;26790;13716;7.7;3.9
16;2021-03-09;774;554;27564;14270;7.9;4.1
16;2021-03-10;606;593;28170;14863;8.1;4.3
16;2021-03-11;1447;506;29617;15369;8.5;4.4
16;2021-03-12;1164;422;30781;15791;8.8;4.5
16;2021-03-13;765;15;31546;15806;9.1;4.5
16;2021-03-14;1;0;31547;15806;9.1;4.5
16;2021-03-15;462;171;32009;15977;9.2;4.6
16;2021-03-16;860;401;32869;16378;9.4;4.7
16;2021-03-17;590;280;33459;16658;9.6;4.8
16;2021-03-18;1033;267;34492;16925;9.9;4.9
16;2021-03-19;1103;232;35595;17157;10.2;4.9
16;2021-03-20;396;5;35991;17162;10.3;4.9
16;2021-03-21;9;0;36000;17162;10.3;4.9
16;2021-03-22;728;96;36728;17258;10.5;5.0
16;2021-03-23;1464;101;38192;17359;11.0;5.0
16;2021-03-24;1123;182;39315;17541;11.3;5.0
16;2021-03-25;2047;87;41362;17628;11.9;5.1
16;2021-03-26;1916;98;43278;17726;12.4;5.1
16;2021-03-27;432;21;43710;17747;12.6;5.1
16;2021-03-28;0;0;43710;17747;12.6;5.1
16;2021-03-29;923;60;44633;17807;12.8;5.1
16;2021-03-30;1883;175;46516;17982;13.4;5.2
16;2021-03-31;1513;134;48029;18116;13.8;5.2
16;2021-04-01;2009;398;50038;18514;14.4;5.3
16;2021-04-02;1442;378;51480;18892;14.8;5.4
16;2021-04-03;288;5;51768;18897;14.9;5.4
16;2021-04-04;1;0;51769;18897;14.9;5.4
16;2021-04-05;2;0;51771;18897;14.9;5.4
16;2021-04-06;2013;546;53784;19443;15.4;5.6
16;2021-04-07;1954;404;55738;19847;16.0;5.7
16;2021-04-08;2824;583;58562;20430;16.8;5.9
16;2021-04-09;2695;552;61257;20982;17.6;6.0
16;2021-04-10;1290;37;62547;21019;18.0;6.0
16;2021-04-11;2;0;62549;21019;18.0;6.0
16;2021-04-12;1431;316;63980;21335;18.4;6.1
16;2021-04-13;2124;838;66104;22173;19.0;6.4
16;2021-04-14;1951;630;68055;22803;19.5;6.5
16;2021-04-15;2102;979;70157;23782;20.1;6.8
16;2021-04-16;2043;786;72200;24568;20.7;7.1
16;2021-04-17;1507;92;73707;24660;21.2;7.1
16;2021-04-18;197;3;73904;24663;21.2;7.1
16;2021-04-19;1440;523;75344;25186;21.6;7.2
16;2021-04-20;2053;1231;77397;26417;22.2;7.6
16;2021-04-21;1776;750;79173;27167;22.7;7.8
16;2021-04-22;2290;1006;81463;28173;23.4;8.1
16;2021-04-23;2362;1167;83825;29340;24.1;8.4
16;2021-04-24;829;38;84654;29378;24.3;8.4
16;2021-04-25;117;5;84771;29383;24.3;8.4
16;2021-04-26;1400;808;86171;30191;24.7;8.7
16;2021-04-27;2055;1410;88226;31601;25.3;9.1
16;2021-04-28;1592;1124;89818;32725;25.8;9.4
16;2021-04-29;2250;1483;92068;34208;26.4;9.8
16;2021-04-30;2856;1338;94924;35546;27.3;10.2
16;2021-05-01;353;60;95277;35606;27.4;10.2
16;2021-05-02;155;13;95432;35619;27.4;10.2
16;2021-05-03;2610;528;98042;36147;28.2;10.4
16;2021-05-04;2057;2040;100099;38187;28.7;11.0
16;2021-05-05;1688;1826;101787;40013;29.2;11.5
16;2021-05-06;1886;2236;103673;42249;29.8;12.1
16;2021-05-07;3071;2115;106744;44364;30.7;12.7
16;2021-05-08;1197;466;107941;44830;31.0;12.9
16;2021-05-09;530;27;108471;44857;31.2;12.9
16;2021-05-10;1930;1623;110401;46480;31.7;13.3
16;2021-05-11;2354;1959;112755;48439;32.4;13.9
16;2021-05-12;1734;1792;114489;50231;32.9;14.4
16;2021-05-13;1461;354;115950;50585;33.3;14.5
16;2021-05-14;1988;1551;117938;52136;33.9;15.0
16;2021-05-15;596;895;118534;53031;34.0;15.2
16;2021-05-16;132;6;118666;53037;34.1;15.2
16;2021-05-17;1609;1285;120275;54322;34.5;15.6
16;2021-05-18;2756;1422;123031;55744;35.3;16.0
16;2021-05-19;2006;1241;125037;56985;35.9;16.4
16;2021-05-20;2832;1389;127869;58374;36.7;16.8
16;2021-05-21;2943;1388;130812;59762;37.6;17.2
16;2021-05-22;411;711;131223;60473;37.7;17.4
16;2021-05-23;210;11;131433;60484;37.7;17.4
16;2021-05-24;1262;234;132695;60718;38.1;17.4
16;2021-05-25;2759;1461;135454;62179;38.9;17.9
16;2021-05-26;1833;1185;137287;63364;39.4;18.2
16;2021-05-27;2416;1582;139703;64946;40.1;18.7
16;2021-05-28;2899;1556;142602;66502;41.0;19.1
16;2021-05-29;814;883;143416;67385;41.2;19.4
16;2021-05-30;1;4;143417;67389;41.2;19.4
16;2021-05-31;1984;1100;145401;68489;41.8;19.7
16;2021-06-01;2344;1703;147745;70192;42.4;20.2
16;2021-06-02;1820;1502;149565;71694;43.0;20.6
16;2021-06-03;2622;1758;152187;73452;43.7;21.1
16;2021-06-04;2833;2028;155020;75480;44.5;21.7
16;2021-06-05;1006;546;156026;76026;44.8;21.8
16;2021-06-06;161;29;156187;76055;44.9;21.8
16;2021-06-07;1991;1281;158178;77336;45.4;22.2
16;2021-06-08;2394;1991;160572;79327;46.1;22.8
16;2021-06-09;2528;1616;163100;80943;46.8;23.2
16;2021-06-10;2569;1995;165669;82938;47.6;23.8
16;2021-06-11;2152;2730;167821;85668;48.2;24.6
16;2021-06-12;1613;517;169434;86185;48.7;24.8
16;2021-06-13;260;72;169694;86257;48.7;24.8
16;2021-06-14;798;2795;170492;89052;49.0;25.6
16;2021-06-15;1866;2623;172358;91675;49.5;26.3
16;2021-06-16;1575;2083;173933;93758;50.0;26.9
16;2021-06-17;2040;2496;175973;96254;50.5;27.6
16;2021-06-18;2060;3214;178033;99468;51.1;28.6
16;2021-06-19;1352;1311;179385;100779;51.5;28.9
16;2021-06-20;243;28;179628;100807;51.6;29.0
16;2021-06-21;1411;2166;181039;102973;52.0;29.6
16;2021-06-22;1675;2943;182714;105916;52.5;30.4
16;2021-06-23;1562;2015;184276;107931;52.9;31.0
16;2021-06-24;1928;2167;186204;110098;53.5;31.6
16;2021-06-25;1984;2726;188188;112824;54.0;32.4
16;2021-06-26;1060;725;189248;113549;54.4;32.6
16;2021-06-27;132;25;189380;113574;54.4;32.6
16;2021-06-28;1164;1962;190544;115536;54.7;33.2
16;2021-06-29;1282;3359;191826;118895;55.1;34.1
16;2021-06-30;1337;2713;193163;121608;55.5;34.9
16;2021-07-01;1866;3153;195029;124761;56.0;35.8
16;2021-07-02;1423;3578;196452;128339;56.4;36.9
16;2021-07-03;696;1108;197148;129447;56.6;37.2
16;2021-07-04;3;15;197151;129462;56.6;37.2
16;2021-07-05;815;2297;197966;131759;56.9;37.8
16;2021-07-06;1278;3363;199244;135122;57.2;38.8
16;2021-07-07;871;2275;200115;137397;57.5;39.5
16;2021-07-08;1234;2732;201349;140129;57.8;40.2
16;2021-07-09;1113;3707;202462;143836;58.1;41.3
16;2021-07-10;338;1337;202800;145173;58.2;41.7
16;2021-07-11;2;13;202802;145186;58.2;41.7
16;2021-07-12;634;2432;203436;147618;58.4;42.4
16;2021-07-13;1385;3527;204821;151145;58.8;43.4
16;2021-07-14;797;877;205618;152022;59.1;43.7
16;2021-07-15;1249;3406;206867;155428;59.4;44.6
16;2021-07-16;1498;3377;208365;158805;59.8;45.6
16;2021-07-17;539;1188;208904;159993;60.0;46.0
16;2021-07-18;14;6;208918;159999;60.0;46.0
16;2021-07-19;618;2851;209536;162850;60.2;46.8
16;2021-07-20;1125;3281;210661;166131;60.5;47.7
16;2021-07-21;1117;2619;211778;168750;60.8;48.5
16;2021-07-22;1871;2853;213649;171603;61.4;49.3
16;2021-07-23;1552;3544;215201;175147;61.8;50.3
16;2021-07-24;639;1206;215840;176353;62.0;50.6
16;2021-07-25;11;11;215851;176364;62.0;50.7
16;2021-07-26;1529;2128;217380;178492;62.4;51.3
16;2021-07-27;1865;2819;219245;181311;63.0;52.1
16;2021-07-28;1863;2307;221108;183618;63.5;52.7
16;2021-07-29;2240;2472;223348;186090;64.1;53.4
16;2021-07-30;2355;3103;225703;189193;64.8;54.3
16;2021-07-31;960;1353;226663;190546;65.1;54.7
16;2021-08-01;192;22;226855;190568;65.2;54.7
16;2021-08-02;2121;1826;228976;192394;65.8;55.3
16;2021-08-03;2121;2323;231097;194717;66.4;55.9
16;2021-08-04;2121;1886;233218;196603;67.0;56.5
16;2021-08-05;2775;1654;235993;198257;67.8;56.9
16;2021-08-06;2511;2365;238504;200622;68.5;57.6
16;2021-08-07;828;559;239332;201181;68.7;57.8
16;2021-08-08;36;33;239368;201214;68.7;57.8
16;2021-08-09;2181;1060;241549;202274;69.4;58.1
16;2021-08-10;2887;1584;244436;203858;70.2;58.5
16;2021-08-11;2603;1232;247039;205090;71.0;58.9
16;2021-08-12;2012;1734;249051;206824;71.5;59.4
16;2021-08-13;2686;1467;251737;208291;72.3;59.8
16;2021-08-14;757;455;252494;208746;72.5;60.0
16;2021-08-15;29;4;252523;208750;72.5;60.0
16;2021-08-16;1339;1582;253862;210332;72.9;60.4
16;2021-08-17;1837;1628;255699;211960;73.4;60.9
16;2021-08-18;1591;1471;257290;213431;73.9;61.3
16;2021-08-19;1517;1777;258807;215208;74.3;61.8
16;2021-08-20;1601;1902;260408;217110;74.8;62.4
16;2021-08-21;564;827;260972;217937;75.0;62.6
16;2021-08-22;4;5;260976;217942;75.0;62.6
16;2021-08-23;993;2064;261969;220006;75.2;63.2
16;2021-08-24;1039;2375;263008;222381;75.5;63.9
16;2021-08-25;886;1781;263894;224162;75.8;64.4
16;2021-08-26;876;2531;264770;226693;76.0;65.1
16;2021-08-27;854;2408;265624;229101;76.3;65.8
16;2021-08-28;260;771;265884;229872;76.4;66.0
16;2021-08-29;2;15;265886;229887;76.4;66.0
16;2021-08-30;638;2396;266524;232283;76.5;66.7
16;2021-08-31;667;2632;267191;234915;76.7;67.5
16;2021-09-01;469;2544;267660;237459;76.9;68.2
16;2021-09-02;542;2366;268202;239825;77.0;68.9
16;2021-09-03;541;2812;268743;242637;77.2;69.7
16;2021-09-04;361;965;269104;243602;77.3;70.0
16;2021-09-05;5;29;269109;243631;77.3;70.0
16;2021-09-06;317;1760;269426;245391;77.4;70.5
16;2021-09-07;353;1990;269779;247381;77.5;71.0
16;2021-09-08;389;2213;270168;249594;77.6;71.7
16;2021-09-09;344;1710;270512;251304;77.7;72.2
16;2021-09-10;441;2099;270953;253403;77.8;72.8
16;2021-09-11;185;847;271138;254250;77.9;73.0
16;2021-09-12;6;23;271144;254273;77.9;73.0
16;2021-09-13;256;1350;271400;255623;77.9;73.4
16;2021-09-14;368;1441;271768;257064;78.1;73.8
16;2021-09-15;348;1347;272116;258411;78.2;74.2
16;2021-09-16;303;887;272419;259298;78.2;74.5
16;2021-09-17;498;1374;272917;260672;78.4;74.9
16;2021-09-18;101;535;273018;261207;78.4;75.0
16;2021-09-19;0;9;273018;261216;78.4;75.0
16;2021-09-20;191;720;273209;261936;78.5;75.2
16;2021-09-21;183;673;273392;262609;78.5;75.4
16;2021-09-22;187;990;273579;263599;78.6;75.7
16;2021-09-23;170;559;273749;264158;78.6;75.9
16;2021-09-24;337;1049;274086;265207;78.7;76.2
16;2021-09-25;64;439;274150;265646;78.7;76.3
16;2021-09-26;1;6;274151;265652;78.7;76.3
16;2021-09-27;191;580;274342;266232;78.8;76.5
16;2021-09-28;145;536;274487;266768;78.8;76.6
16;2021-09-29;197;605;274684;267373;78.9;76.8
17;2020-12-27;0;0;0;0;0.0;0.0
17;2020-12-28;0;0;0;0;0.0;0.0
17;2020-12-29;0;0;0;0;0.0;0.0
17;2020-12-30;1;0;1;0;0.0;0.0
17;2020-12-31;0;0;1;0;0.0;0.0
17;2021-01-01;1;0;2;0;0.0;0.0
17;2021-01-02;1;0;3;0;0.0;0.0
17;2021-01-03;0;0;3;0;0.0;0.0
17;2021-01-04;56;0;59;0;0.0;0.0
17;2021-01-05;98;0;157;0;0.0;0.0
17;2021-01-06;132;0;289;0;0.0;0.0
17;2021-01-07;484;1;773;1;0.1;0.0
17;2021-01-08;418;0;1191;1;0.2;0.0
17;2021-01-09;0;0;1191;1;0.2;0.0
17;2021-01-10;1;0;1192;1;0.2;0.0
17;2021-01-11;381;1;1573;2;0.2;0.0
17;2021-01-12;751;1;2324;3;0.4;0.0
17;2021-01-13;654;2;2978;5;0.5;0.0
17;2021-01-14;616;8;3594;13;0.6;0.0
17;2021-01-15;681;1;4275;14;0.7;0.0
17;2021-01-16;129;2;4404;16;0.7;0.0
17;2021-01-17;19;0;4423;16;0.7;0.0
17;2021-01-18;887;2;5310;18;0.8;0.0
17;2021-01-19;1910;3;7220;21;1.1;0.0
17;2021-01-20;2396;2;9616;23;1.5;0.0
17;2021-01-21;2500;3;12116;26;1.9;0.0
17;2021-01-22;1892;6;14008;32;2.2;0.0
17;2021-01-23;738;1;14746;33;2.3;0.0
17;2021-01-24;50;0;14796;33;2.3;0.0
17;2021-01-25;1383;5;16179;38;2.5;0.0
17;2021-01-26;2110;2;18289;40;2.8;0.0
17;2021-01-27;1676;32;19965;72;3.1;0.0
17;2021-01-28;2476;217;22441;289;3.5;0.0
17;2021-01-29;1740;157;24181;446;3.7;0.1
17;2021-01-30;528;3;24709;449;3.8;0.1
17;2021-01-31;37;2;24746;451;3.8;0.1
17;2021-02-01;741;186;25487;637;3.9;0.1
17;2021-02-02;1202;320;26689;957;4.1;0.1
17;2021-02-03;1297;375;27986;1332;4.3;0.2
17;2021-02-04;1162;436;29148;1768;4.5;0.3
17;2021-02-05;603;695;29751;2463;4.6;0.4
17;2021-02-06;24;39;29775;2502;4.6;0.4
17;2021-02-07;31;13;29806;2515;4.6;0.4
17;2021-02-08;706;348;30512;2863;4.7;0.4
17;2021-02-09;1101;1082;31613;3945;4.9;0.6
17;2021-02-10;866;1219;32479;5164;5.0;0.8
17;2021-02-11;1241;1296;33720;6460;5.2;1.0
17;2021-02-12;773;881;34493;7341;5.3;1.1
17;2021-02-13;43;93;34536;7434;5.3;1.1
17;2021-02-14;1;10;34537;7444;5.3;1.2
17;2021-02-15;621;925;35158;8369;5.4;1.3
17;2021-02-16;751;1431;35909;9800;5.5;1.5
17;2021-02-17;795;1000;36704;10800;5.7;1.7
17;2021-02-18;965;1714;37669;12514;5.8;1.9
17;2021-02-19;1069;1249;38738;13763;6.0;2.1
17;2021-02-20;105;258;38843;14021;6.0;2.2
17;2021-02-21;9;2;38852;14023;6.0;2.2
17;2021-02-22;648;1246;39500;15269;6.1;2.4
17;2021-02-23;782;1216;40282;16485;6.2;2.5
17;2021-02-24;1080;1292;41362;17777;6.4;2.7
17;2021-02-25;1087;1458;42449;19235;6.6;3.0
17;2021-02-26;1307;1046;43756;20281;6.8;3.1
17;2021-02-27;527;212;44283;20493;6.8;3.2
17;2021-02-28;19;9;44302;20502;6.8;3.2
17;2021-03-01;638;868;44940;21370;6.9;3.3
17;2021-03-02;1095;740;46035;22110;7.1;3.4
17;2021-03-03;1618;684;47653;22794;7.4;3.5
17;2021-03-04;2425;1010;50078;23804;7.7;3.7
17;2021-03-05;2662;566;52740;24370;8.2;3.8
17;2021-03-06;1027;28;53767;24398;8.3;3.8
17;2021-03-07;183;17;53950;24415;8.3;3.8
17;2021-03-08;1018;748;54968;25163;8.5;3.9
17;2021-03-09;1745;521;56713;25684;8.8;4.0
17;2021-03-10;2047;592;58760;26276;9.1;4.1
17;2021-03-11;3227;921;61987;27197;9.6;4.2
17;2021-03-12;3356;567;65343;27764;10.1;4.3
17;2021-03-13;1202;11;66545;27775;10.3;4.3
17;2021-03-14;33;0;66578;27775;10.3;4.3
17;2021-03-15;1243;961;67821;28736;10.5;4.4
17;2021-03-16;892;517;68713;29253;10.6;4.5
17;2021-03-17;1460;689;70173;29942;10.8;4.6
17;2021-03-18;1683;757;71856;30699;11.1;4.7
17;2021-03-19;2096;535;73952;31234;11.4;4.8
17;2021-03-20;1086;57;75038;31291;11.6;4.8
17;2021-03-21;37;41;75075;31332;11.6;4.8
17;2021-03-22;1577;682;76652;32014;11.8;4.9
17;2021-03-23;2491;573;79143;32587;12.2;5.0
17;2021-03-24;3545;842;82688;33429;12.8;5.2
17;2021-03-25;4713;639;87401;34068;13.5;5.3
17;2021-03-26;4943;468;92344;34536;14.3;5.3
17;2021-03-27;1737;68;94081;34604;14.5;5.3
17;2021-03-28;369;45;94450;34649;14.6;5.4
17;2021-03-29;2361;566;96811;35215;15.0;5.4
17;2021-03-30;2654;976;99465;36191;15.4;5.6
17;2021-03-31;3843;899;103308;37090;16.0;5.7
17;2021-04-01;4012;1157;107320;38247;16.6;5.9
17;2021-04-02;3710;831;111030;39078;17.2;6.0
17;2021-04-03;1152;187;112182;39265;17.3;6.1
17;2021-04-04;501;6;112683;39271;17.4;6.1
17;2021-04-05;445;128;113128;39399;17.5;6.1
17;2021-04-06;3480;1025;116608;40424;18.0;6.2
17;2021-04-07;4131;1149;120739;41573;18.7;6.4
17;2021-04-08;4567;1476;125306;43049;19.4;6.7
17;2021-04-09;6499;842;131805;43891;20.4;6.8
17;2021-04-10;2582;68;134387;43959;20.8;6.8
17;2021-04-11;790;16;135177;43975;20.9;6.8
17;2021-04-12;2889;1610;138066;45585;21.3;7.0
17;2021-04-13;4152;1281;142218;46866;22.0;7.2
17;2021-04-14;4419;1206;146637;48072;22.7;7.4
17;2021-04-15;4599;1134;151236;49206;23.4;7.6
17;2021-04-16;4298;1153;155534;50359;24.0;7.8
17;2021-04-17;1682;382;157216;50741;24.3;7.8
17;2021-04-18;471;81;157687;50822;24.4;7.9
17;2021-04-19;2336;2053;160023;52875;24.7;8.2
17;2021-04-20;2927;2547;162950;55422;25.2;8.6
17;2021-04-21;2974;1940;165924;57362;25.6;8.9
17;2021-04-22;3122;2355;169046;59717;26.1;9.2
17;2021-04-23;2446;2723;171492;62440;26.5;9.6
17;2021-04-24;1669;923;173161;63363;26.8;9.8
17;2021-04-25;664;244;173825;63607;26.9;9.8
17;2021-04-26;2578;2610;176403;66217;27.3;10.2
17;2021-04-27;3150;2658;179553;68875;27.7;10.6
17;2021-04-28;3102;2915;182655;71790;28.2;11.1
17;2021-04-29;4149;2835;186804;74625;28.9;11.5
17;2021-04-30;4355;2620;191159;77245;29.5;11.9
17;2021-05-01;849;539;192008;77784;29.7;12.0
17;2021-05-02;553;837;192561;78621;29.8;12.2
17;2021-05-03;2546;2953;195107;81574;30.2;12.6
17;2021-05-04;2316;3710;197423;85284;30.5;13.2
17;2021-05-05;2907;3697;200330;88981;31.0;13.8
17;2021-05-06;4120;3391;204450;92372;31.6;14.3
17;2021-05-07;4359;3618;208809;95990;32.3;14.8
17;2021-05-08;1306;751;210115;96741;32.5;15.0
17;2021-05-09;1311;705;211426;97446;32.7;15.1
17;2021-05-10;2726;3674;214152;101120;33.1;15.6
17;2021-05-11;3500;3986;217652;105106;33.6;16.2
17;2021-05-12;3529;3797;221181;108903;34.2;16.8
17;2021-05-13;2542;693;223723;109596;34.6;16.9
17;2021-05-14;3031;2392;226754;111988;35.0;17.3
17;2021-05-15;2127;654;228881;112642;35.4;17.4
17;2021-05-16;1733;316;230614;112958;35.6;17.5
17;2021-05-17;4288;1997;234902;114955;36.3;17.8
17;2021-05-18;4745;1629;239647;116584;37.0;18.0
17;2021-05-19;5070;1281;244717;117865;37.8;18.2
17;2021-05-20;4940;1935;249657;119800;38.6;18.5
17;2021-05-21;4994;1943;254651;121743;39.4;18.8
17;2021-05-22;2391;529;257042;122272;39.7;18.9
17;2021-05-23;1900;128;258942;122400;40.0;18.9
17;2021-05-24;1426;210;260368;122610;40.2;18.9
17;2021-05-25;4031;1767;264399;124377;40.9;19.2
17;2021-05-26;4368;2035;268767;126412;41.5;19.5
17;2021-05-27;5211;2136;273978;128548;42.3;19.9
17;2021-05-28;4467;3412;278445;131960;43.0;20.4
17;2021-05-29;1559;1696;280004;133656;43.3;20.7
17;2021-05-30;857;410;280861;134066;43.4;20.7
17;2021-05-31;2946;2998;283807;137064;43.9;21.2
17;2021-06-01;4296;2915;288103;139979;44.5;21.6
17;2021-06-02;4203;3167;292306;143146;45.2;22.1
17;2021-06-03;5057;3144;297363;146290;46.0;22.6
17;2021-06-04;4513;3849;301876;150139;46.7;23.2
17;2021-06-05;1991;1594;303867;151733;47.0;23.4
17;2021-06-06;852;734;304719;152467;47.1;23.6
17;2021-06-07;3137;4339;307856;156806;47.6;24.2
17;2021-06-08;3790;4493;311646;161299;48.2;24.9
17;2021-06-09;4344;3048;315990;164347;48.8;25.4
17;2021-06-10;4927;2782;320917;167129;49.6;25.8
17;2021-06-11;4793;3679;325710;170808;50.3;26.4
17;2021-06-12;1813;1387;327523;172195;50.6;26.6
17;2021-06-13;612;415;328135;172610;50.7;26.7
17;2021-06-14;2834;4533;330969;177143;51.1;27.4
17;2021-06-15;3624;4368;334593;181511;51.7;28.1
17;2021-06-16;4127;3692;338720;185203;52.3;28.6
17;2021-06-17;4367;4110;343087;189313;53.0;29.3
17;2021-06-18;4059;4435;347146;193748;53.6;29.9
17;2021-06-19;1450;1975;348596;195723;53.9;30.2
17;2021-06-20;595;1036;349191;196759;54.0;30.4
17;2021-06-21;2559;4369;351750;201128;54.4;31.1
17;2021-06-22;3530;4450;355280;205578;54.9;31.8
17;2021-06-23;3795;3994;359075;209572;55.5;32.4
17;2021-06-24;3599;3952;362674;213524;56.0;33.0
17;2021-06-25;2718;4984;365392;218508;56.5;33.8
17;2021-06-26;905;2333;366297;220841;56.6;34.1
17;2021-06-27;397;1903;366694;222744;56.7;34.4
17;2021-06-28;1523;5413;368217;228157;56.9;35.3
17;2021-06-29;1684;5889;369901;234046;57.2;36.2
17;2021-06-30;2029;5545;371930;239591;57.5;37.0
17;2021-07-01;2267;5560;374197;245151;57.8;37.9
17;2021-07-02;2485;5979;376682;251130;58.2;38.8
17;2021-07-03;627;2533;377309;253663;58.3;39.2
17;2021-07-04;155;1250;377464;254913;58.3;39.4
17;2021-07-05;1887;5176;379351;260089;58.6;40.2
17;2021-07-06;2129;5595;381480;265684;59.0;41.1
17;2021-07-07;2406;5496;383886;271180;59.3;41.9
17;2021-07-08;2915;5442;386801;276622;59.8;42.7
17;2021-07-09;2526;6073;389327;282695;60.2;43.7
17;2021-07-10;826;2469;390153;285164;60.3;44.1
17;2021-07-11;379;906;390532;286070;60.4;44.2
17;2021-07-12;2002;5617;392534;291687;60.7;45.1
17;2021-07-13;2372;6717;394906;298404;61.0;46.1
17;2021-07-14;71;71;394977;298475;61.0;46.1
17;2021-07-15;2190;6861;397167;305336;61.4;47.2
17;2021-07-16;2777;6964;399944;312300;61.8;48.3
17;2021-07-17;1051;2271;400995;314571;62.0;48.6
17;2021-07-18;312;1036;401307;315607;62.0;48.8
17;2021-07-19;2635;5904;403942;321511;62.4;49.7
17;2021-07-20;3314;6312;407256;327823;62.9;50.7
17;2021-07-21;3802;6023;411058;333846;63.5;51.6
17;2021-07-22;4248;6264;415306;340110;64.2;52.6
17;2021-07-23;3904;6562;419210;346672;64.8;53.6
17;2021-07-24;2067;1390;421277;348062;65.1;53.8
17;2021-07-25;1040;417;422317;348479;65.3;53.9
17;2021-07-26;3735;5425;426052;353904;65.8;54.7
17;2021-07-27;4728;5438;430780;359342;66.6;55.5
17;2021-07-28;5215;5161;435995;364503;67.4;56.3
17;2021-07-29;5166;5339;441161;369842;68.2;57.2
17;2021-07-30;5510;5573;446671;375415;69.0;58.0
17;2021-07-31;2116;1213;448787;376628;69.4;58.2
17;2021-08-01;1095;359;449882;376987;69.5;58.3
17;2021-08-02;4620;4391;454502;381378;70.2;58.9
17;2021-08-03;5761;4160;460263;385538;71.1;59.6
17;2021-08-04;6201;3379;466464;388917;72.1;60.1
17;2021-08-05;6390;3148;472854;392065;73.1;60.6
17;2021-08-06;5888;3600;478742;395665;74.0;61.1
17;2021-08-07;1991;867;480733;396532;74.3;61.3
17;2021-08-08;978;219;481711;396751;74.4;61.3
17;2021-08-09;3920;3689;485631;400440;75.0;61.9
17;2021-08-10;5086;3486;490717;403926;75.8;62.4
17;2021-08-11;4918;3811;495635;407737;76.6;63.0
17;2021-08-12;4895;3957;500530;411694;77.4;63.6
17;2021-08-13;4520;4142;505050;415836;78.1;64.3
17;2021-08-14;1239;1383;506289;417219;78.2;64.5
17;2021-08-15;407;375;506696;417594;78.3;64.5
17;2021-08-16;2852;4063;509548;421657;78.7;65.2
17;2021-08-17;3052;4289;512600;425946;79.2;65.8
17;2021-08-18;2622;4554;515222;430500;79.6;66.5
17;2021-08-19;2733;4372;517955;434872;80.0;67.2
17;2021-08-20;2496;5023;520451;439895;80.4;68.0
17;2021-08-21;684;1355;521135;441250;80.5;68.2
17;2021-08-22;217;458;521352;441708;80.6;68.3
17;2021-08-23;1988;4954;523340;446662;80.9;69.0
17;2021-08-24;1941;5091;525281;451753;81.2;69.8
17;2021-08-25;1658;5505;526939;457258;81.4;70.7
17;2021-08-26;1603;5761;528542;463019;81.7;71.6
17;2021-08-27;1550;5954;530092;468973;81.9;72.5
17;2021-08-28;521;1455;530613;470428;82.0;72.7
17;2021-08-29;87;575;530700;471003;82.0;72.8
17;2021-08-30;1434;5106;532134;476109;82.2;73.6
17;2021-08-31;1326;5356;533460;481465;82.4;74.4
17;2021-09-01;1194;5117;534654;486582;82.6;75.2
17;2021-09-02;1136;4549;535790;491131;82.8;75.9
17;2021-09-03;1167;5337;536957;496468;83.0;76.7
17;2021-09-04;286;971;537243;497439;83.0;76.9
17;2021-09-05;53;139;537296;497578;83.0;76.9
17;2021-09-06;727;3734;538023;501312;83.1;77.5
17;2021-09-07;717;3259;538740;504571;83.3;78.0
17;2021-09-08;822;4140;539562;508711;83.4;78.6
17;2021-09-09;814;3192;540376;511903;83.5;79.1
17;2021-09-10;791;3950;541167;515853;83.6;79.7
17;2021-09-11;299;1001;541466;516854;83.7;79.9
17;2021-09-12;10;23;541476;516877;83.7;79.9
17;2021-09-13;647;2799;542123;519676;83.8;80.3
17;2021-09-14;615;2750;542738;522426;83.9;80.7
17;2021-09-15;938;2374;543676;524800;84.0;81.1
17;2021-09-16;539;1451;544215;526251;84.1;81.3
17;2021-09-17;610;1921;544825;528172;84.2;81.6
17;2021-09-18;192;582;545017;528754;84.2;81.7
17;2021-09-19;12;6;545029;528760;84.2;81.7
17;2021-09-20;428;1225;545457;529985;84.3;81.9
17;2021-09-21;324;892;545781;530877;84.3;82.0
17;2021-09-22;419;1692;546200;532569;84.4;82.3
17;2021-09-23;357;970;546557;533539;84.5;82.5
17;2021-09-24;383;1821;546940;535360;84.5;82.7
17;2021-09-25;126;472;547066;535832;84.5;82.8
17;2021-09-26;0;16;547066;535848;84.5;82.8
17;2021-09-27;436;1176;547502;537024;84.6;83.0
17;2021-09-28;272;685;547774;537709;84.7;83.1
17;2021-09-29;438;1207;548212;538916;84.7;83.3
18;2020-12-27;0;0;0;0;0.0;0.0
18;2020-12-28;0;0;0;0;0.0;0.0
18;2020-12-29;0;0;0;0;0.0;0.0
18;2020-12-30;1;0;1;0;0.0;0.0
18;2020-12-31;0;0;1;0;0.0;0.0
18;2021-01-01;0;0;1;0;0.0;0.0
18;2021-01-02;0;0;1;0;0.0;0.0
18;2021-01-03;0;0;1;0;0.0;0.0
18;2021-01-04;3;0;4;0;0.0;0.0
18;2021-01-05;0;0;4;0;0.0;0.0
18;2021-01-06;1;0;5;0;0.0;0.0
18;2021-01-07;30;1;35;1;0.0;0.0
18;2021-01-08;65;0;100;1;0.0;0.0
18;2021-01-09;225;0;325;1;0.1;0.0
18;2021-01-10;146;0;471;1;0.2;0.0
18;2021-01-11;169;0;640;1;0.2;0.0
18;2021-01-12;371;0;1011;1;0.3;0.0
18;2021-01-13;270;1;1281;2;0.4;0.0
18;2021-01-14;269;2;1550;4;0.5;0.0
18;2021-01-15;332;2;1882;6;0.6;0.0
18;2021-01-16;288;2;2170;8;0.7;0.0
18;2021-01-17;1;0;2171;8;0.7;0.0
18;2021-01-18;291;0;2462;8;0.8;0.0
18;2021-01-19;1373;2;3835;10;1.3;0.0
18;2021-01-20;1239;2;5074;12;1.7;0.0
18;2021-01-21;965;0;6039;12;2.0;0.0
18;2021-01-22;780;2;6819;14;2.3;0.0
18;2021-01-23;249;2;7068;16;2.4;0.0
18;2021-01-24;0;0;7068;16;2.4;0.0
18;2021-01-25;509;0;7577;16;2.6;0.0
18;2021-01-26;395;1;7972;17;2.7;0.0
18;2021-01-27;390;2;8362;19;2.8;0.0
18;2021-01-28;566;8;8928;27;3.0;0.0
18;2021-01-29;491;72;9419;99;3.2;0.0
18;2021-01-30;431;135;9850;234;3.3;0.1
18;2021-01-31;82;97;9932;331;3.4;0.1
18;2021-02-01;328;119;10260;450;3.5;0.2
18;2021-02-02;507;227;10767;677;3.6;0.2
18;2021-02-03;398;201;11165;878;3.8;0.3
18;2021-02-04;630;226;11795;1104;4.0;0.4
18;2021-02-05;448;181;12243;1285;4.1;0.4
18;2021-02-06;283;88;12526;1373;4.2;0.5
18;2021-02-07;108;1;12634;1374;4.3;0.5
18;2021-02-08;268;189;12902;1563;4.4;0.5
18;2021-02-09;583;759;13485;2322;4.5;0.8
18;2021-02-10;741;628;14226;2950;4.8;1.0
18;2021-02-11;655;412;14881;3362;5.0;1.1
18;2021-02-12;502;303;15383;3665;5.2;1.2
18;2021-02-13;286;107;15669;3772;5.3;1.3
18;2021-02-14;364;97;16033;3869;5.4;1.3
18;2021-02-15;378;308;16411;4177;5.5;1.4
18;2021-02-16;399;327;16810;4504;5.7;1.5
18;2021-02-17;403;385;17213;4889;5.8;1.6
18;2021-02-18;344;456;17557;5345;5.9;1.8
18;2021-02-19;471;244;18028;5589;6.1;1.9
18;2021-02-20;721;191;18749;5780;6.3;2.0
18;2021-02-21;317;4;19066;5784;6.4;2.0
18;2021-02-22;217;293;19283;6077;6.5;2.1
18;2021-02-23;204;270;19487;6347;6.6;2.1
18;2021-02-24;241;200;19728;6547;6.7;2.2
18;2021-02-25;294;453;20022;7000;6.8;2.4
18;2021-02-26;583;191;20605;7191;7.0;2.4
18;2021-02-27;510;346;21115;7537;7.1;2.5
18;2021-02-28;7;66;21122;7603;7.1;2.6
18;2021-03-01;237;345;21359;7948;7.2;2.7
18;2021-03-02;284;462;21643;8410;7.3;2.8
18;2021-03-03;346;526;21989;8936;7.4;3.0
18;2021-03-04;475;520;22464;9456;7.6;3.2
18;2021-03-05;524;335;22988;9791;7.8;3.3
18;2021-03-06;1071;307;24059;10098;8.1;3.4
18;2021-03-07;7;131;24066;10229;8.1;3.5
18;2021-03-08;335;313;24401;10542;8.2;3.6
18;2021-03-09;411;328;24812;10870;8.4;3.7
18;2021-03-10;422;414;25234;11284;8.5;3.8
18;2021-03-11;518;383;25752;11667;8.7;3.9
18;2021-03-12;705;283;26457;11950;8.9;4.0
18;2021-03-13;1164;241;27621;12191;9.3;4.1
18;2021-03-14;301;214;27922;12405;9.4;4.2
18;2021-03-15;492;365;28414;12770;9.6;4.3
18;2021-03-16;392;302;28806;13072;9.7;4.4
18;2021-03-17;383;407;29189;13479;9.8;4.5
18;2021-03-18;512;220;29701;13699;10.0;4.6
18;2021-03-19;755;221;30456;13920;10.3;4.7
18;2021-03-20;986;614;31442;14534;10.6;4.9
18;2021-03-21;308;305;31750;14839;10.7;5.0
18;2021-03-22;602;292;32352;15131;10.9;5.1
18;2021-03-23;707;287;33059;15418;11.2;5.2
18;2021-03-24;1052;295;34111;15713;11.5;5.3
18;2021-03-25;1049;299;35160;16012;11.9;5.4
18;2021-03-26;1209;347;36369;16359;12.3;5.5
18;2021-03-27;1488;317;37857;16676;12.8;5.6
18;2021-03-28;215;0;38072;16676;12.8;5.6
18;2021-03-29;1102;197;39174;16873;13.2;5.7
18;2021-03-30;1084;302;40258;17175;13.6;5.8
18;2021-03-31;1305;252;41563;17427;14.0;5.9
18;2021-04-01;1375;347;42938;17774;14.5;6.0
18;2021-04-02;1229;309;44167;18083;14.9;6.1
18;2021-04-03;581;181;44748;18264;15.1;6.2
18;2021-04-04;71;5;44819;18269;15.1;6.2
18;2021-04-05;199;0;45018;18269;15.2;6.2
18;2021-04-06;1027;350;46045;18619;15.5;6.3
18;2021-04-07;1322;363;47367;18982;16.0;6.4
18;2021-04-08;1692;347;49059;19329;16.6;6.5
18;2021-04-09;1833;281;50892;19610;17.2;6.6
18;2021-04-10;2632;652;53524;20262;18.1;6.8
18;2021-04-11;1986;319;55510;20581;18.7;6.9
18;2021-04-12;1401;404;56911;20985;19.2;7.1
18;2021-04-13;1785;470;58696;21455;19.8;7.2
18;2021-04-14;1378;517;60074;21972;20.3;7.4
18;2021-04-15;1532;530;61606;22502;20.8;7.6
18;2021-04-16;1614;590;63220;23092;21.3;7.8
18;2021-04-17;1599;520;64819;23612;21.9;8.0
18;2021-04-18;377;232;65196;23844;22.0;8.0
18;2021-04-19;1317;592;66513;24436;22.4;8.2
18;2021-04-20;1446;715;67959;25151;22.9;8.5
18;2021-04-21;1270;908;69229;26059;23.4;8.8
18;2021-04-22;1403;703;70632;26762;23.8;9.0
18;2021-04-23;1387;734;72019;27496;24.3;9.3
18;2021-04-24;1355;1271;73374;28767;24.8;9.7
18;2021-04-25;287;217;73661;28984;24.9;9.8
18;2021-04-26;1205;955;74866;29939;25.3;10.1
18;2021-04-27;1545;764;76411;30703;25.8;10.4
18;2021-04-28;1358;876;77769;31579;26.2;10.7
18;2021-04-29;1851;735;79620;32314;26.9;10.9
18;2021-04-30;1569;991;81189;33305;27.4;11.2
18;2021-05-01;788;210;81977;33515;27.7;11.3
18;2021-05-02;806;61;82783;33576;27.9;11.3
18;2021-05-03;1627;1012;84410;34588;28.5;11.7
18;2021-05-04;1729;1283;86139;35871;29.1;12.1
18;2021-05-05;1735;1213;87874;37084;29.6;12.5
18;2021-05-06;2162;1363;90036;38447;30.4;13.0
18;2021-05-07;1234;1398;91270;39845;30.8;13.4
18;2021-05-08;994;1464;92264;41309;31.1;13.9
18;2021-05-09;500;2258;92764;43567;31.3;14.7
18;2021-05-10;1157;1508;93921;45075;31.7;15.2
18;2021-05-11;1696;1748;95617;46823;32.3;15.8
18;2021-05-12;1807;1495;97424;48318;32.9;16.3
18;2021-05-13;1061;370;98485;48688;33.2;16.4
18;2021-05-14;1345;942;99830;49630;33.7;16.7
18;2021-05-15;1809;1163;101639;50793;34.3;17.1
18;2021-05-16;537;581;102176;51374;34.5;17.3
18;2021-05-17;1245;1091;103421;52465;34.9;17.7
18;2021-05-18;2146;933;105567;53398;35.6;18.0
18;2021-05-19;2162;920;107729;54318;36.3;18.3
18;2021-05-20;2275;983;110004;55301;37.1;18.7
18;2021-05-21;1495;764;111499;56065;37.6;18.9
18;2021-05-22;1724;1072;113223;57137;38.2;19.3
18;2021-05-23;486;336;113709;57473;38.4;19.4
18;2021-05-24;461;292;114170;57765;38.5;19.5
18;2021-05-25;1841;1057;116011;58822;39.1;19.8
18;2021-05-26;2153;846;118164;59668;39.9;20.1
18;2021-05-27;2209;1228;120373;60896;40.6;20.5
18;2021-05-28;1712;1306;122085;62202;41.2;21.0
18;2021-05-29;2621;1661;124706;63863;42.1;21.5
18;2021-05-30;1482;504;126188;64367;42.6;21.7
18;2021-05-31;1785;693;127973;65060;43.2;21.9
18;2021-06-01;2038;948;130011;66008;43.9;22.3
18;2021-06-02;2010;1015;132021;67023;44.5;22.6
18;2021-06-03;2283;1198;134304;68221;45.3;23.0
18;2021-06-04;1912;1121;136216;69342;46.0;23.4
18;2021-06-05;2800;1445;139016;70787;46.9;23.9
18;2021-06-06;364;381;139380;71168;47.0;24.0
18;2021-06-07;1294;1232;140674;72400;47.5;24.4
18;2021-06-08;1490;1394;142164;73794;48.0;24.9
18;2021-06-09;1329;1068;143493;74862;48.4;25.3
18;2021-06-10;1631;1408;145124;76270;49.0;25.7
18;2021-06-11;1496;1404;146620;77674;49.5;26.2
18;2021-06-12;1245;2510;147865;80184;49.9;27.1
18;2021-06-13;126;262;147991;80446;49.9;27.1
18;2021-06-14;656;1828;148647;82274;50.2;27.8
18;2021-06-15;1093;1823;149740;84097;50.5;28.4
18;2021-06-16;1255;1441;150995;85538;50.9;28.9
18;2021-06-17;1205;1671;152200;87209;51.3;29.4
18;2021-06-18;1290;1665;153490;88874;51.8;30.0
18;2021-06-19;1564;1251;155054;90125;52.3;30.4
18;2021-06-20;246;159;155300;90284;52.4;30.5
18;2021-06-21;665;1601;155965;91885;52.6;31.0
18;2021-06-22;1068;1645;157033;93530;53.0;31.6
18;2021-06-23;944;1642;157977;95172;53.3;32.1
18;2021-06-24;1033;1062;159010;96234;53.6;32.5
18;2021-06-25;892;1745;159902;97979;53.9;33.1
18;2021-06-26;1097;1474;160999;99453;54.3;33.6
18;2021-06-27;31;372;161030;99825;54.3;33.7
18;2021-06-28;422;1922;161452;101747;54.5;34.3
18;2021-06-29;597;2377;162049;104124;54.7;35.1
18;2021-06-30;600;2543;162649;106667;54.9;36.0
18;2021-07-01;963;2155;163612;108822;55.2;36.7
18;2021-07-02;614;1685;164226;110507;55.4;37.3
18;2021-07-03;754;2572;164980;113079;55.7;38.2
18;2021-07-04;164;1032;165144;114111;55.7;38.5
18;2021-07-05;765;1877;165909;115988;56.0;39.1
18;2021-07-06;559;2300;166468;118288;56.2;39.9
18;2021-07-07;766;2115;167234;120403;56.4;40.6
18;2021-07-08;1032;1984;168266;122387;56.8;41.3
18;2021-07-09;703;2305;168969;124692;57.0;42.1
18;2021-07-10;781;3172;169750;127864;57.3;43.1
18;2021-07-11;82;665;169832;128529;57.3;43.4
18;2021-07-12;223;2253;170055;130782;57.4;44.1
18;2021-07-13;619;2904;170674;133686;57.6;45.1
18;2021-07-14;194;936;170868;134622;57.6;45.4
18;2021-07-15;1396;2814;172264;137436;58.1;46.4
18;2021-07-16;1185;2122;173449;139558;58.5;47.1
18;2021-07-17;1130;2470;174579;142028;58.9;47.9
18;2021-07-18;228;332;174807;142360;59.0;48.0
18;2021-07-19;1055;1657;175862;144017;59.3;48.6
18;2021-07-20;1625;2269;177487;146286;59.9;49.4
18;2021-07-21;1901;2061;179388;148347;60.5;50.0
18;2021-07-22;2211;1900;181599;150247;61.3;50.7
18;2021-07-23;1395;1612;182994;151859;61.7;51.2
18;2021-07-24;891;1532;183885;153391;62.0;51.8
18;2021-07-25;192;396;184077;153787;62.1;51.9
18;2021-07-26;1398;1503;185475;155290;62.6;52.4
18;2021-07-27;1824;1535;187299;156825;63.2;52.9
18;2021-07-28;2198;1796;189497;158621;63.9;53.5
18;2021-07-29;2140;1816;191637;160437;64.7;54.1
18;2021-07-30;1585;1343;193222;161780;65.2;54.6
18;2021-07-31;1237;1280;194459;163060;65.6;55.0
18;2021-08-01;90;34;194549;163094;65.6;55.0
18;2021-08-02;1410;765;195959;163859;66.1;55.3
18;2021-08-03;1719;1630;197678;165489;66.7;55.8
18;2021-08-04;2441;1102;200119;166591;67.5;56.2
18;2021-08-05;1529;1247;201648;167838;68.0;56.6
18;2021-08-06;1582;1140;203230;168978;68.6;57.0
18;2021-08-07;609;764;203839;169742;68.8;57.3
18;2021-08-08;49;60;203888;169802;68.8;57.3
18;2021-08-09;1105;874;204993;170676;69.2;57.6
18;2021-08-10;1208;1511;206201;172187;69.6;58.1
18;2021-08-11;1608;1509;207809;173696;70.1;58.6
18;2021-08-12;1554;1594;209363;175290;70.6;59.1
18;2021-08-13;1087;1172;210450;176462;71.0;59.5
18;2021-08-14;759;603;211209;177065;71.3;59.7
18;2021-08-15;35;17;211244;177082;71.3;59.7
18;2021-08-16;830;1201;212074;178283;71.5;60.1
18;2021-08-17;979;1999;213053;180282;71.9;60.8
18;2021-08-18;1158;1961;214211;182243;72.3;61.5
18;2021-08-19;1105;1612;215316;183855;72.6;62.0
18;2021-08-20;911;1758;216227;185613;73.0;62.6
18;2021-08-21;419;705;216646;186318;73.1;62.9
18;2021-08-22;22;73;216668;186391;73.1;62.9
18;2021-08-23;488;1680;217156;188071;73.3;63.5
18;2021-08-24;903;1494;218059;189565;73.6;64.0
18;2021-08-25;840;1863;218899;191428;73.9;64.6
18;2021-08-26;772;1532;219671;192960;74.1;65.1
18;2021-08-27;575;1995;220246;194955;74.3;65.8
18;2021-08-28;501;870;220747;195825;74.5;66.1
18;2021-08-29;92;176;220839;196001;74.5;66.1
18;2021-08-30;528;1443;221367;197444;74.7;66.6
18;2021-08-31;507;1442;221874;198886;74.9;67.1
18;2021-09-01;578;1643;222452;200529;75.1;67.7
18;2021-09-02;398;1268;222850;201797;75.2;68.1
18;2021-09-03;455;1304;223305;203101;75.3;68.5
18;2021-09-04;356;810;223661;203911;75.5;68.8
18;2021-09-05;29;80;223690;203991;75.5;68.8
18;2021-09-06;278;1090;223968;205081;75.6;69.2
18;2021-09-07;279;992;224247;206073;75.7;69.5
18;2021-09-08;401;1137;224648;207210;75.8;69.9
18;2021-09-09;355;1146;225003;208356;75.9;70.3
18;2021-09-10;406;1091;225409;209447;76.0;70.7
18;2021-09-11;262;866;225671;210313;76.1;71.0
18;2021-09-12;8;32;225679;210345;76.1;71.0
18;2021-09-13;310;860;225989;211205;76.2;71.3
18;2021-09-14;273;1014;226262;212219;76.3;71.6
18;2021-09-15;319;1050;226581;213269;76.4;72.0
18;2021-09-16;469;876;227050;214145;76.6;72.2
18;2021-09-17;337;737;227387;214882;76.7;72.5
18;2021-09-18;177;617;227564;215499;76.8;72.7
18;2021-09-19;6;3;227570;215502;76.8;72.7
18;2021-09-20;156;550;227726;216052;76.8;72.9
18;2021-09-21;111;423;227837;216475;76.9;73.0
18;2021-09-22;193;870;228030;217345;76.9;73.3
18;2021-09-23;249;466;228279;217811;77.0;73.5
18;2021-09-24;141;489;228420;218300;77.1;73.6
18;2021-09-25;159;688;228579;218988;77.1;73.9
18;2021-09-26;15;89;228594;219077;77.1;73.9
18;2021-09-27;107;314;228701;219391;77.2;74.0
18;2021-09-28;69;273;228770;219664;77.2;74.1
18;2021-09-29;63;280;228833;219944;77.2;74.2
19;2020-12-27;0;0;0;0;0.0;0.0
19;2020-12-28;0;0;0;0;0.0;0.0
19;2020-12-29;1;0;1;0;0.0;0.0
19;2020-12-30;0;0;1;0;0.0;0.0
19;2020-12-31;0;0;1;0;0.0;0.0
19;2021-01-01;0;0;1;0;0.0;0.0
19;2021-01-02;0;0;1;0;0.0;0.0
19;2021-01-03;0;0;1;0;0.0;0.0
19;2021-01-04;0;0;1;0;0.0;0.0
19;2021-01-05;0;0;1;0;0.0;0.0
19;2021-01-06;0;0;1;0;0.0;0.0
19;2021-01-07;344;1;345;1;0.1;0.0
19;2021-01-08;248;1;593;2;0.2;0.0
19;2021-01-09;1;0;594;2;0.2;0.0
19;2021-01-10;1;0;595;2;0.2;0.0
19;2021-01-11;38;0;633;2;0.3;0.0
19;2021-01-12;416;1;1049;3;0.4;0.0
19;2021-01-13;429;3;1478;6;0.6;0.0
19;2021-01-14;475;0;1953;6;0.8;0.0
19;2021-01-15;226;0;2179;6;0.9;0.0
19;2021-01-16;0;0;2179;6;0.9;0.0
19;2021-01-17;1;0;2180;6;0.9;0.0
19;2021-01-18;251;2;2431;8;1.0;0.0
19;2021-01-19;521;0;2952;8;1.2;0.0
19;2021-01-20;921;5;3873;13;1.6;0.0
19;2021-01-21;507;4;4380;17;1.8;0.0
19;2021-01-22;1318;5;5698;22;2.4;0.0
19;2021-01-23;281;0;5979;22;2.5;0.0
19;2021-01-24;37;0;6016;22;2.5;0.0
19;2021-01-25;233;0;6249;22;2.6;0.0
19;2021-01-26;608;3;6857;25;2.9;0.0
19;2021-01-27;334;3;7191;28;3.0;0.0
19;2021-01-28;297;153;7488;181;3.1;0.1
19;2021-01-29;348;54;7836;235;3.3;0.1
19;2021-01-30;130;24;7966;259;3.3;0.1
19;2021-01-31;41;0;8007;259;3.3;0.1
19;2021-02-01;158;94;8165;353;3.4;0.1
19;2021-02-02;303;424;8468;777;3.5;0.3
19;2021-02-03;285;235;8753;1012;3.6;0.4
19;2021-02-04;255;363;9008;1375;3.7;0.6
19;2021-02-05;311;74;9319;1449;3.9;0.6
19;2021-02-06;214;2;9533;1451;4.0;0.6
19;2021-02-07;48;2;9581;1453;4.0;0.6
19;2021-02-08;177;92;9758;1545;4.1;0.6
19;2021-02-09;333;178;10091;1723;4.2;0.7
19;2021-02-10;517;222;10608;1945;4.4;0.8
19;2021-02-11;414;299;11022;2244;4.6;0.9
19;2021-02-12;799;1124;11821;3368;4.9;1.4
19;2021-02-13;352;140;12173;3508;5.1;1.5
19;2021-02-14;98;5;12271;3513;5.1;1.5
19;2021-02-15;200;213;12471;3726;5.2;1.6
19;2021-02-16;386;149;12857;3875;5.3;1.6
19;2021-02-17;306;392;13163;4267;5.5;1.8
19;2021-02-18;174;422;13337;4689;5.5;2.0
19;2021-02-19;469;259;13806;4948;5.7;2.1
19;2021-02-20;133;158;13939;5106;5.8;2.1
19;2021-02-21;20;33;13959;5139;5.8;2.1
19;2021-02-22;221;190;14180;5329;5.9;2.2
19;2021-02-23;268;311;14448;5640;6.0;2.3
19;2021-02-24;361;179;14809;5819;6.2;2.4
19;2021-02-25;519;342;15328;6161;6.4;2.6
19;2021-02-26;395;270;15723;6431;6.5;2.7
19;2021-02-27;348;133;16071;6564;6.7;2.7
19;2021-02-28;68;32;16139;6596;6.7;2.7
19;2021-03-01;266;196;16405;6792;6.8;2.8
19;2021-03-02;428;224;16833;7016;7.0;2.9
19;2021-03-03;692;303;17525;7319;7.3;3.0
19;2021-03-04;826;325;18351;7644;7.6;3.2
19;2021-03-05;891;667;19242;8311;8.0;3.5
19;2021-03-06;1072;174;20314;8485;8.5;3.5
19;2021-03-07;463;32;20777;8517;8.6;3.5
19;2021-03-08;640;135;21417;8652;8.9;3.6
19;2021-03-09;836;227;22253;8879;9.3;3.7
19;2021-03-10;1155;276;23408;9155;9.7;3.8
19;2021-03-11;1274;291;24682;9446;10.3;3.9
19;2021-03-12;1136;379;25818;9825;10.7;4.1
19;2021-03-13;1110;160;26928;9985;11.2;4.2
19;2021-03-14;161;80;27089;10065;11.3;4.2
19;2021-03-15;699;131;27788;10196;11.6;4.2
19;2021-03-16;688;298;28476;10494;11.8;4.4
19;2021-03-17;839;277;29315;10771;12.2;4.5
19;2021-03-18;767;279;30082;11050;12.5;4.6
19;2021-03-19;1014;483;31096;11533;12.9;4.8
19;2021-03-20;783;131;31879;11664;13.3;4.9
19;2021-03-21;128;3;32007;11667;13.3;4.9
19;2021-03-22;548;174;32555;11841;13.5;4.9
19;2021-03-23;1045;229;33600;12070;14.0;5.0
19;2021-03-24;1172;371;34772;12441;14.5;5.2
19;2021-03-25;1189;404;35961;12845;15.0;5.3
19;2021-03-26;1325;274;37286;13119;15.5;5.5
19;2021-03-27;854;185;38140;13304;15.9;5.5
19;2021-03-28;63;60;38203;13364;15.9;5.6
19;2021-03-29;612;176;38815;13540;16.2;5.6
19;2021-03-30;971;343;39786;13883;16.6;5.8
19;2021-03-31;1157;490;40943;14373;17.0;6.0
19;2021-04-01;1491;424;42434;14797;17.7;6.2
19;2021-04-02;1008;522;43442;15319;18.1;6.4
19;2021-04-03;597;283;44039;15602;18.3;6.5
19;2021-04-04;130;3;44169;15605;18.4;6.5
19;2021-04-05;40;75;44209;15680;18.4;6.5
19;2021-04-06;734;602;44943;16282;18.7;6.8
19;2021-04-07;976;732;45919;17014;19.1;7.1
19;2021-04-08;1116;1016;47035;18030;19.6;7.5
19;2021-04-09;1641;615;48676;18645;20.3;7.8
19;2021-04-10;946;557;49622;19202;20.6;8.0
19;2021-04-11;557;74;50179;19276;20.9;8.0
19;2021-04-12;681;521;50860;19797;21.2;8.2
19;2021-04-13;915;575;51775;20372;21.5;8.5
19;2021-04-14;1333;844;53108;21216;22.1;8.8
19;2021-04-15;1229;871;54337;22087;22.6;9.2
19;2021-04-16;1506;819;55843;22906;23.2;9.5
19;2021-04-17;762;478;56605;23384;23.6;9.7
19;2021-04-18;661;69;57266;23453;23.8;9.8
19;2021-04-19;730;439;57996;23892;24.1;9.9
19;2021-04-20;979;748;58975;24640;24.5;10.3
19;2021-04-21;1271;698;60246;25338;25.1;10.5
19;2021-04-22;1188;898;61434;26236;25.6;10.9
19;2021-04-23;1127;1021;62561;27257;26.0;11.3
19;2021-04-24;678;676;63239;27933;26.3;11.6
19;2021-04-25;675;69;63914;28002;26.6;11.7
19;2021-04-26;1056;332;64970;28334;27.0;11.8
19;2021-04-27;1027;568;65997;28902;27.5;12.0
19;2021-04-28;1553;555;67550;29457;28.1;12.3
19;2021-04-29;1453;1181;69003;30638;28.7;12.7
19;2021-04-30;1876;1056;70879;31694;29.5;13.2
19;2021-05-01;671;173;71550;31867;29.8;13.3
19;2021-05-02;551;152;72101;32019;30.0;13.3
19;2021-05-03;854;547;72955;32566;30.4;13.6
19;2021-05-04;1025;707;73980;33273;30.8;13.8
19;2021-05-05;1256;741;75236;34014;31.3;14.2
19;2021-05-06;1127;1195;76363;35209;31.8;14.6
19;2021-05-07;1663;1190;78026;36399;32.5;15.1
19;2021-05-08;712;205;78738;36604;32.8;15.2
19;2021-05-09;487;547;79225;37151;33.0;15.5
19;2021-05-10;1164;665;80389;37816;33.4;15.7
19;2021-05-11;1639;856;82028;38672;34.1;16.1
19;2021-05-12;1945;1319;83973;39991;34.9;16.6
19;2021-05-13;571;242;84544;40233;35.2;16.7
19;2021-05-14;1646;988;86190;41221;35.9;17.2
19;2021-05-15;1443;592;87633;41813;36.5;17.4
19;2021-05-16;350;82;87983;41895;36.6;17.4
19;2021-05-17;1498;559;89481;42454;37.2;17.7
19;2021-05-18;1669;498;91150;42952;37.9;17.9
19;2021-05-19;2009;822;93159;43774;38.8;18.2
19;2021-05-20;1722;890;94881;44664;39.5;18.6
19;2021-05-21;1964;814;96845;45478;40.3;18.9
19;2021-05-22;1271;651;98116;46129;40.8;19.2
19;2021-05-23;324;131;98440;46260;41.0;19.2
19;2021-05-24;139;46;98579;46306;41.0;19.3
19;2021-05-25;1502;492;100081;46798;41.6;19.5
19;2021-05-26;1924;666;102005;47464;42.4;19.7
19;2021-05-27;1786;834;103791;48298;43.2;20.1
19;2021-05-28;1937;990;105728;49288;44.0;20.5
19;2021-05-29;1375;705;107103;49993;44.6;20.8
19;2021-05-30;191;495;107294;50488;44.6;21.0
19;2021-05-31;1199;537;108493;51025;45.1;21.2
19;2021-06-01;1284;886;109777;51911;45.7;21.6
19;2021-06-02;1816;952;111593;52863;46.4;22.0
19;2021-06-03;1447;1251;113040;54114;47.0;22.5
19;2021-06-04;1847;1349;114887;55463;47.8;23.1
19;2021-06-05;1210;815;116097;56278;48.3;23.4
19;2021-06-06;87;648;116184;56926;48.3;23.7
19;2021-06-07;922;934;117106;57860;48.7;24.1
19;2021-06-08;1103;906;118209;58766;49.2;24.5
19;2021-06-09;1329;1459;119538;60225;49.7;25.1
19;2021-06-10;1283;1580;120821;61805;50.3;25.7
19;2021-06-11;1306;1917;122127;63722;50.8;26.5
19;2021-06-12;1356;1314;123483;65036;51.4;27.1
19;2021-06-13;542;424;124025;65460;51.6;27.2
19;2021-06-14;736;1016;124761;66476;51.9;27.7
19;2021-06-15;979;1143;125740;67619;52.3;28.1
19;2021-06-16;1222;1363;126962;68982;52.8;28.7
19;2021-06-17;868;1788;127830;70770;53.2;29.4
19;2021-06-18;1056;2135;128886;72905;53.6;30.3
19;2021-06-19;919;1302;129805;74207;54.0;30.9
19;2021-06-20;395;327;130200;74534;54.2;31.0
19;2021-06-21;500;1074;130700;75608;54.4;31.5
19;2021-06-22;698;1490;131398;77098;54.7;32.1
19;2021-06-23;744;1989;132142;79087;55.0;32.9
19;2021-06-24;687;1663;132829;80750;55.3;33.6
19;2021-06-25;562;2216;133391;82966;55.5;34.5
19;2021-06-26;474;1741;133865;84707;55.7;35.2
19;2021-06-27;289;446;134154;85153;55.8;35.4
19;2021-06-28;315;1499;134469;86652;56.0;36.1
19;2021-06-29;353;1893;134822;88545;56.1;36.8
19;2021-06-30;795;2152;135617;90697;56.4;37.7
19;2021-07-01;361;2322;135978;93019;56.6;38.7
19;2021-07-02;798;2316;136776;95335;56.9;39.7
19;2021-07-03;513;1744;137289;97079;57.1;40.4
19;2021-07-04;1;73;137290;97152;57.1;40.4
19;2021-07-05;600;1015;137890;98167;57.4;40.8
19;2021-07-06;504;1539;138394;99706;57.6;41.5
19;2021-07-07;706;2046;139100;101752;57.9;42.3
19;2021-07-08;770;2148;139870;103900;58.2;43.2
19;2021-07-09;716;2659;140586;106559;58.5;44.3
19;2021-07-10;586;1705;141172;108264;58.7;45.0
19;2021-07-11;45;212;141217;108476;58.8;45.1
19;2021-07-12;445;1486;141662;109962;58.9;45.8
19;2021-07-13;687;1828;142349;111790;59.2;46.5
19;2021-07-14;201;272;142550;112062;59.3;46.6
19;2021-07-15;870;2050;143420;114112;59.7;47.5
19;2021-07-16;1228;2445;144648;116557;60.2;48.5
19;2021-07-17;703;1718;145351;118275;60.5;49.2
19;2021-07-18;365;672;145716;118947;60.6;49.5
19;2021-07-19;968;1398;146684;120345;61.0;50.1
19;2021-07-20;967;1674;147651;122019;61.4;50.8
19;2021-07-21;1083;1710;148734;123729;61.9;51.5
19;2021-07-22;1392;1854;150126;125583;62.5;52.3
19;2021-07-23;1784;1995;151910;127578;63.2;53.1
19;2021-07-24;908;1753;152818;129331;63.6;53.8
19;2021-07-25;164;513;152982;129844;63.7;54.0
19;2021-07-26;911;911;153893;130755;64.0;54.4
19;2021-07-27;1425;1116;155318;131871;64.6;54.9
19;2021-07-28;2045;1221;157363;133092;65.5;55.4
19;2021-07-29;1623;1204;158986;134296;66.2;55.9
19;2021-07-30;1909;1027;160895;135323;66.9;56.3
19;2021-07-31;1129;1018;162024;136341;67.4;56.7
19;2021-08-01;347;372;162371;136713;67.6;56.9
19;2021-08-02;1194;809;163565;137522;68.1;57.2
19;2021-08-03;1453;1055;165018;138577;68.7;57.7
19;2021-08-04;1983;763;167001;139340;69.5;58.0
19;2021-08-05;1630;958;168631;140298;70.2;58.4
19;2021-08-06;1962;1217;170593;141515;71.0;58.9
19;2021-08-07;1335;1000;171928;142515;71.5;59.3
19;2021-08-08;187;234;172115;142749;71.6;59.4
19;2021-08-09;1008;784;173123;143533;72.0;59.7
19;2021-08-10;1280;1013;174403;144546;72.6;60.1
19;2021-08-11;1356;1006;175759;145552;73.1;60.6
19;2021-08-12;1016;1275;176775;146827;73.6;61.1
19;2021-08-13;1181;1275;177956;148102;74.0;61.6
19;2021-08-14;978;1164;178934;149266;74.5;62.1
19;2021-08-15;30;54;178964;149320;74.5;62.1
19;2021-08-16;592;1029;179556;150349;74.7;62.6
19;2021-08-17;633;1167;180189;151516;75.0;63.0
19;2021-08-18;655;979;180844;152495;75.2;63.5
19;2021-08-19;438;1258;181282;153753;75.4;64.0
19;2021-08-20;867;1927;182149;155680;75.8;64.8
19;2021-08-21;495;1376;182644;157056;76.0;65.3
19;2021-08-22;52;93;182696;157149;76.0;65.4
19;2021-08-23;224;1157;182920;158306;76.1;65.9
19;2021-08-24;538;1317;183458;159623;76.3;66.4
19;2021-08-25;649;1557;184107;161180;76.6;67.1
19;2021-08-26;475;1463;184582;162643;76.8;67.7
19;2021-08-27;502;1689;185084;164332;77.0;68.4
19;2021-08-28;360;1278;185444;165610;77.2;68.9
19;2021-08-29;60;182;185504;165792;77.2;69.0
19;2021-08-30;225;1094;185729;166886;77.3;69.4
19;2021-08-31;326;1454;186055;168340;77.4;70.0
19;2021-09-01;364;1480;186419;169820;77.6;70.7
19;2021-09-02;346;1318;186765;171138;77.7;71.2
19;2021-09-03;408;1515;187173;172653;77.9;71.8
19;2021-09-04;301;1394;187474;174047;78.0;72.4
19;2021-09-05;32;245;187506;174292;78.0;72.5
19;2021-09-06;196;697;187702;174989;78.1;72.8
19;2021-09-07;227;822;187929;175811;78.2;73.2
19;2021-09-08;286;934;188215;176745;78.3;73.5
19;2021-09-09;253;618;188468;177363;78.4;73.8
19;2021-09-10;252;853;188720;178216;78.5;74.2
19;2021-09-11;294;1157;189014;179373;78.6;74.6
19;2021-09-12;42;151;189056;179524;78.7;74.7
19;2021-09-13;106;437;189162;179961;78.7;74.9
19;2021-09-14;168;614;189330;180575;78.8;75.1
19;2021-09-15;242;669;189572;181244;78.9;75.4
19;2021-09-16;230;411;189802;181655;79.0;75.6
19;2021-09-17;254;531;190056;182186;79.1;75.8
19;2021-09-18;183;689;190239;182875;79.2;76.1
19;2021-09-19;17;34;190256;182909;79.2;76.1
19;2021-09-20;112;205;190368;183114;79.2;76.2
19;2021-09-21;143;294;190511;183408;79.3;76.3
19;2021-09-22;152;398;190663;183806;79.3;76.5
19;2021-09-23;86;300;190749;184106;79.4;76.6
19;2021-09-24;119;358;190868;184464;79.4;76.8
19;2021-09-25;140;568;191008;185032;79.5;77.0
19;2021-09-26;14;25;191022;185057;79.5;77.0
19;2021-09-27;43;215;191065;185272;79.5;77.1
19;2021-09-28;67;202;191132;185474;79.5;77.2
19;2021-09-29;81;341;191213;185815;79.6;77.3
21;2020-12-27;4;0;4;0;0.0;0.0
21;2020-12-28;2;0;6;0;0.0;0.0
21;2020-12-29;19;0;25;0;0.0;0.0
21;2020-12-30;22;0;47;0;0.0;0.0
21;2020-12-31;0;0;47;0;0.0;0.0
21;2021-01-01;0;0;47;0;0.0;0.0
21;2021-01-02;1;0;48;0;0.0;0.0
21;2021-01-03;1;0;49;0;0.0;0.0
21;2021-01-04;22;0;71;0;0.0;0.0
21;2021-01-05;250;2;321;2;0.1;0.0
21;2021-01-06;300;0;621;2;0.1;0.0
21;2021-01-07;389;0;1010;2;0.2;0.0
21;2021-01-08;455;2;1465;4;0.3;0.0
21;2021-01-09;252;0;1717;4;0.3;0.0
21;2021-01-10;2;0;1719;4;0.3;0.0
21;2021-01-11;624;1;2343;5;0.4;0.0
21;2021-01-12;655;0;2998;5;0.6;0.0
21;2021-01-13;706;2;3704;7;0.7;0.0
21;2021-01-14;1189;6;4893;13;0.9;0.0
21;2021-01-15;719;5;5612;18;1.1;0.0
21;2021-01-16;162;0;5774;18;1.1;0.0
21;2021-01-17;5;0;5779;18;1.1;0.0
21;2021-01-18;1319;4;7098;22;1.3;0.0
21;2021-01-19;1370;1;8468;23;1.6;0.0
21;2021-01-20;1301;45;9769;68;1.8;0.0
21;2021-01-21;1544;3;11313;71;2.1;0.0
21;2021-01-22;1246;5;12559;76;2.4;0.0
21;2021-01-23;490;0;13049;76;2.4;0.0
21;2021-01-24;124;0;13173;76;2.5;0.0
21;2021-01-25;928;18;14101;94;2.6;0.0
21;2021-01-26;1542;135;15643;229;2.9;0.0
21;2021-01-27;2061;145;17704;374;3.3;0.1
21;2021-01-28;1460;216;19164;590;3.6;0.1
21;2021-01-29;1022;209;20186;799;3.8;0.1
21;2021-01-30;470;26;20656;825;3.9;0.2
21;2021-01-31;97;3;20753;828;3.9;0.2
21;2021-02-01;453;280;21206;1108;4.0;0.2
21;2021-02-02;456;428;21662;1536;4.1;0.3
21;2021-02-03;446;271;22108;1807;4.1;0.3
21;2021-02-04;417;524;22525;2331;4.2;0.4
21;2021-02-05;489;448;23014;2779;4.3;0.5
21;2021-02-06;162;218;23176;2997;4.3;0.6
21;2021-02-07;2;2;23178;2999;4.3;0.6
21;2021-02-08;433;367;23611;3366;4.4;0.6
21;2021-02-09;515;466;24126;3832;4.5;0.7
21;2021-02-10;461;541;24587;4373;4.6;0.8
21;2021-02-11;486;713;25073;5086;4.7;1.0
21;2021-02-12;356;824;25429;5910;4.8;1.1
21;2021-02-13;365;243;25794;6153;4.8;1.2
21;2021-02-14;239;130;26033;6283;4.9;1.2
21;2021-02-15;120;1096;26153;7379;4.9;1.4
21;2021-02-16;207;1307;26360;8686;4.9;1.6
21;2021-02-17;402;1760;26762;10446;5.0;2.0
21;2021-02-18;604;1179;27366;11625;5.1;2.2
21;2021-02-19;217;990;27583;12615;5.2;2.4
21;2021-02-20;121;326;27704;12941;5.2;2.4
21;2021-02-21;1;83;27705;13024;5.2;2.4
21;2021-02-22;83;654;27788;13678;5.2;2.6
21;2021-02-23;170;885;27958;14563;5.2;2.7
21;2021-02-24;226;609;28184;15172;5.3;2.8
21;2021-02-25;647;715;28831;15887;5.4;3.0
21;2021-02-26;926;598;29757;16485;5.6;3.1
21;2021-02-27;532;241;30289;16726;5.7;3.1
21;2021-02-28;24;112;30313;16838;5.7;3.2
21;2021-03-01;679;522;30992;17360;5.8;3.3
21;2021-03-02;1054;490;32046;17850;6.0;3.3
21;2021-03-03;1170;381;33216;18231;6.2;3.4
21;2021-03-04;1688;471;34904;18702;6.5;3.5
21;2021-03-05;2196;626;37100;19328;7.0;3.6
21;2021-03-06;1594;189;38694;19517;7.3;3.7
21;2021-03-07;4;15;38698;19532;7.3;3.7
21;2021-03-08;772;410;39470;19942;7.4;3.7
21;2021-03-09;1570;527;41040;20469;7.7;3.8
21;2021-03-10;1627;524;42667;20993;8.0;3.9
21;2021-03-11;2196;670;44863;21663;8.4;4.1
21;2021-03-12;2905;430;47768;22093;9.0;4.1
21;2021-03-13;1932;155;49700;22248;9.3;4.2
21;2021-03-14;38;42;49738;22290;9.3;4.2
21;2021-03-15;1415;87;51153;22377;9.6;4.2
21;2021-03-16;1883;152;53036;22529;10.0;4.2
21;2021-03-17;1809;112;54845;22641;10.3;4.2
21;2021-03-18;2127;260;56972;22901;10.7;4.3
21;2021-03-19;1964;148;58936;23049;11.1;4.3
21;2021-03-20;1228;38;60164;23087;11.3;4.3
21;2021-03-21;2;0;60166;23087;11.3;4.3
21;2021-03-22;1556;92;61722;23179;11.6;4.3
21;2021-03-23;2696;105;64418;23284;12.1;4.4
21;2021-03-24;2895;163;67313;23447;12.6;4.4
21;2021-03-25;3730;245;71043;23692;13.3;4.4
21;2021-03-26;3655;195;74698;23887;14.0;4.5
21;2021-03-27;1732;60;76430;23947;14.3;4.5
21;2021-03-28;200;38;76630;23985;14.4;4.5
21;2021-03-29;1788;510;78418;24495;14.7;4.6
21;2021-03-30;2348;797;80766;25292;15.2;4.7
21;2021-03-31;2718;645;83484;25937;15.7;4.9
21;2021-04-01;2693;720;86177;26657;16.2;5.0
21;2021-04-02;2249;741;88426;27398;16.6;5.1
21;2021-04-03;1018;280;89444;27678;16.8;5.2
21;2021-04-04;2;12;89446;27690;16.8;5.2
21;2021-04-05;9;0;89455;27690;16.8;5.2
21;2021-04-06;1358;1134;90813;28824;17.0;5.4
21;2021-04-07;1750;968;92563;29792;17.4;5.6
21;2021-04-08;3217;1144;95780;30936;18.0;5.8
21;2021-04-09;3481;1184;99261;32120;18.6;6.0
21;2021-04-10;1374;729;100635;32849;18.9;6.2
21;2021-04-11;145;3;100780;32852;18.9;6.2
21;2021-04-12;1117;1344;101897;34196;19.1;6.4
21;2021-04-13;1654;1777;103551;35973;19.4;6.8
21;2021-04-14;1484;1467;105035;37440;19.7;7.0
21;2021-04-15;1900;1590;106935;39030;20.1;7.3
21;2021-04-16;2321;1309;109256;40339;20.5;7.6
21;2021-04-17;1020;973;110276;41312;20.7;7.8
21;2021-04-18;15;4;110291;41316;20.7;7.8
21;2021-04-19;1110;1318;111401;42634;20.9;8.0
21;2021-04-20;1243;1833;112644;44467;21.1;8.3
21;2021-04-21;1095;1720;113739;46187;21.3;8.7
21;2021-04-22;1275;2210;115014;48397;21.6;9.1
21;2021-04-23;1984;1723;116998;50120;22.0;9.4
21;2021-04-24;1001;871;117999;50991;22.1;9.6
21;2021-04-25;9;168;118008;51159;22.1;9.6
21;2021-04-26;1013;1592;119021;52751;22.3;9.9
21;2021-04-27;1842;1932;120863;54683;22.7;10.3
21;2021-04-28;2230;2221;123093;56904;23.1;10.7
21;2021-04-29;3135;2251;126228;59155;23.7;11.1
21;2021-04-30;3562;1823;129790;60978;24.4;11.4
21;2021-05-01;962;225;130752;61203;24.5;11.5
21;2021-05-02;2;5;130754;61208;24.5;11.5
21;2021-05-03;2081;1349;132835;62557;24.9;11.7
21;2021-05-04;2576;1639;135411;64196;25.4;12.0
21;2021-05-05;2247;1690;137658;65886;25.8;12.4
21;2021-05-06;3015;2246;140673;68132;26.4;12.8
21;2021-05-07;2805;2169;143478;70301;26.9;13.2
21;2021-05-08;1067;271;144545;70572;27.1;13.2
21;2021-05-09;26;177;144571;70749;27.1;13.3
21;2021-05-10;3169;1728;147740;72477;27.7;13.6
21;2021-05-11;4923;2002;152663;74479;28.6;14.0
21;2021-05-12;4805;1747;157468;76226;29.6;14.3
21;2021-05-13;3845;368;161313;76594;30.3;14.4
21;2021-05-14;5197;1469;166510;78063;31.2;14.6
21;2021-05-15;3428;647;169938;78710;31.9;14.8
21;2021-05-16;49;4;169987;78714;31.9;14.8
21;2021-05-17;4128;1256;174115;79970;32.7;15.0
21;2021-05-18;4358;1500;178473;81470;33.5;15.3
21;2021-05-19;3470;1125;181943;82595;34.1;15.5
21;2021-05-20;3898;1359;185841;83954;34.9;15.8
21;2021-05-21;3627;2153;189468;86107;35.6;16.2
21;2021-05-22;1669;768;191137;86875;35.9;16.3
21;2021-05-23;4;17;191141;86892;35.9;16.3
21;2021-05-24;1815;266;192956;87158;36.2;16.4
21;2021-05-25;2648;1960;195604;89118;36.7;16.7
21;2021-05-26;2604;2000;198208;91118;37.2;17.1
21;2021-05-27;4014;2088;202222;93206;37.9;17.5
21;2021-05-28;3572;2813;205794;96019;38.6;18.0
21;2021-05-29;1932;1468;207726;97487;39.0;18.3
21;2021-05-30;98;13;207824;97500;39.0;18.3
21;2021-05-31;2501;1776;210325;99276;39.5;18.6
21;2021-06-01;3449;2247;213774;101523;40.1;19.1
21;2021-06-02;2617;1757;216391;103280;40.6;19.4
21;2021-06-03;3147;2075;219538;105355;41.2;19.8
21;2021-06-04;3285;2585;222823;107940;41.8;20.3
21;2021-06-05;2922;1654;225745;109594;42.4;20.6
21;2021-06-06;51;85;225796;109679;42.4;20.6
21;2021-06-07;4314;1344;230110;111023;43.2;20.8
21;2021-06-08;4935;2144;235045;113167;44.1;21.2
21;2021-06-09;4500;1625;239545;114792;45.0;21.5
21;2021-06-10;3933;2595;243478;117387;45.7;22.0
21;2021-06-11;4164;3096;247642;120483;46.5;22.6
21;2021-06-12;2199;1606;249841;122089;46.9;22.9
21;2021-06-13;29;11;249870;122100;46.9;22.9
21;2021-06-14;2197;2563;252067;124663;47.3;23.4
21;2021-06-15;2958;3088;255025;127751;47.9;24.0
21;2021-06-16;2850;2609;257875;130360;48.4;24.5
21;2021-06-17;3421;3040;261296;133400;49.0;25.0
21;2021-06-18;2424;3796;263720;137196;49.5;25.7
21;2021-06-19;2045;1863;265765;139059;49.9;26.1
21;2021-06-20;26;13;265791;139072;49.9;26.1
21;2021-06-21;1840;3404;267631;142476;50.2;26.7
21;2021-06-22;1885;5828;269516;148304;50.6;27.8
21;2021-06-23;2030;5011;271546;153315;51.0;28.8
21;2021-06-24;2367;4663;273913;157978;51.4;29.6
21;2021-06-25;1530;5894;275443;163872;51.7;30.8
21;2021-06-26;1441;3898;276884;167770;52.0;31.5
21;2021-06-27;18;125;276902;167895;52.0;31.5
21;2021-06-28;1397;4014;278299;171909;52.2;32.3
21;2021-06-29;1634;4174;279933;176083;52.5;33.0
21;2021-06-30;1568;3372;281501;179455;52.8;33.7
21;2021-07-01;1663;4147;283164;183602;53.1;34.5
21;2021-07-02;2179;4229;285343;187831;53.5;35.2
21;2021-07-03;1094;2101;286437;189932;53.8;35.6
21;2021-07-04;37;55;286474;189987;53.8;35.7
21;2021-07-05;1610;3626;288084;193613;54.1;36.3
21;2021-07-06;1347;3580;289431;197193;54.3;37.0
21;2021-07-07;1455;3240;290886;200433;54.6;37.6
21;2021-07-08;1883;4159;292769;204592;54.9;38.4
21;2021-07-09;2081;4346;294850;208938;55.3;39.2
21;2021-07-10;1089;2546;295939;211484;55.5;39.7
21;2021-07-11;21;74;295960;211558;55.5;39.7
21;2021-07-12;1656;3727;297616;215285;55.8;40.4
21;2021-07-13;2343;4885;299959;220170;56.3;41.3
21;2021-07-14;2873;2017;302832;222187;56.8;41.7
21;2021-07-15;3814;4549;306646;226736;57.5;42.5
21;2021-07-16;3890;5250;310536;231986;58.3;43.5
21;2021-07-17;2775;4168;313311;236154;58.8;44.3
21;2021-07-18;157;82;313468;236236;58.8;44.3
21;2021-07-19;2375;4624;315843;240860;59.3;45.2
21;2021-07-20;2760;5486;318603;246346;59.8;46.2
21;2021-07-21;2908;4786;321511;251132;60.3;47.1
21;2021-07-22;3026;4719;324537;255851;60.9;48.0
21;2021-07-23;4352;4896;328889;260747;61.7;48.9
21;2021-07-24;3034;3020;331923;263767;62.3;49.5
21;2021-07-25;68;40;331991;263807;62.3;49.5
21;2021-07-26;2663;3588;334654;267395;62.8;50.2
21;2021-07-27;3412;3772;338066;271167;63.4;50.9
21;2021-07-28;3574;3353;341640;274520;64.1;51.5
21;2021-07-29;4134;3364;345774;277884;64.9;52.1
21;2021-07-30;4622;3346;350396;281230;65.8;52.8
21;2021-07-31;3427;2378;353823;283608;66.4;53.2
21;2021-08-01;330;57;354153;283665;66.5;53.2
21;2021-08-02;2539;3167;356692;286832;66.9;53.8
21;2021-08-03;2624;2761;359316;289593;67.4;54.3
21;2021-08-04;2363;2487;361679;292080;67.9;54.8
21;2021-08-05;2219;3078;363898;295158;68.3;55.4
21;2021-08-06;2590;3308;366488;298466;68.8;56.0
21;2021-08-07;1905;2660;368393;301126;69.1;56.5
21;2021-08-08;75;70;368468;301196;69.1;56.5
21;2021-08-09;1651;2930;370119;304126;69.5;57.1
21;2021-08-10;1413;2715;371532;306841;69.7;57.6
21;2021-08-11;1665;2446;373197;309287;70.0;58.0
21;2021-08-12;1174;2417;374371;311704;70.3;58.5
21;2021-08-13;1521;2747;375892;314451;70.5;59.0
21;2021-08-14;860;2435;376752;316886;70.7;59.5
21;2021-08-15;51;64;376803;316950;70.7;59.5
21;2021-08-16;1400;2823;378203;319773;71.0;60.0
21;2021-08-17;1205;2775;379408;322548;71.2;60.5
21;2021-08-18;1030;2872;380438;325420;71.4;61.1
21;2021-08-19;957;3067;381395;328487;71.6;61.6
21;2021-08-20;1063;4192;382458;332679;71.8;62.4
21;2021-08-21;844;3143;383302;335822;71.9;63.0
21;2021-08-22;34;116;383336;335938;71.9;63.0
21;2021-08-23;938;3220;384274;339158;72.1;63.6
21;2021-08-24;987;2877;385261;342035;72.3;64.2
21;2021-08-25;870;2551;386131;344586;72.5;64.7
21;2021-08-26;728;2426;386859;347012;72.6;65.1
21;2021-08-27;1035;3397;387894;350409;72.8;65.8
21;2021-08-28;711;2755;388605;353164;72.9;66.3
21;2021-08-29;45;215;388650;353379;72.9;66.3
21;2021-08-30;789;2270;389439;355649;73.1;66.7
21;2021-08-31;942;2106;390381;357755;73.3;67.1
21;2021-09-01;623;1782;391004;359537;73.4;67.5
21;2021-09-02;546;1462;391550;360999;73.5;67.7
21;2021-09-03;786;2033;392336;363032;73.6;68.1
21;2021-09-04;752;1674;393088;364706;73.8;68.4
21;2021-09-05;69;107;393157;364813;73.8;68.5
21;2021-09-06;408;1478;393565;366291;73.9;68.7
21;2021-09-07;389;1311;393954;367602;73.9;69.0
21;2021-09-08;548;1605;394502;369207;74.0;69.3
21;2021-09-09;397;1381;394899;370588;74.1;69.5
21;2021-09-10;648;1766;395547;372354;74.2;69.9
21;2021-09-11;468;1462;396015;373816;74.3;70.1
21;2021-09-12;19;35;396034;373851;74.3;70.2
21;2021-09-13;250;891;396284;374742;74.4;70.3
21;2021-09-14;459;1317;396743;376059;74.5;70.6
21;2021-09-15;485;905;397228;376964;74.5;70.7
21;2021-09-16;336;756;397564;377720;74.6;70.9
21;2021-09-17;549;1056;398113;378776;74.7;71.1
21;2021-09-18;327;1003;398440;379779;74.8;71.3
21;2021-09-19;5;21;398445;379800;74.8;71.3
21;2021-09-20;248;619;398693;380419;74.8;71.4
21;2021-09-21;366;663;399059;381082;74.9;71.5
21;2021-09-22;335;904;399394;381986;74.9;71.7
21;2021-09-23;273;521;399667;382507;75.0;71.8
21;2021-09-24;359;805;400026;383312;75.1;71.9
21;2021-09-25;215;865;400241;384177;75.1;72.1
21;2021-09-26;6;21;400247;384198;75.1;72.1
21;2021-09-27;242;447;400489;384645;75.2;72.2
21;2021-09-28;208;486;400697;385131;75.2;72.3
21;2021-09-29;233;531;400930;385662;75.2;72.4
22;2020-12-27;0;0;0;0;0.0;0.0
22;2020-12-28;0;0;0;0;0.0;0.0
22;2020-12-29;0;0;0;0;0.0;0.0
22;2020-12-30;0;0;0;0;0.0;0.0
22;2020-12-31;0;0;0;0;0.0;0.0
22;2021-01-01;0;0;0;0;0.0;0.0
22;2021-01-02;2;0;2;0;0.0;0.0
22;2021-01-03;0;0;2;0;0.0;0.0
22;2021-01-04;5;0;7;0;0.0;0.0
22;2021-01-05;61;0;68;0;0.0;0.0
22;2021-01-06;114;1;182;1;0.0;0.0
22;2021-01-07;67;0;249;1;0.0;0.0
22;2021-01-08;174;0;423;1;0.1;0.0
22;2021-01-09;1;0;424;1;0.1;0.0
22;2021-01-10;0;0;424;1;0.1;0.0
22;2021-01-11;234;1;658;2;0.1;0.0
22;2021-01-12;627;0;1285;2;0.2;0.0
22;2021-01-13;677;1;1962;3;0.3;0.0
22;2021-01-14;717;8;2679;11;0.4;0.0
22;2021-01-15;529;2;3208;13;0.5;0.0
22;2021-01-16;96;0;3304;13;0.6;0.0
22;2021-01-17;1;0;3305;13;0.6;0.0
22;2021-01-18;312;1;3617;14;0.6;0.0
22;2021-01-19;687;0;4304;14;0.7;0.0
22;2021-01-20;598;1;4902;15;0.8;0.0
22;2021-01-21;947;1;5849;16;1.0;0.0
22;2021-01-22;840;2;6689;18;1.1;0.0
22;2021-01-23;219;0;6908;18;1.2;0.0
22;2021-01-24;2;0;6910;18;1.2;0.0
22;2021-01-25;751;9;7661;27;1.3;0.0
22;2021-01-26;1018;59;8679;86;1.5;0.0
22;2021-01-27;3858;109;12537;195;2.1;0.0
22;2021-01-28;4510;83;17047;278;2.9;0.0
22;2021-01-29;1897;120;18944;398;3.2;0.1
22;2021-01-30;289;0;19233;398;3.2;0.1
22;2021-01-31;3;0;19236;398;3.2;0.1
22;2021-02-01;642;75;19878;473;3.3;0.1
22;2021-02-02;903;414;20781;887;3.5;0.1
22;2021-02-03;691;472;21472;1359;3.6;0.2
22;2021-02-04;964;611;22436;1970;3.8;0.3
22;2021-02-05;722;512;23158;2482;3.9;0.4
22;2021-02-06;256;0;23414;2482;3.9;0.4
22;2021-02-07;0;0;23414;2482;3.9;0.4
22;2021-02-08;531;112;23945;2594;4.0;0.4
22;2021-02-09;614;264;24559;2858;4.1;0.5
22;2021-02-10;425;180;24984;3038;4.2;0.5
22;2021-02-11;1085;299;26069;3337;4.4;0.6
22;2021-02-12;594;296;26663;3633;4.5;0.6
22;2021-02-13;319;70;26982;3703;4.5;0.6
22;2021-02-14;0;4;26982;3707;4.5;0.6
22;2021-02-15;672;363;27654;4070;4.6;0.7
22;2021-02-16;1042;597;28696;4667;4.8;0.8
22;2021-02-17;1203;2311;29899;6978;5.0;1.2
22;2021-02-18;2146;2651;32045;9629;5.4;1.6
22;2021-02-19;1637;1753;33682;11382;5.6;1.9
22;2021-02-20;480;157;34162;11539;5.7;1.9
22;2021-02-21;6;49;34168;11588;5.7;1.9
22;2021-02-22;401;570;34569;12158;5.8;2.0
22;2021-02-23;665;765;35234;12923;5.9;2.2
22;2021-02-24;695;767;35929;13690;6.0;2.3
22;2021-02-25;1200;1003;37129;14693;6.2;2.5
22;2021-02-26;1066;601;38195;15294;6.4;2.6
22;2021-02-27;564;220;38759;15514;6.5;2.6
22;2021-02-28;16;8;38775;15522;6.5;2.6
22;2021-03-01;958;455;39733;15977;6.7;2.7
22;2021-03-02;1207;748;40940;16725;6.9;2.8
22;2021-03-03;1325;737;42265;17462;7.1;2.9
22;2021-03-04;1602;796;43867;18258;7.4;3.1
22;2021-03-05;2108;692;45975;18950;7.7;3.2
22;2021-03-06;1114;244;47089;19194;7.9;3.2
22;2021-03-07;219;1;47308;19195;7.9;3.2
22;2021-03-08;1291;585;48599;19780;8.2;3.3
22;2021-03-09;1824;670;50423;20450;8.5;3.4
22;2021-03-10;1988;927;52411;21377;8.8;3.6
22;2021-03-11;2375;1544;54786;22921;9.2;3.8
22;2021-03-12;3101;907;57887;23828;9.7;4.0
22;2021-03-13;1721;277;59608;24105;10.0;4.0
22;2021-03-14;245;23;59853;24128;10.0;4.0
22;2021-03-15;1620;555;61473;24683;10.3;4.1
22;2021-03-16;1603;837;63076;25520;10.6;4.3
22;2021-03-17;2651;689;65727;26209;11.0;4.4
22;2021-03-18;2552;1095;68279;27304;11.5;4.6
22;2021-03-19;3281;792;71560;28096;12.0;4.7
22;2021-03-20;2208;282;73768;28378;12.4;4.8
22;2021-03-21;16;0;73784;28378;12.4;4.8
22;2021-03-22;2363;359;76147;28737;12.8;4.8
22;2021-03-23;3142;780;79289;29517;13.3;5.0
22;2021-03-24;3485;682;82774;30199;13.9;5.1
22;2021-03-25;3961;606;86735;30805;14.5;5.2
22;2021-03-26;4003;482;90738;31287;15.2;5.2
22;2021-03-27;2092;179;92830;31466;15.6;5.3
22;2021-03-28;67;1;92897;31467;15.6;5.3
22;2021-03-29;2766;905;95663;32372;16.0;5.4
22;2021-03-30;3567;1149;99230;33521;16.6;5.6
22;2021-03-31;3674;1080;102904;34601;17.3;5.8
22;2021-04-01;4944;1129;107848;35730;18.1;6.0
22;2021-04-02;4390;1034;112238;36764;18.8;6.2
22;2021-04-03;1998;403;114236;37167;19.2;6.2
22;2021-04-04;37;0;114273;37167;19.2;6.2
22;2021-04-05;15;0;114288;37167;19.2;6.2
22;2021-04-06;3288;1135;117576;38302;19.7;6.4
22;2021-04-07;3429;1364;121005;39666;20.3;6.7
22;2021-04-08;4447;1322;125452;40988;21.0;6.9
22;2021-04-09;5183;1361;130635;42349;21.9;7.1
22;2021-04-10;2447;365;133082;42714;22.3;7.2
22;2021-04-11;485;10;133567;42724;22.4;7.2
22;2021-04-12;2988;1006;136555;43730;22.9;7.3
22;2021-04-13;3318;1516;139873;45246;23.5;7.6
22;2021-04-14;3167;2483;143040;47729;24.0;8.0
22;2021-04-15;3600;2430;146640;50159;24.6;8.4
22;2021-04-16;3632;2485;150272;52644;25.2;8.8
22;2021-04-17;1920;1792;152192;54436;25.5;9.1
22;2021-04-18;17;0;152209;54436;25.5;9.1
22;2021-04-19;3021;2145;155230;56581;26.0;9.5
22;2021-04-20;3310;2793;158540;59374;26.6;10.0
22;2021-04-21;3223;2731;161763;62105;27.1;10.4
22;2021-04-22;3593;3128;165356;65233;27.7;10.9
22;2021-04-23;3726;3172;169082;68405;28.4;11.5
22;2021-04-24;2005;1962;171087;70367;28.7;11.8
22;2021-04-25;17;0;171104;70367;28.7;11.8
22;2021-04-26;3213;2854;174317;73221;29.2;12.3
22;2021-04-27;3371;3128;177688;76349;29.8;12.8
22;2021-04-28;3488;3149;181176;79498;30.4;13.3
22;2021-04-29;4080;3244;185256;82742;31.1;13.9
22;2021-04-30;3906;3216;189162;85958;31.7;14.4
22;2021-05-01;60;69;189222;86027;31.7;14.4
22;2021-05-02;1237;59;190459;86086;31.9;14.4
22;2021-05-03;2029;2711;192488;88797;32.3;14.9
22;2021-05-04;2155;2893;194643;91690;32.6;15.4
22;2021-05-05;2049;3006;196692;94696;33.0;15.9
22;2021-05-06;2508;3488;199200;98184;33.4;16.5
22;2021-05-07;2829;3383;202029;101567;33.9;17.0
22;2021-05-08;45;120;202074;101687;33.9;17.1
22;2021-05-09;602;438;202676;102125;34.0;17.1
22;2021-05-10;4473;2728;207149;104853;34.7;17.6
22;2021-05-11;5107;2889;212256;107742;35.6;18.1
22;2021-05-12;6599;1016;218855;108758;36.7;18.2
22;2021-05-13;528;35;219383;108793;36.8;18.2
22;2021-05-14;6406;1075;225789;109868;37.9;18.4
22;2021-05-15;3988;419;229777;110287;38.5;18.5
22;2021-05-16;419;37;230196;110324;38.6;18.5
22;2021-05-17;5668;517;235864;110841;39.6;18.6
22;2021-05-18;6009;945;241873;111786;40.6;18.8
22;2021-05-19;6130;705;248003;112491;41.6;18.9
22;2021-05-20;6587;1369;254590;113860;42.7;19.1
22;2021-05-21;5898;1449;260488;115309;43.7;19.3
22;2021-05-22;4093;768;264581;116077;44.4;19.5
22;2021-05-23;407;17;264988;116094;44.4;19.5
22;2021-05-24;5315;226;270303;116320;45.3;19.5
22;2021-05-25;5637;1169;275940;117489;46.3;19.7
22;2021-05-26;4226;2807;280166;120296;47.0;20.2
22;2021-05-27;4503;3830;284669;124126;47.7;20.8
22;2021-05-28;4384;4417;289053;128543;48.5;21.6
22;2021-05-29;3046;1770;292099;130313;49.0;21.9
22;2021-05-30;19;7;292118;130320;49.0;21.9
22;2021-05-31;3653;3148;295771;133468;49.6;22.4
22;2021-06-01;3520;3685;299291;137153;50.2;23.0
22;2021-06-02;3085;3375;302376;140528;50.7;23.6
22;2021-06-03;3196;4085;305572;144613;51.3;24.3
22;2021-06-04;3371;4535;308943;149148;51.8;25.0
22;2021-06-05;3543;2025;312486;151173;52.4;25.4
22;2021-06-06;214;30;312700;151203;52.5;25.4
22;2021-06-07;3042;3255;315742;154458;53.0;25.9
22;2021-06-08;2798;3525;318540;157983;53.4;26.5
22;2021-06-09;2543;3506;321083;161489;53.9;27.1
22;2021-06-10;2516;4242;323599;165731;54.3;27.8
22;2021-06-11;2551;4226;326150;169957;54.7;28.5
22;2021-06-12;2411;1453;328561;171410;55.1;28.8
22;2021-06-13;134;1093;328695;172503;55.1;28.9
22;2021-06-14;2644;2462;331339;174965;55.6;29.3
22;2021-06-15;3095;2995;334434;177960;56.1;29.8
22;2021-06-16;3007;2806;337441;180766;56.6;30.3
22;2021-06-17;2560;3174;340001;183940;57.0;30.9
22;2021-06-18;3099;4111;343100;188051;57.5;31.5
22;2021-06-19;2984;1453;346084;189504;58.0;31.8
22;2021-06-20;157;8;346241;189512;58.1;31.8
22;2021-06-21;1783;5020;348024;194532;58.4;32.6
22;2021-06-22;2403;5548;350427;200080;58.8;33.6
22;2021-06-23;1284;6202;351711;206282;59.0;34.6
22;2021-06-24;2578;3912;354289;210194;59.4;35.3
22;2021-06-25;1568;6808;355857;217002;59.7;36.4
22;2021-06-26;783;3853;356640;220855;59.8;37.0
22;2021-06-27;4;511;356644;221366;59.8;37.1
22;2021-06-28;1051;5586;357695;226952;60.0;38.1
22;2021-06-29;1375;5949;359070;232901;60.2;39.1
22;2021-06-30;1129;5735;360199;238636;60.4;40.0
22;2021-07-01;1383;6034;361582;244670;60.6;41.0
22;2021-07-02;1709;6089;363291;250759;60.9;42.1
22;2021-07-03;1009;3818;364300;254577;61.1;42.7
22;2021-07-04;149;365;364449;254942;61.1;42.8
22;2021-07-05;1598;5804;366047;260746;61.4;43.7
22;2021-07-06;2313;5992;368360;266738;61.8;44.7
22;2021-07-07;2291;4933;370651;271671;62.2;45.6
22;2021-07-08;2503;5096;373154;276767;62.6;46.4
22;2021-07-09;2496;5377;375650;282144;63.0;47.3
22;2021-07-10;1808;3356;377458;285500;63.3;47.9
22;2021-07-11;484;75;377942;285575;63.4;47.9
22;2021-07-12;2334;4722;380276;290297;63.8;48.7
22;2021-07-13;3782;5054;384058;295351;64.4;49.5
22;2021-07-14;700;2494;384758;297845;64.5;50.0
22;2021-07-15;3868;4619;388626;302464;65.2;50.7
22;2021-07-16;3836;5290;392462;307754;65.8;51.6
22;2021-07-17;2558;3410;395020;311164;66.3;52.2
22;2021-07-18;570;88;395590;311252;66.4;52.2
22;2021-07-19;2772;4103;398362;315355;66.8;52.9
22;2021-07-20;3923;4129;402285;319484;67.5;53.6
22;2021-07-21;3998;3405;406283;322889;68.1;54.2
22;2021-07-22;4858;3704;411141;326593;69.0;54.8
22;2021-07-23;4452;4218;415593;330811;69.7;55.5
22;2021-07-24;2260;2614;417853;333425;70.1;55.9
22;2021-07-25;118;150;417971;333575;70.1;56.0
22;2021-07-26;3022;3918;420993;337493;70.6;56.6
22;2021-07-27;3725;4912;424718;342405;71.2;57.4
22;2021-07-28;3706;3661;428424;346066;71.9;58.0
22;2021-07-29;4294;3779;432718;349845;72.6;58.7
22;2021-07-30;4039;3971;436757;353816;73.3;59.3
22;2021-07-31;2402;2806;439159;356622;73.7;59.8
22;2021-08-01;118;150;439277;356772;73.7;59.8
22;2021-08-02;4669;2551;443946;359323;74.5;60.3
22;2021-08-03;4787;3426;448733;362749;75.3;60.8
22;2021-08-04;5773;2494;454506;365243;76.2;61.3
22;2021-08-05;4126;3802;458632;369045;76.9;61.9
22;2021-08-06;3654;3810;462286;372855;77.5;62.5
22;2021-08-07;2355;2269;464641;375124;77.9;62.9
22;2021-08-08;427;71;465068;375195;78.0;62.9
22;2021-08-09;2722;2707;467790;377902;78.5;63.4
22;2021-08-10;2732;3513;470522;381415;78.9;64.0
22;2021-08-11;2429;3115;472951;384530;79.3;64.5
22;2021-08-12;2216;3476;475167;388006;79.7;65.1
22;2021-08-13;1935;2970;477102;390976;80.0;65.6
22;2021-08-14;1343;1911;478445;392887;80.3;65.9
22;2021-08-15;86;198;478531;393085;80.3;65.9
22;2021-08-16;1470;3177;480001;396262;80.5;66.5
22;2021-08-17;1757;3459;481758;399721;80.8;67.0
22;2021-08-18;1406;3302;483164;403023;81.0;67.6
22;2021-08-19;1348;3609;484512;406632;81.3;68.2
22;2021-08-20;1462;3605;485974;410237;81.5;68.8
22;2021-08-21;816;2261;486790;412498;81.7;69.2
22;2021-08-22;151;308;486941;412806;81.7;69.2
22;2021-08-23;1966;3607;488907;416413;82.0;69.8
22;2021-08-24;1431;3247;490338;419660;82.2;70.4
22;2021-08-25;844;2507;491182;422167;82.4;70.8
22;2021-08-26;1056;4293;492238;426460;82.6;71.5
22;2021-08-27;1325;4601;493563;431061;82.8;72.3
22;2021-08-28;738;2517;494301;433578;82.9;72.7
22;2021-08-29;35;26;494336;433604;82.9;72.7
22;2021-08-30;924;2964;495260;436568;83.1;73.2
22;2021-08-31;966;3798;496226;440366;83.2;73.9
22;2021-09-01;968;3419;497194;443785;83.4;74.4
22;2021-09-02;837;3062;498031;446847;83.5;75.0
22;2021-09-03;939;3068;498970;449915;83.7;75.5
22;2021-09-04;781;2736;499751;452651;83.8;75.9
22;2021-09-05;96;47;499847;452698;83.8;75.9
22;2021-09-06;487;2184;500334;454882;83.9;76.3
22;2021-09-07;513;2301;500847;457183;84.0;76.7
22;2021-09-08;628;2189;501475;459372;84.1;77.1
22;2021-09-09;671;2314;502146;461686;84.2;77.4
22;2021-09-10;701;2437;502847;464123;84.3;77.8
22;2021-09-11;575;1821;503422;465944;84.4;78.2
22;2021-09-12;31;85;503453;466029;84.4;78.2
22;2021-09-13;481;2589;503934;468618;84.5;78.6
22;2021-09-14;585;2310;504519;470928;84.6;79.0
22;2021-09-15;450;1703;504969;472631;84.7;79.3
22;2021-09-16;551;1041;505520;473672;84.8;79.5
22;2021-09-17;619;1630;506139;475302;84.9;79.7
22;2021-09-18;283;2161;506422;477463;84.9;80.1
22;2021-09-19;0;8;506422;477471;84.9;80.1
22;2021-09-20;362;708;506784;478179;85.0;80.2
22;2021-09-21;363;955;507147;479134;85.1;80.4
22;2021-09-22;298;1160;507445;480294;85.1;80.6
22;2021-09-23;398;716;507843;481010;85.2;80.7
22;2021-09-24;362;1099;508205;482109;85.2;80.9
22;2021-09-25;218;1386;508423;483495;85.3;81.1
22;2021-09-26;12;70;508435;483565;85.3;81.1
22;2021-09-27;334;743;508769;484308;85.3;81.2
22;2021-09-28;202;576;508971;484884;85.4;81.3
22;2021-09-29;230;887;509201;485771;85.4;81.5
23;2020-12-27;0;0;0;0;0.0;0.0
23;2020-12-28;2;0;2;0;0.0;0.0
23;2020-12-29;0;0;2;0;0.0;0.0
23;2020-12-30;0;0;2;0;0.0;0.0
23;2020-12-31;0;0;2;0;0.0;0.0
23;2021-01-01;0;0;2;0;0.0;0.0
23;2021-01-02;1;0;3;0;0.0;0.0
23;2021-01-03;1;0;4;0;0.0;0.0
23;2021-01-04;1;0;5;0;0.0;0.0
23;2021-01-05;3;0;8;0;0.0;0.0
23;2021-01-06;10;0;18;0;0.0;0.0
23;2021-01-07;116;1;134;1;0.1;0.0
23;2021-01-08;117;0;251;1;0.2;0.0
23;2021-01-09;36;0;287;1;0.2;0.0
23;2021-01-10;1;0;288;1;0.2;0.0
23;2021-01-11;176;1;464;2;0.4;0.0
23;2021-01-12;237;3;701;5;0.6;0.0
23;2021-01-13;309;0;1010;5;0.9;0.0
23;2021-01-14;293;4;1303;9;1.1;0.0
23;2021-01-15;334;5;1637;14;1.4;0.0
23;2021-01-16;163;1;1800;15;1.5;0.0
23;2021-01-17;0;0;1800;15;1.5;0.0
23;2021-01-18;342;3;2142;18;1.8;0.0
23;2021-01-19;498;2;2640;20;2.3;0.0
23;2021-01-20;363;1;3003;21;2.6;0.0
23;2021-01-21;700;1;3703;22;3.2;0.0
23;2021-01-22;479;0;4182;22;3.6;0.0
23;2021-01-23;368;1;4550;23;3.9;0.0
23;2021-01-24;0;0;4550;23;3.9;0.0
23;2021-01-25;382;16;4932;39;4.2;0.0
23;2021-01-26;301;5;5233;44;4.5;0.0
23;2021-01-27;226;2;5459;46;4.7;0.0
23;2021-01-28;232;30;5691;76;4.9;0.1
23;2021-01-29;304;98;5995;174;5.2;0.1
23;2021-01-30;100;24;6095;198;5.2;0.2
23;2021-01-31;2;33;6097;231;5.2;0.2
23;2021-02-01;148;80;6245;311;5.4;0.3
23;2021-02-02;157;107;6402;418;5.5;0.4
23;2021-02-03;105;178;6507;596;5.6;0.5
23;2021-02-04;77;247;6584;843;5.7;0.7
23;2021-02-05;117;274;6701;1117;5.8;1.0
23;2021-02-06;14;127;6715;1244;5.8;1.1
23;2021-02-07;1;0;6716;1244;5.8;1.1
23;2021-02-08;123;166;6839;1410;5.9;1.2
23;2021-02-09;89;254;6928;1664;6.0;1.4
23;2021-02-10;92;227;7020;1891;6.0;1.6
23;2021-02-11;246;513;7266;2404;6.2;2.1
23;2021-02-12;174;258;7440;2662;6.4;2.3
23;2021-02-13;8;178;7448;2840;6.4;2.4
23;2021-02-14;8;0;7456;2840;6.4;2.4
23;2021-02-15;157;300;7613;3140;6.5;2.7
23;2021-02-16;103;368;7716;3508;6.6;3.0
23;2021-02-17;65;403;7781;3911;6.7;3.4
23;2021-02-18;142;304;7923;4215;6.8;3.6
23;2021-02-19;109;203;8032;4418;6.9;3.8
23;2021-02-20;2;81;8034;4499;6.9;3.9
23;2021-02-21;0;0;8034;4499;6.9;3.9
23;2021-02-22;104;178;8138;4677;7.0;4.0
23;2021-02-23;108;174;8246;4851;7.1;4.2
23;2021-02-24;176;140;8422;4991;7.2;4.3
23;2021-02-25;184;86;8606;5077;7.4;4.4
23;2021-02-26;287;149;8893;5226;7.6;4.5
23;2021-02-27;112;11;9005;5237;7.7;4.5
23;2021-02-28;1;31;9006;5268;7.7;4.5
23;2021-03-01;88;172;9094;5440;7.8;4.7
23;2021-03-02;229;115;9323;5555;8.0;4.8
23;2021-03-03;133;79;9456;5634;8.1;4.8
23;2021-03-04;307;129;9763;5763;8.4;5.0
23;2021-03-05;517;104;10280;5867;8.8;5.0
23;2021-03-06;494;6;10774;5873;9.3;5.1
23;2021-03-07;313;3;11087;5876;9.5;5.1
23;2021-03-08;197;70;11284;5946;9.7;5.1
23;2021-03-09;421;102;11705;6048;10.1;5.2
23;2021-03-10;348;37;12053;6085;10.4;5.2
23;2021-03-11;324;44;12377;6129;10.6;5.3
23;2021-03-12;621;34;12998;6163;11.2;5.3
23;2021-03-13;287;12;13285;6175;11.4;5.3
23;2021-03-14;47;34;13332;6209;11.5;5.3
23;2021-03-15;220;124;13552;6333;11.7;5.4
23;2021-03-16;192;80;13744;6413;11.8;5.5
23;2021-03-17;131;99;13875;6512;11.9;5.6
23;2021-03-18;192;92;14067;6604;12.1;5.7
23;2021-03-19;207;117;14274;6721;12.3;5.8
23;2021-03-20;631;37;14905;6758;12.8;5.8
23;2021-03-21;128;0;15033;6758;12.9;5.8
23;2021-03-22;274;156;15307;6914;13.2;5.9
23;2021-03-23;504;101;15811;7015;13.6;6.0
23;2021-03-24;422;124;16233;7139;14.0;6.1
23;2021-03-25;820;188;17053;7327;14.7;6.3
23;2021-03-26;735;193;17788;7520;15.3;6.5
23;2021-03-27;507;50;18295;7570;15.7;6.5
23;2021-03-28;3;9;18298;7579;15.7;6.5
23;2021-03-29;358;108;18656;7687;16.0;6.6
23;2021-03-30;537;178;19193;7865;16.5;6.8
23;2021-03-31;411;171;19604;8036;16.9;6.9
23;2021-04-01;600;172;20204;8208;17.4;7.1
23;2021-04-02;498;296;20702;8504;17.8;7.3
23;2021-04-03;715;44;21417;8548;18.4;7.4
23;2021-04-04;4;0;21421;8548;18.4;7.4
23;2021-04-05;2;3;21423;8551;18.4;7.4
23;2021-04-06;382;293;21805;8844;18.8;7.6
23;2021-04-07;706;309;22511;9153;19.4;7.9
23;2021-04-08;805;237;23316;9390;20.1;8.1
23;2021-04-09;940;366;24256;9756;20.9;8.4
23;2021-04-10;1097;111;25353;9867;21.8;8.5
23;2021-04-11;21;2;25374;9869;21.8;8.5
23;2021-04-12;692;236;26066;10105;22.4;8.7
23;2021-04-13;670;302;26736;10407;23.0;9.0
23;2021-04-14;586;178;27322;10585;23.5;9.1
23;2021-04-15;928;185;28250;10770;24.3;9.3
23;2021-04-16;905;213;29155;10983;25.1;9.4
23;2021-04-17;996;553;30151;11536;25.9;9.9
23;2021-04-18;3;136;30154;11672;25.9;10.0
23;2021-04-19;612;297;30766;11969;26.5;10.3
23;2021-04-20;721;292;31487;12261;27.1;10.5
23;2021-04-21;733;397;32220;12658;27.7;10.9
23;2021-04-22;655;472;32875;13130;28.3;11.3
23;2021-04-23;596;346;33471;13476;28.8;11.6
23;2021-04-24;855;449;34326;13925;29.5;12.0
23;2021-04-25;0;0;34326;13925;29.5;12.0
23;2021-04-26;615;253;34941;14178;30.1;12.2
23;2021-04-27;675;419;35616;14597;30.6;12.6
23;2021-04-28;628;276;36244;14873;31.2;12.8
23;2021-04-29;883;379;37127;15252;31.9;13.1
23;2021-04-30;719;784;37846;16036;32.6;13.8
23;2021-05-01;1229;42;39075;16078;33.6;13.8
23;2021-05-02;14;0;39089;16078;33.6;13.8
23;2021-05-03;430;520;39519;16598;34.0;14.3
23;2021-05-04;617;513;40136;17111;34.5;14.7
23;2021-05-05;540;713;40676;17824;35.0;15.3
23;2021-05-06;728;698;41404;18522;35.6;15.9
23;2021-05-07;685;643;42089;19165;36.2;16.5
23;2021-05-08;1411;588;43500;19753;37.4;17.0
23;2021-05-09;4;0;43504;19753;37.4;17.0
23;2021-05-10;555;656;44059;20409;37.9;17.6
23;2021-05-11;560;764;44619;21173;38.4;18.2
23;2021-05-12;720;662;45339;21835;39.0;18.8
23;2021-05-13;538;56;45877;21891;39.5;18.8
23;2021-05-14;787;458;46664;22349;40.1;19.2
23;2021-05-15;995;235;47659;22584;41.0;19.4
23;2021-05-16;0;0;47659;22584;41.0;19.4
23;2021-05-17;566;448;48225;23032;41.5;19.8
23;2021-05-18;777;292;49002;23324;42.1;20.1
23;2021-05-19;1051;259;50053;23583;43.0;20.3
23;2021-05-20;838;314;50891;23897;43.8;20.6
23;2021-05-21;1108;311;51999;24208;44.7;20.8
23;2021-05-22;740;125;52739;24333;45.4;20.9
23;2021-05-23;3;20;52742;24353;45.4;20.9
23;2021-05-24;363;166;53105;24519;45.7;21.1
23;2021-05-25;908;336;54013;24855;46.5;21.4
23;2021-05-26;1077;227;55090;25082;47.4;21.6
23;2021-05-27;931;437;56021;25519;48.2;21.9
23;2021-05-28;781;743;56802;26262;48.9;22.6
23;2021-05-29;638;1099;57440;27361;49.4;23.5
23;2021-05-30;6;63;57446;27424;49.4;23.6
23;2021-05-31;433;539;57879;27963;49.8;24.1
23;2021-06-01;582;827;58461;28790;50.3;24.8
23;2021-06-02;625;516;59086;29306;50.8;25.2
23;2021-06-03;708;551;59794;29857;51.4;25.7
23;2021-06-04;778;614;60572;30471;52.1;26.2
23;2021-06-05;543;777;61115;31248;52.6;26.9
23;2021-06-06;0;0;61115;31248;52.6;26.9
23;2021-06-07;393;696;61508;31944;52.9;27.5
23;2021-06-08;323;776;61831;32720;53.2;28.1
23;2021-06-09;287;648;62118;33368;53.4;28.7
23;2021-06-10;374;690;62492;34058;53.7;29.3
23;2021-06-11;384;807;62876;34865;54.1;30.0
23;2021-06-12;376;1265;63252;36130;54.4;31.1
23;2021-06-13;13;5;63265;36135;54.4;31.1
23;2021-06-14;235;589;63500;36724;54.6;31.6
23;2021-06-15;229;860;63729;37584;54.8;32.3
23;2021-06-16;362;579;64091;38163;55.1;32.8
23;2021-06-17;339;810;64430;38973;55.4;33.5
23;2021-06-18;356;767;64786;39740;55.7;34.2
23;2021-06-19;493;1523;65279;41263;56.1;35.5
23;2021-06-20;2;11;65281;41274;56.1;35.5
23;2021-06-21;205;620;65486;41894;56.3;36.0
23;2021-06-22;216;687;65702;42581;56.5;36.6
23;2021-06-23;221;750;65923;43331;56.7;37.3
23;2021-06-24;200;606;66123;43937;56.9;37.8
23;2021-06-25;302;815;66425;44752;57.1;38.5
23;2021-06-26;221;999;66646;45751;57.3;39.3
23;2021-06-27;3;0;66649;45751;57.3;39.3
23;2021-06-28;115;690;66764;46441;57.4;39.9
23;2021-06-29;189;823;66953;47264;57.6;40.7
23;2021-06-30;169;944;67122;48208;57.7;41.5
23;2021-07-01;168;870;67290;49078;57.9;42.2
23;2021-07-02;192;1069;67482;50147;58.0;43.1
23;2021-07-03;250;979;67732;51126;58.3;44.0
23;2021-07-04;1;0;67733;51126;58.3;44.0
23;2021-07-05;160;805;67893;51931;58.4;44.7
23;2021-07-06;215;1043;68108;52974;58.6;45.6
23;2021-07-07;210;848;68318;53822;58.8;46.3
23;2021-07-08;254;740;68572;54562;59.0;46.9
23;2021-07-09;275;1012;68847;55574;59.2;47.8
23;2021-07-10;234;644;69081;56218;59.4;48.4
23;2021-07-11;0;0;69081;56218;59.4;48.4
23;2021-07-12;232;702;69313;56920;59.6;49.0
23;2021-07-13;471;917;69784;57837;60.0;49.7
23;2021-07-14;212;320;69996;58157;60.2;50.0
23;2021-07-15;483;810;70479;58967;60.6;50.7
23;2021-07-16;764;566;71243;59533;61.3;51.2
23;2021-07-17;220;478;71463;60011;61.5;51.6
23;2021-07-18;0;1;71463;60012;61.5;51.6
23;2021-07-19;704;628;72167;60640;62.1;52.2
23;2021-07-20;633;569;72800;61209;62.6;52.6
23;2021-07-21;702;636;73502;61845;63.2;53.2
23;2021-07-22;945;438;74447;62283;64.0;53.6
23;2021-07-23;841;508;75288;62791;64.8;54.0
23;2021-07-24;1013;439;76301;63230;65.6;54.4
23;2021-07-25;13;16;76314;63246;65.6;54.4
23;2021-07-26;788;563;77102;63809;66.3;54.9
23;2021-07-27;928;436;78030;64245;67.1;55.3
23;2021-07-28;877;411;78907;64656;67.9;55.6
23;2021-07-29;1049;400;79956;65056;68.8;56.0
23;2021-07-30;947;521;80903;65577;69.6;56.4
23;2021-07-31;1165;306;82068;65883;70.6;56.7
23;2021-08-01;19;8;82087;65891;70.6;56.7
23;2021-08-02;674;506;82761;66397;71.2;57.1
23;2021-08-03;767;458;83528;66855;71.8;57.5
23;2021-08-04;612;297;84140;67152;72.4;57.8
23;2021-08-05;692;365;84832;67517;73.0;58.1
23;2021-08-06;421;482;85253;67999;73.3;58.5
23;2021-08-07;299;188;85552;68187;73.6;58.6
23;2021-08-08;146;38;85698;68225;73.7;58.7
23;2021-08-09;492;492;86190;68717;74.1;59.1
23;2021-08-10;467;608;86657;69325;74.5;59.6
23;2021-08-11;428;487;87085;69812;74.9;60.0
23;2021-08-12;514;567;87599;70379;75.3;60.5
23;2021-08-13;420;578;88019;70957;75.7;61.0
23;2021-08-14;287;390;88306;71347;75.9;61.4
23;2021-08-15;27;9;88333;71356;76.0;61.4
23;2021-08-16;276;710;88609;72066;76.2;62.0
23;2021-08-17;278;729;88887;72795;76.4;62.6
23;2021-08-18;180;637;89067;73432;76.6;63.2
23;2021-08-19;257;726;89324;74158;76.8;63.8
23;2021-08-20;215;682;89539;74840;77.0;64.4
23;2021-08-21;140;500;89679;75340;77.1;64.8
23;2021-08-22;54;48;89733;75388;77.2;64.8
23;2021-08-23;149;816;89882;76204;77.3;65.5
23;2021-08-24;265;911;90147;77115;77.5;66.3
23;2021-08-25;187;791;90334;77906;77.7;67.0
23;2021-08-26;220;744;90554;78650;77.9;67.6
23;2021-08-27;213;639;90767;79289;78.1;68.2
23;2021-08-28;220;454;90987;79743;78.3;68.6
23;2021-08-29;15;88;91002;79831;78.3;68.7
23;2021-08-30;187;665;91189;80496;78.4;69.2
23;2021-08-31;227;672;91416;81168;78.6;69.8
23;2021-09-01;160;429;91576;81597;78.8;70.2
23;2021-09-02;118;346;91694;81943;78.9;70.5
23;2021-09-03;208;583;91902;82526;79.0;71.0
23;2021-09-04;178;846;92080;83372;79.2;71.7
23;2021-09-05;5;7;92085;83379;79.2;71.7
23;2021-09-06;132;489;92217;83868;79.3;72.1
23;2021-09-07;98;527;92315;84395;79.4;72.6
23;2021-09-08;121;486;92436;84881;79.5;73.0
23;2021-09-09;115;393;92551;85274;79.6;73.3
23;2021-09-10;150;450;92701;85724;79.7;73.7
23;2021-09-11;102;224;92803;85948;79.8;73.9
23;2021-09-12;5;16;92808;85964;79.8;73.9
23;2021-09-13;111;401;92919;86365;79.9;74.3
23;2021-09-14;111;464;93030;86829;80.0;74.7
23;2021-09-15;94;241;93124;87070;80.1;74.9
23;2021-09-16;127;152;93251;87222;80.2;75.0
23;2021-09-17;140;227;93391;87449;80.3;75.2
23;2021-09-18;44;224;93435;87673;80.4;75.4
23;2021-09-19;0;1;93435;87674;80.4;75.4
23;2021-09-20;59;217;93494;87891;80.4;75.6
23;2021-09-21;84;183;93578;88074;80.5;75.7
23;2021-09-22;71;260;93649;88334;80.5;76.0
23;2021-09-23;58;133;93707;88467;80.6;76.1
23;2021-09-24;64;234;93771;88701;80.6;76.3
23;2021-09-25;27;138;93798;88839;80.7;76.4
23;2021-09-26;0;1;93798;88840;80.7;76.4
23;2021-09-27;34;159;93832;88999;80.7;76.5
23;2021-09-28;34;133;93866;89132;80.7;76.7
23;2021-09-29;62;156;93928;89288;80.8;76.8
24;2020-12-27;1;0;1;0;0.0;0.0
24;2020-12-28;1;0;2;0;0.0;0.0
24;2020-12-29;2;0;4;0;0.0;0.0
24;2020-12-30;1;0;5;0;0.0;0.0
24;2020-12-31;1;0;6;0;0.0;0.0
24;2021-01-01;2;0;8;0;0.0;0.0
24;2021-01-02;1;0;9;0;0.0;0.0
24;2021-01-03;0;0;9;0;0.0;0.0
24;2021-01-04;1;0;10;0;0.0;0.0
24;2021-01-05;1;0;11;0;0.0;0.0
24;2021-01-06;2;0;13;0;0.0;0.0
24;2021-01-07;190;0;203;0;0.0;0.0
24;2021-01-08;282;0;485;0;0.1;0.0
24;2021-01-09;185;13;670;13;0.2;0.0
24;2021-01-10;35;0;705;13;0.2;0.0
24;2021-01-11;269;0;974;13;0.2;0.0
24;2021-01-12;280;0;1254;13;0.3;0.0
24;2021-01-13;233;0;1487;13;0.4;0.0
24;2021-01-14;1020;21;2507;34;0.6;0.0
24;2021-01-15;605;4;3112;38;0.8;0.0
24;2021-01-16;88;0;3200;38;0.8;0.0
24;2021-01-17;2;1;3202;39;0.8;0.0
24;2021-01-18;300;0;3502;39;0.9;0.0
24;2021-01-19;467;1;3969;40;1.0;0.0
24;2021-01-20;557;0;4526;40;1.1;0.0
24;2021-01-21;644;6;5170;46;1.3;0.0
24;2021-01-22;516;1;5686;47;1.4;0.0
24;2021-01-23;154;1;5840;48;1.4;0.0
24;2021-01-24;4;0;5844;48;1.4;0.0
24;2021-01-25;442;0;6286;48;1.5;0.0
24;2021-01-26;638;65;6924;113;1.7;0.0
24;2021-01-27;1267;14;8191;127;2.0;0.0
24;2021-01-28;986;126;9177;253;2.2;0.1
24;2021-01-29;932;128;10109;381;2.5;0.1
24;2021-01-30;282;1;10391;382;2.5;0.1
24;2021-01-31;0;0;10391;382;2.5;0.1
24;2021-02-01;379;164;10770;546;2.6;0.1
24;2021-02-02;616;289;11386;835;2.8;0.2
24;2021-02-03;653;435;12039;1270;2.9;0.3
24;2021-02-04;978;382;13017;1652;3.2;0.4
24;2021-02-05;689;355;13706;2007;3.4;0.5
24;2021-02-06;141;35;13847;2042;3.4;0.5
24;2021-02-07;33;1;13880;2043;3.4;0.5
24;2021-02-08;310;222;14190;2265;3.5;0.6
24;2021-02-09;454;230;14644;2495;3.6;0.6
24;2021-02-10;378;101;15022;2596;3.7;0.6
24;2021-02-11;561;487;15583;3083;3.8;0.8
24;2021-02-12;496;373;16079;3456;3.9;0.8
24;2021-02-13;202;41;16281;3497;4.0;0.9
24;2021-02-14;89;0;16370;3497;4.0;0.9
24;2021-02-15;187;197;16557;3694;4.1;0.9
24;2021-02-16;336;450;16893;4144;4.1;1.0
24;2021-02-17;586;784;17479;4928;4.3;1.2
24;2021-02-18;444;648;17923;5576;4.4;1.4
24;2021-02-19;462;640;18385;6216;4.5;1.5
24;2021-02-20;164;107;18549;6323;4.5;1.5
24;2021-02-21;111;0;18660;6323;4.6;1.5
24;2021-02-22;427;454;19087;6777;4.7;1.7
24;2021-02-23;562;598;19649;7375;4.8;1.8
24;2021-02-24;539;734;20188;8109;4.9;2.0
24;2021-02-25;727;771;20915;8880;5.1;2.2
24;2021-02-26;978;830;21893;9710;5.4;2.4
24;2021-02-27;363;228;22256;9938;5.4;2.4
24;2021-02-28;25;4;22281;9942;5.5;2.4
24;2021-03-01;291;318;22572;10260;5.5;2.5
24;2021-03-02;541;380;23113;10640;5.7;2.6
24;2021-03-03;681;297;23794;10937;5.8;2.7
24;2021-03-04;914;468;24708;11405;6.1;2.8
24;2021-03-05;1067;519;25775;11924;6.3;2.9
24;2021-03-06;1125;126;26900;12050;6.6;3.0
24;2021-03-07;232;63;27132;12113;6.6;3.0
24;2021-03-08;530;217;27662;12330;6.8;3.0
24;2021-03-09;1174;395;28836;12725;7.1;3.1
24;2021-03-10;1142;413;29978;13138;7.3;3.2
24;2021-03-11;1607;443;31585;13581;7.7;3.3
24;2021-03-12;2058;429;33643;14010;8.2;3.4
24;2021-03-13;1348;181;34991;14191;8.6;3.5
24;2021-03-14;141;88;35132;14279;8.6;3.5
24;2021-03-15;953;163;36085;14442;8.8;3.5
24;2021-03-16;1144;228;37229;14670;9.1;3.6
24;2021-03-17;1217;279;38446;14949;9.4;3.7
24;2021-03-18;1054;550;39500;15499;9.7;3.8
24;2021-03-19;1251;526;40751;16025;10.0;3.9
24;2021-03-20;1054;143;41805;16168;10.2;4.0
24;2021-03-21;25;11;41830;16179;10.2;4.0
24;2021-03-22;1224;406;43054;16585;10.5;4.1
24;2021-03-23;1879;388;44933;16973;11.0;4.2
24;2021-03-24;1892;379;46825;17352;11.5;4.2
24;2021-03-25;1991;468;48816;17820;12.0;4.4
24;2021-03-26;2374;278;51190;18098;12.5;4.4
24;2021-03-27;1349;42;52539;18140;12.9;4.4
24;2021-03-28;63;9;52602;18149;12.9;4.4
24;2021-03-29;1673;327;54275;18476;13.3;4.5
24;2021-03-30;2410;390;56685;18866;13.9;4.6
24;2021-03-31;2187;308;58872;19174;14.4;4.7
24;2021-04-01;2197;309;61069;19483;15.0;4.8
24;2021-04-02;2073;391;63142;19874;15.5;4.9
24;2021-04-03;1376;121;64518;19995;15.8;4.9
24;2021-04-04;74;1;64592;19996;15.8;4.9
24;2021-04-05;948;60;65540;20056;16.0;4.9
24;2021-04-06;2355;700;67895;20756;16.6;5.1
24;2021-04-07;2717;691;70612;21447;17.3;5.3
24;2021-04-08;3001;959;73613;22406;18.0;5.5
24;2021-04-09;3488;1004;77101;23410;18.9;5.7
24;2021-04-10;2595;313;79696;23723;19.5;5.8
24;2021-04-11;1103;20;80799;23743;19.8;5.8
24;2021-04-12;2498;808;83297;24551;20.4;6.0
24;2021-04-13;2902;1202;86199;25753;21.1;6.3
24;2021-04-14;2938;1196;89137;26949;21.8;6.6
24;2021-04-15;2790;1104;91927;28053;22.5;6.9
24;2021-04-16;3265;975;95192;29028;23.3;7.1
24;2021-04-17;2273;500;97465;29528;23.9;7.2
24;2021-04-18;424;6;97889;29534;24.0;7.2
24;2021-04-19;1598;1011;99487;30545;24.4;7.5
24;2021-04-20;2268;1432;101755;31977;24.9;7.8
24;2021-04-21;2146;1443;103901;33420;25.4;8.2
24;2021-04-22;2061;1257;105962;34677;25.9;8.5
24;2021-04-23;1960;1335;107922;36012;26.4;8.8
24;2021-04-24;863;724;108785;36736;26.6;9.0
24;2021-04-25;54;4;108839;36740;26.7;9.0
24;2021-04-26;1295;1476;110134;38216;27.0;9.4
24;2021-04-27;1848;1879;111982;40095;27.4;9.8
24;2021-04-28;1506;1942;113488;42037;27.8;10.3
24;2021-04-29;1730;1883;115218;43920;28.2;10.8
24;2021-04-30;2271;1768;117489;45688;28.8;11.2
24;2021-05-01;2059;1062;119548;46750;29.3;11.4
24;2021-05-02;1925;218;121473;46968;29.7;11.5
24;2021-05-03;1475;1830;122948;48798;30.1;11.9
24;2021-05-04;2227;2295;125175;51093;30.7;12.5
24;2021-05-05;1891;2716;127066;53809;31.1;13.2
24;2021-05-06;1890;2795;128956;56604;31.6;13.9
24;2021-05-07;2263;2786;131219;59390;32.1;14.5
24;2021-05-08;1285;1150;132504;60540;32.4;14.8
24;2021-05-09;1169;903;133673;61443;32.7;15.0
24;2021-05-10;1097;2622;134770;64065;33.0;15.7
24;2021-05-11;2037;2783;136807;66848;33.5;16.4
24;2021-05-12;1924;2246;138731;69094;34.0;16.9
24;2021-05-13;1465;1215;140196;70309;34.3;17.2
24;2021-05-14;2378;1333;142574;71642;34.9;17.5
24;2021-05-15;2048;816;144622;72458;35.4;17.7
24;2021-05-16;1171;346;145793;72804;35.7;17.8
24;2021-05-17;2240;1250;148033;74054;36.2;18.1
24;2021-05-18;2485;1817;150518;75871;36.9;18.6
24;2021-05-19;2283;1376;152801;77247;37.4;18.9
24;2021-05-20;2375;1571;155176;78818;38.0;19.3
24;2021-05-21;2434;1415;157610;80233;38.6;19.6
24;2021-05-22;1719;409;159329;80642;39.0;19.7
24;2021-05-23;952;72;160281;80714;39.2;19.8
24;2021-05-24;1517;331;161798;81045;39.6;19.8
24;2021-05-25;2297;1383;164095;82428;40.2;20.2
24;2021-05-26;2148;1319;166243;83747;40.7;20.5
24;2021-05-27;1749;2192;167992;85939;41.1;21.0
24;2021-05-28;2144;1999;170136;87938;41.7;21.5
24;2021-05-29;1153;2082;171289;90020;41.9;22.0
24;2021-05-30;1418;169;172707;90189;42.3;22.1
24;2021-05-31;1740;1363;174447;91552;42.7;22.4
24;2021-06-01;2581;1977;177028;93529;43.3;22.9
24;2021-06-02;2654;1781;179682;95310;44.0;23.3
24;2021-06-03;2289;1458;181971;96768;44.6;23.7
24;2021-06-04;2377;1899;184348;98667;45.1;24.2
24;2021-06-05;2007;1413;186355;100080;45.6;24.5
24;2021-06-06;766;222;187121;100302;45.8;24.6
24;2021-06-07;1432;1497;188553;101799;46.2;24.9
24;2021-06-08;1677;1905;190230;103704;46.6;25.4
24;2021-06-09;1322;1596;191552;105300;46.9;25.8
24;2021-06-10;1577;1909;193129;107209;47.3;26.3
24;2021-06-11;1334;2077;194463;109286;47.6;26.8
24;2021-06-12;1118;2539;195581;111825;47.9;27.4
24;2021-06-13;1238;921;196819;112746;48.2;27.6
24;2021-06-14;1166;1858;197985;114604;48.5;28.1
24;2021-06-15;1488;2991;199473;117595;48.8;28.8
24;2021-06-16;1670;2732;201143;120327;49.3;29.5
24;2021-06-17;1544;2176;202687;122503;49.6;30.0
24;2021-06-18;1400;2859;204087;125362;50.0;30.7
24;2021-06-19;1273;1522;205360;126884;50.3;31.1
24;2021-06-20;514;501;205874;127385;50.4;31.2
24;2021-06-21;931;1833;206805;129218;50.6;31.6
24;2021-06-22;1451;2591;208256;131809;51.0;32.3
24;2021-06-23;1425;2417;209681;134226;51.3;32.9
24;2021-06-24;1137;1916;210818;136142;51.6;33.3
24;2021-06-25;968;2817;211786;138959;51.9;34.0
24;2021-06-26;866;2099;212652;141058;52.1;34.5
24;2021-06-27;402;979;213054;142037;52.2;34.8
24;2021-06-28;818;2482;213872;144519;52.4;35.4
24;2021-06-29;938;2867;214810;147386;52.6;36.1
24;2021-06-30;1111;2455;215921;149841;52.9;36.7
24;2021-07-01;1131;2303;217052;152144;53.1;37.3
24;2021-07-02;1096;2745;218148;154889;53.4;37.9
24;2021-07-03;810;1903;218958;156792;53.6;38.4
24;2021-07-04;411;1013;219369;157805;53.7;38.6
24;2021-07-05;793;2316;220162;160121;53.9;39.2
24;2021-07-06;879;3354;221041;163475;54.1;40.0
24;2021-07-07;1086;3040;222127;166515;54.4;40.8
24;2021-07-08;1339;2118;223466;168633;54.7;41.3
24;2021-07-09;1178;3216;224644;171849;55.0;42.1
24;2021-07-10;481;1963;225125;173812;55.1;42.6
24;2021-07-11;587;1189;225712;175001;55.3;42.9
24;2021-07-12;906;2517;226618;177518;55.5;43.5
24;2021-07-13;1323;3217;227941;180735;55.8;44.3
24;2021-07-14;619;1189;228560;181924;56.0;44.5
24;2021-07-15;1697;2776;230257;184700;56.4;45.2
24;2021-07-16;2149;2598;232406;187298;56.9;45.9
24;2021-07-17;1528;2239;233934;189537;57.3;46.4
24;2021-07-18;709;887;234643;190424;57.5;46.6
24;2021-07-19;1580;2188;236223;192612;57.8;47.2
24;2021-07-20;2017;2435;238240;195047;58.3;47.8
24;2021-07-21;1875;2329;240115;197376;58.8;48.3
24;2021-07-22;2350;2439;242465;199815;59.4;48.9
24;2021-07-23;2303;2623;244768;202438;59.9;49.6
24;2021-07-24;1807;1545;246575;203983;60.4;49.9
24;2021-07-25;816;875;247391;204858;60.6;50.2
24;2021-07-26;1572;2015;248963;206873;61.0;50.7
24;2021-07-27;2848;2289;251811;209162;61.7;51.2
24;2021-07-28;2764;1935;254575;211097;62.3;51.7
24;2021-07-29;3063;2237;257638;213334;63.1;52.2
24;2021-07-30;2466;1919;260104;215253;63.7;52.7
24;2021-07-31;1654;1566;261758;216819;64.1;53.1
24;2021-08-01;1117;658;262875;217477;64.4;53.3
24;2021-08-02;1946;1621;264821;219098;64.8;53.6
24;2021-08-03;2887;1908;267708;221006;65.6;54.1
24;2021-08-04;3077;1630;270785;222636;66.3;54.5
24;2021-08-05;3047;1438;273832;224074;67.1;54.9
24;2021-08-06;2537;1539;276369;225613;67.7;55.2
24;2021-08-07;1792;1121;278161;226734;68.1;55.5
24;2021-08-08;1107;687;279268;227421;68.4;55.7
24;2021-08-09;1740;1383;281008;228804;68.8;56.0
24;2021-08-10;2267;1785;283275;230589;69.4;56.5
24;2021-08-11;2278;1698;285553;232287;69.9;56.9
24;2021-08-12;1916;1957;287469;234244;70.4;57.4
24;2021-08-13;1530;1625;288999;235869;70.8;57.8
24;2021-08-14;1171;1242;290170;237111;71.1;58.1
24;2021-08-15;741;583;290911;237694;71.2;58.2
24;2021-08-16;1122;1704;292033;239398;71.5;58.6
24;2021-08-17;1632;2108;293665;241506;71.9;59.1
24;2021-08-18;1562;1925;295227;243431;72.3;59.6
24;2021-08-19;1125;2636;296352;246067;72.6;60.3
24;2021-08-20;1107;2428;297459;248495;72.8;60.8
24;2021-08-21;874;1634;298333;250129;73.1;61.2
24;2021-08-22;351;1102;298684;251231;73.1;61.5
24;2021-08-23;671;2036;299355;253267;73.3;62.0
24;2021-08-24;818;2395;300173;255662;73.5;62.6
24;2021-08-25;814;2323;300987;257985;73.7;63.2
24;2021-08-26;744;2839;301731;260824;73.9;63.9
24;2021-08-27;801;2763;302532;263587;74.1;64.5
24;2021-08-28;523;1910;303055;265497;74.2;65.0
24;2021-08-29;171;1029;303226;266526;74.2;65.3
24;2021-08-30;375;1965;303601;268491;74.3;65.7
24;2021-08-31;591;2489;304192;270980;74.5;66.4
24;2021-09-01;624;2481;304816;273461;74.6;67.0
24;2021-09-02;465;1901;305281;275362;74.8;67.4
24;2021-09-03;550;2236;305831;277598;74.9;68.0
24;2021-09-04;364;1995;306195;279593;75.0;68.5
24;2021-09-05;245;974;306440;280567;75.0;68.7
24;2021-09-06;344;1622;306784;282189;75.1;69.1
24;2021-09-07;477;1892;307261;284081;75.2;69.6
24;2021-09-08;399;1927;307660;286008;75.3;70.0
24;2021-09-09;335;1345;307995;287353;75.4;70.4
24;2021-09-10;376;1785;308371;289138;75.5;70.8
24;2021-09-11;316;1686;308687;290824;75.6;71.2
24;2021-09-12;92;432;308779;291256;75.6;71.3
24;2021-09-13;292;1232;309071;292488;75.7;71.6
24;2021-09-14;429;1134;309500;293622;75.8;71.9
24;2021-09-15;412;1267;309912;294889;75.9;72.2
24;2021-09-16;248;890;310160;295779;75.9;72.4
24;2021-09-17;409;1036;310569;296815;76.0;72.7
24;2021-09-18;308;1111;310877;297926;76.1;73.0
24;2021-09-19;45;347;310922;298273;76.1;73.0
24;2021-09-20;154;577;311076;298850;76.2;73.2
24;2021-09-21;379;407;311455;299257;76.3;73.3
24;2021-09-22;225;697;311680;299954;76.3;73.4
24;2021-09-23;135;389;311815;300343;76.4;73.5
24;2021-09-24;247;810;312062;301153;76.4;73.7
24;2021-09-25;212;592;312274;301745;76.5;73.9
24;2021-09-26;32;106;312306;301851;76.5;73.9
24;2021-09-27;176;492;312482;302343;76.5;74.0
24;2021-09-28;208;327;312690;302670;76.6;74.1
24;2021-09-29;214;585;312904;303255;76.6;74.3
25;2020-12-27;0;0;0;0;0.0;0.0
25;2020-12-28;1;0;1;0;0.0;0.0
25;2020-12-29;0;0;1;0;0.0;0.0
25;2020-12-30;0;0;1;0;0.0;0.0
25;2020-12-31;3;0;4;0;0.0;0.0
25;2021-01-01;0;0;4;0;0.0;0.0
25;2021-01-02;1;0;5;0;0.0;0.0
25;2021-01-03;0;0;5;0;0.0;0.0
25;2021-01-04;1;0;6;0;0.0;0.0
25;2021-01-05;1;0;7;0;0.0;0.0
25;2021-01-06;75;1;82;1;0.0;0.0
25;2021-01-07;235;1;317;2;0.1;0.0
25;2021-01-08;345;1;662;3;0.1;0.0
25;2021-01-09;102;0;764;3;0.1;0.0
25;2021-01-10;0;0;764;3;0.1;0.0
25;2021-01-11;503;5;1267;8;0.2;0.0
25;2021-01-12;682;2;1949;10;0.4;0.0
25;2021-01-13;627;2;2576;12;0.5;0.0
25;2021-01-14;896;12;3472;24;0.6;0.0
25;2021-01-15;786;9;4258;33;0.8;0.0
25;2021-01-16;206;0;4464;33;0.8;0.0
25;2021-01-17;112;0;4576;33;0.8;0.0
25;2021-01-18;1297;6;5873;39;1.1;0.0
25;2021-01-19;1414;5;7287;44;1.4;0.0
25;2021-01-20;1422;4;8709;48;1.6;0.0
25;2021-01-21;1843;3;10552;51;2.0;0.0
25;2021-01-22;1509;5;12061;56;2.2;0.0
25;2021-01-23;499;0;12560;56;2.3;0.0
25;2021-01-24;119;0;12679;56;2.4;0.0
25;2021-01-25;990;0;13669;56;2.5;0.0
25;2021-01-26;1487;41;15156;97;2.8;0.0
25;2021-01-27;1248;67;16404;164;3.0;0.0
25;2021-01-28;1089;74;17493;238;3.2;0.0
25;2021-01-29;906;200;18399;438;3.4;0.1
25;2021-01-30;293;82;18692;520;3.5;0.1
25;2021-01-31;2;0;18694;520;3.5;0.1
25;2021-02-01;612;201;19306;721;3.6;0.1
25;2021-02-02;674;363;19980;1084;3.7;0.2
25;2021-02-03;758;214;20738;1298;3.8;0.2
25;2021-02-04;715;365;21453;1663;4.0;0.3
25;2021-02-05;520;425;21973;2088;4.1;0.4
25;2021-02-06;197;138;22170;2226;4.1;0.4
25;2021-02-07;2;34;22172;2260;4.1;0.4
25;2021-02-08;612;454;22784;2714;4.2;0.5
25;2021-02-09;615;422;23399;3136;4.3;0.6
25;2021-02-10;818;423;24217;3559;4.5;0.7
25;2021-02-11;589;734;24806;4293;4.6;0.8
25;2021-02-12;413;466;25219;4759;4.7;0.9
25;2021-02-13;97;113;25316;4872;4.7;0.9
25;2021-02-14;0;0;25316;4872;4.7;0.9
25;2021-02-15;186;811;25502;5683;4.7;1.1
25;2021-02-16;214;1181;25716;6864;4.8;1.3
25;2021-02-17;107;1028;25823;7892;4.8;1.5
25;2021-02-18;147;1139;25970;9031;4.8;1.7
25;2021-02-19;102;999;26072;10030;4.8;1.9
25;2021-02-20;27;364;26099;10394;4.8;1.9
25;2021-02-21;1;102;26100;10496;4.8;1.9
25;2021-02-22;83;875;26183;11371;4.9;2.1
25;2021-02-23;195;862;26378;12233;4.9;2.3
25;2021-02-24;104;804;26482;13037;4.9;2.4
25;2021-02-25;522;798;27004;13835;5.0;2.6
25;2021-02-26;607;817;27611;14652;5.1;2.7
25;2021-02-27;228;313;27839;14965;5.2;2.8
25;2021-02-28;6;1;27845;14966;5.2;2.8
25;2021-03-01;442;532;28287;15498;5.2;2.9
25;2021-03-02;654;709;28941;16207;5.4;3.0
25;2021-03-03;544;657;29485;16864;5.5;3.1
25;2021-03-04;1158;601;30643;17465;5.7;3.2
25;2021-03-05;1854;349;32497;17814;6.0;3.3
25;2021-03-06;1170;208;33667;18022;6.2;3.3
25;2021-03-07;9;7;33676;18029;6.2;3.3
25;2021-03-08;548;632;34224;18661;6.3;3.5
25;2021-03-09;1040;712;35264;19373;6.5;3.6
25;2021-03-10;1150;595;36414;19968;6.8;3.7
25;2021-03-11;1657;547;38071;20515;7.1;3.8
25;2021-03-12;1996;440;40067;20955;7.4;3.9
25;2021-03-13;1121;97;41188;21052;7.6;3.9
25;2021-03-14;35;0;41223;21052;7.6;3.9
25;2021-03-15;1125;138;42348;21190;7.9;3.9
25;2021-03-16;1288;122;43636;21312;8.1;4.0
25;2021-03-17;1414;137;45050;21449;8.4;4.0
25;2021-03-18;1526;85;46576;21534;8.6;4.0
25;2021-03-19;1595;127;48171;21661;8.9;4.0
25;2021-03-20;822;38;48993;21699;9.1;4.0
25;2021-03-21;24;0;49017;21699;9.1;4.0
25;2021-03-22;1485;85;50502;21784;9.4;4.0
25;2021-03-23;2161;154;52663;21938;9.8;4.1
25;2021-03-24;2418;97;55081;22035;10.2;4.1
25;2021-03-25;2837;195;57918;22230;10.7;4.1
25;2021-03-26;3160;182;61078;22412;11.3;4.2
25;2021-03-27;1112;89;62190;22501;11.5;4.2
25;2021-03-28;121;65;62311;22566;11.6;4.2
25;2021-03-29;1791;276;64102;22842;11.9;4.2
25;2021-03-30;2214;396;66316;23238;12.3;4.3
25;2021-03-31;2220;359;68536;23597;12.7;4.4
25;2021-04-01;2451;524;70987;24121;13.2;4.5
25;2021-04-02;2026;602;73013;24723;13.5;4.6
25;2021-04-03;447;110;73460;24833;13.6;4.6
25;2021-04-04;39;19;73499;24852;13.6;4.6
25;2021-04-05;145;4;73644;24856;13.7;4.6
25;2021-04-06;1937;685;75581;25541;14.0;4.7
25;2021-04-07;1878;850;77459;26391;14.4;4.9
25;2021-04-08;2435;822;79894;27213;14.8;5.0
25;2021-04-09;2597;998;82491;28211;15.3;5.2
25;2021-04-10;978;288;83469;28499;15.5;5.3
25;2021-04-11;105;28;83574;28527;15.5;5.3
25;2021-04-12;1556;966;85130;29493;15.8;5.5
25;2021-04-13;1988;1320;87118;30813;16.1;5.7
25;2021-04-14;1750;1215;88868;32028;16.5;5.9
25;2021-04-15;1997;1326;90865;33354;16.8;6.2
25;2021-04-16;2085;1007;92950;34361;17.2;6.4
25;2021-04-17;1104;415;94054;34776;17.4;6.4
25;2021-04-18;118;18;94172;34794;17.5;6.4
25;2021-04-19;1327;1243;95499;36037;17.7;6.7
25;2021-04-20;1615;1461;97114;37498;18.0;7.0
25;2021-04-21;1717;1631;98831;39129;18.3;7.3
25;2021-04-22;1855;1709;100686;40838;18.7;7.6
25;2021-04-23;1903;1769;102589;42607;19.0;7.9
25;2021-04-24;1278;703;103867;43310;19.3;8.0
25;2021-04-25;140;114;104007;43424;19.3;8.0
25;2021-04-26;1721;1686;105728;45110;19.6;8.4
25;2021-04-27;2804;1521;108532;46631;20.1;8.6
25;2021-04-28;2425;1554;110957;48185;20.6;8.9
25;2021-04-29;2648;1822;113605;50007;21.1;9.3
25;2021-04-30;3107;1559;116712;51566;21.6;9.6
25;2021-05-01;1789;334;118501;51900;22.0;9.6
25;2021-05-02;442;22;118943;51922;22.0;9.6
25;2021-05-03;2901;847;121844;52769;22.6;9.8
25;2021-05-04;2639;1881;124483;54650;23.1;10.1
25;2021-05-05;2597;1666;127080;56316;23.6;10.4
25;2021-05-06;2927;2164;130007;58480;24.1;10.8
25;2021-05-07;3063;2115;133070;60595;24.7;11.2
25;2021-05-08;1334;229;134404;60824;24.9;11.3
25;2021-05-09;244;87;134648;60911;25.0;11.3
25;2021-05-10;3129;1635;137777;62546;25.5;11.6
25;2021-05-11;3747;2038;141524;64584;26.2;12.0
25;2021-05-12;3688;1789;145212;66373;26.9;12.3
25;2021-05-13;3523;598;148735;66971;27.6;12.4
25;2021-05-14;4482;1305;153217;68276;28.4;12.7
25;2021-05-15;3282;710;156499;68986;29.0;12.8
25;2021-05-16;723;93;157222;69079;29.1;12.8
25;2021-05-17;4089;1098;161311;70177;29.9;13.0
25;2021-05-18;5205;1194;166516;71371;30.9;13.2
25;2021-05-19;5247;1134;171763;72505;31.8;13.4
25;2021-05-20;5134;1451;176897;73956;32.8;13.7
25;2021-05-21;5762;1981;182659;75937;33.9;14.1
25;2021-05-22;3174;722;185833;76659;34.4;14.2
25;2021-05-23;781;157;186614;76816;34.6;14.2
25;2021-05-24;1529;152;188143;76968;34.9;14.3
25;2021-05-25;3513;1650;191656;78618;35.5;14.6
25;2021-05-26;3974;1558;195630;80176;36.3;14.9
25;2021-05-27;4519;1895;200149;82071;37.1;15.2
25;2021-05-28;3994;2651;204143;84722;37.8;15.7
25;2021-05-29;2016;1021;206159;85743;38.2;15.9
25;2021-05-30;174;96;206333;85839;38.2;15.9
25;2021-05-31;2672;1705;209005;87544;38.7;16.2
25;2021-06-01;2729;2155;211734;89699;39.3;16.6
25;2021-06-02;2608;2246;214342;91945;39.7;17.0
25;2021-06-03;3274;2044;217616;93989;40.3;17.4
25;2021-06-04;3209;2408;220825;96397;40.9;17.9
25;2021-06-05;1491;1401;222316;97798;41.2;18.1
25;2021-06-06;987;259;223303;98057;41.4;18.2
25;2021-06-07;2782;2575;226085;100632;41.9;18.7
25;2021-06-08;2603;2761;228688;103393;42.4;19.2
25;2021-06-09;2382;2763;231070;106156;42.8;19.7
25;2021-06-10;2325;2653;233395;108809;43.3;20.2
25;2021-06-11;2709;3302;236104;112111;43.8;20.8
25;2021-06-12;1571;1855;237675;113966;44.1;21.1
25;2021-06-13;496;257;238171;114223;44.2;21.2
25;2021-06-14;1421;3753;239592;117976;44.4;21.9
25;2021-06-15;1644;3567;241236;121543;44.7;22.5
25;2021-06-16;1954;3273;243190;124816;45.1;23.1
25;2021-06-17;1474;3321;244664;128137;45.4;23.8
25;2021-06-18;2286;4297;246950;132434;45.8;24.5
25;2021-06-19;1348;1978;248298;134412;46.0;24.9
25;2021-06-20;59;239;248357;134651;46.0;25.0
25;2021-06-21;1139;4139;249496;138790;46.3;25.7
25;2021-06-22;1151;4672;250647;143462;46.5;26.6
25;2021-06-23;1404;4072;252051;147534;46.7;27.3
25;2021-06-24;1191;4085;253242;151619;46.9;28.1
25;2021-06-25;1640;5603;254882;157222;47.2;29.1
25;2021-06-26;626;3384;255508;160606;47.4;29.8
25;2021-06-27;451;877;255959;161483;47.4;29.9
25;2021-06-28;907;4476;256866;165959;47.6;30.8
25;2021-06-29;1130;5469;257996;171428;47.8;31.8
25;2021-06-30;1311;5372;259307;176800;48.1;32.8
25;2021-07-01;1706;5230;261013;182030;48.4;33.7
25;2021-07-02;1747;5061;262760;187091;48.7;34.7
25;2021-07-03;1042;2692;263802;189783;48.9;35.2
25;2021-07-04;409;722;264211;190505;49.0;35.3
25;2021-07-05;1299;2579;265510;193084;49.2;35.8
25;2021-07-06;1568;4745;267078;197829;49.5;36.7
25;2021-07-07;1597;4501;268675;202330;49.8;37.5
25;2021-07-08;1554;3932;270229;206262;50.1;38.2
25;2021-07-09;1796;4588;272025;210850;50.4;39.1
25;2021-07-10;781;2371;272806;213221;50.6;39.5
25;2021-07-11;127;307;272933;213528;50.6;39.6
25;2021-07-12;1404;3859;274337;217387;50.9;40.3
25;2021-07-13;2470;4769;276807;222156;51.3;41.2
25;2021-07-14;379;561;277186;222717;51.4;41.3
25;2021-07-15;2401;3655;279587;226372;51.8;42.0
25;2021-07-16;3485;3831;283072;230203;52.5;42.7
25;2021-07-17;2207;2040;285279;232243;52.9;43.1
25;2021-07-18;808;1299;286087;233542;53.0;43.3
25;2021-07-19;2543;4207;288630;237749;53.5;44.1
25;2021-07-20;3383;3713;292013;241462;54.1;44.8
25;2021-07-21;3300;3367;295313;244829;54.7;45.4
25;2021-07-22;3350;2983;298663;247812;55.4;45.9
25;2021-07-23;3566;3357;302229;251169;56.0;46.6
25;2021-07-24;1413;2270;303642;253439;56.3;47.0
25;2021-07-25;679;710;304321;254149;56.4;47.1
25;2021-07-26;3056;3009;307377;257158;57.0;47.7
25;2021-07-27;3835;2124;311212;259282;57.7;48.1
25;2021-07-28;3692;2119;314904;261401;58.4;48.5
25;2021-07-29;4320;2092;319224;263493;59.2;48.8
25;2021-07-30;4291;2489;323515;265982;60.0;49.3
25;2021-07-31;1821;1469;325336;267451;60.3;49.6
25;2021-08-01;1352;201;326688;267652;60.6;49.6
25;2021-08-02;2743;2210;329431;269862;61.1;50.0
25;2021-08-03;2839;2204;332270;272066;61.6;50.4
25;2021-08-04;2941;1429;335211;273495;62.1;50.7
25;2021-08-05;2205;1732;337416;275227;62.5;51.0
25;2021-08-06;2289;2349;339705;277576;63.0;51.5
25;2021-08-07;1294;1206;340999;278782;63.2;51.7
25;2021-08-08;325;477;341324;279259;63.3;51.8
25;2021-08-09;2024;2228;343348;281487;63.6;52.2
25;2021-08-10;1975;2524;345323;284011;64.0;52.6
25;2021-08-11;1832;2033;347155;286044;64.4;53.0
25;2021-08-12;2148;2503;349303;288547;64.8;53.5
25;2021-08-13;1712;2023;351015;290570;65.1;53.9
25;2021-08-14;969;1791;351984;292361;65.2;54.2
25;2021-08-15;9;45;351993;292406;65.3;54.2
25;2021-08-16;1261;3261;353254;295667;65.5;54.8
25;2021-08-17;1459;3286;354713;298953;65.8;55.4
25;2021-08-18;1235;2804;355948;301757;66.0;55.9
25;2021-08-19;987;2866;356935;304623;66.2;56.5
25;2021-08-20;1430;3691;358365;308314;66.4;57.2
25;2021-08-21;567;1782;358932;310096;66.5;57.5
25;2021-08-22;212;1273;359144;311369;66.6;57.7
25;2021-08-23;1109;3335;360253;314704;66.8;58.3
25;2021-08-24;1069;3234;361322;317938;67.0;58.9
25;2021-08-25;1015;3061;362337;320999;67.2;59.5
25;2021-08-26;1143;3006;363480;324005;67.4;60.1
25;2021-08-27;1202;3063;364682;327068;67.6;60.6
25;2021-08-28;588;1791;365270;328859;67.7;61.0
25;2021-08-29;160;513;365430;329372;67.7;61.1
25;2021-08-30;938;2824;366368;332196;67.9;61.6
25;2021-08-31;969;2420;367337;334616;68.1;62.0
25;2021-09-01;842;2574;368179;337190;68.3;62.5
25;2021-09-02;772;1953;368951;339143;68.4;62.9
25;2021-09-03;798;2216;369749;341359;68.5;63.3
25;2021-09-04;690;1556;370439;342915;68.7;63.6
25;2021-09-05;128;234;370567;343149;68.7;63.6
25;2021-09-06;631;1845;371198;344994;68.8;64.0
25;2021-09-07;489;1417;371687;346411;68.9;64.2
25;2021-09-08;624;2000;372311;348411;69.0;64.6
25;2021-09-09;424;1366;372735;349777;69.1;64.8
25;2021-09-10;840;2070;373575;351847;69.3;65.2
25;2021-09-11;372;1144;373947;352991;69.3;65.4
25;2021-09-12;110;231;374057;353222;69.3;65.5
25;2021-09-13;723;1340;374780;354562;69.5;65.7
25;2021-09-14;617;1323;375397;355885;69.6;66.0
25;2021-09-15;756;1478;376153;357363;69.7;66.2
25;2021-09-16;499;828;376652;358191;69.8;66.4
25;2021-09-17;740;1338;377392;359529;70.0;66.6
25;2021-09-18;319;869;377711;360398;70.0;66.8
25;2021-09-19;78;163;377789;360561;70.0;66.8
25;2021-09-20;453;740;378242;361301;70.1;67.0
25;2021-09-21;202;590;378444;361891;70.2;67.1
25;2021-09-22;450;1190;378894;363081;70.2;67.3
25;2021-09-23;252;456;379146;363537;70.3;67.4
25;2021-09-24;490;1052;379636;364589;70.4;67.6
25;2021-09-25;280;894;379916;365483;70.4;67.8
25;2021-09-26;8;5;379924;365488;70.4;67.8
25;2021-09-27;291;584;380215;366072;70.5;67.9
25;2021-09-28;209;441;380424;366513;70.5;67.9
25;2021-09-29;456;820;380880;367333;70.6;68.1
26;2020-12-27;0;0;0;0;0.0;0.0
26;2020-12-28;0;0;0;0;0.0;0.0
26;2020-12-29;0;0;0;0;0.0;0.0
26;2020-12-30;0;0;0;0;0.0;0.0
26;2020-12-31;0;0;0;0;0.0;0.0
26;2021-01-01;1;0;1;0;0.0;0.0
26;2021-01-02;0;0;1;0;0.0;0.0
26;2021-01-03;0;0;1;0;0.0;0.0
26;2021-01-04;0;0;1;0;0.0;0.0
26;2021-01-05;0;0;1;0;0.0;0.0
26;2021-01-06;0;0;1;0;0.0;0.0
26;2021-01-07;168;0;169;0;0.0;0.0
26;2021-01-08;125;0;294;0;0.1;0.0
26;2021-01-09;2;0;296;0;0.1;0.0
26;2021-01-10;0;0;296;0;0.1;0.0
26;2021-01-11;266;2;562;2;0.1;0.0
26;2021-01-12;176;1;738;3;0.1;0.0
26;2021-01-13;418;1;1156;4;0.2;0.0
26;2021-01-14;489;0;1645;4;0.3;0.0
26;2021-01-15;563;1;2208;5;0.4;0.0
26;2021-01-16;250;1;2458;6;0.5;0.0
26;2021-01-17;0;0;2458;6;0.5;0.0
26;2021-01-18;637;1;3095;7;0.6;0.0
26;2021-01-19;786;2;3881;9;0.7;0.0
26;2021-01-20;742;0;4623;9;0.9;0.0
26;2021-01-21;807;2;5430;11;1.0;0.0
26;2021-01-22;787;4;6217;15;1.2;0.0
26;2021-01-23;563;3;6780;18;1.3;0.0
26;2021-01-24;24;0;6804;18;1.3;0.0
26;2021-01-25;696;2;7500;20;1.4;0.0
26;2021-01-26;801;4;8301;24;1.6;0.0
26;2021-01-27;823;6;9124;30;1.8;0.0
26;2021-01-28;1330;104;10454;134;2.0;0.0
26;2021-01-29;970;63;11424;197;2.2;0.0
26;2021-01-30;606;5;12030;202;2.3;0.0
26;2021-01-31;24;0;12054;202;2.3;0.0
26;2021-02-01;709;175;12763;377;2.5;0.1
26;2021-02-02;1276;199;14039;576;2.7;0.1
26;2021-02-03;1265;245;15304;821;2.9;0.2
26;2021-02-04;985;401;16289;1222;3.1;0.2
26;2021-02-05;674;291;16963;1513;3.3;0.3
26;2021-02-06;407;170;17370;1683;3.3;0.3
26;2021-02-07;57;2;17427;1685;3.3;0.3
26;2021-02-08;545;351;17972;2036;3.5;0.4
26;2021-02-09;617;405;18589;2441;3.6;0.5
26;2021-02-10;665;288;19254;2729;3.7;0.5
26;2021-02-11;753;252;20007;2981;3.8;0.6
26;2021-02-12;591;387;20598;3368;4.0;0.6
26;2021-02-13;388;237;20986;3605;4.0;0.7
26;2021-02-14;36;0;21022;3605;4.0;0.7
26;2021-02-15;414;397;21436;4002;4.1;0.8
26;2021-02-16;294;437;21730;4439;4.2;0.9
26;2021-02-17;194;579;21924;5018;4.2;1.0
26;2021-02-18;337;754;22261;5772;4.3;1.1
26;2021-02-19;341;690;22602;6462;4.3;1.2
26;2021-02-20;95;371;22697;6833;4.4;1.3
26;2021-02-21;3;17;22700;6850;4.4;1.3
26;2021-02-22;144;530;22844;7380;4.4;1.4
26;2021-02-23;398;879;23242;8259;4.5;1.6
26;2021-02-24;346;1082;23588;9341;4.5;1.8
26;2021-02-25;746;912;24334;10253;4.7;2.0
26;2021-02-26;926;530;25260;10783;4.9;2.1
26;2021-02-27;278;416;25538;11199;4.9;2.2
26;2021-02-28;3;28;25541;11227;4.9;2.2
26;2021-03-01;458;566;25999;11793;5.0;2.3
26;2021-03-02;742;534;26741;12327;5.1;2.4
26;2021-03-03;731;603;27472;12930;5.3;2.5
26;2021-03-04;1045;504;28517;13434;5.5;2.6
26;2021-03-05;1710;473;30227;13907;5.8;2.7
26;2021-03-06;2772;427;32999;14334;6.3;2.8
26;2021-03-07;2989;218;35988;14552;6.9;2.8
26;2021-03-08;908;582;36896;15134;7.1;2.9
26;2021-03-09;1325;501;38221;15635;7.3;3.0
26;2021-03-10;1218;470;39439;16105;7.6;3.1
26;2021-03-11;1609;613;41048;16718;7.9;3.2
26;2021-03-12;2215;458;43263;17176;8.3;3.3
26;2021-03-13;1886;317;45149;17493;8.7;3.4
26;2021-03-14;69;39;45218;17532;8.7;3.4
26;2021-03-15;1653;245;46871;17777;9.0;3.4
26;2021-03-16;1232;510;48103;18287;9.2;3.5
26;2021-03-17;1369;295;49472;18582;9.5;3.6
26;2021-03-18;1587;277;51059;18859;9.8;3.6
26;2021-03-19;2444;342;53503;19201;10.3;3.7
26;2021-03-20;1290;152;54793;19353;10.5;3.7
26;2021-03-21;61;20;54854;19373;10.5;3.7
26;2021-03-22;1847;196;56701;19569;10.9;3.8
26;2021-03-23;2474;277;59175;19846;11.4;3.8
26;2021-03-24;2551;245;61726;20091;11.9;3.9
26;2021-03-25;3044;338;64770;20429;12.4;3.9
26;2021-03-26;3050;355;67820;20784;13.0;4.0
26;2021-03-27;1244;162;69064;20946;13.3;4.0
26;2021-03-28;94;7;69158;20953;13.3;4.0
26;2021-03-29;1908;406;71066;21359;13.7;4.1
26;2021-03-30;2383;547;73449;21906;14.1;4.2
26;2021-03-31;2229;582;75678;22488;14.5;4.3
26;2021-04-01;2279;779;77957;23267;15.0;4.5
26;2021-04-02;2213;987;80170;24254;15.4;4.7
26;2021-04-03;551;1199;80721;25453;15.5;4.9
26;2021-04-04;215;883;80936;26336;15.5;5.1
26;2021-04-05;557;52;81493;26388;15.7;5.1
26;2021-04-06;1486;832;82979;27220;15.9;5.2
26;2021-04-07;1793;894;84772;28114;16.3;5.4
26;2021-04-08;3008;937;87780;29051;16.9;5.6
26;2021-04-09;3414;1009;91194;30060;17.5;5.8
26;2021-04-10;1356;924;92550;30984;17.8;6.0
26;2021-04-11;88;35;92638;31019;17.8;6.0
26;2021-04-12;1713;1125;94351;32144;18.1;6.2
26;2021-04-13;2797;1450;97148;33594;18.7;6.5
26;2021-04-14;2206;1483;99354;35077;19.1;6.7
26;2021-04-15;2282;1589;101636;36666;19.5;7.0
26;2021-04-16;2272;1589;103908;38255;20.0;7.3
26;2021-04-17;1095;840;105003;39095;20.2;7.5
26;2021-04-18;36;52;105039;39147;20.2;7.5
26;2021-04-19;1547;1570;106586;40717;20.5;7.8
26;2021-04-20;1797;1724;108383;42441;20.8;8.2
26;2021-04-21;2012;1509;110395;43950;21.2;8.4
26;2021-04-22;2289;1599;112684;45549;21.6;8.8
26;2021-04-23;2011;1637;114695;47186;22.0;9.1
26;2021-04-24;1655;844;116350;48030;22.4;9.2
26;2021-04-25;629;97;116979;48127;22.5;9.2
26;2021-04-26;1377;1595;118356;49722;22.7;9.6
26;2021-04-27;1986;1684;120342;51406;23.1;9.9
26;2021-04-28;1865;1540;122207;52946;23.5;10.2
26;2021-04-29;2866;1892;125073;54838;24.0;10.5
26;2021-04-30;2626;1762;127699;56600;24.5;10.9
26;2021-05-01;1538;380;129237;56980;24.8;10.9
26;2021-05-02;1084;118;130321;57098;25.0;11.0
26;2021-05-03;2200;1786;132521;58884;25.5;11.3
26;2021-05-04;2614;2363;135135;61247;26.0;11.8
26;2021-05-05;2772;2196;137907;63443;26.5;12.2
26;2021-05-06;3321;2226;141228;65669;27.1;12.6
26;2021-05-07;2860;2257;144088;67926;27.7;13.0
26;2021-05-08;1960;619;146048;68545;28.1;13.2
26;2021-05-09;713;123;146761;68668;28.2;13.2
26;2021-05-10;3022;1827;149783;70495;28.8;13.5
26;2021-05-11;4445;2182;154228;72677;29.6;14.0
26;2021-05-12;4828;1694;159056;74371;30.6;14.3
26;2021-05-13;4363;617;163419;74988;31.4;14.4
26;2021-05-14;4640;1549;168059;76537;32.3;14.7
26;2021-05-15;4468;625;172527;77162;33.1;14.8
26;2021-05-16;3629;344;176156;77506;33.8;14.9
26;2021-05-17;3657;1486;179813;78992;34.5;15.2
26;2021-05-18;4474;1741;184287;80733;35.4;15.5
26;2021-05-19;4486;1450;188773;82183;36.3;15.8
26;2021-05-20;4685;1767;193458;83950;37.2;16.1
26;2021-05-21;4729;1798;198187;85748;38.1;16.5
26;2021-05-22;3189;690;201376;86438;38.7;16.6
26;2021-05-23;1597;183;202973;86621;39.0;16.6
26;2021-05-24;3788;742;206761;87363;39.7;16.8
26;2021-05-25;3591;2345;210352;89708;40.4;17.2
26;2021-05-26;4177;2271;214529;91979;41.2;17.7
26;2021-05-27;4211;2458;218740;94437;42.0;18.1
26;2021-05-28;3776;2766;222516;97203;42.7;18.7
26;2021-05-29;3088;1654;225604;98857;43.3;19.0
26;2021-05-30;320;70;225924;98927;43.4;19.0
26;2021-05-31;3081;1854;229005;100781;44.0;19.4
26;2021-06-01;3110;2308;232115;103089;44.6;19.8
26;2021-06-02;2868;2219;234983;105308;45.1;20.2
26;2021-06-03;2850;2487;237833;107795;45.7;20.7
26;2021-06-04;2658;2908;240491;110703;46.2;21.3
26;2021-06-05;1806;1694;242297;112397;46.5;21.6
26;2021-06-06;9;0;242306;112397;46.5;21.6
26;2021-06-07;2346;2430;244652;114827;47.0;22.1
26;2021-06-08;2453;2293;247105;117120;47.5;22.5
26;2021-06-09;2096;2387;249201;119507;47.9;23.0
26;2021-06-10;1981;2763;251182;122270;48.3;23.5
26;2021-06-11;1896;3273;253078;125543;48.6;24.1
26;2021-06-12;1219;1790;254297;127333;48.9;24.5
26;2021-06-13;97;214;254394;127547;48.9;24.5
26;2021-06-14;1415;3498;255809;131045;49.1;25.2
26;2021-06-15;1585;3963;257394;135008;49.4;25.9
26;2021-06-16;1784;3472;259178;138480;49.8;26.6
26;2021-06-17;1509;3166;260687;141646;50.1;27.2
26;2021-06-18;1797;4368;262484;146014;50.4;28.0
26;2021-06-19;933;3177;263417;149191;50.6;28.7
26;2021-06-20;263;876;263680;150067;50.7;28.8
26;2021-06-21;1005;4557;264685;154624;50.8;29.7
26;2021-06-22;1061;5120;265746;159744;51.1;30.7
26;2021-06-23;1168;5071;266914;164815;51.3;31.7
26;2021-06-24;1258;4544;268172;169359;51.5;32.5
26;2021-06-25;1014;5541;269186;174900;51.7;33.6
26;2021-06-26;662;3823;269848;178723;51.8;34.3
26;2021-06-27;299;1273;270147;179996;51.9;34.6
26;2021-06-28;778;4757;270925;184753;52.0;35.5
26;2021-06-29;1097;4955;272022;189708;52.3;36.4
26;2021-06-30;1411;4890;273433;194598;52.5;37.4
26;2021-07-01;1651;4388;275084;198986;52.8;38.2
26;2021-07-02;1333;5163;276417;204149;53.1;39.2
26;2021-07-03;769;3321;277186;207470;53.2;39.9
26;2021-07-04;331;633;277517;208103;53.3;40.0
26;2021-07-05;887;4673;278404;212776;53.5;40.9
26;2021-07-06;1266;4199;279670;216975;53.7;41.7
26;2021-07-07;1440;3796;281110;220771;54.0;42.4
26;2021-07-08;2387;3330;283497;224101;54.5;43.0
26;2021-07-09;1558;4787;285055;228888;54.8;44.0
26;2021-07-10;910;2913;285965;231801;54.9;44.5
26;2021-07-11;332;347;286297;232148;55.0;44.6
26;2021-07-12;1113;4218;287410;236366;55.2;45.4
26;2021-07-13;2301;4343;289711;240709;55.7;46.2
26;2021-07-14;1060;813;290771;241522;55.9;46.4
26;2021-07-15;3166;3655;293937;245177;56.5;47.1
26;2021-07-16;2999;3688;296936;248865;57.0;47.8
26;2021-07-17;1876;1814;298812;250679;57.4;48.2
26;2021-07-18;20;24;298832;250703;57.4;48.2
26;2021-07-19;2724;3264;301556;253967;57.9;48.8
26;2021-07-20;3706;3370;305262;257337;58.6;49.4
26;2021-07-21;3587;3086;308849;260423;59.3;50.0
26;2021-07-22;4120;2970;312969;263393;60.1;50.6
26;2021-07-23;3860;3401;316829;266794;60.9;51.3
26;2021-07-24;2344;1363;319173;268157;61.3;51.5
26;2021-07-25;608;97;319781;268254;61.4;51.5
26;2021-07-26;3428;2581;323209;270835;62.1;52.0
26;2021-07-27;4838;2621;328047;273456;63.0;52.5
26;2021-07-28;4533;2387;332580;275843;63.9;53.0
26;2021-07-29;3902;2896;336482;278739;64.6;53.5
26;2021-07-30;3484;2671;339966;281410;65.3;54.1
26;2021-07-31;1144;1008;341110;282418;65.5;54.3
26;2021-08-01;419;108;341529;282526;65.6;54.3
26;2021-08-02;2953;2362;344482;284888;66.2;54.7
26;2021-08-03;3298;2295;347780;287183;66.8;55.2
26;2021-08-04;3997;2016;351777;289199;67.6;55.6
26;2021-08-05;3153;2204;354930;291403;68.2;56.0
26;2021-08-06;3174;2638;358104;294041;68.8;56.5
26;2021-08-07;640;844;358744;294885;68.9;56.6
26;2021-08-08;29;13;358773;294898;68.9;56.7
26;2021-08-09;2191;3062;360964;297960;69.3;57.2
26;2021-08-10;2341;3049;363305;301009;69.8;57.8
26;2021-08-11;2077;2719;365382;303728;70.2;58.3
26;2021-08-12;1773;2587;367155;306315;70.5;58.8
26;2021-08-13;1742;2424;368897;308739;70.9;59.3
26;2021-08-14;272;872;369169;309611;70.9;59.5
26;2021-08-15;6;8;369175;309619;70.9;59.5
26;2021-08-16;1190;3291;370365;312910;71.1;60.1
26;2021-08-17;1520;3152;371885;316062;71.4;60.7
26;2021-08-18;1631;3375;373516;319437;71.8;61.4
26;2021-08-19;1552;3069;375068;322506;72.1;62.0
26;2021-08-20;1446;2980;376514;325486;72.3;62.5
26;2021-08-21;599;1090;377113;326576;72.4;62.7
26;2021-08-22;58;379;377171;326955;72.5;62.8
26;2021-08-23;1599;3621;378770;330576;72.8;63.5
26;2021-08-24;1748;3595;380518;334171;73.1;64.2
26;2021-08-25;1605;3659;382123;337830;73.4;64.9
26;2021-08-26;1493;3160;383616;340990;73.7;65.5
26;2021-08-27;1569;3606;385185;344596;74.0;66.2
26;2021-08-28;395;1104;385580;345700;74.1;66.4
26;2021-08-29;10;25;385590;345725;74.1;66.4
26;2021-08-30;1464;3440;387054;349165;74.4;67.1
26;2021-08-31;1286;3434;388340;352599;74.6;67.7
26;2021-09-01;1374;2815;389714;355414;74.9;68.3
26;2021-09-02;1114;2153;390828;357567;75.1;68.7
26;2021-09-03;1103;2753;391931;360320;75.3;69.2
26;2021-09-04;429;740;392360;361060;75.4;69.4
26;2021-09-05;25;24;392385;361084;75.4;69.4
26;2021-09-06;731;1779;393116;362863;75.5;69.7
26;2021-09-07;757;1695;393873;364558;75.7;70.0
26;2021-09-08;849;1927;394722;366485;75.8;70.4
26;2021-09-09;506;1606;395228;368091;75.9;70.7
26;2021-09-10;833;2057;396061;370148;76.1;71.1
26;2021-09-11;304;800;396365;370948;76.1;71.3
26;2021-09-12;1;5;396366;370953;76.1;71.3
26;2021-09-13;540;1730;396906;372683;76.2;71.6
26;2021-09-14;720;1699;397626;374382;76.4;71.9
26;2021-09-15;711;1828;398337;376210;76.5;72.3
26;2021-09-16;490;1006;398827;377216;76.6;72.5
26;2021-09-17;613;1731;399440;378947;76.7;72.8
26;2021-09-18;271;742;399711;379689;76.8;72.9
26;2021-09-19;4;13;399715;379702;76.8;72.9
26;2021-09-20;334;1095;400049;380797;76.8;73.2
26;2021-09-21;415;1012;400464;381809;76.9;73.3
26;2021-09-22;423;1519;400887;383328;77.0;73.6
26;2021-09-23;360;780;401247;384108;77.1;73.8
26;2021-09-24;440;1431;401687;385539;77.2;74.1
26;2021-09-25;179;595;401866;386134;77.2;74.2
26;2021-09-26;2;19;401868;386153;77.2;74.2
26;2021-09-27;312;811;402180;386964;77.3;74.3
26;2021-09-28;243;608;402423;387572;77.3;74.5
26;2021-09-29;381;1009;402804;388581;77.4;74.6
27;2020-12-27;2;0;2;0;0.0;0.0
27;2020-12-28;1;0;3;0;0.0;0.0
27;2020-12-29;2;0;5;0;0.0;0.0
27;2020-12-30;0;0;5;0;0.0;0.0
27;2020-12-31;0;0;5;0;0.0;0.0
27;2021-01-01;0;0;5;0;0.0;0.0
27;2021-01-02;0;0;5;0;0.0;0.0
27;2021-01-03;2;0;7;0;0.0;0.0
27;2021-01-04;0;0;7;0;0.0;0.0
27;2021-01-05;15;0;22;0;0.0;0.0
27;2021-01-06;161;0;183;0;0.0;0.0
27;2021-01-07;371;1;554;1;0.1;0.0
27;2021-01-08;443;0;997;1;0.2;0.0
27;2021-01-09;72;1;1069;2;0.2;0.0
27;2021-01-10;100;0;1169;2;0.2;0.0
27;2021-01-11;384;0;1553;2;0.3;0.0
27;2021-01-12;409;2;1962;4;0.3;0.0
27;2021-01-13;840;1;2802;5;0.5;0.0
27;2021-01-14;1629;24;4431;29;0.7;0.0
27;2021-01-15;1222;3;5653;32;0.9;0.0
27;2021-01-16;332;1;5985;33;1.0;0.0
27;2021-01-17;205;0;6190;33;1.0;0.0
27;2021-01-18;800;2;6990;35;1.2;0.0
27;2021-01-19;772;3;7762;38;1.3;0.0
27;2021-01-20;871;1;8633;39;1.4;0.0
27;2021-01-21;654;4;9287;43;1.5;0.0
27;2021-01-22;779;4;10066;47;1.7;0.0
27;2021-01-23;350;0;10416;47;1.7;0.0
27;2021-01-24;169;2;10585;49;1.8;0.0
27;2021-01-25;635;13;11220;62;1.9;0.0
27;2021-01-26;462;16;11682;78;1.9;0.0
27;2021-01-27;506;98;12188;176;2.0;0.0
27;2021-01-28;517;234;12705;410;2.1;0.1
27;2021-01-29;509;99;13214;509;2.2;0.1
27;2021-01-30;242;23;13456;532;2.2;0.1
27;2021-01-31;27;18;13483;550;2.2;0.1
27;2021-02-01;348;178;13831;728;2.3;0.1
27;2021-02-02;308;237;14139;965;2.4;0.2
27;2021-02-03;487;350;14626;1315;2.4;0.2
27;2021-02-04;717;795;15343;2110;2.6;0.4
27;2021-02-05;664;963;16007;3073;2.7;0.5
27;2021-02-06;126;190;16133;3263;2.7;0.5
27;2021-02-07;25;35;16158;3298;2.7;0.5
27;2021-02-08;312;299;16470;3597;2.7;0.6
27;2021-02-09;341;410;16811;4007;2.8;0.7
27;2021-02-10;305;445;17116;4452;2.8;0.7
27;2021-02-11;318;365;17434;4817;2.9;0.8
27;2021-02-12;230;436;17664;5253;2.9;0.9
27;2021-02-13;151;101;17815;5354;3.0;0.9
27;2021-02-14;6;64;17821;5418;3.0;0.9
27;2021-02-15;390;442;18211;5860;3.0;1.0
27;2021-02-16;296;522;18507;6382;3.1;1.1
27;2021-02-17;247;464;18754;6846;3.1;1.1
27;2021-02-18;363;493;19117;7339;3.2;1.2
27;2021-02-19;218;531;19335;7870;3.2;1.3
27;2021-02-20;129;202;19464;8072;3.2;1.3
27;2021-02-21;12;96;19476;8168;3.2;1.4
27;2021-02-22;482;446;19958;8614;3.3;1.4
27;2021-02-23;496;515;20454;9129;3.4;1.5
27;2021-02-24;543;530;20997;9659;3.5;1.6
27;2021-02-25;847;627;21844;10286;3.6;1.7
27;2021-02-26;955;600;22799;10886;3.8;1.8
27;2021-02-27;408;131;23207;11017;3.9;1.8
27;2021-02-28;174;24;23381;11041;3.9;1.8
27;2021-03-01;488;375;23869;11416;4.0;1.9
27;2021-03-02;765;282;24634;11698;4.1;1.9
27;2021-03-03;852;283;25486;11981;4.2;2.0
27;2021-03-04;887;206;26373;12187;4.4;2.0
27;2021-03-05;1304;203;27677;12390;4.6;2.1
27;2021-03-06;1637;100;29314;12490;4.9;2.1
27;2021-03-07;619;16;29933;12506;5.0;2.1
27;2021-03-08;1204;265;31137;12771;5.2;2.1
27;2021-03-09;1827;229;32964;13000;5.5;2.2
27;2021-03-10;2116;326;35080;13326;5.8;2.2
27;2021-03-11;2162;200;37242;13526;6.2;2.3
27;2021-03-12;2817;192;40059;13718;6.7;2.3
27;2021-03-13;1919;120;41978;13838;7.0;2.3
27;2021-03-14;655;16;42633;13854;7.1;2.3
27;2021-03-15;1556;212;44189;14066;7.4;2.3
27;2021-03-16;1489;236;45678;14302;7.6;2.4
27;2021-03-17;1856;357;47534;14659;7.9;2.4
27;2021-03-18;1687;344;49221;15003;8.2;2.5
27;2021-03-19;1834;161;51055;15164;8.5;2.5
27;2021-03-20;905;41;51960;15205;8.7;2.5
27;2021-03-21;258;3;52218;15208;8.7;2.5
27;2021-03-22;1235;534;53453;15742;8.9;2.6
27;2021-03-23;1627;439;55080;16181;9.2;2.7
27;2021-03-24;1523;469;56603;16650;9.4;2.8
27;2021-03-25;2165;505;58768;17155;9.8;2.9
27;2021-03-26;2531;433;61299;17588;10.2;2.9
27;2021-03-27;1568;200;62867;17788;10.5;3.0
27;2021-03-28;1149;49;64016;17837;10.7;3.0
27;2021-03-29;1375;820;65391;18657;10.9;3.1
27;2021-03-30;1391;835;66782;19492;11.1;3.2
27;2021-03-31;1486;866;68268;20358;11.4;3.4
27;2021-04-01;1956;809;70224;21167;11.7;3.5
27;2021-04-02;1999;1170;72223;22337;12.0;3.7
27;2021-04-03;1563;732;73786;23069;12.3;3.8
27;2021-04-04;978;176;74764;23245;12.4;3.9
27;2021-04-05;283;6;75047;23251;12.5;3.9
27;2021-04-06;1413;1791;76460;25042;12.7;4.2
27;2021-04-07;1323;1742;77783;26784;12.9;4.5
27;2021-04-08;1684;1677;79467;28461;13.2;4.7
27;2021-04-09;2947;1558;82414;30019;13.7;5.0
27;2021-04-10;2033;986;84447;31005;14.1;5.2
27;2021-04-11;946;211;85393;31216;14.2;5.2
27;2021-04-12;2434;1507;87827;32723;14.6;5.4
27;2021-04-13;2394;1547;90221;34270;15.0;5.7
27;2021-04-14;2085;1623;92306;35893;15.4;6.0
27;2021-04-15;1874;1658;94180;37551;15.7;6.3
27;2021-04-16;2751;1109;96931;38660;16.1;6.4
27;2021-04-17;2168;496;99099;39156;16.5;6.5
27;2021-04-18;452;16;99551;39172;16.6;6.5
27;2021-04-19;1712;1174;101263;40346;16.9;6.7
27;2021-04-20;2387;1299;103650;41645;17.3;6.9
27;2021-04-21;2210;1081;105860;42726;17.6;7.1
27;2021-04-22;2180;1417;108040;44143;18.0;7.3
27;2021-04-23;2446;1172;110486;45315;18.4;7.5
27;2021-04-24;3260;1147;113746;46462;18.9;7.7
27;2021-04-25;1130;1051;114876;47513;19.1;7.9
27;2021-04-26;1925;1147;116801;48660;19.4;8.1
27;2021-04-27;2528;1082;119329;49742;19.9;8.3
27;2021-04-28;2395;1310;121724;51052;20.3;8.5
27;2021-04-29;2491;1472;124215;52524;20.7;8.7
27;2021-04-30;2371;1604;126586;54128;21.1;9.0
27;2021-05-01;2638;890;129224;55018;21.5;9.2
27;2021-05-02;1952;897;131176;55915;21.8;9.3
27;2021-05-03;3063;872;134239;56787;22.3;9.5
27;2021-05-04;2781;1648;137020;58435;22.8;9.7
27;2021-05-05;2816;1649;139836;60084;23.3;10.0
27;2021-05-06;3184;1281;143020;61365;23.8;10.2
27;2021-05-07;3322;1979;146342;63344;24.4;10.5
27;2021-05-08;2805;1329;149147;64673;24.8;10.8
27;2021-05-09;1696;297;150843;64970;25.1;10.8
27;2021-05-10;2950;2269;153793;67239;25.6;11.2
27;2021-05-11;3358;1753;157151;68992;26.2;11.5
27;2021-05-12;3463;1725;160614;70717;26.7;11.8
27;2021-05-13;1892;254;162506;70971;27.1;11.8
27;2021-05-14;3884;1783;166390;72754;27.7;12.1
27;2021-05-15;6601;951;172991;73705;28.8;12.3
27;2021-05-16;3668;438;176659;74143;29.4;12.3
27;2021-05-17;2774;1161;179433;75304;29.9;12.5
27;2021-05-18;3845;1296;183278;76600;30.5;12.8
27;2021-05-19;3967;1154;187245;77754;31.2;12.9
27;2021-05-20;3874;1171;191119;78925;31.8;13.1
27;2021-05-21;3967;1789;195086;80714;32.5;13.4
27;2021-05-22;4367;802;199453;81516;33.2;13.6
27;2021-05-23;799;173;200252;81689;33.3;13.6
27;2021-05-24;1489;342;201741;82031;33.6;13.7
27;2021-05-25;3511;1606;205252;83637;34.2;13.9
27;2021-05-26;3855;1740;209107;85377;34.8;14.2
27;2021-05-27;3789;1478;212896;86855;35.4;14.5
27;2021-05-28;3403;2621;216299;89476;36.0;14.9
27;2021-05-29;4822;2293;221121;91769;36.8;15.3
27;2021-05-30;1117;247;222238;92016;37.0;15.3
27;2021-05-31;3465;2272;225703;94288;37.6;15.7
27;2021-06-01;3813;2239;229516;96527;38.2;16.1
27;2021-06-02;3341;2175;232857;98702;38.8;16.4
27;2021-06-03;4430;2115;237287;100817;39.5;16.8
27;2021-06-04;3603;2962;240890;103779;40.1;17.3
27;2021-06-05;3207;3347;244097;107126;40.6;17.8
27;2021-06-06;2004;1005;246101;108131;41.0;18.0
27;2021-06-07;2570;2353;248671;110484;41.4;18.4
27;2021-06-08;3126;2371;251797;112855;41.9;18.8
27;2021-06-09;2305;2470;254102;115325;42.3;19.2
27;2021-06-10;2431;2038;256533;117363;42.7;19.5
27;2021-06-11;2889;3766;259422;121129;43.2;20.2
27;2021-06-12;1982;4191;261404;125320;43.5;20.9
27;2021-06-13;1084;2686;262488;128006;43.7;21.3
27;2021-06-14;1995;3110;264483;131116;44.0;21.8
27;2021-06-15;2688;3018;267171;134134;44.5;22.3
27;2021-06-16;2501;3254;269672;137388;44.9;22.9
27;2021-06-17;2296;3288;271968;140676;45.3;23.4
27;2021-06-18;2746;4418;274714;145094;45.7;24.2
27;2021-06-19;1863;3392;276577;148486;46.0;24.7
27;2021-06-20;607;710;277184;149196;46.1;24.8
27;2021-06-21;1703;3495;278887;152691;46.4;25.4
27;2021-06-22;2385;3710;281272;156401;46.8;26.0
27;2021-06-23;2073;3568;283345;159969;47.2;26.6
27;2021-06-24;2256;3412;285601;163381;47.5;27.2
27;2021-06-25;1936;4459;287537;167840;47.9;27.9
27;2021-06-26;884;5352;288421;173192;48.0;28.8
27;2021-06-27;377;1427;288798;174619;48.1;29.1
27;2021-06-28;1129;3403;289927;178022;48.3;29.6
27;2021-06-29;1703;4363;291630;182385;48.5;30.4
27;2021-06-30;2115;4097;293745;186482;48.9;31.0
27;2021-07-01;2224;3908;295969;190390;49.3;31.7
27;2021-07-02;1589;4620;297558;195010;49.5;32.5
27;2021-07-03;1308;4773;298866;199783;49.8;33.3
27;2021-07-04;504;1403;299370;201186;49.8;33.5
27;2021-07-05;1417;3528;300787;204714;50.1;34.1
27;2021-07-06;1365;4180;302152;208894;50.3;34.8
27;2021-07-07;1756;4900;303908;213794;50.6;35.6
27;2021-07-08;2089;4350;305997;218144;50.9;36.3
27;2021-07-09;1984;5287;307981;223431;51.3;37.2
27;2021-07-10;1167;4179;309148;227610;51.5;37.9
27;2021-07-11;426;1139;309574;228749;51.5;38.1
27;2021-07-12;1253;4372;310827;233121;51.7;38.8
27;2021-07-13;2759;5345;313586;238466;52.2;39.7
27;2021-07-14;1518;1753;315104;240219;52.5;40.0
27;2021-07-15;3033;5464;318137;245683;53.0;40.9
27;2021-07-16;3820;5286;321957;250969;53.6;41.8
27;2021-07-17;2732;3878;324689;254847;54.1;42.4
27;2021-07-18;552;1266;325241;256113;54.1;42.6
27;2021-07-19;3687;3787;328928;259900;54.8;43.3
27;2021-07-20;3459;3591;332387;263491;55.3;43.9
27;2021-07-21;4251;3900;336638;267391;56.0;44.5
27;2021-07-22;4750;3714;341388;271105;56.8;45.1
27;2021-07-23;3592;3398;344980;274503;57.4;45.7
27;2021-07-24;3114;2325;348094;276828;57.9;46.1
27;2021-07-25;493;545;348587;277373;58.0;46.2
27;2021-07-26;3071;3175;351658;280548;58.5;46.7
27;2021-07-27;3596;3101;355254;283649;59.1;47.2
27;2021-07-28;3592;3241;358846;286890;59.7;47.8
27;2021-07-29;4590;3510;363436;290400;60.5;48.3
27;2021-07-30;3816;3142;367252;293542;61.1;48.9
27;2021-07-31;3062;2585;370314;296127;61.6;49.3
27;2021-08-01;538;498;370852;296625;61.7;49.4
27;2021-08-02;3319;2584;374171;299209;62.3;49.8
27;2021-08-03;3427;2770;377598;301979;62.9;50.3
27;2021-08-04;3058;2334;380656;304313;63.4;50.7
27;2021-08-05;2676;2358;383332;306671;63.8;51.1
27;2021-08-06;3270;3244;386602;309915;64.4;51.6
27;2021-08-07;1802;2553;388404;312468;64.7;52.0
27;2021-08-08;218;197;388622;312665;64.7;52.1
27;2021-08-09;2210;2807;390832;315472;65.1;52.5
27;2021-08-10;2811;3511;393643;318983;65.5;53.1
27;2021-08-11;2637;3099;396280;322082;66.0;53.6
27;2021-08-12;2363;3905;398643;325987;66.4;54.3
27;2021-08-13;1745;2571;400388;328558;66.7;54.7
27;2021-08-14;1163;2889;401551;331447;66.8;55.2
27;2021-08-15;18;23;401569;331470;66.9;55.2
27;2021-08-16;1810;3816;403379;335286;67.2;55.8
27;2021-08-17;2046;3441;405425;338727;67.5;56.4
27;2021-08-18;1456;2986;406881;341713;67.7;56.9
27;2021-08-19;1711;3356;408592;345069;68.0;57.4
27;2021-08-20;1636;3440;410228;348509;68.3;58.0
27;2021-08-21;987;2842;411215;351351;68.5;58.5
27;2021-08-22;184;162;411399;351513;68.5;58.5
27;2021-08-23;1080;4007;412479;355520;68.7;59.2
27;2021-08-24;1440;3969;413919;359489;68.9;59.8
27;2021-08-25;1718;3414;415637;362903;69.2;60.4
27;2021-08-26;1156;2932;416793;365835;69.4;60.9
27;2021-08-27;1261;3218;418054;369053;69.6;61.4
27;2021-08-28;911;2867;418965;371920;69.7;61.9
27;2021-08-29;87;135;419052;372055;69.8;61.9
27;2021-08-30;906;3315;419958;375370;69.9;62.5
27;2021-08-31;1224;3205;421182;378575;70.1;63.0
27;2021-09-01;995;3177;422177;381752;70.3;63.6
27;2021-09-02;873;2489;423050;384241;70.4;64.0
27;2021-09-03;847;2469;423897;386710;70.6;64.4
27;2021-09-04;727;2086;424624;388796;70.7;64.7
27;2021-09-05;36;162;424660;388958;70.7;64.8
27;2021-09-06;536;1804;425196;390762;70.8;65.1
27;2021-09-07;697;2367;425893;393129;70.9;65.4
27;2021-09-08;765;2402;426658;395531;71.0;65.8
27;2021-09-09;677;1932;427335;397463;71.1;66.2
27;2021-09-10;891;2372;428226;399835;71.3;66.6
27;2021-09-11;602;1944;428828;401779;71.4;66.9
27;2021-09-12;42;184;428870;401963;71.4;66.9
27;2021-09-13;351;1335;429221;403298;71.5;67.1
27;2021-09-14;593;1474;429814;404772;71.6;67.4
27;2021-09-15;552;1668;430366;406440;71.6;67.7
27;2021-09-16;594;1131;430960;407571;71.7;67.9
27;2021-09-17;789;1289;431749;408860;71.9;68.1
27;2021-09-18;365;1248;432114;410108;71.9;68.3
27;2021-09-19;56;161;432170;410269;71.9;68.3
27;2021-09-20;260;773;432430;411042;72.0;68.4
27;2021-09-21;428;961;432858;412003;72.1;68.6
27;2021-09-22;300;1029;433158;413032;72.1;68.8
27;2021-09-23;343;758;433501;413790;72.2;68.9
27;2021-09-24;575;1244;434076;415034;72.3;69.1
27;2021-09-25;292;1122;434368;416156;72.3;69.3
27;2021-09-26;4;12;434372;416168;72.3;69.3
27;2021-09-27;190;470;434562;416638;72.3;69.4
27;2021-09-28;313;724;434875;417362;72.4;69.5
27;2021-09-29;229;723;435104;418085;72.4;69.6
28;2020-12-27;0;0;0;0;0.0;0.0
28;2020-12-28;0;0;0;0;0.0;0.0
28;2020-12-29;0;0;0;0;0.0;0.0
28;2020-12-30;0;0;0;0;0.0;0.0
28;2020-12-31;0;0;0;0;0.0;0.0
28;2021-01-01;1;0;1;0;0.0;0.0
28;2021-01-02;0;0;1;0;0.0;0.0
28;2021-01-03;0;0;1;0;0.0;0.0
28;2021-01-04;0;0;1;0;0.0;0.0
28;2021-01-05;5;0;6;0;0.0;0.0
28;2021-01-06;84;0;90;0;0.0;0.0
28;2021-01-07;102;0;192;0;0.0;0.0
28;2021-01-08;134;2;326;2;0.1;0.0
28;2021-01-09;79;0;405;2;0.1;0.0
28;2021-01-10;1;0;406;2;0.1;0.0
28;2021-01-11;204;0;610;2;0.1;0.0
28;2021-01-12;265;1;875;3;0.2;0.0
28;2021-01-13;398;3;1273;6;0.3;0.0
28;2021-01-14;451;5;1724;11;0.4;0.0
28;2021-01-15;374;3;2098;14;0.5;0.0
28;2021-01-16;206;2;2304;16;0.5;0.0
28;2021-01-17;21;0;2325;16;0.5;0.0
28;2021-01-18;372;2;2697;18;0.6;0.0
28;2021-01-19;503;4;3200;22;0.7;0.0
28;2021-01-20;636;1;3836;23;0.9;0.0
28;2021-01-21;796;3;4632;26;1.1;0.0
28;2021-01-22;478;1;5110;27;1.2;0.0
28;2021-01-23;353;0;5463;27;1.3;0.0
28;2021-01-24;1;0;5464;27;1.3;0.0
28;2021-01-25;456;4;5920;31;1.4;0.0
28;2021-01-26;717;4;6637;35;1.5;0.0
28;2021-01-27;1211;50;7848;85;1.8;0.0
28;2021-01-28;1587;89;9435;174;2.2;0.0
28;2021-01-29;896;87;10331;261;2.4;0.1
28;2021-01-30;248;46;10579;307;2.5;0.1
28;2021-01-31;2;22;10581;329;2.5;0.1
28;2021-02-01;325;115;10906;444;2.5;0.1
28;2021-02-02;368;197;11274;641;2.6;0.1
28;2021-02-03;473;247;11747;888;2.7;0.2
28;2021-02-04;525;263;12272;1151;2.9;0.3
28;2021-02-05;436;210;12708;1361;3.0;0.3
28;2021-02-06;201;128;12909;1489;3.0;0.3
28;2021-02-07;0;0;12909;1489;3.0;0.3
28;2021-02-08;331;207;13240;1696;3.1;0.4
28;2021-02-09;281;262;13521;1958;3.1;0.5
28;2021-02-10;443;324;13964;2282;3.3;0.5
28;2021-02-11;562;412;14526;2694;3.4;0.6
28;2021-02-12;453;332;14979;3026;3.5;0.7
28;2021-02-13;181;157;15160;3183;3.5;0.7
28;2021-02-14;0;2;15160;3185;3.5;0.7
28;2021-02-15;280;341;15440;3526;3.6;0.8
28;2021-02-16;396;594;15836;4120;3.7;1.0
28;2021-02-17;584;1036;16420;5156;3.8;1.2
28;2021-02-18;665;1295;17085;6451;4.0;1.5
28;2021-02-19;548;661;17633;7112;4.1;1.7
28;2021-02-20;114;116;17747;7228;4.1;1.7
28;2021-02-21;7;32;17754;7260;4.1;1.7
28;2021-02-22;223;424;17977;7684;4.2;1.8
28;2021-02-23;203;310;18180;7994;4.2;1.9
28;2021-02-24;244;378;18424;8372;4.3;1.9
28;2021-02-25;574;344;18998;8716;4.4;2.0
28;2021-02-26;764;307;19762;9023;4.6;2.1
28;2021-02-27;265;74;20027;9097;4.7;2.1
28;2021-02-28;23;17;20050;9114;4.7;2.1
28;2021-03-01;292;180;20342;9294;4.7;2.2
28;2021-03-02;396;245;20738;9539;4.8;2.2
28;2021-03-03;369;339;21107;9878;4.9;2.3
28;2021-03-04;720;426;21827;10304;5.1;2.4
28;2021-03-05;1319;368;23146;10672;5.4;2.5
28;2021-03-06;1998;81;25144;10753;5.9;2.5
28;2021-03-07;974;31;26118;10784;6.1;2.5
28;2021-03-08;398;262;26516;11046;6.2;2.6
28;2021-03-09;981;329;27497;11375;6.4;2.6
28;2021-03-10;1358;486;28855;11861;6.7;2.8
28;2021-03-11;1535;663;30390;12524;7.1;2.9
28;2021-03-12;2255;606;32645;13130;7.6;3.1
28;2021-03-13;1235;113;33880;13243;7.9;3.1
28;2021-03-14;518;17;34398;13260;8.0;3.1
28;2021-03-15;755;225;35153;13485;8.2;3.1
28;2021-03-16;716;217;35869;13702;8.4;3.2
28;2021-03-17;746;283;36615;13985;8.5;3.3
28;2021-03-18;1203;265;37818;14250;8.8;3.3
28;2021-03-19;1558;321;39376;14571;9.2;3.4
28;2021-03-20;639;21;40015;14592;9.3;3.4
28;2021-03-21;29;8;40044;14600;9.3;3.4
28;2021-03-22;766;317;40810;14917;9.5;3.5
28;2021-03-23;1027;189;41837;15106;9.7;3.5
28;2021-03-24;1315;274;43152;15380;10.0;3.6
28;2021-03-25;1796;286;44948;15666;10.5;3.6
28;2021-03-26;2084;346;47032;16012;11.0;3.7
28;2021-03-27;402;38;47434;16050;11.0;3.7
28;2021-03-28;12;0;47446;16050;11.0;3.7
28;2021-03-29;1139;349;48585;16399;11.3;3.8
28;2021-03-30;1711;252;50296;16651;11.7;3.9
28;2021-03-31;2018;474;52314;17125;12.2;4.0
28;2021-04-01;1796;586;54110;17711;12.6;4.1
28;2021-04-02;1583;1315;55693;19026;13.0;4.4
28;2021-04-03;607;1070;56300;20096;13.1;4.7
28;2021-04-04;33;299;56333;20395;13.1;4.7
28;2021-04-05;40;3;56373;20398;13.1;4.8
28;2021-04-06;1221;459;57594;20857;13.4;4.9
28;2021-04-07;1890;1005;59484;21862;13.9;5.1
28;2021-04-08;2087;1070;61571;22932;14.3;5.3
28;2021-04-09;3230;916;64801;23848;15.1;5.6
28;2021-04-10;1581;201;66382;24049;15.5;5.6
28;2021-04-11;141;450;66523;24499;15.5;5.7
28;2021-04-12;1673;558;68196;25057;15.9;5.8
28;2021-04-13;1875;673;70071;25730;16.3;6.0
28;2021-04-14;2771;903;72842;26633;17.0;6.2
28;2021-04-15;2557;1147;75399;27780;17.6;6.5
28;2021-04-16;2554;806;77953;28586;18.2;6.7
28;2021-04-17;2309;133;80262;28719;18.7;6.7
28;2021-04-18;45;8;80307;28727;18.7;6.7
28;2021-04-19;1576;648;81883;29375;19.1;6.8
28;2021-04-20;1836;596;83719;29971;19.5;7.0
28;2021-04-21;2680;962;86399;30933;20.1;7.2
28;2021-04-22;1782;1218;88181;32151;20.5;7.5
28;2021-04-23;2325;1103;90506;33254;21.1;7.7
28;2021-04-24;3656;137;94162;33391;21.9;7.8
28;2021-04-25;1012;37;95174;33428;22.2;7.8
28;2021-04-26;1331;929;96505;34357;22.5;8.0
28;2021-04-27;1436;1268;97941;35625;22.8;8.3
28;2021-04-28;2373;1828;100314;37453;23.4;8.7
28;2021-04-29;2130;1510;102444;38963;23.9;9.1
28;2021-04-30;2973;1225;105417;40188;24.5;9.4
28;2021-05-01;127;115;105544;40303;24.6;9.4
28;2021-05-02;2;65;105546;40368;24.6;9.4
28;2021-05-03;1048;1016;106594;41384;24.8;9.6
28;2021-05-04;1359;1671;107953;43055;25.1;10.0
28;2021-05-05;2830;1649;110783;44704;25.8;10.4
28;2021-05-06;2456;1473;113239;46177;26.4;10.8
28;2021-05-07;2311;1923;115550;48100;26.9;11.2
28;2021-05-08;1078;112;116628;48212;27.2;11.2
28;2021-05-09;105;610;116733;48822;27.2;11.4
28;2021-05-10;1308;1891;118041;50713;27.5;11.8
28;2021-05-11;2024;2328;120065;53041;28.0;12.4
28;2021-05-12;2620;3232;122685;56273;28.6;13.1
28;2021-05-13;289;451;122974;56724;28.6;13.2
28;2021-05-14;1900;1612;124874;58336;29.1;13.6
28;2021-05-15;1433;1673;126307;60009;29.4;14.0
28;2021-05-16;1986;131;128293;60140;29.9;14.0
28;2021-05-17;2874;1485;131167;61625;30.5;14.4
28;2021-05-18;3382;1378;134549;63003;31.3;14.7
28;2021-05-19;5090;1279;139639;64282;32.5;15.0
28;2021-05-20;4149;1231;143788;65513;33.5;15.3
28;2021-05-21;3464;1579;147252;67092;34.3;15.6
28;2021-05-22;729;1161;147981;68253;34.5;15.9
28;2021-05-23;1956;137;149937;68390;34.9;15.9
28;2021-05-24;1428;395;151365;68785;35.2;16.0
28;2021-05-25;1876;1403;153241;70188;35.7;16.3
28;2021-05-26;2765;1341;156006;71529;36.3;16.7
28;2021-05-27;2754;1233;158760;72762;37.0;16.9
28;2021-05-28;3080;1726;161840;74488;37.7;17.3
28;2021-05-29;1868;872;163708;75360;38.1;17.5
28;2021-05-30;16;47;163724;75407;38.1;17.6
28;2021-05-31;2014;934;165738;76341;38.6;17.8
28;2021-06-01;2133;1653;167871;77994;39.1;18.2
28;2021-06-02;2077;2457;169948;80451;39.6;18.7
28;2021-06-03;2498;1560;172446;82011;40.2;19.1
28;2021-06-04;2608;2353;175054;84364;40.8;19.6
28;2021-06-05;1909;2519;176963;86883;41.2;20.2
28;2021-06-06;1060;1046;178023;87929;41.5;20.5
28;2021-06-07;3575;1574;181598;89503;42.3;20.8
28;2021-06-08;3196;1519;184794;91022;43.0;21.2
28;2021-06-09;3675;2123;188469;93145;43.9;21.7
28;2021-06-10;3140;1257;191609;94402;44.6;22.0
28;2021-06-11;3791;2129;195400;96531;45.5;22.5
28;2021-06-12;1304;560;196704;97091;45.8;22.6
28;2021-06-13;385;108;197089;97199;45.9;22.6
28;2021-06-14;2207;1992;199296;99191;46.4;23.1
28;2021-06-15;2092;2225;201388;101416;46.9;23.6
28;2021-06-16;2508;3972;203896;105388;47.5;24.5
28;2021-06-17;1940;3135;205836;108523;47.9;25.3
28;2021-06-18;2487;3788;208323;112311;48.5;26.2
28;2021-06-19;776;1612;209099;113923;48.7;26.5
28;2021-06-20;23;24;209122;113947;48.7;26.5
28;2021-06-21;1682;1989;210804;115936;49.1;27.0
28;2021-06-22;1372;2106;212176;118042;49.4;27.5
28;2021-06-23;1782;3164;213958;121206;49.8;28.2
28;2021-06-24;733;928;214691;122134;50.0;28.4
28;2021-06-25;1888;3025;216579;125159;50.4;29.1
28;2021-06-26;310;2110;216889;127269;50.5;29.6
28;2021-06-27;588;1284;217477;128553;50.6;29.9
28;2021-06-28;1225;3654;218702;132207;50.9;30.8
28;2021-06-29;1342;3790;220044;135997;51.2;31.7
28;2021-06-30;1493;4261;221537;140258;51.6;32.7
28;2021-07-01;1277;3500;222814;143758;51.9;33.5
28;2021-07-02;1312;4651;224126;148409;52.2;34.6
28;2021-07-03;1131;2370;225257;150779;52.5;35.1
28;2021-07-04;145;1325;225402;152104;52.5;35.4
28;2021-07-05;1360;2511;226762;154615;52.8;36.0
28;2021-07-06;1508;2868;228270;157483;53.2;36.7
28;2021-07-07;1636;4140;229906;161623;53.5;37.6
28;2021-07-08;1467;3240;231373;164863;53.9;38.4
28;2021-07-09;1393;4516;232766;169379;54.2;39.4
28;2021-07-10;528;2205;233294;171584;54.3;40.0
28;2021-07-11;2;1;233296;171585;54.3;40.0
28;2021-07-12;1526;3928;234822;175513;54.7;40.9
28;2021-07-13;2261;4143;237083;179656;55.2;41.8
28;2021-07-14;1328;1395;238411;181051;55.5;42.2
28;2021-07-15;2986;3974;241397;185025;56.2;43.1
28;2021-07-16;2444;4750;243841;189775;56.8;44.2
28;2021-07-17;1263;2430;245104;192205;57.1;44.8
28;2021-07-18;368;945;245472;193150;57.2;45.0
28;2021-07-19;1806;4331;247278;197481;57.6;46.0
28;2021-07-20;2476;4090;249754;201571;58.2;46.9
28;2021-07-21;2959;4285;252713;205856;58.8;47.9
28;2021-07-22;3670;3430;256383;209286;59.7;48.7
28;2021-07-23;2960;3996;259343;213282;60.4;49.7
28;2021-07-24;1715;1484;261058;214766;60.8;50.0
28;2021-07-25;67;60;261125;214826;60.8;50.0
28;2021-07-26;2930;3386;264055;218212;61.5;50.8
28;2021-07-27;3885;2621;267940;220833;62.4;51.4
28;2021-07-28;3947;2743;271887;223576;63.3;52.1
28;2021-07-29;4466;2091;276353;225667;64.4;52.6
28;2021-07-30;3824;2845;280177;228512;65.2;53.2
28;2021-07-31;763;821;280940;229333;65.4;53.4
28;2021-08-01;378;65;281318;229398;65.5;53.4
28;2021-08-02;1793;1520;283111;230918;65.9;53.8
28;2021-08-03;2684;2166;285795;233084;66.6;54.3
28;2021-08-04;1932;2300;287727;235384;67.0;54.8
28;2021-08-05;1663;1730;289390;237114;67.4;55.2
28;2021-08-06;1618;1969;291008;239083;67.8;55.7
28;2021-08-07;798;1001;291806;240084;68.0;55.9
28;2021-08-08;22;33;291828;240117;68.0;55.9
28;2021-08-09;1388;1102;293216;241219;68.3;56.2
28;2021-08-10;1714;2027;294930;243246;68.7;56.6
28;2021-08-11;1273;1572;296203;244818;69.0;57.0
28;2021-08-12;1164;1881;297367;246699;69.2;57.4
28;2021-08-13;1321;1649;298688;248348;69.6;57.8
28;2021-08-14;656;841;299344;249189;69.7;58.0
28;2021-08-15;264;59;299608;249248;69.8;58.0
28;2021-08-16;862;2145;300470;251393;70.0;58.5
28;2021-08-17;1126;2798;301596;254191;70.2;59.2
28;2021-08-18;891;2412;302487;256603;70.4;59.8
28;2021-08-19;888;2615;303375;259218;70.6;60.4
28;2021-08-20;939;2753;304314;261971;70.9;61.0
28;2021-08-21;381;1001;304695;262972;71.0;61.2
28;2021-08-22;9;31;304704;263003;71.0;61.2
28;2021-08-23;1041;2148;305745;265151;71.2;61.7
28;2021-08-24;867;2582;306612;267733;71.4;62.3
28;2021-08-25;1075;2208;307687;269941;71.7;62.9
28;2021-08-26;701;1817;308388;271758;71.8;63.3
28;2021-08-27;749;2368;309137;274126;72.0;63.8
28;2021-08-28;524;1096;309661;275222;72.1;64.1
28;2021-08-29;7;23;309668;275245;72.1;64.1
28;2021-08-30;994;2184;310662;277429;72.3;64.6
28;2021-08-31;798;2248;311460;279677;72.5;65.1
28;2021-09-01;747;2603;312207;282280;72.7;65.7
28;2021-09-02;542;2112;312749;284392;72.8;66.2
28;2021-09-03;664;2563;313413;286955;73.0;66.8
28;2021-09-04;584;2603;313997;289558;73.1;67.4
28;2021-09-05;209;247;314206;289805;73.2;67.5
28;2021-09-06;404;1619;314610;291424;73.3;67.9
28;2021-09-07;352;1452;314962;292876;73.3;68.2
28;2021-09-08;544;1588;315506;294464;73.5;68.6
28;2021-09-09;318;1143;315824;295607;73.5;68.8
28;2021-09-10;586;1659;316410;297266;73.7;69.2
28;2021-09-11;298;1329;316708;298595;73.8;69.5
28;2021-09-12;39;32;316747;298627;73.8;69.5
28;2021-09-13;312;1032;317059;299659;73.8;69.8
28;2021-09-14;321;1271;317380;300930;73.9;70.1
28;2021-09-15;525;1023;317905;301953;74.0;70.3
28;2021-09-16;247;686;318152;302639;74.1;70.5
28;2021-09-17;299;1046;318451;303685;74.2;70.7
28;2021-09-18;124;237;318575;303922;74.2;70.8
28;2021-09-19;7;17;318582;303939;74.2;70.8
28;2021-09-20;154;458;318736;304397;74.2;70.9
28;2021-09-21;392;934;319128;305331;74.3;71.1
28;2021-09-22;328;1066;319456;306397;74.4;71.4
28;2021-09-23;189;505;319645;306902;74.4;71.5
28;2021-09-24;251;969;319896;307871;74.5;71.7
28;2021-09-25;95;324;319991;308195;74.5;71.8
28;2021-09-26;21;34;320012;308229;74.5;71.8
28;2021-09-27;166;665;320178;308894;74.6;71.9
28;2021-09-28;168;439;320346;309333;74.6;72.0
28;2021-09-29;344;686;320690;310019;74.7;72.2
29;2020-12-27;0;0;0;0;0.0;0.0
29;2020-12-28;1;0;1;0;0.0;0.0
29;2020-12-29;0;0;1;0;0.0;0.0
29;2020-12-30;0;0;1;0;0.0;0.0
29;2020-12-31;0;0;1;0;0.0;0.0
29;2021-01-01;3;0;4;0;0.0;0.0
29;2021-01-02;0;0;4;0;0.0;0.0
29;2021-01-03;1;0;5;0;0.0;0.0
29;2021-01-04;32;0;37;0;0.0;0.0
29;2021-01-05;32;0;69;0;0.0;0.0
29;2021-01-06;43;0;112;0;0.0;0.0
29;2021-01-07;138;0;250;0;0.0;0.0
29;2021-01-08;408;0;658;0;0.1;0.0
29;2021-01-09;2;0;660;0;0.1;0.0
29;2021-01-10;2;0;662;0;0.1;0.0
29;2021-01-11;667;0;1329;0;0.1;0.0
29;2021-01-12;1121;0;2450;0;0.3;0.0
29;2021-01-13;1101;1;3551;1;0.4;0.0
29;2021-01-14;894;4;4445;5;0.5;0.0
29;2021-01-15;1221;6;5666;11;0.6;0.0
29;2021-01-16;168;1;5834;12;0.6;0.0
29;2021-01-17;111;1;5945;13;0.7;0.0
29;2021-01-18;842;3;6787;16;0.7;0.0
29;2021-01-19;1314;1;8101;17;0.9;0.0
29;2021-01-20;2393;2;10494;19;1.2;0.0
29;2021-01-21;5659;8;16153;27;1.8;0.0
29;2021-01-22;3785;4;19938;31;2.2;0.0
29;2021-01-23;538;0;20476;31;2.3;0.0
29;2021-01-24;200;1;20676;32;2.3;0.0
29;2021-01-25;575;7;21251;39;2.3;0.0
29;2021-01-26;951;34;22202;73;2.4;0.0
29;2021-01-27;1286;51;23488;124;2.6;0.0
29;2021-01-28;803;134;24291;258;2.7;0.0
29;2021-01-29;779;195;25070;453;2.8;0.0
29;2021-01-30;281;4;25351;457;2.8;0.1
29;2021-01-31;80;5;25431;462;2.8;0.1
29;2021-02-01;429;370;25860;832;2.9;0.1
29;2021-02-02;879;661;26739;1493;2.9;0.2
29;2021-02-03;810;808;27549;2301;3.0;0.3
29;2021-02-04;867;603;28416;2904;3.1;0.3
29;2021-02-05;675;570;29091;3474;3.2;0.4
29;2021-02-06;249;86;29340;3560;3.2;0.4
29;2021-02-07;78;91;29418;3651;3.2;0.4
29;2021-02-08;384;420;29802;4071;3.3;0.4
29;2021-02-09;864;813;30666;4884;3.4;0.5
29;2021-02-10;1150;945;31816;5829;3.5;0.6
29;2021-02-11;1797;3851;33613;9680;3.7;1.1
29;2021-02-12;2326;2429;35939;12109;4.0;1.3
29;2021-02-13;639;388;36578;12497;4.0;1.4
29;2021-02-14;12;201;36590;12698;4.0;1.4
29;2021-02-15;267;763;36857;13461;4.1;1.5
29;2021-02-16;887;869;37744;14330;4.2;1.6
29;2021-02-17;800;648;38544;14978;4.3;1.7
29;2021-02-18;1530;696;40074;15674;4.4;1.7
29;2021-02-19;1417;797;41491;16471;4.6;1.8
29;2021-02-20;204;268;41695;16739;4.6;1.8
29;2021-02-21;162;139;41857;16878;4.6;1.9
29;2021-02-22;773;442;42630;17320;4.7;1.9
29;2021-02-23;1270;704;43900;18024;4.8;2.0
29;2021-02-24;1473;628;45373;18652;5.0;2.1
29;2021-02-25;2511;695;47884;19347;5.3;2.1
29;2021-02-26;2678;557;50562;19904;5.6;2.2
29;2021-02-27;1285;209;51847;20113;5.7;2.2
29;2021-02-28;200;56;52047;20169;5.7;2.2
29;2021-03-01;945;374;52992;20543;5.8;2.3
29;2021-03-02;1815;651;54807;21194;6.0;2.3
29;2021-03-03;2095;857;56902;22051;6.3;2.4
29;2021-03-04;2843;1400;59745;23451;6.6;2.6
29;2021-03-05;3539;1537;63284;24988;7.0;2.8
29;2021-03-06;2000;397;65284;25385;7.2;2.8
29;2021-03-07;412;73;65696;25458;7.2;2.8
29;2021-03-08;1274;518;66970;25976;7.4;2.9
29;2021-03-09;2603;866;69573;26842;7.7;3.0
29;2021-03-10;2427;777;72000;27619;7.9;3.0
29;2021-03-11;4520;907;76520;28526;8.4;3.1
29;2021-03-12;5272;893;81792;29419;9.0;3.2
29;2021-03-13;2825;384;84617;29803;9.3;3.3
29;2021-03-14;367;3;84984;29806;9.4;3.3
29;2021-03-15;2050;266;87034;30072;9.6;3.3
29;2021-03-16;1825;727;88859;30799;9.8;3.4
29;2021-03-17;1862;692;90721;31491;10.0;3.5
29;2021-03-18;1866;1019;92587;32510;10.2;3.6
29;2021-03-19;3270;870;95857;33380;10.6;3.7
29;2021-03-20;1914;214;97771;33594;10.8;3.7
29;2021-03-21;132;11;97903;33605;10.8;3.7
29;2021-03-22;1647;550;99550;34155;11.0;3.8
29;2021-03-23;3442;1028;102992;35183;11.4;3.9
29;2021-03-24;3781;1017;106773;36200;11.8;4.0
29;2021-03-25;4821;1061;111594;37261;12.3;4.1
29;2021-03-26;5423;1157;117017;38418;12.9;4.2
29;2021-03-27;2429;330;119446;38748;13.2;4.3
29;2021-03-28;198;50;119644;38798;13.2;4.3
29;2021-03-29;2042;813;121686;39611;13.4;4.4
29;2021-03-30;3977;1325;125663;40936;13.9;4.5
29;2021-03-31;3936;1153;129599;42089;14.3;4.6
29;2021-04-01;5029;1140;134628;43229;14.9;4.8
29;2021-04-02;4765;1167;139393;44396;15.4;4.9
29;2021-04-03;2500;535;141893;44931;15.7;5.0
29;2021-04-04;146;33;142039;44964;15.7;5.0
29;2021-04-05;972;330;143011;45294;15.8;5.0
29;2021-04-06;3200;1234;146211;46528;16.1;5.1
29;2021-04-07;3653;940;149864;47468;16.5;5.2
29;2021-04-08;5285;2053;155149;49521;17.1;5.5
29;2021-04-09;6759;1562;161908;51083;17.9;5.6
29;2021-04-10;3503;710;165411;51793;18.2;5.7
29;2021-04-11;120;80;165531;51873;18.3;5.7
29;2021-04-12;3853;1480;169384;53353;18.7;5.9
29;2021-04-13;5864;1754;175248;55107;19.3;6.1
29;2021-04-14;4759;1742;180007;56849;19.9;6.3
29;2021-04-15;7174;1730;187181;58579;20.6;6.5
29;2021-04-16;6703;1353;193884;59932;21.4;6.6
29;2021-04-17;3829;968;197713;60900;21.8;6.7
29;2021-04-18;489;40;198202;60940;21.9;6.7
29;2021-04-19;3881;1464;202083;62404;22.3;6.9
29;2021-04-20;4396;2135;206479;64539;22.8;7.1
29;2021-04-21;4378;2195;210857;66734;23.3;7.4
29;2021-04-22;6639;2848;217496;69582;24.0;7.7
29;2021-04-23;6049;2195;223545;71777;24.7;7.9
29;2021-04-24;4008;1310;227553;73087;25.1;8.1
29;2021-04-25;435;169;227988;73256;25.1;8.1
29;2021-04-26;5260;1859;233248;75115;25.7;8.3
29;2021-04-27;5335;3175;238583;78290;26.3;8.6
29;2021-04-28;5359;2890;243942;81180;26.9;9.0
29;2021-04-29;6593;3303;250535;84483;27.6;9.3
29;2021-04-30;6265;3848;256800;88331;28.3;9.7
29;2021-05-01;1986;978;258786;89309;28.5;9.9
29;2021-05-02;1249;191;260035;89500;28.7;9.9
29;2021-05-03;4540;2278;264575;91778;29.2;10.1
29;2021-05-04;4109;3728;268684;95506;29.6;10.5
29;2021-05-05;4519;3400;273203;98906;30.1;10.9
29;2021-05-06;6240;3713;279443;102619;30.8;11.3
29;2021-05-07;5985;4562;285428;107181;31.5;11.8
29;2021-05-08;2097;561;287525;107742;31.7;11.9
29;2021-05-09;1731;136;289256;107878;31.9;11.9
29;2021-05-10;4760;3751;294016;111629;32.4;12.3
29;2021-05-11;4709;4965;298725;116594;33.0;12.9
29;2021-05-12;5024;4359;303749;120953;33.5;13.3
29;2021-05-13;3441;1498;307190;122451;33.9;13.5
29;2021-05-14;5649;3980;312839;126431;34.5;13.9
29;2021-05-15;4048;2294;316887;128725;35.0;14.2
29;2021-05-16;1588;294;318475;129019;35.1;14.2
29;2021-05-17;5561;3119;324036;132138;35.7;14.6
29;2021-05-18;5732;3070;329768;135208;36.4;14.9
29;2021-05-19;6214;2954;335982;138162;37.1;15.2
29;2021-05-20;7173;4546;343155;142708;37.9;15.7
29;2021-05-21;7212;3797;350367;146505;38.6;16.2
29;2021-05-22;5342;2123;355709;148628;39.2;16.4
29;2021-05-23;1631;65;357340;148693;39.4;16.4
29;2021-05-24;3485;534;360825;149227;39.8;16.5
29;2021-05-25;5835;3027;366660;152254;40.4;16.8
29;2021-05-26;5889;2987;372549;155241;41.1;17.1
29;2021-05-27;6824;3952;379373;159193;41.8;17.6
29;2021-05-28;6544;4389;385917;163582;42.6;18.0
29;2021-05-29;4382;2797;390299;166379;43.1;18.4
29;2021-05-30;1113;360;391412;166739;43.2;18.4
29;2021-05-31;6382;3432;397794;170171;43.9;18.8
29;2021-06-01;6603;4311;404397;174482;44.6;19.2
29;2021-06-02;6162;4126;410559;178608;45.3;19.7
29;2021-06-03;7689;4495;418248;183103;46.1;20.2
29;2021-06-04;6812;6135;425060;189238;46.9;20.9
29;2021-06-05;5350;3023;430410;192261;47.5;21.2
29;2021-06-06;1284;538;431694;192799;47.6;21.3
29;2021-06-07;4658;5561;436352;198360;48.1;21.9
29;2021-06-08;7173;5187;443525;203547;48.9;22.5
29;2021-06-09;6403;4743;449928;208290;49.6;23.0
29;2021-06-10;7775;5046;457703;213336;50.5;23.5
29;2021-06-11;8473;5860;466176;219196;51.4;24.2
29;2021-06-12;6562;2812;472738;222008;52.1;24.5
29;2021-06-13;2351;1370;475089;223378;52.4;24.6
29;2021-06-14;4034;6306;479123;229684;52.9;25.3
29;2021-06-15;5478;6182;484601;235866;53.5;26.0
29;2021-06-16;5571;5622;490172;241488;54.1;26.6
29;2021-06-17;6369;6309;496541;247797;54.8;27.3
29;2021-06-18;6116;7486;502657;255283;55.4;28.2
29;2021-06-19;4619;3522;507276;258805;56.0;28.5
29;2021-06-20;891;1452;508167;260257;56.1;28.7
29;2021-06-21;3761;6492;511928;266749;56.5;29.4
29;2021-06-22;4490;6421;516418;273170;57.0;30.1
29;2021-06-23;4672;6128;521090;279298;57.5;30.8
29;2021-06-24;4809;6744;525899;286042;58.0;31.6
29;2021-06-25;3598;7530;529497;293572;58.4;32.4
29;2021-06-26;2131;4093;531628;297665;58.6;32.8
29;2021-06-27;967;1631;532595;299296;58.7;33.0
29;2021-06-28;2843;6862;535438;306158;59.1;33.8
29;2021-06-29;2813;7722;538251;313880;59.4;34.6
29;2021-06-30;3048;7505;541299;321385;59.7;35.5
29;2021-07-01;3789;8418;545088;329803;60.1;36.4
29;2021-07-02;3607;9650;548695;339453;60.5;37.4
29;2021-07-03;2327;6050;551022;345503;60.8;38.1
29;2021-07-04;814;1771;551836;347274;60.9;38.3
29;2021-07-05;1914;7154;553750;354428;61.1;39.1
29;2021-07-06;1542;8004;555292;362432;61.3;40.0
29;2021-07-07;1706;7035;556998;369467;61.4;40.8
29;2021-07-08;2453;8199;559451;377666;61.7;41.7
29;2021-07-09;2628;9061;562079;386727;62.0;42.7
29;2021-07-10;1917;6102;563996;392829;62.2;43.3
29;2021-07-11;449;1064;564445;393893;62.3;43.4
29;2021-07-12;1983;8376;566428;402269;62.5;44.4
29;2021-07-13;2754;8660;569182;410929;62.8;45.3
29;2021-07-14;2086;3372;571268;414301;63.0;45.7
29;2021-07-15;3858;9723;575126;424024;63.4;46.8
29;2021-07-16;4619;9185;579745;433209;64.0;47.8
29;2021-07-17;3223;6109;582968;439318;64.3;48.5
29;2021-07-18;668;1079;583636;440397;64.4;48.6
29;2021-07-19;3157;7541;586793;447938;64.7;49.4
29;2021-07-20;3556;9432;590349;457370;65.1;50.5
29;2021-07-21;3665;7706;594014;465076;65.5;51.3
29;2021-07-22;3428;8532;597442;473608;65.9;52.2
29;2021-07-23;4066;10700;601508;484308;66.4;53.4
29;2021-07-24;2536;5956;604044;490264;66.6;54.1
29;2021-07-25;655;2359;604699;492623;66.7;54.3
29;2021-07-26;3399;7277;608098;499900;67.1;55.1
29;2021-07-27;3721;7110;611819;507010;67.5;55.9
29;2021-07-28;4207;6031;616026;513041;68.0;56.6
29;2021-07-29;5705;6360;621731;519401;68.6;57.3
29;2021-07-30;5470;6536;627201;525937;69.2;58.0
29;2021-07-31;2938;4931;630139;530868;69.5;58.6
29;2021-08-01;658;921;630797;531789;69.6;58.7
29;2021-08-02;4308;5213;635105;537002;70.1;59.2
29;2021-08-03;5490;4406;640595;541408;70.7;59.7
29;2021-08-04;5743;3609;646338;545017;71.3;60.1
29;2021-08-05;6656;4110;652994;549127;72.0;60.6
29;2021-08-06;6216;4334;659210;553461;72.7;61.1
29;2021-08-07;4294;2953;663504;556414;73.2;61.4
29;2021-08-08;854;754;664358;557168;73.3;61.5
29;2021-08-09;3086;4739;667444;561907;73.6;62.0
29;2021-08-10;4495;3865;671939;565772;74.1;62.4
29;2021-08-11;3974;3189;675913;568961;74.6;62.8
29;2021-08-12;4649;4500;680562;573461;75.1;63.3
29;2021-08-13;4239;3718;684801;577179;75.5;63.7
29;2021-08-14;2968;2845;687769;580024;75.9;64.0
29;2021-08-15;338;405;688107;580429;75.9;64.0
29;2021-08-16;3288;4375;691395;584804;76.3;64.5
29;2021-08-17;4411;3419;695806;588223;76.8;64.9
29;2021-08-18;3682;3619;699488;591842;77.2;65.3
29;2021-08-19;3914;4720;703402;596562;77.6;65.8
29;2021-08-20;3512;4600;706914;601162;78.0;66.3
29;2021-08-21;2276;3164;709190;604326;78.2;66.7
29;2021-08-22;216;415;709406;604741;78.3;66.7
29;2021-08-23;2503;4627;711909;609368;78.5;67.2
29;2021-08-24;2469;4953;714378;614321;78.8;67.8
29;2021-08-25;2168;4229;716546;618550;79.0;68.2
29;2021-08-26;2358;5339;718904;623889;79.3;68.8
29;2021-08-27;2056;5914;720960;629803;79.5;69.5
29;2021-08-28;1473;4001;722433;633804;79.7;69.9
29;2021-08-29;453;1318;722886;635122;79.7;70.1
29;2021-08-30;1455;4232;724341;639354;79.9;70.5
29;2021-08-31;1626;4535;725967;643889;80.1;71.0
29;2021-09-01;1341;4005;727308;647894;80.2;71.5
29;2021-09-02;1170;4426;728478;652320;80.4;72.0
29;2021-09-03;1434;5291;729912;657611;80.5;72.5
29;2021-09-04;1419;4064;731331;661675;80.7;73.0
29;2021-09-05;227;740;731558;662415;80.7;73.1
29;2021-09-06;740;3762;732298;666177;80.8;73.5
29;2021-09-07;927;4018;733225;670195;80.9;73.9
29;2021-09-08;909;3903;734134;674098;81.0;74.4
29;2021-09-09;953;3921;735087;678019;81.1;74.8
29;2021-09-10;1194;5081;736281;683100;81.2;75.4
29;2021-09-11;728;3667;737009;686767;81.3;75.8
29;2021-09-12;116;443;737125;687210;81.3;75.8
29;2021-09-13;834;3942;737959;691152;81.4;76.2
29;2021-09-14;717;3915;738676;695067;81.5;76.7
29;2021-09-15;715;3225;739391;698292;81.6;77.0
29;2021-09-16;838;2790;740229;701082;81.7;77.3
29;2021-09-17;922;3243;741151;704325;81.8;77.7
29;2021-09-18;596;3449;741747;707774;81.8;78.1
29;2021-09-19;84;442;741831;708216;81.8;78.1
29;2021-09-20;490;2169;742321;710385;81.9;78.4
29;2021-09-21;473;1917;742794;712302;81.9;78.6
29;2021-09-22;365;2240;743159;714542;82.0;78.8
29;2021-09-23;462;1753;743621;716295;82.0;79.0
29;2021-09-24;482;2230;744103;718525;82.1;79.3
29;2021-09-25;340;2731;744443;721256;82.1;79.6
29;2021-09-26;56;239;744499;721495;82.1;79.6
29;2021-09-27;327;1637;744826;723132;82.2;79.8
29;2021-09-28;257;1568;745083;724700;82.2;79.9
29;2021-09-29;394;1677;745477;726377;82.2;80.1
2A;2020-12-27;0;0;0;0;0.0;0.0
2A;2020-12-28;0;0;0;0;0.0;0.0
2A;2020-12-29;0;0;0;0;0.0;0.0
2A;2020-12-30;0;0;0;0;0.0;0.0
2A;2020-12-31;0;0;0;0;0.0;0.0
2A;2021-01-01;0;0;0;0;0.0;0.0
2A;2021-01-02;1;0;1;0;0.0;0.0
2A;2021-01-03;0;0;1;0;0.0;0.0
2A;2021-01-04;0;0;1;0;0.0;0.0
2A;2021-01-05;0;0;1;0;0.0;0.0
2A;2021-01-06;6;0;7;0;0.0;0.0
2A;2021-01-07;122;1;129;1;0.1;0.0
2A;2021-01-08;114;0;243;1;0.1;0.0
2A;2021-01-09;39;0;282;1;0.2;0.0
2A;2021-01-10;33;0;315;1;0.2;0.0
2A;2021-01-11;78;0;393;1;0.2;0.0
2A;2021-01-12;85;0;478;1;0.3;0.0
2A;2021-01-13;113;0;591;1;0.4;0.0
2A;2021-01-14;191;1;782;2;0.5;0.0
2A;2021-01-15;149;0;931;2;0.6;0.0
2A;2021-01-16;160;1;1091;3;0.7;0.0
2A;2021-01-17;86;1;1177;4;0.7;0.0
2A;2021-01-18;201;2;1378;6;0.8;0.0
2A;2021-01-19;488;1;1866;7;1.1;0.0
2A;2021-01-20;356;0;2222;7;1.4;0.0
2A;2021-01-21;453;1;2675;8;1.6;0.0
2A;2021-01-22;367;0;3042;8;1.9;0.0
2A;2021-01-23;183;0;3225;8;2.0;0.0
2A;2021-01-24;118;1;3343;9;2.1;0.0
2A;2021-01-25;215;0;3558;9;2.2;0.0
2A;2021-01-26;402;7;3960;16;2.4;0.0
2A;2021-01-27;324;5;4284;21;2.6;0.0
2A;2021-01-28;335;73;4619;94;2.8;0.1
2A;2021-01-29;342;59;4961;153;3.1;0.1
2A;2021-01-30;128;34;5089;187;3.1;0.1
2A;2021-01-31;92;11;5181;198;3.2;0.1
2A;2021-02-01;230;42;5411;240;3.3;0.1
2A;2021-02-02;288;107;5699;347;3.5;0.2
2A;2021-02-03;265;72;5964;419;3.7;0.3
2A;2021-02-04;256;113;6220;532;3.8;0.3
2A;2021-02-05;267;95;6487;627;4.0;0.4
2A;2021-02-06;121;54;6608;681;4.1;0.4
2A;2021-02-07;68;39;6676;720;4.1;0.4
2A;2021-02-08;92;169;6768;889;4.2;0.5
2A;2021-02-09;128;263;6896;1152;4.2;0.7
2A;2021-02-10;167;208;7063;1360;4.3;0.8
2A;2021-02-11;299;308;7362;1668;4.5;1.0
2A;2021-02-12;345;240;7707;1908;4.7;1.2
2A;2021-02-13;225;49;7932;1957;4.9;1.2
2A;2021-02-14;135;58;8067;2015;5.0;1.2
2A;2021-02-15;198;152;8265;2167;5.1;1.3
2A;2021-02-16;384;265;8649;2432;5.3;1.5
2A;2021-02-17;297;151;8946;2583;5.5;1.6
2A;2021-02-18;340;164;9286;2747;5.7;1.7
2A;2021-02-19;145;251;9431;2998;5.8;1.8
2A;2021-02-20;243;104;9674;3102;6.0;1.9
2A;2021-02-21;58;42;9732;3144;6.0;1.9
2A;2021-02-22;77;193;9809;3337;6.0;2.1
2A;2021-02-23;122;238;9931;3575;6.1;2.2
2A;2021-02-24;82;243;10013;3818;6.2;2.4
2A;2021-02-25;104;210;10117;4028;6.2;2.5
2A;2021-02-26;123;216;10240;4244;6.3;2.6
2A;2021-02-27;308;52;10548;4296;6.5;2.6
2A;2021-02-28;69;55;10617;4351;6.5;2.7
2A;2021-03-01;117;129;10734;4480;6.6;2.8
2A;2021-03-02;199;237;10933;4717;6.7;2.9
2A;2021-03-03;249;236;11182;4953;6.9;3.0
2A;2021-03-04;508;205;11690;5158;7.2;3.2
2A;2021-03-05;973;260;12663;5418;7.8;3.3
2A;2021-03-06;1167;73;13830;5491;8.5;3.4
2A;2021-03-07;1021;43;14851;5534;9.1;3.4
2A;2021-03-08;933;79;15784;5613;9.7;3.5
2A;2021-03-09;938;140;16722;5753;10.3;3.5
2A;2021-03-10;634;135;17356;5888;10.7;3.6
2A;2021-03-11;723;258;18079;6146;11.1;3.8
2A;2021-03-12;561;310;18640;6456;11.5;4.0
2A;2021-03-13;613;189;19253;6645;11.9;4.1
2A;2021-03-14;312;125;19565;6770;12.0;4.2
2A;2021-03-15;377;197;19942;6967;12.3;4.3
2A;2021-03-16;498;366;20440;7333;12.6;4.5
2A;2021-03-17;703;267;21143;7600;13.0;4.7
2A;2021-03-18;447;299;21590;7899;13.3;4.9
2A;2021-03-19;489;152;22079;8051;13.6;5.0
2A;2021-03-20;1079;258;23158;8309;14.3;5.1
2A;2021-03-21;695;53;23853;8362;14.7;5.1
2A;2021-03-22;347;65;24200;8427;14.9;5.2
2A;2021-03-23;518;56;24718;8483;15.2;5.2
2A;2021-03-24;864;92;25582;8575;15.8;5.3
2A;2021-03-25;930;140;26512;8715;16.3;5.4
2A;2021-03-26;1080;164;27592;8879;17.0;5.5
2A;2021-03-27;1189;199;28781;9078;17.7;5.6
2A;2021-03-28;241;95;29022;9173;17.9;5.6
2A;2021-03-29;283;138;29305;9311;18.0;5.7
2A;2021-03-30;383;233;29688;9544;18.3;5.9
2A;2021-03-31;445;224;30133;9768;18.6;6.0
2A;2021-04-01;638;451;30771;10219;18.9;6.3
2A;2021-04-02;903;780;31674;10999;19.5;6.8
2A;2021-04-03;646;981;32320;11980;19.9;7.4
2A;2021-04-04;578;783;32898;12763;20.3;7.9
2A;2021-04-05;525;691;33423;13454;20.6;8.3
2A;2021-04-06;548;559;33971;14013;20.9;8.6
2A;2021-04-07;795;428;34766;14441;21.4;8.9
2A;2021-04-08;1047;358;35813;14799;22.0;9.1
2A;2021-04-09;934;389;36747;15188;22.6;9.4
2A;2021-04-10;1058;382;37805;15570;23.3;9.6
2A;2021-04-11;362;256;38167;15826;23.5;9.7
2A;2021-04-12;669;339;38836;16165;23.9;10.0
2A;2021-04-13;329;378;39165;16543;24.1;10.2
2A;2021-04-14;1045;587;40210;17130;24.8;10.5
2A;2021-04-15;1044;524;41254;17654;25.4;10.9
2A;2021-04-16;872;392;42126;18046;25.9;11.1
2A;2021-04-17;1369;934;43495;18980;26.8;11.7
2A;2021-04-18;981;948;44476;19928;27.4;12.3
2A;2021-04-19;270;343;44746;20271;27.5;12.5
2A;2021-04-20;354;344;45100;20615;27.8;12.7
2A;2021-04-21;729;734;45829;21349;28.2;13.1
2A;2021-04-22;897;646;46726;21995;28.8;13.5
2A;2021-04-23;986;776;47712;22771;29.4;14.0
2A;2021-04-24;1750;984;49462;23755;30.5;14.6
2A;2021-04-25;976;306;50438;24061;31.1;14.8
2A;2021-04-26;308;226;50746;24287;31.2;15.0
2A;2021-04-27;343;347;51089;24634;31.5;15.2
2A;2021-04-28;1676;424;52765;25058;32.5;15.4
2A;2021-04-29;1053;361;53818;25419;33.1;15.7
2A;2021-04-30;1131;1062;54949;26481;33.8;16.3
2A;2021-05-01;970;575;55919;27056;34.4;16.7
2A;2021-05-02;674;708;56593;27764;34.8;17.1
2A;2021-05-03;583;575;57176;28339;35.2;17.4
2A;2021-05-04;752;535;57928;28874;35.7;17.8
2A;2021-05-05;1011;983;58939;29857;36.3;18.4
2A;2021-05-06;904;911;59843;30768;36.8;18.9
2A;2021-05-07;1156;834;60999;31602;37.6;19.5
2A;2021-05-08;422;501;61421;32103;37.8;19.8
2A;2021-05-09;783;636;62204;32739;38.3;20.2
2A;2021-05-10;454;741;62658;33480;38.6;20.6
2A;2021-05-11;652;417;63310;33897;39.0;20.9
2A;2021-05-12;925;488;64235;34385;39.5;21.2
2A;2021-05-13;920;138;65155;34523;40.1;21.3
2A;2021-05-14;797;678;65952;35201;40.6;21.7
2A;2021-05-15;779;649;66731;35850;41.1;22.1
2A;2021-05-16;740;500;67471;36350;41.5;22.4
2A;2021-05-17;584;557;68055;36907;41.9;22.7
2A;2021-05-18;614;475;68669;37382;42.3;23.0
2A;2021-05-19;787;481;69456;37863;42.8;23.3
2A;2021-05-20;692;539;70148;38402;43.2;23.6
2A;2021-05-21;536;483;70684;38885;43.5;23.9
2A;2021-05-22;440;310;71124;39195;43.8;24.1
2A;2021-05-23;533;282;71657;39477;44.1;24.3
2A;2021-05-24;125;33;71782;39510;44.2;24.3
2A;2021-05-25;421;503;72203;40013;44.5;24.6
2A;2021-05-26;425;1166;72628;41179;44.7;25.4
2A;2021-05-27;435;1111;73063;42290;45.0;26.0
2A;2021-05-28;298;915;73361;43205;45.2;26.6
2A;2021-05-29;334;900;73695;44105;45.4;27.2
2A;2021-05-30;181;507;73876;44612;45.5;27.5
2A;2021-05-31;191;413;74067;45025;45.6;27.7
2A;2021-06-01;342;727;74409;45752;45.8;28.2
2A;2021-06-02;285;940;74694;46692;46.0;28.7
2A;2021-06-03;306;850;75000;47542;46.2;29.3
2A;2021-06-04;271;1091;75271;48633;46.3;29.9
2A;2021-06-05;319;1443;75590;50076;46.5;30.8
2A;2021-06-06;173;907;75763;50983;46.6;31.4
2A;2021-06-07;171;658;75934;51641;46.8;31.8
2A;2021-06-08;324;706;76258;52347;47.0;32.2
2A;2021-06-09;304;1320;76562;53667;47.1;33.0
2A;2021-06-10;329;857;76891;54524;47.3;33.6
2A;2021-06-11;277;1019;77168;55543;47.5;34.2
2A;2021-06-12;232;657;77400;56200;47.7;34.6
2A;2021-06-13;189;797;77589;56997;47.8;35.1
2A;2021-06-14;251;922;77840;57919;47.9;35.7
2A;2021-06-15;217;507;78057;58426;48.1;36.0
2A;2021-06-16;213;776;78270;59202;48.2;36.4
2A;2021-06-17;235;591;78505;59793;48.3;36.8
2A;2021-06-18;246;912;78751;60705;48.5;37.4
2A;2021-06-19;208;689;78959;61394;48.6;37.8
2A;2021-06-20;150;692;79109;62086;48.7;38.2
2A;2021-06-21;181;792;79290;62878;48.8;38.7
2A;2021-06-22;236;841;79526;63719;49.0;39.2
2A;2021-06-23;217;568;79743;64287;49.1;39.6
2A;2021-06-24;149;369;79892;64656;49.2;39.8
2A;2021-06-25;167;470;80059;65126;49.3;40.1
2A;2021-06-26;203;872;80262;65998;49.4;40.6
2A;2021-06-27;175;794;80437;66792;49.5;41.1
2A;2021-06-28;194;704;80631;67496;49.6;41.6
2A;2021-06-29;216;689;80847;68185;49.8;42.0
2A;2021-06-30;242;490;81089;68675;49.9;42.3
2A;2021-07-01;211;483;81300;69158;50.1;42.6
2A;2021-07-02;294;368;81594;69526;50.2;42.8
2A;2021-07-03;211;617;81805;70143;50.4;43.2
2A;2021-07-04;179;664;81984;70807;50.5;43.6
2A;2021-07-05;163;235;82147;71042;50.6;43.7
2A;2021-07-06;252;389;82399;71431;50.7;44.0
2A;2021-07-07;433;611;82832;72042;51.0;44.4
2A;2021-07-08;592;705;83424;72747;51.4;44.8
2A;2021-07-09;384;420;83808;73167;51.6;45.0
2A;2021-07-10;281;346;84089;73513;51.8;45.3
2A;2021-07-11;92;151;84181;73664;51.8;45.4
2A;2021-07-12;317;346;84498;74010;52.0;45.6
2A;2021-07-13;1178;534;85676;74544;52.7;45.9
2A;2021-07-14;1623;341;87299;74885;53.7;46.1
2A;2021-07-15;1436;836;88735;75721;54.6;46.6
2A;2021-07-16;1168;463;89903;76184;55.4;46.9
2A;2021-07-17;1096;345;90999;76529;56.0;47.1
2A;2021-07-18;635;135;91634;76664;56.4;47.2
2A;2021-07-19;918;425;92552;77089;57.0;47.5
2A;2021-07-20;1283;469;93835;77558;57.8;47.8
2A;2021-07-21;1426;724;95261;78282;58.7;48.2
2A;2021-07-22;1400;764;96661;79046;59.5;48.7
2A;2021-07-23;1439;463;98100;79509;60.4;49.0
2A;2021-07-24;897;290;98997;79799;61.0;49.1
2A;2021-07-25;451;81;99448;79880;61.2;49.2
2A;2021-07-26;1198;507;100646;80387;62.0;49.5
2A;2021-07-27;1297;512;101943;80899;62.8;49.8
2A;2021-07-28;1199;593;103142;81492;63.5;50.2
2A;2021-07-29;1230;656;104372;82148;64.3;50.6
2A;2021-07-30;961;609;105333;82757;64.9;51.0
2A;2021-07-31;548;340;105881;83097;65.2;51.2
2A;2021-08-01;570;124;106451;83221;65.5;51.2
2A;2021-08-02;451;494;106902;83715;65.8;51.5
2A;2021-08-03;814;882;107716;84597;66.3;52.1
2A;2021-08-04;724;1161;108440;85758;66.8;52.8
2A;2021-08-05;957;1349;109397;87107;67.4;53.6
2A;2021-08-06;390;814;109787;87921;67.6;54.1
2A;2021-08-07;352;888;110139;88809;67.8;54.7
2A;2021-08-08;78;185;110217;88994;67.9;54.8
2A;2021-08-09;663;1141;110880;90135;68.3;55.5
2A;2021-08-10;642;1209;111522;91344;68.7;56.2
2A;2021-08-11;593;1064;112115;92408;69.0;56.9
2A;2021-08-12;742;1491;112857;93899;69.5;57.8
2A;2021-08-13;484;1066;113341;94965;69.8;58.5
2A;2021-08-14;414;766;113755;95731;70.0;58.9
2A;2021-08-15;27;26;113782;95757;70.1;59.0
2A;2021-08-16;482;1292;114264;97049;70.4;59.8
2A;2021-08-17;940;1556;115204;98605;70.9;60.7
2A;2021-08-18;525;1123;115729;99728;71.3;61.4
2A;2021-08-19;431;1010;116160;100738;71.5;62.0
2A;2021-08-20;328;574;116488;101312;71.7;62.4
2A;2021-08-21;240;535;116728;101847;71.9;62.7
2A;2021-08-22;197;617;116925;102464;72.0;63.1
2A;2021-08-23;325;744;117250;103208;72.2;63.5
2A;2021-08-24;326;858;117576;104066;72.4;64.1
2A;2021-08-25;401;881;117977;104947;72.6;64.6
2A;2021-08-26;343;768;118320;105715;72.8;65.1
2A;2021-08-27;244;714;118564;106429;73.0;65.5
2A;2021-08-28;255;352;118819;106781;73.2;65.7
2A;2021-08-29;97;115;118916;106896;73.2;65.8
2A;2021-08-30;244;652;119160;107548;73.4;66.2
2A;2021-08-31;169;520;119329;108068;73.5;66.5
2A;2021-09-01;343;838;119672;108906;73.7;67.1
2A;2021-09-02;315;734;119987;109640;73.9;67.5
2A;2021-09-03;242;634;120229;110274;74.0;67.9
2A;2021-09-04;146;453;120375;110727;74.1;68.2
2A;2021-09-05;29;32;120404;110759;74.1;68.2
2A;2021-09-06;111;425;120515;111184;74.2;68.5
2A;2021-09-07;190;793;120705;111977;74.3;68.9
2A;2021-09-08;220;794;120925;112771;74.5;69.4
2A;2021-09-09;201;592;121126;113363;74.6;69.8
2A;2021-09-10;155;466;121281;113829;74.7;70.1
2A;2021-09-11;135;345;121416;114174;74.8;70.3
2A;2021-09-12;41;143;121457;114317;74.8;70.4
2A;2021-09-13;101;227;121558;114544;74.8;70.5
2A;2021-09-14;220;430;121778;114974;75.0;70.8
2A;2021-09-15;191;541;121969;115515;75.1;71.1
2A;2021-09-16;214;362;122183;115877;75.2;71.3
2A;2021-09-17;133;175;122316;116052;75.3;71.5
2A;2021-09-18;104;302;122420;116354;75.4;71.6
2A;2021-09-19;10;49;122430;116403;75.4;71.7
2A;2021-09-20;37;130;122467;116533;75.4;71.7
2A;2021-09-21;89;246;122556;116779;75.5;71.9
2A;2021-09-22;99;447;122655;117226;75.5;72.2
2A;2021-09-23;89;324;122744;117550;75.6;72.4
2A;2021-09-24;59;258;122803;117808;75.6;72.5
2A;2021-09-25;63;143;122866;117951;75.6;72.6
2A;2021-09-26;10;29;122876;117980;75.7;72.6
2A;2021-09-27;43;104;122919;118084;75.7;72.7
2A;2021-09-28;102;172;123021;118256;75.7;72.8
2A;2021-09-29;106;296;123127;118552;75.8;73.0
2B;2020-12-27;0;0;0;0;0.0;0.0
2B;2020-12-28;0;0;0;0;0.0;0.0
2B;2020-12-29;0;0;0;0;0.0;0.0
2B;2020-12-30;0;0;0;0;0.0;0.0
2B;2020-12-31;0;0;0;0;0.0;0.0
2B;2021-01-01;0;0;0;0;0.0;0.0
2B;2021-01-02;0;0;0;0;0.0;0.0
2B;2021-01-03;0;0;0;0;0.0;0.0
2B;2021-01-04;2;0;2;0;0.0;0.0
2B;2021-01-05;0;0;2;0;0.0;0.0
2B;2021-01-06;48;1;50;1;0.0;0.0
2B;2021-01-07;210;0;260;1;0.1;0.0
2B;2021-01-08;197;2;457;3;0.3;0.0
2B;2021-01-09;40;0;497;3;0.3;0.0
2B;2021-01-10;1;0;498;3;0.3;0.0
2B;2021-01-11;74;0;572;3;0.3;0.0
2B;2021-01-12;128;1;700;4;0.4;0.0
2B;2021-01-13;93;0;793;4;0.4;0.0
2B;2021-01-14;72;0;865;4;0.5;0.0
2B;2021-01-15;259;0;1124;4;0.6;0.0
2B;2021-01-16;44;0;1168;4;0.6;0.0
2B;2021-01-17;8;0;1176;4;0.6;0.0
2B;2021-01-18;271;0;1447;4;0.8;0.0
2B;2021-01-19;505;0;1952;4;1.1;0.0
2B;2021-01-20;462;3;2414;7;1.3;0.0
2B;2021-01-21;358;0;2772;7;1.5;0.0
2B;2021-01-22;381;0;3153;7;1.7;0.0
2B;2021-01-23;61;0;3214;7;1.8;0.0
2B;2021-01-24;29;0;3243;7;1.8;0.0
2B;2021-01-25;210;2;3453;9;1.9;0.0
2B;2021-01-26;392;1;3845;10;2.1;0.0
2B;2021-01-27;341;30;4186;40;2.3;0.0
2B;2021-01-28;365;118;4551;158;2.5;0.1
2B;2021-01-29;296;135;4847;293;2.7;0.2
2B;2021-01-30;80;32;4927;325;2.7;0.2
2B;2021-01-31;60;0;4987;325;2.7;0.2
2B;2021-02-01;233;84;5220;409;2.9;0.2
2B;2021-02-02;358;72;5578;481;3.1;0.3
2B;2021-02-03;520;86;6098;567;3.3;0.3
2B;2021-02-04;458;110;6556;677;3.6;0.4
2B;2021-02-05;394;85;6950;762;3.8;0.4
2B;2021-02-06;87;11;7037;773;3.9;0.4
2B;2021-02-07;60;0;7097;773;3.9;0.4
2B;2021-02-08;231;121;7328;894;4.0;0.5
2B;2021-02-09;586;251;7914;1145;4.3;0.6
2B;2021-02-10;485;161;8399;1306;4.6;0.7
2B;2021-02-11;382;108;8781;1414;4.8;0.8
2B;2021-02-12;299;110;9080;1524;5.0;0.8
2B;2021-02-13;77;10;9157;1534;5.0;0.8
2B;2021-02-14;62;1;9219;1535;5.1;0.8
2B;2021-02-15;190;100;9409;1635;5.2;0.9
2B;2021-02-16;251;217;9660;1852;5.3;1.0
2B;2021-02-17;312;253;9972;2105;5.5;1.2
2B;2021-02-18;215;278;10187;2383;5.6;1.3
2B;2021-02-19;163;267;10350;2650;5.7;1.5
2B;2021-02-20;32;38;10382;2688;5.7;1.5
2B;2021-02-21;28;23;10410;2711;5.7;1.5
2B;2021-02-22;133;154;10543;2865;5.8;1.6
2B;2021-02-23;232;300;10775;3165;5.9;1.7
2B;2021-02-24;229;266;11004;3431;6.0;1.9
2B;2021-02-25;245;280;11249;3711;6.2;2.0
2B;2021-02-26;301;241;11550;3952;6.3;2.2
2B;2021-02-27;60;71;11610;4023;6.4;2.2
2B;2021-02-28;1;44;11611;4067;6.4;2.2
2B;2021-03-01;246;238;11857;4305;6.5;2.4
2B;2021-03-02;352;354;12209;4659;6.7;2.6
2B;2021-03-03;299;395;12508;5054;6.9;2.8
2B;2021-03-04;447;376;12955;5430;7.1;3.0
2B;2021-03-05;619;351;13574;5781;7.4;3.2
2B;2021-03-06;682;90;14256;5871;7.8;3.2
2B;2021-03-07;361;56;14617;5927;8.0;3.3
2B;2021-03-08;301;220;14918;6147;8.2;3.4
2B;2021-03-09;384;472;15302;6619;8.4;3.6
2B;2021-03-10;631;420;15933;7039;8.7;3.9
2B;2021-03-11;584;333;16517;7372;9.1;4.0
2B;2021-03-12;968;219;17485;7591;9.6;4.2
2B;2021-03-13;511;97;17996;7688;9.9;4.2
2B;2021-03-14;226;63;18222;7751;10.0;4.3
2B;2021-03-15;516;198;18738;7949;10.3;4.4
2B;2021-03-16;571;271;19309;8220;10.6;4.5
2B;2021-03-17;530;258;19839;8478;10.9;4.7
2B;2021-03-18;551;221;20390;8699;11.2;4.8
2B;2021-03-19;805;192;21195;8891;11.6;4.9
2B;2021-03-20;656;37;21851;8928;12.0;4.9
2B;2021-03-21;428;36;22279;8964;12.2;4.9
2B;2021-03-22;546;122;22825;9086;12.5;5.0
2B;2021-03-23;788;255;23613;9341;13.0;5.1
2B;2021-03-24;831;214;24444;9555;13.4;5.2
2B;2021-03-25;824;163;25268;9718;13.9;5.3
2B;2021-03-26;958;189;26226;9907;14.4;5.4
2B;2021-03-27;1092;36;27318;9943;15.0;5.5
2B;2021-03-28;830;121;28148;10064;15.4;5.5
2B;2021-03-29;745;177;28893;10241;15.9;5.6
2B;2021-03-30;972;323;29865;10564;16.4;5.8
2B;2021-03-31;981;266;30846;10830;16.9;5.9
2B;2021-04-01;1003;226;31849;11056;17.5;6.1
2B;2021-04-02;966;408;32815;11464;18.0;6.3
2B;2021-04-03;1246;153;34061;11617;18.7;6.4
2B;2021-04-04;197;60;34258;11677;18.8;6.4
2B;2021-04-05;109;113;34367;11790;18.9;6.5
2B;2021-04-06;1032;360;35399;12150;19.4;6.7
2B;2021-04-07;1231;421;36630;12571;20.1;6.9
2B;2021-04-08;1129;408;37759;12979;20.7;7.1
2B;2021-04-09;1166;567;38925;13546;21.4;7.4
2B;2021-04-10;1352;265;40277;13811;22.1;7.6
2B;2021-04-11;815;65;41092;13876;22.5;7.6
2B;2021-04-12;853;558;41945;14434;23.0;7.9
2B;2021-04-13;1063;630;43008;15064;23.6;8.3
2B;2021-04-14;1046;494;44054;15558;24.2;8.5
2B;2021-04-15;886;517;44940;16075;24.7;8.8
2B;2021-04-16;910;647;45850;16722;25.2;9.2
2B;2021-04-17;386;447;46236;17169;25.4;9.4
2B;2021-04-18;253;343;46489;17512;25.5;9.6
2B;2021-04-19;822;436;47311;17948;26.0;9.8
2B;2021-04-20;898;843;48209;18791;26.5;10.3
2B;2021-04-21;1056;608;49265;19399;27.0;10.6
2B;2021-04-22;938;732;50203;20131;27.5;11.0
2B;2021-04-23;662;628;50865;20759;27.9;11.4
2B;2021-04-24;288;772;51153;21531;28.1;11.8
2B;2021-04-25;285;477;51438;22008;28.2;12.1
2B;2021-04-26;708;918;52146;22926;28.6;12.6
2B;2021-04-27;965;873;53111;23799;29.1;13.1
2B;2021-04-28;918;862;54029;24661;29.6;13.5
2B;2021-04-29;925;867;54954;25528;30.2;14.0
2B;2021-04-30;1133;831;56087;26359;30.8;14.5
2B;2021-05-01;460;1116;56547;27475;31.0;15.1
2B;2021-05-02;335;244;56882;27719;31.2;15.2
2B;2021-05-03;1017;495;57899;28214;31.8;15.5
2B;2021-05-04;811;1152;58710;29366;32.2;16.1
2B;2021-05-05;800;1376;59510;30742;32.7;16.9
2B;2021-05-06;1286;905;60796;31647;33.4;17.4
2B;2021-05-07;1062;987;61858;32634;33.9;17.9
2B;2021-05-08;459;852;62317;33486;34.2;18.4
2B;2021-05-09;392;683;62709;34169;34.4;18.7
2B;2021-05-10;925;802;63634;34971;34.9;19.2
2B;2021-05-11;933;1163;64567;36134;35.4;19.8
2B;2021-05-12;859;893;65426;37027;35.9;20.3
2B;2021-05-13;1028;376;66454;37403;36.5;20.5
2B;2021-05-14;719;577;67173;37980;36.9;20.8
2B;2021-05-15;702;353;67875;38333;37.2;21.0
2B;2021-05-16;300;180;68175;38513;37.4;21.1
2B;2021-05-17;1003;405;69178;38918;38.0;21.4
2B;2021-05-18;990;382;70168;39300;38.5;21.6
2B;2021-05-19;771;416;70939;39716;38.9;21.8
2B;2021-05-20;668;359;71607;40075;39.3;22.0
2B;2021-05-21;706;502;72313;40577;39.7;22.3
2B;2021-05-22;575;392;72888;40969;40.0;22.5
2B;2021-05-23;170;46;73058;41015;40.1;22.5
2B;2021-05-24;40;115;73098;41130;40.1;22.6
2B;2021-05-25;548;352;73646;41482;40.4;22.8
2B;2021-05-26;545;787;74191;42269;40.7;23.2
2B;2021-05-27;407;1131;74598;43400;40.9;23.8
2B;2021-05-28;550;905;75148;44305;41.2;24.3
2B;2021-05-29;311;353;75459;44658;41.4;24.5
2B;2021-05-30;46;45;75505;44703;41.4;24.5
2B;2021-05-31;375;831;75880;45534;41.6;25.0
2B;2021-06-01;414;1037;76294;46571;41.9;25.6
2B;2021-06-02;363;988;76657;47559;42.1;26.1
2B;2021-06-03;498;806;77155;48365;42.3;26.5
2B;2021-06-04;343;1253;77498;49618;42.5;27.2
2B;2021-06-05;257;491;77755;50109;42.7;27.5
2B;2021-06-06;51;129;77806;50238;42.7;27.6
2B;2021-06-07;280;949;78086;51187;42.8;28.1
2B;2021-06-08;399;1167;78485;52354;43.1;28.7
2B;2021-06-09;519;1177;79004;53531;43.3;29.4
2B;2021-06-10;369;939;79373;54470;43.5;29.9
2B;2021-06-11;432;1272;79805;55742;43.8;30.6
2B;2021-06-12;151;544;79956;56286;43.9;30.9
2B;2021-06-13;27;59;79983;56345;43.9;30.9
2B;2021-06-14;195;1111;80178;57456;44.0;31.5
2B;2021-06-15;344;1217;80522;58673;44.2;32.2
2B;2021-06-16;383;935;80905;59608;44.4;32.7
2B;2021-06-17;402;1049;81307;60657;44.6;33.3
2B;2021-06-18;348;960;81655;61617;44.8;33.8
2B;2021-06-19;144;330;81799;61947;44.9;34.0
2B;2021-06-20;44;194;81843;62141;44.9;34.1
2B;2021-06-21;265;962;82108;63103;45.1;34.6
2B;2021-06-22;317;1115;82425;64218;45.2;35.2
2B;2021-06-23;209;871;82634;65089;45.3;35.7
2B;2021-06-24;337;758;82971;65847;45.5;36.1
2B;2021-06-25;210;1074;83181;66921;45.6;36.7
2B;2021-06-26;105;550;83286;67471;45.7;37.0
2B;2021-06-27;31;214;83317;67685;45.7;37.1
2B;2021-06-28;329;954;83646;68639;45.9;37.7
2B;2021-06-29;270;985;83916;69624;46.0;38.2
2B;2021-06-30;381;949;84297;70573;46.3;38.7
2B;2021-07-01;226;507;84523;71080;46.4;39.0
2B;2021-07-02;219;557;84742;71637;46.5;39.3
2B;2021-07-03;91;397;84833;72034;46.5;39.5
2B;2021-07-04;2;0;84835;72034;46.5;39.5
2B;2021-07-05;264;666;85099;72700;46.7;39.9
2B;2021-07-06;450;707;85549;73407;46.9;40.3
2B;2021-07-07;380;910;85929;74317;47.1;40.8
2B;2021-07-08;183;351;86112;74668;47.2;41.0
2B;2021-07-09;250;376;86362;75044;47.4;41.2
2B;2021-07-10;197;199;86559;75243;47.5;41.3
2B;2021-07-11;13;14;86572;75257;47.5;41.3
2B;2021-07-12;497;746;87069;76003;47.8;41.7
2B;2021-07-13;822;1020;87891;77023;48.2;42.3
2B;2021-07-14;344;100;88235;77123;48.4;42.3
2B;2021-07-15;1270;589;89505;77712;49.1;42.6
2B;2021-07-16;1120;564;90625;78276;49.7;42.9
2B;2021-07-17;710;318;91335;78594;50.1;43.1
2B;2021-07-18;179;49;91514;78643;50.2;43.1
2B;2021-07-19;857;708;92371;79351;50.7;43.5
2B;2021-07-20;1211;681;93582;80032;51.3;43.9
2B;2021-07-21;1396;725;94978;80757;52.1;44.3
2B;2021-07-22;1330;604;96308;81361;52.8;44.6
2B;2021-07-23;1328;502;97636;81863;53.6;44.9
2B;2021-07-24;534;315;98170;82178;53.9;45.1
2B;2021-07-25;203;71;98373;82249;54.0;45.1
2B;2021-07-26;913;634;99286;82883;54.5;45.5
2B;2021-07-27;1578;704;100864;83587;55.3;45.9
2B;2021-07-28;1177;633;102041;84220;56.0;46.2
2B;2021-07-29;1144;449;103185;84669;56.6;46.5
2B;2021-07-30;763;348;103948;85017;57.0;46.6
2B;2021-07-31;539;233;104487;85250;57.3;46.8
2B;2021-08-01;230;57;104717;85307;57.5;46.8
2B;2021-08-02;799;471;105516;85778;57.9;47.1
2B;2021-08-03;1137;786;106653;86564;58.5;47.5
2B;2021-08-04;810;454;107463;87018;59.0;47.7
2B;2021-08-05;1024;560;108487;87578;59.5;48.1
2B;2021-08-06;704;526;109191;88104;59.9;48.3
2B;2021-08-07;306;408;109497;88512;60.1;48.6
2B;2021-08-08;93;142;109590;88654;60.1;48.6
2B;2021-08-09;536;747;110126;89401;60.4;49.1
2B;2021-08-10;739;1131;110865;90532;60.8;49.7
2B;2021-08-11;752;901;111617;91433;61.2;50.2
2B;2021-08-12;692;1045;112309;92478;61.6;50.7
2B;2021-08-13;494;948;112803;93426;61.9;51.3
2B;2021-08-14;200;437;113003;93863;62.0;51.5
2B;2021-08-15;117;173;113120;94036;62.1;51.6
2B;2021-08-16;509;1063;113629;95099;62.3;52.2
2B;2021-08-17;587;1308;114216;96407;62.7;52.9
2B;2021-08-18;506;1193;114722;97600;62.9;53.6
2B;2021-08-19;433;900;115155;98500;63.2;54.0
2B;2021-08-20;368;810;115523;99310;63.4;54.5
2B;2021-08-21;158;474;115681;99784;63.5;54.7
2B;2021-08-22;79;208;115760;99992;63.5;54.9
2B;2021-08-23;376;945;116136;100937;63.7;55.4
2B;2021-08-24;497;1214;116633;102151;64.0;56.0
2B;2021-08-25;347;971;116980;103122;64.2;56.6
2B;2021-08-26;400;817;117380;103939;64.4;57.0
2B;2021-08-27;261;572;117641;104511;64.5;57.3
2B;2021-08-28;168;442;117809;104953;64.6;57.6
2B;2021-08-29;53;126;117862;105079;64.7;57.7
2B;2021-08-30;364;851;118226;105930;64.9;58.1
2B;2021-08-31;380;922;118606;106852;65.1;58.6
2B;2021-09-01;368;986;118974;107838;65.3;59.2
2B;2021-09-02;304;737;119278;108575;65.4;59.6
2B;2021-09-03;219;507;119497;109082;65.6;59.9
2B;2021-09-04;123;352;119620;109434;65.6;60.0
2B;2021-09-05;17;137;119637;109571;65.6;60.1
2B;2021-09-06;163;655;119800;110226;65.7;60.5
2B;2021-09-07;258;989;120058;111215;65.9;61.0
2B;2021-09-08;202;746;120260;111961;66.0;61.4
2B;2021-09-09;181;520;120441;112481;66.1;61.7
2B;2021-09-10;199;487;120640;112968;66.2;62.0
2B;2021-09-11;130;312;120770;113280;66.3;62.2
2B;2021-09-12;17;114;120787;113394;66.3;62.2
2B;2021-09-13;191;534;120978;113928;66.4;62.5
2B;2021-09-14;279;929;121257;114857;66.5;63.0
2B;2021-09-15;159;598;121416;115455;66.6;63.3
2B;2021-09-16;215;301;121631;115756;66.7;63.5
2B;2021-09-17;113;193;121744;115949;66.8;63.6
2B;2021-09-18;51;157;121795;116106;66.8;63.7
2B;2021-09-19;14;18;121809;116124;66.8;63.7
2B;2021-09-20;106;409;121915;116533;66.9;63.9
2B;2021-09-21;100;410;122015;116943;66.9;64.2
2B;2021-09-22;115;404;122130;117347;67.0;64.4
2B;2021-09-23;103;228;122233;117575;67.1;64.5
2B;2021-09-24;85;212;122318;117787;67.1;64.6
2B;2021-09-25;36;123;122354;117910;67.1;64.7
2B;2021-09-26;2;23;122356;117933;67.1;64.7
2B;2021-09-27;71;229;122427;118162;67.2;64.8
2B;2021-09-28;97;192;122524;118354;67.2;64.9
2B;2021-09-29;119;345;122643;118699;67.3;65.1
30;2020-12-27;1;0;1;0;0.0;0.0
30;2020-12-28;2;0;3;0;0.0;0.0
30;2020-12-29;0;0;3;0;0.0;0.0
30;2020-12-30;0;0;3;0;0.0;0.0
30;2020-12-31;0;0;3;0;0.0;0.0
30;2021-01-01;0;0;3;0;0.0;0.0
30;2021-01-02;0;0;3;0;0.0;0.0
30;2021-01-03;0;0;3;0;0.0;0.0
30;2021-01-04;0;0;3;0;0.0;0.0
30;2021-01-05;3;0;6;0;0.0;0.0
30;2021-01-06;128;0;134;0;0.0;0.0
30;2021-01-07;314;0;448;0;0.1;0.0
30;2021-01-08;532;0;980;0;0.1;0.0
30;2021-01-09;270;0;1250;0;0.2;0.0
30;2021-01-10;0;0;1250;0;0.2;0.0
30;2021-01-11;537;0;1787;0;0.2;0.0
30;2021-01-12;801;3;2588;3;0.3;0.0
30;2021-01-13;640;0;3228;3;0.4;0.0
30;2021-01-14;653;5;3881;8;0.5;0.0
30;2021-01-15;756;2;4637;10;0.6;0.0
30;2021-01-16;313;0;4950;10;0.7;0.0
30;2021-01-17;4;0;4954;10;0.7;0.0
30;2021-01-18;945;5;5899;15;0.8;0.0
30;2021-01-19;1735;5;7634;20;1.0;0.0
30;2021-01-20;1304;2;8938;22;1.2;0.0
30;2021-01-21;1229;2;10167;24;1.4;0.0
30;2021-01-22;1078;6;11245;30;1.5;0.0
30;2021-01-23;634;2;11879;32;1.6;0.0
30;2021-01-24;0;0;11879;32;1.6;0.0
30;2021-01-25;830;5;12709;37;1.7;0.0
30;2021-01-26;1059;15;13768;52;1.8;0.0
30;2021-01-27;983;104;14751;156;2.0;0.0
30;2021-01-28;714;246;15465;402;2.1;0.1
30;2021-01-29;671;418;16136;820;2.2;0.1
30;2021-01-30;473;261;16609;1081;2.2;0.1
30;2021-01-31;3;6;16612;1087;2.2;0.1
30;2021-02-01;816;405;17428;1492;2.3;0.2
30;2021-02-02;1876;634;19304;2126;2.6;0.3
30;2021-02-03;1184;455;20488;2581;2.7;0.3
30;2021-02-04;970;589;21458;3170;2.9;0.4
30;2021-02-05;599;699;22057;3869;2.9;0.5
30;2021-02-06;295;203;22352;4072;3.0;0.5
30;2021-02-07;3;8;22355;4080;3.0;0.5
30;2021-02-08;574;604;22929;4684;3.1;0.6
30;2021-02-09;985;908;23914;5592;3.2;0.7
30;2021-02-10;985;980;24899;6572;3.3;0.9
30;2021-02-11;929;936;25828;7508;3.5;1.0
30;2021-02-12;620;875;26448;8383;3.5;1.1
30;2021-02-13;436;296;26884;8679;3.6;1.2
30;2021-02-14;3;19;26887;8698;3.6;1.2
30;2021-02-15;450;473;27337;9171;3.7;1.2
30;2021-02-16;460;712;27797;9883;3.7;1.3
30;2021-02-17;683;518;28480;10401;3.8;1.4
30;2021-02-18;794;429;29274;10830;3.9;1.4
30;2021-02-19;577;563;29851;11393;4.0;1.5
30;2021-02-20;224;177;30075;11570;4.0;1.5
30;2021-02-21;5;3;30080;11573;4.0;1.5
30;2021-02-22;502;652;30582;12225;4.1;1.6
30;2021-02-23;973;1341;31555;13566;4.2;1.8
30;2021-02-24;929;1014;32484;14580;4.3;1.9
30;2021-02-25;1209;778;33693;15358;4.5;2.1
30;2021-02-26;1336;491;35029;15849;4.7;2.1
30;2021-02-27;564;442;35593;16291;4.8;2.2
30;2021-02-28;6;7;35599;16298;4.8;2.2
30;2021-03-01;1342;740;36941;17038;4.9;2.3
30;2021-03-02;1714;807;38655;17845;5.2;2.4
30;2021-03-03;2310;654;40965;18499;5.5;2.5
30;2021-03-04;2638;798;43603;19297;5.8;2.6
30;2021-03-05;2766;558;46369;19855;6.2;2.7
30;2021-03-06;2996;317;49365;20172;6.6;2.7
30;2021-03-07;1862;47;51227;20219;6.8;2.7
30;2021-03-08;1555;708;52782;20927;7.1;2.8
30;2021-03-09;2276;794;55058;21721;7.4;2.9
30;2021-03-10;2360;607;57418;22328;7.7;3.0
30;2021-03-11;3054;660;60472;22988;8.1;3.1
30;2021-03-12;3114;363;63586;23351;8.5;3.1
30;2021-03-13;2227;278;65813;23629;8.8;3.2
30;2021-03-14;83;3;65896;23632;8.8;3.2
30;2021-03-15;1579;547;67475;24179;9.0;3.2
30;2021-03-16;1297;1013;68772;25192;9.2;3.4
30;2021-03-17;1456;625;70228;25817;9.4;3.4
30;2021-03-18;1648;703;71876;26520;9.6;3.5
30;2021-03-19;2250;532;74126;27052;9.9;3.6
30;2021-03-20;1400;142;75526;27194;10.1;3.6
30;2021-03-21;58;8;75584;27202;10.1;3.6
30;2021-03-22;2394;712;77978;27914;10.4;3.7
30;2021-03-23;3512;798;81490;28712;10.9;3.8
30;2021-03-24;3639;810;85129;29522;11.4;3.9
30;2021-03-25;4405;838;89534;30360;12.0;4.1
30;2021-03-26;4361;644;93895;31004;12.5;4.1
30;2021-03-27;1971;374;95866;31378;12.8;4.2
30;2021-03-28;35;29;95901;31407;12.8;4.2
30;2021-03-29;2816;1641;98717;33048;13.2;4.4
30;2021-03-30;3777;1869;102494;34917;13.7;4.7
30;2021-03-31;3505;1636;105999;36553;14.2;4.9
30;2021-04-01;4016;1465;110015;38018;14.7;5.1
30;2021-04-02;3605;1221;113620;39239;15.2;5.2
30;2021-04-03;1061;1216;114681;40455;15.3;5.4
30;2021-04-04;30;188;114711;40643;15.3;5.4
30;2021-04-05;765;291;115476;40934;15.4;5.5
30;2021-04-06;3045;1576;118521;42510;15.8;5.7
30;2021-04-07;2718;1626;121239;44136;16.2;5.9
30;2021-04-08;3921;1486;125160;45622;16.7;6.1
30;2021-04-09;4888;1512;130048;47134;17.4;6.3
30;2021-04-10;2426;1175;132474;48309;17.7;6.5
30;2021-04-11;950;59;133424;48368;17.8;6.5
30;2021-04-12;3142;1490;136566;49858;18.2;6.7
30;2021-04-13;4019;1930;140585;51788;18.8;6.9
30;2021-04-14;3387;1542;143972;53330;19.2;7.1
30;2021-04-15;3826;1469;147798;54799;19.7;7.3
30;2021-04-16;3704;1543;151502;56342;20.2;7.5
30;2021-04-17;1493;952;152995;57294;20.4;7.7
30;2021-04-18;961;67;153956;57361;20.6;7.7
30;2021-04-19;2447;2297;156403;59658;20.9;8.0
30;2021-04-20;2817;2829;159220;62487;21.3;8.3
30;2021-04-21;2599;2568;161819;65055;21.6;8.7
30;2021-04-22;3525;2317;165344;67372;22.1;9.0
30;2021-04-23;3580;2299;168924;69671;22.6;9.3
30;2021-04-24;1347;1230;170271;70901;22.7;9.5
30;2021-04-25;748;91;171019;70992;22.8;9.5
30;2021-04-26;2015;2387;173034;73379;23.1;9.8
30;2021-04-27;2951;2593;175985;75972;23.5;10.2
30;2021-04-28;2838;2485;178823;78457;23.9;10.5
30;2021-04-29;3621;2319;182444;80776;24.4;10.8
30;2021-04-30;3409;2014;185853;82790;24.8;11.1
30;2021-05-01;1747;601;187600;83391;25.1;11.1
30;2021-05-02;664;245;188264;83636;25.2;11.2
30;2021-05-03;3750;2504;192014;86140;25.7;11.5
30;2021-05-04;3979;3538;195993;89678;26.2;12.0
30;2021-05-05;3942;3117;199935;92795;26.7;12.4
30;2021-05-06;4202;3366;204137;96161;27.3;12.8
30;2021-05-07;4078;3062;208215;99223;27.8;13.3
30;2021-05-08;1605;721;209820;99944;28.0;13.4
30;2021-05-09;372;613;210192;100557;28.1;13.4
30;2021-05-10;2921;3113;213113;103670;28.5;13.9
30;2021-05-11;5389;3646;218502;107316;29.2;14.3
30;2021-05-12;5303;3214;223805;110530;29.9;14.8
30;2021-05-13;3230;1028;227035;111558;30.3;14.9
30;2021-05-14;4890;2460;231925;114018;31.0;15.2
30;2021-05-15;3407;1206;235332;115224;31.4;15.4
30;2021-05-16;397;338;235729;115562;31.5;15.4
30;2021-05-17;3793;3030;239522;118592;32.0;15.8
30;2021-05-18;4826;3033;244348;121625;32.6;16.2
30;2021-05-19;4773;2546;249121;124171;33.3;16.6
30;2021-05-20;5015;2571;254136;126742;34.0;16.9
30;2021-05-21;4884;2472;259020;129214;34.6;17.3
30;2021-05-22;3155;1283;262175;130497;35.0;17.4
30;2021-05-23;289;344;262464;130841;35.1;17.5
30;2021-05-24;785;766;263249;131607;35.2;17.6
30;2021-05-25;2654;3157;265903;134764;35.5;18.0
30;2021-05-26;2887;2571;268790;137335;35.9;18.3
30;2021-05-27;3757;2708;272547;140043;36.4;18.7
30;2021-05-28;3325;3246;275872;143289;36.9;19.1
30;2021-05-29;1687;1793;277559;145082;37.1;19.4
30;2021-05-30;360;584;277919;145666;37.1;19.5
30;2021-05-31;2829;2293;280748;147959;37.5;19.8
30;2021-06-01;3658;2791;284406;150750;38.0;20.1
30;2021-06-02;3320;2449;287726;153199;38.4;20.5
30;2021-06-03;4129;3344;291855;156543;39.0;20.9
30;2021-06-04;3898;3393;295753;159936;39.5;21.4
30;2021-06-05;1905;1313;297658;161249;39.8;21.5
30;2021-06-06;684;264;298342;161513;39.9;21.6
30;2021-06-07;4721;2524;303063;164037;40.5;21.9
30;2021-06-08;4830;3324;307893;167361;41.1;22.4
30;2021-06-09;4151;2988;312044;170349;41.7;22.8
30;2021-06-10;4611;3352;316655;173701;42.3;23.2
30;2021-06-11;4583;3807;321238;177508;42.9;23.7
30;2021-06-12;2485;1709;323723;179217;43.3;23.9
30;2021-06-13;493;344;324216;179561;43.3;24.0
30;2021-06-14;2470;4711;326686;184272;43.6;24.6
30;2021-06-15;3198;5309;329884;189581;44.1;25.3
30;2021-06-16;3107;4642;332991;194223;44.5;25.9
30;2021-06-17;3922;4372;336913;198595;45.0;26.5
30;2021-06-18;3713;4694;340626;203289;45.5;27.2
30;2021-06-19;1441;2004;342067;205293;45.7;27.4
30;2021-06-20;357;491;342424;205784;45.7;27.5
30;2021-06-21;2379;4910;344803;210694;46.1;28.2
30;2021-06-22;2364;5741;347167;216435;46.4;28.9
30;2021-06-23;2528;5342;349695;221777;46.7;29.6
30;2021-06-24;2336;4707;352031;226484;47.0;30.3
30;2021-06-25;2611;5603;354642;232087;47.4;31.0
30;2021-06-26;908;2939;355550;235026;47.5;31.4
30;2021-06-27;222;527;355772;235553;47.5;31.5
30;2021-06-28;1670;6022;357442;241575;47.8;32.3
30;2021-06-29;1837;6022;359279;247597;48.0;33.1
30;2021-06-30;2001;5253;361280;252850;48.3;33.8
30;2021-07-01;3105;4715;364385;257565;48.7;34.4
30;2021-07-02;2833;4624;367218;262189;49.1;35.0
30;2021-07-03;1154;3047;368372;265236;49.2;35.4
30;2021-07-04;116;393;368488;265629;49.2;35.5
30;2021-07-05;2025;4028;370513;269657;49.5;36.0
30;2021-07-06;2663;4973;373176;274630;49.9;36.7
30;2021-07-07;2538;4220;375714;278850;50.2;37.3
30;2021-07-08;2011;3417;377725;282267;50.5;37.7
30;2021-07-09;2410;5312;380135;287579;50.8;38.4
30;2021-07-10;1504;2157;381639;289736;51.0;38.7
30;2021-07-11;47;415;381686;290151;51.0;38.8
30;2021-07-12;2527;5152;384213;295303;51.3;39.5
30;2021-07-13;3300;6029;387513;301332;51.8;40.3
30;2021-07-14;502;550;388015;301882;51.8;40.3
30;2021-07-15;4127;5474;392142;307356;52.4;41.1
30;2021-07-16;5036;5727;397178;313083;53.1;41.8
30;2021-07-17;1706;2466;398884;315549;53.3;42.2
30;2021-07-18;146;602;399030;316151;53.3;42.2
30;2021-07-19;3374;6313;402404;322464;53.8;43.1
30;2021-07-20;4640;6520;407044;328984;54.4;44.0
30;2021-07-21;4063;5413;411107;334397;54.9;44.7
30;2021-07-22;4900;5740;416007;340137;55.6;45.4
30;2021-07-23;4998;5866;421005;346003;56.2;46.2
30;2021-07-24;2240;3256;423245;349259;56.5;46.7
30;2021-07-25;137;309;423382;349568;56.6;46.7
30;2021-07-26;4414;4132;427796;353700;57.2;47.3
30;2021-07-27;4856;4647;432652;358347;57.8;47.9
30;2021-07-28;4877;4024;437529;362371;58.5;48.4
30;2021-07-29;5929;4138;443458;366509;59.2;49.0
30;2021-07-30;5342;4389;448800;370898;60.0;49.6
30;2021-07-31;2655;1965;451455;372863;60.3;49.8
30;2021-08-01;734;312;452189;373175;60.4;49.9
30;2021-08-02;3685;4011;455874;377186;60.9;50.4
30;2021-08-03;4887;3953;460761;381139;61.6;50.9
30;2021-08-04;5283;3050;466044;384189;62.3;51.3
30;2021-08-05;4616;3792;470660;387981;62.9;51.8
30;2021-08-06;4333;4064;474993;392045;63.5;52.4
30;2021-08-07;1841;1953;476834;393998;63.7;52.6
30;2021-08-08;619;280;477453;394278;63.8;52.7
30;2021-08-09;3342;3761;480795;398039;64.2;53.2
30;2021-08-10;3926;4401;484721;402440;64.8;53.8
30;2021-08-11;3402;3480;488123;405920;65.2;54.2
30;2021-08-12;3763;4220;491886;410140;65.7;54.8
30;2021-08-13;3306;3338;495192;413478;66.2;55.2
30;2021-08-14;1134;2048;496326;415526;66.3;55.5
30;2021-08-15;270;175;496596;415701;66.3;55.5
30;2021-08-16;2201;4864;498797;420565;66.6;56.2
30;2021-08-17;2745;4197;501542;424762;67.0;56.8
30;2021-08-18;2839;3835;504381;428597;67.4;57.3
30;2021-08-19;2858;4317;507239;432914;67.8;57.8
30;2021-08-20;2607;4465;509846;437379;68.1;58.4
30;2021-08-21;1018;2887;510864;440266;68.3;58.8
30;2021-08-22;227;516;511091;440782;68.3;58.9
30;2021-08-23;1687;4476;512778;445258;68.5;59.5
30;2021-08-24;1952;4525;514730;449783;68.8;60.1
30;2021-08-25;1688;4345;516418;454128;69.0;60.7
30;2021-08-26;1851;4256;518269;458384;69.2;61.2
30;2021-08-27;1772;4355;520041;462739;69.5;61.8
30;2021-08-28;681;2476;520722;465215;69.6;62.2
30;2021-08-29;182;614;520904;465829;69.6;62.2
30;2021-08-30;1406;4307;522310;470136;69.8;62.8
30;2021-08-31;1331;4190;523641;474326;70.0;63.4
30;2021-09-01;1237;3624;524878;477950;70.1;63.9
30;2021-09-02;1355;3590;526233;481540;70.3;64.3
30;2021-09-03;1500;4188;527733;485728;70.5;64.9
30;2021-09-04;681;1963;528414;487691;70.6;65.2
30;2021-09-05;136;527;528550;488218;70.6;65.2
30;2021-09-06;740;2742;529290;490960;70.7;65.6
30;2021-09-07;696;2646;529986;493606;70.8;65.9
30;2021-09-08;864;2863;530850;496469;70.9;66.3
30;2021-09-09;891;2492;531741;498961;71.0;66.7
30;2021-09-10;921;3001;532662;501962;71.2;67.1
30;2021-09-11;548;1667;533210;503629;71.2;67.3
30;2021-09-12;93;224;533303;503853;71.3;67.3
30;2021-09-13;681;2013;533984;505866;71.3;67.6
30;2021-09-14;646;2050;534630;507916;71.4;67.9
30;2021-09-15;727;1837;535357;509753;71.5;68.1
30;2021-09-16;744;1478;536101;511231;71.6;68.3
30;2021-09-17;801;2029;536902;513260;71.7;68.6
30;2021-09-18;400;1010;537302;514270;71.8;68.7
30;2021-09-19;70;158;537372;514428;71.8;68.7
30;2021-09-20;396;1200;537768;515628;71.8;68.9
30;2021-09-21;451;1156;538219;516784;71.9;69.0
30;2021-09-22;480;1379;538699;518163;72.0;69.2
30;2021-09-23;621;1199;539320;519362;72.1;69.4
30;2021-09-24;550;1627;539870;520989;72.1;69.6
30;2021-09-25;323;855;540193;521844;72.2;69.7
30;2021-09-26;54;168;540247;522012;72.2;69.7
30;2021-09-27;355;885;540602;522897;72.2;69.9
30;2021-09-28;567;890;541169;523787;72.3;70.0
30;2021-09-29;445;1064;541614;524851;72.4;70.1
31;2020-12-27;0;0;0;0;0.0;0.0
31;2020-12-28;2;0;2;0;0.0;0.0
31;2020-12-29;0;0;2;0;0.0;0.0
31;2020-12-30;0;0;2;0;0.0;0.0
31;2020-12-31;1;0;3;0;0.0;0.0
31;2021-01-01;4;0;7;0;0.0;0.0
31;2021-01-02;1;0;8;0;0.0;0.0
31;2021-01-03;2;0;10;0;0.0;0.0
31;2021-01-04;5;0;15;0;0.0;0.0
31;2021-01-05;50;0;65;0;0.0;0.0
31;2021-01-06;211;1;276;1;0.0;0.0
31;2021-01-07;284;1;560;2;0.0;0.0
31;2021-01-08;546;1;1106;3;0.1;0.0
31;2021-01-09;275;0;1381;3;0.1;0.0
31;2021-01-10;286;0;1667;3;0.1;0.0
31;2021-01-11;983;3;2650;6;0.2;0.0
31;2021-01-12;1192;1;3842;7;0.3;0.0
31;2021-01-13;1158;3;5000;10;0.4;0.0
31;2021-01-14;1179;18;6179;28;0.4;0.0
31;2021-01-15;1048;3;7227;31;0.5;0.0
31;2021-01-16;243;1;7470;32;0.5;0.0
31;2021-01-17;176;0;7646;32;0.5;0.0
31;2021-01-18;1616;5;9262;37;0.7;0.0
31;2021-01-19;2937;10;12199;47;0.9;0.0
31;2021-01-20;3683;12;15882;59;1.1;0.0
31;2021-01-21;2998;7;18880;66;1.3;0.0
31;2021-01-22;2275;4;21155;70;1.5;0.0
31;2021-01-23;728;2;21883;72;1.6;0.0
31;2021-01-24;212;1;22095;73;1.6;0.0
31;2021-01-25;1744;9;23839;82;1.7;0.0
31;2021-01-26;1839;36;25678;118;1.8;0.0
31;2021-01-27;1573;139;27251;257;1.9;0.0
31;2021-01-28;1385;282;28636;539;2.0;0.0
31;2021-01-29;1360;315;29996;854;2.1;0.1
31;2021-01-30;446;168;30442;1022;2.2;0.1
31;2021-01-31;61;191;30503;1213;2.2;0.1
31;2021-02-01;1182;664;31685;1877;2.3;0.1
31;2021-02-02;3056;760;34741;2637;2.5;0.2
31;2021-02-03;1922;736;36663;3373;2.6;0.2
31;2021-02-04;1814;790;38477;4163;2.7;0.3
31;2021-02-05;1342;542;39819;4705;2.8;0.3
31;2021-02-06;384;52;40203;4757;2.9;0.3
31;2021-02-07;37;37;40240;4794;2.9;0.3
31;2021-02-08;1116;608;41356;5402;3.0;0.4
31;2021-02-09;1679;1480;43035;6882;3.1;0.5
31;2021-02-10;1964;2269;44999;9151;3.2;0.7
31;2021-02-11;1814;1743;46813;10894;3.3;0.8
31;2021-02-12;1540;747;48353;11641;3.5;0.8
31;2021-02-13;504;211;48857;11852;3.5;0.8
31;2021-02-14;56;191;48913;12043;3.5;0.9
31;2021-02-15;443;1062;49356;13105;3.5;0.9
31;2021-02-16;462;1263;49818;14368;3.6;1.0
31;2021-02-17;472;1326;50290;15694;3.6;1.1
31;2021-02-18;476;1401;50766;17095;3.6;1.2
31;2021-02-19;393;1289;51159;18384;3.7;1.3
31;2021-02-20;69;415;51228;18799;3.7;1.3
31;2021-02-21;77;145;51305;18944;3.7;1.4
31;2021-02-22;434;1454;51739;20398;3.7;1.5
31;2021-02-23;864;2661;52603;23059;3.8;1.6
31;2021-02-24;652;1930;53255;24989;3.8;1.8
31;2021-02-25;1435;1617;54690;26606;3.9;1.9
31;2021-02-26;1711;988;56401;27594;4.0;2.0
31;2021-02-27;638;306;57039;27900;4.1;2.0
31;2021-02-28;78;54;57117;27954;4.1;2.0
31;2021-03-01;875;943;57992;28897;4.1;2.1
31;2021-03-02;1240;1437;59232;30334;4.2;2.2
31;2021-03-03;1355;1626;60587;31960;4.3;2.3
31;2021-03-04;2423;1317;63010;33277;4.5;2.4
31;2021-03-05;3054;1438;66064;34715;4.7;2.5
31;2021-03-06;2834;355;68898;35070;4.9;2.5
31;2021-03-07;5368;108;74266;35178;5.3;2.5
31;2021-03-08;1598;966;75864;36144;5.4;2.6
31;2021-03-09;2792;1041;78656;37185;5.6;2.7
31;2021-03-10;2574;993;81230;38178;5.8;2.7
31;2021-03-11;4382;1061;85612;39239;6.1;2.8
31;2021-03-12;5319;1102;90931;40341;6.5;2.9
31;2021-03-13;2838;473;93769;40814;6.7;2.9
31;2021-03-14;235;49;94004;40863;6.7;2.9
31;2021-03-15;2584;414;96588;41277;6.9;2.9
31;2021-03-16;1747;778;98335;42055;7.0;3.0
31;2021-03-17;1656;541;99991;42596;7.1;3.0
31;2021-03-18;1988;698;101979;43294;7.3;3.1
31;2021-03-19;3185;520;105164;43814;7.5;3.1
31;2021-03-20;1797;136;106961;43950;7.6;3.1
31;2021-03-21;211;24;107172;43974;7.7;3.1
31;2021-03-22;2579;355;109751;44329;7.8;3.2
31;2021-03-23;4057;317;113808;44646;8.1;3.2
31;2021-03-24;4356;288;118164;44934;8.4;3.2
31;2021-03-25;6041;515;124205;45449;8.9;3.2
31;2021-03-26;5466;507;129671;45956;9.3;3.3
31;2021-03-27;4350;208;134021;46164;9.6;3.3
31;2021-03-28;2291;48;136312;46212;9.7;3.3
31;2021-03-29;4206;430;140518;46642;10.0;3.3
31;2021-03-30;6595;552;147113;47194;10.5;3.4
31;2021-03-31;5649;382;152762;47576;10.9;3.4
31;2021-04-01;6967;552;159729;48128;11.4;3.4
31;2021-04-02;6102;574;165831;48702;11.8;3.5
31;2021-04-03;3927;151;169758;48853;12.1;3.5
31;2021-04-04;2060;113;171818;48966;12.3;3.5
31;2021-04-05;481;71;172299;49037;12.3;3.5
31;2021-04-06;4165;1143;176464;50180;12.6;3.6
31;2021-04-07;5988;981;182452;51161;13.0;3.7
31;2021-04-08;7568;1037;190020;52198;13.6;3.7
31;2021-04-09;8385;1257;198405;53455;14.2;3.8
31;2021-04-10;4716;543;203121;53998;14.5;3.9
31;2021-04-11;2069;136;205190;54134;14.6;3.9
31;2021-04-12;6001;1834;211191;55968;15.1;4.0
31;2021-04-13;8047;2014;219238;57982;15.6;4.1
31;2021-04-14;6655;1900;225893;59882;16.1;4.3
31;2021-04-15;7771;2238;233664;62120;16.7;4.4
31;2021-04-16;7177;2092;240841;64212;17.2;4.6
31;2021-04-17;4413;904;245254;65116;17.5;4.6
31;2021-04-18;2513;355;247767;65471;17.7;4.7
31;2021-04-19;5220;2020;252987;67491;18.1;4.8
31;2021-04-20;6073;2835;259060;70326;18.5;5.0
31;2021-04-21;5974;2786;265034;73112;18.9;5.2
31;2021-04-22;6379;3236;271413;76348;19.4;5.4
31;2021-04-23;6282;2550;277695;78898;19.8;5.6
31;2021-04-24;1616;3137;279311;82035;19.9;5.9
31;2021-04-25;688;2092;279999;84127;20.0;6.0
31;2021-04-26;3794;3212;283793;87339;20.3;6.2
31;2021-04-27;4517;3875;288310;91214;20.6;6.5
31;2021-04-28;4545;3550;292855;94764;20.9;6.8
31;2021-04-29;5181;4054;298036;98818;21.3;7.1
31;2021-04-30;5037;4121;303073;102939;21.6;7.3
31;2021-05-01;1487;3114;304560;106053;21.7;7.6
31;2021-05-02;1414;1979;305974;108032;21.8;7.7
31;2021-05-03;5658;2416;311632;110448;22.2;7.9
31;2021-05-04;4779;4739;316411;115187;22.6;8.2
31;2021-05-05;2994;5712;319405;120899;22.8;8.6
31;2021-05-06;3635;7376;323040;128275;23.1;9.2
31;2021-05-07;5256;7146;328296;135421;23.4;9.7
31;2021-05-08;3633;3102;331929;138523;23.7;9.9
31;2021-05-09;3760;2307;335689;140830;24.0;10.1
31;2021-05-10;5683;5471;341372;146301;24.4;10.4
31;2021-05-11;6605;6680;347977;152981;24.8;10.9
31;2021-05-12;6171;5926;354148;158907;25.3;11.3
31;2021-05-13;4642;2066;358790;160973;25.6;11.5
31;2021-05-14;6910;3974;365700;164947;26.1;11.8
31;2021-05-15;5145;1753;370845;166700;26.5;11.9
31;2021-05-16;3299;633;374144;167333;26.7;11.9
31;2021-05-17;5143;4148;379287;171481;27.1;12.2
31;2021-05-18;5588;4270;384875;175751;27.5;12.5
31;2021-05-19;5782;3762;390657;179513;27.9;12.8
31;2021-05-20;6473;4787;397130;184300;28.3;13.2
31;2021-05-21;5985;4594;403115;188894;28.8;13.5
31;2021-05-22;4081;1628;407196;190522;29.1;13.6
31;2021-05-23;3583;342;410779;190864;29.3;13.6
31;2021-05-24;3881;706;414660;191570;29.6;13.7
31;2021-05-25;6189;3607;420849;195177;30.0;13.9
31;2021-05-26;5607;4643;426456;199820;30.4;14.3
31;2021-05-27;4788;6183;431244;206003;30.8;14.7
31;2021-05-28;4116;6344;435360;212347;31.1;15.2
31;2021-05-29;1917;4024;437277;216371;31.2;15.4
31;2021-05-30;751;2361;438028;218732;31.3;15.6
31;2021-05-31;4397;5072;442425;223804;31.6;16.0
31;2021-06-01;5953;6558;448378;230362;32.0;16.4
31;2021-06-02;5802;6296;454180;236658;32.4;16.9
31;2021-06-03;7309;8133;461489;244791;32.9;17.5
31;2021-06-04;7542;7149;469031;251940;33.5;18.0
31;2021-06-05;9077;2771;478108;254711;34.1;18.2
31;2021-06-06;8106;1579;486214;256290;34.7;18.3
31;2021-06-07;7987;5471;494201;261761;35.3;18.7
31;2021-06-08;9106;6043;503307;267804;35.9;19.1
31;2021-06-09;8918;5551;512225;273355;36.6;19.5
31;2021-06-10;9781;6351;522006;279706;37.3;20.0
31;2021-06-11;10047;6626;532053;286332;38.0;20.4
31;2021-06-12;8788;3022;540841;289354;38.6;20.7
31;2021-06-13;8378;2018;549219;291372;39.2;20.8
31;2021-06-14;8428;6728;557647;298100;39.8;21.3
31;2021-06-15;9774;7445;567421;305545;40.5;21.8
31;2021-06-16;8735;5255;576156;310800;41.1;22.2
31;2021-06-17;8278;6602;584434;317402;41.7;22.7
31;2021-06-18;8551;7753;592985;325155;42.3;23.2
31;2021-06-19;7364;5440;600349;330595;42.9;23.6
31;2021-06-20;5572;3727;605921;334322;43.3;23.9
31;2021-06-21;5372;6916;611293;341238;43.6;24.4
31;2021-06-22;4987;8228;616280;349466;44.0;24.9
31;2021-06-23;5105;7283;621385;356749;44.4;25.5
31;2021-06-24;4633;8323;626018;365072;44.7;26.1
31;2021-06-25;5014;9309;631032;374381;45.0;26.7
31;2021-06-26;4282;6398;635314;380779;45.3;27.2
31;2021-06-27;3596;4106;638910;384885;45.6;27.5
31;2021-06-28;4097;6642;643007;391527;45.9;27.9
31;2021-06-29;3798;7559;646805;399086;46.2;28.5
31;2021-06-30;4280;7819;651085;406905;46.5;29.0
31;2021-07-01;4121;8461;655206;415366;46.8;29.6
31;2021-07-02;4108;9327;659314;424693;47.1;30.3
31;2021-07-03;4100;6111;663414;430804;47.4;30.8
31;2021-07-04;3205;4811;666619;435615;47.6;31.1
31;2021-07-05;4057;7093;670676;442708;47.9;31.6
31;2021-07-06;3888;8362;674564;451070;48.2;32.2
31;2021-07-07;3964;7961;678528;459031;48.4;32.8
31;2021-07-08;4054;8536;682582;467567;48.7;33.4
31;2021-07-09;4461;8799;687043;476366;49.0;34.0
31;2021-07-10;3918;5494;690961;481860;49.3;34.4
31;2021-07-11;3137;4137;694098;485997;49.5;34.7
31;2021-07-12;3824;8635;697922;494632;49.8;35.3
31;2021-07-13;6918;9444;704840;504076;50.3;36.0
31;2021-07-14;6167;3938;711007;508014;50.8;36.3
31;2021-07-15;8516;9451;719523;517465;51.4;36.9
31;2021-07-16;7775;9908;727298;527373;51.9;37.6
31;2021-07-17;8357;10556;735655;537929;52.5;38.4
31;2021-07-18;6620;9472;742275;547401;53.0;39.1
31;2021-07-19;4793;10775;747068;558176;53.3;39.8
31;2021-07-20;7159;11480;754227;569656;53.8;40.7
31;2021-07-21;7039;11529;761266;581185;54.3;41.5
31;2021-07-22;8165;11757;769431;592942;54.9;42.3
31;2021-07-23;7474;11811;776905;604753;55.5;43.2
31;2021-07-24;10312;10571;787217;615324;56.2;43.9
31;2021-07-25;7560;8801;794777;624125;56.7;44.6
31;2021-07-26;5513;9543;800290;633668;57.1;45.2
31;2021-07-27;7961;9196;808251;642864;57.7;45.9
31;2021-07-28;8677;8282;816928;651146;58.3;46.5
31;2021-07-29;8853;8047;825781;659193;58.9;47.1
31;2021-07-30;7672;7987;833453;667180;59.5;47.6
31;2021-07-31;6015;7393;839468;674573;59.9;48.2
31;2021-08-01;4430;4302;843898;678875;60.2;48.5
31;2021-08-02;5487;5418;849385;684293;60.6;48.8
31;2021-08-03;5895;5186;855280;689479;61.1;49.2
31;2021-08-04;5924;4803;861204;694282;61.5;49.6
31;2021-08-05;5585;7230;866789;701512;61.9;50.1
31;2021-08-06;5301;7343;872090;708855;62.3;50.6
31;2021-08-07;4596;6651;876686;715506;62.6;51.1
31;2021-08-08;3385;5578;880071;721084;62.8;51.5
31;2021-08-09;4396;7010;884467;728094;63.1;52.0
31;2021-08-10;4686;6284;889153;734378;63.5;52.4
31;2021-08-11;4525;5858;893678;740236;63.8;52.8
31;2021-08-12;4522;6757;898200;746993;64.1;53.3
31;2021-08-13;4170;6201;902370;753194;64.4;53.8
31;2021-08-14;3033;6461;905403;759655;64.6;54.2
31;2021-08-15;1308;4096;906711;763751;64.7;54.5
31;2021-08-16;3219;8117;909930;771868;65.0;55.1
31;2021-08-17;3433;7096;913363;778964;65.2;55.6
31;2021-08-18;3314;7006;916677;785970;65.4;56.1
31;2021-08-19;2987;6994;919664;792964;65.6;56.6
31;2021-08-20;3019;7395;922683;800359;65.9;57.1
31;2021-08-21;1979;6798;924662;807157;66.0;57.6
31;2021-08-22;1486;5636;926148;812793;66.1;58.0
31;2021-08-23;2369;7728;928517;820521;66.3;58.6
31;2021-08-24;2557;6173;931074;826694;66.5;59.0
31;2021-08-25;2389;5728;933463;832422;66.6;59.4
31;2021-08-26;2270;5798;935733;838220;66.8;59.8
31;2021-08-27;2356;6662;938089;844882;67.0;60.3
31;2021-08-28;1835;6788;939924;851670;67.1;60.8
31;2021-08-29;1281;5066;941205;856736;67.2;61.2
31;2021-08-30;2141;6631;943346;863367;67.3;61.6
31;2021-08-31;2255;5571;945601;868938;67.5;62.0
31;2021-09-01;1695;5059;947296;873997;67.6;62.4
31;2021-09-02;1757;4522;949053;878519;67.7;62.7
31;2021-09-03;1778;5203;950831;883722;67.9;63.1
31;2021-09-04;2005;5941;952836;889663;68.0;63.5
31;2021-09-05;1128;2400;953964;892063;68.1;63.7
31;2021-09-06;1361;3586;955325;895649;68.2;63.9
31;2021-09-07;1259;3351;956584;899000;68.3;64.2
31;2021-09-08;1416;3952;958000;902952;68.4;64.5
31;2021-09-09;1078;3115;959078;906067;68.5;64.7
31;2021-09-10;1654;3962;960732;910029;68.6;65.0
31;2021-09-11;1284;3989;962016;914018;68.7;65.2
31;2021-09-12;539;1814;962555;915832;68.7;65.4
31;2021-09-13;1009;2628;963564;918460;68.8;65.6
31;2021-09-14;1231;2798;964795;921258;68.9;65.8
31;2021-09-15;1082;2690;965877;923948;68.9;66.0
31;2021-09-16;894;1675;966771;925623;69.0;66.1
31;2021-09-17;1072;2505;967843;928128;69.1;66.3
31;2021-09-18;851;2798;968694;930926;69.1;66.5
31;2021-09-19;318;1237;969012;932163;69.2;66.5
31;2021-09-20;606;1599;969618;933762;69.2;66.7
31;2021-09-21;819;1560;970437;935322;69.3;66.8
31;2021-09-22;831;2055;971268;937377;69.3;66.9
31;2021-09-23;771;1545;972039;938922;69.4;67.0
31;2021-09-24;837;2013;972876;940935;69.4;67.2
31;2021-09-25;662;2532;973538;943467;69.5;67.3
31;2021-09-26;245;1127;973783;944594;69.5;67.4
31;2021-09-27;678;1500;974461;946094;69.6;67.5
31;2021-09-28;727;1347;975188;947441;69.6;67.6
31;2021-09-29;725;1656;975913;949097;69.7;67.7
32;2020-12-27;0;0;0;0;0.0;0.0
32;2020-12-28;0;0;0;0;0.0;0.0
32;2020-12-29;0;0;0;0;0.0;0.0
32;2020-12-30;0;0;0;0;0.0;0.0
32;2020-12-31;0;0;0;0;0.0;0.0
32;2021-01-01;0;0;0;0;0.0;0.0
32;2021-01-02;0;0;0;0;0.0;0.0
32;2021-01-03;1;0;1;0;0.0;0.0
32;2021-01-04;3;0;4;0;0.0;0.0
32;2021-01-05;1;0;5;0;0.0;0.0
32;2021-01-06;3;0;8;0;0.0;0.0
32;2021-01-07;155;0;163;0;0.1;0.0
32;2021-01-08;70;0;233;0;0.1;0.0
32;2021-01-09;5;0;238;0;0.1;0.0
32;2021-01-10;0;0;238;0;0.1;0.0
32;2021-01-11;11;0;249;0;0.1;0.0
32;2021-01-12;96;0;345;0;0.2;0.0
32;2021-01-13;325;1;670;1;0.4;0.0
32;2021-01-14;389;3;1059;4;0.6;0.0
32;2021-01-15;448;2;1507;6;0.8;0.0
32;2021-01-16;17;2;1524;8;0.8;0.0
32;2021-01-17;1;0;1525;8;0.8;0.0
32;2021-01-18;345;1;1870;9;1.0;0.0
32;2021-01-19;420;0;2290;9;1.2;0.0
32;2021-01-20;358;0;2648;9;1.4;0.0
32;2021-01-21;582;0;3230;9;1.7;0.0
32;2021-01-22;372;0;3602;9;1.9;0.0
32;2021-01-23;189;0;3791;9;2.0;0.0
32;2021-01-24;5;0;3796;9;2.0;0.0
32;2021-01-25;468;1;4264;10;2.2;0.0
32;2021-01-26;609;0;4873;10;2.6;0.0
32;2021-01-27;703;4;5576;14;2.9;0.0
32;2021-01-28;687;12;6263;26;3.3;0.0
32;2021-01-29;461;49;6724;75;3.5;0.0
32;2021-01-30;260;0;6984;75;3.7;0.0
32;2021-01-31;4;5;6988;80;3.7;0.0
32;2021-02-01;289;57;7277;137;3.8;0.1
32;2021-02-02;639;135;7916;272;4.2;0.1
32;2021-02-03;338;196;8254;468;4.3;0.2
32;2021-02-04;426;271;8680;739;4.6;0.4
32;2021-02-05;348;354;9028;1093;4.8;0.6
32;2021-02-06;148;0;9176;1093;4.8;0.6
32;2021-02-07;0;36;9176;1129;4.8;0.6
32;2021-02-08;278;108;9454;1237;5.0;0.7
32;2021-02-09;310;225;9764;1462;5.1;0.8
32;2021-02-10;272;242;10036;1704;5.3;0.9
32;2021-02-11;383;301;10419;2005;5.5;1.1
32;2021-02-12;298;226;10717;2231;5.6;1.2
32;2021-02-13;249;1;10966;2232;5.8;1.2
32;2021-02-14;0;28;10966;2260;5.8;1.2
32;2021-02-15;25;183;10991;2443;5.8;1.3
32;2021-02-16;393;337;11384;2780;6.0;1.5
32;2021-02-17;192;437;11576;3217;6.1;1.7
32;2021-02-18;331;422;11907;3639;6.3;1.9
32;2021-02-19;184;264;12091;3903;6.4;2.1
32;2021-02-20;1;70;12092;3973;6.4;2.1
32;2021-02-21;0;0;12092;3973;6.4;2.1
32;2021-02-22;158;332;12250;4305;6.4;2.3
32;2021-02-23;431;517;12681;4822;6.7;2.5
32;2021-02-24;277;335;12958;5157;6.8;2.7
32;2021-02-25;481;479;13439;5636;7.1;3.0
32;2021-02-26;444;360;13883;5996;7.3;3.2
32;2021-02-27;157;214;14040;6210;7.4;3.3
32;2021-02-28;4;0;14044;6210;7.4;3.3
32;2021-03-01;51;277;14095;6487;7.4;3.4
32;2021-03-02;415;406;14510;6893;7.6;3.6
32;2021-03-03;276;268;14786;7161;7.8;3.8
32;2021-03-04;542;320;15328;7481;8.1;3.9
32;2021-03-05;438;228;15766;7709;8.3;4.1
32;2021-03-06;520;150;16286;7859;8.6;4.1
32;2021-03-07;25;5;16311;7864;8.6;4.1
32;2021-03-08;234;278;16545;8142;8.7;4.3
32;2021-03-09;643;312;17188;8454;9.0;4.4
32;2021-03-10;482;318;17670;8772;9.3;4.6
32;2021-03-11;854;283;18524;9055;9.7;4.8
32;2021-03-12;881;334;19405;9389;10.2;4.9
32;2021-03-13;492;232;19897;9621;10.5;5.1
32;2021-03-14;1;0;19898;9621;10.5;5.1
32;2021-03-15;264;25;20162;9646;10.6;5.1
32;2021-03-16;314;303;20476;9949;10.8;5.2
32;2021-03-17;150;153;20626;10102;10.9;5.3
32;2021-03-18;375;304;21001;10406;11.1;5.5
32;2021-03-19;405;179;21406;10585;11.3;5.6
32;2021-03-20;136;33;21542;10618;11.3;5.6
32;2021-03-21;0;0;21542;10618;11.3;5.6
32;2021-03-22;340;167;21882;10785;11.5;5.7
32;2021-03-23;560;397;22442;11182;11.8;5.9
32;2021-03-24;643;267;23085;11449;12.1;6.0
32;2021-03-25;899;413;23984;11862;12.6;6.2
32;2021-03-26;657;293;24641;12155;13.0;6.4
32;2021-03-27;165;3;24806;12158;13.1;6.4
32;2021-03-28;1;1;24807;12159;13.1;6.4
32;2021-03-29;371;48;25178;12207;13.2;6.4
32;2021-03-30;766;287;25944;12494;13.7;6.6
32;2021-03-31;654;170;26598;12664;14.0;6.7
32;2021-04-01;1238;318;27836;12982;14.6;6.8
32;2021-04-02;575;167;28411;13149;15.0;6.9
32;2021-04-03;114;0;28525;13149;15.0;6.9
32;2021-04-04;0;0;28525;13149;15.0;6.9
32;2021-04-05;0;0;28525;13149;15.0;6.9
32;2021-04-06;2650;310;31175;13459;16.4;7.1
32;2021-04-07;1178;202;32353;13661;17.0;7.2
32;2021-04-08;1736;405;34089;14066;17.9;7.4
32;2021-04-09;883;218;34972;14284;18.4;7.5
32;2021-04-10;809;29;35781;14313;18.8;7.5
32;2021-04-11;14;0;35795;14313;18.8;7.5
32;2021-04-12;477;23;36272;14336;19.1;7.5
32;2021-04-13;2469;389;38741;14725;20.4;7.7
32;2021-04-14;1226;263;39967;14988;21.0;7.9
32;2021-04-15;1704;392;41671;15380;21.9;8.1
32;2021-04-16;638;282;42309;15662;22.3;8.2
32;2021-04-17;783;39;43092;15701;22.7;8.3
32;2021-04-18;13;1;43105;15702;22.7;8.3
32;2021-04-19;502;45;43607;15747;22.9;8.3
32;2021-04-20;2472;393;46079;16140;24.2;8.5
32;2021-04-21;1009;302;47088;16442;24.8;8.7
32;2021-04-22;1662;319;48750;16761;25.7;8.8
32;2021-04-23;549;158;49299;16919;25.9;8.9
32;2021-04-24;1392;57;50691;16976;26.7;8.9
32;2021-04-25;0;11;50691;16987;26.7;8.9
32;2021-04-26;387;359;51078;17346;26.9;9.1
32;2021-04-27;2551;556;53629;17902;28.2;9.4
32;2021-04-28;972;354;54601;18256;28.7;9.6
32;2021-04-29;1008;883;55609;19139;29.3;10.1
32;2021-04-30;453;363;56062;19502;29.5;10.3
32;2021-05-01;2607;97;58669;19599;30.9;10.3
32;2021-05-02;0;0;58669;19599;30.9;10.3
32;2021-05-03;170;321;58839;19920;31.0;10.5
32;2021-05-04;785;2490;59624;22410;31.4;11.8
32;2021-05-05;2360;1098;61984;23508;32.6;12.4
32;2021-05-06;516;1655;62500;25163;32.9;13.2
32;2021-05-07;2286;538;64786;25701;34.1;13.5
32;2021-05-08;70;516;64856;26217;34.1;13.8
32;2021-05-09;21;179;64877;26396;34.1;13.9
32;2021-05-10;1994;549;66871;26945;35.2;14.2
32;2021-05-11;651;2276;67522;29221;35.5;15.4
32;2021-05-12;2313;1137;69835;30358;36.7;16.0
32;2021-05-13;280;1417;70115;31775;36.9;16.7
32;2021-05-14;2223;328;72338;32103;38.1;16.9
32;2021-05-15;134;712;72472;32815;38.1;17.3
32;2021-05-16;2;0;72474;32815;38.1;17.3
32;2021-05-17;353;169;72827;32984;38.3;17.4
32;2021-05-18;1642;298;74469;33282;39.2;17.5
32;2021-05-19;2474;272;76943;33554;40.5;17.7
32;2021-05-20;2885;470;79828;34024;42.0;17.9
32;2021-05-21;2532;499;82360;34523;43.3;18.2
32;2021-05-22;334;110;82694;34633;43.5;18.2
32;2021-05-23;2;13;82696;34646;43.5;18.2
32;2021-05-24;3;0;82699;34646;43.5;18.2
32;2021-05-25;1982;373;84681;35019;44.6;18.4
32;2021-05-26;2547;556;87228;35575;45.9;18.7
32;2021-05-27;2876;626;90104;36201;47.4;19.0
32;2021-05-28;2308;766;92412;36967;48.6;19.5
32;2021-05-29;372;313;92784;37280;48.8;19.6
32;2021-05-30;4;6;92788;37286;48.8;19.6
32;2021-05-31;1413;625;94201;37911;49.6;19.9
32;2021-06-01;566;2887;94767;40798;49.9;21.5
32;2021-06-02;1580;1351;96347;42149;50.7;22.2
32;2021-06-03;395;2085;96742;44234;50.9;23.3
32;2021-06-04;1836;831;98578;45065;51.9;23.7
32;2021-06-05;206;1660;98784;46725;52.0;24.6
32;2021-06-06;8;14;98792;46739;52.0;24.6
32;2021-06-07;102;418;98894;47157;52.0;24.8
32;2021-06-08;663;2536;99557;49693;52.4;26.1
32;2021-06-09;1191;1056;100748;50749;53.0;26.7
32;2021-06-10;684;1225;101432;51974;53.4;27.3
32;2021-06-11;926;663;102358;52637;53.9;27.7
32;2021-06-12;150;2679;102508;55316;53.9;29.1
32;2021-06-13;1;1;102509;55317;53.9;29.1
32;2021-06-14;528;210;103037;55527;54.2;29.2
32;2021-06-15;1733;1025;104770;56552;55.1;29.8
32;2021-06-16;850;2777;105620;59329;55.6;31.2
32;2021-06-17;859;828;106479;60157;56.0;31.7
32;2021-06-18;315;2723;106794;62880;56.2;33.1
32;2021-06-19;914;437;107708;63317;56.7;33.3
32;2021-06-20;5;13;107713;63330;56.7;33.3
32;2021-06-21;67;1994;107780;65324;56.7;34.4
32;2021-06-22;1042;970;108822;66294;57.3;34.9
32;2021-06-23;516;2183;109338;68477;57.5;36.0
32;2021-06-24;528;517;109866;68994;57.8;36.3
32;2021-06-25;501;2360;110367;71354;58.1;37.5
32;2021-06-26;108;171;110475;71525;58.1;37.6
32;2021-06-27;2;5;110477;71530;58.1;37.6
32;2021-06-28;630;603;111107;72133;58.5;38.0
32;2021-06-29;800;1982;111907;74115;58.9;39.0
32;2021-06-30;757;2726;112664;76841;59.3;40.4
32;2021-07-01;538;2637;113202;79478;59.6;41.8
32;2021-07-02;641;2335;113843;81813;59.9;43.1
32;2021-07-03;481;506;114324;82319;60.2;43.3
32;2021-07-04;1;12;114325;82331;60.2;43.3
32;2021-07-05;76;390;114401;82721;60.2;43.5
32;2021-07-06;878;2083;115279;84804;60.7;44.6
32;2021-07-07;781;2756;116060;87560;61.1;46.1
32;2021-07-08;479;2268;116539;89828;61.3;47.3
32;2021-07-09;615;2226;117154;92054;61.6;48.4
32;2021-07-10;536;520;117690;92574;61.9;48.7
32;2021-07-11;0;5;117690;92579;61.9;48.7
32;2021-07-12;526;1244;118216;93823;62.2;49.4
32;2021-07-13;1695;1817;119911;95640;63.1;50.3
32;2021-07-14;492;35;120403;95675;63.4;50.3
32;2021-07-15;2096;892;122499;96567;64.5;50.8
32;2021-07-16;1170;1915;123669;98482;65.1;51.8
32;2021-07-17;78;129;123747;98611;65.1;51.9
32;2021-07-18;2;5;123749;98616;65.1;51.9
32;2021-07-19;1997;147;125746;98763;66.2;52.0
32;2021-07-20;2036;1271;127782;100034;67.2;52.6
32;2021-07-21;1614;1691;129396;101725;68.1;53.5
32;2021-07-22;1946;513;131342;102238;69.1;53.8
32;2021-07-23;1408;1731;132750;103969;69.9;54.7
32;2021-07-24;139;117;132889;104086;69.9;54.8
32;2021-07-25;34;10;132923;104096;69.9;54.8
32;2021-07-26;1071;1070;133994;105166;70.5;55.3
32;2021-07-27;1730;2099;135724;107265;71.4;56.4
32;2021-07-28;694;975;136418;108240;71.8;57.0
32;2021-07-29;1694;1607;138112;109847;72.7;57.8
32;2021-07-30;363;348;138475;110195;72.9;58.0
32;2021-07-31;186;350;138661;110545;73.0;58.2
32;2021-08-01;18;4;138679;110549;73.0;58.2
32;2021-08-02;82;76;138761;110625;73.0;58.2
32;2021-08-03;1174;1792;139935;112417;73.6;59.2
32;2021-08-04;633;652;140568;113069;74.0;59.5
32;2021-08-05;1104;1944;141672;115013;74.5;60.5
32;2021-08-06;563;495;142235;115508;74.8;60.8
32;2021-08-07;148;92;142383;115600;74.9;60.8
32;2021-08-08;1;0;142384;115600;74.9;60.8
32;2021-08-09;263;1826;142647;117426;75.1;61.8
32;2021-08-10;715;2076;143362;119502;75.4;62.9
32;2021-08-11;579;446;143941;119948;75.7;63.1
32;2021-08-12;933;2102;144874;122050;76.2;64.2
32;2021-08-13;178;249;145052;122299;76.3;64.4
32;2021-08-14;113;117;145165;122416;76.4;64.4
32;2021-08-15;13;21;145178;122437;76.4;64.4
32;2021-08-16;41;40;145219;122477;76.4;64.4
32;2021-08-17;573;2300;145792;124777;76.7;65.7
32;2021-08-18;310;559;146102;125336;76.9;66.0
32;2021-08-19;954;1411;147056;126747;77.4;66.7
32;2021-08-20;155;165;147211;126912;77.5;66.8
32;2021-08-21;150;192;147361;127104;77.5;66.9
32;2021-08-22;8;3;147369;127107;77.5;66.9
32;2021-08-23;42;101;147411;127208;77.6;66.9
32;2021-08-24;584;1449;147995;128657;77.9;67.7
32;2021-08-25;94;191;148089;128848;77.9;67.8
32;2021-08-26;320;2260;148409;131108;78.1;69.0
32;2021-08-27;274;553;148683;131661;78.2;69.3
32;2021-08-28;70;109;148753;131770;78.3;69.3
32;2021-08-29;1;8;148754;131778;78.3;69.3
32;2021-08-30;19;50;148773;131828;78.3;69.4
32;2021-08-31;194;1536;148967;133364;78.4;70.2
32;2021-09-01;649;829;149616;134193;78.7;70.6
32;2021-09-02;317;1733;149933;135926;78.9;71.5
32;2021-09-03;186;314;150119;136240;79.0;71.7
32;2021-09-04;49;106;150168;136346;79.0;71.7
32;2021-09-05;11;15;150179;136361;79.0;71.8
32;2021-09-06;38;103;150217;136464;79.0;71.8
32;2021-09-07;438;950;150655;137414;79.3;72.3
32;2021-09-08;255;551;150910;137965;79.4;72.6
32;2021-09-09;225;1063;151135;139028;79.5;73.2
32;2021-09-10;203;241;151338;139269;79.6;73.3
32;2021-09-11;88;160;151426;139429;79.7;73.4
32;2021-09-12;7;11;151433;139440;79.7;73.4
32;2021-09-13;4;12;151437;139452;79.7;73.4
32;2021-09-14;319;845;151756;140297;79.9;73.8
32;2021-09-15;200;145;151956;140442;80.0;73.9
32;2021-09-16;180;215;152136;140657;80.1;74.0
32;2021-09-17;199;345;152335;141002;80.2;74.2
32;2021-09-18;40;62;152375;141064;80.2;74.2
32;2021-09-19;0;2;152375;141066;80.2;74.2
32;2021-09-20;4;18;152379;141084;80.2;74.2
32;2021-09-21;241;458;152620;141542;80.3;74.5
32;2021-09-22;233;545;152853;142087;80.4;74.8
32;2021-09-23;132;219;152985;142306;80.5;74.9
32;2021-09-24;101;287;153086;142593;80.6;75.0
32;2021-09-25;28;51;153114;142644;80.6;75.1
32;2021-09-26;2;5;153116;142649;80.6;75.1
32;2021-09-27;9;29;153125;142678;80.6;75.1
32;2021-09-28;112;515;153237;143193;80.6;75.3
32;2021-09-29;86;334;153323;143527;80.7;75.5
33;2020-12-27;4;0;4;0;0.0;0.0
33;2020-12-28;4;0;8;0;0.0;0.0
33;2020-12-29;0;0;8;0;0.0;0.0
33;2020-12-30;0;0;8;0;0.0;0.0
33;2020-12-31;1;0;9;0;0.0;0.0
33;2021-01-01;0;0;9;0;0.0;0.0
33;2021-01-02;2;0;11;0;0.0;0.0
33;2021-01-03;2;0;13;0;0.0;0.0
33;2021-01-04;2;0;15;0;0.0;0.0
33;2021-01-05;2;0;17;0;0.0;0.0
33;2021-01-06;135;0;152;0;0.0;0.0
33;2021-01-07;1309;1;1461;1;0.1;0.0
33;2021-01-08;1200;2;2661;3;0.2;0.0
33;2021-01-09;298;0;2959;3;0.2;0.0
33;2021-01-10;229;0;3188;3;0.2;0.0
33;2021-01-11;627;0;3815;3;0.2;0.0
33;2021-01-12;1415;2;5230;5;0.3;0.0
33;2021-01-13;1313;9;6543;14;0.4;0.0
33;2021-01-14;1291;12;7834;26;0.5;0.0
33;2021-01-15;1609;11;9443;37;0.6;0.0
33;2021-01-16;568;6;10011;43;0.6;0.0
33;2021-01-17;406;2;10417;45;0.6;0.0
33;2021-01-18;1224;9;11641;54;0.7;0.0
33;2021-01-19;2935;8;14576;62;0.9;0.0
33;2021-01-20;3421;12;17997;74;1.1;0.0
33;2021-01-21;2864;3;20861;77;1.3;0.0
33;2021-01-22;2328;7;23189;84;1.4;0.0
33;2021-01-23;854;2;24043;86;1.5;0.0
33;2021-01-24;532;2;24575;88;1.5;0.0
33;2021-01-25;2173;54;26748;142;1.6;0.0
33;2021-01-26;2263;145;29011;287;1.8;0.0
33;2021-01-27;2263;188;31274;475;1.9;0.0
33;2021-01-28;2160;409;33434;884;2.0;0.1
33;2021-01-29;1825;633;35259;1517;2.2;0.1
33;2021-01-30;705;155;35964;1672;2.2;0.1
33;2021-01-31;390;133;36354;1805;2.2;0.1
33;2021-02-01;1457;603;37811;2408;2.3;0.1
33;2021-02-02;2646;1033;40457;3441;2.5;0.2
33;2021-02-03;2938;829;43395;4270;2.7;0.3
33;2021-02-04;4030;1276;47425;5546;2.9;0.3
33;2021-02-05;2192;1094;49617;6640;3.0;0.4
33;2021-02-06;648;172;50265;6812;3.1;0.4
33;2021-02-07;218;182;50483;6994;3.1;0.4
33;2021-02-08;1265;681;51748;7675;3.2;0.5
33;2021-02-09;1327;1431;53075;9106;3.2;0.6
33;2021-02-10;1267;1526;54342;10632;3.3;0.7
33;2021-02-11;1306;1294;55648;11926;3.4;0.7
33;2021-02-12;1121;1076;56769;13002;3.5;0.8
33;2021-02-13;204;241;56973;13243;3.5;0.8
33;2021-02-14;47;192;57020;13435;3.5;0.8
33;2021-02-15;685;1339;57705;14774;3.5;0.9
33;2021-02-16;816;1674;58521;16448;3.6;1.0
33;2021-02-17;668;1672;59189;18120;3.6;1.1
33;2021-02-18;899;1777;60088;19897;3.7;1.2
33;2021-02-19;918;1666;61006;21563;3.7;1.3
33;2021-02-20;78;458;61084;22021;3.7;1.3
33;2021-02-21;37;349;61121;22370;3.7;1.4
33;2021-02-22;709;1476;61830;23846;3.8;1.5
33;2021-02-23;1235;2147;63065;25993;3.9;1.6
33;2021-02-24;1402;2048;64467;28041;3.9;1.7
33;2021-02-25;2837;3207;67304;31248;4.1;1.9
33;2021-02-26;4059;1986;71363;33234;4.4;2.0
33;2021-02-27;1360;558;72723;33792;4.5;2.1
33;2021-02-28;127;424;72850;34216;4.5;2.1
33;2021-03-01;1535;1562;74385;35778;4.6;2.2
33;2021-03-02;2325;1494;76710;37272;4.7;2.3
33;2021-03-03;2312;1474;79022;38746;4.8;2.4
33;2021-03-04;3936;1460;82958;40206;5.1;2.5
33;2021-03-05;5762;1516;88720;41722;5.4;2.6
33;2021-03-06;3417;502;92137;42224;5.6;2.6
33;2021-03-07;741;139;92878;42363;5.7;2.6
33;2021-03-08;2712;992;95590;43355;5.9;2.7
33;2021-03-09;4404;1157;99994;44512;6.1;2.7
33;2021-03-10;5121;1126;105115;45638;6.4;2.8
33;2021-03-11;7545;1138;112660;46776;6.9;2.9
33;2021-03-12;10118;1098;122778;47874;7.5;2.9
33;2021-03-13;5155;206;127933;48080;7.8;2.9
33;2021-03-14;714;28;128647;48108;7.9;2.9
33;2021-03-15;4443;660;133090;48768;8.1;3.0
33;2021-03-16;3582;814;136672;49582;8.4;3.0
33;2021-03-17;3643;920;140315;50502;8.6;3.1
33;2021-03-18;4037;1388;144352;51890;8.8;3.2
33;2021-03-19;6270;1013;150622;52903;9.2;3.2
33;2021-03-20;3368;105;153990;53008;9.4;3.2
33;2021-03-21;462;29;154452;53037;9.5;3.2
33;2021-03-22;4901;442;159353;53479;9.8;3.3
33;2021-03-23;6324;601;165677;54080;10.1;3.3
33;2021-03-24;7076;526;172753;54606;10.6;3.3
33;2021-03-25;8843;646;181596;55252;11.1;3.4
33;2021-03-26;10038;845;191634;56097;11.7;3.4
33;2021-03-27;3620;83;195254;56180;12.0;3.4
33;2021-03-28;577;33;195831;56213;12.0;3.4
33;2021-03-29;6767;697;202598;56910;12.4;3.5
33;2021-03-30;8102;1032;210700;57942;12.9;3.5
33;2021-03-31;7577;1044;218277;58986;13.4;3.6
33;2021-04-01;8822;1191;227099;60177;13.9;3.7
33;2021-04-02;8412;1547;235511;61724;14.4;3.8
33;2021-04-03;2832;520;238343;62244;14.6;3.8
33;2021-04-04;218;160;238561;62404;14.6;3.8
33;2021-04-05;693;123;239254;62527;14.6;3.8
33;2021-04-06;6048;2678;245302;65205;15.0;4.0
33;2021-04-07;7422;2519;252724;67724;15.5;4.1
33;2021-04-08;10328;2770;263052;70494;16.1;4.3
33;2021-04-09;12688;3085;275740;73579;16.9;4.5
33;2021-04-10;5357;1391;281097;74970;17.2;4.6
33;2021-04-11;1002;351;282099;75321;17.3;4.6
33;2021-04-12;7425;3274;289524;78595;17.7;4.8
33;2021-04-13;9321;3476;298845;82071;18.3;5.0
33;2021-04-14;9038;3642;307883;85713;18.8;5.2
33;2021-04-15;10110;3873;317993;89586;19.5;5.5
33;2021-04-16;9718;4223;327711;93809;20.1;5.7
33;2021-04-17;4651;1657;332362;95466;20.3;5.8
33;2021-04-18;929;411;333291;95877;20.4;5.9
33;2021-04-19;5616;3832;338907;99709;20.7;6.1
33;2021-04-20;7294;4259;346201;103968;21.2;6.4
33;2021-04-21;6594;4341;352795;108309;21.6;6.6
33;2021-04-22;7349;4481;360144;112790;22.0;6.9
33;2021-04-23;7705;4819;367849;117609;22.5;7.2
33;2021-04-24;4500;1797;372349;119406;22.8;7.3
33;2021-04-25;1652;418;374001;119824;22.9;7.3
33;2021-04-26;5269;5075;379270;124899;23.2;7.6
33;2021-04-27;6579;5583;385849;130482;23.6;8.0
33;2021-04-28;6783;5555;392632;136037;24.0;8.3
33;2021-04-29;8425;6213;401057;142250;24.6;8.7
33;2021-04-30;8739;6091;409796;148341;25.1;9.1
33;2021-05-01;2902;513;412698;148854;25.3;9.1
33;2021-05-02;1835;346;414533;149200;25.4;9.1
33;2021-05-03;7018;5204;421551;154404;25.8;9.5
33;2021-05-04;6824;6651;428375;161055;26.2;9.9
33;2021-05-05;7140;7561;435515;168616;26.7;10.3
33;2021-05-06;8704;8219;444219;176835;27.2;10.8
33;2021-05-07;8610;8865;452829;185700;27.7;11.4
33;2021-05-08;3542;1587;456371;187287;27.9;11.5
33;2021-05-09;1118;969;457489;188256;28.0;11.5
33;2021-05-10;6874;7288;464363;195544;28.4;12.0
33;2021-05-11;8634;7854;472997;203398;29.0;12.5
33;2021-05-12;9175;6702;482172;210100;29.5;12.9
33;2021-05-13;5209;2109;487381;212209;29.8;13.0
33;2021-05-14;8127;5349;495508;217558;30.3;13.3
33;2021-05-15;5179;2865;500687;220423;30.7;13.5
33;2021-05-16;1842;804;502529;221227;30.8;13.5
33;2021-05-17;8861;5109;511390;226336;31.3;13.9
33;2021-05-18;10625;4872;522015;231208;32.0;14.2
33;2021-05-19;10900;4775;532915;235983;32.6;14.4
33;2021-05-20;10907;5581;543822;241564;33.3;14.8
33;2021-05-21;10915;6235;554737;247799;34.0;15.2
33;2021-05-22;5121;2749;559858;250548;34.3;15.3
33;2021-05-23;1751;385;561609;250933;34.4;15.4
33;2021-05-24;5412;1000;567021;251933;34.7;15.4
33;2021-05-25;9391;5761;576412;257694;35.3;15.8
33;2021-05-26;9676;6032;586088;263726;35.9;16.1
33;2021-05-27;10901;7704;596989;271430;36.5;16.6
33;2021-05-28;10063;9480;607052;280910;37.2;17.2
33;2021-05-29;5042;4115;612094;285025;37.5;17.4
33;2021-05-30;1703;667;613797;285692;37.6;17.5
33;2021-05-31;8551;6404;622348;292096;38.1;17.9
33;2021-06-01;11804;8694;634152;300790;38.8;18.4
33;2021-06-02;11710;8195;645862;308985;39.5;18.9
33;2021-06-03;12715;9185;658577;318170;40.3;19.5
33;2021-06-04;12931;10930;671508;329100;41.1;20.1
33;2021-06-05;5272;5053;676780;334153;41.4;20.5
33;2021-06-06;2525;1193;679305;335346;41.6;20.5
33;2021-06-07;9759;8495;689064;343841;42.2;21.1
33;2021-06-08;11937;9439;701001;353280;42.9;21.6
33;2021-06-09;11775;8515;712776;361795;43.6;22.1
33;2021-06-10;12950;8382;725726;370177;44.4;22.7
33;2021-06-11;12517;11150;738243;381327;45.2;23.3
33;2021-06-12;6185;4477;744428;385804;45.6;23.6
33;2021-06-13;2612;1283;747040;387087;45.7;23.7
33;2021-06-14;8580;10150;755620;397237;46.3;24.3
33;2021-06-15;12054;10253;767674;407490;47.0;24.9
33;2021-06-16;12057;8863;779731;416353;47.7;25.5
33;2021-06-17;13117;9605;792848;425958;48.5;26.1
33;2021-06-18;11796;11430;804644;437388;49.3;26.8
33;2021-06-19;5609;4817;810253;442205;49.6;27.1
33;2021-06-20;2946;1475;813199;443680;49.8;27.2
33;2021-06-21;7875;10164;821074;453844;50.3;27.8
33;2021-06-22;9063;11073;830137;464917;50.8;28.5
33;2021-06-23;8670;10840;838807;475757;51.4;29.1
33;2021-06-24;9743;9979;848550;485736;51.9;29.7
33;2021-06-25;8047;13708;856597;499444;52.4;30.6
33;2021-06-26;4344;5916;860941;505360;52.7;30.9
33;2021-06-27;2467;1959;863408;507319;52.9;31.1
33;2021-06-28;4871;12754;868279;520073;53.2;31.8
33;2021-06-29;6443;13654;874722;533727;53.6;32.7
33;2021-06-30;6680;13386;881402;547113;54.0;33.5
33;2021-07-01;8046;11806;889448;558919;54.5;34.2
33;2021-07-02;6844;15106;896292;574025;54.9;35.1
33;2021-07-03;3227;6783;899519;580808;55.1;35.6
33;2021-07-04;2065;2379;901584;583187;55.2;35.7
33;2021-07-05;4398;12903;905982;596090;55.5;36.5
33;2021-07-06;6146;14588;912128;610678;55.8;37.4
33;2021-07-07;6894;13041;919022;623719;56.3;38.2
33;2021-07-08;7969;12752;926991;636471;56.8;39.0
33;2021-07-09;6471;15110;933462;651581;57.1;39.9
33;2021-07-10;3114;7159;936576;658740;57.3;40.3
33;2021-07-11;1844;2303;938420;661043;57.5;40.5
33;2021-07-12;3950;14701;942370;675744;57.7;41.4
33;2021-07-13;7153;16100;949523;691844;58.1;42.4
33;2021-07-14;3689;5315;953212;697159;58.4;42.7
33;2021-07-15;7625;15976;960837;713135;58.8;43.7
33;2021-07-16;8588;15137;969425;728272;59.3;44.6
33;2021-07-17;3155;6429;972580;734701;59.5;45.0
33;2021-07-18;1702;3205;974282;737906;59.6;45.2
33;2021-07-19;5872;15088;980154;752994;60.0;46.1
33;2021-07-20;7429;16118;987583;769112;60.5;47.1
33;2021-07-21;8370;14530;995953;783642;61.0;48.0
33;2021-07-22;9366;15097;1005319;798739;61.5;48.9
33;2021-07-23;9666;16346;1014985;815085;62.1;49.9
33;2021-07-24;3835;7550;1018820;822635;62.4;50.4
33;2021-07-25;2093;2666;1020913;825301;62.5;50.5
33;2021-07-26;6966;13413;1027879;838714;62.9;51.3
33;2021-07-27;10091;13392;1037970;852106;63.5;52.2
33;2021-07-28;10929;11965;1048899;864071;64.2;52.9
33;2021-07-29;11673;11903;1060572;875974;64.9;53.6
33;2021-07-30;11399;12205;1071971;888179;65.6;54.4
33;2021-07-31;4761;5647;1076732;893826;65.9;54.7
33;2021-08-01;2484;1951;1079216;895777;66.1;54.8
33;2021-08-02;8417;9889;1087633;905666;66.6;55.4
33;2021-08-03;11559;9020;1099192;914686;67.3;56.0
33;2021-08-04;12284;7364;1111476;922050;68.0;56.4
33;2021-08-05;11932;8043;1123408;930093;68.8;56.9
33;2021-08-06;11230;9056;1134638;939149;69.5;57.5
33;2021-08-07;5929;4517;1140567;943666;69.8;57.8
33;2021-08-08;3200;1820;1143767;945486;70.0;57.9
33;2021-08-09;8662;8721;1152429;954207;70.6;58.4
33;2021-08-10;9372;8448;1161801;962655;71.1;58.9
33;2021-08-11;8113;7583;1169914;970238;71.6;59.4
33;2021-08-12;7980;8019;1177894;978257;72.1;59.9
33;2021-08-13;7846;7679;1185740;985936;72.6;60.4
33;2021-08-14;3526;4333;1189266;990269;72.8;60.6
33;2021-08-15;1211;1881;1190477;992150;72.9;60.7
33;2021-08-16;6428;8628;1196905;1000778;73.3;61.3
33;2021-08-17;6632;9068;1203537;1009846;73.7;61.8
33;2021-08-18;5629;8771;1209166;1018617;74.0;62.4
33;2021-08-19;5505;9119;1214671;1027736;74.4;62.9
33;2021-08-20;4956;9835;1219627;1037571;74.7;63.5
33;2021-08-21;2208;5036;1221835;1042607;74.8;63.8
33;2021-08-22;565;2366;1222400;1044973;74.8;64.0
33;2021-08-23;3918;10288;1226318;1055261;75.1;64.6
33;2021-08-24;4138;11093;1230456;1066354;75.3;65.3
33;2021-08-25;3721;10487;1234177;1076841;75.6;65.9
33;2021-08-26;3657;11057;1237834;1087898;75.8;66.6
33;2021-08-27;3825;12583;1241659;1100481;76.0;67.4
33;2021-08-28;1579;6638;1243238;1107119;76.1;67.8
33;2021-08-29;454;2426;1243692;1109545;76.1;67.9
33;2021-08-30;2341;10537;1246033;1120082;76.3;68.6
33;2021-08-31;3237;11072;1249270;1131154;76.5;69.2
33;2021-09-01;2818;8818;1252088;1139972;76.7;69.8
33;2021-09-02;2683;8394;1254771;1148366;76.8;70.3
33;2021-09-03;3100;10138;1257871;1158504;77.0;70.9
33;2021-09-04;1641;6080;1259512;1164584;77.1;71.3
33;2021-09-05;413;1517;1259925;1166101;77.1;71.4
33;2021-09-06;1595;7181;1261520;1173282;77.2;71.8
33;2021-09-07;2065;6578;1263585;1179860;77.4;72.2
33;2021-09-08;1752;6597;1265337;1186457;77.5;72.6
33;2021-09-09;1872;6739;1267209;1193196;77.6;73.0
33;2021-09-10;2080;7280;1269289;1200476;77.7;73.5
33;2021-09-11;995;4493;1270284;1204969;77.8;73.8
33;2021-09-12;130;606;1270414;1205575;77.8;73.8
33;2021-09-13;1460;4785;1271874;1210360;77.9;74.1
33;2021-09-14;1554;5143;1273428;1215503;78.0;74.4
33;2021-09-15;1536;4441;1274964;1219944;78.1;74.7
33;2021-09-16;1473;3346;1276437;1223290;78.1;74.9
33;2021-09-17;1786;4515;1278223;1227805;78.3;75.2
33;2021-09-18;605;3050;1278828;1230855;78.3;75.4
33;2021-09-19;115;398;1278943;1231253;78.3;75.4
33;2021-09-20;1044;2157;1279987;1233410;78.4;75.5
33;2021-09-21;955;2449;1280942;1235859;78.4;75.7
33;2021-09-22;959;3443;1281901;1239302;78.5;75.9
33;2021-09-23;898;2305;1282799;1241607;78.5;76.0
33;2021-09-24;1288;3716;1284087;1245323;78.6;76.2
33;2021-09-25;515;2356;1284602;1247679;78.6;76.4
33;2021-09-26;64;332;1284666;1248011;78.6;76.4
33;2021-09-27;663;2009;1285329;1250020;78.7;76.5
33;2021-09-28;819;2146;1286148;1252166;78.7;76.7
33;2021-09-29;874;2211;1287022;1254377;78.8;76.8
34;2020-12-27;1;0;1;0;0.0;0.0
34;2020-12-28;3;0;4;0;0.0;0.0
34;2020-12-29;0;0;4;0;0.0;0.0
34;2020-12-30;0;0;4;0;0.0;0.0
34;2020-12-31;0;0;4;0;0.0;0.0
34;2021-01-01;1;0;5;0;0.0;0.0
34;2021-01-02;2;0;7;0;0.0;0.0
34;2021-01-03;0;0;7;0;0.0;0.0
34;2021-01-04;23;0;30;0;0.0;0.0
34;2021-01-05;107;2;137;2;0.0;0.0
34;2021-01-06;199;1;336;3;0.0;0.0
34;2021-01-07;364;0;700;3;0.1;0.0
34;2021-01-08;606;0;1306;3;0.1;0.0
34;2021-01-09;244;0;1550;3;0.1;0.0
34;2021-01-10;94;1;1644;4;0.1;0.0
34;2021-01-11;567;2;2211;6;0.2;0.0
34;2021-01-12;1009;1;3220;7;0.3;0.0
34;2021-01-13;1098;6;4318;13;0.4;0.0
34;2021-01-14;1954;12;6272;25;0.5;0.0
34;2021-01-15;1471;4;7743;29;0.7;0.0
34;2021-01-16;332;7;8075;36;0.7;0.0
34;2021-01-17;235;1;8310;37;0.7;0.0
34;2021-01-18;1124;3;9434;40;0.8;0.0
34;2021-01-19;1610;8;11044;48;0.9;0.0
34;2021-01-20;2090;8;13134;56;1.1;0.0
34;2021-01-21;4234;10;17368;66;1.5;0.0
34;2021-01-22;2555;8;19923;74;1.7;0.0
34;2021-01-23;600;2;20523;76;1.7;0.0
34;2021-01-24;2;0;20525;76;1.7;0.0
34;2021-01-25;1242;5;21767;81;1.9;0.0
34;2021-01-26;1461;17;23228;98;2.0;0.0
34;2021-01-27;1471;23;24699;121;2.1;0.0
34;2021-01-28;1394;120;26093;241;2.2;0.0
34;2021-01-29;1260;124;27353;365;2.3;0.0
34;2021-01-30;479;12;27832;377;2.4;0.0
34;2021-01-31;4;0;27836;377;2.4;0.0
34;2021-02-01;1027;220;28863;597;2.5;0.1
34;2021-02-02;1462;400;30325;997;2.6;0.1
34;2021-02-03;2654;484;32979;1481;2.8;0.1
34;2021-02-04;2314;835;35293;2316;3.0;0.2
34;2021-02-05;1891;1070;37184;3386;3.2;0.3
34;2021-02-06;497;209;37681;3595;3.2;0.3
34;2021-02-07;32;95;37713;3690;3.2;0.3
34;2021-02-08;860;954;38573;4644;3.3;0.4
34;2021-02-09;1034;1185;39607;5829;3.4;0.5
34;2021-02-10;1296;1338;40903;7167;3.5;0.6
34;2021-02-11;1794;2423;42697;9590;3.6;0.8
34;2021-02-12;1921;1459;44618;11049;3.8;0.9
34;2021-02-13;357;435;44975;11484;3.8;1.0
34;2021-02-14;22;271;44997;11755;3.8;1.0
34;2021-02-15;673;845;45670;12600;3.9;1.1
34;2021-02-16;666;1130;46336;13730;3.9;1.2
34;2021-02-17;715;1165;47051;14895;4.0;1.3
34;2021-02-18;837;1115;47888;16010;4.1;1.4
34;2021-02-19;816;902;48704;16912;4.1;1.4
34;2021-02-20;300;336;49004;17248;4.2;1.5
34;2021-02-21;64;18;49068;17266;4.2;1.5
34;2021-02-22;630;978;49698;18244;4.2;1.6
34;2021-02-23;565;1107;50263;19351;4.3;1.6
34;2021-02-24;943;1926;51206;21277;4.4;1.8
34;2021-02-25;1607;1885;52813;23162;4.5;2.0
34;2021-02-26;1850;1332;54663;24494;4.6;2.1
34;2021-02-27;702;316;55365;24810;4.7;2.1
34;2021-02-28;86;61;55451;24871;4.7;2.1
34;2021-03-01;931;938;56382;25809;4.8;2.2
34;2021-03-02;1592;1047;57974;26856;4.9;2.3
34;2021-03-03;1835;1129;59809;27985;5.1;2.4
34;2021-03-04;2867;1386;62676;29371;5.3;2.5
34;2021-03-05;3686;1359;66362;30730;5.6;2.6
34;2021-03-06;2640;175;69002;30905;5.9;2.6
34;2021-03-07;1242;56;70244;30961;6.0;2.6
34;2021-03-08;2781;839;73025;31800;6.2;2.7
34;2021-03-09;4019;1248;77044;33048;6.6;2.8
34;2021-03-10;3991;1182;81035;34230;6.9;2.9
34;2021-03-11;5437;1189;86472;35419;7.4;3.0
34;2021-03-12;6492;853;92964;36272;7.9;3.1
34;2021-03-13;3138;164;96102;36436;8.2;3.1
34;2021-03-14;1003;54;97105;36490;8.3;3.1
34;2021-03-15;3307;551;100412;37041;8.5;3.1
34;2021-03-16;2912;638;103324;37679;8.8;3.2
34;2021-03-17;3305;735;106629;38414;9.1;3.3
34;2021-03-18;3450;905;110079;39319;9.4;3.3
34;2021-03-19;4692;787;114771;40106;9.8;3.4
34;2021-03-20;3148;65;117919;40171;10.0;3.4
34;2021-03-21;1997;60;119916;40231;10.2;3.4
34;2021-03-22;3683;460;123599;40691;10.5;3.5
34;2021-03-23;4961;534;128560;41225;10.9;3.5
34;2021-03-24;5221;627;133781;41852;11.4;3.6
34;2021-03-25;7197;713;140978;42565;12.0;3.6
34;2021-03-26;7169;572;148147;43137;12.6;3.7
34;2021-03-27;2373;85;150520;43222;12.8;3.7
34;2021-03-28;699;21;151219;43243;12.9;3.7
34;2021-03-29;4186;750;155405;43993;13.2;3.7
34;2021-03-30;5221;960;160626;44953;13.7;3.8
34;2021-03-31;5068;1204;165694;46157;14.1;3.9
34;2021-04-01;7031;1037;172725;47194;14.7;4.0
34;2021-04-02;5823;1191;178548;48385;15.2;4.1
34;2021-04-03;1137;85;179685;48470;15.3;4.1
34;2021-04-04;166;5;179851;48475;15.3;4.1
34;2021-04-05;432;26;180283;48501;15.3;4.1
34;2021-04-06;3136;2440;183419;50941;15.6;4.3
34;2021-04-07;3387;2631;186806;53572;15.9;4.6
34;2021-04-08;5252;2801;192058;56373;16.3;4.8
34;2021-04-09;8072;2492;200130;58865;17.0;5.0
34;2021-04-10;3164;1373;203294;60238;17.3;5.1
34;2021-04-11;1715;805;205009;61043;17.4;5.2
34;2021-04-12;4500;2518;209509;63561;17.8;5.4
34;2021-04-13;5240;3051;214749;66612;18.3;5.7
34;2021-04-14;5621;3238;220370;69850;18.7;5.9
34;2021-04-15;6996;3166;227366;73016;19.3;6.2
34;2021-04-16;6580;3158;233946;76174;19.9;6.5
34;2021-04-17;2378;2068;236324;78242;20.1;6.7
34;2021-04-18;988;1717;237312;79959;20.2;6.8
34;2021-04-19;3421;3119;240733;83078;20.5;7.1
34;2021-04-20;3766;3657;244499;86735;20.8;7.4
34;2021-04-21;4241;3717;248740;90452;21.1;7.7
34;2021-04-22;4489;4595;253229;95047;21.5;8.1
34;2021-04-23;5378;3514;258607;98561;22.0;8.4
34;2021-04-24;3164;1579;261771;100140;22.3;8.5
34;2021-04-25;1919;644;263690;100784;22.4;8.6
34;2021-04-26;4223;3469;267913;104253;22.8;8.9
34;2021-04-27;5128;4005;273041;108258;23.2;9.2
34;2021-04-28;5771;3539;278812;111797;23.7;9.5
34;2021-04-29;6421;3925;285233;115722;24.3;9.8
34;2021-04-30;7870;3257;293103;118979;24.9;10.1
34;2021-05-01;2405;499;295508;119478;25.1;10.2
34;2021-05-02;3260;322;298768;119800;25.4;10.2
34;2021-05-03;6576;2902;305344;122702;26.0;10.4
34;2021-05-04;7109;3791;312453;126493;26.6;10.8
34;2021-05-05;6498;4528;318951;131021;27.1;11.1
34;2021-05-06;6945;5191;325896;136212;27.7;11.6
34;2021-05-07;6927;5657;332823;141869;28.3;12.1
34;2021-05-08;3609;1172;336432;143041;28.6;12.2
34;2021-05-09;2178;1288;338610;144329;28.8;12.3
34;2021-05-10;5853;4798;344463;149127;29.3;12.7
34;2021-05-11;7411;5307;351874;154434;29.9;13.1
34;2021-05-12;7755;4453;359629;158887;30.6;13.5
34;2021-05-13;6127;785;365756;159672;31.1;13.6
34;2021-05-14;7491;3734;373247;163406;31.7;13.9
34;2021-05-15;4863;1686;378110;165092;32.1;14.0
34;2021-05-16;4949;460;383059;165552;32.6;14.1
34;2021-05-17;8693;1983;391752;167535;33.3;14.2
34;2021-05-18;9142;1973;400894;169508;34.1;14.4
34;2021-05-19;8625;1811;409519;171319;34.8;14.6
34;2021-05-20;8866;2517;418385;173836;35.6;14.8
34;2021-05-21;8784;3204;427169;177040;36.3;15.1
34;2021-05-22;5787;1153;432956;178193;36.8;15.2
34;2021-05-23;3883;549;436839;178742;37.1;15.2
34;2021-05-24;1896;852;438735;179594;37.3;15.3
34;2021-05-25;7141;3811;445876;183405;37.9;15.6
34;2021-05-26;8319;3033;454195;186438;38.6;15.9
34;2021-05-27;8316;4307;462511;190745;39.3;16.2
34;2021-05-28;8062;5439;470573;196184;40.0;16.7
34;2021-05-29;4006;3101;474579;199285;40.4;16.9
34;2021-05-30;1985;1389;476564;200674;40.5;17.1
34;2021-05-31;5878;5247;482442;205921;41.0;17.5
34;2021-06-01;6948;6090;489390;212011;41.6;18.0
34;2021-06-02;6136;5810;495526;217821;42.1;18.5
34;2021-06-03;7705;6477;503231;224298;42.8;19.1
34;2021-06-04;7651;7582;510882;231880;43.4;19.7
34;2021-06-05;4140;3678;515022;235558;43.8;20.0
34;2021-06-06;3266;1865;518288;237423;44.1;20.2
34;2021-06-07;4414;6759;522702;244182;44.4;20.8
34;2021-06-08;5854;6826;528556;251008;44.9;21.3
34;2021-06-09;5826;6839;534382;257847;45.4;21.9
34;2021-06-10;6322;6864;540704;264711;46.0;22.5
34;2021-06-11;5399;9275;546103;273986;46.4;23.3
34;2021-06-12;3166;4726;549269;278712;46.7;23.7
34;2021-06-13;1081;1905;550350;280617;46.8;23.9
34;2021-06-14;3442;7810;553792;288427;47.1;24.5
34;2021-06-15;3951;8789;557743;297216;47.4;25.3
34;2021-06-16;4619;7855;562362;305071;47.8;25.9
34;2021-06-17;4227;7948;566589;313019;48.2;26.6
34;2021-06-18;4350;9327;570939;322346;48.5;27.4
34;2021-06-19;2729;4403;573668;326749;48.8;27.8
34;2021-06-20;888;2872;574556;329621;48.9;28.0
34;2021-06-21;2180;8553;576736;338174;49.0;28.8
34;2021-06-22;2974;9405;579710;347579;49.3;29.6
34;2021-06-23;3528;8963;583238;356542;49.6;30.3
34;2021-06-24;3559;8671;586797;365213;49.9;31.1
34;2021-06-25;3374;10439;590171;375652;50.2;31.9
34;2021-06-26;1641;6189;591812;381841;50.3;32.5
34;2021-06-27;308;4268;592120;386109;50.3;32.8
34;2021-06-28;2265;9426;594385;395535;50.5;33.6
34;2021-06-29;2682;10295;597067;405830;50.8;34.5
34;2021-06-30;3356;9543;600423;415373;51.1;35.3
34;2021-07-01;3528;9443;603951;424816;51.4;36.1
34;2021-07-02;3433;9739;607384;434555;51.6;36.9
34;2021-07-03;1682;6158;609066;440713;51.8;37.5
34;2021-07-04;312;2763;609378;443476;51.8;37.7
34;2021-07-05;3234;7998;612612;451474;52.1;38.4
34;2021-07-06;3532;9175;616144;460649;52.4;39.2
34;2021-07-07;3273;8651;619417;469300;52.7;39.9
34;2021-07-08;4303;8868;623720;478168;53.0;40.7
34;2021-07-09;4009;9348;627729;487516;53.4;41.5
34;2021-07-10;2140;5717;629869;493233;53.6;41.9
34;2021-07-11;923;2576;630792;495809;53.6;42.2
34;2021-07-12;2929;8966;633721;504775;53.9;42.9
34;2021-07-13;4657;10041;638378;514816;54.3;43.8
34;2021-07-14;783;356;639161;515172;54.3;43.8
34;2021-07-15;5911;10396;645072;525568;54.8;44.7
34;2021-07-16;5860;10726;650932;536294;55.3;45.6
34;2021-07-17;4499;4415;655431;540709;55.7;46.0
34;2021-07-18;235;195;655666;540904;55.7;46.0
34;2021-07-19;5117;8329;660783;549233;56.2;46.7
34;2021-07-20;6896;8385;667679;557618;56.8;47.4
34;2021-07-21;7650;7826;675329;565444;57.4;48.1
34;2021-07-22;7441;8176;682770;573620;58.1;48.8
34;2021-07-23;7842;8157;690612;581777;58.7;49.5
34;2021-07-24;6150;3057;696762;584834;59.2;49.7
34;2021-07-25;3210;548;699972;585382;59.5;49.8
34;2021-07-26;6238;6429;706210;591811;60.0;50.3
34;2021-07-27;8755;6055;714965;597866;60.8;50.8
34;2021-07-28;9710;5923;724675;603789;61.6;51.3
34;2021-07-29;11326;6053;736001;609842;62.6;51.9
34;2021-07-30;9849;6538;745850;616380;63.4;52.4
34;2021-07-31;6445;2196;752295;618576;64.0;52.6
34;2021-08-01;3315;618;755610;619194;64.2;52.6
34;2021-08-02;7359;5066;762969;624260;64.9;53.1
34;2021-08-03;8143;5398;771112;629658;65.6;53.5
34;2021-08-04;8446;4568;779558;634226;66.3;53.9
34;2021-08-05;7135;5027;786693;639253;66.9;54.4
34;2021-08-06;6096;5228;792789;644481;67.4;54.8
34;2021-08-07;3109;2437;795898;646918;67.7;55.0
34;2021-08-08;202;204;796100;647122;67.7;55.0
34;2021-08-09;4780;6179;800880;653301;68.1;55.5
34;2021-08-10;5394;6483;806274;659784;68.6;56.1
34;2021-08-11;4831;6543;811105;666327;69.0;56.7
34;2021-08-12;4572;6200;815677;672527;69.4;57.2
34;2021-08-13;4109;5738;819786;678265;69.7;57.7
34;2021-08-14;1797;2880;821583;681145;69.9;57.9
34;2021-08-15;209;194;821792;681339;69.9;57.9
34;2021-08-16;2905;7547;824697;688886;70.1;58.6
34;2021-08-17;3591;8281;828288;697167;70.4;59.3
34;2021-08-18;3206;7563;831494;704730;70.7;59.9
34;2021-08-19;3268;7784;834762;712514;71.0;60.6
34;2021-08-20;2725;7721;837487;720235;71.2;61.2
34;2021-08-21;1398;3563;838885;723798;71.3;61.5
34;2021-08-22;163;308;839048;724106;71.3;61.6
34;2021-08-23;2330;8655;841378;732761;71.5;62.3
34;2021-08-24;2727;8962;844105;741723;71.8;63.1
34;2021-08-25;2345;8540;846450;750263;72.0;63.8
34;2021-08-26;2605;7888;849055;758151;72.2;64.5
34;2021-08-27;2196;7570;851251;765721;72.4;65.1
34;2021-08-28;1116;3561;852367;769282;72.5;65.4
34;2021-08-29;368;1357;852735;770639;72.5;65.5
34;2021-08-30;2053;6883;854788;777522;72.7;66.1
34;2021-08-31;2118;6840;856906;784362;72.9;66.7
34;2021-09-01;2048;6427;858954;790789;73.0;67.2
34;2021-09-02;1665;4828;860619;795617;73.2;67.6
34;2021-09-03;1763;5561;862382;801178;73.3;68.1
34;2021-09-04;1357;3377;863739;804555;73.4;68.4
34;2021-09-05;141;240;863880;804795;73.5;68.4
34;2021-09-06;1148;4056;865028;808851;73.5;68.8
34;2021-09-07;1348;4125;866376;812976;73.7;69.1
34;2021-09-08;1625;4777;868001;817753;73.8;69.5
34;2021-09-09;1179;3855;869180;821608;73.9;69.9
34;2021-09-10;1518;4091;870698;825699;74.0;70.2
34;2021-09-11;1274;2071;871972;827770;74.1;70.4
34;2021-09-12;90;88;872062;827858;74.1;70.4
34;2021-09-13;992;3305;873054;831163;74.2;70.7
34;2021-09-14;1223;3267;874277;834430;74.3;70.9
34;2021-09-15;1477;2951;875754;837381;74.5;71.2
34;2021-09-16;879;1875;876633;839256;74.5;71.4
34;2021-09-17;1108;2418;877741;841674;74.6;71.6
34;2021-09-18;781;1759;878522;843433;74.7;71.7
34;2021-09-19;36;59;878558;843492;74.7;71.7
34;2021-09-20;607;1905;879165;845397;74.7;71.9
34;2021-09-21;608;1779;879773;847176;74.8;72.0
34;2021-09-22;829;2527;880602;849703;74.9;72.2
34;2021-09-23;667;1656;881269;851359;74.9;72.4
34;2021-09-24;842;2218;882111;853577;75.0;72.6
34;2021-09-25;490;1552;882601;855129;75.0;72.7
34;2021-09-26;41;142;882642;855271;75.0;72.7
34;2021-09-27;615;1474;883257;856745;75.1;72.8
34;2021-09-28;627;1124;883884;857869;75.2;72.9
34;2021-09-29;804;1800;884688;859669;75.2;73.1
35;2020-12-27;0;0;0;0;0.0;0.0
35;2020-12-28;0;0;0;0;0.0;0.0
35;2020-12-29;2;0;2;0;0.0;0.0
35;2020-12-30;0;0;2;0;0.0;0.0
35;2020-12-31;1;0;3;0;0.0;0.0
35;2021-01-01;3;0;6;0;0.0;0.0
35;2021-01-02;1;0;7;0;0.0;0.0
35;2021-01-03;0;0;7;0;0.0;0.0
35;2021-01-04;10;0;17;0;0.0;0.0
35;2021-01-05;110;0;127;0;0.0;0.0
35;2021-01-06;175;0;302;0;0.0;0.0
35;2021-01-07;440;1;742;1;0.1;0.0
35;2021-01-08;513;1;1255;2;0.1;0.0
35;2021-01-09;31;0;1286;2;0.1;0.0
35;2021-01-10;2;0;1288;2;0.1;0.0
35;2021-01-11;538;0;1826;2;0.2;0.0
35;2021-01-12;886;2;2712;4;0.3;0.0
35;2021-01-13;969;1;3681;5;0.3;0.0
35;2021-01-14;1261;17;4942;22;0.5;0.0
35;2021-01-15;731;2;5673;24;0.5;0.0
35;2021-01-16;189;3;5862;27;0.5;0.0
35;2021-01-17;44;0;5906;27;0.5;0.0
35;2021-01-18;1222;0;7128;27;0.7;0.0
35;2021-01-19;5405;12;12533;39;1.2;0.0
35;2021-01-20;3238;7;15771;46;1.5;0.0
35;2021-01-21;3642;5;19413;51;1.8;0.0
35;2021-01-22;2087;9;21500;60;2.0;0.0
35;2021-01-23;421;1;21921;61;2.0;0.0
35;2021-01-24;51;0;21972;61;2.0;0.0
35;2021-01-25;917;15;22889;76;2.1;0.0
35;2021-01-26;1130;126;24019;202;2.2;0.0
35;2021-01-27;1030;115;25049;317;2.3;0.0
35;2021-01-28;915;272;25964;589;2.4;0.1
35;2021-01-29;724;255;26688;844;2.5;0.1
35;2021-01-30;140;15;26828;859;2.5;0.1
35;2021-01-31;0;0;26828;859;2.5;0.1
35;2021-02-01;672;282;27500;1141;2.5;0.1
35;2021-02-02;726;410;28226;1551;2.6;0.1
35;2021-02-03;662;467;28888;2018;2.7;0.2
35;2021-02-04;590;582;29478;2600;2.7;0.2
35;2021-02-05;624;509;30102;3109;2.8;0.3
35;2021-02-06;175;4;30277;3113;2.8;0.3
35;2021-02-07;1;0;30278;3113;2.8;0.3
35;2021-02-08;446;538;30724;3651;2.8;0.3
35;2021-02-09;1715;3232;32439;6883;3.0;0.6
35;2021-02-10;1370;2517;33809;9400;3.1;0.9
35;2021-02-11;1945;3007;35754;12407;3.3;1.1
35;2021-02-12;1663;1551;37417;13958;3.5;1.3
35;2021-02-13;58;230;37475;14188;3.5;1.3
35;2021-02-14;8;46;37483;14234;3.5;1.3
35;2021-02-15;770;822;38253;15056;3.5;1.4
35;2021-02-16;919;779;39172;15835;3.6;1.5
35;2021-02-17;895;870;40067;16705;3.7;1.5
35;2021-02-18;1018;804;41085;17509;3.8;1.6
35;2021-02-19;1013;752;42098;18261;3.9;1.7
35;2021-02-20;143;38;42241;18299;3.9;1.7
35;2021-02-21;5;0;42246;18299;3.9;1.7
35;2021-02-22;776;649;43022;18948;4.0;1.8
35;2021-02-23;1287;695;44309;19643;4.1;1.8
35;2021-02-24;1404;677;45713;20320;4.2;1.9
35;2021-02-25;2249;658;47962;20978;4.4;1.9
35;2021-02-26;2600;594;50562;21572;4.7;2.0
35;2021-02-27;869;78;51431;21650;4.8;2.0
35;2021-02-28;10;0;51441;21650;4.8;2.0
35;2021-03-01;959;567;52400;22217;4.8;2.1
35;2021-03-02;1634;1804;54034;24021;5.0;2.2
35;2021-03-03;1913;861;55947;24882;5.2;2.3
35;2021-03-04;2917;1293;58864;26175;5.4;2.4
35;2021-03-05;3717;1254;62581;27429;5.8;2.5
35;2021-03-06;1337;79;63918;27508;5.9;2.5
35;2021-03-07;1;36;63919;27544;5.9;2.5
35;2021-03-08;1475;539;65394;28083;6.0;2.6
35;2021-03-09;3238;546;68632;28629;6.3;2.6
35;2021-03-10;2902;516;71534;29145;6.6;2.7
35;2021-03-11;4199;652;75733;29797;7.0;2.8
35;2021-03-12;6049;519;81782;30316;7.6;2.8
35;2021-03-13;2427;124;84209;30440;7.8;2.8
35;2021-03-14;18;25;84227;30465;7.8;2.8
35;2021-03-15;1966;658;86193;31123;8.0;2.9
35;2021-03-16;2505;714;88698;31837;8.2;2.9
35;2021-03-17;2397;588;91095;32425;8.4;3.0
35;2021-03-18;2334;580;93429;33005;8.6;3.1
35;2021-03-19;3546;496;96975;33501;9.0;3.1
35;2021-03-20;1543;108;98518;33609;9.1;3.1
35;2021-03-21;38;1;98556;33610;9.1;3.1
35;2021-03-22;1749;835;100305;34445;9.3;3.2
35;2021-03-23;3626;1167;103931;35612;9.6;3.3
35;2021-03-24;3730;982;107661;36594;9.9;3.4
35;2021-03-25;5328;980;112989;37574;10.4;3.5
35;2021-03-26;5852;801;118841;38375;11.0;3.5
35;2021-03-27;1416;208;120257;38583;11.1;3.6
35;2021-03-28;4;0;120261;38583;11.1;3.6
35;2021-03-29;2778;902;123039;39485;11.4;3.6
35;2021-03-30;4292;1311;127331;40796;11.8;3.8
35;2021-03-31;3472;1330;130803;42126;12.1;3.9
35;2021-04-01;4249;1236;135052;43362;12.5;4.0
35;2021-04-02;4861;1205;139913;44567;12.9;4.1
35;2021-04-03;763;214;140676;44781;13.0;4.1
35;2021-04-04;6;0;140682;44781;13.0;4.1
35;2021-04-05;24;1;140706;44782;13.0;4.1
35;2021-04-06;3282;2022;143988;46804;13.3;4.3
35;2021-04-07;3965;1839;147953;48643;13.7;4.5
35;2021-04-08;5802;1590;153755;50233;14.2;4.6
35;2021-04-09;7429;1412;161184;51645;14.9;4.8
35;2021-04-10;1860;250;163044;51895;15.1;4.8
35;2021-04-11;35;23;163079;51918;15.1;4.8
35;2021-04-12;5137;1593;168216;53511;15.5;4.9
35;2021-04-13;7624;2782;175840;56293;16.3;5.2
35;2021-04-14;6314;2299;182154;58592;16.8;5.4
35;2021-04-15;7565;2178;189719;60770;17.5;5.6
35;2021-04-16;8081;1761;197800;62531;18.3;5.8
35;2021-04-17;1571;222;199371;62753;18.4;5.8
35;2021-04-18;10;4;199381;62757;18.4;5.8
35;2021-04-19;4819;1667;204200;64424;18.9;6.0
35;2021-04-20;5165;2636;209365;67060;19.3;6.2
35;2021-04-21;5133;2208;214498;69268;19.8;6.4
35;2021-04-22;6429;2326;220927;71594;20.4;6.6
35;2021-04-23;6821;2365;227748;73959;21.0;6.8
35;2021-04-24;1131;261;228879;74220;21.2;6.9
35;2021-04-25;8;16;228887;74236;21.2;6.9
35;2021-04-26;5099;2153;233986;76389;21.6;7.1
35;2021-04-27;6089;3189;240075;79578;22.2;7.4
35;2021-04-28;6172;2548;246247;82126;22.8;7.6
35;2021-04-29;7117;2732;253364;84858;23.4;7.8
35;2021-04-30;7564;2521;260928;87379;24.1;8.1
35;2021-05-01;617;239;261545;87618;24.2;8.1
35;2021-05-02;15;21;261560;87639;24.2;8.1
35;2021-05-03;5307;2328;266867;89967;24.7;8.3
35;2021-05-04;5068;5316;271935;95283;25.1;8.8
35;2021-05-05;4883;4436;276818;99719;25.6;9.2
35;2021-05-06;6175;5257;282993;104976;26.2;9.7
35;2021-05-07;5620;5218;288613;110194;26.7;10.2
35;2021-05-08;1719;135;290332;110329;26.8;10.2
35;2021-05-09;698;75;291030;110404;26.9;10.2
35;2021-05-10;3719;4951;294749;115355;27.2;10.7
35;2021-05-11;4774;5795;299523;121150;27.7;11.2
35;2021-05-12;5292;5491;304815;126641;28.2;11.7
35;2021-05-13;2699;1424;307514;128065;28.4;11.8
35;2021-05-14;5460;4327;312974;132392;28.9;12.2
35;2021-05-15;2929;718;315903;133110;29.2;12.3
35;2021-05-16;997;61;316900;133171;29.3;12.3
35;2021-05-17;4474;3874;321374;137045;29.7;12.7
35;2021-05-18;5838;4316;327212;141361;30.2;13.1
35;2021-05-19;5866;3632;333078;144993;30.8;13.4
35;2021-05-20;6448;3996;339526;148989;31.4;13.8
35;2021-05-21;6139;4755;345665;153744;31.9;14.2
35;2021-05-22;2118;727;347783;154471;32.1;14.3
35;2021-05-23;688;46;348471;154517;32.2;14.3
35;2021-05-24;3206;1298;351677;155815;32.5;14.4
35;2021-05-25;5542;4271;357219;160086;33.0;14.8
35;2021-05-26;5720;4151;362939;164237;33.5;15.2
35;2021-05-27;6527;4750;369466;168987;34.1;15.6
35;2021-05-28;6330;5544;375796;174531;34.7;16.1
35;2021-05-29;2873;1137;378669;175668;35.0;16.2
35;2021-05-30;878;39;379547;175707;35.1;16.2
35;2021-05-31;6309;4380;385856;180087;35.7;16.6
35;2021-06-01;7365;5103;393221;185190;36.3;17.1
35;2021-06-02;7220;3789;400441;188979;37.0;17.5
35;2021-06-03;8155;4981;408596;193960;37.8;17.9
35;2021-06-04;7274;7442;415870;201402;38.4;18.6
35;2021-06-05;4138;1582;420008;202984;38.8;18.8
35;2021-06-06;3053;146;423061;203130;39.1;18.8
35;2021-06-07;5780;5771;428841;208901;39.6;19.3
35;2021-06-08;7604;5948;436445;214849;40.3;19.9
35;2021-06-09;8461;4807;444906;219656;41.1;20.3
35;2021-06-10;9346;4735;454252;224391;42.0;20.7
35;2021-06-11;8633;7461;462885;231852;42.8;21.4
35;2021-06-12;4684;1208;467569;233060;43.2;21.5
35;2021-06-13;3386;227;470955;233287;43.5;21.6
35;2021-06-14;6231;6517;477186;239804;44.1;22.2
35;2021-06-15;7505;6963;484691;246767;44.8;22.8
35;2021-06-16;8323;5623;493014;252390;45.6;23.3
35;2021-06-17;8896;5905;501910;258295;46.4;23.9
35;2021-06-18;8716;8088;510626;266383;47.2;24.6
35;2021-06-19;1504;2510;512130;268893;47.3;24.8
35;2021-06-20;2953;883;515083;269776;47.6;24.9
35;2021-06-21;5930;6373;521013;276149;48.1;25.5
35;2021-06-22;6841;7499;527854;283648;48.8;26.2
35;2021-06-23;7253;6143;535107;289791;49.5;26.8
35;2021-06-24;8367;5922;543474;295713;50.2;27.3
35;2021-06-25;6628;8478;550102;304191;50.8;28.1
35;2021-06-26;1107;3076;551209;307267;50.9;28.4
35;2021-06-27;2635;1031;553844;308298;51.2;28.5
35;2021-06-28;4298;7759;558142;316057;51.6;29.2
35;2021-06-29;5088;7971;563230;324028;52.1;29.9
35;2021-06-30;5602;7891;568832;331919;52.6;30.7
35;2021-07-01;6586;7539;575418;339458;53.2;31.4
35;2021-07-02;5329;9857;580747;349315;53.7;32.3
35;2021-07-03;1083;2838;581830;352153;53.8;32.5
35;2021-07-04;2149;1554;583979;353707;54.0;32.7
35;2021-07-05;3735;8209;587714;361916;54.3;33.4
35;2021-07-06;4787;9470;592501;371386;54.8;34.3
35;2021-07-07;5057;8316;597558;379702;55.2;35.1
35;2021-07-08;5386;8486;602944;388188;55.7;35.9
35;2021-07-09;3906;11543;606850;399731;56.1;36.9
35;2021-07-10;892;3147;607742;402878;56.2;37.2
35;2021-07-11;1300;2355;609042;405233;56.3;37.4
35;2021-07-12;3121;9145;612163;414378;56.6;38.3
35;2021-07-13;3980;10747;616143;425125;56.9;39.3
35;2021-07-14;2153;4450;618296;429575;57.1;39.7
35;2021-07-15;4293;10177;622589;439752;57.5;40.6
35;2021-07-16;4802;10998;627391;450750;58.0;41.7
35;2021-07-17;1988;4064;629379;454814;58.2;42.0
35;2021-07-18;844;2571;630223;457385;58.2;42.3
35;2021-07-19;3251;8971;633474;466356;58.5;43.1
35;2021-07-20;4244;10590;637718;476946;58.9;44.1
35;2021-07-21;4369;9385;642087;486331;59.3;44.9
35;2021-07-22;4852;9654;646939;495985;59.8;45.8
35;2021-07-23;4563;11009;651502;506994;60.2;46.9
35;2021-07-24;1587;4262;653089;511256;60.4;47.2
35;2021-07-25;815;2845;653904;514101;60.4;47.5
35;2021-07-26;3891;8734;657795;522835;60.8;48.3
35;2021-07-27;5281;9652;663076;532487;61.3;49.2
35;2021-07-28;5318;8669;668394;541156;61.8;50.0
35;2021-07-29;6114;8332;674508;549488;62.3;50.8
35;2021-07-30;5904;9085;680412;558573;62.9;51.6
35;2021-07-31;2323;3654;682735;562227;63.1;52.0
35;2021-08-01;1525;2415;684260;564642;63.2;52.2
35;2021-08-02;4757;6949;689017;571591;63.7;52.8
35;2021-08-03;6712;7580;695729;579171;64.3;53.5
35;2021-08-04;6712;6592;702441;585763;64.9;54.1
35;2021-08-05;6685;6981;709126;592744;65.5;54.8
35;2021-08-06;6065;7319;715191;600063;66.1;55.5
35;2021-08-07;2109;3149;717300;603212;66.3;55.7
35;2021-08-08;1523;2256;718823;605468;66.4;56.0
35;2021-08-09;4618;5534;723441;611002;66.9;56.5
35;2021-08-10;6565;6380;730006;617382;67.5;57.1
35;2021-08-11;6474;5862;736480;623244;68.1;57.6
35;2021-08-12;7014;5582;743494;628826;68.7;58.1
35;2021-08-13;6686;5064;750180;633890;69.3;58.6
35;2021-08-14;3047;1985;753227;635875;69.6;58.8
35;2021-08-15;2472;1261;755699;637136;69.8;58.9
35;2021-08-16;4872;5291;760571;642427;70.3;59.4
35;2021-08-17;6405;6081;766976;648508;70.9;59.9
35;2021-08-18;6488;5630;773464;654138;71.5;60.5
35;2021-08-19;6301;5762;779765;659900;72.1;61.0
35;2021-08-20;5134;6349;784899;666249;72.5;61.6
35;2021-08-21;2384;2633;787283;668882;72.8;61.8
35;2021-08-22;1765;1795;789048;670677;72.9;62.0
35;2021-08-23;3103;6012;792151;676689;73.2;62.5
35;2021-08-24;3498;7221;795649;683910;73.5;63.2
35;2021-08-25;3311;6616;798960;690526;73.8;63.8
35;2021-08-26;2639;6891;801599;697417;74.1;64.5
35;2021-08-27;2777;7257;804376;704674;74.3;65.1
35;2021-08-28;1177;2953;805553;707627;74.4;65.4
35;2021-08-29;517;1759;806070;709386;74.5;65.6
35;2021-08-30;1975;5494;808045;714880;74.7;66.1
35;2021-08-31;2381;6522;810426;721402;74.9;66.7
35;2021-09-01;1922;6094;812348;727496;75.1;67.2
35;2021-09-02;1838;6172;814186;733668;75.2;67.8
35;2021-09-03;2031;7048;816217;740716;75.4;68.5
35;2021-09-04;1125;4096;817342;744812;75.5;68.8
35;2021-09-05;516;2076;817858;746888;75.6;69.0
35;2021-09-06;1129;5011;818987;751899;75.7;69.5
35;2021-09-07;1321;5416;820308;757315;75.8;70.0
35;2021-09-08;1333;6262;821641;763577;75.9;70.6
35;2021-09-09;1247;5311;822888;768888;76.0;71.1
35;2021-09-10;1563;6592;824451;775480;76.2;71.7
35;2021-09-11;621;3898;825072;779378;76.2;72.0
35;2021-09-12;285;2373;825357;781751;76.3;72.2
35;2021-09-13;1310;4312;826667;786063;76.4;72.6
35;2021-09-14;1364;4451;828031;790514;76.5;73.1
35;2021-09-15;1222;4593;829253;795107;76.6;73.5
35;2021-09-16;1117;2842;830370;797949;76.7;73.7
35;2021-09-17;1268;3895;831638;801844;76.9;74.1
35;2021-09-18;514;2875;832152;804719;76.9;74.4
35;2021-09-19;167;1020;832319;805739;76.9;74.5
35;2021-09-20;1153;2647;833472;808386;77.0;74.7
35;2021-09-21;664;1925;834136;810311;77.1;74.9
35;2021-09-22;856;3621;834992;813932;77.2;75.2
35;2021-09-23;565;1531;835557;815463;77.2;75.4
35;2021-09-24;971;3037;836528;818500;77.3;75.6
35;2021-09-25;421;1958;836949;820458;77.3;75.8
35;2021-09-26;16;164;836965;820622;77.3;75.8
35;2021-09-27;518;1625;837483;822247;77.4;76.0
35;2021-09-28;459;1186;837942;823433;77.4;76.1
35;2021-09-29;604;1980;838546;825413;77.5;76.3
36;2020-12-27;0;0;0;0;0.0;0.0
36;2020-12-28;0;0;0;0;0.0;0.0
36;2020-12-29;0;0;0;0;0.0;0.0
36;2020-12-30;0;0;0;0;0.0;0.0
36;2020-12-31;0;0;0;0;0.0;0.0
36;2021-01-01;0;0;0;0;0.0;0.0
36;2021-01-02;0;0;0;0;0.0;0.0
36;2021-01-03;0;0;0;0;0.0;0.0
36;2021-01-04;2;0;2;0;0.0;0.0
36;2021-01-05;0;0;2;0;0.0;0.0
36;2021-01-06;24;0;26;0;0.0;0.0
36;2021-01-07;51;0;77;0;0.0;0.0
36;2021-01-08;111;0;188;0;0.1;0.0
36;2021-01-09;84;0;272;0;0.1;0.0
36;2021-01-10;142;0;414;0;0.2;0.0
36;2021-01-11;240;1;654;1;0.3;0.0
36;2021-01-12;282;0;936;1;0.4;0.0
36;2021-01-13;198;1;1134;2;0.5;0.0
36;2021-01-14;506;3;1640;5;0.8;0.0
36;2021-01-15;179;1;1819;6;0.8;0.0
36;2021-01-16;24;1;1843;7;0.8;0.0
36;2021-01-17;19;1;1862;8;0.9;0.0
36;2021-01-18;612;3;2474;11;1.1;0.0
36;2021-01-19;1173;1;3647;12;1.7;0.0
36;2021-01-20;1102;2;4749;14;2.2;0.0
36;2021-01-21;721;1;5470;15;2.5;0.0
36;2021-01-22;858;2;6328;17;2.9;0.0
36;2021-01-23;294;0;6622;17;3.0;0.0
36;2021-01-24;185;0;6807;17;3.1;0.0
36;2021-01-25;640;4;7447;21;3.4;0.0
36;2021-01-26;609;1;8056;22;3.7;0.0
36;2021-01-27;853;19;8909;41;4.1;0.0
36;2021-01-28;478;34;9387;75;4.3;0.0
36;2021-01-29;573;88;9960;163;4.6;0.1
36;2021-01-30;288;61;10248;224;4.7;0.1
36;2021-01-31;115;116;10363;340;4.8;0.2
36;2021-02-01;379;88;10742;428;4.9;0.2
36;2021-02-02;410;167;11152;595;5.1;0.3
36;2021-02-03;473;240;11625;835;5.4;0.4
36;2021-02-04;275;246;11900;1081;5.5;0.5
36;2021-02-05;301;151;12201;1232;5.6;0.6
36;2021-02-06;1;0;12202;1232;5.6;0.6
36;2021-02-07;1;0;12203;1232;5.6;0.6
36;2021-02-08;280;198;12483;1430;5.7;0.7
36;2021-02-09;328;536;12811;1966;5.9;0.9
36;2021-02-10;489;601;13300;2567;6.1;1.2
36;2021-02-11;384;566;13684;3133;6.3;1.4
36;2021-02-12;303;356;13987;3489;6.4;1.6
36;2021-02-13;126;54;14113;3543;6.5;1.6
36;2021-02-14;22;22;14135;3565;6.5;1.6
36;2021-02-15;42;443;14177;4008;6.5;1.8
36;2021-02-16;107;309;14284;4317;6.6;2.0
36;2021-02-17;117;480;14401;4797;6.6;2.2
36;2021-02-18;161;520;14562;5317;6.7;2.4
36;2021-02-19;181;408;14743;5725;6.8;2.6
36;2021-02-20;86;194;14829;5919;6.8;2.7
36;2021-02-21;87;127;14916;6046;6.9;2.8
36;2021-02-22;162;393;15078;6439;6.9;3.0
36;2021-02-23;62;498;15140;6937;7.0;3.2
36;2021-02-24;110;558;15250;7495;7.0;3.5
36;2021-02-25;251;226;15501;7721;7.1;3.6
36;2021-02-26;339;397;15840;8118;7.3;3.7
36;2021-02-27;73;216;15913;8334;7.3;3.8
36;2021-02-28;13;79;15926;8413;7.3;3.9
36;2021-03-01;218;301;16144;8714;7.4;4.0
36;2021-03-02;352;323;16496;9037;7.6;4.2
36;2021-03-03;394;482;16890;9519;7.8;4.4
36;2021-03-04;662;326;17552;9845;8.1;4.5
36;2021-03-05;800;271;18352;10116;8.5;4.7
36;2021-03-06;410;17;18762;10133;8.6;4.7
36;2021-03-07;339;8;19101;10141;8.8;4.7
36;2021-03-08;251;290;19352;10431;8.9;4.8
36;2021-03-09;449;241;19801;10672;9.1;4.9
36;2021-03-10;724;389;20525;11061;9.5;5.1
36;2021-03-11;840;237;21365;11298;9.8;5.2
36;2021-03-12;1446;295;22811;11593;10.5;5.3
36;2021-03-13;575;124;23386;11717;10.8;5.4
36;2021-03-14;113;1;23499;11718;10.8;5.4
36;2021-03-15;648;154;24147;11872;11.1;5.5
36;2021-03-16;445;67;24592;11939;11.3;5.5
36;2021-03-17;766;90;25358;12029;11.7;5.5
36;2021-03-18;414;72;25772;12101;11.9;5.6
36;2021-03-19;737;40;26509;12141;12.2;5.6
36;2021-03-20;451;26;26960;12167;12.4;5.6
36;2021-03-21;0;0;26960;12167;12.4;5.6
36;2021-03-22;497;59;27457;12226;12.6;5.6
36;2021-03-23;777;59;28234;12285;13.0;5.7
36;2021-03-24;1089;76;29323;12361;13.5;5.7
36;2021-03-25;1337;89;30660;12450;14.1;5.7
36;2021-03-26;1419;140;32079;12590;14.8;5.8
36;2021-03-27;475;43;32554;12633;15.0;5.8
36;2021-03-28;68;56;32622;12689;15.0;5.8
36;2021-03-29;462;182;33084;12871;15.2;5.9
36;2021-03-30;583;263;33667;13134;15.5;6.0
36;2021-03-31;1262;172;34929;13306;16.1;6.1
36;2021-04-01;1086;431;36015;13737;16.6;6.3
36;2021-04-02;966;143;36981;13880;17.0;6.4
36;2021-04-03;282;176;37263;14056;17.2;6.5
36;2021-04-04;42;2;37305;14058;17.2;6.5
36;2021-04-05;15;46;37320;14104;17.2;6.5
36;2021-04-06;820;361;38140;14465;17.6;6.7
36;2021-04-07;1072;539;39212;15004;18.1;6.9
36;2021-04-08;1347;479;40559;15483;18.7;7.1
36;2021-04-09;1937;403;42496;15886;19.6;7.3
36;2021-04-10;592;243;43088;16129;19.8;7.4
36;2021-04-11;256;90;43344;16219;20.0;7.5
36;2021-04-12;848;560;44192;16779;20.4;7.7
36;2021-04-13;1140;515;45332;17294;20.9;8.0
36;2021-04-14;1582;865;46914;18159;21.6;8.4
36;2021-04-15;1654;473;48568;18632;22.4;8.6
36;2021-04-16;1485;468;50053;19100;23.1;8.8
36;2021-04-17;893;250;50946;19350;23.5;8.9
36;2021-04-18;383;7;51329;19357;23.6;8.9
36;2021-04-19;874;443;52203;19800;24.0;9.1
36;2021-04-20;1145;520;53348;20320;24.6;9.4
36;2021-04-21;1240;879;54588;21199;25.1;9.8
36;2021-04-22;1593;869;56181;22068;25.9;10.2
36;2021-04-23;1329;614;57510;22682;26.5;10.4
36;2021-04-24;677;380;58187;23062;26.8;10.6
36;2021-04-25;413;94;58600;23156;27.0;10.7
36;2021-04-26;1134;446;59734;23602;27.5;10.9
36;2021-04-27;1277;551;61011;24153;28.1;11.1
36;2021-04-28;1488;1061;62499;25214;28.8;11.6
36;2021-04-29;2016;703;64515;25917;29.7;11.9
36;2021-04-30;1553;457;66068;26374;30.4;12.1
36;2021-05-01;724;62;66792;26436;30.8;12.2
36;2021-05-02;498;64;67290;26500;31.0;12.2
36;2021-05-03;1293;314;68583;26814;31.6;12.3
36;2021-05-04;780;803;69363;27617;31.9;12.7
36;2021-05-05;1282;1303;70645;28920;32.5;13.3
36;2021-05-06;2137;795;72782;29715;33.5;13.7
36;2021-05-07;1469;766;74251;30481;34.2;14.0
36;2021-05-08;306;105;74557;30586;34.3;14.1
36;2021-05-09;174;343;74731;30929;34.4;14.2
36;2021-05-10;1216;814;75947;31743;35.0;14.6
36;2021-05-11;1725;1244;77672;32987;35.8;15.2
36;2021-05-12;1827;1484;79499;34471;36.6;15.9
36;2021-05-13;548;304;80047;34775;36.9;16.0
36;2021-05-14;701;1035;80748;35810;37.2;16.5
36;2021-05-15;635;591;81383;36401;37.5;16.8
36;2021-05-16;337;377;81720;36778;37.6;16.9
36;2021-05-17;615;943;82335;37721;37.9;17.4
36;2021-05-18;874;935;83209;38656;38.3;17.8
36;2021-05-19;1333;846;84542;39502;38.9;18.2
36;2021-05-20;1611;1200;86153;40702;39.7;18.7
36;2021-05-21;1106;1064;87259;41766;40.2;19.2
36;2021-05-22;678;342;87937;42108;40.5;19.4
36;2021-05-23;428;297;88365;42405;40.7;19.5
36;2021-05-24;506;469;88871;42874;40.9;19.7
36;2021-05-25;1045;685;89916;43559;41.4;20.1
36;2021-05-26;1472;1158;91388;44717;42.1;20.6
36;2021-05-27;1397;975;92785;45692;42.7;21.0
36;2021-05-28;921;1480;93706;47172;43.2;21.7
36;2021-05-29;700;507;94406;47679;43.5;22.0
36;2021-05-30;111;572;94517;48251;43.5;22.2
36;2021-05-31;1137;763;95654;49014;44.1;22.6
36;2021-06-01;1413;829;97067;49843;44.7;23.0
36;2021-06-02;2062;614;99129;50457;45.7;23.2
36;2021-06-03;1902;1199;101031;51656;46.5;23.8
36;2021-06-04;1772;1038;102803;52694;47.3;24.3
36;2021-06-05;693;657;103496;53351;47.7;24.6
36;2021-06-06;336;272;103832;53623;47.8;24.7
36;2021-06-07;983;806;104815;54429;48.3;25.1
36;2021-06-08;957;981;105772;55410;48.7;25.5
36;2021-06-09;1675;1061;107447;56471;49.5;26.0
36;2021-06-10;1530;1381;108977;57852;50.2;26.6
36;2021-06-11;1288;1489;110265;59341;50.8;27.3
36;2021-06-12;920;779;111185;60120;51.2;27.7
36;2021-06-13;343;269;111528;60389;51.4;27.8
36;2021-06-14;605;1268;112133;61657;51.6;28.4
36;2021-06-15;733;1215;112866;62872;52.0;29.0
36;2021-06-16;903;1519;113769;64391;52.4;29.7
36;2021-06-17;750;1899;114519;66290;52.7;30.5
36;2021-06-18;706;1878;115225;68168;53.1;31.4
36;2021-06-19;295;395;115520;68563;53.2;31.6
36;2021-06-20;235;327;115755;68890;53.3;31.7
36;2021-06-21;692;1449;116447;70339;53.6;32.4
36;2021-06-22;841;1552;117288;71891;54.0;33.1
36;2021-06-23;774;1786;118062;73677;54.4;33.9
36;2021-06-24;855;1522;118917;75199;54.8;34.6
36;2021-06-25;942;1218;119859;76417;55.2;35.2
36;2021-06-26;324;602;120183;77019;55.3;35.5
36;2021-06-27;105;267;120288;77286;55.4;35.6
36;2021-06-28;696;922;120984;78208;55.7;36.0
36;2021-06-29;688;1459;121672;79667;56.0;36.7
36;2021-06-30;836;2148;122508;81815;56.4;37.7
36;2021-07-01;353;1081;122861;82896;56.6;38.2
36;2021-07-02;749;1843;123610;84739;56.9;39.0
36;2021-07-03;465;885;124075;85624;57.1;39.4
36;2021-07-04;185;325;124260;85949;57.2;39.6
36;2021-07-05;493;1335;124753;87284;57.5;40.2
36;2021-07-06;491;1220;125244;88504;57.7;40.8
36;2021-07-07;586;1791;125830;90295;57.9;41.6
36;2021-07-08;550;1706;126380;92001;58.2;42.4
36;2021-07-09;786;1651;127166;93652;58.6;43.1
36;2021-07-10;470;1119;127636;94771;58.8;43.6
36;2021-07-11;257;154;127893;94925;58.9;43.7
36;2021-07-12;332;1628;128225;96553;59.1;44.5
36;2021-07-13;311;1936;128536;98489;59.2;45.4
36;2021-07-14;376;763;128912;99252;59.4;45.7
36;2021-07-15;917;2161;129829;101413;59.8;46.7
36;2021-07-16;628;1869;130457;103282;60.1;47.6
36;2021-07-17;400;859;130857;104141;60.3;48.0
36;2021-07-18;199;408;131056;104549;60.4;48.1
36;2021-07-19;552;1456;131608;106005;60.6;48.8
36;2021-07-20;776;1406;132384;107411;61.0;49.5
36;2021-07-21;713;1984;133097;109395;61.3;50.4
36;2021-07-22;1138;1686;134235;111081;61.8;51.2
36;2021-07-23;968;1739;135203;112820;62.3;52.0
36;2021-07-24;605;800;135808;113620;62.5;52.3
36;2021-07-25;148;404;135956;114024;62.6;52.5
36;2021-07-26;948;1085;136904;115109;63.0;53.0
36;2021-07-27;816;1354;137720;116463;63.4;53.6
36;2021-07-28;1385;1401;139105;117864;64.1;54.3
36;2021-07-29;1707;1309;140812;119173;64.8;54.9
36;2021-07-30;1445;1322;142257;120495;65.5;55.5
36;2021-07-31;933;536;143190;121031;65.9;55.7
36;2021-08-01;210;239;143400;121270;66.0;55.8
36;2021-08-02;1116;891;144516;122161;66.6;56.3
36;2021-08-03;1271;997;145787;123158;67.1;56.7
36;2021-08-04;1694;940;147481;124098;67.9;57.2
36;2021-08-05;1823;910;149304;125008;68.8;57.6
36;2021-08-06;1417;877;150721;125885;69.4;58.0
36;2021-08-07;541;526;151262;126411;69.7;58.2
36;2021-08-08;292;153;151554;126564;69.8;58.3
36;2021-08-09;818;846;152372;127410;70.2;58.7
36;2021-08-10;1067;1011;153439;128421;70.7;59.1
36;2021-08-11;1356;857;154795;129278;71.3;59.5
36;2021-08-12;1161;854;155956;130132;71.8;59.9
36;2021-08-13;1192;778;157148;130910;72.4;60.3
36;2021-08-14;426;836;157574;131746;72.6;60.7
36;2021-08-15;365;113;157939;131859;72.7;60.7
36;2021-08-16;606;954;158545;132813;73.0;61.2
36;2021-08-17;766;1001;159311;133814;73.4;61.6
36;2021-08-18;1037;1163;160348;134977;73.8;62.2
36;2021-08-19;840;1178;161188;136155;74.2;62.7
36;2021-08-20;487;1479;161675;137634;74.5;63.4
36;2021-08-21;309;468;161984;138102;74.6;63.6
36;2021-08-22;27;65;162011;138167;74.6;63.6
36;2021-08-23;551;1179;162562;139346;74.9;64.2
36;2021-08-24;588;1203;163150;140549;75.1;64.7
36;2021-08-25;465;1092;163615;141641;75.4;65.2
36;2021-08-26;666;1480;164281;143121;75.7;65.9
36;2021-08-27;529;1409;164810;144530;75.9;66.6
36;2021-08-28;368;580;165178;145110;76.1;66.8
36;2021-08-29;221;240;165399;145350;76.2;66.9
36;2021-08-30;246;748;165645;146098;76.3;67.3
36;2021-08-31;387;935;166032;147033;76.5;67.7
36;2021-09-01;386;1219;166418;148252;76.6;68.3
36;2021-09-02;323;1055;166741;149307;76.8;68.8
36;2021-09-03;297;1494;167038;150801;76.9;69.4
36;2021-09-04;248;864;167286;151665;77.0;69.8
36;2021-09-05;119;384;167405;152049;77.1;70.0
36;2021-09-06;150;1041;167555;153090;77.2;70.5
36;2021-09-07;191;855;167746;153945;77.3;70.9
36;2021-09-08;237;1303;167983;155248;77.4;71.5
36;2021-09-09;292;1010;168275;156258;77.5;72.0
36;2021-09-10;269;1141;168544;157399;77.6;72.5
36;2021-09-11;163;761;168707;158160;77.7;72.8
36;2021-09-12;82;235;168789;158395;77.7;72.9
36;2021-09-13;168;734;168957;159129;77.8;73.3
36;2021-09-14;168;791;169125;159920;77.9;73.6
36;2021-09-15;301;568;169426;160488;78.0;73.9
36;2021-09-16;248;669;169674;161157;78.1;74.2
36;2021-09-17;256;567;169930;161724;78.3;74.5
36;2021-09-18;122;427;170052;162151;78.3;74.7
36;2021-09-19;43;214;170095;162365;78.3;74.8
36;2021-09-20;131;325;170226;162690;78.4;74.9
36;2021-09-21;132;300;170358;162990;78.5;75.1
36;2021-09-22;118;674;170476;163664;78.5;75.4
36;2021-09-23;134;437;170610;164101;78.6;75.6
36;2021-09-24;128;497;170738;164598;78.6;75.8
36;2021-09-25;119;502;170857;165100;78.7;76.0
36;2021-09-26;15;318;170872;165418;78.7;76.2
36;2021-09-27;66;224;170938;165642;78.7;76.3
36;2021-09-28;69;233;171007;165875;78.8;76.4
36;2021-09-29;107;387;171114;166262;78.8;76.6
37;2020-12-27;1;0;1;0;0.0;0.0
37;2020-12-28;17;0;18;0;0.0;0.0
37;2020-12-29;10;0;28;0;0.0;0.0
37;2020-12-30;0;0;28;0;0.0;0.0
37;2020-12-31;0;0;28;0;0.0;0.0
37;2021-01-01;0;0;28;0;0.0;0.0
37;2021-01-02;0;0;28;0;0.0;0.0
37;2021-01-03;2;0;30;0;0.0;0.0
37;2021-01-04;23;0;53;0;0.0;0.0
37;2021-01-05;47;0;100;0;0.0;0.0
37;2021-01-06;79;0;179;0;0.0;0.0
37;2021-01-07;116;0;295;0;0.0;0.0
37;2021-01-08;442;1;737;1;0.1;0.0
37;2021-01-09;80;1;817;2;0.1;0.0
37;2021-01-10;83;0;900;2;0.1;0.0
37;2021-01-11;280;0;1180;2;0.2;0.0
37;2021-01-12;658;4;1838;6;0.3;0.0
37;2021-01-13;560;1;2398;7;0.4;0.0
37;2021-01-14;524;3;2922;10;0.5;0.0
37;2021-01-15;627;1;3549;11;0.6;0.0
37;2021-01-16;304;2;3853;13;0.6;0.0
37;2021-01-17;262;1;4115;14;0.7;0.0
37;2021-01-18;733;9;4848;23;0.8;0.0
37;2021-01-19;1244;11;6092;34;1.0;0.0
37;2021-01-20;1038;5;7130;39;1.2;0.0
37;2021-01-21;857;1;7987;40;1.3;0.0
37;2021-01-22;767;2;8754;42;1.4;0.0
37;2021-01-23;173;0;8927;42;1.5;0.0
37;2021-01-24;1;0;8928;42;1.5;0.0
37;2021-01-25;541;15;9469;57;1.6;0.0
37;2021-01-26;1814;63;11283;120;1.9;0.0
37;2021-01-27;1523;67;12806;187;2.1;0.0
37;2021-01-28;1532;87;14338;274;2.4;0.0
37;2021-01-29;634;304;14972;578;2.5;0.1
37;2021-01-30;204;53;15176;631;2.5;0.1
37;2021-01-31;15;52;15191;683;2.5;0.1
37;2021-02-01;333;182;15524;865;2.6;0.1
37;2021-02-02;523;494;16047;1359;2.7;0.2
37;2021-02-03;659;330;16706;1689;2.8;0.3
37;2021-02-04;548;385;17254;2074;2.9;0.3
37;2021-02-05;468;406;17722;2480;2.9;0.4
37;2021-02-06;189;2;17911;2482;3.0;0.4
37;2021-02-07;20;1;17931;2483;3.0;0.4
37;2021-02-08;333;279;18264;2762;3.0;0.5
37;2021-02-09;627;620;18891;3382;3.1;0.6
37;2021-02-10;664;462;19555;3844;3.2;0.6
37;2021-02-11;613;522;20168;4366;3.3;0.7
37;2021-02-12;489;514;20657;4880;3.4;0.8
37;2021-02-13;156;169;20813;5049;3.4;0.8
37;2021-02-14;2;70;20815;5119;3.4;0.8
37;2021-02-15;427;389;21242;5508;3.5;0.9
37;2021-02-16;841;1318;22083;6826;3.6;1.1
37;2021-02-17;634;1218;22717;8044;3.8;1.3
37;2021-02-18;913;1288;23630;9332;3.9;1.5
37;2021-02-19;797;729;24427;10061;4.0;1.7
37;2021-02-20;245;155;24672;10216;4.1;1.7
37;2021-02-21;5;1;24677;10217;4.1;1.7
37;2021-02-22;335;465;25012;10682;4.1;1.8
37;2021-02-23;606;491;25618;11173;4.2;1.8
37;2021-02-24;573;482;26191;11655;4.3;1.9
37;2021-02-25;875;481;27066;12136;4.5;2.0
37;2021-02-26;1118;472;28184;12608;4.7;2.1
37;2021-02-27;585;131;28769;12739;4.8;2.1
37;2021-02-28;23;0;28792;12739;4.8;2.1
37;2021-03-01;603;307;29395;13046;4.9;2.2
37;2021-03-02;1090;457;30485;13503;5.0;2.2
37;2021-03-03;972;439;31457;13942;5.2;2.3
37;2021-03-04;1608;413;33065;14355;5.5;2.4
37;2021-03-05;2131;475;35196;14830;5.8;2.4
37;2021-03-06;1165;174;36361;15004;6.0;2.5
37;2021-03-07;472;66;36833;15070;6.1;2.5
37;2021-03-08;668;361;37501;15431;6.2;2.5
37;2021-03-09;1653;621;39154;16052;6.5;2.7
37;2021-03-10;1607;681;40761;16733;6.7;2.8
37;2021-03-11;2050;641;42811;17374;7.1;2.9
37;2021-03-12;3210;458;46021;17832;7.6;2.9
37;2021-03-13;1948;180;47969;18012;7.9;3.0
37;2021-03-14;206;4;48175;18016;8.0;3.0
37;2021-03-15;1069;243;49244;18259;8.1;3.0
37;2021-03-16;1049;522;50293;18781;8.3;3.1
37;2021-03-17;936;277;51229;19058;8.5;3.1
37;2021-03-18;1036;517;52265;19575;8.6;3.2
37;2021-03-19;2219;340;54484;19915;9.0;3.3
37;2021-03-20;1334;141;55818;20056;9.2;3.3
37;2021-03-21;205;3;56023;20059;9.3;3.3
37;2021-03-22;1287;238;57310;20297;9.5;3.4
37;2021-03-23;2257;563;59567;20860;9.8;3.4
37;2021-03-24;2245;463;61812;21323;10.2;3.5
37;2021-03-25;2984;440;64796;21763;10.7;3.6
37;2021-03-26;3524;402;68320;22165;11.3;3.7
37;2021-03-27;1175;125;69495;22290;11.5;3.7
37;2021-03-28;139;1;69634;22291;11.5;3.7
37;2021-03-29;1605;344;71239;22635;11.8;3.7
37;2021-03-30;2524;618;73763;23253;12.2;3.8
37;2021-03-31;2050;482;75813;23735;12.5;3.9
37;2021-04-01;2601;966;78414;24701;13.0;4.1
37;2021-04-02;2809;667;81223;25368;13.4;4.2
37;2021-04-03;817;222;82040;25590;13.6;4.2
37;2021-04-04;104;1;82144;25591;13.6;4.2
37;2021-04-05;4;0;82148;25591;13.6;4.2
37;2021-04-06;2242;782;84390;26373;13.9;4.4
37;2021-04-07;3172;876;87562;27249;14.5;4.5
37;2021-04-08;4043;964;91605;28213;15.1;4.7
37;2021-04-09;4544;947;96149;29160;15.9;4.8
37;2021-04-10;1328;429;97477;29589;16.1;4.9
37;2021-04-11;104;1;97581;29590;16.1;4.9
37;2021-04-12;2642;675;100223;30265;16.6;5.0
37;2021-04-13;4114;1163;104337;31428;17.2;5.2
37;2021-04-14;3043;895;107380;32323;17.7;5.3
37;2021-04-15;3758;1018;111138;33341;18.4;5.5
37;2021-04-16;4358;1229;115496;34570;19.1;5.7
37;2021-04-17;1147;223;116643;34793;19.3;5.7
37;2021-04-18;97;3;116740;34796;19.3;5.7
37;2021-04-19;2481;847;119221;35643;19.7;5.9
37;2021-04-20;3233;1339;122454;36982;20.2;6.1
37;2021-04-21;2928;1155;125382;38137;20.7;6.3
37;2021-04-22;3455;1400;128837;39537;21.3;6.5
37;2021-04-23;3693;1813;132530;41350;21.9;6.8
37;2021-04-24;1007;385;133537;41735;22.1;6.9
37;2021-04-25;46;2;133583;41737;22.1;6.9
37;2021-04-26;2971;1336;136554;43073;22.6;7.1
37;2021-04-27;4186;1799;140740;44872;23.2;7.4
37;2021-04-28;3464;1950;144204;46822;23.8;7.7
37;2021-04-29;4586;2002;148790;48824;24.6;8.1
37;2021-04-30;5055;1950;153845;50774;25.4;8.4
37;2021-05-01;638;209;154483;50983;25.5;8.4
37;2021-05-02;104;15;154587;50998;25.5;8.4
37;2021-05-03;2672;1957;157259;52955;26.0;8.7
37;2021-05-04;3730;2702;160989;55657;26.6;9.2
37;2021-05-05;3498;2071;164487;57728;27.2;9.5
37;2021-05-06;4992;1945;169479;59673;28.0;9.9
37;2021-05-07;4685;2868;174164;62541;28.8;10.3
37;2021-05-08;538;312;174702;62853;28.9;10.4
37;2021-05-09;63;41;174765;62894;28.9;10.4
37;2021-05-10;2160;3480;176925;66374;29.2;11.0
37;2021-05-11;3868;3868;180793;70242;29.9;11.6
37;2021-05-12;4041;2537;184834;72779;30.5;12.0
37;2021-05-13;1139;515;185973;73294;30.7;12.1
37;2021-05-14;4046;2676;190019;75970;31.4;12.5
37;2021-05-15;2322;743;192341;76713;31.8;12.7
37;2021-05-16;22;70;192363;76783;31.8;12.7
37;2021-05-17;2765;2038;195128;78821;32.2;13.0
37;2021-05-18;3875;2359;199003;81180;32.9;13.4
37;2021-05-19;3495;1808;202498;82988;33.4;13.7
37;2021-05-20;4751;1768;207249;84756;34.2;14.0
37;2021-05-21;4525;2569;211774;87325;35.0;14.4
37;2021-05-22;1078;751;212852;88076;35.2;14.5
37;2021-05-23;73;89;212925;88165;35.2;14.6
37;2021-05-24;513;106;213438;88271;35.3;14.6
37;2021-05-25;5123;2176;218561;90447;36.1;14.9
37;2021-05-26;4929;2099;223490;92546;36.9;15.3
37;2021-05-27;5984;2355;229474;94901;37.9;15.7
37;2021-05-28;6019;3248;235493;98149;38.9;16.2
37;2021-05-29;1520;1164;237013;99313;39.2;16.4
37;2021-05-30;55;160;237068;99473;39.2;16.4
37;2021-05-31;3646;2519;240714;101992;39.8;16.8
37;2021-06-01;5841;3610;246555;105602;40.7;17.4
37;2021-06-02;5077;2449;251632;108051;41.6;17.8
37;2021-06-03;6085;2876;257717;110927;42.6;18.3
37;2021-06-04;5509;4202;263226;115129;43.5;19.0
37;2021-06-05;1853;1300;265079;116429;43.8;19.2
37;2021-06-06;49;197;265128;116626;43.8;19.3
37;2021-06-07;3021;4164;268149;120790;44.3;20.0
37;2021-06-08;4201;4644;272350;125434;45.0;20.7
37;2021-06-09;3882;3564;276232;128998;45.6;21.3
37;2021-06-10;5271;3615;281503;132613;46.5;21.9
37;2021-06-11;4972;4821;286475;137434;47.3;22.7
37;2021-06-12;3552;1347;290027;138781;47.9;22.9
37;2021-06-13;15;164;290042;138945;47.9;23.0
37;2021-06-14;2666;4032;292708;142977;48.4;23.6
37;2021-06-15;3898;4779;296606;147756;49.0;24.4
37;2021-06-16;3261;3599;299867;151355;49.5;25.0
37;2021-06-17;4012;4492;303879;155847;50.2;25.7
37;2021-06-18;4704;5068;308583;160915;51.0;26.6
37;2021-06-19;2518;1098;311101;162013;51.4;26.8
37;2021-06-20;9;183;311110;162196;51.4;26.8
37;2021-06-21;2417;3827;313527;166023;51.8;27.4
37;2021-06-22;2968;5003;316495;171026;52.3;28.3
37;2021-06-23;2625;3642;319120;174668;52.7;28.9
37;2021-06-24;2872;3539;321992;178207;53.2;29.4
37;2021-06-25;3308;4876;325300;183083;53.7;30.2
37;2021-06-26;1238;3083;326538;186166;53.9;30.8
37;2021-06-27;23;142;326561;186308;53.9;30.8
37;2021-06-28;1703;4508;328264;190816;54.2;31.5
37;2021-06-29;1904;6223;330168;197039;54.5;32.5
37;2021-06-30;1870;4441;332038;201480;54.8;33.3
37;2021-07-01;2124;4793;334162;206273;55.2;34.1
37;2021-07-02;2681;5589;336843;211862;55.6;35.0
37;2021-07-03;945;2138;337788;214000;55.8;35.3
37;2021-07-04;5;105;337793;214105;55.8;35.4
37;2021-07-05;1708;5133;339501;219238;56.1;36.2
37;2021-07-06;2003;6757;341504;225995;56.4;37.3
37;2021-07-07;1944;5465;343448;231460;56.7;38.2
37;2021-07-08;2465;6662;345913;238122;57.1;39.3
37;2021-07-09;1986;7640;347899;245762;57.5;40.6
37;2021-07-10;1016;2618;348915;248380;57.6;41.0
37;2021-07-11;26;96;348941;248476;57.6;41.0
37;2021-07-12;1131;5982;350072;254458;57.8;42.0
37;2021-07-13;1615;7816;351687;262274;58.1;43.3
37;2021-07-14;525;408;352212;262682;58.2;43.4
37;2021-07-15;2625;7497;354837;270179;58.6;44.6
37;2021-07-16;2757;7796;357594;277975;59.1;45.9
37;2021-07-17;1202;2444;358796;280419;59.3;46.3
37;2021-07-18;50;53;358846;280472;59.3;46.3
37;2021-07-19;1652;6127;360498;286599;59.5;47.3
37;2021-07-20;2906;7060;363404;293659;60.0;48.5
37;2021-07-21;2980;5782;366384;299441;60.5;49.5
37;2021-07-22;4057;6531;370441;305972;61.2;50.5
37;2021-07-23;3808;7100;374249;313072;61.8;51.7
37;2021-07-24;1775;3306;376024;316378;62.1;52.3
37;2021-07-25;66;77;376090;316455;62.1;52.3
37;2021-07-26;3236;4318;379326;320773;62.7;53.0
37;2021-07-27;4429;4960;383755;325733;63.4;53.8
37;2021-07-28;4138;3660;387893;329393;64.1;54.4
37;2021-07-29;5086;4195;392979;333588;64.9;55.1
37;2021-07-30;5247;4936;398226;338524;65.8;55.9
37;2021-07-31;1920;1845;400146;340369;66.1;56.2
37;2021-08-01;31;52;400177;340421;66.1;56.2
37;2021-08-02;3292;3291;403469;343712;66.6;56.8
37;2021-08-03;5262;3144;408731;346856;67.5;57.3
37;2021-08-04;4559;1925;413290;348781;68.3;57.6
37;2021-08-05;4785;2600;418075;351381;69.1;58.0
37;2021-08-06;4852;3305;422927;354686;69.9;58.6
37;2021-08-07;1626;1125;424553;355811;70.1;58.8
37;2021-08-08;34;177;424587;355988;70.1;58.8
37;2021-08-09;2435;2259;427022;358247;70.5;59.2
37;2021-08-10;3026;2638;430048;360885;71.0;59.6
37;2021-08-11;2098;2108;432146;362993;71.4;60.0
37;2021-08-12;2613;2690;434759;365683;71.8;60.4
37;2021-08-13;2484;2775;437243;368458;72.2;60.9
37;2021-08-14;755;814;437998;369272;72.4;61.0
37;2021-08-15;12;57;438010;369329;72.4;61.0
37;2021-08-16;1464;3160;439474;372489;72.6;61.5
37;2021-08-17;1795;3973;441269;376462;72.9;62.2
37;2021-08-18;1398;3141;442667;379603;73.1;62.7
37;2021-08-19;1598;3842;444265;383445;73.4;63.3
37;2021-08-20;1597;4552;445862;387997;73.6;64.1
37;2021-08-21;610;1201;446472;389198;73.8;64.3
37;2021-08-22;3;31;446475;389229;73.8;64.3
37;2021-08-23;1290;3984;447765;393213;74.0;65.0
37;2021-08-24;1541;4851;449306;398064;74.2;65.8
37;2021-08-25;1053;4223;450359;402287;74.4;66.5
37;2021-08-26;1278;4513;451637;406800;74.6;67.2
37;2021-08-27;1454;5663;453091;412463;74.8;68.1
37;2021-08-28;407;1462;453498;413925;74.9;68.4
37;2021-08-29;1;18;453499;413943;74.9;68.4
37;2021-08-30;1076;3945;454575;417888;75.1;69.0
37;2021-08-31;1280;3831;455855;421719;75.3;69.7
37;2021-09-01;976;2687;456831;424406;75.5;70.1
37;2021-09-02;896;2810;457727;427216;75.6;70.6
37;2021-09-03;1043;3961;458770;431177;75.8;71.2
37;2021-09-04;666;1463;459436;432640;75.9;71.5
37;2021-09-05;1;30;459437;432670;75.9;71.5
37;2021-09-06;377;1314;459814;433984;76.0;71.7
37;2021-09-07;535;1508;460349;435492;76.0;71.9
37;2021-09-08;819;2081;461168;437573;76.2;72.3
37;2021-09-09;553;1535;461721;439108;76.3;72.5
37;2021-09-10;813;1908;462534;441016;76.4;72.8
37;2021-09-11;396;1008;462930;442024;76.5;73.0
37;2021-09-12;14;24;462944;442048;76.5;73.0
37;2021-09-13;450;1402;463394;443450;76.5;73.3
37;2021-09-14;508;1520;463902;444970;76.6;73.5
37;2021-09-15;622;1477;464524;446447;76.7;73.7
37;2021-09-16;352;767;464876;447214;76.8;73.9
37;2021-09-17;633;1469;465509;448683;76.9;74.1
37;2021-09-18;306;841;465815;449524;76.9;74.3
37;2021-09-19;16;42;465831;449566;76.9;74.3
37;2021-09-20;270;680;466101;450246;77.0;74.4
37;2021-09-21;438;1321;466539;451567;77.1;74.6
37;2021-09-22;425;1288;466964;452855;77.1;74.8
37;2021-09-23;426;1044;467390;453899;77.2;75.0
37;2021-09-24;500;1401;467890;455300;77.3;75.2
37;2021-09-25;231;766;468121;456066;77.3;75.3
37;2021-09-26;1;22;468122;456088;77.3;75.3
37;2021-09-27;289;690;468411;456778;77.4;75.5
37;2021-09-28;394;660;468805;457438;77.4;75.6
37;2021-09-29;366;938;469171;458376;77.5;75.7
38;2020-12-27;1;0;1;0;0.0;0.0
38;2020-12-28;1;0;2;0;0.0;0.0
38;2020-12-29;0;0;2;0;0.0;0.0
38;2020-12-30;2;0;4;0;0.0;0.0
38;2020-12-31;5;0;9;0;0.0;0.0
38;2021-01-01;3;0;12;0;0.0;0.0
38;2021-01-02;1;0;13;0;0.0;0.0
38;2021-01-03;3;0;16;0;0.0;0.0
38;2021-01-04;163;0;179;0;0.0;0.0
38;2021-01-05;258;1;437;1;0.0;0.0
38;2021-01-06;364;0;801;1;0.1;0.0
38;2021-01-07;636;1;1437;2;0.1;0.0
38;2021-01-08;695;0;2132;2;0.2;0.0
38;2021-01-09;30;0;2162;2;0.2;0.0
38;2021-01-10;2;0;2164;2;0.2;0.0
38;2021-01-11;801;1;2965;3;0.2;0.0
38;2021-01-12;1471;4;4436;7;0.4;0.0
38;2021-01-13;1084;5;5520;12;0.4;0.0
38;2021-01-14;1681;12;7201;24;0.6;0.0
38;2021-01-15;1675;7;8876;31;0.7;0.0
38;2021-01-16;307;1;9183;32;0.7;0.0
38;2021-01-17;3;0;9186;32;0.7;0.0
38;2021-01-18;1178;3;10364;35;0.8;0.0
38;2021-01-19;2241;5;12605;40;1.0;0.0
38;2021-01-20;1888;4;14493;44;1.1;0.0
38;2021-01-21;1644;7;16137;51;1.3;0.0
38;2021-01-22;1401;8;17538;59;1.4;0.0
38;2021-01-23;379;3;17917;62;1.4;0.0
38;2021-01-24;1;0;17918;62;1.4;0.0
38;2021-01-25;795;86;18713;148;1.5;0.0
38;2021-01-26;855;143;19568;291;1.5;0.0
38;2021-01-27;1093;230;20661;521;1.6;0.0
38;2021-01-28;1175;431;21836;952;1.7;0.1
38;2021-01-29;952;341;22788;1293;1.8;0.1
38;2021-01-30;304;0;23092;1293;1.8;0.1
38;2021-01-31;0;0;23092;1293;1.8;0.1
38;2021-02-01;703;550;23795;1843;1.9;0.1
38;2021-02-02;965;886;24760;2729;2.0;0.2
38;2021-02-03;1230;606;25990;3335;2.1;0.3
38;2021-02-04;1278;869;27268;4204;2.2;0.3
38;2021-02-05;1400;813;28668;5017;2.3;0.4
38;2021-02-06;188;80;28856;5097;2.3;0.4
38;2021-02-07;3;47;28859;5144;2.3;0.4
38;2021-02-08;862;643;29721;5787;2.3;0.5
38;2021-02-09;1537;1160;31258;6947;2.5;0.5
38;2021-02-10;1581;1152;32839;8099;2.6;0.6
38;2021-02-11;1871;1018;34710;9117;2.7;0.7
38;2021-02-12;1509;976;36219;10093;2.9;0.8
38;2021-02-13;467;164;36686;10257;2.9;0.8
38;2021-02-14;1;3;36687;10260;2.9;0.8
38;2021-02-15;976;749;37663;11009;3.0;0.9
38;2021-02-16;1379;801;39042;11810;3.1;0.9
38;2021-02-17;1376;872;40418;12682;3.2;1.0
38;2021-02-18;1791;899;42209;13581;3.3;1.1
38;2021-02-19;1255;680;43464;14261;3.4;1.1
38;2021-02-20;471;238;43935;14499;3.5;1.1
38;2021-02-21;1;0;43936;14499;3.5;1.1
38;2021-02-22;1074;708;45010;15207;3.6;1.2
38;2021-02-23;1542;799;46552;16006;3.7;1.3
38;2021-02-24;1739;972;48291;16978;3.8;1.3
38;2021-02-25;2500;889;50791;17867;4.0;1.4
38;2021-02-26;3311;838;54102;18705;4.3;1.5
38;2021-02-27;1511;352;55613;19057;4.4;1.5
38;2021-02-28;33;2;55646;19059;4.4;1.5
38;2021-03-01;2512;680;58158;19739;4.6;1.6
38;2021-03-02;4049;976;62207;20715;4.9;1.6
38;2021-03-03;3368;1128;65575;21843;5.2;1.7
38;2021-03-04;4489;1290;70064;23133;5.5;1.8
38;2021-03-05;5233;1080;75297;24213;6.0;1.9
38;2021-03-06;3042;261;78339;24474;6.2;1.9
38;2021-03-07;115;2;78454;24476;6.2;1.9
38;2021-03-08;2440;791;80894;25267;6.4;2.0
38;2021-03-09;4028;1204;84922;26471;6.7;2.1
38;2021-03-10;3508;996;88430;27467;7.0;2.2
38;2021-03-11;5142;1446;93572;28913;7.4;2.3
38;2021-03-12;7095;1128;100667;30041;8.0;2.4
38;2021-03-13;3771;225;104438;30266;8.3;2.4
38;2021-03-14;544;15;104982;30281;8.3;2.4
38;2021-03-15;2702;980;107684;31261;8.5;2.5
38;2021-03-16;2081;1272;109765;32533;8.7;2.6
38;2021-03-17;2024;1178;111789;33711;8.8;2.7
38;2021-03-18;2640;1339;114429;35050;9.0;2.8
38;2021-03-19;4009;1035;118438;36085;9.4;2.9
38;2021-03-20;1826;243;120264;36328;9.5;2.9
38;2021-03-21;132;8;120396;36336;9.5;2.9
38;2021-03-22;2867;983;123263;37319;9.7;3.0
38;2021-03-23;4781;1470;128044;38789;10.1;3.1
38;2021-03-24;3707;1538;131751;40327;10.4;3.2
38;2021-03-25;5791;1533;137542;41860;10.9;3.3
38;2021-03-26;6599;1735;144141;43595;11.4;3.4
38;2021-03-27;2513;756;146654;44351;11.6;3.5
38;2021-03-28;926;48;147580;44399;11.7;3.5
38;2021-03-29;2679;1835;150259;46234;11.9;3.7
38;2021-03-30;4563;2530;154822;48764;12.2;3.9
38;2021-03-31;3665;2218;158487;50982;12.5;4.0
38;2021-04-01;5135;2522;163622;53504;12.9;4.2
38;2021-04-02;3873;2516;167495;56020;13.2;4.4
38;2021-04-03;1418;938;168913;56958;13.4;4.5
38;2021-04-04;430;46;169343;57004;13.4;4.5
38;2021-04-05;2177;347;171520;57351;13.6;4.5
38;2021-04-06;4346;2399;175866;59750;13.9;4.7
38;2021-04-07;4415;2731;180281;62481;14.3;4.9
38;2021-04-08;5650;2665;185931;65146;14.7;5.1
38;2021-04-09;8561;2730;194492;67876;15.4;5.4
38;2021-04-10;3597;1478;198089;69354;15.7;5.5
38;2021-04-11;1048;100;199137;69454;15.7;5.5
38;2021-04-12;4203;2250;203340;71704;16.1;5.7
38;2021-04-13;6123;2469;209463;74173;16.6;5.9
38;2021-04-14;5118;2458;214581;76631;17.0;6.1
38;2021-04-15;6363;2768;220944;79399;17.5;6.3
38;2021-04-16;6213;2705;227157;82104;18.0;6.5
38;2021-04-17;2588;994;229745;83098;18.2;6.6
38;2021-04-18;1331;72;231076;83170;18.3;6.6
38;2021-04-19;3947;2835;235023;86005;18.6;6.8
38;2021-04-20;5425;2854;240448;88859;19.0;7.0
38;2021-04-21;4977;2707;245425;91566;19.4;7.2
38;2021-04-22;5790;2830;251215;94396;19.9;7.5
38;2021-04-23;6040;2820;257255;97216;20.3;7.7
38;2021-04-24;2665;1350;259920;98566;20.5;7.8
38;2021-04-25;805;590;260725;99156;20.6;7.8
38;2021-04-26;4487;2475;265212;101631;21.0;8.0
38;2021-04-27;6041;2719;271253;104350;21.4;8.2
38;2021-04-28;6198;2505;277451;106855;21.9;8.4
38;2021-04-29;8331;3064;285782;109919;22.6;8.7
38;2021-04-30;7674;4042;293456;113961;23.2;9.0
38;2021-05-01;1546;195;295002;114156;23.3;9.0
38;2021-05-02;847;74;295849;114230;23.4;9.0
38;2021-05-03;5300;3588;301149;117818;23.8;9.3
38;2021-05-04;6199;5082;307348;122900;24.3;9.7
38;2021-05-05;6067;4602;313415;127502;24.8;10.1
38;2021-05-06;6708;5327;320123;132829;25.3;10.5
38;2021-05-07;7284;6437;327407;139266;25.9;11.0
38;2021-05-08;3778;720;331185;139986;26.2;11.1
38;2021-05-09;2853;1931;334038;141917;26.4;11.2
38;2021-05-10;6156;5302;340194;147219;26.9;11.6
38;2021-05-11;8226;6016;348420;153235;27.5;12.1
38;2021-05-12;9044;4702;357464;157937;28.3;12.5
38;2021-05-13;6635;1417;364099;159354;28.8;12.6
38;2021-05-14;9565;3422;373664;162776;29.5;12.9
38;2021-05-15;6864;1450;380528;164226;30.1;13.0
38;2021-05-16;5474;650;386002;164876;30.5;13.0
38;2021-05-17;7671;3001;393673;167877;31.1;13.3
38;2021-05-18;8622;4031;402295;171908;31.8;13.6
38;2021-05-19;8157;3347;410452;175255;32.4;13.9
38;2021-05-20;8978;4492;419430;179747;33.2;14.2
38;2021-05-21;9959;4584;429389;184331;33.9;14.6
38;2021-05-22;7456;1905;436845;186236;34.5;14.7
38;2021-05-23;5589;580;442434;186816;35.0;14.8
38;2021-05-24;7503;1626;449937;188442;35.6;14.9
38;2021-05-25;9544;4850;459481;193292;36.3;15.3
38;2021-05-26;8126;4725;467607;198017;37.0;15.7
38;2021-05-27;9134;5656;476741;203673;37.7;16.1
38;2021-05-28;8786;6483;485527;210156;38.4;16.6
38;2021-05-29;5820;3246;491347;213402;38.8;16.9
38;2021-05-30;2695;1593;494042;214995;39.1;17.0
38;2021-05-31;8272;5131;502314;220126;39.7;17.4
38;2021-06-01;7964;6423;510278;226549;40.3;17.9
38;2021-06-02;7141;5615;517419;232164;40.9;18.4
38;2021-06-03;7393;6822;524812;238986;41.5;18.9
38;2021-06-04;8130;7610;532942;246596;42.1;19.5
38;2021-06-05;5794;3946;538736;250542;42.6;19.8
38;2021-06-06;2507;1463;541243;252005;42.8;19.9
38;2021-06-07;5554;6864;546797;258869;43.2;20.5
38;2021-06-08;5879;7523;552676;266392;43.7;21.1
38;2021-06-09;5048;6464;557724;272856;44.1;21.6
38;2021-06-10;5427;6789;563151;279645;44.5;22.1
38;2021-06-11;5887;7782;569038;287427;45.0;22.7
38;2021-06-12;3945;3259;572983;290686;45.3;23.0
38;2021-06-13;1256;1299;574239;291985;45.4;23.1
38;2021-06-14;3870;7661;578109;299646;45.7;23.7
38;2021-06-15;5234;8144;583343;307790;46.1;24.3
38;2021-06-16;5124;7402;588467;315192;46.5;24.9
38;2021-06-17;4523;7057;592990;322249;46.9;25.5
38;2021-06-18;6163;9226;599153;331475;47.4;26.2
38;2021-06-19;3596;4971;602749;336446;47.6;26.6
38;2021-06-20;1038;2901;603787;339347;47.7;26.8
38;2021-06-21;3747;8709;607534;348056;48.0;27.5
38;2021-06-22;3790;10103;611324;358159;48.3;28.3
38;2021-06-23;3155;9544;614479;367703;48.6;29.1
38;2021-06-24;3380;8587;617859;376290;48.8;29.7
38;2021-06-25;3786;11486;621645;387776;49.1;30.7
38;2021-06-26;2228;7851;623873;395627;49.3;31.3
38;2021-06-27;1098;4356;624971;399983;49.4;31.6
38;2021-06-28;2951;10302;627922;410285;49.6;32.4
38;2021-06-29;3784;10449;631706;420734;49.9;33.3
38;2021-06-30;4061;9941;635767;430675;50.3;34.0
38;2021-07-01;3548;9010;639315;439685;50.5;34.8
38;2021-07-02;3727;11616;643042;451301;50.8;35.7
38;2021-07-03;1739;8785;644781;460086;51.0;36.4
38;2021-07-04;1243;3209;646024;463295;51.1;36.6
38;2021-07-05;3058;10542;649082;473837;51.3;37.5
38;2021-07-06;3460;10235;652542;484072;51.6;38.3
38;2021-07-07;3569;9399;656111;493471;51.9;39.0
38;2021-07-08;3549;8221;659660;501692;52.1;39.7
38;2021-07-09;3897;10738;663557;512430;52.5;40.5
38;2021-07-10;2405;7801;665962;520231;52.6;41.1
38;2021-07-11;777;2030;666739;522261;52.7;41.3
38;2021-07-12;3483;10676;670222;532937;53.0;42.1
38;2021-07-13;6600;10932;676822;543869;53.5;43.0
38;2021-07-14;4670;3331;681492;547200;53.9;43.3
38;2021-07-15;8733;9667;690225;556867;54.6;44.0
38;2021-07-16;8759;10701;698984;567568;55.3;44.9
38;2021-07-17;4739;7485;703723;575053;55.6;45.5
38;2021-07-18;2570;2488;706293;577541;55.8;45.7
38;2021-07-19;5824;9220;712117;586761;56.3;46.4
38;2021-07-20;6289;8303;718406;595064;56.8;47.0
38;2021-07-21;7864;8028;726270;603092;57.4;47.7
38;2021-07-22;7598;6995;733868;610087;58.0;48.2
38;2021-07-23;8943;9043;742811;619130;58.7;48.9
38;2021-07-24;5577;5534;748388;624664;59.2;49.4
38;2021-07-25;2869;1654;751257;626318;59.4;49.5
38;2021-07-26;7869;7500;759126;633818;60.0;50.1
38;2021-07-27;7626;6274;766752;640092;60.6;50.6
38;2021-07-28;8622;5712;775374;645804;61.3;51.1
38;2021-07-29;7685;4680;783059;650484;61.9;51.4
38;2021-07-30;7809;6664;790868;657148;62.5;51.9
38;2021-07-31;4359;3603;795227;660751;62.9;52.2
38;2021-08-01;1298;1084;796525;661835;63.0;52.3
38;2021-08-02;3939;4453;800464;666288;63.3;52.7
38;2021-08-03;4590;4555;805054;670843;63.6;53.0
38;2021-08-04;4637;4354;809691;675197;64.0;53.4
38;2021-08-05;3738;4641;813429;679838;64.3;53.7
38;2021-08-06;4158;5949;817587;685787;64.6;54.2
38;2021-08-07;2318;3532;819905;689319;64.8;54.5
38;2021-08-08;791;2015;820696;691334;64.9;54.7
38;2021-08-09;3605;5576;824301;696910;65.2;55.1
38;2021-08-10;4897;6253;829198;703163;65.6;55.6
38;2021-08-11;3970;4664;833168;707827;65.9;56.0
38;2021-08-12;3393;4607;836561;712434;66.1;56.3
38;2021-08-13;4201;6033;840762;718467;66.5;56.8
38;2021-08-14;1784;4019;842546;722486;66.6;57.1
38;2021-08-15;538;1917;843084;724403;66.6;57.3
38;2021-08-16;2978;7924;846062;732327;66.9;57.9
38;2021-08-17;3445;5962;849507;738289;67.2;58.4
38;2021-08-18;2995;7138;852502;745427;67.4;58.9
38;2021-08-19;2615;4829;855117;750256;67.6;59.3
38;2021-08-20;2894;8428;858011;758684;67.8;60.0
38;2021-08-21;1206;5014;859217;763698;67.9;60.4
38;2021-08-22;510;1511;859727;765209;68.0;60.5
38;2021-08-23;2589;7622;862316;772831;68.2;61.1
38;2021-08-24;2568;5328;864884;778159;68.4;61.5
38;2021-08-25;2614;5876;867498;784035;68.6;62.0
38;2021-08-26;2276;4243;869774;788278;68.8;62.3
38;2021-08-27;2506;5931;872280;794209;69.0;62.8
38;2021-08-28;1423;3688;873703;797897;69.1;63.1
38;2021-08-29;376;1084;874079;798981;69.1;63.2
38;2021-08-30;2331;5782;876410;804763;69.3;63.6
38;2021-08-31;2219;4728;878629;809491;69.5;64.0
38;2021-09-01;2184;4375;880813;813866;69.6;64.3
38;2021-09-02;1666;3382;882479;817248;69.8;64.6
38;2021-09-03;2008;5072;884487;822320;69.9;65.0
38;2021-09-04;1149;2824;885636;825144;70.0;65.2
38;2021-09-05;391;724;886027;825868;70.0;65.3
38;2021-09-06;1192;3412;887219;829280;70.1;65.6
38;2021-09-07;1296;3374;888515;832654;70.2;65.8
38;2021-09-08;1721;3654;890236;836308;70.4;66.1
38;2021-09-09;1112;2356;891348;838664;70.5;66.3
38;2021-09-10;1576;3904;892924;842568;70.6;66.6
38;2021-09-11;1032;2396;893956;844964;70.7;66.8
38;2021-09-12;212;547;894168;845511;70.7;66.8
38;2021-09-13;906;2789;895074;848300;70.8;67.1
38;2021-09-14;908;2612;895982;850912;70.8;67.3
38;2021-09-15;1305;2759;897287;853671;70.9;67.5
38;2021-09-16;680;1552;897967;855223;71.0;67.6
38;2021-09-17;892;2497;898859;857720;71.1;67.8
38;2021-09-18;704;2220;899563;859940;71.1;68.0
38;2021-09-19;101;372;899664;860312;71.1;68.0
38;2021-09-20;598;1719;900262;862031;71.2;68.1
38;2021-09-21;487;1399;900749;863430;71.2;68.3
38;2021-09-22;688;2732;901437;866162;71.3;68.5
38;2021-09-23;446;1396;901883;867558;71.3;68.6
38;2021-09-24;772;2194;902655;869752;71.4;68.8
38;2021-09-25;491;1935;903146;871687;71.4;68.9
38;2021-09-26;94;378;903240;872065;71.4;68.9
38;2021-09-27;427;1227;903667;873292;71.4;69.0
38;2021-09-28;507;1115;904174;874407;71.5;69.1
38;2021-09-29;671;1901;904845;876308;71.5;69.3
39;2020-12-27;0;0;0;0;0.0;0.0
39;2020-12-28;0;0;0;0;0.0;0.0
39;2020-12-29;0;0;0;0;0.0;0.0
39;2020-12-30;0;0;0;0;0.0;0.0
39;2020-12-31;0;0;0;0;0.0;0.0
39;2021-01-01;0;0;0;0;0.0;0.0
39;2021-01-02;0;0;0;0;0.0;0.0
39;2021-01-03;0;0;0;0;0.0;0.0
39;2021-01-04;3;0;3;0;0.0;0.0
39;2021-01-05;3;0;6;0;0.0;0.0
39;2021-01-06;57;3;63;3;0.0;0.0
39;2021-01-07;333;2;396;5;0.2;0.0
39;2021-01-08;657;2;1053;7;0.4;0.0
39;2021-01-09;169;0;1222;7;0.5;0.0
39;2021-01-10;1;0;1223;7;0.5;0.0
39;2021-01-11;474;1;1697;8;0.7;0.0
39;2021-01-12;431;1;2128;9;0.8;0.0
39;2021-01-13;408;2;2536;11;1.0;0.0
39;2021-01-14;574;3;3110;14;1.2;0.0
39;2021-01-15;471;1;3581;15;1.4;0.0
39;2021-01-16;141;1;3722;16;1.4;0.0
39;2021-01-17;0;1;3722;17;1.4;0.0
39;2021-01-18;924;7;4646;24;1.8;0.0
39;2021-01-19;1181;6;5827;30;2.3;0.0
39;2021-01-20;905;4;6732;34;2.6;0.0
39;2021-01-21;1179;2;7911;36;3.1;0.0
39;2021-01-22;985;2;8896;38;3.5;0.0
39;2021-01-23;383;1;9279;39;3.6;0.0
39;2021-01-24;0;0;9279;39;3.6;0.0
39;2021-01-25;642;2;9921;41;3.8;0.0
39;2021-01-26;1122;11;11043;52;4.3;0.0
39;2021-01-27;927;16;11970;68;4.6;0.0
39;2021-01-28;741;232;12711;300;4.9;0.1
39;2021-01-29;583;410;13294;710;5.2;0.3
39;2021-01-30;265;104;13559;814;5.3;0.3
39;2021-01-31;1;0;13560;814;5.3;0.3
39;2021-02-01;562;251;14122;1065;5.5;0.4
39;2021-02-02;753;278;14875;1343;5.8;0.5
39;2021-02-03;531;497;15406;1840;6.0;0.7
39;2021-02-04;554;429;15960;2269;6.2;0.9
39;2021-02-05;438;403;16398;2672;6.4;1.0
39;2021-02-06;265;107;16663;2779;6.5;1.1
39;2021-02-07;0;1;16663;2780;6.5;1.1
39;2021-02-08;321;339;16984;3119;6.6;1.2
39;2021-02-09;383;461;17367;3580;6.7;1.4
39;2021-02-10;253;313;17620;3893;6.8;1.5
39;2021-02-11;587;499;18207;4392;7.1;1.7
39;2021-02-12;386;412;18593;4804;7.2;1.9
39;2021-02-13;99;61;18692;4865;7.2;1.9
39;2021-02-14;0;0;18692;4865;7.2;1.9
39;2021-02-15;99;657;18791;5522;7.3;2.1
39;2021-02-16;99;843;18890;6365;7.3;2.5
39;2021-02-17;58;630;18948;6995;7.3;2.7
39;2021-02-18;109;780;19057;7775;7.4;3.0
39;2021-02-19;100;438;19157;8213;7.4;3.2
39;2021-02-20;18;336;19175;8549;7.4;3.3
39;2021-02-21;0;0;19175;8549;7.4;3.3
39;2021-02-22;100;665;19275;9214;7.5;3.6
39;2021-02-23;4;712;19279;9926;7.5;3.8
39;2021-02-24;125;787;19404;10713;7.5;4.2
39;2021-02-25;214;697;19618;11410;7.6;4.4
39;2021-02-26;218;437;19836;11847;7.7;4.6
39;2021-02-27;169;264;20005;12111;7.8;4.7
39;2021-02-28;1;0;20006;12111;7.8;4.7
39;2021-03-01;218;605;20224;12716;7.8;4.9
39;2021-03-02;329;790;20553;13506;8.0;5.2
39;2021-03-03;602;513;21155;14019;8.2;5.4
39;2021-03-04;658;444;21813;14463;8.5;5.6
39;2021-03-05;670;308;22483;14771;8.7;5.7
39;2021-03-06;775;229;23258;15000;9.0;5.8
39;2021-03-07;242;84;23500;15084;9.1;5.8
39;2021-03-08;285;438;23785;15522;9.2;6.0
39;2021-03-09;844;448;24629;15970;9.6;6.2
39;2021-03-10;985;332;25614;16302;9.9;6.3
39;2021-03-11;829;450;26443;16752;10.3;6.5
39;2021-03-12;805;281;27248;17033;10.6;6.6
39;2021-03-13;789;102;28037;17135;10.9;6.6
39;2021-03-14;35;10;28072;17145;10.9;6.6
39;2021-03-15;513;107;28585;17252;11.1;6.7
39;2021-03-16;555;69;29140;17321;11.3;6.7
39;2021-03-17;611;56;29751;17377;11.5;6.7
39;2021-03-18;600;71;30351;17448;11.8;6.8
39;2021-03-19;393;68;30744;17516;11.9;6.8
39;2021-03-20;312;12;31056;17528;12.0;6.8
39;2021-03-21;3;0;31059;17528;12.0;6.8
39;2021-03-22;755;115;31814;17643;12.3;6.8
39;2021-03-23;1129;44;32943;17687;12.8;6.9
39;2021-03-24;1179;98;34122;17785;13.2;6.9
39;2021-03-25;2042;134;36164;17919;14.0;6.9
39;2021-03-26;797;115;36961;18034;14.3;7.0
39;2021-03-27;345;7;37306;18041;14.5;7.0
39;2021-03-28;36;4;37342;18045;14.5;7.0
39;2021-03-29;1036;194;38378;18239;14.9;7.1
39;2021-03-30;1400;268;39778;18507;15.4;7.2
39;2021-03-31;658;527;40436;19034;15.7;7.4
39;2021-04-01;1310;316;41746;19350;16.2;7.5
39;2021-04-02;626;129;42372;19479;16.4;7.6
39;2021-04-03;180;8;42552;19487;16.5;7.6
39;2021-04-04;4;1;42556;19488;16.5;7.6
39;2021-04-05;1;0;42557;19488;16.5;7.6
39;2021-04-06;824;634;43381;20122;16.8;7.8
39;2021-04-07;1133;680;44514;20802;17.3;8.1
39;2021-04-08;1790;580;46304;21382;18.0;8.3
39;2021-04-09;1675;293;47979;21675;18.6;8.4
39;2021-04-10;346;187;48325;21862;18.7;8.5
39;2021-04-11;2;0;48327;21862;18.7;8.5
39;2021-04-12;680;398;49007;22260;19.0;8.6
39;2021-04-13;1200;579;50207;22839;19.5;8.9
39;2021-04-14;845;640;51052;23479;19.8;9.1
39;2021-04-15;1479;722;52531;24201;20.4;9.4
39;2021-04-16;1090;176;53621;24377;20.8;9.5
39;2021-04-17;197;61;53818;24438;20.9;9.5
39;2021-04-18;0;0;53818;24438;20.9;9.5
39;2021-04-19;523;696;54341;25134;21.1;9.7
39;2021-04-20;766;547;55107;25681;21.4;10.0
39;2021-04-21;1143;723;56250;26404;21.8;10.2
39;2021-04-22;1012;1129;57262;27533;22.2;10.7
39;2021-04-23;457;364;57719;27897;22.4;10.8
39;2021-04-24;275;149;57994;28046;22.5;10.9
39;2021-04-25;12;3;58006;28049;22.5;10.9
39;2021-04-26;568;1040;58574;29089;22.7;11.3
39;2021-04-27;788;983;59362;30072;23.0;11.7
39;2021-04-28;1720;418;61082;30490;23.7;11.8
39;2021-04-29;2570;972;63652;31462;24.7;12.2
39;2021-04-30;2473;392;66125;31854;25.6;12.4
39;2021-05-01;41;53;66166;31907;25.7;12.4
39;2021-05-02;0;0;66166;31907;25.7;12.4
39;2021-05-03;917;811;67083;32718;26.0;12.7
39;2021-05-04;948;1122;68031;33840;26.4;13.1
39;2021-05-05;1954;882;69985;34722;27.1;13.5
39;2021-05-06;2424;1343;72409;36065;28.1;14.0
39;2021-05-07;1286;573;73695;36638;28.6;14.2
39;2021-05-08;179;55;73874;36693;28.7;14.2
39;2021-05-09;10;8;73884;36701;28.7;14.2
39;2021-05-10;1762;850;75646;37551;29.3;14.6
39;2021-05-11;1774;1514;77420;39065;30.0;15.2
39;2021-05-12;1810;1493;79230;40558;30.7;15.7
39;2021-05-13;246;23;79476;40581;30.8;15.7
39;2021-05-14;2392;335;81868;40916;31.8;15.9
39;2021-05-15;1848;255;83716;41171;32.5;16.0
39;2021-05-16;0;0;83716;41171;32.5;16.0
39;2021-05-17;1987;726;85703;41897;33.2;16.2
39;2021-05-18;1690;1180;87393;43077;33.9;16.7
39;2021-05-19;2496;555;89889;43632;34.9;16.9
39;2021-05-20;2465;756;92354;44388;35.8;17.2
39;2021-05-21;1800;561;94154;44949;36.5;17.4
39;2021-05-22;322;218;94476;45167;36.6;17.5
39;2021-05-23;8;36;94484;45203;36.6;17.5
39;2021-05-24;8;28;94492;45231;36.6;17.5
39;2021-05-25;1725;1197;96217;46428;37.3;18.0
39;2021-05-26;1643;1376;97860;47804;38.0;18.5
39;2021-05-27;1486;1623;99346;49427;38.5;19.2
39;2021-05-28;856;1219;100202;50646;38.9;19.6
39;2021-05-29;261;273;100463;50919;39.0;19.7
39;2021-05-30;2;40;100465;50959;39.0;19.8
39;2021-05-31;1625;1245;102090;52204;39.6;20.2
39;2021-06-01;1893;1321;103983;53525;40.3;20.8
39;2021-06-02;1706;1165;105689;54690;41.0;21.2
39;2021-06-03;1326;1158;107015;55848;41.5;21.7
39;2021-06-04;940;1070;107955;56918;41.9;22.1
39;2021-06-05;766;514;108721;57432;42.2;22.3
39;2021-06-06;1;36;108722;57468;42.2;22.3
39;2021-06-07;2103;918;110825;58386;43.0;22.6
39;2021-06-08;2209;1153;113034;59539;43.8;23.1
39;2021-06-09;1733;1240;114767;60779;44.5;23.6
39;2021-06-10;1616;2080;116383;62859;45.1;24.4
39;2021-06-11;1568;1270;117951;64129;45.7;24.9
39;2021-06-12;1262;348;119213;64477;46.2;25.0
39;2021-06-13;11;18;119224;64495;46.2;25.0
39;2021-06-14;1336;1889;120560;66384;46.8;25.7
39;2021-06-15;1386;1259;121946;67643;47.3;26.2
39;2021-06-16;1171;1532;123117;69175;47.7;26.8
39;2021-06-17;1044;1717;124161;70892;48.2;27.5
39;2021-06-18;1638;1180;125799;72072;48.8;28.0
39;2021-06-19;249;404;126048;72476;48.9;28.1
39;2021-06-20;2;18;126050;72494;48.9;28.1
39;2021-06-21;351;2495;126401;74989;49.0;29.1
39;2021-06-22;814;2293;127215;77282;49.3;30.0
39;2021-06-23;1200;1301;128415;78583;49.8;30.5
39;2021-06-24;736;1043;129151;79626;50.1;30.9
39;2021-06-25;679;2961;129830;82587;50.4;32.0
39;2021-06-26;206;1564;130036;84151;50.4;32.6
39;2021-06-27;0;0;130036;84151;50.4;32.6
39;2021-06-28;305;2743;130341;86894;50.5;33.7
39;2021-06-29;497;2697;130838;89591;50.7;34.7
39;2021-06-30;895;2424;131733;92015;51.1;35.7
39;2021-07-01;645;1939;132378;93954;51.3;36.4
39;2021-07-02;1111;1406;133489;95360;51.8;37.0
39;2021-07-03;554;524;134043;95884;52.0;37.2
39;2021-07-04;2;1;134045;95885;52.0;37.2
39;2021-07-05;602;2589;134647;98474;52.2;38.2
39;2021-07-06;835;1887;135482;100361;52.5;38.9
39;2021-07-07;591;1386;136073;101747;52.8;39.5
39;2021-07-08;700;906;136773;102653;53.0;39.8
39;2021-07-09;1078;1585;137851;104238;53.5;40.4
39;2021-07-10;739;476;138590;104714;53.7;40.6
39;2021-07-11;28;8;138618;104722;53.8;40.6
39;2021-07-12;577;2599;139195;107321;54.0;41.6
39;2021-07-13;1638;2659;140833;109980;54.6;42.7
39;2021-07-14;17;21;140850;110001;54.6;42.7
39;2021-07-15;1906;1838;142756;111839;55.4;43.4
39;2021-07-16;3226;2051;145982;113890;56.6;44.2
39;2021-07-17;2225;1163;148207;115053;57.5;44.6
39;2021-07-18;164;52;148371;115105;57.5;44.6
39;2021-07-19;1399;2950;149770;118055;58.1;45.8
39;2021-07-20;1842;2811;151612;120866;58.8;46.9
39;2021-07-21;2587;2581;154199;123447;59.8;47.9
39;2021-07-22;1934;1843;156133;125290;60.6;48.6
39;2021-07-23;1814;1933;157947;127223;61.3;49.3
39;2021-07-24;1400;1428;159347;128651;61.8;49.9
39;2021-07-25;0;1;159347;128652;61.8;49.9
39;2021-07-26;1318;2001;160665;130653;62.3;50.7
39;2021-07-27;2343;1903;163008;132556;63.2;51.4
39;2021-07-28;2688;1475;165696;134031;64.3;52.0
39;2021-07-29;2200;1743;167896;135774;65.1;52.7
39;2021-07-30;2045;1466;169941;137240;65.9;53.2
39;2021-07-31;1367;657;171308;137897;66.4;53.5
39;2021-08-01;10;18;171318;137915;66.4;53.5
39;2021-08-02;1205;1400;172523;139315;66.9;54.0
39;2021-08-03;1920;1486;174443;140801;67.7;54.6
39;2021-08-04;1046;659;175489;141460;68.1;54.9
39;2021-08-05;1241;740;176730;142200;68.5;55.1
39;2021-08-06;1375;2289;178105;144489;69.1;56.0
39;2021-08-07;1069;1213;179174;145702;69.5;56.5
39;2021-08-08;26;10;179200;145712;69.5;56.5
39;2021-08-09;436;304;179636;146016;69.7;56.6
39;2021-08-10;1229;931;180865;146947;70.1;57.0
39;2021-08-11;893;1532;181758;148479;70.5;57.6
39;2021-08-12;1596;2170;183354;150649;71.1;58.4
39;2021-08-13;1333;2119;184687;152768;71.6;59.2
39;2021-08-14;361;1106;185048;153874;71.8;59.7
39;2021-08-15;1;1;185049;153875;71.8;59.7
39;2021-08-16;488;736;185537;154611;72.0;60.0
39;2021-08-17;573;1442;186110;156053;72.2;60.5
39;2021-08-18;862;1727;186972;157780;72.5;61.2
39;2021-08-19;906;1593;187878;159373;72.9;61.8
39;2021-08-20;639;2500;188517;161873;73.1;62.8
39;2021-08-21;467;1291;188984;163164;73.3;63.3
39;2021-08-22;7;11;188991;163175;73.3;63.3
39;2021-08-23;265;972;189256;164147;73.4;63.7
39;2021-08-24;455;1607;189711;165754;73.6;64.3
39;2021-08-25;629;1604;190340;167358;73.8;64.9
39;2021-08-26;717;1859;191057;169217;74.1;65.6
39;2021-08-27;405;2060;191462;171277;74.3;66.4
39;2021-08-28;325;1369;191787;172646;74.4;67.0
39;2021-08-29;0;1;191787;172647;74.4;67.0
39;2021-08-30;345;1018;192132;173665;74.5;67.4
39;2021-08-31;398;1036;192530;174701;74.7;67.8
39;2021-09-01;510;1580;193040;176281;74.9;68.4
39;2021-09-02;332;1418;193372;177699;75.0;68.9
39;2021-09-03;475;2312;193847;180011;75.2;69.8
39;2021-09-04;148;212;193995;180223;75.2;69.9
39;2021-09-05;0;1;193995;180224;75.2;69.9
39;2021-09-06;239;524;194234;180748;75.3;70.1
39;2021-09-07;228;344;194462;181092;75.4;70.2
39;2021-09-08;441;779;194903;181871;75.6;70.5
39;2021-09-09;420;1117;195323;182988;75.8;71.0
39;2021-09-10;198;737;195521;183725;75.8;71.3
39;2021-09-11;282;889;195803;184614;75.9;71.6
39;2021-09-12;0;32;195803;184646;75.9;71.6
39;2021-09-13;141;221;195944;184867;76.0;71.7
39;2021-09-14;182;414;196126;185281;76.1;71.9
39;2021-09-15;266;585;196392;185866;76.2;72.1
39;2021-09-16;469;1051;196861;186917;76.3;72.5
39;2021-09-17;420;667;197281;187584;76.5;72.7
39;2021-09-18;96;237;197377;187821;76.5;72.8
39;2021-09-19;3;3;197380;187824;76.5;72.8
39;2021-09-20;70;128;197450;187952;76.6;72.9
39;2021-09-21;87;125;197537;188077;76.6;72.9
39;2021-09-22;268;777;197805;188854;76.7;73.2
39;2021-09-23;172;312;197977;189166;76.8;73.4
39;2021-09-24;206;584;198183;189750;76.9;73.6
39;2021-09-25;65;250;198248;190000;76.9;73.7
39;2021-09-26;0;0;198248;190000;76.9;73.7
39;2021-09-27;131;318;198379;190318;76.9;73.8
39;2021-09-28;55;138;198434;190456;77.0;73.9
39;2021-09-29;195;509;198629;190965;77.0;74.1
40;2020-12-27;0;0;0;0;0.0;0.0
40;2020-12-28;0;0;0;0;0.0;0.0
40;2020-12-29;0;0;0;0;0.0;0.0
40;2020-12-30;0;0;0;0;0.0;0.0
40;2020-12-31;1;0;1;0;0.0;0.0
40;2021-01-01;0;0;1;0;0.0;0.0
40;2021-01-02;0;0;1;0;0.0;0.0
40;2021-01-03;0;0;1;0;0.0;0.0
40;2021-01-04;0;0;1;0;0.0;0.0
40;2021-01-05;0;0;1;0;0.0;0.0
40;2021-01-06;1;0;2;0;0.0;0.0
40;2021-01-07;212;0;214;0;0.1;0.0
40;2021-01-08;391;2;605;2;0.1;0.0
40;2021-01-09;0;0;605;2;0.1;0.0
40;2021-01-10;1;0;606;2;0.1;0.0
40;2021-01-11;111;0;717;2;0.2;0.0
40;2021-01-12;0;0;717;2;0.2;0.0
40;2021-01-13;681;5;1398;7;0.3;0.0
40;2021-01-14;901;7;2299;14;0.6;0.0
40;2021-01-15;811;3;3110;17;0.8;0.0
40;2021-01-16;157;0;3267;17;0.8;0.0
40;2021-01-17;1;1;3268;18;0.8;0.0
40;2021-01-18;405;0;3673;18;0.9;0.0
40;2021-01-19;1203;3;4876;21;1.2;0.0
40;2021-01-20;881;2;5757;23;1.4;0.0
40;2021-01-21;1266;5;7023;28;1.7;0.0
40;2021-01-22;811;2;7834;30;1.9;0.0
40;2021-01-23;289;0;8123;30;2.0;0.0
40;2021-01-24;2;0;8125;30;2.0;0.0
40;2021-01-25;393;2;8518;32;2.1;0.0
40;2021-01-26;802;5;9320;37;2.3;0.0
40;2021-01-27;1118;11;10438;48;2.5;0.0
40;2021-01-28;709;109;11147;157;2.7;0.0
40;2021-01-29;601;225;11748;382;2.9;0.1
40;2021-01-30;237;3;11985;385;2.9;0.1
40;2021-01-31;1;0;11986;385;2.9;0.1
40;2021-02-01;359;127;12345;512;3.0;0.1
40;2021-02-02;922;50;13267;562;3.2;0.1
40;2021-02-03;894;294;14161;856;3.4;0.2
40;2021-02-04;1059;543;15220;1399;3.7;0.3
40;2021-02-05;794;333;16014;1732;3.9;0.4
40;2021-02-06;382;81;16396;1813;4.0;0.4
40;2021-02-07;10;0;16406;1813;4.0;0.4
40;2021-02-08;373;103;16779;1916;4.1;0.5
40;2021-02-09;811;499;17590;2415;4.3;0.6
40;2021-02-10;749;394;18339;2809;4.5;0.7
40;2021-02-11;739;556;19078;3365;4.6;0.8
40;2021-02-12;628;570;19706;3935;4.8;1.0
40;2021-02-13;400;83;20106;4018;4.9;1.0
40;2021-02-14;0;0;20106;4018;4.9;1.0
40;2021-02-15;48;319;20154;4337;4.9;1.1
40;2021-02-16;284;487;20438;4824;5.0;1.2
40;2021-02-17;359;804;20797;5628;5.0;1.4
40;2021-02-18;383;587;21180;6215;5.1;1.5
40;2021-02-19;145;551;21325;6766;5.2;1.6
40;2021-02-20;39;80;21364;6846;5.2;1.7
40;2021-02-21;1;63;21365;6909;5.2;1.7
40;2021-02-22;53;453;21418;7362;5.2;1.8
40;2021-02-23;179;688;21597;8050;5.2;2.0
40;2021-02-24;283;570;21880;8620;5.3;2.1
40;2021-02-25;726;861;22606;9481;5.5;2.3
40;2021-02-26;656;518;23262;9999;5.6;2.4
40;2021-02-27;384;91;23646;10090;5.7;2.4
40;2021-02-28;2;0;23648;10090;5.7;2.4
40;2021-03-01;418;441;24066;10531;5.8;2.6
40;2021-03-02;733;863;24799;11394;6.0;2.8
40;2021-03-03;934;760;25733;12154;6.2;3.0
40;2021-03-04;1321;722;27054;12876;6.6;3.1
40;2021-03-05;1233;645;28287;13521;6.9;3.3
40;2021-03-06;867;338;29154;13859;7.1;3.4
40;2021-03-07;92;2;29246;13861;7.1;3.4
40;2021-03-08;838;434;30084;14295;7.3;3.5
40;2021-03-09;1505;555;31589;14850;7.7;3.6
40;2021-03-10;1754;672;33343;15522;8.1;3.8
40;2021-03-11;1986;631;35329;16153;8.6;3.9
40;2021-03-12;2050;519;37379;16672;9.1;4.0
40;2021-03-13;972;245;38351;16917;9.3;4.1
40;2021-03-14;98;0;38449;16917;9.3;4.1
40;2021-03-15;925;87;39374;17004;9.6;4.1
40;2021-03-16;988;260;40362;17264;9.8;4.2
40;2021-03-17;1577;335;41939;17599;10.2;4.3
40;2021-03-18;1559;332;43498;17931;10.6;4.4
40;2021-03-19;1808;140;45306;18071;11.0;4.4
40;2021-03-20;706;14;46012;18085;11.2;4.4
40;2021-03-21;52;1;46064;18086;11.2;4.4
40;2021-03-22;1174;35;47238;18121;11.5;4.4
40;2021-03-23;2325;167;49563;18288;12.0;4.4
40;2021-03-24;2326;232;51889;18520;12.6;4.5
40;2021-03-25;2768;380;54657;18900;13.3;4.6
40;2021-03-26;3123;202;57780;19102;14.0;4.6
40;2021-03-27;923;47;58703;19149;14.2;4.6
40;2021-03-28;178;47;58881;19196;14.3;4.7
40;2021-03-29;1153;374;60034;19570;14.6;4.8
40;2021-03-30;2298;387;62332;19957;15.1;4.8
40;2021-03-31;1994;300;64326;20257;15.6;4.9
40;2021-04-01;2413;333;66739;20590;16.2;5.0
40;2021-04-02;2361;219;69100;20809;16.8;5.1
40;2021-04-03;741;120;69841;20929;17.0;5.1
40;2021-04-04;362;8;70203;20937;17.0;5.1
40;2021-04-05;523;40;70726;20977;17.2;5.1
40;2021-04-06;2095;802;72821;21779;17.7;5.3
40;2021-04-07;2664;869;75485;22648;18.3;5.5
40;2021-04-08;3061;895;78546;23543;19.1;5.7
40;2021-04-09;3826;604;82372;24147;20.0;5.9
40;2021-04-10;1599;341;83971;24488;20.4;5.9
40;2021-04-11;52;6;84023;24494;20.4;5.9
40;2021-04-12;2178;729;86201;25223;20.9;6.1
40;2021-04-13;2567;1089;88768;26312;21.5;6.4
40;2021-04-14;2572;1375;91340;27687;22.2;6.7
40;2021-04-15;2987;1504;94327;29191;22.9;7.1
40;2021-04-16;2878;1180;97205;30371;23.6;7.4
40;2021-04-17;1464;345;98669;30716;24.0;7.5
40;2021-04-18;57;24;98726;30740;24.0;7.5
40;2021-04-19;1056;1019;99782;31759;24.2;7.7
40;2021-04-20;1622;1743;101404;33502;24.6;8.1
40;2021-04-21;1777;1734;103181;35236;25.0;8.6
40;2021-04-22;2112;1771;105293;37007;25.6;9.0
40;2021-04-23;2163;1390;107456;38397;26.1;9.3
40;2021-04-24;1329;622;108785;39019;26.4;9.5
40;2021-04-25;37;57;108822;39076;26.4;9.5
40;2021-04-26;1251;1133;110073;40209;26.7;9.8
40;2021-04-27;1487;2030;111560;42239;27.1;10.3
40;2021-04-28;2052;1365;113612;43604;27.6;10.6
40;2021-04-29;2608;1888;116220;45492;28.2;11.0
40;2021-04-30;2701;1613;118921;47105;28.9;11.4
40;2021-05-01;1228;781;120149;47886;29.2;11.6
40;2021-05-02;143;322;120292;48208;29.2;11.7
40;2021-05-03;1857;1498;122149;49706;29.6;12.1
40;2021-05-04;1880;2465;124029;52171;30.1;12.7
40;2021-05-05;2187;2668;126216;54839;30.6;13.3
40;2021-05-06;2237;2864;128453;57703;31.2;14.0
40;2021-05-07;1902;3003;130355;60706;31.6;14.7
40;2021-05-08;674;469;131029;61175;31.8;14.8
40;2021-05-09;316;22;131345;61197;31.9;14.9
40;2021-05-10;1400;2040;132745;63237;32.2;15.3
40;2021-05-11;2196;2504;134941;65741;32.8;16.0
40;2021-05-12;2731;1943;137672;67684;33.4;16.4
40;2021-05-13;1984;511;139656;68195;33.9;16.6
40;2021-05-14;2324;1657;141980;69852;34.5;17.0
40;2021-05-15;1340;961;143320;70813;34.8;17.2
40;2021-05-16;434;24;143754;70837;34.9;17.2
40;2021-05-17;2119;1305;145873;72142;35.4;17.5
40;2021-05-18;2508;1404;148381;73546;36.0;17.9
40;2021-05-19;2954;1105;151335;74651;36.7;18.1
40;2021-05-20;3584;1159;154919;75810;37.6;18.4
40;2021-05-21;2925;1319;157844;77129;38.3;18.7
40;2021-05-22;1146;794;158990;77923;38.6;18.9
40;2021-05-23;631;29;159621;77952;38.7;18.9
40;2021-05-24;1212;332;160833;78284;39.0;19.0
40;2021-05-25;2168;1310;163001;79594;39.6;19.3
40;2021-05-26;2614;1562;165615;81156;40.2;19.7
40;2021-05-27;2733;1998;168348;83154;40.9;20.2
40;2021-05-28;2567;2270;170915;85424;41.5;20.7
40;2021-05-29;1558;1252;172473;86676;41.9;21.0
40;2021-05-30;4;52;172477;86728;41.9;21.1
40;2021-05-31;2566;1207;175043;87935;42.5;21.3
40;2021-06-01;3011;1766;178054;89701;43.2;21.8
40;2021-06-02;3170;1988;181224;91689;44.0;22.3
40;2021-06-03;3591;2330;184815;94019;44.9;22.8
40;2021-06-04;3015;2802;187830;96821;45.6;23.5
40;2021-06-05;1780;1395;189610;98216;46.0;23.8
40;2021-06-06;458;79;190068;98295;46.1;23.9
40;2021-06-07;2184;2021;192252;100316;46.7;24.3
40;2021-06-08;2954;2096;195206;102412;47.4;24.9
40;2021-06-09;3212;2266;198418;104678;48.2;25.4
40;2021-06-10;2994;2097;201412;106775;48.9;25.9
40;2021-06-11;3142;2792;204554;109567;49.7;26.6
40;2021-06-12;1963;1634;206517;111201;50.1;27.0
40;2021-06-13;645;162;207162;111363;50.3;27.0
40;2021-06-14;1457;2494;208619;113857;50.6;27.6
40;2021-06-15;2235;2818;210854;116675;51.2;28.3
40;2021-06-16;2608;2458;213462;119133;51.8;28.9
40;2021-06-17;2431;2439;215893;121572;52.4;29.5
40;2021-06-18;2325;2902;218218;124474;53.0;30.2
40;2021-06-19;1799;1226;220017;125700;53.4;30.5
40;2021-06-20;346;276;220363;125976;53.5;30.6
40;2021-06-21;1395;2317;221758;128293;53.8;31.1
40;2021-06-22;1690;2994;223448;131287;54.2;31.9
40;2021-06-23;1603;3343;225051;134630;54.6;32.7
40;2021-06-24;1733;2384;226784;137014;55.0;33.3
40;2021-06-25;1757;3258;228541;140272;55.5;34.0
40;2021-06-26;1328;1712;229869;141984;55.8;34.5
40;2021-06-27;262;354;230131;142338;55.9;34.5
40;2021-06-28;1334;2818;231465;145156;56.2;35.2
40;2021-06-29;1712;3392;233177;148548;56.6;36.1
40;2021-06-30;1772;3638;234949;152186;57.0;36.9
40;2021-07-01;1714;3951;236663;156137;57.4;37.9
40;2021-07-02;1561;3809;238224;159946;57.8;38.8
40;2021-07-03;676;1919;238900;161865;58.0;39.3
40;2021-07-04;219;483;239119;162348;58.0;39.4
40;2021-07-05;1477;3020;240596;165368;58.4;40.1
40;2021-07-06;1768;3613;242364;168981;58.8;41.0
40;2021-07-07;1973;3847;244337;172828;59.3;42.0
40;2021-07-08;2099;3408;246436;176236;59.8;42.8
40;2021-07-09;2108;3946;248544;180182;60.3;43.7
40;2021-07-10;1004;2156;249548;182338;60.6;44.3
40;2021-07-11;207;294;249755;182632;60.6;44.3
40;2021-07-12;1314;4045;251069;186677;60.9;45.3
40;2021-07-13;2428;4697;253497;191374;61.5;46.5
40;2021-07-14;2198;2059;255695;193433;62.1;47.0
40;2021-07-15;2842;4859;258537;198292;62.8;48.1
40;2021-07-16;3311;3944;261848;202236;63.6;49.1
40;2021-07-17;2110;2595;263958;204831;64.1;49.7
40;2021-07-18;472;542;264430;205373;64.2;49.9
40;2021-07-19;2565;3697;266995;209070;64.8;50.7
40;2021-07-20;3065;4050;270060;213120;65.6;51.7
40;2021-07-21;3203;3887;273263;217007;66.3;52.7
40;2021-07-22;3857;3933;277120;220940;67.3;53.6
40;2021-07-23;4092;4110;281212;225050;68.3;54.6
40;2021-07-24;2795;2113;284007;227163;68.9;55.1
40;2021-07-25;958;490;284965;227653;69.2;55.3
40;2021-07-26;2940;3076;287905;230729;69.9;56.0
40;2021-07-27;3526;3602;291431;234331;70.7;56.9
40;2021-07-28;3379;3396;294810;237727;71.6;57.7
40;2021-07-29;3546;3432;298356;241159;72.4;58.5
40;2021-07-30;3136;3405;301492;244564;73.2;59.4
40;2021-07-31;1781;1907;303273;246471;73.6;59.8
40;2021-08-01;342;287;303615;246758;73.7;59.9
40;2021-08-02;2003;2382;305618;249140;74.2;60.5
40;2021-08-03;2335;2695;307953;251835;74.7;61.1
40;2021-08-04;2093;2323;310046;254158;75.3;61.7
40;2021-08-05;1971;2669;312017;256827;75.7;62.3
40;2021-08-06;1886;3067;313903;259894;76.2;63.1
40;2021-08-07;1218;1746;315121;261640;76.5;63.5
40;2021-08-08;84;154;315205;261794;76.5;63.5
40;2021-08-09;1600;3124;316805;264918;76.9;64.3
40;2021-08-10;1429;3158;318234;268076;77.2;65.1
40;2021-08-11;1422;2844;319656;270920;77.6;65.8
40;2021-08-12;1277;3101;320933;274021;77.9;66.5
40;2021-08-13;1138;2979;322071;277000;78.2;67.2
40;2021-08-14;618;2032;322689;279032;78.3;67.7
40;2021-08-15;5;172;322694;279204;78.3;67.8
40;2021-08-16;1108;3383;323802;282587;78.6;68.6
40;2021-08-17;1159;3418;324961;286005;78.9;69.4
40;2021-08-18;989;3258;325950;289263;79.1;70.2
40;2021-08-19;854;2972;326804;292235;79.3;70.9
40;2021-08-20;811;3033;327615;295268;79.5;71.7
40;2021-08-21;523;1901;328138;297169;79.6;72.1
40;2021-08-22;71;464;328209;297633;79.7;72.2
40;2021-08-23;730;2818;328939;300451;79.8;72.9
40;2021-08-24;696;2540;329635;302991;80.0;73.5
40;2021-08-25;677;2002;330312;304993;80.2;74.0
40;2021-08-26;493;1674;330805;306667;80.3;74.4
40;2021-08-27;638;2468;331443;309135;80.5;75.0
40;2021-08-28;327;1215;331770;310350;80.5;75.3
40;2021-08-29;1;9;331771;310359;80.5;75.3
40;2021-08-30;600;2160;332371;312519;80.7;75.9
40;2021-08-31;469;1466;332840;313985;80.8;76.2
40;2021-09-01;449;1548;333289;315533;80.9;76.6
40;2021-09-02;403;1501;333692;317034;81.0;77.0
40;2021-09-03;440;1631;334132;318665;81.1;77.3
40;2021-09-04;369;1187;334501;319852;81.2;77.6
40;2021-09-05;4;26;334505;319878;81.2;77.6
40;2021-09-06;244;880;334749;320758;81.3;77.9
40;2021-09-07;291;977;335040;321735;81.3;78.1
40;2021-09-08;415;1237;335455;322972;81.4;78.4
40;2021-09-09;261;1037;335716;324009;81.5;78.6
40;2021-09-10;358;1278;336074;325287;81.6;79.0
40;2021-09-11;248;887;336322;326174;81.6;79.2
40;2021-09-12;8;8;336330;326182;81.6;79.2
40;2021-09-13;370;950;336700;327132;81.7;79.4
40;2021-09-14;292;884;336992;328016;81.8;79.6
40;2021-09-15;444;895;337436;328911;81.9;79.8
40;2021-09-16;238;348;337674;329259;82.0;79.9
40;2021-09-17;365;788;338039;330047;82.1;80.1
40;2021-09-18;179;634;338218;330681;82.1;80.3
40;2021-09-19;0;9;338218;330690;82.1;80.3
40;2021-09-20;150;382;338368;331072;82.1;80.4
40;2021-09-21;149;286;338517;331358;82.2;80.4
40;2021-09-22;229;559;338746;331917;82.2;80.6
40;2021-09-23;164;297;338910;332214;82.3;80.6
40;2021-09-24;237;605;339147;332819;82.3;80.8
40;2021-09-25;134;427;339281;333246;82.4;80.9
40;2021-09-26;0;2;339281;333248;82.4;80.9
40;2021-09-27;86;224;339367;333472;82.4;80.9
40;2021-09-28;81;229;339448;333701;82.4;81.0
40;2021-09-29;203;583;339651;334284;82.4;81.1
41;2020-12-27;0;0;0;0;0.0;0.0
41;2020-12-28;0;0;0;0;0.0;0.0
41;2020-12-29;0;0;0;0;0.0;0.0
41;2020-12-30;0;0;0;0;0.0;0.0
41;2020-12-31;0;0;0;0;0.0;0.0
41;2021-01-01;0;0;0;0;0.0;0.0
41;2021-01-02;2;0;2;0;0.0;0.0
41;2021-01-03;0;0;2;0;0.0;0.0
41;2021-01-04;0;0;2;0;0.0;0.0
41;2021-01-05;35;0;37;0;0.0;0.0
41;2021-01-06;71;0;108;0;0.0;0.0
41;2021-01-07;21;0;129;0;0.0;0.0
41;2021-01-08;1;0;130;0;0.0;0.0
41;2021-01-09;0;0;130;0;0.0;0.0
41;2021-01-10;0;0;130;0;0.0;0.0
41;2021-01-11;133;0;263;0;0.1;0.0
41;2021-01-12;321;1;584;1;0.2;0.0
41;2021-01-13;271;0;855;1;0.3;0.0
41;2021-01-14;284;1;1139;2;0.3;0.0
41;2021-01-15;215;1;1354;3;0.4;0.0
41;2021-01-16;0;0;1354;3;0.4;0.0
41;2021-01-17;0;0;1354;3;0.4;0.0
41;2021-01-18;397;2;1751;5;0.5;0.0
41;2021-01-19;857;2;2608;7;0.8;0.0
41;2021-01-20;1060;3;3668;10;1.1;0.0
41;2021-01-21;1568;2;5236;12;1.6;0.0
41;2021-01-22;839;1;6075;13;1.9;0.0
41;2021-01-23;92;0;6167;13;1.9;0.0
41;2021-01-24;0;0;6167;13;1.9;0.0
41;2021-01-25;421;1;6588;14;2.0;0.0
41;2021-01-26;473;3;7061;17;2.2;0.0
41;2021-01-27;441;2;7502;19;2.3;0.0
41;2021-01-28;604;56;8106;75;2.5;0.0
41;2021-01-29;260;13;8366;88;2.6;0.0
41;2021-01-30;0;0;8366;88;2.6;0.0
41;2021-01-31;0;0;8366;88;2.6;0.0
41;2021-02-01;349;121;8715;209;2.7;0.1
41;2021-02-02;471;216;9186;425;2.8;0.1
41;2021-02-03;341;200;9527;625;2.9;0.2
41;2021-02-04;559;136;10086;761;3.1;0.2
41;2021-02-05;329;167;10415;928;3.2;0.3
41;2021-02-06;5;0;10420;928;3.2;0.3
41;2021-02-07;2;0;10422;928;3.2;0.3
41;2021-02-08;305;273;10727;1201;3.3;0.4
41;2021-02-09;599;410;11326;1611;3.5;0.5
41;2021-02-10;486;671;11812;2282;3.6;0.7
41;2021-02-11;1066;1152;12878;3434;3.9;1.0
41;2021-02-12;687;355;13565;3789;4.1;1.2
41;2021-02-13;9;5;13574;3794;4.1;1.2
41;2021-02-14;3;27;13577;3821;4.1;1.2
41;2021-02-15;314;259;13891;4080;4.2;1.2
41;2021-02-16;354;468;14245;4548;4.3;1.4
41;2021-02-17;317;400;14562;4948;4.4;1.5
41;2021-02-18;616;267;15178;5215;4.6;1.6
41;2021-02-19;456;279;15634;5494;4.8;1.7
41;2021-02-20;68;37;15702;5531;4.8;1.7
41;2021-02-21;0;0;15702;5531;4.8;1.7
41;2021-02-22;311;332;16013;5863;4.9;1.8
41;2021-02-23;454;270;16467;6133;5.0;1.9
41;2021-02-24;282;365;16749;6498;5.1;2.0
41;2021-02-25;675;383;17424;6881;5.3;2.1
41;2021-02-26;630;220;18054;7101;5.5;2.2
41;2021-02-27;161;4;18215;7105;5.6;2.2
41;2021-02-28;4;31;18219;7136;5.6;2.2
41;2021-03-01;311;260;18530;7396;5.7;2.3
41;2021-03-02;649;337;19179;7733;5.9;2.4
41;2021-03-03;497;366;19676;8099;6.0;2.5
41;2021-03-04;786;749;20462;8848;6.2;2.7
41;2021-03-05;840;638;21302;9486;6.5;2.9
41;2021-03-06;715;22;22017;9508;6.7;2.9
41;2021-03-07;498;18;22515;9526;6.9;2.9
41;2021-03-08;301;334;22816;9860;7.0;3.0
41;2021-03-09;1042;402;23858;10262;7.3;3.1
41;2021-03-10;721;440;24579;10702;7.5;3.3
41;2021-03-11;1182;636;25761;11338;7.9;3.5
41;2021-03-12;1115;398;26876;11736;8.2;3.6
41;2021-03-13;1224;19;28100;11755;8.6;3.6
41;2021-03-14;392;7;28492;11762;8.7;3.6
41;2021-03-15;798;340;29290;12102;8.9;3.7
41;2021-03-16;1061;402;30351;12504;9.3;3.8
41;2021-03-17;587;236;30938;12740;9.4;3.9
41;2021-03-18;926;395;31864;13135;9.7;4.0
41;2021-03-19;911;328;32775;13463;10.0;4.1
41;2021-03-20;541;16;33316;13479;10.2;4.1
41;2021-03-21;1;0;33317;13479;10.2;4.1
41;2021-03-22;810;271;34127;13750;10.4;4.2
41;2021-03-23;1309;481;35436;14231;10.8;4.3
41;2021-03-24;1231;363;36667;14594;11.2;4.5
41;2021-03-25;2026;436;38693;15030;11.8;4.6
41;2021-03-26;1655;325;40348;15355;12.3;4.7
41;2021-03-27;451;58;40799;15413;12.4;4.7
41;2021-03-28;1;0;40800;15413;12.4;4.7
41;2021-03-29;939;306;41739;15719;12.7;4.8
41;2021-03-30;1496;592;43235;16311;13.2;5.0
41;2021-03-31;1148;490;44383;16801;13.5;5.1
41;2021-04-01;2252;565;46635;17366;14.2;5.3
41;2021-04-02;1241;473;47876;17839;14.6;5.4
41;2021-04-03;321;5;48197;17844;14.7;5.4
41;2021-04-04;39;0;48236;17844;14.7;5.4
41;2021-04-05;140;2;48376;17846;14.8;5.4
41;2021-04-06;1302;623;49678;18469;15.2;5.6
41;2021-04-07;1852;703;51530;19172;15.7;5.8
41;2021-04-08;2294;915;53824;20087;16.4;6.1
41;2021-04-09;2568;612;56392;20699;17.2;6.3
41;2021-04-10;954;496;57346;21195;17.5;6.5
41;2021-04-11;279;376;57625;21571;17.6;6.6
41;2021-04-12;1689;656;59314;22227;18.1;6.8
41;2021-04-13;2260;987;61574;23214;18.8;7.1
41;2021-04-14;1794;546;63368;23760;19.3;7.2
41;2021-04-15;2384;975;65752;24735;20.1;7.5
41;2021-04-16;1929;625;67681;25360;20.6;7.7
41;2021-04-17;647;137;68328;25497;20.8;7.8
41;2021-04-18;5;0;68333;25497;20.8;7.8
41;2021-04-19;1260;744;69593;26241;21.2;8.0
41;2021-04-20;2004;1197;71597;27438;21.8;8.4
41;2021-04-21;1503;919;73100;28357;22.3;8.6
41;2021-04-22;2236;1599;75336;29956;23.0;9.1
41;2021-04-23;1736;1078;77072;31034;23.5;9.5
41;2021-04-24;1544;283;78616;31317;24.0;9.6
41;2021-04-25;1007;21;79623;31338;24.3;9.6
41;2021-04-26;1355;625;80978;31963;24.7;9.7
41;2021-04-27;2092;1033;83070;32996;25.3;10.1
41;2021-04-28;1562;858;84632;33854;25.8;10.3
41;2021-04-29;2210;1376;86842;35230;26.5;10.7
41;2021-04-30;1963;863;88805;36093;27.1;11.0
41;2021-05-01;189;12;88994;36105;27.1;11.0
41;2021-05-02;107;17;89101;36122;27.2;11.0
41;2021-05-03;1864;892;90965;37014;27.7;11.3
41;2021-05-04;2091;1543;93056;38557;28.4;11.8
41;2021-05-05;1882;1188;94938;39745;29.0;12.1
41;2021-05-06;2448;1692;97386;41437;29.7;12.6
41;2021-05-07;2015;1801;99401;43238;30.3;13.2
41;2021-05-08;202;154;99603;43392;30.4;13.2
41;2021-05-09;11;354;99614;43746;30.4;13.3
41;2021-05-10;1590;1556;101204;45302;30.9;13.8
41;2021-05-11;2085;2100;103289;47402;31.5;14.5
41;2021-05-12;1951;1678;105240;49080;32.1;15.0
41;2021-05-13;1485;948;106725;50028;32.6;15.3
41;2021-05-14;1576;1305;108301;51333;33.0;15.7
41;2021-05-15;206;294;108507;51627;33.1;15.7
41;2021-05-16;4;0;108511;51627;33.1;15.7
41;2021-05-17;2483;564;110994;52191;33.9;15.9
41;2021-05-18;3138;1029;114132;53220;34.8;16.2
41;2021-05-19;2553;673;116685;53893;35.6;16.4
41;2021-05-20;3349;1148;120034;55041;36.6;16.8
41;2021-05-21;2727;967;122761;56008;37.4;17.1
41;2021-05-22;396;237;123157;56245;37.6;17.2
41;2021-05-23;6;2;123163;56247;37.6;17.2
41;2021-05-24;2605;150;125768;56397;38.4;17.2
41;2021-05-25;2991;577;128759;56974;39.3;17.4
41;2021-05-26;3036;650;131795;57624;40.2;17.6
41;2021-05-27;3294;1109;135089;58733;41.2;17.9
41;2021-05-28;3144;971;138233;59704;42.2;18.2
41;2021-05-29;2073;429;140306;60133;42.8;18.3
41;2021-05-30;344;22;140650;60155;42.9;18.3
41;2021-05-31;1710;1499;142360;61654;43.4;18.8
41;2021-06-01;2263;2010;144623;63664;44.1;19.4
41;2021-06-02;1832;1288;146455;64952;44.7;19.8
41;2021-06-03;2597;1940;149052;66892;45.5;20.4
41;2021-06-04;2303;1958;151355;68850;46.2;21.0
41;2021-06-05;611;1583;151966;70433;46.4;21.5
41;2021-06-06;109;927;152075;71360;46.4;21.8
41;2021-06-07;1515;1530;153590;72890;46.8;22.2
41;2021-06-08;1712;2409;155302;75299;47.4;23.0
41;2021-06-09;1615;1635;156917;76934;47.9;23.5
41;2021-06-10;1917;1813;158834;78747;48.4;24.0
41;2021-06-11;1572;1790;160406;80537;48.9;24.6
41;2021-06-12;664;648;161070;81185;49.1;24.8
41;2021-06-13;13;77;161083;81262;49.1;24.8
41;2021-06-14;1269;1962;162352;83224;49.5;25.4
41;2021-06-15;1835;2757;164187;85981;50.1;26.2
41;2021-06-16;1724;2308;165911;88289;50.6;26.9
41;2021-06-17;1810;2573;167721;90862;51.2;27.7
41;2021-06-18;1662;2399;169383;93261;51.7;28.4
41;2021-06-19;412;529;169795;93790;51.8;28.6
41;2021-06-20;11;32;169806;93822;51.8;28.6
41;2021-06-21;1325;1779;171131;95601;52.2;29.2
41;2021-06-22;1619;2561;172750;98162;52.7;29.9
41;2021-06-23;1375;2038;174125;100200;53.1;30.6
41;2021-06-24;1483;2307;175608;102507;53.6;31.3
41;2021-06-25;1294;2617;176902;105124;54.0;32.1
41;2021-06-26;433;614;177335;105738;54.1;32.3
41;2021-06-27;1;4;177336;105742;54.1;32.3
41;2021-06-28;404;2696;177740;108438;54.2;33.1
41;2021-06-29;664;3442;178404;111880;54.4;34.1
41;2021-06-30;552;3067;178956;114947;54.6;35.1
41;2021-07-01;767;3098;179723;118045;54.8;36.0
41;2021-07-02;589;3500;180312;121545;55.0;37.1
41;2021-07-03;158;646;180470;122191;55.0;37.3
41;2021-07-04;2;2;180472;122193;55.0;37.3
41;2021-07-05;285;2818;180757;125011;55.1;38.1
41;2021-07-06;666;3633;181423;128644;55.3;39.2
41;2021-07-07;479;3137;181902;131781;55.5;40.2
41;2021-07-08;940;3365;182842;135146;55.8;41.2
41;2021-07-09;540;3641;183382;138787;55.9;42.3
41;2021-07-10;247;2087;183629;140874;56.0;43.0
41;2021-07-11;5;280;183634;141154;56.0;43.1
41;2021-07-12;861;2291;184495;143445;56.3;43.8
41;2021-07-13;1198;3282;185693;146727;56.6;44.8
41;2021-07-14;141;1080;185834;147807;56.7;45.1
41;2021-07-15;1334;3319;187168;151126;57.1;46.1
41;2021-07-16;1091;3389;188259;154515;57.4;47.1
41;2021-07-17;344;807;188603;155322;57.5;47.4
41;2021-07-18;24;32;188627;155354;57.5;47.4
41;2021-07-19;1190;2319;189817;157673;57.9;48.1
41;2021-07-20;1643;2744;191460;160417;58.4;48.9
41;2021-07-21;1709;2083;193169;162500;58.9;49.6
41;2021-07-22;2263;2290;195432;164790;59.6;50.3
41;2021-07-23;2104;2468;197536;167258;60.3;51.0
41;2021-07-24;329;841;197865;168099;60.4;51.3
41;2021-07-25;19;23;197884;168122;60.4;51.3
41;2021-07-26;1902;1677;199786;169799;60.9;51.8
41;2021-07-27;2534;2341;202320;172140;61.7;52.5
41;2021-07-28;2161;1828;204481;173968;62.4;53.1
41;2021-07-29;2345;2026;206826;175994;63.1;53.7
41;2021-07-30;2151;2085;208977;178079;63.7;54.3
41;2021-07-31;380;581;209357;178660;63.9;54.5
41;2021-08-01;21;7;209378;178667;63.9;54.5
41;2021-08-02;1550;1605;210928;180272;64.3;55.0
41;2021-08-03;2517;1857;213445;182129;65.1;55.6
41;2021-08-04;2302;1199;215747;183328;65.8;55.9
41;2021-08-05;3046;1263;218793;184591;66.7;56.3
41;2021-08-06;2214;1302;221007;185893;67.4;56.7
41;2021-08-07;511;347;221518;186240;67.6;56.8
41;2021-08-08;13;20;221531;186260;67.6;56.8
41;2021-08-09;1689;1357;223220;187617;68.1;57.2
41;2021-08-10;2563;1421;225783;189038;68.9;57.7
41;2021-08-11;1593;1440;227376;190478;69.4;58.1
41;2021-08-12;1942;1339;229318;191817;69.9;58.5
41;2021-08-13;1475;1697;230793;193514;70.4;59.0
41;2021-08-14;364;205;231157;193719;70.5;59.1
41;2021-08-15;0;16;231157;193735;70.5;59.1
41;2021-08-16;864;2069;232021;195804;70.8;59.7
41;2021-08-17;1498;1634;233519;197438;71.2;60.2
41;2021-08-18;1135;1971;234654;199409;71.6;60.8
41;2021-08-19;1311;1554;235965;200963;72.0;61.3
41;2021-08-20;915;2313;236880;203276;72.3;62.0
41;2021-08-21;120;227;237000;203503;72.3;62.1
41;2021-08-22;1;32;237001;203535;72.3;62.1
41;2021-08-23;694;2295;237695;205830;72.5;62.8
41;2021-08-24;1415;2313;239110;208143;72.9;63.5
41;2021-08-25;620;2200;239730;210343;73.1;64.2
41;2021-08-26;843;2821;240573;213164;73.4;65.0
41;2021-08-27;620;2763;241193;215927;73.6;65.9
41;2021-08-28;99;622;241292;216549;73.6;66.1
41;2021-08-29;46;24;241338;216573;73.6;66.1
41;2021-08-30;668;2118;242006;218691;73.8;66.7
41;2021-08-31;765;2597;242771;221288;74.1;67.5
41;2021-09-01;500;1831;243271;223119;74.2;68.1
41;2021-09-02;627;2155;243898;225274;74.4;68.7
41;2021-09-03;650;2228;244548;227502;74.6;69.4
41;2021-09-04;194;593;244742;228095;74.7;69.6
41;2021-09-05;3;1;244745;228096;74.7;69.6
41;2021-09-06;291;1094;245036;229190;74.7;69.9
41;2021-09-07;415;1355;245451;230545;74.9;70.3
41;2021-09-08;314;1276;245765;231821;75.0;70.7
41;2021-09-09;295;1296;246060;233117;75.1;71.1
41;2021-09-10;380;1373;246440;234490;75.2;71.5
41;2021-09-11;83;392;246523;234882;75.2;71.6
41;2021-09-12;0;9;246523;234891;75.2;71.6
41;2021-09-13;201;912;246724;235803;75.3;71.9
41;2021-09-14;364;1056;247088;236859;75.4;72.2
41;2021-09-15;279;1070;247367;237929;75.5;72.6
41;2021-09-16;236;833;247603;238762;75.5;72.8
41;2021-09-17;360;713;247963;239475;75.6;73.0
41;2021-09-18;78;169;248041;239644;75.7;73.1
41;2021-09-19;0;7;248041;239651;75.7;73.1
41;2021-09-20;176;513;248217;240164;75.7;73.3
41;2021-09-21;181;515;248398;240679;75.8;73.4
41;2021-09-22;268;801;248666;241480;75.9;73.7
41;2021-09-23;237;662;248903;242142;75.9;73.9
41;2021-09-24;313;630;249216;242772;76.0;74.1
41;2021-09-25;70;233;249286;243005;76.0;74.1
41;2021-09-26;0;3;249286;243008;76.0;74.1
41;2021-09-27;165;342;249451;243350;76.1;74.2
41;2021-09-28;156;420;249607;243770;76.1;74.4
41;2021-09-29;178;489;249785;244259;76.2;74.5
42;2020-12-27;1;0;1;0;0.0;0.0
42;2020-12-28;0;0;1;0;0.0;0.0
42;2020-12-29;0;0;1;0;0.0;0.0
42;2020-12-30;0;0;1;0;0.0;0.0
42;2020-12-31;0;0;1;0;0.0;0.0
42;2021-01-01;0;0;1;0;0.0;0.0
42;2021-01-02;0;0;1;0;0.0;0.0
42;2021-01-03;0;0;1;0;0.0;0.0
42;2021-01-04;1;0;2;0;0.0;0.0
42;2021-01-05;1;0;3;0;0.0;0.0
42;2021-01-06;178;1;181;1;0.0;0.0
42;2021-01-07;256;0;437;1;0.1;0.0
42;2021-01-08;264;1;701;2;0.1;0.0
42;2021-01-09;136;0;837;2;0.1;0.0
42;2021-01-10;0;0;837;2;0.1;0.0
42;2021-01-11;293;2;1130;4;0.1;0.0
42;2021-01-12;412;1;1542;5;0.2;0.0
42;2021-01-13;526;2;2068;7;0.3;0.0
42;2021-01-14;775;2;2843;9;0.4;0.0
42;2021-01-15;707;4;3550;13;0.5;0.0
42;2021-01-16;298;2;3848;15;0.5;0.0
42;2021-01-17;219;0;4067;15;0.5;0.0
42;2021-01-18;967;1;5034;16;0.7;0.0
42;2021-01-19;1329;8;6363;24;0.8;0.0
42;2021-01-20;956;3;7319;27;1.0;0.0
42;2021-01-21;1023;6;8342;33;1.1;0.0
42;2021-01-22;991;6;9333;39;1.2;0.0
42;2021-01-23;401;0;9734;39;1.3;0.0
42;2021-01-24;358;0;10092;39;1.3;0.0
42;2021-01-25;1099;12;11191;51;1.5;0.0
42;2021-01-26;1750;18;12941;69;1.7;0.0
42;2021-01-27;1456;118;14397;187;1.9;0.0
42;2021-01-28;1667;133;16064;320;2.1;0.0
42;2021-01-29;946;109;17010;429;2.2;0.1
42;2021-01-30;257;96;17267;525;2.3;0.1
42;2021-01-31;258;2;17525;527;2.3;0.1
42;2021-02-01;738;58;18263;585;2.4;0.1
42;2021-02-02;1851;265;20114;850;2.6;0.1
42;2021-02-03;1516;456;21630;1306;2.8;0.2
42;2021-02-04;1279;556;22909;1862;3.0;0.2
42;2021-02-05;684;482;23593;2344;3.1;0.3
42;2021-02-06;303;128;23896;2472;3.1;0.3
42;2021-02-07;276;134;24172;2606;3.2;0.3
42;2021-02-08;508;492;24680;3098;3.2;0.4
42;2021-02-09;703;629;25383;3727;3.3;0.5
42;2021-02-10;742;553;26125;4280;3.4;0.6
42;2021-02-11;772;553;26897;4833;3.5;0.6
42;2021-02-12;675;602;27572;5435;3.6;0.7
42;2021-02-13;428;242;28000;5677;3.7;0.7
42;2021-02-14;186;172;28186;5849;3.7;0.8
42;2021-02-15;520;623;28706;6472;3.8;0.8
42;2021-02-16;490;996;29196;7468;3.8;1.0
42;2021-02-17;518;1334;29714;8802;3.9;1.2
42;2021-02-18;756;1164;30470;9966;4.0;1.3
42;2021-02-19;768;847;31238;10813;4.1;1.4
42;2021-02-20;248;332;31486;11145;4.1;1.5
42;2021-02-21;63;254;31549;11399;4.1;1.5
42;2021-02-22;574;804;32123;12203;4.2;1.6
42;2021-02-23;1211;1302;33334;13505;4.4;1.8
42;2021-02-24;1244;1037;34578;14542;4.5;1.9
42;2021-02-25;1667;1306;36245;15848;4.7;2.1
42;2021-02-26;1646;824;37891;16672;5.0;2.2
42;2021-02-27;580;243;38471;16915;5.0;2.2
42;2021-02-28;167;98;38638;17013;5.1;2.2
42;2021-03-01;807;753;39445;17766;5.2;2.3
42;2021-03-02;1275;724;40720;18490;5.3;2.4
42;2021-03-03;1368;715;42088;19205;5.5;2.5
42;2021-03-04;1705;648;43793;19853;5.7;2.6
42;2021-03-05;2623;619;46416;20472;6.1;2.7
42;2021-03-06;1933;245;48349;20717;6.3;2.7
42;2021-03-07;1491;94;49840;20811;6.5;2.7
42;2021-03-08;1405;487;51245;21298;6.7;2.8
42;2021-03-09;1983;433;53228;21731;7.0;2.8
42;2021-03-10;2053;491;55281;22222;7.2;2.9
42;2021-03-11;3047;605;58328;22827;7.6;3.0
42;2021-03-12;3008;810;61336;23637;8.0;3.1
42;2021-03-13;1479;352;62815;23989;8.2;3.1
42;2021-03-14;472;161;63287;24150;8.3;3.2
42;2021-03-15;1572;589;64859;24739;8.5;3.2
42;2021-03-16;1472;754;66331;25493;8.7;3.3
42;2021-03-17;1723;1069;68054;26562;8.9;3.5
42;2021-03-18;1804;1024;69858;27586;9.1;3.6
42;2021-03-19;2565;676;72423;28262;9.5;3.7
42;2021-03-20;1672;233;74095;28495;9.7;3.7
42;2021-03-21;526;99;74621;28594;9.8;3.7
42;2021-03-22;1426;730;76047;29324;9.9;3.8
42;2021-03-23;2507;856;78554;30180;10.3;3.9
42;2021-03-24;2783;785;81337;30965;10.6;4.0
42;2021-03-25;3719;933;85056;31898;11.1;4.2
42;2021-03-26;3759;782;88815;32680;11.6;4.3
42;2021-03-27;1806;452;90621;33132;11.8;4.3
42;2021-03-28;1039;215;91660;33347;12.0;4.4
42;2021-03-29;2063;922;93723;34269;12.3;4.5
42;2021-03-30;3146;865;96869;35134;12.7;4.6
42;2021-03-31;2444;1072;99313;36206;13.0;4.7
42;2021-04-01;3391;1054;102704;37260;13.4;4.9
42;2021-04-02;2849;1230;105553;38490;13.8;5.0
42;2021-04-03;1418;609;106971;39099;14.0;5.1
42;2021-04-04;1403;393;108374;39492;14.2;5.2
42;2021-04-05;1901;297;110275;39789;14.4;5.2
42;2021-04-06;2292;1408;112567;41197;14.7;5.4
42;2021-04-07;2761;1832;115328;43029;15.1;5.6
42;2021-04-08;4025;1588;119353;44617;15.6;5.8
42;2021-04-09;5134;1562;124487;46179;16.3;6.0
42;2021-04-10;2591;767;127078;46946;16.6;6.1
42;2021-04-11;1957;432;129035;47378;16.9;6.2
42;2021-04-12;3699;1549;132734;48927;17.4;6.4
42;2021-04-13;4659;1808;137393;50735;18.0;6.6
42;2021-04-14;4309;1902;141702;52637;18.5;6.9
42;2021-04-15;4808;1838;146510;54475;19.2;7.1
42;2021-04-16;4620;1890;151130;56365;19.8;7.4
42;2021-04-17;2982;1071;154112;57436;20.2;7.5
42;2021-04-18;1887;413;155999;57849;20.4;7.6
42;2021-04-19;3090;1536;159089;59385;20.8;7.8
42;2021-04-20;3467;1956;162556;61341;21.3;8.0
42;2021-04-21;3479;1749;166035;63090;21.7;8.2
42;2021-04-22;3768;1953;169803;65043;22.2;8.5
42;2021-04-23;3842;2017;173645;67060;22.7;8.8
42;2021-04-24;2363;1518;176008;68578;23.0;9.0
42;2021-04-25;1658;944;177666;69522;23.2;9.1
42;2021-04-26;3280;1734;180946;71256;23.7;9.3
42;2021-04-27;3253;2208;184199;73464;24.1;9.6
42;2021-04-28;3463;2619;187662;76083;24.5;9.9
42;2021-04-29;3767;2801;191429;78884;25.0;10.3
42;2021-04-30;3359;3023;194788;81907;25.5;10.7
42;2021-05-01;2968;1053;197756;82960;25.9;10.8
42;2021-05-02;1934;1261;199690;84221;26.1;11.0
42;2021-05-03;2868;2768;202558;86989;26.5;11.4
42;2021-05-04;3416;3126;205974;90115;26.9;11.8
42;2021-05-05;3328;3398;209302;93513;27.4;12.2
42;2021-05-06;3888;3771;213190;97284;27.9;12.7
42;2021-05-07;3732;4039;216922;101323;28.4;13.2
42;2021-05-08;3164;1070;220086;102393;28.8;13.4
42;2021-05-09;1505;2213;221591;104606;29.0;13.7
42;2021-05-10;3250;3828;224841;108434;29.4;14.2
42;2021-05-11;5574;3899;230415;112333;30.1;14.7
42;2021-05-12;5339;3567;235754;115900;30.8;15.2
42;2021-05-13;5451;1150;241205;117050;31.5;15.3
42;2021-05-14;5237;2927;246442;119977;32.2;15.7
42;2021-05-15;4880;2127;251322;122104;32.9;16.0
42;2021-05-16;2873;1036;254195;123140;33.2;16.1
42;2021-05-17;5885;2840;260080;125980;34.0;16.5
42;2021-05-18;6251;2977;266331;128957;34.8;16.9
42;2021-05-19;6523;2750;272854;131707;35.7;17.2
42;2021-05-20;7103;2893;279957;134600;36.6;17.6
42;2021-05-21;6351;3275;286308;137875;37.4;18.0
42;2021-05-22;5834;2134;292142;140009;38.2;18.3
42;2021-05-23;2832;874;294974;140883;38.6;18.4
42;2021-05-24;5246;1432;300220;142315;39.3;18.6
42;2021-05-25;5152;3940;305372;146255;39.9;19.1
42;2021-05-26;5160;3459;310532;149714;40.6;19.6
42;2021-05-27;5366;3630;315898;153344;41.3;20.1
42;2021-05-28;5043;4189;320941;157533;42.0;20.6
42;2021-05-29;4340;2984;325281;160517;42.5;21.0
42;2021-05-30;1981;1205;327262;161722;42.8;21.1
42;2021-05-31;4241;3419;331503;165141;43.3;21.6
42;2021-06-01;4592;3562;336095;168703;43.9;22.1
42;2021-06-02;4481;3006;340576;171709;44.5;22.5
42;2021-06-03;4930;3839;345506;175548;45.2;23.0
42;2021-06-04;4766;4213;350272;179761;45.8;23.5
42;2021-06-05;3689;2424;353961;182185;46.3;23.8
42;2021-06-06;1445;1293;355406;183478;46.5;24.0
42;2021-06-07;3992;3377;359398;186855;47.0;24.4
42;2021-06-08;3466;3242;362864;190097;47.4;24.9
42;2021-06-09;2964;3206;365828;193303;47.8;25.3
42;2021-06-10;3242;2931;369070;196234;48.3;25.7
42;2021-06-11;3585;4113;372655;200347;48.7;26.2
42;2021-06-12;2863;2881;375518;203228;49.1;26.6
42;2021-06-13;944;1278;376462;204506;49.2;26.7
42;2021-06-14;2313;4061;378775;208567;49.5;27.3
42;2021-06-15;2830;4071;381605;212638;49.9;27.8
42;2021-06-16;2920;3551;384525;216189;50.3;28.3
42;2021-06-17;2635;3734;387160;219923;50.6;28.8
42;2021-06-18;3093;5143;390253;225066;51.0;29.4
42;2021-06-19;2845;4243;393098;229309;51.4;30.0
42;2021-06-20;857;1844;393955;231153;51.5;30.2
42;2021-06-21;1908;6277;395863;237430;51.8;31.0
42;2021-06-22;1875;5891;397738;243321;52.0;31.8
42;2021-06-23;1845;5321;399583;248642;52.3;32.5
42;2021-06-24;1785;4682;401368;253324;52.5;33.1
42;2021-06-25;2037;6951;403405;260275;52.8;34.0
42;2021-06-26;1408;5818;404813;266093;52.9;34.8
42;2021-06-27;756;2858;405569;268951;53.0;35.2
42;2021-06-28;1746;7063;407315;276014;53.3;36.1
42;2021-06-29;1526;6566;408841;282580;53.5;37.0
42;2021-06-30;1969;5765;410810;288345;53.7;37.7
42;2021-07-01;1779;5119;412589;293464;54.0;38.4
42;2021-07-02;2046;6739;414635;300203;54.2;39.3
42;2021-07-03;1760;5977;416395;306180;54.4;40.0
42;2021-07-04;853;2513;417248;308693;54.6;40.4
42;2021-07-05;1716;6286;418964;314979;54.8;41.2
42;2021-07-06;2106;5576;421070;320555;55.1;41.9
42;2021-07-07;2338;4657;423408;325212;55.4;42.5
42;2021-07-08;2272;3956;425680;329168;55.7;43.0
42;2021-07-09;2416;6096;428096;335264;56.0;43.8
42;2021-07-10;1693;5581;429789;340845;56.2;44.6
42;2021-07-11;921;2304;430710;343149;56.3;44.9
42;2021-07-12;1776;6287;432486;349436;56.6;45.7
42;2021-07-13;3610;6290;436096;355726;57.0;46.5
42;2021-07-14;4479;2052;440575;357778;57.6;46.8
42;2021-07-15;4558;5626;445133;363404;58.2;47.5
42;2021-07-16;4442;6197;449575;369601;58.8;48.3
42;2021-07-17;3219;4707;452794;374308;59.2;48.9
42;2021-07-18;1838;1743;454632;376051;59.4;49.2
42;2021-07-19;3806;5073;458438;381124;59.9;49.8
42;2021-07-20;4719;4821;463157;385945;60.6;50.5
42;2021-07-21;5176;4718;468333;390663;61.2;51.1
42;2021-07-22;5501;3935;473834;394598;62.0;51.6
42;2021-07-23;5499;5119;479333;399717;62.7;52.3
42;2021-07-24;4037;3833;483370;403550;63.2;52.8
42;2021-07-25;1656;1389;485026;404939;63.4;53.0
42;2021-07-26;4731;4312;489757;409251;64.0;53.5
42;2021-07-27;5333;3955;495090;413206;64.7;54.0
42;2021-07-28;5782;3676;500872;416882;65.5;54.5
42;2021-07-29;5678;3432;506550;420314;66.2;55.0
42;2021-07-30;5140;3775;511690;424089;66.9;55.5
42;2021-07-31;4764;3057;516454;427146;67.5;55.9
42;2021-08-01;2498;1316;518952;428462;67.9;56.0
42;2021-08-02;4366;3106;523318;431568;68.4;56.4
42;2021-08-03;3826;3284;527144;434852;68.9;56.9
42;2021-08-04;3473;3222;530617;438074;69.4;57.3
42;2021-08-05;3402;3313;534019;441387;69.8;57.7
42;2021-08-06;3639;3994;537658;445381;70.3;58.2
42;2021-08-07;3022;3067;540680;448448;70.7;58.6
42;2021-08-08;1200;1717;541880;450165;70.9;58.9
42;2021-08-09;2809;3859;544689;454024;71.2;59.4
42;2021-08-10;3275;3909;547964;457933;71.7;59.9
42;2021-08-11;2593;3520;550557;461453;72.0;60.3
42;2021-08-12;2517;3569;553074;465022;72.3;60.8
42;2021-08-13;2333;3907;555407;468929;72.6;61.3
42;2021-08-14;1652;3269;557059;472198;72.8;61.7
42;2021-08-15;600;1027;557659;473225;72.9;61.9
42;2021-08-16;2077;4571;559736;477796;73.2;62.5
42;2021-08-17;2245;4174;561981;481970;73.5;63.0
42;2021-08-18;2053;4145;564034;486115;73.8;63.6
42;2021-08-19;1932;3369;565966;489484;74.0;64.0
42;2021-08-20;2271;4611;568237;494095;74.3;64.6
42;2021-08-21;1083;3865;569320;497960;74.4;65.1
42;2021-08-22;501;2020;569821;499980;74.5;65.4
42;2021-08-23;1625;4666;571446;504646;74.7;66.0
42;2021-08-24;1748;4043;573194;508689;75.0;66.5
42;2021-08-25;1748;3898;574942;512587;75.2;67.0
42;2021-08-26;1445;3048;576387;515635;75.4;67.4
42;2021-08-27;1775;4563;578162;520198;75.6;68.0
42;2021-08-28;1311;3707;579473;523905;75.8;68.5
42;2021-08-29;377;1428;579850;525333;75.8;68.7
42;2021-08-30;1282;3434;581132;528767;76.0;69.1
42;2021-08-31;1238;2859;582370;531626;76.2;69.5
42;2021-09-01;1251;3017;583621;534643;76.3;69.9
42;2021-09-02;1320;2934;584941;537577;76.5;70.3
42;2021-09-03;1567;3303;586508;540880;76.7;70.7
42;2021-09-04;1044;2984;587552;543864;76.8;71.1
42;2021-09-05;381;874;587933;544738;76.9;71.2
42;2021-09-06;763;2167;588696;546905;77.0;71.5
42;2021-09-07;822;1933;589518;548838;77.1;71.8
42;2021-09-08;917;2229;590435;551067;77.2;72.1
42;2021-09-09;650;1779;591085;552846;77.3;72.3
42;2021-09-10;922;2278;592007;555124;77.4;72.6
42;2021-09-11;719;2399;592726;557523;77.5;72.9
42;2021-09-12;163;553;592889;558076;77.5;73.0
42;2021-09-13;545;1619;593434;559695;77.6;73.2
42;2021-09-14;776;1977;594210;561672;77.7;73.4
42;2021-09-15;702;1567;594912;563239;77.8;73.7
42;2021-09-16;525;823;595437;564062;77.9;73.8
42;2021-09-17;732;1636;596169;565698;78.0;74.0
42;2021-09-18;575;1799;596744;567497;78.0;74.2
42;2021-09-19;99;366;596843;567863;78.0;74.3
42;2021-09-20;395;849;597238;568712;78.1;74.4
42;2021-09-21;340;735;597578;569447;78.1;74.5
42;2021-09-22;473;1382;598051;570829;78.2;74.6
42;2021-09-23;370;907;598421;571736;78.3;74.8
42;2021-09-24;471;1561;598892;573297;78.3;75.0
42;2021-09-25;384;1274;599276;574571;78.4;75.1
42;2021-09-26;61;289;599337;574860;78.4;75.2
42;2021-09-27;332;790;599669;575650;78.4;75.3
42;2021-09-28;339;703;600008;576353;78.5;75.4
42;2021-09-29;400;951;600408;577304;78.5;75.5
43;2020-12-27;0;0;0;0;0.0;0.0
43;2020-12-28;0;0;0;0;0.0;0.0
43;2020-12-29;0;0;0;0;0.0;0.0
43;2020-12-30;0;0;0;0;0.0;0.0
43;2020-12-31;0;0;0;0;0.0;0.0
43;2021-01-01;0;0;0;0;0.0;0.0
43;2021-01-02;0;0;0;0;0.0;0.0
43;2021-01-03;0;0;0;0;0.0;0.0
43;2021-01-04;2;0;2;0;0.0;0.0
43;2021-01-05;0;0;2;0;0.0;0.0
43;2021-01-06;0;0;2;0;0.0;0.0
43;2021-01-07;167;0;169;0;0.1;0.0
43;2021-01-08;151;1;320;1;0.1;0.0
43;2021-01-09;0;0;320;1;0.1;0.0
43;2021-01-10;0;0;320;1;0.1;0.0
43;2021-01-11;137;0;457;1;0.2;0.0
43;2021-01-12;244;0;701;1;0.3;0.0
43;2021-01-13;244;2;945;3;0.4;0.0
43;2021-01-14;294;2;1239;5;0.5;0.0
43;2021-01-15;303;2;1542;7;0.7;0.0
43;2021-01-16;32;0;1574;7;0.7;0.0
43;2021-01-17;0;0;1574;7;0.7;0.0
43;2021-01-18;761;5;2335;12;1.0;0.0
43;2021-01-19;776;5;3111;17;1.4;0.0
43;2021-01-20;519;2;3630;19;1.6;0.0
43;2021-01-21;447;2;4077;21;1.8;0.0
43;2021-01-22;465;6;4542;27;2.0;0.0
43;2021-01-23;1;0;4543;27;2.0;0.0
43;2021-01-24;2;0;4545;27;2.0;0.0
43;2021-01-25;539;0;5084;27;2.2;0.0
43;2021-01-26;615;5;5699;32;2.5;0.0
43;2021-01-27;740;0;6439;32;2.8;0.0
43;2021-01-28;747;30;7186;62;3.2;0.0
43;2021-01-29;722;81;7908;143;3.5;0.1
43;2021-01-30;109;0;8017;143;3.5;0.1
43;2021-01-31;0;0;8017;143;3.5;0.1
43;2021-02-01;403;99;8420;242;3.7;0.1
43;2021-02-02;717;145;9137;387;4.0;0.2
43;2021-02-03;690;41;9827;428;4.3;0.2
43;2021-02-04;525;157;10352;585;4.6;0.3
43;2021-02-05;544;147;10896;732;4.8;0.3
43;2021-02-06;165;16;11061;748;4.9;0.3
43;2021-02-07;0;0;11061;748;4.9;0.3
43;2021-02-08;411;282;11472;1030;5.1;0.5
43;2021-02-09;368;414;11840;1444;5.2;0.6
43;2021-02-10;401;348;12241;1792;5.4;0.8
43;2021-02-11;388;312;12629;2104;5.6;0.9
43;2021-02-12;425;187;13054;2291;5.8;1.0
43;2021-02-13;570;41;13624;2332;6.0;1.0
43;2021-02-14;0;0;13624;2332;6.0;1.0
43;2021-02-15;69;385;13693;2717;6.0;1.2
43;2021-02-16;41;319;13734;3036;6.1;1.3
43;2021-02-17;87;426;13821;3462;6.1;1.5
43;2021-02-18;147;324;13968;3786;6.2;1.7
43;2021-02-19;278;459;14246;4245;6.3;1.9
43;2021-02-20;22;4;14268;4249;6.3;1.9
43;2021-02-21;0;0;14268;4249;6.3;1.9
43;2021-02-22;16;424;14284;4673;6.3;2.1
43;2021-02-23;202;709;14486;5382;6.4;2.4
43;2021-02-24;147;679;14633;6061;6.4;2.7
43;2021-02-25;228;618;14861;6679;6.5;2.9
43;2021-02-26;222;576;15083;7255;6.6;3.2
43;2021-02-27;139;60;15222;7315;6.7;3.2
43;2021-02-28;1;0;15223;7315;6.7;3.2
43;2021-03-01;210;438;15433;7753;6.8;3.4
43;2021-03-02;342;540;15775;8293;7.0;3.7
43;2021-03-03;338;548;16113;8841;7.1;3.9
43;2021-03-04;551;435;16664;9276;7.3;4.1
43;2021-03-05;566;426;17230;9702;7.6;4.3
43;2021-03-06;489;175;17719;9877;7.8;4.4
43;2021-03-07;12;0;17731;9877;7.8;4.4
43;2021-03-08;447;413;18178;10290;8.0;4.5
43;2021-03-09;621;350;18799;10640;8.3;4.7
43;2021-03-10;674;476;19473;11116;8.6;4.9
43;2021-03-11;953;428;20426;11544;9.0;5.1
43;2021-03-12;945;414;21371;11958;9.4;5.3
43;2021-03-13;792;108;22163;12066;9.8;5.3
43;2021-03-14;2;0;22165;12066;9.8;5.3
43;2021-03-15;706;143;22871;12209;10.1;5.4
43;2021-03-16;847;283;23718;12492;10.5;5.5
43;2021-03-17;638;138;24356;12630;10.7;5.6
43;2021-03-18;676;140;25032;12770;11.0;5.6
43;2021-03-19;839;91;25871;12861;11.4;5.7
43;2021-03-20;450;60;26321;12921;11.6;5.7
43;2021-03-21;0;0;26321;12921;11.6;5.7
43;2021-03-22;742;39;27063;12960;11.9;5.7
43;2021-03-23;872;49;27935;13009;12.3;5.7
43;2021-03-24;1174;95;29109;13104;12.8;5.8
43;2021-03-25;1594;158;30703;13262;13.5;5.8
43;2021-03-26;1609;192;32312;13454;14.2;5.9
43;2021-03-27;1449;79;33761;13533;14.9;6.0
43;2021-03-28;420;20;34181;13553;15.1;6.0
43;2021-03-29;1096;171;35277;13724;15.5;6.0
43;2021-03-30;1314;235;36591;13959;16.1;6.2
43;2021-03-31;1306;266;37897;14225;16.7;6.3
43;2021-04-01;1348;340;39245;14565;17.3;6.4
43;2021-04-02;1052;352;40297;14917;17.8;6.6
43;2021-04-03;340;198;40637;15115;17.9;6.7
43;2021-04-04;0;0;40637;15115;17.9;6.7
43;2021-04-05;3;0;40640;15115;17.9;6.7
43;2021-04-06;688;607;41328;15722;18.2;6.9
43;2021-04-07;868;575;42196;16297;18.6;7.2
43;2021-04-08;1086;463;43282;16760;19.1;7.4
43;2021-04-09;1147;663;44429;17423;19.6;7.7
43;2021-04-10;626;264;45055;17687;19.9;7.8
43;2021-04-11;0;0;45055;17687;19.9;7.8
43;2021-04-12;681;649;45736;18336;20.2;8.1
43;2021-04-13;917;726;46653;19062;20.6;8.4
43;2021-04-14;723;669;47376;19731;20.9;8.7
43;2021-04-15;959;701;48335;20432;21.3;9.0
43;2021-04-16;1008;694;49343;21126;21.7;9.3
43;2021-04-17;423;301;49766;21427;21.9;9.4
43;2021-04-18;3;5;49769;21432;21.9;9.4
43;2021-04-19;628;567;50397;21999;22.2;9.7
43;2021-04-20;839;675;51236;22674;22.6;10.0
43;2021-04-21;320;987;51556;23661;22.7;10.4
43;2021-04-22;680;1016;52236;24677;23.0;10.9
43;2021-04-23;401;1102;52637;25779;23.2;11.4
43;2021-04-24;347;1039;52984;26818;23.4;11.8
43;2021-04-25;23;403;53007;27221;23.4;12.0
43;2021-04-26;385;964;53392;28185;23.5;12.4
43;2021-04-27;825;984;54217;29169;23.9;12.9
43;2021-04-28;794;1108;55011;30277;24.2;13.3
43;2021-04-29;1236;1139;56247;31416;24.8;13.8
43;2021-04-30;1199;1067;57446;32483;25.3;14.3
43;2021-05-01;400;27;57846;32510;25.5;14.3
43;2021-05-02;1;0;57847;32510;25.5;14.3
43;2021-05-03;1218;408;59065;32918;26.0;14.5
43;2021-05-04;1237;956;60302;33874;26.6;14.9
43;2021-05-05;1143;848;61445;34722;27.1;15.3
43;2021-05-06;1405;938;62850;35660;27.7;15.7
43;2021-05-07;1089;1172;63939;36832;28.2;16.2
43;2021-05-08;521;136;64460;36968;28.4;16.3
43;2021-05-09;0;2;64460;36970;28.4;16.3
43;2021-05-10;1084;725;65544;37695;28.9;16.6
43;2021-05-11;1553;1010;67097;38705;29.6;17.1
43;2021-05-12;1482;808;68579;39513;30.2;17.4
43;2021-05-13;936;378;69515;39891;30.6;17.6
43;2021-05-14;2204;1110;71719;41001;31.6;18.1
43;2021-05-15;1271;315;72990;41316;32.2;18.2
43;2021-05-16;272;47;73262;41363;32.3;18.2
43;2021-05-17;1625;631;74887;41994;33.0;18.5
43;2021-05-18;1966;675;76853;42669;33.9;18.8
43;2021-05-19;2065;571;78918;43240;34.8;19.1
43;2021-05-20;2338;805;81256;44045;35.8;19.4
43;2021-05-21;2385;709;83641;44754;36.9;19.7
43;2021-05-22;1207;341;84848;45095;37.4;19.9
43;2021-05-23;1;0;84849;45095;37.4;19.9
43;2021-05-24;382;99;85231;45194;37.6;19.9
43;2021-05-25;1407;654;86638;45848;38.2;20.2
43;2021-05-26;1347;559;87985;46407;38.8;20.5
43;2021-05-27;1388;713;89373;47120;39.4;20.8
43;2021-05-28;1348;727;90721;47847;40.0;21.1
43;2021-05-29;1135;604;91856;48451;40.5;21.4
43;2021-05-30;149;17;92005;48468;40.5;21.4
43;2021-05-31;1207;442;93212;48910;41.1;21.6
43;2021-06-01;1280;985;94492;49895;41.6;22.0
43;2021-06-02;1086;700;95578;50595;42.1;22.3
43;2021-06-03;1192;856;96770;51451;42.6;22.7
43;2021-06-04;1351;858;98121;52309;43.2;23.1
43;2021-06-05;823;452;98944;52761;43.6;23.3
43;2021-06-06;10;5;98954;52766;43.6;23.3
43;2021-06-07;748;516;99702;53282;43.9;23.5
43;2021-06-08;664;706;100366;53988;44.2;23.8
43;2021-06-09;538;760;100904;54748;44.5;24.1
43;2021-06-10;807;1120;101711;55868;44.8;24.6
43;2021-06-11;761;1348;102472;57216;45.2;25.2
43;2021-06-12;914;514;103386;57730;45.6;25.4
43;2021-06-13;3;27;103389;57757;45.6;25.5
43;2021-06-14;446;1087;103835;58844;45.8;25.9
43;2021-06-15;629;1191;104464;60035;46.0;26.5
43;2021-06-16;549;974;105013;61009;46.3;26.9
43;2021-06-17;601;1500;105614;62509;46.5;27.5
43;2021-06-18;898;1464;106512;63973;46.9;28.2
43;2021-06-19;447;781;106959;64754;47.1;28.5
43;2021-06-20;0;12;106959;64766;47.1;28.5
43;2021-06-21;424;1306;107383;66072;47.3;29.1
43;2021-06-22;533;1958;107916;68030;47.6;30.0
43;2021-06-23;342;1743;108258;69773;47.7;30.8
43;2021-06-24;511;1492;108769;71265;47.9;31.4
43;2021-06-25;597;2345;109366;73610;48.2;32.4
43;2021-06-26;505;1245;109871;74855;48.4;33.0
43;2021-06-27;10;20;109881;74875;48.4;33.0
43;2021-06-28;341;1785;110222;76660;48.6;33.8
43;2021-06-29;525;2381;110747;79041;48.8;34.8
43;2021-06-30;460;2276;111207;81317;49.0;35.8
43;2021-07-01;473;1910;111680;83227;49.2;36.7
43;2021-07-02;500;1964;112180;85191;49.4;37.5
43;2021-07-03;258;1108;112438;86299;49.6;38.0
43;2021-07-04;1;0;112439;86299;49.6;38.0
43;2021-07-05;526;1202;112965;87501;49.8;38.6
43;2021-07-06;633;1680;113598;89181;50.1;39.3
43;2021-07-07;524;1423;114122;90604;50.3;39.9
43;2021-07-08;837;1417;114959;92021;50.7;40.6
43;2021-07-09;549;1500;115508;93521;50.9;41.2
43;2021-07-10;401;1337;115909;94858;51.1;41.8
43;2021-07-11;23;99;115932;94957;51.1;41.8
43;2021-07-12;604;1684;116536;96641;51.4;42.6
43;2021-07-13;1186;1849;117722;98490;51.9;43.4
43;2021-07-14;848;161;118570;98651;52.3;43.5
43;2021-07-15;1933;1840;120503;100491;53.1;44.3
43;2021-07-16;1752;1616;122255;102107;53.9;45.0
43;2021-07-17;1544;1202;123799;103309;54.6;45.5
43;2021-07-18;4;19;123803;103328;54.6;45.5
43;2021-07-19;1441;1257;125244;104585;55.2;46.1
43;2021-07-20;1895;1451;127139;106036;56.0;46.7
43;2021-07-21;1854;1112;128993;107148;56.8;47.2
43;2021-07-22;2110;1333;131103;108481;57.8;47.8
43;2021-07-23;1619;1325;132722;109806;58.5;48.4
43;2021-07-24;576;1000;133298;110806;58.7;48.8
43;2021-07-25;0;1;133298;110807;58.7;48.8
43;2021-07-26;1643;1071;134941;111878;59.5;49.3
43;2021-07-27;2284;1227;137225;113105;60.5;49.8
43;2021-07-28;1954;1093;139179;114198;61.3;50.3
43;2021-07-29;1986;1016;141165;115214;62.2;50.8
43;2021-07-30;1867;1336;143032;116550;63.0;51.4
43;2021-07-31;706;611;143738;117161;63.3;51.6
43;2021-08-01;13;21;143751;117182;63.4;51.6
43;2021-08-02;1535;968;145286;118150;64.0;52.1
43;2021-08-03;1405;1170;146691;119320;64.6;52.6
43;2021-08-04;1263;1108;147954;120428;65.2;53.1
43;2021-08-05;1254;1285;149208;121713;65.8;53.6
43;2021-08-06;1129;1465;150337;123178;66.3;54.3
43;2021-08-07;758;759;151095;123937;66.6;54.6
43;2021-08-08;5;0;151100;123937;66.6;54.6
43;2021-08-09;822;1636;151922;125573;67.0;55.3
43;2021-08-10;1023;1584;152945;127157;67.4;56.0
43;2021-08-11;680;1340;153625;128497;67.7;56.6
43;2021-08-12;875;1605;154500;130102;68.1;57.3
43;2021-08-13;681;1179;155181;131281;68.4;57.9
43;2021-08-14;364;556;155545;131837;68.6;58.1
43;2021-08-15;5;9;155550;131846;68.6;58.1
43;2021-08-16;685;1675;156235;133521;68.9;58.8
43;2021-08-17;711;1511;156946;135032;69.2;59.5
43;2021-08-18;558;1513;157504;136545;69.4;60.2
43;2021-08-19;641;1610;158145;138155;69.7;60.9
43;2021-08-20;518;1595;158663;139750;69.9;61.6
43;2021-08-21;239;555;158902;140305;70.0;61.8
43;2021-08-22;7;7;158909;140312;70.0;61.8
43;2021-08-23;500;1588;159409;141900;70.3;62.5
43;2021-08-24;517;1398;159926;143298;70.5;63.2
43;2021-08-25;521;1298;160447;144596;70.7;63.7
43;2021-08-26;475;1138;160922;145734;70.9;64.2
43;2021-08-27;529;1359;161451;147093;71.2;64.8
43;2021-08-28;176;499;161627;147592;71.2;65.0
43;2021-08-29;0;1;161627;147593;71.2;65.0
43;2021-08-30;483;1062;162110;148655;71.4;65.5
43;2021-08-31;382;890;162492;149545;71.6;65.9
43;2021-09-01;307;962;162799;150507;71.7;66.3
43;2021-09-02;308;969;163107;151476;71.9;66.8
43;2021-09-03;503;1017;163610;152493;72.1;67.2
43;2021-09-04;318;569;163928;153062;72.2;67.5
43;2021-09-05;39;24;163967;153086;72.3;67.5
43;2021-09-06;249;762;164216;153848;72.4;67.8
43;2021-09-07;237;715;164453;154563;72.5;68.1
43;2021-09-08;207;803;164660;155366;72.6;68.5
43;2021-09-09;268;810;164928;156176;72.7;68.8
43;2021-09-10;328;709;165256;156885;72.8;69.1
43;2021-09-11;265;456;165521;157341;72.9;69.3
43;2021-09-12;0;4;165521;157345;72.9;69.3
43;2021-09-13;147;517;165668;157862;73.0;69.6
43;2021-09-14;210;634;165878;158496;73.1;69.9
43;2021-09-15;221;497;166099;158993;73.2;70.1
43;2021-09-16;196;354;166295;159347;73.3;70.2
43;2021-09-17;234;530;166529;159877;73.4;70.5
43;2021-09-18;157;344;166686;160221;73.5;70.6
43;2021-09-19;2;4;166688;160225;73.5;70.6
43;2021-09-20;102;306;166790;160531;73.5;70.7
43;2021-09-21;149;321;166939;160852;73.6;70.9
43;2021-09-22;124;393;167063;161245;73.6;71.1
43;2021-09-23;71;292;167134;161537;73.7;71.2
43;2021-09-24;170;488;167304;162025;73.7;71.4
43;2021-09-25;102;295;167406;162320;73.8;71.5
43;2021-09-26;0;0;167406;162320;73.8;71.5
43;2021-09-27;149;340;167555;162660;73.8;71.7
43;2021-09-28;387;218;167942;162878;74.0;71.8
43;2021-09-29;143;301;168085;163179;74.1;71.9
44;2020-12-27;1;0;1;0;0.0;0.0
44;2020-12-28;3;0;4;0;0.0;0.0
44;2020-12-29;1;0;5;0;0.0;0.0
44;2020-12-30;2;0;7;0;0.0;0.0
44;2020-12-31;1;0;8;0;0.0;0.0
44;2021-01-01;2;0;10;0;0.0;0.0
44;2021-01-02;0;0;10;0;0.0;0.0
44;2021-01-03;4;0;14;0;0.0;0.0
44;2021-01-04;0;0;14;0;0.0;0.0
44;2021-01-05;2;0;16;0;0.0;0.0
44;2021-01-06;20;1;36;1;0.0;0.0
44;2021-01-07;187;0;223;1;0.0;0.0
44;2021-01-08;528;0;751;1;0.1;0.0
44;2021-01-09;473;0;1224;1;0.1;0.0
44;2021-01-10;456;1;1680;2;0.1;0.0
44;2021-01-11;800;1;2480;3;0.2;0.0
44;2021-01-12;910;1;3390;4;0.2;0.0
44;2021-01-13;1086;1;4476;5;0.3;0.0
44;2021-01-14;1116;6;5592;11;0.4;0.0
44;2021-01-15;987;1;6579;12;0.5;0.0
44;2021-01-16;336;2;6915;14;0.5;0.0
44;2021-01-17;328;1;7243;15;0.5;0.0
44;2021-01-18;856;3;8099;18;0.6;0.0
44;2021-01-19;2624;6;10723;24;0.7;0.0
44;2021-01-20;2744;4;13467;28;0.9;0.0
44;2021-01-21;4536;8;18003;36;1.3;0.0
44;2021-01-22;2415;7;20418;43;1.4;0.0
44;2021-01-23;767;1;21185;44;1.5;0.0
44;2021-01-24;120;0;21305;44;1.5;0.0
44;2021-01-25;839;0;22144;44;1.5;0.0
44;2021-01-26;2563;16;24707;60;1.7;0.0
44;2021-01-27;2103;55;26810;115;1.9;0.0
44;2021-01-28;3732;187;30542;302;2.1;0.0
44;2021-01-29;2370;440;32912;742;2.3;0.1
44;2021-01-30;628;190;33540;932;2.3;0.1
44;2021-01-31;14;176;33554;1108;2.3;0.1
44;2021-02-01;594;501;34148;1609;2.4;0.1
44;2021-02-02;878;696;35026;2305;2.4;0.2
44;2021-02-03;889;814;35915;3119;2.5;0.2
44;2021-02-04;938;661;36853;3780;2.6;0.3
44;2021-02-05;897;561;37750;4341;2.6;0.3
44;2021-02-06;471;230;38221;4571;2.7;0.3
44;2021-02-07;72;174;38293;4745;2.7;0.3
44;2021-02-08;522;385;38815;5130;2.7;0.4
44;2021-02-09;993;1108;39808;6238;2.8;0.4
44;2021-02-10;1143;1143;40951;7381;2.8;0.5
44;2021-02-11;2291;2941;43242;10322;3.0;0.7
44;2021-02-12;1662;1648;44904;11970;3.1;0.8
44;2021-02-13;433;407;45337;12377;3.2;0.9
44;2021-02-14;10;158;45347;12535;3.2;0.9
44;2021-02-15;505;830;45852;13365;3.2;0.9
44;2021-02-16;1439;2148;47291;15513;3.3;1.1
44;2021-02-17;1106;1855;48397;17368;3.4;1.2
44;2021-02-18;1959;3278;50356;20646;3.5;1.4
44;2021-02-19;1580;2291;51936;22937;3.6;1.6
44;2021-02-20;409;489;52345;23426;3.6;1.6
44;2021-02-21;6;171;52351;23597;3.6;1.6
44;2021-02-22;717;682;53068;24279;3.7;1.7
44;2021-02-23;1246;898;54314;25177;3.8;1.8
44;2021-02-24;1238;897;55552;26074;3.9;1.8
44;2021-02-25;2445;819;57997;26893;4.0;1.9
44;2021-02-26;2291;777;60288;27670;4.2;1.9
44;2021-02-27;975;343;61263;28013;4.3;1.9
44;2021-02-28;7;31;61270;28044;4.3;2.0
44;2021-03-01;988;456;62258;28500;4.3;2.0
44;2021-03-02;1814;874;64072;29374;4.5;2.0
44;2021-03-03;1859;977;65931;30351;4.6;2.1
44;2021-03-04;2882;1391;68813;31742;4.8;2.2
44;2021-03-05;3481;1225;72294;32967;5.0;2.3
44;2021-03-06;2507;408;74801;33375;5.2;2.3
44;2021-03-07;988;87;75789;33462;5.3;2.3
44;2021-03-08;1783;524;77572;33986;5.4;2.4
44;2021-03-09;3352;1002;80924;34988;5.6;2.4
44;2021-03-10;3079;1018;84003;36006;5.8;2.5
44;2021-03-11;4438;1693;88441;37699;6.2;2.6
44;2021-03-12;5892;1278;94333;38977;6.6;2.7
44;2021-03-13;3629;281;97962;39258;6.8;2.7
44;2021-03-14;431;62;98393;39320;6.8;2.7
44;2021-03-15;2687;360;101080;39680;7.0;2.8
44;2021-03-16;2149;619;103229;40299;7.2;2.8
44;2021-03-17;1960;653;105189;40952;7.3;2.8
44;2021-03-18;2169;632;107358;41584;7.5;2.9
44;2021-03-19;3785;362;111143;41946;7.7;2.9
44;2021-03-20;3213;297;114356;42243;8.0;2.9
44;2021-03-21;914;19;115270;42262;8.0;2.9
44;2021-03-22;2462;438;117732;42700;8.2;3.0
44;2021-03-23;3960;700;121692;43400;8.5;3.0
44;2021-03-24;4303;628;125995;44028;8.8;3.1
44;2021-03-25;5636;920;131631;44948;9.2;3.1
44;2021-03-26;6511;752;138142;45700;9.6;3.2
44;2021-03-27;3216;401;141358;46101;9.8;3.2
44;2021-03-28;1244;27;142602;46128;9.9;3.2
44;2021-03-29;3121;785;145723;46913;10.1;3.3
44;2021-03-30;5138;1102;150861;48015;10.5;3.3
44;2021-03-31;4612;1296;155473;49311;10.8;3.4
44;2021-04-01;6140;1007;161613;50318;11.2;3.5
44;2021-04-02;5795;949;167408;51267;11.6;3.6
44;2021-04-03;2435;650;169843;51917;11.8;3.6
44;2021-04-04;667;21;170510;51938;11.9;3.6
44;2021-04-05;692;288;171202;52226;11.9;3.6
44;2021-04-06;4216;1371;175418;53597;12.2;3.7
44;2021-04-07;5075;1648;180493;55245;12.6;3.8
44;2021-04-08;7182;1668;187675;56913;13.1;4.0
44;2021-04-09;10065;1815;197740;58728;13.8;4.1
44;2021-04-10;4563;1454;202303;60182;14.1;4.2
44;2021-04-11;2148;424;204451;60606;14.2;4.2
44;2021-04-12;5464;1588;209915;62194;14.6;4.3
44;2021-04-13;6727;2256;216642;64450;15.1;4.5
44;2021-04-14;5912;2237;222554;66687;15.5;4.6
44;2021-04-15;6709;2206;229263;68893;16.0;4.8
44;2021-04-16;7785;2048;237048;70941;16.5;4.9
44;2021-04-17;4300;1382;241348;72323;16.8;5.0
44;2021-04-18;2253;819;243601;73142;17.0;5.1
44;2021-04-19;5042;1901;248643;75043;17.3;5.2
44;2021-04-20;6281;2642;254924;77685;17.7;5.4
44;2021-04-21;6006;2788;260930;80473;18.2;5.6
44;2021-04-22;6958;2508;267888;82981;18.6;5.8
44;2021-04-23;7335;3185;275223;86166;19.2;6.0
44;2021-04-24;3971;2045;279194;88211;19.4;6.1
44;2021-04-25;2076;1058;281270;89269;19.6;6.2
44;2021-04-26;5648;2750;286918;92019;20.0;6.4
44;2021-04-27;7415;4076;294333;96095;20.5;6.7
44;2021-04-28;7608;3773;301941;99868;21.0;6.9
44;2021-04-29;8965;4269;310906;104137;21.6;7.2
44;2021-04-30;9569;4680;320475;108817;22.3;7.6
44;2021-05-01;2848;919;323323;109736;22.5;7.6
44;2021-05-02;1903;618;325226;110354;22.6;7.7
44;2021-05-03;5547;4058;330773;114412;23.0;8.0
44;2021-05-04;6327;5112;337100;119524;23.5;8.3
44;2021-05-05;6071;4606;343171;124130;23.9;8.6
44;2021-05-06;7255;4871;350426;129001;24.4;9.0
44;2021-05-07;7451;5689;357877;134690;24.9;9.4
44;2021-05-08;2583;1262;360460;135952;25.1;9.5
44;2021-05-09;1801;1810;362261;137762;25.2;9.6
44;2021-05-10;6574;5766;368835;143528;25.7;10.0
44;2021-05-11;7787;6252;376622;149780;26.2;10.4
44;2021-05-12;8195;5705;384817;155485;26.8;10.8
44;2021-05-13;5304;1193;390121;156678;27.1;10.9
44;2021-05-14;7587;3968;397708;160646;27.7;11.2
44;2021-05-15;5008;2233;402716;162879;28.0;11.3
44;2021-05-16;2791;739;405507;163618;28.2;11.4
44;2021-05-17;6744;5138;412251;168756;28.7;11.7
44;2021-05-18;7962;5211;420213;173967;29.2;12.1
44;2021-05-19;8165;4270;428378;178237;29.8;12.4
44;2021-05-20;8367;4646;436745;182883;30.4;12.7
44;2021-05-21;8844;5189;445589;188072;31.0;13.1
44;2021-05-22;5097;2231;450686;190303;31.4;13.2
44;2021-05-23;1759;824;452445;191127;31.5;13.3
44;2021-05-24;4884;1616;457329;192743;31.8;13.4
44;2021-05-25;7740;5544;465069;198287;32.4;13.8
44;2021-05-26;8181;5041;473250;203328;32.9;14.1
44;2021-05-27;9659;5340;482909;208668;33.6;14.5
44;2021-05-28;9182;6890;492091;215558;34.2;15.0
44;2021-05-29;5883;3309;497974;218867;34.7;15.2
44;2021-05-30;1775;705;499749;219572;34.8;15.3
44;2021-05-31;8059;6169;507808;225741;35.3;15.7
44;2021-06-01;9906;6542;517714;232283;36.0;16.2
44;2021-06-02;9533;5681;527247;237964;36.7;16.6
44;2021-06-03;10852;5866;538099;243830;37.4;17.0
44;2021-06-04;9959;8067;548058;251897;38.1;17.5
44;2021-06-05;5780;4330;553838;256227;38.5;17.8
44;2021-06-06;2361;1130;556199;257357;38.7;17.9
44;2021-06-07;9548;6927;565747;264284;39.4;18.4
44;2021-06-08;10907;7501;576654;271785;40.1;18.9
44;2021-06-09;10552;6313;587206;278098;40.9;19.4
44;2021-06-10;11425;6037;598631;284135;41.7;19.8
44;2021-06-11;11958;8630;610589;292765;42.5;20.4
44;2021-06-12;7761;4094;618350;296859;43.0;20.7
44;2021-06-13;2792;1004;621142;297863;43.2;20.7
44;2021-06-14;8760;8412;629902;306275;43.8;21.3
44;2021-06-15;11704;8256;641606;314531;44.6;21.9
44;2021-06-16;10976;7657;652582;322188;45.4;22.4
44;2021-06-17;11725;8683;664307;330871;46.2;23.0
44;2021-06-18;10900;10113;675207;340984;47.0;23.7
44;2021-06-19;5883;4318;681090;345302;47.4;24.0
44;2021-06-20;2534;1338;683624;346640;47.6;24.1
44;2021-06-21;7349;10010;690973;356650;48.1;24.8
44;2021-06-22;8469;10623;699442;367273;48.7;25.6
44;2021-06-23;8554;9138;707996;376411;49.3;26.2
44;2021-06-24;9123;8562;717119;384973;49.9;26.8
44;2021-06-25;7643;10815;724762;395788;50.4;27.5
44;2021-06-26;2958;6464;727720;402252;50.6;28.0
44;2021-06-27;816;2403;728536;404655;50.7;28.2
44;2021-06-28;5229;10054;733765;414709;51.1;28.9
44;2021-06-29;6179;12081;739944;426790;51.5;29.7
44;2021-06-30;6183;10446;746127;437236;51.9;30.4
44;2021-07-01;6929;10474;753056;447710;52.4;31.2
44;2021-07-02;6693;12549;759749;460259;52.9;32.0
44;2021-07-03;2583;7002;762332;467261;53.0;32.5
44;2021-07-04;995;2235;763327;469496;53.1;32.7
44;2021-07-05;5315;11868;768642;481364;53.5;33.5
44;2021-07-06;6058;12598;774700;493962;53.9;34.4
44;2021-07-07;6512;11097;781212;505059;54.4;35.1
44;2021-07-08;7390;11952;788602;517011;54.9;36.0
44;2021-07-09;6260;14246;794862;531257;55.3;37.0
44;2021-07-10;2446;7007;797308;538264;55.5;37.5
44;2021-07-11;731;2262;798039;540526;55.5;37.6
44;2021-07-12;4395;14049;802434;554575;55.8;38.6
44;2021-07-13;5767;14846;808201;569421;56.2;39.6
44;2021-07-14;3688;5808;811889;575229;56.5;40.0
44;2021-07-15;7228;14280;819117;589509;57.0;41.0
44;2021-07-16;8233;14989;827350;604498;57.6;42.1
44;2021-07-17;3371;7576;830721;612074;57.8;42.6
44;2021-07-18;1433;2548;832154;614622;57.9;42.8
44;2021-07-19;4866;14695;837020;629317;58.2;43.8
44;2021-07-20;6033;15668;843053;644985;58.7;44.9
44;2021-07-21;5843;13985;848896;658970;59.1;45.9
44;2021-07-22;6724;13746;855620;672716;59.5;46.8
44;2021-07-23;6160;15623;861780;688339;60.0;47.9
44;2021-07-24;2856;8716;864636;697055;60.2;48.5
44;2021-07-25;945;3088;865581;700143;60.2;48.7
44;2021-07-26;6081;12679;871662;712822;60.7;49.6
44;2021-07-27;9712;12189;881374;725011;61.3;50.4
44;2021-07-28;9263;10842;890637;735853;62.0;51.2
44;2021-07-29;10287;10839;900924;746692;62.7;52.0
44;2021-07-30;9183;10924;910107;757616;63.3;52.7
44;2021-07-31;4789;5651;914896;763267;63.7;53.1
44;2021-08-01;2573;1409;917469;764676;63.8;53.2
44;2021-08-02;6628;9472;924097;774148;64.3;53.9
44;2021-08-03;8464;8536;932561;782684;64.9;54.5
44;2021-08-04;9127;6986;941688;789670;65.5;54.9
44;2021-08-05;11571;7520;953259;797190;66.3;55.5
44;2021-08-06;9696;8201;962955;805391;67.0;56.0
44;2021-08-07;4609;3702;967564;809093;67.3;56.3
44;2021-08-08;2539;1727;970103;810820;67.5;56.4
44;2021-08-09;8909;7979;979012;818799;68.1;57.0
44;2021-08-10;10272;7621;989284;826420;68.8;57.5
44;2021-08-11;10420;6786;999704;833206;69.6;58.0
44;2021-08-12;10419;7344;1010123;840550;70.3;58.5
44;2021-08-13;8455;6165;1018578;846715;70.9;58.9
44;2021-08-14;3233;3221;1021811;849936;71.1;59.1
44;2021-08-15;716;933;1022527;850869;71.2;59.2
44;2021-08-16;5850;8305;1028377;859174;71.6;59.8
44;2021-08-17;5606;8180;1033983;867354;71.9;60.4
44;2021-08-18;4817;7619;1038800;874973;72.3;60.9
44;2021-08-19;4970;8349;1043770;883322;72.6;61.5
44;2021-08-20;4498;8922;1048268;892244;72.9;62.1
44;2021-08-21;1960;4612;1050228;896856;73.1;62.4
44;2021-08-22;711;2441;1050939;899297;73.1;62.6
44;2021-08-23;3676;9431;1054615;908728;73.4;63.2
44;2021-08-24;3644;8697;1058259;917425;73.6;63.8
44;2021-08-25;3142;8586;1061401;926011;73.9;64.4
44;2021-08-26;2965;10340;1064366;936351;74.1;65.2
44;2021-08-27;3077;10451;1067443;946802;74.3;65.9
44;2021-08-28;1384;5848;1068827;952650;74.4;66.3
44;2021-08-29;565;2706;1069392;955356;74.4;66.5
44;2021-08-30;2667;10966;1072059;966322;74.6;67.2
44;2021-08-31;2819;11226;1074878;977548;74.8;68.0
44;2021-09-01;2688;9935;1077566;987483;75.0;68.7
44;2021-09-02;2253;8741;1079819;996224;75.1;69.3
44;2021-09-03;2129;10204;1081948;1006428;75.3;70.0
44;2021-09-04;1447;6025;1083395;1012453;75.4;70.4
44;2021-09-05;442;1434;1083837;1013887;75.4;70.5
44;2021-09-06;1619;6622;1085456;1020509;75.5;71.0
44;2021-09-07;1477;5776;1086933;1026285;75.6;71.4
44;2021-09-08;1892;6519;1088825;1032804;75.8;71.9
44;2021-09-09;1501;5152;1090326;1037956;75.9;72.2
44;2021-09-10;1824;6492;1092150;1044448;76.0;72.7
44;2021-09-11;1084;4163;1093234;1048611;76.1;73.0
44;2021-09-12;227;850;1093461;1049461;76.1;73.0
44;2021-09-13;1166;4388;1094627;1053849;76.2;73.3
44;2021-09-14;1116;4388;1095743;1058237;76.2;73.6
44;2021-09-15;1446;4488;1097189;1062725;76.3;73.9
44;2021-09-16;989;2380;1098178;1065105;76.4;74.1
44;2021-09-17;1256;3845;1099434;1068950;76.5;74.4
44;2021-09-18;777;3131;1100211;1072081;76.6;74.6
44;2021-09-19;214;702;1100425;1072783;76.6;74.6
44;2021-09-20;915;2206;1101340;1074989;76.6;74.8
44;2021-09-21;748;1868;1102088;1076857;76.7;74.9
44;2021-09-22;941;3546;1103029;1080403;76.8;75.2
44;2021-09-23;830;1929;1103859;1082332;76.8;75.3
44;2021-09-24;1101;2992;1104960;1085324;76.9;75.5
44;2021-09-25;489;2291;1105449;1087615;76.9;75.7
44;2021-09-26;178;483;1105627;1088098;76.9;75.7
44;2021-09-27;768;1783;1106395;1089881;77.0;75.8
44;2021-09-28;653;1675;1107048;1091556;77.0;76.0
44;2021-09-29;962;2501;1108010;1094057;77.1;76.1
45;2020-12-27;0;0;0;0;0.0;0.0
45;2020-12-28;1;0;1;0;0.0;0.0
45;2020-12-29;0;0;1;0;0.0;0.0
45;2020-12-30;0;0;1;0;0.0;0.0
45;2020-12-31;1;0;2;0;0.0;0.0
45;2021-01-01;0;0;2;0;0.0;0.0
45;2021-01-02;0;0;2;0;0.0;0.0
45;2021-01-03;0;0;2;0;0.0;0.0
45;2021-01-04;0;0;2;0;0.0;0.0
45;2021-01-05;76;0;78;0;0.0;0.0
45;2021-01-06;68;0;146;0;0.0;0.0
45;2021-01-07;213;0;359;0;0.1;0.0
45;2021-01-08;199;1;558;1;0.1;0.0
45;2021-01-09;42;0;600;1;0.1;0.0
45;2021-01-10;23;0;623;1;0.1;0.0
45;2021-01-11;254;0;877;1;0.1;0.0
45;2021-01-12;680;3;1557;4;0.2;0.0
45;2021-01-13;496;1;2053;5;0.3;0.0
45;2021-01-14;493;39;2546;44;0.4;0.0
45;2021-01-15;391;3;2937;47;0.4;0.0
45;2021-01-16;39;1;2976;48;0.4;0.0
45;2021-01-17;24;0;3000;48;0.4;0.0
45;2021-01-18;816;1;3816;49;0.6;0.0
45;2021-01-19;1197;5;5013;54;0.7;0.0
45;2021-01-20;2119;12;7132;66;1.0;0.0
45;2021-01-21;2521;6;9653;72;1.4;0.0
45;2021-01-22;1409;6;11062;78;1.6;0.0
45;2021-01-23;124;0;11186;78;1.6;0.0
45;2021-01-24;39;0;11225;78;1.6;0.0
45;2021-01-25;557;3;11782;81;1.7;0.0
45;2021-01-26;870;16;12652;97;1.9;0.0
45;2021-01-27;650;42;13302;139;1.9;0.0
45;2021-01-28;881;197;14183;336;2.1;0.0
45;2021-01-29;578;109;14761;445;2.2;0.1
45;2021-01-30;40;35;14801;480;2.2;0.1
45;2021-01-31;37;22;14838;502;2.2;0.1
45;2021-02-01;461;192;15299;694;2.2;0.1
45;2021-02-02;761;436;16060;1130;2.4;0.2
45;2021-02-03;773;443;16833;1573;2.5;0.2
45;2021-02-04;714;257;17547;1830;2.6;0.3
45;2021-02-05;418;149;17965;1979;2.6;0.3
45;2021-02-06;39;25;18004;2004;2.6;0.3
45;2021-02-07;7;24;18011;2028;2.6;0.3
45;2021-02-08;455;175;18466;2203;2.7;0.3
45;2021-02-09;1006;356;19472;2559;2.9;0.4
45;2021-02-10;1279;765;20751;3324;3.0;0.5
45;2021-02-11;1385;1441;22136;4765;3.2;0.7
45;2021-02-12;1052;1069;23188;5834;3.4;0.9
45;2021-02-13;85;148;23273;5982;3.4;0.9
45;2021-02-14;40;11;23313;5993;3.4;0.9
45;2021-02-15;524;451;23837;6444;3.5;0.9
45;2021-02-16;757;721;24594;7165;3.6;1.0
45;2021-02-17;642;803;25236;7968;3.7;1.2
45;2021-02-18;841;649;26077;8617;3.8;1.3
45;2021-02-19;827;635;26904;9252;3.9;1.4
45;2021-02-20;59;75;26963;9327;3.9;1.4
45;2021-02-21;17;33;26980;9360;4.0;1.4
45;2021-02-22;409;466;27389;9826;4.0;1.4
45;2021-02-23;816;574;28205;10400;4.1;1.5
45;2021-02-24;653;694;28858;11094;4.2;1.6
45;2021-02-25;963;587;29821;11681;4.4;1.7
45;2021-02-26;1043;519;30864;12200;4.5;1.8
45;2021-02-27;290;33;31154;12233;4.6;1.8
45;2021-02-28;28;2;31182;12235;4.6;1.8
45;2021-03-01;534;249;31716;12484;4.6;1.8
45;2021-03-02;668;569;32384;13053;4.7;1.9
45;2021-03-03;981;742;33365;13795;4.9;2.0
45;2021-03-04;1108;912;34473;14707;5.0;2.2
45;2021-03-05;1445;774;35918;15481;5.3;2.3
45;2021-03-06;2021;125;37939;15606;5.6;2.3
45;2021-03-07;143;53;38082;15659;5.6;2.3
45;2021-03-08;754;767;38836;16426;5.7;2.4
45;2021-03-09;1256;591;40092;17017;5.9;2.5
45;2021-03-10;1591;808;41683;17825;6.1;2.6
45;2021-03-11;1721;685;43404;18510;6.4;2.7
45;2021-03-12;2072;566;45476;19076;6.7;2.8
45;2021-03-13;988;44;46464;19120;6.8;2.8
45;2021-03-14;24;39;46488;19159;6.8;2.8
45;2021-03-15;810;572;47298;19731;6.9;2.9
45;2021-03-16;942;811;48240;20542;7.1;3.0
45;2021-03-17;1054;652;49294;21194;7.2;3.1
45;2021-03-18;997;572;50291;21766;7.4;3.2
45;2021-03-19;1619;418;51910;22184;7.6;3.2
45;2021-03-20;498;80;52408;22264;7.7;3.3
45;2021-03-21;20;35;52428;22299;7.7;3.3
45;2021-03-22;915;519;53343;22818;7.8;3.3
45;2021-03-23;1985;710;55328;23528;8.1;3.4
45;2021-03-24;1897;541;57225;24069;8.4;3.5
45;2021-03-25;2983;452;60208;24521;8.8;3.6
45;2021-03-26;3390;483;63598;25004;9.3;3.7
45;2021-03-27;1796;123;65394;25127;9.6;3.7
45;2021-03-28;89;40;65483;25167;9.6;3.7
45;2021-03-29;1531;538;67014;25705;9.8;3.8
45;2021-03-30;2785;777;69799;26482;10.2;3.9
45;2021-03-31;2135;578;71934;27060;10.5;4.0
45;2021-04-01;2968;565;74902;27625;11.0;4.0
45;2021-04-02;2827;513;77729;28138;11.4;4.1
45;2021-04-03;810;71;78539;28209;11.5;4.1
45;2021-04-04;113;33;78652;28242;11.5;4.1
45;2021-04-05;15;2;78667;28244;11.5;4.1
45;2021-04-06;1735;792;80402;29036;11.8;4.3
45;2021-04-07;1774;1112;82176;30148;12.0;4.4
45;2021-04-08;2772;1020;84948;31168;12.4;4.6
45;2021-04-09;3675;647;88623;31815;13.0;4.7
45;2021-04-10;2323;117;90946;31932;13.3;4.7
45;2021-04-11;153;24;91099;31956;13.3;4.7
45;2021-04-12;2606;670;93705;32626;13.7;4.8
45;2021-04-13;3848;1091;97553;33717;14.3;4.9
45;2021-04-14;2930;1219;100483;34936;14.7;5.1
45;2021-04-15;3518;1040;104001;35976;15.2;5.3
45;2021-04-16;3774;690;107775;36666;15.8;5.4
45;2021-04-17;1614;112;109389;36778;16.0;5.4
45;2021-04-18;200;42;109589;36820;16.0;5.4
45;2021-04-19;1938;941;111527;37761;16.3;5.5
45;2021-04-20;3074;1695;114601;39456;16.8;5.8
45;2021-04-21;2724;1304;117325;40760;17.2;6.0
45;2021-04-22;3420;1844;120745;42604;17.7;6.2
45;2021-04-23;3278;1784;124023;44388;18.2;6.5
45;2021-04-24;2023;867;126046;45255;18.5;6.6
45;2021-04-25;291;86;126337;45341;18.5;6.6
45;2021-04-26;2228;1163;128565;46504;18.8;6.8
45;2021-04-27;3351;2350;131916;48854;19.3;7.2
45;2021-04-28;2802;1937;134718;50791;19.7;7.4
45;2021-04-29;3854;2320;138572;53111;20.3;7.8
45;2021-04-30;4391;1801;142963;54912;20.9;8.0
45;2021-05-01;451;61;143414;54973;21.0;8.1
45;2021-05-02;627;122;144041;55095;21.1;8.1
45;2021-05-03;2821;992;146862;56087;21.5;8.2
45;2021-05-04;3157;2349;150019;58436;22.0;8.6
45;2021-05-05;2714;2161;152733;60597;22.4;8.9
45;2021-05-06;3330;2539;156063;63136;22.9;9.2
45;2021-05-07;2871;3183;158934;66319;23.3;9.7
45;2021-05-08;613;244;159547;66563;23.4;9.7
45;2021-05-09;1498;131;161045;66694;23.6;9.8
45;2021-05-10;4139;2968;165184;69662;24.2;10.2
45;2021-05-11;5030;2967;170214;72629;24.9;10.6
45;2021-05-12;6078;2772;176292;75401;25.8;11.0
45;2021-05-13;2449;598;178741;75999;26.2;11.1
45;2021-05-14;4965;1629;183706;77628;26.9;11.4
45;2021-05-15;4064;615;187770;78243;27.5;11.5
45;2021-05-16;289;33;188059;78276;27.5;11.5
45;2021-05-17;3359;1528;191418;79804;28.0;11.7
45;2021-05-18;5117;1681;196535;81485;28.8;11.9
45;2021-05-19;4494;2063;201029;83548;29.4;12.2
45;2021-05-20;5268;2137;206297;85685;30.2;12.5
45;2021-05-21;5140;2223;211437;87908;31.0;12.9
45;2021-05-22;3042;632;214479;88540;31.4;13.0
45;2021-05-23;15;94;214494;88634;31.4;13.0
45;2021-05-24;2826;215;217320;88849;31.8;13.0
45;2021-05-25;4962;3030;222282;91879;32.6;13.5
45;2021-05-26;5108;2337;227390;94216;33.3;13.8
45;2021-05-27;5306;3230;232696;97446;34.1;14.3
45;2021-05-28;5665;3590;238361;101036;34.9;14.8
45;2021-05-29;3671;1288;242032;102324;35.4;15.0
45;2021-05-30;33;182;242065;102506;35.4;15.0
45;2021-05-31;4331;2513;246396;105019;36.1;15.4
45;2021-06-01;6091;3003;252487;108022;37.0;15.8
45;2021-06-02;4937;3107;257424;111129;37.7;16.3
45;2021-06-03;5616;3199;263040;114328;38.5;16.7
45;2021-06-04;5895;3178;268935;117506;39.4;17.2
45;2021-06-05;2035;1332;270970;118838;39.7;17.4
45;2021-06-06;88;198;271058;119036;39.7;17.4
45;2021-06-07;4081;2722;275139;121758;40.3;17.8
45;2021-06-08;4646;4070;279785;125828;41.0;18.4
45;2021-06-09;4356;3343;284141;129171;41.6;18.9
45;2021-06-10;4647;2687;288788;131858;42.3;19.3
45;2021-06-11;4121;3661;292909;135519;42.9;19.8
45;2021-06-12;2440;1504;295349;137023;43.2;20.1
45;2021-06-13;21;424;295370;137447;43.3;20.1
45;2021-06-14;3142;4151;298512;141598;43.7;20.7
45;2021-06-15;3388;4323;301900;145921;44.2;21.4
45;2021-06-16;3904;3452;305804;149373;44.8;21.9
45;2021-06-17;3523;3538;309327;152911;45.3;22.4
45;2021-06-18;3799;5028;313126;157939;45.9;23.1
45;2021-06-19;2393;1761;315519;159700;46.2;23.4
45;2021-06-20;48;142;315567;159842;46.2;23.4
45;2021-06-21;2164;5851;317731;165693;46.5;24.3
45;2021-06-22;2417;6529;320148;172222;46.9;25.2
45;2021-06-23;2282;5598;322430;177820;47.2;26.0
45;2021-06-24;2136;3531;324566;181351;47.5;26.6
45;2021-06-25;2444;6446;327010;187797;47.9;27.5
45;2021-06-26;1948;3094;328958;190891;48.2;28.0
45;2021-06-27;53;138;329011;191029;48.2;28.0
45;2021-06-28;2081;4828;331092;195857;48.5;28.7
45;2021-06-29;2847;6816;333939;202673;48.9;29.7
45;2021-06-30;2886;5852;336825;208525;49.3;30.5
45;2021-07-01;2398;5038;339223;213563;49.7;31.3
45;2021-07-02;2372;6281;341595;219844;50.0;32.2
45;2021-07-03;754;2540;342349;222384;50.1;32.6
45;2021-07-04;6;12;342355;222396;50.1;32.6
45;2021-07-05;2139;4989;344494;227385;50.4;33.3
45;2021-07-06;2806;6777;347300;234162;50.9;34.3
45;2021-07-07;2447;6061;349747;240223;51.2;35.2
45;2021-07-08;2826;5377;352573;245600;51.6;36.0
45;2021-07-09;2146;6984;354719;252584;51.9;37.0
45;2021-07-10;1553;3862;356272;256446;52.2;37.6
45;2021-07-11;24;31;356296;256477;52.2;37.6
45;2021-07-12;1591;5996;357887;262473;52.4;38.4
45;2021-07-13;3042;8236;360929;270709;52.9;39.6
45;2021-07-14;1475;1519;362404;272228;53.1;39.9
45;2021-07-15;3733;7289;366137;279517;53.6;40.9
45;2021-07-16;3253;7446;369390;286963;54.1;42.0
45;2021-07-17;1285;2332;370675;289295;54.3;42.4
45;2021-07-18;15;19;370690;289314;54.3;42.4
45;2021-07-19;1869;5935;372559;295249;54.6;43.2
45;2021-07-20;4757;6900;377316;302149;55.3;44.2
45;2021-07-21;5175;5478;382491;307627;56.0;45.0
45;2021-07-22;6178;4903;388669;312530;56.9;45.8
45;2021-07-23;4259;5478;392928;318008;57.5;46.6
45;2021-07-24;1863;2824;394791;320832;57.8;47.0
45;2021-07-25;5;14;394796;320846;57.8;47.0
45;2021-07-26;2913;4983;397709;325829;58.2;47.7
45;2021-07-27;5464;5084;403173;330913;59.0;48.5
45;2021-07-28;4989;4180;408162;335093;59.8;49.1
45;2021-07-29;5279;3255;413441;338348;60.5;49.5
45;2021-07-30;4762;4708;418203;343056;61.2;50.2
45;2021-07-31;849;1950;419052;345006;61.4;50.5
45;2021-08-01;2;4;419054;345010;61.4;50.5
45;2021-08-02;3635;3245;422689;348255;61.9;51.0
45;2021-08-03;4878;3009;427567;351264;62.6;51.4
45;2021-08-04;3742;2234;431309;353498;63.2;51.8
45;2021-08-05;3326;2636;434635;356134;63.6;52.2
45;2021-08-06;3747;3270;438382;359404;64.2;52.6
45;2021-08-07;1679;1049;440061;360453;64.4;52.8
45;2021-08-08;9;18;440070;360471;64.4;52.8
45;2021-08-09;2627;3014;442697;363485;64.8;53.2
45;2021-08-10;3515;3806;446212;367291;65.3;53.8
45;2021-08-11;2702;3719;448914;371010;65.7;54.3
45;2021-08-12;2093;3430;451007;374440;66.0;54.8
45;2021-08-13;1745;4223;452752;378663;66.3;55.5
45;2021-08-14;682;956;453434;379619;66.4;55.6
45;2021-08-15;62;31;453496;379650;66.4;55.6
45;2021-08-16;1159;2319;454655;381969;66.6;55.9
45;2021-08-17;1859;3449;456514;385418;66.9;56.4
45;2021-08-18;1782;4049;458296;389467;67.1;57.0
45;2021-08-19;1446;4269;459742;393736;67.3;57.7
45;2021-08-20;1424;3681;461166;397417;67.5;58.2
45;2021-08-21;905;1154;462071;398571;67.7;58.4
45;2021-08-22;4;8;462075;398579;67.7;58.4
45;2021-08-23;1332;4245;463407;402824;67.9;59.0
45;2021-08-24;1736;4521;465143;407345;68.1;59.7
45;2021-08-25;1585;3725;466728;411070;68.3;60.2
45;2021-08-26;1010;3450;467738;414520;68.5;60.7
45;2021-08-27;1432;4981;469170;419501;68.7;61.4
45;2021-08-28;878;2030;470048;421531;68.8;61.7
45;2021-08-29;100;38;470148;421569;68.8;61.7
45;2021-08-30;1223;4119;471371;425688;69.0;62.3
45;2021-08-31;1076;4514;472447;430202;69.2;63.0
45;2021-09-01;1102;3549;473549;433751;69.3;63.5
45;2021-09-02;922;3355;474471;437106;69.5;64.0
45;2021-09-03;1088;3843;475559;440949;69.6;64.6
45;2021-09-04;495;1315;476054;442264;69.7;64.8
45;2021-09-05;1;16;476055;442280;69.7;64.8
45;2021-09-06;884;2823;476939;445103;69.8;65.2
45;2021-09-07;708;2232;477647;447335;69.9;65.5
45;2021-09-08;855;2620;478502;449955;70.1;65.9
45;2021-09-09;794;1681;479296;451636;70.2;66.1
45;2021-09-10;778;1879;480074;453515;70.3;66.4
45;2021-09-11;440;1606;480514;455121;70.4;66.6
45;2021-09-12;369;370;480883;455491;70.4;66.7
45;2021-09-13;434;1296;481317;456787;70.5;66.9
45;2021-09-14;753;2078;482070;458865;70.6;67.2
45;2021-09-15;797;1823;482867;460688;70.7;67.5
45;2021-09-16;803;960;483670;461648;70.8;67.6
45;2021-09-17;765;1655;484435;463303;70.9;67.8
45;2021-09-18;480;990;484915;464293;71.0;68.0
45;2021-09-19;2;29;484917;464322;71.0;68.0
45;2021-09-20;412;979;485329;465301;71.1;68.1
45;2021-09-21;449;748;485778;466049;71.1;68.2
45;2021-09-22;437;1701;486215;467750;71.2;68.5
45;2021-09-23;528;837;486743;468587;71.3;68.6
45;2021-09-24;577;1375;487320;469962;71.4;68.8
45;2021-09-25;350;781;487670;470743;71.4;68.9
45;2021-09-26;2;11;487672;470754;71.4;68.9
45;2021-09-27;435;756;488107;471510;71.5;69.0
45;2021-09-28;446;752;488553;472262;71.5;69.2
45;2021-09-29;472;967;489025;473229;71.6;69.3
46;2020-12-27;4;0;4;0;0.0;0.0
46;2020-12-28;0;0;4;0;0.0;0.0
46;2020-12-29;0;0;4;0;0.0;0.0
46;2020-12-30;0;0;4;0;0.0;0.0
46;2020-12-31;0;0;4;0;0.0;0.0
46;2021-01-01;0;0;4;0;0.0;0.0
46;2021-01-02;0;0;4;0;0.0;0.0
46;2021-01-03;1;0;5;0;0.0;0.0
46;2021-01-04;0;0;5;0;0.0;0.0
46;2021-01-05;0;0;5;0;0.0;0.0
46;2021-01-06;3;0;8;0;0.0;0.0
46;2021-01-07;136;0;144;0;0.1;0.0
46;2021-01-08;181;0;325;0;0.2;0.0
46;2021-01-09;1;0;326;0;0.2;0.0
46;2021-01-10;2;0;328;0;0.2;0.0
46;2021-01-11;118;0;446;0;0.3;0.0
46;2021-01-12;140;0;586;0;0.3;0.0
46;2021-01-13;235;0;821;0;0.5;0.0
46;2021-01-14;243;2;1064;2;0.6;0.0
46;2021-01-15;306;2;1370;4;0.8;0.0
46;2021-01-16;18;0;1388;4;0.8;0.0
46;2021-01-17;0;0;1388;4;0.8;0.0
46;2021-01-18;276;2;1664;6;1.0;0.0
46;2021-01-19;390;0;2054;6;1.2;0.0
46;2021-01-20;939;2;2993;8;1.7;0.0
46;2021-01-21;997;0;3990;8;2.3;0.0
46;2021-01-22;391;2;4381;10;2.5;0.0
46;2021-01-23;0;0;4381;10;2.5;0.0
46;2021-01-24;0;0;4381;10;2.5;0.0
46;2021-01-25;204;1;4585;11;2.6;0.0
46;2021-01-26;264;1;4849;12;2.8;0.0
46;2021-01-27;276;0;5125;12;3.0;0.0
46;2021-01-28;278;43;5403;55;3.1;0.0
46;2021-01-29;233;61;5636;116;3.3;0.1
46;2021-01-30;1;0;5637;116;3.3;0.1
46;2021-01-31;1;0;5638;116;3.3;0.1
46;2021-02-01;234;141;5872;257;3.4;0.1
46;2021-02-02;210;201;6082;458;3.5;0.3
46;2021-02-03;227;90;6309;548;3.6;0.3
46;2021-02-04;372;73;6681;621;3.9;0.4
46;2021-02-05;226;153;6907;774;4.0;0.4
46;2021-02-06;9;0;6916;774;4.0;0.4
46;2021-02-07;43;0;6959;774;4.0;0.4
46;2021-02-08;197;125;7156;899;4.1;0.5
46;2021-02-09;271;202;7427;1101;4.3;0.6
46;2021-02-10;280;481;7707;1582;4.5;0.9
46;2021-02-11;655;509;8362;2091;4.8;1.2
46;2021-02-12;323;313;8685;2404;5.0;1.4
46;2021-02-13;2;0;8687;2404;5.0;1.4
46;2021-02-14;0;62;8687;2466;5.0;1.4
46;2021-02-15;195;223;8882;2689;5.1;1.6
46;2021-02-16;217;214;9099;2903;5.3;1.7
46;2021-02-17;201;276;9300;3179;5.4;1.8
46;2021-02-18;337;227;9637;3406;5.6;2.0
46;2021-02-19;277;199;9914;3605;5.7;2.1
46;2021-02-20;0;0;9914;3605;5.7;2.1
46;2021-02-21;1;0;9915;3605;5.7;2.1
46;2021-02-22;131;156;10046;3761;5.8;2.2
46;2021-02-23;225;130;10271;3891;5.9;2.2
46;2021-02-24;179;262;10450;4153;6.0;2.4
46;2021-02-25;247;288;10697;4441;6.2;2.6
46;2021-02-26;403;313;11100;4754;6.4;2.7
46;2021-02-27;120;1;11220;4755;6.5;2.7
46;2021-02-28;0;3;11220;4758;6.5;2.7
46;2021-03-01;169;157;11389;4915;6.6;2.8
46;2021-03-02;406;198;11795;5113;6.8;3.0
46;2021-03-03;458;309;12253;5422;7.1;3.1
46;2021-03-04;607;413;12860;5835;7.4;3.4
46;2021-03-05;808;335;13668;6170;7.9;3.6
46;2021-03-06;476;15;14144;6185;8.2;3.6
46;2021-03-07;101;19;14245;6204;8.2;3.6
46;2021-03-08;348;223;14593;6427;8.4;3.7
46;2021-03-09;746;255;15339;6682;8.9;3.9
46;2021-03-10;686;234;16025;6916;9.3;4.0
46;2021-03-11;851;247;16876;7163;9.7;4.1
46;2021-03-12;926;205;17802;7368;10.3;4.3
46;2021-03-13;512;4;18314;7372;10.6;4.3
46;2021-03-14;0;0;18314;7372;10.6;4.3
46;2021-03-15;505;153;18819;7525;10.9;4.3
46;2021-03-16;752;165;19571;7690;11.3;4.4
46;2021-03-17;674;188;20245;7878;11.7;4.5
46;2021-03-18;758;204;21003;8082;12.1;4.7
46;2021-03-19;811;145;21814;8227;12.6;4.8
46;2021-03-20;294;4;22108;8231;12.8;4.8
46;2021-03-21;2;0;22110;8231;12.8;4.8
46;2021-03-22;555;238;22665;8469;13.1;4.9
46;2021-03-23;702;209;23367;8678;13.5;5.0
46;2021-03-24;673;237;24040;8915;13.9;5.1
46;2021-03-25;1135;177;25175;9092;14.5;5.3
46;2021-03-26;1025;338;26200;9430;15.1;5.4
46;2021-03-27;420;50;26620;9480;15.4;5.5
46;2021-03-28;127;1;26747;9481;15.4;5.5
46;2021-03-29;733;251;27480;9732;15.9;5.6
46;2021-03-30;767;364;28247;10096;16.3;5.8
46;2021-03-31;865;415;29112;10511;16.8;6.1
46;2021-04-01;1171;345;30283;10856;17.5;6.3
46;2021-04-02;922;393;31205;11249;18.0;6.5
46;2021-04-03;167;165;31372;11414;18.1;6.6
46;2021-04-04;0;71;31372;11485;18.1;6.6
46;2021-04-05;3;0;31375;11485;18.1;6.6
46;2021-04-06;544;517;31919;12002;18.4;6.9
46;2021-04-07;784;644;32703;12646;18.9;7.3
46;2021-04-08;962;540;33665;13186;19.4;7.6
46;2021-04-09;1018;506;34683;13692;20.0;7.9
46;2021-04-10;506;208;35189;13900;20.3;8.0
46;2021-04-11;232;1;35421;13901;20.5;8.0
46;2021-04-12;845;546;36266;14447;20.9;8.3
46;2021-04-13;1187;718;37453;15165;21.6;8.8
46;2021-04-14;1533;612;38986;15777;22.5;9.1
46;2021-04-15;1504;661;40490;16438;23.4;9.5
46;2021-04-16;1584;567;42074;17005;24.3;9.8
46;2021-04-17;994;136;43068;17141;24.9;9.9
46;2021-04-18;517;9;43585;17150;25.2;9.9
46;2021-04-19;1070;570;44655;17720;25.8;10.2
46;2021-04-20;1229;730;45884;18450;26.5;10.7
46;2021-04-21;1230;711;47114;19161;27.2;11.1
46;2021-04-22;1391;726;48505;19887;28.0;11.5
46;2021-04-23;1132;732;49637;20619;28.7;11.9
46;2021-04-24;472;19;50109;20638;28.9;11.9
46;2021-04-25;351;11;50460;20649;29.1;11.9
46;2021-04-26;852;730;51312;21379;29.6;12.3
46;2021-04-27;1221;665;52533;22044;30.3;12.7
46;2021-04-28;1289;668;53822;22712;31.1;13.1
46;2021-04-29;1417;524;55239;23236;31.9;13.4
46;2021-04-30;1438;566;56677;23802;32.7;13.7
46;2021-05-01;697;73;57374;23875;33.1;13.8
46;2021-05-02;346;4;57720;23879;33.3;13.8
46;2021-05-03;853;568;58573;24447;33.8;14.1
46;2021-05-04;1037;1061;59610;25508;34.4;14.7
46;2021-05-05;1374;787;60984;26295;35.2;15.2
46;2021-05-06;1377;741;62361;27036;36.0;15.6
46;2021-05-07;1396;792;63757;27828;36.8;16.1
46;2021-05-08;280;409;64037;28237;37.0;16.3
46;2021-05-09;23;225;64060;28462;37.0;16.4
46;2021-05-10;516;1136;64576;29598;37.3;17.1
46;2021-05-11;1031;1254;65607;30852;37.9;17.8
46;2021-05-12;993;1556;66600;32408;38.5;18.7
46;2021-05-13;599;144;67199;32552;38.8;18.8
46;2021-05-14;958;1097;68157;33649;39.4;19.4
46;2021-05-15;254;654;68411;34303;39.5;19.8
46;2021-05-16;77;297;68488;34600;39.6;20.0
46;2021-05-17;652;960;69140;35560;39.9;20.5
46;2021-05-18;1402;1024;70542;36584;40.7;21.1
46;2021-05-19;1305;904;71847;37488;41.5;21.6
46;2021-05-20;1453;810;73300;38298;42.3;22.1
46;2021-05-21;997;1158;74297;39456;42.9;22.8
46;2021-05-22;146;367;74443;39823;43.0;23.0
46;2021-05-23;451;25;74894;39848;43.2;23.0
46;2021-05-24;411;113;75305;39961;43.5;23.1
46;2021-05-25;961;1333;76266;41294;44.0;23.8
46;2021-05-26;1237;1149;77503;42443;44.8;24.5
46;2021-05-27;1432;1192;78935;43635;45.6;25.2
46;2021-05-28;1428;1208;80363;44843;46.4;25.9
46;2021-05-29;1049;397;81412;45240;47.0;26.1
46;2021-05-30;409;39;81821;45279;47.3;26.1
46;2021-05-31;968;976;82789;46255;47.8;26.7
46;2021-06-01;1277;996;84066;47251;48.5;27.3
46;2021-06-02;1320;1116;85386;48367;49.3;27.9
46;2021-06-03;1415;1011;86801;49378;50.1;28.5
46;2021-06-04;1329;977;88130;50355;50.9;29.1
46;2021-06-05;381;414;88511;50769;51.1;29.3
46;2021-06-06;209;96;88720;50865;51.2;29.4
46;2021-06-07;814;616;89534;51481;51.7;29.7
46;2021-06-08;1020;895;90554;52376;52.3;30.2
46;2021-06-09;1503;974;92057;53350;53.2;30.8
46;2021-06-10;981;850;93038;54200;53.7;31.3
46;2021-06-11;969;1321;94007;55521;54.3;32.1
46;2021-06-12;459;545;94466;56066;54.6;32.4
46;2021-06-13;27;86;94493;56152;54.6;32.4
46;2021-06-14;593;1138;95086;57290;54.9;33.1
46;2021-06-15;751;1245;95837;58535;55.3;33.8
46;2021-06-16;1001;1113;96838;59648;55.9;34.4
46;2021-06-17;527;895;97365;60543;56.2;35.0
46;2021-06-18;657;1254;98022;61797;56.6;35.7
46;2021-06-19;457;313;98479;62110;56.9;35.9
46;2021-06-20;39;161;98518;62271;56.9;36.0
46;2021-06-21;429;946;98947;63217;57.1;36.5
46;2021-06-22;350;1177;99297;64394;57.3;37.2
46;2021-06-23;519;1074;99816;65468;57.6;37.8
46;2021-06-24;251;820;100067;66288;57.8;38.3
46;2021-06-25;491;1118;100558;67406;58.1;38.9
46;2021-06-26;398;553;100956;67959;58.3;39.2
46;2021-06-27;3;4;100959;67963;58.3;39.2
46;2021-06-28;315;1340;101274;69303;58.5;40.0
46;2021-06-29;375;1680;101649;70983;58.7;41.0
46;2021-06-30;510;1577;102159;72560;59.0;41.9
46;2021-07-01;487;1153;102646;73713;59.3;42.6
46;2021-07-02;455;1087;103101;74800;59.5;43.2
46;2021-07-03;120;454;103221;75254;59.6;43.5
46;2021-07-04;57;127;103278;75381;59.6;43.5
46;2021-07-05;347;1186;103625;76567;59.8;44.2
46;2021-07-06;449;1457;104074;78024;60.1;45.1
46;2021-07-07;583;1726;104657;79750;60.4;46.1
46;2021-07-08;340;1164;104997;80914;60.6;46.7
46;2021-07-09;395;1706;105392;82620;60.9;47.7
46;2021-07-10;285;1039;105677;83659;61.0;48.3
46;2021-07-11;15;375;105692;84034;61.0;48.5
46;2021-07-12;248;1259;105940;85293;61.2;49.3
46;2021-07-13;626;1671;106566;86964;61.5;50.2
46;2021-07-14;73;144;106639;87108;61.6;50.3
46;2021-07-15;917;1464;107556;88572;62.1;51.1
46;2021-07-16;766;1394;108322;89966;62.6;52.0
46;2021-07-17;364;539;108686;90505;62.8;52.3
46;2021-07-18;2;0;108688;90505;62.8;52.3
46;2021-07-19;729;1188;109417;91693;63.2;53.0
46;2021-07-20;983;1438;110400;93131;63.8;53.8
46;2021-07-21;1001;1378;111401;94509;64.3;54.6
46;2021-07-22;1404;1118;112805;95627;65.1;55.2
46;2021-07-23;768;1322;113573;96949;65.6;56.0
46;2021-07-24;956;662;114529;97611;66.1;56.4
46;2021-07-25;136;17;114665;97628;66.2;56.4
46;2021-07-26;881;879;115546;98507;66.7;56.9
46;2021-07-27;1220;978;116766;99485;67.4;57.5
46;2021-07-28;1284;1114;118050;100599;68.2;58.1
46;2021-07-29;1580;849;119630;101448;69.1;58.6
46;2021-07-30;1933;956;121563;102404;70.2;59.1
46;2021-07-31;958;661;122521;103065;70.8;59.5
46;2021-08-01;12;3;122533;103068;70.8;59.5
46;2021-08-02;974;591;123507;103659;71.3;59.9
46;2021-08-03;1365;679;124872;104338;72.1;60.3
46;2021-08-04;1735;586;126607;104924;73.1;60.6
46;2021-08-05;1382;842;127989;105766;73.9;61.1
46;2021-08-06;1422;847;129411;106613;74.7;61.6
46;2021-08-07;707;543;130118;107156;75.1;61.9
46;2021-08-08;152;66;130270;107222;75.2;61.9
46;2021-08-09;1016;694;131286;107916;75.8;62.3
46;2021-08-10;1206;892;132492;108808;76.5;62.8
46;2021-08-11;1260;1064;133752;109872;77.2;63.4
46;2021-08-12;990;800;134742;110672;77.8;63.9
46;2021-08-13;953;1005;135695;111677;78.4;64.5
46;2021-08-14;588;774;136283;112451;78.7;64.9
46;2021-08-15;8;27;136291;112478;78.7;65.0
46;2021-08-16;795;810;137086;113288;79.2;65.4
46;2021-08-17;889;1288;137975;114576;79.7;66.2
46;2021-08-18;769;1051;138744;115627;80.1;66.8
46;2021-08-19;672;1363;139416;116990;80.5;67.6
46;2021-08-20;518;1557;139934;118547;80.8;68.5
46;2021-08-21;378;649;140312;119196;81.0;68.8
46;2021-08-22;2;31;140314;119227;81.0;68.9
46;2021-08-23;424;1204;140738;120431;81.3;69.5
46;2021-08-24;554;1338;141292;121769;81.6;70.3
46;2021-08-25;530;1398;141822;123167;81.9;71.1
46;2021-08-26;392;1095;142214;124262;82.1;71.8
46;2021-08-27;435;1912;142649;126174;82.4;72.9
46;2021-08-28;271;652;142920;126826;82.5;73.2
46;2021-08-29;5;11;142925;126837;82.5;73.2
46;2021-08-30;294;1133;143219;127970;82.7;73.9
46;2021-08-31;340;1278;143559;129248;82.9;74.6
46;2021-09-01;393;1147;143952;130395;83.1;75.3
46;2021-09-02;271;1024;144223;131419;83.3;75.9
46;2021-09-03;321;1293;144544;132712;83.5;76.6
46;2021-09-04;188;664;144732;133376;83.6;77.0
46;2021-09-05;8;16;144740;133392;83.6;77.0
46;2021-09-06;218;756;144958;134148;83.7;77.5
46;2021-09-07;252;817;145210;134965;83.9;77.9
46;2021-09-08;277;892;145487;135857;84.0;78.5
46;2021-09-09;198;640;145685;136497;84.1;78.8
46;2021-09-10;277;1025;145962;137522;84.3;79.4
46;2021-09-11;150;388;146112;137910;84.4;79.6
46;2021-09-12;8;23;146120;137933;84.4;79.7
46;2021-09-13;178;694;146298;138627;84.5;80.1
46;2021-09-14;264;735;146562;139362;84.6;80.5
46;2021-09-15;257;676;146819;140038;84.8;80.9
46;2021-09-16;132;265;146951;140303;84.9;81.0
46;2021-09-17;232;554;147183;140857;85.0;81.3
46;2021-09-18;101;364;147284;141221;85.1;81.6
46;2021-09-19;3;9;147287;141230;85.1;81.6
46;2021-09-20;69;350;147356;141580;85.1;81.8
46;2021-09-21;70;237;147426;141817;85.1;81.9
46;2021-09-22;128;482;147554;142299;85.2;82.2
46;2021-09-23;82;225;147636;142524;85.3;82.3
46;2021-09-24;76;400;147712;142924;85.3;82.5
46;2021-09-25;69;221;147781;143145;85.3;82.7
46;2021-09-26;3;8;147784;143153;85.3;82.7
46;2021-09-27;75;229;147859;143382;85.4;82.8
46;2021-09-28;48;225;147907;143607;85.4;82.9
46;2021-09-29;81;289;147988;143896;85.5;83.1
47;2020-12-27;0;0;0;0;0.0;0.0
47;2020-12-28;0;0;0;0;0.0;0.0
47;2020-12-29;0;0;0;0;0.0;0.0
47;2020-12-30;0;0;0;0;0.0;0.0
47;2020-12-31;0;0;0;0;0.0;0.0
47;2021-01-01;4;0;4;0;0.0;0.0
47;2021-01-02;0;0;4;0;0.0;0.0
47;2021-01-03;0;0;4;0;0.0;0.0
47;2021-01-04;0;0;4;0;0.0;0.0
47;2021-01-05;1;0;5;0;0.0;0.0
47;2021-01-06;0;0;5;0;0.0;0.0
47;2021-01-07;71;0;76;0;0.0;0.0
47;2021-01-08;314;0;390;0;0.1;0.0
47;2021-01-09;113;0;503;0;0.2;0.0
47;2021-01-10;0;0;503;0;0.2;0.0
47;2021-01-11;249;1;752;1;0.2;0.0
47;2021-01-12;327;0;1079;1;0.3;0.0
47;2021-01-13;349;0;1428;1;0.4;0.0
47;2021-01-14;363;4;1791;5;0.5;0.0
47;2021-01-15;287;1;2078;6;0.6;0.0
47;2021-01-16;176;3;2254;9;0.7;0.0
47;2021-01-17;0;0;2254;9;0.7;0.0
47;2021-01-18;486;1;2740;10;0.8;0.0
47;2021-01-19;469;2;3209;12;1.0;0.0
47;2021-01-20;516;0;3725;12;1.1;0.0
47;2021-01-21;585;1;4310;13;1.3;0.0
47;2021-01-22;470;0;4780;13;1.4;0.0
47;2021-01-23;390;0;5170;13;1.6;0.0
47;2021-01-24;0;0;5170;13;1.6;0.0
47;2021-01-25;434;0;5604;13;1.7;0.0
47;2021-01-26;792;4;6396;17;1.9;0.0
47;2021-01-27;731;0;7127;17;2.2;0.0
47;2021-01-28;574;60;7701;77;2.3;0.0
47;2021-01-29;461;161;8162;238;2.5;0.1
47;2021-01-30;301;37;8463;275;2.6;0.1
47;2021-01-31;0;0;8463;275;2.6;0.1
47;2021-02-01;372;113;8835;388;2.7;0.1
47;2021-02-02;759;308;9594;696;2.9;0.2
47;2021-02-03;425;149;10019;845;3.0;0.3
47;2021-02-04;370;303;10389;1148;3.1;0.3
47;2021-02-05;300;302;10689;1450;3.2;0.4
47;2021-02-06;297;84;10986;1534;3.3;0.5
47;2021-02-07;0;0;10986;1534;3.3;0.5
47;2021-02-08;183;201;11169;1735;3.4;0.5
47;2021-02-09;231;199;11400;1934;3.5;0.6
47;2021-02-10;254;199;11654;2133;3.5;0.6
47;2021-02-11;356;319;12010;2452;3.6;0.7
47;2021-02-12;243;373;12253;2825;3.7;0.9
47;2021-02-13;226;89;12479;2914;3.8;0.9
47;2021-02-14;0;0;12479;2914;3.8;0.9
47;2021-02-15;194;312;12673;3226;3.8;1.0
47;2021-02-16;303;524;12976;3750;3.9;1.1
47;2021-02-17;326;385;13302;4135;4.0;1.3
47;2021-02-18;201;483;13503;4618;4.1;1.4
47;2021-02-19;193;307;13696;4925;4.1;1.5
47;2021-02-20;117;216;13813;5141;4.2;1.6
47;2021-02-21;0;0;13813;5141;4.2;1.6
47;2021-02-22;75;323;13888;5464;4.2;1.7
47;2021-02-23;149;541;14037;6005;4.2;1.8
47;2021-02-24;261;492;14298;6497;4.3;2.0
47;2021-02-25;304;361;14602;6858;4.4;2.1
47;2021-02-26;467;288;15069;7146;4.6;2.2
47;2021-02-27;324;175;15393;7321;4.7;2.2
47;2021-02-28;0;0;15393;7321;4.7;2.2
47;2021-03-01;124;364;15517;7685;4.7;2.3
47;2021-03-02;199;322;15716;8007;4.8;2.4
47;2021-03-03;244;303;15960;8310;4.8;2.5
47;2021-03-04;592;297;16552;8607;5.0;2.6
47;2021-03-05;844;255;17396;8862;5.3;2.7
47;2021-03-06;505;168;17901;9030;5.4;2.7
47;2021-03-07;331;6;18232;9036;5.5;2.7
47;2021-03-08;458;200;18690;9236;5.7;2.8
47;2021-03-09;508;454;19198;9690;5.8;2.9
47;2021-03-10;666;281;19864;9971;6.0;3.0
47;2021-03-11;940;359;20804;10330;6.3;3.1
47;2021-03-12;1373;267;22177;10597;6.7;3.2
47;2021-03-13;950;108;23127;10705;7.0;3.2
47;2021-03-14;51;0;23178;10705;7.0;3.2
47;2021-03-15;593;151;23771;10856;7.2;3.3
47;2021-03-16;750;158;24521;11014;7.4;3.3
47;2021-03-17;861;203;25382;11217;7.7;3.4
47;2021-03-18;917;174;26299;11391;8.0;3.4
47;2021-03-19;1272;128;27571;11519;8.3;3.5
47;2021-03-20;1088;59;28659;11578;8.7;3.5
47;2021-03-21;344;1;29003;11579;8.8;3.5
47;2021-03-22;1010;94;30013;11673;9.1;3.5
47;2021-03-23;1146;144;31159;11817;9.4;3.6
47;2021-03-24;1214;128;32373;11945;9.8;3.6
47;2021-03-25;1567;150;33940;12095;10.3;3.7
47;2021-03-26;1882;198;35822;12293;10.8;3.7
47;2021-03-27;980;130;36802;12423;11.1;3.8
47;2021-03-28;699;5;37501;12428;11.4;3.8
47;2021-03-29;1511;79;39012;12507;11.8;3.8
47;2021-03-30;1645;127;40657;12634;12.3;3.8
47;2021-03-31;1605;152;42262;12786;12.8;3.9
47;2021-04-01;1682;269;43944;13055;13.3;4.0
47;2021-04-02;1932;452;45876;13507;13.9;4.1
47;2021-04-03;1202;182;47078;13689;14.3;4.1
47;2021-04-04;475;13;47553;13702;14.4;4.1
47;2021-04-05;1297;59;48850;13761;14.8;4.2
47;2021-04-06;1386;388;50236;14149;15.2;4.3
47;2021-04-07;1697;592;51933;14741;15.7;4.5
47;2021-04-08;1834;469;53767;15210;16.3;4.6
47;2021-04-09;2084;542;55851;15752;16.9;4.8
47;2021-04-10;1565;324;57416;16076;17.4;4.9
47;2021-04-11;530;9;57946;16085;17.5;4.9
47;2021-04-12;1438;614;59384;16699;18.0;5.1
47;2021-04-13;1813;763;61197;17462;18.5;5.3
47;2021-04-14;1749;720;62946;18182;19.1;5.5
47;2021-04-15;2012;844;64958;19026;19.7;5.8
47;2021-04-16;1768;890;66726;19916;20.2;6.0
47;2021-04-17;1471;969;68197;20885;20.6;6.3
47;2021-04-18;23;0;68220;20885;20.7;6.3
47;2021-04-19;1331;931;69551;21816;21.1;6.6
47;2021-04-20;1626;910;71177;22726;21.5;6.9
47;2021-04-21;1623;774;72800;23500;22.0;7.1
47;2021-04-22;1869;1056;74669;24556;22.6;7.4
47;2021-04-23;1729;1075;76398;25631;23.1;7.8
47;2021-04-24;1549;803;77947;26434;23.6;8.0
47;2021-04-25;242;344;78189;26778;23.7;8.1
47;2021-04-26;1490;1359;79679;28137;24.1;8.5
47;2021-04-27;1922;1466;81601;29603;24.7;9.0
47;2021-04-28;2090;1589;83691;31192;25.3;9.4
47;2021-04-29;2532;1503;86223;32695;26.1;9.9
47;2021-04-30;2044;1778;88267;34473;26.7;10.4
47;2021-05-01;2263;984;90530;35457;27.4;10.7
47;2021-05-02;21;357;90551;35814;27.4;10.8
47;2021-05-03;1596;1418;92147;37232;27.9;11.3
47;2021-05-04;1645;1729;93792;38961;28.4;11.8
47;2021-05-05;1926;1639;95718;40600;29.0;12.3
47;2021-05-06;2105;1507;97823;42107;29.6;12.7
47;2021-05-07;2001;1621;99824;43728;30.2;13.2
47;2021-05-08;2097;464;101921;44192;30.9;13.4
47;2021-05-09;24;359;101945;44551;30.9;13.5
47;2021-05-10;1202;1669;103147;46220;31.2;14.0
47;2021-05-11;2172;1982;105319;48202;31.9;14.6
47;2021-05-12;2624;1445;107943;49647;32.7;15.0
47;2021-05-13;2380;656;110323;50303;33.4;15.2
47;2021-05-14;2061;860;112384;51163;34.0;15.5
47;2021-05-15;1934;865;114318;52028;34.6;15.8
47;2021-05-16;367;9;114685;52037;34.7;15.8
47;2021-05-17;1884;1124;116569;53161;35.3;16.1
47;2021-05-18;2358;1139;118927;54300;36.0;16.4
47;2021-05-19;2345;760;121272;55060;36.7;16.7
47;2021-05-20;2589;967;123861;56027;37.5;17.0
47;2021-05-21;1538;1133;125399;57160;38.0;17.3
47;2021-05-22;2369;839;127768;57999;38.7;17.6
47;2021-05-23;25;186;127793;58185;38.7;17.6
47;2021-05-24;1549;237;129342;58422;39.2;17.7
47;2021-05-25;1481;1318;130823;59740;39.6;18.1
47;2021-05-26;1599;1089;132422;60829;40.1;18.4
47;2021-05-27;1943;1270;134365;62099;40.7;18.8
47;2021-05-28;1458;1534;135823;63633;41.1;19.3
47;2021-05-29;1153;1120;136976;64753;41.5;19.6
47;2021-05-30;12;45;136988;64798;41.5;19.6
47;2021-05-31;1868;1416;138856;66214;42.0;20.0
47;2021-06-01;1921;1342;140777;67556;42.6;20.5
47;2021-06-02;2100;1332;142877;68888;43.3;20.9
47;2021-06-03;2486;1610;145363;70498;44.0;21.3
47;2021-06-04;1965;2117;147328;72615;44.6;22.0
47;2021-06-05;1640;1470;148968;74085;45.1;22.4
47;2021-06-06;211;70;149179;74155;45.2;22.4
47;2021-06-07;1659;2237;150838;76392;45.7;23.1
47;2021-06-08;1629;1903;152467;78295;46.2;23.7
47;2021-06-09;1824;2123;154291;80418;46.7;24.3
47;2021-06-10;2377;1619;156668;82037;47.4;24.8
47;2021-06-11;1826;2099;158494;84136;48.0;25.5
47;2021-06-12;1351;2102;159845;86238;48.4;26.1
47;2021-06-13;4;10;159849;86248;48.4;26.1
47;2021-06-14;1281;2440;161130;88688;48.8;26.8
47;2021-06-15;1464;2032;162594;90720;49.2;27.5
47;2021-06-16;1203;2183;163797;92903;49.6;28.1
47;2021-06-17;1654;1522;165451;94425;50.1;28.6
47;2021-06-18;1439;2496;166890;96921;50.5;29.3
47;2021-06-19;1541;2452;168431;99373;51.0;30.1
47;2021-06-20;5;33;168436;99406;51.0;30.1
47;2021-06-21;1136;2513;169572;101919;51.3;30.9
47;2021-06-22;762;2506;170334;104425;51.6;31.6
47;2021-06-23;999;2015;171333;106440;51.9;32.2
47;2021-06-24;1211;1936;172544;108376;52.2;32.8
47;2021-06-25;1006;2608;173550;110984;52.5;33.6
47;2021-06-26;987;2789;174537;113773;52.8;34.4
47;2021-06-27;16;349;174553;114122;52.8;34.5
47;2021-06-28;875;2407;175428;116529;53.1;35.3
47;2021-06-29;797;2314;176225;118843;53.3;36.0
47;2021-06-30;730;2303;176955;121146;53.6;36.7
47;2021-07-01;921;2105;177876;123251;53.8;37.3
47;2021-07-02;885;2274;178761;125525;54.1;38.0
47;2021-07-03;726;3042;179487;128567;54.3;38.9
47;2021-07-04;34;12;179521;128579;54.3;38.9
47;2021-07-05;979;2148;180500;130727;54.6;39.6
47;2021-07-06;1007;1957;181507;132684;54.9;40.2
47;2021-07-07;1298;2064;182805;134748;55.3;40.8
47;2021-07-08;1142;2192;183947;136940;55.7;41.5
47;2021-07-09;1047;2404;184994;139344;56.0;42.2
47;2021-07-10;952;2131;185946;141475;56.3;42.8
47;2021-07-11;1;6;185947;141481;56.3;42.8
47;2021-07-12;556;2580;186503;144061;56.5;43.6
47;2021-07-13;1094;2585;187597;146646;56.8;44.4
47;2021-07-14;1165;1577;188762;148223;57.1;44.9
47;2021-07-15;1717;3135;190479;151358;57.7;45.8
47;2021-07-16;1722;2676;192201;154034;58.2;46.6
47;2021-07-17;1201;2458;193402;156492;58.5;47.4
47;2021-07-18;36;188;193438;156680;58.6;47.4
47;2021-07-19;1113;2557;194551;159237;58.9;48.2
47;2021-07-20;1638;2341;196189;161578;59.4;48.9
47;2021-07-21;2193;2240;198382;163818;60.1;49.6
47;2021-07-22;2157;2298;200539;166116;60.7;50.3
47;2021-07-23;2124;2250;202663;168366;61.4;51.0
47;2021-07-24;1114;1915;203777;170281;61.7;51.5
47;2021-07-25;20;1;203797;170282;61.7;51.5
47;2021-07-26;1236;1944;205033;172226;62.1;52.1
47;2021-07-27;2122;1633;207155;173859;62.7;52.6
47;2021-07-28;1881;1605;209036;175464;63.3;53.1
47;2021-07-29;2339;1602;211375;177066;64.0;53.6
47;2021-07-30;1865;1625;213240;178691;64.6;54.1
47;2021-07-31;1485;1667;214725;180358;65.0;54.6
47;2021-08-01;18;8;214743;180366;65.0;54.6
47;2021-08-02;2053;1219;216796;181585;65.6;55.0
47;2021-08-03;2159;1106;218955;182691;66.3;55.3
47;2021-08-04;2192;1526;221147;184217;66.9;55.8
47;2021-08-05;2407;1447;223554;185664;67.7;56.2
47;2021-08-06;1999;1841;225553;187505;68.3;56.8
47;2021-08-07;1628;1418;227181;188923;68.8;57.2
47;2021-08-08;24;22;227205;188945;68.8;57.2
47;2021-08-09;1883;1213;229088;190158;69.3;57.6
47;2021-08-10;1920;1298;231008;191456;69.9;58.0
47;2021-08-11;1804;1400;232812;192856;70.5;58.4
47;2021-08-12;2060;1339;234872;194195;71.1;58.8
47;2021-08-13;1424;1668;236296;195863;71.5;59.3
47;2021-08-14;1350;1443;237646;197306;71.9;59.7
47;2021-08-15;11;18;237657;197324;71.9;59.7
47;2021-08-16;1436;1445;239093;198769;72.4;60.2
47;2021-08-17;1124;1684;240217;200453;72.7;60.7
47;2021-08-18;1181;1714;241398;202167;73.1;61.2
47;2021-08-19;1038;1811;242436;203978;73.4;61.7
47;2021-08-20;972;1708;243408;205686;73.7;62.3
47;2021-08-21;828;1276;244236;206962;73.9;62.7
47;2021-08-22;19;31;244255;206993;73.9;62.7
47;2021-08-23;616;1826;244871;208819;74.1;63.2
47;2021-08-24;811;1622;245682;210441;74.4;63.7
47;2021-08-25;811;1787;246493;212228;74.6;64.2
47;2021-08-26;736;2080;247229;214308;74.8;64.9
47;2021-08-27;700;1978;247929;216286;75.1;65.5
47;2021-08-28;566;1670;248495;217956;75.2;66.0
47;2021-08-29;2;16;248497;217972;75.2;66.0
47;2021-08-30;459;1926;248956;219898;75.4;66.6
47;2021-08-31;584;1816;249540;221714;75.5;67.1
47;2021-09-01;420;2019;249960;223733;75.7;67.7
47;2021-09-02;436;2018;250396;225751;75.8;68.3
47;2021-09-03;504;1954;250900;227705;76.0;68.9
47;2021-09-04;477;1822;251377;229527;76.1;69.5
47;2021-09-05;8;36;251385;229563;76.1;69.5
47;2021-09-06;338;1407;251723;230970;76.2;69.9
47;2021-09-07;475;1268;252198;232238;76.3;70.3
47;2021-09-08;417;1621;252615;233859;76.5;70.8
47;2021-09-09;405;1346;253020;235205;76.6;71.2
47;2021-09-10;470;1331;253490;236536;76.7;71.6
47;2021-09-11;434;1429;253924;237965;76.9;72.0
47;2021-09-12;3;7;253927;237972;76.9;72.0
47;2021-09-13;253;953;254180;238925;76.9;72.3
47;2021-09-14;397;1046;254577;239971;77.1;72.6
47;2021-09-15;342;939;254919;240910;77.2;72.9
47;2021-09-16;323;558;255242;241468;77.3;73.1
47;2021-09-17;391;645;255633;242113;77.4;73.3
47;2021-09-18;263;956;255896;243069;77.5;73.6
47;2021-09-19;4;4;255900;243073;77.5;73.6
47;2021-09-20;162;470;256062;243543;77.5;73.7
47;2021-09-21;284;454;256346;243997;77.6;73.9
47;2021-09-22;212;617;256558;244614;77.7;74.1
47;2021-09-23;210;378;256768;244992;77.7;74.2
47;2021-09-24;283;613;257051;245605;77.8;74.4
47;2021-09-25;213;628;257264;246233;77.9;74.5
47;2021-09-26;6;6;257270;246239;77.9;74.5
47;2021-09-27;111;376;257381;246615;77.9;74.7
47;2021-09-28;126;374;257507;246989;78.0;74.8
47;2021-09-29;147;473;257654;247462;78.0;74.9
48;2020-12-27;0;0;0;0;0.0;0.0
48;2020-12-28;0;0;0;0;0.0;0.0
48;2020-12-29;0;0;0;0;0.0;0.0
48;2020-12-30;0;0;0;0;0.0;0.0
48;2020-12-31;0;0;0;0;0.0;0.0
48;2021-01-01;0;0;0;0;0.0;0.0
48;2021-01-02;0;0;0;0;0.0;0.0
48;2021-01-03;0;0;0;0;0.0;0.0
48;2021-01-04;0;0;0;0;0.0;0.0
48;2021-01-05;0;0;0;0;0.0;0.0
48;2021-01-06;0;0;0;0;0.0;0.0
48;2021-01-07;56;0;56;0;0.1;0.0
48;2021-01-08;88;0;144;0;0.2;0.0
48;2021-01-09;1;0;145;0;0.2;0.0
48;2021-01-10;0;0;145;0;0.2;0.0
48;2021-01-11;13;0;158;0;0.2;0.0
48;2021-01-12;19;1;177;1;0.2;0.0
48;2021-01-13;104;0;281;1;0.4;0.0
48;2021-01-14;90;1;371;2;0.5;0.0
48;2021-01-15;63;0;434;2;0.6;0.0
48;2021-01-16;0;0;434;2;0.6;0.0
48;2021-01-17;0;0;434;2;0.6;0.0
48;2021-01-18;117;0;551;2;0.7;0.0
48;2021-01-19;345;2;896;4;1.2;0.0
48;2021-01-20;364;0;1260;4;1.7;0.0
48;2021-01-21;466;1;1726;5;2.3;0.0
48;2021-01-22;269;0;1995;5;2.6;0.0
48;2021-01-23;36;0;2031;5;2.7;0.0
48;2021-01-24;0;0;2031;5;2.7;0.0
48;2021-01-25;109;2;2140;7;2.8;0.0
48;2021-01-26;261;0;2401;7;3.1;0.0
48;2021-01-27;257;1;2658;8;3.5;0.0
48;2021-01-28;273;10;2931;18;3.8;0.0
48;2021-01-29;175;59;3106;77;4.1;0.1
48;2021-01-30;1;7;3107;84;4.1;0.1
48;2021-01-31;0;6;3107;90;4.1;0.1
48;2021-02-01;100;45;3207;135;4.2;0.2
48;2021-02-02;194;32;3401;167;4.5;0.2
48;2021-02-03;177;81;3578;248;4.7;0.3
48;2021-02-04;234;12;3812;260;5.0;0.3
48;2021-02-05;145;33;3957;293;5.2;0.4
48;2021-02-06;34;1;3991;294;5.2;0.4
48;2021-02-07;0;0;3991;294;5.2;0.4
48;2021-02-08;50;57;4041;351;5.3;0.5
48;2021-02-09;66;151;4107;502;5.4;0.7
48;2021-02-10;64;297;4171;799;5.5;1.0
48;2021-02-11;165;379;4336;1178;5.7;1.5
48;2021-02-12;120;143;4456;1321;5.8;1.7
48;2021-02-13;8;54;4464;1375;5.9;1.8
48;2021-02-14;0;0;4464;1375;5.9;1.8
48;2021-02-15;51;84;4515;1459;5.9;1.9
48;2021-02-16;43;132;4558;1591;6.0;2.1
48;2021-02-17;35;267;4593;1858;6.0;2.4
48;2021-02-18;252;91;4845;1949;6.4;2.6
48;2021-02-19;60;149;4905;2098;6.4;2.8
48;2021-02-20;0;1;4905;2099;6.4;2.8
48;2021-02-21;0;14;4905;2113;6.4;2.8
48;2021-02-22;24;85;4929;2198;6.5;2.9
48;2021-02-23;74;199;5003;2397;6.6;3.1
48;2021-02-24;68;238;5071;2635;6.6;3.5
48;2021-02-25;148;212;5219;2847;6.8;3.7
48;2021-02-26;51;185;5270;3032;6.9;4.0
48;2021-02-27;28;1;5298;3033;6.9;4.0
48;2021-02-28;3;14;5301;3047;6.9;4.0
48;2021-03-01;102;77;5403;3124;7.1;4.1
48;2021-03-02;199;71;5602;3195;7.3;4.2
48;2021-03-03;153;94;5755;3289;7.5;4.3
48;2021-03-04;194;171;5949;3460;7.8;4.5
48;2021-03-05;136;122;6085;3582;8.0;4.7
48;2021-03-06;180;52;6265;3634;8.2;4.8
48;2021-03-07;75;2;6340;3636;8.3;4.8
48;2021-03-08;352;120;6692;3756;8.8;4.9
48;2021-03-09;377;92;7069;3848;9.3;5.0
48;2021-03-10;263;57;7332;3905;9.6;5.1
48;2021-03-11;334;82;7666;3987;10.0;5.2
48;2021-03-12;255;138;7921;4125;10.4;5.4
48;2021-03-13;301;5;8222;4130;10.8;5.4
48;2021-03-14;8;0;8230;4130;10.8;5.4
48;2021-03-15;174;55;8404;4185;11.0;5.5
48;2021-03-16;167;65;8571;4250;11.2;5.6
48;2021-03-17;156;110;8727;4360;11.4;5.7
48;2021-03-18;190;104;8917;4464;11.7;5.9
48;2021-03-19;116;95;9033;4559;11.8;6.0
48;2021-03-20;101;0;9134;4559;12.0;6.0
48;2021-03-21;0;0;9134;4559;12.0;6.0
48;2021-03-22;160;18;9294;4577;12.2;6.0
48;2021-03-23;329;100;9623;4677;12.6;6.1
48;2021-03-24;284;100;9907;4777;13.0;6.3
48;2021-03-25;757;117;10664;4894;14.0;6.4
48;2021-03-26;269;59;10933;4953;14.3;6.5
48;2021-03-27;104;1;11037;4954;14.5;6.5
48;2021-03-28;80;20;11117;4974;14.6;6.5
48;2021-03-29;305;78;11422;5052;15.0;6.6
48;2021-03-30;364;131;11786;5183;15.4;6.8
48;2021-03-31;448;85;12234;5268;16.0;6.9
48;2021-04-01;730;73;12964;5341;17.0;7.0
48;2021-04-02;487;134;13451;5475;17.6;7.2
48;2021-04-03;140;83;13591;5558;17.8;7.3
48;2021-04-04;0;0;13591;5558;17.8;7.3
48;2021-04-05;43;1;13634;5559;17.9;7.3
48;2021-04-06;465;160;14099;5719;18.5;7.5
48;2021-04-07;465;141;14564;5860;19.1;7.7
48;2021-04-08;620;188;15184;6048;19.9;7.9
48;2021-04-09;446;122;15630;6170;20.5;8.1
48;2021-04-10;95;60;15725;6230;20.6;8.2
48;2021-04-11;2;0;15727;6230;20.6;8.2
48;2021-04-12;364;71;16091;6301;21.1;8.3
48;2021-04-13;361;92;16452;6393;21.6;8.4
48;2021-04-14;623;187;17075;6580;22.4;8.6
48;2021-04-15;701;358;17776;6938;23.3;9.1
48;2021-04-16;538;225;18314;7163;24.0;9.4
48;2021-04-17;89;71;18403;7234;24.1;9.5
48;2021-04-18;0;0;18403;7234;24.1;9.5
48;2021-04-19;196;105;18599;7339;24.4;9.6
48;2021-04-20;216;180;18815;7519;24.7;9.9
48;2021-04-21;284;207;19099;7726;25.0;10.1
48;2021-04-22;306;480;19405;8206;25.4;10.8
48;2021-04-23;255;242;19660;8448;25.8;11.1
48;2021-04-24;97;95;19757;8543;25.9;11.2
48;2021-04-25;1;9;19758;8552;25.9;11.2
48;2021-04-26;87;210;19845;8762;26.0;11.5
48;2021-04-27;172;292;20017;9054;26.2;11.9
48;2021-04-28;149;415;20166;9469;26.4;12.4
48;2021-04-29;204;488;20370;9957;26.7;13.1
48;2021-04-30;172;223;20542;10180;26.9;13.3
48;2021-05-01;0;0;20542;10180;26.9;13.3
48;2021-05-02;0;0;20542;10180;26.9;13.3
48;2021-05-03;106;386;20648;10566;27.1;13.9
48;2021-05-04;227;420;20875;10986;27.4;14.4
48;2021-05-05;84;486;20959;11472;27.5;15.0
48;2021-05-06;775;640;21734;12112;28.5;15.9
48;2021-05-07;96;503;21830;12615;28.6;16.5
48;2021-05-08;309;43;22139;12658;29.0;16.6
48;2021-05-09;285;9;22424;12667;29.4;16.6
48;2021-05-10;55;325;22479;12992;29.5;17.0
48;2021-05-11;221;289;22700;13281;29.8;17.4
48;2021-05-12;249;313;22949;13594;30.1;17.8
48;2021-05-13;472;157;23421;13751;30.7;18.0
48;2021-05-14;244;222;23665;13973;31.0;18.3
48;2021-05-15;84;46;23749;14019;31.1;18.4
48;2021-05-16;1;6;23750;14025;31.1;18.4
48;2021-05-17;474;267;24224;14292;31.8;18.7
48;2021-05-18;263;229;24487;14521;32.1;19.0
48;2021-05-19;207;277;24694;14798;32.4;19.4
48;2021-05-20;318;256;25012;15054;32.8;19.7
48;2021-05-21;174;267;25186;15321;33.0;20.1
48;2021-05-22;25;50;25211;15371;33.0;20.1
48;2021-05-23;0;6;25211;15377;33.0;20.2
48;2021-05-24;0;14;25211;15391;33.0;20.2
48;2021-05-25;181;265;25392;15656;33.3;20.5
48;2021-05-26;416;298;25808;15954;33.8;20.9
48;2021-05-27;1178;380;26986;16334;35.4;21.4
48;2021-05-28;315;350;27301;16684;35.8;21.9
48;2021-05-29;79;50;27380;16734;35.9;21.9
48;2021-05-30;0;1;27380;16735;35.9;21.9
48;2021-05-31;624;263;28004;16998;36.7;22.3
48;2021-06-01;272;305;28276;17303;37.1;22.7
48;2021-06-02;407;424;28683;17727;37.6;23.2
48;2021-06-03;629;431;29312;18158;38.4;23.8
48;2021-06-04;291;283;29603;18441;38.8;24.2
48;2021-06-05;121;77;29724;18518;39.0;24.3
48;2021-06-06;1;1;29725;18519;39.0;24.3
48;2021-06-07;440;161;30165;18680;39.5;24.5
48;2021-06-08;615;309;30780;18989;40.3;24.9
48;2021-06-09;379;190;31159;19179;40.8;25.1
48;2021-06-10;1003;242;32162;19421;42.2;25.5
48;2021-06-11;371;161;32533;19582;42.6;25.7
48;2021-06-12;74;57;32607;19639;42.7;25.7
48;2021-06-13;0;2;32607;19641;42.7;25.7
48;2021-06-14;124;115;32731;19756;42.9;25.9
48;2021-06-15;407;386;33138;20142;43.4;26.4
48;2021-06-16;260;144;33398;20286;43.8;26.6
48;2021-06-17;486;575;33884;20861;44.4;27.3
48;2021-06-18;254;314;34138;21175;44.8;27.8
48;2021-06-19;35;291;34173;21466;44.8;28.1
48;2021-06-20;123;224;34296;21690;45.0;28.4
48;2021-06-21;125;134;34421;21824;45.1;28.6
48;2021-06-22;258;335;34679;22159;45.5;29.0
48;2021-06-23;111;545;34790;22704;45.6;29.8
48;2021-06-24;364;610;35154;23314;46.1;30.6
48;2021-06-25;154;276;35308;23590;46.3;30.9
48;2021-06-26;15;45;35323;23635;46.3;31.0
48;2021-06-27;1;1;35324;23636;46.3;31.0
48;2021-06-28;81;177;35405;23813;46.4;31.2
48;2021-06-29;297;415;35702;24228;46.8;31.8
48;2021-06-30;98;465;35800;24693;46.9;32.4
48;2021-07-01;194;669;35994;25362;47.2;33.2
48;2021-07-02;148;369;36142;25731;47.4;33.7
48;2021-07-03;42;89;36184;25820;47.4;33.8
48;2021-07-04;7;0;36191;25820;47.4;33.8
48;2021-07-05;40;117;36231;25937;47.5;34.0
48;2021-07-06;277;598;36508;26535;47.9;34.8
48;2021-07-07;201;489;36709;27024;48.1;35.4
48;2021-07-08;223;1189;36932;28213;48.4;37.0
48;2021-07-09;159;553;37091;28766;48.6;37.7
48;2021-07-10;95;147;37186;28913;48.7;37.9
48;2021-07-11;0;4;37186;28917;48.7;37.9
48;2021-07-12;139;672;37325;29589;48.9;38.8
48;2021-07-13;211;430;37536;30019;49.2;39.4
48;2021-07-14;179;145;37715;30164;49.4;39.5
48;2021-07-15;187;459;37902;30623;49.7;40.1
48;2021-07-16;234;314;38136;30937;50.0;40.6
48;2021-07-17;129;118;38265;31055;50.2;40.7
48;2021-07-18;4;5;38269;31060;50.2;40.7
48;2021-07-19;105;306;38374;31366;50.3;41.1
48;2021-07-20;678;993;39052;32359;51.2;42.4
48;2021-07-21;69;371;39121;32730;51.3;42.9
48;2021-07-22;777;1125;39898;33855;52.3;44.4
48;2021-07-23;367;437;40265;34292;52.8;45.0
48;2021-07-24;509;170;40774;34462;53.4;45.2
48;2021-07-25;138;46;40912;34508;53.6;45.2
48;2021-07-26;101;199;41013;34707;53.8;45.5
48;2021-07-27;1195;644;42208;35351;55.3;46.3
48;2021-07-28;177;316;42385;35667;55.6;46.8
48;2021-07-29;716;646;43101;36313;56.5;47.6
48;2021-07-30;200;292;43301;36605;56.8;48.0
48;2021-07-31;339;178;43640;36783;57.2;48.2
48;2021-08-01;18;55;43658;36838;57.2;48.3
48;2021-08-02;228;164;43886;37002;57.5;48.5
48;2021-08-03;925;575;44811;37577;58.7;49.3
48;2021-08-04;328;220;45139;37797;59.2;49.5
48;2021-08-05;674;473;45813;38270;60.1;50.2
48;2021-08-06;442;275;46255;38545;60.6;50.5
48;2021-08-07;249;125;46504;38670;61.0;50.7
48;2021-08-08;2;5;46506;38675;61.0;50.7
48;2021-08-09;170;141;46676;38816;61.2;50.9
48;2021-08-10;726;555;47402;39371;62.1;51.6
48;2021-08-11;295;238;47697;39609;62.5;51.9
48;2021-08-12;419;414;48116;40023;63.1;52.5
48;2021-08-13;229;212;48345;40235;63.4;52.7
48;2021-08-14;137;165;48482;40400;63.6;53.0
48;2021-08-15;131;81;48613;40481;63.7;53.1
48;2021-08-16;121;192;48734;40673;63.9;53.3
48;2021-08-17;364;1188;49098;41861;64.4;54.9
48;2021-08-18;211;201;49309;42062;64.6;55.1
48;2021-08-19;240;325;49549;42387;65.0;55.6
48;2021-08-20;215;284;49764;42671;65.2;55.9
48;2021-08-21;85;232;49849;42903;65.3;56.2
48;2021-08-22;0;0;49849;42903;65.3;56.2
48;2021-08-23;65;153;49914;43056;65.4;56.4
48;2021-08-24;308;952;50222;44008;65.8;57.7
48;2021-08-25;156;351;50378;44359;66.0;58.1
48;2021-08-26;180;499;50558;44858;66.3;58.8
48;2021-08-27;153;337;50711;45195;66.5;59.2
48;2021-08-28;127;303;50838;45498;66.6;59.6
48;2021-08-29;0;1;50838;45499;66.6;59.6
48;2021-08-30;54;146;50892;45645;66.7;59.8
48;2021-08-31;257;1071;51149;46716;67.0;61.2
48;2021-09-01;125;347;51274;47063;67.2;61.7
48;2021-09-02;131;405;51405;47468;67.4;62.2
48;2021-09-03;138;328;51543;47796;67.6;62.7
48;2021-09-04;121;244;51664;48040;67.7;63.0
48;2021-09-05;3;26;51667;48066;67.7;63.0
48;2021-09-06;34;190;51701;48256;67.8;63.3
48;2021-09-07;159;392;51860;48648;68.0;63.8
48;2021-09-08;96;225;51956;48873;68.1;64.1
48;2021-09-09;95;303;52051;49176;68.2;64.5
48;2021-09-10;128;401;52179;49577;68.4;65.0
48;2021-09-11;89;220;52268;49797;68.5;65.3
48;2021-09-12;1;3;52269;49800;68.5;65.3
48;2021-09-13;78;153;52347;49953;68.6;65.5
48;2021-09-14;202;384;52549;50337;68.9;66.0
48;2021-09-15;68;164;52617;50501;69.0;66.2
48;2021-09-16;121;219;52738;50720;69.1;66.5
48;2021-09-17;101;182;52839;50902;69.3;66.7
48;2021-09-18;31;90;52870;50992;69.3;66.8
48;2021-09-19;0;0;52870;50992;69.3;66.8
48;2021-09-20;28;87;52898;51079;69.3;67.0
48;2021-09-21;63;183;52961;51262;69.4;67.2
48;2021-09-22;49;151;53010;51413;69.5;67.4
48;2021-09-23;28;100;53038;51513;69.5;67.5
48;2021-09-24;43;118;53081;51631;69.6;67.7
48;2021-09-25;27;78;53108;51709;69.6;67.8
48;2021-09-26;1;0;53109;51709;69.6;67.8
48;2021-09-27;10;43;53119;51752;69.6;67.8
48;2021-09-28;65;155;53184;51907;69.7;68.0
48;2021-09-29;51;133;53235;52040;69.8;68.2
49;2020-12-27;0;0;0;0;0.0;0.0
49;2020-12-28;2;0;2;0;0.0;0.0
49;2020-12-29;0;0;2;0;0.0;0.0
49;2020-12-30;0;0;2;0;0.0;0.0
49;2020-12-31;0;0;2;0;0.0;0.0
49;2021-01-01;2;0;4;0;0.0;0.0
49;2021-01-02;1;1;5;1;0.0;0.0
49;2021-01-03;0;0;5;1;0.0;0.0
49;2021-01-04;10;0;15;1;0.0;0.0
49;2021-01-05;92;0;107;1;0.0;0.0
49;2021-01-06;232;0;339;1;0.0;0.0
49;2021-01-07;367;0;706;1;0.1;0.0
49;2021-01-08;328;1;1034;2;0.1;0.0
49;2021-01-09;118;0;1152;2;0.1;0.0
49;2021-01-10;114;0;1266;2;0.2;0.0
49;2021-01-11;287;0;1553;2;0.2;0.0
49;2021-01-12;623;0;2176;2;0.3;0.0
49;2021-01-13;602;2;2778;4;0.3;0.0
49;2021-01-14;590;5;3368;9;0.4;0.0
49;2021-01-15;775;1;4143;10;0.5;0.0
49;2021-01-16;148;0;4291;10;0.5;0.0
49;2021-01-17;111;2;4402;12;0.5;0.0
49;2021-01-18;691;0;5093;12;0.6;0.0
49;2021-01-19;1204;2;6297;14;0.8;0.0
49;2021-01-20;1512;3;7809;17;1.0;0.0
49;2021-01-21;1943;4;9752;21;1.2;0.0
49;2021-01-22;1319;5;11071;26;1.4;0.0
49;2021-01-23;263;0;11334;26;1.4;0.0
49;2021-01-24;1;0;11335;26;1.4;0.0
49;2021-01-25;552;3;11887;29;1.5;0.0
49;2021-01-26;988;74;12875;103;1.6;0.0
49;2021-01-27;1860;35;14735;138;1.8;0.0
49;2021-01-28;2877;75;17612;213;2.2;0.0
49;2021-01-29;1589;83;19201;296;2.4;0.0
49;2021-01-30;300;41;19501;337;2.4;0.0
49;2021-01-31;62;45;19563;382;2.4;0.0
49;2021-02-01;661;148;20224;530;2.5;0.1
49;2021-02-02;743;360;20967;890;2.6;0.1
49;2021-02-03;677;310;21644;1200;2.7;0.1
49;2021-02-04;757;408;22401;1608;2.7;0.2
49;2021-02-05;708;533;23109;2141;2.8;0.3
49;2021-02-06;228;101;23337;2242;2.9;0.3
49;2021-02-07;59;68;23396;2310;2.9;0.3
49;2021-02-08;549;414;23945;2724;2.9;0.3
49;2021-02-09;716;543;24661;3267;3.0;0.4
49;2021-02-10;807;793;25468;4060;3.1;0.5
49;2021-02-11;1028;1311;26496;5371;3.2;0.7
49;2021-02-12;870;895;27366;6266;3.4;0.8
49;2021-02-13;266;99;27632;6365;3.4;0.8
49;2021-02-14;9;90;27641;6455;3.4;0.8
49;2021-02-15;730;590;28371;7045;3.5;0.9
49;2021-02-16;1106;1041;29477;8086;3.6;1.0
49;2021-02-17;1160;1723;30637;9809;3.8;1.2
49;2021-02-18;1811;2344;32448;12153;4.0;1.5
49;2021-02-19;1397;1043;33845;13196;4.1;1.6
49;2021-02-20;232;330;34077;13526;4.2;1.7
49;2021-02-21;0;64;34077;13590;4.2;1.7
49;2021-02-22;647;467;34724;14057;4.3;1.7
49;2021-02-23;734;736;35458;14793;4.3;1.8
49;2021-02-24;824;525;36282;15318;4.4;1.9
49;2021-02-25;1208;674;37490;15992;4.6;2.0
49;2021-02-26;1678;723;39168;16715;4.8;2.0
49;2021-02-27;435;224;39603;16939;4.9;2.1
49;2021-02-28;49;30;39652;16969;4.9;2.1
49;2021-03-01;768;494;40420;17463;5.0;2.1
49;2021-03-02;1082;603;41502;18066;5.1;2.2
49;2021-03-03;1559;598;43061;18664;5.3;2.3
49;2021-03-04;1769;838;44830;19502;5.5;2.4
49;2021-03-05;2214;620;47044;20122;5.8;2.5
49;2021-03-06;717;160;47761;20282;5.9;2.5
49;2021-03-07;627;13;48388;20295;5.9;2.5
49;2021-03-08;1397;657;49785;20952;6.1;2.6
49;2021-03-09;2052;685;51837;21637;6.4;2.7
49;2021-03-10;2530;837;54367;22474;6.7;2.8
49;2021-03-11;3195;1431;57562;23905;7.1;2.9
49;2021-03-12;3766;977;61328;24882;7.5;3.0
49;2021-03-13;1501;198;62829;25080;7.7;3.1
49;2021-03-14;6;0;62835;25080;7.7;3.1
49;2021-03-15;2084;525;64919;25605;8.0;3.1
49;2021-03-16;1733;955;66652;26560;8.2;3.3
49;2021-03-17;1811;674;68463;27234;8.4;3.3
49;2021-03-18;2205;720;70668;27954;8.7;3.4
49;2021-03-19;3333;558;74001;28512;9.1;3.5
49;2021-03-20;1743;204;75744;28716;9.3;3.5
49;2021-03-21;499;22;76243;28738;9.3;3.5
49;2021-03-22;2248;542;78491;29280;9.6;3.6
49;2021-03-23;3406;675;81897;29955;10.0;3.7
49;2021-03-24;3603;497;85500;30452;10.5;3.7
49;2021-03-25;4225;651;89725;31103;11.0;3.8
49;2021-03-26;4886;502;94611;31605;11.6;3.9
49;2021-03-27;1675;99;96286;31704;11.8;3.9
49;2021-03-28;400;28;96686;31732;11.9;3.9
49;2021-03-29;2371;605;99057;32337;12.1;4.0
49;2021-03-30;3267;938;102324;33275;12.5;4.1
49;2021-03-31;2980;748;105304;34023;12.9;4.2
49;2021-04-01;4118;869;109422;34892;13.4;4.3
49;2021-04-02;4297;954;113719;35846;13.9;4.4
49;2021-04-03;971;193;114690;36039;14.1;4.4
49;2021-04-04;315;3;115005;36042;14.1;4.4
49;2021-04-05;944;22;115949;36064;14.2;4.4
49;2021-04-06;2330;1318;118279;37382;14.5;4.6
49;2021-04-07;3308;1364;121587;38746;14.9;4.7
49;2021-04-08;5184;1423;126771;40169;15.5;4.9
49;2021-04-09;6207;1440;132978;41609;16.3;5.1
49;2021-04-10;2065;500;135043;42109;16.6;5.2
49;2021-04-11;390;9;135433;42118;16.6;5.2
49;2021-04-12;4073;1575;139506;43693;17.1;5.4
49;2021-04-13;5380;1914;144886;45607;17.8;5.6
49;2021-04-14;4542;1877;149428;47484;18.3;5.8
49;2021-04-15;5381;1880;154809;49364;19.0;6.1
49;2021-04-16;5761;2137;160570;51501;19.7;6.3
49;2021-04-17;3335;852;163905;52353;20.1;6.4
49;2021-04-18;381;476;164286;52829;20.1;6.5
49;2021-04-19;3710;2057;167996;54886;20.6;6.7
49;2021-04-20;4371;2111;172367;56997;21.1;7.0
49;2021-04-21;3955;2203;176322;59200;21.6;7.3
49;2021-04-22;4836;2111;181158;61311;22.2;7.5
49;2021-04-23;4814;2335;185972;63646;22.8;7.8
49;2021-04-24;2938;1154;188910;64800;23.2;7.9
49;2021-04-25;40;282;188950;65082;23.2;8.0
49;2021-04-26;3744;2109;192694;67191;23.6;8.2
49;2021-04-27;4472;2497;197166;69688;24.2;8.5
49;2021-04-28;4616;2498;201782;72186;24.7;8.8
49;2021-04-29;5206;3014;206988;75200;25.4;9.2
49;2021-04-30;5558;3193;212546;78393;26.1;9.6
49;2021-05-01;2364;665;214910;79058;26.3;9.7
49;2021-05-02;5;40;214915;79098;26.3;9.7
49;2021-05-03;5012;2408;219927;81506;27.0;10.0
49;2021-05-04;4972;3036;224899;84542;27.6;10.4
49;2021-05-05;4789;3005;229688;87547;28.2;10.7
49;2021-05-06;5328;3094;235016;90641;28.8;11.1
49;2021-05-07;4281;5008;239297;95649;29.3;11.7
49;2021-05-08;3577;438;242874;96087;29.8;11.8
49;2021-05-09;10;41;242884;96128;29.8;11.8
49;2021-05-10;4829;4269;247713;100397;30.4;12.3
49;2021-05-11;5397;5083;253110;105480;31.0;12.9
49;2021-05-12;4800;4590;257910;110070;31.6;13.5
49;2021-05-13;4778;691;262688;110761;32.2;13.6
49;2021-05-14;5170;3268;267858;114029;32.8;14.0
49;2021-05-15;4157;1806;272015;115835;33.3;14.2
49;2021-05-16;2786;117;274801;115952;33.7;14.2
49;2021-05-17;4834;3682;279635;119634;34.3;14.7
49;2021-05-18;5472;3767;285107;123401;34.9;15.1
49;2021-05-19;5916;3229;291023;126630;35.7;15.5
49;2021-05-20;6807;2966;297830;129596;36.5;15.9
49;2021-05-21;6450;3744;304280;133340;37.3;16.3
49;2021-05-22;5183;1193;309463;134533;37.9;16.5
49;2021-05-23;1;12;309464;134545;37.9;16.5
49;2021-05-24;4212;448;313676;134993;38.4;16.5
49;2021-05-25;6326;3294;320002;138287;39.2;16.9
49;2021-05-26;6273;2664;326275;140951;40.0;17.3
49;2021-05-27;7113;2723;333388;143674;40.9;17.6
49;2021-05-28;6875;4005;340263;147679;41.7;18.1
49;2021-05-29;5023;1894;345286;149573;42.3;18.3
49;2021-05-30;21;14;345307;149587;42.3;18.3
49;2021-05-31;6036;3216;351343;152803;43.1;18.7
49;2021-06-01;6592;3979;357935;156782;43.9;19.2
49;2021-06-02;5794;3737;363729;160519;44.6;19.7
49;2021-06-03;6603;3416;370332;163935;45.4;20.1
49;2021-06-04;6470;4861;376802;168796;46.2;20.7
49;2021-06-05;4384;2694;381186;171490;46.7;21.0
49;2021-06-06;38;48;381224;171538;46.7;21.0
49;2021-06-07;4634;4759;385858;176297;47.3;21.6
49;2021-06-08;5185;5103;391043;181400;47.9;22.2
49;2021-06-09;5325;4504;396368;185904;48.6;22.8
49;2021-06-10;6005;3781;402373;189685;49.3;23.2
49;2021-06-11;4873;6030;407246;195715;49.9;24.0
49;2021-06-12;4097;3200;411343;198915;50.4;24.4
49;2021-06-13;20;989;411363;199904;50.4;24.5
49;2021-06-14;3411;6015;414774;205919;50.8;25.2
49;2021-06-15;4241;6392;419015;212311;51.4;26.0
49;2021-06-16;4150;5677;423165;217988;51.9;26.7
49;2021-06-17;5069;5076;428234;223064;52.5;27.3
49;2021-06-18;4134;6885;432368;229949;53.0;28.2
49;2021-06-19;3525;3971;435893;233920;53.4;28.7
49;2021-06-20;33;25;435926;233945;53.4;28.7
49;2021-06-21;2828;6509;438754;240454;53.8;29.5
49;2021-06-22;3208;7004;441962;247458;54.2;30.3
49;2021-06-23;3253;6311;445215;253769;54.6;31.1
49;2021-06-24;4316;4975;449531;258744;55.1;31.7
49;2021-06-25;3325;7447;452856;266191;55.5;32.6
49;2021-06-26;2570;4625;455426;270816;55.8;33.2
49;2021-06-27;15;1544;455441;272360;55.8;33.4
49;2021-06-28;2234;7182;457675;279542;56.1;34.3
49;2021-06-29;3028;7270;460703;286812;56.5;35.2
49;2021-06-30;2824;6803;463527;293615;56.8;36.0
49;2021-07-01;3393;6272;466920;299887;57.2;36.8
49;2021-07-02;3065;8067;469985;307954;57.6;37.7
49;2021-07-03;2007;5486;471992;313440;57.9;38.4
49;2021-07-04;7;53;471999;313493;57.9;38.4
49;2021-07-05;1738;7078;473737;320571;58.1;39.3
49;2021-07-06;1894;7550;475631;328121;58.3;40.2
49;2021-07-07;2099;6622;477730;334743;58.6;41.0
49;2021-07-08;2689;6357;480419;341100;58.9;41.8
49;2021-07-09;2361;8246;482780;349346;59.2;42.8
49;2021-07-10;1802;5344;484582;354690;59.4;43.5
49;2021-07-11;12;35;484594;354725;59.4;43.5
49;2021-07-12;1947;7713;486541;362438;59.6;44.4
49;2021-07-13;2572;8300;489113;370738;59.9;45.4
49;2021-07-14;2893;3373;492006;374111;60.3;45.9
49;2021-07-15;3165;7552;495171;381663;60.7;46.8
49;2021-07-16;3396;8293;498567;389956;61.1;47.8
49;2021-07-17;2103;5479;500670;395435;61.4;48.5
49;2021-07-18;3751;583;504421;396018;61.8;48.5
49;2021-07-19;2666;7450;507087;403468;62.2;49.5
49;2021-07-20;3588;7481;510675;410949;62.6;50.4
49;2021-07-21;4227;6462;514902;417411;63.1;51.2
49;2021-07-22;4815;5865;519717;423276;63.7;51.9
49;2021-07-23;5111;6624;524828;429900;64.3;52.7
49;2021-07-24;3690;5002;528518;434902;64.8;53.3
49;2021-07-25;67;33;528585;434935;64.8;53.3
49;2021-07-26;4517;5901;533102;440836;65.3;54.0
49;2021-07-27;5753;5442;538855;446278;66.0;54.7
49;2021-07-28;6019;4360;544874;450638;66.8;55.2
49;2021-07-29;6702;4154;551576;454792;67.6;55.7
49;2021-07-30;6173;4788;557749;459580;68.4;56.3
49;2021-07-31;3958;3421;561707;463001;68.8;56.7
49;2021-08-01;21;22;561728;463023;68.8;56.8
49;2021-08-02;4271;4657;565999;467680;69.4;57.3
49;2021-08-03;5434;3801;571433;471481;70.0;57.8
49;2021-08-04;5276;3718;576709;475199;70.7;58.2
49;2021-08-05;5307;3289;582016;478488;71.3;58.6
49;2021-08-06;5718;4282;587734;482770;72.0;59.2
49;2021-08-07;3924;3044;591658;485814;72.5;59.5
49;2021-08-08;24;36;591682;485850;72.5;59.5
49;2021-08-09;3501;4682;595183;490532;72.9;60.1
49;2021-08-10;4250;3900;599433;494432;73.5;60.6
49;2021-08-11;4006;3650;603439;498082;74.0;61.0
49;2021-08-12;2665;3055;606104;501137;74.3;61.4
49;2021-08-13;3926;4271;610030;505408;74.8;61.9
49;2021-08-14;2279;3149;612309;508557;75.0;62.3
49;2021-08-15;30;26;612339;508583;75.1;62.3
49;2021-08-16;2831;5061;615170;513644;75.4;63.0
49;2021-08-17;3281;4911;618451;518555;75.8;63.6
49;2021-08-18;2977;4114;621428;522669;76.2;64.1
49;2021-08-19;1548;3663;622976;526332;76.4;64.5
49;2021-08-20;2731;5771;625707;532103;76.7;65.2
49;2021-08-21;1399;4150;627106;536253;76.9;65.7
49;2021-08-22;6;41;627112;536294;76.9;65.7
49;2021-08-23;2257;5627;629369;541921;77.1;66.4
49;2021-08-24;2746;5786;632115;547707;77.5;67.1
49;2021-08-25;2330;5430;634445;553137;77.8;67.8
49;2021-08-26;1714;4827;636159;557964;78.0;68.4
49;2021-08-27;2455;6813;638614;564777;78.3;69.2
49;2021-08-28;906;4303;639520;569080;78.4;69.8
49;2021-08-29;5;94;639525;569174;78.4;69.8
49;2021-08-30;1155;4295;640680;573469;78.5;70.3
49;2021-08-31;2247;6000;642927;579469;78.8;71.0
49;2021-09-01;1683;4452;644610;583921;79.0;71.6
49;2021-09-02;1062;2807;645672;586728;79.1;71.9
49;2021-09-03;1460;4187;647132;590915;79.3;72.4
49;2021-09-04;1208;3571;648340;594486;79.5;72.9
49;2021-09-05;4;9;648344;594495;79.5;72.9
49;2021-09-06;1098;2945;649442;597440;79.6;73.2
49;2021-09-07;1189;2886;650631;600326;79.7;73.6
49;2021-09-08;982;3322;651613;603648;79.9;74.0
49;2021-09-09;769;1776;652382;605424;80.0;74.2
49;2021-09-10;970;3069;653352;608493;80.1;74.6
49;2021-09-11;723;2643;654075;611136;80.2;74.9
49;2021-09-12;11;8;654086;611144;80.2;74.9
49;2021-09-13;741;2542;654827;613686;80.3;75.2
49;2021-09-14;638;2303;655465;615989;80.3;75.5
49;2021-09-15;618;2226;656083;618215;80.4;75.8
49;2021-09-16;522;1287;656605;619502;80.5;75.9
49;2021-09-17;929;2516;657534;622018;80.6;76.2
49;2021-09-18;542;2005;658076;624023;80.7;76.5
49;2021-09-19;2;8;658078;624031;80.7;76.5
49;2021-09-20;512;1245;658590;625276;80.7;76.6
49;2021-09-21;432;1598;659022;626874;80.8;76.8
49;2021-09-22;336;1993;659358;628867;80.8;77.1
49;2021-09-23;323;1160;659681;630027;80.9;77.2
49;2021-09-24;565;2241;660246;632268;80.9;77.5
49;2021-09-25;197;1013;660443;633281;80.9;77.6
49;2021-09-26;0;0;660443;633281;80.9;77.6
49;2021-09-27;384;1374;660827;634655;81.0;77.8
49;2021-09-28;402;1062;661229;635717;81.0;77.9
49;2021-09-29;376;1240;661605;636957;81.1;78.1
50;2020-12-27;0;0;0;0;0.0;0.0
50;2020-12-28;0;0;0;0;0.0;0.0
50;2020-12-29;1;0;1;0;0.0;0.0
50;2020-12-30;0;0;1;0;0.0;0.0
50;2020-12-31;0;0;1;0;0.0;0.0
50;2021-01-01;0;0;1;0;0.0;0.0
50;2021-01-02;0;0;1;0;0.0;0.0
50;2021-01-03;0;0;1;0;0.0;0.0
50;2021-01-04;1;0;2;0;0.0;0.0
50;2021-01-05;0;0;2;0;0.0;0.0
50;2021-01-06;126;0;128;0;0.0;0.0
50;2021-01-07;324;0;452;0;0.1;0.0
50;2021-01-08;436;2;888;2;0.2;0.0
50;2021-01-09;236;0;1124;2;0.2;0.0
50;2021-01-10;23;0;1147;2;0.2;0.0
50;2021-01-11;391;1;1538;3;0.3;0.0
50;2021-01-12;599;0;2137;3;0.4;0.0
50;2021-01-13;695;5;2832;8;0.6;0.0
50;2021-01-14;1051;11;3883;19;0.8;0.0
50;2021-01-15;710;3;4593;22;0.9;0.0
50;2021-01-16;215;3;4808;25;1.0;0.0
50;2021-01-17;1;0;4809;25;1.0;0.0
50;2021-01-18;620;1;5429;26;1.1;0.0
50;2021-01-19;901;3;6330;29;1.3;0.0
50;2021-01-20;964;0;7294;29;1.5;0.0
50;2021-01-21;917;4;8211;33;1.7;0.0
50;2021-01-22;716;2;8927;35;1.8;0.0
50;2021-01-23;668;4;9595;39;2.0;0.0
50;2021-01-24;881;3;10476;42;2.1;0.0
50;2021-01-25;2709;8;13185;50;2.7;0.0
50;2021-01-26;1336;14;14521;64;3.0;0.0
50;2021-01-27;768;56;15289;120;3.1;0.0
50;2021-01-28;716;161;16005;281;3.3;0.1
50;2021-01-29;581;290;16586;571;3.4;0.1
50;2021-01-30;381;137;16967;708;3.5;0.1
50;2021-01-31;0;0;16967;708;3.5;0.1
50;2021-02-01;451;209;17418;917;3.5;0.2
50;2021-02-02;417;224;17835;1141;3.6;0.2
50;2021-02-03;391;366;18226;1507;3.7;0.3
50;2021-02-04;486;421;18712;1928;3.8;0.4
50;2021-02-05;424;425;19136;2353;3.9;0.5
50;2021-02-06;179;104;19315;2457;3.9;0.5
50;2021-02-07;0;0;19315;2457;3.9;0.5
50;2021-02-08;254;432;19569;2889;4.0;0.6
50;2021-02-09;246;548;19815;3437;4.0;0.7
50;2021-02-10;571;469;20386;3906;4.2;0.8
50;2021-02-11;436;830;20822;4736;4.2;1.0
50;2021-02-12;329;576;21151;5312;4.3;1.1
50;2021-02-13;306;413;21457;5725;4.4;1.2
50;2021-02-14;185;732;21642;6457;4.4;1.3
50;2021-02-15;664;1774;22306;8231;4.5;1.7
50;2021-02-16;746;1453;23052;9684;4.7;2.0
50;2021-02-17;632;673;23684;10357;4.8;2.1
50;2021-02-18;569;685;24253;11042;4.9;2.3
50;2021-02-19;630;393;24883;11435;5.1;2.3
50;2021-02-20;423;128;25306;11563;5.2;2.4
50;2021-02-21;85;21;25391;11584;5.2;2.4
50;2021-02-22;291;569;25682;12153;5.2;2.5
50;2021-02-23;503;431;26185;12584;5.3;2.6
50;2021-02-24;624;489;26809;13073;5.5;2.7
50;2021-02-25;780;478;27589;13551;5.6;2.8
50;2021-02-26;998;318;28587;13869;5.8;2.8
50;2021-02-27;887;97;29474;13966;6.0;2.8
50;2021-02-28;111;0;29585;13966;6.0;2.8
50;2021-03-01;488;447;30073;14413;6.1;2.9
50;2021-03-02;651;431;30724;14844;6.3;3.0
50;2021-03-03;798;381;31522;15225;6.4;3.1
50;2021-03-04;1247;289;32769;15514;6.7;3.2
50;2021-03-05;1553;296;34322;15810;7.0;3.2
50;2021-03-06;1319;137;35641;15947;7.3;3.3
50;2021-03-07;550;39;36191;15986;7.4;3.3
50;2021-03-08;1025;572;37216;16558;7.6;3.4
50;2021-03-09;1555;543;38771;17101;7.9;3.5
50;2021-03-10;1607;293;40378;17394;8.2;3.5
50;2021-03-11;2352;338;42730;17732;8.7;3.6
50;2021-03-12;2866;239;45596;17971;9.3;3.7
50;2021-03-13;1995;125;47591;18096;9.7;3.7
50;2021-03-14;280;41;47871;18137;9.8;3.7
50;2021-03-15;1378;291;49249;18428;10.0;3.8
50;2021-03-16;1341;275;50590;18703;10.3;3.8
50;2021-03-17;1295;404;51885;19107;10.6;3.9
50;2021-03-18;1162;427;53047;19534;10.8;4.0
50;2021-03-19;1733;575;54780;20109;11.2;4.1
50;2021-03-20;1688;230;56468;20339;11.5;4.1
50;2021-03-21;794;12;57262;20351;11.7;4.1
50;2021-03-22;1508;334;58770;20685;12.0;4.2
50;2021-03-23;2077;399;60847;21084;12.4;4.3
50;2021-03-24;2281;551;63128;21635;12.9;4.4
50;2021-03-25;2812;472;65940;22107;13.4;4.5
50;2021-03-26;3205;470;69145;22577;14.1;4.6
50;2021-03-27;1823;373;70968;22950;14.5;4.7
50;2021-03-28;403;20;71371;22970;14.5;4.7
50;2021-03-29;2139;717;73510;23687;15.0;4.8
50;2021-03-30;2283;640;75793;24327;15.4;5.0
50;2021-03-31;2479;570;78272;24897;16.0;5.1
50;2021-04-01;3104;866;81376;25763;16.6;5.3
50;2021-04-02;2960;928;84336;26691;17.2;5.4
50;2021-04-03;1245;675;85581;27366;17.4;5.6
50;2021-04-04;321;134;85902;27500;17.5;5.6
50;2021-04-05;400;27;86302;27527;17.6;5.6
50;2021-04-06;2127;1222;88429;28749;18.0;5.9
50;2021-04-07;2556;1175;90985;29924;18.5;6.1
50;2021-04-08;3595;1207;94580;31131;19.3;6.3
50;2021-04-09;3936;1300;98516;32431;20.1;6.6
50;2021-04-10;2534;873;101050;33304;20.6;6.8
50;2021-04-11;411;144;101461;33448;20.7;6.8
50;2021-04-12;2438;1377;103899;34825;21.2;7.1
50;2021-04-13;2678;1511;106577;36336;21.7;7.4
50;2021-04-14;2608;1355;109185;37691;22.3;7.7
50;2021-04-15;3161;1115;112346;38806;22.9;7.9
50;2021-04-16;3363;1103;115709;39909;23.6;8.1
50;2021-04-17;2397;1185;118106;41094;24.1;8.4
50;2021-04-18;425;665;118531;41759;24.2;8.5
50;2021-04-19;1997;1469;120528;43228;24.6;8.8
50;2021-04-20;2273;1589;122801;44817;25.0;9.1
50;2021-04-21;2548;1758;125349;46575;25.5;9.5
50;2021-04-22;3077;1825;128426;48400;26.2;9.9
50;2021-04-23;2757;1917;131183;50317;26.7;10.3
50;2021-04-24;1900;1429;133083;51746;27.1;10.5
50;2021-04-25;470;272;133553;52018;27.2;10.6
50;2021-04-26;2119;1878;135672;53896;27.7;11.0
50;2021-04-27;2412;1996;138084;55892;28.1;11.4
50;2021-04-28;2708;1972;140792;57864;28.7;11.8
50;2021-04-29;3286;2041;144078;59905;29.4;12.2
50;2021-04-30;2999;1923;147077;61828;30.0;12.6
50;2021-05-01;1015;596;148092;62424;30.2;12.7
50;2021-05-02;523;448;148615;62872;30.3;12.8
50;2021-05-03;1771;1805;150386;64677;30.6;13.2
50;2021-05-04;1771;2329;152157;67006;31.0;13.7
50;2021-05-05;1659;2952;153816;69958;31.3;14.3
50;2021-05-06;2530;2579;156346;72537;31.9;14.8
50;2021-05-07;2150;2850;158496;75387;32.3;15.4
50;2021-05-08;1170;792;159666;76179;32.5;15.5
50;2021-05-09;624;361;160290;76540;32.7;15.6
50;2021-05-10;1704;2602;161994;79142;33.0;16.1
50;2021-05-11;2542;2836;164536;81978;33.5;16.7
50;2021-05-12;3179;2438;167715;84416;34.2;17.2
50;2021-05-13;3382;613;171097;85029;34.9;17.3
50;2021-05-14;3568;2275;174665;87304;35.6;17.8
50;2021-05-15;4001;1870;178666;89174;36.4;18.2
50;2021-05-16;947;267;179613;89441;36.6;18.2
50;2021-05-17;2140;1877;181753;91318;37.0;18.6
50;2021-05-18;2524;1614;184277;92932;37.6;18.9
50;2021-05-19;2503;1447;186780;94379;38.1;19.2
50;2021-05-20;3261;1625;190041;96004;38.7;19.6
50;2021-05-21;3156;1908;193197;97912;39.4;20.0
50;2021-05-22;2651;1323;195848;99235;39.9;20.2
50;2021-05-23;603;284;196451;99519;40.0;20.3
50;2021-05-24;1527;490;197978;100009;40.3;20.4
50;2021-05-25;2450;1668;200428;101677;40.8;20.7
50;2021-05-26;3002;1458;203430;103135;41.5;21.0
50;2021-05-27;3035;1969;206465;105104;42.1;21.4
50;2021-05-28;2941;2111;209406;107215;42.7;21.9
50;2021-05-29;2760;1402;212166;108617;43.2;22.1
50;2021-05-30;812;327;212978;108944;43.4;22.2
50;2021-05-31;2652;1815;215630;110759;43.9;22.6
50;2021-06-01;3333;2066;218963;112825;44.6;23.0
50;2021-06-02;3259;1782;222222;114607;45.3;23.4
50;2021-06-03;3914;2059;226136;116666;46.1;23.8
50;2021-06-04;3822;2874;229958;119540;46.9;24.4
50;2021-06-05;2958;1837;232916;121377;47.5;24.7
50;2021-06-06;813;442;233729;121819;47.6;24.8
50;2021-06-07;3512;2078;237241;123897;48.4;25.3
50;2021-06-08;4072;2228;241313;126125;49.2;25.7
50;2021-06-09;4253;1987;245566;128112;50.0;26.1
50;2021-06-10;4193;2113;249759;130225;50.9;26.5
50;2021-06-11;4223;2711;253982;132936;51.8;27.1
50;2021-06-12;3738;1613;257720;134549;52.5;27.4
50;2021-06-13;1143;451;258863;135000;52.8;27.5
50;2021-06-14;2693;2967;261556;137967;53.3;28.1
50;2021-06-15;3016;2599;264572;140566;53.9;28.6
50;2021-06-16;3096;1970;267668;142536;54.6;29.0
50;2021-06-17;2798;2484;270466;145020;55.1;29.6
50;2021-06-18;3239;3051;273705;148071;55.8;30.2
50;2021-06-19;3176;1925;276881;149996;56.4;30.6
50;2021-06-20;731;710;277612;150706;56.6;30.7
50;2021-06-21;1819;3129;279431;153835;56.9;31.4
50;2021-06-22;2064;3389;281495;157224;57.4;32.0
50;2021-06-23;1872;3875;283367;161099;57.8;32.8
50;2021-06-24;1711;4007;285078;165106;58.1;33.6
50;2021-06-25;2134;4007;287212;169113;58.5;34.5
50;2021-06-26;2147;3692;289359;172805;59.0;35.2
50;2021-06-27;615;895;289974;173700;59.1;35.4
50;2021-06-28;1927;3349;291901;177049;59.5;36.1
50;2021-06-29;1881;3406;293782;180455;59.9;36.8
50;2021-06-30;2180;3408;295962;183863;60.3;37.5
50;2021-07-01;1944;3282;297906;187145;60.7;38.1
50;2021-07-02;1898;3934;299804;191079;61.1;38.9
50;2021-07-03;1448;3445;301252;194524;61.4;39.6
50;2021-07-04;445;1066;301697;195590;61.5;39.9
50;2021-07-05;1262;3412;302959;199002;61.7;40.6
50;2021-07-06;1573;3896;304532;202898;62.1;41.4
50;2021-07-07;1804;3617;306336;206515;62.4;42.1
50;2021-07-08;1374;4101;307710;210616;62.7;42.9
50;2021-07-09;1394;4570;309104;215186;63.0;43.9
50;2021-07-10;1023;3599;310127;218785;63.2;44.6
50;2021-07-11;373;1018;310500;219803;63.3;44.8
50;2021-07-12;1317;4623;311817;224426;63.5;45.7
50;2021-07-13;1624;4856;313441;229282;63.9;46.7
50;2021-07-14;1476;2358;314917;231640;64.2;47.2
50;2021-07-15;1687;5048;316604;236688;64.5;48.2
50;2021-07-16;2992;5241;319596;241929;65.1;49.3
50;2021-07-17;2149;3732;321745;245661;65.6;50.1
50;2021-07-18;402;1089;322147;246750;65.7;50.3
50;2021-07-19;1571;5185;323718;251935;66.0;51.3
50;2021-07-20;1924;5405;325642;257340;66.4;52.4
50;2021-07-21;1802;5256;327444;262596;66.7;53.5
50;2021-07-22;1947;5002;329391;267598;67.1;54.5
50;2021-07-23;2072;5372;331463;272970;67.6;55.6
50;2021-07-24;1311;3836;332774;276806;67.8;56.4
50;2021-07-25;274;1037;333048;277843;67.9;56.6
50;2021-07-26;2289;3487;335337;281330;68.3;57.3
50;2021-07-27;2899;3346;338236;284676;68.9;58.0
50;2021-07-28;2997;3686;341233;288362;69.5;58.8
50;2021-07-29;3581;3220;344814;291582;70.3;59.4
50;2021-07-30;3075;3005;347889;294587;70.9;60.0
50;2021-07-31;2406;2672;350295;297259;71.4;60.6
50;2021-08-01;484;685;350779;297944;71.5;60.7
50;2021-08-02;2474;2739;353253;300683;72.0;61.3
50;2021-08-03;3404;2470;356657;303153;72.7;61.8
50;2021-08-04;3601;2322;360258;305475;73.4;62.3
50;2021-08-05;3188;2159;363446;307634;74.1;62.7
50;2021-08-06;3656;2800;367102;310434;74.8;63.3
50;2021-08-07;2461;2156;369563;312590;75.3;63.7
50;2021-08-08;511;712;370074;313302;75.4;63.9
50;2021-08-09;2492;2134;372566;315436;75.9;64.3
50;2021-08-10;2987;1989;375553;317425;76.5;64.7
50;2021-08-11;2850;2018;378403;319443;77.1;65.1
50;2021-08-12;2593;2438;380996;321881;77.6;65.6
50;2021-08-13;2504;1979;383500;323860;78.2;66.0
50;2021-08-14;1810;1748;385310;325608;78.5;66.4
50;2021-08-15;399;334;385709;325942;78.6;66.4
50;2021-08-16;1719;2227;387428;328169;79.0;66.9
50;2021-08-17;1972;2703;389400;330872;79.4;67.4
50;2021-08-18;1840;2389;391240;333261;79.7;67.9
50;2021-08-19;1708;2577;392948;335838;80.1;68.4
50;2021-08-20;1617;2738;394565;338576;80.4;69.0
50;2021-08-21;1017;2727;395582;341303;80.6;69.6
50;2021-08-22;384;519;395966;341822;80.7;69.7
50;2021-08-23;1137;2905;397103;344727;80.9;70.3
50;2021-08-24;1247;3222;398350;347949;81.2;70.9
50;2021-08-25;1091;2649;399441;350598;81.4;71.5
50;2021-08-26;864;3156;400305;353754;81.6;72.1
50;2021-08-27;932;3181;401237;356935;81.8;72.7
50;2021-08-28;791;2887;402028;359822;81.9;73.3
50;2021-08-29;283;575;402311;360397;82.0;73.5
50;2021-08-30;775;2948;403086;363345;82.2;74.1
50;2021-08-31;821;3034;403907;366379;82.3;74.7
50;2021-09-01;681;2889;404588;369268;82.5;75.3
50;2021-09-02;502;2541;405090;371809;82.6;75.8
50;2021-09-03;659;2878;405749;374687;82.7;76.4
50;2021-09-04;622;2991;406371;377678;82.8;77.0
50;2021-09-05;194;741;406565;378419;82.9;77.1
50;2021-09-06;379;2192;406944;380611;82.9;77.6
50;2021-09-07;296;1754;407240;382365;83.0;77.9
50;2021-09-08;464;2128;407704;384493;83.1;78.4
50;2021-09-09;379;1493;408083;385986;83.2;78.7
50;2021-09-10;494;2019;408577;388005;83.3;79.1
50;2021-09-11;362;2428;408939;390433;83.3;79.6
50;2021-09-12;71;387;409010;390820;83.4;79.7
50;2021-09-13;409;1386;409419;392206;83.4;79.9
50;2021-09-14;411;1383;409830;393589;83.5;80.2
50;2021-09-15;414;1087;410244;394676;83.6;80.4
50;2021-09-16;461;747;410705;395423;83.7;80.6
50;2021-09-17;456;1030;411161;396453;83.8;80.8
50;2021-09-18;313;1467;411474;397920;83.9;81.1
50;2021-09-19;46;276;411520;398196;83.9;81.2
50;2021-09-20;381;588;411901;398784;83.9;81.3
50;2021-09-21;431;623;412332;399407;84.0;81.4
50;2021-09-22;215;866;412547;400273;84.1;81.6
50;2021-09-23;261;445;412808;400718;84.1;81.7
50;2021-09-24;243;810;413051;401528;84.2;81.8
50;2021-09-25;213;934;413264;402462;84.2;82.0
50;2021-09-26;20;181;413284;402643;84.2;82.1
50;2021-09-27;104;385;413388;403028;84.2;82.1
50;2021-09-28;157;384;413545;403412;84.3;82.2
50;2021-09-29;152;520;413697;403932;84.3;82.3
51;2020-12-27;0;0;0;0;0.0;0.0
51;2020-12-28;0;0;0;0;0.0;0.0
51;2020-12-29;0;0;0;0;0.0;0.0
51;2020-12-30;0;0;0;0;0.0;0.0
51;2020-12-31;1;0;1;0;0.0;0.0
51;2021-01-01;0;0;1;0;0.0;0.0
51;2021-01-02;0;0;1;0;0.0;0.0
51;2021-01-03;0;0;1;0;0.0;0.0
51;2021-01-04;1;0;2;0;0.0;0.0
51;2021-01-05;1;0;3;0;0.0;0.0
51;2021-01-06;6;0;9;0;0.0;0.0
51;2021-01-07;262;1;271;1;0.0;0.0
51;2021-01-08;508;1;779;2;0.1;0.0
51;2021-01-09;91;0;870;2;0.2;0.0
51;2021-01-10;0;0;870;2;0.2;0.0
51;2021-01-11;545;2;1415;4;0.3;0.0
51;2021-01-12;1542;4;2957;8;0.5;0.0
51;2021-01-13;1289;5;4246;13;0.8;0.0
51;2021-01-14;1475;6;5721;19;1.0;0.0
51;2021-01-15;607;3;6328;22;1.1;0.0
51;2021-01-16;177;1;6505;23;1.2;0.0
51;2021-01-17;102;0;6607;23;1.2;0.0
51;2021-01-18;845;3;7452;26;1.3;0.0
51;2021-01-19;997;2;8449;28;1.5;0.0
51;2021-01-20;955;7;9404;35;1.7;0.0
51;2021-01-21;790;2;10194;37;1.8;0.0
51;2021-01-22;393;2;10587;39;1.9;0.0
51;2021-01-23;294;0;10881;39;1.9;0.0
51;2021-01-24;130;1;11011;40;2.0;0.0
51;2021-01-25;712;3;11723;43;2.1;0.0
51;2021-01-26;779;5;12502;48;2.2;0.0
51;2021-01-27;655;2;13157;50;2.3;0.0
51;2021-01-28;646;54;13803;104;2.4;0.0
51;2021-01-29;474;141;14277;245;2.5;0.0
51;2021-01-30;126;5;14403;250;2.6;0.0
51;2021-01-31;83;0;14486;250;2.6;0.0
51;2021-02-01;275;58;14761;308;2.6;0.1
51;2021-02-02;738;622;15499;930;2.7;0.2
51;2021-02-03;642;454;16141;1384;2.9;0.2
51;2021-02-04;968;733;17109;2117;3.0;0.4
51;2021-02-05;973;473;18082;2590;3.2;0.5
51;2021-02-06;30;136;18112;2726;3.2;0.5
51;2021-02-07;0;18;18112;2744;3.2;0.5
51;2021-02-08;115;392;18227;3136;3.2;0.6
51;2021-02-09;222;454;18449;3590;3.3;0.6
51;2021-02-10;220;599;18669;4189;3.3;0.7
51;2021-02-11;302;491;18971;4680;3.4;0.8
51;2021-02-12;341;489;19312;5169;3.4;0.9
51;2021-02-13;8;94;19320;5263;3.4;0.9
51;2021-02-14;8;119;19328;5382;3.4;1.0
51;2021-02-15;265;592;19593;5974;3.5;1.1
51;2021-02-16;402;762;19995;6736;3.5;1.2
51;2021-02-17;367;694;20362;7430;3.6;1.3
51;2021-02-18;437;469;20799;7899;3.7;1.4
51;2021-02-19;529;380;21328;8279;3.8;1.5
51;2021-02-20;205;264;21533;8543;3.8;1.5
51;2021-02-21;10;93;21543;8636;3.8;1.5
51;2021-02-22;195;544;21738;9180;3.9;1.6
51;2021-02-23;262;915;22000;10095;3.9;1.8
51;2021-02-24;414;554;22414;10649;4.0;1.9
51;2021-02-25;1049;780;23463;11429;4.2;2.0
51;2021-02-26;1228;601;24691;12030;4.4;2.1
51;2021-02-27;590;96;25281;12126;4.5;2.2
51;2021-02-28;7;52;25288;12178;4.5;2.2
51;2021-03-01;767;279;26055;12457;4.6;2.2
51;2021-03-02;1128;414;27183;12871;4.8;2.3
51;2021-03-03;1193;388;28376;13259;5.0;2.4
51;2021-03-04;1061;630;29437;13889;5.2;2.5
51;2021-03-05;1560;567;30997;14456;5.5;2.6
51;2021-03-06;1433;56;32430;14512;5.8;2.6
51;2021-03-07;250;5;32680;14517;5.8;2.6
51;2021-03-08;992;98;33672;14615;6.0;2.6
51;2021-03-09;1665;180;35337;14795;6.3;2.6
51;2021-03-10;1996;103;37333;14898;6.6;2.6
51;2021-03-11;2371;168;39704;15066;7.0;2.7
51;2021-03-12;3253;148;42957;15214;7.6;2.7
51;2021-03-13;2550;49;45507;15263;8.1;2.7
51;2021-03-14;190;5;45697;15268;8.1;2.7
51;2021-03-15;1580;150;47277;15418;8.4;2.7
51;2021-03-16;1478;182;48755;15600;8.6;2.8
51;2021-03-17;1497;206;50252;15806;8.9;2.8
51;2021-03-18;1615;287;51867;16093;9.2;2.9
51;2021-03-19;2311;296;54178;16389;9.6;2.9
51;2021-03-20;1661;216;55839;16605;9.9;2.9
51;2021-03-21;133;4;55972;16609;9.9;2.9
51;2021-03-22;1416;125;57388;16734;10.2;3.0
51;2021-03-23;2469;160;59857;16894;10.6;3.0
51;2021-03-24;2846;131;62703;17025;11.1;3.0
51;2021-03-25;3254;331;65957;17356;11.7;3.1
51;2021-03-26;3411;501;69368;17857;12.3;3.2
51;2021-03-27;1842;249;71210;18106;12.6;3.2
51;2021-03-28;213;3;71423;18109;12.7;3.2
51;2021-03-29;991;629;72414;18738;12.8;3.3
51;2021-03-30;1748;851;74162;19589;13.2;3.5
51;2021-03-31;1738;748;75900;20337;13.5;3.6
51;2021-04-01;2282;449;78182;20786;13.9;3.7
51;2021-04-02;2425;641;80607;21427;14.3;3.8
51;2021-04-03;1301;411;81908;21838;14.5;3.9
51;2021-04-04;106;2;82014;21840;14.5;3.9
51;2021-04-05;72;138;82086;21978;14.6;3.9
51;2021-04-06;763;1230;82849;23208;14.7;4.1
51;2021-04-07;1312;1407;84161;24615;14.9;4.4
51;2021-04-08;2204;1771;86365;26386;15.3;4.7
51;2021-04-09;2862;1724;89227;28110;15.8;5.0
51;2021-04-10;2219;496;91446;28606;16.2;5.1
51;2021-04-11;105;85;91551;28691;16.2;5.1
51;2021-04-12;1450;1338;93001;30029;16.5;5.3
51;2021-04-13;1936;1670;94937;31699;16.8;5.6
51;2021-04-14;2460;1549;97397;33248;17.3;5.9
51;2021-04-15;2856;1672;100253;34920;17.8;6.2
51;2021-04-16;3214;1600;103467;36520;18.4;6.5
51;2021-04-17;1966;775;105433;37295;18.7;6.6
51;2021-04-18;296;114;105729;37409;18.8;6.6
51;2021-04-19;1561;1157;107290;38566;19.0;6.8
51;2021-04-20;1791;1661;109081;40227;19.3;7.1
51;2021-04-21;2002;1741;111083;41968;19.7;7.4
51;2021-04-22;2407;1661;113490;43629;20.1;7.7
51;2021-04-23;2982;1823;116472;45452;20.7;8.1
51;2021-04-24;1749;952;118221;46404;21.0;8.2
51;2021-04-25;123;160;118344;46564;21.0;8.3
51;2021-04-26;1851;761;120195;47325;21.3;8.4
51;2021-04-27;2442;1214;122637;48539;21.8;8.6
51;2021-04-28;2552;1290;125189;49829;22.2;8.8
51;2021-04-29;2676;1460;127865;51289;22.7;9.1
51;2021-04-30;2975;1658;130840;52947;23.2;9.4
51;2021-05-01;1453;411;132293;53358;23.5;9.5
51;2021-05-02;107;99;132400;53457;23.5;9.5
51;2021-05-03;2484;754;134884;54211;23.9;9.6
51;2021-05-04;2788;1351;137672;55562;24.4;9.9
51;2021-05-05;2860;1638;140532;57200;24.9;10.1
51;2021-05-06;5344;1949;145876;59149;25.9;10.5
51;2021-05-07;3705;1902;149581;61051;26.5;10.8
51;2021-05-08;2862;815;152443;61866;27.0;11.0
51;2021-05-09;212;92;152655;61958;27.1;11.0
51;2021-05-10;3214;1859;155869;63817;27.6;11.3
51;2021-05-11;3643;2032;159512;65849;28.3;11.7
51;2021-05-12;4182;2233;163694;68082;29.0;12.1
51;2021-05-13;1777;505;165471;68587;29.3;12.2
51;2021-05-14;5401;1740;170872;70327;30.3;12.5
51;2021-05-15;4227;1351;175099;71678;31.1;12.7
51;2021-05-16;284;45;175383;71723;31.1;12.7
51;2021-05-17;3131;1520;178514;73243;31.7;13.0
51;2021-05-18;3918;1760;182432;75003;32.4;13.3
51;2021-05-19;4031;1722;186463;76725;33.1;13.6
51;2021-05-20;4649;1966;191112;78691;33.9;14.0
51;2021-05-21;3597;2463;194709;81154;34.5;14.4
51;2021-05-22;2075;1548;196784;82702;34.9;14.7
51;2021-05-23;308;210;197092;82912;35.0;14.7
51;2021-05-24;2018;720;199110;83632;35.3;14.8
51;2021-05-25;3130;1828;202240;85460;35.9;15.2
51;2021-05-26;3296;1710;205536;87170;36.5;15.5
51;2021-05-27;3267;2056;208803;89226;37.0;15.8
51;2021-05-28;3606;2796;212409;92022;37.7;16.3
51;2021-05-29;2401;1990;214810;94012;38.1;16.7
51;2021-05-30;401;133;215211;94145;38.2;16.7
51;2021-05-31;3348;1767;218559;95912;38.8;17.0
51;2021-06-01;3853;2321;222412;98233;39.4;17.4
51;2021-06-02;6096;2328;228508;100561;40.5;17.8
51;2021-06-03;3580;2424;232088;102985;41.2;18.3
51;2021-06-04;6345;2935;238433;105920;42.3;18.8
51;2021-06-05;2596;1814;241029;107734;42.7;19.1
51;2021-06-06;172;157;241201;107891;42.8;19.1
51;2021-06-07;4302;2164;245503;110055;43.5;19.5
51;2021-06-08;3925;2529;249428;112584;44.2;20.0
51;2021-06-09;4016;2748;253444;115332;45.0;20.5
51;2021-06-10;3208;2485;256652;117817;45.5;20.9
51;2021-06-11;3358;3425;260010;121242;46.1;21.5
51;2021-06-12;2165;2170;262175;123412;46.5;21.9
51;2021-06-13;191;149;262366;123561;46.5;21.9
51;2021-06-14;1627;3327;263993;126888;46.8;22.5
51;2021-06-15;3189;3577;267182;130465;47.4;23.1
51;2021-06-16;2208;3683;269390;134148;47.8;23.8
51;2021-06-17;2608;5399;271998;139547;48.2;24.8
51;2021-06-18;2355;5211;274353;144758;48.7;25.7
51;2021-06-19;1683;4425;276036;149183;49.0;26.5
51;2021-06-20;184;228;276220;149411;49.0;26.5
51;2021-06-21;1231;4435;277451;153846;49.2;27.3
51;2021-06-22;1558;4043;279009;157889;49.5;28.0
51;2021-06-23;3670;4236;282679;162125;50.1;28.8
51;2021-06-24;2246;3224;284925;165349;50.5;29.3
51;2021-06-25;1905;6525;286830;171874;50.9;30.5
51;2021-06-26;1203;5063;288033;176937;51.1;31.4
51;2021-06-27;103;336;288136;177273;51.1;31.4
51;2021-06-28;1401;4413;289537;181686;51.4;32.2
51;2021-06-29;1174;4463;290711;186149;51.6;33.0
51;2021-06-30;1687;6044;292398;192193;51.9;34.1
51;2021-07-01;1978;3765;294376;195958;52.2;34.8
51;2021-07-02;1838;6885;296214;202843;52.5;36.0
51;2021-07-03;1003;3196;297217;206039;52.7;36.5
51;2021-07-04;171;254;297388;206293;52.7;36.6
51;2021-07-05;768;5529;298156;211822;52.9;37.6
51;2021-07-06;1247;4778;299403;216600;53.1;38.4
51;2021-07-07;1617;4934;301020;221534;53.4;39.3
51;2021-07-08;2067;3430;303087;224964;53.8;39.9
51;2021-07-09;1854;5055;304941;230019;54.1;40.8
51;2021-07-10;1238;3205;306179;233224;54.3;41.4
51;2021-07-11;190;281;306369;233505;54.3;41.4
51;2021-07-12;996;4379;307365;237884;54.5;42.2
51;2021-07-13;1480;4770;308845;242654;54.8;43.0
51;2021-07-14;1071;1691;309916;244345;55.0;43.3
51;2021-07-15;2938;4910;312854;249255;55.5;44.2
51;2021-07-16;2364;5273;315218;254528;55.9;45.1
51;2021-07-17;1820;3476;317038;258004;56.2;45.8
51;2021-07-18;163;330;317201;258334;56.3;45.8
51;2021-07-19;1892;3973;319093;262307;56.6;46.5
51;2021-07-20;2585;5143;321678;267450;57.1;47.4
51;2021-07-21;3611;4066;325289;271516;57.7;48.2
51;2021-07-22;4412;3758;329701;275274;58.5;48.8
51;2021-07-23;3640;4377;333341;279651;59.1;49.6
51;2021-07-24;2086;2724;335427;282375;59.5;50.1
51;2021-07-25;356;258;335783;282633;59.6;50.1
51;2021-07-26;3113;2809;338896;285442;60.1;50.6
51;2021-07-27;5863;3273;344759;288715;61.1;51.2
51;2021-07-28;4138;4320;348897;293035;61.9;52.0
51;2021-07-29;4700;2717;353597;295752;62.7;52.5
51;2021-07-30;3628;3155;357225;298907;63.4;53.0
51;2021-07-31;2526;2131;359751;301038;63.8;53.4
51;2021-08-01;375;236;360126;301274;63.9;53.4
51;2021-08-02;3286;2308;363412;303582;64.5;53.8
51;2021-08-03;3775;1912;367187;305494;65.1;54.2
51;2021-08-04;4451;2124;371638;307618;65.9;54.6
51;2021-08-05;2656;1534;374294;309152;66.4;54.8
51;2021-08-06;3044;2550;377338;311702;66.9;55.3
51;2021-08-07;2161;1698;379499;313400;67.3;55.6
51;2021-08-08;368;208;379867;313608;67.4;55.6
51;2021-08-09;2604;1851;382471;315459;67.8;56.0
51;2021-08-10;2371;1983;384842;317442;68.3;56.3
51;2021-08-11;2917;2341;387759;319783;68.8;56.7
51;2021-08-12;1753;1958;389512;321741;69.1;57.1
51;2021-08-13;2066;2670;391578;324411;69.5;57.5
51;2021-08-14;1581;2027;393159;326438;69.7;57.9
51;2021-08-15;149;150;393308;326588;69.8;57.9
51;2021-08-16;1356;3016;394664;329604;70.0;58.5
51;2021-08-17;1560;3283;396224;332887;70.3;59.0
51;2021-08-18;1899;3693;398123;336580;70.6;59.7
51;2021-08-19;1408;2548;399531;339128;70.9;60.1
51;2021-08-20;1708;3974;401239;343102;71.2;60.9
51;2021-08-21;988;2497;402227;345599;71.3;61.3
51;2021-08-22;101;343;402328;345942;71.4;61.4
51;2021-08-23;1111;3607;403439;349549;71.6;62.0
51;2021-08-24;1172;3643;404611;353192;71.8;62.6
51;2021-08-25;1319;4487;405930;357679;72.0;63.4
51;2021-08-26;1056;2547;406986;360226;72.2;63.9
51;2021-08-27;1214;4178;408200;364404;72.4;64.6
51;2021-08-28;655;2632;408855;367036;72.5;65.1
51;2021-08-29;84;360;408939;367396;72.5;65.2
51;2021-08-30;1332;4829;410271;372225;72.8;66.0
51;2021-08-31;780;3011;411051;375236;72.9;66.6
51;2021-09-01;739;3372;411790;378608;73.0;67.2
51;2021-09-02;799;2216;412589;380824;73.2;67.5
51;2021-09-03;904;2911;413493;383735;73.3;68.1
51;2021-09-04;618;2805;414111;386540;73.4;68.6
51;2021-09-05;122;225;414233;386765;73.5;68.6
51;2021-09-06;432;1791;414665;388556;73.5;68.9
51;2021-09-07;519;1670;415184;390226;73.6;69.2
51;2021-09-08;626;2175;415810;392401;73.7;69.6
51;2021-09-09;464;1348;416274;393749;73.8;69.8
51;2021-09-10;665;2087;416939;395836;73.9;70.2
51;2021-09-11;557;1934;417496;397770;74.0;70.5
51;2021-09-12;19;82;417515;397852;74.1;70.6
51;2021-09-13;424;1091;417939;398943;74.1;70.8
51;2021-09-14;593;1331;418532;400274;74.2;71.0
51;2021-09-15;490;1421;419022;401695;74.3;71.2
51;2021-09-16;306;658;419328;402353;74.4;71.4
51;2021-09-17;538;1127;419866;403480;74.5;71.6
51;2021-09-18;470;1418;420336;404898;74.6;71.8
51;2021-09-19;13;64;420349;404962;74.6;71.8
51;2021-09-20;280;533;420629;405495;74.6;71.9
51;2021-09-21;255;489;420884;405984;74.6;72.0
51;2021-09-22;318;1348;421202;407332;74.7;72.2
51;2021-09-23;195;602;421397;407934;74.7;72.4
51;2021-09-24;365;977;421762;408911;74.8;72.5
51;2021-09-25;284;983;422046;409894;74.9;72.7
51;2021-09-26;7;129;422053;410023;74.9;72.7
51;2021-09-27;259;445;422312;410468;74.9;72.8
51;2021-09-28;293;362;422605;410830;75.0;72.9
51;2021-09-29;347;774;422952;411604;75.0;73.0
52;2020-12-27;0;0;0;0;0.0;0.0
52;2020-12-28;1;0;1;0;0.0;0.0
52;2020-12-29;0;0;1;0;0.0;0.0
52;2020-12-30;0;0;1;0;0.0;0.0
52;2020-12-31;0;0;1;0;0.0;0.0
52;2021-01-01;0;0;1;0;0.0;0.0
52;2021-01-02;1;0;2;0;0.0;0.0
52;2021-01-03;0;0;2;0;0.0;0.0
52;2021-01-04;0;0;2;0;0.0;0.0
52;2021-01-05;0;0;2;0;0.0;0.0
52;2021-01-06;2;0;4;0;0.0;0.0
52;2021-01-07;0;0;4;0;0.0;0.0
52;2021-01-08;200;1;204;1;0.1;0.0
52;2021-01-09;93;0;297;1;0.2;0.0
52;2021-01-10;0;0;297;1;0.2;0.0
52;2021-01-11;207;0;504;1;0.3;0.0
52;2021-01-12;171;0;675;1;0.4;0.0
52;2021-01-13;563;2;1238;3;0.7;0.0
52;2021-01-14;677;10;1915;13;1.1;0.0
52;2021-01-15;411;1;2326;14;1.4;0.0
52;2021-01-16;16;0;2342;14;1.4;0.0
52;2021-01-17;0;0;2342;14;1.4;0.0
52;2021-01-18;427;0;2769;14;1.6;0.0
52;2021-01-19;440;0;3209;14;1.9;0.0
52;2021-01-20;422;0;3631;14;2.1;0.0
52;2021-01-21;423;1;4054;15;2.4;0.0
52;2021-01-22;321;2;4375;17;2.6;0.0
52;2021-01-23;73;1;4448;18;2.6;0.0
52;2021-01-24;0;0;4448;18;2.6;0.0
52;2021-01-25;236;0;4684;18;2.8;0.0
52;2021-01-26;308;0;4992;18;2.9;0.0
52;2021-01-27;238;1;5230;19;3.1;0.0
52;2021-01-28;174;4;5404;23;3.2;0.0
52;2021-01-29;74;114;5478;137;3.2;0.1
52;2021-01-30;91;92;5569;229;3.3;0.1
52;2021-01-31;0;0;5569;229;3.3;0.1
52;2021-02-01;117;178;5686;407;3.4;0.2
52;2021-02-02;61;167;5747;574;3.4;0.3
52;2021-02-03;89;387;5836;961;3.4;0.6
52;2021-02-04;231;534;6067;1495;3.6;0.9
52;2021-02-05;113;421;6180;1916;3.7;1.1
52;2021-02-06;22;0;6202;1916;3.7;1.1
52;2021-02-07;0;1;6202;1917;3.7;1.1
52;2021-02-08;34;163;6236;2080;3.7;1.2
52;2021-02-09;47;174;6283;2254;3.7;1.3
52;2021-02-10;88;162;6371;2416;3.8;1.4
52;2021-02-11;129;123;6500;2539;3.8;1.5
52;2021-02-12;187;106;6687;2645;4.0;1.6
52;2021-02-13;5;1;6692;2646;4.0;1.6
52;2021-02-14;0;16;6692;2662;4.0;1.6
52;2021-02-15;79;226;6771;2888;4.0;1.7
52;2021-02-16;50;282;6821;3170;4.0;1.9
52;2021-02-17;38;254;6859;3424;4.1;2.0
52;2021-02-18;82;238;6941;3662;4.1;2.2
52;2021-02-19;51;151;6992;3813;4.1;2.3
52;2021-02-20;14;89;7006;3902;4.1;2.3
52;2021-02-21;0;0;7006;3902;4.1;2.3
52;2021-02-22;42;322;7048;4224;4.2;2.5
52;2021-02-23;56;224;7104;4448;4.2;2.6
52;2021-02-24;81;212;7185;4660;4.2;2.8
52;2021-02-25;161;224;7346;4884;4.3;2.9
52;2021-02-26;296;174;7642;5058;4.5;3.0
52;2021-02-27;149;49;7791;5107;4.6;3.0
52;2021-02-28;0;0;7791;5107;4.6;3.0
52;2021-03-01;162;13;7953;5120;4.7;3.0
52;2021-03-02;211;45;8164;5165;4.8;3.1
52;2021-03-03;356;35;8520;5200;5.0;3.1
52;2021-03-04;379;58;8899;5258;5.3;3.1
52;2021-03-05;531;52;9430;5310;5.6;3.1
52;2021-03-06;409;35;9839;5345;5.8;3.2
52;2021-03-07;0;0;9839;5345;5.8;3.2
52;2021-03-08;398;102;10237;5447;6.0;3.2
52;2021-03-09;549;103;10786;5550;6.4;3.3
52;2021-03-10;308;102;11094;5652;6.6;3.3
52;2021-03-11;587;34;11681;5686;6.9;3.4
52;2021-03-12;585;68;12266;5754;7.2;3.4
52;2021-03-13;494;10;12760;5764;7.5;3.4
52;2021-03-14;15;3;12775;5767;7.5;3.4
52;2021-03-15;318;27;13093;5794;7.7;3.4
52;2021-03-16;203;15;13296;5809;7.9;3.4
52;2021-03-17;369;13;13665;5822;8.1;3.4
52;2021-03-18;442;10;14107;5832;8.3;3.4
52;2021-03-19;453;53;14560;5885;8.6;3.5
52;2021-03-20;259;12;14819;5897;8.8;3.5
52;2021-03-21;15;1;14834;5898;8.8;3.5
52;2021-03-22;375;49;15209;5947;9.0;3.5
52;2021-03-23;686;111;15895;6058;9.4;3.6
52;2021-03-24;771;71;16666;6129;9.8;3.6
52;2021-03-25;1143;88;17809;6217;10.5;3.7
52;2021-03-26;1036;135;18845;6352;11.1;3.8
52;2021-03-27;477;75;19322;6427;11.4;3.8
52;2021-03-28;53;0;19375;6427;11.4;3.8
52;2021-03-29;507;182;19882;6609;11.7;3.9
52;2021-03-30;870;303;20752;6912;12.3;4.1
52;2021-03-31;956;291;21708;7203;12.8;4.3
52;2021-04-01;1145;183;22853;7386;13.5;4.4
52;2021-04-02;958;109;23811;7495;14.1;4.4
52;2021-04-03;462;2;24273;7497;14.3;4.4
52;2021-04-04;1;1;24274;7498;14.3;4.4
52;2021-04-05;1;0;24275;7498;14.3;4.4
52;2021-04-06;434;293;24709;7791;14.6;4.6
52;2021-04-07;506;450;25215;8241;14.9;4.9
52;2021-04-08;860;208;26075;8449;15.4;5.0
52;2021-04-09;1058;131;27133;8580;16.0;5.1
52;2021-04-10;850;102;27983;8682;16.5;5.1
52;2021-04-11;96;1;28079;8683;16.6;5.1
52;2021-04-12;933;277;29012;8960;17.1;5.3
52;2021-04-13;1251;380;30263;9340;17.9;5.5
52;2021-04-14;1345;455;31608;9795;18.7;5.8
52;2021-04-15;1505;440;33113;10235;19.6;6.0
52;2021-04-16;1570;359;34683;10594;20.5;6.3
52;2021-04-17;1312;135;35995;10729;21.3;6.3
52;2021-04-18;510;29;36505;10758;21.6;6.4
52;2021-04-19;697;611;37202;11369;22.0;6.7
52;2021-04-20;1079;679;38281;12048;22.6;7.1
52;2021-04-21;1058;673;39339;12721;23.2;7.5
52;2021-04-22;1468;733;40807;13454;24.1;7.9
52;2021-04-23;1250;669;42057;14123;24.8;8.3
52;2021-04-24;477;293;42534;14416;25.1;8.5
52;2021-04-25;3;77;42537;14493;25.1;8.6
52;2021-04-26;631;560;43168;15053;25.5;8.9
52;2021-04-27;932;668;44100;15721;26.1;9.3
52;2021-04-28;1443;568;45543;16289;26.9;9.6
52;2021-04-29;1452;583;46995;16872;27.8;10.0
52;2021-04-30;1316;611;48311;17483;28.5;10.3
52;2021-05-01;8;230;48319;17713;28.5;10.5
52;2021-05-02;0;1;48319;17714;28.5;10.5
52;2021-05-03;1159;628;49478;18342;29.2;10.8
52;2021-05-04;1445;719;50923;19061;30.1;11.3
52;2021-05-05;1768;647;52691;19708;31.1;11.6
52;2021-05-06;1963;537;54654;20245;32.3;12.0
52;2021-05-07;1441;1168;56095;21413;33.1;12.7
52;2021-05-08;587;317;56682;21730;33.5;12.8
52;2021-05-09;1;47;56683;21777;33.5;12.9
52;2021-05-10;792;1100;57475;22877;34.0;13.5
52;2021-05-11;868;1389;58343;24266;34.5;14.3
52;2021-05-12;1206;1382;59549;25648;35.2;15.2
52;2021-05-13;67;184;59616;25832;35.2;15.3
52;2021-05-14;1184;1365;60800;27197;35.9;16.1
52;2021-05-15;491;929;61291;28126;36.2;16.6
52;2021-05-16;8;43;61299;28169;36.2;16.6
52;2021-05-17;1141;705;62440;28874;36.9;17.1
52;2021-05-18;1218;677;63658;29551;37.6;17.5
52;2021-05-19;1541;415;65199;29966;38.5;17.7
52;2021-05-20;1546;418;66745;30384;39.4;18.0
52;2021-05-21;1624;611;68369;30995;40.4;18.3
52;2021-05-22;1089;210;69458;31205;41.0;18.4
52;2021-05-23;1;0;69459;31205;41.0;18.4
52;2021-05-24;405;33;69864;31238;41.3;18.5
52;2021-05-25;1351;385;71215;31623;42.1;18.7
52;2021-05-26;1477;672;72692;32295;42.9;19.1
52;2021-05-27;1564;786;74256;33081;43.9;19.5
52;2021-05-28;1493;668;75749;33749;44.8;19.9
52;2021-05-29;695;834;76444;34583;45.2;20.4
52;2021-05-30;16;551;76460;35134;45.2;20.8
52;2021-05-31;825;829;77285;35963;45.7;21.2
52;2021-06-01;956;816;78241;36779;46.2;21.7
52;2021-06-02;896;754;79137;37533;46.8;22.2
52;2021-06-03;825;825;79962;38358;47.2;22.7
52;2021-06-04;883;1340;80845;39698;47.8;23.5
52;2021-06-05;581;637;81426;40335;48.1;23.8
52;2021-06-06;27;55;81453;40390;48.1;23.9
52;2021-06-07;359;931;81812;41321;48.3;24.4
52;2021-06-08;556;1470;82368;42791;48.7;25.3
52;2021-06-09;611;1474;82979;44265;49.0;26.2
52;2021-06-10;794;1157;83773;45422;49.5;26.8
52;2021-06-11;830;1347;84603;46769;50.0;27.6
52;2021-06-12;423;586;85026;47355;50.2;28.0
52;2021-06-13;2;6;85028;47361;50.2;28.0
52;2021-06-14;171;1413;85199;48774;50.3;28.8
52;2021-06-15;221;1807;85420;50581;50.5;29.9
52;2021-06-16;351;1996;85771;52577;50.7;31.1
52;2021-06-17;265;1156;86036;53733;50.8;31.7
52;2021-06-18;308;1553;86344;55286;51.0;32.7
52;2021-06-19;502;684;86846;55970;51.3;33.1
52;2021-06-20;1;17;86847;55987;51.3;33.1
52;2021-06-21;523;897;87370;56884;51.6;33.6
52;2021-06-22;503;1047;87873;57931;51.9;34.2
52;2021-06-23;563;1043;88436;58974;52.3;34.8
52;2021-06-24;610;715;89046;59689;52.6;35.3
52;2021-06-25;661;1314;89707;61003;53.0;36.0
52;2021-06-26;264;722;89971;61725;53.2;36.5
52;2021-06-27;1;8;89972;61733;53.2;36.5
52;2021-06-28;184;1442;90156;63175;53.3;37.3
52;2021-06-29;163;1414;90319;64589;53.4;38.2
52;2021-06-30;221;1467;90540;66056;53.5;39.0
52;2021-07-01;320;1020;90860;67076;53.7;39.6
52;2021-07-02;430;1454;91290;68530;53.9;40.5
52;2021-07-03;302;1148;91592;69678;54.1;41.2
52;2021-07-04;0;11;91592;69689;54.1;41.2
52;2021-07-05;173;1446;91765;71135;54.2;42.0
52;2021-07-06;284;1449;92049;72584;54.4;42.9
52;2021-07-07;309;1163;92358;73747;54.6;43.6
52;2021-07-08;473;1166;92831;74913;54.8;44.3
52;2021-07-09;288;1620;93119;76533;55.0;45.2
52;2021-07-10;155;822;93274;77355;55.1;45.7
52;2021-07-11;13;12;93287;77367;55.1;45.7
52;2021-07-12;299;1467;93586;78834;55.3;46.6
52;2021-07-13;590;1365;94176;80199;55.6;47.4
52;2021-07-14;437;153;94613;80352;55.9;47.5
52;2021-07-15;614;1428;95227;81780;56.3;48.3
52;2021-07-16;899;1337;96126;83117;56.8;49.1
52;2021-07-17;530;343;96656;83460;57.1;49.3
52;2021-07-18;3;12;96659;83472;57.1;49.3
52;2021-07-19;691;987;97350;84459;57.5;49.9
52;2021-07-20;1110;831;98460;85290;58.2;50.4
52;2021-07-21;1161;737;99621;86027;58.9;50.8
52;2021-07-22;1447;865;101068;86892;59.7;51.3
52;2021-07-23;1399;956;102467;87848;60.5;51.9
52;2021-07-24;873;487;103340;88335;61.1;52.2
52;2021-07-25;22;21;103362;88356;61.1;52.2
52;2021-07-26;1010;613;104372;88969;61.7;52.6
52;2021-07-27;1342;657;105714;89626;62.5;53.0
52;2021-07-28;1382;643;107096;90269;63.3;53.3
52;2021-07-29;1263;622;108359;90891;64.0;53.7
52;2021-07-30;1365;712;109724;91603;64.8;54.1
52;2021-07-31;873;549;110597;92152;65.3;54.4
52;2021-08-01;1;14;110598;92166;65.3;54.5
52;2021-08-02;1185;562;111783;92728;66.0;54.8
52;2021-08-03;1363;539;113146;93267;66.9;55.1
52;2021-08-04;1157;579;114303;93846;67.5;55.4
52;2021-08-05;1026;574;115329;94420;68.1;55.8
52;2021-08-06;1057;697;116386;95117;68.8;56.2
52;2021-08-07;519;422;116905;95539;69.1;56.4
52;2021-08-08;0;6;116905;95545;69.1;56.5
52;2021-08-09;469;871;117374;96416;69.3;57.0
52;2021-08-10;717;748;118091;97164;69.8;57.4
52;2021-08-11;535;837;118626;98001;70.1;57.9
52;2021-08-12;623;750;119249;98751;70.5;58.3
52;2021-08-13;420;1029;119669;99780;70.7;59.0
52;2021-08-14;421;360;120090;100140;71.0;59.2
52;2021-08-15;13;13;120103;100153;71.0;59.2
52;2021-08-16;327;934;120430;101087;71.2;59.7
52;2021-08-17;415;911;120845;101998;71.4;60.3
52;2021-08-18;489;944;121334;102942;71.7;60.8
52;2021-08-19;461;836;121795;103778;72.0;61.3
52;2021-08-20;384;1210;122179;104988;72.2;62.0
52;2021-08-21;394;604;122573;105592;72.4;62.4
52;2021-08-22;5;11;122578;105603;72.4;62.4
52;2021-08-23;431;1058;123009;106661;72.7;63.0
52;2021-08-24;307;1077;123316;107738;72.9;63.7
52;2021-08-25;254;1061;123570;108799;73.0;64.3
52;2021-08-26;301;914;123871;109713;73.2;64.8
52;2021-08-27;429;1276;124300;110989;73.4;65.6
52;2021-08-28;243;495;124543;111484;73.6;65.9
52;2021-08-29;3;25;124546;111509;73.6;65.9
52;2021-08-30;204;998;124750;112507;73.7;66.5
52;2021-08-31;205;1054;124955;113561;73.8;67.1
52;2021-09-01;183;1066;125138;114627;73.9;67.7
52;2021-09-02;194;762;125332;115389;74.1;68.2
52;2021-09-03;242;937;125574;116326;74.2;68.7
52;2021-09-04;189;556;125763;116882;74.3;69.1
52;2021-09-05;2;14;125765;116896;74.3;69.1
52;2021-09-06;126;543;125891;117439;74.4;69.4
52;2021-09-07;161;520;126052;117959;74.5;69.7
52;2021-09-08;140;616;126192;118575;74.6;70.1
52;2021-09-09;138;432;126330;119007;74.6;70.3
52;2021-09-10;255;740;126585;119747;74.8;70.8
52;2021-09-11;151;321;126736;120068;74.9;70.9
52;2021-09-12;2;12;126738;120080;74.9;70.9
52;2021-09-13;174;621;126912;120701;75.0;71.3
52;2021-09-14;141;463;127053;121164;75.1;71.6
52;2021-09-15;148;447;127201;121611;75.2;71.9
52;2021-09-16;136;309;127337;121920;75.2;72.0
52;2021-09-17;232;543;127569;122463;75.4;72.4
52;2021-09-18;134;242;127703;122705;75.5;72.5
52;2021-09-19;4;18;127707;122723;75.5;72.5
52;2021-09-20;106;353;127813;123076;75.5;72.7
52;2021-09-21;94;208;127907;123284;75.6;72.8
52;2021-09-22;107;319;128014;123603;75.6;73.0
52;2021-09-23;138;207;128152;123810;75.7;73.2
52;2021-09-24;127;284;128279;124094;75.8;73.3
52;2021-09-25;92;250;128371;124344;75.8;73.5
52;2021-09-26;0;0;128371;124344;75.8;73.5
52;2021-09-27;116;181;128487;124525;75.9;73.6
52;2021-09-28;119;144;128606;124669;76.0;73.7
52;2021-09-29;91;207;128697;124876;76.0;73.8
53;2020-12-27;0;0;0;0;0.0;0.0
53;2020-12-28;0;0;0;0;0.0;0.0
53;2020-12-29;0;0;0;0;0.0;0.0
53;2020-12-30;0;0;0;0;0.0;0.0
53;2020-12-31;0;0;0;0;0.0;0.0
53;2021-01-01;0;0;0;0;0.0;0.0
53;2021-01-02;1;0;1;0;0.0;0.0
53;2021-01-03;0;0;1;0;0.0;0.0
53;2021-01-04;1;0;2;0;0.0;0.0
53;2021-01-05;0;0;2;0;0.0;0.0
53;2021-01-06;0;0;2;0;0.0;0.0
53;2021-01-07;102;0;104;0;0.0;0.0
53;2021-01-08;284;1;388;1;0.1;0.0
53;2021-01-09;134;1;522;2;0.2;0.0
53;2021-01-10;15;0;537;2;0.2;0.0
53;2021-01-11;176;0;713;2;0.2;0.0
53;2021-01-12;456;0;1169;2;0.4;0.0
53;2021-01-13;254;0;1423;2;0.5;0.0
53;2021-01-14;290;7;1713;9;0.6;0.0
53;2021-01-15;343;4;2056;13;0.7;0.0
53;2021-01-16;60;0;2116;13;0.7;0.0
53;2021-01-17;25;0;2141;13;0.7;0.0
53;2021-01-18;364;0;2505;13;0.8;0.0
53;2021-01-19;594;0;3099;13;1.0;0.0
53;2021-01-20;742;0;3841;13;1.3;0.0
53;2021-01-21;773;2;4614;15;1.5;0.0
53;2021-01-22;705;5;5319;20;1.7;0.0
53;2021-01-23;160;0;5479;20;1.8;0.0
53;2021-01-24;6;0;5485;20;1.8;0.0
53;2021-01-25;550;0;6035;20;2.0;0.0
53;2021-01-26;1198;7;7233;27;2.4;0.0
53;2021-01-27;696;4;7929;31;2.6;0.0
53;2021-01-28;736;94;8665;125;2.8;0.0
53;2021-01-29;422;177;9087;302;3.0;0.1
53;2021-01-30;130;0;9217;302;3.0;0.1
53;2021-01-31;0;0;9217;302;3.0;0.1
53;2021-02-01;298;143;9515;445;3.1;0.1
53;2021-02-02;309;226;9824;671;3.2;0.2
53;2021-02-03;227;358;10051;1029;3.3;0.3
53;2021-02-04;184;303;10235;1332;3.4;0.4
53;2021-02-05;234;289;10469;1621;3.4;0.5
53;2021-02-06;153;23;10622;1644;3.5;0.5
53;2021-02-07;0;0;10622;1644;3.5;0.5
53;2021-02-08;168;89;10790;1733;3.5;0.6
53;2021-02-09;369;206;11159;1939;3.7;0.6
53;2021-02-10;266;397;11425;2336;3.7;0.8
53;2021-02-11;432;397;11857;2733;3.9;0.9
53;2021-02-12;318;486;12175;3219;4.0;1.1
53;2021-02-13;96;53;12271;3272;4.0;1.1
53;2021-02-14;0;99;12271;3371;4.0;1.1
53;2021-02-15;239;334;12510;3705;4.1;1.2
53;2021-02-16;528;697;13038;4402;4.3;1.4
53;2021-02-17;391;518;13429;4920;4.4;1.6
53;2021-02-18;547;504;13976;5424;4.6;1.8
53;2021-02-19;895;359;14871;5783;4.9;1.9
53;2021-02-20;139;83;15010;5866;4.9;1.9
53;2021-02-21;1;20;15011;5886;4.9;1.9
53;2021-02-22;161;433;15172;6319;5.0;2.1
53;2021-02-23;59;506;15231;6825;5.0;2.2
53;2021-02-24;137;393;15368;7218;5.0;2.4
53;2021-02-25;457;268;15825;7486;5.2;2.5
53;2021-02-26;437;217;16262;7703;5.3;2.5
53;2021-02-27;86;85;16348;7788;5.4;2.6
53;2021-02-28;0;0;16348;7788;5.4;2.6
53;2021-03-01;231;223;16579;8011;5.4;2.6
53;2021-03-02;246;210;16825;8221;5.5;2.7
53;2021-03-03;321;366;17146;8587;5.6;2.8
53;2021-03-04;859;333;18005;8920;5.9;2.9
53;2021-03-05;660;270;18665;9190;6.1;3.0
53;2021-03-06;447;184;19112;9374;6.3;3.1
53;2021-03-07;276;5;19388;9379;6.3;3.1
53;2021-03-08;375;160;19763;9539;6.5;3.1
53;2021-03-09;878;242;20641;9781;6.8;3.2
53;2021-03-10;807;106;21448;9887;7.0;3.2
53;2021-03-11;1247;228;22695;10115;7.4;3.3
53;2021-03-12;1603;145;24298;10260;8.0;3.4
53;2021-03-13;824;13;25122;10273;8.2;3.4
53;2021-03-14;1;0;25123;10273;8.2;3.4
53;2021-03-15;1001;288;26124;10561;8.6;3.5
53;2021-03-16;1035;331;27159;10892;8.9;3.6
53;2021-03-17;687;257;27846;11149;9.1;3.7
53;2021-03-18;972;345;28818;11494;9.4;3.8
53;2021-03-19;1346;590;30164;12084;9.9;4.0
53;2021-03-20;592;17;30756;12101;10.1;4.0
53;2021-03-21;3;0;30759;12101;10.1;4.0
53;2021-03-22;1213;155;31972;12256;10.5;4.0
53;2021-03-23;1699;71;33671;12327;11.0;4.0
53;2021-03-24;1323;117;34994;12444;11.5;4.1
53;2021-03-25;2323;242;37317;12686;12.2;4.2
53;2021-03-26;1882;152;39199;12838;12.8;4.2
53;2021-03-27;339;3;39538;12841;12.9;4.2
53;2021-03-28;2;0;39540;12841;12.9;4.2
53;2021-03-29;1474;213;41014;13054;13.4;4.3
53;2021-03-30;1944;202;42958;13256;14.1;4.3
53;2021-03-31;1791;223;44749;13479;14.7;4.4
53;2021-04-01;1948;671;46697;14150;15.3;4.6
53;2021-04-02;2075;227;48772;14377;16.0;4.7
53;2021-04-03;414;1;49186;14378;16.1;4.7
53;2021-04-04;10;0;49196;14378;16.1;4.7
53;2021-04-05;9;15;49205;14393;16.1;4.7
53;2021-04-06;1305;504;50510;14897;16.5;4.9
53;2021-04-07;1172;925;51682;15822;16.9;5.2
53;2021-04-08;1663;1006;53345;16828;17.5;5.5
53;2021-04-09;1958;406;55303;17234;18.1;5.6
53;2021-04-10;543;13;55846;17247;18.3;5.6
53;2021-04-11;13;0;55859;17247;18.3;5.6
53;2021-04-12;694;1067;56553;18314;18.5;6.0
53;2021-04-13;1470;1105;58023;19419;19.0;6.4
53;2021-04-14;1022;734;59045;20153;19.3;6.6
53;2021-04-15;1156;1105;60201;21258;19.7;7.0
53;2021-04-16;1271;815;61472;22073;20.1;7.2
53;2021-04-17;279;273;61751;22346;20.2;7.3
53;2021-04-18;0;0;61751;22346;20.2;7.3
53;2021-04-19;681;1061;62432;23407;20.4;7.7
53;2021-04-20;936;1452;63368;24859;20.8;8.1
53;2021-04-21;851;1009;64219;25868;21.0;8.5
53;2021-04-22;1045;1613;65264;27481;21.4;9.0
53;2021-04-23;1327;1052;66591;28533;21.8;9.3
53;2021-04-24;68;7;66659;28540;21.8;9.3
53;2021-04-25;6;39;66665;28579;21.8;9.4
53;2021-04-26;368;1230;67033;29809;22.0;9.8
53;2021-04-27;723;1969;67756;31778;22.2;10.4
53;2021-04-28;977;1393;68733;33171;22.5;10.9
53;2021-04-29;1052;1711;69785;34882;22.9;11.4
53;2021-04-30;1366;1315;71151;36197;23.3;11.9
53;2021-05-01;36;50;71187;36247;23.3;11.9
53;2021-05-02;0;0;71187;36247;23.3;11.9
53;2021-05-03;1570;703;72757;36950;23.8;12.1
53;2021-05-04;1303;1440;74060;38390;24.3;12.6
53;2021-05-05;1611;825;75671;39215;24.8;12.8
53;2021-05-06;1390;1399;77061;40614;25.2;13.3
53;2021-05-07;1537;1301;78598;41915;25.7;13.7
53;2021-05-08;939;36;79537;41951;26.0;13.7
53;2021-05-09;11;2;79548;41953;26.1;13.7
53;2021-05-10;2414;815;81962;42768;26.8;14.0
53;2021-05-11;3097;1281;85059;44049;27.9;14.4
53;2021-05-12;2751;1093;87810;45142;28.8;14.8
53;2021-05-13;350;27;88160;45169;28.9;14.8
53;2021-05-14;2021;677;90181;45846;29.5;15.0
53;2021-05-15;1058;63;91239;45909;29.9;15.0
53;2021-05-16;3;0;91242;45909;29.9;15.0
53;2021-05-17;1701;1196;92943;47105;30.4;15.4
53;2021-05-18;1880;1550;94823;48655;31.1;15.9
53;2021-05-19;2303;746;97126;49401;31.8;16.2
53;2021-05-20;3216;866;100342;50267;32.9;16.5
53;2021-05-21;2798;827;103140;51094;33.8;16.7
53;2021-05-22;21;59;103161;51153;33.8;16.8
53;2021-05-23;0;0;103161;51153;33.8;16.8
53;2021-05-24;8;6;103169;51159;33.8;16.8
53;2021-05-25;1820;802;104989;51961;34.4;17.0
53;2021-05-26;1853;908;106842;52869;35.0;17.3
53;2021-05-27;3072;1079;109914;53948;36.0;17.7
53;2021-05-28;2562;874;112476;54822;36.8;18.0
53;2021-05-29;846;240;113322;55062;37.1;18.0
53;2021-05-30;18;6;113340;55068;37.1;18.0
53;2021-05-31;2565;802;115905;55870;38.0;18.3
53;2021-06-01;3488;1254;119393;57124;39.1;18.7
53;2021-06-02;3183;521;122576;57645;40.1;18.9
53;2021-06-03;4198;784;126774;58429;41.5;19.1
53;2021-06-04;3179;1265;129953;59694;42.6;19.5
53;2021-06-05;137;245;130090;59939;42.6;19.6
53;2021-06-06;1;4;130091;59943;42.6;19.6
53;2021-06-07;2629;923;132720;60866;43.5;19.9
53;2021-06-08;3588;1128;136308;61994;44.6;20.3
53;2021-06-09;2454;943;138762;62937;45.4;20.6
53;2021-06-10;3521;842;142283;63779;46.6;20.9
53;2021-06-11;2964;1210;145247;64989;47.6;21.3
53;2021-06-12;108;138;145355;65127;47.6;21.3
53;2021-06-13;10;2;145365;65129;47.6;21.3
53;2021-06-14;1600;1788;146965;66917;48.1;21.9
53;2021-06-15;1898;2263;148863;69180;48.7;22.7
53;2021-06-16;1828;1733;150691;70913;49.3;23.2
53;2021-06-17;3011;1651;153702;72564;50.3;23.8
53;2021-06-18;2705;1805;156407;74369;51.2;24.4
53;2021-06-19;761;1164;157168;75533;51.5;24.7
53;2021-06-20;3;479;157171;76012;51.5;24.9
53;2021-06-21;918;2523;158089;78535;51.8;25.7
53;2021-06-22;1299;3452;159388;81987;52.2;26.8
53;2021-06-23;1362;2892;160750;84879;52.6;27.8
53;2021-06-24;1802;2033;162552;86912;53.2;28.5
53;2021-06-25;1785;2044;164337;88956;53.8;29.1
53;2021-06-26;977;351;165314;89307;54.1;29.2
53;2021-06-27;8;8;165322;89315;54.1;29.2
53;2021-06-28;662;2899;165984;92214;54.4;30.2
53;2021-06-29;858;3645;166842;95859;54.6;31.4
53;2021-06-30;749;1518;167591;97377;54.9;31.9
53;2021-07-01;1507;2630;169098;100007;55.4;32.7
53;2021-07-02;1528;2025;170626;102032;55.9;33.4
53;2021-07-03;858;574;171484;102606;56.2;33.6
53;2021-07-04;0;4;171484;102610;56.2;33.6
53;2021-07-05;542;2057;172026;104667;56.3;34.3
53;2021-07-06;859;3615;172885;108282;56.6;35.5
53;2021-07-07;1024;2652;173909;110934;57.0;36.3
53;2021-07-08;1313;3116;175222;114050;57.4;37.3
53;2021-07-09;1131;3399;176353;117449;57.8;38.5
53;2021-07-10;422;1001;176775;118450;57.9;38.8
53;2021-07-11;12;20;176787;118470;57.9;38.8
53;2021-07-12;503;3706;177290;122176;58.1;40.0
53;2021-07-13;894;4762;178184;126938;58.4;41.6
53;2021-07-14;104;284;178288;127222;58.4;41.7
53;2021-07-15;1112;4342;179400;131564;58.7;43.1
53;2021-07-16;1248;3847;180648;135411;59.2;44.3
53;2021-07-17;1317;300;181965;135711;59.6;44.4
53;2021-07-18;27;20;181992;135731;59.6;44.4
53;2021-07-19;734;3426;182726;139157;59.8;45.6
53;2021-07-20;985;4122;183711;143279;60.2;46.9
53;2021-07-21;686;3274;184397;146553;60.4;48.0
53;2021-07-22;1512;3522;185909;150075;60.9;49.1
53;2021-07-23;1603;3758;187512;153833;61.4;50.4
53;2021-07-24;956;280;188468;154113;61.7;50.5
53;2021-07-25;60;24;188528;154137;61.7;50.5
53;2021-07-26;1727;1941;190255;156078;62.3;51.1
53;2021-07-27;2356;2820;192611;158898;63.1;52.0
53;2021-07-28;2145;2813;194756;161711;63.8;53.0
53;2021-07-29;2491;2546;197247;164257;64.6;53.8
53;2021-07-30;1828;2647;199075;166904;65.2;54.7
53;2021-07-31;626;229;199701;167133;65.4;54.7
53;2021-08-01;37;25;199738;167158;65.4;54.7
53;2021-08-02;2083;1732;201821;168890;66.1;55.3
53;2021-08-03;2415;1905;204236;170795;66.9;55.9
53;2021-08-04;2475;1863;206711;172658;67.7;56.5
53;2021-08-05;2869;1541;209580;174199;68.6;57.0
53;2021-08-06;2517;1719;212097;175918;69.5;57.6
53;2021-08-07;483;272;212580;176190;69.6;57.7
53;2021-08-08;6;19;212586;176209;69.6;57.7
53;2021-08-09;1839;1649;214425;177858;70.2;58.2
53;2021-08-10;2324;1748;216749;179606;71.0;58.8
53;2021-08-11;1681;867;218430;180473;71.5;59.1
53;2021-08-12;2007;984;220437;181457;72.2;59.4
53;2021-08-13;2039;1314;222476;182771;72.9;59.9
53;2021-08-14;66;63;222542;182834;72.9;59.9
53;2021-08-15;1;2;222543;182836;72.9;59.9
53;2021-08-16;1337;1596;223880;184432;73.3;60.4
53;2021-08-17;1548;1657;225428;186089;73.8;60.9
53;2021-08-18;1515;1600;226943;187689;74.3;61.5
53;2021-08-19;1374;1972;228317;189661;74.8;62.1
53;2021-08-20;1099;2082;229416;191743;75.1;62.8
53;2021-08-21;189;341;229605;192084;75.2;62.9
53;2021-08-22;0;0;229605;192084;75.2;62.9
53;2021-08-23;843;1915;230448;193999;75.5;63.5
53;2021-08-24;903;2117;231351;196116;75.8;64.2
53;2021-08-25;915;2272;232266;198388;76.1;65.0
53;2021-08-26;666;2614;232932;201002;76.3;65.8
53;2021-08-27;753;2644;233685;203646;76.5;66.7
53;2021-08-28;49;133;233734;203779;76.5;66.7
53;2021-08-29;12;31;233746;203810;76.5;66.7
53;2021-08-30;619;2107;234365;205917;76.7;67.4
53;2021-08-31;762;2920;235127;208837;77.0;68.4
53;2021-09-01;341;1637;235468;210474;77.1;68.9
53;2021-09-02;441;1823;235909;212297;77.3;69.5
53;2021-09-03;449;2494;236358;214791;77.4;70.3
53;2021-09-04;115;213;236473;215004;77.4;70.4
53;2021-09-05;1;12;236474;215016;77.4;70.4
53;2021-09-06;300;1664;236774;216680;77.5;71.0
53;2021-09-07;286;1944;237060;218624;77.6;71.6
53;2021-09-08;419;2157;237479;220781;77.8;72.3
53;2021-09-09;236;1461;237715;222242;77.8;72.8
53;2021-09-10;382;2090;238097;224332;78.0;73.5
53;2021-09-11;39;137;238136;224469;78.0;73.5
53;2021-09-12;0;1;238136;224470;78.0;73.5
53;2021-09-13;230;1197;238366;225667;78.1;73.9
53;2021-09-14;242;1049;238608;226716;78.1;74.2
53;2021-09-15;331;1069;238939;227785;78.2;74.6
53;2021-09-16;305;380;239244;228165;78.3;74.7
53;2021-09-17;429;1057;239673;229222;78.5;75.1
53;2021-09-18;44;70;239717;229292;78.5;75.1
53;2021-09-19;8;14;239725;229306;78.5;75.1
53;2021-09-20;122;382;239847;229688;78.5;75.2
53;2021-09-21;248;651;240095;230339;78.6;75.4
53;2021-09-22;193;664;240288;231003;78.7;75.6
53;2021-09-23;133;395;240421;231398;78.7;75.8
53;2021-09-24;197;638;240618;232036;78.8;76.0
53;2021-09-25;27;50;240645;232086;78.8;76.0
53;2021-09-26;0;0;240645;232086;78.8;76.0
53;2021-09-27;159;374;240804;232460;78.9;76.1
53;2021-09-28;163;280;240967;232740;78.9;76.2
53;2021-09-29;159;489;241126;233229;79.0;76.4
54;2020-12-27;0;0;0;0;0.0;0.0
54;2020-12-28;1;0;1;0;0.0;0.0
54;2020-12-29;0;0;1;0;0.0;0.0
54;2020-12-30;0;0;1;0;0.0;0.0
54;2020-12-31;10;0;11;0;0.0;0.0
54;2021-01-01;0;0;11;0;0.0;0.0
54;2021-01-02;0;0;11;0;0.0;0.0
54;2021-01-03;1;0;12;0;0.0;0.0
54;2021-01-04;163;0;175;0;0.0;0.0
54;2021-01-05;396;0;571;0;0.1;0.0
54;2021-01-06;650;1;1221;1;0.2;0.0
54;2021-01-07;816;2;2037;3;0.3;0.0
54;2021-01-08;706;3;2743;6;0.4;0.0
54;2021-01-09;81;0;2824;6;0.4;0.0
54;2021-01-10;78;0;2902;6;0.4;0.0
54;2021-01-11;974;3;3876;9;0.5;0.0
54;2021-01-12;1181;1;5057;10;0.7;0.0
54;2021-01-13;2426;7;7483;17;1.0;0.0
54;2021-01-14;3401;23;10884;40;1.5;0.0
54;2021-01-15;2717;13;13601;53;1.9;0.0
54;2021-01-16;815;4;14416;57;2.0;0.0
54;2021-01-17;209;0;14625;57;2.0;0.0
54;2021-01-18;1557;5;16182;62;2.2;0.0
54;2021-01-19;1707;0;17889;62;2.4;0.0
54;2021-01-20;1525;4;19414;66;2.7;0.0
54;2021-01-21;1371;4;20785;70;2.8;0.0
54;2021-01-22;1092;8;21877;78;3.0;0.0
54;2021-01-23;478;1;22355;79;3.1;0.0
54;2021-01-24;66;0;22421;79;3.1;0.0
54;2021-01-25;946;28;23367;107;3.2;0.0
54;2021-01-26;142;0;23509;107;3.2;0.0
54;2021-01-27;12;148;23521;255;3.2;0.0
54;2021-01-28;32;205;23553;460;3.2;0.1
54;2021-01-29;18;234;23571;694;3.2;0.1
54;2021-01-30;7;0;23578;694;3.2;0.1
54;2021-01-31;1;0;23579;694;3.2;0.1
54;2021-02-01;13;740;23592;1434;3.2;0.2
54;2021-02-02;24;914;23616;2348;3.2;0.3
54;2021-02-03;363;1390;23979;3738;3.3;0.5
54;2021-02-04;739;2229;24718;5967;3.4;0.8
54;2021-02-05;799;1663;25517;7630;3.5;1.0
54;2021-02-06;204;249;25721;7879;3.5;1.1
54;2021-02-07;4;100;25725;7979;3.5;1.1
54;2021-02-08;117;849;25842;8828;3.5;1.2
54;2021-02-09;305;932;26147;9760;3.6;1.3
54;2021-02-10;386;688;26533;10448;3.6;1.4
54;2021-02-11;293;711;26826;11159;3.7;1.5
54;2021-02-12;446;1098;27272;12257;3.7;1.7
54;2021-02-13;148;217;27420;12474;3.8;1.7
54;2021-02-14;9;8;27429;12482;3.8;1.7
54;2021-02-15;428;961;27857;13443;3.8;1.8
54;2021-02-16;401;1067;28258;14510;3.9;2.0
54;2021-02-17;518;820;28776;15330;3.9;2.1
54;2021-02-18;595;679;29371;16009;4.0;2.2
54;2021-02-19;519;642;29890;16651;4.1;2.3
54;2021-02-20;34;248;29924;16899;4.1;2.3
54;2021-02-21;3;21;29927;16920;4.1;2.3
54;2021-02-22;484;530;30411;17450;4.2;2.4
54;2021-02-23;679;506;31090;17956;4.3;2.5
54;2021-02-24;728;336;31818;18292;4.4;2.5
54;2021-02-25;1474;663;33292;18955;4.6;2.6
54;2021-02-26;1776;745;35068;19700;4.8;2.7
54;2021-02-27;698;108;35766;19808;4.9;2.7
54;2021-02-28;11;26;35777;19834;4.9;2.7
54;2021-03-01;643;193;36420;20027;5.0;2.7
54;2021-03-02;1495;146;37915;20173;5.2;2.8
54;2021-03-03;1758;61;39673;20234;5.4;2.8
54;2021-03-04;2027;98;41700;20332;5.7;2.8
54;2021-03-05;2797;144;44497;20476;6.1;2.8
54;2021-03-06;4045;108;48542;20584;6.6;2.8
54;2021-03-07;2626;70;51168;20654;7.0;2.8
54;2021-03-08;1337;63;52505;20717;7.2;2.8
54;2021-03-09;2649;104;55154;20821;7.6;2.9
54;2021-03-10;3195;106;58349;20927;8.0;2.9
54;2021-03-11;3388;98;61737;21025;8.5;2.9
54;2021-03-12;4978;183;66715;21208;9.1;2.9
54;2021-03-13;4205;111;70920;21319;9.7;2.9
54;2021-03-14;543;40;71463;21359;9.8;2.9
54;2021-03-15;1719;103;73182;21462;10.0;2.9
54;2021-03-16;1733;156;74915;21618;10.3;3.0
54;2021-03-17;2082;144;76997;21762;10.5;3.0
54;2021-03-18;2062;167;79059;21929;10.8;3.0
54;2021-03-19;3320;266;82379;22195;11.3;3.0
54;2021-03-20;2311;72;84690;22267;11.6;3.0
54;2021-03-21;295;14;84985;22281;11.6;3.1
54;2021-03-22;1034;303;86019;22584;11.8;3.1
54;2021-03-23;1937;483;87956;23067;12.0;3.2
54;2021-03-24;2194;703;90150;23770;12.3;3.3
54;2021-03-25;3173;716;93323;24486;12.8;3.4
54;2021-03-26;3513;800;96836;25286;13.3;3.5
54;2021-03-27;2419;282;99255;25568;13.6;3.5
54;2021-03-28;280;6;99535;25574;13.6;3.5
54;2021-03-29;1668;377;101203;25951;13.9;3.6
54;2021-03-30;2559;956;103762;26907;14.2;3.7
54;2021-03-31;2599;1135;106361;28042;14.6;3.8
54;2021-04-01;3237;1281;109598;29323;15.0;4.0
54;2021-04-02;2962;1676;112560;30999;15.4;4.2
54;2021-04-03;1264;1302;113824;32301;15.6;4.4
54;2021-04-04;137;418;113961;32719;15.6;4.5
54;2021-04-05;144;572;114105;33291;15.6;4.6
54;2021-04-06;1268;1646;115373;34937;15.8;4.8
54;2021-04-07;924;2252;116297;37189;15.9;5.1
54;2021-04-08;2325;2424;118622;39613;16.2;5.4
54;2021-04-09;4117;3127;122739;42740;16.8;5.9
54;2021-04-10;3208;1677;125947;44417;17.2;6.1
54;2021-04-11;206;945;126153;45362;17.3;6.2
54;2021-04-12;2198;1528;128351;46890;17.6;6.4
54;2021-04-13;3001;1969;131352;48859;18.0;6.7
54;2021-04-14;3262;1862;134614;50721;18.4;6.9
54;2021-04-15;2876;2297;137490;53018;18.8;7.3
54;2021-04-16;3141;2598;140631;55616;19.3;7.6
54;2021-04-17;3475;1487;144106;57103;19.7;7.8
54;2021-04-18;64;245;144170;57348;19.7;7.9
54;2021-04-19;2464;1081;146634;58429;20.1;8.0
54;2021-04-20;3012;1245;149646;59674;20.5;8.2
54;2021-04-21;4401;1630;154047;61304;21.1;8.4
54;2021-04-22;3722;2386;157769;63690;21.6;8.7
54;2021-04-23;3865;2083;161634;65773;22.1;9.0
54;2021-04-24;2347;1039;163981;66812;22.5;9.1
54;2021-04-25;284;276;164265;67088;22.5;9.2
54;2021-04-26;2306;1272;166571;68360;22.8;9.4
54;2021-04-27;3288;1439;169859;69799;23.3;9.6
54;2021-04-28;2974;1940;172833;71739;23.7;9.8
54;2021-04-29;3796;2074;176629;73813;24.2;10.1
54;2021-04-30;4491;1952;181120;75765;24.8;10.4
54;2021-05-01;2265;804;183385;76569;25.1;10.5
54;2021-05-02;229;68;183614;76637;25.1;10.5
54;2021-05-03;3096;937;186710;77574;25.6;10.6
54;2021-05-04;3515;1452;190225;79026;26.0;10.8
54;2021-05-05;4895;1409;195120;80435;26.7;11.0
54;2021-05-06;4434;2797;199554;83232;27.3;11.4
54;2021-05-07;4823;3397;204377;86629;28.0;11.9
54;2021-05-08;2030;644;206407;87273;28.3;11.9
54;2021-05-09;375;136;206782;87409;28.3;12.0
54;2021-05-10;3207;2234;209989;89643;28.7;12.3
54;2021-05-11;5491;2932;215480;92575;29.5;12.7
54;2021-05-12;4144;3386;219624;95961;30.1;13.1
54;2021-05-13;2647;492;222271;96453;30.4;13.2
54;2021-05-14;6884;2002;229155;98455;31.4;13.5
54;2021-05-15;5485;1322;234640;99777;32.1;13.7
54;2021-05-16;944;109;235584;99886;32.3;13.7
54;2021-05-17;3799;829;239383;100715;32.8;13.8
54;2021-05-18;3288;1104;242671;101819;33.2;13.9
54;2021-05-19;3464;1514;246135;103333;33.7;14.1
54;2021-05-20;4538;1616;250673;104949;34.3;14.4
54;2021-05-21;6752;2502;257425;107451;35.2;14.7
54;2021-05-22;5660;1375;263085;108826;36.0;14.9
54;2021-05-23;504;55;263589;108881;36.1;14.9
54;2021-05-24;1444;343;265033;109224;36.3;15.0
54;2021-05-25;4200;1533;269233;110757;36.9;15.2
54;2021-05-26;3535;2214;272768;112971;37.3;15.5
54;2021-05-27;4180;2419;276948;115390;37.9;15.8
54;2021-05-28;4988;3552;281936;118942;38.6;16.3
54;2021-05-29;3844;3996;285780;122938;39.1;16.8
54;2021-05-30;127;83;285907;123021;39.1;16.8
54;2021-05-31;2940;3058;288847;126079;39.5;17.3
54;2021-06-01;2622;4194;291469;130273;39.9;17.8
54;2021-06-02;2165;4088;293634;134361;40.2;18.4
54;2021-06-03;3146;5647;296780;140008;40.6;19.2
54;2021-06-04;5103;5467;301883;145475;41.3;19.9
54;2021-06-05;2342;3280;304225;148755;41.7;20.4
54;2021-06-06;72;236;304297;148991;41.7;20.4
54;2021-06-07;3705;2935;308002;151926;42.2;20.8
54;2021-06-08;4543;4267;312545;156193;42.8;21.4
54;2021-06-09;6003;3311;318548;159504;43.6;21.8
54;2021-06-10;5296;4446;323844;163950;44.3;22.4
54;2021-06-11;5022;4919;328866;168869;45.0;23.1
54;2021-06-12;4242;3226;333108;172095;45.6;23.6
54;2021-06-13;54;210;333162;172305;45.6;23.6
54;2021-06-14;2333;3594;335495;175899;45.9;24.1
54;2021-06-15;2831;4727;338326;180626;46.3;24.7
54;2021-06-16;3490;5657;341816;186283;46.8;25.5
54;2021-06-17;3138;5219;344954;191502;47.2;26.2
54;2021-06-18;4157;6238;349111;197740;47.8;27.1
54;2021-06-19;2648;3126;351759;200866;48.2;27.5
54;2021-06-20;101;339;351860;201205;48.2;27.5
54;2021-06-21;2557;4767;354417;205972;48.5;28.2
54;2021-06-22;2047;6221;356464;212193;48.8;29.1
54;2021-06-23;2245;5592;358709;217785;49.1;29.8
54;2021-06-24;2090;3454;360799;221239;49.4;30.3
54;2021-06-25;2195;7056;362994;228295;49.7;31.3
54;2021-06-26;2383;5671;365377;233966;50.0;32.0
54;2021-06-27;134;607;365511;234573;50.0;32.1
54;2021-06-28;1960;4355;367471;238928;50.3;32.7
54;2021-06-29;1941;5204;369412;244132;50.6;33.4
54;2021-06-30;1982;5122;371394;249254;50.8;34.1
54;2021-07-01;2144;5983;373538;255237;51.1;34.9
54;2021-07-02;2815;7563;376353;262800;51.5;36.0
54;2021-07-03;2836;4095;379189;266895;51.9;36.5
54;2021-07-04;196;498;379385;267393;51.9;36.6
54;2021-07-05;1667;4250;381052;271643;52.2;37.2
54;2021-07-06;2000;5079;383052;276722;52.4;37.9
54;2021-07-07;1903;4843;384955;281565;52.7;38.5
54;2021-07-08;1679;4111;386634;285676;52.9;39.1
54;2021-07-09;3204;6025;389838;291701;53.4;39.9
54;2021-07-10;2545;4375;392383;296076;53.7;40.5
54;2021-07-11;9;103;392392;296179;53.7;40.6
54;2021-07-12;2100;4695;394492;300874;54.0;41.2
54;2021-07-13;2620;4970;397112;305844;54.4;41.9
54;2021-07-14;1535;1506;398647;307350;54.6;42.1
54;2021-07-15;3171;4834;401818;312184;55.0;42.7
54;2021-07-16;4664;6213;406482;318397;55.7;43.6
54;2021-07-17;4005;4766;410487;323163;56.2;44.2
54;2021-07-18;1803;1687;412290;324850;56.4;44.5
54;2021-07-19;2592;4044;414882;328894;56.8;45.0
54;2021-07-20;2909;4811;417791;333705;57.2;45.7
54;2021-07-21;3134;6333;420925;340038;57.6;46.6
54;2021-07-22;3282;5730;424207;345768;58.1;47.3
54;2021-07-23;3983;6976;428190;352744;58.6;48.3
54;2021-07-24;2945;5320;431135;358064;59.0;49.0
54;2021-07-25;71;50;431206;358114;59.0;49.0
54;2021-07-26;2981;4171;434187;362285;59.4;49.6
54;2021-07-27;3717;4008;437904;366293;60.0;50.1
54;2021-07-28;5208;3875;443112;370168;60.7;50.7
54;2021-07-29;5158;3206;448270;373374;61.4;51.1
54;2021-07-30;5133;5001;453403;378375;62.1;51.8
54;2021-07-31;4537;3232;457940;381607;62.7;52.2
54;2021-08-01;257;73;458197;381680;62.7;52.3
54;2021-08-02;3097;3704;461294;385384;63.2;52.8
54;2021-08-03;4109;2918;465403;388302;63.7;53.2
54;2021-08-04;4427;2703;469830;391005;64.3;53.5
54;2021-08-05;4620;2432;474450;393437;65.0;53.9
54;2021-08-06;5452;3990;479902;397427;65.7;54.4
54;2021-08-07;3672;2829;483574;400256;66.2;54.8
54;2021-08-08;248;114;483822;400370;66.2;54.8
54;2021-08-09;2979;2694;486801;403064;66.6;55.2
54;2021-08-10;2563;3767;489364;406831;67.0;55.7
54;2021-08-11;2335;2565;491699;409396;67.3;56.1
54;2021-08-12;2191;3006;493890;412402;67.6;56.5
54;2021-08-13;2630;4448;496520;416850;68.0;57.1
54;2021-08-14;1436;2077;497956;418927;68.2;57.4
54;2021-08-15;31;43;497987;418970;68.2;57.4
54;2021-08-16;1861;3431;499848;422401;68.4;57.8
54;2021-08-17;1948;3312;501796;425713;68.7;58.3
54;2021-08-18;1501;4105;503297;429818;68.9;58.8
54;2021-08-19;1256;2789;504553;432607;69.1;59.2
54;2021-08-20;1877;4933;506430;437540;69.3;59.9
54;2021-08-21;1469;4014;507899;441554;69.5;60.5
54;2021-08-22;63;28;507962;441582;69.5;60.5
54;2021-08-23;1223;3857;509185;445439;69.7;61.0
54;2021-08-24;1139;3156;510324;448595;69.9;61.4
54;2021-08-25;1425;4383;511749;452978;70.1;62.0
54;2021-08-26;1006;3108;512755;456086;70.2;62.4
54;2021-08-27;1523;5325;514278;461411;70.4;63.2
54;2021-08-28;1143;4279;515421;465690;70.6;63.8
54;2021-08-29;16;50;515437;465740;70.6;63.8
54;2021-08-30;1212;4201;516649;469941;70.7;64.3
54;2021-08-31;1065;4704;517714;474645;70.9;65.0
54;2021-09-01;1104;3756;518818;478401;71.0;65.5
54;2021-09-02;727;2168;519545;480569;71.1;65.8
54;2021-09-03;980;3214;520525;483783;71.3;66.2
54;2021-09-04;1166;3430;521691;487213;71.4;66.7
54;2021-09-05;25;32;521716;487245;71.4;66.7
54;2021-09-06;493;1469;522209;488714;71.5;66.9
54;2021-09-07;592;1597;522801;490311;71.6;67.1
54;2021-09-08;625;1888;523426;492199;71.7;67.4
54;2021-09-09;925;2078;524351;494277;71.8;67.7
54;2021-09-10;981;2781;525332;497058;71.9;68.1
54;2021-09-11;725;2696;526057;499754;72.0;68.4
54;2021-09-12;80;118;526137;499872;72.0;68.4
54;2021-09-13;634;1257;526771;501129;72.1;68.6
54;2021-09-14;609;1475;527380;502604;72.2;68.8
54;2021-09-15;627;1746;528007;504350;72.3;69.1
54;2021-09-16;633;713;528640;505063;72.4;69.1
54;2021-09-17;875;1528;529515;506591;72.5;69.4
54;2021-09-18;480;1436;529995;508027;72.6;69.6
54;2021-09-19;28;38;530023;508065;72.6;69.6
54;2021-09-20;370;658;530393;508723;72.6;69.7
54;2021-09-21;439;939;530832;509662;72.7;69.8
54;2021-09-22;394;1119;531226;510781;72.7;69.9
54;2021-09-23;297;844;531523;511625;72.8;70.0
54;2021-09-24;516;1175;532039;512800;72.8;70.2
54;2021-09-25;317;1076;532356;513876;72.9;70.4
54;2021-09-26;9;30;532365;513906;72.9;70.4
54;2021-09-27;229;675;532594;514581;72.9;70.5
54;2021-09-28;329;629;532923;515210;73.0;70.5
54;2021-09-29;372;805;533295;516015;73.0;70.6
55;2020-12-27;0;0;0;0;0.0;0.0
55;2020-12-28;0;0;0;0;0.0;0.0
55;2020-12-29;0;0;0;0;0.0;0.0
55;2020-12-30;0;0;0;0;0.0;0.0
55;2020-12-31;0;0;0;0;0.0;0.0
55;2021-01-01;0;0;0;0;0.0;0.0
55;2021-01-02;0;0;0;0;0.0;0.0
55;2021-01-03;0;0;0;0;0.0;0.0
55;2021-01-04;1;0;1;0;0.0;0.0
55;2021-01-05;0;0;1;0;0.0;0.0
55;2021-01-06;0;0;1;0;0.0;0.0
55;2021-01-07;122;0;123;0;0.1;0.0
55;2021-01-08;127;0;250;0;0.1;0.0
55;2021-01-09;52;0;302;0;0.2;0.0
55;2021-01-10;0;0;302;0;0.2;0.0
55;2021-01-11;128;1;430;1;0.2;0.0
55;2021-01-12;119;0;549;1;0.3;0.0
55;2021-01-13;134;0;683;1;0.4;0.0
55;2021-01-14;645;7;1328;8;0.7;0.0
55;2021-01-15;237;0;1565;8;0.9;0.0
55;2021-01-16;62;0;1627;8;0.9;0.0
55;2021-01-17;1;0;1628;8;0.9;0.0
55;2021-01-18;414;1;2042;9;1.1;0.0
55;2021-01-19;352;3;2394;12;1.3;0.0
55;2021-01-20;456;2;2850;14;1.6;0.0
55;2021-01-21;430;0;3280;14;1.8;0.0
55;2021-01-22;390;0;3670;14;2.0;0.0
55;2021-01-23;49;0;3719;14;2.0;0.0
55;2021-01-24;0;0;3719;14;2.0;0.0
55;2021-01-25;436;0;4155;14;2.3;0.0
55;2021-01-26;431;0;4586;14;2.5;0.0
55;2021-01-27;424;0;5010;14;2.8;0.0
55;2021-01-28;485;97;5495;111;3.0;0.1
55;2021-01-29;159;50;5654;161;3.1;0.1
55;2021-01-30;92;27;5746;188;3.2;0.1
55;2021-01-31;0;0;5746;188;3.2;0.1
55;2021-02-01;153;155;5899;343;3.2;0.2
55;2021-02-02;159;133;6058;476;3.3;0.3
55;2021-02-03;53;139;6111;615;3.4;0.3
55;2021-02-04;235;378;6346;993;3.5;0.5
55;2021-02-05;174;138;6520;1131;3.6;0.6
55;2021-02-06;62;56;6582;1187;3.6;0.7
55;2021-02-07;2;53;6584;1240;3.6;0.7
55;2021-02-08;0;17;6584;1257;3.6;0.7
55;2021-02-09;92;115;6676;1372;3.7;0.8
55;2021-02-10;65;23;6741;1395;3.7;0.8
55;2021-02-11;175;93;6916;1488;3.8;0.8
55;2021-02-12;94;27;7010;1515;3.9;0.8
55;2021-02-13;0;0;7010;1515;3.9;0.8
55;2021-02-14;0;0;7010;1515;3.9;0.8
55;2021-02-15;15;306;7025;1821;3.9;1.0
55;2021-02-16;143;277;7168;2098;3.9;1.2
55;2021-02-17;26;388;7194;2486;4.0;1.4
55;2021-02-18;20;258;7214;2744;4.0;1.5
55;2021-02-19;125;245;7339;2989;4.0;1.6
55;2021-02-20;11;0;7350;2989;4.0;1.6
55;2021-02-21;0;0;7350;2989;4.0;1.6
55;2021-02-22;55;365;7405;3354;4.1;1.8
55;2021-02-23;85;366;7490;3720;4.1;2.0
55;2021-02-24;72;347;7562;4067;4.2;2.2
55;2021-02-25;270;621;7832;4688;4.3;2.6
55;2021-02-26;324;205;8156;4893;4.5;2.7
55;2021-02-27;125;85;8281;4978;4.6;2.7
55;2021-02-28;2;8;8283;4986;4.6;2.7
55;2021-03-01;77;118;8360;5104;4.6;2.8
55;2021-03-02;125;136;8485;5240;4.7;2.9
55;2021-03-03;198;3;8683;5243;4.8;2.9
55;2021-03-04;238;40;8921;5283;4.9;2.9
55;2021-03-05;362;43;9283;5326;5.1;2.9
55;2021-03-06;224;6;9507;5332;5.2;2.9
55;2021-03-07;74;1;9581;5333;5.3;2.9
55;2021-03-08;328;49;9909;5382;5.5;3.0
55;2021-03-09;635;48;10544;5430;5.8;3.0
55;2021-03-10;397;24;10941;5454;6.0;3.0
55;2021-03-11;597;139;11538;5593;6.4;3.1
55;2021-03-12;816;89;12354;5682;6.8;3.1
55;2021-03-13;522;12;12876;5694;7.1;3.1
55;2021-03-14;14;0;12890;5694;7.1;3.1
55;2021-03-15;393;23;13283;5717;7.3;3.1
55;2021-03-16;568;105;13851;5822;7.6;3.2
55;2021-03-17;683;21;14534;5843;8.0;3.2
55;2021-03-18;323;23;14857;5866;8.2;3.2
55;2021-03-19;471;59;15328;5925;8.4;3.3
55;2021-03-20;254;15;15582;5940;8.6;3.3
55;2021-03-21;1;1;15583;5941;8.6;3.3
55;2021-03-22;474;20;16057;5961;8.8;3.3
55;2021-03-23;972;65;17029;6026;9.4;3.3
55;2021-03-24;802;43;17831;6069;9.8;3.3
55;2021-03-25;1097;81;18928;6150;10.4;3.4
55;2021-03-26;602;36;19530;6186;10.8;3.4
55;2021-03-27;256;23;19786;6209;10.9;3.4
55;2021-03-28;0;0;19786;6209;10.9;3.4
55;2021-03-29;944;41;20730;6250;11.4;3.4
55;2021-03-30;1425;73;22155;6323;12.2;3.5
55;2021-03-31;1483;70;23638;6393;13.0;3.5
55;2021-04-01;1207;129;24845;6522;13.7;3.6
55;2021-04-02;902;69;25747;6591;14.2;3.6
55;2021-04-03;93;12;25840;6603;14.2;3.6
55;2021-04-04;2;0;25842;6603;14.2;3.6
55;2021-04-05;6;12;25848;6615;14.2;3.6
55;2021-04-06;933;276;26781;6891;14.7;3.8
55;2021-04-07;993;237;27774;7128;15.3;3.9
55;2021-04-08;1649;420;29423;7548;16.2;4.2
55;2021-04-09;1430;261;30853;7809;17.0;4.3
55;2021-04-10;243;175;31096;7984;17.1;4.4
55;2021-04-11;452;22;31548;8006;17.4;4.4
55;2021-04-12;855;328;32403;8334;17.8;4.6
55;2021-04-13;1355;526;33758;8860;18.6;4.9
55;2021-04-14;1372;726;35130;9586;19.3;5.3
55;2021-04-15;1637;458;36767;10044;20.2;5.5
55;2021-04-16;704;379;37471;10423;20.6;5.7
55;2021-04-17;677;31;38148;10454;21.0;5.8
55;2021-04-18;38;18;38186;10472;21.0;5.8
55;2021-04-19;961;346;39147;10818;21.6;6.0
55;2021-04-20;1173;771;40320;11589;22.2;6.4
55;2021-04-21;990;640;41310;12229;22.7;6.7
55;2021-04-22;1099;674;42409;12903;23.3;7.1
55;2021-04-23;1424;598;43833;13501;24.1;7.4
55;2021-04-24;313;124;44146;13625;24.3;7.5
55;2021-04-25;384;51;44530;13676;24.5;7.5
55;2021-04-26;478;815;45008;14491;24.8;8.0
55;2021-04-27;570;994;45578;15485;25.1;8.5
55;2021-04-28;931;815;46509;16300;25.6;9.0
55;2021-04-29;1118;857;47627;17157;26.2;9.4
55;2021-04-30;1280;620;48907;17777;26.9;9.8
55;2021-05-01;153;131;49060;17908;27.0;9.9
55;2021-05-02;2;3;49062;17911;27.0;9.9
55;2021-05-03;1209;629;50271;18540;27.7;10.2
55;2021-05-04;683;1178;50954;19718;28.1;10.9
55;2021-05-05;657;1070;51611;20788;28.4;11.4
55;2021-05-06;1350;1157;52961;21945;29.2;12.1
55;2021-05-07;1433;554;54394;22499;29.9;12.4
55;2021-05-08;156;77;54550;22576;30.0;12.4
55;2021-05-09;62;522;54612;23098;30.1;12.7
55;2021-05-10;860;1029;55472;24127;30.5;13.3
55;2021-05-11;1072;1371;56544;25498;31.1;14.0
55;2021-05-12;1031;1760;57575;27258;31.7;15.0
55;2021-05-13;99;75;57674;27333;31.8;15.0
55;2021-05-14;352;555;58026;27888;31.9;15.4
55;2021-05-15;291;486;58317;28374;32.1;15.6
55;2021-05-16;3;10;58320;28384;32.1;15.6
55;2021-05-17;1028;841;59348;29225;32.7;16.1
55;2021-05-18;1567;886;60915;30111;33.5;16.6
55;2021-05-19;1809;778;62724;30889;34.5;17.0
55;2021-05-20;2215;730;64939;31619;35.8;17.4
55;2021-05-21;2010;799;66949;32418;36.9;17.8
55;2021-05-22;198;167;67147;32585;37.0;17.9
55;2021-05-23;23;120;67170;32705;37.0;18.0
55;2021-05-24;0;0;67170;32705;37.0;18.0
55;2021-05-25;1347;651;68517;33356;37.7;18.4
55;2021-05-26;1674;1017;70191;34373;38.6;18.9
55;2021-05-27;1321;981;71512;35354;39.4;19.5
55;2021-05-28;1521;928;73033;36282;40.2;20.0
55;2021-05-29;1403;695;74436;36977;41.0;20.4
55;2021-05-30;15;205;74451;37182;41.0;20.5
55;2021-05-31;1048;1130;75499;38312;41.6;21.1
55;2021-06-01;919;957;76418;39269;42.1;21.6
55;2021-06-02;1162;979;77580;40248;42.7;22.2
55;2021-06-03;703;538;78283;40786;43.1;22.5
55;2021-06-04;1388;1098;79671;41884;43.9;23.1
55;2021-06-05;1366;278;81037;42162;44.6;23.2
55;2021-06-06;0;2;81037;42164;44.6;23.2
55;2021-06-07;791;714;81828;42878;45.0;23.6
55;2021-06-08;700;1073;82528;43951;45.4;24.2
55;2021-06-09;852;868;83380;44819;45.9;24.7
55;2021-06-10;378;275;83758;45094;46.1;24.8
55;2021-06-11;528;1285;84286;46379;46.4;25.5
55;2021-06-12;761;518;85047;46897;46.8;25.8
55;2021-06-13;265;33;85312;46930;47.0;25.8
55;2021-06-14;391;1362;85703;48292;47.2;26.6
55;2021-06-15;574;1212;86277;49504;47.5;27.3
55;2021-06-16;735;832;87012;50336;47.9;27.7
55;2021-06-17;425;858;87437;51194;48.1;28.2
55;2021-06-18;667;1473;88104;52667;48.5;29.0
55;2021-06-19;593;454;88697;53121;48.8;29.2
55;2021-06-20;0;0;88697;53121;48.8;29.2
55;2021-06-21;441;1023;89138;54144;49.1;29.8
55;2021-06-22;335;1012;89473;55156;49.3;30.4
55;2021-06-23;626;1209;90099;56365;49.6;31.0
55;2021-06-24;163;433;90262;56798;49.7;31.3
55;2021-06-25;642;1227;90904;58025;50.0;31.9
55;2021-06-26;418;341;91322;58366;50.3;32.1
55;2021-06-27;1;2;91323;58368;50.3;32.1
55;2021-06-28;149;1379;91472;59747;50.4;32.9
55;2021-06-29;201;1287;91673;61034;50.5;33.6
55;2021-06-30;272;1928;91945;62962;50.6;34.7
55;2021-07-01;388;1977;92333;64939;50.8;35.8
55;2021-07-02;391;1719;92724;66658;51.0;36.7
55;2021-07-03;107;262;92831;66920;51.1;36.8
55;2021-07-04;12;19;92843;66939;51.1;36.9
55;2021-07-05;222;1508;93065;68447;51.2;37.7
55;2021-07-06;327;898;93392;69345;51.4;38.2
55;2021-07-07;388;1801;93780;71146;51.6;39.2
55;2021-07-08;534;1594;94314;72740;51.9;40.0
55;2021-07-09;456;1478;94770;74218;52.2;40.9
55;2021-07-10;356;1112;95126;75330;52.4;41.5
55;2021-07-11;0;9;95126;75339;52.4;41.5
55;2021-07-12;608;1166;95734;76505;52.7;42.1
55;2021-07-13;599;1487;96333;77992;53.0;42.9
55;2021-07-14;1;13;96334;78005;53.0;42.9
55;2021-07-15;782;1645;97116;79650;53.5;43.9
55;2021-07-16;1255;1807;98371;81457;54.2;44.8
55;2021-07-17;1283;821;99654;82278;54.9;45.3
55;2021-07-18;1;2;99655;82280;54.9;45.3
55;2021-07-19;597;785;100252;83065;55.2;45.7
55;2021-07-20;1001;1019;101253;84084;55.7;46.3
55;2021-07-21;1482;1369;102735;85453;56.6;47.0
55;2021-07-22;1174;565;103909;86018;57.2;47.4
55;2021-07-23;1113;1354;105022;87372;57.8;48.1
55;2021-07-24;819;760;105841;88132;58.3;48.5
55;2021-07-25;120;229;105961;88361;58.3;48.6
55;2021-07-26;668;444;106629;88805;58.7;48.9
55;2021-07-27;1166;479;107795;89284;59.3;49.2
55;2021-07-28;1039;1063;108834;90347;59.9;49.7
55;2021-07-29;670;446;109504;90793;60.3;50.0
55;2021-07-30;1272;966;110776;91759;61.0;50.5
55;2021-07-31;714;613;111490;92372;61.4;50.9
55;2021-08-01;9;5;111499;92377;61.4;50.9
55;2021-08-02;797;443;112296;92820;61.8;51.1
55;2021-08-03;793;417;113089;93237;62.3;51.3
55;2021-08-04;1248;950;114337;94187;62.9;51.9
55;2021-08-05;1055;324;115392;94511;63.5;52.0
55;2021-08-06;819;1095;116211;95606;64.0;52.6
55;2021-08-07;596;336;116807;95942;64.3;52.8
55;2021-08-08;0;0;116807;95942;64.3;52.8
55;2021-08-09;402;306;117209;96248;64.5;53.0
55;2021-08-10;447;776;117656;97024;64.8;53.4
55;2021-08-11;595;640;118251;97664;65.1;53.8
55;2021-08-12;327;488;118578;98152;65.3;54.0
55;2021-08-13;437;1109;119015;99261;65.5;54.6
55;2021-08-14;144;190;119159;99451;65.6;54.8
55;2021-08-15;11;5;119170;99456;65.6;54.8
55;2021-08-16;245;739;119415;100195;65.7;55.2
55;2021-08-17;259;289;119674;100484;65.9;55.3
55;2021-08-18;547;1241;120221;101725;66.2;56.0
55;2021-08-19;450;960;120671;102685;66.4;56.5
55;2021-08-20;571;1012;121242;103697;66.7;57.1
55;2021-08-21;292;771;121534;104468;66.9;57.5
55;2021-08-22;8;6;121542;104474;66.9;57.5
55;2021-08-23;356;612;121898;105086;67.1;57.9
55;2021-08-24;314;833;122212;105919;67.3;58.3
55;2021-08-25;678;1173;122890;107092;67.7;59.0
55;2021-08-26;470;1253;123360;108345;67.9;59.6
55;2021-08-27;331;1246;123691;109591;68.1;60.3
55;2021-08-28;386;578;124077;110169;68.3;60.7
55;2021-08-29;216;59;124293;110228;68.4;60.7
55;2021-08-30;135;677;124428;110905;68.5;61.1
55;2021-08-31;283;824;124711;111729;68.7;61.5
55;2021-09-01;547;1269;125258;112998;69.0;62.2
55;2021-09-02;207;896;125465;113894;69.1;62.7
55;2021-09-03;408;1275;125873;115169;69.3;63.4
55;2021-09-04;287;600;126160;115769;69.5;63.7
55;2021-09-05;18;91;126178;115860;69.5;63.8
55;2021-09-06;60;127;126238;115987;69.5;63.9
55;2021-09-07;274;595;126512;116582;69.6;64.2
55;2021-09-08;229;338;126741;116920;69.8;64.4
55;2021-09-09;181;595;126922;117515;69.9;64.7
55;2021-09-10;180;550;127102;118065;70.0;65.0
55;2021-09-11;93;319;127195;118384;70.0;65.2
55;2021-09-12;1;1;127196;118385;70.0;65.2
55;2021-09-13;95;431;127291;118816;70.1;65.4
55;2021-09-14;230;284;127521;119100;70.2;65.6
55;2021-09-15;269;636;127790;119736;70.4;65.9
55;2021-09-16;96;181;127886;119917;70.4;66.0
55;2021-09-17;83;121;127969;120038;70.5;66.1
55;2021-09-18;138;391;128107;120429;70.5;66.3
55;2021-09-19;1;59;128108;120488;70.5;66.3
55;2021-09-20;63;193;128171;120681;70.6;66.4
55;2021-09-21;100;331;128271;121012;70.6;66.6
55;2021-09-22;109;395;128380;121407;70.7;66.8
55;2021-09-23;94;427;128474;121834;70.7;67.1
55;2021-09-24;88;367;128562;122201;70.8;67.3
55;2021-09-25;56;159;128618;122360;70.8;67.4
55;2021-09-26;0;34;128618;122394;70.8;67.4
55;2021-09-27;45;126;128663;122520;70.8;67.5
55;2021-09-28;51;124;128714;122644;70.9;67.5
55;2021-09-29;154;857;128868;123501;70.9;68.0
56;2020-12-27;0;0;0;0;0.0;0.0
56;2020-12-28;1;0;1;0;0.0;0.0
56;2020-12-29;0;0;1;0;0.0;0.0
56;2020-12-30;0;0;1;0;0.0;0.0
56;2020-12-31;0;0;1;0;0.0;0.0
56;2021-01-01;0;0;1;0;0.0;0.0
56;2021-01-02;1;0;2;0;0.0;0.0
56;2021-01-03;2;0;4;0;0.0;0.0
56;2021-01-04;2;0;6;0;0.0;0.0
56;2021-01-05;1;0;7;0;0.0;0.0
56;2021-01-06;2;0;9;0;0.0;0.0
56;2021-01-07;198;0;207;0;0.0;0.0
56;2021-01-08;119;0;326;0;0.0;0.0
56;2021-01-09;1;0;327;0;0.0;0.0
56;2021-01-10;1;0;328;0;0.0;0.0
56;2021-01-11;242;0;570;0;0.1;0.0
56;2021-01-12;755;1;1325;1;0.2;0.0
56;2021-01-13;638;1;1963;2;0.3;0.0
56;2021-01-14;970;2;2933;4;0.4;0.0
56;2021-01-15;844;5;3777;9;0.5;0.0
56;2021-01-16;235;3;4012;12;0.5;0.0
56;2021-01-17;27;0;4039;12;0.5;0.0
56;2021-01-18;1006;1;5045;13;0.7;0.0
56;2021-01-19;866;0;5911;13;0.8;0.0
56;2021-01-20;885;1;6796;14;0.9;0.0
56;2021-01-21;1450;1;8246;15;1.1;0.0
56;2021-01-22;1183;3;9429;18;1.2;0.0
56;2021-01-23;319;2;9748;20;1.3;0.0
56;2021-01-24;6;0;9754;20;1.3;0.0
56;2021-01-25;830;0;10584;20;1.4;0.0
56;2021-01-26;1034;4;11618;24;1.5;0.0
56;2021-01-27;1082;59;12700;83;1.7;0.0
56;2021-01-28;974;119;13674;202;1.8;0.0
56;2021-01-29;875;100;14549;302;1.9;0.0
56;2021-01-30;139;18;14688;320;1.9;0.0
56;2021-01-31;0;0;14688;320;1.9;0.0
56;2021-02-01;480;113;15168;433;2.0;0.1
56;2021-02-02;941;246;16109;679;2.1;0.1
56;2021-02-03;1025;254;17134;933;2.3;0.1
56;2021-02-04;4702;332;21836;1265;2.9;0.2
56;2021-02-05;3594;418;25430;1683;3.4;0.2
56;2021-02-06;551;162;25981;1845;3.4;0.2
56;2021-02-07;136;26;26117;1871;3.5;0.2
56;2021-02-08;297;257;26414;2128;3.5;0.3
56;2021-02-09;794;406;27208;2534;3.6;0.3
56;2021-02-10;864;637;28072;3171;3.7;0.4
56;2021-02-11;973;999;29045;4170;3.8;0.6
56;2021-02-12;1153;567;30198;4737;4.0;0.6
56;2021-02-13;220;76;30418;4813;4.0;0.6
56;2021-02-14;6;45;30424;4858;4.0;0.6
56;2021-02-15;623;835;31047;5693;4.1;0.8
56;2021-02-16;1219;587;32266;6280;4.3;0.8
56;2021-02-17;1189;771;33455;7051;4.4;0.9
56;2021-02-18;1351;707;34806;7758;4.6;1.0
56;2021-02-19;1323;706;36129;8464;4.8;1.1
56;2021-02-20;366;193;36495;8657;4.8;1.1
56;2021-02-21;2;0;36497;8657;4.8;1.1
56;2021-02-22;376;580;36873;9237;4.9;1.2
56;2021-02-23;742;737;37615;9974;5.0;1.3
56;2021-02-24;918;908;38533;10882;5.1;1.4
56;2021-02-25;2032;3831;40565;14713;5.4;1.9
56;2021-02-26;2356;2101;42921;16814;5.7;2.2
56;2021-02-27;748;366;43669;17180;5.8;2.3
56;2021-02-28;15;112;43684;17292;5.8;2.3
56;2021-03-01;649;449;44333;17741;5.9;2.3
56;2021-03-02;980;654;45313;18395;6.0;2.4
56;2021-03-03;1150;765;46463;19160;6.1;2.5
56;2021-03-04;1965;925;48428;20085;6.4;2.7
56;2021-03-05;2584;1322;51012;21407;6.8;2.8
56;2021-03-06;1209;193;52221;21600;6.9;2.9
56;2021-03-07;282;24;52503;21624;6.9;2.9
56;2021-03-08;1141;349;53644;21973;7.1;2.9
56;2021-03-09;2042;540;55686;22513;7.4;3.0
56;2021-03-10;2000;850;57686;23363;7.6;3.1
56;2021-03-11;3251;695;60937;24058;8.1;3.2
56;2021-03-12;4208;774;65145;24832;8.6;3.3
56;2021-03-13;1885;146;67030;24978;8.9;3.3
56;2021-03-14;195;4;67225;24982;8.9;3.3
56;2021-03-15;1285;521;68510;25503;9.1;3.4
56;2021-03-16;1088;998;69598;26501;9.2;3.5
56;2021-03-17;1371;755;70969;27256;9.4;3.6
56;2021-03-18;2001;1840;72970;29096;9.7;3.9
56;2021-03-19;2947;1366;75917;30462;10.0;4.0
56;2021-03-20;1492;202;77409;30664;10.2;4.1
56;2021-03-21;209;22;77618;30686;10.3;4.1
56;2021-03-22;1612;400;79230;31086;10.5;4.1
56;2021-03-23;2808;678;82038;31764;10.9;4.2
56;2021-03-24;3450;520;85488;32284;11.3;4.3
56;2021-03-25;4238;715;89726;32999;11.9;4.4
56;2021-03-26;5092;761;94818;33760;12.5;4.5
56;2021-03-27;1501;288;96319;34048;12.7;4.5
56;2021-03-28;264;11;96583;34059;12.8;4.5
56;2021-03-29;2236;501;98819;34560;13.1;4.6
56;2021-03-30;3518;785;102337;35345;13.5;4.7
56;2021-03-31;3116;717;105453;36062;14.0;4.8
56;2021-04-01;4078;820;109531;36882;14.5;4.9
56;2021-04-02;3925;945;113456;37827;15.0;5.0
56;2021-04-03;1186;270;114642;38097;15.2;5.0
56;2021-04-04;233;4;114875;38101;15.2;5.0
56;2021-04-05;244;8;115119;38109;15.2;5.0
56;2021-04-06;2828;1233;117947;39342;15.6;5.2
56;2021-04-07;4023;1193;121970;40535;16.1;5.4
56;2021-04-08;5295;1164;127265;41699;16.8;5.5
56;2021-04-09;7396;1280;134661;42979;17.8;5.7
56;2021-04-10;2576;428;137237;43407;18.2;5.7
56;2021-04-11;194;101;137431;43508;18.2;5.8
56;2021-04-12;3932;832;141363;44340;18.7;5.9
56;2021-04-13;5965;1263;147328;45603;19.5;6.0
56;2021-04-14;5168;1432;152496;47035;20.2;6.2
56;2021-04-15;7153;1775;159649;48810;21.1;6.5
56;2021-04-16;7842;2012;167491;50822;22.2;6.7
56;2021-04-17;3130;648;170621;51470;22.6;6.8
56;2021-04-18;528;110;171149;51580;22.7;6.8
56;2021-04-19;3719;1261;174868;52841;23.1;7.0
56;2021-04-20;4107;1974;178975;54815;23.7;7.3
56;2021-04-21;4059;2321;183034;57136;24.2;7.6
56;2021-04-22;5173;1918;188207;59054;24.9;7.8
56;2021-04-23;5172;2413;193379;61467;25.6;8.1
56;2021-04-24;2899;638;196278;62105;26.0;8.2
56;2021-04-25;465;149;196743;62254;26.0;8.2
56;2021-04-26;4710;1657;201453;63911;26.7;8.5
56;2021-04-27;5097;2537;206550;66448;27.3;8.8
56;2021-04-28;4966;2243;211516;68691;28.0;9.1
56;2021-04-29;5842;2925;217358;71616;28.8;9.5
56;2021-04-30;6245;2785;223603;74401;29.6;9.8
56;2021-05-01;2489;363;226092;74764;29.9;9.9
56;2021-05-02;307;254;226399;75018;30.0;9.9
56;2021-05-03;3863;2050;230262;77068;30.5;10.2
56;2021-05-04;4379;3899;234641;80967;31.1;10.7
56;2021-05-05;3523;3871;238164;84838;31.5;11.2
56;2021-05-06;4377;5430;242541;90268;32.1;11.9
56;2021-05-07;4267;4990;246808;95258;32.7;12.6
56;2021-05-08;1645;320;248453;95578;32.9;12.6
56;2021-05-09;494;227;248947;95805;32.9;12.7
56;2021-05-10;3751;3803;252698;99608;33.4;13.2
56;2021-05-11;4169;5040;256867;104648;34.0;13.9
56;2021-05-12;4342;4771;261209;109419;34.6;14.5
56;2021-05-13;2397;1014;263606;110433;34.9;14.6
56;2021-05-14;4227;4347;267833;114780;35.4;15.2
56;2021-05-15;2488;1895;270321;116675;35.8;15.4
56;2021-05-16;237;488;270558;117163;35.8;15.5
56;2021-05-17;2513;3664;273071;120827;36.1;16.0
56;2021-05-18;3522;4092;276593;124919;36.6;16.5
56;2021-05-19;3527;3391;280120;128310;37.1;17.0
56;2021-05-20;3805;4808;283925;133118;37.6;17.6
56;2021-05-21;3748;5217;287673;138335;38.1;18.3
56;2021-05-22;1697;2207;289370;140542;38.3;18.6
56;2021-05-23;284;197;289654;140739;38.3;18.6
56;2021-05-24;2058;498;291712;141237;38.6;18.7
56;2021-05-25;3140;4472;294852;145709;39.0;19.3
56;2021-05-26;3735;3933;298587;149642;39.5;19.8
56;2021-05-27;4362;4862;302949;154504;40.1;20.4
56;2021-05-28;4638;5938;307587;160442;40.7;21.2
56;2021-05-29;1886;1632;309473;162074;41.0;21.5
56;2021-05-30;318;67;309791;162141;41.0;21.5
56;2021-05-31;4502;3212;314293;165353;41.6;21.9
56;2021-06-01;5664;3379;319957;168732;42.3;22.3
56;2021-06-02;5631;2946;325588;171678;43.1;22.7
56;2021-06-03;6189;3292;331777;174970;43.9;23.2
56;2021-06-04;5813;4401;337590;179371;44.7;23.7
56;2021-06-05;4346;2372;341936;181743;45.3;24.1
56;2021-06-06;496;615;342432;182358;45.3;24.1
56;2021-06-07;5101;3167;347533;185525;46.0;24.6
56;2021-06-08;6070;3365;353603;188890;46.8;25.0
56;2021-06-09;6429;2811;360032;191701;47.7;25.4
56;2021-06-10;7478;2873;367510;194574;48.6;25.8
56;2021-06-11;6767;3864;374277;198438;49.5;26.3
56;2021-06-12;5103;2062;379380;200500;50.2;26.5
56;2021-06-13;1978;439;381358;200939;50.5;26.6
56;2021-06-14;3313;4588;384671;205527;50.9;27.2
56;2021-06-15;4201;4878;388872;210405;51.5;27.8
56;2021-06-16;4494;4501;393366;214906;52.1;28.4
56;2021-06-17;4257;4748;397623;219654;52.6;29.1
56;2021-06-18;4513;5967;402136;225621;53.2;29.9
56;2021-06-19;3832;2143;405968;227764;53.7;30.1
56;2021-06-20;1503;340;407471;228104;53.9;30.2
56;2021-06-21;3306;4461;410777;232565;54.4;30.8
56;2021-06-22;3483;5433;414260;237998;54.8;31.5
56;2021-06-23;3763;5061;418023;243059;55.3;32.2
56;2021-06-24;3477;5318;421500;248377;55.8;32.9
56;2021-06-25;3884;6280;425384;254657;56.3;33.7
56;2021-06-26;3202;2915;428586;257572;56.7;34.1
56;2021-06-27;305;163;428891;257735;56.8;34.1
56;2021-06-28;1575;3982;430466;261717;57.0;34.6
56;2021-06-29;2433;5761;432899;267478;57.3;35.4
56;2021-06-30;2497;5558;435396;273036;57.6;36.1
56;2021-07-01;2734;4956;438130;277992;58.0;36.8
56;2021-07-02;2656;6201;440786;284193;58.3;37.6
56;2021-07-03;2203;2677;442989;286870;58.6;38.0
56;2021-07-04;778;811;443767;287681;58.7;38.1
56;2021-07-05;1872;5442;445639;293123;59.0;38.8
56;2021-07-06;2190;5931;447829;299054;59.3;39.6
56;2021-07-07;2843;5642;450672;304696;59.6;40.3
56;2021-07-08;3085;6035;453757;310731;60.1;41.1
56;2021-07-09;2213;7097;455970;317828;60.3;42.1
56;2021-07-10;1126;3000;457096;320828;60.5;42.5
56;2021-07-11;256;344;457352;321172;60.5;42.5
56;2021-07-12;2181;6605;459533;327777;60.8;43.4
56;2021-07-13;3259;7466;462792;335243;61.3;44.4
56;2021-07-14;1785;2591;464577;337834;61.5;44.7
56;2021-07-15;3820;7068;468397;344902;62.0;45.6
56;2021-07-16;4076;8082;472473;352984;62.5;46.7
56;2021-07-17;2320;3524;474793;356508;62.8;47.2
56;2021-07-18;256;478;475049;356986;62.9;47.2
56;2021-07-19;2868;6357;477917;363343;63.3;48.1
56;2021-07-20;3722;7910;481639;371253;63.7;49.1
56;2021-07-21;3095;7516;484734;378769;64.2;50.1
56;2021-07-22;4391;8027;489125;386796;64.7;51.2
56;2021-07-23;4389;8406;493514;395202;65.3;52.3
56;2021-07-24;1687;4600;495201;399802;65.5;52.9
56;2021-07-25;552;1917;495753;401719;65.6;53.2
56;2021-07-26;3680;5451;499433;407170;66.1;53.9
56;2021-07-27;5375;6194;504808;413364;66.8;54.7
56;2021-07-28;4686;5462;509494;418826;67.4;55.4
56;2021-07-29;5378;5626;514872;424452;68.1;56.2
56;2021-07-30;5383;5863;520255;430315;68.9;57.0
56;2021-07-31;2157;2690;522412;433005;69.1;57.3
56;2021-08-01;1254;977;523666;433982;69.3;57.4
56;2021-08-02;4536;4598;528202;438580;69.9;58.0
56;2021-08-03;6384;4957;534586;443537;70.8;58.7
56;2021-08-04;5954;4363;540540;447900;71.5;59.3
56;2021-08-05;6097;4604;546637;452504;72.3;59.9
56;2021-08-06;5856;4925;552493;457429;73.1;60.5
56;2021-08-07;2859;2225;555352;459654;73.5;60.8
56;2021-08-08;1829;566;557181;460220;73.7;60.9
56;2021-08-09;3936;4266;561117;464486;74.3;61.5
56;2021-08-10;4927;4612;566044;469098;74.9;62.1
56;2021-08-11;4565;4137;570609;473235;75.5;62.6
56;2021-08-12;4488;4542;575097;477777;76.1;63.2
56;2021-08-13;4215;4814;579312;482591;76.7;63.9
56;2021-08-14;1790;2136;581102;484727;76.9;64.2
56;2021-08-15;348;485;581450;485212;77.0;64.2
56;2021-08-16;3064;4521;584514;489733;77.4;64.8
56;2021-08-17;3762;5055;588276;494788;77.9;65.5
56;2021-08-18;3739;4609;592015;499397;78.4;66.1
56;2021-08-19;3067;4991;595082;504388;78.8;66.8
56;2021-08-20;2901;5259;597983;509647;79.1;67.5
56;2021-08-21;1159;2399;599142;512046;79.3;67.8
56;2021-08-22;129;503;599271;512549;79.3;67.8
56;2021-08-23;1927;4967;601198;517516;79.6;68.5
56;2021-08-24;1922;5513;603120;523029;79.8;69.2
56;2021-08-25;1708;5056;604828;528085;80.0;69.9
56;2021-08-26;1407;5325;606235;533410;80.2;70.6
56;2021-08-27;1747;5877;607982;539287;80.5;71.4
56;2021-08-28;604;2801;608586;542088;80.5;71.7
56;2021-08-29;79;476;608665;542564;80.6;71.8
56;2021-08-30;1380;4746;610045;547310;80.7;72.4
56;2021-08-31;1473;4793;611518;552103;80.9;73.1
56;2021-09-01;1316;4198;612834;556301;81.1;73.6
56;2021-09-02;1081;4037;613915;560338;81.3;74.2
56;2021-09-03;1098;4597;615013;564935;81.4;74.8
56;2021-09-04;763;2445;615776;567380;81.5;75.1
56;2021-09-05;125;371;615901;567751;81.5;75.1
56;2021-09-06;882;3622;616783;571373;81.6;75.6
56;2021-09-07;816;3470;617599;574843;81.7;76.1
56;2021-09-08;964;3468;618563;578311;81.9;76.5
56;2021-09-09;794;3021;619357;581332;82.0;76.9
56;2021-09-10;934;3489;620291;584821;82.1;77.4
56;2021-09-11;474;2108;620765;586929;82.2;77.7
56;2021-09-12;34;171;620799;587100;82.2;77.7
56;2021-09-13;753;2677;621552;589777;82.3;78.1
56;2021-09-14;695;2777;622247;592554;82.4;78.4
56;2021-09-15;714;2499;622961;595053;82.4;78.8
56;2021-09-16;702;1591;623663;596644;82.5;79.0
56;2021-09-17;756;2148;624419;598792;82.6;79.3
56;2021-09-18;305;1706;624724;600498;82.7;79.5
56;2021-09-19;32;112;624756;600610;82.7;79.5
56;2021-09-20;426;1288;625182;601898;82.7;79.7
56;2021-09-21;497;1165;625679;603063;82.8;79.8
56;2021-09-22;463;1704;626142;604767;82.9;80.0
56;2021-09-23;541;1048;626683;605815;82.9;80.2
56;2021-09-24;575;1611;627258;607426;83.0;80.4
56;2021-09-25;250;1026;627508;608452;83.1;80.5
56;2021-09-26;12;79;627520;608531;83.1;80.5
56;2021-09-27;474;1000;627994;609531;83.1;80.7
56;2021-09-28;433;958;628427;610489;83.2;80.8
56;2021-09-29;384;1168;628811;611657;83.2;81.0
57;2020-12-27;2;0;2;0;0.0;0.0
57;2020-12-28;0;0;2;0;0.0;0.0
57;2020-12-29;1;0;3;0;0.0;0.0
57;2020-12-30;1;0;4;0;0.0;0.0
57;2020-12-31;0;0;4;0;0.0;0.0
57;2021-01-01;1;0;5;0;0.0;0.0
57;2021-01-02;3;0;8;0;0.0;0.0
57;2021-01-03;0;0;8;0;0.0;0.0
57;2021-01-04;17;0;25;0;0.0;0.0
57;2021-01-05;199;0;224;0;0.0;0.0
57;2021-01-06;226;1;450;1;0.0;0.0
57;2021-01-07;586;2;1036;3;0.1;0.0
57;2021-01-08;509;2;1545;5;0.1;0.0
57;2021-01-09;203;0;1748;5;0.2;0.0
57;2021-01-10;109;1;1857;6;0.2;0.0
57;2021-01-11;470;1;2327;7;0.2;0.0
57;2021-01-12;612;5;2939;12;0.3;0.0
57;2021-01-13;696;2;3635;14;0.4;0.0
57;2021-01-14;708;6;4343;20;0.4;0.0
57;2021-01-15;636;5;4979;25;0.5;0.0
57;2021-01-16;452;1;5431;26;0.5;0.0
57;2021-01-17;493;1;5924;27;0.6;0.0
57;2021-01-18;2715;20;8639;47;0.8;0.0
57;2021-01-19;2567;20;11206;67;1.1;0.0
57;2021-01-20;2764;17;13970;84;1.3;0.0
57;2021-01-21;1797;5;15767;89;1.5;0.0
57;2021-01-22;1325;6;17092;95;1.7;0.0
57;2021-01-23;543;15;17635;110;1.7;0.0
57;2021-01-24;1;0;17636;110;1.7;0.0
57;2021-01-25;869;174;18505;284;1.8;0.0
57;2021-01-26;1112;202;19617;486;1.9;0.0
57;2021-01-27;1070;160;20687;646;2.0;0.1
57;2021-01-28;1040;241;21727;887;2.1;0.1
57;2021-01-29;983;368;22710;1255;2.2;0.1
57;2021-01-30;440;82;23150;1337;2.2;0.1
57;2021-01-31;11;16;23161;1353;2.2;0.1
57;2021-02-01;828;321;23989;1674;2.3;0.2
57;2021-02-02;989;334;24978;2008;2.4;0.2
57;2021-02-03;986;294;25964;2302;2.5;0.2
57;2021-02-04;1138;773;27102;3075;2.6;0.3
57;2021-02-05;927;324;28029;3399;2.7;0.3
57;2021-02-06;480;308;28509;3707;2.8;0.4
57;2021-02-07;103;333;28612;4040;2.8;0.4
57;2021-02-08;1258;1395;29870;5435;2.9;0.5
57;2021-02-09;1763;1575;31633;7010;3.1;0.7
57;2021-02-10;1712;1957;33345;8967;3.2;0.9
57;2021-02-11;1487;1265;34832;10232;3.4;1.0
57;2021-02-12;1227;612;36059;10844;3.5;1.0
57;2021-02-13;1152;133;37211;10977;3.6;1.1
57;2021-02-14;1210;27;38421;11004;3.7;1.1
57;2021-02-15;766;698;39187;11702;3.8;1.1
57;2021-02-16;1076;655;40263;12357;3.9;1.2
57;2021-02-17;1008;789;41271;13146;4.0;1.3
57;2021-02-18;974;968;42245;14114;4.1;1.4
57;2021-02-19;956;730;43201;14844;4.2;1.4
57;2021-02-20;1172;487;44373;15331;4.3;1.5
57;2021-02-21;323;13;44696;15344;4.3;1.5
57;2021-02-22;1230;734;45926;16078;4.4;1.6
57;2021-02-23;2234;917;48160;16995;4.6;1.6
57;2021-02-24;2287;822;50447;17817;4.9;1.7
57;2021-02-25;3297;945;53744;18762;5.2;1.8
57;2021-02-26;3593;826;57337;19588;5.5;1.9
57;2021-02-27;3697;478;61034;20066;5.9;1.9
57;2021-02-28;1897;58;62931;20124;6.1;1.9
57;2021-03-01;2063;1201;64994;21325;6.3;2.1
57;2021-03-02;2858;1420;67852;22745;6.6;2.2
57;2021-03-03;2810;1464;70662;24209;6.8;2.3
57;2021-03-04;3274;1182;73936;25391;7.1;2.5
57;2021-03-05;4458;1139;78394;26530;7.6;2.6
57;2021-03-06;7243;694;85637;27224;8.3;2.6
57;2021-03-07;6070;256;91707;27480;8.9;2.7
57;2021-03-08;2300;909;94007;28389;9.1;2.7
57;2021-03-09;3385;1196;97392;29585;9.4;2.9
57;2021-03-10;3582;893;100974;30478;9.7;2.9
57;2021-03-11;4040;1173;105014;31651;10.1;3.1
57;2021-03-12;5108;1124;110122;32775;10.6;3.2
57;2021-03-13;6283;940;116405;33715;11.2;3.3
57;2021-03-14;2425;423;118830;34138;11.5;3.3
57;2021-03-15;2965;863;121795;35001;11.8;3.4
57;2021-03-16;3060;1271;124855;36272;12.1;3.5
57;2021-03-17;3049;1135;127904;37407;12.3;3.6
57;2021-03-18;3402;1058;131306;38465;12.7;3.7
57;2021-03-19;4625;1037;135931;39502;13.1;3.8
57;2021-03-20;4700;1024;140631;40526;13.6;3.9
57;2021-03-21;1895;250;142526;40776;13.8;3.9
57;2021-03-22;2479;1475;145005;42251;14.0;4.1
57;2021-03-23;3443;2330;148448;44581;14.3;4.3
57;2021-03-24;3897;2133;152345;46714;14.7;4.5
57;2021-03-25;4743;2587;157088;49301;15.2;4.8
57;2021-03-26;4842;2261;161930;51562;15.6;5.0
57;2021-03-27;3710;3136;165640;54698;16.0;5.3
57;2021-03-28;1398;1827;167038;56525;16.1;5.5
57;2021-03-29;1932;2162;168970;58687;16.3;5.7
57;2021-03-30;3300;2466;172270;61153;16.6;5.9
57;2021-03-31;2825;2284;175095;63437;16.9;6.1
57;2021-04-01;3223;3161;178318;66598;17.2;6.4
57;2021-04-02;2392;2566;180710;69164;17.4;6.7
57;2021-04-03;2565;2649;183275;71813;17.7;6.9
57;2021-04-04;596;968;183871;72781;17.8;7.0
57;2021-04-05;1922;674;185793;73455;17.9;7.1
57;2021-04-06;2451;2829;188244;76284;18.2;7.4
57;2021-04-07;3815;3088;192059;79372;18.5;7.7
57;2021-04-08;5613;2899;197672;82271;19.1;7.9
57;2021-04-09;5013;2724;202685;84995;19.6;8.2
57;2021-04-10;2353;3634;205038;88629;19.8;8.6
57;2021-04-11;1099;1890;206137;90519;19.9;8.7
57;2021-04-12;1795;2745;207932;93264;20.1;9.0
57;2021-04-13;1976;3022;209908;96286;20.3;9.3
57;2021-04-14;1922;2985;211830;99271;20.4;9.6
57;2021-04-15;2364;3425;214194;102696;20.7;9.9
57;2021-04-16;2700;3289;216894;105985;20.9;10.2
57;2021-04-17;2473;3177;219367;109162;21.2;10.5
57;2021-04-18;1241;1771;220608;110933;21.3;10.7
57;2021-04-19;2142;2257;222750;113190;21.5;10.9
57;2021-04-20;2513;2779;225263;115969;21.7;11.2
57;2021-04-21;2568;2379;227831;118348;22.0;11.4
57;2021-04-22;3208;2250;231039;120598;22.3;11.6
57;2021-04-23;4057;2574;235096;123172;22.7;11.9
57;2021-04-24;3395;2560;238491;125732;23.0;12.1
57;2021-04-25;757;1126;239248;126858;23.1;12.2
57;2021-04-26;2972;1992;242220;128850;23.4;12.4
57;2021-04-27;3898;2375;246118;131225;23.8;12.7
57;2021-04-28;4212;2589;250330;133814;24.2;12.9
57;2021-04-29;5261;3442;255591;137256;24.7;13.3
57;2021-04-30;4729;3529;260320;140785;25.1;13.6
57;2021-05-01;2356;1685;262676;142470;25.4;13.8
57;2021-05-02;790;912;263466;143382;25.4;13.8
57;2021-05-03;3561;2990;267027;146372;25.8;14.1
57;2021-05-04;4871;3160;271898;149532;26.2;14.4
57;2021-05-05;6123;3157;278021;152689;26.8;14.7
57;2021-05-06;5990;3274;284011;155963;27.4;15.1
57;2021-05-07;6852;3439;290863;159402;28.1;15.4
57;2021-05-08;4051;1605;294914;161007;28.5;15.5
57;2021-05-09;2048;1114;296962;162121;28.7;15.7
57;2021-05-10;5129;3063;302091;165184;29.2;15.9
57;2021-05-11;7451;2848;309542;168032;29.9;16.2
57;2021-05-12;7843;3242;317385;171274;30.6;16.5
57;2021-05-13;4509;915;321894;172189;31.1;16.6
57;2021-05-14;7839;2628;329733;174817;31.8;16.9
57;2021-05-15;5965;2045;335698;176862;32.4;17.1
57;2021-05-16;3307;578;339005;177440;32.7;17.1
57;2021-05-17;3866;2063;342871;179503;33.1;17.3
57;2021-05-18;6292;2103;349163;181606;33.7;17.5
57;2021-05-19;7019;2327;356182;183933;34.4;17.8
57;2021-05-20;6047;2172;362229;186105;35.0;18.0
57;2021-05-21;7564;2922;369793;189027;35.7;18.2
57;2021-05-22;4895;2171;374688;191198;36.2;18.5
57;2021-05-23;1964;430;376652;191628;36.4;18.5
57;2021-05-24;3027;1056;379679;192684;36.7;18.6
57;2021-05-25;5571;2804;385250;195488;37.2;18.9
57;2021-05-26;6374;3177;391624;198665;37.8;19.2
57;2021-05-27;5794;3120;397418;201785;38.4;19.5
57;2021-05-28;7024;4732;404442;206517;39.0;19.9
57;2021-05-29;5220;4243;409662;210760;39.5;20.3
57;2021-05-30;1967;1743;411629;212503;39.7;20.5
57;2021-05-31;4315;3339;415944;215842;40.2;20.8
57;2021-06-01;5933;3713;421877;219555;40.7;21.2
57;2021-06-02;6340;3898;428217;223453;41.3;21.6
57;2021-06-03;6209;3690;434426;227143;41.9;21.9
57;2021-06-04;7568;4990;441994;232133;42.7;22.4
57;2021-06-05;4764;4030;446758;236163;43.1;22.8
57;2021-06-06;1992;889;448750;237052;43.3;22.9
57;2021-06-07;4317;4034;453067;241086;43.7;23.3
57;2021-06-08;6721;4313;459788;245399;44.4;23.7
57;2021-06-09;6876;4154;466664;249553;45.1;24.1
57;2021-06-10;6218;4595;472882;254148;45.7;24.5
57;2021-06-11;5361;5363;478243;259511;46.2;25.1
57;2021-06-12;5741;4446;483984;263957;46.7;25.5
57;2021-06-13;1500;1142;485484;265099;46.9;25.6
57;2021-06-14;3380;4697;488864;269796;47.2;26.0
57;2021-06-15;3815;6023;492679;275819;47.6;26.6
57;2021-06-16;4400;6599;497079;282418;48.0;27.3
57;2021-06-17;4200;6072;501279;288490;48.4;27.9
57;2021-06-18;4273;7306;505552;295796;48.8;28.6
57;2021-06-19;4156;6289;509708;302085;49.2;29.2
57;2021-06-20;986;1665;510694;303750;49.3;29.3
57;2021-06-21;2066;5966;512760;309716;49.5;29.9
57;2021-06-22;2644;7986;515404;317702;49.8;30.7
57;2021-06-23;3071;8385;518475;326087;50.1;31.5
57;2021-06-24;2456;5284;520931;331371;50.3;32.0
57;2021-06-25;2856;7825;523787;339196;50.6;32.7
57;2021-06-26;2871;7255;526658;346451;50.8;33.4
57;2021-06-27;752;2985;527410;349436;50.9;33.7
57;2021-06-28;1591;5078;529001;354514;51.1;34.2
57;2021-06-29;2082;6830;531083;361344;51.3;34.9
57;2021-06-30;3067;7321;534150;368665;51.6;35.6
57;2021-07-01;2705;5957;536855;374622;51.8;36.2
57;2021-07-02;2697;8072;539552;382694;52.1;36.9
57;2021-07-03;3238;6528;542790;389222;52.4;37.6
57;2021-07-04;942;2467;543732;391689;52.5;37.8
57;2021-07-05;1712;4607;545444;396296;52.7;38.3
57;2021-07-06;2425;6480;547869;402776;52.9;38.9
57;2021-07-07;2732;7089;550601;409865;53.2;39.6
57;2021-07-08;2495;5875;553096;415740;53.4;40.1
57;2021-07-09;3424;8413;556520;424153;53.7;40.9
57;2021-07-10;3097;6941;559617;431094;54.0;41.6
57;2021-07-11;855;2233;560472;433327;54.1;41.8
57;2021-07-12;2441;6434;562913;439761;54.3;42.5
57;2021-07-13;4415;7504;567328;447265;54.8;43.2
57;2021-07-14;2823;3842;570151;451107;55.0;43.5
57;2021-07-15;3961;7790;574112;458897;55.4;44.3
57;2021-07-16;5641;9829;579753;468726;56.0;45.2
57;2021-07-17;5823;7281;585576;476007;56.5;46.0
57;2021-07-18;1491;2660;587067;478667;56.7;46.2
57;2021-07-19;2373;6202;589440;484869;56.9;46.8
57;2021-07-20;4331;6914;593771;491783;57.3;47.5
57;2021-07-21;5300;6906;599071;498689;57.8;48.1
57;2021-07-22;5982;5955;605053;504644;58.4;48.7
57;2021-07-23;7016;6406;612069;511050;59.1;49.3
57;2021-07-24;4536;7037;616605;518087;59.5;50.0
57;2021-07-25;1334;1770;617939;519857;59.7;50.2
57;2021-07-26;3724;4491;621663;524348;60.0;50.6
57;2021-07-27;6866;4950;628529;529298;60.7;51.1
57;2021-07-28;7487;4564;636016;533862;61.4;51.5
57;2021-07-29;7632;4600;643648;538462;62.1;52.0
57;2021-07-30;6872;4899;650520;543361;62.8;52.5
57;2021-07-31;5707;5022;656227;548383;63.4;52.9
57;2021-08-01;2027;1116;658254;549499;63.5;53.0
57;2021-08-02;3543;3181;661797;552680;63.9;53.4
57;2021-08-03;5801;4283;667598;556963;64.4;53.8
57;2021-08-04;5228;3461;672826;560424;65.0;54.1
57;2021-08-05;5375;3775;678201;564199;65.5;54.5
57;2021-08-06;5624;4851;683825;569050;66.0;54.9
57;2021-08-07;4587;5167;688412;574217;66.5;55.4
57;2021-08-08;1478;1508;689890;575725;66.6;55.6
57;2021-08-09;2621;3174;692511;578899;66.9;55.9
57;2021-08-10;3519;3787;696030;582686;67.2;56.3
57;2021-08-11;3724;4021;699754;586707;67.6;56.6
57;2021-08-12;3159;5218;702913;591925;67.9;57.1
57;2021-08-13;3496;4733;706409;596658;68.2;57.6
57;2021-08-14;2164;5186;708573;601844;68.4;58.1
57;2021-08-15;529;1093;709102;602937;68.5;58.2
57;2021-08-16;1790;3566;710892;606503;68.6;58.6
57;2021-08-17;2380;5355;713272;611858;68.9;59.1
57;2021-08-18;2469;5374;715741;617232;69.1;59.6
57;2021-08-19;2214;5485;717955;622717;69.3;60.1
57;2021-08-20;2057;6030;720012;628747;69.5;60.7
57;2021-08-21;1869;5393;721881;634140;69.7;61.2
57;2021-08-22;454;1530;722335;635670;69.7;61.4
57;2021-08-23;1144;3718;723479;639388;69.8;61.7
57;2021-08-24;1816;5613;725295;645001;70.0;62.3
57;2021-08-25;1620;5318;726915;650319;70.2;62.8
57;2021-08-26;1604;4673;728519;654992;70.3;63.2
57;2021-08-27;1768;5897;730287;660889;70.5;63.8
57;2021-08-28;2010;5382;732297;666271;70.7;64.3
57;2021-08-29;342;1089;732639;667360;70.7;64.4
57;2021-08-30;1031;3260;733670;670620;70.8;64.7
57;2021-08-31;1550;4424;735220;675044;71.0;65.2
57;2021-09-01;1457;4151;736677;679195;71.1;65.6
57;2021-09-02;1170;3401;737847;682596;71.2;65.9
57;2021-09-03;1552;4349;739399;686945;71.4;66.3
57;2021-09-04;1678;4004;741077;690949;71.5;66.7
57;2021-09-05;382;940;741459;691889;71.6;66.8
57;2021-09-06;755;2130;742214;694019;71.7;67.0
57;2021-09-07;690;2248;742904;696267;71.7;67.2
57;2021-09-08;907;2920;743811;699187;71.8;67.5
57;2021-09-09;598;2360;744409;701547;71.9;67.7
57;2021-09-10;1073;2972;745482;704519;72.0;68.0
57;2021-09-11;1174;3249;746656;707768;72.1;68.3
57;2021-09-12;243;548;746899;708316;72.1;68.4
57;2021-09-13;581;1790;747480;710106;72.2;68.6
57;2021-09-14;768;2342;748248;712448;72.2;68.8
57;2021-09-15;768;1995;749016;714443;72.3;69.0
57;2021-09-16;709;1227;749725;715670;72.4;69.1
57;2021-09-17;1108;1788;750833;717458;72.5;69.3
57;2021-09-18;804;2586;751637;720044;72.6;69.5
57;2021-09-19;119;345;751756;720389;72.6;69.5
57;2021-09-20;408;865;752164;721254;72.6;69.6
57;2021-09-21;497;826;752661;722080;72.7;69.7
57;2021-09-22;489;1303;753150;723383;72.7;69.8
57;2021-09-23;465;1211;753615;724594;72.8;70.0
57;2021-09-24;738;1431;754353;726025;72.8;70.1
57;2021-09-25;504;1996;754857;728021;72.9;70.3
57;2021-09-26;121;326;754978;728347;72.9;70.3
57;2021-09-27;440;843;755418;729190;72.9;70.4
57;2021-09-28;313;596;755731;729786;73.0;70.5
57;2021-09-29;538;1104;756269;730890;73.0;70.6
58;2020-12-27;0;0;0;0;0.0;0.0
58;2020-12-28;0;0;0;0;0.0;0.0
58;2020-12-29;1;0;1;0;0.0;0.0
58;2020-12-30;0;0;1;0;0.0;0.0
58;2020-12-31;0;0;1;0;0.0;0.0
58;2021-01-01;0;0;1;0;0.0;0.0
58;2021-01-02;0;0;1;0;0.0;0.0
58;2021-01-03;1;0;2;0;0.0;0.0
58;2021-01-04;0;0;2;0;0.0;0.0
58;2021-01-05;2;0;4;0;0.0;0.0
58;2021-01-06;145;0;149;0;0.1;0.0
58;2021-01-07;241;0;390;0;0.2;0.0
58;2021-01-08;63;0;453;0;0.2;0.0
58;2021-01-09;1;0;454;0;0.2;0.0
58;2021-01-10;0;0;454;0;0.2;0.0
58;2021-01-11;54;0;508;0;0.3;0.0
58;2021-01-12;260;0;768;0;0.4;0.0
58;2021-01-13;410;2;1178;2;0.6;0.0
58;2021-01-14;291;1;1469;3;0.7;0.0
58;2021-01-15;141;0;1610;3;0.8;0.0
58;2021-01-16;10;1;1620;4;0.8;0.0
58;2021-01-17;0;0;1620;4;0.8;0.0
58;2021-01-18;413;1;2033;5;1.0;0.0
58;2021-01-19;987;2;3020;7;1.5;0.0
58;2021-01-20;1206;2;4226;9;2.1;0.0
58;2021-01-21;962;4;5188;13;2.6;0.0
58;2021-01-22;779;3;5967;16;3.0;0.0
58;2021-01-23;253;0;6220;16;3.1;0.0
58;2021-01-24;2;0;6222;16;3.1;0.0
58;2021-01-25;439;0;6661;16;3.3;0.0
58;2021-01-26;650;3;7311;19;3.7;0.0
58;2021-01-27;604;44;7915;63;4.0;0.0
58;2021-01-28;756;65;8671;128;4.3;0.1
58;2021-01-29;837;5;9508;133;4.8;0.1
58;2021-01-30;281;0;9789;133;4.9;0.1
58;2021-01-31;10;0;9799;133;4.9;0.1
58;2021-02-01;200;70;9999;203;5.0;0.1
58;2021-02-02;566;79;10565;282;5.3;0.1
58;2021-02-03;279;135;10844;417;5.4;0.2
58;2021-02-04;284;85;11128;502;5.6;0.3
58;2021-02-05;184;86;11312;588;5.7;0.3
58;2021-02-06;89;0;11401;588;5.7;0.3
58;2021-02-07;0;0;11401;588;5.7;0.3
58;2021-02-08;306;60;11707;648;5.9;0.3
58;2021-02-09;503;294;12210;942;6.1;0.5
58;2021-02-10;350;358;12560;1300;6.3;0.7
58;2021-02-11;286;365;12846;1665;6.4;0.8
58;2021-02-12;243;191;13089;1856;6.6;0.9
58;2021-02-13;83;29;13172;1885;6.6;0.9
58;2021-02-14;0;3;13172;1888;6.6;0.9
58;2021-02-15;114;365;13286;2253;6.7;1.1
58;2021-02-16;208;701;13494;2954;6.8;1.5
58;2021-02-17;221;600;13715;3554;6.9;1.8
58;2021-02-18;187;570;13902;4124;7.0;2.1
58;2021-02-19;241;586;14143;4710;7.1;2.4
58;2021-02-20;62;170;14205;4880;7.1;2.4
58;2021-02-21;0;30;14205;4910;7.1;2.5
58;2021-02-22;78;298;14283;5208;7.2;2.6
58;2021-02-23;49;483;14332;5691;7.2;2.9
58;2021-02-24;39;495;14371;6186;7.2;3.1
58;2021-02-25;252;591;14623;6777;7.3;3.4
58;2021-02-26;246;484;14869;7261;7.4;3.6
58;2021-02-27;104;142;14973;7403;7.5;3.7
58;2021-02-28;11;8;14984;7411;7.5;3.7
58;2021-03-01;145;183;15129;7594;7.6;3.8
58;2021-03-02;416;527;15545;8121;7.8;4.1
58;2021-03-03;523;248;16068;8369;8.1;4.2
58;2021-03-04;725;257;16793;8626;8.4;4.3
58;2021-03-05;866;192;17659;8818;8.8;4.4
58;2021-03-06;577;77;18236;8895;9.1;4.5
58;2021-03-07;63;10;18299;8905;9.2;4.5
58;2021-03-08;156;269;18455;9174;9.2;4.6
58;2021-03-09;545;476;19000;9650;9.5;4.8
58;2021-03-10;838;215;19838;9865;9.9;4.9
58;2021-03-11;857;247;20695;10112;10.4;5.1
58;2021-03-12;862;185;21557;10297;10.8;5.2
58;2021-03-13;506;64;22063;10361;11.1;5.2
58;2021-03-14;34;1;22097;10362;11.1;5.2
58;2021-03-15;530;108;22627;10470;11.3;5.2
58;2021-03-16;725;219;23352;10689;11.7;5.4
58;2021-03-17;755;189;24107;10878;12.1;5.5
58;2021-03-18;584;172;24691;11050;12.4;5.5
58;2021-03-19;540;98;25231;11148;12.6;5.6
58;2021-03-20;322;64;25553;11212;12.8;5.6
58;2021-03-21;17;0;25570;11212;12.8;5.6
58;2021-03-22;797;25;26367;11237;13.2;5.6
58;2021-03-23;1636;42;28003;11279;14.0;5.7
58;2021-03-24;1370;76;29373;11355;14.7;5.7
58;2021-03-25;1840;47;31213;11402;15.6;5.7
58;2021-03-26;1414;56;32627;11458;16.3;5.7
58;2021-03-27;358;8;32985;11466;16.5;5.7
58;2021-03-28;20;0;33005;11466;16.5;5.7
58;2021-03-29;636;148;33641;11614;16.9;5.8
58;2021-03-30;1187;254;34828;11868;17.4;5.9
58;2021-03-31;1116;390;35944;12258;18.0;6.1
58;2021-04-01;1548;401;37492;12659;18.8;6.3
58;2021-04-02;1463;360;38955;13019;19.5;6.5
58;2021-04-03;568;148;39523;13167;19.8;6.6
58;2021-04-04;1;1;39524;13168;19.8;6.6
58;2021-04-05;47;0;39571;13168;19.8;6.6
58;2021-04-06;823;343;40394;13511;20.2;6.8
58;2021-04-07;695;550;41089;14061;20.6;7.0
58;2021-04-08;1493;427;42582;14488;21.3;7.3
58;2021-04-09;1775;486;44357;14974;22.2;7.5
58;2021-04-10;650;201;45007;15175;22.5;7.6
58;2021-04-11;17;3;45024;15178;22.6;7.6
58;2021-04-12;1117;502;46141;15680;23.1;7.9
58;2021-04-13;1435;629;47576;16309;23.8;8.2
58;2021-04-14;1355;692;48931;17001;24.5;8.5
58;2021-04-15;1438;605;50369;17606;25.2;8.8
58;2021-04-16;1734;516;52103;18122;26.1;9.1
58;2021-04-17;721;233;52824;18355;26.5;9.2
58;2021-04-18;20;7;52844;18362;26.5;9.2
58;2021-04-19;530;602;53374;18964;26.7;9.5
58;2021-04-20;487;1119;53861;20083;27.0;10.1
58;2021-04-21;628;967;54489;21050;27.3;10.5
58;2021-04-22;768;1519;55257;22569;27.7;11.3
58;2021-04-23;919;784;56176;23353;28.1;11.7
58;2021-04-24;211;206;56387;23559;28.3;11.8
58;2021-04-25;109;9;56496;23568;28.3;11.8
58;2021-04-26;762;248;57258;23816;28.7;11.9
58;2021-04-27;1499;1104;58757;24920;29.4;12.5
58;2021-04-28;1536;1041;60293;25961;30.2;13.0
58;2021-04-29;1444;1039;61737;27000;30.9;13.5
58;2021-04-30;1258;936;62995;27936;31.6;14.0
58;2021-05-01;6;17;63001;27953;31.6;14.0
58;2021-05-02;4;2;63005;27955;31.6;14.0
58;2021-05-03;1042;407;64047;28362;32.1;14.2
58;2021-05-04;1073;1344;65120;29706;32.6;14.9
58;2021-05-05;955;1092;66075;30798;33.1;15.4
58;2021-05-06;1363;1053;67438;31851;33.8;16.0
58;2021-05-07;1111;1088;68549;32939;34.3;16.5
58;2021-05-08;59;60;68608;32999;34.4;16.5
58;2021-05-09;7;21;68615;33020;34.4;16.5
58;2021-05-10;875;990;69490;34010;34.8;17.0
58;2021-05-11;1184;1981;70674;35991;35.4;18.0
58;2021-05-12;1660;1558;72334;37549;36.2;18.8
58;2021-05-13;49;183;72383;37732;36.3;18.9
58;2021-05-14;2311;907;74694;38639;37.4;19.4
58;2021-05-15;1726;456;76420;39095;38.3;19.6
58;2021-05-16;118;33;76538;39128;38.3;19.6
58;2021-05-17;793;611;77331;39739;38.7;19.9
58;2021-05-18;1333;1181;78664;40920;39.4;20.5
58;2021-05-19;1738;548;80402;41468;40.3;20.8
58;2021-05-20;1701;674;82103;42142;41.1;21.1
58;2021-05-21;854;719;82957;42861;41.6;21.5
58;2021-05-22;304;237;83261;43098;41.7;21.6
58;2021-05-23;2;21;83263;43119;41.7;21.6
58;2021-05-24;21;41;83284;43160;41.7;21.6
58;2021-05-25;1386;1155;84670;44315;42.4;22.2
58;2021-05-26;844;832;85514;45147;42.8;22.6
58;2021-05-27;753;935;86267;46082;43.2;23.1
58;2021-05-28;429;905;86696;46987;43.4;23.5
58;2021-05-29;151;209;86847;47196;43.5;23.6
58;2021-05-30;21;19;86868;47215;43.5;23.7
58;2021-05-31;757;385;87625;47600;43.9;23.8
58;2021-06-01;1372;1644;88997;49244;44.6;24.7
58;2021-06-02;1467;1049;90464;50293;45.3;25.2
58;2021-06-03;1024;956;91488;51249;45.8;25.7
58;2021-06-04;842;902;92330;52151;46.3;26.1
58;2021-06-05;272;263;92602;52414;46.4;26.3
58;2021-06-06;26;45;92628;52459;46.4;26.3
58;2021-06-07;712;791;93340;53250;46.8;26.7
58;2021-06-08;1321;1758;94661;55008;47.4;27.6
58;2021-06-09;1417;1007;96078;56015;48.1;28.1
58;2021-06-10;1106;974;97184;56989;48.7;28.6
58;2021-06-11;1023;907;98207;57896;49.2;29.0
58;2021-06-12;1056;415;99263;58311;49.7;29.2
58;2021-06-13;36;33;99299;58344;49.7;29.2
58;2021-06-14;516;1016;99815;59360;50.0;29.7
58;2021-06-15;1592;1757;101407;61117;50.8;30.6
58;2021-06-16;1806;992;103213;62109;51.7;31.1
58;2021-06-17;2023;1101;105236;63210;52.7;31.7
58;2021-06-18;986;1061;106222;64271;53.2;32.2
58;2021-06-19;581;320;106803;64591;53.5;32.4
58;2021-06-20;9;2;106812;64593;53.5;32.4
58;2021-06-21;472;553;107284;65146;53.8;32.6
58;2021-06-22;1028;1960;108312;67106;54.3;33.6
58;2021-06-23;1477;1504;109789;68610;55.0;34.4
58;2021-06-24;729;1022;110518;69632;55.4;34.9
58;2021-06-25;824;1719;111342;71351;55.8;35.7
58;2021-06-26;554;1228;111896;72579;56.1;36.4
58;2021-06-27;18;22;111914;72601;56.1;36.4
58;2021-06-28;463;987;112377;73588;56.3;36.9
58;2021-06-29;623;2161;113000;75749;56.6;38.0
58;2021-06-30;999;1624;113999;77373;57.1;38.8
58;2021-07-01;760;1670;114759;79043;57.5;39.6
58;2021-07-02;444;849;115203;79892;57.7;40.0
58;2021-07-03;249;512;115452;80404;57.8;40.3
58;2021-07-04;12;30;115464;80434;57.8;40.3
58;2021-07-05;510;763;115974;81197;58.1;40.7
58;2021-07-06;695;2121;116669;83318;58.5;41.7
58;2021-07-07;388;947;117057;84265;58.6;42.2
58;2021-07-08;399;1016;117456;85281;58.8;42.7
58;2021-07-09;709;1419;118165;86700;59.2;43.4
58;2021-07-10;260;412;118425;87112;59.3;43.6
58;2021-07-11;175;52;118600;87164;59.4;43.7
58;2021-07-12;197;965;118797;88129;59.5;44.2
58;2021-07-13;933;2503;119730;90632;60.0;45.4
58;2021-07-14;27;58;119757;90690;60.0;45.4
58;2021-07-15;1134;1935;120891;92625;60.6;46.4
58;2021-07-16;1411;1441;122302;94066;61.3;47.1
58;2021-07-17;463;288;122765;94354;61.5;47.3
58;2021-07-18;102;21;122867;94375;61.6;47.3
58;2021-07-19;1655;987;124522;95362;62.4;47.8
58;2021-07-20;1408;2455;125930;97817;63.1;49.0
58;2021-07-21;1178;2010;127108;99827;63.7;50.0
58;2021-07-22;1143;1670;128251;101497;64.3;50.9
58;2021-07-23;1268;1444;129519;102941;64.9;51.6
58;2021-07-24;1000;1271;130519;104212;65.4;52.2
58;2021-07-25;89;40;130608;104252;65.4;52.2
58;2021-07-26;980;858;131588;105110;65.9;52.7
58;2021-07-27;1566;2569;133154;107679;66.7;53.9
58;2021-07-28;1569;1969;134723;109648;67.5;54.9
58;2021-07-29;1580;1620;136303;111268;68.3;55.7
58;2021-07-30;1466;1428;137769;112696;69.0;56.5
58;2021-07-31;568;524;138337;113220;69.3;56.7
58;2021-08-01;35;13;138372;113233;69.3;56.7
58;2021-08-02;1590;854;139962;114087;70.1;57.2
58;2021-08-03;2051;1779;142013;115866;71.2;58.1
58;2021-08-04;1307;1184;143320;117050;71.8;58.6
58;2021-08-05;1621;1175;144941;118225;72.6;59.2
58;2021-08-06;1359;1032;146300;119257;73.3;59.7
58;2021-08-07;318;401;146618;119658;73.5;60.0
58;2021-08-08;30;58;146648;119716;73.5;60.0
58;2021-08-09;1083;1388;147731;121104;74.0;60.7
58;2021-08-10;1779;1387;149510;122491;74.9;61.4
58;2021-08-11;1134;780;150644;123271;75.5;61.8
58;2021-08-12;1067;1108;151711;124379;76.0;62.3
58;2021-08-13;931;955;152642;125334;76.5;62.8
58;2021-08-14;232;317;152874;125651;76.6;63.0
58;2021-08-15;14;27;152888;125678;76.6;63.0
58;2021-08-16;311;1402;153199;127080;76.8;63.7
58;2021-08-17;805;1337;154004;128417;77.2;64.3
58;2021-08-18;766;1171;154770;129588;77.5;64.9
58;2021-08-19;731;1342;155501;130930;77.9;65.6
58;2021-08-20;707;1298;156208;132228;78.3;66.2
58;2021-08-21;253;476;156461;132704;78.4;66.5
58;2021-08-22;9;86;156470;132790;78.4;66.5
58;2021-08-23;418;815;156888;133605;78.6;66.9
58;2021-08-24;513;1481;157401;135086;78.9;67.7
58;2021-08-25;434;1542;157835;136628;79.1;68.5
58;2021-08-26;551;1731;158386;138359;79.4;69.3
58;2021-08-27;494;1565;158880;139924;79.6;70.1
58;2021-08-28;244;640;159124;140564;79.7;70.4
58;2021-08-29;9;42;159133;140606;79.7;70.4
58;2021-08-30;356;808;159489;141414;79.9;70.9
58;2021-08-31;491;1607;159980;143021;80.2;71.7
58;2021-09-01;428;1676;160408;144697;80.4;72.5
58;2021-09-02;290;1361;160698;146058;80.5;73.2
58;2021-09-03;364;1564;161062;147622;80.7;74.0
58;2021-09-04;206;700;161268;148322;80.8;74.3
58;2021-09-05;3;27;161271;148349;80.8;74.3
58;2021-09-06;117;561;161388;148910;80.9;74.6
58;2021-09-07;319;986;161707;149896;81.0;75.1
58;2021-09-08;240;1330;161947;151226;81.1;75.8
58;2021-09-09;247;704;162194;151930;81.3;76.1
58;2021-09-10;260;962;162454;152892;81.4;76.6
58;2021-09-11;129;526;162583;153418;81.5;76.9
58;2021-09-12;5;17;162588;153435;81.5;76.9
58;2021-09-13;207;749;162795;154184;81.6;77.2
58;2021-09-14;290;973;163085;155157;81.7;77.7
58;2021-09-15;189;573;163274;155730;81.8;78.0
58;2021-09-16;205;451;163479;156181;81.9;78.2
58;2021-09-17;197;376;163676;156557;82.0;78.4
58;2021-09-18;118;363;163794;156920;82.1;78.6
58;2021-09-19;5;4;163799;156924;82.1;78.6
58;2021-09-20;173;228;163972;157152;82.2;78.7
58;2021-09-21;140;422;164112;157574;82.2;78.9
58;2021-09-22;160;536;164272;158110;82.3;79.2
58;2021-09-23;134;288;164406;158398;82.4;79.4
58;2021-09-24;110;389;164516;158787;82.4;79.6
58;2021-09-25;93;374;164609;159161;82.5;79.7
58;2021-09-26;6;13;164615;159174;82.5;79.7
58;2021-09-27;91;232;164706;159406;82.5;79.9
58;2021-09-28;125;328;164831;159734;82.6;80.0
58;2021-09-29;97;344;164928;160078;82.6;80.2
59;2020-12-27;1;0;1;0;0.0;0.0
59;2020-12-28;27;0;28;0;0.0;0.0
59;2020-12-29;0;0;28;0;0.0;0.0
59;2020-12-30;0;0;28;0;0.0;0.0
59;2020-12-31;2;0;30;0;0.0;0.0
59;2021-01-01;3;0;33;0;0.0;0.0
59;2021-01-02;3;0;36;0;0.0;0.0
59;2021-01-03;4;0;40;0;0.0;0.0
59;2021-01-04;79;0;119;0;0.0;0.0
59;2021-01-05;217;0;336;0;0.0;0.0
59;2021-01-06;429;1;765;1;0.0;0.0
59;2021-01-07;1314;0;2079;1;0.1;0.0
59;2021-01-08;1262;5;3341;6;0.1;0.0
59;2021-01-09;608;3;3949;9;0.2;0.0
59;2021-01-10;430;0;4379;9;0.2;0.0
59;2021-01-11;1846;5;6225;14;0.2;0.0
59;2021-01-12;2471;2;8696;16;0.3;0.0
59;2021-01-13;2366;2;11062;18;0.4;0.0
59;2021-01-14;2759;21;13821;39;0.5;0.0
59;2021-01-15;2275;15;16096;54;0.6;0.0
59;2021-01-16;771;1;16867;55;0.7;0.0
59;2021-01-17;560;2;17427;57;0.7;0.0
59;2021-01-18;3511;13;20938;70;0.8;0.0
59;2021-01-19;4757;8;25695;78;1.0;0.0
59;2021-01-20;4136;11;29831;89;1.2;0.0
59;2021-01-21;4731;31;34562;120;1.3;0.0
59;2021-01-22;4026;10;38588;130;1.5;0.0
59;2021-01-23;1217;3;39805;133;1.5;0.0
59;2021-01-24;170;0;39975;133;1.5;0.0
59;2021-01-25;2729;50;42704;183;1.6;0.0
59;2021-01-26;2824;127;45528;310;1.8;0.0
59;2021-01-27;1736;286;47264;596;1.8;0.0
59;2021-01-28;3398;714;50662;1310;2.0;0.1
59;2021-01-29;2543;717;53205;2027;2.1;0.1
59;2021-01-30;288;142;53493;2169;2.1;0.1
59;2021-01-31;24;0;53517;2169;2.1;0.1
59;2021-02-01;79;760;53596;2929;2.1;0.1
59;2021-02-02;691;1328;54287;4257;2.1;0.2
59;2021-02-03;3755;1341;58042;5598;2.2;0.2
59;2021-02-04;2966;1600;61008;7198;2.4;0.3
59;2021-02-05;1067;1278;62075;8476;2.4;0.3
59;2021-02-06;207;298;62282;8774;2.4;0.3
59;2021-02-07;268;49;62550;8823;2.4;0.3
59;2021-02-08;684;1364;63234;10187;2.4;0.4
59;2021-02-09;1015;1538;64249;11725;2.5;0.5
59;2021-02-10;975;1390;65224;13115;2.5;0.5
59;2021-02-11;1347;1590;66571;14705;2.6;0.6
59;2021-02-12;1415;1413;67986;16118;2.6;0.6
59;2021-02-13;207;594;68193;16712;2.6;0.6
59;2021-02-14;13;39;68206;16751;2.6;0.6
59;2021-02-15;1397;2175;69603;18926;2.7;0.7
59;2021-02-16;1436;2654;71039;21580;2.7;0.8
59;2021-02-17;1623;2731;72662;24311;2.8;0.9
59;2021-02-18;3106;4155;75768;28466;2.9;1.1
59;2021-02-19;3209;3031;78977;31497;3.1;1.2
59;2021-02-20;1413;1235;80390;32732;3.1;1.3
59;2021-02-21;242;236;80632;32968;3.1;1.3
59;2021-02-22;1430;1997;82062;34965;3.2;1.4
59;2021-02-23;2659;2277;84721;37242;3.3;1.4
59;2021-02-24;4108;3610;88829;40852;3.4;1.6
59;2021-02-25;6919;3446;95748;44298;3.7;1.7
59;2021-02-26;6496;1691;102244;45989;3.9;1.8
59;2021-02-27;3095;181;105339;46170;4.1;1.8
59;2021-02-28;208;59;105547;46229;4.1;1.8
59;2021-03-01;3692;577;109239;46806;4.2;1.8
59;2021-03-02;4794;515;114033;47321;4.4;1.8
59;2021-03-03;5748;925;119781;48246;4.6;1.9
59;2021-03-04;7083;876;126864;49122;4.9;1.9
59;2021-03-05;7836;900;134700;50022;5.2;1.9
59;2021-03-06;11562;480;146262;50502;5.6;2.0
59;2021-03-07;7586;322;153848;50824;5.9;2.0
59;2021-03-08;4497;1005;158345;51829;6.1;2.0
59;2021-03-09;6578;1277;164923;53106;6.4;2.1
59;2021-03-10;7028;1072;171951;54178;6.6;2.1
59;2021-03-11;9476;1777;181427;55955;7.0;2.2
59;2021-03-12;12158;1487;193585;57442;7.5;2.2
59;2021-03-13;16557;1060;210142;58502;8.1;2.3
59;2021-03-14;6963;326;217105;58828;8.4;2.3
59;2021-03-15;5613;1438;222718;60266;8.6;2.3
59;2021-03-16;3741;1269;226459;61535;8.7;2.4
59;2021-03-17;3856;2044;230315;63579;8.9;2.5
59;2021-03-18;3956;2430;234271;66009;9.0;2.5
59;2021-03-19;7743;1753;242014;67762;9.3;2.6
59;2021-03-20;16023;1267;258037;69029;10.0;2.7
59;2021-03-21;6318;444;264355;69473;10.2;2.7
59;2021-03-22;5449;1738;269804;71211;10.4;2.8
59;2021-03-23;7772;2776;277576;73987;10.7;2.9
59;2021-03-24;6861;2934;284437;76921;11.0;3.0
59;2021-03-25;10534;2536;294971;79457;11.4;3.1
59;2021-03-26;12253;2805;307224;82262;11.9;3.2
59;2021-03-27;15275;1148;322499;83410;12.5;3.2
59;2021-03-28;7984;358;330483;83768;12.8;3.2
59;2021-03-29;5495;3170;335978;86938;13.0;3.4
59;2021-03-30;7540;3726;343518;90664;13.3;3.5
59;2021-03-31;6156;4068;349674;94732;13.5;3.7
59;2021-04-01;7493;4899;357167;99631;13.8;3.8
59;2021-04-02;7645;5494;364812;105125;14.1;4.1
59;2021-04-03;13018;4292;377830;109417;14.6;4.2
59;2021-04-04;5348;2175;383178;111592;14.8;4.3
59;2021-04-05;6020;1529;389198;113121;15.0;4.4
59;2021-04-06;5406;4473;394604;117594;15.2;4.5
59;2021-04-07;7622;5416;402226;123010;15.5;4.8
59;2021-04-08;10393;5736;412619;128746;15.9;5.0
59;2021-04-09;13421;5920;426040;134666;16.5;5.2
59;2021-04-10;11478;6124;437518;140790;16.9;5.4
59;2021-04-11;4636;3554;442154;144344;17.1;5.6
59;2021-04-12;6304;4342;448458;148686;17.3;5.7
59;2021-04-13;8934;4783;457392;153469;17.7;5.9
59;2021-04-14;8788;4341;466180;157810;18.0;6.1
59;2021-04-15;10306;4842;476486;162652;18.4;6.3
59;2021-04-16;10879;5496;487365;168148;18.8;6.5
59;2021-04-17;7295;9068;494660;177216;19.1;6.8
59;2021-04-18;3234;4158;497894;181374;19.2;7.0
59;2021-04-19;5044;4287;502938;185661;19.4;7.2
59;2021-04-20;6898;4206;509836;189867;19.7;7.3
59;2021-04-21;6271;4421;516107;194288;19.9;7.5
59;2021-04-22;8612;5515;524719;199803;20.3;7.7
59;2021-04-23;8460;5678;533179;205481;20.6;7.9
59;2021-04-24;5537;8046;538716;213527;20.8;8.2
59;2021-04-25;3242;6075;541958;219602;20.9;8.5
59;2021-04-26;6493;3775;548451;223377;21.2;8.6
59;2021-04-27;8366;5156;556817;228533;21.5;8.8
59;2021-04-28;8767;6530;565584;235063;21.8;9.1
59;2021-04-29;9417;8489;575001;243552;22.2;9.4
59;2021-04-30;10605;8468;585606;252020;22.6;9.7
59;2021-05-01;11998;7597;597604;259617;23.1;10.0
59;2021-05-02;8642;5990;606246;265607;23.4;10.3
59;2021-05-03;9552;5044;615798;270651;23.8;10.5
59;2021-05-04;11426;5965;627224;276616;24.2;10.7
59;2021-05-05;10295;6189;637519;282805;24.6;10.9
59;2021-05-06;11196;8427;648715;291232;25.1;11.2
59;2021-05-07;13297;9560;662012;300792;25.6;11.6
59;2021-05-08;14741;4169;676753;304961;26.1;11.8
59;2021-05-09;11492;3329;688245;308290;26.6;11.9
59;2021-05-10;12746;6622;700991;314912;27.1;12.2
59;2021-05-11;15112;8300;716103;323212;27.7;12.5
59;2021-05-12;16625;8627;732728;331839;28.3;12.8
59;2021-05-13;18440;3456;751168;335295;29.0;13.0
59;2021-05-14;15782;6960;766950;342255;29.6;13.2
59;2021-05-15;23443;5281;790393;347536;30.5;13.4
59;2021-05-16;21177;2416;811570;349952;31.3;13.5
59;2021-05-17;15066;5256;826636;355208;31.9;13.7
59;2021-05-18;16922;5658;843558;360866;32.6;13.9
59;2021-05-19;18318;5107;861876;365973;33.3;14.1
59;2021-05-20;17933;6983;879809;372956;34.0;14.4
59;2021-05-21;18370;8260;898179;381216;34.7;14.7
59;2021-05-22;23809;5669;921988;386885;35.6;14.9
59;2021-05-23;17921;2275;939909;389160;36.3;15.0
59;2021-05-24;16690;2144;956599;391304;36.9;15.1
59;2021-05-25;14990;6651;971589;397955;37.5;15.4
59;2021-05-26;15892;7029;987481;404984;38.1;15.6
59;2021-05-27;16151;9154;1003632;414138;38.8;16.0
59;2021-05-28;15884;11419;1019516;425557;39.4;16.4
59;2021-05-29;14370;8686;1033886;434243;39.9;16.8
59;2021-05-30;8406;1840;1042292;436083;40.3;16.8
59;2021-05-31;14203;7947;1056495;444030;40.8;17.2
59;2021-06-01;15088;10361;1071583;454391;41.4;17.6
59;2021-06-02;14769;9901;1086352;464292;42.0;17.9
59;2021-06-03;15630;12100;1101982;476392;42.6;18.4
59;2021-06-04;15608;13437;1117590;489829;43.2;18.9
59;2021-06-05;14979;9335;1132569;499164;43.7;19.3
59;2021-06-06;8826;3205;1141395;502369;44.1;19.4
59;2021-06-07;10526;9415;1151921;511784;44.5;19.8
59;2021-06-08;11759;11072;1163680;522856;44.9;20.2
59;2021-06-09;10759;11880;1174439;534736;45.4;20.7
59;2021-06-10;11502;12306;1185941;547042;45.8;21.1
59;2021-06-11;10973;15970;1196914;563012;46.2;21.7
59;2021-06-12;11068;13673;1207982;576685;46.7;22.3
59;2021-06-13;6344;7028;1214326;583713;46.9;22.5
59;2021-06-14;6505;12674;1220831;596387;47.2;23.0
59;2021-06-15;8231;15944;1229062;612331;47.5;23.7
59;2021-06-16;9203;13540;1238265;625871;47.8;24.2
59;2021-06-17;9187;15644;1247452;641515;48.2;24.8
59;2021-06-18;9081;20057;1256533;661572;48.5;25.6
59;2021-06-19;8953;17487;1265486;679059;48.9;26.2
59;2021-06-20;4900;10188;1270386;689247;49.1;26.6
59;2021-06-21;5280;15964;1275666;705211;49.3;27.2
59;2021-06-22;6336;18671;1282002;723882;49.5;28.0
59;2021-06-23;6168;19081;1288170;742963;49.8;28.7
59;2021-06-24;7338;20518;1295508;763481;50.0;29.5
59;2021-06-25;6507;21190;1302015;784671;50.3;30.3
59;2021-06-26;6489;23744;1308504;808415;50.5;31.2
59;2021-06-27;4752;17077;1313256;825492;50.7;31.9
59;2021-06-28;5003;19812;1318259;845304;50.9;32.6
59;2021-06-29;5549;20376;1323808;865680;51.1;33.4
59;2021-06-30;6132;20095;1329940;885775;51.4;34.2
59;2021-07-01;6771;20837;1336711;906612;51.6;35.0
59;2021-07-02;6837;23240;1343548;929852;51.9;35.9
59;2021-07-03;5562;24605;1349110;954457;52.1;36.9
59;2021-07-04;4416;15976;1353526;970433;52.3;37.5
59;2021-07-05;5671;17486;1359197;987919;52.5;38.2
59;2021-07-06;6609;18796;1365806;1006715;52.8;38.9
59;2021-07-07;6939;17447;1372745;1024162;53.0;39.6
59;2021-07-08;8027;17682;1380772;1041844;53.3;40.2
59;2021-07-09;7706;20297;1388478;1062141;53.6;41.0
59;2021-07-10;7450;18538;1395928;1080679;53.9;41.7
59;2021-07-11;4448;10231;1400376;1090910;54.1;42.1
59;2021-07-12;5917;18043;1406293;1108953;54.3;42.8
59;2021-07-13;9911;20750;1416204;1129703;54.7;43.6
59;2021-07-14;9782;8453;1425986;1138156;55.1;44.0
59;2021-07-15;11638;20386;1437624;1158542;55.5;44.7
59;2021-07-16;13216;20490;1450840;1179032;56.0;45.5
59;2021-07-17;12399;17467;1463239;1196499;56.5;46.2
59;2021-07-18;7963;8684;1471202;1205183;56.8;46.6
59;2021-07-19;10404;16443;1481606;1221626;57.2;47.2
59;2021-07-20;13409;17120;1495015;1238746;57.7;47.8
59;2021-07-21;14525;15596;1509540;1254342;58.3;48.4
59;2021-07-22;17061;15204;1526601;1269546;59.0;49.0
59;2021-07-23;15729;15823;1542330;1285369;59.6;49.6
59;2021-07-24;16356;12298;1558686;1297667;60.2;50.1
59;2021-07-25;11916;7340;1570602;1305007;60.7;50.4
59;2021-07-26;13041;12612;1583643;1317619;61.2;50.9
59;2021-07-27;16228;11958;1599871;1329577;61.8;51.4
59;2021-07-28;17453;11664;1617324;1341241;62.5;51.8
59;2021-07-29;17423;11670;1634747;1352911;63.1;52.3
59;2021-07-30;15921;11608;1650668;1364519;63.8;52.7
59;2021-07-31;14020;9209;1664688;1373728;64.3;53.1
59;2021-08-01;9959;4572;1674647;1378300;64.7;53.2
59;2021-08-02;12211;10030;1686858;1388330;65.2;53.6
59;2021-08-03;13450;10056;1700308;1398386;65.7;54.0
59;2021-08-04;11236;8284;1711544;1406670;66.1;54.3
59;2021-08-05;12721;9785;1724265;1416455;66.6;54.7
59;2021-08-06;12561;11039;1736826;1427494;67.1;55.1
59;2021-08-07;9739;9300;1746565;1436794;67.5;55.5
59;2021-08-08;6958;5263;1753523;1442057;67.7;55.7
59;2021-08-09;8409;10826;1761932;1452883;68.1;56.1
59;2021-08-10;10405;10755;1772337;1463638;68.5;56.5
59;2021-08-11;8674;9320;1781011;1472958;68.8;56.9
59;2021-08-12;9002;12075;1790013;1485033;69.1;57.4
59;2021-08-13;8634;11748;1798647;1496781;69.5;57.8
59;2021-08-14;5951;10392;1804598;1507173;69.7;58.2
59;2021-08-15;3376;4666;1807974;1511839;69.8;58.4
59;2021-08-16;5876;13864;1813850;1525703;70.1;58.9
59;2021-08-17;6986;12764;1820836;1538467;70.3;59.4
59;2021-08-18;5955;11468;1826791;1549935;70.6;59.9
59;2021-08-19;6352;13870;1833143;1563805;70.8;60.4
59;2021-08-20;5833;14585;1838976;1578390;71.0;61.0
59;2021-08-21;4191;10295;1843167;1588685;71.2;61.4
59;2021-08-22;2849;7651;1846016;1596336;71.3;61.7
59;2021-08-23;4785;15731;1850801;1612067;71.5;62.3
59;2021-08-24;5298;15189;1856099;1627256;71.7;62.9
59;2021-08-25;4665;13085;1860764;1640341;71.9;63.4
59;2021-08-26;5208;14348;1865972;1654689;72.1;63.9
59;2021-08-27;5003;15428;1870975;1670117;72.3;64.5
59;2021-08-28;3807;12372;1874782;1682489;72.4;65.0
59;2021-08-29;1942;8434;1876724;1690923;72.5;65.3
59;2021-08-30;3888;12944;1880612;1703867;72.6;65.8
59;2021-08-31;3818;12943;1884430;1716810;72.8;66.3
59;2021-09-01;3291;10714;1887721;1727524;72.9;66.7
59;2021-09-02;3192;10951;1890913;1738475;73.0;67.1
59;2021-09-03;3790;12124;1894703;1750599;73.2;67.6
59;2021-09-04;3391;9963;1898094;1760562;73.3;68.0
59;2021-09-05;1206;3653;1899300;1764215;73.4;68.1
59;2021-09-06;2135;7319;1901435;1771534;73.4;68.4
59;2021-09-07;2250;7049;1903685;1778583;73.5;68.7
59;2021-09-08;2569;7506;1906254;1786089;73.6;69.0
59;2021-09-09;2412;6702;1908666;1792791;73.7;69.2
59;2021-09-10;3273;8098;1911939;1800889;73.8;69.6
59;2021-09-11;2585;7514;1914524;1808403;73.9;69.8
59;2021-09-12;909;2921;1915433;1811324;74.0;70.0
59;2021-09-13;1945;5504;1917378;1816828;74.1;70.2
59;2021-09-14;2312;5953;1919690;1822781;74.1;70.4
59;2021-09-15;2272;5354;1921962;1828135;74.2;70.6
59;2021-09-16;2168;4257;1924130;1832392;74.3;70.8
59;2021-09-17;2907;5444;1927037;1837836;74.4;71.0
59;2021-09-18;1779;5918;1928816;1843754;74.5;71.2
59;2021-09-19;382;1300;1929198;1845054;74.5;71.3
59;2021-09-20;1356;3299;1930554;1848353;74.6;71.4
59;2021-09-21;1335;2936;1931889;1851289;74.6;71.5
59;2021-09-22;1406;4737;1933295;1856026;74.7;71.7
59;2021-09-23;1516;2816;1934811;1858842;74.7;71.8
59;2021-09-24;1900;4237;1936711;1863079;74.8;72.0
59;2021-09-25;1157;4014;1937868;1867093;74.9;72.1
59;2021-09-26;313;1207;1938181;1868300;74.9;72.2
59;2021-09-27;1086;2529;1939267;1870829;74.9;72.3
59;2021-09-28;1063;2181;1940330;1873010;74.9;72.3
59;2021-09-29;1267;2943;1941597;1875953;75.0;72.5
60;2020-12-27;0;0;0;0;0.0;0.0
60;2020-12-28;0;0;0;0;0.0;0.0
60;2020-12-29;1;0;1;0;0.0;0.0
60;2020-12-30;1;0;2;0;0.0;0.0
60;2020-12-31;0;0;2;0;0.0;0.0
60;2021-01-01;0;0;2;0;0.0;0.0
60;2021-01-02;5;0;7;0;0.0;0.0
60;2021-01-03;1;0;8;0;0.0;0.0
60;2021-01-04;1;0;9;0;0.0;0.0
60;2021-01-05;37;0;46;0;0.0;0.0
60;2021-01-06;188;3;234;3;0.0;0.0
60;2021-01-07;235;4;469;7;0.1;0.0
60;2021-01-08;380;4;849;11;0.1;0.0
60;2021-01-09;3;0;852;11;0.1;0.0
60;2021-01-10;60;0;912;11;0.1;0.0
60;2021-01-11;345;2;1257;13;0.2;0.0
60;2021-01-12;537;2;1794;15;0.2;0.0
60;2021-01-13;475;5;2269;20;0.3;0.0
60;2021-01-14;507;6;2776;26;0.3;0.0
60;2021-01-15;703;7;3479;33;0.4;0.0
60;2021-01-16;124;1;3603;34;0.4;0.0
60;2021-01-17;32;0;3635;34;0.4;0.0
60;2021-01-18;860;7;4495;41;0.5;0.0
60;2021-01-19;1207;11;5702;52;0.7;0.0
60;2021-01-20;1719;11;7421;63;0.9;0.0
60;2021-01-21;2265;8;9686;71;1.2;0.0
60;2021-01-22;1547;14;11233;85;1.4;0.0
60;2021-01-23;499;4;11732;89;1.4;0.0
60;2021-01-24;61;1;11793;90;1.4;0.0
60;2021-01-25;897;14;12690;104;1.5;0.0
60;2021-01-26;950;16;13640;120;1.7;0.0
60;2021-01-27;646;6;14286;126;1.7;0.0
60;2021-01-28;396;164;14682;290;1.8;0.0
60;2021-01-29;77;98;14759;388;1.8;0.0
60;2021-01-30;0;1;14759;389;1.8;0.0
60;2021-01-31;22;57;14781;446;1.8;0.1
60;2021-02-01;39;102;14820;548;1.8;0.1
60;2021-02-02;26;143;14846;691;1.8;0.1
60;2021-02-03;165;228;15011;919;1.8;0.1
60;2021-02-04;170;331;15181;1250;1.8;0.2
60;2021-02-05;315;463;15496;1713;1.9;0.2
60;2021-02-06;65;76;15561;1789;1.9;0.2
60;2021-02-07;31;30;15592;1819;1.9;0.2
60;2021-02-08;329;486;15921;2305;1.9;0.3
60;2021-02-09;319;427;16240;2732;2.0;0.3
60;2021-02-10;556;945;16796;3677;2.0;0.4
60;2021-02-11;942;1059;17738;4736;2.1;0.6
60;2021-02-12;917;807;18655;5543;2.3;0.7
60;2021-02-13;91;289;18746;5832;2.3;0.7
60;2021-02-14;24;81;18770;5913;2.3;0.7
60;2021-02-15;614;633;19384;6546;2.3;0.8
60;2021-02-16;580;781;19964;7327;2.4;0.9
60;2021-02-17;633;757;20597;8084;2.5;1.0
60;2021-02-18;684;696;21281;8780;2.6;1.1
60;2021-02-19;641;624;21922;9404;2.7;1.1
60;2021-02-20;104;155;22026;9559;2.7;1.2
60;2021-02-21;23;99;22049;9658;2.7;1.2
60;2021-02-22;461;736;22510;10394;2.7;1.3
60;2021-02-23;535;656;23045;11050;2.8;1.3
60;2021-02-24;794;465;23839;11515;2.9;1.4
60;2021-02-25;1095;249;24934;11764;3.0;1.4
60;2021-02-26;1298;168;26232;11932;3.2;1.4
60;2021-02-27;666;35;26898;11967;3.3;1.5
60;2021-02-28;7;10;26905;11977;3.3;1.5
60;2021-03-01;894;47;27799;12024;3.4;1.5
60;2021-03-02;1013;158;28812;12182;3.5;1.5
60;2021-03-03;1320;424;30132;12606;3.7;1.5
60;2021-03-04;1725;472;31857;13078;3.9;1.6
60;2021-03-05;1822;283;33679;13361;4.1;1.6
60;2021-03-06;1919;141;35598;13502;4.3;1.6
60;2021-03-07;885;31;36483;13533;4.4;1.6
60;2021-03-08;978;292;37461;13825;4.5;1.7
60;2021-03-09;1642;327;39103;14152;4.7;1.7
60;2021-03-10;1938;396;41041;14548;5.0;1.8
60;2021-03-11;2325;363;43366;14911;5.3;1.8
60;2021-03-12;2596;525;45962;15436;5.6;1.9
60;2021-03-13;3839;206;49801;15642;6.0;1.9
60;2021-03-14;1782;63;51583;15705;6.3;1.9
60;2021-03-15;2090;484;53673;16189;6.5;2.0
60;2021-03-16;1584;616;55257;16805;6.7;2.0
60;2021-03-17;1658;600;56915;17405;6.9;2.1
60;2021-03-18;1759;728;58674;18133;7.1;2.2
60;2021-03-19;2591;521;61265;18654;7.4;2.3
60;2021-03-20;3241;191;64506;18845;7.8;2.3
60;2021-03-21;2124;97;66630;18942;8.1;2.3
60;2021-03-22;2132;704;68762;19646;8.3;2.4
60;2021-03-23;3310;712;72072;20358;8.7;2.5
60;2021-03-24;3070;863;75142;21221;9.1;2.6
60;2021-03-25;3849;842;78991;22063;9.6;2.7
60;2021-03-26;4217;869;83208;22932;10.1;2.8
60;2021-03-27;4142;321;87350;23253;10.6;2.8
60;2021-03-28;2450;83;89800;23336;10.9;2.8
60;2021-03-29;2612;1079;92412;24415;11.2;3.0
60;2021-03-30;3285;1068;95697;25483;11.6;3.1
60;2021-03-31;2668;1134;98365;26617;11.9;3.2
60;2021-04-01;2562;1102;100927;27719;12.2;3.4
60;2021-04-02;3309;1112;104236;28831;12.6;3.5
60;2021-04-03;3171;1010;107407;29841;13.0;3.6
60;2021-04-04;874;485;108281;30326;13.1;3.7
60;2021-04-05;458;81;108739;30407;13.2;3.7
60;2021-04-06;1968;1619;110707;32026;13.4;3.9
60;2021-04-07;1984;1745;112691;33771;13.7;4.1
60;2021-04-08;2611;1496;115302;35267;14.0;4.3
60;2021-04-09;2999;1522;118301;36789;14.3;4.5
60;2021-04-10;2927;1586;121228;38375;14.7;4.7
60;2021-04-11;1045;998;122273;39373;14.8;4.8
60;2021-04-12;2045;1721;124318;41094;15.1;5.0
60;2021-04-13;2749;1786;127067;42880;15.4;5.2
60;2021-04-14;3143;1822;130210;44702;15.8;5.4
60;2021-04-15;3563;1891;133773;46593;16.2;5.6
60;2021-04-16;3288;1952;137061;48545;16.6;5.9
60;2021-04-17;2848;2168;139909;50713;17.0;6.1
60;2021-04-18;573;1833;140482;52546;17.0;6.4
60;2021-04-19;1742;2213;142224;54759;17.2;6.6
60;2021-04-20;2129;2677;144353;57436;17.5;7.0
60;2021-04-21;2653;2208;147006;59644;17.8;7.2
60;2021-04-22;2628;2507;149634;62151;18.1;7.5
60;2021-04-23;2651;2499;152285;64650;18.5;7.8
60;2021-04-24;2470;3450;154755;68100;18.8;8.3
60;2021-04-25;1159;1959;155914;70059;18.9;8.5
60;2021-04-26;1890;2522;157804;72581;19.1;8.8
60;2021-04-27;2311;2836;160115;75417;19.4;9.1
60;2021-04-28;3061;2392;163176;77809;19.8;9.4
60;2021-04-29;3154;2622;166330;80431;20.2;9.7
60;2021-04-30;3459;2957;169789;83388;20.6;10.1
60;2021-05-01;2353;1124;172142;84512;20.9;10.2
60;2021-05-02;2147;846;174289;85358;21.1;10.3
60;2021-05-03;2956;1857;177245;87215;21.5;10.6
60;2021-05-04;3016;2352;180261;89567;21.8;10.9
60;2021-05-05;3260;2810;183521;92377;22.2;11.2
60;2021-05-06;3649;2478;187170;94855;22.7;11.5
60;2021-05-07;3985;2513;191155;97368;23.2;11.8
60;2021-05-08;3582;969;194737;98337;23.6;11.9
60;2021-05-09;3458;959;198195;99296;24.0;12.0
60;2021-05-10;2391;2294;200586;101590;24.3;12.3
60;2021-05-11;3671;2464;204257;104054;24.8;12.6
60;2021-05-12;4716;2553;208973;106607;25.3;12.9
60;2021-05-13;5292;1131;214265;107738;26.0;13.1
60;2021-05-14;5601;1807;219866;109545;26.6;13.3
60;2021-05-15;6172;1719;226038;111264;27.4;13.5
60;2021-05-16;4858;690;230896;111954;28.0;13.6
60;2021-05-17;3714;1674;234610;113628;28.4;13.8
60;2021-05-18;4045;2074;238655;115702;28.9;14.0
60;2021-05-19;5097;1857;243752;117559;29.5;14.2
60;2021-05-20;5459;1803;249211;119362;30.2;14.5
60;2021-05-21;5969;1970;255180;121332;30.9;14.7
60;2021-05-22;5354;1974;260534;123306;31.6;14.9
60;2021-05-23;4263;658;264797;123964;32.1;15.0
60;2021-05-24;2950;534;267747;124498;32.5;15.1
60;2021-05-25;4138;2005;271885;126503;33.0;15.3
60;2021-05-26;4466;1833;276351;128336;33.5;15.6
60;2021-05-27;4611;1995;280962;130331;34.1;15.8
60;2021-05-28;4626;2492;285588;132823;34.6;16.1
60;2021-05-29;4612;2268;290200;135091;35.2;16.4
60;2021-05-30;1086;347;291286;135438;35.3;16.4
60;2021-05-31;3831;2083;295117;137521;35.8;16.7
60;2021-06-01;4445;2844;299562;140365;36.3;17.0
60;2021-06-02;3916;2443;303478;142808;36.8;17.3
60;2021-06-03;3903;2370;307381;145178;37.3;17.6
60;2021-06-04;4651;2906;312032;148084;37.8;17.9
60;2021-06-05;4302;3418;316334;151502;38.3;18.4
60;2021-06-06;2159;795;318493;152297;38.6;18.5
60;2021-06-07;2778;2761;321271;155058;38.9;18.8
60;2021-06-08;3801;2999;325072;158057;39.4;19.2
60;2021-06-09;3249;3400;328321;161457;39.8;19.6
60;2021-06-10;3454;3365;331775;164822;40.2;20.0
60;2021-06-11;3881;4188;335656;169010;40.7;20.5
60;2021-06-12;3780;4280;339436;173290;41.1;21.0
60;2021-06-13;1154;2225;340590;175515;41.3;21.3
60;2021-06-14;1911;3307;342501;178822;41.5;21.7
60;2021-06-15;3015;4159;345516;182981;41.9;22.2
60;2021-06-16;3250;4487;348766;187468;42.3;22.7
60;2021-06-17;2978;4782;351744;192250;42.6;23.3
60;2021-06-18;2982;4603;354726;196853;43.0;23.9
60;2021-06-19;3144;4725;357870;201578;43.4;24.4
60;2021-06-20;1431;1936;359301;203514;43.5;24.7
60;2021-06-21;1408;4042;360709;207556;43.7;25.2
60;2021-06-22;1758;5286;362467;212842;43.9;25.8
60;2021-06-23;1860;5232;364327;218074;44.2;26.4
60;2021-06-24;1802;5600;366129;223674;44.4;27.1
60;2021-06-25;1905;5729;368034;229403;44.6;27.8
60;2021-06-26;1860;6972;369894;236375;44.8;28.6
60;2021-06-27;713;2593;370607;238968;44.9;29.0
60;2021-06-28;1781;4141;372388;243109;45.1;29.5
60;2021-06-29;2010;5460;374398;248569;45.4;30.1
60;2021-06-30;2296;5358;376694;253927;45.7;30.8
60;2021-07-01;1888;4917;378582;258844;45.9;31.4
60;2021-07-02;2370;5875;380952;264719;46.2;32.1
60;2021-07-03;2400;6157;383352;270876;46.5;32.8
60;2021-07-04;792;2724;384144;273600;46.6;33.2
60;2021-07-05;1659;4406;385803;278006;46.8;33.7
60;2021-07-06;2146;4494;387949;282500;47.0;34.2
60;2021-07-07;2174;5116;390123;287616;47.3;34.9
60;2021-07-08;2672;4689;392795;292305;47.6;35.4
60;2021-07-09;2640;5564;395435;297869;47.9;36.1
60;2021-07-10;2579;5874;398014;303743;48.2;36.8
60;2021-07-11;1212;1942;399226;305685;48.4;37.0
60;2021-07-12;1446;4736;400672;310421;48.6;37.6
60;2021-07-13;2912;5019;403584;315440;48.9;38.2
60;2021-07-14;2584;1408;406168;316848;49.2;38.4
60;2021-07-15;3429;4870;409597;321718;49.6;39.0
60;2021-07-16;3698;5238;413295;326956;50.1;39.6
60;2021-07-17;4079;5132;417374;332088;50.6;40.2
60;2021-07-18;2186;2130;419560;334218;50.9;40.5
60;2021-07-19;2542;3888;422102;338106;51.2;41.0
60;2021-07-20;4197;4896;426299;343002;51.7;41.6
60;2021-07-21;4352;4284;430651;347286;52.2;42.1
60;2021-07-22;4627;4331;435278;351617;52.8;42.6
60;2021-07-23;4981;4900;440259;356517;53.4;43.2
60;2021-07-24;4314;4674;444573;361191;53.9;43.8
60;2021-07-25;2603;1831;447176;363022;54.2;44.0
60;2021-07-26;3376;3756;450552;366778;54.6;44.5
60;2021-07-27;4435;4627;454987;371405;55.1;45.0
60;2021-07-28;4551;3769;459538;375174;55.7;45.5
60;2021-07-29;4901;3709;464439;378883;56.3;45.9
60;2021-07-30;5030;4260;469469;383143;56.9;46.4
60;2021-07-31;4063;3968;473532;387111;57.4;46.9
60;2021-08-01;1682;862;475214;387973;57.6;47.0
60;2021-08-02;3200;2754;478414;390727;58.0;47.4
60;2021-08-03;3605;2893;482019;393620;58.4;47.7
60;2021-08-04;3316;2795;485335;396415;58.8;48.0
60;2021-08-05;3032;2259;488367;398674;59.2;48.3
60;2021-08-06;3830;3055;492197;401729;59.7;48.7
60;2021-08-07;3369;3076;495566;404805;60.1;49.1
60;2021-08-08;1534;910;497100;405715;60.2;49.2
60;2021-08-09;2205;2872;499305;408587;60.5;49.5
60;2021-08-10;3277;3308;502582;411895;60.9;49.9
60;2021-08-11;2814;3235;505396;415130;61.3;50.3
60;2021-08-12;2355;2665;507751;417795;61.5;50.6
60;2021-08-13;2751;2998;510502;420793;61.9;51.0
60;2021-08-14;2540;2734;513042;423527;62.2;51.3
60;2021-08-15;1361;553;514403;424080;62.3;51.4
60;2021-08-16;2114;3774;516517;427854;62.6;51.9
60;2021-08-17;2345;3819;518862;431673;62.9;52.3
60;2021-08-18;1944;3284;520806;434957;63.1;52.7
60;2021-08-19;1647;3074;522453;438031;63.3;53.1
60;2021-08-20;1866;3999;524319;442030;63.5;53.6
60;2021-08-21;1611;3491;525930;445521;63.7;54.0
60;2021-08-22;578;1339;526508;446860;63.8;54.2
60;2021-08-23;1103;3223;527611;450083;63.9;54.6
60;2021-08-24;1369;4494;528980;454577;64.1;55.1
60;2021-08-25;1430;3585;530410;458162;64.3;55.5
60;2021-08-26;1431;3459;531841;461621;64.5;55.9
60;2021-08-27;1434;4172;533275;465793;64.6;56.5
60;2021-08-28;1378;4478;534653;470271;64.8;57.0
60;2021-08-29;550;2041;535203;472312;64.9;57.2
60;2021-08-30;1231;3000;536434;475312;65.0;57.6
60;2021-08-31;1639;3853;538073;479165;65.2;58.1
60;2021-09-01;1237;2796;539310;481961;65.4;58.4
60;2021-09-02;1057;2715;540367;484676;65.5;58.7
60;2021-09-03;1023;3179;541390;487855;65.6;59.1
60;2021-09-04;1520;3735;542910;491590;65.8;59.6
60;2021-09-05;365;1364;543275;492954;65.8;59.7
60;2021-09-06;795;2579;544070;495533;65.9;60.1
60;2021-09-07;837;2985;544907;498518;66.0;60.4
60;2021-09-08;885;2992;545792;501510;66.2;60.8
60;2021-09-09;679;2360;546471;503870;66.2;61.1
60;2021-09-10;1047;3004;547518;506874;66.4;61.4
60;2021-09-11;1059;3492;548577;510366;66.5;61.9
60;2021-09-12;305;1138;548882;511504;66.5;62.0
60;2021-09-13;609;1943;549491;513447;66.6;62.2
60;2021-09-14;756;1847;550247;515294;66.7;62.5
60;2021-09-15;563;1240;550810;516534;66.8;62.6
60;2021-09-16;916;1403;551726;517937;66.9;62.8
60;2021-09-17;712;1465;552438;519402;67.0;63.0
60;2021-09-18;817;2607;553255;522009;67.1;63.3
60;2021-09-19;189;497;553444;522506;67.1;63.3
60;2021-09-20;456;1097;553900;523603;67.1;63.5
60;2021-09-21;499;983;554399;524586;67.2;63.6
60;2021-09-22;442;1306;554841;525892;67.2;63.7
60;2021-09-23;625;897;555466;526789;67.3;63.8
60;2021-09-24;489;1194;555955;527983;67.4;64.0
60;2021-09-25;493;1870;556448;529853;67.4;64.2
60;2021-09-26;78;294;556526;530147;67.5;64.3
60;2021-09-27;328;759;556854;530906;67.5;64.3
60;2021-09-28;320;881;557174;531787;67.5;64.5
60;2021-09-29;385;1030;557559;532817;67.6;64.6
61;2020-12-27;0;0;0;0;0.0;0.0
61;2020-12-28;0;0;0;0;0.0;0.0
61;2020-12-29;0;0;0;0;0.0;0.0
61;2020-12-30;0;0;0;0;0.0;0.0
61;2020-12-31;0;0;0;0;0.0;0.0
61;2021-01-01;1;0;1;0;0.0;0.0
61;2021-01-02;1;0;2;0;0.0;0.0
61;2021-01-03;0;0;2;0;0.0;0.0
61;2021-01-04;1;0;3;0;0.0;0.0
61;2021-01-05;3;0;6;0;0.0;0.0
61;2021-01-06;77;0;83;0;0.0;0.0
61;2021-01-07;175;2;258;2;0.1;0.0
61;2021-01-08;406;1;664;3;0.2;0.0
61;2021-01-09;165;1;829;4;0.3;0.0
61;2021-01-10;49;0;878;4;0.3;0.0
61;2021-01-11;396;1;1274;5;0.5;0.0
61;2021-01-12;681;2;1955;7;0.7;0.0
61;2021-01-13;740;1;2695;8;1.0;0.0
61;2021-01-14;530;7;3225;15;1.2;0.0
61;2021-01-15;537;4;3762;19;1.4;0.0
61;2021-01-16;289;1;4051;20;1.5;0.0
61;2021-01-17;888;6;4939;26;1.8;0.0
61;2021-01-18;1913;2;6852;28;2.5;0.0
61;2021-01-19;1326;3;8178;31;3.0;0.0
61;2021-01-20;685;0;8863;31;3.2;0.0
61;2021-01-21;848;1;9711;32;3.5;0.0
61;2021-01-22;764;0;10475;32;3.8;0.0
61;2021-01-23;257;2;10732;34;3.9;0.0
61;2021-01-24;229;0;10961;34;4.0;0.0
61;2021-01-25;578;1;11539;35;4.2;0.0
61;2021-01-26;566;0;12105;35;4.4;0.0
61;2021-01-27;569;13;12674;48;4.6;0.0
61;2021-01-28;465;50;13139;98;4.7;0.0
61;2021-01-29;479;132;13618;230;4.9;0.1
61;2021-01-30;212;3;13830;233;5.0;0.1
61;2021-01-31;109;0;13939;233;5.0;0.1
61;2021-02-01;430;178;14369;411;5.2;0.1
61;2021-02-02;388;287;14757;698;5.3;0.3
61;2021-02-03;412;382;15169;1080;5.5;0.4
61;2021-02-04;390;261;15559;1341;5.6;0.5
61;2021-02-05;536;333;16095;1674;5.8;0.6
61;2021-02-06;204;78;16299;1752;5.9;0.6
61;2021-02-07;45;199;16344;1951;5.9;0.7
61;2021-02-08;541;1196;16885;3147;6.1;1.1
61;2021-02-09;405;739;17290;3886;6.2;1.4
61;2021-02-10;280;511;17570;4397;6.3;1.6
61;2021-02-11;432;449;18002;4846;6.5;1.8
61;2021-02-12;401;627;18403;5473;6.6;2.0
61;2021-02-13;133;331;18536;5804;6.7;2.1
61;2021-02-14;3;245;18539;6049;6.7;2.2
61;2021-02-15;169;605;18708;6654;6.8;2.4
61;2021-02-16;203;513;18911;7167;6.8;2.6
61;2021-02-17;44;458;18955;7625;6.8;2.8
61;2021-02-18;161;394;19116;8019;6.9;2.9
61;2021-02-19;101;303;19217;8322;6.9;3.0
61;2021-02-20;40;194;19257;8516;7.0;3.1
61;2021-02-21;2;119;19259;8635;7.0;3.1
61;2021-02-22;88;437;19347;9072;7.0;3.3
61;2021-02-23;104;379;19451;9451;7.0;3.4
61;2021-02-24;173;428;19624;9879;7.1;3.6
61;2021-02-25;265;323;19889;10202;7.2;3.7
61;2021-02-26;266;378;20155;10580;7.3;3.8
61;2021-02-27;110;182;20265;10762;7.3;3.9
61;2021-02-28;4;117;20269;10879;7.3;3.9
61;2021-03-01;216;521;20485;11400;7.4;4.1
61;2021-03-02;148;619;20633;12019;7.5;4.3
61;2021-03-03;143;376;20776;12395;7.5;4.5
61;2021-03-04;429;389;21205;12784;7.7;4.6
61;2021-03-05;702;265;21907;13049;7.9;4.7
61;2021-03-06;436;213;22343;13262;8.1;4.8
61;2021-03-07;155;2;22498;13264;8.1;4.8
61;2021-03-08;295;287;22793;13551;8.2;4.9
61;2021-03-09;622;159;23415;13710;8.5;5.0
61;2021-03-10;672;163;24087;13873;8.7;5.0
61;2021-03-11;1120;119;25207;13992;9.1;5.1
61;2021-03-12;1467;89;26674;14081;9.6;5.1
61;2021-03-13;775;53;27449;14134;9.9;5.1
61;2021-03-14;226;6;27675;14140;10.0;5.1
61;2021-03-15;814;35;28489;14175;10.3;5.1
61;2021-03-16;723;19;29212;14194;10.5;5.1
61;2021-03-17;761;13;29973;14207;10.8;5.1
61;2021-03-18;858;26;30831;14233;11.1;5.1
61;2021-03-19;1026;50;31857;14283;11.5;5.2
61;2021-03-20;472;15;32329;14298;11.7;5.2
61;2021-03-21;72;2;32401;14300;11.7;5.2
61;2021-03-22;797;91;33198;14391;12.0;5.2
61;2021-03-23;920;39;34118;14430;12.3;5.2
61;2021-03-24;1373;70;35491;14500;12.8;5.2
61;2021-03-25;1876;67;37367;14567;13.5;5.3
61;2021-03-26;1799;47;39166;14614;14.1;5.3
61;2021-03-27;1083;18;40249;14632;14.5;5.3
61;2021-03-28;359;9;40608;14641;14.7;5.3
61;2021-03-29;1271;182;41879;14823;15.1;5.4
61;2021-03-30;1470;98;43349;14921;15.7;5.4
61;2021-03-31;1686;51;45035;14972;16.3;5.4
61;2021-04-01;2051;231;47086;15203;17.0;5.5
61;2021-04-02;1519;433;48605;15636;17.6;5.6
61;2021-04-03;640;285;49245;15921;17.8;5.7
61;2021-04-04;193;1;49438;15922;17.9;5.8
61;2021-04-05;532;8;49970;15930;18.0;5.8
61;2021-04-06;1350;618;51320;16548;18.5;6.0
61;2021-04-07;1697;657;53017;17205;19.1;6.2
61;2021-04-08;2266;833;55283;18038;20.0;6.5
61;2021-04-09;2135;831;57418;18869;20.7;6.8
61;2021-04-10;1534;484;58952;19353;21.3;7.0
61;2021-04-11;238;199;59190;19552;21.4;7.1
61;2021-04-12;1284;734;60474;20286;21.8;7.3
61;2021-04-13;1739;704;62213;20990;22.5;7.6
61;2021-04-14;1734;784;63947;21774;23.1;7.9
61;2021-04-15;2267;782;66214;22556;23.9;8.1
61;2021-04-16;2223;688;68437;23244;24.7;8.4
61;2021-04-17;1487;324;69924;23568;25.3;8.5
61;2021-04-18;538;99;70462;23667;25.4;8.5
61;2021-04-19;936;750;71398;24417;25.8;8.8
61;2021-04-20;1523;786;72921;25203;26.3;9.1
61;2021-04-21;1351;1040;74272;26243;26.8;9.5
61;2021-04-22;1292;1217;75564;27460;27.3;9.9
61;2021-04-23;1214;1147;76778;28607;27.7;10.3
61;2021-04-24;1437;819;78215;29426;28.2;10.6
61;2021-04-25;361;331;78576;29757;28.4;10.7
61;2021-04-26;670;1143;79246;30900;28.6;11.2
61;2021-04-27;1465;1138;80711;32038;29.1;11.6
61;2021-04-28;1386;1390;82097;33428;29.6;12.1
61;2021-04-29;1246;1858;83343;35286;30.1;12.7
61;2021-04-30;1719;1173;85062;36459;30.7;13.2
61;2021-05-01;788;321;85850;36780;31.0;13.3
61;2021-05-02;439;226;86289;37006;31.2;13.4
61;2021-05-03;844;1250;87133;38256;31.5;13.8
61;2021-05-04;1323;1749;88456;40005;31.9;14.4
61;2021-05-05;1008;2027;89464;42032;32.3;15.2
61;2021-05-06;1772;2211;91236;44243;32.9;16.0
61;2021-05-07;1376;1971;92612;46214;33.4;16.7
61;2021-05-08;930;472;93542;46686;33.8;16.9
61;2021-05-09;394;293;93936;46979;33.9;17.0
61;2021-05-10;987;1746;94923;48725;34.3;17.6
61;2021-05-11;1377;1515;96300;50240;34.8;18.1
61;2021-05-12;1870;1592;98170;51832;35.5;18.7
61;2021-05-13;889;491;99059;52323;35.8;18.9
61;2021-05-14;1851;1186;100910;53509;36.4;19.3
61;2021-05-15;2107;1117;103017;54626;37.2;19.7
61;2021-05-16;984;300;104001;54926;37.6;19.8
61;2021-05-17;1312;913;105313;55839;38.0;20.2
61;2021-05-18;2423;894;107736;56733;38.9;20.5
61;2021-05-19;2400;804;110136;57537;39.8;20.8
61;2021-05-20;2212;815;112348;58352;40.6;21.1
61;2021-05-21;2150;861;114498;59213;41.3;21.4
61;2021-05-22;1780;718;116278;59931;42.0;21.6
61;2021-05-23;714;54;116992;59985;42.3;21.7
61;2021-05-24;914;111;117906;60096;42.6;21.7
61;2021-05-25;1991;920;119897;61016;43.3;22.0
61;2021-05-26;2045;931;121942;61947;44.0;22.4
61;2021-05-27;2041;1089;123983;63036;44.8;22.8
61;2021-05-28;2052;1374;126035;64410;45.5;23.3
61;2021-05-29;1466;556;127501;64966;46.0;23.5
61;2021-05-30;450;44;127951;65010;46.2;23.5
61;2021-05-31;1559;936;129510;65946;46.8;23.8
61;2021-06-01;1875;1387;131385;67333;47.4;24.3
61;2021-06-02;1676;1133;133061;68466;48.1;24.7
61;2021-06-03;2250;1110;135311;69576;48.9;25.1
61;2021-06-04;1897;1344;137208;70920;49.6;25.6
61;2021-06-05;1669;1240;138877;72160;50.2;26.1
61;2021-06-06;318;230;139195;72390;50.3;26.1
61;2021-06-07;2189;867;141384;73257;51.1;26.5
61;2021-06-08;1847;1566;143231;74823;51.7;27.0
61;2021-06-09;1975;1185;145206;76008;52.4;27.4
61;2021-06-10;1974;1192;147180;77200;53.2;27.9
61;2021-06-11;1822;1579;149002;78779;53.8;28.5
61;2021-06-12;1424;999;150426;79778;54.3;28.8
61;2021-06-13;340;377;150766;80155;54.4;28.9
61;2021-06-14;1107;1187;151873;81342;54.8;29.4
61;2021-06-15;1214;1694;153087;83036;55.3;30.0
61;2021-06-16;1114;1363;154201;84399;55.7;30.5
61;2021-06-17;1020;1730;155221;86129;56.1;31.1
61;2021-06-18;1523;1671;156744;87800;56.6;31.7
61;2021-06-19;1245;1303;157989;89103;57.1;32.2
61;2021-06-20;289;345;158278;89448;57.2;32.3
61;2021-06-21;807;1627;159085;91075;57.5;32.9
61;2021-06-22;1024;1679;160109;92754;57.8;33.5
61;2021-06-23;967;2436;161076;95190;58.2;34.4
61;2021-06-24;650;1361;161726;96551;58.4;34.9
61;2021-06-25;840;2166;162566;98717;58.7;35.7
61;2021-06-26;621;1953;163187;100670;58.9;36.4
61;2021-06-27;139;799;163326;101469;59.0;36.6
61;2021-06-28;478;2245;163804;103714;59.2;37.5
61;2021-06-29;699;2859;164503;106573;59.4;38.5
61;2021-06-30;771;2463;165274;109036;59.7;39.4
61;2021-07-01;633;1697;165907;110733;59.9;40.0
61;2021-07-02;842;2496;166749;113229;60.2;40.9
61;2021-07-03;417;1910;167166;115139;60.4;41.6
61;2021-07-04;75;638;167241;115777;60.4;41.8
61;2021-07-05;682;1774;167923;117551;60.6;42.5
61;2021-07-06;991;2792;168914;120343;61.0;43.5
61;2021-07-07;734;2360;169648;122703;61.3;44.3
61;2021-07-08;840;1944;170488;124647;61.6;45.0
61;2021-07-09;723;2375;171211;127022;61.8;45.9
61;2021-07-10;463;1767;171674;128789;62.0;46.5
61;2021-07-11;244;489;171918;129278;62.1;46.7
61;2021-07-12;438;2290;172356;131568;62.2;47.5
61;2021-07-13;643;2486;172999;134054;62.5;48.4
61;2021-07-14;150;334;173149;134388;62.5;48.5
61;2021-07-15;815;2814;173964;137202;62.8;49.5
61;2021-07-16;967;2569;174931;139771;63.2;50.5
61;2021-07-17;708;2232;175639;142003;63.4;51.3
61;2021-07-18;339;368;175978;142371;63.6;51.4
61;2021-07-19;934;2399;176912;144770;63.9;52.3
61;2021-07-20;1327;2354;178239;147124;64.4;53.1
61;2021-07-21;1503;2181;179742;149305;64.9;53.9
61;2021-07-22;1750;2188;181492;151493;65.5;54.7
61;2021-07-23;1793;2305;183285;153798;66.2;55.5
61;2021-07-24;1457;2008;184742;155806;66.7;56.3
61;2021-07-25;323;393;185065;156199;66.8;56.4
61;2021-07-26;1252;1933;186317;158132;67.3;57.1
61;2021-07-27;2419;1583;188736;159715;68.2;57.7
61;2021-07-28;2457;1355;191193;161070;69.0;58.2
61;2021-07-29;2563;1576;193756;162646;70.0;58.7
61;2021-07-30;2397;1388;196153;164034;70.8;59.2
61;2021-07-31;1282;1300;197435;165334;71.3;59.7
61;2021-08-01;504;259;197939;165593;71.5;59.8
61;2021-08-02;1913;1122;199852;166715;72.2;60.2
61;2021-08-03;2451;915;202303;167630;73.1;60.5
61;2021-08-04;2343;781;204646;168411;73.9;60.8
61;2021-08-05;1901;990;206547;169401;74.6;61.2
61;2021-08-06;2163;1163;208710;170564;75.4;61.6
61;2021-08-07;1422;799;210132;171363;75.9;61.9
61;2021-08-08;447;263;210579;171626;76.0;62.0
61;2021-08-09;1310;1112;211889;172738;76.5;62.4
61;2021-08-10;1314;1107;213203;173845;77.0;62.8
61;2021-08-11;1117;1257;214320;175102;77.4;63.2
61;2021-08-12;1038;1321;215358;176423;77.8;63.7
61;2021-08-13;879;1610;216237;178033;78.1;64.3
61;2021-08-14;717;862;216954;178895;78.4;64.6
61;2021-08-15;94;183;217048;179078;78.4;64.7
61;2021-08-16;913;1541;217961;180619;78.7;65.2
61;2021-08-17;1152;1700;219113;182319;79.1;65.8
61;2021-08-18;811;1479;219924;183798;79.4;66.4
61;2021-08-19;744;1570;220668;185368;79.7;66.9
61;2021-08-20;801;2131;221469;187499;80.0;67.7
61;2021-08-21;491;1344;221960;188843;80.2;68.2
61;2021-08-22;137;447;222097;189290;80.2;68.4
61;2021-08-23;415;1702;222512;190992;80.4;69.0
61;2021-08-24;528;1899;223040;192891;80.5;69.7
61;2021-08-25;412;1735;223452;194626;80.7;70.3
61;2021-08-26;429;1598;223881;196224;80.9;70.9
61;2021-08-27;514;1889;224395;198113;81.0;71.5
61;2021-08-28;285;1366;224680;199479;81.1;72.0
61;2021-08-29;50;417;224730;199896;81.2;72.2
61;2021-08-30;399;1624;225129;201520;81.3;72.8
61;2021-08-31;506;1713;225635;203233;81.5;73.4
61;2021-09-01;454;1499;226089;204732;81.6;73.9
61;2021-09-02;421;1341;226510;206073;81.8;74.4
61;2021-09-03;475;1580;226985;207653;82.0;75.0
61;2021-09-04;345;1337;227330;208990;82.1;75.5
61;2021-09-05;76;225;227406;209215;82.1;75.6
61;2021-09-06;284;1233;227690;210448;82.2;76.0
61;2021-09-07;362;1567;228052;212015;82.4;76.6
61;2021-09-08;273;1431;228325;213446;82.5;77.1
61;2021-09-09;285;1205;228610;214651;82.6;77.5
61;2021-09-10;364;1167;228974;215818;82.7;77.9
61;2021-09-11;270;1101;229244;216919;82.8;78.3
61;2021-09-12;37;127;229281;217046;82.8;78.4
61;2021-09-13;207;866;229488;217912;82.9;78.7
61;2021-09-14;195;693;229683;218605;82.9;78.9
61;2021-09-15;256;595;229939;219200;83.0;79.2
61;2021-09-16;220;269;230159;219469;83.1;79.3
61;2021-09-17;241;532;230400;220001;83.2;79.5
61;2021-09-18;217;611;230617;220612;83.3;79.7
61;2021-09-19;1;0;230618;220612;83.3;79.7
61;2021-09-20;177;267;230795;220879;83.3;79.8
61;2021-09-21;236;187;231031;221066;83.4;79.8
61;2021-09-22;158;692;231189;221758;83.5;80.1
61;2021-09-23;163;227;231352;221985;83.5;80.2
61;2021-09-24;135;378;231487;222363;83.6;80.3
61;2021-09-25;171;596;231658;222959;83.7;80.5
61;2021-09-26;9;15;231667;222974;83.7;80.5
61;2021-09-27;125;291;231792;223265;83.7;80.6
61;2021-09-28;96;247;231888;223512;83.7;80.7
61;2021-09-29;106;214;231994;223726;83.8;80.8
62;2020-12-27;2;0;2;0;0.0;0.0
62;2020-12-28;1;0;3;0;0.0;0.0
62;2020-12-29;0;0;3;0;0.0;0.0
62;2020-12-30;0;0;3;0;0.0;0.0
62;2020-12-31;0;0;3;0;0.0;0.0
62;2021-01-01;0;0;3;0;0.0;0.0
62;2021-01-02;2;0;5;0;0.0;0.0
62;2021-01-03;0;0;5;0;0.0;0.0
62;2021-01-04;3;0;8;0;0.0;0.0
62;2021-01-05;47;0;55;0;0.0;0.0
62;2021-01-06;123;0;178;0;0.0;0.0
62;2021-01-07;351;0;529;0;0.0;0.0
62;2021-01-08;713;7;1242;7;0.1;0.0
62;2021-01-09;164;1;1406;8;0.1;0.0
62;2021-01-10;84;0;1490;8;0.1;0.0
62;2021-01-11;557;1;2047;9;0.1;0.0
62;2021-01-12;1260;3;3307;12;0.2;0.0
62;2021-01-13;1139;6;4446;18;0.3;0.0
62;2021-01-14;1385;8;5831;26;0.4;0.0
62;2021-01-15;1300;8;7131;34;0.5;0.0
62;2021-01-16;309;2;7440;36;0.5;0.0
62;2021-01-17;107;0;7547;36;0.5;0.0
62;2021-01-18;1666;8;9213;44;0.6;0.0
62;2021-01-19;2104;4;11317;48;0.8;0.0
62;2021-01-20;2056;5;13373;53;0.9;0.0
62;2021-01-21;2244;5;15617;58;1.1;0.0
62;2021-01-22;1835;7;17452;65;1.2;0.0
62;2021-01-23;512;1;17964;66;1.2;0.0
62;2021-01-24;0;0;17964;66;1.2;0.0
62;2021-01-25;1284;6;19248;72;1.3;0.0
62;2021-01-26;1545;13;20793;85;1.4;0.0
62;2021-01-27;1518;139;22311;224;1.5;0.0
62;2021-01-28;4179;345;26490;569;1.8;0.0
62;2021-01-29;2047;304;28537;873;2.0;0.1
62;2021-01-30;159;128;28696;1001;2.0;0.1
62;2021-01-31;22;3;28718;1004;2.0;0.1
62;2021-02-01;46;317;28764;1321;2.0;0.1
62;2021-02-02;59;736;28823;2057;2.0;0.1
62;2021-02-03;44;574;28867;2631;2.0;0.2
62;2021-02-04;81;744;28948;3375;2.0;0.2
62;2021-02-05;81;636;29029;4011;2.0;0.3
62;2021-02-06;32;155;29061;4166;2.0;0.3
62;2021-02-07;236;30;29297;4196;2.0;0.3
62;2021-02-08;133;674;29430;4870;2.0;0.3
62;2021-02-09;227;912;29657;5782;2.0;0.4
62;2021-02-10;385;996;30042;6778;2.1;0.5
62;2021-02-11;726;846;30768;7624;2.1;0.5
62;2021-02-12;967;640;31735;8264;2.2;0.6
62;2021-02-13;162;209;31897;8473;2.2;0.6
62;2021-02-14;0;0;31897;8473;2.2;0.6
62;2021-02-15;665;926;32562;9399;2.2;0.6
62;2021-02-16;923;1376;33485;10775;2.3;0.7
62;2021-02-17;1082;1619;34567;12394;2.4;0.9
62;2021-02-18;2227;3405;36794;15799;2.5;1.1
62;2021-02-19;2312;2262;39106;18061;2.7;1.2
62;2021-02-20;616;372;39722;18433;2.7;1.3
62;2021-02-21;88;26;39810;18459;2.7;1.3
62;2021-02-22;848;713;40658;19172;2.8;1.3
62;2021-02-23;1418;995;42076;20167;2.9;1.4
62;2021-02-24;1547;537;43623;20704;3.0;1.4
62;2021-02-25;3169;371;46792;21075;3.2;1.5
62;2021-02-26;2912;302;49704;21377;3.4;1.5
62;2021-02-27;1829;85;51533;21462;3.5;1.5
62;2021-02-28;52;42;51585;21504;3.6;1.5
62;2021-03-01;1322;103;52907;21607;3.6;1.5
62;2021-03-02;3156;161;56063;21768;3.9;1.5
62;2021-03-03;3272;131;59335;21899;4.1;1.5
62;2021-03-04;3809;216;63144;22115;4.3;1.5
62;2021-03-05;4647;230;67791;22345;4.7;1.5
62;2021-03-06;9619;266;77410;22611;5.3;1.6
62;2021-03-07;8074;226;85484;22837;5.9;1.6
62;2021-03-08;2195;233;87679;23070;6.0;1.6
62;2021-03-09;3808;350;91487;23420;6.3;1.6
62;2021-03-10;4233;566;95720;23986;6.6;1.7
62;2021-03-11;5993;1484;101713;25470;7.0;1.8
62;2021-03-12;6639;1380;108352;26850;7.5;1.8
62;2021-03-13;14723;799;123075;27649;8.5;1.9
62;2021-03-14;9585;410;132660;28059;9.1;1.9
62;2021-03-15;3762;993;136422;29052;9.4;2.0
62;2021-03-16;2736;834;139158;29886;9.6;2.1
62;2021-03-17;2805;721;141963;30607;9.8;2.1
62;2021-03-18;2725;936;144688;31543;10.0;2.2
62;2021-03-19;4783;909;149471;32452;10.3;2.2
62;2021-03-20;11066;620;160537;33072;11.1;2.3
62;2021-03-21;9447;374;169984;33446;11.7;2.3
62;2021-03-22;2943;1089;172927;34535;11.9;2.4
62;2021-03-23;4997;1469;177924;36004;12.2;2.5
62;2021-03-24;4696;1361;182620;37365;12.6;2.6
62;2021-03-25;6553;1461;189173;38826;13.0;2.7
62;2021-03-26;7049;1489;196222;40315;13.5;2.8
62;2021-03-27;12594;754;208816;41069;14.4;2.8
62;2021-03-28;6941;289;215757;41358;14.9;2.8
62;2021-03-29;3470;1201;219227;42559;15.1;2.9
62;2021-03-30;4549;2203;223776;44762;15.4;3.1
62;2021-03-31;4225;2460;228001;47222;15.7;3.3
62;2021-04-01;4975;2762;232976;49984;16.0;3.4
62;2021-04-02;5067;3230;238043;53214;16.4;3.7
62;2021-04-03;8208;3347;246251;56561;17.0;3.9
62;2021-04-04;4582;1934;250833;58495;17.3;4.0
62;2021-04-05;944;461;251777;58956;17.3;4.1
62;2021-04-06;4122;3009;255899;61965;17.6;4.3
62;2021-04-07;5071;3517;260970;65482;18.0;4.5
62;2021-04-08;6492;3988;267462;69470;18.4;4.8
62;2021-04-09;7628;3477;275090;72947;18.9;5.0
62;2021-04-10;6635;8071;281725;81018;19.4;5.6
62;2021-04-11;2804;6881;284529;87899;19.6;6.1
62;2021-04-12;3419;2385;287948;90284;19.8;6.2
62;2021-04-13;6171;3164;294119;93448;20.2;6.4
62;2021-04-14;5307;3064;299426;96512;20.6;6.6
62;2021-04-15;5734;2986;305160;99498;21.0;6.8
62;2021-04-16;5418;3201;310578;102699;21.4;7.1
62;2021-04-17;4356;7355;314934;110054;21.7;7.6
62;2021-04-18;1956;6847;316890;116901;21.8;8.0
62;2021-04-19;2777;1934;319667;118835;22.0;8.2
62;2021-04-20;4148;3886;323815;122721;22.3;8.4
62;2021-04-21;3746;3986;327561;126707;22.5;8.7
62;2021-04-22;3948;5194;331509;131901;22.8;9.1
62;2021-04-23;4063;5320;335572;137221;23.1;9.4
62;2021-04-24;4401;6726;339973;143947;23.4;9.9
62;2021-04-25;1911;3498;341884;147445;23.5;10.1
62;2021-04-26;2224;2421;344108;149866;23.7;10.3
62;2021-04-27;4408;3749;348516;153615;24.0;10.6
62;2021-04-28;4592;4401;353108;158016;24.3;10.9
62;2021-04-29;4787;5848;357895;163864;24.6;11.3
62;2021-04-30;5215;5688;363110;169552;25.0;11.7
62;2021-05-01;5725;3472;368835;173024;25.4;11.9
62;2021-05-02;7826;3147;376661;176171;25.9;12.1
62;2021-05-03;4509;2337;381170;178508;26.2;12.3
62;2021-05-04;5396;4965;386566;183473;26.6;12.6
62;2021-05-05;4736;4824;391302;188297;26.9;13.0
62;2021-05-06;5619;4936;396921;193233;27.3;13.3
62;2021-05-07;7691;4657;404612;197890;27.9;13.6
62;2021-05-08;10658;2328;415270;200218;28.6;13.8
62;2021-05-09;8625;1642;423895;201860;29.2;13.9
62;2021-05-10;4867;4019;428762;205879;29.5;14.2
62;2021-05-11;6414;5039;435176;210918;30.0;14.5
62;2021-05-12;8623;4589;443799;215507;30.5;14.8
62;2021-05-13;9998;1491;453797;216998;31.2;14.9
62;2021-05-14;11880;3392;465677;220390;32.1;15.2
62;2021-05-15;19781;3295;485458;223685;33.4;15.4
62;2021-05-16;16397;1419;501855;225104;34.5;15.5
62;2021-05-17;8181;2659;510036;227763;35.1;15.7
62;2021-05-18;9325;3129;519361;230892;35.7;15.9
62;2021-05-19;8615;2927;527976;233819;36.3;16.1
62;2021-05-20;8341;3838;536317;237657;36.9;16.4
62;2021-05-21;9398;4215;545715;241872;37.6;16.6
62;2021-05-22;17873;3525;563588;245397;38.8;16.9
62;2021-05-23;12373;1162;575961;246559;39.6;17.0
62;2021-05-24;3911;586;579872;247145;39.9;17.0
62;2021-05-25;7221;4097;587093;251242;40.4;17.3
62;2021-05-26;6782;4912;593875;256154;40.9;17.6
62;2021-05-27;6382;5687;600257;261841;41.3;18.0
62;2021-05-28;6518;6729;606775;268570;41.8;18.5
62;2021-05-29;10850;5537;617625;274107;42.5;18.9
62;2021-05-30;4036;982;621661;275089;42.8;18.9
62;2021-05-31;4794;3947;626455;279036;43.1;19.2
62;2021-06-01;6520;6507;632975;285543;43.6;19.7
62;2021-06-02;7443;5810;640418;291353;44.1;20.1
62;2021-06-03;7854;5878;648272;297231;44.6;20.5
62;2021-06-04;7903;6238;656175;303469;45.2;20.9
62;2021-06-05;8273;6226;664448;309695;45.7;21.3
62;2021-06-06;3128;1289;667576;310984;46.0;21.4
62;2021-06-07;4625;3763;672201;314747;46.3;21.7
62;2021-06-08;6207;5902;678408;320649;46.7;22.1
62;2021-06-09;5498;4763;683906;325412;47.1;22.4
62;2021-06-10;5206;5864;689112;331276;47.4;22.8
62;2021-06-11;6208;8867;695320;340143;47.9;23.4
62;2021-06-12;5935;8643;701255;348786;48.3;24.0
62;2021-06-13;3225;3793;704480;352579;48.5;24.3
62;2021-06-14;2610;6770;707090;359349;48.7;24.7
62;2021-06-15;4675;8529;711765;367878;49.0;25.3
62;2021-06-16;5081;7429;716846;375307;49.3;25.8
62;2021-06-17;5234;8041;722080;383348;49.7;26.4
62;2021-06-18;4824;10490;726904;393838;50.0;27.1
62;2021-06-19;5794;13435;732698;407273;50.4;28.0
62;2021-06-20;2101;4369;734799;411642;50.6;28.3
62;2021-06-21;2976;8922;737775;420564;50.8;28.9
62;2021-06-22;3430;10169;741205;430733;51.0;29.6
62;2021-06-23;3387;10315;744592;441048;51.3;30.4
62;2021-06-24;3346;11784;747938;452832;51.5;31.2
62;2021-06-25;3724;15762;751662;468594;51.7;32.3
62;2021-06-26;3549;18423;755211;487017;52.0;33.5
62;2021-06-27;1121;9814;756332;496831;52.1;34.2
62;2021-06-28;1923;8865;758255;505696;52.2;34.8
62;2021-06-29;2973;11461;761228;517157;52.4;35.6
62;2021-06-30;4142;10809;765370;527966;52.7;36.3
62;2021-07-01;4483;10483;769853;538449;53.0;37.1
62;2021-07-02;4161;11977;774014;550426;53.3;37.9
62;2021-07-03;2997;18054;777011;568480;53.5;39.1
62;2021-07-04;1450;9195;778461;577675;53.6;39.8
62;2021-07-05;2415;6913;780876;584588;53.8;40.2
62;2021-07-06;3821;10013;784697;594601;54.0;40.9
62;2021-07-07;3917;8912;788614;603513;54.3;41.5
62;2021-07-08;5246;9081;793860;612594;54.6;42.2
62;2021-07-09;4471;10842;798331;623436;55.0;42.9
62;2021-07-10;4975;11890;803306;635326;55.3;43.7
62;2021-07-11;1337;2088;804643;637414;55.4;43.9
62;2021-07-12;2327;7132;806970;644546;55.5;44.4
62;2021-07-13;5176;12152;812146;656698;55.9;45.2
62;2021-07-14;3634;3165;815780;659863;56.2;45.4
62;2021-07-15;7586;11491;823366;671354;56.7;46.2
62;2021-07-16;7625;11044;830991;682398;57.2;47.0
62;2021-07-17;9719;10329;840710;692727;57.9;47.7
62;2021-07-18;2712;3457;843422;696184;58.1;47.9
62;2021-07-19;6012;7013;849434;703197;58.5;48.4
62;2021-07-20;7934;10721;857368;713918;59.0;49.1
62;2021-07-21;9776;9405;867144;723323;59.7;49.8
62;2021-07-22;9800;9012;876944;732335;60.4;50.4
62;2021-07-23;10627;8405;887571;740740;61.1;51.0
62;2021-07-24;9664;10319;897235;751059;61.8;51.7
62;2021-07-25;5549;1877;902784;752936;62.1;51.8
62;2021-07-26;6239;5384;909023;758320;62.6;52.2
62;2021-07-27;9851;8125;918874;766445;63.2;52.8
62;2021-07-28;10404;7488;929278;773933;64.0;53.3
62;2021-07-29;12006;7657;941284;781590;64.8;53.8
62;2021-07-30;9093;6290;950377;787880;65.4;54.2
62;2021-07-31;6639;4023;957016;791903;65.9;54.5
62;2021-08-01;2342;1103;959358;793006;66.0;54.6
62;2021-08-02;6866;4759;966224;797765;66.5;54.9
62;2021-08-03;8628;7472;974852;805237;67.1;55.4
62;2021-08-04;9491;5481;984343;810718;67.8;55.8
62;2021-08-05;8372;5629;992715;816347;68.3;56.2
62;2021-08-06;7320;5933;1000035;822280;68.8;56.6
62;2021-08-07;5493;4958;1005528;827238;69.2;56.9
62;2021-08-08;1875;1301;1007403;828539;69.3;57.0
62;2021-08-09;5262;5031;1012665;833570;69.7;57.4
62;2021-08-10;6221;7356;1018886;840926;70.1;57.9
62;2021-08-11;5413;7380;1024299;848306;70.5;58.4
62;2021-08-12;6007;7002;1030306;855308;70.9;58.9
62;2021-08-13;4518;6061;1034824;861369;71.2;59.3
62;2021-08-14;3837;6866;1038661;868235;71.5;59.8
62;2021-08-15;1141;1212;1039802;869447;71.6;59.8
62;2021-08-16;3188;5864;1042990;875311;71.8;60.3
62;2021-08-17;4170;7346;1047160;882657;72.1;60.8
62;2021-08-18;4357;7243;1051517;889900;72.4;61.3
62;2021-08-19;4392;8579;1055909;898479;72.7;61.8
62;2021-08-20;3444;8463;1059353;906942;72.9;62.4
62;2021-08-21;2458;9765;1061811;916707;73.1;63.1
62;2021-08-22;391;2816;1062202;919523;73.1;63.3
62;2021-08-23;2746;7829;1064948;927352;73.3;63.8
62;2021-08-24;3841;10406;1068789;937758;73.6;64.5
62;2021-08-25;3509;9198;1072298;946956;73.8;65.2
62;2021-08-26;3192;9773;1075490;956729;74.0;65.9
62;2021-08-27;2597;8825;1078087;965554;74.2;66.5
62;2021-08-28;2041;7996;1080128;973550;74.3;67.0
62;2021-08-29;865;2252;1080993;975802;74.4;67.2
62;2021-08-30;2047;7387;1083040;983189;74.5;67.7
62;2021-08-31;2141;8022;1085181;991211;74.7;68.2
62;2021-09-01;1824;6168;1087005;997379;74.8;68.7
62;2021-09-02;1848;6847;1088853;1004226;74.9;69.1
62;2021-09-03;2069;7443;1090922;1011669;75.1;69.6
62;2021-09-04;2119;6678;1093041;1018347;75.2;70.1
62;2021-09-05;317;1265;1093358;1019612;75.3;70.2
62;2021-09-06;1027;3807;1094385;1023419;75.3;70.4
62;2021-09-07;1229;4350;1095614;1027769;75.4;70.7
62;2021-09-08;1284;4557;1096898;1032326;75.5;71.1
62;2021-09-09;1265;4709;1098163;1037035;75.6;71.4
62;2021-09-10;1581;4966;1099744;1042001;75.7;71.7
62;2021-09-11;1261;4286;1101005;1046287;75.8;72.0
62;2021-09-12;201;547;1101206;1046834;75.8;72.1
62;2021-09-13;768;2754;1101974;1049588;75.9;72.2
62;2021-09-14;1254;4267;1103228;1053855;75.9;72.5
62;2021-09-15;1327;4215;1104555;1058070;76.0;72.8
62;2021-09-16;1372;2913;1105927;1060983;76.1;73.0
62;2021-09-17;1319;2413;1107246;1063396;76.2;73.2
62;2021-09-18;1077;2881;1108323;1066277;76.3;73.4
62;2021-09-19;136;448;1108459;1066725;76.3;73.4
62;2021-09-20;597;1471;1109056;1068196;76.3;73.5
62;2021-09-21;882;2421;1109938;1070617;76.4;73.7
62;2021-09-22;789;2671;1110727;1073288;76.5;73.9
62;2021-09-23;719;1837;1111446;1075125;76.5;74.0
62;2021-09-24;808;1984;1112254;1077109;76.6;74.1
62;2021-09-25;713;2666;1112967;1079775;76.6;74.3
62;2021-09-26;73;373;1113040;1080148;76.6;74.4
62;2021-09-27;310;1054;1113350;1081202;76.6;74.4
62;2021-09-28;579;1701;1113929;1082903;76.7;74.5
62;2021-09-29;752;1897;1114681;1084800;76.7;74.7
63;2020-12-27;0;0;0;0;0.0;0.0
63;2020-12-28;1;0;1;0;0.0;0.0
63;2020-12-29;0;0;1;0;0.0;0.0
63;2020-12-30;0;0;1;0;0.0;0.0
63;2020-12-31;0;0;1;0;0.0;0.0
63;2021-01-01;1;0;2;0;0.0;0.0
63;2021-01-02;0;0;2;0;0.0;0.0
63;2021-01-03;1;0;3;0;0.0;0.0
63;2021-01-04;0;0;3;0;0.0;0.0
63;2021-01-05;1;0;4;0;0.0;0.0
63;2021-01-06;4;1;8;1;0.0;0.0
63;2021-01-07;310;0;318;1;0.0;0.0
63;2021-01-08;217;0;535;1;0.1;0.0
63;2021-01-09;91;0;626;1;0.1;0.0
63;2021-01-10;82;0;708;1;0.1;0.0
63;2021-01-11;431;2;1139;3;0.2;0.0
63;2021-01-12;661;1;1800;4;0.3;0.0
63;2021-01-13;873;2;2673;6;0.4;0.0
63;2021-01-14;547;8;3220;14;0.5;0.0
63;2021-01-15;431;3;3651;17;0.6;0.0
63;2021-01-16;157;0;3808;17;0.6;0.0
63;2021-01-17;133;0;3941;17;0.6;0.0
63;2021-01-18;634;2;4575;19;0.7;0.0
63;2021-01-19;868;2;5443;21;0.8;0.0
63;2021-01-20;1069;1;6512;22;1.0;0.0
63;2021-01-21;1018;3;7530;25;1.1;0.0
63;2021-01-22;970;3;8500;28;1.3;0.0
63;2021-01-23;192;0;8692;28;1.3;0.0
63;2021-01-24;164;1;8856;29;1.3;0.0
63;2021-01-25;829;0;9685;29;1.5;0.0
63;2021-01-26;974;2;10659;31;1.6;0.0
63;2021-01-27;1003;4;11662;35;1.8;0.0
63;2021-01-28;1321;67;12983;102;2.0;0.0
63;2021-01-29;1066;62;14049;164;2.1;0.0
63;2021-01-30;68;0;14117;164;2.1;0.0
63;2021-01-31;6;0;14123;164;2.1;0.0
63;2021-02-01;575;162;14698;326;2.2;0.0
63;2021-02-02;886;219;15584;545;2.4;0.1
63;2021-02-03;1475;269;17059;814;2.6;0.1
63;2021-02-04;2120;489;19179;1303;2.9;0.2
63;2021-02-05;1144;253;20323;1556;3.1;0.2
63;2021-02-06;116;0;20439;1556;3.1;0.2
63;2021-02-07;9;1;20448;1557;3.1;0.2
63;2021-02-08;538;345;20986;1902;3.2;0.3
63;2021-02-09;671;359;21657;2261;3.3;0.3
63;2021-02-10;609;508;22266;2769;3.4;0.4
63;2021-02-11;751;404;23017;3173;3.5;0.5
63;2021-02-12;820;732;23837;3905;3.6;0.6
63;2021-02-13;82;1;23919;3906;3.6;0.6
63;2021-02-14;0;57;23919;3963;3.6;0.6
63;2021-02-15;202;620;24121;4583;3.7;0.7
63;2021-02-16;409;951;24530;5534;3.7;0.8
63;2021-02-17;359;666;24889;6200;3.8;0.9
63;2021-02-18;607;659;25496;6859;3.9;1.0
63;2021-02-19;449;764;25945;7623;3.9;1.2
63;2021-02-20;35;17;25980;7640;3.9;1.2
63;2021-02-21;2;9;25982;7649;3.9;1.2
63;2021-02-22;291;690;26273;8339;4.0;1.3
63;2021-02-23;580;881;26853;9220;4.1;1.4
63;2021-02-24;696;1202;27549;10422;4.2;1.6
63;2021-02-25;1604;1438;29153;11860;4.4;1.8
63;2021-02-26;1624;1195;30777;13055;4.7;2.0
63;2021-02-27;641;65;31418;13120;4.8;2.0
63;2021-02-28;4;177;31422;13297;4.8;2.0
63;2021-03-01;586;403;32008;13700;4.8;2.1
63;2021-03-02;907;652;32915;14352;5.0;2.2
63;2021-03-03;1036;591;33951;14943;5.1;2.3
63;2021-03-04;1754;424;35705;15367;5.4;2.3
63;2021-03-05;2612;620;38317;15987;5.8;2.4
63;2021-03-06;1551;53;39868;16040;6.0;2.4
63;2021-03-07;514;19;40382;16059;6.1;2.4
63;2021-03-08;966;565;41348;16624;6.3;2.5
63;2021-03-09;1539;904;42887;17528;6.5;2.7
63;2021-03-10;1654;544;44541;18072;6.7;2.7
63;2021-03-11;3055;853;47596;18925;7.2;2.9
63;2021-03-12;3513;380;51109;19305;7.7;2.9
63;2021-03-13;2048;81;53157;19386;8.1;2.9
63;2021-03-14;61;21;53218;19407;8.1;2.9
63;2021-03-15;1769;359;54987;19766;8.3;3.0
63;2021-03-16;1746;390;56733;20156;8.6;3.1
63;2021-03-17;1642;652;58375;20808;8.8;3.2
63;2021-03-18;1945;730;60320;21538;9.1;3.3
63;2021-03-19;2742;483;63062;22021;9.6;3.3
63;2021-03-20;1121;67;64183;22088;9.7;3.3
63;2021-03-21;50;45;64233;22133;9.7;3.4
63;2021-03-22;1984;253;66217;22386;10.0;3.4
63;2021-03-23;2885;343;69102;22729;10.5;3.4
63;2021-03-24;3224;346;72326;23075;11.0;3.5
63;2021-03-25;4597;389;76923;23464;11.7;3.6
63;2021-03-26;4692;545;81615;24009;12.4;3.6
63;2021-03-27;2457;232;84072;24241;12.7;3.7
63;2021-03-28;1047;83;85119;24324;12.9;3.7
63;2021-03-29;2480;514;87599;24838;13.3;3.8
63;2021-03-30;3283;627;90882;25465;13.8;3.9
63;2021-03-31;2968;745;93850;26210;14.2;4.0
63;2021-04-01;3843;521;97693;26731;14.8;4.0
63;2021-04-02;3484;711;101177;27442;15.3;4.2
63;2021-04-03;1174;181;102351;27623;15.5;4.2
63;2021-04-04;877;28;103228;27651;15.6;4.2
63;2021-04-05;801;85;104029;27736;15.8;4.2
63;2021-04-06;2479;940;106508;28676;16.1;4.3
63;2021-04-07;3208;873;109716;29549;16.6;4.5
63;2021-04-08;4721;1221;114437;30770;17.3;4.7
63;2021-04-09;5314;999;119751;31769;18.1;4.8
63;2021-04-10;2221;481;121972;32250;18.5;4.9
63;2021-04-11;835;40;122807;32290;18.6;4.9
63;2021-04-12;1595;1309;124402;33599;18.8;5.1
63;2021-04-13;1986;1962;126388;35561;19.1;5.4
63;2021-04-14;2631;1438;129019;36999;19.5;5.6
63;2021-04-15;3809;1541;132828;38540;20.1;5.8
63;2021-04-16;2840;2157;135668;40697;20.5;6.2
63;2021-04-17;1233;672;136901;41369;20.7;6.3
63;2021-04-18;803;61;137704;41430;20.9;6.3
63;2021-04-19;1657;2099;139361;43529;21.1;6.6
63;2021-04-20;1702;2298;141063;45827;21.4;6.9
63;2021-04-21;1514;2407;142577;48234;21.6;7.3
63;2021-04-22;1916;2259;144493;50493;21.9;7.6
63;2021-04-23;2019;3109;146512;53602;22.2;8.1
63;2021-04-24;1192;1127;147704;54729;22.4;8.3
63;2021-04-25;554;412;148258;55141;22.5;8.4
63;2021-04-26;1438;2240;149696;57381;22.7;8.7
63;2021-04-27;2326;2607;152022;59988;23.0;9.1
63;2021-04-28;2346;3157;154368;63145;23.4;9.6
63;2021-04-29;2882;2805;157250;65950;23.8;10.0
63;2021-04-30;2862;2802;160112;68752;24.3;10.4
63;2021-05-01;1127;1051;161239;69803;24.4;10.6
63;2021-05-02;897;639;162136;70442;24.6;10.7
63;2021-05-03;2686;2233;164822;72675;25.0;11.0
63;2021-05-04;2879;2689;167701;75364;25.4;11.4
63;2021-05-05;2936;3117;170637;78481;25.8;11.9
63;2021-05-06;3673;3051;174310;81532;26.4;12.3
63;2021-05-07;4033;3525;178343;85057;27.0;12.9
63;2021-05-08;2002;654;180345;85711;27.3;13.0
63;2021-05-09;1802;606;182147;86317;27.6;13.1
63;2021-05-10;4194;2760;186341;89077;28.2;13.5
63;2021-05-11;5338;2758;191679;91835;29.0;13.9
63;2021-05-12;5274;2905;196953;94740;29.8;14.3
63;2021-05-13;4136;699;201089;95439;30.5;14.5
63;2021-05-14;4772;1509;205861;96948;31.2;14.7
63;2021-05-15;3727;986;209588;97934;31.7;14.8
63;2021-05-16;3521;447;213109;98381;32.3;14.9
63;2021-05-17;3902;1993;217011;100374;32.9;15.2
63;2021-05-18;5124;1610;222135;101984;33.6;15.4
63;2021-05-19;5228;1627;227363;103611;34.4;15.7
63;2021-05-20;6806;2088;234169;105699;35.5;16.0
63;2021-05-21;6256;2328;240425;108027;36.4;16.4
63;2021-05-22;3352;848;243777;108875;36.9;16.5
63;2021-05-23;2388;245;246165;109120;37.3;16.5
63;2021-05-24;2643;581;248808;109701;37.7;16.6
63;2021-05-25;4270;2642;253078;112343;38.3;17.0
63;2021-05-26;5452;2420;258530;114763;39.2;17.4
63;2021-05-27;6502;2799;265032;117562;40.1;17.8
63;2021-05-28;5422;3877;270454;121439;41.0;18.4
63;2021-05-29;3361;1500;273815;122939;41.5;18.6
63;2021-05-30;1579;217;275394;123156;41.7;18.7
63;2021-05-31;4157;2284;279551;125440;42.3;19.0
63;2021-06-01;3805;2946;283356;128386;42.9;19.4
63;2021-06-02;3886;2524;287242;130910;43.5;19.8
63;2021-06-03;4902;3134;292144;134044;44.2;20.3
63;2021-06-04;5100;3618;297244;137662;45.0;20.9
63;2021-06-05;2816;1742;300060;139404;45.4;21.1
63;2021-06-06;1309;698;301369;140102;45.6;21.2
63;2021-06-07;3163;2514;304532;142616;46.1;21.6
63;2021-06-08;2882;2746;307414;145362;46.6;22.0
63;2021-06-09;3025;2266;310439;147628;47.0;22.4
63;2021-06-10;3226;2688;313665;150316;47.5;22.8
63;2021-06-11;3098;4043;316763;154359;48.0;23.4
63;2021-06-12;1640;1969;318403;156328;48.2;23.7
63;2021-06-13;482;1098;318885;157426;48.3;23.8
63;2021-06-14;1824;3472;320709;160898;48.6;24.4
63;2021-06-15;2211;3478;322920;164376;48.9;24.9
63;2021-06-16;2576;3313;325496;167689;49.3;25.4
63;2021-06-17;2398;4314;327894;172003;49.7;26.1
63;2021-06-18;2480;5824;330374;177827;50.0;26.9
63;2021-06-19;1643;2835;332017;180662;50.3;27.4
63;2021-06-20;677;2441;332694;183103;50.4;27.7
63;2021-06-21;1272;5386;333966;188489;50.6;28.5
63;2021-06-22;1233;5537;335199;194026;50.8;29.4
63;2021-06-23;1531;4766;336730;198792;51.0;30.1
63;2021-06-24;1925;5383;338655;204175;51.3;30.9
63;2021-06-25;1751;5894;340406;210069;51.6;31.8
63;2021-06-26;1073;3352;341479;213421;51.7;32.3
63;2021-06-27;712;3487;342191;216908;51.8;32.9
63;2021-06-28;1136;5663;343327;222571;52.0;33.7
63;2021-06-29;1225;5159;344552;227730;52.2;34.5
63;2021-06-30;1606;5292;346158;233022;52.4;35.3
63;2021-07-01;1930;8064;348088;241086;52.7;36.5
63;2021-07-02;2061;6540;350149;247626;53.0;37.5
63;2021-07-03;965;2926;351114;250552;53.2;37.9
63;2021-07-04;1066;1885;352180;252437;53.3;38.2
63;2021-07-05;1539;6279;353719;258716;53.6;39.2
63;2021-07-06;1607;4807;355326;263523;53.8;39.9
63;2021-07-07;1974;4086;357300;267609;54.1;40.5
63;2021-07-08;2205;4579;359505;272188;54.5;41.2
63;2021-07-09;1924;5718;361429;277906;54.7;42.1
63;2021-07-10;1535;3415;362964;281321;55.0;42.6
63;2021-07-11;910;1537;363874;282858;55.1;42.8
63;2021-07-12;1597;8701;365471;291559;55.4;44.2
63;2021-07-13;3598;6131;369069;297690;55.9;45.1
63;2021-07-14;3618;1790;372687;299480;56.4;45.4
63;2021-07-15;4415;5027;377102;304507;57.1;46.1
63;2021-07-16;4694;5782;381796;310289;57.8;47.0
63;2021-07-17;3012;2473;384808;312762;58.3;47.4
63;2021-07-18;2825;1090;387633;313852;58.7;47.5
63;2021-07-19;4002;4844;391635;318696;59.3;48.3
63;2021-07-20;4737;5456;396372;324152;60.0;49.1
63;2021-07-21;4790;3975;401162;328127;60.8;49.7
63;2021-07-22;5509;4397;406671;332524;61.6;50.4
63;2021-07-23;5162;4651;411833;337175;62.4;51.1
63;2021-07-24;3677;1951;415510;339126;62.9;51.4
63;2021-07-25;3065;1438;418575;340564;63.4;51.6
63;2021-07-26;4042;3228;422617;343792;64.0;52.1
63;2021-07-27;3934;3162;426551;346954;64.6;52.5
63;2021-07-28;3855;2718;430406;349672;65.2;53.0
63;2021-07-29;4454;3157;434860;352829;65.9;53.4
63;2021-07-30;3816;3574;438676;356403;66.4;54.0
63;2021-07-31;2162;1718;440838;358121;66.8;54.2
63;2021-08-01;1197;836;442035;358957;67.0;54.4
63;2021-08-02;2238;3067;444273;362024;67.3;54.8
63;2021-08-03;2740;3252;447013;365276;67.7;55.3
63;2021-08-04;2818;3247;449831;368523;68.1;55.8
63;2021-08-05;2449;3477;452280;372000;68.5;56.3
63;2021-08-06;2360;4150;454640;376150;68.9;57.0
63;2021-08-07;1308;2807;455948;378957;69.1;57.4
63;2021-08-08;324;1205;456272;380162;69.1;57.6
63;2021-08-09;1905;4222;458177;384384;69.4;58.2
63;2021-08-10;2307;3993;460484;388377;69.7;58.8
63;2021-08-11;2142;3628;462626;392005;70.1;59.4
63;2021-08-12;1955;4621;464581;396626;70.4;60.1
63;2021-08-13;1688;4009;466269;400635;70.6;60.7
63;2021-08-14;841;3237;467110;403872;70.7;61.2
63;2021-08-15;184;1451;467294;405323;70.8;61.4
63;2021-08-16;1272;4399;468566;409722;71.0;62.1
63;2021-08-17;1650;4051;470216;413773;71.2;62.7
63;2021-08-18;1490;3305;471706;417078;71.4;63.2
63;2021-08-19;1366;3444;473072;420522;71.7;63.7
63;2021-08-20;1451;3712;474523;424234;71.9;64.3
63;2021-08-21;676;2165;475199;426399;72.0;64.6
63;2021-08-22;212;1092;475411;427491;72.0;64.7
63;2021-08-23;1137;3591;476548;431082;72.2;65.3
63;2021-08-24;1092;2990;477640;434072;72.3;65.7
63;2021-08-25;1011;2787;478651;436859;72.5;66.2
63;2021-08-26;1191;2707;479842;439566;72.7;66.6
63;2021-08-27;1280;3163;481122;442729;72.9;67.1
63;2021-08-28;713;1709;481835;444438;73.0;67.3
63;2021-08-29;107;577;481942;445015;73.0;67.4
63;2021-08-30;801;2446;482743;447461;73.1;67.8
63;2021-08-31;999;2568;483742;450029;73.3;68.2
63;2021-09-01;972;2138;484714;452167;73.4;68.5
63;2021-09-02;850;2199;485564;454366;73.5;68.8
63;2021-09-03;921;2663;486485;457029;73.7;69.2
63;2021-09-04;710;1536;487195;458565;73.8;69.5
63;2021-09-05;80;273;487275;458838;73.8;69.5
63;2021-09-06;565;1609;487840;460447;73.9;69.7
63;2021-09-07;678;1736;488518;462183;74.0;70.0
63;2021-09-08;715;1788;489233;463971;74.1;70.3
63;2021-09-09;597;1652;489830;465623;74.2;70.5
63;2021-09-10;730;2126;490560;467749;74.3;70.8
63;2021-09-11;457;1121;491017;468870;74.4;71.0
63;2021-09-12;49;159;491066;469029;74.4;71.0
63;2021-09-13;466;1476;491532;470505;74.4;71.3
63;2021-09-14;531;1417;492063;471922;74.5;71.5
63;2021-09-15;584;1294;492647;473216;74.6;71.7
63;2021-09-16;477;918;493124;474134;74.7;71.8
63;2021-09-17;477;1318;493601;475452;74.8;72.0
63;2021-09-18;321;1030;493922;476482;74.8;72.2
63;2021-09-19;41;97;493963;476579;74.8;72.2
63;2021-09-20;366;720;494329;477299;74.9;72.3
63;2021-09-21;411;756;494740;478055;74.9;72.4
63;2021-09-22;400;1113;495140;479168;75.0;72.6
63;2021-09-23;300;764;495440;479932;75.0;72.7
63;2021-09-24;486;1269;495926;481201;75.1;72.9
63;2021-09-25;253;828;496179;482029;75.2;73.0
63;2021-09-26;26;100;496205;482129;75.2;73.0
63;2021-09-27;315;647;496520;482776;75.2;73.1
63;2021-09-28;293;688;496813;483464;75.2;73.2
63;2021-09-29;302;806;497115;484270;75.3;73.3
64;2020-12-27;1;0;1;0;0.0;0.0
64;2020-12-28;2;0;3;0;0.0;0.0
64;2020-12-29;0;0;3;0;0.0;0.0
64;2020-12-30;1;0;4;0;0.0;0.0
64;2020-12-31;0;0;4;0;0.0;0.0
64;2021-01-01;0;0;4;0;0.0;0.0
64;2021-01-02;0;0;4;0;0.0;0.0
64;2021-01-03;0;0;4;0;0.0;0.0
64;2021-01-04;29;0;33;0;0.0;0.0
64;2021-01-05;25;0;58;0;0.0;0.0
64;2021-01-06;189;0;247;0;0.0;0.0
64;2021-01-07;842;1;1089;1;0.2;0.0
64;2021-01-08;880;2;1969;3;0.3;0.0
64;2021-01-09;54;0;2023;3;0.3;0.0
64;2021-01-10;2;0;2025;3;0.3;0.0
64;2021-01-11;543;0;2568;3;0.4;0.0
64;2021-01-12;760;3;3328;6;0.5;0.0
64;2021-01-13;867;2;4195;8;0.6;0.0
64;2021-01-14;1046;3;5241;11;0.8;0.0
64;2021-01-15;929;3;6170;14;0.9;0.0
64;2021-01-16;70;0;6240;14;0.9;0.0
64;2021-01-17;5;0;6245;14;0.9;0.0
64;2021-01-18;942;5;7187;19;1.1;0.0
64;2021-01-19;1449;2;8636;21;1.3;0.0
64;2021-01-20;1616;3;10252;24;1.5;0.0
64;2021-01-21;2602;1;12854;25;1.9;0.0
64;2021-01-22;1652;3;14506;28;2.1;0.0
64;2021-01-23;525;1;15031;29;2.2;0.0
64;2021-01-24;89;0;15120;29;2.2;0.0
64;2021-01-25;974;7;16094;36;2.4;0.0
64;2021-01-26;1358;21;17452;57;2.6;0.0
64;2021-01-27;1243;115;18695;172;2.7;0.0
64;2021-01-28;1651;603;20346;775;3.0;0.1
64;2021-01-29;973;604;21319;1379;3.1;0.2
64;2021-01-30;469;54;21788;1433;3.2;0.2
64;2021-01-31;93;0;21881;1433;3.2;0.2
64;2021-02-01;675;287;22556;1720;3.3;0.3
64;2021-02-02;1134;523;23690;2243;3.5;0.3
64;2021-02-03;1043;603;24733;2846;3.6;0.4
64;2021-02-04;1027;510;25760;3356;3.8;0.5
64;2021-02-05;868;445;26628;3801;3.9;0.6
64;2021-02-06;501;31;27129;3832;4.0;0.6
64;2021-02-07;131;3;27260;3835;4.0;0.6
64;2021-02-08;769;276;28029;4111;4.1;0.6
64;2021-02-09;949;658;28978;4769;4.2;0.7
64;2021-02-10;916;709;29894;5478;4.4;0.8
64;2021-02-11;1199;1239;31093;6717;4.6;1.0
64;2021-02-12;1076;963;32169;7680;4.7;1.1
64;2021-02-13;225;213;32394;7893;4.7;1.2
64;2021-02-14;38;26;32432;7919;4.7;1.2
64;2021-02-15;223;856;32655;8775;4.8;1.3
64;2021-02-16;261;1137;32916;9912;4.8;1.5
64;2021-02-17;291;992;33207;10904;4.9;1.6
64;2021-02-18;508;1461;33715;12365;4.9;1.8
64;2021-02-19;413;1037;34128;13402;5.0;2.0
64;2021-02-20;119;317;34247;13719;5.0;2.0
64;2021-02-21;20;66;34267;13785;5.0;2.0
64;2021-02-22;479;773;34746;14558;5.1;2.1
64;2021-02-23;722;906;35468;15464;5.2;2.3
64;2021-02-24;732;821;36200;16285;5.3;2.4
64;2021-02-25;1094;772;37294;17057;5.5;2.5
64;2021-02-26;1217;742;38511;17799;5.6;2.6
64;2021-02-27;864;303;39375;18102;5.8;2.6
64;2021-02-28;42;58;39417;18160;5.8;2.7
64;2021-03-01;767;631;40184;18791;5.9;2.8
64;2021-03-02;1078;755;41262;19546;6.0;2.9
64;2021-03-03;1251;861;42513;20407;6.2;3.0
64;2021-03-04;1882;1065;44395;21472;6.5;3.1
64;2021-03-05;2199;923;46594;22395;6.8;3.3
64;2021-03-06;1543;457;48137;22852;7.0;3.3
64;2021-03-07;595;86;48732;22938;7.1;3.4
64;2021-03-08;1534;678;50266;23616;7.4;3.5
64;2021-03-09;2069;760;52335;24376;7.7;3.6
64;2021-03-10;2082;690;54417;25066;8.0;3.7
64;2021-03-11;2976;994;57393;26060;8.4;3.8
64;2021-03-12;3487;565;60880;26625;8.9;3.9
64;2021-03-13;2258;159;63138;26784;9.2;3.9
64;2021-03-14;233;15;63371;26799;9.3;3.9
64;2021-03-15;2337;226;65708;27025;9.6;4.0
64;2021-03-16;2001;259;67709;27284;9.9;4.0
64;2021-03-17;2072;236;69781;27520;10.2;4.0
64;2021-03-18;2463;203;72244;27723;10.6;4.1
64;2021-03-19;3014;277;75258;28000;11.0;4.1
64;2021-03-20;2469;93;77727;28093;11.4;4.1
64;2021-03-21;1282;27;79009;28120;11.6;4.1
64;2021-03-22;2588;540;81597;28660;11.9;4.2
64;2021-03-23;3197;644;84794;29304;12.4;4.3
64;2021-03-24;3564;695;88358;29999;12.9;4.4
64;2021-03-25;4351;792;92709;30791;13.6;4.5
64;2021-03-26;4429;696;97138;31487;14.2;4.6
64;2021-03-27;2974;429;100112;31916;14.7;4.7
64;2021-03-28;521;55;100633;31971;14.7;4.7
64;2021-03-29;3028;873;103661;32844;15.2;4.8
64;2021-03-30;4135;862;107796;33706;15.8;4.9
64;2021-03-31;3594;786;111390;34492;16.3;5.0
64;2021-04-01;4786;935;116176;35427;17.0;5.2
64;2021-04-02;4444;743;120620;36170;17.7;5.3
64;2021-04-03;2061;583;122681;36753;18.0;5.4
64;2021-04-04;309;48;122990;36801;18.0;5.4
64;2021-04-05;1689;144;124679;36945;18.3;5.4
64;2021-04-06;3647;1387;128326;38332;18.8;5.6
64;2021-04-07;3947;1508;132273;39840;19.4;5.8
64;2021-04-08;5192;1592;137465;41432;20.1;6.1
64;2021-04-09;5898;1636;143363;43068;21.0;6.3
64;2021-04-10;3222;1048;146585;44116;21.5;6.5
64;2021-04-11;448;250;147033;44366;21.5;6.5
64;2021-04-12;4047;1864;151080;46230;22.1;6.8
64;2021-04-13;4466;2158;155546;48388;22.8;7.1
64;2021-04-14;4088;2134;159634;50522;23.4;7.4
64;2021-04-15;4394;2292;164028;52814;24.0;7.7
64;2021-04-16;4300;2253;168328;55067;24.6;8.1
64;2021-04-17;2479;1498;170807;56565;25.0;8.3
64;2021-04-18;1096;1181;171903;57746;25.2;8.5
64;2021-04-19;2736;2440;174639;60186;25.6;8.8
64;2021-04-20;3208;2425;177847;62611;26.0;9.2
64;2021-04-21;3224;2559;181071;65170;26.5;9.5
64;2021-04-22;3389;2775;184460;67945;27.0;9.9
64;2021-04-23;3433;2612;187893;70557;27.5;10.3
64;2021-04-24;2068;1586;189961;72143;27.8;10.6
64;2021-04-25;290;235;190251;72378;27.8;10.6
64;2021-04-26;2661;2645;192912;75023;28.2;11.0
64;2021-04-27;3060;3127;195972;78150;28.7;11.4
64;2021-04-28;3604;3053;199576;81203;29.2;11.9
64;2021-04-29;4650;3454;204226;84657;29.9;12.4
64;2021-04-30;4085;3599;208311;88256;30.5;12.9
64;2021-05-01;1485;1030;209796;89286;30.7;13.1
64;2021-05-02;446;325;210242;89611;30.8;13.1
64;2021-05-03;2910;3520;213152;93131;31.2;13.6
64;2021-05-04;3646;3982;216798;97113;31.7;14.2
64;2021-05-05;3358;4007;220156;101120;32.2;14.8
64;2021-05-06;4110;3988;224266;105108;32.8;15.4
64;2021-05-07;3922;4185;228188;109293;33.4;16.0
64;2021-05-08;2623;1235;230811;110528;33.8;16.2
64;2021-05-09;722;305;231533;110833;33.9;16.2
64;2021-05-10;2862;4232;234395;115065;34.3;16.8
64;2021-05-11;4183;4140;238578;119205;34.9;17.4
64;2021-05-12;4489;3941;243067;123146;35.6;18.0
64;2021-05-13;3198;885;246265;124031;36.0;18.2
64;2021-05-14;5153;3150;251418;127181;36.8;18.6
64;2021-05-15;3525;1865;254943;129046;37.3;18.9
64;2021-05-16;498;225;255441;129271;37.4;18.9
64;2021-05-17;4190;2389;259631;131660;38.0;19.3
64;2021-05-18;5163;2298;264794;133958;38.8;19.6
64;2021-05-19;4979;2166;269773;136124;39.5;19.9
64;2021-05-20;5567;2158;275340;138282;40.3;20.2
64;2021-05-21;5268;2246;280608;140528;41.1;20.6
64;2021-05-22;3581;1508;284189;142036;41.6;20.8
64;2021-05-23;431;206;284620;142242;41.7;20.8
64;2021-05-24;2996;1232;287616;143474;42.1;21.0
64;2021-05-25;4332;2851;291948;146325;42.7;21.4
64;2021-05-26;4357;2713;296305;149038;43.4;21.8
64;2021-05-27;5283;3156;301588;152194;44.1;22.3
64;2021-05-28;4619;3432;306207;155626;44.8;22.8
64;2021-05-29;2810;2112;309017;157738;45.2;23.1
64;2021-05-30;439;203;309456;157941;45.3;23.1
64;2021-05-31;3889;3659;313345;161600;45.9;23.7
64;2021-06-01;5333;3565;318678;165165;46.6;24.2
64;2021-06-02;4931;3174;323609;168339;47.4;24.6
64;2021-06-03;6365;3254;329974;171593;48.3;25.1
64;2021-06-04;5149;4551;335123;176144;49.1;25.8
64;2021-06-05;3482;2520;338605;178664;49.6;26.2
64;2021-06-06;2014;328;340619;178992;49.9;26.2
64;2021-06-07;4128;4332;344747;183324;50.5;26.8
64;2021-06-08;5151;4118;349898;187442;51.2;27.4
64;2021-06-09;5150;3656;355048;191098;52.0;28.0
64;2021-06-10;6180;3144;361228;194242;52.9;28.4
64;2021-06-11;5584;4874;366812;199116;53.7;29.1
64;2021-06-12;3949;2331;370761;201447;54.3;29.5
64;2021-06-13;1555;392;372316;201839;54.5;29.5
64;2021-06-14;3669;4792;375985;206631;55.0;30.2
64;2021-06-15;4570;4708;380555;211339;55.7;30.9
64;2021-06-16;4470;4664;385025;216003;56.4;31.6
64;2021-06-17;3641;4306;388666;220309;56.9;32.2
64;2021-06-18;4421;5167;393087;225476;57.5;33.0
64;2021-06-19;2984;3279;396071;228755;58.0;33.5
64;2021-06-20;881;539;396952;229294;58.1;33.6
64;2021-06-21;2314;5125;399266;234419;58.4;34.3
64;2021-06-22;2555;5726;401821;240145;58.8;35.2
64;2021-06-23;3104;5480;404925;245625;59.3;36.0
64;2021-06-24;2719;3809;407644;249434;59.7;36.5
64;2021-06-25;2900;6436;410544;255870;60.1;37.5
64;2021-06-26;1798;3835;412342;259705;60.4;38.0
64;2021-06-27;493;713;412835;260418;60.4;38.1
64;2021-06-28;1935;6069;414770;266487;60.7;39.0
64;2021-06-29;1967;6265;416737;272752;61.0;39.9
64;2021-06-30;2255;6000;418992;278752;61.3;40.8
64;2021-07-01;2407;5341;421399;284093;61.7;41.6
64;2021-07-02;2306;6403;423705;290496;62.0;42.5
64;2021-07-03;1263;3782;424968;294278;62.2;43.1
64;2021-07-04;411;847;425379;295125;62.3;43.2
64;2021-07-05;1376;5403;426755;300528;62.5;44.0
64;2021-07-06;1994;6151;428749;306679;62.8;44.9
64;2021-07-07;2063;5751;430812;312430;63.1;45.7
64;2021-07-08;1803;4397;432615;316827;63.3;46.4
64;2021-07-09;1825;6536;434440;323363;63.6;47.3
64;2021-07-10;1171;3879;435611;327242;63.8;47.9
64;2021-07-11;253;860;435864;328102;63.8;48.0
64;2021-07-12;1500;6086;437364;334188;64.0;48.9
64;2021-07-13;2366;7247;439730;341435;64.4;50.0
64;2021-07-14;2368;3405;442098;344840;64.7;50.5
64;2021-07-15;2104;5480;444202;350320;65.0;51.3
64;2021-07-16;2848;6770;447050;357090;65.4;52.3
64;2021-07-17;2338;4585;449388;361675;65.8;52.9
64;2021-07-18;716;2051;450104;363726;65.9;53.2
64;2021-07-19;2348;6121;452452;369847;66.2;54.1
64;2021-07-20;3128;6560;455580;376407;66.7;55.1
64;2021-07-21;3345;6046;458925;382453;67.2;56.0
64;2021-07-22;3809;5716;462734;388169;67.7;56.8
64;2021-07-23;3725;5618;466459;393787;68.3;57.6
64;2021-07-24;2553;4428;469012;398215;68.7;58.3
64;2021-07-25;753;1062;469765;399277;68.8;58.4
64;2021-07-26;3086;5131;472851;404408;69.2;59.2
64;2021-07-27;4261;5144;477112;409552;69.8;59.9
64;2021-07-28;4315;4597;481427;414149;70.5;60.6
64;2021-07-29;5518;3904;486945;418053;71.3;61.2
64;2021-07-30;5146;4227;492091;422280;72.0;61.8
64;2021-07-31;3171;3346;495262;425626;72.5;62.3
64;2021-08-01;1145;589;496407;426215;72.7;62.4
64;2021-08-02;4368;2630;500775;428845;73.3;62.8
64;2021-08-03;4556;3176;505331;432021;74.0;63.2
64;2021-08-04;4132;2999;509463;435020;74.6;63.7
64;2021-08-05;4036;2612;513499;437632;75.2;64.1
64;2021-08-06;3843;3334;517342;440966;75.7;64.5
64;2021-08-07;2481;2701;519823;443667;76.1;64.9
64;2021-08-08;492;609;520315;444276;76.2;65.0
64;2021-08-09;2739;3201;523054;447477;76.6;65.5
64;2021-08-10;3352;3436;526406;450913;77.1;66.0
64;2021-08-11;3067;3264;529473;454177;77.5;66.5
64;2021-08-12;3189;3307;532662;457484;78.0;67.0
64;2021-08-13;2575;3660;535237;461144;78.3;67.5
64;2021-08-14;1632;2683;536869;463827;78.6;67.9
64;2021-08-15;207;691;537076;464518;78.6;68.0
64;2021-08-16;2102;3236;539178;467754;78.9;68.5
64;2021-08-17;2300;3709;541478;471463;79.3;69.0
64;2021-08-18;2044;3520;543522;474983;79.6;69.5
64;2021-08-19;1938;3525;545460;478508;79.8;70.0
64;2021-08-20;1578;3975;547038;482483;80.1;70.6
64;2021-08-21;975;2882;548013;485365;80.2;71.0
64;2021-08-22;160;895;548173;486260;80.2;71.2
64;2021-08-23;1267;3238;549440;489498;80.4;71.7
64;2021-08-24;1376;4596;550816;494094;80.6;72.3
64;2021-08-25;1260;3747;552076;497841;80.8;72.9
64;2021-08-26;1111;3532;553187;501373;81.0;73.4
64;2021-08-27;1188;4229;554375;505602;81.1;74.0
64;2021-08-28;733;2496;555108;508098;81.3;74.4
64;2021-08-29;90;533;555198;508631;81.3;74.5
64;2021-08-30;989;3614;556187;512245;81.4;75.0
64;2021-08-31;990;3973;557177;516218;81.6;75.6
64;2021-09-01;924;3195;558101;519413;81.7;76.0
64;2021-09-02;896;3260;558997;522673;81.8;76.5
64;2021-09-03;872;3202;559869;525875;82.0;77.0
64;2021-09-04;697;2245;560566;528120;82.1;77.3
64;2021-09-05;74;267;560640;528387;82.1;77.3
64;2021-09-06;532;2582;561172;530969;82.1;77.7
64;2021-09-07;710;2338;561882;533307;82.2;78.1
64;2021-09-08;734;2831;562616;536138;82.4;78.5
64;2021-09-09;471;2165;563087;538303;82.4;78.8
64;2021-09-10;743;2473;563830;540776;82.5;79.2
64;2021-09-11;590;2135;564420;542911;82.6;79.5
64;2021-09-12;60;211;564480;543122;82.6;79.5
64;2021-09-13;439;1916;564919;545038;82.7;79.8
64;2021-09-14;487;1927;565406;546965;82.8;80.1
64;2021-09-15;688;1747;566094;548712;82.9;80.3
64;2021-09-16;484;842;566578;549554;82.9;80.4
64;2021-09-17;564;1354;567142;550908;83.0;80.6
64;2021-09-18;331;1257;567473;552165;83.1;80.8
64;2021-09-19;18;42;567491;552207;83.1;80.8
64;2021-09-20;248;480;567739;552687;83.1;80.9
64;2021-09-21;430;951;568169;553638;83.2;81.0
64;2021-09-22;380;1426;568549;555064;83.2;81.2
64;2021-09-23;278;730;568827;555794;83.3;81.4
64;2021-09-24;397;986;569224;556780;83.3;81.5
64;2021-09-25;298;1033;569522;557813;83.4;81.7
64;2021-09-26;0;4;569522;557817;83.4;81.7
64;2021-09-27;234;563;569756;558380;83.4;81.7
64;2021-09-28;261;671;570017;559051;83.4;81.8
64;2021-09-29;339;984;570356;560035;83.5;82.0
65;2020-12-27;0;0;0;0;0.0;0.0
65;2020-12-28;1;0;1;0;0.0;0.0
65;2020-12-29;0;0;1;0;0.0;0.0
65;2020-12-30;0;0;1;0;0.0;0.0
65;2020-12-31;0;0;1;0;0.0;0.0
65;2021-01-01;1;0;2;0;0.0;0.0
65;2021-01-02;0;0;2;0;0.0;0.0
65;2021-01-03;0;0;2;0;0.0;0.0
65;2021-01-04;0;0;2;0;0.0;0.0
65;2021-01-05;1;0;3;0;0.0;0.0
65;2021-01-06;3;0;6;0;0.0;0.0
65;2021-01-07;168;0;174;0;0.1;0.0
65;2021-01-08;253;1;427;1;0.2;0.0
65;2021-01-09;177;1;604;2;0.3;0.0
65;2021-01-10;1;0;605;2;0.3;0.0
65;2021-01-11;275;3;880;5;0.4;0.0
65;2021-01-12;271;1;1151;6;0.5;0.0
65;2021-01-13;587;1;1738;7;0.8;0.0
65;2021-01-14;580;5;2318;12;1.0;0.0
65;2021-01-15;527;2;2845;14;1.3;0.0
65;2021-01-16;221;2;3066;16;1.4;0.0
65;2021-01-17;0;0;3066;16;1.4;0.0
65;2021-01-18;554;4;3620;20;1.6;0.0
65;2021-01-19;571;2;4191;22;1.8;0.0
65;2021-01-20;585;5;4776;27;2.1;0.0
65;2021-01-21;585;0;5361;27;2.4;0.0
65;2021-01-22;598;0;5959;27;2.6;0.0
65;2021-01-23;174;1;6133;28;2.7;0.0
65;2021-01-24;3;1;6136;29;2.7;0.0
65;2021-01-25;551;4;6687;33;2.9;0.0
65;2021-01-26;883;2;7570;35;3.3;0.0
65;2021-01-27;590;10;8160;45;3.6;0.0
65;2021-01-28;509;70;8669;115;3.8;0.1
65;2021-01-29;426;135;9095;250;4.0;0.1
65;2021-01-30;182;42;9277;292;4.1;0.1
65;2021-01-31;15;0;9292;292;4.1;0.1
65;2021-02-01;350;78;9642;370;4.3;0.2
65;2021-02-02;432;146;10074;516;4.4;0.2
65;2021-02-03;463;207;10537;723;4.6;0.3
65;2021-02-04;310;267;10847;990;4.8;0.4
65;2021-02-05;284;310;11131;1300;4.9;0.6
65;2021-02-06;99;72;11230;1372;5.0;0.6
65;2021-02-07;10;0;11240;1372;5.0;0.6
65;2021-02-08;426;184;11666;1556;5.1;0.7
65;2021-02-09;272;308;11938;1864;5.3;0.8
65;2021-02-10;298;202;12236;2066;5.4;0.9
65;2021-02-11;320;226;12556;2292;5.5;1.0
65;2021-02-12;277;175;12833;2467;5.7;1.1
65;2021-02-13;125;78;12958;2545;5.7;1.1
65;2021-02-14;3;15;12961;2560;5.7;1.1
65;2021-02-15;203;314;13164;2874;5.8;1.3
65;2021-02-16;488;449;13652;3323;6.0;1.5
65;2021-02-17;231;405;13883;3728;6.1;1.6
65;2021-02-18;284;467;14167;4195;6.2;1.8
65;2021-02-19;156;365;14323;4560;6.3;2.0
65;2021-02-20;53;140;14376;4700;6.3;2.1
65;2021-02-21;3;48;14379;4748;6.3;2.1
65;2021-02-22;166;436;14545;5184;6.4;2.3
65;2021-02-23;249;426;14794;5610;6.5;2.5
65;2021-02-24;231;536;15025;6146;6.6;2.7
65;2021-02-25;215;157;15240;6303;6.7;2.8
65;2021-02-26;349;636;15589;6939;6.9;3.1
65;2021-02-27;109;166;15698;7105;6.9;3.1
65;2021-02-28;1;0;15699;7105;6.9;3.1
65;2021-03-01;379;316;16078;7421;7.1;3.3
65;2021-03-02;454;281;16532;7702;7.3;3.4
65;2021-03-03;381;334;16913;8036;7.5;3.5
65;2021-03-04;696;286;17609;8322;7.8;3.7
65;2021-03-05;679;261;18288;8583;8.1;3.8
65;2021-03-06;1187;78;19475;8661;8.6;3.8
65;2021-03-07;257;12;19732;8673;8.7;3.8
65;2021-03-08;412;315;20144;8988;8.9;4.0
65;2021-03-09;670;309;20814;9297;9.2;4.1
65;2021-03-10;624;347;21438;9644;9.5;4.3
65;2021-03-11;778;336;22216;9980;9.8;4.4
65;2021-03-12;1060;184;23276;10164;10.3;4.5
65;2021-03-13;354;88;23630;10252;10.4;4.5
65;2021-03-14;3;30;23633;10282;10.4;4.5
65;2021-03-15;816;182;24449;10464;10.8;4.6
65;2021-03-16;693;212;25142;10676;11.1;4.7
65;2021-03-17;712;201;25854;10877;11.4;4.8
65;2021-03-18;537;228;26391;11105;11.6;4.9
65;2021-03-19;878;158;27269;11263;12.0;5.0
65;2021-03-20;245;42;27514;11305;12.1;5.0
65;2021-03-21;12;2;27526;11307;12.1;5.0
65;2021-03-22;734;147;28260;11454;12.5;5.0
65;2021-03-23;838;359;29098;11813;12.8;5.2
65;2021-03-24;868;248;29966;12061;13.2;5.3
65;2021-03-25;1253;188;31219;12249;13.8;5.4
65;2021-03-26;1225;141;32444;12390;14.3;5.5
65;2021-03-27;1357;92;33801;12482;14.9;5.5
65;2021-03-28;1;1;33802;12483;14.9;5.5
65;2021-03-29;1490;357;35292;12840;15.6;5.7
65;2021-03-30;1357;405;36649;13245;16.2;5.8
65;2021-03-31;1208;366;37857;13611;16.7;6.0
65;2021-04-01;1509;393;39366;14004;17.4;6.2
65;2021-04-02;1684;286;41050;14290;18.1;6.3
65;2021-04-03;247;45;41297;14335;18.2;6.3
65;2021-04-04;4;2;41301;14337;18.2;6.3
65;2021-04-05;158;44;41459;14381;18.3;6.3
65;2021-04-06;1294;493;42753;14874;18.8;6.6
65;2021-04-07;1958;456;44711;15330;19.7;6.8
65;2021-04-08;1643;415;46354;15745;20.4;6.9
65;2021-04-09;1642;471;47996;16216;21.2;7.1
65;2021-04-10;1591;150;49587;16366;21.9;7.2
65;2021-04-11;3;0;49590;16366;21.9;7.2
65;2021-04-12;1351;733;50941;17099;22.5;7.5
65;2021-04-13;1584;589;52525;17688;23.2;7.8
65;2021-04-14;1904;744;54429;18432;24.0;8.1
65;2021-04-15;1701;669;56130;19101;24.7;8.4
65;2021-04-16;1824;527;57954;19628;25.5;8.7
65;2021-04-17;2156;131;60110;19759;26.5;8.7
65;2021-04-18;7;27;60117;19786;26.5;8.7
65;2021-04-19;1337;767;61454;20553;27.1;9.1
65;2021-04-20;1530;706;62984;21259;27.8;9.4
65;2021-04-21;1052;1041;64036;22300;28.2;9.8
65;2021-04-22;1646;725;65682;23025;29.0;10.2
65;2021-04-23;1160;1146;66842;24171;29.5;10.7
65;2021-04-24;1265;610;68107;24781;30.0;10.9
65;2021-04-25;31;15;68138;24796;30.0;10.9
65;2021-04-26;1610;1289;69748;26085;30.7;11.5
65;2021-04-27;1423;1336;71171;27421;31.4;12.1
65;2021-04-28;1731;1021;72902;28442;32.1;12.5
65;2021-04-29;1959;1032;74861;29474;33.0;13.0
65;2021-04-30;1782;922;76643;30396;33.8;13.4
65;2021-05-01;1574;230;78217;30626;34.5;13.5
65;2021-05-02;671;25;78888;30651;34.8;13.5
65;2021-05-03;1280;1618;80168;32269;35.3;14.2
65;2021-05-04;1535;1240;81703;33509;36.0;14.8
65;2021-05-05;1374;1640;83077;35149;36.6;15.5
65;2021-05-06;1558;1171;84635;36320;37.3;16.0
65;2021-05-07;1275;1566;85910;37886;37.9;16.7
65;2021-05-08;1647;442;87557;38328;38.6;16.9
65;2021-05-09;0;87;87557;38415;38.6;16.9
65;2021-05-10;954;1883;88511;40298;39.0;17.8
65;2021-05-11;1060;1808;89571;42106;39.5;18.6
65;2021-05-12;1236;1636;90807;43742;40.0;19.3
65;2021-05-13;1345;171;92152;43913;40.6;19.4
65;2021-05-14;1575;1094;93727;45007;41.3;19.8
65;2021-05-15;1401;509;95128;45516;41.9;20.1
65;2021-05-16;1444;69;96572;45585;42.6;20.1
65;2021-05-17;1036;1614;97608;47199;43.0;20.8
65;2021-05-18;1613;1207;99221;48406;43.7;21.3
65;2021-05-19;1684;1010;100905;49416;44.5;21.8
65;2021-05-20;1845;1054;102750;50470;45.3;22.2
65;2021-05-21;1791;1230;104541;51700;46.1;22.8
65;2021-05-22;1287;638;105828;52338;46.7;23.1
65;2021-05-23;689;32;106517;52370;47.0;23.1
65;2021-05-24;703;77;107220;52447;47.3;23.1
65;2021-05-25;1359;1547;108579;53994;47.9;23.8
65;2021-05-26;1471;1352;110050;55346;48.5;24.4
65;2021-05-27;1622;1461;111672;56807;49.2;25.0
65;2021-05-28;1598;1670;113270;58477;49.9;25.8
65;2021-05-29;1188;1515;114458;59992;50.5;26.4
65;2021-05-30;7;10;114465;60002;50.5;26.5
65;2021-05-31;1323;1297;115788;61299;51.0;27.0
65;2021-06-01;1832;937;117620;62236;51.9;27.4
65;2021-06-02;1574;950;119194;63186;52.5;27.9
65;2021-06-03;1343;1105;120537;64291;53.1;28.3
65;2021-06-04;1790;1559;122327;65850;53.9;29.0
65;2021-06-05;432;1240;122759;67090;54.1;29.6
65;2021-06-06;3;13;122762;67103;54.1;29.6
65;2021-06-07;674;1984;123436;69087;54.4;30.5
65;2021-06-08;955;1532;124391;70619;54.8;31.1
65;2021-06-09;827;1546;125218;72165;55.2;31.8
65;2021-06-10;739;1153;125957;73318;55.5;32.3
65;2021-06-11;909;1801;126866;75119;55.9;33.1
65;2021-06-12;150;640;127016;75759;56.0;33.4
65;2021-06-13;5;7;127021;75766;56.0;33.4
65;2021-06-14;501;2421;127522;78187;56.2;34.5
65;2021-06-15;942;1801;128464;79988;56.6;35.3
65;2021-06-16;1063;1365;129527;81353;57.1;35.9
65;2021-06-17;814;1046;130341;82399;57.5;36.3
65;2021-06-18;1019;1633;131360;84032;57.9;37.0
65;2021-06-19;690;1689;132050;85721;58.2;37.8
65;2021-06-20;2;2;132052;85723;58.2;37.8
65;2021-06-21;735;1940;132787;87663;58.5;38.6
65;2021-06-22;1045;1479;133832;89142;59.0;39.3
65;2021-06-23;1063;1234;134895;90376;59.5;39.8
65;2021-06-24;959;1143;135854;91519;59.9;40.3
65;2021-06-25;831;1967;136685;93486;60.3;41.2
65;2021-06-26;168;1658;136853;95144;60.3;41.9
65;2021-06-27;15;1100;136868;96244;60.3;42.4
65;2021-06-28;444;2301;137312;98545;60.5;43.4
65;2021-06-29;683;1921;137995;100466;60.8;44.3
65;2021-06-30;933;1678;138928;102144;61.2;45.0
65;2021-07-01;605;750;139533;102894;61.5;45.4
65;2021-07-02;1166;1732;140699;104626;62.0;46.1
65;2021-07-03;197;1915;140896;106541;62.1;47.0
65;2021-07-04;416;186;141312;106727;62.3;47.0
65;2021-07-05;641;1992;141953;108719;62.6;47.9
65;2021-07-06;897;2127;142850;110846;63.0;48.9
65;2021-07-07;976;1516;143826;112362;63.4;49.5
65;2021-07-08;327;663;144153;113025;63.5;49.8
65;2021-07-09;550;1592;144703;114617;63.8;50.5
65;2021-07-10;303;956;145006;115573;63.9;50.9
65;2021-07-11;0;0;145006;115573;63.9;50.9
65;2021-07-12;480;2220;145486;117793;64.1;51.9
65;2021-07-13;700;2148;146186;119941;64.4;52.9
65;2021-07-14;214;52;146400;119993;64.5;52.9
65;2021-07-15;1095;1662;147495;121655;65.0;53.6
65;2021-07-16;1186;1885;148681;123540;65.5;54.5
65;2021-07-17;431;541;149112;124081;65.7;54.7
65;2021-07-18;22;11;149134;124092;65.7;54.7
65;2021-07-19;635;1494;149769;125586;66.0;55.4
65;2021-07-20;1447;1703;151216;127289;66.7;56.1
65;2021-07-21;1419;1662;152635;128951;67.3;56.8
65;2021-07-22;2197;1288;154832;130239;68.3;57.4
65;2021-07-23;1623;1789;156455;132028;69.0;58.2
65;2021-07-24;1042;649;157497;132677;69.4;58.5
65;2021-07-25;24;21;157521;132698;69.4;58.5
65;2021-07-26;1142;1246;158663;133944;69.9;59.0
65;2021-07-27;1792;1954;160455;135898;70.7;59.9
65;2021-07-28;1603;1321;162058;137219;71.4;60.5
65;2021-07-29;2897;1136;164955;138355;72.7;61.0
65;2021-07-30;2449;1398;167404;139753;73.8;61.6
65;2021-07-31;2305;355;169709;140108;74.8;61.8
65;2021-08-01;14;16;169723;140124;74.8;61.8
65;2021-08-02;994;835;170717;140959;75.3;62.1
65;2021-08-03;2103;1070;172820;142029;76.2;62.6
65;2021-08-04;1802;641;174622;142670;77.0;62.9
65;2021-08-05;1820;833;176442;143503;77.8;63.3
65;2021-08-06;1666;971;178108;144474;78.5;63.7
65;2021-08-07;730;487;178838;144961;78.8;63.9
65;2021-08-08;2;9;178840;144970;78.8;63.9
65;2021-08-09;705;944;179545;145914;79.2;64.3
65;2021-08-10;1193;1544;180738;147458;79.7;65.0
65;2021-08-11;731;1264;181469;148722;80.0;65.6
65;2021-08-12;776;1084;182245;149806;80.3;66.0
65;2021-08-13;427;1010;182672;150816;80.5;66.5
65;2021-08-14;602;567;183274;151383;80.8;66.7
65;2021-08-15;8;19;183282;151402;80.8;66.7
65;2021-08-16;403;1536;183685;152938;81.0;67.4
65;2021-08-17;738;2177;184423;155115;81.3;68.4
65;2021-08-18;604;1545;185027;156660;81.6;69.1
65;2021-08-19;731;1316;185758;157976;81.9;69.6
65;2021-08-20;459;1336;186217;159312;82.1;70.2
65;2021-08-21;43;105;186260;159417;82.1;70.3
65;2021-08-22;11;13;186271;159430;82.1;70.3
65;2021-08-23;273;1681;186544;161111;82.2;71.0
65;2021-08-24;549;2445;187093;163556;82.5;72.1
65;2021-08-25;417;1959;187510;165515;82.7;73.0
65;2021-08-26;464;2307;187974;167822;82.9;74.0
65;2021-08-27;447;1946;188421;169768;83.1;74.8
65;2021-08-28;163;195;188584;169963;83.1;74.9
65;2021-08-29;9;18;188593;169981;83.1;74.9
65;2021-08-30;259;1056;188852;171037;83.3;75.4
65;2021-08-31;468;1588;189320;172625;83.5;76.1
65;2021-09-01;459;1161;189779;173786;83.7;76.6
65;2021-09-02;370;1009;190149;174795;83.8;77.1
65;2021-09-03;451;1245;190600;176040;84.0;77.6
65;2021-09-04;166;909;190766;176949;84.1;78.0
65;2021-09-05;18;35;190784;176984;84.1;78.0
65;2021-09-06;278;794;191062;177778;84.2;78.4
65;2021-09-07;321;1194;191383;178972;84.4;78.9
65;2021-09-08;350;1038;191733;180010;84.5;79.4
65;2021-09-09;249;784;191982;180794;84.6;79.7
65;2021-09-10;379;925;192361;181719;84.8;80.1
65;2021-09-11;54;167;192415;181886;84.8;80.2
65;2021-09-12;1;2;192416;181888;84.8;80.2
65;2021-09-13;201;490;192617;182378;84.9;80.4
65;2021-09-14;187;593;192804;182971;85.0;80.7
65;2021-09-15;249;638;193053;183609;85.1;80.9
65;2021-09-16;139;213;193192;183822;85.2;81.0
65;2021-09-17;275;524;193467;184346;85.3;81.3
65;2021-09-18;98;268;193565;184614;85.3;81.4
65;2021-09-19;2;13;193567;184627;85.3;81.4
65;2021-09-20;109;234;193676;184861;85.4;81.5
65;2021-09-21;110;257;193786;185118;85.4;81.6
65;2021-09-22;153;679;193939;185797;85.5;81.9
65;2021-09-23;66;158;194005;185955;85.5;82.0
65;2021-09-24;170;556;194175;186511;85.6;82.2
65;2021-09-25;73;218;194248;186729;85.6;82.3
65;2021-09-26;3;0;194251;186729;85.6;82.3
65;2021-09-27;62;263;194313;186992;85.7;82.4
65;2021-09-28;83;279;194396;187271;85.7;82.6
65;2021-09-29;128;418;194524;187689;85.8;82.7
66;2020-12-27;0;0;0;0;0.0;0.0
66;2020-12-28;2;0;2;0;0.0;0.0
66;2020-12-29;0;0;2;0;0.0;0.0
66;2020-12-30;0;0;2;0;0.0;0.0
66;2020-12-31;1;0;3;0;0.0;0.0
66;2021-01-01;3;0;6;0;0.0;0.0
66;2021-01-02;0;0;6;0;0.0;0.0
66;2021-01-03;0;0;6;0;0.0;0.0
66;2021-01-04;30;0;36;0;0.0;0.0
66;2021-01-05;135;0;171;0;0.0;0.0
66;2021-01-06;194;0;365;0;0.1;0.0
66;2021-01-07;182;0;547;0;0.1;0.0
66;2021-01-08;212;0;759;0;0.2;0.0
66;2021-01-09;233;0;992;0;0.2;0.0
66;2021-01-10;11;0;1003;0;0.2;0.0
66;2021-01-11;404;2;1407;2;0.3;0.0
66;2021-01-12;588;2;1995;4;0.4;0.0
66;2021-01-13;877;7;2872;11;0.6;0.0
66;2021-01-14;892;11;3764;22;0.8;0.0
66;2021-01-15;588;1;4352;23;0.9;0.0
66;2021-01-16;106;3;4458;26;0.9;0.0
66;2021-01-17;46;1;4504;27;0.9;0.0
66;2021-01-18;654;3;5158;30;1.1;0.0
66;2021-01-19;719;3;5877;33;1.2;0.0
66;2021-01-20;1169;3;7046;36;1.5;0.0
66;2021-01-21;2401;5;9447;41;2.0;0.0
66;2021-01-22;1438;6;10885;47;2.3;0.0
66;2021-01-23;399;4;11284;51;2.4;0.0
66;2021-01-24;225;9;11509;60;2.4;0.0
66;2021-01-25;739;31;12248;91;2.6;0.0
66;2021-01-26;787;56;13035;147;2.7;0.0
66;2021-01-27;867;75;13902;222;2.9;0.0
66;2021-01-28;878;116;14780;338;3.1;0.1
66;2021-01-29;819;110;15599;448;3.3;0.1
66;2021-01-30;481;50;16080;498;3.4;0.1
66;2021-01-31;202;17;16282;515;3.4;0.1
66;2021-02-01;562;151;16844;666;3.5;0.1
66;2021-02-02;621;266;17465;932;3.6;0.2
66;2021-02-03;734;545;18199;1477;3.8;0.3
66;2021-02-04;688;508;18887;1985;3.9;0.4
66;2021-02-05;778;369;19665;2354;4.1;0.5
66;2021-02-06;420;129;20085;2483;4.2;0.5
66;2021-02-07;169;123;20254;2606;4.2;0.5
66;2021-02-08;502;296;20756;2902;4.3;0.6
66;2021-02-09;533;295;21289;3197;4.4;0.7
66;2021-02-10;619;614;21908;3811;4.6;0.8
66;2021-02-11;1104;1384;23012;5195;4.8;1.1
66;2021-02-12;1122;1061;24134;6256;5.0;1.3
66;2021-02-13;366;221;24500;6477;5.1;1.4
66;2021-02-14;111;154;24611;6631;5.1;1.4
66;2021-02-15;425;519;25036;7150;5.2;1.5
66;2021-02-16;304;578;25340;7728;5.3;1.6
66;2021-02-17;378;558;25718;8286;5.4;1.7
66;2021-02-18;366;620;26084;8906;5.4;1.9
66;2021-02-19;400;574;26484;9480;5.5;2.0
66;2021-02-20;184;317;26668;9797;5.6;2.0
66;2021-02-21;41;123;26709;9920;5.6;2.1
66;2021-02-22;415;479;27124;10399;5.7;2.2
66;2021-02-23;509;501;27633;10900;5.8;2.3
66;2021-02-24;347;575;27980;11475;5.8;2.4
66;2021-02-25;717;537;28697;12012;6.0;2.5
66;2021-02-26;953;599;29650;12611;6.2;2.6
66;2021-02-27;363;321;30013;12932;6.3;2.7
66;2021-02-28;59;105;30072;13037;6.3;2.7
66;2021-03-01;378;512;30450;13549;6.4;2.8
66;2021-03-02;335;537;30785;14086;6.4;2.9
66;2021-03-03;530;515;31315;14601;6.5;3.0
66;2021-03-04;991;913;32306;15514;6.7;3.2
66;2021-03-05;1527;697;33833;16211;7.1;3.4
66;2021-03-06;1147;303;34980;16514;7.3;3.4
66;2021-03-07;1098;77;36078;16591;7.5;3.5
66;2021-03-08;696;471;36774;17062;7.7;3.6
66;2021-03-09;1228;526;38002;17588;7.9;3.7
66;2021-03-10;1302;445;39304;18033;8.2;3.8
66;2021-03-11;1474;539;40778;18572;8.5;3.9
66;2021-03-12;2396;543;43174;19115;9.0;4.0
66;2021-03-13;1081;287;44255;19402;9.2;4.1
66;2021-03-14;192;78;44447;19480;9.3;4.1
66;2021-03-15;1109;383;45556;19863;9.5;4.1
66;2021-03-16;953;253;46509;20116;9.7;4.2
66;2021-03-17;866;383;47375;20499;9.9;4.3
66;2021-03-18;969;338;48344;20837;10.1;4.4
66;2021-03-19;1293;314;49637;21151;10.4;4.4
66;2021-03-20;837;121;50474;21272;10.5;4.4
66;2021-03-21;186;43;50660;21315;10.6;4.4
66;2021-03-22;1115;379;51775;21694;10.8;4.5
66;2021-03-23;1757;389;53532;22083;11.2;4.6
66;2021-03-24;1796;510;55328;22593;11.6;4.7
66;2021-03-25;2537;461;57865;23054;12.1;4.8
66;2021-03-26;2577;363;60442;23417;12.6;4.9
66;2021-03-27;1211;292;61653;23709;12.9;4.9
66;2021-03-28;321;3;61974;23712;12.9;5.0
66;2021-03-29;1831;253;63805;23965;13.3;5.0
66;2021-03-30;2241;172;66046;24137;13.8;5.0
66;2021-03-31;1987;249;68033;24386;14.2;5.1
66;2021-04-01;2674;301;70707;24687;14.8;5.2
66;2021-04-02;2421;257;73128;24944;15.3;5.2
66;2021-04-03;1148;331;74276;25275;15.5;5.3
66;2021-04-04;107;124;74383;25399;15.5;5.3
66;2021-04-05;197;140;74580;25539;15.6;5.3
66;2021-04-06;1334;647;75914;26186;15.8;5.5
66;2021-04-07;1399;597;77313;26783;16.1;5.6
66;2021-04-08;2070;548;79383;27331;16.6;5.7
66;2021-04-09;3507;662;82890;27993;17.3;5.8
66;2021-04-10;2308;524;85198;28517;17.8;6.0
66;2021-04-11;1201;169;86399;28686;18.0;6.0
66;2021-04-12;2703;1021;89102;29707;18.6;6.2
66;2021-04-13;3609;1055;92711;30762;19.4;6.4
66;2021-04-14;3292;921;96003;31683;20.0;6.6
66;2021-04-15;3557;1048;99560;32731;20.8;6.8
66;2021-04-16;3592;1033;103152;33764;21.5;7.0
66;2021-04-17;2263;592;105415;34356;22.0;7.2
66;2021-04-18;1445;132;106860;34488;22.3;7.2
66;2021-04-19;2256;1120;109116;35608;22.8;7.4
66;2021-04-20;2373;1075;111489;36683;23.3;7.7
66;2021-04-21;2871;1175;114360;37858;23.9;7.9
66;2021-04-22;2662;1232;117022;39090;24.4;8.2
66;2021-04-23;2380;1234;119402;40324;24.9;8.4
66;2021-04-24;2743;882;122145;41206;25.5;8.6
66;2021-04-25;1206;266;123351;41472;25.8;8.7
66;2021-04-26;1998;1251;125349;42723;26.2;8.9
66;2021-04-27;2748;1302;128097;44025;26.7;9.2
66;2021-04-28;2420;1654;130517;45679;27.2;9.5
66;2021-04-29;2704;2126;133221;47805;27.8;10.0
66;2021-04-30;3053;1551;136274;49356;28.4;10.3
66;2021-05-01;2000;470;138274;49826;28.9;10.4
66;2021-05-02;1529;264;139803;50090;29.2;10.5
66;2021-05-03;2940;1109;142743;51199;29.8;10.7
66;2021-05-04;3169;1339;145912;52538;30.5;11.0
66;2021-05-05;3055;1548;148967;54086;31.1;11.3
66;2021-05-06;3755;2084;152722;56170;31.9;11.7
66;2021-05-07;2968;3064;155690;59234;32.5;12.4
66;2021-05-08;1730;1169;157420;60403;32.9;12.6
66;2021-05-09;886;1369;158306;61772;33.0;12.9
66;2021-05-10;1802;2967;160108;64739;33.4;13.5
66;2021-05-11;2741;3125;162849;67864;34.0;14.2
66;2021-05-12;2432;2569;165281;70433;34.5;14.7
66;2021-05-13;2259;1386;167540;71819;35.0;15.0
66;2021-05-14;2770;2118;170310;73937;35.6;15.4
66;2021-05-15;2326;1574;172636;75511;36.0;15.8
66;2021-05-16;2286;1246;174922;76757;36.5;16.0
66;2021-05-17;2051;1826;176973;78583;36.9;16.4
66;2021-05-18;3237;1808;180210;80391;37.6;16.8
66;2021-05-19;2876;1341;183086;81732;38.2;17.1
66;2021-05-20;4372;1444;187458;83176;39.1;17.4
66;2021-05-21;3267;1463;190725;84639;39.8;17.7
66;2021-05-22;3065;779;193790;85418;40.5;17.8
66;2021-05-23;1509;236;195299;85654;40.8;17.9
66;2021-05-24;1953;427;197252;86081;41.2;18.0
66;2021-05-25;2796;1688;200048;87769;41.8;18.3
66;2021-05-26;2779;1491;202827;89260;42.3;18.6
66;2021-05-27;3384;2247;206211;91507;43.1;19.1
66;2021-05-28;2683;3034;208894;94541;43.6;19.7
66;2021-05-29;2145;1518;211039;96059;44.1;20.1
66;2021-05-30;786;988;211825;97047;44.2;20.3
66;2021-05-31;2124;1771;213949;98818;44.7;20.6
66;2021-06-01;2636;2002;216585;100820;45.2;21.0
66;2021-06-02;2806;2334;219391;103154;45.8;21.5
66;2021-06-03;2488;2957;221879;106111;46.3;22.2
66;2021-06-04;1959;3351;223838;109462;46.7;22.9
66;2021-06-05;1409;2599;225247;112061;47.0;23.4
66;2021-06-06;294;1228;225541;113289;47.1;23.7
66;2021-06-07;1335;2955;226876;116244;47.4;24.3
66;2021-06-08;1736;3019;228612;119263;47.7;24.9
66;2021-06-09;2066;2787;230678;122050;48.2;25.5
66;2021-06-10;2086;2962;232764;125012;48.6;26.1
66;2021-06-11;2098;3856;234862;128868;49.0;26.9
66;2021-06-12;871;2411;235733;131279;49.2;27.4
66;2021-06-13;516;1333;236249;132612;49.3;27.7
66;2021-06-14;1361;3495;237610;136107;49.6;28.4
66;2021-06-15;2131;3572;239741;139679;50.1;29.2
66;2021-06-16;1792;3568;241533;143247;50.4;29.9
66;2021-06-17;2441;3604;243974;146851;50.9;30.7
66;2021-06-18;2225;3822;246199;150673;51.4;31.5
66;2021-06-19;1542;2319;247741;152992;51.7;31.9
66;2021-06-20;998;1267;248739;154259;51.9;32.2
66;2021-06-21;1163;2879;249902;157138;52.2;32.8
66;2021-06-22;1510;3761;251412;160899;52.5;33.6
66;2021-06-23;1325;3027;252737;163926;52.8;34.2
66;2021-06-24;1527;3226;254264;167152;53.1;34.9
66;2021-06-25;1404;3533;255668;170685;53.4;35.6
66;2021-06-26;962;2680;256630;173365;53.6;36.2
66;2021-06-27;677;1557;257307;174922;53.7;36.5
66;2021-06-28;980;2975;258287;177897;53.9;37.1
66;2021-06-29;1148;3797;259435;181694;54.2;37.9
66;2021-06-30;1278;3306;260713;185000;54.4;38.6
66;2021-07-01;1453;4047;262166;189047;54.7;39.5
66;2021-07-02;1349;3599;263515;192646;55.0;40.2
66;2021-07-03;1152;3898;264667;196544;55.3;41.0
66;2021-07-04;715;1789;265382;198333;55.4;41.4
66;2021-07-05;1293;3005;266675;201338;55.7;42.0
66;2021-07-06;1458;3785;268133;205123;56.0;42.8
66;2021-07-07;1430;3247;269563;208370;56.3;43.5
66;2021-07-08;1388;3384;270951;211754;56.6;44.2
66;2021-07-09;1450;3464;272401;215218;56.9;44.9
66;2021-07-10;1004;2403;273405;217621;57.1;45.4
66;2021-07-11;540;1540;273945;219161;57.2;45.8
66;2021-07-12;1021;3645;274966;222806;57.4;46.5
66;2021-07-13;2223;4261;277189;227067;57.9;47.4
66;2021-07-14;1953;1243;279142;228310;58.3;47.7
66;2021-07-15;2801;3110;281943;231420;58.9;48.3
66;2021-07-16;3410;3211;285353;234631;59.6;49.0
66;2021-07-17;2123;2033;287476;236664;60.0;49.4
66;2021-07-18;1197;1062;288673;237726;60.3;49.6
66;2021-07-19;2793;3083;291466;240809;60.8;50.3
66;2021-07-20;3654;2883;295120;243692;61.6;50.9
66;2021-07-21;3962;2953;299082;246645;62.4;51.5
66;2021-07-22;3917;2820;302999;249465;63.3;52.1
66;2021-07-23;3914;3029;306913;252494;64.1;52.7
66;2021-07-24;2584;1923;309497;254417;64.6;53.1
66;2021-07-25;2020;1240;311517;255657;65.0;53.4
66;2021-07-26;2865;2627;314382;258284;65.6;53.9
66;2021-07-27;3229;2888;317611;261172;66.3;54.5
66;2021-07-28;3354;2580;320965;263752;67.0;55.1
66;2021-07-29;3864;2537;324829;266289;67.8;55.6
66;2021-07-30;4233;2472;329062;268761;68.7;56.1
66;2021-07-31;2231;1717;331293;270478;69.2;56.5
66;2021-08-01;1820;900;333113;271378;69.5;56.7
66;2021-08-02;2390;1919;335503;273297;70.0;57.1
66;2021-08-03;2624;2071;338127;275368;70.6;57.5
66;2021-08-04;2645;1994;340772;277362;71.1;57.9
66;2021-08-05;2443;2438;343215;279800;71.7;58.4
66;2021-08-06;2339;2647;345554;282447;72.1;59.0
66;2021-08-07;1506;2098;347060;284545;72.5;59.4
66;2021-08-08;613;1456;347673;286001;72.6;59.7
66;2021-08-09;1357;2801;349030;288802;72.9;60.3
66;2021-08-10;1648;3074;350678;291876;73.2;60.9
66;2021-08-11;1628;3021;352306;294897;73.6;61.6
66;2021-08-12;1678;2991;353984;297888;73.9;62.2
66;2021-08-13;1471;2982;355455;300870;74.2;62.8
66;2021-08-14;658;2508;356113;303378;74.3;63.3
66;2021-08-15;136;1629;356249;305007;74.4;63.7
66;2021-08-16;1277;2594;357526;307601;74.6;64.2
66;2021-08-17;1496;2979;359022;310580;75.0;64.8
66;2021-08-18;1348;3072;360370;313652;75.2;65.5
66;2021-08-19;1113;2925;361483;316577;75.5;66.1
66;2021-08-20;1001;3322;362484;319899;75.7;66.8
66;2021-08-21;593;2013;363077;321912;75.8;67.2
66;2021-08-22;233;1352;363310;323264;75.8;67.5
66;2021-08-23;1149;2764;364459;326028;76.1;68.1
66;2021-08-24;1063;2950;365522;328978;76.3;68.7
66;2021-08-25;914;2301;366436;331279;76.5;69.2
66;2021-08-26;958;2185;367394;333464;76.7;69.6
66;2021-08-27;914;2366;368308;335830;76.9;70.1
66;2021-08-28;514;1136;368822;336966;77.0;70.3
66;2021-08-29;244;333;369066;337299;77.0;70.4
66;2021-08-30;837;2593;369903;339892;77.2;71.0
66;2021-08-31;835;2726;370738;342618;77.4;71.5
66;2021-09-01;725;2161;371463;344779;77.5;72.0
66;2021-09-02;666;1768;372129;346547;77.7;72.3
66;2021-09-03;708;2043;372837;348590;77.8;72.8
66;2021-09-04;721;1749;373558;350339;78.0;73.1
66;2021-09-05;203;311;373761;350650;78.0;73.2
66;2021-09-06;427;1877;374188;352527;78.1;73.6
66;2021-09-07;375;1636;374563;354163;78.2;73.9
66;2021-09-08;551;1767;375114;355930;78.3;74.3
66;2021-09-09;462;1594;375576;357524;78.4;74.6
66;2021-09-10;490;1530;376066;359054;78.5;75.0
66;2021-09-11;513;1307;376579;360361;78.6;75.2
66;2021-09-12;94;178;376673;360539;78.6;75.3
66;2021-09-13;338;1693;377011;362232;78.7;75.6
66;2021-09-14;383;1459;377394;363691;78.8;75.9
66;2021-09-15;470;954;377864;364645;78.9;76.1
66;2021-09-16;379;795;378243;365440;79.0;76.3
66;2021-09-17;325;770;378568;366210;79.0;76.5
66;2021-09-18;356;1098;378924;367308;79.1;76.7
66;2021-09-19;77;240;379001;367548;79.1;76.7
66;2021-09-20;288;672;379289;368220;79.2;76.9
66;2021-09-21;306;585;379595;368805;79.2;77.0
66;2021-09-22;316;792;379911;369597;79.3;77.2
66;2021-09-23;236;509;380147;370106;79.4;77.3
66;2021-09-24;360;772;380507;370878;79.4;77.4
66;2021-09-25;215;940;380722;371818;79.5;77.6
66;2021-09-26;63;213;380785;372031;79.5;77.7
66;2021-09-27;186;498;380971;372529;79.5;77.8
66;2021-09-28;244;542;381215;373071;79.6;77.9
66;2021-09-29;228;576;381443;373647;79.6;78.0
67;2020-12-27;11;0;11;0;0.0;0.0
67;2020-12-28;4;0;15;0;0.0;0.0
67;2020-12-29;2;0;17;0;0.0;0.0
67;2020-12-30;0;0;17;0;0.0;0.0
67;2020-12-31;0;0;17;0;0.0;0.0
67;2021-01-01;6;0;23;0;0.0;0.0
67;2021-01-02;1;0;24;0;0.0;0.0
67;2021-01-03;1;0;25;0;0.0;0.0
67;2021-01-04;41;0;66;0;0.0;0.0
67;2021-01-05;167;0;233;0;0.0;0.0
67;2021-01-06;121;0;354;0;0.0;0.0
67;2021-01-07;235;1;589;1;0.1;0.0
67;2021-01-08;235;1;824;2;0.1;0.0
67;2021-01-09;113;1;937;3;0.1;0.0
67;2021-01-10;67;0;1004;3;0.1;0.0
67;2021-01-11;184;1;1188;4;0.1;0.0
67;2021-01-12;511;1;1699;5;0.2;0.0
67;2021-01-13;660;2;2359;7;0.2;0.0
67;2021-01-14;1092;7;3451;14;0.3;0.0
67;2021-01-15;942;6;4393;20;0.4;0.0
67;2021-01-16;199;3;4592;23;0.4;0.0
67;2021-01-17;101;0;4693;23;0.4;0.0
67;2021-01-18;903;3;5596;26;0.5;0.0
67;2021-01-19;1423;5;7019;31;0.6;0.0
67;2021-01-20;1854;12;8873;43;0.8;0.0
67;2021-01-21;2216;10;11089;53;1.0;0.0
67;2021-01-22;1991;7;13080;60;1.2;0.0
67;2021-01-23;814;5;13894;65;1.2;0.0
67;2021-01-24;380;1;14274;66;1.3;0.0
67;2021-01-25;526;29;14800;95;1.3;0.0
67;2021-01-26;160;101;14960;196;1.3;0.0
67;2021-01-27;1398;79;16358;275;1.4;0.0
67;2021-01-28;3057;205;19415;480;1.7;0.0
67;2021-01-29;2032;139;21447;619;1.9;0.1
67;2021-01-30;1098;66;22545;685;2.0;0.1
67;2021-01-31;1163;24;23708;709;2.1;0.1
67;2021-02-01;3397;235;27105;944;2.4;0.1
67;2021-02-02;2695;390;29800;1334;2.6;0.1
67;2021-02-03;1577;371;31377;1705;2.8;0.2
67;2021-02-04;1196;713;32573;2418;2.9;0.2
67;2021-02-05;1195;588;33768;3006;3.0;0.3
67;2021-02-06;799;122;34567;3128;3.1;0.3
67;2021-02-07;292;37;34859;3165;3.1;0.3
67;2021-02-08;839;383;35698;3548;3.2;0.3
67;2021-02-09;960;652;36658;4200;3.2;0.4
67;2021-02-10;934;699;37592;4899;3.3;0.4
67;2021-02-11;1151;1057;38743;5956;3.4;0.5
67;2021-02-12;1245;670;39988;6626;3.5;0.6
67;2021-02-13;767;240;40755;6866;3.6;0.6
67;2021-02-14;244;91;40999;6957;3.6;0.6
67;2021-02-15;782;655;41781;7612;3.7;0.7
67;2021-02-16;931;865;42712;8477;3.8;0.7
67;2021-02-17;785;936;43497;9413;3.8;0.8
67;2021-02-18;1401;2331;44898;11744;4.0;1.0
67;2021-02-19;1376;1789;46274;13533;4.1;1.2
67;2021-02-20;634;747;46908;14280;4.1;1.3
67;2021-02-21;209;1074;47117;15354;4.2;1.4
67;2021-02-22;1401;1958;48518;17312;4.3;1.5
67;2021-02-23;1461;1308;49979;18620;4.4;1.6
67;2021-02-24;1439;894;51418;19514;4.5;1.7
67;2021-02-25;1618;1208;53036;20722;4.7;1.8
67;2021-02-26;2229;1162;55265;21884;4.9;1.9
67;2021-02-27;1257;620;56522;22504;5.0;2.0
67;2021-02-28;147;261;56669;22765;5.0;2.0
67;2021-03-01;640;843;57309;23608;5.1;2.1
67;2021-03-02;895;1039;58204;24647;5.1;2.2
67;2021-03-03;1409;1110;59613;25757;5.3;2.3
67;2021-03-04;1961;931;61574;26688;5.4;2.4
67;2021-03-05;3258;998;64832;27686;5.7;2.4
67;2021-03-06;2337;679;67169;28365;5.9;2.5
67;2021-03-07;468;239;67637;28604;6.0;2.5
67;2021-03-08;1188;719;68825;29323;6.1;2.6
67;2021-03-09;2226;821;71051;30144;6.3;2.7
67;2021-03-10;2455;1095;73506;31239;6.5;2.8
67;2021-03-11;3208;1297;76714;32536;6.8;2.9
67;2021-03-12;5260;1309;81974;33845;7.2;3.0
67;2021-03-13;3998;862;85972;34707;7.6;3.1
67;2021-03-14;483;369;86455;35076;7.6;3.1
67;2021-03-15;2192;1122;88647;36198;7.8;3.2
67;2021-03-16;1552;1199;90199;37397;8.0;3.3
67;2021-03-17;2071;893;92270;38290;8.1;3.4
67;2021-03-18;2389;720;94659;39010;8.4;3.4
67;2021-03-19;3673;739;98332;39749;8.7;3.5
67;2021-03-20;3064;503;101396;40252;9.0;3.6
67;2021-03-21;336;17;101732;40269;9.0;3.6
67;2021-03-22;2332;756;104064;41025;9.2;3.6
67;2021-03-23;3401;768;107465;41793;9.5;3.7
67;2021-03-24;3909;795;111374;42588;9.8;3.8
67;2021-03-25;5315;535;116689;43123;10.3;3.8
67;2021-03-26;6869;465;123558;43588;10.9;3.8
67;2021-03-27;3926;344;127484;43932;11.3;3.9
67;2021-03-28;579;98;128063;44030;11.3;3.9
67;2021-03-29;3824;423;131887;44453;11.6;3.9
67;2021-03-30;4848;664;136735;45117;12.1;4.0
67;2021-03-31;4848;691;141583;45808;12.5;4.0
67;2021-04-01;5146;924;146729;46732;13.0;4.1
67;2021-04-02;1008;171;147737;46903;13.0;4.1
67;2021-04-03;1689;282;149426;47185;13.2;4.2
67;2021-04-04;328;5;149754;47190;13.2;4.2
67;2021-04-05;371;5;150125;47195;13.3;4.2
67;2021-04-06;3484;1176;153609;48371;13.6;4.3
67;2021-04-07;4533;1281;158142;49652;14.0;4.4
67;2021-04-08;5663;1405;163805;51057;14.5;4.5
67;2021-04-09;7110;1345;170915;52402;15.1;4.6
67;2021-04-10;4332;886;175247;53288;15.5;4.7
67;2021-04-11;857;425;176104;53713;15.5;4.7
67;2021-04-12;3886;1401;179990;55114;15.9;4.9
67;2021-04-13;4890;1574;184880;56688;16.3;5.0
67;2021-04-14;5297;1898;190177;58586;16.8;5.2
67;2021-04-15;6082;2107;196259;60693;17.3;5.4
67;2021-04-16;7834;2419;204093;63112;18.0;5.6
67;2021-04-17;4009;1575;208102;64687;18.4;5.7
67;2021-04-18;1111;644;209213;65331;18.5;5.8
67;2021-04-19;3630;2139;212843;67470;18.8;6.0
67;2021-04-20;4257;1919;217100;69389;19.2;6.1
67;2021-04-21;4071;2514;221171;71903;19.5;6.3
67;2021-04-22;4478;2917;225649;74820;19.9;6.6
67;2021-04-23;5253;3002;230902;77822;20.4;6.9
67;2021-04-24;3101;2022;234003;79844;20.7;7.0
67;2021-04-25;1027;449;235030;80293;20.8;7.1
67;2021-04-26;3191;2614;238221;82907;21.0;7.3
67;2021-04-27;4024;2903;242245;85810;21.4;7.6
67;2021-04-28;4253;3407;246498;89217;21.8;7.9
67;2021-04-29;5125;3490;251623;92707;22.2;8.2
67;2021-04-30;7182;2458;258805;95165;22.9;8.4
67;2021-05-01;2685;780;261490;95945;23.1;8.5
67;2021-05-02;2181;677;263671;96622;23.3;8.5
67;2021-05-03;5561;2615;269232;99237;23.8;8.8
67;2021-05-04;5852;3601;275084;102838;24.3;9.1
67;2021-05-05;5219;4188;280303;107026;24.7;9.4
67;2021-05-06;6714;4918;287017;111944;25.3;9.9
67;2021-05-07;6434;6897;293451;118841;25.9;10.5
67;2021-05-08;3575;1018;297026;119859;26.2;10.6
67;2021-05-09;3366;591;300392;120450;26.5;10.6
67;2021-05-10;4698;4525;305090;124975;26.9;11.0
67;2021-05-11;5647;4909;310737;129884;27.4;11.5
67;2021-05-12;6596;4832;317333;134716;28.0;11.9
67;2021-05-13;7309;1668;324642;136384;28.7;12.0
67;2021-05-14;8878;5353;333520;141737;29.4;12.5
67;2021-05-15;8198;3655;341718;145392;30.2;12.8
67;2021-05-16;6176;969;347894;146361;30.7;12.9
67;2021-05-17;5689;3878;353583;150239;31.2;13.3
67;2021-05-18;6894;3975;360477;154214;31.8;13.6
67;2021-05-19;7376;4165;367853;158379;32.5;14.0
67;2021-05-20;8681;4229;376534;162608;33.2;14.4
67;2021-05-21;8156;5848;384690;168456;34.0;14.9
67;2021-05-22;5933;3416;390623;171872;34.5;15.2
67;2021-05-23;2656;593;393279;172465;34.7;15.2
67;2021-05-24;4414;863;397693;173328;35.1;15.3
67;2021-05-25;5412;4766;403105;178094;35.6;15.7
67;2021-05-26;6063;4868;409168;182962;36.1;16.2
67;2021-05-27;7310;4886;416478;187848;36.8;16.6
67;2021-05-28;7964;6487;424442;194335;37.5;17.2
67;2021-05-29;6646;3860;431088;198195;38.1;17.5
67;2021-05-30;1147;809;432235;199004;38.2;17.6
67;2021-05-31;6405;4054;438640;203058;38.7;17.9
67;2021-06-01;7326;4393;445966;207451;39.4;18.3
67;2021-06-02;8066;4174;454032;211625;40.1;18.7
67;2021-06-03;8841;4858;462873;216483;40.9;19.1
67;2021-06-04;8594;6119;471467;222602;41.6;19.7
67;2021-06-05;6548;3981;478015;226583;42.2;20.0
67;2021-06-06;3468;875;481483;227458;42.5;20.1
67;2021-06-07;7407;4252;488890;231710;43.2;20.5
67;2021-06-08;8616;4928;497506;236638;43.9;20.9
67;2021-06-09;9258;4784;506764;241422;44.7;21.3
67;2021-06-10;9769;5011;516533;246433;45.6;21.8
67;2021-06-11;8065;8307;524598;254740;46.3;22.5
67;2021-06-12;6789;5199;531387;259939;46.9;23.0
67;2021-06-13;3105;1044;534492;260983;47.2;23.0
67;2021-06-14;5504;6454;539996;267437;47.7;23.6
67;2021-06-15;6688;6749;546684;274186;48.3;24.2
67;2021-06-16;6948;6694;553632;280880;48.9;24.8
67;2021-06-17;7273;9040;560905;289920;49.5;25.6
67;2021-06-18;7600;8500;568505;298420;50.2;26.3
67;2021-06-19;6386;5960;574891;304380;50.8;26.9
67;2021-06-20;1447;1411;576338;305791;50.9;27.0
67;2021-06-21;4264;6772;580602;312563;51.3;27.6
67;2021-06-22;4239;9091;584841;321654;51.6;28.4
67;2021-06-23;5292;8181;590133;329835;52.1;29.1
67;2021-06-24;4521;9098;594654;338933;52.5;29.9
67;2021-06-25;5333;9949;599987;348882;53.0;30.8
67;2021-06-26;3463;9100;603450;357982;53.3;31.6
67;2021-06-27;1023;3523;604473;361505;53.4;31.9
67;2021-06-28;2845;8723;607318;370228;53.6;32.7
67;2021-06-29;2896;8610;610214;378838;53.9;33.4
67;2021-06-30;3380;8741;613594;387579;54.2;34.2
67;2021-07-01;3667;8419;617261;395998;54.5;35.0
67;2021-07-02;3735;10933;620996;406931;54.8;35.9
67;2021-07-03;2981;7742;623977;414673;55.1;36.6
67;2021-07-04;764;1869;624741;416542;55.2;36.8
67;2021-07-05;2625;8251;627366;424793;55.4;37.5
67;2021-07-06;3106;8435;630472;433228;55.7;38.3
67;2021-07-07;3925;8742;634397;441970;56.0;39.0
67;2021-07-08;4200;7785;638597;449755;56.4;39.7
67;2021-07-09;3767;11367;642364;461122;56.7;40.7
67;2021-07-10;2859;8204;645223;469326;57.0;41.4
67;2021-07-11;943;1994;646166;471320;57.1;41.6
67;2021-07-12;2478;9723;648644;481043;57.3;42.5
67;2021-07-13;4119;9886;652763;490929;57.6;43.3
67;2021-07-14;3491;4405;656254;495334;57.9;43.7
67;2021-07-15;5140;12226;661394;507560;58.4;44.8
67;2021-07-16;4867;12290;666261;519850;58.8;45.9
67;2021-07-17;3734;8820;669995;528670;59.2;46.7
67;2021-07-18;1464;2550;671459;531220;59.3;46.9
67;2021-07-19;4648;9739;676107;540959;59.7;47.8
67;2021-07-20;5775;9823;681882;550782;60.2;48.6
67;2021-07-21;5869;10650;687751;561432;60.7;49.6
67;2021-07-22;6439;10222;694190;571654;61.3;50.5
67;2021-07-23;7394;11185;701584;582839;61.9;51.5
67;2021-07-24;5423;7578;707007;590417;62.4;52.1
67;2021-07-25;2316;1971;709323;592388;62.6;52.3
67;2021-07-26;5003;7247;714326;599635;63.1;52.9
67;2021-07-27;6621;7325;720947;606960;63.7;53.6
67;2021-07-28;7540;7208;728487;614168;64.3;54.2
67;2021-07-29;8394;6432;736881;620600;65.1;54.8
67;2021-07-30;8667;7312;745548;627912;65.8;55.4
67;2021-07-31;5112;4878;750660;632790;66.3;55.9
67;2021-08-01;2486;1433;753146;634223;66.5;56.0
67;2021-08-02;6415;5090;759561;639313;67.1;56.4
67;2021-08-03;7321;4714;766882;644027;67.7;56.9
67;2021-08-04;6898;4601;773780;648628;68.3;57.3
67;2021-08-05;5746;4230;779526;652858;68.8;57.6
67;2021-08-06;6329;5424;785855;658282;69.4;58.1
67;2021-08-07;4688;4278;790543;662560;69.8;58.5
67;2021-08-08;1310;1440;791853;664000;69.9;58.6
67;2021-08-09;3142;4480;794995;668480;70.2;59.0
67;2021-08-10;3249;4782;798244;673262;70.5;59.4
67;2021-08-11;3423;4675;801667;677937;70.8;59.9
67;2021-08-12;3140;4887;804807;682824;71.1;60.3
67;2021-08-13;3207;5384;808014;688208;71.3;60.8
67;2021-08-14;2198;5084;810212;693292;71.5;61.2
67;2021-08-15;713;1605;810925;694897;71.6;61.4
67;2021-08-16;2091;5241;813016;700138;71.8;61.8
67;2021-08-17;2105;5277;815121;705415;72.0;62.3
67;2021-08-18;2384;6345;817505;711760;72.2;62.8
67;2021-08-19;1900;6152;819405;717912;72.3;63.4
67;2021-08-20;2342;7458;821747;725370;72.6;64.0
67;2021-08-21;1530;5572;823277;730942;72.7;64.5
67;2021-08-22;388;2049;823665;732991;72.7;64.7
67;2021-08-23;1944;6849;825609;739840;72.9;65.3
67;2021-08-24;1997;6613;827606;746453;73.1;65.9
67;2021-08-25;2126;7215;829732;753668;73.3;66.5
67;2021-08-26;1854;5549;831586;759217;73.4;67.0
67;2021-08-27;2215;7052;833801;766269;73.6;67.7
67;2021-08-28;1703;6105;835504;772374;73.8;68.2
67;2021-08-29;439;1600;835943;773974;73.8;68.3
67;2021-08-30;1424;4444;837367;778418;73.9;68.7
67;2021-08-31;1435;4207;838802;782625;74.1;69.1
67;2021-09-01;1794;4557;840596;787182;74.2;69.5
67;2021-09-02;1068;3133;841664;790315;74.3;69.8
67;2021-09-03;1555;4437;843219;794752;74.4;70.2
67;2021-09-04;1474;4094;844693;798846;74.6;70.5
67;2021-09-05;259;936;844952;799782;74.6;70.6
67;2021-09-06;965;2344;845917;802126;74.7;70.8
67;2021-09-07;886;2238;846803;804364;74.8;71.0
67;2021-09-08;1197;2998;848000;807362;74.9;71.3
67;2021-09-09;1103;2286;849103;809648;75.0;71.5
67;2021-09-10;1426;2891;850529;812539;75.1;71.7
67;2021-09-11;1061;3103;851590;815642;75.2;72.0
67;2021-09-12;250;612;851840;816254;75.2;72.1
67;2021-09-13;698;2047;852538;818301;75.3;72.2
67;2021-09-14;937;2009;853475;820310;75.4;72.4
67;2021-09-15;1015;2108;854490;822418;75.4;72.6
67;2021-09-16;749;1302;855239;823720;75.5;72.7
67;2021-09-17;967;2226;856206;825946;75.6;72.9
67;2021-09-18;804;2419;857010;828365;75.7;73.1
67;2021-09-19;103;411;857113;828776;75.7;73.2
67;2021-09-20;600;1129;857713;829905;75.7;73.3
67;2021-09-21;490;1064;858203;830969;75.8;73.4
67;2021-09-22;668;1948;858871;832917;75.8;73.5
67;2021-09-23;565;940;859436;833857;75.9;73.6
67;2021-09-24;678;1662;860114;835519;75.9;73.8
67;2021-09-25;598;1867;860712;837386;76.0;73.9
67;2021-09-26;73;327;860785;837713;76.0;74.0
67;2021-09-27;394;948;861179;838661;76.0;74.0
67;2021-09-28;404;859;861583;839520;76.1;74.1
67;2021-09-29;615;1356;862198;840876;76.1;74.2
68;2020-12-27;0;0;0;0;0.0;0.0
68;2020-12-28;0;0;0;0;0.0;0.0
68;2020-12-29;0;0;0;0;0.0;0.0
68;2020-12-30;2;0;2;0;0.0;0.0
68;2020-12-31;0;0;2;0;0.0;0.0
68;2021-01-01;0;0;2;0;0.0;0.0
68;2021-01-02;0;0;2;0;0.0;0.0
68;2021-01-03;1;0;3;0;0.0;0.0
68;2021-01-04;2;0;5;0;0.0;0.0
68;2021-01-05;11;0;16;0;0.0;0.0
68;2021-01-06;245;1;261;1;0.0;0.0
68;2021-01-07;75;0;336;1;0.0;0.0
68;2021-01-08;118;1;454;2;0.1;0.0
68;2021-01-09;20;0;474;2;0.1;0.0
68;2021-01-10;1;0;475;2;0.1;0.0
68;2021-01-11;82;0;557;2;0.1;0.0
68;2021-01-12;388;1;945;3;0.1;0.0
68;2021-01-13;704;2;1649;5;0.2;0.0
68;2021-01-14;372;2;2021;7;0.3;0.0
68;2021-01-15;204;1;2225;8;0.3;0.0
68;2021-01-16;1;0;2226;8;0.3;0.0
68;2021-01-17;0;0;2226;8;0.3;0.0
68;2021-01-18;379;5;2605;13;0.3;0.0
68;2021-01-19;559;5;3164;18;0.4;0.0
68;2021-01-20;707;10;3871;28;0.5;0.0
68;2021-01-21;1394;13;5265;41;0.7;0.0
68;2021-01-22;1497;12;6762;53;0.9;0.0
68;2021-01-23;215;3;6977;56;0.9;0.0
68;2021-01-24;698;1;7675;57;1.0;0.0
68;2021-01-25;1390;41;9065;98;1.2;0.0
68;2021-01-26;1555;79;10620;177;1.4;0.0
68;2021-01-27;2773;150;13393;327;1.8;0.0
68;2021-01-28;2358;58;15751;385;2.1;0.1
68;2021-01-29;1508;116;17259;501;2.3;0.1
68;2021-01-30;165;3;17424;504;2.3;0.1
68;2021-01-31;0;0;17424;504;2.3;0.1
68;2021-02-01;737;106;18161;610;2.4;0.1
68;2021-02-02;869;293;19030;903;2.5;0.1
68;2021-02-03;1001;596;20031;1499;2.6;0.2
68;2021-02-04;1001;307;21032;1806;2.8;0.2
68;2021-02-05;947;220;21979;2026;2.9;0.3
68;2021-02-06;140;2;22119;2028;2.9;0.3
68;2021-02-07;2;16;22121;2044;2.9;0.3
68;2021-02-08;893;23;23014;2067;3.0;0.3
68;2021-02-09;1357;42;24371;2109;3.2;0.3
68;2021-02-10;1453;64;25824;2173;3.4;0.3
68;2021-02-11;1486;461;27310;2634;3.6;0.3
68;2021-02-12;1551;435;28861;3069;3.8;0.4
68;2021-02-13;131;1;28992;3070;3.8;0.4
68;2021-02-14;58;232;29050;3302;3.8;0.4
68;2021-02-15;662;969;29712;4271;3.9;0.6
68;2021-02-16;864;1197;30576;5468;4.0;0.7
68;2021-02-17;1288;2010;31864;7478;4.2;1.0
68;2021-02-18;1668;1930;33532;9408;4.4;1.2
68;2021-02-19;988;1247;34520;10655;4.5;1.4
68;2021-02-20;93;118;34613;10773;4.5;1.4
68;2021-02-21;1;38;34614;10811;4.5;1.4
68;2021-02-22;447;683;35061;11494;4.6;1.5
68;2021-02-23;639;968;35700;12462;4.7;1.6
68;2021-02-24;854;1042;36554;13504;4.8;1.8
68;2021-02-25;1208;1135;37762;14639;4.9;1.9
68;2021-02-26;1200;847;38962;15486;5.1;2.0
68;2021-02-27;550;158;39512;15644;5.2;2.0
68;2021-02-28;12;1;39524;15645;5.2;2.0
68;2021-03-01;942;678;40466;16323;5.3;2.1
68;2021-03-02;1215;857;41681;17180;5.5;2.3
68;2021-03-03;1593;896;43274;18076;5.7;2.4
68;2021-03-04;1995;944;45269;19020;5.9;2.5
68;2021-03-05;2355;952;47624;19972;6.2;2.6
68;2021-03-06;2286;236;49910;20208;6.5;2.6
68;2021-03-07;838;104;50748;20312;6.6;2.7
68;2021-03-08;1475;886;52223;21198;6.8;2.8
68;2021-03-09;1698;1236;53921;22434;7.1;2.9
68;2021-03-10;1965;1713;55886;24147;7.3;3.2
68;2021-03-11;2637;1833;58523;25980;7.7;3.4
68;2021-03-12;2631;1350;61154;27330;8.0;3.6
68;2021-03-13;3342;257;64496;27587;8.5;3.6
68;2021-03-14;1541;65;66037;27652;8.7;3.6
68;2021-03-15;1796;607;67833;28259;8.9;3.7
68;2021-03-16;1998;590;69831;28849;9.1;3.8
68;2021-03-17;1957;719;71788;29568;9.4;3.9
68;2021-03-18;2220;934;74008;30502;9.7;4.0
68;2021-03-19;3084;720;77092;31222;10.1;4.1
68;2021-03-20;973;122;78065;31344;10.2;4.1
68;2021-03-21;68;2;78133;31346;10.2;4.1
68;2021-03-22;1964;588;80097;31934;10.5;4.2
68;2021-03-23;2860;614;82957;32548;10.9;4.3
68;2021-03-24;3177;807;86134;33355;11.3;4.4
68;2021-03-25;3502;781;89636;34136;11.7;4.5
68;2021-03-26;3894;723;93530;34859;12.3;4.6
68;2021-03-27;1102;168;94632;35027;12.4;4.6
68;2021-03-28;56;3;94688;35030;12.4;4.6
68;2021-03-29;2260;1354;96948;36384;12.7;4.8
68;2021-03-30;2933;1289;99881;37673;13.1;4.9
68;2021-03-31;2643;1348;102524;39021;13.4;5.1
68;2021-04-01;2748;1540;105272;40561;13.8;5.3
68;2021-04-02;244;88;105516;40649;13.8;5.3
68;2021-04-03;241;123;105757;40772;13.9;5.3
68;2021-04-04;5;0;105762;40772;13.9;5.3
68;2021-04-05;49;3;105811;40775;13.9;5.3
68;2021-04-06;1793;1321;107604;42096;14.1;5.5
68;2021-04-07;2585;1535;110189;43631;14.4;5.7
68;2021-04-08;3234;1503;113423;45134;14.9;5.9
68;2021-04-09;4200;1527;117623;46661;15.4;6.1
68;2021-04-10;1204;1968;118827;48629;15.6;6.4
68;2021-04-11;126;1317;118953;49946;15.6;6.5
68;2021-04-12;2665;1631;121618;51577;15.9;6.8
68;2021-04-13;2760;2108;124378;53685;16.3;7.0
68;2021-04-14;3606;2266;127984;55951;16.8;7.3
68;2021-04-15;4055;2160;132039;58111;17.3;7.6
68;2021-04-16;3942;2080;135981;60191;17.8;7.9
68;2021-04-17;1075;440;137056;60631;18.0;7.9
68;2021-04-18;85;9;137141;60640;18.0;7.9
68;2021-04-19;2358;1829;139499;62469;18.3;8.2
68;2021-04-20;2442;2323;141941;64792;18.6;8.5
68;2021-04-21;2830;2473;144771;67265;19.0;8.8
68;2021-04-22;3287;1973;148058;69238;19.4;9.1
68;2021-04-23;3412;2072;151470;71310;19.8;9.3
68;2021-04-24;842;487;152312;71797;20.0;9.4
68;2021-04-25;214;20;152526;71817;20.0;9.4
68;2021-04-26;2329;2104;154855;73921;20.3;9.7
68;2021-04-27;2599;2212;157454;76133;20.6;10.0
68;2021-04-28;3571;1760;161025;77893;21.1;10.2
68;2021-04-29;4164;1747;165189;79640;21.6;10.4
68;2021-04-30;4834;1368;170023;81008;22.3;10.6
68;2021-05-01;948;119;170971;81127;22.4;10.6
68;2021-05-02;732;69;171703;81196;22.5;10.6
68;2021-05-03;3620;1819;175323;83015;23.0;10.9
68;2021-05-04;3937;2357;179260;85372;23.5;11.2
68;2021-05-05;3632;3240;182892;88612;24.0;11.6
68;2021-05-06;4804;2858;187696;91470;24.6;12.0
68;2021-05-07;4518;2900;192214;94370;25.2;12.4
68;2021-05-08;1672;210;193886;94580;25.4;12.4
68;2021-05-09;1075;107;194961;94687;25.5;12.4
68;2021-05-10;3159;3719;198120;98406;26.0;12.9
68;2021-05-11;4715;3614;202835;102020;26.6;13.4
68;2021-05-12;5785;3292;208620;105312;27.3;13.8
68;2021-05-13;4766;840;213386;106152;28.0;13.9
68;2021-05-14;5959;2131;219345;108283;28.7;14.2
68;2021-05-15;3558;909;222903;109192;29.2;14.3
68;2021-05-16;670;118;223573;109310;29.3;14.3
68;2021-05-17;4449;2498;228022;111808;29.9;14.6
68;2021-05-18;6139;2306;234161;114114;30.7;15.0
68;2021-05-19;5867;2882;240028;116996;31.5;15.3
68;2021-05-20;5928;2410;245956;119406;32.2;15.6
68;2021-05-21;5774;2866;251730;122272;33.0;16.0
68;2021-05-22;2576;925;254306;123197;33.3;16.1
68;2021-05-23;15;16;254321;123213;33.3;16.1
68;2021-05-24;2303;970;256624;124183;33.6;16.3
68;2021-05-25;4343;3435;260967;127618;34.2;16.7
68;2021-05-26;4883;3383;265850;131001;34.8;17.2
68;2021-05-27;5400;3401;271250;134402;35.5;17.6
68;2021-05-28;5623;3717;276873;138119;36.3;18.1
68;2021-05-29;1540;1185;278413;139304;36.5;18.3
68;2021-05-30;41;46;278454;139350;36.5;18.3
68;2021-05-31;5158;2363;283612;141713;37.2;18.6
68;2021-06-01;5989;2792;289601;144505;37.9;18.9
68;2021-06-02;4886;3006;294487;147511;38.6;19.3
68;2021-06-03;5938;3096;300425;150607;39.4;19.7
68;2021-06-04;4896;3298;305321;153905;40.0;20.2
68;2021-06-05;781;1168;306102;155073;40.1;20.3
68;2021-06-06;69;114;306171;155187;40.1;20.3
68;2021-06-07;4754;3035;310925;158222;40.7;20.7
68;2021-06-08;4934;3554;315859;161776;41.4;21.2
68;2021-06-09;4994;3446;320853;165222;42.0;21.6
68;2021-06-10;5200;3144;326053;168366;42.7;22.1
68;2021-06-11;5055;4144;331108;172510;43.4;22.6
68;2021-06-12;3036;1770;334144;174280;43.8;22.8
68;2021-06-13;514;682;334658;174962;43.8;22.9
68;2021-06-14;2516;4391;337174;179353;44.2;23.5
68;2021-06-15;3112;4718;340286;184071;44.6;24.1
68;2021-06-16;3387;4441;343673;188512;45.0;24.7
68;2021-06-17;2358;4453;346031;192965;45.3;25.3
68;2021-06-18;3358;5171;349389;198136;45.8;26.0
68;2021-06-19;2253;2170;351642;200306;46.1;26.2
68;2021-06-20;258;891;351900;201197;46.1;26.4
68;2021-06-21;2059;5149;353959;206346;46.4;27.0
68;2021-06-22;1900;5174;355859;211520;46.6;27.7
68;2021-06-23;2318;5740;358177;217260;46.9;28.5
68;2021-06-24;2153;4897;360330;222157;47.2;29.1
68;2021-06-25;2287;6656;362617;228813;47.5;30.0
68;2021-06-26;1303;2609;363920;231422;47.7;30.3
68;2021-06-27;151;880;364071;232302;47.7;30.4
68;2021-06-28;1601;6444;365672;238746;47.9;31.3
68;2021-06-29;1539;6631;367211;245377;48.1;32.2
68;2021-06-30;1797;6554;369008;251931;48.3;33.0
68;2021-07-01;2105;5350;371113;257281;48.6;33.7
68;2021-07-02;2098;6482;373211;263763;48.9;34.6
68;2021-07-03;989;1934;374200;265697;49.0;34.8
68;2021-07-04;242;200;374442;265897;49.1;34.8
68;2021-07-05;1456;5513;375898;271410;49.3;35.6
68;2021-07-06;2001;5883;377899;277293;49.5;36.3
68;2021-07-07;2455;4974;380354;282267;49.8;37.0
68;2021-07-08;2434;4746;382788;287013;50.2;37.6
68;2021-07-09;2092;7364;384880;294377;50.4;38.6
68;2021-07-10;1028;2002;385908;296379;50.6;38.8
68;2021-07-11;147;156;386055;296535;50.6;38.9
68;2021-07-12;1646;6771;387701;303306;50.8;39.7
68;2021-07-13;2909;6548;390610;309854;51.2;40.6
68;2021-07-14;1840;983;392450;310837;51.4;40.7
68;2021-07-15;3188;6651;395638;317488;51.8;41.6
68;2021-07-16;3817;6761;399455;324249;52.3;42.5
68;2021-07-17;3360;2301;402815;326550;52.8;42.8
68;2021-07-18;1054;230;403869;326780;52.9;42.8
68;2021-07-19;3050;6079;406919;332859;53.3;43.6
68;2021-07-20;4001;5665;410920;338524;53.8;44.4
68;2021-07-21;4339;5831;415259;344355;54.4;45.1
68;2021-07-22;4187;4846;419446;349201;55.0;45.8
68;2021-07-23;5041;5759;424487;354960;55.6;46.5
68;2021-07-24;3349;2131;427836;357091;56.1;46.8
68;2021-07-25;825;537;428661;357628;56.2;46.9
68;2021-07-26;4835;4449;433496;362077;56.8;47.4
68;2021-07-27;6364;3752;439860;365829;57.6;47.9
68;2021-07-28;6848;3881;446708;369710;58.5;48.4
68;2021-07-29;6398;3426;453106;373136;59.4;48.9
68;2021-07-30;6343;4376;459449;377512;60.2;49.5
68;2021-07-31;3917;1426;463366;378938;60.7;49.7
68;2021-08-01;1651;494;465017;379432;60.9;49.7
68;2021-08-02;4605;3149;469622;382581;61.5;50.1
68;2021-08-03;3549;2447;473171;385028;62.0;50.4
68;2021-08-04;3135;2689;476306;387717;62.4;50.8
68;2021-08-05;2753;2639;479059;390356;62.8;51.1
68;2021-08-06;3996;4327;483055;394683;63.3;51.7
68;2021-08-07;1227;1305;484282;395988;63.5;51.9
68;2021-08-08;364;813;484646;396801;63.5;52.0
68;2021-08-09;2574;3683;487220;400484;63.8;52.5
68;2021-08-10;2215;2783;489435;403267;64.1;52.8
68;2021-08-11;1896;2728;491331;405995;64.4;53.2
68;2021-08-12;1751;2667;493082;408662;64.6;53.5
68;2021-08-13;2715;4757;495797;413419;65.0;54.2
68;2021-08-14;714;1441;496511;414860;65.1;54.4
68;2021-08-15;45;445;496556;415305;65.1;54.4
68;2021-08-16;2002;5062;498558;420367;65.3;55.1
68;2021-08-17;1802;4848;500360;425215;65.6;55.7
68;2021-08-18;1182;3697;501542;428912;65.7;56.2
68;2021-08-19;1367;3741;502909;432653;65.9;56.7
68;2021-08-20;2228;6065;505137;438718;66.2;57.5
68;2021-08-21;492;1382;505629;440100;66.3;57.7
68;2021-08-22;116;457;505745;440557;66.3;57.7
68;2021-08-23;1186;5425;506931;445982;66.4;58.4
68;2021-08-24;1405;5953;508336;451935;66.6;59.2
68;2021-08-25;1659;3752;509995;455687;66.8;59.7
68;2021-08-26;1988;4505;511983;460192;67.1;60.3
68;2021-08-27;1848;6281;513831;466473;67.3;61.1
68;2021-08-28;422;1070;514253;467543;67.4;61.3
68;2021-08-29;36;418;514289;467961;67.4;61.3
68;2021-08-30;1346;4554;515635;472515;67.6;61.9
68;2021-08-31;1303;4239;516938;476754;67.7;62.5
68;2021-09-01;881;2280;517819;479034;67.8;62.8
68;2021-09-02;877;1982;518696;481016;68.0;63.0
68;2021-09-03;1303;4620;519999;485636;68.1;63.6
68;2021-09-04;493;955;520492;486591;68.2;63.8
68;2021-09-05;209;176;520701;486767;68.2;63.8
68;2021-09-06;691;2386;521392;489153;68.3;64.1
68;2021-09-07;606;1451;521998;490604;68.4;64.3
68;2021-09-08;617;1487;522615;492091;68.5;64.5
68;2021-09-09;899;1571;523514;493662;68.6;64.7
68;2021-09-10;1478;3344;524992;497006;68.8;65.1
68;2021-09-11;469;675;525461;497681;68.8;65.2
68;2021-09-12;73;63;525534;497744;68.9;65.2
68;2021-09-13;810;1389;526344;499133;69.0;65.4
68;2021-09-14;972;1726;527316;500859;69.1;65.6
68;2021-09-15;692;1582;528008;502441;69.2;65.8
68;2021-09-16;630;1074;528638;503515;69.3;66.0
68;2021-09-17;981;2328;529619;505843;69.4;66.3
68;2021-09-18;435;762;530054;506605;69.5;66.4
68;2021-09-19;16;48;530070;506653;69.5;66.4
68;2021-09-20;546;966;530616;507619;69.5;66.5
68;2021-09-21;582;1324;531198;508943;69.6;66.7
68;2021-09-22;632;1154;531830;510097;69.7;66.8
68;2021-09-23;365;679;532195;510776;69.7;66.9
68;2021-09-24;642;1604;532837;512380;69.8;67.1
68;2021-09-25;276;667;533113;513047;69.9;67.2
68;2021-09-26;19;56;533132;513103;69.9;67.2
68;2021-09-27;338;686;533470;513789;69.9;67.3
68;2021-09-28;322;542;533792;514331;69.9;67.4
68;2021-09-29;533;874;534325;515205;70.0;67.5
69;2020-12-27;5;0;5;0;0.0;0.0
69;2020-12-28;13;0;18;0;0.0;0.0
69;2020-12-29;5;0;23;0;0.0;0.0
69;2020-12-30;6;0;29;0;0.0;0.0
69;2020-12-31;12;0;41;0;0.0;0.0
69;2021-01-01;2;0;43;0;0.0;0.0
69;2021-01-02;2;0;45;0;0.0;0.0
69;2021-01-03;3;0;48;0;0.0;0.0
69;2021-01-04;13;0;61;0;0.0;0.0
69;2021-01-05;218;0;279;0;0.0;0.0
69;2021-01-06;518;0;797;0;0.0;0.0
69;2021-01-07;813;0;1610;0;0.1;0.0
69;2021-01-08;828;1;2438;1;0.1;0.0
69;2021-01-09;41;1;2479;2;0.1;0.0
69;2021-01-10;3;1;2482;3;0.1;0.0
69;2021-01-11;1135;2;3617;5;0.2;0.0
69;2021-01-12;1398;8;5015;13;0.3;0.0
69;2021-01-13;1395;3;6410;16;0.3;0.0
69;2021-01-14;2285;17;8695;33;0.5;0.0
69;2021-01-15;1829;8;10524;41;0.6;0.0
69;2021-01-16;930;3;11454;44;0.6;0.0
69;2021-01-17;260;2;11714;46;0.6;0.0
69;2021-01-18;1695;18;13409;64;0.7;0.0
69;2021-01-19;3511;36;16920;100;0.9;0.0
69;2021-01-20;4456;29;21376;129;1.1;0.0
69;2021-01-21;4078;26;25454;155;1.4;0.0
69;2021-01-22;3183;19;28637;174;1.5;0.0
69;2021-01-23;1287;5;29924;179;1.6;0.0
69;2021-01-24;102;1;30026;180;1.6;0.0
69;2021-01-25;2245;36;32271;216;1.7;0.0
69;2021-01-26;2562;88;34833;304;1.9;0.0
69;2021-01-27;2358;169;37191;473;2.0;0.0
69;2021-01-28;2238;351;39429;824;2.1;0.0
69;2021-01-29;2111;273;41540;1097;2.2;0.1
69;2021-01-30;889;3;42429;1100;2.3;0.1
69;2021-01-31;65;0;42494;1100;2.3;0.1
69;2021-02-01;1112;383;43606;1483;2.3;0.1
69;2021-02-02;1559;382;45165;1865;2.4;0.1
69;2021-02-03;1443;518;46608;2383;2.5;0.1
69;2021-02-04;1794;898;48402;3281;2.6;0.2
69;2021-02-05;821;797;49223;4078;2.6;0.2
69;2021-02-06;370;41;49593;4119;2.6;0.2
69;2021-02-07;0;0;49593;4119;2.6;0.2
69;2021-02-08;1133;938;50726;5057;2.7;0.3
69;2021-02-09;2051;1795;52777;6852;2.8;0.4
69;2021-02-10;1855;2407;54632;9259;2.9;0.5
69;2021-02-11;1860;2960;56492;12219;3.0;0.7
69;2021-02-12;1907;1797;58399;14016;3.1;0.7
69;2021-02-13;459;564;58858;14580;3.1;0.8
69;2021-02-14;89;32;58947;14612;3.1;0.8
69;2021-02-15;1016;1407;59963;16019;3.2;0.9
69;2021-02-16;984;1860;60947;17879;3.2;1.0
69;2021-02-17;1027;1895;61974;19774;3.3;1.1
69;2021-02-18;968;1834;62942;21608;3.4;1.2
69;2021-02-19;890;1485;63832;23093;3.4;1.2
69;2021-02-20;321;672;64153;23765;3.4;1.3
69;2021-02-21;53;53;64206;23818;3.4;1.3
69;2021-02-22;609;1696;64815;25514;3.5;1.4
69;2021-02-23;740;1834;65555;27348;3.5;1.5
69;2021-02-24;973;1857;66528;29205;3.5;1.6
69;2021-02-25;2214;2313;68742;31518;3.7;1.7
69;2021-02-26;2772;1652;71514;33170;3.8;1.8
69;2021-02-27;925;496;72439;33666;3.9;1.8
69;2021-02-28;148;98;72587;33764;3.9;1.8
69;2021-03-01;2166;748;74753;34512;4.0;1.8
69;2021-03-02;3298;1184;78051;35696;4.2;1.9
69;2021-03-03;3669;1133;81720;36829;4.4;2.0
69;2021-03-04;4886;1211;86606;38040;4.6;2.0
69;2021-03-05;5875;1117;92481;39157;4.9;2.1
69;2021-03-06;3418;368;95899;39525;5.1;2.1
69;2021-03-07;640;44;96539;39569;5.1;2.1
69;2021-03-08;2960;991;99499;40560;5.3;2.2
69;2021-03-09;4607;1108;104106;41668;5.5;2.2
69;2021-03-10;5072;966;109178;42634;5.8;2.3
69;2021-03-11;6601;980;115779;43614;6.2;2.3
69;2021-03-12;8856;1112;124635;44726;6.6;2.4
69;2021-03-13;4928;242;129563;44968;6.9;2.4
69;2021-03-14;2741;150;132304;45118;7.1;2.4
69;2021-03-15;4804;672;137108;45790;7.3;2.4
69;2021-03-16;3819;656;140927;46446;7.5;2.5
69;2021-03-17;3953;866;144880;47312;7.7;2.5
69;2021-03-18;4967;1535;149847;48847;8.0;2.6
69;2021-03-19;6685;971;156532;49818;8.3;2.7
69;2021-03-20;3593;277;160125;50095;8.5;2.7
69;2021-03-21;1975;101;162100;50196;8.6;2.7
69;2021-03-22;4549;742;166649;50938;8.9;2.7
69;2021-03-23;7364;805;174013;51743;9.3;2.8
69;2021-03-24;6456;994;180469;52737;9.6;2.8
69;2021-03-25;8591;1122;189060;53859;10.1;2.9
69;2021-03-26;8814;1246;197874;55105;10.5;2.9
69;2021-03-27;3157;789;201031;55894;10.7;3.0
69;2021-03-28;2218;186;203249;56080;10.8;3.0
69;2021-03-29;4098;2167;207347;58247;11.1;3.1
69;2021-03-30;7642;2531;214989;60778;11.5;3.2
69;2021-03-31;6356;3100;221345;63878;11.8;3.4
69;2021-04-01;8462;2721;229807;66599;12.2;3.5
69;2021-04-02;8313;3107;238120;69706;12.7;3.7
69;2021-04-03;5424;2114;243544;71820;13.0;3.8
69;2021-04-04;6610;543;250154;72363;13.3;3.9
69;2021-04-05;6190;816;256344;73179;13.7;3.9
69;2021-04-06;5114;3466;261458;76645;13.9;4.1
69;2021-04-07;5167;3865;266625;80510;14.2;4.3
69;2021-04-08;6429;3997;273054;84507;14.6;4.5
69;2021-04-09;9164;3735;282218;88242;15.0;4.7
69;2021-04-10;3053;2492;285271;90734;15.2;4.8
69;2021-04-11;2036;1895;287307;92629;15.3;4.9
69;2021-04-12;5474;3556;292781;96185;15.6;5.1
69;2021-04-13;7068;4113;299849;100298;16.0;5.3
69;2021-04-14;6718;4157;306567;104455;16.3;5.6
69;2021-04-15;7942;4594;314509;109049;16.8;5.8
69;2021-04-16;7869;4488;322378;113537;17.2;6.1
69;2021-04-17;5036;2311;327414;115848;17.5;6.2
69;2021-04-18;1715;1790;329129;117638;17.5;6.3
69;2021-04-19;7020;3774;336149;121412;17.9;6.5
69;2021-04-20;6484;4760;342633;126172;18.3;6.7
69;2021-04-21;5688;4415;348321;130587;18.6;7.0
69;2021-04-22;6428;5437;354749;136024;18.9;7.3
69;2021-04-23;6735;4900;361484;140924;19.3;7.5
69;2021-04-24;3160;2030;364644;142954;19.4;7.6
69;2021-04-25;2120;1544;366764;144498;19.5;7.7
69;2021-04-26;4495;3869;371259;148367;19.8;7.9
69;2021-04-27;6516;5305;377775;153672;20.1;8.2
69;2021-04-28;6273;4859;384048;158531;20.5;8.5
69;2021-04-29;6707;5362;390755;163893;20.8;8.7
69;2021-04-30;6930;6141;397685;170034;21.2;9.1
69;2021-05-01;3301;644;400986;170678;21.4;9.1
69;2021-05-02;1628;5880;402614;176558;21.5;9.4
69;2021-05-03;5859;8240;408473;184798;21.8;9.9
69;2021-05-04;7609;8152;416082;192950;22.2;10.3
69;2021-05-05;11210;5657;427292;198607;22.8;10.6
69;2021-05-06;12470;6297;439762;204904;23.4;10.9
69;2021-05-07;11685;7134;451447;212038;24.1;11.3
69;2021-05-08;4303;1651;455750;213689;24.3;11.4
69;2021-05-09;6635;2679;462385;216368;24.6;11.5
69;2021-05-10;6935;6065;469320;222433;25.0;11.9
69;2021-05-11;9830;7031;479150;229464;25.5;12.2
69;2021-05-12;12451;6783;491601;236247;26.2;12.6
69;2021-05-13;10839;2561;502440;238808;26.8;12.7
69;2021-05-14;12598;5207;515038;244015;27.5;13.0
69;2021-05-15;9136;2592;524174;246607;27.9;13.1
69;2021-05-16;8403;1876;532577;248483;28.4;13.2
69;2021-05-17;11306;5648;543883;254131;29.0;13.5
69;2021-05-18;13226;6397;557109;260528;29.7;13.9
69;2021-05-19;13696;5890;570805;266418;30.4;14.2
69;2021-05-20;11387;6076;582192;272494;31.0;14.5
69;2021-05-21;11036;6547;593228;279041;31.6;14.9
69;2021-05-22;5574;2575;598802;281616;31.9;15.0
69;2021-05-23;4573;1545;603375;283161;32.2;15.1
69;2021-05-24;8420;1863;611795;285024;32.6;15.2
69;2021-05-25;9742;6174;621537;291198;33.1;15.5
69;2021-05-26;10282;6105;631819;297303;33.7;15.8
69;2021-05-27;10429;6780;642248;304083;34.2;16.2
69;2021-05-28;11611;8735;653859;312818;34.9;16.7
69;2021-05-29;7387;6045;661246;318863;35.2;17.0
69;2021-05-30;7386;3170;668632;322033;35.6;17.2
69;2021-05-31;10957;6374;679589;328407;36.2;17.5
69;2021-06-01;12842;7499;692431;335906;36.9;17.9
69;2021-06-02;14885;6722;707316;342628;37.7;18.3
69;2021-06-03;16641;7422;723957;350050;38.6;18.7
69;2021-06-04;16199;8548;740156;358598;39.5;19.1
69;2021-06-05;10107;3416;750263;362014;40.0;19.3
69;2021-06-06;7488;1719;757751;363733;40.4;19.4
69;2021-06-07;12817;7019;770568;370752;41.1;19.8
69;2021-06-08;16309;8276;786877;379028;41.9;20.2
69;2021-06-09;15212;7350;802089;386378;42.8;20.6
69;2021-06-10;16274;7327;818363;393705;43.6;21.0
69;2021-06-11;16635;9675;834998;403380;44.5;21.5
69;2021-06-12;8529;4189;843527;407569;45.0;21.7
69;2021-06-13;5620;2146;849147;409715;45.3;21.8
69;2021-06-14;8573;9081;857720;418796;45.7;22.3
69;2021-06-15;10933;11014;868653;429810;46.3;22.9
69;2021-06-16;11331;12316;879984;442126;46.9;23.6
69;2021-06-17;11455;13255;891439;455381;47.5;24.3
69;2021-06-18;12044;14769;903483;470150;48.2;25.1
69;2021-06-19;6813;8354;910296;478504;48.5;25.5
69;2021-06-20;5274;4769;915570;483273;48.8;25.8
69;2021-06-21;6536;12118;922106;495391;49.2;26.4
69;2021-06-22;7210;13825;929316;509216;49.5;27.1
69;2021-06-23;8350;13026;937666;522242;50.0;27.8
69;2021-06-24;9294;13741;946960;535983;50.5;28.6
69;2021-06-25;7077;16304;954037;552287;50.9;29.4
69;2021-06-26;3871;9070;957908;561357;51.1;29.9
69;2021-06-27;3291;7419;961199;568776;51.2;30.3
69;2021-06-28;4549;14891;965748;583667;51.5;31.1
69;2021-06-29;5369;15665;971117;599332;51.8;31.9
69;2021-06-30;6387;14447;977504;613779;52.1;32.7
69;2021-07-01;9003;11979;986507;625758;52.6;33.4
69;2021-07-02;10682;14127;997189;639885;53.2;34.1
69;2021-07-03;5993;7770;1003182;647655;53.5;34.5
69;2021-07-04;4126;5549;1007308;653204;53.7;34.8
69;2021-07-05;6229;13019;1013537;666223;54.0;35.5
69;2021-07-06;5913;14276;1019450;680499;54.3;36.3
69;2021-07-07;7317;13560;1026767;694059;54.7;37.0
69;2021-07-08;7585;13409;1034352;707468;55.1;37.7
69;2021-07-09;7583;16470;1041935;723938;55.5;38.6
69;2021-07-10;3124;10312;1045059;734250;55.7;39.1
69;2021-07-11;4331;5830;1049390;740080;55.9;39.4
69;2021-07-12;4213;16969;1053603;757049;56.2;40.4
69;2021-07-13;6451;20715;1060054;777764;56.5;41.5
69;2021-07-14;5056;8482;1065110;786246;56.8;41.9
69;2021-07-15;7494;22575;1072604;808821;57.2;43.1
69;2021-07-16;9933;20108;1082537;828929;57.7;44.2
69;2021-07-17;4881;12238;1087418;841167;58.0;44.8
69;2021-07-18;3411;8894;1090829;850061;58.1;45.3
69;2021-07-19;7068;16456;1097897;866517;58.5;46.2
69;2021-07-20;9577;19304;1107474;885821;59.0;47.2
69;2021-07-21;9386;17419;1116860;903240;59.5;48.1
69;2021-07-22;11469;16392;1128329;919632;60.1;49.0
69;2021-07-23;11137;17685;1139466;937317;60.7;50.0
69;2021-07-24;5704;11048;1145170;948365;61.0;50.6
69;2021-07-25;4706;6631;1149876;954996;61.3;50.9
69;2021-07-26;8927;12949;1158803;967945;61.8;51.6
69;2021-07-27;12938;12093;1171741;980038;62.5;52.2
69;2021-07-28;12090;12155;1183831;992193;63.1;52.9
69;2021-07-29;14760;12264;1198591;1004457;63.9;53.5
69;2021-07-30;14366;12240;1212957;1016697;64.7;54.2
69;2021-07-31;8270;7253;1221227;1023950;65.1;54.6
69;2021-08-01;5183;5877;1226410;1029827;65.4;54.9
69;2021-08-02;13205;9637;1239615;1039464;66.1;55.4
69;2021-08-03;13281;8983;1252896;1048447;66.8;55.9
69;2021-08-04;14280;8136;1267176;1056583;67.5;56.3
69;2021-08-05;11518;7539;1278694;1064122;68.2;56.7
69;2021-08-06;10586;7797;1289280;1071919;68.7;57.1
69;2021-08-07;5002;4811;1294282;1076730;69.0;57.4
69;2021-08-08;4368;3564;1298650;1080294;69.2;57.6
69;2021-08-09;7770;9219;1306420;1089513;69.6;58.1
69;2021-08-10;8073;7035;1314493;1096548;70.1;58.4
69;2021-08-11;7892;8114;1322385;1104662;70.5;58.9
69;2021-08-12;7293;7331;1329678;1111993;70.9;59.3
69;2021-08-13;6727;8359;1336405;1120352;71.2;59.7
69;2021-08-14;4511;5211;1340916;1125563;71.5;60.0
69;2021-08-15;2489;2522;1343405;1128085;71.6;60.1
69;2021-08-16;5925;8883;1349330;1136968;71.9;60.6
69;2021-08-17;6411;8273;1355741;1145241;72.3;61.0
69;2021-08-18;6237;9473;1361978;1154714;72.6;61.6
69;2021-08-19;6326;9333;1368304;1164047;72.9;62.0
69;2021-08-20;6069;8841;1374373;1172888;73.3;62.5
69;2021-08-21;2856;3954;1377229;1176842;73.4;62.7
69;2021-08-22;1954;2420;1379183;1179262;73.5;62.9
69;2021-08-23;3917;12384;1383100;1191646;73.7;63.5
69;2021-08-24;5178;13640;1388278;1205286;74.0;64.2
69;2021-08-25;4534;12907;1392812;1218193;74.2;64.9
69;2021-08-26;4541;11734;1397353;1229927;74.5;65.6
69;2021-08-27;4291;14451;1401644;1244378;74.7;66.3
69;2021-08-28;1956;8632;1403600;1253010;74.8;66.8
69;2021-08-29;1317;6527;1404917;1259537;74.9;67.1
69;2021-08-30;3185;11816;1408102;1271353;75.1;67.8
69;2021-08-31;4164;10193;1412266;1281546;75.3;68.3
69;2021-09-01;3711;9789;1415977;1291335;75.5;68.8
69;2021-09-02;4182;9242;1420159;1300577;75.7;69.3
69;2021-09-03;3909;11253;1424068;1311830;75.9;69.9
69;2021-09-04;2204;8714;1426272;1320544;76.0;70.4
69;2021-09-05;1417;3853;1427689;1324397;76.1;70.6
69;2021-09-06;2205;6913;1429894;1331310;76.2;71.0
69;2021-09-07;2305;6978;1432199;1338288;76.3;71.3
69;2021-09-08;2638;7504;1434837;1345792;76.5;71.7
69;2021-09-09;2347;6763;1437184;1352555;76.6;72.1
69;2021-09-10;2552;7620;1439736;1360175;76.7;72.5
69;2021-09-11;1610;5277;1441346;1365452;76.8;72.8
69;2021-09-12;507;2338;1441853;1367790;76.9;72.9
69;2021-09-13;1608;5469;1443461;1373259;76.9;73.2
69;2021-09-14;1791;5515;1445252;1378774;77.0;73.5
69;2021-09-15;1834;5048;1447086;1383822;77.1;73.8
69;2021-09-16;1506;3479;1448592;1387301;77.2;73.9
69;2021-09-17;1765;4881;1450357;1392182;77.3;74.2
69;2021-09-18;1094;4088;1451451;1396270;77.4;74.4
69;2021-09-19;477;1523;1451928;1397793;77.4;74.5
69;2021-09-20;927;2976;1452855;1400769;77.4;74.7
69;2021-09-21;975;3515;1453830;1404284;77.5;74.9
69;2021-09-22;1132;4062;1454962;1408346;77.6;75.1
69;2021-09-23;893;3059;1455855;1411405;77.6;75.2
69;2021-09-24;1234;4177;1457089;1415582;77.7;75.5
69;2021-09-25;707;2722;1457796;1418304;77.7;75.6
69;2021-09-26;291;1211;1458087;1419515;77.7;75.7
69;2021-09-27;653;2029;1458740;1421544;77.8;75.8
69;2021-09-28;909;2094;1459649;1423638;77.8;75.9
69;2021-09-29;1128;3283;1460777;1426921;77.9;76.1
70;2020-12-27;0;0;0;0;0.0;0.0
70;2020-12-28;0;0;0;0;0.0;0.0
70;2020-12-29;0;0;0;0;0.0;0.0
70;2020-12-30;0;0;0;0;0.0;0.0
70;2020-12-31;0;0;0;0;0.0;0.0
70;2021-01-01;0;0;0;0;0.0;0.0
70;2021-01-02;0;0;0;0;0.0;0.0
70;2021-01-03;0;0;0;0;0.0;0.0
70;2021-01-04;0;0;0;0;0.0;0.0
70;2021-01-05;1;0;1;0;0.0;0.0
70;2021-01-06;24;0;25;0;0.0;0.0
70;2021-01-07;121;0;146;0;0.1;0.0
70;2021-01-08;22;0;168;0;0.1;0.0
70;2021-01-09;0;0;168;0;0.1;0.0
70;2021-01-10;0;0;168;0;0.1;0.0
70;2021-01-11;148;1;316;1;0.1;0.0
70;2021-01-12;201;1;517;2;0.2;0.0
70;2021-01-13;172;2;689;4;0.3;0.0
70;2021-01-14;148;5;837;9;0.4;0.0
70;2021-01-15;153;1;990;10;0.4;0.0
70;2021-01-16;65;0;1055;10;0.5;0.0
70;2021-01-17;0;0;1055;10;0.5;0.0
70;2021-01-18;398;0;1453;10;0.6;0.0
70;2021-01-19;503;2;1956;12;0.8;0.0
70;2021-01-20;494;2;2450;14;1.1;0.0
70;2021-01-21;675;2;3125;16;1.3;0.0
70;2021-01-22;458;2;3583;18;1.5;0.0
70;2021-01-23;261;2;3844;20;1.6;0.0
70;2021-01-24;4;0;3848;20;1.7;0.0
70;2021-01-25;369;1;4217;21;1.8;0.0
70;2021-01-26;335;1;4552;22;2.0;0.0
70;2021-01-27;331;10;4883;32;2.1;0.0
70;2021-01-28;366;35;5249;67;2.3;0.0
70;2021-01-29;329;52;5578;119;2.4;0.1
70;2021-01-30;228;0;5806;119;2.5;0.1
70;2021-01-31;0;0;5806;119;2.5;0.1
70;2021-02-01;261;32;6067;151;2.6;0.1
70;2021-02-02;272;92;6339;243;2.7;0.1
70;2021-02-03;251;54;6590;297;2.8;0.1
70;2021-02-04;265;120;6855;417;2.9;0.2
70;2021-02-05;254;72;7109;489;3.0;0.2
70;2021-02-06;209;37;7318;526;3.1;0.2
70;2021-02-07;0;0;7318;526;3.1;0.2
70;2021-02-08;179;150;7497;676;3.2;0.3
70;2021-02-09;206;140;7703;816;3.3;0.3
70;2021-02-10;196;216;7899;1032;3.4;0.4
70;2021-02-11;351;270;8250;1302;3.5;0.6
70;2021-02-12;239;406;8489;1708;3.6;0.7
70;2021-02-13;75;145;8564;1853;3.7;0.8
70;2021-02-14;0;29;8564;1882;3.7;0.8
70;2021-02-15;70;271;8634;2153;3.7;0.9
70;2021-02-16;113;279;8747;2432;3.8;1.0
70;2021-02-17;164;272;8911;2704;3.8;1.2
70;2021-02-18;205;225;9116;2929;3.9;1.3
70;2021-02-19;197;180;9313;3109;4.0;1.3
70;2021-02-20;192;56;9505;3165;4.1;1.4
70;2021-02-21;1;0;9506;3165;4.1;1.4
70;2021-02-22;106;181;9612;3346;4.1;1.4
70;2021-02-23;125;206;9737;3552;4.2;1.5
70;2021-02-24;132;178;9869;3730;4.2;1.6
70;2021-02-25;315;199;10184;3929;4.4;1.7
70;2021-02-26;395;122;10579;4051;4.5;1.7
70;2021-02-27;147;146;10726;4197;4.6;1.8
70;2021-02-28;0;0;10726;4197;4.6;1.8
70;2021-03-01;249;206;10975;4403;4.7;1.9
70;2021-03-02;487;232;11462;4635;4.9;2.0
70;2021-03-03;468;219;11930;4854;5.1;2.1
70;2021-03-04;693;236;12623;5090;5.4;2.2
70;2021-03-05;767;225;13390;5315;5.7;2.3
70;2021-03-06;539;99;13929;5414;6.0;2.3
70;2021-03-07;216;23;14145;5437;6.1;2.3
70;2021-03-08;554;194;14699;5631;6.3;2.4
70;2021-03-09;864;165;15563;5796;6.7;2.5
70;2021-03-10;659;171;16222;5967;7.0;2.6
70;2021-03-11;698;244;16920;6211;7.3;2.7
70;2021-03-12;985;173;17905;6384;7.7;2.7
70;2021-03-13;583;117;18488;6501;7.9;2.8
70;2021-03-14;20;1;18508;6502;7.9;2.8
70;2021-03-15;774;104;19282;6606;8.3;2.8
70;2021-03-16;655;97;19937;6703;8.5;2.9
70;2021-03-17;595;179;20532;6882;8.8;3.0
70;2021-03-18;633;138;21165;7020;9.1;3.0
70;2021-03-19;1019;139;22184;7159;9.5;3.1
70;2021-03-20;641;186;22825;7345;9.8;3.1
70;2021-03-21;9;0;22834;7345;9.8;3.1
70;2021-03-22;757;97;23591;7442;10.1;3.2
70;2021-03-23;1310;154;24901;7596;10.7;3.3
70;2021-03-24;1270;106;26171;7702;11.2;3.3
70;2021-03-25;1247;198;27418;7900;11.8;3.4
70;2021-03-26;1486;299;28904;8199;12.4;3.5
70;2021-03-27;957;128;29861;8327;12.8;3.6
70;2021-03-28;0;10;29861;8337;12.8;3.6
70;2021-03-29;721;413;30582;8750;13.1;3.8
70;2021-03-30;1093;315;31675;9065;13.6;3.9
70;2021-03-31;878;317;32553;9382;14.0;4.0
70;2021-04-01;1153;428;33706;9810;14.5;4.2
70;2021-04-02;1310;345;35016;10155;15.0;4.4
70;2021-04-03;639;320;35655;10475;15.3;4.5
70;2021-04-04;11;0;35666;10475;15.3;4.5
70;2021-04-05;4;2;35670;10477;15.3;4.5
70;2021-04-06;831;555;36501;11032;15.7;4.7
70;2021-04-07;858;588;37359;11620;16.0;5.0
70;2021-04-08;1319;561;38678;12181;16.6;5.2
70;2021-04-09;1402;537;40080;12718;17.2;5.5
70;2021-04-10;859;346;40939;13064;17.6;5.6
70;2021-04-11;23;1;40962;13065;17.6;5.6
70;2021-04-12;696;660;41658;13725;17.9;5.9
70;2021-04-13;921;769;42579;14494;18.3;6.2
70;2021-04-14;816;576;43395;15070;18.6;6.5
70;2021-04-15;1079;604;44474;15674;19.1;6.7
70;2021-04-16;1242;551;45716;16225;19.6;7.0
70;2021-04-17;689;468;46405;16693;19.9;7.2
70;2021-04-18;62;4;46467;16697;19.9;7.2
70;2021-04-19;540;809;47007;17506;20.2;7.5
70;2021-04-20;663;852;47670;18358;20.4;7.9
70;2021-04-21;483;926;48153;19284;20.6;8.3
70;2021-04-22;775;801;48928;20085;21.0;8.6
70;2021-04-23;875;740;49803;20825;21.4;8.9
70;2021-04-24;432;642;50235;21467;21.5;9.2
70;2021-04-25;11;0;50246;21467;21.5;9.2
70;2021-04-26;923;604;51169;22071;21.9;9.5
70;2021-04-27;1208;753;52377;22824;22.5;9.8
70;2021-04-28;889;811;53266;23635;22.8;10.1
70;2021-04-29;1342;927;54608;24562;23.4;10.5
70;2021-04-30;1533;871;56141;25433;24.1;10.9
70;2021-05-01;1694;120;57835;25553;24.8;11.0
70;2021-05-02;2;0;57837;25553;24.8;11.0
70;2021-05-03;1189;580;59026;26133;25.3;11.2
70;2021-05-04;1353;754;60379;26887;25.9;11.5
70;2021-05-05;1188;879;61567;27766;26.4;11.9
70;2021-05-06;1845;1270;63412;29036;27.2;12.5
70;2021-05-07;2127;1239;65539;30275;28.1;13.0
70;2021-05-08;1342;194;66881;30469;28.7;13.1
70;2021-05-09;9;57;66890;30526;28.7;13.1
70;2021-05-10;961;946;67851;31472;29.1;13.5
70;2021-05-11;1240;1076;69091;32548;29.6;14.0
70;2021-05-12;1175;862;70266;33410;30.1;14.3
70;2021-05-13;1544;147;71810;33557;30.8;14.4
70;2021-05-14;2062;754;73872;34311;31.7;14.7
70;2021-05-15;2657;531;76529;34842;32.8;14.9
70;2021-05-16;999;72;77528;34914;33.2;15.0
70;2021-05-17;1237;386;78765;35300;33.8;15.1
70;2021-05-18;1296;591;80061;35891;34.3;15.4
70;2021-05-19;1476;480;81537;36371;35.0;15.6
70;2021-05-20;1779;630;83316;37001;35.7;15.9
70;2021-05-21;1692;817;85008;37818;36.5;16.2
70;2021-05-22;1219;666;86227;38484;37.0;16.5
70;2021-05-23;8;14;86235;38498;37.0;16.5
70;2021-05-24;227;27;86462;38525;37.1;16.5
70;2021-05-25;837;926;87299;39451;37.4;16.9
70;2021-05-26;1048;946;88347;40397;37.9;17.3
70;2021-05-27;1263;996;89610;41393;38.4;17.8
70;2021-05-28;1546;1158;91156;42551;39.1;18.2
70;2021-05-29;1370;587;92526;43138;39.7;18.5
70;2021-05-30;1;8;92527;43146;39.7;18.5
70;2021-05-31;969;679;93496;43825;40.1;18.8
70;2021-06-01;1213;848;94709;44673;40.6;19.2
70;2021-06-02;1265;678;95974;45351;41.2;19.4
70;2021-06-03;1429;837;97403;46188;41.8;19.8
70;2021-06-04;1335;1111;98738;47299;42.3;20.3
70;2021-06-05;1024;663;99762;47962;42.8;20.6
70;2021-06-06;599;79;100361;48041;43.0;20.6
70;2021-06-07;941;848;101302;48889;43.4;21.0
70;2021-06-08;1216;1187;102518;50076;44.0;21.5
70;2021-06-09;1156;988;103674;51064;44.5;21.9
70;2021-06-10;1567;831;105241;51895;45.1;22.3
70;2021-06-11;1585;1957;106826;53852;45.8;23.1
70;2021-06-12;829;1970;107655;55822;46.2;23.9
70;2021-06-13;143;15;107798;55837;46.2;23.9
70;2021-06-14;559;1243;108357;57080;46.5;24.5
70;2021-06-15;451;1506;108808;58586;46.7;25.1
70;2021-06-16;798;1391;109606;59977;47.0;25.7
70;2021-06-17;1154;2097;110760;62074;47.5;26.6
70;2021-06-18;995;2254;111755;64328;47.9;27.6
70;2021-06-19;1091;1639;112846;65967;48.4;28.3
70;2021-06-20;1;3;112847;65970;48.4;28.3
70;2021-06-21;691;1451;113538;67421;48.7;28.9
70;2021-06-22;655;1513;114193;68934;49.0;29.6
70;2021-06-23;662;1569;114855;70503;49.3;30.2
70;2021-06-24;877;2049;115732;72552;49.6;31.1
70;2021-06-25;681;2648;116413;75200;49.9;32.2
70;2021-06-26;942;2134;117355;77334;50.3;33.2
70;2021-06-27;141;763;117496;78097;50.4;33.5
70;2021-06-28;335;1351;117831;79448;50.5;34.1
70;2021-06-29;411;1610;118242;81058;50.7;34.8
70;2021-06-30;390;1634;118632;82692;50.9;35.5
70;2021-07-01;642;1751;119274;84443;51.1;36.2
70;2021-07-02;815;1576;120089;86019;51.5;36.9
70;2021-07-03;841;1084;120930;87103;51.9;37.4
70;2021-07-04;29;70;120959;87173;51.9;37.4
70;2021-07-05;610;1037;121569;88210;52.1;37.8
70;2021-07-06;681;1273;122250;89483;52.4;38.4
70;2021-07-07;508;1425;122758;90908;52.6;39.0
70;2021-07-08;817;1574;123575;92482;53.0;39.7
70;2021-07-09;872;1662;124447;94144;53.4;40.4
70;2021-07-10;831;1033;125278;95177;53.7;40.8
70;2021-07-11;7;20;125285;95197;53.7;40.8
70;2021-07-12;432;1391;125717;96588;53.9;41.4
70;2021-07-13;907;1867;126624;98455;54.3;42.2
70;2021-07-14;33;6;126657;98461;54.3;42.2
70;2021-07-15;1382;1690;128039;100151;54.9;42.9
70;2021-07-16;1632;2056;129671;102207;55.6;43.8
70;2021-07-17;1501;1454;131172;103661;56.3;44.5
70;2021-07-18;1145;641;132317;104302;56.7;44.7
70;2021-07-19;883;976;133200;105278;57.1;45.1
70;2021-07-20;1349;1352;134549;106630;57.7;45.7
70;2021-07-21;1286;1402;135835;108032;58.2;46.3
70;2021-07-22;1867;1827;137702;109859;59.1;47.1
70;2021-07-23;1826;2491;139528;112350;59.8;48.2
70;2021-07-24;1364;1806;140892;114156;60.4;49.0
70;2021-07-25;27;3;140919;114159;60.4;49.0
70;2021-07-26;1055;975;141974;115134;60.9;49.4
70;2021-07-27;1398;975;143372;116109;61.5;49.8
70;2021-07-28;1404;1162;144776;117271;62.1;50.3
70;2021-07-29;1873;1387;146649;118658;62.9;50.9
70;2021-07-30;1974;1347;148623;120005;63.7;51.5
70;2021-07-31;1751;1166;150374;121171;64.5;52.0
70;2021-08-01;2;4;150376;121175;64.5;52.0
70;2021-08-02;775;737;151151;121912;64.8;52.3
70;2021-08-03;1296;1037;152447;122949;65.4;52.7
70;2021-08-04;1210;922;153657;123871;65.9;53.1
70;2021-08-05;1657;1190;155314;125061;66.6;53.6
70;2021-08-06;1796;1334;157110;126395;67.4;54.2
70;2021-08-07;1192;1030;158302;127425;67.9;54.6
70;2021-08-08;35;28;158337;127453;67.9;54.7
70;2021-08-09;533;704;158870;128157;68.1;55.0
70;2021-08-10;898;1131;159768;129288;68.5;55.4
70;2021-08-11;808;722;160576;130010;68.9;55.8
70;2021-08-12;906;1271;161482;131281;69.2;56.3
70;2021-08-13;1040;1622;162522;132903;69.7;57.0
70;2021-08-14;771;976;163293;133879;70.0;57.4
70;2021-08-15;36;28;163329;133907;70.0;57.4
70;2021-08-16;545;909;163874;134816;70.3;57.8
70;2021-08-17;680;1194;164554;136010;70.6;58.3
70;2021-08-18;536;939;165090;136949;70.8;58.7
70;2021-08-19;565;1385;165655;138334;71.0;59.3
70;2021-08-20;510;1899;166165;140233;71.3;60.1
70;2021-08-21;447;1163;166612;141396;71.4;60.6
70;2021-08-22;2;6;166614;141402;71.4;60.6
70;2021-08-23;283;879;166897;142281;71.6;61.0
70;2021-08-24;386;1373;167283;143654;71.7;61.6
70;2021-08-25;354;1343;167637;144997;71.9;62.2
70;2021-08-26;439;1560;168076;146557;72.1;62.8
70;2021-08-27;392;2127;168468;148684;72.2;63.8
70;2021-08-28;367;1706;168835;150390;72.4;64.5
70;2021-08-29;12;6;168847;150396;72.4;64.5
70;2021-08-30;298;835;169145;151231;72.5;64.9
70;2021-08-31;360;1130;169505;152361;72.7;65.3
70;2021-09-01;314;1195;169819;153556;72.8;65.8
70;2021-09-02;303;1296;170122;154852;73.0;66.4
70;2021-09-03;278;1245;170400;156097;73.1;66.9
70;2021-09-04;453;1263;170853;157360;73.3;67.5
70;2021-09-05;21;31;170874;157391;73.3;67.5
70;2021-09-06;167;700;171041;158091;73.3;67.8
70;2021-09-07;186;880;171227;158971;73.4;68.2
70;2021-09-08;193;875;171420;159846;73.5;68.5
70;2021-09-09;178;862;171598;160708;73.6;68.9
70;2021-09-10;253;914;171851;161622;73.7;69.3
70;2021-09-11;292;975;172143;162597;73.8;69.7
70;2021-09-12;7;37;172150;162634;73.8;69.7
70;2021-09-13;152;442;172302;163076;73.9;69.9
70;2021-09-14;314;565;172616;163641;74.0;70.2
70;2021-09-15;171;532;172787;164173;74.1;70.4
70;2021-09-16;250;391;173037;164564;74.2;70.6
70;2021-09-17;191;454;173228;165018;74.3;70.8
70;2021-09-18;174;456;173402;165474;74.4;71.0
70;2021-09-19;3;14;173405;165488;74.4;71.0
70;2021-09-20;82;215;173487;165703;74.4;71.1
70;2021-09-21;163;279;173650;165982;74.5;71.2
70;2021-09-22;113;383;173763;166365;74.5;71.3
70;2021-09-23;63;229;173826;166594;74.5;71.4
70;2021-09-24;196;389;174022;166983;74.6;71.6
70;2021-09-25;138;504;174160;167487;74.7;71.8
70;2021-09-26;0;1;174160;167488;74.7;71.8
70;2021-09-27;51;201;174211;167689;74.7;71.9
70;2021-09-28;76;196;174287;167885;74.7;72.0
70;2021-09-29;91;239;174378;168124;74.8;72.1
71;2020-12-27;0;0;0;0;0.0;0.0
71;2020-12-28;1;0;1;0;0.0;0.0
71;2020-12-29;0;0;1;0;0.0;0.0
71;2020-12-30;0;0;1;0;0.0;0.0
71;2020-12-31;0;0;1;0;0.0;0.0
71;2021-01-01;1;0;2;0;0.0;0.0
71;2021-01-02;0;0;2;0;0.0;0.0
71;2021-01-03;2;0;4;0;0.0;0.0
71;2021-01-04;1;0;5;0;0.0;0.0
71;2021-01-05;13;0;18;0;0.0;0.0
71;2021-01-06;72;0;90;0;0.0;0.0
71;2021-01-07;67;0;157;0;0.0;0.0
71;2021-01-08;146;0;303;0;0.1;0.0
71;2021-01-09;117;0;420;0;0.1;0.0
71;2021-01-10;1;0;421;0;0.1;0.0
71;2021-01-11;245;1;666;1;0.1;0.0
71;2021-01-12;845;1;1511;2;0.3;0.0
71;2021-01-13;562;2;2073;4;0.4;0.0
71;2021-01-14;591;9;2664;13;0.5;0.0
71;2021-01-15;666;2;3330;15;0.6;0.0
71;2021-01-16;9;0;3339;15;0.6;0.0
71;2021-01-17;0;0;3339;15;0.6;0.0
71;2021-01-18;1094;7;4433;22;0.8;0.0
71;2021-01-19;1694;7;6127;29;1.1;0.0
71;2021-01-20;1517;6;7644;35;1.4;0.0
71;2021-01-21;2060;15;9704;50;1.8;0.0
71;2021-01-22;1414;6;11118;56;2.0;0.0
71;2021-01-23;815;6;11933;62;2.2;0.0
71;2021-01-24;1;0;11934;62;2.2;0.0
71;2021-01-25;1065;6;12999;68;2.4;0.0
71;2021-01-26;1505;25;14504;93;2.6;0.0
71;2021-01-27;1248;33;15752;126;2.9;0.0
71;2021-01-28;1083;78;16835;204;3.1;0.0
71;2021-01-29;1016;132;17851;336;3.3;0.1
71;2021-01-30;605;1;18456;337;3.4;0.1
71;2021-01-31;1;14;18457;351;3.4;0.1
71;2021-02-01;752;226;19209;577;3.5;0.1
71;2021-02-02;754;337;19963;914;3.6;0.2
71;2021-02-03;817;395;20780;1309;3.8;0.2
71;2021-02-04;784;540;21564;1849;3.9;0.3
71;2021-02-05;704;478;22268;2327;4.1;0.4
71;2021-02-06;539;8;22807;2335;4.2;0.4
71;2021-02-07;4;49;22811;2384;4.2;0.4
71;2021-02-08;603;501;23414;2885;4.3;0.5
71;2021-02-09;370;805;23784;3690;4.3;0.7
71;2021-02-10;411;781;24195;4471;4.4;0.8
71;2021-02-11;474;942;24669;5413;4.5;1.0
71;2021-02-12;535;842;25204;6255;4.6;1.1
71;2021-02-13;124;353;25328;6608;4.6;1.2
71;2021-02-14;2;7;25330;6615;4.6;1.2
71;2021-02-15;322;701;25652;7316;4.7;1.3
71;2021-02-16;445;1085;26097;8401;4.8;1.5
71;2021-02-17;427;968;26524;9369;4.8;1.7
71;2021-02-18;548;755;27072;10124;4.9;1.8
71;2021-02-19;571;662;27643;10786;5.0;2.0
71;2021-02-20;224;283;27867;11069;5.1;2.0
71;2021-02-21;4;13;27871;11082;5.1;2.0
71;2021-02-22;237;731;28108;11813;5.1;2.2
71;2021-02-23;452;783;28560;12596;5.2;2.3
71;2021-02-24;446;572;29006;13168;5.3;2.4
71;2021-02-25;533;597;29539;13765;5.4;2.5
71;2021-02-26;831;475;30370;14240;5.5;2.6
71;2021-02-27;456;262;30826;14502;5.6;2.6
71;2021-02-28;54;14;30880;14516;5.6;2.6
71;2021-03-01;1187;558;32067;15074;5.9;2.8
71;2021-03-02;1574;541;33641;15615;6.1;2.9
71;2021-03-03;1819;684;35460;16299;6.5;3.0
71;2021-03-04;2001;721;37461;17020;6.8;3.1
71;2021-03-05;2288;610;39749;17630;7.3;3.2
71;2021-03-06;754;61;40503;17691;7.4;3.2
71;2021-03-07;40;20;40543;17711;7.4;3.2
71;2021-03-08;1451;712;41994;18423;7.7;3.4
71;2021-03-09;2160;485;44154;18908;8.1;3.5
71;2021-03-10;2173;447;46327;19355;8.5;3.5
71;2021-03-11;2629;643;48956;19998;8.9;3.7
71;2021-03-12;2603;591;51559;20589;9.4;3.8
71;2021-03-13;995;94;52554;20683;9.6;3.8
71;2021-03-14;36;0;52590;20683;9.6;3.8
71;2021-03-15;1797;489;54387;21172;9.9;3.9
71;2021-03-16;1821;201;56208;21373;10.3;3.9
71;2021-03-17;2134;248;58342;21621;10.6;3.9
71;2021-03-18;1954;428;60296;22049;11.0;4.0
71;2021-03-19;2370;334;62666;22383;11.4;4.1
71;2021-03-20;1083;40;63749;22423;11.6;4.1
71;2021-03-21;17;5;63766;22428;11.6;4.1
71;2021-03-22;2576;381;66342;22809;12.1;4.2
71;2021-03-23;3346;502;69688;23311;12.7;4.3
71;2021-03-24;3349;469;73037;23780;13.3;4.3
71;2021-03-25;4029;596;77066;24376;14.1;4.4
71;2021-03-26;4057;339;81123;24715;14.8;4.5
71;2021-03-27;997;107;82120;24822;15.0;4.5
71;2021-03-28;57;8;82177;24830;15.0;4.5
71;2021-03-29;2409;1161;84586;25991;15.4;4.7
71;2021-03-30;2951;1353;87537;27344;16.0;5.0
71;2021-03-31;2547;1519;90084;28863;16.4;5.3
71;2021-04-01;2717;1297;92801;30160;16.9;5.5
71;2021-04-02;2501;1415;95302;31575;17.4;5.8
71;2021-04-03;268;34;95570;31609;17.4;5.8
71;2021-04-04;6;0;95576;31609;17.4;5.8
71;2021-04-05;61;2;95637;31611;17.5;5.8
71;2021-04-06;2257;1875;97894;33486;17.9;6.1
71;2021-04-07;2390;1782;100284;35268;18.3;6.4
71;2021-04-08;3283;1801;103567;37069;18.9;6.8
71;2021-04-09;4041;1661;107608;38730;19.6;7.1
71;2021-04-10;769;47;108377;38777;19.8;7.1
71;2021-04-11;97;4;108474;38781;19.8;7.1
71;2021-04-12;2353;1695;110827;40476;20.2;7.4
71;2021-04-13;2583;1882;113410;42358;20.7;7.7
71;2021-04-14;2374;1918;115784;44276;21.1;8.1
71;2021-04-15;2779;1690;118563;45966;21.6;8.4
71;2021-04-16;2628;1647;121191;47613;22.1;8.7
71;2021-04-17;952;344;122143;47957;22.3;8.8
71;2021-04-18;106;6;122249;47963;22.3;8.8
71;2021-04-19;1758;2564;124007;50527;22.6;9.2
71;2021-04-20;2220;2599;126227;53126;23.0;9.7
71;2021-04-21;2123;2590;128350;55716;23.4;10.2
71;2021-04-22;2511;2441;130861;58157;23.9;10.6
71;2021-04-23;2922;2265;133783;60422;24.4;11.0
71;2021-04-24;517;52;134300;60474;24.5;11.0
71;2021-04-25;26;0;134326;60474;24.5;11.0
71;2021-04-26;2565;2136;136891;62610;25.0;11.4
71;2021-04-27;2990;2266;139881;64876;25.5;11.8
71;2021-04-28;3073;2123;142954;66999;26.1;12.2
71;2021-04-29;3780;2208;146734;69207;26.8;12.6
71;2021-04-30;3926;1714;150660;70921;27.5;12.9
71;2021-05-01;39;53;150699;70974;27.5;13.0
71;2021-05-02;23;18;150722;70992;27.5;13.0
71;2021-05-03;4289;1381;155011;72373;28.3;13.2
71;2021-05-04;2955;2357;157966;74730;28.8;13.6
71;2021-05-05;3426;2080;161392;76810;29.5;14.0
71;2021-05-06;3467;2360;164859;79170;30.1;14.5
71;2021-05-07;3678;2801;168537;81971;30.8;15.0
71;2021-05-08;179;183;168716;82154;30.8;15.0
71;2021-05-09;44;47;168760;82201;30.8;15.0
71;2021-05-10;3696;2285;172456;84486;31.5;15.4
71;2021-05-11;4663;2358;177119;86844;32.3;15.9
71;2021-05-12;3978;2594;181097;89438;33.1;16.3
71;2021-05-13;1576;155;182673;89593;33.3;16.4
71;2021-05-14;3766;2194;186439;91787;34.0;16.8
71;2021-05-15;243;330;186682;92117;34.1;16.8
71;2021-05-16;2;0;186684;92117;34.1;16.8
71;2021-05-17;3864;1887;190548;94004;34.8;17.2
71;2021-05-18;3498;2425;194046;96429;35.4;17.6
71;2021-05-19;3719;2278;197765;98707;36.1;18.0
71;2021-05-20;4184;2286;201949;100993;36.9;18.4
71;2021-05-21;3721;2560;205670;103553;37.5;18.9
71;2021-05-22;169;304;205839;103857;37.6;19.0
71;2021-05-23;14;55;205853;103912;37.6;19.0
71;2021-05-24;19;94;205872;104006;37.6;19.0
71;2021-05-25;2689;3003;208561;107009;38.1;19.5
71;2021-05-26;2972;2432;211533;109441;38.6;20.0
71;2021-05-27;3387;2587;214920;112028;39.2;20.4
71;2021-05-28;2919;3149;217839;115177;39.8;21.0
71;2021-05-29;482;656;218321;115833;39.9;21.1
71;2021-05-30;76;58;218397;115891;39.9;21.2
71;2021-05-31;2774;3449;221171;119340;40.4;21.8
71;2021-06-01;3671;3538;224842;122878;41.0;22.4
71;2021-06-02;3997;2631;228839;125509;41.8;22.9
71;2021-06-03;4435;2521;233274;128030;42.6;23.4
71;2021-06-04;3717;3701;236991;131731;43.3;24.0
71;2021-06-05;684;647;237675;132378;43.4;24.2
71;2021-06-06;57;91;237732;132469;43.4;24.2
71;2021-06-07;3281;4150;241013;136619;44.0;24.9
71;2021-06-08;3894;4010;244907;140629;44.7;25.7
71;2021-06-09;4694;2752;249601;143381;45.6;26.2
71;2021-06-10;5265;2745;254866;146126;46.5;26.7
71;2021-06-11;4434;3721;259300;149847;47.3;27.4
71;2021-06-12;715;593;260015;150440;47.5;27.5
71;2021-06-13;104;187;260119;150627;47.5;27.5
71;2021-06-14;3510;3785;263629;154412;48.1;28.2
71;2021-06-15;4205;3549;267834;157961;48.9;28.8
71;2021-06-16;4595;2731;272429;160692;49.7;29.3
71;2021-06-17;4267;2989;276696;163681;50.5;29.9
71;2021-06-18;4325;3770;281021;167451;51.3;30.6
71;2021-06-19;1269;654;282290;168105;51.5;30.7
71;2021-06-20;37;27;282327;168132;51.5;30.7
71;2021-06-21;2270;4276;284597;172408;52.0;31.5
71;2021-06-22;2689;4354;287286;176762;52.4;32.3
71;2021-06-23;3060;3420;290346;180182;53.0;32.9
71;2021-06-24;3328;3022;293674;183204;53.6;33.4
71;2021-06-25;2652;4471;296326;187675;54.1;34.3
71;2021-06-26;372;551;296698;188226;54.2;34.4
71;2021-06-27;29;67;296727;188293;54.2;34.4
71;2021-06-28;1535;4624;298262;192917;54.4;35.2
71;2021-06-29;1992;4820;300254;197737;54.8;36.1
71;2021-06-30;2503;3934;302757;201671;55.3;36.8
71;2021-07-01;2826;3900;305583;205571;55.8;37.5
71;2021-07-02;3029;3986;308612;209557;56.3;38.3
71;2021-07-03;319;712;308931;210269;56.4;38.4
71;2021-07-04;28;132;308959;210401;56.4;38.4
71;2021-07-05;2474;4323;311433;214724;56.8;39.2
71;2021-07-06;2460;4559;313893;219283;57.3;40.0
71;2021-07-07;2983;3724;316876;223007;57.8;40.7
71;2021-07-08;2766;4109;319642;227116;58.3;41.5
71;2021-07-09;2383;5022;322025;232138;58.8;42.4
71;2021-07-10;212;656;322237;232794;58.8;42.5
71;2021-07-11;15;65;322252;232859;58.8;42.5
71;2021-07-12;1911;5304;324163;238163;59.2;43.5
71;2021-07-13;2537;5863;326700;244026;59.6;44.5
71;2021-07-14;950;400;327650;244426;59.8;44.6
71;2021-07-15;3024;5733;330674;250159;60.4;45.7
71;2021-07-16;3294;6002;333968;256161;61.0;46.8
71;2021-07-17;505;779;334473;256940;61.1;46.9
71;2021-07-18;89;86;334562;257026;61.1;46.9
71;2021-07-19;2864;5551;337426;262577;61.6;47.9
71;2021-07-20;3366;5913;340792;268490;62.2;49.0
71;2021-07-21;3413;5469;344205;273959;62.8;50.0
71;2021-07-22;3945;5332;348150;279291;63.6;51.0
71;2021-07-23;3233;6000;351383;285291;64.1;52.1
71;2021-07-24;715;597;352098;285888;64.3;52.2
71;2021-07-25;148;82;352246;285970;64.3;52.2
71;2021-07-26;3597;4889;355843;290859;65.0;53.1
71;2021-07-27;4090;5122;359933;295981;65.7;54.0
71;2021-07-28;4248;4809;364181;300790;66.5;54.9
71;2021-07-29;4212;4645;368393;305435;67.2;55.8
71;2021-07-30;4241;4924;372634;310359;68.0;56.7
71;2021-07-31;722;722;373356;311081;68.2;56.8
71;2021-08-01;108;35;373464;311116;68.2;56.8
71;2021-08-02;3967;3759;377431;314875;68.9;57.5
71;2021-08-03;4408;3821;381839;318696;69.7;58.2
71;2021-08-04;4390;2983;386229;321679;70.5;58.7
71;2021-08-05;4188;3267;390417;324946;71.3;59.3
71;2021-08-06;3700;4009;394117;328955;71.9;60.0
71;2021-08-07;495;329;394612;329284;72.0;60.1
71;2021-08-08;51;65;394663;329349;72.0;60.1
71;2021-08-09;3044;3406;397707;332755;72.6;60.7
71;2021-08-10;3074;3388;400781;336143;73.2;61.4
71;2021-08-11;3186;3079;403967;339222;73.7;61.9
71;2021-08-12;3016;3106;406983;342328;74.3;62.5
71;2021-08-13;2691;3334;409674;345662;74.8;63.1
71;2021-08-14;282;518;409956;346180;74.8;63.2
71;2021-08-15;49;110;410005;346290;74.8;63.2
71;2021-08-16;1708;3527;411713;349817;75.2;63.9
71;2021-08-17;1738;3433;413451;353250;75.5;64.5
71;2021-08-18;1452;3160;414903;356410;75.7;65.1
71;2021-08-19;1275;3115;416178;359525;76.0;65.6
71;2021-08-20;1290;3697;417468;363222;76.2;66.3
71;2021-08-21;148;413;417616;363635;76.2;66.4
71;2021-08-22;40;99;417656;363734;76.2;66.4
71;2021-08-23;1426;4543;419082;368277;76.5;67.2
71;2021-08-24;1334;3804;420416;372081;76.7;67.9
71;2021-08-25;950;3773;421366;375854;76.9;68.6
71;2021-08-26;959;3393;422325;379247;77.1;69.2
71;2021-08-27;1149;4462;423474;383709;77.3;70.0
71;2021-08-28;195;413;423669;384122;77.3;70.1
71;2021-08-29;29;106;423698;384228;77.3;70.1
71;2021-08-30;1251;3940;424949;388168;77.6;70.9
71;2021-08-31;1023;3627;425972;391795;77.8;71.5
71;2021-09-01;932;3587;426904;395382;77.9;72.2
71;2021-09-02;600;3117;427504;398499;78.0;72.7
71;2021-09-03;834;4030;428338;402529;78.2;73.5
71;2021-09-04;261;587;428599;403116;78.2;73.6
71;2021-09-05;23;58;428622;403174;78.2;73.6
71;2021-09-06;638;2785;429260;405959;78.4;74.1
71;2021-09-07;516;2269;429776;408228;78.5;74.5
71;2021-09-08;718;2603;430494;410831;78.6;75.0
71;2021-09-09;454;1794;430948;412625;78.7;75.3
71;2021-09-10;810;2759;431758;415384;78.8;75.8
71;2021-09-11;199;323;431957;415707;78.8;75.9
71;2021-09-12;19;49;431976;415756;78.9;75.9
71;2021-09-13;642;1623;432618;417379;79.0;76.2
71;2021-09-14;481;1569;433099;418948;79.1;76.5
71;2021-09-15;601;1495;433700;420443;79.2;76.7
71;2021-09-16;446;820;434146;421263;79.2;76.9
71;2021-09-17;533;1436;434679;422699;79.3;77.2
71;2021-09-18;140;261;434819;422960;79.4;77.2
71;2021-09-19;9;28;434828;422988;79.4;77.2
71;2021-09-20;484;922;435312;423910;79.5;77.4
71;2021-09-21;294;711;435606;424621;79.5;77.5
71;2021-09-22;341;1377;435947;425998;79.6;77.8
71;2021-09-23;306;576;436253;426574;79.6;77.9
71;2021-09-24;366;1028;436619;427602;79.7;78.1
71;2021-09-25;71;176;436690;427778;79.7;78.1
71;2021-09-26;11;35;436701;427813;79.7;78.1
71;2021-09-27;285;757;436986;428570;79.8;78.2
71;2021-09-28;288;476;437274;429046;79.8;78.3
71;2021-09-29;327;738;437601;429784;79.9;78.5
72;2020-12-27;0;0;0;0;0.0;0.0
72;2020-12-28;0;0;0;0;0.0;0.0
72;2020-12-29;0;0;0;0;0.0;0.0
72;2020-12-30;0;0;0;0;0.0;0.0
72;2020-12-31;0;0;0;0;0.0;0.0
72;2021-01-01;2;0;2;0;0.0;0.0
72;2021-01-02;0;0;2;0;0.0;0.0
72;2021-01-03;0;0;2;0;0.0;0.0
72;2021-01-04;0;0;2;0;0.0;0.0
72;2021-01-05;14;0;16;0;0.0;0.0
72;2021-01-06;27;0;43;0;0.0;0.0
72;2021-01-07;110;0;153;0;0.0;0.0
72;2021-01-08;232;0;385;0;0.1;0.0
72;2021-01-09;36;0;421;0;0.1;0.0
72;2021-01-10;0;0;421;0;0.1;0.0
72;2021-01-11;485;1;906;1;0.2;0.0
72;2021-01-12;614;1;1520;2;0.3;0.0
72;2021-01-13;500;1;2020;3;0.4;0.0
72;2021-01-14;644;3;2664;6;0.5;0.0
72;2021-01-15;478;1;3142;7;0.6;0.0
72;2021-01-16;94;0;3236;7;0.6;0.0
72;2021-01-17;0;0;3236;7;0.6;0.0
72;2021-01-18;294;0;3530;7;0.6;0.0
72;2021-01-19;779;4;4309;11;0.8;0.0
72;2021-01-20;1538;6;5847;17;1.0;0.0
72;2021-01-21;1779;5;7626;22;1.4;0.0
72;2021-01-22;1148;5;8774;27;1.6;0.0
72;2021-01-23;32;0;8806;27;1.6;0.0
72;2021-01-24;0;0;8806;27;1.6;0.0
72;2021-01-25;503;7;9309;34;1.7;0.0
72;2021-01-26;1165;21;10474;55;1.9;0.0
72;2021-01-27;884;20;11358;75;2.0;0.0
72;2021-01-28;776;66;12134;141;2.2;0.0
72;2021-01-29;712;59;12846;200;2.3;0.0
72;2021-01-30;58;0;12904;200;2.3;0.0
72;2021-01-31;1;0;12905;200;2.3;0.0
72;2021-02-01;499;195;13404;395;2.4;0.1
72;2021-02-02;506;287;13910;682;2.5;0.1
72;2021-02-03;487;216;14397;898;2.6;0.2
72;2021-02-04;477;327;14874;1225;2.7;0.2
72;2021-02-05;514;304;15388;1529;2.7;0.3
72;2021-02-06;83;7;15471;1536;2.8;0.3
72;2021-02-07;19;1;15490;1537;2.8;0.3
72;2021-02-08;310;319;15800;1856;2.8;0.3
72;2021-02-09;488;500;16288;2356;2.9;0.4
72;2021-02-10;568;847;16856;3203;3.0;0.6
72;2021-02-11;860;1246;17716;4449;3.2;0.8
72;2021-02-12;851;564;18567;5013;3.3;0.9
72;2021-02-13;111;34;18678;5047;3.3;0.9
72;2021-02-14;1;22;18679;5069;3.3;0.9
72;2021-02-15;220;389;18899;5458;3.4;1.0
72;2021-02-16;503;935;19402;6393;3.5;1.1
72;2021-02-17;463;577;19865;6970;3.5;1.2
72;2021-02-18;595;540;20460;7510;3.7;1.3
72;2021-02-19;521;491;20981;8001;3.7;1.4
72;2021-02-20;80;50;21061;8051;3.8;1.4
72;2021-02-21;0;0;21061;8051;3.8;1.4
72;2021-02-22;329;457;21390;8508;3.8;1.5
72;2021-02-23;569;372;21959;8880;3.9;1.6
72;2021-02-24;435;408;22394;9288;4.0;1.7
72;2021-02-25;922;468;23316;9756;4.2;1.7
72;2021-02-26;600;394;23916;10150;4.3;1.8
72;2021-02-27;322;32;24238;10182;4.3;1.8
72;2021-02-28;15;17;24253;10199;4.3;1.8
72;2021-03-01;379;370;24632;10569;4.4;1.9
72;2021-03-02;502;514;25134;11083;4.5;2.0
72;2021-03-03;733;540;25867;11623;4.6;2.1
72;2021-03-04;741;672;26608;12295;4.7;2.2
72;2021-03-05;935;691;27543;12986;4.9;2.3
72;2021-03-06;761;111;28304;13097;5.1;2.3
72;2021-03-07;448;26;28752;13123;5.1;2.3
72;2021-03-08;561;393;29313;13516;5.2;2.4
72;2021-03-09;1045;558;30358;14074;5.4;2.5
72;2021-03-10;1134;613;31492;14687;5.6;2.6
72;2021-03-11;1610;427;33102;15114;5.9;2.7
72;2021-03-12;1364;480;34466;15594;6.2;2.8
72;2021-03-13;983;103;35449;15697;6.3;2.8
72;2021-03-14;14;10;35463;15707;6.3;2.8
72;2021-03-15;1159;212;36622;15919;6.5;2.8
72;2021-03-16;1052;180;37674;16099;6.7;2.9
72;2021-03-17;1035;253;38709;16352;6.9;2.9
72;2021-03-18;1088;362;39797;16714;7.1;3.0
72;2021-03-19;1276;287;41073;17001;7.3;3.0
72;2021-03-20;489;88;41562;17089;7.4;3.1
72;2021-03-21;19;0;41581;17089;7.4;3.1
72;2021-03-22;1347;340;42928;17429;7.7;3.1
72;2021-03-23;1723;472;44651;17901;8.0;3.2
72;2021-03-24;1841;297;46492;18198;8.3;3.2
72;2021-03-25;2447;459;48939;18657;8.7;3.3
72;2021-03-26;2336;366;51275;19023;9.2;3.4
72;2021-03-27;614;31;51889;19054;9.3;3.4
72;2021-03-28;22;0;51911;19054;9.3;3.4
72;2021-03-29;1616;381;53527;19435;9.6;3.5
72;2021-03-30;2496;385;56023;19820;10.0;3.5
72;2021-03-31;2145;365;58168;20185;10.4;3.6
72;2021-04-01;2850;349;61018;20534;10.9;3.7
72;2021-04-02;2248;398;63266;20932;11.3;3.7
72;2021-04-03;292;39;63558;20971;11.3;3.7
72;2021-04-04;16;3;63574;20974;11.3;3.7
72;2021-04-05;51;49;63625;21023;11.4;3.8
72;2021-04-06;1759;469;65384;21492;11.7;3.8
72;2021-04-07;2576;599;67960;22091;12.1;3.9
72;2021-04-08;2721;781;70681;22872;12.6;4.1
72;2021-04-09;3863;582;74544;23454;13.3;4.2
72;2021-04-10;1112;52;75656;23506;13.5;4.2
72;2021-04-11;8;1;75664;23507;13.5;4.2
72;2021-04-12;1846;902;77510;24409;13.8;4.4
72;2021-04-13;2372;1072;79882;25481;14.3;4.5
72;2021-04-14;2250;1096;82132;26577;14.7;4.7
72;2021-04-15;2421;1118;84553;27695;15.1;4.9
72;2021-04-16;2562;958;87115;28653;15.5;5.1
72;2021-04-17;707;144;87822;28797;15.7;5.1
72;2021-04-18;57;2;87879;28799;15.7;5.1
72;2021-04-19;1396;1089;89275;29888;15.9;5.3
72;2021-04-20;2996;1304;92271;31192;16.5;5.6
72;2021-04-21;2515;1562;94786;32754;16.9;5.8
72;2021-04-22;2814;1791;97600;34545;17.4;6.2
72;2021-04-23;3213;1457;100813;36002;18.0;6.4
72;2021-04-24;1400;268;102213;36270;18.2;6.5
72;2021-04-25;881;18;103094;36288;18.4;6.5
72;2021-04-26;3513;1474;106607;37762;19.0;6.7
72;2021-04-27;4088;1852;110695;39614;19.8;7.1
72;2021-04-28;3835;1871;114530;41485;20.4;7.4
72;2021-04-29;4161;1781;118691;43266;21.2;7.7
72;2021-04-30;3615;1705;122306;44971;21.8;8.0
72;2021-05-01;1642;226;123948;45197;22.1;8.1
72;2021-05-02;1533;161;125481;45358;22.4;8.1
72;2021-05-03;3456;1153;128937;46511;23.0;8.3
72;2021-05-04;4013;1799;132950;48310;23.7;8.6
72;2021-05-05;3866;2173;136816;50483;24.4;9.0
72;2021-05-06;3596;1929;140412;52412;25.1;9.4
72;2021-05-07;3543;2137;143955;54549;25.7;9.7
72;2021-05-08;1900;152;145855;54701;26.0;9.8
72;2021-05-09;2080;214;147935;54915;26.4;9.8
72;2021-05-10;3769;1525;151704;56440;27.1;10.1
72;2021-05-11;4597;1994;156301;58434;27.9;10.4
72;2021-05-12;4080;1817;160381;60251;28.6;10.8
72;2021-05-13;3031;273;163412;60524;29.2;10.8
72;2021-05-14;3663;1397;167075;61921;29.8;11.1
72;2021-05-15;3117;365;170192;62286;30.4;11.1
72;2021-05-16;2500;151;172692;62437;30.8;11.1
72;2021-05-17;3724;1286;176416;63723;31.5;11.4
72;2021-05-18;4330;1688;180746;65411;32.3;11.7
72;2021-05-19;3973;1509;184719;66920;33.0;11.9
72;2021-05-20;4261;1452;188980;68372;33.7;12.2
72;2021-05-21;3788;1388;192768;69760;34.4;12.5
72;2021-05-22;2561;506;195329;70266;34.9;12.5
72;2021-05-23;1391;163;196720;70429;35.1;12.6
72;2021-05-24;2353;294;199073;70723;35.5;12.6
72;2021-05-25;4077;1412;203150;72135;36.3;12.9
72;2021-05-26;4096;1413;207246;73548;37.0;13.1
72;2021-05-27;4345;2049;211591;75597;37.8;13.5
72;2021-05-28;4104;2003;215695;77600;38.5;13.9
72;2021-05-29;2668;804;218363;78404;39.0;14.0
72;2021-05-30;1142;870;219505;79274;39.2;14.2
72;2021-05-31;3122;2326;222627;81600;39.7;14.6
72;2021-06-01;3570;2669;226197;84269;40.4;15.0
72;2021-06-02;3611;2777;229808;87046;41.0;15.5
72;2021-06-03;4242;2996;234050;90042;41.8;16.1
72;2021-06-04;3891;2751;237941;92793;42.5;16.6
72;2021-06-05;1440;2567;239381;95360;42.7;17.0
72;2021-06-06;911;1541;240292;96901;42.9;17.3
72;2021-06-07;1744;3424;242036;100325;43.2;17.9
72;2021-06-08;2930;3831;244966;104156;43.7;18.6
72;2021-06-09;2646;3371;247612;107527;44.2;19.2
72;2021-06-10;2825;3316;250437;110843;44.7;19.8
72;2021-06-11;2840;3771;253277;114614;45.2;20.5
72;2021-06-12;1242;2598;254519;117212;45.4;20.9
72;2021-06-13;388;1860;254907;119072;45.5;21.3
72;2021-06-14;1336;4127;256243;123199;45.7;22.0
72;2021-06-15;2752;3507;258995;126706;46.2;22.6
72;2021-06-16;2428;3579;261423;130285;46.7;23.3
72;2021-06-17;2318;3871;263741;134156;47.1;23.9
72;2021-06-18;2310;4312;266051;138468;47.5;24.7
72;2021-06-19;1128;2762;267179;141230;47.7;25.2
72;2021-06-20;339;2055;267518;143285;47.8;25.6
72;2021-06-21;1563;4029;269081;147314;48.0;26.3
72;2021-06-22;1710;4990;270791;152304;48.3;27.2
72;2021-06-23;2007;4222;272798;156526;48.7;27.9
72;2021-06-24;2232;4012;275030;160538;49.1;28.7
72;2021-06-25;1773;4832;276803;165370;49.4;29.5
72;2021-06-26;1190;2876;277993;168246;49.6;30.0
72;2021-06-27;392;2111;278385;170357;49.7;30.4
72;2021-06-28;1439;4292;279824;174649;49.9;31.2
72;2021-06-29;1770;4740;281594;179389;50.3;32.0
72;2021-06-30;1980;4169;283574;183558;50.6;32.8
72;2021-07-01;1953;4417;285527;187975;51.0;33.6
72;2021-07-02;1853;4713;287380;192688;51.3;34.4
72;2021-07-03;1292;3123;288672;195811;51.5;35.0
72;2021-07-04;579;1948;289251;197759;51.6;35.3
72;2021-07-05;1193;4164;290444;201923;51.8;36.0
72;2021-07-06;1460;5149;291904;207072;52.1;37.0
72;2021-07-07;1582;4608;293486;211680;52.4;37.8
72;2021-07-08;1648;4324;295134;216004;52.7;38.6
72;2021-07-09;2107;4604;297241;220608;53.1;39.4
72;2021-07-10;1589;2690;298830;223298;53.3;39.9
72;2021-07-11;947;1587;299777;224885;53.5;40.1
72;2021-07-12;1592;3753;301369;228638;53.8;40.8
72;2021-07-13;2091;4774;303460;233412;54.2;41.7
72;2021-07-14;1325;2365;304785;235777;54.4;42.1
72;2021-07-15;3485;3419;308270;239196;55.0;42.7
72;2021-07-16;3173;4120;311443;243316;55.6;43.4
72;2021-07-17;2646;1758;314089;245074;56.1;43.7
72;2021-07-18;1710;823;315799;245897;56.4;43.9
72;2021-07-19;2917;3508;318716;249405;56.9;44.5
72;2021-07-20;3040;4280;321756;253685;57.4;45.3
72;2021-07-21;2884;3586;324640;257271;57.9;45.9
72;2021-07-22;3772;2911;328412;260182;58.6;46.4
72;2021-07-23;3476;3791;331888;263973;59.2;47.1
72;2021-07-24;2820;1460;334708;265433;59.7;47.4
72;2021-07-25;1453;1080;336161;266513;60.0;47.6
72;2021-07-26;2725;2918;338886;269431;60.5;48.1
72;2021-07-27;3857;3819;342743;273250;61.2;48.8
72;2021-07-28;3571;3121;346314;276371;61.8;49.3
72;2021-07-29;3572;2712;349886;279083;62.5;49.8
72;2021-07-30;3788;3382;353674;282465;63.1;50.4
72;2021-07-31;2546;1749;356220;284214;63.6;50.7
72;2021-08-01;1835;432;358055;284646;63.9;50.8
72;2021-08-02;3215;2285;361270;286931;64.5;51.2
72;2021-08-03;3236;3296;364506;290227;65.1;51.8
72;2021-08-04;3767;2551;368273;292778;65.7;52.3
72;2021-08-05;3770;2460;372043;295238;66.4;52.7
72;2021-08-06;3342;2693;375385;297931;67.0;53.2
72;2021-08-07;2347;1613;377732;299544;67.4;53.5
72;2021-08-08;1623;700;379355;300244;67.7;53.6
72;2021-08-09;2700;2668;382055;302912;68.2;54.1
72;2021-08-10;2915;2747;384970;305659;68.7;54.6
72;2021-08-11;2367;2203;387337;307862;69.1;55.0
72;2021-08-12;2380;2597;389717;310459;69.6;55.4
72;2021-08-13;2158;2295;391875;312754;69.9;55.8
72;2021-08-14;1167;1546;393042;314300;70.2;56.1
72;2021-08-15;623;614;393665;314914;70.3;56.2
72;2021-08-16;1650;2372;395315;317286;70.6;56.6
72;2021-08-17;1717;2889;397032;320175;70.9;57.2
72;2021-08-18;1709;2872;398741;323047;71.2;57.7
72;2021-08-19;1245;2914;399986;325961;71.4;58.2
72;2021-08-20;1656;3168;401642;329129;71.7;58.7
72;2021-08-21;701;2031;402343;331160;71.8;59.1
72;2021-08-22;261;1150;402604;332310;71.9;59.3
72;2021-08-23;1739;3422;404343;335732;72.2;59.9
72;2021-08-24;1531;4121;405874;339853;72.4;60.7
72;2021-08-25;1598;3451;407472;343304;72.7;61.3
72;2021-08-26;1265;4444;408737;347748;73.0;62.1
72;2021-08-27;1191;4112;409928;351860;73.2;62.8
72;2021-08-28;881;2656;410809;354516;73.3;63.3
72;2021-08-29;357;1683;411166;356199;73.4;63.6
72;2021-08-30;1129;3462;412295;359661;73.6;64.2
72;2021-08-31;1218;4015;413513;363676;73.8;64.9
72;2021-09-01;1069;3310;414582;366986;74.0;65.5
72;2021-09-02;902;3459;415484;370445;74.2;66.1
72;2021-09-03;926;3305;416410;373750;74.3;66.7
72;2021-09-04;702;2658;417112;376408;74.5;67.2
72;2021-09-05;256;1554;417368;377962;74.5;67.5
72;2021-09-06;586;2812;417954;380774;74.6;68.0
72;2021-09-07;505;2952;418459;383726;74.7;68.5
72;2021-09-08;617;3173;419076;386899;74.8;69.1
72;2021-09-09;393;2094;419469;388993;74.9;69.4
72;2021-09-10;625;2713;420094;391706;75.0;69.9
72;2021-09-11;401;2718;420495;394424;75.1;70.4
72;2021-09-12;169;954;420664;395378;75.1;70.6
72;2021-09-13;366;1615;421030;396993;75.2;70.9
72;2021-09-14;487;1662;421517;398655;75.2;71.2
72;2021-09-15;614;1995;422131;400650;75.3;71.5
72;2021-09-16;336;831;422467;401481;75.4;71.7
72;2021-09-17;442;1423;422909;402904;75.5;71.9
72;2021-09-18;347;1519;423256;404423;75.6;72.2
72;2021-09-19;89;359;423345;404782;75.6;72.3
72;2021-09-20;349;791;423694;405573;75.6;72.4
72;2021-09-21;317;784;424011;406357;75.7;72.5
72;2021-09-22;442;1526;424453;407883;75.8;72.8
72;2021-09-23;396;630;424849;408513;75.8;72.9
72;2021-09-24;601;1004;425450;409517;75.9;73.1
72;2021-09-25;259;1004;425709;410521;76.0;73.3
72;2021-09-26;73;215;425782;410736;76.0;73.3
72;2021-09-27;210;639;425992;411375;76.0;73.4
72;2021-09-28;203;426;426195;411801;76.1;73.5
72;2021-09-29;358;1009;426553;412810;76.1;73.7
73;2020-12-27;1;0;1;0;0.0;0.0
73;2020-12-28;1;0;2;0;0.0;0.0
73;2020-12-29;0;0;2;0;0.0;0.0
73;2020-12-30;0;0;2;0;0.0;0.0
73;2020-12-31;0;0;2;0;0.0;0.0
73;2021-01-01;0;0;2;0;0.0;0.0
73;2021-01-02;0;0;2;0;0.0;0.0
73;2021-01-03;0;0;2;0;0.0;0.0
73;2021-01-04;1;0;3;0;0.0;0.0
73;2021-01-05;0;0;3;0;0.0;0.0
73;2021-01-06;1;0;4;0;0.0;0.0
73;2021-01-07;30;0;34;0;0.0;0.0
73;2021-01-08;81;0;115;0;0.0;0.0
73;2021-01-09;0;0;115;0;0.0;0.0
73;2021-01-10;0;0;115;0;0.0;0.0
73;2021-01-11;101;0;216;0;0.0;0.0
73;2021-01-12;303;1;519;1;0.1;0.0
73;2021-01-13;360;1;879;2;0.2;0.0
73;2021-01-14;516;2;1395;4;0.3;0.0
73;2021-01-15;617;1;2012;5;0.5;0.0
73;2021-01-16;128;0;2140;5;0.5;0.0
73;2021-01-17;0;0;2140;5;0.5;0.0
73;2021-01-18;624;0;2764;5;0.6;0.0
73;2021-01-19;1240;2;4004;7;0.9;0.0
73;2021-01-20;951;2;4955;9;1.1;0.0
73;2021-01-21;984;4;5939;13;1.4;0.0
73;2021-01-22;947;0;6886;13;1.6;0.0
73;2021-01-23;388;0;7274;13;1.7;0.0
73;2021-01-24;0;0;7274;13;1.7;0.0
73;2021-01-25;656;4;7930;17;1.8;0.0
73;2021-01-26;761;2;8691;19;2.0;0.0
73;2021-01-27;1107;5;9798;24;2.3;0.0
73;2021-01-28;961;5;10759;29;2.5;0.0
73;2021-01-29;684;5;11443;34;2.6;0.0
73;2021-01-30;345;2;11788;36;2.7;0.0
73;2021-01-31;0;0;11788;36;2.7;0.0
73;2021-02-01;606;37;12394;73;2.9;0.0
73;2021-02-02;752;327;13146;400;3.0;0.1
73;2021-02-03;651;344;13797;744;3.2;0.2
73;2021-02-04;625;224;14422;968;3.3;0.2
73;2021-02-05;680;398;15102;1366;3.5;0.3
73;2021-02-06;262;38;15364;1404;3.6;0.3
73;2021-02-07;1;0;15365;1404;3.6;0.3
73;2021-02-08;524;227;15889;1631;3.7;0.4
73;2021-02-09;793;400;16682;2031;3.9;0.5
73;2021-02-10;900;363;17582;2394;4.1;0.6
73;2021-02-11;962;675;18544;3069;4.3;0.7
73;2021-02-12;810;462;19354;3531;4.5;0.8
73;2021-02-13;263;46;19617;3577;4.5;0.8
73;2021-02-14;1;0;19618;3577;4.5;0.8
73;2021-02-15;346;387;19964;3964;4.6;0.9
73;2021-02-16;454;619;20418;4583;4.7;1.1
73;2021-02-17;451;829;20869;5412;4.8;1.3
73;2021-02-18;467;429;21336;5841;4.9;1.4
73;2021-02-19;444;528;21780;6369;5.0;1.5
73;2021-02-20;70;189;21850;6558;5.1;1.5
73;2021-02-21;0;0;21850;6558;5.1;1.5
73;2021-02-22;240;356;22090;6914;5.1;1.6
73;2021-02-23;327;434;22417;7348;5.2;1.7
73;2021-02-24;487;619;22904;7967;5.3;1.8
73;2021-02-25;504;410;23408;8377;5.4;1.9
73;2021-02-26;730;491;24138;8868;5.6;2.1
73;2021-02-27;330;200;24468;9068;5.7;2.1
73;2021-02-28;2;1;24470;9069;5.7;2.1
73;2021-03-01;557;441;25027;9510;5.8;2.2
73;2021-03-02;667;771;25694;10281;5.9;2.4
73;2021-03-03;643;1037;26337;11318;6.1;2.6
73;2021-03-04;1039;809;27376;12127;6.3;2.8
73;2021-03-05;1240;539;28616;12666;6.6;2.9
73;2021-03-06;1091;296;29707;12962;6.9;3.0
73;2021-03-07;455;88;30162;13050;7.0;3.0
73;2021-03-08;608;394;30770;13444;7.1;3.1
73;2021-03-09;983;468;31753;13912;7.3;3.2
73;2021-03-10;1035;759;32788;14671;7.6;3.4
73;2021-03-11;1558;586;34346;15257;7.9;3.5
73;2021-03-12;2018;507;36364;15764;8.4;3.6
73;2021-03-13;1179;192;37543;15956;8.7;3.7
73;2021-03-14;66;3;37609;15959;8.7;3.7
73;2021-03-15;1185;368;38794;16327;9.0;3.8
73;2021-03-16;795;389;39589;16716;9.2;3.9
73;2021-03-17;877;457;40466;17173;9.4;4.0
73;2021-03-18;1351;257;41817;17430;9.7;4.0
73;2021-03-19;1767;385;43584;17815;10.1;4.1
73;2021-03-20;888;127;44472;17942;10.3;4.1
73;2021-03-21;123;2;44595;17944;10.3;4.1
73;2021-03-22;1184;397;45779;18341;10.6;4.2
73;2021-03-23;1448;240;47227;18581;10.9;4.3
73;2021-03-24;1594;342;48821;18923;11.3;4.4
73;2021-03-25;2063;387;50884;19310;11.8;4.5
73;2021-03-26;2471;366;53355;19676;12.3;4.5
73;2021-03-27;885;148;54240;19824;12.5;4.6
73;2021-03-28;312;16;54552;19840;12.6;4.6
73;2021-03-29;1509;238;56061;20078;13.0;4.6
73;2021-03-30;2087;487;58148;20565;13.4;4.8
73;2021-03-31;2089;401;60237;20966;13.9;4.8
73;2021-04-01;2087;334;62324;21300;14.4;4.9
73;2021-04-02;2361;229;64685;21529;15.0;5.0
73;2021-04-03;849;147;65534;21676;15.2;5.0
73;2021-04-04;188;17;65722;21693;15.2;5.0
73;2021-04-05;212;26;65934;21719;15.2;5.0
73;2021-04-06;1507;510;67441;22229;15.6;5.1
73;2021-04-07;1946;650;69387;22879;16.0;5.3
73;2021-04-08;2491;820;71878;23699;16.6;5.5
73;2021-04-09;3059;524;74937;24223;17.3;5.6
73;2021-04-10;1134;320;76071;24543;17.6;5.7
73;2021-04-11;164;10;76235;24553;17.6;5.7
73;2021-04-12;1696;982;77931;25535;18.0;5.9
73;2021-04-13;1895;1129;79826;26664;18.5;6.2
73;2021-04-14;2013;1092;81839;27756;18.9;6.4
73;2021-04-15;2416;1190;84255;28946;19.5;6.7
73;2021-04-16;1893;934;86148;29880;19.9;6.9
73;2021-04-17;1173;560;87321;30440;20.2;7.0
73;2021-04-18;155;76;87476;30516;20.2;7.1
73;2021-04-19;1383;1057;88859;31573;20.5;7.3
73;2021-04-20;1790;1321;90649;32894;21.0;7.6
73;2021-04-21;1576;1301;92225;34195;21.3;7.9
73;2021-04-22;1812;1224;94037;35419;21.7;8.2
73;2021-04-23;1897;1254;95934;36673;22.2;8.5
73;2021-04-24;980;673;96914;37346;22.4;8.6
73;2021-04-25;79;96;96993;37442;22.4;8.7
73;2021-04-26;1164;1320;98157;38762;22.7;9.0
73;2021-04-27;1441;1468;99598;40230;23.0;9.3
73;2021-04-28;1731;1456;101329;41686;23.4;9.6
73;2021-04-29;2413;1562;103742;43248;24.0;10.0
73;2021-04-30;2396;1430;106138;44678;24.5;10.3
73;2021-05-01;1068;309;107206;44987;24.8;10.4
73;2021-05-02;34;165;107240;45152;24.8;10.4
73;2021-05-03;1392;1593;108632;46745;25.1;10.8
73;2021-05-04;1712;1828;110344;48573;25.5;11.2
73;2021-05-05;1976;1684;112320;50257;26.0;11.6
73;2021-05-06;2431;1695;114751;51952;26.5;12.0
73;2021-05-07;2259;1835;117010;53787;27.1;12.4
73;2021-05-08;1837;377;118847;54164;27.5;12.5
73;2021-05-09;127;126;118974;54290;27.5;12.6
73;2021-05-10;1608;1891;120582;56181;27.9;13.0
73;2021-05-11;2379;2367;122961;58548;28.4;13.5
73;2021-05-12;3556;2097;126517;60645;29.2;14.0
73;2021-05-13;1554;275;128071;60920;29.6;14.1
73;2021-05-14;1588;1492;129659;62412;30.0;14.4
73;2021-05-15;1447;943;131106;63355;30.3;14.6
73;2021-05-16;131;62;131237;63417;30.3;14.7
73;2021-05-17;1711;1948;132948;65365;30.7;15.1
73;2021-05-18;2495;1735;135443;67100;31.3;15.5
73;2021-05-19;2539;1623;137982;68723;31.9;15.9
73;2021-05-20;3161;1501;141143;70224;32.6;16.2
73;2021-05-21;2473;1849;143616;72073;33.2;16.7
73;2021-05-22;1989;923;145605;72996;33.7;16.9
73;2021-05-23;212;14;145817;73010;33.7;16.9
73;2021-05-24;2563;324;148380;73334;34.3;17.0
73;2021-05-25;2139;1741;150519;75075;34.8;17.4
73;2021-05-26;2343;1999;152862;77074;35.3;17.8
73;2021-05-27;3080;1713;155942;78787;36.1;18.2
73;2021-05-28;2918;2372;158860;81159;36.7;18.8
73;2021-05-29;2316;1321;161176;82480;37.3;19.1
73;2021-05-30;187;14;161363;82494;37.3;19.1
73;2021-05-31;2410;1631;163773;84125;37.9;19.4
73;2021-06-01;3178;1792;166951;85917;38.6;19.9
73;2021-06-02;3108;1454;170059;87371;39.3;20.2
73;2021-06-03;4422;1740;174481;89111;40.3;20.6
73;2021-06-04;4276;2184;178757;91295;41.3;21.1
73;2021-06-05;3161;1281;181918;92576;42.1;21.4
73;2021-06-06;1881;299;183799;92875;42.5;21.5
73;2021-06-07;2759;2148;186558;95023;43.1;22.0
73;2021-06-08;2684;1873;189242;96896;43.8;22.4
73;2021-06-09;2365;1789;191607;98685;44.3;22.8
73;2021-06-10;2005;1644;193612;100329;44.8;23.2
73;2021-06-11;2192;2441;195804;102770;45.3;23.8
73;2021-06-12;2245;1331;198049;104101;45.8;24.1
73;2021-06-13;44;82;198093;104183;45.8;24.1
73;2021-06-14;1347;2926;199440;107109;46.1;24.8
73;2021-06-15;1592;2754;201032;109863;46.5;25.4
73;2021-06-16;1466;2564;202498;112427;46.8;26.0
73;2021-06-17;947;1727;203445;114154;47.0;26.4
73;2021-06-18;1883;2931;205328;117085;47.5;27.1
73;2021-06-19;1423;1985;206751;119070;47.8;27.5
73;2021-06-20;448;307;207199;119377;47.9;27.6
73;2021-06-21;1111;2938;208310;122315;48.2;28.3
73;2021-06-22;1090;2870;209400;125185;48.4;28.9
73;2021-06-23;1085;3136;210485;128321;48.7;29.7
73;2021-06-24;883;1794;211368;130115;48.9;30.1
73;2021-06-25;1324;2793;212692;132908;49.2;30.7
73;2021-06-26;966;2398;213658;135306;49.4;31.3
73;2021-06-27;329;549;213987;135855;49.5;31.4
73;2021-06-28;971;3557;214958;139412;49.7;32.2
73;2021-06-29;1075;3340;216033;142752;49.9;33.0
73;2021-06-30;1239;3116;217272;145868;50.2;33.7
73;2021-07-01;1191;2362;218463;148230;50.5;34.3
73;2021-07-02;1203;3616;219666;151846;50.8;35.1
73;2021-07-03;961;2793;220627;154639;51.0;35.8
73;2021-07-04;301;619;220928;155258;51.1;35.9
73;2021-07-05;1157;3681;222085;158939;51.3;36.7
73;2021-07-06;1251;2951;223336;161890;51.6;37.4
73;2021-07-07;1443;2949;224779;164839;52.0;38.1
73;2021-07-08;1373;2296;226152;167135;52.3;38.6
73;2021-07-09;1431;4025;227583;171160;52.6;39.6
73;2021-07-10;891;3012;228474;174172;52.8;40.3
73;2021-07-11;561;1470;229035;175642;53.0;40.6
73;2021-07-12;1059;4194;230094;179836;53.2;41.6
73;2021-07-13;1729;4225;231823;184061;53.6;42.6
73;2021-07-14;1843;1919;233666;185980;54.0;43.0
73;2021-07-15;2747;3795;236413;189775;54.7;43.9
73;2021-07-16;2416;4016;238829;193791;55.2;44.8
73;2021-07-17;1515;2607;240344;196398;55.6;45.4
73;2021-07-18;1176;1218;241520;197616;55.8;45.7
73;2021-07-19;2449;3250;243969;200866;56.4;46.4
73;2021-07-20;3367;2855;247336;203721;57.2;47.1
73;2021-07-21;3382;2790;250718;206511;58.0;47.7
73;2021-07-22;2732;2215;253450;208726;58.6;48.3
73;2021-07-23;3417;2902;256867;211628;59.4;48.9
73;2021-07-24;2059;2280;258926;213908;59.9;49.5
73;2021-07-25;625;797;259551;214705;60.0;49.6
73;2021-07-26;2632;2494;262183;217199;60.6;50.2
73;2021-07-27;3813;2273;265996;219472;61.5;50.7
73;2021-07-28;3535;2095;269531;221567;62.3;51.2
73;2021-07-29;3980;2153;273511;223720;63.2;51.7
73;2021-07-30;3566;2475;277077;226195;64.1;52.3
73;2021-07-31;2476;1591;279553;227786;64.6;52.7
73;2021-08-01;834;620;280387;228406;64.8;52.8
73;2021-08-02;3104;2104;283491;230510;65.5;53.3
73;2021-08-03;3493;1999;286984;232509;66.3;53.8
73;2021-08-04;3299;2026;290283;234535;67.1;54.2
73;2021-08-05;2874;2232;293157;236767;67.8;54.7
73;2021-08-06;2509;2382;295666;239149;68.4;55.3
73;2021-08-07;1417;1482;297083;240631;68.7;55.6
73;2021-08-08;434;619;297517;241250;68.8;55.8
73;2021-08-09;1784;2396;299301;243646;69.2;56.3
73;2021-08-10;1897;2488;301198;246134;69.6;56.9
73;2021-08-11;1848;2535;303046;248669;70.1;57.5
73;2021-08-12;1683;2502;304729;251171;70.4;58.1
73;2021-08-13;1460;2841;306189;254012;70.8;58.7
73;2021-08-14;990;1534;307179;255546;71.0;59.1
73;2021-08-15;92;161;307271;255707;71.0;59.1
73;2021-08-16;952;1391;308223;257098;71.3;59.4
73;2021-08-17;963;1960;309186;259058;71.5;59.9
73;2021-08-18;1038;2841;310224;261899;71.7;60.5
73;2021-08-19;1045;3055;311269;264954;72.0;61.3
73;2021-08-20;852;3146;312121;268100;72.2;62.0
73;2021-08-21;461;1837;312582;269937;72.3;62.4
73;2021-08-22;268;936;312850;270873;72.3;62.6
73;2021-08-23;678;2970;313528;273843;72.5;63.3
73;2021-08-24;899;3160;314427;277003;72.7;64.0
73;2021-08-25;712;2907;315139;279910;72.9;64.7
73;2021-08-26;690;2424;315829;282334;73.0;65.3
73;2021-08-27;791;2749;316620;285083;73.2;65.9
73;2021-08-28;457;1748;317077;286831;73.3;66.3
73;2021-08-29;302;1015;317379;287846;73.4;66.5
73;2021-08-30;819;2590;318198;290436;73.6;67.1
73;2021-08-31;816;2392;319014;292828;73.8;67.7
73;2021-09-01;747;2244;319761;295072;73.9;68.2
73;2021-09-02;619;2018;320380;297090;74.1;68.7
73;2021-09-03;693;2210;321073;299300;74.2;69.2
73;2021-09-04;530;1463;321603;300763;74.4;69.5
73;2021-09-05;227;752;321830;301515;74.4;69.7
73;2021-09-06;348;1290;322178;302805;74.5;70.0
73;2021-09-07;414;1094;322592;303899;74.6;70.3
73;2021-09-08;489;1183;323081;305082;74.7;70.5
73;2021-09-09;463;1285;323544;306367;74.8;70.8
73;2021-09-10;573;1527;324117;307894;74.9;71.2
73;2021-09-11;351;1092;324468;308986;75.0;71.4
73;2021-09-12;96;163;324564;309149;75.0;71.5
73;2021-09-13;341;1029;324905;310178;75.1;71.7
73;2021-09-14;410;957;325315;311135;75.2;71.9
73;2021-09-15;424;815;325739;311950;75.3;72.1
73;2021-09-16;329;646;326068;312596;75.4;72.3
73;2021-09-17;377;868;326445;313464;75.5;72.5
73;2021-09-18;257;630;326702;314094;75.5;72.6
73;2021-09-19;46;205;326748;314299;75.5;72.7
73;2021-09-20;163;632;326911;314931;75.6;72.8
73;2021-09-21;297;535;327208;315466;75.6;72.9
73;2021-09-22;275;774;327483;316240;75.7;73.1
73;2021-09-23;280;476;327763;316716;75.8;73.2
73;2021-09-24;292;855;328055;317571;75.8;73.4
73;2021-09-25;189;723;328244;318294;75.9;73.6
73;2021-09-26;73;209;328317;318503;75.9;73.6
73;2021-09-27;243;498;328560;319001;76.0;73.7
73;2021-09-28;184;340;328744;319341;76.0;73.8
73;2021-09-29;219;674;328963;320015;76.1;74.0
74;2020-12-27;10;0;10;0;0.0;0.0
74;2020-12-28;9;0;19;0;0.0;0.0
74;2020-12-29;0;0;19;0;0.0;0.0
74;2020-12-30;5;0;24;0;0.0;0.0
74;2020-12-31;1;0;25;0;0.0;0.0
74;2021-01-01;0;0;25;0;0.0;0.0
74;2021-01-02;1;1;26;1;0.0;0.0
74;2021-01-03;0;0;26;1;0.0;0.0
74;2021-01-04;3;0;29;1;0.0;0.0
74;2021-01-05;4;0;33;1;0.0;0.0
74;2021-01-06;48;0;81;1;0.0;0.0
74;2021-01-07;220;1;301;2;0.0;0.0
74;2021-01-08;294;2;595;4;0.1;0.0
74;2021-01-09;78;0;673;4;0.1;0.0
74;2021-01-10;74;0;747;4;0.1;0.0
74;2021-01-11;375;0;1122;4;0.1;0.0
74;2021-01-12;408;3;1530;7;0.2;0.0
74;2021-01-13;396;0;1926;7;0.2;0.0
74;2021-01-14;482;1;2408;8;0.3;0.0
74;2021-01-15;645;4;3053;12;0.4;0.0
74;2021-01-16;254;1;3307;13;0.4;0.0
74;2021-01-17;134;1;3441;14;0.4;0.0
74;2021-01-18;527;0;3968;14;0.5;0.0
74;2021-01-19;814;2;4782;16;0.6;0.0
74;2021-01-20;1279;4;6061;20;0.7;0.0
74;2021-01-21;1570;2;7631;22;0.9;0.0
74;2021-01-22;1242;6;8873;28;1.1;0.0
74;2021-01-23;345;1;9218;29;1.1;0.0
74;2021-01-24;94;1;9312;30;1.1;0.0
74;2021-01-25;800;2;10112;32;1.2;0.0
74;2021-01-26;1371;14;11483;46;1.4;0.0
74;2021-01-27;1083;11;12566;57;1.5;0.0
74;2021-01-28;1001;28;13567;85;1.6;0.0
74;2021-01-29;881;35;14448;120;1.7;0.0
74;2021-01-30;305;1;14753;121;1.8;0.0
74;2021-01-31;87;1;14840;122;1.8;0.0
74;2021-02-01;632;44;15472;166;1.9;0.0
74;2021-02-02;645;147;16117;313;1.9;0.0
74;2021-02-03;605;114;16722;427;2.0;0.1
74;2021-02-04;615;122;17337;549;2.1;0.1
74;2021-02-05;556;186;17893;735;2.2;0.1
74;2021-02-06;274;111;18167;846;2.2;0.1
74;2021-02-07;93;102;18260;948;2.2;0.1
74;2021-02-08;620;310;18880;1258;2.3;0.2
74;2021-02-09;541;422;19421;1680;2.3;0.2
74;2021-02-10;688;467;20109;2147;2.4;0.3
74;2021-02-11;1081;933;21190;3080;2.6;0.4
74;2021-02-12;917;569;22107;3649;2.7;0.4
74;2021-02-13;407;212;22514;3861;2.7;0.5
74;2021-02-14;320;98;22834;3959;2.8;0.5
74;2021-02-15;281;634;23115;4593;2.8;0.6
74;2021-02-16;492;840;23607;5433;2.8;0.7
74;2021-02-17;530;896;24137;6329;2.9;0.8
74;2021-02-18;473;840;24610;7169;3.0;0.9
74;2021-02-19;619;567;25229;7736;3.0;0.9
74;2021-02-20;114;135;25343;7871;3.1;1.0
74;2021-02-21;48;49;25391;7920;3.1;1.0
74;2021-02-22;320;598;25711;8518;3.1;1.0
74;2021-02-23;307;674;26018;9192;3.1;1.1
74;2021-02-24;241;549;26259;9741;3.2;1.2
74;2021-02-25;523;599;26782;10340;3.2;1.2
74;2021-02-26;973;572;27755;10912;3.4;1.3
74;2021-02-27;254;137;28009;11049;3.4;1.3
74;2021-02-28;125;65;28134;11114;3.4;1.3
74;2021-03-01;723;552;28857;11666;3.5;1.4
74;2021-03-02;1093;567;29950;12233;3.6;1.5
74;2021-03-03;1023;544;30973;12777;3.7;1.5
74;2021-03-04;1611;894;32584;13671;3.9;1.7
74;2021-03-05;2092;792;34676;14463;4.2;1.7
74;2021-03-06;1762;301;36438;14764;4.4;1.8
74;2021-03-07;1386;103;37824;14867;4.6;1.8
74;2021-03-08;1197;849;39021;15716;4.7;1.9
74;2021-03-09;1956;591;40977;16307;4.9;2.0
74;2021-03-10;1749;789;42726;17096;5.2;2.1
74;2021-03-11;2451;662;45177;17758;5.5;2.1
74;2021-03-12;3246;970;48423;18728;5.8;2.3
74;2021-03-13;2001;267;50424;18995;6.1;2.3
74;2021-03-14;609;101;51033;19096;6.2;2.3
74;2021-03-15;2128;539;53161;19635;6.4;2.4
74;2021-03-16;1963;402;55124;20037;6.7;2.4
74;2021-03-17;1974;310;57098;20347;6.9;2.5
74;2021-03-18;2136;283;59234;20630;7.2;2.5
74;2021-03-19;2636;296;61870;20926;7.5;2.5
74;2021-03-20;1375;104;63245;21030;7.6;2.5
74;2021-03-21;290;32;63535;21062;7.7;2.5
74;2021-03-22;2054;316;65589;21378;7.9;2.6
74;2021-03-23;2723;337;68312;21715;8.2;2.6
74;2021-03-24;2948;306;71260;22021;8.6;2.7
74;2021-03-25;3875;309;75135;22330;9.1;2.7
74;2021-03-26;4095;386;79230;22716;9.6;2.7
74;2021-03-27;1941;261;81171;22977;9.8;2.8
74;2021-03-28;437;78;81608;23055;9.9;2.8
74;2021-03-29;3035;702;84643;23757;10.2;2.9
74;2021-03-30;3543;760;88186;24517;10.6;3.0
74;2021-03-31;3144;738;91330;25255;11.0;3.0
74;2021-04-01;4236;902;95566;26157;11.5;3.2
74;2021-04-02;3709;792;99275;26949;12.0;3.3
74;2021-04-03;1696;537;100971;27486;12.2;3.3
74;2021-04-04;236;122;101207;27608;12.2;3.3
74;2021-04-05;433;16;101640;27624;12.3;3.3
74;2021-04-06;2623;1206;104263;28830;12.6;3.5
74;2021-04-07;3195;1252;107458;30082;13.0;3.6
74;2021-04-08;3865;1191;111323;31273;13.4;3.8
74;2021-04-09;4111;1182;115434;32455;13.9;3.9
74;2021-04-10;1944;1027;117378;33482;14.2;4.0
74;2021-04-11;253;184;117631;33666;14.2;4.1
74;2021-04-12;2724;1778;120355;35444;14.5;4.3
74;2021-04-13;3124;2106;123479;37550;14.9;4.5
74;2021-04-14;2903;1972;126382;39522;15.3;4.8
74;2021-04-15;3462;1910;129844;41432;15.7;5.0
74;2021-04-16;3386;1789;133230;43221;16.1;5.2
74;2021-04-17;1936;1035;135166;44256;16.3;5.3
74;2021-04-18;218;211;135384;44467;16.3;5.4
74;2021-04-19;2100;2094;137484;46561;16.6;5.6
74;2021-04-20;3068;2416;140552;48977;17.0;5.9
74;2021-04-21;2463;2374;143015;51351;17.3;6.2
74;2021-04-22;2629;2338;145644;53689;17.6;6.5
74;2021-04-23;2572;2246;148216;55935;17.9;6.8
74;2021-04-24;1485;1540;149701;57475;18.1;6.9
74;2021-04-25;229;149;149930;57624;18.1;7.0
74;2021-04-26;2396;2462;152326;60086;18.4;7.3
74;2021-04-27;3271;2906;155597;62992;18.8;7.6
74;2021-04-28;3465;2629;159062;65621;19.2;7.9
74;2021-04-29;3909;2695;162971;68316;19.7;8.2
74;2021-04-30;4076;2225;167047;70541;20.2;8.5
74;2021-05-01;2121;397;169168;70938;20.4;8.6
74;2021-05-02;205;238;169373;71176;20.4;8.6
74;2021-05-03;2596;3021;171969;74197;20.8;9.0
74;2021-05-04;3217;3115;175186;77312;21.1;9.3
74;2021-05-05;3391;3021;178577;80333;21.6;9.7
74;2021-05-06;3858;2632;182435;82965;22.0;10.0
74;2021-05-07;3594;3541;186029;86506;22.5;10.4
74;2021-05-08;1145;827;187174;87333;22.6;10.5
74;2021-05-09;195;246;187369;87579;22.6;10.6
74;2021-05-10;3466;3143;190835;90722;23.0;11.0
74;2021-05-11;4317;3418;195152;94140;23.6;11.4
74;2021-05-12;5305;2963;200457;97103;24.2;11.7
74;2021-05-13;2357;950;202814;98053;24.5;11.8
74;2021-05-14;5956;2402;208770;100455;25.2;12.1
74;2021-05-15;4512;1848;213282;102303;25.7;12.3
74;2021-05-16;3012;338;216294;102641;26.1;12.4
74;2021-05-17;5396;2891;221690;105532;26.8;12.7
74;2021-05-18;6791;2817;228481;108349;27.6;13.1
74;2021-05-19;6234;2296;234715;110645;28.3;13.4
74;2021-05-20;6643;2557;241358;113202;29.1;13.7
74;2021-05-21;6526;2993;247884;116195;29.9;14.0
74;2021-05-22;5293;1568;253177;117763;30.6;14.2
74;2021-05-23;2052;282;255229;118045;30.8;14.2
74;2021-05-24;2362;660;257591;118705;31.1;14.3
74;2021-05-25;5073;3334;262664;122039;31.7;14.7
74;2021-05-26;5255;2563;267919;124602;32.3;15.0
74;2021-05-27;6001;2976;273920;127578;33.1;15.4
74;2021-05-28;5656;3576;279576;131154;33.7;15.8
74;2021-05-29;3799;2156;283375;133310;34.2;16.1
74;2021-05-30;488;309;283863;133619;34.3;16.1
74;2021-05-31;5070;3549;288933;137168;34.9;16.6
74;2021-06-01;4931;3726;293864;140894;35.5;17.0
74;2021-06-02;5269;3207;299133;144101;36.1;17.4
74;2021-06-03;6890;3247;306023;147348;36.9;17.8
74;2021-06-04;6911;4431;312934;151779;37.8;18.3
74;2021-06-05;4608;2706;317542;154485;38.3;18.6
74;2021-06-06;124;112;317666;154597;38.3;18.7
74;2021-06-07;5031;4144;322697;158741;39.0;19.2
74;2021-06-08;5025;3949;327722;162690;39.6;19.6
74;2021-06-09;5081;3481;332803;166171;40.2;20.1
74;2021-06-10;5123;2877;337926;169048;40.8;20.4
74;2021-06-11;5214;3812;343140;172860;41.4;20.9
74;2021-06-12;3567;2378;346707;175238;41.9;21.2
74;2021-06-13;120;89;346827;175327;41.9;21.2
74;2021-06-14;3595;4482;350422;179809;42.3;21.7
74;2021-06-15;3672;3896;354094;183705;42.7;22.2
74;2021-06-16;4827;3123;358921;186828;43.3;22.6
74;2021-06-17;3816;2953;362737;189781;43.8;22.9
74;2021-06-18;4113;4668;366850;194449;44.3;23.5
74;2021-06-19;2993;3101;369843;197550;44.6;23.8
74;2021-06-20;125;97;369968;197647;44.7;23.9
74;2021-06-21;2383;5418;372351;203065;44.9;24.5
74;2021-06-22;2493;5312;374844;208377;45.2;25.2
74;2021-06-23;2974;4618;377818;212995;45.6;25.7
74;2021-06-24;2865;4626;380683;217621;46.0;26.3
74;2021-06-25;2931;6768;383614;224389;46.3;27.1
74;2021-06-26;1705;5400;385319;229789;46.5;27.7
74;2021-06-27;66;1664;385385;231453;46.5;27.9
74;2021-06-28;1916;7219;387301;238672;46.8;28.8
74;2021-06-29;2297;7421;389598;246093;47.0;29.7
74;2021-06-30;2747;6544;392345;252637;47.4;30.5
74;2021-07-01;3526;5426;395871;258063;47.8;31.2
74;2021-07-02;3121;6639;398992;264702;48.2;32.0
74;2021-07-03;1698;5085;400690;269787;48.4;32.6
74;2021-07-04;81;1022;400771;270809;48.4;32.7
74;2021-07-05;2078;6829;402849;277638;48.6;33.5
74;2021-07-06;2799;6488;405648;284126;49.0;34.3
74;2021-07-07;3093;5446;408741;289572;49.3;35.0
74;2021-07-08;3865;4921;412606;294493;49.8;35.5
74;2021-07-09;2671;6974;415277;301467;50.1;36.4
74;2021-07-10;1622;5132;416899;306599;50.3;37.0
74;2021-07-11;76;142;416975;306741;50.3;37.0
74;2021-07-12;2095;7899;419070;314640;50.6;38.0
74;2021-07-13;3966;7585;423036;322225;51.1;38.9
74;2021-07-14;1968;2238;425004;324463;51.3;39.2
74;2021-07-15;3593;6875;428597;331338;51.7;40.0
74;2021-07-16;4242;7740;432839;339078;52.2;40.9
74;2021-07-17;3004;5330;435843;344408;52.6;41.6
74;2021-07-18;156;155;435999;344563;52.6;41.6
74;2021-07-19;4295;7351;440294;351914;53.1;42.5
74;2021-07-20;5873;6467;446167;358381;53.9;43.3
74;2021-07-21;5669;6674;451836;365055;54.5;44.1
74;2021-07-22;4773;5323;456609;370378;55.1;44.7
74;2021-07-23;6227;6993;462836;377371;55.9;45.6
74;2021-07-24;3154;4314;465990;381685;56.3;46.1
74;2021-07-25;181;171;466171;381856;56.3;46.1
74;2021-07-26;5617;6134;471788;387990;57.0;46.8
74;2021-07-27;6852;5176;478640;393166;57.8;47.5
74;2021-07-28;6659;5102;485299;398268;58.6;48.1
74;2021-07-29;5278;3930;490577;402198;59.2;48.6
74;2021-07-30;6714;5503;497291;407701;60.0;49.2
74;2021-07-31;4377;3122;501668;410823;60.6;49.6
74;2021-08-01;183;148;501851;410971;60.6;49.6
74;2021-08-02;6263;4408;508114;415379;61.3;50.1
74;2021-08-03;6036;3860;514150;419239;62.1;50.6
74;2021-08-04;6322;3506;520472;422745;62.8;51.0
74;2021-08-05;4930;3265;525402;426010;63.4;51.4
74;2021-08-06;5065;4182;530467;430192;64.0;51.9
74;2021-08-07;3210;2899;533677;433091;64.4;52.3
74;2021-08-08;153;134;533830;433225;64.4;52.3
74;2021-08-09;4973;4828;538803;438053;65.0;52.9
74;2021-08-10;4986;4685;543789;442738;65.6;53.4
74;2021-08-11;4413;4889;548202;447627;66.2;54.0
74;2021-08-12;3609;3607;551811;451234;66.6;54.5
74;2021-08-13;3817;4625;555628;455859;67.1;55.0
74;2021-08-14;2184;3342;557812;459201;67.3;55.4
74;2021-08-15;62;102;557874;459303;67.3;55.4
74;2021-08-16;3859;5876;561733;465179;67.8;56.2
74;2021-08-17;3132;5486;564865;470665;68.2;56.8
74;2021-08-18;3085;5459;567950;476124;68.6;57.5
74;2021-08-19;2353;3898;570303;480022;68.8;57.9
74;2021-08-20;2628;5697;572931;485719;69.2;58.6
74;2021-08-21;1239;4273;574170;489992;69.3;59.1
74;2021-08-22;56;137;574226;490129;69.3;59.2
74;2021-08-23;2186;6696;576412;496825;69.6;60.0
74;2021-08-24;2216;5938;578628;502763;69.8;60.7
74;2021-08-25;1967;6293;580595;509056;70.1;61.5
74;2021-08-26;1547;3786;582142;512842;70.3;61.9
74;2021-08-27;1917;5508;584059;518350;70.5;62.6
74;2021-08-28;926;4039;584985;522389;70.6;63.1
74;2021-08-29;66;188;585051;522577;70.6;63.1
74;2021-08-30;1841;5483;586892;528060;70.8;63.7
74;2021-08-31;1673;5125;588565;533185;71.0;64.4
74;2021-09-01;1798;4154;590363;537339;71.3;64.9
74;2021-09-02;1214;3035;591577;540374;71.4;65.2
74;2021-09-03;1499;4186;593076;544560;71.6;65.7
74;2021-09-04;1143;2846;594219;547406;71.7;66.1
74;2021-09-05;48;96;594267;547502;71.7;66.1
74;2021-09-06;1240;3376;595507;550878;71.9;66.5
74;2021-09-07;1025;3053;596532;553931;72.0;66.9
74;2021-09-08;1303;3179;597835;557110;72.2;67.3
74;2021-09-09;1212;2210;599047;559320;72.3;67.5
74;2021-09-10;1113;3108;600160;562428;72.4;67.9
74;2021-09-11;753;2322;600913;564750;72.5;68.2
74;2021-09-12;40;80;600953;564830;72.5;68.2
74;2021-09-13;956;2631;601909;567461;72.7;68.5
74;2021-09-14;1054;2477;602963;569938;72.8;68.8
74;2021-09-15;1055;2268;604018;572206;72.9;69.1
74;2021-09-16;747;1030;604765;573236;73.0;69.2
74;2021-09-17;828;1848;605593;575084;73.1;69.4
74;2021-09-18;604;1670;606197;576754;73.2;69.6
74;2021-09-19;3;9;606200;576763;73.2;69.6
74;2021-09-20;799;1881;606999;578644;73.3;69.9
74;2021-09-21;638;1371;607637;580015;73.4;70.0
74;2021-09-22;617;2100;608254;582115;73.4;70.3
74;2021-09-23;639;995;608893;583110;73.5;70.4
74;2021-09-24;722;1967;609615;585077;73.6;70.6
74;2021-09-25;461;1619;610076;586696;73.6;70.8
74;2021-09-26;1;2;610077;586698;73.6;70.8
74;2021-09-27;571;1774;610648;588472;73.7;71.0
74;2021-09-28;390;954;611038;589426;73.8;71.2
74;2021-09-29;535;1561;611573;590987;73.8;71.3
75;2020-12-27;72;1;72;1;0.0;0.0
75;2020-12-28;63;0;135;1;0.0;0.0
75;2020-12-29;33;0;168;1;0.0;0.0
75;2020-12-30;86;0;254;1;0.0;0.0
75;2020-12-31;47;0;301;1;0.0;0.0
75;2021-01-01;62;3;363;4;0.0;0.0
75;2021-01-02;64;1;427;5;0.0;0.0
75;2021-01-03;107;1;534;6;0.0;0.0
75;2021-01-04;323;1;857;7;0.0;0.0
75;2021-01-05;882;10;1739;17;0.1;0.0
75;2021-01-06;1369;16;3108;33;0.1;0.0
75;2021-01-07;2070;19;5178;52;0.2;0.0
75;2021-01-08;2881;30;8059;82;0.4;0.0
75;2021-01-09;1097;2;9156;84;0.4;0.0
75;2021-01-10;1101;4;10257;88;0.5;0.0
75;2021-01-11;3119;46;13376;134;0.6;0.0
75;2021-01-12;3490;51;16866;185;0.8;0.0
75;2021-01-13;3575;44;20441;229;1.0;0.0
75;2021-01-14;3786;61;24227;290;1.1;0.0
75;2021-01-15;3340;46;27567;336;1.3;0.0
75;2021-01-16;1147;14;28714;350;1.3;0.0
75;2021-01-17;562;14;29276;364;1.4;0.0
75;2021-01-18;3290;69;32566;433;1.5;0.0
75;2021-01-19;3873;47;36439;480;1.7;0.0
75;2021-01-20;4438;59;40877;539;1.9;0.0
75;2021-01-21;4949;71;45826;610;2.1;0.0
75;2021-01-22;4606;69;50432;679;2.3;0.0
75;2021-01-23;1767;12;52199;691;2.4;0.0
75;2021-01-24;761;7;52960;698;2.5;0.0
75;2021-01-25;1739;24;54699;722;2.5;0.0
75;2021-01-26;2564;80;57263;802;2.7;0.0
75;2021-01-27;3167;148;60430;950;2.8;0.0
75;2021-01-28;4789;229;65219;1179;3.0;0.1
75;2021-01-29;4063;237;69282;1416;3.2;0.1
75;2021-01-30;1362;18;70644;1434;3.3;0.1
75;2021-01-31;225;3;70869;1437;3.3;0.1
75;2021-02-01;1634;339;72503;1776;3.4;0.1
75;2021-02-02;2152;583;74655;2359;3.5;0.1
75;2021-02-03;1894;632;76549;2991;3.6;0.1
75;2021-02-04;2153;1034;78702;4025;3.7;0.2
75;2021-02-05;2224;755;80926;4780;3.8;0.2
75;2021-02-06;1135;73;82061;4853;3.8;0.2
75;2021-02-07;179;6;82240;4859;3.8;0.2
75;2021-02-08;1267;1273;83507;6132;3.9;0.3
75;2021-02-09;1802;2186;85309;8318;4.0;0.4
75;2021-02-10;2428;2169;87737;10487;4.1;0.5
75;2021-02-11;2951;4878;90688;15365;4.2;0.7
75;2021-02-12;3136;2223;93824;17588;4.4;0.8
75;2021-02-13;858;820;94682;18408;4.4;0.9
75;2021-02-14;211;39;94893;18447;4.4;0.9
75;2021-02-15;1010;1888;95903;20335;4.5;0.9
75;2021-02-16;1466;5125;97369;25460;4.5;1.2
75;2021-02-17;1342;2436;98711;27896;4.6;1.3
75;2021-02-18;1778;4499;100489;32395;4.7;1.5
75;2021-02-19;2230;3259;102719;35654;4.8;1.7
75;2021-02-20;485;1280;103204;36934;4.8;1.7
75;2021-02-21;201;112;103405;37046;4.8;1.7
75;2021-02-22;1228;1475;104633;38521;4.9;1.8
75;2021-02-23;1468;1974;106101;40495;4.9;1.9
75;2021-02-24;1700;1739;107801;42234;5.0;2.0
75;2021-02-25;2796;4291;110597;46525;5.1;2.2
75;2021-02-26;3384;2050;113981;48575;5.3;2.3
75;2021-02-27;1408;690;115389;49265;5.4;2.3
75;2021-02-28;330;99;115719;49364;5.4;2.3
75;2021-03-01;2601;1337;118320;50701;5.5;2.4
75;2021-03-02;4192;1671;122512;52372;5.7;2.4
75;2021-03-03;5442;1870;127954;54242;6.0;2.5
75;2021-03-04;8061;2130;136015;56372;6.3;2.6
75;2021-03-05;10580;2270;146595;58642;6.8;2.7
75;2021-03-06;11081;951;157676;59593;7.3;2.8
75;2021-03-07;9512;1404;167188;60997;7.8;2.8
75;2021-03-08;5926;1376;173114;62373;8.1;2.9
75;2021-03-09;7536;1892;180650;64265;8.4;3.0
75;2021-03-10;7523;1952;188173;66217;8.8;3.1
75;2021-03-11;10365;2342;198538;68559;9.2;3.2
75;2021-03-12;12072;2407;210610;70966;9.8;3.3
75;2021-03-13;8560;749;219170;71715;10.2;3.3
75;2021-03-14;4175;260;223345;71975;10.4;3.4
75;2021-03-15;7475;963;230820;72938;10.7;3.4
75;2021-03-16;5168;680;235988;73618;11.0;3.4
75;2021-03-17;5432;823;241420;74441;11.2;3.5
75;2021-03-18;6629;851;248049;75292;11.5;3.5
75;2021-03-19;9768;984;257817;76276;12.0;3.6
75;2021-03-20;5942;602;263759;76878;12.3;3.6
75;2021-03-21;1595;424;265354;77302;12.4;3.6
75;2021-03-22;8665;1017;274019;78319;12.8;3.6
75;2021-03-23;10967;1255;284986;79574;13.3;3.7
75;2021-03-24;11016;1327;296002;80901;13.8;3.8
75;2021-03-25;14223;1539;310225;82440;14.4;3.8
75;2021-03-26;13989;1701;324214;84141;15.1;3.9
75;2021-03-27;7289;765;331503;84906;15.4;4.0
75;2021-03-28;1788;151;333291;85057;15.5;4.0
75;2021-03-29;7978;2171;341269;87228;15.9;4.1
75;2021-03-30;10948;3205;352217;90433;16.4;4.2
75;2021-03-31;9753;3563;361970;93996;16.8;4.4
75;2021-04-01;10714;5172;372684;99168;17.3;4.6
75;2021-04-02;9066;5534;381750;104702;17.8;4.9
75;2021-04-03;4126;4846;385876;109548;18.0;5.1
75;2021-04-04;1424;1455;387300;111003;18.0;5.2
75;2021-04-05;2260;1316;389560;112319;18.1;5.2
75;2021-04-06;6930;4253;396490;116572;18.5;5.4
75;2021-04-07;8105;4376;404595;120948;18.8;5.6
75;2021-04-08;11093;4167;415688;125115;19.3;5.8
75;2021-04-09;12218;4617;427906;129732;19.9;6.0
75;2021-04-10;5848;4237;433754;133969;20.2;6.2
75;2021-04-11;1949;1784;435703;135753;20.3;6.3
75;2021-04-12;7489;3782;443192;139535;20.6;6.5
75;2021-04-13;8573;6780;451765;146315;21.0;6.8
75;2021-04-14;8306;5214;460071;151529;21.4;7.1
75;2021-04-15;8930;6127;469001;157656;21.8;7.3
75;2021-04-16;9393;6104;478394;163760;22.3;7.6
75;2021-04-17;4822;3637;483216;167397;22.5;7.8
75;2021-04-18;1672;876;484888;168273;22.6;7.8
75;2021-04-19;5592;4939;490480;173212;22.8;8.1
75;2021-04-20;6472;5944;496952;179156;23.1;8.3
75;2021-04-21;6881;5562;503833;184718;23.5;8.6
75;2021-04-22;7548;5897;511381;190615;23.8;8.9
75;2021-04-23;8688;6439;520069;197054;24.2;9.2
75;2021-04-24;6184;3346;526253;200400;24.5;9.3
75;2021-04-25;2970;760;529223;201160;24.6;9.4
75;2021-04-26;7030;4699;536253;205859;25.0;9.6
75;2021-04-27;10600;6388;546853;212247;25.5;9.9
75;2021-04-28;12202;5982;559055;218229;26.0;10.2
75;2021-04-29;13764;6317;572819;224546;26.7;10.5
75;2021-04-30;13669;6145;586488;230691;27.3;10.7
75;2021-05-01;5082;1324;591570;232015;27.5;10.8
75;2021-05-02;2389;789;593959;232804;27.6;10.8
75;2021-05-03;10295;13446;604254;246250;28.1;11.5
75;2021-05-04;11195;8060;615449;254310;28.6;11.8
75;2021-05-05;13564;6694;629013;261004;29.3;12.1
75;2021-05-06;14008;8173;643021;269177;29.9;12.5
75;2021-05-07;13984;8556;657005;277733;30.6;12.9
75;2021-05-08;10086;5508;667091;283241;31.1;13.2
75;2021-05-09;3821;3179;670912;286420;31.2;13.3
75;2021-05-10;14298;6705;685210;293125;31.9;13.6
75;2021-05-11;16849;8383;702059;301508;32.7;14.0
75;2021-05-12;17963;8132;720022;309640;33.5;14.4
75;2021-05-13;13642;2487;733664;312127;34.2;14.5
75;2021-05-14;18396;5119;752060;317246;35.0;14.8
75;2021-05-15;12326;2655;764386;319901;35.6;14.9
75;2021-05-16;3860;758;768246;320659;35.8;14.9
75;2021-05-17;16011;4644;784257;325303;36.5;15.1
75;2021-05-18;19161;5310;803418;330613;37.4;15.4
75;2021-05-19;20729;10692;824147;341305;38.4;15.9
75;2021-05-20;21584;8655;845731;349960;39.4;16.3
75;2021-05-21;21031;6543;866762;356503;40.3;16.6
75;2021-05-22;15904;3293;882666;359796;41.1;16.7
75;2021-05-23;5639;1335;888305;361131;41.3;16.8
75;2021-05-24;15634;2559;903939;363690;42.1;16.9
75;2021-05-25;18035;9560;921974;373250;42.9;17.4
75;2021-05-26;18887;8196;940861;381446;43.8;17.8
75;2021-05-27;20142;9792;961003;391238;44.7;18.2
75;2021-05-28;19339;10827;980342;402065;45.6;18.7
75;2021-05-29;16113;5834;996455;407899;46.4;19.0
75;2021-05-30;7040;2157;1003495;410056;46.7;19.1
75;2021-05-31;18094;9429;1021589;419485;47.6;19.5
75;2021-06-01;18694;12963;1040283;432448;48.4;20.1
75;2021-06-02;18120;10294;1058403;442742;49.3;20.6
75;2021-06-03;20252;11946;1078655;454688;50.2;21.2
75;2021-06-04;18116;12824;1096771;467512;51.1;21.8
75;2021-06-05;11988;9613;1108759;477125;51.6;22.2
75;2021-06-06;6724;3156;1115483;480281;51.9;22.4
75;2021-06-07;13891;11815;1129374;492096;52.6;22.9
75;2021-06-08;14799;13953;1144173;506049;53.3;23.6
75;2021-06-09;16509;15234;1160682;521283;54.0;24.3
75;2021-06-10;18362;26286;1179044;547569;54.9;25.5
75;2021-06-11;15310;16455;1194354;564024;55.6;26.3
75;2021-06-12;13282;10001;1207636;574025;56.2;26.7
75;2021-06-13;6276;3794;1213912;577819;56.5;26.9
75;2021-06-14;11822;15390;1225734;593209;57.1;27.6
75;2021-06-15;12729;19542;1238463;612751;57.6;28.5
75;2021-06-16;12205;17232;1250668;629983;58.2;29.3
75;2021-06-17;12658;17667;1263326;647650;58.8;30.1
75;2021-06-18;11273;22600;1274599;670250;59.3;31.2
75;2021-06-19;7529;11820;1282128;682070;59.7;31.7
75;2021-06-20;2819;5473;1284947;687543;59.8;32.0
75;2021-06-21;8513;16327;1293460;703870;60.2;32.8
75;2021-06-22;8809;21792;1302269;725662;60.6;33.8
75;2021-06-23;10304;21423;1312573;747085;61.1;34.8
75;2021-06-24;11318;20638;1323891;767723;61.6;35.7
75;2021-06-25;9873;24681;1333764;792404;62.1;36.9
75;2021-06-26;7934;15419;1341698;807823;62.5;37.6
75;2021-06-27;2702;6325;1344400;814148;62.6;37.9
75;2021-06-28;8471;20143;1352871;834291;63.0;38.8
75;2021-06-29;9344;23819;1362215;858110;63.4;39.9
75;2021-06-30;10211;23620;1372426;881730;63.9;41.0
75;2021-07-01;11430;23511;1383856;905241;64.4;42.1
75;2021-07-02;10881;24770;1394737;930011;64.9;43.3
75;2021-07-03;7817;19801;1402554;949812;65.3;44.2
75;2021-07-04;3906;9556;1406460;959368;65.5;44.7
75;2021-07-05;9344;21581;1415804;980949;65.9;45.7
75;2021-07-06;10166;24008;1425970;1004957;66.4;46.8
75;2021-07-07;10158;25088;1436128;1030045;66.9;47.9
75;2021-07-08;10672;25021;1446800;1055066;67.3;49.1
75;2021-07-09;10865;24030;1457665;1079096;67.9;50.2
75;2021-07-10;7949;18499;1465614;1097595;68.2;51.1
75;2021-07-11;4351;8529;1469965;1106124;68.4;51.5
75;2021-07-12;9857;23084;1479822;1129208;68.9;52.6
75;2021-07-13;14395;24804;1494217;1154012;69.6;53.7
75;2021-07-14;8354;9725;1502571;1163737;69.9;54.2
75;2021-07-15;15587;25660;1518158;1189397;70.7;55.4
75;2021-07-16;15822;22143;1533980;1211540;71.4;56.4
75;2021-07-17;12198;16909;1546178;1228449;72.0;57.2
75;2021-07-18;6267;6841;1552445;1235290;72.3;57.5
75;2021-07-19;14400;21294;1566845;1256584;72.9;58.5
75;2021-07-20;16072;21898;1582917;1278482;73.7;59.5
75;2021-07-21;15714;20706;1598631;1299188;74.4;60.5
75;2021-07-22;17148;20089;1615779;1319277;75.2;61.4
75;2021-07-23;17164;19107;1632943;1338384;76.0;62.3
75;2021-07-24;11192;14076;1644135;1352460;76.5;63.0
75;2021-07-25;5003;5070;1649138;1357530;76.8;63.2
75;2021-07-26;15182;16872;1664320;1374402;77.5;64.0
75;2021-07-27;18143;16660;1682463;1391062;78.3;64.8
75;2021-07-28;17143;15483;1699606;1406545;79.1;65.5
75;2021-07-29;16772;15094;1716378;1421639;79.9;66.2
75;2021-07-30;16675;14351;1733053;1435990;80.7;66.8
75;2021-07-31;9346;9865;1742399;1445855;81.1;67.3
75;2021-08-01;3712;3256;1746111;1449111;81.3;67.5
75;2021-08-02;10951;11981;1757062;1461092;81.8;68.0
75;2021-08-03;11126;10836;1768188;1471928;82.3;68.5
75;2021-08-04;9730;9485;1777918;1481413;82.8;69.0
75;2021-08-05;8721;9552;1786639;1490965;83.2;69.4
75;2021-08-06;8251;9992;1794890;1500957;83.6;69.9
75;2021-08-07;5702;7158;1800592;1508115;83.8;70.2
75;2021-08-08;1959;3280;1802551;1511395;83.9;70.4
75;2021-08-09;8609;11473;1811160;1522868;84.3;70.9
75;2021-08-10;9269;11585;1820429;1534453;84.7;71.4
75;2021-08-11;7786;10144;1828215;1544597;85.1;71.9
75;2021-08-12;6935;10598;1835150;1555195;85.4;72.4
75;2021-08-13;6251;8867;1841401;1564062;85.7;72.8
75;2021-08-14;4111;7196;1845512;1571258;85.9;73.1
75;2021-08-15;1024;1935;1846536;1573193;86.0;73.2
75;2021-08-16;6133;14032;1852669;1587225;86.2;73.9
75;2021-08-17;5810;13602;1858479;1600827;86.5;74.5
75;2021-08-18;5080;12009;1863559;1612836;86.7;75.1
75;2021-08-19;4769;12686;1868328;1625522;87.0;75.7
75;2021-08-20;4559;11788;1872887;1637310;87.2;76.2
75;2021-08-21;3182;8809;1876069;1646119;87.3;76.6
75;2021-08-22;995;3163;1877064;1649282;87.4;76.8
75;2021-08-23;4914;15305;1881978;1664587;87.6;77.5
75;2021-08-24;4800;14533;1886778;1679120;87.8;78.2
75;2021-08-25;4519;12334;1891297;1691454;88.0;78.7
75;2021-08-26;4076;10280;1895373;1701734;88.2;79.2
75;2021-08-27;4446;11676;1899819;1713410;88.4;79.8
75;2021-08-28;3069;8303;1902888;1721713;88.6;80.1
75;2021-08-29;752;2018;1903640;1723731;88.6;80.2
75;2021-08-30;4506;14665;1908146;1738396;88.8;80.9
75;2021-08-31;4391;13814;1912537;1752210;89.0;81.6
75;2021-09-01;3933;11408;1916470;1763618;89.2;82.1
75;2021-09-02;3208;9619;1919678;1773237;89.4;82.5
75;2021-09-03;3670;10404;1923348;1783641;89.5;83.0
75;2021-09-04;3549;8923;1926897;1792564;89.7;83.4
75;2021-09-05;703;1715;1927600;1794279;89.7;83.5
75;2021-09-06;2573;8080;1930173;1802359;89.8;83.9
75;2021-09-07;2357;7378;1932530;1809737;90.0;84.2
75;2021-09-08;2568;7334;1935098;1817071;90.1;84.6
75;2021-09-09;2358;6830;1937456;1823901;90.2;84.9
75;2021-09-10;2672;8037;1940128;1831938;90.3;85.3
75;2021-09-11;2355;6969;1942483;1838907;90.4;85.6
75;2021-09-12;500;1197;1942983;1840104;90.4;85.7
75;2021-09-13;2257;6491;1945240;1846595;90.5;86.0
75;2021-09-14;2235;5655;1947475;1852250;90.7;86.2
75;2021-09-15;2272;4642;1949747;1856892;90.8;86.4
75;2021-09-16;1884;3708;1951631;1860600;90.8;86.6
75;2021-09-17;2523;4756;1954154;1865356;91.0;86.8
75;2021-09-18;1561;4675;1955715;1870031;91.0;87.0
75;2021-09-19;283;736;1955998;1870767;91.0;87.1
75;2021-09-20;1689;3637;1957687;1874404;91.1;87.3
75;2021-09-21;1617;3197;1959304;1877601;91.2;87.4
75;2021-09-22;1587;3962;1960891;1881563;91.3;87.6
75;2021-09-23;1412;2837;1962303;1884400;91.3;87.7
75;2021-09-24;1789;4020;1964092;1888420;91.4;87.9
75;2021-09-25;1261;4347;1965353;1892767;91.5;88.1
75;2021-09-26;275;524;1965628;1893291;91.5;88.1
75;2021-09-27;1299;3001;1966927;1896292;91.6;88.3
75;2021-09-28;1393;2465;1968320;1898757;91.6;88.4
75;2021-09-29;1356;2860;1969676;1901617;91.7;88.5
76;2020-12-27;0;0;0;0;0.0;0.0
76;2020-12-28;1;0;1;0;0.0;0.0
76;2020-12-29;0;0;1;0;0.0;0.0
76;2020-12-30;0;0;1;0;0.0;0.0
76;2020-12-31;0;0;1;0;0.0;0.0
76;2021-01-01;0;0;1;0;0.0;0.0
76;2021-01-02;0;0;1;0;0.0;0.0
76;2021-01-03;0;0;1;0;0.0;0.0
76;2021-01-04;17;0;18;0;0.0;0.0
76;2021-01-05;138;0;156;0;0.0;0.0
76;2021-01-06;682;2;838;2;0.1;0.0
76;2021-01-07;1354;7;2192;9;0.2;0.0
76;2021-01-08;1537;2;3729;11;0.3;0.0
76;2021-01-09;735;2;4464;13;0.4;0.0
76;2021-01-10;492;1;4956;14;0.4;0.0
76;2021-01-11;1358;2;6314;16;0.5;0.0
76;2021-01-12;1358;2;7672;18;0.6;0.0
76;2021-01-13;1187;4;8859;22;0.7;0.0
76;2021-01-14;2178;23;11037;45;0.9;0.0
76;2021-01-15;1910;9;12947;54;1.0;0.0
76;2021-01-16;990;7;13937;61;1.1;0.0
76;2021-01-17;2898;19;16835;80;1.4;0.0
76;2021-01-18;4395;16;21230;96;1.7;0.0
76;2021-01-19;3021;8;24251;104;1.9;0.0
76;2021-01-20;2072;6;26323;110;2.1;0.0
76;2021-01-21;1773;4;28096;114;2.3;0.0
76;2021-01-22;1705;4;29801;118;2.4;0.0
76;2021-01-23;450;2;30251;120;2.4;0.0
76;2021-01-24;99;0;30350;120;2.4;0.0
76;2021-01-25;1475;135;31825;255;2.6;0.0
76;2021-01-26;1394;323;33219;578;2.7;0.0
76;2021-01-27;1341;411;34560;989;2.8;0.1
76;2021-01-28;1286;366;35846;1355;2.9;0.1
76;2021-01-29;1156;429;37002;1784;3.0;0.1
76;2021-01-30;283;274;37285;2058;3.0;0.2
76;2021-01-31;4;91;37289;2149;3.0;0.2
76;2021-02-01;841;738;38130;2887;3.1;0.2
76;2021-02-02;1055;941;39185;3828;3.2;0.3
76;2021-02-03;921;901;40106;4729;3.2;0.4
76;2021-02-04;976;1366;41082;6095;3.3;0.5
76;2021-02-05;975;1036;42057;7131;3.4;0.6
76;2021-02-06;263;770;42320;7901;3.4;0.6
76;2021-02-07;468;1481;42788;9382;3.4;0.8
76;2021-02-08;1921;3328;44709;12710;3.6;1.0
76;2021-02-09;1753;2600;46462;15310;3.7;1.2
76;2021-02-10;1488;1610;47950;16920;3.9;1.4
76;2021-02-11;1680;1297;49630;18217;4.0;1.5
76;2021-02-12;1706;1349;51336;19566;4.1;1.6
76;2021-02-13;230;278;51566;19844;4.1;1.6
76;2021-02-14;9;80;51575;19924;4.1;1.6
76;2021-02-15;552;1337;52127;21261;4.2;1.7
76;2021-02-16;742;1276;52869;22537;4.3;1.8
76;2021-02-17;626;1100;53495;23637;4.3;1.9
76;2021-02-18;780;1050;54275;24687;4.4;2.0
76;2021-02-19;870;1019;55145;25706;4.4;2.1
76;2021-02-20;270;228;55415;25934;4.5;2.1
76;2021-02-21;0;0;55415;25934;4.5;2.1
76;2021-02-22;371;943;55786;26877;4.5;2.2
76;2021-02-23;576;908;56362;27785;4.5;2.2
76;2021-02-24;600;902;56962;28687;4.6;2.3
76;2021-02-25;1665;956;58627;29643;4.7;2.4
76;2021-02-26;2171;817;60798;30460;4.9;2.4
76;2021-02-27;1109;229;61907;30689;5.0;2.5
76;2021-02-28;27;182;61934;30871;5.0;2.5
76;2021-03-01;830;1783;62764;32654;5.0;2.6
76;2021-03-02;1382;1464;64146;34118;5.2;2.7
76;2021-03-03;1942;1164;66088;35282;5.3;2.8
76;2021-03-04;2819;938;68907;36220;5.5;2.9
76;2021-03-05;4183;697;73090;36917;5.9;3.0
76;2021-03-06;3366;155;76456;37072;6.1;3.0
76;2021-03-07;1257;31;77713;37103;6.2;3.0
76;2021-03-08;2102;1101;79815;38204;6.4;3.1
76;2021-03-09;3574;1016;83389;39220;6.7;3.2
76;2021-03-10;3595;953;86984;40173;7.0;3.2
76;2021-03-11;5633;876;92617;41049;7.4;3.3
76;2021-03-12;6830;575;99447;41624;8.0;3.3
76;2021-03-13;4645;148;104092;41772;8.4;3.4
76;2021-03-14;1068;26;105160;41798;8.5;3.4
76;2021-03-15;2919;232;108079;42030;8.7;3.4
76;2021-03-16;2557;394;110636;42424;8.9;3.4
76;2021-03-17;2696;308;113332;42732;9.1;3.4
76;2021-03-18;3003;305;116335;43037;9.4;3.5
76;2021-03-19;4398;429;120733;43466;9.7;3.5
76;2021-03-20;3974;286;124707;43752;10.0;3.5
76;2021-03-21;838;16;125545;43768;10.1;3.5
76;2021-03-22;3992;349;129537;44117;10.4;3.5
76;2021-03-23;5709;355;135246;44472;10.9;3.6
76;2021-03-24;5701;393;140947;44865;11.3;3.6
76;2021-03-25;7505;575;148452;45440;11.9;3.7
76;2021-03-26;8721;590;157173;46030;12.6;3.7
76;2021-03-27;4809;391;161982;46421;13.0;3.7
76;2021-03-28;1021;32;163003;46453;13.1;3.7
76;2021-03-29;5388;817;168391;47270;13.5;3.8
76;2021-03-30;6587;1054;174978;48324;14.1;3.9
76;2021-03-31;6462;1257;181440;49581;14.6;4.0
76;2021-04-01;6786;2013;188226;51594;15.1;4.1
76;2021-04-02;6485;2676;194711;54270;15.7;4.4
76;2021-04-03;2442;1077;197153;55347;15.9;4.4
76;2021-04-04;265;10;197418;55357;15.9;4.5
76;2021-04-05;869;377;198287;55734;15.9;4.5
76;2021-04-06;3556;2778;201843;58512;16.2;4.7
76;2021-04-07;4415;2391;206258;60903;16.6;4.9
76;2021-04-08;5841;2775;212099;63678;17.1;5.1
76;2021-04-09;8803;3069;220902;66747;17.8;5.4
76;2021-04-10;4876;1422;225778;68169;18.2;5.5
76;2021-04-11;814;535;226592;68704;18.2;5.5
76;2021-04-12;4726;2844;231318;71548;18.6;5.8
76;2021-04-13;5925;2852;237243;74400;19.1;6.0
76;2021-04-14;4802;3126;242045;77526;19.5;6.2
76;2021-04-15;5562;3352;247607;80878;19.9;6.5
76;2021-04-16;7354;3441;254961;84319;20.5;6.8
76;2021-04-17;4386;1430;259347;85749;20.9;6.9
76;2021-04-18;339;141;259686;85890;20.9;6.9
76;2021-04-19;3478;3767;263164;89657;21.2;7.2
76;2021-04-20;4344;4276;267508;93933;21.5;7.6
76;2021-04-21;4192;4680;271700;98613;21.8;7.9
76;2021-04-22;4563;5435;276263;104048;22.2;8.4
76;2021-04-23;5444;5969;281707;110017;22.6;8.8
76;2021-04-24;4164;2190;285871;112207;23.0;9.0
76;2021-04-25;894;268;286765;112475;23.1;9.0
76;2021-04-26;4484;4461;291249;116936;23.4;9.4
76;2021-04-27;5000;4981;296249;121917;23.8;9.8
76;2021-04-28;5348;4144;301597;126061;24.2;10.1
76;2021-04-29;6926;4143;308523;130204;24.8;10.5
76;2021-04-30;8219;4606;316742;134810;25.5;10.8
76;2021-05-01;4827;1012;321569;135822;25.9;10.9
76;2021-05-02;1842;265;323411;136087;26.0;10.9
76;2021-05-03;4703;3297;328114;139384;26.4;11.2
76;2021-05-04;4822;4535;332936;143919;26.8;11.6
76;2021-05-05;4783;5167;337719;149086;27.2;12.0
76;2021-05-06;5923;5565;343642;154651;27.6;12.4
76;2021-05-07;6137;6738;349779;161389;28.1;13.0
76;2021-05-08;5056;908;354835;162297;28.5;13.0
76;2021-05-09;2538;234;357373;162531;28.7;13.1
76;2021-05-10;4947;5060;362320;167591;29.1;13.5
76;2021-05-11;6519;5675;368839;173266;29.7;13.9
76;2021-05-12;6263;5082;375102;178348;30.2;14.3
76;2021-05-13;8842;1284;383944;179632;30.9;14.4
76;2021-05-14;10415;4659;394359;184291;31.7;14.8
76;2021-05-15;9118;2456;403477;186747;32.4;15.0
76;2021-05-16;6236;479;409713;187226;32.9;15.1
76;2021-05-17;7226;3272;416939;190498;33.5;15.3
76;2021-05-18;8304;2815;425243;193313;34.2;15.5
76;2021-05-19;8401;3200;433644;196513;34.9;15.8
76;2021-05-20;9651;3426;443295;199939;35.6;16.1
76;2021-05-21;8368;4088;451663;204027;36.3;16.4
76;2021-05-22;7163;2357;458826;206384;36.9;16.6
76;2021-05-23;6388;416;465214;206800;37.4;16.6
76;2021-05-24;6864;1524;472078;208324;38.0;16.7
76;2021-05-25;8024;4085;480102;212409;38.6;17.1
76;2021-05-26;7570;3606;487672;216015;39.2;17.4
76;2021-05-27;8340;4694;496012;220709;39.9;17.7
76;2021-05-28;8231;6537;504243;227246;40.5;18.3
76;2021-05-29;6225;3511;510468;230757;41.0;18.6
76;2021-05-30;3149;431;513617;231188;41.3;18.6
76;2021-05-31;8166;3951;521783;235139;42.0;18.9
76;2021-06-01;9208;5018;530991;240157;42.7;19.3
76;2021-06-02;7930;4442;538921;244599;43.3;19.7
76;2021-06-03;9540;5392;548461;249991;44.1;20.1
76;2021-06-04;9240;6662;557701;256653;44.8;20.6
76;2021-06-05;6285;3799;563986;260452;45.3;20.9
76;2021-06-06;2556;650;566542;261102;45.5;21.0
76;2021-06-07;6978;5443;573520;266545;46.1;21.4
76;2021-06-08;8660;6266;582180;272811;46.8;21.9
76;2021-06-09;7210;6072;589390;278883;47.4;22.4
76;2021-06-10;7999;6558;597389;285441;48.0;22.9
76;2021-06-11;7575;8229;604964;293670;48.6;23.6
76;2021-06-12;7166;5876;612130;299546;49.2;24.1
76;2021-06-13;2961;1295;615091;300841;49.5;24.2
76;2021-06-14;6486;6719;621577;307560;50.0;24.7
76;2021-06-15;6300;7471;627877;315031;50.5;25.3
76;2021-06-16;6651;7483;634528;322514;51.0;25.9
76;2021-06-17;7011;7751;641539;330265;51.6;26.6
76;2021-06-18;7687;9225;649226;339490;52.2;27.3
76;2021-06-19;5987;6256;655213;345746;52.7;27.8
76;2021-06-20;2809;1818;658022;347564;52.9;27.9
76;2021-06-21;5589;8176;663611;355740;53.4;28.6
76;2021-06-22;4923;9865;668534;365605;53.7;29.4
76;2021-06-23;4727;9433;673261;375038;54.1;30.2
76;2021-06-24;4797;9913;678058;384951;54.5;30.9
76;2021-06-25;5222;11578;683280;396529;54.9;31.9
76;2021-06-26;3454;7874;686734;404403;55.2;32.5
76;2021-06-27;1366;5162;688100;409565;55.3;32.9
76;2021-06-28;3612;9945;691712;419510;55.6;33.7
76;2021-06-29;3872;10218;695584;429728;55.9;34.5
76;2021-06-30;4267;9837;699851;439565;56.3;35.3
76;2021-07-01;4596;9906;704447;449471;56.6;36.1
76;2021-07-02;4366;12002;708813;461473;57.0;37.1
76;2021-07-03;3584;8447;712397;469920;57.3;37.8
76;2021-07-04;1487;5305;713884;475225;57.4;38.2
76;2021-07-05;3956;9331;717840;484556;57.7;39.0
76;2021-07-06;4056;10074;721896;494630;58.0;39.8
76;2021-07-07;4012;9322;725908;503952;58.4;40.5
76;2021-07-08;4464;9457;730372;513409;58.7;41.3
76;2021-07-09;4364;12408;734736;525817;59.1;42.3
76;2021-07-10;3138;8548;737874;534365;59.3;43.0
76;2021-07-11;1777;2821;739651;537186;59.5;43.2
76;2021-07-12;3155;11148;742806;548334;59.7;44.1
76;2021-07-13;4934;12259;747740;560593;60.1;45.1
76;2021-07-14;4803;5546;752543;566139;60.5;45.5
76;2021-07-15;5912;11786;758455;577925;61.0;46.5
76;2021-07-16;6720;12007;765175;589932;61.5;47.4
76;2021-07-17;5277;8708;770452;598640;61.9;48.1
76;2021-07-18;2257;3357;772709;601997;62.1;48.4
76;2021-07-19;5160;11147;777869;613144;62.5;49.3
76;2021-07-20;6276;11617;784145;624761;63.0;50.2
76;2021-07-21;6342;10563;790487;635324;63.6;51.1
76;2021-07-22;8240;9649;798727;644973;64.2;51.9
76;2021-07-23;7642;11997;806369;656970;64.8;52.8
76;2021-07-24;4992;7718;811361;664688;65.2;53.4
76;2021-07-25;2873;3138;814234;667826;65.5;53.7
76;2021-07-26;5433;10144;819667;677970;65.9;54.5
76;2021-07-27;8337;9550;828004;687520;66.6;55.3
76;2021-07-28;8270;7824;836274;695344;67.2;55.9
76;2021-07-29;9589;6989;845863;702333;68.0;56.5
76;2021-07-30;8012;7845;853875;710178;68.7;57.1
76;2021-07-31;6613;5333;860488;715511;69.2;57.5
76;2021-08-01;3863;2085;864351;717596;69.5;57.7
76;2021-08-02;6561;7096;870912;724692;70.0;58.3
76;2021-08-03;7972;6359;878884;731051;70.7;58.8
76;2021-08-04;7259;5842;886143;736893;71.2;59.2
76;2021-08-05;8098;5726;894241;742619;71.9;59.7
76;2021-08-06;6810;6874;901051;749493;72.4;60.3
76;2021-08-07;4792;4382;905843;753875;72.8;60.6
76;2021-08-08;2408;2157;908251;756032;73.0;60.8
76;2021-08-09;5636;6737;913887;762769;73.5;61.3
76;2021-08-10;6350;6554;920237;769323;74.0;61.9
76;2021-08-11;6451;5494;926688;774817;74.5;62.3
76;2021-08-12;6044;6061;932732;780878;75.0;62.8
76;2021-08-13;5058;6207;937790;787085;75.4;63.3
76;2021-08-14;3839;4599;941629;791684;75.7;63.7
76;2021-08-15;1579;2357;943208;794041;75.8;63.8
76;2021-08-16;3665;6717;946873;800758;76.1;64.4
76;2021-08-17;3918;6945;950791;807703;76.4;64.9
76;2021-08-18;3747;6735;954538;814438;76.7;65.5
76;2021-08-19;3391;7169;957929;821607;77.0;66.1
76;2021-08-20;3433;7831;961362;829438;77.3;66.7
76;2021-08-21;1823;4220;963185;833658;77.4;67.0
76;2021-08-22;869;3295;964054;836953;77.5;67.3
76;2021-08-23;2624;7760;966678;844713;77.7;67.9
76;2021-08-24;2822;7590;969500;852303;77.9;68.5
76;2021-08-25;2629;7079;972129;859382;78.2;69.1
76;2021-08-26;2074;5798;974203;865180;78.3;69.6
76;2021-08-27;2695;7951;976898;873131;78.5;70.2
76;2021-08-28;2137;6062;979035;879193;78.7;70.7
76;2021-08-29;698;3013;979733;882206;78.8;70.9
76;2021-08-30;2165;7446;981898;889652;78.9;71.5
76;2021-08-31;1942;7336;983840;896988;79.1;72.1
76;2021-09-01;1722;6891;985562;903879;79.2;72.7
76;2021-09-02;1305;4993;986867;908872;79.3;73.1
76;2021-09-03;1593;7209;988460;916081;79.5;73.7
76;2021-09-04;1615;6346;990075;922427;79.6;74.2
76;2021-09-05;633;1948;990708;924375;79.7;74.3
76;2021-09-06;1311;5065;992019;929440;79.8;74.7
76;2021-09-07;1166;4403;993185;933843;79.9;75.1
76;2021-09-08;1273;5080;994458;938923;80.0;75.5
76;2021-09-09;1086;3578;995544;942501;80.0;75.8
76;2021-09-10;1697;4839;997241;947340;80.2;76.2
76;2021-09-11;1164;3606;998405;950946;80.3;76.5
76;2021-09-12;286;892;998691;951838;80.3;76.5
76;2021-09-13;823;3185;999514;955023;80.4;76.8
76;2021-09-14;1374;3679;1000888;958702;80.5;77.1
76;2021-09-15;1168;3266;1002056;961968;80.6;77.3
76;2021-09-16;1268;1953;1003324;963921;80.7;77.5
76;2021-09-17;1403;2894;1004727;966815;80.8;77.7
76;2021-09-18;733;2509;1005460;969324;80.8;77.9
76;2021-09-19;194;775;1005654;970099;80.9;78.0
76;2021-09-20;841;1808;1006495;971907;80.9;78.1
76;2021-09-21;765;1596;1007260;973503;81.0;78.3
76;2021-09-22;675;2295;1007935;975798;81.0;78.5
76;2021-09-23;753;1167;1008688;976965;81.1;78.5
76;2021-09-24;1059;2041;1009747;979006;81.2;78.7
76;2021-09-25;573;2129;1010320;981135;81.2;78.9
76;2021-09-26;125;416;1010445;981551;81.2;78.9
76;2021-09-27;625;1343;1011070;982894;81.3;79.0
76;2021-09-28;505;1121;1011575;984015;81.3;79.1
76;2021-09-29;780;1583;1012355;985598;81.4;79.2
77;2020-12-27;1;0;1;0;0.0;0.0
77;2020-12-28;2;0;3;0;0.0;0.0
77;2020-12-29;0;0;3;0;0.0;0.0
77;2020-12-30;0;0;3;0;0.0;0.0
77;2020-12-31;0;0;3;0;0.0;0.0
77;2021-01-01;4;0;7;0;0.0;0.0
77;2021-01-02;2;0;9;0;0.0;0.0
77;2021-01-03;0;0;9;0;0.0;0.0
77;2021-01-04;7;0;16;0;0.0;0.0
77;2021-01-05;199;0;215;0;0.0;0.0
77;2021-01-06;237;2;452;2;0.0;0.0
77;2021-01-07;521;4;973;6;0.1;0.0
77;2021-01-08;621;0;1594;6;0.1;0.0
77;2021-01-09;272;1;1866;7;0.1;0.0
77;2021-01-10;235;2;2101;9;0.1;0.0
77;2021-01-11;782;3;2883;12;0.2;0.0
77;2021-01-12;884;1;3767;13;0.3;0.0
77;2021-01-13;941;1;4708;14;0.3;0.0
77;2021-01-14;849;7;5557;21;0.4;0.0
77;2021-01-15;859;10;6416;31;0.5;0.0
77;2021-01-16;168;1;6584;32;0.5;0.0
77;2021-01-17;132;2;6716;34;0.5;0.0
77;2021-01-18;1195;4;7911;38;0.6;0.0
77;2021-01-19;1721;13;9632;51;0.7;0.0
77;2021-01-20;2540;9;12172;60;0.9;0.0
77;2021-01-21;2062;25;14234;85;1.0;0.0
77;2021-01-22;1148;7;15382;92;1.1;0.0
77;2021-01-23;350;0;15732;92;1.1;0.0
77;2021-01-24;45;0;15777;92;1.1;0.0
77;2021-01-25;940;22;16717;114;1.2;0.0
77;2021-01-26;1715;24;18432;138;1.3;0.0
77;2021-01-27;1364;23;19796;161;1.4;0.0
77;2021-01-28;1699;89;21495;250;1.5;0.0
77;2021-01-29;1289;139;22784;389;1.6;0.0
77;2021-01-30;211;2;22995;391;1.6;0.0
77;2021-01-31;1;0;22996;391;1.6;0.0
77;2021-02-01;570;191;23566;582;1.7;0.0
77;2021-02-02;872;243;24438;825;1.7;0.1
77;2021-02-03;795;490;25233;1315;1.8;0.1
77;2021-02-04;789;758;26022;2073;1.8;0.1
77;2021-02-05;857;765;26879;2838;1.9;0.2
77;2021-02-06;165;95;27044;2933;1.9;0.2
77;2021-02-07;17;87;27061;3020;1.9;0.2
77;2021-02-08;498;826;27559;3846;1.9;0.3
77;2021-02-09;590;1351;28149;5197;2.0;0.4
77;2021-02-10;1029;1666;29178;6863;2.0;0.5
77;2021-02-11;1060;1504;30238;8367;2.1;0.6
77;2021-02-12;1098;1036;31336;9403;2.2;0.7
77;2021-02-13;189;167;31525;9570;2.2;0.7
77;2021-02-14;12;56;31537;9626;2.2;0.7
77;2021-02-15;555;723;32092;10349;2.3;0.7
77;2021-02-16;598;1176;32690;11525;2.3;0.8
77;2021-02-17;514;962;33204;12487;2.3;0.9
77;2021-02-18;838;1344;34042;13831;2.4;1.0
77;2021-02-19;776;904;34818;14735;2.4;1.0
77;2021-02-20;54;131;34872;14866;2.4;1.0
77;2021-02-21;7;31;34879;14897;2.5;1.0
77;2021-02-22;303;540;35182;15437;2.5;1.1
77;2021-02-23;360;817;35542;16254;2.5;1.1
77;2021-02-24;513;657;36055;16911;2.5;1.2
77;2021-02-25;794;737;36849;17648;2.6;1.2
77;2021-02-26;840;661;37689;18309;2.6;1.3
77;2021-02-27;459;118;38148;18427;2.7;1.3
77;2021-02-28;33;5;38181;18432;2.7;1.3
77;2021-03-01;679;575;38860;19007;2.7;1.3
77;2021-03-02;1091;872;39951;19879;2.8;1.4
77;2021-03-03;1958;1038;41909;20917;2.9;1.5
77;2021-03-04;2795;994;44704;21911;3.1;1.5
77;2021-03-05;3374;904;48078;22815;3.4;1.6
77;2021-03-06;4825;247;52903;23062;3.7;1.6
77;2021-03-07;3193;111;56096;23173;3.9;1.6
77;2021-03-08;1230;461;57326;23634;4.0;1.7
77;2021-03-09;2508;569;59834;24203;4.2;1.7
77;2021-03-10;2397;528;62231;24731;4.4;1.7
77;2021-03-11;3502;747;65733;25478;4.6;1.8
77;2021-03-12;3890;653;69623;26131;4.9;1.8
77;2021-03-13;4478;199;74101;26330;5.2;1.8
77;2021-03-14;2153;111;76254;26441;5.4;1.9
77;2021-03-15;2511;269;78765;26710;5.5;1.9
77;2021-03-16;2444;371;81209;27081;5.7;1.9
77;2021-03-17;2555;417;83764;27498;5.9;1.9
77;2021-03-18;3011;387;86775;27885;6.1;2.0
77;2021-03-19;3359;428;90134;28313;6.3;2.0
77;2021-03-20;1967;77;92101;28390;6.5;2.0
77;2021-03-21;243;14;92344;28404;6.5;2.0
77;2021-03-22;3019;393;95363;28797;6.7;2.0
77;2021-03-23;4520;522;99883;29319;7.0;2.1
77;2021-03-24;4156;612;104039;29931;7.3;2.1
77;2021-03-25;5908;399;109947;30330;7.7;2.1
77;2021-03-26;6268;449;116215;30779;8.2;2.2
77;2021-03-27;3323;123;119538;30902;8.4;2.2
77;2021-03-28;1730;49;121268;30951;8.5;2.2
77;2021-03-29;2654;684;123922;31635;8.7;2.2
77;2021-03-30;3995;1179;127917;32814;9.0;2.3
77;2021-03-31;3755;1218;131672;34032;9.2;2.4
77;2021-04-01;4143;1797;135815;35829;9.5;2.5
77;2021-04-02;3992;2007;139807;37836;9.8;2.7
77;2021-04-03;1743;2271;141550;40107;9.9;2.8
77;2021-04-04;421;1424;141971;41531;10.0;2.9
77;2021-04-05;161;164;142132;41695;10.0;2.9
77;2021-04-06;2721;1923;144853;43618;10.2;3.1
77;2021-04-07;3320;2085;148173;45703;10.4;3.2
77;2021-04-08;4532;2362;152705;48065;10.7;3.4
77;2021-04-09;4854;2086;157559;50151;11.1;3.5
77;2021-04-10;3074;2750;160633;52901;11.3;3.7
77;2021-04-11;586;717;161219;53618;11.3;3.8
77;2021-04-12;2230;1820;163449;55438;11.5;3.9
77;2021-04-13;3359;2634;166808;58072;11.7;4.1
77;2021-04-14;2519;2651;169327;60723;11.9;4.3
77;2021-04-15;3319;3113;172646;63836;12.1;4.5
77;2021-04-16;3575;2717;176221;66553;12.4;4.7
77;2021-04-17;1386;477;177607;67030;12.5;4.7
77;2021-04-18;150;11;177757;67041;12.5;4.7
77;2021-04-19;2083;2512;179840;69553;12.6;4.9
77;2021-04-20;2572;3379;182412;72932;12.8;5.1
77;2021-04-21;2194;3472;184606;76404;13.0;5.4
77;2021-04-22;3002;3855;187608;80259;13.2;5.6
77;2021-04-23;3531;3640;191139;83899;13.4;5.9
77;2021-04-24;4900;2498;196039;86397;13.8;6.1
77;2021-04-25;4078;1239;200117;87636;14.1;6.2
77;2021-04-26;3225;2041;203342;89677;14.3;6.3
77;2021-04-27;3996;2506;207338;92183;14.6;6.5
77;2021-04-28;4067;2607;211405;94790;14.8;6.7
77;2021-04-29;4482;3063;215887;97853;15.2;6.9
77;2021-04-30;4911;3327;220798;101180;15.5;7.1
77;2021-05-01;2465;593;223263;101773;15.7;7.1
77;2021-05-02;3141;276;226404;102049;15.9;7.2
77;2021-05-03;5991;2069;232395;104118;16.3;7.3
77;2021-05-04;6437;2990;238832;107108;16.8;7.5
77;2021-05-05;6018;3022;244850;110130;17.2;7.7
77;2021-05-06;6886;3591;251736;113721;17.7;8.0
77;2021-05-07;8204;3257;259940;116978;18.3;8.2
77;2021-05-08;5718;810;265658;117788;18.7;8.3
77;2021-05-09;4905;482;270563;118270;19.0;8.3
77;2021-05-10;8086;2327;278649;120597;19.6;8.5
77;2021-05-11;9577;2911;288226;123508;20.2;8.7
77;2021-05-12;8977;2277;297203;125785;20.9;8.8
77;2021-05-13;9302;878;306505;126663;21.5;8.9
77;2021-05-14;10438;1669;316943;128332;22.3;9.0
77;2021-05-15;8991;1247;325934;129579;22.9;9.1
77;2021-05-16;5151;470;331085;130049;23.3;9.1
77;2021-05-17;10371;1476;341456;131525;24.0;9.2
77;2021-05-18;11784;1803;353240;133328;24.8;9.4
77;2021-05-19;10917;1600;364157;134928;25.6;9.5
77;2021-05-20;12214;2154;376371;137082;26.4;9.6
77;2021-05-21;11652;2694;388023;139776;27.3;9.8
77;2021-05-22;9817;1737;397840;141513;27.9;9.9
77;2021-05-23;6978;815;404818;142328;28.4;10.0
77;2021-05-24;6762;778;411580;143106;28.9;10.1
77;2021-05-25;8315;2817;419895;145923;29.5;10.3
77;2021-05-26;7561;2978;427456;148901;30.0;10.5
77;2021-05-27;7552;3967;435008;152868;30.6;10.7
77;2021-05-28;7633;3996;442641;156864;31.1;11.0
77;2021-05-29;7353;2319;449994;159183;31.6;11.2
77;2021-05-30;4355;891;454349;160074;31.9;11.2
77;2021-05-31;8382;3833;462731;163907;32.5;11.5
77;2021-06-01;9645;4372;472376;168279;33.2;11.8
77;2021-06-02;9005;3927;481381;172206;33.8;12.1
77;2021-06-03;9001;5258;490382;177464;34.4;12.5
77;2021-06-04;9114;5489;499496;182953;35.1;12.9
77;2021-06-05;6660;4982;506156;187935;35.6;13.2
77;2021-06-06;4909;3210;511065;191145;35.9;13.4
77;2021-06-07;6421;4534;517486;195679;36.4;13.7
77;2021-06-08;5726;5223;523212;200902;36.8;14.1
77;2021-06-09;5059;4956;528271;205858;37.1;14.5
77;2021-06-10;5014;5455;533285;211313;37.5;14.8
77;2021-06-11;5752;6025;539037;217338;37.9;15.3
77;2021-06-12;6543;4752;545580;222090;38.3;15.6
77;2021-06-13;3507;3052;549087;225142;38.6;15.8
77;2021-06-14;3218;7932;552305;233074;38.8;16.4
77;2021-06-15;4125;8477;556430;241551;39.1;17.0
77;2021-06-16;4804;8378;561234;249929;39.4;17.6
77;2021-06-17;4467;9021;565701;258950;39.7;18.2
77;2021-06-18;4365;9785;570066;268735;40.0;18.9
77;2021-06-19;5305;6931;575371;275666;40.4;19.4
77;2021-06-20;2096;3801;577467;279467;40.6;19.6
77;2021-06-21;3228;9580;580695;289047;40.8;20.3
77;2021-06-22;3665;11371;584360;300418;41.0;21.1
77;2021-06-23;3443;10050;587803;310468;41.3;21.8
77;2021-06-24;3359;10911;591162;321379;41.5;22.6
77;2021-06-25;3622;10798;594784;332177;41.8;23.3
77;2021-06-26;4086;10069;598870;342246;42.1;24.0
77;2021-06-27;2123;6427;600993;348673;42.2;24.5
77;2021-06-28;2796;10830;603789;359503;42.4;25.3
77;2021-06-29;3416;12524;607205;372027;42.7;26.1
77;2021-06-30;3290;11450;610495;383477;42.9;26.9
77;2021-07-01;3296;11649;613791;395126;43.1;27.8
77;2021-07-02;3463;12253;617254;407379;43.4;28.6
77;2021-07-03;3182;10801;620436;418180;43.6;29.4
77;2021-07-04;1996;6490;622432;424670;43.7;29.8
77;2021-07-05;3584;9541;626016;434211;44.0;30.5
77;2021-07-06;3735;9524;629751;443735;44.2;31.2
77;2021-07-07;4051;8950;633802;452685;44.5;31.8
77;2021-07-08;3934;8760;637736;461445;44.8;32.4
77;2021-07-09;4712;10339;642448;471784;45.1;33.1
77;2021-07-10;4043;9841;646491;481625;45.4;33.8
77;2021-07-11;3090;5093;649581;486718;45.6;34.2
77;2021-07-12;3285;10871;652866;497589;45.9;35.0
77;2021-07-13;6161;12032;659027;509621;46.3;35.8
77;2021-07-14;3602;6447;662629;516068;46.5;36.3
77;2021-07-15;7189;11972;669818;528040;47.1;37.1
77;2021-07-16;7824;9891;677642;537931;47.6;37.8
77;2021-07-17;5792;9464;683434;547395;48.0;38.5
77;2021-07-18;4137;5329;687571;552724;48.3;38.8
77;2021-07-19;7516;8955;695087;561679;48.8;39.5
77;2021-07-20;9659;8042;704746;569721;49.5;40.0
77;2021-07-21;9524;7481;714270;577202;50.2;40.5
77;2021-07-22;10558;7552;724828;584754;50.9;41.1
77;2021-07-23;9877;8205;734705;592959;51.6;41.7
77;2021-07-24;7214;7876;741919;600835;52.1;42.2
77;2021-07-25;5898;4036;747817;604871;52.5;42.5
77;2021-07-26;9210;5967;757027;610838;53.2;42.9
77;2021-07-27;10951;6047;767978;616885;53.9;43.3
77;2021-07-28;9490;6426;777468;623311;54.6;43.8
77;2021-07-29;9537;5513;787005;628824;55.3;44.2
77;2021-07-30;9743;6365;796748;635189;56.0;44.6
77;2021-07-31;7258;6632;804006;641821;56.5;45.1
77;2021-08-01;2953;1216;806959;643037;56.7;45.2
77;2021-08-02;7131;5733;814090;648770;57.2;45.6
77;2021-08-03;5854;4525;819944;653295;57.6;45.9
77;2021-08-04;4740;4388;824684;657683;57.9;46.2
77;2021-08-05;3260;2972;827944;660655;58.2;46.4
77;2021-08-06;5981;5262;833925;665917;58.6;46.8
77;2021-08-07;5294;6792;839219;672709;59.0;47.3
77;2021-08-08;1976;1863;841195;674572;59.1;47.4
77;2021-08-09;5093;6583;846288;681155;59.4;47.8
77;2021-08-10;2713;3579;849001;684734;59.6;48.1
77;2021-08-11;3143;6240;852144;690974;59.9;48.5
77;2021-08-12;2282;3575;854426;694549;60.0;48.8
77;2021-08-13;2736;4895;857162;699444;60.2;49.1
77;2021-08-14;2956;7331;860118;706775;60.4;49.6
77;2021-08-15;789;773;860907;707548;60.5;49.7
77;2021-08-16;2479;6986;863386;714534;60.6;50.2
77;2021-08-17;2897;7212;866283;721746;60.9;50.7
77;2021-08-18;2684;6560;868967;728306;61.0;51.2
77;2021-08-19;2651;5104;871618;733410;61.2;51.5
77;2021-08-20;2710;5686;874328;739096;61.4;51.9
77;2021-08-21;2715;7337;877043;746433;61.6;52.4
77;2021-08-22;1734;5343;878777;751776;61.7;52.8
77;2021-08-23;2515;9618;881292;761394;61.9;53.5
77;2021-08-24;3066;9241;884358;770635;62.1;54.1
77;2021-08-25;2564;6537;886922;777172;62.3;54.6
77;2021-08-26;2560;6255;889482;783427;62.5;55.0
77;2021-08-27;2777;6994;892259;790421;62.7;55.5
77;2021-08-28;1972;7249;894231;797670;62.8;56.0
77;2021-08-29;1482;5150;895713;802820;62.9;56.4
77;2021-08-30;2524;8150;898237;810970;63.1;57.0
77;2021-08-31;2849;5736;901086;816706;63.3;57.4
77;2021-09-01;2234;3851;903320;820557;63.5;57.6
77;2021-09-02;1606;3148;904926;823705;63.6;57.9
77;2021-09-03;2132;4559;907058;828264;63.7;58.2
77;2021-09-04;2420;5777;909478;834041;63.9;58.6
77;2021-09-05;899;1557;910377;835598;63.9;58.7
77;2021-09-06;1063;2318;911440;837916;64.0;58.9
77;2021-09-07;842;2291;912282;840207;64.1;59.0
77;2021-09-08;1707;3579;913989;843786;64.2;59.3
77;2021-09-09;960;2210;914949;845996;64.3;59.4
77;2021-09-10;1186;2565;916135;848561;64.4;59.6
77;2021-09-11;2035;5700;918170;854261;64.5;60.0
77;2021-09-12;521;1423;918691;855684;64.5;60.1
77;2021-09-13;879;2312;919570;857996;64.6;60.3
77;2021-09-14;1016;2155;920586;860151;64.7;60.4
77;2021-09-15;1173;2524;921759;862675;64.7;60.6
77;2021-09-16;953;1499;922712;864174;64.8;60.7
77;2021-09-17;1153;2019;923865;866193;64.9;60.8
77;2021-09-18;1296;3580;925161;869773;65.0;61.1
77;2021-09-19;232;1182;925393;870955;65.0;61.2
77;2021-09-20;796;1623;926189;872578;65.1;61.3
77;2021-09-21;787;1500;926976;874078;65.1;61.4
77;2021-09-22;749;2482;927725;876560;65.2;61.6
77;2021-09-23;568;1507;928293;878067;65.2;61.7
77;2021-09-24;804;1939;929097;880006;65.3;61.8
77;2021-09-25;998;3953;930095;883959;65.3;62.1
77;2021-09-26;205;756;930300;884715;65.3;62.1
77;2021-09-27;644;1309;930944;886024;65.4;62.2
77;2021-09-28;766;838;931710;886862;65.4;62.3
77;2021-09-29;933;1973;932643;888835;65.5;62.4
78;2020-12-27;2;0;2;0;0.0;0.0
78;2020-12-28;1;1;3;1;0.0;0.0
78;2020-12-29;0;0;3;1;0.0;0.0
78;2020-12-30;1;0;4;1;0.0;0.0
78;2020-12-31;15;0;19;1;0.0;0.0
78;2021-01-01;1;0;20;1;0.0;0.0
78;2021-01-02;1;0;21;1;0.0;0.0
78;2021-01-03;3;0;24;1;0.0;0.0
78;2021-01-04;145;3;169;4;0.0;0.0
78;2021-01-05;175;1;344;5;0.0;0.0
78;2021-01-06;208;3;552;8;0.0;0.0
78;2021-01-07;469;2;1021;10;0.1;0.0
78;2021-01-08;650;3;1671;13;0.1;0.0
78;2021-01-09;22;0;1693;13;0.1;0.0
78;2021-01-10;2;0;1695;13;0.1;0.0
78;2021-01-11;792;3;2487;16;0.2;0.0
78;2021-01-12;945;5;3432;21;0.2;0.0
78;2021-01-13;741;8;4173;29;0.3;0.0
78;2021-01-14;812;9;4985;38;0.3;0.0
78;2021-01-15;848;10;5833;48;0.4;0.0
78;2021-01-16;32;0;5865;48;0.4;0.0
78;2021-01-17;0;0;5865;48;0.4;0.0
78;2021-01-18;1385;21;7250;69;0.5;0.0
78;2021-01-19;1841;28;9091;97;0.6;0.0
78;2021-01-20;1651;15;10742;112;0.7;0.0
78;2021-01-21;3258;16;14000;128;1.0;0.0
78;2021-01-22;2216;17;16216;145;1.1;0.0
78;2021-01-23;280;0;16496;145;1.1;0.0
78;2021-01-24;5;0;16501;145;1.1;0.0
78;2021-01-25;957;26;17458;171;1.2;0.0
78;2021-01-26;1560;19;19018;190;1.3;0.0
78;2021-01-27;2062;38;21080;228;1.5;0.0
78;2021-01-28;2439;89;23519;317;1.6;0.0
78;2021-01-29;1491;57;25010;374;1.7;0.0
78;2021-01-30;210;2;25220;376;1.7;0.0
78;2021-01-31;3;0;25223;376;1.7;0.0
78;2021-02-01;788;211;26011;587;1.8;0.0
78;2021-02-02;967;318;26978;905;1.9;0.1
78;2021-02-03;975;217;27953;1122;1.9;0.1
78;2021-02-04;1117;414;29070;1536;2.0;0.1
78;2021-02-05;1191;447;30261;1983;2.1;0.1
78;2021-02-06;200;44;30461;2027;2.1;0.1
78;2021-02-07;139;13;30600;2040;2.1;0.1
78;2021-02-08;760;538;31360;2578;2.2;0.2
78;2021-02-09;1122;860;32482;3438;2.2;0.2
78;2021-02-10;1245;1067;33727;4505;2.3;0.3
78;2021-02-11;1820;1681;35547;6186;2.5;0.4
78;2021-02-12;1820;1242;37367;7428;2.6;0.5
78;2021-02-13;173;63;37540;7491;2.6;0.5
78;2021-02-14;27;23;37567;7514;2.6;0.5
78;2021-02-15;447;1131;38014;8645;2.6;0.6
78;2021-02-16;628;1299;38642;9944;2.7;0.7
78;2021-02-17;588;1926;39230;11870;2.7;0.8
78;2021-02-18;998;1911;40228;13781;2.8;1.0
78;2021-02-19;820;1440;41048;15221;2.8;1.1
78;2021-02-20;148;102;41196;15323;2.8;1.1
78;2021-02-21;0;12;41196;15335;2.8;1.1
78;2021-02-22;502;809;41698;16144;2.9;1.1
78;2021-02-23;540;895;42238;17039;2.9;1.2
78;2021-02-24;619;1031;42857;18070;3.0;1.2
78;2021-02-25;867;916;43724;18986;3.0;1.3
78;2021-02-26;1131;1016;44855;20002;3.1;1.4
78;2021-02-27;740;115;45595;20117;3.1;1.4
78;2021-02-28;68;18;45663;20135;3.2;1.4
78;2021-03-01;966;702;46629;20837;3.2;1.4
78;2021-03-02;1727;885;48356;21722;3.3;1.5
78;2021-03-03;1965;1053;50321;22775;3.5;1.6
78;2021-03-04;2950;1412;53271;24187;3.7;1.7
78;2021-03-05;3255;1471;56526;25658;3.9;1.8
78;2021-03-06;6244;284;62770;25942;4.3;1.8
78;2021-03-07;3444;104;66214;26046;4.6;1.8
78;2021-03-08;1462;669;67676;26715;4.7;1.8
78;2021-03-09;2940;832;70616;27547;4.9;1.9
78;2021-03-10;3081;1034;73697;28581;5.1;2.0
78;2021-03-11;4177;1237;77874;29818;5.4;2.1
78;2021-03-12;5371;1284;83245;31102;5.7;2.1
78;2021-03-13;4657;199;87902;31301;6.1;2.2
78;2021-03-14;1036;41;88938;31342;6.1;2.2
78;2021-03-15;3620;266;92558;31608;6.4;2.2
78;2021-03-16;2567;561;95125;32169;6.6;2.2
78;2021-03-17;2969;434;98094;32603;6.8;2.3
78;2021-03-18;3780;443;101874;33046;7.0;2.3
78;2021-03-19;5317;484;107191;33530;7.4;2.3
78;2021-03-20;2259;129;109450;33659;7.6;2.3
78;2021-03-21;167;7;109617;33666;7.6;2.3
78;2021-03-22;3530;378;113147;34044;7.8;2.4
78;2021-03-23;5231;538;118378;34582;8.2;2.4
78;2021-03-24;4892;551;123270;35133;8.5;2.4
78;2021-03-25;6940;562;130210;35695;9.0;2.5
78;2021-03-26;6943;706;137153;36401;9.5;2.5
78;2021-03-27;3746;196;140899;36597;9.7;2.5
78;2021-03-28;1918;54;142817;36651;9.9;2.5
78;2021-03-29;3864;759;146681;37410;10.1;2.6
78;2021-03-30;5526;1048;152207;38458;10.5;2.7
78;2021-03-31;5334;1289;157541;39747;10.9;2.7
78;2021-04-01;5589;2349;163130;42096;11.3;2.9
78;2021-04-02;5194;2621;168324;44717;11.6;3.1
78;2021-04-03;2198;2562;170522;47279;11.8;3.3
78;2021-04-04;174;14;170696;47293;11.8;3.3
78;2021-04-05;199;19;170895;47312;11.8;3.3
78;2021-04-06;3618;2300;174513;49612;12.0;3.4
78;2021-04-07;4356;2582;178869;52194;12.3;3.6
78;2021-04-08;5524;2669;184393;54863;12.7;3.8
78;2021-04-09;6907;2441;191300;57304;13.2;4.0
78;2021-04-10;3995;1903;195295;59207;13.5;4.1
78;2021-04-11;374;606;195669;59813;13.5;4.1
78;2021-04-12;3531;2356;199200;62169;13.8;4.3
78;2021-04-13;5461;2499;204661;64668;14.1;4.5
78;2021-04-14;4954;3382;209615;68050;14.5;4.7
78;2021-04-15;4616;3852;214231;71902;14.8;5.0
78;2021-04-16;5625;4016;219856;75918;15.2;5.2
78;2021-04-17;3610;716;223466;76634;15.4;5.3
78;2021-04-18;272;42;223738;76676;15.4;5.3
78;2021-04-19;3245;2812;226983;79488;15.7;5.5
78;2021-04-20;4709;3682;231692;83170;16.0;5.7
78;2021-04-21;4533;3502;236225;86672;16.3;6.0
78;2021-04-22;4566;4692;240791;91364;16.6;6.3
78;2021-04-23;5059;4429;245850;95793;17.0;6.6
78;2021-04-24;4865;2614;250715;98407;17.3;6.8
78;2021-04-25;3048;1731;253763;100138;17.5;6.9
78;2021-04-26;4768;3317;258531;103455;17.8;7.1
78;2021-04-27;5474;4295;264005;107750;18.2;7.4
78;2021-04-28;5650;4773;269655;112523;18.6;7.8
78;2021-04-29;6263;4056;275918;116579;19.0;8.0
78;2021-04-30;7207;4445;283125;121024;19.5;8.4
78;2021-05-01;612;254;283737;121278;19.6;8.4
78;2021-05-02;2009;164;285746;121442;19.7;8.4
78;2021-05-03;7464;1271;293210;122713;20.2;8.5
78;2021-05-04;6076;3968;299286;126681;20.7;8.7
78;2021-05-05;7295;4545;306581;131226;21.2;9.1
78;2021-05-06;6480;5164;313061;136390;21.6;9.4
78;2021-05-07;8308;5112;321369;141502;22.2;9.8
78;2021-05-08;2916;1446;324285;142948;22.4;9.9
78;2021-05-09;2819;351;327104;143299;22.6;9.9
78;2021-05-10;7343;4447;334447;147746;23.1;10.2
78;2021-05-11;8143;5405;342590;153151;23.6;10.6
78;2021-05-12;8729;3913;351319;157064;24.3;10.8
78;2021-05-13;6628;600;357947;157664;24.7;10.9
78;2021-05-14;10216;2216;368163;159880;25.4;11.0
78;2021-05-15;4934;2359;373097;162239;25.8;11.2
78;2021-05-16;3697;792;376794;163031;26.0;11.3
78;2021-05-17;8741;1348;385535;164379;26.6;11.3
78;2021-05-18;9886;1894;395421;166273;27.3;11.5
78;2021-05-19;11650;1711;407071;167984;28.1;11.6
78;2021-05-20;11595;2262;418666;170246;28.9;11.8
78;2021-05-21;12120;2618;430786;172864;29.7;11.9
78;2021-05-22;6537;1357;437323;174221;30.2;12.0
78;2021-05-23;3125;390;440448;174611;30.4;12.1
78;2021-05-24;3521;418;443969;175029;30.6;12.1
78;2021-05-25;9983;2504;453952;177533;31.3;12.3
78;2021-05-26;10159;3776;464111;181309;32.0;12.5
78;2021-05-27;10947;4639;475058;185948;32.8;12.8
78;2021-05-28;11405;6012;486463;191960;33.6;13.3
78;2021-05-29;4228;3381;490691;195341;33.9;13.5
78;2021-05-30;135;345;490826;195686;33.9;13.5
78;2021-05-31;7968;5350;498794;201036;34.4;13.9
78;2021-06-01;10022;6515;508816;207551;35.1;14.3
78;2021-06-02;8580;6194;517396;213745;35.7;14.8
78;2021-06-03;9892;6470;527288;220215;36.4;15.2
78;2021-06-04;9793;8143;537081;228358;37.1;15.8
78;2021-06-05;5519;6129;542600;234487;37.5;16.2
78;2021-06-06;2150;2009;544750;236496;37.6;16.3
78;2021-06-07;8112;6513;552862;243009;38.2;16.8
78;2021-06-08;8064;7322;560926;250331;38.7;17.3
78;2021-06-09;7325;6724;568251;257055;39.2;17.7
78;2021-06-10;7105;7095;575356;264150;39.7;18.2
78;2021-06-11;7583;8181;582939;272331;40.2;18.8
78;2021-06-12;6374;2920;589313;275251;40.7;19.0
78;2021-06-13;946;2458;590259;277709;40.7;19.2
78;2021-06-14;3415;9807;593674;287516;41.0;19.8
78;2021-06-15;5794;8282;599468;295798;41.4;20.4
78;2021-06-16;5430;8619;604898;304417;41.8;21.0
78;2021-06-17;5481;8533;610379;312950;42.1;21.6
78;2021-06-18;6103;9801;616482;322751;42.6;22.3
78;2021-06-19;5219;4817;621701;327568;42.9;22.6
78;2021-06-20;625;2838;622326;330406;43.0;22.8
78;2021-06-21;4092;9468;626418;339874;43.2;23.5
78;2021-06-22;3349;10317;629767;350191;43.5;24.2
78;2021-06-23;3839;10392;633606;360583;43.7;24.9
78;2021-06-24;3795;9971;637401;370554;44.0;25.6
78;2021-06-25;3994;13143;641395;383697;44.3;26.5
78;2021-06-26;4209;7947;645604;391644;44.6;27.0
78;2021-06-27;1041;2540;646645;394184;44.6;27.2
78;2021-06-28;3286;10897;649931;405081;44.9;28.0
78;2021-06-29;3535;11246;653466;416327;45.1;28.7
78;2021-06-30;4110;13224;657576;429551;45.4;29.7
78;2021-07-01;4106;12700;661682;442251;45.7;30.5
78;2021-07-02;4260;13934;665942;456185;46.0;31.5
78;2021-07-03;3159;8618;669101;464803;46.2;32.1
78;2021-07-04;778;1742;669879;466545;46.2;32.2
78;2021-07-05;3384;9692;673263;476237;46.5;32.9
78;2021-07-06;3525;12039;676788;488276;46.7;33.7
78;2021-07-07;3818;11603;680606;499879;47.0;34.5
78;2021-07-08;3928;11676;684534;511555;47.3;35.3
78;2021-07-09;4759;12740;689293;524295;47.6;36.2
78;2021-07-10;2626;6611;691919;530906;47.8;36.6
78;2021-07-11;748;2046;692667;532952;47.8;36.8
78;2021-07-12;3037;11740;695704;544692;48.0;37.6
78;2021-07-13;5351;11971;701055;556663;48.4;38.4
78;2021-07-14;2533;4989;703588;561652;48.6;38.8
78;2021-07-15;5661;11950;709249;573602;49.0;39.6
78;2021-07-16;7321;10783;716570;584385;49.5;40.3
78;2021-07-17;4725;4889;721295;589274;49.8;40.7
78;2021-07-18;1158;471;722453;589745;49.9;40.7
78;2021-07-19;3877;10348;726330;600093;50.1;41.4
78;2021-07-20;5616;9922;731946;610015;50.5;42.1
78;2021-07-21;5905;9858;737851;619873;50.9;42.8
78;2021-07-22;5973;9293;743824;629166;51.3;43.4
78;2021-07-23;6259;9228;750083;638394;51.8;44.1
78;2021-07-24;2937;4965;753020;643359;52.0;44.4
78;2021-07-25;987;376;754007;643735;52.0;44.4
78;2021-07-26;4866;6985;758873;650720;52.4;44.9
78;2021-07-27;7598;6914;766471;657634;52.9;45.4
78;2021-07-28;6976;5933;773447;663567;53.4;45.8
78;2021-07-29;7901;6006;781348;669573;53.9;46.2
78;2021-07-30;7739;7049;789087;676622;54.5;46.7
78;2021-07-31;2653;2732;791740;679354;54.7;46.9
78;2021-08-01;109;72;791849;679426;54.7;46.9
78;2021-08-02;2443;2123;794292;681549;54.8;47.0
78;2021-08-03;4268;4251;798560;685800;55.1;47.3
78;2021-08-04;4459;2809;803019;688609;55.4;47.5
78;2021-08-05;3883;3171;806902;691780;55.7;47.8
78;2021-08-06;3980;3713;810882;695493;56.0;48.0
78;2021-08-07;2819;3442;813701;698935;56.2;48.2
78;2021-08-08;483;343;814184;699278;56.2;48.3
78;2021-08-09;1877;1662;816061;700940;56.3;48.4
78;2021-08-10;3410;3982;819471;704922;56.6;48.7
78;2021-08-11;2981;3383;822452;708305;56.8;48.9
78;2021-08-12;2746;3534;825198;711839;57.0;49.1
78;2021-08-13;2865;3185;828063;715024;57.2;49.4
78;2021-08-14;2301;2977;830364;718001;57.3;49.6
78;2021-08-15;281;373;830645;718374;57.3;49.6
78;2021-08-16;910;2339;831555;720713;57.4;49.8
78;2021-08-17;2795;4423;834350;725136;57.6;50.1
78;2021-08-18;2471;3819;836821;728955;57.8;50.3
78;2021-08-19;2237;3583;839058;732538;57.9;50.6
78;2021-08-20;2097;3998;841155;736536;58.1;50.8
78;2021-08-21;1883;3586;843038;740122;58.2;51.1
78;2021-08-22;87;147;843125;740269;58.2;51.1
78;2021-08-23;2153;4246;845278;744515;58.4;51.4
78;2021-08-24;3630;6972;848908;751487;58.6;51.9
78;2021-08-25;3295;6592;852203;758079;58.8;52.3
78;2021-08-26;2979;7236;855182;765315;59.0;52.8
78;2021-08-27;2860;7370;858042;772685;59.2;53.3
78;2021-08-28;2440;5275;860482;777960;59.4;53.7
78;2021-08-29;368;352;860850;778312;59.4;53.7
78;2021-08-30;2859;5069;863709;783381;59.6;54.1
78;2021-08-31;3452;5826;867161;789207;59.9;54.5
78;2021-09-01;2710;5288;869871;794495;60.0;54.8
78;2021-09-02;2092;4440;871963;798935;60.2;55.2
78;2021-09-03;2257;4719;874220;803654;60.3;55.5
78;2021-09-04;2474;4249;876694;807903;60.5;55.8
78;2021-09-05;292;382;876986;808285;60.5;55.8
78;2021-09-06;1284;3003;878270;811288;60.6;56.0
78;2021-09-07;1349;3508;879619;814796;60.7;56.2
78;2021-09-08;1677;3790;881296;818586;60.8;56.5
78;2021-09-09;1073;3316;882369;821902;60.9;56.7
78;2021-09-10;1364;3467;883733;825369;61.0;57.0
78;2021-09-11;2042;4194;885775;829563;61.1;57.3
78;2021-09-12;72;165;885847;829728;61.2;57.3
78;2021-09-13;776;2568;886623;832296;61.2;57.5
78;2021-09-14;1065;3819;887688;836115;61.3;57.7
78;2021-09-15;1202;3531;888890;839646;61.4;58.0
78;2021-09-16;841;2086;889731;841732;61.4;58.1
78;2021-09-17;1177;2838;890908;844570;61.5;58.3
78;2021-09-18;1393;4072;892301;848642;61.6;58.6
78;2021-09-19;145;407;892446;849049;61.6;58.6
78;2021-09-20;669;1707;893115;850756;61.7;58.7
78;2021-09-21;820;1975;893935;852731;61.7;58.9
78;2021-09-22;952;3509;894887;856240;61.8;59.1
78;2021-09-23;881;1633;895768;857873;61.8;59.2
78;2021-09-24;1009;2380;896777;860253;61.9;59.4
78;2021-09-25;1055;3916;897832;864169;62.0;59.7
78;2021-09-26;59;154;897891;864323;62.0;59.7
78;2021-09-27;677;1501;898568;865824;62.0;59.8
78;2021-09-28;827;1493;899395;867317;62.1;59.9
78;2021-09-29;996;2152;900391;869469;62.2;60.0
79;2020-12-27;0;0;0;0;0.0;0.0
79;2020-12-28;4;0;4;0;0.0;0.0
79;2020-12-29;0;0;4;0;0.0;0.0
79;2020-12-30;0;0;4;0;0.0;0.0
79;2020-12-31;0;0;4;0;0.0;0.0
79;2021-01-01;0;0;4;0;0.0;0.0
79;2021-01-02;0;0;4;0;0.0;0.0
79;2021-01-03;0;0;4;0;0.0;0.0
79;2021-01-04;1;0;5;0;0.0;0.0
79;2021-01-05;0;0;5;0;0.0;0.0
79;2021-01-06;0;0;5;0;0.0;0.0
79;2021-01-07;158;0;163;0;0.0;0.0
79;2021-01-08;165;0;328;0;0.1;0.0
79;2021-01-09;100;0;428;0;0.1;0.0
79;2021-01-10;3;0;431;0;0.1;0.0
79;2021-01-11;184;1;615;1;0.2;0.0
79;2021-01-12;245;1;860;2;0.2;0.0
79;2021-01-13;258;0;1118;2;0.3;0.0
79;2021-01-14;506;8;1624;10;0.4;0.0
79;2021-01-15;618;5;2242;15;0.6;0.0
79;2021-01-16;66;0;2308;15;0.6;0.0
79;2021-01-17;0;0;2308;15;0.6;0.0
79;2021-01-18;477;2;2785;17;0.7;0.0
79;2021-01-19;1360;2;4145;19;1.1;0.0
79;2021-01-20;1678;1;5823;20;1.6;0.0
79;2021-01-21;1999;7;7822;27;2.1;0.0
79;2021-01-22;875;4;8697;31;2.3;0.0
79;2021-01-23;65;0;8762;31;2.4;0.0
79;2021-01-24;0;0;8762;31;2.4;0.0
79;2021-01-25;646;7;9408;38;2.5;0.0
79;2021-01-26;593;13;10001;51;2.7;0.0
79;2021-01-27;740;81;10741;132;2.9;0.0
79;2021-01-28;735;128;11476;260;3.1;0.1
79;2021-01-29;495;81;11971;341;3.2;0.1
79;2021-01-30;0;0;11971;341;3.2;0.1
79;2021-01-31;0;0;11971;341;3.2;0.1
79;2021-02-01;207;105;12178;446;3.3;0.1
79;2021-02-02;334;73;12512;519;3.4;0.1
79;2021-02-03;391;56;12903;575;3.5;0.2
79;2021-02-04;326;107;13229;682;3.6;0.2
79;2021-02-05;360;273;13589;955;3.6;0.3
79;2021-02-06;6;0;13595;955;3.6;0.3
79;2021-02-07;22;0;13617;955;3.7;0.3
79;2021-02-08;283;159;13900;1114;3.7;0.3
79;2021-02-09;457;744;14357;1858;3.9;0.5
79;2021-02-10;619;1148;14976;3006;4.0;0.8
79;2021-02-11;777;1192;15753;4198;4.2;1.1
79;2021-02-12;471;711;16224;4909;4.4;1.3
79;2021-02-13;53;61;16277;4970;4.4;1.3
79;2021-02-14;0;0;16277;4970;4.4;1.3
79;2021-02-15;186;426;16463;5396;4.4;1.4
79;2021-02-16;333;642;16796;6038;4.5;1.6
79;2021-02-17;248;754;17044;6792;4.6;1.8
79;2021-02-18;353;847;17397;7639;4.7;2.1
79;2021-02-19;268;507;17665;8146;4.7;2.2
79;2021-02-20;5;18;17670;8164;4.7;2.2
79;2021-02-21;1;0;17671;8164;4.7;2.2
79;2021-02-22;137;400;17808;8564;4.8;2.3
79;2021-02-23;248;498;18056;9062;4.8;2.4
79;2021-02-24;246;461;18302;9523;4.9;2.6
79;2021-02-25;520;416;18822;9939;5.1;2.7
79;2021-02-26;599;348;19421;10287;5.2;2.8
79;2021-02-27;408;7;19829;10294;5.3;2.8
79;2021-02-28;35;0;19864;10294;5.3;2.8
79;2021-03-01;89;295;19953;10589;5.4;2.8
79;2021-03-02;302;453;20255;11042;5.4;3.0
79;2021-03-03;662;482;20917;11524;5.6;3.1
79;2021-03-04;904;524;21821;12048;5.9;3.2
79;2021-03-05;1217;408;23038;12456;6.2;3.3
79;2021-03-06;611;6;23649;12462;6.3;3.3
79;2021-03-07;77;1;23726;12463;6.4;3.3
79;2021-03-08;344;279;24070;12742;6.5;3.4
79;2021-03-09;842;311;24912;13053;6.7;3.5
79;2021-03-10;1146;374;26058;13427;7.0;3.6
79;2021-03-11;1639;306;27697;13733;7.4;3.7
79;2021-03-12;1721;111;29418;13844;7.9;3.7
79;2021-03-13;1135;13;30553;13857;8.2;3.7
79;2021-03-14;50;0;30603;13857;8.2;3.7
79;2021-03-15;497;157;31100;14014;8.3;3.8
79;2021-03-16;735;146;31835;14160;8.5;3.8
79;2021-03-17;578;107;32413;14267;8.7;3.8
79;2021-03-18;553;198;32966;14465;8.8;3.9
79;2021-03-19;661;256;33627;14721;9.0;4.0
79;2021-03-20;1007;14;34634;14735;9.3;4.0
79;2021-03-21;3;0;34637;14735;9.3;4.0
79;2021-03-22;957;203;35594;14938;9.6;4.0
79;2021-03-23;1595;169;37189;15107;10.0;4.1
79;2021-03-24;1831;162;39020;15269;10.5;4.1
79;2021-03-25;2499;191;41519;15460;11.1;4.1
79;2021-03-26;2406;137;43925;15597;11.8;4.2
79;2021-03-27;768;18;44693;15615;12.0;4.2
79;2021-03-28;1;0;44694;15615;12.0;4.2
79;2021-03-29;2148;115;46842;15730;12.6;4.2
79;2021-03-30;2817;64;49659;15794;13.3;4.2
79;2021-03-31;2777;381;52436;16175;14.1;4.3
79;2021-04-01;2698;383;55134;16558;14.8;4.4
79;2021-04-02;2823;394;57957;16952;15.6;4.5
79;2021-04-03;634;53;58591;17005;15.7;4.6
79;2021-04-04;3;0;58594;17005;15.7;4.6
79;2021-04-05;381;4;58975;17009;15.8;4.6
79;2021-04-06;1792;582;60767;17591;16.3;4.7
79;2021-04-07;3114;728;63881;18319;17.1;4.9
79;2021-04-08;2631;697;66512;19016;17.8;5.1
79;2021-04-09;3737;541;70249;19557;18.9;5.2
79;2021-04-10;1466;387;71715;19944;19.2;5.4
79;2021-04-11;4;0;71719;19944;19.2;5.4
79;2021-04-12;1753;353;73472;20297;19.7;5.4
79;2021-04-13;2174;748;75646;21045;20.3;5.6
79;2021-04-14;2480;678;78126;21723;21.0;5.8
79;2021-04-15;2216;666;80342;22389;21.6;6.0
79;2021-04-16;1412;443;81754;22832;21.9;6.1
79;2021-04-17;581;353;82335;23185;22.1;6.2
79;2021-04-18;1;14;82336;23199;22.1;6.2
79;2021-04-19;1088;838;83424;24037;22.4;6.5
79;2021-04-20;1506;1229;84930;25266;22.8;6.8
79;2021-04-21;1419;1438;86349;26704;23.2;7.2
79;2021-04-22;1572;1085;87921;27789;23.6;7.5
79;2021-04-23;1316;1187;89237;28976;23.9;7.8
79;2021-04-24;653;458;89890;29434;24.1;7.9
79;2021-04-25;1;0;89891;29434;24.1;7.9
79;2021-04-26;1343;1813;91234;31247;24.5;8.4
79;2021-04-27;1898;2335;93132;33582;25.0;9.0
79;2021-04-28;1458;2865;94590;36447;25.4;9.8
79;2021-04-29;2105;2239;96695;38686;25.9;10.4
79;2021-04-30;2115;2453;98810;41139;26.5;11.0
79;2021-05-01;521;378;99331;41517;26.7;11.1
79;2021-05-02;1;11;99332;41528;26.7;11.1
79;2021-05-03;1182;1291;100514;42819;27.0;11.5
79;2021-05-04;1732;2324;102246;45143;27.4;12.1
79;2021-05-05;1694;2479;103940;47622;27.9;12.8
79;2021-05-06;2326;2221;106266;49843;28.5;13.4
79;2021-05-07;2104;2795;108370;52638;29.1;14.1
79;2021-05-08;198;506;108568;53144;29.1;14.3
79;2021-05-09;0;0;108568;53144;29.1;14.3
79;2021-05-10;1582;1785;110150;54929;29.6;14.7
79;2021-05-11;2309;1651;112459;56580;30.2;15.2
79;2021-05-12;2000;2680;114459;59260;30.7;15.9
79;2021-05-13;640;289;115099;59549;30.9;16.0
79;2021-05-14;2100;673;117199;60222;31.5;16.2
79;2021-05-15;1399;498;118598;60720;31.8;16.3
79;2021-05-16;1;22;118599;60742;31.8;16.3
79;2021-05-17;1873;1085;120472;61827;32.3;16.6
79;2021-05-18;2971;1272;123443;63099;33.1;16.9
79;2021-05-19;2897;968;126340;64067;33.9;17.2
79;2021-05-20;3106;1244;129446;65311;34.7;17.5
79;2021-05-21;2768;1066;132214;66377;35.5;17.8
79;2021-05-22;1084;261;133298;66638;35.8;17.9
79;2021-05-23;1;0;133299;66638;35.8;17.9
79;2021-05-24;161;20;133460;66658;35.8;17.9
79;2021-05-25;3198;991;136658;67649;36.7;18.2
79;2021-05-26;3312;853;139970;68502;37.6;18.4
79;2021-05-27;3588;1718;143558;70220;38.5;18.8
79;2021-05-28;3331;1815;146889;72035;39.4;19.3
79;2021-05-29;1073;447;147962;72482;39.7;19.5
79;2021-05-30;3;1;147965;72483;39.7;19.5
79;2021-05-31;2382;731;150347;73214;40.3;19.6
79;2021-06-01;3021;1568;153368;74782;41.2;20.1
79;2021-06-02;4066;1164;157434;75946;42.2;20.4
79;2021-06-03;4089;1754;161523;77700;43.3;20.9
79;2021-06-04;4141;2032;165664;79732;44.5;21.4
79;2021-06-05;2801;758;168465;80490;45.2;21.6
79;2021-06-06;696;39;169161;80529;45.4;21.6
79;2021-06-07;2805;1412;171966;81941;46.1;22.0
79;2021-06-08;2982;2069;174948;84010;46.9;22.5
79;2021-06-09;3631;1935;178579;85945;47.9;23.1
79;2021-06-10;3020;1964;181599;87909;48.7;23.6
79;2021-06-11;3767;2315;185366;90224;49.7;24.2
79;2021-06-12;1707;611;187073;90835;50.2;24.4
79;2021-06-13;213;24;187286;90859;50.3;24.4
79;2021-06-14;1247;1690;188533;92549;50.6;24.8
79;2021-06-15;1881;2358;190414;94907;51.1;25.5
79;2021-06-16;2204;2247;192618;97154;51.7;26.1
79;2021-06-17;2237;2616;194855;99770;52.3;26.8
79;2021-06-18;2413;2313;197268;102083;52.9;27.4
79;2021-06-19;1246;579;198514;102662;53.3;27.6
79;2021-06-20;3;2;198517;102664;53.3;27.6
79;2021-06-21;1233;2282;199750;104946;53.6;28.2
79;2021-06-22;1547;2870;201297;107816;54.0;28.9
79;2021-06-23;1770;2549;203067;110365;54.5;29.6
79;2021-06-24;2105;2000;205172;112365;55.1;30.2
79;2021-06-25;1488;2838;206660;115203;55.5;30.9
79;2021-06-26;870;808;207530;116011;55.7;31.1
79;2021-06-27;13;6;207543;116017;55.7;31.1
79;2021-06-28;1056;2620;208599;118637;56.0;31.8
79;2021-06-29;1473;3550;210072;122187;56.4;32.8
79;2021-06-30;1354;3447;211426;125634;56.7;33.7
79;2021-07-01;1202;3785;212628;129419;57.1;34.7
79;2021-07-02;1488;3346;214116;132765;57.5;35.6
79;2021-07-03;399;1504;214515;134269;57.6;36.0
79;2021-07-04;2;9;214517;134278;57.6;36.0
79;2021-07-05;753;2119;215270;136397;57.8;36.6
79;2021-07-06;947;3661;216217;140058;58.0;37.6
79;2021-07-07;1332;4308;217549;144366;58.4;38.7
79;2021-07-08;1107;4041;218656;148407;58.7;39.8
79;2021-07-09;836;3717;219492;152124;58.9;40.8
79;2021-07-10;514;1315;220006;153439;59.0;41.2
79;2021-07-11;3;12;220009;153451;59.0;41.2
79;2021-07-12;545;3695;220554;157146;59.2;42.2
79;2021-07-13;999;5185;221553;162331;59.5;43.6
79;2021-07-14;134;874;221687;163205;59.5;43.8
79;2021-07-15;1235;4682;222922;167887;59.8;45.1
79;2021-07-16;1333;4363;224255;172250;60.2;46.2
79;2021-07-17;576;2424;224831;174674;60.3;46.9
79;2021-07-18;44;498;224875;175172;60.3;47.0
79;2021-07-19;736;3315;225611;178487;60.5;47.9
79;2021-07-20;1230;3944;226841;182431;60.9;49.0
79;2021-07-21;1177;4195;228018;186626;61.2;50.1
79;2021-07-22;1354;3972;229372;190598;61.6;51.1
79;2021-07-23;1349;4553;230721;195151;61.9;52.4
79;2021-07-24;865;1499;231586;196650;62.1;52.8
79;2021-07-25;55;326;231641;196976;62.2;52.9
79;2021-07-26;1371;2598;233012;199574;62.5;53.6
79;2021-07-27;2084;2993;235096;202567;63.1;54.4
79;2021-07-28;2498;2492;237594;205059;63.8;55.0
79;2021-07-29;3009;2861;240603;207920;64.6;55.8
79;2021-07-30;2138;2814;242741;210734;65.1;56.6
79;2021-07-31;888;1157;243629;211891;65.4;56.9
79;2021-08-01;5;3;243634;211894;65.4;56.9
79;2021-08-02;1797;1545;245431;213439;65.9;57.3
79;2021-08-03;2822;2051;248253;215490;66.6;57.8
79;2021-08-04;2985;1742;251238;217232;67.4;58.3
79;2021-08-05;2900;2211;254138;219443;68.2;58.9
79;2021-08-06;2529;1633;256667;221076;68.9;59.3
79;2021-08-07;872;812;257539;221888;69.1;59.5
79;2021-08-08;4;3;257543;221891;69.1;59.5
79;2021-08-09;2495;1085;260038;222976;69.8;59.8
79;2021-08-10;2977;1547;263015;224523;70.6;60.3
79;2021-08-11;2583;1660;265598;226183;71.3;60.7
79;2021-08-12;2766;1428;268364;227611;72.0;61.1
79;2021-08-13;2875;1059;271239;228670;72.8;61.4
79;2021-08-14;518;391;271757;229061;72.9;61.5
79;2021-08-15;8;5;271765;229066;72.9;61.5
79;2021-08-16;1765;1195;273530;230261;73.4;61.8
79;2021-08-17;2102;1590;275632;231851;74.0;62.2
79;2021-08-18;1922;1915;277554;233766;74.5;62.7
79;2021-08-19;1617;1710;279171;235476;74.9;63.2
79;2021-08-20;1513;2162;280684;237638;75.3;63.8
79;2021-08-21;243;543;280927;238181;75.4;63.9
79;2021-08-22;1;21;280928;238202;75.4;63.9
79;2021-08-23;864;2176;281792;240378;75.6;64.5
79;2021-08-24;1072;2484;282864;242862;75.9;65.2
79;2021-08-25;1050;2760;283914;245622;76.2;65.9
79;2021-08-26;1015;2330;284929;247952;76.5;66.5
79;2021-08-27;611;2059;285540;250011;76.6;67.1
79;2021-08-28;299;841;285839;250852;76.7;67.3
79;2021-08-29;7;5;285846;250857;76.7;67.3
79;2021-08-30;554;2366;286400;253223;76.9;68.0
79;2021-08-31;633;2537;287033;255760;77.0;68.6
79;2021-09-01;650;2694;287683;258454;77.2;69.4
79;2021-09-02;761;2513;288444;260967;77.4;70.0
79;2021-09-03;637;2795;289081;263762;77.6;70.8
79;2021-09-04;266;722;289347;264484;77.7;71.0
79;2021-09-05;12;24;289359;264508;77.7;71.0
79;2021-09-06;329;1900;289688;266408;77.7;71.5
79;2021-09-07;343;2140;290031;268548;77.8;72.1
79;2021-09-08;541;2235;290572;270783;78.0;72.7
79;2021-09-09;315;1762;290887;272545;78.1;73.1
79;2021-09-10;421;2290;291308;274835;78.2;73.8
79;2021-09-11;161;868;291469;275703;78.2;74.0
79;2021-09-12;0;0;291469;275703;78.2;74.0
79;2021-09-13;363;1291;291832;276994;78.3;74.3
79;2021-09-14;370;1556;292202;278550;78.4;74.8
79;2021-09-15;477;1432;292679;279982;78.5;75.1
79;2021-09-16;461;1094;293140;281076;78.7;75.4
79;2021-09-17;443;1405;293583;282481;78.8;75.8
79;2021-09-18;139;567;293722;283048;78.8;76.0
79;2021-09-19;1;4;293723;283052;78.8;76.0
79;2021-09-20;190;552;293913;283604;78.9;76.1
79;2021-09-21;350;720;294263;284324;79.0;76.3
79;2021-09-22;209;1102;294472;285426;79.0;76.6
79;2021-09-23;412;565;294884;285991;79.1;76.7
79;2021-09-24;242;1347;295126;287338;79.2;77.1
79;2021-09-25;73;324;295199;287662;79.2;77.2
79;2021-09-26;0;1;295199;287663;79.2;77.2
79;2021-09-27;205;525;295404;288188;79.3;77.3
79;2021-09-28;130;409;295534;288597;79.3;77.4
79;2021-09-29;324;743;295858;289340;79.4;77.6
80;2020-12-27;0;0;0;0;0.0;0.0
80;2020-12-28;0;0;0;0;0.0;0.0
80;2020-12-29;11;0;11;0;0.0;0.0
80;2020-12-30;0;0;11;0;0.0;0.0
80;2020-12-31;0;0;11;0;0.0;0.0
80;2021-01-01;0;0;11;0;0.0;0.0
80;2021-01-02;0;0;11;0;0.0;0.0
80;2021-01-03;1;0;12;0;0.0;0.0
80;2021-01-04;0;0;12;0;0.0;0.0
80;2021-01-05;0;0;12;0;0.0;0.0
80;2021-01-06;30;0;42;0;0.0;0.0
80;2021-01-07;276;2;318;2;0.1;0.0
80;2021-01-08;330;0;648;2;0.1;0.0
80;2021-01-09;108;0;756;2;0.1;0.0
80;2021-01-10;21;0;777;2;0.1;0.0
80;2021-01-11;275;0;1052;2;0.2;0.0
80;2021-01-12;430;1;1482;3;0.3;0.0
80;2021-01-13;514;4;1996;7;0.4;0.0
80;2021-01-14;454;4;2450;11;0.4;0.0
80;2021-01-15;331;1;2781;12;0.5;0.0
80;2021-01-16;103;1;2884;13;0.5;0.0
80;2021-01-17;102;1;2986;14;0.5;0.0
80;2021-01-18;412;2;3398;16;0.6;0.0
80;2021-01-19;963;16;4361;32;0.8;0.0
80;2021-01-20;1086;10;5447;42;1.0;0.0
80;2021-01-21;1012;9;6459;51;1.1;0.0
80;2021-01-22;1113;3;7572;54;1.3;0.0
80;2021-01-23;907;3;8479;57;1.5;0.0
80;2021-01-24;823;5;9302;62;1.6;0.0
80;2021-01-25;1542;10;10844;72;1.9;0.0
80;2021-01-26;1480;11;12324;83;2.2;0.0
80;2021-01-27;822;22;13146;105;2.3;0.0
80;2021-01-28;622;157;13768;262;2.4;0.0
80;2021-01-29;637;190;14405;452;2.5;0.1
80;2021-01-30;87;54;14492;506;2.5;0.1
80;2021-01-31;0;0;14492;506;2.5;0.1
80;2021-02-01;26;230;14518;736;2.5;0.1
80;2021-02-02;21;407;14539;1143;2.6;0.2
80;2021-02-03;28;480;14567;1623;2.6;0.3
80;2021-02-04;278;310;14845;1933;2.6;0.3
80;2021-02-05;347;196;15192;2129;2.7;0.4
80;2021-02-06;168;56;15360;2185;2.7;0.4
80;2021-02-07;1;0;15361;2185;2.7;0.4
80;2021-02-08;425;205;15786;2390;2.8;0.4
80;2021-02-09;686;230;16472;2620;2.9;0.5
80;2021-02-10;607;425;17079;3045;3.0;0.5
80;2021-02-11;862;301;17941;3346;3.1;0.6
80;2021-02-12;945;284;18886;3630;3.3;0.6
80;2021-02-13;197;372;19083;4002;3.3;0.7
80;2021-02-14;78;480;19161;4482;3.4;0.8
80;2021-02-15;606;943;19767;5425;3.5;1.0
80;2021-02-16;688;980;20455;6405;3.6;1.1
80;2021-02-17;484;977;20939;7382;3.7;1.3
80;2021-02-18;569;893;21508;8275;3.8;1.5
80;2021-02-19;502;678;22010;8953;3.9;1.6
80;2021-02-20;22;365;22032;9318;3.9;1.6
80;2021-02-21;47;38;22079;9356;3.9;1.6
80;2021-02-22;147;455;22226;9811;3.9;1.7
80;2021-02-23;471;572;22697;10383;4.0;1.8
80;2021-02-24;431;526;23128;10909;4.1;1.9
80;2021-02-25;815;414;23943;11323;4.2;2.0
80;2021-02-26;1063;410;25006;11733;4.4;2.1
80;2021-02-27;475;54;25481;11787;4.5;2.1
80;2021-02-28;49;22;25530;11809;4.5;2.1
80;2021-03-01;729;61;26259;11870;4.6;2.1
80;2021-03-02;1013;89;27272;11959;4.8;2.1
80;2021-03-03;982;51;28254;12010;5.0;2.1
80;2021-03-04;1389;192;29643;12202;5.2;2.1
80;2021-03-05;1874;307;31517;12509;5.5;2.2
80;2021-03-06;2917;330;34434;12839;6.0;2.3
80;2021-03-07;1842;74;36276;12913;6.4;2.3
80;2021-03-08;714;550;36990;13463;6.5;2.4
80;2021-03-09;1310;797;38300;14260;6.7;2.5
80;2021-03-10;1724;695;40024;14955;7.0;2.6
80;2021-03-11;1909;760;41933;15715;7.4;2.8
80;2021-03-12;3138;703;45071;16418;7.9;2.9
80;2021-03-13;4006;205;49077;16623;8.6;2.9
80;2021-03-14;350;12;49427;16635;8.7;2.9
80;2021-03-15;1014;239;50441;16874;8.9;3.0
80;2021-03-16;882;330;51323;17204;9.0;3.0
80;2021-03-17;665;269;51988;17473;9.1;3.1
80;2021-03-18;1002;286;52990;17759;9.3;3.1
80;2021-03-19;1739;370;54729;18129;9.6;3.2
80;2021-03-20;3821;117;58550;18246;10.3;3.2
80;2021-03-21;486;31;59036;18277;10.4;3.2
80;2021-03-22;903;287;59939;18564;10.5;3.3
80;2021-03-23;1713;411;61652;18975;10.8;3.3
80;2021-03-24;1755;464;63407;19439;11.1;3.4
80;2021-03-25;2713;443;66120;19882;11.6;3.5
80;2021-03-26;3105;405;69225;20287;12.1;3.6
80;2021-03-27;2237;226;71462;20513;12.5;3.6
80;2021-03-28;676;93;72138;20606;12.7;3.6
80;2021-03-29;1979;739;74117;21345;13.0;3.7
80;2021-03-30;1967;861;76084;22206;13.4;3.9
80;2021-03-31;1495;981;77579;23187;13.6;4.1
80;2021-04-01;1950;1480;79529;24667;14.0;4.3
80;2021-04-02;2811;1550;82340;26217;14.5;4.6
80;2021-04-03;3048;853;85388;27070;15.0;4.8
80;2021-04-04;134;8;85522;27078;15.0;4.8
80;2021-04-05;684;195;86206;27273;15.1;4.8
80;2021-04-06;1280;958;87486;28231;15.4;5.0
80;2021-04-07;1624;1193;89110;29424;15.6;5.2
80;2021-04-08;2154;842;91264;30266;16.0;5.3
80;2021-04-09;3531;1351;94795;31617;16.6;5.5
80;2021-04-10;2737;1946;97532;33563;17.1;5.9
80;2021-04-11;188;176;97720;33739;17.2;5.9
80;2021-04-12;1814;483;99534;34222;17.5;6.0
80;2021-04-13;2385;1031;101919;35253;17.9;6.2
80;2021-04-14;2769;1163;104688;36416;18.4;6.4
80;2021-04-15;3731;877;108419;37293;19.0;6.5
80;2021-04-16;3337;871;111756;38164;19.6;6.7
80;2021-04-17;1653;2291;113409;40455;19.9;7.1
80;2021-04-18;372;390;113781;40845;20.0;7.2
80;2021-04-19;951;771;114732;41616;20.1;7.3
80;2021-04-20;1613;820;116345;42436;20.4;7.4
80;2021-04-21;1612;996;117957;43432;20.7;7.6
80;2021-04-22;2167;1251;120124;44683;21.1;7.8
80;2021-04-23;2639;1245;122763;45928;21.5;8.1
80;2021-04-24;1357;1190;124120;47118;21.8;8.3
80;2021-04-25;209;531;124329;47649;21.8;8.4
80;2021-04-26;1295;1438;125624;49087;22.0;8.6
80;2021-04-27;2025;1396;127649;50483;22.4;8.9
80;2021-04-28;2199;1379;129848;51862;22.8;9.1
80;2021-04-29;3218;1867;133066;53729;23.4;9.4
80;2021-04-30;3081;2839;136147;56568;23.9;9.9
80;2021-05-01;987;658;137134;57226;24.1;10.0
80;2021-05-02;371;53;137505;57279;24.1;10.1
80;2021-05-03;2720;1186;140225;58465;24.6;10.3
80;2021-05-04;2494;1697;142719;60162;25.0;10.6
80;2021-05-05;3366;1895;146085;62057;25.6;10.9
80;2021-05-06;3169;2546;149254;64603;26.2;11.3
80;2021-05-07;3454;2685;152708;67288;26.8;11.8
80;2021-05-08;2784;924;155492;68212;27.3;12.0
80;2021-05-09;1407;268;156899;68480;27.5;12.0
80;2021-05-10;1880;1828;158779;70308;27.9;12.3
80;2021-05-11;3274;1793;162053;72101;28.4;12.7
80;2021-05-12;4703;1574;166756;73675;29.3;12.9
80;2021-05-13;3836;367;170592;74042;29.9;13.0
80;2021-05-14;5188;1392;175780;75434;30.9;13.2
80;2021-05-15;5917;1053;181697;76487;31.9;13.4
80;2021-05-16;2678;312;184375;76799;32.4;13.5
80;2021-05-17;2371;818;186746;77617;32.8;13.6
80;2021-05-18;3949;850;190695;78467;33.5;13.8
80;2021-05-19;4018;940;194713;79407;34.2;13.9
80;2021-05-20;4568;1215;199281;80622;35.0;14.1
80;2021-05-21;4890;1650;204171;82272;35.8;14.4
80;2021-05-22;5030;1156;209201;83428;36.7;14.6
80;2021-05-23;1783;237;210984;83665;37.0;14.7
80;2021-05-24;1469;159;212453;83824;37.3;14.7
80;2021-05-25;2622;1136;215075;84960;37.7;14.9
80;2021-05-26;4249;1703;219324;86663;38.5;15.2
80;2021-05-27;3977;2467;223301;89130;39.2;15.6
80;2021-05-28;3866;2968;227167;92098;39.9;16.2
80;2021-05-29;3697;1627;230864;93725;40.5;16.4
80;2021-05-30;1182;198;232046;93923;40.7;16.5
80;2021-05-31;2605;1369;234651;95292;41.2;16.7
80;2021-06-01;4031;2434;238682;97726;41.9;17.2
80;2021-06-02;3334;2005;242016;99731;42.5;17.5
80;2021-06-03;4266;2924;246282;102655;43.2;18.0
80;2021-06-04;4796;3082;251078;105737;44.1;18.6
80;2021-06-05;3554;2065;254632;107802;44.7;18.9
80;2021-06-06;802;211;255434;108013;44.8;19.0
80;2021-06-07;1750;1945;257184;109958;45.1;19.3
80;2021-06-08;2743;2552;259927;112510;45.6;19.7
80;2021-06-09;3012;2735;262939;115245;46.1;20.2
80;2021-06-10;3163;3167;266102;118412;46.7;20.8
80;2021-06-11;3217;3893;269319;122305;47.3;21.5
80;2021-06-12;3042;2326;272361;124631;47.8;21.9
80;2021-06-13;474;404;272835;125035;47.9;21.9
80;2021-06-14;1263;2852;274098;127887;48.1;22.4
80;2021-06-15;2315;3418;276413;131305;48.5;23.0
80;2021-06-16;1563;4212;277976;135517;48.8;23.8
80;2021-06-17;2359;3622;280335;139139;49.2;24.4
80;2021-06-18;2552;3903;282887;143042;49.6;25.1
80;2021-06-19;2986;4340;285873;147382;50.2;25.9
80;2021-06-20;203;1077;286076;148459;50.2;26.1
80;2021-06-21;1015;2619;287091;151078;50.4;26.5
80;2021-06-22;1149;3929;288240;155007;50.6;27.2
80;2021-06-23;1850;5289;290090;160296;50.9;28.1
80;2021-06-24;1695;4683;291785;164979;51.2;29.0
80;2021-06-25;1374;6125;293159;171104;51.5;30.0
80;2021-06-26;1933;6183;295092;177287;51.8;31.1
80;2021-06-27;333;2031;295425;179318;51.8;31.5
80;2021-06-28;903;3169;296328;182487;52.0;32.0
80;2021-06-29;1919;4622;298247;187109;52.3;32.8
80;2021-06-30;1245;4784;299492;191893;52.6;33.7
80;2021-07-01;1594;4999;301086;196892;52.8;34.6
80;2021-07-02;1856;5984;302942;202876;53.2;35.6
80;2021-07-03;1293;5265;304235;208141;53.4;36.5
80;2021-07-04;692;1471;304927;209612;53.5;36.8
80;2021-07-05;879;2963;305806;212575;53.7;37.3
80;2021-07-06;1852;3990;307658;216565;54.0;38.0
80;2021-07-07;1560;4504;309218;221069;54.3;38.8
80;2021-07-08;2082;5003;311300;226072;54.6;39.7
80;2021-07-09;2596;5472;313896;231544;55.1;40.6
80;2021-07-10;1616;4015;315512;235559;55.4;41.3
80;2021-07-11;406;805;315918;236364;55.4;41.5
80;2021-07-12;871;3379;316789;239743;55.6;42.1
80;2021-07-13;2087;5083;318876;244826;56.0;43.0
80;2021-07-14;2801;1749;321677;246575;56.5;43.3
80;2021-07-15;2792;5296;324469;251871;56.9;44.2
80;2021-07-16;3878;5890;328347;257761;57.6;45.2
80;2021-07-17;3368;4460;331715;262221;58.2;46.0
80;2021-07-18;874;896;332589;263117;58.4;46.2
80;2021-07-19;2157;2885;334746;266002;58.8;46.7
80;2021-07-20;3321;4903;338067;270905;59.3;47.5
80;2021-07-21;3496;4496;341563;275401;59.9;48.3
80;2021-07-22;4362;4569;345925;279970;60.7;49.1
80;2021-07-23;5399;4825;351324;284795;61.7;50.0
80;2021-07-24;4369;4343;355693;289138;62.4;50.7
80;2021-07-25;1185;650;356878;289788;62.6;50.9
80;2021-07-26;2681;2340;359559;292128;63.1;51.3
80;2021-07-27;4373;3705;363932;295833;63.9;51.9
80;2021-07-28;5101;2803;369033;298636;64.8;52.4
80;2021-07-29;4991;3229;374024;301865;65.6;53.0
80;2021-07-30;5024;3638;379048;305503;66.5;53.6
80;2021-07-31;4156;2928;383204;308431;67.3;54.1
80;2021-08-01;1288;363;384492;308794;67.5;54.2
80;2021-08-02;2059;1739;386551;310533;67.8;54.5
80;2021-08-03;3716;2363;390267;312896;68.5;54.9
80;2021-08-04;3366;2490;393633;315386;69.1;55.4
80;2021-08-05;3136;2576;396769;317962;69.6;55.8
80;2021-08-06;3248;2876;400017;320838;70.2;56.3
80;2021-08-07;2423;2666;402440;323504;70.6;56.8
80;2021-08-08;621;686;403061;324190;70.7;56.9
80;2021-08-09;1382;2078;404443;326268;71.0;57.3
80;2021-08-10;2353;2849;406796;329117;71.4;57.8
80;2021-08-11;1946;2383;408742;331500;71.7;58.2
80;2021-08-12;2236;2659;410978;334159;72.1;58.6
80;2021-08-13;1882;3154;412860;337313;72.5;59.2
80;2021-08-14;1411;2112;414271;339425;72.7;59.6
80;2021-08-15;318;663;414589;340088;72.8;59.7
80;2021-08-16;897;2419;415486;342507;72.9;60.1
80;2021-08-17;1709;3505;417195;346012;73.2;60.7
80;2021-08-18;1234;3714;418429;349726;73.4;61.4
80;2021-08-19;1568;3821;419997;353547;73.7;62.1
80;2021-08-20;1264;4434;421261;357981;73.9;62.8
80;2021-08-21;1078;2686;422339;360667;74.1;63.3
80;2021-08-22;145;680;422484;361347;74.2;63.4
80;2021-08-23;583;2999;423067;364346;74.3;63.9
80;2021-08-24;1092;4371;424159;368717;74.4;64.7
80;2021-08-25;971;3677;425130;372394;74.6;65.4
80;2021-08-26;956;3819;426086;376213;74.8;66.0
80;2021-08-27;1016;4456;427102;380669;75.0;66.8
80;2021-08-28;720;3347;427822;384016;75.1;67.4
80;2021-08-29;199;555;428021;384571;75.1;67.5
80;2021-08-30;500;2307;428521;386878;75.2;67.9
80;2021-08-31;750;3183;429271;390061;75.3;68.5
80;2021-09-01;675;2481;429946;392542;75.5;68.9
80;2021-09-02;525;2278;430471;394820;75.6;69.3
80;2021-09-03;761;3116;431232;397936;75.7;69.8
80;2021-09-04;956;2753;432188;400689;75.9;70.3
80;2021-09-05;165;374;432353;401063;75.9;70.4
80;2021-09-06;421;1562;432774;402625;76.0;70.7
80;2021-09-07;490;1840;433264;404465;76.0;71.0
80;2021-09-08;494;1874;433758;406339;76.1;71.3
80;2021-09-09;529;1753;434287;408092;76.2;71.6
80;2021-09-10;618;2076;434905;410168;76.3;72.0
80;2021-09-11;520;2117;435425;412285;76.4;72.4
80;2021-09-12;77;327;435502;412612;76.4;72.4
80;2021-09-13;310;1101;435812;413713;76.5;72.6
80;2021-09-14;638;1474;436450;415187;76.6;72.9
80;2021-09-15;355;1087;436805;416274;76.7;73.1
80;2021-09-16;474;1031;437279;417305;76.7;73.2
80;2021-09-17;506;1238;437785;418543;76.8;73.5
80;2021-09-18;349;1276;438134;419819;76.9;73.7
80;2021-09-19;17;169;438151;419988;76.9;73.7
80;2021-09-20;325;446;438476;420434;77.0;73.8
80;2021-09-21;294;614;438770;421048;77.0;73.9
80;2021-09-22;283;709;439053;421757;77.1;74.0
80;2021-09-23;302;505;439355;422262;77.1;74.1
80;2021-09-24;369;896;439724;423158;77.2;74.3
80;2021-09-25;281;1131;440005;424289;77.2;74.5
80;2021-09-26;20;109;440025;424398;77.2;74.5
80;2021-09-27;188;535;440213;424933;77.3;74.6
80;2021-09-28;147;380;440360;425313;77.3;74.6
80;2021-09-29;255;510;440615;425823;77.3;74.7
81;2020-12-27;1;0;1;0;0.0;0.0
81;2020-12-28;0;0;1;0;0.0;0.0
81;2020-12-29;0;0;1;0;0.0;0.0
81;2020-12-30;1;0;2;0;0.0;0.0
81;2020-12-31;0;0;2;0;0.0;0.0
81;2021-01-01;0;0;2;0;0.0;0.0
81;2021-01-02;0;0;2;0;0.0;0.0
81;2021-01-03;0;0;2;0;0.0;0.0
81;2021-01-04;1;0;3;0;0.0;0.0
81;2021-01-05;0;0;3;0;0.0;0.0
81;2021-01-06;5;0;8;0;0.0;0.0
81;2021-01-07;265;0;273;0;0.1;0.0
81;2021-01-08;312;1;585;1;0.2;0.0
81;2021-01-09;74;1;659;2;0.2;0.0
81;2021-01-10;1;0;660;2;0.2;0.0
81;2021-01-11;133;0;793;2;0.2;0.0
81;2021-01-12;167;0;960;2;0.2;0.0
81;2021-01-13;234;1;1194;3;0.3;0.0
81;2021-01-14;963;5;2157;8;0.6;0.0
81;2021-01-15;523;3;2680;11;0.7;0.0
81;2021-01-16;71;1;2751;12;0.7;0.0
81;2021-01-17;0;0;2751;12;0.7;0.0
81;2021-01-18;581;2;3332;14;0.9;0.0
81;2021-01-19;662;4;3994;18;1.0;0.0
81;2021-01-20;754;2;4748;20;1.2;0.0
81;2021-01-21;1183;4;5931;24;1.5;0.0
81;2021-01-22;857;2;6788;26;1.7;0.0
81;2021-01-23;221;2;7009;28;1.8;0.0
81;2021-01-24;102;0;7111;28;1.8;0.0
81;2021-01-25;569;1;7680;29;2.0;0.0
81;2021-01-26;636;2;8316;31;2.1;0.0
81;2021-01-27;552;1;8868;32;2.3;0.0
81;2021-01-28;700;203;9568;235;2.5;0.1
81;2021-01-29;303;171;9871;406;2.5;0.1
81;2021-01-30;204;34;10075;440;2.6;0.1
81;2021-01-31;104;0;10179;440;2.6;0.1
81;2021-02-01;320;111;10499;551;2.7;0.1
81;2021-02-02;445;116;10944;667;2.8;0.2
81;2021-02-03;476;204;11420;871;2.9;0.2
81;2021-02-04;1449;628;12869;1499;3.3;0.4
81;2021-02-05;870;298;13739;1797;3.5;0.5
81;2021-02-06;274;17;14013;1814;3.6;0.5
81;2021-02-07;103;0;14116;1814;3.6;0.5
81;2021-02-08;275;194;14391;2008;3.7;0.5
81;2021-02-09;420;187;14811;2195;3.8;0.6
81;2021-02-10;371;262;15182;2457;3.9;0.6
81;2021-02-11;651;340;15833;2797;4.1;0.7
81;2021-02-12;579;465;16412;3262;4.2;0.8
81;2021-02-13;188;104;16600;3366;4.3;0.9
81;2021-02-14;100;1;16700;3367;4.3;0.9
81;2021-02-15;234;324;16934;3691;4.4;1.0
81;2021-02-16;281;459;17215;4150;4.4;1.1
81;2021-02-17;241;378;17456;4528;4.5;1.2
81;2021-02-18;482;540;17938;5068;4.6;1.3
81;2021-02-19;571;303;18509;5371;4.8;1.4
81;2021-02-20;322;223;18831;5594;4.9;1.4
81;2021-02-21;23;66;18854;5660;4.9;1.5
81;2021-02-22;233;419;19087;6079;4.9;1.6
81;2021-02-23;168;480;19255;6559;5.0;1.7
81;2021-02-24;291;513;19546;7072;5.0;1.8
81;2021-02-25;719;920;20265;7992;5.2;2.1
81;2021-02-26;911;843;21176;8835;5.5;2.3
81;2021-02-27;275;221;21451;9056;5.5;2.3
81;2021-02-28;21;61;21472;9117;5.5;2.4
81;2021-03-01;208;353;21680;9470;5.6;2.4
81;2021-03-02;364;458;22044;9928;5.7;2.6
81;2021-03-03;463;370;22507;10298;5.8;2.7
81;2021-03-04;1061;403;23568;10701;6.1;2.8
81;2021-03-05;1406;352;24974;11053;6.4;2.8
81;2021-03-06;982;158;25956;11211;6.7;2.9
81;2021-03-07;154;91;26110;11302;6.7;2.9
81;2021-03-08;466;319;26576;11621;6.9;3.0
81;2021-03-09;814;332;27390;11953;7.1;3.1
81;2021-03-10;898;360;28288;12313;7.3;3.2
81;2021-03-11;1350;325;29638;12638;7.6;3.3
81;2021-03-12;1690;296;31328;12934;8.1;3.3
81;2021-03-13;1030;171;32358;13105;8.3;3.4
81;2021-03-14;66;79;32424;13184;8.4;3.4
81;2021-03-15;1092;219;33516;13403;8.6;3.5
81;2021-03-16;724;214;34240;13617;8.8;3.5
81;2021-03-17;893;275;35133;13892;9.1;3.6
81;2021-03-18;970;573;36103;14465;9.3;3.7
81;2021-03-19;1271;456;37374;14921;9.6;3.8
81;2021-03-20;677;285;38051;15206;9.8;3.9
81;2021-03-21;139;22;38190;15228;9.8;3.9
81;2021-03-22;932;267;39122;15495;10.1;4.0
81;2021-03-23;1420;219;40542;15714;10.5;4.1
81;2021-03-24;1606;262;42148;15976;10.9;4.1
81;2021-03-25;2028;322;44176;16298;11.4;4.2
81;2021-03-26;2100;270;46276;16568;11.9;4.3
81;2021-03-27;1091;37;47367;16605;12.2;4.3
81;2021-03-28;734;38;48101;16643;12.4;4.3
81;2021-03-29;2866;188;50967;16831;13.1;4.3
81;2021-03-30;3055;214;54022;17045;13.9;4.4
81;2021-03-31;2691;297;56713;17342;14.6;4.5
81;2021-04-01;3314;569;60027;17911;15.5;4.6
81;2021-04-02;2616;369;62643;18280;16.1;4.7
81;2021-04-03;1147;304;63790;18584;16.4;4.8
81;2021-04-04;1403;24;65193;18608;16.8;4.8
81;2021-04-05;718;20;65911;18628;17.0;4.8
81;2021-04-06;1599;516;67510;19144;17.4;4.9
81;2021-04-07;1817;581;69327;19725;17.9;5.1
81;2021-04-08;2619;822;71946;20547;18.5;5.3
81;2021-04-09;3052;476;74998;21023;19.3;5.4
81;2021-04-10;1476;516;76474;21539;19.7;5.6
81;2021-04-11;1299;70;77773;21609;20.0;5.6
81;2021-04-12;1220;682;78993;22291;20.4;5.7
81;2021-04-13;2528;791;81521;23082;21.0;6.0
81;2021-04-14;2506;834;84027;23916;21.7;6.2
81;2021-04-15;3099;1198;87126;25114;22.5;6.5
81;2021-04-16;2822;1090;89948;26204;23.2;6.8
81;2021-04-17;1145;296;91093;26500;23.5;6.8
81;2021-04-18;519;145;91612;26645;23.6;6.9
81;2021-04-19;913;819;92525;27464;23.9;7.1
81;2021-04-20;2270;1168;94795;28632;24.4;7.4
81;2021-04-21;2224;1004;97019;29636;25.0;7.6
81;2021-04-22;2816;1060;99835;30696;25.7;7.9
81;2021-04-23;2885;969;102720;31665;26.5;8.2
81;2021-04-24;1326;741;104046;32406;26.8;8.4
81;2021-04-25;454;715;104500;33121;26.9;8.5
81;2021-04-26;1061;2421;105561;35542;27.2;9.2
81;2021-04-27;1596;2345;107157;37887;27.6;9.8
81;2021-04-28;1427;2393;108584;40280;28.0;10.4
81;2021-04-29;1818;2739;110402;43019;28.5;11.1
81;2021-04-30;2013;2348;112415;45367;29.0;11.7
81;2021-05-01;362;685;112777;46052;29.1;11.9
81;2021-05-02;291;1376;113068;47428;29.1;12.2
81;2021-05-03;1115;1168;114183;48596;29.4;12.5
81;2021-05-04;2621;1908;116804;50504;30.1;13.0
81;2021-05-05;2016;1931;118820;52435;30.6;13.5
81;2021-05-06;2748;3455;121568;55890;31.3;14.4
81;2021-05-07;2128;2878;123696;58768;31.9;15.2
81;2021-05-08;962;878;124658;59646;32.1;15.4
81;2021-05-09;534;1351;125192;60997;32.3;15.7
81;2021-05-10;825;1599;126017;62596;32.5;16.1
81;2021-05-11;1661;2571;127678;65167;32.9;16.8
81;2021-05-12;1640;2459;129318;67626;33.3;17.4
81;2021-05-13;1216;564;130534;68190;33.7;17.6
81;2021-05-14;1890;1723;132424;69913;34.1;18.0
81;2021-05-15;1511;618;133935;70531;34.5;18.2
81;2021-05-16;1368;417;135303;70948;34.9;18.3
81;2021-05-17;1167;864;136470;71812;35.2;18.5
81;2021-05-18;1702;1419;138172;73231;35.6;18.9
81;2021-05-19;2641;1244;140813;74475;36.3;19.2
81;2021-05-20;2968;1351;143781;75826;37.1;19.5
81;2021-05-21;2739;1115;146520;76941;37.8;19.8
81;2021-05-22;2814;520;149334;77461;38.5;20.0
81;2021-05-23;1178;74;150512;77535;38.8;20.0
81;2021-05-24;837;83;151349;77618;39.0;20.0
81;2021-05-25;2490;1100;153839;78718;39.7;20.3
81;2021-05-26;1891;800;155730;79518;40.1;20.5
81;2021-05-27;2555;1542;158285;81060;40.8;20.9
81;2021-05-28;2566;1660;160851;82720;41.5;21.3
81;2021-05-29;1400;544;162251;83264;41.8;21.5
81;2021-05-30;935;219;163186;83483;42.1;21.5
81;2021-05-31;1183;1336;164369;84819;42.4;21.9
81;2021-06-01;1779;2695;166148;87514;42.8;22.6
81;2021-06-02;2007;2445;168155;89959;43.4;23.2
81;2021-06-03;2003;2529;170158;92488;43.9;23.8
81;2021-06-04;1844;2942;172002;95430;44.3;24.6
81;2021-06-05;1757;1307;173759;96737;44.8;24.9
81;2021-06-06;370;366;174129;97103;44.9;25.0
81;2021-06-07;1209;1540;175338;98643;45.2;25.4
81;2021-06-08;2369;2382;177707;101025;45.8;26.0
81;2021-06-09;2438;1867;180145;102892;46.4;26.5
81;2021-06-10;1278;1560;181423;104452;46.8;26.9
81;2021-06-11;2657;2198;184080;106650;47.5;27.5
81;2021-06-12;1659;1037;185739;107687;47.9;27.8
81;2021-06-13;444;475;186183;108162;48.0;27.9
81;2021-06-14;771;1415;186954;109577;48.2;28.2
81;2021-06-15;1677;3500;188631;113077;48.6;29.2
81;2021-06-16;1269;3013;189900;116090;49.0;29.9
81;2021-06-17;1344;2525;191244;118615;49.3;30.6
81;2021-06-18;1837;2771;193081;121386;49.8;31.3
81;2021-06-19;824;951;193905;122337;50.0;31.5
81;2021-06-20;405;536;194310;122873;50.1;31.7
81;2021-06-21;425;1038;194735;123911;50.2;31.9
81;2021-06-22;1061;2567;195796;126478;50.5;32.6
81;2021-06-23;1142;2159;196938;128637;50.8;33.2
81;2021-06-24;1115;1937;198053;130574;51.1;33.7
81;2021-06-25;1238;2864;199291;133438;51.4;34.4
81;2021-06-26;721;1712;200012;135150;51.6;34.8
81;2021-06-27;526;1646;200538;136796;51.7;35.3
81;2021-06-28;476;1538;201014;138334;51.8;35.7
81;2021-06-29;1079;2634;202093;140968;52.1;36.3
81;2021-06-30;1043;3153;203136;144121;52.4;37.2
81;2021-07-01;1102;2628;204238;146749;52.7;37.8
81;2021-07-02;1070;2860;205308;149609;52.9;38.6
81;2021-07-03;732;2829;206040;152438;53.1;39.3
81;2021-07-04;268;1010;206308;153448;53.2;39.6
81;2021-07-05;702;1625;207010;155073;53.4;40.0
81;2021-07-06;975;3176;207985;158249;53.6;40.8
81;2021-07-07;1059;2437;209044;160686;53.9;41.4
81;2021-07-08;1030;2232;210074;162918;54.2;42.0
81;2021-07-09;1147;2702;211221;165620;54.5;42.7
81;2021-07-10;806;1523;212027;167143;54.7;43.1
81;2021-07-11;436;1012;212463;168155;54.8;43.4
81;2021-07-12;785;1725;213248;169880;55.0;43.8
81;2021-07-13;2081;3144;215329;173024;55.5;44.6
81;2021-07-14;1443;1573;216772;174597;55.9;45.0
81;2021-07-15;2545;2760;219317;177357;56.5;45.7
81;2021-07-16;2032;3027;221349;180384;57.1;46.5
81;2021-07-17;1218;2452;222567;182836;57.4;47.1
81;2021-07-18;672;1131;223239;183967;57.6;47.4
81;2021-07-19;1256;1734;224495;185701;57.9;47.9
81;2021-07-20;3064;2806;227559;188507;58.7;48.6
81;2021-07-21;3488;2346;231047;190853;59.6;49.2
81;2021-07-22;3557;2092;234604;192945;60.5;49.7
81;2021-07-23;3172;3245;237776;196190;61.3;50.6
81;2021-07-24;2518;1722;240294;197912;61.9;51.0
81;2021-07-25;1684;711;241978;198623;62.4;51.2
81;2021-07-26;2014;1547;243992;200170;62.9;51.6
81;2021-07-27;3619;2543;247611;202713;63.8;52.3
81;2021-07-28;3052;2205;250663;204918;64.6;52.8
81;2021-07-29;3354;1781;254017;206699;65.5;53.3
81;2021-07-30;2829;2261;256846;208960;66.2;53.9
81;2021-07-31;1947;1015;258793;209975;66.7;54.1
81;2021-08-01;836;637;259629;210612;66.9;54.3
81;2021-08-02;1082;989;260711;211601;67.2;54.6
81;2021-08-03;2362;2116;263073;213717;67.8;55.1
81;2021-08-04;2031;1535;265104;215252;68.3;55.5
81;2021-08-05;1544;1877;266648;217129;68.7;56.0
81;2021-08-06;1726;1970;268374;219099;69.2;56.5
81;2021-08-07;984;1042;269358;220141;69.4;56.8
81;2021-08-08;437;708;269795;220849;69.6;56.9
81;2021-08-09;804;659;270599;221508;69.8;57.1
81;2021-08-10;1610;2756;272209;224264;70.2;57.8
81;2021-08-11;1110;2410;273319;226674;70.5;58.4
81;2021-08-12;1063;2250;274382;228924;70.7;59.0
81;2021-08-13;873;2473;275255;231397;71.0;59.7
81;2021-08-14;501;1873;275756;233270;71.1;60.1
81;2021-08-15;141;1100;275897;234370;71.1;60.4
81;2021-08-16;631;1816;276528;236186;71.3;60.9
81;2021-08-17;1346;3101;277874;239287;71.6;61.7
81;2021-08-18;1067;2359;278941;241646;71.9;62.3
81;2021-08-19;942;2267;279883;243913;72.2;62.9
81;2021-08-20;928;2354;280811;246267;72.4;63.5
81;2021-08-21;471;1538;281282;247805;72.5;63.9
81;2021-08-22;184;931;281466;248736;72.6;64.1
81;2021-08-23;487;1260;281953;249996;72.7;64.4
81;2021-08-24;852;2543;282805;252539;72.9;65.1
81;2021-08-25;718;2053;283523;254592;73.1;65.6
81;2021-08-26;855;2110;284378;256702;73.3;66.2
81;2021-08-27;852;2185;285230;258887;73.5;66.7
81;2021-08-28;484;1417;285714;260304;73.7;67.1
81;2021-08-29;163;832;285877;261136;73.7;67.3
81;2021-08-30;420;1211;286297;262347;73.8;67.6
81;2021-08-31;831;2116;287128;264463;74.0;68.2
81;2021-09-01;656;1410;287784;265873;74.2;68.5
81;2021-09-02;575;1305;288359;267178;74.3;68.9
81;2021-09-03;581;1464;288940;268642;74.5;69.3
81;2021-09-04;496;932;289436;269574;74.6;69.5
81;2021-09-05;97;245;289533;269819;74.6;69.6
81;2021-09-06;276;678;289809;270497;74.7;69.7
81;2021-09-07;386;1379;290195;271876;74.8;70.1
81;2021-09-08;439;1266;290634;273142;74.9;70.4
81;2021-09-09;364;1040;290998;274182;75.0;70.7
81;2021-09-10;391;1247;291389;275429;75.1;71.0
81;2021-09-11;404;926;291793;276355;75.2;71.2
81;2021-09-12;78;244;291871;276599;75.2;71.3
81;2021-09-13;230;729;292101;277328;75.3;71.5
81;2021-09-14;498;1195;292599;278523;75.4;71.8
81;2021-09-15;452;764;293051;279287;75.5;72.0
81;2021-09-16;335;548;293386;279835;75.6;72.1
81;2021-09-17;411;841;293797;280676;75.7;72.4
81;2021-09-18;258;697;294055;281373;75.8;72.5
81;2021-09-19;50;164;294105;281537;75.8;72.6
81;2021-09-20;107;323;294212;281860;75.8;72.7
81;2021-09-21;264;595;294476;282455;75.9;72.8
81;2021-09-22;213;663;294689;283118;76.0;73.0
81;2021-09-23;163;663;294852;283781;76.0;73.2
81;2021-09-24;308;705;295160;284486;76.1;73.3
81;2021-09-25;170;673;295330;285159;76.1;73.5
81;2021-09-26;35;116;295365;285275;76.1;73.5
81;2021-09-27;136;272;295501;285547;76.2;73.6
81;2021-09-28;186;362;295687;285909;76.2;73.7
81;2021-09-29;248;517;295935;286426;76.3;73.8
82;2020-12-27;1;0;1;0;0.0;0.0
82;2020-12-28;2;0;3;0;0.0;0.0
82;2020-12-29;0;0;3;0;0.0;0.0
82;2020-12-30;0;0;3;0;0.0;0.0
82;2020-12-31;0;0;3;0;0.0;0.0
82;2021-01-01;0;0;3;0;0.0;0.0
82;2021-01-02;0;0;3;0;0.0;0.0
82;2021-01-03;0;0;3;0;0.0;0.0
82;2021-01-04;0;0;3;0;0.0;0.0
82;2021-01-05;86;0;89;0;0.0;0.0
82;2021-01-06;1;0;90;0;0.0;0.0
82;2021-01-07;75;0;165;0;0.1;0.0
82;2021-01-08;46;0;211;0;0.1;0.0
82;2021-01-09;77;0;288;0;0.1;0.0
82;2021-01-10;0;0;288;0;0.1;0.0
82;2021-01-11;94;0;382;0;0.1;0.0
82;2021-01-12;285;0;667;0;0.3;0.0
82;2021-01-13;336;1;1003;1;0.4;0.0
82;2021-01-14;444;2;1447;3;0.6;0.0
82;2021-01-15;612;2;2059;5;0.8;0.0
82;2021-01-16;230;3;2289;8;0.9;0.0
82;2021-01-17;89;0;2378;8;0.9;0.0
82;2021-01-18;432;0;2810;8;1.1;0.0
82;2021-01-19;483;1;3293;9;1.3;0.0
82;2021-01-20;663;2;3956;11;1.5;0.0
82;2021-01-21;447;1;4403;12;1.7;0.0
82;2021-01-22;483;2;4886;14;1.9;0.0
82;2021-01-23;151;0;5037;14;1.9;0.0
82;2021-01-24;0;0;5037;14;1.9;0.0
82;2021-01-25;375;0;5412;14;2.1;0.0
82;2021-01-26;468;0;5880;14;2.2;0.0
82;2021-01-27;520;0;6400;14;2.4;0.0
82;2021-01-28;586;34;6986;48;2.7;0.0
82;2021-01-29;405;108;7391;156;2.8;0.1
82;2021-01-30;44;20;7435;176;2.8;0.1
82;2021-01-31;2;0;7437;176;2.8;0.1
82;2021-02-01;292;53;7729;229;2.9;0.1
82;2021-02-02;344;96;8073;325;3.1;0.1
82;2021-02-03;462;65;8535;390;3.2;0.1
82;2021-02-04;768;210;9303;600;3.5;0.2
82;2021-02-05;480;132;9783;732;3.7;0.3
82;2021-02-06;93;36;9876;768;3.8;0.3
82;2021-02-07;29;79;9905;847;3.8;0.3
82;2021-02-08;151;185;10056;1032;3.8;0.4
82;2021-02-09;238;330;10294;1362;3.9;0.5
82;2021-02-10;271;543;10565;1905;4.0;0.7
82;2021-02-11;225;347;10790;2252;4.1;0.9
82;2021-02-12;190;520;10980;2772;4.2;1.1
82;2021-02-13;60;97;11040;2869;4.2;1.1
82;2021-02-14;5;61;11045;2930;4.2;1.1
82;2021-02-15;216;246;11261;3176;4.3;1.2
82;2021-02-16;280;326;11541;3502;4.4;1.3
82;2021-02-17;359;463;11900;3965;4.5;1.5
82;2021-02-18;507;430;12407;4395;4.7;1.7
82;2021-02-19;490;500;12897;4895;4.9;1.9
82;2021-02-20;78;119;12975;5014;4.9;1.9
82;2021-02-21;0;0;12975;5014;4.9;1.9
82;2021-02-22;200;332;13175;5346;5.0;2.0
82;2021-02-23;277;411;13452;5757;5.1;2.2
82;2021-02-24;283;363;13735;6120;5.2;2.3
82;2021-02-25;637;465;14372;6585;5.5;2.5
82;2021-02-26;648;382;15020;6967;5.7;2.7
82;2021-02-27;214;63;15234;7030;5.8;2.7
82;2021-02-28;30;7;15264;7037;5.8;2.7
82;2021-03-01;291;197;15555;7234;5.9;2.8
82;2021-03-02;495;356;16050;7590;6.1;2.9
82;2021-03-03;440;342;16490;7932;6.3;3.0
82;2021-03-04;600;280;17090;8212;6.5;3.1
82;2021-03-05;680;359;17770;8571;6.8;3.3
82;2021-03-06;693;36;18463;8607;7.0;3.3
82;2021-03-07;302;3;18765;8610;7.1;3.3
82;2021-03-08;603;141;19368;8751;7.4;3.3
82;2021-03-09;582;229;19950;8980;7.6;3.4
82;2021-03-10;779;223;20729;9203;7.9;3.5
82;2021-03-11;977;267;21706;9470;8.3;3.6
82;2021-03-12;992;99;22698;9569;8.6;3.6
82;2021-03-13;564;54;23262;9623;8.9;3.7
82;2021-03-14;61;5;23323;9628;8.9;3.7
82;2021-03-15;485;312;23808;9940;9.1;3.8
82;2021-03-16;197;324;24005;10264;9.1;3.9
82;2021-03-17;191;285;24196;10549;9.2;4.0
82;2021-03-18;279;344;24475;10893;9.3;4.1
82;2021-03-19;533;303;25008;11196;9.5;4.3
82;2021-03-20;251;56;25259;11252;9.6;4.3
82;2021-03-21;23;0;25282;11252;9.6;4.3
82;2021-03-22;406;317;25688;11569;9.8;4.4
82;2021-03-23;601;312;26289;11881;10.0;4.5
82;2021-03-24;621;322;26910;12203;10.2;4.6
82;2021-03-25;928;244;27838;12447;10.6;4.7
82;2021-03-26;1216;264;29054;12711;11.1;4.8
82;2021-03-27;479;78;29533;12789;11.2;4.9
82;2021-03-28;136;2;29669;12791;11.3;4.9
82;2021-03-29;925;375;30594;13166;11.6;5.0
82;2021-03-30;1188;280;31782;13446;12.1;5.1
82;2021-03-31;1018;260;32800;13706;12.5;5.2
82;2021-04-01;1070;196;33870;13902;12.9;5.3
82;2021-04-02;1213;284;35083;14186;13.4;5.4
82;2021-04-03;715;129;35798;14315;13.6;5.5
82;2021-04-04;276;14;36074;14329;13.7;5.5
82;2021-04-05;388;20;36462;14349;13.9;5.5
82;2021-04-06;953;510;37415;14859;14.2;5.7
82;2021-04-07;1016;495;38431;15354;14.6;5.8
82;2021-04-08;1454;418;39885;15772;15.2;6.0
82;2021-04-09;1656;470;41541;16242;15.8;6.2
82;2021-04-10;1716;103;43257;16345;16.5;6.2
82;2021-04-11;560;19;43817;16364;16.7;6.2
82;2021-04-12;1348;294;45165;16658;17.2;6.3
82;2021-04-13;1626;271;46791;16929;17.8;6.4
82;2021-04-14;1411;298;48202;17227;18.4;6.6
82;2021-04-15;1781;324;49983;17551;19.0;6.7
82;2021-04-16;1542;335;51525;17886;19.6;6.8
82;2021-04-17;1243;70;52768;17956;20.1;6.8
82;2021-04-18;560;15;53328;17971;20.3;6.8
82;2021-04-19;958;358;54286;18329;20.7;7.0
82;2021-04-20;1267;401;55553;18730;21.2;7.1
82;2021-04-21;1217;373;56770;19103;21.6;7.3
82;2021-04-22;1452;294;58222;19397;22.2;7.4
82;2021-04-23;1076;682;59298;20079;22.6;7.6
82;2021-04-24;1188;265;60486;20344;23.0;7.7
82;2021-04-25;736;49;61222;20393;23.3;7.8
82;2021-04-26;748;808;61970;21201;23.6;8.1
82;2021-04-27;905;921;62875;22122;23.9;8.4
82;2021-04-28;921;896;63796;23018;24.3;8.8
82;2021-04-29;1107;912;64903;23930;24.7;9.1
82;2021-04-30;1042;884;65945;24814;25.1;9.4
82;2021-05-01;1143;258;67088;25072;25.5;9.5
82;2021-05-02;697;145;67785;25217;25.8;9.6
82;2021-05-03;410;1215;68195;26432;26.0;10.1
82;2021-05-04;862;1167;69057;27599;26.3;10.5
82;2021-05-05;568;1172;69625;28771;26.5;11.0
82;2021-05-06;848;1409;70473;30180;26.8;11.5
82;2021-05-07;734;1455;71207;31635;27.1;12.0
82;2021-05-08;934;518;72141;32153;27.5;12.2
82;2021-05-09;753;578;72894;32731;27.8;12.5
82;2021-05-10;850;1363;73744;34094;28.1;13.0
82;2021-05-11;1157;1347;74901;35441;28.5;13.5
82;2021-05-12;1015;1344;75916;36785;28.9;14.0
82;2021-05-13;1454;432;77370;37217;29.5;14.2
82;2021-05-14;1690;1239;79060;38456;30.1;14.6
82;2021-05-15;1934;696;80994;39152;30.8;14.9
82;2021-05-16;558;114;81552;39266;31.1;15.0
82;2021-05-17;1090;1172;82642;40438;31.5;15.4
82;2021-05-18;1465;1189;84107;41627;32.0;15.9
82;2021-05-19;1272;974;85379;42601;32.5;16.2
82;2021-05-20;1408;1160;86787;43761;33.0;16.7
82;2021-05-21;1411;1218;88198;44979;33.6;17.1
82;2021-05-22;2067;623;90265;45602;34.4;17.4
82;2021-05-23;705;117;90970;45719;34.6;17.4
82;2021-05-24;1441;265;92411;45984;35.2;17.5
82;2021-05-25;1444;963;93855;46947;35.7;17.9
82;2021-05-26;1411;919;95266;47866;36.3;18.2
82;2021-05-27;1460;1025;96726;48891;36.8;18.6
82;2021-05-28;1540;1139;98266;50030;37.4;19.1
82;2021-05-29;1496;543;99762;50573;38.0;19.3
82;2021-05-30;402;101;100164;50674;38.1;19.3
82;2021-05-31;1490;990;101654;51664;38.7;19.7
82;2021-06-01;1750;1048;103404;52712;39.4;20.1
82;2021-06-02;1477;1005;104881;53717;39.9;20.5
82;2021-06-03;1489;1180;106370;54897;40.5;20.9
82;2021-06-04;2250;1305;108620;56202;41.4;21.4
82;2021-06-05;2267;984;110887;57186;42.2;21.8
82;2021-06-06;329;133;111216;57319;42.3;21.8
82;2021-06-07;957;1275;112173;58594;42.7;22.3
82;2021-06-08;1445;1138;113618;59732;43.3;22.7
82;2021-06-09;1707;1142;115325;60874;43.9;23.2
82;2021-06-10;1441;1208;116766;62082;44.5;23.6
82;2021-06-11;1921;1127;118687;63209;45.2;24.1
82;2021-06-12;2392;1393;121079;64602;46.1;24.6
82;2021-06-13;379;113;121458;64715;46.2;24.6
82;2021-06-14;1213;1082;122671;65797;46.7;25.1
82;2021-06-15;1462;1245;124133;67042;47.3;25.5
82;2021-06-16;1749;1168;125882;68210;47.9;26.0
82;2021-06-17;1219;1472;127101;69682;48.4;26.5
82;2021-06-18;1469;1439;128570;71121;49.0;27.1
82;2021-06-19;2269;981;130839;72102;49.8;27.5
82;2021-06-20;268;173;131107;72275;49.9;27.5
82;2021-06-21;484;1361;131591;73636;50.1;28.0
82;2021-06-22;892;1710;132483;75346;50.4;28.7
82;2021-06-23;1238;1586;133721;76932;50.9;29.3
82;2021-06-24;757;1905;134478;78837;51.2;30.0
82;2021-06-25;739;1936;135217;80773;51.5;30.8
82;2021-06-26;1239;2145;136456;82918;52.0;31.6
82;2021-06-27;195;440;136651;83358;52.0;31.7
82;2021-06-28;329;1411;136980;84769;52.2;32.3
82;2021-06-29;518;1840;137498;86609;52.4;33.0
82;2021-06-30;947;1912;138445;88521;52.7;33.7
82;2021-07-01;658;1632;139103;90153;53.0;34.3
82;2021-07-02;931;2293;140034;92446;53.3;35.2
82;2021-07-03;858;2340;140892;94786;53.6;36.1
82;2021-07-04;120;439;141012;95225;53.7;36.3
82;2021-07-05;445;1561;141457;96786;53.9;36.9
82;2021-07-06;513;1866;141970;98652;54.1;37.6
82;2021-07-07;793;1772;142763;100424;54.4;38.2
82;2021-07-08;504;1504;143267;101928;54.6;38.8
82;2021-07-09;781;2154;144048;104082;54.9;39.6
82;2021-07-10;706;2215;144754;106297;55.1;40.5
82;2021-07-11;39;380;144793;106677;55.1;40.6
82;2021-07-12;578;1884;145371;108561;55.4;41.3
82;2021-07-13;714;2002;146085;110563;55.6;42.1
82;2021-07-14;617;741;146702;111304;55.9;42.4
82;2021-07-15;858;1748;147560;113052;56.2;43.0
82;2021-07-16;1436;2636;148996;115688;56.7;44.1
82;2021-07-17;560;2182;149556;117870;56.9;44.9
82;2021-07-18;14;41;149570;117911;57.0;44.9
82;2021-07-19;736;2072;150306;119983;57.2;45.7
82;2021-07-20;920;1883;151226;121866;57.6;46.4
82;2021-07-21;1289;1759;152515;123625;58.1;47.1
82;2021-07-22;1083;1765;153598;125390;58.5;47.7
82;2021-07-23;1055;2989;154653;128379;58.9;48.9
82;2021-07-24;1102;1490;155755;129869;59.3;49.5
82;2021-07-25;303;73;156058;129942;59.4;49.5
82;2021-07-26;950;1896;157008;131838;59.8;50.2
82;2021-07-27;1324;1640;158332;133478;60.3;50.8
82;2021-07-28;1468;1499;159800;134977;60.8;51.4
82;2021-07-29;1331;1534;161131;136511;61.4;52.0
82;2021-07-30;1537;2474;162668;138985;61.9;52.9
82;2021-07-31;459;295;163127;139280;62.1;53.0
82;2021-08-01;273;50;163400;139330;62.2;53.1
82;2021-08-02;1271;878;164671;140208;62.7;53.4
82;2021-08-03;1435;832;166106;141040;63.3;53.7
82;2021-08-04;1363;1029;167469;142069;63.8;54.1
82;2021-08-05;1491;600;168960;142669;64.3;54.3
82;2021-08-06;995;646;169955;143315;64.7;54.6
82;2021-08-07;923;1195;170878;144510;65.1;55.0
82;2021-08-08;157;65;171035;144575;65.1;55.1
82;2021-08-09;1071;899;172106;145474;65.5;55.4
82;2021-08-10;1290;915;173396;146389;66.0;55.7
82;2021-08-11;1263;1123;174659;147512;66.5;56.2
82;2021-08-12;1471;946;176130;148458;67.1;56.5
82;2021-08-13;1413;997;177543;149455;67.6;56.9
82;2021-08-14;313;485;177856;149940;67.7;57.1
82;2021-08-15;61;38;177917;149978;67.7;57.1
82;2021-08-16;781;1459;178698;151437;68.0;57.7
82;2021-08-17;1064;1236;179762;152673;68.4;58.1
82;2021-08-18;616;848;180378;153521;68.7;58.5
82;2021-08-19;1012;1146;181390;154667;69.1;58.9
82;2021-08-20;1033;1907;182423;156574;69.5;59.6
82;2021-08-21;495;990;182918;157564;69.7;60.0
82;2021-08-22;21;55;182939;157619;69.7;60.0
82;2021-08-23;745;1292;183684;158911;69.9;60.5
82;2021-08-24;863;1117;184547;160028;70.3;60.9
82;2021-08-25;849;1538;185396;161566;70.6;61.5
82;2021-08-26;597;1107;185993;162673;70.8;61.9
82;2021-08-27;898;1685;186891;164358;71.2;62.6
82;2021-08-28;211;616;187102;164974;71.2;62.8
82;2021-08-29;44;49;187146;165023;71.3;62.8
82;2021-08-30;430;1024;187576;166047;71.4;63.2
82;2021-08-31;339;1027;187915;167074;71.6;63.6
82;2021-09-01;721;1406;188636;168480;71.8;64.2
82;2021-09-02;406;1294;189042;169774;72.0;64.6
82;2021-09-03;499;1882;189541;171656;72.2;65.4
82;2021-09-04;425;740;189966;172396;72.3;65.6
82;2021-09-05;6;23;189972;172419;72.3;65.7
82;2021-09-06;373;1289;190345;173708;72.5;66.1
82;2021-09-07;209;961;190554;174669;72.6;66.5
82;2021-09-08;494;1259;191048;175928;72.7;67.0
82;2021-09-09;248;1045;191296;176973;72.8;67.4
82;2021-09-10;487;1458;191783;178431;73.0;67.9
82;2021-09-11;212;521;191995;178952;73.1;68.1
82;2021-09-12;10;29;192005;178981;73.1;68.2
82;2021-09-13;297;1115;192302;180096;73.2;68.6
82;2021-09-14;210;944;192512;181040;73.3;68.9
82;2021-09-15;306;1166;192818;182206;73.4;69.4
82;2021-09-16;220;495;193038;182701;73.5;69.6
82;2021-09-17;187;495;193225;183196;73.6;69.8
82;2021-09-18;326;1081;193551;184277;73.7;70.2
82;2021-09-19;1;14;193552;184291;73.7;70.2
82;2021-09-20;140;415;193692;184706;73.8;70.3
82;2021-09-21;94;382;193786;185088;73.8;70.5
82;2021-09-22;136;455;193922;185543;73.8;70.7
82;2021-09-23;112;382;194034;185925;73.9;70.8
82;2021-09-24;209;599;194243;186524;74.0;71.0
82;2021-09-25;231;658;194474;187182;74.1;71.3
82;2021-09-26;5;10;194479;187192;74.1;71.3
82;2021-09-27;100;453;194579;187645;74.1;71.5
82;2021-09-28;90;229;194669;187874;74.1;71.5
82;2021-09-29;231;476;194900;188350;74.2;71.7
83;2020-12-27;1;0;1;0;0.0;0.0
83;2020-12-28;0;0;1;0;0.0;0.0
83;2020-12-29;2;0;3;0;0.0;0.0
83;2020-12-30;3;0;6;0;0.0;0.0
83;2020-12-31;0;0;6;0;0.0;0.0
83;2021-01-01;1;0;7;0;0.0;0.0
83;2021-01-02;0;0;7;0;0.0;0.0
83;2021-01-03;1;0;8;0;0.0;0.0
83;2021-01-04;1;0;9;0;0.0;0.0
83;2021-01-05;4;0;13;0;0.0;0.0
83;2021-01-06;69;0;82;0;0.0;0.0
83;2021-01-07;324;0;406;0;0.0;0.0
83;2021-01-08;421;0;827;0;0.1;0.0
83;2021-01-09;48;0;875;0;0.1;0.0
83;2021-01-10;1;0;876;0;0.1;0.0
83;2021-01-11;475;0;1351;0;0.1;0.0
83;2021-01-12;1015;4;2366;4;0.2;0.0
83;2021-01-13;963;7;3329;11;0.3;0.0
83;2021-01-14;846;5;4175;16;0.4;0.0
83;2021-01-15;714;2;4889;18;0.5;0.0
83;2021-01-16;42;1;4931;19;0.5;0.0
83;2021-01-17;1;0;4932;19;0.5;0.0
83;2021-01-18;1227;4;6159;23;0.6;0.0
83;2021-01-19;2019;6;8178;29;0.8;0.0
83;2021-01-20;1661;7;9839;36;0.9;0.0
83;2021-01-21;2099;7;11938;43;1.1;0.0
83;2021-01-22;1662;6;13600;49;1.3;0.0
83;2021-01-23;246;0;13846;49;1.3;0.0
83;2021-01-24;21;1;13867;50;1.3;0.0
83;2021-01-25;1557;7;15424;57;1.4;0.0
83;2021-01-26;1758;12;17182;69;1.6;0.0
83;2021-01-27;2154;79;19336;148;1.8;0.0
83;2021-01-28;5098;340;24434;488;2.3;0.0
83;2021-01-29;2950;317;27384;805;2.6;0.1
83;2021-01-30;237;42;27621;847;2.6;0.1
83;2021-01-31;46;0;27667;847;2.6;0.1
83;2021-02-01;1282;380;28949;1227;2.7;0.1
83;2021-02-02;1440;682;30389;1909;2.8;0.2
83;2021-02-03;1527;587;31916;2496;3.0;0.2
83;2021-02-04;1485;702;33401;3198;3.1;0.3
83;2021-02-05;1226;610;34627;3808;3.2;0.4
83;2021-02-06;23;12;34650;3820;3.2;0.4
83;2021-02-07;1;0;34651;3820;3.2;0.4
83;2021-02-08;1090;550;35741;4370;3.3;0.4
83;2021-02-09;1324;757;37065;5127;3.5;0.5
83;2021-02-10;1535;722;38600;5849;3.6;0.5
83;2021-02-11;1611;976;40211;6825;3.7;0.6
83;2021-02-12;1348;768;41559;7593;3.9;0.7
83;2021-02-13;55;21;41614;7614;3.9;0.7
83;2021-02-14;0;0;41614;7614;3.9;0.7
83;2021-02-15;676;768;42290;8382;3.9;0.8
83;2021-02-16;544;1073;42834;9455;4.0;0.9
83;2021-02-17;803;1502;43637;10957;4.1;1.0
83;2021-02-18;1630;3349;45267;14306;4.2;1.3
83;2021-02-19;1482;1999;46749;16305;4.4;1.5
83;2021-02-20;63;155;46812;16460;4.4;1.5
83;2021-02-21;25;33;46837;16493;4.4;1.5
83;2021-02-22;507;1382;47344;17875;4.4;1.7
83;2021-02-23;671;1133;48015;19008;4.5;1.8
83;2021-02-24;724;1175;48739;20183;4.5;1.9
83;2021-02-25;1251;1106;49990;21289;4.7;2.0
83;2021-02-26;1298;979;51288;22268;4.8;2.1
83;2021-02-27;552;50;51840;22318;4.8;2.1
83;2021-02-28;10;12;51850;22330;4.8;2.1
83;2021-03-01;808;986;52658;23316;4.9;2.2
83;2021-03-02;991;1066;53649;24382;5.0;2.3
83;2021-03-03;1440;1283;55089;25665;5.1;2.4
83;2021-03-04;1891;1165;56980;26830;5.3;2.5
83;2021-03-05;2221;1064;59201;27894;5.5;2.6
83;2021-03-06;3010;111;62211;28005;5.8;2.6
83;2021-03-07;2227;44;64438;28049;6.0;2.6
83;2021-03-08;851;1104;65289;29153;6.1;2.7
83;2021-03-09;1937;1037;67226;30190;6.3;2.8
83;2021-03-10;2381;1230;69607;31420;6.5;2.9
83;2021-03-11;3677;2040;73284;33460;6.8;3.1
83;2021-03-12;3661;1379;76945;34839;7.2;3.2
83;2021-03-13;4613;173;81558;35012;7.6;3.3
83;2021-03-14;2341;55;83899;35067;7.8;3.3
83;2021-03-15;3339;650;87238;35717;8.1;3.3
83;2021-03-16;2601;663;89839;36380;8.4;3.4
83;2021-03-17;2846;740;92685;37120;8.6;3.5
83;2021-03-18;3550;783;96235;37903;9.0;3.5
83;2021-03-19;4175;581;100410;38484;9.4;3.6
83;2021-03-20;3477;71;103887;38555;9.7;3.6
83;2021-03-21;2011;32;105898;38587;9.9;3.6
83;2021-03-22;3965;886;109863;39473;10.2;3.7
83;2021-03-23;4751;579;114614;40052;10.7;3.7
83;2021-03-24;5050;708;119664;40760;11.1;3.8
83;2021-03-25;6534;844;126198;41604;11.8;3.9
83;2021-03-26;7174;749;133372;42353;12.4;3.9
83;2021-03-27;3969;383;137341;42736;12.8;4.0
83;2021-03-28;2183;34;139524;42770;13.0;4.0
83;2021-03-29;4557;760;144081;43530;13.4;4.1
83;2021-03-30;5969;939;150050;44469;14.0;4.1
83;2021-03-31;5554;1071;155604;45540;14.5;4.2
83;2021-04-01;5981;1250;161585;46790;15.0;4.4
83;2021-04-02;5762;1069;167347;47859;15.6;4.5
83;2021-04-03;1800;628;169147;48487;15.8;4.5
83;2021-04-04;854;345;170001;48832;15.8;4.5
83;2021-04-05;190;64;170191;48896;15.8;4.6
83;2021-04-06;4731;1392;174922;50288;16.3;4.7
83;2021-04-07;5832;1657;180754;51945;16.8;4.8
83;2021-04-08;7892;2000;188646;53945;17.6;5.0
83;2021-04-09;7596;2200;196242;56145;18.3;5.2
83;2021-04-10;2948;2643;199190;58788;18.5;5.5
83;2021-04-11;1715;2131;200905;60919;18.7;5.7
83;2021-04-12;4951;2855;205856;63774;19.2;5.9
83;2021-04-13;5408;2992;211264;66766;19.7;6.2
83;2021-04-14;5896;2932;217160;69698;20.2;6.5
83;2021-04-15;6774;3034;223934;72732;20.9;6.8
83;2021-04-16;6126;3515;230060;76247;21.4;7.1
83;2021-04-17;3510;2185;233570;78432;21.8;7.3
83;2021-04-18;2179;1292;235749;79724;22.0;7.4
83;2021-04-19;4110;3898;239859;83622;22.3;7.8
83;2021-04-20;4359;3866;244218;87488;22.7;8.1
83;2021-04-21;4300;4144;248518;91632;23.1;8.5
83;2021-04-22;5008;4293;253526;95925;23.6;8.9
83;2021-04-23;4528;4562;258054;100487;24.0;9.4
83;2021-04-24;2629;2711;260683;103198;24.3;9.6
83;2021-04-25;1925;1571;262608;104769;24.5;9.8
83;2021-04-26;3568;3848;266176;108617;24.8;10.1
83;2021-04-27;4140;4536;270316;113153;25.2;10.5
83;2021-04-28;4314;4357;274630;117510;25.6;10.9
83;2021-04-29;5823;5107;280453;122617;26.1;11.4
83;2021-04-30;5785;4286;286238;126903;26.7;11.8
83;2021-05-01;1693;429;287931;127332;26.8;11.9
83;2021-05-02;1237;758;289168;128090;26.9;11.9
83;2021-05-03;3750;4282;292918;132372;27.3;12.3
83;2021-05-04;3346;5096;296264;137468;27.6;12.8
83;2021-05-05;3643;4972;299907;142440;27.9;13.3
83;2021-05-06;4676;4948;304583;147388;28.4;13.7
83;2021-05-07;4166;5307;308749;152695;28.8;14.2
83;2021-05-08;2764;1012;311513;153707;29.0;14.3
83;2021-05-09;2151;1236;313664;154943;29.2;14.4
83;2021-05-10;3201;5416;316865;160359;29.5;14.9
83;2021-05-11;5126;5683;321991;166042;30.0;15.5
83;2021-05-12;6292;4846;328283;170888;30.6;15.9
83;2021-05-13;6580;1343;334863;172231;31.2;16.0
83;2021-05-14;7422;4116;342285;176347;31.9;16.4
83;2021-05-15;7751;2204;350036;178551;32.6;16.6
83;2021-05-16;6625;1247;356661;179798;33.2;16.7
83;2021-05-17;4892;4208;361553;184006;33.7;17.1
83;2021-05-18;5534;3861;367087;187867;34.2;17.5
83;2021-05-19;6205;3408;373292;191275;34.8;17.8
83;2021-05-20;6752;3805;380044;195080;35.4;18.2
83;2021-05-21;7906;3864;387950;198944;36.1;18.5
83;2021-05-22;6086;1719;394036;200663;36.7;18.7
83;2021-05-23;4682;713;398718;201376;37.1;18.8
83;2021-05-24;5809;973;404527;202349;37.7;18.8
83;2021-05-25;5510;4755;410037;207104;38.2;19.3
83;2021-05-26;4857;4444;414894;211548;38.6;19.7
83;2021-05-27;5068;5249;419962;216797;39.1;20.2
83;2021-05-28;4503;5755;424465;222552;39.5;20.7
83;2021-05-29;2704;4264;427169;226816;39.8;21.1
83;2021-05-30;1256;1372;428425;228188;39.9;21.2
83;2021-05-31;5487;4763;433912;232951;40.4;21.7
83;2021-06-01;5730;5290;439642;238241;40.9;22.2
83;2021-06-02;5262;4581;444904;242822;41.4;22.6
83;2021-06-03;5744;5128;450648;247950;42.0;23.1
83;2021-06-04;5444;6040;456092;253990;42.5;23.7
83;2021-06-05;3919;3197;460011;257187;42.8;24.0
83;2021-06-06;1933;1383;461944;258570;43.0;24.1
83;2021-06-07;3913;5085;465857;263655;43.4;24.6
83;2021-06-08;4175;4813;470032;268468;43.8;25.0
83;2021-06-09;4007;4700;474039;273168;44.1;25.4
83;2021-06-10;3999;4261;478038;277429;44.5;25.8
83;2021-06-11;3657;5446;481695;282875;44.9;26.3
83;2021-06-12;2913;2982;484608;285857;45.1;26.6
83;2021-06-13;995;1390;485603;287247;45.2;26.7
83;2021-06-14;2853;5651;488456;292898;45.5;27.3
83;2021-06-15;3166;4858;491622;297756;45.8;27.7
83;2021-06-16;2963;4503;494585;302259;46.1;28.1
83;2021-06-17;2784;5287;497369;307546;46.3;28.6
83;2021-06-18;3160;5964;500529;313510;46.6;29.2
83;2021-06-19;2323;4100;502852;317610;46.8;29.6
83;2021-06-20;676;1889;503528;319499;46.9;29.8
83;2021-06-21;2108;7585;505636;327084;47.1;30.5
83;2021-06-22;2103;7162;507739;334246;47.3;31.1
83;2021-06-23;1935;6928;509674;341174;47.5;31.8
83;2021-06-24;1962;7364;511636;348538;47.6;32.5
83;2021-06-25;2111;8394;513747;356932;47.8;33.2
83;2021-06-26;1462;6808;515209;363740;48.0;33.9
83;2021-06-27;692;3184;515901;366924;48.0;34.2
83;2021-06-28;1570;7881;517471;374805;48.2;34.9
83;2021-06-29;1907;7807;519378;382612;48.4;35.6
83;2021-06-30;2240;7272;521618;389884;48.6;36.3
83;2021-07-01;2562;6565;524180;396449;48.8;36.9
83;2021-07-02;2265;7798;526445;404247;49.0;37.6
83;2021-07-03;1508;5686;527953;409933;49.2;38.2
83;2021-07-04;572;2752;528525;412685;49.2;38.4
83;2021-07-05;1925;7531;530450;420216;49.4;39.1
83;2021-07-06;2571;5939;533021;426155;49.6;39.7
83;2021-07-07;2683;4667;535704;430822;49.9;40.1
83;2021-07-08;3245;4470;538949;435292;50.2;40.5
83;2021-07-09;3045;6963;541994;442255;50.5;41.2
83;2021-07-10;1579;4926;543573;447181;50.6;41.6
83;2021-07-11;1008;1766;544581;448947;50.7;41.8
83;2021-07-12;2142;7687;546723;456634;50.9;42.5
83;2021-07-13;4041;7092;550764;463726;51.3;43.2
83;2021-07-14;2094;1321;552858;465047;51.5;43.3
83;2021-07-15;4578;6842;557436;471889;51.9;43.9
83;2021-07-16;5274;7117;562710;479006;52.4;44.6
83;2021-07-17;3648;4997;566358;484003;52.7;45.1
83;2021-07-18;1604;1311;567962;485314;52.9;45.2
83;2021-07-19;3953;6315;571915;491629;53.3;45.8
83;2021-07-20;5986;6188;577901;497817;53.8;46.4
83;2021-07-21;6031;5210;583932;503027;54.4;46.8
83;2021-07-22;7117;5537;591049;508564;55.0;47.4
83;2021-07-23;7098;5916;598147;514480;55.7;47.9
83;2021-07-24;4649;4558;602796;519038;56.1;48.3
83;2021-07-25;1329;737;604125;519775;56.3;48.4
83;2021-07-26;5545;4936;609670;524711;56.8;48.9
83;2021-07-27;6833;4903;616503;529614;57.4;49.3
83;2021-07-28;6601;4426;623104;534040;58.0;49.7
83;2021-07-29;7499;4858;630603;538898;58.7;50.2
83;2021-07-30;6968;4760;637571;543658;59.4;50.6
83;2021-07-31;4667;3217;642238;546875;59.8;50.9
83;2021-08-01;1066;849;643304;547724;59.9;51.0
83;2021-08-02;5771;3705;649075;551429;60.4;51.4
83;2021-08-03;6384;3995;655459;555424;61.0;51.7
83;2021-08-04;5908;3711;661367;559135;61.6;52.1
83;2021-08-05;6182;4087;667549;563222;62.2;52.4
83;2021-08-06;6162;4914;673711;568136;62.7;52.9
83;2021-08-07;3750;3557;677461;571693;63.1;53.2
83;2021-08-08;1064;823;678525;572516;63.2;53.3
83;2021-08-09;4717;4645;683242;577161;63.6;53.7
83;2021-08-10;5235;5147;688477;582308;64.1;54.2
83;2021-08-11;4592;5067;693069;587375;64.5;54.7
83;2021-08-12;4926;5568;697995;592943;65.0;55.2
83;2021-08-13;4938;5741;702933;598684;65.5;55.8
83;2021-08-14;3223;3892;706156;602576;65.8;56.1
83;2021-08-15;208;392;706364;602968;65.8;56.2
83;2021-08-16;3629;5481;709993;608449;66.1;56.7
83;2021-08-17;3576;5271;713569;613720;66.5;57.2
83;2021-08-18;3604;5000;717173;618720;66.8;57.6
83;2021-08-19;4178;6261;721351;624981;67.2;58.2
83;2021-08-20;3640;6515;724991;631496;67.5;58.8
83;2021-08-21;2345;4489;727336;635985;67.7;59.2
83;2021-08-22;634;1033;727970;637018;67.8;59.3
83;2021-08-23;2506;5786;730476;642804;68.0;59.9
83;2021-08-24;2923;5921;733399;648725;68.3;60.4
83;2021-08-25;2583;5292;735982;654017;68.5;60.9
83;2021-08-26;2797;5844;738779;659861;68.8;61.4
83;2021-08-27;2918;5920;741697;665781;69.1;62.0
83;2021-08-28;1936;4538;743633;670319;69.3;62.4
83;2021-08-29;476;1161;744109;671480;69.3;62.5
83;2021-08-30;2380;4974;746489;676454;69.5;63.0
83;2021-08-31;2506;5479;748995;681933;69.7;63.5
83;2021-09-01;2545;5084;751540;687017;70.0;64.0
83;2021-09-02;2482;4968;754022;691985;70.2;64.4
83;2021-09-03;2325;5251;756347;697236;70.4;64.9
83;2021-09-04;1920;4645;758267;701881;70.6;65.4
83;2021-09-05;568;543;758835;702424;70.7;65.4
83;2021-09-06;1641;4111;760476;706535;70.8;65.8
83;2021-09-07;1658;3874;762134;710409;71.0;66.2
83;2021-09-08;1923;3861;764057;714270;71.2;66.5
83;2021-09-09;1485;3922;765542;718192;71.3;66.9
83;2021-09-10;1770;4333;767312;722525;71.5;67.3
83;2021-09-11;1372;3883;768684;726408;71.6;67.6
83;2021-09-12;204;497;768888;726905;71.6;67.7
83;2021-09-13;1213;3364;770101;730269;71.7;68.0
83;2021-09-14;1314;3487;771415;733756;71.8;68.3
83;2021-09-15;1353;2536;772768;736292;72.0;68.6
83;2021-09-16;1036;2171;773804;738463;72.1;68.8
83;2021-09-17;1025;2523;774829;740986;72.2;69.0
83;2021-09-18;1019;3000;775848;743986;72.3;69.3
83;2021-09-19;97;399;775945;744385;72.3;69.3
83;2021-09-20;670;2029;776615;746414;72.3;69.5
83;2021-09-21;718;1807;777333;748221;72.4;69.7
83;2021-09-22;759;2493;778092;750714;72.5;69.9
83;2021-09-23;710;2111;778802;752825;72.5;70.1
83;2021-09-24;720;2193;779522;755018;72.6;70.3
83;2021-09-25;734;2663;780256;757681;72.7;70.6
83;2021-09-26;71;449;780327;758130;72.7;70.6
83;2021-09-27;586;1729;780913;759859;72.7;70.8
83;2021-09-28;538;1502;781451;761361;72.8;70.9
83;2021-09-29;706;1872;782157;763233;72.8;71.1
84;2020-12-27;1;0;1;0;0.0;0.0
84;2020-12-28;1;0;2;0;0.0;0.0
84;2020-12-29;3;0;5;0;0.0;0.0
84;2020-12-30;2;0;7;0;0.0;0.0
84;2020-12-31;2;0;9;0;0.0;0.0
84;2021-01-01;0;0;9;0;0.0;0.0
84;2021-01-02;0;0;9;0;0.0;0.0
84;2021-01-03;0;0;9;0;0.0;0.0
84;2021-01-04;0;0;9;0;0.0;0.0
84;2021-01-05;0;0;9;0;0.0;0.0
84;2021-01-06;0;0;9;0;0.0;0.0
84;2021-01-07;69;0;78;0;0.0;0.0
84;2021-01-08;84;0;162;0;0.0;0.0
84;2021-01-09;31;0;193;0;0.0;0.0
84;2021-01-10;0;0;193;0;0.0;0.0
84;2021-01-11;219;0;412;0;0.1;0.0
84;2021-01-12;624;2;1036;2;0.2;0.0
84;2021-01-13;359;0;1395;2;0.2;0.0
84;2021-01-14;959;12;2354;14;0.4;0.0
84;2021-01-15;619;9;2973;23;0.5;0.0
84;2021-01-16;167;0;3140;23;0.6;0.0
84;2021-01-17;29;1;3169;24;0.6;0.0
84;2021-01-18;696;2;3865;26;0.7;0.0
84;2021-01-19;881;2;4746;28;0.8;0.0
84;2021-01-20;1023;3;5769;31;1.0;0.0
84;2021-01-21;1050;5;6819;36;1.2;0.0
84;2021-01-22;1135;1;7954;37;1.4;0.0
84;2021-01-23;250;0;8204;37;1.5;0.0
84;2021-01-24;3;0;8207;37;1.5;0.0
84;2021-01-25;809;0;9016;37;1.6;0.0
84;2021-01-26;940;4;9956;41;1.8;0.0
84;2021-01-27;1072;2;11028;43;2.0;0.0
84;2021-01-28;1622;16;12650;59;2.3;0.0
84;2021-01-29;1203;57;13853;116;2.5;0.0
84;2021-01-30;171;16;14024;132;2.5;0.0
84;2021-01-31;7;0;14031;132;2.5;0.0
84;2021-02-01;660;124;14691;256;2.6;0.0
84;2021-02-02;788;245;15479;501;2.8;0.1
84;2021-02-03;762;228;16241;729;2.9;0.1
84;2021-02-04;912;370;17153;1099;3.1;0.2
84;2021-02-05;727;377;17880;1476;3.2;0.3
84;2021-02-06;127;40;18007;1516;3.2;0.3
84;2021-02-07;1;0;18008;1516;3.2;0.3
84;2021-02-08;569;231;18577;1747;3.3;0.3
84;2021-02-09;694;609;19271;2356;3.4;0.4
84;2021-02-10;560;491;19831;2847;3.5;0.5
84;2021-02-11;549;491;20380;3338;3.6;0.6
84;2021-02-12;561;592;20941;3930;3.7;0.7
84;2021-02-13;47;138;20988;4068;3.7;0.7
84;2021-02-14;3;0;20991;4068;3.7;0.7
84;2021-02-15;207;717;21198;4785;3.8;0.9
84;2021-02-16;222;672;21420;5457;3.8;1.0
84;2021-02-17;448;651;21868;6108;3.9;1.1
84;2021-02-18;557;936;22425;7044;4.0;1.3
84;2021-02-19;739;979;23164;8023;4.1;1.4
84;2021-02-20;68;114;23232;8137;4.1;1.5
84;2021-02-21;6;35;23238;8172;4.1;1.5
84;2021-02-22;370;613;23608;8785;4.2;1.6
84;2021-02-23;272;604;23880;9389;4.3;1.7
84;2021-02-24;395;603;24275;9992;4.3;1.8
84;2021-02-25;714;699;24989;10691;4.5;1.9
84;2021-02-26;823;568;25812;11259;4.6;2.0
84;2021-02-27;133;100;25945;11359;4.6;2.0
84;2021-02-28;17;0;25962;11359;4.6;2.0
84;2021-03-01;458;549;26420;11908;4.7;2.1
84;2021-03-02;633;696;27053;12604;4.8;2.2
84;2021-03-03;820;815;27873;13419;5.0;2.4
84;2021-03-04;1099;612;28972;14031;5.2;2.5
84;2021-03-05;1313;474;30285;14505;5.4;2.6
84;2021-03-06;1460;64;31745;14569;5.7;2.6
84;2021-03-07;481;16;32226;14585;5.7;2.6
84;2021-03-08;812;539;33038;15124;5.9;2.7
84;2021-03-09;1387;699;34425;15823;6.1;2.8
84;2021-03-10;1475;604;35900;16427;6.4;2.9
84;2021-03-11;1984;600;37884;17027;6.8;3.0
84;2021-03-12;2081;576;39965;17603;7.1;3.1
84;2021-03-13;747;36;40712;17639;7.3;3.1
84;2021-03-14;247;53;40959;17692;7.3;3.2
84;2021-03-15;1070;300;42029;17992;7.5;3.2
84;2021-03-16;1180;314;43209;18306;7.7;3.3
84;2021-03-17;1147;423;44356;18729;7.9;3.3
84;2021-03-18;1457;387;45813;19116;8.2;3.4
84;2021-03-19;2179;453;47992;19569;8.6;3.5
84;2021-03-20;841;26;48833;19595;8.7;3.5
84;2021-03-21;150;11;48983;19606;8.7;3.5
84;2021-03-22;1162;461;50145;20067;8.9;3.6
84;2021-03-23;1914;428;52059;20495;9.3;3.7
84;2021-03-24;2177;394;54236;20889;9.7;3.7
84;2021-03-25;3654;392;57890;21281;10.3;3.8
84;2021-03-26;3318;473;61208;21754;10.9;3.9
84;2021-03-27;915;58;62123;21812;11.1;3.9
84;2021-03-28;74;2;62197;21814;11.1;3.9
84;2021-03-29;1716;528;63913;22342;11.4;4.0
84;2021-03-30;2674;688;66587;23030;11.9;4.1
84;2021-03-31;2405;639;68992;23669;12.3;4.2
84;2021-04-01;3021;574;72013;24243;12.8;4.3
84;2021-04-02;2452;525;74465;24768;13.3;4.4
84;2021-04-03;510;29;74975;24797;13.4;4.4
84;2021-04-04;14;0;74989;24797;13.4;4.4
84;2021-04-05;814;100;75803;24897;13.5;4.4
84;2021-04-06;2144;841;77947;25738;13.9;4.6
84;2021-04-07;2404;862;80351;26600;14.3;4.7
84;2021-04-08;3653;1043;84004;27643;15.0;4.9
84;2021-04-09;4116;947;88120;28590;15.7;5.1
84;2021-04-10;1308;131;89428;28721;15.9;5.1
84;2021-04-11;37;12;89465;28733;15.9;5.1
84;2021-04-12;2094;806;91559;29539;16.3;5.3
84;2021-04-13;2940;1364;94499;30903;16.8;5.5
84;2021-04-14;2811;1350;97310;32253;17.3;5.7
84;2021-04-15;3271;1417;100581;33670;17.9;6.0
84;2021-04-16;3431;1551;104012;35221;18.5;6.3
84;2021-04-17;1666;200;105678;35421;18.8;6.3
84;2021-04-18;38;1;105716;35422;18.8;6.3
84;2021-04-19;2507;921;108223;36343;19.3;6.5
84;2021-04-20;2627;1527;110850;37870;19.8;6.8
84;2021-04-21;2651;1482;113501;39352;20.2;7.0
84;2021-04-22;3013;1740;116514;41092;20.8;7.3
84;2021-04-23;3041;1908;119555;43000;21.3;7.7
84;2021-04-24;1530;288;121085;43288;21.6;7.7
84;2021-04-25;27;2;121112;43290;21.6;7.7
84;2021-04-26;2199;1364;123311;44654;22.0;8.0
84;2021-04-27;2556;1977;125867;46631;22.4;8.3
84;2021-04-28;2818;1842;128685;48473;22.9;8.6
84;2021-04-29;3420;2047;132105;50520;23.5;9.0
84;2021-04-30;3134;2424;135239;52944;24.1;9.4
84;2021-05-01;457;259;135696;53203;24.2;9.5
84;2021-05-02;2;0;135698;53203;24.2;9.5
84;2021-05-03;2162;1626;137860;54829;24.6;9.8
84;2021-05-04;2488;2535;140348;57364;25.0;10.2
84;2021-05-05;2353;2226;142701;59590;25.4;10.6
84;2021-05-06;3223;2259;145924;61849;26.0;11.0
84;2021-05-07;2766;2559;148690;64408;26.5;11.5
84;2021-05-08;1158;527;149848;64935;26.7;11.6
84;2021-05-09;8;53;149856;64988;26.7;11.6
84;2021-05-10;2159;2466;152015;67454;27.1;12.0
84;2021-05-11;2905;3153;154920;70607;27.6;12.6
84;2021-05-12;2849;2920;157769;73527;28.1;13.1
84;2021-05-13;2160;848;159929;74375;28.5;13.3
84;2021-05-14;2727;2036;162656;76411;29.0;13.6
84;2021-05-15;2001;986;164657;77397;29.4;13.8
84;2021-05-16;1340;187;165997;77584;29.6;13.8
84;2021-05-17;2224;2156;168221;79740;30.0;14.2
84;2021-05-18;2904;2113;171125;81853;30.5;14.6
84;2021-05-19;3230;1665;174355;83518;31.1;14.9
84;2021-05-20;3698;2208;178053;85726;31.7;15.3
84;2021-05-21;3471;2331;181524;88057;32.4;15.7
84;2021-05-22;1582;682;183106;88739;32.6;15.8
84;2021-05-23;6;9;183112;88748;32.6;15.8
84;2021-05-24;1840;424;184952;89172;33.0;15.9
84;2021-05-25;2984;2188;187936;91360;33.5;16.3
84;2021-05-26;3075;2090;191011;93450;34.0;16.7
84;2021-05-27;3857;2312;194868;95762;34.7;17.1
84;2021-05-28;3179;3303;198047;99065;35.3;17.7
84;2021-05-29;1093;1649;199140;100714;35.5;18.0
84;2021-05-30;10;85;199150;100799;35.5;18.0
84;2021-05-31;2191;2638;201341;103437;35.9;18.4
84;2021-06-01;3141;3158;204482;106595;36.4;19.0
84;2021-06-02;3170;2629;207652;109224;37.0;19.5
84;2021-06-03;4114;2998;211766;112222;37.7;20.0
84;2021-06-04;3613;3021;215379;115243;38.4;20.5
84;2021-06-05;1781;1501;217160;116744;38.7;20.8
84;2021-06-06;984;208;218144;116952;38.9;20.8
84;2021-06-07;2451;2758;220595;119710;39.3;21.3
84;2021-06-08;3317;3054;223912;122764;39.9;21.9
84;2021-06-09;3033;2686;226945;125450;40.5;22.4
84;2021-06-10;3512;2794;230457;128244;41.1;22.9
84;2021-06-11;3031;3068;233488;131312;41.6;23.4
84;2021-06-12;1965;1308;235453;132620;42.0;23.6
84;2021-06-13;413;213;235866;132833;42.0;23.7
84;2021-06-14;1930;3153;237796;135986;42.4;24.2
84;2021-06-15;2573;3453;240369;139439;42.8;24.9
84;2021-06-16;2527;2962;242896;142401;43.3;25.4
84;2021-06-17;2992;3479;245888;145880;43.8;26.0
84;2021-06-18;2424;3553;248312;149433;44.3;26.6
84;2021-06-19;1287;1551;249599;150984;44.5;26.9
84;2021-06-20;546;354;250145;151338;44.6;27.0
84;2021-06-21;1569;3135;251714;154473;44.9;27.5
84;2021-06-22;2163;4010;253877;158483;45.3;28.3
84;2021-06-23;2117;3306;255994;161789;45.6;28.8
84;2021-06-24;2201;3484;258195;165273;46.0;29.5
84;2021-06-25;1836;3888;260031;169161;46.4;30.2
84;2021-06-26;1133;1817;261164;170978;46.6;30.5
84;2021-06-27;297;345;261461;171323;46.6;30.5
84;2021-06-28;1207;3224;262668;174547;46.8;31.1
84;2021-06-29;1477;4051;264145;178598;47.1;31.8
84;2021-06-30;1716;3969;265861;182567;47.4;32.5
84;2021-07-01;1819;3955;267680;186522;47.7;33.2
84;2021-07-02;1760;3898;269440;190420;48.0;33.9
84;2021-07-03;1102;2030;270542;192450;48.2;34.3
84;2021-07-04;395;416;270937;192866;48.3;34.4
84;2021-07-05;1550;3540;272487;196406;48.6;35.0
84;2021-07-06;1637;4164;274124;200570;48.9;35.8
84;2021-07-07;1676;3102;275800;203672;49.2;36.3
84;2021-07-08;2157;3742;277957;207414;49.5;37.0
84;2021-07-09;1874;3970;279831;211384;49.9;37.7
84;2021-07-10;1253;2162;281084;213546;50.1;38.1
84;2021-07-11;354;300;281438;213846;50.2;38.1
84;2021-07-12;1409;3836;282847;217682;50.4;38.8
84;2021-07-13;2334;5008;285181;222690;50.8;39.7
84;2021-07-14;1885;1249;287066;223939;51.2;39.9
84;2021-07-15;2708;4557;289774;228496;51.7;40.7
84;2021-07-16;2778;4603;292552;233099;52.1;41.6
84;2021-07-17;1588;2449;294140;235548;52.4;42.0
84;2021-07-18;1017;552;295157;236100;52.6;42.1
84;2021-07-19;2415;3743;297572;239843;53.0;42.8
84;2021-07-20;2954;4168;300526;244011;53.6;43.5
84;2021-07-21;3187;3653;303713;247664;54.1;44.1
84;2021-07-22;3778;3791;307491;251455;54.8;44.8
84;2021-07-23;3520;3678;311011;255133;55.4;45.5
84;2021-07-24;1470;2248;312481;257381;55.7;45.9
84;2021-07-25;1033;513;313514;257894;55.9;46.0
84;2021-07-26;2725;3038;316239;260932;56.4;46.5
84;2021-07-27;3443;3568;319682;264500;57.0;47.1
84;2021-07-28;3866;3307;323548;267807;57.7;47.7
84;2021-07-29;4224;3158;327772;270965;58.4;48.3
84;2021-07-30;4026;3326;331798;274291;59.1;48.9
84;2021-07-31;2000;1694;333798;275985;59.5;49.2
84;2021-08-01;819;437;334617;276422;59.6;49.3
84;2021-08-02;2992;2695;337609;279117;60.2;49.8
84;2021-08-03;4108;2795;341717;281912;60.9;50.3
84;2021-08-04;3918;2611;345635;284523;61.6;50.7
84;2021-08-05;3888;2585;349523;287108;62.3;51.2
84;2021-08-06;3695;2868;353218;289976;63.0;51.7
84;2021-08-07;2078;1744;355296;291720;63.3;52.0
84;2021-08-08;386;735;355682;292455;63.4;52.1
84;2021-08-09;2940;2603;358622;295058;63.9;52.6
84;2021-08-10;3745;2956;362367;298014;64.6;53.1
84;2021-08-11;3269;2675;365636;300689;65.2;53.6
84;2021-08-12;3173;2978;368809;303667;65.7;54.1
84;2021-08-13;2922;2701;371731;306368;66.3;54.6
84;2021-08-14;1735;1746;373466;308114;66.6;54.9
84;2021-08-15;314;227;373780;308341;66.6;55.0
84;2021-08-16;2448;3086;376228;311427;67.1;55.5
84;2021-08-17;2736;3260;378964;314687;67.6;56.1
84;2021-08-18;2418;2797;381382;317484;68.0;56.6
84;2021-08-19;2278;3120;383660;320604;68.4;57.1
84;2021-08-20;2199;3305;385859;323909;68.8;57.7
84;2021-08-21;1229;1885;387088;325794;69.0;58.1
84;2021-08-22;167;738;387255;326532;69.0;58.2
84;2021-08-23;1775;3297;389030;329829;69.3;58.8
84;2021-08-24;1923;3469;390953;333298;69.7;59.4
84;2021-08-25;1844;3352;392797;336650;70.0;60.0
84;2021-08-26;1639;3627;394436;340277;70.3;60.7
84;2021-08-27;1630;3813;396066;344090;70.6;61.3
84;2021-08-28;920;2180;396986;346270;70.8;61.7
84;2021-08-29;174;607;397160;346877;70.8;61.8
84;2021-08-30;1389;3278;398549;350155;71.0;62.4
84;2021-08-31;1363;4153;399912;354308;71.3;63.2
84;2021-09-01;1250;3595;401162;357903;71.5;63.8
84;2021-09-02;1206;3208;402368;361111;71.7;64.4
84;2021-09-03;1276;3550;403644;364661;72.0;65.0
84;2021-09-04;751;2178;404395;366839;72.1;65.4
84;2021-09-05;124;475;404519;367314;72.1;65.5
84;2021-09-06;812;2475;405331;369789;72.3;65.9
84;2021-09-07;1026;2752;406357;372541;72.4;66.4
84;2021-09-08;908;2914;407265;375455;72.6;66.9
84;2021-09-09;884;2437;408149;377892;72.8;67.4
84;2021-09-10;926;2908;409075;380800;72.9;67.9
84;2021-09-11;573;1915;409648;382715;73.0;68.2
84;2021-09-12;115;302;409763;383017;73.0;68.3
84;2021-09-13;696;1934;410459;384951;73.2;68.6
84;2021-09-14;812;2041;411271;386992;73.3;69.0
84;2021-09-15;820;1932;412091;388924;73.5;69.3
84;2021-09-16;600;1334;412691;390258;73.6;69.6
84;2021-09-17;612;1612;413303;391870;73.7;69.9
84;2021-09-18;514;1497;413817;393367;73.8;70.1
84;2021-09-19;46;177;413863;393544;73.8;70.2
84;2021-09-20;326;890;414189;394434;73.8;70.3
84;2021-09-21;363;1112;414552;395546;73.9;70.5
84;2021-09-22;419;1586;414971;397132;74.0;70.8
84;2021-09-23;396;1113;415367;398245;74.0;71.0
84;2021-09-24;396;1250;415763;399495;74.1;71.2
84;2021-09-25;323;1245;416086;400740;74.2;71.4
84;2021-09-26;53;142;416139;400882;74.2;71.5
84;2021-09-27;314;787;416453;401669;74.2;71.6
84;2021-09-28;307;754;416760;402423;74.3;71.7
84;2021-09-29;348;1215;417108;403638;74.4;72.0
85;2020-12-27;1;0;1;0;0.0;0.0
85;2020-12-28;0;0;1;0;0.0;0.0
85;2020-12-29;0;0;1;0;0.0;0.0
85;2020-12-30;0;0;1;0;0.0;0.0
85;2020-12-31;0;0;1;0;0.0;0.0
85;2021-01-01;0;0;1;0;0.0;0.0
85;2021-01-02;0;0;1;0;0.0;0.0
85;2021-01-03;1;0;2;0;0.0;0.0
85;2021-01-04;26;0;28;0;0.0;0.0
85;2021-01-05;62;0;90;0;0.0;0.0
85;2021-01-06;107;1;197;1;0.0;0.0
85;2021-01-07;203;0;400;1;0.1;0.0
85;2021-01-08;293;2;693;3;0.1;0.0
85;2021-01-09;288;1;981;4;0.1;0.0
85;2021-01-10;59;0;1040;4;0.2;0.0
85;2021-01-11;453;0;1493;4;0.2;0.0
85;2021-01-12;584;1;2077;5;0.3;0.0
85;2021-01-13;543;2;2620;7;0.4;0.0
85;2021-01-14;683;4;3303;11;0.5;0.0
85;2021-01-15;439;3;3742;14;0.5;0.0
85;2021-01-16;264;2;4006;16;0.6;0.0
85;2021-01-17;37;0;4043;16;0.6;0.0
85;2021-01-18;999;1;5042;17;0.7;0.0
85;2021-01-19;1429;10;6471;27;0.9;0.0
85;2021-01-20;1892;2;8363;29;1.2;0.0
85;2021-01-21;3221;7;11584;36;1.7;0.0
85;2021-01-22;1700;16;13284;52;1.9;0.0
85;2021-01-23;466;1;13750;53;2.0;0.0
85;2021-01-24;50;0;13800;53;2.0;0.0
85;2021-01-25;577;0;14377;53;2.1;0.0
85;2021-01-26;877;33;15254;86;2.2;0.0
85;2021-01-27;1809;32;17063;118;2.5;0.0
85;2021-01-28;1636;39;18699;157;2.7;0.0
85;2021-01-29;875;63;19574;220;2.9;0.0
85;2021-01-30;149;5;19723;225;2.9;0.0
85;2021-01-31;2;40;19725;265;2.9;0.0
85;2021-02-01;484;98;20209;363;3.0;0.1
85;2021-02-02;536;170;20745;533;3.0;0.1
85;2021-02-03;415;248;21160;781;3.1;0.1
85;2021-02-04;623;252;21783;1033;3.2;0.2
85;2021-02-05;624;253;22407;1286;3.3;0.2
85;2021-02-06;157;211;22564;1497;3.3;0.2
85;2021-02-07;1;0;22565;1497;3.3;0.2
85;2021-02-08;388;497;22953;1994;3.4;0.3
85;2021-02-09;663;981;23616;2975;3.5;0.4
85;2021-02-10;583;1035;24199;4010;3.5;0.6
85;2021-02-11;1524;2784;25723;6794;3.8;1.0
85;2021-02-12;1015;1162;26738;7956;3.9;1.2
85;2021-02-13;251;432;26989;8388;4.0;1.2
85;2021-02-14;2;84;26991;8472;4.0;1.2
85;2021-02-15;336;646;27327;9118;4.0;1.3
85;2021-02-16;569;958;27896;10076;4.1;1.5
85;2021-02-17;784;1451;28680;11527;4.2;1.7
85;2021-02-18;1277;1719;29957;13246;4.4;1.9
85;2021-02-19;956;1087;30913;14333;4.5;2.1
85;2021-02-20;174;186;31087;14519;4.6;2.1
85;2021-02-21;1;11;31088;14530;4.6;2.1
85;2021-02-22;815;745;31903;15275;4.7;2.2
85;2021-02-23;826;373;32729;15648;4.8;2.3
85;2021-02-24;757;237;33486;15885;4.9;2.3
85;2021-02-25;1336;313;34822;16198;5.1;2.4
85;2021-02-26;1229;248;36051;16446;5.3;2.4
85;2021-02-27;401;77;36452;16523;5.3;2.4
85;2021-02-28;7;1;36459;16524;5.3;2.4
85;2021-03-01;766;351;37225;16875;5.4;2.5
85;2021-03-02;1099;669;38324;17544;5.6;2.6
85;2021-03-03;844;438;39168;17982;5.7;2.6
85;2021-03-04;1577;1082;40745;19064;6.0;2.8
85;2021-03-05;1741;742;42486;19806;6.2;2.9
85;2021-03-06;1227;116;43713;19922;6.4;2.9
85;2021-03-07;333;27;44046;19949;6.4;2.9
85;2021-03-08;1741;405;45787;20354;6.7;3.0
85;2021-03-09;2239;516;48026;20870;7.0;3.1
85;2021-03-10;1862;617;49888;21487;7.3;3.1
85;2021-03-11;3118;1030;53006;22517;7.8;3.3
85;2021-03-12;2730;816;55736;23333;8.2;3.4
85;2021-03-13;1372;155;57108;23488;8.4;3.4
85;2021-03-14;182;3;57290;23491;8.4;3.4
85;2021-03-15;1919;507;59209;23998;8.7;3.5
85;2021-03-16;1631;512;60840;24510;8.9;3.6
85;2021-03-17;980;524;61820;25034;9.0;3.7
85;2021-03-18;1904;449;63724;25483;9.3;3.7
85;2021-03-19;2199;365;65923;25848;9.6;3.8
85;2021-03-20;1069;178;66992;26026;9.8;3.8
85;2021-03-21;272;5;67264;26031;9.8;3.8
85;2021-03-22;1763;555;69027;26586;10.1;3.9
85;2021-03-23;2420;729;71447;27315;10.5;4.0
85;2021-03-24;2206;520;73653;27835;10.8;4.1
85;2021-03-25;3649;596;77302;28431;11.3;4.2
85;2021-03-26;3357;645;80659;29076;11.8;4.3
85;2021-03-27;1729;124;82388;29200;12.1;4.3
85;2021-03-28;540;4;82928;29204;12.1;4.3
85;2021-03-29;2414;758;85342;29962;12.5;4.4
85;2021-03-30;2866;1022;88208;30984;12.9;4.5
85;2021-03-31;2200;676;90408;31660;13.2;4.6
85;2021-04-01;3880;913;94288;32573;13.8;4.8
85;2021-04-02;2710;1104;96998;33677;14.2;4.9
85;2021-04-03;1411;322;98409;33999;14.4;5.0
85;2021-04-04;324;29;98733;34028;14.5;5.0
85;2021-04-05;104;175;98837;34203;14.5;5.0
85;2021-04-06;2196;1592;101033;35795;14.8;5.2
85;2021-04-07;3094;1189;104127;36984;15.2;5.4
85;2021-04-08;4544;1602;108671;38586;15.9;5.6
85;2021-04-09;4604;1225;113275;39811;16.6;5.8
85;2021-04-10;1866;401;115141;40212;16.9;5.9
85;2021-04-11;27;10;115168;40222;16.9;5.9
85;2021-04-12;4283;1490;119451;41712;17.5;6.1
85;2021-04-13;4836;1867;124287;43579;18.2;6.4
85;2021-04-14;3961;1011;128248;44590;18.8;6.5
85;2021-04-15;5517;1740;133765;46330;19.6;6.8
85;2021-04-16;5240;1541;139005;47871;20.3;7.0
85;2021-04-17;1382;436;140387;48307;20.5;7.1
85;2021-04-18;351;12;140738;48319;20.6;7.1
85;2021-04-19;3368;1698;144106;50017;21.1;7.3
85;2021-04-20;3694;1928;147800;51945;21.6;7.6
85;2021-04-21;2692;1693;150492;53638;22.0;7.9
85;2021-04-22;3805;2231;154297;55869;22.6;8.2
85;2021-04-23;3902;2090;158199;57959;23.2;8.5
85;2021-04-24;1663;1532;159862;59491;23.4;8.7
85;2021-04-25;981;565;160843;60056;23.5;8.8
85;2021-04-26;3589;2352;164432;62408;24.1;9.1
85;2021-04-27;4393;2152;168825;64560;24.7;9.4
85;2021-04-28;5747;1256;174572;65816;25.6;9.6
85;2021-04-29;5635;1996;180207;67812;26.4;9.9
85;2021-04-30;5574;1663;185781;69475;27.2;10.2
85;2021-05-01;1736;638;187517;70113;27.4;10.3
85;2021-05-02;873;471;188390;70584;27.6;10.3
85;2021-05-03;3494;2387;191884;72971;28.1;10.7
85;2021-05-04;3487;3082;195371;76053;28.6;11.1
85;2021-05-05;4532;2165;199903;78218;29.3;11.4
85;2021-05-06;4922;2598;204825;80816;30.0;11.8
85;2021-05-07;3932;3849;208757;84665;30.6;12.4
85;2021-05-08;2246;232;211003;84897;30.9;12.4
85;2021-05-09;1507;183;212510;85080;31.1;12.5
85;2021-05-10;3209;4914;215719;89994;31.6;13.2
85;2021-05-11;4027;4964;219746;94958;32.2;13.9
85;2021-05-12;5019;3933;224765;98891;32.9;14.5
85;2021-05-13;5144;613;229909;99504;33.7;14.6
85;2021-05-14;4356;3166;234265;102670;34.3;15.0
85;2021-05-15;2325;771;236590;103441;34.6;15.1
85;2021-05-16;2212;162;238802;103603;35.0;15.2
85;2021-05-17;4145;3376;242947;106979;35.6;15.7
85;2021-05-18;5215;2853;248162;109832;36.3;16.1
85;2021-05-19;6493;1770;254655;111602;37.3;16.3
85;2021-05-20;6773;2174;261428;113776;38.3;16.7
85;2021-05-21;5497;2735;266925;116511;39.1;17.1
85;2021-05-22;2584;749;269509;117260;39.4;17.2
85;2021-05-23;1329;161;270838;117421;39.6;17.2
85;2021-05-24;4572;436;275410;117857;40.3;17.3
85;2021-05-25;4516;3564;279926;121421;41.0;17.8
85;2021-05-26;4945;2678;284871;124099;41.7;18.2
85;2021-05-27;4959;3694;289830;127793;42.4;18.7
85;2021-05-28;5251;4054;295081;131847;43.2;19.3
85;2021-05-29;3962;1530;299043;133377;43.8;19.5
85;2021-05-30;1291;126;300334;133503;44.0;19.5
85;2021-05-31;4689;3376;305023;136879;44.6;20.0
85;2021-06-01;5405;3397;310428;140276;45.4;20.5
85;2021-06-02;5554;2515;315982;142791;46.3;20.9
85;2021-06-03;5915;3231;321897;146022;47.1;21.4
85;2021-06-04;5837;3807;327734;149829;48.0;21.9
85;2021-06-05;2848;1934;330582;151763;48.4;22.2
85;2021-06-06;1511;804;332093;152567;48.6;22.3
85;2021-06-07;3236;4859;335329;157426;49.1;23.0
85;2021-06-08;4090;4523;339419;161949;49.7;23.7
85;2021-06-09;4844;3501;344263;165450;50.4;24.2
85;2021-06-10;5199;3698;349462;169148;51.2;24.8
85;2021-06-11;4506;4657;353968;173805;51.8;25.4
85;2021-06-12;1491;1795;355459;175600;52.0;25.7
85;2021-06-13;1219;672;356678;176272;52.2;25.8
85;2021-06-14;2682;5092;359360;181364;52.6;26.5
85;2021-06-15;3715;4928;363075;186292;53.1;27.3
85;2021-06-16;4083;3907;367158;190199;53.7;27.8
85;2021-06-17;3940;3902;371098;194101;54.3;28.4
85;2021-06-18;3625;5684;374723;199785;54.8;29.2
85;2021-06-19;1213;2029;375936;201814;55.0;29.5
85;2021-06-20;140;520;376076;202334;55.0;29.6
85;2021-06-21;2375;5810;378451;208144;55.4;30.5
85;2021-06-22;2849;5728;381300;213872;55.8;31.3
85;2021-06-23;3390;4499;384690;218371;56.3;32.0
85;2021-06-24;3642;4561;388332;222932;56.8;32.6
85;2021-06-25;2289;6180;390621;229112;57.2;33.5
85;2021-06-26;791;3757;391412;232869;57.3;34.1
85;2021-06-27;125;1369;391537;234238;57.3;34.3
85;2021-06-28;1186;6713;392723;240951;57.5;35.3
85;2021-06-29;1757;6870;394480;247821;57.7;36.3
85;2021-06-30;2212;6208;396692;254029;58.1;37.2
85;2021-07-01;2842;6056;399534;260085;58.5;38.1
85;2021-07-02;2268;7015;401802;267100;58.8;39.1
85;2021-07-03;618;3165;402420;270265;58.9;39.6
85;2021-07-04;145;1084;402565;271349;58.9;39.7
85;2021-07-05;1064;6649;403629;277998;59.1;40.7
85;2021-07-06;1582;6453;405211;284451;59.3;41.6
85;2021-07-07;1649;5859;406860;290310;59.6;42.5
85;2021-07-08;2164;5435;409024;295745;59.9;43.3
85;2021-07-09;1646;7094;410670;302839;60.1;44.3
85;2021-07-10;566;2835;411236;305674;60.2;44.7
85;2021-07-11;529;1287;411765;306961;60.3;44.9
85;2021-07-12;1408;7046;413173;314007;60.5;46.0
85;2021-07-13;2059;7383;415232;321390;60.8;47.0
85;2021-07-14;1451;2047;416683;323437;61.0;47.3
85;2021-07-15;2681;6937;419364;330374;61.4;48.4
85;2021-07-16;3432;6829;422796;337203;61.9;49.4
85;2021-07-17;1565;2148;424361;339351;62.1;49.7
85;2021-07-18;1150;1154;425511;340505;62.3;49.8
85;2021-07-19;3559;6220;429070;346725;62.8;50.8
85;2021-07-20;4300;6213;433370;352938;63.4;51.7
85;2021-07-21;3996;6192;437366;359130;64.0;52.6
85;2021-07-22;3908;6188;441274;365318;64.6;53.5
85;2021-07-23;4530;6703;445804;372021;65.3;54.5
85;2021-07-24;1045;2293;446849;374314;65.4;54.8
85;2021-07-25;491;303;447340;374617;65.5;54.8
85;2021-07-26;4514;5361;451854;379978;66.1;55.6
85;2021-07-27;5320;5396;457174;385374;66.9;56.4
85;2021-07-28;4963;4969;462137;390343;67.6;57.1
85;2021-07-29;5879;4730;468016;395073;68.5;57.8
85;2021-07-30;6028;4951;474044;400024;69.4;58.6
85;2021-07-31;1226;1576;475270;401600;69.6;58.8
85;2021-08-01;470;195;475740;401795;69.6;58.8
85;2021-08-02;4949;3950;480689;405745;70.4;59.4
85;2021-08-03;6523;3352;487212;409097;71.3;59.9
85;2021-08-04;6631;3421;493843;412518;72.3;60.4
85;2021-08-05;6198;3601;500041;416119;73.2;60.9
85;2021-08-06;5810;4513;505851;420632;74.0;61.6
85;2021-08-07;1505;1179;507356;421811;74.3;61.7
85;2021-08-08;331;232;507687;422043;74.3;61.8
85;2021-08-09;4154;3275;511841;425318;74.9;62.3
85;2021-08-10;4830;3419;516671;428737;75.6;62.8
85;2021-08-11;4672;4216;521343;432953;76.3;63.4
85;2021-08-12;4473;4298;525816;437251;77.0;64.0
85;2021-08-13;3897;3648;529713;440899;77.5;64.5
85;2021-08-14;1028;1088;530741;441987;77.7;64.7
85;2021-08-15;160;237;530901;442224;77.7;64.7
85;2021-08-16;2844;4774;533745;446998;78.1;65.4
85;2021-08-17;2977;4359;536722;451357;78.6;66.1
85;2021-08-18;3154;4107;539876;455464;79.0;66.7
85;2021-08-19;2730;4279;542606;459743;79.4;67.3
85;2021-08-20;2481;5229;545087;464972;79.8;68.1
85;2021-08-21;701;1398;545788;466370;79.9;68.3
85;2021-08-22;344;1019;546132;467389;79.9;68.4
85;2021-08-23;1874;5373;548006;472762;80.2;69.2
85;2021-08-24;1823;4873;549829;477635;80.5;69.9
85;2021-08-25;1648;4833;551477;482468;80.7;70.6
85;2021-08-26;1541;4765;553018;487233;80.9;71.3
85;2021-08-27;1702;5519;554720;492752;81.2;72.1
85;2021-08-28;573;1343;555293;494095;81.3;72.3
85;2021-08-29;128;989;555421;495084;81.3;72.5
85;2021-08-30;1122;4948;556543;500032;81.5;73.2
85;2021-08-31;1132;5439;557675;505471;81.6;74.0
85;2021-09-01;1138;5169;558813;510640;81.8;74.7
85;2021-09-02;992;4372;559805;515012;81.9;75.4
85;2021-09-03;1242;4537;561047;519549;82.1;76.0
85;2021-09-04;369;1385;561416;520934;82.2;76.3
85;2021-09-05;42;195;561458;521129;82.2;76.3
85;2021-09-06;849;3824;562307;524953;82.3;76.8
85;2021-09-07;842;3314;563149;528267;82.4;77.3
85;2021-09-08;867;3657;564016;531924;82.6;77.9
85;2021-09-09;648;2975;564664;534899;82.7;78.3
85;2021-09-10;792;3644;565456;538543;82.8;78.8
85;2021-09-11;243;1403;565699;539946;82.8;79.0
85;2021-09-12;17;58;565716;540004;82.8;79.0
85;2021-09-13;543;2607;566259;542611;82.9;79.4
85;2021-09-14;543;2375;566802;544986;83.0;79.8
85;2021-09-15;607;2529;567409;547515;83.1;80.1
85;2021-09-16;399;1360;567808;548875;83.1;80.3
85;2021-09-17;737;2387;568545;551262;83.2;80.7
85;2021-09-18;189;915;568734;552177;83.2;80.8
85;2021-09-19;5;22;568739;552199;83.2;80.8
85;2021-09-20;352;1355;569091;553554;83.3;81.0
85;2021-09-21;429;1067;569520;554621;83.4;81.2
85;2021-09-22;429;1899;569949;556520;83.4;81.5
85;2021-09-23;809;981;570758;557501;83.5;81.6
85;2021-09-24;591;1927;571349;559428;83.6;81.9
85;2021-09-25;153;879;571502;560307;83.7;82.0
85;2021-09-26;0;12;571502;560319;83.7;82.0
85;2021-09-27;364;929;571866;561248;83.7;82.2
85;2021-09-28;231;565;572097;561813;83.7;82.2
85;2021-09-29;396;1288;572493;563101;83.8;82.4
86;2020-12-27;0;0;0;0;0.0;0.0
86;2020-12-28;1;0;1;0;0.0;0.0
86;2020-12-29;1;0;2;0;0.0;0.0
86;2020-12-30;0;0;2;0;0.0;0.0
86;2020-12-31;0;0;2;0;0.0;0.0
86;2021-01-01;0;0;2;0;0.0;0.0
86;2021-01-02;1;0;3;0;0.0;0.0
86;2021-01-03;2;0;5;0;0.0;0.0
86;2021-01-04;0;0;5;0;0.0;0.0
86;2021-01-05;1;0;6;0;0.0;0.0
86;2021-01-06;178;0;184;0;0.0;0.0
86;2021-01-07;672;0;856;0;0.2;0.0
86;2021-01-08;609;2;1465;2;0.3;0.0
86;2021-01-09;0;0;1465;2;0.3;0.0
86;2021-01-10;173;0;1638;2;0.4;0.0
86;2021-01-11;305;0;1943;2;0.4;0.0
86;2021-01-12;460;0;2403;2;0.5;0.0
86;2021-01-13;337;0;2740;2;0.6;0.0
86;2021-01-14;552;1;3292;3;0.8;0.0
86;2021-01-15;544;0;3836;3;0.9;0.0
86;2021-01-16;2;0;3838;3;0.9;0.0
86;2021-01-17;0;0;3838;3;0.9;0.0
86;2021-01-18;564;0;4402;3;1.0;0.0
86;2021-01-19;1917;1;6319;4;1.4;0.0
86;2021-01-20;1464;10;7783;14;1.8;0.0
86;2021-01-21;1292;0;9075;14;2.1;0.0
86;2021-01-22;834;0;9909;14;2.3;0.0
86;2021-01-23;314;0;10223;14;2.3;0.0
86;2021-01-24;0;0;10223;14;2.3;0.0
86;2021-01-25;586;102;10809;116;2.5;0.0
86;2021-01-26;751;108;11560;224;2.6;0.1
86;2021-01-27;765;141;12325;365;2.8;0.1
86;2021-01-28;1055;382;13380;747;3.1;0.2
86;2021-01-29;880;195;14260;942;3.3;0.2
86;2021-01-30;276;94;14536;1036;3.3;0.2
86;2021-01-31;57;157;14593;1193;3.3;0.3
86;2021-02-01;434;193;15027;1386;3.4;0.3
86;2021-02-02;573;368;15600;1754;3.6;0.4
86;2021-02-03;525;213;16125;1967;3.7;0.4
86;2021-02-04;479;349;16604;2316;3.8;0.5
86;2021-02-05;437;664;17041;2980;3.9;0.7
86;2021-02-06;148;171;17189;3151;3.9;0.7
86;2021-02-07;120;8;17309;3159;4.0;0.7
86;2021-02-08;362;246;17671;3405;4.0;0.8
86;2021-02-09;754;957;18425;4362;4.2;1.0
86;2021-02-10;973;819;19398;5181;4.4;1.2
86;2021-02-11;1009;871;20407;6052;4.7;1.4
86;2021-02-12;746;308;21153;6360;4.8;1.5
86;2021-02-13;193;69;21346;6429;4.9;1.5
86;2021-02-14;1;34;21347;6463;4.9;1.5
86;2021-02-15;243;346;21590;6809;4.9;1.6
86;2021-02-16;384;629;21974;7438;5.0;1.7
86;2021-02-17;453;774;22427;8212;5.1;1.9
86;2021-02-18;422;761;22849;8973;5.2;2.1
86;2021-02-19;602;509;23451;9482;5.4;2.2
86;2021-02-20;115;132;23566;9614;5.4;2.2
86;2021-02-21;1;0;23567;9614;5.4;2.2
86;2021-02-22;241;333;23808;9947;5.4;2.3
86;2021-02-23;369;497;24177;10444;5.5;2.4
86;2021-02-24;409;487;24586;10931;5.6;2.5
86;2021-02-25;903;569;25489;11500;5.8;2.6
86;2021-02-26;1029;467;26518;11967;6.1;2.7
86;2021-02-27;460;126;26978;12093;6.2;2.8
86;2021-02-28;3;2;26981;12095;6.2;2.8
86;2021-03-01;232;450;27213;12545;6.2;2.9
86;2021-03-02;1142;742;28355;13287;6.5;3.0
86;2021-03-03;794;552;29149;13839;6.7;3.2
86;2021-03-04;1496;588;30645;14427;7.0;3.3
86;2021-03-05;1577;291;32222;14718;7.4;3.4
86;2021-03-06;995;150;33217;14868;7.6;3.4
86;2021-03-07;371;29;33588;14897;7.7;3.4
86;2021-03-08;473;493;34061;15390;7.8;3.5
86;2021-03-09;1368;485;35429;15875;8.1;3.6
86;2021-03-10;948;572;36377;16447;8.3;3.8
86;2021-03-11;1798;450;38175;16897;8.7;3.9
86;2021-03-12;2208;413;40383;17310;9.2;4.0
86;2021-03-13;1444;95;41827;17405;9.6;4.0
86;2021-03-14;133;16;41960;17421;9.6;4.0
86;2021-03-15;784;151;42744;17572;9.8;4.0
86;2021-03-16;847;194;43591;17766;10.0;4.1
86;2021-03-17;786;200;44377;17966;10.1;4.1
86;2021-03-18;1005;101;45382;18067;10.4;4.1
86;2021-03-19;2146;309;47528;18376;10.9;4.2
86;2021-03-20;592;130;48120;18506;11.0;4.2
86;2021-03-21;10;0;48130;18506;11.0;4.2
86;2021-03-22;852;273;48982;18779;11.2;4.3
86;2021-03-23;2016;324;50998;19103;11.7;4.4
86;2021-03-24;1557;287;52555;19390;12.0;4.4
86;2021-03-25;2489;343;55044;19733;12.6;4.5
86;2021-03-26;3044;362;58088;20095;13.3;4.6
86;2021-03-27;733;142;58821;20237;13.4;4.6
86;2021-03-28;5;124;58826;20361;13.4;4.7
86;2021-03-29;1260;384;60086;20745;13.7;4.7
86;2021-03-30;2404;820;62490;21565;14.3;4.9
86;2021-03-31;1511;623;64001;22188;14.6;5.1
86;2021-04-01;2246;939;66247;23127;15.1;5.3
86;2021-04-02;1902;552;68149;23679;15.6;5.4
86;2021-04-03;826;324;68975;24003;15.8;5.5
86;2021-04-04;83;109;69058;24112;15.8;5.5
86;2021-04-05;314;5;69372;24117;15.9;5.5
86;2021-04-06;1532;958;70904;25075;16.2;5.7
86;2021-04-07;1633;620;72537;25695;16.6;5.9
86;2021-04-08;2569;760;75106;26455;17.2;6.0
86;2021-04-09;3250;650;78356;27105;17.9;6.2
86;2021-04-10;1662;192;80018;27297;18.3;6.2
86;2021-04-11;442;11;80460;27308;18.4;6.2
86;2021-04-12;820;762;81280;28070;18.6;6.4
86;2021-04-13;2454;938;83734;29008;19.1;6.6
86;2021-04-14;1870;875;85604;29883;19.6;6.8
86;2021-04-15;2276;726;87880;30609;20.1;7.0
86;2021-04-16;2471;1227;90351;31836;20.7;7.3
86;2021-04-17;1040;264;91391;32100;20.9;7.3
86;2021-04-18;119;4;91510;32104;20.9;7.3
86;2021-04-19;745;797;92255;32901;21.1;7.5
86;2021-04-20;2301;1503;94556;34404;21.6;7.9
86;2021-04-21;2108;1126;96664;35530;22.1;8.1
86;2021-04-22;2329;1437;98993;36967;22.6;8.5
86;2021-04-23;2392;1576;101385;38543;23.2;8.8
86;2021-04-24;1299;511;102684;39054;23.5;8.9
86;2021-04-25;825;27;103509;39081;23.7;8.9
86;2021-04-26;2080;889;105589;39970;24.1;9.1
86;2021-04-27;3155;1661;108744;41631;24.9;9.5
86;2021-04-28;3002;1508;111746;43139;25.5;9.9
86;2021-04-29;3558;1829;115304;44968;26.4;10.3
86;2021-04-30;2969;1478;118273;46446;27.0;10.6
86;2021-05-01;1580;197;119853;46643;27.4;10.7
86;2021-05-02;1279;45;121132;46688;27.7;10.7
86;2021-05-03;2563;1006;123695;47694;28.3;10.9
86;2021-05-04;3508;1893;127203;49587;29.1;11.3
86;2021-05-05;3989;1484;131192;51071;30.0;11.7
86;2021-05-06;4289;1650;135481;52721;31.0;12.1
86;2021-05-07;4043;1824;139524;54545;31.9;12.5
86;2021-05-08;1976;396;141500;54941;32.4;12.6
86;2021-05-09;1641;203;143141;55144;32.7;12.6
86;2021-05-10;1957;1173;145098;56317;33.2;12.9
86;2021-05-11;3603;2682;148701;58999;34.0;13.5
86;2021-05-12;2252;1649;150953;60648;34.5;13.9
86;2021-05-13;1687;299;152640;60947;34.9;13.9
86;2021-05-14;2097;788;154737;61735;35.4;14.1
86;2021-05-15;1466;499;156203;62234;35.7;14.2
86;2021-05-16;778;164;156981;62398;35.9;14.3
86;2021-05-17;3218;1056;160199;63454;36.6;14.5
86;2021-05-18;4306;1662;164505;65116;37.6;14.9
86;2021-05-19;3587;1432;168092;66548;38.4;15.2
86;2021-05-20;4371;1618;172463;68166;39.4;15.6
86;2021-05-21;3438;1771;175901;69937;40.2;16.0
86;2021-05-22;2076;664;177977;70601;40.7;16.1
86;2021-05-23;1438;183;179415;70784;41.0;16.2
86;2021-05-24;1845;204;181260;70988;41.4;16.2
86;2021-05-25;2851;1640;184111;72628;42.1;16.6
86;2021-05-26;2725;1529;186836;74157;42.7;17.0
86;2021-05-27;3546;1848;190382;76005;43.5;17.4
86;2021-05-28;2164;2532;192546;78537;44.0;18.0
86;2021-05-29;1527;1286;194073;79823;44.4;18.2
86;2021-05-30;934;132;195007;79955;44.6;18.3
86;2021-05-31;1922;1818;196929;81773;45.0;18.7
86;2021-06-01;2664;2579;199593;84352;45.6;19.3
86;2021-06-02;2305;2659;201898;87011;46.2;19.9
86;2021-06-03;3337;2407;205235;89418;46.9;20.4
86;2021-06-04;2237;2857;207472;92275;47.4;21.1
86;2021-06-05;1502;1575;208974;93850;47.8;21.5
86;2021-06-06;819;900;209793;94750;48.0;21.7
86;2021-06-07;1120;2465;210913;97215;48.2;22.2
86;2021-06-08;1990;3695;212903;100910;48.7;23.1
86;2021-06-09;1901;3314;214804;104224;49.1;23.8
86;2021-06-10;2349;3241;217153;107465;49.6;24.6
86;2021-06-11;1517;2783;218670;110248;50.0;25.2
86;2021-06-12;746;2242;219416;112490;50.2;25.7
86;2021-06-13;214;1477;219630;113967;50.2;26.1
86;2021-06-14;1158;2901;220788;116868;50.5;26.7
86;2021-06-15;1690;4258;222478;121126;50.9;27.7
86;2021-06-16;1808;3135;224286;124261;51.3;28.4
86;2021-06-17;1777;4445;226063;128706;51.7;29.4
86;2021-06-18;1882;4585;227945;133291;52.1;30.5
86;2021-06-19;636;2097;228581;135388;52.3;31.0
86;2021-06-20;172;1319;228753;136707;52.3;31.3
86;2021-06-21;1106;2234;229859;138941;52.6;31.8
86;2021-06-22;1298;3458;231157;142399;52.8;32.6
86;2021-06-23;1364;2399;232521;144798;53.2;33.1
86;2021-06-24;1590;2725;234111;147523;53.5;33.7
86;2021-06-25;1192;3543;235303;151066;53.8;34.5
86;2021-06-26;391;2650;235694;153716;53.9;35.1
86;2021-06-27;138;1633;235832;155349;53.9;35.5
86;2021-06-28;270;3339;236102;158688;54.0;36.3
86;2021-06-29;858;4602;236960;163290;54.2;37.3
86;2021-06-30;1051;2973;238011;166263;54.4;38.0
86;2021-07-01;1549;3003;239560;169266;54.8;38.7
86;2021-07-02;1111;3636;240671;172902;55.0;39.5
86;2021-07-03;516;2393;241187;175295;55.1;40.1
86;2021-07-04;115;1346;241302;176641;55.2;40.4
86;2021-07-05;472;2832;241774;179473;55.3;41.0
86;2021-07-06;988;4108;242762;183581;55.5;42.0
86;2021-07-07;1260;2627;244022;186208;55.8;42.6
86;2021-07-08;1618;3148;245640;189356;56.2;43.3
86;2021-07-09;1746;3080;247386;192436;56.6;44.0
86;2021-07-10;1304;1954;248690;194390;56.9;44.4
86;2021-07-11;482;839;249172;195229;57.0;44.6
86;2021-07-12;848;2400;250020;197629;57.2;45.2
86;2021-07-13;1780;3367;251800;200996;57.6;46.0
86;2021-07-14;785;1232;252585;202228;57.7;46.2
86;2021-07-15;1882;3289;254467;205517;58.2;47.0
86;2021-07-16;1671;2660;256138;208177;58.6;47.6
86;2021-07-17;1352;1601;257490;209778;58.9;48.0
86;2021-07-18;382;908;257872;210686;59.0;48.2
86;2021-07-19;1377;1887;259249;212573;59.3;48.6
86;2021-07-20;2353;2733;261602;215306;59.8;49.2
86;2021-07-21;2305;2162;263907;217468;60.3;49.7
86;2021-07-22;2902;2800;266809;220268;61.0;50.4
86;2021-07-23;2465;2163;269274;222431;61.6;50.9
86;2021-07-24;1546;1225;270820;223656;61.9;51.1
86;2021-07-25;718;322;271538;223978;62.1;51.2
86;2021-07-26;1588;2103;273126;226081;62.4;51.7
86;2021-07-27;3558;2755;276684;228836;63.3;52.3
86;2021-07-28;3284;2140;279968;230976;64.0;52.8
86;2021-07-29;3266;2544;283234;233520;64.8;53.4
86;2021-07-30;2247;2370;285481;235890;65.3;53.9
86;2021-07-31;1429;1059;286910;236949;65.6;54.2
86;2021-08-01;651;338;287561;237287;65.7;54.2
86;2021-08-02;1944;1679;289505;238966;66.2;54.6
86;2021-08-03;3290;1991;292795;240957;66.9;55.1
86;2021-08-04;2739;1786;295534;242743;67.6;55.5
86;2021-08-05;3572;2055;299106;244798;68.4;56.0
86;2021-08-06;2420;1761;301526;246559;68.9;56.4
86;2021-08-07;1576;997;303102;247556;69.3;56.6
86;2021-08-08;958;553;304060;248109;69.5;56.7
86;2021-08-09;1885;1305;305945;249414;69.9;57.0
86;2021-08-10;2683;1779;308628;251193;70.6;57.4
86;2021-08-11;2365;1437;310993;252630;71.1;57.8
86;2021-08-12;2485;1832;313478;254462;71.7;58.2
86;2021-08-13;1838;1487;315316;255949;72.1;58.5
86;2021-08-14;1331;1153;316647;257102;72.4;58.8
86;2021-08-15;562;623;317209;257725;72.5;58.9
86;2021-08-16;1142;1788;318351;259513;72.8;59.3
86;2021-08-17;1558;2215;319909;261728;73.1;59.8
86;2021-08-18;1266;1861;321175;263589;73.4;60.3
86;2021-08-19;1501;2634;322676;266223;73.8;60.9
86;2021-08-20;1257;2608;323933;268831;74.1;61.5
86;2021-08-21;888;2008;324821;270839;74.3;61.9
86;2021-08-22;350;721;325171;271560;74.3;62.1
86;2021-08-23;724;1824;325895;273384;74.5;62.5
86;2021-08-24;1081;2752;326976;276136;74.8;63.1
86;2021-08-25;933;2064;327909;278200;75.0;63.6
86;2021-08-26;914;2813;328823;281013;75.2;64.2
86;2021-08-27;862;2174;329685;283187;75.4;64.7
86;2021-08-28;555;1775;330240;284962;75.5;65.1
86;2021-08-29;114;828;330354;285790;75.5;65.3
86;2021-08-30;686;2123;331040;287913;75.7;65.8
86;2021-08-31;961;3204;332001;291117;75.9;66.6
86;2021-09-01;570;2750;332571;293867;76.0;67.2
86;2021-09-02;753;2830;333324;296697;76.2;67.8
86;2021-09-03;758;2403;334082;299100;76.4;68.4
86;2021-09-04;365;2218;334447;301318;76.5;68.9
86;2021-09-05;27;918;334474;302236;76.5;69.1
86;2021-09-06;356;1753;334830;303989;76.6;69.5
86;2021-09-07;509;2208;335339;306197;76.7;70.0
86;2021-09-08;559;2400;335898;308597;76.8;70.6
86;2021-09-09;573;2024;336471;310621;76.9;71.0
86;2021-09-10;520;2134;336991;312755;77.0;71.5
86;2021-09-11;354;1893;337345;314648;77.1;71.9
86;2021-09-12;102;797;337447;315445;77.1;72.1
86;2021-09-13;320;1433;337767;316878;77.2;72.4
86;2021-09-14;400;2011;338167;318889;77.3;72.9
86;2021-09-15;472;1555;338639;320444;77.4;73.3
86;2021-09-16;437;1010;339076;321454;77.5;73.5
86;2021-09-17;488;1062;339564;322516;77.6;73.7
86;2021-09-18;294;1269;339858;323785;77.7;74.0
86;2021-09-19;85;415;339943;324200;77.7;74.1
86;2021-09-20;223;641;340166;324841;77.8;74.3
86;2021-09-21;266;825;340432;325666;77.8;74.5
86;2021-09-22;336;1184;340768;326850;77.9;74.7
86;2021-09-23;353;580;341121;327430;78.0;74.9
86;2021-09-24;308;840;341429;328270;78.1;75.1
86;2021-09-25;289;1063;341718;329333;78.1;75.3
86;2021-09-26;45;166;341763;329499;78.1;75.3
86;2021-09-27;159;359;341922;329858;78.2;75.4
86;2021-09-28;239;368;342161;330226;78.2;75.5
86;2021-09-29;228;685;342389;330911;78.3;75.7
87;2020-12-27;0;0;0;0;0.0;0.0
87;2020-12-28;3;0;3;0;0.0;0.0
87;2020-12-29;0;0;3;0;0.0;0.0
87;2020-12-30;0;0;3;0;0.0;0.0
87;2020-12-31;0;0;3;0;0.0;0.0
87;2021-01-01;0;0;3;0;0.0;0.0
87;2021-01-02;0;0;3;0;0.0;0.0
87;2021-01-03;0;0;3;0;0.0;0.0
87;2021-01-04;2;0;5;0;0.0;0.0
87;2021-01-05;1;0;6;0;0.0;0.0
87;2021-01-06;10;0;16;0;0.0;0.0
87;2021-01-07;301;0;317;0;0.1;0.0
87;2021-01-08;407;0;724;0;0.2;0.0
87;2021-01-09;65;0;789;0;0.2;0.0
87;2021-01-10;35;0;824;0;0.2;0.0
87;2021-01-11;424;0;1248;0;0.3;0.0
87;2021-01-12;653;0;1901;0;0.5;0.0
87;2021-01-13;660;2;2561;2;0.7;0.0
87;2021-01-14;517;10;3078;12;0.8;0.0
87;2021-01-15;534;3;3612;15;1.0;0.0
87;2021-01-16;204;1;3816;16;1.0;0.0
87;2021-01-17;1;0;3817;16;1.0;0.0
87;2021-01-18;645;5;4462;21;1.2;0.0
87;2021-01-19;657;1;5119;22;1.4;0.0
87;2021-01-20;674;3;5793;25;1.6;0.0
87;2021-01-21;717;0;6510;25;1.8;0.0
87;2021-01-22;758;4;7268;29;2.0;0.0
87;2021-01-23;287;0;7555;29;2.0;0.0
87;2021-01-24;1;0;7556;29;2.0;0.0
87;2021-01-25;620;10;8176;39;2.2;0.0
87;2021-01-26;570;47;8746;86;2.4;0.0
87;2021-01-27;572;36;9318;122;2.5;0.0
87;2021-01-28;856;91;10174;213;2.7;0.1
87;2021-01-29;741;239;10915;452;2.9;0.1
87;2021-01-30;325;66;11240;518;3.0;0.1
87;2021-01-31;34;71;11274;589;3.0;0.2
87;2021-02-01;413;280;11687;869;3.2;0.2
87;2021-02-02;452;407;12139;1276;3.3;0.3
87;2021-02-03;540;350;12679;1626;3.4;0.4
87;2021-02-04;613;528;13292;2154;3.6;0.6
87;2021-02-05;344;352;13636;2506;3.7;0.7
87;2021-02-06;55;109;13691;2615;3.7;0.7
87;2021-02-07;20;0;13711;2615;3.7;0.7
87;2021-02-08;246;369;13957;2984;3.8;0.8
87;2021-02-09;219;439;14176;3423;3.8;0.9
87;2021-02-10;262;462;14438;3885;3.9;1.0
87;2021-02-11;286;408;14724;4293;4.0;1.2
87;2021-02-12;287;402;15011;4695;4.0;1.3
87;2021-02-13;25;135;15036;4830;4.1;1.3
87;2021-02-14;0;2;15036;4832;4.1;1.3
87;2021-02-15;237;300;15273;5132;4.1;1.4
87;2021-02-16;332;235;15605;5367;4.2;1.4
87;2021-02-17;329;296;15934;5663;4.3;1.5
87;2021-02-18;478;537;16412;6200;4.4;1.7
87;2021-02-19;404;390;16816;6590;4.5;1.8
87;2021-02-20;124;143;16940;6733;4.6;1.8
87;2021-02-21;2;9;16942;6742;4.6;1.8
87;2021-02-22;440;444;17382;7186;4.7;1.9
87;2021-02-23;557;492;17939;7678;4.8;2.1
87;2021-02-24;451;465;18390;8143;5.0;2.2
87;2021-02-25;790;581;19180;8724;5.2;2.4
87;2021-02-26;841;379;20021;9103;5.4;2.5
87;2021-02-27;405;150;20426;9253;5.5;2.5
87;2021-02-28;3;0;20429;9253;5.5;2.5
87;2021-03-01;518;303;20947;9556;5.6;2.6
87;2021-03-02;1030;319;21977;9875;5.9;2.7
87;2021-03-03;1174;281;23151;10156;6.2;2.7
87;2021-03-04;1406;307;24557;10463;6.6;2.8
87;2021-03-05;1770;241;26327;10704;7.1;2.9
87;2021-03-06;1048;37;27375;10741;7.4;2.9
87;2021-03-07;257;6;27632;10747;7.5;2.9
87;2021-03-08;863;207;28495;10954;7.7;3.0
87;2021-03-09;1288;207;29783;11161;8.0;3.0
87;2021-03-10;1299;214;31082;11375;8.4;3.1
87;2021-03-11;1754;236;32836;11611;8.9;3.1
87;2021-03-12;2128;253;34964;11864;9.4;3.2
87;2021-03-13;1309;22;36273;11886;9.8;3.2
87;2021-03-14;80;1;36353;11887;9.8;3.2
87;2021-03-15;987;348;37340;12235;10.1;3.3
87;2021-03-16;1060;231;38400;12466;10.4;3.4
87;2021-03-17;1070;219;39470;12685;10.6;3.4
87;2021-03-18;1186;336;40656;13021;11.0;3.5
87;2021-03-19;1685;277;42341;13298;11.4;3.6
87;2021-03-20;926;86;43267;13384;11.7;3.6
87;2021-03-21;32;0;43299;13384;11.7;3.6
87;2021-03-22;1049;365;44348;13749;12.0;3.7
87;2021-03-23;1386;426;45734;14175;12.3;3.8
87;2021-03-24;1508;363;47242;14538;12.7;3.9
87;2021-03-25;2500;397;49742;14935;13.4;4.0
87;2021-03-26;2532;451;52274;15386;14.1;4.1
87;2021-03-27;891;123;53165;15509;14.3;4.2
87;2021-03-28;270;18;53435;15527;14.4;4.2
87;2021-03-29;1119;412;54554;15939;14.7;4.3
87;2021-03-30;1907;660;56461;16599;15.2;4.5
87;2021-03-31;1660;692;58121;17291;15.7;4.7
87;2021-04-01;2237;571;60358;17862;16.3;4.8
87;2021-04-02;1843;628;62201;18490;16.8;5.0
87;2021-04-03;455;266;62656;18756;16.9;5.1
87;2021-04-04;2;0;62658;18756;16.9;5.1
87;2021-04-05;82;1;62740;18757;16.9;5.1
87;2021-04-06;1004;904;63744;19661;17.2;5.3
87;2021-04-07;1487;922;65231;20583;17.6;5.6
87;2021-04-08;1785;1030;67016;21613;18.1;5.8
87;2021-04-09;2647;741;69663;22354;18.8;6.0
87;2021-04-10;1189;307;70852;22661;19.1;6.1
87;2021-04-11;69;0;70921;22661;19.1;6.1
87;2021-04-12;1619;826;72540;23487;19.6;6.3
87;2021-04-13;2288;1064;74828;24551;20.2;6.6
87;2021-04-14;2529;1185;77357;25736;20.9;6.9
87;2021-04-15;2223;1073;79580;26809;21.5;7.2
87;2021-04-16;2735;1068;82315;27877;22.2;7.5
87;2021-04-17;731;388;83046;28265;22.4;7.6
87;2021-04-18;111;139;83157;28404;22.4;7.7
87;2021-04-19;1661;838;84818;29242;22.9;7.9
87;2021-04-20;2084;884;86902;30126;23.4;8.1
87;2021-04-21;2295;990;89197;31116;24.1;8.4
87;2021-04-22;2564;1163;91761;32279;24.7;8.7
87;2021-04-23;1997;1180;93758;33459;25.3;9.0
87;2021-04-24;824;619;94582;34078;25.5;9.2
87;2021-04-25;64;103;94646;34181;25.5;9.2
87;2021-04-26;1356;910;96002;35091;25.9;9.5
87;2021-04-27;2398;1196;98400;36287;26.5;9.8
87;2021-04-28;3867;1431;102267;37718;27.6;10.2
87;2021-04-29;3078;1827;105345;39545;28.4;10.7
87;2021-04-30;3172;1345;108517;40890;29.3;11.0
87;2021-05-01;614;59;109131;40949;29.4;11.0
87;2021-05-02;361;5;109492;40954;29.5;11.0
87;2021-05-03;2322;931;111814;41885;30.2;11.3
87;2021-05-04;2902;1067;114716;42952;30.9;11.6
87;2021-05-05;2989;1505;117705;44457;31.7;12.0
87;2021-05-06;2531;1698;120236;46155;32.4;12.4
87;2021-05-07;2945;1710;123181;47865;33.2;12.9
87;2021-05-08;772;291;123953;48156;33.4;13.0
87;2021-05-09;18;133;123971;48289;33.4;13.0
87;2021-05-10;1938;1584;125909;49873;34.0;13.5
87;2021-05-11;2465;1902;128374;51775;34.6;14.0
87;2021-05-12;2623;2062;130997;53837;35.3;14.5
87;2021-05-13;1085;292;132082;54129;35.6;14.6
87;2021-05-14;2245;1773;134327;55902;36.2;15.1
87;2021-05-15;950;409;135277;56311;36.5;15.2
87;2021-05-16;141;73;135418;56384;36.5;15.2
87;2021-05-17;1628;1761;137046;58145;37.0;15.7
87;2021-05-18;2632;1818;139678;59963;37.7;16.2
87;2021-05-19;2822;1553;142500;61516;38.4;16.6
87;2021-05-20;3302;1724;145802;63240;39.3;17.1
87;2021-05-21;2764;1841;148566;65081;40.1;17.6
87;2021-05-22;1457;628;150023;65709;40.5;17.7
87;2021-05-23;211;92;150234;65801;40.5;17.7
87;2021-05-24;1055;141;151289;65942;40.8;17.8
87;2021-05-25;2117;1810;153406;67752;41.4;18.3
87;2021-05-26;3219;2476;156625;70228;42.2;18.9
87;2021-05-27;3022;2354;159647;72582;43.1;19.6
87;2021-05-28;2675;2511;162322;75093;43.8;20.3
87;2021-05-29;1061;1306;163383;76399;44.1;20.6
87;2021-05-30;258;60;163641;76459;44.1;20.6
87;2021-05-31;2287;1357;165928;77816;44.8;21.0
87;2021-06-01;2547;1858;168475;79674;45.4;21.5
87;2021-06-02;2525;1850;171000;81524;46.1;22.0
87;2021-06-03;3212;2525;174212;84049;47.0;22.7
87;2021-06-04;2838;2053;177050;86102;47.8;23.2
87;2021-06-05;1309;569;178359;86671;48.1;23.4
87;2021-06-06;261;95;178620;86766;48.2;23.4
87;2021-06-07;2098;1894;180718;88660;48.7;23.9
87;2021-06-08;2958;2597;183676;91257;49.5;24.6
87;2021-06-09;2303;2809;185979;94066;50.2;25.4
87;2021-06-10;2974;2552;188953;96618;51.0;26.1
87;2021-06-11;2363;3062;191316;99680;51.6;26.9
87;2021-06-12;1219;1099;192535;100779;51.9;27.2
87;2021-06-13;294;485;192829;101264;52.0;27.3
87;2021-06-14;980;2729;193809;103993;52.3;28.0
87;2021-06-15;1361;3317;195170;107310;52.6;28.9
87;2021-06-16;1650;3424;196820;110734;53.1;29.9
87;2021-06-17;2438;2314;199258;113048;53.7;30.5
87;2021-06-18;1790;3012;201048;116060;54.2;31.3
87;2021-06-19;1047;1177;202095;117237;54.5;31.6
87;2021-06-20;205;206;202300;117443;54.6;31.7
87;2021-06-21;1040;2647;203340;120090;54.8;32.4
87;2021-06-22;1029;2879;204369;122969;55.1;33.2
87;2021-06-23;1256;3081;205625;126050;55.5;34.0
87;2021-06-24;1616;2561;207241;128611;55.9;34.7
87;2021-06-25;1448;2708;208689;131319;56.3;35.4
87;2021-06-26;529;1199;209218;132518;56.4;35.7
87;2021-06-27;26;212;209244;132730;56.4;35.8
87;2021-06-28;717;2575;209961;135305;56.6;36.5
87;2021-06-29;1156;3415;211117;138720;56.9;37.4
87;2021-06-30;1125;2651;212242;141371;57.2;38.1
87;2021-07-01;1482;2552;213724;143923;57.6;38.8
87;2021-07-02;1204;3461;214928;147384;58.0;39.8
87;2021-07-03;415;1512;215343;148896;58.1;40.2
87;2021-07-04;24;384;215367;149280;58.1;40.3
87;2021-07-05;685;2391;216052;151671;58.3;40.9
87;2021-07-06;583;3220;216635;154891;58.4;41.8
87;2021-07-07;862;3343;217497;158234;58.7;42.7
87;2021-07-08;1119;3671;218616;161905;59.0;43.7
87;2021-07-09;1113;3701;219729;165606;59.3;44.7
87;2021-07-10;290;1360;220019;166966;59.3;45.0
87;2021-07-11;49;284;220068;167250;59.4;45.1
87;2021-07-12;559;3192;220627;170442;59.5;46.0
87;2021-07-13;833;3509;221460;173951;59.7;46.9
87;2021-07-14;517;538;221977;174489;59.9;47.1
87;2021-07-15;1361;3461;223338;177950;60.2;48.0
87;2021-07-16;1731;3593;225069;181543;60.7;49.0
87;2021-07-17;655;1373;225724;182916;60.9;49.3
87;2021-07-18;81;285;225805;183201;60.9;49.4
87;2021-07-19;1434;3400;227239;186601;61.3;50.3
87;2021-07-20;1805;3590;229044;190191;61.8;51.3
87;2021-07-21;1451;3149;230495;193340;62.2;52.1
87;2021-07-22;1877;3244;232372;196584;62.7;53.0
87;2021-07-23;1875;3171;234247;199755;63.2;53.9
87;2021-07-24;816;1284;235063;201039;63.4;54.2
87;2021-07-25;106;241;235169;201280;63.4;54.3
87;2021-07-26;1541;2328;236710;203608;63.8;54.9
87;2021-07-27;2556;2062;239266;205670;64.5;55.5
87;2021-07-28;2390;2005;241656;207675;65.2;56.0
87;2021-07-29;3009;1998;244665;209673;66.0;56.6
87;2021-07-30;2543;2072;247208;211745;66.7;57.1
87;2021-07-31;1103;837;248311;212582;67.0;57.3
87;2021-08-01;283;151;248594;212733;67.0;57.4
87;2021-08-02;2119;1519;250713;214252;67.6;57.8
87;2021-08-03;2495;1331;253208;215583;68.3;58.1
87;2021-08-04;2314;1061;255522;216644;68.9;58.4
87;2021-08-05;2528;1412;258050;218056;69.6;58.8
87;2021-08-06;2144;1659;260194;219715;70.2;59.3
87;2021-08-07;1110;783;261304;220498;70.5;59.5
87;2021-08-08;208;124;261512;220622;70.5;59.5
87;2021-08-09;1818;1526;263330;222148;71.0;59.9
87;2021-08-10;2199;1533;265529;223681;71.6;60.3
87;2021-08-11;1912;1273;267441;224954;72.1;60.7
87;2021-08-12;2106;1481;269547;226435;72.7;61.1
87;2021-08-13;1724;1620;271271;228055;73.2;61.5
87;2021-08-14;671;733;271942;228788;73.3;61.7
87;2021-08-15;72;104;272014;228892;73.4;61.7
87;2021-08-16;1505;1739;273519;230631;73.8;62.2
87;2021-08-17;1351;1668;274870;232299;74.1;62.7
87;2021-08-18;1245;1998;276115;234297;74.5;63.2
87;2021-08-19;1222;1798;277337;236095;74.8;63.7
87;2021-08-20;917;2205;278254;238300;75.0;64.3
87;2021-08-21;318;965;278572;239265;75.1;64.5
87;2021-08-22;92;235;278664;239500;75.2;64.6
87;2021-08-23;745;2393;279409;241893;75.4;65.2
87;2021-08-24;765;2135;280174;244028;75.6;65.8
87;2021-08-25;710;2062;280884;246090;75.8;66.4
87;2021-08-26;857;2156;281741;248246;76.0;67.0
87;2021-08-27;788;2666;282529;250912;76.2;67.7
87;2021-08-28;331;1300;282860;252212;76.3;68.0
87;2021-08-29;65;244;282925;252456;76.3;68.1
87;2021-08-30;472;2214;283397;254670;76.4;68.7
87;2021-08-31;606;1932;284003;256602;76.6;69.2
87;2021-09-01;749;2469;284752;259071;76.8;69.9
87;2021-09-02;556;2342;285308;261413;76.9;70.5
87;2021-09-03;648;2483;285956;263896;77.1;71.2
87;2021-09-04;276;1130;286232;265026;77.2;71.5
87;2021-09-05;9;7;286241;265033;77.2;71.5
87;2021-09-06;395;1986;286636;267019;77.3;72.0
87;2021-09-07;384;1523;287020;268542;77.4;72.4
87;2021-09-08;456;1820;287476;270362;77.5;72.9
87;2021-09-09;323;1285;287799;271647;77.6;73.3
87;2021-09-10;465;1695;288264;273342;77.7;73.7
87;2021-09-11;319;972;288583;274314;77.8;74.0
87;2021-09-12;3;13;288586;274327;77.8;74.0
87;2021-09-13;310;1106;288896;275433;77.9;74.3
87;2021-09-14;284;1019;289180;276452;78.0;74.6
87;2021-09-15;367;963;289547;277415;78.1;74.8
87;2021-09-16;347;789;289894;278204;78.2;75.0
87;2021-09-17;404;884;290298;279088;78.3;75.3
87;2021-09-18;286;727;290584;279815;78.4;75.5
87;2021-09-19;4;14;290588;279829;78.4;75.5
87;2021-09-20;203;465;290791;280294;78.4;75.6
87;2021-09-21;260;507;291051;280801;78.5;75.7
87;2021-09-22;235;758;291286;281559;78.6;75.9
87;2021-09-23;218;529;291504;282088;78.6;76.1
87;2021-09-24;293;740;291797;282828;78.7;76.3
87;2021-09-25;167;511;291964;283339;78.7;76.4
87;2021-09-26;1;5;291965;283344;78.7;76.4
87;2021-09-27;194;401;292159;283745;78.8;76.5
87;2021-09-28;204;321;292363;284066;78.9;76.6
87;2021-09-29;170;398;292533;284464;78.9;76.7
88;2020-12-27;0;0;0;0;0.0;0.0
88;2020-12-28;0;0;0;0;0.0;0.0
88;2020-12-29;0;0;0;0;0.0;0.0
88;2020-12-30;0;0;0;0;0.0;0.0
88;2020-12-31;0;0;0;0;0.0;0.0
88;2021-01-01;2;0;2;0;0.0;0.0
88;2021-01-02;0;0;2;0;0.0;0.0
88;2021-01-03;0;0;2;0;0.0;0.0
88;2021-01-04;0;0;2;0;0.0;0.0
88;2021-01-05;1;0;3;0;0.0;0.0
88;2021-01-06;3;0;6;0;0.0;0.0
88;2021-01-07;71;1;77;1;0.0;0.0
88;2021-01-08;189;2;266;3;0.1;0.0
88;2021-01-09;190;2;456;5;0.1;0.0
88;2021-01-10;0;0;456;5;0.1;0.0
88;2021-01-11;227;0;683;5;0.2;0.0
88;2021-01-12;422;0;1105;5;0.3;0.0
88;2021-01-13;491;2;1596;7;0.4;0.0
88;2021-01-14;347;2;1943;9;0.5;0.0
88;2021-01-15;380;1;2323;10;0.6;0.0
88;2021-01-16;62;0;2385;10;0.7;0.0
88;2021-01-17;1;0;2386;10;0.7;0.0
88;2021-01-18;461;0;2847;10;0.8;0.0
88;2021-01-19;451;0;3298;10;0.9;0.0
88;2021-01-20;462;1;3760;11;1.0;0.0
88;2021-01-21;1547;5;5307;16;1.5;0.0
88;2021-01-22;1182;2;6489;18;1.8;0.0
88;2021-01-23;285;0;6774;18;1.9;0.0
88;2021-01-24;298;2;7072;20;2.0;0.0
88;2021-01-25;937;4;8009;24;2.2;0.0
88;2021-01-26;388;5;8397;29;2.3;0.0
88;2021-01-27;4;0;8401;29;2.3;0.0
88;2021-01-28;162;34;8563;63;2.4;0.0
88;2021-01-29;526;145;9089;208;2.5;0.1
88;2021-01-30;288;79;9377;287;2.6;0.1
88;2021-01-31;0;0;9377;287;2.6;0.1
88;2021-02-01;406;261;9783;548;2.7;0.2
88;2021-02-02;333;346;10116;894;2.8;0.2
88;2021-02-03;437;223;10553;1117;2.9;0.3
88;2021-02-04;315;210;10868;1327;3.0;0.4
88;2021-02-05;457;236;11325;1563;3.2;0.4
88;2021-02-06;110;49;11435;1612;3.2;0.4
88;2021-02-07;0;0;11435;1612;3.2;0.4
88;2021-02-08;361;160;11796;1772;3.3;0.5
88;2021-02-09;291;237;12087;2009;3.4;0.6
88;2021-02-10;416;299;12503;2308;3.5;0.6
88;2021-02-11;850;953;13353;3261;3.7;0.9
88;2021-02-12;939;658;14292;3919;4.0;1.1
88;2021-02-13;162;202;14454;4121;4.0;1.1
88;2021-02-14;81;195;14535;4316;4.0;1.2
88;2021-02-15;639;891;15174;5207;4.2;1.4
88;2021-02-16;472;532;15646;5739;4.4;1.6
88;2021-02-17;455;341;16101;6080;4.5;1.7
88;2021-02-18;516;270;16617;6350;4.6;1.8
88;2021-02-19;536;383;17153;6733;4.8;1.9
88;2021-02-20;156;86;17309;6819;4.8;1.9
88;2021-02-21;1;25;17310;6844;4.8;1.9
88;2021-02-22;425;252;17735;7096;4.9;2.0
88;2021-02-23;403;187;18138;7283;5.0;2.0
88;2021-02-24;505;168;18643;7451;5.2;2.1
88;2021-02-25;675;220;19318;7671;5.4;2.1
88;2021-02-26;863;230;20181;7901;5.6;2.2
88;2021-02-27;269;31;20450;7932;5.7;2.2
88;2021-02-28;30;1;20480;7933;5.7;2.2
88;2021-03-01;358;379;20838;8312;5.8;2.3
88;2021-03-02;431;389;21269;8701;5.9;2.4
88;2021-03-03;650;364;21919;9065;6.1;2.5
88;2021-03-04;1044;659;22963;9724;6.4;2.7
88;2021-03-05;933;626;23896;10350;6.6;2.9
88;2021-03-06;1873;112;25769;10462;7.2;2.9
88;2021-03-07;1060;77;26829;10539;7.5;2.9
88;2021-03-08;726;625;27555;11164;7.7;3.1
88;2021-03-09;1095;468;28650;11632;8.0;3.2
88;2021-03-10;1083;451;29733;12083;8.3;3.4
88;2021-03-11;1441;362;31174;12445;8.7;3.5
88;2021-03-12;1309;460;32483;12905;9.0;3.6
88;2021-03-13;1210;129;33693;13034;9.4;3.6
88;2021-03-14;166;5;33859;13039;9.4;3.6
88;2021-03-15;928;436;34787;13475;9.7;3.7
88;2021-03-16;1024;337;35811;13812;10.0;3.8
88;2021-03-17;906;414;36717;14226;10.2;4.0
88;2021-03-18;1303;398;38020;14624;10.6;4.1
88;2021-03-19;1465;500;39485;15124;11.0;4.2
88;2021-03-20;1319;55;40804;15179;11.3;4.2
88;2021-03-21;37;0;40841;15179;11.4;4.2
88;2021-03-22;1233;541;42074;15720;11.7;4.4
88;2021-03-23;1780;443;43854;16163;12.2;4.5
88;2021-03-24;1877;466;45731;16629;12.7;4.6
88;2021-03-25;2497;490;48228;17119;13.4;4.8
88;2021-03-26;2479;443;50707;17562;14.1;4.9
88;2021-03-27;884;297;51591;17859;14.3;5.0
88;2021-03-28;61;3;51652;17862;14.4;5.0
88;2021-03-29;1305;436;52957;18298;14.7;5.1
88;2021-03-30;2062;392;55019;18690;15.3;5.2
88;2021-03-31;1619;575;56638;19265;15.8;5.4
88;2021-04-01;2117;718;58755;19983;16.3;5.6
88;2021-04-02;2812;647;61567;20630;17.1;5.7
88;2021-04-03;745;215;62312;20845;17.3;5.8
88;2021-04-04;16;1;62328;20846;17.3;5.8
88;2021-04-05;23;2;62351;20848;17.3;5.8
88;2021-04-06;1140;678;63491;21526;17.7;6.0
88;2021-04-07;1600;714;65091;22240;18.1;6.2
88;2021-04-08;1857;788;66948;23028;18.6;6.4
88;2021-04-09;3078;741;70026;23769;19.5;6.6
88;2021-04-10;724;648;70750;24417;19.7;6.8
88;2021-04-11;33;1;70783;24418;19.7;6.8
88;2021-04-12;1537;987;72320;25405;20.1;7.1
88;2021-04-13;2035;1088;74355;26493;20.7;7.4
88;2021-04-14;1910;949;76265;27442;21.2;7.6
88;2021-04-15;1967;1244;78232;28686;21.8;8.0
88;2021-04-16;2109;1048;80341;29734;22.3;8.3
88;2021-04-17;1430;765;81771;30499;22.7;8.5
88;2021-04-18;268;23;82039;30522;22.8;8.5
88;2021-04-19;1172;1237;83211;31759;23.1;8.8
88;2021-04-20;1190;1396;84401;33155;23.5;9.2
88;2021-04-21;1503;1296;85904;34451;23.9;9.6
88;2021-04-22;1899;1632;87803;36083;24.4;10.0
88;2021-04-23;1825;2046;89628;38129;24.9;10.6
88;2021-04-24;1184;783;90812;38912;25.3;10.8
88;2021-04-25;34;2;90846;38914;25.3;10.8
88;2021-04-26;1181;1168;92027;40082;25.6;11.1
88;2021-04-27;1277;1727;93304;41809;26.0;11.6
88;2021-04-28;1634;1496;94938;43305;26.4;12.0
88;2021-04-29;2082;1455;97020;44760;27.0;12.4
88;2021-04-30;2450;1624;99470;46384;27.7;12.9
88;2021-05-01;2008;289;101478;46673;28.2;13.0
88;2021-05-02;1301;119;102779;46792;28.6;13.0
88;2021-05-03;1559;1218;104338;48010;29.0;13.4
88;2021-05-04;1444;1464;105782;49474;29.4;13.8
88;2021-05-05;2426;1598;108208;51072;30.1;14.2
88;2021-05-06;3210;1204;111418;52276;31.0;14.5
88;2021-05-07;2938;1345;114356;53621;31.8;14.9
88;2021-05-08;1532;467;115888;54088;32.2;15.0
88;2021-05-09;1734;163;117622;54251;32.7;15.1
88;2021-05-10;1763;1568;119385;55819;33.2;15.5
88;2021-05-11;2655;1909;122040;57728;33.9;16.1
88;2021-05-12;2532;1853;124572;59581;34.6;16.6
88;2021-05-13;3258;683;127830;60264;35.6;16.8
88;2021-05-14;2500;1539;130330;61803;36.3;17.2
88;2021-05-15;1624;744;131954;62547;36.7;17.4
88;2021-05-16;1332;103;133286;62650;37.1;17.4
88;2021-05-17;1987;944;135273;63594;37.6;17.7
88;2021-05-18;2255;1116;137528;64710;38.3;18.0
88;2021-05-19;2721;1148;140249;65858;39.0;18.3
88;2021-05-20;3348;1237;143597;67095;39.9;18.7
88;2021-05-21;2874;1148;146471;68243;40.7;19.0
88;2021-05-22;1431;713;147902;68956;41.1;19.2
88;2021-05-23;558;74;148460;69030;41.3;19.2
88;2021-05-24;1675;435;150135;69465;41.8;19.3
88;2021-05-25;1646;1174;151781;70639;42.2;19.6
88;2021-05-26;2368;1140;154149;71779;42.9;20.0
88;2021-05-27;2200;1361;156349;73140;43.5;20.3
88;2021-05-28;1891;1963;158240;75103;44.0;20.9
88;2021-05-29;1230;1755;159470;76858;44.4;21.4
88;2021-05-30;587;418;160057;77276;44.5;21.5
88;2021-05-31;1327;1849;161384;79125;44.9;22.0
88;2021-06-01;1720;1983;163104;81108;45.4;22.6
88;2021-06-02;2076;1871;165180;82979;45.9;23.1
88;2021-06-03;2738;1612;167918;84591;46.7;23.5
88;2021-06-04;2042;1926;169960;86517;47.3;24.1
88;2021-06-05;1531;1135;171491;87652;47.7;24.4
88;2021-06-06;692;156;172183;87808;47.9;24.4
88;2021-06-07;1290;1710;173473;89518;48.3;24.9
88;2021-06-08;1666;1933;175139;91451;48.7;25.4
88;2021-06-09;1619;1909;176758;93360;49.2;26.0
88;2021-06-10;1781;2047;178539;95407;49.7;26.5
88;2021-06-11;1549;2211;180088;97618;50.1;27.2
88;2021-06-12;669;1657;180757;99275;50.3;27.6
88;2021-06-13;464;377;181221;99652;50.4;27.7
88;2021-06-14;1030;2249;182251;101901;50.7;28.3
88;2021-06-15;1928;2458;184179;104359;51.2;29.0
88;2021-06-16;1485;2873;185664;107232;51.6;29.8
88;2021-06-17;1601;2732;187265;109964;52.1;30.6
88;2021-06-18;1355;2460;188620;112424;52.5;31.3
88;2021-06-19;701;1089;189321;113513;52.7;31.6
88;2021-06-20;78;79;189399;113592;52.7;31.6
88;2021-06-21;672;2578;190071;116170;52.9;32.3
88;2021-06-22;869;3433;190940;119603;53.1;33.3
88;2021-06-23;1144;2876;192084;122479;53.4;34.1
88;2021-06-24;702;2604;192786;125083;53.6;34.8
88;2021-06-25;1435;3179;194221;128262;54.0;35.7
88;2021-06-26;903;2073;195124;130335;54.3;36.3
88;2021-06-27;543;635;195667;130970;54.4;36.4
88;2021-06-28;758;2514;196425;133484;54.6;37.1
88;2021-06-29;960;3353;197385;136837;54.9;38.1
88;2021-06-30;1136;3114;198521;139951;55.2;38.9
88;2021-07-01;1056;2686;199577;142637;55.5;39.7
88;2021-07-02;992;3144;200569;145781;55.8;40.5
88;2021-07-03;692;1699;201261;147480;56.0;41.0
88;2021-07-04;258;815;201519;148295;56.1;41.2
88;2021-07-05;993;2020;202512;150315;56.3;41.8
88;2021-07-06;1021;2414;203533;152729;56.6;42.5
88;2021-07-07;1177;2586;204710;155315;56.9;43.2
88;2021-07-08;1082;2063;205792;157378;57.2;43.8
88;2021-07-09;1583;2704;207375;160082;57.7;44.5
88;2021-07-10;721;1818;208096;161900;57.9;45.0
88;2021-07-11;468;696;208564;162596;58.0;45.2
88;2021-07-12;1055;2520;209619;165116;58.3;45.9
88;2021-07-13;1313;2654;210932;167770;58.7;46.7
88;2021-07-14;1207;799;212139;168569;59.0;46.9
88;2021-07-15;1744;3306;213883;171875;59.5;47.8
88;2021-07-16;1469;2960;215352;174835;59.9;48.6
88;2021-07-17;802;1587;216154;176422;60.1;49.1
88;2021-07-18;180;679;216334;177101;60.2;49.3
88;2021-07-19;1563;2232;217897;179333;60.6;49.9
88;2021-07-20;2144;2385;220041;181718;61.2;50.5
88;2021-07-21;1938;2215;221979;183933;61.7;51.2
88;2021-07-22;1699;2107;223678;186040;62.2;51.7
88;2021-07-23;2508;2777;226186;188817;62.9;52.5
88;2021-07-24;1059;1186;227245;190003;63.2;52.8
88;2021-07-25;432;608;227677;190611;63.3;53.0
88;2021-07-26;1715;2074;229392;192685;63.8;53.6
88;2021-07-27;2350;2060;231742;194745;64.5;54.2
88;2021-07-28;2210;2248;233952;196993;65.1;54.8
88;2021-07-29;3033;1635;236985;198628;65.9;55.2
88;2021-07-30;2272;2294;239257;200922;66.5;55.9
88;2021-07-31;1105;1036;240362;201958;66.9;56.2
88;2021-08-01;449;461;240811;202419;67.0;56.3
88;2021-08-02;2376;1770;243187;204189;67.6;56.8
88;2021-08-03;2875;1591;246062;205780;68.4;57.2
88;2021-08-04;2519;1530;248581;207310;69.1;57.7
88;2021-08-05;1994;1378;250575;208688;69.7;58.0
88;2021-08-06;2947;2010;253522;210698;70.5;58.6
88;2021-08-07;1175;912;254697;211610;70.8;58.9
88;2021-08-08;751;319;255448;211929;71.1;58.9
88;2021-08-09;1547;1648;256995;213577;71.5;59.4
88;2021-08-10;1941;2040;258936;215617;72.0;60.0
88;2021-08-11;1869;1756;260805;217373;72.5;60.5
88;2021-08-12;1669;1349;262474;218722;73.0;60.8
88;2021-08-13;1952;2136;264426;220858;73.5;61.4
88;2021-08-14;580;912;265006;221770;73.7;61.7
88;2021-08-15;337;520;265343;222290;73.8;61.8
88;2021-08-16;1149;1988;266492;224278;74.1;62.4
88;2021-08-17;1267;2058;267759;226336;74.5;63.0
88;2021-08-18;1208;1925;268967;228261;74.8;63.5
88;2021-08-19;1042;1582;270009;229843;75.1;63.9
88;2021-08-20;1020;2330;271029;232173;75.4;64.6
88;2021-08-21;405;1144;271434;233317;75.5;64.9
88;2021-08-22;100;479;271534;233796;75.5;65.0
88;2021-08-23;734;1640;272268;235436;75.7;65.5
88;2021-08-24;918;1973;273186;237409;76.0;66.0
88;2021-08-25;891;2458;274077;239867;76.2;66.7
88;2021-08-26;868;2049;274945;241916;76.5;67.3
88;2021-08-27;844;2711;275789;244627;76.7;68.0
88;2021-08-28;490;1350;276279;245977;76.8;68.4
88;2021-08-29;130;693;276409;246670;76.9;68.6
88;2021-08-30;699;2383;277108;249053;77.1;69.3
88;2021-08-31;781;2375;277889;251428;77.3;69.9
88;2021-09-01;685;2076;278574;253504;77.5;70.5
88;2021-09-02;666;1746;279240;255250;77.7;71.0
88;2021-09-03;728;2259;279968;257509;77.9;71.6
88;2021-09-04;426;1159;280394;258668;78.0;71.9
88;2021-09-05;188;425;280582;259093;78.0;72.1
88;2021-09-06;505;1362;281087;260455;78.2;72.4
88;2021-09-07;566;1412;281653;261867;78.3;72.8
88;2021-09-08;455;1491;282108;263358;78.5;73.3
88;2021-09-09;536;1100;282644;264458;78.6;73.6
88;2021-09-10;590;1583;283234;266041;78.8;74.0
88;2021-09-11;350;851;283584;266892;78.9;74.2
88;2021-09-12;70;142;283654;267034;78.9;74.3
88;2021-09-13;427;1074;284081;268108;79.0;74.6
88;2021-09-14;548;1259;284629;269367;79.2;74.9
88;2021-09-15;424;971;285053;270338;79.3;75.2
88;2021-09-16;255;535;285308;270873;79.4;75.3
88;2021-09-17;432;1027;285740;271900;79.5;75.6
88;2021-09-18;233;679;285973;272579;79.5;75.8
88;2021-09-19;51;164;286024;272743;79.6;75.9
88;2021-09-20;222;564;286246;273307;79.6;76.0
88;2021-09-21;207;596;286453;273903;79.7;76.2
88;2021-09-22;206;779;286659;274682;79.7;76.4
88;2021-09-23;287;624;286946;275306;79.8;76.6
88;2021-09-24;280;801;287226;276107;79.9;76.8
88;2021-09-25;126;565;287352;276672;79.9;77.0
88;2021-09-26;18;159;287370;276831;79.9;77.0
88;2021-09-27;163;453;287533;277284;80.0;77.1
88;2021-09-28;175;523;287708;277807;80.0;77.3
88;2021-09-29;172;506;287880;278313;80.1;77.4
89;2020-12-27;0;0;0;0;0.0;0.0
89;2020-12-28;2;0;2;0;0.0;0.0
89;2020-12-29;0;0;2;0;0.0;0.0
89;2020-12-30;0;0;2;0;0.0;0.0
89;2020-12-31;0;0;2;0;0.0;0.0
89;2021-01-01;0;0;2;0;0.0;0.0
89;2021-01-02;0;0;2;0;0.0;0.0
89;2021-01-03;0;0;2;0;0.0;0.0
89;2021-01-04;0;0;2;0;0.0;0.0
89;2021-01-05;0;0;2;0;0.0;0.0
89;2021-01-06;48;0;50;0;0.0;0.0
89;2021-01-07;201;0;251;0;0.1;0.0
89;2021-01-08;48;0;299;0;0.1;0.0
89;2021-01-09;1;0;300;0;0.1;0.0
89;2021-01-10;0;0;300;0;0.1;0.0
89;2021-01-11;221;0;521;0;0.2;0.0
89;2021-01-12;349;0;870;0;0.3;0.0
89;2021-01-13;533;3;1403;3;0.4;0.0
89;2021-01-14;711;7;2114;10;0.6;0.0
89;2021-01-15;277;2;2391;12;0.7;0.0
89;2021-01-16;90;3;2481;15;0.7;0.0
89;2021-01-17;0;0;2481;15;0.7;0.0
89;2021-01-18;503;1;2984;16;0.9;0.0
89;2021-01-19;841;3;3825;19;1.2;0.0
89;2021-01-20;762;0;4587;19;1.4;0.0
89;2021-01-21;940;3;5527;22;1.7;0.0
89;2021-01-22;1020;1;6547;23;2.0;0.0
89;2021-01-23;200;0;6747;23;2.0;0.0
89;2021-01-24;107;0;6854;23;2.1;0.0
89;2021-01-25;483;3;7337;26;2.2;0.0
89;2021-01-26;582;13;7919;39;2.4;0.0
89;2021-01-27;473;37;8392;76;2.5;0.0
89;2021-01-28;551;123;8943;199;2.7;0.1
89;2021-01-29;958;39;9901;238;3.0;0.1
89;2021-01-30;184;13;10085;251;3.0;0.1
89;2021-01-31;24;1;10109;252;3.0;0.1
89;2021-02-01;255;138;10364;390;3.1;0.1
89;2021-02-02;283;312;10647;702;3.2;0.2
89;2021-02-03;292;318;10939;1020;3.3;0.3
89;2021-02-04;434;559;11373;1579;3.4;0.5
89;2021-02-05;387;178;11760;1757;3.5;0.5
89;2021-02-06;77;66;11837;1823;3.6;0.5
89;2021-02-07;0;0;11837;1823;3.6;0.5
89;2021-02-08;288;158;12125;1981;3.7;0.6
89;2021-02-09;284;397;12409;2378;3.7;0.7
89;2021-02-10;396;278;12805;2656;3.9;0.8
89;2021-02-11;332;526;13137;3182;4.0;1.0
89;2021-02-12;432;561;13569;3743;4.1;1.1
89;2021-02-13;51;122;13620;3865;4.1;1.2
89;2021-02-14;21;116;13641;3981;4.1;1.2
89;2021-02-15;218;306;13859;4287;4.2;1.3
89;2021-02-16;134;426;13993;4713;4.2;1.4
89;2021-02-17;263;334;14256;5047;4.3;1.5
89;2021-02-18;225;420;14481;5467;4.4;1.6
89;2021-02-19;245;568;14726;6035;4.4;1.8
89;2021-02-20;33;126;14759;6161;4.4;1.9
89;2021-02-21;0;10;14759;6171;4.4;1.9
89;2021-02-22;233;355;14992;6526;4.5;2.0
89;2021-02-23;170;383;15162;6909;4.6;2.1
89;2021-02-24;343;290;15505;7199;4.7;2.2
89;2021-02-25;370;371;15875;7570;4.8;2.3
89;2021-02-26;385;279;16260;7849;4.9;2.4
89;2021-02-27;138;62;16398;7911;4.9;2.4
89;2021-02-28;6;12;16404;7923;4.9;2.4
89;2021-03-01;541;198;16945;8121;5.1;2.4
89;2021-03-02;754;307;17699;8428;5.3;2.5
89;2021-03-03;647;231;18346;8659;5.5;2.6
89;2021-03-04;633;335;18979;8994;5.7;2.7
89;2021-03-05;728;455;19707;9449;5.9;2.8
89;2021-03-06;549;119;20256;9568;6.1;2.9
89;2021-03-07;288;40;20544;9608;6.2;2.9
89;2021-03-08;559;300;21103;9908;6.4;3.0
89;2021-03-09;1003;241;22106;10149;6.7;3.1
89;2021-03-10;984;232;23090;10381;7.0;3.1
89;2021-03-11;1076;284;24166;10665;7.3;3.2
89;2021-03-12;1280;308;25446;10973;7.7;3.3
89;2021-03-13;637;44;26083;11017;7.9;3.3
89;2021-03-14;1;0;26084;11017;7.9;3.3
89;2021-03-15;816;310;26900;11327;8.1;3.4
89;2021-03-16;948;217;27848;11544;8.4;3.5
89;2021-03-17;920;266;28768;11810;8.7;3.6
89;2021-03-18;885;253;29653;12063;8.9;3.6
89;2021-03-19;1149;196;30802;12259;9.3;3.7
89;2021-03-20;844;29;31646;12288;9.5;3.7
89;2021-03-21;173;6;31819;12294;9.6;3.7
89;2021-03-22;1044;221;32863;12515;9.9;3.8
89;2021-03-23;1744;257;34607;12772;10.4;3.8
89;2021-03-24;1968;324;36575;13096;11.0;3.9
89;2021-03-25;1821;170;38396;13266;11.6;4.0
89;2021-03-26;2628;184;41024;13450;12.4;4.1
89;2021-03-27;1775;48;42799;13498;12.9;4.1
89;2021-03-28;32;3;42831;13501;12.9;4.1
89;2021-03-29;965;570;43796;14071;13.2;4.2
89;2021-03-30;1155;568;44951;14639;13.5;4.4
89;2021-03-31;2005;471;46956;15110;14.1;4.5
89;2021-04-01;2121;459;49077;15569;14.8;4.7
89;2021-04-02;2140;446;51217;16015;15.4;4.8
89;2021-04-03;1004;243;52221;16258;15.7;4.9
89;2021-04-04;16;1;52237;16259;15.7;4.9
89;2021-04-05;92;2;52329;16261;15.8;4.9
89;2021-04-06;1032;754;53361;17015;16.1;5.1
89;2021-04-07;1027;799;54388;17814;16.4;5.4
89;2021-04-08;1731;728;56119;18542;16.9;5.6
89;2021-04-09;2164;767;58283;19309;17.6;5.8
89;2021-04-10;891;180;59174;19489;17.8;5.9
89;2021-04-11;38;51;59212;19540;17.8;5.9
89;2021-04-12;1010;791;60222;20331;18.1;6.1
89;2021-04-13;1356;1081;61578;21412;18.5;6.4
89;2021-04-14;1214;1036;62792;22448;18.9;6.8
89;2021-04-15;1412;942;64204;23390;19.3;7.0
89;2021-04-16;1330;939;65534;24329;19.7;7.3
89;2021-04-17;1070;455;66604;24784;20.1;7.5
89;2021-04-18;27;154;66631;24938;20.1;7.5
89;2021-04-19;748;1039;67379;25977;20.3;7.8
89;2021-04-20;1016;1533;68395;27510;20.6;8.3
89;2021-04-21;814;1100;69209;28610;20.8;8.6
89;2021-04-22;1106;1164;70315;29774;21.2;9.0
89;2021-04-23;1820;1964;72135;31738;21.7;9.6
89;2021-04-24;1173;1173;73308;32911;22.1;9.9
89;2021-04-25;139;6;73447;32917;22.1;9.9
89;2021-04-26;1503;775;74950;33692;22.6;10.1
89;2021-04-27;1733;1053;76683;34745;23.1;10.5
89;2021-04-28;1596;1854;78279;36599;23.6;11.0
89;2021-04-29;1970;1923;80249;38522;24.2;11.6
89;2021-04-30;1803;1767;82052;40289;24.7;12.1
89;2021-05-01;846;721;82898;41010;25.0;12.3
89;2021-05-02;134;31;83032;41041;25.0;12.4
89;2021-05-03;1606;762;84638;41803;25.5;12.6
89;2021-05-04;1619;1125;86257;42928;26.0;12.9
89;2021-05-05;2319;1265;88576;44193;26.7;13.3
89;2021-05-06;2411;1382;90987;45575;27.4;13.7
89;2021-05-07;2718;1313;93705;46888;28.2;14.1
89;2021-05-08;1787;534;95492;47422;28.8;14.3
89;2021-05-09;196;18;95688;47440;28.8;14.3
89;2021-05-10;1201;960;96889;48400;29.2;14.6
89;2021-05-11;2491;1463;99380;49863;29.9;15.0
89;2021-05-12;2058;1215;101438;51078;30.5;15.4
89;2021-05-13;415;332;101853;51410;30.7;15.5
89;2021-05-14;1880;1095;103733;52505;31.2;15.8
89;2021-05-15;2247;394;105980;52899;31.9;15.9
89;2021-05-16;10;35;105990;52934;31.9;15.9
89;2021-05-17;2091;635;108081;53569;32.5;16.1
89;2021-05-18;2324;830;110405;54399;33.2;16.4
89;2021-05-19;2861;882;113266;55281;34.1;16.6
89;2021-05-20;2927;887;116193;56168;35.0;16.9
89;2021-05-21;2481;877;118674;57045;35.7;17.2
89;2021-05-22;1430;560;120104;57605;36.2;17.3
89;2021-05-23;108;10;120212;57615;36.2;17.3
89;2021-05-24;288;226;120500;57841;36.3;17.4
89;2021-05-25;1558;982;122058;58823;36.8;17.7
89;2021-05-26;1815;1024;123873;59847;37.3;18.0
89;2021-05-27;2118;1358;125991;61205;37.9;18.4
89;2021-05-28;2143;1418;128134;62623;38.6;18.9
89;2021-05-29;541;658;128675;63281;38.7;19.1
89;2021-05-30;25;22;128700;63303;38.8;19.1
89;2021-05-31;1248;971;129948;64274;39.1;19.4
89;2021-06-01;1505;979;131453;65253;39.6;19.6
89;2021-06-02;1946;1278;133399;66531;40.2;20.0
89;2021-06-03;2428;1522;135827;68053;40.9;20.5
89;2021-06-04;2140;1884;137967;69937;41.5;21.1
89;2021-06-05;1185;1223;139152;71160;41.9;21.4
89;2021-06-06;23;37;139175;71197;41.9;21.4
89;2021-06-07;2107;1448;141282;72645;42.5;21.9
89;2021-06-08;2194;1447;143476;74092;43.2;22.3
89;2021-06-09;2321;1509;145797;75601;43.9;22.8
89;2021-06-10;2790;1598;148587;77199;44.7;23.2
89;2021-06-11;1950;1746;150537;78945;45.3;23.8
89;2021-06-12;1103;757;151640;79702;45.7;24.0
89;2021-06-13;156;417;151796;80119;45.7;24.1
89;2021-06-14;1311;1825;153107;81944;46.1;24.7
89;2021-06-15;1401;2011;154508;83955;46.5;25.3
89;2021-06-16;1129;2583;155637;86538;46.9;26.1
89;2021-06-17;1432;2335;157069;88873;47.3;26.8
89;2021-06-18;1623;2877;158692;91750;47.8;27.6
89;2021-06-19;686;1660;159378;93410;48.0;28.1
89;2021-06-20;55;125;159433;93535;48.0;28.2
89;2021-06-21;758;1528;160191;95063;48.2;28.6
89;2021-06-22;1049;2679;161240;97742;48.6;29.4
89;2021-06-23;1154;1797;162394;99539;48.9;30.0
89;2021-06-24;1077;1497;163471;101036;49.2;30.4
89;2021-06-25;1008;2425;164479;103461;49.5;31.2
89;2021-06-26;560;2482;165039;105943;49.7;31.9
89;2021-06-27;14;28;165053;105971;49.7;31.9
89;2021-06-28;1033;2494;166086;108465;50.0;32.7
89;2021-06-29;691;2403;166777;110868;50.2;33.4
89;2021-06-30;1083;3182;167860;114050;50.5;34.3
89;2021-07-01;1022;2989;168882;117039;50.9;35.2
89;2021-07-02;1107;2748;169989;119787;51.2;36.1
89;2021-07-03;554;1574;170543;121361;51.4;36.5
89;2021-07-04;11;36;170554;121397;51.4;36.6
89;2021-07-05;1295;1838;171849;123235;51.7;37.1
89;2021-07-06;1051;2312;172900;125547;52.1;37.8
89;2021-07-07;666;1787;173566;127334;52.3;38.3
89;2021-07-08;793;1873;174359;129207;52.5;38.9
89;2021-07-09;1140;2606;175499;131813;52.8;39.7
89;2021-07-10;719;816;176218;132629;53.1;39.9
89;2021-07-11;26;39;176244;132668;53.1;39.9
89;2021-07-12;1422;1899;177666;134567;53.5;40.5
89;2021-07-13;2136;2745;179802;137312;54.1;41.3
89;2021-07-14;314;324;180116;137636;54.2;41.4
89;2021-07-15;2246;3156;182362;140792;54.9;42.4
89;2021-07-16;2389;2863;184751;143655;55.6;43.3
89;2021-07-17;1235;1229;185986;144884;56.0;43.6
89;2021-07-18;277;97;186263;144981;56.1;43.7
89;2021-07-19;1566;2811;187829;147792;56.6;44.5
89;2021-07-20;1927;3283;189756;151075;57.1;45.5
89;2021-07-21;2080;2725;191836;153800;57.8;46.3
89;2021-07-22;2476;2992;194312;156792;58.5;47.2
89;2021-07-23;2473;3105;196785;159897;59.3;48.1
89;2021-07-24;1241;1247;198026;161144;59.6;48.5
89;2021-07-25;69;185;198095;161329;59.6;48.6
89;2021-07-26;1719;2322;199814;163651;60.2;49.3
89;2021-07-27;2345;1911;202159;165562;60.9;49.9
89;2021-07-28;2538;1339;204697;166901;61.6;50.3
89;2021-07-29;2525;1621;207222;168522;62.4;50.7
89;2021-07-30;2678;1625;209900;170147;63.2;51.2
89;2021-07-31;1121;1073;211021;171220;63.5;51.6
89;2021-08-01;69;31;211090;171251;63.6;51.6
89;2021-08-02;1792;1287;212882;172538;64.1;52.0
89;2021-08-03;2492;1254;215374;173792;64.9;52.3
89;2021-08-04;1528;1641;216902;175433;65.3;52.8
89;2021-08-05;1534;1692;218436;177125;65.8;53.3
89;2021-08-06;2175;1651;220611;178776;66.4;53.8
89;2021-08-07;929;1097;221540;179873;66.7;54.2
89;2021-08-08;56;48;221596;179921;66.7;54.2
89;2021-08-09;1106;1175;222702;181096;67.1;54.5
89;2021-08-10;1800;1816;224502;182912;67.6;55.1
89;2021-08-11;1536;1584;226038;184496;68.1;55.6
89;2021-08-12;1364;1390;227402;185886;68.5;56.0
89;2021-08-13;1280;1951;228682;187837;68.9;56.6
89;2021-08-14;526;1024;229208;188861;69.0;56.9
89;2021-08-15;20;43;229228;188904;69.0;56.9
89;2021-08-16;1022;1968;230250;190872;69.3;57.5
89;2021-08-17;846;1572;231096;192444;69.6;57.9
89;2021-08-18;631;1897;231727;194341;69.8;58.5
89;2021-08-19;679;1387;232406;195728;70.0;58.9
89;2021-08-20;1031;2263;233437;197991;70.3;59.6
89;2021-08-21;297;1003;233734;198994;70.4;59.9
89;2021-08-22;32;34;233766;199028;70.4;59.9
89;2021-08-23;767;2252;234533;201280;70.6;60.6
89;2021-08-24;854;2365;235387;203645;70.9;61.3
89;2021-08-25;584;1429;235971;205074;71.1;61.8
89;2021-08-26;609;2053;236580;207127;71.2;62.4
89;2021-08-27;843;2263;237423;209390;71.5;63.1
89;2021-08-28;362;1303;237785;210693;71.6;63.4
89;2021-08-29;30;70;237815;210763;71.6;63.5
89;2021-08-30;643;2234;238458;212997;71.8;64.1
89;2021-08-31;599;1625;239057;214622;72.0;64.6
89;2021-09-01;512;1373;239569;215995;72.1;65.0
89;2021-09-02;434;1457;240003;217452;72.3;65.5
89;2021-09-03;578;2090;240581;219542;72.4;66.1
89;2021-09-04;494;996;241075;220538;72.6;66.4
89;2021-09-05;21;18;241096;220556;72.6;66.4
89;2021-09-06;417;1857;241513;222413;72.7;67.0
89;2021-09-07;353;1146;241866;223559;72.8;67.3
89;2021-09-08;328;1013;242194;224572;72.9;67.6
89;2021-09-09;268;960;242462;225532;73.0;67.9
89;2021-09-10;460;1558;242922;227090;73.1;68.4
89;2021-09-11;272;823;243194;227913;73.2;68.6
89;2021-09-12;11;45;243205;227958;73.2;68.6
89;2021-09-13;381;1286;243586;229244;73.3;69.0
89;2021-09-14;369;842;243955;230086;73.5;69.3
89;2021-09-15;229;694;244184;230780;73.5;69.5
89;2021-09-16;242;567;244426;231347;73.6;69.7
89;2021-09-17;495;1115;244921;232462;73.8;70.0
89;2021-09-18;177;743;245098;233205;73.8;70.2
89;2021-09-19;4;17;245102;233222;73.8;70.2
89;2021-09-20;247;723;245349;233945;73.9;70.4
89;2021-09-21;292;478;245641;234423;74.0;70.6
89;2021-09-22;195;575;245836;234998;74.0;70.8
89;2021-09-23;222;464;246058;235462;74.1;70.9
89;2021-09-24;299;866;246357;236328;74.2;71.2
89;2021-09-25;107;464;246464;236792;74.2;71.3
89;2021-09-26;3;19;246467;236811;74.2;71.3
89;2021-09-27;190;502;246657;237313;74.3;71.5
89;2021-09-28;231;399;246888;237712;74.3;71.6
89;2021-09-29;166;422;247054;238134;74.4;71.7
90;2020-12-27;0;0;0;0;0.0;0.0
90;2020-12-28;0;0;0;0;0.0;0.0
90;2020-12-29;0;0;0;0;0.0;0.0
90;2020-12-30;1;0;1;0;0.0;0.0
90;2020-12-31;0;0;1;0;0.0;0.0
90;2021-01-01;0;0;1;0;0.0;0.0
90;2021-01-02;1;0;2;0;0.0;0.0
90;2021-01-03;0;0;2;0;0.0;0.0
90;2021-01-04;2;0;4;0;0.0;0.0
90;2021-01-05;0;0;4;0;0.0;0.0
90;2021-01-06;0;0;4;0;0.0;0.0
90;2021-01-07;1;0;5;0;0.0;0.0
90;2021-01-08;170;0;175;0;0.1;0.0
90;2021-01-09;46;0;221;0;0.2;0.0
90;2021-01-10;0;0;221;0;0.2;0.0
90;2021-01-11;200;0;421;0;0.3;0.0
90;2021-01-12;431;1;852;1;0.6;0.0
90;2021-01-13;467;2;1319;3;0.9;0.0
90;2021-01-14;414;2;1733;5;1.2;0.0
90;2021-01-15;404;8;2137;13;1.5;0.0
90;2021-01-16;111;2;2248;15;1.6;0.0
90;2021-01-17;1;0;2249;15;1.6;0.0
90;2021-01-18;365;2;2614;17;1.9;0.0
90;2021-01-19;462;4;3076;21;2.2;0.0
90;2021-01-20;393;2;3469;23;2.5;0.0
90;2021-01-21;351;1;3820;24;2.7;0.0
90;2021-01-22;345;2;4165;26;3.0;0.0
90;2021-01-23;98;0;4263;26;3.0;0.0
90;2021-01-24;0;0;4263;26;3.0;0.0
90;2021-01-25;322;1;4585;27;3.3;0.0
90;2021-01-26;224;0;4809;27;3.4;0.0
90;2021-01-27;254;0;5063;27;3.6;0.0
90;2021-01-28;328;29;5391;56;3.8;0.0
90;2021-01-29;291;155;5682;211;4.1;0.2
90;2021-01-30;176;40;5858;251;4.2;0.2
90;2021-01-31;118;0;5976;251;4.3;0.2
90;2021-02-01;275;103;6251;354;4.5;0.3
90;2021-02-02;290;151;6541;505;4.7;0.4
90;2021-02-03;256;242;6797;747;4.8;0.5
90;2021-02-04;257;293;7054;1040;5.0;0.7
90;2021-02-05;266;262;7320;1302;5.2;0.9
90;2021-02-06;89;59;7409;1361;5.3;1.0
90;2021-02-07;0;0;7409;1361;5.3;1.0
90;2021-02-08;170;205;7579;1566;5.4;1.1
90;2021-02-09;139;157;7718;1723;5.5;1.2
90;2021-02-10;182;27;7900;1750;5.6;1.2
90;2021-02-11;229;95;8129;1845;5.8;1.3
90;2021-02-12;126;231;8255;2076;5.9;1.5
90;2021-02-13;96;40;8351;2116;6.0;1.5
90;2021-02-14;0;0;8351;2116;6.0;1.5
90;2021-02-15;112;244;8463;2360;6.0;1.7
90;2021-02-16;92;249;8555;2609;6.1;1.9
90;2021-02-17;178;169;8733;2778;6.2;2.0
90;2021-02-18;128;198;8861;2976;6.3;2.1
90;2021-02-19;64;211;8925;3187;6.4;2.3
90;2021-02-20;40;62;8965;3249;6.4;2.3
90;2021-02-21;0;0;8965;3249;6.4;2.3
90;2021-02-22;77;270;9042;3519;6.5;2.5
90;2021-02-23;40;197;9082;3716;6.5;2.7
90;2021-02-24;109;251;9191;3967;6.6;2.8
90;2021-02-25;89;254;9280;4221;6.6;3.0
90;2021-02-26;89;335;9369;4556;6.7;3.3
90;2021-02-27;140;146;9509;4702;6.8;3.4
90;2021-02-28;8;98;9517;4800;6.8;3.4
90;2021-03-01;211;205;9728;5005;6.9;3.6
90;2021-03-02;178;247;9906;5252;7.1;3.7
90;2021-03-03;239;323;10145;5575;7.2;4.0
90;2021-03-04;260;255;10405;5830;7.4;4.2
90;2021-03-05;359;252;10764;6082;7.7;4.3
90;2021-03-06;291;97;11055;6179;7.9;4.4
90;2021-03-07;18;1;11073;6180;7.9;4.4
90;2021-03-08;246;224;11319;6404;8.1;4.6
90;2021-03-09;430;154;11749;6558;8.4;4.7
90;2021-03-10;348;193;12097;6751;8.6;4.8
90;2021-03-11;347;116;12444;6867;8.9;4.9
90;2021-03-12;519;129;12963;6996;9.2;5.0
90;2021-03-13;539;48;13502;7044;9.6;5.0
90;2021-03-14;21;0;13523;7044;9.6;5.0
90;2021-03-15;388;117;13911;7161;9.9;5.1
90;2021-03-16;402;101;14313;7262;10.2;5.2
90;2021-03-17;323;76;14636;7338;10.4;5.2
90;2021-03-18;348;78;14984;7416;10.7;5.3
90;2021-03-19;468;78;15452;7494;11.0;5.3
90;2021-03-20;427;48;15879;7542;11.3;5.4
90;2021-03-21;7;1;15886;7543;11.3;5.4
90;2021-03-22;399;30;16285;7573;11.6;5.4
90;2021-03-23;740;77;17025;7650;12.1;5.5
90;2021-03-24;817;46;17842;7696;12.7;5.5
90;2021-03-25;949;75;18791;7771;13.4;5.5
90;2021-03-26;1226;62;20017;7833;14.3;5.6
90;2021-03-27;439;34;20456;7867;14.6;5.6
90;2021-03-28;34;0;20490;7867;14.6;5.6
90;2021-03-29;712;142;21202;8009;15.1;5.7
90;2021-03-30;675;155;21877;8164;15.6;5.8
90;2021-03-31;728;85;22605;8249;16.1;5.9
90;2021-04-01;602;123;23207;8372;16.6;6.0
90;2021-04-02;657;98;23864;8470;17.0;6.0
90;2021-04-03;370;40;24234;8510;17.3;6.1
90;2021-04-04;1;0;24235;8510;17.3;6.1
90;2021-04-05;0;0;24235;8510;17.3;6.1
90;2021-04-06;529;250;24764;8760;17.7;6.3
90;2021-04-07;485;267;25249;9027;18.0;6.4
90;2021-04-08;510;246;25759;9273;18.4;6.6
90;2021-04-09;751;266;26510;9539;18.9;6.8
90;2021-04-10;224;8;26734;9547;19.1;6.8
90;2021-04-11;7;0;26741;9547;19.1;6.8
90;2021-04-12;557;480;27298;10027;19.5;7.2
90;2021-04-13;632;531;27930;10558;19.9;7.5
90;2021-04-14;526;351;28456;10909;20.3;7.8
90;2021-04-15;905;291;29361;11200;21.0;8.0
90;2021-04-16;370;404;29731;11604;21.2;8.3
90;2021-04-17;189;128;29920;11732;21.3;8.4
90;2021-04-18;21;0;29941;11732;21.4;8.4
90;2021-04-19;435;572;30376;12304;21.7;8.8
90;2021-04-20;493;617;30869;12921;22.0;9.2
90;2021-04-21;353;497;31222;13418;22.3;9.6
90;2021-04-22;569;602;31791;14020;22.7;10.0
90;2021-04-23;504;742;32295;14762;23.0;10.5
90;2021-04-24;305;202;32600;14964;23.3;10.7
90;2021-04-25;1;0;32601;14964;23.3;10.7
90;2021-04-26;509;750;33110;15714;23.6;11.2
90;2021-04-27;640;680;33750;16394;24.1;11.7
90;2021-04-28;765;445;34515;16839;24.6;12.0
90;2021-04-29;1003;449;35518;17288;25.3;12.3
90;2021-04-30;1120;460;36638;17748;26.1;12.7
90;2021-05-01;60;42;36698;17790;26.2;12.7
90;2021-05-02;4;0;36702;17790;26.2;12.7
90;2021-05-03;903;285;37605;18075;26.8;12.9
90;2021-05-04;784;637;38389;18712;27.4;13.4
90;2021-05-05;891;504;39280;19216;28.0;13.7
90;2021-05-06;851;626;40131;19842;28.6;14.2
90;2021-05-07;440;507;40571;20349;28.9;14.5
90;2021-05-08;26;27;40597;20376;29.0;14.5
90;2021-05-09;5;33;40602;20409;29.0;14.6
90;2021-05-10;506;581;41108;20990;29.3;15.0
90;2021-05-11;778;638;41886;21628;29.9;15.4
90;2021-05-12;531;598;42417;22226;30.3;15.9
90;2021-05-13;1113;265;43530;22491;31.1;16.0
90;2021-05-14;865;403;44395;22894;31.7;16.3
90;2021-05-15;14;125;44409;23019;31.7;16.4
90;2021-05-16;2;7;44411;23026;31.7;16.4
90;2021-05-17;792;290;45203;23316;32.3;16.6
90;2021-05-18;1024;472;46227;23788;33.0;17.0
90;2021-05-19;1264;384;47491;24172;33.9;17.2
90;2021-05-20;1201;270;48692;24442;34.7;17.4
90;2021-05-21;1264;434;49956;24876;35.6;17.8
90;2021-05-22;9;131;49965;25007;35.7;17.8
90;2021-05-23;4;0;49969;25007;35.7;17.8
90;2021-05-24;368;265;50337;25272;35.9;18.0
90;2021-05-25;635;791;50972;26063;36.4;18.6
90;2021-05-26;630;569;51602;26632;36.8;19.0
90;2021-05-27;962;380;52564;27012;37.5;19.3
90;2021-05-28;668;827;53232;27839;38.0;19.9
90;2021-05-29;93;296;53325;28135;38.0;20.1
90;2021-05-30;4;1;53329;28136;38.1;20.1
90;2021-05-31;808;713;54137;28849;38.6;20.6
90;2021-06-01;969;739;55106;29588;39.3;21.1
90;2021-06-02;760;676;55866;30264;39.9;21.6
90;2021-06-03;758;744;56624;31008;40.4;22.1
90;2021-06-04;833;971;57457;31979;41.0;22.8
90;2021-06-05;54;427;57511;32406;41.0;23.1
90;2021-06-06;1;16;57512;32422;41.0;23.1
90;2021-06-07;1265;1081;58777;33503;41.9;23.9
90;2021-06-08;1482;939;60259;34442;43.0;24.6
90;2021-06-09;964;659;61223;35101;43.7;25.0
90;2021-06-10;627;498;61850;35599;44.1;25.4
90;2021-06-11;787;1126;62637;36725;44.7;26.2
90;2021-06-12;806;297;63443;37022;45.3;26.4
90;2021-06-13;10;12;63453;37034;45.3;26.4
90;2021-06-14;264;972;63717;38006;45.5;27.1
90;2021-06-15;566;882;64283;38888;45.9;27.7
90;2021-06-16;509;548;64792;39436;46.2;28.1
90;2021-06-17;443;638;65235;40074;46.5;28.6
90;2021-06-18;623;997;65858;41071;47.0;29.3
90;2021-06-19;450;170;66308;41241;47.3;29.4
90;2021-06-20;0;28;66308;41269;47.3;29.4
90;2021-06-21;256;1176;66564;42445;47.5;30.3
90;2021-06-22;384;950;66948;43395;47.8;31.0
90;2021-06-23;415;633;67363;44028;48.1;31.4
90;2021-06-24;317;599;67680;44627;48.3;31.8
90;2021-06-25;431;1270;68111;45897;48.6;32.7
90;2021-06-26;420;561;68531;46458;48.9;33.1
90;2021-06-27;2;6;68533;46464;48.9;33.2
90;2021-06-28;379;1298;68912;47762;49.2;34.1
90;2021-06-29;305;1305;69217;49067;49.4;35.0
90;2021-06-30;485;1227;69702;50294;49.7;35.9
90;2021-07-01;355;920;70057;51214;50.0;36.5
90;2021-07-02;506;1205;70563;52419;50.3;37.4
90;2021-07-03;52;129;70615;52548;50.4;37.5
90;2021-07-04;0;21;70615;52569;50.4;37.5
90;2021-07-05;400;1014;71015;53583;50.7;38.2
90;2021-07-06;514;971;71529;54554;51.0;38.9
90;2021-07-07;381;998;71910;55552;51.3;39.6
90;2021-07-08;304;607;72214;56159;51.5;40.1
90;2021-07-09;439;949;72653;57108;51.8;40.7
90;2021-07-10;32;91;72685;57199;51.9;40.8
90;2021-07-11;7;17;72692;57216;51.9;40.8
90;2021-07-12;246;1074;72938;58290;52.0;41.6
90;2021-07-13;474;1162;73412;59452;52.4;42.4
90;2021-07-14;4;9;73416;59461;52.4;42.4
90;2021-07-15;789;1455;74205;60916;52.9;43.5
90;2021-07-16;826;1681;75031;62597;53.5;44.7
90;2021-07-17;484;955;75515;63552;53.9;45.3
90;2021-07-18;4;2;75519;63554;53.9;45.3
90;2021-07-19;1186;1460;76705;65014;54.7;46.4
90;2021-07-20;1339;1135;78044;66149;55.7;47.2
90;2021-07-21;1395;983;79439;67132;56.7;47.9
90;2021-07-22;1127;697;80566;67829;57.5;48.4
90;2021-07-23;968;1020;81534;68849;58.2;49.1
90;2021-07-24;121;66;81655;68915;58.3;49.2
90;2021-07-25;2;1;81657;68916;58.3;49.2
90;2021-07-26;1072;801;82729;69717;59.0;49.7
90;2021-07-27;1081;746;83810;70463;59.8;50.3
90;2021-07-28;825;712;84635;71175;60.4;50.8
90;2021-07-29;843;441;85478;71616;61.0;51.1
90;2021-07-30;786;506;86264;72122;61.6;51.5
90;2021-07-31;484;313;86748;72435;61.9;51.7
90;2021-08-01;0;3;86748;72438;61.9;51.7
90;2021-08-02;850;510;87598;72948;62.5;52.1
90;2021-08-03;929;494;88527;73442;63.2;52.4
90;2021-08-04;1067;460;89594;73902;63.9;52.7
90;2021-08-05;521;223;90115;74125;64.3;52.9
90;2021-08-06;649;388;90764;74513;64.8;53.2
90;2021-08-07;36;63;90800;74576;64.8;53.2
90;2021-08-08;18;3;90818;74579;64.8;53.2
90;2021-08-09;730;947;91548;75526;65.3;53.9
90;2021-08-10;536;1152;92084;76678;65.7;54.7
90;2021-08-11;537;948;92621;77626;66.1;55.4
90;2021-08-12;449;820;93070;78446;66.4;56.0
90;2021-08-13;544;898;93614;79344;66.8;56.6
90;2021-08-14;30;98;93644;79442;66.8;56.7
90;2021-08-15;2;7;93646;79449;66.8;56.7
90;2021-08-16;451;632;94097;80081;67.1;57.1
90;2021-08-17;347;1167;94444;81248;67.4;58.0
90;2021-08-18;274;880;94718;82128;67.6;58.6
90;2021-08-19;248;627;94966;82755;67.8;59.0
90;2021-08-20;359;771;95325;83526;68.0;59.6
90;2021-08-21;32;71;95357;83597;68.0;59.7
90;2021-08-22;0;7;95357;83604;68.0;59.7
90;2021-08-23;308;489;95665;84093;68.3;60.0
90;2021-08-24;334;958;95999;85051;68.5;60.7
90;2021-08-25;250;915;96249;85966;68.7;61.3
90;2021-08-26;243;675;96492;86641;68.9;61.8
90;2021-08-27;270;737;96762;87378;69.0;62.3
90;2021-08-28;21;64;96783;87442;69.1;62.4
90;2021-08-29;3;6;96786;87448;69.1;62.4
90;2021-08-30;319;639;97105;88087;69.3;62.9
90;2021-08-31;276;1021;97381;89108;69.5;63.6
90;2021-09-01;267;787;97648;89895;69.7;64.1
90;2021-09-02;159;408;97807;90303;69.8;64.4
90;2021-09-03;222;533;98029;90836;69.9;64.8
90;2021-09-04;55;157;98084;90993;70.0;64.9
90;2021-09-05;9;25;98093;91018;70.0;64.9
90;2021-09-06;134;741;98227;91759;70.1;65.5
90;2021-09-07;220;675;98447;92434;70.2;66.0
90;2021-09-08;223;654;98670;93088;70.4;66.4
90;2021-09-09;187;321;98857;93409;70.5;66.7
90;2021-09-10;188;551;99045;93960;70.7;67.0
90;2021-09-11;12;12;99057;93972;70.7;67.1
90;2021-09-12;0;7;99057;93979;70.7;67.1
90;2021-09-13;211;513;99268;94492;70.8;67.4
90;2021-09-14;156;453;99424;94945;70.9;67.7
90;2021-09-15;182;392;99606;95337;71.1;68.0
90;2021-09-16;154;238;99760;95575;71.2;68.2
90;2021-09-17;183;340;99943;95915;71.3;68.4
90;2021-09-18;17;24;99960;95939;71.3;68.5
90;2021-09-19;7;4;99967;95943;71.3;68.5
90;2021-09-20;153;250;100120;96193;71.4;68.6
90;2021-09-21;105;247;100225;96440;71.5;68.8
90;2021-09-22;102;353;100327;96793;71.6;69.1
90;2021-09-23;80;137;100407;96930;71.6;69.2
90;2021-09-24;102;285;100509;97215;71.7;69.4
90;2021-09-25;16;31;100525;97246;71.7;69.4
90;2021-09-26;0;7;100525;97253;71.7;69.4
90;2021-09-27;93;199;100618;97452;71.8;69.5
90;2021-09-28;90;140;100708;97592;71.9;69.6
90;2021-09-29;79;235;100787;97827;71.9;69.8
91;2020-12-27;0;0;0;0;0.0;0.0
91;2020-12-28;0;0;0;0;0.0;0.0
91;2020-12-29;1;0;1;0;0.0;0.0
91;2020-12-30;1;0;2;0;0.0;0.0
91;2020-12-31;0;0;2;0;0.0;0.0
91;2021-01-01;5;0;7;0;0.0;0.0
91;2021-01-02;0;0;7;0;0.0;0.0
91;2021-01-03;0;0;7;0;0.0;0.0
91;2021-01-04;1;0;8;0;0.0;0.0
91;2021-01-05;71;0;79;0;0.0;0.0
91;2021-01-06;188;2;267;2;0.0;0.0
91;2021-01-07;522;6;789;8;0.1;0.0
91;2021-01-08;394;1;1183;9;0.1;0.0
91;2021-01-09;89;2;1272;11;0.1;0.0
91;2021-01-10;1;0;1273;11;0.1;0.0
91;2021-01-11;595;2;1868;13;0.1;0.0
91;2021-01-12;899;8;2767;21;0.2;0.0
91;2021-01-13;703;7;3470;28;0.3;0.0
91;2021-01-14;721;11;4191;39;0.3;0.0
91;2021-01-15;569;4;4760;43;0.4;0.0
91;2021-01-16;316;7;5076;50;0.4;0.0
91;2021-01-17;118;1;5194;51;0.4;0.0
91;2021-01-18;991;3;6185;54;0.5;0.0
91;2021-01-19;1876;12;8061;66;0.6;0.0
91;2021-01-20;2377;17;10438;83;0.8;0.0
91;2021-01-21;2109;16;12547;99;1.0;0.0
91;2021-01-22;1862;10;14409;109;1.1;0.0
91;2021-01-23;413;1;14822;110;1.1;0.0
91;2021-01-24;53;0;14875;110;1.1;0.0
91;2021-01-25;1049;3;15924;113;1.2;0.0
91;2021-01-26;1577;35;17501;148;1.3;0.0
91;2021-01-27;2423;90;19924;238;1.5;0.0
91;2021-01-28;1987;175;21911;413;1.7;0.0
91;2021-01-29;1748;60;23659;473;1.8;0.0
91;2021-01-30;422;6;24081;479;1.8;0.0
91;2021-01-31;54;0;24135;479;1.8;0.0
91;2021-02-01;965;213;25100;692;1.9;0.1
91;2021-02-02;859;346;25959;1038;2.0;0.1
91;2021-02-03;938;541;26897;1579;2.0;0.1
91;2021-02-04;885;267;27782;1846;2.1;0.1
91;2021-02-05;1037;330;28819;2176;2.2;0.2
91;2021-02-06;340;83;29159;2259;2.2;0.2
91;2021-02-07;14;0;29173;2259;2.2;0.2
91;2021-02-08;905;532;30078;2791;2.3;0.2
91;2021-02-09;963;700;31041;3491;2.4;0.3
91;2021-02-10;1065;935;32106;4426;2.4;0.3
91;2021-02-11;1124;939;33230;5365;2.5;0.4
91;2021-02-12;1064;744;34294;6109;2.6;0.5
91;2021-02-13;332;317;34626;6426;2.6;0.5
91;2021-02-14;18;102;34644;6528;2.6;0.5
91;2021-02-15;368;887;35012;7415;2.7;0.6
91;2021-02-16;555;1426;35567;8841;2.7;0.7
91;2021-02-17;814;2257;36381;11098;2.8;0.8
91;2021-02-18;942;1718;37323;12816;2.8;1.0
91;2021-02-19;872;1143;38195;13959;2.9;1.1
91;2021-02-20;167;256;38362;14215;2.9;1.1
91;2021-02-21;13;39;38375;14254;2.9;1.1
91;2021-02-22;334;896;38709;15150;2.9;1.1
91;2021-02-23;398;833;39107;15983;3.0;1.2
91;2021-02-24;473;819;39580;16802;3.0;1.3
91;2021-02-25;735;803;40315;17605;3.1;1.3
91;2021-02-26;1096;832;41411;18437;3.1;1.4
91;2021-02-27;612;244;42023;18681;3.2;1.4
91;2021-02-28;65;59;42088;18740;3.2;1.4
91;2021-03-01;932;846;43020;19586;3.3;1.5
91;2021-03-02;1260;919;44280;20505;3.4;1.6
91;2021-03-03;1467;1101;45747;21606;3.5;1.6
91;2021-03-04;2435;1006;48182;22612;3.7;1.7
91;2021-03-05;3354;993;51536;23605;3.9;1.8
91;2021-03-06;4912;409;56448;24014;4.3;1.8
91;2021-03-07;3208;117;59656;24131;4.5;1.8
91;2021-03-08;1474;913;61130;25044;4.6;1.9
91;2021-03-09;2625;882;63755;25926;4.8;2.0
91;2021-03-10;2624;957;66379;26883;5.0;2.0
91;2021-03-11;3786;1064;70165;27947;5.3;2.1
91;2021-03-12;4792;989;74957;28936;5.7;2.2
91;2021-03-13;5258;330;80215;29266;6.1;2.2
91;2021-03-14;304;28;80519;29294;6.1;2.2
91;2021-03-15;2985;425;83504;29719;6.3;2.3
91;2021-03-16;2617;376;86121;30095;6.5;2.3
91;2021-03-17;2227;342;88348;30437;6.7;2.3
91;2021-03-18;2394;407;90742;30844;6.9;2.3
91;2021-03-19;4093;383;94835;31227;7.2;2.4
91;2021-03-20;3608;180;98443;31407;7.5;2.4
91;2021-03-21;138;21;98581;31428;7.5;2.4
91;2021-03-22;3148;592;101729;32020;7.7;2.4
91;2021-03-23;4139;685;105868;32705;8.0;2.5
91;2021-03-24;3937;495;109805;33200;8.3;2.5
91;2021-03-25;5059;523;114864;33723;8.7;2.6
91;2021-03-26;5550;550;120414;34273;9.1;2.6
91;2021-03-27;4982;343;125396;34616;9.5;2.6
91;2021-03-28;282;57;125678;34673;9.5;2.6
91;2021-03-29;3305;1023;128983;35696;9.8;2.7
91;2021-03-30;4426;1214;133409;36910;10.1;2.8
91;2021-03-31;3368;1328;136777;38238;10.4;2.9
91;2021-04-01;3740;1684;140517;39922;10.7;3.0
91;2021-04-02;3887;2309;144404;42231;10.9;3.2
91;2021-04-03;1874;2856;146278;45087;11.1;3.4
91;2021-04-04;647;1319;146925;46406;11.1;3.5
91;2021-04-05;562;132;147487;46538;11.2;3.5
91;2021-04-06;3403;1779;150890;48317;11.4;3.7
91;2021-04-07;3422;1926;154312;50243;11.7;3.8
91;2021-04-08;4665;2154;158977;52397;12.0;4.0
91;2021-04-09;5349;2161;164326;54558;12.5;4.1
91;2021-04-10;2733;2807;167059;57365;12.7;4.3
91;2021-04-11;191;141;167250;57506;12.7;4.4
91;2021-04-12;2854;2278;170104;59784;12.9;4.5
91;2021-04-13;3758;2643;173862;62427;13.2;4.7
91;2021-04-14;3706;2319;177568;64746;13.5;4.9
91;2021-04-15;4475;2516;182043;67262;13.8;5.1
91;2021-04-16;4548;2801;186591;70063;14.1;5.3
91;2021-04-17;2983;2071;189574;72134;14.4;5.5
91;2021-04-18;269;73;189843;72207;14.4;5.5
91;2021-04-19;2306;2731;192149;74938;14.6;5.7
91;2021-04-20;3178;2978;195327;77916;14.8;5.9
91;2021-04-21;2990;2894;198317;80810;15.0;6.1
91;2021-04-22;3170;3364;201487;84174;15.3;6.4
91;2021-04-23;3717;3329;205204;87503;15.6;6.6
91;2021-04-24;3480;3732;208684;91235;15.8;6.9
91;2021-04-25;2618;643;211302;91878;16.0;7.0
91;2021-04-26;3485;2799;214787;94677;16.3;7.2
91;2021-04-27;4486;2921;219273;97598;16.6;7.4
91;2021-04-28;4569;2693;223842;100291;17.0;7.6
91;2021-04-29;5744;3056;229586;103347;17.4;7.8
91;2021-04-30;5385;2846;234971;106193;17.8;8.0
91;2021-05-01;3517;520;238488;106713;18.1;8.1
91;2021-05-02;628;131;239116;106844;18.1;8.1
91;2021-05-03;5202;2288;244318;109132;18.5;8.3
91;2021-05-04;5589;3170;249907;112302;18.9;8.5
91;2021-05-05;4851;2873;254758;115175;19.3;8.7
91;2021-05-06;5247;3373;260005;118548;19.7;9.0
91;2021-05-07;6122;3740;266127;122288;20.2;9.3
91;2021-05-08;6518;965;272645;123253;20.7;9.3
91;2021-05-09;4804;564;277449;123817;21.0;9.4
91;2021-05-10;5901;3002;283350;126819;21.5;9.6
91;2021-05-11;6826;3833;290176;130652;22.0;9.9
91;2021-05-12;5895;3440;296071;134092;22.4;10.2
91;2021-05-13;4825;1082;300896;135174;22.8;10.2
91;2021-05-14;6549;2395;307445;137569;23.3;10.4
91;2021-05-15;7792;1929;315237;139498;23.9;10.6
91;2021-05-16;4583;371;319820;139869;24.2;10.6
91;2021-05-17;6952;1703;326772;141572;24.8;10.7
91;2021-05-18;8120;1739;334892;143311;25.4;10.9
91;2021-05-19;7098;1694;341990;145005;25.9;11.0
91;2021-05-20;8200;2140;350190;147145;26.5;11.2
91;2021-05-21;8143;2580;358333;149725;27.2;11.3
91;2021-05-22;7660;1538;365993;151263;27.7;11.5
91;2021-05-23;4792;534;370785;151797;28.1;11.5
91;2021-05-24;5013;595;375798;152392;28.5;11.6
91;2021-05-25;7621;2652;383419;155044;29.1;11.8
91;2021-05-26;6874;2941;390293;157985;29.6;12.0
91;2021-05-27;7971;3438;398264;161423;30.2;12.2
91;2021-05-28;7534;4323;405798;165746;30.8;12.6
91;2021-05-29;9301;3501;415099;169247;31.5;12.8
91;2021-05-30;5948;963;421047;170210;31.9;12.9
91;2021-05-31;6738;3696;427785;173906;32.4;13.2
91;2021-06-01;7787;4764;435572;178670;33.0;13.5
91;2021-06-02;7454;3949;443026;182619;33.6;13.8
91;2021-06-03;7859;4777;450885;187396;34.2;14.2
91;2021-06-04;7192;5716;458077;193112;34.7;14.6
91;2021-06-05;6385;5819;464462;198931;35.2;15.1
91;2021-06-06;4087;2512;468549;201443;35.5;15.3
91;2021-06-07;5878;5478;474427;206921;36.0;15.7
91;2021-06-08;7038;5793;481465;212714;36.5;16.1
91;2021-06-09;6469;5139;487934;217853;37.0;16.5
91;2021-06-10;7177;5779;495111;223632;37.5;16.9
91;2021-06-11;6545;7109;501656;230741;38.0;17.5
91;2021-06-12;6218;7367;507874;238108;38.5;18.0
91;2021-06-13;2845;2314;510719;240422;38.7;18.2
91;2021-06-14;4225;7194;514944;247616;39.0;18.8
91;2021-06-15;5575;7258;520519;254874;39.5;19.3
91;2021-06-16;5297;6445;525816;261319;39.9;19.8
91;2021-06-17;6250;7130;532066;268449;40.3;20.3
91;2021-06-18;4629;8737;536695;277186;40.7;21.0
91;2021-06-19;4189;7153;540884;284339;41.0;21.6
91;2021-06-20;1007;4211;541891;288550;41.1;21.9
91;2021-06-21;3232;7237;545123;295787;41.3;22.4
91;2021-06-22;4157;9229;549280;305016;41.6;23.1
91;2021-06-23;4315;7957;553595;312973;42.0;23.7
91;2021-06-24;4912;8482;558507;321455;42.3;24.4
91;2021-06-25;3477;9166;561984;330621;42.6;25.1
91;2021-06-26;2989;8032;564973;338653;42.8;25.7
91;2021-06-27;550;2996;565523;341649;42.9;25.9
91;2021-06-28;3129;8237;568652;349886;43.1;26.5
91;2021-06-29;3588;9632;572240;359518;43.4;27.2
91;2021-06-30;3954;8700;576194;368218;43.7;27.9
91;2021-07-01;4101;8871;580295;377089;44.0;28.6
91;2021-07-02;3774;9316;584069;386405;44.3;29.3
91;2021-07-03;2880;9788;586949;396193;44.5;30.0
91;2021-07-04;852;4725;587801;400918;44.6;30.4
91;2021-07-05;2662;7257;590463;408175;44.8;30.9
91;2021-07-06;3758;9430;594221;417605;45.0;31.7
91;2021-07-07;3806;8591;598027;426196;45.3;32.3
91;2021-07-08;4359;8990;602386;435186;45.7;33.0
91;2021-07-09;3968;9950;606354;445136;46.0;33.7
91;2021-07-10;3397;10235;609751;455371;46.2;34.5
91;2021-07-11;986;4803;610737;460174;46.3;34.9
91;2021-07-12;2803;8887;613540;469061;46.5;35.6
91;2021-07-13;4467;10391;618007;479452;46.8;36.3
91;2021-07-14;2303;3585;620310;483037;47.0;36.6
91;2021-07-15;4537;9824;624847;492861;47.4;37.4
91;2021-07-16;6287;9765;631134;502626;47.8;38.1
91;2021-07-17;5750;9067;636884;511693;48.3;38.8
91;2021-07-18;3402;3684;640286;515377;48.5;39.1
91;2021-07-19;3778;7534;644064;522911;48.8;39.6
91;2021-07-20;6073;9308;650137;532219;49.3;40.3
91;2021-07-21;6250;7731;656387;539950;49.7;40.9
91;2021-07-22;6498;8400;662885;548350;50.2;41.6
91;2021-07-23;6925;8286;669810;556636;50.8;42.2
91;2021-07-24;5013;6476;674823;563112;51.1;42.7
91;2021-07-25;3267;1408;678090;564520;51.4;42.8
91;2021-07-26;4934;6592;683024;571112;51.8;43.3
91;2021-07-27;7565;7082;690589;578194;52.3;43.8
91;2021-07-28;7366;5924;697955;584118;52.9;44.3
91;2021-07-29;7397;5911;705352;590029;53.5;44.7
91;2021-07-30;6913;5783;712265;595812;54.0;45.2
91;2021-07-31;4910;4789;717175;600601;54.4;45.5
91;2021-08-01;2660;1338;719835;601939;54.6;45.6
91;2021-08-02;4773;4235;724608;606174;54.9;45.9
91;2021-08-03;5891;4693;730499;610867;55.4;46.3
91;2021-08-04;5700;4140;736199;615007;55.8;46.6
91;2021-08-05;5604;4270;741803;619277;56.2;46.9
91;2021-08-06;5708;5626;747511;624903;56.7;47.4
91;2021-08-07;3084;2419;750595;627322;56.9;47.5
91;2021-08-08;621;1102;751216;628424;56.9;47.6
91;2021-08-09;3832;3976;755048;632400;57.2;47.9
91;2021-08-10;4649;4552;759697;636952;57.6;48.3
91;2021-08-11;4151;4486;763848;641438;57.9;48.6
91;2021-08-12;4088;4782;767936;646220;58.2;49.0
91;2021-08-13;4301;4864;772237;651084;58.5;49.3
91;2021-08-14;2245;2402;774482;653486;58.7;49.5
91;2021-08-15;95;171;774577;653657;58.7;49.5
91;2021-08-16;3075;4660;777652;658317;58.9;49.9
91;2021-08-17;3653;5818;781305;664135;59.2;50.3
91;2021-08-18;3028;5797;784333;669932;59.4;50.8
91;2021-08-19;3478;5773;787811;675705;59.7;51.2
91;2021-08-20;3214;6957;791025;682662;60.0;51.7
91;2021-08-21;2465;3354;793490;686016;60.1;52.0
91;2021-08-22;738;1297;794228;687313;60.2;52.1
91;2021-08-23;2420;5312;796648;692625;60.4;52.5
91;2021-08-24;2986;6960;799634;699585;60.6;53.0
91;2021-08-25;3425;6721;803059;706306;60.9;53.5
91;2021-08-26;2748;5951;805807;712257;61.1;54.0
91;2021-08-27;2833;7503;808640;719760;61.3;54.6
91;2021-08-28;2386;4836;811026;724596;61.5;54.9
91;2021-08-29;1772;2794;812798;727390;61.6;55.1
91;2021-08-30;1790;5610;814588;733000;61.7;55.6
91;2021-08-31;2256;6096;816844;739096;61.9;56.0
91;2021-09-01;2434;4607;819278;743703;62.1;56.4
91;2021-09-02;1907;3900;821185;747603;62.2;56.7
91;2021-09-03;2149;4973;823334;752576;62.4;57.0
91;2021-09-04;2068;4233;825402;756809;62.6;57.4
91;2021-09-05;746;944;826148;757753;62.6;57.4
91;2021-09-06;1663;3504;827811;761257;62.7;57.7
91;2021-09-07;1549;3282;829360;764539;62.9;57.9
91;2021-09-08;1780;3550;831140;768089;63.0;58.2
91;2021-09-09;1281;3363;832421;771452;63.1;58.5
91;2021-09-10;1779;4032;834200;775484;63.2;58.8
91;2021-09-11;1736;4472;835936;779956;63.4;59.1
91;2021-09-12;623;1029;836559;780985;63.4;59.2
91;2021-09-13;1261;2909;837820;783894;63.5;59.4
91;2021-09-14;1787;3500;839607;787394;63.6;59.7
91;2021-09-15;1617;3284;841224;790678;63.8;59.9
91;2021-09-16;1472;2378;842696;793056;63.9;60.1
91;2021-09-17;1435;2992;844131;796048;64.0;60.3
91;2021-09-18;1384;3665;845515;799713;64.1;60.6
91;2021-09-19;455;1147;845970;800860;64.1;60.7
91;2021-09-20;752;1597;846722;802457;64.2;60.8
91;2021-09-21;881;1743;847603;804200;64.2;61.0
91;2021-09-22;917;2635;848520;806835;64.3;61.2
91;2021-09-23;919;1730;849439;808565;64.4;61.3
91;2021-09-24;894;2196;850333;810761;64.4;61.4
91;2021-09-25;1049;3481;851382;814242;64.5;61.7
91;2021-09-26;220;820;851602;815062;64.5;61.8
91;2021-09-27;724;1567;852326;816629;64.6;61.9
91;2021-09-28;896;1439;853222;818068;64.7;62.0
91;2021-09-29;1008;2222;854230;820290;64.7;62.2
92;2020-12-27;42;0;42;0;0.0;0.0
92;2020-12-28;28;0;70;0;0.0;0.0
92;2020-12-29;65;0;135;0;0.0;0.0
92;2020-12-30;52;0;187;0;0.0;0.0
92;2020-12-31;13;0;200;0;0.0;0.0
92;2021-01-01;35;0;235;0;0.0;0.0
92;2021-01-02;14;0;249;0;0.0;0.0
92;2021-01-03;16;0;265;0;0.0;0.0
92;2021-01-04;77;1;342;1;0.0;0.0
92;2021-01-05;236;1;578;2;0.0;0.0
92;2021-01-06;417;3;995;5;0.1;0.0
92;2021-01-07;674;4;1669;9;0.1;0.0
92;2021-01-08;849;4;2518;13;0.2;0.0
92;2021-01-09;130;1;2648;14;0.2;0.0
92;2021-01-10;51;0;2699;14;0.2;0.0
92;2021-01-11;852;5;3551;19;0.2;0.0
92;2021-01-12;1307;9;4858;28;0.3;0.0
92;2021-01-13;1252;13;6110;41;0.4;0.0
92;2021-01-14;1238;16;7348;57;0.5;0.0
92;2021-01-15;986;7;8334;64;0.5;0.0
92;2021-01-16;185;1;8519;65;0.5;0.0
92;2021-01-17;30;0;8549;65;0.5;0.0
92;2021-01-18;1554;20;10103;85;0.6;0.0
92;2021-01-19;1573;20;11676;105;0.7;0.0
92;2021-01-20;1820;11;13496;116;0.8;0.0
92;2021-01-21;3455;21;16951;137;1.1;0.0
92;2021-01-22;2624;40;19575;177;1.2;0.0
92;2021-01-23;153;0;19728;177;1.2;0.0
92;2021-01-24;32;0;19760;177;1.2;0.0
92;2021-01-25;861;13;20621;190;1.3;0.0
92;2021-01-26;1218;10;21839;200;1.4;0.0
92;2021-01-27;2226;90;24065;290;1.5;0.0
92;2021-01-28;4200;175;28265;465;1.8;0.0
92;2021-01-29;2719;232;30984;697;1.9;0.0
92;2021-01-30;326;11;31310;708;1.9;0.0
92;2021-01-31;35;1;31345;709;1.9;0.0
92;2021-02-01;876;290;32221;999;2.0;0.1
92;2021-02-02;1070;320;33291;1319;2.1;0.1
92;2021-02-03;1005;412;34296;1731;2.1;0.1
92;2021-02-04;1055;485;35351;2216;2.2;0.1
92;2021-02-05;1336;457;36687;2673;2.3;0.2
92;2021-02-06;127;18;36814;2691;2.3;0.2
92;2021-02-07;23;13;36837;2704;2.3;0.2
92;2021-02-08;586;625;37423;3329;2.3;0.2
92;2021-02-09;1072;1146;38495;4475;2.4;0.3
92;2021-02-10;1092;1190;39587;5665;2.5;0.4
92;2021-02-11;1517;1690;41104;7355;2.5;0.5
92;2021-02-12;1424;1372;42528;8727;2.6;0.5
92;2021-02-13;79;57;42607;8784;2.6;0.5
92;2021-02-14;29;0;42636;8784;2.6;0.5
92;2021-02-15;583;1227;43219;10011;2.7;0.6
92;2021-02-16;791;1610;44010;11621;2.7;0.7
92;2021-02-17;626;1475;44636;13096;2.8;0.8
92;2021-02-18;1581;2918;46217;16014;2.9;1.0
92;2021-02-19;1735;2270;47952;18284;3.0;1.1
92;2021-02-20;147;337;48099;18621;3.0;1.2
92;2021-02-21;47;49;48146;18670;3.0;1.2
92;2021-02-22;504;964;48650;19634;3.0;1.2
92;2021-02-23;742;1069;49392;20703;3.1;1.3
92;2021-02-24;616;1017;50008;21720;3.1;1.3
92;2021-02-25;928;1422;50936;23142;3.2;1.4
92;2021-02-26;1466;1119;52402;24261;3.2;1.5
92;2021-02-27;507;167;52909;24428;3.3;1.5
92;2021-02-28;75;44;52984;24472;3.3;1.5
92;2021-03-01;1104;813;54088;25285;3.4;1.6
92;2021-03-02;1983;1081;56071;26366;3.5;1.6
92;2021-03-03;2806;898;58877;27264;3.6;1.7
92;2021-03-04;3606;1268;62483;28532;3.9;1.8
92;2021-03-05;4985;1452;67468;29984;4.2;1.9
92;2021-03-06;5725;322;73193;30306;4.5;1.9
92;2021-03-07;2908;228;76101;30534;4.7;1.9
92;2021-03-08;2426;691;78527;31225;4.9;1.9
92;2021-03-09;3449;873;81976;32098;5.1;2.0
92;2021-03-10;3950;873;85926;32971;5.3;2.0
92;2021-03-11;5024;1296;90950;34267;5.6;2.1
92;2021-03-12;6777;1471;97727;35738;6.1;2.2
92;2021-03-13;5163;236;102890;35974;6.4;2.2
92;2021-03-14;1745;76;104635;36050;6.5;2.2
92;2021-03-15;3808;586;108443;36636;6.7;2.3
92;2021-03-16;3697;562;112140;37198;6.9;2.3
92;2021-03-17;3879;417;116019;37615;7.2;2.3
92;2021-03-18;4146;737;120165;38352;7.4;2.4
92;2021-03-19;5934;718;126099;39070;7.8;2.4
92;2021-03-20;2540;75;128639;39145;8.0;2.4
92;2021-03-21;155;29;128794;39174;8.0;2.4
92;2021-03-22;4119;475;132913;39649;8.2;2.5
92;2021-03-23;6110;862;139023;40511;8.6;2.5
92;2021-03-24;6382;657;145405;41168;9.0;2.6
92;2021-03-25;8443;643;153848;41811;9.5;2.6
92;2021-03-26;8360;891;162208;42702;10.1;2.6
92;2021-03-27;2838;280;165046;42982;10.2;2.7
92;2021-03-28;543;39;165589;43021;10.3;2.7
92;2021-03-29;4668;1055;170257;44076;10.6;2.7
92;2021-03-30;6394;1544;176651;45620;10.9;2.8
92;2021-03-31;5555;2232;182206;47852;11.3;3.0
92;2021-04-01;6275;3663;188481;51515;11.7;3.2
92;2021-04-02;5639;3411;194120;54926;12.0;3.4
92;2021-04-03;876;1409;194996;56335;12.1;3.5
92;2021-04-04;492;1053;195488;57388;12.1;3.6
92;2021-04-05;817;158;196305;57546;12.2;3.6
92;2021-04-06;3666;1945;199971;59491;12.4;3.7
92;2021-04-07;5003;2887;204974;62378;12.7;3.9
92;2021-04-08;5992;3182;210966;65560;13.1;4.1
92;2021-04-09;8034;3047;219000;68607;13.6;4.3
92;2021-04-10;2642;1290;221642;69897;13.7;4.3
92;2021-04-11;166;805;221808;70702;13.7;4.4
92;2021-04-12;3687;2511;225495;73213;14.0;4.5
92;2021-04-13;4387;4421;229882;77634;14.2;4.8
92;2021-04-14;4875;4037;234757;81671;14.5;5.1
92;2021-04-15;5302;3951;240059;85622;14.9;5.3
92;2021-04-16;5076;3855;245135;89477;15.2;5.5
92;2021-04-17;1806;1188;246941;90665;15.3;5.6
92;2021-04-18;351;94;247292;90759;15.3;5.6
92;2021-04-19;2819;2842;250111;93601;15.5;5.8
92;2021-04-20;4197;3757;254308;97358;15.8;6.0
92;2021-04-21;4617;4514;258925;101872;16.0;6.3
92;2021-04-22;4662;5121;263587;106993;16.3;6.6
92;2021-04-23;5254;4700;268841;111693;16.7;6.9
92;2021-04-24;4942;1902;273783;113595;17.0;7.0
92;2021-04-25;1793;148;275576;113743;17.1;7.0
92;2021-04-26;4002;3617;279578;117360;17.3;7.3
92;2021-04-27;6047;5252;285625;122612;17.7;7.6
92;2021-04-28;7381;4487;293006;127099;18.2;7.9
92;2021-04-29;7989;4767;300995;131866;18.7;8.2
92;2021-04-30;8847;4838;309842;136704;19.2;8.5
92;2021-05-01;1201;405;311043;137109;19.3;8.5
92;2021-05-02;667;139;311710;137248;19.3;8.5
92;2021-05-03;6785;3879;318495;141127;19.7;8.7
92;2021-05-04;10429;4355;328924;145482;20.4;9.0
92;2021-05-05;10075;5243;338999;150725;21.0;9.3
92;2021-05-06;11426;4897;350425;155622;21.7;9.6
92;2021-05-07;9869;5293;360294;160915;22.3;10.0
92;2021-05-08;7215;1921;367509;162836;22.8;10.1
92;2021-05-09;3787;600;371296;163436;23.0;10.1
92;2021-05-10;9547;3995;380843;167431;23.6;10.4
92;2021-05-11;13978;5682;394821;173113;24.5;10.7
92;2021-05-12;14286;4577;409107;177690;25.4;11.0
92;2021-05-13;9167;903;418274;178593;25.9;11.1
92;2021-05-14;12029;2303;430303;180896;26.7;11.2
92;2021-05-15;8392;1226;438695;182122;27.2;11.3
92;2021-05-16;4141;453;442836;182575;27.4;11.3
92;2021-05-17;10647;2216;453483;184791;28.1;11.5
92;2021-05-18;16412;3118;469895;187909;29.1;11.6
92;2021-05-19;16038;3715;485933;191624;30.1;11.9
92;2021-05-20;16837;3980;502770;195604;31.2;12.1
92;2021-05-21;14071;3613;516841;199217;32.0;12.3
92;2021-05-22;8318;1512;525159;200729;32.5;12.4
92;2021-05-23;4082;454;529241;201183;32.8;12.5
92;2021-05-24;6119;855;535360;202038;33.2;12.5
92;2021-05-25;13110;4563;548470;206601;34.0;12.8
92;2021-05-26;11924;5036;560394;211637;34.7;13.1
92;2021-05-27;12735;6324;573129;217961;35.5;13.5
92;2021-05-28;11232;6276;584361;224237;36.2;13.9
92;2021-05-29;5451;2305;589812;226542;36.5;14.0
92;2021-05-30;2252;389;592064;226931;36.7;14.1
92;2021-05-31;12049;5296;604113;232227;37.4;14.4
92;2021-06-01;12633;7632;616746;239859;38.2;14.9
92;2021-06-02;14378;7203;631124;247062;39.1;15.3
92;2021-06-03;14596;8022;645720;255084;40.0;15.8
92;2021-06-04;12234;8219;657954;263303;40.8;16.3
92;2021-06-05;7382;6229;665336;269532;41.2;16.7
92;2021-06-06;3597;1675;668933;271207;41.5;16.8
92;2021-06-07;11433;7635;680366;278842;42.2;17.3
92;2021-06-08;12761;9601;693127;288443;43.0;17.9
92;2021-06-09;11659;9472;704786;297915;43.7;18.5
92;2021-06-10;11965;10563;716751;308478;44.4;19.1
92;2021-06-11;8150;11033;724901;319511;44.9;19.8
92;2021-06-12;6364;5091;731265;324602;45.3;20.1
92;2021-06-13;3969;2720;735234;327322;45.6;20.3
92;2021-06-14;5211;11169;740445;338491;45.9;21.0
92;2021-06-15;6535;13122;746980;351613;46.3;21.8
92;2021-06-16;6949;12990;753929;364603;46.7;22.6
92;2021-06-17;7429;13999;761358;378602;47.2;23.5
92;2021-06-18;6905;14385;768263;392987;47.6;24.4
92;2021-06-19;3965;9106;772228;402093;47.9;24.9
92;2021-06-20;1968;5607;774196;407700;48.0;25.3
92;2021-06-21;4837;12274;779033;419974;48.3;26.0
92;2021-06-22;5878;17536;784911;437510;48.6;27.1
92;2021-06-23;5482;15990;790393;453500;49.0;28.1
92;2021-06-24;6208;15118;796601;468618;49.4;29.0
92;2021-06-25;5120;16097;801721;484715;49.7;30.0
92;2021-06-26;4070;10454;805791;495169;49.9;30.7
92;2021-06-27;1858;6046;807649;501215;50.0;31.1
92;2021-06-28;3673;12047;811322;513262;50.3;31.8
92;2021-06-29;4679;18150;816001;531412;50.6;32.9
92;2021-06-30;4455;16227;820456;547639;50.8;33.9
92;2021-07-01;5527;16304;825983;563943;51.2;34.9
92;2021-07-02;4941;15278;830924;579221;51.5;35.9
92;2021-07-03;3304;10185;834228;589406;51.7;36.5
92;2021-07-04;1124;4208;835352;593614;51.8;36.8
92;2021-07-05;4825;12330;840177;605944;52.1;37.5
92;2021-07-06;5284;15810;845461;621754;52.4;38.5
92;2021-07-07;4266;11460;849727;633214;52.7;39.2
92;2021-07-08;5410;14638;855137;647852;53.0;40.1
92;2021-07-09;5898;14203;861035;662055;53.4;41.0
92;2021-07-10;4377;8456;865412;670511;53.6;41.5
92;2021-07-11;1486;2615;866898;673126;53.7;41.7
92;2021-07-12;4416;14640;871314;687766;54.0;42.6
92;2021-07-13;7883;17456;879197;705222;54.5;43.7
92;2021-07-14;5113;5745;884310;710967;54.8;44.1
92;2021-07-15;9569;16255;893879;727222;55.4;45.1
92;2021-07-16;9063;14184;902942;741406;56.0;45.9
92;2021-07-17;6581;7603;909523;749009;56.4;46.4
92;2021-07-18;1841;2482;911364;751491;56.5;46.6
92;2021-07-19;6480;13196;917844;764687;56.9;47.4
92;2021-07-20;10090;14105;927934;778792;57.5;48.3
92;2021-07-21;10466;12122;938400;790914;58.1;49.0
92;2021-07-22;12056;12991;950456;803905;58.9;49.8
92;2021-07-23;11590;11356;962046;815261;59.6;50.5
92;2021-07-24;6732;6267;968778;821528;60.0;50.9
92;2021-07-25;2778;2329;971556;823857;60.2;51.1
92;2021-07-26;9490;9178;981046;833035;60.8;51.6
92;2021-07-27;11519;9619;992565;842654;61.5;52.2
92;2021-07-28;12949;8205;1005514;850859;62.3;52.7
92;2021-07-29;10452;8635;1015966;859494;63.0;53.3
92;2021-07-30;9129;8359;1025095;867853;63.5;53.8
92;2021-07-31;5701;4821;1030796;872674;63.9;54.1
92;2021-08-01;2215;1300;1033011;873974;64.0;54.2
92;2021-08-02;4685;4935;1037696;878909;64.3;54.5
92;2021-08-03;5143;6147;1042839;885056;64.6;54.8
92;2021-08-04;4772;4874;1047611;889930;64.9;55.1
92;2021-08-05;4524;5687;1052135;895617;65.2;55.5
92;2021-08-06;4549;5972;1056684;901589;65.5;55.9
92;2021-08-07;2833;4181;1059517;905770;65.7;56.1
92;2021-08-08;963;1082;1060480;906852;65.7;56.2
92;2021-08-09;3211;4252;1063691;911104;65.9;56.5
92;2021-08-10;3831;5614;1067522;916718;66.2;56.8
92;2021-08-11;3236;4436;1070758;921154;66.4;57.1
92;2021-08-12;3394;5602;1074152;926756;66.6;57.4
92;2021-08-13;2994;5146;1077146;931902;66.7;57.7
92;2021-08-14;1885;3930;1079031;935832;66.9;58.0
92;2021-08-15;587;839;1079618;936671;66.9;58.0
92;2021-08-16;2399;5324;1082017;941995;67.0;58.4
92;2021-08-17;2634;6989;1084651;948984;67.2;58.8
92;2021-08-18;2426;5255;1087077;954239;67.4;59.1
92;2021-08-19;2519;5745;1089596;959984;67.5;59.5
92;2021-08-20;2275;5197;1091871;965181;67.7;59.8
92;2021-08-21;1387;4221;1093258;969402;67.7;60.1
92;2021-08-22;427;1598;1093685;971000;67.8;60.2
92;2021-08-23;2495;6600;1096180;977600;67.9;60.6
92;2021-08-24;3152;8348;1099332;985948;68.1;61.1
92;2021-08-25;2860;7582;1102192;993530;68.3;61.6
92;2021-08-26;3014;7576;1105206;1001106;68.5;62.0
92;2021-08-27;3091;7010;1108297;1008116;68.7;62.5
92;2021-08-28;1614;4517;1109911;1012633;68.8;62.7
92;2021-08-29;345;789;1110256;1013422;68.8;62.8
92;2021-08-30;2248;4899;1112504;1018321;68.9;63.1
92;2021-08-31;3090;7042;1115594;1025363;69.1;63.5
92;2021-09-01;3276;7606;1118870;1032969;69.3;64.0
92;2021-09-02;2642;6830;1121512;1039799;69.5;64.4
92;2021-09-03;2661;6595;1124173;1046394;69.7;64.8
92;2021-09-04;2200;5054;1126373;1051448;69.8;65.2
92;2021-09-05;444;1051;1126817;1052499;69.8;65.2
92;2021-09-06;1306;3705;1128123;1056204;69.9;65.4
92;2021-09-07;1689;4195;1129812;1060399;70.0;65.7
92;2021-09-08;2175;4319;1131987;1064718;70.1;66.0
92;2021-09-09;1220;3274;1133207;1067992;70.2;66.2
92;2021-09-10;1772;4250;1134979;1072242;70.3;66.4
92;2021-09-11;1548;2938;1136527;1075180;70.4;66.6
92;2021-09-12;209;466;1136736;1075646;70.4;66.7
92;2021-09-13;1100;3090;1137836;1078736;70.5;66.8
92;2021-09-14;1224;3590;1139060;1082326;70.6;67.1
92;2021-09-15;1579;3628;1140639;1085954;70.7;67.3
92;2021-09-16;1077;2155;1141716;1088109;70.7;67.4
92;2021-09-17;1428;3095;1143144;1091204;70.8;67.6
92;2021-09-18;930;2230;1144074;1093434;70.9;67.8
92;2021-09-19;129;292;1144203;1093726;70.9;67.8
92;2021-09-20;774;1831;1144977;1095557;71.0;67.9
92;2021-09-21;779;1867;1145756;1097424;71.0;68.0
92;2021-09-22;1075;3813;1146831;1101237;71.1;68.2
92;2021-09-23;733;1817;1147564;1103054;71.1;68.4
92;2021-09-24;1086;2846;1148650;1105900;71.2;68.5
92;2021-09-25;615;2206;1149265;1108106;71.2;68.7
92;2021-09-26;95;249;1149360;1108355;71.2;68.7
92;2021-09-27;767;1622;1150127;1109977;71.3;68.8
92;2021-09-28;773;1568;1150900;1111545;71.3;68.9
92;2021-09-29;1120;2826;1152020;1114371;71.4;69.1
93;2020-12-27;12;3;12;3;0.0;0.0
93;2020-12-28;6;0;18;3;0.0;0.0
93;2020-12-29;2;0;20;3;0.0;0.0
93;2020-12-30;44;1;64;4;0.0;0.0
93;2020-12-31;11;0;75;4;0.0;0.0
93;2021-01-01;5;0;80;4;0.0;0.0
93;2021-01-02;0;0;80;4;0.0;0.0
93;2021-01-03;4;0;84;4;0.0;0.0
93;2021-01-04;3;0;87;4;0.0;0.0
93;2021-01-05;66;1;153;5;0.0;0.0
93;2021-01-06;179;0;332;5;0.0;0.0
93;2021-01-07;381;1;713;6;0.0;0.0
93;2021-01-08;632;1;1345;7;0.1;0.0
93;2021-01-09;21;0;1366;7;0.1;0.0
93;2021-01-10;2;0;1368;7;0.1;0.0
93;2021-01-11;505;3;1873;10;0.1;0.0
93;2021-01-12;753;7;2626;17;0.2;0.0
93;2021-01-13;751;6;3377;23;0.2;0.0
93;2021-01-14;689;18;4066;41;0.2;0.0
93;2021-01-15;515;3;4581;44;0.3;0.0
93;2021-01-16;138;3;4719;47;0.3;0.0
93;2021-01-17;6;1;4725;48;0.3;0.0
93;2021-01-18;1198;11;5923;59;0.4;0.0
93;2021-01-19;1613;17;7536;76;0.5;0.0
93;2021-01-20;1556;18;9092;94;0.5;0.0
93;2021-01-21;1921;35;11013;129;0.7;0.0
93;2021-01-22;1391;14;12404;143;0.7;0.0
93;2021-01-23;713;4;13117;147;0.8;0.0
93;2021-01-24;0;0;13117;147;0.8;0.0
93;2021-01-25;1208;13;14325;160;0.9;0.0
93;2021-01-26;1295;28;15620;188;0.9;0.0
93;2021-01-27;2158;63;17778;251;1.1;0.0
93;2021-01-28;2267;172;20045;423;1.2;0.0
93;2021-01-29;1625;206;21670;629;1.3;0.0
93;2021-01-30;927;36;22597;665;1.4;0.0
93;2021-01-31;9;5;22606;670;1.4;0.0
93;2021-02-01;1186;146;23792;816;1.4;0.0
93;2021-02-02;1171;284;24963;1100;1.5;0.1
93;2021-02-03;1231;389;26194;1489;1.6;0.1
93;2021-02-04;926;538;27120;2027;1.6;0.1
93;2021-02-05;800;396;27920;2423;1.7;0.1
93;2021-02-06;694;64;28614;2487;1.7;0.1
93;2021-02-07;6;0;28620;2487;1.7;0.1
93;2021-02-08;913;546;29533;3033;1.8;0.2
93;2021-02-09;851;552;30384;3585;1.8;0.2
93;2021-02-10;882;616;31266;4201;1.9;0.3
93;2021-02-11;1244;719;32510;4920;1.9;0.3
93;2021-02-12;1041;565;33551;5485;2.0;0.3
93;2021-02-13;395;209;33946;5694;2.0;0.3
93;2021-02-14;13;58;33959;5752;2.0;0.3
93;2021-02-15;414;906;34373;6658;2.1;0.4
93;2021-02-16;550;989;34923;7647;2.1;0.5
93;2021-02-17;542;1326;35465;8973;2.1;0.5
93;2021-02-18;1135;1630;36600;10603;2.2;0.6
93;2021-02-19;993;1290;37593;11893;2.3;0.7
93;2021-02-20;303;529;37896;12422;2.3;0.7
93;2021-02-21;10;24;37906;12446;2.3;0.7
93;2021-02-22;602;985;38508;13431;2.3;0.8
93;2021-02-23;561;874;39069;14305;2.3;0.9
93;2021-02-24;643;959;39712;15264;2.4;0.9
93;2021-02-25;901;863;40613;16127;2.4;1.0
93;2021-02-26;1121;819;41734;16946;2.5;1.0
93;2021-02-27;543;515;42277;17461;2.5;1.0
93;2021-02-28;88;57;42365;17518;2.5;1.0
93;2021-03-01;1083;854;43448;18372;2.6;1.1
93;2021-03-02;1447;949;44895;19321;2.7;1.2
93;2021-03-03;1745;1018;46640;20339;2.8;1.2
93;2021-03-04;2717;1019;49357;21358;3.0;1.3
93;2021-03-05;3822;802;53179;22160;3.2;1.3
93;2021-03-06;5050;525;58229;22685;3.5;1.4
93;2021-03-07;4299;238;62528;22923;3.7;1.4
93;2021-03-08;2036;1117;64564;24040;3.9;1.4
93;2021-03-09;2915;885;67479;24925;4.0;1.5
93;2021-03-10;2860;1032;70339;25957;4.2;1.6
93;2021-03-11;3575;1185;73914;27142;4.4;1.6
93;2021-03-12;4124;1247;78038;28389;4.7;1.7
93;2021-03-13;4289;611;82327;29000;4.9;1.7
93;2021-03-14;884;70;83211;29070;5.0;1.7
93;2021-03-15;3556;659;86767;29729;5.2;1.8
93;2021-03-16;3159;606;89926;30335;5.4;1.8
93;2021-03-17;2656;597;92582;30932;5.5;1.9
93;2021-03-18;3314;716;95896;31648;5.7;1.9
93;2021-03-19;3767;633;99663;32281;6.0;1.9
93;2021-03-20;3460;300;103123;32581;6.2;2.0
93;2021-03-21;813;266;103936;32847;6.2;2.0
93;2021-03-22;3851;617;107787;33464;6.5;2.0
93;2021-03-23;4767;808;112554;34272;6.7;2.1
93;2021-03-24;4114;685;116668;34957;7.0;2.1
93;2021-03-25;5586;870;122254;35827;7.3;2.1
93;2021-03-26;5547;893;127801;36720;7.7;2.2
93;2021-03-27;4283;322;132084;37042;7.9;2.2
93;2021-03-28;613;42;132697;37084;7.9;2.2
93;2021-03-29;3851;964;136548;38048;8.2;2.3
93;2021-03-30;4726;1269;141274;39317;8.5;2.4
93;2021-03-31;3914;1248;145188;40565;8.7;2.4
93;2021-04-01;4055;3140;149243;43705;8.9;2.6
93;2021-04-02;3224;3552;152467;47257;9.1;2.8
93;2021-04-03;2518;2259;154985;49516;9.3;3.0
93;2021-04-04;764;160;155749;49676;9.3;3.0
93;2021-04-05;708;87;156457;49763;9.4;3.0
93;2021-04-06;4563;2353;161020;52116;9.6;3.1
93;2021-04-07;4902;2093;165922;54209;9.9;3.2
93;2021-04-08;5814;2683;171736;56892;10.3;3.4
93;2021-04-09;6097;3179;177833;60071;10.6;3.6
93;2021-04-10;4198;2484;182031;62555;10.9;3.7
93;2021-04-11;575;434;182606;62989;10.9;3.8
93;2021-04-12;4100;2914;186706;65903;11.2;3.9
93;2021-04-13;4606;3650;191312;69553;11.5;4.2
93;2021-04-14;4366;2477;195678;72030;11.7;4.3
93;2021-04-15;4557;3036;200235;75066;12.0;4.5
93;2021-04-16;4442;2991;204677;78057;12.3;4.7
93;2021-04-17;3517;2500;208194;80557;12.5;4.8
93;2021-04-18;290;434;208484;80991;12.5;4.8
93;2021-04-19;3776;2864;212260;83855;12.7;5.0
93;2021-04-20;4308;3262;216568;87117;13.0;5.2
93;2021-04-21;4145;2768;220713;89885;13.2;5.4
93;2021-04-22;4512;4022;225225;93907;13.5;5.6
93;2021-04-23;5627;3244;230852;97151;13.8;5.8
93;2021-04-24;5921;3326;236773;100477;14.2;6.0
93;2021-04-25;1733;598;238506;101075;14.3;6.1
93;2021-04-26;4864;3076;243370;104151;14.6;6.2
93;2021-04-27;6453;3621;249823;107772;15.0;6.5
93;2021-04-28;6071;3430;255894;111202;15.3;6.7
93;2021-04-29;7301;3243;263195;114445;15.8;6.9
93;2021-04-30;8268;3114;271463;117559;16.3;7.0
93;2021-05-01;4948;1191;276411;118750;16.6;7.1
93;2021-05-02;419;646;276830;119396;16.6;7.1
93;2021-05-03;8171;5115;285001;124511;17.1;7.5
93;2021-05-04;7822;5395;292823;129906;17.5;7.8
93;2021-05-05;7575;4803;300398;134709;18.0;8.1
93;2021-05-06;8250;4777;308648;139486;18.5;8.4
93;2021-05-07;7013;5426;315661;144912;18.9;8.7
93;2021-05-08;8363;2392;324024;147304;19.4;8.8
93;2021-05-09;6125;1368;330149;148672;19.8;8.9
93;2021-05-10;8255;4071;338404;152743;20.3;9.1
93;2021-05-11;9309;4799;347713;157542;20.8;9.4
93;2021-05-12;9192;3655;356905;161197;21.4;9.7
93;2021-05-13;8300;1651;365205;162848;21.9;9.8
93;2021-05-14;10420;3527;375625;166375;22.5;10.0
93;2021-05-15;11124;3008;386749;169383;23.2;10.1
93;2021-05-16;5558;727;392307;170110;23.5;10.2
93;2021-05-17;11904;2268;404211;172378;24.2;10.3
93;2021-05-18;14097;2388;418308;174766;25.0;10.5
93;2021-05-19;11431;2943;429739;177709;25.7;10.6
93;2021-05-20;12624;3486;442363;181195;26.5;10.8
93;2021-05-21;13015;2884;455378;184079;27.3;11.0
93;2021-05-22;12376;2199;467754;186278;28.0;11.2
93;2021-05-23;8478;1108;476232;187386;28.5;11.2
93;2021-05-24;11206;1941;487438;189327;29.2;11.3
93;2021-05-25;12291;4318;499729;193645;29.9;11.6
93;2021-05-26;11078;3758;510807;197403;30.6;11.8
93;2021-05-27;12708;3893;523515;201296;31.3;12.1
93;2021-05-28;12653;5255;536168;206551;32.1;12.4
93;2021-05-29;11395;4264;547563;210815;32.8;12.6
93;2021-05-30;8211;1380;555774;212195;33.3;12.7
93;2021-05-31;9180;5173;564954;217368;33.8;13.0
93;2021-06-01;11399;6277;576353;223645;34.5;13.4
93;2021-06-02;10719;5194;587072;228839;35.2;13.7
93;2021-06-03;10814;5517;597886;234356;35.8;14.0
93;2021-06-04;10590;7789;608476;242145;36.4;14.5
93;2021-06-05;9019;7358;617495;249503;37.0;14.9
93;2021-06-06;8403;1746;625898;251249;37.5;15.0
93;2021-06-07;10065;7511;635963;258760;38.1;15.5
93;2021-06-08;10366;7376;646329;266136;38.7;15.9
93;2021-06-09;10242;7291;656571;273427;39.3;16.4
93;2021-06-10;9010;8194;665581;281621;39.9;16.9
93;2021-06-11;8823;8813;674404;290434;40.4;17.4
93;2021-06-12;9862;6656;684266;297090;41.0;17.8
93;2021-06-13;7168;2130;691434;299220;41.4;17.9
93;2021-06-14;5399;9731;696833;308951;41.7;18.5
93;2021-06-15;6235;9659;703068;318610;42.1;19.1
93;2021-06-16;6645;9059;709713;327669;42.5;19.6
93;2021-06-17;5752;8462;715465;336131;42.8;20.1
93;2021-06-18;7226;11120;722691;347251;43.3;20.8
93;2021-06-19;7075;11099;729766;358350;43.7;21.5
93;2021-06-20;4943;6877;734709;365227;44.0;21.9
93;2021-06-21;4071;10728;738780;375955;44.2;22.5
93;2021-06-22;4696;11314;743476;387269;44.5;23.2
93;2021-06-23;4537;10594;748013;397863;44.8;23.8
93;2021-06-24;4200;10297;752213;408160;45.0;24.4
93;2021-06-25;5188;13053;757401;421213;45.3;25.2
93;2021-06-26;5301;13928;762702;435141;45.7;26.1
93;2021-06-27;3285;7104;765987;442245;45.9;26.5
93;2021-06-28;3699;12507;769686;454752;46.1;27.2
93;2021-06-29;4016;12353;773702;467105;46.3;28.0
93;2021-06-30;4144;11302;777846;478407;46.6;28.6
93;2021-07-01;6089;11162;783935;489569;46.9;29.3
93;2021-07-02;5798;12380;789733;501949;47.3;30.1
93;2021-07-03;5550;13464;795283;515413;47.6;30.9
93;2021-07-04;3081;7888;798364;523301;47.8;31.3
93;2021-07-05;4590;10848;802954;534149;48.1;32.0
93;2021-07-06;4850;11759;807804;545908;48.4;32.7
93;2021-07-07;5227;11413;813031;557321;48.7;33.4
93;2021-07-08;5060;10266;818091;567587;49.0;34.0
93;2021-07-09;5923;13034;824014;580621;49.3;34.8
93;2021-07-10;5919;14293;829933;594914;49.7;35.6
93;2021-07-11;3689;9090;833622;604004;49.9;36.2
93;2021-07-12;5607;12078;839229;616082;50.2;36.9
93;2021-07-13;11144;13309;850373;629391;50.9;37.7
93;2021-07-14;10669;6797;861042;636188;51.6;38.1
93;2021-07-15;12553;14138;873595;650326;52.3;38.9
93;2021-07-16;13241;13697;886836;664023;53.1;39.8
93;2021-07-17;11370;13917;898206;677940;53.8;40.6
93;2021-07-18;7395;8959;905601;686899;54.2;41.1
93;2021-07-19;9637;10929;915238;697828;54.8;41.8
93;2021-07-20;12662;10688;927900;708516;55.6;42.4
93;2021-07-21;14408;10955;942308;719471;56.4;43.1
93;2021-07-22;14179;9482;956487;728953;57.3;43.6
93;2021-07-23;14620;10662;971107;739615;58.1;44.3
93;2021-07-24;13920;10649;985027;750264;59.0;44.9
93;2021-07-25;9036;6363;994063;756627;59.5;45.3
93;2021-07-26;12795;7797;1006858;764424;60.3;45.8
93;2021-07-27;15186;7466;1022044;771890;61.2;46.2
93;2021-07-28;15025;8309;1037069;780199;62.1;46.7
93;2021-07-29;13605;7081;1050674;787280;62.9;47.1
93;2021-07-30;14172;7869;1064846;795149;63.8;47.6
93;2021-07-31;12249;7720;1077095;802869;64.5;48.1
93;2021-08-01;7507;4603;1084602;807472;64.9;48.3
93;2021-08-02;11696;5732;1096298;813204;65.6;48.7
93;2021-08-03;8028;6868;1104326;820072;66.1;49.1
93;2021-08-04;8138;8006;1112464;828078;66.6;49.6
93;2021-08-05;6277;6866;1118741;834944;67.0;50.0
93;2021-08-06;7351;8339;1126092;843283;67.4;50.5
93;2021-08-07;7406;9051;1133498;852334;67.9;51.0
93;2021-08-08;4545;5566;1138043;857900;68.1;51.4
93;2021-08-09;7616;8087;1145659;865987;68.6;51.9
93;2021-08-10;7459;8851;1153118;874838;69.0;52.4
93;2021-08-11;7650;9693;1160768;884531;69.5;53.0
93;2021-08-12;6614;9044;1167382;893575;69.9;53.5
93;2021-08-13;6828;9028;1174210;902603;70.3;54.0
93;2021-08-14;6747;10495;1180957;913098;70.7;54.7
93;2021-08-15;2951;3621;1183908;916719;70.9;54.9
93;2021-08-16;6332;11219;1190240;927938;71.3;55.6
93;2021-08-17;6282;10917;1196522;938855;71.6;56.2
93;2021-08-18;5705;11211;1202227;950066;72.0;56.9
93;2021-08-19;5019;9673;1207246;959739;72.3;57.5
93;2021-08-20;5151;11233;1212397;970972;72.6;58.1
93;2021-08-21;4533;11946;1216930;982918;72.9;58.9
93;2021-08-22;2257;7051;1219187;989969;73.0;59.3
93;2021-08-23;4473;9333;1223660;999302;73.3;59.8
93;2021-08-24;4444;8430;1228104;1007732;73.5;60.3
93;2021-08-25;4309;8607;1232413;1016339;73.8;60.9
93;2021-08-26;3769;7105;1236182;1023444;74.0;61.3
93;2021-08-27;4062;8546;1240244;1031990;74.3;61.8
93;2021-08-28;3894;9586;1244138;1041576;74.5;62.4
93;2021-08-29;1806;4802;1245944;1046378;74.6;62.7
93;2021-08-30;3035;7616;1248979;1053994;74.8;63.1
93;2021-08-31;3106;7809;1252085;1061803;75.0;63.6
93;2021-09-01;3526;7772;1255611;1069575;75.2;64.0
93;2021-09-02;2750;6021;1258361;1075596;75.3;64.4
93;2021-09-03;2912;7306;1261273;1082902;75.5;64.8
93;2021-09-04;3391;8962;1264664;1091864;75.7;65.4
93;2021-09-05;1299;3709;1265963;1095573;75.8;65.6
93;2021-09-06;1864;5324;1267827;1100897;75.9;65.9
93;2021-09-07;1840;4849;1269667;1105746;76.0;66.2
93;2021-09-08;2241;5636;1271908;1111382;76.2;66.5
93;2021-09-09;2000;4922;1273908;1116304;76.3;66.8
93;2021-09-10;2732;5758;1276640;1122062;76.4;67.2
93;2021-09-11;2373;7028;1279013;1129090;76.6;67.6
93;2021-09-12;870;2888;1279883;1131978;76.6;67.8
93;2021-09-13;1760;4963;1281643;1136941;76.7;68.1
93;2021-09-14;1909;4606;1283552;1141547;76.9;68.4
93;2021-09-15;1844;4246;1285396;1145793;77.0;68.6
93;2021-09-16;1558;3036;1286954;1148829;77.1;68.8
93;2021-09-17;1953;4548;1288907;1153377;77.2;69.1
93;2021-09-18;1649;5573;1290556;1158950;77.3;69.4
93;2021-09-19;531;2103;1291087;1161053;77.3;69.5
93;2021-09-20;1248;2901;1292335;1163954;77.4;69.7
93;2021-09-21;1007;2480;1293342;1166434;77.4;69.8
93;2021-09-22;1479;3917;1294821;1170351;77.5;70.1
93;2021-09-23;1014;2406;1295835;1172757;77.6;70.2
93;2021-09-24;1325;3410;1297160;1176167;77.7;70.4
93;2021-09-25;1095;4514;1298255;1180681;77.7;70.7
93;2021-09-26;422;1669;1298677;1182350;77.8;70.8
93;2021-09-27;871;2211;1299548;1184561;77.8;70.9
93;2021-09-28;836;2016;1300384;1186577;77.9;71.0
93;2021-09-29;1153;3218;1301537;1189795;77.9;71.2
94;2020-12-27;7;0;7;0;0.0;0.0
94;2020-12-28;11;0;18;0;0.0;0.0
94;2020-12-29;0;0;18;0;0.0;0.0
94;2020-12-30;1;0;19;0;0.0;0.0
94;2020-12-31;7;0;26;0;0.0;0.0
94;2021-01-01;4;0;30;0;0.0;0.0
94;2021-01-02;0;0;30;0;0.0;0.0
94;2021-01-03;3;0;33;0;0.0;0.0
94;2021-01-04;39;2;72;2;0.0;0.0
94;2021-01-05;233;2;305;4;0.0;0.0
94;2021-01-06;332;4;637;8;0.0;0.0
94;2021-01-07;694;11;1331;19;0.1;0.0
94;2021-01-08;925;10;2256;29;0.2;0.0
94;2021-01-09;47;0;2303;29;0.2;0.0
94;2021-01-10;18;0;2321;29;0.2;0.0
94;2021-01-11;1015;10;3336;39;0.2;0.0
94;2021-01-12;1343;25;4679;64;0.3;0.0
94;2021-01-13;1408;26;6087;90;0.4;0.0
94;2021-01-14;1543;27;7630;117;0.5;0.0
94;2021-01-15;1222;23;8852;140;0.6;0.0
94;2021-01-16;197;1;9049;141;0.6;0.0
94;2021-01-17;99;0;9148;141;0.7;0.0
94;2021-01-18;1499;25;10647;166;0.8;0.0
94;2021-01-19;1952;27;12599;193;0.9;0.0
94;2021-01-20;2186;25;14785;218;1.1;0.0
94;2021-01-21;3032;17;17817;235;1.3;0.0
94;2021-01-22;2192;26;20009;261;1.4;0.0
94;2021-01-23;735;3;20744;264;1.5;0.0
94;2021-01-24;285;0;21029;264;1.5;0.0
94;2021-01-25;1474;21;22503;285;1.6;0.0
94;2021-01-26;1581;19;24084;304;1.7;0.0
94;2021-01-27;1846;31;25930;335;1.8;0.0
94;2021-01-28;1558;128;27488;463;2.0;0.0
94;2021-01-29;1382;137;28870;600;2.1;0.0
94;2021-01-30;580;4;29450;604;2.1;0.0
94;2021-01-31;123;8;29573;612;2.1;0.0
94;2021-02-01;931;140;30504;752;2.2;0.1
94;2021-02-02;854;225;31358;977;2.2;0.1
94;2021-02-03;763;342;32121;1319;2.3;0.1
94;2021-02-04;900;389;33021;1708;2.3;0.1
94;2021-02-05;875;521;33896;2229;2.4;0.2
94;2021-02-06;408;60;34304;2289;2.4;0.2
94;2021-02-07;123;0;34427;2289;2.4;0.2
94;2021-02-08;635;463;35062;2752;2.5;0.2
94;2021-02-09;1035;931;36097;3683;2.6;0.3
94;2021-02-10;1103;1259;37200;4942;2.6;0.4
94;2021-02-11;1432;1469;38632;6411;2.7;0.5
94;2021-02-12;1394;1540;40026;7951;2.8;0.6
94;2021-02-13;299;194;40325;8145;2.9;0.6
94;2021-02-14;30;70;40355;8215;2.9;0.6
94;2021-02-15;753;1475;41108;9690;2.9;0.7
94;2021-02-16;702;2317;41810;12007;3.0;0.9
94;2021-02-17;719;1264;42529;13271;3.0;0.9
94;2021-02-18;797;1408;43326;14679;3.1;1.0
94;2021-02-19;968;1178;44294;15857;3.2;1.1
94;2021-02-20;132;719;44426;16576;3.2;1.2
94;2021-02-21;21;144;44447;16720;3.2;1.2
94;2021-02-22;523;1024;44970;17744;3.2;1.3
94;2021-02-23;624;992;45594;18736;3.2;1.3
94;2021-02-24;693;664;46287;19400;3.3;1.4
94;2021-02-25;1071;1303;47358;20703;3.4;1.5
94;2021-02-26;1323;825;48681;21528;3.5;1.5
94;2021-02-27;518;431;49199;21959;3.5;1.6
94;2021-02-28;91;72;49290;22031;3.5;1.6
94;2021-03-01;885;766;50175;22797;3.6;1.6
94;2021-03-02;1568;798;51743;23595;3.7;1.7
94;2021-03-03;1952;866;53695;24461;3.8;1.7
94;2021-03-04;2857;1015;56552;25476;4.0;1.8
94;2021-03-05;3836;1230;60388;26706;4.3;1.9
94;2021-03-06;4821;526;65209;27232;4.6;1.9
94;2021-03-07;3689;534;68898;27766;4.9;2.0
94;2021-03-08;1919;682;70817;28448;5.0;2.0
94;2021-03-09;2558;801;73375;29249;5.2;2.1
94;2021-03-10;3201;947;76576;30196;5.4;2.1
94;2021-03-11;3839;897;80415;31093;5.7;2.2
94;2021-03-12;4584;769;84999;31862;6.0;2.3
94;2021-03-13;4132;390;89131;32252;6.3;2.3
94;2021-03-14;2115;154;91246;32406;6.5;2.3
94;2021-03-15;3171;757;94417;33163;6.7;2.4
94;2021-03-16;2776;435;97193;33598;6.9;2.4
94;2021-03-17;2860;459;100053;34057;7.1;2.4
94;2021-03-18;3266;441;103319;34498;7.3;2.5
94;2021-03-19;4272;703;107591;35201;7.7;2.5
94;2021-03-20;3692;299;111283;35500;7.9;2.5
94;2021-03-21;1465;383;112748;35883;8.0;2.6
94;2021-03-22;3221;658;115969;36541;8.2;2.6
94;2021-03-23;4516;731;120485;37272;8.6;2.7
94;2021-03-24;4627;624;125112;37896;8.9;2.7
94;2021-03-25;6321;690;131433;38586;9.3;2.7
94;2021-03-26;6091;813;137524;39399;9.8;2.8
94;2021-03-27;4470;281;141994;39680;10.1;2.8
94;2021-03-28;1892;112;143886;39792;10.2;2.8
94;2021-03-29;4130;1218;148016;41010;10.5;2.9
94;2021-03-30;5298;1353;153314;42363;10.9;3.0
94;2021-03-31;4912;1785;158226;44148;11.3;3.1
94;2021-04-01;5830;2311;164056;46459;11.7;3.3
94;2021-04-02;5246;2311;169302;48770;12.0;3.5
94;2021-04-03;3087;2497;172389;51267;12.3;3.6
94;2021-04-04;1051;764;173440;52031;12.3;3.7
94;2021-04-05;837;142;174277;52173;12.4;3.7
94;2021-04-06;3583;2529;177860;54702;12.6;3.9
94;2021-04-07;3864;2257;181724;56959;12.9;4.1
94;2021-04-08;4629;2063;186353;59022;13.3;4.2
94;2021-04-09;5364;2473;191717;61495;13.6;4.4
94;2021-04-10;2957;3004;194674;64499;13.8;4.6
94;2021-04-11;1268;1766;195942;66265;13.9;4.7
94;2021-04-12;3440;2274;199382;68539;14.2;4.9
94;2021-04-13;4312;3406;203694;71945;14.5;5.1
94;2021-04-14;3905;2699;207599;74644;14.8;5.3
94;2021-04-15;4453;2997;212052;77641;15.1;5.5
94;2021-04-16;4709;2849;216761;80490;15.4;5.7
94;2021-04-17;2461;2774;219222;83264;15.6;5.9
94;2021-04-18;919;1244;220141;84508;15.7;6.0
94;2021-04-19;2977;2446;223118;86954;15.9;6.2
94;2021-04-20;3275;2714;226393;89668;16.1;6.4
94;2021-04-21;3220;3166;229613;92834;16.3;6.6
94;2021-04-22;3911;3655;233524;96489;16.6;6.9
94;2021-04-23;4120;3995;237644;100484;16.9;7.1
94;2021-04-24;4265;3401;241909;103885;17.2;7.4
94;2021-04-25;2408;1512;244317;105397;17.4;7.5
94;2021-04-26;4011;3280;248328;108677;17.7;7.7
94;2021-04-27;5097;3369;253425;112046;18.0;8.0
94;2021-04-28;4832;3640;258257;115686;18.4;8.2
94;2021-04-29;6418;3808;264675;119494;18.8;8.5
94;2021-04-30;6487;3923;271162;123417;19.3;8.8
94;2021-05-01;4057;1066;275219;124483;19.6;8.9
94;2021-05-02;3050;1474;278269;125957;19.8;9.0
94;2021-05-03;5734;5327;284003;131284;20.2;9.3
94;2021-05-04;6097;3565;290100;134849;20.6;9.6
94;2021-05-05;6183;3427;296283;138276;21.1;9.8
94;2021-05-06;7163;3529;303446;141805;21.6;10.1
94;2021-05-07;6674;4118;310120;145923;22.1;10.4
94;2021-05-08;4906;2557;315026;148480;22.4;10.6
94;2021-05-09;4226;2252;319252;150732;22.7;10.7
94;2021-05-10;7713;3124;326965;153856;23.3;10.9
94;2021-05-11;8969;3932;335934;157788;23.9;11.2
94;2021-05-12;9576;3598;345510;161386;24.6;11.5
94;2021-05-13;8676;1369;354186;162755;25.2;11.6
94;2021-05-14;9867;3310;364053;166065;25.9;11.8
94;2021-05-15;8940;2163;372993;168228;26.5;12.0
94;2021-05-16;5067;911;378060;169139;26.9;12.0
94;2021-05-17;10836;2248;388896;171387;27.7;12.2
94;2021-05-18;11294;2449;400190;173836;28.5;12.4
94;2021-05-19;11675;3596;411865;177432;29.3;12.6
94;2021-05-20;12157;4360;424022;181792;30.2;12.9
94;2021-05-21;11873;3164;435895;184956;31.0;13.2
94;2021-05-22;10283;1972;446178;186928;31.7;13.3
94;2021-05-23;4998;712;451176;187640;32.1;13.3
94;2021-05-24;9669;1349;460845;188989;32.8;13.4
94;2021-05-25;9996;4268;470841;193257;33.5;13.7
94;2021-05-26;10292;3310;481133;196567;34.2;14.0
94;2021-05-27;10864;4588;491997;201155;35.0;14.3
94;2021-05-28;10443;4950;502440;206105;35.7;14.7
94;2021-05-29;9867;3457;512307;209562;36.4;14.9
94;2021-05-30;4785;931;517092;210493;36.8;15.0
94;2021-05-31;9985;4235;527077;214728;37.5;15.3
94;2021-06-01;10308;5091;537385;219819;38.2;15.6
94;2021-06-02;9353;4587;546738;224406;38.9;16.0
94;2021-06-03;9562;5604;556300;230010;39.6;16.4
94;2021-06-04;10403;6539;566703;236549;40.3;16.8
94;2021-06-05;9180;6249;575883;242798;41.0;17.3
94;2021-06-06;3984;1848;579867;244646;41.2;17.4
94;2021-06-07;8663;5971;588530;250617;41.9;17.8
94;2021-06-08;8996;7515;597526;258132;42.5;18.4
94;2021-06-09;8955;8166;606481;266298;43.1;18.9
94;2021-06-10;8800;10972;615281;277270;43.8;19.7
94;2021-06-11;7845;8394;623126;285664;44.3;20.3
94;2021-06-12;10259;6853;633385;292517;45.0;20.8
94;2021-06-13;3469;3263;636854;295780;45.3;21.0
94;2021-06-14;6958;8203;643812;303983;45.8;21.6
94;2021-06-15;7736;8820;651548;312803;46.3;22.2
94;2021-06-16;7243;8270;658791;321073;46.9;22.8
94;2021-06-17;6698;9060;665489;330133;47.3;23.5
94;2021-06-18;6573;11957;672062;342090;47.8;24.3
94;2021-06-19;6001;9585;678063;351675;48.2;25.0
94;2021-06-20;1888;4009;679951;355684;48.4;25.3
94;2021-06-21;4527;11185;684478;366869;48.7;26.1
94;2021-06-22;4843;10812;689321;377681;49.0;26.9
94;2021-06-23;4179;11151;693500;388832;49.3;27.7
94;2021-06-24;4970;10333;698470;399165;49.7;28.4
94;2021-06-25;4285;13732;702755;412897;50.0;29.4
94;2021-06-26;3136;12004;705891;424901;50.2;30.2
94;2021-06-27;1059;4998;706950;429899;50.3;30.6
94;2021-06-28;3494;12074;710444;441973;50.5;31.4
94;2021-06-29;4052;12175;714496;454148;50.8;32.3
94;2021-06-30;4364;11642;718860;465790;51.1;33.1
94;2021-07-01;5672;11115;724532;476905;51.5;33.9
94;2021-07-02;5327;12193;729859;489098;51.9;34.8
94;2021-07-03;3710;11799;733569;500897;52.2;35.6
94;2021-07-04;1517;5091;735086;505988;52.3;36.0
94;2021-07-05;4488;11425;739574;517413;52.6;36.8
94;2021-07-06;4619;10891;744193;528304;52.9;37.6
94;2021-07-07;5041;11083;749234;539387;53.3;38.4
94;2021-07-08;5102;10023;754336;549410;53.6;39.1
94;2021-07-09;6107;11878;760443;561288;54.1;39.9
94;2021-07-10;4122;11358;764565;572646;54.4;40.7
94;2021-07-11;1555;4719;766120;577365;54.5;41.1
94;2021-07-12;4336;11965;770456;589330;54.8;41.9
94;2021-07-13;6491;12045;776947;601375;55.3;42.8
94;2021-07-14;4294;5296;781241;606671;55.6;43.1
94;2021-07-15;7321;12367;788562;619038;56.1;44.0
94;2021-07-16;7847;11321;796409;630359;56.6;44.8
94;2021-07-17;6104;11326;802513;641685;57.1;45.6
94;2021-07-18;2629;4024;805142;645709;57.3;45.9
94;2021-07-19;6912;10448;812054;656157;57.8;46.7
94;2021-07-20;8567;10383;820621;666540;58.4;47.4
94;2021-07-21;8803;9584;829424;676124;59.0;48.1
94;2021-07-22;9791;9427;839215;685551;59.7;48.8
94;2021-07-23;9432;9411;848647;694962;60.4;49.4
94;2021-07-24;7214;8882;855861;703844;60.9;50.1
94;2021-07-25;2191;2742;858052;706586;61.0;50.3
94;2021-07-26;7970;8045;866022;714631;61.6;50.8
94;2021-07-27;8622;7003;874644;721634;62.2;51.3
94;2021-07-28;8811;6319;883455;727953;62.8;51.8
94;2021-07-29;9059;6375;892514;734328;63.5;52.2
94;2021-07-30;8207;6597;900721;740925;64.1;52.7
94;2021-07-31;7212;6309;907933;747234;64.6;53.1
94;2021-08-01;3203;1783;911136;749017;64.8;53.3
94;2021-08-02;6663;5470;917799;754487;65.3;53.7
94;2021-08-03;6371;5212;924170;759699;65.7;54.0
94;2021-08-04;6306;5131;930476;764830;66.2;54.4
94;2021-08-05;5849;5466;936325;770296;66.6;54.8
94;2021-08-06;5809;5845;942134;776141;67.0;55.2
94;2021-08-07;4250;4479;946384;780620;67.3;55.5
94;2021-08-08;1371;1717;947755;782337;67.4;55.6
94;2021-08-09;4890;6530;952645;788867;67.8;56.1
94;2021-08-10;5402;6311;958047;795178;68.1;56.6
94;2021-08-11;4275;5720;962322;800898;68.4;57.0
94;2021-08-12;4415;6504;966737;807402;68.8;57.4
94;2021-08-13;3782;5752;970519;813154;69.0;57.8
94;2021-08-14;2903;5737;973422;818891;69.2;58.2
94;2021-08-15;459;736;973881;819627;69.3;58.3
94;2021-08-16;3484;8281;977365;827908;69.5;58.9
94;2021-08-17;3375;8131;980740;836039;69.8;59.5
94;2021-08-18;3270;8608;984010;844647;70.0;60.1
94;2021-08-19;3333;6910;987343;851557;70.2;60.6
94;2021-08-20;3121;7754;990464;859311;70.4;61.1
94;2021-08-21;2564;7151;993028;866462;70.6;61.6
94;2021-08-22;896;2737;993924;869199;70.7;61.8
94;2021-08-23;2825;8449;996749;877648;70.9;62.4
94;2021-08-24;3142;7514;999891;885162;71.1;63.0
94;2021-08-25;2745;6745;1002636;891907;71.3;63.4
94;2021-08-26;2593;6146;1005229;898053;71.5;63.9
94;2021-08-27;2647;6572;1007876;904625;71.7;64.3
94;2021-08-28;2573;6491;1010449;911116;71.9;64.8
94;2021-08-29;868;2347;1011317;913463;71.9;65.0
94;2021-08-30;2828;7885;1014145;921348;72.1;65.5
94;2021-08-31;2600;7444;1016745;928792;72.3;66.1
94;2021-09-01;2324;6201;1019069;934993;72.5;66.5
94;2021-09-02;1963;5212;1021032;940205;72.6;66.9
94;2021-09-03;2097;5813;1023129;946018;72.8;67.3
94;2021-09-04;2391;5415;1025520;951433;72.9;67.7
94;2021-09-05;704;1287;1026224;952720;73.0;67.8
94;2021-09-06;1544;4082;1027768;956802;73.1;68.0
94;2021-09-07;1458;3740;1029226;960542;73.2;68.3
94;2021-09-08;1472;3723;1030698;964265;73.3;68.6
94;2021-09-09;1255;3445;1031953;967710;73.4;68.8
94;2021-09-10;1555;4072;1033508;971782;73.5;69.1
94;2021-09-11;1689;4508;1035197;976290;73.6;69.4
94;2021-09-12;416;1185;1035613;977475;73.7;69.5
94;2021-09-13;1038;2815;1036651;980290;73.7;69.7
94;2021-09-14;1314;3355;1037965;983645;73.8;70.0
94;2021-09-15;1274;3102;1039239;986747;73.9;70.2
94;2021-09-16;1035;2181;1040274;988928;74.0;70.3
94;2021-09-17;1146;2681;1041420;991609;74.1;70.5
94;2021-09-18;1104;3686;1042524;995295;74.1;70.8
94;2021-09-19;294;1038;1042818;996333;74.2;70.9
94;2021-09-20;777;1961;1043595;998294;74.2;71.0
94;2021-09-21;996;1778;1044591;1000072;74.3;71.1
94;2021-09-22;951;2364;1045542;1002436;74.4;71.3
94;2021-09-23;770;1694;1046312;1004130;74.4;71.4
94;2021-09-24;987;1966;1047299;1006096;74.5;71.6
94;2021-09-25;950;3049;1048249;1009145;74.6;71.8
94;2021-09-26;269;699;1048518;1009844;74.6;71.8
94;2021-09-27;665;1460;1049183;1011304;74.6;71.9
94;2021-09-28;653;1418;1049836;1012722;74.7;72.0
94;2021-09-29;831;1573;1050667;1014295;74.7;72.1
95;2020-12-27;3;0;3;0;0.0;0.0
95;2020-12-28;6;0;9;0;0.0;0.0
95;2020-12-29;0;0;9;0;0.0;0.0
95;2020-12-30;0;0;9;0;0.0;0.0
95;2020-12-31;2;0;11;0;0.0;0.0
95;2021-01-01;0;0;11;0;0.0;0.0
95;2021-01-02;13;0;24;0;0.0;0.0
95;2021-01-03;1;0;25;0;0.0;0.0
95;2021-01-04;50;0;75;0;0.0;0.0
95;2021-01-05;317;0;392;0;0.0;0.0
95;2021-01-06;191;0;583;0;0.0;0.0
95;2021-01-07;130;1;713;1;0.1;0.0
95;2021-01-08;279;2;992;3;0.1;0.0
95;2021-01-09;251;0;1243;3;0.1;0.0
95;2021-01-10;384;1;1627;4;0.1;0.0
95;2021-01-11;491;1;2118;5;0.2;0.0
95;2021-01-12;864;1;2982;6;0.2;0.0
95;2021-01-13;782;11;3764;17;0.3;0.0
95;2021-01-14;886;12;4650;29;0.4;0.0
95;2021-01-15;758;5;5408;34;0.4;0.0
95;2021-01-16;298;2;5706;36;0.5;0.0
95;2021-01-17;225;0;5931;36;0.5;0.0
95;2021-01-18;1338;5;7269;41;0.6;0.0
95;2021-01-19;1577;5;8846;46;0.7;0.0
95;2021-01-20;2039;3;10885;49;0.9;0.0
95;2021-01-21;1855;5;12740;54;1.0;0.0
95;2021-01-22;1325;6;14065;60;1.1;0.0
95;2021-01-23;648;0;14713;60;1.2;0.0
95;2021-01-24;182;0;14895;60;1.2;0.0
95;2021-01-25;796;32;15691;92;1.3;0.0
95;2021-01-26;988;159;16679;251;1.3;0.0
95;2021-01-27;1251;154;17930;405;1.4;0.0
95;2021-01-28;1720;20;19650;425;1.6;0.0
95;2021-01-29;1250;177;20900;602;1.7;0.0
95;2021-01-30;478;4;21378;606;1.7;0.0
95;2021-01-31;212;1;21590;607;1.7;0.0
95;2021-02-01;566;245;22156;852;1.8;0.1
95;2021-02-02;528;262;22684;1114;1.8;0.1
95;2021-02-03;614;489;23298;1603;1.9;0.1
95;2021-02-04;1068;350;24366;1953;2.0;0.2
95;2021-02-05;733;276;25099;2229;2.0;0.2
95;2021-02-06;338;211;25437;2440;2.0;0.2
95;2021-02-07;142;346;25579;2786;2.0;0.2
95;2021-02-08;765;307;26344;3093;2.1;0.2
95;2021-02-09;1134;1001;27478;4094;2.2;0.3
95;2021-02-10;1263;1316;28741;5410;2.3;0.4
95;2021-02-11;1386;1079;30127;6489;2.4;0.5
95;2021-02-12;1031;903;31158;7392;2.5;0.6
95;2021-02-13;329;261;31487;7653;2.5;0.6
95;2021-02-14;43;148;31530;7801;2.5;0.6
95;2021-02-15;430;786;31960;8587;2.6;0.7
95;2021-02-16;493;626;32453;9213;2.6;0.7
95;2021-02-17;654;909;33107;10122;2.7;0.8
95;2021-02-18;724;1313;33831;11435;2.7;0.9
95;2021-02-19;783;1050;34614;12485;2.8;1.0
95;2021-02-20;306;374;34920;12859;2.8;1.0
95;2021-02-21;165;252;35085;13111;2.8;1.1
95;2021-02-22;327;780;35412;13891;2.8;1.1
95;2021-02-23;368;549;35780;14440;2.9;1.2
95;2021-02-24;310;696;36090;15136;2.9;1.2
95;2021-02-25;729;880;36819;16016;2.9;1.3
95;2021-02-26;991;683;37810;16699;3.0;1.3
95;2021-02-27;365;356;38175;17055;3.1;1.4
95;2021-02-28;61;192;38236;17247;3.1;1.4
95;2021-03-01;773;479;39009;17726;3.1;1.4
95;2021-03-02;1321;758;40330;18484;3.2;1.5
95;2021-03-03;1599;835;41929;19319;3.4;1.5
95;2021-03-04;3196;1052;45125;20371;3.6;1.6
95;2021-03-05;3647;1004;48772;21375;3.9;1.7
95;2021-03-06;4005;457;52777;21832;4.2;1.7
95;2021-03-07;4218;302;56995;22134;4.6;1.8
95;2021-03-08;1541;777;58536;22911;4.7;1.8
95;2021-03-09;2622;464;61158;23375;4.9;1.9
95;2021-03-10;2344;789;63502;24164;5.1;1.9
95;2021-03-11;3140;1092;66642;25256;5.3;2.0
95;2021-03-12;3519;774;70161;26030;5.6;2.1
95;2021-03-13;3515;412;73676;26442;5.9;2.1
95;2021-03-14;1981;293;75657;26735;6.1;2.1
95;2021-03-15;2371;304;78028;27039;6.3;2.2
95;2021-03-16;1575;407;79603;27446;6.4;2.2
95;2021-03-17;2103;410;81706;27856;6.5;2.2
95;2021-03-18;2799;370;84505;28226;6.8;2.3
95;2021-03-19;3475;362;87980;28588;7.0;2.3
95;2021-03-20;2592;204;90572;28792;7.3;2.3
95;2021-03-21;1205;244;91777;29036;7.4;2.3
95;2021-03-22;2936;365;94713;29401;7.6;2.4
95;2021-03-23;3439;459;98152;29860;7.9;2.4
95;2021-03-24;3946;519;102098;30379;8.2;2.4
95;2021-03-25;5859;654;107957;31033;8.6;2.5
95;2021-03-26;5429;688;113386;31721;9.1;2.5
95;2021-03-27;3748;227;117134;31948;9.4;2.6
95;2021-03-28;1535;121;118669;32069;9.5;2.6
95;2021-03-29;2894;572;121563;32641;9.7;2.6
95;2021-03-30;3886;1236;125449;33877;10.0;2.7
95;2021-03-31;3657;1669;129106;35546;10.3;2.8
95;2021-04-01;5484;2270;134590;37816;10.8;3.0
95;2021-04-02;3561;2748;138151;40564;11.1;3.2
95;2021-04-03;2095;2476;140246;43040;11.2;3.4
95;2021-04-04;1247;1198;141493;44238;11.3;3.5
95;2021-04-05;596;64;142089;44302;11.4;3.5
95;2021-04-06;1859;1538;143948;45840;11.5;3.7
95;2021-04-07;4953;2193;148901;48033;11.9;3.8
95;2021-04-08;4897;2467;153798;50500;12.3;4.0
95;2021-04-09;5435;2339;159233;52839;12.8;4.2
95;2021-04-10;3709;1435;162942;54274;13.1;4.3
95;2021-04-11;1567;1038;164509;55312;13.2;4.4
95;2021-04-12;3254;1610;167763;56922;13.4;4.6
95;2021-04-13;3141;1691;170904;58613;13.7;4.7
95;2021-04-14;2751;1989;173655;60602;13.9;4.9
95;2021-04-15;3902;3349;177557;63951;14.2;5.1
95;2021-04-16;4064;3036;181621;66987;14.5;5.4
95;2021-04-17;2375;1757;183996;68744;14.7;5.5
95;2021-04-18;1511;1021;185507;69765;14.9;5.6
95;2021-04-19;2570;2371;188077;72136;15.1;5.8
95;2021-04-20;2121;2456;190198;74592;15.2;6.0
95;2021-04-21;3931;2630;194129;77222;15.6;6.2
95;2021-04-22;3413;4632;197542;81854;15.8;6.6
95;2021-04-23;2765;3555;200307;85409;16.0;6.8
95;2021-04-24;3571;2587;203878;87996;16.3;7.0
95;2021-04-25;1959;1550;205837;89546;16.5;7.2
95;2021-04-26;2753;2701;208590;92247;16.7;7.4
95;2021-04-27;3852;2180;212442;94427;17.0;7.6
95;2021-04-28;3890;2661;216332;97088;17.3;7.8
95;2021-04-29;6142;4541;222474;101629;17.8;8.1
95;2021-04-30;6904;2934;229378;104563;18.4;8.4
95;2021-05-01;2370;918;231748;105481;18.6;8.4
95;2021-05-02;2448;1501;234196;106982;18.8;8.6
95;2021-05-03;5126;1927;239322;108909;19.2;8.7
95;2021-05-04;6352;2724;245674;111633;19.7;8.9
95;2021-05-05;5146;3801;250820;115434;20.1;9.2
95;2021-05-06;8206;4923;259026;120357;20.7;9.6
95;2021-05-07;5778;4748;264804;125105;21.2;10.0
95;2021-05-08;5742;1535;270546;126640;21.7;10.1
95;2021-05-09;2830;1592;273376;128232;21.9;10.3
95;2021-05-10;9970;3191;283346;131423;22.7;10.5
95;2021-05-11;8450;3454;291796;134877;23.4;10.8
95;2021-05-12;9465;3223;301261;138100;24.1;11.1
95;2021-05-13;7953;1202;309214;139302;24.8;11.2
95;2021-05-14;7014;1910;316228;141212;25.3;11.3
95;2021-05-15;4511;1063;320739;142275;25.7;11.4
95;2021-05-16;4824;846;325563;143121;26.1;11.5
95;2021-05-17;7737;1352;333300;144473;26.7;11.6
95;2021-05-18;9465;1857;342765;146330;27.5;11.7
95;2021-05-19;9244;2496;352009;148826;28.2;11.9
95;2021-05-20;12585;2445;364594;151271;29.2;12.1
95;2021-05-21;10172;2537;374766;153808;30.0;12.3
95;2021-05-22;9394;1570;384160;155378;30.8;12.4
95;2021-05-23;4144;960;388304;156338;31.1;12.5
95;2021-05-24;2396;535;390700;156873;31.3;12.6
95;2021-05-25;7210;2082;397910;158955;31.9;12.7
95;2021-05-26;8850;3119;406760;162074;32.6;13.0
95;2021-05-27;10360;4429;417120;166503;33.4;13.3
95;2021-05-28;7683;4413;424803;170916;34.0;13.7
95;2021-05-29;5264;2760;430067;173676;34.5;13.9
95;2021-05-30;3733;1709;433800;175385;34.7;14.0
95;2021-05-31;6424;3327;440224;178712;35.3;14.3
95;2021-06-01;8782;3810;449006;182522;36.0;14.6
95;2021-06-02;8730;4749;457736;187271;36.7;15.0
95;2021-06-03;8524;6562;466260;193833;37.3;15.5
95;2021-06-04;8882;4404;475142;198237;38.1;15.9
95;2021-06-05;8335;3747;483477;201984;38.7;16.2
95;2021-06-06;4834;1622;488311;203606;39.1;16.3
95;2021-06-07;6058;4543;494369;208149;39.6;16.7
95;2021-06-08;6550;5514;500919;213663;40.1;17.1
95;2021-06-09;6253;6477;507172;220140;40.6;17.6
95;2021-06-10;6428;6813;513600;226953;41.1;18.2
95;2021-06-11;7222;6442;520822;233395;41.7;18.7
95;2021-06-12;6002;4373;526824;237768;42.2;19.0
95;2021-06-13;2082;3289;528906;241057;42.4;19.3
95;2021-06-14;5371;5989;534277;247046;42.8;19.8
95;2021-06-15;5739;8070;540016;255116;43.3;20.4
95;2021-06-16;5491;7536;545507;262652;43.7;21.0
95;2021-06-17;6599;8162;552106;270814;44.2;21.7
95;2021-06-18;5822;7861;557928;278675;44.7;22.3
95;2021-06-19;4967;8926;562895;287601;45.1;23.0
95;2021-06-20;1424;3316;564319;290917;45.2;23.3
95;2021-06-21;3533;7712;567852;298629;45.5;23.9
95;2021-06-22;5066;9055;572918;307684;45.9;24.6
95;2021-06-23;4774;10875;577692;318559;46.3;25.5
95;2021-06-24;4941;10723;582633;329282;46.7;26.4
95;2021-06-25;4878;10357;587511;339639;47.1;27.2
95;2021-06-26;4320;8477;591831;348116;47.4;27.9
95;2021-06-27;1032;3994;592863;352110;47.5;28.2
95;2021-06-28;2739;9486;595602;361596;47.7;29.0
95;2021-06-29;2537;8785;598139;370381;47.9;29.7
95;2021-06-30;3952;9996;602091;380377;48.2;30.5
95;2021-07-01;4864;11165;606955;391542;48.6;31.4
95;2021-07-02;4260;10544;611215;402086;49.0;32.2
95;2021-07-03;3526;9155;614741;411241;49.2;32.9
95;2021-07-04;1278;3399;616019;414640;49.3;33.2
95;2021-07-05;2357;4374;618376;419014;49.5;33.6
95;2021-07-06;2773;7752;621149;426766;49.8;34.2
95;2021-07-07;3960;9620;625109;436386;50.1;35.0
95;2021-07-08;5311;9820;630420;446206;50.5;35.7
95;2021-07-09;4552;10076;634972;456282;50.9;36.6
95;2021-07-10;3399;7391;638371;463673;51.1;37.1
95;2021-07-11;1526;3603;639897;467276;51.3;37.4
95;2021-07-12;2991;9692;642888;476968;51.5;38.2
95;2021-07-13;5054;10070;647942;487038;51.9;39.0
95;2021-07-14;4427;5740;652369;492778;52.3;39.5
95;2021-07-15;7400;12362;659769;505140;52.9;40.5
95;2021-07-16;7985;12003;667754;517143;53.5;41.4
95;2021-07-17;5054;7823;672808;524966;53.9;42.1
95;2021-07-18;3481;2912;676289;527878;54.2;42.3
95;2021-07-19;4832;6866;681121;534744;54.6;42.8
95;2021-07-20;6957;8382;688078;543126;55.1;43.5
95;2021-07-21;9258;9451;697336;552577;55.9;44.3
95;2021-07-22;10147;9725;707483;562302;56.7;45.0
95;2021-07-23;10916;10204;718399;572506;57.5;45.9
95;2021-07-24;5259;6235;723658;578741;58.0;46.4
95;2021-07-25;2251;2284;725909;581025;58.1;46.5
95;2021-07-26;4522;4022;730431;585047;58.5;46.9
95;2021-07-27;8500;7045;738931;592092;59.2;47.4
95;2021-07-28;9718;7561;748649;599653;60.0;48.0
95;2021-07-29;8430;5470;757079;605123;60.6;48.5
95;2021-07-30;8518;7774;765597;612897;61.3;49.1
95;2021-07-31;4239;4102;769836;616999;61.7;49.4
95;2021-08-01;2335;1374;772171;618373;61.9;49.5
95;2021-08-02;4157;3917;776328;622290;62.2;49.8
95;2021-08-03;6154;5538;782482;627828;62.7;50.3
95;2021-08-04;6508;6087;788990;633915;63.2;50.8
95;2021-08-05;6868;5730;795858;639645;63.8;51.2
95;2021-08-06;6512;7065;802370;646710;64.3;51.8
95;2021-08-07;2843;3038;805213;649748;64.5;52.0
95;2021-08-08;1369;1888;806582;651636;64.6;52.2
95;2021-08-09;3926;5035;810508;656671;64.9;52.6
95;2021-08-10;5242;5842;815750;662513;65.3;53.1
95;2021-08-11;5366;6562;821116;669075;65.8;53.6
95;2021-08-12;5223;6363;826339;675438;66.2;54.1
95;2021-08-13;3907;5473;830246;680911;66.5;54.5
95;2021-08-14;3566;3322;833812;684233;66.8;54.8
95;2021-08-15;282;361;834094;684594;66.8;54.8
95;2021-08-16;2856;6054;836950;690648;67.0;55.3
95;2021-08-17;3621;7263;840571;697911;67.3;55.9
95;2021-08-18;4274;8073;844845;705984;67.7;56.6
95;2021-08-19;3792;6590;848637;712574;68.0;57.1
95;2021-08-20;3791;7928;852428;720502;68.3;57.7
95;2021-08-21;2715;4302;855143;724804;68.5;58.1
95;2021-08-22;857;2398;856000;727202;68.6;58.3
95;2021-08-23;2468;5650;858468;732852;68.8;58.7
95;2021-08-24;2959;6463;861427;739315;69.0;59.2
95;2021-08-25;3767;8293;865194;747608;69.3;59.9
95;2021-08-26;3162;7534;868356;755142;69.6;60.5
95;2021-08-27;3514;8721;871870;763863;69.8;61.2
95;2021-08-28;2797;5494;874667;769357;70.1;61.6
95;2021-08-29;638;1711;875305;771068;70.1;61.8
95;2021-08-30;2762;6189;878067;777257;70.3;62.3
95;2021-08-31;2811;6505;880878;783762;70.6;62.8
95;2021-09-01;2689;6481;883567;790243;70.8;63.3
95;2021-09-02;1680;4634;885247;794877;70.9;63.7
95;2021-09-03;2203;5837;887450;800714;71.1;64.1
95;2021-09-04;2520;5854;889970;806568;71.3;64.6
95;2021-09-05;413;639;890383;807207;71.3;64.7
95;2021-09-06;1224;3538;891607;810745;71.4;64.9
95;2021-09-07;1390;3458;892997;814203;71.5;65.2
95;2021-09-08;1648;4246;894645;818449;71.7;65.6
95;2021-09-09;1274;3695;895919;822144;71.8;65.9
95;2021-09-10;1549;4002;897468;826146;71.9;66.2
95;2021-09-11;1532;3823;899000;829969;72.0;66.5
95;2021-09-12;313;796;899313;830765;72.0;66.5
95;2021-09-13;871;2573;900184;833338;72.1;66.8
95;2021-09-14;1103;2753;901287;836091;72.2;67.0
95;2021-09-15;1273;3569;902560;839660;72.3;67.3
95;2021-09-16;886;1887;903446;841547;72.4;67.4
95;2021-09-17;1155;2875;904601;844422;72.5;67.6
95;2021-09-18;1263;4200;905864;848622;72.6;68.0
95;2021-09-19;232;583;906096;849205;72.6;68.0
95;2021-09-20;586;1413;906682;850618;72.6;68.1
95;2021-09-21;825;1804;907507;852422;72.7;68.3
95;2021-09-22;929;3074;908436;855496;72.8;68.5
95;2021-09-23;743;1190;909179;856686;72.8;68.6
95;2021-09-24;747;2039;909926;858725;72.9;68.8
95;2021-09-25;1013;3796;910939;862521;73.0;69.1
95;2021-09-26;133;409;911072;862930;73.0;69.1
95;2021-09-27;672;1185;911744;864115;73.0;69.2
95;2021-09-28;754;1400;912498;865515;73.1;69.3
95;2021-09-29;786;1891;913284;867406;73.2;69.5
971;2020-12-27;0;0;0;0;0.0;0.0
971;2020-12-28;0;0;0;0;0.0;0.0
971;2020-12-29;0;0;0;0;0.0;0.0
971;2020-12-30;0;0;0;0;0.0;0.0
971;2020-12-31;0;0;0;0;0.0;0.0
971;2021-01-01;1;0;1;0;0.0;0.0
971;2021-01-02;0;0;1;0;0.0;0.0
971;2021-01-03;0;0;1;0;0.0;0.0
971;2021-01-04;1;0;2;0;0.0;0.0
971;2021-01-05;0;0;2;0;0.0;0.0
971;2021-01-06;1;0;3;0;0.0;0.0
971;2021-01-07;0;0;3;0;0.0;0.0
971;2021-01-08;58;1;61;1;0.0;0.0
971;2021-01-09;20;0;81;1;0.0;0.0
971;2021-01-10;0;0;81;1;0.0;0.0
971;2021-01-11;60;0;141;1;0.0;0.0
971;2021-01-12;46;0;187;1;0.0;0.0
971;2021-01-13;47;1;234;2;0.1;0.0
971;2021-01-14;63;0;297;2;0.1;0.0
971;2021-01-15;77;0;374;2;0.1;0.0
971;2021-01-16;0;0;374;2;0.1;0.0
971;2021-01-17;0;0;374;2;0.1;0.0
971;2021-01-18;82;1;456;3;0.1;0.0
971;2021-01-19;147;0;603;3;0.2;0.0
971;2021-01-20;134;0;737;3;0.2;0.0
971;2021-01-21;155;1;892;4;0.2;0.0
971;2021-01-22;135;0;1027;4;0.3;0.0
971;2021-01-23;1;0;1028;4;0.3;0.0
971;2021-01-24;0;0;1028;4;0.3;0.0
971;2021-01-25;203;1;1231;5;0.3;0.0
971;2021-01-26;218;1;1449;6;0.4;0.0
971;2021-01-27;237;0;1686;6;0.4;0.0
971;2021-01-28;242;2;1928;8;0.5;0.0
971;2021-01-29;199;2;2127;10;0.6;0.0
971;2021-01-30;25;0;2152;10;0.6;0.0
971;2021-01-31;1;0;2153;10;0.6;0.0
971;2021-02-01;228;3;2381;13;0.6;0.0
971;2021-02-02;246;13;2627;26;0.7;0.0
971;2021-02-03;228;3;2855;29;0.8;0.0
971;2021-02-04;307;21;3162;50;0.8;0.0
971;2021-02-05;288;25;3450;75;0.9;0.0
971;2021-02-06;49;1;3499;76;0.9;0.0
971;2021-02-07;0;0;3499;76;0.9;0.0
971;2021-02-08;260;18;3759;94;1.0;0.0
971;2021-02-09;321;25;4080;119;1.1;0.0
971;2021-02-10;254;21;4334;140;1.1;0.0
971;2021-02-11;301;99;4635;239;1.2;0.1
971;2021-02-12;291;26;4926;265;1.3;0.1
971;2021-02-13;51;4;4977;269;1.3;0.1
971;2021-02-14;19;36;4996;305;1.3;0.1
971;2021-02-15;85;45;5081;350;1.3;0.1
971;2021-02-16;16;1;5097;351;1.4;0.1
971;2021-02-17;17;1;5114;352;1.4;0.1
971;2021-02-18;254;11;5368;363;1.4;0.1
971;2021-02-19;250;15;5618;378;1.5;0.1
971;2021-02-20;49;0;5667;378;1.5;0.1
971;2021-02-21;2;0;5669;378;1.5;0.1
971;2021-02-22;193;47;5862;425;1.6;0.1
971;2021-02-23;206;59;6068;484;1.6;0.1
971;2021-02-24;345;113;6413;597;1.7;0.2
971;2021-02-25;385;65;6798;662;1.8;0.2
971;2021-02-26;231;72;7029;734;1.9;0.2
971;2021-02-27;65;0;7094;734;1.9;0.2
971;2021-02-28;1;0;7095;734;1.9;0.2
971;2021-03-01;180;76;7275;810;1.9;0.2
971;2021-03-02;277;115;7552;925;2.0;0.2
971;2021-03-03;245;99;7797;1024;2.1;0.3
971;2021-03-04;336;74;8133;1098;2.2;0.3
971;2021-03-05;375;133;8508;1231;2.3;0.3
971;2021-03-06;598;9;9106;1240;2.4;0.3
971;2021-03-07;1;0;9107;1240;2.4;0.3
971;2021-03-08;327;132;9434;1372;2.5;0.4
971;2021-03-09;391;135;9825;1507;2.6;0.4
971;2021-03-10;436;155;10261;1662;2.7;0.4
971;2021-03-11;122;43;10383;1705;2.8;0.5
971;2021-03-12;502;216;10885;1921;2.9;0.5
971;2021-03-13;138;4;11023;1925;2.9;0.5
971;2021-03-14;14;21;11037;1946;2.9;0.5
971;2021-03-15;425;45;11462;1991;3.0;0.5
971;2021-03-16;488;81;11950;2072;3.2;0.5
971;2021-03-17;471;70;12421;2142;3.3;0.6
971;2021-03-18;588;82;13009;2224;3.5;0.6
971;2021-03-19;584;91;13593;2315;3.6;0.6
971;2021-03-20;177;15;13770;2330;3.7;0.6
971;2021-03-21;8;0;13778;2330;3.7;0.6
971;2021-03-22;361;87;14139;2417;3.8;0.6
971;2021-03-23;539;155;14678;2572;3.9;0.7
971;2021-03-24;474;97;15152;2669;4.0;0.7
971;2021-03-25;758;180;15910;2849;4.2;0.8
971;2021-03-26;644;120;16554;2969;4.4;0.8
971;2021-03-27;296;33;16850;3002;4.5;0.8
971;2021-03-28;24;2;16874;3004;4.5;0.8
971;2021-03-29;383;85;17257;3089;4.6;0.8
971;2021-03-30;626;164;17883;3253;4.7;0.9
971;2021-03-31;545;132;18428;3385;4.9;0.9
971;2021-04-01;663;197;19091;3582;5.1;1.0
971;2021-04-02;40;34;19131;3616;5.1;1.0
971;2021-04-03;62;2;19193;3618;5.1;1.0
971;2021-04-04;4;17;19197;3635;5.1;1.0
971;2021-04-05;13;0;19210;3635;5.1;1.0
971;2021-04-06;487;195;19697;3830;5.2;1.0
971;2021-04-07;581;118;20278;3948;5.4;1.0
971;2021-04-08;525;156;20803;4104;5.5;1.1
971;2021-04-09;486;210;21289;4314;5.6;1.1
971;2021-04-10;101;5;21390;4319;5.7;1.1
971;2021-04-11;8;9;21398;4328;5.7;1.1
971;2021-04-12;304;259;21702;4587;5.8;1.2
971;2021-04-13;555;325;22257;4912;5.9;1.3
971;2021-04-14;448;228;22705;5140;6.0;1.4
971;2021-04-15;553;311;23258;5451;6.2;1.4
971;2021-04-16;563;274;23821;5725;6.3;1.5
971;2021-04-17;216;4;24037;5729;6.4;1.5
971;2021-04-18;6;13;24043;5742;6.4;1.5
971;2021-04-19;405;243;24448;5985;6.5;1.6
971;2021-04-20;727;344;25175;6329;6.7;1.7
971;2021-04-21;627;319;25802;6648;6.8;1.8
971;2021-04-22;819;322;26621;6970;7.1;1.8
971;2021-04-23;845;249;27466;7219;7.3;1.9
971;2021-04-24;391;68;27857;7287;7.4;1.9
971;2021-04-25;601;63;28458;7350;7.6;2.0
971;2021-04-26;981;219;29439;7569;7.8;2.0
971;2021-04-27;716;235;30155;7804;8.0;2.1
971;2021-04-28;864;268;31019;8072;8.2;2.1
971;2021-04-29;1201;204;32220;8276;8.5;2.2
971;2021-04-30;1269;188;33489;8464;8.9;2.2
971;2021-05-01;607;39;34096;8503;9.0;2.3
971;2021-05-02;357;19;34453;8522;9.1;2.3
971;2021-05-03;925;191;35378;8713;9.4;2.3
971;2021-05-04;960;209;36338;8922;9.6;2.4
971;2021-05-05;1022;251;37360;9173;9.9;2.4
971;2021-05-06;1146;174;38506;9347;10.2;2.5
971;2021-05-07;1266;271;39772;9618;10.6;2.6
971;2021-05-08;324;38;40096;9656;10.6;2.6
971;2021-05-09;183;11;40279;9667;10.7;2.6
971;2021-05-10;848;218;41127;9885;10.9;2.6
971;2021-05-11;965;314;42092;10199;11.2;2.7
971;2021-05-12;907;325;42999;10524;11.4;2.8
971;2021-05-13;212;78;43211;10602;11.5;2.8
971;2021-05-14;861;271;44072;10873;11.7;2.9
971;2021-05-15;486;14;44558;10887;11.8;2.9
971;2021-05-16;182;35;44740;10922;11.9;2.9
971;2021-05-17;721;275;45461;11197;12.1;3.0
971;2021-05-18;743;389;46204;11586;12.3;3.1
971;2021-05-19;705;529;46909;12115;12.4;3.2
971;2021-05-20;811;376;47720;12491;12.7;3.3
971;2021-05-21;827;405;48547;12896;12.9;3.4
971;2021-05-22;508;214;49055;13110;13.0;3.5
971;2021-05-23;200;114;49255;13224;13.1;3.5
971;2021-05-24;201;173;49456;13397;13.1;3.6
971;2021-05-25;551;661;50007;14058;13.3;3.7
971;2021-05-26;595;491;50602;14549;13.4;3.9
971;2021-05-27;133;179;50735;14728;13.5;3.9
971;2021-05-28;520;525;51255;15253;13.6;4.0
971;2021-05-29;238;140;51493;15393;13.7;4.1
971;2021-05-30;75;112;51568;15505;13.7;4.1
971;2021-05-31;453;535;52021;16040;13.8;4.3
971;2021-06-01;591;706;52612;16746;14.0;4.4
971;2021-06-02;576;705;53188;17451;14.1;4.6
971;2021-06-03;509;558;53697;18009;14.2;4.8
971;2021-06-04;834;799;54531;18808;14.5;5.0
971;2021-06-05;317;644;54848;19452;14.6;5.2
971;2021-06-06;139;528;54987;19980;14.6;5.3
971;2021-06-07;421;781;55408;20761;14.7;5.5
971;2021-06-08;490;885;55898;21646;14.8;5.7
971;2021-06-09;503;857;56401;22503;15.0;6.0
971;2021-06-10;537;848;56938;23351;15.1;6.2
971;2021-06-11;470;1233;57408;24584;15.2;6.5
971;2021-06-12;303;658;57711;25242;15.3;6.7
971;2021-06-13;126;312;57837;25554;15.3;6.8
971;2021-06-14;371;3680;58208;29234;15.4;7.8
971;2021-06-15;483;1981;58691;31215;15.6;8.3
971;2021-06-16;478;1432;59169;32647;15.7;8.7
971;2021-06-17;432;1008;59601;33655;15.8;8.9
971;2021-06-18;483;1020;60084;34675;15.9;9.2
971;2021-06-19;313;509;60397;35184;16.0;9.3
971;2021-06-20;111;231;60508;35415;16.1;9.4
971;2021-06-21;348;674;60856;36089;16.1;9.6
971;2021-06-22;332;870;61188;36959;16.2;9.8
971;2021-06-23;370;891;61558;37850;16.3;10.0
971;2021-06-24;417;731;61975;38581;16.4;10.2
971;2021-06-25;456;757;62431;39338;16.6;10.4
971;2021-06-26;301;512;62732;39850;16.6;10.6
971;2021-06-27;116;148;62848;39998;16.7;10.6
971;2021-06-28;304;682;63152;40680;16.8;10.8
971;2021-06-29;388;780;63540;41460;16.9;11.0
971;2021-06-30;441;924;63981;42384;17.0;11.2
971;2021-07-01;364;649;64345;43033;17.1;11.4
971;2021-07-02;433;693;64778;43726;17.2;11.6
971;2021-07-03;274;464;65052;44190;17.3;11.7
971;2021-07-04;112;238;65164;44428;17.3;11.8
971;2021-07-05;331;505;65495;44933;17.4;11.9
971;2021-07-06;388;769;65883;45702;17.5;12.1
971;2021-07-07;378;842;66261;46544;17.6;12.3
971;2021-07-08;416;791;66677;47335;17.7;12.6
971;2021-07-09;435;796;67112;48131;17.8;12.8
971;2021-07-10;245;295;67357;48426;17.9;12.8
971;2021-07-11;170;137;67527;48563;17.9;12.9
971;2021-07-12;477;603;68004;49166;18.0;13.0
971;2021-07-13;882;1001;68886;50167;18.3;13.3
971;2021-07-14;476;283;69362;50450;18.4;13.4
971;2021-07-15;883;841;70245;51291;18.6;13.6
971;2021-07-16;1095;1041;71340;52332;18.9;13.9
971;2021-07-17;647;445;71987;52777;19.1;14.0
971;2021-07-18;401;221;72388;52998;19.2;14.1
971;2021-07-19;579;579;72967;53577;19.4;14.2
971;2021-07-20;839;735;73806;54312;19.6;14.4
971;2021-07-21;767;500;74573;54812;19.8;14.5
971;2021-07-22;988;875;75561;55687;20.0;14.8
971;2021-07-23;1033;756;76594;56443;20.3;15.0
971;2021-07-24;426;386;77020;56829;20.4;15.1
971;2021-07-25;247;262;77267;57091;20.5;15.1
971;2021-07-26;636;563;77903;57654;20.7;15.3
971;2021-07-27;882;588;78785;58242;20.9;15.5
971;2021-07-28;795;655;79580;58897;21.1;15.6
971;2021-07-29;970;673;80550;59570;21.4;15.8
971;2021-07-30;1321;755;81871;60325;21.7;16.0
971;2021-07-31;557;412;82428;60737;21.9;16.1
971;2021-08-01;315;251;82743;60988;22.0;16.2
971;2021-08-02;764;420;83507;61408;22.2;16.3
971;2021-08-03;763;675;84270;62083;22.4;16.5
971;2021-08-04;690;673;84960;62756;22.5;16.7
971;2021-08-05;698;594;85658;63350;22.7;16.8
971;2021-08-06;933;641;86591;63991;23.0;17.0
971;2021-08-07;452;391;87043;64382;23.1;17.1
971;2021-08-08;278;313;87321;64695;23.2;17.2
971;2021-08-09;592;584;87913;65279;23.3;17.3
971;2021-08-10;759;796;88672;66075;23.5;17.5
971;2021-08-11;925;791;89597;66866;23.8;17.7
971;2021-08-12;1013;801;90610;67667;24.0;18.0
971;2021-08-13;975;443;91585;68110;24.3;18.1
971;2021-08-14;634;701;92219;68811;24.5;18.3
971;2021-08-15;436;413;92655;69224;24.6;18.4
971;2021-08-16;823;742;93478;69966;24.8;18.6
971;2021-08-17;905;871;94383;70837;25.0;18.8
971;2021-08-18;1273;976;95656;71813;25.4;19.1
971;2021-08-19;1339;927;96995;72740;25.7;19.3
971;2021-08-20;1528;1047;98523;73787;26.1;19.6
971;2021-08-21;731;518;99254;74305;26.3;19.7
971;2021-08-22;363;272;99617;74577;26.4;19.8
971;2021-08-23;874;629;100491;75206;26.7;20.0
971;2021-08-24;1292;794;101783;76000;27.0;20.2
971;2021-08-25;1389;801;103172;76801;27.4;20.4
971;2021-08-26;1405;775;104577;77576;27.7;20.6
971;2021-08-27;1491;1099;106068;78675;28.1;20.9
971;2021-08-28;936;579;107004;79254;28.4;21.0
971;2021-08-29;222;239;107226;79493;28.5;21.1
971;2021-08-30;932;749;108158;80242;28.7;21.3
971;2021-08-31;1253;900;109411;81142;29.0;21.5
971;2021-09-01;1126;914;110537;82056;29.3;21.8
971;2021-09-02;1062;884;111599;82940;29.6;22.0
971;2021-09-03;975;1135;112574;84075;29.9;22.3
971;2021-09-04;533;629;113107;84704;30.0;22.5
971;2021-09-05;126;240;113233;84944;30.0;22.5
971;2021-09-06;605;705;113838;85649;30.2;22.7
971;2021-09-07;620;744;114458;86393;30.4;22.9
971;2021-09-08;699;1055;115157;87448;30.6;23.2
971;2021-09-09;634;1136;115791;88584;30.7;23.5
971;2021-09-10;734;1341;116525;89925;30.9;23.9
971;2021-09-11;402;696;116927;90621;31.0;24.0
971;2021-09-12;84;359;117011;90980;31.0;24.1
971;2021-09-13;357;655;117368;91635;31.1;24.3
971;2021-09-14;542;1146;117910;92781;31.3;24.6
971;2021-09-15;548;1167;118458;93948;31.4;24.9
971;2021-09-16;439;1084;118897;95032;31.5;25.2
971;2021-09-17;544;1478;119441;96510;31.7;25.6
971;2021-09-18;279;1019;119720;97529;31.8;25.9
971;2021-09-19;92;336;119812;97865;31.8;26.0
971;2021-09-20;233;963;120045;98828;31.9;26.2
971;2021-09-21;274;1190;120319;100018;31.9;26.5
971;2021-09-22;370;1194;120689;101212;32.0;26.9
971;2021-09-23;368;1223;121057;102435;32.1;27.2
971;2021-09-24;443;1279;121500;103714;32.2;27.5
971;2021-09-25;228;777;121728;104491;32.3;27.7
971;2021-09-26;72;227;121800;104718;32.3;27.8
971;2021-09-27;247;662;122047;105380;32.4;28.0
971;2021-09-28;252;831;122299;106211;32.5;28.2
971;2021-09-29;293;887;122592;107098;32.5;28.4
972;2020-12-27;0;0;0;0;0.0;0.0
972;2020-12-28;0;0;0;0;0.0;0.0
972;2020-12-29;0;0;0;0;0.0;0.0
972;2020-12-30;0;0;0;0;0.0;0.0
972;2020-12-31;0;0;0;0;0.0;0.0
972;2021-01-01;0;0;0;0;0.0;0.0
972;2021-01-02;0;0;0;0;0.0;0.0
972;2021-01-03;0;0;0;0;0.0;0.0
972;2021-01-04;0;0;0;0;0.0;0.0
972;2021-01-05;0;0;0;0;0.0;0.0
972;2021-01-06;5;0;5;0;0.0;0.0
972;2021-01-07;31;0;36;0;0.0;0.0
972;2021-01-08;90;0;126;0;0.0;0.0
972;2021-01-09;20;0;146;0;0.0;0.0
972;2021-01-10;0;0;146;0;0.0;0.0
972;2021-01-11;122;0;268;0;0.1;0.0
972;2021-01-12;79;0;347;0;0.1;0.0
972;2021-01-13;65;0;412;0;0.1;0.0
972;2021-01-14;88;1;500;1;0.1;0.0
972;2021-01-15;171;0;671;1;0.2;0.0
972;2021-01-16;51;0;722;1;0.2;0.0
972;2021-01-17;0;0;722;1;0.2;0.0
972;2021-01-18;158;0;880;1;0.2;0.0
972;2021-01-19;168;1;1048;2;0.3;0.0
972;2021-01-20;170;0;1218;2;0.3;0.0
972;2021-01-21;181;2;1399;4;0.4;0.0
972;2021-01-22;173;0;1572;4;0.4;0.0
972;2021-01-23;58;0;1630;4;0.5;0.0
972;2021-01-24;0;0;1630;4;0.5;0.0
972;2021-01-25;161;1;1791;5;0.5;0.0
972;2021-01-26;138;1;1929;6;0.5;0.0
972;2021-01-27;163;4;2092;10;0.6;0.0
972;2021-01-28;152;10;2244;20;0.6;0.0
972;2021-01-29;143;39;2387;59;0.7;0.0
972;2021-01-30;96;16;2483;75;0.7;0.0
972;2021-01-31;0;0;2483;75;0.7;0.0
972;2021-02-01;119;56;2602;131;0.7;0.0
972;2021-02-02;184;74;2786;205;0.8;0.1
972;2021-02-03;132;63;2918;268;0.8;0.1
972;2021-02-04;160;58;3078;326;0.9;0.1
972;2021-02-05;123;74;3201;400;0.9;0.1
972;2021-02-06;63;18;3264;418;0.9;0.1
972;2021-02-07;1;0;3265;418;0.9;0.1
972;2021-02-08;137;54;3402;472;0.9;0.1
972;2021-02-09;177;58;3579;530;1.0;0.1
972;2021-02-10;153;66;3732;596;1.0;0.2
972;2021-02-11;149;74;3881;670;1.1;0.2
972;2021-02-12;152;99;4033;769;1.1;0.2
972;2021-02-13;47;26;4080;795;1.1;0.2
972;2021-02-14;0;0;4080;795;1.1;0.2
972;2021-02-15;51;63;4131;858;1.2;0.2
972;2021-02-16;0;0;4131;858;1.2;0.2
972;2021-02-17;1;3;4132;861;1.2;0.2
972;2021-02-18;69;101;4201;962;1.2;0.3
972;2021-02-19;69;106;4270;1068;1.2;0.3
972;2021-02-20;48;50;4318;1118;1.2;0.3
972;2021-02-21;0;0;4318;1118;1.2;0.3
972;2021-02-22;102;52;4420;1170;1.2;0.3
972;2021-02-23;113;203;4533;1373;1.3;0.4
972;2021-02-24;106;192;4639;1565;1.3;0.4
972;2021-02-25;93;123;4732;1688;1.3;0.5
972;2021-02-26;132;144;4864;1832;1.4;0.5
972;2021-02-27;69;46;4933;1878;1.4;0.5
972;2021-02-28;0;0;4933;1878;1.4;0.5
972;2021-03-01;138;124;5071;2002;1.4;0.6
972;2021-03-02;158;63;5229;2065;1.5;0.6
972;2021-03-03;179;129;5408;2194;1.5;0.6
972;2021-03-04;152;122;5560;2316;1.5;0.6
972;2021-03-05;236;105;5796;2421;1.6;0.7
972;2021-03-06;119;52;5915;2473;1.6;0.7
972;2021-03-07;100;3;6015;2476;1.7;0.7
972;2021-03-08;196;124;6211;2600;1.7;0.7
972;2021-03-09;283;94;6494;2694;1.8;0.8
972;2021-03-10;322;122;6816;2816;1.9;0.8
972;2021-03-11;336;70;7152;2886;2.0;0.8
972;2021-03-12;413;52;7565;2938;2.1;0.8
972;2021-03-13;155;16;7720;2954;2.2;0.8
972;2021-03-14;4;1;7724;2955;2.2;0.8
972;2021-03-15;277;88;8001;3043;2.2;0.8
972;2021-03-16;305;54;8306;3097;2.3;0.9
972;2021-03-17;388;44;8694;3141;2.4;0.9
972;2021-03-18;437;44;9131;3185;2.5;0.9
972;2021-03-19;401;58;9532;3243;2.7;0.9
972;2021-03-20;149;47;9681;3290;2.7;0.9
972;2021-03-21;25;1;9706;3291;2.7;0.9
972;2021-03-22;361;114;10067;3405;2.8;0.9
972;2021-03-23;404;121;10471;3526;2.9;1.0
972;2021-03-24;429;104;10900;3630;3.0;1.0
972;2021-03-25;491;97;11391;3727;3.2;1.0
972;2021-03-26;634;105;12025;3832;3.4;1.1
972;2021-03-27;154;69;12179;3901;3.4;1.1
972;2021-03-28;81;0;12260;3901;3.4;1.1
972;2021-03-29;423;164;12683;4065;3.5;1.1
972;2021-03-30;469;239;13152;4304;3.7;1.2
972;2021-03-31;1150;189;14302;4493;4.0;1.3
972;2021-04-01;955;169;15257;4662;4.3;1.3
972;2021-04-02;896;14;16153;4676;4.5;1.3
972;2021-04-03;789;57;16942;4733;4.7;1.3
972;2021-04-04;751;13;17693;4746;4.9;1.3
972;2021-04-05;828;44;18521;4790;5.2;1.3
972;2021-04-06;885;136;19406;4926;5.4;1.4
972;2021-04-07;1437;326;20843;5252;5.8;1.5
972;2021-04-08;1307;272;22150;5524;6.2;1.5
972;2021-04-09;1239;316;23389;5840;6.5;1.6
972;2021-04-10;838;164;24227;6004;6.8;1.7
972;2021-04-11;620;14;24847;6018;6.9;1.7
972;2021-04-12;867;317;25714;6335;7.2;1.8
972;2021-04-13;881;327;26595;6662;7.4;1.9
972;2021-04-14;959;321;27554;6983;7.7;1.9
972;2021-04-15;959;299;28513;7282;7.9;2.0
972;2021-04-16;997;296;29510;7578;8.2;2.1
972;2021-04-17;530;161;30040;7739;8.4;2.2
972;2021-04-18;339;56;30379;7795;8.5;2.2
972;2021-04-19;668;342;31047;8137;8.7;2.3
972;2021-04-20;866;307;31913;8444;8.9;2.4
972;2021-04-21;1002;353;32915;8797;9.2;2.5
972;2021-04-22;605;308;33520;9105;9.3;2.5
972;2021-04-23;614;463;34134;9568;9.5;2.7
972;2021-04-24;364;197;34498;9765;9.6;2.7
972;2021-04-25;168;199;34666;9964;9.7;2.8
972;2021-04-26;516;540;35182;10504;9.8;2.9
972;2021-04-27;568;606;35750;11110;10.0;3.1
972;2021-04-28;448;690;36198;11800;10.1;3.3
972;2021-04-29;654;640;36852;12440;10.3;3.5
972;2021-04-30;771;682;37623;13122;10.5;3.7
972;2021-05-01;244;246;37867;13368;10.6;3.7
972;2021-05-02;227;512;38094;13880;10.6;3.9
972;2021-05-03;569;769;38663;14649;10.8;4.1
972;2021-05-04;525;678;39188;15327;10.9;4.3
972;2021-05-05;548;896;39736;16223;11.1;4.5
972;2021-05-06;546;785;40282;17008;11.2;4.7
972;2021-05-07;629;1015;40911;18023;11.4;5.0
972;2021-05-08;225;525;41136;18548;11.5;5.2
972;2021-05-09;172;505;41308;19053;11.5;5.3
972;2021-05-10;519;855;41827;19908;11.7;5.5
972;2021-05-11;476;869;42303;20777;11.8;5.8
972;2021-05-12;560;910;42863;21687;11.9;6.0
972;2021-05-13;275;532;43138;22219;12.0;6.2
972;2021-05-14;388;746;43526;22965;12.1;6.4
972;2021-05-15;233;578;43759;23543;12.2;6.6
972;2021-05-16;155;442;43914;23985;12.2;6.7
972;2021-05-17;474;753;44388;24738;12.4;6.9
972;2021-05-18;445;678;44833;25416;12.5;7.1
972;2021-05-19;453;744;45286;26160;12.6;7.3
972;2021-05-20;594;498;45880;26658;12.8;7.4
972;2021-05-21;544;683;46424;27341;12.9;7.6
972;2021-05-22;186;359;46610;27700;13.0;7.7
972;2021-05-23;111;182;46721;27882;13.0;7.8
972;2021-05-24;135;241;46856;28123;13.1;7.8
972;2021-05-25;350;697;47206;28820;13.2;8.0
972;2021-05-26;382;712;47588;29532;13.3;8.2
972;2021-05-27;271;647;47859;30179;13.3;8.4
972;2021-05-28;280;815;48139;30994;13.4;8.6
972;2021-05-29;154;513;48293;31507;13.5;8.8
972;2021-05-30;17;33;48310;31540;13.5;8.8
972;2021-05-31;346;678;48656;32218;13.6;9.0
972;2021-06-01;299;543;48955;32761;13.6;9.1
972;2021-06-02;325;575;49280;33336;13.7;9.3
972;2021-06-03;247;424;49527;33760;13.8;9.4
972;2021-06-04;350;642;49877;34402;13.9;9.6
972;2021-06-05;260;371;50137;34773;14.0;9.7
972;2021-06-06;25;32;50162;34805;14.0;9.7
972;2021-06-07;260;735;50422;35540;14.1;9.9
972;2021-06-08;255;585;50677;36125;14.1;10.1
972;2021-06-09;303;697;50980;36822;14.2;10.3
972;2021-06-10;308;450;51288;37272;14.3;10.4
972;2021-06-11;358;533;51646;37805;14.4;10.5
972;2021-06-12;232;320;51878;38125;14.5;10.6
972;2021-06-13;32;29;51910;38154;14.5;10.6
972;2021-06-14;367;547;52277;38701;14.6;10.8
972;2021-06-15;410;487;52687;39188;14.7;10.9
972;2021-06-16;436;435;53123;39623;14.8;11.0
972;2021-06-17;354;573;53477;40196;14.9;11.2
972;2021-06-18;458;537;53935;40733;15.0;11.4
972;2021-06-19;225;196;54160;40929;15.1;11.4
972;2021-06-20;25;17;54185;40946;15.1;11.4
972;2021-06-21;332;579;54517;41525;15.2;11.6
972;2021-06-22;297;462;54814;41987;15.3;11.7
972;2021-06-23;421;562;55235;42549;15.4;11.9
972;2021-06-24;329;437;55564;42986;15.5;12.0
972;2021-06-25;313;387;55877;43373;15.6;12.1
972;2021-06-26;222;201;56099;43574;15.6;12.1
972;2021-06-27;16;23;56115;43597;15.6;12.2
972;2021-06-28;336;421;56451;44018;15.7;12.3
972;2021-06-29;329;430;56780;44448;15.8;12.4
972;2021-06-30;440;420;57220;44868;15.9;12.5
972;2021-07-01;351;394;57571;45262;16.0;12.6
972;2021-07-02;124;200;57695;45462;16.1;12.7
972;2021-07-03;100;118;57795;45580;16.1;12.7
972;2021-07-04;24;36;57819;45616;16.1;12.7
972;2021-07-05;494;580;58313;46196;16.3;12.9
972;2021-07-06;488;429;58801;46625;16.4;13.0
972;2021-07-07;612;493;59413;47118;16.6;13.1
972;2021-07-08;491;422;59904;47540;16.7;13.3
972;2021-07-09;629;581;60533;48121;16.9;13.4
972;2021-07-10;405;308;60938;48429;17.0;13.5
972;2021-07-11;52;38;60990;48467;17.0;13.5
972;2021-07-12;847;697;61837;49164;17.2;13.7
972;2021-07-13;1474;706;63311;49870;17.6;13.9
972;2021-07-14;133;65;63444;49935;17.7;13.9
972;2021-07-15;1603;680;65047;50615;18.1;14.1
972;2021-07-16;1632;660;66679;51275;18.6;14.3
972;2021-07-17;1094;367;67773;51642;18.9;14.4
972;2021-07-18;56;39;67829;51681;18.9;14.4
972;2021-07-19;1148;652;68977;52333;19.2;14.6
972;2021-07-20;1129;577;70106;52910;19.5;14.7
972;2021-07-21;1089;601;71195;53511;19.8;14.9
972;2021-07-22;906;519;72101;54030;20.1;15.1
972;2021-07-23;967;484;73068;54514;20.4;15.2
972;2021-07-24;505;223;73573;54737;20.5;15.3
972;2021-07-25;50;63;73623;54800;20.5;15.3
972;2021-07-26;685;524;74308;55324;20.7;15.4
972;2021-07-27;1029;515;75337;55839;21.0;15.6
972;2021-07-28;645;561;75982;56400;21.2;15.7
972;2021-07-29;840;548;76822;56948;21.4;15.9
972;2021-07-30;902;615;77724;57563;21.7;16.0
972;2021-07-31;560;275;78284;57838;21.8;16.1
972;2021-08-01;83;33;78367;57871;21.8;16.1
972;2021-08-02;812;815;79179;58686;22.1;16.4
972;2021-08-03;730;742;79909;59428;22.3;16.6
972;2021-08-04;786;568;80695;59996;22.5;16.7
972;2021-08-05;915;590;81610;60586;22.7;16.9
972;2021-08-06;1197;895;82807;61481;23.1;17.1
972;2021-08-07;667;570;83474;62051;23.3;17.3
972;2021-08-08;85;83;83559;62134;23.3;17.3
972;2021-08-09;1129;1064;84688;63198;23.6;17.6
972;2021-08-10;1199;1040;85887;64238;23.9;17.9
972;2021-08-11;1234;920;87121;65158;24.3;18.2
972;2021-08-12;1450;930;88571;66088;24.7;18.4
972;2021-08-13;1317;644;89888;66732;25.1;18.6
972;2021-08-14;846;322;90734;67054;25.3;18.7
972;2021-08-15;70;55;90804;67109;25.3;18.7
972;2021-08-16;1278;1045;92082;68154;25.7;19.0
972;2021-08-17;1177;1187;93259;69341;26.0;19.3
972;2021-08-18;1237;1173;94496;70514;26.3;19.7
972;2021-08-19;1285;892;95781;71406;26.7;19.9
972;2021-08-20;1328;893;97109;72299;27.1;20.2
972;2021-08-21;758;626;97867;72925;27.3;20.3
972;2021-08-22;47;82;97914;73007;27.3;20.4
972;2021-08-23;1181;859;99095;73866;27.6;20.6
972;2021-08-24;1374;878;100469;74744;28.0;20.8
972;2021-08-25;1076;768;101545;75512;28.3;21.0
972;2021-08-26;1279;801;102824;76313;28.7;21.3
972;2021-08-27;1282;1077;104106;77390;29.0;21.6
972;2021-08-28;778;755;104884;78145;29.2;21.8
972;2021-08-29;100;64;104984;78209;29.3;21.8
972;2021-08-30;1142;1126;106126;79335;29.6;22.1
972;2021-08-31;906;1106;107032;80441;29.8;22.4
972;2021-09-01;811;1133;107843;81574;30.1;22.7
972;2021-09-02;872;1213;108715;82787;30.3;23.1
972;2021-09-03;766;1315;109481;84102;30.5;23.4
972;2021-09-04;613;908;110094;85010;30.7;23.7
972;2021-09-05;144;135;110238;85145;30.7;23.7
972;2021-09-06;597;1064;110835;86209;30.9;24.0
972;2021-09-07;629;985;111464;87194;31.1;24.3
972;2021-09-08;587;1146;112051;88340;31.2;24.6
972;2021-09-09;516;1118;112567;89458;31.4;24.9
972;2021-09-10;580;1346;113147;90804;31.5;25.3
972;2021-09-11;486;921;113633;91725;31.7;25.6
972;2021-09-12;107;113;113740;91838;31.7;25.6
972;2021-09-13;460;1128;114200;92966;31.8;25.9
972;2021-09-14;477;1151;114677;94117;32.0;26.2
972;2021-09-15;385;1088;115062;95205;32.1;26.5
972;2021-09-16;375;1069;115437;96274;32.2;26.8
972;2021-09-17;587;1269;116024;97543;32.3;27.2
972;2021-09-18;422;929;116446;98472;32.5;27.4
972;2021-09-19;41;120;116487;98592;32.5;27.5
972;2021-09-20;357;921;116844;99513;32.6;27.7
972;2021-09-21;425;985;117269;100498;32.7;28.0
972;2021-09-22;354;853;117623;101351;32.8;28.3
972;2021-09-23;399;824;118022;102175;32.9;28.5
972;2021-09-24;448;974;118470;103149;33.0;28.8
972;2021-09-25;329;835;118799;103984;33.1;29.0
972;2021-09-26;29;184;118828;104168;33.1;29.0
972;2021-09-27;299;666;119127;104834;33.2;29.2
972;2021-09-28;397;668;119524;105502;33.3;29.4
972;2021-09-29;342;633;119866;106135;33.4;29.6
973;2020-12-27;0;0;0;0;0.0;0.0
973;2020-12-28;0;0;0;0;0.0;0.0
973;2020-12-29;0;0;0;0;0.0;0.0
973;2020-12-30;0;0;0;0;0.0;0.0
973;2020-12-31;0;0;0;0;0.0;0.0
973;2021-01-01;0;0;0;0;0.0;0.0
973;2021-01-02;1;1;1;1;0.0;0.0
973;2021-01-03;0;0;1;1;0.0;0.0
973;2021-01-04;0;0;1;1;0.0;0.0
973;2021-01-05;0;0;1;1;0.0;0.0
973;2021-01-06;0;0;1;1;0.0;0.0
973;2021-01-07;0;0;1;1;0.0;0.0
973;2021-01-08;0;0;1;1;0.0;0.0
973;2021-01-09;0;0;1;1;0.0;0.0
973;2021-01-10;0;0;1;1;0.0;0.0
973;2021-01-11;0;0;1;1;0.0;0.0
973;2021-01-12;0;0;1;1;0.0;0.0
973;2021-01-13;30;0;31;1;0.0;0.0
973;2021-01-14;46;0;77;1;0.0;0.0
973;2021-01-15;35;0;112;1;0.0;0.0
973;2021-01-16;18;1;130;2;0.0;0.0
973;2021-01-17;0;0;130;2;0.0;0.0
973;2021-01-18;63;0;193;2;0.1;0.0
973;2021-01-19;151;1;344;3;0.1;0.0
973;2021-01-20;134;0;478;3;0.2;0.0
973;2021-01-21;118;0;596;3;0.2;0.0
973;2021-01-22;76;0;672;3;0.2;0.0
973;2021-01-23;0;0;672;3;0.2;0.0
973;2021-01-24;0;0;672;3;0.2;0.0
973;2021-01-25;56;0;728;3;0.3;0.0
973;2021-01-26;100;2;828;5;0.3;0.0
973;2021-01-27;109;1;937;6;0.3;0.0
973;2021-01-28;96;3;1033;9;0.4;0.0
973;2021-01-29;104;3;1137;12;0.4;0.0
973;2021-01-30;0;0;1137;12;0.4;0.0
973;2021-01-31;0;0;1137;12;0.4;0.0
973;2021-02-01;54;0;1191;12;0.4;0.0
973;2021-02-02;122;5;1313;17;0.5;0.0
973;2021-02-03;119;6;1432;23;0.5;0.0
973;2021-02-04;79;25;1511;48;0.5;0.0
973;2021-02-05;65;8;1576;56;0.5;0.0
973;2021-02-06;0;0;1576;56;0.5;0.0
973;2021-02-07;0;0;1576;56;0.5;0.0
973;2021-02-08;52;12;1628;68;0.6;0.0
973;2021-02-09;92;38;1720;106;0.6;0.0
973;2021-02-10;101;37;1821;143;0.6;0.0
973;2021-02-11;105;90;1926;233;0.7;0.1
973;2021-02-12;89;59;2015;292;0.7;0.1
973;2021-02-13;0;0;2015;292;0.7;0.1
973;2021-02-14;0;0;2015;292;0.7;0.1
973;2021-02-15;27;57;2042;349;0.7;0.1
973;2021-02-16;123;45;2165;394;0.7;0.1
973;2021-02-17;145;111;2310;505;0.8;0.2
973;2021-02-18;103;124;2413;629;0.8;0.2
973;2021-02-19;122;70;2535;699;0.9;0.2
973;2021-02-20;0;0;2535;699;0.9;0.2
973;2021-02-21;0;0;2535;699;0.9;0.2
973;2021-02-22;78;46;2613;745;0.9;0.3
973;2021-02-23;158;99;2771;844;1.0;0.3
973;2021-02-24;190;118;2961;962;1.0;0.3
973;2021-02-25;259;86;3220;1048;1.1;0.4
973;2021-02-26;264;62;3484;1110;1.2;0.4
973;2021-02-27;121;1;3605;1111;1.2;0.4
973;2021-02-28;0;0;3605;1111;1.2;0.4
973;2021-03-01;182;83;3787;1194;1.3;0.4
973;2021-03-02;256;103;4043;1297;1.4;0.4
973;2021-03-03;255;122;4298;1419;1.5;0.5
973;2021-03-04;281;84;4579;1503;1.6;0.5
973;2021-03-05;274;46;4853;1549;1.7;0.5
973;2021-03-06;118;2;4971;1551;1.7;0.5
973;2021-03-07;0;0;4971;1551;1.7;0.5
973;2021-03-08;188;39;5159;1590;1.8;0.5
973;2021-03-09;353;87;5512;1677;1.9;0.6
973;2021-03-10;360;105;5872;1782;2.0;0.6
973;2021-03-11;271;110;6143;1892;2.1;0.7
973;2021-03-12;288;96;6431;1988;2.2;0.7
973;2021-03-13;112;4;6543;1992;2.3;0.7
973;2021-03-14;0;0;6543;1992;2.3;0.7
973;2021-03-15;181;27;6724;2019;2.3;0.7
973;2021-03-16;243;140;6967;2159;2.4;0.7
973;2021-03-17;274;127;7241;2286;2.5;0.8
973;2021-03-18;249;154;7490;2440;2.6;0.8
973;2021-03-19;283;128;7773;2568;2.7;0.9
973;2021-03-20;259;17;8032;2585;2.8;0.9
973;2021-03-21;119;2;8151;2587;2.8;0.9
973;2021-03-22;219;109;8370;2696;2.9;0.9
973;2021-03-23;275;193;8645;2889;3.0;1.0
973;2021-03-24;235;215;8880;3104;3.1;1.1
973;2021-03-25;167;179;9047;3283;3.1;1.1
973;2021-03-26;189;301;9236;3584;3.2;1.2
973;2021-03-27;58;93;9294;3677;3.2;1.3
973;2021-03-28;0;0;9294;3677;3.2;1.3
973;2021-03-29;175;246;9469;3923;3.3;1.3
973;2021-03-30;446;237;9915;4160;3.4;1.4
973;2021-03-31;318;291;10233;4451;3.5;1.5
973;2021-04-01;446;260;10679;4711;3.7;1.6
973;2021-04-02;309;277;10988;4988;3.8;1.7
973;2021-04-03;159;121;11147;5109;3.8;1.8
973;2021-04-04;0;0;11147;5109;3.8;1.8
973;2021-04-05;118;14;11265;5123;3.9;1.8
973;2021-04-06;441;334;11706;5457;4.0;1.9
973;2021-04-07;502;344;12208;5801;4.2;2.0
973;2021-04-08;513;269;12721;6070;4.4;2.1
973;2021-04-09;498;226;13219;6296;4.5;2.2
973;2021-04-10;147;90;13366;6386;4.6;2.2
973;2021-04-11;2;0;13368;6386;4.6;2.2
973;2021-04-12;551;267;13919;6653;4.8;2.3
973;2021-04-13;673;244;14592;6897;5.0;2.4
973;2021-04-14;721;313;15313;7210;5.3;2.5
973;2021-04-15;776;248;16089;7458;5.5;2.6
973;2021-04-16;761;304;16850;7762;5.8;2.7
973;2021-04-17;499;137;17349;7899;6.0;2.7
973;2021-04-18;499;46;17848;7945;6.1;2.7
973;2021-04-19;715;252;18563;8197;6.4;2.8
973;2021-04-20;607;280;19170;8477;6.6;2.9
973;2021-04-21;873;250;20043;8727;6.9;3.0
973;2021-04-22;727;231;20770;8958;7.1;3.1
973;2021-04-23;705;232;21475;9190;7.4;3.2
973;2021-04-24;524;97;21999;9287;7.6;3.2
973;2021-04-25;611;50;22610;9337;7.8;3.2
973;2021-04-26;779;233;23389;9570;8.0;3.3
973;2021-04-27;818;344;24207;9914;8.3;3.4
973;2021-04-28;746;331;24953;10245;8.6;3.5
973;2021-04-29;666;286;25619;10531;8.8;3.6
973;2021-04-30;711;260;26330;10791;9.1;3.7
973;2021-05-01;211;29;26541;10820;9.1;3.7
973;2021-05-02;602;85;27143;10905;9.3;3.8
973;2021-05-03;554;390;27697;11295;9.5;3.9
973;2021-05-04;664;327;28361;11622;9.8;4.0
973;2021-05-05;700;455;29061;12077;10.0;4.2
973;2021-05-06;694;477;29755;12554;10.2;4.3
973;2021-05-07;595;474;30350;13028;10.4;4.5
973;2021-05-08;343;59;30693;13087;10.6;4.5
973;2021-05-09;262;72;30955;13159;10.6;4.5
973;2021-05-10;440;611;31395;13770;10.8;4.7
973;2021-05-11;398;497;31793;14267;10.9;4.9
973;2021-05-12;515;647;32308;14914;11.1;5.1
973;2021-05-13;333;99;32641;15013;11.2;5.2
973;2021-05-14;485;555;33126;15568;11.4;5.4
973;2021-05-15;256;348;33382;15916;11.5;5.5
973;2021-05-16;207;210;33589;16126;11.6;5.5
973;2021-05-17;445;599;34034;16725;11.7;5.8
973;2021-05-18;564;568;34598;17293;11.9;5.9
973;2021-05-19;534;552;35132;17845;12.1;6.1
973;2021-05-20;643;451;35775;18296;12.3;6.3
973;2021-05-21;505;609;36280;18905;12.5;6.5
973;2021-05-22;167;500;36447;19405;12.5;6.7
973;2021-05-23;271;475;36718;19880;12.6;6.8
973;2021-05-24;562;249;37280;20129;12.8;6.9
973;2021-05-25;501;745;37781;20874;13.0;7.2
973;2021-05-26;453;684;38234;21558;13.2;7.4
973;2021-05-27;712;527;38946;22085;13.4;7.6
973;2021-05-28;579;554;39525;22639;13.6;7.8
973;2021-05-29;259;360;39784;22999;13.7;7.9
973;2021-05-30;151;399;39935;23398;13.7;8.0
973;2021-05-31;356;573;40291;23971;13.9;8.2
973;2021-06-01;421;467;40712;24438;14.0;8.4
973;2021-06-02;563;554;41275;24992;14.2;8.6
973;2021-06-03;524;470;41799;25462;14.4;8.8
973;2021-06-04;601;496;42400;25958;14.6;8.9
973;2021-06-05;273;292;42673;26250;14.7;9.0
973;2021-06-06;211;301;42884;26551;14.8;9.1
973;2021-06-07;488;452;43372;27003;14.9;9.3
973;2021-06-08;544;315;43916;27318;15.1;9.4
973;2021-06-09;530;390;44446;27708;15.3;9.5
973;2021-06-10;358;290;44804;27998;15.4;9.6
973;2021-06-11;436;466;45240;28464;15.6;9.8
973;2021-06-12;170;283;45410;28747;15.6;9.9
973;2021-06-13;214;269;45624;29016;15.7;10.0
973;2021-06-14;384;549;46008;29565;15.8;10.2
973;2021-06-15;376;445;46384;30010;16.0;10.3
973;2021-06-16;489;459;46873;30469;16.1;10.5
973;2021-06-17;438;578;47311;31047;16.3;10.7
973;2021-06-18;389;562;47700;31609;16.4;10.9
973;2021-06-19;235;260;47935;31869;16.5;11.0
973;2021-06-20;126;270;48061;32139;16.5;11.1
973;2021-06-21;335;601;48396;32740;16.6;11.3
973;2021-06-22;376;462;48772;33202;16.8;11.4
973;2021-06-23;343;539;49115;33741;16.9;11.6
973;2021-06-24;446;500;49561;34241;17.0;11.8
973;2021-06-25;445;559;50006;34800;17.2;12.0
973;2021-06-26;172;320;50178;35120;17.3;12.1
973;2021-06-27;121;170;50299;35290;17.3;12.1
973;2021-06-28;314;593;50613;35883;17.4;12.3
973;2021-06-29;376;506;50989;36389;17.5;12.5
973;2021-06-30;410;680;51399;37069;17.7;12.8
973;2021-07-01;431;399;51830;37468;17.8;12.9
973;2021-07-02;511;524;52341;37992;18.0;13.1
973;2021-07-03;210;275;52551;38267;18.1;13.2
973;2021-07-04;86;243;52637;38510;18.1;13.2
973;2021-07-05;361;546;52998;39056;18.2;13.4
973;2021-07-06;373;473;53371;39529;18.4;13.6
973;2021-07-07;375;415;53746;39944;18.5;13.7
973;2021-07-08;316;328;54062;40272;18.6;13.9
973;2021-07-09;393;434;54455;40706;18.7;14.0
973;2021-07-10;168;278;54623;40984;18.8;14.1
973;2021-07-11;102;163;54725;41147;18.8;14.2
973;2021-07-12;403;497;55128;41644;19.0;14.3
973;2021-07-13;682;560;55810;42204;19.2;14.5
973;2021-07-14;394;161;56204;42365;19.3;14.6
973;2021-07-15;658;527;56862;42892;19.6;14.8
973;2021-07-16;602;485;57464;43377;19.8;14.9
973;2021-07-17;345;285;57809;43662;19.9;15.0
973;2021-07-18;251;124;58060;43786;20.0;15.1
973;2021-07-19;524;459;58584;44245;20.2;15.2
973;2021-07-20;572;494;59156;44739;20.4;15.4
973;2021-07-21;709;397;59865;45136;20.6;15.5
973;2021-07-22;660;452;60525;45588;20.8;15.7
973;2021-07-23;609;371;61134;45959;21.0;15.8
973;2021-07-24;325;241;61459;46200;21.1;15.9
973;2021-07-25;166;111;61625;46311;21.2;15.9
973;2021-07-26;446;345;62071;46656;21.4;16.1
973;2021-07-27;551;358;62622;47014;21.5;16.2
973;2021-07-28;467;370;63089;47384;21.7;16.3
973;2021-07-29;536;431;63625;47815;21.9;16.4
973;2021-07-30;541;408;64166;48223;22.1;16.6
973;2021-07-31;203;163;64369;48386;22.1;16.6
973;2021-08-01;139;132;64508;48518;22.2;16.7
973;2021-08-02;397;432;64905;48950;22.3;16.8
973;2021-08-03;432;402;65337;49352;22.5;17.0
973;2021-08-04;308;373;65645;49725;22.6;17.1
973;2021-08-05;343;363;65988;50088;22.7;17.2
973;2021-08-06;364;525;66352;50613;22.8;17.4
973;2021-08-07;164;266;66516;50879;22.9;17.5
973;2021-08-08;123;177;66639;51056;22.9;17.6
973;2021-08-09;332;473;66971;51529;23.0;17.7
973;2021-08-10;361;516;67332;52045;23.2;17.9
973;2021-08-11;584;518;67916;52563;23.4;18.1
973;2021-08-12;550;584;68466;53147;23.6;18.3
973;2021-08-13;367;234;68833;53381;23.7;18.4
973;2021-08-14;253;401;69086;53782;23.8;18.5
973;2021-08-15;122;138;69208;53920;23.8;18.5
973;2021-08-16;307;472;69515;54392;23.9;18.7
973;2021-08-17;371;400;69886;54792;24.0;18.8
973;2021-08-18;368;445;70254;55237;24.2;19.0
973;2021-08-19;331;481;70585;55718;24.3;19.2
973;2021-08-20;313;400;70898;56118;24.4;19.3
973;2021-08-21;161;257;71059;56375;24.4;19.4
973;2021-08-22;115;183;71174;56558;24.5;19.5
973;2021-08-23;286;384;71460;56942;24.6;19.6
973;2021-08-24;310;465;71770;57407;24.7;19.7
973;2021-08-25;284;347;72054;57754;24.8;19.9
973;2021-08-26;314;404;72368;58158;24.9;20.0
973;2021-08-27;365;426;72733;58584;25.0;20.2
973;2021-08-28;143;266;72876;58850;25.1;20.2
973;2021-08-29;87;186;72963;59036;25.1;20.3
973;2021-08-30;219;349;73182;59385;25.2;20.4
973;2021-08-31;298;377;73480;59762;25.3;20.6
973;2021-09-01;254;400;73734;60162;25.4;20.7
973;2021-09-02;298;411;74032;60573;25.5;20.8
973;2021-09-03;277;353;74309;60926;25.6;21.0
973;2021-09-04;147;201;74456;61127;25.6;21.0
973;2021-09-05;71;93;74527;61220;25.6;21.1
973;2021-09-06;168;239;74695;61459;25.7;21.1
973;2021-09-07;202;264;74897;61723;25.8;21.2
973;2021-09-08;218;421;75115;62144;25.8;21.4
973;2021-09-09;215;313;75330;62457;25.9;21.5
973;2021-09-10;224;325;75554;62782;26.0;21.6
973;2021-09-11;124;295;75678;63077;26.0;21.7
973;2021-09-12;60;98;75738;63175;26.1;21.7
973;2021-09-13;218;234;75956;63409;26.1;21.8
973;2021-09-14;264;307;76220;63716;26.2;21.9
973;2021-09-15;345;330;76565;64046;26.3;22.0
973;2021-09-16;264;239;76829;64285;26.4;22.1
973;2021-09-17;215;242;77044;64527;26.5;22.2
973;2021-09-18;113;242;77157;64769;26.5;22.3
973;2021-09-19;55;150;77212;64919;26.6;22.3
973;2021-09-20;146;185;77358;65104;26.6;22.4
973;2021-09-21;194;201;77552;65305;26.7;22.5
973;2021-09-22;184;348;77736;65653;26.7;22.6
973;2021-09-23;245;236;77981;65889;26.8;22.7
973;2021-09-24;258;308;78239;66197;26.9;22.8
973;2021-09-25;113;257;78352;66454;27.0;22.9
973;2021-09-26;39;93;78391;66547;27.0;22.9
973;2021-09-27;158;166;78549;66713;27.0;22.9
973;2021-09-28;155;204;78704;66917;27.1;23.0
973;2021-09-29;194;236;78898;67153;27.1;23.1
974;2020-12-27;0;0;0;0;0.0;0.0
974;2020-12-28;0;0;0;0;0.0;0.0
974;2020-12-29;0;0;0;0;0.0;0.0
974;2020-12-30;0;0;0;0;0.0;0.0
974;2020-12-31;0;0;0;0;0.0;0.0
974;2021-01-01;1;0;1;0;0.0;0.0
974;2021-01-02;0;0;1;0;0.0;0.0
974;2021-01-03;0;0;1;0;0.0;0.0
974;2021-01-04;0;0;1;0;0.0;0.0
974;2021-01-05;2;0;3;0;0.0;0.0
974;2021-01-06;0;0;3;0;0.0;0.0
974;2021-01-07;0;0;3;0;0.0;0.0
974;2021-01-08;0;0;3;0;0.0;0.0
974;2021-01-09;1;0;4;0;0.0;0.0
974;2021-01-10;0;0;4;0;0.0;0.0
974;2021-01-11;0;0;4;0;0.0;0.0
974;2021-01-12;0;0;4;0;0.0;0.0
974;2021-01-13;0;0;4;0;0.0;0.0
974;2021-01-14;0;0;4;0;0.0;0.0
974;2021-01-15;335;0;339;0;0.0;0.0
974;2021-01-16;27;0;366;0;0.0;0.0
974;2021-01-17;0;0;366;0;0.0;0.0
974;2021-01-18;49;1;415;1;0.0;0.0
974;2021-01-19;395;0;810;1;0.1;0.0
974;2021-01-20;485;1;1295;2;0.2;0.0
974;2021-01-21;614;2;1909;4;0.2;0.0
974;2021-01-22;414;1;2323;5;0.3;0.0
974;2021-01-23;75;0;2398;5;0.3;0.0
974;2021-01-24;0;0;2398;5;0.3;0.0
974;2021-01-25;273;2;2671;7;0.3;0.0
974;2021-01-26;429;0;3100;7;0.4;0.0
974;2021-01-27;316;0;3416;7;0.4;0.0
974;2021-01-28;409;0;3825;7;0.4;0.0
974;2021-01-29;422;3;4247;10;0.5;0.0
974;2021-01-30;421;1;4668;11;0.5;0.0
974;2021-01-31;0;0;4668;11;0.5;0.0
974;2021-02-01;373;4;5041;15;0.6;0.0
974;2021-02-02;502;3;5543;18;0.6;0.0
974;2021-02-03;602;9;6145;27;0.7;0.0
974;2021-02-04;629;16;6774;43;0.8;0.0
974;2021-02-05;564;97;7338;140;0.9;0.0
974;2021-02-06;501;6;7839;146;0.9;0.0
974;2021-02-07;0;8;7839;154;0.9;0.0
974;2021-02-08;470;32;8309;186;1.0;0.0
974;2021-02-09;787;63;9096;249;1.1;0.0
974;2021-02-10;820;86;9916;335;1.2;0.0
974;2021-02-11;795;86;10711;421;1.2;0.0
974;2021-02-12;638;91;11349;512;1.3;0.1
974;2021-02-13;655;75;12004;587;1.4;0.1
974;2021-02-14;1;0;12005;587;1.4;0.1
974;2021-02-15;526;123;12531;710;1.5;0.1
974;2021-02-16;651;524;13182;1234;1.5;0.1
974;2021-02-17;593;311;13775;1545;1.6;0.2
974;2021-02-18;495;384;14270;1929;1.7;0.2
974;2021-02-19;497;305;14767;2234;1.7;0.3
974;2021-02-20;577;106;15344;2340;1.8;0.3
974;2021-02-21;0;0;15344;2340;1.8;0.3
974;2021-02-22;403;208;15747;2548;1.8;0.3
974;2021-02-23;607;201;16354;2749;1.9;0.3
974;2021-02-24;583;219;16937;2968;2.0;0.3
974;2021-02-25;649;247;17586;3215;2.0;0.4
974;2021-02-26;485;407;18071;3622;2.1;0.4
974;2021-02-27;384;396;18455;4018;2.1;0.5
974;2021-02-28;0;0;18455;4018;2.1;0.5
974;2021-03-01;293;327;18748;4345;2.2;0.5
974;2021-03-02;487;434;19235;4779;2.2;0.6
974;2021-03-03;757;487;19992;5266;2.3;0.6
974;2021-03-04;778;450;20770;5716;2.4;0.7
974;2021-03-05;729;470;21499;6186;2.5;0.7
974;2021-03-06;813;496;22312;6682;2.6;0.8
974;2021-03-07;0;0;22312;6682;2.6;0.8
974;2021-03-08;436;494;22748;7176;2.6;0.8
974;2021-03-09;671;742;23419;7918;2.7;0.9
974;2021-03-10;644;795;24063;8713;2.8;1.0
974;2021-03-11;700;603;24763;9316;2.9;1.1
974;2021-03-12;731;644;25494;9960;3.0;1.2
974;2021-03-13;669;577;26163;10537;3.0;1.2
974;2021-03-14;2;0;26165;10537;3.0;1.2
974;2021-03-15;508;485;26673;11022;3.1;1.3
974;2021-03-16;681;675;27354;11697;3.2;1.4
974;2021-03-17;848;517;28202;12214;3.3;1.4
974;2021-03-18;1022;492;29224;12706;3.4;1.5
974;2021-03-19;786;524;30010;13230;3.5;1.5
974;2021-03-20;578;585;30588;13815;3.6;1.6
974;2021-03-21;0;0;30588;13815;3.6;1.6
974;2021-03-22;566;459;31154;14274;3.6;1.7
974;2021-03-23;780;632;31934;14906;3.7;1.7
974;2021-03-24;791;640;32725;15546;3.8;1.8
974;2021-03-25;934;531;33659;16077;3.9;1.9
974;2021-03-26;923;447;34582;16524;4.0;1.9
974;2021-03-27;781;334;35363;16858;4.1;2.0
974;2021-03-28;1;0;35364;16858;4.1;2.0
974;2021-03-29;960;270;36324;17128;4.2;2.0
974;2021-03-30;884;493;37208;17621;4.3;2.0
974;2021-03-31;736;652;37944;18273;4.4;2.1
974;2021-04-01;718;705;38662;18978;4.5;2.2
974;2021-04-02;688;753;39350;19731;4.6;2.3
974;2021-04-03;699;696;40049;20427;4.7;2.4
974;2021-04-04;0;0;40049;20427;4.7;2.4
974;2021-04-05;0;0;40049;20427;4.7;2.4
974;2021-04-06;796;635;40845;21062;4.7;2.4
974;2021-04-07;1367;780;42212;21842;4.9;2.5
974;2021-04-08;1792;771;44004;22613;5.1;2.6
974;2021-04-09;1509;775;45513;23388;5.3;2.7
974;2021-04-10;1137;643;46650;24031;5.4;2.8
974;2021-04-11;2;0;46652;24031;5.4;2.8
974;2021-04-12;1237;547;47889;24578;5.6;2.9
974;2021-04-13;1439;750;49328;25328;5.7;2.9
974;2021-04-14;2068;769;51396;26097;6.0;3.0
974;2021-04-15;2506;954;53902;27051;6.3;3.1
974;2021-04-16;1936;783;55838;27834;6.5;3.2
974;2021-04-17;1290;603;57128;28437;6.6;3.3
974;2021-04-18;0;0;57128;28437;6.6;3.3
974;2021-04-19;1374;562;58502;28999;6.8;3.4
974;2021-04-20;1651;804;60153;29803;7.0;3.5
974;2021-04-21;2124;626;62277;30429;7.2;3.5
974;2021-04-22;2952;821;65229;31250;7.6;3.6
974;2021-04-23;2311;820;67540;32070;7.9;3.7
974;2021-04-24;1111;803;68651;32873;8.0;3.8
974;2021-04-25;3;0;68654;32873;8.0;3.8
974;2021-04-26;1172;912;69826;33785;8.1;3.9
974;2021-04-27;1687;1027;71513;34812;8.3;4.0
974;2021-04-28;2901;747;74414;35559;8.7;4.1
974;2021-04-29;3947;814;78361;36373;9.1;4.2
974;2021-04-30;3450;905;81811;37278;9.5;4.3
974;2021-05-01;2106;227;83917;37505;9.8;4.4
974;2021-05-02;1;0;83918;37505;9.8;4.4
974;2021-05-03;1865;575;85783;38080;10.0;4.4
974;2021-05-04;2127;1092;87910;39172;10.2;4.6
974;2021-05-05;3119;1642;91029;40814;10.6;4.7
974;2021-05-06;4001;1587;95030;42401;11.1;4.9
974;2021-05-07;3229;1524;98259;43925;11.4;5.1
974;2021-05-08;1578;504;99837;44429;11.6;5.2
974;2021-05-09;2;1;99839;44430;11.6;5.2
974;2021-05-10;2413;1001;102252;45431;11.9;5.3
974;2021-05-11;3650;1640;105902;47071;12.3;5.5
974;2021-05-12;4721;2403;110623;49474;12.9;5.8
974;2021-05-13;3553;597;114176;50071;13.3;5.8
974;2021-05-14;5276;2519;119452;52590;13.9;6.1
974;2021-05-15;3157;1536;122609;54126;14.3;6.3
974;2021-05-16;17;18;122626;54144;14.3;6.3
974;2021-05-17;2995;1497;125621;55641;14.6;6.5
974;2021-05-18;3763;1802;129384;57443;15.0;6.7
974;2021-05-19;4688;2433;134072;59876;15.6;7.0
974;2021-05-20;5139;2853;139211;62729;16.2;7.3
974;2021-05-21;4996;2629;144207;65358;16.8;7.6
974;2021-05-22;3371;1255;147578;66613;17.2;7.7
974;2021-05-23;6;3;147584;66616;17.2;7.7
974;2021-05-24;3644;1078;151228;67694;17.6;7.9
974;2021-05-25;4248;1919;155476;69613;18.1;8.1
974;2021-05-26;4987;2992;160463;72605;18.7;8.4
974;2021-05-27;4620;4101;165083;76706;19.2;8.9
974;2021-05-28;4385;3837;169468;80543;19.7;9.4
974;2021-05-29;2554;2456;172022;82999;20.0;9.7
974;2021-05-30;8;14;172030;83013;20.0;9.7
974;2021-05-31;2347;2247;174377;85260;20.3;9.9
974;2021-06-01;3302;2761;177679;88021;20.7;10.2
974;2021-06-02;3968;3363;181647;91384;21.1;10.6
974;2021-06-03;4041;3652;185688;95036;21.6;11.1
974;2021-06-04;3849;3759;189537;98795;22.0;11.5
974;2021-06-05;2213;1931;191750;100726;22.3;11.7
974;2021-06-06;1074;134;192824;100860;22.4;11.7
974;2021-06-07;2012;2526;194836;103386;22.7;12.0
974;2021-06-08;2558;3338;197394;106724;23.0;12.4
974;2021-06-09;2983;4836;200377;111560;23.3;13.0
974;2021-06-10;3411;4462;203788;116022;23.7;13.5
974;2021-06-11;2840;4622;206628;120644;24.0;14.0
974;2021-06-12;1726;3376;208354;124020;24.2;14.4
974;2021-06-13;1324;246;209678;124266;24.4;14.5
974;2021-06-14;1488;3182;211166;127448;24.6;14.8
974;2021-06-15;2060;3617;213226;131065;24.8;15.2
974;2021-06-16;2748;4660;215974;135725;25.1;15.8
974;2021-06-17;2521;4895;218495;140620;25.4;16.4
974;2021-06-18;2595;4889;221090;145509;25.7;16.9
974;2021-06-19;1300;3516;222390;149025;25.9;17.3
974;2021-06-20;633;289;223023;149314;25.9;17.4
974;2021-06-21;1265;3235;224288;152549;26.1;17.7
974;2021-06-22;1619;3760;225907;156309;26.3;18.2
974;2021-06-23;2257;4993;228164;161302;26.5;18.8
974;2021-06-24;2280;4069;230444;165371;26.8;19.2
974;2021-06-25;2188;4106;232632;169477;27.1;19.7
974;2021-06-26;1401;2712;234033;172189;27.2;20.0
974;2021-06-27;664;268;234697;172457;27.3;20.1
974;2021-06-28;1307;2480;236004;174937;27.4;20.3
974;2021-06-29;1755;2846;237759;177783;27.6;20.7
974;2021-06-30;2561;3843;240320;181626;27.9;21.1
974;2021-07-01;2699;3826;243019;185452;28.3;21.6
974;2021-07-02;2511;3708;245530;189160;28.6;22.0
974;2021-07-03;1613;2456;247143;191616;28.7;22.3
974;2021-07-04;881;1038;248024;192654;28.8;22.4
974;2021-07-05;1696;2221;249720;194875;29.0;22.7
974;2021-07-06;2569;2545;252289;197420;29.3;23.0
974;2021-07-07;2664;3134;254953;200554;29.6;23.3
974;2021-07-08;2417;3172;257370;203726;29.9;23.7
974;2021-07-09;2761;3427;260131;207153;30.2;24.1
974;2021-07-10;1618;2192;261749;209345;30.4;24.3
974;2021-07-11;729;1017;262478;210362;30.5;24.5
974;2021-07-12;1745;2604;264223;212966;30.7;24.8
974;2021-07-13;4431;3345;268654;216311;31.2;25.2
974;2021-07-14;3300;607;271954;216918;31.6;25.2
974;2021-07-15;5556;4022;277510;220940;32.3;25.7
974;2021-07-16;6240;3299;283750;224239;33.0;26.1
974;2021-07-17;4373;1912;288123;226151;33.5;26.3
974;2021-07-18;2674;765;290797;226916;33.8;26.4
974;2021-07-19;4650;2030;295447;228946;34.4;26.6
974;2021-07-20;6233;2426;301680;231372;35.1;26.9
974;2021-07-21;6746;2860;308426;234232;35.9;27.2
974;2021-07-22;7140;2825;315566;237057;36.7;27.6
974;2021-07-23;6643;2980;322209;240037;37.5;27.9
974;2021-07-24;3800;2066;326009;242103;37.9;28.2
974;2021-07-25;2522;754;328531;242857;38.2;28.2
974;2021-07-26;4371;2097;332902;244954;38.7;28.5
974;2021-07-27;5442;2560;338344;247514;39.3;28.8
974;2021-07-28;5396;2905;343740;250419;40.0;29.1
974;2021-07-29;5743;2809;349483;253228;40.6;29.4
974;2021-07-30;5874;2581;355357;255809;41.3;29.7
974;2021-07-31;3936;1648;359293;257457;41.8;29.9
974;2021-08-01;1907;715;361200;258172;42.0;30.0
974;2021-08-02;3434;1865;364634;260037;42.4;30.2
974;2021-08-03;4301;4073;368935;264110;42.9;30.7
974;2021-08-04;4878;4232;373813;268342;43.5;31.2
974;2021-08-05;4446;4667;378259;273009;44.0;31.7
974;2021-08-06;4082;5104;382341;278113;44.5;32.3
974;2021-08-07;2748;4041;385089;282154;44.8;32.8
974;2021-08-08;1481;2265;386570;284419;45.0;33.1
974;2021-08-09;2574;4523;389144;288942;45.3;33.6
974;2021-08-10;3790;4961;392934;293903;45.7;34.2
974;2021-08-11;4634;5448;397568;299351;46.2;34.8
974;2021-08-12;4714;5917;402282;305268;46.8;35.5
974;2021-08-13;4457;5827;406739;311095;47.3;36.2
974;2021-08-14;2607;4329;409346;315424;47.6;36.7
974;2021-08-15;1573;2174;410919;317598;47.8;36.9
974;2021-08-16;2345;4180;413264;321778;48.1;37.4
974;2021-08-17;3184;4525;416448;326303;48.4;37.9
974;2021-08-18;3348;5901;419796;332204;48.8;38.6
974;2021-08-19;3311;4907;423107;337111;49.2;39.2
974;2021-08-20;3440;5274;426547;342385;49.6;39.8
974;2021-08-21;1835;4615;428382;347000;49.8;40.4
974;2021-08-22;1019;1944;429401;348944;49.9;40.6
974;2021-08-23;1815;3326;431216;352270;50.1;41.0
974;2021-08-24;2460;3773;433676;356043;50.4;41.4
974;2021-08-25;2905;5216;436581;361259;50.8;42.0
974;2021-08-26;2666;3870;439247;365129;51.1;42.5
974;2021-08-27;2778;4009;442025;369138;51.4;42.9
974;2021-08-28;1863;3880;443888;373018;51.6;43.4
974;2021-08-29;760;1573;444648;374591;51.7;43.6
974;2021-08-30;1565;2532;446213;377123;51.9;43.9
974;2021-08-31;1863;3350;448076;380473;52.1;44.2
974;2021-09-01;2408;4908;450484;385381;52.4;44.8
974;2021-09-02;2252;4316;452736;389697;52.6;45.3
974;2021-09-03;2339;4539;455075;394236;52.9;45.8
974;2021-09-04;1583;3920;456658;398156;53.1;46.3
974;2021-09-05;606;1338;457264;399494;53.2;46.5
974;2021-09-06;1214;2552;458478;402046;53.3;46.8
974;2021-09-07;1368;3204;459846;405250;53.5;47.1
974;2021-09-08;2105;3963;461951;409213;53.7;47.6
974;2021-09-09;1786;3431;463737;412644;53.9;48.0
974;2021-09-10;1918;3817;465655;416461;54.1;48.4
974;2021-09-11;1521;2509;467176;418970;54.3;48.7
974;2021-09-12;390;969;467566;419939;54.4;48.8
974;2021-09-13;1073;1939;468639;421878;54.5;49.1
974;2021-09-14;1505;2458;470144;424336;54.7;49.3
974;2021-09-15;1814;3025;471958;427361;54.9;49.7
974;2021-09-16;1382;2781;473340;430142;55.0;50.0
974;2021-09-17;1481;3062;474821;433204;55.2;50.4
974;2021-09-18;1196;1956;476017;435160;55.4;50.6
974;2021-09-19;290;717;476307;435877;55.4;50.7
974;2021-09-20;715;1631;477022;437508;55.5;50.9
974;2021-09-21;837;1814;477859;439322;55.6;51.1
974;2021-09-22;1248;2516;479107;441838;55.7;51.4
974;2021-09-23;844;2119;479951;443957;55.8;51.6
974;2021-09-24;1087;2466;481038;446423;55.9;51.9
974;2021-09-25;768;1879;481806;448302;56.0;52.1
974;2021-09-26;160;516;481966;448818;56.0;52.2
974;2021-09-27;608;1070;482574;449888;56.1;52.3
974;2021-09-28;851;1534;483425;451422;56.2;52.5
974;2021-09-29;1174;2324;484599;453746;56.4;52.8
976;2020-12-27;0;0;0;0;0.0;0.0
976;2020-12-28;0;0;0;0;0.0;0.0
976;2020-12-29;0;0;0;0;0.0;0.0
976;2020-12-30;0;0;0;0;0.0;0.0
976;2020-12-31;0;0;0;0;0.0;0.0
976;2021-01-01;0;0;0;0;0.0;0.0
976;2021-01-02;0;0;0;0;0.0;0.0
976;2021-01-03;0;0;0;0;0.0;0.0
976;2021-01-04;0;0;0;0;0.0;0.0
976;2021-01-05;0;0;0;0;0.0;0.0
976;2021-01-06;0;0;0;0;0.0;0.0
976;2021-01-07;0;0;0;0;0.0;0.0
976;2021-01-08;0;0;0;0;0.0;0.0
976;2021-01-09;0;0;0;0;0.0;0.0
976;2021-01-10;0;0;0;0;0.0;0.0
976;2021-01-11;9;0;9;0;0.0;0.0
976;2021-01-12;0;0;9;0;0.0;0.0
976;2021-01-13;0;0;9;0;0.0;0.0
976;2021-01-14;0;0;9;0;0.0;0.0
976;2021-01-15;1;0;10;0;0.0;0.0
976;2021-01-16;1;0;11;0;0.0;0.0
976;2021-01-17;0;0;11;0;0.0;0.0
976;2021-01-18;1;0;12;0;0.0;0.0
976;2021-01-19;0;0;12;0;0.0;0.0
976;2021-01-20;0;0;12;0;0.0;0.0
976;2021-01-21;1;1;13;1;0.0;0.0
976;2021-01-22;0;0;13;1;0.0;0.0
976;2021-01-23;1;0;14;1;0.0;0.0
976;2021-01-24;0;0;14;1;0.0;0.0
976;2021-01-25;144;3;158;4;0.1;0.0
976;2021-01-26;167;2;325;6;0.1;0.0
976;2021-01-27;250;3;575;9;0.2;0.0
976;2021-01-28;104;7;679;16;0.2;0.0
976;2021-01-29;233;3;912;19;0.3;0.0
976;2021-01-30;286;11;1198;30;0.4;0.0
976;2021-01-31;1;0;1199;30;0.4;0.0
976;2021-02-01;161;2;1360;32;0.5;0.0
976;2021-02-02;328;11;1688;43;0.6;0.0
976;2021-02-03;228;4;1916;47;0.7;0.0
976;2021-02-04;215;9;2131;56;0.8;0.0
976;2021-02-05;213;1;2344;57;0.8;0.0
976;2021-02-06;83;10;2427;67;0.9;0.0
976;2021-02-07;0;0;2427;67;0.9;0.0
976;2021-02-08;82;3;2509;70;0.9;0.0
976;2021-02-09;194;1;2703;71;1.0;0.0
976;2021-02-10;187;5;2890;76;1.0;0.0
976;2021-02-11;236;4;3126;80;1.1;0.0
976;2021-02-12;288;4;3414;84;1.2;0.0
976;2021-02-13;56;0;3470;84;1.2;0.0
976;2021-02-14;1;0;3471;84;1.2;0.0
976;2021-02-15;359;9;3830;93;1.4;0.0
976;2021-02-16;266;10;4096;103;1.5;0.0
976;2021-02-17;167;9;4263;112;1.5;0.0
976;2021-02-18;217;15;4480;127;1.6;0.0
976;2021-02-19;237;24;4717;151;1.7;0.1
976;2021-02-20;138;9;4855;160;1.7;0.1
976;2021-02-21;0;0;4855;160;1.7;0.1
976;2021-02-22;130;117;4985;277;1.8;0.1
976;2021-02-23;184;152;5169;429;1.8;0.2
976;2021-02-24;176;146;5345;575;1.9;0.2
976;2021-02-25;227;273;5572;848;2.0;0.3
976;2021-02-26;242;245;5814;1093;2.1;0.4
976;2021-02-27;0;0;5814;1093;2.1;0.4
976;2021-02-28;0;0;5814;1093;2.1;0.4
976;2021-03-01;146;255;5960;1348;2.1;0.5
976;2021-03-02;228;258;6188;1606;2.2;0.6
976;2021-03-03;202;190;6390;1796;2.3;0.6
976;2021-03-04;205;143;6595;1939;2.4;0.7
976;2021-03-05;225;116;6820;2055;2.4;0.7
976;2021-03-06;1;0;6821;2055;2.4;0.7
976;2021-03-07;1;0;6822;2055;2.4;0.7
976;2021-03-08;189;112;7011;2167;2.5;0.8
976;2021-03-09;390;163;7401;2330;2.6;0.8
976;2021-03-10;179;178;7580;2508;2.7;0.9
976;2021-03-11;167;207;7747;2715;2.8;1.0
976;2021-03-12;237;293;7984;3008;2.9;1.1
976;2021-03-13;3;0;7987;3008;2.9;1.1
976;2021-03-14;0;0;7987;3008;2.9;1.1
976;2021-03-15;157;295;8144;3303;2.9;1.2
976;2021-03-16;238;226;8382;3529;3.0;1.3
976;2021-03-17;264;145;8646;3674;3.1;1.3
976;2021-03-18;174;235;8820;3909;3.2;1.4
976;2021-03-19;173;296;8993;4205;3.2;1.5
976;2021-03-20;0;0;8993;4205;3.2;1.5
976;2021-03-21;0;0;8993;4205;3.2;1.5
976;2021-03-22;97;136;9090;4341;3.3;1.6
976;2021-03-23;136;238;9226;4579;3.3;1.6
976;2021-03-24;160;146;9386;4725;3.4;1.7
976;2021-03-25;184;206;9570;4931;3.4;1.8
976;2021-03-26;160;212;9730;5143;3.5;1.8
976;2021-03-27;18;0;9748;5143;3.5;1.8
976;2021-03-28;1;0;9749;5143;3.5;1.8
976;2021-03-29;0;2;9749;5145;3.5;1.8
976;2021-03-30;272;337;10021;5482;3.6;2.0
976;2021-03-31;225;124;10246;5606;3.7;2.0
976;2021-04-01;246;104;10492;5710;3.8;2.0
976;2021-04-02;285;262;10777;5972;3.9;2.1
976;2021-04-03;905;310;11682;6282;4.2;2.2
976;2021-04-04;2;0;11684;6282;4.2;2.2
976;2021-04-05;1;0;11685;6282;4.2;2.2
976;2021-04-06;161;277;11846;6559;4.2;2.3
976;2021-04-07;237;266;12083;6825;4.3;2.4
976;2021-04-08;283;140;12366;6965;4.4;2.5
976;2021-04-09;248;172;12614;7137;4.5;2.6
976;2021-04-10;181;114;12795;7251;4.6;2.6
976;2021-04-11;7;0;12802;7251;4.6;2.6
976;2021-04-12;0;18;12802;7269;4.6;2.6
976;2021-04-13;394;345;13196;7614;4.7;2.7
976;2021-04-14;239;205;13435;7819;4.8;2.8
976;2021-04-15;209;117;13644;7936;4.9;2.8
976;2021-04-16;214;127;13858;8063;5.0;2.9
976;2021-04-17;225;130;14083;8193;5.0;2.9
976;2021-04-18;1;0;14084;8193;5.0;2.9
976;2021-04-19;7;1;14091;8194;5.0;2.9
976;2021-04-20;367;221;14458;8415;5.2;3.0
976;2021-04-21;411;150;14869;8565;5.3;3.1
976;2021-04-22;410;150;15279;8715;5.5;3.1
976;2021-04-23;366;166;15645;8881;5.6;3.2
976;2021-04-24;413;128;16058;9009;5.7;3.2
976;2021-04-25;3;0;16061;9009;5.7;3.2
976;2021-04-26;55;8;16116;9017;5.8;3.2
976;2021-04-27;351;292;16467;9309;5.9;3.3
976;2021-04-28;355;512;16822;9821;6.0;3.5
976;2021-04-29;559;344;17381;10165;6.2;3.6
976;2021-04-30;408;238;17789;10403;6.4;3.7
976;2021-05-01;671;286;18460;10689;6.6;3.8
976;2021-05-02;0;0;18460;10689;6.6;3.8
976;2021-05-03;140;6;18600;10695;6.7;3.8
976;2021-05-04;354;425;18954;11120;6.8;4.0
976;2021-05-05;447;318;19401;11438;6.9;4.1
976;2021-05-06;320;202;19721;11640;7.1;4.2
976;2021-05-07;341;133;20062;11773;7.2;4.2
976;2021-05-08;309;141;20371;11914;7.3;4.3
976;2021-05-09;0;0;20371;11914;7.3;4.3
976;2021-05-10;9;9;20380;11923;7.3;4.3
976;2021-05-11;363;492;20743;12415;7.4;4.4
976;2021-05-12;334;310;21077;12725;7.5;4.6
976;2021-05-13;126;96;21203;12821;7.6;4.6
976;2021-05-14;0;0;21203;12821;7.6;4.6
976;2021-05-15;485;282;21688;13103;7.8;4.7
976;2021-05-16;1;0;21689;13103;7.8;4.7
976;2021-05-17;124;51;21813;13154;7.8;4.7
976;2021-05-18;518;430;22331;13584;8.0;4.9
976;2021-05-19;652;663;22983;14247;8.2;5.1
976;2021-05-20;1057;499;24040;14746;8.6;5.3
976;2021-05-21;1046;313;25086;15059;9.0;5.4
976;2021-05-22;1240;298;26326;15357;9.4;5.5
976;2021-05-23;0;0;26326;15357;9.4;5.5
976;2021-05-24;1;0;26327;15357;9.4;5.5
976;2021-05-25;886;622;27213;15979;9.7;5.7
976;2021-05-26;1033;842;28246;16821;10.1;6.0
976;2021-05-27;1321;512;29567;17333;10.6;6.2
976;2021-05-28;956;375;30523;17708;10.9;6.3
976;2021-05-29;1130;392;31653;18100;11.3;6.5
976;2021-05-30;1;1;31654;18101;11.3;6.5
976;2021-05-31;107;6;31761;18107;11.4;6.5
976;2021-06-01;1149;651;32910;18758;11.8;6.7
976;2021-06-02;1243;531;34153;19289;12.2;6.9
976;2021-06-03;813;355;34966;19644;12.5;7.0
976;2021-06-04;1000;325;35966;19969;12.9;7.1
976;2021-06-05;680;299;36646;20268;13.1;7.3
976;2021-06-06;1;0;36647;20268;13.1;7.3
976;2021-06-07;91;12;36738;20280;13.1;7.3
976;2021-06-08;952;442;37690;20722;13.5;7.4
976;2021-06-09;969;550;38659;21272;13.8;7.6
976;2021-06-10;704;232;39363;21504;14.1;7.7
976;2021-06-11;850;365;40213;21869;14.4;7.8
976;2021-06-12;583;275;40796;22144;14.6;7.9
976;2021-06-13;2;0;40798;22144;14.6;7.9
976;2021-06-14;187;112;40985;22256;14.7;8.0
976;2021-06-15;413;838;41398;23094;14.8;8.3
976;2021-06-16;891;1441;42289;24535;15.1;8.8
976;2021-06-17;797;661;43086;25196;15.4;9.0
976;2021-06-18;705;620;43791;25816;15.7;9.2
976;2021-06-19;537;644;44328;26460;15.9;9.5
976;2021-06-20;1;0;44329;26460;15.9;9.5
976;2021-06-21;127;132;44456;26592;15.9;9.5
976;2021-06-22;429;1150;44885;27742;16.1;9.9
976;2021-06-23;691;1186;45576;28928;16.3;10.4
976;2021-06-24;480;544;46056;29472;16.5;10.5
976;2021-06-25;542;479;46598;29951;16.7;10.7
976;2021-06-26;386;692;46984;30643;16.8;11.0
976;2021-06-27;1;0;46985;30643;16.8;11.0
976;2021-06-28;108;191;47093;30834;16.9;11.0
976;2021-06-29;742;973;47835;31807;17.1;11.4
976;2021-06-30;708;948;48543;32755;17.4;11.7
976;2021-07-01;583;547;49126;33302;17.6;11.9
976;2021-07-02;451;432;49577;33734;17.7;12.1
976;2021-07-03;443;422;50020;34156;17.9;12.2
976;2021-07-04;2;0;50022;34156;17.9;12.2
976;2021-07-05;121;223;50143;34379;17.9;12.3
976;2021-07-06;498;865;50641;35244;18.1;12.6
976;2021-07-07;770;1014;51411;36258;18.4;13.0
976;2021-07-08;827;636;52238;36894;18.7;13.2
976;2021-07-09;786;519;53024;37413;19.0;13.4
976;2021-07-10;441;319;53465;37732;19.1;13.5
976;2021-07-11;0;0;53465;37732;19.1;13.5
976;2021-07-12;164;170;53629;37902;19.2;13.6
976;2021-07-13;847;999;54476;38901;19.5;13.9
976;2021-07-14;0;5;54476;38906;19.5;13.9
976;2021-07-15;1220;812;55696;39718;19.9;14.2
976;2021-07-16;1292;657;56988;40375;20.4;14.4
976;2021-07-17;1033;377;58021;40752;20.8;14.6
976;2021-07-18;0;0;58021;40752;20.8;14.6
976;2021-07-19;206;134;58227;40886;20.8;14.6
976;2021-07-20;1155;877;59382;41763;21.2;14.9
976;2021-07-21;34;29;59416;41792;21.3;15.0
976;2021-07-22;1123;665;60539;42457;21.7;15.2
976;2021-07-23;1206;545;61745;43002;22.1;15.4
976;2021-07-24;855;440;62600;43442;22.4;15.5
976;2021-07-25;2;0;62602;43442;22.4;15.5
976;2021-07-26;180;37;62782;43479;22.5;15.6
976;2021-07-27;1138;826;63920;44305;22.9;15.9
976;2021-07-28;1040;634;64960;44939;23.2;16.1
976;2021-07-29;1232;566;66192;45505;23.7;16.3
976;2021-07-30;1212;412;67404;45917;24.1;16.4
976;2021-07-31;760;277;68164;46194;24.4;16.5
976;2021-08-01;5;3;68169;46197;24.4;16.5
976;2021-08-02;339;174;68508;46371;24.5;16.6
976;2021-08-03;1504;935;70012;47306;25.1;16.9
976;2021-08-04;1828;808;71840;48114;25.7;17.2
976;2021-08-05;1462;504;73302;48618;26.2;17.4
976;2021-08-06;1689;509;74991;49127;26.8;17.6
976;2021-08-07;912;357;75903;49484;27.2;17.7
976;2021-08-08;7;1;75910;49485;27.2;17.7
976;2021-08-09;529;236;76439;49721;27.4;17.8
976;2021-08-10;1641;1380;78080;51101;27.9;18.3
976;2021-08-11;2043;1239;80123;52340;28.7;18.7
976;2021-08-12;1709;619;81832;52959;29.3;18.9
976;2021-08-13;1573;533;83405;53492;29.8;19.1
976;2021-08-14;833;456;84238;53948;30.1;19.3
976;2021-08-15;0;0;84238;53948;30.1;19.3
976;2021-08-16;568;291;84806;54239;30.3;19.4
976;2021-08-17;1827;1300;86633;55539;31.0;19.9
976;2021-08-18;2230;1225;88863;56764;31.8;20.3
976;2021-08-19;1978;554;90841;57318;32.5;20.5
976;2021-08-20;1797;547;92638;57865;33.1;20.7
976;2021-08-21;1054;522;93692;58387;33.5;20.9
976;2021-08-22;11;0;93703;58387;33.5;20.9
976;2021-08-23;574;271;94277;58658;33.7;21.0
976;2021-08-24;1062;1008;95339;59666;34.1;21.3
976;2021-08-25;1075;1292;96414;60958;34.5;21.8
976;2021-08-26;909;574;97323;61532;34.8;22.0
976;2021-08-27;738;565;98061;62097;35.1;22.2
976;2021-08-28;471;857;98532;62954;35.3;22.5
976;2021-08-29;0;12;98532;62966;35.3;22.5
976;2021-08-30;149;256;98681;63222;35.3;22.6
976;2021-08-31;655;1162;99336;64384;35.5;23.0
976;2021-09-01;812;1396;100148;65780;35.8;23.5
976;2021-09-02;840;902;100988;66682;36.1;23.9
976;2021-09-03;910;1295;101898;67977;36.5;24.3
976;2021-09-04;432;1000;102330;68977;36.6;24.7
976;2021-09-05;0;1;102330;68978;36.6;24.7
976;2021-09-06;445;401;102775;69379;36.8;24.8
976;2021-09-07;738;703;103513;70082;37.0;25.1
976;2021-09-08;1084;1264;104597;71346;37.4;25.5
976;2021-09-09;848;1016;105445;72362;37.7;25.9
976;2021-09-10;1154;1084;106599;73446;38.1;26.3
976;2021-09-11;523;1037;107122;74483;38.3;26.7
976;2021-09-12;0;32;107122;74515;38.3;26.7
976;2021-09-13;701;618;107823;75133;38.6;26.9
976;2021-09-14;1044;722;108867;75855;39.0;27.1
976;2021-09-15;1682;1181;110549;77036;39.6;27.6
976;2021-09-16;1731;893;112280;77929;40.2;27.9
976;2021-09-17;1842;1060;114122;78989;40.8;28.3
976;2021-09-18;951;783;115073;79772;41.2;28.5
976;2021-09-19;1;52;115074;79824;41.2;28.6
976;2021-09-20;1004;543;116078;80367;41.5;28.8
976;2021-09-21;1650;768;117728;81135;42.1;29.0
976;2021-09-22;1437;964;119165;82099;42.6;29.4
976;2021-09-23;1021;879;120186;82978;43.0;29.7
976;2021-09-24;1084;1011;121270;83989;43.4;30.1
976;2021-09-25;489;478;121759;84467;43.6;30.2
976;2021-09-26;0;21;121759;84488;43.6;30.2
976;2021-09-27;690;423;122449;84911;43.8;30.4
976;2021-09-28;1166;923;123615;85834;44.2;30.7
976;2021-09-29;1152;1054;124767;86888;44.6;31.1
977;2020-12-27;0;0;0;0;0.0;0.0
977;2020-12-28;0;0;0;0;0.0;0.0
977;2020-12-29;0;0;0;0;0.0;0.0
977;2020-12-30;0;0;0;0;0.0;0.0
977;2020-12-31;0;0;0;0;0.0;0.0
977;2021-01-01;0;0;0;0;0.0;0.0
977;2021-01-02;0;0;0;0;0.0;0.0
977;2021-01-03;0;0;0;0;0.0;0.0
977;2021-01-04;0;0;0;0;0.0;0.0
977;2021-01-05;0;0;0;0;0.0;0.0
977;2021-01-06;0;0;0;0;0.0;0.0
977;2021-01-07;0;0;0;0;0.0;0.0
977;2021-01-08;0;0;0;0;0.0;0.0
977;2021-01-09;0;0;0;0;0.0;0.0
977;2021-01-10;0;0;0;0;0.0;0.0
977;2021-01-11;0;0;0;0;0.0;0.0
977;2021-01-12;0;0;0;0;0.0;0.0
977;2021-01-13;0;0;0;0;0.0;0.0
977;2021-01-14;0;0;0;0;0.0;0.0
977;2021-01-15;0;0;0;0;0.0;0.0
977;2021-01-16;0;0;0;0;0.0;0.0
977;2021-01-17;0;0;0;0;0.0;0.0
977;2021-01-18;1;0;1;0;0.0;0.0
977;2021-01-19;0;0;1;0;0.0;0.0
977;2021-01-20;0;0;1;0;0.0;0.0
977;2021-01-21;12;0;13;0;0.1;0.0
977;2021-01-22;12;0;25;0;0.3;0.0
977;2021-01-23;0;0;25;0;0.3;0.0
977;2021-01-24;0;0;25;0;0.3;0.0
977;2021-01-25;0;0;25;0;0.3;0.0
977;2021-01-26;0;0;25;0;0.3;0.0
977;2021-01-27;12;0;37;0;0.4;0.0
977;2021-01-28;1;0;38;0;0.4;0.0
977;2021-01-29;6;0;44;0;0.4;0.0
977;2021-01-30;0;0;44;0;0.4;0.0
977;2021-01-31;0;0;44;0;0.4;0.0
977;2021-02-01;0;0;44;0;0.4;0.0
977;2021-02-02;0;0;44;0;0.4;0.0
977;2021-02-03;11;0;55;0;0.6;0.0
977;2021-02-04;12;0;67;0;0.7;0.0
977;2021-02-05;11;0;78;0;0.8;0.0
977;2021-02-06;0;0;78;0;0.8;0.0
977;2021-02-07;0;0;78;0;0.8;0.0
977;2021-02-08;0;0;78;0;0.8;0.0
977;2021-02-09;14;0;92;0;0.9;0.0
977;2021-02-10;0;0;92;0;0.9;0.0
977;2021-02-11;18;0;110;0;1.1;0.0
977;2021-02-12;46;0;156;0;1.6;0.0
977;2021-02-13;0;0;156;0;1.6;0.0
977;2021-02-14;0;0;156;0;1.6;0.0
977;2021-02-15;0;0;156;0;1.6;0.0
977;2021-02-16;0;0;156;0;1.6;0.0
977;2021-02-17;0;0;156;0;1.6;0.0
977;2021-02-18;19;0;175;0;1.8;0.0
977;2021-02-19;35;0;210;0;2.1;0.0
977;2021-02-20;0;0;210;0;2.1;0.0
977;2021-02-21;0;0;210;0;2.1;0.0
977;2021-02-22;0;0;210;0;2.1;0.0
977;2021-02-23;0;18;210;18;2.1;0.2
977;2021-02-24;0;0;210;18;2.1;0.2
977;2021-02-25;15;3;225;21;2.3;0.2
977;2021-02-26;33;17;258;38;2.6;0.4
977;2021-02-27;0;0;258;38;2.6;0.4
977;2021-02-28;0;0;258;38;2.6;0.4
977;2021-03-01;0;0;258;38;2.6;0.4
977;2021-03-02;19;11;277;49;2.8;0.5
977;2021-03-03;0;0;277;49;2.8;0.5
977;2021-03-04;16;9;293;58;2.9;0.6
977;2021-03-05;35;16;328;74;3.3;0.7
977;2021-03-06;0;0;328;74;3.3;0.7
977;2021-03-07;0;0;328;74;3.3;0.7
977;2021-03-08;0;0;328;74;3.3;0.7
977;2021-03-09;1;0;329;74;3.3;0.7
977;2021-03-10;0;0;329;74;3.3;0.7
977;2021-03-11;20;26;349;100;3.5;1.0
977;2021-03-12;62;42;411;142;4.1;1.4
977;2021-03-13;0;0;411;142;4.1;1.4
977;2021-03-14;0;0;411;142;4.1;1.4
977;2021-03-15;0;0;411;142;4.1;1.4
977;2021-03-16;30;10;441;152;4.4;1.5
977;2021-03-17;0;0;441;152;4.4;1.5
977;2021-03-18;30;16;471;168;4.7;1.7
977;2021-03-19;58;27;529;195;5.3;2.0
977;2021-03-20;0;0;529;195;5.3;2.0
977;2021-03-21;0;0;529;195;5.3;2.0
977;2021-03-22;0;0;529;195;5.3;2.0
977;2021-03-23;0;0;529;195;5.3;2.0
977;2021-03-24;0;0;529;195;5.3;2.0
977;2021-03-25;65;17;594;212;6.0;2.1
977;2021-03-26;73;25;667;237;6.7;2.4
977;2021-03-27;0;0;667;237;6.7;2.4
977;2021-03-28;0;0;667;237;6.7;2.4
977;2021-03-29;0;0;667;237;6.7;2.4
977;2021-03-30;39;16;706;253;7.1;2.5
977;2021-03-31;26;14;732;267;7.3;2.7
977;2021-04-01;25;32;757;299;7.6;3.0
977;2021-04-02;0;0;757;299;7.6;3.0
977;2021-04-03;0;0;757;299;7.6;3.0
977;2021-04-04;0;0;757;299;7.6;3.0
977;2021-04-05;9;0;766;299;7.7;3.0
977;2021-04-06;0;0;766;299;7.7;3.0
977;2021-04-07;0;0;766;299;7.7;3.0
977;2021-04-08;57;46;823;345;8.3;3.5
977;2021-04-09;58;31;881;376;8.8;3.8
977;2021-04-10;0;0;881;376;8.8;3.8
977;2021-04-11;0;0;881;376;8.8;3.8
977;2021-04-12;0;0;881;376;8.8;3.8
977;2021-04-13;0;0;881;376;8.8;3.8
977;2021-04-14;5;5;886;381;8.9;3.8
977;2021-04-15;57;70;943;451;9.5;4.5
977;2021-04-16;89;35;1032;486;10.4;4.9
977;2021-04-17;0;1;1032;487;10.4;4.9
977;2021-04-18;0;0;1032;487;10.4;4.9
977;2021-04-19;1;0;1033;487;10.4;4.9
977;2021-04-20;335;62;1368;549;13.7;5.5
977;2021-04-21;337;30;1705;579;17.1;5.8
977;2021-04-22;284;47;1989;626;20.0;6.3
977;2021-04-23;260;42;2249;668;22.6;6.7
977;2021-04-24;231;1;2480;669;24.9;6.7
977;2021-04-25;0;0;2480;669;24.9;6.7
977;2021-04-26;283;19;2763;688;27.7;6.9
977;2021-04-27;224;67;2987;755;30.0;7.6
977;2021-04-28;192;26;3179;781;31.9;7.8
977;2021-04-29;170;23;3349;804;33.6;8.1
977;2021-04-30;171;16;3520;820;35.3;8.2
977;2021-05-01;202;11;3722;831;37.4;8.3
977;2021-05-02;0;0;3722;831;37.4;8.3
977;2021-05-03;135;9;3857;840;38.7;8.4
977;2021-05-04;161;54;4018;894;40.3;9.0
977;2021-05-05;221;28;4239;922;42.6;9.3
977;2021-05-06;175;33;4414;955;44.3;9.6
977;2021-05-07;149;32;4563;987;45.8;9.9
977;2021-05-08;1;0;4564;987;45.8;9.9
977;2021-05-09;0;0;4564;987;45.8;9.9
977;2021-05-10;0;0;4564;987;45.8;9.9
977;2021-05-11;3;41;4567;1028;45.8;10.3
977;2021-05-12;6;36;4573;1064;45.9;10.7
977;2021-05-13;0;0;4573;1064;45.9;10.7
977;2021-05-14;28;98;4601;1162;46.2;11.7
977;2021-05-15;0;0;4601;1162;46.2;11.7
977;2021-05-16;1;0;4602;1162;46.2;11.7
977;2021-05-17;1;14;4603;1176;46.2;11.8
977;2021-05-18;17;32;4620;1208;46.4;12.1
977;2021-05-19;1;2;4621;1210;46.4;12.1
977;2021-05-20;0;8;4621;1218;46.4;12.2
977;2021-05-21;12;31;4633;1249;46.5;12.5
977;2021-05-22;0;0;4633;1249;46.5;12.5
977;2021-05-23;0;0;4633;1249;46.5;12.5
977;2021-05-24;0;0;4633;1249;46.5;12.5
977;2021-05-25;50;331;4683;1580;47.0;15.9
977;2021-05-26;54;360;4737;1940;47.6;19.5
977;2021-05-27;34;317;4771;2257;47.9;22.7
977;2021-05-28;27;256;4798;2513;48.2;25.2
977;2021-05-29;35;375;4833;2888;48.5;29.0
977;2021-05-30;1;0;4834;2888;48.5;29.0
977;2021-05-31;45;216;4879;3104;49.0;31.2
977;2021-06-01;48;227;4927;3331;49.5;33.4
977;2021-06-02;69;273;4996;3604;50.2;36.2
977;2021-06-03;43;252;5039;3856;50.6;38.7
977;2021-06-04;82;270;5121;4126;51.4;41.4
977;2021-06-05;1;0;5122;4126;51.4;41.4
977;2021-06-06;0;0;5122;4126;51.4;41.4
977;2021-06-07;1;1;5123;4127;51.4;41.4
977;2021-06-08;8;2;5131;4129;51.5;41.5
977;2021-06-09;0;3;5131;4132;51.5;41.5
977;2021-06-10;8;4;5139;4136;51.6;41.5
977;2021-06-11;4;8;5143;4144;51.6;41.6
977;2021-06-12;15;59;5158;4203;51.8;42.2
977;2021-06-13;0;0;5158;4203;51.8;42.2
977;2021-06-14;0;0;5158;4203;51.8;42.2
977;2021-06-15;0;1;5158;4204;51.8;42.2
977;2021-06-16;0;0;5158;4204;51.8;42.2
977;2021-06-17;2;6;5160;4210;51.8;42.3
977;2021-06-18;0;2;5160;4212;51.8;42.3
977;2021-06-19;25;49;5185;4261;52.1;42.8
977;2021-06-20;0;0;5185;4261;52.1;42.8
977;2021-06-21;1;2;5186;4263;52.1;42.8
977;2021-06-22;9;0;5195;4263;52.2;42.8
977;2021-06-23;15;9;5210;4272;52.3;42.9
977;2021-06-24;10;5;5220;4277;52.4;42.9
977;2021-06-25;0;0;5220;4277;52.4;42.9
977;2021-06-26;25;45;5245;4322;52.7;43.4
977;2021-06-27;0;0;5245;4322;52.7;43.4
977;2021-06-28;0;0;5245;4322;52.7;43.4
977;2021-06-29;0;0;5245;4322;52.7;43.4
977;2021-06-30;0;0;5245;4322;52.7;43.4
977;2021-07-01;28;36;5273;4358;52.9;43.8
977;2021-07-02;26;31;5299;4389;53.2;44.1
977;2021-07-03;30;215;5329;4604;53.5;46.2
977;2021-07-04;0;0;5329;4604;53.5;46.2
977;2021-07-05;4;8;5333;4612;53.5;46.3
977;2021-07-06;0;0;5333;4612;53.5;46.3
977;2021-07-07;8;0;5341;4612;53.6;46.3
977;2021-07-08;33;23;5374;4635;54.0;46.5
977;2021-07-09;23;31;5397;4666;54.2;46.8
977;2021-07-10;33;45;5430;4711;54.5;47.3
977;2021-07-11;0;0;5430;4711;54.5;47.3
977;2021-07-12;0;1;5430;4712;54.5;47.3
977;2021-07-13;10;10;5440;4722;54.6;47.4
977;2021-07-14;0;0;5440;4722;54.6;47.4
977;2021-07-15;1;11;5441;4733;54.6;47.5
977;2021-07-16;44;51;5485;4784;55.1;48.0
977;2021-07-17;34;39;5519;4823;55.4;48.4
977;2021-07-18;1;0;5520;4823;55.4;48.4
977;2021-07-19;3;2;5523;4825;55.4;48.4
977;2021-07-20;3;1;5526;4826;55.5;48.4
977;2021-07-21;33;16;5559;4842;55.8;48.6
977;2021-07-22;36;33;5595;4875;56.2;48.9
977;2021-07-23;32;31;5627;4906;56.5;49.3
977;2021-07-24;42;25;5669;4931;56.9;49.5
977;2021-07-25;0;0;5669;4931;56.9;49.5
977;2021-07-26;13;10;5682;4941;57.0;49.6
977;2021-07-27;0;10;5682;4951;57.0;49.7
977;2021-07-28;31;14;5713;4965;57.4;49.8
977;2021-07-29;33;32;5746;4997;57.7;50.2
977;2021-07-30;31;28;5777;5025;58.0;50.4
977;2021-07-31;53;24;5830;5049;58.5;50.7
977;2021-08-01;0;0;5830;5049;58.5;50.7
977;2021-08-02;11;1;5841;5050;58.6;50.7
977;2021-08-03;0;0;5841;5050;58.6;50.7
977;2021-08-04;40;14;5881;5064;59.0;50.8
977;2021-08-05;28;30;5909;5094;59.3;51.1
977;2021-08-06;35;35;5944;5129;59.7;51.5
977;2021-08-07;56;25;6000;5154;60.2;51.7
977;2021-08-08;0;0;6000;5154;60.2;51.7
977;2021-08-09;7;5;6007;5159;60.3;51.8
977;2021-08-10;15;9;6022;5168;60.5;51.9
977;2021-08-11;36;18;6058;5186;60.8;52.1
977;2021-08-12;24;30;6082;5216;61.1;52.4
977;2021-08-13;32;14;6114;5230;61.4;52.5
977;2021-08-14;20;26;6134;5256;61.6;52.8
977;2021-08-15;0;0;6134;5256;61.6;52.8
977;2021-08-16;14;29;6148;5285;61.7;53.1
977;2021-08-17;15;8;6163;5293;61.9;53.1
977;2021-08-18;25;28;6188;5321;62.1;53.4
977;2021-08-19;31;36;6219;5357;62.4;53.8
977;2021-08-20;27;41;6246;5398;62.7;54.2
977;2021-08-21;34;41;6280;5439;63.0;54.6
977;2021-08-22;6;0;6286;5439;63.1;54.6
977;2021-08-23;3;11;6289;5450;63.1;54.7
977;2021-08-24;8;3;6297;5453;63.2;54.7
977;2021-08-25;20;37;6317;5490;63.4;55.1
977;2021-08-26;27;41;6344;5531;63.7;55.5
977;2021-08-27;27;35;6371;5566;64.0;55.9
977;2021-08-28;27;56;6398;5622;64.2;56.4
977;2021-08-29;0;0;6398;5622;64.2;56.4
977;2021-08-30;1;4;6399;5626;64.2;56.5
977;2021-08-31;1;2;6400;5628;64.3;56.5
977;2021-09-01;10;28;6410;5656;64.4;56.8
977;2021-09-02;22;35;6432;5691;64.6;57.1
977;2021-09-03;26;25;6458;5716;64.8;57.4
977;2021-09-04;37;49;6495;5765;65.2;57.9
977;2021-09-05;0;0;6495;5765;65.2;57.9
977;2021-09-06;4;16;6499;5781;65.2;58.0
977;2021-09-07;1;4;6500;5785;65.3;58.1
977;2021-09-08;12;13;6512;5798;65.4;58.2
977;2021-09-09;20;36;6532;5834;65.6;58.6
977;2021-09-10;6;31;6538;5865;65.6;58.9
977;2021-09-11;36;31;6574;5896;66.0;59.2
977;2021-09-12;0;6;6574;5902;66.0;59.3
977;2021-09-13;4;4;6578;5906;66.0;59.3
977;2021-09-14;1;0;6579;5906;66.0;59.3
977;2021-09-15;11;26;6590;5932;66.2;59.6
977;2021-09-16;15;31;6605;5963;66.3;59.9
977;2021-09-17;10;32;6615;5995;66.4;60.2
977;2021-09-18;21;39;6636;6034;66.6;60.6
977;2021-09-19;0;0;6636;6034;66.6;60.6
977;2021-09-20;0;2;6636;6036;66.6;60.6
977;2021-09-21;0;1;6636;6037;66.6;60.6
977;2021-09-22;10;11;6646;6048;66.7;60.7
977;2021-09-23;7;30;6653;6078;66.8;61.0
977;2021-09-24;0;0;6653;6078;66.8;61.0
977;2021-09-25;11;49;6664;6127;66.9;61.5
977;2021-09-26;0;0;6664;6127;66.9;61.5
977;2021-09-27;0;0;6664;6127;66.9;61.5
977;2021-09-28;0;1;6664;6128;66.9;61.5
977;2021-09-29;4;15;6668;6143;66.9;61.7
978;2020-12-27;0;0;0;0;0.0;0.0
978;2020-12-28;0;0;0;0;0.0;0.0
978;2020-12-29;0;0;0;0;0.0;0.0
978;2020-12-30;0;0;0;0;0.0;0.0
978;2020-12-31;0;0;0;0;0.0;0.0
978;2021-01-01;0;0;0;0;0.0;0.0
978;2021-01-02;0;0;0;0;0.0;0.0
978;2021-01-03;0;0;0;0;0.0;0.0
978;2021-01-04;0;0;0;0;0.0;0.0
978;2021-01-05;0;0;0;0;0.0;0.0
978;2021-01-06;0;0;0;0;0.0;0.0
978;2021-01-07;0;0;0;0;0.0;0.0
978;2021-01-08;0;0;0;0;0.0;0.0
978;2021-01-09;0;0;0;0;0.0;0.0
978;2021-01-10;0;0;0;0;0.0;0.0
978;2021-01-11;0;0;0;0;0.0;0.0
978;2021-01-12;0;0;0;0;0.0;0.0
978;2021-01-13;10;0;10;0;0.0;0.0
978;2021-01-14;12;0;22;0;0.1;0.0
978;2021-01-15;9;0;31;0;0.1;0.0
978;2021-01-16;0;0;31;0;0.1;0.0
978;2021-01-17;0;0;31;0;0.1;0.0
978;2021-01-18;0;0;31;0;0.1;0.0
978;2021-01-19;12;0;43;0;0.1;0.0
978;2021-01-20;13;0;56;0;0.2;0.0
978;2021-01-21;6;0;62;0;0.2;0.0
978;2021-01-22;0;0;62;0;0.2;0.0
978;2021-01-23;0;0;62;0;0.2;0.0
978;2021-01-24;0;0;62;0;0.2;0.0
978;2021-01-25;0;0;62;0;0.2;0.0
978;2021-01-26;9;0;71;0;0.2;0.0
978;2021-01-27;10;0;81;0;0.2;0.0
978;2021-01-28;6;1;87;1;0.2;0.0
978;2021-01-29;0;0;87;1;0.2;0.0
978;2021-01-30;0;0;87;1;0.2;0.0
978;2021-01-31;0;0;87;1;0.2;0.0
978;2021-02-01;1;0;88;1;0.2;0.0
978;2021-02-02;39;0;127;1;0.4;0.0
978;2021-02-03;11;0;138;1;0.4;0.0
978;2021-02-04;32;0;170;1;0.5;0.0
978;2021-02-05;6;0;176;1;0.5;0.0
978;2021-02-06;0;0;176;1;0.5;0.0
978;2021-02-07;0;0;176;1;0.5;0.0
978;2021-02-08;0;0;176;1;0.5;0.0
978;2021-02-09;38;0;214;1;0.6;0.0
978;2021-02-10;27;1;241;2;0.7;0.0
978;2021-02-11;0;0;241;2;0.7;0.0
978;2021-02-12;36;0;277;2;0.8;0.0
978;2021-02-13;0;0;277;2;0.8;0.0
978;2021-02-14;0;0;277;2;0.8;0.0
978;2021-02-15;50;1;327;3;0.9;0.0
978;2021-02-16;0;0;327;3;0.9;0.0
978;2021-02-17;0;0;327;3;0.9;0.0
978;2021-02-18;28;0;355;3;1.0;0.0
978;2021-02-19;44;0;399;3;1.1;0.0
978;2021-02-20;0;0;399;3;1.1;0.0
978;2021-02-21;0;0;399;3;1.1;0.0
978;2021-02-22;45;4;444;7;1.3;0.0
978;2021-02-23;41;25;485;32;1.4;0.1
978;2021-02-24;36;1;521;33;1.5;0.1
978;2021-02-25;55;34;576;67;1.6;0.2
978;2021-02-26;39;5;615;72;1.7;0.2
978;2021-02-27;0;0;615;72;1.7;0.2
978;2021-02-28;0;0;615;72;1.7;0.2
978;2021-03-01;49;4;664;76;1.9;0.2
978;2021-03-02;7;19;671;95;1.9;0.3
978;2021-03-03;53;23;724;118;2.0;0.3
978;2021-03-04;31;18;755;136;2.1;0.4
978;2021-03-05;46;10;801;146;2.3;0.4
978;2021-03-06;0;0;801;146;2.3;0.4
978;2021-03-07;0;0;801;146;2.3;0.4
978;2021-03-08;32;5;833;151;2.4;0.4
978;2021-03-09;21;23;854;174;2.4;0.5
978;2021-03-10;35;25;889;199;2.5;0.6
978;2021-03-11;2;0;891;199;2.5;0.6
978;2021-03-12;53;20;944;219;2.7;0.6
978;2021-03-13;13;0;957;219;2.7;0.6
978;2021-03-14;0;0;957;219;2.7;0.6
978;2021-03-15;31;41;988;260;2.8;0.7
978;2021-03-16;73;5;1061;265;3.0;0.7
978;2021-03-17;67;13;1128;278;3.2;0.8
978;2021-03-18;82;38;1210;316;3.4;0.9
978;2021-03-19;32;50;1242;366;3.5;1.0
978;2021-03-20;0;0;1242;366;3.5;1.0
978;2021-03-21;0;0;1242;366;3.5;1.0
978;2021-03-22;35;45;1277;411;3.6;1.2
978;2021-03-23;30;43;1307;454;3.7;1.3
978;2021-03-24;38;42;1345;496;3.8;1.4
978;2021-03-25;97;34;1442;530;4.1;1.5
978;2021-03-26;45;33;1487;563;4.2;1.6
978;2021-03-27;94;3;1581;566;4.5;1.6
978;2021-03-28;0;0;1581;566;4.5;1.6
978;2021-03-29;69;46;1650;612;4.7;1.7
978;2021-03-30;99;24;1749;636;4.9;1.8
978;2021-03-31;91;49;1840;685;5.2;1.9
978;2021-04-01;57;48;1897;733;5.4;2.1
978;2021-04-02;0;0;1897;733;5.4;2.1
978;2021-04-03;1;0;1898;733;5.4;2.1
978;2021-04-04;0;0;1898;733;5.4;2.1
978;2021-04-05;2;0;1900;733;5.4;2.1
978;2021-04-06;49;63;1949;796;5.5;2.3
978;2021-04-07;93;33;2042;829;5.8;2.3
978;2021-04-08;122;7;2164;836;6.1;2.4
978;2021-04-09;91;39;2255;875;6.4;2.5
978;2021-04-10;170;13;2425;888;6.9;2.5
978;2021-04-11;0;0;2425;888;6.9;2.5
978;2021-04-12;42;74;2467;962;7.0;2.7
978;2021-04-13;49;71;2516;1033;7.1;2.9
978;2021-04-14;82;45;2598;1078;7.4;3.1
978;2021-04-15;92;22;2690;1100;7.6;3.1
978;2021-04-16;77;42;2767;1142;7.8;3.2
978;2021-04-17;165;5;2932;1147;8.3;3.2
978;2021-04-18;0;0;2932;1147;8.3;3.2
978;2021-04-19;52;67;2984;1214;8.4;3.4
978;2021-04-20;83;27;3067;1241;8.7;3.5
978;2021-04-21;91;29;3158;1270;8.9;3.6
978;2021-04-22;101;20;3259;1290;9.2;3.7
978;2021-04-23;45;65;3304;1355;9.4;3.8
978;2021-04-24;99;78;3403;1433;9.6;4.1
978;2021-04-25;0;0;3403;1433;9.6;4.1
978;2021-04-26;29;91;3432;1524;9.7;4.3
978;2021-04-27;59;63;3491;1587;9.9;4.5
978;2021-04-28;93;40;3584;1627;10.1;4.6
978;2021-04-29;89;31;3673;1658;10.4;4.7
978;2021-04-30;103;14;3776;1672;10.7;4.7
978;2021-05-01;0;8;3776;1680;10.7;4.8
978;2021-05-02;0;0;3776;1680;10.7;4.8
978;2021-05-03;25;99;3801;1779;10.8;5.0
978;2021-05-04;159;101;3960;1880;11.2;5.3
978;2021-05-05;142;59;4102;1939;11.6;5.5
978;2021-05-06;199;49;4301;1988;12.2;5.6
978;2021-05-07;127;71;4428;2059;12.5;5.8
978;2021-05-08;69;122;4497;2181;12.7;6.2
978;2021-05-09;0;0;4497;2181;12.7;6.2
978;2021-05-10;124;100;4621;2281;13.1;6.5
978;2021-05-11;132;72;4753;2353;13.5;6.7
978;2021-05-12;155;78;4908;2431;13.9;6.9
978;2021-05-13;83;6;4991;2437;14.1;6.9
978;2021-05-14;130;62;5121;2499;14.5;7.1
978;2021-05-15;86;4;5207;2503;14.7;7.1
978;2021-05-16;0;0;5207;2503;14.7;7.1
978;2021-05-17;146;115;5353;2618;15.1;7.4
978;2021-05-18;151;94;5504;2712;15.6;7.7
978;2021-05-19;84;69;5588;2781;15.8;7.9
978;2021-05-20;104;26;5692;2807;16.1;7.9
978;2021-05-21;98;52;5790;2859;16.4;8.1
978;2021-05-22;99;11;5889;2870;16.7;8.1
978;2021-05-23;0;0;5889;2870;16.7;8.1
978;2021-05-24;33;7;5922;2877;16.8;8.1
978;2021-05-25;119;78;6041;2955;17.1;8.4
978;2021-05-26;108;49;6149;3004;17.4;8.5
978;2021-05-27;112;42;6261;3046;17.7;8.6
978;2021-05-28;33;1;6294;3047;17.8;8.6
978;2021-05-29;60;213;6354;3260;18.0;9.2
978;2021-05-30;0;0;6354;3260;18.0;9.2
978;2021-05-31;111;63;6465;3323;18.3;9.4
978;2021-06-01;116;62;6581;3385;18.6;9.6
978;2021-06-02;131;33;6712;3418;19.0;9.7
978;2021-06-03;101;38;6813;3456;19.3;9.8
978;2021-06-04;128;70;6941;3526;19.6;10.0
978;2021-06-05;83;21;7024;3547;19.9;10.0
978;2021-06-06;0;0;7024;3547;19.9;10.0
978;2021-06-07;96;96;7120;3643;20.2;10.3
978;2021-06-08;82;89;7202;3732;20.4;10.6
978;2021-06-09;99;73;7301;3805;20.7;10.8
978;2021-06-10;112;63;7413;3868;21.0;10.9
978;2021-06-11;116;106;7529;3974;21.3;11.2
978;2021-06-12;57;30;7586;4004;21.5;11.3
978;2021-06-13;0;0;7586;4004;21.5;11.3
978;2021-06-14;105;127;7691;4131;21.8;11.7
978;2021-06-15;88;120;7779;4251;22.0;12.0
978;2021-06-16;105;148;7884;4399;22.3;12.4
978;2021-06-17;85;72;7969;4471;22.6;12.7
978;2021-06-18;67;98;8036;4569;22.7;12.9
978;2021-06-19;65;79;8101;4648;22.9;13.2
978;2021-06-20;0;0;8101;4648;22.9;13.2
978;2021-06-21;78;150;8179;4798;23.1;13.6
978;2021-06-22;71;103;8250;4901;23.3;13.9
978;2021-06-23;68;115;8318;5016;23.5;14.2
978;2021-06-24;43;75;8361;5091;23.7;14.4
978;2021-06-25;64;100;8425;5191;23.8;14.7
978;2021-06-26;35;61;8460;5252;23.9;14.9
978;2021-06-27;0;0;8460;5252;23.9;14.9
978;2021-06-28;73;131;8533;5383;24.1;15.2
978;2021-06-29;62;104;8595;5487;24.3;15.5
978;2021-06-30;56;110;8651;5597;24.5;15.8
978;2021-07-01;42;87;8693;5684;24.6;16.1
978;2021-07-02;52;90;8745;5774;24.7;16.3
978;2021-07-03;40;90;8785;5864;24.9;16.6
978;2021-07-04;0;1;8785;5865;24.9;16.6
978;2021-07-05;67;93;8852;5958;25.1;16.9
978;2021-07-06;55;74;8907;6032;25.2;17.1
978;2021-07-07;55;123;8962;6155;25.4;17.4
978;2021-07-08;54;107;9016;6262;25.5;17.7
978;2021-07-09;45;92;9061;6354;25.6;18.0
978;2021-07-10;38;85;9099;6439;25.8;18.2
978;2021-07-11;0;4;9099;6443;25.8;18.2
978;2021-07-12;71;130;9170;6573;26.0;18.6
978;2021-07-13;146;162;9316;6735;26.4;19.1
978;2021-07-14;3;0;9319;6735;26.4;19.1
978;2021-07-15;161;195;9480;6930;26.8;19.6
978;2021-07-16;113;113;9593;7043;27.1;19.9
978;2021-07-17;52;100;9645;7143;27.3;20.2
978;2021-07-18;0;0;9645;7143;27.3;20.2
978;2021-07-19;99;133;9744;7276;27.6;20.6
978;2021-07-20;80;74;9824;7350;27.8;20.8
978;2021-07-21;63;50;9887;7400;28.0;20.9
978;2021-07-22;97;114;9984;7514;28.3;21.3
978;2021-07-23;67;98;10051;7612;28.4;21.5
978;2021-07-24;20;35;10071;7647;28.5;21.6
978;2021-07-25;0;0;10071;7647;28.5;21.6
978;2021-07-26;99;116;10170;7763;28.8;22.0
978;2021-07-27;72;144;10242;7907;29.0;22.4
978;2021-07-28;72;126;10314;8033;29.2;22.7
978;2021-07-29;80;98;10394;8131;29.4;23.0
978;2021-07-30;82;115;10476;8246;29.6;23.3
978;2021-07-31;49;68;10525;8314;29.8;23.5
978;2021-08-01;0;0;10525;8314;29.8;23.5
978;2021-08-02;65;95;10590;8409;30.0;23.8
978;2021-08-03;60;94;10650;8503;30.1;24.1
978;2021-08-04;64;55;10714;8558;30.3;24.2
978;2021-08-05;48;70;10762;8628;30.5;24.4
978;2021-08-06;73;127;10835;8755;30.7;24.8
978;2021-08-07;44;46;10879;8801;30.8;24.9
978;2021-08-08;0;0;10879;8801;30.8;24.9
978;2021-08-09;138;150;11017;8951;31.2;25.3
978;2021-08-10;81;93;11098;9044;31.4;25.6
978;2021-08-11;106;99;11204;9143;31.7;25.9
978;2021-08-12;99;99;11303;9242;32.0;26.2
978;2021-08-13;132;75;11435;9317;32.4;26.4
978;2021-08-14;74;100;11509;9417;32.6;26.7
978;2021-08-15;0;0;11509;9417;32.6;26.7
978;2021-08-16;45;71;11554;9488;32.7;26.9
978;2021-08-17;33;33;11587;9521;32.8;26.9
978;2021-08-18;35;55;11622;9576;32.9;27.1
978;2021-08-19;34;26;11656;9602;33.0;27.2
978;2021-08-20;46;61;11702;9663;33.1;27.3
978;2021-08-21;0;0;11702;9663;33.1;27.3
978;2021-08-22;0;0;11702;9663;33.1;27.3
978;2021-08-23;51;87;11753;9750;33.3;27.6
978;2021-08-24;31;52;11784;9802;33.4;27.7
978;2021-08-25;26;51;11810;9853;33.4;27.9
978;2021-08-26;31;26;11841;9879;33.5;28.0
978;2021-08-27;47;88;11888;9967;33.6;28.2
978;2021-08-28;3;0;11891;9967;33.7;28.2
978;2021-08-29;0;0;11891;9967;33.7;28.2
978;2021-08-30;39;113;11930;10080;33.8;28.5
978;2021-08-31;46;81;11976;10161;33.9;28.8
978;2021-09-01;30;85;12006;10246;34.0;29.0
978;2021-09-02;38;70;12044;10316;34.1;29.2
978;2021-09-03;15;96;12059;10412;34.1;29.5
978;2021-09-04;0;0;12059;10412;34.1;29.5
978;2021-09-05;0;0;12059;10412;34.1;29.5
978;2021-09-06;32;80;12091;10492;34.2;29.7
978;2021-09-07;35;51;12126;10543;34.3;29.8
978;2021-09-08;21;45;12147;10588;34.4;30.0
978;2021-09-09;21;58;12168;10646;34.4;30.1
978;2021-09-10;43;81;12211;10727;34.6;30.4
978;2021-09-11;1;0;12212;10727;34.6;30.4
978;2021-09-12;5;1;12217;10728;34.6;30.4
978;2021-09-13;32;56;12249;10784;34.7;30.5
978;2021-09-14;23;33;12272;10817;34.7;30.6
978;2021-09-15;24;43;12296;10860;34.8;30.7
978;2021-09-16;8;33;12304;10893;34.8;30.8
978;2021-09-17;13;45;12317;10938;34.9;31.0
978;2021-09-18;0;0;12317;10938;34.9;31.0
978;2021-09-19;0;0;12317;10938;34.9;31.0
978;2021-09-20;10;35;12327;10973;34.9;31.1
978;2021-09-21;15;37;12342;11010;34.9;31.2
978;2021-09-22;13;34;12355;11044;35.0;31.3
978;2021-09-23;25;41;12380;11085;35.0;31.4
978;2021-09-24;19;27;12399;11112;35.1;31.4
978;2021-09-25;0;1;12399;11113;35.1;31.5
978;2021-09-26;0;0;12399;11113;35.1;31.5
978;2021-09-27;11;31;12410;11144;35.1;31.5
978;2021-09-28;19;25;12429;11169;35.2;31.6
978;2021-09-29;20;25;12449;11194;35.2;31.7
