dep;jour;n_dose1;n_complet;n_cum_dose1;n_cum_complet;couv_dose1;couv_complet
01;2020-12-27;2;0;2;0;0.0;0.0
01;2020-12-28;0;0;2;0;0.0;0.0
01;2020-12-29;0;0;2;0;0.0;0.0
01;2020-12-30;0;0;2;0;0.0;0.0
01;2020-12-31;0;0;2;0;0.0;0.0
01;2021-01-01;2;0;4;0;0.0;0.0
01;2021-01-02;1;0;5;0;0.0;0.0
01;2021-01-03;0;0;5;0;0.0;0.0
01;2021-01-04;2;0;7;0;0.0;0.0
01;2021-01-05;2;0;9;0;0.0;0.0
01;2021-01-06;1;0;10;0;0.0;0.0
01;2021-01-07;67;0;77;0;0.0;0.0
01;2021-01-08;159;1;236;1;0.0;0.0
01;2021-01-09;2;1;238;2;0.0;0.0
01;2021-01-10;1;0;239;2;0.0;0.0
01;2021-01-11;148;0;387;2;0.1;0.0
01;2021-01-12;319;2;706;4;0.1;0.0
01;2021-01-13;445;1;1151;5;0.2;0.0
01;2021-01-14;530;3;1681;8;0.3;0.0
01;2021-01-15;398;4;2079;12;0.3;0.0
01;2021-01-16;202;0;2281;12;0.3;0.0
01;2021-01-17;128;0;2409;12;0.4;0.0
01;2021-01-18;380;3;2789;15;0.4;0.0
01;2021-01-19;1041;2;3830;17;0.6;0.0
01;2021-01-20;1262;4;5092;21;0.8;0.0
01;2021-01-21;1101;6;6193;27;0.9;0.0
01;2021-01-22;651;4;6844;31;1.0;0.0
01;2021-01-23;223;0;7067;31;1.1;0.0
01;2021-01-24;70;1;7137;32;1.1;0.0
01;2021-01-25;485;1;7622;33;1.2;0.0
01;2021-01-26;744;5;8366;38;1.3;0.0
01;2021-01-27;518;7;8884;45;1.4;0.0
01;2021-01-28;683;57;9567;102;1.5;0.0
01;2021-01-29;640;102;10207;204;1.6;0.0
01;2021-01-30;237;15;10444;219;1.6;0.0
01;2021-01-31;64;0;10508;219;1.6;0.0
01;2021-02-01;459;73;10967;292;1.7;0.0
01;2021-02-02;519;185;11486;477;1.7;0.1
01;2021-02-03;376;300;11862;777;1.8;0.1
01;2021-02-04;480;417;12342;1194;1.9;0.2
01;2021-02-05;444;281;12786;1475;1.9;0.2
01;2021-02-06;264;143;13050;1618;2.0;0.2
01;2021-02-07;2;111;13052;1729;2.0;0.3
01;2021-02-08;508;404;13560;2133;2.1;0.3
01;2021-02-09;776;858;14336;2991;2.2;0.5
01;2021-02-10;957;720;15293;3711;2.3;0.6
01;2021-02-11;795;774;16088;4485;2.4;0.7
01;2021-02-12;640;552;16728;5037;2.5;0.8
01;2021-02-13;161;151;16889;5188;2.6;0.8
01;2021-02-14;2;9;16891;5197;2.6;0.8
01;2021-02-15;438;445;17329;5642;2.6;0.9
01;2021-02-16;661;422;17990;6064;2.7;0.9
01;2021-02-17;525;251;18515;6315;2.8;1.0
01;2021-02-18;592;569;19107;6884;2.9;1.0
01;2021-02-19;580;249;19687;7133;3.0;1.1
01;2021-02-20;201;154;19888;7287;3.0;1.1
01;2021-02-21;1;1;19889;7288;3.0;1.1
01;2021-02-22;429;558;20318;7846;3.1;1.2
01;2021-02-23;483;523;20801;8369;3.2;1.3
01;2021-02-24;435;462;21236;8831;3.2;1.3
01;2021-02-25;827;610;22063;9441;3.4;1.4
01;2021-02-26;874;545;22937;9986;3.5;1.5
01;2021-02-27;481;118;23418;10104;3.6;1.5
01;2021-02-28;20;3;23438;10107;3.6;1.5
01;2021-03-01;636;460;24074;10567;3.7;1.6
01;2021-03-02;964;561;25038;11128;3.8;1.7
01;2021-03-03;945;669;25983;11797;4.0;1.8
01;2021-03-04;1201;647;27184;12444;4.1;1.9
01;2021-03-05;1357;502;28541;12946;4.3;2.0
01;2021-03-06;781;102;29322;13048;4.5;2.0
01;2021-03-07;44;1;29366;13049;4.5;2.0
01;2021-03-08;670;627;30036;13676;4.6;2.1
01;2021-03-09;1341;619;31377;14295;4.8;2.2
01;2021-03-10;1163;560;32540;14855;5.0;2.3
01;2021-03-11;1687;646;34227;15501;5.2;2.4
01;2021-03-12;2008;647;36235;16148;5.5;2.5
01;2021-03-13;1502;102;37737;16250;5.7;2.5
01;2021-03-14;134;59;37871;16309;5.8;2.5
01;2021-03-15;1156;407;39027;16716;5.9;2.5
01;2021-03-16;1014;566;40041;17282;6.1;2.6
01;2021-03-17;841;347;40882;17629;6.2;2.7
01;2021-03-18;1295;475;42177;18104;6.4;2.8
01;2021-03-19;1752;549;43929;18653;6.7;2.8
01;2021-03-20;1447;137;45376;18790;6.9;2.9
01;2021-03-21;99;11;45475;18801;6.9;2.9
01;2021-03-22;1576;494;47051;19295;7.2;2.9
01;2021-03-23;2197;655;49248;19950;7.5;3.0
01;2021-03-24;1618;421;50866;20371;7.7;3.1
01;2021-03-25;2912;636;53778;21007;8.2;3.2
01;2021-03-26;2872;617;56650;21624;8.6;3.3
01;2021-03-27;1310;164;57960;21788;8.8;3.3
01;2021-03-28;22;1;57982;21789;8.8;3.3
01;2021-03-29;1932;548;59914;22337;9.1;3.4
01;2021-03-30;2515;781;62429;23118;9.5;3.5
01;2021-03-31;1869;630;64298;23748;9.8;3.6
01;2021-04-01;2569;860;66867;24608;10.2;3.7
01;2021-04-02;2818;733;69685;25341;10.6;3.9
01;2021-04-03;1256;137;70941;25478;10.8;3.9
01;2021-04-04;3;1;70944;25479;10.8;3.9
01;2021-04-05;1261;67;72205;25546;11.0;3.9
01;2021-04-06;2825;801;75030;26347;11.4;4.0
01;2021-04-07;2741;710;77771;27057;11.8;4.1
01;2021-04-08;3245;1008;81016;28065;12.3;4.3
01;2021-04-09;3983;1336;84999;29401;12.9;4.5
01;2021-04-10;1823;305;86822;29706;13.2;4.5
01;2021-04-11;45;22;86867;29728;13.2;4.5
01;2021-04-12;2716;1229;89583;30957;13.6;4.7
01;2021-04-13;2945;1331;92528;32288;14.1;4.9
01;2021-04-14;3125;1083;95653;33371;14.6;5.1
01;2021-04-15;3074;1484;98727;34855;15.0;5.3
01;2021-04-16;2860;1587;101587;36442;15.5;5.5
01;2021-04-17;1654;682;103241;37124;15.7;5.7
01;2021-04-18;13;0;103254;37124;15.7;5.7
01;2021-04-19;2040;1524;105294;38648;16.0;5.9
01;2021-04-20;2668;1574;107962;40222;16.4;6.1
01;2021-04-21;2690;1352;110652;41574;16.8;6.3
01;2021-04-22;2835;1531;113487;43105;17.3;6.6
01;2021-04-23;2765;1534;116252;44639;17.7;6.8
01;2021-04-24;1448;656;117700;45295;17.9;6.9
01;2021-04-25;9;0;117709;45295;17.9;6.9
01;2021-04-26;1970;1731;119679;47026;18.2;7.2
01;2021-04-27;2572;1559;122251;48585;18.6;7.4
01;2021-04-28;2500;1577;124751;50162;19.0;7.6
01;2021-04-29;2716;1775;127467;51937;19.4;7.9
01;2021-04-30;2982;2252;130449;54189;19.9;8.2
01;2021-05-01;1473;859;131922;55048;20.1;8.4
01;2021-05-02;545;76;132467;55124;20.2;8.4
01;2021-05-03;2296;2482;134763;57606;20.5;8.8
01;2021-05-04;2539;2643;137302;60249;20.9;9.2
01;2021-05-05;2527;2503;139829;62752;21.3;9.6
01;2021-05-06;2995;2530;142824;65282;21.7;9.9
01;2021-05-07;3215;2779;146039;68061;22.2;10.4
01;2021-05-08;1645;922;147684;68983;22.5;10.5
01;2021-05-09;1022;162;148706;69145;22.6;10.5
01;2021-05-10;2500;3071;151206;72216;23.0;11.0
01;2021-05-11;3580;3066;154786;75282;23.6;11.5
01;2021-05-12;3652;3007;158438;78289;24.1;11.9
01;2021-05-13;4089;1503;162527;79792;24.7;12.1
01;2021-05-14;4272;2347;166799;82139;25.4;12.5
01;2021-05-15;3159;1435;169958;83574;25.9;12.7
01;2021-05-16;1413;150;171371;83724;26.1;12.7
01;2021-05-17;3446;2471;174817;86195;26.6;13.1
01;2021-05-18;4075;1959;178892;88154;27.2;13.4
01;2021-05-19;3974;1904;182866;90058;27.8;13.7
01;2021-05-20;4526;2017;187392;92075;28.5;14.0
01;2021-05-21;4621;2198;192013;94273;29.2;14.3
01;2021-05-22;3368;955;195381;95228;29.7;14.5
01;2021-05-23;834;84;196215;95312;29.9;14.5
01;2021-05-24;2765;500;198980;95812;30.3;14.6
01;2021-05-25;3560;2430;202540;98242;30.8;15.0
01;2021-05-26;3569;2253;206109;100495;31.4;15.3
01;2021-05-27;3853;2097;209962;102592;32.0;15.6
01;2021-05-28;3665;2638;213627;105230;32.5;16.0
01;2021-05-29;3055;1305;216682;106535;33.0;16.2
01;2021-05-30;613;88;217295;106623;33.1;16.2
01;2021-05-31;2407;2521;219702;109144;33.4;16.6
01;2021-06-01;2771;2591;222473;111735;33.9;17.0
01;2021-06-02;2883;2203;225356;113938;34.3;17.3
01;2021-06-03;3366;2441;228722;116379;34.8;17.7
01;2021-06-04;4501;3373;233223;119752;35.5;18.2
01;2021-06-05;3252;1732;236475;121484;36.0;18.5
01;2021-06-06;670;78;237145;121562;36.1;18.5
01;2021-06-07;3388;2873;240533;124435;36.6;18.9
01;2021-06-08;3649;2718;244182;127153;37.2;19.4
01;2021-06-09;2949;2637;247131;129790;37.6;19.8
01;2021-06-10;2767;2043;249898;131833;38.0;20.1
01;2021-06-11;3072;3367;252970;135200;38.5;20.6
01;2021-06-12;2402;2197;255372;137397;38.9;20.9
01;2021-06-13;201;479;255573;137876;38.9;21.0
01;2021-06-14;2119;3162;257692;141038;39.2;21.5
01;2021-06-15;2005;3368;259697;144406;39.5;22.0
01;2021-06-16;2175;3287;261872;147693;39.9;22.5
01;2021-06-17;1959;3174;263831;150867;40.2;23.0
01;2021-06-18;2635;4163;266466;155030;40.6;23.6
01;2021-06-19;1727;2556;268193;157586;40.8;24.0
01;2021-06-20;159;498;268352;158084;40.8;24.1
01;2021-06-21;1798;3704;270150;161788;41.1;24.6
01;2021-06-22;1552;4002;271702;165790;41.4;25.2
01;2021-06-23;1583;3754;273285;169544;41.6;25.8
01;2021-06-24;1473;3565;274758;173109;41.8;26.4
01;2021-06-25;1889;4566;276647;177675;42.1;27.0
01;2021-06-26;1209;2946;277856;180621;42.3;27.5
01;2021-06-27;171;339;278027;180960;42.3;27.5
01;2021-06-28;1382;4024;279409;184984;42.5;28.2
01;2021-06-29;1409;3852;280818;188836;42.7;28.7
01;2021-06-30;1381;4157;282199;192993;43.0;29.4
01;2021-07-01;1431;4088;283630;197081;43.2;30.0
01;2021-07-02;1588;4987;285218;202068;43.4;30.8
01;2021-07-03;858;3374;286076;205442;43.5;31.3
01;2021-07-04;105;499;286181;205941;43.6;31.3
01;2021-07-05;1486;4083;287667;210024;43.8;32.0
01;2021-07-06;1105;4275;288772;214299;44.0;32.6
01;2021-07-07;1757;3697;290529;217996;44.2;33.2
01;2021-07-08;1474;3677;292003;221673;44.4;33.7
01;2021-07-09;1885;4365;293888;226038;44.7;34.4
01;2021-07-10;1119;3438;295007;229476;44.9;34.9
01;2021-07-11;105;418;295112;229894;44.9;35.0
01;2021-07-12;1422;3844;296534;233738;45.1;35.6
01;2021-07-13;2058;4116;298592;237854;45.5;36.2
01;2021-07-14;148;179;298740;238033;45.5;36.2
01;2021-07-15;3104;4192;301844;242225;45.9;36.9
01;2021-07-16;3746;4838;305590;247063;46.5;37.6
01;2021-07-17;2203;3045;307793;250108;46.9;38.1
01;2021-07-18;290;551;308083;250659;46.9;38.2
01;2021-07-19;2915;3871;310998;254530;47.3;38.7
01;2021-07-20;3297;3695;314295;258225;47.8;39.3
01;2021-07-21;3934;3568;318229;261793;48.4;39.8
01;2021-07-22;4219;3496;322448;265289;49.1;40.4
01;2021-07-23;3942;4223;326390;269512;49.7;41.0
01;2021-07-24;2731;2713;329121;272225;50.1;41.4
01;2021-07-25;61;60;329182;272285;50.1;41.4
01;2021-07-26;3346;3240;332528;275525;50.6;41.9
01;2021-07-27;4105;2793;336633;278318;51.2;42.4
01;2021-07-28;3989;2652;340622;280970;51.8;42.8
01;2021-07-29;4697;2438;345319;283408;52.6;43.1
01;2021-07-30;4458;3432;349777;286840;53.2;43.7
01;2021-07-31;3641;1773;353418;288613;53.8;43.9
01;2021-08-01;397;76;353815;288689;53.9;43.9
01;2021-08-02;3078;2455;356893;291144;54.3;44.3
01;2021-08-03;3069;2455;359962;293599;54.8;44.7
01;2021-08-04;2543;1739;362505;295338;55.2;45.0
01;2021-08-05;2249;2365;364754;297703;55.5;45.3
01;2021-08-06;2750;3114;367504;300817;55.9;45.8
01;2021-08-07;2072;1837;369576;302654;56.3;46.1
01;2021-08-08;248;257;369824;302911;56.3;46.1
01;2021-08-09;1136;2633;370960;305544;56.5;46.5
01;2021-08-10;1445;2412;372405;307956;56.7;46.9
01;2021-08-11;1472;2596;373877;310552;56.9;47.3
01;2021-08-12;1626;2829;375503;313381;57.2;47.7
01;2021-08-13;1814;2729;377317;316110;57.4;48.1
01;2021-08-14;1392;2233;378709;318343;57.6;48.5
01;2021-08-15;18;21;378727;318364;57.6;48.5
01;2021-08-16;983;3013;379710;321377;57.8;48.9
01;2021-08-17;1355;2761;381065;324138;58.0;49.3
01;2021-08-18;1257;2907;382322;327045;58.2;49.8
01;2021-08-19;1301;2425;383623;329470;58.4;50.2
01;2021-08-20;1458;3951;385081;333421;58.6;50.8
01;2021-08-21;883;2848;385964;336269;58.8;51.2
01;2021-08-22;19;20;385983;336289;58.8;51.2
01;2021-08-23;1116;3020;387099;339309;58.9;51.6
01;2021-08-24;1230;3153;388329;342462;59.1;52.1
01;2021-08-25;1124;2993;389453;345455;59.3;52.6
01;2021-08-26;1649;2740;391102;348195;59.5;53.0
01;2021-08-27;1641;3652;392743;351847;59.8;53.6
01;2021-08-28;1044;2591;393787;354438;59.9;54.0
01;2021-08-29;16;31;393803;354469;59.9;54.0
01;2021-08-30;1187;2708;394990;357177;60.1;54.4
01;2021-08-31;1094;1896;396084;359073;60.3;54.7
01;2021-09-01;924;1697;397008;360770;60.4;54.9
01;2021-09-02;807;1523;397815;362293;60.6;55.1
01;2021-09-03;1130;2198;398945;364491;60.7;55.5
01;2021-09-04;796;1898;399741;366389;60.8;55.8
01;2021-09-05;97;61;399838;366450;60.9;55.8
01;2021-09-06;659;1093;400497;367543;61.0;55.9
01;2021-09-07;579;1021;401076;368564;61.1;56.1
01;2021-09-08;815;1391;401891;369955;61.2;56.3
01;2021-09-09;775;1131;402666;371086;61.3;56.5
01;2021-09-10;1058;1557;403724;372643;61.5;56.7
01;2021-09-11;736;1432;404460;374075;61.6;56.9
01;2021-09-12;25;38;404485;374113;61.6;56.9
01;2021-09-13;578;998;405063;375111;61.7;57.1
01;2021-09-14;621;992;405684;376103;61.8;57.2
01;2021-09-15;725;1447;406409;377550;61.9;57.5
01;2021-09-16;491;923;406900;378473;61.9;57.6
01;2021-09-17;764;1394;407664;379867;62.1;57.8
01;2021-09-18;376;1205;408040;381072;62.1;58.0
01;2021-09-19;10;10;408050;381082;62.1;58.0
01;2021-09-20;380;637;408430;381719;62.2;58.1
01;2021-09-21;387;703;408817;382422;62.2;58.2
01;2021-09-22;347;899;409164;383321;62.3;58.3
01;2021-09-23;301;658;409465;383979;62.3;58.4
01;2021-09-24;402;947;409867;384926;62.4;58.6
01;2021-09-25;307;955;410174;385881;62.4;58.7
01;2021-09-26;2;24;410176;385905;62.4;58.7
01;2021-09-27;174;557;410350;386462;62.5;58.8
01;2021-09-28;310;1193;410660;387655;62.5;59.0
01;2021-09-29;464;1282;411124;388937;62.6;59.2
01;2021-09-30;347;831;411471;389768;62.6;59.3
01;2021-10-01;464;1077;411935;390845;62.7;59.5
01;2021-10-02;396;1309;412331;392154;62.8;59.7
01;2021-10-03;0;0;412331;392154;62.8;59.7
01;2021-10-04;196;512;412527;392666;62.8;59.8
01;2021-10-05;205;536;412732;393202;62.8;59.9
01;2021-10-06;341;750;413073;393952;62.9;60.0
01;2021-10-07;201;491;413274;394443;62.9;60.0
01;2021-10-08;337;720;413611;395163;63.0;60.2
01;2021-10-09;348;697;413959;395860;63.0;60.3
01;2021-10-10;8;18;413967;395878;63.0;60.3
01;2021-10-11;178;403;414145;396281;63.0;60.3
01;2021-10-12;153;327;414298;396608;63.1;60.4
01;2021-10-13;347;508;414645;397116;63.1;60.4
01;2021-10-14;133;506;414778;397622;63.1;60.5
01;2021-10-15;317;477;415095;398099;63.2;60.6
01;2021-10-16;251;414;415346;398513;63.2;60.7
01;2021-10-17;4;15;415350;398528;63.2;60.7
01;2021-10-18;134;227;415484;398755;63.2;60.7
01;2021-10-19;176;296;415660;399051;63.3;60.7
02;2020-12-27;0;0;0;0;0.0;0.0
02;2020-12-28;0;0;0;0;0.0;0.0
02;2020-12-29;0;0;0;0;0.0;0.0
02;2020-12-30;0;0;0;0;0.0;0.0
02;2020-12-31;0;0;0;0;0.0;0.0
02;2021-01-01;0;0;0;0;0.0;0.0
02;2021-01-02;0;0;0;0;0.0;0.0
02;2021-01-03;0;0;0;0;0.0;0.0
02;2021-01-04;0;0;0;0;0.0;0.0
02;2021-01-05;0;0;0;0;0.0;0.0
02;2021-01-06;22;0;22;0;0.0;0.0
02;2021-01-07;261;1;283;1;0.1;0.0
02;2021-01-08;489;3;772;4;0.1;0.0
02;2021-01-09;75;0;847;4;0.2;0.0
02;2021-01-10;49;0;896;4;0.2;0.0
02;2021-01-11;267;0;1163;4;0.2;0.0
02;2021-01-12;354;1;1517;5;0.3;0.0
02;2021-01-13;469;4;1986;9;0.4;0.0
02;2021-01-14;652;11;2638;20;0.5;0.0
02;2021-01-15;630;8;3268;28;0.6;0.0
02;2021-01-16;333;5;3601;33;0.7;0.0
02;2021-01-17;62;0;3663;33;0.7;0.0
02;2021-01-18;811;10;4474;43;0.9;0.0
02;2021-01-19;941;7;5415;50;1.0;0.0
02;2021-01-20;1431;5;6846;55;1.3;0.0
02;2021-01-21;2605;12;9451;67;1.8;0.0
02;2021-01-22;1420;5;10871;72;2.1;0.0
02;2021-01-23;290;2;11161;74;2.1;0.0
02;2021-01-24;67;0;11228;74;2.1;0.0
02;2021-01-25;432;10;11660;84;2.2;0.0
02;2021-01-26;704;17;12364;101;2.4;0.0
02;2021-01-27;162;3;12526;104;2.4;0.0
02;2021-01-28;69;246;12595;350;2.4;0.1
02;2021-01-29;119;418;12714;768;2.4;0.1
02;2021-01-30;4;14;12718;782;2.4;0.1
02;2021-01-31;0;10;12718;792;2.4;0.2
02;2021-02-01;11;211;12729;1003;2.4;0.2
02;2021-02-02;45;329;12774;1332;2.4;0.3
02;2021-02-03;124;338;12898;1670;2.5;0.3
02;2021-02-04;226;357;13124;2027;2.5;0.4
02;2021-02-05;179;413;13303;2440;2.5;0.5
02;2021-02-06;69;176;13372;2616;2.5;0.5
02;2021-02-07;9;0;13381;2616;2.5;0.5
02;2021-02-08;306;433;13687;3049;2.6;0.6
02;2021-02-09;322;680;14009;3729;2.7;0.7
02;2021-02-10;485;1042;14494;4771;2.8;0.9
02;2021-02-11;937;1860;15431;6631;2.9;1.3
02;2021-02-12;885;1119;16316;7750;3.1;1.5
02;2021-02-13;290;129;16606;7879;3.2;1.5
02;2021-02-14;1;5;16607;7884;3.2;1.5
02;2021-02-15;344;681;16951;8565;3.2;1.6
02;2021-02-16;414;561;17365;9126;3.3;1.7
02;2021-02-17;499;631;17864;9757;3.4;1.9
02;2021-02-18;507;446;18371;10203;3.5;1.9
02;2021-02-19;444;569;18815;10772;3.6;2.0
02;2021-02-20;372;234;19187;11006;3.6;2.1
02;2021-02-21;39;17;19226;11023;3.7;2.1
02;2021-02-22;377;317;19603;11340;3.7;2.2
02;2021-02-23;432;362;20035;11702;3.8;2.2
02;2021-02-24;600;146;20635;11848;3.9;2.3
02;2021-02-25;870;137;21505;11985;4.1;2.3
02;2021-02-26;809;77;22314;12062;4.2;2.3
02;2021-02-27;444;16;22758;12078;4.3;2.3
02;2021-02-28;55;2;22813;12080;4.3;2.3
02;2021-03-01;638;26;23451;12106;4.5;2.3
02;2021-03-02;1032;130;24483;12236;4.7;2.3
02;2021-03-03;754;204;25237;12440;4.8;2.4
02;2021-03-04;1161;658;26398;13098;5.0;2.5
02;2021-03-05;1050;511;27448;13609;5.2;2.6
02;2021-03-06;2141;102;29589;13711;5.6;2.6
02;2021-03-07;1504;55;31093;13766;5.9;2.6
02;2021-03-08;574;371;31667;14137;6.0;2.7
02;2021-03-09;997;406;32664;14543;6.2;2.8
02;2021-03-10;896;476;33560;15019;6.4;2.9
02;2021-03-11;1295;392;34855;15411;6.6;2.9
02;2021-03-12;1707;419;36562;15830;7.0;3.0
02;2021-03-13;2592;251;39154;16081;7.4;3.1
02;2021-03-14;1458;45;40612;16126;7.7;3.1
02;2021-03-15;612;457;41224;16583;7.8;3.2
02;2021-03-16;862;407;42086;16990;8.0;3.2
02;2021-03-17;759;456;42845;17446;8.1;3.3
02;2021-03-18;610;623;43455;18069;8.3;3.4
02;2021-03-19;1172;304;44627;18373;8.5;3.5
02;2021-03-20;2430;163;47057;18536;8.9;3.5
02;2021-03-21;1487;84;48544;18620;9.2;3.5
02;2021-03-22;762;497;49306;19117;9.4;3.6
02;2021-03-23;1195;552;50501;19669;9.6;3.7
02;2021-03-24;1582;506;52083;20175;9.9;3.8
02;2021-03-25;1694;600;53777;20775;10.2;3.9
02;2021-03-26;2411;499;56188;21274;10.7;4.0
02;2021-03-27;2494;141;58682;21415;11.2;4.1
02;2021-03-28;638;15;59320;21430;11.3;4.1
02;2021-03-29;1038;861;60358;22291;11.5;4.2
02;2021-03-30;1555;847;61913;23138;11.8;4.4
02;2021-03-31;1298;717;63211;23855;12.0;4.5
02;2021-04-01;1290;864;64501;24719;12.3;4.7
02;2021-04-02;1183;1231;65684;25950;12.5;4.9
02;2021-04-03;2644;853;68328;26803;13.0;5.1
02;2021-04-04;727;240;69055;27043;13.1;5.1
02;2021-04-05;1509;134;70564;27177;13.4;5.2
02;2021-04-06;1539;859;72103;28036;13.7;5.3
02;2021-04-07;1872;781;73975;28817;14.1;5.5
02;2021-04-08;1919;1112;75894;29929;14.4;5.7
02;2021-04-09;2432;1099;78326;31028;14.9;5.9
02;2021-04-10;2430;1215;80756;32243;15.4;6.1
02;2021-04-11;475;418;81231;32661;15.4;6.2
02;2021-04-12;1822;636;83053;33297;15.8;6.3
02;2021-04-13;1601;928;84654;34225;16.1;6.5
02;2021-04-14;2583;979;87237;35204;16.6;6.7
02;2021-04-15;2495;782;89732;35986;17.1;6.8
02;2021-04-16;2439;1132;92171;37118;17.5;7.1
02;2021-04-17;1890;2148;94061;39266;17.9;7.5
02;2021-04-18;270;813;94331;40079;17.9;7.6
02;2021-04-19;1158;636;95489;40715;18.2;7.7
02;2021-04-20;1674;767;97163;41482;18.5;7.9
02;2021-04-21;1550;996;98713;42478;18.8;8.1
02;2021-04-22;1749;709;100462;43187;19.1;8.2
02;2021-04-23;1930;1418;102392;44605;19.5;8.5
02;2021-04-24;1714;1646;104106;46251;19.8;8.8
02;2021-04-25;462;235;104568;46486;19.9;8.8
02;2021-04-26;1339;564;105907;47050;20.1;8.9
02;2021-04-27;1627;1098;107534;48148;20.4;9.2
02;2021-04-28;1592;1440;109126;49588;20.7;9.4
02;2021-04-29;1889;1184;111015;50772;21.1;9.7
02;2021-04-30;2716;1661;113731;52433;21.6;10.0
02;2021-05-01;1991;1235;115722;53668;22.0;10.2
02;2021-05-02;1982;424;117704;54092;22.4;10.3
02;2021-05-03;2224;987;119928;55079;22.8;10.5
02;2021-05-04;1522;1317;121450;56396;23.1;10.7
02;2021-05-05;2327;1844;123777;58240;23.5;11.1
02;2021-05-06;2122;1739;125899;59979;23.9;11.4
02;2021-05-07;2357;2184;128256;62163;24.4;11.8
02;2021-05-08;2917;951;131173;63114;24.9;12.0
02;2021-05-09;1823;424;132996;63538;25.3;12.1
02;2021-05-10;2375;1484;135371;65022;25.7;12.4
02;2021-05-11;2878;1579;138249;66601;26.3;12.7
02;2021-05-12;2675;1628;140924;68229;26.8;13.0
02;2021-05-13;2990;1039;143914;69268;27.4;13.2
02;2021-05-14;3381;1209;147295;70477;28.0;13.4
02;2021-05-15;4374;1087;151669;71564;28.8;13.6
02;2021-05-16;2795;213;154464;71777;29.4;13.6
02;2021-05-17;2147;665;156611;72442;29.8;13.8
02;2021-05-18;2634;979;159245;73421;30.3;14.0
02;2021-05-19;2852;1000;162097;74421;30.8;14.1
02;2021-05-20;3553;1235;165650;75656;31.5;14.4
02;2021-05-21;3818;1075;169468;76731;32.2;14.6
02;2021-05-22;5845;970;175313;77701;33.3;14.8
02;2021-05-23;2658;240;177971;77941;33.8;14.8
02;2021-05-24;3541;544;181512;78485;34.5;14.9
02;2021-05-25;2257;1164;183769;79649;34.9;15.1
02;2021-05-26;3079;1498;186848;81147;35.5;15.4
02;2021-05-27;3649;1493;190497;82640;36.2;15.7
02;2021-05-28;3515;1588;194012;84228;36.9;16.0
02;2021-05-29;4078;1573;198090;85801;37.7;16.3
02;2021-05-30;1449;187;199539;85988;37.9;16.3
02;2021-05-31;2575;1197;202114;87185;38.4;16.6
02;2021-06-01;2870;1870;204984;89055;39.0;16.9
02;2021-06-02;3159;1656;208143;90711;39.6;17.2
02;2021-06-03;2854;1841;210997;92552;40.1;17.6
02;2021-06-04;3142;2063;214139;94615;40.7;18.0
02;2021-06-05;3441;1736;217580;96351;41.4;18.3
02;2021-06-06;1736;259;219316;96610;41.7;18.4
02;2021-06-07;1613;1501;220929;98111;42.0;18.7
02;2021-06-08;2061;1848;222990;99959;42.4;19.0
02;2021-06-09;2057;1653;225047;101612;42.8;19.3
02;2021-06-10;2011;1843;227058;103455;43.2;19.7
02;2021-06-11;2194;3073;229252;106528;43.6;20.3
02;2021-06-12;2310;2598;231562;109126;44.0;20.7
02;2021-06-13;683;1387;232245;110513;44.1;21.0
02;2021-06-14;1049;2392;233294;112905;44.3;21.5
02;2021-06-15;1517;2462;234811;115367;44.6;21.9
02;2021-06-16;1534;2749;236345;118116;44.9;22.5
02;2021-06-17;1782;2860;238127;120976;45.3;23.0
02;2021-06-18;2312;3573;240439;124549;45.7;23.7
02;2021-06-19;1841;3824;242280;128373;46.1;24.4
02;2021-06-20;646;1524;242926;129897;46.2;24.7
02;2021-06-21;806;3190;243732;133087;46.3;25.3
02;2021-06-22;1155;3668;244887;136755;46.6;26.0
02;2021-06-23;1226;3589;246113;140344;46.8;26.7
02;2021-06-24;1327;3150;247440;143494;47.0;27.3
02;2021-06-25;1399;4545;248839;148039;47.3;28.1
02;2021-06-26;1345;4229;250184;152268;47.6;28.9
02;2021-06-27;600;2333;250784;154601;47.7;29.4
02;2021-06-28;877;3021;251661;157622;47.8;30.0
02;2021-06-29;919;2929;252580;160551;48.0;30.5
02;2021-06-30;1510;3162;254090;163713;48.3;31.1
02;2021-07-01;1193;3592;255283;167305;48.5;31.8
02;2021-07-02;1358;5136;256641;172441;48.8;32.8
02;2021-07-03;999;5989;257640;178430;49.0;33.9
02;2021-07-04;509;2370;258149;180800;49.1;34.4
02;2021-07-05;661;3937;258810;184737;49.2;35.1
02;2021-07-06;675;3045;259485;187782;49.3;35.7
02;2021-07-07;1321;3726;260806;191508;49.6;36.4
02;2021-07-08;1394;3871;262200;195379;49.8;37.1
02;2021-07-09;1283;4221;263483;199600;50.1;37.9
02;2021-07-10;1333;4607;264816;204207;50.3;38.8
02;2021-07-11;480;1967;265296;206174;50.4;39.2
02;2021-07-12;1417;3732;266713;209906;50.7;39.9
02;2021-07-13;2065;3662;268778;213568;51.1;40.6
02;2021-07-14;1753;1599;270531;215167;51.4;40.9
02;2021-07-15;2727;3563;273258;218730;51.9;41.6
02;2021-07-16;3164;4219;276422;222949;52.5;42.4
02;2021-07-17;3560;4230;279982;227179;53.2;43.2
02;2021-07-18;2037;1618;282019;228797;53.6;43.5
02;2021-07-19;3440;3038;285459;231835;54.3;44.1
02;2021-07-20;3501;3307;288960;235142;54.9;44.7
02;2021-07-21;3909;2952;292869;238094;55.7;45.3
02;2021-07-22;3322;2805;296191;240899;56.3;45.8
02;2021-07-23;3205;3559;299396;244458;56.9;46.5
02;2021-07-24;4447;3724;303843;248182;57.8;47.2
02;2021-07-25;2192;1089;306035;249271;58.2;47.4
02;2021-07-26;3874;2252;309909;251523;58.9;47.8
02;2021-07-27;3660;2148;313569;253671;59.6;48.2
02;2021-07-28;3279;2102;316848;255773;60.2;48.6
02;2021-07-29;2583;2225;319431;257998;60.7;49.0
02;2021-07-30;3313;2312;322744;260310;61.4;49.5
02;2021-07-31;4183;2281;326927;262591;62.1;49.9
02;2021-08-01;1475;692;328402;263283;62.4;50.0
02;2021-08-02;2042;1602;330444;264885;62.8;50.4
02;2021-08-03;2530;1902;332974;266787;63.3;50.7
02;2021-08-04;2577;1714;335551;268501;63.8;51.0
02;2021-08-05;1848;2265;337399;270766;64.1;51.5
02;2021-08-06;2101;2742;339500;273508;64.5;52.0
02;2021-08-07;2524;2785;342024;276293;65.0;52.5
02;2021-08-08;1025;1572;343049;277865;65.2;52.8
02;2021-08-09;1909;2749;344958;280614;65.6;53.3
02;2021-08-10;1765;2462;346723;283076;65.9;53.8
02;2021-08-11;1480;2110;348203;285186;66.2;54.2
02;2021-08-12;1205;2333;349408;287519;66.4;54.7
02;2021-08-13;1611;2910;351019;290429;66.7;55.2
02;2021-08-14;1666;3695;352685;294124;67.0;55.9
02;2021-08-15;161;572;352846;294696;67.1;56.0
02;2021-08-16;1282;3757;354128;298453;67.3;56.7
02;2021-08-17;1421;2840;355549;301293;67.6;57.3
02;2021-08-18;1578;3184;357127;304477;67.9;57.9
02;2021-08-19;1134;3218;358261;307695;68.1;58.5
02;2021-08-20;1205;2951;359466;310646;68.3;59.1
02;2021-08-21;1449;4082;360915;314728;68.6;59.8
02;2021-08-22;407;1657;361322;316385;68.7;60.1
02;2021-08-23;1157;3080;362479;319465;68.9;60.7
02;2021-08-24;907;2185;363386;321650;69.1;61.1
02;2021-08-25;1021;2597;364407;324247;69.3;61.6
02;2021-08-26;913;2334;365320;326581;69.4;62.1
02;2021-08-27;965;2617;366285;329198;69.6;62.6
02;2021-08-28;1302;3430;367587;332628;69.9;63.2
02;2021-08-29;328;1171;367915;333799;69.9;63.5
02;2021-08-30;996;2431;368911;336230;70.1;63.9
02;2021-08-31;866;2171;369777;338401;70.3;64.3
02;2021-09-01;709;1422;370486;339823;70.4;64.6
02;2021-09-02;651;1610;371137;341433;70.6;64.9
02;2021-09-03;695;1797;371832;343230;70.7;65.2
02;2021-09-04;858;2760;372690;345990;70.8;65.8
02;2021-09-05;226;455;372916;346445;70.9;65.9
02;2021-09-06;407;901;373323;347346;71.0;66.0
02;2021-09-07;456;1196;373779;348542;71.1;66.3
02;2021-09-08;517;1736;374296;350278;71.2;66.6
02;2021-09-09;443;1176;374739;351454;71.2;66.8
02;2021-09-10;564;1363;375303;352817;71.3;67.1
02;2021-09-11;724;2130;376027;354947;71.5;67.5
02;2021-09-12;91;270;376118;355217;71.5;67.5
02;2021-09-13;425;952;376543;356169;71.6;67.7
02;2021-09-14;415;822;376958;356991;71.7;67.9
02;2021-09-15;449;1306;377407;358297;71.7;68.1
02;2021-09-16;457;832;377864;359129;71.8;68.3
02;2021-09-17;585;936;378449;360065;71.9;68.4
02;2021-09-18;568;2031;379017;362096;72.0;68.8
02;2021-09-19;78;259;379095;362355;72.1;68.9
02;2021-09-20;296;654;379391;363009;72.1;69.0
02;2021-09-21;279;626;379670;363635;72.2;69.1
02;2021-09-22;362;906;380032;364541;72.2;69.3
02;2021-09-23;262;563;380294;365104;72.3;69.4
02;2021-09-24;299;764;380593;365868;72.3;69.6
02;2021-09-25;319;1211;380912;367079;72.4;69.8
02;2021-09-26;33;158;380945;367237;72.4;69.8
02;2021-09-27;140;370;381085;367607;72.4;69.9
02;2021-09-28;157;392;381242;367999;72.5;70.0
02;2021-09-29;228;419;381470;368418;72.5;70.0
02;2021-09-30;238;480;381708;368898;72.6;70.1
02;2021-10-01;350;658;382058;369556;72.6;70.3
02;2021-10-02;390;853;382448;370409;72.7;70.4
02;2021-10-03;36;60;382484;370469;72.7;70.4
02;2021-10-04;155;361;382639;370830;72.7;70.5
02;2021-10-05;175;318;382814;371148;72.8;70.6
02;2021-10-06;256;422;383070;371570;72.8;70.6
02;2021-10-07;231;462;383301;372032;72.9;70.7
02;2021-10-08;313;603;383614;372635;72.9;70.8
02;2021-10-09;326;692;383940;373327;73.0;71.0
02;2021-10-10;30;56;383970;373383;73.0;71.0
02;2021-10-11;164;304;384134;373687;73.0;71.0
02;2021-10-12;137;296;384271;373983;73.0;71.1
02;2021-10-13;229;392;384500;374375;73.1;71.2
02;2021-10-14;205;313;384705;374688;73.1;71.2
02;2021-10-15;289;418;384994;375106;73.2;71.3
02;2021-10-16;303;426;385297;375532;73.2;71.4
02;2021-10-17;12;23;385309;375555;73.2;71.4
02;2021-10-18;130;194;385439;375749;73.3;71.4
02;2021-10-19;119;205;385558;375954;73.3;71.5
03;2020-12-27;0;0;0;0;0.0;0.0
03;2020-12-28;1;0;1;0;0.0;0.0
03;2020-12-29;0;0;1;0;0.0;0.0
03;2020-12-30;1;0;2;0;0.0;0.0
03;2020-12-31;0;0;2;0;0.0;0.0
03;2021-01-01;0;0;2;0;0.0;0.0
03;2021-01-02;0;0;2;0;0.0;0.0
03;2021-01-03;0;0;2;0;0.0;0.0
03;2021-01-04;0;0;2;0;0.0;0.0
03;2021-01-05;0;0;2;0;0.0;0.0
03;2021-01-06;10;0;12;0;0.0;0.0
03;2021-01-07;60;0;72;0;0.0;0.0
03;2021-01-08;146;1;218;1;0.1;0.0
03;2021-01-09;122;0;340;1;0.1;0.0
03;2021-01-10;6;0;346;1;0.1;0.0
03;2021-01-11;412;1;758;2;0.2;0.0
03;2021-01-12;631;0;1389;2;0.4;0.0
03;2021-01-13;669;2;2058;4;0.6;0.0
03;2021-01-14;860;4;2918;8;0.9;0.0
03;2021-01-15;387;3;3305;11;1.0;0.0
03;2021-01-16;278;0;3583;11;1.1;0.0
03;2021-01-17;42;0;3625;11;1.1;0.0
03;2021-01-18;878;0;4503;11;1.4;0.0
03;2021-01-19;1151;2;5654;13;1.7;0.0
03;2021-01-20;1292;4;6946;17;2.1;0.0
03;2021-01-21;1202;5;8148;22;2.5;0.0
03;2021-01-22;1117;6;9265;28;2.8;0.0
03;2021-01-23;465;1;9730;29;2.9;0.0
03;2021-01-24;0;0;9730;29;2.9;0.0
03;2021-01-25;187;0;9917;29;3.0;0.0
03;2021-01-26;680;14;10597;43;3.2;0.0
03;2021-01-27;696;11;11293;54;3.4;0.0
03;2021-01-28;1021;50;12314;104;3.7;0.0
03;2021-01-29;856;83;13170;187;4.0;0.1
03;2021-01-30;600;2;13770;189;4.2;0.1
03;2021-01-31;0;0;13770;189;4.2;0.1
03;2021-02-01;161;75;13931;264;4.2;0.1
03;2021-02-02;767;268;14698;532;4.4;0.2
03;2021-02-03;1056;492;15754;1024;4.8;0.3
03;2021-02-04;1557;644;17311;1668;5.2;0.5
03;2021-02-05;948;318;18259;1986;5.5;0.6
03;2021-02-06;152;13;18411;1999;5.6;0.6
03;2021-02-07;5;0;18416;1999;5.6;0.6
03;2021-02-08;128;56;18544;2055;5.6;0.6
03;2021-02-09;611;448;19155;2503;5.8;0.8
03;2021-02-10;485;344;19640;2847;5.9;0.9
03;2021-02-11;1027;585;20667;3432;6.2;1.0
03;2021-02-12;1078;555;21745;3987;6.6;1.2
03;2021-02-13;126;167;21871;4154;6.6;1.3
03;2021-02-14;0;1;21871;4155;6.6;1.3
03;2021-02-15;309;862;22180;5017;6.7;1.5
03;2021-02-16;549;1166;22729;6183;6.9;1.9
03;2021-02-17;452;1356;23181;7539;7.0;2.3
03;2021-02-18;368;1270;23549;8809;7.1;2.7
03;2021-02-19;497;794;24046;9603;7.3;2.9
03;2021-02-20;128;183;24174;9786;7.3;3.0
03;2021-02-21;2;1;24176;9787;7.3;3.0
03;2021-02-22;158;202;24334;9989;7.3;3.0
03;2021-02-23;722;949;25056;10938;7.6;3.3
03;2021-02-24;610;1023;25666;11961;7.7;3.6
03;2021-02-25;1094;1834;26760;13795;8.1;4.2
03;2021-02-26;822;1375;27582;15170;8.3;4.6
03;2021-02-27;96;257;27678;15427;8.4;4.7
03;2021-02-28;0;15;27678;15442;8.4;4.7
03;2021-03-01;178;240;27856;15682;8.4;4.7
03;2021-03-02;818;660;28674;16342;8.7;4.9
03;2021-03-03;904;462;29578;16804;8.9;5.1
03;2021-03-04;1543;589;31121;17393;9.4;5.2
03;2021-03-05;1122;737;32243;18130;9.7;5.5
03;2021-03-06;915;114;33158;18244;10.0;5.5
03;2021-03-07;2;0;33160;18244;10.0;5.5
03;2021-03-08;240;246;33400;18490;10.1;5.6
03;2021-03-09;1016;439;34416;18929;10.4;5.7
03;2021-03-10;941;554;35357;19483;10.7;5.9
03;2021-03-11;1674;659;37031;20142;11.2;6.1
03;2021-03-12;1303;869;38334;21011;11.6;6.3
03;2021-03-13;864;114;39198;21125;11.8;6.4
03;2021-03-14;2;8;39200;21133;11.8;6.4
03;2021-03-15;250;200;39450;21333;11.9;6.4
03;2021-03-16;649;404;40099;21737;12.1;6.6
03;2021-03-17;1304;448;41403;22185;12.5;6.7
03;2021-03-18;1720;400;43123;22585;13.0;6.8
03;2021-03-19;1728;365;44851;22950;13.5;6.9
03;2021-03-20;301;27;45152;22977;13.6;6.9
03;2021-03-21;1;0;45153;22977;13.6;6.9
03;2021-03-22;224;398;45377;23375;13.7;7.1
03;2021-03-23;1355;357;46732;23732;14.1;7.2
03;2021-03-24;1824;352;48556;24084;14.7;7.3
03;2021-03-25;2366;571;50922;24655;15.4;7.4
03;2021-03-26;2240;452;53162;25107;16.0;7.6
03;2021-03-27;817;23;53979;25130;16.3;7.6
03;2021-03-28;1;39;53980;25169;16.3;7.6
03;2021-03-29;659;176;54639;25345;16.5;7.6
03;2021-03-30;1907;459;56546;25804;17.1;7.8
03;2021-03-31;1014;988;57560;26792;17.4;8.1
03;2021-04-01;1374;1128;58934;27920;17.8;8.4
03;2021-04-02;1705;617;60639;28537;18.3;8.6
03;2021-04-03;365;100;61004;28637;18.4;8.6
03;2021-04-04;3;0;61007;28637;18.4;8.6
03;2021-04-05;18;14;61025;28651;18.4;8.6
03;2021-04-06;1073;414;62098;29065;18.7;8.8
03;2021-04-07;1562;525;63660;29590;19.2;8.9
03;2021-04-08;2121;488;65781;30078;19.9;9.1
03;2021-04-09;2056;1164;67837;31242;20.5;9.4
03;2021-04-10;1013;73;68850;31315;20.8;9.5
03;2021-04-11;478;9;69328;31324;20.9;9.5
03;2021-04-12;986;228;70314;31552;21.2;9.5
03;2021-04-13;1873;989;72187;32541;21.8;9.8
03;2021-04-14;2334;1225;74521;33766;22.5;10.2
03;2021-04-15;2621;1405;77142;35171;23.3;10.6
03;2021-04-16;2834;1187;79976;36358;24.1;11.0
03;2021-04-17;1083;443;81059;36801;24.5;11.1
03;2021-04-18;0;0;81059;36801;24.5;11.1
03;2021-04-19;1191;588;82250;37389;24.8;11.3
03;2021-04-20;1747;1277;83997;38666;25.4;11.7
03;2021-04-21;1122;1295;85119;39961;25.7;12.1
03;2021-04-22;1675;1007;86794;40968;26.2;12.4
03;2021-04-23;2478;1274;89272;42242;26.9;12.7
03;2021-04-24;1301;928;90573;43170;27.3;13.0
03;2021-04-25;350;16;90923;43186;27.4;13.0
03;2021-04-26;1332;467;92255;43653;27.8;13.2
03;2021-04-27;1766;1530;94021;45183;28.4;13.6
03;2021-04-28;1930;1125;95951;46308;29.0;14.0
03;2021-04-29;2371;1255;98322;47563;29.7;14.4
03;2021-04-30;1931;810;100253;48373;30.3;14.6
03;2021-05-01;438;493;100691;48866;30.4;14.7
03;2021-05-02;2;1;100693;48867;30.4;14.7
03;2021-05-03;1912;775;102605;49642;31.0;15.0
03;2021-05-04;2847;1637;105452;51279;31.8;15.5
03;2021-05-05;2604;1332;108056;52611;32.6;15.9
03;2021-05-06;3095;2011;111151;54622;33.5;16.5
03;2021-05-07;4729;1800;115880;56422;35.0;17.0
03;2021-05-08;661;381;116541;56803;35.2;17.1
03;2021-05-09;49;511;116590;57314;35.2;17.3
03;2021-05-10;1892;1481;118482;58795;35.8;17.7
03;2021-05-11;3902;1841;122384;60636;36.9;18.3
03;2021-05-12;2972;1523;125356;62159;37.8;18.8
03;2021-05-13;4384;410;129740;62569;39.2;18.9
03;2021-05-14;3658;1702;133398;64271;40.3;19.4
03;2021-05-15;1943;491;135341;64762;40.8;19.5
03;2021-05-16;522;57;135863;64819;41.0;19.6
03;2021-05-17;1277;862;137140;65681;41.4;19.8
03;2021-05-18;3068;1506;140208;67187;42.3;20.3
03;2021-05-19;2623;967;142831;68154;43.1;20.6
03;2021-05-20;3334;1145;146165;69299;44.1;20.9
03;2021-05-21;4194;1285;150359;70584;45.4;21.3
03;2021-05-22;2012;360;152371;70944;46.0;21.4
03;2021-05-23;641;73;153012;71017;46.2;21.4
03;2021-05-24;2654;217;155666;71234;47.0;21.5
03;2021-05-25;3067;1692;158733;72926;47.9;22.0
03;2021-05-26;2336;1044;161069;73970;48.6;22.3
03;2021-05-27;2945;1126;164014;75096;49.5;22.7
03;2021-05-28;3848;2287;167862;77383;50.7;23.4
03;2021-05-29;1747;603;169609;77986;51.2;23.5
03;2021-05-30;242;23;169851;78009;51.3;23.5
03;2021-05-31;697;575;170548;78584;51.5;23.7
03;2021-06-01;2302;2347;172850;80931;52.2;24.4
03;2021-06-02;1534;1749;174384;82680;52.6;25.0
03;2021-06-03;2060;2755;176444;85435;53.3;25.8
03;2021-06-04;1698;2508;178142;87943;53.8;26.5
03;2021-06-05;1076;1144;179218;89087;54.1;26.9
03;2021-06-06;60;7;179278;89094;54.1;26.9
03;2021-06-07;785;1815;180063;90909;54.3;27.4
03;2021-06-08;1458;2557;181521;93466;54.8;28.2
03;2021-06-09;1267;1877;182788;95343;55.2;28.8
03;2021-06-10;1381;2124;184169;97467;55.6;29.4
03;2021-06-11;1503;3450;185672;100917;56.0;30.5
03;2021-06-12;831;823;186503;101740;56.3;30.7
03;2021-06-13;20;10;186523;101750;56.3;30.7
03;2021-06-14;381;2177;186904;103927;56.4;31.4
03;2021-06-15;1317;3837;188221;107764;56.8;32.5
03;2021-06-16;788;2890;189009;110654;57.0;33.4
03;2021-06-17;1083;3334;190092;113988;57.4;34.4
03;2021-06-18;1107;3981;191199;117969;57.7;35.6
03;2021-06-19;641;1618;191840;119587;57.9;36.1
03;2021-06-20;20;8;191860;119595;57.9;36.1
03;2021-06-21;461;2636;192321;122231;58.0;36.9
03;2021-06-22;1027;4003;193348;126234;58.4;38.1
03;2021-06-23;716;3285;194064;129519;58.6;39.1
03;2021-06-24;982;3862;195046;133381;58.9;40.3
03;2021-06-25;1016;3893;196062;137274;59.2;41.4
03;2021-06-26;513;2040;196575;139314;59.3;42.0
03;2021-06-27;65;486;196640;139800;59.4;42.2
03;2021-06-28;642;2101;197282;141901;59.5;42.8
03;2021-06-29;1028;3330;198310;145231;59.9;43.8
03;2021-06-30;831;3120;199141;148351;60.1;44.8
03;2021-07-01;987;2936;200128;151287;60.4;45.7
03;2021-07-02;920;4094;201048;155381;60.7;46.9
03;2021-07-03;487;1884;201535;157265;60.8;47.5
03;2021-07-04;20;332;201555;157597;60.8;47.6
03;2021-07-05;818;2381;202373;159978;61.1;48.3
03;2021-07-06;1172;3462;203545;163440;61.4;49.3
03;2021-07-07;804;2618;204349;166058;61.7;50.1
03;2021-07-08;1060;3043;205409;169101;62.0;51.0
03;2021-07-09;1470;3626;206879;172727;62.4;52.1
03;2021-07-10;508;1925;207387;174652;62.6;52.7
03;2021-07-11;61;492;207448;175144;62.6;52.9
03;2021-07-12;939;1148;208387;176292;62.9;53.2
03;2021-07-13;2613;3153;211000;179445;63.7;54.2
03;2021-07-14;195;25;211195;179470;63.7;54.2
03;2021-07-15;2612;2454;213807;181924;64.5;54.9
03;2021-07-16;2737;2275;216544;184199;65.4;55.6
03;2021-07-17;1032;1626;217576;185825;65.7;56.1
03;2021-07-18;33;8;217609;185833;65.7;56.1
03;2021-07-19;2391;1277;220000;187110;66.4;56.5
03;2021-07-20;3075;3033;223075;190143;67.3;57.4
03;2021-07-21;3213;1440;226288;191583;68.3;57.8
03;2021-07-22;2851;1889;229139;193472;69.2;58.4
03;2021-07-23;3205;1307;232344;194779;70.1;58.8
03;2021-07-24;590;581;232934;195360;70.3;59.0
03;2021-07-25;18;5;232952;195365;70.3;59.0
03;2021-07-26;2043;1579;234995;196944;70.9;59.4
03;2021-07-27;3321;2231;238316;199175;71.9;60.1
03;2021-07-28;2719;1118;241035;200293;72.8;60.5
03;2021-07-29;2550;1663;243585;201956;73.5;61.0
03;2021-07-30;2136;1455;245721;203411;74.2;61.4
03;2021-07-31;964;893;246685;204304;74.5;61.7
03;2021-08-01;13;20;246698;204324;74.5;61.7
03;2021-08-02;1679;1605;248377;205929;75.0;62.2
03;2021-08-03;2223;2778;250600;208707;75.6;63.0
03;2021-08-04;2196;895;252796;209602;76.3;63.3
03;2021-08-05;1265;1939;254061;211541;76.7;63.8
03;2021-08-06;1281;1028;255342;212569;77.1;64.2
03;2021-08-07;614;496;255956;213065;77.3;64.3
03;2021-08-08;66;29;256022;213094;77.3;64.3
03;2021-08-09;597;1304;256619;214398;77.5;64.7
03;2021-08-10;1676;3471;258295;217869;78.0;65.8
03;2021-08-11;1333;2529;259628;220398;78.4;66.5
03;2021-08-12;1135;3513;260763;223911;78.7;67.6
03;2021-08-13;776;1052;261539;224963;78.9;67.9
03;2021-08-14;380;566;261919;225529;79.1;68.1
03;2021-08-15;9;61;261928;225590;79.1;68.1
03;2021-08-16;725;2693;262653;228283;79.3;68.9
03;2021-08-17;1076;3219;263729;231502;79.6;69.9
03;2021-08-18;1164;2157;264893;233659;80.0;70.5
03;2021-08-19;1009;3049;265902;236708;80.3;71.4
03;2021-08-20;718;1138;266620;237846;80.5;71.8
03;2021-08-21;418;727;267038;238573;80.6;72.0
03;2021-08-22;8;6;267046;238579;80.6;72.0
03;2021-08-23;785;2289;267831;240868;80.8;72.7
03;2021-08-24;893;2406;268724;243274;81.1;73.4
03;2021-08-25;935;2029;269659;245303;81.4;74.0
03;2021-08-26;574;1435;270233;246738;81.6;74.5
03;2021-08-27;457;1582;270690;248320;81.7;74.9
03;2021-08-28;219;674;270909;248994;81.8;75.2
03;2021-08-29;4;0;270913;248994;81.8;75.2
03;2021-08-30;768;1450;271681;250444;82.0;75.6
03;2021-08-31;706;1949;272387;252393;82.2;76.2
03;2021-09-01;604;1292;272991;253685;82.4;76.6
03;2021-09-02;479;1091;273470;254776;82.5;76.9
03;2021-09-03;494;1073;273964;255849;82.7;77.2
03;2021-09-04;251;608;274215;256457;82.8;77.4
03;2021-09-05;7;14;274222;256471;82.8;77.4
03;2021-09-06;321;689;274543;257160;82.9;77.6
03;2021-09-07;579;1172;275122;258332;83.0;78.0
03;2021-09-08;424;1244;275546;259576;83.2;78.3
03;2021-09-09;276;661;275822;260237;83.3;78.5
03;2021-09-10;414;911;276236;261148;83.4;78.8
03;2021-09-11;209;651;276445;261799;83.4;79.0
03;2021-09-12;2;20;276447;261819;83.4;79.0
03;2021-09-13;285;660;276732;262479;83.5;79.2
03;2021-09-14;450;931;277182;263410;83.7;79.5
03;2021-09-15;360;996;277542;264406;83.8;79.8
03;2021-09-16;219;555;277761;264961;83.8;80.0
03;2021-09-17;161;356;277922;265317;83.9;80.1
03;2021-09-18;133;311;278055;265628;83.9;80.2
03;2021-09-19;0;11;278055;265639;83.9;80.2
03;2021-09-20;187;425;278242;266064;84.0;80.3
03;2021-09-21;252;721;278494;266785;84.1;80.5
03;2021-09-22;268;685;278762;267470;84.1;80.7
03;2021-09-23;179;461;278941;267931;84.2;80.9
03;2021-09-24;148;321;279089;268252;84.2;81.0
03;2021-09-25;51;258;279140;268510;84.3;81.0
03;2021-09-26;3;0;279143;268510;84.3;81.0
03;2021-09-27;117;325;279260;268835;84.3;81.1
03;2021-09-28;193;618;279453;269453;84.3;81.3
03;2021-09-29;213;505;279666;269958;84.4;81.5
03;2021-09-30;122;251;279788;270209;84.4;81.6
03;2021-10-01;157;489;279945;270698;84.5;81.7
03;2021-10-02;82;176;280027;270874;84.5;81.8
03;2021-10-03;0;0;280027;270874;84.5;81.8
03;2021-10-04;42;102;280069;270976;84.5;81.8
03;2021-10-05;169;391;280238;271367;84.6;81.9
03;2021-10-06;274;546;280512;271913;84.7;82.1
03;2021-10-07;99;207;280611;272120;84.7;82.1
03;2021-10-08;130;282;280741;272402;84.7;82.2
03;2021-10-09;109;165;280850;272567;84.8;82.3
03;2021-10-10;5;2;280855;272569;84.8;82.3
03;2021-10-11;160;293;281015;272862;84.8;82.4
03;2021-10-12;180;285;281195;273147;84.9;82.4
03;2021-10-13;242;385;281437;273532;84.9;82.6
03;2021-10-14;89;154;281526;273686;85.0;82.6
03;2021-10-15;69;178;281595;273864;85.0;82.7
03;2021-10-16;71;99;281666;273963;85.0;82.7
03;2021-10-17;0;1;281666;273964;85.0;82.7
03;2021-10-18;80;110;281746;274074;85.0;82.7
03;2021-10-19;118;149;281864;274223;85.1;82.8
04;2020-12-27;0;0;0;0;0.0;0.0
04;2020-12-28;1;0;1;0;0.0;0.0
04;2020-12-29;0;0;1;0;0.0;0.0
04;2020-12-30;0;0;1;0;0.0;0.0
04;2020-12-31;0;0;1;0;0.0;0.0
04;2021-01-01;0;0;1;0;0.0;0.0
04;2021-01-02;0;0;1;0;0.0;0.0
04;2021-01-03;0;0;1;0;0.0;0.0
04;2021-01-04;0;0;1;0;0.0;0.0
04;2021-01-05;4;0;5;0;0.0;0.0
04;2021-01-06;0;0;5;0;0.0;0.0
04;2021-01-07;61;0;66;0;0.0;0.0
04;2021-01-08;89;0;155;0;0.1;0.0
04;2021-01-09;57;0;212;0;0.1;0.0
04;2021-01-10;0;0;212;0;0.1;0.0
04;2021-01-11;77;0;289;0;0.2;0.0
04;2021-01-12;421;0;710;0;0.4;0.0
04;2021-01-13;244;2;954;2;0.6;0.0
04;2021-01-14;90;2;1044;4;0.6;0.0
04;2021-01-15;164;4;1208;8;0.7;0.0
04;2021-01-16;106;3;1314;11;0.8;0.0
04;2021-01-17;14;0;1328;11;0.8;0.0
04;2021-01-18;236;9;1564;20;0.9;0.0
04;2021-01-19;469;4;2033;24;1.2;0.0
04;2021-01-20;574;10;2607;34;1.6;0.0
04;2021-01-21;615;6;3222;40;2.0;0.0
04;2021-01-22;638;1;3860;41;2.3;0.0
04;2021-01-23;111;0;3971;41;2.4;0.0
04;2021-01-24;0;0;3971;41;2.4;0.0
04;2021-01-25;240;0;4211;41;2.5;0.0
04;2021-01-26;656;1;4867;42;2.9;0.0
04;2021-01-27;480;0;5347;42;3.2;0.0
04;2021-01-28;665;22;6012;64;3.6;0.0
04;2021-01-29;368;43;6380;107;3.9;0.1
04;2021-01-30;65;41;6445;148;3.9;0.1
04;2021-01-31;1;5;6446;153;3.9;0.1
04;2021-02-01;268;150;6714;303;4.1;0.2
04;2021-02-02;562;225;7276;528;4.4;0.3
04;2021-02-03;367;159;7643;687;4.6;0.4
04;2021-02-04;359;54;8002;741;4.8;0.4
04;2021-02-05;379;219;8381;960;5.1;0.6
04;2021-02-06;50;93;8431;1053;5.1;0.6
04;2021-02-07;2;22;8433;1075;5.1;0.7
04;2021-02-08;163;71;8596;1146;5.2;0.7
04;2021-02-09;196;143;8792;1289;5.3;0.8
04;2021-02-10;253;170;9045;1459;5.5;0.9
04;2021-02-11;363;291;9408;1750;5.7;1.1
04;2021-02-12;293;317;9701;2067;5.9;1.3
04;2021-02-13;27;94;9728;2161;5.9;1.3
04;2021-02-14;0;0;9728;2161;5.9;1.3
04;2021-02-15;31;164;9759;2325;5.9;1.4
04;2021-02-16;81;520;9840;2845;6.0;1.7
04;2021-02-17;67;431;9907;3276;6.0;2.0
04;2021-02-18;45;614;9952;3890;6.0;2.4
04;2021-02-19;53;371;10005;4261;6.1;2.6
04;2021-02-20;5;71;10010;4332;6.1;2.6
04;2021-02-21;0;0;10010;4332;6.1;2.6
04;2021-02-22;7;297;10017;4629;6.1;2.8
04;2021-02-23;19;594;10036;5223;6.1;3.2
04;2021-02-24;38;447;10074;5670;6.1;3.4
04;2021-02-25;73;377;10147;6047;6.1;3.7
04;2021-02-26;216;335;10363;6382;6.3;3.9
04;2021-02-27;179;75;10542;6457;6.4;3.9
04;2021-02-28;1;0;10543;6457;6.4;3.9
04;2021-03-01;18;74;10561;6531;6.4;4.0
04;2021-03-02;135;41;10696;6572;6.5;4.0
04;2021-03-03;375;646;11071;7218;6.7;4.4
04;2021-03-04;208;490;11279;7708;6.8;4.7
04;2021-03-05;236;358;11515;8066;7.0;4.9
04;2021-03-06;912;78;12427;8144;7.5;4.9
04;2021-03-07;498;26;12925;8170;7.8;4.9
04;2021-03-08;45;84;12970;8254;7.9;5.0
04;2021-03-09;215;258;13185;8512;8.0;5.2
04;2021-03-10;401;374;13586;8886;8.2;5.4
04;2021-03-11;496;342;14082;9228;8.5;5.6
04;2021-03-12;697;210;14779;9438;8.9;5.7
04;2021-03-13;1088;64;15867;9502;9.6;5.8
04;2021-03-14;460;4;16327;9506;9.9;5.8
04;2021-03-15;93;14;16420;9520;9.9;5.8
04;2021-03-16;74;9;16494;9529;10.0;5.8
04;2021-03-17;534;86;17028;9615;10.3;5.8
04;2021-03-18;814;25;17842;9640;10.8;5.8
04;2021-03-19;723;33;18565;9673;11.2;5.9
04;2021-03-20;159;3;18724;9676;11.3;5.9
04;2021-03-21;0;0;18724;9676;11.3;5.9
04;2021-03-22;105;13;18829;9689;11.4;5.9
04;2021-03-23;245;7;19074;9696;11.5;5.9
04;2021-03-24;1024;54;20098;9750;12.2;5.9
04;2021-03-25;1326;48;21424;9798;13.0;5.9
04;2021-03-26;1448;69;22872;9867;13.8;6.0
04;2021-03-27;266;22;23138;9889;14.0;6.0
04;2021-03-28;2;0;23140;9889;14.0;6.0
04;2021-03-29;680;13;23820;9902;14.4;6.0
04;2021-03-30;1086;151;24906;10053;15.1;6.1
04;2021-03-31;1327;107;26233;10160;15.9;6.2
04;2021-04-01;1133;134;27366;10294;16.6;6.2
04;2021-04-02;1185;114;28551;10408;17.3;6.3
04;2021-04-03;250;21;28801;10429;17.4;6.3
04;2021-04-04;1;0;28802;10429;17.4;6.3
04;2021-04-05;36;1;28838;10430;17.5;6.3
04;2021-04-06;929;155;29767;10585;18.0;6.4
04;2021-04-07;880;438;30647;11023;18.6;6.7
04;2021-04-08;926;697;31573;11720;19.1;7.1
04;2021-04-09;678;423;32251;12143;19.5;7.4
04;2021-04-10;231;192;32482;12335;19.7;7.5
04;2021-04-11;154;65;32636;12400;19.8;7.5
04;2021-04-12;593;103;33229;12503;20.1;7.6
04;2021-04-13;1190;242;34419;12745;20.8;7.7
04;2021-04-14;994;500;35413;13245;21.4;8.0
04;2021-04-15;921;673;36334;13918;22.0;8.4
04;2021-04-16;819;457;37153;14375;22.5;8.7
04;2021-04-17;209;69;37362;14444;22.6;8.7
04;2021-04-18;0;13;37362;14457;22.6;8.8
04;2021-04-19;338;288;37700;14745;22.8;8.9
04;2021-04-20;1003;446;38703;15191;23.4;9.2
04;2021-04-21;656;747;39359;15938;23.8;9.6
04;2021-04-22;758;855;40117;16793;24.3;10.2
04;2021-04-23;696;541;40813;17334;24.7;10.5
04;2021-04-24;165;65;40978;17399;24.8;10.5
04;2021-04-25;0;0;40978;17399;24.8;10.5
04;2021-04-26;172;613;41150;18012;24.9;10.9
04;2021-04-27;395;967;41545;18979;25.1;11.5
04;2021-04-28;431;1089;41976;20068;25.4;12.1
04;2021-04-29;688;1130;42664;21198;25.8;12.8
04;2021-04-30;436;850;43100;22048;26.1;13.3
04;2021-05-01;104;22;43204;22070;26.2;13.4
04;2021-05-02;8;131;43212;22201;26.2;13.4
04;2021-05-03;151;551;43363;22752;26.2;13.8
04;2021-05-04;564;839;43927;23591;26.6;14.3
04;2021-05-05;514;927;44441;24518;26.9;14.8
04;2021-05-06;1161;593;45602;25111;27.6;15.2
04;2021-05-07;656;767;46258;25878;28.0;15.7
04;2021-05-08;48;99;46306;25977;28.0;15.7
04;2021-05-09;0;0;46306;25977;28.0;15.7
04;2021-05-10;467;297;46773;26274;28.3;15.9
04;2021-05-11;1198;907;47971;27181;29.0;16.5
04;2021-05-12;1387;741;49358;27922;29.9;16.9
04;2021-05-13;378;131;49736;28053;30.1;17.0
04;2021-05-14;441;296;50177;28349;30.4;17.2
04;2021-05-15;99;162;50276;28511;30.4;17.3
04;2021-05-16;4;6;50280;28517;30.4;17.3
04;2021-05-17;155;297;50435;28814;30.5;17.4
04;2021-05-18;392;975;50827;29789;30.8;18.0
04;2021-05-19;773;688;51600;30477;31.2;18.4
04;2021-05-20;1256;548;52856;31025;32.0;18.8
04;2021-05-21;853;787;53709;31812;32.5;19.3
04;2021-05-22;105;146;53814;31958;32.6;19.3
04;2021-05-23;1;1;53815;31959;32.6;19.3
04;2021-05-24;2;36;53817;31995;32.6;19.4
04;2021-05-25;868;596;54685;32591;33.1;19.7
04;2021-05-26;1048;791;55733;33382;33.7;20.2
04;2021-05-27;1356;632;57089;34014;34.6;20.6
04;2021-05-28;1119;656;58208;34670;35.2;21.0
04;2021-05-29;90;398;58298;35068;35.3;21.2
04;2021-05-30;3;1;58301;35069;35.3;21.2
04;2021-05-31;420;416;58721;35485;35.5;21.5
04;2021-06-01;640;641;59361;36126;35.9;21.9
04;2021-06-02;871;1063;60232;37189;36.5;22.5
04;2021-06-03;1196;851;61428;38040;37.2;23.0
04;2021-06-04;978;779;62406;38819;37.8;23.5
04;2021-06-05;142;203;62548;39022;37.9;23.6
04;2021-06-06;7;13;62555;39035;37.9;23.6
04;2021-06-07;563;317;63118;39352;38.2;23.8
04;2021-06-08;839;595;63957;39947;38.7;24.2
04;2021-06-09;1146;689;65103;40636;39.4;24.6
04;2021-06-10;1142;585;66245;41221;40.1;25.0
04;2021-06-11;944;615;67189;41836;40.7;25.3
04;2021-06-12;212;148;67401;41984;40.8;25.4
04;2021-06-13;1;1;67402;41985;40.8;25.4
04;2021-06-14;478;303;67880;42288;41.1;25.6
04;2021-06-15;644;1002;68524;43290;41.5;26.2
04;2021-06-16;1023;787;69547;44077;42.1;26.7
04;2021-06-17;1001;959;70548;45036;42.7;27.3
04;2021-06-18;761;886;71309;45922;43.2;27.8
04;2021-06-19;40;85;71349;46007;43.2;27.8
04;2021-06-20;7;9;71356;46016;43.2;27.9
04;2021-06-21;304;613;71660;46629;43.4;28.2
04;2021-06-22;361;1308;72021;47937;43.6;29.0
04;2021-06-23;474;1312;72495;49249;43.9;29.8
04;2021-06-24;852;820;73347;50069;44.4;30.3
04;2021-06-25;461;639;73808;50708;44.7;30.7
04;2021-06-26;57;130;73865;50838;44.7;30.8
04;2021-06-27;4;4;73869;50842;44.7;30.8
04;2021-06-28;158;341;74027;51183;44.8;31.0
04;2021-06-29;370;838;74397;52021;45.0;31.5
04;2021-06-30;541;1123;74938;53144;45.4;32.2
04;2021-07-01;578;1219;75516;54363;45.7;32.9
04;2021-07-02;557;1090;76073;55453;46.0;33.6
04;2021-07-03;65;162;76138;55615;46.1;33.7
04;2021-07-04;6;6;76144;55621;46.1;33.7
04;2021-07-05;106;297;76250;55918;46.2;33.8
04;2021-07-06;503;1383;76753;57301;46.5;34.7
04;2021-07-07;494;1341;77247;58642;46.8;35.5
04;2021-07-08;725;1361;77972;60003;47.2;36.3
04;2021-07-09;580;1063;78552;61066;47.6;37.0
04;2021-07-10;92;177;78644;61243;47.6;37.1
04;2021-07-11;0;21;78644;61264;47.6;37.1
04;2021-07-12;128;652;78772;61916;47.7;37.5
04;2021-07-13;883;1541;79655;63457;48.2;38.4
04;2021-07-14;26;43;79681;63500;48.2;38.4
04;2021-07-15;1219;1736;80900;65236;49.0;39.5
04;2021-07-16;1082;1119;81982;66355;49.6;40.2
04;2021-07-17;446;235;82428;66590;49.9;40.3
04;2021-07-18;114;18;82542;66608;50.0;40.3
04;2021-07-19;484;655;83026;67263;50.3;40.7
04;2021-07-20;1313;1469;84339;68732;51.1;41.6
04;2021-07-21;1126;1165;85465;69897;51.7;42.3
04;2021-07-22;1500;1372;86965;71269;52.6;43.1
04;2021-07-23;1150;1142;88115;72411;53.3;43.8
04;2021-07-24;685;216;88800;72627;53.8;44.0
04;2021-07-25;42;20;88842;72647;53.8;44.0
04;2021-07-26;445;639;89287;73286;54.0;44.4
04;2021-07-27;1370;1046;90657;74332;54.9;45.0
04;2021-07-28;1073;1037;91730;75369;55.5;45.6
04;2021-07-29;1561;1302;93291;76671;56.5;46.4
04;2021-07-30;1244;924;94535;77595;57.2;47.0
04;2021-07-31;251;176;94786;77771;57.4;47.1
04;2021-08-01;48;19;94834;77790;57.4;47.1
04;2021-08-02;196;110;95030;77900;57.5;47.2
04;2021-08-03;1348;1119;96378;79019;58.3;47.8
04;2021-08-04;1179;865;97557;79884;59.1;48.4
04;2021-08-05;1194;738;98751;80622;59.8;48.8
04;2021-08-06;516;396;99267;81018;60.1;49.0
04;2021-08-07;162;162;99429;81180;60.2;49.1
04;2021-08-08;25;12;99454;81192;60.2;49.1
04;2021-08-09;102;117;99556;81309;60.3;49.2
04;2021-08-10;655;981;100211;82290;60.7;49.8
04;2021-08-11;1147;1022;101358;83312;61.4;50.4
04;2021-08-12;1125;1308;102483;84620;62.0;51.2
04;2021-08-13;443;387;102926;85007;62.3;51.5
04;2021-08-14;100;73;103026;85080;62.4;51.5
04;2021-08-15;1;0;103027;85080;62.4;51.5
04;2021-08-16;103;138;103130;85218;62.4;51.6
04;2021-08-17;496;1015;103626;86233;62.7;52.2
04;2021-08-18;720;1318;104346;87551;63.2;53.0
04;2021-08-19;740;1413;105086;88964;63.6;53.9
04;2021-08-20;749;1363;105835;90327;64.1;54.7
04;2021-08-21;66;111;105901;90438;64.1;54.7
04;2021-08-22;15;45;105916;90483;64.1;54.8
04;2021-08-23;55;110;105971;90593;64.1;54.8
04;2021-08-24;685;1494;106656;92087;64.6;55.7
04;2021-08-25;658;1183;107314;93270;65.0;56.5
04;2021-08-26;488;1217;107802;94487;65.3;57.2
04;2021-08-27;452;929;108254;95416;65.5;57.8
04;2021-08-28;132;245;108386;95661;65.6;57.9
04;2021-08-29;27;23;108413;95684;65.6;57.9
04;2021-08-30;122;240;108535;95924;65.7;58.1
04;2021-08-31;511;976;109046;96900;66.0;58.7
04;2021-09-01;511;1200;109557;98100;66.3;59.4
04;2021-09-02;336;855;109893;98955;66.5;59.9
04;2021-09-03;289;766;110182;99721;66.7;60.4
04;2021-09-04;149;227;110331;99948;66.8;60.5
04;2021-09-05;14;9;110345;99957;66.8;60.5
04;2021-09-06;57;103;110402;100060;66.8;60.6
04;2021-09-07;371;834;110773;100894;67.1;61.1
04;2021-09-08;328;740;111101;101634;67.3;61.5
04;2021-09-09;341;724;111442;102358;67.5;62.0
04;2021-09-10;280;667;111722;103025;67.6;62.4
04;2021-09-11;93;114;111815;103139;67.7;62.4
04;2021-09-12;19;23;111834;103162;67.7;62.4
04;2021-09-13;95;72;111929;103234;67.8;62.5
04;2021-09-14;336;609;112265;103843;68.0;62.9
04;2021-09-15;310;702;112575;104545;68.1;63.3
04;2021-09-16;312;523;112887;105068;68.3;63.6
04;2021-09-17;185;565;113072;105633;68.4;63.9
04;2021-09-18;48;123;113120;105756;68.5;64.0
04;2021-09-19;0;5;113120;105761;68.5;64.0
04;2021-09-20;79;52;113199;105813;68.5;64.1
04;2021-09-21;188;571;113387;106384;68.6;64.4
04;2021-09-22;162;677;113549;107061;68.7;64.8
04;2021-09-23;207;377;113756;107438;68.9;65.0
04;2021-09-24;143;436;113899;107874;68.9;65.3
04;2021-09-25;42;99;113941;107973;69.0;65.4
04;2021-09-26;6;26;113947;107999;69.0;65.4
04;2021-09-27;19;66;113966;108065;69.0;65.4
04;2021-09-28;139;277;114105;108342;69.1;65.6
04;2021-09-29;136;383;114241;108725;69.2;65.8
04;2021-09-30;123;274;114364;108999;69.2;66.0
04;2021-10-01;120;183;114484;109182;69.3;66.1
04;2021-10-02;60;135;114544;109317;69.3;66.2
04;2021-10-03;3;5;114547;109322;69.3;66.2
04;2021-10-04;35;45;114582;109367;69.4;66.2
04;2021-10-05;171;341;114753;109708;69.5;66.4
04;2021-10-06;183;343;114936;110051;69.6;66.6
04;2021-10-07;94;282;115030;110333;69.6;66.8
04;2021-10-08;99;171;115129;110504;69.7;66.9
04;2021-10-09;25;88;115154;110592;69.7;66.9
04;2021-10-10;2;2;115156;110594;69.7;66.9
04;2021-10-11;33;118;115189;110712;69.7;67.0
04;2021-10-12;112;187;115301;110899;69.8;67.1
04;2021-10-13;169;272;115470;111171;69.9;67.3
04;2021-10-14;74;198;115544;111369;69.9;67.4
04;2021-10-15;69;139;115613;111508;70.0;67.5
04;2021-10-16;39;70;115652;111578;70.0;67.5
04;2021-10-17;4;4;115656;111582;70.0;67.5
04;2021-10-18;58;96;115714;111678;70.0;67.6
04;2021-10-19;74;201;115788;111879;70.1;67.7
05;2020-12-27;0;0;0;0;0.0;0.0
05;2020-12-28;1;0;1;0;0.0;0.0
05;2020-12-29;1;0;2;0;0.0;0.0
05;2020-12-30;2;0;4;0;0.0;0.0
05;2020-12-31;0;0;4;0;0.0;0.0
05;2021-01-01;2;0;6;0;0.0;0.0
05;2021-01-02;2;0;8;0;0.0;0.0
05;2021-01-03;1;0;9;0;0.0;0.0
05;2021-01-04;2;0;11;0;0.0;0.0
05;2021-01-05;0;0;11;0;0.0;0.0
05;2021-01-06;22;1;33;1;0.0;0.0
05;2021-01-07;128;0;161;1;0.1;0.0
05;2021-01-08;146;1;307;2;0.2;0.0
05;2021-01-09;11;0;318;2;0.2;0.0
05;2021-01-10;0;0;318;2;0.2;0.0
05;2021-01-11;44;0;362;2;0.3;0.0
05;2021-01-12;104;0;466;2;0.3;0.0
05;2021-01-13;139;0;605;2;0.4;0.0
05;2021-01-14;167;0;772;2;0.5;0.0
05;2021-01-15;127;1;899;3;0.6;0.0
05;2021-01-16;15;0;914;3;0.6;0.0
05;2021-01-17;0;0;914;3;0.6;0.0
05;2021-01-18;226;1;1140;4;0.8;0.0
05;2021-01-19;227;0;1367;4;1.0;0.0
05;2021-01-20;213;0;1580;4;1.1;0.0
05;2021-01-21;255;0;1835;4;1.3;0.0
05;2021-01-22;196;1;2031;5;1.4;0.0
05;2021-01-23;113;0;2144;5;1.5;0.0
05;2021-01-24;0;0;2144;5;1.5;0.0
05;2021-01-25;316;0;2460;5;1.7;0.0
05;2021-01-26;486;0;2946;5;2.1;0.0
05;2021-01-27;389;4;3335;9;2.4;0.0
05;2021-01-28;363;56;3698;65;2.6;0.0
05;2021-01-29;364;113;4062;178;2.9;0.1
05;2021-01-30;97;9;4159;187;2.9;0.1
05;2021-01-31;4;0;4163;187;2.9;0.1
05;2021-02-01;177;21;4340;208;3.1;0.1
05;2021-02-02;187;120;4527;328;3.2;0.2
05;2021-02-03;208;63;4735;391;3.3;0.3
05;2021-02-04;197;125;4932;516;3.5;0.4
05;2021-02-05;183;109;5115;625;3.6;0.4
05;2021-02-06;76;24;5191;649;3.7;0.5
05;2021-02-07;2;5;5193;654;3.7;0.5
05;2021-02-08;84;124;5277;778;3.7;0.5
05;2021-02-09;97;113;5374;891;3.8;0.6
05;2021-02-10;81;175;5455;1066;3.8;0.8
05;2021-02-11;87;137;5542;1203;3.9;0.8
05;2021-02-12;85;148;5627;1351;4.0;1.0
05;2021-02-13;75;31;5702;1382;4.0;1.0
05;2021-02-14;0;0;5702;1382;4.0;1.0
05;2021-02-15;98;190;5800;1572;4.1;1.1
05;2021-02-16;111;286;5911;1858;4.2;1.3
05;2021-02-17;136;231;6047;2089;4.3;1.5
05;2021-02-18;154;299;6201;2388;4.4;1.7
05;2021-02-19;158;322;6359;2710;4.5;1.9
05;2021-02-20;31;87;6390;2797;4.5;2.0
05;2021-02-21;0;0;6390;2797;4.5;2.0
05;2021-02-22;70;247;6460;3044;4.6;2.1
05;2021-02-23;18;237;6478;3281;4.6;2.3
05;2021-02-24;20;190;6498;3471;4.6;2.4
05;2021-02-25;56;174;6554;3645;4.6;2.6
05;2021-02-26;145;215;6699;3860;4.7;2.7
05;2021-02-27;65;171;6764;4031;4.8;2.8
05;2021-02-28;11;0;6775;4031;4.8;2.8
05;2021-03-01;92;169;6867;4200;4.8;3.0
05;2021-03-02;92;198;6959;4398;4.9;3.1
05;2021-03-03;112;233;7071;4631;5.0;3.3
05;2021-03-04;242;167;7313;4798;5.2;3.4
05;2021-03-05;578;193;7891;4991;5.6;3.5
05;2021-03-06;670;60;8561;5051;6.0;3.6
05;2021-03-07;516;21;9077;5072;6.4;3.6
05;2021-03-08;557;139;9634;5211;6.8;3.7
05;2021-03-09;520;167;10154;5378;7.2;3.8
05;2021-03-10;498;145;10652;5523;7.5;3.9
05;2021-03-11;378;141;11030;5664;7.8;4.0
05;2021-03-12;437;93;11467;5757;8.1;4.1
05;2021-03-13;797;100;12264;5857;8.7;4.1
05;2021-03-14;670;12;12934;5869;9.1;4.1
05;2021-03-15;354;125;13288;5994;9.4;4.2
05;2021-03-16;149;144;13437;6138;9.5;4.3
05;2021-03-17;261;120;13698;6258;9.7;4.4
05;2021-03-18;364;35;14062;6293;9.9;4.4
05;2021-03-19;450;59;14512;6352;10.2;4.5
05;2021-03-20;167;32;14679;6384;10.4;4.5
05;2021-03-21;1;0;14680;6384;10.4;4.5
05;2021-03-22;718;39;15398;6423;10.9;4.5
05;2021-03-23;805;18;16203;6441;11.4;4.5
05;2021-03-24;789;78;16992;6519;12.0;4.6
05;2021-03-25;901;60;17893;6579;12.6;4.6
05;2021-03-26;1023;49;18916;6628;13.3;4.7
05;2021-03-27;467;35;19383;6663;13.7;4.7
05;2021-03-28;10;0;19393;6663;13.7;4.7
05;2021-03-29;905;67;20298;6730;14.3;4.7
05;2021-03-30;1142;79;21440;6809;15.1;4.8
05;2021-03-31;824;255;22264;7064;15.7;5.0
05;2021-04-01;901;244;23165;7308;16.3;5.2
05;2021-04-02;664;380;23829;7688;16.8;5.4
05;2021-04-03;551;187;24380;7875;17.2;5.6
05;2021-04-04;350;64;24730;7939;17.4;5.6
05;2021-04-05;158;12;24888;7951;17.6;5.6
05;2021-04-06;646;276;25534;8227;18.0;5.8
05;2021-04-07;773;324;26307;8551;18.6;6.0
05;2021-04-08;733;338;27040;8889;19.1;6.3
05;2021-04-09;883;413;27923;9302;19.7;6.6
05;2021-04-10;714;389;28637;9691;20.2;6.8
05;2021-04-11;191;174;28828;9865;20.3;7.0
05;2021-04-12;732;265;29560;10130;20.9;7.1
05;2021-04-13;921;249;30481;10379;21.5;7.3
05;2021-04-14;666;328;31147;10707;22.0;7.6
05;2021-04-15;768;400;31915;11107;22.5;7.8
05;2021-04-16;729;410;32644;11517;23.0;8.1
05;2021-04-17;671;242;33315;11759;23.5;8.3
05;2021-04-18;305;23;33620;11782;23.7;8.3
05;2021-04-19;363;538;33983;12320;24.0;8.7
05;2021-04-20;482;631;34465;12951;24.3;9.1
05;2021-04-21;494;629;34959;13580;24.7;9.6
05;2021-04-22;385;549;35344;14129;24.9;10.0
05;2021-04-23;523;657;35867;14786;25.3;10.4
05;2021-04-24;347;384;36214;15170;25.5;10.7
05;2021-04-25;288;23;36502;15193;25.7;10.7
05;2021-04-26;367;708;36869;15901;26.0;11.2
05;2021-04-27;657;751;37526;16652;26.5;11.7
05;2021-04-28;468;721;37994;17373;26.8;12.3
05;2021-04-29;702;750;38696;18123;27.3;12.8
05;2021-04-30;509;756;39205;18879;27.7;13.3
05;2021-05-01;138;110;39343;18989;27.8;13.4
05;2021-05-02;267;115;39610;19104;27.9;13.5
05;2021-05-03;458;494;40068;19598;28.3;13.8
05;2021-05-04;384;503;40452;20101;28.5;14.2
05;2021-05-05;461;671;40913;20772;28.9;14.7
05;2021-05-06;644;726;41557;21498;29.3;15.2
05;2021-05-07;595;800;42152;22298;29.7;15.7
05;2021-05-08;481;177;42633;22475;30.1;15.9
05;2021-05-09;208;57;42841;22532;30.2;15.9
05;2021-05-10;500;697;43341;23229;30.6;16.4
05;2021-05-11;669;916;44010;24145;31.0;17.0
05;2021-05-12;647;733;44657;24878;31.5;17.5
05;2021-05-13;960;116;45617;24994;32.2;17.6
05;2021-05-14;826;495;46443;25489;32.8;18.0
05;2021-05-15;1044;353;47487;25842;33.5;18.2
05;2021-05-16;235;52;47722;25894;33.7;18.3
05;2021-05-17;484;430;48206;26324;34.0;18.6
05;2021-05-18;519;419;48725;26743;34.4;18.9
05;2021-05-19;727;459;49452;27202;34.9;19.2
05;2021-05-20;747;434;50199;27636;35.4;19.5
05;2021-05-21;705;513;50904;28149;35.9;19.9
05;2021-05-22;607;239;51511;28388;36.3;20.0
05;2021-05-23;277;59;51788;28447;36.5;20.1
05;2021-05-24;510;157;52298;28604;36.9;20.2
05;2021-05-25;515;483;52813;29087;37.3;20.5
05;2021-05-26;695;362;53508;29449;37.7;20.8
05;2021-05-27;799;572;54307;30021;38.3;21.2
05;2021-05-28;666;648;54973;30669;38.8;21.6
05;2021-05-29;566;544;55539;31213;39.2;22.0
05;2021-05-30;212;82;55751;31295;39.3;22.1
05;2021-05-31;576;495;56327;31790;39.7;22.4
05;2021-06-01;590;586;56917;32376;40.2;22.8
05;2021-06-02;684;703;57601;33079;40.6;23.3
05;2021-06-03;716;651;58317;33730;41.1;23.8
05;2021-06-04;1017;818;59334;34548;41.9;24.4
05;2021-06-05;807;508;60141;35056;42.4;24.7
05;2021-06-06;203;89;60344;35145;42.6;24.8
05;2021-06-07;605;833;60949;35978;43.0;25.4
05;2021-06-08;702;661;61651;36639;43.5;25.8
05;2021-06-09;648;783;62299;37422;43.9;26.4
05;2021-06-10;545;719;62844;38141;44.3;26.9
05;2021-06-11;765;723;63609;38864;44.9;27.4
05;2021-06-12;593;485;64202;39349;45.3;27.8
05;2021-06-13;113;91;64315;39440;45.4;27.8
05;2021-06-14;403;669;64718;40109;45.7;28.3
05;2021-06-15;542;912;65260;41021;46.0;28.9
05;2021-06-16;433;671;65693;41692;46.3;29.4
05;2021-06-17;360;805;66053;42497;46.6;30.0
05;2021-06-18;400;725;66453;43222;46.9;30.5
05;2021-06-19;421;570;66874;43792;47.2;30.9
05;2021-06-20;64;77;66938;43869;47.2;30.9
05;2021-06-21;319;641;67257;44510;47.4;31.4
05;2021-06-22;356;829;67613;45339;47.7;32.0
05;2021-06-23;354;763;67967;46102;47.9;32.5
05;2021-06-24;388;1022;68355;47124;48.2;33.2
05;2021-06-25;229;893;68584;48017;48.4;33.9
05;2021-06-26;292;1074;68876;49091;48.6;34.6
05;2021-06-27;128;170;69004;49261;48.7;34.8
05;2021-06-28;254;792;69258;50053;48.9;35.3
05;2021-06-29;250;785;69508;50838;49.0;35.9
05;2021-06-30;329;790;69837;51628;49.3;36.4
05;2021-07-01;385;793;70222;52421;49.5;37.0
05;2021-07-02;369;871;70591;53292;49.8;37.6
05;2021-07-03;305;741;70896;54033;50.0;38.1
05;2021-07-04;179;175;71075;54208;50.1;38.2
05;2021-07-05;264;780;71339;54988;50.3;38.8
05;2021-07-06;336;858;71675;55846;50.6;39.4
05;2021-07-07;400;781;72075;56627;50.8;39.9
05;2021-07-08;431;848;72506;57475;51.1;40.5
05;2021-07-09;422;994;72928;58469;51.4;41.2
05;2021-07-10;314;729;73242;59198;51.7;41.8
05;2021-07-11;176;120;73418;59318;51.8;41.8
05;2021-07-12;416;1013;73834;60331;52.1;42.6
05;2021-07-13;482;869;74316;61200;52.4;43.2
05;2021-07-14;837;300;75153;61500;53.0;43.4
05;2021-07-15;709;993;75862;62493;53.5;44.1
05;2021-07-16;1027;1456;76889;63949;54.2;45.1
05;2021-07-17;672;1306;77561;65255;54.7;46.0
05;2021-07-18;286;132;77847;65387;54.9;46.1
05;2021-07-19;572;792;78419;66179;55.3;46.7
05;2021-07-20;763;801;79182;66980;55.9;47.3
05;2021-07-21;883;842;80065;67822;56.5;47.8
05;2021-07-22;812;870;80877;68692;57.1;48.5
05;2021-07-23;1446;1239;82323;69931;58.1;49.3
05;2021-07-24;864;836;83187;70767;58.7;49.9
05;2021-07-25;305;160;83492;70927;58.9;50.0
05;2021-07-26;778;561;84270;71488;59.4;50.4
05;2021-07-27;1259;757;85529;72245;60.3;51.0
05;2021-07-28;1523;720;87052;72965;61.4;51.5
05;2021-07-29;1346;724;88398;73689;62.4;52.0
05;2021-07-30;959;595;89357;74284;63.0;52.4
05;2021-07-31;782;526;90139;74810;63.6;52.8
05;2021-08-01;192;178;90331;74988;63.7;52.9
05;2021-08-02;835;549;91166;75537;64.3;53.3
05;2021-08-03;828;610;91994;76147;64.9;53.7
05;2021-08-04;992;758;92986;76905;65.6;54.3
05;2021-08-05;981;727;93967;77632;66.3;54.8
05;2021-08-06;873;793;94840;78425;66.9;55.3
05;2021-08-07;631;642;95471;79067;67.3;55.8
05;2021-08-08;196;270;95667;79337;67.5;56.0
05;2021-08-09;775;847;96442;80184;68.0;56.6
05;2021-08-10;651;700;97093;80884;68.5;57.1
05;2021-08-11;743;857;97836;81741;69.0;57.7
05;2021-08-12;795;786;98631;82527;69.6;58.2
05;2021-08-13;626;893;99257;83420;70.0;58.8
05;2021-08-14;410;781;99667;84201;70.3;59.4
05;2021-08-15;188;224;99855;84425;70.4;59.6
05;2021-08-16;489;1086;100344;85511;70.8;60.3
05;2021-08-17;433;880;100777;86391;71.1;60.9
05;2021-08-18;438;974;101215;87365;71.4;61.6
05;2021-08-19;500;964;101715;88329;71.8;62.3
05;2021-08-20;478;1115;102193;89444;72.1;63.1
05;2021-08-21;359;851;102552;90295;72.3;63.7
05;2021-08-22;117;254;102669;90549;72.4;63.9
05;2021-08-23;321;828;102990;91377;72.7;64.5
05;2021-08-24;404;781;103394;92158;72.9;65.0
05;2021-08-25;408;926;103802;93084;73.2;65.7
05;2021-08-26;307;816;104109;93900;73.4;66.2
05;2021-08-27;334;921;104443;94821;73.7;66.9
05;2021-08-28;245;655;104688;95476;73.9;67.4
05;2021-08-29;66;255;104754;95731;73.9;67.5
05;2021-08-30;268;774;105022;96505;74.1;68.1
05;2021-08-31;253;686;105275;97191;74.3;68.6
05;2021-09-01;271;581;105546;97772;74.5;69.0
05;2021-09-02;255;603;105801;98375;74.6;69.4
05;2021-09-03;253;533;106054;98908;74.8;69.8
05;2021-09-04;203;607;106257;99515;75.0;70.2
05;2021-09-05;55;158;106312;99673;75.0;70.3
05;2021-09-06;163;328;106475;100001;75.1;70.5
05;2021-09-07;218;496;106693;100497;75.3;70.9
05;2021-09-08;178;521;106871;101018;75.4;71.3
05;2021-09-09;196;435;107067;101453;75.5;71.6
05;2021-09-10;183;329;107250;101782;75.7;71.8
05;2021-09-11;148;441;107398;102223;75.8;72.1
05;2021-09-12;26;106;107424;102329;75.8;72.2
05;2021-09-13;171;282;107595;102611;75.9;72.4
05;2021-09-14;224;269;107819;102880;76.1;72.6
05;2021-09-15;177;376;107996;103256;76.2;72.8
05;2021-09-16;174;254;108170;103510;76.3;73.0
05;2021-09-17;147;319;108317;103829;76.4;73.2
05;2021-09-18;120;359;108437;104188;76.5;73.5
05;2021-09-19;16;38;108453;104226;76.5;73.5
05;2021-09-20;59;166;108512;104392;76.5;73.6
05;2021-09-21;81;246;108593;104638;76.6;73.8
05;2021-09-22;108;290;108701;104928;76.7;74.0
05;2021-09-23;100;238;108801;105166;76.8;74.2
05;2021-09-24;85;281;108886;105447;76.8;74.4
05;2021-09-25;85;225;108971;105672;76.9;74.5
05;2021-09-26;17;31;108988;105703;76.9;74.6
05;2021-09-27;63;144;109051;105847;76.9;74.7
05;2021-09-28;68;160;109119;106007;77.0;74.8
05;2021-09-29;85;199;109204;106206;77.0;74.9
05;2021-09-30;59;102;109263;106308;77.1;75.0
05;2021-10-01;116;240;109379;106548;77.2;75.2
05;2021-10-02;93;194;109472;106742;77.2;75.3
05;2021-10-03;14;31;109486;106773;77.2;75.3
05;2021-10-04;64;160;109550;106933;77.3;75.4
05;2021-10-05;66;180;109616;107113;77.3;75.6
05;2021-10-06;84;164;109700;107277;77.4;75.7
05;2021-10-07;53;114;109753;107391;77.4;75.8
05;2021-10-08;87;144;109840;107535;77.5;75.9
05;2021-10-09;80;177;109920;107712;77.5;76.0
05;2021-10-10;14;22;109934;107734;77.6;76.0
05;2021-10-11;60;103;109994;107837;77.6;76.1
05;2021-10-12;47;107;110041;107944;77.6;76.1
05;2021-10-13;75;123;110116;108067;77.7;76.2
05;2021-10-14;65;100;110181;108167;77.7;76.3
05;2021-10-15;51;95;110232;108262;77.8;76.4
05;2021-10-16;82;163;110314;108425;77.8;76.5
05;2021-10-17;9;15;110323;108440;77.8;76.5
05;2021-10-18;42;98;110365;108538;77.9;76.6
05;2021-10-19;62;84;110427;108622;77.9;76.6
06;2020-12-27;16;4;16;4;0.0;0.0
06;2020-12-28;27;3;43;7;0.0;0.0
06;2020-12-29;12;3;55;10;0.0;0.0
06;2020-12-30;10;1;65;11;0.0;0.0
06;2020-12-31;30;1;95;12;0.0;0.0
06;2021-01-01;26;4;121;16;0.0;0.0
06;2021-01-02;9;0;130;16;0.0;0.0
06;2021-01-03;11;3;141;19;0.0;0.0
06;2021-01-04;160;3;301;22;0.0;0.0
06;2021-01-05;195;11;496;33;0.0;0.0
06;2021-01-06;256;10;752;43;0.1;0.0
06;2021-01-07;529;7;1281;50;0.1;0.0
06;2021-01-08;695;5;1976;55;0.2;0.0
06;2021-01-09;391;5;2367;60;0.2;0.0
06;2021-01-10;83;2;2450;62;0.2;0.0
06;2021-01-11;1168;7;3618;69;0.3;0.0
06;2021-01-12;2253;13;5871;82;0.5;0.0
06;2021-01-13;1758;15;7629;97;0.7;0.0
06;2021-01-14;2200;30;9829;127;0.9;0.0
06;2021-01-15;1894;7;11723;134;1.1;0.0
06;2021-01-16;995;7;12718;141;1.2;0.0
06;2021-01-17;249;0;12967;141;1.2;0.0
06;2021-01-18;2515;27;15482;168;1.4;0.0
06;2021-01-19;2786;26;18268;194;1.7;0.0
06;2021-01-20;3396;21;21664;215;2.0;0.0
06;2021-01-21;3069;35;24733;250;2.3;0.0
06;2021-01-22;3036;39;27769;289;2.6;0.0
06;2021-01-23;1311;5;29080;294;2.7;0.0
06;2021-01-24;34;0;29114;294;2.7;0.0
06;2021-01-25;2097;16;31211;310;2.9;0.0
06;2021-01-26;3421;55;34632;365;3.2;0.0
06;2021-01-27;2580;114;37212;479;3.4;0.0
06;2021-01-28;2832;219;40044;698;3.7;0.1
06;2021-01-29;2534;329;42578;1027;3.9;0.1
06;2021-01-30;674;47;43252;1074;4.0;0.1
06;2021-01-31;4;1;43256;1075;4.0;0.1
06;2021-02-01;1032;471;44288;1546;4.1;0.1
06;2021-02-02;1521;420;45809;1966;4.2;0.2
06;2021-02-03;344;139;46153;2105;4.3;0.2
06;2021-02-04;727;894;46880;2999;4.3;0.3
06;2021-02-05;1019;1107;47899;4106;4.4;0.4
06;2021-02-06;174;466;48073;4572;4.5;0.4
06;2021-02-07;14;49;48087;4621;4.5;0.4
06;2021-02-08;550;1087;48637;5708;4.5;0.5
06;2021-02-09;331;736;48968;6444;4.5;0.6
06;2021-02-10;390;666;49358;7110;4.6;0.7
06;2021-02-11;489;1064;49847;8174;4.6;0.8
06;2021-02-12;663;1312;50510;9486;4.7;0.9
06;2021-02-13;207;518;50717;10004;4.7;0.9
06;2021-02-14;22;6;50739;10010;4.7;0.9
06;2021-02-15;469;1261;51208;11271;4.7;1.0
06;2021-02-16;878;2004;52086;13275;4.8;1.2
06;2021-02-17;848;2120;52934;15395;4.9;1.4
06;2021-02-18;1833;2682;54767;18077;5.1;1.7
06;2021-02-19;1780;2151;56547;20228;5.2;1.9
06;2021-02-20;291;525;56838;20753;5.3;1.9
06;2021-02-21;25;56;56863;20809;5.3;1.9
06;2021-02-22;1093;1622;57956;22431;5.4;2.1
06;2021-02-23;1777;1555;59733;23986;5.5;2.2
06;2021-02-24;2130;1298;61863;25284;5.7;2.3
06;2021-02-25;3872;1692;65735;26976;6.1;2.5
06;2021-02-26;3419;1630;69154;28606;6.4;2.7
06;2021-02-27;1445;338;70599;28944;6.5;2.7
06;2021-02-28;104;25;70703;28969;6.6;2.7
06;2021-03-01;2446;840;73149;29809;6.8;2.8
06;2021-03-02;2480;999;75629;30808;7.0;2.9
06;2021-03-03;2884;588;78513;31396;7.3;2.9
06;2021-03-04;4648;633;83161;32029;7.7;3.0
06;2021-03-05;3933;1052;87094;33081;8.1;3.1
06;2021-03-06;11991;403;99085;33484;9.2;3.1
06;2021-03-07;10226;354;109311;33838;10.1;3.1
06;2021-03-08;4194;1220;113505;35058;10.5;3.2
06;2021-03-09;5024;982;118529;36040;11.0;3.3
06;2021-03-10;4745;894;123274;36934;11.4;3.4
06;2021-03-11;6749;942;130023;37876;12.0;3.5
06;2021-03-12;6899;1044;136922;38920;12.7;3.6
06;2021-03-13;11291;403;148213;39323;13.7;3.6
06;2021-03-14;520;56;148733;39379;13.8;3.6
06;2021-03-15;4861;787;153594;40166;14.2;3.7
06;2021-03-16;3786;1072;157380;41238;14.6;3.8
06;2021-03-17;6221;1917;163601;43155;15.2;4.0
06;2021-03-18;5147;1862;168748;45017;15.6;4.2
06;2021-03-19;6848;2063;175596;47080;16.3;4.4
06;2021-03-20;2381;560;177977;47640;16.5;4.4
06;2021-03-21;417;27;178394;47667;16.5;4.4
06;2021-03-22;4001;720;182395;48387;16.9;4.5
06;2021-03-23;6004;1237;188399;49624;17.5;4.6
06;2021-03-24;4236;3347;192635;52971;17.8;4.9
06;2021-03-25;5893;3274;198528;56245;18.4;5.2
06;2021-03-26;6377;2019;204905;58264;19.0;5.4
06;2021-03-27;2044;373;206949;58637;19.2;5.4
06;2021-03-28;219;8;207168;58645;19.2;5.4
06;2021-03-29;3213;2109;210381;60754;19.5;5.6
06;2021-03-30;5201;2547;215582;63301;20.0;5.9
06;2021-03-31;8065;1704;223647;65005;20.7;6.0
06;2021-04-01;7679;2522;231326;67527;21.4;6.3
06;2021-04-02;7262;2744;238588;70271;22.1;6.5
06;2021-04-03;2723;1378;241311;71649;22.4;6.6
06;2021-04-04;305;550;241616;72199;22.4;6.7
06;2021-04-05;1417;702;243033;72901;22.5;6.8
06;2021-04-06;6690;3341;249723;76242;23.1;7.1
06;2021-04-07;6238;3923;255961;80165;23.7;7.4
06;2021-04-08;5757;5692;261718;85857;24.2;8.0
06;2021-04-09;9402;5907;271120;91764;25.1;8.5
06;2021-04-10;2396;2789;273516;94553;25.3;8.8
06;2021-04-11;190;60;273706;94613;25.4;8.8
06;2021-04-12;4391;3550;278097;98163;25.8;9.1
06;2021-04-13;6395;5155;284492;103318;26.4;9.6
06;2021-04-14;5481;4520;289973;107838;26.9;10.0
06;2021-04-15;5561;4413;295534;112251;27.4;10.4
06;2021-04-16;7098;5221;302632;117472;28.0;10.9
06;2021-04-17;2790;3063;305422;120535;28.3;11.2
06;2021-04-18;272;228;305694;120763;28.3;11.2
06;2021-04-19;5510;4062;311204;124825;28.8;11.6
06;2021-04-20;5674;4894;316878;129719;29.4;12.0
06;2021-04-21;8339;4213;325217;133932;30.1;12.4
06;2021-04-22;8585;4231;333802;138163;30.9;12.8
06;2021-04-23;8859;4321;342661;142484;31.7;13.2
06;2021-04-24;2358;1500;345019;143984;32.0;13.3
06;2021-04-25;122;29;345141;144013;32.0;13.3
06;2021-04-26;4163;2328;349304;146341;32.4;13.6
06;2021-04-27;4598;4064;353902;150405;32.8;13.9
06;2021-04-28;4166;4591;358068;154996;33.2;14.4
06;2021-04-29;6100;5481;364168;160477;33.7;14.9
06;2021-04-30;6793;5205;370961;165682;34.4;15.3
06;2021-05-01;4168;846;375129;166528;34.8;15.4
06;2021-05-02;495;161;375624;166689;34.8;15.4
06;2021-05-03;6932;3581;382556;170270;35.4;15.8
06;2021-05-04;5758;5421;388314;175691;36.0;16.3
06;2021-05-05;4553;3925;392867;179616;36.4;16.6
06;2021-05-06;5236;4759;398103;184375;36.9;17.1
06;2021-05-07;5664;5687;403767;190062;37.4;17.6
06;2021-05-08;4879;1339;408646;191401;37.9;17.7
06;2021-05-09;206;308;408852;191709;37.9;17.8
06;2021-05-10;4839;5057;413691;196766;38.3;18.2
06;2021-05-11;4950;5571;418641;202337;38.8;18.7
06;2021-05-12;9113;4910;427754;207247;39.6;19.2
06;2021-05-13;9285;2151;437039;209398;40.5;19.4
06;2021-05-14;10865;3373;447904;212771;41.5;19.7
06;2021-05-15;9314;2248;457218;215019;42.4;19.9
06;2021-05-16;1506;288;458724;215307;42.5;19.9
06;2021-05-17;7531;3767;466255;219074;43.2;20.3
06;2021-05-18;9754;3235;476009;222309;44.1;20.6
06;2021-05-19;7721;2990;483730;225299;44.8;20.9
06;2021-05-20;7989;3685;491719;228984;45.6;21.2
06;2021-05-21;8836;3956;500555;232940;46.4;21.6
06;2021-05-22;3033;1326;503588;234266;46.7;21.7
06;2021-05-23;134;631;503722;234897;46.7;21.8
06;2021-05-24;3209;1002;506931;235899;47.0;21.9
06;2021-05-25;4766;4934;511697;240833;47.4;22.3
06;2021-05-26;5696;6634;517393;247467;47.9;22.9
06;2021-05-27;5593;6287;522986;253754;48.5;23.5
06;2021-05-28;4989;7299;527975;261053;48.9;24.2
06;2021-05-29;1638;2925;529613;263978;49.1;24.5
06;2021-05-30;258;1121;529871;265099;49.1;24.6
06;2021-05-31;4422;5133;534293;270232;49.5;25.0
06;2021-06-01;5760;7438;540053;277670;50.0;25.7
06;2021-06-02;3330;8556;543383;286226;50.3;26.5
06;2021-06-03;4556;8309;547939;294535;50.8;27.3
06;2021-06-04;5494;7733;553433;302268;51.3;28.0
06;2021-06-05;2468;3347;555901;305615;51.5;28.3
06;2021-06-06;186;237;556087;305852;51.5;28.3
06;2021-06-07;4151;5588;560238;311440;51.9;28.9
06;2021-06-08;4490;5229;564728;316669;52.3;29.3
06;2021-06-09;4128;7367;568856;324036;52.7;30.0
06;2021-06-10;4799;6873;573655;330909;53.1;30.7
06;2021-06-11;3932;8364;577587;339273;53.5;31.4
06;2021-06-12;1749;3752;579336;343025;53.7;31.8
06;2021-06-13;151;439;579487;343464;53.7;31.8
06;2021-06-14;2747;8608;582234;352072;53.9;32.6
06;2021-06-15;3300;9495;585534;361567;54.2;33.5
06;2021-06-16;3518;7024;589052;368591;54.6;34.1
06;2021-06-17;3689;7196;592741;375787;54.9;34.8
06;2021-06-18;2646;5932;595387;381719;55.2;35.4
06;2021-06-19;1322;1689;596709;383408;55.3;35.5
06;2021-06-20;211;349;596920;383757;55.3;35.6
06;2021-06-21;1738;6296;598658;390053;55.5;36.1
06;2021-06-22;2377;7364;601035;397417;55.7;36.8
06;2021-06-23;2101;6546;603136;403963;55.9;37.4
06;2021-06-24;3501;8976;606637;412939;56.2;38.3
06;2021-06-25;2310;9607;608947;422546;56.4;39.1
06;2021-06-26;893;2288;609840;424834;56.5;39.4
06;2021-06-27;379;1192;610219;426026;56.5;39.5
06;2021-06-28;2503;8123;612722;434149;56.8;40.2
06;2021-06-29;2396;7733;615118;441882;57.0;40.9
06;2021-06-30;1522;7693;616640;449575;57.1;41.7
06;2021-07-01;3579;7485;620219;457060;57.5;42.3
06;2021-07-02;4479;8284;624698;465344;57.9;43.1
06;2021-07-03;1241;4307;625939;469651;58.0;43.5
06;2021-07-04;318;303;626257;469954;58.0;43.5
06;2021-07-05;4082;5145;630339;475099;58.4;44.0
06;2021-07-06;2155;5817;632494;480916;58.6;44.6
06;2021-07-07;4193;5985;636687;486901;59.0;45.1
06;2021-07-08;3732;6336;640419;493237;59.3;45.7
06;2021-07-09;4869;6242;645288;499479;59.8;46.3
06;2021-07-10;1779;2332;647067;501811;59.9;46.5
06;2021-07-11;333;323;647400;502134;60.0;46.5
06;2021-07-12;4214;7154;651614;509288;60.4;47.2
06;2021-07-13;6133;9028;657747;518316;60.9;48.0
06;2021-07-14;1255;442;659002;518758;61.1;48.1
06;2021-07-15;6856;8042;665858;526800;61.7;48.8
06;2021-07-16;8540;9042;674398;535842;62.5;49.6
06;2021-07-17;3167;5478;677565;541320;62.8;50.2
06;2021-07-18;1079;5334;678644;546654;62.9;50.6
06;2021-07-19;6171;8038;684815;554692;63.4;51.4
06;2021-07-20;7607;10266;692422;564958;64.1;52.3
06;2021-07-21;8483;8720;700905;573678;64.9;53.1
06;2021-07-22;10458;7890;711363;581568;65.9;53.9
06;2021-07-23;9577;6935;720940;588503;66.8;54.5
06;2021-07-24;3306;3107;724246;591610;67.1;54.8
06;2021-07-25;1005;482;725251;592092;67.2;54.9
06;2021-07-26;7666;6894;732917;598986;67.9;55.5
06;2021-07-27;9281;5603;742198;604589;68.8;56.0
06;2021-07-28;7497;5417;749695;610006;69.5;56.5
06;2021-07-29;8896;5791;758591;615797;70.3;57.1
06;2021-07-30;8563;5569;767154;621366;71.1;57.6
06;2021-07-31;3831;3084;770985;624450;71.4;57.9
06;2021-08-01;902;438;771887;624888;71.5;57.9
06;2021-08-02;7157;4636;779044;629524;72.2;58.3
06;2021-08-03;6872;5511;785916;635035;72.8;58.8
06;2021-08-04;5844;3528;791760;638563;73.4;59.2
06;2021-08-05;6791;4479;798551;643042;74.0;59.6
06;2021-08-06;6127;6125;804678;649167;74.5;60.1
06;2021-08-07;2327;2473;807005;651640;74.8;60.4
06;2021-08-08;617;635;807622;652275;74.8;60.4
06;2021-08-09;4886;6042;812508;658317;75.3;61.0
06;2021-08-10;5523;6917;818031;665234;75.8;61.6
06;2021-08-11;4465;6221;822496;671455;76.2;62.2
06;2021-08-12;4753;6744;827249;678199;76.6;62.8
06;2021-08-13;3889;6454;831138;684653;77.0;63.4
06;2021-08-14;1600;2275;832738;686928;77.1;63.6
06;2021-08-15;421;639;833159;687567;77.2;63.7
06;2021-08-16;3303;6911;836462;694478;77.5;64.3
06;2021-08-17;3854;7780;840316;702258;77.9;65.1
06;2021-08-18;3008;6415;843324;708673;78.1;65.7
06;2021-08-19;4030;8131;847354;716804;78.5;66.4
06;2021-08-20;3334;6540;850688;723344;78.8;67.0
06;2021-08-21;1847;3595;852535;726939;79.0;67.3
06;2021-08-22;390;713;852925;727652;79.0;67.4
06;2021-08-23;2607;6531;855532;734183;79.3;68.0
06;2021-08-24;2914;6476;858446;740659;79.5;68.6
06;2021-08-25;2659;5686;861105;746345;79.8;69.1
06;2021-08-26;2743;6892;863848;753237;80.0;69.8
06;2021-08-27;2674;7080;866522;760317;80.3;70.4
06;2021-08-28;1301;3336;867823;763653;80.4;70.7
06;2021-08-29;300;827;868123;764480;80.4;70.8
06;2021-08-30;2479;6181;870602;770661;80.7;71.4
06;2021-08-31;2783;6856;873385;777517;80.9;72.0
06;2021-09-01;3193;5292;876578;782809;81.2;72.5
06;2021-09-02;2513;5493;879091;788302;81.4;73.0
06;2021-09-03;2226;5963;881317;794265;81.6;73.6
06;2021-09-04;1391;3498;882708;797763;81.8;73.9
06;2021-09-05;289;500;882997;798263;81.8;74.0
06;2021-09-06;1724;3926;884721;802189;82.0;74.3
06;2021-09-07;1693;4136;886414;806325;82.1;74.7
06;2021-09-08;1710;3223;888124;809548;82.3;75.0
06;2021-09-09;1473;3351;889597;812899;82.4;75.3
06;2021-09-10;1987;3505;891584;816404;82.6;75.6
06;2021-09-11;1091;2278;892675;818682;82.7;75.8
06;2021-09-12;148;325;892823;819007;82.7;75.9
06;2021-09-13;1341;2650;894164;821657;82.8;76.1
06;2021-09-14;1553;2283;895717;823940;83.0;76.3
06;2021-09-15;1531;2766;897248;826706;83.1;76.6
06;2021-09-16;1392;2431;898640;829137;83.3;76.8
06;2021-09-17;1540;2890;900180;832027;83.4;77.1
06;2021-09-18;703;1964;900883;833991;83.5;77.3
06;2021-09-19;111;289;900994;834280;83.5;77.3
06;2021-09-20;754;2138;901748;836418;83.5;77.5
06;2021-09-21;1018;2482;902766;838900;83.6;77.7
06;2021-09-22;1079;2518;903845;841418;83.7;78.0
06;2021-09-23;847;2201;904692;843619;83.8;78.2
06;2021-09-24;957;2354;905649;845973;83.9;78.4
06;2021-09-25;493;1781;906142;847754;83.9;78.5
06;2021-09-26;104;225;906246;847979;84.0;78.6
06;2021-09-27;683;1622;906929;849601;84.0;78.7
06;2021-09-28;584;1608;907513;851209;84.1;78.9
06;2021-09-29;821;1792;908334;853001;84.2;79.0
06;2021-09-30;764;1712;909098;854713;84.2;79.2
06;2021-10-01;953;2091;910051;856804;84.3;79.4
06;2021-10-02;500;1349;910551;858153;84.4;79.5
06;2021-10-03;105;171;910656;858324;84.4;79.5
06;2021-10-04;437;1191;911093;859515;84.4;79.6
06;2021-10-05;621;1644;911714;861159;84.5;79.8
06;2021-10-06;770;1746;912484;862905;84.5;79.9
06;2021-10-07;654;1574;913138;864479;84.6;80.1
06;2021-10-08;880;1742;914018;866221;84.7;80.3
06;2021-10-09;527;1152;914545;867373;84.7;80.4
06;2021-10-10;139;213;914684;867586;84.7;80.4
06;2021-10-11;582;1264;915266;868850;84.8;80.5
06;2021-10-12;567;1156;915833;870006;84.8;80.6
06;2021-10-13;750;1403;916583;871409;84.9;80.7
06;2021-10-14;626;1168;917209;872577;85.0;80.8
06;2021-10-15;804;1398;918013;873975;85.0;81.0
06;2021-10-16;539;803;918552;874778;85.1;81.0
06;2021-10-17;55;187;918607;874965;85.1;81.1
06;2021-10-18;549;1108;919156;876073;85.2;81.2
06;2021-10-19;517;896;919673;876969;85.2;81.2
07;2020-12-27;0;0;0;0;0.0;0.0
07;2020-12-28;0;0;0;0;0.0;0.0
07;2020-12-29;0;0;0;0;0.0;0.0
07;2020-12-30;0;0;0;0;0.0;0.0
07;2020-12-31;0;0;0;0;0.0;0.0
07;2021-01-01;7;0;7;0;0.0;0.0
07;2021-01-02;0;0;7;0;0.0;0.0
07;2021-01-03;0;0;7;0;0.0;0.0
07;2021-01-04;0;0;7;0;0.0;0.0
07;2021-01-05;0;0;7;0;0.0;0.0
07;2021-01-06;31;0;38;0;0.0;0.0
07;2021-01-07;130;1;168;1;0.1;0.0
07;2021-01-08;45;1;213;2;0.1;0.0
07;2021-01-09;17;0;230;2;0.1;0.0
07;2021-01-10;0;0;230;2;0.1;0.0
07;2021-01-11;157;1;387;3;0.1;0.0
07;2021-01-12;310;1;697;4;0.2;0.0
07;2021-01-13;308;4;1005;8;0.3;0.0
07;2021-01-14;475;0;1480;8;0.5;0.0
07;2021-01-15;188;0;1668;8;0.5;0.0
07;2021-01-16;17;0;1685;8;0.5;0.0
07;2021-01-17;2;0;1687;8;0.5;0.0
07;2021-01-18;364;5;2051;13;0.6;0.0
07;2021-01-19;830;3;2881;16;0.9;0.0
07;2021-01-20;605;8;3486;24;1.1;0.0
07;2021-01-21;454;3;3940;27;1.2;0.0
07;2021-01-22;292;0;4232;27;1.3;0.0
07;2021-01-23;107;0;4339;27;1.3;0.0
07;2021-01-24;0;0;4339;27;1.3;0.0
07;2021-01-25;164;0;4503;27;1.4;0.0
07;2021-01-26;491;4;4994;31;1.5;0.0
07;2021-01-27;558;14;5552;45;1.7;0.0
07;2021-01-28;1207;104;6759;149;2.1;0.0
07;2021-01-29;714;19;7473;168;2.3;0.1
07;2021-01-30;212;4;7685;172;2.4;0.1
07;2021-01-31;7;0;7692;172;2.4;0.1
07;2021-02-01;267;33;7959;205;2.4;0.1
07;2021-02-02;664;240;8623;445;2.6;0.1
07;2021-02-03;1046;235;9669;680;3.0;0.2
07;2021-02-04;723;270;10392;950;3.2;0.3
07;2021-02-05;484;255;10876;1205;3.3;0.4
07;2021-02-06;98;2;10974;1207;3.4;0.4
07;2021-02-07;12;1;10986;1208;3.4;0.4
07;2021-02-08;239;175;11225;1383;3.4;0.4
07;2021-02-09;490;331;11715;1714;3.6;0.5
07;2021-02-10;539;397;12254;2111;3.7;0.6
07;2021-02-11;400;282;12654;2393;3.9;0.7
07;2021-02-12;266;162;12920;2555;4.0;0.8
07;2021-02-13;69;20;12989;2575;4.0;0.8
07;2021-02-14;1;0;12990;2575;4.0;0.8
07;2021-02-15;270;130;13260;2705;4.1;0.8
07;2021-02-16;352;364;13612;3069;4.2;0.9
07;2021-02-17;466;330;14078;3399;4.3;1.0
07;2021-02-18;564;767;14642;4166;4.5;1.3
07;2021-02-19;461;508;15103;4674;4.6;1.4
07;2021-02-20;109;69;15212;4743;4.7;1.5
07;2021-02-21;15;0;15227;4743;4.7;1.5
07;2021-02-22;425;217;15652;4960;4.8;1.5
07;2021-02-23;648;622;16300;5582;5.0;1.7
07;2021-02-24;927;710;17227;6292;5.3;1.9
07;2021-02-25;709;539;17936;6831;5.5;2.1
07;2021-02-26;844;295;18780;7126;5.7;2.2
07;2021-02-27;190;145;18970;7271;5.8;2.2
07;2021-02-28;1;0;18971;7271;5.8;2.2
07;2021-03-01;438;215;19409;7486;5.9;2.3
07;2021-03-02;658;566;20067;8052;6.1;2.5
07;2021-03-03;696;537;20763;8589;6.4;2.6
07;2021-03-04;1101;360;21864;8949;6.7;2.7
07;2021-03-05;1083;378;22947;9327;7.0;2.9
07;2021-03-06;1127;99;24074;9426;7.4;2.9
07;2021-03-07;717;21;24791;9447;7.6;2.9
07;2021-03-08;353;320;25144;9767;7.7;3.0
07;2021-03-09;1091;439;26235;10206;8.0;3.1
07;2021-03-10;867;524;27102;10730;8.3;3.3
07;2021-03-11;1373;473;28475;11203;8.7;3.4
07;2021-03-12;1618;573;30093;11776;9.2;3.6
07;2021-03-13;683;106;30776;11882;9.4;3.6
07;2021-03-14;4;0;30780;11882;9.4;3.6
07;2021-03-15;525;292;31305;12174;9.6;3.7
07;2021-03-16;1210;487;32515;12661;9.9;3.9
07;2021-03-17;1189;773;33704;13434;10.3;4.1
07;2021-03-18;1219;418;34923;13852;10.7;4.2
07;2021-03-19;1269;426;36192;14278;11.1;4.4
07;2021-03-20;467;109;36659;14387;11.2;4.4
07;2021-03-21;3;2;36662;14389;11.2;4.4
07;2021-03-22;791;537;37453;14926;11.5;4.6
07;2021-03-23;1519;727;38972;15653;11.9;4.8
07;2021-03-24;1280;673;40252;16326;12.3;5.0
07;2021-03-25;1852;521;42104;16847;12.9;5.2
07;2021-03-26;1834;446;43938;17293;13.4;5.3
07;2021-03-27;384;101;44322;17394;13.6;5.3
07;2021-03-28;6;1;44328;17395;13.6;5.3
07;2021-03-29;789;361;45117;17756;13.8;5.4
07;2021-03-30;1526;516;46643;18272;14.3;5.6
07;2021-03-31;1662;508;48305;18780;14.8;5.7
07;2021-04-01;1590;667;49895;19447;15.3;5.9
07;2021-04-02;1522;442;51417;19889;15.7;6.1
07;2021-04-03;230;106;51647;19995;15.8;6.1
07;2021-04-04;3;1;51650;19996;15.8;6.1
07;2021-04-05;0;66;51650;20062;15.8;6.1
07;2021-04-06;1156;761;52806;20823;16.2;6.4
07;2021-04-07;1316;906;54122;21729;16.6;6.6
07;2021-04-08;1969;1182;56091;22911;17.2;7.0
07;2021-04-09;2423;576;58514;23487;17.9;7.2
07;2021-04-10;807;164;59321;23651;18.1;7.2
07;2021-04-11;340;13;59661;23664;18.3;7.2
07;2021-04-12;1288;604;60949;24268;18.6;7.4
07;2021-04-13;1766;1340;62715;25608;19.2;7.8
07;2021-04-14;1688;1020;64403;26628;19.7;8.1
07;2021-04-15;1443;848;65846;27476;20.1;8.4
07;2021-04-16;1506;918;67352;28394;20.6;8.7
07;2021-04-17;870;217;68222;28611;20.9;8.8
07;2021-04-18;699;39;68921;28650;21.1;8.8
07;2021-04-19;1162;574;70083;29224;21.4;8.9
07;2021-04-20;1440;1321;71523;30545;21.9;9.3
07;2021-04-21;1719;919;73242;31464;22.4;9.6
07;2021-04-22;1816;971;75058;32435;23.0;9.9
07;2021-04-23;1410;971;76468;33406;23.4;10.2
07;2021-04-24;962;254;77430;33660;23.7;10.3
07;2021-04-25;717;69;78147;33729;23.9;10.3
07;2021-04-26;1137;680;79284;34409;24.3;10.5
07;2021-04-27;1394;1567;80678;35976;24.7;11.0
07;2021-04-28;1635;1760;82313;37736;25.2;11.5
07;2021-04-29;1938;1536;84251;39272;25.8;12.0
07;2021-04-30;1661;1487;85912;40759;26.3;12.5
07;2021-05-01;960;122;86872;40881;26.6;12.5
07;2021-05-02;844;155;87716;41036;26.8;12.6
07;2021-05-03;1279;435;88995;41471;27.2;12.7
07;2021-05-04;2170;1568;91165;43039;27.9;13.2
07;2021-05-05;1744;1388;92909;44427;28.4;13.6
07;2021-05-06;2101;1588;95010;46015;29.1;14.1
07;2021-05-07;1597;1557;96607;47572;29.6;14.6
07;2021-05-08;1230;406;97837;47978;29.9;14.7
07;2021-05-09;1030;327;98867;48305;30.2;14.8
07;2021-05-10;1406;1177;100273;49482;30.7;15.1
07;2021-05-11;2470;1698;102743;51180;31.4;15.7
07;2021-05-12;2165;1279;104908;52459;32.1;16.0
07;2021-05-13;1712;273;106620;52732;32.6;16.1
07;2021-05-14;1734;999;108354;53731;33.1;16.4
07;2021-05-15;1626;500;109980;54231;33.6;16.6
07;2021-05-16;1442;214;111422;54445;34.1;16.7
07;2021-05-17;1771;859;113193;55304;34.6;16.9
07;2021-05-18;2295;1303;115488;56607;35.3;17.3
07;2021-05-19;2375;1000;117863;57607;36.1;17.6
07;2021-05-20;2165;1308;120028;58915;36.7;18.0
07;2021-05-21;1758;1312;121786;60227;37.3;18.4
07;2021-05-22;935;543;122721;60770;37.5;18.6
07;2021-05-23;856;157;123577;60927;37.8;18.6
07;2021-05-24;1648;340;125225;61267;38.3;18.7
07;2021-05-25;2184;1481;127409;62748;39.0;19.2
07;2021-05-26;1525;1379;128934;64127;39.4;19.6
07;2021-05-27;2014;1412;130948;65539;40.1;20.1
07;2021-05-28;1772;2079;132720;67618;40.6;20.7
07;2021-05-29;942;683;133662;68301;40.9;20.9
07;2021-05-30;622;570;134284;68871;41.1;21.1
07;2021-05-31;1133;1284;135417;70155;41.4;21.5
07;2021-06-01;2152;2001;137569;72156;42.1;22.1
07;2021-06-02;1531;1653;139100;73809;42.6;22.6
07;2021-06-03;1712;1254;140812;75063;43.1;23.0
07;2021-06-04;1676;1594;142488;76657;43.6;23.5
07;2021-06-05;986;955;143474;77612;43.9;23.7
07;2021-06-06;598;624;144072;78236;44.1;23.9
07;2021-06-07;961;1193;145033;79429;44.4;24.3
07;2021-06-08;1547;1772;146580;81201;44.8;24.8
07;2021-06-09;1030;1421;147610;82622;45.2;25.3
07;2021-06-10;789;1388;148399;84010;45.4;25.7
07;2021-06-11;1153;2032;149552;86042;45.8;26.3
07;2021-06-12;643;1217;150195;87259;45.9;26.7
07;2021-06-13;395;444;150590;87703;46.1;26.8
07;2021-06-14;566;1957;151156;89660;46.2;27.4
07;2021-06-15;936;2552;152092;92212;46.5;28.2
07;2021-06-16;1023;1854;153115;94066;46.8;28.8
07;2021-06-17;885;1949;154000;96015;47.1;29.4
07;2021-06-18;868;2282;154868;98297;47.4;30.1
07;2021-06-19;603;1452;155471;99749;47.6;30.5
07;2021-06-20;369;729;155840;100478;47.7;30.7
07;2021-06-21;516;2143;156356;102621;47.8;31.4
07;2021-06-22;655;2662;157011;105283;48.0;32.2
07;2021-06-23;680;1960;157691;107243;48.2;32.8
07;2021-06-24;646;1852;158337;109095;48.4;33.4
07;2021-06-25;701;2177;159038;111272;48.7;34.0
07;2021-06-26;363;1430;159401;112702;48.8;34.5
07;2021-06-27;285;1073;159686;113775;48.9;34.8
07;2021-06-28;506;2241;160192;116016;49.0;35.5
07;2021-06-29;540;2988;160732;119004;49.2;36.4
07;2021-06-30;822;2278;161554;121282;49.4;37.1
07;2021-07-01;776;1951;162330;123233;49.7;37.7
07;2021-07-02;880;2298;163210;125531;49.9;38.4
07;2021-07-03;421;1137;163631;126668;50.1;38.8
07;2021-07-04;211;852;163842;127520;50.1;39.0
07;2021-07-05;670;1685;164512;129205;50.3;39.5
07;2021-07-06;880;2630;165392;131835;50.6;40.3
07;2021-07-07;970;1951;166362;133786;50.9;40.9
07;2021-07-08;928;1959;167290;135745;51.2;41.5
07;2021-07-09;995;2262;168285;138007;51.5;42.2
07;2021-07-10;598;1100;168883;139107;51.7;42.6
07;2021-07-11;239;614;169122;139721;51.7;42.7
07;2021-07-12;807;1769;169929;141490;52.0;43.3
07;2021-07-13;1770;3173;171699;144663;52.5;44.3
07;2021-07-14;167;133;171866;144796;52.6;44.3
07;2021-07-15;1962;2468;173828;147264;53.2;45.1
07;2021-07-16;2057;1988;175885;149252;53.8;45.7
07;2021-07-17;1486;1250;177371;150502;54.3;46.0
07;2021-07-18;771;480;178142;150982;54.5;46.2
07;2021-07-19;1516;1690;179658;152672;55.0;46.7
07;2021-07-20;2518;2678;182176;155350;55.7;47.5
07;2021-07-21;1856;1917;184032;157267;56.3;48.1
07;2021-07-22;1918;1374;185950;158641;56.9;48.5
07;2021-07-23;2265;1689;188215;160330;57.6;49.0
07;2021-07-24;1642;1112;189857;161442;58.1;49.4
07;2021-07-25;34;22;189891;161464;58.1;49.4
07;2021-07-26;2199;1546;192090;163010;58.8;49.9
07;2021-07-27;3017;1916;195107;164926;59.7;50.5
07;2021-07-28;1643;1309;196750;166235;60.2;50.9
07;2021-07-29;2540;1275;199290;167510;61.0;51.2
07;2021-07-30;1356;1415;200646;168925;61.4;51.7
07;2021-07-31;1506;922;202152;169847;61.8;52.0
07;2021-08-01;74;26;202226;169873;61.9;52.0
07;2021-08-02;1516;1133;203742;171006;62.3;52.3
07;2021-08-03;2418;1911;206160;172917;63.1;52.9
07;2021-08-04;1947;1033;208107;173950;63.7;53.2
07;2021-08-05;1893;1296;210000;175246;64.2;53.6
07;2021-08-06;2033;1712;212033;176958;64.9;54.1
07;2021-08-07;998;556;213031;177514;65.2;54.3
07;2021-08-08;12;23;213043;177537;65.2;54.3
07;2021-08-09;1258;1382;214301;178919;65.6;54.7
07;2021-08-10;1599;2261;215900;181180;66.0;55.4
07;2021-08-11;1399;1600;217299;182780;66.5;55.9
07;2021-08-12;1105;1486;218404;184266;66.8;56.4
07;2021-08-13;1182;1790;219586;186056;67.2;56.9
07;2021-08-14;512;766;220098;186822;67.3;57.2
07;2021-08-15;9;28;220107;186850;67.3;57.2
07;2021-08-16;754;1329;220861;188179;67.6;57.6
07;2021-08-17;1339;2278;222200;190457;68.0;58.3
07;2021-08-18;880;1518;223080;191975;68.2;58.7
07;2021-08-19;1149;1697;224229;193672;68.6;59.2
07;2021-08-20;899;2086;225128;195758;68.9;59.9
07;2021-08-21;364;549;225492;196307;69.0;60.1
07;2021-08-22;7;23;225499;196330;69.0;60.1
07;2021-08-23;467;1307;225966;197637;69.1;60.5
07;2021-08-24;1125;2312;227091;199949;69.5;61.2
07;2021-08-25;692;1838;227783;201787;69.7;61.7
07;2021-08-26;690;2021;228473;203808;69.9;62.4
07;2021-08-27;784;1830;229257;205638;70.1;62.9
07;2021-08-28;338;608;229595;206246;70.2;63.1
07;2021-08-29;1;33;229596;206279;70.2;63.1
07;2021-08-30;430;1303;230026;207582;70.4;63.5
07;2021-08-31;1095;2203;231121;209785;70.7;64.2
07;2021-09-01;544;1346;231665;211131;70.9;64.6
07;2021-09-02;606;1384;232271;212515;71.1;65.0
07;2021-09-03;742;1775;233013;214290;71.3;65.6
07;2021-09-04;308;696;233321;214986;71.4;65.8
07;2021-09-05;26;28;233347;215014;71.4;65.8
07;2021-09-06;402;906;233749;215920;71.5;66.1
07;2021-09-07;523;1297;234272;217217;71.7;66.5
07;2021-09-08;446;1041;234718;218258;71.8;66.8
07;2021-09-09;479;858;235197;219116;72.0;67.0
07;2021-09-10;519;1245;235716;220361;72.1;67.4
07;2021-09-11;168;627;235884;220988;72.2;67.6
07;2021-09-12;0;7;235884;220995;72.2;67.6
07;2021-09-13;352;524;236236;221519;72.3;67.8
07;2021-09-14;537;887;236773;222406;72.4;68.0
07;2021-09-15;305;744;237078;223150;72.5;68.3
07;2021-09-16;430;568;237508;223718;72.7;68.4
07;2021-09-17;318;802;237826;224520;72.8;68.7
07;2021-09-18;100;455;237926;224975;72.8;68.8
07;2021-09-19;3;32;237929;225007;72.8;68.8
07;2021-09-20;239;365;238168;225372;72.9;68.9
07;2021-09-21;287;696;238455;226068;72.9;69.2
07;2021-09-22;172;727;238627;226795;73.0;69.4
07;2021-09-23;190;533;238817;227328;73.1;69.5
07;2021-09-24;279;838;239096;228166;73.1;69.8
07;2021-09-25;52;208;239148;228374;73.2;69.9
07;2021-09-26;6;17;239154;228391;73.2;69.9
07;2021-09-27;146;459;239300;228850;73.2;70.0
07;2021-09-28;178;522;239478;229372;73.3;70.2
07;2021-09-29;127;513;239605;229885;73.3;70.3
07;2021-09-30;174;451;239779;230336;73.4;70.5
07;2021-10-01;220;594;239999;230930;73.4;70.6
07;2021-10-02;76;137;240075;231067;73.4;70.7
07;2021-10-03;10;15;240085;231082;73.4;70.7
07;2021-10-04;161;366;240246;231448;73.5;70.8
07;2021-10-05;207;446;240453;231894;73.6;70.9
07;2021-10-06;161;332;240614;232226;73.6;71.0
07;2021-10-07;140;438;240754;232664;73.7;71.2
07;2021-10-08;207;430;240961;233094;73.7;71.3
07;2021-10-09;65;95;241026;233189;73.7;71.3
07;2021-10-10;0;1;241026;233190;73.7;71.3
07;2021-10-11;101;269;241127;233459;73.8;71.4
07;2021-10-12;190;406;241317;233865;73.8;71.5
07;2021-10-13;131;234;241448;234099;73.9;71.6
07;2021-10-14;144;237;241592;234336;73.9;71.7
07;2021-10-15;215;348;241807;234684;74.0;71.8
07;2021-10-16;86;79;241893;234763;74.0;71.8
07;2021-10-17;2;0;241895;234763;74.0;71.8
07;2021-10-18;162;208;242057;234971;74.1;71.9
07;2021-10-19;168;170;242225;235141;74.1;71.9
08;2020-12-27;1;0;1;0;0.0;0.0
08;2020-12-28;0;0;1;0;0.0;0.0
08;2020-12-29;0;0;1;0;0.0;0.0
08;2020-12-30;0;0;1;0;0.0;0.0
08;2020-12-31;0;0;1;0;0.0;0.0
08;2021-01-01;0;0;1;0;0.0;0.0
08;2021-01-02;0;0;1;0;0.0;0.0
08;2021-01-03;2;0;3;0;0.0;0.0
08;2021-01-04;24;0;27;0;0.0;0.0
08;2021-01-05;1;0;28;0;0.0;0.0
08;2021-01-06;0;0;28;0;0.0;0.0
08;2021-01-07;188;0;216;0;0.1;0.0
08;2021-01-08;315;1;531;1;0.2;0.0
08;2021-01-09;115;0;646;1;0.2;0.0
08;2021-01-10;1;0;647;1;0.2;0.0
08;2021-01-11;66;0;713;1;0.3;0.0
08;2021-01-12;157;0;870;1;0.3;0.0
08;2021-01-13;480;1;1350;2;0.5;0.0
08;2021-01-14;538;9;1888;11;0.7;0.0
08;2021-01-15;288;2;2176;13;0.8;0.0
08;2021-01-16;107;0;2283;13;0.9;0.0
08;2021-01-17;2;0;2285;13;0.9;0.0
08;2021-01-18;372;2;2657;15;1.0;0.0
08;2021-01-19;873;2;3530;17;1.3;0.0
08;2021-01-20;909;4;4439;21;1.7;0.0
08;2021-01-21;743;1;5182;22;2.0;0.0
08;2021-01-22;678;1;5860;23;2.2;0.0
08;2021-01-23;237;0;6097;23;2.3;0.0
08;2021-01-24;0;0;6097;23;2.3;0.0
08;2021-01-25;209;0;6306;23;2.4;0.0
08;2021-01-26;303;2;6609;25;2.5;0.0
08;2021-01-27;410;1;7019;26;2.6;0.0
08;2021-01-28;565;183;7584;209;2.9;0.1
08;2021-01-29;587;182;8171;391;3.1;0.1
08;2021-01-30;222;63;8393;454;3.2;0.2
08;2021-01-31;1;0;8394;454;3.2;0.2
08;2021-02-01;80;46;8474;500;3.2;0.2
08;2021-02-02;192;172;8666;672;3.3;0.3
08;2021-02-03;140;169;8806;841;3.3;0.3
08;2021-02-04;309;287;9115;1128;3.4;0.4
08;2021-02-05;499;360;9614;1488;3.6;0.6
08;2021-02-06;149;75;9763;1563;3.7;0.6
08;2021-02-07;8;0;9771;1563;3.7;0.6
08;2021-02-08;40;172;9811;1735;3.7;0.7
08;2021-02-09;220;646;10031;2381;3.8;0.9
08;2021-02-10;334;639;10365;3020;3.9;1.1
08;2021-02-11;467;365;10832;3385;4.1;1.3
08;2021-02-12;676;386;11508;3771;4.3;1.4
08;2021-02-13;140;115;11648;3886;4.4;1.5
08;2021-02-14;3;60;11651;3946;4.4;1.5
08;2021-02-15;227;208;11878;4154;4.5;1.6
08;2021-02-16;130;374;12008;4528;4.5;1.7
08;2021-02-17;112;414;12120;4942;4.6;1.9
08;2021-02-18;215;518;12335;5460;4.6;2.1
08;2021-02-19;305;423;12640;5883;4.8;2.2
08;2021-02-20;7;206;12647;6089;4.8;2.3
08;2021-02-21;0;0;12647;6089;4.8;2.3
08;2021-02-22;132;180;12779;6269;4.8;2.4
08;2021-02-23;150;319;12929;6588;4.9;2.5
08;2021-02-24;163;388;13092;6976;4.9;2.6
08;2021-02-25;500;529;13592;7505;5.1;2.8
08;2021-02-26;603;625;14195;8130;5.3;3.1
08;2021-02-27;319;194;14514;8324;5.5;3.1
08;2021-02-28;19;1;14533;8325;5.5;3.1
08;2021-03-01;200;105;14733;8430;5.5;3.2
08;2021-03-02;654;281;15387;8711;5.8;3.3
08;2021-03-03;899;202;16286;8913;6.1;3.4
08;2021-03-04;735;334;17021;9247;6.4;3.5
08;2021-03-05;1021;543;18042;9790;6.8;3.7
08;2021-03-06;695;141;18737;9931;7.1;3.7
08;2021-03-07;75;2;18812;9933;7.1;3.7
08;2021-03-08;218;125;19030;10058;7.2;3.8
08;2021-03-09;688;156;19718;10214;7.4;3.8
08;2021-03-10;1038;124;20756;10338;7.8;3.9
08;2021-03-11;982;256;21738;10594;8.2;4.0
08;2021-03-12;1633;519;23371;11113;8.8;4.2
08;2021-03-13;798;125;24169;11238;9.1;4.2
08;2021-03-14;22;0;24191;11238;9.1;4.2
08;2021-03-15;291;73;24482;11311;9.2;4.3
08;2021-03-16;563;40;25045;11351;9.4;4.3
08;2021-03-17;804;66;25849;11417;9.7;4.3
08;2021-03-18;815;162;26664;11579;10.0;4.4
08;2021-03-19;1134;287;27798;11866;10.5;4.5
08;2021-03-20;511;20;28309;11886;10.7;4.5
08;2021-03-21;13;1;28322;11887;10.7;4.5
08;2021-03-22;367;45;28689;11932;10.8;4.5
08;2021-03-23;733;63;29422;11995;11.1;4.5
08;2021-03-24;1327;75;30749;12070;11.6;4.5
08;2021-03-25;1906;98;32655;12168;12.3;4.6
08;2021-03-26;2571;174;35226;12342;13.3;4.6
08;2021-03-27;898;125;36124;12467;13.6;4.7
08;2021-03-28;228;7;36352;12474;13.7;4.7
08;2021-03-29;261;184;36613;12658;13.8;4.8
08;2021-03-30;832;488;37445;13146;14.1;5.0
08;2021-03-31;852;535;38297;13681;14.4;5.2
08;2021-04-01;1688;453;39985;14134;15.1;5.3
08;2021-04-02;1497;523;41482;14657;15.6;5.5
08;2021-04-03;1329;205;42811;14862;16.1;5.6
08;2021-04-04;134;4;42945;14866;16.2;5.6
08;2021-04-05;17;0;42962;14866;16.2;5.6
08;2021-04-06;702;484;43664;15350;16.4;5.8
08;2021-04-07;909;705;44573;16055;16.8;6.0
08;2021-04-08;1745;525;46318;16580;17.4;6.2
08;2021-04-09;2347;731;48665;17311;18.3;6.5
08;2021-04-10;1445;229;50110;17540;18.9;6.6
08;2021-04-11;10;6;50120;17546;18.9;6.6
08;2021-04-12;671;218;50791;17764;19.1;6.7
08;2021-04-13;1309;613;52100;18377;19.6;6.9
08;2021-04-14;1280;867;53380;19244;20.1;7.2
08;2021-04-15;1606;810;54986;20054;20.7;7.6
08;2021-04-16;1873;884;56859;20938;21.4;7.9
08;2021-04-17;1112;403;57971;21341;21.8;8.0
08;2021-04-18;23;14;57994;21355;21.8;8.0
08;2021-04-19;1152;301;59146;21656;22.3;8.2
08;2021-04-20;1120;544;60266;22200;22.7;8.4
08;2021-04-21;1139;747;61405;22947;23.1;8.6
08;2021-04-22;1326;880;62731;23827;23.6;9.0
08;2021-04-23;1675;1174;64406;25001;24.3;9.4
08;2021-04-24;1325;647;65731;25648;24.8;9.7
08;2021-04-25;26;198;65757;25846;24.8;9.7
08;2021-04-26;1040;157;66797;26003;25.2;9.8
08;2021-04-27;1338;601;68135;26604;25.7;10.0
08;2021-04-28;1453;682;69588;27286;26.2;10.3
08;2021-04-29;1173;1316;70761;28602;26.6;10.8
08;2021-04-30;1769;1618;72530;30220;27.3;11.4
08;2021-05-01;1049;497;73579;30717;27.7;11.6
08;2021-05-02;627;183;74206;30900;27.9;11.6
08;2021-05-03;1172;376;75378;31276;28.4;11.8
08;2021-05-04;1328;876;76706;32152;28.9;12.1
08;2021-05-05;1567;1335;78273;33487;29.5;12.6
08;2021-05-06;1971;1664;80244;35151;30.2;13.2
08;2021-05-07;1860;2102;82104;37253;30.9;14.0
08;2021-05-08;922;768;83026;38021;31.3;14.3
08;2021-05-09;443;71;83469;38092;31.4;14.3
08;2021-05-10;1192;664;84661;38756;31.9;14.6
08;2021-05-11;1907;946;86568;39702;32.6;15.0
08;2021-05-12;1808;1240;88376;40942;33.3;15.4
08;2021-05-13;1306;620;89682;41562;33.8;15.7
08;2021-05-14;2535;1038;92217;42600;34.7;16.0
08;2021-05-15;1820;712;94037;43312;35.4;16.3
08;2021-05-16;820;102;94857;43414;35.7;16.3
08;2021-05-17;700;906;95557;44320;36.0;16.7
08;2021-05-18;1250;841;96807;45161;36.5;17.0
08;2021-05-19;1611;960;98418;46121;37.1;17.4
08;2021-05-20;2147;963;100565;47084;37.9;17.7
08;2021-05-21;2339;1275;102904;48359;38.8;18.2
08;2021-05-22;1817;763;104721;49122;39.4;18.5
08;2021-05-23;864;90;105585;49212;39.8;18.5
08;2021-05-24;716;106;106301;49318;40.0;18.6
08;2021-05-25;1456;669;107757;49987;40.6;18.8
08;2021-05-26;1529;1011;109286;50998;41.2;19.2
08;2021-05-27;2006;1146;111292;52144;41.9;19.6
08;2021-05-28;1973;1822;113265;53966;42.7;20.3
08;2021-05-29;1767;966;115032;54932;43.3;20.7
08;2021-05-30;836;102;115868;55034;43.6;20.7
08;2021-05-31;755;570;116623;55604;43.9;20.9
08;2021-06-01;1350;879;117973;56483;44.4;21.3
08;2021-06-02;1295;1194;119268;57677;44.9;21.7
08;2021-06-03;1386;1524;120654;59201;45.4;22.3
08;2021-06-04;1778;2420;122432;61621;46.1;23.2
08;2021-06-05;1176;1381;123608;63002;46.6;23.7
08;2021-06-06;907;107;124515;63109;46.9;23.8
08;2021-06-07;661;1174;125176;64283;47.1;24.2
08;2021-06-08;931;1496;126107;65779;47.5;24.8
08;2021-06-09;840;1391;126947;67170;47.8;25.3
08;2021-06-10;1719;1563;128666;68733;48.5;25.9
08;2021-06-11;1721;2211;130387;70944;49.1;26.7
08;2021-06-12;1417;1528;131804;72472;49.6;27.3
08;2021-06-13;385;598;132189;73070;49.8;27.5
08;2021-06-14;380;1304;132569;74374;49.9;28.0
08;2021-06-15;742;1548;133311;75922;50.2;28.6
08;2021-06-16;808;2054;134119;77976;50.5;29.4
08;2021-06-17;1285;1854;135404;79830;51.0;30.1
08;2021-06-18;1610;2594;137014;82424;51.6;31.0
08;2021-06-19;1324;1407;138338;83831;52.1;31.6
08;2021-06-20;117;423;138455;84254;52.1;31.7
08;2021-06-21;494;1395;138949;85649;52.3;32.3
08;2021-06-22;812;2023;139761;87672;52.6;33.0
08;2021-06-23;859;1672;140620;89344;53.0;33.6
08;2021-06-24;1038;1923;141658;91267;53.3;34.4
08;2021-06-25;1084;2735;142742;94002;53.8;35.4
08;2021-06-26;1010;1784;143752;95786;54.1;36.1
08;2021-06-27;351;643;144103;96429;54.3;36.3
08;2021-06-28;397;1324;144500;97753;54.4;36.8
08;2021-06-29;627;1471;145127;99224;54.7;37.4
08;2021-06-30;857;1689;145984;100913;55.0;38.0
08;2021-07-01;888;2194;146872;103107;55.3;38.8
08;2021-07-02;939;2645;147811;105752;55.7;39.8
08;2021-07-03;784;2145;148595;107897;56.0;40.6
08;2021-07-04;128;861;148723;108758;56.0;41.0
08;2021-07-05;104;1195;148827;109953;56.0;41.4
08;2021-07-06;425;1835;149252;111788;56.2;42.1
08;2021-07-07;364;1780;149616;113568;56.3;42.8
08;2021-07-08;716;2016;150332;115584;56.6;43.5
08;2021-07-09;732;2432;151064;118016;56.9;44.4
08;2021-07-10;652;2003;151716;120019;57.1;45.2
08;2021-07-11;238;725;151954;120744;57.2;45.5
08;2021-07-12;312;1192;152266;121936;57.3;45.9
08;2021-07-13;947;1788;153213;123724;57.7;46.6
08;2021-07-14;179;329;153392;124053;57.8;46.7
08;2021-07-15;759;2449;154151;126502;58.1;47.6
08;2021-07-16;1084;2408;155235;128910;58.5;48.5
08;2021-07-17;993;2108;156228;131018;58.8;49.3
08;2021-07-18;346;741;156574;131759;59.0;49.6
08;2021-07-19;459;918;157033;132677;59.1;50.0
08;2021-07-20;879;1435;157912;134112;59.5;50.5
08;2021-07-21;1237;1717;159149;135829;59.9;51.2
08;2021-07-22;1150;2167;160299;137996;60.4;52.0
08;2021-07-23;1584;2444;161883;140440;61.0;52.9
08;2021-07-24;1309;1924;163192;142364;61.5;53.6
08;2021-07-25;774;445;163966;142809;61.8;53.8
08;2021-07-26;1325;846;165291;143655;62.2;54.1
08;2021-07-27;2186;1408;167477;145063;63.1;54.6
08;2021-07-28;2413;1455;169890;146518;64.0;55.2
08;2021-07-29;2601;1347;172491;147865;65.0;55.7
08;2021-07-30;2601;1587;175092;149452;65.9;56.3
08;2021-07-31;1972;1075;177064;150527;66.7;56.7
08;2021-08-01;935;301;177999;150828;67.0;56.8
08;2021-08-02;1255;682;179254;151510;67.5;57.1
08;2021-08-03;1634;824;180888;152334;68.1;57.4
08;2021-08-04;1493;666;182381;153000;68.7;57.6
08;2021-08-05;1905;977;184286;153977;69.4;58.0
08;2021-08-06;2589;1098;186875;155075;70.4;58.4
08;2021-08-07;1673;1162;188548;156237;71.0;58.8
08;2021-08-08;585;374;189133;156611;71.2;59.0
08;2021-08-09;672;534;189805;157145;71.5;59.2
08;2021-08-10;879;750;190684;157895;71.8;59.5
08;2021-08-11;525;791;191209;158686;72.0;59.8
08;2021-08-12;1161;1080;192370;159766;72.4;60.2
08;2021-08-13;1157;1013;193527;160779;72.9;60.5
08;2021-08-14;587;913;194114;161692;73.1;60.9
08;2021-08-15;137;273;194251;161965;73.2;61.0
08;2021-08-16;218;1177;194469;163142;73.2;61.4
08;2021-08-17;514;1211;194983;164353;73.4;61.9
08;2021-08-18;281;1263;195264;165616;73.5;62.4
08;2021-08-19;606;1888;195870;167504;73.8;63.1
08;2021-08-20;685;2178;196555;169682;74.0;63.9
08;2021-08-21;273;1340;196828;171022;74.1;64.4
08;2021-08-22;104;900;196932;171922;74.2;64.7
08;2021-08-23;160;1448;197092;173370;74.2;65.3
08;2021-08-24;365;1752;197457;175122;74.4;66.0
08;2021-08-25;323;1248;197780;176370;74.5;66.4
08;2021-08-26;502;2064;198282;178434;74.7;67.2
08;2021-08-27;451;2324;198733;180758;74.8;68.1
08;2021-08-28;262;1289;198995;182047;74.9;68.6
08;2021-08-29;169;563;199164;182610;75.0;68.8
08;2021-08-30;302;1156;199466;183766;75.1;69.2
08;2021-08-31;360;1248;199826;185014;75.3;69.7
08;2021-09-01;417;1232;200243;186246;75.4;70.1
08;2021-09-02;466;1150;200709;187396;75.6;70.6
08;2021-09-03;464;1553;201173;188949;75.8;71.2
08;2021-09-04;349;1413;201522;190362;75.9;71.7
08;2021-09-05;106;173;201628;190535;75.9;71.8
08;2021-09-06;196;404;201824;190939;76.0;71.9
08;2021-09-07;205;488;202029;191427;76.1;72.1
08;2021-09-08;281;500;202310;191927;76.2;72.3
08;2021-09-09;344;590;202654;192517;76.3;72.5
08;2021-09-10;495;780;203149;193297;76.5;72.8
08;2021-09-11;383;732;203532;194029;76.7;73.1
08;2021-09-12;52;71;203584;194100;76.7;73.1
08;2021-09-13;386;174;203970;194274;76.8;73.2
08;2021-09-14;247;275;204217;194549;76.9;73.3
08;2021-09-15;219;317;204436;194866;77.0;73.4
08;2021-09-16;231;422;204667;195288;77.1;73.5
08;2021-09-17;321;501;204988;195789;77.2;73.7
08;2021-09-18;173;430;205161;196219;77.3;73.9
08;2021-09-19;29;90;205190;196309;77.3;73.9
08;2021-09-20;54;237;205244;196546;77.3;74.0
08;2021-09-21;123;277;205367;196823;77.3;74.1
08;2021-09-22;130;368;205497;197191;77.4;74.3
08;2021-09-23;174;412;205671;197603;77.5;74.4
08;2021-09-24;164;517;205835;198120;77.5;74.6
08;2021-09-25;122;414;205957;198534;77.6;74.8
08;2021-09-26;23;105;205980;198639;77.6;74.8
08;2021-09-27;49;211;206029;198850;77.6;74.9
08;2021-09-28;80;227;206109;199077;77.6;75.0
08;2021-09-29;116;339;206225;199416;77.7;75.1
08;2021-09-30;147;376;206372;199792;77.7;75.2
08;2021-10-01;165;466;206537;200258;77.8;75.4
08;2021-10-02;141;291;206678;200549;77.8;75.5
08;2021-10-03;24;67;206702;200616;77.8;75.6
08;2021-10-04;58;347;206760;200963;77.9;75.7
08;2021-10-05;79;172;206839;201135;77.9;75.7
08;2021-10-06;92;242;206931;201377;77.9;75.8
08;2021-10-07;105;196;207036;201573;78.0;75.9
08;2021-10-08;154;357;207190;201930;78.0;76.0
08;2021-10-09;136;331;207326;202261;78.1;76.2
08;2021-10-10;34;47;207360;202308;78.1;76.2
08;2021-10-11;58;83;207418;202391;78.1;76.2
08;2021-10-12;77;134;207495;202525;78.1;76.3
08;2021-10-13;116;160;207611;202685;78.2;76.3
08;2021-10-14;55;154;207666;202839;78.2;76.4
08;2021-10-15;213;307;207879;203146;78.3;76.5
08;2021-10-16;81;131;207960;203277;78.3;76.6
08;2021-10-17;31;26;207991;203303;78.3;76.6
08;2021-10-18;69;58;208060;203361;78.4;76.6
08;2021-10-19;56;72;208116;203433;78.4;76.6
09;2020-12-27;0;0;0;0;0.0;0.0
09;2020-12-28;1;0;1;0;0.0;0.0
09;2020-12-29;0;0;1;0;0.0;0.0
09;2020-12-30;0;0;1;0;0.0;0.0
09;2020-12-31;0;0;1;0;0.0;0.0
09;2021-01-01;0;0;1;0;0.0;0.0
09;2021-01-02;0;0;1;0;0.0;0.0
09;2021-01-03;0;0;1;0;0.0;0.0
09;2021-01-04;2;1;3;1;0.0;0.0
09;2021-01-05;0;0;3;1;0.0;0.0
09;2021-01-06;3;0;6;1;0.0;0.0
09;2021-01-07;257;2;263;3;0.2;0.0
09;2021-01-08;228;0;491;3;0.3;0.0
09;2021-01-09;103;0;594;3;0.4;0.0
09;2021-01-10;60;0;654;3;0.4;0.0
09;2021-01-11;176;0;830;3;0.5;0.0
09;2021-01-12;303;0;1133;3;0.7;0.0
09;2021-01-13;196;0;1329;3;0.9;0.0
09;2021-01-14;432;7;1761;10;1.2;0.0
09;2021-01-15;223;1;1984;11;1.3;0.0
09;2021-01-16;192;3;2176;14;1.4;0.0
09;2021-01-17;123;0;2299;14;1.5;0.0
09;2021-01-18;263;2;2562;16;1.7;0.0
09;2021-01-19;255;1;2817;17;1.8;0.0
09;2021-01-20;346;2;3163;19;2.1;0.0
09;2021-01-21;330;1;3493;20;2.3;0.0
09;2021-01-22;327;1;3820;21;2.5;0.0
09;2021-01-23;237;0;4057;21;2.7;0.0
09;2021-01-24;87;1;4144;22;2.7;0.0
09;2021-01-25;208;12;4352;34;2.9;0.0
09;2021-01-26;629;25;4981;59;3.3;0.0
09;2021-01-27;472;49;5453;108;3.6;0.1
09;2021-01-28;287;205;5740;313;3.8;0.2
09;2021-01-29;251;129;5991;442;3.9;0.3
09;2021-01-30;143;55;6134;497;4.0;0.3
09;2021-01-31;56;10;6190;507;4.1;0.3
09;2021-02-01;81;142;6271;649;4.1;0.4
09;2021-02-02;58;295;6329;944;4.2;0.6
09;2021-02-03;87;204;6416;1148;4.2;0.8
09;2021-02-04;49;299;6465;1447;4.2;0.9
09;2021-02-05;90;154;6555;1601;4.3;1.1
09;2021-02-06;69;51;6624;1652;4.3;1.1
09;2021-02-07;6;71;6630;1723;4.4;1.1
09;2021-02-08;23;177;6653;1900;4.4;1.2
09;2021-02-09;55;290;6708;2190;4.4;1.4
09;2021-02-10;14;195;6722;2385;4.4;1.6
09;2021-02-11;6;219;6728;2604;4.4;1.7
09;2021-02-12;147;176;6875;2780;4.5;1.8
09;2021-02-13;8;144;6883;2924;4.5;1.9
09;2021-02-14;0;52;6883;2976;4.5;2.0
09;2021-02-15;76;133;6959;3109;4.6;2.0
09;2021-02-16;227;509;7186;3618;4.7;2.4
09;2021-02-17;83;387;7269;4005;4.8;2.6
09;2021-02-18;87;446;7356;4451;4.8;2.9
09;2021-02-19;63;284;7419;4735;4.9;3.1
09;2021-02-20;58;199;7477;4934;4.9;3.2
09;2021-02-21;0;51;7477;4985;4.9;3.3
09;2021-02-22;127;217;7604;5202;5.0;3.4
09;2021-02-23;161;145;7765;5347;5.1;3.5
09;2021-02-24;74;178;7839;5525;5.1;3.6
09;2021-02-25;211;169;8050;5694;5.3;3.7
09;2021-02-26;162;177;8212;5871;5.4;3.9
09;2021-02-27;65;71;8277;5942;5.4;3.9
09;2021-02-28;44;17;8321;5959;5.5;3.9
09;2021-03-01;248;95;8569;6054;5.6;4.0
09;2021-03-02;282;77;8851;6131;5.8;4.0
09;2021-03-03;253;132;9104;6263;6.0;4.1
09;2021-03-04;414;33;9518;6296;6.2;4.1
09;2021-03-05;331;65;9849;6361;6.5;4.2
09;2021-03-06;397;46;10246;6407;6.7;4.2
09;2021-03-07;124;4;10370;6411;6.8;4.2
09;2021-03-08;379;64;10749;6475;7.1;4.2
09;2021-03-09;437;144;11186;6619;7.3;4.3
09;2021-03-10;562;73;11748;6692;7.7;4.4
09;2021-03-11;695;79;12443;6771;8.2;4.4
09;2021-03-12;661;35;13104;6806;8.6;4.5
09;2021-03-13;384;3;13488;6809;8.9;4.5
09;2021-03-14;122;5;13610;6814;8.9;4.5
09;2021-03-15;465;50;14075;6864;9.2;4.5
09;2021-03-16;370;81;14445;6945;9.5;4.6
09;2021-03-17;399;71;14844;7016;9.7;4.6
09;2021-03-18;454;43;15298;7059;10.0;4.6
09;2021-03-19;526;56;15824;7115;10.4;4.7
09;2021-03-20;314;40;16138;7155;10.6;4.7
09;2021-03-21;105;0;16243;7155;10.7;4.7
09;2021-03-22;424;120;16667;7275;10.9;4.8
09;2021-03-23;566;174;17233;7449;11.3;4.9
09;2021-03-24;710;44;17943;7493;11.8;4.9
09;2021-03-25;869;139;18812;7632;12.3;5.0
09;2021-03-26;751;47;19563;7679;12.8;5.0
09;2021-03-27;620;70;20183;7749;13.2;5.1
09;2021-03-28;132;24;20315;7773;13.3;5.1
09;2021-03-29;498;279;20813;8052;13.7;5.3
09;2021-03-30;729;157;21542;8209;14.1;5.4
09;2021-03-31;801;183;22343;8392;14.7;5.5
09;2021-04-01;734;257;23077;8649;15.1;5.7
09;2021-04-02;692;269;23769;8918;15.6;5.9
09;2021-04-03;772;117;24541;9035;16.1;5.9
09;2021-04-04;122;57;24663;9092;16.2;6.0
09;2021-04-05;237;61;24900;9153;16.3;6.0
09;2021-04-06;1059;396;25959;9549;17.0;6.3
09;2021-04-07;1208;364;27167;9913;17.8;6.5
09;2021-04-08;1470;414;28637;10327;18.8;6.8
09;2021-04-09;1137;417;29774;10744;19.5;7.0
09;2021-04-10;1349;196;31123;10940;20.4;7.2
09;2021-04-11;173;102;31296;11042;20.5;7.2
09;2021-04-12;736;344;32032;11386;21.0;7.5
09;2021-04-13;1047;417;33079;11803;21.7;7.7
09;2021-04-14;1332;512;34411;12315;22.6;8.1
09;2021-04-15;1148;508;35559;12823;23.3;8.4
09;2021-04-16;1032;415;36591;13238;24.0;8.7
09;2021-04-17;1192;358;37783;13596;24.8;8.9
09;2021-04-18;102;96;37885;13692;24.9;9.0
09;2021-04-19;697;408;38582;14100;25.3;9.3
09;2021-04-20;766;531;39348;14631;25.8;9.6
09;2021-04-21;938;590;40286;15221;26.4;10.0
09;2021-04-22;666;609;40952;15830;26.9;10.4
09;2021-04-23;773;432;41725;16262;27.4;10.7
09;2021-04-24;741;670;42466;16932;27.9;11.1
09;2021-04-25;75;113;42541;17045;27.9;11.2
09;2021-04-26;382;533;42923;17578;28.2;11.5
09;2021-04-27;444;722;43367;18300;28.5;12.0
09;2021-04-28;806;795;44173;19095;29.0;12.5
09;2021-04-29;549;775;44722;19870;29.3;13.0
09;2021-04-30;622;724;45344;20594;29.8;13.5
09;2021-05-01;478;455;45822;21049;30.1;13.8
09;2021-05-02;52;100;45874;21149;30.1;13.9
09;2021-05-03;522;664;46396;21813;30.4;14.3
09;2021-05-04;554;1349;46950;23162;30.8;15.2
09;2021-05-05;822;1348;47772;24510;31.3;16.1
09;2021-05-06;848;1032;48620;25542;31.9;16.8
09;2021-05-07;978;822;49598;26364;32.5;17.3
09;2021-05-08;395;461;49993;26825;32.8;17.6
09;2021-05-09;265;85;50258;26910;33.0;17.7
09;2021-05-10;504;966;50762;27876;33.3;18.3
09;2021-05-11;741;1052;51503;28928;33.8;19.0
09;2021-05-12;1535;1405;53038;30333;34.8;19.9
09;2021-05-13;1383;425;54421;30758;35.7;20.2
09;2021-05-14;987;656;55408;31414;36.4;20.6
09;2021-05-15;1236;789;56644;32203;37.2;21.1
09;2021-05-16;296;48;56940;32251;37.4;21.2
09;2021-05-17;873;413;57813;32664;37.9;21.4
09;2021-05-18;1290;395;59103;33059;38.8;21.7
09;2021-05-19;1495;371;60598;33430;39.8;21.9
09;2021-05-20;1379;404;61977;33834;40.7;22.2
09;2021-05-21;1162;494;63139;34328;41.4;22.5
09;2021-05-22;1544;364;64683;34692;42.4;22.8
09;2021-05-23;272;24;64955;34716;42.6;22.8
09;2021-05-24;177;100;65132;34816;42.7;22.8
09;2021-05-25;998;500;66130;35316;43.4;23.2
09;2021-05-26;1285;448;67415;35764;44.2;23.5
09;2021-05-27;965;403;68380;36167;44.9;23.7
09;2021-05-28;958;513;69338;36680;45.5;24.1
09;2021-05-29;1793;601;71131;37281;46.7;24.5
09;2021-05-30;541;197;71672;37478;47.0;24.6
09;2021-05-31;717;593;72389;38071;47.5;25.0
09;2021-06-01;970;642;73359;38713;48.1;25.4
09;2021-06-02;1009;897;74368;39610;48.8;26.0
09;2021-06-03;809;681;75177;40291;49.3;26.4
09;2021-06-04;877;798;76054;41089;49.9;27.0
09;2021-06-05;1320;875;77374;41964;50.8;27.5
09;2021-06-06;304;108;77678;42072;51.0;27.6
09;2021-06-07;623;518;78301;42590;51.4;27.9
09;2021-06-08;821;488;79122;43078;51.9;28.3
09;2021-06-09;805;834;79927;43912;52.4;28.8
09;2021-06-10;642;534;80569;44446;52.9;29.2
09;2021-06-11;830;761;81399;45207;53.4;29.7
09;2021-06-12;635;808;82034;46015;53.8;30.2
09;2021-06-13;94;130;82128;46145;53.9;30.3
09;2021-06-14;628;708;82756;46853;54.3;30.7
09;2021-06-15;824;889;83580;47742;54.8;31.3
09;2021-06-16;627;1080;84207;48822;55.3;32.0
09;2021-06-17;779;852;84986;49674;55.8;32.6
09;2021-06-18;636;1150;85622;50824;56.2;33.3
09;2021-06-19;516;1580;86138;52404;56.5;34.4
09;2021-06-20;8;279;86146;52683;56.5;34.6
09;2021-06-21;473;698;86619;53381;56.8;35.0
09;2021-06-22;463;1066;87082;54447;57.1;35.7
09;2021-06-23;435;1224;87517;55671;57.4;36.5
09;2021-06-24;581;769;88098;56440;57.8;37.0
09;2021-06-25;410;1064;88508;57504;58.1;37.7
09;2021-06-26;443;1087;88951;58591;58.4;38.4
09;2021-06-27;2;275;88953;58866;58.4;38.6
09;2021-06-28;239;1047;89192;59913;58.5;39.3
09;2021-06-29;314;1229;89506;61142;58.7;40.1
09;2021-06-30;456;1492;89962;62634;59.0;41.1
09;2021-07-01;384;1434;90346;64068;59.3;42.0
09;2021-07-02;308;1162;90654;65230;59.5;42.8
09;2021-07-03;210;1617;90864;66847;59.6;43.9
09;2021-07-04;4;253;90868;67100;59.6;44.0
09;2021-07-05;188;713;91056;67813;59.7;44.5
09;2021-07-06;293;1222;91349;69035;59.9;45.3
09;2021-07-07;419;1399;91768;70434;60.2;46.2
09;2021-07-08;325;1058;92093;71492;60.4;46.9
09;2021-07-09;292;1153;92385;72645;60.6;47.7
09;2021-07-10;345;1725;92730;74370;60.8;48.8
09;2021-07-11;147;392;92877;74762;60.9;49.1
09;2021-07-12;187;1074;93064;75836;61.1;49.8
09;2021-07-13;641;1308;93705;77144;61.5;50.6
09;2021-07-14;490;220;94195;77364;61.8;50.8
09;2021-07-15;819;1166;95014;78530;62.3;51.5
09;2021-07-16;610;1192;95624;79722;62.7;52.3
09;2021-07-17;1015;1444;96639;81166;63.4;53.3
09;2021-07-18;302;221;96941;81387;63.6;53.4
09;2021-07-19;483;973;97424;82360;63.9;54.0
09;2021-07-20;830;1260;98254;83620;64.5;54.9
09;2021-07-21;1016;1165;99270;84785;65.1;55.6
09;2021-07-22;846;910;100116;85695;65.7;56.2
09;2021-07-23;724;912;100840;86607;66.2;56.8
09;2021-07-24;927;463;101767;87070;66.8;57.1
09;2021-07-25;560;134;102327;87204;67.1;57.2
09;2021-07-26;648;765;102975;87969;67.6;57.7
09;2021-07-27;1177;949;104152;88918;68.3;58.3
09;2021-07-28;1197;988;105349;89906;69.1;59.0
09;2021-07-29;1042;739;106391;90645;69.8;59.5
09;2021-07-30;779;623;107170;91268;70.3;59.9
09;2021-07-31;1379;419;108549;91687;71.2;60.2
09;2021-08-01;141;125;108690;91812;71.3;60.2
09;2021-08-02;614;478;109304;92290;71.7;60.6
09;2021-08-03;1254;767;110558;93057;72.5;61.1
09;2021-08-04;1400;654;111958;93711;73.5;61.5
09;2021-08-05;996;677;112954;94388;74.1;61.9
09;2021-08-06;1017;641;113971;95029;74.8;62.4
09;2021-08-07;825;430;114796;95459;75.3;62.6
09;2021-08-08;129;131;114925;95590;75.4;62.7
09;2021-08-09;690;650;115615;96240;75.9;63.2
09;2021-08-10;940;695;116555;96935;76.5;63.6
09;2021-08-11;896;866;117451;97801;77.1;64.2
09;2021-08-12;631;731;118082;98532;77.5;64.7
09;2021-08-13;465;645;118547;99177;77.8;65.1
09;2021-08-14;311;828;118858;100005;78.0;65.6
09;2021-08-15;67;138;118925;100143;78.0;65.7
09;2021-08-16;547;620;119472;100763;78.4;66.1
09;2021-08-17;674;777;120146;101540;78.8;66.6
09;2021-08-18;620;931;120766;102471;79.2;67.2
09;2021-08-19;432;722;121198;103193;79.5;67.7
09;2021-08-20;363;749;121561;103942;79.8;68.2
09;2021-08-21;343;1384;121904;105326;80.0;69.1
09;2021-08-22;67;168;121971;105494;80.0;69.2
09;2021-08-23;341;759;122312;106253;80.3;69.7
09;2021-08-24;407;955;122719;107208;80.5;70.3
09;2021-08-25;283;1003;123002;108211;80.7;71.0
09;2021-08-26;316;928;123318;109139;80.9;71.6
09;2021-08-27;226;740;123544;109879;81.1;72.1
09;2021-08-28;257;970;123801;110849;81.2;72.7
09;2021-08-29;15;144;123816;110993;81.2;72.8
09;2021-08-30;275;720;124091;111713;81.4;73.3
09;2021-08-31;314;1064;124405;112777;81.6;74.0
09;2021-09-01;361;770;124766;113547;81.9;74.5
09;2021-09-02;159;494;124925;114041;82.0;74.8
09;2021-09-03;223;743;125148;114784;82.1;75.3
09;2021-09-04;200;474;125348;115258;82.3;75.6
09;2021-09-05;25;80;125373;115338;82.3;75.7
09;2021-09-06;182;519;125555;115857;82.4;76.0
09;2021-09-07;157;547;125712;116404;82.5;76.4
09;2021-09-08;204;827;125916;117231;82.6;76.9
09;2021-09-09;160;434;126076;117665;82.7;77.2
09;2021-09-10;130;429;126206;118094;82.8;77.5
09;2021-09-11;175;400;126381;118494;82.9;77.8
09;2021-09-12;27;71;126408;118565;82.9;77.8
09;2021-09-13;129;418;126537;118983;83.0;78.1
09;2021-09-14;144;502;126681;119485;83.1;78.4
09;2021-09-15;188;603;126869;120088;83.2;78.8
09;2021-09-16;130;324;126999;120412;83.3;79.0
09;2021-09-17;146;406;127145;120818;83.4;79.3
09;2021-09-18;159;345;127304;121163;83.5;79.5
09;2021-09-19;2;0;127306;121163;83.5;79.5
09;2021-09-20;71;290;127377;121453;83.6;79.7
09;2021-09-21;101;205;127478;121658;83.6;79.8
09;2021-09-22;141;471;127619;122129;83.7;80.1
09;2021-09-23;71;164;127690;122293;83.8;80.2
09;2021-09-24;117;289;127807;122582;83.9;80.4
09;2021-09-25;62;195;127869;122777;83.9;80.6
09;2021-09-26;0;17;127869;122794;83.9;80.6
09;2021-09-27;82;327;127951;123121;84.0;80.8
09;2021-09-28;74;175;128025;123296;84.0;80.9
09;2021-09-29;97;235;128122;123531;84.1;81.1
09;2021-09-30;43;119;128165;123650;84.1;81.1
09;2021-10-01;82;125;128247;123775;84.2;81.2
09;2021-10-02;83;229;128330;124004;84.2;81.4
09;2021-10-03;2;8;128332;124012;84.2;81.4
09;2021-10-04;53;114;128385;124126;84.2;81.4
09;2021-10-05;70;125;128455;124251;84.3;81.5
09;2021-10-06;123;222;128578;124473;84.4;81.7
09;2021-10-07;60;165;128638;124638;84.4;81.8
09;2021-10-08;109;180;128747;124818;84.5;81.9
09;2021-10-09;55;133;128802;124951;84.5;82.0
09;2021-10-10;0;7;128802;124958;84.5;82.0
09;2021-10-11;69;107;128871;125065;84.6;82.1
09;2021-10-12;45;77;128916;125142;84.6;82.1
09;2021-10-13;88;155;129004;125297;84.6;82.2
09;2021-10-14;54;90;129058;125387;84.7;82.3
09;2021-10-15;81;120;129139;125507;84.7;82.4
09;2021-10-16;96;103;129235;125610;84.8;82.4
09;2021-10-17;2;1;129237;125611;84.8;82.4
09;2021-10-18;53;118;129290;125729;84.8;82.5
09;2021-10-19;55;81;129345;125810;84.9;82.6
10;2020-12-27;0;0;0;0;0.0;0.0
10;2020-12-28;0;0;0;0;0.0;0.0
10;2020-12-29;0;0;0;0;0.0;0.0
10;2020-12-30;0;0;0;0;0.0;0.0
10;2020-12-31;0;0;0;0;0.0;0.0
10;2021-01-01;0;0;0;0;0.0;0.0
10;2021-01-02;1;0;1;0;0.0;0.0
10;2021-01-03;0;0;1;0;0.0;0.0
10;2021-01-04;0;0;1;0;0.0;0.0
10;2021-01-05;1;0;2;0;0.0;0.0
10;2021-01-06;0;0;2;0;0.0;0.0
10;2021-01-07;85;0;87;0;0.0;0.0
10;2021-01-08;255;0;342;0;0.1;0.0
10;2021-01-09;0;0;342;0;0.1;0.0
10;2021-01-10;1;0;343;0;0.1;0.0
10;2021-01-11;118;1;461;1;0.1;0.0
10;2021-01-12;195;4;656;5;0.2;0.0
10;2021-01-13;314;0;970;5;0.3;0.0
10;2021-01-14;392;10;1362;15;0.4;0.0
10;2021-01-15;359;3;1721;18;0.6;0.0
10;2021-01-16;56;0;1777;18;0.6;0.0
10;2021-01-17;1;0;1778;18;0.6;0.0
10;2021-01-18;702;4;2480;22;0.8;0.0
10;2021-01-19;1392;8;3872;30;1.2;0.0
10;2021-01-20;1084;9;4956;39;1.6;0.0
10;2021-01-21;1152;2;6108;41;2.0;0.0
10;2021-01-22;818;2;6926;43;2.2;0.0
10;2021-01-23;309;0;7235;43;2.3;0.0
10;2021-01-24;0;0;7235;43;2.3;0.0
10;2021-01-25;445;8;7680;51;2.5;0.0
10;2021-01-26;487;17;8167;68;2.6;0.0
10;2021-01-27;458;15;8625;83;2.8;0.0
10;2021-01-28;358;49;8983;132;2.9;0.0
10;2021-01-29;430;191;9413;323;3.0;0.1
10;2021-01-30;30;0;9443;323;3.0;0.1
10;2021-01-31;0;0;9443;323;3.0;0.1
10;2021-02-01;409;139;9852;462;3.2;0.1
10;2021-02-02;182;151;10034;613;3.2;0.2
10;2021-02-03;361;215;10395;828;3.4;0.3
10;2021-02-04;342;269;10737;1097;3.5;0.4
10;2021-02-05;328;322;11065;1419;3.6;0.5
10;2021-02-06;3;35;11068;1454;3.6;0.5
10;2021-02-07;0;0;11068;1454;3.6;0.5
10;2021-02-08;190;411;11258;1865;3.6;0.6
10;2021-02-09;486;586;11744;2451;3.8;0.8
10;2021-02-10;667;481;12411;2932;4.0;0.9
10;2021-02-11;781;596;13192;3528;4.3;1.1
10;2021-02-12;580;549;13772;4077;4.4;1.3
10;2021-02-13;37;120;13809;4197;4.5;1.4
10;2021-02-14;0;0;13809;4197;4.5;1.4
10;2021-02-15;143;442;13952;4639;4.5;1.5
10;2021-02-16;116;541;14068;5180;4.5;1.7
10;2021-02-17;129;603;14197;5783;4.6;1.9
10;2021-02-18;217;555;14414;6338;4.7;2.0
10;2021-02-19;188;473;14602;6811;4.7;2.2
10;2021-02-20;24;183;14626;6994;4.7;2.3
10;2021-02-21;0;0;14626;6994;4.7;2.3
10;2021-02-22;77;445;14703;7439;4.7;2.4
10;2021-02-23;76;557;14779;7996;4.8;2.6
10;2021-02-24;114;373;14893;8369;4.8;2.7
10;2021-02-25;322;373;15215;8742;4.9;2.8
10;2021-02-26;351;283;15566;9025;5.0;2.9
10;2021-02-27;275;129;15841;9154;5.1;3.0
10;2021-02-28;0;0;15841;9154;5.1;3.0
10;2021-03-01;257;332;16098;9486;5.2;3.1
10;2021-03-02;435;369;16533;9855;5.3;3.2
10;2021-03-03;454;583;16987;10438;5.5;3.4
10;2021-03-04;636;501;17623;10939;5.7;3.5
10;2021-03-05;677;254;18300;11193;5.9;3.6
10;2021-03-06;950;46;19250;11239;6.2;3.6
10;2021-03-07;769;7;20019;11246;6.5;3.6
10;2021-03-08;502;442;20521;11688;6.6;3.8
10;2021-03-09;673;435;21194;12123;6.8;3.9
10;2021-03-10;662;365;21856;12488;7.1;4.0
10;2021-03-11;1174;238;23030;12726;7.4;4.1
10;2021-03-12;1338;250;24368;12976;7.9;4.2
10;2021-03-13;891;39;25259;13015;8.2;4.2
10;2021-03-14;1381;17;26640;13032;8.6;4.2
10;2021-03-15;821;83;27461;13115;8.9;4.2
10;2021-03-16;688;64;28149;13179;9.1;4.3
10;2021-03-17;831;68;28980;13247;9.4;4.3
10;2021-03-18;886;84;29866;13331;9.6;4.3
10;2021-03-19;952;71;30818;13402;9.9;4.3
10;2021-03-20;552;19;31370;13421;10.1;4.3
10;2021-03-21;1848;44;33218;13465;10.7;4.3
10;2021-03-22;879;76;34097;13541;11.0;4.4
10;2021-03-23;1243;94;35340;13635;11.4;4.4
10;2021-03-24;1311;60;36651;13695;11.8;4.4
10;2021-03-25;1676;232;38327;13927;12.4;4.5
10;2021-03-26;1432;116;39759;14043;12.8;4.5
10;2021-03-27;762;80;40521;14123;13.1;4.6
10;2021-03-28;1221;31;41742;14154;13.5;4.6
10;2021-03-29;648;305;42390;14459;13.7;4.7
10;2021-03-30;927;376;43317;14835;14.0;4.8
10;2021-03-31;617;361;43934;15196;14.2;4.9
10;2021-04-01;882;687;44816;15883;14.5;5.1
10;2021-04-02;1069;589;45885;16472;14.8;5.3
10;2021-04-03;540;606;46425;17078;15.0;5.5
10;2021-04-04;1826;264;48251;17342;15.6;5.6
10;2021-04-05;1843;43;50094;17385;16.2;5.6
10;2021-04-06;514;651;50608;18036;16.3;5.8
10;2021-04-07;592;541;51200;18577;16.5;6.0
10;2021-04-08;1062;610;52262;19187;16.9;6.2
10;2021-04-09;1130;613;53392;19800;17.2;6.4
10;2021-04-10;1769;352;55161;20152;17.8;6.5
10;2021-04-11;55;1221;55216;21373;17.8;6.9
10;2021-04-12;1001;808;56217;22181;18.1;7.2
10;2021-04-13;1506;896;57723;23077;18.6;7.4
10;2021-04-14;827;603;58550;23680;18.9;7.6
10;2021-04-15;1454;899;60004;24579;19.4;7.9
10;2021-04-16;1109;697;61113;25276;19.7;8.2
10;2021-04-17;2391;363;63504;25639;20.5;8.3
10;2021-04-18;1421;1789;64925;27428;20.9;8.9
10;2021-04-19;837;833;65762;28261;21.2;9.1
10;2021-04-20;548;1037;66310;29298;21.4;9.5
10;2021-04-21;636;975;66946;30273;21.6;9.8
10;2021-04-22;932;963;67878;31236;21.9;10.1
10;2021-04-23;2172;779;70050;32015;22.6;10.3
10;2021-04-24;2296;380;72346;32395;23.3;10.5
10;2021-04-25;1991;1217;74337;33612;24.0;10.8
10;2021-04-26;773;623;75110;34235;24.2;11.0
10;2021-04-27;895;537;76005;34772;24.5;11.2
10;2021-04-28;873;407;76878;35179;24.8;11.4
10;2021-04-29;1433;674;78311;35853;25.3;11.6
10;2021-04-30;2172;771;80483;36624;26.0;11.8
10;2021-05-01;1988;2169;82471;38793;26.6;12.5
10;2021-05-02;1948;1898;84419;40691;27.2;13.1
10;2021-05-03;622;447;85041;41138;27.4;13.3
10;2021-05-04;1144;1248;86185;42386;27.8;13.7
10;2021-05-05;1753;1023;87938;43409;28.4;14.0
10;2021-05-06;2257;951;90195;44360;29.1;14.3
10;2021-05-07;2219;1141;92414;45501;29.8;14.7
10;2021-05-08;2270;860;94684;46361;30.6;15.0
10;2021-05-09;2004;100;96688;46461;31.2;15.0
10;2021-05-10;531;1094;97219;47555;31.4;15.3
10;2021-05-11;1052;1034;98271;48589;31.7;15.7
10;2021-05-12;2061;884;100332;49473;32.4;16.0
10;2021-05-13;2181;436;102513;49909;33.1;16.1
10;2021-05-14;2728;673;105241;50582;34.0;16.3
10;2021-05-15;2423;2053;107664;52635;34.7;17.0
10;2021-05-16;2080;1447;109744;54082;35.4;17.5
10;2021-05-17;1451;442;111195;54524;35.9;17.6
10;2021-05-18;2510;640;113705;55164;36.7;17.8
10;2021-05-19;1554;642;115259;55806;37.2;18.0
10;2021-05-20;1896;847;117155;56653;37.8;18.3
10;2021-05-21;2318;619;119473;57272;38.6;18.5
10;2021-05-22;2179;422;121652;57694;39.3;18.6
10;2021-05-23;1816;138;123468;57832;39.8;18.7
10;2021-05-24;1968;177;125436;58009;40.5;18.7
10;2021-05-25;2195;491;127631;58500;41.2;18.9
10;2021-05-26;1679;421;129310;58921;41.7;19.0
10;2021-05-27;1659;753;130969;59674;42.3;19.3
10;2021-05-28;1720;1186;132689;60860;42.8;19.6
10;2021-05-29;2170;643;134859;61503;43.5;19.8
10;2021-05-30;1029;136;135888;61639;43.8;19.9
10;2021-05-31;1039;751;136927;62390;44.2;20.1
10;2021-06-01;1134;886;138061;63276;44.5;20.4
10;2021-06-02;1035;720;139096;63996;44.9;20.7
10;2021-06-03;1473;1069;140569;65065;45.4;21.0
10;2021-06-04;1768;2598;142337;67663;45.9;21.8
10;2021-06-05;1518;2451;143855;70114;46.4;22.6
10;2021-06-06;1005;1874;144860;71988;46.7;23.2
10;2021-06-07;700;1112;145560;73100;47.0;23.6
10;2021-06-08;896;1172;146456;74272;47.3;24.0
10;2021-06-09;880;915;147336;75187;47.5;24.3
10;2021-06-10;678;1070;148014;76257;47.8;24.6
10;2021-06-11;1200;2209;149214;78466;48.1;25.3
10;2021-06-12;856;2390;150070;80856;48.4;26.1
10;2021-06-13;401;1834;150471;82690;48.6;26.7
10;2021-06-14;538;743;151009;83433;48.7;26.9
10;2021-06-15;741;2132;151750;85565;49.0;27.6
10;2021-06-16;741;1858;152491;87423;49.2;28.2
10;2021-06-17;851;2457;153342;89880;49.5;29.0
10;2021-06-18;1030;2471;154372;92351;49.8;29.8
10;2021-06-19;981;2595;155353;94946;50.1;30.6
10;2021-06-20;549;1597;155902;96543;50.3;31.2
10;2021-06-21;684;1045;156586;97588;50.5;31.5
10;2021-06-22;745;1526;157331;99114;50.8;32.0
10;2021-06-23;653;2406;157984;101520;51.0;32.8
10;2021-06-24;790;2617;158774;104137;51.2;33.6
10;2021-06-25;730;3048;159504;107185;51.5;34.6
10;2021-06-26;514;2747;160018;109932;51.6;35.5
10;2021-06-27;402;1940;160420;111872;51.8;36.1
10;2021-06-28;683;1784;161103;113656;52.0;36.7
10;2021-06-29;616;2698;161719;116354;52.2;37.5
10;2021-06-30;534;1524;162253;117878;52.4;38.0
10;2021-07-01;555;2172;162808;120050;52.5;38.7
10;2021-07-02;664;2726;163472;122776;52.7;39.6
10;2021-07-03;529;2600;164001;125376;52.9;40.5
10;2021-07-04;411;1726;164412;127102;53.1;41.0
10;2021-07-05;667;2224;165079;129326;53.3;41.7
10;2021-07-06;651;2188;165730;131514;53.5;42.4
10;2021-07-07;639;1703;166369;133217;53.7;43.0
10;2021-07-08;751;1459;167120;134676;53.9;43.5
10;2021-07-09;820;1949;167940;136625;54.2;44.1
10;2021-07-10;632;2096;168572;138721;54.4;44.8
10;2021-07-11;500;1384;169072;140105;54.6;45.2
10;2021-07-12;783;1624;169855;141729;54.8;45.7
10;2021-07-13;1126;1874;170981;143603;55.2;46.3
10;2021-07-14;1169;1054;172150;144657;55.5;46.7
10;2021-07-15;1477;1980;173627;146637;56.0;47.3
10;2021-07-16;1241;2276;174868;148913;56.4;48.1
10;2021-07-17;1287;1738;176155;150651;56.8;48.6
10;2021-07-18;942;1225;177097;151876;57.1;49.0
10;2021-07-19;1361;1622;178458;153498;57.6;49.5
10;2021-07-20;1685;1433;180143;154931;58.1;50.0
10;2021-07-21;1395;1485;181538;156416;58.6;50.5
10;2021-07-22;1941;1598;183479;158014;59.2;51.0
10;2021-07-23;1605;1544;185084;159558;59.7;51.5
10;2021-07-24;1389;1229;186473;160787;60.2;51.9
10;2021-07-25;1251;790;187724;161577;60.6;52.1
10;2021-07-26;1914;1318;189638;162895;61.2;52.6
10;2021-07-27;2139;1071;191777;163966;61.9;52.9
10;2021-07-28;2094;1019;193871;164985;62.6;53.2
10;2021-07-29;2444;1205;196315;166190;63.3;53.6
10;2021-07-30;2176;1311;198491;167501;64.0;54.0
10;2021-07-31;1680;938;200171;168439;64.6;54.4
10;2021-08-01;1236;570;201407;169009;65.0;54.5
10;2021-08-02;1463;1338;202870;170347;65.5;55.0
10;2021-08-03;1635;897;204505;171244;66.0;55.3
10;2021-08-04;1370;1068;205875;172312;66.4;55.6
10;2021-08-05;1654;1345;207529;173657;67.0;56.0
10;2021-08-06;1835;1333;209364;174990;67.6;56.5
10;2021-08-07;1156;1133;210520;176123;67.9;56.8
10;2021-08-08;660;751;211180;176874;68.1;57.1
10;2021-08-09;1311;1542;212491;178416;68.6;57.6
10;2021-08-10;1670;1353;214161;179769;69.1;58.0
10;2021-08-11;854;1108;215015;180877;69.4;58.4
10;2021-08-12;1055;1225;216070;182102;69.7;58.8
10;2021-08-13;739;1074;216809;183176;70.0;59.1
10;2021-08-14;587;1235;217396;184411;70.1;59.5
10;2021-08-15;317;781;217713;185192;70.3;59.8
10;2021-08-16;725;1618;218438;186810;70.5;60.3
10;2021-08-17;877;1776;219315;188586;70.8;60.9
10;2021-08-18;723;1620;220038;190206;71.0;61.4
10;2021-08-19;551;1571;220589;191777;71.2;61.9
10;2021-08-20;644;1733;221233;193510;71.4;62.4
10;2021-08-21;452;1419;221685;194929;71.5;62.9
10;2021-08-22;189;1061;221874;195990;71.6;63.2
10;2021-08-23;481;1562;222355;197552;71.7;63.7
10;2021-08-24;669;1771;223024;199323;72.0;64.3
10;2021-08-25;460;1381;223484;200704;72.1;64.8
10;2021-08-26;432;1486;223916;202190;72.3;65.2
10;2021-08-27;629;1589;224545;203779;72.5;65.8
10;2021-08-28;396;1333;224941;205112;72.6;66.2
10;2021-08-29;225;946;225166;206058;72.7;66.5
10;2021-08-30;433;1376;225599;207434;72.8;66.9
10;2021-08-31;470;1426;226069;208860;72.9;67.4
10;2021-09-01;298;1105;226367;209965;73.0;67.8
10;2021-09-02;273;972;226640;210937;73.1;68.1
10;2021-09-03;404;1062;227044;211999;73.3;68.4
10;2021-09-04;342;1014;227386;213013;73.4;68.7
10;2021-09-05;174;409;227560;213422;73.4;68.9
10;2021-09-06;273;595;227833;214017;73.5;69.1
10;2021-09-07;303;601;228136;214618;73.6;69.3
10;2021-09-08;255;607;228391;215225;73.7;69.4
10;2021-09-09;333;720;228724;215945;73.8;69.7
10;2021-09-10;433;763;229157;216708;73.9;69.9
10;2021-09-11;264;634;229421;217342;74.0;70.1
10;2021-09-12;93;210;229514;217552;74.1;70.2
10;2021-09-13;226;473;229740;218025;74.1;70.4
10;2021-09-14;249;597;229989;218622;74.2;70.5
10;2021-09-15;237;637;230226;219259;74.3;70.7
10;2021-09-16;281;598;230507;219857;74.4;70.9
10;2021-09-17;270;859;230777;220716;74.5;71.2
10;2021-09-18;197;611;230974;221327;74.5;71.4
10;2021-09-19;62;224;231036;221551;74.6;71.5
10;2021-09-20;139;627;231175;222178;74.6;71.7
10;2021-09-21;151;554;231326;222732;74.6;71.9
10;2021-09-22;132;305;231458;223037;74.7;72.0
10;2021-09-23;216;353;231674;223390;74.8;72.1
10;2021-09-24;211;547;231885;223937;74.8;72.3
10;2021-09-25;112;420;231997;224357;74.9;72.4
10;2021-09-26;58;216;232055;224573;74.9;72.5
10;2021-09-27;222;268;232277;224841;75.0;72.6
10;2021-09-28;205;362;232482;225203;75.0;72.7
10;2021-09-29;190;292;232672;225495;75.1;72.8
10;2021-09-30;157;221;232829;225716;75.1;72.8
10;2021-10-01;202;447;233031;226163;75.2;73.0
10;2021-10-02;145;285;233176;226448;75.2;73.1
10;2021-10-03;58;128;233234;226576;75.3;73.1
10;2021-10-04;98;194;233332;226770;75.3;73.2
10;2021-10-05;107;216;233439;226986;75.3;73.2
10;2021-10-06;136;225;233575;227211;75.4;73.3
10;2021-10-07;138;319;233713;227530;75.4;73.4
10;2021-10-08;186;286;233899;227816;75.5;73.5
10;2021-10-09;123;247;234022;228063;75.5;73.6
10;2021-10-10;53;87;234075;228150;75.5;73.6
10;2021-10-11;113;191;234188;228341;75.6;73.7
10;2021-10-12;111;190;234299;228531;75.6;73.7
10;2021-10-13;119;180;234418;228711;75.6;73.8
10;2021-10-14;113;223;234531;228934;75.7;73.9
10;2021-10-15;149;302;234680;229236;75.7;74.0
10;2021-10-16;116;161;234796;229397;75.8;74.0
10;2021-10-17;43;55;234839;229452;75.8;74.0
10;2021-10-18;108;165;234947;229617;75.8;74.1
10;2021-10-19;108;199;235055;229816;75.8;74.2
11;2020-12-27;0;0;0;0;0.0;0.0
11;2020-12-28;1;0;1;0;0.0;0.0
11;2020-12-29;1;0;2;0;0.0;0.0
11;2020-12-30;0;0;2;0;0.0;0.0
11;2020-12-31;0;0;2;0;0.0;0.0
11;2021-01-01;0;0;2;0;0.0;0.0
11;2021-01-02;4;0;6;0;0.0;0.0
11;2021-01-03;0;0;6;0;0.0;0.0
11;2021-01-04;1;0;7;0;0.0;0.0
11;2021-01-05;95;1;102;1;0.0;0.0
11;2021-01-06;26;0;128;1;0.0;0.0
11;2021-01-07;119;0;247;1;0.1;0.0
11;2021-01-08;91;1;338;2;0.1;0.0
11;2021-01-09;86;0;424;2;0.1;0.0
11;2021-01-10;67;0;491;2;0.1;0.0
11;2021-01-11;136;0;627;2;0.2;0.0
11;2021-01-12;545;3;1172;5;0.3;0.0
11;2021-01-13;409;1;1581;6;0.4;0.0
11;2021-01-14;647;10;2228;16;0.6;0.0
11;2021-01-15;342;3;2570;19;0.7;0.0
11;2021-01-16;77;1;2647;20;0.7;0.0
11;2021-01-17;47;2;2694;22;0.7;0.0
11;2021-01-18;388;0;3082;22;0.8;0.0
11;2021-01-19;540;12;3622;34;1.0;0.0
11;2021-01-20;693;7;4315;41;1.2;0.0
11;2021-01-21;650;7;4965;48;1.3;0.0
11;2021-01-22;526;2;5491;50;1.5;0.0
11;2021-01-23;165;2;5656;52;1.5;0.0
11;2021-01-24;139;1;5795;53;1.6;0.0
11;2021-01-25;376;19;6171;72;1.7;0.0
11;2021-01-26;852;85;7023;157;1.9;0.0
11;2021-01-27;804;27;7827;184;2.1;0.0
11;2021-01-28;652;62;8479;246;2.3;0.1
11;2021-01-29;442;124;8921;370;2.4;0.1
11;2021-01-30;139;4;9060;374;2.4;0.1
11;2021-01-31;83;0;9143;374;2.5;0.1
11;2021-02-01;344;197;9487;571;2.5;0.2
11;2021-02-02;412;407;9899;978;2.7;0.3
11;2021-02-03;392;354;10291;1332;2.8;0.4
11;2021-02-04;377;499;10668;1831;2.9;0.5
11;2021-02-05;322;336;10990;2167;2.9;0.6
11;2021-02-06;211;65;11201;2232;3.0;0.6
11;2021-02-07;109;14;11310;2246;3.0;0.6
11;2021-02-08;317;160;11627;2406;3.1;0.6
11;2021-02-09;300;280;11927;2686;3.2;0.7
11;2021-02-10;344;446;12271;3132;3.3;0.8
11;2021-02-11;609;631;12880;3763;3.5;1.0
11;2021-02-12;408;381;13288;4144;3.6;1.1
11;2021-02-13;196;118;13484;4262;3.6;1.1
11;2021-02-14;75;26;13559;4288;3.6;1.2
11;2021-02-15;241;209;13800;4497;3.7;1.2
11;2021-02-16;264;509;14064;5006;3.8;1.3
11;2021-02-17;454;620;14518;5626;3.9;1.5
11;2021-02-18;456;571;14974;6197;4.0;1.7
11;2021-02-19;300;535;15274;6732;4.1;1.8
11;2021-02-20;148;75;15422;6807;4.1;1.8
11;2021-02-21;59;46;15481;6853;4.2;1.8
11;2021-02-22;124;328;15605;7181;4.2;1.9
11;2021-02-23;283;318;15888;7499;4.3;2.0
11;2021-02-24;253;366;16141;7865;4.3;2.1
11;2021-02-25;563;332;16704;8197;4.5;2.2
11;2021-02-26;524;315;17228;8512;4.6;2.3
11;2021-02-27;319;100;17547;8612;4.7;2.3
11;2021-02-28;95;24;17642;8636;4.7;2.3
11;2021-03-01;339;315;17981;8951;4.8;2.4
11;2021-03-02;563;390;18544;9341;5.0;2.5
11;2021-03-03;601;432;19145;9773;5.1;2.6
11;2021-03-04;1078;410;20223;10183;5.4;2.7
11;2021-03-05;1002;412;21225;10595;5.7;2.8
11;2021-03-06;1095;207;22320;10802;6.0;2.9
11;2021-03-07;658;33;22978;10835;6.2;2.9
11;2021-03-08;367;353;23345;11188;6.3;3.0
11;2021-03-09;1001;401;24346;11589;6.5;3.1
11;2021-03-10;1175;545;25521;12134;6.8;3.3
11;2021-03-11;1572;450;27093;12584;7.3;3.4
11;2021-03-12;1457;445;28550;13029;7.7;3.5
11;2021-03-13;1159;239;29709;13268;8.0;3.6
11;2021-03-14;523;54;30232;13322;8.1;3.6
11;2021-03-15;651;241;30883;13563;8.3;3.6
11;2021-03-16;854;201;31737;13764;8.5;3.7
11;2021-03-17;907;221;32644;13985;8.8;3.8
11;2021-03-18;1171;287;33815;14272;9.1;3.8
11;2021-03-19;1372;248;35187;14520;9.4;3.9
11;2021-03-20;789;176;35976;14696;9.7;3.9
11;2021-03-21;225;68;36201;14764;9.7;4.0
11;2021-03-22;809;221;37010;14985;9.9;4.0
11;2021-03-23;1807;393;38817;15378;10.4;4.1
11;2021-03-24;1847;322;40664;15700;10.9;4.2
11;2021-03-25;2190;375;42854;16075;11.5;4.3
11;2021-03-26;2125;451;44979;16526;12.1;4.4
11;2021-03-27;1178;147;46157;16673;12.4;4.5
11;2021-03-28;265;44;46422;16717;12.5;4.5
11;2021-03-29;1182;224;47604;16941;12.8;4.5
11;2021-03-30;1996;329;49600;17270;13.3;4.6
11;2021-03-31;1614;386;51214;17656;13.7;4.7
11;2021-04-01;2144;430;53358;18086;14.3;4.9
11;2021-04-02;1642;428;55000;18514;14.8;5.0
11;2021-04-03;720;146;55720;18660;15.0;5.0
11;2021-04-04;198;76;55918;18736;15.0;5.0
11;2021-04-05;257;4;56175;18740;15.1;5.0
11;2021-04-06;1574;555;57749;19295;15.5;5.2
11;2021-04-07;1779;576;59528;19871;16.0;5.3
11;2021-04-08;1785;686;61313;20557;16.5;5.5
11;2021-04-09;2261;608;63574;21165;17.1;5.7
11;2021-04-10;1168;181;64742;21346;17.4;5.7
11;2021-04-11;551;106;65293;21452;17.5;5.8
11;2021-04-12;1614;545;66907;21997;18.0;5.9
11;2021-04-13;2262;890;69169;22887;18.6;6.1
11;2021-04-14;1660;1017;70829;23904;19.0;6.4
11;2021-04-15;1843;1135;72672;25039;19.5;6.7
11;2021-04-16;1839;851;74511;25890;20.0;6.9
11;2021-04-17;1771;564;76282;26454;20.5;7.1
11;2021-04-18;114;155;76396;26609;20.5;7.1
11;2021-04-19;1384;739;77780;27348;20.9;7.3
11;2021-04-20;1729;1284;79509;28632;21.3;7.7
11;2021-04-21;1780;1324;81289;29956;21.8;8.0
11;2021-04-22;1749;1326;83038;31282;22.3;8.4
11;2021-04-23;2014;1239;85052;32521;22.8;8.7
11;2021-04-24;1735;469;86787;32990;23.3;8.9
11;2021-04-25;659;183;87446;33173;23.5;8.9
11;2021-04-26;1380;839;88826;34012;23.8;9.1
11;2021-04-27;1839;1556;90665;35568;24.3;9.5
11;2021-04-28;2008;1470;92673;37038;24.9;9.9
11;2021-04-29;2247;1641;94920;38679;25.5;10.4
11;2021-04-30;2158;1427;97078;40106;26.0;10.8
11;2021-05-01;1338;345;98416;40451;26.4;10.9
11;2021-05-02;588;336;99004;40787;26.6;10.9
11;2021-05-03;1487;739;100491;41526;27.0;11.1
11;2021-05-04;1878;1431;102369;42957;27.5;11.5
11;2021-05-05;1896;1441;104265;44398;28.0;11.9
11;2021-05-06;2191;1475;106456;45873;28.6;12.3
11;2021-05-07;2106;1560;108562;47433;29.1;12.7
11;2021-05-08;898;728;109460;48161;29.4;12.9
11;2021-05-09;628;543;110088;48704;29.5;13.1
11;2021-05-10;1327;1652;111415;50356;29.9;13.5
11;2021-05-11;2041;1874;113456;52230;30.4;14.0
11;2021-05-12;1848;1653;115304;53883;30.9;14.5
11;2021-05-13;1405;414;116709;54297;31.3;14.6
11;2021-05-14;1718;1184;118427;55481;31.8;14.9
11;2021-05-15;1158;897;119585;56378;32.1;15.1
11;2021-05-16;808;163;120393;56541;32.3;15.2
11;2021-05-17;1470;1046;121863;57587;32.7;15.5
11;2021-05-18;1898;1192;123761;58779;33.2;15.8
11;2021-05-19;1846;1124;125607;59903;33.7;16.1
11;2021-05-20;1971;1091;127578;60994;34.2;16.4
11;2021-05-21;2276;1093;129854;62087;34.8;16.7
11;2021-05-22;1485;727;131339;62814;35.2;16.9
11;2021-05-23;768;72;132107;62886;35.4;16.9
11;2021-05-24;1411;224;133518;63110;35.8;16.9
11;2021-05-25;1811;1353;135329;64463;36.3;17.3
11;2021-05-26;1934;1299;137263;65762;36.8;17.6
11;2021-05-27;1989;1722;139252;67484;37.4;18.1
11;2021-05-28;1754;1901;141006;69385;37.8;18.6
11;2021-05-29;1428;1601;142434;70986;38.2;19.0
11;2021-05-30;486;395;142920;71381;38.3;19.2
11;2021-05-31;1261;1616;144181;72997;38.7;19.6
11;2021-06-01;1856;1904;146037;74901;39.2;20.1
11;2021-06-02;1760;2067;147797;76968;39.7;20.7
11;2021-06-03;2598;2409;150395;79377;40.4;21.3
11;2021-06-04;2147;2668;152542;82045;40.9;22.0
11;2021-06-05;1588;1902;154130;83947;41.4;22.5
11;2021-06-06;877;858;155007;84805;41.6;22.8
11;2021-06-07;1527;1709;156534;86514;42.0;23.2
11;2021-06-08;2042;1996;158576;88510;42.5;23.7
11;2021-06-09;1786;2184;160362;90694;43.0;24.3
11;2021-06-10;1806;2427;162168;93121;43.5;25.0
11;2021-06-11;1864;2495;164032;95616;44.0;25.7
11;2021-06-12;1455;1624;165487;97240;44.4;26.1
11;2021-06-13;713;723;166200;97963;44.6;26.3
11;2021-06-14;1032;1968;167232;99931;44.9;26.8
11;2021-06-15;1394;2685;168626;102616;45.2;27.5
11;2021-06-16;1335;2528;169961;105144;45.6;28.2
11;2021-06-17;1474;2522;171435;107666;46.0;28.9
11;2021-06-18;1518;2487;172953;110153;46.4;29.6
11;2021-06-19;1236;1410;174189;111563;46.7;29.9
11;2021-06-20;299;599;174488;112162;46.8;30.1
11;2021-06-21;838;2122;175326;114284;47.0;30.7
11;2021-06-22;1016;2606;176342;116890;47.3;31.4
11;2021-06-23;1094;2089;177436;118979;47.6;31.9
11;2021-06-24;909;2244;178345;121223;47.9;32.5
11;2021-06-25;993;2547;179338;123770;48.1;33.2
11;2021-06-26;773;1655;180111;125425;48.3;33.7
11;2021-06-27;210;688;180321;126113;48.4;33.8
11;2021-06-28;697;2297;181018;128410;48.6;34.5
11;2021-06-29;963;2603;181981;131013;48.8;35.2
11;2021-06-30;906;2520;182887;133533;49.1;35.8
11;2021-07-01;1004;1889;183891;135422;49.3;36.3
11;2021-07-02;966;2540;184857;137962;49.6;37.0
11;2021-07-03;729;1807;185586;139769;49.8;37.5
11;2021-07-04;340;1109;185926;140878;49.9;37.8
11;2021-07-05;695;2132;186621;143010;50.1;38.4
11;2021-07-06;972;2521;187593;145531;50.3;39.0
11;2021-07-07;946;2512;188539;148043;50.6;39.7
11;2021-07-08;1191;1912;189730;149955;50.9;40.2
11;2021-07-09;824;1796;190554;151751;51.1;40.7
11;2021-07-10;369;1302;190923;153053;51.2;41.1
11;2021-07-11;313;564;191236;153617;51.3;41.2
11;2021-07-12;505;2672;191741;156289;51.4;41.9
11;2021-07-13;1304;3064;193045;159353;51.8;42.8
11;2021-07-14;210;233;193255;159586;51.9;42.8
11;2021-07-15;1451;2961;194706;162547;52.2;43.6
11;2021-07-16;1876;2734;196582;165281;52.7;44.3
11;2021-07-17;1075;2166;197657;167447;53.0;44.9
11;2021-07-18;652;946;198309;168393;53.2;45.2
11;2021-07-19;1355;2089;199664;170482;53.6;45.7
11;2021-07-20;1999;2403;201663;172885;54.1;46.4
11;2021-07-21;2015;2441;203678;175326;54.6;47.0
11;2021-07-22;2414;1884;206092;177210;55.3;47.5
11;2021-07-23;2232;2283;208324;179493;55.9;48.2
11;2021-07-24;1274;1629;209598;181122;56.2;48.6
11;2021-07-25;749;693;210347;181815;56.4;48.8
11;2021-07-26;1667;1427;212014;183242;56.9;49.2
11;2021-07-27;2340;1999;214354;185241;57.5;49.7
11;2021-07-28;2480;1991;216834;187232;58.2;50.2
11;2021-07-29;2771;1795;219605;189027;58.9;50.7
11;2021-07-30;2575;1803;222180;190830;59.6;51.2
11;2021-07-31;2008;1143;224188;191973;60.2;51.5
11;2021-08-01;1011;482;225199;192455;60.4;51.6
11;2021-08-02;1929;1152;227128;193607;60.9;51.9
11;2021-08-03;2443;1602;229571;195209;61.6;52.4
11;2021-08-04;2560;1270;232131;196479;62.3;52.7
11;2021-08-05;2382;1334;234513;197813;62.9;53.1
11;2021-08-06;2252;1661;236765;199474;63.5;53.5
11;2021-08-07;1665;1172;238430;200646;64.0;53.8
11;2021-08-08;599;210;239029;200856;64.1;53.9
11;2021-08-09;1033;1434;240062;202290;64.4;54.3
11;2021-08-10;1747;1987;241809;204277;64.9;54.8
11;2021-08-11;1717;1689;243526;205966;65.3;55.3
11;2021-08-12;1716;1858;245242;207824;65.8;55.8
11;2021-08-13;1348;1655;246590;209479;66.2;56.2
11;2021-08-14;984;1596;247574;211075;66.4;56.6
11;2021-08-15;138;125;247712;211200;66.5;56.7
11;2021-08-16;731;1914;248443;213114;66.7;57.2
11;2021-08-17;1046;2391;249489;215505;66.9;57.8
11;2021-08-18;1108;2032;250597;217537;67.2;58.4
11;2021-08-19;1006;2291;251603;219828;67.5;59.0
11;2021-08-20;976;2291;252579;222119;67.8;59.6
11;2021-08-21;576;1838;253155;223957;67.9;60.1
11;2021-08-22;192;512;253347;224469;68.0;60.2
11;2021-08-23;522;1816;253869;226285;68.1;60.7
11;2021-08-24;800;2255;254669;228540;68.3;61.3
11;2021-08-25;796;2158;255465;230698;68.5;61.9
11;2021-08-26;759;2001;256224;232699;68.7;62.4
11;2021-08-27;701;2223;256925;234922;68.9;63.0
11;2021-08-28;437;1745;257362;236667;69.1;63.5
11;2021-08-29;143;514;257505;237181;69.1;63.6
11;2021-08-30;455;1322;257960;238503;69.2;64.0
11;2021-08-31;584;1865;258544;240368;69.4;64.5
11;2021-09-01;608;1714;259152;242082;69.5;65.0
11;2021-09-02;556;1553;259708;243635;69.7;65.4
11;2021-09-03;538;1549;260246;245184;69.8;65.8
11;2021-09-04;489;1483;260735;246667;70.0;66.2
11;2021-09-05;153;237;260888;246904;70.0;66.2
11;2021-09-06;299;674;261187;247578;70.1;66.4
11;2021-09-07;357;895;261544;248473;70.2;66.7
11;2021-09-08;478;1155;262022;249628;70.3;67.0
11;2021-09-09;397;862;262419;250490;70.4;67.2
11;2021-09-10;381;990;262800;251480;70.5;67.5
11;2021-09-11;379;985;263179;252465;70.6;67.7
11;2021-09-12;61;127;263240;252592;70.6;67.8
11;2021-09-13;240;731;263480;253323;70.7;68.0
11;2021-09-14;363;623;263843;253946;70.8;68.1
11;2021-09-15;361;973;264204;254919;70.9;68.4
11;2021-09-16;309;585;264513;255504;71.0;68.6
11;2021-09-17;315;682;264828;256186;71.1;68.7
11;2021-09-18;269;733;265097;256919;71.1;68.9
11;2021-09-19;59;123;265156;257042;71.1;69.0
11;2021-09-20;166;333;265322;257375;71.2;69.1
11;2021-09-21;289;417;265611;257792;71.3;69.2
11;2021-09-22;231;769;265842;258561;71.3;69.4
11;2021-09-23;181;398;266023;258959;71.4;69.5
11;2021-09-24;275;519;266298;259478;71.5;69.6
11;2021-09-25;237;674;266535;260152;71.5;69.8
11;2021-09-26;35;131;266570;260283;71.5;69.8
11;2021-09-27;105;385;266675;260668;71.6;69.9
11;2021-09-28;214;355;266889;261023;71.6;70.0
11;2021-09-29;221;537;267110;261560;71.7;70.2
11;2021-09-30;194;360;267304;261920;71.7;70.3
11;2021-10-01;226;389;267530;262309;71.8;70.4
11;2021-10-02;232;447;267762;262756;71.8;70.5
11;2021-10-03;2;1;267764;262757;71.8;70.5
11;2021-10-04;138;296;267902;263053;71.9;70.6
11;2021-10-05;177;322;268079;263375;71.9;70.7
11;2021-10-06;261;447;268340;263822;72.0;70.8
11;2021-10-07;169;290;268509;264112;72.0;70.9
11;2021-10-08;211;418;268720;264530;72.1;71.0
11;2021-10-09;147;365;268867;264895;72.1;71.1
11;2021-10-10;0;1;268867;264896;72.1;71.1
11;2021-10-11;132;251;268999;265147;72.2;71.1
11;2021-10-12;154;314;269153;265461;72.2;71.2
11;2021-10-13;233;289;269386;265750;72.3;71.3
11;2021-10-14;188;250;269574;266000;72.3;71.4
11;2021-10-15;231;331;269805;266331;72.4;71.5
11;2021-10-16;185;245;269990;266576;72.4;71.5
11;2021-10-17;14;26;270004;266602;72.4;71.5
11;2021-10-18;99;150;270103;266752;72.5;71.6
11;2021-10-19;124;187;270227;266939;72.5;71.6
12;2020-12-27;0;0;0;0;0.0;0.0
12;2020-12-28;0;0;0;0;0.0;0.0
12;2020-12-29;0;0;0;0;0.0;0.0
12;2020-12-30;0;0;0;0;0.0;0.0
12;2020-12-31;0;0;0;0;0.0;0.0
12;2021-01-01;0;0;0;0;0.0;0.0
12;2021-01-02;0;0;0;0;0.0;0.0
12;2021-01-03;2;0;2;0;0.0;0.0
12;2021-01-04;1;0;3;0;0.0;0.0
12;2021-01-05;1;0;4;0;0.0;0.0
12;2021-01-06;12;0;16;0;0.0;0.0
12;2021-01-07;202;0;218;0;0.1;0.0
12;2021-01-08;65;0;283;0;0.1;0.0
12;2021-01-09;0;0;283;0;0.1;0.0
12;2021-01-10;1;0;284;0;0.1;0.0
12;2021-01-11;100;1;384;1;0.1;0.0
12;2021-01-12;361;2;745;3;0.3;0.0
12;2021-01-13;285;0;1030;3;0.4;0.0
12;2021-01-14;602;12;1632;15;0.6;0.0
12;2021-01-15;367;10;1999;25;0.7;0.0
12;2021-01-16;138;2;2137;27;0.8;0.0
12;2021-01-17;1;0;2138;27;0.8;0.0
12;2021-01-18;452;0;2590;27;0.9;0.0
12;2021-01-19;611;4;3201;31;1.1;0.0
12;2021-01-20;879;5;4080;36;1.5;0.0
12;2021-01-21;736;1;4816;37;1.7;0.0
12;2021-01-22;799;1;5615;38;2.0;0.0
12;2021-01-23;382;0;5997;38;2.2;0.0
12;2021-01-24;0;0;5997;38;2.2;0.0
12;2021-01-25;453;0;6450;38;2.3;0.0
12;2021-01-26;650;0;7100;38;2.6;0.0
12;2021-01-27;1888;40;8988;78;3.2;0.0
12;2021-01-28;1886;232;10874;310;3.9;0.1
12;2021-01-29;1331;46;12205;356;4.4;0.1
12;2021-01-30;359;2;12564;358;4.5;0.1
12;2021-01-31;0;0;12564;358;4.5;0.1
12;2021-02-01;335;89;12899;447;4.6;0.2
12;2021-02-02;459;241;13358;688;4.8;0.2
12;2021-02-03;459;168;13817;856;5.0;0.3
12;2021-02-04;459;526;14276;1382;5.1;0.5
12;2021-02-05;449;183;14725;1565;5.3;0.6
12;2021-02-06;222;66;14947;1631;5.4;0.6
12;2021-02-07;8;0;14955;1631;5.4;0.6
12;2021-02-08;104;313;15059;1944;5.4;0.7
12;2021-02-09;209;341;15268;2285;5.5;0.8
12;2021-02-10;468;475;15736;2760;5.7;1.0
12;2021-02-11;539;344;16275;3104;5.8;1.1
12;2021-02-12;570;345;16845;3449;6.1;1.2
12;2021-02-13;175;132;17020;3581;6.1;1.3
12;2021-02-14;1;0;17021;3581;6.1;1.3
12;2021-02-15;175;374;17196;3955;6.2;1.4
12;2021-02-16;171;509;17367;4464;6.2;1.6
12;2021-02-17;366;1431;17733;5895;6.4;2.1
12;2021-02-18;678;1662;18411;7557;6.6;2.7
12;2021-02-19;594;974;19005;8531;6.8;3.1
12;2021-02-20;103;392;19108;8923;6.9;3.2
12;2021-02-21;0;0;19108;8923;6.9;3.2
12;2021-02-22;150;398;19258;9321;6.9;3.3
12;2021-02-23;157;558;19415;9879;7.0;3.5
12;2021-02-24;156;685;19571;10564;7.0;3.8
12;2021-02-25;201;769;19772;11333;7.1;4.1
12;2021-02-26;320;650;20092;11983;7.2;4.3
12;2021-02-27;191;350;20283;12333;7.3;4.4
12;2021-02-28;13;0;20296;12333;7.3;4.4
12;2021-03-01;51;349;20347;12682;7.3;4.6
12;2021-03-02;190;507;20537;13189;7.4;4.7
12;2021-03-03;245;388;20782;13577;7.5;4.9
12;2021-03-04;278;363;21060;13940;7.6;5.0
12;2021-03-05;421;370;21481;14310;7.7;5.1
12;2021-03-06;793;129;22274;14439;8.0;5.2
12;2021-03-07;140;33;22414;14472;8.1;5.2
12;2021-03-08;234;208;22648;14680;8.1;5.3
12;2021-03-09;716;233;23364;14913;8.4;5.4
12;2021-03-10;785;744;24149;15657;8.7;5.6
12;2021-03-11;919;663;25068;16320;9.0;5.9
12;2021-03-12;1259;530;26327;16850;9.5;6.1
12;2021-03-13;896;140;27223;16990;9.8;6.1
12;2021-03-14;45;2;27268;16992;9.8;6.1
12;2021-03-15;559;159;27827;17151;10.0;6.2
12;2021-03-16;818;162;28645;17313;10.3;6.2
12;2021-03-17;1504;167;30149;17480;10.8;6.3
12;2021-03-18;997;255;31146;17735;11.2;6.4
12;2021-03-19;1382;282;32528;18017;11.7;6.5
12;2021-03-20;725;82;33253;18099;11.9;6.5
12;2021-03-21;264;10;33517;18109;12.0;6.5
12;2021-03-22;606;175;34123;18284;12.3;6.6
12;2021-03-23;1214;178;35337;18462;12.7;6.6
12;2021-03-24;1422;210;36759;18672;13.2;6.7
12;2021-03-25;1843;206;38602;18878;13.9;6.8
12;2021-03-26;1978;233;40580;19111;14.6;6.9
12;2021-03-27;981;68;41561;19179;14.9;6.9
12;2021-03-28;60;1;41621;19180;15.0;6.9
12;2021-03-29;963;85;42584;19265;15.3;6.9
12;2021-03-30;1737;125;44321;19390;15.9;7.0
12;2021-03-31;1460;107;45781;19497;16.4;7.0
12;2021-04-01;1957;167;47738;19664;17.1;7.1
12;2021-04-02;1613;346;49351;20010;17.7;7.2
12;2021-04-03;882;96;50233;20106;18.0;7.2
12;2021-04-04;1;0;50234;20106;18.0;7.2
12;2021-04-05;645;15;50879;20121;18.3;7.2
12;2021-04-06;1151;538;52030;20659;18.7;7.4
12;2021-04-07;1651;645;53681;21304;19.3;7.7
12;2021-04-08;2098;575;55779;21879;20.0;7.9
12;2021-04-09;2112;657;57891;22536;20.8;8.1
12;2021-04-10;1427;222;59318;22758;21.3;8.2
12;2021-04-11;120;1;59438;22759;21.4;8.2
12;2021-04-12;1836;506;61274;23265;22.0;8.4
12;2021-04-13;1906;779;63180;24044;22.7;8.6
12;2021-04-14;1832;1322;65012;25366;23.4;9.1
12;2021-04-15;1937;901;66949;26267;24.1;9.4
12;2021-04-16;1675;1205;68624;27472;24.7;9.9
12;2021-04-17;1553;568;70177;28040;25.2;10.1
12;2021-04-18;0;0;70177;28040;25.2;10.1
12;2021-04-19;1687;550;71864;28590;25.8;10.3
12;2021-04-20;1546;986;73410;29576;26.4;10.6
12;2021-04-21;1693;1183;75103;30759;27.0;11.1
12;2021-04-22;1689;1098;76792;31857;27.6;11.4
12;2021-04-23;1383;1335;78175;33192;28.1;11.9
12;2021-04-24;1450;720;79625;33912;28.6;12.2
12;2021-04-25;60;0;79685;33912;28.6;12.2
12;2021-04-26;1459;898;81144;34810;29.2;12.5
12;2021-04-27;1321;1281;82465;36091;29.6;13.0
12;2021-04-28;1113;1870;83578;37961;30.0;13.6
12;2021-04-29;1571;1911;85149;39872;30.6;14.3
12;2021-04-30;1815;1839;86964;41711;31.2;15.0
12;2021-05-01;1617;262;88581;41973;31.8;15.1
12;2021-05-02;9;0;88590;41973;31.8;15.1
12;2021-05-03;1713;1252;90303;43225;32.4;15.5
12;2021-05-04;1482;1396;91785;44621;33.0;16.0
12;2021-05-05;1296;1677;93081;46298;33.4;16.6
12;2021-05-06;1753;1378;94834;47676;34.1;17.1
12;2021-05-07;1483;1780;96317;49456;34.6;17.8
12;2021-05-08;1330;461;97647;49917;35.1;17.9
12;2021-05-09;13;34;97660;49951;35.1;17.9
12;2021-05-10;829;2216;98489;52167;35.4;18.7
12;2021-05-11;928;1851;99417;54018;35.7;19.4
12;2021-05-12;948;1820;100365;55838;36.1;20.1
12;2021-05-13;1587;811;101952;56649;36.6;20.4
12;2021-05-14;1235;1534;103187;58183;37.1;20.9
12;2021-05-15;1067;1115;104254;59298;37.5;21.3
12;2021-05-16;2;19;104256;59317;37.5;21.3
12;2021-05-17;1082;1810;105338;61127;37.8;22.0
12;2021-05-18;1427;1535;106765;62662;38.4;22.5
12;2021-05-19;1915;1330;108680;63992;39.0;23.0
12;2021-05-20;2118;876;110798;64868;39.8;23.3
12;2021-05-21;1821;1253;112619;66121;40.5;23.8
12;2021-05-22;1207;1016;113826;67137;40.9;24.1
12;2021-05-23;7;12;113833;67149;40.9;24.1
12;2021-05-24;1956;538;115789;67687;41.6;24.3
12;2021-05-25;1742;1159;117531;68846;42.2;24.7
12;2021-05-26;1998;780;119529;69626;42.9;25.0
12;2021-05-27;2165;744;121694;70370;43.7;25.3
12;2021-05-28;1927;1031;123621;71401;44.4;25.7
12;2021-05-29;1637;805;125258;72206;45.0;25.9
12;2021-05-30;9;43;125267;72249;45.0;26.0
12;2021-05-31;1699;817;126966;73066;45.6;26.2
12;2021-06-01;1887;1028;128853;74094;46.3;26.6
12;2021-06-02;1979;1051;130832;75145;47.0;27.0
12;2021-06-03;2123;831;132955;75976;47.8;27.3
12;2021-06-04;1967;1419;134922;77395;48.5;27.8
12;2021-06-05;1738;985;136660;78380;49.1;28.2
12;2021-06-06;6;6;136666;78386;49.1;28.2
12;2021-06-07;1092;1811;137758;80197;49.5;28.8
12;2021-06-08;1332;1201;139090;81398;50.0;29.2
12;2021-06-09;895;1294;139985;82692;50.3;29.7
12;2021-06-10;1022;921;141007;83613;50.7;30.0
12;2021-06-11;1204;2081;142211;85694;51.1;30.8
12;2021-06-12;1033;1322;143244;87016;51.5;31.3
12;2021-06-13;6;47;143250;87063;51.5;31.3
12;2021-06-14;662;1830;143912;88893;51.7;31.9
12;2021-06-15;745;1885;144657;90778;52.0;32.6
12;2021-06-16;820;1818;145477;92596;52.3;33.3
12;2021-06-17;678;995;146155;93591;52.5;33.6
12;2021-06-18;1134;1840;147289;95431;52.9;34.3
12;2021-06-19;914;1406;148203;96837;53.2;34.8
12;2021-06-20;4;10;148207;96847;53.2;34.8
12;2021-06-21;511;1737;148718;98584;53.4;35.4
12;2021-06-22;502;1474;149220;100058;53.6;35.9
12;2021-06-23;579;1306;149799;101364;53.8;36.4
12;2021-06-24;249;545;150048;101909;53.9;36.6
12;2021-06-25;876;1842;150924;103751;54.2;37.3
12;2021-06-26;673;1527;151597;105278;54.5;37.8
12;2021-06-27;1;9;151598;105287;54.5;37.8
12;2021-06-28;467;2454;152065;107741;54.6;38.7
12;2021-06-29;565;1959;152630;109700;54.8;39.4
12;2021-06-30;828;2132;153458;111832;55.1;40.2
12;2021-07-01;345;1086;153803;112918;55.3;40.6
12;2021-07-02;796;2629;154599;115547;55.5;41.5
12;2021-07-03;565;1872;155164;117419;55.7;42.2
12;2021-07-04;1;0;155165;117419;55.7;42.2
12;2021-07-05;440;2406;155605;119825;55.9;43.0
12;2021-07-06;640;2495;156245;122320;56.1;43.9
12;2021-07-07;688;2116;156933;124436;56.4;44.7
12;2021-07-08;295;913;157228;125349;56.5;45.0
12;2021-07-09;724;2589;157952;127938;56.7;46.0
12;2021-07-10;445;2077;158397;130015;56.9;46.7
12;2021-07-11;0;0;158397;130015;56.9;46.7
12;2021-07-12;587;2439;158984;132454;57.1;47.6
12;2021-07-13;840;2593;159824;135047;57.4;48.5
12;2021-07-14;44;25;159868;135072;57.4;48.5
12;2021-07-15;795;2107;160663;137179;57.7;49.3
12;2021-07-16;1247;2556;161910;139735;58.2;50.2
12;2021-07-17;790;2007;162700;141742;58.4;50.9
12;2021-07-18;25;11;162725;141753;58.5;50.9
12;2021-07-19;1319;2005;164044;143758;58.9;51.6
12;2021-07-20;1422;1475;165466;145233;59.4;52.2
12;2021-07-21;1022;941;166488;146174;59.8;52.5
12;2021-07-22;2236;1308;168724;147482;60.6;53.0
12;2021-07-23;1865;2064;170589;149546;61.3;53.7
12;2021-07-24;1604;1566;172193;151112;61.9;54.3
12;2021-07-25;97;28;172290;151140;61.9;54.3
12;2021-07-26;1931;1438;174221;152578;62.6;54.8
12;2021-07-27;2236;1011;176457;153589;63.4;55.2
12;2021-07-28;1715;675;178172;154264;64.0;55.4
12;2021-07-29;1189;807;179361;155071;64.4;55.7
12;2021-07-30;2507;1284;181868;156355;65.3;56.2
12;2021-07-31;1967;1005;183835;157360;66.0;56.5
12;2021-08-01;225;38;184060;157398;66.1;56.5
12;2021-08-02;1815;833;185875;158231;66.8;56.8
12;2021-08-03;1960;776;187835;159007;67.5;57.1
12;2021-08-04;1695;833;189530;159840;68.1;57.4
12;2021-08-05;1637;689;191167;160529;68.7;57.7
12;2021-08-06;1706;1314;192873;161843;69.3;58.1
12;2021-08-07;1448;744;194321;162587;69.8;58.4
12;2021-08-08;0;3;194321;162590;69.8;58.4
12;2021-08-09;1351;1415;195672;164005;70.3;58.9
12;2021-08-10;1343;1255;197015;165260;70.8;59.4
12;2021-08-11;820;1195;197835;166455;71.1;59.8
12;2021-08-12;737;1070;198572;167525;71.3;60.2
12;2021-08-13;1075;1335;199647;168860;71.7;60.7
12;2021-08-14;739;1354;200386;170214;72.0;61.1
12;2021-08-15;255;75;200641;170289;72.1;61.2
12;2021-08-16;670;1817;201311;172106;72.3;61.8
12;2021-08-17;905;1991;202216;174097;72.6;62.5
12;2021-08-18;448;1522;202664;175619;72.8;63.1
12;2021-08-19;641;1115;203305;176734;73.0;63.5
12;2021-08-20;797;1888;204102;178622;73.3;64.2
12;2021-08-21;473;1526;204575;180148;73.5;64.7
12;2021-08-22;93;27;204668;180175;73.5;64.7
12;2021-08-23;453;1921;205121;182096;73.7;65.4
12;2021-08-24;486;1918;205607;184014;73.9;66.1
12;2021-08-25;333;1579;205940;185593;74.0;66.7
12;2021-08-26;487;1607;206427;187200;74.2;67.3
12;2021-08-27;599;1700;207026;188900;74.4;67.9
12;2021-08-28;332;1553;207358;190453;74.5;68.4
12;2021-08-29;176;143;207534;190596;74.6;68.5
12;2021-08-30;563;1870;208097;192466;74.8;69.1
12;2021-08-31;419;1344;208516;193810;74.9;69.6
12;2021-09-01;426;923;208942;194733;75.1;70.0
12;2021-09-02;267;734;209209;195467;75.2;70.2
12;2021-09-03;490;1189;209699;196656;75.3;70.6
12;2021-09-04;432;1092;210131;197748;75.5;71.0
12;2021-09-05;52;192;210183;197940;75.5;71.1
12;2021-09-06;214;592;210397;198532;75.6;71.3
12;2021-09-07;270;482;210667;199014;75.7;71.5
12;2021-09-08;245;464;210912;199478;75.8;71.7
12;2021-09-09;174;394;211086;199872;75.8;71.8
12;2021-09-10;501;1006;211587;200878;76.0;72.2
12;2021-09-11;386;936;211973;201814;76.2;72.5
12;2021-09-12;17;103;211990;201917;76.2;72.5
12;2021-09-13;157;389;212147;202306;76.2;72.7
12;2021-09-14;281;351;212428;202657;76.3;72.8
12;2021-09-15;249;407;212677;203064;76.4;73.0
12;2021-09-16;387;412;213064;203476;76.5;73.1
12;2021-09-17;346;505;213410;203981;76.7;73.3
12;2021-09-18;242;687;213652;204668;76.8;73.5
12;2021-09-19;0;4;213652;204672;76.8;73.5
12;2021-09-20;107;432;213759;205104;76.8;73.7
12;2021-09-21;112;220;213871;205324;76.8;73.8
12;2021-09-22;132;578;214003;205902;76.9;74.0
12;2021-09-23;106;161;214109;206063;76.9;74.0
12;2021-09-24;216;536;214325;206599;77.0;74.2
12;2021-09-25;161;667;214486;207266;77.1;74.5
12;2021-09-26;0;1;214486;207267;77.1;74.5
12;2021-09-27;82;242;214568;207509;77.1;74.5
12;2021-09-28;97;252;214665;207761;77.1;74.6
12;2021-09-29;112;325;214777;208086;77.2;74.8
12;2021-09-30;51;124;214828;208210;77.2;74.8
12;2021-10-01;162;405;214990;208615;77.2;74.9
12;2021-10-02;182;479;215172;209094;77.3;75.1
12;2021-10-03;0;2;215172;209096;77.3;75.1
12;2021-10-04;84;169;215256;209265;77.3;75.2
12;2021-10-05;67;191;215323;209456;77.4;75.2
12;2021-10-06;117;267;215440;209723;77.4;75.3
12;2021-10-07;67;317;215507;210040;77.4;75.5
12;2021-10-08;153;402;215660;210442;77.5;75.6
12;2021-10-09;169;350;215829;210792;77.5;75.7
12;2021-10-10;1;0;215830;210792;77.5;75.7
12;2021-10-11;57;100;215887;210892;77.6;75.8
12;2021-10-12;40;114;215927;211006;77.6;75.8
12;2021-10-13;150;286;216077;211292;77.6;75.9
12;2021-10-14;69;137;216146;211429;77.6;76.0
12;2021-10-15;86;183;216232;211612;77.7;76.0
12;2021-10-16;181;254;216413;211866;77.7;76.1
12;2021-10-17;0;6;216413;211872;77.7;76.1
12;2021-10-18;62;78;216475;211950;77.8;76.1
12;2021-10-19;56;71;216531;212021;77.8;76.2
13;2020-12-27;5;0;5;0;0.0;0.0
13;2020-12-28;7;0;12;0;0.0;0.0
13;2020-12-29;1;0;13;0;0.0;0.0
13;2020-12-30;3;0;16;0;0.0;0.0
13;2020-12-31;6;0;22;0;0.0;0.0
13;2021-01-01;4;1;26;1;0.0;0.0
13;2021-01-02;4;0;30;1;0.0;0.0
13;2021-01-03;11;3;41;4;0.0;0.0
13;2021-01-04;1;1;42;5;0.0;0.0
13;2021-01-05;80;1;122;6;0.0;0.0
13;2021-01-06;122;0;244;6;0.0;0.0
13;2021-01-07;174;1;418;7;0.0;0.0
13;2021-01-08;189;0;607;7;0.0;0.0
13;2021-01-09;13;0;620;7;0.0;0.0
13;2021-01-10;3;0;623;7;0.0;0.0
13;2021-01-11;482;2;1105;9;0.1;0.0
13;2021-01-12;814;2;1919;11;0.1;0.0
13;2021-01-13;1087;2;3006;13;0.1;0.0
13;2021-01-14;1590;30;4596;43;0.2;0.0
13;2021-01-15;1539;9;6135;52;0.3;0.0
13;2021-01-16;406;3;6541;55;0.3;0.0
13;2021-01-17;44;0;6585;55;0.3;0.0
13;2021-01-18;2389;10;8974;65;0.4;0.0
13;2021-01-19;7423;54;16397;119;0.8;0.0
13;2021-01-20;5585;31;21982;150;1.1;0.0
13;2021-01-21;5366;39;27348;189;1.3;0.0
13;2021-01-22;4007;26;31355;215;1.5;0.0
13;2021-01-23;1358;8;32713;223;1.6;0.0
13;2021-01-24;491;6;33204;229;1.6;0.0
13;2021-01-25;2343;31;35547;260;1.7;0.0
13;2021-01-26;2951;92;38498;352;1.9;0.0
13;2021-01-27;3122;126;41620;478;2.0;0.0
13;2021-01-28;3252;198;44872;676;2.2;0.0
13;2021-01-29;2513;138;47385;814;2.3;0.0
13;2021-01-30;1024;12;48409;826;2.4;0.0
13;2021-01-31;252;2;48661;828;2.4;0.0
13;2021-02-01;1864;291;50525;1119;2.5;0.1
13;2021-02-02;2260;614;52785;1733;2.6;0.1
13;2021-02-03;1869;580;54654;2313;2.7;0.1
13;2021-02-04;1907;929;56561;3242;2.8;0.2
13;2021-02-05;2629;1556;59190;4798;2.9;0.2
13;2021-02-06;857;312;60047;5110;3.0;0.3
13;2021-02-07;279;6;60326;5116;3.0;0.3
13;2021-02-08;1906;1544;62232;6660;3.1;0.3
13;2021-02-09;3321;4465;65553;11125;3.2;0.5
13;2021-02-10;3260;3419;68813;14544;3.4;0.7
13;2021-02-11;3584;3597;72397;18141;3.6;0.9
13;2021-02-12;2841;3149;75238;21290;3.7;1.0
13;2021-02-13;735;597;75973;21887;3.7;1.1
13;2021-02-14;73;378;76046;22265;3.7;1.1
13;2021-02-15;972;2026;77018;24291;3.8;1.2
13;2021-02-16;1396;2629;78414;26920;3.9;1.3
13;2021-02-17;1350;3001;79764;29921;3.9;1.5
13;2021-02-18;1903;2687;81667;32608;4.0;1.6
13;2021-02-19;1517;2184;83184;34792;4.1;1.7
13;2021-02-20;458;783;83642;35575;4.1;1.7
13;2021-02-21;33;284;83675;35859;4.1;1.8
13;2021-02-22;1023;2262;84698;38121;4.2;1.9
13;2021-02-23;1290;2678;85988;40799;4.2;2.0
13;2021-02-24;1520;2624;87508;43423;4.3;2.1
13;2021-02-25;2384;2150;89892;45573;4.4;2.2
13;2021-02-26;2459;2131;92351;47704;4.5;2.3
13;2021-02-27;983;750;93334;48454;4.6;2.4
13;2021-02-28;194;208;93528;48662;4.6;2.4
13;2021-03-01;1929;1538;95457;50200;4.7;2.5
13;2021-03-02;3013;2643;98470;52843;4.8;2.6
13;2021-03-03;3491;2584;101961;55427;5.0;2.7
13;2021-03-04;4208;3154;106169;58581;5.2;2.9
13;2021-03-05;4043;2807;110212;61388;5.4;3.0
13;2021-03-06;5304;841;115516;62229;5.7;3.1
13;2021-03-07;4297;384;119813;62613;5.9;3.1
13;2021-03-08;3931;2013;123744;64626;6.1;3.2
13;2021-03-09;5083;2298;128827;66924;6.3;3.3
13;2021-03-10;5180;2005;134007;68929;6.6;3.4
13;2021-03-11;7314;2167;141321;71096;6.9;3.5
13;2021-03-12;8335;2138;149656;73234;7.4;3.6
13;2021-03-13;6379;750;156035;73984;7.7;3.6
13;2021-03-14;2313;174;158348;74158;7.8;3.6
13;2021-03-15;6358;1334;164706;75492;8.1;3.7
13;2021-03-16;5078;1562;169784;77054;8.3;3.8
13;2021-03-17;5175;1437;174959;78491;8.6;3.9
13;2021-03-18;5815;1900;180774;80391;8.9;4.0
13;2021-03-19;6816;1627;187590;82018;9.2;4.0
13;2021-03-20;4044;708;191634;82726;9.4;4.1
13;2021-03-21;727;89;192361;82815;9.5;4.1
13;2021-03-22;7296;1573;199657;84388;9.8;4.1
13;2021-03-23;9132;1779;208789;86167;10.3;4.2
13;2021-03-24;8869;2207;217658;88374;10.7;4.3
13;2021-03-25;10917;2136;228575;90510;11.2;4.4
13;2021-03-26;10715;1941;239290;92451;11.8;4.5
13;2021-03-27;4869;844;244159;93295;12.0;4.6
13;2021-03-28;1122;83;245281;93378;12.1;4.6
13;2021-03-29;7580;2023;252861;95401;12.4;4.7
13;2021-03-30;12615;2557;265476;97958;13.0;4.8
13;2021-03-31;10810;3206;276286;101164;13.6;5.0
13;2021-04-01;12277;3128;288563;104292;14.2;5.1
13;2021-04-02;9792;3917;298355;108209;14.7;5.3
13;2021-04-03;4007;2819;302362;111028;14.9;5.5
13;2021-04-04;631;307;302993;111335;14.9;5.5
13;2021-04-05;3537;734;306530;112069;15.1;5.5
13;2021-04-06;8520;4273;315050;116342;15.5;5.7
13;2021-04-07;10080;4712;325130;121054;16.0;6.0
13;2021-04-08;10117;5487;335247;126541;16.5;6.2
13;2021-04-09;11284;5146;346531;131687;17.0;6.5
13;2021-04-10;7302;2107;353833;133794;17.4;6.6
13;2021-04-11;1380;535;355213;134329;17.5;6.6
13;2021-04-12;7984;4826;363197;139155;17.9;6.8
13;2021-04-13;9145;5531;372342;144686;18.3;7.1
13;2021-04-14;9534;5836;381876;150522;18.8;7.4
13;2021-04-15;9878;5981;391754;156503;19.3;7.7
13;2021-04-16;9968;5586;401722;162089;19.7;8.0
13;2021-04-17;4080;2028;405802;164117;19.9;8.1
13;2021-04-18;2527;1426;408329;165543;20.1;8.1
13;2021-04-19;6457;6420;414786;171963;20.4;8.5
13;2021-04-20;7404;7615;422190;179578;20.8;8.8
13;2021-04-21;7771;7393;429961;186971;21.1;9.2
13;2021-04-22;8460;7943;438421;194914;21.5;9.6
13;2021-04-23;8395;6848;446816;201762;22.0;9.9
13;2021-04-24;4624;3820;451440;205582;22.2;10.1
13;2021-04-25;877;528;452317;206110;22.2;10.1
13;2021-04-26;6169;7122;458486;213232;22.5;10.5
13;2021-04-27;7263;8043;465749;221275;22.9;10.9
13;2021-04-28;9453;7735;475202;229010;23.4;11.3
13;2021-04-29;11408;7628;486610;236638;23.9;11.6
13;2021-04-30;10918;7388;497528;244026;24.5;12.0
13;2021-05-01;5365;3799;502893;247825;24.7;12.2
13;2021-05-02;2101;750;504994;248575;24.8;12.2
13;2021-05-03;7296;7876;512290;256451;25.2;12.6
13;2021-05-04;8455;8524;520745;264975;25.6;13.0
13;2021-05-05;8226;8980;528971;273955;26.0;13.5
13;2021-05-06;10143;8598;539114;282553;26.5;13.9
13;2021-05-07;8852;10047;547966;292600;26.9;14.4
13;2021-05-08;4569;3939;552535;296539;27.2;14.6
13;2021-05-09;939;688;553474;297227;27.2;14.6
13;2021-05-10;7710;8772;561184;305999;27.6;15.0
13;2021-05-11;10980;9584;572164;315583;28.1;15.5
13;2021-05-12;12841;8735;585005;324318;28.8;15.9
13;2021-05-13;9508;3643;594513;327961;29.2;16.1
13;2021-05-14;13658;6458;608171;334419;29.9;16.4
13;2021-05-15;10196;4540;618367;338959;30.4;16.7
13;2021-05-16;3130;796;621497;339755;30.5;16.7
13;2021-05-17;10843;6813;632340;346568;31.1;17.0
13;2021-05-18;11928;6486;644268;353054;31.7;17.4
13;2021-05-19;12158;6362;656426;359416;32.3;17.7
13;2021-05-20;13446;6474;669872;365890;32.9;18.0
13;2021-05-21;12992;6784;682864;372674;33.6;18.3
13;2021-05-22;7514;3639;690378;376313;33.9;18.5
13;2021-05-23;862;638;691240;376951;34.0;18.5
13;2021-05-24;6761;2469;698001;379420;34.3;18.6
13;2021-05-25;9269;7595;707270;387015;34.8;19.0
13;2021-05-26;10143;7838;717413;394853;35.3;19.4
13;2021-05-27;10340;8422;727753;403275;35.8;19.8
13;2021-05-28;9005;9176;736758;412451;36.2;20.3
13;2021-05-29;7173;4624;743931;417075;36.6;20.5
13;2021-05-30;891;527;744822;417602;36.6;20.5
13;2021-05-31;8184;8031;753006;425633;37.0;20.9
13;2021-06-01;9582;9302;762588;434935;37.5;21.4
13;2021-06-02;10082;8786;772670;443721;38.0;21.8
13;2021-06-03;12297;9501;784967;453222;38.6;22.3
13;2021-06-04;12025;10047;796992;463269;39.2;22.8
13;2021-06-05;7822;5597;804814;468866;39.6;23.0
13;2021-06-06;1671;887;806485;469753;39.6;23.1
13;2021-06-07;6686;9883;813171;479636;40.0;23.6
13;2021-06-08;8318;9995;821489;489631;40.4;24.1
13;2021-06-09;8398;9742;829887;499373;40.8;24.5
13;2021-06-10;8953;9787;838840;509160;41.2;25.0
13;2021-06-11;8230;12715;847070;521875;41.6;25.7
13;2021-06-12;5778;6704;852848;528579;41.9;26.0
13;2021-06-13;950;1216;853798;529795;42.0;26.0
13;2021-06-14;5995;11144;859793;540939;42.3;26.6
13;2021-06-15;7286;11407;867079;552346;42.6;27.1
13;2021-06-16;7340;9867;874419;562213;43.0;27.6
13;2021-06-17;7445;10717;881864;572930;43.3;28.2
13;2021-06-18;7550;11076;889414;584006;43.7;28.7
13;2021-06-19;4618;7501;894032;591507;43.9;29.1
13;2021-06-20;1876;1045;895908;592552;44.0;29.1
13;2021-06-21;4463;12263;900371;604815;44.3;29.7
13;2021-06-22;4942;13879;905313;618694;44.5;30.4
13;2021-06-23;5148;13578;910461;632272;44.8;31.1
13;2021-06-24;5341;12855;915802;645127;45.0;31.7
13;2021-06-25;5244;14683;921046;659810;45.3;32.4
13;2021-06-26;3016;9681;924062;669491;45.4;32.9
13;2021-06-27;537;931;924599;670422;45.4;33.0
13;2021-06-28;3730;12564;928329;682986;45.6;33.6
13;2021-06-29;4500;12905;932829;695891;45.9;34.2
13;2021-06-30;4905;12699;937734;708590;46.1;34.8
13;2021-07-01;5581;11501;943315;720091;46.4;35.4
13;2021-07-02;5572;12397;948887;732488;46.6;36.0
13;2021-07-03;3504;9161;952391;741649;46.8;36.5
13;2021-07-04;476;867;952867;742516;46.8;36.5
13;2021-07-05;3872;11779;956739;754295;47.0;37.1
13;2021-07-06;5462;11681;962201;765976;47.3;37.6
13;2021-07-07;5821;10707;968022;776683;47.6;38.2
13;2021-07-08;6230;10330;974252;787013;47.9;38.7
13;2021-07-09;5933;11937;980185;798950;48.2;39.3
13;2021-07-10;3163;8638;983348;807588;48.3;39.7
13;2021-07-11;500;1012;983848;808600;48.4;39.7
13;2021-07-12;4493;10951;988341;819551;48.6;40.3
13;2021-07-13;8980;13191;997321;832742;49.0;40.9
13;2021-07-14;5610;4874;1002931;837616;49.3;41.2
13;2021-07-15;11438;12949;1014369;850565;49.9;41.8
13;2021-07-16;12195;12940;1026564;863505;50.5;42.4
13;2021-07-17;6584;8495;1033148;872000;50.8;42.9
13;2021-07-18;727;1062;1033875;873062;50.8;42.9
13;2021-07-19;9809;11153;1043684;884215;51.3;43.5
13;2021-07-20;12271;11664;1055955;895879;51.9;44.0
13;2021-07-21;12690;10364;1068645;906243;52.5;44.5
13;2021-07-22;14555;10468;1083200;916711;53.2;45.1
13;2021-07-23;14486;10985;1097686;927696;54.0;45.6
13;2021-07-24;8342;7981;1106028;935677;54.4;46.0
13;2021-07-25;1017;785;1107045;936462;54.4;46.0
13;2021-07-26;11649;9124;1118694;945586;55.0;46.5
13;2021-07-27;13610;9427;1132304;955013;55.7;46.9
13;2021-07-28;12341;8193;1144645;963206;56.3;47.3
13;2021-07-29;13766;8101;1158411;971307;56.9;47.7
13;2021-07-30;13716;8647;1172127;979954;57.6;48.2
13;2021-07-31;8678;5846;1180805;985800;58.0;48.5
13;2021-08-01;1107;729;1181912;986529;58.1;48.5
13;2021-08-02;10057;6736;1191969;993265;58.6;48.8
13;2021-08-03;11073;7302;1203042;1000567;59.1;49.2
13;2021-08-04;9429;6577;1212471;1007144;59.6;49.5
13;2021-08-05;9530;7588;1222001;1014732;60.1;49.9
13;2021-08-06;9199;9007;1231200;1023739;60.5;50.3
13;2021-08-07;5442;5591;1236642;1029330;60.8;50.6
13;2021-08-08;905;807;1237547;1030137;60.8;50.6
13;2021-08-09;8397;9081;1245944;1039218;61.2;51.1
13;2021-08-10;9153;8916;1255097;1048134;61.7;51.5
13;2021-08-11;7911;8547;1263008;1056681;62.1;51.9
13;2021-08-12;7795;9674;1270803;1066355;62.5;52.4
13;2021-08-13;6961;9192;1277764;1075547;62.8;52.9
13;2021-08-14;3692;6457;1281456;1082004;63.0;53.2
13;2021-08-15;485;731;1281941;1082735;63.0;53.2
13;2021-08-16;6583;11083;1288524;1093818;63.3;53.8
13;2021-08-17;6674;10618;1295198;1104436;63.7;54.3
13;2021-08-18;6343;10182;1301541;1114618;64.0;54.8
13;2021-08-19;6674;10618;1308215;1125236;64.3;55.3
13;2021-08-20;5831;11237;1314046;1136473;64.6;55.9
13;2021-08-21;2618;7569;1316664;1144042;64.7;56.2
13;2021-08-22;369;1090;1317033;1145132;64.7;56.3
13;2021-08-23;4978;11223;1322011;1156355;65.0;56.8
13;2021-08-24;5448;10921;1327459;1167276;65.2;57.4
13;2021-08-25;5214;10101;1332673;1177377;65.5;57.9
13;2021-08-26;5135;9786;1337808;1187163;65.8;58.4
13;2021-08-27;5093;10638;1342901;1197801;66.0;58.9
13;2021-08-28;2362;6461;1345263;1204262;66.1;59.2
13;2021-08-29;338;1140;1345601;1205402;66.1;59.2
13;2021-08-30;4245;9728;1349846;1215130;66.3;59.7
13;2021-08-31;4871;9917;1354717;1225047;66.6;60.2
13;2021-09-01;4848;8267;1359565;1233314;66.8;60.6
13;2021-09-02;4778;8008;1364343;1241322;67.1;61.0
13;2021-09-03;4279;8654;1368622;1249976;67.3;61.4
13;2021-09-04;2173;5409;1370795;1255385;67.4;61.7
13;2021-09-05;185;348;1370980;1255733;67.4;61.7
13;2021-09-06;3143;6034;1374123;1261767;67.5;62.0
13;2021-09-07;3226;6247;1377349;1268014;67.7;62.3
13;2021-09-08;3521;6352;1380870;1274366;67.9;62.6
13;2021-09-09;3172;5729;1384042;1280095;68.0;62.9
13;2021-09-10;3676;6749;1387718;1286844;68.2;63.3
13;2021-09-11;2293;5145;1390011;1291989;68.3;63.5
13;2021-09-12;239;294;1390250;1292283;68.3;63.5
13;2021-09-13;2513;4265;1392763;1296548;68.5;63.7
13;2021-09-14;3223;4620;1395986;1301168;68.6;64.0
13;2021-09-15;2891;5524;1398877;1306692;68.8;64.2
13;2021-09-16;2226;3907;1401103;1310599;68.9;64.4
13;2021-09-17;2341;4875;1403444;1315474;69.0;64.7
13;2021-09-18;1532;4252;1404976;1319726;69.1;64.9
13;2021-09-19;125;176;1405101;1319902;69.1;64.9
13;2021-09-20;1548;3310;1406649;1323212;69.1;65.0
13;2021-09-21;1478;2929;1408127;1326141;69.2;65.2
13;2021-09-22;1699;4543;1409826;1330684;69.3;65.4
13;2021-09-23;1649;3541;1411475;1334225;69.4;65.6
13;2021-09-24;1625;4276;1413100;1338501;69.5;65.8
13;2021-09-25;1238;3967;1414338;1342468;69.5;66.0
13;2021-09-26;87;258;1414425;1342726;69.5;66.0
13;2021-09-27;1256;3163;1415681;1345889;69.6;66.2
13;2021-09-28;1331;2641;1417012;1348530;69.7;66.3
13;2021-09-29;1610;3559;1418622;1352089;69.7;66.5
13;2021-09-30;1363;3203;1419985;1355292;69.8;66.6
13;2021-10-01;1567;3572;1421552;1358864;69.9;66.8
13;2021-10-02;1176;2816;1422728;1361680;69.9;66.9
13;2021-10-03;101;418;1422829;1362098;69.9;67.0
13;2021-10-04;623;1594;1423452;1363692;70.0;67.0
13;2021-10-05;1136;2465;1424588;1366157;70.0;67.2
13;2021-10-06;1263;3151;1425851;1369308;70.1;67.3
13;2021-10-07;1027;2498;1426878;1371806;70.1;67.4
13;2021-10-08;1375;3268;1428253;1375074;70.2;67.6
13;2021-10-09;917;2326;1429170;1377400;70.2;67.7
13;2021-10-10;81;120;1429251;1377520;70.3;67.7
13;2021-10-11;930;1716;1430181;1379236;70.3;67.8
13;2021-10-12;1140;1788;1431321;1381024;70.4;67.9
13;2021-10-13;1206;2149;1432527;1383173;70.4;68.0
13;2021-10-14;1014;1785;1433541;1384958;70.5;68.1
13;2021-10-15;1395;2271;1434936;1387229;70.5;68.2
13;2021-10-16;915;1532;1435851;1388761;70.6;68.3
13;2021-10-17;72;104;1435923;1388865;70.6;68.3
13;2021-10-18;928;1383;1436851;1390248;70.6;68.3
13;2021-10-19;949;1462;1437800;1391710;70.7;68.4
14;2020-12-27;0;0;0;0;0.0;0.0
14;2020-12-28;1;1;1;1;0.0;0.0
14;2020-12-29;1;0;2;1;0.0;0.0
14;2020-12-30;0;0;2;1;0.0;0.0
14;2020-12-31;3;0;5;1;0.0;0.0
14;2021-01-01;2;0;7;1;0.0;0.0
14;2021-01-02;1;0;8;1;0.0;0.0
14;2021-01-03;0;0;8;1;0.0;0.0
14;2021-01-04;10;0;18;1;0.0;0.0
14;2021-01-05;24;0;42;1;0.0;0.0
14;2021-01-06;352;0;394;1;0.1;0.0
14;2021-01-07;402;2;796;3;0.1;0.0
14;2021-01-08;630;5;1426;8;0.2;0.0
14;2021-01-09;127;0;1553;8;0.2;0.0
14;2021-01-10;41;0;1594;8;0.2;0.0
14;2021-01-11;674;5;2268;13;0.3;0.0
14;2021-01-12;954;7;3222;20;0.5;0.0
14;2021-01-13;850;1;4072;21;0.6;0.0
14;2021-01-14;2841;28;6913;49;1.0;0.0
14;2021-01-15;1899;22;8812;71;1.3;0.0
14;2021-01-16;271;3;9083;74;1.3;0.0
14;2021-01-17;145;7;9228;81;1.3;0.0
14;2021-01-18;1087;6;10315;87;1.5;0.0
14;2021-01-19;1155;3;11470;90;1.7;0.0
14;2021-01-20;1987;5;13457;95;1.9;0.0
14;2021-01-21;1817;7;15274;102;2.2;0.0
14;2021-01-22;1494;6;16768;108;2.4;0.0
14;2021-01-23;297;1;17065;109;2.5;0.0
14;2021-01-24;73;1;17138;110;2.5;0.0
14;2021-01-25;911;10;18049;120;2.6;0.0
14;2021-01-26;848;37;18897;157;2.7;0.0
14;2021-01-27;884;160;19781;317;2.9;0.0
14;2021-01-28;782;145;20563;462;3.0;0.1
14;2021-01-29;786;229;21349;691;3.1;0.1
14;2021-01-30;270;12;21619;703;3.1;0.1
14;2021-01-31;58;3;21677;706;3.1;0.1
14;2021-02-01;729;226;22406;932;3.2;0.1
14;2021-02-02;830;420;23236;1352;3.4;0.2
14;2021-02-03;761;388;23997;1740;3.5;0.3
14;2021-02-04;1170;2056;25167;3796;3.6;0.5
14;2021-02-05;1296;1315;26463;5111;3.8;0.7
14;2021-02-06;398;237;26861;5348;3.9;0.8
14;2021-02-07;180;72;27041;5420;3.9;0.8
14;2021-02-08;773;822;27814;6242;4.0;0.9
14;2021-02-09;723;1009;28537;7251;4.1;1.0
14;2021-02-10;825;1607;29362;8858;4.2;1.3
14;2021-02-11;1350;1430;30712;10288;4.4;1.5
14;2021-02-12;1383;1080;32095;11368;4.6;1.6
14;2021-02-13;308;186;32403;11554;4.7;1.7
14;2021-02-14;84;64;32487;11618;4.7;1.7
14;2021-02-15;443;1077;32930;12695;4.8;1.8
14;2021-02-16;679;976;33609;13671;4.9;2.0
14;2021-02-17;405;978;34014;14649;4.9;2.1
14;2021-02-18;707;884;34721;15533;5.0;2.2
14;2021-02-19;734;777;35455;16310;5.1;2.4
14;2021-02-20;91;268;35546;16578;5.1;2.4
14;2021-02-21;6;90;35552;16668;5.1;2.4
14;2021-02-22;432;1040;35984;17708;5.2;2.6
14;2021-02-23;487;920;36471;18628;5.3;2.7
14;2021-02-24;441;890;36912;19518;5.3;2.8
14;2021-02-25;1224;1177;38136;20695;5.5;3.0
14;2021-02-26;1576;1161;39712;21856;5.7;3.2
14;2021-02-27;507;269;40219;22125;5.8;3.2
14;2021-02-28;27;41;40246;22166;5.8;3.2
14;2021-03-01;522;929;40768;23095;5.9;3.3
14;2021-03-02;966;807;41734;23902;6.0;3.5
14;2021-03-03;1080;841;42814;24743;6.2;3.6
14;2021-03-04;1950;794;44764;25537;6.5;3.7
14;2021-03-05;2433;881;47197;26418;6.8;3.8
14;2021-03-06;3078;210;50275;26628;7.3;3.9
14;2021-03-07;1196;64;51471;26692;7.4;3.9
14;2021-03-08;1254;816;52725;27508;7.6;4.0
14;2021-03-09;1741;701;54466;28209;7.9;4.1
14;2021-03-10;1835;594;56301;28803;8.1;4.2
14;2021-03-11;2760;480;59061;29283;8.5;4.2
14;2021-03-12;4047;583;63108;29866;9.1;4.3
14;2021-03-13;1854;179;64962;30045;9.4;4.3
14;2021-03-14;31;39;64993;30084;9.4;4.4
14;2021-03-15;2006;143;66999;30227;9.7;4.4
14;2021-03-16;1401;279;68400;30506;9.9;4.4
14;2021-03-17;1155;197;69555;30703;10.1;4.4
14;2021-03-18;1482;304;71037;31007;10.3;4.5
14;2021-03-19;2608;272;73645;31279;10.7;4.5
14;2021-03-20;2659;43;76304;31322;11.0;4.5
14;2021-03-21;455;9;76759;31331;11.1;4.5
14;2021-03-22;1872;363;78631;31694;11.4;4.6
14;2021-03-23;2179;327;80810;32021;11.7;4.6
14;2021-03-24;2432;195;83242;32216;12.0;4.7
14;2021-03-25;3292;327;86534;32543;12.5;4.7
14;2021-03-26;4609;485;91143;33028;13.2;4.8
14;2021-03-27;2230;234;93373;33262;13.5;4.8
14;2021-03-28;36;1;93409;33263;13.5;4.8
14;2021-03-29;1614;487;95023;33750;13.7;4.9
14;2021-03-30;2722;518;97745;34268;14.1;5.0
14;2021-03-31;2326;930;100071;35198;14.5;5.1
14;2021-04-01;4177;1688;104248;36886;15.1;5.3
14;2021-04-02;3867;1276;108115;38162;15.6;5.5
14;2021-04-03;1126;1206;109241;39368;15.8;5.7
14;2021-04-04;25;483;109266;39851;15.8;5.8
14;2021-04-05;1218;325;110484;40176;16.0;5.8
14;2021-04-06;2383;1000;112867;41176;16.3;6.0
14;2021-04-07;2731;1037;115598;42213;16.7;6.1
14;2021-04-08;4303;1125;119901;43338;17.3;6.3
14;2021-04-09;6031;1193;125932;44531;18.2;6.4
14;2021-04-10;2896;444;128828;44975;18.6;6.5
14;2021-04-11;629;125;129457;45100;18.7;6.5
14;2021-04-12;2915;1589;132372;46689;19.1;6.8
14;2021-04-13;3471;1450;135843;48139;19.6;7.0
14;2021-04-14;3123;1175;138966;49314;20.1;7.1
14;2021-04-15;4398;1520;143364;50834;20.7;7.4
14;2021-04-16;4598;1570;147962;52404;21.4;7.6
14;2021-04-17;2312;1666;150274;54070;21.7;7.8
14;2021-04-18;538;328;150812;54398;21.8;7.9
14;2021-04-19;2760;1706;153572;56104;22.2;8.1
14;2021-04-20;3390;1836;156962;57940;22.7;8.4
14;2021-04-21;3016;1477;159978;59417;23.1;8.6
14;2021-04-22;4230;2095;164208;61512;23.7;8.9
14;2021-04-23;4651;2316;168859;63828;24.4;9.2
14;2021-04-24;1851;1757;170710;65585;24.7;9.5
14;2021-04-25;456;28;171166;65613;24.8;9.5
14;2021-04-26;3379;1572;174545;67185;25.2;9.7
14;2021-04-27;3502;2579;178047;69764;25.7;10.1
14;2021-04-28;3245;1899;181292;71663;26.2;10.4
14;2021-04-29;4544;2316;185836;73979;26.9;10.7
14;2021-04-30;5124;2653;190960;76632;27.6;11.1
14;2021-05-01;3554;204;194514;76836;28.1;11.1
14;2021-05-02;1238;56;195752;76892;28.3;11.1
14;2021-05-03;2482;2770;198234;79662;28.7;11.5
14;2021-05-04;3128;2913;201362;82575;29.1;11.9
14;2021-05-05;3687;2760;205049;85335;29.7;12.3
14;2021-05-06;4929;3491;209978;88826;30.4;12.8
14;2021-05-07;4870;3854;214848;92680;31.1;13.4
14;2021-05-08;2728;1265;217576;93945;31.5;13.6
14;2021-05-09;1914;671;219490;94616;31.7;13.7
14;2021-05-10;3637;3152;223127;97768;32.3;14.1
14;2021-05-11;4346;3609;227473;101377;32.9;14.7
14;2021-05-12;4053;3223;231526;104600;33.5;15.1
14;2021-05-13;4688;1132;236214;105732;34.2;15.3
14;2021-05-14;6674;2629;242888;108361;35.1;15.7
14;2021-05-15;5148;778;248036;109139;35.9;15.8
14;2021-05-16;2320;120;250356;109259;36.2;15.8
14;2021-05-17;2820;2261;253176;111520;36.6;16.1
14;2021-05-18;4089;2244;257265;113764;37.2;16.5
14;2021-05-19;3753;2021;261018;115785;37.7;16.7
14;2021-05-20;4482;2768;265500;118553;38.4;17.1
14;2021-05-21;4276;3528;269776;122081;39.0;17.7
14;2021-05-22;1669;866;271445;122947;39.3;17.8
14;2021-05-23;649;71;272094;123018;39.4;17.8
14;2021-05-24;2845;751;274939;123769;39.8;17.9
14;2021-05-25;3635;3387;278574;127156;40.3;18.4
14;2021-05-26;3438;2407;282012;129563;40.8;18.7
14;2021-05-27;4771;3241;286783;132804;41.5;19.2
14;2021-05-28;5090;3893;291873;136697;42.2;19.8
14;2021-05-29;2343;2459;294216;139156;42.6;20.1
14;2021-05-30;759;237;294975;139393;42.7;20.2
14;2021-05-31;4088;2967;299063;142360;43.3;20.6
14;2021-06-01;5741;3219;304804;145579;44.1;21.1
14;2021-06-02;5024;2862;309828;148441;44.8;21.5
14;2021-06-03;6657;4019;316485;152460;45.8;22.0
14;2021-06-04;6444;5142;322929;157602;46.7;22.8
14;2021-06-05;4359;1866;327288;159468;47.3;23.1
14;2021-06-06;2043;83;329331;159551;47.6;23.1
14;2021-06-07;4253;3452;333584;163003;48.2;23.6
14;2021-06-08;5234;3132;338818;166135;49.0;24.0
14;2021-06-09;4270;2968;343088;169103;49.6;24.5
14;2021-06-10;5080;2973;348168;172076;50.4;24.9
14;2021-06-11;4840;4887;353008;176963;51.1;25.6
14;2021-06-12;3677;4520;356685;181483;51.6;26.2
14;2021-06-13;848;1089;357533;182572;51.7;26.4
14;2021-06-14;2185;3793;359718;186365;52.0;27.0
14;2021-06-15;3315;3970;363033;190335;52.5;27.5
14;2021-06-16;3445;4556;366478;194891;53.0;28.2
14;2021-06-17;4230;5269;370708;200160;53.6;28.9
14;2021-06-18;3732;6121;374440;206281;54.2;29.8
14;2021-06-19;2591;2951;377031;209232;54.5;30.3
14;2021-06-20;581;1556;377612;210788;54.6;30.5
14;2021-06-21;2121;4359;379733;215147;54.9;31.1
14;2021-06-22;2582;5180;382315;220327;55.3;31.9
14;2021-06-23;2504;4348;384819;224675;55.7;32.5
14;2021-06-24;3450;5811;388269;230486;56.2;33.3
14;2021-06-25;2752;7277;391021;237763;56.6;34.4
14;2021-06-26;2177;4539;393198;242302;56.9;35.0
14;2021-06-27;440;1829;393638;244131;56.9;35.3
14;2021-06-28;1311;3970;394949;248101;57.1;35.9
14;2021-06-29;1789;5365;396738;253466;57.4;36.7
14;2021-06-30;2024;4618;398762;258084;57.7;37.3
14;2021-07-01;2931;5072;401693;263156;58.1;38.1
14;2021-07-02;2600;6669;404293;269825;58.5;39.0
14;2021-07-03;1430;2647;405723;272472;58.7;39.4
14;2021-07-04;422;713;406145;273185;58.7;39.5
14;2021-07-05;1191;4777;407336;277962;58.9;40.2
14;2021-07-06;2090;6002;409426;283964;59.2;41.1
14;2021-07-07;2257;4578;411683;288542;59.5;41.7
14;2021-07-08;2912;5527;414595;294069;60.0;42.5
14;2021-07-09;2771;6433;417366;300502;60.4;43.5
14;2021-07-10;2037;3203;419403;303705;60.7;43.9
14;2021-07-11;900;871;420303;304576;60.8;44.0
14;2021-07-12;1634;5904;421937;310480;61.0;44.9
14;2021-07-13;3081;7340;425018;317820;61.5;46.0
14;2021-07-14;2260;3065;427278;320885;61.8;46.4
14;2021-07-15;4172;7655;431450;328540;62.4;47.5
14;2021-07-16;4710;7698;436160;336238;63.1;48.6
14;2021-07-17;2114;4214;438274;340452;63.4;49.2
14;2021-07-18;821;1870;439095;342322;63.5;49.5
14;2021-07-19;2599;6128;441694;348450;63.9;50.4
14;2021-07-20;3247;7258;444941;355708;64.3;51.4
14;2021-07-21;4106;5847;449047;361555;64.9;52.3
14;2021-07-22;4852;6604;453899;368159;65.6;53.2
14;2021-07-23;5384;6772;459283;374931;66.4;54.2
14;2021-07-24;3084;3795;462367;378726;66.9;54.8
14;2021-07-25;1504;1249;463871;379975;67.1;55.0
14;2021-07-26;4682;4186;468553;384161;67.8;55.6
14;2021-07-27;5404;4364;473957;388525;68.5;56.2
14;2021-07-28;5117;3976;479074;392501;69.3;56.8
14;2021-07-29;6446;4889;485520;397390;70.2;57.5
14;2021-07-30;5843;5172;491363;402562;71.1;58.2
14;2021-07-31;2774;2513;494137;405075;71.5;58.6
14;2021-08-01;1895;934;496032;406009;71.7;58.7
14;2021-08-02;3948;4293;499980;410302;72.3;59.3
14;2021-08-03;4482;4173;504462;414475;73.0;59.9
14;2021-08-04;4650;3538;509112;418013;73.6;60.5
14;2021-08-05;4659;4040;513771;422053;74.3;61.0
14;2021-08-06;4431;4808;518202;426861;74.9;61.7
14;2021-08-07;2133;2295;520335;429156;75.3;62.1
14;2021-08-08;638;854;520973;430010;75.3;62.2
14;2021-08-09;2129;2877;523102;432887;75.7;62.6
14;2021-08-10;3663;4171;526765;437058;76.2;63.2
14;2021-08-11;3076;3456;529841;440514;76.6;63.7
14;2021-08-12;3482;4351;533323;444865;77.1;64.3
14;2021-08-13;2638;4140;535961;449005;77.5;64.9
14;2021-08-14;1423;2010;537384;451015;77.7;65.2
14;2021-08-15;389;1485;537773;452500;77.8;65.4
14;2021-08-16;1833;2785;539606;455285;78.0;65.8
14;2021-08-17;2263;4570;541869;459855;78.4;66.5
14;2021-08-18;2064;4528;543933;464383;78.7;67.2
14;2021-08-19;2336;5086;546269;469469;79.0;67.9
14;2021-08-20;2189;5403;548458;474872;79.3;68.7
14;2021-08-21;1016;2838;549474;477710;79.5;69.1
14;2021-08-22;170;1564;549644;479274;79.5;69.3
14;2021-08-23;1270;4170;550914;483444;79.7;69.9
14;2021-08-24;1348;4302;552262;487746;79.9;70.5
14;2021-08-25;1400;4399;553662;492145;80.1;71.2
14;2021-08-26;1433;5081;555095;497226;80.3;71.9
14;2021-08-27;1467;5289;556562;502515;80.5;72.7
14;2021-08-28;737;3005;557299;505520;80.6;73.1
14;2021-08-29;187;1015;557486;506535;80.6;73.3
14;2021-08-30;1016;3547;558502;510082;80.8;73.8
14;2021-08-31;1330;4642;559832;514724;81.0;74.4
14;2021-09-01;1069;3627;560901;518351;81.1;75.0
14;2021-09-02;865;3039;561766;521390;81.2;75.4
14;2021-09-03;1185;3862;562951;525252;81.4;76.0
14;2021-09-04;665;2225;563616;527477;81.5;76.3
14;2021-09-05;127;372;563743;527849;81.5;76.3
14;2021-09-06;468;1853;564211;529702;81.6;76.6
14;2021-09-07;499;1860;564710;531562;81.7;76.9
14;2021-09-08;682;2706;565392;534268;81.8;77.3
14;2021-09-09;595;1777;565987;536045;81.9;77.5
14;2021-09-10;772;2362;566759;538407;82.0;77.9
14;2021-09-11;522;1486;567281;539893;82.0;78.1
14;2021-09-12;67;240;567348;540133;82.1;78.1
14;2021-09-13;311;1154;567659;541287;82.1;78.3
14;2021-09-14;659;1263;568318;542550;82.2;78.5
14;2021-09-15;716;1997;569034;544547;82.3;78.8
14;2021-09-16;593;1340;569627;545887;82.4;78.9
14;2021-09-17;634;1454;570261;547341;82.5;79.2
14;2021-09-18;218;971;570479;548312;82.5;79.3
14;2021-09-19;40;137;570519;548449;82.5;79.3
14;2021-09-20;333;811;570852;549260;82.6;79.4
14;2021-09-21;546;846;571398;550106;82.6;79.6
14;2021-09-22;491;1753;571889;551859;82.7;79.8
14;2021-09-23;449;784;572338;552643;82.8;79.9
14;2021-09-24;406;1311;572744;553954;82.8;80.1
14;2021-09-25;194;690;572938;554644;82.9;80.2
14;2021-09-26;41;140;572979;554784;82.9;80.2
14;2021-09-27;277;710;573256;555494;82.9;80.3
14;2021-09-28;359;675;573615;556169;83.0;80.4
14;2021-09-29;307;920;573922;557089;83.0;80.6
14;2021-09-30;340;687;574262;557776;83.1;80.7
14;2021-10-01;451;831;574713;558607;83.1;80.8
14;2021-10-02;247;514;574960;559121;83.2;80.9
14;2021-10-03;37;61;574997;559182;83.2;80.9
14;2021-10-04;281;502;575278;559684;83.2;80.9
14;2021-10-05;272;447;575550;560131;83.2;81.0
14;2021-10-06;388;795;575938;560926;83.3;81.1
14;2021-10-07;224;408;576162;561334;83.3;81.2
14;2021-10-08;426;836;576588;562170;83.4;81.3
14;2021-10-09;186;339;576774;562509;83.4;81.4
14;2021-10-10;3;2;576777;562511;83.4;81.4
14;2021-10-11;180;463;576957;562974;83.4;81.4
14;2021-10-12;302;592;577259;563566;83.5;81.5
14;2021-10-13;353;517;577612;564083;83.5;81.6
14;2021-10-14;217;440;577829;564523;83.6;81.6
14;2021-10-15;507;634;578336;565157;83.6;81.7
14;2021-10-16;194;262;578530;565419;83.7;81.8
14;2021-10-17;3;7;578533;565426;83.7;81.8
14;2021-10-18;192;328;578725;565754;83.7;81.8
14;2021-10-19;215;421;578940;566175;83.7;81.9
15;2020-12-27;2;0;2;0;0.0;0.0
15;2020-12-28;0;0;2;0;0.0;0.0
15;2020-12-29;0;0;2;0;0.0;0.0
15;2020-12-30;0;0;2;0;0.0;0.0
15;2020-12-31;0;0;2;0;0.0;0.0
15;2021-01-01;1;0;3;0;0.0;0.0
15;2021-01-02;0;0;3;0;0.0;0.0
15;2021-01-03;0;0;3;0;0.0;0.0
15;2021-01-04;0;0;3;0;0.0;0.0
15;2021-01-05;0;0;3;0;0.0;0.0
15;2021-01-06;0;0;3;0;0.0;0.0
15;2021-01-07;72;0;75;0;0.1;0.0
15;2021-01-08;109;2;184;2;0.1;0.0
15;2021-01-09;0;0;184;2;0.1;0.0
15;2021-01-10;3;0;187;2;0.1;0.0
15;2021-01-11;99;1;286;3;0.2;0.0
15;2021-01-12;94;0;380;3;0.3;0.0
15;2021-01-13;230;0;610;3;0.4;0.0
15;2021-01-14;313;5;923;8;0.6;0.0
15;2021-01-15;138;0;1061;8;0.7;0.0
15;2021-01-16;90;0;1151;8;0.8;0.0
15;2021-01-17;0;0;1151;8;0.8;0.0
15;2021-01-18;404;2;1555;10;1.1;0.0
15;2021-01-19;550;0;2105;10;1.5;0.0
15;2021-01-20;629;2;2734;12;1.9;0.0
15;2021-01-21;576;4;3310;16;2.3;0.0
15;2021-01-22;503;3;3813;19;2.7;0.0
15;2021-01-23;432;1;4245;20;3.0;0.0
15;2021-01-24;6;0;4251;20;3.0;0.0
15;2021-01-25;401;0;4652;20;3.3;0.0
15;2021-01-26;436;0;5088;20;3.6;0.0
15;2021-01-27;735;7;5823;27;4.1;0.0
15;2021-01-28;624;52;6447;79;4.5;0.1
15;2021-01-29;336;82;6783;161;4.7;0.1
15;2021-01-30;218;3;7001;164;4.9;0.1
15;2021-01-31;1;1;7002;165;4.9;0.1
15;2021-02-01;239;95;7241;260;5.1;0.2
15;2021-02-02;189;89;7430;349;5.2;0.2
15;2021-02-03;267;159;7697;508;5.4;0.4
15;2021-02-04;663;204;8360;712;5.9;0.5
15;2021-02-05;296;256;8656;968;6.1;0.7
15;2021-02-06;98;77;8754;1045;6.1;0.7
15;2021-02-07;0;0;8754;1045;6.1;0.7
15;2021-02-08;233;108;8987;1153;6.3;0.8
15;2021-02-09;206;119;9193;1272;6.4;0.9
15;2021-02-10;338;301;9531;1573;6.7;1.1
15;2021-02-11;118;239;9649;1812;6.8;1.3
15;2021-02-12;136;159;9785;1971;6.9;1.4
15;2021-02-13;92;77;9877;2048;6.9;1.4
15;2021-02-14;0;0;9877;2048;6.9;1.4
15;2021-02-15;64;215;9941;2263;7.0;1.6
15;2021-02-16;52;294;9993;2557;7.0;1.8
15;2021-02-17;134;473;10127;3030;7.1;2.1
15;2021-02-18;87;754;10214;3784;7.2;2.6
15;2021-02-19;90;429;10304;4213;7.2;3.0
15;2021-02-20;20;258;10324;4471;7.2;3.1
15;2021-02-21;0;0;10324;4471;7.2;3.1
15;2021-02-22;23;496;10347;4967;7.2;3.5
15;2021-02-23;180;457;10527;5424;7.4;3.8
15;2021-02-24;31;456;10558;5880;7.4;4.1
15;2021-02-25;228;1001;10786;6881;7.6;4.8
15;2021-02-26;186;475;10972;7356;7.7;5.2
15;2021-02-27;145;89;11117;7445;7.8;5.2
15;2021-02-28;1;0;11118;7445;7.8;5.2
15;2021-03-01;121;223;11239;7668;7.9;5.4
15;2021-03-02;251;307;11490;7975;8.0;5.6
15;2021-03-03;207;29;11697;8004;8.2;5.6
15;2021-03-04;246;248;11943;8252;8.4;5.8
15;2021-03-05;348;175;12291;8427;8.6;5.9
15;2021-03-06;680;11;12971;8438;9.1;5.9
15;2021-03-07;81;2;13052;8440;9.1;5.9
15;2021-03-08;93;107;13145;8547;9.2;6.0
15;2021-03-09;281;294;13426;8841;9.4;6.2
15;2021-03-10;417;180;13843;9021;9.7;6.3
15;2021-03-11;434;296;14277;9317;10.0;6.5
15;2021-03-12;525;96;14802;9413;10.4;6.6
15;2021-03-13;355;7;15157;9420;10.6;6.6
15;2021-03-14;18;0;15175;9420;10.6;6.6
15;2021-03-15;542;65;15717;9485;11.0;6.6
15;2021-03-16;328;22;16045;9507;11.2;6.7
15;2021-03-17;130;53;16175;9560;11.3;6.7
15;2021-03-18;250;96;16425;9656;11.5;6.8
15;2021-03-19;669;34;17094;9690;12.0;6.8
15;2021-03-20;148;38;17242;9728;12.1;6.8
15;2021-03-21;6;0;17248;9728;12.1;6.8
15;2021-03-22;574;82;17822;9810;12.5;6.9
15;2021-03-23;776;102;18598;9912;13.0;6.9
15;2021-03-24;936;36;19534;9948;13.7;7.0
15;2021-03-25;1282;33;20816;9981;14.6;7.0
15;2021-03-26;1010;63;21826;10044;15.3;7.0
15;2021-03-27;301;7;22127;10051;15.5;7.0
15;2021-03-28;20;0;22147;10051;15.5;7.0
15;2021-03-29;782;19;22929;10070;16.1;7.1
15;2021-03-30;1135;205;24064;10275;16.9;7.2
15;2021-03-31;941;28;25005;10303;17.5;7.2
15;2021-04-01;1233;65;26238;10368;18.4;7.3
15;2021-04-02;1141;62;27379;10430;19.2;7.3
15;2021-04-03;120;18;27499;10448;19.3;7.3
15;2021-04-04;0;0;27499;10448;19.3;7.3
15;2021-04-05;33;3;27532;10451;19.3;7.3
15;2021-04-06;834;87;28366;10538;19.9;7.4
15;2021-04-07;663;108;29029;10646;20.3;7.5
15;2021-04-08;1246;151;30275;10797;21.2;7.6
15;2021-04-09;1277;106;31552;10903;22.1;7.6
15;2021-04-10;364;21;31916;10924;22.3;7.6
15;2021-04-11;14;0;31930;10924;22.4;7.6
15;2021-04-12;644;461;32574;11385;22.8;8.0
15;2021-04-13;1124;324;33698;11709;23.6;8.2
15;2021-04-14;1038;199;34736;11908;24.3;8.3
15;2021-04-15;1183;314;35919;12222;25.2;8.6
15;2021-04-16;1038;555;36957;12777;25.9;8.9
15;2021-04-17;445;15;37402;12792;26.2;9.0
15;2021-04-18;0;10;37402;12802;26.2;9.0
15;2021-04-19;537;514;37939;13316;26.6;9.3
15;2021-04-20;847;616;38786;13932;27.2;9.8
15;2021-04-21;591;651;39377;14583;27.6;10.2
15;2021-04-22;728;777;40105;15360;28.1;10.8
15;2021-04-23;730;681;40835;16041;28.6;11.2
15;2021-04-24;363;123;41198;16164;28.8;11.3
15;2021-04-25;1;3;41199;16167;28.8;11.3
15;2021-04-26;325;632;41524;16799;29.1;11.8
15;2021-04-27;467;941;41991;17740;29.4;12.4
15;2021-04-28;383;789;42374;18529;29.7;13.0
15;2021-04-29;587;1014;42961;19543;30.1;13.7
15;2021-04-30;547;1077;43508;20620;30.5;14.4
15;2021-05-01;283;29;43791;20649;30.7;14.5
15;2021-05-02;0;0;43791;20649;30.7;14.5
15;2021-05-03;881;331;44672;20980;31.3;14.7
15;2021-05-04;801;857;45473;21837;31.8;15.3
15;2021-05-05;676;680;46149;22517;32.3;15.8
15;2021-05-06;826;967;46975;23484;32.9;16.4
15;2021-05-07;1154;906;48129;24390;33.7;17.1
15;2021-05-08;491;55;48620;24445;34.0;17.1
15;2021-05-09;24;9;48644;24454;34.1;17.1
15;2021-05-10;704;913;49348;25367;34.6;17.8
15;2021-05-11;1186;1186;50534;26553;35.4;18.6
15;2021-05-12;1147;837;51681;27390;36.2;19.2
15;2021-05-13;1165;440;52846;27830;37.0;19.5
15;2021-05-14;1503;583;54349;28413;38.1;19.9
15;2021-05-15;1410;418;55759;28831;39.0;20.2
15;2021-05-16;1;10;55760;28841;39.0;20.2
15;2021-05-17;999;605;56759;29446;39.7;20.6
15;2021-05-18;1221;970;57980;30416;40.6;21.3
15;2021-05-19;1020;459;59000;30875;41.3;21.6
15;2021-05-20;1239;782;60239;31657;42.2;22.2
15;2021-05-21;1348;749;61587;32406;43.1;22.7
15;2021-05-22;527;188;62114;32594;43.5;22.8
15;2021-05-23;2;11;62116;32605;43.5;22.8
15;2021-05-24;693;257;62809;32862;44.0;23.0
15;2021-05-25;1151;620;63960;33482;44.8;23.4
15;2021-05-26;1093;459;65053;33941;45.6;23.8
15;2021-05-27;1271;660;66324;34601;46.4;24.2
15;2021-05-28;1509;887;67833;35488;47.5;24.8
15;2021-05-29;984;361;68817;35849;48.2;25.1
15;2021-05-30;14;25;68831;35874;48.2;25.1
15;2021-05-31;1199;480;70030;36354;49.0;25.5
15;2021-06-01;1398;570;71428;36924;50.0;25.9
15;2021-06-02;863;418;72291;37342;50.6;26.1
15;2021-06-03;932;704;73223;38046;51.3;26.6
15;2021-06-04;1076;719;74299;38765;52.0;27.1
15;2021-06-05;651;264;74950;39029;52.5;27.3
15;2021-06-06;16;20;74966;39049;52.5;27.3
15;2021-06-07;797;351;75763;39400;53.1;27.6
15;2021-06-08;477;397;76240;39797;53.4;27.9
15;2021-06-09;376;377;76616;40174;53.6;28.1
15;2021-06-10;276;423;76892;40597;53.8;28.4
15;2021-06-11;660;1100;77552;41697;54.3;29.2
15;2021-06-12;377;467;77929;42164;54.6;29.5
15;2021-06-13;11;6;77940;42170;54.6;29.5
15;2021-06-14;542;977;78482;43147;55.0;30.2
15;2021-06-15;450;1164;78932;44311;55.3;31.0
15;2021-06-16;543;899;79475;45210;55.7;31.7
15;2021-06-17;292;934;79767;46144;55.9;32.3
15;2021-06-18;740;1205;80507;47349;56.4;33.2
15;2021-06-19;542;704;81049;48053;56.8;33.6
15;2021-06-20;11;1;81060;48054;56.8;33.6
15;2021-06-21;279;1042;81339;49096;57.0;34.4
15;2021-06-22;232;1480;81571;50576;57.1;35.4
15;2021-06-23;346;1445;81917;52021;57.4;36.4
15;2021-06-24;291;1094;82208;53115;57.6;37.2
15;2021-06-25;378;1641;82586;54756;57.8;38.3
15;2021-06-26;164;908;82750;55664;57.9;39.0
15;2021-06-27;0;0;82750;55664;57.9;39.0
15;2021-06-28;176;1228;82926;56892;58.1;39.8
15;2021-06-29;302;1264;83228;58156;58.3;40.7
15;2021-06-30;268;982;83496;59138;58.5;41.4
15;2021-07-01;380;1220;83876;60358;58.7;42.3
15;2021-07-02;410;1348;84286;61706;59.0;43.2
15;2021-07-03;252;707;84538;62413;59.2;43.7
15;2021-07-04;1;1;84539;62414;59.2;43.7
15;2021-07-05;248;1257;84787;63671;59.4;44.6
15;2021-07-06;275;1469;85062;65140;59.6;45.6
15;2021-07-07;255;1344;85317;66484;59.7;46.6
15;2021-07-08;489;1353;85806;67837;60.1;47.5
15;2021-07-09;488;1784;86294;69621;60.4;48.8
15;2021-07-10;215;862;86509;70483;60.6;49.4
15;2021-07-11;9;5;86518;70488;60.6;49.4
15;2021-07-12;278;1484;86796;71972;60.8;50.4
15;2021-07-13;587;1776;87383;73748;61.2;51.6
15;2021-07-14;16;130;87399;73878;61.2;51.7
15;2021-07-15;1132;729;88531;74607;62.0;52.2
15;2021-07-16;1139;1336;89670;75943;62.8;53.2
15;2021-07-17;819;953;90489;76896;63.4;53.8
15;2021-07-18;0;1;90489;76897;63.4;53.8
15;2021-07-19;1074;1270;91563;78167;64.1;54.7
15;2021-07-20;1612;570;93175;78737;65.2;55.1
15;2021-07-21;1189;603;94364;79340;66.1;55.6
15;2021-07-22;894;512;95258;79852;66.7;55.9
15;2021-07-23;1341;1065;96599;80917;67.6;56.7
15;2021-07-24;628;770;97227;81687;68.1;57.2
15;2021-07-25;1;24;97228;81711;68.1;57.2
15;2021-07-26;1247;594;98475;82305;69.0;57.6
15;2021-07-27;1691;576;100166;82881;70.1;58.0
15;2021-07-28;1238;584;101404;83465;71.0;58.4
15;2021-07-29;838;402;102242;83867;71.6;58.7
15;2021-07-30;1007;1131;103249;84998;72.3;59.5
15;2021-07-31;603;636;103852;85634;72.7;60.0
15;2021-08-01;21;12;103873;85646;72.7;60.0
15;2021-08-02;1143;543;105016;86189;73.5;60.4
15;2021-08-03;1162;383;106178;86572;74.3;60.6
15;2021-08-04;788;408;106966;86980;74.9;60.9
15;2021-08-05;383;284;107349;87264;75.2;61.1
15;2021-08-06;787;1235;108136;88499;75.7;62.0
15;2021-08-07;265;1160;108401;89659;75.9;62.8
15;2021-08-08;3;6;108404;89665;75.9;62.8
15;2021-08-09;511;1164;108915;90829;76.3;63.6
15;2021-08-10;435;725;109350;91554;76.6;64.1
15;2021-08-11;411;1007;109761;92561;76.9;64.8
15;2021-08-12;520;1182;110281;93743;77.2;65.6
15;2021-08-13;681;1136;110962;94879;77.7;66.4
15;2021-08-14;179;552;111141;95431;77.8;66.8
15;2021-08-15;17;9;111158;95440;77.8;66.8
15;2021-08-16;387;1134;111545;96574;78.1;67.6
15;2021-08-17;402;1140;111947;97714;78.4;68.4
15;2021-08-18;367;803;112314;98517;78.6;69.0
15;2021-08-19;300;878;112614;99395;78.9;69.6
15;2021-08-20;601;1215;113215;100610;79.3;70.4
15;2021-08-21;218;867;113433;101477;79.4;71.1
15;2021-08-22;12;26;113445;101503;79.4;71.1
15;2021-08-23;229;611;113674;102114;79.6;71.5
15;2021-08-24;245;590;113919;102704;79.8;71.9
15;2021-08-25;155;493;114074;103197;79.9;72.3
15;2021-08-26;136;363;114210;103560;80.0;72.5
15;2021-08-27;366;1337;114576;104897;80.2;73.5
15;2021-08-28;214;857;114790;105754;80.4;74.1
15;2021-08-29;7;13;114797;105767;80.4;74.1
15;2021-08-30;225;1056;115022;106823;80.5;74.8
15;2021-08-31;404;649;115426;107472;80.8;75.3
15;2021-09-01;182;401;115608;107873;81.0;75.5
15;2021-09-02;97;228;115705;108101;81.0;75.7
15;2021-09-03;201;889;115906;108990;81.2;76.3
15;2021-09-04;157;358;116063;109348;81.3;76.6
15;2021-09-05;0;2;116063;109350;81.3;76.6
15;2021-09-06;98;303;116161;109653;81.3;76.8
15;2021-09-07;100;197;116261;109850;81.4;76.9
15;2021-09-08;201;410;116462;110260;81.5;77.2
15;2021-09-09;100;315;116562;110575;81.6;77.4
15;2021-09-10;233;760;116795;111335;81.8;78.0
15;2021-09-11;95;290;116890;111625;81.8;78.2
15;2021-09-12;0;0;116890;111625;81.8;78.2
15;2021-09-13;102;265;116992;111890;81.9;78.3
15;2021-09-14;124;107;117116;111997;82.0;78.4
15;2021-09-15;69;247;117185;112244;82.1;78.6
15;2021-09-16;34;101;117219;112345;82.1;78.7
15;2021-09-17;266;605;117485;112950;82.3;79.1
15;2021-09-18;79;380;117564;113330;82.3;79.4
15;2021-09-19;0;0;117564;113330;82.3;79.4
15;2021-09-20;123;217;117687;113547;82.4;79.5
15;2021-09-21;41;107;117728;113654;82.4;79.6
15;2021-09-22;84;355;117812;114009;82.5;79.8
15;2021-09-23;37;109;117849;114118;82.5;79.9
15;2021-09-24;138;335;117987;114453;82.6;80.1
15;2021-09-25;42;217;118029;114670;82.6;80.3
15;2021-09-26;1;5;118030;114675;82.6;80.3
15;2021-09-27;89;133;118119;114808;82.7;80.4
15;2021-09-28;74;131;118193;114939;82.8;80.5
15;2021-09-29;69;191;118262;115130;82.8;80.6
15;2021-09-30;37;94;118299;115224;82.8;80.7
15;2021-10-01;117;216;118416;115440;82.9;80.8
15;2021-10-02;30;143;118446;115583;82.9;80.9
15;2021-10-03;0;2;118446;115585;82.9;80.9
15;2021-10-04;59;59;118505;115644;83.0;81.0
15;2021-10-05;35;51;118540;115695;83.0;81.0
15;2021-10-06;79;105;118619;115800;83.1;81.1
15;2021-10-07;46;91;118665;115891;83.1;81.1
15;2021-10-08;54;174;118719;116065;83.1;81.3
15;2021-10-09;54;107;118773;116172;83.2;81.3
15;2021-10-10;1;6;118774;116178;83.2;81.4
15;2021-10-11;50;163;118824;116341;83.2;81.5
15;2021-10-12;36;60;118860;116401;83.2;81.5
15;2021-10-13;76;152;118936;116553;83.3;81.6
15;2021-10-14;24;21;118960;116574;83.3;81.6
15;2021-10-15;65;119;119025;116693;83.3;81.7
15;2021-10-16;50;97;119075;116790;83.4;81.8
15;2021-10-17;0;0;119075;116790;83.4;81.8
15;2021-10-18;50;118;119125;116908;83.4;81.9
15;2021-10-19;27;59;119152;116967;83.4;81.9
16;2020-12-27;0;0;0;0;0.0;0.0
16;2020-12-28;2;0;2;0;0.0;0.0
16;2020-12-29;0;0;2;0;0.0;0.0
16;2020-12-30;1;0;3;0;0.0;0.0
16;2020-12-31;0;0;3;0;0.0;0.0
16;2021-01-01;0;0;3;0;0.0;0.0
16;2021-01-02;0;0;3;0;0.0;0.0
16;2021-01-03;0;0;3;0;0.0;0.0
16;2021-01-04;1;0;4;0;0.0;0.0
16;2021-01-05;1;0;5;0;0.0;0.0
16;2021-01-06;88;0;93;0;0.0;0.0
16;2021-01-07;240;0;333;0;0.1;0.0
16;2021-01-08;465;2;798;2;0.2;0.0
16;2021-01-09;1;0;799;2;0.2;0.0
16;2021-01-10;1;0;800;2;0.2;0.0
16;2021-01-11;304;0;1104;2;0.3;0.0
16;2021-01-12;437;1;1541;3;0.4;0.0
16;2021-01-13;480;1;2021;4;0.6;0.0
16;2021-01-14;601;7;2622;11;0.8;0.0
16;2021-01-15;503;3;3125;14;0.9;0.0
16;2021-01-16;0;0;3125;14;0.9;0.0
16;2021-01-17;0;0;3125;14;0.9;0.0
16;2021-01-18;432;6;3557;20;1.0;0.0
16;2021-01-19;835;2;4392;22;1.3;0.0
16;2021-01-20;1188;3;5580;25;1.6;0.0
16;2021-01-21;1384;13;6964;38;2.0;0.0
16;2021-01-22;1115;3;8079;41;2.3;0.0
16;2021-01-23;183;2;8262;43;2.4;0.0
16;2021-01-24;0;0;8262;43;2.4;0.0
16;2021-01-25;641;3;8903;46;2.6;0.0
16;2021-01-26;1026;2;9929;48;2.9;0.0
16;2021-01-27;1406;105;11335;153;3.3;0.0
16;2021-01-28;1276;72;12611;225;3.6;0.1
16;2021-01-29;742;141;13353;366;3.8;0.1
16;2021-01-30;36;0;13389;366;3.8;0.1
16;2021-01-31;0;0;13389;366;3.8;0.1
16;2021-02-01;395;203;13784;569;4.0;0.2
16;2021-02-02;576;175;14360;744;4.1;0.2
16;2021-02-03;621;350;14981;1094;4.3;0.3
16;2021-02-04;465;269;15446;1363;4.4;0.4
16;2021-02-05;505;275;15951;1638;4.6;0.5
16;2021-02-06;4;80;15955;1718;4.6;0.5
16;2021-02-07;41;3;15996;1721;4.6;0.5
16;2021-02-08;357;217;16353;1938;4.7;0.6
16;2021-02-09;650;294;17003;2232;4.9;0.6
16;2021-02-10;694;677;17697;2909;5.1;0.8
16;2021-02-11;805;617;18502;3526;5.3;1.0
16;2021-02-12;622;835;19124;4361;5.5;1.3
16;2021-02-13;43;79;19167;4440;5.5;1.3
16;2021-02-14;3;7;19170;4447;5.5;1.3
16;2021-02-15;217;661;19387;5108;5.6;1.5
16;2021-02-16;375;952;19762;6060;5.7;1.7
16;2021-02-17;346;1306;20108;7366;5.8;2.1
16;2021-02-18;511;1250;20619;8616;5.9;2.5
16;2021-02-19;389;784;21008;9400;6.0;2.7
16;2021-02-20;3;8;21011;9408;6.0;2.7
16;2021-02-21;2;0;21013;9408;6.0;2.7
16;2021-02-22;136;529;21149;9937;6.1;2.9
16;2021-02-23;207;922;21356;10859;6.1;3.1
16;2021-02-24;277;895;21633;11754;6.2;3.4
16;2021-02-25;395;689;22028;12443;6.3;3.6
16;2021-02-26;478;501;22506;12944;6.5;3.7
16;2021-02-27;249;1;22755;12945;6.5;3.7
16;2021-02-28;5;5;22760;12950;6.5;3.7
16;2021-03-01;152;329;22912;13279;6.6;3.8
16;2021-03-02;271;671;23183;13950;6.7;4.0
16;2021-03-03;391;725;23574;14675;6.8;4.2
16;2021-03-04;804;571;24378;15246;7.0;4.4
16;2021-03-05;1143;545;25521;15791;7.3;4.5
16;2021-03-06;753;16;26274;15807;7.5;4.5
16;2021-03-07;94;18;26368;15825;7.6;4.5
16;2021-03-08;437;321;26805;16146;7.7;4.6
16;2021-03-09;774;698;27579;16844;7.9;4.8
16;2021-03-10;606;666;28185;17510;8.1;5.0
16;2021-03-11;1448;539;29633;18049;8.5;5.2
16;2021-03-12;1165;462;30798;18511;8.8;5.3
16;2021-03-13;765;15;31563;18526;9.1;5.3
16;2021-03-14;1;0;31564;18526;9.1;5.3
16;2021-03-15;462;186;32026;18712;9.2;5.4
16;2021-03-16;861;423;32887;19135;9.4;5.5
16;2021-03-17;591;284;33478;19419;9.6;5.6
16;2021-03-18;1033;283;34511;19702;9.9;5.7
16;2021-03-19;1103;248;35614;19950;10.2;5.7
16;2021-03-20;396;5;36010;19955;10.3;5.7
16;2021-03-21;9;0;36019;19955;10.3;5.7
16;2021-03-22;728;101;36747;20056;10.6;5.8
16;2021-03-23;1464;107;38211;20163;11.0;5.8
16;2021-03-24;1123;186;39334;20349;11.3;5.8
16;2021-03-25;2047;94;41381;20443;11.9;5.9
16;2021-03-26;1918;99;43299;20542;12.4;5.9
16;2021-03-27;432;22;43731;20564;12.6;5.9
16;2021-03-28;0;0;43731;20564;12.6;5.9
16;2021-03-29;923;60;44654;20624;12.8;5.9
16;2021-03-30;1882;179;46536;20803;13.4;6.0
16;2021-03-31;1513;135;48049;20938;13.8;6.0
16;2021-04-01;2009;404;50058;21342;14.4;6.1
16;2021-04-02;1442;381;51500;21723;14.8;6.2
16;2021-04-03;288;5;51788;21728;14.9;6.2
16;2021-04-04;1;0;51789;21728;14.9;6.2
16;2021-04-05;2;0;51791;21728;14.9;6.2
16;2021-04-06;2013;549;53804;22277;15.5;6.4
16;2021-04-07;1953;408;55757;22685;16.0;6.5
16;2021-04-08;2823;591;58580;23276;16.8;6.7
16;2021-04-09;2694;555;61274;23831;17.6;6.8
16;2021-04-10;1290;38;62564;23869;18.0;6.9
16;2021-04-11;2;0;62566;23869;18.0;6.9
16;2021-04-12;1430;316;63996;24185;18.4;6.9
16;2021-04-13;2124;842;66120;25027;19.0;7.2
16;2021-04-14;1951;634;68071;25661;19.6;7.4
16;2021-04-15;2102;984;70173;26645;20.2;7.7
16;2021-04-16;2042;790;72215;27435;20.7;7.9
16;2021-04-17;1507;93;73722;27528;21.2;7.9
16;2021-04-18;197;3;73919;27531;21.2;7.9
16;2021-04-19;1440;524;75359;28055;21.6;8.1
16;2021-04-20;2053;1235;77412;29290;22.2;8.4
16;2021-04-21;1776;753;79188;30043;22.7;8.6
16;2021-04-22;2290;1009;81478;31052;23.4;8.9
16;2021-04-23;2362;1174;83840;32226;24.1;9.3
16;2021-04-24;829;38;84669;32264;24.3;9.3
16;2021-04-25;117;6;84786;32270;24.4;9.3
16;2021-04-26;1400;810;86186;33080;24.8;9.5
16;2021-04-27;2055;1417;88241;34497;25.3;9.9
16;2021-04-28;1592;1127;89833;35624;25.8;10.2
16;2021-04-29;2250;1501;92083;37125;26.4;10.7
16;2021-04-30;2856;1345;94939;38470;27.3;11.0
16;2021-05-01;353;60;95292;38530;27.4;11.1
16;2021-05-02;155;13;95447;38543;27.4;11.1
16;2021-05-03;2611;538;98058;39081;28.2;11.2
16;2021-05-04;2057;2046;100115;41127;28.8;11.8
16;2021-05-05;1688;1832;101803;42959;29.2;12.3
16;2021-05-06;1886;2248;103689;45207;29.8;13.0
16;2021-05-07;3072;2123;106761;47330;30.7;13.6
16;2021-05-08;1197;468;107958;47798;31.0;13.7
16;2021-05-09;530;27;108488;47825;31.2;13.7
16;2021-05-10;1931;1624;110419;49449;31.7;14.2
16;2021-05-11;2354;1965;112773;51414;32.4;14.8
16;2021-05-12;1734;1798;114507;53212;32.9;15.3
16;2021-05-13;1461;356;115968;53568;33.3;15.4
16;2021-05-14;1989;1563;117957;55131;33.9;15.8
16;2021-05-15;596;895;118553;56026;34.0;16.1
16;2021-05-16;132;6;118685;56032;34.1;16.1
16;2021-05-17;1609;1286;120294;57318;34.5;16.5
16;2021-05-18;2756;1426;123050;58744;35.3;16.9
16;2021-05-19;2006;1241;125056;59985;35.9;17.2
16;2021-05-20;2832;1389;127888;61374;36.7;17.6
16;2021-05-21;2943;1395;130831;62769;37.6;18.0
16;2021-05-22;411;711;131242;63480;37.7;18.2
16;2021-05-23;210;11;131452;63491;37.8;18.2
16;2021-05-24;1262;234;132714;63725;38.1;18.3
16;2021-05-25;2759;1461;135473;65186;38.9;18.7
16;2021-05-26;1833;1186;137306;66372;39.4;19.1
16;2021-05-27;2416;1583;139722;67955;40.1;19.5
16;2021-05-28;2899;1565;142621;69520;41.0;20.0
16;2021-05-29;814;883;143435;70403;41.2;20.2
16;2021-05-30;1;4;143436;70407;41.2;20.2
16;2021-05-31;1984;1105;145420;71512;41.8;20.5
16;2021-06-01;2344;1713;147764;73225;42.4;21.0
16;2021-06-02;1820;1502;149584;74727;43.0;21.5
16;2021-06-03;2622;1761;152206;76488;43.7;22.0
16;2021-06-04;2833;2030;155039;78518;44.5;22.6
16;2021-06-05;1006;549;156045;79067;44.8;22.7
16;2021-06-06;161;29;156206;79096;44.9;22.7
16;2021-06-07;1992;1281;158198;80377;45.4;23.1
16;2021-06-08;2395;1998;160593;82375;46.1;23.7
16;2021-06-09;2528;1616;163121;83991;46.8;24.1
16;2021-06-10;2569;2003;165690;85994;47.6;24.7
16;2021-06-11;2152;2733;167842;88727;48.2;25.5
16;2021-06-12;1613;517;169455;89244;48.7;25.6
16;2021-06-13;260;72;169715;89316;48.7;25.7
16;2021-06-14;797;2798;170512;92114;49.0;26.5
16;2021-06-15;1866;2623;172378;94737;49.5;27.2
16;2021-06-16;1575;2083;173953;96820;50.0;27.8
16;2021-06-17;2040;2509;175993;99329;50.5;28.5
16;2021-06-18;2060;3217;178053;102546;51.1;29.5
16;2021-06-19;1351;1311;179404;103857;51.5;29.8
16;2021-06-20;243;28;179647;103885;51.6;29.8
16;2021-06-21;1411;2168;181058;106053;52.0;30.5
16;2021-06-22;1675;2943;182733;108996;52.5;31.3
16;2021-06-23;1562;2016;184295;111012;52.9;31.9
16;2021-06-24;1928;2167;186223;113179;53.5;32.5
16;2021-06-25;1983;2727;188206;115906;54.1;33.3
16;2021-06-26;1060;725;189266;116631;54.4;33.5
16;2021-06-27;132;25;189398;116656;54.4;33.5
16;2021-06-28;1164;1964;190562;118620;54.7;34.1
16;2021-06-29;1282;3365;191844;121985;55.1;35.0
16;2021-06-30;1337;2714;193181;124699;55.5;35.8
16;2021-07-01;1865;3156;195046;127855;56.0;36.7
16;2021-07-02;1422;3580;196468;131435;56.4;37.7
16;2021-07-03;696;1111;197164;132546;56.6;38.1
16;2021-07-04;3;15;197167;132561;56.6;38.1
16;2021-07-05;815;2298;197982;134859;56.9;38.7
16;2021-07-06;1278;3366;199260;138225;57.2;39.7
16;2021-07-07;871;2276;200131;140501;57.5;40.4
16;2021-07-08;1234;2736;201365;143237;57.8;41.1
16;2021-07-09;1113;3709;202478;146946;58.2;42.2
16;2021-07-10;338;1338;202816;148284;58.3;42.6
16;2021-07-11;2;13;202818;148297;58.3;42.6
16;2021-07-12;634;2436;203452;150733;58.4;43.3
16;2021-07-13;1385;3530;204837;154263;58.8;44.3
16;2021-07-14;797;877;205634;155140;59.1;44.6
16;2021-07-15;1250;3408;206884;158548;59.4;45.5
16;2021-07-16;1498;3383;208382;161931;59.8;46.5
16;2021-07-17;539;1188;208921;163119;60.0;46.8
16;2021-07-18;14;6;208935;163125;60.0;46.9
16;2021-07-19;618;2853;209553;165978;60.2;47.7
16;2021-07-20;1124;3288;210677;169266;60.5;48.6
16;2021-07-21;1117;2619;211794;171885;60.8;49.4
16;2021-07-22;1872;2863;213666;174748;61.4;50.2
16;2021-07-23;1552;3545;215218;178293;61.8;51.2
16;2021-07-24;639;1212;215857;179505;62.0;51.6
16;2021-07-25;11;11;215868;179516;62.0;51.6
16;2021-07-26;1529;2129;217397;181645;62.4;52.2
16;2021-07-27;1866;2819;219263;184464;63.0;53.0
16;2021-07-28;1864;2311;221127;186775;63.5;53.6
16;2021-07-29;2241;2477;223368;189252;64.2;54.4
16;2021-07-30;2355;3109;225723;192361;64.8;55.2
16;2021-07-31;960;1353;226683;193714;65.1;55.6
16;2021-08-01;192;22;226875;193736;65.2;55.6
16;2021-08-02;2121;1829;228996;195565;65.8;56.2
16;2021-08-03;2120;2328;231116;197893;66.4;56.8
16;2021-08-04;2122;1886;233238;199779;67.0;57.4
16;2021-08-05;2775;1655;236013;201434;67.8;57.9
16;2021-08-06;2512;2365;238525;203799;68.5;58.5
16;2021-08-07;828;559;239353;204358;68.7;58.7
16;2021-08-08;37;33;239390;204391;68.8;58.7
16;2021-08-09;2183;1061;241573;205452;69.4;59.0
16;2021-08-10;2886;1586;244459;207038;70.2;59.5
16;2021-08-11;2603;1232;247062;208270;71.0;59.8
16;2021-08-12;2012;1735;249074;210005;71.5;60.3
16;2021-08-13;2686;1468;251760;211473;72.3;60.7
16;2021-08-14;758;455;252518;211928;72.5;60.9
16;2021-08-15;29;4;252547;211932;72.5;60.9
16;2021-08-16;1339;1582;253886;213514;72.9;61.3
16;2021-08-17;1837;1628;255723;215142;73.4;61.8
16;2021-08-18;1591;1471;257314;216613;73.9;62.2
16;2021-08-19;1517;1777;258831;218390;74.3;62.7
16;2021-08-20;1602;1902;260433;220292;74.8;63.3
16;2021-08-21;564;827;260997;221119;75.0;63.5
16;2021-08-22;4;5;261001;221124;75.0;63.5
16;2021-08-23;993;2064;261994;223188;75.2;64.1
16;2021-08-24;1040;2376;263034;225564;75.5;64.8
16;2021-08-25;887;1781;263921;227345;75.8;65.3
16;2021-08-26;880;2531;264801;229876;76.1;66.0
16;2021-08-27;853;2408;265654;232284;76.3;66.7
16;2021-08-28;261;771;265915;233055;76.4;66.9
16;2021-08-29;2;15;265917;233070;76.4;66.9
16;2021-08-30;638;2373;266555;235443;76.6;67.6
16;2021-08-31;668;2545;267223;237988;76.7;68.4
16;2021-09-01;469;2354;267692;240342;76.9;69.0
16;2021-09-02;544;2078;268236;242420;77.0;69.6
16;2021-09-03;544;2544;268780;244964;77.2;70.4
16;2021-09-04;365;904;269145;245868;77.3;70.6
16;2021-09-05;6;29;269151;245897;77.3;70.6
16;2021-09-06;318;1457;269469;247354;77.4;71.0
16;2021-09-07;356;1673;269825;249027;77.5;71.5
16;2021-09-08;392;1989;270217;251016;77.6;72.1
16;2021-09-09;351;1497;270568;252513;77.7;72.5
16;2021-09-10;440;1767;271008;254280;77.8;73.0
16;2021-09-11;185;785;271193;255065;77.9;73.3
16;2021-09-12;6;21;271199;255086;77.9;73.3
16;2021-09-13;256;1066;271455;256152;78.0;73.6
16;2021-09-14;373;957;271828;257109;78.1;73.8
16;2021-09-15;349;1349;272177;258458;78.2;74.2
16;2021-09-16;303;888;272480;259346;78.3;74.5
16;2021-09-17;500;1376;272980;260722;78.4;74.9
16;2021-09-18;100;535;273080;261257;78.4;75.0
16;2021-09-19;0;9;273080;261266;78.4;75.0
16;2021-09-20;197;722;273277;261988;78.5;75.2
16;2021-09-21;184;674;273461;262662;78.5;75.4
16;2021-09-22;186;990;273647;263652;78.6;75.7
16;2021-09-23;170;560;273817;264212;78.6;75.9
16;2021-09-24;339;1049;274156;265261;78.7;76.2
16;2021-09-25;65;439;274221;265700;78.8;76.3
16;2021-09-26;1;6;274222;265706;78.8;76.3
16;2021-09-27;193;583;274415;266289;78.8;76.5
16;2021-09-28;146;536;274561;266825;78.9;76.6
16;2021-09-29;198;606;274759;267431;78.9;76.8
16;2021-09-30;115;482;274874;267913;78.9;76.9
16;2021-10-01;241;540;275115;268453;79.0;77.1
16;2021-10-02;81;324;275196;268777;79.0;77.2
16;2021-10-03;0;7;275196;268784;79.0;77.2
16;2021-10-04;117;356;275313;269140;79.1;77.3
16;2021-10-05;122;375;275435;269515;79.1;77.4
16;2021-10-06;182;510;275617;270025;79.2;77.6
16;2021-10-07;122;315;275739;270340;79.2;77.6
16;2021-10-08;238;673;275977;271013;79.3;77.8
16;2021-10-09;76;181;276053;271194;79.3;77.9
16;2021-10-10;1;10;276054;271204;79.3;77.9
16;2021-10-11;106;274;276160;271478;79.3;78.0
16;2021-10-12;96;221;276256;271699;79.3;78.0
16;2021-10-13;198;343;276454;272042;79.4;78.1
16;2021-10-14;90;163;276544;272205;79.4;78.2
16;2021-10-15;183;420;276727;272625;79.5;78.3
16;2021-10-16;84;97;276811;272722;79.5;78.3
16;2021-10-17;2;1;276813;272723;79.5;78.3
16;2021-10-18;143;283;276956;273006;79.5;78.4
16;2021-10-19;98;146;277054;273152;79.6;78.5
17;2020-12-27;0;0;0;0;0.0;0.0
17;2020-12-28;0;0;0;0;0.0;0.0
17;2020-12-29;0;0;0;0;0.0;0.0
17;2020-12-30;1;0;1;0;0.0;0.0
17;2020-12-31;0;0;1;0;0.0;0.0
17;2021-01-01;1;0;2;0;0.0;0.0
17;2021-01-02;1;0;3;0;0.0;0.0
17;2021-01-03;0;0;3;0;0.0;0.0
17;2021-01-04;56;0;59;0;0.0;0.0
17;2021-01-05;98;0;157;0;0.0;0.0
17;2021-01-06;132;0;289;0;0.0;0.0
17;2021-01-07;484;1;773;1;0.1;0.0
17;2021-01-08;418;1;1191;2;0.2;0.0
17;2021-01-09;0;0;1191;2;0.2;0.0
17;2021-01-10;1;0;1192;2;0.2;0.0
17;2021-01-11;381;2;1573;4;0.2;0.0
17;2021-01-12;751;1;2324;5;0.4;0.0
17;2021-01-13;655;2;2979;7;0.5;0.0
17;2021-01-14;616;9;3595;16;0.6;0.0
17;2021-01-15;681;2;4276;18;0.7;0.0
17;2021-01-16;129;2;4405;20;0.7;0.0
17;2021-01-17;19;0;4424;20;0.7;0.0
17;2021-01-18;887;5;5311;25;0.8;0.0
17;2021-01-19;1910;17;7221;42;1.1;0.0
17;2021-01-20;2396;4;9617;46;1.5;0.0
17;2021-01-21;2500;12;12117;58;1.9;0.0
17;2021-01-22;1893;15;14010;73;2.2;0.0
17;2021-01-23;738;1;14748;74;2.3;0.0
17;2021-01-24;50;0;14798;74;2.3;0.0
17;2021-01-25;1382;5;16180;79;2.5;0.0
17;2021-01-26;2110;5;18290;84;2.8;0.0
17;2021-01-27;1676;33;19966;117;3.1;0.0
17;2021-01-28;2476;232;22442;349;3.5;0.1
17;2021-01-29;1740;222;24182;571;3.7;0.1
17;2021-01-30;528;5;24710;576;3.8;0.1
17;2021-01-31;37;2;24747;578;3.8;0.1
17;2021-02-01;741;210;25488;788;3.9;0.1
17;2021-02-02;1202;347;26690;1135;4.1;0.2
17;2021-02-03;1300;401;27990;1536;4.3;0.2
17;2021-02-04;1162;503;29152;2039;4.5;0.3
17;2021-02-05;603;757;29755;2796;4.6;0.4
17;2021-02-06;25;43;29780;2839;4.6;0.4
17;2021-02-07;31;13;29811;2852;4.6;0.4
17;2021-02-08;706;400;30517;3252;4.7;0.5
17;2021-02-09;1103;1316;31620;4568;4.9;0.7
17;2021-02-10;866;1288;32486;5856;5.0;0.9
17;2021-02-11;1241;1402;33727;7258;5.2;1.1
17;2021-02-12;774;966;34501;8224;5.3;1.3
17;2021-02-13;43;104;34544;8328;5.3;1.3
17;2021-02-14;1;10;34545;8338;5.3;1.3
17;2021-02-15;621;1222;35166;9560;5.4;1.5
17;2021-02-16;752;1827;35918;11387;5.6;1.8
17;2021-02-17;795;1357;36713;12744;5.7;2.0
17;2021-02-18;965;2185;37678;14929;5.8;2.3
17;2021-02-19;1069;1539;38747;16468;6.0;2.5
17;2021-02-20;105;311;38852;16779;6.0;2.6
17;2021-02-21;9;2;38861;16781;6.0;2.6
17;2021-02-22;650;1630;39511;18411;6.1;2.8
17;2021-02-23;782;1535;40293;19946;6.2;3.1
17;2021-02-24;1080;1586;41373;21532;6.4;3.3
17;2021-02-25;1087;1708;42460;23240;6.6;3.6
17;2021-02-26;1308;1296;43768;24536;6.8;3.8
17;2021-02-27;529;248;44297;24784;6.8;3.8
17;2021-02-28;19;9;44316;24793;6.8;3.8
17;2021-03-01;638;1042;44954;25835;6.9;4.0
17;2021-03-02;1095;870;46049;26705;7.1;4.1
17;2021-03-03;1617;795;47666;27500;7.4;4.2
17;2021-03-04;2426;1143;50092;28643;7.7;4.4
17;2021-03-05;2665;683;52757;29326;8.2;4.5
17;2021-03-06;1028;32;53785;29358;8.3;4.5
17;2021-03-07;183;47;53968;29405;8.3;4.5
17;2021-03-08;1019;836;54987;30241;8.5;4.7
17;2021-03-09;1745;621;56732;30862;8.8;4.8
17;2021-03-10;2051;648;58783;31510;9.1;4.9
17;2021-03-11;3228;999;62011;32509;9.6;5.0
17;2021-03-12;3356;630;65367;33139;10.1;5.1
17;2021-03-13;1203;13;66570;33152;10.3;5.1
17;2021-03-14;34;0;66604;33152;10.3;5.1
17;2021-03-15;1243;996;67847;34148;10.5;5.3
17;2021-03-16;892;536;68739;34684;10.6;5.4
17;2021-03-17;1460;707;70199;35391;10.8;5.5
17;2021-03-18;1683;766;71882;36157;11.1;5.6
17;2021-03-19;2096;549;73978;36706;11.4;5.7
17;2021-03-20;1086;59;75064;36765;11.6;5.7
17;2021-03-21;37;43;75101;36808;11.6;5.7
17;2021-03-22;1577;693;76678;37501;11.8;5.8
17;2021-03-23;2491;583;79169;38084;12.2;5.9
17;2021-03-24;3546;862;82715;38946;12.8;6.0
17;2021-03-25;4714;649;87429;39595;13.5;6.1
17;2021-03-26;4943;478;92372;40073;14.3;6.2
17;2021-03-27;1737;69;94109;40142;14.5;6.2
17;2021-03-28;369;45;94478;40187;14.6;6.2
17;2021-03-29;2361;569;96839;40756;15.0;6.3
17;2021-03-30;2653;990;99492;41746;15.4;6.5
17;2021-03-31;3843;912;103335;42658;16.0;6.6
17;2021-04-01;4013;1170;107348;43828;16.6;6.8
17;2021-04-02;3708;841;111056;44669;17.2;6.9
17;2021-04-03;1152;187;112208;44856;17.3;6.9
17;2021-04-04;502;6;112710;44862;17.4;6.9
17;2021-04-05;445;128;113155;44990;17.5;7.0
17;2021-04-06;3479;1032;116634;46022;18.0;7.1
17;2021-04-07;4131;1159;120765;47181;18.7;7.3
17;2021-04-08;4566;1482;125331;48663;19.4;7.5
17;2021-04-09;6498;846;131829;49509;20.4;7.7
17;2021-04-10;2582;72;134411;49581;20.8;7.7
17;2021-04-11;790;18;135201;49599;20.9;7.7
17;2021-04-12;2889;1624;138090;51223;21.3;7.9
17;2021-04-13;4152;1288;142242;52511;22.0;8.1
17;2021-04-14;4419;1213;146661;53724;22.7;8.3
17;2021-04-15;4601;1140;151262;54864;23.4;8.5
17;2021-04-16;4298;1155;155560;56019;24.0;8.7
17;2021-04-17;1682;384;157242;56403;24.3;8.7
17;2021-04-18;471;81;157713;56484;24.4;8.7
17;2021-04-19;2335;2062;160048;58546;24.7;9.0
17;2021-04-20;2927;2559;162975;61105;25.2;9.4
17;2021-04-21;2974;1942;165949;63047;25.6;9.7
17;2021-04-22;3121;2366;169070;65413;26.1;10.1
17;2021-04-23;2446;2731;171516;68144;26.5;10.5
17;2021-04-24;1669;929;173185;69073;26.8;10.7
17;2021-04-25;664;246;173849;69319;26.9;10.7
17;2021-04-26;2578;2627;176427;71946;27.3;11.1
17;2021-04-27;3151;2671;179578;74617;27.8;11.5
17;2021-04-28;3102;2940;182680;77557;28.2;12.0
17;2021-04-29;4148;2867;186828;80424;28.9;12.4
17;2021-04-30;4356;2640;191184;83064;29.5;12.8
17;2021-05-01;849;543;192033;83607;29.7;12.9
17;2021-05-02;553;839;192586;84446;29.8;13.1
17;2021-05-03;2546;2963;195132;87409;30.2;13.5
17;2021-05-04;2315;3726;197447;91135;30.5;14.1
17;2021-05-05;2907;3704;200354;94839;31.0;14.7
17;2021-05-06;4120;3405;204474;98244;31.6;15.2
17;2021-05-07;4359;3633;208833;101877;32.3;15.7
17;2021-05-08;1306;753;210139;102630;32.5;15.9
17;2021-05-09;1311;706;211450;103336;32.7;16.0
17;2021-05-10;2726;3694;214176;107030;33.1;16.5
17;2021-05-11;3500;3997;217676;111027;33.6;17.2
17;2021-05-12;3530;3814;221206;114841;34.2;17.7
17;2021-05-13;2542;693;223748;115534;34.6;17.9
17;2021-05-14;3031;2393;226779;117927;35.0;18.2
17;2021-05-15;2127;662;228906;118589;35.4;18.3
17;2021-05-16;1733;318;230639;118907;35.6;18.4
17;2021-05-17;4288;1999;234927;120906;36.3;18.7
17;2021-05-18;4747;1638;239674;122544;37.0;18.9
17;2021-05-19;5071;1281;244745;123825;37.8;19.1
17;2021-05-20;4939;1946;249684;125771;38.6;19.4
17;2021-05-21;4994;1955;254678;127726;39.4;19.7
17;2021-05-22;2390;532;257068;128258;39.7;19.8
17;2021-05-23;1900;128;258968;128386;40.0;19.8
17;2021-05-24;1426;210;260394;128596;40.2;19.9
17;2021-05-25;4031;1769;264425;130365;40.9;20.1
17;2021-05-26;4369;2040;268794;132405;41.5;20.5
17;2021-05-27;5211;2139;274005;134544;42.3;20.8
17;2021-05-28;4469;3437;278474;137981;43.0;21.3
17;2021-05-29;1559;1707;280033;139688;43.3;21.6
17;2021-05-30;857;410;280890;140098;43.4;21.7
17;2021-05-31;2947;3013;283837;143111;43.9;22.1
17;2021-06-01;4295;2927;288132;146038;44.5;22.6
17;2021-06-02;4203;3177;292335;149215;45.2;23.1
17;2021-06-03;5059;3168;297394;152383;46.0;23.5
17;2021-06-04;4513;3859;301907;156242;46.7;24.1
17;2021-06-05;1991;1603;303898;157845;47.0;24.4
17;2021-06-06;852;735;304750;158580;47.1;24.5
17;2021-06-07;3138;4345;307888;162925;47.6;25.2
17;2021-06-08;3789;4496;311677;167421;48.2;25.9
17;2021-06-09;4345;3055;316022;170476;48.8;26.3
17;2021-06-10;4927;2794;320949;173270;49.6;26.8
17;2021-06-11;4794;3693;325743;176963;50.3;27.3
17;2021-06-12;1813;1405;327556;178368;50.6;27.6
17;2021-06-13;612;415;328168;178783;50.7;27.6
17;2021-06-14;2834;4538;331002;183321;51.2;28.3
17;2021-06-15;3625;4382;334627;187703;51.7;29.0
17;2021-06-16;4127;3695;338754;191398;52.4;29.6
17;2021-06-17;4367;4125;343121;195523;53.0;30.2
17;2021-06-18;4059;4441;347180;199964;53.7;30.9
17;2021-06-19;1450;1988;348630;201952;53.9;31.2
17;2021-06-20;595;1036;349225;202988;54.0;31.4
17;2021-06-21;2558;4372;351783;207360;54.4;32.0
17;2021-06-22;3532;4454;355315;211814;54.9;32.7
17;2021-06-23;3795;3998;359110;215812;55.5;33.4
17;2021-06-24;3600;3959;362710;219771;56.1;34.0
17;2021-06-25;2718;4992;365428;224763;56.5;34.7
17;2021-06-26;905;2333;366333;227096;56.6;35.1
17;2021-06-27;397;1904;366730;229000;56.7;35.4
17;2021-06-28;1522;5417;368252;234417;56.9;36.2
17;2021-06-29;1684;5892;369936;240309;57.2;37.1
17;2021-06-30;2030;5548;371966;245857;57.5;38.0
17;2021-07-01;2267;5562;374233;251419;57.8;38.9
17;2021-07-02;2485;5982;376718;257401;58.2;39.8
17;2021-07-03;627;2544;377345;259945;58.3;40.2
17;2021-07-04;155;1250;377500;261195;58.3;40.4
17;2021-07-05;1887;5178;379387;266373;58.6;41.2
17;2021-07-06;2128;5600;381515;271973;59.0;42.0
17;2021-07-07;2406;5500;383921;277473;59.3;42.9
17;2021-07-08;2915;5446;386836;282919;59.8;43.7
17;2021-07-09;2526;6078;389362;288997;60.2;44.7
17;2021-07-10;826;2470;390188;291467;60.3;45.0
17;2021-07-11;379;906;390567;292373;60.4;45.2
17;2021-07-12;2002;5616;392569;297989;60.7;46.1
17;2021-07-13;2372;6720;394941;304709;61.0;47.1
17;2021-07-14;71;72;395012;304781;61.0;47.1
17;2021-07-15;2190;6862;397202;311643;61.4;48.2
17;2021-07-16;2778;6965;399980;318608;61.8;49.2
17;2021-07-17;1051;2274;401031;320882;62.0;49.6
17;2021-07-18;312;1036;401343;321918;62.0;49.7
17;2021-07-19;2634;5908;403977;327826;62.4;50.7
17;2021-07-20;3315;6319;407292;334145;62.9;51.6
17;2021-07-21;3802;6029;411094;340174;63.5;52.6
17;2021-07-22;4248;6269;415342;346443;64.2;53.5
17;2021-07-23;3906;6566;419248;353009;64.8;54.6
17;2021-07-24;2067;1403;421315;354412;65.1;54.8
17;2021-07-25;1040;417;422355;354829;65.3;54.8
17;2021-07-26;3735;5425;426090;360254;65.8;55.7
17;2021-07-27;4728;5442;430818;365696;66.6;56.5
17;2021-07-28;5214;5178;436032;370874;67.4;57.3
17;2021-07-29;5166;5345;441198;376219;68.2;58.1
17;2021-07-30;5512;5577;446710;381796;69.0;59.0
17;2021-07-31;2117;1215;448827;383011;69.4;59.2
17;2021-08-01;1095;359;449922;383370;69.5;59.2
17;2021-08-02;4621;4392;454543;387762;70.2;59.9
17;2021-08-03;5762;4165;460305;391927;71.1;60.6
17;2021-08-04;6202;3379;466507;395306;72.1;61.1
17;2021-08-05;6390;3150;472897;398456;73.1;61.6
17;2021-08-06;5888;3601;478785;402057;74.0;62.1
17;2021-08-07;1993;870;480778;402927;74.3;62.3
17;2021-08-08;978;219;481756;403146;74.5;62.3
17;2021-08-09;3923;3695;485679;406841;75.1;62.9
17;2021-08-10;5087;3488;490766;410329;75.8;63.4
17;2021-08-11;4920;3812;495686;414141;76.6;64.0
17;2021-08-12;4897;3959;500583;418100;77.4;64.6
17;2021-08-13;4521;4143;505104;422243;78.1;65.3
17;2021-08-14;1239;1383;506343;423626;78.3;65.5
17;2021-08-15;407;377;506750;424003;78.3;65.5
17;2021-08-16;2855;4065;509605;428068;78.8;66.2
17;2021-08-17;3052;4292;512657;432360;79.2;66.8
17;2021-08-18;2622;4555;515279;436915;79.6;67.5
17;2021-08-19;2733;4372;518012;441287;80.1;68.2
17;2021-08-20;2501;5025;520513;446312;80.4;69.0
17;2021-08-21;685;1355;521198;447667;80.5;69.2
17;2021-08-22;221;457;521419;448124;80.6;69.3
17;2021-08-23;1987;4956;523406;453080;80.9;70.0
17;2021-08-24;1942;5093;525348;458173;81.2;70.8
17;2021-08-25;1660;5506;527008;463679;81.4;71.7
17;2021-08-26;1603;5761;528611;469440;81.7;72.5
17;2021-08-27;1552;5953;530163;475393;81.9;73.5
17;2021-08-28;521;1455;530684;476848;82.0;73.7
17;2021-08-29;87;575;530771;477423;82.0;73.8
17;2021-08-30;1436;5049;532207;482472;82.2;74.6
17;2021-08-31;1327;5239;533534;487711;82.5;75.4
17;2021-09-01;1195;4760;534729;492471;82.6;76.1
17;2021-09-02;1141;4146;535870;496617;82.8;76.7
17;2021-09-03;1173;4918;537043;501535;83.0;77.5
17;2021-09-04;287;917;537330;502452;83.0;77.6
17;2021-09-05;56;103;537386;502555;83.0;77.7
17;2021-09-06;730;3209;538116;505764;83.2;78.2
17;2021-09-07;720;2637;538836;508401;83.3;78.6
17;2021-09-08;823;3590;539659;511991;83.4;79.1
17;2021-09-09;819;2403;540478;514394;83.5;79.5
17;2021-09-10;805;3330;541283;517724;83.7;80.0
17;2021-09-11;304;853;541587;518577;83.7;80.1
17;2021-09-12;10;13;541597;518590;83.7;80.1
17;2021-09-13;655;1933;542252;520523;83.8;80.4
17;2021-09-14;619;1625;542871;522148;83.9;80.7
17;2021-09-15;944;2376;543815;524524;84.0;81.1
17;2021-09-16;546;1454;544361;525978;84.1;81.3
17;2021-09-17;623;1921;544984;527899;84.2;81.6
17;2021-09-18;193;583;545177;528482;84.3;81.7
17;2021-09-19;13;6;545190;528488;84.3;81.7
17;2021-09-20;432;1227;545622;529715;84.3;81.9
17;2021-09-21;326;893;545948;530608;84.4;82.0
17;2021-09-22;420;1694;546368;532302;84.4;82.3
17;2021-09-23;360;972;546728;533274;84.5;82.4
17;2021-09-24;386;1821;547114;535095;84.6;82.7
17;2021-09-25;128;472;547242;535567;84.6;82.8
17;2021-09-26;0;16;547242;535583;84.6;82.8
17;2021-09-27;437;1177;547679;536760;84.6;83.0
17;2021-09-28;276;689;547955;537449;84.7;83.1
17;2021-09-29;454;1215;548409;538664;84.8;83.2
17;2021-09-30;374;715;548783;539379;84.8;83.4
17;2021-10-01;362;742;549145;540121;84.9;83.5
17;2021-10-02;110;310;549255;540431;84.9;83.5
17;2021-10-03;4;29;549259;540460;84.9;83.5
17;2021-10-04;366;860;549625;541320;84.9;83.7
17;2021-10-05;380;580;550005;541900;85.0;83.7
17;2021-10-06;424;1132;550429;543032;85.1;83.9
17;2021-10-07;275;556;550704;543588;85.1;84.0
17;2021-10-08;423;888;551127;544476;85.2;84.1
17;2021-10-09;157;317;551284;544793;85.2;84.2
17;2021-10-10;1;23;551285;544816;85.2;84.2
17;2021-10-11;390;563;551675;545379;85.3;84.3
17;2021-10-12;221;364;551896;545743;85.3;84.3
17;2021-10-13;367;672;552263;546415;85.3;84.4
17;2021-10-14;225;412;552488;546827;85.4;84.5
17;2021-10-15;389;664;552877;547491;85.4;84.6
17;2021-10-16;81;147;552958;547638;85.5;84.6
17;2021-10-17;11;5;552969;547643;85.5;84.6
17;2021-10-18;336;340;553305;547983;85.5;84.7
17;2021-10-19;226;362;553531;548345;85.5;84.7
18;2020-12-27;0;0;0;0;0.0;0.0
18;2020-12-28;0;0;0;0;0.0;0.0
18;2020-12-29;0;0;0;0;0.0;0.0
18;2020-12-30;1;0;1;0;0.0;0.0
18;2020-12-31;0;0;1;0;0.0;0.0
18;2021-01-01;0;0;1;0;0.0;0.0
18;2021-01-02;0;0;1;0;0.0;0.0
18;2021-01-03;0;0;1;0;0.0;0.0
18;2021-01-04;3;0;4;0;0.0;0.0
18;2021-01-05;0;0;4;0;0.0;0.0
18;2021-01-06;1;0;5;0;0.0;0.0
18;2021-01-07;30;1;35;1;0.0;0.0
18;2021-01-08;65;0;100;1;0.0;0.0
18;2021-01-09;225;1;325;2;0.1;0.0
18;2021-01-10;146;0;471;2;0.2;0.0
18;2021-01-11;169;0;640;2;0.2;0.0
18;2021-01-12;371;0;1011;2;0.3;0.0
18;2021-01-13;270;2;1281;4;0.4;0.0
18;2021-01-14;269;2;1550;6;0.5;0.0
18;2021-01-15;332;2;1882;8;0.6;0.0
18;2021-01-16;288;3;2170;11;0.7;0.0
18;2021-01-17;1;0;2171;11;0.7;0.0
18;2021-01-18;291;0;2462;11;0.8;0.0
18;2021-01-19;1373;5;3835;16;1.3;0.0
18;2021-01-20;1239;2;5074;18;1.7;0.0
18;2021-01-21;963;0;6037;18;2.0;0.0
18;2021-01-22;781;2;6818;20;2.3;0.0
18;2021-01-23;249;2;7067;22;2.4;0.0
18;2021-01-24;0;0;7067;22;2.4;0.0
18;2021-01-25;509;1;7576;23;2.6;0.0
18;2021-01-26;395;1;7971;24;2.7;0.0
18;2021-01-27;390;2;8361;26;2.8;0.0
18;2021-01-28;566;8;8927;34;3.0;0.0
18;2021-01-29;490;73;9417;107;3.2;0.0
18;2021-01-30;431;159;9848;266;3.3;0.1
18;2021-01-31;82;116;9930;382;3.4;0.1
18;2021-02-01;328;139;10258;521;3.5;0.2
18;2021-02-02;507;240;10765;761;3.6;0.3
18;2021-02-03;398;204;11163;965;3.8;0.3
18;2021-02-04;630;228;11793;1193;4.0;0.4
18;2021-02-05;448;194;12241;1387;4.1;0.5
18;2021-02-06;283;100;12524;1487;4.2;0.5
18;2021-02-07;108;1;12632;1488;4.3;0.5
18;2021-02-08;268;230;12900;1718;4.4;0.6
18;2021-02-09;583;780;13483;2498;4.5;0.8
18;2021-02-10;742;695;14225;3193;4.8;1.1
18;2021-02-11;655;451;14880;3644;5.0;1.2
18;2021-02-12;502;330;15382;3974;5.2;1.3
18;2021-02-13;286;124;15668;4098;5.3;1.4
18;2021-02-14;364;98;16032;4196;5.4;1.4
18;2021-02-15;378;394;16410;4590;5.5;1.5
18;2021-02-16;401;402;16811;4992;5.7;1.7
18;2021-02-17;404;456;17215;5448;5.8;1.8
18;2021-02-18;344;535;17559;5983;5.9;2.0
18;2021-02-19;471;305;18030;6288;6.1;2.1
18;2021-02-20;720;241;18750;6529;6.3;2.2
18;2021-02-21;316;4;19066;6533;6.4;2.2
18;2021-02-22;218;369;19284;6902;6.5;2.3
18;2021-02-23;204;350;19488;7252;6.6;2.4
18;2021-02-24;241;274;19729;7526;6.7;2.5
18;2021-02-25;294;519;20023;8045;6.8;2.7
18;2021-02-26;583;236;20606;8281;7.0;2.8
18;2021-02-27;510;388;21116;8669;7.1;2.9
18;2021-02-28;7;68;21123;8737;7.1;2.9
18;2021-03-01;237;412;21360;9149;7.2;3.1
18;2021-03-02;284;520;21644;9669;7.3;3.3
18;2021-03-03;346;586;21990;10255;7.4;3.5
18;2021-03-04;475;571;22465;10826;7.6;3.7
18;2021-03-05;524;372;22989;11198;7.8;3.8
18;2021-03-06;1071;347;24060;11545;8.1;3.9
18;2021-03-07;7;140;24067;11685;8.1;3.9
18;2021-03-08;336;363;24403;12048;8.2;4.1
18;2021-03-09;410;367;24813;12415;8.4;4.2
18;2021-03-10;423;453;25236;12868;8.5;4.3
18;2021-03-11;518;426;25754;13294;8.7;4.5
18;2021-03-12;705;306;26459;13600;8.9;4.6
18;2021-03-13;1164;252;27623;13852;9.3;4.7
18;2021-03-14;301;215;27924;14067;9.4;4.7
18;2021-03-15;492;382;28416;14449;9.6;4.9
18;2021-03-16;392;314;28808;14763;9.7;5.0
18;2021-03-17;383;415;29191;15178;9.8;5.1
18;2021-03-18;512;230;29703;15408;10.0;5.2
18;2021-03-19;755;228;30458;15636;10.3;5.3
18;2021-03-20;986;622;31444;16258;10.6;5.5
18;2021-03-21;308;307;31752;16565;10.7;5.6
18;2021-03-22;602;299;32354;16864;10.9;5.7
18;2021-03-23;705;295;33059;17159;11.2;5.8
18;2021-03-24;1052;299;34111;17458;11.5;5.9
18;2021-03-25;1049;304;35160;17762;11.9;6.0
18;2021-03-26;1208;351;36368;18113;12.3;6.1
18;2021-03-27;1488;322;37856;18435;12.8;6.2
18;2021-03-28;215;0;38071;18435;12.8;6.2
18;2021-03-29;1101;202;39172;18637;13.2;6.3
18;2021-03-30;1084;306;40256;18943;13.6;6.4
18;2021-03-31;1305;256;41561;19199;14.0;6.5
18;2021-04-01;1375;350;42936;19549;14.5;6.6
18;2021-04-02;1229;312;44165;19861;14.9;6.7
18;2021-04-03;581;181;44746;20042;15.1;6.8
18;2021-04-04;71;5;44817;20047;15.1;6.8
18;2021-04-05;199;0;45016;20047;15.2;6.8
18;2021-04-06;1027;353;46043;20400;15.5;6.9
18;2021-04-07;1322;368;47365;20768;16.0;7.0
18;2021-04-08;1692;351;49057;21119;16.6;7.1
18;2021-04-09;1833;284;50890;21403;17.2;7.2
18;2021-04-10;2632;653;53522;22056;18.1;7.4
18;2021-04-11;1986;322;55508;22378;18.7;7.5
18;2021-04-12;1401;404;56909;22782;19.2;7.7
18;2021-04-13;1785;468;58694;23250;19.8;7.8
18;2021-04-14;1378;518;60072;23768;20.3;8.0
18;2021-04-15;1532;534;61604;24302;20.8;8.2
18;2021-04-16;1614;594;63218;24896;21.3;8.4
18;2021-04-17;1599;524;64817;25420;21.9;8.6
18;2021-04-18;377;232;65194;25652;22.0;8.7
18;2021-04-19;1317;594;66511;26246;22.4;8.9
18;2021-04-20;1445;716;67956;26962;22.9;9.1
18;2021-04-21;1270;910;69226;27872;23.4;9.4
18;2021-04-22;1403;705;70629;28577;23.8;9.6
18;2021-04-23;1387;738;72016;29315;24.3;9.9
18;2021-04-24;1355;1274;73371;30589;24.8;10.3
18;2021-04-25;287;218;73658;30807;24.9;10.4
18;2021-04-26;1205;957;74863;31764;25.3;10.7
18;2021-04-27;1544;766;76407;32530;25.8;11.0
18;2021-04-28;1358;879;77765;33409;26.2;11.3
18;2021-04-29;1851;735;79616;34144;26.9;11.5
18;2021-04-30;1569;999;81185;35143;27.4;11.9
18;2021-05-01;788;212;81973;35355;27.7;11.9
18;2021-05-02;806;61;82779;35416;27.9;11.9
18;2021-05-03;1627;1014;84406;36430;28.5;12.3
18;2021-05-04;1729;1287;86135;37717;29.1;12.7
18;2021-05-05;1736;1217;87871;38934;29.6;13.1
18;2021-05-06;2162;1368;90033;40302;30.4;13.6
18;2021-05-07;1234;1404;91267;41706;30.8;14.1
18;2021-05-08;994;1471;92261;43177;31.1;14.6
18;2021-05-09;500;2261;92761;45438;31.3;15.3
18;2021-05-10;1157;1509;93918;46947;31.7;15.8
18;2021-05-11;1696;1752;95614;48699;32.3;16.4
18;2021-05-12;1806;1497;97420;50196;32.9;16.9
18;2021-05-13;1061;370;98481;50566;33.2;17.1
18;2021-05-14;1345;942;99826;51508;33.7;17.4
18;2021-05-15;1809;1164;101635;52672;34.3;17.8
18;2021-05-16;537;581;102172;53253;34.5;18.0
18;2021-05-17;1245;1091;103417;54344;34.9;18.3
18;2021-05-18;2146;935;105563;55279;35.6;18.6
18;2021-05-19;2162;920;107725;56199;36.3;19.0
18;2021-05-20;2276;983;110001;57182;37.1;19.3
18;2021-05-21;1495;765;111496;57947;37.6;19.6
18;2021-05-22;1724;1075;113220;59022;38.2;19.9
18;2021-05-23;486;336;113706;59358;38.4;20.0
18;2021-05-24;461;293;114167;59651;38.5;20.1
18;2021-05-25;1841;1061;116008;60712;39.1;20.5
18;2021-05-26;2153;846;118161;61558;39.9;20.8
18;2021-05-27;2209;1231;120370;62789;40.6;21.2
18;2021-05-28;1712;1308;122082;64097;41.2;21.6
18;2021-05-29;2621;1663;124703;65760;42.1;22.2
18;2021-05-30;1482;504;126185;66264;42.6;22.4
18;2021-05-31;1786;694;127971;66958;43.2;22.6
18;2021-06-01;2040;948;130011;67906;43.9;22.9
18;2021-06-02;2010;1018;132021;68924;44.5;23.3
18;2021-06-03;2283;1205;134304;70129;45.3;23.7
18;2021-06-04;1912;1123;136216;71252;46.0;24.0
18;2021-06-05;2800;1450;139016;72702;46.9;24.5
18;2021-06-06;364;381;139380;73083;47.0;24.7
18;2021-06-07;1294;1232;140674;74315;47.5;25.1
18;2021-06-08;1490;1394;142164;75709;48.0;25.5
18;2021-06-09;1330;1068;143494;76777;48.4;25.9
18;2021-06-10;1631;1410;145125;78187;49.0;26.4
18;2021-06-11;1496;1404;146621;79591;49.5;26.9
18;2021-06-12;1245;2510;147866;82101;49.9;27.7
18;2021-06-13;126;263;147992;82364;49.9;27.8
18;2021-06-14;656;1828;148648;84192;50.2;28.4
18;2021-06-15;1093;1823;149741;86015;50.5;29.0
18;2021-06-16;1255;1441;150996;87456;50.9;29.5
18;2021-06-17;1205;1670;152201;89126;51.3;30.1
18;2021-06-18;1290;1667;153491;90793;51.8;30.6
18;2021-06-19;1564;1251;155055;92044;52.3;31.1
18;2021-06-20;246;159;155301;92203;52.4;31.1
18;2021-06-21;665;1601;155966;93804;52.6;31.6
18;2021-06-22;1068;1645;157034;95449;53.0;32.2
18;2021-06-23;944;1642;157978;97091;53.3;32.8
18;2021-06-24;1033;1062;159011;98153;53.6;33.1
18;2021-06-25;892;1746;159903;99899;53.9;33.7
18;2021-06-26;1097;1473;161000;101372;54.3;34.2
18;2021-06-27;31;372;161031;101744;54.3;34.3
18;2021-06-28;422;1922;161453;103666;54.5;35.0
18;2021-06-29;597;2379;162050;106045;54.7;35.8
18;2021-06-30;600;2543;162650;108588;54.9;36.6
18;2021-07-01;964;2157;163614;110745;55.2;37.4
18;2021-07-02;614;1686;164228;112431;55.4;37.9
18;2021-07-03;754;2574;164982;115005;55.7;38.8
18;2021-07-04;164;1032;165146;116037;55.7;39.1
18;2021-07-05;765;1877;165911;117914;56.0;39.8
18;2021-07-06;559;2301;166470;120215;56.2;40.6
18;2021-07-07;766;2115;167236;122330;56.4;41.3
18;2021-07-08;1031;1984;168267;124314;56.8;41.9
18;2021-07-09;703;2307;168970;126621;57.0;42.7
18;2021-07-10;781;3175;169751;129796;57.3;43.8
18;2021-07-11;84;668;169835;130464;57.3;44.0
18;2021-07-12;223;2253;170058;132717;57.4;44.8
18;2021-07-13;619;2904;170677;135621;57.6;45.8
18;2021-07-14;194;937;170871;136558;57.6;46.1
18;2021-07-15;1396;2816;172267;139374;58.1;47.0
18;2021-07-16;1185;2122;173452;141496;58.5;47.7
18;2021-07-17;1130;2472;174582;143968;58.9;48.6
18;2021-07-18;228;332;174810;144300;59.0;48.7
18;2021-07-19;1055;1657;175865;145957;59.3;49.2
18;2021-07-20;1625;2269;177490;148226;59.9;50.0
18;2021-07-21;1901;2062;179391;150288;60.5;50.7
18;2021-07-22;2211;1902;181602;152190;61.3;51.3
18;2021-07-23;1395;1613;182997;153803;61.7;51.9
18;2021-07-24;891;1534;183888;155337;62.0;52.4
18;2021-07-25;192;396;184080;155733;62.1;52.5
18;2021-07-26;1397;1502;185477;157235;62.6;53.0
18;2021-07-27;1824;1539;187301;158774;63.2;53.6
18;2021-07-28;2198;1797;189499;160571;63.9;54.2
18;2021-07-29;2140;1817;191639;162388;64.7;54.8
18;2021-07-30;1585;1344;193224;163732;65.2;55.2
18;2021-07-31;1237;1281;194461;165013;65.6;55.7
18;2021-08-01;90;34;194551;165047;65.6;55.7
18;2021-08-02;1410;765;195961;165812;66.1;55.9
18;2021-08-03;1719;1630;197680;167442;66.7;56.5
18;2021-08-04;2441;1102;200121;168544;67.5;56.9
18;2021-08-05;1529;1247;201650;169791;68.0;57.3
18;2021-08-06;1582;1142;203232;170933;68.6;57.7
18;2021-08-07;610;764;203842;171697;68.8;57.9
18;2021-08-08;49;60;203891;171757;68.8;57.9
18;2021-08-09;1105;875;204996;172632;69.2;58.2
18;2021-08-10;1208;1511;206204;174143;69.6;58.8
18;2021-08-11;1608;1510;207812;175653;70.1;59.3
18;2021-08-12;1554;1594;209366;177247;70.6;59.8
18;2021-08-13;1087;1172;210453;178419;71.0;60.2
18;2021-08-14;759;603;211212;179022;71.3;60.4
18;2021-08-15;35;17;211247;179039;71.3;60.4
18;2021-08-16;830;1201;212077;180240;71.5;60.8
18;2021-08-17;979;1999;213056;182239;71.9;61.5
18;2021-08-18;1158;1961;214214;184200;72.3;62.1
18;2021-08-19;1105;1612;215319;185812;72.6;62.7
18;2021-08-20;911;1758;216230;187570;73.0;63.3
18;2021-08-21;420;705;216650;188275;73.1;63.5
18;2021-08-22;22;73;216672;188348;73.1;63.5
18;2021-08-23;487;1680;217159;190028;73.3;64.1
18;2021-08-24;903;1494;218062;191522;73.6;64.6
18;2021-08-25;840;1864;218902;193386;73.9;65.2
18;2021-08-26;772;1532;219674;194918;74.1;65.8
18;2021-08-27;575;1994;220249;196912;74.3;66.4
18;2021-08-28;501;873;220750;197785;74.5;66.7
18;2021-08-29;92;176;220842;197961;74.5;66.8
18;2021-08-30;528;1409;221370;199370;74.7;67.3
18;2021-08-31;507;1397;221877;200767;74.9;67.7
18;2021-09-01;577;1509;222454;202276;75.1;68.2
18;2021-09-02;398;1108;222852;203384;75.2;68.6
18;2021-09-03;455;1141;223307;204525;75.3;69.0
18;2021-09-04;357;736;223664;205261;75.5;69.3
18;2021-09-05;29;56;223693;205317;75.5;69.3
18;2021-09-06;279;871;223972;206188;75.6;69.6
18;2021-09-07;282;828;224254;207016;75.7;69.8
18;2021-09-08;405;1032;224659;208048;75.8;70.2
18;2021-09-09;357;988;225016;209036;75.9;70.5
18;2021-09-10;414;933;225430;209969;76.1;70.8
18;2021-09-11;262;783;225692;210752;76.1;71.1
18;2021-09-12;8;19;225700;210771;76.1;71.1
18;2021-09-13;311;704;226011;211475;76.3;71.3
18;2021-09-14;283;775;226294;212250;76.3;71.6
18;2021-09-15;323;1054;226617;213304;76.5;72.0
18;2021-09-16;471;878;227088;214182;76.6;72.3
18;2021-09-17;337;738;227425;214920;76.7;72.5
18;2021-09-18;186;622;227611;215542;76.8;72.7
18;2021-09-19;6;4;227617;215546;76.8;72.7
18;2021-09-20;157;550;227774;216096;76.8;72.9
18;2021-09-21;114;424;227888;216520;76.9;73.0
18;2021-09-22;194;870;228082;217390;76.9;73.3
18;2021-09-23;250;465;228332;217855;77.0;73.5
18;2021-09-24;141;490;228473;218345;77.1;73.7
18;2021-09-25;159;690;228632;219035;77.1;73.9
18;2021-09-26;15;89;228647;219124;77.1;73.9
18;2021-09-27;109;315;228756;219439;77.2;74.0
18;2021-09-28;70;273;228826;219712;77.2;74.1
18;2021-09-29;68;281;228894;219993;77.2;74.2
18;2021-09-30;116;280;229010;220273;77.3;74.3
18;2021-10-01;144;289;229154;220562;77.3;74.4
18;2021-10-02;62;163;229216;220725;77.3;74.5
18;2021-10-03;6;10;229222;220735;77.3;74.5
18;2021-10-04;143;457;229365;221192;77.4;74.6
18;2021-10-05;161;336;229526;221528;77.4;74.7
18;2021-10-06;134;442;229660;221970;77.5;74.9
18;2021-10-07;99;374;229759;222344;77.5;75.0
18;2021-10-08;146;520;229905;222864;77.6;75.2
18;2021-10-09;119;315;230024;223179;77.6;75.3
18;2021-10-10;4;13;230028;223192;77.6;75.3
18;2021-10-11;156;199;230184;223391;77.7;75.4
18;2021-10-12;140;205;230324;223596;77.7;75.4
18;2021-10-13;168;220;230492;223816;77.8;75.5
18;2021-10-14;58;220;230550;224036;77.8;75.6
18;2021-10-15;164;307;230714;224343;77.8;75.7
18;2021-10-16;151;235;230865;224578;77.9;75.8
18;2021-10-17;8;15;230873;224593;77.9;75.8
18;2021-10-18;115;158;230988;224751;77.9;75.8
18;2021-10-19;102;107;231090;224858;78.0;75.9
19;2020-12-27;0;0;0;0;0.0;0.0
19;2020-12-28;0;0;0;0;0.0;0.0
19;2020-12-29;1;0;1;0;0.0;0.0
19;2020-12-30;0;0;1;0;0.0;0.0
19;2020-12-31;0;0;1;0;0.0;0.0
19;2021-01-01;0;0;1;0;0.0;0.0
19;2021-01-02;0;0;1;0;0.0;0.0
19;2021-01-03;0;0;1;0;0.0;0.0
19;2021-01-04;0;0;1;0;0.0;0.0
19;2021-01-05;0;0;1;0;0.0;0.0
19;2021-01-06;0;0;1;0;0.0;0.0
19;2021-01-07;344;2;345;2;0.1;0.0
19;2021-01-08;248;1;593;3;0.2;0.0
19;2021-01-09;1;0;594;3;0.2;0.0
19;2021-01-10;1;0;595;3;0.2;0.0
19;2021-01-11;38;0;633;3;0.3;0.0
19;2021-01-12;416;2;1049;5;0.4;0.0
19;2021-01-13;429;11;1478;16;0.6;0.0
19;2021-01-14;475;1;1953;17;0.8;0.0
19;2021-01-15;226;18;2179;35;0.9;0.0
19;2021-01-16;0;0;2179;35;0.9;0.0
19;2021-01-17;1;0;2180;35;0.9;0.0
19;2021-01-18;251;2;2431;37;1.0;0.0
19;2021-01-19;521;0;2952;37;1.2;0.0
19;2021-01-20;921;9;3873;46;1.6;0.0
19;2021-01-21;507;5;4380;51;1.8;0.0
19;2021-01-22;1318;18;5698;69;2.4;0.0
19;2021-01-23;281;0;5979;69;2.5;0.0
19;2021-01-24;38;0;6017;69;2.5;0.0
19;2021-01-25;233;0;6250;69;2.6;0.0
19;2021-01-26;608;4;6858;73;2.9;0.0
19;2021-01-27;334;5;7192;78;3.0;0.0
19;2021-01-28;296;251;7488;329;3.1;0.1
19;2021-01-29;348;61;7836;390;3.3;0.2
19;2021-01-30;130;26;7966;416;3.3;0.2
19;2021-01-31;41;1;8007;417;3.3;0.2
19;2021-02-01;158;95;8165;512;3.4;0.2
19;2021-02-02;303;429;8468;941;3.5;0.4
19;2021-02-03;285;246;8753;1187;3.6;0.5
19;2021-02-04;255;375;9008;1562;3.7;0.6
19;2021-02-05;311;76;9319;1638;3.9;0.7
19;2021-02-06;215;2;9534;1640;4.0;0.7
19;2021-02-07;48;2;9582;1642;4.0;0.7
19;2021-02-08;177;150;9759;1792;4.1;0.7
19;2021-02-09;333;274;10092;2066;4.2;0.9
19;2021-02-10;517;296;10609;2362;4.4;1.0
19;2021-02-11;414;319;11023;2681;4.6;1.1
19;2021-02-12;799;1161;11822;3842;4.9;1.6
19;2021-02-13;352;187;12174;4029;5.1;1.7
19;2021-02-14;99;13;12273;4042;5.1;1.7
19;2021-02-15;200;243;12473;4285;5.2;1.8
19;2021-02-16;386;171;12859;4456;5.4;1.9
19;2021-02-17;306;468;13165;4924;5.5;2.0
19;2021-02-18;174;507;13339;5431;5.6;2.3
19;2021-02-19;469;299;13808;5730;5.7;2.4
19;2021-02-20;133;207;13941;5937;5.8;2.5
19;2021-02-21;20;40;13961;5977;5.8;2.5
19;2021-02-22;221;211;14182;6188;5.9;2.6
19;2021-02-23;268;345;14450;6533;6.0;2.7
19;2021-02-24;361;208;14811;6741;6.2;2.8
19;2021-02-25;519;382;15330;7123;6.4;3.0
19;2021-02-26;395;318;15725;7441;6.5;3.1
19;2021-02-27;349;162;16074;7603;6.7;3.2
19;2021-02-28;68;36;16142;7639;6.7;3.2
19;2021-03-01;266;221;16408;7860;6.8;3.3
19;2021-03-02;428;258;16836;8118;7.0;3.4
19;2021-03-03;692;340;17528;8458;7.3;3.5
19;2021-03-04;826;353;18354;8811;7.6;3.7
19;2021-03-05;891;737;19245;9548;8.0;4.0
19;2021-03-06;1072;216;20317;9764;8.5;4.1
19;2021-03-07;463;38;20780;9802;8.6;4.1
19;2021-03-08;640;166;21420;9968;8.9;4.1
19;2021-03-09;836;251;22256;10219;9.3;4.3
19;2021-03-10;1155;321;23411;10540;9.7;4.4
19;2021-03-11;1274;309;24685;10849;10.3;4.5
19;2021-03-12;1136;407;25821;11256;10.7;4.7
19;2021-03-13;1110;169;26931;11425;11.2;4.8
19;2021-03-14;161;85;27092;11510;11.3;4.8
19;2021-03-15;699;137;27791;11647;11.6;4.8
19;2021-03-16;688;304;28479;11951;11.8;5.0
19;2021-03-17;839;283;29318;12234;12.2;5.1
19;2021-03-18;767;283;30085;12517;12.5;5.2
19;2021-03-19;1014;488;31099;13005;12.9;5.4
19;2021-03-20;785;132;31884;13137;13.3;5.5
19;2021-03-21;128;4;32012;13141;13.3;5.5
19;2021-03-22;548;177;32560;13318;13.5;5.5
19;2021-03-23;1046;234;33606;13552;14.0;5.6
19;2021-03-24;1172;373;34778;13925;14.5;5.8
19;2021-03-25;1189;415;35967;14340;15.0;6.0
19;2021-03-26;1325;279;37292;14619;15.5;6.1
19;2021-03-27;854;192;38146;14811;15.9;6.2
19;2021-03-28;63;60;38209;14871;15.9;6.2
19;2021-03-29;612;177;38821;15048;16.2;6.3
19;2021-03-30;971;344;39792;15392;16.6;6.4
19;2021-03-31;1157;498;40949;15890;17.0;6.6
19;2021-04-01;1491;429;42440;16319;17.7;6.8
19;2021-04-02;1008;528;43448;16847;18.1;7.0
19;2021-04-03;597;285;44045;17132;18.3;7.1
19;2021-04-04;130;3;44175;17135;18.4;7.1
19;2021-04-05;40;76;44215;17211;18.4;7.2
19;2021-04-06;734;604;44949;17815;18.7;7.4
19;2021-04-07;976;732;45925;18547;19.1;7.7
19;2021-04-08;1116;1020;47041;19567;19.6;8.1
19;2021-04-09;1641;616;48682;20183;20.3;8.4
19;2021-04-10;946;560;49628;20743;20.6;8.6
19;2021-04-11;557;74;50185;20817;20.9;8.7
19;2021-04-12;681;524;50866;21341;21.2;8.9
19;2021-04-13;915;576;51781;21917;21.5;9.1
19;2021-04-14;1333;852;53114;22769;22.1;9.5
19;2021-04-15;1229;873;54343;23642;22.6;9.8
19;2021-04-16;1504;822;55847;24464;23.2;10.2
19;2021-04-17;761;480;56608;24944;23.6;10.4
19;2021-04-18;661;72;57269;25016;23.8;10.4
19;2021-04-19;730;440;57999;25456;24.1;10.6
19;2021-04-20;979;751;58978;26207;24.5;10.9
19;2021-04-21;1271;700;60249;26907;25.1;11.2
19;2021-04-22;1188;900;61437;27807;25.6;11.6
19;2021-04-23;1127;1020;62564;28827;26.0;12.0
19;2021-04-24;678;676;63242;29503;26.3;12.3
19;2021-04-25;675;70;63917;29573;26.6;12.3
19;2021-04-26;1056;332;64973;29905;27.0;12.4
19;2021-04-27;1027;569;66000;30474;27.5;12.7
19;2021-04-28;1553;557;67553;31031;28.1;12.9
19;2021-04-29;1453;1197;69006;32228;28.7;13.4
19;2021-04-30;1876;1062;70882;33290;29.5;13.9
19;2021-05-01;671;175;71553;33465;29.8;13.9
19;2021-05-02;551;152;72104;33617;30.0;14.0
19;2021-05-03;854;547;72958;34164;30.4;14.2
19;2021-05-04;1025;709;73983;34873;30.8;14.5
19;2021-05-05;1256;741;75239;35614;31.3;14.8
19;2021-05-06;1127;1200;76366;36814;31.8;15.3
19;2021-05-07;1663;1191;78029;38005;32.5;15.8
19;2021-05-08;712;206;78741;38211;32.8;15.9
19;2021-05-09;487;547;79228;38758;33.0;16.1
19;2021-05-10;1164;671;80392;39429;33.4;16.4
19;2021-05-11;1639;858;82031;40287;34.1;16.8
19;2021-05-12;1945;1322;83976;41609;34.9;17.3
19;2021-05-13;571;242;84547;41851;35.2;17.4
19;2021-05-14;1646;988;86193;42839;35.9;17.8
19;2021-05-15;1443;593;87636;43432;36.5;18.1
19;2021-05-16;350;82;87986;43514;36.6;18.1
19;2021-05-17;1498;559;89484;44073;37.2;18.3
19;2021-05-18;1669;500;91153;44573;37.9;18.5
19;2021-05-19;2009;829;93162;45402;38.8;18.9
19;2021-05-20;1722;892;94884;46294;39.5;19.3
19;2021-05-21;1964;814;96848;47108;40.3;19.6
19;2021-05-22;1271;651;98119;47759;40.8;19.9
19;2021-05-23;324;131;98443;47890;41.0;19.9
19;2021-05-24;139;46;98582;47936;41.0;19.9
19;2021-05-25;1503;492;100085;48428;41.6;20.2
19;2021-05-26;1924;666;102009;49094;42.4;20.4
19;2021-05-27;1786;837;103795;49931;43.2;20.8
19;2021-05-28;1937;991;105732;50922;44.0;21.2
19;2021-05-29;1375;705;107107;51627;44.6;21.5
19;2021-05-30;191;497;107298;52124;44.6;21.7
19;2021-05-31;1199;537;108497;52661;45.1;21.9
19;2021-06-01;1284;886;109781;53547;45.7;22.3
19;2021-06-02;1816;958;111597;54505;46.4;22.7
19;2021-06-03;1447;1255;113044;55760;47.0;23.2
19;2021-06-04;1848;1358;114892;57118;47.8;23.8
19;2021-06-05;1210;815;116102;57933;48.3;24.1
19;2021-06-06;87;648;116189;58581;48.3;24.4
19;2021-06-07;923;935;117112;59516;48.7;24.8
19;2021-06-08;1104;906;118216;60422;49.2;25.1
19;2021-06-09;1328;1463;119544;61885;49.7;25.7
19;2021-06-10;1283;1580;120827;63465;50.3;26.4
19;2021-06-11;1306;1921;122133;65386;50.8;27.2
19;2021-06-12;1356;1317;123489;66703;51.4;27.8
19;2021-06-13;542;424;124031;67127;51.6;27.9
19;2021-06-14;736;1016;124767;68143;51.9;28.4
19;2021-06-15;979;1143;125746;69286;52.3;28.8
19;2021-06-16;1222;1363;126968;70649;52.8;29.4
19;2021-06-17;868;1788;127836;72437;53.2;30.1
19;2021-06-18;1056;2135;128892;74572;53.6;31.0
19;2021-06-19;919;1302;129811;75874;54.0;31.6
19;2021-06-20;395;327;130206;76201;54.2;31.7
19;2021-06-21;500;1074;130706;77275;54.4;32.2
19;2021-06-22;698;1490;131404;78765;54.7;32.8
19;2021-06-23;744;1989;132148;80754;55.0;33.6
19;2021-06-24;687;1663;132835;82417;55.3;34.3
19;2021-06-25;562;2216;133397;84633;55.5;35.2
19;2021-06-26;474;1741;133871;86374;55.7;35.9
19;2021-06-27;289;446;134160;86820;55.8;36.1
19;2021-06-28;315;1499;134475;88319;56.0;36.7
19;2021-06-29;353;1893;134828;90212;56.1;37.5
19;2021-06-30;796;2152;135624;92364;56.4;38.4
19;2021-07-01;361;2322;135985;94686;56.6;39.4
19;2021-07-02;798;2316;136783;97002;56.9;40.4
19;2021-07-03;513;1744;137296;98746;57.1;41.1
19;2021-07-04;1;73;137297;98819;57.1;41.1
19;2021-07-05;600;1015;137897;99834;57.4;41.5
19;2021-07-06;504;1541;138401;101375;57.6;42.2
19;2021-07-07;706;2046;139107;103421;57.9;43.0
19;2021-07-08;770;2148;139877;105569;58.2;43.9
19;2021-07-09;716;2659;140593;108228;58.5;45.0
19;2021-07-10;586;1708;141179;109936;58.7;45.7
19;2021-07-11;45;212;141224;110148;58.8;45.8
19;2021-07-12;446;1487;141670;111635;58.9;46.4
19;2021-07-13;687;1828;142357;113463;59.2;47.2
19;2021-07-14;201;272;142558;113735;59.3;47.3
19;2021-07-15;870;2050;143428;115785;59.7;48.2
19;2021-07-16;1228;2445;144656;118230;60.2;49.2
19;2021-07-17;703;1718;145359;119948;60.5;49.9
19;2021-07-18;365;672;145724;120620;60.6;50.2
19;2021-07-19;968;1401;146692;122021;61.0;50.8
19;2021-07-20;967;1676;147659;123697;61.4;51.5
19;2021-07-21;1083;1711;148742;125408;61.9;52.2
19;2021-07-22;1392;1858;150134;127266;62.5;53.0
19;2021-07-23;1785;1996;151919;129262;63.2;53.8
19;2021-07-24;908;1753;152827;131015;63.6;54.5
19;2021-07-25;164;513;152991;131528;63.7;54.7
19;2021-07-26;911;911;153902;132439;64.0;55.1
19;2021-07-27;1424;1117;155326;133556;64.6;55.6
19;2021-07-28;2045;1224;157371;134780;65.5;56.1
19;2021-07-29;1623;1204;158994;135984;66.2;56.6
19;2021-07-30;1909;1027;160903;137011;66.9;57.0
19;2021-07-31;1129;1018;162032;138029;67.4;57.4
19;2021-08-01;347;373;162379;138402;67.6;57.6
19;2021-08-02;1194;810;163573;139212;68.1;57.9
19;2021-08-03;1453;1055;165026;140267;68.7;58.4
19;2021-08-04;1983;763;167009;141030;69.5;58.7
19;2021-08-05;1630;958;168639;141988;70.2;59.1
19;2021-08-06;1964;1220;170603;143208;71.0;59.6
19;2021-08-07;1335;1001;171938;144209;71.5;60.0
19;2021-08-08;187;234;172125;144443;71.6;60.1
19;2021-08-09;1009;784;173134;145227;72.0;60.4
19;2021-08-10;1280;1014;174414;146241;72.6;60.8
19;2021-08-11;1356;1006;175770;147247;73.1;61.3
19;2021-08-12;1016;1276;176786;148523;73.6;61.8
19;2021-08-13;1181;1275;177967;149798;74.0;62.3
19;2021-08-14;979;1165;178946;150963;74.5;62.8
19;2021-08-15;30;54;178976;151017;74.5;62.8
19;2021-08-16;592;1029;179568;152046;74.7;63.3
19;2021-08-17;633;1167;180201;153213;75.0;63.7
19;2021-08-18;656;979;180857;154192;75.3;64.2
19;2021-08-19;438;1258;181295;155450;75.4;64.7
19;2021-08-20;867;1927;182162;157377;75.8;65.5
19;2021-08-21;495;1376;182657;158753;76.0;66.1
19;2021-08-22;52;93;182709;158846;76.0;66.1
19;2021-08-23;226;1158;182935;160004;76.1;66.6
19;2021-08-24;538;1317;183473;161321;76.3;67.1
19;2021-08-25;649;1557;184122;162878;76.6;67.8
19;2021-08-26;477;1463;184599;164341;76.8;68.4
19;2021-08-27;501;1689;185100;166030;77.0;69.1
19;2021-08-28;360;1277;185460;167307;77.2;69.6
19;2021-08-29;60;182;185520;167489;77.2;69.7
19;2021-08-30;224;1089;185744;168578;77.3;70.1
19;2021-08-31;326;1352;186070;169930;77.4;70.7
19;2021-09-01;365;1433;186435;171363;77.6;71.3
19;2021-09-02;348;1193;186783;172556;77.7;71.8
19;2021-09-03;411;1423;187194;173979;77.9;72.4
19;2021-09-04;302;1361;187496;175340;78.0;73.0
19;2021-09-05;32;106;187528;175446;78.0;73.0
19;2021-09-06;197;630;187725;176076;78.1;73.3
19;2021-09-07;229;755;187954;176831;78.2;73.6
19;2021-09-08;287;742;188241;177573;78.3;73.9
19;2021-09-09;257;536;188498;178109;78.4;74.1
19;2021-09-10;252;708;188750;178817;78.5;74.4
19;2021-09-11;295;1055;189045;179872;78.7;74.8
19;2021-09-12;42;70;189087;179942;78.7;74.9
19;2021-09-13;107;245;189194;180187;78.7;75.0
19;2021-09-14;171;387;189365;180574;78.8;75.1
19;2021-09-15;245;669;189610;181243;78.9;75.4
19;2021-09-16;234;411;189844;181654;79.0;75.6
19;2021-09-17;258;531;190102;182185;79.1;75.8
19;2021-09-18;184;689;190286;182874;79.2;76.1
19;2021-09-19;17;34;190303;182908;79.2;76.1
19;2021-09-20;112;205;190415;183113;79.2;76.2
19;2021-09-21;143;296;190558;183409;79.3;76.3
19;2021-09-22;152;398;190710;183807;79.4;76.5
19;2021-09-23;87;300;190797;184107;79.4;76.6
19;2021-09-24;125;361;190922;184468;79.4;76.8
19;2021-09-25;140;568;191062;185036;79.5;77.0
19;2021-09-26;14;25;191076;185061;79.5;77.0
19;2021-09-27;43;215;191119;185276;79.5;77.1
19;2021-09-28;67;202;191186;185478;79.5;77.2
19;2021-09-29;82;341;191268;185819;79.6;77.3
19;2021-09-30;104;272;191372;186091;79.6;77.4
19;2021-10-01;115;233;191487;186324;79.7;77.5
19;2021-10-02;151;340;191638;186664;79.7;77.7
19;2021-10-03;9;11;191647;186675;79.7;77.7
19;2021-10-04;56;134;191703;186809;79.8;77.7
19;2021-10-05;100;187;191803;186996;79.8;77.8
19;2021-10-06;108;249;191911;187245;79.9;77.9
19;2021-10-07;65;242;191976;187487;79.9;78.0
19;2021-10-08;81;222;192057;187709;79.9;78.1
19;2021-10-09;146;276;192203;187985;80.0;78.2
19;2021-10-10;3;10;192206;187995;80.0;78.2
19;2021-10-11;55;164;192261;188159;80.0;78.3
19;2021-10-12;102;184;192363;188343;80.0;78.4
19;2021-10-13;103;192;192466;188535;80.1;78.4
19;2021-10-14;76;102;192542;188637;80.1;78.5
19;2021-10-15;81;139;192623;188776;80.1;78.5
19;2021-10-16;140;247;192763;189023;80.2;78.6
19;2021-10-17;2;24;192765;189047;80.2;78.7
19;2021-10-18;43;78;192808;189125;80.2;78.7
19;2021-10-19;64;76;192872;189201;80.3;78.7
21;2020-12-27;4;0;4;0;0.0;0.0
21;2020-12-28;2;0;6;0;0.0;0.0
21;2020-12-29;19;0;25;0;0.0;0.0
21;2020-12-30;22;0;47;0;0.0;0.0
21;2020-12-31;0;0;47;0;0.0;0.0
21;2021-01-01;0;0;47;0;0.0;0.0
21;2021-01-02;1;0;48;0;0.0;0.0
21;2021-01-03;1;0;49;0;0.0;0.0
21;2021-01-04;23;0;72;0;0.0;0.0
21;2021-01-05;251;2;323;2;0.1;0.0
21;2021-01-06;300;0;623;2;0.1;0.0
21;2021-01-07;389;1;1012;3;0.2;0.0
21;2021-01-08;455;2;1467;5;0.3;0.0
21;2021-01-09;252;0;1719;5;0.3;0.0
21;2021-01-10;2;1;1721;6;0.3;0.0
21;2021-01-11;624;1;2345;7;0.4;0.0
21;2021-01-12;656;0;3001;7;0.6;0.0
21;2021-01-13;707;2;3708;9;0.7;0.0
21;2021-01-14;1190;11;4898;20;0.9;0.0
21;2021-01-15;719;5;5617;25;1.1;0.0
21;2021-01-16;161;1;5778;26;1.1;0.0
21;2021-01-17;5;0;5783;26;1.1;0.0
21;2021-01-18;1318;7;7101;33;1.3;0.0
21;2021-01-19;1371;5;8472;38;1.6;0.0
21;2021-01-20;1300;49;9772;87;1.8;0.0
21;2021-01-21;1543;8;11315;95;2.1;0.0
21;2021-01-22;1246;5;12561;100;2.4;0.0
21;2021-01-23;490;1;13051;101;2.4;0.0
21;2021-01-24;124;0;13175;101;2.5;0.0
21;2021-01-25;928;20;14103;121;2.6;0.0
21;2021-01-26;1546;147;15649;268;2.9;0.1
21;2021-01-27;2061;172;17710;440;3.3;0.1
21;2021-01-28;1460;240;19170;680;3.6;0.1
21;2021-01-29;1022;212;20192;892;3.8;0.2
21;2021-01-30;470;32;20662;924;3.9;0.2
21;2021-01-31;97;3;20759;927;3.9;0.2
21;2021-02-01;453;287;21212;1214;4.0;0.2
21;2021-02-02;457;442;21669;1656;4.1;0.3
21;2021-02-03;446;284;22115;1940;4.2;0.4
21;2021-02-04;417;541;22532;2481;4.2;0.5
21;2021-02-05;489;526;23021;3007;4.3;0.6
21;2021-02-06;162;228;23183;3235;4.4;0.6
21;2021-02-07;2;2;23185;3237;4.4;0.6
21;2021-02-08;433;390;23618;3627;4.4;0.7
21;2021-02-09;516;524;24134;4151;4.5;0.8
21;2021-02-10;461;584;24595;4735;4.6;0.9
21;2021-02-11;486;750;25081;5485;4.7;1.0
21;2021-02-12;356;936;25437;6421;4.8;1.2
21;2021-02-13;365;325;25802;6746;4.8;1.3
21;2021-02-14;239;149;26041;6895;4.9;1.3
21;2021-02-15;120;1407;26161;8302;4.9;1.6
21;2021-02-16;207;1567;26368;9869;4.9;1.9
21;2021-02-17;405;1989;26773;11858;5.0;2.2
21;2021-02-18;604;1353;27377;13211;5.1;2.5
21;2021-02-19;218;1136;27595;14347;5.2;2.7
21;2021-02-20;121;425;27716;14772;5.2;2.8
21;2021-02-21;1;83;27717;14855;5.2;2.8
21;2021-02-22;84;773;27801;15628;5.2;2.9
21;2021-02-23;169;1040;27970;16668;5.2;3.1
21;2021-02-24;226;745;28196;17413;5.3;3.3
21;2021-02-25;647;831;28843;18244;5.4;3.4
21;2021-02-26;927;720;29770;18964;5.6;3.6
21;2021-02-27;532;300;30302;19264;5.7;3.6
21;2021-02-28;24;133;30326;19397;5.7;3.6
21;2021-03-01;680;630;31006;20027;5.8;3.8
21;2021-03-02;1055;556;32061;20583;6.0;3.9
21;2021-03-03;1169;449;33230;21032;6.2;3.9
21;2021-03-04;1689;521;34919;21553;6.6;4.0
21;2021-03-05;2196;668;37115;22221;7.0;4.2
21;2021-03-06;1594;202;38709;22423;7.3;4.2
21;2021-03-07;4;16;38713;22439;7.3;4.2
21;2021-03-08;773;449;39486;22888;7.4;4.3
21;2021-03-09;1572;577;41058;23465;7.7;4.4
21;2021-03-10;1628;563;42686;24028;8.0;4.5
21;2021-03-11;2198;704;44884;24732;8.4;4.6
21;2021-03-12;2905;443;47789;25175;9.0;4.7
21;2021-03-13;1932;190;49721;25365;9.3;4.8
21;2021-03-14;38;48;49759;25413;9.3;4.8
21;2021-03-15;1416;88;51175;25501;9.6;4.8
21;2021-03-16;1884;159;53059;25660;10.0;4.8
21;2021-03-17;1810;120;54869;25780;10.3;4.8
21;2021-03-18;2129;272;56998;26052;10.7;4.9
21;2021-03-19;1964;151;58962;26203;11.1;4.9
21;2021-03-20;1228;38;60190;26241;11.3;4.9
21;2021-03-21;2;0;60192;26241;11.3;4.9
21;2021-03-22;1556;93;61748;26334;11.6;4.9
21;2021-03-23;2696;111;64444;26445;12.1;5.0
21;2021-03-24;2896;165;67340;26610;12.6;5.0
21;2021-03-25;3731;249;71071;26859;13.3;5.0
21;2021-03-26;3655;207;74726;27066;14.0;5.1
21;2021-03-27;1732;62;76458;27128;14.3;5.1
21;2021-03-28;200;38;76658;27166;14.4;5.1
21;2021-03-29;1788;522;78446;27688;14.7;5.2
21;2021-03-30;2347;810;80793;28498;15.2;5.3
21;2021-03-31;2718;656;83511;29154;15.7;5.5
21;2021-04-01;2694;725;86205;29879;16.2;5.6
21;2021-04-02;2250;749;88455;30628;16.6;5.7
21;2021-04-03;1018;282;89473;30910;16.8;5.8
21;2021-04-04;2;12;89475;30922;16.8;5.8
21;2021-04-05;9;0;89484;30922;16.8;5.8
21;2021-04-06;1359;1140;90843;32062;17.0;6.0
21;2021-04-07;1750;971;92593;33033;17.4;6.2
21;2021-04-08;3217;1152;95810;34185;18.0;6.4
21;2021-04-09;3481;1190;99291;35375;18.6;6.6
21;2021-04-10;1376;750;100667;36125;18.9;6.8
21;2021-04-11;145;4;100812;36129;18.9;6.8
21;2021-04-12;1118;1348;101930;37477;19.1;7.0
21;2021-04-13;1654;1787;103584;39264;19.4;7.4
21;2021-04-14;1485;1475;105069;40739;19.7;7.6
21;2021-04-15;1899;1594;106968;42333;20.1;7.9
21;2021-04-16;2323;1316;109291;43649;20.5;8.2
21;2021-04-17;1021;978;110312;44627;20.7;8.4
21;2021-04-18;15;4;110327;44631;20.7;8.4
21;2021-04-19;1110;1323;111437;45954;20.9;8.6
21;2021-04-20;1245;1837;112682;47791;21.1;9.0
21;2021-04-21;1096;1723;113778;49514;21.4;9.3
21;2021-04-22;1275;2219;115053;51733;21.6;9.7
21;2021-04-23;1984;1732;117037;53465;22.0;10.0
21;2021-04-24;1002;874;118039;54339;22.2;10.2
21;2021-04-25;9;169;118048;54508;22.2;10.2
21;2021-04-26;1013;1598;119061;56106;22.3;10.5
21;2021-04-27;1843;1943;120904;58049;22.7;10.9
21;2021-04-28;2231;2231;123135;60280;23.1;11.3
21;2021-04-29;3135;2273;126270;62553;23.7;11.7
21;2021-04-30;3563;1866;129833;64419;24.4;12.1
21;2021-05-01;962;227;130795;64646;24.5;12.1
21;2021-05-02;2;5;130797;64651;24.5;12.1
21;2021-05-03;2082;1351;132879;66002;24.9;12.4
21;2021-05-04;2578;1651;135457;67653;25.4;12.7
21;2021-05-05;2247;1692;137704;69345;25.8;13.0
21;2021-05-06;3016;2252;140720;71597;26.4;13.4
21;2021-05-07;2805;2181;143525;73778;26.9;13.8
21;2021-05-08;1067;272;144592;74050;27.1;13.9
21;2021-05-09;26;177;144618;74227;27.1;13.9
21;2021-05-10;3170;1731;147788;75958;27.7;14.3
21;2021-05-11;4923;2006;152711;77964;28.7;14.6
21;2021-05-12;4805;1750;157516;79714;29.6;15.0
21;2021-05-13;3845;369;161361;80083;30.3;15.0
21;2021-05-14;5196;1472;166557;81555;31.3;15.3
21;2021-05-15;3428;647;169985;82202;31.9;15.4
21;2021-05-16;49;4;170034;82206;31.9;15.4
21;2021-05-17;4128;1259;174162;83465;32.7;15.7
21;2021-05-18;4360;1503;178522;84968;33.5;15.9
21;2021-05-19;3470;1128;181992;86096;34.2;16.2
21;2021-05-20;3898;1362;185890;87458;34.9;16.4
21;2021-05-21;3628;2158;189518;89616;35.6;16.8
21;2021-05-22;1669;771;191187;90387;35.9;17.0
21;2021-05-23;4;17;191191;90404;35.9;17.0
21;2021-05-24;1815;266;193006;90670;36.2;17.0
21;2021-05-25;2648;1963;195654;92633;36.7;17.4
21;2021-05-26;2604;2000;198258;94633;37.2;17.8
21;2021-05-27;4014;2099;202272;96732;38.0;18.2
21;2021-05-28;3572;2822;205844;99554;38.6;18.7
21;2021-05-29;1932;1470;207776;101024;39.0;19.0
21;2021-05-30;98;13;207874;101037;39.0;19.0
21;2021-05-31;2501;1781;210375;102818;39.5;19.3
21;2021-06-01;3449;2254;213824;105072;40.1;19.7
21;2021-06-02;2617;1760;216441;106832;40.6;20.0
21;2021-06-03;3146;2077;219587;108909;41.2;20.4
21;2021-06-04;3286;2591;222873;111500;41.8;20.9
21;2021-06-05;2921;1653;225794;113153;42.4;21.2
21;2021-06-06;51;85;225845;113238;42.4;21.2
21;2021-06-07;4314;1347;230159;114585;43.2;21.5
21;2021-06-08;4935;2146;235094;116731;44.1;21.9
21;2021-06-09;4500;1631;239594;118362;45.0;22.2
21;2021-06-10;3933;2596;243527;120958;45.7;22.7
21;2021-06-11;4164;3109;247691;124067;46.5;23.3
21;2021-06-12;2199;1608;249890;125675;46.9;23.6
21;2021-06-13;29;11;249919;125686;46.9;23.6
21;2021-06-14;2197;2565;252116;128251;47.3;24.1
21;2021-06-15;2959;3092;255075;131343;47.9;24.6
21;2021-06-16;2850;2612;257925;133955;48.4;25.1
21;2021-06-17;3422;3041;261347;136996;49.0;25.7
21;2021-06-18;2424;3802;263771;140798;49.5;26.4
21;2021-06-19;2046;1866;265817;142664;49.9;26.8
21;2021-06-20;26;13;265843;142677;49.9;26.8
21;2021-06-21;1840;3408;267683;146085;50.2;27.4
21;2021-06-22;1885;5829;269568;151914;50.6;28.5
21;2021-06-23;2030;5011;271598;156925;51.0;29.4
21;2021-06-24;2367;4666;273965;161591;51.4;30.3
21;2021-06-25;1530;5895;275495;167486;51.7;31.4
21;2021-06-26;1441;3899;276936;171385;52.0;32.2
21;2021-06-27;18;125;276954;171510;52.0;32.2
21;2021-06-28;1397;4017;278351;175527;52.2;32.9
21;2021-06-29;1633;4174;279984;179701;52.5;33.7
21;2021-06-30;1568;3372;281552;183073;52.8;34.4
21;2021-07-01;1663;4147;283215;187220;53.1;35.1
21;2021-07-02;2179;4231;285394;191451;53.6;35.9
21;2021-07-03;1096;2101;286490;193552;53.8;36.3
21;2021-07-04;37;55;286527;193607;53.8;36.3
21;2021-07-05;1611;3628;288138;197235;54.1;37.0
21;2021-07-06;1349;3583;289487;200818;54.3;37.7
21;2021-07-07;1455;3241;290942;204059;54.6;38.3
21;2021-07-08;1884;4160;292826;208219;55.0;39.1
21;2021-07-09;2081;4350;294907;212569;55.3;39.9
21;2021-07-10;1089;2547;295996;215116;55.5;40.4
21;2021-07-11;21;74;296017;215190;55.5;40.4
21;2021-07-12;1656;3727;297673;218917;55.9;41.1
21;2021-07-13;2343;4889;300016;223806;56.3;42.0
21;2021-07-14;2874;2017;302890;225823;56.8;42.4
21;2021-07-15;3814;4551;306704;230374;57.6;43.2
21;2021-07-16;3889;5254;310593;235628;58.3;44.2
21;2021-07-17;2775;4170;313368;239798;58.8;45.0
21;2021-07-18;158;82;313526;239880;58.8;45.0
21;2021-07-19;2376;4624;315902;244504;59.3;45.9
21;2021-07-20;2760;5487;318662;249991;59.8;46.9
21;2021-07-21;2908;4787;321570;254778;60.3;47.8
21;2021-07-22;3026;4721;324596;259499;60.9;48.7
21;2021-07-23;4352;4897;328948;264396;61.7;49.6
21;2021-07-24;3034;3021;331982;267417;62.3;50.2
21;2021-07-25;68;40;332050;267457;62.3;50.2
21;2021-07-26;2663;3590;334713;271047;62.8;50.9
21;2021-07-27;3412;3772;338125;274819;63.5;51.6
21;2021-07-28;3574;3355;341699;278174;64.1;52.2
21;2021-07-29;4135;3366;345834;281540;64.9;52.8
21;2021-07-30;4623;3354;350457;284894;65.8;53.5
21;2021-07-31;3427;2378;353884;287272;66.4;53.9
21;2021-08-01;331;57;354215;287329;66.5;53.9
21;2021-08-02;2541;3168;356756;290497;66.9;54.5
21;2021-08-03;2624;2761;359380;293258;67.4;55.0
21;2021-08-04;2365;2487;361745;295745;67.9;55.5
21;2021-08-05;2219;3079;363964;298824;68.3;56.1
21;2021-08-06;2592;3312;366556;302136;68.8;56.7
21;2021-08-07;1905;2660;368461;304796;69.1;57.2
21;2021-08-08;75;70;368536;304866;69.2;57.2
21;2021-08-09;1651;2930;370187;307796;69.5;57.8
21;2021-08-10;1413;2716;371600;310512;69.7;58.3
21;2021-08-11;1666;2446;373266;312958;70.0;58.7
21;2021-08-12;1176;2419;374442;315377;70.3;59.2
21;2021-08-13;1525;2747;375967;318124;70.6;59.7
21;2021-08-14;861;2435;376828;320559;70.7;60.2
21;2021-08-15;51;64;376879;320623;70.7;60.2
21;2021-08-16;1400;2822;378279;323445;71.0;60.7
21;2021-08-17;1205;2775;379484;326220;71.2;61.2
21;2021-08-18;1031;2873;380515;329093;71.4;61.8
21;2021-08-19;957;3068;381472;332161;71.6;62.3
21;2021-08-20;1065;4191;382537;336352;71.8;63.1
21;2021-08-21;844;3145;383381;339497;71.9;63.7
21;2021-08-22;35;117;383416;339614;72.0;63.7
21;2021-08-23;938;3220;384354;342834;72.1;64.3
21;2021-08-24;988;2877;385342;345711;72.3;64.9
21;2021-08-25;870;2551;386212;348262;72.5;65.4
21;2021-08-26;728;2427;386940;350689;72.6;65.8
21;2021-08-27;1035;3398;387975;354087;72.8;66.4
21;2021-08-28;711;2757;388686;356844;72.9;67.0
21;2021-08-29;49;216;388735;357060;72.9;67.0
21;2021-08-30;790;2213;389525;359273;73.1;67.4
21;2021-08-31;944;1990;390469;361263;73.3;67.8
21;2021-09-01;625;1613;391094;362876;73.4;68.1
21;2021-09-02;551;1216;391645;364092;73.5;68.3
21;2021-09-03;788;1715;392433;365807;73.6;68.6
21;2021-09-04;752;1445;393185;367252;73.8;68.9
21;2021-09-05;69;79;393254;367331;73.8;68.9
21;2021-09-06;413;1243;393667;368574;73.9;69.2
21;2021-09-07;396;1033;394063;369607;73.9;69.4
21;2021-09-08;556;1285;394619;370892;74.1;69.6
21;2021-09-09;407;934;395026;371826;74.1;69.8
21;2021-09-10;674;1390;395700;373216;74.3;70.0
21;2021-09-11;474;1300;396174;374516;74.3;70.3
21;2021-09-12;21;34;396195;374550;74.3;70.3
21;2021-09-13;258;703;396453;375253;74.4;70.4
21;2021-09-14;489;957;396942;376210;74.5;70.6
21;2021-09-15;489;905;397431;377115;74.6;70.8
21;2021-09-16;345;759;397776;377874;74.6;70.9
21;2021-09-17;556;1057;398332;378931;74.7;71.1
21;2021-09-18;331;1008;398663;379939;74.8;71.3
21;2021-09-19;6;22;398669;379961;74.8;71.3
21;2021-09-20;255;620;398924;380581;74.9;71.4
21;2021-09-21;377;664;399301;381245;74.9;71.5
21;2021-09-22;337;906;399638;382151;75.0;71.7
21;2021-09-23;275;522;399913;382673;75.0;71.8
21;2021-09-24;365;807;400278;383480;75.1;72.0
21;2021-09-25;216;866;400494;384346;75.2;72.1
21;2021-09-26;6;21;400500;384367;75.2;72.1
21;2021-09-27;245;448;400745;384815;75.2;72.2
21;2021-09-28;214;490;400959;385305;75.2;72.3
21;2021-09-29;245;535;401204;385840;75.3;72.4
21;2021-09-30;290;406;401494;386246;75.3;72.5
21;2021-10-01;364;834;401858;387080;75.4;72.6
21;2021-10-02;223;574;402081;387654;75.5;72.7
21;2021-10-03;6;22;402087;387676;75.5;72.8
21;2021-10-04;196;330;402283;388006;75.5;72.8
21;2021-10-05;154;461;402437;388467;75.5;72.9
21;2021-10-06;240;508;402677;388975;75.6;73.0
21;2021-10-07;140;335;402817;389310;75.6;73.1
21;2021-10-08;384;737;403201;390047;75.7;73.2
21;2021-10-09;249;443;403450;390490;75.7;73.3
21;2021-10-10;4;14;403454;390504;75.7;73.3
21;2021-10-11;132;316;403586;390820;75.7;73.3
21;2021-10-12;164;440;403750;391260;75.8;73.4
21;2021-10-13;243;400;403993;391660;75.8;73.5
21;2021-10-14;163;347;404156;392007;75.8;73.6
21;2021-10-15;269;469;404425;392476;75.9;73.7
21;2021-10-16;209;315;404634;392791;75.9;73.7
21;2021-10-17;2;4;404636;392795;75.9;73.7
21;2021-10-18;121;260;404757;393055;76.0;73.8
21;2021-10-19;117;264;404874;393319;76.0;73.8
22;2020-12-27;0;0;0;0;0.0;0.0
22;2020-12-28;0;0;0;0;0.0;0.0
22;2020-12-29;0;0;0;0;0.0;0.0
22;2020-12-30;0;0;0;0;0.0;0.0
22;2020-12-31;0;0;0;0;0.0;0.0
22;2021-01-01;0;0;0;0;0.0;0.0
22;2021-01-02;2;0;2;0;0.0;0.0
22;2021-01-03;0;0;2;0;0.0;0.0
22;2021-01-04;5;0;7;0;0.0;0.0
22;2021-01-05;61;0;68;0;0.0;0.0
22;2021-01-06;114;1;182;1;0.0;0.0
22;2021-01-07;67;0;249;1;0.0;0.0
22;2021-01-08;174;0;423;1;0.1;0.0
22;2021-01-09;1;0;424;1;0.1;0.0
22;2021-01-10;0;0;424;1;0.1;0.0
22;2021-01-11;234;3;658;4;0.1;0.0
22;2021-01-12;627;0;1285;4;0.2;0.0
22;2021-01-13;677;1;1962;5;0.3;0.0
22;2021-01-14;717;8;2679;13;0.4;0.0
22;2021-01-15;531;2;3210;15;0.5;0.0
22;2021-01-16;96;0;3306;15;0.6;0.0
22;2021-01-17;1;0;3307;15;0.6;0.0
22;2021-01-18;312;2;3619;17;0.6;0.0
22;2021-01-19;686;1;4305;18;0.7;0.0
22;2021-01-20;598;1;4903;19;0.8;0.0
22;2021-01-21;947;2;5850;21;1.0;0.0
22;2021-01-22;840;2;6690;23;1.1;0.0
22;2021-01-23;219;0;6909;23;1.2;0.0
22;2021-01-24;2;0;6911;23;1.2;0.0
22;2021-01-25;751;11;7662;34;1.3;0.0
22;2021-01-26;1018;59;8680;93;1.5;0.0
22;2021-01-27;3858;119;12538;212;2.1;0.0
22;2021-01-28;4511;89;17049;301;2.9;0.1
22;2021-01-29;1897;130;18946;431;3.2;0.1
22;2021-01-30;289;0;19235;431;3.2;0.1
22;2021-01-31;3;0;19238;431;3.2;0.1
22;2021-02-01;642;81;19880;512;3.3;0.1
22;2021-02-02;903;436;20783;948;3.5;0.2
22;2021-02-03;691;503;21474;1451;3.6;0.2
22;2021-02-04;965;639;22439;2090;3.8;0.4
22;2021-02-05;723;564;23162;2654;3.9;0.4
22;2021-02-06;256;2;23418;2656;3.9;0.4
22;2021-02-07;0;0;23418;2656;3.9;0.4
22;2021-02-08;531;134;23949;2790;4.0;0.5
22;2021-02-09;614;347;24563;3137;4.1;0.5
22;2021-02-10;425;201;24988;3338;4.2;0.6
22;2021-02-11;1085;325;26073;3663;4.4;0.6
22;2021-02-12;595;329;26668;3992;4.5;0.7
22;2021-02-13;319;78;26987;4070;4.5;0.7
22;2021-02-14;0;5;26987;4075;4.5;0.7
22;2021-02-15;672;430;27659;4505;4.6;0.8
22;2021-02-16;1042;702;28701;5207;4.8;0.9
22;2021-02-17;1203;2456;29904;7663;5.0;1.3
22;2021-02-18;2146;3009;32050;10672;5.4;1.8
22;2021-02-19;1637;1947;33687;12619;5.7;2.1
22;2021-02-20;480;214;34167;12833;5.7;2.2
22;2021-02-21;7;49;34174;12882;5.7;2.2
22;2021-02-22;401;718;34575;13600;5.8;2.3
22;2021-02-23;665;934;35240;14534;5.9;2.4
22;2021-02-24;695;947;35935;15481;6.0;2.6
22;2021-02-25;1200;1201;37135;16682;6.2;2.8
22;2021-02-26;1066;710;38201;17392;6.4;2.9
22;2021-02-27;564;285;38765;17677;6.5;3.0
22;2021-02-28;16;8;38781;17685;6.5;3.0
22;2021-03-01;960;524;39741;18209;6.7;3.1
22;2021-03-02;1209;879;40950;19088;6.9;3.2
22;2021-03-03;1326;865;42276;19953;7.1;3.3
22;2021-03-04;1602;935;43878;20888;7.4;3.5
22;2021-03-05;2111;808;45989;21696;7.7;3.6
22;2021-03-06;1114;302;47103;21998;7.9;3.7
22;2021-03-07;219;1;47322;21999;7.9;3.7
22;2021-03-08;1290;662;48612;22661;8.2;3.8
22;2021-03-09;1824;756;50436;23417;8.5;3.9
22;2021-03-10;1987;1006;52423;24423;8.8;4.1
22;2021-03-11;2375;1661;54798;26084;9.2;4.4
22;2021-03-12;3101;968;57899;27052;9.7;4.5
22;2021-03-13;1724;296;59623;27348;10.0;4.6
22;2021-03-14;245;25;59868;27373;10.0;4.6
22;2021-03-15;1621;570;61489;27943;10.3;4.7
22;2021-03-16;1602;859;63091;28802;10.6;4.8
22;2021-03-17;2651;709;65742;29511;11.0;4.9
22;2021-03-18;2555;1108;68297;30619;11.5;5.1
22;2021-03-19;3281;803;71578;31422;12.0;5.3
22;2021-03-20;2208;288;73786;31710;12.4;5.3
22;2021-03-21;16;0;73802;31710;12.4;5.3
22;2021-03-22;2363;367;76165;32077;12.8;5.4
22;2021-03-23;3142;787;79307;32864;13.3;5.5
22;2021-03-24;3485;692;82792;33556;13.9;5.6
22;2021-03-25;3961;612;86753;34168;14.6;5.7
22;2021-03-26;4003;491;90756;34659;15.2;5.8
22;2021-03-27;2093;183;92849;34842;15.6;5.8
22;2021-03-28;67;1;92916;34843;15.6;5.8
22;2021-03-29;2765;914;95681;35757;16.0;6.0
22;2021-03-30;3567;1160;99248;36917;16.6;6.2
22;2021-03-31;3674;1091;102922;38008;17.3;6.4
22;2021-04-01;4943;1135;107865;39143;18.1;6.6
22;2021-04-02;4391;1042;112256;40185;18.8;6.7
22;2021-04-03;1998;404;114254;40589;19.2;6.8
22;2021-04-04;37;0;114291;40589;19.2;6.8
22;2021-04-05;15;0;114306;40589;19.2;6.8
22;2021-04-06;3288;1143;117594;41732;19.7;7.0
22;2021-04-07;3429;1376;121023;43108;20.3;7.2
22;2021-04-08;4446;1327;125469;44435;21.0;7.5
22;2021-04-09;5183;1370;130652;45805;21.9;7.7
22;2021-04-10;2450;372;133102;46177;22.3;7.7
22;2021-04-11;485;10;133587;46187;22.4;7.7
22;2021-04-12;2987;1014;136574;47201;22.9;7.9
22;2021-04-13;3318;1519;139892;48720;23.5;8.2
22;2021-04-14;3165;2491;143057;51211;24.0;8.6
22;2021-04-15;3599;2435;146656;53646;24.6;9.0
22;2021-04-16;3632;2493;150288;56139;25.2;9.4
22;2021-04-17;1920;1795;152208;57934;25.5;9.7
22;2021-04-18;17;0;152225;57934;25.5;9.7
22;2021-04-19;3022;2151;155247;60085;26.0;10.1
22;2021-04-20;3310;2798;158557;62883;26.6;10.5
22;2021-04-21;3223;2743;161780;65626;27.1;11.0
22;2021-04-22;3593;3139;165373;68765;27.7;11.5
22;2021-04-23;3727;3177;169100;71942;28.4;12.1
22;2021-04-24;2005;1967;171105;73909;28.7;12.4
22;2021-04-25;17;0;171122;73909;28.7;12.4
22;2021-04-26;3213;2857;174335;76766;29.2;12.9
22;2021-04-27;3371;3146;177706;79912;29.8;13.4
22;2021-04-28;3488;3159;181194;83071;30.4;13.9
22;2021-04-29;4080;3277;185274;86348;31.1;14.5
22;2021-04-30;3905;3230;189179;89578;31.7;15.0
22;2021-05-01;60;69;189239;89647;31.7;15.0
22;2021-05-02;1237;59;190476;89706;31.9;15.0
22;2021-05-03;2029;2714;192505;92420;32.3;15.5
22;2021-05-04;2155;2899;194660;95319;32.7;16.0
22;2021-05-05;2049;3005;196709;98324;33.0;16.5
22;2021-05-06;2508;3498;199217;101822;33.4;17.1
22;2021-05-07;2829;3408;202046;105230;33.9;17.7
22;2021-05-08;45;121;202091;105351;33.9;17.7
22;2021-05-09;602;438;202693;105789;34.0;17.7
22;2021-05-10;4473;2733;207166;108522;34.7;18.2
22;2021-05-11;5106;2903;212272;111425;35.6;18.7
22;2021-05-12;6599;1025;218871;112450;36.7;18.9
22;2021-05-13;528;35;219399;112485;36.8;18.9
22;2021-05-14;6407;1089;225806;113574;37.9;19.1
22;2021-05-15;3988;429;229794;114003;38.5;19.1
22;2021-05-16;419;37;230213;114040;38.6;19.1
22;2021-05-17;5668;521;235881;114561;39.6;19.2
22;2021-05-18;6012;955;241893;115516;40.6;19.4
22;2021-05-19;6130;711;248023;116227;41.6;19.5
22;2021-05-20;6587;1375;254610;117602;42.7;19.7
22;2021-05-21;5898;1456;260508;119058;43.7;20.0
22;2021-05-22;4093;772;264601;119830;44.4;20.1
22;2021-05-23;407;17;265008;119847;44.5;20.1
22;2021-05-24;5315;226;270323;120073;45.3;20.1
22;2021-05-25;5637;1180;275960;121253;46.3;20.3
22;2021-05-26;4226;2811;280186;124064;47.0;20.8
22;2021-05-27;4504;3841;284690;127905;47.8;21.5
22;2021-05-28;4384;4435;289074;132340;48.5;22.2
22;2021-05-29;3046;1771;292120;134111;49.0;22.5
22;2021-05-30;19;7;292139;134118;49.0;22.5
22;2021-05-31;3653;3153;295792;137271;49.6;23.0
22;2021-06-01;3520;3690;299312;140961;50.2;23.6
22;2021-06-02;3085;3387;302397;144348;50.7;24.2
22;2021-06-03;3196;4099;305593;148447;51.3;24.9
22;2021-06-04;3371;4540;308964;152987;51.8;25.7
22;2021-06-05;3543;2027;312507;155014;52.4;26.0
22;2021-06-06;214;30;312721;155044;52.5;26.0
22;2021-06-07;3042;3256;315763;158300;53.0;26.6
22;2021-06-08;2798;3530;318561;161830;53.4;27.1
22;2021-06-09;2543;3506;321104;165336;53.9;27.7
22;2021-06-10;2516;4249;323620;169585;54.3;28.4
22;2021-06-11;2551;4227;326171;173812;54.7;29.2
22;2021-06-12;2411;1454;328582;175266;55.1;29.4
22;2021-06-13;134;1093;328716;176359;55.1;29.6
22;2021-06-14;2644;2469;331360;178828;55.6;30.0
22;2021-06-15;3095;2996;334455;181824;56.1;30.5
22;2021-06-16;3008;2812;337463;184636;56.6;31.0
22;2021-06-17;2560;3182;340023;187818;57.0;31.5
22;2021-06-18;3102;4116;343125;191934;57.6;32.2
22;2021-06-19;2984;1455;346109;193389;58.1;32.4
22;2021-06-20;157;8;346266;193397;58.1;32.4
22;2021-06-21;1783;5021;348049;198418;58.4;33.3
22;2021-06-22;2403;5554;350452;203972;58.8;34.2
22;2021-06-23;1285;6203;351737;210175;59.0;35.3
22;2021-06-24;2578;3912;354315;214087;59.4;35.9
22;2021-06-25;1568;6812;355883;220899;59.7;37.1
22;2021-06-26;783;3853;356666;224752;59.8;37.7
22;2021-06-27;4;511;356670;225263;59.8;37.8
22;2021-06-28;1051;5586;357721;230849;60.0;38.7
22;2021-06-29;1376;5954;359097;236803;60.2;39.7
22;2021-06-30;1129;5738;360226;242541;60.4;40.7
22;2021-07-01;1383;6037;361609;248578;60.7;41.7
22;2021-07-02;1708;6094;363317;254672;60.9;42.7
22;2021-07-03;1009;3819;364326;258491;61.1;43.4
22;2021-07-04;149;365;364475;258856;61.1;43.4
22;2021-07-05;1598;5804;366073;264660;61.4;44.4
22;2021-07-06;2313;5991;368386;270651;61.8;45.4
22;2021-07-07;2292;4933;370678;275584;62.2;46.2
22;2021-07-08;2503;5097;373181;280681;62.6;47.1
22;2021-07-09;2496;5386;375677;286067;63.0;48.0
22;2021-07-10;1808;3359;377485;289426;63.3;48.5
22;2021-07-11;484;75;377969;289501;63.4;48.6
22;2021-07-12;2335;4734;380304;294235;63.8;49.4
22;2021-07-13;3782;5055;384086;299290;64.4;50.2
22;2021-07-14;700;2490;384786;301780;64.5;50.6
22;2021-07-15;3870;4622;388656;306402;65.2;51.4
22;2021-07-16;3835;5293;392491;311695;65.8;52.3
22;2021-07-17;2558;3412;395049;315107;66.3;52.9
22;2021-07-18;571;88;395620;315195;66.4;52.9
22;2021-07-19;2773;4104;398393;319299;66.8;53.6
22;2021-07-20;3923;4133;402316;323432;67.5;54.3
22;2021-07-21;3999;3420;406315;326852;68.2;54.8
22;2021-07-22;4862;3707;411177;330559;69.0;55.4
22;2021-07-23;4452;4221;415629;334780;69.7;56.2
22;2021-07-24;2260;2616;417889;337396;70.1;56.6
22;2021-07-25;118;150;418007;337546;70.1;56.6
22;2021-07-26;3022;3922;421029;341468;70.6;57.3
22;2021-07-27;3728;4918;424757;346386;71.2;58.1
22;2021-07-28;3706;3662;428463;350048;71.9;58.7
22;2021-07-29;4293;3780;432756;353828;72.6;59.3
22;2021-07-30;4038;3978;436794;357806;73.3;60.0
22;2021-07-31;2403;2805;439197;360611;73.7;60.5
22;2021-08-01;119;150;439316;360761;73.7;60.5
22;2021-08-02;4670;2551;443986;363312;74.5;60.9
22;2021-08-03;4787;3428;448773;366740;75.3;61.5
22;2021-08-04;5774;2499;454547;369239;76.2;61.9
22;2021-08-05;4129;3805;458676;373044;76.9;62.6
22;2021-08-06;3655;3811;462331;376855;77.5;63.2
22;2021-08-07;2355;2269;464686;379124;77.9;63.6
22;2021-08-08;427;71;465113;379195;78.0;63.6
22;2021-08-09;2723;2708;467836;381903;78.5;64.1
22;2021-08-10;2735;3513;470571;385416;78.9;64.6
22;2021-08-11;2429;3114;473000;388530;79.3;65.2
22;2021-08-12;2215;3478;475215;392008;79.7;65.8
22;2021-08-13;1938;2973;477153;394981;80.0;66.3
22;2021-08-14;1342;1911;478495;396892;80.3;66.6
22;2021-08-15;87;199;478582;397091;80.3;66.6
22;2021-08-16;1471;3178;480053;400269;80.5;67.1
22;2021-08-17;1759;3459;481812;403728;80.8;67.7
22;2021-08-18;1405;3302;483217;407030;81.1;68.3
22;2021-08-19;1350;3608;484567;410638;81.3;68.9
22;2021-08-20;1462;3605;486029;414243;81.5;69.5
22;2021-08-21;814;2261;486843;416504;81.7;69.9
22;2021-08-22;151;308;486994;416812;81.7;69.9
22;2021-08-23;1966;3609;488960;420421;82.0;70.5
22;2021-08-24;1432;3246;490392;423667;82.3;71.1
22;2021-08-25;844;2507;491236;426174;82.4;71.5
22;2021-08-26;1055;4294;492291;430468;82.6;72.2
22;2021-08-27;1326;4602;493617;435070;82.8;73.0
22;2021-08-28;737;2517;494354;437587;82.9;73.4
22;2021-08-29;35;26;494389;437613;82.9;73.4
22;2021-08-30;927;2925;495316;440538;83.1;73.9
22;2021-08-31;968;3739;496284;444277;83.2;74.5
22;2021-09-01;974;3252;497258;447529;83.4;75.1
22;2021-09-02;840;2834;498098;450363;83.5;75.5
22;2021-09-03;942;2766;499040;453129;83.7;76.0
22;2021-09-04;783;2606;499823;455735;83.8;76.4
22;2021-09-05;97;28;499920;455763;83.9;76.4
22;2021-09-06;491;1862;500411;457625;83.9;76.8
22;2021-09-07;514;2014;500925;459639;84.0;77.1
22;2021-09-08;633;1879;501558;461518;84.1;77.4
22;2021-09-09;679;1924;502237;463442;84.2;77.7
22;2021-09-10;706;2122;502943;465564;84.4;78.1
22;2021-09-11;585;1693;503528;467257;84.5;78.4
22;2021-09-12;31;81;503559;467338;84.5;78.4
22;2021-09-13;485;2097;504044;469435;84.5;78.7
22;2021-09-14;594;1572;504638;471007;84.6;79.0
22;2021-09-15;464;1703;505102;472710;84.7;79.3
22;2021-09-16;551;1043;505653;473753;84.8;79.5
22;2021-09-17;626;1631;506279;475384;84.9;79.7
22;2021-09-18;284;2161;506563;477545;85.0;80.1
22;2021-09-19;1;8;506564;477553;85.0;80.1
22;2021-09-20;363;709;506927;478262;85.0;80.2
22;2021-09-21;364;956;507291;479218;85.1;80.4
22;2021-09-22;303;1160;507594;480378;85.1;80.6
22;2021-09-23;407;720;508001;481098;85.2;80.7
22;2021-09-24;362;1100;508363;482198;85.3;80.9
22;2021-09-25;220;1386;508583;483584;85.3;81.1
22;2021-09-26;12;70;508595;483654;85.3;81.1
22;2021-09-27;337;745;508932;484399;85.4;81.2
22;2021-09-28;203;576;509135;484975;85.4;81.3
22;2021-09-29;232;887;509367;485862;85.4;81.5
22;2021-09-30;271;740;509638;486602;85.5;81.6
22;2021-10-01;278;776;509916;487378;85.5;81.7
22;2021-10-02;331;915;510247;488293;85.6;81.9
22;2021-10-03;0;0;510247;488293;85.6;81.9
22;2021-10-04;119;427;510366;488720;85.6;82.0
22;2021-10-05;220;646;510586;489366;85.6;82.1
22;2021-10-06;225;372;510811;489738;85.7;82.1
22;2021-10-07;243;690;511054;490428;85.7;82.3
22;2021-10-08;319;775;511373;491203;85.8;82.4
22;2021-10-09;239;463;511612;491666;85.8;82.5
22;2021-10-10;4;8;511616;491674;85.8;82.5
22;2021-10-11;130;261;511746;491935;85.8;82.5
22;2021-10-12;84;151;511830;492086;85.9;82.5
22;2021-10-13;182;250;512012;492336;85.9;82.6
22;2021-10-14;228;764;512240;493100;85.9;82.7
22;2021-10-15;262;445;512502;493545;86.0;82.8
22;2021-10-16;326;477;512828;494022;86.0;82.9
22;2021-10-17;0;3;512828;494025;86.0;82.9
22;2021-10-18;130;323;512958;494348;86.0;82.9
22;2021-10-19;50;109;513008;494457;86.0;82.9
23;2020-12-27;0;0;0;0;0.0;0.0
23;2020-12-28;2;0;2;0;0.0;0.0
23;2020-12-29;0;0;2;0;0.0;0.0
23;2020-12-30;0;0;2;0;0.0;0.0
23;2020-12-31;0;0;2;0;0.0;0.0
23;2021-01-01;0;0;2;0;0.0;0.0
23;2021-01-02;1;0;3;0;0.0;0.0
23;2021-01-03;1;1;4;1;0.0;0.0
23;2021-01-04;1;0;5;1;0.0;0.0
23;2021-01-05;3;0;8;1;0.0;0.0
23;2021-01-06;10;0;18;1;0.0;0.0
23;2021-01-07;116;1;134;2;0.1;0.0
23;2021-01-08;117;0;251;2;0.2;0.0
23;2021-01-09;36;0;287;2;0.2;0.0
23;2021-01-10;1;0;288;2;0.2;0.0
23;2021-01-11;176;2;464;4;0.4;0.0
23;2021-01-12;237;5;701;9;0.6;0.0
23;2021-01-13;310;0;1011;9;0.9;0.0
23;2021-01-14;293;5;1304;14;1.1;0.0
23;2021-01-15;334;5;1638;19;1.4;0.0
23;2021-01-16;163;1;1801;20;1.5;0.0
23;2021-01-17;0;0;1801;20;1.5;0.0
23;2021-01-18;342;3;2143;23;1.8;0.0
23;2021-01-19;498;2;2641;25;2.3;0.0
23;2021-01-20;363;1;3004;26;2.6;0.0
23;2021-01-21;700;1;3704;27;3.2;0.0
23;2021-01-22;481;0;4185;27;3.6;0.0
23;2021-01-23;368;1;4553;28;3.9;0.0
23;2021-01-24;0;0;4553;28;3.9;0.0
23;2021-01-25;382;17;4935;45;4.2;0.0
23;2021-01-26;301;5;5236;50;4.5;0.0
23;2021-01-27;227;3;5463;53;4.7;0.0
23;2021-01-28;232;45;5695;98;4.9;0.1
23;2021-01-29;304;104;5999;202;5.2;0.2
23;2021-01-30;100;28;6099;230;5.2;0.2
23;2021-01-31;2;33;6101;263;5.2;0.2
23;2021-02-01;148;105;6249;368;5.4;0.3
23;2021-02-02;157;123;6406;491;5.5;0.4
23;2021-02-03;105;207;6511;698;5.6;0.6
23;2021-02-04;77;263;6588;961;5.7;0.8
23;2021-02-05;117;312;6705;1273;5.8;1.1
23;2021-02-06;14;167;6719;1440;5.8;1.2
23;2021-02-07;1;0;6720;1440;5.8;1.2
23;2021-02-08;123;216;6843;1656;5.9;1.4
23;2021-02-09;89;298;6932;1954;6.0;1.7
23;2021-02-10;92;281;7024;2235;6.0;1.9
23;2021-02-11;246;588;7270;2823;6.3;2.4
23;2021-02-12;174;284;7444;3107;6.4;2.7
23;2021-02-13;8;191;7452;3298;6.4;2.8
23;2021-02-14;8;0;7460;3298;6.4;2.8
23;2021-02-15;157;366;7617;3664;6.6;3.2
23;2021-02-16;103;439;7720;4103;6.6;3.5
23;2021-02-17;65;490;7785;4593;6.7;4.0
23;2021-02-18;142;368;7927;4961;6.8;4.3
23;2021-02-19;109;254;8036;5215;6.9;4.5
23;2021-02-20;2;93;8038;5308;6.9;4.6
23;2021-02-21;0;0;8038;5308;6.9;4.6
23;2021-02-22;104;212;8142;5520;7.0;4.7
23;2021-02-23;108;218;8250;5738;7.1;4.9
23;2021-02-24;176;168;8426;5906;7.2;5.1
23;2021-02-25;184;110;8610;6016;7.4;5.2
23;2021-02-26;287;168;8897;6184;7.7;5.3
23;2021-02-27;112;11;9009;6195;7.7;5.3
23;2021-02-28;1;31;9010;6226;7.7;5.4
23;2021-03-01;88;201;9098;6427;7.8;5.5
23;2021-03-02;229;132;9327;6559;8.0;5.6
23;2021-03-03;133;90;9460;6649;8.1;5.7
23;2021-03-04;307;138;9767;6787;8.4;5.8
23;2021-03-05;517;111;10284;6898;8.8;5.9
23;2021-03-06;495;7;10779;6905;9.3;5.9
23;2021-03-07;313;3;11092;6908;9.5;5.9
23;2021-03-08;198;73;11290;6981;9.7;6.0
23;2021-03-09;421;103;11711;7084;10.1;6.1
23;2021-03-10;349;39;12060;7123;10.4;6.1
23;2021-03-11;324;48;12384;7171;10.7;6.2
23;2021-03-12;621;35;13005;7206;11.2;6.2
23;2021-03-13;288;12;13293;7218;11.4;6.2
23;2021-03-14;47;34;13340;7252;11.5;6.2
23;2021-03-15;220;125;13560;7377;11.7;6.3
23;2021-03-16;192;91;13752;7468;11.8;6.4
23;2021-03-17;132;101;13884;7569;11.9;6.5
23;2021-03-18;192;99;14076;7668;12.1;6.6
23;2021-03-19;209;123;14285;7791;12.3;6.7
23;2021-03-20;631;37;14916;7828;12.8;6.7
23;2021-03-21;128;0;15044;7828;12.9;6.7
23;2021-03-22;274;157;15318;7985;13.2;6.9
23;2021-03-23;504;104;15822;8089;13.6;7.0
23;2021-03-24;422;124;16244;8213;14.0;7.1
23;2021-03-25;820;190;17064;8403;14.7;7.2
23;2021-03-26;735;195;17799;8598;15.3;7.4
23;2021-03-27;507;50;18306;8648;15.7;7.4
23;2021-03-28;3;9;18309;8657;15.7;7.4
23;2021-03-29;358;111;18667;8768;16.1;7.5
23;2021-03-30;537;178;19204;8946;16.5;7.7
23;2021-03-31;411;175;19615;9121;16.9;7.8
23;2021-04-01;600;175;20215;9296;17.4;8.0
23;2021-04-02;498;299;20713;9595;17.8;8.3
23;2021-04-03;715;44;21428;9639;18.4;8.3
23;2021-04-04;4;0;21432;9639;18.4;8.3
23;2021-04-05;2;3;21434;9642;18.4;8.3
23;2021-04-06;382;293;21816;9935;18.8;8.5
23;2021-04-07;706;310;22522;10245;19.4;8.8
23;2021-04-08;805;239;23327;10484;20.1;9.0
23;2021-04-09;940;370;24267;10854;20.9;9.3
23;2021-04-10;1097;111;25364;10965;21.8;9.4
23;2021-04-11;21;2;25385;10967;21.8;9.4
23;2021-04-12;692;235;26077;11202;22.4;9.6
23;2021-04-13;670;303;26747;11505;23.0;9.9
23;2021-04-14;586;178;27333;11683;23.5;10.0
23;2021-04-15;929;186;28262;11869;24.3;10.2
23;2021-04-16;905;217;29167;12086;25.1;10.4
23;2021-04-17;996;555;30163;12641;25.9;10.9
23;2021-04-18;3;136;30166;12777;25.9;11.0
23;2021-04-19;613;297;30779;13074;26.5;11.2
23;2021-04-20;720;297;31499;13371;27.1;11.5
23;2021-04-21;733;397;32232;13768;27.7;11.8
23;2021-04-22;655;474;32887;14242;28.3;12.2
23;2021-04-23;596;347;33483;14589;28.8;12.5
23;2021-04-24;855;450;34338;15039;29.5;12.9
23;2021-04-25;0;0;34338;15039;29.5;12.9
23;2021-04-26;615;255;34953;15294;30.1;13.2
23;2021-04-27;675;429;35628;15723;30.6;13.5
23;2021-04-28;628;277;36256;16000;31.2;13.8
23;2021-04-29;883;379;37139;16379;31.9;14.1
23;2021-04-30;719;787;37858;17166;32.6;14.8
23;2021-05-01;1229;44;39087;17210;33.6;14.8
23;2021-05-02;14;0;39101;17210;33.6;14.8
23;2021-05-03;430;522;39531;17732;34.0;15.3
23;2021-05-04;617;513;40148;18245;34.5;15.7
23;2021-05-05;540;715;40688;18960;35.0;16.3
23;2021-05-06;728;702;41416;19662;35.6;16.9
23;2021-05-07;685;645;42101;20307;36.2;17.5
23;2021-05-08;1411;589;43512;20896;37.4;18.0
23;2021-05-09;4;1;43516;20897;37.4;18.0
23;2021-05-10;555;656;44071;21553;37.9;18.5
23;2021-05-11;560;765;44631;22318;38.4;19.2
23;2021-05-12;720;662;45351;22980;39.0;19.8
23;2021-05-13;538;55;45889;23035;39.5;19.8
23;2021-05-14;786;455;46675;23490;40.1;20.2
23;2021-05-15;995;235;47670;23725;41.0;20.4
23;2021-05-16;0;0;47670;23725;41.0;20.4
23;2021-05-17;566;448;48236;24173;41.5;20.8
23;2021-05-18;777;292;49013;24465;42.2;21.0
23;2021-05-19;1051;259;50064;24724;43.1;21.3
23;2021-05-20;838;315;50902;25039;43.8;21.5
23;2021-05-21;1108;311;52010;25350;44.7;21.8
23;2021-05-22;740;125;52750;25475;45.4;21.9
23;2021-05-23;3;20;52753;25495;45.4;21.9
23;2021-05-24;363;166;53116;25661;45.7;22.1
23;2021-05-25;908;336;54024;25997;46.5;22.4
23;2021-05-26;1077;227;55101;26224;47.4;22.6
23;2021-05-27;931;437;56032;26661;48.2;22.9
23;2021-05-28;781;744;56813;27405;48.9;23.6
23;2021-05-29;639;1102;57452;28507;49.4;24.5
23;2021-05-30;6;63;57458;28570;49.4;24.6
23;2021-05-31;433;541;57891;29111;49.8;25.0
23;2021-06-01;582;827;58473;29938;50.3;25.7
23;2021-06-02;624;520;59097;30458;50.8;26.2
23;2021-06-03;708;552;59805;31010;51.4;26.7
23;2021-06-04;778;614;60583;31624;52.1;27.2
23;2021-06-05;543;777;61126;32401;52.6;27.9
23;2021-06-06;0;0;61126;32401;52.6;27.9
23;2021-06-07;393;697;61519;33098;52.9;28.5
23;2021-06-08;323;776;61842;33874;53.2;29.1
23;2021-06-09;287;648;62129;34522;53.4;29.7
23;2021-06-10;374;692;62503;35214;53.8;30.3
23;2021-06-11;384;808;62887;36022;54.1;31.0
23;2021-06-12;376;1265;63263;37287;54.4;32.1
23;2021-06-13;13;5;63276;37292;54.4;32.1
23;2021-06-14;236;589;63512;37881;54.6;32.6
23;2021-06-15;229;861;63741;38742;54.8;33.3
23;2021-06-16;362;579;64103;39321;55.1;33.8
23;2021-06-17;339;810;64442;40131;55.4;34.5
23;2021-06-18;356;767;64798;40898;55.7;35.2
23;2021-06-19;492;1522;65290;42420;56.2;36.5
23;2021-06-20;2;11;65292;42431;56.2;36.5
23;2021-06-21;205;620;65497;43051;56.3;37.0
23;2021-06-22;216;687;65713;43738;56.5;37.6
23;2021-06-23;221;750;65934;44488;56.7;38.3
23;2021-06-24;200;606;66134;45094;56.9;38.8
23;2021-06-25;302;816;66436;45910;57.1;39.5
23;2021-06-26;221;999;66657;46909;57.3;40.3
23;2021-06-27;3;0;66660;46909;57.3;40.3
23;2021-06-28;115;690;66775;47599;57.4;40.9
23;2021-06-29;189;823;66964;48422;57.6;41.6
23;2021-06-30;169;944;67133;49366;57.7;42.5
23;2021-07-01;168;870;67301;50236;57.9;43.2
23;2021-07-02;192;1069;67493;51305;58.0;44.1
23;2021-07-03;250;979;67743;52284;58.3;45.0
23;2021-07-04;1;0;67744;52284;58.3;45.0
23;2021-07-05;159;804;67903;53088;58.4;45.7
23;2021-07-06;215;1043;68118;54131;58.6;46.6
23;2021-07-07;211;853;68329;54984;58.8;47.3
23;2021-07-08;254;740;68583;55724;59.0;47.9
23;2021-07-09;275;1013;68858;56737;59.2;48.8
23;2021-07-10;234;644;69092;57381;59.4;49.4
23;2021-07-11;0;0;69092;57381;59.4;49.4
23;2021-07-12;232;702;69324;58083;59.6;50.0
23;2021-07-13;471;917;69795;59000;60.0;50.7
23;2021-07-14;212;320;70007;59320;60.2;51.0
23;2021-07-15;484;810;70491;60130;60.6;51.7
23;2021-07-16;764;568;71255;60698;61.3;52.2
23;2021-07-17;220;478;71475;61176;61.5;52.6
23;2021-07-18;0;1;71475;61177;61.5;52.6
23;2021-07-19;704;630;72179;61807;62.1;53.2
23;2021-07-20;633;569;72812;62376;62.6;53.6
23;2021-07-21;702;636;73514;63012;63.2;54.2
23;2021-07-22;945;439;74459;63451;64.0;54.6
23;2021-07-23;840;508;75299;63959;64.8;55.0
23;2021-07-24;1013;439;76312;64398;65.6;55.4
23;2021-07-25;13;16;76325;64414;65.6;55.4
23;2021-07-26;788;563;77113;64977;66.3;55.9
23;2021-07-27;928;436;78041;65413;67.1;56.3
23;2021-07-28;877;411;78918;65824;67.9;56.6
23;2021-07-29;1049;400;79967;66224;68.8;57.0
23;2021-07-30;946;521;80913;66745;69.6;57.4
23;2021-07-31;1165;306;82078;67051;70.6;57.7
23;2021-08-01;19;8;82097;67059;70.6;57.7
23;2021-08-02;674;506;82771;67565;71.2;58.1
23;2021-08-03;768;458;83539;68023;71.8;58.5
23;2021-08-04;613;298;84152;68321;72.4;58.8
23;2021-08-05;692;365;84844;68686;73.0;59.1
23;2021-08-06;421;482;85265;69168;73.3;59.5
23;2021-08-07;299;188;85564;69356;73.6;59.7
23;2021-08-08;146;38;85710;69394;73.7;59.7
23;2021-08-09;492;492;86202;69886;74.1;60.1
23;2021-08-10;467;608;86669;70494;74.5;60.6
23;2021-08-11;428;487;87097;70981;74.9;61.0
23;2021-08-12;514;567;87611;71548;75.4;61.5
23;2021-08-13;420;578;88031;72126;75.7;62.0
23;2021-08-14;287;390;88318;72516;76.0;62.4
23;2021-08-15;27;9;88345;72525;76.0;62.4
23;2021-08-16;276;710;88621;73235;76.2;63.0
23;2021-08-17;277;732;88898;73967;76.5;63.6
23;2021-08-18;180;637;89078;74604;76.6;64.2
23;2021-08-19;257;726;89335;75330;76.8;64.8
23;2021-08-20;215;682;89550;76012;77.0;65.4
23;2021-08-21;140;500;89690;76512;77.1;65.8
23;2021-08-22;54;48;89744;76560;77.2;65.8
23;2021-08-23;149;816;89893;77376;77.3;66.5
23;2021-08-24;265;911;90158;78287;77.5;67.3
23;2021-08-25;187;791;90345;79078;77.7;68.0
23;2021-08-26;220;744;90565;79822;77.9;68.7
23;2021-08-27;213;639;90778;80461;78.1;69.2
23;2021-08-28;222;454;91000;80915;78.3;69.6
23;2021-08-29;15;88;91015;81003;78.3;69.7
23;2021-08-30;187;652;91202;81655;78.4;70.2
23;2021-08-31;229;663;91431;82318;78.6;70.8
23;2021-09-01;162;391;91593;82709;78.8;71.1
23;2021-09-02;120;306;91713;83015;78.9;71.4
23;2021-09-03;211;508;91924;83523;79.1;71.8
23;2021-09-04;178;793;92102;84316;79.2;72.5
23;2021-09-05;5;5;92107;84321;79.2;72.5
23;2021-09-06;133;379;92240;84700;79.3;72.8
23;2021-09-07;98;343;92338;85043;79.4;73.1
23;2021-09-08;121;357;92459;85400;79.5;73.4
23;2021-09-09;119;306;92578;85706;79.6;73.7
23;2021-09-10;150;312;92728;86018;79.8;74.0
23;2021-09-11;102;202;92830;86220;79.8;74.2
23;2021-09-12;5;7;92835;86227;79.8;74.2
23;2021-09-13;113;323;92948;86550;79.9;74.4
23;2021-09-14;113;288;93061;86838;80.0;74.7
23;2021-09-15;97;242;93158;87080;80.1;74.9
23;2021-09-16;127;153;93285;87233;80.2;75.0
23;2021-09-17;140;227;93425;87460;80.4;75.2
23;2021-09-18;44;224;93469;87684;80.4;75.4
23;2021-09-19;0;1;93469;87685;80.4;75.4
23;2021-09-20;58;221;93527;87906;80.4;75.6
23;2021-09-21;85;186;93612;88092;80.5;75.8
23;2021-09-22;71;261;93683;88353;80.6;76.0
23;2021-09-23;59;133;93742;88486;80.6;76.1
23;2021-09-24;65;233;93807;88719;80.7;76.3
23;2021-09-25;27;138;93834;88857;80.7;76.4
23;2021-09-26;0;1;93834;88858;80.7;76.4
23;2021-09-27;34;159;93868;89017;80.7;76.6
23;2021-09-28;34;133;93902;89150;80.8;76.7
23;2021-09-29;64;156;93966;89306;80.8;76.8
23;2021-09-30;43;64;94009;89370;80.9;76.9
23;2021-10-01;82;178;94091;89548;80.9;77.0
23;2021-10-02;22;97;94113;89645;80.9;77.1
23;2021-10-03;1;4;94114;89649;80.9;77.1
23;2021-10-04;43;93;94157;89742;81.0;77.2
23;2021-10-05;34;83;94191;89825;81.0;77.3
23;2021-10-06;56;97;94247;89922;81.1;77.3
23;2021-10-07;61;126;94308;90048;81.1;77.4
23;2021-10-08;53;192;94361;90240;81.2;77.6
23;2021-10-09;16;44;94377;90284;81.2;77.7
23;2021-10-10;0;0;94377;90284;81.2;77.7
23;2021-10-11;21;98;94398;90382;81.2;77.7
23;2021-10-12;51;86;94449;90468;81.2;77.8
23;2021-10-13;49;76;94498;90544;81.3;77.9
23;2021-10-14;31;66;94529;90610;81.3;77.9
23;2021-10-15;71;93;94600;90703;81.4;78.0
23;2021-10-16;29;38;94629;90741;81.4;78.0
23;2021-10-17;0;0;94629;90741;81.4;78.0
23;2021-10-18;53;68;94682;90809;81.4;78.1
23;2021-10-19;33;41;94715;90850;81.5;78.1
24;2020-12-27;2;1;2;1;0.0;0.0
24;2020-12-28;1;0;3;1;0.0;0.0
24;2020-12-29;2;0;5;1;0.0;0.0
24;2020-12-30;1;0;6;1;0.0;0.0
24;2020-12-31;1;0;7;1;0.0;0.0
24;2021-01-01;2;1;9;2;0.0;0.0
24;2021-01-02;1;0;10;2;0.0;0.0
24;2021-01-03;1;0;11;2;0.0;0.0
24;2021-01-04;1;0;12;2;0.0;0.0
24;2021-01-05;1;0;13;2;0.0;0.0
24;2021-01-06;3;0;16;2;0.0;0.0
24;2021-01-07;190;0;206;2;0.1;0.0
24;2021-01-08;282;0;488;2;0.1;0.0
24;2021-01-09;185;13;673;15;0.2;0.0
24;2021-01-10;35;0;708;15;0.2;0.0
24;2021-01-11;269;0;977;15;0.2;0.0
24;2021-01-12;280;0;1257;15;0.3;0.0
24;2021-01-13;233;1;1490;16;0.4;0.0
24;2021-01-14;1025;31;2515;47;0.6;0.0
24;2021-01-15;608;6;3123;53;0.8;0.0
24;2021-01-16;88;0;3211;53;0.8;0.0
24;2021-01-17;2;1;3213;54;0.8;0.0
24;2021-01-18;300;1;3513;55;0.9;0.0
24;2021-01-19;468;1;3981;56;1.0;0.0
24;2021-01-20;557;3;4538;59;1.1;0.0
24;2021-01-21;647;6;5185;65;1.3;0.0
24;2021-01-22;517;1;5702;66;1.4;0.0
24;2021-01-23;154;1;5856;67;1.4;0.0
24;2021-01-24;4;1;5860;68;1.4;0.0
24;2021-01-25;443;1;6303;69;1.5;0.0
24;2021-01-26;638;65;6941;134;1.7;0.0
24;2021-01-27;1267;15;8208;149;2.0;0.0
24;2021-01-28;987;131;9195;280;2.3;0.1
24;2021-01-29;933;139;10128;419;2.5;0.1
24;2021-01-30;282;1;10410;420;2.5;0.1
24;2021-01-31;0;0;10410;420;2.5;0.1
24;2021-02-01;379;170;10789;590;2.6;0.1
24;2021-02-02;616;308;11405;898;2.8;0.2
24;2021-02-03;654;489;12059;1387;3.0;0.3
24;2021-02-04;978;392;13037;1779;3.2;0.4
24;2021-02-05;689;410;13726;2189;3.4;0.5
24;2021-02-06;142;36;13868;2225;3.4;0.5
24;2021-02-07;33;1;13901;2226;3.4;0.5
24;2021-02-08;310;237;14211;2463;3.5;0.6
24;2021-02-09;454;231;14665;2694;3.6;0.7
24;2021-02-10;378;112;15043;2806;3.7;0.7
24;2021-02-11;561;515;15604;3321;3.8;0.8
24;2021-02-12;499;390;16103;3711;3.9;0.9
24;2021-02-13;202;45;16305;3756;4.0;0.9
24;2021-02-14;89;0;16394;3756;4.0;0.9
24;2021-02-15;188;241;16582;3997;4.1;1.0
24;2021-02-16;336;520;16918;4517;4.1;1.1
24;2021-02-17;586;848;17504;5365;4.3;1.3
24;2021-02-18;446;734;17950;6099;4.4;1.5
24;2021-02-19;462;679;18412;6778;4.5;1.7
24;2021-02-20;164;140;18576;6918;4.5;1.7
24;2021-02-21;112;0;18688;6918;4.6;1.7
24;2021-02-22;427;527;19115;7445;4.7;1.8
24;2021-02-23;565;683;19680;8128;4.8;2.0
24;2021-02-24;538;830;20218;8958;5.0;2.2
24;2021-02-25;727;865;20945;9823;5.1;2.4
24;2021-02-26;978;973;21923;10796;5.4;2.6
24;2021-02-27;363;266;22286;11062;5.5;2.7
24;2021-02-28;25;4;22311;11066;5.5;2.7
24;2021-03-01;292;371;22603;11437;5.5;2.8
24;2021-03-02;542;421;23145;11858;5.7;2.9
24;2021-03-03;681;343;23826;12201;5.8;3.0
24;2021-03-04;914;506;24740;12707;6.1;3.1
24;2021-03-05;1067;570;25807;13277;6.3;3.3
24;2021-03-06;1125;145;26932;13422;6.6;3.3
24;2021-03-07;232;63;27164;13485;6.7;3.3
24;2021-03-08;529;256;27693;13741;6.8;3.4
24;2021-03-09;1175;443;28868;14184;7.1;3.5
24;2021-03-10;1142;452;30010;14636;7.3;3.6
24;2021-03-11;1610;470;31620;15106;7.7;3.7
24;2021-03-12;2061;443;33681;15549;8.2;3.8
24;2021-03-13;1348;204;35029;15753;8.6;3.9
24;2021-03-14;141;93;35170;15846;8.6;3.9
24;2021-03-15;953;172;36123;16018;8.8;3.9
24;2021-03-16;1146;235;37269;16253;9.1;4.0
24;2021-03-17;1217;292;38486;16545;9.4;4.1
24;2021-03-18;1056;561;39542;17106;9.7;4.2
24;2021-03-19;1252;543;40794;17649;10.0;4.3
24;2021-03-20;1054;150;41848;17799;10.2;4.4
24;2021-03-21;25;11;41873;17810;10.3;4.4
24;2021-03-22;1224;424;43097;18234;10.6;4.5
24;2021-03-23;1878;400;44975;18634;11.0;4.6
24;2021-03-24;1893;390;46868;19024;11.5;4.7
24;2021-03-25;1991;476;48859;19500;12.0;4.8
24;2021-03-26;2376;285;51235;19785;12.5;4.8
24;2021-03-27;1349;44;52584;19829;12.9;4.9
24;2021-03-28;63;9;52647;19838;12.9;4.9
24;2021-03-29;1672;329;54319;20167;13.3;4.9
24;2021-03-30;2409;403;56728;20570;13.9;5.0
24;2021-03-31;2187;317;58915;20887;14.4;5.1
24;2021-04-01;2195;315;61110;21202;15.0;5.2
24;2021-04-02;2072;396;63182;21598;15.5;5.3
24;2021-04-03;1376;123;64558;21721;15.8;5.3
24;2021-04-04;74;1;64632;21722;15.8;5.3
24;2021-04-05;948;61;65580;21783;16.1;5.3
24;2021-04-06;2356;704;67936;22487;16.6;5.5
24;2021-04-07;2716;695;70652;23182;17.3;5.7
24;2021-04-08;3001;965;73653;24147;18.0;5.9
24;2021-04-09;3486;1012;77139;25159;18.9;6.2
24;2021-04-10;2596;315;79735;25474;19.5;6.2
24;2021-04-11;1103;22;80838;25496;19.8;6.2
24;2021-04-12;2497;817;83335;26313;20.4;6.4
24;2021-04-13;2901;1207;86236;27520;21.1;6.7
24;2021-04-14;2939;1200;89175;28720;21.8;7.0
24;2021-04-15;2791;1104;91966;29824;22.5;7.3
24;2021-04-16;3264;977;95230;30801;23.3;7.5
24;2021-04-17;2272;503;97502;31304;23.9;7.7
24;2021-04-18;424;6;97926;31310;24.0;7.7
24;2021-04-19;1599;1013;99525;32323;24.4;7.9
24;2021-04-20;2268;1437;101793;33760;24.9;8.3
24;2021-04-21;2145;1445;103938;35205;25.5;8.6
24;2021-04-22;2061;1261;105999;36466;26.0;8.9
24;2021-04-23;1960;1341;107959;37807;26.4;9.3
24;2021-04-24;863;724;108822;38531;26.6;9.4
24;2021-04-25;54;4;108876;38535;26.7;9.4
24;2021-04-26;1295;1480;110171;40015;27.0;9.8
24;2021-04-27;1848;1881;112019;41896;27.4;10.3
24;2021-04-28;1507;1957;113526;43853;27.8;10.7
24;2021-04-29;1732;1894;115258;45747;28.2;11.2
24;2021-04-30;2271;1780;117529;47527;28.8;11.6
24;2021-05-01;2059;1071;119588;48598;29.3;11.9
24;2021-05-02;1924;217;121512;48815;29.8;12.0
24;2021-05-03;1475;1837;122987;50652;30.1;12.4
24;2021-05-04;2227;2306;125214;52958;30.7;13.0
24;2021-05-05;1891;2722;127105;55680;31.1;13.6
24;2021-05-06;1890;2800;128995;58480;31.6;14.3
24;2021-05-07;2263;2795;131258;61275;32.1;15.0
24;2021-05-08;1285;1154;132543;62429;32.5;15.3
24;2021-05-09;1170;903;133713;63332;32.7;15.5
24;2021-05-10;1097;2627;134810;65959;33.0;16.2
24;2021-05-11;2037;2797;136847;68756;33.5;16.8
24;2021-05-12;1924;2258;138771;71014;34.0;17.4
24;2021-05-13;1465;1217;140236;72231;34.3;17.7
24;2021-05-14;2378;1333;142614;73564;34.9;18.0
24;2021-05-15;2048;816;144662;74380;35.4;18.2
24;2021-05-16;1172;347;145834;74727;35.7;18.3
24;2021-05-17;2240;1255;148074;75982;36.3;18.6
24;2021-05-18;2485;1820;150559;77802;36.9;19.1
24;2021-05-19;2283;1377;152842;79179;37.4;19.4
24;2021-05-20;2376;1577;155218;80756;38.0;19.8
24;2021-05-21;2434;1415;157652;82171;38.6;20.1
24;2021-05-22;1719;409;159371;82580;39.0;20.2
24;2021-05-23;950;72;160321;82652;39.3;20.2
24;2021-05-24;1518;333;161839;82985;39.6;20.3
24;2021-05-25;2298;1387;164137;84372;40.2;20.7
24;2021-05-26;2148;1320;166285;85692;40.7;21.0
24;2021-05-27;1750;2193;168035;87885;41.1;21.5
24;2021-05-28;2144;2004;170179;89889;41.7;22.0
24;2021-05-29;1154;2084;171333;91973;42.0;22.5
24;2021-05-30;1418;171;172751;92144;42.3;22.6
24;2021-05-31;1740;1365;174491;93509;42.7;22.9
24;2021-06-01;2582;1978;177073;95487;43.4;23.4
24;2021-06-02;2654;1785;179727;97272;44.0;23.8
24;2021-06-03;2289;1464;182016;98736;44.6;24.2
24;2021-06-04;2377;1899;184393;100635;45.2;24.6
24;2021-06-05;2007;1415;186400;102050;45.6;25.0
24;2021-06-06;767;222;187167;102272;45.8;25.0
24;2021-06-07;1432;1497;188599;103769;46.2;25.4
24;2021-06-08;1677;1905;190276;105674;46.6;25.9
24;2021-06-09;1322;1596;191598;107270;46.9;26.3
24;2021-06-10;1579;1914;193177;109184;47.3;26.7
24;2021-06-11;1334;2082;194511;111266;47.6;27.2
24;2021-06-12;1117;2543;195628;113809;47.9;27.9
24;2021-06-13;1238;919;196866;114728;48.2;28.1
24;2021-06-14;1166;1857;198032;116585;48.5;28.5
24;2021-06-15;1488;2993;199520;119578;48.9;29.3
24;2021-06-16;1670;2733;201190;122311;49.3;29.9
24;2021-06-17;1545;2180;202735;124491;49.6;30.5
24;2021-06-18;1400;2861;204135;127352;50.0;31.2
24;2021-06-19;1273;1522;205408;128874;50.3;31.6
24;2021-06-20;514;501;205922;129375;50.4;31.7
24;2021-06-21;932;1833;206854;131208;50.7;32.1
24;2021-06-22;1451;2592;208305;133800;51.0;32.8
24;2021-06-23;1425;2419;209730;136219;51.4;33.4
24;2021-06-24;1137;1917;210867;138136;51.6;33.8
24;2021-06-25;968;2818;211835;140954;51.9;34.5
24;2021-06-26;866;2104;212701;143058;52.1;35.0
24;2021-06-27;402;979;213103;144037;52.2;35.3
24;2021-06-28;818;2482;213921;146519;52.4;35.9
24;2021-06-29;938;2867;214859;149386;52.6;36.6
24;2021-06-30;1111;2456;215970;151842;52.9;37.2
24;2021-07-01;1132;2303;217102;154145;53.2;37.7
24;2021-07-02;1097;2746;218199;156891;53.4;38.4
24;2021-07-03;811;1905;219010;158796;53.6;38.9
24;2021-07-04;411;1013;219421;159809;53.7;39.1
24;2021-07-05;793;2316;220214;162125;53.9;39.7
24;2021-07-06;879;3354;221093;165479;54.1;40.5
24;2021-07-07;1087;3041;222180;168520;54.4;41.3
24;2021-07-08;1340;2121;223520;170641;54.7;41.8
24;2021-07-09;1177;3215;224697;173856;55.0;42.6
24;2021-07-10;481;1964;225178;175820;55.1;43.1
24;2021-07-11;587;1190;225765;177010;55.3;43.3
24;2021-07-12;908;2516;226673;179526;55.5;44.0
24;2021-07-13;1322;3219;227995;182745;55.8;44.7
24;2021-07-14;619;1189;228614;183934;56.0;45.0
24;2021-07-15;1697;2777;230311;186711;56.4;45.7
24;2021-07-16;2150;2598;232461;189309;56.9;46.4
24;2021-07-17;1528;2239;233989;191548;57.3;46.9
24;2021-07-18;709;887;234698;192435;57.5;47.1
24;2021-07-19;1580;2187;236278;194622;57.9;47.7
24;2021-07-20;2018;2440;238296;197062;58.3;48.3
24;2021-07-21;1875;2330;240171;199392;58.8;48.8
24;2021-07-22;2351;2443;242522;201835;59.4;49.4
24;2021-07-23;2303;2623;244825;204458;59.9;50.1
24;2021-07-24;1807;1546;246632;206004;60.4;50.4
24;2021-07-25;816;875;247448;206879;60.6;50.7
24;2021-07-26;1572;2015;249020;208894;61.0;51.2
24;2021-07-27;2848;2289;251868;211183;61.7;51.7
24;2021-07-28;2766;1940;254634;213123;62.4;52.2
24;2021-07-29;3063;2259;257697;215382;63.1;52.7
24;2021-07-30;2466;1921;260163;217303;63.7;53.2
24;2021-07-31;1654;1570;261817;218873;64.1;53.6
24;2021-08-01;1117;658;262934;219531;64.4;53.8
24;2021-08-02;1946;1623;264880;221154;64.9;54.2
24;2021-08-03;2888;1908;267768;223062;65.6;54.6
24;2021-08-04;3078;1631;270846;224693;66.3;55.0
24;2021-08-05;3049;1441;273895;226134;67.1;55.4
24;2021-08-06;2538;1540;276433;227674;67.7;55.7
24;2021-08-07;1792;1120;278225;228794;68.1;56.0
24;2021-08-08;1108;687;279333;229481;68.4;56.2
24;2021-08-09;1739;1383;281072;230864;68.8;56.5
24;2021-08-10;2266;1786;283338;232650;69.4;57.0
24;2021-08-11;2279;1698;285617;234348;69.9;57.4
24;2021-08-12;1916;1956;287533;236304;70.4;57.9
24;2021-08-13;1530;1625;289063;237929;70.8;58.3
24;2021-08-14;1171;1242;290234;239171;71.1;58.6
24;2021-08-15;741;583;290975;239754;71.2;58.7
24;2021-08-16;1123;1706;292098;241460;71.5;59.1
24;2021-08-17;1634;2109;293732;243569;71.9;59.6
24;2021-08-18;1562;1925;295294;245494;72.3;60.1
24;2021-08-19;1127;2635;296421;248129;72.6;60.8
24;2021-08-20;1107;2429;297528;250558;72.9;61.4
24;2021-08-21;875;1635;298403;252193;73.1;61.8
24;2021-08-22;350;1101;298753;253294;73.2;62.0
24;2021-08-23;673;2036;299426;255330;73.3;62.5
24;2021-08-24;818;2395;300244;257725;73.5;63.1
24;2021-08-25;815;2323;301059;260048;73.7;63.7
24;2021-08-26;747;2840;301806;262888;73.9;64.4
24;2021-08-27;801;2765;302607;265653;74.1;65.0
24;2021-08-28;522;1909;303129;267562;74.2;65.5
24;2021-08-29;171;1029;303300;268591;74.3;65.8
24;2021-08-30;376;1951;303676;270542;74.4;66.2
24;2021-08-31;593;2430;304269;272972;74.5;66.8
24;2021-09-01;627;2378;304896;275350;74.7;67.4
24;2021-09-02;465;1779;305361;277129;74.8;67.9
24;2021-09-03;550;2046;305911;279175;74.9;68.4
24;2021-09-04;365;1938;306276;281113;75.0;68.8
24;2021-09-05;245;932;306521;282045;75.1;69.1
24;2021-09-06;345;1465;306866;283510;75.1;69.4
24;2021-09-07;478;1647;307344;285157;75.3;69.8
24;2021-09-08;402;1760;307746;286917;75.4;70.3
24;2021-09-09;335;1102;308081;288019;75.4;70.5
24;2021-09-10;391;1583;308472;289602;75.5;70.9
24;2021-09-11;317;1609;308789;291211;75.6;71.3
24;2021-09-12;92;374;308881;291585;75.6;71.4
24;2021-09-13;294;1014;309175;292599;75.7;71.6
24;2021-09-14;432;911;309607;293510;75.8;71.9
24;2021-09-15;413;1268;310020;294778;75.9;72.2
24;2021-09-16;250;890;310270;295668;76.0;72.4
24;2021-09-17;411;1037;310681;296705;76.1;72.7
24;2021-09-18;312;1112;310993;297817;76.2;72.9
24;2021-09-19;45;347;311038;298164;76.2;73.0
24;2021-09-20;154;577;311192;298741;76.2;73.2
24;2021-09-21;384;411;311576;299152;76.3;73.3
24;2021-09-22;227;698;311803;299850;76.3;73.4
24;2021-09-23;140;389;311943;300239;76.4;73.5
24;2021-09-24;249;812;312192;301051;76.4;73.7
24;2021-09-25;216;593;312408;301644;76.5;73.9
24;2021-09-26;32;107;312440;301751;76.5;73.9
24;2021-09-27;181;495;312621;302246;76.5;74.0
24;2021-09-28;209;330;312830;302576;76.6;74.1
24;2021-09-29;227;588;313057;303164;76.7;74.2
24;2021-09-30;253;439;313310;303603;76.7;74.3
24;2021-10-01;229;487;313539;304090;76.8;74.5
24;2021-10-02;196;483;313735;304573;76.8;74.6
24;2021-10-03;17;39;313752;304612;76.8;74.6
24;2021-10-04;112;288;313864;304900;76.9;74.7
24;2021-10-05;105;341;313969;305241;76.9;74.7
24;2021-10-06;200;439;314169;305680;76.9;74.8
24;2021-10-07;105;175;314274;305855;77.0;74.9
24;2021-10-08;186;440;314460;306295;77.0;75.0
24;2021-10-09;169;470;314629;306765;77.0;75.1
24;2021-10-10;14;31;314643;306796;77.0;75.1
24;2021-10-11;86;189;314729;306985;77.1;75.2
24;2021-10-12;130;392;314859;307377;77.1;75.3
24;2021-10-13;125;302;314984;307679;77.1;75.3
24;2021-10-14;124;213;315108;307892;77.2;75.4
24;2021-10-15;207;409;315315;308301;77.2;75.5
24;2021-10-16;165;323;315480;308624;77.2;75.6
24;2021-10-17;18;28;315498;308652;77.3;75.6
24;2021-10-18;63;121;315561;308773;77.3;75.6
24;2021-10-19;116;266;315677;309039;77.3;75.7
25;2020-12-27;0;0;0;0;0.0;0.0
25;2020-12-28;1;0;1;0;0.0;0.0
25;2020-12-29;0;0;1;0;0.0;0.0
25;2020-12-30;0;0;1;0;0.0;0.0
25;2020-12-31;3;1;4;1;0.0;0.0
25;2021-01-01;0;0;4;1;0.0;0.0
25;2021-01-02;1;0;5;1;0.0;0.0
25;2021-01-03;0;0;5;1;0.0;0.0
25;2021-01-04;1;0;6;1;0.0;0.0
25;2021-01-05;1;0;7;1;0.0;0.0
25;2021-01-06;75;1;82;2;0.0;0.0
25;2021-01-07;235;1;317;3;0.1;0.0
25;2021-01-08;345;1;662;4;0.1;0.0
25;2021-01-09;102;0;764;4;0.1;0.0
25;2021-01-10;0;0;764;4;0.1;0.0
25;2021-01-11;503;6;1267;10;0.2;0.0
25;2021-01-12;682;2;1949;12;0.4;0.0
25;2021-01-13;627;11;2576;23;0.5;0.0
25;2021-01-14;896;19;3472;42;0.6;0.0
25;2021-01-15;787;9;4259;51;0.8;0.0
25;2021-01-16;206;1;4465;52;0.8;0.0
25;2021-01-17;112;0;4577;52;0.8;0.0
25;2021-01-18;1299;6;5876;58;1.1;0.0
25;2021-01-19;1416;5;7292;63;1.4;0.0
25;2021-01-20;1421;6;8713;69;1.6;0.0
25;2021-01-21;1843;4;10556;73;2.0;0.0
25;2021-01-22;1509;8;12065;81;2.2;0.0
25;2021-01-23;499;1;12564;82;2.3;0.0
25;2021-01-24;119;0;12683;82;2.4;0.0
25;2021-01-25;990;0;13673;82;2.5;0.0
25;2021-01-26;1490;42;15163;124;2.8;0.0
25;2021-01-27;1247;70;16410;194;3.0;0.0
25;2021-01-28;1090;75;17500;269;3.2;0.0
25;2021-01-29;906;233;18406;502;3.4;0.1
25;2021-01-30;293;91;18699;593;3.5;0.1
25;2021-01-31;2;0;18701;593;3.5;0.1
25;2021-02-01;613;222;19314;815;3.6;0.2
25;2021-02-02;674;415;19988;1230;3.7;0.2
25;2021-02-03;758;248;20746;1478;3.8;0.3
25;2021-02-04;716;445;21462;1923;4.0;0.4
25;2021-02-05;521;468;21983;2391;4.1;0.4
25;2021-02-06;197;156;22180;2547;4.1;0.5
25;2021-02-07;2;34;22182;2581;4.1;0.5
25;2021-02-08;612;508;22794;3089;4.2;0.6
25;2021-02-09;615;490;23409;3579;4.3;0.7
25;2021-02-10;818;503;24227;4082;4.5;0.8
25;2021-02-11;589;850;24816;4932;4.6;0.9
25;2021-02-12;413;550;25229;5482;4.7;1.0
25;2021-02-13;98;141;25327;5623;4.7;1.0
25;2021-02-14;0;0;25327;5623;4.7;1.0
25;2021-02-15;186;1032;25513;6655;4.7;1.2
25;2021-02-16;212;1454;25725;8109;4.8;1.5
25;2021-02-17;107;1337;25832;9446;4.8;1.8
25;2021-02-18;147;1428;25979;10874;4.8;2.0
25;2021-02-19;102;1269;26081;12143;4.8;2.3
25;2021-02-20;27;491;26108;12634;4.8;2.3
25;2021-02-21;1;143;26109;12777;4.8;2.4
25;2021-02-22;83;1061;26192;13838;4.9;2.6
25;2021-02-23;195;1077;26387;14915;4.9;2.8
25;2021-02-24;105;975;26492;15890;4.9;2.9
25;2021-02-25;522;1003;27014;16893;5.0;3.1
25;2021-02-26;607;981;27621;17874;5.1;3.3
25;2021-02-27;228;374;27849;18248;5.2;3.4
25;2021-02-28;6;1;27855;18249;5.2;3.4
25;2021-03-01;443;623;28298;18872;5.2;3.5
25;2021-03-02;653;834;28951;19706;5.4;3.7
25;2021-03-03;544;736;29495;20442;5.5;3.8
25;2021-03-04;1159;663;30654;21105;5.7;3.9
25;2021-03-05;1853;398;32507;21503;6.0;4.0
25;2021-03-06;1171;227;33678;21730;6.2;4.0
25;2021-03-07;9;9;33687;21739;6.2;4.0
25;2021-03-08;548;709;34235;22448;6.3;4.2
25;2021-03-09;1040;783;35275;23231;6.5;4.3
25;2021-03-10;1151;656;36426;23887;6.8;4.4
25;2021-03-11;1659;590;38085;24477;7.1;4.5
25;2021-03-12;1998;466;40083;24943;7.4;4.6
25;2021-03-13;1123;101;41206;25044;7.6;4.6
25;2021-03-14;35;0;41241;25044;7.6;4.6
25;2021-03-15;1126;148;42367;25192;7.9;4.7
25;2021-03-16;1288;127;43655;25319;8.1;4.7
25;2021-03-17;1414;144;45069;25463;8.4;4.7
25;2021-03-18;1526;86;46595;25549;8.6;4.7
25;2021-03-19;1595;132;48190;25681;8.9;4.8
25;2021-03-20;822;43;49012;25724;9.1;4.8
25;2021-03-21;24;0;49036;25724;9.1;4.8
25;2021-03-22;1486;88;50522;25812;9.4;4.8
25;2021-03-23;2161;164;52683;25976;9.8;4.8
25;2021-03-24;2418;101;55101;26077;10.2;4.8
25;2021-03-25;2837;201;57938;26278;10.7;4.9
25;2021-03-26;3160;183;61098;26461;11.3;4.9
25;2021-03-27;1112;91;62210;26552;11.5;4.9
25;2021-03-28;121;65;62331;26617;11.6;4.9
25;2021-03-29;1790;286;64121;26903;11.9;5.0
25;2021-03-30;2213;403;66334;27306;12.3;5.1
25;2021-03-31;2220;368;68554;27674;12.7;5.1
25;2021-04-01;2451;530;71005;28204;13.2;5.2
25;2021-04-02;2026;613;73031;28817;13.5;5.3
25;2021-04-03;447;110;73478;28927;13.6;5.4
25;2021-04-04;39;21;73517;28948;13.6;5.4
25;2021-04-05;145;4;73662;28952;13.7;5.4
25;2021-04-06;1937;691;75599;29643;14.0;5.5
25;2021-04-07;1878;857;77477;30500;14.4;5.7
25;2021-04-08;2434;831;79911;31331;14.8;5.8
25;2021-04-09;2597;997;82508;32328;15.3;6.0
25;2021-04-10;978;292;83486;32620;15.5;6.0
25;2021-04-11;105;28;83591;32648;15.5;6.1
25;2021-04-12;1556;968;85147;33616;15.8;6.2
25;2021-04-13;1988;1326;87135;34942;16.2;6.5
25;2021-04-14;1750;1223;88885;36165;16.5;6.7
25;2021-04-15;1997;1329;90882;37494;16.8;7.0
25;2021-04-16;2085;1009;92967;38503;17.2;7.1
25;2021-04-17;1104;417;94071;38920;17.4;7.2
25;2021-04-18;119;18;94190;38938;17.5;7.2
25;2021-04-19;1327;1246;95517;40184;17.7;7.4
25;2021-04-20;1615;1466;97132;41650;18.0;7.7
25;2021-04-21;1717;1636;98849;43286;18.3;8.0
25;2021-04-22;1855;1713;100704;44999;18.7;8.3
25;2021-04-23;1904;1771;102608;46770;19.0;8.7
25;2021-04-24;1278;705;103886;47475;19.3;8.8
25;2021-04-25;140;114;104026;47589;19.3;8.8
25;2021-04-26;1722;1687;105748;49276;19.6;9.1
25;2021-04-27;2804;1524;108552;50800;20.1;9.4
25;2021-04-28;2425;1563;110977;52363;20.6;9.7
25;2021-04-29;2648;1837;113625;54200;21.1;10.0
25;2021-04-30;3109;1581;116734;55781;21.6;10.3
25;2021-05-01;1789;333;118523;56114;22.0;10.4
25;2021-05-02;442;22;118965;56136;22.1;10.4
25;2021-05-03;2900;847;121865;56983;22.6;10.6
25;2021-05-04;2639;1884;124504;58867;23.1;10.9
25;2021-05-05;2597;1670;127101;60537;23.6;11.2
25;2021-05-06;2927;2170;130028;62707;24.1;11.6
25;2021-05-07;3063;2129;133091;64836;24.7;12.0
25;2021-05-08;1334;230;134425;65066;24.9;12.1
25;2021-05-09;244;87;134669;65153;25.0;12.1
25;2021-05-10;3129;1639;137798;66792;25.5;12.4
25;2021-05-11;3747;2042;141545;68834;26.2;12.8
25;2021-05-12;3688;1790;145233;70624;26.9;13.1
25;2021-05-13;3523;599;148756;71223;27.6;13.2
25;2021-05-14;4482;1307;153238;72530;28.4;13.4
25;2021-05-15;3282;710;156520;73240;29.0;13.6
25;2021-05-16;723;93;157243;73333;29.1;13.6
25;2021-05-17;4089;1100;161332;74433;29.9;13.8
25;2021-05-18;5205;1194;166537;75627;30.9;14.0
25;2021-05-19;5247;1135;171784;76762;31.8;14.2
25;2021-05-20;5134;1455;176918;78217;32.8;14.5
25;2021-05-21;5763;1981;182681;80198;33.9;14.9
25;2021-05-22;3174;723;185855;80921;34.5;15.0
25;2021-05-23;781;157;186636;81078;34.6;15.0
25;2021-05-24;1529;152;188165;81230;34.9;15.1
25;2021-05-25;3513;1651;191678;82881;35.5;15.4
25;2021-05-26;3974;1561;195652;84442;36.3;15.7
25;2021-05-27;4519;1897;200171;86339;37.1;16.0
25;2021-05-28;3994;2652;204165;88991;37.8;16.5
25;2021-05-29;2016;1021;206181;90012;38.2;16.7
25;2021-05-30;174;96;206355;90108;38.3;16.7
25;2021-05-31;2672;1708;209027;91816;38.7;17.0
25;2021-06-01;2729;2156;211756;93972;39.3;17.4
25;2021-06-02;2608;2251;214364;96223;39.7;17.8
25;2021-06-03;3273;2045;217637;98268;40.3;18.2
25;2021-06-04;3209;2412;220846;100680;40.9;18.7
25;2021-06-05;1491;1403;222337;102083;41.2;18.9
25;2021-06-06;987;259;223324;102342;41.4;19.0
25;2021-06-07;2782;2575;226106;104917;41.9;19.4
25;2021-06-08;2603;2762;228709;107679;42.4;20.0
25;2021-06-09;2382;2763;231091;110442;42.8;20.5
25;2021-06-10;2325;2654;233416;113096;43.3;21.0
25;2021-06-11;2709;3305;236125;116401;43.8;21.6
25;2021-06-12;1571;1861;237696;118262;44.1;21.9
25;2021-06-13;497;259;238193;118521;44.2;22.0
25;2021-06-14;1421;3753;239614;122274;44.4;22.7
25;2021-06-15;1641;3568;241255;125842;44.7;23.3
25;2021-06-16;1954;3273;243209;129115;45.1;23.9
25;2021-06-17;1474;3323;244683;132438;45.4;24.6
25;2021-06-18;2286;4297;246969;136735;45.8;25.3
25;2021-06-19;1350;1979;248319;138714;46.0;25.7
25;2021-06-20;59;239;248378;138953;46.0;25.8
25;2021-06-21;1139;4139;249517;143092;46.3;26.5
25;2021-06-22;1151;4673;250668;147765;46.5;27.4
25;2021-06-23;1404;4072;252072;151837;46.7;28.1
25;2021-06-24;1191;4085;253263;155922;46.9;28.9
25;2021-06-25;1640;5603;254903;161525;47.3;29.9
25;2021-06-26;626;3384;255529;164909;47.4;30.6
25;2021-06-27;451;877;255980;165786;47.5;30.7
25;2021-06-28;907;4476;256887;170262;47.6;31.6
25;2021-06-29;1130;5468;258017;175730;47.8;32.6
25;2021-06-30;1311;5372;259328;181102;48.1;33.6
25;2021-07-01;1706;5230;261034;186332;48.4;34.5
25;2021-07-02;1748;5061;262782;191393;48.7;35.5
25;2021-07-03;1042;2692;263824;194085;48.9;36.0
25;2021-07-04;409;722;264233;194807;49.0;36.1
25;2021-07-05;1299;2580;265532;197387;49.2;36.6
25;2021-07-06;1568;4748;267100;202135;49.5;37.5
25;2021-07-07;1596;4501;268696;206636;49.8;38.3
25;2021-07-08;1554;3932;270250;210568;50.1;39.0
25;2021-07-09;1796;4591;272046;215159;50.4;39.9
25;2021-07-10;781;2371;272827;217530;50.6;40.3
25;2021-07-11;127;307;272954;217837;50.6;40.4
25;2021-07-12;1404;3859;274358;221696;50.9;41.1
25;2021-07-13;2470;4770;276828;226466;51.3;42.0
25;2021-07-14;379;561;277207;227027;51.4;42.1
25;2021-07-15;2404;3658;279611;230685;51.8;42.8
25;2021-07-16;3483;3832;283094;234517;52.5;43.5
25;2021-07-17;2207;2040;285301;236557;52.9;43.9
25;2021-07-18;808;1300;286109;237857;53.0;44.1
25;2021-07-19;2544;4210;288653;242067;53.5;44.9
25;2021-07-20;3384;3714;292037;245781;54.1;45.6
25;2021-07-21;3300;3369;295337;249150;54.7;46.2
25;2021-07-22;3351;2986;298688;252136;55.4;46.7
25;2021-07-23;3566;3357;302254;255493;56.0;47.4
25;2021-07-24;1411;2269;303665;257762;56.3;47.8
25;2021-07-25;679;710;304344;258472;56.4;47.9
25;2021-07-26;3056;3012;307400;261484;57.0;48.5
25;2021-07-27;3835;2127;311235;263611;57.7;48.9
25;2021-07-28;3692;2119;314927;265730;58.4;49.3
25;2021-07-29;4321;2093;319248;267823;59.2;49.6
25;2021-07-30;4292;2492;323540;270315;60.0;50.1
25;2021-07-31;1821;1469;325361;271784;60.3;50.4
25;2021-08-01;1352;201;326713;271985;60.6;50.4
25;2021-08-02;2743;2214;329456;274199;61.1;50.8
25;2021-08-03;2840;2203;332296;276402;61.6;51.2
25;2021-08-04;2941;1430;335237;277832;62.1;51.5
25;2021-08-05;2207;1732;337444;279564;62.6;51.8
25;2021-08-06;2289;2349;339733;281913;63.0;52.3
25;2021-08-07;1294;1206;341027;283119;63.2;52.5
25;2021-08-08;325;477;341352;283596;63.3;52.6
25;2021-08-09;2025;2230;343377;285826;63.7;53.0
25;2021-08-10;1976;2524;345353;288350;64.0;53.5
25;2021-08-11;1832;2034;347185;290384;64.4;53.8
25;2021-08-12;2149;2504;349334;292888;64.8;54.3
25;2021-08-13;1712;2024;351046;294912;65.1;54.7
25;2021-08-14;970;1791;352016;296703;65.3;55.0
25;2021-08-15;9;46;352025;296749;65.3;55.0
25;2021-08-16;1262;3261;353287;300010;65.5;55.6
25;2021-08-17;1459;3286;354746;303296;65.8;56.2
25;2021-08-18;1236;2804;355982;306100;66.0;56.7
25;2021-08-19;988;2868;356970;308968;66.2;57.3
25;2021-08-20;1435;3693;358405;312661;66.4;58.0
25;2021-08-21;568;1781;358973;314442;66.5;58.3
25;2021-08-22;212;1273;359185;315715;66.6;58.5
25;2021-08-23;1116;3336;360301;319051;66.8;59.1
25;2021-08-24;1071;3234;361372;322285;67.0;59.7
25;2021-08-25;1018;3062;362390;325347;67.2;60.3
25;2021-08-26;1145;3008;363535;328355;67.4;60.9
25;2021-08-27;1206;3064;364741;331419;67.6;61.4
25;2021-08-28;588;1791;365329;333210;67.7;61.8
25;2021-08-29;162;513;365491;333723;67.8;61.9
25;2021-08-30;943;2788;366434;336511;67.9;62.4
25;2021-08-31;975;2304;367409;338815;68.1;62.8
25;2021-09-01;846;2221;368255;341036;68.3;63.2
25;2021-09-02;802;1667;369057;342703;68.4;63.5
25;2021-09-03;806;1887;369863;344590;68.6;63.9
25;2021-09-04;691;1358;370554;345948;68.7;64.1
25;2021-09-05;128;183;370682;346131;68.7;64.2
25;2021-09-06;632;1344;371314;347475;68.8;64.4
25;2021-09-07;495;1106;371809;348581;68.9;64.6
25;2021-09-08;625;1606;372434;350187;69.0;64.9
25;2021-09-09;428;989;372862;351176;69.1;65.1
25;2021-09-10;850;1626;373712;352802;69.3;65.4
25;2021-09-11;375;1034;374087;353836;69.3;65.6
25;2021-09-12;111;203;374198;354039;69.4;65.6
25;2021-09-13;732;962;374930;355001;69.5;65.8
25;2021-09-14;627;855;375557;355856;69.6;66.0
25;2021-09-15;763;1480;376320;357336;69.8;66.2
25;2021-09-16;503;829;376823;358165;69.9;66.4
25;2021-09-17;748;1340;377571;359505;70.0;66.6
25;2021-09-18;321;871;377892;360376;70.1;66.8
25;2021-09-19;78;166;377970;360542;70.1;66.8
25;2021-09-20;455;741;378425;361283;70.2;67.0
25;2021-09-21;205;592;378630;361875;70.2;67.1
25;2021-09-22;451;1192;379081;363067;70.3;67.3
25;2021-09-23;254;457;379335;363524;70.3;67.4
25;2021-09-24;494;1052;379829;364576;70.4;67.6
25;2021-09-25;282;896;380111;365472;70.5;67.7
25;2021-09-26;8;5;380119;365477;70.5;67.8
25;2021-09-27;294;586;380413;366063;70.5;67.9
25;2021-09-28;209;442;380622;366505;70.6;67.9
25;2021-09-29;459;822;381081;367327;70.6;68.1
25;2021-09-30;224;363;381305;367690;70.7;68.2
25;2021-10-01;425;888;381730;368578;70.8;68.3
25;2021-10-02;275;578;382005;369156;70.8;68.4
25;2021-10-03;9;6;382014;369162;70.8;68.4
25;2021-10-04;322;730;382336;369892;70.9;68.6
25;2021-10-05;114;365;382450;370257;70.9;68.6
25;2021-10-06;412;764;382862;371021;71.0;68.8
25;2021-10-07;127;279;382989;371300;71.0;68.8
25;2021-10-08;484;897;383473;372197;71.1;69.0
25;2021-10-09;295;512;383768;372709;71.1;69.1
25;2021-10-10;6;28;383774;372737;71.1;69.1
25;2021-10-11;265;597;384039;373334;71.2;69.2
25;2021-10-12;132;202;384171;373536;71.2;69.2
25;2021-10-13;494;772;384665;374308;71.3;69.4
25;2021-10-14;113;184;384778;374492;71.3;69.4
25;2021-10-15;515;630;385293;375122;71.4;69.5
25;2021-10-16;307;423;385600;375545;71.5;69.6
25;2021-10-17;8;7;385608;375552;71.5;69.6
25;2021-10-18;212;305;385820;375857;71.5;69.7
25;2021-10-19;97;125;385917;375982;71.5;69.7
26;2020-12-27;0;0;0;0;0.0;0.0
26;2020-12-28;0;0;0;0;0.0;0.0
26;2020-12-29;0;0;0;0;0.0;0.0
26;2020-12-30;0;0;0;0;0.0;0.0
26;2020-12-31;0;0;0;0;0.0;0.0
26;2021-01-01;1;0;1;0;0.0;0.0
26;2021-01-02;0;0;1;0;0.0;0.0
26;2021-01-03;0;0;1;0;0.0;0.0
26;2021-01-04;0;0;1;0;0.0;0.0
26;2021-01-05;0;0;1;0;0.0;0.0
26;2021-01-06;0;0;1;0;0.0;0.0
26;2021-01-07;168;0;169;0;0.0;0.0
26;2021-01-08;126;0;295;0;0.1;0.0
26;2021-01-09;2;0;297;0;0.1;0.0
26;2021-01-10;0;0;297;0;0.1;0.0
26;2021-01-11;267;2;564;2;0.1;0.0
26;2021-01-12;177;1;741;3;0.1;0.0
26;2021-01-13;418;1;1159;4;0.2;0.0
26;2021-01-14;501;2;1660;6;0.3;0.0
26;2021-01-15;563;2;2223;8;0.4;0.0
26;2021-01-16;250;1;2473;9;0.5;0.0
26;2021-01-17;0;0;2473;9;0.5;0.0
26;2021-01-18;637;1;3110;10;0.6;0.0
26;2021-01-19;785;3;3895;13;0.7;0.0
26;2021-01-20;742;0;4637;13;0.9;0.0
26;2021-01-21;809;5;5446;18;1.0;0.0
26;2021-01-22;787;5;6233;23;1.2;0.0
26;2021-01-23;563;3;6796;26;1.3;0.0
26;2021-01-24;24;0;6820;26;1.3;0.0
26;2021-01-25;696;2;7516;28;1.4;0.0
26;2021-01-26;800;4;8316;32;1.6;0.0
26;2021-01-27;823;9;9139;41;1.8;0.0
26;2021-01-28;1332;169;10471;210;2.0;0.0
26;2021-01-29;971;67;11442;277;2.2;0.1
26;2021-01-30;606;5;12048;282;2.3;0.1
26;2021-01-31;24;0;12072;282;2.3;0.1
26;2021-02-01;708;189;12780;471;2.5;0.1
26;2021-02-02;1276;216;14056;687;2.7;0.1
26;2021-02-03;1265;282;15321;969;2.9;0.2
26;2021-02-04;985;459;16306;1428;3.1;0.3
26;2021-02-05;674;336;16980;1764;3.3;0.3
26;2021-02-06;407;238;17387;2002;3.3;0.4
26;2021-02-07;57;2;17444;2004;3.4;0.4
26;2021-02-08;545;416;17989;2420;3.5;0.5
26;2021-02-09;618;475;18607;2895;3.6;0.6
26;2021-02-10;666;341;19273;3236;3.7;0.6
26;2021-02-11;753;328;20026;3564;3.8;0.7
26;2021-02-12;591;447;20617;4011;4.0;0.8
26;2021-02-13;388;332;21005;4343;4.0;0.8
26;2021-02-14;36;0;21041;4343;4.0;0.8
26;2021-02-15;414;526;21455;4869;4.1;0.9
26;2021-02-16;294;550;21749;5419;4.2;1.0
26;2021-02-17;194;737;21943;6156;4.2;1.2
26;2021-02-18;337;890;22280;7046;4.3;1.4
26;2021-02-19;341;803;22621;7849;4.3;1.5
26;2021-02-20;96;487;22717;8336;4.4;1.6
26;2021-02-21;3;24;22720;8360;4.4;1.6
26;2021-02-22;144;706;22864;9066;4.4;1.7
26;2021-02-23;398;1002;23262;10068;4.5;1.9
26;2021-02-24;346;1225;23608;11293;4.5;2.2
26;2021-02-25;748;1073;24356;12366;4.7;2.4
26;2021-02-26;925;642;25281;13008;4.9;2.5
26;2021-02-27;278;508;25559;13516;4.9;2.6
26;2021-02-28;3;30;25562;13546;4.9;2.6
26;2021-03-01;459;661;26021;14207;5.0;2.7
26;2021-03-02;742;634;26763;14841;5.1;2.9
26;2021-03-03;733;683;27496;15524;5.3;3.0
26;2021-03-04;1045;584;28541;16108;5.5;3.1
26;2021-03-05;1710;533;30251;16641;5.8;3.2
26;2021-03-06;2773;507;33024;17148;6.3;3.3
26;2021-03-07;2988;226;36012;17374;6.9;3.3
26;2021-03-08;908;654;36920;18028;7.1;3.5
26;2021-03-09;1325;558;38245;18586;7.3;3.6
26;2021-03-10;1219;514;39464;19100;7.6;3.7
26;2021-03-11;1612;656;41076;19756;7.9;3.8
26;2021-03-12;2216;489;43292;20245;8.3;3.9
26;2021-03-13;1886;347;45178;20592;8.7;4.0
26;2021-03-14;68;38;45246;20630;8.7;4.0
26;2021-03-15;1653;252;46899;20882;9.0;4.0
26;2021-03-16;1233;518;48132;21400;9.2;4.1
26;2021-03-17;1369;307;49501;21707;9.5;4.2
26;2021-03-18;1587;285;51088;21992;9.8;4.2
26;2021-03-19;2444;353;53532;22345;10.3;4.3
26;2021-03-20;1290;152;54822;22497;10.5;4.3
26;2021-03-21;61;21;54883;22518;10.5;4.3
26;2021-03-22;1847;202;56730;22720;10.9;4.4
26;2021-03-23;2476;283;59206;23003;11.4;4.4
26;2021-03-24;2551;249;61757;23252;11.9;4.5
26;2021-03-25;3044;348;64801;23600;12.4;4.5
26;2021-03-26;3053;364;67854;23964;13.0;4.6
26;2021-03-27;1243;163;69097;24127;13.3;4.6
26;2021-03-28;94;7;69191;24134;13.3;4.6
26;2021-03-29;1908;409;71099;24543;13.7;4.7
26;2021-03-30;2384;553;73483;25096;14.1;4.8
26;2021-03-31;2228;587;75711;25683;14.5;4.9
26;2021-04-01;2279;785;77990;26468;15.0;5.1
26;2021-04-02;2213;996;80203;27464;15.4;5.3
26;2021-04-03;551;1204;80754;28668;15.5;5.5
26;2021-04-04;215;887;80969;29555;15.6;5.7
26;2021-04-05;557;52;81526;29607;15.7;5.7
26;2021-04-06;1486;833;83012;30440;15.9;5.8
26;2021-04-07;1793;902;84805;31342;16.3;6.0
26;2021-04-08;3008;946;87813;32288;16.9;6.2
26;2021-04-09;3415;1013;91228;33301;17.5;6.4
26;2021-04-10;1356;929;92584;34230;17.8;6.6
26;2021-04-11;88;35;92672;34265;17.8;6.6
26;2021-04-12;1713;1127;94385;35392;18.1;6.8
26;2021-04-13;2797;1459;97182;36851;18.7;7.1
26;2021-04-14;2204;1490;99386;38341;19.1;7.4
26;2021-04-15;2282;1602;101668;39943;19.5;7.7
26;2021-04-16;2272;1596;103940;41539;20.0;8.0
26;2021-04-17;1095;841;105035;42380;20.2;8.1
26;2021-04-18;36;52;105071;42432;20.2;8.2
26;2021-04-19;1547;1575;106618;44007;20.5;8.5
26;2021-04-20;1796;1732;108414;45739;20.8;8.8
26;2021-04-21;2013;1516;110427;47255;21.2;9.1
26;2021-04-22;2291;1606;112718;48861;21.7;9.4
26;2021-04-23;2012;1644;114730;50505;22.0;9.7
26;2021-04-24;1655;846;116385;51351;22.4;9.9
26;2021-04-25;629;97;117014;51448;22.5;9.9
26;2021-04-26;1377;1598;118391;53046;22.7;10.2
26;2021-04-27;1987;1687;120378;54733;23.1;10.5
26;2021-04-28;1865;1545;122243;56278;23.5;10.8
26;2021-04-29;2867;1898;125110;58176;24.0;11.2
26;2021-04-30;2626;1769;127736;59945;24.5;11.5
26;2021-05-01;1538;380;129274;60325;24.8;11.6
26;2021-05-02;1084;118;130358;60443;25.0;11.6
26;2021-05-03;2200;1793;132558;62236;25.5;12.0
26;2021-05-04;2614;2365;135172;64601;26.0;12.4
26;2021-05-05;2772;2204;137944;66805;26.5;12.8
26;2021-05-06;3322;2228;141266;69033;27.1;13.3
26;2021-05-07;2860;2262;144126;71295;27.7;13.7
26;2021-05-08;1960;622;146086;71917;28.1;13.8
26;2021-05-09;713;124;146799;72041;28.2;13.8
26;2021-05-10;3021;1831;149820;73872;28.8;14.2
26;2021-05-11;4445;2188;154265;76060;29.6;14.6
26;2021-05-12;4828;1696;159093;77756;30.6;14.9
26;2021-05-13;4363;617;163456;78373;31.4;15.1
26;2021-05-14;4640;1551;168096;79924;32.3;15.4
26;2021-05-15;4467;626;172563;80550;33.1;15.5
26;2021-05-16;3629;345;176192;80895;33.8;15.5
26;2021-05-17;3657;1487;179849;82382;34.5;15.8
26;2021-05-18;4474;1743;184323;84125;35.4;16.2
26;2021-05-19;4486;1451;188809;85576;36.3;16.4
26;2021-05-20;4684;1770;193493;87346;37.2;16.8
26;2021-05-21;4728;1804;198221;89150;38.1;17.1
26;2021-05-22;3189;690;201410;89840;38.7;17.3
26;2021-05-23;1597;183;203007;90023;39.0;17.3
26;2021-05-24;3788;743;206795;90766;39.7;17.4
26;2021-05-25;3590;2348;210385;93114;40.4;17.9
26;2021-05-26;4177;2272;214562;95386;41.2;18.3
26;2021-05-27;4211;2460;218773;97846;42.0;18.8
26;2021-05-28;3776;2768;222549;100614;42.8;19.3
26;2021-05-29;3087;1653;225636;102267;43.3;19.6
26;2021-05-30;321;70;225957;102337;43.4;19.7
26;2021-05-31;3082;1854;229039;104191;44.0;20.0
26;2021-06-01;3110;2309;232149;106500;44.6;20.5
26;2021-06-02;2869;2220;235018;108720;45.1;20.9
26;2021-06-03;2849;2491;237867;111211;45.7;21.4
26;2021-06-04;2667;2917;240534;114128;46.2;21.9
26;2021-06-05;1806;1694;242340;115822;46.6;22.2
26;2021-06-06;10;0;242350;115822;46.6;22.2
26;2021-06-07;2346;2431;244696;118253;47.0;22.7
26;2021-06-08;2453;2293;247149;120546;47.5;23.2
26;2021-06-09;2096;2391;249245;122937;47.9;23.6
26;2021-06-10;1980;2762;251225;125699;48.3;24.1
26;2021-06-11;1887;3272;253112;128971;48.6;24.8
26;2021-06-12;1218;1790;254330;130761;48.9;25.1
26;2021-06-13;97;214;254427;130975;48.9;25.2
26;2021-06-14;1415;3498;255842;134473;49.1;25.8
26;2021-06-15;1586;3964;257428;138437;49.5;26.6
26;2021-06-16;1784;3473;259212;141910;49.8;27.3
26;2021-06-17;1510;3167;260722;145077;50.1;27.9
26;2021-06-18;1797;4368;262519;149445;50.4;28.7
26;2021-06-19;934;3180;263453;152625;50.6;29.3
26;2021-06-20;263;876;263716;153501;50.7;29.5
26;2021-06-21;1005;4558;264721;158059;50.9;30.4
26;2021-06-22;1061;5119;265782;163178;51.1;31.3
26;2021-06-23;1168;5072;266950;168250;51.3;32.3
26;2021-06-24;1259;4544;268209;172794;51.5;33.2
26;2021-06-25;1014;5542;269223;178336;51.7;34.3
26;2021-06-26;662;3822;269885;182158;51.8;35.0
26;2021-06-27;299;1273;270184;183431;51.9;35.2
26;2021-06-28;778;4757;270962;188188;52.1;36.2
26;2021-06-29;1097;4956;272059;193144;52.3;37.1
26;2021-06-30;1411;4891;273470;198035;52.5;38.0
26;2021-07-01;1651;4388;275121;202423;52.9;38.9
26;2021-07-02;1332;5162;276453;207585;53.1;39.9
26;2021-07-03;769;3321;277222;210906;53.3;40.5
26;2021-07-04;331;633;277553;211539;53.3;40.6
26;2021-07-05;887;4673;278440;216212;53.5;41.5
26;2021-07-06;1266;4199;279706;220411;53.7;42.3
26;2021-07-07;1440;3797;281146;224208;54.0;43.1
26;2021-07-08;2387;3330;283533;227538;54.5;43.7
26;2021-07-09;1558;4789;285091;232327;54.8;44.6
26;2021-07-10;910;2913;286001;235240;54.9;45.2
26;2021-07-11;332;347;286333;235587;55.0;45.3
26;2021-07-12;1113;4218;287446;239805;55.2;46.1
26;2021-07-13;2300;4343;289746;244148;55.7;46.9
26;2021-07-14;1060;814;290806;244962;55.9;47.1
26;2021-07-15;3166;3659;293972;248621;56.5;47.8
26;2021-07-16;3000;3688;296972;252309;57.0;48.5
26;2021-07-17;1877;1816;298849;254125;57.4;48.8
26;2021-07-18;20;24;298869;254149;57.4;48.8
26;2021-07-19;2724;3265;301593;257414;57.9;49.4
26;2021-07-20;3706;3370;305299;260784;58.6;50.1
26;2021-07-21;3588;3088;308887;263872;59.3;50.7
26;2021-07-22;4119;2974;313006;266846;60.1;51.3
26;2021-07-23;3860;3403;316866;270249;60.9;51.9
26;2021-07-24;2344;1363;319210;271612;61.3;52.2
26;2021-07-25;608;97;319818;271709;61.4;52.2
26;2021-07-26;3429;2586;323247;274295;62.1;52.7
26;2021-07-27;4840;2621;328087;276916;63.0;53.2
26;2021-07-28;4534;2390;332621;279306;63.9;53.7
26;2021-07-29;3902;2900;336523;282206;64.6;54.2
26;2021-07-30;3485;2677;340008;284883;65.3;54.7
26;2021-07-31;1144;1010;341152;285893;65.5;54.9
26;2021-08-01;420;108;341572;286001;65.6;54.9
26;2021-08-02;2953;2365;344525;288366;66.2;55.4
26;2021-08-03;3299;2296;347824;290662;66.8;55.8
26;2021-08-04;3999;2016;351823;292678;67.6;56.2
26;2021-08-05;3154;2208;354977;294886;68.2;56.6
26;2021-08-06;3174;2639;358151;297525;68.8;57.2
26;2021-08-07;640;845;358791;298370;68.9;57.3
26;2021-08-08;29;13;358820;298383;68.9;57.3
26;2021-08-09;2191;3061;361011;301444;69.4;57.9
26;2021-08-10;2341;3049;363352;304493;69.8;58.5
26;2021-08-11;2078;2720;365430;307213;70.2;59.0
26;2021-08-12;1775;2587;367205;309800;70.5;59.5
26;2021-08-13;1742;2424;368947;312224;70.9;60.0
26;2021-08-14;272;872;369219;313096;70.9;60.1
26;2021-08-15;6;8;369225;313104;70.9;60.1
26;2021-08-16;1190;3292;370415;316396;71.2;60.8
26;2021-08-17;1523;3154;371938;319550;71.4;61.4
26;2021-08-18;1631;3376;373569;322926;71.8;62.0
26;2021-08-19;1553;3070;375122;325996;72.1;62.6
26;2021-08-20;1446;2979;376568;328975;72.3;63.2
26;2021-08-21;599;1090;377167;330065;72.5;63.4
26;2021-08-22;58;379;377225;330444;72.5;63.5
26;2021-08-23;1602;3621;378827;334065;72.8;64.2
26;2021-08-24;1749;3596;380576;337661;73.1;64.9
26;2021-08-25;1605;3659;382181;341320;73.4;65.6
26;2021-08-26;1495;3160;383676;344480;73.7;66.2
26;2021-08-27;1570;3607;385246;348087;74.0;66.9
26;2021-08-28;395;1105;385641;349192;74.1;67.1
26;2021-08-29;10;25;385651;349217;74.1;67.1
26;2021-08-30;1466;3384;387117;352601;74.4;67.7
26;2021-08-31;1288;3312;388405;355913;74.6;68.4
26;2021-09-01;1381;2599;389786;358512;74.9;68.9
26;2021-09-02;1116;1948;390902;360460;75.1;69.2
26;2021-09-03;1104;2520;392006;362980;75.3;69.7
26;2021-09-04;432;654;392438;363634;75.4;69.9
26;2021-09-05;25;18;392463;363652;75.4;69.9
26;2021-09-06;736;1445;393199;365097;75.5;70.1
26;2021-09-07;762;1417;393961;366514;75.7;70.4
26;2021-09-08;852;1665;394813;368179;75.8;70.7
26;2021-09-09;520;1322;395333;369501;75.9;71.0
26;2021-09-10;837;1751;396170;371252;76.1;71.3
26;2021-09-11;307;715;396477;371967;76.2;71.5
26;2021-09-12;0;5;396477;371972;76.2;71.5
26;2021-09-13;545;1291;397022;373263;76.3;71.7
26;2021-09-14;736;1280;397758;374543;76.4;72.0
26;2021-09-15;720;1831;398478;376374;76.5;72.3
26;2021-09-16;499;1008;398977;377382;76.6;72.5
26;2021-09-17;620;1732;399597;379114;76.8;72.8
26;2021-09-18;272;743;399869;379857;76.8;73.0
26;2021-09-19;3;13;399872;379870;76.8;73.0
26;2021-09-20;335;1095;400207;380965;76.9;73.2
26;2021-09-21;417;1013;400624;381978;77.0;73.4
26;2021-09-22;427;1520;401051;383498;77.0;73.7
26;2021-09-23;363;784;401414;384282;77.1;73.8
26;2021-09-24;442;1433;401856;385715;77.2;74.1
26;2021-09-25;183;602;402039;386317;77.2;74.2
26;2021-09-26;2;19;402041;386336;77.2;74.2
26;2021-09-27;312;812;402353;387148;77.3;74.4
26;2021-09-28;245;611;402598;387759;77.3;74.5
26;2021-09-29;385;1010;402983;388769;77.4;74.7
26;2021-09-30;225;517;403208;389286;77.5;74.8
26;2021-10-01;447;999;403655;390285;77.5;75.0
26;2021-10-02;189;341;403844;390626;77.6;75.0
26;2021-10-03;5;4;403849;390630;77.6;75.0
26;2021-10-04;320;633;404169;391263;77.6;75.2
26;2021-10-05;155;503;404324;391766;77.7;75.3
26;2021-10-06;385;797;404709;392563;77.7;75.4
26;2021-10-07;166;400;404875;392963;77.8;75.5
26;2021-10-08;380;845;405255;393808;77.8;75.7
26;2021-10-09;206;317;405461;394125;77.9;75.7
26;2021-10-10;1;17;405462;394142;77.9;75.7
26;2021-10-11;264;526;405726;394668;77.9;75.8
26;2021-10-12;176;331;405902;394999;78.0;75.9
26;2021-10-13;319;594;406221;395593;78.0;76.0
26;2021-10-14;189;363;406410;395956;78.1;76.1
26;2021-10-15;394;612;406804;396568;78.1;76.2
26;2021-10-16;195;202;406999;396770;78.2;76.2
26;2021-10-17;7;10;407006;396780;78.2;76.2
26;2021-10-18;253;377;407259;397157;78.2;76.3
26;2021-10-19;143;200;407402;397357;78.3;76.3
27;2020-12-27;2;0;2;0;0.0;0.0
27;2020-12-28;1;0;3;0;0.0;0.0
27;2020-12-29;2;0;5;0;0.0;0.0
27;2020-12-30;0;0;5;0;0.0;0.0
27;2020-12-31;0;0;5;0;0.0;0.0
27;2021-01-01;0;0;5;0;0.0;0.0
27;2021-01-02;0;0;5;0;0.0;0.0
27;2021-01-03;2;0;7;0;0.0;0.0
27;2021-01-04;0;0;7;0;0.0;0.0
27;2021-01-05;15;0;22;0;0.0;0.0
27;2021-01-06;161;0;183;0;0.0;0.0
27;2021-01-07;373;1;556;1;0.1;0.0
27;2021-01-08;443;2;999;3;0.2;0.0
27;2021-01-09;72;1;1071;4;0.2;0.0
27;2021-01-10;100;0;1171;4;0.2;0.0
27;2021-01-11;383;0;1554;4;0.3;0.0
27;2021-01-12;409;2;1963;6;0.3;0.0
27;2021-01-13;840;3;2803;9;0.5;0.0
27;2021-01-14;1629;32;4432;41;0.7;0.0
27;2021-01-15;1224;6;5656;47;0.9;0.0
27;2021-01-16;332;2;5988;49;1.0;0.0
27;2021-01-17;205;0;6193;49;1.0;0.0
27;2021-01-18;800;3;6993;52;1.2;0.0
27;2021-01-19;772;3;7765;55;1.3;0.0
27;2021-01-20;871;1;8636;56;1.4;0.0
27;2021-01-21;654;4;9290;60;1.5;0.0
27;2021-01-22;778;5;10068;65;1.7;0.0
27;2021-01-23;350;0;10418;65;1.7;0.0
27;2021-01-24;169;6;10587;71;1.8;0.0
27;2021-01-25;635;15;11222;86;1.9;0.0
27;2021-01-26;462;17;11684;103;1.9;0.0
27;2021-01-27;506;104;12190;207;2.0;0.0
27;2021-01-28;517;294;12707;501;2.1;0.1
27;2021-01-29;509;108;13216;609;2.2;0.1
27;2021-01-30;242;29;13458;638;2.2;0.1
27;2021-01-31;27;24;13485;662;2.2;0.1
27;2021-02-01;348;194;13833;856;2.3;0.1
27;2021-02-02;308;280;14141;1136;2.4;0.2
27;2021-02-03;487;400;14628;1536;2.4;0.3
27;2021-02-04;717;884;15345;2420;2.6;0.4
27;2021-02-05;664;1141;16009;3561;2.7;0.6
27;2021-02-06;126;220;16135;3781;2.7;0.6
27;2021-02-07;25;42;16160;3823;2.7;0.6
27;2021-02-08;312;378;16472;4201;2.7;0.7
27;2021-02-09;341;553;16813;4754;2.8;0.8
27;2021-02-10;306;521;17119;5275;2.8;0.9
27;2021-02-11;318;453;17437;5728;2.9;1.0
27;2021-02-12;231;542;17668;6270;2.9;1.0
27;2021-02-13;151;133;17819;6403;3.0;1.1
27;2021-02-14;6;92;17825;6495;3.0;1.1
27;2021-02-15;389;598;18214;7093;3.0;1.2
27;2021-02-16;296;733;18510;7826;3.1;1.3
27;2021-02-17;249;635;18759;8461;3.1;1.4
27;2021-02-18;363;681;19122;9142;3.2;1.5
27;2021-02-19;218;689;19340;9831;3.2;1.6
27;2021-02-20;129;250;19469;10081;3.2;1.7
27;2021-02-21;12;136;19481;10217;3.2;1.7
27;2021-02-22;482;566;19963;10783;3.3;1.8
27;2021-02-23;496;622;20459;11405;3.4;1.9
27;2021-02-24;543;648;21002;12053;3.5;2.0
27;2021-02-25;848;760;21850;12813;3.6;2.1
27;2021-02-26;955;693;22805;13506;3.8;2.2
27;2021-02-27;408;162;23213;13668;3.9;2.3
27;2021-02-28;174;30;23387;13698;3.9;2.3
27;2021-03-01;488;442;23875;14140;4.0;2.4
27;2021-03-02;766;371;24641;14511;4.1;2.4
27;2021-03-03;855;363;25496;14874;4.2;2.5
27;2021-03-04;886;237;26382;15111;4.4;2.5
27;2021-03-05;1304;242;27686;15353;4.6;2.6
27;2021-03-06;1639;110;29325;15463;4.9;2.6
27;2021-03-07;620;18;29945;15481;5.0;2.6
27;2021-03-08;1204;304;31149;15785;5.2;2.6
27;2021-03-09;1828;270;32977;16055;5.5;2.7
27;2021-03-10;2116;352;35093;16407;5.8;2.7
27;2021-03-11;2162;234;37255;16641;6.2;2.8
27;2021-03-12;2816;204;40071;16845;6.7;2.8
27;2021-03-13;1919;130;41990;16975;7.0;2.8
27;2021-03-14;655;16;42645;16991;7.1;2.8
27;2021-03-15;1558;218;44203;17209;7.4;2.9
27;2021-03-16;1490;242;45693;17451;7.6;2.9
27;2021-03-17;1857;376;47550;17827;7.9;3.0
27;2021-03-18;1687;349;49237;18176;8.2;3.0
27;2021-03-19;1835;177;51072;18353;8.5;3.1
27;2021-03-20;905;43;51977;18396;8.7;3.1
27;2021-03-21;258;3;52235;18399;8.7;3.1
27;2021-03-22;1235;548;53470;18947;8.9;3.2
27;2021-03-23;1627;460;55097;19407;9.2;3.2
27;2021-03-24;1523;480;56620;19887;9.4;3.3
27;2021-03-25;2165;523;58785;20410;9.8;3.4
27;2021-03-26;2531;446;61316;20856;10.2;3.5
27;2021-03-27;1568;202;62884;21058;10.5;3.5
27;2021-03-28;1149;50;64033;21108;10.7;3.5
27;2021-03-29;1375;835;65408;21943;10.9;3.7
27;2021-03-30;1391;850;66799;22793;11.1;3.8
27;2021-03-31;1485;877;68284;23670;11.4;3.9
27;2021-04-01;1955;815;70239;24485;11.7;4.1
27;2021-04-02;1999;1187;72238;25672;12.0;4.3
27;2021-04-03;1563;741;73801;26413;12.3;4.4
27;2021-04-04;979;176;74780;26589;12.4;4.4
27;2021-04-05;283;7;75063;26596;12.5;4.4
27;2021-04-06;1414;1804;76477;28400;12.7;4.7
27;2021-04-07;1321;1746;77798;30146;13.0;5.0
27;2021-04-08;1685;1684;79483;31830;13.2;5.3
27;2021-04-09;2944;1570;82427;33400;13.7;5.6
27;2021-04-10;2033;988;84460;34388;14.1;5.7
27;2021-04-11;946;212;85406;34600;14.2;5.8
27;2021-04-12;2434;1518;87840;36118;14.6;6.0
27;2021-04-13;2393;1548;90233;37666;15.0;6.3
27;2021-04-14;2085;1631;92318;39297;15.4;6.5
27;2021-04-15;1874;1662;94192;40959;15.7;6.8
27;2021-04-16;2751;1118;96943;42077;16.1;7.0
27;2021-04-17;2168;498;99111;42575;16.5;7.1
27;2021-04-18;452;18;99563;42593;16.6;7.1
27;2021-04-19;1712;1175;101275;43768;16.9;7.3
27;2021-04-20;2388;1310;103663;45078;17.3;7.5
27;2021-04-21;2210;1083;105873;46161;17.6;7.7
27;2021-04-22;2180;1423;108053;47584;18.0;7.9
27;2021-04-23;2446;1182;110499;48766;18.4;8.1
27;2021-04-24;3260;1151;113759;49917;18.9;8.3
27;2021-04-25;1130;1052;114889;50969;19.1;8.5
27;2021-04-26;1924;1148;116813;52117;19.4;8.7
27;2021-04-27;2527;1093;119340;53210;19.9;8.9
27;2021-04-28;2396;1319;121736;54529;20.3;9.1
27;2021-04-29;2491;1476;124227;56005;20.7;9.3
27;2021-04-30;2371;1616;126598;57621;21.1;9.6
27;2021-05-01;2638;892;129236;58513;21.5;9.7
27;2021-05-02;1952;901;131188;59414;21.8;9.9
27;2021-05-03;3064;883;134252;60297;22.3;10.0
27;2021-05-04;2782;1652;137034;61949;22.8;10.3
27;2021-05-05;2816;1653;139850;63602;23.3;10.6
27;2021-05-06;3184;1298;143034;64900;23.8;10.8
27;2021-05-07;3322;2003;146356;66903;24.4;11.1
27;2021-05-08;2805;1332;149161;68235;24.8;11.4
27;2021-05-09;1698;298;150859;68533;25.1;11.4
27;2021-05-10;2950;2271;153809;70804;25.6;11.8
27;2021-05-11;3358;1759;157167;72563;26.2;12.1
27;2021-05-12;3464;1729;160631;74292;26.7;12.4
27;2021-05-13;1892;255;162523;74547;27.1;12.4
27;2021-05-14;3884;1790;166407;76337;27.7;12.7
27;2021-05-15;6601;953;173008;77290;28.8;12.9
27;2021-05-16;3668;438;176676;77728;29.4;12.9
27;2021-05-17;2774;1161;179450;78889;29.9;13.1
27;2021-05-18;3845;1296;183295;80185;30.5;13.3
27;2021-05-19;3967;1154;187262;81339;31.2;13.5
27;2021-05-20;3873;1174;191135;82513;31.8;13.7
27;2021-05-21;3968;1801;195103;84314;32.5;14.0
27;2021-05-22;4367;802;199470;85116;33.2;14.2
27;2021-05-23;799;173;200269;85289;33.3;14.2
27;2021-05-24;1489;342;201758;85631;33.6;14.3
27;2021-05-25;3511;1608;205269;87239;34.2;14.5
27;2021-05-26;3855;1740;209124;88979;34.8;14.8
27;2021-05-27;3789;1487;212913;90466;35.4;15.1
27;2021-05-28;3403;2634;216316;93100;36.0;15.5
27;2021-05-29;4822;2302;221138;95402;36.8;15.9
27;2021-05-30;1117;247;222255;95649;37.0;15.9
27;2021-05-31;3464;2274;225719;97923;37.6;16.3
27;2021-06-01;3813;2250;229532;100173;38.2;16.7
27;2021-06-02;3341;2183;232873;102356;38.8;17.0
27;2021-06-03;4430;2127;237303;104483;39.5;17.4
27;2021-06-04;3602;2977;240905;107460;40.1;17.9
27;2021-06-05;3207;3351;244112;110811;40.6;18.4
27;2021-06-06;2004;1005;246116;111816;41.0;18.6
27;2021-06-07;2570;2357;248686;114173;41.4;19.0
27;2021-06-08;3126;2379;251812;116552;41.9;19.4
27;2021-06-09;2305;2471;254117;119023;42.3;19.8
27;2021-06-10;2431;2041;256548;121064;42.7;20.2
27;2021-06-11;2889;3770;259437;124834;43.2;20.8
27;2021-06-12;1982;4191;261419;129025;43.5;21.5
27;2021-06-13;1085;2687;262504;131712;43.7;21.9
27;2021-06-14;1996;3113;264500;134825;44.0;22.4
27;2021-06-15;2689;3021;267189;137846;44.5;22.9
27;2021-06-16;2502;3261;269691;141107;44.9;23.5
27;2021-06-17;2298;3293;271989;144400;45.3;24.0
27;2021-06-18;2746;4420;274735;148820;45.7;24.8
27;2021-06-19;1863;3392;276598;152212;46.0;25.3
27;2021-06-20;607;710;277205;152922;46.1;25.5
27;2021-06-21;1703;3496;278908;156418;46.4;26.0
27;2021-06-22;2385;3719;281293;160137;46.8;26.7
27;2021-06-23;2073;3572;283366;163709;47.2;27.3
27;2021-06-24;2256;3414;285622;167123;47.5;27.8
27;2021-06-25;1936;4460;287558;171583;47.9;28.6
27;2021-06-26;884;5352;288442;176935;48.0;29.5
27;2021-06-27;377;1427;288819;178362;48.1;29.7
27;2021-06-28;1129;3405;289948;181767;48.3;30.3
27;2021-06-29;1703;4366;291651;186133;48.6;31.0
27;2021-06-30;2115;4096;293766;190229;48.9;31.7
27;2021-07-01;2224;3908;295990;194137;49.3;32.3
27;2021-07-02;1589;4620;297579;198757;49.5;33.1
27;2021-07-03;1309;4774;298888;203531;49.8;33.9
27;2021-07-04;503;1403;299391;204934;49.8;34.1
27;2021-07-05;1417;3529;300808;208463;50.1;34.7
27;2021-07-06;1366;4180;302174;212643;50.3;35.4
27;2021-07-07;1757;4905;303931;217548;50.6;36.2
27;2021-07-08;2089;4357;306020;221905;50.9;36.9
27;2021-07-09;1984;5287;308004;227192;51.3;37.8
27;2021-07-10;1167;4179;309171;231371;51.5;38.5
27;2021-07-11;426;1140;309597;232511;51.5;38.7
27;2021-07-12;1254;4374;310851;236885;51.7;39.4
27;2021-07-13;2759;5347;313610;242232;52.2;40.3
27;2021-07-14;1518;1753;315128;243985;52.5;40.6
27;2021-07-15;3033;5468;318161;249453;53.0;41.5
27;2021-07-16;3821;5291;321982;254744;53.6;42.4
27;2021-07-17;2732;3878;324714;258622;54.1;43.1
27;2021-07-18;553;1266;325267;259888;54.1;43.3
27;2021-07-19;3687;3792;328954;263680;54.8;43.9
27;2021-07-20;3460;3593;332414;267273;55.3;44.5
27;2021-07-21;4250;3901;336664;271174;56.0;45.1
27;2021-07-22;4750;3716;341414;274890;56.8;45.8
27;2021-07-23;3592;3400;345006;278290;57.4;46.3
27;2021-07-24;3114;2329;348120;280619;58.0;46.7
27;2021-07-25;493;546;348613;281165;58.0;46.8
27;2021-07-26;3072;3175;351685;284340;58.5;47.3
27;2021-07-27;3595;3104;355280;287444;59.1;47.9
27;2021-07-28;3592;3242;358872;290686;59.7;48.4
27;2021-07-29;4590;3511;363462;294197;60.5;49.0
27;2021-07-30;3817;3146;367279;297343;61.1;49.5
27;2021-07-31;3062;2588;370341;299931;61.7;49.9
27;2021-08-01;540;498;370881;300429;61.7;50.0
27;2021-08-02;3319;2585;374200;303014;62.3;50.4
27;2021-08-03;3427;2771;377627;305785;62.9;50.9
27;2021-08-04;3060;2335;380687;308120;63.4;51.3
27;2021-08-05;2676;2358;383363;310478;63.8;51.7
27;2021-08-06;3269;3244;386632;313722;64.4;52.2
27;2021-08-07;1801;2558;388433;316280;64.7;52.7
27;2021-08-08;218;197;388651;316477;64.7;52.7
27;2021-08-09;2210;2807;390861;319284;65.1;53.2
27;2021-08-10;2812;3514;393673;322798;65.5;53.7
27;2021-08-11;2638;3099;396311;325897;66.0;54.3
27;2021-08-12;2363;3905;398674;329802;66.4;54.9
27;2021-08-13;1745;2572;400419;332374;66.7;55.3
27;2021-08-14;1164;2890;401583;335264;66.9;55.8
27;2021-08-15;18;23;401601;335287;66.9;55.8
27;2021-08-16;1811;3816;403412;339103;67.2;56.5
27;2021-08-17;2046;3444;405458;342547;67.5;57.0
27;2021-08-18;1457;2987;406915;345534;67.7;57.5
27;2021-08-19;1711;3358;408626;348892;68.0;58.1
27;2021-08-20;1636;3441;410262;352333;68.3;58.7
27;2021-08-21;987;2842;411249;355175;68.5;59.1
27;2021-08-22;184;164;411433;355339;68.5;59.2
27;2021-08-23;1080;4008;412513;359347;68.7;59.8
27;2021-08-24;1440;3970;413953;363317;68.9;60.5
27;2021-08-25;1718;3414;415671;366731;69.2;61.1
27;2021-08-26;1158;2932;416829;369663;69.4;61.5
27;2021-08-27;1265;3224;418094;372887;69.6;62.1
27;2021-08-28;912;2870;419006;375757;69.8;62.6
27;2021-08-29;87;135;419093;375892;69.8;62.6
27;2021-08-30;905;3278;419998;379170;69.9;63.1
27;2021-08-31;1225;3083;421223;382253;70.1;63.6
27;2021-09-01;997;2922;422220;385175;70.3;64.1
27;2021-09-02;874;2188;423094;387363;70.4;64.5
27;2021-09-03;848;2170;423942;389533;70.6;64.8
27;2021-09-04;733;1957;424675;391490;70.7;65.2
27;2021-09-05;36;154;424711;391644;70.7;65.2
27;2021-09-06;538;1456;425249;393100;70.8;65.4
27;2021-09-07;698;2086;425947;395186;70.9;65.8
27;2021-09-08;771;2088;426718;397274;71.0;66.1
27;2021-09-09;683;1649;427401;398923;71.2;66.4
27;2021-09-10;905;1927;428306;400850;71.3;66.7
27;2021-09-11;612;1811;428918;402661;71.4;67.0
27;2021-09-12;42;171;428960;402832;71.4;67.1
27;2021-09-13;351;928;429311;403760;71.5;67.2
27;2021-09-14;595;1096;429906;404856;71.6;67.4
27;2021-09-15;557;1670;430463;406526;71.7;67.7
27;2021-09-16;599;1134;431062;407660;71.8;67.9
27;2021-09-17;792;1293;431854;408953;71.9;68.1
27;2021-09-18;365;1247;432219;410200;72.0;68.3
27;2021-09-19;56;161;432275;410361;72.0;68.3
27;2021-09-20;260;773;432535;411134;72.0;68.4
27;2021-09-21;428;964;432963;412098;72.1;68.6
27;2021-09-22;308;1030;433271;413128;72.1;68.8
27;2021-09-23;348;756;433619;413884;72.2;68.9
27;2021-09-24;582;1246;434201;415130;72.3;69.1
27;2021-09-25;291;1124;434492;416254;72.3;69.3
27;2021-09-26;4;12;434496;416266;72.3;69.3
27;2021-09-27;190;475;434686;416741;72.4;69.4
27;2021-09-28;313;726;434999;417467;72.4;69.5
27;2021-09-29;242;727;435241;418194;72.5;69.6
27;2021-09-30;166;523;435407;418717;72.5;69.7
27;2021-10-01;345;1000;435752;419717;72.5;69.9
27;2021-10-02;365;797;436117;420514;72.6;70.0
27;2021-10-03;13;12;436130;420526;72.6;70.0
27;2021-10-04;178;374;436308;420900;72.6;70.1
27;2021-10-05;262;465;436570;421365;72.7;70.1
27;2021-10-06;282;693;436852;422058;72.7;70.3
27;2021-10-07;144;281;436996;422339;72.7;70.3
27;2021-10-08;329;826;437325;423165;72.8;70.4
27;2021-10-09;254;539;437579;423704;72.8;70.5
27;2021-10-10;12;35;437591;423739;72.8;70.5
27;2021-10-11;159;388;437750;424127;72.9;70.6
27;2021-10-12;250;474;438000;424601;72.9;70.7
27;2021-10-13;279;421;438279;425022;73.0;70.8
27;2021-10-14;148;360;438427;425382;73.0;70.8
27;2021-10-15;350;800;438777;426182;73.0;70.9
27;2021-10-16;333;466;439110;426648;73.1;71.0
27;2021-10-17;23;22;439133;426670;73.1;71.0
27;2021-10-18;173;250;439306;426920;73.1;71.1
27;2021-10-19;242;325;439548;427245;73.2;71.1
28;2020-12-27;0;0;0;0;0.0;0.0
28;2020-12-28;0;0;0;0;0.0;0.0
28;2020-12-29;0;0;0;0;0.0;0.0
28;2020-12-30;0;0;0;0;0.0;0.0
28;2020-12-31;0;0;0;0;0.0;0.0
28;2021-01-01;1;0;1;0;0.0;0.0
28;2021-01-02;0;0;1;0;0.0;0.0
28;2021-01-03;0;0;1;0;0.0;0.0
28;2021-01-04;0;0;1;0;0.0;0.0
28;2021-01-05;5;0;6;0;0.0;0.0
28;2021-01-06;84;0;90;0;0.0;0.0
28;2021-01-07;102;0;192;0;0.0;0.0
28;2021-01-08;134;2;326;2;0.1;0.0
28;2021-01-09;79;0;405;2;0.1;0.0
28;2021-01-10;1;0;406;2;0.1;0.0
28;2021-01-11;204;0;610;2;0.1;0.0
28;2021-01-12;265;2;875;4;0.2;0.0
28;2021-01-13;398;3;1273;7;0.3;0.0
28;2021-01-14;452;6;1725;13;0.4;0.0
28;2021-01-15;374;3;2099;16;0.5;0.0
28;2021-01-16;206;2;2305;18;0.5;0.0
28;2021-01-17;21;0;2326;18;0.5;0.0
28;2021-01-18;374;2;2700;20;0.6;0.0
28;2021-01-19;503;4;3203;24;0.7;0.0
28;2021-01-20;636;1;3839;25;0.9;0.0
28;2021-01-21;796;3;4635;28;1.1;0.0
28;2021-01-22;478;1;5113;29;1.2;0.0
28;2021-01-23;353;0;5466;29;1.3;0.0
28;2021-01-24;1;0;5467;29;1.3;0.0
28;2021-01-25;456;4;5923;33;1.4;0.0
28;2021-01-26;717;9;6640;42;1.5;0.0
28;2021-01-27;1212;52;7852;94;1.8;0.0
28;2021-01-28;1587;95;9439;189;2.2;0.0
28;2021-01-29;895;99;10334;288;2.4;0.1
28;2021-01-30;249;53;10583;341;2.5;0.1
28;2021-01-31;2;22;10585;363;2.5;0.1
28;2021-02-01;325;121;10910;484;2.5;0.1
28;2021-02-02;368;239;11278;723;2.6;0.2
28;2021-02-03;473;258;11751;981;2.7;0.2
28;2021-02-04;526;279;12277;1260;2.9;0.3
28;2021-02-05;436;230;12713;1490;3.0;0.3
28;2021-02-06;201;130;12914;1620;3.0;0.4
28;2021-02-07;0;0;12914;1620;3.0;0.4
28;2021-02-08;331;250;13245;1870;3.1;0.4
28;2021-02-09;281;344;13526;2214;3.1;0.5
28;2021-02-10;443;399;13969;2613;3.3;0.6
28;2021-02-11;562;492;14531;3105;3.4;0.7
28;2021-02-12;453;432;14984;3537;3.5;0.8
28;2021-02-13;181;191;15165;3728;3.5;0.9
28;2021-02-14;0;2;15165;3730;3.5;0.9
28;2021-02-15;280;473;15445;4203;3.6;1.0
28;2021-02-16;396;710;15841;4913;3.7;1.1
28;2021-02-17;584;1155;16425;6068;3.8;1.4
28;2021-02-18;666;1408;17091;7476;4.0;1.7
28;2021-02-19;548;766;17639;8242;4.1;1.9
28;2021-02-20;114;145;17753;8387;4.1;2.0
28;2021-02-21;7;33;17760;8420;4.1;2.0
28;2021-02-22;223;521;17983;8941;4.2;2.1
28;2021-02-23;203;379;18186;9320;4.2;2.2
28;2021-02-24;244;474;18430;9794;4.3;2.3
28;2021-02-25;574;454;19004;10248;4.4;2.4
28;2021-02-26;764;378;19768;10626;4.6;2.5
28;2021-02-27;265;86;20033;10712;4.7;2.5
28;2021-02-28;23;17;20056;10729;4.7;2.5
28;2021-03-01;293;215;20349;10944;4.7;2.5
28;2021-03-02;396;293;20745;11237;4.8;2.6
28;2021-03-03;367;399;21112;11636;4.9;2.7
28;2021-03-04;720;494;21832;12130;5.1;2.8
28;2021-03-05;1319;419;23151;12549;5.4;2.9
28;2021-03-06;1999;95;25150;12644;5.9;2.9
28;2021-03-07;974;42;26124;12686;6.1;3.0
28;2021-03-08;398;308;26522;12994;6.2;3.0
28;2021-03-09;981;364;27503;13358;6.4;3.1
28;2021-03-10;1358;558;28861;13916;6.7;3.2
28;2021-03-11;1535;710;30396;14626;7.1;3.4
28;2021-03-12;2258;647;32654;15273;7.6;3.6
28;2021-03-13;1235;134;33889;15407;7.9;3.6
28;2021-03-14;519;18;34408;15425;8.0;3.6
28;2021-03-15;755;234;35163;15659;8.2;3.6
28;2021-03-16;716;224;35879;15883;8.4;3.7
28;2021-03-17;746;290;36625;16173;8.5;3.8
28;2021-03-18;1203;278;37828;16451;8.8;3.8
28;2021-03-19;1558;340;39386;16791;9.2;3.9
28;2021-03-20;639;21;40025;16812;9.3;3.9
28;2021-03-21;29;8;40054;16820;9.3;3.9
28;2021-03-22;765;324;40819;17144;9.5;4.0
28;2021-03-23;1027;193;41846;17337;9.7;4.0
28;2021-03-24;1315;281;43161;17618;10.1;4.1
28;2021-03-25;1796;291;44957;17909;10.5;4.2
28;2021-03-26;2084;348;47041;18257;11.0;4.3
28;2021-03-27;402;38;47443;18295;11.0;4.3
28;2021-03-28;12;0;47455;18295;11.1;4.3
28;2021-03-29;1139;358;48594;18653;11.3;4.3
28;2021-03-30;1710;255;50304;18908;11.7;4.4
28;2021-03-31;2017;482;52321;19390;12.2;4.5
28;2021-04-01;1795;591;54116;19981;12.6;4.7
28;2021-04-02;1583;1321;55699;21302;13.0;5.0
28;2021-04-03;607;1071;56306;22373;13.1;5.2
28;2021-04-04;33;302;56339;22675;13.1;5.3
28;2021-04-05;40;3;56379;22678;13.1;5.3
28;2021-04-06;1222;467;57601;23145;13.4;5.4
28;2021-04-07;1890;1008;59491;24153;13.9;5.6
28;2021-04-08;2085;1076;61576;25229;14.3;5.9
28;2021-04-09;3230;924;64806;26153;15.1;6.1
28;2021-04-10;1581;203;66387;26356;15.5;6.1
28;2021-04-11;141;451;66528;26807;15.5;6.2
28;2021-04-12;1672;568;68200;27375;15.9;6.4
28;2021-04-13;1875;673;70075;28048;16.3;6.5
28;2021-04-14;2770;906;72845;28954;17.0;6.7
28;2021-04-15;2557;1153;75402;30107;17.6;7.0
28;2021-04-16;2554;811;77956;30918;18.2;7.2
28;2021-04-17;2309;134;80265;31052;18.7;7.2
28;2021-04-18;45;8;80310;31060;18.7;7.2
28;2021-04-19;1576;651;81886;31711;19.1;7.4
28;2021-04-20;1836;598;83722;32309;19.5;7.5
28;2021-04-21;2680;965;86402;33274;20.1;7.7
28;2021-04-22;1783;1224;88185;34498;20.5;8.0
28;2021-04-23;2325;1109;90510;35607;21.1;8.3
28;2021-04-24;3656;143;94166;35750;21.9;8.3
28;2021-04-25;1012;39;95178;35789;22.2;8.3
28;2021-04-26;1331;930;96509;36719;22.5;8.6
28;2021-04-27;1436;1287;97945;38006;22.8;8.9
28;2021-04-28;2373;1834;100318;39840;23.4;9.3
28;2021-04-29;2131;1515;102449;41355;23.9;9.6
28;2021-04-30;2973;1231;105422;42586;24.5;9.9
28;2021-05-01;127;121;105549;42707;24.6;9.9
28;2021-05-02;2;65;105551;42772;24.6;10.0
28;2021-05-03;1049;1022;106600;43794;24.8;10.2
28;2021-05-04;1359;1672;107959;45466;25.1;10.6
28;2021-05-05;2830;1654;110789;47120;25.8;11.0
28;2021-05-06;2456;1470;113245;48590;26.4;11.3
28;2021-05-07;2311;1934;115556;50524;26.9;11.8
28;2021-05-08;1078;118;116634;50642;27.2;11.8
28;2021-05-09;105;610;116739;51252;27.2;11.9
28;2021-05-10;1308;1894;118047;53146;27.5;12.4
28;2021-05-11;2024;2344;120071;55490;28.0;12.9
28;2021-05-12;2620;3236;122691;58726;28.6;13.7
28;2021-05-13;289;452;122980;59178;28.6;13.8
28;2021-05-14;1900;1616;124880;60794;29.1;14.2
28;2021-05-15;1433;1673;126313;62467;29.4;14.5
28;2021-05-16;1986;131;128299;62598;29.9;14.6
28;2021-05-17;2874;1493;131173;64091;30.5;14.9
28;2021-05-18;3382;1381;134555;65472;31.3;15.2
28;2021-05-19;5089;1282;139644;66754;32.5;15.5
28;2021-05-20;4149;1230;143793;67984;33.5;15.8
28;2021-05-21;3464;1587;147257;69571;34.3;16.2
28;2021-05-22;729;1161;147986;70732;34.5;16.5
28;2021-05-23;1956;139;149942;70871;34.9;16.5
28;2021-05-24;1428;395;151370;71266;35.2;16.6
28;2021-05-25;1876;1408;153246;72674;35.7;16.9
28;2021-05-26;2765;1346;156011;74020;36.3;17.2
28;2021-05-27;2754;1234;158765;75254;37.0;17.5
28;2021-05-28;3080;1732;161845;76986;37.7;17.9
28;2021-05-29;1868;873;163713;77859;38.1;18.1
28;2021-05-30;16;47;163729;77906;38.1;18.1
28;2021-05-31;2014;937;165743;78843;38.6;18.4
28;2021-06-01;2133;1662;167876;80505;39.1;18.7
28;2021-06-02;2076;2456;169952;82961;39.6;19.3
28;2021-06-03;2498;1562;172450;84523;40.2;19.7
28;2021-06-04;2608;2358;175058;86881;40.8;20.2
28;2021-06-05;1909;2522;176967;89403;41.2;20.8
28;2021-06-06;1060;1046;178027;90449;41.5;21.1
28;2021-06-07;3575;1575;181602;92024;42.3;21.4
28;2021-06-08;3196;1520;184798;93544;43.0;21.8
28;2021-06-09;3675;2130;188473;95674;43.9;22.3
28;2021-06-10;3141;1262;191614;96936;44.6;22.6
28;2021-06-11;3790;2135;195404;99071;45.5;23.1
28;2021-06-12;1304;560;196708;99631;45.8;23.2
28;2021-06-13;385;108;197093;99739;45.9;23.2
28;2021-06-14;2207;1995;199300;101734;46.4;23.7
28;2021-06-15;2092;2224;201392;103958;46.9;24.2
28;2021-06-16;2508;3982;203900;107940;47.5;25.1
28;2021-06-17;1940;3135;205840;111075;47.9;25.9
28;2021-06-18;2487;3789;208327;114864;48.5;26.7
28;2021-06-19;776;1612;209103;116476;48.7;27.1
28;2021-06-20;23;24;209126;116500;48.7;27.1
28;2021-06-21;1682;1989;210808;118489;49.1;27.6
28;2021-06-22;1372;2108;212180;120597;49.4;28.1
28;2021-06-23;1782;3164;213962;123761;49.8;28.8
28;2021-06-24;734;929;214696;124690;50.0;29.0
28;2021-06-25;1888;3028;216584;127718;50.4;29.7
28;2021-06-26;310;2114;216894;129832;50.5;30.2
28;2021-06-27;588;1284;217482;131116;50.6;30.5
28;2021-06-28;1225;3655;218707;134771;50.9;31.4
28;2021-06-29;1342;3791;220049;138562;51.2;32.3
28;2021-06-30;1494;4261;221543;142823;51.6;33.3
28;2021-07-01;1277;3500;222820;146323;51.9;34.1
28;2021-07-02;1313;4651;224133;150974;52.2;35.2
28;2021-07-03;1131;2372;225264;153346;52.5;35.7
28;2021-07-04;145;1325;225409;154671;52.5;36.0
28;2021-07-05;1358;2512;226767;157183;52.8;36.6
28;2021-07-06;1508;2870;228275;160053;53.2;37.3
28;2021-07-07;1636;4144;229911;164197;53.5;38.2
28;2021-07-08;1467;3241;231378;167438;53.9;39.0
28;2021-07-09;1392;4520;232770;171958;54.2;40.0
28;2021-07-10;528;2206;233298;174164;54.3;40.6
28;2021-07-11;2;1;233300;174165;54.3;40.6
28;2021-07-12;1526;3929;234826;178094;54.7;41.5
28;2021-07-13;2261;4143;237087;182237;55.2;42.4
28;2021-07-14;1328;1395;238415;183632;55.5;42.8
28;2021-07-15;2985;3973;241400;187605;56.2;43.7
28;2021-07-16;2444;4752;243844;192357;56.8;44.8
28;2021-07-17;1263;2431;245107;194788;57.1;45.4
28;2021-07-18;368;945;245475;195733;57.2;45.6
28;2021-07-19;1806;4339;247281;200072;57.6;46.6
28;2021-07-20;2476;4091;249757;204163;58.2;47.5
28;2021-07-21;2959;4286;252716;208449;58.8;48.5
28;2021-07-22;3670;3432;256386;211881;59.7;49.3
28;2021-07-23;2959;3998;259345;215879;60.4;50.3
28;2021-07-24;1715;1486;261060;217365;60.8;50.6
28;2021-07-25;67;60;261127;217425;60.8;50.6
28;2021-07-26;2930;3388;264057;220813;61.5;51.4
28;2021-07-27;3885;2621;267942;223434;62.4;52.0
28;2021-07-28;3946;2746;271888;226180;63.3;52.7
28;2021-07-29;4466;2092;276354;228272;64.4;53.2
28;2021-07-30;3825;2849;280179;231121;65.2;53.8
28;2021-07-31;763;826;280942;231947;65.4;54.0
28;2021-08-01;378;65;281320;232012;65.5;54.0
28;2021-08-02;1793;1520;283113;233532;65.9;54.4
28;2021-08-03;2684;2168;285797;235700;66.6;54.9
28;2021-08-04;1932;2304;287729;238004;67.0;55.4
28;2021-08-05;1663;1731;289392;239735;67.4;55.8
28;2021-08-06;1618;1970;291010;241705;67.8;56.3
28;2021-08-07;798;1002;291808;242707;68.0;56.5
28;2021-08-08;22;33;291830;242740;68.0;56.5
28;2021-08-09;1388;1102;293218;243842;68.3;56.8
28;2021-08-10;1715;2027;294933;245869;68.7;57.3
28;2021-08-11;1274;1572;296207;247441;69.0;57.6
28;2021-08-12;1165;1881;297372;249322;69.2;58.1
28;2021-08-13;1320;1649;298692;250971;69.6;58.4
28;2021-08-14;659;844;299351;251815;69.7;58.6
28;2021-08-15;264;59;299615;251874;69.8;58.7
28;2021-08-16;863;2145;300478;254019;70.0;59.2
28;2021-08-17;1127;2798;301605;256817;70.2;59.8
28;2021-08-18;891;2412;302496;259229;70.4;60.4
28;2021-08-19;890;2616;303386;261845;70.6;61.0
28;2021-08-20;940;2753;304326;264598;70.9;61.6
28;2021-08-21;381;1001;304707;265599;71.0;61.8
28;2021-08-22;9;31;304716;265630;71.0;61.9
28;2021-08-23;1041;2149;305757;267779;71.2;62.4
28;2021-08-24;867;2582;306624;270361;71.4;63.0
28;2021-08-25;1078;2210;307702;272571;71.7;63.5
28;2021-08-26;701;1817;308403;274388;71.8;63.9
28;2021-08-27;750;2369;309153;276757;72.0;64.4
28;2021-08-28;524;1098;309677;277855;72.1;64.7
28;2021-08-29;7;23;309684;277878;72.1;64.7
28;2021-08-30;994;2164;310678;280042;72.3;65.2
28;2021-08-31;798;2186;311476;282228;72.5;65.7
28;2021-09-01;750;2433;312226;284661;72.7;66.3
28;2021-09-02;540;1958;312766;286619;72.8;66.7
28;2021-09-03;668;2365;313434;288984;73.0;67.3
28;2021-09-04;586;2503;314020;291487;73.1;67.9
28;2021-09-05;210;139;314230;291626;73.2;67.9
28;2021-09-06;405;1388;314635;293014;73.3;68.2
28;2021-09-07;352;1298;314987;294312;73.4;68.5
28;2021-09-08;544;1426;315531;295738;73.5;68.9
28;2021-09-09;319;982;315850;296720;73.6;69.1
28;2021-09-10;594;1417;316444;298137;73.7;69.4
28;2021-09-11;298;1257;316742;299394;73.8;69.7
28;2021-09-12;40;28;316782;299422;73.8;69.7
28;2021-09-13;312;734;317094;300156;73.8;69.9
28;2021-09-14;322;941;317416;301097;73.9;70.1
28;2021-09-15;531;1027;317947;302124;74.0;70.4
28;2021-09-16;253;689;318200;302813;74.1;70.5
28;2021-09-17;302;1048;318502;303861;74.2;70.8
28;2021-09-18;126;237;318628;304098;74.2;70.8
28;2021-09-19;7;17;318635;304115;74.2;70.8
28;2021-09-20;154;459;318789;304574;74.2;70.9
28;2021-09-21;395;935;319184;305509;74.3;71.1
28;2021-09-22;330;1068;319514;306577;74.4;71.4
28;2021-09-23;190;507;319704;307084;74.4;71.5
28;2021-09-24;255;968;319959;308052;74.5;71.7
28;2021-09-25;99;326;320058;308378;74.5;71.8
28;2021-09-26;21;34;320079;308412;74.5;71.8
28;2021-09-27;167;664;320246;309076;74.6;72.0
28;2021-09-28;172;440;320418;309516;74.6;72.1
28;2021-09-29;352;688;320770;310204;74.7;72.2
28;2021-09-30;234;451;321004;310655;74.8;72.3
28;2021-10-01;251;726;321255;311381;74.8;72.5
28;2021-10-02;76;151;321331;311532;74.8;72.5
28;2021-10-03;0;6;321331;311538;74.8;72.5
28;2021-10-04;132;255;321463;311793;74.9;72.6
28;2021-10-05;159;369;321622;312162;74.9;72.7
28;2021-10-06;198;608;321820;312770;74.9;72.8
28;2021-10-07;133;274;321953;313044;75.0;72.9
28;2021-10-08;254;464;322207;313508;75.0;73.0
28;2021-10-09;75;143;322282;313651;75.0;73.0
28;2021-10-10;10;12;322292;313663;75.1;73.0
28;2021-10-11;158;223;322450;313886;75.1;73.1
28;2021-10-12;183;380;322633;314266;75.1;73.2
28;2021-10-13;192;406;322825;314672;75.2;73.3
28;2021-10-14;173;257;322998;314929;75.2;73.3
28;2021-10-15;224;384;323222;315313;75.3;73.4
28;2021-10-16;53;103;323275;315416;75.3;73.5
28;2021-10-17;11;24;323286;315440;75.3;73.5
28;2021-10-18;125;138;323411;315578;75.3;73.5
28;2021-10-19;181;266;323592;315844;75.4;73.6
29;2020-12-27;0;0;0;0;0.0;0.0
29;2020-12-28;1;1;1;1;0.0;0.0
29;2020-12-29;0;0;1;1;0.0;0.0
29;2020-12-30;0;0;1;1;0.0;0.0
29;2020-12-31;0;0;1;1;0.0;0.0
29;2021-01-01;3;0;4;1;0.0;0.0
29;2021-01-02;2;0;6;1;0.0;0.0
29;2021-01-03;1;0;7;1;0.0;0.0
29;2021-01-04;33;0;40;1;0.0;0.0
29;2021-01-05;32;0;72;1;0.0;0.0
29;2021-01-06;43;0;115;1;0.0;0.0
29;2021-01-07;139;0;254;1;0.0;0.0
29;2021-01-08;408;1;662;2;0.1;0.0
29;2021-01-09;2;0;664;2;0.1;0.0
29;2021-01-10;2;0;666;2;0.1;0.0
29;2021-01-11;668;0;1334;2;0.1;0.0
29;2021-01-12;1121;0;2455;2;0.3;0.0
29;2021-01-13;1101;2;3556;4;0.4;0.0
29;2021-01-14;895;4;4451;8;0.5;0.0
29;2021-01-15;1222;7;5673;15;0.6;0.0
29;2021-01-16;168;1;5841;16;0.6;0.0
29;2021-01-17;111;1;5952;17;0.7;0.0
29;2021-01-18;843;6;6795;23;0.7;0.0
29;2021-01-19;1314;3;8109;26;0.9;0.0
29;2021-01-20;2393;3;10502;29;1.2;0.0
29;2021-01-21;5663;16;16165;45;1.8;0.0
29;2021-01-22;3809;8;19974;53;2.2;0.0
29;2021-01-23;539;0;20513;53;2.3;0.0
29;2021-01-24;200;1;20713;54;2.3;0.0
29;2021-01-25;573;7;21286;61;2.3;0.0
29;2021-01-26;954;34;22240;95;2.5;0.0
29;2021-01-27;1286;53;23526;148;2.6;0.0
29;2021-01-28;803;137;24329;285;2.7;0.0
29;2021-01-29;780;205;25109;490;2.8;0.1
29;2021-01-30;282;4;25391;494;2.8;0.1
29;2021-01-31;80;5;25471;499;2.8;0.1
29;2021-02-01;429;448;25900;947;2.9;0.1
29;2021-02-02;879;825;26779;1772;3.0;0.2
29;2021-02-03;810;895;27589;2667;3.0;0.3
29;2021-02-04;870;643;28459;3310;3.1;0.4
29;2021-02-05;677;584;29136;3894;3.2;0.4
29;2021-02-06;251;104;29387;3998;3.2;0.4
29;2021-02-07;78;104;29465;4102;3.3;0.5
29;2021-02-08;384;445;29849;4547;3.3;0.5
29;2021-02-09;864;852;30713;5399;3.4;0.6
29;2021-02-10;1150;1017;31863;6416;3.5;0.7
29;2021-02-11;1802;4163;33665;10579;3.7;1.2
29;2021-02-12;2328;2502;35993;13081;4.0;1.4
29;2021-02-13;639;413;36632;13494;4.0;1.5
29;2021-02-14;12;228;36644;13722;4.0;1.5
29;2021-02-15;268;945;36912;14667;4.1;1.6
29;2021-02-16;887;1054;37799;15721;4.2;1.7
29;2021-02-17;800;852;38599;16573;4.3;1.8
29;2021-02-18;1530;844;40129;17417;4.4;1.9
29;2021-02-19;1417;1008;41546;18425;4.6;2.0
29;2021-02-20;204;366;41750;18791;4.6;2.1
29;2021-02-21;163;167;41913;18958;4.6;2.1
29;2021-02-22;773;560;42686;19518;4.7;2.2
29;2021-02-23;1270;905;43956;20423;4.8;2.3
29;2021-02-24;1472;827;45428;21250;5.0;2.3
29;2021-02-25;2511;909;47939;22159;5.3;2.4
29;2021-02-26;2679;716;50618;22875;5.6;2.5
29;2021-02-27;1286;280;51904;23155;5.7;2.6
29;2021-02-28;200;73;52104;23228;5.7;2.6
29;2021-03-01;948;480;53052;23708;5.9;2.6
29;2021-03-02;1818;798;54870;24506;6.1;2.7
29;2021-03-03;2094;1021;56964;25527;6.3;2.8
29;2021-03-04;2843;1557;59807;27084;6.6;3.0
29;2021-03-05;3540;1685;63347;28769;7.0;3.2
29;2021-03-06;2000;441;65347;29210;7.2;3.2
29;2021-03-07;412;83;65759;29293;7.3;3.2
29;2021-03-08;1274;595;67033;29888;7.4;3.3
29;2021-03-09;2604;977;69637;30865;7.7;3.4
29;2021-03-10;2426;872;72063;31737;7.9;3.5
29;2021-03-11;4520;1006;76583;32743;8.4;3.6
29;2021-03-12;5273;974;81856;33717;9.0;3.7
29;2021-03-13;2825;414;84681;34131;9.3;3.8
29;2021-03-14;367;3;85048;34134;9.4;3.8
29;2021-03-15;2050;272;87098;34406;9.6;3.8
29;2021-03-16;1825;748;88923;35154;9.8;3.9
29;2021-03-17;1862;716;90785;35870;10.0;4.0
29;2021-03-18;1869;1038;92654;36908;10.2;4.1
29;2021-03-19;3271;885;95925;37793;10.6;4.2
29;2021-03-20;1914;225;97839;38018;10.8;4.2
29;2021-03-21;132;11;97971;38029;10.8;4.2
29;2021-03-22;1647;559;99618;38588;11.0;4.3
29;2021-03-23;3443;1043;103061;39631;11.4;4.4
29;2021-03-24;3781;1025;106842;40656;11.8;4.5
29;2021-03-25;4822;1077;111664;41733;12.3;4.6
29;2021-03-26;5423;1174;117087;42907;12.9;4.7
29;2021-03-27;2429;335;119516;43242;13.2;4.8
29;2021-03-28;198;50;119714;43292;13.2;4.8
29;2021-03-29;2042;825;121756;44117;13.4;4.9
29;2021-03-30;3975;1334;125731;45451;13.9;5.0
29;2021-03-31;3937;1162;129668;46613;14.3;5.1
29;2021-04-01;5028;1153;134696;47766;14.9;5.3
29;2021-04-02;4765;1172;139461;48938;15.4;5.4
29;2021-04-03;2500;538;141961;49476;15.7;5.5
29;2021-04-04;146;33;142107;49509;15.7;5.5
29;2021-04-05;972;333;143079;49842;15.8;5.5
29;2021-04-06;3198;1246;146277;51088;16.1;5.6
29;2021-04-07;3652;944;149929;52032;16.5;5.7
29;2021-04-08;5284;2059;155213;54091;17.1;6.0
29;2021-04-09;6761;1570;161974;55661;17.9;6.1
29;2021-04-10;3509;718;165483;56379;18.3;6.2
29;2021-04-11;120;80;165603;56459;18.3;6.2
29;2021-04-12;3853;1486;169456;57945;18.7;6.4
29;2021-04-13;5865;1764;175321;59709;19.3;6.6
29;2021-04-14;4762;1745;180083;61454;19.9;6.8
29;2021-04-15;7175;1734;187258;63188;20.7;7.0
29;2021-04-16;6703;1358;193961;64546;21.4;7.1
29;2021-04-17;3830;971;197791;65517;21.8;7.2
29;2021-04-18;489;41;198280;65558;21.9;7.2
29;2021-04-19;3881;1466;202161;67024;22.3;7.4
29;2021-04-20;4397;2137;206558;69161;22.8;7.6
29;2021-04-21;4379;2199;210937;71360;23.3;7.9
29;2021-04-22;6637;2857;217574;74217;24.0;8.2
29;2021-04-23;6050;2210;223624;76427;24.7;8.4
29;2021-04-24;4008;1323;227632;77750;25.1;8.6
29;2021-04-25;435;172;228067;77922;25.2;8.6
29;2021-04-26;5260;1880;233327;79802;25.7;8.8
29;2021-04-27;5336;3198;238663;83000;26.3;9.2
29;2021-04-28;5359;2913;244022;85913;26.9;9.5
29;2021-04-29;6594;3353;250616;89266;27.6;9.8
29;2021-04-30;6265;3909;256881;93175;28.3;10.3
29;2021-05-01;1986;981;258867;94156;28.6;10.4
29;2021-05-02;1249;196;260116;94352;28.7;10.4
29;2021-05-03;4539;2293;264655;96645;29.2;10.7
29;2021-05-04;4107;3741;268762;100386;29.6;11.1
29;2021-05-05;4525;3413;273287;103799;30.1;11.4
29;2021-05-06;6239;3726;279526;107525;30.8;11.9
29;2021-05-07;5985;4625;285511;112150;31.5;12.4
29;2021-05-08;2097;564;287608;112714;31.7;12.4
29;2021-05-09;1731;141;289339;112855;31.9;12.4
29;2021-05-10;4767;3770;294106;116625;32.4;12.9
29;2021-05-11;4709;5000;298815;121625;33.0;13.4
29;2021-05-12;5023;4381;303838;126006;33.5;13.9
29;2021-05-13;3441;1501;307279;127507;33.9;14.1
29;2021-05-14;5650;4002;312929;131509;34.5;14.5
29;2021-05-15;4050;2313;316979;133822;35.0;14.8
29;2021-05-16;1588;294;318567;134116;35.1;14.8
29;2021-05-17;5562;3130;324129;137246;35.8;15.1
29;2021-05-18;5732;3096;329861;140342;36.4;15.5
29;2021-05-19;6214;2970;336075;143312;37.1;15.8
29;2021-05-20;7172;4568;343247;147880;37.9;16.3
29;2021-05-21;7211;3813;350458;151693;38.7;16.7
29;2021-05-22;5343;2128;355801;153821;39.2;17.0
29;2021-05-23;1631;65;357432;153886;39.4;17.0
29;2021-05-24;3485;534;360917;154420;39.8;17.0
29;2021-05-25;5835;3042;366752;157462;40.5;17.4
29;2021-05-26;5889;2996;372641;160458;41.1;17.7
29;2021-05-27;6823;3987;379464;164445;41.9;18.1
29;2021-05-28;6544;4448;386008;168893;42.6;18.6
29;2021-05-29;4382;2808;390390;171701;43.1;18.9
29;2021-05-30;1113;361;391503;172062;43.2;19.0
29;2021-05-31;6384;3459;397887;175521;43.9;19.4
29;2021-06-01;6604;4352;404491;179873;44.6;19.8
29;2021-06-02;6162;4132;410653;184005;45.3;20.3
29;2021-06-03;7689;4525;418342;188530;46.1;20.8
29;2021-06-04;6812;6165;425154;194695;46.9;21.5
29;2021-06-05;5350;3037;430504;197732;47.5;21.8
29;2021-06-06;1284;538;431788;198270;47.6;21.9
29;2021-06-07;4659;5564;436447;203834;48.1;22.5
29;2021-06-08;7171;5210;443618;209044;48.9;23.1
29;2021-06-09;6404;4752;450022;213796;49.6;23.6
29;2021-06-10;7775;5063;457797;218859;50.5;24.1
29;2021-06-11;8473;5875;466270;224734;51.4;24.8
29;2021-06-12;6562;2816;472832;227550;52.2;25.1
29;2021-06-13;2352;1372;475184;228922;52.4;25.3
29;2021-06-14;4034;6320;479218;235242;52.9;25.9
29;2021-06-15;5477;6181;484695;241423;53.5;26.6
29;2021-06-16;5570;5630;490265;247053;54.1;27.3
29;2021-06-17;6371;6320;496636;253373;54.8;27.9
29;2021-06-18;6116;7493;502752;260866;55.5;28.8
29;2021-06-19;4619;3527;507371;264393;56.0;29.2
29;2021-06-20;891;1452;508262;265845;56.1;29.3
29;2021-06-21;3761;6495;512023;272340;56.5;30.0
29;2021-06-22;4490;6426;516513;278766;57.0;30.8
29;2021-06-23;4673;6132;521186;284898;57.5;31.4
29;2021-06-24;4810;6746;525996;291644;58.0;32.2
29;2021-06-25;3599;7532;529595;299176;58.4;33.0
29;2021-06-26;2132;4093;531727;303269;58.7;33.5
29;2021-06-27;967;1631;532694;304900;58.8;33.6
29;2021-06-28;2844;6862;535538;311762;59.1;34.4
29;2021-06-29;2813;7731;538351;319493;59.4;35.2
29;2021-06-30;3048;7510;541399;327003;59.7;36.1
29;2021-07-01;3792;8426;545191;335429;60.1;37.0
29;2021-07-02;3608;9670;548799;345099;60.5;38.1
29;2021-07-03;2327;6053;551126;351152;60.8;38.7
29;2021-07-04;814;1771;551940;352923;60.9;38.9
29;2021-07-05;1914;7155;553854;360078;61.1;39.7
29;2021-07-06;1543;8006;555397;368084;61.3;40.6
29;2021-07-07;1707;7039;557104;375123;61.5;41.4
29;2021-07-08;2454;8208;559558;383331;61.7;42.3
29;2021-07-09;2627;9069;562185;392400;62.0;43.3
29;2021-07-10;1917;6104;564102;398504;62.2;44.0
29;2021-07-11;449;1064;564551;399568;62.3;44.1
29;2021-07-12;1982;8375;566533;407943;62.5;45.0
29;2021-07-13;2755;8666;569288;416609;62.8;46.0
29;2021-07-14;2086;3372;571374;419981;63.0;46.3
29;2021-07-15;3858;9734;575232;429715;63.5;47.4
29;2021-07-16;4621;9199;579853;438914;64.0;48.4
29;2021-07-17;3223;6117;583076;445031;64.3;49.1
29;2021-07-18;668;1079;583744;446110;64.4;49.2
29;2021-07-19;3157;7545;586901;453655;64.7;50.0
29;2021-07-20;3556;9434;590457;463089;65.1;51.1
29;2021-07-21;3664;7711;594121;470800;65.5;51.9
29;2021-07-22;3429;8538;597550;479338;65.9;52.9
29;2021-07-23;4066;10707;601616;490045;66.4;54.1
29;2021-07-24;2536;5957;604152;496002;66.6;54.7
29;2021-07-25;655;2359;604807;498361;66.7;55.0
29;2021-07-26;3400;7282;608207;505643;67.1;55.8
29;2021-07-27;3721;7112;611928;512755;67.5;56.6
29;2021-07-28;4210;6038;616138;518793;68.0;57.2
29;2021-07-29;5706;6365;621844;525158;68.6;57.9
29;2021-07-30;5473;6538;627317;531696;69.2;58.7
29;2021-07-31;2939;4932;630256;536628;69.5;59.2
29;2021-08-01;659;921;630915;537549;69.6;59.3
29;2021-08-02;4309;5221;635224;542770;70.1;59.9
29;2021-08-03;5490;4410;640714;547180;70.7;60.4
29;2021-08-04;5745;3610;646459;550790;71.3;60.8
29;2021-08-05;6655;4111;653114;554901;72.0;61.2
29;2021-08-06;6218;4338;659332;559239;72.7;61.7
29;2021-08-07;4294;2960;663626;562199;73.2;62.0
29;2021-08-08;855;754;664481;562953;73.3;62.1
29;2021-08-09;3084;4741;667565;567694;73.6;62.6
29;2021-08-10;4494;3865;672059;571559;74.1;63.0
29;2021-08-11;3976;3189;676035;574748;74.6;63.4
29;2021-08-12;4653;4501;680688;579249;75.1;63.9
29;2021-08-13;4239;3720;684927;582969;75.6;64.3
29;2021-08-14;2968;2846;687895;585815;75.9;64.6
29;2021-08-15;338;405;688233;586220;75.9;64.7
29;2021-08-16;3289;4375;691522;590595;76.3;65.1
29;2021-08-17;4412;3421;695934;594016;76.8;65.5
29;2021-08-18;3686;3620;699620;597636;77.2;65.9
29;2021-08-19;3916;4719;703536;602355;77.6;66.4
29;2021-08-20;3513;4600;707049;606955;78.0;67.0
29;2021-08-21;2277;3164;709326;610119;78.2;67.3
29;2021-08-22;218;415;709544;610534;78.3;67.3
29;2021-08-23;2505;4627;712049;615161;78.5;67.9
29;2021-08-24;2468;4954;714517;620115;78.8;68.4
29;2021-08-25;2170;4230;716687;624345;79.1;68.9
29;2021-08-26;2362;5341;719049;629686;79.3;69.5
29;2021-08-27;2066;5914;721115;635600;79.5;70.1
29;2021-08-28;1475;4001;722590;639601;79.7;70.6
29;2021-08-29;453;1318;723043;640919;79.8;70.7
29;2021-08-30;1457;4158;724500;645077;79.9;71.2
29;2021-08-31;1631;4406;726131;649483;80.1;71.6
29;2021-09-01;1343;3756;727474;653239;80.2;72.1
29;2021-09-02;1176;4059;728650;657298;80.4;72.5
29;2021-09-03;1444;4765;730094;662063;80.5;73.0
29;2021-09-04;1421;3776;731515;665839;80.7;73.4
29;2021-09-05;228;687;731743;666526;80.7;73.5
29;2021-09-06;741;3351;732484;669877;80.8;73.9
29;2021-09-07;932;3449;733416;673326;80.9;74.3
29;2021-09-08;913;3435;734329;676761;81.0;74.7
29;2021-09-09;965;3459;735294;680220;81.1;75.0
29;2021-09-10;1199;4375;736493;684595;81.2;75.5
29;2021-09-11;734;3452;737227;688047;81.3;75.9
29;2021-09-12;117;410;737344;688457;81.3;75.9
29;2021-09-13;842;3235;738186;691692;81.4;76.3
29;2021-09-14;736;3010;738922;694702;81.5;76.6
29;2021-09-15;720;3226;739642;697928;81.6;77.0
29;2021-09-16;843;2789;740485;700717;81.7;77.3
29;2021-09-17;938;3243;741423;703960;81.8;77.7
29;2021-09-18;598;3449;742021;707409;81.9;78.0
29;2021-09-19;86;443;742107;707852;81.9;78.1
29;2021-09-20;492;2170;742599;710022;81.9;78.3
29;2021-09-21;476;1918;743075;711940;82.0;78.5
29;2021-09-22;365;2241;743440;714181;82.0;78.8
29;2021-09-23;467;1755;743907;715936;82.1;79.0
29;2021-09-24;489;2231;744396;718167;82.1;79.2
29;2021-09-25;343;2734;744739;720901;82.2;79.5
29;2021-09-26;56;239;744795;721140;82.2;79.5
29;2021-09-27;329;1639;745124;722779;82.2;79.7
29;2021-09-28;264;1567;745388;724346;82.2;79.9
29;2021-09-29;400;1678;745788;726024;82.3;80.1
29;2021-09-30;320;1327;746108;727351;82.3;80.2
29;2021-10-01;461;1536;746569;728887;82.4;80.4
29;2021-10-02;359;1675;746928;730562;82.4;80.6
29;2021-10-03;7;30;746935;730592;82.4;80.6
29;2021-10-04;299;1318;747234;731910;82.4;80.7
29;2021-10-05;240;1066;747474;732976;82.5;80.9
29;2021-10-06;302;1176;747776;734152;82.5;81.0
29;2021-10-07;315;916;748091;735068;82.5;81.1
29;2021-10-08;450;1269;748541;736337;82.6;81.2
29;2021-10-09;336;998;748877;737335;82.6;81.3
29;2021-10-10;5;12;748882;737347;82.6;81.3
29;2021-10-11;297;918;749179;738265;82.6;81.4
29;2021-10-12;242;605;749421;738870;82.7;81.5
29;2021-10-13;293;772;749714;739642;82.7;81.6
29;2021-10-14;294;649;750008;740291;82.7;81.7
29;2021-10-15;371;740;750379;741031;82.8;81.7
29;2021-10-16;322;604;750701;741635;82.8;81.8
29;2021-10-17;10;20;750711;741655;82.8;81.8
29;2021-10-18;212;560;750923;742215;82.8;81.9
29;2021-10-19;217;363;751140;742578;82.9;81.9
2A;2020-12-27;0;0;0;0;0.0;0.0
2A;2020-12-28;0;0;0;0;0.0;0.0
2A;2020-12-29;0;0;0;0;0.0;0.0
2A;2020-12-30;0;0;0;0;0.0;0.0
2A;2020-12-31;0;0;0;0;0.0;0.0
2A;2021-01-01;0;0;0;0;0.0;0.0
2A;2021-01-02;1;0;1;0;0.0;0.0
2A;2021-01-03;0;0;1;0;0.0;0.0
2A;2021-01-04;0;0;1;0;0.0;0.0
2A;2021-01-05;0;0;1;0;0.0;0.0
2A;2021-01-06;6;0;7;0;0.0;0.0
2A;2021-01-07;122;1;129;1;0.1;0.0
2A;2021-01-08;114;2;243;3;0.1;0.0
2A;2021-01-09;39;0;282;3;0.2;0.0
2A;2021-01-10;33;0;315;3;0.2;0.0
2A;2021-01-11;78;0;393;3;0.2;0.0
2A;2021-01-12;85;0;478;3;0.3;0.0
2A;2021-01-13;113;1;591;4;0.4;0.0
2A;2021-01-14;192;1;783;5;0.5;0.0
2A;2021-01-15;149;0;932;5;0.6;0.0
2A;2021-01-16;160;2;1092;7;0.7;0.0
2A;2021-01-17;86;1;1178;8;0.7;0.0
2A;2021-01-18;201;2;1379;10;0.8;0.0
2A;2021-01-19;488;5;1867;15;1.1;0.0
2A;2021-01-20;356;1;2223;16;1.4;0.0
2A;2021-01-21;453;1;2676;17;1.6;0.0
2A;2021-01-22;367;0;3043;17;1.9;0.0
2A;2021-01-23;183;0;3226;17;2.0;0.0
2A;2021-01-24;118;1;3344;18;2.1;0.0
2A;2021-01-25;215;0;3559;18;2.2;0.0
2A;2021-01-26;402;9;3961;27;2.4;0.0
2A;2021-01-27;325;7;4286;34;2.6;0.0
2A;2021-01-28;335;79;4621;113;2.8;0.1
2A;2021-01-29;342;63;4963;176;3.1;0.1
2A;2021-01-30;128;38;5091;214;3.1;0.1
2A;2021-01-31;92;12;5183;226;3.2;0.1
2A;2021-02-01;230;49;5413;275;3.3;0.2
2A;2021-02-02;288;118;5701;393;3.5;0.2
2A;2021-02-03;265;75;5966;468;3.7;0.3
2A;2021-02-04;256;124;6222;592;3.8;0.4
2A;2021-02-05;267;106;6489;698;4.0;0.4
2A;2021-02-06;121;60;6610;758;4.1;0.5
2A;2021-02-07;68;54;6678;812;4.1;0.5
2A;2021-02-08;92;210;6770;1022;4.2;0.6
2A;2021-02-09;128;302;6898;1324;4.2;0.8
2A;2021-02-10;167;237;7065;1561;4.3;1.0
2A;2021-02-11;299;363;7364;1924;4.5;1.2
2A;2021-02-12;346;302;7710;2226;4.7;1.4
2A;2021-02-13;225;60;7935;2286;4.9;1.4
2A;2021-02-14;135;79;8070;2365;5.0;1.5
2A;2021-02-15;198;182;8268;2547;5.1;1.6
2A;2021-02-16;384;320;8652;2867;5.3;1.8
2A;2021-02-17;299;168;8951;3035;5.5;1.9
2A;2021-02-18;340;199;9291;3234;5.7;2.0
2A;2021-02-19;145;298;9436;3532;5.8;2.2
2A;2021-02-20;243;138;9679;3670;6.0;2.3
2A;2021-02-21;58;54;9737;3724;6.0;2.3
2A;2021-02-22;77;215;9814;3939;6.0;2.4
2A;2021-02-23;122;289;9936;4228;6.1;2.6
2A;2021-02-24;82;297;10018;4525;6.2;2.8
2A;2021-02-25;104;265;10122;4790;6.2;2.9
2A;2021-02-26;123;272;10245;5062;6.3;3.1
2A;2021-02-27;308;70;10553;5132;6.5;3.2
2A;2021-02-28;69;66;10622;5198;6.5;3.2
2A;2021-03-01;117;152;10739;5350;6.6;3.3
2A;2021-03-02;200;265;10939;5615;6.7;3.5
2A;2021-03-03;249;258;11188;5873;6.9;3.6
2A;2021-03-04;508;227;11696;6100;7.2;3.8
2A;2021-03-05;974;291;12670;6391;7.8;3.9
2A;2021-03-06;1166;75;13836;6466;8.5;4.0
2A;2021-03-07;1021;48;14857;6514;9.1;4.0
2A;2021-03-08;933;93;15790;6607;9.7;4.1
2A;2021-03-09;938;153;16728;6760;10.3;4.2
2A;2021-03-10;636;141;17364;6901;10.7;4.2
2A;2021-03-11;723;281;18087;7182;11.1;4.4
2A;2021-03-12;563;318;18650;7500;11.5;4.6
2A;2021-03-13;613;199;19263;7699;11.9;4.7
2A;2021-03-14;311;126;19574;7825;12.1;4.8
2A;2021-03-15;378;204;19952;8029;12.3;4.9
2A;2021-03-16;498;371;20450;8400;12.6;5.2
2A;2021-03-17;703;278;21153;8678;13.0;5.3
2A;2021-03-18;447;304;21600;8982;13.3;5.5
2A;2021-03-19;489;160;22089;9142;13.6;5.6
2A;2021-03-20;1079;264;23168;9406;14.3;5.8
2A;2021-03-21;695;54;23863;9460;14.7;5.8
2A;2021-03-22;347;68;24210;9528;14.9;5.9
2A;2021-03-23;519;59;24729;9587;15.2;5.9
2A;2021-03-24;864;92;25593;9679;15.8;6.0
2A;2021-03-25;930;142;26523;9821;16.3;6.0
2A;2021-03-26;1080;166;27603;9987;17.0;6.1
2A;2021-03-27;1189;201;28792;10188;17.7;6.3
2A;2021-03-28;241;97;29033;10285;17.9;6.3
2A;2021-03-29;283;138;29316;10423;18.0;6.4
2A;2021-03-30;383;238;29699;10661;18.3;6.6
2A;2021-03-31;445;226;30144;10887;18.6;6.7
2A;2021-04-01;638;453;30782;11340;19.0;7.0
2A;2021-04-02;904;787;31686;12127;19.5;7.5
2A;2021-04-03;644;982;32330;13109;19.9;8.1
2A;2021-04-04;578;785;32908;13894;20.3;8.6
2A;2021-04-05;525;700;33433;14594;20.6;9.0
2A;2021-04-06;548;561;33981;15155;20.9;9.3
2A;2021-04-07;795;429;34776;15584;21.4;9.6
2A;2021-04-08;1047;358;35823;15942;22.1;9.8
2A;2021-04-09;935;399;36758;16341;22.6;10.1
2A;2021-04-10;1058;384;37816;16725;23.3;10.3
2A;2021-04-11;362;256;38178;16981;23.5;10.5
2A;2021-04-12;671;343;38849;17324;23.9;10.7
2A;2021-04-13;329;381;39178;17705;24.1;10.9
2A;2021-04-14;1045;591;40223;18296;24.8;11.3
2A;2021-04-15;1044;529;41267;18825;25.4;11.6
2A;2021-04-16;872;394;42139;19219;25.9;11.8
2A;2021-04-17;1368;938;43507;20157;26.8;12.4
2A;2021-04-18;981;949;44488;21106;27.4;13.0
2A;2021-04-19;270;343;44758;21449;27.6;13.2
2A;2021-04-20;354;344;45112;21793;27.8;13.4
2A;2021-04-21;729;736;45841;22529;28.2;13.9
2A;2021-04-22;897;649;46738;23178;28.8;14.3
2A;2021-04-23;986;779;47724;23957;29.4;14.7
2A;2021-04-24;1752;985;49476;24942;30.5;15.4
2A;2021-04-25;976;306;50452;25248;31.1;15.5
2A;2021-04-26;308;228;50760;25476;31.3;15.7
2A;2021-04-27;342;349;51102;25825;31.5;15.9
2A;2021-04-28;1676;426;52778;26251;32.5;16.2
2A;2021-04-29;1053;361;53831;26612;33.1;16.4
2A;2021-04-30;1131;1063;54962;27675;33.8;17.0
2A;2021-05-01;970;575;55932;28250;34.4;17.4
2A;2021-05-02;674;708;56606;28958;34.9;17.8
2A;2021-05-03;583;576;57189;29534;35.2;18.2
2A;2021-05-04;752;536;57941;30070;35.7;18.5
2A;2021-05-05;1011;985;58952;31055;36.3;19.1
2A;2021-05-06;904;911;59856;31966;36.9;19.7
2A;2021-05-07;1157;834;61013;32800;37.6;20.2
2A;2021-05-08;422;502;61435;33302;37.8;20.5
2A;2021-05-09;783;636;62218;33938;38.3;20.9
2A;2021-05-10;454;741;62672;34679;38.6;21.4
2A;2021-05-11;652;417;63324;35096;39.0;21.6
2A;2021-05-12;925;488;64249;35584;39.6;21.9
2A;2021-05-13;920;138;65169;35722;40.1;22.0
2A;2021-05-14;797;678;65966;36400;40.6;22.4
2A;2021-05-15;778;649;66744;37049;41.1;22.8
2A;2021-05-16;740;501;67484;37550;41.5;23.1
2A;2021-05-17;584;558;68068;38108;41.9;23.5
2A;2021-05-18;614;475;68682;38583;42.3;23.8
2A;2021-05-19;787;481;69469;39064;42.8;24.1
2A;2021-05-20;692;539;70161;39603;43.2;24.4
2A;2021-05-21;536;483;70697;40086;43.5;24.7
2A;2021-05-22;440;310;71137;40396;43.8;24.9
2A;2021-05-23;533;283;71670;40679;44.1;25.0
2A;2021-05-24;125;33;71795;40712;44.2;25.1
2A;2021-05-25;421;503;72216;41215;44.5;25.4
2A;2021-05-26;425;1166;72641;42381;44.7;26.1
2A;2021-05-27;435;1111;73076;43492;45.0;26.8
2A;2021-05-28;298;915;73374;44407;45.2;27.3
2A;2021-05-29;334;900;73708;45307;45.4;27.9
2A;2021-05-30;181;507;73889;45814;45.5;28.2
2A;2021-05-31;191;413;74080;46227;45.6;28.5
2A;2021-06-01;342;727;74422;46954;45.8;28.9
2A;2021-06-02;285;940;74707;47894;46.0;29.5
2A;2021-06-03;306;850;75013;48744;46.2;30.0
2A;2021-06-04;271;1091;75284;49835;46.4;30.7
2A;2021-06-05;319;1443;75603;51278;46.5;31.6
2A;2021-06-06;173;907;75776;52185;46.7;32.1
2A;2021-06-07;171;658;75947;52843;46.8;32.5
2A;2021-06-08;324;706;76271;53549;47.0;33.0
2A;2021-06-09;304;1320;76575;54869;47.1;33.8
2A;2021-06-10;329;857;76904;55726;47.3;34.3
2A;2021-06-11;277;1021;77181;56747;47.5;34.9
2A;2021-06-12;232;665;77413;57412;47.7;35.3
2A;2021-06-13;189;797;77602;58209;47.8;35.8
2A;2021-06-14;251;922;77853;59131;47.9;36.4
2A;2021-06-15;217;507;78070;59638;48.1;36.7
2A;2021-06-16;213;776;78283;60414;48.2;37.2
2A;2021-06-17;235;591;78518;61005;48.3;37.6
2A;2021-06-18;246;912;78764;61917;48.5;38.1
2A;2021-06-19;208;689;78972;62606;48.6;38.5
2A;2021-06-20;150;692;79122;63298;48.7;39.0
2A;2021-06-21;184;795;79306;64093;48.8;39.5
2A;2021-06-22;236;841;79542;64934;49.0;40.0
2A;2021-06-23;217;568;79759;65502;49.1;40.3
2A;2021-06-24;149;369;79908;65871;49.2;40.6
2A;2021-06-25;167;470;80075;66341;49.3;40.8
2A;2021-06-26;203;872;80278;67213;49.4;41.4
2A;2021-06-27;175;794;80453;68007;49.5;41.9
2A;2021-06-28;194;704;80647;68711;49.7;42.3
2A;2021-06-29;216;689;80863;69400;49.8;42.7
2A;2021-06-30;245;494;81108;69894;49.9;43.0
2A;2021-07-01;211;484;81319;70378;50.1;43.3
2A;2021-07-02;294;368;81613;70746;50.2;43.6
2A;2021-07-03;211;617;81824;71363;50.4;43.9
2A;2021-07-04;179;664;82003;72027;50.5;44.3
2A;2021-07-05;164;235;82167;72262;50.6;44.5
2A;2021-07-06;252;389;82419;72651;50.7;44.7
2A;2021-07-07;433;611;82852;73262;51.0;45.1
2A;2021-07-08;592;705;83444;73967;51.4;45.5
2A;2021-07-09;384;420;83828;74387;51.6;45.8
2A;2021-07-10;281;346;84109;74733;51.8;46.0
2A;2021-07-11;92;161;84201;74894;51.8;46.1
2A;2021-07-12;316;347;84517;75241;52.0;46.3
2A;2021-07-13;1179;535;85696;75776;52.8;46.7
2A;2021-07-14;1623;342;87319;76118;53.8;46.9
2A;2021-07-15;1434;836;88753;76954;54.6;47.4
2A;2021-07-16;1168;467;89921;77421;55.4;47.7
2A;2021-07-17;1096;348;91017;77769;56.0;47.9
2A;2021-07-18;635;136;91652;77905;56.4;48.0
2A;2021-07-19;918;430;92570;78335;57.0;48.2
2A;2021-07-20;1283;476;93853;78811;57.8;48.5
2A;2021-07-21;1426;725;95279;79536;58.7;49.0
2A;2021-07-22;1401;767;96680;80303;59.5;49.4
2A;2021-07-23;1439;464;98119;80767;60.4;49.7
2A;2021-07-24;896;290;99015;81057;61.0;49.9
2A;2021-07-25;451;81;99466;81138;61.2;50.0
2A;2021-07-26;1198;507;100664;81645;62.0;50.3
2A;2021-07-27;1297;520;101961;82165;62.8;50.6
2A;2021-07-28;1199;593;103160;82758;63.5;51.0
2A;2021-07-29;1230;657;104390;83415;64.3;51.4
2A;2021-07-30;961;610;105351;84025;64.9;51.7
2A;2021-07-31;550;340;105901;84365;65.2;51.9
2A;2021-08-01;570;124;106471;84489;65.6;52.0
2A;2021-08-02;451;494;106922;84983;65.8;52.3
2A;2021-08-03;814;881;107736;85864;66.3;52.9
2A;2021-08-04;724;1161;108460;87025;66.8;53.6
2A;2021-08-05;956;1348;109416;88373;67.4;54.4
2A;2021-08-06;390;815;109806;89188;67.6;54.9
2A;2021-08-07;352;888;110158;90076;67.8;55.5
2A;2021-08-08;78;185;110236;90261;67.9;55.6
2A;2021-08-09;663;1142;110899;91403;68.3;56.3
2A;2021-08-10;641;1209;111540;92612;68.7;57.0
2A;2021-08-11;593;1064;112133;93676;69.0;57.7
2A;2021-08-12;742;1491;112875;95167;69.5;58.6
2A;2021-08-13;486;1066;113361;96233;69.8;59.2
2A;2021-08-14;414;766;113775;96999;70.0;59.7
2A;2021-08-15;27;26;113802;97025;70.1;59.7
2A;2021-08-16;481;1292;114283;98317;70.4;60.5
2A;2021-08-17;940;1557;115223;99874;70.9;61.5
2A;2021-08-18;525;1123;115748;100997;71.3;62.2
2A;2021-08-19;431;1010;116179;102007;71.5;62.8
2A;2021-08-20;328;574;116507;102581;71.7;63.2
2A;2021-08-21;240;535;116747;103116;71.9;63.5
2A;2021-08-22;197;617;116944;103733;72.0;63.9
2A;2021-08-23;325;744;117269;104477;72.2;64.3
2A;2021-08-24;326;858;117595;105335;72.4;64.9
2A;2021-08-25;401;881;117996;106216;72.6;65.4
2A;2021-08-26;342;769;118338;106985;72.9;65.9
2A;2021-08-27;245;716;118583;107701;73.0;66.3
2A;2021-08-28;256;352;118839;108053;73.2;66.5
2A;2021-08-29;97;116;118936;108169;73.2;66.6
2A;2021-08-30;244;605;119180;108774;73.4;67.0
2A;2021-08-31;172;493;119352;109267;73.5;67.3
2A;2021-09-01;344;758;119696;110025;73.7;67.7
2A;2021-09-02;314;610;120010;110635;73.9;68.1
2A;2021-09-03;243;457;120253;111092;74.0;68.4
2A;2021-09-04;151;406;120404;111498;74.1;68.6
2A;2021-09-05;29;23;120433;111521;74.1;68.7
2A;2021-09-06;111;342;120544;111863;74.2;68.9
2A;2021-09-07;191;630;120735;112493;74.3;69.3
2A;2021-09-08;221;651;120956;113144;74.5;69.7
2A;2021-09-09;211;461;121167;113605;74.6;69.9
2A;2021-09-10;155;346;121322;113951;74.7;70.2
2A;2021-09-11;135;282;121457;114233;74.8;70.3
2A;2021-09-12;42;82;121499;114315;74.8;70.4
2A;2021-09-13;103;181;121602;114496;74.9;70.5
2A;2021-09-14;227;232;121829;114728;75.0;70.6
2A;2021-09-15;191;542;122020;115270;75.1;71.0
2A;2021-09-16;221;366;122241;115636;75.3;71.2
2A;2021-09-17;136;176;122377;115812;75.3;71.3
2A;2021-09-18;104;302;122481;116114;75.4;71.5
2A;2021-09-19;10;49;122491;116163;75.4;71.5
2A;2021-09-20;38;130;122529;116293;75.4;71.6
2A;2021-09-21;89;246;122618;116539;75.5;71.8
2A;2021-09-22;101;448;122719;116987;75.6;72.0
2A;2021-09-23;91;325;122810;117312;75.6;72.2
2A;2021-09-24;59;259;122869;117571;75.6;72.4
2A;2021-09-25;63;143;122932;117714;75.7;72.5
2A;2021-09-26;10;29;122942;117743;75.7;72.5
2A;2021-09-27;43;104;122985;117847;75.7;72.6
2A;2021-09-28;103;172;123088;118019;75.8;72.7
2A;2021-09-29;108;297;123196;118316;75.8;72.8
2A;2021-09-30;74;209;123270;118525;75.9;73.0
2A;2021-10-01;81;119;123351;118644;75.9;73.0
2A;2021-10-02;79;137;123430;118781;76.0;73.1
2A;2021-10-03;18;33;123448;118814;76.0;73.2
2A;2021-10-04;44;81;123492;118895;76.0;73.2
2A;2021-10-05;38;114;123530;119009;76.1;73.3
2A;2021-10-06;56;119;123586;119128;76.1;73.3
2A;2021-10-07;56;111;123642;119239;76.1;73.4
2A;2021-10-08;51;135;123693;119374;76.2;73.5
2A;2021-10-09;79;263;123772;119637;76.2;73.7
2A;2021-10-10;71;81;123843;119718;76.2;73.7
2A;2021-10-11;34;68;123877;119786;76.3;73.8
2A;2021-10-12;34;57;123911;119843;76.3;73.8
2A;2021-10-13;56;119;123967;119962;76.3;73.9
2A;2021-10-14;72;134;124039;120096;76.4;73.9
2A;2021-10-15;66;84;124105;120180;76.4;74.0
2A;2021-10-16;77;177;124182;120357;76.5;74.1
2A;2021-10-17;51;40;124233;120397;76.5;74.1
2A;2021-10-18;54;75;124287;120472;76.5;74.2
2A;2021-10-19;40;65;124327;120537;76.5;74.2
2B;2020-12-27;0;0;0;0;0.0;0.0
2B;2020-12-28;0;0;0;0;0.0;0.0
2B;2020-12-29;0;0;0;0;0.0;0.0
2B;2020-12-30;0;0;0;0;0.0;0.0
2B;2020-12-31;0;0;0;0;0.0;0.0
2B;2021-01-01;0;0;0;0;0.0;0.0
2B;2021-01-02;0;0;0;0;0.0;0.0
2B;2021-01-03;0;0;0;0;0.0;0.0
2B;2021-01-04;2;0;2;0;0.0;0.0
2B;2021-01-05;0;0;2;0;0.0;0.0
2B;2021-01-06;48;1;50;1;0.0;0.0
2B;2021-01-07;210;0;260;1;0.1;0.0
2B;2021-01-08;197;3;457;4;0.3;0.0
2B;2021-01-09;40;0;497;4;0.3;0.0
2B;2021-01-10;1;0;498;4;0.3;0.0
2B;2021-01-11;74;0;572;4;0.3;0.0
2B;2021-01-12;128;1;700;5;0.4;0.0
2B;2021-01-13;93;0;793;5;0.4;0.0
2B;2021-01-14;72;0;865;5;0.5;0.0
2B;2021-01-15;259;2;1124;7;0.6;0.0
2B;2021-01-16;44;0;1168;7;0.6;0.0
2B;2021-01-17;8;0;1176;7;0.6;0.0
2B;2021-01-18;271;1;1447;8;0.8;0.0
2B;2021-01-19;507;1;1954;9;1.1;0.0
2B;2021-01-20;462;3;2416;12;1.3;0.0
2B;2021-01-21;358;0;2774;12;1.5;0.0
2B;2021-01-22;382;1;3156;13;1.7;0.0
2B;2021-01-23;61;0;3217;13;1.8;0.0
2B;2021-01-24;29;0;3246;13;1.8;0.0
2B;2021-01-25;210;2;3456;15;1.9;0.0
2B;2021-01-26;392;1;3848;16;2.1;0.0
2B;2021-01-27;342;48;4190;64;2.3;0.0
2B;2021-01-28;365;146;4555;210;2.5;0.1
2B;2021-01-29;297;162;4852;372;2.7;0.2
2B;2021-01-30;80;33;4932;405;2.7;0.2
2B;2021-01-31;60;0;4992;405;2.7;0.2
2B;2021-02-01;233;94;5225;499;2.9;0.3
2B;2021-02-02;358;78;5583;577;3.1;0.3
2B;2021-02-03;520;91;6103;668;3.3;0.4
2B;2021-02-04;458;173;6561;841;3.6;0.5
2B;2021-02-05;395;95;6956;936;3.8;0.5
2B;2021-02-06;87;14;7043;950;3.9;0.5
2B;2021-02-07;60;0;7103;950;3.9;0.5
2B;2021-02-08;231;153;7334;1103;4.0;0.6
2B;2021-02-09;586;313;7920;1416;4.3;0.8
2B;2021-02-10;484;196;8404;1612;4.6;0.9
2B;2021-02-11;382;129;8786;1741;4.8;1.0
2B;2021-02-12;299;125;9085;1866;5.0;1.0
2B;2021-02-13;77;13;9162;1879;5.0;1.0
2B;2021-02-14;62;1;9224;1880;5.1;1.0
2B;2021-02-15;190;128;9414;2008;5.2;1.1
2B;2021-02-16;249;287;9663;2295;5.3;1.3
2B;2021-02-17;312;318;9975;2613;5.5;1.4
2B;2021-02-18;215;347;10190;2960;5.6;1.6
2B;2021-02-19;163;306;10353;3266;5.7;1.8
2B;2021-02-20;32;62;10385;3328;5.7;1.8
2B;2021-02-21;28;29;10413;3357;5.7;1.8
2B;2021-02-22;133;188;10546;3545;5.8;1.9
2B;2021-02-23;232;355;10778;3900;5.9;2.1
2B;2021-02-24;229;310;11007;4210;6.0;2.3
2B;2021-02-25;245;340;11252;4550;6.2;2.5
2B;2021-02-26;301;282;11553;4832;6.3;2.7
2B;2021-02-27;60;86;11613;4918;6.4;2.7
2B;2021-02-28;1;57;11614;4975;6.4;2.7
2B;2021-03-01;246;261;11860;5236;6.5;2.9
2B;2021-03-02;352;390;12212;5626;6.7;3.1
2B;2021-03-03;299;433;12511;6059;6.9;3.3
2B;2021-03-04;447;409;12958;6468;7.1;3.5
2B;2021-03-05;619;384;13577;6852;7.4;3.8
2B;2021-03-06;682;101;14259;6953;7.8;3.8
2B;2021-03-07;361;60;14620;7013;8.0;3.8
2B;2021-03-08;301;240;14921;7253;8.2;4.0
2B;2021-03-09;384;506;15305;7759;8.4;4.3
2B;2021-03-10;631;446;15936;8205;8.7;4.5
2B;2021-03-11;585;355;16521;8560;9.1;4.7
2B;2021-03-12;967;231;17488;8791;9.6;4.8
2B;2021-03-13;511;110;17999;8901;9.9;4.9
2B;2021-03-14;226;64;18225;8965;10.0;4.9
2B;2021-03-15;516;202;18741;9167;10.3;5.0
2B;2021-03-16;571;279;19312;9446;10.6;5.2
2B;2021-03-17;530;263;19842;9709;10.9;5.3
2B;2021-03-18;551;230;20393;9939;11.2;5.5
2B;2021-03-19;805;195;21198;10134;11.6;5.6
2B;2021-03-20;656;38;21854;10172;12.0;5.6
2B;2021-03-21;428;37;22282;10209;12.2;5.6
2B;2021-03-22;546;126;22828;10335;12.5;5.7
2B;2021-03-23;788;260;23616;10595;13.0;5.8
2B;2021-03-24;832;215;24448;10810;13.4;5.9
2B;2021-03-25;825;164;25273;10974;13.9;6.0
2B;2021-03-26;958;191;26231;11165;14.4;6.1
2B;2021-03-27;1092;40;27323;11205;15.0;6.1
2B;2021-03-28;830;126;28153;11331;15.4;6.2
2B;2021-03-29;745;181;28898;11512;15.9;6.3
2B;2021-03-30;971;333;29869;11845;16.4;6.5
2B;2021-03-31;981;266;30850;12111;16.9;6.6
2B;2021-04-01;1003;230;31853;12341;17.5;6.8
2B;2021-04-02;967;414;32820;12755;18.0;7.0
2B;2021-04-03;1247;154;34067;12909;18.7;7.1
2B;2021-04-04;197;61;34264;12970;18.8;7.1
2B;2021-04-05;109;113;34373;13083;18.9;7.2
2B;2021-04-06;1032;362;35405;13445;19.4;7.4
2B;2021-04-07;1231;430;36636;13875;20.1;7.6
2B;2021-04-08;1128;409;37764;14284;20.7;7.8
2B;2021-04-09;1166;568;38930;14852;21.4;8.1
2B;2021-04-10;1352;267;40282;15119;22.1;8.3
2B;2021-04-11;815;65;41097;15184;22.5;8.3
2B;2021-04-12;853;559;41950;15743;23.0;8.6
2B;2021-04-13;1064;632;43014;16375;23.6;9.0
2B;2021-04-14;1046;494;44060;16869;24.2;9.3
2B;2021-04-15;886;520;44946;17389;24.7;9.5
2B;2021-04-16;910;649;45856;18038;25.2;9.9
2B;2021-04-17;386;447;46242;18485;25.4;10.1
2B;2021-04-18;253;343;46495;18828;25.5;10.3
2B;2021-04-19;822;438;47317;19266;26.0;10.6
2B;2021-04-20;898;846;48215;20112;26.5;11.0
2B;2021-04-21;1055;610;49270;20722;27.0;11.4
2B;2021-04-22;937;734;50207;21456;27.5;11.8
2B;2021-04-23;662;630;50869;22086;27.9;12.1
2B;2021-04-24;288;772;51157;22858;28.1;12.5
2B;2021-04-25;285;477;51442;23335;28.2;12.8
2B;2021-04-26;708;922;52150;24257;28.6;13.3
2B;2021-04-27;966;876;53116;25133;29.1;13.8
2B;2021-04-28;918;865;54034;25998;29.6;14.3
2B;2021-04-29;925;873;54959;26871;30.2;14.7
2B;2021-04-30;1133;832;56092;27703;30.8;15.2
2B;2021-05-01;460;1116;56552;28819;31.0;15.8
2B;2021-05-02;335;245;56887;29064;31.2;15.9
2B;2021-05-03;1016;496;57903;29560;31.8;16.2
2B;2021-05-04;811;1154;58714;30714;32.2;16.9
2B;2021-05-05;800;1377;59514;32091;32.7;17.6
2B;2021-05-06;1285;905;60799;32996;33.4;18.1
2B;2021-05-07;1062;990;61861;33986;33.9;18.6
2B;2021-05-08;459;853;62320;34839;34.2;19.1
2B;2021-05-09;393;684;62713;35523;34.4;19.5
2B;2021-05-10;925;805;63638;36328;34.9;19.9
2B;2021-05-11;933;1163;64571;37491;35.4;20.6
2B;2021-05-12;859;893;65430;38384;35.9;21.1
2B;2021-05-13;1028;376;66458;38760;36.5;21.3
2B;2021-05-14;719;579;67177;39339;36.9;21.6
2B;2021-05-15;701;353;67878;39692;37.2;21.8
2B;2021-05-16;300;180;68178;39872;37.4;21.9
2B;2021-05-17;1004;406;69182;40278;38.0;22.1
2B;2021-05-18;990;382;70172;40660;38.5;22.3
2B;2021-05-19;773;417;70945;41077;38.9;22.5
2B;2021-05-20;668;359;71613;41436;39.3;22.7
2B;2021-05-21;707;502;72320;41938;39.7;23.0
2B;2021-05-22;576;392;72896;42330;40.0;23.2
2B;2021-05-23;170;46;73066;42376;40.1;23.3
2B;2021-05-24;40;115;73106;42491;40.1;23.3
2B;2021-05-25;548;354;73654;42845;40.4;23.5
2B;2021-05-26;545;787;74199;43632;40.7;23.9
2B;2021-05-27;407;1131;74606;44763;40.9;24.6
2B;2021-05-28;550;905;75156;45668;41.2;25.1
2B;2021-05-29;311;353;75467;46021;41.4;25.3
2B;2021-05-30;46;45;75513;46066;41.4;25.3
2B;2021-05-31;375;831;75888;46897;41.6;25.7
2B;2021-06-01;414;1037;76302;47934;41.9;26.3
2B;2021-06-02;363;988;76665;48922;42.1;26.8
2B;2021-06-03;498;806;77163;49728;42.3;27.3
2B;2021-06-04;343;1253;77506;50981;42.5;28.0
2B;2021-06-05;257;494;77763;51475;42.7;28.2
2B;2021-06-06;51;129;77814;51604;42.7;28.3
2B;2021-06-07;280;949;78094;52553;42.8;28.8
2B;2021-06-08;399;1167;78493;53720;43.1;29.5
2B;2021-06-09;519;1177;79012;54897;43.4;30.1
2B;2021-06-10;369;939;79381;55836;43.6;30.6
2B;2021-06-11;432;1275;79813;57111;43.8;31.3
2B;2021-06-12;152;545;79965;57656;43.9;31.6
2B;2021-06-13;27;59;79992;57715;43.9;31.7
2B;2021-06-14;195;1115;80187;58830;44.0;32.3
2B;2021-06-15;344;1217;80531;60047;44.2;32.9
2B;2021-06-16;383;935;80914;60982;44.4;33.5
2B;2021-06-17;402;1049;81316;62031;44.6;34.0
2B;2021-06-18;348;960;81664;62991;44.8;34.6
2B;2021-06-19;144;330;81808;63321;44.9;34.7
2B;2021-06-20;44;194;81852;63515;44.9;34.8
2B;2021-06-21;265;962;82117;64477;45.1;35.4
2B;2021-06-22;317;1115;82434;65592;45.2;36.0
2B;2021-06-23;209;871;82643;66463;45.3;36.5
2B;2021-06-24;337;758;82980;67221;45.5;36.9
2B;2021-06-25;210;1074;83190;68295;45.6;37.5
2B;2021-06-26;105;550;83295;68845;45.7;37.8
2B;2021-06-27;31;214;83326;69059;45.7;37.9
2B;2021-06-28;329;954;83655;70013;45.9;38.4
2B;2021-06-29;270;985;83925;70998;46.0;39.0
2B;2021-06-30;380;948;84305;71946;46.3;39.5
2B;2021-07-01;226;507;84531;72453;46.4;39.8
2B;2021-07-02;219;557;84750;73010;46.5;40.1
2B;2021-07-03;92;398;84842;73408;46.6;40.3
2B;2021-07-04;2;0;84844;73408;46.6;40.3
2B;2021-07-05;263;666;85107;74074;46.7;40.6
2B;2021-07-06;450;707;85557;74781;46.9;41.0
2B;2021-07-07;381;911;85938;75692;47.2;41.5
2B;2021-07-08;183;351;86121;76043;47.3;41.7
2B;2021-07-09;250;378;86371;76421;47.4;41.9
2B;2021-07-10;197;199;86568;76620;47.5;42.0
2B;2021-07-11;13;14;86581;76634;47.5;42.0
2B;2021-07-12;497;747;87078;77381;47.8;42.5
2B;2021-07-13;822;1021;87900;78402;48.2;43.0
2B;2021-07-14;344;100;88244;78502;48.4;43.1
2B;2021-07-15;1270;589;89514;79091;49.1;43.4
2B;2021-07-16;1120;564;90634;79655;49.7;43.7
2B;2021-07-17;710;319;91344;79974;50.1;43.9
2B;2021-07-18;179;49;91523;80023;50.2;43.9
2B;2021-07-19;857;709;92380;80732;50.7;44.3
2B;2021-07-20;1210;684;93590;81416;51.4;44.7
2B;2021-07-21;1396;726;94986;82142;52.1;45.1
2B;2021-07-22;1330;604;96316;82746;52.8;45.4
2B;2021-07-23;1330;505;97646;83251;53.6;45.7
2B;2021-07-24;534;316;98180;83567;53.9;45.9
2B;2021-07-25;203;71;98383;83638;54.0;45.9
2B;2021-07-26;913;634;99296;84272;54.5;46.2
2B;2021-07-27;1578;711;100874;84983;55.3;46.6
2B;2021-07-28;1177;633;102051;85616;56.0;47.0
2B;2021-07-29;1144;449;103195;86065;56.6;47.2
2B;2021-07-30;763;351;103958;86416;57.0;47.4
2B;2021-07-31;539;235;104497;86651;57.3;47.5
2B;2021-08-01;230;57;104727;86708;57.5;47.6
2B;2021-08-02;799;472;105526;87180;57.9;47.8
2B;2021-08-03;1138;786;106664;87966;58.5;48.3
2B;2021-08-04;810;454;107474;88420;59.0;48.5
2B;2021-08-05;1026;560;108500;88980;59.5;48.8
2B;2021-08-06;704;526;109204;89506;59.9;49.1
2B;2021-08-07;306;408;109510;89914;60.1;49.3
2B;2021-08-08;93;142;109603;90056;60.1;49.4
2B;2021-08-09;536;747;110139;90803;60.4;49.8
2B;2021-08-10;739;1133;110878;91936;60.8;50.4
2B;2021-08-11;753;902;111631;92838;61.2;50.9
2B;2021-08-12;692;1045;112323;93883;61.6;51.5
2B;2021-08-13;494;948;112817;94831;61.9;52.0
2B;2021-08-14;200;437;113017;95268;62.0;52.3
2B;2021-08-15;117;173;113134;95441;62.1;52.4
2B;2021-08-16;509;1063;113643;96504;62.4;52.9
2B;2021-08-17;587;1308;114230;97812;62.7;53.7
2B;2021-08-18;506;1193;114736;99005;63.0;54.3
2B;2021-08-19;434;900;115170;99905;63.2;54.8
2B;2021-08-20;369;813;115539;100718;63.4;55.3
2B;2021-08-21;158;474;115697;101192;63.5;55.5
2B;2021-08-22;79;208;115776;101400;63.5;55.6
2B;2021-08-23;376;945;116152;102345;63.7;56.2
2B;2021-08-24;498;1214;116650;103559;64.0;56.8
2B;2021-08-25;347;971;116997;104530;64.2;57.4
2B;2021-08-26;404;817;117401;105347;64.4;57.8
2B;2021-08-27;263;572;117664;105919;64.6;58.1
2B;2021-08-28;168;443;117832;106362;64.7;58.4
2B;2021-08-29;53;126;117885;106488;64.7;58.4
2B;2021-08-30;365;836;118250;107324;64.9;58.9
2B;2021-08-31;380;864;118630;108188;65.1;59.4
2B;2021-09-01;370;913;119000;109101;65.3;59.9
2B;2021-09-02;307;654;119307;109755;65.5;60.2
2B;2021-09-03;224;423;119531;110178;65.6;60.5
2B;2021-09-04;124;306;119655;110484;65.7;60.6
2B;2021-09-05;17;102;119672;110586;65.7;60.7
2B;2021-09-06;165;570;119837;111156;65.8;61.0
2B;2021-09-07;259;759;120096;111915;65.9;61.4
2B;2021-09-08;203;621;120299;112536;66.0;61.7
2B;2021-09-09;185;405;120484;112941;66.1;62.0
2B;2021-09-10;201;368;120685;113309;66.2;62.2
2B;2021-09-11;130;249;120815;113558;66.3;62.3
2B;2021-09-12;17;94;120832;113652;66.3;62.4
2B;2021-09-13;191;464;121023;114116;66.4;62.6
2B;2021-09-14;284;634;121307;114750;66.6;63.0
2B;2021-09-15;160;598;121467;115348;66.6;63.3
2B;2021-09-16;220;301;121687;115649;66.8;63.5
2B;2021-09-17;117;194;121804;115843;66.8;63.6
2B;2021-09-18;51;157;121855;116000;66.9;63.6
2B;2021-09-19;17;18;121872;116018;66.9;63.7
2B;2021-09-20;106;409;121978;116427;66.9;63.9
2B;2021-09-21;102;411;122080;116838;67.0;64.1
2B;2021-09-22;117;404;122197;117242;67.0;64.3
2B;2021-09-23;103;228;122300;117470;67.1;64.5
2B;2021-09-24;87;213;122387;117683;67.2;64.6
2B;2021-09-25;36;123;122423;117806;67.2;64.6
2B;2021-09-26;2;23;122425;117829;67.2;64.6
2B;2021-09-27;70;229;122495;118058;67.2;64.8
2B;2021-09-28;99;194;122594;118252;67.3;64.9
2B;2021-09-29;121;345;122715;118597;67.3;65.1
2B;2021-09-30;71;133;122786;118730;67.4;65.1
2B;2021-10-01;113;163;122899;118893;67.4;65.2
2B;2021-10-02;54;114;122953;119007;67.5;65.3
2B;2021-10-03;13;15;122966;119022;67.5;65.3
2B;2021-10-04;84;156;123050;119178;67.5;65.4
2B;2021-10-05;91;225;123141;119403;67.6;65.5
2B;2021-10-06;125;285;123266;119688;67.6;65.7
2B;2021-10-07;49;137;123315;119825;67.7;65.7
2B;2021-10-08;86;171;123401;119996;67.7;65.8
2B;2021-10-09;67;108;123468;120104;67.7;65.9
2B;2021-10-10;11;22;123479;120126;67.7;65.9
2B;2021-10-11;60;146;123539;120272;67.8;66.0
2B;2021-10-12;78;163;123617;120435;67.8;66.1
2B;2021-10-13;128;226;123745;120661;67.9;66.2
2B;2021-10-14;94;178;123839;120839;67.9;66.3
2B;2021-10-15;74;119;123913;120958;68.0;66.4
2B;2021-10-16;80;96;123993;121054;68.0;66.4
2B;2021-10-17;12;2;124005;121056;68.0;66.4
2B;2021-10-18;80;110;124085;121166;68.1;66.5
2B;2021-10-19;74;88;124159;121254;68.1;66.5
30;2020-12-27;3;0;3;0;0.0;0.0
30;2020-12-28;2;0;5;0;0.0;0.0
30;2020-12-29;0;0;5;0;0.0;0.0
30;2020-12-30;0;0;5;0;0.0;0.0
30;2020-12-31;0;0;5;0;0.0;0.0
30;2021-01-01;0;0;5;0;0.0;0.0
30;2021-01-02;0;0;5;0;0.0;0.0
30;2021-01-03;0;0;5;0;0.0;0.0
30;2021-01-04;0;0;5;0;0.0;0.0
30;2021-01-05;4;0;9;0;0.0;0.0
30;2021-01-06;128;0;137;0;0.0;0.0
30;2021-01-07;315;0;452;0;0.1;0.0
30;2021-01-08;532;2;984;2;0.1;0.0
30;2021-01-09;270;0;1254;2;0.2;0.0
30;2021-01-10;0;0;1254;2;0.2;0.0
30;2021-01-11;536;1;1790;3;0.2;0.0
30;2021-01-12;801;3;2591;6;0.3;0.0
30;2021-01-13;641;0;3232;6;0.4;0.0
30;2021-01-14;654;5;3886;11;0.5;0.0
30;2021-01-15;756;2;4642;13;0.6;0.0
30;2021-01-16;313;0;4955;13;0.7;0.0
30;2021-01-17;4;0;4959;13;0.7;0.0
30;2021-01-18;949;12;5908;25;0.8;0.0
30;2021-01-19;1736;6;7644;31;1.0;0.0
30;2021-01-20;1303;3;8947;34;1.2;0.0
30;2021-01-21;1230;3;10177;37;1.4;0.0
30;2021-01-22;1078;7;11255;44;1.5;0.0
30;2021-01-23;634;2;11889;46;1.6;0.0
30;2021-01-24;0;0;11889;46;1.6;0.0
30;2021-01-25;830;5;12719;51;1.7;0.0
30;2021-01-26;1060;17;13779;68;1.8;0.0
30;2021-01-27;983;110;14762;178;2.0;0.0
30;2021-01-28;715;271;15477;449;2.1;0.1
30;2021-01-29;671;440;16148;889;2.2;0.1
30;2021-01-30;473;285;16621;1174;2.2;0.2
30;2021-01-31;3;7;16624;1181;2.2;0.2
30;2021-02-01;816;441;17440;1622;2.3;0.2
30;2021-02-02;1875;683;19315;2305;2.6;0.3
30;2021-02-03;1185;486;20500;2791;2.7;0.4
30;2021-02-04;970;662;21470;3453;2.9;0.5
30;2021-02-05;599;762;22069;4215;2.9;0.6
30;2021-02-06;296;261;22365;4476;3.0;0.6
30;2021-02-07;3;9;22368;4485;3.0;0.6
30;2021-02-08;574;735;22942;5220;3.1;0.7
30;2021-02-09;986;1009;23928;6229;3.2;0.8
30;2021-02-10;985;1093;24913;7322;3.3;1.0
30;2021-02-11;929;1031;25842;8353;3.5;1.1
30;2021-02-12;620;997;26462;9350;3.5;1.2
30;2021-02-13;435;383;26897;9733;3.6;1.3
30;2021-02-14;3;23;26900;9756;3.6;1.3
30;2021-02-15;450;616;27350;10372;3.7;1.4
30;2021-02-16;460;847;27810;11219;3.7;1.5
30;2021-02-17;684;619;28494;11838;3.8;1.6
30;2021-02-18;799;527;29293;12365;3.9;1.7
30;2021-02-19;578;670;29871;13035;4.0;1.7
30;2021-02-20;224;228;30095;13263;4.0;1.8
30;2021-02-21;5;3;30100;13266;4.0;1.8
30;2021-02-22;502;764;30602;14030;4.1;1.9
30;2021-02-23;973;1467;31575;15497;4.2;2.1
30;2021-02-24;931;1196;32506;16693;4.3;2.2
30;2021-02-25;1211;893;33717;17586;4.5;2.3
30;2021-02-26;1336;599;35053;18185;4.7;2.4
30;2021-02-27;564;542;35617;18727;4.8;2.5
30;2021-02-28;6;7;35623;18734;4.8;2.5
30;2021-03-01;1343;830;36966;19564;4.9;2.6
30;2021-03-02;1718;915;38684;20479;5.2;2.7
30;2021-03-03;2311;769;40995;21248;5.5;2.8
30;2021-03-04;2638;879;43633;22127;5.8;3.0
30;2021-03-05;2767;623;46400;22750;6.2;3.0
30;2021-03-06;2998;370;49398;23120;6.6;3.1
30;2021-03-07;1862;50;51260;23170;6.8;3.1
30;2021-03-08;1556;789;52816;23959;7.1;3.2
30;2021-03-09;2277;873;55093;24832;7.4;3.3
30;2021-03-10;2360;663;57453;25495;7.7;3.4
30;2021-03-11;3053;712;60506;26207;8.1;3.5
30;2021-03-12;3113;404;63619;26611;8.5;3.6
30;2021-03-13;2227;298;65846;26909;8.8;3.6
30;2021-03-14;83;3;65929;26912;8.8;3.6
30;2021-03-15;1580;571;67509;27483;9.0;3.7
30;2021-03-16;1297;1072;68806;28555;9.2;3.8
30;2021-03-17;1456;650;70262;29205;9.4;3.9
30;2021-03-18;1647;716;71909;29921;9.6;4.0
30;2021-03-19;2250;553;74159;30474;9.9;4.1
30;2021-03-20;1401;149;75560;30623;10.1;4.1
30;2021-03-21;58;9;75618;30632;10.1;4.1
30;2021-03-22;2395;727;78013;31359;10.4;4.2
30;2021-03-23;3512;822;81525;32181;10.9;4.3
30;2021-03-24;3637;835;85162;33016;11.4;4.4
30;2021-03-25;4406;857;89568;33873;12.0;4.5
30;2021-03-26;4364;652;93932;34525;12.5;4.6
30;2021-03-27;1971;381;95903;34906;12.8;4.7
30;2021-03-28;35;29;95938;34935;12.8;4.7
30;2021-03-29;2816;1660;98754;36595;13.2;4.9
30;2021-03-30;3777;1890;102531;38485;13.7;5.1
30;2021-03-31;3505;1656;106036;40141;14.2;5.4
30;2021-04-01;4015;1473;110051;41614;14.7;5.6
30;2021-04-02;3606;1235;113657;42849;15.2;5.7
30;2021-04-03;1061;1230;114718;44079;15.3;5.9
30;2021-04-04;30;189;114748;44268;15.3;5.9
30;2021-04-05;765;292;115513;44560;15.4;6.0
30;2021-04-06;3045;1582;118558;46142;15.8;6.2
30;2021-04-07;2719;1635;121277;47777;16.2;6.4
30;2021-04-08;3919;1499;125196;49276;16.7;6.6
30;2021-04-09;4889;1530;130085;50806;17.4;6.8
30;2021-04-10;2427;1179;132512;51985;17.7;6.9
30;2021-04-11;951;60;133463;52045;17.8;7.0
30;2021-04-12;3142;1499;136605;53544;18.3;7.2
30;2021-04-13;4019;1941;140624;55485;18.8;7.4
30;2021-04-14;3386;1549;144010;57034;19.2;7.6
30;2021-04-15;3827;1476;147837;58510;19.8;7.8
30;2021-04-16;3704;1549;151541;60059;20.2;8.0
30;2021-04-17;1493;959;153034;61018;20.4;8.2
30;2021-04-18;961;67;153995;61085;20.6;8.2
30;2021-04-19;2446;2301;156441;63386;20.9;8.5
30;2021-04-20;2817;2837;159258;66223;21.3;8.8
30;2021-04-21;2599;2580;161857;68803;21.6;9.2
30;2021-04-22;3525;2324;165382;71127;22.1;9.5
30;2021-04-23;3580;2311;168962;73438;22.6;9.8
30;2021-04-24;1347;1231;170309;74669;22.8;10.0
30;2021-04-25;748;92;171057;74761;22.9;10.0
30;2021-04-26;2015;2392;173072;77153;23.1;10.3
30;2021-04-27;2952;2605;176024;79758;23.5;10.7
30;2021-04-28;2839;2496;178863;82254;23.9;11.0
30;2021-04-29;3621;2333;182484;84587;24.4;11.3
30;2021-04-30;3411;2032;185895;86619;24.8;11.6
30;2021-05-01;1747;604;187642;87223;25.1;11.7
30;2021-05-02;667;246;188309;87469;25.2;11.7
30;2021-05-03;3750;2512;192059;89981;25.7;12.0
30;2021-05-04;3976;3547;196035;93528;26.2;12.5
30;2021-05-05;3942;3127;199977;96655;26.7;12.9
30;2021-05-06;4202;3378;204179;100033;27.3;13.4
30;2021-05-07;4080;3071;208259;103104;27.8;13.8
30;2021-05-08;1606;723;209865;103827;28.0;13.9
30;2021-05-09;372;613;210237;104440;28.1;14.0
30;2021-05-10;2922;3121;213159;107561;28.5;14.4
30;2021-05-11;5387;3655;218546;111216;29.2;14.9
30;2021-05-12;5303;3219;223849;114435;29.9;15.3
30;2021-05-13;3230;1029;227079;115464;30.3;15.4
30;2021-05-14;4890;2460;231969;117924;31.0;15.8
30;2021-05-15;3407;1206;235376;119130;31.4;15.9
30;2021-05-16;398;338;235774;119468;31.5;16.0
30;2021-05-17;3793;3033;239567;122501;32.0;16.4
30;2021-05-18;4826;3036;244393;125537;32.7;16.8
30;2021-05-19;4774;2547;249167;128084;33.3;17.1
30;2021-05-20;5014;2577;254181;130661;34.0;17.5
30;2021-05-21;4884;2474;259065;133135;34.6;17.8
30;2021-05-22;3155;1287;262220;134422;35.0;18.0
30;2021-05-23;289;344;262509;134766;35.1;18.0
30;2021-05-24;785;766;263294;135532;35.2;18.1
30;2021-05-25;2654;3158;265948;138690;35.5;18.5
30;2021-05-26;2888;2572;268836;141262;35.9;18.9
30;2021-05-27;3757;2716;272593;143978;36.4;19.2
30;2021-05-28;3325;3263;275918;147241;36.9;19.7
30;2021-05-29;1687;1797;277605;149038;37.1;19.9
30;2021-05-30;360;584;277965;149622;37.1;20.0
30;2021-05-31;2830;2298;280795;151920;37.5;20.3
30;2021-06-01;3657;2795;284452;154715;38.0;20.7
30;2021-06-02;3320;2451;287772;157166;38.4;21.0
30;2021-06-03;4129;3358;291901;160524;39.0;21.4
30;2021-06-04;3896;3400;295797;163924;39.5;21.9
30;2021-06-05;1904;1314;297701;165238;39.8;22.1
30;2021-06-06;684;265;298385;165503;39.9;22.1
30;2021-06-07;4722;2527;303107;168030;40.5;22.4
30;2021-06-08;4830;3331;307937;171361;41.1;22.9
30;2021-06-09;4151;2992;312088;174353;41.7;23.3
30;2021-06-10;4613;3358;316701;177711;42.3;23.7
30;2021-06-11;4583;3811;321284;181522;42.9;24.3
30;2021-06-12;2485;1709;323769;183231;43.3;24.5
30;2021-06-13;493;344;324262;183575;43.3;24.5
30;2021-06-14;2470;4712;326732;188287;43.7;25.2
30;2021-06-15;3199;5312;329931;193599;44.1;25.9
30;2021-06-16;3107;4650;333038;198249;44.5;26.5
30;2021-06-17;3923;4377;336961;202626;45.0;27.1
30;2021-06-18;3714;4701;340675;207327;45.5;27.7
30;2021-06-19;1441;2005;342116;209332;45.7;28.0
30;2021-06-20;357;491;342473;209823;45.8;28.0
30;2021-06-21;2379;4911;344852;214734;46.1;28.7
30;2021-06-22;2365;5742;347217;220476;46.4;29.5
30;2021-06-23;2529;5344;349746;225820;46.7;30.2
30;2021-06-24;2336;4709;352082;230529;47.0;30.8
30;2021-06-25;2611;5604;354693;236133;47.4;31.5
30;2021-06-26;909;2941;355602;239074;47.5;31.9
30;2021-06-27;222;527;355824;239601;47.5;32.0
30;2021-06-28;1670;6024;357494;245625;47.8;32.8
30;2021-06-29;1837;6023;359331;251648;48.0;33.6
30;2021-06-30;2001;5256;361332;256904;48.3;34.3
30;2021-07-01;3107;4719;364439;261623;48.7;35.0
30;2021-07-02;2834;4627;367273;266250;49.1;35.6
30;2021-07-03;1154;3047;368427;269297;49.2;36.0
30;2021-07-04;116;393;368543;269690;49.2;36.0
30;2021-07-05;2027;4030;370570;273720;49.5;36.6
30;2021-07-06;2663;4975;373233;278695;49.9;37.2
30;2021-07-07;2538;4224;375771;282919;50.2;37.8
30;2021-07-08;2012;3418;377783;286337;50.5;38.3
30;2021-07-09;2410;5314;380193;291651;50.8;39.0
30;2021-07-10;1504;2159;381697;293810;51.0;39.3
30;2021-07-11;47;415;381744;294225;51.0;39.3
30;2021-07-12;2528;5154;384272;299379;51.3;40.0
30;2021-07-13;3300;6030;387572;305409;51.8;40.8
30;2021-07-14;502;550;388074;305959;51.8;40.9
30;2021-07-15;4127;5477;392201;311436;52.4;41.6
30;2021-07-16;5038;5729;397239;317165;53.1;42.4
30;2021-07-17;1706;2469;398945;319634;53.3;42.7
30;2021-07-18;146;602;399091;320236;53.3;42.8
30;2021-07-19;3374;6315;402465;326551;53.8;43.6
30;2021-07-20;4641;6525;407106;333076;54.4;44.5
30;2021-07-21;4063;5415;411169;338491;54.9;45.2
30;2021-07-22;4900;5746;416069;344237;55.6;46.0
30;2021-07-23;4998;5873;421067;350110;56.3;46.8
30;2021-07-24;2240;3257;423307;353367;56.6;47.2
30;2021-07-25;137;310;423444;353677;56.6;47.3
30;2021-07-26;4414;4134;427858;357811;57.2;47.8
30;2021-07-27;4856;4654;432714;362465;57.8;48.4
30;2021-07-28;4877;4027;437591;366492;58.5;49.0
30;2021-07-29;5929;4144;443520;370636;59.3;49.5
30;2021-07-30;5343;4396;448863;375032;60.0;50.1
30;2021-07-31;2656;1965;451519;376997;60.3;50.4
30;2021-08-01;735;311;452254;377308;60.4;50.4
30;2021-08-02;3686;4015;455940;381323;60.9;50.9
30;2021-08-03;4888;3957;460828;385280;61.6;51.5
30;2021-08-04;5286;3055;466114;388335;62.3;51.9
30;2021-08-05;4617;3797;470731;392132;62.9;52.4
30;2021-08-06;4333;4066;475064;396198;63.5;52.9
30;2021-08-07;1841;1953;476905;398151;63.7;53.2
30;2021-08-08;620;280;477525;398431;63.8;53.2
30;2021-08-09;3343;3762;480868;402193;64.2;53.7
30;2021-08-10;3926;4403;484794;406596;64.8;54.3
30;2021-08-11;3402;3481;488196;410077;65.2;54.8
30;2021-08-12;3764;4224;491960;414301;65.7;55.4
30;2021-08-13;3309;3341;495269;417642;66.2;55.8
30;2021-08-14;1134;2048;496403;419690;66.3;56.1
30;2021-08-15;270;176;496673;419866;66.4;56.1
30;2021-08-16;2201;4867;498874;424733;66.7;56.7
30;2021-08-17;2746;4199;501620;428932;67.0;57.3
30;2021-08-18;2849;3836;504469;432768;67.4;57.8
30;2021-08-19;2859;4319;507328;437087;67.8;58.4
30;2021-08-20;2609;4469;509937;441556;68.1;59.0
30;2021-08-21;1018;2889;510955;444445;68.3;59.4
30;2021-08-22;227;516;511182;444961;68.3;59.4
30;2021-08-23;1687;4477;512869;449438;68.5;60.0
30;2021-08-24;1955;4526;514824;453964;68.8;60.7
30;2021-08-25;1692;4345;516516;458309;69.0;61.2
30;2021-08-26;1852;4259;518368;462568;69.3;61.8
30;2021-08-27;1779;4358;520147;466926;69.5;62.4
30;2021-08-28;681;2476;520828;469402;69.6;62.7
30;2021-08-29;182;614;521010;470016;69.6;62.8
30;2021-08-30;1408;4248;522418;474264;69.8;63.4
30;2021-08-31;1340;4072;523758;478336;70.0;63.9
30;2021-09-01;1248;3447;525006;481783;70.1;64.4
30;2021-09-02;1398;3313;526404;485096;70.3;64.8
30;2021-09-03;1600;3755;528004;488851;70.5;65.3
30;2021-09-04;686;1808;528690;490659;70.6;65.6
30;2021-09-05;136;486;528826;491145;70.7;65.6
30;2021-09-06;805;2278;529631;493423;70.8;65.9
30;2021-09-07;704;2110;530335;495533;70.9;66.2
30;2021-09-08;869;2551;531204;498084;71.0;66.5
30;2021-09-09;912;2164;532116;500248;71.1;66.8
30;2021-09-10;997;2614;533113;502862;71.2;67.2
30;2021-09-11;553;1584;533666;504446;71.3;67.4
30;2021-09-12;95;224;533761;504670;71.3;67.4
30;2021-09-13;729;1599;534490;506269;71.4;67.6
30;2021-09-14;652;1522;535142;507791;71.5;67.8
30;2021-09-15;761;1837;535903;509628;71.6;68.1
30;2021-09-16;753;1477;536656;511105;71.7;68.3
30;2021-09-17;802;2030;537458;513135;71.8;68.6
30;2021-09-18;399;1011;537857;514146;71.9;68.7
30;2021-09-19;69;158;537926;514304;71.9;68.7
30;2021-09-20;397;1204;538323;515508;71.9;68.9
30;2021-09-21;451;1162;538774;516670;72.0;69.0
30;2021-09-22;483;1384;539257;518054;72.0;69.2
30;2021-09-23;628;1203;539885;519257;72.1;69.4
30;2021-09-24;561;1629;540446;520886;72.2;69.6
30;2021-09-25;324;857;540770;521743;72.3;69.7
30;2021-09-26;54;168;540824;521911;72.3;69.7
30;2021-09-27;381;891;541205;522802;72.3;69.8
30;2021-09-28;578;894;541783;523696;72.4;70.0
30;2021-09-29;458;1066;542241;524762;72.4;70.1
30;2021-09-30;406;912;542647;525674;72.5;70.2
30;2021-10-01;500;1001;543147;526675;72.6;70.4
30;2021-10-02;267;580;543414;527255;72.6;70.4
30;2021-10-03;25;47;543439;527302;72.6;70.5
30;2021-10-04;329;790;543768;528092;72.7;70.6
30;2021-10-05;311;660;544079;528752;72.7;70.6
30;2021-10-06;377;854;544456;529606;72.7;70.8
30;2021-10-07;380;843;544836;530449;72.8;70.9
30;2021-10-08;429;1055;545265;531504;72.9;71.0
30;2021-10-09;284;563;545549;532067;72.9;71.1
30;2021-10-10;5;34;545554;532101;72.9;71.1
30;2021-10-11;244;542;545798;532643;72.9;71.2
30;2021-10-12;366;709;546164;533352;73.0;71.3
30;2021-10-13;292;680;546456;534032;73.0;71.4
30;2021-10-14;350;683;546806;534715;73.1;71.4
30;2021-10-15;422;712;547228;535427;73.1;71.5
30;2021-10-16;181;386;547409;535813;73.1;71.6
30;2021-10-17;12;30;547421;535843;73.1;71.6
30;2021-10-18;224;440;547645;536283;73.2;71.7
30;2021-10-19;303;579;547948;536862;73.2;71.7
31;2020-12-27;0;0;0;0;0.0;0.0
31;2020-12-28;2;0;2;0;0.0;0.0
31;2020-12-29;0;0;2;0;0.0;0.0
31;2020-12-30;0;0;2;0;0.0;0.0
31;2020-12-31;1;0;3;0;0.0;0.0
31;2021-01-01;4;0;7;0;0.0;0.0
31;2021-01-02;1;0;8;0;0.0;0.0
31;2021-01-03;2;0;10;0;0.0;0.0
31;2021-01-04;5;0;15;0;0.0;0.0
31;2021-01-05;50;0;65;0;0.0;0.0
31;2021-01-06;211;1;276;1;0.0;0.0
31;2021-01-07;284;1;560;2;0.0;0.0
31;2021-01-08;546;1;1106;3;0.1;0.0
31;2021-01-09;275;0;1381;3;0.1;0.0
31;2021-01-10;286;0;1667;3;0.1;0.0
31;2021-01-11;983;4;2650;7;0.2;0.0
31;2021-01-12;1192;1;3842;8;0.3;0.0
31;2021-01-13;1158;5;5000;13;0.4;0.0
31;2021-01-14;1178;20;6178;33;0.4;0.0
31;2021-01-15;1048;3;7226;36;0.5;0.0
31;2021-01-16;243;1;7469;37;0.5;0.0
31;2021-01-17;176;0;7645;37;0.5;0.0
31;2021-01-18;1616;6;9261;43;0.7;0.0
31;2021-01-19;2939;12;12200;55;0.9;0.0
31;2021-01-20;3683;15;15883;70;1.1;0.0
31;2021-01-21;2997;9;18880;79;1.3;0.0
31;2021-01-22;2275;7;21155;86;1.5;0.0
31;2021-01-23;728;2;21883;88;1.6;0.0
31;2021-01-24;212;1;22095;89;1.6;0.0
31;2021-01-25;1744;9;23839;98;1.7;0.0
31;2021-01-26;1839;63;25678;161;1.8;0.0
31;2021-01-27;1574;151;27252;312;1.9;0.0
31;2021-01-28;1385;299;28637;611;2.0;0.0
31;2021-01-29;1361;351;29998;962;2.1;0.1
31;2021-01-30;446;186;30444;1148;2.2;0.1
31;2021-01-31;61;209;30505;1357;2.2;0.1
31;2021-02-01;1185;753;31690;2110;2.3;0.2
31;2021-02-02;3056;819;34746;2929;2.5;0.2
31;2021-02-03;1922;788;36668;3717;2.6;0.3
31;2021-02-04;1814;848;38482;4565;2.7;0.3
31;2021-02-05;1343;579;39825;5144;2.8;0.4
31;2021-02-06;385;57;40210;5201;2.9;0.4
31;2021-02-07;37;42;40247;5243;2.9;0.4
31;2021-02-08;1116;666;41363;5909;3.0;0.4
31;2021-02-09;1680;1575;43043;7484;3.1;0.5
31;2021-02-10;1964;2475;45007;9959;3.2;0.7
31;2021-02-11;1814;1825;46821;11784;3.3;0.8
31;2021-02-12;1540;797;48361;12581;3.5;0.9
31;2021-02-13;504;228;48865;12809;3.5;0.9
31;2021-02-14;56;216;48921;13025;3.5;0.9
31;2021-02-15;445;1368;49366;14393;3.5;1.0
31;2021-02-16;463;1543;49829;15936;3.6;1.1
31;2021-02-17;473;1650;50302;17586;3.6;1.3
31;2021-02-18;477;1773;50779;19359;3.6;1.4
31;2021-02-19;393;1564;51172;20923;3.7;1.5
31;2021-02-20;69;529;51241;21452;3.7;1.5
31;2021-02-21;77;161;51318;21613;3.7;1.5
31;2021-02-22;434;1731;51752;23344;3.7;1.7
31;2021-02-23;863;3011;52615;26355;3.8;1.9
31;2021-02-24;654;2187;53269;28542;3.8;2.0
31;2021-02-25;1435;1847;54704;30389;3.9;2.2
31;2021-02-26;1711;1234;56415;31623;4.0;2.3
31;2021-02-27;638;404;57053;32027;4.1;2.3
31;2021-02-28;78;54;57131;32081;4.1;2.3
31;2021-03-01;875;1134;58006;33215;4.1;2.4
31;2021-03-02;1239;1667;59245;34882;4.2;2.5
31;2021-03-03;1357;1814;60602;36696;4.3;2.6
31;2021-03-04;2424;1508;63026;38204;4.5;2.7
31;2021-03-05;3052;1606;66078;39810;4.7;2.8
31;2021-03-06;2834;413;68912;40223;4.9;2.9
31;2021-03-07;5368;113;74280;40336;5.3;2.9
31;2021-03-08;1599;1097;75879;41433;5.4;3.0
31;2021-03-09;2792;1199;78671;42632;5.6;3.0
31;2021-03-10;2574;1104;81245;43736;5.8;3.1
31;2021-03-11;4382;1169;85627;44905;6.1;3.2
31;2021-03-12;5322;1212;90949;46117;6.5;3.3
31;2021-03-13;2840;510;93789;46627;6.7;3.3
31;2021-03-14;235;49;94024;46676;6.7;3.3
31;2021-03-15;2584;435;96608;47111;6.9;3.4
31;2021-03-16;1746;823;98354;47934;7.0;3.4
31;2021-03-17;1656;563;100010;48497;7.1;3.5
31;2021-03-18;1986;714;101996;49211;7.3;3.5
31;2021-03-19;3185;534;105181;49745;7.5;3.6
31;2021-03-20;1797;142;106978;49887;7.6;3.6
31;2021-03-21;211;35;107189;49922;7.7;3.6
31;2021-03-22;2580;375;109769;50297;7.8;3.6
31;2021-03-23;4057;329;113826;50626;8.1;3.6
31;2021-03-24;4357;299;118183;50925;8.4;3.6
31;2021-03-25;6042;537;124225;51462;8.9;3.7
31;2021-03-26;5465;525;129690;51987;9.3;3.7
31;2021-03-27;4350;213;134040;52200;9.6;3.7
31;2021-03-28;2291;48;136331;52248;9.7;3.7
31;2021-03-29;4206;435;140537;52683;10.0;3.8
31;2021-03-30;6596;560;147133;53243;10.5;3.8
31;2021-03-31;5650;394;152783;53637;10.9;3.8
31;2021-04-01;6968;568;159751;54205;11.4;3.9
31;2021-04-02;6102;597;165853;54802;11.8;3.9
31;2021-04-03;3927;159;169780;54961;12.1;3.9
31;2021-04-04;2060;116;171840;55077;12.3;3.9
31;2021-04-05;481;71;172321;55148;12.3;3.9
31;2021-04-06;4165;1159;176486;56307;12.6;4.0
31;2021-04-07;5988;993;182474;57300;13.0;4.1
31;2021-04-08;7569;1047;190043;58347;13.6;4.2
31;2021-04-09;8385;1261;198428;59608;14.2;4.3
31;2021-04-10;4718;549;203146;60157;14.5;4.3
31;2021-04-11;2069;140;205215;60297;14.6;4.3
31;2021-04-12;6001;1847;211216;62144;15.1;4.4
31;2021-04-13;8051;2053;219267;64197;15.7;4.6
31;2021-04-14;6654;1933;225921;66130;16.1;4.7
31;2021-04-15;7771;2253;233692;68383;16.7;4.9
31;2021-04-16;7178;2104;240870;70487;17.2;5.0
31;2021-04-17;4414;915;245284;71402;17.5;5.1
31;2021-04-18;2514;358;247798;71760;17.7;5.1
31;2021-04-19;5220;2034;253018;73794;18.1;5.3
31;2021-04-20;6074;2854;259092;76648;18.5;5.5
31;2021-04-21;5974;2803;265066;79451;18.9;5.7
31;2021-04-22;6377;3251;271443;82702;19.4;5.9
31;2021-04-23;6283;2566;277726;85268;19.8;6.1
31;2021-04-24;1616;3143;279342;88411;19.9;6.3
31;2021-04-25;688;2096;280030;90507;20.0;6.5
31;2021-04-26;3794;3229;283824;93736;20.3;6.7
31;2021-04-27;4516;3902;288340;97638;20.6;7.0
31;2021-04-28;4543;3534;292883;101172;20.9;7.2
31;2021-04-29;5183;4056;298066;105228;21.3;7.5
31;2021-04-30;5039;4148;303105;109376;21.6;7.8
31;2021-05-01;1487;3120;304592;112496;21.7;8.0
31;2021-05-02;1416;1979;306008;114475;21.8;8.2
31;2021-05-03;5658;2425;311666;116900;22.2;8.3
31;2021-05-04;4778;4749;316444;121649;22.6;8.7
31;2021-05-05;2994;5731;319438;127380;22.8;9.1
31;2021-05-06;3635;7386;323073;134766;23.1;9.6
31;2021-05-07;5258;7178;328331;141944;23.4;10.1
31;2021-05-08;3634;3103;331965;145047;23.7;10.4
31;2021-05-09;3760;2310;335725;147357;24.0;10.5
31;2021-05-10;5683;5482;341408;152839;24.4;10.9
31;2021-05-11;6606;6703;348014;159542;24.8;11.4
31;2021-05-12;6172;5939;354186;165481;25.3;11.8
31;2021-05-13;4642;2068;358828;167549;25.6;12.0
31;2021-05-14;6911;3982;365739;171531;26.1;12.2
31;2021-05-15;5145;1756;370884;173287;26.5;12.4
31;2021-05-16;3300;634;374184;173921;26.7;12.4
31;2021-05-17;5143;4151;379327;178072;27.1;12.7
31;2021-05-18;5589;4279;384916;182351;27.5;13.0
31;2021-05-19;5782;3763;390698;186114;27.9;13.3
31;2021-05-20;6473;4807;397171;190921;28.4;13.6
31;2021-05-21;5984;4605;403155;195526;28.8;14.0
31;2021-05-22;4083;1628;407238;197154;29.1;14.1
31;2021-05-23;3583;342;410821;197496;29.3;14.1
31;2021-05-24;3881;707;414702;198203;29.6;14.1
31;2021-05-25;6190;3611;420892;201814;30.0;14.4
31;2021-05-26;5608;4644;426500;206458;30.4;14.7
31;2021-05-27;4788;6193;431288;212651;30.8;15.2
31;2021-05-28;4115;6349;435403;219000;31.1;15.6
31;2021-05-29;1917;4032;437320;223032;31.2;15.9
31;2021-05-30;751;2362;438071;225394;31.3;16.1
31;2021-05-31;4396;5083;442467;230477;31.6;16.5
31;2021-06-01;5954;6565;448421;237042;32.0;16.9
31;2021-06-02;5803;6308;454224;243350;32.4;17.4
31;2021-06-03;7308;8139;461532;251489;32.9;18.0
31;2021-06-04;7540;7164;469072;258653;33.5;18.5
31;2021-06-05;9078;2778;478150;261431;34.1;18.7
31;2021-06-06;8106;1582;486256;263013;34.7;18.8
31;2021-06-07;7986;5473;494242;268486;35.3;19.2
31;2021-06-08;9106;6052;503348;274538;35.9;19.6
31;2021-06-09;8918;5557;512266;280095;36.6;20.0
31;2021-06-10;9781;6362;522047;286457;37.3;20.4
31;2021-06-11;10050;6639;532097;293096;38.0;20.9
31;2021-06-12;8788;3026;540885;296122;38.6;21.1
31;2021-06-13;8378;2018;549263;298140;39.2;21.3
31;2021-06-14;8429;6731;557692;304871;39.8;21.8
31;2021-06-15;9773;7446;567465;312317;40.5;22.3
31;2021-06-16;8735;5262;576200;317579;41.1;22.7
31;2021-06-17;8277;6610;584477;324189;41.7;23.1
31;2021-06-18;8551;7757;593028;331946;42.3;23.7
31;2021-06-19;7364;5442;600392;337388;42.9;24.1
31;2021-06-20;5573;3727;605965;341115;43.3;24.3
31;2021-06-21;5374;6918;611339;348033;43.6;24.8
31;2021-06-22;4986;8231;616325;356264;44.0;25.4
31;2021-06-23;5105;7284;621430;363548;44.4;26.0
31;2021-06-24;4634;8340;626064;371888;44.7;26.5
31;2021-06-25;5014;9313;631078;381201;45.0;27.2
31;2021-06-26;4283;6399;635361;387600;45.4;27.7
31;2021-06-27;3596;4106;638957;391706;45.6;28.0
31;2021-06-28;4098;6647;643055;398353;45.9;28.4
31;2021-06-29;3798;7564;646853;405917;46.2;29.0
31;2021-06-30;4280;7821;651133;413738;46.5;29.5
31;2021-07-01;4122;8472;655255;422210;46.8;30.1
31;2021-07-02;4114;9330;659369;431540;47.1;30.8
31;2021-07-03;4100;6114;663469;437654;47.4;31.2
31;2021-07-04;3205;4812;666674;442466;47.6;31.6
31;2021-07-05;4057;7094;670731;449560;47.9;32.1
31;2021-07-06;3889;8363;674620;457923;48.2;32.7
31;2021-07-07;3964;7962;678584;465885;48.4;33.3
31;2021-07-08;4054;8540;682638;474425;48.7;33.9
31;2021-07-09;4462;8800;687100;483225;49.0;34.5
31;2021-07-10;3918;5498;691018;488723;49.3;34.9
31;2021-07-11;3137;4138;694155;492861;49.5;35.2
31;2021-07-12;3826;8640;697981;501501;49.8;35.8
31;2021-07-13;6921;9448;704902;510949;50.3;36.5
31;2021-07-14;6167;3939;711069;514888;50.8;36.8
31;2021-07-15;8515;9450;719584;524338;51.4;37.4
31;2021-07-16;7775;9921;727359;534259;51.9;38.1
31;2021-07-17;8358;10559;735717;544818;52.5;38.9
31;2021-07-18;6620;9476;742337;554294;53.0;39.6
31;2021-07-19;4794;10778;747131;565072;53.3;40.3
31;2021-07-20;7160;11485;754291;576557;53.8;41.2
31;2021-07-21;7041;11532;761332;588089;54.3;42.0
31;2021-07-22;8165;11770;769497;599859;54.9;42.8
31;2021-07-23;7476;11819;776973;611678;55.5;43.7
31;2021-07-24;10311;10576;787284;622254;56.2;44.4
31;2021-07-25;7560;8803;794844;631057;56.7;45.0
31;2021-07-26;5514;9547;800358;640604;57.1;45.7
31;2021-07-27;7960;9199;808318;649803;57.7;46.4
31;2021-07-28;8677;8285;816995;658088;58.3;47.0
31;2021-07-29;8856;8057;825851;666145;58.9;47.6
31;2021-07-30;7674;7988;833525;674133;59.5;48.1
31;2021-07-31;6016;7395;839541;681528;59.9;48.6
31;2021-08-01;4431;4305;843972;685833;60.2;49.0
31;2021-08-02;5490;5419;849462;691252;60.6;49.3
31;2021-08-03;5897;5188;855359;696440;61.1;49.7
31;2021-08-04;5925;4809;861284;701249;61.5;50.1
31;2021-08-05;5586;7232;866870;708481;61.9;50.6
31;2021-08-06;5304;7344;872174;715825;62.3;51.1
31;2021-08-07;4596;6652;876770;722477;62.6;51.6
31;2021-08-08;3386;5579;880156;728056;62.8;52.0
31;2021-08-09;4396;7011;884552;735067;63.1;52.5
31;2021-08-10;4686;6286;889238;741353;63.5;52.9
31;2021-08-11;4527;5860;893765;747213;63.8;53.3
31;2021-08-12;4524;6760;898289;753973;64.1;53.8
31;2021-08-13;4174;6204;902463;760177;64.4;54.3
31;2021-08-14;3033;6462;905496;766639;64.6;54.7
31;2021-08-15;1309;4098;906805;770737;64.7;55.0
31;2021-08-16;3219;8118;910024;778855;65.0;55.6
31;2021-08-17;3433;7098;913457;785953;65.2;56.1
31;2021-08-18;3314;7008;916771;792961;65.4;56.6
31;2021-08-19;2987;6994;919758;799955;65.7;57.1
31;2021-08-20;3025;7395;922783;807350;65.9;57.6
31;2021-08-21;1980;6801;924763;814151;66.0;58.1
31;2021-08-22;1486;5638;926249;819789;66.1;58.5
31;2021-08-23;2385;7729;928634;827518;66.3;59.1
31;2021-08-24;2609;6174;931243;833692;66.5;59.5
31;2021-08-25;2415;5730;933658;839422;66.6;59.9
31;2021-08-26;2280;5802;935938;845224;66.8;60.3
31;2021-08-27;2363;6664;938301;851888;67.0;60.8
31;2021-08-28;1846;6791;940147;858679;67.1;61.3
31;2021-08-29;1282;5067;941429;863746;67.2;61.7
31;2021-08-30;2191;6586;943620;870332;67.4;62.1
31;2021-08-31;2260;5452;945880;875784;67.5;62.5
31;2021-09-01;1755;4657;947635;880441;67.6;62.8
31;2021-09-02;1770;4050;949405;884491;67.8;63.1
31;2021-09-03;1833;4716;951238;889207;67.9;63.5
31;2021-09-04;2009;5690;953247;894897;68.0;63.9
31;2021-09-05;1129;2172;954376;897069;68.1;64.0
31;2021-09-06;1368;3039;955744;900108;68.2;64.3
31;2021-09-07;1263;2866;957007;902974;68.3;64.5
31;2021-09-08;1424;3424;958431;906398;68.4;64.7
31;2021-09-09;1111;2559;959542;908957;68.5;64.9
31;2021-09-10;1678;3406;961220;912363;68.6;65.1
31;2021-09-11;1293;3776;962513;916139;68.7;65.4
31;2021-09-12;541;1683;963054;917822;68.7;65.5
31;2021-09-13;1014;1983;964068;919805;68.8;65.7
31;2021-09-14;1248;2001;965316;921806;68.9;65.8
31;2021-09-15;1089;2694;966405;924500;69.0;66.0
31;2021-09-16;900;1682;967305;926182;69.0;66.1
31;2021-09-17;1076;2506;968381;928688;69.1;66.3
31;2021-09-18;857;2798;969238;931486;69.2;66.5
31;2021-09-19;323;1242;969561;932728;69.2;66.6
31;2021-09-20;609;1599;970170;934327;69.3;66.7
31;2021-09-21;825;1562;970995;935889;69.3;66.8
31;2021-09-22;834;2059;971829;937948;69.4;67.0
31;2021-09-23;773;1549;972602;939497;69.4;67.1
31;2021-09-24;833;2009;973435;941506;69.5;67.2
31;2021-09-25;665;2537;974100;944043;69.5;67.4
31;2021-09-26;249;1128;974349;945171;69.5;67.5
31;2021-09-27;690;1509;975039;946680;69.6;67.6
31;2021-09-28;729;1350;975768;948030;69.7;67.7
31;2021-09-29;760;1670;976528;949700;69.7;67.8
31;2021-09-30;719;1247;977247;950947;69.8;67.9
31;2021-10-01;825;1852;978072;952799;69.8;68.0
31;2021-10-02;766;1761;978838;954560;69.9;68.1
31;2021-10-03;107;349;978945;954909;69.9;68.2
31;2021-10-04;390;694;979335;955603;69.9;68.2
31;2021-10-05;540;1321;979875;956924;69.9;68.3
31;2021-10-06;629;1193;980504;958117;70.0;68.4
31;2021-10-07;644;1390;981148;959507;70.0;68.5
31;2021-10-08;760;1187;981908;960694;70.1;68.6
31;2021-10-09;510;1278;982418;961972;70.1;68.7
31;2021-10-10;19;57;982437;962029;70.1;68.7
31;2021-10-11;374;511;982811;962540;70.2;68.7
31;2021-10-12;587;1059;983398;963599;70.2;68.8
31;2021-10-13;592;1059;983990;964658;70.2;68.9
31;2021-10-14;651;1125;984641;965783;70.3;68.9
31;2021-10-15;730;1064;985371;966847;70.3;69.0
31;2021-10-16;450;1023;985821;967870;70.4;69.1
31;2021-10-17;8;31;985829;967901;70.4;69.1
31;2021-10-18;317;469;986146;968370;70.4;69.1
31;2021-10-19;540;920;986686;969290;70.4;69.2
32;2020-12-27;0;0;0;0;0.0;0.0
32;2020-12-28;0;0;0;0;0.0;0.0
32;2020-12-29;0;0;0;0;0.0;0.0
32;2020-12-30;0;0;0;0;0.0;0.0
32;2020-12-31;0;0;0;0;0.0;0.0
32;2021-01-01;0;0;0;0;0.0;0.0
32;2021-01-02;0;0;0;0;0.0;0.0
32;2021-01-03;1;0;1;0;0.0;0.0
32;2021-01-04;3;0;4;0;0.0;0.0
32;2021-01-05;2;0;6;0;0.0;0.0
32;2021-01-06;3;0;9;0;0.0;0.0
32;2021-01-07;155;0;164;0;0.1;0.0
32;2021-01-08;70;0;234;0;0.1;0.0
32;2021-01-09;5;0;239;0;0.1;0.0
32;2021-01-10;0;0;239;0;0.1;0.0
32;2021-01-11;11;0;250;0;0.1;0.0
32;2021-01-12;96;0;346;0;0.2;0.0
32;2021-01-13;325;1;671;1;0.4;0.0
32;2021-01-14;389;3;1060;4;0.6;0.0
32;2021-01-15;449;3;1509;7;0.8;0.0
32;2021-01-16;17;2;1526;9;0.8;0.0
32;2021-01-17;1;0;1527;9;0.8;0.0
32;2021-01-18;345;1;1872;10;1.0;0.0
32;2021-01-19;421;0;2293;10;1.2;0.0
32;2021-01-20;358;0;2651;10;1.4;0.0
32;2021-01-21;582;1;3233;11;1.7;0.0
32;2021-01-22;372;0;3605;11;1.9;0.0
32;2021-01-23;189;0;3794;11;2.0;0.0
32;2021-01-24;5;0;3799;11;2.0;0.0
32;2021-01-25;468;1;4267;12;2.2;0.0
32;2021-01-26;612;0;4879;12;2.6;0.0
32;2021-01-27;703;4;5582;16;2.9;0.0
32;2021-01-28;687;15;6269;31;3.3;0.0
32;2021-01-29;461;54;6730;85;3.5;0.0
32;2021-01-30;260;0;6990;85;3.7;0.0
32;2021-01-31;4;5;6994;90;3.7;0.0
32;2021-02-01;289;58;7283;148;3.8;0.1
32;2021-02-02;641;139;7924;287;4.2;0.2
32;2021-02-03;338;200;8262;487;4.3;0.3
32;2021-02-04;427;279;8689;766;4.6;0.4
32;2021-02-05;347;359;9036;1125;4.8;0.6
32;2021-02-06;150;0;9186;1125;4.8;0.6
32;2021-02-07;0;36;9186;1161;4.8;0.6
32;2021-02-08;278;121;9464;1282;5.0;0.7
32;2021-02-09;310;229;9774;1511;5.1;0.8
32;2021-02-10;272;254;10046;1765;5.3;0.9
32;2021-02-11;383;317;10429;2082;5.5;1.1
32;2021-02-12;298;280;10727;2362;5.6;1.2
32;2021-02-13;249;1;10976;2363;5.8;1.2
32;2021-02-14;1;28;10977;2391;5.8;1.3
32;2021-02-15;25;212;11002;2603;5.8;1.4
32;2021-02-16;395;368;11397;2971;6.0;1.6
32;2021-02-17;191;474;11588;3445;6.1;1.8
32;2021-02-18;333;493;11921;3938;6.3;2.1
32;2021-02-19;184;278;12105;4216;6.4;2.2
32;2021-02-20;1;120;12106;4336;6.4;2.3
32;2021-02-21;0;0;12106;4336;6.4;2.3
32;2021-02-22;158;385;12264;4721;6.5;2.5
32;2021-02-23;432;571;12696;5292;6.7;2.8
32;2021-02-24;276;381;12972;5673;6.8;3.0
32;2021-02-25;480;527;13452;6200;7.1;3.3
32;2021-02-26;444;384;13896;6584;7.3;3.5
32;2021-02-27;157;246;14053;6830;7.4;3.6
32;2021-02-28;4;0;14057;6830;7.4;3.6
32;2021-03-01;51;300;14108;7130;7.4;3.8
32;2021-03-02;414;449;14522;7579;7.6;4.0
32;2021-03-03;276;292;14798;7871;7.8;4.1
32;2021-03-04;541;340;15339;8211;8.1;4.3
32;2021-03-05;438;248;15777;8459;8.3;4.5
32;2021-03-06;520;173;16297;8632;8.6;4.5
32;2021-03-07;25;5;16322;8637;8.6;4.5
32;2021-03-08;234;295;16556;8932;8.7;4.7
32;2021-03-09;644;335;17200;9267;9.1;4.9
32;2021-03-10;482;329;17682;9596;9.3;5.0
32;2021-03-11;855;295;18537;9891;9.8;5.2
32;2021-03-12;881;344;19418;10235;10.2;5.4
32;2021-03-13;492;246;19910;10481;10.5;5.5
32;2021-03-14;1;0;19911;10481;10.5;5.5
32;2021-03-15;262;26;20173;10507;10.6;5.5
32;2021-03-16;314;310;20487;10817;10.8;5.7
32;2021-03-17;150;156;20637;10973;10.9;5.8
32;2021-03-18;375;308;21012;11281;11.1;5.9
32;2021-03-19;405;183;21417;11464;11.3;6.0
32;2021-03-20;136;33;21553;11497;11.3;6.0
32;2021-03-21;0;0;21553;11497;11.3;6.0
32;2021-03-22;340;170;21893;11667;11.5;6.1
32;2021-03-23;560;399;22453;12066;11.8;6.3
32;2021-03-24;643;271;23096;12337;12.2;6.5
32;2021-03-25;899;418;23995;12755;12.6;6.7
32;2021-03-26;657;294;24652;13049;13.0;6.9
32;2021-03-27;165;3;24817;13052;13.1;6.9
32;2021-03-28;1;1;24818;13053;13.1;6.9
32;2021-03-29;371;49;25189;13102;13.3;6.9
32;2021-03-30;766;290;25955;13392;13.7;7.0
32;2021-03-31;654;174;26609;13566;14.0;7.1
32;2021-04-01;1237;320;27846;13886;14.7;7.3
32;2021-04-02;575;167;28421;14053;15.0;7.4
32;2021-04-03;113;0;28534;14053;15.0;7.4
32;2021-04-04;0;0;28534;14053;15.0;7.4
32;2021-04-05;1;0;28535;14053;15.0;7.4
32;2021-04-06;2649;316;31184;14369;16.4;7.6
32;2021-04-07;1178;206;32362;14575;17.0;7.7
32;2021-04-08;1736;407;34098;14982;17.9;7.9
32;2021-04-09;883;218;34981;15200;18.4;8.0
32;2021-04-10;809;30;35790;15230;18.8;8.0
32;2021-04-11;14;0;35804;15230;18.8;8.0
32;2021-04-12;477;23;36281;15253;19.1;8.0
32;2021-04-13;2469;389;38750;15642;20.4;8.2
32;2021-04-14;1226;264;39976;15906;21.0;8.4
32;2021-04-15;1704;396;41680;16302;21.9;8.6
32;2021-04-16;638;284;42318;16586;22.3;8.7
32;2021-04-17;783;39;43101;16625;22.7;8.7
32;2021-04-18;13;1;43114;16626;22.7;8.7
32;2021-04-19;502;46;43616;16672;23.0;8.8
32;2021-04-20;2472;394;46088;17066;24.3;9.0
32;2021-04-21;1009;302;47097;17368;24.8;9.1
32;2021-04-22;1662;321;48759;17689;25.7;9.3
32;2021-04-23;549;159;49308;17848;25.9;9.4
32;2021-04-24;1392;58;50700;17906;26.7;9.4
32;2021-04-25;0;11;50700;17917;26.7;9.4
32;2021-04-26;387;359;51087;18276;26.9;9.6
32;2021-04-27;2551;560;53638;18836;28.2;9.9
32;2021-04-28;972;357;54610;19193;28.7;10.1
32;2021-04-29;1008;885;55618;20078;29.3;10.6
32;2021-04-30;453;363;56071;20441;29.5;10.8
32;2021-05-01;2607;98;58678;20539;30.9;10.8
32;2021-05-02;0;0;58678;20539;30.9;10.8
32;2021-05-03;170;321;58848;20860;31.0;11.0
32;2021-05-04;785;2497;59633;23357;31.4;12.3
32;2021-05-05;2360;1101;61993;24458;32.6;12.9
32;2021-05-06;516;1661;62509;26119;32.9;13.7
32;2021-05-07;2286;539;64795;26658;34.1;14.0
32;2021-05-08;70;516;64865;27174;34.1;14.3
32;2021-05-09;21;179;64886;27353;34.1;14.4
32;2021-05-10;1994;553;66880;27906;35.2;14.7
32;2021-05-11;652;2278;67532;30184;35.5;15.9
32;2021-05-12;2313;1139;69845;31323;36.8;16.5
32;2021-05-13;280;1417;70125;32740;36.9;17.2
32;2021-05-14;2223;328;72348;33068;38.1;17.4
32;2021-05-15;134;712;72482;33780;38.1;17.8
32;2021-05-16;2;0;72484;33780;38.1;17.8
32;2021-05-17;353;170;72837;33950;38.3;17.9
32;2021-05-18;1642;298;74479;34248;39.2;18.0
32;2021-05-19;2474;274;76953;34522;40.5;18.2
32;2021-05-20;2885;471;79838;34993;42.0;18.4
32;2021-05-21;2532;500;82370;35493;43.3;18.7
32;2021-05-22;334;110;82704;35603;43.5;18.7
32;2021-05-23;2;13;82706;35616;43.5;18.7
32;2021-05-24;3;0;82709;35616;43.5;18.7
32;2021-05-25;1982;374;84691;35990;44.6;18.9
32;2021-05-26;2547;559;87238;36549;45.9;19.2
32;2021-05-27;2876;626;90114;37175;47.4;19.6
32;2021-05-28;2308;767;92422;37942;48.6;20.0
32;2021-05-29;372;314;92794;38256;48.8;20.1
32;2021-05-30;4;6;92798;38262;48.8;20.1
32;2021-05-31;1413;626;94211;38888;49.6;20.5
32;2021-06-01;567;2889;94778;41777;49.9;22.0
32;2021-06-02;1580;1351;96358;43128;50.7;22.7
32;2021-06-03;395;2086;96753;45214;50.9;23.8
32;2021-06-04;1836;831;98589;46045;51.9;24.2
32;2021-06-05;207;1660;98796;47705;52.0;25.1
32;2021-06-06;8;14;98804;47719;52.0;25.1
32;2021-06-07;102;418;98906;48137;52.0;25.3
32;2021-06-08;663;2538;99569;50675;52.4;26.7
32;2021-06-09;1191;1056;100760;51731;53.0;27.2
32;2021-06-10;684;1225;101444;52956;53.4;27.9
32;2021-06-11;928;665;102372;53621;53.9;28.2
32;2021-06-12;150;2679;102522;56300;53.9;29.6
32;2021-06-13;1;1;102523;56301;53.9;29.6
32;2021-06-14;528;210;103051;56511;54.2;29.7
32;2021-06-15;1733;1027;104784;57538;55.1;30.3
32;2021-06-16;850;2778;105634;60316;55.6;31.7
32;2021-06-17;859;829;106493;61145;56.0;32.2
32;2021-06-18;315;2724;106808;63869;56.2;33.6
32;2021-06-19;914;437;107722;64306;56.7;33.8
32;2021-06-20;5;13;107727;64319;56.7;33.8
32;2021-06-21;67;1994;107794;66313;56.7;34.9
32;2021-06-22;1042;971;108836;67284;57.3;35.4
32;2021-06-23;517;2183;109353;69467;57.5;36.6
32;2021-06-24;528;517;109881;69984;57.8;36.8
32;2021-06-25;501;2360;110382;72344;58.1;38.1
32;2021-06-26;108;171;110490;72515;58.1;38.2
32;2021-06-27;2;5;110492;72520;58.1;38.2
32;2021-06-28;630;603;111122;73123;58.5;38.5
32;2021-06-29;800;1982;111922;75105;58.9;39.5
32;2021-06-30;757;2726;112679;77831;59.3;41.0
32;2021-07-01;538;2638;113217;80469;59.6;42.3
32;2021-07-02;641;2335;113858;82804;59.9;43.6
32;2021-07-03;481;506;114339;83310;60.2;43.8
32;2021-07-04;2;12;114341;83322;60.2;43.8
32;2021-07-05;76;390;114417;83712;60.2;44.0
32;2021-07-06;878;2083;115295;85795;60.7;45.1
32;2021-07-07;781;2757;116076;88552;61.1;46.6
32;2021-07-08;479;2268;116555;90820;61.3;47.8
32;2021-07-09;615;2226;117170;93046;61.7;49.0
32;2021-07-10;536;520;117706;93566;61.9;49.2
32;2021-07-11;0;5;117706;93571;61.9;49.2
32;2021-07-12;526;1244;118232;94815;62.2;49.9
32;2021-07-13;1695;1818;119927;96633;63.1;50.8
32;2021-07-14;492;36;120419;96669;63.4;50.9
32;2021-07-15;2096;892;122515;97561;64.5;51.3
32;2021-07-16;1170;1914;123685;99475;65.1;52.3
32;2021-07-17;78;128;123763;99603;65.1;52.4
32;2021-07-18;2;5;123765;99608;65.1;52.4
32;2021-07-19;1997;147;125762;99755;66.2;52.5
32;2021-07-20;2036;1273;127798;101028;67.2;53.2
32;2021-07-21;1614;1692;129412;102720;68.1;54.1
32;2021-07-22;1946;513;131358;103233;69.1;54.3
32;2021-07-23;1408;1731;132766;104964;69.9;55.2
32;2021-07-24;139;118;132905;105082;69.9;55.3
32;2021-07-25;34;10;132939;105092;70.0;55.3
32;2021-07-26;1071;1070;134010;106162;70.5;55.9
32;2021-07-27;1730;2100;135740;108262;71.4;57.0
32;2021-07-28;694;975;136434;109237;71.8;57.5
32;2021-07-29;1694;1608;138128;110845;72.7;58.3
32;2021-07-30;363;349;138491;111194;72.9;58.5
32;2021-07-31;186;350;138677;111544;73.0;58.7
32;2021-08-01;18;4;138695;111548;73.0;58.7
32;2021-08-02;82;76;138777;111624;73.0;58.7
32;2021-08-03;1173;1792;139950;113416;73.6;59.7
32;2021-08-04;634;652;140584;114068;74.0;60.0
32;2021-08-05;1104;1944;141688;116012;74.6;61.0
32;2021-08-06;563;495;142251;116507;74.9;61.3
32;2021-08-07;148;92;142399;116599;74.9;61.4
32;2021-08-08;1;0;142400;116599;74.9;61.4
32;2021-08-09;263;1826;142663;118425;75.1;62.3
32;2021-08-10;715;2078;143378;120503;75.4;63.4
32;2021-08-11;579;446;143957;120949;75.8;63.6
32;2021-08-12;931;2102;144888;123051;76.2;64.8
32;2021-08-13;178;249;145066;123300;76.3;64.9
32;2021-08-14;113;117;145179;123417;76.4;64.9
32;2021-08-15;13;21;145192;123438;76.4;65.0
32;2021-08-16;44;40;145236;123478;76.4;65.0
32;2021-08-17;572;2301;145808;125779;76.7;66.2
32;2021-08-18;312;559;146120;126338;76.9;66.5
32;2021-08-19;956;1410;147076;127748;77.4;67.2
32;2021-08-20;208;166;147284;127914;77.5;67.3
32;2021-08-21;150;194;147434;128108;77.6;67.4
32;2021-08-22;8;3;147442;128111;77.6;67.4
32;2021-08-23;45;101;147487;128212;77.6;67.5
32;2021-08-24;585;1449;148072;129661;77.9;68.2
32;2021-08-25;94;191;148166;129852;78.0;68.3
32;2021-08-26;321;2262;148487;132114;78.1;69.5
32;2021-08-27;276;553;148763;132667;78.3;69.8
32;2021-08-28;70;109;148833;132776;78.3;69.9
32;2021-08-29;1;8;148834;132784;78.3;69.9
32;2021-08-30;20;49;148854;132833;78.3;69.9
32;2021-08-31;195;1517;149049;134350;78.4;70.7
32;2021-09-01;680;785;149729;135135;78.8;71.1
32;2021-09-02;318;1579;150047;136714;79.0;71.9
32;2021-09-03;196;294;150243;137008;79.1;72.1
32;2021-09-04;49;90;150292;137098;79.1;72.1
32;2021-09-05;12;15;150304;137113;79.1;72.1
32;2021-09-06;50;72;150354;137185;79.1;72.2
32;2021-09-07;438;810;150792;137995;79.3;72.6
32;2021-09-08;255;484;151047;138479;79.5;72.9
32;2021-09-09;227;885;151274;139364;79.6;73.3
32;2021-09-10;203;195;151477;139559;79.7;73.4
32;2021-09-11;88;137;151565;139696;79.8;73.5
32;2021-09-12;7;11;151572;139707;79.8;73.5
32;2021-09-13;4;10;151576;139717;79.8;73.5
32;2021-09-14;324;574;151900;140291;79.9;73.8
32;2021-09-15;200;145;152100;140436;80.0;73.9
32;2021-09-16;184;216;152284;140652;80.1;74.0
32;2021-09-17;199;345;152483;140997;80.2;74.2
32;2021-09-18;40;62;152523;141059;80.3;74.2
32;2021-09-19;0;2;152523;141061;80.3;74.2
32;2021-09-20;4;18;152527;141079;80.3;74.2
32;2021-09-21;241;459;152768;141538;80.4;74.5
32;2021-09-22;233;548;153001;142086;80.5;74.8
32;2021-09-23;134;217;153135;142303;80.6;74.9
32;2021-09-24;101;288;153236;142591;80.6;75.0
32;2021-09-25;28;51;153264;142642;80.6;75.1
32;2021-09-26;3;5;153267;142647;80.6;75.1
32;2021-09-27;9;29;153276;142676;80.7;75.1
32;2021-09-28;113;515;153389;143191;80.7;75.3
32;2021-09-29;88;334;153477;143525;80.8;75.5
32;2021-09-30;170;201;153647;143726;80.8;75.6
32;2021-10-01;103;246;153750;143972;80.9;75.8
32;2021-10-02;28;103;153778;144075;80.9;75.8
32;2021-10-03;0;8;153778;144083;80.9;75.8
32;2021-10-04;13;19;153791;144102;80.9;75.8
32;2021-10-05;59;287;153850;144389;81.0;76.0
32;2021-10-06;41;260;153891;144649;81.0;76.1
32;2021-10-07;56;218;153947;144867;81.0;76.2
32;2021-10-08;65;257;154012;145124;81.0;76.4
32;2021-10-09;25;52;154037;145176;81.1;76.4
32;2021-10-10;0;0;154037;145176;81.1;76.4
32;2021-10-11;11;44;154048;145220;81.1;76.4
32;2021-10-12;61;188;154109;145408;81.1;76.5
32;2021-10-13;56;202;154165;145610;81.1;76.6
32;2021-10-14;93;269;154258;145879;81.2;76.8
32;2021-10-15;67;143;154325;146022;81.2;76.8
32;2021-10-16;25;39;154350;146061;81.2;76.9
32;2021-10-17;0;0;154350;146061;81.2;76.9
32;2021-10-18;9;20;154359;146081;81.2;76.9
32;2021-10-19;93;148;154452;146229;81.3;76.9
33;2020-12-27;4;0;4;0;0.0;0.0
33;2020-12-28;3;0;7;0;0.0;0.0
33;2020-12-29;0;0;7;0;0.0;0.0
33;2020-12-30;0;0;7;0;0.0;0.0
33;2020-12-31;1;0;8;0;0.0;0.0
33;2021-01-01;0;0;8;0;0.0;0.0
33;2021-01-02;2;1;10;1;0.0;0.0
33;2021-01-03;2;1;12;2;0.0;0.0
33;2021-01-04;2;0;14;2;0.0;0.0
33;2021-01-05;2;0;16;2;0.0;0.0
33;2021-01-06;134;1;150;3;0.0;0.0
33;2021-01-07;1309;4;1459;7;0.1;0.0
33;2021-01-08;1200;3;2659;10;0.2;0.0
33;2021-01-09;299;1;2958;11;0.2;0.0
33;2021-01-10;229;0;3187;11;0.2;0.0
33;2021-01-11;628;0;3815;11;0.2;0.0
33;2021-01-12;1417;2;5232;13;0.3;0.0
33;2021-01-13;1315;9;6547;22;0.4;0.0
33;2021-01-14;1293;19;7840;41;0.5;0.0
33;2021-01-15;1610;15;9450;56;0.6;0.0
33;2021-01-16;568;10;10018;66;0.6;0.0
33;2021-01-17;406;4;10424;70;0.6;0.0
33;2021-01-18;1227;14;11651;84;0.7;0.0
33;2021-01-19;2938;13;14589;97;0.9;0.0
33;2021-01-20;3431;17;18020;114;1.1;0.0
33;2021-01-21;2866;9;20886;123;1.3;0.0
33;2021-01-22;2328;13;23214;136;1.4;0.0
33;2021-01-23;853;3;24067;139;1.5;0.0
33;2021-01-24;532;2;24599;141;1.5;0.0
33;2021-01-25;2173;63;26772;204;1.6;0.0
33;2021-01-26;2263;164;29035;368;1.8;0.0
33;2021-01-27;2263;208;31298;576;1.9;0.0
33;2021-01-28;2161;438;33459;1014;2.0;0.1
33;2021-01-29;1826;684;35285;1698;2.2;0.1
33;2021-01-30;707;172;35992;1870;2.2;0.1
33;2021-01-31;390;158;36382;2028;2.2;0.1
33;2021-02-01;1457;647;37839;2675;2.3;0.2
33;2021-02-02;2644;1113;40483;3788;2.5;0.2
33;2021-02-03;2942;874;43425;4662;2.7;0.3
33;2021-02-04;4033;1352;47458;6014;2.9;0.4
33;2021-02-05;2193;1172;49651;7186;3.0;0.4
33;2021-02-06;648;199;50299;7385;3.1;0.5
33;2021-02-07;220;229;50519;7614;3.1;0.5
33;2021-02-08;1267;756;51786;8370;3.2;0.5
33;2021-02-09;1328;1675;53114;10045;3.3;0.6
33;2021-02-10;1268;1746;54382;11791;3.3;0.7
33;2021-02-11;1306;1442;55688;13233;3.4;0.8
33;2021-02-12;1121;1250;56809;14483;3.5;0.9
33;2021-02-13;204;292;57013;14775;3.5;0.9
33;2021-02-14;47;245;57060;15020;3.5;0.9
33;2021-02-15;684;1718;57744;16738;3.5;1.0
33;2021-02-16;816;2053;58560;18791;3.6;1.2
33;2021-02-17;668;2048;59228;20839;3.6;1.3
33;2021-02-18;899;2243;60127;23082;3.7;1.4
33;2021-02-19;921;2014;61048;25096;3.7;1.5
33;2021-02-20;78;656;61126;25752;3.7;1.6
33;2021-02-21;37;460;61163;26212;3.7;1.6
33;2021-02-22;709;1885;61872;28097;3.8;1.7
33;2021-02-23;1235;2746;63107;30843;3.9;1.9
33;2021-02-24;1407;2524;64514;33367;3.9;2.0
33;2021-02-25;2842;3759;67356;37126;4.1;2.3
33;2021-02-26;4059;2334;71415;39460;4.4;2.4
33;2021-02-27;1361;722;72776;40182;4.5;2.5
33;2021-02-28;127;514;72903;40696;4.5;2.5
33;2021-03-01;1537;1856;74440;42552;4.6;2.6
33;2021-03-02;2326;1747;76766;44299;4.7;2.7
33;2021-03-03;2313;1709;79079;46008;4.8;2.8
33;2021-03-04;3938;1672;83017;47680;5.1;2.9
33;2021-03-05;5764;1745;88781;49425;5.4;3.0
33;2021-03-06;3417;566;92198;49991;5.6;3.1
33;2021-03-07;741;160;92939;50151;5.7;3.1
33;2021-03-08;2713;1154;95652;51305;5.9;3.1
33;2021-03-09;4403;1341;100055;52646;6.1;3.2
33;2021-03-10;5122;1243;105177;53889;6.4;3.3
33;2021-03-11;7551;1237;112728;55126;6.9;3.4
33;2021-03-12;10117;1180;122845;56306;7.5;3.4
33;2021-03-13;5155;220;128000;56526;7.8;3.5
33;2021-03-14;714;29;128714;56555;7.9;3.5
33;2021-03-15;4445;685;133159;57240;8.2;3.5
33;2021-03-16;3584;883;136743;58123;8.4;3.6
33;2021-03-17;3644;953;140387;59076;8.6;3.6
33;2021-03-18;4038;1417;144425;60493;8.8;3.7
33;2021-03-19;6272;1042;150697;61535;9.2;3.8
33;2021-03-20;3368;109;154065;61644;9.4;3.8
33;2021-03-21;462;30;154527;61674;9.5;3.8
33;2021-03-22;4901;456;159428;62130;9.8;3.8
33;2021-03-23;6324;613;165752;62743;10.1;3.8
33;2021-03-24;7076;528;172828;63271;10.6;3.9
33;2021-03-25;8843;662;181671;63933;11.1;3.9
33;2021-03-26;10041;864;191712;64797;11.7;4.0
33;2021-03-27;3619;84;195331;64881;12.0;4.0
33;2021-03-28;577;34;195908;64915;12.0;4.0
33;2021-03-29;6764;709;202672;65624;12.4;4.0
33;2021-03-30;8103;1051;210775;66675;12.9;4.1
33;2021-03-31;7577;1072;218352;67747;13.4;4.1
33;2021-04-01;8823;1203;227175;68950;13.9;4.2
33;2021-04-02;8412;1567;235587;70517;14.4;4.3
33;2021-04-03;2832;525;238419;71042;14.6;4.3
33;2021-04-04;218;160;238637;71202;14.6;4.4
33;2021-04-05;694;125;239331;71327;14.7;4.4
33;2021-04-06;6049;2691;245380;74018;15.0;4.5
33;2021-04-07;7423;2552;252803;76570;15.5;4.7
33;2021-04-08;10331;2788;263134;79358;16.1;4.9
33;2021-04-09;12687;3102;275821;82460;16.9;5.0
33;2021-04-10;5357;1395;281178;83855;17.2;5.1
33;2021-04-11;1004;353;282182;84208;17.3;5.2
33;2021-04-12;7427;3287;289609;87495;17.7;5.4
33;2021-04-13;9323;3501;298932;90996;18.3;5.6
33;2021-04-14;9040;3649;307972;94645;18.9;5.8
33;2021-04-15;10110;3890;318082;98535;19.5;6.0
33;2021-04-16;9718;4233;327800;102768;20.1;6.3
33;2021-04-17;4652;1662;332452;104430;20.4;6.4
33;2021-04-18;929;415;333381;104845;20.4;6.4
33;2021-04-19;5617;3844;338998;108689;20.8;6.7
33;2021-04-20;7294;4275;346292;112964;21.2;6.9
33;2021-04-21;6594;4356;352886;117320;21.6;7.2
33;2021-04-22;7351;4494;360237;121814;22.1;7.5
33;2021-04-23;7702;4837;367939;126651;22.5;7.8
33;2021-04-24;4500;1804;372439;128455;22.8;7.9
33;2021-04-25;1652;418;374091;128873;22.9;7.9
33;2021-04-26;5271;5089;379362;133962;23.2;8.2
33;2021-04-27;6578;5634;385940;139596;23.6;8.5
33;2021-04-28;6783;5583;392723;145179;24.0;8.9
33;2021-04-29;8425;6250;401148;151429;24.6;9.3
33;2021-04-30;8741;6135;409889;157564;25.1;9.6
33;2021-05-01;2903;517;412792;158081;25.3;9.7
33;2021-05-02;1835;348;414627;158429;25.4;9.7
33;2021-05-03;7018;5221;421645;163650;25.8;10.0
33;2021-05-04;6826;6672;428471;170322;26.2;10.4
33;2021-05-05;7139;7576;435610;177898;26.7;10.9
33;2021-05-06;8703;8246;444313;186144;27.2;11.4
33;2021-05-07;8609;8924;452922;195068;27.7;11.9
33;2021-05-08;3543;1600;456465;196668;27.9;12.0
33;2021-05-09;1118;969;457583;197637;28.0;12.1
33;2021-05-10;6873;7312;464456;204949;28.4;12.5
33;2021-05-11;8634;7883;473090;212832;29.0;13.0
33;2021-05-12;9175;6703;482265;219535;29.5;13.4
33;2021-05-13;5212;2115;487477;221650;29.8;13.6
33;2021-05-14;8130;5355;495607;227005;30.3;13.9
33;2021-05-15;5179;2866;500786;229871;30.7;14.1
33;2021-05-16;1842;803;502628;230674;30.8;14.1
33;2021-05-17;8861;5111;511489;235785;31.3;14.4
33;2021-05-18;10626;4890;522115;240675;32.0;14.7
33;2021-05-19;10900;4784;533015;245459;32.6;15.0
33;2021-05-20;10907;5589;543922;251048;33.3;15.4
33;2021-05-21;10915;6250;554837;257298;34.0;15.8
33;2021-05-22;5121;2751;559958;260049;34.3;15.9
33;2021-05-23;1751;385;561709;260434;34.4;15.9
33;2021-05-24;5412;1001;567121;261435;34.7;16.0
33;2021-05-25;9391;5780;576512;267215;35.3;16.4
33;2021-05-26;9674;6049;586186;273264;35.9;16.7
33;2021-05-27;10902;7725;597088;280989;36.6;17.2
33;2021-05-28;10063;9520;607151;290509;37.2;17.8
33;2021-05-29;5042;4117;612193;294626;37.5;18.0
33;2021-05-30;1703;667;613896;295293;37.6;18.1
33;2021-05-31;8549;6420;622445;301713;38.1;18.5
33;2021-06-01;11802;8722;634247;310435;38.8;19.0
33;2021-06-02;11711;8217;645958;318652;39.5;19.5
33;2021-06-03;12715;9209;658673;327861;40.3;20.1
33;2021-06-04;12932;10958;671605;338819;41.1;20.7
33;2021-06-05;5272;5063;676877;343882;41.4;21.1
33;2021-06-06;2526;1194;679403;345076;41.6;21.1
33;2021-06-07;9758;8503;689161;353579;42.2;21.6
33;2021-06-08;11937;9464;701098;363043;42.9;22.2
33;2021-06-09;11775;8533;712873;371576;43.6;22.7
33;2021-06-10;12951;8397;725824;379973;44.4;23.3
33;2021-06-11;12515;11170;738339;391143;45.2;23.9
33;2021-06-12;6185;4480;744524;395623;45.6;24.2
33;2021-06-13;2614;1284;747138;396907;45.7;24.3
33;2021-06-14;8582;10157;755720;407064;46.3;24.9
33;2021-06-15;12054;10274;767774;417338;47.0;25.5
33;2021-06-16;12058;8880;779832;426218;47.7;26.1
33;2021-06-17;13116;9623;792948;435841;48.5;26.7
33;2021-06-18;11797;11447;804745;447288;49.3;27.4
33;2021-06-19;5610;4822;810355;452110;49.6;27.7
33;2021-06-20;2946;1476;813301;453586;49.8;27.8
33;2021-06-21;7874;10167;821175;463753;50.3;28.4
33;2021-06-22;9066;11088;830241;474841;50.8;29.1
33;2021-06-23;8672;10847;838913;485688;51.4;29.7
33;2021-06-24;9744;9981;848657;495669;52.0;30.3
33;2021-06-25;8047;13716;856704;509385;52.4;31.2
33;2021-06-26;4345;5921;861049;515306;52.7;31.5
33;2021-06-27;2467;1959;863516;517265;52.9;31.7
33;2021-06-28;4871;12764;868387;530029;53.2;32.4
33;2021-06-29;6443;13656;874830;543685;53.6;33.3
33;2021-06-30;6680;13396;881510;557081;54.0;34.1
33;2021-07-01;8046;11810;889556;568891;54.5;34.8
33;2021-07-02;6843;15110;896399;584001;54.9;35.8
33;2021-07-03;3227;6785;899626;590786;55.1;36.2
33;2021-07-04;2066;2379;901692;593165;55.2;36.3
33;2021-07-05;4397;12908;906089;606073;55.5;37.1
33;2021-07-06;6141;14593;912230;620666;55.8;38.0
33;2021-07-07;6871;13053;919101;633719;56.3;38.8
33;2021-07-08;7966;12758;927067;646477;56.8;39.6
33;2021-07-09;6469;15112;933536;661589;57.2;40.5
33;2021-07-10;3114;7162;936650;668751;57.3;40.9
33;2021-07-11;1844;2303;938494;671054;57.5;41.1
33;2021-07-12;3950;14705;942444;685759;57.7;42.0
33;2021-07-13;7152;16107;949596;701866;58.1;43.0
33;2021-07-14;3690;5315;953286;707181;58.4;43.3
33;2021-07-15;7627;15983;960913;723164;58.8;44.3
33;2021-07-16;8588;15150;969501;738314;59.4;45.2
33;2021-07-17;3156;6433;972657;744747;59.5;45.6
33;2021-07-18;1702;3205;974359;747952;59.7;45.8
33;2021-07-19;5872;15097;980231;763049;60.0;46.7
33;2021-07-20;7431;16134;987662;779183;60.5;47.7
33;2021-07-21;8370;14543;996032;793726;61.0;48.6
33;2021-07-22;9366;15112;1005398;808838;61.6;49.5
33;2021-07-23;9666;16350;1015064;825188;62.1;50.5
33;2021-07-24;3839;7554;1018903;832742;62.4;51.0
33;2021-07-25;2093;2667;1020996;835409;62.5;51.1
33;2021-07-26;6965;13420;1027961;848829;62.9;52.0
33;2021-07-27;10091;13403;1038052;862232;63.6;52.8
33;2021-07-28;10932;11977;1048984;874209;64.2;53.5
33;2021-07-29;11673;11913;1060657;886122;64.9;54.2
33;2021-07-30;11401;12226;1072058;898348;65.6;55.0
33;2021-07-31;4761;5650;1076819;903998;65.9;55.3
33;2021-08-01;2484;1951;1079303;905949;66.1;55.5
33;2021-08-02;8419;9892;1087722;915841;66.6;56.1
33;2021-08-03;11560;9028;1099282;924869;67.3;56.6
33;2021-08-04;12287;7372;1111569;932241;68.1;57.1
33;2021-08-05;11937;8046;1123506;940287;68.8;57.6
33;2021-08-06;11230;9056;1134736;949343;69.5;58.1
33;2021-08-07;5929;4515;1140665;953858;69.8;58.4
33;2021-08-08;3186;1771;1143851;955629;70.0;58.5
33;2021-08-09;8661;8721;1152512;964350;70.6;59.0
33;2021-08-10;9375;8453;1161887;972803;71.1;59.6
33;2021-08-11;8115;7590;1170002;980393;71.6;60.0
33;2021-08-12;7981;8021;1177983;988414;72.1;60.5
33;2021-08-13;7849;7683;1185832;996097;72.6;61.0
33;2021-08-14;3527;4332;1189359;1000429;72.8;61.2
33;2021-08-15;1211;1881;1190570;1002310;72.9;61.4
33;2021-08-16;6430;8630;1197000;1010940;73.3;61.9
33;2021-08-17;6638;9072;1203638;1020012;73.7;62.4
33;2021-08-18;5633;8771;1209271;1028783;74.0;63.0
33;2021-08-19;5505;9120;1214776;1037903;74.4;63.5
33;2021-08-20;4962;9837;1219738;1047740;74.7;64.1
33;2021-08-21;2208;5036;1221946;1052776;74.8;64.5
33;2021-08-22;565;2366;1222511;1055142;74.8;64.6
33;2021-08-23;3921;10289;1226432;1065431;75.1;65.2
33;2021-08-24;4145;11094;1230577;1076525;75.3;65.9
33;2021-08-25;3725;10489;1234302;1087014;75.6;66.5
33;2021-08-26;3663;11057;1237965;1098071;75.8;67.2
33;2021-08-27;3830;12588;1241795;1110659;76.0;68.0
33;2021-08-28;1583;6639;1243378;1117298;76.1;68.4
33;2021-08-29;456;2426;1243834;1119724;76.1;68.6
33;2021-08-30;2377;10459;1246211;1130183;76.3;69.2
33;2021-08-31;3252;10861;1249463;1141044;76.5;69.9
33;2021-09-01;2869;8285;1252332;1149329;76.7;70.4
33;2021-09-02;2712;7787;1255044;1157116;76.8;70.8
33;2021-09-03;3120;9377;1258164;1166493;77.0;71.4
33;2021-09-04;1656;5793;1259820;1172286;77.1;71.8
33;2021-09-05;414;1459;1260234;1173745;77.2;71.9
33;2021-09-06;1626;6438;1261860;1180183;77.3;72.3
33;2021-09-07;2082;5718;1263942;1185901;77.4;72.6
33;2021-09-08;1770;5906;1265712;1191807;77.5;73.0
33;2021-09-09;1924;5652;1267636;1197459;77.6;73.3
33;2021-09-10;2106;6304;1269742;1203763;77.7;73.7
33;2021-09-11;1024;4233;1270766;1207996;77.8;74.0
33;2021-09-12;131;556;1270897;1208552;77.8;74.0
33;2021-09-13;1520;3617;1272417;1212169;77.9;74.2
33;2021-09-14;1586;3488;1274003;1215657;78.0;74.4
33;2021-09-15;1555;4454;1275558;1220111;78.1;74.7
33;2021-09-16;1499;3349;1277057;1223460;78.2;74.9
33;2021-09-17;1812;4517;1278869;1227977;78.3;75.2
33;2021-09-18;607;3053;1279476;1231030;78.3;75.4
33;2021-09-19;115;398;1279591;1231428;78.3;75.4
33;2021-09-20;1059;2162;1280650;1233590;78.4;75.5
33;2021-09-21;962;2453;1281612;1236043;78.5;75.7
33;2021-09-22;964;3447;1282576;1239490;78.5;75.9
33;2021-09-23;915;2308;1283491;1241798;78.6;76.0
33;2021-09-24;1299;3720;1284790;1245518;78.7;76.3
33;2021-09-25;520;2354;1285310;1247872;78.7;76.4
33;2021-09-26;66;333;1285376;1248205;78.7;76.4
33;2021-09-27;670;2014;1286046;1250219;78.7;76.5
33;2021-09-28;835;2151;1286881;1252370;78.8;76.7
33;2021-09-29;889;2212;1287770;1254582;78.8;76.8
33;2021-09-30;694;1686;1288464;1256268;78.9;76.9
33;2021-10-01;1058;2683;1289522;1258951;78.9;77.1
33;2021-10-02;556;1352;1290078;1260303;79.0;77.2
33;2021-10-03;10;45;1290088;1260348;79.0;77.2
33;2021-10-04;647;1401;1290735;1261749;79.0;77.2
33;2021-10-05;545;1426;1291280;1263175;79.1;77.3
33;2021-10-06;785;1686;1292065;1264861;79.1;77.4
33;2021-10-07;589;1480;1292654;1266341;79.1;77.5
33;2021-10-08;865;2114;1293519;1268455;79.2;77.7
33;2021-10-09;500;928;1294019;1269383;79.2;77.7
33;2021-10-10;5;42;1294024;1269425;79.2;77.7
33;2021-10-11;491;1186;1294515;1270611;79.3;77.8
33;2021-10-12;554;1140;1295069;1271751;79.3;77.9
33;2021-10-13;781;1378;1295850;1273129;79.3;77.9
33;2021-10-14;541;1116;1296391;1274245;79.4;78.0
33;2021-10-15;874;1571;1297265;1275816;79.4;78.1
33;2021-10-16;427;700;1297692;1276516;79.4;78.1
33;2021-10-17;16;21;1297708;1276537;79.4;78.2
33;2021-10-18;579;737;1298287;1277274;79.5;78.2
33;2021-10-19;660;1020;1298947;1278294;79.5;78.3
34;2020-12-27;1;0;1;0;0.0;0.0
34;2020-12-28;3;0;4;0;0.0;0.0
34;2020-12-29;0;0;4;0;0.0;0.0
34;2020-12-30;0;0;4;0;0.0;0.0
34;2020-12-31;0;0;4;0;0.0;0.0
34;2021-01-01;1;0;5;0;0.0;0.0
34;2021-01-02;2;0;7;0;0.0;0.0
34;2021-01-03;0;0;7;0;0.0;0.0
34;2021-01-04;23;0;30;0;0.0;0.0
34;2021-01-05;108;2;138;2;0.0;0.0
34;2021-01-06;199;7;337;9;0.0;0.0
34;2021-01-07;364;0;701;9;0.1;0.0
34;2021-01-08;606;0;1307;9;0.1;0.0
34;2021-01-09;244;0;1551;9;0.1;0.0
34;2021-01-10;94;1;1645;10;0.1;0.0
34;2021-01-11;567;2;2212;12;0.2;0.0
34;2021-01-12;1009;1;3221;13;0.3;0.0
34;2021-01-13;1099;7;4320;20;0.4;0.0
34;2021-01-14;1957;14;6277;34;0.5;0.0
34;2021-01-15;1471;7;7748;41;0.7;0.0
34;2021-01-16;333;7;8081;48;0.7;0.0
34;2021-01-17;235;1;8316;49;0.7;0.0
34;2021-01-18;1125;5;9441;54;0.8;0.0
34;2021-01-19;1610;8;11051;62;0.9;0.0
34;2021-01-20;2091;23;13142;85;1.1;0.0
34;2021-01-21;4234;20;17376;105;1.5;0.0
34;2021-01-22;2556;10;19932;115;1.7;0.0
34;2021-01-23;601;2;20533;117;1.7;0.0
34;2021-01-24;3;0;20536;117;1.7;0.0
34;2021-01-25;1242;6;21778;123;1.9;0.0
34;2021-01-26;1461;20;23239;143;2.0;0.0
34;2021-01-27;1471;24;24710;167;2.1;0.0
34;2021-01-28;1393;124;26103;291;2.2;0.0
34;2021-01-29;1260;139;27363;430;2.3;0.0
34;2021-01-30;479;25;27842;455;2.4;0.0
34;2021-01-31;4;0;27846;455;2.4;0.0
34;2021-02-01;1028;247;28874;702;2.5;0.1
34;2021-02-02;1464;443;30338;1145;2.6;0.1
34;2021-02-03;2655;525;32993;1670;2.8;0.1
34;2021-02-04;2317;886;35310;2556;3.0;0.2
34;2021-02-05;1891;1176;37201;3732;3.2;0.3
34;2021-02-06;499;241;37700;3973;3.2;0.3
34;2021-02-07;34;108;37734;4081;3.2;0.3
34;2021-02-08;860;1060;38594;5141;3.3;0.4
34;2021-02-09;1035;1301;39629;6442;3.4;0.5
34;2021-02-10;1298;1504;40927;7946;3.5;0.7
34;2021-02-11;1795;2706;42722;10652;3.6;0.9
34;2021-02-12;1923;1645;44645;12297;3.8;1.0
34;2021-02-13;358;513;45003;12810;3.8;1.1
34;2021-02-14;22;286;45025;13096;3.8;1.1
34;2021-02-15;673;1203;45698;14299;3.9;1.2
34;2021-02-16;666;1523;46364;15822;3.9;1.3
34;2021-02-17;715;1519;47079;17341;4.0;1.5
34;2021-02-18;838;1490;47917;18831;4.1;1.6
34;2021-02-19;817;1225;48734;20056;4.1;1.7
34;2021-02-20;300;479;49034;20535;4.2;1.7
34;2021-02-21;64;18;49098;20553;4.2;1.7
34;2021-02-22;632;1296;49730;21849;4.2;1.9
34;2021-02-23;566;1479;50296;23328;4.3;2.0
34;2021-02-24;942;2332;51238;25660;4.4;2.2
34;2021-02-25;1608;2275;52846;27935;4.5;2.4
34;2021-02-26;1850;1632;54696;29567;4.7;2.5
34;2021-02-27;702;431;55398;29998;4.7;2.6
34;2021-02-28;86;64;55484;30062;4.7;2.6
34;2021-03-01;932;1162;56416;31224;4.8;2.7
34;2021-03-02;1592;1280;58008;32504;4.9;2.8
34;2021-03-03;1835;1407;59843;33911;5.1;2.9
34;2021-03-04;2869;1628;62712;35539;5.3;3.0
34;2021-03-05;3685;1544;66397;37083;5.6;3.2
34;2021-03-06;2641;208;69038;37291;5.9;3.2
34;2021-03-07;1242;78;70280;37369;6.0;3.2
34;2021-03-08;2782;1014;73062;38383;6.2;3.3
34;2021-03-09;4020;1459;77082;39842;6.6;3.4
34;2021-03-10;3992;1343;81074;41185;6.9;3.5
34;2021-03-11;5436;1317;86510;42502;7.4;3.6
34;2021-03-12;6494;941;93004;43443;7.9;3.7
34;2021-03-13;3139;182;96143;43625;8.2;3.7
34;2021-03-14;1003;58;97146;43683;8.3;3.7
34;2021-03-15;3308;574;100454;44257;8.5;3.8
34;2021-03-16;2913;674;103367;44931;8.8;3.8
34;2021-03-17;3305;747;106672;45678;9.1;3.9
34;2021-03-18;3451;948;110123;46626;9.4;4.0
34;2021-03-19;4692;809;114815;47435;9.8;4.0
34;2021-03-20;3149;71;117964;47506;10.0;4.0
34;2021-03-21;1997;63;119961;47569;10.2;4.0
34;2021-03-22;3683;475;123644;48044;10.5;4.1
34;2021-03-23;4961;544;128605;48588;10.9;4.1
34;2021-03-24;5221;655;133826;49243;11.4;4.2
34;2021-03-25;7197;732;141023;49975;12.0;4.2
34;2021-03-26;7168;583;148191;50558;12.6;4.3
34;2021-03-27;2374;87;150565;50645;12.8;4.3
34;2021-03-28;700;22;151265;50667;12.9;4.3
34;2021-03-29;4187;770;155452;51437;13.2;4.4
34;2021-03-30;5220;974;160672;52411;13.7;4.5
34;2021-03-31;5069;1219;165741;53630;14.1;4.6
34;2021-04-01;7032;1068;172773;54698;14.7;4.7
34;2021-04-02;5823;1202;178596;55900;15.2;4.8
34;2021-04-03;1137;88;179733;55988;15.3;4.8
34;2021-04-04;166;5;179899;55993;15.3;4.8
34;2021-04-05;433;26;180332;56019;15.3;4.8
34;2021-04-06;3136;2460;183468;58479;15.6;5.0
34;2021-04-07;3388;2647;186856;61126;15.9;5.2
34;2021-04-08;5251;2816;192107;63942;16.3;5.4
34;2021-04-09;8075;2510;200182;66452;17.0;5.6
34;2021-04-10;3164;1378;203346;67830;17.3;5.8
34;2021-04-11;1715;808;205061;68638;17.4;5.8
34;2021-04-12;4502;2539;209563;71177;17.8;6.1
34;2021-04-13;5240;3064;214803;74241;18.3;6.3
34;2021-04-14;5621;3253;220424;77494;18.7;6.6
34;2021-04-15;6997;3181;227421;80675;19.3;6.9
34;2021-04-16;6580;3178;234001;83853;19.9;7.1
34;2021-04-17;2378;2076;236379;85929;20.1;7.3
34;2021-04-18;988;1723;237367;87652;20.2;7.5
34;2021-04-19;3422;3125;240789;90777;20.5;7.7
34;2021-04-20;3768;3666;244557;94443;20.8;8.0
34;2021-04-21;4241;3732;248798;98175;21.2;8.3
34;2021-04-22;4490;4621;253288;102796;21.5;8.7
34;2021-04-23;5380;3536;258668;106332;22.0;9.0
34;2021-04-24;3164;1588;261832;107920;22.3;9.2
34;2021-04-25;1919;650;263751;108570;22.4;9.2
34;2021-04-26;4223;3482;267974;112052;22.8;9.5
34;2021-04-27;5128;4031;273102;116083;23.2;9.9
34;2021-04-28;5770;3558;278872;119641;23.7;10.2
34;2021-04-29;6421;3953;285293;123594;24.3;10.5
34;2021-04-30;7870;3301;293163;126895;24.9;10.8
34;2021-05-01;2405;508;295568;127403;25.1;10.8
34;2021-05-02;3260;329;298828;127732;25.4;10.9
34;2021-05-03;6577;2918;305405;130650;26.0;11.1
34;2021-05-04;7111;3817;312516;134467;26.6;11.4
34;2021-05-05;6497;4537;319013;139004;27.1;11.8
34;2021-05-06;6945;5219;325958;144223;27.7;12.3
34;2021-05-07;6928;5692;332886;149915;28.3;12.7
34;2021-05-08;3608;1174;336494;151089;28.6;12.8
34;2021-05-09;2178;1290;338672;152379;28.8;13.0
34;2021-05-10;5855;4809;344527;157188;29.3;13.4
34;2021-05-11;7412;5332;351939;162520;29.9;13.8
34;2021-05-12;7757;4470;359696;166990;30.6;14.2
34;2021-05-13;6128;786;365824;167776;31.1;14.3
34;2021-05-14;7491;3747;373315;171523;31.7;14.6
34;2021-05-15;4863;1686;378178;173209;32.2;14.7
34;2021-05-16;4949;460;383127;173669;32.6;14.8
34;2021-05-17;8693;1986;391820;175655;33.3;14.9
34;2021-05-18;9143;1979;400963;177634;34.1;15.1
34;2021-05-19;8625;1812;409588;179446;34.8;15.3
34;2021-05-20;8868;2522;418456;181968;35.6;15.5
34;2021-05-21;8784;3231;427240;185199;36.3;15.7
34;2021-05-22;5787;1155;433027;186354;36.8;15.8
34;2021-05-23;3883;549;436910;186903;37.1;15.9
34;2021-05-24;1898;853;438808;187756;37.3;16.0
34;2021-05-25;7142;3816;445950;191572;37.9;16.3
34;2021-05-26;8318;3039;454268;194611;38.6;16.5
34;2021-05-27;8317;4307;462585;198918;39.3;16.9
34;2021-05-28;8062;5458;470647;204376;40.0;17.4
34;2021-05-29;4006;3110;474653;207486;40.4;17.6
34;2021-05-30;1985;1389;476638;208875;40.5;17.8
34;2021-05-31;5878;5260;482516;214135;41.0;18.2
34;2021-06-01;6948;6111;489464;220246;41.6;18.7
34;2021-06-02;6137;5815;495601;226061;42.1;19.2
34;2021-06-03;7703;6487;503304;232548;42.8;19.8
34;2021-06-04;7651;7591;510955;240139;43.4;20.4
34;2021-06-05;4140;3680;515095;243819;43.8;20.7
34;2021-06-06;3266;1865;518361;245684;44.1;20.9
34;2021-06-07;4416;6767;522777;252451;44.4;21.5
34;2021-06-08;5854;6829;528631;259280;44.9;22.0
34;2021-06-09;5827;6847;534458;266127;45.4;22.6
34;2021-06-10;6323;6879;540781;273006;46.0;23.2
34;2021-06-11;5401;9279;546182;282285;46.4;24.0
34;2021-06-12;3167;4728;549349;287013;46.7;24.4
34;2021-06-13;1081;1908;550430;288921;46.8;24.6
34;2021-06-14;3443;7814;553873;296735;47.1;25.2
34;2021-06-15;3952;8794;557825;305529;47.4;26.0
34;2021-06-16;4620;7858;562445;313387;47.8;26.6
34;2021-06-17;4228;7954;566673;321341;48.2;27.3
34;2021-06-18;4352;9330;571025;330671;48.6;28.1
34;2021-06-19;2729;4405;573754;335076;48.8;28.5
34;2021-06-20;888;2873;574642;337949;48.9;28.7
34;2021-06-21;2181;8557;576823;346506;49.0;29.5
34;2021-06-22;2975;9405;579798;355911;49.3;30.3
34;2021-06-23;3528;8965;583326;364876;49.6;31.0
34;2021-06-24;3559;8677;586885;373553;49.9;31.8
34;2021-06-25;3378;10440;590263;383993;50.2;32.6
34;2021-06-26;1642;6192;591905;390185;50.3;33.2
34;2021-06-27;308;4268;592213;394453;50.4;33.5
34;2021-06-28;2267;9430;594480;403883;50.5;34.3
34;2021-06-29;2683;10298;597163;414181;50.8;35.2
34;2021-06-30;3355;9547;600518;423728;51.1;36.0
34;2021-07-01;3530;9449;604048;433177;51.4;36.8
34;2021-07-02;3433;9741;607481;442918;51.7;37.7
34;2021-07-03;1683;6158;609164;449076;51.8;38.2
34;2021-07-04;312;2763;609476;451839;51.8;38.4
34;2021-07-05;3234;7999;612710;459838;52.1;39.1
34;2021-07-06;3531;9176;616241;469014;52.4;39.9
34;2021-07-07;3273;8654;619514;477668;52.7;40.6
34;2021-07-08;4302;8877;623816;486545;53.0;41.4
34;2021-07-09;4010;9347;627826;495892;53.4;42.2
34;2021-07-10;2140;5717;629966;501609;53.6;42.6
34;2021-07-11;924;2576;630890;504185;53.6;42.9
34;2021-07-12;2929;8970;633819;513155;53.9;43.6
34;2021-07-13;4656;10048;638475;523203;54.3;44.5
34;2021-07-14;784;357;639259;523560;54.4;44.5
34;2021-07-15;5910;10400;645169;533960;54.9;45.4
34;2021-07-16;5859;10742;651028;544702;55.4;46.3
34;2021-07-17;4500;4421;655528;549123;55.7;46.7
34;2021-07-18;235;199;655763;549322;55.8;46.7
34;2021-07-19;5119;8336;660882;557658;56.2;47.4
34;2021-07-20;6897;8392;667779;566050;56.8;48.1
34;2021-07-21;7649;7832;675428;573882;57.4;48.8
34;2021-07-22;7443;8181;682871;582063;58.1;49.5
34;2021-07-23;7843;8167;690714;590230;58.7;50.2
34;2021-07-24;6151;3062;696865;593292;59.2;50.4
34;2021-07-25;3210;548;700075;593840;59.5;50.5
34;2021-07-26;6238;6435;706313;600275;60.1;51.0
34;2021-07-27;8755;6058;715068;606333;60.8;51.6
34;2021-07-28;9711;5934;724779;612267;61.6;52.1
34;2021-07-29;11327;6058;736106;618325;62.6;52.6
34;2021-07-30;9849;6547;745955;624872;63.4;53.1
34;2021-07-31;6445;2198;752400;627070;64.0;53.3
34;2021-08-01;3317;621;755717;627691;64.3;53.4
34;2021-08-02;7361;5072;763078;632763;64.9;53.8
34;2021-08-03;8144;5403;771222;638166;65.6;54.3
34;2021-08-04;8446;4571;779668;642737;66.3;54.6
34;2021-08-05;7137;5033;786805;647770;66.9;55.1
34;2021-08-06;6224;5236;793029;653006;67.4;55.5
34;2021-08-07;3110;2437;796139;655443;67.7;55.7
34;2021-08-08;203;204;796342;655647;67.7;55.7
34;2021-08-09;4781;6180;801123;661827;68.1;56.3
34;2021-08-10;5397;6486;806520;668313;68.6;56.8
34;2021-08-11;4832;6545;811352;674858;69.0;57.4
34;2021-08-12;4576;6202;815928;681060;69.4;57.9
34;2021-08-13;4111;5739;820039;686799;69.7;58.4
34;2021-08-14;1796;2881;821835;689680;69.9;58.6
34;2021-08-15;212;194;822047;689874;69.9;58.7
34;2021-08-16;2905;7552;824952;697426;70.1;59.3
34;2021-08-17;3596;8282;828548;705708;70.4;60.0
34;2021-08-18;3208;7564;831756;713272;70.7;60.6
34;2021-08-19;3273;7789;835029;721061;71.0;61.3
34;2021-08-20;2725;7722;837754;728783;71.2;62.0
34;2021-08-21;1415;3578;839169;732361;71.3;62.3
34;2021-08-22;163;308;839332;732669;71.4;62.3
34;2021-08-23;2330;8656;841662;741325;71.6;63.0
34;2021-08-24;2730;8962;844392;750287;71.8;63.8
34;2021-08-25;2346;8543;846738;758830;72.0;64.5
34;2021-08-26;2608;7890;849346;766720;72.2;65.2
34;2021-08-27;2198;7573;851544;774293;72.4;65.8
34;2021-08-28;1120;3562;852664;777855;72.5;66.1
34;2021-08-29;368;1357;853032;779212;72.5;66.3
34;2021-08-30;2054;6769;855086;785981;72.7;66.8
34;2021-08-31;2123;6586;857209;792567;72.9;67.4
34;2021-09-01;2063;5883;859272;798450;73.1;67.9
34;2021-09-02;1669;4091;860941;802541;73.2;68.2
34;2021-09-03;1777;4926;862718;807467;73.4;68.7
34;2021-09-04;1370;3090;864088;810557;73.5;68.9
34;2021-09-05;142;220;864230;810777;73.5;68.9
34;2021-09-06;1280;3172;865510;813949;73.6;69.2
34;2021-09-07;1386;3294;866896;817243;73.7;69.5
34;2021-09-08;1629;4074;868525;821317;73.8;69.8
34;2021-09-09;1196;3107;869721;824424;73.9;70.1
34;2021-09-10;1538;3302;871259;827726;74.1;70.4
34;2021-09-11;1285;1847;872544;829573;74.2;70.5
34;2021-09-12;92;81;872636;829654;74.2;70.5
34;2021-09-13;1008;2529;873644;832183;74.3;70.8
34;2021-09-14;1240;2272;874884;834455;74.4;70.9
34;2021-09-15;1496;2955;876380;837410;74.5;71.2
34;2021-09-16;893;1883;877273;839293;74.6;71.4
34;2021-09-17;1127;2415;878400;841708;74.7;71.6
34;2021-09-18;792;1763;879192;843471;74.8;71.7
34;2021-09-19;37;59;879229;843530;74.8;71.7
34;2021-09-20;619;1913;879848;845443;74.8;71.9
34;2021-09-21;612;1780;880460;847223;74.9;72.0
34;2021-09-22;841;2531;881301;849754;74.9;72.2
34;2021-09-23;674;1656;881975;851410;75.0;72.4
34;2021-09-24;847;2224;882822;853634;75.1;72.6
34;2021-09-25;496;1556;883318;855190;75.1;72.7
34;2021-09-26;51;142;883369;855332;75.1;72.7
34;2021-09-27;672;1494;884041;856826;75.2;72.9
34;2021-09-28;658;1130;884699;857956;75.2;72.9
34;2021-09-29;857;1814;885556;859770;75.3;73.1
34;2021-09-30;610;1353;886166;861123;75.3;73.2
34;2021-10-01;720;1503;886886;862626;75.4;73.3
34;2021-10-02;653;1391;887539;864017;75.5;73.5
34;2021-10-03;60;162;887599;864179;75.5;73.5
34;2021-10-04;597;1084;888196;865263;75.5;73.6
34;2021-10-05;531;1037;888727;866300;75.6;73.7
34;2021-10-06;842;1711;889569;868011;75.6;73.8
34;2021-10-07;549;1000;890118;869011;75.7;73.9
34;2021-10-08;849;1400;890967;870411;75.8;74.0
34;2021-10-09;581;1012;891548;871423;75.8;74.1
34;2021-10-10;66;74;891614;871497;75.8;74.1
34;2021-10-11;696;1065;892310;872562;75.9;74.2
34;2021-10-12;494;689;892804;873251;75.9;74.2
34;2021-10-13;619;1101;893423;874352;76.0;74.3
34;2021-10-14;495;634;893918;874986;76.0;74.4
34;2021-10-15;835;1226;894753;876212;76.1;74.5
34;2021-10-16;479;682;895232;876894;76.1;74.6
34;2021-10-17;81;48;895313;876942;76.1;74.6
34;2021-10-18;636;856;895949;877798;76.2;74.6
34;2021-10-19;459;733;896408;878531;76.2;74.7
35;2020-12-27;0;0;0;0;0.0;0.0
35;2020-12-28;0;0;0;0;0.0;0.0
35;2020-12-29;2;0;2;0;0.0;0.0
35;2020-12-30;0;0;2;0;0.0;0.0
35;2020-12-31;3;0;5;0;0.0;0.0
35;2021-01-01;3;0;8;0;0.0;0.0
35;2021-01-02;1;0;9;0;0.0;0.0
35;2021-01-03;0;0;9;0;0.0;0.0
35;2021-01-04;11;0;20;0;0.0;0.0
35;2021-01-05;110;0;130;0;0.0;0.0
35;2021-01-06;175;0;305;0;0.0;0.0
35;2021-01-07;440;1;745;1;0.1;0.0
35;2021-01-08;513;1;1258;2;0.1;0.0
35;2021-01-09;31;0;1289;2;0.1;0.0
35;2021-01-10;2;0;1291;2;0.1;0.0
35;2021-01-11;538;0;1829;2;0.2;0.0
35;2021-01-12;886;3;2715;5;0.3;0.0
35;2021-01-13;971;4;3686;9;0.3;0.0
35;2021-01-14;1261;18;4947;27;0.5;0.0
35;2021-01-15;732;3;5679;30;0.5;0.0
35;2021-01-16;189;3;5868;33;0.5;0.0
35;2021-01-17;44;0;5912;33;0.5;0.0
35;2021-01-18;1223;2;7135;35;0.7;0.0
35;2021-01-19;5408;18;12543;53;1.2;0.0
35;2021-01-20;3239;10;15782;63;1.5;0.0
35;2021-01-21;3647;17;19429;80;1.8;0.0
35;2021-01-22;2087;10;21516;90;2.0;0.0
35;2021-01-23;421;1;21937;91;2.0;0.0
35;2021-01-24;51;0;21988;91;2.0;0.0
35;2021-01-25;918;17;22906;108;2.1;0.0
35;2021-01-26;1131;142;24037;250;2.2;0.0
35;2021-01-27;1029;125;25066;375;2.3;0.0
35;2021-01-28;917;298;25983;673;2.4;0.1
35;2021-01-29;725;290;26708;963;2.5;0.1
35;2021-01-30;140;19;26848;982;2.5;0.1
35;2021-01-31;0;0;26848;982;2.5;0.1
35;2021-02-01;673;333;27521;1315;2.5;0.1
35;2021-02-02;725;483;28246;1798;2.6;0.2
35;2021-02-03;662;506;28908;2304;2.7;0.2
35;2021-02-04;590;657;29498;2961;2.7;0.3
35;2021-02-05;624;563;30122;3524;2.8;0.3
35;2021-02-06;175;9;30297;3533;2.8;0.3
35;2021-02-07;1;0;30298;3533;2.8;0.3
35;2021-02-08;446;653;30744;4186;2.8;0.4
35;2021-02-09;1715;3560;32459;7746;3.0;0.7
35;2021-02-10;1370;2728;33829;10474;3.1;1.0
35;2021-02-11;1945;3236;35774;13710;3.3;1.3
35;2021-02-12;1663;1730;37437;15440;3.5;1.4
35;2021-02-13;58;254;37495;15694;3.5;1.5
35;2021-02-14;8;69;37503;15763;3.5;1.5
35;2021-02-15;771;1099;38274;16862;3.5;1.6
35;2021-02-16;920;1020;39194;17882;3.6;1.7
35;2021-02-17;895;1087;40089;18969;3.7;1.8
35;2021-02-18;1020;996;41109;19965;3.8;1.8
35;2021-02-19;1013;968;42122;20933;3.9;1.9
35;2021-02-20;143;49;42265;20982;3.9;1.9
35;2021-02-21;5;0;42270;20982;3.9;1.9
35;2021-02-22;776;832;43046;21814;4.0;2.0
35;2021-02-23;1287;868;44333;22682;4.1;2.1
35;2021-02-24;1405;815;45738;23497;4.2;2.2
35;2021-02-25;2249;790;47987;24287;4.4;2.2
35;2021-02-26;2599;735;50586;25022;4.7;2.3
35;2021-02-27;869;104;51455;25126;4.8;2.3
35;2021-02-28;10;1;51465;25127;4.8;2.3
35;2021-03-01;959;691;52424;25818;4.8;2.4
35;2021-03-02;1635;1995;54059;27813;5.0;2.6
35;2021-03-03;1914;972;55973;28785;5.2;2.7
35;2021-03-04;2916;1418;58889;30203;5.4;2.8
35;2021-03-05;3715;1352;62604;31555;5.8;2.9
35;2021-03-06;1338;87;63942;31642;5.9;2.9
35;2021-03-07;1;40;63943;31682;5.9;2.9
35;2021-03-08;1475;589;65418;32271;6.0;3.0
35;2021-03-09;3238;621;68656;32892;6.3;3.0
35;2021-03-10;2902;566;71558;33458;6.6;3.1
35;2021-03-11;4199;727;75757;34185;7.0;3.2
35;2021-03-12;6049;572;81806;34757;7.6;3.2
35;2021-03-13;2428;136;84234;34893;7.8;3.2
35;2021-03-14;18;25;84252;34918;7.8;3.2
35;2021-03-15;1966;676;86218;35594;8.0;3.3
35;2021-03-16;2505;734;88723;36328;8.2;3.4
35;2021-03-17;2396;602;91119;36930;8.4;3.4
35;2021-03-18;2334;599;93453;37529;8.6;3.5
35;2021-03-19;3548;514;97001;38043;9.0;3.5
35;2021-03-20;1543;114;98544;38157;9.1;3.5
35;2021-03-21;38;1;98582;38158;9.1;3.5
35;2021-03-22;1750;844;100332;39002;9.3;3.6
35;2021-03-23;3626;1186;103958;40188;9.6;3.7
35;2021-03-24;3730;994;107688;41182;10.0;3.8
35;2021-03-25;5327;1012;113015;42194;10.4;3.9
35;2021-03-26;5853;824;118868;43018;11.0;4.0
35;2021-03-27;1416;211;120284;43229;11.1;4.0
35;2021-03-28;4;0;120288;43229;11.1;4.0
35;2021-03-29;2778;912;123066;44141;11.4;4.1
35;2021-03-30;4292;1338;127358;45479;11.8;4.2
35;2021-03-31;3471;1349;130829;46828;12.1;4.3
35;2021-04-01;4250;1245;135079;48073;12.5;4.4
35;2021-04-02;4861;1214;139940;49287;12.9;4.6
35;2021-04-03;763;216;140703;49503;13.0;4.6
35;2021-04-04;6;0;140709;49503;13.0;4.6
35;2021-04-05;24;2;140733;49505;13.0;4.6
35;2021-04-06;3279;2032;144012;51537;13.3;4.8
35;2021-04-07;3967;1849;147979;53386;13.7;4.9
35;2021-04-08;5803;1596;153782;54982;14.2;5.1
35;2021-04-09;7431;1430;161213;56412;14.9;5.2
35;2021-04-10;1860;255;163073;56667;15.1;5.2
35;2021-04-11;35;23;163108;56690;15.1;5.2
35;2021-04-12;5137;1603;168245;58293;15.5;5.4
35;2021-04-13;7625;2793;175870;61086;16.3;5.6
35;2021-04-14;6315;2305;182185;63391;16.8;5.9
35;2021-04-15;7564;2189;189749;65580;17.5;6.1
35;2021-04-16;8082;1767;197831;67347;18.3;6.2
35;2021-04-17;1571;223;199402;67570;18.4;6.2
35;2021-04-18;10;4;199412;67574;18.4;6.2
35;2021-04-19;4819;1674;204231;69248;18.9;6.4
35;2021-04-20;5165;2649;209396;71897;19.4;6.6
35;2021-04-21;5134;2217;214530;74114;19.8;6.8
35;2021-04-22;6429;2335;220959;76449;20.4;7.1
35;2021-04-23;6821;2374;227780;78823;21.1;7.3
35;2021-04-24;1132;265;228912;79088;21.2;7.3
35;2021-04-25;8;16;228920;79104;21.2;7.3
35;2021-04-26;5098;2162;234018;81266;21.6;7.5
35;2021-04-27;6090;3213;240108;84479;22.2;7.8
35;2021-04-28;6173;2572;246281;87051;22.8;8.0
35;2021-04-29;7117;2769;253398;89820;23.4;8.3
35;2021-04-30;7564;2552;260962;92372;24.1;8.5
35;2021-05-01;618;239;261580;92611;24.2;8.6
35;2021-05-02;15;21;261595;92632;24.2;8.6
35;2021-05-03;5307;2336;266902;94968;24.7;8.8
35;2021-05-04;5067;5344;271969;100312;25.1;9.3
35;2021-05-05;4881;4451;276850;104763;25.6;9.7
35;2021-05-06;6176;5281;283026;110044;26.2;10.2
35;2021-05-07;5620;5251;288646;115295;26.7;10.7
35;2021-05-08;1719;136;290365;115431;26.8;10.7
35;2021-05-09;698;75;291063;115506;26.9;10.7
35;2021-05-10;3719;4956;294782;120462;27.2;11.1
35;2021-05-11;4773;5810;299555;126272;27.7;11.7
35;2021-05-12;5292;5501;304847;131773;28.2;12.2
35;2021-05-13;2699;1424;307546;133197;28.4;12.3
35;2021-05-14;5460;4334;313006;137531;28.9;12.7
35;2021-05-15;2929;718;315935;138249;29.2;12.8
35;2021-05-16;997;61;316932;138310;29.3;12.8
35;2021-05-17;4474;3881;321406;142191;29.7;13.1
35;2021-05-18;5838;4328;327244;146519;30.2;13.5
35;2021-05-19;5866;3633;333110;150152;30.8;13.9
35;2021-05-20;6448;4009;339558;154161;31.4;14.2
35;2021-05-21;6141;4771;345699;158932;31.9;14.7
35;2021-05-22;2118;739;347817;159671;32.1;14.8
35;2021-05-23;688;46;348505;159717;32.2;14.8
35;2021-05-24;3206;1298;351711;161015;32.5;14.9
35;2021-05-25;5541;4278;357252;165293;33.0;15.3
35;2021-05-26;5721;4166;362973;169459;33.5;15.7
35;2021-05-27;6527;4778;369500;174237;34.1;16.1
35;2021-05-28;6330;5574;375830;179811;34.7;16.6
35;2021-05-29;2873;1147;378703;180958;35.0;16.7
35;2021-05-30;878;39;379581;180997;35.1;16.7
35;2021-05-31;6309;4393;385890;185390;35.7;17.1
35;2021-06-01;7365;5124;393255;190514;36.3;17.6
35;2021-06-02;7219;3798;400474;194312;37.0;18.0
35;2021-06-03;8156;4999;408630;199311;37.8;18.4
35;2021-06-04;7274;7468;415904;206779;38.4;19.1
35;2021-06-05;4138;1588;420042;208367;38.8;19.3
35;2021-06-06;3053;147;423095;208514;39.1;19.3
35;2021-06-07;5781;5777;428876;214291;39.6;19.8
35;2021-06-08;7603;5956;436479;220247;40.3;20.4
35;2021-06-09;8459;4817;444938;225064;41.1;20.8
35;2021-06-10;9345;4751;454283;229815;42.0;21.2
35;2021-06-11;8632;7472;462915;237287;42.8;21.9
35;2021-06-12;4684;1209;467599;238496;43.2;22.0
35;2021-06-13;3386;227;470985;238723;43.5;22.1
35;2021-06-14;6231;6519;477216;245242;44.1;22.7
35;2021-06-15;7504;6966;484720;252208;44.8;23.3
35;2021-06-16;8323;5627;493043;257835;45.6;23.8
35;2021-06-17;8897;5912;501940;263747;46.4;24.4
35;2021-06-18;8718;8098;510658;271845;47.2;25.1
35;2021-06-19;1504;2510;512162;274355;47.3;25.4
35;2021-06-20;2953;884;515115;275239;47.6;25.4
35;2021-06-21;5930;6380;521045;281619;48.2;26.0
35;2021-06-22;6841;7501;527886;289120;48.8;26.7
35;2021-06-23;7254;6144;535140;295264;49.5;27.3
35;2021-06-24;8367;5924;543507;301188;50.2;27.8
35;2021-06-25;6627;8481;550134;309669;50.8;28.6
35;2021-06-26;1106;3077;551240;312746;50.9;28.9
35;2021-06-27;2635;1031;553875;313777;51.2;29.0
35;2021-06-28;4298;7761;558173;321538;51.6;29.7
35;2021-06-29;5090;7974;563263;329512;52.1;30.5
35;2021-06-30;5602;7898;568865;337410;52.6;31.2
35;2021-07-01;6589;7551;575454;344961;53.2;31.9
35;2021-07-02;5333;9862;580787;354823;53.7;32.8
35;2021-07-03;1083;2840;581870;357663;53.8;33.1
35;2021-07-04;2149;1554;584019;359217;54.0;33.2
35;2021-07-05;3735;8209;587754;367426;54.3;34.0
35;2021-07-06;4787;9478;592541;376904;54.8;34.8
35;2021-07-07;5060;8323;597601;385227;55.2;35.6
35;2021-07-08;5386;8490;602987;393717;55.7;36.4
35;2021-07-09;3907;11548;606894;405265;56.1;37.5
35;2021-07-10;892;3148;607786;408413;56.2;37.7
35;2021-07-11;1300;2354;609086;410767;56.3;38.0
35;2021-07-12;3121;9145;612207;419912;56.6;38.8
35;2021-07-13;3981;10749;616188;430661;56.9;39.8
35;2021-07-14;2154;4452;618342;435113;57.1;40.2
35;2021-07-15;4294;10181;622636;445294;57.5;41.2
35;2021-07-16;4802;11009;627438;456303;58.0;42.2
35;2021-07-17;1988;4064;629426;460367;58.2;42.5
35;2021-07-18;846;2572;630272;462939;58.2;42.8
35;2021-07-19;3251;8974;633523;471913;58.5;43.6
35;2021-07-20;4242;10592;637765;482505;58.9;44.6
35;2021-07-21;4372;9388;642137;491893;59.3;45.5
35;2021-07-22;4853;9657;646990;501550;59.8;46.4
35;2021-07-23;4564;11012;651554;512562;60.2;47.4
35;2021-07-24;1587;4267;653141;516829;60.4;47.8
35;2021-07-25;815;2846;653956;519675;60.4;48.0
35;2021-07-26;3893;8737;657849;528412;60.8;48.8
35;2021-07-27;5281;9659;663130;538071;61.3;49.7
35;2021-07-28;5319;8673;668449;546744;61.8;50.5
35;2021-07-29;6113;8343;674562;555087;62.3;51.3
35;2021-07-30;5904;9086;680466;564173;62.9;52.1
35;2021-07-31;2322;3656;682788;567829;63.1;52.5
35;2021-08-01;1526;2415;684314;570244;63.2;52.7
35;2021-08-02;4757;6949;689071;577193;63.7;53.3
35;2021-08-03;6712;7582;695783;584775;64.3;54.0
35;2021-08-04;6714;6594;702497;591369;64.9;54.7
35;2021-08-05;6687;6985;709184;598354;65.5;55.3
35;2021-08-06;6067;7323;715251;605677;66.1;56.0
35;2021-08-07;2109;3151;717360;608828;66.3;56.3
35;2021-08-08;1523;2257;718883;611085;66.4;56.5
35;2021-08-09;4619;5535;723502;616620;66.9;57.0
35;2021-08-10;6566;6381;730068;623001;67.5;57.6
35;2021-08-11;6474;5865;736542;628866;68.1;58.1
35;2021-08-12;7013;5586;743555;634452;68.7;58.6
35;2021-08-13;6698;5068;750253;639520;69.3;59.1
35;2021-08-14;3049;1985;753302;641505;69.6;59.3
35;2021-08-15;2470;1261;755772;642766;69.8;59.4
35;2021-08-16;4871;5296;760643;648062;70.3;59.9
35;2021-08-17;6408;6082;767051;654144;70.9;60.5
35;2021-08-18;6487;5633;773538;659777;71.5;61.0
35;2021-08-19;6303;5765;779841;665542;72.1;61.5
35;2021-08-20;5132;6350;784973;671892;72.5;62.1
35;2021-08-21;2384;2634;787357;674526;72.8;62.3
35;2021-08-22;1765;1798;789122;676324;72.9;62.5
35;2021-08-23;3105;6014;792227;682338;73.2;63.1
35;2021-08-24;3503;7221;795730;689559;73.5;63.7
35;2021-08-25;3314;6616;799044;696175;73.8;64.3
35;2021-08-26;2641;6895;801685;703070;74.1;65.0
35;2021-08-27;2784;7261;804469;710331;74.3;65.6
35;2021-08-28;1179;2955;805648;713286;74.5;65.9
35;2021-08-29;517;1760;806165;715046;74.5;66.1
35;2021-08-30;1978;5390;808143;720436;74.7;66.6
35;2021-08-31;2389;6360;810532;726796;74.9;67.2
35;2021-09-01;1926;5760;812458;732556;75.1;67.7
35;2021-09-02;1845;5752;814303;738308;75.3;68.2
35;2021-09-03;2031;6631;816334;744939;75.4;68.8
35;2021-09-04;1134;4009;817468;748948;75.5;69.2
35;2021-09-05;517;2007;817985;750955;75.6;69.4
35;2021-09-06;1140;4593;819125;755548;75.7;69.8
35;2021-09-07;1326;4870;820451;760418;75.8;70.3
35;2021-09-08;1336;5818;821787;766236;75.9;70.8
35;2021-09-09;1263;4845;823050;771081;76.1;71.3
35;2021-09-10;1588;5976;824638;777057;76.2;71.8
35;2021-09-11;625;3798;825263;780855;76.3;72.2
35;2021-09-12;285;2324;825548;783179;76.3;72.4
35;2021-09-13;1328;3835;826876;787014;76.4;72.7
35;2021-09-14;1387;3394;828263;790408;76.5;73.0
35;2021-09-15;1236;4597;829499;795005;76.7;73.5
35;2021-09-16;1133;2854;830632;797859;76.8;73.7
35;2021-09-17;1280;3898;831912;801757;76.9;74.1
35;2021-09-18;518;2877;832430;804634;76.9;74.4
35;2021-09-19;170;1020;832600;805654;76.9;74.5
35;2021-09-20;1158;2649;833758;808303;77.1;74.7
35;2021-09-21;669;1925;834427;810228;77.1;74.9
35;2021-09-22;861;3625;835288;813853;77.2;75.2
35;2021-09-23;570;1532;835858;815385;77.2;75.4
35;2021-09-24;983;3041;836841;818426;77.3;75.6
35;2021-09-25;426;1958;837267;820384;77.4;75.8
35;2021-09-26;16;164;837283;820548;77.4;75.8
35;2021-09-27;519;1626;837802;822174;77.4;76.0
35;2021-09-28;464;1186;838266;823360;77.5;76.1
35;2021-09-29;610;1984;838876;825344;77.5;76.3
35;2021-09-30;353;835;839229;826179;77.6;76.4
35;2021-10-01;810;2166;840039;828345;77.6;76.6
35;2021-10-02;359;1135;840398;829480;77.7;76.7
35;2021-10-03;2;12;840400;829492;77.7;76.7
35;2021-10-04;514;1010;840914;830502;77.7;76.8
35;2021-10-05;433;984;841347;831486;77.8;76.8
35;2021-10-06;604;1332;841951;832818;77.8;77.0
35;2021-10-07;379;980;842330;833798;77.8;77.1
35;2021-10-08;699;2074;843029;835872;77.9;77.2
35;2021-10-09;373;882;843402;836754;77.9;77.3
35;2021-10-10;0;4;843402;836758;77.9;77.3
35;2021-10-11;428;919;843830;837677;78.0;77.4
35;2021-10-12;407;736;844237;838413;78.0;77.5
35;2021-10-13;513;831;844750;839244;78.1;77.6
35;2021-10-14;357;649;845107;839893;78.1;77.6
35;2021-10-15;703;1572;845810;841465;78.2;77.8
35;2021-10-16;366;649;846176;842114;78.2;77.8
35;2021-10-17;3;3;846179;842117;78.2;77.8
35;2021-10-18;420;741;846599;842858;78.2;77.9
35;2021-10-19;359;716;846958;843574;78.3;78.0
36;2020-12-27;0;0;0;0;0.0;0.0
36;2020-12-28;0;0;0;0;0.0;0.0
36;2020-12-29;0;0;0;0;0.0;0.0
36;2020-12-30;0;0;0;0;0.0;0.0
36;2020-12-31;0;0;0;0;0.0;0.0
36;2021-01-01;0;0;0;0;0.0;0.0
36;2021-01-02;0;0;0;0;0.0;0.0
36;2021-01-03;0;0;0;0;0.0;0.0
36;2021-01-04;2;0;2;0;0.0;0.0
36;2021-01-05;0;0;2;0;0.0;0.0
36;2021-01-06;24;0;26;0;0.0;0.0
36;2021-01-07;51;0;77;0;0.0;0.0
36;2021-01-08;111;0;188;0;0.1;0.0
36;2021-01-09;84;0;272;0;0.1;0.0
36;2021-01-10;142;0;414;0;0.2;0.0
36;2021-01-11;240;1;654;1;0.3;0.0
36;2021-01-12;282;0;936;1;0.4;0.0
36;2021-01-13;198;1;1134;2;0.5;0.0
36;2021-01-14;506;4;1640;6;0.8;0.0
36;2021-01-15;179;1;1819;7;0.8;0.0
36;2021-01-16;24;1;1843;8;0.8;0.0
36;2021-01-17;19;1;1862;9;0.9;0.0
36;2021-01-18;611;5;2473;14;1.1;0.0
36;2021-01-19;1173;2;3646;16;1.7;0.0
36;2021-01-20;1102;4;4748;20;2.2;0.0
36;2021-01-21;721;1;5469;21;2.5;0.0
36;2021-01-22;858;2;6327;23;2.9;0.0
36;2021-01-23;294;0;6621;23;3.0;0.0
36;2021-01-24;185;1;6806;24;3.1;0.0
36;2021-01-25;640;5;7446;29;3.4;0.0
36;2021-01-26;609;1;8055;30;3.7;0.0
36;2021-01-27;853;20;8908;50;4.1;0.0
36;2021-01-28;478;44;9386;94;4.3;0.0
36;2021-01-29;573;96;9959;190;4.6;0.1
36;2021-01-30;288;71;10247;261;4.7;0.1
36;2021-01-31;115;130;10362;391;4.8;0.2
36;2021-02-01;379;100;10741;491;4.9;0.2
36;2021-02-02;410;175;11151;666;5.1;0.3
36;2021-02-03;473;264;11624;930;5.4;0.4
36;2021-02-04;275;272;11899;1202;5.5;0.6
36;2021-02-05;301;164;12200;1366;5.6;0.6
36;2021-02-06;1;0;12201;1366;5.6;0.6
36;2021-02-07;1;0;12202;1366;5.6;0.6
36;2021-02-08;280;258;12482;1624;5.7;0.7
36;2021-02-09;328;605;12810;2229;5.9;1.0
36;2021-02-10;491;656;13301;2885;6.1;1.3
36;2021-02-11;384;593;13685;3478;6.3;1.6
36;2021-02-12;303;459;13988;3937;6.4;1.8
36;2021-02-13;126;80;14114;4017;6.5;1.8
36;2021-02-14;22;43;14136;4060;6.5;1.9
36;2021-02-15;42;575;14178;4635;6.5;2.1
36;2021-02-16;107;412;14285;5047;6.6;2.3
36;2021-02-17;117;622;14402;5669;6.6;2.6
36;2021-02-18;161;616;14563;6285;6.7;2.9
36;2021-02-19;181;540;14744;6825;6.8;3.1
36;2021-02-20;86;239;14830;7064;6.8;3.3
36;2021-02-21;87;156;14917;7220;6.9;3.3
36;2021-02-22;162;512;15079;7732;6.9;3.6
36;2021-02-23;62;574;15141;8306;7.0;3.8
36;2021-02-24;110;680;15251;8986;7.0;4.1
36;2021-02-25;251;281;15502;9267;7.1;4.3
36;2021-02-26;339;468;15841;9735;7.3;4.5
36;2021-02-27;73;277;15914;10012;7.3;4.6
36;2021-02-28;13;97;15927;10109;7.3;4.7
36;2021-03-01;218;341;16145;10450;7.4;4.8
36;2021-03-02;352;367;16497;10817;7.6;5.0
36;2021-03-03;394;532;16891;11349;7.8;5.2
36;2021-03-04;663;358;17554;11707;8.1;5.4
36;2021-03-05;800;298;18354;12005;8.5;5.5
36;2021-03-06;410;18;18764;12023;8.6;5.5
36;2021-03-07;339;9;19103;12032;8.8;5.5
36;2021-03-08;251;316;19354;12348;8.9;5.7
36;2021-03-09;449;271;19803;12619;9.1;5.8
36;2021-03-10;724;409;20527;13028;9.5;6.0
36;2021-03-11;840;246;21367;13274;9.8;6.1
36;2021-03-12;1446;300;22813;13574;10.5;6.3
36;2021-03-13;576;129;23389;13703;10.8;6.3
36;2021-03-14;113;1;23502;13704;10.8;6.3
36;2021-03-15;648;159;24150;13863;11.1;6.4
36;2021-03-16;446;67;24596;13930;11.3;6.4
36;2021-03-17;768;92;25364;14022;11.7;6.5
36;2021-03-18;414;72;25778;14094;11.9;6.5
36;2021-03-19;739;40;26517;14134;12.2;6.5
36;2021-03-20;450;27;26967;14161;12.4;6.5
36;2021-03-21;0;0;26967;14161;12.4;6.5
36;2021-03-22;497;60;27464;14221;12.6;6.5
36;2021-03-23;777;60;28241;14281;13.0;6.6
36;2021-03-24;1089;78;29330;14359;13.5;6.6
36;2021-03-25;1339;90;30669;14449;14.1;6.7
36;2021-03-26;1418;158;32087;14607;14.8;6.7
36;2021-03-27;475;43;32562;14650;15.0;6.7
36;2021-03-28;68;57;32630;14707;15.0;6.8
36;2021-03-29;462;187;33092;14894;15.2;6.9
36;2021-03-30;583;263;33675;15157;15.5;7.0
36;2021-03-31;1262;172;34937;15329;16.1;7.1
36;2021-04-01;1086;432;36023;15761;16.6;7.3
36;2021-04-02;966;144;36989;15905;17.0;7.3
36;2021-04-03;282;195;37271;16100;17.2;7.4
36;2021-04-04;42;2;37313;16102;17.2;7.4
36;2021-04-05;15;46;37328;16148;17.2;7.4
36;2021-04-06;820;362;38148;16510;17.6;7.6
36;2021-04-07;1072;545;39220;17055;18.1;7.9
36;2021-04-08;1347;481;40567;17536;18.7;8.1
36;2021-04-09;1936;406;42503;17942;19.6;8.3
36;2021-04-10;591;243;43094;18185;19.8;8.4
36;2021-04-11;256;90;43350;18275;20.0;8.4
36;2021-04-12;848;561;44198;18836;20.4;8.7
36;2021-04-13;1140;519;45338;19355;20.9;8.9
36;2021-04-14;1582;866;46920;20221;21.6;9.3
36;2021-04-15;1653;474;48573;20695;22.4;9.5
36;2021-04-16;1486;470;50059;21165;23.1;9.7
36;2021-04-17;893;251;50952;21416;23.5;9.9
36;2021-04-18;383;7;51335;21423;23.6;9.9
36;2021-04-19;874;444;52209;21867;24.0;10.1
36;2021-04-20;1145;524;53354;22391;24.6;10.3
36;2021-04-21;1240;881;54594;23272;25.1;10.7
36;2021-04-22;1593;873;56187;24145;25.9;11.1
36;2021-04-23;1329;618;57516;24763;26.5;11.4
36;2021-04-24;677;380;58193;25143;26.8;11.6
36;2021-04-25;413;95;58606;25238;27.0;11.6
36;2021-04-26;1134;450;59740;25688;27.5;11.8
36;2021-04-27;1278;553;61018;26241;28.1;12.1
36;2021-04-28;1488;1066;62506;27307;28.8;12.6
36;2021-04-29;2016;715;64522;28022;29.7;12.9
36;2021-04-30;1553;458;66075;28480;30.4;13.1
36;2021-05-01;724;64;66799;28544;30.8;13.1
36;2021-05-02;498;64;67297;28608;31.0;13.2
36;2021-05-03;1293;320;68590;28928;31.6;13.3
36;2021-05-04;780;805;69370;29733;31.9;13.7
36;2021-05-05;1282;1306;70652;31039;32.5;14.3
36;2021-05-06;2137;798;72789;31837;33.5;14.7
36;2021-05-07;1469;771;74258;32608;34.2;15.0
36;2021-05-08;306;105;74564;32713;34.3;15.1
36;2021-05-09;174;343;74738;33056;34.4;15.2
36;2021-05-10;1216;818;75954;33874;35.0;15.6
36;2021-05-11;1725;1251;77679;35125;35.8;16.2
36;2021-05-12;1827;1487;79506;36612;36.6;16.9
36;2021-05-13;548;304;80054;36916;36.9;17.0
36;2021-05-14;701;1037;80755;37953;37.2;17.5
36;2021-05-15;635;592;81390;38545;37.5;17.8
36;2021-05-16;337;377;81727;38922;37.6;17.9
36;2021-05-17;615;944;82342;39866;37.9;18.4
36;2021-05-18;874;937;83216;40803;38.3;18.8
36;2021-05-19;1333;845;84549;41648;38.9;19.2
36;2021-05-20;1611;1209;86160;42857;39.7;19.7
36;2021-05-21;1106;1070;87266;43927;40.2;20.2
36;2021-05-22;678;342;87944;44269;40.5;20.4
36;2021-05-23;428;297;88372;44566;40.7;20.5
36;2021-05-24;506;469;88878;45035;40.9;20.7
36;2021-05-25;1045;686;89923;45721;41.4;21.1
36;2021-05-26;1472;1165;91395;46886;42.1;21.6
36;2021-05-27;1398;977;92793;47863;42.7;22.0
36;2021-05-28;921;1480;93714;49343;43.2;22.7
36;2021-05-29;700;507;94414;49850;43.5;23.0
36;2021-05-30;111;572;94525;50422;43.5;23.2
36;2021-05-31;1137;764;95662;51186;44.1;23.6
36;2021-06-01;1413;830;97075;52016;44.7;24.0
36;2021-06-02;2062;614;99137;52630;45.7;24.2
36;2021-06-03;1902;1201;101039;53831;46.5;24.8
36;2021-06-04;1772;1045;102811;54876;47.3;25.3
36;2021-06-05;693;658;103504;55534;47.7;25.6
36;2021-06-06;336;272;103840;55806;47.8;25.7
36;2021-06-07;983;808;104823;56614;48.3;26.1
36;2021-06-08;957;981;105780;57595;48.7;26.5
36;2021-06-09;1675;1071;107455;58666;49.5;27.0
36;2021-06-10;1530;1382;108985;60048;50.2;27.7
36;2021-06-11;1288;1499;110273;61547;50.8;28.3
36;2021-06-12;921;784;111194;62331;51.2;28.7
36;2021-06-13;343;269;111537;62600;51.4;28.8
36;2021-06-14;605;1269;112142;63869;51.6;29.4
36;2021-06-15;733;1215;112875;65084;52.0;30.0
36;2021-06-16;903;1519;113778;66603;52.4;30.7
36;2021-06-17;749;1904;114527;68507;52.7;31.5
36;2021-06-18;706;1879;115233;70386;53.1;32.4
36;2021-06-19;295;395;115528;70781;53.2;32.6
36;2021-06-20;235;327;115763;71108;53.3;32.7
36;2021-06-21;692;1449;116455;72557;53.6;33.4
36;2021-06-22;841;1552;117296;74109;54.0;34.1
36;2021-06-23;774;1791;118070;75900;54.4;35.0
36;2021-06-24;855;1522;118925;77422;54.8;35.7
36;2021-06-25;942;1221;119867;78643;55.2;36.2
36;2021-06-26;324;602;120191;79245;55.4;36.5
36;2021-06-27;105;267;120296;79512;55.4;36.6
36;2021-06-28;696;923;120992;80435;55.7;37.0
36;2021-06-29;688;1459;121680;81894;56.0;37.7
36;2021-06-30;836;2149;122516;84043;56.4;38.7
36;2021-07-01;353;1081;122869;85124;56.6;39.2
36;2021-07-02;749;1843;123618;86967;56.9;40.1
36;2021-07-03;465;885;124083;87852;57.1;40.5
36;2021-07-04;185;326;124268;88178;57.2;40.6
36;2021-07-05;493;1335;124761;89513;57.5;41.2
36;2021-07-06;491;1220;125252;90733;57.7;41.8
36;2021-07-07;586;1791;125838;92524;58.0;42.6
36;2021-07-08;549;1707;126387;94231;58.2;43.4
36;2021-07-09;786;1654;127173;95885;58.6;44.2
36;2021-07-10;469;1119;127642;97004;58.8;44.7
36;2021-07-11;257;154;127899;97158;58.9;44.7
36;2021-07-12;332;1628;128231;98786;59.1;45.5
36;2021-07-13;311;1936;128542;100722;59.2;46.4
36;2021-07-14;376;763;128918;101485;59.4;46.7
36;2021-07-15;917;2165;129835;103650;59.8;47.7
36;2021-07-16;628;1873;130463;105523;60.1;48.6
36;2021-07-17;400;859;130863;106382;60.3;49.0
36;2021-07-18;199;408;131062;106790;60.4;49.2
36;2021-07-19;552;1456;131614;108246;60.6;49.9
36;2021-07-20;776;1408;132390;109654;61.0;50.5
36;2021-07-21;713;1984;133103;111638;61.3;51.4
36;2021-07-22;1138;1687;134241;113325;61.8;52.2
36;2021-07-23;968;1746;135209;115071;62.3;53.0
36;2021-07-24;605;801;135814;115872;62.5;53.4
36;2021-07-25;148;404;135962;116276;62.6;53.5
36;2021-07-26;948;1086;136910;117362;63.1;54.0
36;2021-07-27;816;1355;137726;118717;63.4;54.7
36;2021-07-28;1385;1402;139111;120119;64.1;55.3
36;2021-07-29;1708;1310;140819;121429;64.9;55.9
36;2021-07-30;1445;1322;142264;122751;65.5;56.5
36;2021-07-31;933;537;143197;123288;65.9;56.8
36;2021-08-01;210;239;143407;123527;66.0;56.9
36;2021-08-02;1116;893;144523;124420;66.6;57.3
36;2021-08-03;1271;999;145794;125419;67.1;57.8
36;2021-08-04;1695;940;147489;126359;67.9;58.2
36;2021-08-05;1825;911;149314;127270;68.8;58.6
36;2021-08-06;1418;877;150732;128147;69.4;59.0
36;2021-08-07;541;527;151273;128674;69.7;59.3
36;2021-08-08;292;153;151565;128827;69.8;59.3
36;2021-08-09;817;846;152382;129673;70.2;59.7
36;2021-08-10;1067;1012;153449;130685;70.7;60.2
36;2021-08-11;1356;858;154805;131543;71.3;60.6
36;2021-08-12;1161;854;155966;132397;71.8;61.0
36;2021-08-13;1193;778;157159;133175;72.4;61.3
36;2021-08-14;426;836;157585;134011;72.6;61.7
36;2021-08-15;365;113;157950;134124;72.7;61.8
36;2021-08-16;606;954;158556;135078;73.0;62.2
36;2021-08-17;766;1002;159322;136080;73.4;62.7
36;2021-08-18;1039;1164;160361;137244;73.9;63.2
36;2021-08-19;840;1178;161201;138422;74.2;63.7
36;2021-08-20;489;1481;161690;139903;74.5;64.4
36;2021-08-21;309;468;161999;140371;74.6;64.6
36;2021-08-22;27;65;162026;140436;74.6;64.7
36;2021-08-23;551;1179;162577;141615;74.9;65.2
36;2021-08-24;589;1204;163166;142819;75.1;65.8
36;2021-08-25;466;1094;163632;143913;75.4;66.3
36;2021-08-26;666;1480;164298;145393;75.7;67.0
36;2021-08-27;529;1409;164827;146802;75.9;67.6
36;2021-08-28;368;580;165195;147382;76.1;67.9
36;2021-08-29;222;241;165417;147623;76.2;68.0
36;2021-08-30;246;726;165663;148349;76.3;68.3
36;2021-08-31;387;833;166050;149182;76.5;68.7
36;2021-09-01;388;1060;166438;150242;76.7;69.2
36;2021-09-02;324;910;166762;151152;76.8;69.6
36;2021-09-03;297;1362;167059;152514;76.9;70.2
36;2021-09-04;248;781;167307;153295;77.1;70.6
36;2021-09-05;119;329;167426;153624;77.1;70.7
36;2021-09-06;150;872;167576;154496;77.2;71.2
36;2021-09-07;192;690;167768;155186;77.3;71.5
36;2021-09-08;236;1121;168004;156307;77.4;72.0
36;2021-09-09;293;834;168297;157141;77.5;72.4
36;2021-09-10;271;951;168568;158092;77.6;72.8
36;2021-09-11;165;724;168733;158816;77.7;73.1
36;2021-09-12;82;190;168815;159006;77.7;73.2
36;2021-09-13;168;550;168983;159556;77.8;73.5
36;2021-09-14;170;438;169153;159994;77.9;73.7
36;2021-09-15;303;569;169456;160563;78.0;73.9
36;2021-09-16;253;670;169709;161233;78.2;74.3
36;2021-09-17;257;567;169966;161800;78.3;74.5
36;2021-09-18;123;427;170089;162227;78.3;74.7
36;2021-09-19;43;214;170132;162441;78.4;74.8
36;2021-09-20;131;325;170263;162766;78.4;75.0
36;2021-09-21;132;300;170395;163066;78.5;75.1
36;2021-09-22;119;674;170514;163740;78.5;75.4
36;2021-09-23;135;438;170649;164178;78.6;75.6
36;2021-09-24;129;497;170778;164675;78.6;75.8
36;2021-09-25;119;502;170897;165177;78.7;76.1
36;2021-09-26;15;318;170912;165495;78.7;76.2
36;2021-09-27;65;224;170977;165719;78.7;76.3
36;2021-09-28;69;233;171046;165952;78.8;76.4
36;2021-09-29;107;387;171153;166339;78.8;76.6
36;2021-09-30;110;252;171263;166591;78.9;76.7
36;2021-10-01;163;308;171426;166899;78.9;76.9
36;2021-10-02;43;183;171469;167082;79.0;76.9
36;2021-10-03;4;23;171473;167105;79.0;77.0
36;2021-10-04;54;195;171527;167300;79.0;77.0
36;2021-10-05;116;163;171643;167463;79.0;77.1
36;2021-10-06;99;293;171742;167756;79.1;77.3
36;2021-10-07;84;204;171826;167960;79.1;77.4
36;2021-10-08;131;269;171957;168229;79.2;77.5
36;2021-10-09;84;210;172041;168439;79.2;77.6
36;2021-10-10;4;11;172045;168450;79.2;77.6
36;2021-10-11;87;141;172132;168591;79.3;77.6
36;2021-10-12;79;94;172211;168685;79.3;77.7
36;2021-10-13;149;249;172360;168934;79.4;77.8
36;2021-10-14;50;56;172410;168990;79.4;77.8
36;2021-10-15;105;249;172515;169239;79.4;77.9
36;2021-10-16;88;148;172603;169387;79.5;78.0
36;2021-10-17;2;7;172605;169394;79.5;78.0
36;2021-10-18;31;117;172636;169511;79.5;78.1
36;2021-10-19;12;49;172648;169560;79.5;78.1
37;2020-12-27;1;0;1;0;0.0;0.0
37;2020-12-28;17;0;18;0;0.0;0.0
37;2020-12-29;10;0;28;0;0.0;0.0
37;2020-12-30;0;0;28;0;0.0;0.0
37;2020-12-31;0;0;28;0;0.0;0.0
37;2021-01-01;0;0;28;0;0.0;0.0
37;2021-01-02;0;0;28;0;0.0;0.0
37;2021-01-03;2;0;30;0;0.0;0.0
37;2021-01-04;23;0;53;0;0.0;0.0
37;2021-01-05;47;0;100;0;0.0;0.0
37;2021-01-06;79;0;179;0;0.0;0.0
37;2021-01-07;116;1;295;1;0.0;0.0
37;2021-01-08;442;1;737;2;0.1;0.0
37;2021-01-09;80;1;817;3;0.1;0.0
37;2021-01-10;83;0;900;3;0.1;0.0
37;2021-01-11;281;0;1181;3;0.2;0.0
37;2021-01-12;658;5;1839;8;0.3;0.0
37;2021-01-13;561;1;2400;9;0.4;0.0
37;2021-01-14;526;4;2926;13;0.5;0.0
37;2021-01-15;627;1;3553;14;0.6;0.0
37;2021-01-16;304;2;3857;16;0.6;0.0
37;2021-01-17;263;1;4120;17;0.7;0.0
37;2021-01-18;733;9;4853;26;0.8;0.0
37;2021-01-19;1244;11;6097;37;1.0;0.0
37;2021-01-20;1039;5;7136;42;1.2;0.0
37;2021-01-21;858;1;7994;43;1.3;0.0
37;2021-01-22;769;2;8763;45;1.4;0.0
37;2021-01-23;173;0;8936;45;1.5;0.0
37;2021-01-24;2;0;8938;45;1.5;0.0
37;2021-01-25;543;17;9481;62;1.6;0.0
37;2021-01-26;1814;69;11295;131;1.9;0.0
37;2021-01-27;1523;77;12818;208;2.1;0.0
37;2021-01-28;1535;95;14353;303;2.4;0.1
37;2021-01-29;634;311;14987;614;2.5;0.1
37;2021-01-30;204;61;15191;675;2.5;0.1
37;2021-01-31;15;64;15206;739;2.5;0.1
37;2021-02-01;333;198;15539;937;2.6;0.2
37;2021-02-02;522;526;16061;1463;2.7;0.2
37;2021-02-03;660;350;16721;1813;2.8;0.3
37;2021-02-04;549;409;17270;2222;2.9;0.4
37;2021-02-05;468;443;17738;2665;2.9;0.4
37;2021-02-06;191;2;17929;2667;3.0;0.4
37;2021-02-07;21;1;17950;2668;3.0;0.4
37;2021-02-08;333;323;18283;2991;3.0;0.5
37;2021-02-09;627;709;18910;3700;3.1;0.6
37;2021-02-10;664;509;19574;4209;3.2;0.7
37;2021-02-11;613;562;20187;4771;3.3;0.8
37;2021-02-12;489;552;20676;5323;3.4;0.9
37;2021-02-13;160;204;20836;5527;3.4;0.9
37;2021-02-14;2;72;20838;5599;3.4;0.9
37;2021-02-15;427;480;21265;6079;3.5;1.0
37;2021-02-16;841;1444;22106;7523;3.7;1.2
37;2021-02-17;633;1372;22739;8895;3.8;1.5
37;2021-02-18;914;1418;23653;10313;3.9;1.7
37;2021-02-19;797;836;24450;11149;4.0;1.8
37;2021-02-20;245;209;24695;11358;4.1;1.9
37;2021-02-21;5;1;24700;11359;4.1;1.9
37;2021-02-22;335;581;25035;11940;4.1;2.0
37;2021-02-23;605;632;25640;12572;4.2;2.1
37;2021-02-24;573;623;26213;13195;4.3;2.2
37;2021-02-25;875;613;27088;13808;4.5;2.3
37;2021-02-26;1118;577;28206;14385;4.7;2.4
37;2021-02-27;585;188;28791;14573;4.8;2.4
37;2021-02-28;23;0;28814;14573;4.8;2.4
37;2021-03-01;603;361;29417;14934;4.9;2.5
37;2021-03-02;1090;543;30507;15477;5.0;2.6
37;2021-03-03;973;549;31480;16026;5.2;2.6
37;2021-03-04;1608;485;33088;16511;5.5;2.7
37;2021-03-05;2133;569;35221;17080;5.8;2.8
37;2021-03-06;1165;216;36386;17296;6.0;2.9
37;2021-03-07;472;68;36858;17364;6.1;2.9
37;2021-03-08;670;401;37528;17765;6.2;2.9
37;2021-03-09;1653;703;39181;18468;6.5;3.1
37;2021-03-10;1609;756;40790;19224;6.7;3.2
37;2021-03-11;2051;709;42841;19933;7.1;3.3
37;2021-03-12;3209;481;46050;20414;7.6;3.4
37;2021-03-13;1948;193;47998;20607;7.9;3.4
37;2021-03-14;208;4;48206;20611;8.0;3.4
37;2021-03-15;1071;252;49277;20863;8.1;3.4
37;2021-03-16;1050;535;50327;21398;8.3;3.5
37;2021-03-17;936;282;51263;21680;8.5;3.6
37;2021-03-18;1039;528;52302;22208;8.6;3.7
37;2021-03-19;2219;345;54521;22553;9.0;3.7
37;2021-03-20;1336;145;55857;22698;9.2;3.7
37;2021-03-21;205;4;56062;22702;9.3;3.8
37;2021-03-22;1288;245;57350;22947;9.5;3.8
37;2021-03-23;2257;573;59607;23520;9.8;3.9
37;2021-03-24;2245;469;61852;23989;10.2;4.0
37;2021-03-25;2985;450;64837;24439;10.7;4.0
37;2021-03-26;3525;413;68362;24852;11.3;4.1
37;2021-03-27;1176;129;69538;24981;11.5;4.1
37;2021-03-28;139;1;69677;24982;11.5;4.1
37;2021-03-29;1606;350;71283;25332;11.8;4.2
37;2021-03-30;2525;630;73808;25962;12.2;4.3
37;2021-03-31;2050;485;75858;26447;12.5;4.4
37;2021-04-01;2600;972;78458;27419;13.0;4.5
37;2021-04-02;2808;671;81266;28090;13.4;4.6
37;2021-04-03;818;226;82084;28316;13.6;4.7
37;2021-04-04;104;1;82188;28317;13.6;4.7
37;2021-04-05;4;0;82192;28317;13.6;4.7
37;2021-04-06;2243;785;84435;29102;13.9;4.8
37;2021-04-07;3173;881;87608;29983;14.5;5.0
37;2021-04-08;4045;971;91653;30954;15.1;5.1
37;2021-04-09;4544;961;96197;31915;15.9;5.3
37;2021-04-10;1331;438;97528;32353;16.1;5.3
37;2021-04-11;104;1;97632;32354;16.1;5.3
37;2021-04-12;2641;680;100273;33034;16.6;5.5
37;2021-04-13;4114;1168;104387;34202;17.2;5.6
37;2021-04-14;3043;896;107430;35098;17.7;5.8
37;2021-04-15;3757;1022;111187;36120;18.4;6.0
37;2021-04-16;4359;1230;115546;37350;19.1;6.2
37;2021-04-17;1147;228;116693;37578;19.3;6.2
37;2021-04-18;98;3;116791;37581;19.3;6.2
37;2021-04-19;2481;852;119272;38433;19.7;6.3
37;2021-04-20;3233;1340;122505;39773;20.2;6.6
37;2021-04-21;2928;1163;125433;40936;20.7;6.8
37;2021-04-22;3456;1404;128889;42340;21.3;7.0
37;2021-04-23;3694;1818;132583;44158;21.9;7.3
37;2021-04-24;1007;387;133590;44545;22.1;7.4
37;2021-04-25;46;2;133636;44547;22.1;7.4
37;2021-04-26;2971;1350;136607;45897;22.6;7.6
37;2021-04-27;4186;1817;140793;47714;23.3;7.9
37;2021-04-28;3466;1957;144259;49671;23.8;8.2
37;2021-04-29;4585;2027;148844;51698;24.6;8.5
37;2021-04-30;5056;1995;153900;53693;25.4;8.9
37;2021-05-01;638;214;154538;53907;25.5;8.9
37;2021-05-02;104;15;154642;53922;25.5;8.9
37;2021-05-03;2672;1960;157314;55882;26.0;9.2
37;2021-05-04;3731;2721;161045;58603;26.6;9.7
37;2021-05-05;3500;2093;164545;60696;27.2;10.0
37;2021-05-06;4992;1954;169537;62650;28.0;10.3
37;2021-05-07;4685;2887;174222;65537;28.8;10.8
37;2021-05-08;538;312;174760;65849;28.9;10.9
37;2021-05-09;63;41;174823;65890;28.9;10.9
37;2021-05-10;2161;3486;176984;69376;29.2;11.5
37;2021-05-11;3868;3882;180852;73258;29.9;12.1
37;2021-05-12;4041;2547;184893;75805;30.5;12.5
37;2021-05-13;1139;517;186032;76322;30.7;12.6
37;2021-05-14;4046;2680;190078;79002;31.4;13.0
37;2021-05-15;2322;744;192400;79746;31.8;13.2
37;2021-05-16;22;70;192422;79816;31.8;13.2
37;2021-05-17;2765;2046;195187;81862;32.2;13.5
37;2021-05-18;3876;2362;199063;84224;32.9;13.9
37;2021-05-19;3495;1808;202558;86032;33.5;14.2
37;2021-05-20;4751;1778;207309;87810;34.2;14.5
37;2021-05-21;4525;2572;211834;90382;35.0;14.9
37;2021-05-22;1079;752;212913;91134;35.2;15.1
37;2021-05-23;73;89;212986;91223;35.2;15.1
37;2021-05-24;513;107;213499;91330;35.3;15.1
37;2021-05-25;5123;2175;218622;93505;36.1;15.4
37;2021-05-26;4930;2100;223552;95605;36.9;15.8
37;2021-05-27;5983;2368;229535;97973;37.9;16.2
37;2021-05-28;6023;3268;235558;101241;38.9;16.7
37;2021-05-29;1520;1167;237078;102408;39.2;16.9
37;2021-05-30;55;160;237133;102568;39.2;16.9
37;2021-05-31;3647;2529;240780;105097;39.8;17.4
37;2021-06-01;5841;3622;246621;108719;40.7;18.0
37;2021-06-02;5079;2459;251700;111178;41.6;18.4
37;2021-06-03;6086;2884;257786;114062;42.6;18.8
37;2021-06-04;5510;4209;263296;118271;43.5;19.5
37;2021-06-05;1853;1306;265149;119577;43.8;19.8
37;2021-06-06;49;197;265198;119774;43.8;19.8
37;2021-06-07;3021;4167;268219;123941;44.3;20.5
37;2021-06-08;4201;4658;272420;128599;45.0;21.2
37;2021-06-09;3883;3573;276303;132172;45.6;21.8
37;2021-06-10;5271;3622;281574;135794;46.5;22.4
37;2021-06-11;4972;4840;286546;140634;47.3;23.2
37;2021-06-12;3552;1349;290098;141983;47.9;23.5
37;2021-06-13;15;164;290113;142147;47.9;23.5
37;2021-06-14;2666;4039;292779;146186;48.4;24.1
37;2021-06-15;3898;4780;296677;150966;49.0;24.9
37;2021-06-16;3260;3602;299937;154568;49.5;25.5
37;2021-06-17;4013;4497;303950;159065;50.2;26.3
37;2021-06-18;4704;5075;308654;164140;51.0;27.1
37;2021-06-19;2519;1101;311173;165241;51.4;27.3
37;2021-06-20;10;183;311183;165424;51.4;27.3
37;2021-06-21;2418;3827;313601;169251;51.8;28.0
37;2021-06-22;2968;5007;316569;174258;52.3;28.8
37;2021-06-23;2625;3644;319194;177902;52.7;29.4
37;2021-06-24;2873;3545;322067;181447;53.2;30.0
37;2021-06-25;3308;4882;325375;186329;53.7;30.8
37;2021-06-26;1238;3086;326613;189415;54.0;31.3
37;2021-06-27;23;142;326636;189557;54.0;31.3
37;2021-06-28;1703;4510;328339;194067;54.2;32.1
37;2021-06-29;1904;6225;330243;200292;54.6;33.1
37;2021-06-30;1870;4443;332113;204735;54.9;33.8
37;2021-07-01;2125;4796;334238;209531;55.2;34.6
37;2021-07-02;2682;5595;336920;215126;55.7;35.5
37;2021-07-03;944;2138;337864;217264;55.8;35.9
37;2021-07-04;5;105;337869;217369;55.8;35.9
37;2021-07-05;1710;5137;339579;222506;56.1;36.8
37;2021-07-06;2003;6760;341582;229266;56.4;37.9
37;2021-07-07;1945;5466;343527;234732;56.7;38.8
37;2021-07-08;2466;6663;345993;241395;57.2;39.9
37;2021-07-09;1986;7645;347979;249040;57.5;41.1
37;2021-07-10;1016;2619;348995;251659;57.6;41.6
37;2021-07-11;26;96;349021;251755;57.7;41.6
37;2021-07-12;1130;5984;350151;257739;57.8;42.6
37;2021-07-13;1614;7817;351765;265556;58.1;43.9
37;2021-07-14;525;408;352290;265964;58.2;43.9
37;2021-07-15;2625;7502;354915;273466;58.6;45.2
37;2021-07-16;2757;7804;357672;281270;59.1;46.5
37;2021-07-17;1202;2447;358874;283717;59.3;46.9
37;2021-07-18;50;53;358924;283770;59.3;46.9
37;2021-07-19;1652;6127;360576;289897;59.6;47.9
37;2021-07-20;2906;7065;363482;296962;60.0;49.1
37;2021-07-21;2982;5786;366464;302748;60.5;50.0
37;2021-07-22;4057;6533;370521;309281;61.2;51.1
37;2021-07-23;3808;7109;374329;316390;61.8;52.3
37;2021-07-24;1775;3308;376104;319698;62.1;52.8
37;2021-07-25;66;77;376170;319775;62.1;52.8
37;2021-07-26;3236;4322;379406;324097;62.7;53.5
37;2021-07-27;4429;4963;383835;329060;63.4;54.4
37;2021-07-28;4134;3663;387969;332723;64.1;55.0
37;2021-07-29;5086;4195;393055;336918;64.9;55.7
37;2021-07-30;5247;4940;398302;341858;65.8;56.5
37;2021-07-31;1921;1846;400223;343704;66.1;56.8
37;2021-08-01;31;52;400254;343756;66.1;56.8
37;2021-08-02;3293;3297;403547;347053;66.7;57.3
37;2021-08-03;5263;3147;408810;350200;67.5;57.8
37;2021-08-04;4559;1931;413369;352131;68.3;58.2
37;2021-08-05;4788;2599;418157;354730;69.1;58.6
37;2021-08-06;4852;3307;423009;358037;69.9;59.1
37;2021-08-07;1626;1125;424635;359162;70.1;59.3
37;2021-08-08;34;177;424669;359339;70.1;59.4
37;2021-08-09;2436;2260;427105;361599;70.6;59.7
37;2021-08-10;3027;2639;430132;364238;71.1;60.2
37;2021-08-11;2099;2108;432231;366346;71.4;60.5
37;2021-08-12;2613;2692;434844;369038;71.8;61.0
37;2021-08-13;2485;2777;437329;371815;72.2;61.4
37;2021-08-14;756;815;438085;372630;72.4;61.6
37;2021-08-15;12;57;438097;372687;72.4;61.6
37;2021-08-16;1466;3160;439563;375847;72.6;62.1
37;2021-08-17;1797;3974;441360;379821;72.9;62.7
37;2021-08-18;1400;3141;442760;382962;73.1;63.3
37;2021-08-19;1598;3842;444358;386804;73.4;63.9
37;2021-08-20;1598;4554;445956;391358;73.7;64.6
37;2021-08-21;610;1201;446566;392559;73.8;64.8
37;2021-08-22;3;31;446569;392590;73.8;64.9
37;2021-08-23;1291;3985;447860;396575;74.0;65.5
37;2021-08-24;1541;4852;449401;401427;74.2;66.3
37;2021-08-25;1055;4223;450456;405650;74.4;67.0
37;2021-08-26;1280;4513;451736;410163;74.6;67.8
37;2021-08-27;1456;5663;453192;415826;74.9;68.7
37;2021-08-28;407;1462;453599;417288;74.9;68.9
37;2021-08-29;1;18;453600;417306;74.9;68.9
37;2021-08-30;1076;3879;454676;421185;75.1;69.6
37;2021-08-31;1280;3715;455956;424900;75.3;70.2
37;2021-09-01;977;2495;456933;427395;75.5;70.6
37;2021-09-02;896;2529;457829;429924;75.6;71.0
37;2021-09-03;1046;3567;458875;433491;75.8;71.6
37;2021-09-04;672;1323;459547;434814;75.9;71.8
37;2021-09-05;1;28;459548;434842;75.9;71.8
37;2021-09-06;378;1091;459926;435933;76.0;72.0
37;2021-09-07;537;1299;460463;437232;76.1;72.2
37;2021-09-08;820;1870;461283;439102;76.2;72.5
37;2021-09-09;557;1272;461840;440374;76.3;72.7
37;2021-09-10;817;1610;462657;441984;76.4;73.0
37;2021-09-11;404;939;463061;442923;76.5;73.2
37;2021-09-12;15;15;463076;442938;76.5;73.2
37;2021-09-13;449;1058;463525;443996;76.6;73.3
37;2021-09-14;511;1090;464036;445086;76.7;73.5
37;2021-09-15;625;1478;464661;446564;76.8;73.8
37;2021-09-16;354;770;465015;447334;76.8;73.9
37;2021-09-17;639;1473;465654;448807;76.9;74.1
37;2021-09-18;306;841;465960;449648;77.0;74.3
37;2021-09-19;16;42;465976;449690;77.0;74.3
37;2021-09-20;272;682;466248;450372;77.0;74.4
37;2021-09-21;443;1325;466691;451697;77.1;74.6
37;2021-09-22;428;1289;467119;452986;77.2;74.8
37;2021-09-23;428;1047;467547;454033;77.2;75.0
37;2021-09-24;504;1406;468051;455439;77.3;75.2
37;2021-09-25;232;769;468283;456208;77.4;75.4
37;2021-09-26;1;22;468284;456230;77.4;75.4
37;2021-09-27;290;692;468574;456922;77.4;75.5
37;2021-09-28;397;661;468971;457583;77.5;75.6
37;2021-09-29;368;940;469339;458523;77.5;75.7
37;2021-09-30;374;496;469713;459019;77.6;75.8
37;2021-10-01;439;804;470152;459823;77.7;76.0
37;2021-10-02;223;561;470375;460384;77.7;76.0
37;2021-10-03;19;23;470394;460407;77.7;76.1
37;2021-10-04;260;523;470654;460930;77.7;76.1
37;2021-10-05;329;436;470983;461366;77.8;76.2
37;2021-10-06;370;699;471353;462065;77.9;76.3
37;2021-10-07;285;416;471638;462481;77.9;76.4
37;2021-10-08;405;645;472043;463126;78.0;76.5
37;2021-10-09;207;490;472250;463616;78.0;76.6
37;2021-10-10;3;8;472253;463624;78.0;76.6
37;2021-10-11;216;344;472469;463968;78.0;76.6
37;2021-10-12;240;461;472709;464429;78.1;76.7
37;2021-10-13;292;506;473001;464935;78.1;76.8
37;2021-10-14;219;393;473220;465328;78.2;76.9
37;2021-10-15;374;700;473594;466028;78.2;77.0
37;2021-10-16;238;313;473832;466341;78.3;77.0
37;2021-10-17;3;0;473835;466341;78.3;77.0
37;2021-10-18;208;288;474043;466629;78.3;77.1
37;2021-10-19;227;359;474270;466988;78.3;77.1
38;2020-12-27;1;0;1;0;0.0;0.0
38;2020-12-28;1;0;2;0;0.0;0.0
38;2020-12-29;0;0;2;0;0.0;0.0
38;2020-12-30;2;0;4;0;0.0;0.0
38;2020-12-31;5;0;9;0;0.0;0.0
38;2021-01-01;4;0;13;0;0.0;0.0
38;2021-01-02;1;0;14;0;0.0;0.0
38;2021-01-03;3;1;17;1;0.0;0.0
38;2021-01-04;163;0;180;1;0.0;0.0
38;2021-01-05;258;1;438;2;0.0;0.0
38;2021-01-06;364;0;802;2;0.1;0.0
38;2021-01-07;636;1;1438;3;0.1;0.0
38;2021-01-08;695;0;2133;3;0.2;0.0
38;2021-01-09;30;0;2163;3;0.2;0.0
38;2021-01-10;2;0;2165;3;0.2;0.0
38;2021-01-11;801;2;2966;5;0.2;0.0
38;2021-01-12;1472;5;4438;10;0.4;0.0
38;2021-01-13;1084;5;5522;15;0.4;0.0
38;2021-01-14;1683;15;7205;30;0.6;0.0
38;2021-01-15;1675;9;8880;39;0.7;0.0
38;2021-01-16;307;2;9187;41;0.7;0.0
38;2021-01-17;3;0;9190;41;0.7;0.0
38;2021-01-18;1179;6;10369;47;0.8;0.0
38;2021-01-19;2242;6;12611;53;1.0;0.0
38;2021-01-20;1889;10;14500;63;1.1;0.0
38;2021-01-21;1644;14;16144;77;1.3;0.0
38;2021-01-22;1400;9;17544;86;1.4;0.0
38;2021-01-23;379;3;17923;89;1.4;0.0
38;2021-01-24;1;0;17924;89;1.4;0.0
38;2021-01-25;795;107;18719;196;1.5;0.0
38;2021-01-26;856;183;19575;379;1.5;0.0
38;2021-01-27;1094;278;20669;657;1.6;0.1
38;2021-01-28;1175;480;21844;1137;1.7;0.1
38;2021-01-29;954;376;22798;1513;1.8;0.1
38;2021-01-30;304;0;23102;1513;1.8;0.1
38;2021-01-31;0;0;23102;1513;1.8;0.1
38;2021-02-01;703;598;23805;2111;1.9;0.2
38;2021-02-02;964;954;24769;3065;2.0;0.2
38;2021-02-03;1230;700;25999;3765;2.1;0.3
38;2021-02-04;1278;971;27277;4736;2.2;0.4
38;2021-02-05;1400;845;28677;5581;2.3;0.4
38;2021-02-06;188;95;28865;5676;2.3;0.4
38;2021-02-07;3;48;28868;5724;2.3;0.5
38;2021-02-08;862;791;29730;6515;2.4;0.5
38;2021-02-09;1538;1309;31268;7824;2.5;0.6
38;2021-02-10;1581;1284;32849;9108;2.6;0.7
38;2021-02-11;1871;1156;34720;10264;2.7;0.8
38;2021-02-12;1509;1125;36229;11389;2.9;0.9
38;2021-02-13;467;191;36696;11580;2.9;0.9
38;2021-02-14;1;7;36697;11587;2.9;0.9
38;2021-02-15;976;940;37673;12527;3.0;1.0
38;2021-02-16;1379;976;39052;13503;3.1;1.1
38;2021-02-17;1376;1061;40428;14564;3.2;1.2
38;2021-02-18;1791;1061;42219;15625;3.3;1.2
38;2021-02-19;1257;869;43476;16494;3.4;1.3
38;2021-02-20;470;316;43946;16810;3.5;1.3
38;2021-02-21;1;1;43947;16811;3.5;1.3
38;2021-02-22;1075;903;45022;17714;3.6;1.4
38;2021-02-23;1543;953;46565;18667;3.7;1.5
38;2021-02-24;1743;1143;48308;19810;3.8;1.6
38;2021-02-25;2501;1059;50809;20869;4.0;1.6
38;2021-02-26;3312;1002;54121;21871;4.3;1.7
38;2021-02-27;1511;442;55632;22313;4.4;1.8
38;2021-02-28;33;2;55665;22315;4.4;1.8
38;2021-03-01;2511;799;58176;23114;4.6;1.8
38;2021-03-02;4048;1070;62224;24184;4.9;1.9
38;2021-03-03;3367;1264;65591;25448;5.2;2.0
38;2021-03-04;4489;1403;70080;26851;5.5;2.1
38;2021-03-05;5234;1231;75314;28082;6.0;2.2
38;2021-03-06;3044;276;78358;28358;6.2;2.2
38;2021-03-07;115;2;78473;28360;6.2;2.2
38;2021-03-08;2440;910;80913;29270;6.4;2.3
38;2021-03-09;4031;1329;84944;30599;6.7;2.4
38;2021-03-10;3508;1102;88452;31701;7.0;2.5
38;2021-03-11;5141;1553;93593;33254;7.4;2.6
38;2021-03-12;7094;1202;100687;34456;8.0;2.7
38;2021-03-13;3772;236;104459;34692;8.3;2.7
38;2021-03-14;544;15;105003;34707;8.3;2.7
38;2021-03-15;2702;1020;107705;35727;8.5;2.8
38;2021-03-16;2081;1357;109786;37084;8.7;2.9
38;2021-03-17;2025;1215;111811;38299;8.8;3.0
38;2021-03-18;2641;1376;114452;39675;9.0;3.1
38;2021-03-19;4007;1076;118459;40751;9.4;3.2
38;2021-03-20;1826;252;120285;41003;9.5;3.2
38;2021-03-21;132;8;120417;41011;9.5;3.2
38;2021-03-22;2865;1013;123282;42024;9.7;3.3
38;2021-03-23;4780;1504;128062;43528;10.1;3.4
38;2021-03-24;3707;1589;131769;45117;10.4;3.6
38;2021-03-25;5791;1561;137560;46678;10.9;3.7
38;2021-03-26;6599;1757;144159;48435;11.4;3.8
38;2021-03-27;2513;766;146672;49201;11.6;3.9
38;2021-03-28;926;48;147598;49249;11.7;3.9
38;2021-03-29;2679;1852;150277;51101;11.9;4.0
38;2021-03-30;4564;2554;154841;53655;12.2;4.2
38;2021-03-31;3665;2232;158506;55887;12.5;4.4
38;2021-04-01;5137;2539;163643;58426;12.9;4.6
38;2021-04-02;3875;2539;167518;60965;13.2;4.8
38;2021-04-03;1418;945;168936;61910;13.4;4.9
38;2021-04-04;430;46;169366;61956;13.4;4.9
38;2021-04-05;2178;355;171544;62311;13.6;4.9
38;2021-04-06;4346;2411;175890;64722;13.9;5.1
38;2021-04-07;4415;2752;180305;67474;14.3;5.3
38;2021-04-08;5652;2681;185957;70155;14.7;5.5
38;2021-04-09;8563;2748;194520;72903;15.4;5.8
38;2021-04-10;3597;1499;198117;74402;15.7;5.9
38;2021-04-11;1049;112;199166;74514;15.7;5.9
38;2021-04-12;4203;2260;203369;76774;16.1;6.1
38;2021-04-13;6123;2478;209492;79252;16.6;6.3
38;2021-04-14;5118;2468;214610;81720;17.0;6.5
38;2021-04-15;6360;2775;220970;84495;17.5;6.7
38;2021-04-16;6214;2729;227184;87224;18.0;6.9
38;2021-04-17;2588;997;229772;88221;18.2;7.0
38;2021-04-18;1331;72;231103;88293;18.3;7.0
38;2021-04-19;3948;2840;235051;91133;18.6;7.2
38;2021-04-20;5425;2862;240476;93995;19.0;7.4
38;2021-04-21;4976;2711;245452;96706;19.4;7.6
38;2021-04-22;5790;2841;251242;99547;19.9;7.9
38;2021-04-23;6044;2831;257286;102378;20.3;8.1
38;2021-04-24;2665;1351;259951;103729;20.5;8.2
38;2021-04-25;805;592;260756;104321;20.6;8.2
38;2021-04-26;4487;2482;265243;106803;21.0;8.4
38;2021-04-27;6040;2740;271283;109543;21.4;8.7
38;2021-04-28;6197;2512;277480;112055;21.9;8.9
38;2021-04-29;8332;3079;285812;115134;22.6;9.1
38;2021-04-30;7673;4067;293485;119201;23.2;9.4
38;2021-05-01;1546;204;295031;119405;23.3;9.4
38;2021-05-02;847;74;295878;119479;23.4;9.4
38;2021-05-03;5299;3592;301177;123071;23.8;9.7
38;2021-05-04;6203;5091;307380;128162;24.3;10.1
38;2021-05-05;6067;4612;313447;132774;24.8;10.5
38;2021-05-06;6709;5338;320156;138112;25.3;10.9
38;2021-05-07;7284;6449;327440;144561;25.9;11.4
38;2021-05-08;3777;724;331217;145285;26.2;11.5
38;2021-05-09;2854;1933;334071;147218;26.4;11.6
38;2021-05-10;6159;5312;340230;152530;26.9;12.1
38;2021-05-11;8226;6028;348456;158558;27.5;12.5
38;2021-05-12;9045;4708;357501;163266;28.3;12.9
38;2021-05-13;6635;1418;364136;164684;28.8;13.0
38;2021-05-14;9566;3425;373702;168109;29.5;13.3
38;2021-05-15;6865;1452;380567;169561;30.1;13.4
38;2021-05-16;5475;650;386042;170211;30.5;13.5
38;2021-05-17;7673;3007;393715;173218;31.1;13.7
38;2021-05-18;8622;4035;402337;177253;31.8;14.0
38;2021-05-19;8158;3349;410495;180602;32.5;14.3
38;2021-05-20;8978;4496;419473;185098;33.2;14.6
38;2021-05-21;9960;4586;429433;189684;33.9;15.0
38;2021-05-22;7457;1907;436890;191591;34.5;15.1
38;2021-05-23;5589;581;442479;192172;35.0;15.2
38;2021-05-24;7502;1627;449981;193799;35.6;15.3
38;2021-05-25;9544;4852;459525;198651;36.3;15.7
38;2021-05-26;8126;4727;467651;203378;37.0;16.1
38;2021-05-27;9135;5664;476786;209042;37.7;16.5
38;2021-05-28;8786;6500;485572;215542;38.4;17.0
38;2021-05-29;5821;3256;491393;218798;38.8;17.3
38;2021-05-30;2695;1593;494088;220391;39.1;17.4
38;2021-05-31;8273;5137;502361;225528;39.7;17.8
38;2021-06-01;7964;6433;510325;231961;40.3;18.3
38;2021-06-02;7141;5624;517466;237585;40.9;18.8
38;2021-06-03;7393;6833;524859;244418;41.5;19.3
38;2021-06-04;8129;7615;532988;252033;42.1;19.9
38;2021-06-05;5794;3949;538782;255982;42.6;20.2
38;2021-06-06;2509;1463;541291;257445;42.8;20.4
38;2021-06-07;5554;6870;546845;264315;43.2;20.9
38;2021-06-08;5880;7529;552725;271844;43.7;21.5
38;2021-06-09;5047;6472;557772;278316;44.1;22.0
38;2021-06-10;5427;6791;563199;285107;44.5;22.5
38;2021-06-11;5888;7786;569087;292893;45.0;23.2
38;2021-06-12;3945;3260;573032;296153;45.3;23.4
38;2021-06-13;1259;1300;574291;297453;45.4;23.5
38;2021-06-14;3868;7663;578159;305116;45.7;24.1
38;2021-06-15;5233;8147;583392;313263;46.1;24.8
38;2021-06-16;5125;7408;588517;320671;46.5;25.3
38;2021-06-17;4523;7058;593040;327729;46.9;25.9
38;2021-06-18;6164;9231;599204;336960;47.4;26.6
38;2021-06-19;3595;4972;602799;341932;47.7;27.0
38;2021-06-20;1039;2901;603838;344833;47.7;27.3
38;2021-06-21;3748;8709;607586;353542;48.0;27.9
38;2021-06-22;3789;10107;611375;363649;48.3;28.7
38;2021-06-23;3157;9545;614532;373194;48.6;29.5
38;2021-06-24;3383;8590;617915;381784;48.8;30.2
38;2021-06-25;3787;11492;621702;393276;49.1;31.1
38;2021-06-26;2229;7851;623931;401127;49.3;31.7
38;2021-06-27;1098;4356;625029;405483;49.4;32.1
38;2021-06-28;2951;10304;627980;415787;49.6;32.9
38;2021-06-29;3785;10451;631765;426238;49.9;33.7
38;2021-06-30;4061;9945;635826;436183;50.3;34.5
38;2021-07-01;3548;9012;639374;445195;50.5;35.2
38;2021-07-02;3726;11617;643100;456812;50.8;36.1
38;2021-07-03;1739;8788;644839;465600;51.0;36.8
38;2021-07-04;1244;3209;646083;468809;51.1;37.1
38;2021-07-05;3057;10545;649140;479354;51.3;37.9
38;2021-07-06;3460;10233;652600;489587;51.6;38.7
38;2021-07-07;3569;9400;656169;498987;51.9;39.4
38;2021-07-08;3549;8226;659718;507213;52.2;40.1
38;2021-07-09;3897;10738;663615;517951;52.5;40.9
38;2021-07-10;2405;7808;666020;525759;52.7;41.6
38;2021-07-11;776;2030;666796;527789;52.7;41.7
38;2021-07-12;3483;10678;670279;538467;53.0;42.6
38;2021-07-13;6600;10934;676879;549401;53.5;43.4
38;2021-07-14;4672;3333;681551;552734;53.9;43.7
38;2021-07-15;8735;9669;690286;562403;54.6;44.5
38;2021-07-16;8759;10704;699045;573107;55.3;45.3
38;2021-07-17;4739;7487;703784;580594;55.6;45.9
38;2021-07-18;2570;2489;706354;583083;55.8;46.1
38;2021-07-19;5824;9223;712178;592306;56.3;46.8
38;2021-07-20;6289;8305;718467;600611;56.8;47.5
38;2021-07-21;7866;8029;726333;608640;57.4;48.1
38;2021-07-22;7598;6998;733931;615638;58.0;48.7
38;2021-07-23;8944;9048;742875;624686;58.7;49.4
38;2021-07-24;5576;5535;748451;630221;59.2;49.8
38;2021-07-25;2867;1656;751318;631877;59.4;50.0
38;2021-07-26;7870;7500;759188;639377;60.0;50.5
38;2021-07-27;7628;6276;766816;645653;60.6;51.0
38;2021-07-28;8622;5718;775438;651371;61.3;51.5
38;2021-07-29;7684;4685;783122;656056;61.9;51.9
38;2021-07-30;7812;6666;790934;662722;62.5;52.4
38;2021-07-31;4359;3606;795293;666328;62.9;52.7
38;2021-08-01;1298;1084;796591;667412;63.0;52.8
38;2021-08-02;3944;4453;800535;671865;63.3;53.1
38;2021-08-03;4592;4558;805127;676423;63.6;53.5
38;2021-08-04;4639;4356;809766;680779;64.0;53.8
38;2021-08-05;3742;4641;813508;685420;64.3;54.2
38;2021-08-06;4158;5950;817666;691370;64.6;54.7
38;2021-08-07;2319;3532;819985;694902;64.8;54.9
38;2021-08-08;791;2015;820776;696917;64.9;55.1
38;2021-08-09;3612;5576;824388;702493;65.2;55.5
38;2021-08-10;4929;6255;829317;708748;65.6;56.0
38;2021-08-11;3979;4666;833296;713414;65.9;56.4
38;2021-08-12;3404;4608;836700;718022;66.1;56.8
38;2021-08-13;4206;6033;840906;724055;66.5;57.2
38;2021-08-14;1786;4020;842692;728075;66.6;57.6
38;2021-08-15;538;1917;843230;729992;66.7;57.7
38;2021-08-16;2979;7924;846209;737916;66.9;58.3
38;2021-08-17;3446;5962;849655;743878;67.2;58.8
38;2021-08-18;2995;7142;852650;751020;67.4;59.4
38;2021-08-19;2617;4830;855267;755850;67.6;59.8
38;2021-08-20;2911;8431;858178;764281;67.8;60.4
38;2021-08-21;1206;5015;859384;769296;67.9;60.8
38;2021-08-22;511;1510;859895;770806;68.0;60.9
38;2021-08-23;2592;7625;862487;778431;68.2;61.5
38;2021-08-24;2569;5331;865056;783762;68.4;62.0
38;2021-08-25;2617;5876;867673;789638;68.6;62.4
38;2021-08-26;2282;4244;869955;793882;68.8;62.8
38;2021-08-27;2505;5932;872460;799814;69.0;63.2
38;2021-08-28;1425;3688;873885;803502;69.1;63.5
38;2021-08-29;377;1085;874262;804587;69.1;63.6
38;2021-08-30;2335;5677;876597;810264;69.3;64.1
38;2021-08-31;2226;4591;878823;814855;69.5;64.4
38;2021-09-01;2216;4054;881039;818909;69.6;64.7
38;2021-09-02;1683;3026;882722;821935;69.8;65.0
38;2021-09-03;2079;4583;884801;826518;69.9;65.3
38;2021-09-04;1154;2659;885955;829177;70.0;65.5
38;2021-09-05;390;664;886345;829841;70.1;65.6
38;2021-09-06;1207;2965;887552;832806;70.2;65.8
38;2021-09-07;1320;2880;888872;835686;70.3;66.1
38;2021-09-08;1751;3256;890623;838942;70.4;66.3
38;2021-09-09;1132;1970;891755;840912;70.5;66.5
38;2021-09-10;1598;3273;893353;844185;70.6;66.7
38;2021-09-11;1041;2268;894394;846453;70.7;66.9
38;2021-09-12;218;525;894612;846978;70.7;67.0
38;2021-09-13;937;2137;895549;849115;70.8;67.1
38;2021-09-14;923;1870;896472;850985;70.9;67.3
38;2021-09-15;1334;2762;897806;853747;71.0;67.5
38;2021-09-16;720;1559;898526;855306;71.0;67.6
38;2021-09-17;894;2501;899420;857807;71.1;67.8
38;2021-09-18;710;2222;900130;860029;71.2;68.0
38;2021-09-19;104;371;900234;860400;71.2;68.0
38;2021-09-20;634;1722;900868;862122;71.2;68.2
38;2021-09-21;534;1400;901402;863522;71.3;68.3
38;2021-09-22;707;2733;902109;866255;71.3;68.5
38;2021-09-23;467;1399;902576;867654;71.4;68.6
38;2021-09-24;773;2195;903349;869849;71.4;68.8
38;2021-09-25;500;1935;903849;871784;71.5;68.9
38;2021-09-26;95;382;903944;872166;71.5;68.9
38;2021-09-27;429;1227;904373;873393;71.5;69.0
38;2021-09-28;509;1116;904882;874509;71.5;69.1
38;2021-09-29;681;1906;905563;876415;71.6;69.3
38;2021-09-30;444;827;906007;877242;71.6;69.3
38;2021-10-01;612;1391;906619;878633;71.7;69.5
38;2021-10-02;481;1165;907100;879798;71.7;69.6
38;2021-10-03;94;193;907194;879991;71.7;69.6
38;2021-10-04;460;954;907654;880945;71.8;69.6
38;2021-10-05;408;870;908062;881815;71.8;69.7
38;2021-10-06;620;1250;908682;883065;71.8;69.8
38;2021-10-07;412;872;909094;883937;71.9;69.9
38;2021-10-08;664;1291;909758;885228;71.9;70.0
38;2021-10-09;506;871;910264;886099;72.0;70.0
38;2021-10-10;40;108;910304;886207;72.0;70.1
38;2021-10-11;378;792;910682;886999;72.0;70.1
38;2021-10-12;469;619;911151;887618;72.0;70.2
38;2021-10-13;550;978;911701;888596;72.1;70.2
38;2021-10-14;384;566;912085;889162;72.1;70.3
38;2021-10-15;569;1064;912654;890226;72.1;70.4
38;2021-10-16;420;614;913074;890840;72.2;70.4
38;2021-10-17;16;7;913090;890847;72.2;70.4
38;2021-10-18;375;554;913465;891401;72.2;70.5
38;2021-10-19;407;548;913872;891949;72.2;70.5
39;2020-12-27;0;0;0;0;0.0;0.0
39;2020-12-28;0;0;0;0;0.0;0.0
39;2020-12-29;0;0;0;0;0.0;0.0
39;2020-12-30;0;0;0;0;0.0;0.0
39;2020-12-31;0;0;0;0;0.0;0.0
39;2021-01-01;0;0;0;0;0.0;0.0
39;2021-01-02;0;0;0;0;0.0;0.0
39;2021-01-03;0;0;0;0;0.0;0.0
39;2021-01-04;3;0;3;0;0.0;0.0
39;2021-01-05;3;0;6;0;0.0;0.0
39;2021-01-06;57;3;63;3;0.0;0.0
39;2021-01-07;333;3;396;6;0.2;0.0
39;2021-01-08;657;2;1053;8;0.4;0.0
39;2021-01-09;169;0;1222;8;0.5;0.0
39;2021-01-10;1;0;1223;8;0.5;0.0
39;2021-01-11;474;1;1697;9;0.7;0.0
39;2021-01-12;431;1;2128;10;0.8;0.0
39;2021-01-13;408;2;2536;12;1.0;0.0
39;2021-01-14;575;4;3111;16;1.2;0.0
39;2021-01-15;471;2;3582;18;1.4;0.0
39;2021-01-16;141;1;3723;19;1.4;0.0
39;2021-01-17;0;1;3723;20;1.4;0.0
39;2021-01-18;924;7;4647;27;1.8;0.0
39;2021-01-19;1180;7;5827;34;2.3;0.0
39;2021-01-20;905;4;6732;38;2.6;0.0
39;2021-01-21;1179;2;7911;40;3.1;0.0
39;2021-01-22;985;3;8896;43;3.5;0.0
39;2021-01-23;383;1;9279;44;3.6;0.0
39;2021-01-24;0;0;9279;44;3.6;0.0
39;2021-01-25;642;2;9921;46;3.8;0.0
39;2021-01-26;1123;13;11044;59;4.3;0.0
39;2021-01-27;928;19;11972;78;4.6;0.0
39;2021-01-28;741;242;12713;320;4.9;0.1
39;2021-01-29;583;424;13296;744;5.2;0.3
39;2021-01-30;264;110;13560;854;5.3;0.3
39;2021-01-31;1;0;13561;854;5.3;0.3
39;2021-02-01;561;263;14122;1117;5.5;0.4
39;2021-02-02;754;321;14876;1438;5.8;0.6
39;2021-02-03;531;515;15407;1953;6.0;0.8
39;2021-02-04;556;462;15963;2415;6.2;0.9
39;2021-02-05;438;429;16401;2844;6.4;1.1
39;2021-02-06;265;111;16666;2955;6.5;1.1
39;2021-02-07;0;1;16666;2956;6.5;1.1
39;2021-02-08;321;374;16987;3330;6.6;1.3
39;2021-02-09;383;483;17370;3813;6.7;1.5
39;2021-02-10;254;336;17624;4149;6.8;1.6
39;2021-02-11;586;511;18210;4660;7.1;1.8
39;2021-02-12;385;417;18595;5077;7.2;2.0
39;2021-02-13;100;69;18695;5146;7.3;2.0
39;2021-02-14;0;0;18695;5146;7.3;2.0
39;2021-02-15;99;756;18794;5902;7.3;2.3
39;2021-02-16;99;910;18893;6812;7.3;2.6
39;2021-02-17;58;694;18951;7506;7.3;2.9
39;2021-02-18;109;864;19060;8370;7.4;3.2
39;2021-02-19;100;485;19160;8855;7.4;3.4
39;2021-02-20;18;364;19178;9219;7.4;3.6
39;2021-02-21;0;0;19178;9219;7.4;3.6
39;2021-02-22;100;729;19278;9948;7.5;3.9
39;2021-02-23;4;764;19282;10712;7.5;4.2
39;2021-02-24;125;869;19407;11581;7.5;4.5
39;2021-02-25;214;753;19621;12334;7.6;4.8
39;2021-02-26;218;470;19839;12804;7.7;5.0
39;2021-02-27;169;298;20008;13102;7.8;5.1
39;2021-02-28;1;0;20009;13102;7.8;5.1
39;2021-03-01;218;639;20227;13741;7.8;5.3
39;2021-03-02;329;826;20556;14567;8.0;5.6
39;2021-03-03;602;534;21158;15101;8.2;5.9
39;2021-03-04;658;486;21816;15587;8.5;6.0
39;2021-03-05;670;332;22486;15919;8.7;6.2
39;2021-03-06;775;250;23261;16169;9.0;6.3
39;2021-03-07;242;84;23503;16253;9.1;6.3
39;2021-03-08;285;449;23788;16702;9.2;6.5
39;2021-03-09;844;467;24632;17169;9.6;6.7
39;2021-03-10;985;343;25617;17512;9.9;6.8
39;2021-03-11;829;469;26446;17981;10.3;7.0
39;2021-03-12;804;292;27250;18273;10.6;7.1
39;2021-03-13;789;105;28039;18378;10.9;7.1
39;2021-03-14;35;10;28074;18388;10.9;7.1
39;2021-03-15;513;112;28587;18500;11.1;7.2
39;2021-03-16;555;56;29142;18556;11.3;7.2
39;2021-03-17;611;57;29753;18613;11.5;7.2
39;2021-03-18;600;73;30353;18686;11.8;7.2
39;2021-03-19;393;72;30746;18758;11.9;7.3
39;2021-03-20;312;12;31058;18770;12.0;7.3
39;2021-03-21;3;0;31061;18770;12.0;7.3
39;2021-03-22;755;118;31816;18888;12.3;7.3
39;2021-03-23;1129;46;32945;18934;12.8;7.3
39;2021-03-24;1179;102;34124;19036;13.2;7.4
39;2021-03-25;2042;135;36166;19171;14.0;7.4
39;2021-03-26;797;116;36963;19287;14.3;7.5
39;2021-03-27;345;7;37308;19294;14.5;7.5
39;2021-03-28;36;4;37344;19298;14.5;7.5
39;2021-03-29;1036;198;38380;19496;14.9;7.6
39;2021-03-30;1401;271;39781;19767;15.4;7.7
39;2021-03-31;658;531;40439;20298;15.7;7.9
39;2021-04-01;1311;319;41750;20617;16.2;8.0
39;2021-04-02;626;131;42376;20748;16.4;8.0
39;2021-04-03;180;8;42556;20756;16.5;8.0
39;2021-04-04;4;1;42560;20757;16.5;8.1
39;2021-04-05;1;0;42561;20757;16.5;8.1
39;2021-04-06;824;633;43385;21390;16.8;8.3
39;2021-04-07;1134;685;44519;22075;17.3;8.6
39;2021-04-08;1790;583;46309;22658;18.0;8.8
39;2021-04-09;1675;294;47984;22952;18.6;8.9
39;2021-04-10;348;188;48332;23140;18.7;9.0
39;2021-04-11;2;0;48334;23140;18.7;9.0
39;2021-04-12;680;400;49014;23540;19.0;9.1
39;2021-04-13;1200;583;50214;24123;19.5;9.4
39;2021-04-14;845;641;51059;24764;19.8;9.6
39;2021-04-15;1479;722;52538;25486;20.4;9.9
39;2021-04-16;1090;176;53628;25662;20.8;10.0
39;2021-04-17;197;61;53825;25723;20.9;10.0
39;2021-04-18;0;0;53825;25723;20.9;10.0
39;2021-04-19;523;699;54348;26422;21.1;10.2
39;2021-04-20;766;548;55114;26970;21.4;10.5
39;2021-04-21;1142;724;56256;27694;21.8;10.7
39;2021-04-22;1012;1132;57268;28826;22.2;11.2
39;2021-04-23;457;364;57725;29190;22.4;11.3
39;2021-04-24;275;149;58000;29339;22.5;11.4
39;2021-04-25;12;3;58012;29342;22.5;11.4
39;2021-04-26;568;1041;58580;30383;22.7;11.8
39;2021-04-27;788;984;59368;31367;23.0;12.2
39;2021-04-28;1720;419;61088;31786;23.7;12.3
39;2021-04-29;2570;976;63658;32762;24.7;12.7
39;2021-04-30;2473;394;66131;33156;25.6;12.9
39;2021-05-01;41;53;66172;33209;25.7;12.9
39;2021-05-02;0;0;66172;33209;25.7;12.9
39;2021-05-03;917;812;67089;34021;26.0;13.2
39;2021-05-04;948;1128;68037;35149;26.4;13.6
39;2021-05-05;1955;893;69992;36042;27.1;14.0
39;2021-05-06;2425;1349;72417;37391;28.1;14.5
39;2021-05-07;1286;576;73703;37967;28.6;14.7
39;2021-05-08;179;55;73882;38022;28.7;14.7
39;2021-05-09;10;8;73892;38030;28.7;14.7
39;2021-05-10;1762;853;75654;38883;29.3;15.1
39;2021-05-11;1774;1515;77428;40398;30.0;15.7
39;2021-05-12;1810;1500;79238;41898;30.7;16.2
39;2021-05-13;246;23;79484;41921;30.8;16.3
39;2021-05-14;2392;335;81876;42256;31.8;16.4
39;2021-05-15;1848;256;83724;42512;32.5;16.5
39;2021-05-16;0;0;83724;42512;32.5;16.5
39;2021-05-17;1986;726;85710;43238;33.2;16.8
39;2021-05-18;1690;1180;87400;44418;33.9;17.2
39;2021-05-19;2496;558;89896;44976;34.9;17.4
39;2021-05-20;2466;756;92362;45732;35.8;17.7
39;2021-05-21;1800;561;94162;46293;36.5;18.0
39;2021-05-22;322;218;94484;46511;36.6;18.0
39;2021-05-23;8;36;94492;46547;36.6;18.1
39;2021-05-24;8;28;94500;46575;36.6;18.1
39;2021-05-25;1725;1197;96225;47772;37.3;18.5
39;2021-05-26;1643;1377;97868;49149;38.0;19.1
39;2021-05-27;1485;1624;99353;50773;38.5;19.7
39;2021-05-28;856;1220;100209;51993;38.9;20.2
39;2021-05-29;261;276;100470;52269;39.0;20.3
39;2021-05-30;2;40;100472;52309;39.0;20.3
39;2021-05-31;1625;1245;102097;53554;39.6;20.8
39;2021-06-01;1893;1321;103990;54875;40.3;21.3
39;2021-06-02;1705;1167;105695;56042;41.0;21.7
39;2021-06-03;1326;1160;107021;57202;41.5;22.2
39;2021-06-04;940;1073;107961;58275;41.9;22.6
39;2021-06-05;766;516;108727;58791;42.2;22.8
39;2021-06-06;1;36;108728;58827;42.2;22.8
39;2021-06-07;2106;918;110834;59745;43.0;23.2
39;2021-06-08;2208;1155;113042;60900;43.8;23.6
39;2021-06-09;1733;1240;114775;62140;44.5;24.1
39;2021-06-10;1616;2080;116391;64220;45.1;24.9
39;2021-06-11;1568;1270;117959;65490;45.7;25.4
39;2021-06-12;1264;350;119223;65840;46.2;25.5
39;2021-06-13;11;18;119234;65858;46.2;25.5
39;2021-06-14;1335;1894;120569;67752;46.8;26.3
39;2021-06-15;1386;1259;121955;69011;47.3;26.8
39;2021-06-16;1171;1536;123126;70547;47.8;27.4
39;2021-06-17;1044;1718;124170;72265;48.2;28.0
39;2021-06-18;1638;1180;125808;73445;48.8;28.5
39;2021-06-19;249;411;126057;73856;48.9;28.6
39;2021-06-20;2;18;126059;73874;48.9;28.7
39;2021-06-21;351;2495;126410;76369;49.0;29.6
39;2021-06-22;816;2295;127226;78664;49.3;30.5
39;2021-06-23;1200;1301;128426;79965;49.8;31.0
39;2021-06-24;736;1044;129162;81009;50.1;31.4
39;2021-06-25;679;2961;129841;83970;50.4;32.6
39;2021-06-26;206;1564;130047;85534;50.4;33.2
39;2021-06-27;0;0;130047;85534;50.4;33.2
39;2021-06-28;305;2743;130352;88277;50.6;34.2
39;2021-06-29;497;2697;130849;90974;50.7;35.3
39;2021-06-30;895;2426;131744;93400;51.1;36.2
39;2021-07-01;645;1939;132389;95339;51.3;37.0
39;2021-07-02;1111;1406;133500;96745;51.8;37.5
39;2021-07-03;554;524;134054;97269;52.0;37.7
39;2021-07-04;2;1;134056;97270;52.0;37.7
39;2021-07-05;601;2589;134657;99859;52.2;38.7
39;2021-07-06;835;1887;135492;101746;52.5;39.5
39;2021-07-07;591;1389;136083;103135;52.8;40.0
39;2021-07-08;700;906;136783;104041;53.0;40.3
39;2021-07-09;1078;1585;137861;105626;53.5;41.0
39;2021-07-10;739;476;138600;106102;53.8;41.1
39;2021-07-11;28;8;138628;106110;53.8;41.2
39;2021-07-12;577;2599;139205;108709;54.0;42.2
39;2021-07-13;1638;2660;140843;111369;54.6;43.2
39;2021-07-14;17;21;140860;111390;54.6;43.2
39;2021-07-15;1906;1837;142766;113227;55.4;43.9
39;2021-07-16;3226;2053;145992;115280;56.6;44.7
39;2021-07-17;2225;1163;148217;116443;57.5;45.2
39;2021-07-18;164;52;148381;116495;57.5;45.2
39;2021-07-19;1399;2953;149780;119448;58.1;46.3
39;2021-07-20;1842;2813;151622;122261;58.8;47.4
39;2021-07-21;2587;2583;154209;124844;59.8;48.4
39;2021-07-22;1934;1845;156143;126689;60.6;49.1
39;2021-07-23;1813;1933;157956;128622;61.3;49.9
39;2021-07-24;1400;1428;159356;130050;61.8;50.4
39;2021-07-25;0;1;159356;130051;61.8;50.4
39;2021-07-26;1318;2001;160674;132052;62.3;51.2
39;2021-07-27;2343;1905;163017;133957;63.2;52.0
39;2021-07-28;2688;1475;165705;135432;64.3;52.5
39;2021-07-29;2200;1743;167905;137175;65.1;53.2
39;2021-07-30;2045;1466;169950;138641;65.9;53.8
39;2021-07-31;1367;657;171317;139298;66.4;54.0
39;2021-08-01;10;18;171327;139316;66.4;54.0
39;2021-08-02;1205;1401;172532;140717;66.9;54.6
39;2021-08-03;1920;1486;174452;142203;67.7;55.1
39;2021-08-04;1047;659;175499;142862;68.1;55.4
39;2021-08-05;1242;740;176741;143602;68.5;55.7
39;2021-08-06;1375;2289;178116;145891;69.1;56.6
39;2021-08-07;1069;1213;179185;147104;69.5;57.1
39;2021-08-08;26;10;179211;147114;69.5;57.1
39;2021-08-09;436;304;179647;147418;69.7;57.2
39;2021-08-10;1230;932;180877;148350;70.1;57.5
39;2021-08-11;893;1532;181770;149882;70.5;58.1
39;2021-08-12;1596;2171;183366;152053;71.1;59.0
39;2021-08-13;1334;2119;184700;154172;71.6;59.8
39;2021-08-14;361;1106;185061;155278;71.8;60.2
39;2021-08-15;1;1;185062;155279;71.8;60.2
39;2021-08-16;488;736;185550;156015;72.0;60.5
39;2021-08-17;574;1443;186124;157458;72.2;61.1
39;2021-08-18;862;1727;186986;159185;72.5;61.7
39;2021-08-19;906;1593;187892;160778;72.9;62.4
39;2021-08-20;640;2500;188532;163278;73.1;63.3
39;2021-08-21;467;1291;188999;164569;73.3;63.8
39;2021-08-22;7;11;189006;164580;73.3;63.8
39;2021-08-23;267;972;189273;165552;73.4;64.2
39;2021-08-24;456;1607;189729;167159;73.6;64.8
39;2021-08-25;631;1604;190360;168763;73.8;65.5
39;2021-08-26;718;1860;191078;170623;74.1;66.2
39;2021-08-27;405;2060;191483;172683;74.3;67.0
39;2021-08-28;325;1371;191808;174054;74.4;67.5
39;2021-08-29;0;1;191808;174055;74.4;67.5
39;2021-08-30;345;1009;192153;175064;74.5;67.9
39;2021-08-31;399;1006;192552;176070;74.7;68.3
39;2021-09-01;512;1425;193064;177495;74.9;68.8
39;2021-09-02;333;1369;193397;178864;75.0;69.4
39;2021-09-03;478;2248;193875;181112;75.2;70.2
39;2021-09-04;148;183;194023;181295;75.2;70.3
39;2021-09-05;0;1;194023;181296;75.2;70.3
39;2021-09-06;244;481;194267;181777;75.3;70.5
39;2021-09-07;228;253;194495;182030;75.4;70.6
39;2021-09-08;441;677;194936;182707;75.6;70.9
39;2021-09-09;439;843;195375;183550;75.8;71.2
39;2021-09-10;198;586;195573;184136;75.8;71.4
39;2021-09-11;282;817;195855;184953;76.0;71.7
39;2021-09-12;1;32;195856;184985;76.0;71.7
39;2021-09-13;143;150;195999;185135;76.0;71.8
39;2021-09-14;182;297;196181;185432;76.1;71.9
39;2021-09-15;267;585;196448;186017;76.2;72.1
39;2021-09-16;476;1053;196924;187070;76.4;72.6
39;2021-09-17;424;671;197348;187741;76.5;72.8
39;2021-09-18;96;237;197444;187978;76.6;72.9
39;2021-09-19;3;3;197447;187981;76.6;72.9
39;2021-09-20;70;128;197517;188109;76.6;73.0
39;2021-09-21;87;125;197604;188234;76.6;73.0
39;2021-09-22;270;781;197874;189015;76.7;73.3
39;2021-09-23;175;312;198049;189327;76.8;73.4
39;2021-09-24;206;584;198255;189911;76.9;73.7
39;2021-09-25;66;250;198321;190161;76.9;73.7
39;2021-09-26;0;0;198321;190161;76.9;73.7
39;2021-09-27;131;318;198452;190479;77.0;73.9
39;2021-09-28;55;139;198507;190618;77.0;73.9
39;2021-09-29;195;511;198702;191129;77.1;74.1
39;2021-09-30;202;448;198904;191577;77.1;74.3
39;2021-10-01;104;199;199008;191776;77.2;74.4
39;2021-10-02;97;227;199105;192003;77.2;74.5
39;2021-10-03;2;1;199107;192004;77.2;74.5
39;2021-10-04;40;131;199147;192135;77.2;74.5
39;2021-10-05;56;125;199203;192260;77.3;74.6
39;2021-10-06;183;347;199386;192607;77.3;74.7
39;2021-10-07;135;465;199521;193072;77.4;74.9
39;2021-10-08;226;496;199747;193568;77.5;75.1
39;2021-10-09;49;47;199796;193615;77.5;75.1
39;2021-10-10;0;1;199796;193616;77.5;75.1
39;2021-10-11;16;53;199812;193669;77.5;75.1
39;2021-10-12;83;93;199895;193762;77.5;75.1
39;2021-10-13;86;152;199981;193914;77.6;75.2
39;2021-10-14;143;226;200124;194140;77.6;75.3
39;2021-10-15;346;465;200470;194605;77.7;75.5
39;2021-10-16;37;63;200507;194668;77.8;75.5
39;2021-10-17;0;3;200507;194671;77.8;75.5
39;2021-10-18;24;26;200531;194697;77.8;75.5
39;2021-10-19;54;58;200585;194755;77.8;75.5
40;2020-12-27;0;0;0;0;0.0;0.0
40;2020-12-28;0;0;0;0;0.0;0.0
40;2020-12-29;0;0;0;0;0.0;0.0
40;2020-12-30;0;0;0;0;0.0;0.0
40;2020-12-31;1;0;1;0;0.0;0.0
40;2021-01-01;0;0;1;0;0.0;0.0
40;2021-01-02;1;0;2;0;0.0;0.0
40;2021-01-03;0;0;2;0;0.0;0.0
40;2021-01-04;0;0;2;0;0.0;0.0
40;2021-01-05;0;0;2;0;0.0;0.0
40;2021-01-06;1;0;3;0;0.0;0.0
40;2021-01-07;212;0;215;0;0.1;0.0
40;2021-01-08;391;4;606;4;0.1;0.0
40;2021-01-09;0;0;606;4;0.1;0.0
40;2021-01-10;1;0;607;4;0.1;0.0
40;2021-01-11;111;0;718;4;0.2;0.0
40;2021-01-12;0;0;718;4;0.2;0.0
40;2021-01-13;681;6;1399;10;0.3;0.0
40;2021-01-14;901;9;2300;19;0.6;0.0
40;2021-01-15;811;4;3111;23;0.8;0.0
40;2021-01-16;157;0;3268;23;0.8;0.0
40;2021-01-17;1;1;3269;24;0.8;0.0
40;2021-01-18;406;0;3675;24;0.9;0.0
40;2021-01-19;1203;4;4878;28;1.2;0.0
40;2021-01-20;881;2;5759;30;1.4;0.0
40;2021-01-21;1265;6;7024;36;1.7;0.0
40;2021-01-22;811;2;7835;38;1.9;0.0
40;2021-01-23;289;0;8124;38;2.0;0.0
40;2021-01-24;2;0;8126;38;2.0;0.0
40;2021-01-25;394;2;8520;40;2.1;0.0
40;2021-01-26;802;6;9322;46;2.3;0.0
40;2021-01-27;1118;12;10440;58;2.5;0.0
40;2021-01-28;709;112;11149;170;2.7;0.0
40;2021-01-29;601;230;11750;400;2.9;0.1
40;2021-01-30;237;4;11987;404;2.9;0.1
40;2021-01-31;1;0;11988;404;2.9;0.1
40;2021-02-01;359;132;12347;536;3.0;0.1
40;2021-02-02;922;52;13269;588;3.2;0.1
40;2021-02-03;895;300;14164;888;3.4;0.2
40;2021-02-04;1059;602;15223;1490;3.7;0.4
40;2021-02-05;794;422;16017;1912;3.9;0.5
40;2021-02-06;382;84;16399;1996;4.0;0.5
40;2021-02-07;10;0;16409;1996;4.0;0.5
40;2021-02-08;375;121;16784;2117;4.1;0.5
40;2021-02-09;815;541;17599;2658;4.3;0.6
40;2021-02-10;749;469;18348;3127;4.5;0.8
40;2021-02-11;739;682;19087;3809;4.6;0.9
40;2021-02-12;627;641;19714;4450;4.8;1.1
40;2021-02-13;400;94;20114;4544;4.9;1.1
40;2021-02-14;0;0;20114;4544;4.9;1.1
40;2021-02-15;48;385;20162;4929;4.9;1.2
40;2021-02-16;284;600;20446;5529;5.0;1.3
40;2021-02-17;359;891;20805;6420;5.1;1.6
40;2021-02-18;383;694;21188;7114;5.1;1.7
40;2021-02-19;145;643;21333;7757;5.2;1.9
40;2021-02-20;39;94;21372;7851;5.2;1.9
40;2021-02-21;1;66;21373;7917;5.2;1.9
40;2021-02-22;53;561;21426;8478;5.2;2.1
40;2021-02-23;180;835;21606;9313;5.2;2.3
40;2021-02-24;284;684;21890;9997;5.3;2.4
40;2021-02-25;726;989;22616;10986;5.5;2.7
40;2021-02-26;656;632;23272;11618;5.6;2.8
40;2021-02-27;384;101;23656;11719;5.7;2.8
40;2021-02-28;2;0;23658;11719;5.7;2.8
40;2021-03-01;418;509;24076;12228;5.8;3.0
40;2021-03-02;733;1040;24809;13268;6.0;3.2
40;2021-03-03;934;910;25743;14178;6.2;3.4
40;2021-03-04;1326;828;27069;15006;6.6;3.6
40;2021-03-05;1233;741;28302;15747;6.9;3.8
40;2021-03-06;868;393;29170;16140;7.1;3.9
40;2021-03-07;93;10;29263;16150;7.1;3.9
40;2021-03-08;838;504;30101;16654;7.3;4.0
40;2021-03-09;1507;642;31608;17296;7.7;4.2
40;2021-03-10;1754;717;33362;18013;8.1;4.4
40;2021-03-11;1986;698;35348;18711;8.6;4.5
40;2021-03-12;2051;551;37399;19262;9.1;4.7
40;2021-03-13;972;255;38371;19517;9.3;4.7
40;2021-03-14;98;0;38469;19517;9.3;4.7
40;2021-03-15;924;88;39393;19605;9.6;4.8
40;2021-03-16;989;275;40382;19880;9.8;4.8
40;2021-03-17;1577;349;41959;20229;10.2;4.9
40;2021-03-18;1559;340;43518;20569;10.6;5.0
40;2021-03-19;1808;146;45326;20715;11.0;5.0
40;2021-03-20;706;15;46032;20730;11.2;5.0
40;2021-03-21;52;1;46084;20731;11.2;5.0
40;2021-03-22;1174;35;47258;20766;11.5;5.0
40;2021-03-23;2325;170;49583;20936;12.0;5.1
40;2021-03-24;2327;232;51910;21168;12.6;5.1
40;2021-03-25;2768;384;54678;21552;13.3;5.2
40;2021-03-26;3123;212;57801;21764;14.0;5.3
40;2021-03-27;923;49;58724;21813;14.3;5.3
40;2021-03-28;178;47;58902;21860;14.3;5.3
40;2021-03-29;1153;382;60055;22242;14.6;5.4
40;2021-03-30;2298;390;62353;22632;15.1;5.5
40;2021-03-31;1997;309;64350;22941;15.6;5.6
40;2021-04-01;2413;335;66763;23276;16.2;5.6
40;2021-04-02;2361;222;69124;23498;16.8;5.7
40;2021-04-03;741;122;69865;23620;17.0;5.7
40;2021-04-04;363;9;70228;23629;17.0;5.7
40;2021-04-05;523;40;70751;23669;17.2;5.7
40;2021-04-06;2095;809;72846;24478;17.7;5.9
40;2021-04-07;2664;877;75510;25355;18.3;6.2
40;2021-04-08;3064;901;78574;26256;19.1;6.4
40;2021-04-09;3826;612;82400;26868;20.0;6.5
40;2021-04-10;1600;343;84000;27211;20.4;6.6
40;2021-04-11;52;6;84052;27217;20.4;6.6
40;2021-04-12;2179;736;86231;27953;20.9;6.8
40;2021-04-13;2567;1092;88798;29045;21.6;7.1
40;2021-04-14;2571;1377;91369;30422;22.2;7.4
40;2021-04-15;2987;1516;94356;31938;22.9;7.8
40;2021-04-16;2878;1185;97234;33123;23.6;8.0
40;2021-04-17;1464;348;98698;33471;24.0;8.1
40;2021-04-18;57;24;98755;33495;24.0;8.1
40;2021-04-19;1056;1023;99811;34518;24.2;8.4
40;2021-04-20;1622;1745;101433;36263;24.6;8.8
40;2021-04-21;1777;1740;103210;38003;25.1;9.2
40;2021-04-22;2112;1776;105322;39779;25.6;9.7
40;2021-04-23;2163;1398;107485;41177;26.1;10.0
40;2021-04-24;1329;627;108814;41804;26.4;10.1
40;2021-04-25;37;56;108851;41860;26.4;10.2
40;2021-04-26;1252;1137;110103;42997;26.7;10.4
40;2021-04-27;1488;2033;111591;45030;27.1;10.9
40;2021-04-28;2052;1371;113643;46401;27.6;11.3
40;2021-04-29;2609;1900;116252;48301;28.2;11.7
40;2021-04-30;2700;1617;118952;49918;28.9;12.1
40;2021-05-01;1228;781;120180;50699;29.2;12.3
40;2021-05-02;143;323;120323;51022;29.2;12.4
40;2021-05-03;1857;1502;122180;52524;29.7;12.7
40;2021-05-04;1880;2467;124060;54991;30.1;13.3
40;2021-05-05;2186;2669;126246;57660;30.6;14.0
40;2021-05-06;2237;2866;128483;60526;31.2;14.7
40;2021-05-07;1902;3007;130385;63533;31.6;15.4
40;2021-05-08;675;469;131060;64002;31.8;15.5
40;2021-05-09;316;22;131376;64024;31.9;15.5
40;2021-05-10;1400;2057;132776;66081;32.2;16.0
40;2021-05-11;2196;2512;134972;68593;32.8;16.6
40;2021-05-12;2731;1945;137703;70538;33.4;17.1
40;2021-05-13;1985;515;139688;71053;33.9;17.2
40;2021-05-14;2324;1657;142012;72710;34.5;17.6
40;2021-05-15;1340;961;143352;73671;34.8;17.9
40;2021-05-16;434;24;143786;73695;34.9;17.9
40;2021-05-17;2118;1311;145904;75006;35.4;18.2
40;2021-05-18;2508;1416;148412;76422;36.0;18.5
40;2021-05-19;2954;1105;151366;77527;36.7;18.8
40;2021-05-20;3584;1163;154950;78690;37.6;19.1
40;2021-05-21;2925;1329;157875;80019;38.3;19.4
40;2021-05-22;1146;797;159021;80816;38.6;19.6
40;2021-05-23;631;29;159652;80845;38.8;19.6
40;2021-05-24;1212;332;160864;81177;39.0;19.7
40;2021-05-25;2168;1308;163032;82485;39.6;20.0
40;2021-05-26;2614;1563;165646;84048;40.2;20.4
40;2021-05-27;2733;2002;168379;86050;40.9;20.9
40;2021-05-28;2567;2275;170946;88325;41.5;21.4
40;2021-05-29;1558;1257;172504;89582;41.9;21.7
40;2021-05-30;4;52;172508;89634;41.9;21.8
40;2021-05-31;2568;1207;175076;90841;42.5;22.0
40;2021-06-01;3011;1770;178087;92611;43.2;22.5
40;2021-06-02;3170;1992;181257;94603;44.0;23.0
40;2021-06-03;3589;2330;184846;96933;44.9;23.5
40;2021-06-04;3015;2803;187861;99736;45.6;24.2
40;2021-06-05;1779;1395;189640;101131;46.0;24.5
40;2021-06-06;458;79;190098;101210;46.1;24.6
40;2021-06-07;2184;2025;192282;103235;46.7;25.1
40;2021-06-08;2954;2101;195236;105336;47.4;25.6
40;2021-06-09;3212;2266;198448;107602;48.2;26.1
40;2021-06-10;2994;2097;201442;109699;48.9;26.6
40;2021-06-11;3142;2799;204584;112498;49.7;27.3
40;2021-06-12;1963;1635;206547;114133;50.1;27.7
40;2021-06-13;645;162;207192;114295;50.3;27.7
40;2021-06-14;1457;2495;208649;116790;50.6;28.3
40;2021-06-15;2235;2818;210884;119608;51.2;29.0
40;2021-06-16;2608;2459;213492;122067;51.8;29.6
40;2021-06-17;2431;2439;215923;124506;52.4;30.2
40;2021-06-18;2326;2902;218249;127408;53.0;30.9
40;2021-06-19;1798;1229;220047;128637;53.4;31.2
40;2021-06-20;346;276;220393;128913;53.5;31.3
40;2021-06-21;1395;2318;221788;131231;53.8;31.9
40;2021-06-22;1689;2995;223477;134226;54.2;32.6
40;2021-06-23;1603;3343;225080;137569;54.6;33.4
40;2021-06-24;1733;2384;226813;139953;55.1;34.0
40;2021-06-25;1757;3264;228570;143217;55.5;34.8
40;2021-06-26;1328;1712;229898;144929;55.8;35.2
40;2021-06-27;263;354;230161;145283;55.9;35.3
40;2021-06-28;1334;2817;231495;148100;56.2;35.9
40;2021-06-29;1713;3393;233208;151493;56.6;36.8
40;2021-06-30;1776;3643;234984;155136;57.0;37.7
40;2021-07-01;1715;3954;236699;159090;57.5;38.6
40;2021-07-02;1560;3811;238259;162901;57.8;39.5
40;2021-07-03;676;1923;238935;164824;58.0;40.0
40;2021-07-04;219;483;239154;165307;58.1;40.1
40;2021-07-05;1477;3020;240631;168327;58.4;40.9
40;2021-07-06;1768;3613;242399;171940;58.8;41.7
40;2021-07-07;1973;3850;244372;175790;59.3;42.7
40;2021-07-08;2099;3409;246471;179199;59.8;43.5
40;2021-07-09;2108;3947;248579;183146;60.3;44.5
40;2021-07-10;1004;2155;249583;185301;60.6;45.0
40;2021-07-11;207;294;249790;185595;60.6;45.0
40;2021-07-12;1314;4047;251104;189642;61.0;46.0
40;2021-07-13;2428;4698;253532;194340;61.5;47.2
40;2021-07-14;2198;2061;255730;196401;62.1;47.7
40;2021-07-15;2842;4860;258572;201261;62.8;48.9
40;2021-07-16;3311;3944;261883;205205;63.6;49.8
40;2021-07-17;2110;2595;263993;207800;64.1;50.4
40;2021-07-18;472;543;264465;208343;64.2;50.6
40;2021-07-19;2565;3701;267030;212044;64.8;51.5
40;2021-07-20;3065;4052;270095;216096;65.6;52.5
40;2021-07-21;3203;3886;273298;219982;66.3;53.4
40;2021-07-22;3858;3934;277156;223916;67.3;54.4
40;2021-07-23;4092;4110;281248;228026;68.3;55.3
40;2021-07-24;2795;2113;284043;230139;68.9;55.9
40;2021-07-25;958;491;285001;230630;69.2;56.0
40;2021-07-26;2942;3076;287943;233706;69.9;56.7
40;2021-07-27;3526;3602;291469;237308;70.7;57.6
40;2021-07-28;3379;3398;294848;240706;71.6;58.4
40;2021-07-29;3546;3432;298394;244138;72.4;59.3
40;2021-07-30;3136;3405;301530;247543;73.2;60.1
40;2021-07-31;1781;1908;303311;249451;73.6;60.5
40;2021-08-01;342;287;303653;249738;73.7;60.6
40;2021-08-02;2006;2383;305659;252121;74.2;61.2
40;2021-08-03;2335;2697;307994;254818;74.8;61.9
40;2021-08-04;2094;2323;310088;257141;75.3;62.4
40;2021-08-05;1971;2668;312059;259809;75.7;63.1
40;2021-08-06;1886;3068;313945;262877;76.2;63.8
40;2021-08-07;1218;1746;315163;264623;76.5;64.2
40;2021-08-08;84;154;315247;264777;76.5;64.3
40;2021-08-09;1600;3124;316847;267901;76.9;65.0
40;2021-08-10;1430;3159;318277;271060;77.3;65.8
40;2021-08-11;1424;2844;319701;273904;77.6;66.5
40;2021-08-12;1277;3102;320978;277006;77.9;67.2
40;2021-08-13;1139;2980;322117;279986;78.2;68.0
40;2021-08-14;618;2033;322735;282019;78.3;68.5
40;2021-08-15;5;172;322740;282191;78.3;68.5
40;2021-08-16;1109;3382;323849;285573;78.6;69.3
40;2021-08-17;1161;3418;325010;288991;78.9;70.1
40;2021-08-18;989;3258;325999;292249;79.1;70.9
40;2021-08-19;857;2972;326856;295221;79.3;71.7
40;2021-08-20;811;3033;327667;298254;79.5;72.4
40;2021-08-21;523;1901;328190;300155;79.7;72.9
40;2021-08-22;71;464;328261;300619;79.7;73.0
40;2021-08-23;733;2818;328994;303437;79.9;73.7
40;2021-08-24;697;2540;329691;305977;80.0;74.3
40;2021-08-25;679;2002;330370;307979;80.2;74.8
40;2021-08-26;493;1674;330863;309653;80.3;75.2
40;2021-08-27;638;2467;331501;312120;80.5;75.8
40;2021-08-28;328;1215;331829;313335;80.5;76.1
40;2021-08-29;1;9;331830;313344;80.5;76.1
40;2021-08-30;602;2116;332432;315460;80.7;76.6
40;2021-08-31;471;1381;332903;316841;80.8;76.9
40;2021-09-01;502;1349;333405;318190;80.9;77.2
40;2021-09-02;426;1276;333831;319466;81.0;77.5
40;2021-09-03;447;1354;334278;320820;81.1;77.9
40;2021-09-04;368;1051;334646;321871;81.2;78.1
40;2021-09-05;4;10;334650;321881;81.2;78.1
40;2021-09-06;263;698;334913;322579;81.3;78.3
40;2021-09-07;305;773;335218;323352;81.4;78.5
40;2021-09-08;427;895;335645;324247;81.5;78.7
40;2021-09-09;271;718;335916;324965;81.5;78.9
40;2021-09-10;371;933;336287;325898;81.6;79.1
40;2021-09-11;250;755;336537;326653;81.7;79.3
40;2021-09-12;8;7;336545;326660;81.7;79.3
40;2021-09-13;473;597;337018;327257;81.8;79.4
40;2021-09-14;461;379;337479;327636;81.9;79.5
40;2021-09-15;505;899;337984;328535;82.0;79.7
40;2021-09-16;291;348;338275;328883;82.1;79.8
40;2021-09-17;430;788;338705;329671;82.2;80.0
40;2021-09-18;179;633;338884;330304;82.3;80.2
40;2021-09-19;0;9;338884;330313;82.3;80.2
40;2021-09-20;155;382;339039;330695;82.3;80.3
40;2021-09-21;153;288;339192;330983;82.3;80.3
40;2021-09-22;235;559;339427;331542;82.4;80.5
40;2021-09-23;171;299;339598;331841;82.4;80.5
40;2021-09-24;238;606;339836;332447;82.5;80.7
40;2021-09-25;135;427;339971;332874;82.5;80.8
40;2021-09-26;0;2;339971;332876;82.5;80.8
40;2021-09-27;86;224;340057;333100;82.5;80.9
40;2021-09-28;82;229;340139;333329;82.6;80.9
40;2021-09-29;207;586;340346;333915;82.6;81.1
40;2021-09-30;98;221;340444;334136;82.6;81.1
40;2021-10-01;228;440;340672;334576;82.7;81.2
40;2021-10-02;181;321;340853;334897;82.7;81.3
40;2021-10-03;0;2;340853;334899;82.7;81.3
40;2021-10-04;130;249;340983;335148;82.8;81.4
40;2021-10-05;79;206;341062;335354;82.8;81.4
40;2021-10-06;258;464;341320;335818;82.8;81.5
40;2021-10-07;98;198;341418;336016;82.9;81.6
40;2021-10-08;176;460;341594;336476;82.9;81.7
40;2021-10-09;140;212;341734;336688;82.9;81.7
40;2021-10-10;2;8;341736;336696;82.9;81.7
40;2021-10-11;70;255;341806;336951;83.0;81.8
40;2021-10-12;76;228;341882;337179;83.0;81.8
40;2021-10-13;226;463;342108;337642;83.0;82.0
40;2021-10-14;56;197;342164;337839;83.1;82.0
40;2021-10-15;152;395;342316;338234;83.1;82.1
40;2021-10-16;130;197;342446;338431;83.1;82.1
40;2021-10-17;0;2;342446;338433;83.1;82.1
40;2021-10-18;54;283;342500;338716;83.1;82.2
40;2021-10-19;88;243;342588;338959;83.2;82.3
41;2020-12-27;0;0;0;0;0.0;0.0
41;2020-12-28;0;0;0;0;0.0;0.0
41;2020-12-29;0;0;0;0;0.0;0.0
41;2020-12-30;0;0;0;0;0.0;0.0
41;2020-12-31;0;0;0;0;0.0;0.0
41;2021-01-01;0;0;0;0;0.0;0.0
41;2021-01-02;3;0;3;0;0.0;0.0
41;2021-01-03;0;0;3;0;0.0;0.0
41;2021-01-04;0;0;3;0;0.0;0.0
41;2021-01-05;35;0;38;0;0.0;0.0
41;2021-01-06;71;0;109;0;0.0;0.0
41;2021-01-07;21;0;130;0;0.0;0.0
41;2021-01-08;1;0;131;0;0.0;0.0
41;2021-01-09;0;0;131;0;0.0;0.0
41;2021-01-10;0;0;131;0;0.0;0.0
41;2021-01-11;133;0;264;0;0.1;0.0
41;2021-01-12;321;1;585;1;0.2;0.0
41;2021-01-13;271;0;856;1;0.3;0.0
41;2021-01-14;284;2;1140;3;0.3;0.0
41;2021-01-15;215;1;1355;4;0.4;0.0
41;2021-01-16;0;0;1355;4;0.4;0.0
41;2021-01-17;0;0;1355;4;0.4;0.0
41;2021-01-18;397;2;1752;6;0.5;0.0
41;2021-01-19;857;2;2609;8;0.8;0.0
41;2021-01-20;1059;5;3668;13;1.1;0.0
41;2021-01-21;1568;9;5236;22;1.6;0.0
41;2021-01-22;840;1;6076;23;1.9;0.0
41;2021-01-23;92;0;6168;23;1.9;0.0
41;2021-01-24;0;0;6168;23;1.9;0.0
41;2021-01-25;421;1;6589;24;2.0;0.0
41;2021-01-26;473;4;7062;28;2.2;0.0
41;2021-01-27;441;2;7503;30;2.3;0.0
41;2021-01-28;604;56;8107;86;2.5;0.0
41;2021-01-29;260;30;8367;116;2.6;0.0
41;2021-01-30;0;0;8367;116;2.6;0.0
41;2021-01-31;0;0;8367;116;2.6;0.0
41;2021-02-01;349;148;8716;264;2.7;0.1
41;2021-02-02;470;230;9186;494;2.8;0.2
41;2021-02-03;342;203;9528;697;2.9;0.2
41;2021-02-04;559;154;10087;851;3.1;0.3
41;2021-02-05;329;188;10416;1039;3.2;0.3
41;2021-02-06;5;0;10421;1039;3.2;0.3
41;2021-02-07;2;0;10423;1039;3.2;0.3
41;2021-02-08;305;306;10728;1345;3.3;0.4
41;2021-02-09;599;454;11327;1799;3.5;0.5
41;2021-02-10;486;695;11813;2494;3.6;0.8
41;2021-02-11;1067;1158;12880;3652;3.9;1.1
41;2021-02-12;688;361;13568;4013;4.1;1.2
41;2021-02-13;9;5;13577;4018;4.1;1.2
41;2021-02-14;3;27;13580;4045;4.1;1.2
41;2021-02-15;314;306;13894;4351;4.2;1.3
41;2021-02-16;354;567;14248;4918;4.3;1.5
41;2021-02-17;317;457;14565;5375;4.4;1.6
41;2021-02-18;617;326;15182;5701;4.6;1.7
41;2021-02-19;456;337;15638;6038;4.8;1.8
41;2021-02-20;68;58;15706;6096;4.8;1.9
41;2021-02-21;0;0;15706;6096;4.8;1.9
41;2021-02-22;311;414;16017;6510;4.9;2.0
41;2021-02-23;454;346;16471;6856;5.0;2.1
41;2021-02-24;284;442;16755;7298;5.1;2.2
41;2021-02-25;675;460;17430;7758;5.3;2.4
41;2021-02-26;630;253;18060;8011;5.5;2.4
41;2021-02-27;161;4;18221;8015;5.6;2.4
41;2021-02-28;4;31;18225;8046;5.6;2.5
41;2021-03-01;311;315;18536;8361;5.7;2.6
41;2021-03-02;650;410;19186;8771;5.9;2.7
41;2021-03-03;496;411;19682;9182;6.0;2.8
41;2021-03-04;785;840;20467;10022;6.2;3.1
41;2021-03-05;840;675;21307;10697;6.5;3.3
41;2021-03-06;715;23;22022;10720;6.7;3.3
41;2021-03-07;498;20;22520;10740;6.9;3.3
41;2021-03-08;301;376;22821;11116;7.0;3.4
41;2021-03-09;1043;452;23864;11568;7.3;3.5
41;2021-03-10;721;458;24585;12026;7.5;3.7
41;2021-03-11;1184;686;25769;12712;7.9;3.9
41;2021-03-12;1115;415;26884;13127;8.2;4.0
41;2021-03-13;1224;20;28108;13147;8.6;4.0
41;2021-03-14;392;7;28500;13154;8.7;4.0
41;2021-03-15;798;354;29298;13508;8.9;4.1
41;2021-03-16;1061;412;30359;13920;9.3;4.2
41;2021-03-17;586;240;30945;14160;9.4;4.3
41;2021-03-18;926;399;31871;14559;9.7;4.4
41;2021-03-19;910;335;32781;14894;10.0;4.5
41;2021-03-20;543;22;33324;14916;10.2;4.5
41;2021-03-21;1;0;33325;14916;10.2;4.5
41;2021-03-22;810;275;34135;15191;10.4;4.6
41;2021-03-23;1309;495;35444;15686;10.8;4.8
41;2021-03-24;1231;367;36675;16053;11.2;4.9
41;2021-03-25;2026;439;38701;16492;11.8;5.0
41;2021-03-26;1655;328;40356;16820;12.3;5.1
41;2021-03-27;451;58;40807;16878;12.4;5.1
41;2021-03-28;1;0;40808;16878;12.4;5.1
41;2021-03-29;939;310;41747;17188;12.7;5.2
41;2021-03-30;1496;599;43243;17787;13.2;5.4
41;2021-03-31;1148;497;44391;18284;13.5;5.6
41;2021-04-01;2252;567;46643;18851;14.2;5.8
41;2021-04-02;1242;475;47885;19326;14.6;5.9
41;2021-04-03;321;6;48206;19332;14.7;5.9
41;2021-04-04;39;0;48245;19332;14.7;5.9
41;2021-04-05;140;2;48385;19334;14.8;5.9
41;2021-04-06;1301;626;49686;19960;15.2;6.1
41;2021-04-07;1852;711;51538;20671;15.7;6.3
41;2021-04-08;2294;920;53832;21591;16.4;6.6
41;2021-04-09;2568;613;56400;22204;17.2;6.8
41;2021-04-10;954;498;57354;22702;17.5;6.9
41;2021-04-11;279;376;57633;23078;17.6;7.0
41;2021-04-12;1689;658;59322;23736;18.1;7.2
41;2021-04-13;2259;988;61581;24724;18.8;7.5
41;2021-04-14;1794;554;63375;25278;19.3;7.7
41;2021-04-15;2384;980;65759;26258;20.1;8.0
41;2021-04-16;1929;629;67688;26887;20.6;8.2
41;2021-04-17;647;138;68335;27025;20.8;8.2
41;2021-04-18;5;0;68340;27025;20.8;8.2
41;2021-04-19;1260;745;69600;27770;21.2;8.5
41;2021-04-20;2004;1203;71604;28973;21.8;8.8
41;2021-04-21;1502;920;73106;29893;22.3;9.1
41;2021-04-22;2236;1604;75342;31497;23.0;9.6
41;2021-04-23;1736;1081;77078;32578;23.5;9.9
41;2021-04-24;1544;283;78622;32861;24.0;10.0
41;2021-04-25;1007;21;79629;32882;24.3;10.0
41;2021-04-26;1354;625;80983;33507;24.7;10.2
41;2021-04-27;2093;1040;83076;34547;25.3;10.5
41;2021-04-28;1563;865;84639;35412;25.8;10.8
41;2021-04-29;2210;1380;86849;36792;26.5;11.2
41;2021-04-30;1963;878;88812;37670;27.1;11.5
41;2021-05-01;189;12;89001;37682;27.1;11.5
41;2021-05-02;107;17;89108;37699;27.2;11.5
41;2021-05-03;1864;896;90972;38595;27.7;11.8
41;2021-05-04;2092;1543;93064;40138;28.4;12.2
41;2021-05-05;1882;1193;94946;41331;29.0;12.6
41;2021-05-06;2447;1695;97393;43026;29.7;13.1
41;2021-05-07;2016;1805;99409;44831;30.3;13.7
41;2021-05-08;202;154;99611;44985;30.4;13.7
41;2021-05-09;11;354;99622;45339;30.4;13.8
41;2021-05-10;1590;1558;101212;46897;30.9;14.3
41;2021-05-11;2085;2102;103297;48999;31.5;14.9
41;2021-05-12;1951;1678;105248;50677;32.1;15.5
41;2021-05-13;1485;949;106733;51626;32.6;15.7
41;2021-05-14;1577;1305;108310;52931;33.0;16.1
41;2021-05-15;206;295;108516;53226;33.1;16.2
41;2021-05-16;4;0;108520;53226;33.1;16.2
41;2021-05-17;2484;564;111004;53790;33.9;16.4
41;2021-05-18;3138;1031;114142;54821;34.8;16.7
41;2021-05-19;2553;675;116695;55496;35.6;16.9
41;2021-05-20;3349;1152;120044;56648;36.6;17.3
41;2021-05-21;2727;968;122771;57616;37.4;17.6
41;2021-05-22;396;237;123167;57853;37.6;17.6
41;2021-05-23;6;2;123173;57855;37.6;17.6
41;2021-05-24;2605;150;125778;58005;38.4;17.7
41;2021-05-25;2991;577;128769;58582;39.3;17.9
41;2021-05-26;3037;652;131806;59234;40.2;18.1
41;2021-05-27;3294;1111;135100;60345;41.2;18.4
41;2021-05-28;3144;979;138244;61324;42.2;18.7
41;2021-05-29;2073;429;140317;61753;42.8;18.8
41;2021-05-30;344;22;140661;61775;42.9;18.8
41;2021-05-31;1710;1505;142371;63280;43.4;19.3
41;2021-06-01;2263;2012;144634;65292;44.1;19.9
41;2021-06-02;1832;1289;146466;66581;44.7;20.3
41;2021-06-03;2597;1942;149063;68523;45.5;20.9
41;2021-06-04;2303;1967;151366;70490;46.2;21.5
41;2021-06-05;611;1583;151977;72073;46.4;22.0
41;2021-06-06;109;927;152086;73000;46.4;22.3
41;2021-06-07;1515;1529;153601;74529;46.9;22.7
41;2021-06-08;1712;2413;155313;76942;47.4;23.5
41;2021-06-09;1614;1641;156927;78583;47.9;24.0
41;2021-06-10;1917;1818;158844;80401;48.5;24.5
41;2021-06-11;1572;1793;160416;82194;48.9;25.1
41;2021-06-12;664;649;161080;82843;49.1;25.3
41;2021-06-13;13;77;161093;82920;49.1;25.3
41;2021-06-14;1269;1963;162362;84883;49.5;25.9
41;2021-06-15;1834;2759;164196;87642;50.1;26.7
41;2021-06-16;1724;2309;165920;89951;50.6;27.4
41;2021-06-17;1810;2574;167730;92525;51.2;28.2
41;2021-06-18;1662;2400;169392;94925;51.7;29.0
41;2021-06-19;412;531;169804;95456;51.8;29.1
41;2021-06-20;11;32;169815;95488;51.8;29.1
41;2021-06-21;1325;1779;171140;97267;52.2;29.7
41;2021-06-22;1619;2563;172759;99830;52.7;30.5
41;2021-06-23;1374;2046;174133;101876;53.1;31.1
41;2021-06-24;1483;2308;175616;104184;53.6;31.8
41;2021-06-25;1294;2617;176910;106801;54.0;32.6
41;2021-06-26;433;614;177343;107415;54.1;32.8
41;2021-06-27;1;4;177344;107419;54.1;32.8
41;2021-06-28;404;2696;177748;110115;54.2;33.6
41;2021-06-29;664;3442;178412;113557;54.4;34.6
41;2021-06-30;552;3068;178964;116625;54.6;35.6
41;2021-07-01;766;3107;179730;119732;54.8;36.5
41;2021-07-02;589;3501;180319;123233;55.0;37.6
41;2021-07-03;158;647;180477;123880;55.1;37.8
41;2021-07-04;2;2;180479;123882;55.1;37.8
41;2021-07-05;284;2818;180763;126700;55.1;38.6
41;2021-07-06;667;3634;181430;130334;55.3;39.8
41;2021-07-07;479;3137;181909;133471;55.5;40.7
41;2021-07-08;940;3366;182849;136837;55.8;41.7
41;2021-07-09;540;3641;183389;140478;55.9;42.9
41;2021-07-10;247;2088;183636;142566;56.0;43.5
41;2021-07-11;5;280;183641;142846;56.0;43.6
41;2021-07-12;861;2291;184502;145137;56.3;44.3
41;2021-07-13;1198;3286;185700;148423;56.6;45.3
41;2021-07-14;141;1080;185841;149503;56.7;45.6
41;2021-07-15;1333;3320;187174;152823;57.1;46.6
41;2021-07-16;1091;3388;188265;156211;57.4;47.6
41;2021-07-17;344;807;188609;157018;57.5;47.9
41;2021-07-18;24;32;188633;157050;57.5;47.9
41;2021-07-19;1191;2320;189824;159370;57.9;48.6
41;2021-07-20;1643;2745;191467;162115;58.4;49.5
41;2021-07-21;1709;2086;193176;164201;58.9;50.1
41;2021-07-22;2263;2300;195439;166501;59.6;50.8
41;2021-07-23;2104;2468;197543;168969;60.3;51.5
41;2021-07-24;330;842;197873;169811;60.4;51.8
41;2021-07-25;19;23;197892;169834;60.4;51.8
41;2021-07-26;1902;1679;199794;171513;60.9;52.3
41;2021-07-27;2533;2345;202327;173858;61.7;53.0
41;2021-07-28;2161;1831;204488;175689;62.4;53.6
41;2021-07-29;2344;2027;206832;177716;63.1;54.2
41;2021-07-30;2151;2084;208983;179800;63.7;54.8
41;2021-07-31;380;581;209363;180381;63.9;55.0
41;2021-08-01;21;7;209384;180388;63.9;55.0
41;2021-08-02;1550;1605;210934;181993;64.3;55.5
41;2021-08-03;2517;1857;213451;183850;65.1;56.1
41;2021-08-04;2302;1198;215753;185048;65.8;56.4
41;2021-08-05;3046;1266;218799;186314;66.7;56.8
41;2021-08-06;2214;1305;221013;187619;67.4;57.2
41;2021-08-07;511;347;221524;187966;67.6;57.3
41;2021-08-08;13;20;221537;187986;67.6;57.3
41;2021-08-09;1689;1357;223226;189343;68.1;57.8
41;2021-08-10;2563;1423;225789;190766;68.9;58.2
41;2021-08-11;1593;1440;227382;192206;69.4;58.6
41;2021-08-12;1942;1339;229324;193545;70.0;59.0
41;2021-08-13;1474;1697;230798;195242;70.4;59.6
41;2021-08-14;365;209;231163;195451;70.5;59.6
41;2021-08-15;0;16;231163;195467;70.5;59.6
41;2021-08-16;863;2069;232026;197536;70.8;60.3
41;2021-08-17;1498;1633;233524;199169;71.2;60.8
41;2021-08-18;1135;1971;234659;201140;71.6;61.4
41;2021-08-19;1312;1554;235971;202694;72.0;61.8
41;2021-08-20;915;2313;236886;205007;72.3;62.5
41;2021-08-21;120;227;237006;205234;72.3;62.6
41;2021-08-22;1;32;237007;205266;72.3;62.6
41;2021-08-23;694;2295;237701;207561;72.5;63.3
41;2021-08-24;1415;2313;239116;209874;72.9;64.0
41;2021-08-25;620;2200;239736;212074;73.1;64.7
41;2021-08-26;843;2821;240579;214895;73.4;65.5
41;2021-08-27;621;2763;241200;217658;73.6;66.4
41;2021-08-28;99;622;241299;218280;73.6;66.6
41;2021-08-29;46;24;241345;218304;73.6;66.6
41;2021-08-30;669;2114;242014;220418;73.8;67.2
41;2021-08-31;766;2556;242780;222974;74.1;68.0
41;2021-09-01;501;1711;243281;224685;74.2;68.5
41;2021-09-02;628;2011;243909;226696;74.4;69.1
41;2021-09-03;650;2101;244559;228797;74.6;69.8
41;2021-09-04;194;556;244753;229353;74.7;70.0
41;2021-09-05;3;0;244756;229353;74.7;70.0
41;2021-09-06;291;958;245047;230311;74.7;70.3
41;2021-09-07;415;1195;245462;231506;74.9;70.6
41;2021-09-08;314;1172;245776;232678;75.0;71.0
41;2021-09-09;296;1164;246072;233842;75.1;71.3
41;2021-09-10;381;1197;246453;235039;75.2;71.7
41;2021-09-11;85;366;246538;235405;75.2;71.8
41;2021-09-12;0;9;246538;235414;75.2;71.8
41;2021-09-13;200;647;246738;236061;75.3;72.0
41;2021-09-14;364;826;247102;236887;75.4;72.3
41;2021-09-15;279;1070;247381;237957;75.5;72.6
41;2021-09-16;237;833;247618;238790;75.5;72.8
41;2021-09-17;363;713;247981;239503;75.6;73.1
41;2021-09-18;78;169;248059;239672;75.7;73.1
41;2021-09-19;0;7;248059;239679;75.7;73.1
41;2021-09-20;177;515;248236;240194;75.7;73.3
41;2021-09-21;182;515;248418;240709;75.8;73.4
41;2021-09-22;268;802;248686;241511;75.9;73.7
41;2021-09-23;240;662;248926;242173;75.9;73.9
41;2021-09-24;313;631;249239;242804;76.0;74.1
41;2021-09-25;70;233;249309;243037;76.0;74.1
41;2021-09-26;0;3;249309;243040;76.0;74.1
41;2021-09-27;165;342;249474;243382;76.1;74.2
41;2021-09-28;155;421;249629;243803;76.1;74.4
41;2021-09-29;178;491;249807;244294;76.2;74.5
41;2021-09-30;112;337;249919;244631;76.2;74.6
41;2021-10-01;210;390;250129;245021;76.3;74.7
41;2021-10-02;80;140;250209;245161;76.3;74.8
41;2021-10-03;0;0;250209;245161;76.3;74.8
41;2021-10-04;106;264;250315;245425;76.4;74.9
41;2021-10-05;117;297;250432;245722;76.4;75.0
41;2021-10-06;224;412;250656;246134;76.5;75.1
41;2021-10-07;120;176;250776;246310;76.5;75.1
41;2021-10-08;201;511;250977;246821;76.6;75.3
41;2021-10-09;51;119;251028;246940;76.6;75.3
41;2021-10-10;0;18;251028;246958;76.6;75.3
41;2021-10-11;118;171;251146;247129;76.6;75.4
41;2021-10-12;67;167;251213;247296;76.6;75.4
41;2021-10-13;183;286;251396;247582;76.7;75.5
41;2021-10-14;88;125;251484;247707;76.7;75.6
41;2021-10-15;182;472;251666;248179;76.8;75.7
41;2021-10-16;32;45;251698;248224;76.8;75.7
41;2021-10-17;0;0;251698;248224;76.8;75.7
41;2021-10-18;134;221;251832;248445;76.8;75.8
41;2021-10-19;72;147;251904;248592;76.8;75.8
42;2020-12-27;1;0;1;0;0.0;0.0
42;2020-12-28;0;0;1;0;0.0;0.0
42;2020-12-29;0;0;1;0;0.0;0.0
42;2020-12-30;0;0;1;0;0.0;0.0
42;2020-12-31;0;0;1;0;0.0;0.0
42;2021-01-01;0;0;1;0;0.0;0.0
42;2021-01-02;0;0;1;0;0.0;0.0
42;2021-01-03;0;0;1;0;0.0;0.0
42;2021-01-04;1;0;2;0;0.0;0.0
42;2021-01-05;1;0;3;0;0.0;0.0
42;2021-01-06;178;1;181;1;0.0;0.0
42;2021-01-07;256;0;437;1;0.1;0.0
42;2021-01-08;264;5;701;6;0.1;0.0
42;2021-01-09;136;1;837;7;0.1;0.0
42;2021-01-10;0;0;837;7;0.1;0.0
42;2021-01-11;293;2;1130;9;0.1;0.0
42;2021-01-12;412;1;1542;10;0.2;0.0
42;2021-01-13;527;2;2069;12;0.3;0.0
42;2021-01-14;775;4;2844;16;0.4;0.0
42;2021-01-15;707;4;3551;20;0.5;0.0
42;2021-01-16;298;2;3849;22;0.5;0.0
42;2021-01-17;219;0;4068;22;0.5;0.0
42;2021-01-18;968;1;5036;23;0.7;0.0
42;2021-01-19;1329;10;6365;33;0.8;0.0
42;2021-01-20;956;4;7321;37;1.0;0.0
42;2021-01-21;1023;6;8344;43;1.1;0.0
42;2021-01-22;992;7;9336;50;1.2;0.0
42;2021-01-23;401;0;9737;50;1.3;0.0
42;2021-01-24;359;0;10096;50;1.3;0.0
42;2021-01-25;1100;13;11196;63;1.5;0.0
42;2021-01-26;1750;21;12946;84;1.7;0.0
42;2021-01-27;1456;126;14402;210;1.9;0.0
42;2021-01-28;1667;146;16069;356;2.1;0.0
42;2021-01-29;946;120;17015;476;2.2;0.1
42;2021-01-30;257;110;17272;586;2.3;0.1
42;2021-01-31;258;2;17530;588;2.3;0.1
42;2021-02-01;738;63;18268;651;2.4;0.1
42;2021-02-02;1867;322;20135;973;2.6;0.1
42;2021-02-03;1518;492;21653;1465;2.8;0.2
42;2021-02-04;1279;615;22932;2080;3.0;0.3
42;2021-02-05;686;528;23618;2608;3.1;0.3
42;2021-02-06;304;151;23922;2759;3.1;0.4
42;2021-02-07;276;154;24198;2913;3.2;0.4
42;2021-02-08;506;615;24704;3528;3.2;0.5
42;2021-02-09;703;798;25407;4326;3.3;0.6
42;2021-02-10;742;689;26149;5015;3.4;0.7
42;2021-02-11;773;688;26922;5703;3.5;0.7
42;2021-02-12;675;754;27597;6457;3.6;0.8
42;2021-02-13;428;304;28025;6761;3.7;0.9
42;2021-02-14;186;221;28211;6982;3.7;0.9
42;2021-02-15;520;820;28731;7802;3.8;1.0
42;2021-02-16;489;1240;29220;9042;3.8;1.2
42;2021-02-17;518;1531;29738;10573;3.9;1.4
42;2021-02-18;757;1388;30495;11961;4.0;1.6
42;2021-02-19;768;1023;31263;12984;4.1;1.7
42;2021-02-20;248;424;31511;13408;4.1;1.8
42;2021-02-21;63;327;31574;13735;4.1;1.8
42;2021-02-22;575;962;32149;14697;4.2;1.9
42;2021-02-23;1212;1440;33361;16137;4.4;2.1
42;2021-02-24;1246;1221;34607;17358;4.5;2.3
42;2021-02-25;1667;1420;36274;18778;4.7;2.5
42;2021-02-26;1646;928;37920;19706;5.0;2.6
42;2021-02-27;580;297;38500;20003;5.0;2.6
42;2021-02-28;167;127;38667;20130;5.1;2.6
42;2021-03-01;807;847;39474;20977;5.2;2.7
42;2021-03-02;1275;822;40749;21799;5.3;2.9
42;2021-03-03;1368;811;42117;22610;5.5;3.0
42;2021-03-04;1705;729;43822;23339;5.7;3.1
42;2021-03-05;2624;679;46446;24018;6.1;3.1
42;2021-03-06;1934;276;48380;24294;6.3;3.2
42;2021-03-07;1491;97;49871;24391;6.5;3.2
42;2021-03-08;1405;519;51276;24910;6.7;3.3
42;2021-03-09;1983;464;53259;25374;7.0;3.3
42;2021-03-10;2053;514;55312;25888;7.2;3.4
42;2021-03-11;3048;641;58360;26529;7.6;3.5
42;2021-03-12;3008;837;61368;27366;8.0;3.6
42;2021-03-13;1479;374;62847;27740;8.2;3.6
42;2021-03-14;472;177;63319;27917;8.3;3.7
42;2021-03-15;1572;609;64891;28526;8.5;3.7
42;2021-03-16;1472;782;66363;29308;8.7;3.8
42;2021-03-17;1723;1081;68086;30389;8.9;4.0
42;2021-03-18;1802;1033;69888;31422;9.1;4.1
42;2021-03-19;2566;690;72454;32112;9.5;4.2
42;2021-03-20;1672;237;74126;32349;9.7;4.2
42;2021-03-21;526;102;74652;32451;9.8;4.2
42;2021-03-22;1426;747;76078;33198;9.9;4.3
42;2021-03-23;2508;874;78586;34072;10.3;4.5
42;2021-03-24;2783;799;81369;34871;10.6;4.6
42;2021-03-25;3720;944;85089;35815;11.1;4.7
42;2021-03-26;3758;793;88847;36608;11.6;4.8
42;2021-03-27;1806;454;90653;37062;11.9;4.8
42;2021-03-28;1039;217;91692;37279;12.0;4.9
42;2021-03-29;2064;932;93756;38211;12.3;5.0
42;2021-03-30;3146;881;96902;39092;12.7;5.1
42;2021-03-31;2444;1084;99346;40176;13.0;5.3
42;2021-04-01;3391;1060;102737;41236;13.4;5.4
42;2021-04-02;2849;1236;105586;42472;13.8;5.6
42;2021-04-03;1418;612;107004;43084;14.0;5.6
42;2021-04-04;1403;397;108407;43481;14.2;5.7
42;2021-04-05;1901;304;110308;43785;14.4;5.7
42;2021-04-06;2291;1420;112599;45205;14.7;5.9
42;2021-04-07;2761;1845;115360;47050;15.1;6.2
42;2021-04-08;4025;1606;119385;48656;15.6;6.4
42;2021-04-09;5136;1571;124521;50227;16.3;6.6
42;2021-04-10;2591;777;127112;51004;16.6;6.7
42;2021-04-11;1957;434;129069;51438;16.9;6.7
42;2021-04-12;3699;1555;132768;52993;17.4;6.9
42;2021-04-13;4659;1816;137427;54809;18.0;7.2
42;2021-04-14;4308;1914;141735;56723;18.5;7.4
42;2021-04-15;4809;1849;146544;58572;19.2;7.7
42;2021-04-16;4624;1900;151168;60472;19.8;7.9
42;2021-04-17;2982;1080;154150;61552;20.2;8.0
42;2021-04-18;1887;417;156037;61969;20.4;8.1
42;2021-04-19;3090;1544;159127;63513;20.8;8.3
42;2021-04-20;3468;1962;162595;65475;21.3;8.6
42;2021-04-21;3479;1754;166074;67229;21.7;8.8
42;2021-04-22;3768;1959;169842;69188;22.2;9.0
42;2021-04-23;3842;2025;173684;71213;22.7;9.3
42;2021-04-24;2363;1520;176047;72733;23.0;9.5
42;2021-04-25;1658;949;177705;73682;23.2;9.6
42;2021-04-26;3280;1740;180985;75422;23.7;9.9
42;2021-04-27;3253;2219;184238;77641;24.1;10.2
42;2021-04-28;3463;2629;187701;80270;24.5;10.5
42;2021-04-29;3768;2822;191469;83092;25.0;10.9
42;2021-04-30;3361;3037;194830;86129;25.5;11.3
42;2021-05-01;2968;1055;197798;87184;25.9;11.4
42;2021-05-02;1934;1264;199732;88448;26.1;11.6
42;2021-05-03;2868;2772;202600;91220;26.5;11.9
42;2021-05-04;3416;3136;206016;94356;26.9;12.3
42;2021-05-05;3328;3405;209344;97761;27.4;12.8
42;2021-05-06;3888;3776;213232;101537;27.9;13.3
42;2021-05-07;3732;4044;216964;105581;28.4;13.8
42;2021-05-08;3164;1075;220128;106656;28.8;13.9
42;2021-05-09;1505;2213;221633;108869;29.0;14.2
42;2021-05-10;3250;3832;224883;112701;29.4;14.7
42;2021-05-11;5574;3917;230457;116618;30.1;15.2
42;2021-05-12;5339;3571;235796;120189;30.8;15.7
42;2021-05-13;5450;1152;241246;121341;31.5;15.9
42;2021-05-14;5237;2928;246483;124269;32.2;16.2
42;2021-05-15;4880;2127;251363;126396;32.9;16.5
42;2021-05-16;2873;1036;254236;127432;33.2;16.7
42;2021-05-17;5885;2840;260121;130272;34.0;17.0
42;2021-05-18;6251;2983;266372;133255;34.8;17.4
42;2021-05-19;6523;2753;272895;136008;35.7;17.8
42;2021-05-20;7103;2899;279998;138907;36.6;18.2
42;2021-05-21;6351;3276;286349;142183;37.4;18.6
42;2021-05-22;5834;2134;292183;144317;38.2;18.9
42;2021-05-23;2832;874;295015;145191;38.6;19.0
42;2021-05-24;5246;1434;300261;146625;39.3;19.2
42;2021-05-25;5152;3941;305413;150566;39.9;19.7
42;2021-05-26;5160;3459;310573;154025;40.6;20.1
42;2021-05-27;5366;3640;315939;157665;41.3;20.6
42;2021-05-28;5044;4208;320983;161873;42.0;21.2
42;2021-05-29;4340;2988;325323;164861;42.5;21.6
42;2021-05-30;1983;1210;327306;166071;42.8;21.7
42;2021-05-31;4241;3424;331547;169495;43.4;22.2
42;2021-06-01;4592;3570;336139;173065;44.0;22.6
42;2021-06-02;4482;3018;340621;176083;44.5;23.0
42;2021-06-03;4930;3844;345551;179927;45.2;23.5
42;2021-06-04;4765;4217;350316;184144;45.8;24.1
42;2021-06-05;3689;2427;354005;186571;46.3;24.4
42;2021-06-06;1445;1295;355450;187866;46.5;24.6
42;2021-06-07;3992;3377;359442;191243;47.0;25.0
42;2021-06-08;3466;3248;362908;194491;47.5;25.4
42;2021-06-09;2964;3206;365872;197697;47.8;25.9
42;2021-06-10;3242;2934;369114;200631;48.3;26.2
42;2021-06-11;3585;4118;372699;204749;48.7;26.8
42;2021-06-12;2863;2882;375562;207631;49.1;27.2
42;2021-06-13;944;1278;376506;208909;49.2;27.3
42;2021-06-14;2313;4062;378819;212971;49.5;27.8
42;2021-06-15;2830;4070;381649;217041;49.9;28.4
42;2021-06-16;2919;3552;384568;220593;50.3;28.8
42;2021-06-17;2635;3738;387203;224331;50.6;29.3
42;2021-06-18;3093;5146;390296;229477;51.0;30.0
42;2021-06-19;2845;4243;393141;233720;51.4;30.6
42;2021-06-20;857;1845;393998;235565;51.5;30.8
42;2021-06-21;1909;6277;395907;241842;51.8;31.6
42;2021-06-22;1875;5891;397782;247733;52.0;32.4
42;2021-06-23;1845;5322;399627;253055;52.3;33.1
42;2021-06-24;1785;4683;401412;257738;52.5;33.7
42;2021-06-25;2037;6952;403449;264690;52.8;34.6
42;2021-06-26;1408;5818;404857;270508;52.9;35.4
42;2021-06-27;756;2858;405613;273366;53.0;35.7
42;2021-06-28;1746;7063;407359;280429;53.3;36.7
42;2021-06-29;1526;6567;408885;286996;53.5;37.5
42;2021-06-30;1969;5766;410854;292762;53.7;38.3
42;2021-07-01;1779;5119;412633;297881;54.0;39.0
42;2021-07-02;2048;6740;414681;304621;54.2;39.8
42;2021-07-03;1760;5979;416441;310600;54.5;40.6
42;2021-07-04;853;2514;417294;313114;54.6;40.9
42;2021-07-05;1716;6289;419010;319403;54.8;41.8
42;2021-07-06;2106;5576;421116;324979;55.1;42.5
42;2021-07-07;2338;4656;423454;329635;55.4;43.1
42;2021-07-08;2271;3958;425725;333593;55.7;43.6
42;2021-07-09;2416;6096;428141;339689;56.0;44.4
42;2021-07-10;1693;5581;429834;345270;56.2;45.1
42;2021-07-11;921;2304;430755;347574;56.3;45.5
42;2021-07-12;1777;6290;432532;353864;56.6;46.3
42;2021-07-13;3611;6290;436143;360154;57.0;47.1
42;2021-07-14;4480;2055;440623;362209;57.6;47.4
42;2021-07-15;4558;5630;445181;367839;58.2;48.1
42;2021-07-16;4443;6199;449624;374038;58.8;48.9
42;2021-07-17;3219;4710;452843;378748;59.2;49.5
42;2021-07-18;1838;1743;454681;380491;59.5;49.8
42;2021-07-19;3806;5074;458487;385565;60.0;50.4
42;2021-07-20;4719;4821;463206;390386;60.6;51.0
42;2021-07-21;5176;4720;468382;395106;61.2;51.7
42;2021-07-22;5500;3938;473882;399044;62.0;52.2
42;2021-07-23;5500;5120;479382;404164;62.7;52.9
42;2021-07-24;4038;3834;483420;407998;63.2;53.4
42;2021-07-25;1656;1391;485076;409389;63.4;53.5
42;2021-07-26;4730;4313;489806;413702;64.0;54.1
42;2021-07-27;5333;3957;495139;417659;64.7;54.6
42;2021-07-28;5783;3676;500922;421335;65.5;55.1
42;2021-07-29;5678;3436;506600;424771;66.2;55.5
42;2021-07-30;5143;3777;511743;428548;66.9;56.0
42;2021-07-31;4765;3057;516508;431605;67.5;56.4
42;2021-08-01;2498;1318;519006;432923;67.9;56.6
42;2021-08-02;4367;3106;523373;436029;68.4;57.0
42;2021-08-03;3826;3285;527199;439314;68.9;57.4
42;2021-08-04;3473;3225;530672;442539;69.4;57.9
42;2021-08-05;3404;3315;534076;445854;69.8;58.3
42;2021-08-06;3640;3995;537716;449849;70.3;58.8
42;2021-08-07;3022;3067;540738;452916;70.7;59.2
42;2021-08-08;1201;1717;541939;454633;70.9;59.4
42;2021-08-09;2808;3859;544747;458492;71.2;60.0
42;2021-08-10;3275;3909;548022;462401;71.7;60.5
42;2021-08-11;2592;3521;550614;465922;72.0;60.9
42;2021-08-12;2518;3569;553132;469491;72.3;61.4
42;2021-08-13;2333;3909;555465;473400;72.6;61.9
42;2021-08-14;1652;3269;557117;476669;72.9;62.3
42;2021-08-15;600;1027;557717;477696;72.9;62.5
42;2021-08-16;2078;4572;559795;482268;73.2;63.1
42;2021-08-17;2246;4175;562041;486443;73.5;63.6
42;2021-08-18;2053;4146;564094;490589;73.8;64.2
42;2021-08-19;1931;3370;566025;493959;74.0;64.6
42;2021-08-20;2271;4613;568296;498572;74.3;65.2
42;2021-08-21;1083;3866;569379;502438;74.5;65.7
42;2021-08-22;501;2020;569880;504458;74.5;66.0
42;2021-08-23;1625;4668;571505;509126;74.7;66.6
42;2021-08-24;1748;4044;573253;513170;75.0;67.1
42;2021-08-25;1748;3900;575001;517070;75.2;67.6
42;2021-08-26;1445;3048;576446;520118;75.4;68.0
42;2021-08-27;1777;4565;578223;524683;75.6;68.6
42;2021-08-28;1311;3707;579534;528390;75.8;69.1
42;2021-08-29;376;1428;579910;529818;75.8;69.3
42;2021-08-30;1286;3345;581196;533163;76.0;69.7
42;2021-08-31;1238;2717;582434;535880;76.2;70.1
42;2021-09-01;1253;2812;583687;538692;76.3;70.4
42;2021-09-02;1322;2617;585009;541309;76.5;70.8
42;2021-09-03;1578;2940;586587;544249;76.7;71.2
42;2021-09-04;1046;2816;587633;547065;76.8;71.5
42;2021-09-05;383;742;588016;547807;76.9;71.6
42;2021-09-06;783;1781;588799;549588;77.0;71.9
42;2021-09-07;824;1583;589623;551171;77.1;72.1
42;2021-09-08;920;1919;590543;553090;77.2;72.3
42;2021-09-09;658;1461;591201;554551;77.3;72.5
42;2021-09-10;928;1984;592129;556535;77.4;72.8
42;2021-09-11;728;2307;592857;558842;77.5;73.1
42;2021-09-12;163;518;593020;559360;77.5;73.1
42;2021-09-13;552;1163;593572;560523;77.6;73.3
42;2021-09-14;775;1364;594347;561887;77.7;73.5
42;2021-09-15;704;1570;595051;563457;77.8;73.7
42;2021-09-16;525;824;595576;564281;77.9;73.8
42;2021-09-17;763;1638;596339;565919;78.0;74.0
42;2021-09-18;577;1800;596916;567719;78.1;74.2
42;2021-09-19;100;367;597016;568086;78.1;74.3
42;2021-09-20;400;848;597416;568934;78.1;74.4
42;2021-09-21;342;738;597758;569672;78.2;74.5
42;2021-09-22;473;1383;598231;571055;78.2;74.7
42;2021-09-23;378;911;598609;571966;78.3;74.8
42;2021-09-24;472;1565;599081;573531;78.3;75.0
42;2021-09-25;389;1274;599470;574805;78.4;75.2
42;2021-09-26;61;289;599531;575094;78.4;75.2
42;2021-09-27;331;794;599862;575888;78.4;75.3
42;2021-09-28;344;707;600206;576595;78.5;75.4
42;2021-09-29;405;958;600611;577553;78.5;75.5
42;2021-09-30;359;690;600970;578243;78.6;75.6
42;2021-10-01;488;1021;601458;579264;78.6;75.7
42;2021-10-02;378;782;601836;580046;78.7;75.8
42;2021-10-03;90;176;601926;580222;78.7;75.9
42;2021-10-04;271;526;602197;580748;78.7;75.9
42;2021-10-05;286;465;602483;581213;78.8;76.0
42;2021-10-06;412;799;602895;582012;78.8;76.1
42;2021-10-07;300;577;603195;582589;78.9;76.2
42;2021-10-08;405;841;603600;583430;78.9;76.3
42;2021-10-09;381;673;603981;584103;79.0;76.4
42;2021-10-10;88;113;604069;584216;79.0;76.4
42;2021-10-11;264;441;604333;584657;79.0;76.5
42;2021-10-12;205;357;604538;585014;79.1;76.5
42;2021-10-13;438;622;604976;585636;79.1;76.6
42;2021-10-14;290;362;605266;585998;79.1;76.6
42;2021-10-15;373;604;605639;586602;79.2;76.7
42;2021-10-16;308;444;605947;587046;79.2;76.8
42;2021-10-17;73;105;606020;587151;79.2;76.8
42;2021-10-18;212;438;606232;587589;79.3;76.8
42;2021-10-19;241;327;606473;587916;79.3;76.9
43;2020-12-27;0;0;0;0;0.0;0.0
43;2020-12-28;0;0;0;0;0.0;0.0
43;2020-12-29;0;0;0;0;0.0;0.0
43;2020-12-30;0;0;0;0;0.0;0.0
43;2020-12-31;0;0;0;0;0.0;0.0
43;2021-01-01;0;0;0;0;0.0;0.0
43;2021-01-02;0;0;0;0;0.0;0.0
43;2021-01-03;0;0;0;0;0.0;0.0
43;2021-01-04;2;0;2;0;0.0;0.0
43;2021-01-05;0;0;2;0;0.0;0.0
43;2021-01-06;0;0;2;0;0.0;0.0
43;2021-01-07;167;0;169;0;0.1;0.0
43;2021-01-08;151;1;320;1;0.1;0.0
43;2021-01-09;0;0;320;1;0.1;0.0
43;2021-01-10;0;0;320;1;0.1;0.0
43;2021-01-11;137;0;457;1;0.2;0.0
43;2021-01-12;244;1;701;2;0.3;0.0
43;2021-01-13;244;2;945;4;0.4;0.0
43;2021-01-14;294;2;1239;6;0.5;0.0
43;2021-01-15;303;2;1542;8;0.7;0.0
43;2021-01-16;32;0;1574;8;0.7;0.0
43;2021-01-17;0;0;1574;8;0.7;0.0
43;2021-01-18;760;6;2334;14;1.0;0.0
43;2021-01-19;776;5;3110;19;1.4;0.0
43;2021-01-20;519;2;3629;21;1.6;0.0
43;2021-01-21;447;2;4076;23;1.8;0.0
43;2021-01-22;467;7;4543;30;2.0;0.0
43;2021-01-23;1;0;4544;30;2.0;0.0
43;2021-01-24;2;0;4546;30;2.0;0.0
43;2021-01-25;539;0;5085;30;2.2;0.0
43;2021-01-26;614;6;5699;36;2.5;0.0
43;2021-01-27;740;0;6439;36;2.8;0.0
43;2021-01-28;747;31;7186;67;3.2;0.0
43;2021-01-29;722;84;7908;151;3.5;0.1
43;2021-01-30;109;0;8017;151;3.5;0.1
43;2021-01-31;0;0;8017;151;3.5;0.1
43;2021-02-01;403;101;8420;252;3.7;0.1
43;2021-02-02;717;151;9137;403;4.0;0.2
43;2021-02-03;690;44;9827;447;4.3;0.2
43;2021-02-04;525;170;10352;617;4.6;0.3
43;2021-02-05;544;170;10896;787;4.8;0.3
43;2021-02-06;167;19;11063;806;4.9;0.4
43;2021-02-07;0;0;11063;806;4.9;0.4
43;2021-02-08;411;304;11474;1110;5.1;0.5
43;2021-02-09;368;432;11842;1542;5.2;0.7
43;2021-02-10;401;361;12243;1903;5.4;0.8
43;2021-02-11;388;396;12631;2299;5.6;1.0
43;2021-02-12;425;201;13056;2500;5.8;1.1
43;2021-02-13;571;42;13627;2542;6.0;1.1
43;2021-02-14;0;0;13627;2542;6.0;1.1
43;2021-02-15;69;477;13696;3019;6.0;1.3
43;2021-02-16;41;372;13737;3391;6.1;1.5
43;2021-02-17;87;483;13824;3874;6.1;1.7
43;2021-02-18;147;379;13971;4253;6.2;1.9
43;2021-02-19;279;513;14250;4766;6.3;2.1
43;2021-02-20;22;4;14272;4770;6.3;2.1
43;2021-02-21;0;0;14272;4770;6.3;2.1
43;2021-02-22;16;500;14288;5270;6.3;2.3
43;2021-02-23;202;801;14490;6071;6.4;2.7
43;2021-02-24;147;730;14637;6801;6.5;3.0
43;2021-02-25;228;694;14865;7495;6.6;3.3
43;2021-02-26;222;673;15087;8168;6.6;3.6
43;2021-02-27;139;76;15226;8244;6.7;3.6
43;2021-02-28;1;0;15227;8244;6.7;3.6
43;2021-03-01;208;480;15435;8724;6.8;3.8
43;2021-03-02;342;579;15777;9303;7.0;4.1
43;2021-03-03;338;588;16115;9891;7.1;4.4
43;2021-03-04;551;466;16666;10357;7.3;4.6
43;2021-03-05;566;456;17232;10813;7.6;4.8
43;2021-03-06;489;182;17721;10995;7.8;4.8
43;2021-03-07;12;0;17733;10995;7.8;4.8
43;2021-03-08;447;447;18180;11442;8.0;5.0
43;2021-03-09;621;361;18801;11803;8.3;5.2
43;2021-03-10;674;505;19475;12308;8.6;5.4
43;2021-03-11;954;445;20429;12753;9.0;5.6
43;2021-03-12;944;431;21373;13184;9.4;5.8
43;2021-03-13;793;117;22166;13301;9.8;5.9
43;2021-03-14;2;1;22168;13302;9.8;5.9
43;2021-03-15;706;148;22874;13450;10.1;5.9
43;2021-03-16;847;289;23721;13739;10.5;6.1
43;2021-03-17;638;140;24359;13879;10.7;6.1
43;2021-03-18;676;142;25035;14021;11.0;6.2
43;2021-03-19;840;111;25875;14132;11.4;6.2
43;2021-03-20;450;61;26325;14193;11.6;6.3
43;2021-03-21;0;0;26325;14193;11.6;6.3
43;2021-03-22;742;41;27067;14234;11.9;6.3
43;2021-03-23;872;49;27939;14283;12.3;6.3
43;2021-03-24;1174;98;29113;14381;12.8;6.3
43;2021-03-25;1594;163;30707;14544;13.5;6.4
43;2021-03-26;1609;192;32316;14736;14.2;6.5
43;2021-03-27;1449;80;33765;14816;14.9;6.5
43;2021-03-28;420;20;34185;14836;15.1;6.5
43;2021-03-29;1096;171;35281;15007;15.5;6.6
43;2021-03-30;1314;245;36595;15252;16.1;6.7
43;2021-03-31;1306;267;37901;15519;16.7;6.8
43;2021-04-01;1347;344;39248;15863;17.3;7.0
43;2021-04-02;1052;357;40300;16220;17.8;7.1
43;2021-04-03;340;199;40640;16419;17.9;7.2
43;2021-04-04;0;0;40640;16419;17.9;7.2
43;2021-04-05;3;0;40643;16419;17.9;7.2
43;2021-04-06;687;608;41330;17027;18.2;7.5
43;2021-04-07;868;578;42198;17605;18.6;7.8
43;2021-04-08;1086;463;43284;18068;19.1;8.0
43;2021-04-09;1147;664;44431;18732;19.6;8.3
43;2021-04-10;626;265;45057;18997;19.9;8.4
43;2021-04-11;0;0;45057;18997;19.9;8.4
43;2021-04-12;681;650;45738;19647;20.2;8.7
43;2021-04-13;917;726;46655;20373;20.6;9.0
43;2021-04-14;723;672;47378;21045;20.9;9.3
43;2021-04-15;959;702;48337;21747;21.3;9.6
43;2021-04-16;1007;694;49344;22441;21.7;9.9
43;2021-04-17;423;305;49767;22746;21.9;10.0
43;2021-04-18;3;5;49770;22751;21.9;10.0
43;2021-04-19;628;568;50398;23319;22.2;10.3
43;2021-04-20;839;677;51237;23996;22.6;10.6
43;2021-04-21;320;988;51557;24984;22.7;11.0
43;2021-04-22;680;1017;52237;26001;23.0;11.5
43;2021-04-23;401;1103;52638;27104;23.2;11.9
43;2021-04-24;347;1041;52985;28145;23.4;12.4
43;2021-04-25;23;403;53008;28548;23.4;12.6
43;2021-04-26;385;965;53393;29513;23.5;13.0
43;2021-04-27;825;989;54218;30502;23.9;13.4
43;2021-04-28;794;1110;55012;31612;24.2;13.9
43;2021-04-29;1236;1141;56248;32753;24.8;14.4
43;2021-04-30;1199;1070;57447;33823;25.3;14.9
43;2021-05-01;400;27;57847;33850;25.5;14.9
43;2021-05-02;1;0;57848;33850;25.5;14.9
43;2021-05-03;1218;409;59066;34259;26.0;15.1
43;2021-05-04;1237;958;60303;35217;26.6;15.5
43;2021-05-05;1144;849;61447;36066;27.1;15.9
43;2021-05-06;1405;941;62852;37007;27.7;16.3
43;2021-05-07;1089;1173;63941;38180;28.2;16.8
43;2021-05-08;521;136;64462;38316;28.4;16.9
43;2021-05-09;0;2;64462;38318;28.4;16.9
43;2021-05-10;1084;725;65546;39043;28.9;17.2
43;2021-05-11;1553;1010;67099;40053;29.6;17.7
43;2021-05-12;1482;812;68581;40865;30.2;18.0
43;2021-05-13;936;378;69517;41243;30.6;18.2
43;2021-05-14;2204;1111;71721;42354;31.6;18.7
43;2021-05-15;1271;315;72992;42669;32.2;18.8
43;2021-05-16;272;47;73264;42716;32.3;18.8
43;2021-05-17;1625;631;74889;43347;33.0;19.1
43;2021-05-18;1966;676;76855;44023;33.9;19.4
43;2021-05-19;2065;576;78920;44599;34.8;19.7
43;2021-05-20;2338;805;81258;45404;35.8;20.0
43;2021-05-21;2385;709;83643;46113;36.9;20.3
43;2021-05-22;1208;342;84851;46455;37.4;20.5
43;2021-05-23;1;0;84852;46455;37.4;20.5
43;2021-05-24;382;99;85234;46554;37.6;20.5
43;2021-05-25;1407;654;86641;47208;38.2;20.8
43;2021-05-26;1347;559;87988;47767;38.8;21.1
43;2021-05-27;1388;713;89376;48480;39.4;21.4
43;2021-05-28;1348;737;90724;49217;40.0;21.7
43;2021-05-29;1135;604;91859;49821;40.5;22.0
43;2021-05-30;149;17;92008;49838;40.5;22.0
43;2021-05-31;1207;442;93215;50280;41.1;22.2
43;2021-06-01;1281;986;94496;51266;41.6;22.6
43;2021-06-02;1086;700;95582;51966;42.1;22.9
43;2021-06-03;1192;857;96774;52823;42.7;23.3
43;2021-06-04;1351;860;98125;53683;43.2;23.7
43;2021-06-05;823;454;98948;54137;43.6;23.9
43;2021-06-06;10;5;98958;54142;43.6;23.9
43;2021-06-07;748;518;99706;54660;43.9;24.1
43;2021-06-08;664;706;100370;55366;44.2;24.4
43;2021-06-09;538;760;100908;56126;44.5;24.7
43;2021-06-10;807;1120;101715;57246;44.8;25.2
43;2021-06-11;761;1348;102476;58594;45.2;25.8
43;2021-06-12;914;514;103390;59108;45.6;26.1
43;2021-06-13;3;27;103393;59135;45.6;26.1
43;2021-06-14;446;1087;103839;60222;45.8;26.5
43;2021-06-15;629;1195;104468;61417;46.0;27.1
43;2021-06-16;549;974;105017;62391;46.3;27.5
43;2021-06-17;601;1502;105618;63893;46.5;28.2
43;2021-06-18;898;1464;106516;65357;46.9;28.8
43;2021-06-19;447;781;106963;66138;47.1;29.1
43;2021-06-20;0;12;106963;66150;47.1;29.2
43;2021-06-21;424;1307;107387;67457;47.3;29.7
43;2021-06-22;533;1959;107920;69416;47.6;30.6
43;2021-06-23;343;1742;108263;71158;47.7;31.4
43;2021-06-24;511;1494;108774;72652;47.9;32.0
43;2021-06-25;597;2345;109371;74997;48.2;33.1
43;2021-06-26;505;1245;109876;76242;48.4;33.6
43;2021-06-27;10;20;109886;76262;48.4;33.6
43;2021-06-28;341;1784;110227;78046;48.6;34.4
43;2021-06-29;525;2382;110752;80428;48.8;35.4
43;2021-06-30;461;2276;111213;82704;49.0;36.4
43;2021-07-01;473;1910;111686;84614;49.2;37.3
43;2021-07-02;500;1964;112186;86578;49.4;38.2
43;2021-07-03;258;1108;112444;87686;49.6;38.6
43;2021-07-04;1;0;112445;87686;49.6;38.6
43;2021-07-05;526;1202;112971;88888;49.8;39.2
43;2021-07-06;633;1681;113604;90569;50.1;39.9
43;2021-07-07;524;1423;114128;91992;50.3;40.5
43;2021-07-08;837;1417;114965;93409;50.7;41.2
43;2021-07-09;549;1499;115514;94908;50.9;41.8
43;2021-07-10;401;1337;115915;96245;51.1;42.4
43;2021-07-11;23;99;115938;96344;51.1;42.5
43;2021-07-12;604;1685;116542;98029;51.4;43.2
43;2021-07-13;1186;1849;117728;99878;51.9;44.0
43;2021-07-14;848;161;118576;100039;52.3;44.1
43;2021-07-15;1932;1844;120508;101883;53.1;44.9
43;2021-07-16;1753;1616;122261;103499;53.9;45.6
43;2021-07-17;1544;1202;123805;104701;54.6;46.1
43;2021-07-18;4;19;123809;104720;54.6;46.2
43;2021-07-19;1441;1258;125250;105978;55.2;46.7
43;2021-07-20;1895;1451;127145;107429;56.0;47.3
43;2021-07-21;1853;1113;128998;108542;56.9;47.8
43;2021-07-22;2110;1333;131108;109875;57.8;48.4
43;2021-07-23;1619;1326;132727;111201;58.5;49.0
43;2021-07-24;576;1000;133303;112201;58.7;49.4
43;2021-07-25;0;1;133303;112202;58.7;49.4
43;2021-07-26;1643;1072;134946;113274;59.5;49.9
43;2021-07-27;2284;1228;137230;114502;60.5;50.5
43;2021-07-28;1954;1093;139184;115595;61.3;50.9
43;2021-07-29;1986;1019;141170;116614;62.2;51.4
43;2021-07-30;1867;1339;143037;117953;63.0;52.0
43;2021-07-31;706;611;143743;118564;63.4;52.3
43;2021-08-01;13;21;143756;118585;63.4;52.3
43;2021-08-02;1534;970;145290;119555;64.0;52.7
43;2021-08-03;1405;1171;146695;120726;64.7;53.2
43;2021-08-04;1263;1109;147958;121835;65.2;53.7
43;2021-08-05;1254;1285;149212;123120;65.8;54.3
43;2021-08-06;1130;1466;150342;124586;66.3;54.9
43;2021-08-07;758;759;151100;125345;66.6;55.2
43;2021-08-08;5;0;151105;125345;66.6;55.2
43;2021-08-09;822;1637;151927;126982;67.0;56.0
43;2021-08-10;1022;1585;152949;128567;67.4;56.7
43;2021-08-11;680;1340;153629;129907;67.7;57.3
43;2021-08-12;875;1605;154504;131512;68.1;58.0
43;2021-08-13;680;1179;155184;132691;68.4;58.5
43;2021-08-14;364;557;155548;133248;68.6;58.7
43;2021-08-15;5;9;155553;133257;68.6;58.7
43;2021-08-16;686;1675;156239;134932;68.9;59.5
43;2021-08-17;713;1511;156952;136443;69.2;60.1
43;2021-08-18;558;1513;157510;137956;69.4;60.8
43;2021-08-19;641;1614;158151;139570;69.7;61.5
43;2021-08-20;518;1597;158669;141167;69.9;62.2
43;2021-08-21;239;555;158908;141722;70.0;62.5
43;2021-08-22;7;7;158915;141729;70.0;62.5
43;2021-08-23;500;1588;159415;143317;70.3;63.2
43;2021-08-24;518;1398;159933;144715;70.5;63.8
43;2021-08-25;522;1298;160455;146013;70.7;64.4
43;2021-08-26;475;1138;160930;147151;70.9;64.9
43;2021-08-27;529;1360;161459;148511;71.2;65.5
43;2021-08-28;178;499;161637;149010;71.2;65.7
43;2021-08-29;0;1;161637;149011;71.2;65.7
43;2021-08-30;500;1041;162137;150052;71.5;66.1
43;2021-08-31;382;834;162519;150886;71.6;66.5
43;2021-09-01;309;884;162828;151770;71.8;66.9
43;2021-09-02;311;870;163139;152640;71.9;67.3
43;2021-09-03;503;915;163642;153555;72.1;67.7
43;2021-09-04;320;545;163962;154100;72.3;67.9
43;2021-09-05;39;9;164001;154109;72.3;67.9
43;2021-09-06;250;679;164251;154788;72.4;68.2
43;2021-09-07;236;613;164487;155401;72.5;68.5
43;2021-09-08;207;694;164694;156095;72.6;68.8
43;2021-09-09;268;640;164962;156735;72.7;69.1
43;2021-09-10;329;609;165291;157344;72.8;69.3
43;2021-09-11;267;402;165558;157746;73.0;69.5
43;2021-09-12;0;4;165558;157750;73.0;69.5
43;2021-09-13;148;375;165706;158125;73.0;69.7
43;2021-09-14;213;332;165919;158457;73.1;69.8
43;2021-09-15;224;499;166143;158956;73.2;70.1
43;2021-09-16;197;356;166340;159312;73.3;70.2
43;2021-09-17;234;530;166574;159842;73.4;70.4
43;2021-09-18;157;350;166731;160192;73.5;70.6
43;2021-09-19;2;4;166733;160196;73.5;70.6
43;2021-09-20;102;306;166835;160502;73.5;70.7
43;2021-09-21;152;321;166987;160823;73.6;70.9
43;2021-09-22;124;393;167111;161216;73.6;71.1
43;2021-09-23;71;292;167182;161508;73.7;71.2
43;2021-09-24;176;489;167358;161997;73.8;71.4
43;2021-09-25;101;296;167459;162293;73.8;71.5
43;2021-09-26;0;0;167459;162293;73.8;71.5
43;2021-09-27;152;343;167611;162636;73.9;71.7
43;2021-09-28;389;225;168000;162861;74.0;71.8
43;2021-09-29;145;302;168145;163163;74.1;71.9
43;2021-09-30;79;181;168224;163344;74.1;72.0
43;2021-10-01;139;320;168363;163664;74.2;72.1
43;2021-10-02;102;244;168465;163908;74.2;72.2
43;2021-10-03;3;7;168468;163915;74.2;72.2
43;2021-10-04;113;176;168581;164091;74.3;72.3
43;2021-10-05;108;182;168689;164273;74.3;72.4
43;2021-10-06;121;224;168810;164497;74.4;72.5
43;2021-10-07;55;146;168865;164643;74.4;72.6
43;2021-10-08;170;314;169035;164957;74.5;72.7
43;2021-10-09;102;211;169137;165168;74.5;72.8
43;2021-10-10;1;1;169138;165169;74.5;72.8
43;2021-10-11;107;128;169245;165297;74.6;72.8
43;2021-10-12;107;191;169352;165488;74.6;72.9
43;2021-10-13;90;119;169442;165607;74.7;73.0
43;2021-10-14;94;138;169536;165745;74.7;73.0
43;2021-10-15;160;201;169696;165946;74.8;73.1
43;2021-10-16;106;142;169802;166088;74.8;73.2
43;2021-10-17;0;1;169802;166089;74.8;73.2
43;2021-10-18;109;140;169911;166229;74.9;73.3
43;2021-10-19;106;362;170017;166591;74.9;73.4
44;2020-12-27;1;0;1;0;0.0;0.0
44;2020-12-28;3;0;4;0;0.0;0.0
44;2020-12-29;1;0;5;0;0.0;0.0
44;2020-12-30;2;0;7;0;0.0;0.0
44;2020-12-31;1;0;8;0;0.0;0.0
44;2021-01-01;2;1;10;1;0.0;0.0
44;2021-01-02;0;0;10;1;0.0;0.0
44;2021-01-03;4;0;14;1;0.0;0.0
44;2021-01-04;0;0;14;1;0.0;0.0
44;2021-01-05;4;0;18;1;0.0;0.0
44;2021-01-06;20;1;38;2;0.0;0.0
44;2021-01-07;187;0;225;2;0.0;0.0
44;2021-01-08;528;0;753;2;0.1;0.0
44;2021-01-09;473;0;1226;2;0.1;0.0
44;2021-01-10;456;1;1682;3;0.1;0.0
44;2021-01-11;801;1;2483;4;0.2;0.0
44;2021-01-12;910;3;3393;7;0.2;0.0
44;2021-01-13;1086;1;4479;8;0.3;0.0
44;2021-01-14;1116;6;5595;14;0.4;0.0
44;2021-01-15;998;5;6593;19;0.5;0.0
44;2021-01-16;336;3;6929;22;0.5;0.0
44;2021-01-17;328;1;7257;23;0.5;0.0
44;2021-01-18;856;3;8113;26;0.6;0.0
44;2021-01-19;2625;11;10738;37;0.7;0.0
44;2021-01-20;2746;6;13484;43;0.9;0.0
44;2021-01-21;4538;12;18022;55;1.3;0.0
44;2021-01-22;2431;8;20453;63;1.4;0.0
44;2021-01-23;767;1;21220;64;1.5;0.0
44;2021-01-24;120;0;21340;64;1.5;0.0
44;2021-01-25;841;9;22181;73;1.5;0.0
44;2021-01-26;2563;20;24744;93;1.7;0.0
44;2021-01-27;2103;70;26847;163;1.9;0.0
44;2021-01-28;3732;203;30579;366;2.1;0.0
44;2021-01-29;2370;488;32949;854;2.3;0.1
44;2021-01-30;628;211;33577;1065;2.3;0.1
44;2021-01-31;14;210;33591;1275;2.3;0.1
44;2021-02-01;594;544;34185;1819;2.4;0.1
44;2021-02-02;879;757;35064;2576;2.4;0.2
44;2021-02-03;888;889;35952;3465;2.5;0.2
44;2021-02-04;938;724;36890;4189;2.6;0.3
44;2021-02-05;897;636;37787;4825;2.6;0.3
44;2021-02-06;471;270;38258;5095;2.7;0.4
44;2021-02-07;72;203;38330;5298;2.7;0.4
44;2021-02-08;522;460;38852;5758;2.7;0.4
44;2021-02-09;993;1253;39845;7011;2.8;0.5
44;2021-02-10;1144;1307;40989;8318;2.9;0.6
44;2021-02-11;2293;3075;43282;11393;3.0;0.8
44;2021-02-12;1662;1776;44944;13169;3.1;0.9
44;2021-02-13;433;506;45377;13675;3.2;1.0
44;2021-02-14;10;176;45387;13851;3.2;1.0
44;2021-02-15;505;1098;45892;14949;3.2;1.0
44;2021-02-16;1440;2558;47332;17507;3.3;1.2
44;2021-02-17;1106;2167;48438;19674;3.4;1.4
44;2021-02-18;1959;3718;50397;23392;3.5;1.6
44;2021-02-19;1580;2533;51977;25925;3.6;1.8
44;2021-02-20;409;642;52386;26567;3.6;1.8
44;2021-02-21;6;177;52392;26744;3.6;1.9
44;2021-02-22;717;834;53109;27578;3.7;1.9
44;2021-02-23;1248;1127;54357;28705;3.8;2.0
44;2021-02-24;1238;1099;55595;29804;3.9;2.1
44;2021-02-25;2446;1086;58041;30890;4.0;2.1
44;2021-02-26;2291;965;60332;31855;4.2;2.2
44;2021-02-27;975;451;61307;32306;4.3;2.2
44;2021-02-28;7;32;61314;32338;4.3;2.3
44;2021-03-01;988;563;62302;32901;4.3;2.3
44;2021-03-02;1814;1060;64116;33961;4.5;2.4
44;2021-03-03;1860;1138;65976;35099;4.6;2.4
44;2021-03-04;2882;1589;68858;36688;4.8;2.6
44;2021-03-05;3481;1340;72339;38028;5.0;2.6
44;2021-03-06;2507;497;74846;38525;5.2;2.7
44;2021-03-07;988;91;75834;38616;5.3;2.7
44;2021-03-08;1783;624;77617;39240;5.4;2.7
44;2021-03-09;3352;1150;80969;40390;5.6;2.8
44;2021-03-10;3079;1120;84048;41510;5.8;2.9
44;2021-03-11;4439;1795;88487;43305;6.2;3.0
44;2021-03-12;5893;1321;94380;44626;6.6;3.1
44;2021-03-13;3630;306;98010;44932;6.8;3.1
44;2021-03-14;432;64;98442;44996;6.8;3.1
44;2021-03-15;2688;379;101130;45375;7.0;3.2
44;2021-03-16;2151;631;103281;46006;7.2;3.2
44;2021-03-17;1960;682;105241;46688;7.3;3.2
44;2021-03-18;2169;641;107410;47329;7.5;3.3
44;2021-03-19;3785;371;111195;47700;7.7;3.3
44;2021-03-20;3213;302;114408;48002;8.0;3.3
44;2021-03-21;915;23;115323;48025;8.0;3.3
44;2021-03-22;2460;445;117783;48470;8.2;3.4
44;2021-03-23;3960;708;121743;49178;8.5;3.4
44;2021-03-24;4303;636;126046;49814;8.8;3.5
44;2021-03-25;5636;946;131682;50760;9.2;3.5
44;2021-03-26;6510;773;138192;51533;9.6;3.6
44;2021-03-27;3216;438;141408;51971;9.8;3.6
44;2021-03-28;1244;45;142652;52016;9.9;3.6
44;2021-03-29;3120;792;145772;52808;10.1;3.7
44;2021-03-30;5138;1120;150910;53928;10.5;3.8
44;2021-03-31;4614;1317;155524;55245;10.8;3.8
44;2021-04-01;6140;1024;161664;56269;11.2;3.9
44;2021-04-02;5795;965;167459;57234;11.7;4.0
44;2021-04-03;2434;654;169893;57888;11.8;4.0
44;2021-04-04;667;23;170560;57911;11.9;4.0
44;2021-04-05;692;288;171252;58199;11.9;4.0
44;2021-04-06;4216;1390;175468;59589;12.2;4.1
44;2021-04-07;5076;1654;180544;61243;12.6;4.3
44;2021-04-08;7182;1679;187726;62922;13.1;4.4
44;2021-04-09;10066;1834;197792;64756;13.8;4.5
44;2021-04-10;4563;1460;202355;66216;14.1;4.6
44;2021-04-11;2148;431;204503;66647;14.2;4.6
44;2021-04-12;5464;1593;209967;68240;14.6;4.7
44;2021-04-13;6727;2265;216694;70505;15.1;4.9
44;2021-04-14;5911;2242;222605;72747;15.5;5.1
44;2021-04-15;6708;2226;229313;74973;16.0;5.2
44;2021-04-16;7785;2056;237098;77029;16.5;5.4
44;2021-04-17;4301;1391;241399;78420;16.8;5.5
44;2021-04-18;2253;823;243652;79243;17.0;5.5
44;2021-04-19;5042;1913;248694;81156;17.3;5.6
44;2021-04-20;6282;2650;254976;83806;17.7;5.8
44;2021-04-21;6006;2794;260982;86600;18.2;6.0
44;2021-04-22;6958;2519;267940;89119;18.6;6.2
44;2021-04-23;7335;3191;275275;92310;19.2;6.4
44;2021-04-24;3971;2057;279246;94367;19.4;6.6
44;2021-04-25;2076;1060;281322;95427;19.6;6.6
44;2021-04-26;5648;2764;286970;98191;20.0;6.8
44;2021-04-27;7415;4104;294385;102295;20.5;7.1
44;2021-04-28;7608;3793;301993;106088;21.0;7.4
44;2021-04-29;8964;4286;310957;110374;21.6;7.7
44;2021-04-30;9570;4716;320527;115090;22.3;8.0
44;2021-05-01;2848;929;323375;116019;22.5;8.1
44;2021-05-02;1902;618;325277;116637;22.6;8.1
44;2021-05-03;5548;4085;330825;120722;23.0;8.4
44;2021-05-04;6326;5137;337151;125859;23.5;8.8
44;2021-05-05;6071;4636;343222;130495;23.9;9.1
44;2021-05-06;7255;4884;350477;135379;24.4;9.4
44;2021-05-07;7451;5726;357928;141105;24.9;9.8
44;2021-05-08;2583;1269;360511;142374;25.1;9.9
44;2021-05-09;1801;1812;362312;144186;25.2;10.0
44;2021-05-10;6574;5778;368886;149964;25.7;10.4
44;2021-05-11;7787;6280;376673;156244;26.2;10.9
44;2021-05-12;8195;5723;384868;161967;26.8;11.3
44;2021-05-13;5304;1194;390172;163161;27.1;11.4
44;2021-05-14;7586;3974;397758;167135;27.7;11.6
44;2021-05-15;5008;2234;402766;169369;28.0;11.8
44;2021-05-16;2791;741;405557;170110;28.2;11.8
44;2021-05-17;6744;5148;412301;175258;28.7;12.2
44;2021-05-18;7962;5234;420263;180492;29.2;12.6
44;2021-05-19;8165;4283;428428;184775;29.8;12.9
44;2021-05-20;8367;4651;436795;189426;30.4;13.2
44;2021-05-21;8846;5216;445641;194642;31.0;13.5
44;2021-05-22;5097;2231;450738;196873;31.4;13.7
44;2021-05-23;1759;826;452497;197699;31.5;13.8
44;2021-05-24;4884;1616;457381;199315;31.8;13.9
44;2021-05-25;7740;5552;465121;204867;32.4;14.3
44;2021-05-26;8181;5044;473302;209911;32.9;14.6
44;2021-05-27;9659;5358;482961;215269;33.6;15.0
44;2021-05-28;9182;6912;492143;222181;34.2;15.5
44;2021-05-29;5884;3333;498027;225514;34.7;15.7
44;2021-05-30;1775;705;499802;226219;34.8;15.7
44;2021-05-31;8059;6184;507861;232403;35.3;16.2
44;2021-06-01;9905;6571;517766;238974;36.0;16.6
44;2021-06-02;9534;5702;527300;244676;36.7;17.0
44;2021-06-03;10853;5888;538153;250564;37.4;17.4
44;2021-06-04;9959;8075;548112;258639;38.1;18.0
44;2021-06-05;5781;4344;553893;262983;38.5;18.3
44;2021-06-06;2361;1130;556254;264113;38.7;18.4
44;2021-06-07;9549;6936;565803;271049;39.4;18.9
44;2021-06-08;10907;7509;576710;278558;40.1;19.4
44;2021-06-09;10551;6329;587261;284887;40.9;19.8
44;2021-06-10;11423;6042;598684;290929;41.7;20.2
44;2021-06-11;11959;8648;610643;299577;42.5;20.8
44;2021-06-12;7761;4096;618404;303673;43.0;21.1
44;2021-06-13;2792;1004;621196;304677;43.2;21.2
44;2021-06-14;8761;8414;629957;313091;43.8;21.8
44;2021-06-15;11706;8259;641663;321350;44.6;22.4
44;2021-06-16;10976;7661;652639;329011;45.4;22.9
44;2021-06-17;11726;8686;664365;337697;46.2;23.5
44;2021-06-18;10900;10118;675265;347815;47.0;24.2
44;2021-06-19;5884;4325;681149;352140;47.4;24.5
44;2021-06-20;2535;1339;683684;353479;47.6;24.6
44;2021-06-21;7349;10014;691033;363493;48.1;25.3
44;2021-06-22;8469;10627;699502;374120;48.7;26.0
44;2021-06-23;8554;9140;708056;383260;49.3;26.7
44;2021-06-24;9123;8572;717179;391832;49.9;27.3
44;2021-06-25;7643;10818;724822;402650;50.4;28.0
44;2021-06-26;2957;6470;727779;409120;50.6;28.5
44;2021-06-27;816;2403;728595;411523;50.7;28.6
44;2021-06-28;5230;10056;733825;421579;51.1;29.3
44;2021-06-29;6179;12086;740004;433665;51.5;30.2
44;2021-06-30;6183;10448;746187;444113;51.9;30.9
44;2021-07-01;6930;10484;753117;454597;52.4;31.6
44;2021-07-02;6693;12550;759810;467147;52.9;32.5
44;2021-07-03;2584;7005;762394;474152;53.0;33.0
44;2021-07-04;995;2235;763389;476387;53.1;33.1
44;2021-07-05;5316;11872;768705;488259;53.5;34.0
44;2021-07-06;6058;12599;774763;500858;53.9;34.9
44;2021-07-07;6512;11102;781275;511960;54.4;35.6
44;2021-07-08;7393;11959;788668;523919;54.9;36.5
44;2021-07-09;6258;14252;794926;538171;55.3;37.4
44;2021-07-10;2446;7007;797372;545178;55.5;37.9
44;2021-07-11;731;2262;798103;547440;55.5;38.1
44;2021-07-12;4395;14053;802498;561493;55.8;39.1
44;2021-07-13;5767;14853;808265;576346;56.2;40.1
44;2021-07-14;3688;5810;811953;582156;56.5;40.5
44;2021-07-15;7228;14290;819181;596446;57.0;41.5
44;2021-07-16;8233;14994;827414;611440;57.6;42.5
44;2021-07-17;3371;7578;830785;619018;57.8;43.1
44;2021-07-18;1433;2548;832218;621566;57.9;43.3
44;2021-07-19;4871;14697;837089;636263;58.2;44.3
44;2021-07-20;6034;15672;843123;651935;58.7;45.4
44;2021-07-21;5843;13987;848966;665922;59.1;46.3
44;2021-07-22;6723;13750;855689;679672;59.5;47.3
44;2021-07-23;6161;15637;861850;695309;60.0;48.4
44;2021-07-24;2856;8718;864706;704027;60.2;49.0
44;2021-07-25;946;3088;865652;707115;60.2;49.2
44;2021-07-26;6081;12687;871733;719802;60.7;50.1
44;2021-07-27;9714;12193;881447;731995;61.3;50.9
44;2021-07-28;9262;10847;890709;742842;62.0;51.7
44;2021-07-29;10287;10849;900996;753691;62.7;52.4
44;2021-07-30;9185;10927;910181;764618;63.3;53.2
44;2021-07-31;4791;5652;914972;770270;63.7;53.6
44;2021-08-01;2575;1409;917547;771679;63.8;53.7
44;2021-08-02;6631;9477;924178;781156;64.3;54.4
44;2021-08-03;8466;8537;932644;789693;64.9;54.9
44;2021-08-04;9128;6987;941772;796680;65.5;55.4
44;2021-08-05;11570;7525;953342;804205;66.3;56.0
44;2021-08-06;9701;8204;963043;812409;67.0;56.5
44;2021-08-07;4609;3705;967652;816114;67.3;56.8
44;2021-08-08;2540;1727;970192;817841;67.5;56.9
44;2021-08-09;8904;7980;979096;825821;68.1;57.5
44;2021-08-10;10274;7627;989370;833448;68.8;58.0
44;2021-08-11;10426;6792;999796;840240;69.6;58.5
44;2021-08-12;10421;7347;1010217;847587;70.3;59.0
44;2021-08-13;8467;6168;1018684;853755;70.9;59.4
44;2021-08-14;3233;3222;1021917;856977;71.1;59.6
44;2021-08-15;716;933;1022633;857910;71.2;59.7
44;2021-08-16;5854;8308;1028487;866218;71.6;60.3
44;2021-08-17;5607;8179;1034094;874397;72.0;60.8
44;2021-08-18;4824;7621;1038918;882018;72.3;61.4
44;2021-08-19;4978;8351;1043896;890369;72.6;62.0
44;2021-08-20;4503;8922;1048399;899291;73.0;62.6
44;2021-08-21;1960;4612;1050359;903903;73.1;62.9
44;2021-08-22;712;2441;1051071;906344;73.1;63.1
44;2021-08-23;3680;9434;1054751;915778;73.4;63.7
44;2021-08-24;3646;8699;1058397;924477;73.6;64.3
44;2021-08-25;3149;8587;1061546;933064;73.9;64.9
44;2021-08-26;2969;10339;1064515;943403;74.1;65.6
44;2021-08-27;3086;10452;1067601;953855;74.3;66.4
44;2021-08-28;1388;5849;1068989;959704;74.4;66.8
44;2021-08-29;565;2706;1069554;962410;74.4;67.0
44;2021-08-30;2666;10876;1072220;973286;74.6;67.7
44;2021-08-31;2828;10971;1075048;984257;74.8;68.5
44;2021-09-01;2755;9514;1077803;993771;75.0;69.1
44;2021-09-02;2322;8289;1080125;1002060;75.2;69.7
44;2021-09-03;2184;9700;1082309;1011760;75.3;70.4
44;2021-09-04;1456;5828;1083765;1017588;75.4;70.8
44;2021-09-05;442;1318;1084207;1018906;75.4;70.9
44;2021-09-06;1664;6054;1085871;1024960;75.6;71.3
44;2021-09-07;1489;5206;1087360;1030166;75.7;71.7
44;2021-09-08;1916;6050;1089276;1036216;75.8;72.1
44;2021-09-09;1521;4537;1090797;1040753;75.9;72.4
44;2021-09-10;1850;5894;1092647;1046647;76.0;72.8
44;2021-09-11;1092;3940;1093739;1050587;76.1;73.1
44;2021-09-12;239;813;1093978;1051400;76.1;73.2
44;2021-09-13;1211;3573;1095189;1054973;76.2;73.4
44;2021-09-14;1126;3301;1096315;1058274;76.3;73.6
44;2021-09-15;1452;4490;1097767;1062764;76.4;74.0
44;2021-09-16;999;2382;1098766;1065146;76.5;74.1
44;2021-09-17;1272;3852;1100038;1068998;76.5;74.4
44;2021-09-18;782;3133;1100820;1072131;76.6;74.6
44;2021-09-19;217;703;1101037;1072834;76.6;74.7
44;2021-09-20;926;2206;1101963;1075040;76.7;74.8
44;2021-09-21;760;1872;1102723;1076912;76.7;74.9
44;2021-09-22;945;3548;1103668;1080460;76.8;75.2
44;2021-09-23;835;1936;1104503;1082396;76.9;75.3
44;2021-09-24;1111;3000;1105614;1085396;76.9;75.5
44;2021-09-25;500;2292;1106114;1087688;77.0;75.7
44;2021-09-26;187;487;1106301;1088175;77.0;75.7
44;2021-09-27;772;1788;1107073;1089963;77.0;75.8
44;2021-09-28;659;1680;1107732;1091643;77.1;76.0
44;2021-09-29;965;2510;1108697;1094153;77.1;76.1
44;2021-09-30;724;1520;1109421;1095673;77.2;76.2
44;2021-10-01;919;2275;1110340;1097948;77.3;76.4
44;2021-10-02;476;1321;1110816;1099269;77.3;76.5
44;2021-10-03;219;362;1111035;1099631;77.3;76.5
44;2021-10-04;503;964;1111538;1100595;77.3;76.6
44;2021-10-05;465;967;1112003;1101562;77.4;76.6
44;2021-10-06;718;1532;1112721;1103094;77.4;76.8
44;2021-10-07;582;1072;1113303;1104166;77.5;76.8
44;2021-10-08;849;1555;1114152;1105721;77.5;76.9
44;2021-10-09;415;961;1114567;1106682;77.6;77.0
44;2021-10-10;113;228;1114680;1106910;77.6;77.0
44;2021-10-11;526;998;1115206;1107908;77.6;77.1
44;2021-10-12;469;830;1115675;1108738;77.6;77.1
44;2021-10-13;596;1122;1116271;1109860;77.7;77.2
44;2021-10-14;544;959;1116815;1110819;77.7;77.3
44;2021-10-15;713;1285;1117528;1112104;77.8;77.4
44;2021-10-16;355;640;1117883;1112744;77.8;77.4
44;2021-10-17;86;190;1117969;1112934;77.8;77.4
44;2021-10-18;613;775;1118582;1113709;77.8;77.5
44;2021-10-19;521;764;1119103;1114473;77.9;77.5
45;2020-12-27;0;0;0;0;0.0;0.0
45;2020-12-28;1;0;1;0;0.0;0.0
45;2020-12-29;0;0;1;0;0.0;0.0
45;2020-12-30;0;0;1;0;0.0;0.0
45;2020-12-31;1;0;2;0;0.0;0.0
45;2021-01-01;0;0;2;0;0.0;0.0
45;2021-01-02;0;0;2;0;0.0;0.0
45;2021-01-03;0;0;2;0;0.0;0.0
45;2021-01-04;0;0;2;0;0.0;0.0
45;2021-01-05;76;0;78;0;0.0;0.0
45;2021-01-06;68;0;146;0;0.0;0.0
45;2021-01-07;220;1;366;1;0.1;0.0
45;2021-01-08;199;1;565;2;0.1;0.0
45;2021-01-09;42;0;607;2;0.1;0.0
45;2021-01-10;23;0;630;2;0.1;0.0
45;2021-01-11;254;0;884;2;0.1;0.0
45;2021-01-12;680;3;1564;5;0.2;0.0
45;2021-01-13;496;2;2060;7;0.3;0.0
45;2021-01-14;495;40;2555;47;0.4;0.0
45;2021-01-15;391;3;2946;50;0.4;0.0
45;2021-01-16;39;1;2985;51;0.4;0.0
45;2021-01-17;24;0;3009;51;0.4;0.0
45;2021-01-18;816;4;3825;55;0.6;0.0
45;2021-01-19;1198;8;5023;63;0.7;0.0
45;2021-01-20;2119;13;7142;76;1.0;0.0
45;2021-01-21;2521;7;9663;83;1.4;0.0
45;2021-01-22;1408;7;11071;90;1.6;0.0
45;2021-01-23;124;0;11195;90;1.6;0.0
45;2021-01-24;39;0;11234;90;1.6;0.0
45;2021-01-25;557;3;11791;93;1.7;0.0
45;2021-01-26;870;19;12661;112;1.9;0.0
45;2021-01-27;650;45;13311;157;1.9;0.0
45;2021-01-28;881;212;14192;369;2.1;0.1
45;2021-01-29;578;124;14770;493;2.2;0.1
45;2021-01-30;40;41;14810;534;2.2;0.1
45;2021-01-31;37;23;14847;557;2.2;0.1
45;2021-02-01;461;205;15308;762;2.2;0.1
45;2021-02-02;761;467;16069;1229;2.4;0.2
45;2021-02-03;773;479;16842;1708;2.5;0.3
45;2021-02-04;716;274;17558;1982;2.6;0.3
45;2021-02-05;418;152;17976;2134;2.6;0.3
45;2021-02-06;39;29;18015;2163;2.6;0.3
45;2021-02-07;7;31;18022;2194;2.6;0.3
45;2021-02-08;455;194;18477;2388;2.7;0.3
45;2021-02-09;1006;411;19483;2799;2.9;0.4
45;2021-02-10;1280;811;20763;3610;3.0;0.5
45;2021-02-11;1384;1527;22147;5137;3.2;0.8
45;2021-02-12;1052;1140;23199;6277;3.4;0.9
45;2021-02-13;85;158;23284;6435;3.4;0.9
45;2021-02-14;40;11;23324;6446;3.4;0.9
45;2021-02-15;524;607;23848;7053;3.5;1.0
45;2021-02-16;757;933;24605;7986;3.6;1.2
45;2021-02-17;642;1046;25247;9032;3.7;1.3
45;2021-02-18;842;849;26089;9881;3.8;1.4
45;2021-02-19;828;761;26917;10642;3.9;1.6
45;2021-02-20;59;94;26976;10736;4.0;1.6
45;2021-02-21;17;44;26993;10780;4.0;1.6
45;2021-02-22;409;632;27402;11412;4.0;1.7
45;2021-02-23;816;789;28218;12201;4.1;1.8
45;2021-02-24;656;917;28874;13118;4.2;1.9
45;2021-02-25;962;781;29836;13899;4.4;2.0
45;2021-02-26;1044;684;30880;14583;4.5;2.1
45;2021-02-27;291;52;31171;14635;4.6;2.1
45;2021-02-28;29;5;31200;14640;4.6;2.1
45;2021-03-01;536;336;31736;14976;4.6;2.2
45;2021-03-02;668;726;32404;15702;4.7;2.3
45;2021-03-03;981;898;33385;16600;4.9;2.4
45;2021-03-04;1108;994;34493;17594;5.1;2.6
45;2021-03-05;1443;874;35936;18468;5.3;2.7
45;2021-03-06;2021;141;37957;18609;5.6;2.7
45;2021-03-07;143;59;38100;18668;5.6;2.7
45;2021-03-08;753;848;38853;19516;5.7;2.9
45;2021-03-09;1256;722;40109;20238;5.9;3.0
45;2021-03-10;1591;906;41700;21144;6.1;3.1
45;2021-03-11;1722;757;43422;21901;6.4;3.2
45;2021-03-12;2072;616;45494;22517;6.7;3.3
45;2021-03-13;988;48;46482;22565;6.8;3.3
45;2021-03-14;24;43;46506;22608;6.8;3.3
45;2021-03-15;810;597;47316;23205;6.9;3.4
45;2021-03-16;942;839;48258;24044;7.1;3.5
45;2021-03-17;1054;690;49312;24734;7.2;3.6
45;2021-03-18;997;585;50309;25319;7.4;3.7
45;2021-03-19;1619;431;51928;25750;7.6;3.8
45;2021-03-20;498;82;52426;25832;7.7;3.8
45;2021-03-21;20;35;52446;25867;7.7;3.8
45;2021-03-22;914;533;53360;26400;7.8;3.9
45;2021-03-23;1985;731;55345;27131;8.1;4.0
45;2021-03-24;1896;556;57241;27687;8.4;4.1
45;2021-03-25;2983;457;60224;28144;8.8;4.1
45;2021-03-26;3390;489;63614;28633;9.3;4.2
45;2021-03-27;1796;126;65410;28759;9.6;4.2
45;2021-03-28;89;40;65499;28799;9.6;4.2
45;2021-03-29;1531;543;67030;29342;9.8;4.3
45;2021-03-30;2784;791;69814;30133;10.2;4.4
45;2021-03-31;2135;585;71949;30718;10.5;4.5
45;2021-04-01;2968;569;74917;31287;11.0;4.6
45;2021-04-02;2827;522;77744;31809;11.4;4.7
45;2021-04-03;810;73;78554;31882;11.5;4.7
45;2021-04-04;113;33;78667;31915;11.5;4.7
45;2021-04-05;15;2;78682;31917;11.5;4.7
45;2021-04-06;1735;798;80417;32715;11.8;4.8
45;2021-04-07;1775;1118;82192;33833;12.0;5.0
45;2021-04-08;2772;1024;84964;34857;12.4;5.1
45;2021-04-09;3676;650;88640;35507;13.0;5.2
45;2021-04-10;2323;120;90963;35627;13.3;5.2
45;2021-04-11;153;25;91116;35652;13.3;5.2
45;2021-04-12;2606;680;93722;36332;13.7;5.3
45;2021-04-13;3848;1096;97570;37428;14.3;5.5
45;2021-04-14;2929;1225;100499;38653;14.7;5.7
45;2021-04-15;3519;1045;104018;39698;15.2;5.8
45;2021-04-16;3775;694;107793;40392;15.8;5.9
45;2021-04-17;1614;116;109407;40508;16.0;5.9
45;2021-04-18;200;43;109607;40551;16.1;5.9
45;2021-04-19;1938;946;111545;41497;16.3;6.1
45;2021-04-20;3074;1702;114619;43199;16.8;6.3
45;2021-04-21;2726;1311;117345;44510;17.2;6.5
45;2021-04-22;3420;1845;120765;46355;17.7;6.8
45;2021-04-23;3278;1788;124043;48143;18.2;7.0
45;2021-04-24;2023;870;126066;49013;18.5;7.2
45;2021-04-25;290;88;126356;49101;18.5;7.2
45;2021-04-26;2229;1167;128585;50268;18.8;7.4
45;2021-04-27;3351;2354;131936;52622;19.3;7.7
45;2021-04-28;2801;1947;134737;54569;19.7;8.0
45;2021-04-29;3854;2346;138591;56915;20.3;8.3
45;2021-04-30;4391;1816;142982;58731;20.9;8.6
45;2021-05-01;451;62;143433;58793;21.0;8.6
45;2021-05-02;627;122;144060;58915;21.1;8.6
45;2021-05-03;2821;994;146881;59909;21.5;8.8
45;2021-05-04;3157;2351;150038;62260;22.0;9.1
45;2021-05-05;2715;2164;152753;64424;22.4;9.4
45;2021-05-06;3330;2543;156083;66967;22.9;9.8
45;2021-05-07;2871;3199;158954;70166;23.3;10.3
45;2021-05-08;613;252;159567;70418;23.4;10.3
45;2021-05-09;1498;134;161065;70552;23.6;10.3
45;2021-05-10;4139;2982;165204;73534;24.2;10.8
45;2021-05-11;5030;2975;170234;76509;24.9;11.2
45;2021-05-12;6078;2786;176312;79295;25.8;11.6
45;2021-05-13;2449;598;178761;79893;26.2;11.7
45;2021-05-14;4965;1633;183726;81526;26.9;11.9
45;2021-05-15;4066;618;187792;82144;27.5;12.0
45;2021-05-16;289;33;188081;82177;27.5;12.0
45;2021-05-17;3359;1538;191440;83715;28.0;12.3
45;2021-05-18;5117;1682;196557;85397;28.8;12.5
45;2021-05-19;4494;2064;201051;87461;29.4;12.8
45;2021-05-20;5267;2142;206318;89603;30.2;13.1
45;2021-05-21;5141;2227;211459;91830;31.0;13.4
45;2021-05-22;3042;632;214501;92462;31.4;13.5
45;2021-05-23;15;94;214516;92556;31.4;13.6
45;2021-05-24;2826;216;217342;92772;31.8;13.6
45;2021-05-25;4961;3034;222303;95806;32.6;14.0
45;2021-05-26;5106;2338;227409;98144;33.3;14.4
45;2021-05-27;5307;3237;232716;101381;34.1;14.8
45;2021-05-28;5665;3593;238381;104974;34.9;15.4
45;2021-05-29;3671;1290;242052;106264;35.4;15.6
45;2021-05-30;33;182;242085;106446;35.5;15.6
45;2021-05-31;4331;2520;246416;108966;36.1;16.0
45;2021-06-01;6090;3007;252506;111973;37.0;16.4
45;2021-06-02;4937;3108;257443;115081;37.7;16.9
45;2021-06-03;5615;3207;263058;118288;38.5;17.3
45;2021-06-04;5894;3185;268952;121473;39.4;17.8
45;2021-06-05;2035;1338;270987;122811;39.7;18.0
45;2021-06-06;88;198;271075;123009;39.7;18.0
45;2021-06-07;4081;2724;275156;125733;40.3;18.4
45;2021-06-08;4646;4080;279802;129813;41.0;19.0
45;2021-06-09;4356;3345;284158;133158;41.6;19.5
45;2021-06-10;4646;2687;288804;135845;42.3;19.9
45;2021-06-11;4121;3669;292925;139514;42.9;20.4
45;2021-06-12;2440;1507;295365;141021;43.3;20.7
45;2021-06-13;21;424;295386;141445;43.3;20.7
45;2021-06-14;3142;4158;298528;145603;43.7;21.3
45;2021-06-15;3388;4325;301916;149928;44.2;22.0
45;2021-06-16;3909;3458;305825;153386;44.8;22.5
45;2021-06-17;3522;3538;309347;156924;45.3;23.0
45;2021-06-18;3799;5028;313146;161952;45.9;23.7
45;2021-06-19;2393;1761;315539;163713;46.2;24.0
45;2021-06-20;48;142;315587;163855;46.2;24.0
45;2021-06-21;2165;5851;317752;169706;46.5;24.9
45;2021-06-22;2417;6531;320169;176237;46.9;25.8
45;2021-06-23;2282;5600;322451;181837;47.2;26.6
45;2021-06-24;2137;3531;324588;185368;47.5;27.1
45;2021-06-25;2444;6446;327032;191814;47.9;28.1
45;2021-06-26;1948;3094;328980;194908;48.2;28.5
45;2021-06-27;53;138;329033;195046;48.2;28.6
45;2021-06-28;2083;4834;331116;199880;48.5;29.3
45;2021-06-29;2848;6817;333964;206697;48.9;30.3
45;2021-06-30;2888;5854;336852;212551;49.3;31.1
45;2021-07-01;2398;5039;339250;217590;49.7;31.9
45;2021-07-02;2377;6283;341627;223873;50.0;32.8
45;2021-07-03;754;2540;342381;226413;50.1;33.2
45;2021-07-04;6;12;342387;226425;50.1;33.2
45;2021-07-05;2143;4992;344530;231417;50.5;33.9
45;2021-07-06;2806;6776;347336;238193;50.9;34.9
45;2021-07-07;2452;6064;349788;244257;51.2;35.8
45;2021-07-08;2828;5377;352616;249634;51.6;36.6
45;2021-07-09;2160;6985;354776;256619;52.0;37.6
45;2021-07-10;1552;3863;356328;260482;52.2;38.1
45;2021-07-11;24;31;356352;260513;52.2;38.1
45;2021-07-12;1591;5996;357943;266509;52.4;39.0
45;2021-07-13;3042;8236;360985;274745;52.9;40.2
45;2021-07-14;1480;1520;362465;276265;53.1;40.5
45;2021-07-15;3733;7290;366198;283555;53.6;41.5
45;2021-07-16;3255;7447;369453;291002;54.1;42.6
45;2021-07-17;1285;2332;370738;293334;54.3;43.0
45;2021-07-18;15;19;370753;293353;54.3;43.0
45;2021-07-19;1870;5936;372623;299289;54.6;43.8
45;2021-07-20;4756;6906;377379;306195;55.3;44.8
45;2021-07-21;5176;5480;382555;311675;56.0;45.6
45;2021-07-22;6179;4904;388734;316579;56.9;46.4
45;2021-07-23;4261;5483;392995;322062;57.5;47.2
45;2021-07-24;1864;2825;394859;324887;57.8;47.6
45;2021-07-25;5;14;394864;324901;57.8;47.6
45;2021-07-26;2913;4985;397777;329886;58.2;48.3
45;2021-07-27;5464;5085;403241;334971;59.0;49.1
45;2021-07-28;4989;4181;408230;339152;59.8;49.7
45;2021-07-29;5281;3257;413511;342409;60.6;50.1
45;2021-07-30;4762;4709;418273;347118;61.3;50.8
45;2021-07-31;849;1950;419122;349068;61.4;51.1
45;2021-08-01;2;4;419124;349072;61.4;51.1
45;2021-08-02;3639;3246;422763;352318;61.9;51.6
45;2021-08-03;4878;3011;427641;355329;62.6;52.0
45;2021-08-04;3744;2236;431385;357565;63.2;52.4
45;2021-08-05;3327;2641;434712;360206;63.7;52.7
45;2021-08-06;3747;3271;438459;363477;64.2;53.2
45;2021-08-07;1680;1050;440139;364527;64.5;53.4
45;2021-08-08;9;18;440148;364545;64.5;53.4
45;2021-08-09;2627;3017;442775;367562;64.8;53.8
45;2021-08-10;3517;3808;446292;371370;65.4;54.4
45;2021-08-11;2701;3721;448993;375091;65.7;54.9
45;2021-08-12;2093;3431;451086;378522;66.1;55.4
45;2021-08-13;1743;4224;452829;382746;66.3;56.0
45;2021-08-14;682;957;453511;383703;66.4;56.2
45;2021-08-15;63;31;453574;383734;66.4;56.2
45;2021-08-16;1158;2319;454732;386053;66.6;56.5
45;2021-08-17;1859;3448;456591;389501;66.9;57.0
45;2021-08-18;1782;4050;458373;393551;67.1;57.6
45;2021-08-19;1445;4268;459818;397819;67.3;58.3
45;2021-08-20;1424;3681;461242;401500;67.5;58.8
45;2021-08-21;905;1154;462147;402654;67.7;59.0
45;2021-08-22;4;8;462151;402662;67.7;59.0
45;2021-08-23;1333;4245;463484;406907;67.9;59.6
45;2021-08-24;1736;4522;465220;411429;68.1;60.2
45;2021-08-25;1585;3726;466805;415155;68.4;60.8
45;2021-08-26;1010;3450;467815;418605;68.5;61.3
45;2021-08-27;1433;4982;469248;423587;68.7;62.0
45;2021-08-28;879;2029;470127;425616;68.8;62.3
45;2021-08-29;100;37;470227;425653;68.9;62.3
45;2021-08-30;1223;4040;471450;429693;69.0;62.9
45;2021-08-31;1078;4391;472528;434084;69.2;63.6
45;2021-09-01;1106;3387;473634;437471;69.4;64.1
45;2021-09-02;925;3116;474559;440587;69.5;64.5
45;2021-09-03;1093;3595;475652;444182;69.7;65.0
45;2021-09-04;496;1261;476148;445443;69.7;65.2
45;2021-09-05;1;16;476149;445459;69.7;65.2
45;2021-09-06;882;2360;477031;447819;69.9;65.6
45;2021-09-07;712;1725;477743;449544;70.0;65.8
45;2021-09-08;859;2218;478602;451762;70.1;66.2
45;2021-09-09;801;1444;479403;453206;70.2;66.4
45;2021-09-10;788;1607;480191;454813;70.3;66.6
45;2021-09-11;445;1520;480636;456333;70.4;66.8
45;2021-09-12;372;161;481008;456494;70.4;66.8
45;2021-09-13;441;972;481449;457466;70.5;67.0
45;2021-09-14;760;1439;482209;458905;70.6;67.2
45;2021-09-15;800;1829;483009;460734;70.7;67.5
45;2021-09-16;805;963;483814;461697;70.8;67.6
45;2021-09-17;766;1656;484580;463353;71.0;67.9
45;2021-09-18;483;991;485063;464344;71.0;68.0
45;2021-09-19;2;29;485065;464373;71.0;68.0
45;2021-09-20;413;979;485478;465352;71.1;68.1
45;2021-09-21;452;751;485930;466103;71.2;68.3
45;2021-09-22;442;1703;486372;467806;71.2;68.5
45;2021-09-23;532;841;486904;468647;71.3;68.6
45;2021-09-24;580;1381;487484;470028;71.4;68.8
45;2021-09-25;353;784;487837;470812;71.4;68.9
45;2021-09-26;2;11;487839;470823;71.4;68.9
45;2021-09-27;436;755;488275;471578;71.5;69.1
45;2021-09-28;453;755;488728;472333;71.6;69.2
45;2021-09-29;477;969;489205;473302;71.6;69.3
45;2021-09-30;357;823;489562;474125;71.7;69.4
45;2021-10-01;317;768;489879;474893;71.7;69.5
45;2021-10-02;293;546;490172;475439;71.8;69.6
45;2021-10-03;98;370;490270;475809;71.8;69.7
45;2021-10-04;219;342;490489;476151;71.8;69.7
45;2021-10-05;347;655;490836;476806;71.9;69.8
45;2021-10-06;436;720;491272;477526;71.9;69.9
45;2021-10-07;282;760;491554;478286;72.0;70.0
45;2021-10-08;351;667;491905;478953;72.0;70.1
45;2021-10-09;418;721;492323;479674;72.1;70.2
45;2021-10-10;4;7;492327;479681;72.1;70.2
45;2021-10-11;204;414;492531;480095;72.1;70.3
45;2021-10-12;344;532;492875;480627;72.2;70.4
45;2021-10-13;334;619;493209;481246;72.2;70.5
45;2021-10-14;256;393;493465;481639;72.3;70.5
45;2021-10-15;408;681;493873;482320;72.3;70.6
45;2021-10-16;348;505;494221;482825;72.4;70.7
45;2021-10-17;0;2;494221;482827;72.4;70.7
45;2021-10-18;241;340;494462;483167;72.4;70.8
45;2021-10-19;221;543;494683;483710;72.4;70.8
46;2020-12-27;4;0;4;0;0.0;0.0
46;2020-12-28;0;0;4;0;0.0;0.0
46;2020-12-29;0;0;4;0;0.0;0.0
46;2020-12-30;0;0;4;0;0.0;0.0
46;2020-12-31;0;0;4;0;0.0;0.0
46;2021-01-01;0;0;4;0;0.0;0.0
46;2021-01-02;0;0;4;0;0.0;0.0
46;2021-01-03;1;0;5;0;0.0;0.0
46;2021-01-04;0;0;5;0;0.0;0.0
46;2021-01-05;0;0;5;0;0.0;0.0
46;2021-01-06;3;0;8;0;0.0;0.0
46;2021-01-07;135;1;143;1;0.1;0.0
46;2021-01-08;181;0;324;1;0.2;0.0
46;2021-01-09;1;0;325;1;0.2;0.0
46;2021-01-10;2;0;327;1;0.2;0.0
46;2021-01-11;118;0;445;1;0.3;0.0
46;2021-01-12;141;0;586;1;0.3;0.0
46;2021-01-13;235;2;821;3;0.5;0.0
46;2021-01-14;244;3;1065;6;0.6;0.0
46;2021-01-15;306;2;1371;8;0.8;0.0
46;2021-01-16;18;0;1389;8;0.8;0.0
46;2021-01-17;0;0;1389;8;0.8;0.0
46;2021-01-18;276;3;1665;11;1.0;0.0
46;2021-01-19;391;1;2056;12;1.2;0.0
46;2021-01-20;939;3;2995;15;1.7;0.0
46;2021-01-21;998;1;3993;16;2.3;0.0
46;2021-01-22;391;2;4384;18;2.5;0.0
46;2021-01-23;0;0;4384;18;2.5;0.0
46;2021-01-24;0;0;4384;18;2.5;0.0
46;2021-01-25;204;2;4588;20;2.6;0.0
46;2021-01-26;264;1;4852;21;2.8;0.0
46;2021-01-27;276;0;5128;21;3.0;0.0
46;2021-01-28;279;43;5407;64;3.1;0.0
46;2021-01-29;233;91;5640;155;3.3;0.1
46;2021-01-30;1;0;5641;155;3.3;0.1
46;2021-01-31;1;0;5642;155;3.3;0.1
46;2021-02-01;234;173;5876;328;3.4;0.2
46;2021-02-02;210;238;6086;566;3.5;0.3
46;2021-02-03;227;97;6313;663;3.6;0.4
46;2021-02-04;372;86;6685;749;3.9;0.4
46;2021-02-05;226;177;6911;926;4.0;0.5
46;2021-02-06;9;0;6920;926;4.0;0.5
46;2021-02-07;43;0;6963;926;4.0;0.5
46;2021-02-08;197;156;7160;1082;4.1;0.6
46;2021-02-09;271;225;7431;1307;4.3;0.8
46;2021-02-10;280;546;7711;1853;4.5;1.1
46;2021-02-11;655;557;8366;2410;4.8;1.4
46;2021-02-12;324;342;8690;2752;5.0;1.6
46;2021-02-13;3;0;8693;2752;5.0;1.6
46;2021-02-14;0;62;8693;2814;5.0;1.6
46;2021-02-15;197;293;8890;3107;5.1;1.8
46;2021-02-16;217;284;9107;3391;5.3;2.0
46;2021-02-17;201;328;9308;3719;5.4;2.1
46;2021-02-18;337;267;9645;3986;5.6;2.3
46;2021-02-19;277;234;9922;4220;5.7;2.4
46;2021-02-20;0;0;9922;4220;5.7;2.4
46;2021-02-21;1;0;9923;4220;5.7;2.4
46;2021-02-22;131;193;10054;4413;5.8;2.5
46;2021-02-23;225;169;10279;4582;5.9;2.6
46;2021-02-24;179;323;10458;4905;6.0;2.8
46;2021-02-25;248;341;10706;5246;6.2;3.0
46;2021-02-26;404;344;11110;5590;6.4;3.2
46;2021-02-27;120;1;11230;5591;6.5;3.2
46;2021-02-28;0;3;11230;5594;6.5;3.2
46;2021-03-01;169;181;11399;5775;6.6;3.3
46;2021-03-02;406;233;11805;6008;6.8;3.5
46;2021-03-03;460;331;12265;6339;7.1;3.7
46;2021-03-04;607;456;12872;6795;7.4;3.9
46;2021-03-05;808;365;13680;7160;7.9;4.1
46;2021-03-06;476;17;14156;7177;8.2;4.1
46;2021-03-07;101;19;14257;7196;8.2;4.2
46;2021-03-08;348;249;14605;7445;8.4;4.3
46;2021-03-09;746;271;15351;7716;8.9;4.5
46;2021-03-10;686;248;16037;7964;9.3;4.6
46;2021-03-11;851;257;16888;8221;9.8;4.7
46;2021-03-12;927;228;17815;8449;10.3;4.9
46;2021-03-13;512;4;18327;8453;10.6;4.9
46;2021-03-14;1;0;18328;8453;10.6;4.9
46;2021-03-15;505;166;18833;8619;10.9;5.0
46;2021-03-16;752;174;19585;8793;11.3;5.1
46;2021-03-17;674;207;20259;9000;11.7;5.2
46;2021-03-18;758;216;21017;9216;12.1;5.3
46;2021-03-19;811;153;21828;9369;12.6;5.4
46;2021-03-20;294;5;22122;9374;12.8;5.4
46;2021-03-21;2;0;22124;9374;12.8;5.4
46;2021-03-22;555;241;22679;9615;13.1;5.6
46;2021-03-23;702;212;23381;9827;13.5;5.7
46;2021-03-24;673;240;24054;10067;13.9;5.8
46;2021-03-25;1135;187;25189;10254;14.5;5.9
46;2021-03-26;1023;342;26212;10596;15.1;6.1
46;2021-03-27;420;73;26632;10669;15.4;6.2
46;2021-03-28;127;1;26759;10670;15.5;6.2
46;2021-03-29;733;253;27492;10923;15.9;6.3
46;2021-03-30;767;365;28259;11288;16.3;6.5
46;2021-03-31;865;421;29124;11709;16.8;6.8
46;2021-04-01;1172;351;30296;12060;17.5;7.0
46;2021-04-02;922;396;31218;12456;18.0;7.2
46;2021-04-03;167;166;31385;12622;18.1;7.3
46;2021-04-04;0;71;31385;12693;18.1;7.3
46;2021-04-05;3;0;31388;12693;18.1;7.3
46;2021-04-06;544;517;31932;13210;18.4;7.6
46;2021-04-07;786;647;32718;13857;18.9;8.0
46;2021-04-08;960;542;33678;14399;19.4;8.3
46;2021-04-09;1018;506;34696;14905;20.0;8.6
46;2021-04-10;506;211;35202;15116;20.3;8.7
46;2021-04-11;232;1;35434;15117;20.5;8.7
46;2021-04-12;845;547;36279;15664;21.0;9.0
46;2021-04-13;1186;721;37465;16385;21.6;9.5
46;2021-04-14;1533;615;38998;17000;22.5;9.8
46;2021-04-15;1505;665;40503;17665;23.4;10.2
46;2021-04-16;1584;566;42087;18231;24.3;10.5
46;2021-04-17;995;137;43082;18368;24.9;10.6
46;2021-04-18;517;10;43599;18378;25.2;10.6
46;2021-04-19;1070;574;44669;18952;25.8;10.9
46;2021-04-20;1229;734;45898;19686;26.5;11.4
46;2021-04-21;1230;714;47128;20400;27.2;11.8
46;2021-04-22;1391;730;48519;21130;28.0;12.2
46;2021-04-23;1132;733;49651;21863;28.7;12.6
46;2021-04-24;472;19;50123;21882;28.9;12.6
46;2021-04-25;351;11;50474;21893;29.1;12.6
46;2021-04-26;852;730;51326;22623;29.6;13.1
46;2021-04-27;1221;668;52547;23291;30.3;13.5
46;2021-04-28;1290;669;53837;23960;31.1;13.8
46;2021-04-29;1417;527;55254;24487;31.9;14.1
46;2021-04-30;1438;569;56692;25056;32.7;14.5
46;2021-05-01;697;74;57389;25130;33.1;14.5
46;2021-05-02;346;4;57735;25134;33.3;14.5
46;2021-05-03;852;570;58587;25704;33.8;14.8
46;2021-05-04;1037;1063;59624;26767;34.4;15.5
46;2021-05-05;1373;790;60997;27557;35.2;15.9
46;2021-05-06;1377;743;62374;28300;36.0;16.3
46;2021-05-07;1396;791;63770;29091;36.8;16.8
46;2021-05-08;280;412;64050;29503;37.0;17.0
46;2021-05-09;23;225;64073;29728;37.0;17.2
46;2021-05-10;515;1137;64588;30865;37.3;17.8
46;2021-05-11;1031;1256;65619;32121;37.9;18.5
46;2021-05-12;993;1564;66612;33685;38.5;19.5
46;2021-05-13;598;143;67210;33828;38.8;19.5
46;2021-05-14;958;1097;68168;34925;39.4;20.2
46;2021-05-15;254;654;68422;35579;39.5;20.5
46;2021-05-16;77;297;68499;35876;39.6;20.7
46;2021-05-17;652;960;69151;36836;39.9;21.3
46;2021-05-18;1402;1025;70553;37861;40.7;21.9
46;2021-05-19;1305;904;71858;38765;41.5;22.4
46;2021-05-20;1453;813;73311;39578;42.3;22.9
46;2021-05-21;997;1158;74308;40736;42.9;23.5
46;2021-05-22;146;369;74454;41105;43.0;23.7
46;2021-05-23;451;26;74905;41131;43.3;23.8
46;2021-05-24;411;113;75316;41244;43.5;23.8
46;2021-05-25;960;1333;76276;42577;44.0;24.6
46;2021-05-26;1237;1149;77513;43726;44.8;25.3
46;2021-05-27;1431;1195;78944;44921;45.6;25.9
46;2021-05-28;1428;1211;80372;46132;46.4;26.6
46;2021-05-29;1049;397;81421;46529;47.0;26.9
46;2021-05-30;409;39;81830;46568;47.3;26.9
46;2021-05-31;968;976;82798;47544;47.8;27.5
46;2021-06-01;1277;999;84075;48543;48.6;28.0
46;2021-06-02;1319;1116;85394;49659;49.3;28.7
46;2021-06-03;1415;1012;86809;50671;50.1;29.3
46;2021-06-04;1330;977;88139;51648;50.9;29.8
46;2021-06-05;381;414;88520;52062;51.1;30.1
46;2021-06-06;209;96;88729;52158;51.2;30.1
46;2021-06-07;814;617;89543;52775;51.7;30.5
46;2021-06-08;1020;896;90563;53671;52.3;31.0
46;2021-06-09;1505;974;92068;54645;53.2;31.6
46;2021-06-10;981;852;93049;55497;53.7;32.0
46;2021-06-11;969;1322;94018;56819;54.3;32.8
46;2021-06-12;459;549;94477;57368;54.6;33.1
46;2021-06-13;27;86;94504;57454;54.6;33.2
46;2021-06-14;593;1138;95097;58592;54.9;33.8
46;2021-06-15;751;1247;95848;59839;55.4;34.6
46;2021-06-16;1002;1113;96850;60952;55.9;35.2
46;2021-06-17;527;897;97377;61849;56.2;35.7
46;2021-06-18;656;1253;98033;63102;56.6;36.4
46;2021-06-19;457;313;98490;63415;56.9;36.6
46;2021-06-20;39;161;98529;63576;56.9;36.7
46;2021-06-21;429;946;98958;64522;57.1;37.3
46;2021-06-22;350;1177;99308;65699;57.3;37.9
46;2021-06-23;519;1075;99827;66774;57.6;38.6
46;2021-06-24;251;820;100078;67594;57.8;39.0
46;2021-06-25;491;1118;100569;68712;58.1;39.7
46;2021-06-26;398;553;100967;69265;58.3;40.0
46;2021-06-27;3;4;100970;69269;58.3;40.0
46;2021-06-28;315;1341;101285;70610;58.5;40.8
46;2021-06-29;375;1680;101660;72290;58.7;41.7
46;2021-06-30;509;1577;102169;73867;59.0;42.7
46;2021-07-01;487;1153;102656;75020;59.3;43.3
46;2021-07-02;455;1087;103111;76107;59.5;44.0
46;2021-07-03;120;454;103231;76561;59.6;44.2
46;2021-07-04;57;127;103288;76688;59.6;44.3
46;2021-07-05;347;1185;103635;77873;59.8;45.0
46;2021-07-06;449;1457;104084;79330;60.1;45.8
46;2021-07-07;583;1728;104667;81058;60.4;46.8
46;2021-07-08;340;1164;105007;82222;60.6;47.5
46;2021-07-09;395;1706;105402;83928;60.9;48.5
46;2021-07-10;285;1039;105687;84967;61.0;49.1
46;2021-07-11;15;375;105702;85342;61.0;49.3
46;2021-07-12;248;1259;105950;86601;61.2;50.0
46;2021-07-13;626;1670;106576;88271;61.5;51.0
46;2021-07-14;73;144;106649;88415;61.6;51.1
46;2021-07-15;917;1464;107566;89879;62.1;51.9
46;2021-07-16;766;1394;108332;91273;62.6;52.7
46;2021-07-17;364;539;108696;91812;62.8;53.0
46;2021-07-18;2;0;108698;91812;62.8;53.0
46;2021-07-19;729;1188;109427;93000;63.2;53.7
46;2021-07-20;983;1438;110410;94438;63.8;54.5
46;2021-07-21;1001;1379;111411;95817;64.3;55.3
46;2021-07-22;1404;1118;112815;96935;65.1;56.0
46;2021-07-23;768;1322;113583;98257;65.6;56.7
46;2021-07-24;957;665;114540;98922;66.1;57.1
46;2021-07-25;136;17;114676;98939;66.2;57.1
46;2021-07-26;881;878;115557;99817;66.7;57.6
46;2021-07-27;1220;978;116777;100795;67.4;58.2
46;2021-07-28;1284;1114;118061;101909;68.2;58.9
46;2021-07-29;1580;849;119641;102758;69.1;59.3
46;2021-07-30;1933;956;121574;103714;70.2;59.9
46;2021-07-31;958;662;122532;104376;70.8;60.3
46;2021-08-01;12;3;122544;104379;70.8;60.3
46;2021-08-02;974;591;123518;104970;71.3;60.6
46;2021-08-03;1365;679;124883;105649;72.1;61.0
46;2021-08-04;1735;586;126618;106235;73.1;61.3
46;2021-08-05;1382;843;128000;107078;73.9;61.8
46;2021-08-06;1422;848;129422;107926;74.7;62.3
46;2021-08-07;707;544;130129;108470;75.1;62.6
46;2021-08-08;152;66;130281;108536;75.2;62.7
46;2021-08-09;1018;694;131299;109230;75.8;63.1
46;2021-08-10;1206;893;132505;110123;76.5;63.6
46;2021-08-11;1260;1064;133765;111187;77.2;64.2
46;2021-08-12;990;800;134755;111987;77.8;64.7
46;2021-08-13;953;1005;135708;112992;78.4;65.3
46;2021-08-14;588;774;136296;113766;78.7;65.7
46;2021-08-15;8;27;136304;113793;78.7;65.7
46;2021-08-16;795;811;137099;114604;79.2;66.2
46;2021-08-17;889;1288;137988;115892;79.7;66.9
46;2021-08-18;770;1051;138758;116943;80.1;67.5
46;2021-08-19;673;1362;139431;118305;80.5;68.3
46;2021-08-20;520;1557;139951;119862;80.8;69.2
46;2021-08-21;378;649;140329;120511;81.0;69.6
46;2021-08-22;2;31;140331;120542;81.0;69.6
46;2021-08-23;424;1205;140755;121747;81.3;70.3
46;2021-08-24;555;1338;141310;123085;81.6;71.1
46;2021-08-25;530;1398;141840;124483;81.9;71.9
46;2021-08-26;392;1095;142232;125578;82.1;72.5
46;2021-08-27;436;1912;142668;127490;82.4;73.6
46;2021-08-28;272;653;142940;128143;82.5;74.0
46;2021-08-29;5;11;142945;128154;82.5;74.0
46;2021-08-30;295;1112;143240;129266;82.7;74.6
46;2021-08-31;340;1239;143580;130505;82.9;75.4
46;2021-09-01;395;1083;143975;131588;83.1;76.0
46;2021-09-02;271;963;144246;132551;83.3;76.5
46;2021-09-03;322;1155;144568;133706;83.5;77.2
46;2021-09-04;188;635;144756;134341;83.6;77.6
46;2021-09-05;8;15;144764;134356;83.6;77.6
46;2021-09-06;219;655;144983;135011;83.7;78.0
46;2021-09-07;252;683;145235;135694;83.9;78.4
46;2021-09-08;277;798;145512;136492;84.0;78.8
46;2021-09-09;203;530;145715;137022;84.1;79.1
46;2021-09-10;277;851;145992;137873;84.3;79.6
46;2021-09-11;151;354;146143;138227;84.4;79.8
46;2021-09-12;8;22;146151;138249;84.4;79.8
46;2021-09-13;179;503;146330;138752;84.5;80.1
46;2021-09-14;267;403;146597;139155;84.7;80.4
46;2021-09-15;257;677;146854;139832;84.8;80.8
46;2021-09-16;132;265;146986;140097;84.9;80.9
46;2021-09-17;234;555;147220;140652;85.0;81.2
46;2021-09-18;100;364;147320;141016;85.1;81.4
46;2021-09-19;3;9;147323;141025;85.1;81.4
46;2021-09-20;70;350;147393;141375;85.1;81.6
46;2021-09-21;70;238;147463;141613;85.2;81.8
46;2021-09-22;128;483;147591;142096;85.2;82.1
46;2021-09-23;83;226;147674;142322;85.3;82.2
46;2021-09-24;77;401;147751;142723;85.3;82.4
46;2021-09-25;69;221;147820;142944;85.4;82.5
46;2021-09-26;3;8;147823;142952;85.4;82.6
46;2021-09-27;76;229;147899;143181;85.4;82.7
46;2021-09-28;48;225;147947;143406;85.4;82.8
46;2021-09-29;84;291;148031;143697;85.5;83.0
46;2021-09-30;63;146;148094;143843;85.5;83.1
46;2021-10-01;102;296;148196;144139;85.6;83.2
46;2021-10-02;80;191;148276;144330;85.6;83.3
46;2021-10-03;0;0;148276;144330;85.6;83.3
46;2021-10-04;63;189;148339;144519;85.7;83.5
46;2021-10-05;66;220;148405;144739;85.7;83.6
46;2021-10-06;72;219;148477;144958;85.7;83.7
46;2021-10-07;61;177;148538;145135;85.8;83.8
46;2021-10-08;123;267;148661;145402;85.8;84.0
46;2021-10-09;71;139;148732;145541;85.9;84.0
46;2021-10-10;4;7;148736;145548;85.9;84.1
46;2021-10-11;57;132;148793;145680;85.9;84.1
46;2021-10-12;40;71;148833;145751;85.9;84.2
46;2021-10-13;75;154;148908;145905;86.0;84.3
46;2021-10-14;55;113;148963;146018;86.0;84.3
46;2021-10-15;91;188;149054;146206;86.1;84.4
46;2021-10-16;56;109;149110;146315;86.1;84.5
46;2021-10-17;1;9;149111;146324;86.1;84.5
46;2021-10-18;28;48;149139;146372;86.1;84.5
46;2021-10-19;38;49;149177;146421;86.1;84.6
47;2020-12-27;0;0;0;0;0.0;0.0
47;2020-12-28;0;0;0;0;0.0;0.0
47;2020-12-29;0;0;0;0;0.0;0.0
47;2020-12-30;0;0;0;0;0.0;0.0
47;2020-12-31;0;0;0;0;0.0;0.0
47;2021-01-01;4;0;4;0;0.0;0.0
47;2021-01-02;0;0;4;0;0.0;0.0
47;2021-01-03;0;0;4;0;0.0;0.0
47;2021-01-04;0;0;4;0;0.0;0.0
47;2021-01-05;1;0;5;0;0.0;0.0
47;2021-01-06;0;0;5;0;0.0;0.0
47;2021-01-07;71;1;76;1;0.0;0.0
47;2021-01-08;314;0;390;1;0.1;0.0
47;2021-01-09;113;0;503;1;0.2;0.0
47;2021-01-10;0;0;503;1;0.2;0.0
47;2021-01-11;249;1;752;2;0.2;0.0
47;2021-01-12;327;0;1079;2;0.3;0.0
47;2021-01-13;349;0;1428;2;0.4;0.0
47;2021-01-14;370;4;1798;6;0.5;0.0
47;2021-01-15;287;2;2085;8;0.6;0.0
47;2021-01-16;176;4;2261;12;0.7;0.0
47;2021-01-17;0;0;2261;12;0.7;0.0
47;2021-01-18;487;2;2748;14;0.8;0.0
47;2021-01-19;468;3;3216;17;1.0;0.0
47;2021-01-20;518;1;3734;18;1.1;0.0
47;2021-01-21;586;1;4320;19;1.3;0.0
47;2021-01-22;471;1;4791;20;1.5;0.0
47;2021-01-23;390;0;5181;20;1.6;0.0
47;2021-01-24;0;0;5181;20;1.6;0.0
47;2021-01-25;434;0;5615;20;1.7;0.0
47;2021-01-26;792;7;6407;27;1.9;0.0
47;2021-01-27;731;1;7138;28;2.2;0.0
47;2021-01-28;575;67;7713;95;2.3;0.0
47;2021-01-29;461;170;8174;265;2.5;0.1
47;2021-01-30;301;39;8475;304;2.6;0.1
47;2021-01-31;0;0;8475;304;2.6;0.1
47;2021-02-01;373;117;8848;421;2.7;0.1
47;2021-02-02;760;316;9608;737;2.9;0.2
47;2021-02-03;426;163;10034;900;3.0;0.3
47;2021-02-04;370;317;10404;1217;3.1;0.4
47;2021-02-05;300;309;10704;1526;3.2;0.5
47;2021-02-06;297;99;11001;1625;3.3;0.5
47;2021-02-07;0;0;11001;1625;3.3;0.5
47;2021-02-08;183;285;11184;1910;3.4;0.6
47;2021-02-09;231;258;11415;2168;3.5;0.7
47;2021-02-10;254;245;11669;2413;3.5;0.7
47;2021-02-11;356;378;12025;2791;3.6;0.8
47;2021-02-12;243;412;12268;3203;3.7;1.0
47;2021-02-13;226;111;12494;3314;3.8;1.0
47;2021-02-14;0;0;12494;3314;3.8;1.0
47;2021-02-15;194;381;12688;3695;3.8;1.1
47;2021-02-16;303;588;12991;4283;3.9;1.3
47;2021-02-17;326;455;13317;4738;4.0;1.4
47;2021-02-18;201;597;13518;5335;4.1;1.6
47;2021-02-19;193;365;13711;5700;4.2;1.7
47;2021-02-20;117;268;13828;5968;4.2;1.8
47;2021-02-21;0;0;13828;5968;4.2;1.8
47;2021-02-22;75;406;13903;6374;4.2;1.9
47;2021-02-23;149;651;14052;7025;4.3;2.1
47;2021-02-24;261;564;14313;7589;4.3;2.3
47;2021-02-25;304;412;14617;8001;4.4;2.4
47;2021-02-26;467;323;15084;8324;4.6;2.5
47;2021-02-27;324;213;15408;8537;4.7;2.6
47;2021-02-28;0;0;15408;8537;4.7;2.6
47;2021-03-01;124;398;15532;8935;4.7;2.7
47;2021-03-02;199;366;15731;9301;4.8;2.8
47;2021-03-03;244;350;15975;9651;4.8;2.9
47;2021-03-04;593;333;16568;9984;5.0;3.0
47;2021-03-05;845;287;17413;10271;5.3;3.1
47;2021-03-06;506;194;17919;10465;5.4;3.2
47;2021-03-07;331;6;18250;10471;5.5;3.2
47;2021-03-08;459;226;18709;10697;5.7;3.2
47;2021-03-09;508;494;19217;11191;5.8;3.4
47;2021-03-10;666;301;19883;11492;6.0;3.5
47;2021-03-11;940;383;20823;11875;6.3;3.6
47;2021-03-12;1373;301;22196;12176;6.7;3.7
47;2021-03-13;950;110;23146;12286;7.0;3.7
47;2021-03-14;51;0;23197;12286;7.0;3.7
47;2021-03-15;593;163;23790;12449;7.2;3.8
47;2021-03-16;752;178;24542;12627;7.4;3.8
47;2021-03-17;861;213;25403;12840;7.7;3.9
47;2021-03-18;917;177;26320;13017;8.0;3.9
47;2021-03-19;1271;129;27591;13146;8.4;4.0
47;2021-03-20;1088;60;28679;13206;8.7;4.0
47;2021-03-21;344;1;29023;13207;8.8;4.0
47;2021-03-22;1009;96;30032;13303;9.1;4.0
47;2021-03-23;1146;149;31178;13452;9.4;4.1
47;2021-03-24;1214;133;32392;13585;9.8;4.1
47;2021-03-25;1567;156;33959;13741;10.3;4.2
47;2021-03-26;1882;202;35841;13943;10.8;4.2
47;2021-03-27;980;131;36821;14074;11.1;4.3
47;2021-03-28;699;6;37520;14080;11.4;4.3
47;2021-03-29;1511;82;39031;14162;11.8;4.3
47;2021-03-30;1645;128;40676;14290;12.3;4.3
47;2021-03-31;1605;157;42281;14447;12.8;4.4
47;2021-04-01;1682;270;43963;14717;13.3;4.5
47;2021-04-02;1932;458;45895;15175;13.9;4.6
47;2021-04-03;1202;184;47097;15359;14.3;4.6
47;2021-04-04;475;13;47572;15372;14.4;4.7
47;2021-04-05;1297;61;48869;15433;14.8;4.7
47;2021-04-06;1386;390;50255;15823;15.2;4.8
47;2021-04-07;1698;598;51953;16421;15.7;5.0
47;2021-04-08;1834;480;53787;16901;16.3;5.1
47;2021-04-09;2085;547;55872;17448;16.9;5.3
47;2021-04-10;1565;326;57437;17774;17.4;5.4
47;2021-04-11;530;9;57967;17783;17.5;5.4
47;2021-04-12;1438;619;59405;18402;18.0;5.6
47;2021-04-13;1813;765;61218;19167;18.5;5.8
47;2021-04-14;1750;722;62968;19889;19.1;6.0
47;2021-04-15;2012;849;64980;20738;19.7;6.3
47;2021-04-16;1767;898;66747;21636;20.2;6.5
47;2021-04-17;1471;968;68218;22604;20.7;6.8
47;2021-04-18;23;0;68241;22604;20.7;6.8
47;2021-04-19;1331;932;69572;23536;21.1;7.1
47;2021-04-20;1625;910;71197;24446;21.6;7.4
47;2021-04-21;1624;776;72821;25222;22.0;7.6
47;2021-04-22;1880;1059;74701;26281;22.6;8.0
47;2021-04-23;1729;1077;76430;27358;23.1;8.3
47;2021-04-24;1549;807;77979;28165;23.6;8.5
47;2021-04-25;242;345;78221;28510;23.7;8.6
47;2021-04-26;1491;1366;79712;29876;24.1;9.0
47;2021-04-27;1921;1476;81633;31352;24.7;9.5
47;2021-04-28;2090;1595;83723;32947;25.3;10.0
47;2021-04-29;2532;1514;86255;34461;26.1;10.4
47;2021-04-30;2044;1780;88299;36241;26.7;11.0
47;2021-05-01;2263;986;90562;37227;27.4;11.3
47;2021-05-02;21;358;90583;37585;27.4;11.4
47;2021-05-03;1596;1422;92179;39007;27.9;11.8
47;2021-05-04;1645;1732;93824;40739;28.4;12.3
47;2021-05-05;1926;1643;95750;42382;29.0;12.8
47;2021-05-06;2105;1509;97855;43891;29.6;13.3
47;2021-05-07;2001;1623;99856;45514;30.2;13.8
47;2021-05-08;2097;464;101953;45978;30.9;13.9
47;2021-05-09;24;359;101977;46337;30.9;14.0
47;2021-05-10;1202;1672;103179;48009;31.2;14.5
47;2021-05-11;2172;1987;105351;49996;31.9;15.1
47;2021-05-12;2625;1451;107976;51447;32.7;15.6
47;2021-05-13;2380;656;110356;52103;33.4;15.8
47;2021-05-14;2061;859;112417;52962;34.0;16.0
47;2021-05-15;1934;865;114351;53827;34.6;16.3
47;2021-05-16;367;9;114718;53836;34.7;16.3
47;2021-05-17;1884;1124;116602;54960;35.3;16.6
47;2021-05-18;2359;1140;118961;56100;36.0;17.0
47;2021-05-19;2344;759;121305;56859;36.7;17.2
47;2021-05-20;2589;974;123894;57833;37.5;17.5
47;2021-05-21;1538;1134;125432;58967;38.0;17.9
47;2021-05-22;2369;839;127801;59806;38.7;18.1
47;2021-05-23;25;186;127826;59992;38.7;18.2
47;2021-05-24;1549;237;129375;60229;39.2;18.2
47;2021-05-25;1481;1318;130856;61547;39.6;18.6
47;2021-05-26;1599;1091;132455;62638;40.1;19.0
47;2021-05-27;1944;1269;134399;63907;40.7;19.3
47;2021-05-28;1459;1537;135858;65444;41.1;19.8
47;2021-05-29;1153;1124;137011;66568;41.5;20.2
47;2021-05-30;12;45;137023;66613;41.5;20.2
47;2021-05-31;1868;1424;138891;68037;42.0;20.6
47;2021-06-01;1921;1344;140812;69381;42.6;21.0
47;2021-06-02;2100;1332;142912;70713;43.3;21.4
47;2021-06-03;2486;1614;145398;72327;44.0;21.9
47;2021-06-04;1965;2118;147363;74445;44.6;22.5
47;2021-06-05;1640;1475;149003;75920;45.1;23.0
47;2021-06-06;211;70;149214;75990;45.2;23.0
47;2021-06-07;1659;2238;150873;78228;45.7;23.7
47;2021-06-08;1629;1904;152502;80132;46.2;24.3
47;2021-06-09;1824;2124;154326;82256;46.7;24.9
47;2021-06-10;2377;1620;156703;83876;47.4;25.4
47;2021-06-11;1826;2101;158529;85977;48.0;26.0
47;2021-06-12;1351;2102;159880;88079;48.4;26.7
47;2021-06-13;4;10;159884;88089;48.4;26.7
47;2021-06-14;1281;2444;161165;90533;48.8;27.4
47;2021-06-15;1464;2033;162629;92566;49.2;28.0
47;2021-06-16;1203;2189;163832;94755;49.6;28.7
47;2021-06-17;1658;1524;165490;96279;50.1;29.1
47;2021-06-18;1439;2496;166929;98775;50.5;29.9
47;2021-06-19;1542;2453;168471;101228;51.0;30.6
47;2021-06-20;5;33;168476;101261;51.0;30.7
47;2021-06-21;1136;2513;169612;103774;51.3;31.4
47;2021-06-22;762;2507;170374;106281;51.6;32.2
47;2021-06-23;999;2016;171373;108297;51.9;32.8
47;2021-06-24;1211;1937;172584;110234;52.2;33.4
47;2021-06-25;1006;2608;173590;112842;52.5;34.2
47;2021-06-26;986;2789;174576;115631;52.8;35.0
47;2021-06-27;16;349;174592;115980;52.9;35.1
47;2021-06-28;875;2409;175467;118389;53.1;35.8
47;2021-06-29;797;2313;176264;120702;53.4;36.5
47;2021-06-30;730;2303;176994;123005;53.6;37.2
47;2021-07-01;923;2107;177917;125112;53.9;37.9
47;2021-07-02;885;2274;178802;127386;54.1;38.6
47;2021-07-03;726;3042;179528;130428;54.3;39.5
47;2021-07-04;34;12;179562;130440;54.4;39.5
47;2021-07-05;978;2147;180540;132587;54.7;40.1
47;2021-07-06;1007;1957;181547;134544;55.0;40.7
47;2021-07-07;1298;2064;182845;136608;55.4;41.4
47;2021-07-08;1143;2193;183988;138801;55.7;42.0
47;2021-07-09;1047;2405;185035;141206;56.0;42.7
47;2021-07-10;951;2131;185986;143337;56.3;43.4
47;2021-07-11;1;6;185987;143343;56.3;43.4
47;2021-07-12;556;2580;186543;145923;56.5;44.2
47;2021-07-13;1094;2585;187637;148508;56.8;45.0
47;2021-07-14;1165;1577;188802;150085;57.2;45.4
47;2021-07-15;1717;3135;190519;153220;57.7;46.4
47;2021-07-16;1722;2677;192241;155897;58.2;47.2
47;2021-07-17;1201;2457;193442;158354;58.6;47.9
47;2021-07-18;36;188;193478;158542;58.6;48.0
47;2021-07-19;1113;2561;194591;161103;58.9;48.8
47;2021-07-20;1638;2342;196229;163445;59.4;49.5
47;2021-07-21;2192;2240;198421;165685;60.1;50.2
47;2021-07-22;2157;2298;200578;167983;60.7;50.9
47;2021-07-23;2124;2251;202702;170234;61.4;51.5
47;2021-07-24;1114;1915;203816;172149;61.7;52.1
47;2021-07-25;20;1;203836;172150;61.7;52.1
47;2021-07-26;1236;1946;205072;174096;62.1;52.7
47;2021-07-27;2123;1634;207195;175730;62.7;53.2
47;2021-07-28;1880;1605;209075;177335;63.3;53.7
47;2021-07-29;2340;1606;211415;178941;64.0;54.2
47;2021-07-30;1865;1628;213280;180569;64.6;54.7
47;2021-07-31;1486;1668;214766;182237;65.0;55.2
47;2021-08-01;18;8;214784;182245;65.0;55.2
47;2021-08-02;2053;1218;216837;183463;65.6;55.5
47;2021-08-03;2159;1105;218996;184568;66.3;55.9
47;2021-08-04;2192;1528;221188;186096;67.0;56.3
47;2021-08-05;2407;1447;223595;187543;67.7;56.8
47;2021-08-06;1999;1841;225594;189384;68.3;57.3
47;2021-08-07;1628;1418;227222;190802;68.8;57.8
47;2021-08-08;24;22;227246;190824;68.8;57.8
47;2021-08-09;1883;1214;229129;192038;69.4;58.1
47;2021-08-10;1919;1297;231048;193335;69.9;58.5
47;2021-08-11;1804;1401;232852;194736;70.5;59.0
47;2021-08-12;2059;1340;234911;196076;71.1;59.4
47;2021-08-13;1424;1668;236335;197744;71.5;59.9
47;2021-08-14;1349;1443;237684;199187;72.0;60.3
47;2021-08-15;11;18;237695;199205;72.0;60.3
47;2021-08-16;1436;1446;239131;200651;72.4;60.7
47;2021-08-17;1124;1685;240255;202336;72.7;61.3
47;2021-08-18;1181;1714;241436;204050;73.1;61.8
47;2021-08-19;1039;1813;242475;205863;73.4;62.3
47;2021-08-20;972;1708;243447;207571;73.7;62.8
47;2021-08-21;829;1277;244276;208848;73.9;63.2
47;2021-08-22;19;31;244295;208879;74.0;63.2
47;2021-08-23;615;1827;244910;210706;74.1;63.8
47;2021-08-24;812;1622;245722;212328;74.4;64.3
47;2021-08-25;811;1787;246533;214115;74.6;64.8
47;2021-08-26;741;2080;247274;216195;74.9;65.4
47;2021-08-27;700;1979;247974;218174;75.1;66.0
47;2021-08-28;568;1670;248542;219844;75.2;66.6
47;2021-08-29;2;16;248544;219860;75.2;66.6
47;2021-08-30;459;1908;249003;221768;75.4;67.1
47;2021-08-31;583;1793;249586;223561;75.6;67.7
47;2021-09-01;422;1956;250008;225517;75.7;68.3
47;2021-09-02;436;1945;250444;227462;75.8;68.9
47;2021-09-03;504;1844;250948;229306;76.0;69.4
47;2021-09-04;479;1743;251427;231049;76.1;69.9
47;2021-09-05;13;35;251440;231084;76.1;70.0
47;2021-09-06;344;1251;251784;232335;76.2;70.3
47;2021-09-07;478;1114;252262;233449;76.4;70.7
47;2021-09-08;419;1484;252681;234933;76.5;71.1
47;2021-09-09;423;1098;253104;236031;76.6;71.5
47;2021-09-10;474;1163;253578;237194;76.8;71.8
47;2021-09-11;438;1373;254016;238567;76.9;72.2
47;2021-09-12;5;6;254021;238573;76.9;72.2
47;2021-09-13;256;731;254277;239304;77.0;72.4
47;2021-09-14;403;797;254680;240101;77.1;72.7
47;2021-09-15;357;940;255037;241041;77.2;73.0
47;2021-09-16;324;560;255361;241601;77.3;73.1
47;2021-09-17;399;646;255760;242247;77.4;73.3
47;2021-09-18;263;955;256023;243202;77.5;73.6
47;2021-09-19;4;4;256027;243206;77.5;73.6
47;2021-09-20;166;470;256193;243676;77.6;73.8
47;2021-09-21;285;455;256478;244131;77.6;73.9
47;2021-09-22;219;617;256697;244748;77.7;74.1
47;2021-09-23;209;378;256906;245126;77.8;74.2
47;2021-09-24;283;615;257189;245741;77.9;74.4
47;2021-09-25;216;628;257405;246369;77.9;74.6
47;2021-09-26;6;6;257411;246375;77.9;74.6
47;2021-09-27;112;377;257523;246752;78.0;74.7
47;2021-09-28;127;375;257650;247127;78.0;74.8
47;2021-09-29;148;473;257798;247600;78.0;75.0
47;2021-09-30;160;356;257958;247956;78.1;75.1
47;2021-10-01;183;519;258141;248475;78.1;75.2
47;2021-10-02;195;486;258336;248961;78.2;75.4
47;2021-10-03;0;5;258336;248966;78.2;75.4
47;2021-10-04;132;362;258468;249328;78.2;75.5
47;2021-10-05;110;307;258578;249635;78.3;75.6
47;2021-10-06;228;459;258806;250094;78.3;75.7
47;2021-10-07;155;367;258961;250461;78.4;75.8
47;2021-10-08;171;413;259132;250874;78.4;75.9
47;2021-10-09;246;380;259378;251254;78.5;76.1
47;2021-10-10;0;3;259378;251257;78.5;76.1
47;2021-10-11;139;207;259517;251464;78.6;76.1
47;2021-10-12;135;286;259652;251750;78.6;76.2
47;2021-10-13;139;287;259791;252037;78.6;76.3
47;2021-10-14;99;219;259890;252256;78.7;76.4
47;2021-10-15;153;367;260043;252623;78.7;76.5
47;2021-10-16;198;251;260241;252874;78.8;76.6
47;2021-10-17;0;2;260241;252876;78.8;76.6
47;2021-10-18;124;192;260365;253068;78.8;76.6
47;2021-10-19;123;160;260488;253228;78.9;76.7
48;2020-12-27;0;0;0;0;0.0;0.0
48;2020-12-28;0;0;0;0;0.0;0.0
48;2020-12-29;1;0;1;0;0.0;0.0
48;2020-12-30;0;0;1;0;0.0;0.0
48;2020-12-31;0;0;1;0;0.0;0.0
48;2021-01-01;0;0;1;0;0.0;0.0
48;2021-01-02;0;0;1;0;0.0;0.0
48;2021-01-03;0;0;1;0;0.0;0.0
48;2021-01-04;0;0;1;0;0.0;0.0
48;2021-01-05;0;0;1;0;0.0;0.0
48;2021-01-06;0;0;1;0;0.0;0.0
48;2021-01-07;56;0;57;0;0.1;0.0
48;2021-01-08;88;1;145;1;0.2;0.0
48;2021-01-09;1;0;146;1;0.2;0.0
48;2021-01-10;0;0;146;1;0.2;0.0
48;2021-01-11;13;0;159;1;0.2;0.0
48;2021-01-12;20;1;179;2;0.2;0.0
48;2021-01-13;104;0;283;2;0.4;0.0
48;2021-01-14;90;1;373;3;0.5;0.0
48;2021-01-15;63;0;436;3;0.6;0.0
48;2021-01-16;0;0;436;3;0.6;0.0
48;2021-01-17;0;0;436;3;0.6;0.0
48;2021-01-18;117;0;553;3;0.7;0.0
48;2021-01-19;345;2;898;5;1.2;0.0
48;2021-01-20;364;0;1262;5;1.7;0.0
48;2021-01-21;466;1;1728;6;2.3;0.0
48;2021-01-22;269;0;1997;6;2.6;0.0
48;2021-01-23;36;0;2033;6;2.7;0.0
48;2021-01-24;0;0;2033;6;2.7;0.0
48;2021-01-25;109;2;2142;8;2.8;0.0
48;2021-01-26;261;0;2403;8;3.1;0.0
48;2021-01-27;257;2;2660;10;3.5;0.0
48;2021-01-28;273;11;2933;21;3.8;0.0
48;2021-01-29;175;60;3108;81;4.1;0.1
48;2021-01-30;1;7;3109;88;4.1;0.1
48;2021-01-31;0;6;3109;94;4.1;0.1
48;2021-02-01;100;48;3209;142;4.2;0.2
48;2021-02-02;195;36;3404;178;4.5;0.2
48;2021-02-03;177;82;3581;260;4.7;0.3
48;2021-02-04;234;14;3815;274;5.0;0.4
48;2021-02-05;145;37;3960;311;5.2;0.4
48;2021-02-06;34;1;3994;312;5.2;0.4
48;2021-02-07;0;0;3994;312;5.2;0.4
48;2021-02-08;50;60;4044;372;5.3;0.5
48;2021-02-09;66;167;4110;539;5.4;0.7
48;2021-02-10;65;303;4175;842;5.5;1.1
48;2021-02-11;165;407;4340;1249;5.7;1.6
48;2021-02-12;120;155;4460;1404;5.8;1.8
48;2021-02-13;8;55;4468;1459;5.9;1.9
48;2021-02-14;0;0;4468;1459;5.9;1.9
48;2021-02-15;51;106;4519;1565;5.9;2.1
48;2021-02-16;43;173;4562;1738;6.0;2.3
48;2021-02-17;35;284;4597;2022;6.0;2.7
48;2021-02-18;252;113;4849;2135;6.4;2.8
48;2021-02-19;60;183;4909;2318;6.4;3.0
48;2021-02-20;0;1;4909;2319;6.4;3.0
48;2021-02-21;0;14;4909;2333;6.4;3.1
48;2021-02-22;24;129;4933;2462;6.5;3.2
48;2021-02-23;74;221;5007;2683;6.6;3.5
48;2021-02-24;68;265;5075;2948;6.7;3.9
48;2021-02-25;148;263;5223;3211;6.8;4.2
48;2021-02-26;51;229;5274;3440;6.9;4.5
48;2021-02-27;28;1;5302;3441;7.0;4.5
48;2021-02-28;3;14;5305;3455;7.0;4.5
48;2021-03-01;102;97;5407;3552;7.1;4.7
48;2021-03-02;199;87;5606;3639;7.3;4.8
48;2021-03-03;152;109;5758;3748;7.5;4.9
48;2021-03-04;195;183;5953;3931;7.8;5.2
48;2021-03-05;136;141;6089;4072;8.0;5.3
48;2021-03-06;180;53;6269;4125;8.2;5.4
48;2021-03-07;75;2;6344;4127;8.3;5.4
48;2021-03-08;352;148;6696;4275;8.8;5.6
48;2021-03-09;377;104;7073;4379;9.3;5.7
48;2021-03-10;263;61;7336;4440;9.6;5.8
48;2021-03-11;334;91;7670;4531;10.1;5.9
48;2021-03-12;256;153;7926;4684;10.4;6.1
48;2021-03-13;301;6;8227;4690;10.8;6.1
48;2021-03-14;8;0;8235;4690;10.8;6.1
48;2021-03-15;174;64;8409;4754;11.0;6.2
48;2021-03-16;167;66;8576;4820;11.2;6.3
48;2021-03-17;156;110;8732;4930;11.4;6.5
48;2021-03-18;191;104;8923;5034;11.7;6.6
48;2021-03-19;116;96;9039;5130;11.8;6.7
48;2021-03-20;101;0;9140;5130;12.0;6.7
48;2021-03-21;0;0;9140;5130;12.0;6.7
48;2021-03-22;161;21;9301;5151;12.2;6.8
48;2021-03-23;329;103;9630;5254;12.6;6.9
48;2021-03-24;284;100;9914;5354;13.0;7.0
48;2021-03-25;757;123;10671;5477;14.0;7.2
48;2021-03-26;269;62;10940;5539;14.3;7.3
48;2021-03-27;104;1;11044;5540;14.5;7.3
48;2021-03-28;80;21;11124;5561;14.6;7.3
48;2021-03-29;305;81;11429;5642;15.0;7.4
48;2021-03-30;365;132;11794;5774;15.5;7.6
48;2021-03-31;448;88;12242;5862;16.0;7.7
48;2021-04-01;732;73;12974;5935;17.0;7.8
48;2021-04-02;487;136;13461;6071;17.6;8.0
48;2021-04-03;140;83;13601;6154;17.8;8.1
48;2021-04-04;0;0;13601;6154;17.8;8.1
48;2021-04-05;43;1;13644;6155;17.9;8.1
48;2021-04-06;465;160;14109;6315;18.5;8.3
48;2021-04-07;466;142;14575;6457;19.1;8.5
48;2021-04-08;620;188;15195;6645;19.9;8.7
48;2021-04-09;446;122;15641;6767;20.5;8.9
48;2021-04-10;95;60;15736;6827;20.6;8.9
48;2021-04-11;2;0;15738;6827;20.6;8.9
48;2021-04-12;364;71;16102;6898;21.1;9.0
48;2021-04-13;361;93;16463;6991;21.6;9.2
48;2021-04-14;624;187;17087;7178;22.4;9.4
48;2021-04-15;701;363;17788;7541;23.3;9.9
48;2021-04-16;538;229;18326;7770;24.0;10.2
48;2021-04-17;89;73;18415;7843;24.1;10.3
48;2021-04-18;0;0;18415;7843;24.1;10.3
48;2021-04-19;196;106;18611;7949;24.4;10.4
48;2021-04-20;216;182;18827;8131;24.7;10.7
48;2021-04-21;284;207;19111;8338;25.1;10.9
48;2021-04-22;306;482;19417;8820;25.5;11.6
48;2021-04-23;255;242;19672;9062;25.8;11.9
48;2021-04-24;97;95;19769;9157;25.9;12.0
48;2021-04-25;1;9;19770;9166;25.9;12.0
48;2021-04-26;87;211;19857;9377;26.0;12.3
48;2021-04-27;172;292;20029;9669;26.3;12.7
48;2021-04-28;149;415;20178;10084;26.5;13.2
48;2021-04-29;203;491;20381;10575;26.7;13.9
48;2021-04-30;172;226;20553;10801;26.9;14.2
48;2021-05-01;0;0;20553;10801;26.9;14.2
48;2021-05-02;0;0;20553;10801;26.9;14.2
48;2021-05-03;105;386;20658;11187;27.1;14.7
48;2021-05-04;227;421;20885;11608;27.4;15.2
48;2021-05-05;84;486;20969;12094;27.5;15.9
48;2021-05-06;775;642;21744;12736;28.5;16.7
48;2021-05-07;96;503;21840;13239;28.6;17.4
48;2021-05-08;309;43;22149;13282;29.0;17.4
48;2021-05-09;285;9;22434;13291;29.4;17.4
48;2021-05-10;55;325;22489;13616;29.5;17.8
48;2021-05-11;221;290;22710;13906;29.8;18.2
48;2021-05-12;249;313;22959;14219;30.1;18.6
48;2021-05-13;472;158;23431;14377;30.7;18.8
48;2021-05-14;244;222;23675;14599;31.0;19.1
48;2021-05-15;84;46;23759;14645;31.1;19.2
48;2021-05-16;1;6;23760;14651;31.1;19.2
48;2021-05-17;474;267;24234;14918;31.8;19.6
48;2021-05-18;263;229;24497;15147;32.1;19.9
48;2021-05-19;207;277;24704;15424;32.4;20.2
48;2021-05-20;318;256;25022;15680;32.8;20.6
48;2021-05-21;174;267;25196;15947;33.0;20.9
48;2021-05-22;25;50;25221;15997;33.1;21.0
48;2021-05-23;0;6;25221;16003;33.1;21.0
48;2021-05-24;0;14;25221;16017;33.1;21.0
48;2021-05-25;181;267;25402;16284;33.3;21.3
48;2021-05-26;416;298;25818;16582;33.8;21.7
48;2021-05-27;1178;380;26996;16962;35.4;22.2
48;2021-05-28;315;350;27311;17312;35.8;22.7
48;2021-05-29;79;50;27390;17362;35.9;22.8
48;2021-05-30;0;1;27390;17363;35.9;22.8
48;2021-05-31;624;263;28014;17626;36.7;23.1
48;2021-06-01;272;305;28286;17931;37.1;23.5
48;2021-06-02;407;424;28693;18355;37.6;24.1
48;2021-06-03;629;431;29322;18786;38.4;24.6
48;2021-06-04;291;283;29613;19069;38.8;25.0
48;2021-06-05;121;77;29734;19146;39.0;25.1
48;2021-06-06;1;1;29735;19147;39.0;25.1
48;2021-06-07;440;161;30175;19308;39.6;25.3
48;2021-06-08;616;309;30791;19617;40.4;25.7
48;2021-06-09;379;190;31170;19807;40.9;26.0
48;2021-06-10;1003;242;32173;20049;42.2;26.3
48;2021-06-11;371;161;32544;20210;42.7;26.5
48;2021-06-12;74;57;32618;20267;42.8;26.6
48;2021-06-13;0;2;32618;20269;42.8;26.6
48;2021-06-14;124;115;32742;20384;42.9;26.7
48;2021-06-15;407;386;33149;20770;43.5;27.2
48;2021-06-16;260;144;33409;20914;43.8;27.4
48;2021-06-17;486;575;33895;21489;44.4;28.2
48;2021-06-18;254;315;34149;21804;44.8;28.6
48;2021-06-19;35;291;34184;22095;44.8;29.0
48;2021-06-20;123;224;34307;22319;45.0;29.3
48;2021-06-21;125;134;34432;22453;45.1;29.4
48;2021-06-22;258;335;34690;22788;45.5;29.9
48;2021-06-23;111;545;34801;23333;45.6;30.6
48;2021-06-24;364;610;35165;23943;46.1;31.4
48;2021-06-25;154;276;35319;24219;46.3;31.7
48;2021-06-26;15;45;35334;24264;46.3;31.8
48;2021-06-27;1;1;35335;24265;46.3;31.8
48;2021-06-28;81;177;35416;24442;46.4;32.0
48;2021-06-29;297;415;35713;24857;46.8;32.6
48;2021-06-30;98;465;35811;25322;46.9;33.2
48;2021-07-01;194;669;36005;25991;47.2;34.1
48;2021-07-02;148;369;36153;26360;47.4;34.6
48;2021-07-03;42;89;36195;26449;47.4;34.7
48;2021-07-04;7;0;36202;26449;47.5;34.7
48;2021-07-05;40;117;36242;26566;47.5;34.8
48;2021-07-06;277;598;36519;27164;47.9;35.6
48;2021-07-07;201;489;36720;27653;48.1;36.2
48;2021-07-08;223;1189;36943;28842;48.4;37.8
48;2021-07-09;159;553;37102;29395;48.6;38.5
48;2021-07-10;95;147;37197;29542;48.8;38.7
48;2021-07-11;0;4;37197;29546;48.8;38.7
48;2021-07-12;139;672;37336;30218;48.9;39.6
48;2021-07-13;211;430;37547;30648;49.2;40.2
48;2021-07-14;179;145;37726;30793;49.5;40.4
48;2021-07-15;187;459;37913;31252;49.7;41.0
48;2021-07-16;234;315;38147;31567;50.0;41.4
48;2021-07-17;129;118;38276;31685;50.2;41.5
48;2021-07-18;4;5;38280;31690;50.2;41.5
48;2021-07-19;105;306;38385;31996;50.3;41.9
48;2021-07-20;677;993;39062;32989;51.2;43.2
48;2021-07-21;68;371;39130;33360;51.3;43.7
48;2021-07-22;777;1124;39907;34484;52.3;45.2
48;2021-07-23;367;439;40274;34923;52.8;45.8
48;2021-07-24;509;170;40783;35093;53.5;46.0
48;2021-07-25;138;46;40921;35139;53.6;46.1
48;2021-07-26;101;199;41022;35338;53.8;46.3
48;2021-07-27;1195;644;42217;35982;55.3;47.2
48;2021-07-28;177;316;42394;36298;55.6;47.6
48;2021-07-29;716;646;43110;36944;56.5;48.4
48;2021-07-30;200;292;43310;37236;56.8;48.8
48;2021-07-31;339;178;43649;37414;57.2;49.0
48;2021-08-01;18;55;43667;37469;57.2;49.1
48;2021-08-02;228;164;43895;37633;57.5;49.3
48;2021-08-03;925;575;44820;38208;58.8;50.1
48;2021-08-04;328;220;45148;38428;59.2;50.4
48;2021-08-05;673;474;45821;38902;60.1;51.0
48;2021-08-06;442;275;46263;39177;60.6;51.4
48;2021-08-07;249;125;46512;39302;61.0;51.5
48;2021-08-08;2;5;46514;39307;61.0;51.5
48;2021-08-09;170;141;46684;39448;61.2;51.7
48;2021-08-10;726;555;47410;40003;62.1;52.4
48;2021-08-11;295;238;47705;40241;62.5;52.8
48;2021-08-12;419;414;48124;40655;63.1;53.3
48;2021-08-13;229;212;48353;40867;63.4;53.6
48;2021-08-14;137;165;48490;41032;63.6;53.8
48;2021-08-15;131;81;48621;41113;63.7;53.9
48;2021-08-16;121;192;48742;41305;63.9;54.1
48;2021-08-17;364;1188;49106;42493;64.4;55.7
48;2021-08-18;211;201;49317;42694;64.6;56.0
48;2021-08-19;240;325;49557;43019;65.0;56.4
48;2021-08-20;215;284;49772;43303;65.2;56.8
48;2021-08-21;85;232;49857;43535;65.4;57.1
48;2021-08-22;0;0;49857;43535;65.4;57.1
48;2021-08-23;65;153;49922;43688;65.4;57.3
48;2021-08-24;308;953;50230;44641;65.8;58.5
48;2021-08-25;156;351;50386;44992;66.0;59.0
48;2021-08-26;180;499;50566;45491;66.3;59.6
48;2021-08-27;153;339;50719;45830;66.5;60.1
48;2021-08-28;127;303;50846;46133;66.7;60.5
48;2021-08-29;0;1;50846;46134;66.7;60.5
48;2021-08-30;54;143;50900;46277;66.7;60.7
48;2021-08-31;257;1053;51157;47330;67.1;62.0
48;2021-09-01;124;334;51281;47664;67.2;62.5
48;2021-09-02;131;388;51412;48052;67.4;63.0
48;2021-09-03;138;297;51550;48349;67.6;63.4
48;2021-09-04;123;209;51673;48558;67.7;63.7
48;2021-09-05;3;25;51676;48583;67.7;63.7
48;2021-09-06;34;178;51710;48761;67.8;63.9
48;2021-09-07;160;347;51870;49108;68.0;64.4
48;2021-09-08;96;181;51966;49289;68.1;64.6
48;2021-09-09;96;235;52062;49524;68.2;64.9
48;2021-09-10;128;263;52190;49787;68.4;65.3
48;2021-09-11;89;195;52279;49982;68.5;65.5
48;2021-09-12;1;2;52280;49984;68.5;65.5
48;2021-09-13;78;66;52358;50050;68.6;65.6
48;2021-09-14;207;259;52565;50309;68.9;65.9
48;2021-09-15;68;164;52633;50473;69.0;66.2
48;2021-09-16;122;223;52755;50696;69.2;66.5
48;2021-09-17;101;183;52856;50879;69.3;66.7
48;2021-09-18;33;90;52889;50969;69.3;66.8
48;2021-09-19;0;0;52889;50969;69.3;66.8
48;2021-09-20;31;88;52920;51057;69.4;66.9
48;2021-09-21;65;183;52985;51240;69.5;67.2
48;2021-09-22;49;151;53034;51391;69.5;67.4
48;2021-09-23;28;100;53062;51491;69.6;67.5
48;2021-09-24;43;118;53105;51609;69.6;67.7
48;2021-09-25;27;78;53132;51687;69.6;67.8
48;2021-09-26;1;0;53133;51687;69.6;67.8
48;2021-09-27;11;43;53144;51730;69.7;67.8
48;2021-09-28;66;155;53210;51885;69.8;68.0
48;2021-09-29;51;133;53261;52018;69.8;68.2
48;2021-09-30;42;87;53303;52105;69.9;68.3
48;2021-10-01;56;141;53359;52246;69.9;68.5
48;2021-10-02;33;51;53392;52297;70.0;68.6
48;2021-10-03;0;1;53392;52298;70.0;68.6
48;2021-10-04;19;62;53411;52360;70.0;68.6
48;2021-10-05;49;151;53460;52511;70.1;68.8
48;2021-10-06;66;94;53526;52605;70.2;69.0
48;2021-10-07;33;112;53559;52717;70.2;69.1
48;2021-10-08;37;113;53596;52830;70.3;69.3
48;2021-10-09;14;56;53610;52886;70.3;69.3
48;2021-10-10;0;1;53610;52887;70.3;69.3
48;2021-10-11;6;25;53616;52912;70.3;69.4
48;2021-10-12;38;94;53654;53006;70.3;69.5
48;2021-10-13;38;80;53692;53086;70.4;69.6
48;2021-10-14;37;69;53729;53155;70.4;69.7
48;2021-10-15;26;55;53755;53210;70.5;69.8
48;2021-10-16;9;19;53764;53229;70.5;69.8
48;2021-10-17;3;3;53767;53232;70.5;69.8
48;2021-10-18;2;11;53769;53243;70.5;69.8
48;2021-10-19;40;54;53809;53297;70.5;69.9
49;2020-12-27;0;0;0;0;0.0;0.0
49;2020-12-28;2;0;2;0;0.0;0.0
49;2020-12-29;0;0;2;0;0.0;0.0
49;2020-12-30;0;0;2;0;0.0;0.0
49;2020-12-31;0;0;2;0;0.0;0.0
49;2021-01-01;2;0;4;0;0.0;0.0
49;2021-01-02;1;1;5;1;0.0;0.0
49;2021-01-03;0;0;5;1;0.0;0.0
49;2021-01-04;10;0;15;1;0.0;0.0
49;2021-01-05;93;0;108;1;0.0;0.0
49;2021-01-06;233;0;341;1;0.0;0.0
49;2021-01-07;367;1;708;2;0.1;0.0
49;2021-01-08;328;1;1036;3;0.1;0.0
49;2021-01-09;118;0;1154;3;0.1;0.0
49;2021-01-10;114;0;1268;3;0.2;0.0
49;2021-01-11;287;0;1555;3;0.2;0.0
49;2021-01-12;623;0;2178;3;0.3;0.0
49;2021-01-13;602;2;2780;5;0.3;0.0
49;2021-01-14;590;7;3370;12;0.4;0.0
49;2021-01-15;764;1;4134;13;0.5;0.0
49;2021-01-16;148;0;4282;13;0.5;0.0
49;2021-01-17;111;2;4393;15;0.5;0.0
49;2021-01-18;691;0;5084;15;0.6;0.0
49;2021-01-19;1204;8;6288;23;0.8;0.0
49;2021-01-20;1511;7;7799;30;1.0;0.0
49;2021-01-21;1942;14;9741;44;1.2;0.0
49;2021-01-22;1305;6;11046;50;1.4;0.0
49;2021-01-23;263;1;11309;51;1.4;0.0
49;2021-01-24;1;0;11310;51;1.4;0.0
49;2021-01-25;552;5;11862;56;1.5;0.0
49;2021-01-26;989;75;12851;131;1.6;0.0
49;2021-01-27;1861;50;14712;181;1.8;0.0
49;2021-01-28;2877;91;17589;272;2.2;0.0
49;2021-01-29;1588;92;19177;364;2.4;0.0
49;2021-01-30;300;46;19477;410;2.4;0.1
49;2021-01-31;62;51;19539;461;2.4;0.1
49;2021-02-01;661;163;20200;624;2.5;0.1
49;2021-02-02;745;384;20945;1008;2.6;0.1
49;2021-02-03;677;382;21622;1390;2.7;0.2
49;2021-02-04;758;445;22380;1835;2.7;0.2
49;2021-02-05;708;591;23088;2426;2.8;0.3
49;2021-02-06;228;110;23316;2536;2.9;0.3
49;2021-02-07;59;83;23375;2619;2.9;0.3
49;2021-02-08;548;480;23923;3099;2.9;0.4
49;2021-02-09;717;648;24640;3747;3.0;0.5
49;2021-02-10;807;951;25447;4698;3.1;0.6
49;2021-02-11;1029;1410;26476;6108;3.2;0.7
49;2021-02-12;869;960;27345;7068;3.4;0.9
49;2021-02-13;266;120;27611;7188;3.4;0.9
49;2021-02-14;9;106;27620;7294;3.4;0.9
49;2021-02-15;730;664;28350;7958;3.5;1.0
49;2021-02-16;1108;1120;29458;9078;3.6;1.1
49;2021-02-17;1160;1872;30618;10950;3.8;1.3
49;2021-02-18;1810;2438;32428;13388;4.0;1.6
49;2021-02-19;1397;1108;33825;14496;4.1;1.8
49;2021-02-20;232;381;34057;14877;4.2;1.8
49;2021-02-21;0;64;34057;14941;4.2;1.8
49;2021-02-22;647;573;34704;15514;4.3;1.9
49;2021-02-23;734;857;35438;16371;4.3;2.0
49;2021-02-24;824;641;36262;17012;4.4;2.1
49;2021-02-25;1208;809;37470;17821;4.6;2.2
49;2021-02-26;1678;848;39148;18669;4.8;2.3
49;2021-02-27;435;282;39583;18951;4.9;2.3
49;2021-02-28;49;39;39632;18990;4.9;2.3
49;2021-03-01;768;587;40400;19577;5.0;2.4
49;2021-03-02;1082;701;41482;20278;5.1;2.5
49;2021-03-03;1559;676;43041;20954;5.3;2.6
49;2021-03-04;1769;942;44810;21896;5.5;2.7
49;2021-03-05;2214;701;47024;22597;5.8;2.8
49;2021-03-06;717;189;47741;22786;5.9;2.8
49;2021-03-07;627;13;48368;22799;5.9;2.8
49;2021-03-08;1398;718;49766;23517;6.1;2.9
49;2021-03-09;2052;745;51818;24262;6.4;3.0
49;2021-03-10;2528;875;54346;25137;6.7;3.1
49;2021-03-11;3195;1478;57541;26615;7.1;3.3
49;2021-03-12;3765;1026;61306;27641;7.5;3.4
49;2021-03-13;1501;218;62807;27859;7.7;3.4
49;2021-03-14;6;0;62813;27859;7.7;3.4
49;2021-03-15;2083;537;64896;28396;8.0;3.5
49;2021-03-16;1732;965;66628;29361;8.2;3.6
49;2021-03-17;1810;681;68438;30042;8.4;3.7
49;2021-03-18;2206;736;70644;30778;8.7;3.8
49;2021-03-19;3333;567;73977;31345;9.1;3.8
49;2021-03-20;1743;210;75720;31555;9.3;3.9
49;2021-03-21;499;23;76219;31578;9.3;3.9
49;2021-03-22;2248;554;78467;32132;9.6;3.9
49;2021-03-23;3407;688;81874;32820;10.0;4.0
49;2021-03-24;3604;508;85478;33328;10.5;4.1
49;2021-03-25;4224;653;89702;33981;11.0;4.2
49;2021-03-26;4886;514;94588;34495;11.6;4.2
49;2021-03-27;1675;106;96263;34601;11.8;4.2
49;2021-03-28;400;28;96663;34629;11.8;4.2
49;2021-03-29;2372;614;99035;35243;12.1;4.3
49;2021-03-30;3269;947;102304;36190;12.5;4.4
49;2021-03-31;2980;754;105284;36944;12.9;4.5
49;2021-04-01;4117;878;109401;37822;13.4;4.6
49;2021-04-02;4298;964;113699;38786;13.9;4.8
49;2021-04-03;971;193;114670;38979;14.1;4.8
49;2021-04-04;315;3;114985;38982;14.1;4.8
49;2021-04-05;944;23;115929;39005;14.2;4.8
49;2021-04-06;2329;1327;118258;40332;14.5;4.9
49;2021-04-07;3309;1371;121567;41703;14.9;5.1
49;2021-04-08;5186;1435;126753;43138;15.5;5.3
49;2021-04-09;6207;1443;132960;44581;16.3;5.5
49;2021-04-10;2065;502;135025;45083;16.5;5.5
49;2021-04-11;390;9;135415;45092;16.6;5.5
49;2021-04-12;4073;1584;139488;46676;17.1;5.7
49;2021-04-13;5380;1921;144868;48597;17.8;6.0
49;2021-04-14;4542;1882;149410;50479;18.3;6.2
49;2021-04-15;5381;1896;154791;52375;19.0;6.4
49;2021-04-16;5761;2145;160552;54520;19.7;6.7
49;2021-04-17;3335;855;163887;55375;20.1;6.8
49;2021-04-18;381;476;164268;55851;20.1;6.8
49;2021-04-19;3710;2061;167978;57912;20.6;7.1
49;2021-04-20;4371;2112;172349;60024;21.1;7.4
49;2021-04-21;3955;2210;176304;62234;21.6;7.6
49;2021-04-22;4837;2114;181141;64348;22.2;7.9
49;2021-04-23;4814;2339;185955;66687;22.8;8.2
49;2021-04-24;2938;1159;188893;67846;23.2;8.3
49;2021-04-25;40;282;188933;68128;23.2;8.4
49;2021-04-26;3744;2112;192677;70240;23.6;8.6
49;2021-04-27;4471;2511;197148;72751;24.2;8.9
49;2021-04-28;4615;2501;201763;75252;24.7;9.2
49;2021-04-29;5206;3027;206969;78279;25.4;9.6
49;2021-04-30;5558;3216;212527;81495;26.0;10.0
49;2021-05-01;2365;667;214892;82162;26.3;10.1
49;2021-05-02;5;40;214897;82202;26.3;10.1
49;2021-05-03;5012;2408;219909;84610;27.0;10.4
49;2021-05-04;4972;3047;224881;87657;27.6;10.7
49;2021-05-05;4789;3008;229670;90665;28.1;11.1
49;2021-05-06;5328;3099;234998;93764;28.8;11.5
49;2021-05-07;4281;5031;239279;98795;29.3;12.1
49;2021-05-08;3577;440;242856;99235;29.8;12.2
49;2021-05-09;10;41;242866;99276;29.8;12.2
49;2021-05-10;4829;4283;247695;103559;30.4;12.7
49;2021-05-11;5397;5091;253092;108650;31.0;13.3
49;2021-05-12;4800;4595;257892;113245;31.6;13.9
49;2021-05-13;4778;691;262670;113936;32.2;14.0
49;2021-05-14;5170;3270;267840;117206;32.8;14.4
49;2021-05-15;4157;1806;271997;119012;33.3;14.6
49;2021-05-16;2786;119;274783;119131;33.7;14.6
49;2021-05-17;4835;3692;279618;122823;34.3;15.1
49;2021-05-18;5472;3769;285090;126592;34.9;15.5
49;2021-05-19;5916;3225;291006;129817;35.7;15.9
49;2021-05-20;6807;2965;297813;132782;36.5;16.3
49;2021-05-21;6450;3746;304263;136528;37.3;16.7
49;2021-05-22;5183;1199;309446;137727;37.9;16.9
49;2021-05-23;1;12;309447;137739;37.9;16.9
49;2021-05-24;4213;448;313660;138187;38.4;16.9
49;2021-05-25;6326;3308;319986;141495;39.2;17.3
49;2021-05-26;6273;2665;326259;144160;40.0;17.7
49;2021-05-27;7114;2728;333373;146888;40.9;18.0
49;2021-05-28;6875;4029;340248;150917;41.7;18.5
49;2021-05-29;5023;1903;345271;152820;42.3;18.7
49;2021-05-30;21;14;345292;152834;42.3;18.7
49;2021-05-31;6036;3221;351328;156055;43.1;19.1
49;2021-06-01;6592;3991;357920;160046;43.9;19.6
49;2021-06-02;5794;3742;363714;163788;44.6;20.1
49;2021-06-03;6602;3421;370316;167209;45.4;20.5
49;2021-06-04;6470;4867;376786;172076;46.2;21.1
49;2021-06-05;4385;2698;381171;174774;46.7;21.4
49;2021-06-06;39;50;381210;174824;46.7;21.4
49;2021-06-07;4634;4761;385844;179585;47.3;22.0
49;2021-06-08;5186;5105;391030;184690;47.9;22.6
49;2021-06-09;5325;4505;396355;189195;48.6;23.2
49;2021-06-10;6005;3785;402360;192980;49.3;23.7
49;2021-06-11;4872;6041;407232;199021;49.9;24.4
49;2021-06-12;4097;3203;411329;202224;50.4;24.8
49;2021-06-13;20;989;411349;203213;50.4;24.9
49;2021-06-14;3410;6016;414759;209229;50.8;25.6
49;2021-06-15;4241;6396;419000;215625;51.4;26.4
49;2021-06-16;4150;5682;423150;221307;51.9;27.1
49;2021-06-17;5069;5078;428219;226385;52.5;27.7
49;2021-06-18;4136;6889;432355;233274;53.0;28.6
49;2021-06-19;3526;3975;435881;237249;53.4;29.1
49;2021-06-20;33;25;435914;237274;53.4;29.1
49;2021-06-21;2828;6512;438742;243786;53.8;29.9
49;2021-06-22;3208;7009;441950;250795;54.2;30.7
49;2021-06-23;3253;6313;445203;257108;54.6;31.5
49;2021-06-24;4317;4979;449520;262087;55.1;32.1
49;2021-06-25;3325;7448;452845;269535;55.5;33.0
49;2021-06-26;2570;4627;455415;274162;55.8;33.6
49;2021-06-27;15;1544;455430;275706;55.8;33.8
49;2021-06-28;2234;7184;457664;282890;56.1;34.7
49;2021-06-29;3028;7272;460692;290162;56.5;35.6
49;2021-06-30;2824;6805;463516;296967;56.8;36.4
49;2021-07-01;3393;6274;466909;303241;57.2;37.2
49;2021-07-02;3064;8067;469973;311308;57.6;38.2
49;2021-07-03;2007;5486;471980;316794;57.8;38.8
49;2021-07-04;7;53;471987;316847;57.8;38.8
49;2021-07-05;1738;7078;473725;323925;58.1;39.7
49;2021-07-06;1894;7551;475619;331476;58.3;40.6
49;2021-07-07;2100;6625;477719;338101;58.6;41.4
49;2021-07-08;2689;6357;480408;344458;58.9;42.2
49;2021-07-09;2361;8251;482769;352709;59.2;43.2
49;2021-07-10;1802;5345;484571;358054;59.4;43.9
49;2021-07-11;12;35;484583;358089;59.4;43.9
49;2021-07-12;1948;7714;486531;365803;59.6;44.8
49;2021-07-13;2572;8304;489103;374107;59.9;45.9
49;2021-07-14;2893;3375;491996;377482;60.3;46.3
49;2021-07-15;3167;7554;495163;385036;60.7;47.2
49;2021-07-16;3396;8299;498559;393335;61.1;48.2
49;2021-07-17;2103;5481;500662;398816;61.4;48.9
49;2021-07-18;3751;583;504413;399399;61.8;49.0
49;2021-07-19;2667;7452;507080;406851;62.2;49.9
49;2021-07-20;3588;7484;510668;414335;62.6;50.8
49;2021-07-21;4228;6464;514896;420799;63.1;51.6
49;2021-07-22;4815;5867;519711;426666;63.7;52.3
49;2021-07-23;5111;6630;524822;433296;64.3;53.1
49;2021-07-24;3690;5004;528512;438300;64.8;53.7
49;2021-07-25;67;33;528579;438333;64.8;53.7
49;2021-07-26;4517;5903;533096;444236;65.3;54.4
49;2021-07-27;5753;5446;538849;449682;66.0;55.1
49;2021-07-28;6019;4362;544868;454044;66.8;55.7
49;2021-07-29;6702;4158;551570;458202;67.6;56.2
49;2021-07-30;6172;4792;557742;462994;68.4;56.7
49;2021-07-31;3959;3422;561701;466416;68.8;57.2
49;2021-08-01;21;22;561722;466438;68.8;57.2
49;2021-08-02;4271;4659;565993;471097;69.4;57.7
49;2021-08-03;5434;3804;571427;474901;70.0;58.2
49;2021-08-04;5276;3722;576703;478623;70.7;58.7
49;2021-08-05;5307;3289;582010;481912;71.3;59.1
49;2021-08-06;5718;4284;587728;486196;72.0;59.6
49;2021-08-07;3926;3044;591654;489240;72.5;60.0
49;2021-08-08;24;36;591678;489276;72.5;60.0
49;2021-08-09;3500;4682;595178;493958;72.9;60.5
49;2021-08-10;4252;3904;599430;497862;73.5;61.0
49;2021-08-11;4007;3654;603437;501516;74.0;61.5
49;2021-08-12;2665;3055;606102;504571;74.3;61.8
49;2021-08-13;3927;4271;610029;508842;74.8;62.4
49;2021-08-14;2279;3149;612308;511991;75.0;62.8
49;2021-08-15;31;26;612339;512017;75.1;62.8
49;2021-08-16;2832;5061;615171;517078;75.4;63.4
49;2021-08-17;3276;4911;618447;521989;75.8;64.0
49;2021-08-18;2977;4114;621424;526103;76.2;64.5
49;2021-08-19;1549;3663;622973;529766;76.4;64.9
49;2021-08-20;2733;5773;625706;535539;76.7;65.6
49;2021-08-21;1400;4151;627106;539690;76.9;66.1
49;2021-08-22;6;41;627112;539731;76.9;66.2
49;2021-08-23;2257;5627;629369;545358;77.1;66.8
49;2021-08-24;2747;5788;632116;551146;77.5;67.6
49;2021-08-25;2330;5432;634446;556578;77.8;68.2
49;2021-08-26;1717;4827;636163;561405;78.0;68.8
49;2021-08-27;2454;6813;638617;568218;78.3;69.6
49;2021-08-28;906;4302;639523;572520;78.4;70.2
49;2021-08-29;5;94;639528;572614;78.4;70.2
49;2021-08-30;1154;4255;640682;576869;78.5;70.7
49;2021-08-31;2249;5915;642931;582784;78.8;71.4
49;2021-09-01;1684;4297;644615;587081;79.0;72.0
49;2021-09-02;1064;2620;645679;589701;79.1;72.3
49;2021-09-03;1461;3951;647140;593652;79.3;72.8
49;2021-09-04;1211;3451;648351;597103;79.5;73.2
49;2021-09-05;5;5;648356;597108;79.5;73.2
49;2021-09-06;1098;2623;649454;599731;79.6;73.5
49;2021-09-07;1191;2539;650645;602270;79.7;73.8
49;2021-09-08;989;3069;651634;605339;79.9;74.2
49;2021-09-09;772;1608;652406;606947;80.0;74.4
49;2021-09-10;973;2840;653379;609787;80.1;74.7
49;2021-09-11;727;2525;654106;612312;80.2;75.0
49;2021-09-12;12;7;654118;612319;80.2;75.1
49;2021-09-13;746;2088;654864;614407;80.3;75.3
49;2021-09-14;644;1709;655508;616116;80.3;75.5
49;2021-09-15;624;2231;656132;618347;80.4;75.8
49;2021-09-16;527;1288;656659;619635;80.5;75.9
49;2021-09-17;935;2518;657594;622153;80.6;76.3
49;2021-09-18;543;2005;658137;624158;80.7;76.5
49;2021-09-19;2;8;658139;624166;80.7;76.5
49;2021-09-20;522;1246;658661;625412;80.7;76.7
49;2021-09-21;435;1598;659096;627010;80.8;76.9
49;2021-09-22;337;1996;659433;629006;80.8;77.1
49;2021-09-23;329;1171;659762;630177;80.9;77.2
49;2021-09-24;567;2243;660329;632420;80.9;77.5
49;2021-09-25;200;1015;660529;633435;81.0;77.6
49;2021-09-26;0;0;660529;633435;81.0;77.6
49;2021-09-27;386;1376;660915;634811;81.0;77.8
49;2021-09-28;414;1061;661329;635872;81.1;77.9
49;2021-09-29;378;1242;661707;637114;81.1;78.1
49;2021-09-30;319;708;662026;637822;81.1;78.2
49;2021-10-01;545;1505;662571;639327;81.2;78.4
49;2021-10-02;354;1134;662925;640461;81.3;78.5
49;2021-10-03;4;13;662929;640474;81.3;78.5
49;2021-10-04;314;760;663243;641234;81.3;78.6
49;2021-10-05;190;555;663433;641789;81.3;78.7
49;2021-10-06;405;751;663838;642540;81.4;78.8
49;2021-10-07;221;410;664059;642950;81.4;78.8
49;2021-10-08;563;1264;664622;644214;81.5;79.0
49;2021-10-09;265;650;664887;644864;81.5;79.0
49;2021-10-10;3;2;664890;644866;81.5;79.0
49;2021-10-11;308;712;665198;645578;81.5;79.1
49;2021-10-12;246;318;665444;645896;81.6;79.2
49;2021-10-13;317;525;665761;646421;81.6;79.2
49;2021-10-14;230;370;665991;646791;81.6;79.3
49;2021-10-15;426;779;666417;647570;81.7;79.4
49;2021-10-16;243;415;666660;647985;81.7;79.4
49;2021-10-17;0;10;666660;647995;81.7;79.4
49;2021-10-18;233;264;666893;648259;81.7;79.5
49;2021-10-19;238;371;667131;648630;81.8;79.5
50;2020-12-27;0;0;0;0;0.0;0.0
50;2020-12-28;0;0;0;0;0.0;0.0
50;2020-12-29;1;0;1;0;0.0;0.0
50;2020-12-30;0;0;1;0;0.0;0.0
50;2020-12-31;0;0;1;0;0.0;0.0
50;2021-01-01;0;0;1;0;0.0;0.0
50;2021-01-02;0;0;1;0;0.0;0.0
50;2021-01-03;0;0;1;0;0.0;0.0
50;2021-01-04;1;0;2;0;0.0;0.0
50;2021-01-05;0;0;2;0;0.0;0.0
50;2021-01-06;126;0;128;0;0.0;0.0
50;2021-01-07;324;0;452;0;0.1;0.0
50;2021-01-08;436;2;888;2;0.2;0.0
50;2021-01-09;237;0;1125;2;0.2;0.0
50;2021-01-10;23;0;1148;2;0.2;0.0
50;2021-01-11;391;1;1539;3;0.3;0.0
50;2021-01-12;599;0;2138;3;0.4;0.0
50;2021-01-13;695;5;2833;8;0.6;0.0
50;2021-01-14;1051;11;3884;19;0.8;0.0
50;2021-01-15;710;4;4594;23;0.9;0.0
50;2021-01-16;215;3;4809;26;1.0;0.0
50;2021-01-17;1;0;4810;26;1.0;0.0
50;2021-01-18;620;2;5430;28;1.1;0.0
50;2021-01-19;902;9;6332;37;1.3;0.0
50;2021-01-20;964;1;7296;38;1.5;0.0
50;2021-01-21;917;4;8213;42;1.7;0.0
50;2021-01-22;716;4;8929;46;1.8;0.0
50;2021-01-23;668;4;9597;50;2.0;0.0
50;2021-01-24;882;3;10479;53;2.1;0.0
50;2021-01-25;2708;16;13187;69;2.7;0.0
50;2021-01-26;1336;16;14523;85;3.0;0.0
50;2021-01-27;769;56;15292;141;3.1;0.0
50;2021-01-28;716;170;16008;311;3.3;0.1
50;2021-01-29;581;307;16589;618;3.4;0.1
50;2021-01-30;382;164;16971;782;3.5;0.2
50;2021-01-31;0;0;16971;782;3.5;0.2
50;2021-02-01;451;224;17422;1006;3.6;0.2
50;2021-02-02;417;235;17839;1241;3.6;0.3
50;2021-02-03;391;375;18230;1616;3.7;0.3
50;2021-02-04;486;448;18716;2064;3.8;0.4
50;2021-02-05;426;448;19142;2512;3.9;0.5
50;2021-02-06;179;114;19321;2626;3.9;0.5
50;2021-02-07;0;0;19321;2626;3.9;0.5
50;2021-02-08;254;505;19575;3131;4.0;0.6
50;2021-02-09;246;640;19821;3771;4.0;0.8
50;2021-02-10;571;557;20392;4328;4.2;0.9
50;2021-02-11;436;915;20828;5243;4.2;1.1
50;2021-02-12;330;671;21158;5914;4.3;1.2
50;2021-02-13;307;487;21465;6401;4.4;1.3
50;2021-02-14;186;826;21651;7227;4.4;1.5
50;2021-02-15;664;2030;22315;9257;4.5;1.9
50;2021-02-16;747;1615;23062;10872;4.7;2.2
50;2021-02-17;632;823;23694;11695;4.8;2.4
50;2021-02-18;569;810;24263;12505;4.9;2.5
50;2021-02-19;631;519;24894;13024;5.1;2.7
50;2021-02-20;423;191;25317;13215;5.2;2.7
50;2021-02-21;85;29;25402;13244;5.2;2.7
50;2021-02-22;291;720;25693;13964;5.2;2.8
50;2021-02-23;503;565;26196;14529;5.3;3.0
50;2021-02-24;624;572;26820;15101;5.5;3.1
50;2021-02-25;780;594;27600;15695;5.6;3.2
50;2021-02-26;998;398;28598;16093;5.8;3.3
50;2021-02-27;887;115;29485;16208;6.0;3.3
50;2021-02-28;111;0;29596;16208;6.0;3.3
50;2021-03-01;488;557;30084;16765;6.1;3.4
50;2021-03-02;651;521;30735;17286;6.3;3.5
50;2021-03-03;797;457;31532;17743;6.4;3.6
50;2021-03-04;1247;340;32779;18083;6.7;3.7
50;2021-03-05;1553;353;34332;18436;7.0;3.8
50;2021-03-06;1320;161;35652;18597;7.3;3.8
50;2021-03-07;551;42;36203;18639;7.4;3.8
50;2021-03-08;1026;625;37229;19264;7.6;3.9
50;2021-03-09;1557;586;38786;19850;7.9;4.0
50;2021-03-10;1607;324;40393;20174;8.2;4.1
50;2021-03-11;2351;362;42744;20536;8.7;4.2
50;2021-03-12;2863;252;45607;20788;9.3;4.2
50;2021-03-13;1995;141;47602;20929;9.7;4.3
50;2021-03-14;280;43;47882;20972;9.8;4.3
50;2021-03-15;1378;301;49260;21273;10.0;4.3
50;2021-03-16;1340;285;50600;21558;10.3;4.4
50;2021-03-17;1296;417;51896;21975;10.6;4.5
50;2021-03-18;1162;435;53058;22410;10.8;4.6
50;2021-03-19;1733;595;54791;23005;11.2;4.7
50;2021-03-20;1688;234;56479;23239;11.5;4.7
50;2021-03-21;793;12;57272;23251;11.7;4.7
50;2021-03-22;1508;343;58780;23594;12.0;4.8
50;2021-03-23;2078;403;60858;23997;12.4;4.9
50;2021-03-24;2281;558;63139;24555;12.9;5.0
50;2021-03-25;2813;476;65952;25031;13.4;5.1
50;2021-03-26;3204;480;69156;25511;14.1;5.2
50;2021-03-27;1825;380;70981;25891;14.5;5.3
50;2021-03-28;403;20;71384;25911;14.5;5.3
50;2021-03-29;2139;723;73523;26634;15.0;5.4
50;2021-03-30;2283;647;75806;27281;15.4;5.6
50;2021-03-31;2479;576;78285;27857;16.0;5.7
50;2021-04-01;3104;875;81389;28732;16.6;5.9
50;2021-04-02;2960;935;84349;29667;17.2;6.0
50;2021-04-03;1245;686;85594;30353;17.4;6.2
50;2021-04-04;320;135;85914;30488;17.5;6.2
50;2021-04-05;400;28;86314;30516;17.6;6.2
50;2021-04-06;2127;1226;88441;31742;18.0;6.5
50;2021-04-07;2558;1185;90999;32927;18.5;6.7
50;2021-04-08;3597;1215;94596;34142;19.3;7.0
50;2021-04-09;3936;1304;98532;35446;20.1;7.2
50;2021-04-10;2535;879;101067;36325;20.6;7.4
50;2021-04-11;411;146;101478;36471;20.7;7.4
50;2021-04-12;2438;1381;103916;37852;21.2;7.7
50;2021-04-13;2679;1522;106595;39374;21.7;8.0
50;2021-04-14;2608;1360;109203;40734;22.3;8.3
50;2021-04-15;3159;1119;112362;41853;22.9;8.5
50;2021-04-16;3362;1104;115724;42957;23.6;8.8
50;2021-04-17;2396;1185;118120;44142;24.1;9.0
50;2021-04-18;425;666;118545;44808;24.2;9.1
50;2021-04-19;1996;1473;120541;46281;24.6;9.4
50;2021-04-20;2273;1594;122814;47875;25.0;9.8
50;2021-04-21;2548;1764;125362;49639;25.5;10.1
50;2021-04-22;3078;1829;128440;51468;26.2;10.5
50;2021-04-23;2758;1924;131198;53392;26.7;10.9
50;2021-04-24;1899;1440;133097;54832;27.1;11.2
50;2021-04-25;470;273;133567;55105;27.2;11.2
50;2021-04-26;2119;1892;135686;56997;27.7;11.6
50;2021-04-27;2412;2005;138098;59002;28.1;12.0
50;2021-04-28;2708;1977;140806;60979;28.7;12.4
50;2021-04-29;3285;2053;144091;63032;29.4;12.8
50;2021-04-30;2999;1937;147090;64969;30.0;13.2
50;2021-05-01;1015;597;148105;65566;30.2;13.4
50;2021-05-02;522;448;148627;66014;30.3;13.5
50;2021-05-03;1771;1806;150398;67820;30.7;13.8
50;2021-05-04;1771;2332;152169;70152;31.0;14.3
50;2021-05-05;1659;2955;153828;73107;31.4;14.9
50;2021-05-06;2530;2590;156358;75697;31.9;15.4
50;2021-05-07;2149;2861;158507;78558;32.3;16.0
50;2021-05-08;1171;796;159678;79354;32.5;16.2
50;2021-05-09;624;362;160302;79716;32.7;16.2
50;2021-05-10;1705;2604;162007;82320;33.0;16.8
50;2021-05-11;2542;2848;164549;85168;33.5;17.4
50;2021-05-12;3179;2440;167728;87608;34.2;17.9
50;2021-05-13;3382;611;171110;88219;34.9;18.0
50;2021-05-14;3568;2279;174678;90498;35.6;18.4
50;2021-05-15;4001;1875;178679;92373;36.4;18.8
50;2021-05-16;947;267;179626;92640;36.6;18.9
50;2021-05-17;2140;1879;181766;94519;37.0;19.3
50;2021-05-18;2523;1619;184289;96138;37.6;19.6
50;2021-05-19;2503;1446;186792;97584;38.1;19.9
50;2021-05-20;3261;1623;190053;99207;38.7;20.2
50;2021-05-21;3156;1911;193209;101118;39.4;20.6
50;2021-05-22;2651;1328;195860;102446;39.9;20.9
50;2021-05-23;604;284;196464;102730;40.0;20.9
50;2021-05-24;1527;489;197991;103219;40.4;21.0
50;2021-05-25;2448;1671;200439;104890;40.9;21.4
50;2021-05-26;3002;1461;203441;106351;41.5;21.7
50;2021-05-27;3036;1972;206477;108323;42.1;22.1
50;2021-05-28;2941;2126;209418;110449;42.7;22.5
50;2021-05-29;2761;1404;212179;111853;43.2;22.8
50;2021-05-30;812;327;212991;112180;43.4;22.9
50;2021-05-31;2651;1817;215642;113997;43.9;23.2
50;2021-06-01;3333;2069;218975;116066;44.6;23.7
50;2021-06-02;3259;1785;222234;117851;45.3;24.0
50;2021-06-03;3914;2060;226148;119911;46.1;24.4
50;2021-06-04;3822;2886;229970;122797;46.9;25.0
50;2021-06-05;2958;1847;232928;124644;47.5;25.4
50;2021-06-06;813;442;233741;125086;47.6;25.5
50;2021-06-07;3512;2082;237253;127168;48.4;25.9
50;2021-06-08;4073;2228;241326;129396;49.2;26.4
50;2021-06-09;4253;1998;245579;131394;50.0;26.8
50;2021-06-10;4193;2118;249772;133512;50.9;27.2
50;2021-06-11;4223;2712;253995;136224;51.8;27.8
50;2021-06-12;3738;1613;257733;137837;52.5;28.1
50;2021-06-13;1143;451;258876;138288;52.8;28.2
50;2021-06-14;2693;2967;261569;141255;53.3;28.8
50;2021-06-15;3016;2602;264585;143857;53.9;29.3
50;2021-06-16;3096;1976;267681;145833;54.6;29.7
50;2021-06-17;2798;2486;270479;148319;55.1;30.2
50;2021-06-18;3239;3055;273718;151374;55.8;30.9
50;2021-06-19;3176;1927;276894;153301;56.4;31.2
50;2021-06-20;731;710;277625;154011;56.6;31.4
50;2021-06-21;1819;3133;279444;157144;57.0;32.0
50;2021-06-22;2064;3393;281508;160537;57.4;32.7
50;2021-06-23;1871;3875;283379;164412;57.8;33.5
50;2021-06-24;1711;4008;285090;168420;58.1;34.3
50;2021-06-25;2134;4009;287224;172429;58.5;35.1
50;2021-06-26;2147;3695;289371;176124;59.0;35.9
50;2021-06-27;615;895;289986;177019;59.1;36.1
50;2021-06-28;1927;3349;291913;180368;59.5;36.8
50;2021-06-29;1881;3409;293794;183777;59.9;37.5
50;2021-06-30;2179;3411;295973;187188;60.3;38.1
50;2021-07-01;1945;3288;297918;190476;60.7;38.8
50;2021-07-02;1898;3935;299816;194411;61.1;39.6
50;2021-07-03;1449;3447;301265;197858;61.4;40.3
50;2021-07-04;445;1066;301710;198924;61.5;40.5
50;2021-07-05;1262;3412;302972;202336;61.7;41.2
50;2021-07-06;1573;3896;304545;206232;62.1;42.0
50;2021-07-07;1804;3617;306349;209849;62.4;42.8
50;2021-07-08;1374;4101;307723;213950;62.7;43.6
50;2021-07-09;1394;4572;309117;218522;63.0;44.5
50;2021-07-10;1023;3599;310140;222121;63.2;45.3
50;2021-07-11;373;1018;310513;223139;63.3;45.5
50;2021-07-12;1317;4625;311830;227764;63.6;46.4
50;2021-07-13;1624;4857;313454;232621;63.9;47.4
50;2021-07-14;1476;2359;314930;234980;64.2;47.9
50;2021-07-15;1688;5056;316618;240036;64.5;48.9
50;2021-07-16;2992;5244;319610;245280;65.1;50.0
50;2021-07-17;2149;3733;321759;249013;65.6;50.7
50;2021-07-18;402;1092;322161;250105;65.7;51.0
50;2021-07-19;1571;5186;323732;255291;66.0;52.0
50;2021-07-20;1924;5407;325656;260698;66.4;53.1
50;2021-07-21;1802;5259;327458;265957;66.7;54.2
50;2021-07-22;1947;5005;329405;270962;67.1;55.2
50;2021-07-23;2072;5386;331477;276348;67.6;56.3
50;2021-07-24;1311;3836;332788;280184;67.8;57.1
50;2021-07-25;274;1037;333062;281221;67.9;57.3
50;2021-07-26;2290;3487;335352;284708;68.3;58.0
50;2021-07-27;2899;3347;338251;288055;68.9;58.7
50;2021-07-28;2998;3689;341249;291744;69.5;59.5
50;2021-07-29;3581;3233;344830;294977;70.3;60.1
50;2021-07-30;3075;3009;347905;297986;70.9;60.7
50;2021-07-31;2406;2672;350311;300658;71.4;61.3
50;2021-08-01;484;686;350795;301344;71.5;61.4
50;2021-08-02;2474;2741;353269;304085;72.0;62.0
50;2021-08-03;3404;2470;356673;306555;72.7;62.5
50;2021-08-04;3602;2324;360275;308879;73.4;63.0
50;2021-08-05;3189;2159;363464;311038;74.1;63.4
50;2021-08-06;3660;2801;367124;313839;74.8;64.0
50;2021-08-07;2462;2156;369586;315995;75.3;64.4
50;2021-08-08;511;712;370097;316707;75.4;64.5
50;2021-08-09;2493;2135;372590;318842;75.9;65.0
50;2021-08-10;2987;1989;375577;320831;76.5;65.4
50;2021-08-11;2852;2018;378429;322849;77.1;65.8
50;2021-08-12;2596;2440;381025;325289;77.7;66.3
50;2021-08-13;2506;1980;383531;327269;78.2;66.7
50;2021-08-14;1811;1748;385342;329017;78.5;67.1
50;2021-08-15;399;334;385741;329351;78.6;67.1
50;2021-08-16;1720;2228;387461;331579;79.0;67.6
50;2021-08-17;1973;2704;389434;334283;79.4;68.1
50;2021-08-18;1846;2389;391280;336672;79.7;68.6
50;2021-08-19;1710;2579;392990;339251;80.1;69.1
50;2021-08-20;1621;2739;394611;341990;80.4;69.7
50;2021-08-21;1017;2727;395628;344717;80.6;70.3
50;2021-08-22;384;519;396012;345236;80.7;70.4
50;2021-08-23;1138;2906;397150;348142;80.9;71.0
50;2021-08-24;1246;3222;398396;351364;81.2;71.6
50;2021-08-25;1107;2649;399503;354013;81.4;72.1
50;2021-08-26;866;3156;400369;357169;81.6;72.8
50;2021-08-27;940;3181;401309;360350;81.8;73.4
50;2021-08-28;795;2887;402104;363237;82.0;74.0
50;2021-08-29;283;575;402387;363812;82.0;74.1
50;2021-08-30;774;2875;403161;366687;82.2;74.7
50;2021-08-31;824;2928;403985;369615;82.3;75.3
50;2021-09-01;714;2660;404699;372275;82.5;75.9
50;2021-09-02;541;2220;405240;374495;82.6;76.3
50;2021-09-03;708;2542;405948;377037;82.7;76.8
50;2021-09-04;620;2852;406568;379889;82.9;77.4
50;2021-09-05;194;669;406762;380558;82.9;77.6
50;2021-09-06;436;1898;407198;382456;83.0;77.9
50;2021-09-07;330;1473;407528;383929;83.1;78.2
50;2021-09-08;518;1934;408046;385863;83.2;78.6
50;2021-09-09;424;1274;408470;387137;83.2;78.9
50;2021-09-10;530;1689;409000;388826;83.4;79.2
50;2021-09-11;365;2179;409365;391005;83.4;79.7
50;2021-09-12;71;369;409436;391374;83.4;79.8
50;2021-09-13;418;1022;409854;392396;83.5;80.0
50;2021-09-14;420;939;410274;393335;83.6;80.2
50;2021-09-15;421;1087;410695;394422;83.7;80.4
50;2021-09-16;466;749;411161;395171;83.8;80.5
50;2021-09-17;465;1034;411626;396205;83.9;80.7
50;2021-09-18;314;1467;411940;397672;84.0;81.0
50;2021-09-19;46;276;411986;397948;84.0;81.1
50;2021-09-20;386;589;412372;398537;84.0;81.2
50;2021-09-21;433;625;412805;399162;84.1;81.4
50;2021-09-22;220;867;413025;400029;84.2;81.5
50;2021-09-23;272;452;413297;400481;84.2;81.6
50;2021-09-24;254;818;413551;401299;84.3;81.8
50;2021-09-25;215;934;413766;402233;84.3;82.0
50;2021-09-26;20;181;413786;402414;84.3;82.0
50;2021-09-27;110;393;413896;402807;84.4;82.1
50;2021-09-28;160;385;414056;403192;84.4;82.2
50;2021-09-29;156;526;414212;403718;84.4;82.3
50;2021-09-30;165;424;414377;404142;84.5;82.4
50;2021-10-01;209;595;414586;404737;84.5;82.5
50;2021-10-02;224;540;414810;405277;84.5;82.6
50;2021-10-03;2;5;414812;405282;84.5;82.6
50;2021-10-04;180;484;414992;405766;84.6;82.7
50;2021-10-05;135;399;415127;406165;84.6;82.8
50;2021-10-06;191;490;415318;406655;84.6;82.9
50;2021-10-07;112;361;415430;407016;84.7;83.0
50;2021-10-08;212;500;415642;407516;84.7;83.1
50;2021-10-09;218;515;415860;408031;84.8;83.2
50;2021-10-10;0;0;415860;408031;84.8;83.2
50;2021-10-11;99;233;415959;408264;84.8;83.2
50;2021-10-12;136;346;416095;408610;84.8;83.3
50;2021-10-13;148;298;416243;408908;84.8;83.3
50;2021-10-14;100;296;416343;409204;84.9;83.4
50;2021-10-15;221;382;416564;409586;84.9;83.5
50;2021-10-16;213;323;416777;409909;84.9;83.5
50;2021-10-17;8;20;416785;409929;84.9;83.5
50;2021-10-18;87;327;416872;410256;85.0;83.6
50;2021-10-19;94;238;416966;410494;85.0;83.7
51;2020-12-27;0;0;0;0;0.0;0.0
51;2020-12-28;0;0;0;0;0.0;0.0
51;2020-12-29;0;0;0;0;0.0;0.0
51;2020-12-30;0;0;0;0;0.0;0.0
51;2020-12-31;1;0;1;0;0.0;0.0
51;2021-01-01;0;0;1;0;0.0;0.0
51;2021-01-02;0;0;1;0;0.0;0.0
51;2021-01-03;0;0;1;0;0.0;0.0
51;2021-01-04;1;0;2;0;0.0;0.0
51;2021-01-05;1;0;3;0;0.0;0.0
51;2021-01-06;6;0;9;0;0.0;0.0
51;2021-01-07;262;1;271;1;0.0;0.0
51;2021-01-08;508;1;779;2;0.1;0.0
51;2021-01-09;92;1;871;3;0.2;0.0
51;2021-01-10;0;0;871;3;0.2;0.0
51;2021-01-11;546;2;1417;5;0.3;0.0
51;2021-01-12;1542;5;2959;10;0.5;0.0
51;2021-01-13;1289;7;4248;17;0.8;0.0
51;2021-01-14;1475;8;5723;25;1.0;0.0
51;2021-01-15;607;4;6330;29;1.1;0.0
51;2021-01-16;177;1;6507;30;1.2;0.0
51;2021-01-17;102;0;6609;30;1.2;0.0
51;2021-01-18;845;4;7454;34;1.3;0.0
51;2021-01-19;997;5;8451;39;1.5;0.0
51;2021-01-20;955;11;9406;50;1.7;0.0
51;2021-01-21;790;3;10196;53;1.8;0.0
51;2021-01-22;394;2;10590;55;1.9;0.0
51;2021-01-23;294;0;10884;55;1.9;0.0
51;2021-01-24;130;1;11014;56;2.0;0.0
51;2021-01-25;712;3;11726;59;2.1;0.0
51;2021-01-26;779;5;12505;64;2.2;0.0
51;2021-01-27;656;4;13161;68;2.3;0.0
51;2021-01-28;646;68;13807;136;2.4;0.0
51;2021-01-29;474;142;14281;278;2.5;0.0
51;2021-01-30;126;5;14407;283;2.6;0.1
51;2021-01-31;83;0;14490;283;2.6;0.1
51;2021-02-01;275;58;14765;341;2.6;0.1
51;2021-02-02;738;723;15503;1064;2.7;0.2
51;2021-02-03;642;472;16145;1536;2.9;0.3
51;2021-02-04;968;816;17113;2352;3.0;0.4
51;2021-02-05;972;513;18085;2865;3.2;0.5
51;2021-02-06;30;147;18115;3012;3.2;0.5
51;2021-02-07;0;18;18115;3030;3.2;0.5
51;2021-02-08;115;412;18230;3442;3.2;0.6
51;2021-02-09;221;470;18451;3912;3.3;0.7
51;2021-02-10;220;637;18671;4549;3.3;0.8
51;2021-02-11;302;530;18973;5079;3.4;0.9
51;2021-02-12;341;564;19314;5643;3.4;1.0
51;2021-02-13;9;115;19323;5758;3.4;1.0
51;2021-02-14;8;171;19331;5929;3.4;1.1
51;2021-02-15;266;848;19597;6777;3.5;1.2
51;2021-02-16;402;969;19999;7746;3.5;1.4
51;2021-02-17;368;877;20367;8623;3.6;1.5
51;2021-02-18;437;593;20804;9216;3.7;1.6
51;2021-02-19;526;423;21330;9639;3.8;1.7
51;2021-02-20;205;293;21535;9932;3.8;1.8
51;2021-02-21;10;101;21545;10033;3.8;1.8
51;2021-02-22;195;689;21740;10722;3.9;1.9
51;2021-02-23;262;1100;22002;11822;3.9;2.1
51;2021-02-24;414;689;22416;12511;4.0;2.2
51;2021-02-25;1049;887;23465;13398;4.2;2.4
51;2021-02-26;1228;668;24693;14066;4.4;2.5
51;2021-02-27;590;124;25283;14190;4.5;2.5
51;2021-02-28;7;71;25290;14261;4.5;2.5
51;2021-03-01;768;314;26058;14575;4.6;2.6
51;2021-03-02;1128;467;27186;15042;4.8;2.7
51;2021-03-03;1195;467;28381;15509;5.0;2.8
51;2021-03-04;1061;701;29442;16210;5.2;2.9
51;2021-03-05;1562;675;31004;16885;5.5;3.0
51;2021-03-06;1434;60;32438;16945;5.8;3.0
51;2021-03-07;251;6;32689;16951;5.8;3.0
51;2021-03-08;992;101;33681;17052;6.0;3.0
51;2021-03-09;1666;197;35347;17249;6.3;3.1
51;2021-03-10;1999;114;37346;17363;6.6;3.1
51;2021-03-11;2371;175;39717;17538;7.0;3.1
51;2021-03-12;3258;167;42975;17705;7.6;3.1
51;2021-03-13;2549;54;45524;17759;8.1;3.1
51;2021-03-14;190;5;45714;17764;8.1;3.2
51;2021-03-15;1580;151;47294;17915;8.4;3.2
51;2021-03-16;1478;186;48772;18101;8.7;3.2
51;2021-03-17;1497;211;50269;18312;8.9;3.2
51;2021-03-18;1615;288;51884;18600;9.2;3.3
51;2021-03-19;2311;302;54195;18902;9.6;3.4
51;2021-03-20;1661;220;55856;19122;9.9;3.4
51;2021-03-21;134;5;55990;19127;9.9;3.4
51;2021-03-22;1416;126;57406;19253;10.2;3.4
51;2021-03-23;2469;170;59875;19423;10.6;3.4
51;2021-03-24;2846;137;62721;19560;11.1;3.5
51;2021-03-25;3254;340;65975;19900;11.7;3.5
51;2021-03-26;3412;511;69387;20411;12.3;3.6
51;2021-03-27;1842;253;71229;20664;12.6;3.7
51;2021-03-28;213;3;71442;20667;12.7;3.7
51;2021-03-29;991;641;72433;21308;12.8;3.8
51;2021-03-30;1748;864;74181;22172;13.2;3.9
51;2021-03-31;1739;761;75920;22933;13.5;4.1
51;2021-04-01;2280;462;78200;23395;13.9;4.1
51;2021-04-02;2425;645;80625;24040;14.3;4.3
51;2021-04-03;1301;414;81926;24454;14.5;4.3
51;2021-04-04;106;2;82032;24456;14.5;4.3
51;2021-04-05;72;141;82104;24597;14.6;4.4
51;2021-04-06;763;1233;82867;25830;14.7;4.6
51;2021-04-07;1312;1412;84179;27242;14.9;4.8
51;2021-04-08;2208;1783;86387;29025;15.3;5.1
51;2021-04-09;2863;1736;89250;30761;15.8;5.5
51;2021-04-10;2219;503;91469;31264;16.2;5.5
51;2021-04-11;105;85;91574;31349;16.2;5.6
51;2021-04-12;1450;1343;93024;32692;16.5;5.8
51;2021-04-13;1936;1682;94960;34374;16.8;6.1
51;2021-04-14;2460;1560;97420;35934;17.3;6.4
51;2021-04-15;2854;1675;100274;37609;17.8;6.7
51;2021-04-16;3214;1609;103488;39218;18.4;7.0
51;2021-04-17;1966;776;105454;39994;18.7;7.1
51;2021-04-18;296;114;105750;40108;18.8;7.1
51;2021-04-19;1561;1162;107311;41270;19.0;7.3
51;2021-04-20;1791;1665;109102;42935;19.4;7.6
51;2021-04-21;2002;1746;111104;44681;19.7;7.9
51;2021-04-22;2406;1666;113510;46347;20.1;8.2
51;2021-04-23;2982;1831;116492;48178;20.7;8.5
51;2021-04-24;1749;955;118241;49133;21.0;8.7
51;2021-04-25;123;161;118364;49294;21.0;8.7
51;2021-04-26;1851;760;120215;50054;21.3;8.9
51;2021-04-27;2441;1237;122656;51291;21.8;9.1
51;2021-04-28;2552;1315;125208;52606;22.2;9.3
51;2021-04-29;2676;1464;127884;54070;22.7;9.6
51;2021-04-30;2975;1679;130859;55749;23.2;9.9
51;2021-05-01;1453;411;132312;56160;23.5;10.0
51;2021-05-02;107;99;132419;56259;23.5;10.0
51;2021-05-03;2484;766;134903;57025;23.9;10.1
51;2021-05-04;2788;1358;137691;58383;24.4;10.4
51;2021-05-05;2861;1643;140552;60026;24.9;10.6
51;2021-05-06;5344;1956;145896;61982;25.9;11.0
51;2021-05-07;3705;1940;149601;63922;26.5;11.3
51;2021-05-08;2862;820;152463;64742;27.0;11.5
51;2021-05-09;212;92;152675;64834;27.1;11.5
51;2021-05-10;3214;1869;155889;66703;27.6;11.8
51;2021-05-11;3643;2042;159532;68745;28.3;12.2
51;2021-05-12;4182;2237;163714;70982;29.0;12.6
51;2021-05-13;1777;505;165491;71487;29.4;12.7
51;2021-05-14;5401;1744;170892;73231;30.3;13.0
51;2021-05-15;4227;1355;175119;74586;31.1;13.2
51;2021-05-16;284;47;175403;74633;31.1;13.2
51;2021-05-17;3131;1524;178534;76157;31.7;13.5
51;2021-05-18;3918;1767;182452;77924;32.4;13.8
51;2021-05-19;4031;1724;186483;79648;33.1;14.1
51;2021-05-20;4649;1969;191132;81617;33.9;14.5
51;2021-05-21;3597;2473;194729;84090;34.5;14.9
51;2021-05-22;2075;1549;196804;85639;34.9;15.2
51;2021-05-23;308;210;197112;85849;35.0;15.2
51;2021-05-24;2019;720;199131;86569;35.3;15.4
51;2021-05-25;3130;1829;202261;88398;35.9;15.7
51;2021-05-26;3297;1713;205558;90111;36.5;16.0
51;2021-05-27;3267;2062;208825;92173;37.0;16.3
51;2021-05-28;3605;2823;212430;94996;37.7;16.8
51;2021-05-29;2401;1995;214831;96991;38.1;17.2
51;2021-05-30;401;133;215232;97124;38.2;17.2
51;2021-05-31;3348;1784;218580;98908;38.8;17.5
51;2021-06-01;3854;2334;222434;101242;39.5;18.0
51;2021-06-02;6095;2332;228529;103574;40.5;18.4
51;2021-06-03;3581;2427;232110;106001;41.2;18.8
51;2021-06-04;6346;2943;238456;108944;42.3;19.3
51;2021-06-05;2597;1822;241053;110766;42.8;19.6
51;2021-06-06;172;157;241225;110923;42.8;19.7
51;2021-06-07;4302;2166;245527;113089;43.5;20.1
51;2021-06-08;3925;2533;249452;115622;44.2;20.5
51;2021-06-09;4016;2750;253468;118372;45.0;21.0
51;2021-06-10;3208;2491;256676;120863;45.5;21.4
51;2021-06-11;3358;3430;260034;124293;46.1;22.0
51;2021-06-12;2165;2170;262199;126463;46.5;22.4
51;2021-06-13;191;149;262390;126612;46.5;22.5
51;2021-06-14;1627;3331;264017;129943;46.8;23.0
51;2021-06-15;3189;3577;267206;133520;47.4;23.7
51;2021-06-16;2208;3685;269414;137205;47.8;24.3
51;2021-06-17;2609;5402;272023;142607;48.2;25.3
51;2021-06-18;2355;5212;274378;147819;48.7;26.2
51;2021-06-19;1683;4425;276061;152244;49.0;27.0
51;2021-06-20;184;228;276245;152472;49.0;27.0
51;2021-06-21;1230;4440;277475;156912;49.2;27.8
51;2021-06-22;1558;4044;279033;160956;49.5;28.5
51;2021-06-23;3670;4239;282703;165195;50.1;29.3
51;2021-06-24;2246;3226;284949;168421;50.5;29.9
51;2021-06-25;1905;6526;286854;174947;50.9;31.0
51;2021-06-26;1203;5065;288057;180012;51.1;31.9
51;2021-06-27;103;336;288160;180348;51.1;32.0
51;2021-06-28;1402;4413;289562;184761;51.4;32.8
51;2021-06-29;1174;4463;290736;189224;51.6;33.6
51;2021-06-30;1685;6044;292421;195268;51.9;34.6
51;2021-07-01;1978;3764;294399;199032;52.2;35.3
51;2021-07-02;1838;6887;296237;205919;52.5;36.5
51;2021-07-03;1003;3198;297240;209117;52.7;37.1
51;2021-07-04;171;254;297411;209371;52.7;37.1
51;2021-07-05;771;5530;298182;214901;52.9;38.1
51;2021-07-06;1246;4781;299428;219682;53.1;39.0
51;2021-07-07;1617;4935;301045;224617;53.4;39.8
51;2021-07-08;2067;3431;303112;228048;53.8;40.4
51;2021-07-09;1854;5056;304966;233104;54.1;41.3
51;2021-07-10;1238;3204;306204;236308;54.3;41.9
51;2021-07-11;190;280;306394;236588;54.3;42.0
51;2021-07-12;996;4379;307390;240967;54.5;42.7
51;2021-07-13;1481;4776;308871;245743;54.8;43.6
51;2021-07-14;1071;1691;309942;247434;55.0;43.9
51;2021-07-15;2938;4915;312880;252349;55.5;44.8
51;2021-07-16;2367;5275;315247;257624;55.9;45.7
51;2021-07-17;1821;3481;317068;261105;56.2;46.3
51;2021-07-18;163;331;317231;261436;56.3;46.4
51;2021-07-19;1892;3979;319123;265415;56.6;47.1
51;2021-07-20;2585;5144;321708;270559;57.1;48.0
51;2021-07-21;3611;4070;325319;274629;57.7;48.7
51;2021-07-22;4412;3758;329731;278387;58.5;49.4
51;2021-07-23;3641;4381;333372;282768;59.1;50.2
51;2021-07-24;2085;2726;335457;285494;59.5;50.6
51;2021-07-25;356;258;335813;285752;59.6;50.7
51;2021-07-26;3113;2809;338926;288561;60.1;51.2
51;2021-07-27;5864;3277;344790;291838;61.2;51.8
51;2021-07-28;4139;4321;348929;296159;61.9;52.5
51;2021-07-29;4701;2723;353630;298882;62.7;53.0
51;2021-07-30;3628;3163;357258;302045;63.4;53.6
51;2021-07-31;2526;2132;359784;304177;63.8;53.9
51;2021-08-01;375;236;360159;304413;63.9;54.0
51;2021-08-02;3287;2310;363446;306723;64.5;54.4
51;2021-08-03;3776;1914;367222;308637;65.1;54.7
51;2021-08-04;4450;2126;371672;310763;65.9;55.1
51;2021-08-05;2655;1536;374327;312299;66.4;55.4
51;2021-08-06;3043;2552;377370;314851;66.9;55.8
51;2021-08-07;2161;1701;379531;316552;67.3;56.1
51;2021-08-08;368;208;379899;316760;67.4;56.2
51;2021-08-09;2604;1852;382503;318612;67.8;56.5
51;2021-08-10;2372;1984;384875;320596;68.3;56.9
51;2021-08-11;2918;2342;387793;322938;68.8;57.3
51;2021-08-12;1754;1957;389547;324895;69.1;57.6
51;2021-08-13;2067;2670;391614;327565;69.5;58.1
51;2021-08-14;1583;2027;393197;329592;69.7;58.5
51;2021-08-15;149;150;393346;329742;69.8;58.5
51;2021-08-16;1355;3015;394701;332757;70.0;59.0
51;2021-08-17;1563;3283;396264;336040;70.3;59.6
51;2021-08-18;1900;3693;398164;339733;70.6;60.3
51;2021-08-19;1419;2549;399583;342282;70.9;60.7
51;2021-08-20;1719;3974;401302;346256;71.2;61.4
51;2021-08-21;988;2497;402290;348753;71.4;61.9
51;2021-08-22;101;343;402391;349096;71.4;61.9
51;2021-08-23;1114;3607;403505;352703;71.6;62.6
51;2021-08-24;1179;3644;404684;356347;71.8;63.2
51;2021-08-25;1323;4488;406007;360835;72.0;64.0
51;2021-08-26;1058;2548;407065;363383;72.2;64.4
51;2021-08-27;1214;4178;408279;367561;72.4;65.2
51;2021-08-28;655;2632;408934;370193;72.5;65.7
51;2021-08-29;84;360;409018;370553;72.5;65.7
51;2021-08-30;1332;4788;410350;375341;72.8;66.6
51;2021-08-31;779;2917;411129;378258;72.9;67.1
51;2021-09-01;739;3217;411868;381475;73.0;67.7
51;2021-09-02;801;2048;412669;383523;73.2;68.0
51;2021-09-03;905;2628;413574;386151;73.4;68.5
51;2021-09-04;622;2706;414196;388857;73.5;69.0
51;2021-09-05;122;194;414318;389051;73.5;69.0
51;2021-09-06;437;1509;414755;390560;73.6;69.3
51;2021-09-07;519;1256;415274;391816;73.7;69.5
51;2021-09-08;628;1925;415902;393741;73.8;69.8
51;2021-09-09;470;1190;416372;394931;73.8;70.0
51;2021-09-10;672;1787;417044;396718;74.0;70.4
51;2021-09-11;562;1828;417606;398546;74.1;70.7
51;2021-09-12;19;79;417625;398625;74.1;70.7
51;2021-09-13;427;851;418052;399476;74.1;70.9
51;2021-09-14;595;873;418647;400349;74.3;71.0
51;2021-09-15;495;1426;419142;401775;74.3;71.3
51;2021-09-16;307;658;419449;402433;74.4;71.4
51;2021-09-17;555;1130;420004;403563;74.5;71.6
51;2021-09-18;470;1421;420474;404984;74.6;71.8
51;2021-09-19;14;64;420488;405048;74.6;71.8
51;2021-09-20;282;539;420770;405587;74.6;71.9
51;2021-09-21;257;490;421027;406077;74.7;72.0
51;2021-09-22;319;1353;421346;407430;74.7;72.3
51;2021-09-23;196;602;421542;408032;74.8;72.4
51;2021-09-24;366;978;421908;409010;74.8;72.5
51;2021-09-25;283;985;422191;409995;74.9;72.7
51;2021-09-26;7;129;422198;410124;74.9;72.7
51;2021-09-27;264;448;422462;410572;74.9;72.8
51;2021-09-28;299;363;422761;410935;75.0;72.9
51;2021-09-29;348;778;423109;411713;75.0;73.0
51;2021-09-30;265;419;423374;412132;75.1;73.1
51;2021-10-01;355;717;423729;412849;75.2;73.2
51;2021-10-02;370;761;424099;413610;75.2;73.4
51;2021-10-03;0;1;424099;413611;75.2;73.4
51;2021-10-04;182;446;424281;414057;75.3;73.4
51;2021-10-05;205;434;424486;414491;75.3;73.5
51;2021-10-06;315;554;424801;415045;75.3;73.6
51;2021-10-07;163;368;424964;415413;75.4;73.7
51;2021-10-08;313;591;425277;416004;75.4;73.8
51;2021-10-09;322;604;425599;416608;75.5;73.9
51;2021-10-10;2;2;425601;416610;75.5;73.9
51;2021-10-11;174;304;425775;416914;75.5;73.9
51;2021-10-12;157;372;425932;417286;75.5;74.0
51;2021-10-13;292;435;426224;417721;75.6;74.1
51;2021-10-14;158;201;426382;417922;75.6;74.1
51;2021-10-15;364;548;426746;418470;75.7;74.2
51;2021-10-16;302;349;427048;418819;75.7;74.3
51;2021-10-17;0;1;427048;418820;75.7;74.3
51;2021-10-18;120;270;427168;419090;75.8;74.3
51;2021-10-19;146;302;427314;419392;75.8;74.4
52;2020-12-27;0;0;0;0;0.0;0.0
52;2020-12-28;1;0;1;0;0.0;0.0
52;2020-12-29;0;0;1;0;0.0;0.0
52;2020-12-30;0;0;1;0;0.0;0.0
52;2020-12-31;0;0;1;0;0.0;0.0
52;2021-01-01;0;0;1;0;0.0;0.0
52;2021-01-02;1;0;2;0;0.0;0.0
52;2021-01-03;0;0;2;0;0.0;0.0
52;2021-01-04;0;0;2;0;0.0;0.0
52;2021-01-05;0;0;2;0;0.0;0.0
52;2021-01-06;2;0;4;0;0.0;0.0
52;2021-01-07;0;0;4;0;0.0;0.0
52;2021-01-08;200;1;204;1;0.1;0.0
52;2021-01-09;93;0;297;1;0.2;0.0
52;2021-01-10;0;0;297;1;0.2;0.0
52;2021-01-11;207;0;504;1;0.3;0.0
52;2021-01-12;171;0;675;1;0.4;0.0
52;2021-01-13;563;3;1238;4;0.7;0.0
52;2021-01-14;677;11;1915;15;1.1;0.0
52;2021-01-15;411;1;2326;16;1.4;0.0
52;2021-01-16;16;1;2342;17;1.4;0.0
52;2021-01-17;0;0;2342;17;1.4;0.0
52;2021-01-18;427;0;2769;17;1.6;0.0
52;2021-01-19;440;1;3209;18;1.9;0.0
52;2021-01-20;422;0;3631;18;2.1;0.0
52;2021-01-21;423;2;4054;20;2.4;0.0
52;2021-01-22;320;2;4374;22;2.6;0.0
52;2021-01-23;73;2;4447;24;2.6;0.0
52;2021-01-24;0;0;4447;24;2.6;0.0
52;2021-01-25;236;0;4683;24;2.8;0.0
52;2021-01-26;308;0;4991;24;2.9;0.0
52;2021-01-27;238;1;5229;25;3.1;0.0
52;2021-01-28;176;4;5405;29;3.2;0.0
52;2021-01-29;74;122;5479;151;3.2;0.1
52;2021-01-30;91;95;5570;246;3.3;0.1
52;2021-01-31;0;0;5570;246;3.3;0.1
52;2021-02-01;117;189;5687;435;3.4;0.3
52;2021-02-02;61;176;5748;611;3.4;0.4
52;2021-02-03;89;410;5837;1021;3.4;0.6
52;2021-02-04;231;592;6068;1613;3.6;1.0
52;2021-02-05;113;505;6181;2118;3.7;1.3
52;2021-02-06;22;0;6203;2118;3.7;1.3
52;2021-02-07;0;1;6203;2119;3.7;1.3
52;2021-02-08;34;208;6237;2327;3.7;1.4
52;2021-02-09;47;216;6284;2543;3.7;1.5
52;2021-02-10;88;189;6372;2732;3.8;1.6
52;2021-02-11;129;148;6501;2880;3.8;1.7
52;2021-02-12;187;128;6688;3008;4.0;1.8
52;2021-02-13;5;1;6693;3009;4.0;1.8
52;2021-02-14;0;16;6693;3025;4.0;1.8
52;2021-02-15;79;277;6772;3302;4.0;2.0
52;2021-02-16;50;358;6822;3660;4.0;2.2
52;2021-02-17;38;313;6860;3973;4.1;2.3
52;2021-02-18;82;279;6942;4252;4.1;2.5
52;2021-02-19;50;192;6992;4444;4.1;2.6
52;2021-02-20;14;106;7006;4550;4.1;2.7
52;2021-02-21;0;0;7006;4550;4.1;2.7
52;2021-02-22;42;382;7048;4932;4.2;2.9
52;2021-02-23;56;278;7104;5210;4.2;3.1
52;2021-02-24;81;246;7185;5456;4.2;3.2
52;2021-02-25;161;238;7346;5694;4.3;3.4
52;2021-02-26;296;182;7642;5876;4.5;3.5
52;2021-02-27;149;49;7791;5925;4.6;3.5
52;2021-02-28;0;0;7791;5925;4.6;3.5
52;2021-03-01;162;14;7953;5939;4.7;3.5
52;2021-03-02;255;52;8208;5991;4.8;3.5
52;2021-03-03;356;38;8564;6029;5.1;3.6
52;2021-03-04;381;58;8945;6087;5.3;3.6
52;2021-03-05;531;54;9476;6141;5.6;3.6
52;2021-03-06;409;36;9885;6177;5.8;3.6
52;2021-03-07;0;0;9885;6177;5.8;3.6
52;2021-03-08;398;112;10283;6289;6.1;3.7
52;2021-03-09;549;111;10832;6400;6.4;3.8
52;2021-03-10;308;109;11140;6509;6.6;3.8
52;2021-03-11;587;36;11727;6545;6.9;3.9
52;2021-03-12;606;70;12333;6615;7.3;3.9
52;2021-03-13;494;12;12827;6627;7.6;3.9
52;2021-03-14;15;3;12842;6630;7.6;3.9
52;2021-03-15;318;28;13160;6658;7.8;3.9
52;2021-03-16;203;16;13363;6674;7.9;3.9
52;2021-03-17;369;16;13732;6690;8.1;4.0
52;2021-03-18;442;12;14174;6702;8.4;4.0
52;2021-03-19;456;55;14630;6757;8.6;4.0
52;2021-03-20;259;12;14889;6769;8.8;4.0
52;2021-03-21;15;1;14904;6770;8.8;4.0
52;2021-03-22;375;49;15279;6819;9.0;4.0
52;2021-03-23;686;153;15965;6972;9.4;4.1
52;2021-03-24;771;74;16736;7046;9.9;4.2
52;2021-03-25;1148;89;17884;7135;10.6;4.2
52;2021-03-26;1038;139;18922;7274;11.2;4.3
52;2021-03-27;477;77;19399;7351;11.5;4.3
52;2021-03-28;53;0;19452;7351;11.5;4.3
52;2021-03-29;507;185;19959;7536;11.8;4.5
52;2021-03-30;868;353;20827;7889;12.3;4.7
52;2021-03-31;956;293;21783;8182;12.9;4.8
52;2021-04-01;1145;183;22928;8365;13.5;4.9
52;2021-04-02;958;111;23886;8476;14.1;5.0
52;2021-04-03;463;3;24349;8479;14.4;5.0
52;2021-04-04;1;1;24350;8480;14.4;5.0
52;2021-04-05;1;0;24351;8480;14.4;5.0
52;2021-04-06;434;296;24785;8776;14.6;5.2
52;2021-04-07;506;451;25291;9227;14.9;5.5
52;2021-04-08;861;212;26152;9439;15.5;5.6
52;2021-04-09;1059;131;27211;9570;16.1;5.7
52;2021-04-10;850;102;28061;9672;16.6;5.7
52;2021-04-11;96;1;28157;9673;16.6;5.7
52;2021-04-12;933;282;29090;9955;17.2;5.9
52;2021-04-13;1251;382;30341;10337;17.9;6.1
52;2021-04-14;1347;461;31688;10798;18.7;6.4
52;2021-04-15;1505;444;33193;11242;19.6;6.6
52;2021-04-16;1571;380;34764;11622;20.5;6.9
52;2021-04-17;1314;137;36078;11759;21.3;6.9
52;2021-04-18;510;29;36588;11788;21.6;7.0
52;2021-04-19;697;612;37285;12400;22.0;7.3
52;2021-04-20;1079;679;38364;13079;22.7;7.7
52;2021-04-21;1058;675;39422;13754;23.3;8.1
52;2021-04-22;1468;739;40890;14493;24.2;8.6
52;2021-04-23;1250;673;42140;15166;24.9;9.0
52;2021-04-24;477;294;42617;15460;25.2;9.1
52;2021-04-25;3;77;42620;15537;25.2;9.2
52;2021-04-26;631;565;43251;16102;25.6;9.5
52;2021-04-27;932;673;44183;16775;26.1;9.9
52;2021-04-28;1444;571;45627;17346;27.0;10.2
52;2021-04-29;1452;583;47079;17929;27.8;10.6
52;2021-04-30;1316;618;48395;18547;28.6;11.0
52;2021-05-01;8;232;48403;18779;28.6;11.1
52;2021-05-02;0;1;48403;18780;28.6;11.1
52;2021-05-03;1159;630;49562;19410;29.3;11.5
52;2021-05-04;1445;723;51007;20133;30.1;11.9
52;2021-05-05;1767;648;52774;20781;31.2;12.3
52;2021-05-06;1962;537;54736;21318;32.3;12.6
52;2021-05-07;1441;1170;56177;22488;33.2;13.3
52;2021-05-08;587;318;56764;22806;33.5;13.5
52;2021-05-09;1;47;56765;22853;33.5;13.5
52;2021-05-10;792;1101;57557;23954;34.0;14.2
52;2021-05-11;868;1391;58425;25345;34.5;15.0
52;2021-05-12;1206;1382;59631;26727;35.2;15.8
52;2021-05-13;67;184;59698;26911;35.3;15.9
52;2021-05-14;1185;1366;60883;28277;36.0;16.7
52;2021-05-15;492;929;61375;29206;36.3;17.3
52;2021-05-16;8;43;61383;29249;36.3;17.3
52;2021-05-17;1142;705;62525;29954;36.9;17.7
52;2021-05-18;1218;677;63743;30631;37.7;18.1
52;2021-05-19;1541;415;65284;31046;38.6;18.3
52;2021-05-20;1546;422;66830;31468;39.5;18.6
52;2021-05-21;1625;611;68455;32079;40.4;19.0
52;2021-05-22;1089;210;69544;32289;41.1;19.1
52;2021-05-23;1;0;69545;32289;41.1;19.1
52;2021-05-24;405;33;69950;32322;41.3;19.1
52;2021-05-25;1352;385;71302;32707;42.1;19.3
52;2021-05-26;1476;672;72778;33379;43.0;19.7
52;2021-05-27;1564;787;74342;34166;43.9;20.2
52;2021-05-28;1494;673;75836;34839;44.8;20.6
52;2021-05-29;695;834;76531;35673;45.2;21.1
52;2021-05-30;16;551;76547;36224;45.2;21.4
52;2021-05-31;825;829;77372;37053;45.7;21.9
52;2021-06-01;956;816;78328;37869;46.3;22.4
52;2021-06-02;896;754;79224;38623;46.8;22.8
52;2021-06-03;825;825;80049;39448;47.3;23.3
52;2021-06-04;883;1340;80932;40788;47.8;24.1
52;2021-06-05;581;637;81513;41425;48.2;24.5
52;2021-06-06;27;55;81540;41480;48.2;24.5
52;2021-06-07;359;931;81899;42411;48.4;25.1
52;2021-06-08;556;1471;82455;43882;48.7;25.9
52;2021-06-09;611;1474;83066;45356;49.1;26.8
52;2021-06-10;794;1159;83860;46515;49.5;27.5
52;2021-06-11;832;1348;84692;47863;50.0;28.3
52;2021-06-12;423;586;85115;48449;50.3;28.6
52;2021-06-13;2;6;85117;48455;50.3;28.6
52;2021-06-14;170;1413;85287;49868;50.4;29.5
52;2021-06-15;221;1807;85508;51675;50.5;30.5
52;2021-06-16;351;1996;85859;53671;50.7;31.7
52;2021-06-17;265;1156;86124;54827;50.9;32.4
52;2021-06-18;308;1553;86432;56380;51.1;33.3
52;2021-06-19;502;690;86934;57070;51.4;33.7
52;2021-06-20;1;17;86935;57087;51.4;33.7
52;2021-06-21;523;898;87458;57985;51.7;34.3
52;2021-06-22;503;1047;87961;59032;52.0;34.9
52;2021-06-23;563;1041;88524;60073;52.3;35.5
52;2021-06-24;610;715;89134;60788;52.7;35.9
52;2021-06-25;661;1314;89795;62102;53.1;36.7
52;2021-06-26;264;722;90059;62824;53.2;37.1
52;2021-06-27;1;8;90060;62832;53.2;37.1
52;2021-06-28;184;1442;90244;64274;53.3;38.0
52;2021-06-29;163;1414;90407;65688;53.4;38.8
52;2021-06-30;221;1468;90628;67156;53.5;39.7
52;2021-07-01;320;1020;90948;68176;53.7;40.3
52;2021-07-02;430;1454;91378;69630;54.0;41.1
52;2021-07-03;302;1148;91680;70778;54.2;41.8
52;2021-07-04;0;11;91680;70789;54.2;41.8
52;2021-07-05;175;1448;91855;72237;54.3;42.7
52;2021-07-06;284;1449;92139;73686;54.4;43.5
52;2021-07-07;309;1163;92448;74849;54.6;44.2
52;2021-07-08;473;1166;92921;76015;54.9;44.9
52;2021-07-09;288;1620;93209;77635;55.1;45.9
52;2021-07-10;155;822;93364;78457;55.2;46.4
52;2021-07-11;13;12;93377;78469;55.2;46.4
52;2021-07-12;299;1467;93676;79936;55.3;47.2
52;2021-07-13;590;1369;94266;81305;55.7;48.0
52;2021-07-14;437;153;94703;81458;56.0;48.1
52;2021-07-15;614;1428;95317;82886;56.3;49.0
52;2021-07-16;899;1339;96216;84225;56.8;49.8
52;2021-07-17;530;343;96746;84568;57.2;50.0
52;2021-07-18;3;12;96749;84580;57.2;50.0
52;2021-07-19;691;987;97440;85567;57.6;50.6
52;2021-07-20;1110;831;98550;86398;58.2;51.0
52;2021-07-21;1161;738;99711;87136;58.9;51.5
52;2021-07-22;1447;869;101158;88005;59.8;52.0
52;2021-07-23;1399;956;102557;88961;60.6;52.6
52;2021-07-24;873;487;103430;89448;61.1;52.8
52;2021-07-25;22;21;103452;89469;61.1;52.9
52;2021-07-26;1010;614;104462;90083;61.7;53.2
52;2021-07-27;1342;658;105804;90741;62.5;53.6
52;2021-07-28;1382;644;107186;91385;63.3;54.0
52;2021-07-29;1263;622;108449;92007;64.1;54.4
52;2021-07-30;1365;713;109814;92720;64.9;54.8
52;2021-07-31;873;549;110687;93269;65.4;55.1
52;2021-08-01;1;14;110688;93283;65.4;55.1
52;2021-08-02;1185;561;111873;93844;66.1;55.4
52;2021-08-03;1363;541;113236;94385;66.9;55.8
52;2021-08-04;1158;579;114394;94964;67.6;56.1
52;2021-08-05;1026;574;115420;95538;68.2;56.4
52;2021-08-06;1057;698;116477;96236;68.8;56.9
52;2021-08-07;519;422;116996;96658;69.1;57.1
52;2021-08-08;0;6;116996;96664;69.1;57.1
52;2021-08-09;469;871;117465;97535;69.4;57.6
52;2021-08-10;717;748;118182;98283;69.8;58.1
52;2021-08-11;535;837;118717;99120;70.1;58.6
52;2021-08-12;623;750;119340;99870;70.5;59.0
52;2021-08-13;420;1029;119760;100899;70.8;59.6
52;2021-08-14;421;360;120181;101259;71.0;59.8
52;2021-08-15;13;13;120194;101272;71.0;59.8
52;2021-08-16;327;934;120521;102206;71.2;60.4
52;2021-08-17;416;911;120937;103117;71.5;60.9
52;2021-08-18;489;944;121426;104061;71.7;61.5
52;2021-08-19;461;836;121887;104897;72.0;62.0
52;2021-08-20;385;1210;122272;106107;72.2;62.7
52;2021-08-21;394;605;122666;106712;72.5;63.0
52;2021-08-22;5;11;122671;106723;72.5;63.1
52;2021-08-23;431;1058;123102;107781;72.7;63.7
52;2021-08-24;307;1077;123409;108858;72.9;64.3
52;2021-08-25;254;1061;123663;109919;73.1;64.9
52;2021-08-26;303;914;123966;110833;73.2;65.5
52;2021-08-27;429;1276;124395;112109;73.5;66.2
52;2021-08-28;243;495;124638;112604;73.6;66.5
52;2021-08-29;3;25;124641;112629;73.6;66.5
52;2021-08-30;204;977;124845;113606;73.8;67.1
52;2021-08-31;205;1034;125050;114640;73.9;67.7
52;2021-09-01;183;1040;125233;115680;74.0;68.3
52;2021-09-02;194;698;125427;116378;74.1;68.8
52;2021-09-03;243;857;125670;117235;74.3;69.3
52;2021-09-04;189;527;125859;117762;74.4;69.6
52;2021-09-05;2;12;125861;117774;74.4;69.6
52;2021-09-06;126;511;125987;118285;74.4;69.9
52;2021-09-07;163;420;126150;118705;74.5;70.1
52;2021-09-08;143;571;126293;119276;74.6;70.5
52;2021-09-09;141;362;126434;119638;74.7;70.7
52;2021-09-10;256;640;126690;120278;74.9;71.1
52;2021-09-11;151;292;126841;120570;74.9;71.2
52;2021-09-12;2;9;126843;120579;74.9;71.2
52;2021-09-13;176;494;127019;121073;75.0;71.5
52;2021-09-14;146;325;127165;121398;75.1;71.7
52;2021-09-15;150;448;127315;121846;75.2;72.0
52;2021-09-16;138;309;127453;122155;75.3;72.2
52;2021-09-17;233;544;127686;122699;75.4;72.5
52;2021-09-18;135;243;127821;122942;75.5;72.6
52;2021-09-19;4;18;127825;122960;75.5;72.6
52;2021-09-20;106;355;127931;123315;75.6;72.9
52;2021-09-21;97;207;128028;123522;75.6;73.0
52;2021-09-22;107;320;128135;123842;75.7;73.2
52;2021-09-23;140;207;128275;124049;75.8;73.3
52;2021-09-24;128;284;128403;124333;75.9;73.5
52;2021-09-25;93;250;128496;124583;75.9;73.6
52;2021-09-26;0;0;128496;124583;75.9;73.6
52;2021-09-27;121;181;128617;124764;76.0;73.7
52;2021-09-28;120;144;128737;124908;76.1;73.8
52;2021-09-29;93;207;128830;125115;76.1;73.9
52;2021-09-30;117;125;128947;125240;76.2;74.0
52;2021-10-01;117;226;129064;125466;76.3;74.1
52;2021-10-02;63;150;129127;125616;76.3;74.2
52;2021-10-03;0;6;129127;125622;76.3;74.2
52;2021-10-04;83;179;129210;125801;76.3;74.3
52;2021-10-05;57;133;129267;125934;76.4;74.4
52;2021-10-06;120;172;129387;126106;76.4;74.5
52;2021-10-07;54;101;129441;126207;76.5;74.6
52;2021-10-08;112;225;129553;126432;76.5;74.7
52;2021-10-09;66;132;129619;126564;76.6;74.8
52;2021-10-10;2;1;129621;126565;76.6;74.8
52;2021-10-11;43;164;129664;126729;76.6;74.9
52;2021-10-12;65;117;129729;126846;76.6;74.9
52;2021-10-13;70;102;129799;126948;76.7;75.0
52;2021-10-14;40;58;129839;127006;76.7;75.0
52;2021-10-15;79;254;129918;127260;76.8;75.2
52;2021-10-16;64;93;129982;127353;76.8;75.2
52;2021-10-17;0;0;129982;127353;76.8;75.2
52;2021-10-18;46;187;130028;127540;76.8;75.4
52;2021-10-19;54;108;130082;127648;76.9;75.4
53;2020-12-27;0;0;0;0;0.0;0.0
53;2020-12-28;0;0;0;0;0.0;0.0
53;2020-12-29;0;0;0;0;0.0;0.0
53;2020-12-30;0;0;0;0;0.0;0.0
53;2020-12-31;0;0;0;0;0.0;0.0
53;2021-01-01;0;0;0;0;0.0;0.0
53;2021-01-02;3;1;3;1;0.0;0.0
53;2021-01-03;0;0;3;1;0.0;0.0
53;2021-01-04;1;0;4;1;0.0;0.0
53;2021-01-05;0;0;4;1;0.0;0.0
53;2021-01-06;0;0;4;1;0.0;0.0
53;2021-01-07;102;0;106;1;0.0;0.0
53;2021-01-08;284;1;390;2;0.1;0.0
53;2021-01-09;134;1;524;3;0.2;0.0
53;2021-01-10;15;0;539;3;0.2;0.0
53;2021-01-11;176;1;715;4;0.2;0.0
53;2021-01-12;456;1;1171;5;0.4;0.0
53;2021-01-13;254;0;1425;5;0.5;0.0
53;2021-01-14;290;7;1715;12;0.6;0.0
53;2021-01-15;343;4;2058;16;0.7;0.0
53;2021-01-16;60;0;2118;16;0.7;0.0
53;2021-01-17;25;2;2143;18;0.7;0.0
53;2021-01-18;364;0;2507;18;0.8;0.0
53;2021-01-19;594;0;3101;18;1.0;0.0
53;2021-01-20;742;0;3843;18;1.3;0.0
53;2021-01-21;773;3;4616;21;1.5;0.0
53;2021-01-22;703;10;5319;31;1.7;0.0
53;2021-01-23;161;1;5480;32;1.8;0.0
53;2021-01-24;6;0;5486;32;1.8;0.0
53;2021-01-25;550;0;6036;32;2.0;0.0
53;2021-01-26;1199;7;7235;39;2.4;0.0
53;2021-01-27;696;6;7931;45;2.6;0.0
53;2021-01-28;737;97;8668;142;2.8;0.0
53;2021-01-29;422;187;9090;329;3.0;0.1
53;2021-01-30;130;0;9220;329;3.0;0.1
53;2021-01-31;0;0;9220;329;3.0;0.1
53;2021-02-01;298;149;9518;478;3.1;0.2
53;2021-02-02;309;232;9827;710;3.2;0.2
53;2021-02-03;228;377;10055;1087;3.3;0.4
53;2021-02-04;184;332;10239;1419;3.4;0.5
53;2021-02-05;234;303;10473;1722;3.4;0.6
53;2021-02-06;153;23;10626;1745;3.5;0.6
53;2021-02-07;0;0;10626;1745;3.5;0.6
53;2021-02-08;168;106;10794;1851;3.5;0.6
53;2021-02-09;369;216;11163;2067;3.7;0.7
53;2021-02-10;266;433;11429;2500;3.7;0.8
53;2021-02-11;433;491;11862;2991;3.9;1.0
53;2021-02-12;318;572;12180;3563;4.0;1.2
53;2021-02-13;96;66;12276;3629;4.0;1.2
53;2021-02-14;0;99;12276;3728;4.0;1.2
53;2021-02-15;240;431;12516;4159;4.1;1.4
53;2021-02-16;527;840;13043;4999;4.3;1.6
53;2021-02-17;391;614;13434;5613;4.4;1.8
53;2021-02-18;546;578;13980;6191;4.6;2.0
53;2021-02-19;895;429;14875;6620;4.9;2.2
53;2021-02-20;139;113;15014;6733;4.9;2.2
53;2021-02-21;1;20;15015;6753;4.9;2.2
53;2021-02-22;161;584;15176;7337;5.0;2.4
53;2021-02-23;59;655;15235;7992;5.0;2.6
53;2021-02-24;137;517;15372;8509;5.0;2.8
53;2021-02-25;457;360;15829;8869;5.2;2.9
53;2021-02-26;437;262;16266;9131;5.3;3.0
53;2021-02-27;86;115;16352;9246;5.4;3.0
53;2021-02-28;0;0;16352;9246;5.4;3.0
53;2021-03-01;230;277;16582;9523;5.4;3.1
53;2021-03-02;246;255;16828;9778;5.5;3.2
53;2021-03-03;322;394;17150;10172;5.6;3.3
53;2021-03-04;859;347;18009;10519;5.9;3.4
53;2021-03-05;660;281;18669;10800;6.1;3.5
53;2021-03-06;447;212;19116;11012;6.3;3.6
53;2021-03-07;276;5;19392;11017;6.4;3.6
53;2021-03-08;375;182;19767;11199;6.5;3.7
53;2021-03-09;878;249;20645;11448;6.8;3.7
53;2021-03-10;807;111;21452;11559;7.0;3.8
53;2021-03-11;1247;229;22699;11788;7.4;3.9
53;2021-03-12;1604;149;24303;11937;8.0;3.9
53;2021-03-13;824;16;25127;11953;8.2;3.9
53;2021-03-14;1;0;25128;11953;8.2;3.9
53;2021-03-15;1001;301;26129;12254;8.6;4.0
53;2021-03-16;1035;332;27164;12586;8.9;4.1
53;2021-03-17;687;261;27851;12847;9.1;4.2
53;2021-03-18;972;345;28823;13192;9.4;4.3
53;2021-03-19;1346;600;30169;13792;9.9;4.5
53;2021-03-20;592;17;30761;13809;10.1;4.5
53;2021-03-21;3;1;30764;13810;10.1;4.5
53;2021-03-22;1214;159;31978;13969;10.5;4.6
53;2021-03-23;1699;72;33677;14041;11.0;4.6
53;2021-03-24;1323;118;35000;14159;11.5;4.6
53;2021-03-25;2322;245;37322;14404;12.2;4.7
53;2021-03-26;1882;153;39204;14557;12.8;4.8
53;2021-03-27;339;3;39543;14560;12.9;4.8
53;2021-03-28;2;0;39545;14560;13.0;4.8
53;2021-03-29;1474;213;41019;14773;13.4;4.8
53;2021-03-30;1944;205;42963;14978;14.1;4.9
53;2021-03-31;1791;224;44754;15202;14.7;5.0
53;2021-04-01;1948;675;46702;15877;15.3;5.2
53;2021-04-02;2075;230;48777;16107;16.0;5.3
53;2021-04-03;414;2;49191;16109;16.1;5.3
53;2021-04-04;11;0;49202;16109;16.1;5.3
53;2021-04-05;9;15;49211;16124;16.1;5.3
53;2021-04-06;1305;507;50516;16631;16.5;5.4
53;2021-04-07;1172;927;51688;17558;16.9;5.7
53;2021-04-08;1663;1010;53351;18568;17.5;6.1
53;2021-04-09;1959;408;55310;18976;18.1;6.2
53;2021-04-10;543;13;55853;18989;18.3;6.2
53;2021-04-11;13;0;55866;18989;18.3;6.2
53;2021-04-12;694;1069;56560;20058;18.5;6.6
53;2021-04-13;1470;1111;58030;21169;19.0;6.9
53;2021-04-14;1021;738;59051;21907;19.3;7.2
53;2021-04-15;1156;1108;60207;23015;19.7;7.5
53;2021-04-16;1271;815;61478;23830;20.1;7.8
53;2021-04-17;279;274;61757;24104;20.2;7.9
53;2021-04-18;0;0;61757;24104;20.2;7.9
53;2021-04-19;681;1068;62438;25172;20.4;8.2
53;2021-04-20;936;1453;63374;26625;20.8;8.7
53;2021-04-21;852;1014;64226;27639;21.0;9.1
53;2021-04-22;1045;1617;65271;29256;21.4;9.6
53;2021-04-23;1329;1055;66600;30311;21.8;9.9
53;2021-04-24;68;7;66668;30318;21.8;9.9
53;2021-04-25;6;39;66674;30357;21.8;9.9
53;2021-04-26;368;1238;67042;31595;22.0;10.3
53;2021-04-27;723;1975;67765;33570;22.2;11.0
53;2021-04-28;977;1392;68742;34962;22.5;11.4
53;2021-04-29;1052;1714;69794;36676;22.9;12.0
53;2021-04-30;1366;1316;71160;37992;23.3;12.4
53;2021-05-01;36;51;71196;38043;23.3;12.5
53;2021-05-02;0;0;71196;38043;23.3;12.5
53;2021-05-03;1570;709;72766;38752;23.8;12.7
53;2021-05-04;1303;1442;74069;40194;24.3;13.2
53;2021-05-05;1611;827;75680;41021;24.8;13.4
53;2021-05-06;1390;1404;77070;42425;25.2;13.9
53;2021-05-07;1537;1307;78607;43732;25.7;14.3
53;2021-05-08;939;36;79546;43768;26.0;14.3
53;2021-05-09;11;2;79557;43770;26.1;14.3
53;2021-05-10;2414;815;81971;44585;26.8;14.6
53;2021-05-11;3097;1288;85068;45873;27.9;15.0
53;2021-05-12;2751;1094;87819;46967;28.8;15.4
53;2021-05-13;350;27;88169;46994;28.9;15.4
53;2021-05-14;2021;678;90190;47672;29.5;15.6
53;2021-05-15;1058;63;91248;47735;29.9;15.6
53;2021-05-16;3;0;91251;47735;29.9;15.6
53;2021-05-17;1701;1196;92952;48931;30.4;16.0
53;2021-05-18;1880;1551;94832;50482;31.1;16.5
53;2021-05-19;2302;748;97134;51230;31.8;16.8
53;2021-05-20;3216;867;100350;52097;32.9;17.1
53;2021-05-21;2798;829;103148;52926;33.8;17.3
53;2021-05-22;21;60;103169;52986;33.8;17.4
53;2021-05-23;1;0;103170;52986;33.8;17.4
53;2021-05-24;8;6;103178;52992;33.8;17.4
53;2021-05-25;1820;803;104998;53795;34.4;17.6
53;2021-05-26;1853;908;106851;54703;35.0;17.9
53;2021-05-27;3072;1080;109923;55783;36.0;18.3
53;2021-05-28;2562;884;112485;56667;36.8;18.6
53;2021-05-29;846;244;113331;56911;37.1;18.6
53;2021-05-30;18;6;113349;56917;37.1;18.6
53;2021-05-31;2565;803;115914;57720;38.0;18.9
53;2021-06-01;3489;1258;119403;58978;39.1;19.3
53;2021-06-02;3183;526;122586;59504;40.1;19.5
53;2021-06-03;4198;792;126784;60296;41.5;19.7
53;2021-06-04;3179;1265;129963;61561;42.6;20.2
53;2021-06-05;137;245;130100;61806;42.6;20.2
53;2021-06-06;1;4;130101;61810;42.6;20.2
53;2021-06-07;2629;922;132730;62732;43.5;20.5
53;2021-06-08;3588;1130;136318;63862;44.6;20.9
53;2021-06-09;2455;944;138773;64806;45.4;21.2
53;2021-06-10;3521;848;142294;65654;46.6;21.5
53;2021-06-11;2964;1213;145258;66867;47.6;21.9
53;2021-06-12;108;138;145366;67005;47.6;21.9
53;2021-06-13;10;2;145376;67007;47.6;21.9
53;2021-06-14;1600;1789;146976;68796;48.1;22.5
53;2021-06-15;1898;2265;148874;71061;48.8;23.3
53;2021-06-16;1827;1732;150701;72793;49.4;23.8
53;2021-06-17;3011;1651;153712;74444;50.3;24.4
53;2021-06-18;2705;1808;156417;76252;51.2;25.0
53;2021-06-19;761;1165;157178;77417;51.5;25.4
53;2021-06-20;3;479;157181;77896;51.5;25.5
53;2021-06-21;918;2525;158099;80421;51.8;26.3
53;2021-06-22;1299;3452;159398;83873;52.2;27.5
53;2021-06-23;1362;2892;160760;86765;52.6;28.4
53;2021-06-24;1803;2034;162563;88799;53.2;29.1
53;2021-06-25;1785;2045;164348;90844;53.8;29.7
53;2021-06-26;977;351;165325;91195;54.1;29.9
53;2021-06-27;8;8;165333;91203;54.1;29.9
53;2021-06-28;662;2898;165995;94101;54.4;30.8
53;2021-06-29;858;3648;166853;97749;54.6;32.0
53;2021-06-30;749;1518;167602;99267;54.9;32.5
53;2021-07-01;1507;2630;169109;101897;55.4;33.4
53;2021-07-02;1530;2026;170639;103923;55.9;34.0
53;2021-07-03;858;574;171497;104497;56.2;34.2
53;2021-07-04;0;4;171497;104501;56.2;34.2
53;2021-07-05;542;2058;172039;106559;56.3;34.9
53;2021-07-06;862;3615;172901;110174;56.6;36.1
53;2021-07-07;1026;2652;173927;112826;57.0;36.9
53;2021-07-08;1315;3116;175242;115942;57.4;38.0
53;2021-07-09;1132;3400;176374;119342;57.8;39.1
53;2021-07-10;422;1001;176796;120343;57.9;39.4
53;2021-07-11;12;20;176808;120363;57.9;39.4
53;2021-07-12;504;3707;177312;124070;58.1;40.6
53;2021-07-13;895;4763;178207;128833;58.4;42.2
53;2021-07-14;104;284;178311;129117;58.4;42.3
53;2021-07-15;1112;4346;179423;133463;58.8;43.7
53;2021-07-16;1248;3847;180671;137310;59.2;45.0
53;2021-07-17;1318;300;181989;137610;59.6;45.1
53;2021-07-18;27;20;182016;137630;59.6;45.1
53;2021-07-19;734;3426;182750;141056;59.8;46.2
53;2021-07-20;987;4123;183737;145179;60.2;47.5
53;2021-07-21;686;3274;184423;148453;60.4;48.6
53;2021-07-22;1515;3525;185938;151978;60.9;49.8
53;2021-07-23;1603;3761;187541;155739;61.4;51.0
53;2021-07-24;956;280;188497;156019;61.7;51.1
53;2021-07-25;60;24;188557;156043;61.7;51.1
53;2021-07-26;1727;1941;190284;157984;62.3;51.7
53;2021-07-27;2356;2824;192640;160808;63.1;52.7
53;2021-07-28;2146;2813;194786;163621;63.8;53.6
53;2021-07-29;2491;2546;197277;166167;64.6;54.4
53;2021-07-30;1829;2647;199106;168814;65.2;55.3
53;2021-07-31;626;232;199732;169046;65.4;55.4
53;2021-08-01;37;25;199769;169071;65.4;55.4
53;2021-08-02;2084;1733;201853;170804;66.1;55.9
53;2021-08-03;2417;1905;204270;172709;66.9;56.6
53;2021-08-04;2477;1863;206747;174572;67.7;57.2
53;2021-08-05;2870;1542;209617;176114;68.6;57.7
53;2021-08-06;2517;1721;212134;177835;69.5;58.2
53;2021-08-07;483;272;212617;178107;69.6;58.3
53;2021-08-08;6;19;212623;178126;69.6;58.3
53;2021-08-09;1839;1650;214462;179776;70.2;58.9
53;2021-08-10;2324;1747;216786;181523;71.0;59.4
53;2021-08-11;1681;867;218467;182390;71.5;59.7
53;2021-08-12;2007;984;220474;183374;72.2;60.1
53;2021-08-13;2039;1316;222513;184690;72.9;60.5
53;2021-08-14;66;63;222579;184753;72.9;60.5
53;2021-08-15;1;2;222580;184755;72.9;60.5
53;2021-08-16;1337;1596;223917;186351;73.3;61.0
53;2021-08-17;1548;1658;225465;188009;73.8;61.6
53;2021-08-18;1515;1600;226980;189609;74.3;62.1
53;2021-08-19;1375;1973;228355;191582;74.8;62.7
53;2021-08-20;1099;2082;229454;193664;75.1;63.4
53;2021-08-21;189;341;229643;194005;75.2;63.5
53;2021-08-22;0;0;229643;194005;75.2;63.5
53;2021-08-23;843;1915;230486;195920;75.5;64.2
53;2021-08-24;903;2117;231389;198037;75.8;64.9
53;2021-08-25;916;2273;232305;200310;76.1;65.6
53;2021-08-26;666;2614;232971;202924;76.3;66.5
53;2021-08-27;754;2645;233725;205569;76.5;67.3
53;2021-08-28;48;133;233773;205702;76.6;67.4
53;2021-08-29;12;31;233785;205733;76.6;67.4
53;2021-08-30;620;2085;234405;207818;76.8;68.1
53;2021-08-31;762;2859;235167;210677;77.0;69.0
53;2021-09-01;342;1544;235509;212221;77.1;69.5
53;2021-09-02;444;1704;235953;213925;77.3;70.1
53;2021-09-03;450;2338;236403;216263;77.4;70.8
53;2021-09-04;115;188;236518;216451;77.5;70.9
53;2021-09-05;1;12;236519;216463;77.5;70.9
53;2021-09-06;301;1468;236820;217931;77.6;71.4
53;2021-09-07;288;1783;237108;219714;77.6;72.0
53;2021-09-08;423;2006;237531;221720;77.8;72.6
53;2021-09-09;237;1351;237768;223071;77.9;73.1
53;2021-09-10;383;1838;238151;224909;78.0;73.7
53;2021-09-11;39;86;238190;224995;78.0;73.7
53;2021-09-12;0;1;238190;224996;78.0;73.7
53;2021-09-13;231;974;238421;225970;78.1;74.0
53;2021-09-14;243;841;238664;226811;78.2;74.3
53;2021-09-15;334;1072;238998;227883;78.3;74.6
53;2021-09-16;306;380;239304;228263;78.4;74.8
53;2021-09-17;432;1057;239736;229320;78.5;75.1
53;2021-09-18;44;70;239780;229390;78.5;75.1
53;2021-09-19;8;14;239788;229404;78.5;75.1
53;2021-09-20;123;382;239911;229786;78.6;75.2
53;2021-09-21;250;651;240161;230437;78.6;75.5
53;2021-09-22;194;665;240355;231102;78.7;75.7
53;2021-09-23;132;395;240487;231497;78.8;75.8
53;2021-09-24;200;639;240687;232136;78.8;76.0
53;2021-09-25;27;50;240714;232186;78.8;76.0
53;2021-09-26;0;0;240714;232186;78.8;76.0
53;2021-09-27;160;374;240874;232560;78.9;76.2
53;2021-09-28;163;282;241037;232842;78.9;76.3
53;2021-09-29;159;488;241196;233330;79.0;76.4
53;2021-09-30;87;213;241283;233543;79.0;76.5
53;2021-10-01;267;621;241550;234164;79.1;76.7
53;2021-10-02;28;52;241578;234216;79.1;76.7
53;2021-10-03;3;7;241581;234223;79.1;76.7
53;2021-10-04;132;277;241713;234500;79.2;76.8
53;2021-10-05;109;210;241822;234710;79.2;76.9
53;2021-10-06;187;345;242009;235055;79.3;77.0
53;2021-10-07;82;287;242091;235342;79.3;77.1
53;2021-10-08;245;541;242336;235883;79.4;77.2
53;2021-10-09;14;27;242350;235910;79.4;77.3
53;2021-10-10;0;0;242350;235910;79.4;77.3
53;2021-10-11;108;159;242458;236069;79.4;77.3
53;2021-10-12;102;230;242560;236299;79.4;77.4
53;2021-10-13;130;229;242690;236528;79.5;77.5
53;2021-10-14;87;110;242777;236638;79.5;77.5
53;2021-10-15;230;386;243007;237024;79.6;77.6
53;2021-10-16;21;42;243028;237066;79.6;77.6
53;2021-10-17;0;1;243028;237067;79.6;77.6
53;2021-10-18;154;189;243182;237256;79.6;77.7
53;2021-10-19;146;192;243328;237448;79.7;77.8
54;2020-12-27;0;0;0;0;0.0;0.0
54;2020-12-28;1;0;1;0;0.0;0.0
54;2020-12-29;0;0;1;0;0.0;0.0
54;2020-12-30;1;0;2;0;0.0;0.0
54;2020-12-31;10;0;12;0;0.0;0.0
54;2021-01-01;0;0;12;0;0.0;0.0
54;2021-01-02;0;0;12;0;0.0;0.0
54;2021-01-03;2;0;14;0;0.0;0.0
54;2021-01-04;163;0;177;0;0.0;0.0
54;2021-01-05;396;2;573;2;0.1;0.0
54;2021-01-06;650;1;1223;3;0.2;0.0
54;2021-01-07;816;2;2039;5;0.3;0.0
54;2021-01-08;706;3;2745;8;0.4;0.0
54;2021-01-09;81;0;2826;8;0.4;0.0
54;2021-01-10;78;0;2904;8;0.4;0.0
54;2021-01-11;974;3;3878;11;0.5;0.0
54;2021-01-12;1182;1;5060;12;0.7;0.0
54;2021-01-13;2428;9;7488;21;1.0;0.0
54;2021-01-14;3403;28;10891;49;1.5;0.0
54;2021-01-15;2718;19;13609;68;1.9;0.0
54;2021-01-16;816;4;14425;72;2.0;0.0
54;2021-01-17;209;0;14634;72;2.0;0.0
54;2021-01-18;1558;7;16192;79;2.2;0.0
54;2021-01-19;1707;2;17899;81;2.5;0.0
54;2021-01-20;1525;5;19424;86;2.7;0.0
54;2021-01-21;1374;5;20798;91;2.8;0.0
54;2021-01-22;1093;8;21891;99;3.0;0.0
54;2021-01-23;477;1;22368;100;3.1;0.0
54;2021-01-24;66;0;22434;100;3.1;0.0
54;2021-01-25;946;35;23380;135;3.2;0.0
54;2021-01-26;142;5;23522;140;3.2;0.0
54;2021-01-27;12;166;23534;306;3.2;0.0
54;2021-01-28;32;229;23566;535;3.2;0.1
54;2021-01-29;19;275;23585;810;3.2;0.1
54;2021-01-30;7;1;23592;811;3.2;0.1
54;2021-01-31;1;0;23593;811;3.2;0.1
54;2021-02-01;13;784;23606;1595;3.2;0.2
54;2021-02-02;25;966;23631;2561;3.2;0.4
54;2021-02-03;364;1530;23995;4091;3.3;0.6
54;2021-02-04;739;2454;24734;6545;3.4;0.9
54;2021-02-05;799;1888;25533;8433;3.5;1.2
54;2021-02-06;205;333;25738;8766;3.5;1.2
54;2021-02-07;4;124;25742;8890;3.5;1.2
54;2021-02-08;117;994;25859;9884;3.5;1.4
54;2021-02-09;306;1067;26165;10951;3.6;1.5
54;2021-02-10;386;795;26551;11746;3.6;1.6
54;2021-02-11;294;813;26845;12559;3.7;1.7
54;2021-02-12;446;1292;27291;13851;3.7;1.9
54;2021-02-13;149;236;27440;14087;3.8;1.9
54;2021-02-14;9;11;27449;14098;3.8;1.9
54;2021-02-15;428;1128;27877;15226;3.8;2.1
54;2021-02-16;401;1222;28278;16448;3.9;2.3
54;2021-02-17;518;956;28796;17404;3.9;2.4
54;2021-02-18;594;780;29390;18184;4.0;2.5
54;2021-02-19;520;777;29910;18961;4.1;2.6
54;2021-02-20;34;282;29944;19243;4.1;2.6
54;2021-02-21;3;24;29947;19267;4.1;2.6
54;2021-02-22;483;598;30430;19865;4.2;2.7
54;2021-02-23;679;560;31109;20425;4.3;2.8
54;2021-02-24;728;354;31837;20779;4.4;2.8
54;2021-02-25;1474;723;33311;21502;4.6;2.9
54;2021-02-26;1776;792;35087;22294;4.8;3.1
54;2021-02-27;699;111;35786;22405;4.9;3.1
54;2021-02-28;11;28;35797;22433;4.9;3.1
54;2021-03-01;624;218;36421;22651;5.0;3.1
54;2021-03-02;1441;151;37862;22802;5.2;3.1
54;2021-03-03;1732;63;39594;22865;5.4;3.1
54;2021-03-04;2004;102;41598;22967;5.7;3.1
54;2021-03-05;2794;146;44392;23113;6.1;3.2
54;2021-03-06;4011;119;48403;23232;6.6;3.2
54;2021-03-07;2625;72;51028;23304;7.0;3.2
54;2021-03-08;1339;68;52367;23372;7.2;3.2
54;2021-03-09;2624;107;54991;23479;7.5;3.2
54;2021-03-10;3170;114;58161;23593;8.0;3.2
54;2021-03-11;3352;101;61513;23694;8.4;3.2
54;2021-03-12;4913;200;66426;23894;9.1;3.3
54;2021-03-13;4185;134;70611;24028;9.7;3.3
54;2021-03-14;543;40;71154;24068;9.7;3.3
54;2021-03-15;1720;105;72874;24173;10.0;3.3
54;2021-03-16;1719;158;74593;24331;10.2;3.3
54;2021-03-17;2075;134;76668;24465;10.5;3.3
54;2021-03-18;2048;163;78716;24628;10.8;3.4
54;2021-03-19;3301;267;82017;24895;11.2;3.4
54;2021-03-20;2301;79;84318;24974;11.5;3.4
54;2021-03-21;286;14;84604;24988;11.6;3.4
54;2021-03-22;1032;300;85636;25288;11.7;3.5
54;2021-03-23;1937;442;87573;25730;12.0;3.5
54;2021-03-24;2191;696;89764;26426;12.3;3.6
54;2021-03-25;3165;721;92929;27147;12.7;3.7
54;2021-03-26;3511;802;96440;27949;13.2;3.8
54;2021-03-27;2418;271;98858;28220;13.5;3.9
54;2021-03-28;280;7;99138;28227;13.6;3.9
54;2021-03-29;1668;354;100806;28581;13.8;3.9
54;2021-03-30;2556;887;103362;29468;14.2;4.0
54;2021-03-31;2598;1129;105960;30597;14.5;4.2
54;2021-04-01;3235;1259;109195;31856;15.0;4.4
54;2021-04-02;2961;1668;112156;33524;15.4;4.6
54;2021-04-03;1263;1310;113419;34834;15.5;4.8
54;2021-04-04;137;421;113556;35255;15.5;4.8
54;2021-04-05;144;573;113700;35828;15.6;4.9
54;2021-04-06;1265;1644;114965;37472;15.7;5.1
54;2021-04-07;923;2225;115888;39697;15.9;5.4
54;2021-04-08;2324;2421;118212;42118;16.2;5.8
54;2021-04-09;4113;3115;122325;45233;16.7;6.2
54;2021-04-10;3202;1666;125527;46899;17.2;6.4
54;2021-04-11;206;1001;125733;47900;17.2;6.6
54;2021-04-12;2198;1514;127931;49414;17.5;6.8
54;2021-04-13;3001;1972;130932;51386;17.9;7.0
54;2021-04-14;3255;1862;134187;53248;18.4;7.3
54;2021-04-15;2875;2289;137062;55537;18.8;7.6
54;2021-04-16;3139;2577;140201;58114;19.2;8.0
54;2021-04-17;3475;1480;143676;59594;19.7;8.2
54;2021-04-18;64;245;143740;59839;19.7;8.2
54;2021-04-19;2463;1089;146203;60928;20.0;8.3
54;2021-04-20;3012;1254;149215;62182;20.4;8.5
54;2021-04-21;4400;1643;153615;63825;21.0;8.7
54;2021-04-22;3723;2386;157338;66211;21.5;9.1
54;2021-04-23;3868;2089;161206;68300;22.1;9.4
54;2021-04-24;2346;1039;163552;69339;22.4;9.5
54;2021-04-25;284;277;163836;69616;22.4;9.5
54;2021-04-26;2306;1272;166142;70888;22.7;9.7
54;2021-04-27;3288;1442;169430;72330;23.2;9.9
54;2021-04-28;2973;1960;172403;74290;23.6;10.2
54;2021-04-29;3795;2089;176198;76379;24.1;10.5
54;2021-04-30;4493;1981;180691;78360;24.7;10.7
54;2021-05-01;2265;808;182956;79168;25.0;10.8
54;2021-05-02;229;68;183185;79236;25.1;10.8
54;2021-05-03;3097;949;186282;80185;25.5;11.0
54;2021-05-04;3514;1459;189796;81644;26.0;11.2
54;2021-05-05;4891;1420;194687;83064;26.7;11.4
54;2021-05-06;4434;2804;199121;85868;27.3;11.8
54;2021-05-07;4823;3418;203944;89286;27.9;12.2
54;2021-05-08;2030;645;205974;89931;28.2;12.3
54;2021-05-09;375;136;206349;90067;28.3;12.3
54;2021-05-10;3207;2242;209556;92309;28.7;12.6
54;2021-05-11;5492;2940;215048;95249;29.4;13.0
54;2021-05-12;4146;3389;219194;98638;30.0;13.5
54;2021-05-13;2648;492;221842;99130;30.4;13.6
54;2021-05-14;6883;2003;228725;101133;31.3;13.8
54;2021-05-15;5484;1324;234209;102457;32.1;14.0
54;2021-05-16;944;108;235153;102565;32.2;14.0
54;2021-05-17;3799;830;238952;103395;32.7;14.2
54;2021-05-18;3288;1104;242240;104499;33.2;14.3
54;2021-05-19;3464;1515;245704;106014;33.6;14.5
54;2021-05-20;4538;1621;250242;107635;34.3;14.7
54;2021-05-21;6755;2525;256997;110160;35.2;15.1
54;2021-05-22;5662;1377;262659;111537;36.0;15.3
54;2021-05-23;504;55;263163;111592;36.0;15.3
54;2021-05-24;1444;343;264607;111935;36.2;15.3
54;2021-05-25;4200;1545;268807;113480;36.8;15.5
54;2021-05-26;3536;2218;272343;115698;37.3;15.8
54;2021-05-27;4179;2434;276522;118132;37.9;16.2
54;2021-05-28;4990;3574;281512;121706;38.5;16.7
54;2021-05-29;3844;3999;285356;125705;39.1;17.2
54;2021-05-30;127;83;285483;125788;39.1;17.2
54;2021-05-31;2940;3067;288423;128855;39.5;17.6
54;2021-06-01;2622;4192;291045;133047;39.8;18.2
54;2021-06-02;2167;4097;293212;137144;40.1;18.8
54;2021-06-03;3144;5655;296356;142799;40.6;19.6
54;2021-06-04;5103;5492;301459;148291;41.3;20.3
54;2021-06-05;2342;3282;303801;151573;41.6;20.8
54;2021-06-06;72;236;303873;151809;41.6;20.8
54;2021-06-07;3706;2938;307579;154747;42.1;21.2
54;2021-06-08;4544;4275;312123;159022;42.7;21.8
54;2021-06-09;6004;3319;318127;162341;43.6;22.2
54;2021-06-10;5296;4455;323423;166796;44.3;22.8
54;2021-06-11;5023;4923;328446;171719;45.0;23.5
54;2021-06-12;4242;3233;332688;174952;45.5;24.0
54;2021-06-13;54;210;332742;175162;45.6;24.0
54;2021-06-14;2334;3595;335076;178757;45.9;24.5
54;2021-06-15;2830;4730;337906;183487;46.3;25.1
54;2021-06-16;3491;5658;341397;189145;46.7;25.9
54;2021-06-17;3138;5222;344535;194367;47.2;26.6
54;2021-06-18;4156;6241;348691;200608;47.7;27.5
54;2021-06-19;2648;3129;351339;203737;48.1;27.9
54;2021-06-20;102;339;351441;204076;48.1;27.9
54;2021-06-21;2556;4772;353997;208848;48.5;28.6
54;2021-06-22;2047;6223;356044;215071;48.7;29.4
54;2021-06-23;2246;5597;358290;220668;49.1;30.2
54;2021-06-24;2090;3455;360380;224123;49.3;30.7
54;2021-06-25;2196;7061;362576;231184;49.6;31.7
54;2021-06-26;2384;5675;364960;236859;50.0;32.4
54;2021-06-27;134;608;365094;237467;50.0;32.5
54;2021-06-28;1960;4357;367054;241824;50.3;33.1
54;2021-06-29;1941;5205;368995;247029;50.5;33.8
54;2021-06-30;1983;5123;370978;252152;50.8;34.5
54;2021-07-01;2144;5984;373122;258136;51.1;35.3
54;2021-07-02;2815;7563;375937;265699;51.5;36.4
54;2021-07-03;2838;4098;378775;269797;51.9;36.9
54;2021-07-04;196;500;378971;270297;51.9;37.0
54;2021-07-05;1668;4251;380639;274548;52.1;37.6
54;2021-07-06;2000;5080;382639;279628;52.4;38.3
54;2021-07-07;1906;4845;384545;284473;52.6;38.9
54;2021-07-08;1679;4114;386224;288587;52.9;39.5
54;2021-07-09;3205;6026;389429;294613;53.3;40.3
54;2021-07-10;2547;4376;391976;298989;53.7;40.9
54;2021-07-11;9;103;391985;299092;53.7;40.9
54;2021-07-12;2101;4698;394086;303790;54.0;41.6
54;2021-07-13;2619;4975;396705;308765;54.3;42.3
54;2021-07-14;1535;1507;398240;310272;54.5;42.5
54;2021-07-15;3172;4835;401412;315107;55.0;43.1
54;2021-07-16;4666;6224;406078;321331;55.6;44.0
54;2021-07-17;4005;4774;410083;326105;56.1;44.6
54;2021-07-18;1804;1688;411887;327793;56.4;44.9
54;2021-07-19;2591;4046;414478;331839;56.7;45.4
54;2021-07-20;2910;4814;417388;336653;57.1;46.1
54;2021-07-21;3133;6335;420521;342988;57.6;47.0
54;2021-07-22;3284;5735;423805;348723;58.0;47.7
54;2021-07-23;3982;6989;427787;355712;58.6;48.7
54;2021-07-24;2945;5334;430732;361046;59.0;49.4
54;2021-07-25;71;50;430803;361096;59.0;49.4
54;2021-07-26;2979;4179;433782;365275;59.4;50.0
54;2021-07-27;3718;4008;437500;369283;59.9;50.6
54;2021-07-28;5211;3879;442711;373162;60.6;51.1
54;2021-07-29;5158;3209;447869;376371;61.3;51.5
54;2021-07-30;5132;5004;453001;381375;62.0;52.2
54;2021-07-31;4539;3235;457540;384610;62.6;52.7
54;2021-08-01;257;73;457797;384683;62.7;52.7
54;2021-08-02;3105;3705;460902;388388;63.1;53.2
54;2021-08-03;4110;2921;465012;391309;63.7;53.6
54;2021-08-04;4428;2707;469440;394016;64.3;53.9
54;2021-08-05;4624;2435;474064;396451;64.9;54.3
54;2021-08-06;5456;3995;479520;400446;65.7;54.8
54;2021-08-07;3676;2830;483196;403276;66.2;55.2
54;2021-08-08;248;114;483444;403390;66.2;55.2
54;2021-08-09;2980;2695;486424;406085;66.6;55.6
54;2021-08-10;2564;3769;488988;409854;66.9;56.1
54;2021-08-11;2335;2565;491323;412419;67.3;56.5
54;2021-08-12;2192;3010;493515;415429;67.6;56.9
54;2021-08-13;2633;4450;496148;419879;67.9;57.5
54;2021-08-14;1436;2077;497584;421956;68.1;57.8
54;2021-08-15;31;43;497615;421999;68.1;57.8
54;2021-08-16;1866;3433;499481;425432;68.4;58.2
54;2021-08-17;1952;3312;501433;428744;68.7;58.7
54;2021-08-18;1502;4109;502935;432853;68.9;59.3
54;2021-08-19;1258;2790;504193;435643;69.0;59.6
54;2021-08-20;1875;4932;506068;440575;69.3;60.3
54;2021-08-21;1471;4017;507539;444592;69.5;60.9
54;2021-08-22;63;28;507602;444620;69.5;60.9
54;2021-08-23;1225;3861;508827;448481;69.7;61.4
54;2021-08-24;1141;3157;509968;451638;69.8;61.8
54;2021-08-25;1427;4382;511395;456020;70.0;62.4
54;2021-08-26;1006;3111;512401;459131;70.2;62.9
54;2021-08-27;1532;5326;513933;464457;70.4;63.6
54;2021-08-28;1148;4285;515081;468742;70.5;64.2
54;2021-08-29;17;50;515098;468792;70.5;64.2
54;2021-08-30;1216;4124;516314;472916;70.7;64.7
54;2021-08-31;1072;4462;517386;477378;70.8;65.4
54;2021-09-01;1108;3399;518494;480777;71.0;65.8
54;2021-09-02;730;1982;519224;482759;71.1;66.1
54;2021-09-03;986;2975;520210;485734;71.2;66.5
54;2021-09-04;1179;3160;521389;488894;71.4;66.9
54;2021-09-05;27;23;521416;488917;71.4;66.9
54;2021-09-06;500;1354;521916;490271;71.5;67.1
54;2021-09-07;610;1465;522526;491736;71.5;67.3
54;2021-09-08;635;1688;523161;493424;71.6;67.6
54;2021-09-09;944;1754;524105;495178;71.8;67.8
54;2021-09-10;1022;2388;525127;497566;71.9;68.1
54;2021-09-11;747;2556;525874;500122;72.0;68.5
54;2021-09-12;93;116;525967;500238;72.0;68.5
54;2021-09-13;652;943;526619;501181;72.1;68.6
54;2021-09-14;625;978;527244;502159;72.2;68.8
54;2021-09-15;640;1747;527884;503906;72.3;69.0
54;2021-09-16;653;714;528537;504620;72.4;69.1
54;2021-09-17;887;1534;529424;506154;72.5;69.3
54;2021-09-18;491;1438;529915;507592;72.6;69.5
54;2021-09-19;30;38;529945;507630;72.6;69.5
54;2021-09-20;387;658;530332;508288;72.6;69.6
54;2021-09-21;454;940;530786;509228;72.7;69.7
54;2021-09-22;411;1120;531197;510348;72.7;69.9
54;2021-09-23;328;845;531525;511193;72.8;70.0
54;2021-09-24;528;1181;532053;512374;72.8;70.1
54;2021-09-25;349;1078;532402;513452;72.9;70.3
54;2021-09-26;9;30;532411;513482;72.9;70.3
54;2021-09-27;234;677;532645;514159;72.9;70.4
54;2021-09-28;346;632;532991;514791;73.0;70.5
54;2021-09-29;395;807;533386;515598;73.0;70.6
54;2021-09-30;232;467;533618;516065;73.1;70.7
54;2021-10-01;495;1011;534113;517076;73.1;70.8
54;2021-10-02;392;963;534505;518039;73.2;70.9
54;2021-10-03;2;10;534507;518049;73.2;70.9
54;2021-10-04;201;529;534708;518578;73.2;71.0
54;2021-10-05;304;943;535012;519521;73.2;71.1
54;2021-10-06;376;808;535388;520329;73.3;71.2
54;2021-10-07;270;686;535658;521015;73.3;71.3
54;2021-10-08;413;975;536071;521990;73.4;71.5
54;2021-10-09;416;734;536487;522724;73.5;71.6
54;2021-10-10;9;18;536496;522742;73.5;71.6
54;2021-10-11;262;432;536758;523174;73.5;71.6
54;2021-10-12;244;616;537002;523790;73.5;71.7
54;2021-10-13;340;529;537342;524319;73.6;71.8
54;2021-10-14;286;560;537628;524879;73.6;71.9
54;2021-10-15;430;661;538058;525540;73.7;72.0
54;2021-10-16;432;548;538490;526088;73.7;72.0
54;2021-10-17;4;11;538494;526099;73.7;72.0
54;2021-10-18;257;427;538751;526526;73.8;72.1
54;2021-10-19;211;346;538962;526872;73.8;72.1
55;2020-12-27;0;0;0;0;0.0;0.0
55;2020-12-28;2;0;2;0;0.0;0.0
55;2020-12-29;0;0;2;0;0.0;0.0
55;2020-12-30;0;0;2;0;0.0;0.0
55;2020-12-31;0;0;2;0;0.0;0.0
55;2021-01-01;0;0;2;0;0.0;0.0
55;2021-01-02;0;0;2;0;0.0;0.0
55;2021-01-03;0;0;2;0;0.0;0.0
55;2021-01-04;1;0;3;0;0.0;0.0
55;2021-01-05;0;0;3;0;0.0;0.0
55;2021-01-06;0;0;3;0;0.0;0.0
55;2021-01-07;122;0;125;0;0.1;0.0
55;2021-01-08;127;0;252;0;0.1;0.0
55;2021-01-09;52;0;304;0;0.2;0.0
55;2021-01-10;0;0;304;0;0.2;0.0
55;2021-01-11;128;1;432;1;0.2;0.0
55;2021-01-12;119;0;551;1;0.3;0.0
55;2021-01-13;134;0;685;1;0.4;0.0
55;2021-01-14;645;8;1330;9;0.7;0.0
55;2021-01-15;237;0;1567;9;0.9;0.0
55;2021-01-16;64;0;1631;9;0.9;0.0
55;2021-01-17;1;0;1632;9;0.9;0.0
55;2021-01-18;414;1;2046;10;1.1;0.0
55;2021-01-19;352;3;2398;13;1.3;0.0
55;2021-01-20;456;2;2854;15;1.6;0.0
55;2021-01-21;430;0;3284;15;1.8;0.0
55;2021-01-22;390;0;3674;15;2.0;0.0
55;2021-01-23;49;0;3723;15;2.0;0.0
55;2021-01-24;0;0;3723;15;2.0;0.0
55;2021-01-25;436;0;4159;15;2.3;0.0
55;2021-01-26;431;0;4590;15;2.5;0.0
55;2021-01-27;424;0;5014;15;2.8;0.0
55;2021-01-28;486;97;5500;112;3.0;0.1
55;2021-01-29;159;54;5659;166;3.1;0.1
55;2021-01-30;92;28;5751;194;3.2;0.1
55;2021-01-31;0;0;5751;194;3.2;0.1
55;2021-02-01;153;176;5904;370;3.3;0.2
55;2021-02-02;159;147;6063;517;3.3;0.3
55;2021-02-03;53;156;6116;673;3.4;0.4
55;2021-02-04;236;399;6352;1072;3.5;0.6
55;2021-02-05;174;140;6526;1212;3.6;0.7
55;2021-02-06;62;56;6588;1268;3.6;0.7
55;2021-02-07;2;53;6590;1321;3.6;0.7
55;2021-02-08;0;18;6590;1339;3.6;0.7
55;2021-02-09;92;116;6682;1455;3.7;0.8
55;2021-02-10;65;23;6747;1478;3.7;0.8
55;2021-02-11;175;98;6922;1576;3.8;0.9
55;2021-02-12;95;28;7017;1604;3.9;0.9
55;2021-02-13;0;0;7017;1604;3.9;0.9
55;2021-02-14;0;0;7017;1604;3.9;0.9
55;2021-02-15;15;417;7032;2021;3.9;1.1
55;2021-02-16;143;394;7175;2415;4.0;1.3
55;2021-02-17;26;489;7201;2904;4.0;1.6
55;2021-02-18;20;341;7221;3245;4.0;1.8
55;2021-02-19;125;287;7346;3532;4.0;1.9
55;2021-02-20;11;0;7357;3532;4.1;1.9
55;2021-02-21;0;0;7357;3532;4.1;1.9
55;2021-02-22;55;458;7412;3990;4.1;2.2
55;2021-02-23;85;439;7497;4429;4.1;2.4
55;2021-02-24;72;415;7569;4844;4.2;2.7
55;2021-02-25;270;684;7839;5528;4.3;3.0
55;2021-02-26;324;236;8163;5764;4.5;3.2
55;2021-02-27;125;87;8288;5851;4.6;3.2
55;2021-02-28;2;8;8290;5859;4.6;3.2
55;2021-03-01;77;141;8367;6000;4.6;3.3
55;2021-03-02;125;170;8492;6170;4.7;3.4
55;2021-03-03;198;3;8690;6173;4.8;3.4
55;2021-03-04;238;43;8928;6216;4.9;3.4
55;2021-03-05;362;47;9290;6263;5.1;3.4
55;2021-03-06;224;6;9514;6269;5.2;3.5
55;2021-03-07;74;5;9588;6274;5.3;3.5
55;2021-03-08;329;52;9917;6326;5.5;3.5
55;2021-03-09;635;50;10552;6376;5.8;3.5
55;2021-03-10;397;26;10949;6402;6.0;3.5
55;2021-03-11;597;147;11546;6549;6.4;3.6
55;2021-03-12;817;94;12363;6643;6.8;3.7
55;2021-03-13;522;13;12885;6656;7.1;3.7
55;2021-03-14;14;0;12899;6656;7.1;3.7
55;2021-03-15;394;24;13293;6680;7.3;3.7
55;2021-03-16;568;111;13861;6791;7.6;3.7
55;2021-03-17;682;22;14543;6813;8.0;3.8
55;2021-03-18;323;23;14866;6836;8.2;3.8
55;2021-03-19;471;60;15337;6896;8.4;3.8
55;2021-03-20;254;16;15591;6912;8.6;3.8
55;2021-03-21;1;1;15592;6913;8.6;3.8
55;2021-03-22;474;21;16066;6934;8.8;3.8
55;2021-03-23;973;66;17039;7000;9.4;3.9
55;2021-03-24;802;43;17841;7043;9.8;3.9
55;2021-03-25;1097;83;18938;7126;10.4;3.9
55;2021-03-26;602;37;19540;7163;10.8;3.9
55;2021-03-27;256;23;19796;7186;10.9;4.0
55;2021-03-28;0;0;19796;7186;10.9;4.0
55;2021-03-29;944;41;20740;7227;11.4;4.0
55;2021-03-30;1425;77;22165;7304;12.2;4.0
55;2021-03-31;1483;73;23648;7377;13.0;4.1
55;2021-04-01;1207;131;24855;7508;13.7;4.1
55;2021-04-02;902;76;25757;7584;14.2;4.2
55;2021-04-03;93;12;25850;7596;14.2;4.2
55;2021-04-04;2;0;25852;7596;14.2;4.2
55;2021-04-05;6;12;25858;7608;14.2;4.2
55;2021-04-06;933;276;26791;7884;14.7;4.3
55;2021-04-07;993;240;27784;8124;15.3;4.5
55;2021-04-08;1649;421;29433;8545;16.2;4.7
55;2021-04-09;1430;262;30863;8807;17.0;4.8
55;2021-04-10;243;175;31106;8982;17.1;4.9
55;2021-04-11;452;23;31558;9005;17.4;5.0
55;2021-04-12;855;330;32413;9335;17.8;5.1
55;2021-04-13;1355;530;33768;9865;18.6;5.4
55;2021-04-14;1372;727;35140;10592;19.3;5.8
55;2021-04-15;1637;461;36777;11053;20.2;6.1
55;2021-04-16;704;379;37481;11432;20.6;6.3
55;2021-04-17;677;33;38158;11465;21.0;6.3
55;2021-04-18;38;19;38196;11484;21.0;6.3
55;2021-04-19;961;348;39157;11832;21.6;6.5
55;2021-04-20;1173;776;40330;12608;22.2;6.9
55;2021-04-21;990;641;41320;13249;22.7;7.3
55;2021-04-22;1099;683;42419;13932;23.4;7.7
55;2021-04-23;1425;600;43844;14532;24.1;8.0
55;2021-04-24;313;124;44157;14656;24.3;8.1
55;2021-04-25;384;51;44541;14707;24.5;8.1
55;2021-04-26;478;815;45019;15522;24.8;8.5
55;2021-04-27;570;996;45589;16518;25.1;9.1
55;2021-04-28;931;815;46520;17333;25.6;9.5
55;2021-04-29;1118;859;47638;18192;26.2;10.0
55;2021-04-30;1280;624;48918;18816;26.9;10.4
55;2021-05-01;153;132;49071;18948;27.0;10.4
55;2021-05-02;2;3;49073;18951;27.0;10.4
55;2021-05-03;1209;630;50282;19581;27.7;10.8
55;2021-05-04;683;1180;50965;20761;28.1;11.4
55;2021-05-05;657;1075;51622;21836;28.4;12.0
55;2021-05-06;1350;1163;52972;22999;29.2;12.7
55;2021-05-07;1433;556;54405;23555;30.0;13.0
55;2021-05-08;156;77;54561;23632;30.0;13.0
55;2021-05-09;62;523;54623;24155;30.1;13.3
55;2021-05-10;859;1030;55482;25185;30.5;13.9
55;2021-05-11;1072;1380;56554;26565;31.1;14.6
55;2021-05-12;1031;1766;57585;28331;31.7;15.6
55;2021-05-13;99;75;57684;28406;31.8;15.6
55;2021-05-14;352;556;58036;28962;32.0;15.9
55;2021-05-15;291;492;58327;29454;32.1;16.2
55;2021-05-16;3;10;58330;29464;32.1;16.2
55;2021-05-17;1028;841;59358;30305;32.7;16.7
55;2021-05-18;1567;893;60925;31198;33.5;17.2
55;2021-05-19;1809;776;62734;31974;34.5;17.6
55;2021-05-20;2215;730;64949;32704;35.8;18.0
55;2021-05-21;2009;800;66958;33504;36.9;18.4
55;2021-05-22;198;167;67156;33671;37.0;18.5
55;2021-05-23;23;120;67179;33791;37.0;18.6
55;2021-05-24;0;0;67179;33791;37.0;18.6
55;2021-05-25;1347;653;68526;34444;37.7;19.0
55;2021-05-26;1675;1018;70201;35462;38.6;19.5
55;2021-05-27;1322;983;71523;36445;39.4;20.1
55;2021-05-28;1521;930;73044;37375;40.2;20.6
55;2021-05-29;1403;698;74447;38073;41.0;21.0
55;2021-05-30;15;205;74462;38278;41.0;21.1
55;2021-05-31;1048;1130;75510;39408;41.6;21.7
55;2021-06-01;919;955;76429;40363;42.1;22.2
55;2021-06-02;1162;983;77591;41346;42.7;22.8
55;2021-06-03;703;545;78294;41891;43.1;23.1
55;2021-06-04;1388;1100;79682;42991;43.9;23.7
55;2021-06-05;1366;278;81048;43269;44.6;23.8
55;2021-06-06;0;2;81048;43271;44.6;23.8
55;2021-06-07;791;714;81839;43985;45.1;24.2
55;2021-06-08;700;1072;82539;45057;45.4;24.8
55;2021-06-09;852;872;83391;45929;45.9;25.3
55;2021-06-10;378;275;83769;46204;46.1;25.4
55;2021-06-11;528;1287;84297;47491;46.4;26.1
55;2021-06-12;761;519;85058;48010;46.8;26.4
55;2021-06-13;265;33;85323;48043;47.0;26.4
55;2021-06-14;391;1361;85714;49404;47.2;27.2
55;2021-06-15;574;1212;86288;50616;47.5;27.9
55;2021-06-16;735;832;87023;51448;47.9;28.3
55;2021-06-17;425;858;87448;52306;48.1;28.8
55;2021-06-18;667;1474;88115;53780;48.5;29.6
55;2021-06-19;593;456;88708;54236;48.8;29.9
55;2021-06-20;0;0;88708;54236;48.8;29.9
55;2021-06-21;441;1023;89149;55259;49.1;30.4
55;2021-06-22;335;1011;89484;56270;49.3;31.0
55;2021-06-23;626;1210;90110;57480;49.6;31.6
55;2021-06-24;164;433;90274;57913;49.7;31.9
55;2021-06-25;642;1227;90916;59140;50.1;32.6
55;2021-06-26;418;341;91334;59481;50.3;32.7
55;2021-06-27;1;2;91335;59483;50.3;32.7
55;2021-06-28;149;1379;91484;60862;50.4;33.5
55;2021-06-29;201;1288;91685;62150;50.5;34.2
55;2021-06-30;272;1930;91957;64080;50.6;35.3
55;2021-07-01;388;1977;92345;66057;50.8;36.4
55;2021-07-02;392;1719;92737;67776;51.1;37.3
55;2021-07-03;107;262;92844;68038;51.1;37.5
55;2021-07-04;12;19;92856;68057;51.1;37.5
55;2021-07-05;222;1508;93078;69565;51.2;38.3
55;2021-07-06;327;900;93405;70465;51.4;38.8
55;2021-07-07;389;1801;93794;72266;51.6;39.8
55;2021-07-08;535;1594;94329;73860;51.9;40.7
55;2021-07-09;457;1478;94786;75338;52.2;41.5
55;2021-07-10;357;1113;95143;76451;52.4;42.1
55;2021-07-11;0;9;95143;76460;52.4;42.1
55;2021-07-12;608;1166;95751;77626;52.7;42.7
55;2021-07-13;599;1487;96350;79113;53.0;43.6
55;2021-07-14;1;13;96351;79126;53.0;43.6
55;2021-07-15;782;1646;97133;80772;53.5;44.5
55;2021-07-16;1255;1810;98388;82582;54.2;45.5
55;2021-07-17;1284;822;99672;83404;54.9;45.9
55;2021-07-18;1;2;99673;83406;54.9;45.9
55;2021-07-19;597;785;100270;84191;55.2;46.4
55;2021-07-20;1001;1024;101271;85215;55.8;46.9
55;2021-07-21;1482;1371;102753;86586;56.6;47.7
55;2021-07-22;1174;569;103927;87155;57.2;48.0
55;2021-07-23;1113;1356;105040;88511;57.8;48.7
55;2021-07-24;819;762;105859;89273;58.3;49.1
55;2021-07-25;120;229;105979;89502;58.3;49.3
55;2021-07-26;668;444;106647;89946;58.7;49.5
55;2021-07-27;1166;479;107813;90425;59.4;49.8
55;2021-07-28;1039;1066;108852;91491;59.9;50.4
55;2021-07-29;670;446;109522;91937;60.3;50.6
55;2021-07-30;1272;966;110794;92903;61.0;51.1
55;2021-07-31;714;613;111508;93516;61.4;51.5
55;2021-08-01;9;5;111517;93521;61.4;51.5
55;2021-08-02;820;443;112337;93964;61.8;51.7
55;2021-08-03;791;419;113128;94383;62.3;52.0
55;2021-08-04;1248;951;114376;95334;63.0;52.5
55;2021-08-05;1055;324;115431;95658;63.5;52.7
55;2021-08-06;819;1096;116250;96754;64.0;53.3
55;2021-08-07;596;337;116846;97091;64.3;53.5
55;2021-08-08;0;0;116846;97091;64.3;53.5
55;2021-08-09;402;306;117248;97397;64.5;53.6
55;2021-08-10;447;776;117695;98173;64.8;54.0
55;2021-08-11;596;640;118291;98813;65.1;54.4
55;2021-08-12;327;489;118618;99302;65.3;54.7
55;2021-08-13;439;1110;119057;100412;65.5;55.3
55;2021-08-14;144;190;119201;100602;65.6;55.4
55;2021-08-15;11;5;119212;100607;65.6;55.4
55;2021-08-16;246;739;119458;101346;65.8;55.8
55;2021-08-17;259;289;119717;101635;65.9;56.0
55;2021-08-18;576;1241;120293;102876;66.2;56.6
55;2021-08-19;451;960;120744;103836;66.5;57.2
55;2021-08-20;623;1012;121367;104848;66.8;57.7
55;2021-08-21;292;772;121659;105620;67.0;58.1
55;2021-08-22;8;6;121667;105626;67.0;58.2
55;2021-08-23;357;612;122024;106238;67.2;58.5
55;2021-08-24;338;833;122362;107071;67.4;58.9
55;2021-08-25;678;1173;123040;108244;67.7;59.6
55;2021-08-26;473;1253;123513;109497;68.0;60.3
55;2021-08-27;336;1247;123849;110744;68.2;61.0
55;2021-08-28;389;578;124238;111322;68.4;61.3
55;2021-08-29;217;59;124455;111381;68.5;61.3
55;2021-08-30;175;670;124630;112051;68.6;61.7
55;2021-08-31;289;802;124919;112853;68.8;62.1
55;2021-09-01;771;1213;125690;114066;69.2;62.8
55;2021-09-02;271;820;125961;114886;69.3;63.2
55;2021-09-03;531;1046;126492;115932;69.6;63.8
55;2021-09-04;290;576;126782;116508;69.8;64.1
55;2021-09-05;18;91;126800;116599;69.8;64.2
55;2021-09-06;103;122;126903;116721;69.9;64.3
55;2021-09-07;285;402;127188;117123;70.0;64.5
55;2021-09-08;276;275;127464;117398;70.2;64.6
55;2021-09-09;200;544;127664;117942;70.3;64.9
55;2021-09-10;254;420;127918;118362;70.4;65.2
55;2021-09-11;101;281;128019;118643;70.5;65.3
55;2021-09-12;1;2;128020;118645;70.5;65.3
55;2021-09-13;103;328;128123;118973;70.5;65.5
55;2021-09-14;293;174;128416;119147;70.7;65.6
55;2021-09-15;309;638;128725;119785;70.9;65.9
55;2021-09-16;120;181;128845;119966;70.9;66.0
55;2021-09-17;91;124;128936;120090;71.0;66.1
55;2021-09-18;142;391;129078;120481;71.1;66.3
55;2021-09-19;1;59;129079;120540;71.1;66.4
55;2021-09-20;83;192;129162;120732;71.1;66.5
55;2021-09-21;100;332;129262;121064;71.2;66.7
55;2021-09-22;152;396;129414;121460;71.2;66.9
55;2021-09-23;145;427;129559;121887;71.3;67.1
55;2021-09-24;88;369;129647;122256;71.4;67.3
55;2021-09-25;59;160;129706;122416;71.4;67.4
55;2021-09-26;0;33;129706;122449;71.4;67.4
55;2021-09-27;48;129;129754;122578;71.4;67.5
55;2021-09-28;51;124;129805;122702;71.5;67.6
55;2021-09-29;157;863;129962;123565;71.5;68.0
55;2021-09-30;58;331;130020;123896;71.6;68.2
55;2021-10-01;57;274;130077;124170;71.6;68.4
55;2021-10-02;91;372;130168;124542;71.7;68.6
55;2021-10-03;0;59;130168;124601;71.7;68.6
55;2021-10-04;108;391;130276;124992;71.7;68.8
55;2021-10-05;71;259;130347;125251;71.8;69.0
55;2021-10-06;101;378;130448;125629;71.8;69.2
55;2021-10-07;58;152;130506;125781;71.8;69.2
55;2021-10-08;62;143;130568;125924;71.9;69.3
55;2021-10-09;60;242;130628;126166;71.9;69.5
55;2021-10-10;20;194;130648;126360;71.9;69.6
55;2021-10-11;70;173;130718;126533;72.0;69.7
55;2021-10-12;78;365;130796;126898;72.0;69.9
55;2021-10-13;89;165;130885;127063;72.1;70.0
55;2021-10-14;33;153;130918;127216;72.1;70.0
55;2021-10-15;57;139;130975;127355;72.1;70.1
55;2021-10-16;30;164;131005;127519;72.1;70.2
55;2021-10-17;13;14;131018;127533;72.1;70.2
55;2021-10-18;66;93;131084;127626;72.2;70.3
55;2021-10-19;43;60;131127;127686;72.2;70.3
56;2020-12-27;0;0;0;0;0.0;0.0
56;2020-12-28;1;0;1;0;0.0;0.0
56;2020-12-29;0;0;1;0;0.0;0.0
56;2020-12-30;0;0;1;0;0.0;0.0
56;2020-12-31;0;0;1;0;0.0;0.0
56;2021-01-01;0;0;1;0;0.0;0.0
56;2021-01-02;1;0;2;0;0.0;0.0
56;2021-01-03;2;2;4;2;0.0;0.0
56;2021-01-04;2;1;6;3;0.0;0.0
56;2021-01-05;1;0;7;3;0.0;0.0
56;2021-01-06;2;0;9;3;0.0;0.0
56;2021-01-07;198;0;207;3;0.0;0.0
56;2021-01-08;119;0;326;3;0.0;0.0
56;2021-01-09;1;0;327;3;0.0;0.0
56;2021-01-10;1;0;328;3;0.0;0.0
56;2021-01-11;242;0;570;3;0.1;0.0
56;2021-01-12;755;15;1325;18;0.2;0.0
56;2021-01-13;638;1;1963;19;0.3;0.0
56;2021-01-14;971;19;2934;38;0.4;0.0
56;2021-01-15;844;5;3778;43;0.5;0.0
56;2021-01-16;235;3;4013;46;0.5;0.0
56;2021-01-17;27;0;4040;46;0.5;0.0
56;2021-01-18;1007;1;5047;47;0.7;0.0
56;2021-01-19;866;24;5913;71;0.8;0.0
56;2021-01-20;888;1;6801;72;0.9;0.0
56;2021-01-21;1450;16;8251;88;1.1;0.0
56;2021-01-22;1183;4;9434;92;1.2;0.0
56;2021-01-23;319;3;9753;95;1.3;0.0
56;2021-01-24;6;0;9759;95;1.3;0.0
56;2021-01-25;830;4;10589;99;1.4;0.0
56;2021-01-26;1034;4;11623;103;1.5;0.0
56;2021-01-27;1083;62;12706;165;1.7;0.0
56;2021-01-28;976;123;13682;288;1.8;0.0
56;2021-01-29;875;107;14557;395;1.9;0.1
56;2021-01-30;139;19;14696;414;1.9;0.1
56;2021-01-31;0;0;14696;414;1.9;0.1
56;2021-02-01;480;155;15176;569;2.0;0.1
56;2021-02-02;941;258;16117;827;2.1;0.1
56;2021-02-03;1025;270;17142;1097;2.3;0.1
56;2021-02-04;4705;360;21847;1457;2.9;0.2
56;2021-02-05;3596;436;25443;1893;3.4;0.3
56;2021-02-06;550;171;25993;2064;3.4;0.3
56;2021-02-07;136;26;26129;2090;3.5;0.3
56;2021-02-08;297;291;26426;2381;3.5;0.3
56;2021-02-09;795;506;27221;2887;3.6;0.4
56;2021-02-10;864;700;28085;3587;3.7;0.5
56;2021-02-11;973;1081;29058;4668;3.8;0.6
56;2021-02-12;1153;645;30211;5313;4.0;0.7
56;2021-02-13;220;103;30431;5416;4.0;0.7
56;2021-02-14;6;46;30437;5462;4.0;0.7
56;2021-02-15;622;1087;31059;6549;4.1;0.9
56;2021-02-16;1220;735;32279;7284;4.3;1.0
56;2021-02-17;1189;960;33468;8244;4.4;1.1
56;2021-02-18;1351;882;34819;9126;4.6;1.2
56;2021-02-19;1323;916;36142;10042;4.8;1.3
56;2021-02-20;364;259;36506;10301;4.8;1.4
56;2021-02-21;2;1;36508;10302;4.8;1.4
56;2021-02-22;376;704;36884;11006;4.9;1.5
56;2021-02-23;742;951;37626;11957;5.0;1.6
56;2021-02-24;918;1187;38544;13144;5.1;1.7
56;2021-02-25;2032;4258;40576;17402;5.4;2.3
56;2021-02-26;2358;2255;42934;19657;5.7;2.6
56;2021-02-27;748;446;43682;20103;5.8;2.7
56;2021-02-28;15;114;43697;20217;5.8;2.7
56;2021-03-01;649;559;44346;20776;5.9;2.7
56;2021-03-02;981;789;45327;21565;6.0;2.9
56;2021-03-03;1150;910;46477;22475;6.2;3.0
56;2021-03-04;1965;1040;48442;23515;6.4;3.1
56;2021-03-05;2583;1436;51025;24951;6.8;3.3
56;2021-03-06;1209;223;52234;25174;6.9;3.3
56;2021-03-07;282;24;52516;25198;7.0;3.3
56;2021-03-08;1141;395;53657;25593;7.1;3.4
56;2021-03-09;2044;635;55701;26228;7.4;3.5
56;2021-03-10;2000;939;57701;27167;7.6;3.6
56;2021-03-11;3252;744;60953;27911;8.1;3.7
56;2021-03-12;4208;834;65161;28745;8.6;3.8
56;2021-03-13;1884;153;67045;28898;8.9;3.8
56;2021-03-14;195;4;67240;28902;8.9;3.8
56;2021-03-15;1286;531;68526;29433;9.1;3.9
56;2021-03-16;1088;1029;69614;30462;9.2;4.0
56;2021-03-17;1372;778;70986;31240;9.4;4.1
56;2021-03-18;2001;1863;72987;33103;9.7;4.4
56;2021-03-19;2948;1397;75935;34500;10.1;4.6
56;2021-03-20;1492;207;77427;34707;10.2;4.6
56;2021-03-21;209;22;77636;34729;10.3;4.6
56;2021-03-22;1613;407;79249;35136;10.5;4.7
56;2021-03-23;2810;687;82059;35823;10.9;4.7
56;2021-03-24;3450;527;85509;36350;11.3;4.8
56;2021-03-25;4240;731;89749;37081;11.9;4.9
56;2021-03-26;5092;774;94841;37855;12.6;5.0
56;2021-03-27;1502;296;96343;38151;12.8;5.0
56;2021-03-28;264;11;96607;38162;12.8;5.1
56;2021-03-29;2236;507;98843;38669;13.1;5.1
56;2021-03-30;3519;787;102362;39456;13.5;5.2
56;2021-03-31;3115;723;105477;40179;14.0;5.3
56;2021-04-01;4079;827;109556;41006;14.5;5.4
56;2021-04-02;3925;955;113481;41961;15.0;5.6
56;2021-04-03;1186;270;114667;42231;15.2;5.6
56;2021-04-04;233;4;114900;42235;15.2;5.6
56;2021-04-05;245;8;115145;42243;15.2;5.6
56;2021-04-06;2828;1237;117973;43480;15.6;5.8
56;2021-04-07;4023;1197;121996;44677;16.1;5.9
56;2021-04-08;5296;1170;127292;45847;16.8;6.1
56;2021-04-09;7396;1289;134688;47136;17.8;6.2
56;2021-04-10;2576;430;137264;47566;18.2;6.3
56;2021-04-11;194;101;137458;47667;18.2;6.3
56;2021-04-12;3932;838;141390;48505;18.7;6.4
56;2021-04-13;5965;1268;147355;49773;19.5;6.6
56;2021-04-14;5168;1434;152523;51207;20.2;6.8
56;2021-04-15;7153;1779;159676;52986;21.1;7.0
56;2021-04-16;7842;2020;167518;55006;22.2;7.3
56;2021-04-17;3130;649;170648;55655;22.6;7.4
56;2021-04-18;528;110;171176;55765;22.7;7.4
56;2021-04-19;3718;1264;174894;57029;23.1;7.5
56;2021-04-20;4107;1981;179001;59010;23.7;7.8
56;2021-04-21;4060;2328;183061;61338;24.2;8.1
56;2021-04-22;5173;1928;188234;63266;24.9;8.4
56;2021-04-23;5172;2425;193406;65691;25.6;8.7
56;2021-04-24;2899;649;196305;66340;26.0;8.8
56;2021-04-25;465;149;196770;66489;26.0;8.8
56;2021-04-26;4710;1672;201480;68161;26.7;9.0
56;2021-04-27;5098;2554;206578;70715;27.3;9.4
56;2021-04-28;4965;2249;211543;72964;28.0;9.7
56;2021-04-29;5842;2944;217385;75908;28.8;10.0
56;2021-04-30;6246;2805;223631;78713;29.6;10.4
56;2021-05-01;2490;365;226121;79078;29.9;10.5
56;2021-05-02;307;254;226428;79332;30.0;10.5
56;2021-05-03;3863;2069;230291;81401;30.5;10.8
56;2021-05-04;4377;3910;234668;85311;31.1;11.3
56;2021-05-05;3522;3879;238190;89190;31.5;11.8
56;2021-05-06;4377;5447;242567;94637;32.1;12.5
56;2021-05-07;4267;5015;246834;99652;32.7;13.2
56;2021-05-08;1645;324;248479;99976;32.9;13.2
56;2021-05-09;494;227;248973;100203;33.0;13.3
56;2021-05-10;3751;3809;252724;104012;33.4;13.8
56;2021-05-11;4169;5053;256893;109065;34.0;14.4
56;2021-05-12;4342;4776;261235;113841;34.6;15.1
56;2021-05-13;2397;1014;263632;114855;34.9;15.2
56;2021-05-14;4227;4361;267859;119216;35.5;15.8
56;2021-05-15;2488;1895;270347;121111;35.8;16.0
56;2021-05-16;237;488;270584;121599;35.8;16.1
56;2021-05-17;2513;3668;273097;125267;36.1;16.6
56;2021-05-18;3522;4103;276619;129370;36.6;17.1
56;2021-05-19;3527;3398;280146;132768;37.1;17.6
56;2021-05-20;3805;4821;283951;137589;37.6;18.2
56;2021-05-21;3748;5228;287699;142817;38.1;18.9
56;2021-05-22;1696;2207;289395;145024;38.3;19.2
56;2021-05-23;284;197;289679;145221;38.3;19.2
56;2021-05-24;2058;497;291737;145718;38.6;19.3
56;2021-05-25;3141;4470;294878;150188;39.0;19.9
56;2021-05-26;3735;3937;298613;154125;39.5;20.4
56;2021-05-27;4362;4868;302975;158993;40.1;21.0
56;2021-05-28;4640;5960;307615;164953;40.7;21.8
56;2021-05-29;1886;1635;309501;166588;41.0;22.0
56;2021-05-30;318;67;309819;166655;41.0;22.1
56;2021-05-31;4502;3222;314321;169877;41.6;22.5
56;2021-06-01;5664;3386;319985;173263;42.4;22.9
56;2021-06-02;5631;2953;325616;176216;43.1;23.3
56;2021-06-03;6190;3305;331806;179521;43.9;23.8
56;2021-06-04;5814;4413;337620;183934;44.7;24.3
56;2021-06-05;4346;2385;341966;186319;45.3;24.7
56;2021-06-06;496;615;342462;186934;45.3;24.7
56;2021-06-07;5101;3172;347563;190106;46.0;25.2
56;2021-06-08;6070;3375;353633;193481;46.8;25.6
56;2021-06-09;6431;2815;360064;196296;47.7;26.0
56;2021-06-10;7479;2875;367543;199171;48.6;26.4
56;2021-06-11;6769;3867;374312;203038;49.5;26.9
56;2021-06-12;5103;2064;379415;205102;50.2;27.1
56;2021-06-13;1978;439;381393;205541;50.5;27.2
56;2021-06-14;3313;4595;384706;210136;50.9;27.8
56;2021-06-15;4201;4897;388907;215033;51.5;28.5
56;2021-06-16;4497;4505;393404;219538;52.1;29.1
56;2021-06-17;4257;4751;397661;224289;52.6;29.7
56;2021-06-18;4513;5973;402174;230262;53.2;30.5
56;2021-06-19;3832;2144;406006;232406;53.7;30.8
56;2021-06-20;1503;340;407509;232746;53.9;30.8
56;2021-06-21;3306;4462;410815;237208;54.4;31.4
56;2021-06-22;3483;5441;414298;242649;54.8;32.1
56;2021-06-23;3763;5061;418061;247710;55.3;32.8
56;2021-06-24;3478;5319;421539;253029;55.8;33.5
56;2021-06-25;3883;6280;425422;259309;56.3;34.3
56;2021-06-26;3202;2916;428624;262225;56.7;34.7
56;2021-06-27;305;163;428929;262388;56.8;34.7
56;2021-06-28;1575;3982;430504;266370;57.0;35.3
56;2021-06-29;2433;5769;432937;272139;57.3;36.0
56;2021-06-30;2499;5561;435436;277700;57.6;36.8
56;2021-07-01;2735;4960;438171;282660;58.0;37.4
56;2021-07-02;2656;6204;440827;288864;58.3;38.2
56;2021-07-03;2203;2684;443030;291548;58.6;38.6
56;2021-07-04;778;811;443808;292359;58.7;38.7
56;2021-07-05;1872;5442;445680;297801;59.0;39.4
56;2021-07-06;2190;5933;447870;303734;59.3;40.2
56;2021-07-07;2844;5642;450714;309376;59.7;40.9
56;2021-07-08;3086;6036;453800;315412;60.1;41.7
56;2021-07-09;2213;7098;456013;322510;60.4;42.7
56;2021-07-10;1126;3004;457139;325514;60.5;43.1
56;2021-07-11;256;344;457395;325858;60.5;43.1
56;2021-07-12;2181;6605;459576;332463;60.8;44.0
56;2021-07-13;3259;7467;462835;339930;61.3;45.0
56;2021-07-14;1785;2591;464620;342521;61.5;45.3
56;2021-07-15;3820;7070;468440;349591;62.0;46.3
56;2021-07-16;4076;8096;472516;357687;62.5;47.3
56;2021-07-17;2320;3525;474836;361212;62.8;47.8
56;2021-07-18;257;478;475093;361690;62.9;47.9
56;2021-07-19;2869;6359;477962;368049;63.3;48.7
56;2021-07-20;3722;7913;481684;375962;63.8;49.8
56;2021-07-21;3096;7520;484780;383482;64.2;50.8
56;2021-07-22;4391;8034;489171;391516;64.7;51.8
56;2021-07-23;4389;8413;493560;399929;65.3;52.9
56;2021-07-24;1687;4602;495247;404531;65.5;53.5
56;2021-07-25;551;1916;495798;406447;65.6;53.8
56;2021-07-26;3680;5463;499478;411910;66.1;54.5
56;2021-07-27;5375;6201;504853;418111;66.8;55.3
56;2021-07-28;4687;5465;509540;423576;67.4;56.1
56;2021-07-29;5378;5628;514918;429204;68.1;56.8
56;2021-07-30;5383;5864;520301;435068;68.9;57.6
56;2021-07-31;2159;2694;522460;437762;69.1;57.9
56;2021-08-01;1255;977;523715;438739;69.3;58.1
56;2021-08-02;4536;4600;528251;443339;69.9;58.7
56;2021-08-03;6385;4962;534636;448301;70.8;59.3
56;2021-08-04;5952;4364;540588;452665;71.5;59.9
56;2021-08-05;6097;4605;546685;457270;72.4;60.5
56;2021-08-06;5856;4926;552541;462196;73.1;61.2
56;2021-08-07;2859;2228;555400;464424;73.5;61.5
56;2021-08-08;1830;566;557230;464990;73.8;61.5
56;2021-08-09;3937;4268;561167;469258;74.3;62.1
56;2021-08-10;4928;4612;566095;473870;74.9;62.7
56;2021-08-11;4566;4138;570661;478008;75.5;63.3
56;2021-08-12;4489;4550;575150;482558;76.1;63.9
56;2021-08-13;4214;4813;579364;487371;76.7;64.5
56;2021-08-14;1793;2136;581157;489507;76.9;64.8
56;2021-08-15;348;485;581505;489992;77.0;64.9
56;2021-08-16;3067;4522;584572;494514;77.4;65.4
56;2021-08-17;3761;5056;588333;499570;77.9;66.1
56;2021-08-18;3741;4609;592074;504179;78.4;66.7
56;2021-08-19;3069;4993;595143;509172;78.8;67.4
56;2021-08-20;2906;5261;598049;514433;79.2;68.1
56;2021-08-21;1159;2399;599208;516832;79.3;68.4
56;2021-08-22;129;503;599337;517335;79.3;68.5
56;2021-08-23;1928;4969;601265;522304;79.6;69.1
56;2021-08-24;1924;5514;603189;527818;79.8;69.9
56;2021-08-25;1710;5056;604899;532874;80.1;70.5
56;2021-08-26;1409;5326;606308;538200;80.2;71.2
56;2021-08-27;1757;5879;608065;544079;80.5;72.0
56;2021-08-28;605;2802;608670;546881;80.6;72.4
56;2021-08-29;79;476;608749;547357;80.6;72.4
56;2021-08-30;1382;4626;610131;551983;80.8;73.1
56;2021-08-31;1473;4648;611604;556631;80.9;73.7
56;2021-09-01;1321;3927;612925;560558;81.1;74.2
56;2021-09-02;1082;3711;614007;564269;81.3;74.7
56;2021-09-03;1102;4241;615109;568510;81.4;75.2
56;2021-09-04;767;2340;615876;570850;81.5;75.6
56;2021-09-05;128;365;616004;571215;81.5;75.6
56;2021-09-06;885;3115;616889;574330;81.6;76.0
56;2021-09-07;820;3001;617709;577331;81.8;76.4
56;2021-09-08;968;3235;618677;580566;81.9;76.8
56;2021-09-09;800;2667;619477;583233;82.0;77.2
56;2021-09-10;942;3160;620419;586393;82.1;77.6
56;2021-09-11;474;2017;620893;588410;82.2;77.9
56;2021-09-12;34;167;620927;588577;82.2;77.9
56;2021-09-13;767;2073;621694;590650;82.3;78.2
56;2021-09-14;702;1869;622396;592519;82.4;78.4
56;2021-09-15;715;2499;623111;595018;82.5;78.8
56;2021-09-16;708;1591;623819;596609;82.6;79.0
56;2021-09-17;764;2148;624583;598757;82.7;79.2
56;2021-09-18;305;1706;624888;600463;82.7;79.5
56;2021-09-19;32;112;624920;600575;82.7;79.5
56;2021-09-20;435;1287;625355;601862;82.8;79.7
56;2021-09-21;502;1164;625857;603026;82.8;79.8
56;2021-09-22;464;1704;626321;604730;82.9;80.0
56;2021-09-23;545;1050;626866;605780;83.0;80.2
56;2021-09-24;583;1617;627449;607397;83.0;80.4
56;2021-09-25;256;1029;627705;608426;83.1;80.5
56;2021-09-26;12;79;627717;608505;83.1;80.5
56;2021-09-27;477;1000;628194;609505;83.1;80.7
56;2021-09-28;436;958;628630;610463;83.2;80.8
56;2021-09-29;387;1168;629017;611631;83.3;81.0
56;2021-09-30;334;606;629351;612237;83.3;81.0
56;2021-10-01;514;1256;629865;613493;83.4;81.2
56;2021-10-02;161;403;630026;613896;83.4;81.2
56;2021-10-03;5;77;630031;613973;83.4;81.3
56;2021-10-04;294;762;630325;614735;83.4;81.4
56;2021-10-05;239;620;630564;615355;83.5;81.4
56;2021-10-06;403;947;630967;616302;83.5;81.6
56;2021-10-07;312;880;631279;617182;83.6;81.7
56;2021-10-08;431;911;631710;618093;83.6;81.8
56;2021-10-09;153;383;631863;618476;83.6;81.9
56;2021-10-10;11;58;631874;618534;83.6;81.9
56;2021-10-11;280;596;632154;619130;83.7;81.9
56;2021-10-12;278;666;632432;619796;83.7;82.0
56;2021-10-13;226;380;632658;620176;83.7;82.1
56;2021-10-14;287;720;632945;620896;83.8;82.2
56;2021-10-15;494;853;633439;621749;83.8;82.3
56;2021-10-16;149;221;633588;621970;83.9;82.3
56;2021-10-17;8;21;633596;621991;83.9;82.3
56;2021-10-18;329;523;633925;622514;83.9;82.4
56;2021-10-19;222;494;634147;623008;83.9;82.5
57;2020-12-27;2;0;2;0;0.0;0.0
57;2020-12-28;0;0;2;0;0.0;0.0
57;2020-12-29;3;0;5;0;0.0;0.0
57;2020-12-30;2;0;7;0;0.0;0.0
57;2020-12-31;0;0;7;0;0.0;0.0
57;2021-01-01;1;1;8;1;0.0;0.0
57;2021-01-02;3;0;11;1;0.0;0.0
57;2021-01-03;0;0;11;1;0.0;0.0
57;2021-01-04;17;0;28;1;0.0;0.0
57;2021-01-05;199;0;227;1;0.0;0.0
57;2021-01-06;226;1;453;2;0.0;0.0
57;2021-01-07;587;2;1040;4;0.1;0.0
57;2021-01-08;509;2;1549;6;0.1;0.0
57;2021-01-09;203;0;1752;6;0.2;0.0
57;2021-01-10;109;1;1861;7;0.2;0.0
57;2021-01-11;470;1;2331;8;0.2;0.0
57;2021-01-12;612;7;2943;15;0.3;0.0
57;2021-01-13;697;2;3640;17;0.4;0.0
57;2021-01-14;708;6;4348;23;0.4;0.0
57;2021-01-15;637;5;4985;28;0.5;0.0
57;2021-01-16;452;1;5437;29;0.5;0.0
57;2021-01-17;493;1;5930;30;0.6;0.0
57;2021-01-18;2717;23;8647;53;0.8;0.0
57;2021-01-19;2567;22;11214;75;1.1;0.0
57;2021-01-20;2771;24;13985;99;1.4;0.0
57;2021-01-21;1803;9;15788;108;1.5;0.0
57;2021-01-22;1326;8;17114;116;1.7;0.0
57;2021-01-23;543;15;17657;131;1.7;0.0
57;2021-01-24;1;0;17658;131;1.7;0.0
57;2021-01-25;869;186;18527;317;1.8;0.0
57;2021-01-26;1113;214;19640;531;1.9;0.1
57;2021-01-27;1070;183;20710;714;2.0;0.1
57;2021-01-28;1041;296;21751;1010;2.1;0.1
57;2021-01-29;983;392;22734;1402;2.2;0.1
57;2021-01-30;440;93;23174;1495;2.2;0.1
57;2021-01-31;11;27;23185;1522;2.2;0.1
57;2021-02-01;829;351;24014;1873;2.3;0.2
57;2021-02-02;989;363;25003;2236;2.4;0.2
57;2021-02-03;987;318;25990;2554;2.5;0.2
57;2021-02-04;1138;803;27128;3357;2.6;0.3
57;2021-02-05;929;354;28057;3711;2.7;0.4
57;2021-02-06;482;347;28539;4058;2.8;0.4
57;2021-02-07;103;336;28642;4394;2.8;0.4
57;2021-02-08;1258;1548;29900;5942;2.9;0.6
57;2021-02-09;1763;1676;31663;7618;3.1;0.7
57;2021-02-10;1711;2076;33374;9694;3.2;0.9
57;2021-02-11;1488;1326;34862;11020;3.4;1.1
57;2021-02-12;1227;677;36089;11697;3.5;1.1
57;2021-02-13;1152;179;37241;11876;3.6;1.1
57;2021-02-14;1211;28;38452;11904;3.7;1.1
57;2021-02-15;766;858;39218;12762;3.8;1.2
57;2021-02-16;1076;798;40294;13560;3.9;1.3
57;2021-02-17;1008;962;41302;14522;4.0;1.4
57;2021-02-18;976;1157;42278;15679;4.1;1.5
57;2021-02-19;956;934;43234;16613;4.2;1.6
57;2021-02-20;1172;614;44406;17227;4.3;1.7
57;2021-02-21;323;13;44729;17240;4.3;1.7
57;2021-02-22;1231;912;45960;18152;4.4;1.8
57;2021-02-23;2235;1087;48195;19239;4.7;1.9
57;2021-02-24;2287;1005;50482;20244;4.9;2.0
57;2021-02-25;3299;1130;53781;21374;5.2;2.1
57;2021-02-26;3594;962;57375;22336;5.5;2.2
57;2021-02-27;3698;543;61073;22879;5.9;2.2
57;2021-02-28;1897;62;62970;22941;6.1;2.2
57;2021-03-01;2084;1346;65054;24287;6.3;2.3
57;2021-03-02;2874;1613;67928;25900;6.6;2.5
57;2021-03-03;2841;1619;70769;27519;6.8;2.7
57;2021-03-04;3299;1302;74068;28821;7.2;2.8
57;2021-03-05;4463;1258;78531;30079;7.6;2.9
57;2021-03-06;7277;797;85808;30876;8.3;3.0
57;2021-03-07;6069;287;91877;31163;8.9;3.0
57;2021-03-08;2300;1018;94177;32181;9.1;3.1
57;2021-03-09;3415;1314;97592;33495;9.4;3.2
57;2021-03-10;3606;981;101198;34476;9.8;3.3
57;2021-03-11;4073;1266;105271;35742;10.2;3.5
57;2021-03-12;5152;1225;110423;36967;10.7;3.6
57;2021-03-13;6304;996;116727;37963;11.3;3.7
57;2021-03-14;2425;431;119152;38394;11.5;3.7
57;2021-03-15;2966;887;122118;39281;11.8;3.8
57;2021-03-16;3073;1306;125191;40587;12.1;3.9
57;2021-03-17;3058;1162;128249;41749;12.4;4.0
57;2021-03-18;3418;1093;131667;42842;12.7;4.1
57;2021-03-19;4642;1066;136309;43908;13.2;4.2
57;2021-03-20;4712;1040;141021;44948;13.6;4.3
57;2021-03-21;1904;257;142925;45205;13.8;4.4
57;2021-03-22;2481;1509;145406;46714;14.0;4.5
57;2021-03-23;3443;2372;148849;49086;14.4;4.7
57;2021-03-24;3901;2171;152750;51257;14.7;4.9
57;2021-03-25;4747;2614;157497;53871;15.2;5.2
57;2021-03-26;4840;2286;162337;56157;15.7;5.4
57;2021-03-27;3710;3174;166047;59331;16.0;5.7
57;2021-03-28;1398;1849;167445;61180;16.2;5.9
57;2021-03-29;1932;2211;169377;63391;16.4;6.1
57;2021-03-30;3305;2534;172682;65925;16.7;6.4
57;2021-03-31;2826;2343;175508;68268;16.9;6.6
57;2021-04-01;3225;3203;178733;71471;17.3;6.9
57;2021-04-02;2392;2610;181125;74081;17.5;7.2
57;2021-04-03;2565;2668;183690;76749;17.7;7.4
57;2021-04-04;596;970;184286;77719;17.8;7.5
57;2021-04-05;1922;676;186208;78395;18.0;7.6
57;2021-04-06;2453;2864;188661;81259;18.2;7.8
57;2021-04-07;3817;3150;192478;84409;18.6;8.1
57;2021-04-08;5613;2954;198091;87363;19.1;8.4
57;2021-04-09;5014;2786;203105;90149;19.6;8.7
57;2021-04-10;2353;3661;205458;93810;19.8;9.1
57;2021-04-11;1099;1892;206557;95702;19.9;9.2
57;2021-04-12;1795;2775;208352;98477;20.1;9.5
57;2021-04-13;1977;3043;210329;101520;20.3;9.8
57;2021-04-14;1923;3001;212252;104521;20.5;10.1
57;2021-04-15;2365;3447;214617;107968;20.7;10.4
57;2021-04-16;2700;3314;217317;111282;21.0;10.7
57;2021-04-17;2475;3192;219792;114474;21.2;11.1
57;2021-04-18;1241;1774;221033;116248;21.3;11.2
57;2021-04-19;2143;2261;223176;118509;21.5;11.4
57;2021-04-20;2513;2790;225689;121299;21.8;11.7
57;2021-04-21;2568;2383;228257;123682;22.0;11.9
57;2021-04-22;3209;2257;231466;125939;22.3;12.2
57;2021-04-23;4062;2588;235528;128527;22.7;12.4
57;2021-04-24;3397;2567;238925;131094;23.1;12.7
57;2021-04-25;757;1128;239682;132222;23.1;12.8
57;2021-04-26;2972;2005;242654;134227;23.4;13.0
57;2021-04-27;3898;2385;246552;136612;23.8;13.2
57;2021-04-28;4213;2596;250765;139208;24.2;13.4
57;2021-04-29;5261;3465;256026;142673;24.7;13.8
57;2021-04-30;4729;3555;260755;146228;25.2;14.1
57;2021-05-01;2356;1686;263111;147914;25.4;14.3
57;2021-05-02;790;915;263901;148829;25.5;14.4
57;2021-05-03;3561;2995;267462;151824;25.8;14.7
57;2021-05-04;4872;3176;272334;155000;26.3;15.0
57;2021-05-05;6123;3173;278457;158173;26.9;15.3
57;2021-05-06;5990;3282;284447;161455;27.5;15.6
57;2021-05-07;6853;3449;291300;164904;28.1;15.9
57;2021-05-08;4051;1605;295351;166509;28.5;16.1
57;2021-05-09;2049;1114;297400;167623;28.7;16.2
57;2021-05-10;5129;3067;302529;170690;29.2;16.5
57;2021-05-11;7453;2852;309982;173542;29.9;16.8
57;2021-05-12;7843;3249;317825;176791;30.7;17.1
57;2021-05-13;4509;915;322334;177706;31.1;17.2
57;2021-05-14;7840;2633;330174;180339;31.9;17.4
57;2021-05-15;5965;2048;336139;182387;32.5;17.6
57;2021-05-16;3307;578;339446;182965;32.8;17.7
57;2021-05-17;3867;2064;343313;185029;33.1;17.9
57;2021-05-18;6292;2105;349605;187134;33.8;18.1
57;2021-05-19;7018;2327;356623;189461;34.4;18.3
57;2021-05-20;6047;2180;362670;191641;35.0;18.5
57;2021-05-21;7563;2925;370233;194566;35.7;18.8
57;2021-05-22;4895;2170;375128;196736;36.2;19.0
57;2021-05-23;1964;429;377092;197165;36.4;19.0
57;2021-05-24;3027;1060;380119;198225;36.7;19.1
57;2021-05-25;5571;2806;385690;201031;37.2;19.4
57;2021-05-26;6375;3178;392065;204209;37.8;19.7
57;2021-05-27;5794;3124;397859;207333;38.4;20.0
57;2021-05-28;7024;4739;404883;212072;39.1;20.5
57;2021-05-29;5220;4243;410103;216315;39.6;20.9
57;2021-05-30;1968;1743;412071;218058;39.8;21.1
57;2021-05-31;4315;3340;416386;221398;40.2;21.4
57;2021-06-01;5934;3718;422320;225116;40.8;21.7
57;2021-06-02;6339;3906;428659;229022;41.4;22.1
57;2021-06-03;6209;3702;434868;232724;42.0;22.5
57;2021-06-04;7569;4993;442437;237717;42.7;22.9
57;2021-06-05;4764;4032;447201;241749;43.2;23.3
57;2021-06-06;1992;890;449193;242639;43.4;23.4
57;2021-06-07;4316;4035;453509;246674;43.8;23.8
57;2021-06-08;6721;4314;460230;250988;44.4;24.2
57;2021-06-09;6876;4156;467106;255144;45.1;24.6
57;2021-06-10;6218;4598;473324;259742;45.7;25.1
57;2021-06-11;5360;5367;478684;265109;46.2;25.6
57;2021-06-12;5741;4452;484425;269561;46.8;26.0
57;2021-06-13;1500;1142;485925;270703;46.9;26.1
57;2021-06-14;3381;4698;489306;275401;47.2;26.6
57;2021-06-15;3815;6024;493121;281425;47.6;27.2
57;2021-06-16;4400;6596;497521;288021;48.0;27.8
57;2021-06-17;4202;6073;501723;294094;48.4;28.4
57;2021-06-18;4273;7308;505996;301402;48.8;29.1
57;2021-06-19;4158;6292;510154;307694;49.2;29.7
57;2021-06-20;986;1665;511140;309359;49.3;29.9
57;2021-06-21;2065;5966;513205;315325;49.5;30.4
57;2021-06-22;2644;7987;515849;323312;49.8;31.2
57;2021-06-23;3071;8385;518920;331697;50.1;32.0
57;2021-06-24;2457;5289;521377;336986;50.3;32.5
57;2021-06-25;2856;7826;524233;344812;50.6;33.3
57;2021-06-26;2872;7259;527105;352071;50.9;34.0
57;2021-06-27;752;2985;527857;355056;51.0;34.3
57;2021-06-28;1591;5079;529448;360135;51.1;34.8
57;2021-06-29;2081;6832;531529;366967;51.3;35.4
57;2021-06-30;3069;7321;534598;374288;51.6;36.1
57;2021-07-01;2707;5957;537305;380245;51.9;36.7
57;2021-07-02;2697;8073;540002;388318;52.1;37.5
57;2021-07-03;3238;6528;543240;394846;52.4;38.1
57;2021-07-04;942;2467;544182;397313;52.5;38.4
57;2021-07-05;1713;4608;545895;401921;52.7;38.8
57;2021-07-06;2425;6480;548320;408401;52.9;39.4
57;2021-07-07;2734;7088;551054;415489;53.2;40.1
57;2021-07-08;2495;5876;553549;421365;53.4;40.7
57;2021-07-09;3424;8415;556973;429780;53.8;41.5
57;2021-07-10;3096;6943;560069;436723;54.1;42.2
57;2021-07-11;854;2233;560923;438956;54.2;42.4
57;2021-07-12;2441;6433;563364;445389;54.4;43.0
57;2021-07-13;4415;7507;567779;452896;54.8;43.7
57;2021-07-14;2823;3845;570602;456741;55.1;44.1
57;2021-07-15;3962;7790;574564;464531;55.5;44.8
57;2021-07-16;5643;9831;580207;474362;56.0;45.8
57;2021-07-17;5824;7287;586031;481649;56.6;46.5
57;2021-07-18;1491;2660;587522;484309;56.7;46.8
57;2021-07-19;2375;6201;589897;490510;56.9;47.4
57;2021-07-20;4333;6915;594230;497425;57.4;48.0
57;2021-07-21;5304;6909;599534;504334;57.9;48.7
57;2021-07-22;5982;5958;605516;510292;58.5;49.3
57;2021-07-23;7016;6408;612532;516700;59.1;49.9
57;2021-07-24;4536;7037;617068;523737;59.6;50.6
57;2021-07-25;1334;1770;618402;525507;59.7;50.7
57;2021-07-26;3724;4496;622126;530003;60.1;51.2
57;2021-07-27;6868;4954;628994;534957;60.7;51.6
57;2021-07-28;7490;4568;636484;539525;61.4;52.1
57;2021-07-29;7639;4603;644123;544128;62.2;52.5
57;2021-07-30;6874;4900;650997;549028;62.8;53.0
57;2021-07-31;5708;5026;656705;554054;63.4;53.5
57;2021-08-01;2027;1116;658732;555170;63.6;53.6
57;2021-08-02;3543;3183;662275;558353;63.9;53.9
57;2021-08-03;5804;4285;668079;562638;64.5;54.3
57;2021-08-04;5229;3465;673308;566103;65.0;54.7
57;2021-08-05;5377;3786;678685;569889;65.5;55.0
57;2021-08-06;5625;4858;684310;574747;66.1;55.5
57;2021-08-07;4585;5171;688895;579918;66.5;56.0
57;2021-08-08;1480;1507;690375;581425;66.6;56.1
57;2021-08-09;2625;3177;693000;584602;66.9;56.4
57;2021-08-10;3520;3788;696520;588390;67.2;56.8
57;2021-08-11;3726;4024;700246;592414;67.6;57.2
57;2021-08-12;3161;5217;703407;597631;67.9;57.7
57;2021-08-13;3497;4733;706904;602364;68.2;58.2
57;2021-08-14;2166;5186;709070;607550;68.5;58.7
57;2021-08-15;529;1093;709599;608643;68.5;58.8
57;2021-08-16;1791;3569;711390;612212;68.7;59.1
57;2021-08-17;2381;5355;713771;617567;68.9;59.6
57;2021-08-18;2474;5375;716245;622942;69.1;60.1
57;2021-08-19;2214;5486;718459;628428;69.4;60.7
57;2021-08-20;2059;6034;720518;634462;69.6;61.2
57;2021-08-21;1874;5396;722392;639858;69.7;61.8
57;2021-08-22;454;1530;722846;641388;69.8;61.9
57;2021-08-23;1144;3719;723990;645107;69.9;62.3
57;2021-08-24;1817;5615;725807;650722;70.1;62.8
57;2021-08-25;1619;5319;727426;656041;70.2;63.3
57;2021-08-26;1609;4674;729035;660715;70.4;63.8
57;2021-08-27;1770;5897;730805;666612;70.6;64.4
57;2021-08-28;2013;5386;732818;671998;70.7;64.9
57;2021-08-29;342;1090;733160;673088;70.8;65.0
57;2021-08-30;1033;3209;734193;676297;70.9;65.3
57;2021-08-31;1554;4295;735747;680592;71.0;65.7
57;2021-09-01;1470;3844;737217;684436;71.2;66.1
57;2021-09-02;1179;3106;738396;687542;71.3;66.4
57;2021-09-03;1571;3957;739967;691499;71.4;66.8
57;2021-09-04;1688;3743;741655;695242;71.6;67.1
57;2021-09-05;383;847;742038;696089;71.6;67.2
57;2021-09-06;779;1771;742817;697860;71.7;67.4
57;2021-09-07;707;1857;743524;699717;71.8;67.5
57;2021-09-08;941;2507;744465;702224;71.9;67.8
57;2021-09-09;614;1970;745079;704194;71.9;68.0
57;2021-09-10;1083;2471;746162;706665;72.0;68.2
57;2021-09-11;1185;2976;747347;709641;72.1;68.5
57;2021-09-12;249;491;747596;710132;72.2;68.6
57;2021-09-13;590;1350;748186;711482;72.2;68.7
57;2021-09-14;783;1703;748969;713185;72.3;68.8
57;2021-09-15;779;1995;749748;715180;72.4;69.0
57;2021-09-16;717;1230;750465;716410;72.4;69.2
57;2021-09-17;1137;1791;751602;718201;72.6;69.3
57;2021-09-18;813;2586;752415;720787;72.6;69.6
57;2021-09-19;121;346;752536;721133;72.6;69.6
57;2021-09-20;413;865;752949;721998;72.7;69.7
57;2021-09-21;512;828;753461;722826;72.7;69.8
57;2021-09-22;496;1307;753957;724133;72.8;69.9
57;2021-09-23;487;1219;754444;725352;72.8;70.0
57;2021-09-24;753;1438;755197;726790;72.9;70.2
57;2021-09-25;505;1999;755702;728789;73.0;70.4
57;2021-09-26;122;328;755824;729117;73.0;70.4
57;2021-09-27;443;848;756267;729965;73.0;70.5
57;2021-09-28;316;600;756583;730565;73.0;70.5
57;2021-09-29;557;1111;757140;731676;73.1;70.6
57;2021-09-30;292;618;757432;732294;73.1;70.7
57;2021-10-01;522;1329;757954;733623;73.2;70.8
57;2021-10-02;663;1565;758617;735188;73.2;71.0
57;2021-10-03;121;232;758738;735420;73.2;71.0
57;2021-10-04;364;618;759102;736038;73.3;71.1
57;2021-10-05;287;577;759389;736615;73.3;71.1
57;2021-10-06;456;772;759845;737387;73.4;71.2
57;2021-10-07;314;627;760159;738014;73.4;71.2
57;2021-10-08;503;1037;760662;739051;73.4;71.3
57;2021-10-09;607;1154;761269;740205;73.5;71.5
57;2021-10-10;101;121;761370;740326;73.5;71.5
57;2021-10-11;340;611;761710;740937;73.5;71.5
57;2021-10-12;304;463;762014;741400;73.6;71.6
57;2021-10-13;554;719;762568;742119;73.6;71.6
57;2021-10-14;315;483;762883;742602;73.6;71.7
57;2021-10-15;589;1021;763472;743623;73.7;71.8
57;2021-10-16;651;731;764123;744354;73.8;71.9
57;2021-10-17;101;133;764224;744487;73.8;71.9
57;2021-10-18;387;529;764611;745016;73.8;71.9
57;2021-10-19;307;394;764918;745410;73.8;72.0
58;2020-12-27;0;0;0;0;0.0;0.0
58;2020-12-28;0;0;0;0;0.0;0.0
58;2020-12-29;1;0;1;0;0.0;0.0
58;2020-12-30;0;0;1;0;0.0;0.0
58;2020-12-31;0;0;1;0;0.0;0.0
58;2021-01-01;0;0;1;0;0.0;0.0
58;2021-01-02;0;0;1;0;0.0;0.0
58;2021-01-03;1;0;2;0;0.0;0.0
58;2021-01-04;0;0;2;0;0.0;0.0
58;2021-01-05;2;0;4;0;0.0;0.0
58;2021-01-06;145;0;149;0;0.1;0.0
58;2021-01-07;241;0;390;0;0.2;0.0
58;2021-01-08;63;0;453;0;0.2;0.0
58;2021-01-09;1;0;454;0;0.2;0.0
58;2021-01-10;0;0;454;0;0.2;0.0
58;2021-01-11;55;0;509;0;0.3;0.0
58;2021-01-12;260;0;769;0;0.4;0.0
58;2021-01-13;412;4;1181;4;0.6;0.0
58;2021-01-14;292;2;1473;6;0.7;0.0
58;2021-01-15;143;0;1616;6;0.8;0.0
58;2021-01-16;10;1;1626;7;0.8;0.0
58;2021-01-17;0;0;1626;7;0.8;0.0
58;2021-01-18;414;1;2040;8;1.0;0.0
58;2021-01-19;987;3;3027;11;1.5;0.0
58;2021-01-20;1208;2;4235;13;2.1;0.0
58;2021-01-21;962;5;5197;18;2.6;0.0
58;2021-01-22;779;3;5976;21;3.0;0.0
58;2021-01-23;253;0;6229;21;3.1;0.0
58;2021-01-24;2;0;6231;21;3.1;0.0
58;2021-01-25;439;1;6670;22;3.3;0.0
58;2021-01-26;651;4;7321;26;3.7;0.0
58;2021-01-27;604;44;7925;70;4.0;0.0
58;2021-01-28;758;66;8683;136;4.4;0.1
58;2021-01-29;838;7;9521;143;4.8;0.1
58;2021-01-30;281;0;9802;143;4.9;0.1
58;2021-01-31;10;0;9812;143;4.9;0.1
58;2021-02-01;200;73;10012;216;5.0;0.1
58;2021-02-02;566;83;10578;299;5.3;0.1
58;2021-02-03;280;147;10858;446;5.4;0.2
58;2021-02-04;284;93;11142;539;5.6;0.3
58;2021-02-05;184;93;11326;632;5.7;0.3
58;2021-02-06;89;0;11415;632;5.7;0.3
58;2021-02-07;0;0;11415;632;5.7;0.3
58;2021-02-08;306;72;11721;704;5.9;0.4
58;2021-02-09;503;315;12224;1019;6.1;0.5
58;2021-02-10;350;379;12574;1398;6.3;0.7
58;2021-02-11;287;381;12861;1779;6.4;0.9
58;2021-02-12;243;204;13104;1983;6.6;1.0
58;2021-02-13;84;29;13188;2012;6.6;1.0
58;2021-02-14;0;3;13188;2015;6.6;1.0
58;2021-02-15;114;526;13302;2541;6.7;1.3
58;2021-02-16;207;937;13509;3478;6.8;1.7
58;2021-02-17;221;760;13730;4238;6.9;2.1
58;2021-02-18;186;787;13916;5025;7.0;2.5
58;2021-02-19;238;722;14154;5747;7.1;2.9
58;2021-02-20;62;228;14216;5975;7.1;3.0
58;2021-02-21;0;30;14216;6005;7.1;3.0
58;2021-02-22;78;403;14294;6408;7.2;3.2
58;2021-02-23;49;617;14343;7025;7.2;3.5
58;2021-02-24;39;628;14382;7653;7.2;3.8
58;2021-02-25;252;702;14634;8355;7.3;4.2
58;2021-02-26;246;621;14880;8976;7.5;4.5
58;2021-02-27;104;189;14984;9165;7.5;4.6
58;2021-02-28;11;8;14995;9173;7.5;4.6
58;2021-03-01;145;246;15140;9419;7.6;4.7
58;2021-03-02;415;642;15555;10061;7.8;5.0
58;2021-03-03;523;295;16078;10356;8.1;5.2
58;2021-03-04;725;279;16803;10635;8.4;5.3
58;2021-03-05;866;205;17669;10840;8.9;5.4
58;2021-03-06;577;87;18246;10927;9.1;5.5
58;2021-03-07;63;12;18309;10939;9.2;5.5
58;2021-03-08;156;300;18465;11239;9.3;5.6
58;2021-03-09;545;548;19010;11787;9.5;5.9
58;2021-03-10;841;245;19851;12032;9.9;6.0
58;2021-03-11;858;277;20709;12309;10.4;6.2
58;2021-03-12;863;201;21572;12510;10.8;6.3
58;2021-03-13;506;67;22078;12577;11.1;6.3
58;2021-03-14;34;1;22112;12578;11.1;6.3
58;2021-03-15;531;118;22643;12696;11.3;6.4
58;2021-03-16;725;224;23368;12920;11.7;6.5
58;2021-03-17;755;198;24123;13118;12.1;6.6
58;2021-03-18;584;180;24707;13298;12.4;6.7
58;2021-03-19;540;108;25247;13406;12.6;6.7
58;2021-03-20;322;64;25569;13470;12.8;6.7
58;2021-03-21;17;1;25586;13471;12.8;6.7
58;2021-03-22;796;26;26382;13497;13.2;6.8
58;2021-03-23;1636;44;28018;13541;14.0;6.8
58;2021-03-24;1371;82;29389;13623;14.7;6.8
58;2021-03-25;1840;49;31229;13672;15.6;6.8
58;2021-03-26;1414;57;32643;13729;16.4;6.9
58;2021-03-27;358;8;33001;13737;16.5;6.9
58;2021-03-28;20;0;33021;13737;16.5;6.9
58;2021-03-29;636;154;33657;13891;16.9;7.0
58;2021-03-30;1187;260;34844;14151;17.5;7.1
58;2021-03-31;1116;396;35960;14547;18.0;7.3
58;2021-04-01;1547;407;37507;14954;18.8;7.5
58;2021-04-02;1464;369;38971;15323;19.5;7.7
58;2021-04-03;568;152;39539;15475;19.8;7.8
58;2021-04-04;1;1;39540;15476;19.8;7.8
58;2021-04-05;48;0;39588;15476;19.8;7.8
58;2021-04-06;823;347;40411;15823;20.2;7.9
58;2021-04-07;697;552;41108;16375;20.6;8.2
58;2021-04-08;1493;427;42601;16802;21.3;8.4
58;2021-04-09;1775;487;44376;17289;22.2;8.7
58;2021-04-10;650;202;45026;17491;22.6;8.8
58;2021-04-11;17;3;45043;17494;22.6;8.8
58;2021-04-12;1116;504;46159;17998;23.1;9.0
58;2021-04-13;1435;630;47594;18628;23.8;9.3
58;2021-04-14;1360;700;48954;19328;24.5;9.7
58;2021-04-15;1441;613;50395;19941;25.2;10.0
58;2021-04-16;1734;517;52129;20458;26.1;10.2
58;2021-04-17;721;234;52850;20692;26.5;10.4
58;2021-04-18;20;7;52870;20699;26.5;10.4
58;2021-04-19;530;606;53400;21305;26.8;10.7
58;2021-04-20;487;1120;53887;22425;27.0;11.2
58;2021-04-21;628;970;54515;23395;27.3;11.7
58;2021-04-22;768;1525;55283;24920;27.7;12.5
58;2021-04-23;919;787;56202;25707;28.2;12.9
58;2021-04-24;211;208;56413;25915;28.3;13.0
58;2021-04-25;109;9;56522;25924;28.3;13.0
58;2021-04-26;761;247;57283;26171;28.7;13.1
58;2021-04-27;1499;1120;58782;27291;29.5;13.7
58;2021-04-28;1536;1054;60318;28345;30.2;14.2
58;2021-04-29;1444;1048;61762;29393;30.9;14.7
58;2021-04-30;1258;943;63020;30336;31.6;15.2
58;2021-05-01;6;17;63026;30353;31.6;15.2
58;2021-05-02;4;2;63030;30355;31.6;15.2
58;2021-05-03;1042;407;64072;30762;32.1;15.4
58;2021-05-04;1073;1347;65145;32109;32.6;16.1
58;2021-05-05;955;1095;66100;33204;33.1;16.6
58;2021-05-06;1363;1061;67463;34265;33.8;17.2
58;2021-05-07;1111;1092;68574;35357;34.4;17.7
58;2021-05-08;59;60;68633;35417;34.4;17.7
58;2021-05-09;7;21;68640;35438;34.4;17.8
58;2021-05-10;875;992;69515;36430;34.8;18.3
58;2021-05-11;1183;1984;70698;38414;35.4;19.2
58;2021-05-12;1660;1558;72358;39972;36.3;20.0
58;2021-05-13;49;183;72407;40155;36.3;20.1
58;2021-05-14;2311;909;74718;41064;37.4;20.6
58;2021-05-15;1726;456;76444;41520;38.3;20.8
58;2021-05-16;118;33;76562;41553;38.4;20.8
58;2021-05-17;793;612;77355;42165;38.8;21.1
58;2021-05-18;1333;1182;78688;43347;39.4;21.7
58;2021-05-19;1738;548;80426;43895;40.3;22.0
58;2021-05-20;1701;674;82127;44569;41.1;22.3
58;2021-05-21;854;730;82981;45299;41.6;22.7
58;2021-05-22;304;240;83285;45539;41.7;22.8
58;2021-05-23;2;21;83287;45560;41.7;22.8
58;2021-05-24;21;42;83308;45602;41.7;22.8
58;2021-05-25;1386;1155;84694;46757;42.4;23.4
58;2021-05-26;845;839;85539;47596;42.9;23.8
58;2021-05-27;753;943;86292;48539;43.2;24.3
58;2021-05-28;429;909;86721;49448;43.4;24.8
58;2021-05-29;151;212;86872;49660;43.5;24.9
58;2021-05-30;21;19;86893;49679;43.5;24.9
58;2021-05-31;757;398;87650;50077;43.9;25.1
58;2021-06-01;1372;1656;89022;51733;44.6;25.9
58;2021-06-02;1467;1048;90489;52781;45.3;26.4
58;2021-06-03;1024;958;91513;53739;45.8;26.9
58;2021-06-04;842;909;92355;54648;46.3;27.4
58;2021-06-05;272;263;92627;54911;46.4;27.5
58;2021-06-06;26;50;92653;54961;46.4;27.5
58;2021-06-07;712;793;93365;55754;46.8;27.9
58;2021-06-08;1321;1758;94686;57512;47.4;28.8
58;2021-06-09;1417;1009;96103;58521;48.1;29.3
58;2021-06-10;1106;982;97209;59503;48.7;29.8
58;2021-06-11;1023;907;98232;60410;49.2;30.3
58;2021-06-12;1056;415;99288;60825;49.7;30.5
58;2021-06-13;36;33;99324;60858;49.8;30.5
58;2021-06-14;516;1016;99840;61874;50.0;31.0
58;2021-06-15;1592;1757;101432;63631;50.8;31.9
58;2021-06-16;1806;994;103238;64625;51.7;32.4
58;2021-06-17;2023;1109;105261;65734;52.7;32.9
58;2021-06-18;986;1061;106247;66795;53.2;33.5
58;2021-06-19;581;320;106828;67115;53.5;33.6
58;2021-06-20;9;2;106837;67117;53.5;33.6
58;2021-06-21;472;553;107309;67670;53.8;33.9
58;2021-06-22;1028;1965;108337;69635;54.3;34.9
58;2021-06-23;1477;1511;109814;71146;55.0;35.6
58;2021-06-24;729;1024;110543;72170;55.4;36.2
58;2021-06-25;824;1719;111367;73889;55.8;37.0
58;2021-06-26;554;1228;111921;75117;56.1;37.6
58;2021-06-27;18;26;111939;75143;56.1;37.6
58;2021-06-28;463;987;112402;76130;56.3;38.1
58;2021-06-29;623;2160;113025;78290;56.6;39.2
58;2021-06-30;999;1627;114024;79917;57.1;40.0
58;2021-07-01;760;1674;114784;81591;57.5;40.9
58;2021-07-02;444;851;115228;82442;57.7;41.3
58;2021-07-03;249;512;115477;82954;57.9;41.6
58;2021-07-04;12;30;115489;82984;57.9;41.6
58;2021-07-05;510;768;115999;83752;58.1;42.0
58;2021-07-06;695;2121;116694;85873;58.5;43.0
58;2021-07-07;388;955;117082;86828;58.7;43.5
58;2021-07-08;399;1019;117481;87847;58.9;44.0
58;2021-07-09;709;1422;118190;89269;59.2;44.7
58;2021-07-10;262;412;118452;89681;59.3;44.9
58;2021-07-11;175;53;118627;89734;59.4;45.0
58;2021-07-12;197;968;118824;90702;59.5;45.4
58;2021-07-13;933;2503;119757;93205;60.0;46.7
58;2021-07-14;27;60;119784;93265;60.0;46.7
58;2021-07-15;1135;1936;120919;95201;60.6;47.7
58;2021-07-16;1411;1446;122330;96647;61.3;48.4
58;2021-07-17;463;289;122793;96936;61.5;48.6
58;2021-07-18;102;21;122895;96957;61.6;48.6
58;2021-07-19;1655;987;124550;97944;62.4;49.1
58;2021-07-20;1408;2455;125958;100399;63.1;50.3
58;2021-07-21;1178;2010;127136;102409;63.7;51.3
58;2021-07-22;1143;1670;128279;104079;64.3;52.1
58;2021-07-23;1268;1446;129547;105525;64.9;52.9
58;2021-07-24;1000;1272;130547;106797;65.4;53.5
58;2021-07-25;89;40;130636;106837;65.5;53.5
58;2021-07-26;980;860;131616;107697;65.9;54.0
58;2021-07-27;1566;2569;133182;110266;66.7;55.2
58;2021-07-28;1570;1974;134752;112240;67.5;56.2
58;2021-07-29;1581;1629;136333;113869;68.3;57.0
58;2021-07-30;1466;1427;137799;115296;69.0;57.8
58;2021-07-31;568;525;138367;115821;69.3;58.0
58;2021-08-01;35;13;138402;115834;69.3;58.0
58;2021-08-02;1589;863;139991;116697;70.1;58.5
58;2021-08-03;2051;1781;142042;118478;71.2;59.4
58;2021-08-04;1307;1185;143349;119663;71.8;60.0
58;2021-08-05;1621;1175;144970;120838;72.6;60.5
58;2021-08-06;1360;1032;146330;121870;73.3;61.1
58;2021-08-07;318;401;146648;122271;73.5;61.3
58;2021-08-08;30;58;146678;122329;73.5;61.3
58;2021-08-09;1083;1387;147761;123716;74.0;62.0
58;2021-08-10;1778;1388;149539;125104;74.9;62.7
58;2021-08-11;1134;780;150673;125884;75.5;63.1
58;2021-08-12;1067;1109;151740;126993;76.0;63.6
58;2021-08-13;930;955;152670;127948;76.5;64.1
58;2021-08-14;232;317;152902;128265;76.6;64.3
58;2021-08-15;14;27;152916;128292;76.6;64.3
58;2021-08-16;311;1402;153227;129694;76.8;65.0
58;2021-08-17;805;1337;154032;131031;77.2;65.6
58;2021-08-18;767;1171;154799;132202;77.6;66.2
58;2021-08-19;731;1342;155530;133544;77.9;66.9
58;2021-08-20;708;1298;156238;134842;78.3;67.6
58;2021-08-21;254;476;156492;135318;78.4;67.8
58;2021-08-22;9;86;156501;135404;78.4;67.8
58;2021-08-23;418;816;156919;136220;78.6;68.2
58;2021-08-24;513;1481;157432;137701;78.9;69.0
58;2021-08-25;436;1542;157868;139243;79.1;69.8
58;2021-08-26;553;1731;158421;140974;79.4;70.6
58;2021-08-27;494;1565;158915;142539;79.6;71.4
58;2021-08-28;244;640;159159;143179;79.7;71.7
58;2021-08-29;9;42;159168;143221;79.7;71.8
58;2021-08-30;356;783;159524;144004;79.9;72.1
58;2021-08-31;493;1531;160017;145535;80.2;72.9
58;2021-09-01;429;1495;160446;147030;80.4;73.7
58;2021-09-02;291;1238;160737;148268;80.5;74.3
58;2021-09-03;364;1323;161101;149591;80.7;74.9
58;2021-09-04;206;637;161307;150228;80.8;75.3
58;2021-09-05;5;27;161312;150255;80.8;75.3
58;2021-09-06;117;395;161429;150650;80.9;75.5
58;2021-09-07;320;810;161749;151460;81.0;75.9
58;2021-09-08;240;1036;161989;152496;81.2;76.4
58;2021-09-09;248;472;162237;152968;81.3;76.6
58;2021-09-10;260;682;162497;153650;81.4;77.0
58;2021-09-11;128;440;162625;154090;81.5;77.2
58;2021-09-12;5;6;162630;154096;81.5;77.2
58;2021-09-13;207;439;162837;154535;81.6;77.4
58;2021-09-14;291;664;163128;155199;81.7;77.8
58;2021-09-15;189;573;163317;155772;81.8;78.0
58;2021-09-16;205;451;163522;156223;81.9;78.3
58;2021-09-17;197;376;163719;156599;82.0;78.5
58;2021-09-18;118;362;163837;156961;82.1;78.6
58;2021-09-19;5;4;163842;156965;82.1;78.6
58;2021-09-20;174;231;164016;157196;82.2;78.8
58;2021-09-21;139;421;164155;157617;82.2;79.0
58;2021-09-22;161;535;164316;158152;82.3;79.2
58;2021-09-23;135;288;164451;158440;82.4;79.4
58;2021-09-24;113;391;164564;158831;82.4;79.6
58;2021-09-25;93;374;164657;159205;82.5;79.8
58;2021-09-26;6;13;164663;159218;82.5;79.8
58;2021-09-27;91;233;164754;159451;82.5;79.9
58;2021-09-28;126;330;164880;159781;82.6;80.1
58;2021-09-29;99;346;164979;160127;82.7;80.2
58;2021-09-30;67;217;165046;160344;82.7;80.3
58;2021-10-01;89;220;165135;160564;82.7;80.4
58;2021-10-02;85;220;165220;160784;82.8;80.6
58;2021-10-03;0;6;165220;160790;82.8;80.6
58;2021-10-04;61;204;165281;160994;82.8;80.7
58;2021-10-05;136;326;165417;161320;82.9;80.8
58;2021-10-06;65;310;165482;161630;82.9;81.0
58;2021-10-07;90;161;165572;161791;83.0;81.1
58;2021-10-08;105;224;165677;162015;83.0;81.2
58;2021-10-09;59;139;165736;162154;83.0;81.2
58;2021-10-10;3;8;165739;162162;83.0;81.2
58;2021-10-11;57;161;165796;162323;83.1;81.3
58;2021-10-12;109;212;165905;162535;83.1;81.4
58;2021-10-13;147;256;166052;162791;83.2;81.6
58;2021-10-14;68;233;166120;163024;83.2;81.7
58;2021-10-15;80;100;166200;163124;83.3;81.7
58;2021-10-16;63;142;166263;163266;83.3;81.8
58;2021-10-17;2;4;166265;163270;83.3;81.8
58;2021-10-18;34;64;166299;163334;83.3;81.8
58;2021-10-19;74;95;166373;163429;83.4;81.9
59;2020-12-27;1;0;1;0;0.0;0.0
59;2020-12-28;27;0;28;0;0.0;0.0
59;2020-12-29;0;0;28;0;0.0;0.0
59;2020-12-30;0;0;28;0;0.0;0.0
59;2020-12-31;2;0;30;0;0.0;0.0
59;2021-01-01;3;0;33;0;0.0;0.0
59;2021-01-02;4;0;37;0;0.0;0.0
59;2021-01-03;4;0;41;0;0.0;0.0
59;2021-01-04;79;0;120;0;0.0;0.0
59;2021-01-05;217;0;337;0;0.0;0.0
59;2021-01-06;428;2;765;2;0.0;0.0
59;2021-01-07;1314;1;2079;3;0.1;0.0
59;2021-01-08;1263;10;3342;13;0.1;0.0
59;2021-01-09;607;3;3949;16;0.2;0.0
59;2021-01-10;431;1;4380;17;0.2;0.0
59;2021-01-11;1846;7;6226;24;0.2;0.0
59;2021-01-12;2489;2;8715;26;0.3;0.0
59;2021-01-13;2370;3;11085;29;0.4;0.0
59;2021-01-14;2759;28;13844;57;0.5;0.0
59;2021-01-15;2275;17;16119;74;0.6;0.0
59;2021-01-16;771;3;16890;77;0.7;0.0
59;2021-01-17;560;4;17450;81;0.7;0.0
59;2021-01-18;3511;15;20961;96;0.8;0.0
59;2021-01-19;4760;12;25721;108;1.0;0.0
59;2021-01-20;4136;13;29857;121;1.2;0.0
59;2021-01-21;4732;42;34589;163;1.3;0.0
59;2021-01-22;4027;14;38616;177;1.5;0.0
59;2021-01-23;1217;3;39833;180;1.5;0.0
59;2021-01-24;170;0;40003;180;1.5;0.0
59;2021-01-25;2730;60;42733;240;1.7;0.0
59;2021-01-26;2826;140;45559;380;1.8;0.0
59;2021-01-27;1736;307;47295;687;1.8;0.0
59;2021-01-28;3399;763;50694;1450;2.0;0.1
59;2021-01-29;2544;798;53238;2248;2.1;0.1
59;2021-01-30;288;174;53526;2422;2.1;0.1
59;2021-01-31;24;0;53550;2422;2.1;0.1
59;2021-02-01;79;863;53629;3285;2.1;0.1
59;2021-02-02;691;1464;54320;4749;2.1;0.2
59;2021-02-03;3755;1461;58075;6210;2.2;0.2
59;2021-02-04;2968;1736;61043;7946;2.4;0.3
59;2021-02-05;1072;1408;62115;9354;2.4;0.4
59;2021-02-06;208;353;62323;9707;2.4;0.4
59;2021-02-07;268;49;62591;9756;2.4;0.4
59;2021-02-08;684;1608;63275;11364;2.4;0.4
59;2021-02-09;1016;1840;64291;13204;2.5;0.5
59;2021-02-10;975;1626;65266;14830;2.5;0.6
59;2021-02-11;1349;1809;66615;16639;2.6;0.6
59;2021-02-12;1416;1645;68031;18284;2.6;0.7
59;2021-02-13;208;740;68239;19024;2.6;0.7
59;2021-02-14;14;42;68253;19066;2.6;0.7
59;2021-02-15;1397;3098;69650;22164;2.7;0.9
59;2021-02-16;1440;3758;71090;25922;2.7;1.0
59;2021-02-17;1624;3814;72714;29736;2.8;1.1
59;2021-02-18;3107;5183;75821;34919;2.9;1.3
59;2021-02-19;3208;3619;79029;38538;3.1;1.5
59;2021-02-20;1413;1583;80442;40121;3.1;1.5
59;2021-02-21;241;263;80683;40384;3.1;1.6
59;2021-02-22;1432;2566;82115;42950;3.2;1.7
59;2021-02-23;2658;2869;84773;45819;3.3;1.8
59;2021-02-24;4107;4072;88880;49891;3.4;1.9
59;2021-02-25;6921;3734;95801;53625;3.7;2.1
59;2021-02-26;6499;1897;102300;55522;4.0;2.1
59;2021-02-27;3095;194;105395;55716;4.1;2.2
59;2021-02-28;208;60;105603;55776;4.1;2.2
59;2021-03-01;3692;672;109295;56448;4.2;2.2
59;2021-03-02;4795;577;114090;57025;4.4;2.2
59;2021-03-03;5749;1020;119839;58045;4.6;2.2
59;2021-03-04;7087;968;126926;59013;4.9;2.3
59;2021-03-05;7841;1015;134767;60028;5.2;2.3
59;2021-03-06;11561;566;146328;60594;5.7;2.3
59;2021-03-07;7588;364;153916;60958;5.9;2.4
59;2021-03-08;4498;1122;158414;62080;6.1;2.4
59;2021-03-09;6578;1455;164992;63535;6.4;2.5
59;2021-03-10;7026;1218;172018;64753;6.6;2.5
59;2021-03-11;9474;1912;181492;66665;7.0;2.6
59;2021-03-12;12159;1587;193651;68252;7.5;2.6
59;2021-03-13;16559;1134;210210;69386;8.1;2.7
59;2021-03-14;6963;345;217173;69731;8.4;2.7
59;2021-03-15;5613;1514;222786;71245;8.6;2.8
59;2021-03-16;3739;1342;226525;72587;8.7;2.8
59;2021-03-17;3857;2106;230382;74693;8.9;2.9
59;2021-03-18;3960;2518;234342;77211;9.1;3.0
59;2021-03-19;7743;1847;242085;79058;9.4;3.1
59;2021-03-20;16020;1301;258105;80359;10.0;3.1
59;2021-03-21;6319;458;264424;80817;10.2;3.1
59;2021-03-22;5449;1789;269873;82606;10.4;3.2
59;2021-03-23;7774;2839;277647;85445;10.7;3.3
59;2021-03-24;6861;2995;284508;88440;11.0;3.4
59;2021-03-25;10535;2590;295043;91030;11.4;3.5
59;2021-03-26;12254;2864;307297;93894;11.9;3.6
59;2021-03-27;15274;1171;322571;95065;12.5;3.7
59;2021-03-28;7985;368;330556;95433;12.8;3.7
59;2021-03-29;5494;3215;336050;98648;13.0;3.8
59;2021-03-30;7540;3765;343590;102413;13.3;4.0
59;2021-03-31;6157;4126;349747;106539;13.5;4.1
59;2021-04-01;7493;4936;357240;111475;13.8;4.3
59;2021-04-02;7645;5533;364885;117008;14.1;4.5
59;2021-04-03;13018;4315;377903;121323;14.6;4.7
59;2021-04-04;5348;2192;383251;123515;14.8;4.8
59;2021-04-05;6021;1544;389272;125059;15.0;4.8
59;2021-04-06;5404;4506;394676;129565;15.2;5.0
59;2021-04-07;7623;5458;402299;135023;15.5;5.2
59;2021-04-08;10393;5785;412692;140808;15.9;5.4
59;2021-04-09;13423;5959;426115;146767;16.5;5.7
59;2021-04-10;11478;6159;437593;152926;16.9;5.9
59;2021-04-11;4637;3570;442230;156496;17.1;6.0
59;2021-04-12;6304;4354;448534;160850;17.3;6.2
59;2021-04-13;8934;4806;457468;165656;17.7;6.4
59;2021-04-14;8789;4348;466257;170004;18.0;6.6
59;2021-04-15;10306;4862;476563;174866;18.4;6.8
59;2021-04-16;10880;5508;487443;180374;18.8;7.0
59;2021-04-17;7296;9086;494739;189460;19.1;7.3
59;2021-04-18;3234;4175;497973;193635;19.2;7.5
59;2021-04-19;5046;4302;503019;197937;19.4;7.6
59;2021-04-20;6897;4225;509916;202162;19.7;7.8
59;2021-04-21;6271;4437;516187;206599;19.9;8.0
59;2021-04-22;8612;5527;524799;212126;20.3;8.2
59;2021-04-23;8458;5710;533257;217836;20.6;8.4
59;2021-04-24;5537;8066;538794;225902;20.8;8.7
59;2021-04-25;3242;6081;542036;231983;20.9;9.0
59;2021-04-26;6493;3801;548529;235784;21.2;9.1
59;2021-04-27;8366;5208;556895;240992;21.5;9.3
59;2021-04-28;8767;6584;565662;247576;21.8;9.6
59;2021-04-29;9418;8588;575080;256164;22.2;9.9
59;2021-04-30;10608;8563;585688;264727;22.6;10.2
59;2021-05-01;11998;7611;597686;272338;23.1;10.5
59;2021-05-02;8642;6000;606328;278338;23.4;10.8
59;2021-05-03;9554;5072;615882;283410;23.8;10.9
59;2021-05-04;11428;6018;627310;289428;24.2;11.2
59;2021-05-05;10294;6229;637604;295657;24.6;11.4
59;2021-05-06;11199;8465;648803;304122;25.1;11.7
59;2021-05-07;13297;9635;662100;313757;25.6;12.1
59;2021-05-08;14744;4180;676844;317937;26.1;12.3
59;2021-05-09;11492;3336;688336;321273;26.6;12.4
59;2021-05-10;12746;6660;701082;327933;27.1;12.7
59;2021-05-11;15112;8336;716194;336269;27.7;13.0
59;2021-05-12;16626;8653;732820;344922;28.3;13.3
59;2021-05-13;18441;3462;751261;348384;29.0;13.5
59;2021-05-14;15783;6972;767044;355356;29.6;13.7
59;2021-05-15;23444;5296;790488;360652;30.5;13.9
59;2021-05-16;21176;2417;811664;363069;31.4;14.0
59;2021-05-17;15066;5274;826730;368343;31.9;14.2
59;2021-05-18;16924;5678;843654;374021;32.6;14.4
59;2021-05-19;18319;5115;861973;379136;33.3;14.6
59;2021-05-20;17934;6996;879907;386132;34.0;14.9
59;2021-05-21;18370;8286;898277;394418;34.7;15.2
59;2021-05-22;23812;5687;922089;400105;35.6;15.5
59;2021-05-23;17922;2276;940011;402381;36.3;15.5
59;2021-05-24;16691;2145;956702;404526;37.0;15.6
59;2021-05-25;14990;6673;971692;411199;37.5;15.9
59;2021-05-26;15894;7046;987586;418245;38.1;16.2
59;2021-05-27;16151;9178;1003737;427423;38.8;16.5
59;2021-05-28;15886;11476;1019623;438899;39.4;17.0
59;2021-05-29;14370;8713;1033993;447612;39.9;17.3
59;2021-05-30;8406;1840;1042399;449452;40.3;17.4
59;2021-05-31;14203;7979;1056602;457431;40.8;17.7
59;2021-06-01;15085;10423;1071687;467854;41.4;18.1
59;2021-06-02;14770;9933;1086457;477787;42.0;18.5
59;2021-06-03;15629;12140;1102086;489927;42.6;18.9
59;2021-06-04;15608;13479;1117694;503406;43.2;19.4
59;2021-06-05;14979;9348;1132673;512754;43.7;19.8
59;2021-06-06;8827;3207;1141500;515961;44.1;19.9
59;2021-06-07;10527;9435;1152027;525396;44.5;20.3
59;2021-06-08;11760;11091;1163787;536487;45.0;20.7
59;2021-06-09;10758;11913;1174545;548400;45.4;21.2
59;2021-06-10;11504;12330;1186049;560730;45.8;21.7
59;2021-06-11;10972;15994;1197021;576724;46.2;22.3
59;2021-06-12;11069;13684;1208090;590408;46.7;22.8
59;2021-06-13;6344;7029;1214434;597437;46.9;23.1
59;2021-06-14;6506;12692;1220940;610129;47.2;23.6
59;2021-06-15;8231;15956;1229171;626085;47.5;24.2
59;2021-06-16;9205;13553;1238376;639638;47.8;24.7
59;2021-06-17;9187;15659;1247563;655297;48.2;25.3
59;2021-06-18;9081;20067;1256644;675364;48.5;26.1
59;2021-06-19;8953;17491;1265597;692855;48.9;26.8
59;2021-06-20;4900;10189;1270497;703044;49.1;27.2
59;2021-06-21;5279;15975;1275776;719019;49.3;27.8
59;2021-06-22;6336;18687;1282112;737706;49.5;28.5
59;2021-06-23;6168;19085;1288280;756791;49.8;29.2
59;2021-06-24;7338;20540;1295618;777331;50.0;30.0
59;2021-06-25;6508;21195;1302126;798526;50.3;30.8
59;2021-06-26;6489;23751;1308615;822277;50.5;31.8
59;2021-06-27;4752;17080;1313367;839357;50.7;32.4
59;2021-06-28;5004;19823;1318371;859180;50.9;33.2
59;2021-06-29;5549;20384;1323920;879564;51.1;34.0
59;2021-06-30;6134;20100;1330054;899664;51.4;34.7
59;2021-07-01;6772;20845;1336826;920509;51.6;35.6
59;2021-07-02;6836;23242;1343662;943751;51.9;36.5
59;2021-07-03;5561;24606;1349223;968357;52.1;37.4
59;2021-07-04;4415;15975;1353638;984332;52.3;38.0
59;2021-07-05;5673;17486;1359311;1001818;52.5;38.7
59;2021-07-06;6610;18801;1365921;1020619;52.8;39.4
59;2021-07-07;6940;17452;1372861;1038071;53.0;40.1
59;2021-07-08;8026;17699;1380887;1055770;53.3;40.8
59;2021-07-09;7705;20305;1388592;1076075;53.6;41.6
59;2021-07-10;7450;18540;1396042;1094615;53.9;42.3
59;2021-07-11;4448;10233;1400490;1104848;54.1;42.7
59;2021-07-12;5919;18049;1406409;1122897;54.3;43.4
59;2021-07-13;9910;20759;1416319;1143656;54.7;44.2
59;2021-07-14;9782;8457;1426101;1152113;55.1;44.5
59;2021-07-15;11638;20413;1437739;1172526;55.5;45.3
59;2021-07-16;13216;20514;1450955;1193040;56.0;46.1
59;2021-07-17;12399;17478;1463354;1210518;56.5;46.8
59;2021-07-18;7962;8684;1471316;1219202;56.8;47.1
59;2021-07-19;10404;16455;1481720;1235657;57.2;47.7
59;2021-07-20;13409;17127;1495129;1252784;57.7;48.4
59;2021-07-21;14528;15606;1509657;1268390;58.3;49.0
59;2021-07-22;17065;15229;1526722;1283619;59.0;49.6
59;2021-07-23;15729;15845;1542451;1299464;59.6;50.2
59;2021-07-24;16358;12316;1558809;1311780;60.2;50.7
59;2021-07-25;11916;7342;1570725;1319122;60.7;51.0
59;2021-07-26;13042;12625;1583767;1331747;61.2;51.4
59;2021-07-27;16229;11971;1599996;1343718;61.8;51.9
59;2021-07-28;17457;11681;1617453;1355399;62.5;52.4
59;2021-07-29;17424;11685;1634877;1367084;63.1;52.8
59;2021-07-30;15922;11622;1650799;1378706;63.8;53.3
59;2021-07-31;14022;9210;1664821;1387916;64.3;53.6
59;2021-08-01;9959;4575;1674780;1392491;64.7;53.8
59;2021-08-02;12215;10036;1686995;1402527;65.2;54.2
59;2021-08-03;13456;10063;1700451;1412590;65.7;54.6
59;2021-08-04;11240;8292;1711691;1420882;66.1;54.9
59;2021-08-05;12723;9796;1724414;1430678;66.6;55.3
59;2021-08-06;12561;11047;1736975;1441725;67.1;55.7
59;2021-08-07;9739;9302;1746714;1451027;67.5;56.0
59;2021-08-08;6960;5269;1753674;1456296;67.7;56.2
59;2021-08-09;8410;10832;1762084;1467128;68.1;56.7
59;2021-08-10;10404;10758;1772488;1477886;68.5;57.1
59;2021-08-11;8676;9322;1781164;1487208;68.8;57.4
59;2021-08-12;9004;12080;1790168;1499288;69.1;57.9
59;2021-08-13;8639;11755;1798807;1511043;69.5;58.4
59;2021-08-14;5953;10394;1804760;1521437;69.7;58.8
59;2021-08-15;3377;4666;1808137;1526103;69.8;58.9
59;2021-08-16;5878;13868;1814015;1539971;70.1;59.5
59;2021-08-17;6993;12768;1821008;1552739;70.3;60.0
59;2021-08-18;5958;11471;1826966;1564210;70.6;60.4
59;2021-08-19;6355;13875;1833321;1578085;70.8;61.0
59;2021-08-20;5838;14589;1839159;1592674;71.0;61.5
59;2021-08-21;4188;10296;1843347;1602970;71.2;61.9
59;2021-08-22;2852;7652;1846199;1610622;71.3;62.2
59;2021-08-23;4786;15736;1850985;1626358;71.5;62.8
59;2021-08-24;5302;15195;1856287;1641553;71.7;63.4
59;2021-08-25;4670;13087;1860957;1654640;71.9;63.9
59;2021-08-26;5210;14350;1866167;1668990;72.1;64.5
59;2021-08-27;5009;15433;1871176;1684423;72.3;65.1
59;2021-08-28;3809;12375;1874985;1696798;72.4;65.5
59;2021-08-29;1946;8437;1876931;1705235;72.5;65.9
59;2021-08-30;3896;12671;1880827;1717906;72.6;66.4
59;2021-08-31;3834;12400;1884661;1730306;72.8;66.8
59;2021-09-01;3315;9769;1887976;1740075;72.9;67.2
59;2021-09-02;3218;9911;1891194;1749986;73.0;67.6
59;2021-09-03;3833;10908;1895027;1760894;73.2;68.0
59;2021-09-04;3400;9395;1898427;1770289;73.3;68.4
59;2021-09-05;1243;3456;1899670;1773745;73.4;68.5
59;2021-09-06;2161;6202;1901831;1779947;73.5;68.8
59;2021-09-07;2264;6031;1904095;1785978;73.5;69.0
59;2021-09-08;2602;6547;1906697;1792525;73.6;69.2
59;2021-09-09;2448;5732;1909145;1798257;73.7;69.5
59;2021-09-10;3326;6794;1912471;1805051;73.9;69.7
59;2021-09-11;2600;7022;1915071;1812073;74.0;70.0
59;2021-09-12;913;2784;1915984;1814857;74.0;70.1
59;2021-09-13;1963;4264;1917947;1819121;74.1;70.3
59;2021-09-14;2354;4274;1920301;1823395;74.2;70.4
59;2021-09-15;2280;5369;1922581;1828764;74.3;70.6
59;2021-09-16;2193;4260;1924774;1833024;74.3;70.8
59;2021-09-17;2933;5461;1927707;1838485;74.5;71.0
59;2021-09-18;1790;5921;1929497;1844406;74.5;71.2
59;2021-09-19;386;1303;1929883;1845709;74.5;71.3
59;2021-09-20;1361;3303;1931244;1849012;74.6;71.4
59;2021-09-21;1341;2942;1932585;1851954;74.6;71.5
59;2021-09-22;1418;4743;1934003;1856697;74.7;71.7
59;2021-09-23;1524;2825;1935527;1859522;74.8;71.8
59;2021-09-24;1907;4243;1937434;1863765;74.8;72.0
59;2021-09-25;1159;4025;1938593;1867790;74.9;72.1
59;2021-09-26;314;1211;1938907;1869001;74.9;72.2
59;2021-09-27;1092;2534;1939999;1871535;74.9;72.3
59;2021-09-28;1076;2198;1941075;1873733;75.0;72.4
59;2021-09-29;1289;2960;1942364;1876693;75.0;72.5
59;2021-09-30;1241;2263;1943605;1878956;75.1;72.6
59;2021-10-01;1682;3398;1945287;1882354;75.1;72.7
59;2021-10-02;1465;3259;1946752;1885613;75.2;72.8
59;2021-10-03;262;632;1947014;1886245;75.2;72.9
59;2021-10-04;1081;1986;1948095;1888231;75.2;72.9
59;2021-10-05;1157;2171;1949252;1890402;75.3;73.0
59;2021-10-06;1262;2504;1950514;1892906;75.3;73.1
59;2021-10-07;976;1777;1951490;1894683;75.4;73.2
59;2021-10-08;1694;3311;1953184;1897994;75.4;73.3
59;2021-10-09;1315;2313;1954499;1900307;75.5;73.4
59;2021-10-10;285;450;1954784;1900757;75.5;73.4
59;2021-10-11;1044;1626;1955828;1902383;75.5;73.5
59;2021-10-12;1095;1678;1956923;1904061;75.6;73.5
59;2021-10-13;1226;1900;1958149;1905961;75.6;73.6
59;2021-10-14;950;1521;1959099;1907482;75.7;73.7
59;2021-10-15;1498;2548;1960597;1910030;75.7;73.8
59;2021-10-16;1185;1665;1961782;1911695;75.8;73.8
59;2021-10-17;271;342;1962053;1912037;75.8;73.9
59;2021-10-18;993;1223;1963046;1913260;75.8;73.9
59;2021-10-19;1015;1370;1964061;1914630;75.9;74.0
60;2020-12-27;0;0;0;0;0.0;0.0
60;2020-12-28;0;0;0;0;0.0;0.0
60;2020-12-29;1;0;1;0;0.0;0.0
60;2020-12-30;1;0;2;0;0.0;0.0
60;2020-12-31;0;0;2;0;0.0;0.0
60;2021-01-01;0;0;2;0;0.0;0.0
60;2021-01-02;5;0;7;0;0.0;0.0
60;2021-01-03;1;0;8;0;0.0;0.0
60;2021-01-04;1;0;9;0;0.0;0.0
60;2021-01-05;37;0;46;0;0.0;0.0
60;2021-01-06;188;4;234;4;0.0;0.0
60;2021-01-07;235;4;469;8;0.1;0.0
60;2021-01-08;380;4;849;12;0.1;0.0
60;2021-01-09;3;0;852;12;0.1;0.0
60;2021-01-10;60;0;912;12;0.1;0.0
60;2021-01-11;345;5;1257;17;0.2;0.0
60;2021-01-12;538;6;1795;23;0.2;0.0
60;2021-01-13;477;6;2272;29;0.3;0.0
60;2021-01-14;509;6;2781;35;0.3;0.0
60;2021-01-15;705;10;3486;45;0.4;0.0
60;2021-01-16;123;1;3609;46;0.4;0.0
60;2021-01-17;32;0;3641;46;0.4;0.0
60;2021-01-18;861;9;4502;55;0.5;0.0
60;2021-01-19;1207;14;5709;69;0.7;0.0
60;2021-01-20;1721;15;7430;84;0.9;0.0
60;2021-01-21;2266;14;9696;98;1.2;0.0
60;2021-01-22;1548;23;11244;121;1.4;0.0
60;2021-01-23;499;4;11743;125;1.4;0.0
60;2021-01-24;61;1;11804;126;1.4;0.0
60;2021-01-25;898;15;12702;141;1.5;0.0
60;2021-01-26;951;17;13653;158;1.7;0.0
60;2021-01-27;646;9;14299;167;1.7;0.0
60;2021-01-28;396;168;14695;335;1.8;0.0
60;2021-01-29;77;106;14772;441;1.8;0.1
60;2021-01-30;0;1;14772;442;1.8;0.1
60;2021-01-31;22;61;14794;503;1.8;0.1
60;2021-02-01;42;105;14836;608;1.8;0.1
60;2021-02-02;26;159;14862;767;1.8;0.1
60;2021-02-03;165;238;15027;1005;1.8;0.1
60;2021-02-04;170;339;15197;1344;1.8;0.2
60;2021-02-05;314;471;15511;1815;1.9;0.2
60;2021-02-06;65;79;15576;1894;1.9;0.2
60;2021-02-07;31;32;15607;1926;1.9;0.2
60;2021-02-08;330;516;15937;2442;1.9;0.3
60;2021-02-09;321;468;16258;2910;2.0;0.4
60;2021-02-10;557;993;16815;3903;2.0;0.5
60;2021-02-11;944;1133;17759;5036;2.2;0.6
60;2021-02-12;920;859;18679;5895;2.3;0.7
60;2021-02-13;92;309;18771;6204;2.3;0.8
60;2021-02-14;25;87;18796;6291;2.3;0.8
60;2021-02-15;614;805;19410;7096;2.4;0.9
60;2021-02-16;580;921;19990;8017;2.4;1.0
60;2021-02-17;632;934;20622;8951;2.5;1.1
60;2021-02-18;684;826;21306;9777;2.6;1.2
60;2021-02-19;641;763;21947;10540;2.7;1.3
60;2021-02-20;104;187;22051;10727;2.7;1.3
60;2021-02-21;23;121;22074;10848;2.7;1.3
60;2021-02-22;462;871;22536;11719;2.7;1.4
60;2021-02-23;534;783;23070;12502;2.8;1.5
60;2021-02-24;794;556;23864;13058;2.9;1.6
60;2021-02-25;1095;313;24959;13371;3.0;1.6
60;2021-02-26;1299;199;26258;13570;3.2;1.6
60;2021-02-27;669;36;26927;13606;3.3;1.6
60;2021-02-28;7;10;26934;13616;3.3;1.7
60;2021-03-01;895;50;27829;13666;3.4;1.7
60;2021-03-02;1012;169;28841;13835;3.5;1.7
60;2021-03-03;1324;460;30165;14295;3.7;1.7
60;2021-03-04;1726;528;31891;14823;3.9;1.8
60;2021-03-05;1823;304;33714;15127;4.1;1.8
60;2021-03-06;1920;151;35634;15278;4.3;1.9
60;2021-03-07;885;40;36519;15318;4.4;1.9
60;2021-03-08;980;319;37499;15637;4.5;1.9
60;2021-03-09;1644;364;39143;16001;4.7;1.9
60;2021-03-10;1938;436;41081;16437;5.0;2.0
60;2021-03-11;2325;390;43406;16827;5.3;2.0
60;2021-03-12;2597;555;46003;17382;5.6;2.1
60;2021-03-13;3838;218;49841;17600;6.0;2.1
60;2021-03-14;1782;65;51623;17665;6.3;2.1
60;2021-03-15;2093;506;53716;18171;6.5;2.2
60;2021-03-16;1585;633;55301;18804;6.7;2.3
60;2021-03-17;1657;626;56958;19430;6.9;2.4
60;2021-03-18;1760;743;58718;20173;7.1;2.4
60;2021-03-19;2591;536;61309;20709;7.4;2.5
60;2021-03-20;3242;202;64551;20911;7.8;2.5
60;2021-03-21;2123;99;66674;21010;8.1;2.5
60;2021-03-22;2132;721;68806;21731;8.3;2.6
60;2021-03-23;3309;732;72115;22463;8.7;2.7
60;2021-03-24;3071;881;75186;23344;9.1;2.8
60;2021-03-25;3848;864;79034;24208;9.6;2.9
60;2021-03-26;4218;883;83252;25091;10.1;3.0
60;2021-03-27;4142;329;87394;25420;10.6;3.1
60;2021-03-28;2450;87;89844;25507;10.9;3.1
60;2021-03-29;2612;1091;92456;26598;11.2;3.2
60;2021-03-30;3286;1081;95742;27679;11.6;3.4
60;2021-03-31;2669;1152;98411;28831;11.9;3.5
60;2021-04-01;2562;1105;100973;29936;12.2;3.6
60;2021-04-02;3310;1115;104283;31051;12.6;3.8
60;2021-04-03;3172;1019;107455;32070;13.0;3.9
60;2021-04-04;874;488;108329;32558;13.1;3.9
60;2021-04-05;458;85;108787;32643;13.2;4.0
60;2021-04-06;1969;1626;110756;34269;13.4;4.2
60;2021-04-07;1984;1759;112740;36028;13.7;4.4
60;2021-04-08;2610;1504;115350;37532;14.0;4.5
60;2021-04-09;2999;1532;118349;39064;14.3;4.7
60;2021-04-10;2927;1593;121276;40657;14.7;4.9
60;2021-04-11;1045;1002;122321;41659;14.8;5.0
60;2021-04-12;2044;1725;124365;43384;15.1;5.3
60;2021-04-13;2750;1790;127115;45174;15.4;5.5
60;2021-04-14;3144;1831;130259;47005;15.8;5.7
60;2021-04-15;3561;1903;133820;48908;16.2;5.9
60;2021-04-16;3288;1962;137108;50870;16.6;6.2
60;2021-04-17;2848;2177;139956;53047;17.0;6.4
60;2021-04-18;573;1833;140529;54880;17.0;6.7
60;2021-04-19;1743;2218;142272;57098;17.2;6.9
60;2021-04-20;2129;2679;144401;59777;17.5;7.2
60;2021-04-21;2653;2212;147054;61989;17.8;7.5
60;2021-04-22;2628;2515;149682;64504;18.1;7.8
60;2021-04-23;2651;2507;152333;67011;18.5;8.1
60;2021-04-24;2470;3461;154803;70472;18.8;8.5
60;2021-04-25;1159;1965;155962;72437;18.9;8.8
60;2021-04-26;1890;2537;157852;74974;19.1;9.1
60;2021-04-27;2312;2853;160164;77827;19.4;9.4
60;2021-04-28;3061;2403;163225;80230;19.8;9.7
60;2021-04-29;3153;2629;166378;82859;20.2;10.0
60;2021-04-30;3459;2969;169837;85828;20.6;10.4
60;2021-05-01;2353;1127;172190;86955;20.9;10.5
60;2021-05-02;2147;847;174337;87802;21.1;10.6
60;2021-05-03;2955;1861;177292;89663;21.5;10.9
60;2021-05-04;3016;2361;180308;92024;21.9;11.2
60;2021-05-05;3260;2812;183568;94836;22.2;11.5
60;2021-05-06;3648;2486;187216;97322;22.7;11.8
60;2021-05-07;3986;2528;191202;99850;23.2;12.1
60;2021-05-08;3582;973;194784;100823;23.6;12.2
60;2021-05-09;3458;959;198242;101782;24.0;12.3
60;2021-05-10;2392;2295;200634;104077;24.3;12.6
60;2021-05-11;3672;2472;204306;106549;24.8;12.9
60;2021-05-12;4717;2558;209023;109107;25.3;13.2
60;2021-05-13;5292;1131;214315;110238;26.0;13.4
60;2021-05-14;5602;1811;219917;112049;26.7;13.6
60;2021-05-15;6172;1721;226089;113770;27.4;13.8
60;2021-05-16;4858;691;230947;114461;28.0;13.9
60;2021-05-17;3715;1673;234662;116134;28.4;14.1
60;2021-05-18;4046;2078;238708;118212;28.9;14.3
60;2021-05-19;5097;1857;243805;120069;29.5;14.6
60;2021-05-20;5460;1814;249265;121883;30.2;14.8
60;2021-05-21;5969;1974;255234;123857;30.9;15.0
60;2021-05-22;5354;1982;260588;125839;31.6;15.3
60;2021-05-23;4263;658;264851;126497;32.1;15.3
60;2021-05-24;2950;534;267801;127031;32.5;15.4
60;2021-05-25;4136;2005;271937;129036;33.0;15.6
60;2021-05-26;4466;1833;276403;130869;33.5;15.9
60;2021-05-27;4611;1998;281014;132867;34.1;16.1
60;2021-05-28;4625;2506;285639;135373;34.6;16.4
60;2021-05-29;4612;2275;290251;137648;35.2;16.7
60;2021-05-30;1086;348;291337;137996;35.3;16.7
60;2021-05-31;3833;2085;295170;140081;35.8;17.0
60;2021-06-01;4445;2854;299615;142935;36.3;17.3
60;2021-06-02;3916;2449;303531;145384;36.8;17.6
60;2021-06-03;3904;2382;307435;147766;37.3;17.9
60;2021-06-04;4652;2910;312087;150676;37.8;18.3
60;2021-06-05;4302;3419;316389;154095;38.3;18.7
60;2021-06-06;2159;795;318548;154890;38.6;18.8
60;2021-06-07;2778;2763;321326;157653;38.9;19.1
60;2021-06-08;3802;3012;325128;160665;39.4;19.5
60;2021-06-09;3249;3402;328377;164067;39.8;19.9
60;2021-06-10;3454;3368;331831;167435;40.2;20.3
60;2021-06-11;3881;4194;335712;171629;40.7;20.8
60;2021-06-12;3780;4282;339492;175911;41.1;21.3
60;2021-06-13;1154;2225;340646;178136;41.3;21.6
60;2021-06-14;1912;3307;342558;181443;41.5;22.0
60;2021-06-15;3015;4165;345573;185608;41.9;22.5
60;2021-06-16;3250;4488;348823;190096;42.3;23.0
60;2021-06-17;2978;4784;351801;194880;42.6;23.6
60;2021-06-18;2982;4606;354783;199486;43.0;24.2
60;2021-06-19;3144;4728;357927;204214;43.4;24.8
60;2021-06-20;1431;1936;359358;206150;43.6;25.0
60;2021-06-21;1408;4042;360766;210192;43.7;25.5
60;2021-06-22;1757;5293;362523;215485;43.9;26.1
60;2021-06-23;1861;5237;364384;220722;44.2;26.8
60;2021-06-24;1803;5601;366187;226323;44.4;27.4
60;2021-06-25;1907;5729;368094;232052;44.6;28.1
60;2021-06-26;1860;6973;369954;239025;44.8;29.0
60;2021-06-27;713;2593;370667;241618;44.9;29.3
60;2021-06-28;1781;4142;372448;245760;45.1;29.8
60;2021-06-29;2010;5466;374458;251226;45.4;30.4
60;2021-06-30;2296;5360;376754;256586;45.7;31.1
60;2021-07-01;1888;4921;378642;261507;45.9;31.7
60;2021-07-02;2370;5878;381012;267385;46.2;32.4
60;2021-07-03;2400;6160;383412;273545;46.5;33.2
60;2021-07-04;792;2724;384204;276269;46.6;33.5
60;2021-07-05;1659;4406;385863;280675;46.8;34.0
60;2021-07-06;2146;4501;388009;285176;47.0;34.6
60;2021-07-07;2174;5119;390183;290295;47.3;35.2
60;2021-07-08;2672;4692;392855;294987;47.6;35.8
60;2021-07-09;2641;5568;395496;300555;47.9;36.4
60;2021-07-10;2579;5875;398075;306430;48.2;37.1
60;2021-07-11;1212;1942;399287;308372;48.4;37.4
60;2021-07-12;1447;4737;400734;313109;48.6;37.9
60;2021-07-13;2912;5020;403646;318129;48.9;38.6
60;2021-07-14;2584;1411;406230;319540;49.2;38.7
60;2021-07-15;3430;4873;409660;324413;49.7;39.3
60;2021-07-16;3698;5243;413358;329656;50.1;40.0
60;2021-07-17;4079;5135;417437;334791;50.6;40.6
60;2021-07-18;2186;2131;419623;336922;50.9;40.8
60;2021-07-19;2542;3892;422165;340814;51.2;41.3
60;2021-07-20;4197;4904;426362;345718;51.7;41.9
60;2021-07-21;4352;4289;430714;350007;52.2;42.4
60;2021-07-22;4627;4337;435341;354344;52.8;42.9
60;2021-07-23;4981;4904;440322;359248;53.4;43.5
60;2021-07-24;4314;4676;444636;363924;53.9;44.1
60;2021-07-25;2604;1831;447240;365755;54.2;44.3
60;2021-07-26;3377;3758;450617;369513;54.6;44.8
60;2021-07-27;4437;4634;455054;374147;55.2;45.3
60;2021-07-28;4554;3771;459608;377918;55.7;45.8
60;2021-07-29;4901;3714;464509;381632;56.3;46.3
60;2021-07-30;5025;4263;469534;385895;56.9;46.8
60;2021-07-31;4063;3969;473597;389864;57.4;47.3
60;2021-08-01;1684;863;475281;390727;57.6;47.4
60;2021-08-02;3198;2755;478479;393482;58.0;47.7
60;2021-08-03;3605;2894;482084;396376;58.4;48.0
60;2021-08-04;3317;2801;485401;399177;58.8;48.4
60;2021-08-05;3033;2261;488434;401438;59.2;48.7
60;2021-08-06;3830;3057;492264;404495;59.7;49.0
60;2021-08-07;3370;3078;495634;407573;60.1;49.4
60;2021-08-08;1535;911;497169;408484;60.3;49.5
60;2021-08-09;2207;2874;499376;411358;60.5;49.9
60;2021-08-10;3276;3314;502652;414672;60.9;50.3
60;2021-08-11;2788;3239;505440;417911;61.3;50.7
60;2021-08-12;2355;2665;507795;420576;61.5;51.0
60;2021-08-13;2751;2999;510546;423575;61.9;51.3
60;2021-08-14;2543;2735;513089;426310;62.2;51.7
60;2021-08-15;1362;554;514451;426864;62.4;51.7
60;2021-08-16;2042;3777;516493;430641;62.6;52.2
60;2021-08-17;2347;3819;518840;434460;62.9;52.7
60;2021-08-18;1943;3284;520783;437744;63.1;53.1
60;2021-08-19;1647;3074;522430;440818;63.3;53.4
60;2021-08-20;1867;3999;524297;444817;63.5;53.9
60;2021-08-21;1613;3493;525910;448310;63.7;54.3
60;2021-08-22;576;1339;526486;449649;63.8;54.5
60;2021-08-23;1107;3223;527593;452872;63.9;54.9
60;2021-08-24;1371;4496;528964;457368;64.1;55.4
60;2021-08-25;1431;3587;530395;460955;64.3;55.9
60;2021-08-26;1432;3459;531827;464414;64.5;56.3
60;2021-08-27;1435;4173;533262;468587;64.6;56.8
60;2021-08-28;1380;4479;534642;473066;64.8;57.3
60;2021-08-29;550;2041;535192;475107;64.9;57.6
60;2021-08-30;1232;2964;536424;478071;65.0;57.9
60;2021-08-31;1645;3799;538069;481870;65.2;58.4
60;2021-09-01;1239;2664;539308;484534;65.4;58.7
60;2021-09-02;1058;2570;540366;487104;65.5;59.0
60;2021-09-03;1024;2975;541390;490079;65.6;59.4
60;2021-09-04;1521;3606;542911;493685;65.8;59.8
60;2021-09-05;367;1332;543278;495017;65.8;60.0
60;2021-09-06;798;2382;544076;497399;65.9;60.3
60;2021-09-07;840;2776;544916;500175;66.0;60.6
60;2021-09-08;887;2709;545803;502884;66.2;60.9
60;2021-09-09;685;2159;546488;505043;66.2;61.2
60;2021-09-10;1052;2770;547540;507813;66.4;61.5
60;2021-09-11;1064;3332;548604;511145;66.5;62.0
60;2021-09-12;308;1108;548912;512253;66.5;62.1
60;2021-09-13;611;1721;549523;513974;66.6;62.3
60;2021-09-14;760;1497;550283;515471;66.7;62.5
60;2021-09-15;570;1243;550853;516714;66.8;62.6
60;2021-09-16;919;1327;551772;518041;66.9;62.8
60;2021-09-17;717;1465;552489;519506;67.0;63.0
60;2021-09-18;820;2610;553309;522116;67.1;63.3
60;2021-09-19;191;498;553500;522614;67.1;63.3
60;2021-09-20;462;1097;553962;523711;67.1;63.5
60;2021-09-21;500;984;554462;524695;67.2;63.6
60;2021-09-22;443;1306;554905;526001;67.3;63.8
60;2021-09-23;629;901;555534;526902;67.3;63.9
60;2021-09-24;488;1198;556022;528100;67.4;64.0
60;2021-09-25;495;1877;556517;529977;67.5;64.2
60;2021-09-26;78;294;556595;530271;67.5;64.3
60;2021-09-27;335;767;556930;531038;67.5;64.4
60;2021-09-28;321;885;557251;531923;67.5;64.5
60;2021-09-29;407;1048;557658;532971;67.6;64.6
60;2021-09-30;367;737;558025;533708;67.6;64.7
60;2021-10-01;412;1037;558437;534745;67.7;64.8
60;2021-10-02;588;1468;559025;536213;67.8;65.0
60;2021-10-03;80;305;559105;536518;67.8;65.0
60;2021-10-04;358;680;559463;537198;67.8;65.1
60;2021-10-05;266;533;559729;537731;67.8;65.2
60;2021-10-06;363;762;560092;538493;67.9;65.3
60;2021-10-07;184;556;560276;539049;67.9;65.3
60;2021-10-08;431;790;560707;539839;68.0;65.4
60;2021-10-09;616;1274;561323;541113;68.0;65.6
60;2021-10-10;51;190;561374;541303;68.0;65.6
60;2021-10-11;290;520;561664;541823;68.1;65.7
60;2021-10-12;220;472;561884;542295;68.1;65.7
60;2021-10-13;361;611;562245;542906;68.1;65.8
60;2021-10-14;271;625;562516;543531;68.2;65.9
60;2021-10-15;354;694;562870;544225;68.2;66.0
60;2021-10-16;539;896;563409;545121;68.3;66.1
60;2021-10-17;49;132;563458;545253;68.3;66.1
60;2021-10-18;257;507;563715;545760;68.3;66.1
60;2021-10-19;232;284;563947;546044;68.4;66.2
61;2020-12-27;0;0;0;0;0.0;0.0
61;2020-12-28;0;0;0;0;0.0;0.0
61;2020-12-29;0;0;0;0;0.0;0.0
61;2020-12-30;0;0;0;0;0.0;0.0
61;2020-12-31;0;0;0;0;0.0;0.0
61;2021-01-01;2;0;2;0;0.0;0.0
61;2021-01-02;1;0;3;0;0.0;0.0
61;2021-01-03;0;0;3;0;0.0;0.0
61;2021-01-04;1;0;4;0;0.0;0.0
61;2021-01-05;3;0;7;0;0.0;0.0
61;2021-01-06;77;0;84;0;0.0;0.0
61;2021-01-07;175;2;259;2;0.1;0.0
61;2021-01-08;405;1;664;3;0.2;0.0
61;2021-01-09;165;1;829;4;0.3;0.0
61;2021-01-10;49;0;878;4;0.3;0.0
61;2021-01-11;396;1;1274;5;0.5;0.0
61;2021-01-12;681;3;1955;8;0.7;0.0
61;2021-01-13;740;2;2695;10;1.0;0.0
61;2021-01-14;530;9;3225;19;1.2;0.0
61;2021-01-15;537;4;3762;23;1.4;0.0
61;2021-01-16;289;1;4051;24;1.5;0.0
61;2021-01-17;891;12;4942;36;1.8;0.0
61;2021-01-18;1914;3;6856;39;2.5;0.0
61;2021-01-19;1327;5;8183;44;3.0;0.0
61;2021-01-20;685;0;8868;44;3.2;0.0
61;2021-01-21;848;1;9716;45;3.5;0.0
61;2021-01-22;764;1;10480;46;3.8;0.0
61;2021-01-23;257;2;10737;48;3.9;0.0
61;2021-01-24;229;2;10966;50;4.0;0.0
61;2021-01-25;578;1;11544;51;4.2;0.0
61;2021-01-26;568;1;12112;52;4.4;0.0
61;2021-01-27;572;14;12684;66;4.6;0.0
61;2021-01-28;466;53;13150;119;4.7;0.0
61;2021-01-29;479;204;13629;323;4.9;0.1
61;2021-01-30;212;3;13841;326;5.0;0.1
61;2021-01-31;109;3;13950;329;5.0;0.1
61;2021-02-01;430;190;14380;519;5.2;0.2
61;2021-02-02;389;425;14769;944;5.3;0.3
61;2021-02-03;412;491;15181;1435;5.5;0.5
61;2021-02-04;390;338;15571;1773;5.6;0.6
61;2021-02-05;536;361;16107;2134;5.8;0.8
61;2021-02-06;206;93;16313;2227;5.9;0.8
61;2021-02-07;45;199;16358;2426;5.9;0.9
61;2021-02-08;541;1405;16899;3831;6.1;1.4
61;2021-02-09;405;810;17304;4641;6.2;1.7
61;2021-02-10;280;560;17584;5201;6.4;1.9
61;2021-02-11;432;558;18016;5759;6.5;2.1
61;2021-02-12;401;736;18417;6495;6.7;2.3
61;2021-02-13;133;431;18550;6926;6.7;2.5
61;2021-02-14;3;315;18553;7241;6.7;2.6
61;2021-02-15;169;841;18722;8082;6.8;2.9
61;2021-02-16;203;679;18925;8761;6.8;3.2
61;2021-02-17;44;638;18969;9399;6.9;3.4
61;2021-02-18;161;524;19130;9923;6.9;3.6
61;2021-02-19;101;391;19231;10314;6.9;3.7
61;2021-02-20;40;236;19271;10550;7.0;3.8
61;2021-02-21;2;155;19273;10705;7.0;3.9
61;2021-02-22;88;566;19361;11271;7.0;4.1
61;2021-02-23;102;495;19463;11766;7.0;4.2
61;2021-02-24;173;570;19636;12336;7.1;4.5
61;2021-02-25;265;445;19901;12781;7.2;4.6
61;2021-02-26;266;465;20167;13246;7.3;4.8
61;2021-02-27;110;228;20277;13474;7.3;4.9
61;2021-02-28;4;122;20281;13596;7.3;4.9
61;2021-03-01;215;611;20496;14207;7.4;5.1
61;2021-03-02;148;700;20644;14907;7.5;5.4
61;2021-03-03;143;448;20787;15355;7.5;5.5
61;2021-03-04;429;444;21216;15799;7.7;5.7
61;2021-03-05;704;302;21920;16101;7.9;5.8
61;2021-03-06;436;232;22356;16333;8.1;5.9
61;2021-03-07;155;2;22511;16335;8.1;5.9
61;2021-03-08;295;314;22806;16649;8.2;6.0
61;2021-03-09;622;186;23428;16835;8.5;6.1
61;2021-03-10;672;189;24100;17024;8.7;6.1
61;2021-03-11;1120;131;25220;17155;9.1;6.2
61;2021-03-12;1466;105;26686;17260;9.6;6.2
61;2021-03-13;775;56;27461;17316;9.9;6.3
61;2021-03-14;226;6;27687;17322;10.0;6.3
61;2021-03-15;814;37;28501;17359;10.3;6.3
61;2021-03-16;723;23;29224;17382;10.6;6.3
61;2021-03-17;761;12;29985;17394;10.8;6.3
61;2021-03-18;858;29;30843;17423;11.1;6.3
61;2021-03-19;1026;51;31869;17474;11.5;6.3
61;2021-03-20;478;17;32347;17491;11.7;6.3
61;2021-03-21;72;4;32419;17495;11.7;6.3
61;2021-03-22;797;94;33216;17589;12.0;6.4
61;2021-03-23;920;42;34136;17631;12.3;6.4
61;2021-03-24;1373;70;35509;17701;12.8;6.4
61;2021-03-25;1876;69;37385;17770;13.5;6.4
61;2021-03-26;1800;47;39185;17817;14.2;6.4
61;2021-03-27;1083;19;40268;17836;14.5;6.4
61;2021-03-28;359;9;40627;17845;14.7;6.4
61;2021-03-29;1272;183;41899;18028;15.1;6.5
61;2021-03-30;1470;102;43369;18130;15.7;6.5
61;2021-03-31;1687;56;45056;18186;16.3;6.6
61;2021-04-01;2051;233;47107;18419;17.0;6.7
61;2021-04-02;1519;435;48626;18854;17.6;6.8
61;2021-04-03;640;290;49266;19144;17.8;6.9
61;2021-04-04;193;1;49459;19145;17.9;6.9
61;2021-04-05;534;8;49993;19153;18.1;6.9
61;2021-04-06;1350;621;51343;19774;18.5;7.1
61;2021-04-07;1695;663;53038;20437;19.2;7.4
61;2021-04-08;2266;837;55304;21274;20.0;7.7
61;2021-04-09;2133;837;57437;22111;20.7;8.0
61;2021-04-10;1534;489;58971;22600;21.3;8.2
61;2021-04-11;238;202;59209;22802;21.4;8.2
61;2021-04-12;1284;738;60493;23540;21.8;8.5
61;2021-04-13;1742;707;62235;24247;22.5;8.8
61;2021-04-14;1734;788;63969;25035;23.1;9.0
61;2021-04-15;2268;789;66237;25824;23.9;9.3
61;2021-04-16;2227;691;68464;26515;24.7;9.6
61;2021-04-17;1483;321;69947;26836;25.3;9.7
61;2021-04-18;538;99;70485;26935;25.5;9.7
61;2021-04-19;935;750;71420;27685;25.8;10.0
61;2021-04-20;1523;786;72943;28471;26.3;10.3
61;2021-04-21;1351;1041;74294;29512;26.8;10.7
61;2021-04-22;1292;1222;75586;30734;27.3;11.1
61;2021-04-23;1213;1156;76799;31890;27.7;11.5
61;2021-04-24;1437;822;78236;32712;28.3;11.8
61;2021-04-25;361;333;78597;33045;28.4;11.9
61;2021-04-26;671;1146;79268;34191;28.6;12.3
61;2021-04-27;1465;1146;80733;35337;29.2;12.8
61;2021-04-28;1386;1392;82119;36729;29.7;13.3
61;2021-04-29;1246;1861;83365;38590;30.1;13.9
61;2021-04-30;1719;1176;85084;39766;30.7;14.4
61;2021-05-01;789;324;85873;40090;31.0;14.5
61;2021-05-02;439;227;86312;40317;31.2;14.6
61;2021-05-03;843;1251;87155;41568;31.5;15.0
61;2021-05-04;1323;1753;88478;43321;32.0;15.6
61;2021-05-05;1008;2032;89486;45353;32.3;16.4
61;2021-05-06;1772;2215;91258;47568;33.0;17.2
61;2021-05-07;1376;1974;92634;49542;33.5;17.9
61;2021-05-08;929;473;93563;50015;33.8;18.1
61;2021-05-09;395;294;93958;50309;33.9;18.2
61;2021-05-10;987;1756;94945;52065;34.3;18.8
61;2021-05-11;1377;1516;96322;53581;34.8;19.4
61;2021-05-12;1869;1595;98191;55176;35.5;19.9
61;2021-05-13;889;491;99080;55667;35.8;20.1
61;2021-05-14;1851;1191;100931;56858;36.4;20.5
61;2021-05-15;2111;1121;103042;57979;37.2;20.9
61;2021-05-16;984;300;104026;58279;37.6;21.0
61;2021-05-17;1312;914;105338;59193;38.0;21.4
61;2021-05-18;2422;894;107760;60087;38.9;21.7
61;2021-05-19;2400;804;110160;60891;39.8;22.0
61;2021-05-20;2212;819;112372;61710;40.6;22.3
61;2021-05-21;2149;860;114521;62570;41.4;22.6
61;2021-05-22;1780;718;116301;63288;42.0;22.9
61;2021-05-23;714;54;117015;63342;42.3;22.9
61;2021-05-24;914;113;117929;63455;42.6;22.9
61;2021-05-25;1991;921;119920;64376;43.3;23.2
61;2021-05-26;2046;932;121966;65308;44.0;23.6
61;2021-05-27;2042;1094;124008;66402;44.8;24.0
61;2021-05-28;2052;1378;126060;67780;45.5;24.5
61;2021-05-29;1466;557;127526;68337;46.1;24.7
61;2021-05-30;450;44;127976;68381;46.2;24.7
61;2021-05-31;1559;938;129535;69319;46.8;25.0
61;2021-06-01;1875;1389;131410;70708;47.5;25.5
61;2021-06-02;1676;1137;133086;71845;48.1;25.9
61;2021-06-03;2249;1110;135335;72955;48.9;26.3
61;2021-06-04;1898;1346;137233;74301;49.6;26.8
61;2021-06-05;1669;1240;138902;75541;50.2;27.3
61;2021-06-06;318;230;139220;75771;50.3;27.4
61;2021-06-07;2189;867;141409;76638;51.1;27.7
61;2021-06-08;1847;1570;143256;78208;51.7;28.2
61;2021-06-09;1975;1185;145231;79393;52.4;28.7
61;2021-06-10;1974;1192;147205;80585;53.2;29.1
61;2021-06-11;1822;1581;149027;82166;53.8;29.7
61;2021-06-12;1424;999;150451;83165;54.3;30.0
61;2021-06-13;340;377;150791;83542;54.5;30.2
61;2021-06-14;1107;1188;151898;84730;54.9;30.6
61;2021-06-15;1214;1694;153112;86424;55.3;31.2
61;2021-06-16;1114;1363;154226;87787;55.7;31.7
61;2021-06-17;1019;1730;155245;89517;56.1;32.3
61;2021-06-18;1523;1671;156768;91188;56.6;32.9
61;2021-06-19;1245;1303;158013;92491;57.1;33.4
61;2021-06-20;289;345;158302;92836;57.2;33.5
61;2021-06-21;807;1629;159109;94465;57.5;34.1
61;2021-06-22;1024;1683;160133;96148;57.8;34.7
61;2021-06-23;967;2436;161100;98584;58.2;35.6
61;2021-06-24;650;1361;161750;99945;58.4;36.1
61;2021-06-25;839;2167;162589;102112;58.7;36.9
61;2021-06-26;620;1956;163209;104068;58.9;37.6
61;2021-06-27;139;799;163348;104867;59.0;37.9
61;2021-06-28;478;2247;163826;107114;59.2;38.7
61;2021-06-29;699;2858;164525;109972;59.4;39.7
61;2021-06-30;771;2463;165296;112435;59.7;40.6
61;2021-07-01;633;1699;165929;114134;59.9;41.2
61;2021-07-02;842;2495;166771;116629;60.2;42.1
61;2021-07-03;417;1910;167188;118539;60.4;42.8
61;2021-07-04;75;638;167263;119177;60.4;43.0
61;2021-07-05;682;1774;167945;120951;60.7;43.7
61;2021-07-06;991;2794;168936;123745;61.0;44.7
61;2021-07-07;734;2360;169670;126105;61.3;45.5
61;2021-07-08;840;1944;170510;128049;61.6;46.2
61;2021-07-09;723;2375;171233;130424;61.8;47.1
61;2021-07-10;463;1767;171696;132191;62.0;47.7
61;2021-07-11;244;489;171940;132680;62.1;47.9
61;2021-07-12;438;2290;172378;134970;62.3;48.7
61;2021-07-13;643;2488;173021;137458;62.5;49.6
61;2021-07-14;150;334;173171;137792;62.5;49.8
61;2021-07-15;815;2814;173986;140606;62.8;50.8
61;2021-07-16;967;2574;174953;143180;63.2;51.7
61;2021-07-17;708;2232;175661;145412;63.4;52.5
61;2021-07-18;339;368;176000;145780;63.6;52.6
61;2021-07-19;934;2403;176934;148183;63.9;53.5
61;2021-07-20;1327;2356;178261;150539;64.4;54.4
61;2021-07-21;1503;2181;179764;152720;64.9;55.2
61;2021-07-22;1750;2188;181514;154908;65.6;55.9
61;2021-07-23;1793;2306;183307;157214;66.2;56.8
61;2021-07-24;1457;2008;184764;159222;66.7;57.5
61;2021-07-25;323;393;185087;159615;66.8;57.6
61;2021-07-26;1252;1933;186339;161548;67.3;58.3
61;2021-07-27;2420;1583;188759;163131;68.2;58.9
61;2021-07-28;2457;1356;191216;164487;69.1;59.4
61;2021-07-29;2563;1577;193779;166064;70.0;60.0
61;2021-07-30;2396;1393;196175;167457;70.8;60.5
61;2021-07-31;1282;1301;197457;168758;71.3;60.9
61;2021-08-01;504;259;197961;169017;71.5;61.0
61;2021-08-02;1913;1123;199874;170140;72.2;61.4
61;2021-08-03;2452;915;202326;171055;73.1;61.8
61;2021-08-04;2344;781;204670;171836;73.9;62.1
61;2021-08-05;1901;992;206571;172828;74.6;62.4
61;2021-08-06;2164;1163;208735;173991;75.4;62.8
61;2021-08-07;1422;799;210157;174790;75.9;63.1
61;2021-08-08;447;263;210604;175053;76.1;63.2
61;2021-08-09;1310;1112;211914;176165;76.5;63.6
61;2021-08-10;1315;1107;213229;177272;77.0;64.0
61;2021-08-11;1118;1258;214347;178530;77.4;64.5
61;2021-08-12;1036;1321;215383;179851;77.8;65.0
61;2021-08-13;880;1611;216263;181462;78.1;65.5
61;2021-08-14;717;864;216980;182326;78.4;65.8
61;2021-08-15;94;183;217074;182509;78.4;65.9
61;2021-08-16;913;1541;217987;184050;78.7;66.5
61;2021-08-17;1153;1702;219140;185752;79.1;67.1
61;2021-08-18;811;1479;219951;187231;79.4;67.6
61;2021-08-19;746;1570;220697;188801;79.7;68.2
61;2021-08-20;800;2131;221497;190932;80.0;69.0
61;2021-08-21;492;1345;221989;192277;80.2;69.4
61;2021-08-22;137;447;222126;192724;80.2;69.6
61;2021-08-23;415;1702;222541;194426;80.4;70.2
61;2021-08-24;528;1899;223069;196325;80.6;70.9
61;2021-08-25;413;1735;223482;198060;80.7;71.5
61;2021-08-26;429;1599;223911;199659;80.9;72.1
61;2021-08-27;515;1889;224426;201548;81.0;72.8
61;2021-08-28;286;1365;224712;202913;81.2;73.3
61;2021-08-29;50;417;224762;203330;81.2;73.4
61;2021-08-30;400;1618;225162;204948;81.3;74.0
61;2021-08-31;505;1672;225667;206620;81.5;74.6
61;2021-09-01;454;1312;226121;207932;81.7;75.1
61;2021-09-02;421;1097;226542;209029;81.8;75.5
61;2021-09-03;476;1296;227018;210325;82.0;76.0
61;2021-09-04;348;1254;227366;211579;82.1;76.4
61;2021-09-05;76;181;227442;211760;82.1;76.5
61;2021-09-06;286;973;227728;212733;82.2;76.8
61;2021-09-07;362;1392;228090;214125;82.4;77.3
61;2021-09-08;274;1193;228364;215318;82.5;77.8
61;2021-09-09;296;886;228660;216204;82.6;78.1
61;2021-09-10;366;889;229026;217093;82.7;78.4
61;2021-09-11;270;1021;229296;218114;82.8;78.8
61;2021-09-12;37;109;229333;218223;82.8;78.8
61;2021-09-13;208;526;229541;218749;82.9;79.0
61;2021-09-14;198;361;229739;219110;83.0;79.1
61;2021-09-15;259;595;229998;219705;83.1;79.3
61;2021-09-16;221;269;230219;219974;83.1;79.4
61;2021-09-17;243;535;230462;220509;83.2;79.6
61;2021-09-18;217;612;230679;221121;83.3;79.9
61;2021-09-19;1;0;230680;221121;83.3;79.9
61;2021-09-20;179;267;230859;221388;83.4;80.0
61;2021-09-21;237;189;231096;221577;83.5;80.0
61;2021-09-22;159;692;231255;222269;83.5;80.3
61;2021-09-23;163;228;231418;222497;83.6;80.4
61;2021-09-24;136;379;231554;222876;83.6;80.5
61;2021-09-25;172;596;231726;223472;83.7;80.7
61;2021-09-26;9;16;231735;223488;83.7;80.7
61;2021-09-27;125;293;231860;223781;83.7;80.8
61;2021-09-28;96;248;231956;224029;83.8;80.9
61;2021-09-29;105;217;232061;224246;83.8;81.0
61;2021-09-30;204;237;232265;224483;83.9;81.1
61;2021-10-01;87;265;232352;224748;83.9;81.2
61;2021-10-02;197;566;232549;225314;84.0;81.4
61;2021-10-03;1;8;232550;225322;84.0;81.4
61;2021-10-04;108;287;232658;225609;84.0;81.5
61;2021-10-05;112;289;232770;225898;84.1;81.6
61;2021-10-06;155;321;232925;226219;84.1;81.7
61;2021-10-07;141;259;233066;226478;84.2;81.8
61;2021-10-08;157;243;233223;226721;84.2;81.9
61;2021-10-09;89;168;233312;226889;84.3;81.9
61;2021-10-10;1;2;233313;226891;84.3;81.9
61;2021-10-11;140;387;233453;227278;84.3;82.1
61;2021-10-12;70;185;233523;227463;84.3;82.1
61;2021-10-13;115;203;233638;227666;84.4;82.2
61;2021-10-14;67;207;233705;227873;84.4;82.3
61;2021-10-15;128;206;233833;228079;84.4;82.4
61;2021-10-16;67;101;233900;228180;84.5;82.4
61;2021-10-17;8;8;233908;228188;84.5;82.4
61;2021-10-18;64;144;233972;228332;84.5;82.5
61;2021-10-19;62;107;234034;228439;84.5;82.5
62;2020-12-27;2;0;2;0;0.0;0.0
62;2020-12-28;1;0;3;0;0.0;0.0
62;2020-12-29;0;0;3;0;0.0;0.0
62;2020-12-30;0;0;3;0;0.0;0.0
62;2020-12-31;0;0;3;0;0.0;0.0
62;2021-01-01;0;0;3;0;0.0;0.0
62;2021-01-02;3;2;6;2;0.0;0.0
62;2021-01-03;0;0;6;2;0.0;0.0
62;2021-01-04;3;0;9;2;0.0;0.0
62;2021-01-05;47;0;56;2;0.0;0.0
62;2021-01-06;123;0;179;2;0.0;0.0
62;2021-01-07;352;0;531;2;0.0;0.0
62;2021-01-08;713;9;1244;11;0.1;0.0
62;2021-01-09;164;1;1408;12;0.1;0.0
62;2021-01-10;84;0;1492;12;0.1;0.0
62;2021-01-11;557;3;2049;15;0.1;0.0
62;2021-01-12;1261;6;3310;21;0.2;0.0
62;2021-01-13;1139;17;4449;38;0.3;0.0
62;2021-01-14;1386;9;5835;47;0.4;0.0
62;2021-01-15;1300;13;7135;60;0.5;0.0
62;2021-01-16;309;3;7444;63;0.5;0.0
62;2021-01-17;107;1;7551;64;0.5;0.0
62;2021-01-18;1667;10;9218;74;0.6;0.0
62;2021-01-19;2104;6;11322;80;0.8;0.0
62;2021-01-20;2056;7;13378;87;0.9;0.0
62;2021-01-21;2243;10;15621;97;1.1;0.0
62;2021-01-22;1835;7;17456;104;1.2;0.0
62;2021-01-23;512;1;17968;105;1.2;0.0
62;2021-01-24;0;0;17968;105;1.2;0.0
62;2021-01-25;1286;8;19254;113;1.3;0.0
62;2021-01-26;1546;21;20800;134;1.4;0.0
62;2021-01-27;1520;179;22320;313;1.5;0.0
62;2021-01-28;4184;403;26504;716;1.8;0.0
62;2021-01-29;2048;339;28552;1055;2.0;0.1
62;2021-01-30;160;151;28712;1206;2.0;0.1
62;2021-01-31;24;3;28736;1209;2.0;0.1
62;2021-02-01;46;355;28782;1564;2.0;0.1
62;2021-02-02;59;785;28841;2349;2.0;0.2
62;2021-02-03;44;627;28885;2976;2.0;0.2
62;2021-02-04;81;801;28966;3777;2.0;0.3
62;2021-02-05;80;748;29046;4525;2.0;0.3
62;2021-02-06;32;199;29078;4724;2.0;0.3
62;2021-02-07;236;31;29314;4755;2.0;0.3
62;2021-02-08;133;841;29447;5596;2.0;0.4
62;2021-02-09;227;1093;29674;6689;2.0;0.5
62;2021-02-10;385;1165;30059;7854;2.1;0.5
62;2021-02-11;725;996;30784;8850;2.1;0.6
62;2021-02-12;968;778;31752;9628;2.2;0.7
62;2021-02-13;162;266;31914;9894;2.2;0.7
62;2021-02-14;0;0;31914;9894;2.2;0.7
62;2021-02-15;666;1265;32580;11159;2.2;0.8
62;2021-02-16;923;1774;33503;12933;2.3;0.9
62;2021-02-17;1085;2070;34588;15003;2.4;1.0
62;2021-02-18;2228;3770;36816;18773;2.5;1.3
62;2021-02-19;2315;2548;39131;21321;2.7;1.5
62;2021-02-20;616;480;39747;21801;2.7;1.5
62;2021-02-21;88;50;39835;21851;2.7;1.5
62;2021-02-22;849;964;40684;22815;2.8;1.6
62;2021-02-23;1419;1212;42103;24027;2.9;1.7
62;2021-02-24;1547;656;43650;24683;3.0;1.7
62;2021-02-25;3170;425;46820;25108;3.2;1.7
62;2021-02-26;2912;355;49732;25463;3.4;1.8
62;2021-02-27;1830;99;51562;25562;3.5;1.8
62;2021-02-28;52;42;51614;25604;3.6;1.8
62;2021-03-01;1322;125;52936;25729;3.6;1.8
62;2021-03-02;3155;189;56091;25918;3.9;1.8
62;2021-03-03;3274;141;59365;26059;4.1;1.8
62;2021-03-04;3811;228;63176;26287;4.3;1.8
62;2021-03-05;4648;250;67824;26537;4.7;1.8
62;2021-03-06;9622;293;77446;26830;5.3;1.8
62;2021-03-07;8073;248;85519;27078;5.9;1.9
62;2021-03-08;2197;273;87716;27351;6.0;1.9
62;2021-03-09;3811;398;91527;27749;6.3;1.9
62;2021-03-10;4234;630;95761;28379;6.6;2.0
62;2021-03-11;5994;1550;101755;29929;7.0;2.1
62;2021-03-12;6639;1447;108394;31376;7.5;2.2
62;2021-03-13;14725;834;123119;32210;8.5;2.2
62;2021-03-14;9581;445;132700;32655;9.1;2.2
62;2021-03-15;3761;1026;136461;33681;9.4;2.3
62;2021-03-16;2736;864;139197;34545;9.6;2.4
62;2021-03-17;2805;744;142002;35289;9.8;2.4
62;2021-03-18;2726;956;144728;36245;10.0;2.5
62;2021-03-19;4784;940;149512;37185;10.3;2.6
62;2021-03-20;11064;637;160576;37822;11.1;2.6
62;2021-03-21;9447;387;170023;38209;11.7;2.6
62;2021-03-22;2944;1121;172967;39330;11.9;2.7
62;2021-03-23;4996;1504;177963;40834;12.2;2.8
62;2021-03-24;4696;1393;182659;42227;12.6;2.9
62;2021-03-25;6554;1495;189213;43722;13.0;3.0
62;2021-03-26;7048;1518;196261;45240;13.5;3.1
62;2021-03-27;12592;769;208853;46009;14.4;3.2
62;2021-03-28;6941;292;215794;46301;14.9;3.2
62;2021-03-29;3470;1219;219264;47520;15.1;3.3
62;2021-03-30;4549;2223;223813;49743;15.4;3.4
62;2021-03-31;4225;2491;228038;52234;15.7;3.6
62;2021-04-01;4977;2776;233015;55010;16.0;3.8
62;2021-04-02;5067;3247;238082;58257;16.4;4.0
62;2021-04-03;8207;3377;246289;61634;17.0;4.2
62;2021-04-04;4582;1946;250871;63580;17.3;4.4
62;2021-04-05;944;468;251815;64048;17.3;4.4
62;2021-04-06;4122;3023;255937;67071;17.6;4.6
62;2021-04-07;5070;3539;261007;70610;18.0;4.9
62;2021-04-08;6492;4016;267499;74626;18.4;5.1
62;2021-04-09;7629;3497;275128;78123;18.9;5.4
62;2021-04-10;6633;8088;281761;86211;19.4;5.9
62;2021-04-11;2803;6902;284564;93113;19.6;6.4
62;2021-04-12;3419;2389;287983;95502;19.8;6.6
62;2021-04-13;6169;3175;294152;98677;20.2;6.8
62;2021-04-14;5307;3072;299459;101749;20.6;7.0
62;2021-04-15;5734;3020;305193;104769;21.0;7.2
62;2021-04-16;5417;3216;310610;107985;21.4;7.4
62;2021-04-17;4355;7375;314965;115360;21.7;7.9
62;2021-04-18;1957;6858;316922;122218;21.8;8.4
62;2021-04-19;2777;1939;319699;124157;22.0;8.5
62;2021-04-20;4148;3900;323847;128057;22.3;8.8
62;2021-04-21;3746;3988;327593;132045;22.5;9.1
62;2021-04-22;3948;5194;331541;137239;22.8;9.4
62;2021-04-23;4064;5333;335605;142572;23.1;9.8
62;2021-04-24;4401;6738;340006;149310;23.4;10.3
62;2021-04-25;1911;3504;341917;152814;23.5;10.5
62;2021-04-26;2224;2436;344141;155250;23.7;10.7
62;2021-04-27;4408;3773;348549;159023;24.0;10.9
62;2021-04-28;4591;4421;353140;163444;24.3;11.3
62;2021-04-29;4787;5909;357927;169353;24.6;11.7
62;2021-04-30;5215;5743;363142;175096;25.0;12.1
62;2021-05-01;5725;3482;368867;178578;25.4;12.3
62;2021-05-02;7826;3163;376693;181741;25.9;12.5
62;2021-05-03;4510;2351;381203;184092;26.2;12.7
62;2021-05-04;5398;4992;386601;189084;26.6;13.0
62;2021-05-05;4736;4844;391337;193928;26.9;13.3
62;2021-05-06;5619;4956;396956;198884;27.3;13.7
62;2021-05-07;7691;4688;404647;203572;27.9;14.0
62;2021-05-08;10659;2352;415306;205924;28.6;14.2
62;2021-05-09;8625;1642;423931;207566;29.2;14.3
62;2021-05-10;4866;4031;428797;211597;29.5;14.6
62;2021-05-11;6414;5060;435211;216657;30.0;14.9
62;2021-05-12;8624;4609;443835;221266;30.6;15.2
62;2021-05-13;9999;1492;453834;222758;31.2;15.3
62;2021-05-14;11880;3414;465714;226172;32.1;15.6
62;2021-05-15;19781;3303;485495;229475;33.4;15.8
62;2021-05-16;16399;1425;501894;230900;34.5;15.9
62;2021-05-17;8180;2659;510074;233559;35.1;16.1
62;2021-05-18;9326;3133;519400;236692;35.8;16.3
62;2021-05-19;8614;2933;528014;239625;36.3;16.5
62;2021-05-20;8341;3843;536355;243468;36.9;16.8
62;2021-05-21;9397;4222;545752;247690;37.6;17.0
62;2021-05-22;17874;3540;563626;251230;38.8;17.3
62;2021-05-23;12373;1164;575999;252394;39.6;17.4
62;2021-05-24;3911;587;579910;252981;39.9;17.4
62;2021-05-25;7220;4100;587130;257081;40.4;17.7
62;2021-05-26;6782;4913;593912;261994;40.9;18.0
62;2021-05-27;6382;5692;600294;267686;41.3;18.4
62;2021-05-28;6519;6772;606813;274458;41.8;18.9
62;2021-05-29;10849;5547;617662;280005;42.5;19.3
62;2021-05-30;4036;985;621698;280990;42.8;19.3
62;2021-05-31;4794;3969;626492;284959;43.1;19.6
62;2021-06-01;6520;6533;633012;291492;43.6;20.1
62;2021-06-02;7444;5820;640456;297312;44.1;20.5
62;2021-06-03;7854;5898;648310;303210;44.6;20.9
62;2021-06-04;7903;6263;656213;309473;45.2;21.3
62;2021-06-05;8274;6240;664487;315713;45.7;21.7
62;2021-06-06;3128;1292;667615;317005;46.0;21.8
62;2021-06-07;4627;3773;672242;320778;46.3;22.1
62;2021-06-08;6207;5912;678449;326690;46.7;22.5
62;2021-06-09;5499;4768;683948;331458;47.1;22.8
62;2021-06-10;5207;5890;689155;337348;47.4;23.2
62;2021-06-11;6208;8875;695363;346223;47.9;23.8
62;2021-06-12;5936;8647;701299;354870;48.3;24.4
62;2021-06-13;3225;3803;704524;358673;48.5;24.7
62;2021-06-14;2610;6781;707134;365454;48.7;25.2
62;2021-06-15;4675;8542;711809;373996;49.0;25.7
62;2021-06-16;5082;7431;716891;381427;49.3;26.3
62;2021-06-17;5234;8045;722125;389472;49.7;26.8
62;2021-06-18;4825;10494;726950;399966;50.0;27.5
62;2021-06-19;5792;13442;732742;413408;50.4;28.5
62;2021-06-20;2101;4369;734843;417777;50.6;28.8
62;2021-06-21;2976;8928;737819;426705;50.8;29.4
62;2021-06-22;3431;10170;741250;436875;51.0;30.1
62;2021-06-23;3388;10324;744638;447199;51.3;30.8
62;2021-06-24;3346;11787;747984;458986;51.5;31.6
62;2021-06-25;3724;15768;751708;474754;51.7;32.7
62;2021-06-26;3549;18426;755257;493180;52.0;33.9
62;2021-06-27;1121;9814;756378;502994;52.1;34.6
62;2021-06-28;1923;8871;758301;511865;52.2;35.2
62;2021-06-29;2974;11463;761275;523328;52.4;36.0
62;2021-06-30;4143;10816;765418;534144;52.7;36.8
62;2021-07-01;4483;10486;769901;544630;53.0;37.5
62;2021-07-02;4162;11985;774063;556615;53.3;38.3
62;2021-07-03;2997;18053;777060;574668;53.5;39.6
62;2021-07-04;1451;9195;778511;583863;53.6;40.2
62;2021-07-05;2416;6916;780927;590779;53.8;40.7
62;2021-07-06;3821;10017;784748;600796;54.0;41.4
62;2021-07-07;3917;8918;788665;609714;54.3;42.0
62;2021-07-08;5249;9088;793914;618802;54.6;42.6
62;2021-07-09;4473;10850;798387;629652;55.0;43.3
62;2021-07-10;4975;11890;803362;641542;55.3;44.2
62;2021-07-11;1337;2091;804699;643633;55.4;44.3
62;2021-07-12;2327;7135;807026;650768;55.6;44.8
62;2021-07-13;5175;12161;812201;662929;55.9;45.6
62;2021-07-14;3634;3164;815835;666093;56.2;45.8
62;2021-07-15;7588;11501;823423;677594;56.7;46.6
62;2021-07-16;7625;11046;831048;688640;57.2;47.4
62;2021-07-17;9719;10335;840767;698975;57.9;48.1
62;2021-07-18;2712;3458;843479;702433;58.1;48.4
62;2021-07-19;6014;7025;849493;709458;58.5;48.8
62;2021-07-20;7936;10725;857429;720183;59.0;49.6
62;2021-07-21;9778;9413;867207;729596;59.7;50.2
62;2021-07-22;9802;9027;877009;738623;60.4;50.8
62;2021-07-23;10630;8411;887639;747034;61.1;51.4
62;2021-07-24;9664;10322;897303;757356;61.8;52.1
62;2021-07-25;5549;1878;902852;759234;62.1;52.3
62;2021-07-26;6239;5390;909091;764624;62.6;52.6
62;2021-07-27;9851;8130;918942;772754;63.3;53.2
62;2021-07-28;10406;7489;929348;780243;64.0;53.7
62;2021-07-29;12007;7663;941355;787906;64.8;54.2
62;2021-07-30;9096;6296;950451;794202;65.4;54.7
62;2021-07-31;6640;4026;957091;798228;65.9;54.9
62;2021-08-01;2342;1103;959433;799331;66.0;55.0
62;2021-08-02;6867;4761;966300;804092;66.5;55.3
62;2021-08-03;8629;7476;974929;811568;67.1;55.9
62;2021-08-04;9491;5485;984420;817053;67.8;56.2
62;2021-08-05;8377;5635;992797;822688;68.3;56.6
62;2021-08-06;7322;5935;1000119;828623;68.8;57.0
62;2021-08-07;5494;4959;1005613;833582;69.2;57.4
62;2021-08-08;1877;1301;1007490;834883;69.3;57.5
62;2021-08-09;5262;5034;1012752;839917;69.7;57.8
62;2021-08-10;6222;7360;1018974;847277;70.1;58.3
62;2021-08-11;5415;7383;1024389;854660;70.5;58.8
62;2021-08-12;6007;7003;1030396;861663;70.9;59.3
62;2021-08-13;4522;6062;1034918;867725;71.2;59.7
62;2021-08-14;3838;6868;1038756;874593;71.5;60.2
62;2021-08-15;1141;1212;1039897;875805;71.6;60.3
62;2021-08-16;3188;5868;1043085;881673;71.8;60.7
62;2021-08-17;4172;7350;1047257;889023;72.1;61.2
62;2021-08-18;4362;7245;1051619;896268;72.4;61.7
62;2021-08-19;4392;8582;1056011;904850;72.7;62.3
62;2021-08-20;3448;8467;1059459;913317;72.9;62.9
62;2021-08-21;2459;9766;1061918;923083;73.1;63.5
62;2021-08-22;392;2817;1062310;925900;73.1;63.7
62;2021-08-23;2744;7831;1065054;933731;73.3;64.3
62;2021-08-24;3840;10409;1068894;944140;73.6;65.0
62;2021-08-25;3509;9197;1072403;953337;73.8;65.6
62;2021-08-26;3192;9775;1075595;963112;74.0;66.3
62;2021-08-27;2601;8826;1078196;971938;74.2;66.9
62;2021-08-28;2044;7996;1080240;979934;74.4;67.5
62;2021-08-29;864;2253;1081104;982187;74.4;67.6
62;2021-08-30;2049;7288;1083153;989475;74.6;68.1
62;2021-08-31;2146;7831;1085299;997306;74.7;68.6
62;2021-09-01;1849;5812;1087148;1003118;74.8;69.0
62;2021-09-02;1855;6450;1089003;1009568;75.0;69.5
62;2021-09-03;2073;6903;1091076;1016471;75.1;70.0
62;2021-09-04;2123;6276;1093199;1022747;75.2;70.4
62;2021-09-05;320;1198;1093519;1023945;75.3;70.5
62;2021-09-06;1032;3360;1094551;1027305;75.3;70.7
62;2021-09-07;1249;3860;1095800;1031165;75.4;71.0
62;2021-09-08;1304;4173;1097104;1035338;75.5;71.3
62;2021-09-09;1279;4263;1098383;1039601;75.6;71.6
62;2021-09-10;1597;4403;1099980;1044004;75.7;71.9
62;2021-09-11;1279;3954;1101259;1047958;75.8;72.1
62;2021-09-12;204;495;1101463;1048453;75.8;72.2
62;2021-09-13;791;2235;1102254;1050688;75.9;72.3
62;2021-09-14;1291;3382;1103545;1054070;76.0;72.6
62;2021-09-15;1349;4222;1104894;1058292;76.1;72.8
62;2021-09-16;1387;2921;1106281;1061213;76.1;73.0
62;2021-09-17;1337;2418;1107618;1063631;76.2;73.2
62;2021-09-18;1089;2883;1108707;1066514;76.3;73.4
62;2021-09-19;139;448;1108846;1066962;76.3;73.4
62;2021-09-20;618;1481;1109464;1068443;76.4;73.5
62;2021-09-21;903;2423;1110367;1070866;76.4;73.7
62;2021-09-22;791;2674;1111158;1073540;76.5;73.9
62;2021-09-23;732;1840;1111890;1075380;76.5;74.0
62;2021-09-24;817;1982;1112707;1077362;76.6;74.2
62;2021-09-25;723;2673;1113430;1080035;76.6;74.3
62;2021-09-26;73;373;1113503;1080408;76.6;74.4
62;2021-09-27;321;1056;1113824;1081464;76.7;74.4
62;2021-09-28;593;1707;1114417;1083171;76.7;74.6
62;2021-09-29;762;1906;1115179;1085077;76.8;74.7
62;2021-09-30;450;1008;1115629;1086085;76.8;74.8
62;2021-10-01;702;1665;1116331;1087750;76.8;74.9
62;2021-10-02;699;1498;1117030;1089248;76.9;75.0
62;2021-10-03;82;236;1117112;1089484;76.9;75.0
62;2021-10-04;376;790;1117488;1090274;76.9;75.0
62;2021-10-05;604;1454;1118092;1091728;77.0;75.1
62;2021-10-06;564;1244;1118656;1092972;77.0;75.2
62;2021-10-07;482;1257;1119138;1094229;77.0;75.3
62;2021-10-08;752;1598;1119890;1095827;77.1;75.4
62;2021-10-09;623;1395;1120513;1097222;77.1;75.5
62;2021-10-10;64;199;1120577;1097421;77.1;75.5
62;2021-10-11;338;656;1120915;1098077;77.2;75.6
62;2021-10-12;470;1346;1121385;1099423;77.2;75.7
62;2021-10-13;528;884;1121913;1100307;77.2;75.7
62;2021-10-14;403;765;1122316;1101072;77.3;75.8
62;2021-10-15;656;1139;1122972;1102211;77.3;75.9
62;2021-10-16;553;832;1123525;1103043;77.3;75.9
62;2021-10-17;54;75;1123579;1103118;77.3;75.9
62;2021-10-18;354;511;1123933;1103629;77.4;76.0
62;2021-10-19;539;824;1124472;1104453;77.4;76.0
63;2020-12-27;0;0;0;0;0.0;0.0
63;2020-12-28;1;0;1;0;0.0;0.0
63;2020-12-29;0;0;1;0;0.0;0.0
63;2020-12-30;0;0;1;0;0.0;0.0
63;2020-12-31;0;0;1;0;0.0;0.0
63;2021-01-01;1;0;2;0;0.0;0.0
63;2021-01-02;0;0;2;0;0.0;0.0
63;2021-01-03;1;0;3;0;0.0;0.0
63;2021-01-04;0;0;3;0;0.0;0.0
63;2021-01-05;1;0;4;0;0.0;0.0
63;2021-01-06;4;1;8;1;0.0;0.0
63;2021-01-07;310;1;318;2;0.0;0.0
63;2021-01-08;217;6;535;8;0.1;0.0
63;2021-01-09;91;0;626;8;0.1;0.0
63;2021-01-10;82;0;708;8;0.1;0.0
63;2021-01-11;432;4;1140;12;0.2;0.0
63;2021-01-12;661;1;1801;13;0.3;0.0
63;2021-01-13;873;8;2674;21;0.4;0.0
63;2021-01-14;547;10;3221;31;0.5;0.0
63;2021-01-15;432;5;3653;36;0.6;0.0
63;2021-01-16;157;0;3810;36;0.6;0.0
63;2021-01-17;134;0;3944;36;0.6;0.0
63;2021-01-18;634;3;4578;39;0.7;0.0
63;2021-01-19;868;2;5446;41;0.8;0.0
63;2021-01-20;1069;11;6515;52;1.0;0.0
63;2021-01-21;1018;3;7533;55;1.1;0.0
63;2021-01-22;970;3;8503;58;1.3;0.0
63;2021-01-23;192;0;8695;58;1.3;0.0
63;2021-01-24;165;2;8860;60;1.3;0.0
63;2021-01-25;829;4;9689;64;1.5;0.0
63;2021-01-26;975;2;10664;66;1.6;0.0
63;2021-01-27;1003;5;11667;71;1.8;0.0
63;2021-01-28;1323;69;12990;140;2.0;0.0
63;2021-01-29;1066;66;14056;206;2.1;0.0
63;2021-01-30;68;0;14124;206;2.1;0.0
63;2021-01-31;6;0;14130;206;2.1;0.0
63;2021-02-01;575;181;14705;387;2.2;0.1
63;2021-02-02;886;235;15591;622;2.4;0.1
63;2021-02-03;1477;287;17068;909;2.6;0.1
63;2021-02-04;2120;521;19188;1430;2.9;0.2
63;2021-02-05;1144;272;20332;1702;3.1;0.3
63;2021-02-06;116;0;20448;1702;3.1;0.3
63;2021-02-07;9;1;20457;1703;3.1;0.3
63;2021-02-08;539;405;20996;2108;3.2;0.3
63;2021-02-09;671;433;21667;2541;3.3;0.4
63;2021-02-10;609;602;22276;3143;3.4;0.5
63;2021-02-11;751;473;23027;3616;3.5;0.5
63;2021-02-12;819;808;23846;4424;3.6;0.7
63;2021-02-13;82;1;23928;4425;3.6;0.7
63;2021-02-14;0;65;23928;4490;3.6;0.7
63;2021-02-15;202;782;24130;5272;3.7;0.8
63;2021-02-16;409;1136;24539;6408;3.7;1.0
63;2021-02-17;359;876;24898;7284;3.8;1.1
63;2021-02-18;608;824;25506;8108;3.9;1.2
63;2021-02-19;449;970;25955;9078;3.9;1.4
63;2021-02-20;35;32;25990;9110;3.9;1.4
63;2021-02-21;2;17;25992;9127;3.9;1.4
63;2021-02-22;292;928;26284;10055;4.0;1.5
63;2021-02-23;580;1134;26864;11189;4.1;1.7
63;2021-02-24;696;1415;27560;12604;4.2;1.9
63;2021-02-25;1603;1665;29163;14269;4.4;2.2
63;2021-02-26;1623;1364;30786;15633;4.7;2.4
63;2021-02-27;641;73;31427;15706;4.8;2.4
63;2021-02-28;4;178;31431;15884;4.8;2.4
63;2021-03-01;586;518;32017;16402;4.8;2.5
63;2021-03-02;907;803;32924;17205;5.0;2.6
63;2021-03-03;1037;727;33961;17932;5.1;2.7
63;2021-03-04;1754;502;35715;18434;5.4;2.8
63;2021-03-05;2612;701;38327;19135;5.8;2.9
63;2021-03-06;1550;55;39877;19190;6.0;2.9
63;2021-03-07;512;21;40389;19211;6.1;2.9
63;2021-03-08;967;648;41356;19859;6.3;3.0
63;2021-03-09;1539;1065;42895;20924;6.5;3.2
63;2021-03-10;1655;618;44550;21542;6.7;3.3
63;2021-03-11;3056;897;47606;22439;7.2;3.4
63;2021-03-12;3515;396;51121;22835;7.7;3.5
63;2021-03-13;2050;86;53171;22921;8.1;3.5
63;2021-03-14;61;22;53232;22943;8.1;3.5
63;2021-03-15;1775;375;55007;23318;8.3;3.5
63;2021-03-16;1747;416;56754;23734;8.6;3.6
63;2021-03-17;1642;692;58396;24426;8.8;3.7
63;2021-03-18;1946;753;60342;25179;9.1;3.8
63;2021-03-19;2741;497;63083;25676;9.6;3.9
63;2021-03-20;1122;72;64205;25748;9.7;3.9
63;2021-03-21;50;45;64255;25793;9.7;3.9
63;2021-03-22;1985;261;66240;26054;10.0;3.9
63;2021-03-23;2886;348;69126;26402;10.5;4.0
63;2021-03-24;3224;353;72350;26755;11.0;4.1
63;2021-03-25;4598;399;76948;27154;11.7;4.1
63;2021-03-26;4692;577;81640;27731;12.4;4.2
63;2021-03-27;2457;235;84097;27966;12.7;4.2
63;2021-03-28;1047;83;85144;28049;12.9;4.2
63;2021-03-29;2480;525;87624;28574;13.3;4.3
63;2021-03-30;3283;632;90907;29206;13.8;4.4
63;2021-03-31;2968;761;93875;29967;14.2;4.5
63;2021-04-01;3846;543;97721;30510;14.8;4.6
63;2021-04-02;3484;713;101205;31223;15.3;4.7
63;2021-04-03;1174;181;102379;31404;15.5;4.8
63;2021-04-04;877;29;103256;31433;15.6;4.8
63;2021-04-05;802;86;104058;31519;15.8;4.8
63;2021-04-06;2483;943;106541;32462;16.1;4.9
63;2021-04-07;3208;875;109749;33337;16.6;5.0
63;2021-04-08;4720;1230;114469;34567;17.3;5.2
63;2021-04-09;5314;1012;119783;35579;18.1;5.4
63;2021-04-10;2222;482;122005;36061;18.5;5.5
63;2021-04-11;835;41;122840;36102;18.6;5.5
63;2021-04-12;1589;1315;124429;37417;18.8;5.7
63;2021-04-13;1986;1968;126415;39385;19.1;6.0
63;2021-04-14;2630;1439;129045;40824;19.5;6.2
63;2021-04-15;3809;1548;132854;42372;20.1;6.4
63;2021-04-16;2840;2167;135694;44539;20.6;6.7
63;2021-04-17;1233;673;136927;45212;20.7;6.8
63;2021-04-18;803;67;137730;45279;20.9;6.9
63;2021-04-19;1657;2107;139387;47386;21.1;7.2
63;2021-04-20;1702;2302;141089;49688;21.4;7.5
63;2021-04-21;1514;2413;142603;52101;21.6;7.9
63;2021-04-22;1916;2268;144519;54369;21.9;8.2
63;2021-04-23;2019;3115;146538;57484;22.2;8.7
63;2021-04-24;1192;1128;147730;58612;22.4;8.9
63;2021-04-25;554;412;148284;59024;22.5;8.9
63;2021-04-26;1438;2242;149722;61266;22.7;9.3
63;2021-04-27;2326;2616;152048;63882;23.0;9.7
63;2021-04-28;2346;3171;154394;67053;23.4;10.2
63;2021-04-29;2882;2841;157276;69894;23.8;10.6
63;2021-04-30;2862;2824;160138;72718;24.3;11.0
63;2021-05-01;1127;1052;161265;73770;24.4;11.2
63;2021-05-02;897;640;162162;74410;24.6;11.3
63;2021-05-03;2685;2253;164847;76663;25.0;11.6
63;2021-05-04;2877;2699;167724;79362;25.4;12.0
63;2021-05-05;2939;3126;170663;82488;25.8;12.5
63;2021-05-06;3673;3060;174336;85548;26.4;13.0
63;2021-05-07;4032;3546;178368;89094;27.0;13.5
63;2021-05-08;2002;655;180370;89749;27.3;13.6
63;2021-05-09;1802;608;182172;90357;27.6;13.7
63;2021-05-10;4194;2765;186366;93122;28.2;14.1
63;2021-05-11;5339;2769;191705;95891;29.0;14.5
63;2021-05-12;5274;2916;196979;98807;29.8;15.0
63;2021-05-13;4136;700;201115;99507;30.5;15.1
63;2021-05-14;4772;1514;205887;101021;31.2;15.3
63;2021-05-15;3727;987;209614;102008;31.7;15.5
63;2021-05-16;3521;448;213135;102456;32.3;15.5
63;2021-05-17;3902;1992;217037;104448;32.9;15.8
63;2021-05-18;5124;1615;222161;106063;33.6;16.1
63;2021-05-19;5229;1629;227390;107692;34.4;16.3
63;2021-05-20;6806;2092;234196;109784;35.5;16.6
63;2021-05-21;6256;2333;240452;112117;36.4;17.0
63;2021-05-22;3352;848;243804;112965;36.9;17.1
63;2021-05-23;2388;245;246192;113210;37.3;17.1
63;2021-05-24;2643;581;248835;113791;37.7;17.2
63;2021-05-25;4270;2646;253105;116437;38.3;17.6
63;2021-05-26;5452;2422;258557;118859;39.2;18.0
63;2021-05-27;6502;2801;265059;121660;40.1;18.4
63;2021-05-28;5422;3906;270481;125566;41.0;19.0
63;2021-05-29;3361;1503;273842;127069;41.5;19.2
63;2021-05-30;1579;217;275421;127286;41.7;19.3
63;2021-05-31;4157;2288;279578;129574;42.3;19.6
63;2021-06-01;3805;2963;283383;132537;42.9;20.1
63;2021-06-02;3886;2535;287269;135072;43.5;20.5
63;2021-06-03;4902;3143;292171;138215;44.3;20.9
63;2021-06-04;5100;3624;297271;141839;45.0;21.5
63;2021-06-05;2816;1747;300087;143586;45.5;21.7
63;2021-06-06;1310;698;301397;144284;45.6;21.9
63;2021-06-07;3163;2519;304560;146803;46.1;22.2
63;2021-06-08;2881;2754;307441;149557;46.6;22.7
63;2021-06-09;3025;2271;310466;151828;47.0;23.0
63;2021-06-10;3226;2691;313692;154519;47.5;23.4
63;2021-06-11;3099;4047;316791;158566;48.0;24.0
63;2021-06-12;1640;1969;318431;160535;48.2;24.3
63;2021-06-13;482;1098;318913;161633;48.3;24.5
63;2021-06-14;1824;3473;320737;165106;48.6;25.0
63;2021-06-15;2210;3480;322947;168586;48.9;25.5
63;2021-06-16;2576;3315;325523;171901;49.3;26.0
63;2021-06-17;2398;4316;327921;176217;49.7;26.7
63;2021-06-18;2480;5827;330401;182044;50.0;27.6
63;2021-06-19;1643;2835;332044;184879;50.3;28.0
63;2021-06-20;678;2441;332722;187320;50.4;28.4
63;2021-06-21;1272;5389;333994;192709;50.6;29.2
63;2021-06-22;1233;5539;335227;198248;50.8;30.0
63;2021-06-23;1531;4764;336758;203012;51.0;30.7
63;2021-06-24;1925;5383;338683;208395;51.3;31.6
63;2021-06-25;1751;5899;340434;214294;51.6;32.5
63;2021-06-26;1074;3352;341508;217646;51.7;33.0
63;2021-06-27;712;3487;342220;221133;51.8;33.5
63;2021-06-28;1136;5663;343356;226796;52.0;34.4
63;2021-06-29;1226;5160;344582;231956;52.2;35.1
63;2021-06-30;1606;5294;346188;237250;52.4;35.9
63;2021-07-01;1928;8070;348116;245320;52.7;37.2
63;2021-07-02;2061;6540;350177;251860;53.0;38.1
63;2021-07-03;965;2929;351142;254789;53.2;38.6
63;2021-07-04;1066;1885;352208;256674;53.3;38.9
63;2021-07-05;1540;6280;353748;262954;53.6;39.8
63;2021-07-06;1610;4808;355358;267762;53.8;40.6
63;2021-07-07;1973;4089;357331;271851;54.1;41.2
63;2021-07-08;2204;4587;359535;276438;54.5;41.9
63;2021-07-09;1911;5720;361446;282158;54.7;42.7
63;2021-07-10;1534;3416;362980;285574;55.0;43.3
63;2021-07-11;910;1538;363890;287112;55.1;43.5
63;2021-07-12;1597;8702;365487;295814;55.4;44.8
63;2021-07-13;3597;6133;369084;301947;55.9;45.7
63;2021-07-14;3618;1790;372702;303737;56.4;46.0
63;2021-07-15;4415;5035;377117;308772;57.1;46.8
63;2021-07-16;4693;5788;381810;314560;57.8;47.6
63;2021-07-17;3012;2473;384822;317033;58.3;48.0
63;2021-07-18;2825;1091;387647;318124;58.7;48.2
63;2021-07-19;4002;4848;391649;322972;59.3;48.9
63;2021-07-20;4738;5461;396387;328433;60.0;49.7
63;2021-07-21;4789;3979;401176;332412;60.8;50.3
63;2021-07-22;5512;4402;406688;336814;61.6;51.0
63;2021-07-23;5161;4652;411849;341466;62.4;51.7
63;2021-07-24;3679;1952;415528;343418;62.9;52.0
63;2021-07-25;3065;1439;418593;344857;63.4;52.2
63;2021-07-26;4038;3230;422631;348087;64.0;52.7
63;2021-07-27;3934;3166;426565;351253;64.6;53.2
63;2021-07-28;3851;2717;430416;353970;65.2;53.6
63;2021-07-29;4453;3160;434869;357130;65.9;54.1
63;2021-07-30;3807;3575;438676;360705;66.4;54.6
63;2021-07-31;2161;1721;440837;362426;66.8;54.9
63;2021-08-01;1197;837;442034;363263;67.0;55.0
63;2021-08-02;2227;3067;444261;366330;67.3;55.5
63;2021-08-03;2728;3255;446989;369585;67.7;56.0
63;2021-08-04;2808;3245;449797;372830;68.1;56.5
63;2021-08-05;2444;3481;452241;376311;68.5;57.0
63;2021-08-06;2352;4154;454593;380465;68.9;57.6
63;2021-08-07;1305;2808;455898;383273;69.1;58.1
63;2021-08-08;324;1205;456222;384478;69.1;58.2
63;2021-08-09;1849;4210;458071;388688;69.4;58.9
63;2021-08-10;2218;3994;460289;392682;69.7;59.5
63;2021-08-11;2100;3628;462389;396310;70.0;60.0
63;2021-08-12;1855;4620;464244;400930;70.3;60.7
63;2021-08-13;1677;4010;465921;404940;70.6;61.3
63;2021-08-14;842;3239;466763;408179;70.7;61.8
63;2021-08-15;184;1451;466947;409630;70.7;62.0
63;2021-08-16;1171;4396;468118;414026;70.9;62.7
63;2021-08-17;1601;4052;469719;418078;71.1;63.3
63;2021-08-18;1450;3305;471169;421383;71.4;63.8
63;2021-08-19;1322;3443;472491;424826;71.6;64.3
63;2021-08-20;1387;3712;473878;428538;71.8;64.9
63;2021-08-21;674;2166;474552;430704;71.9;65.2
63;2021-08-22;212;1092;474764;431796;71.9;65.4
63;2021-08-23;1075;3591;475839;435387;72.1;65.9
63;2021-08-24;1091;2990;476930;438377;72.2;66.4
63;2021-08-25;1006;2788;477936;441165;72.4;66.8
63;2021-08-26;1130;2708;479066;443873;72.6;67.2
63;2021-08-27;1149;3162;480215;447035;72.7;67.7
63;2021-08-28;698;1709;480913;448744;72.8;68.0
63;2021-08-29;107;577;481020;449321;72.9;68.1
63;2021-08-30;790;2398;481810;451719;73.0;68.4
63;2021-08-31;992;2473;482802;454192;73.1;68.8
63;2021-09-01;962;1867;483764;456059;73.3;69.1
63;2021-09-02;820;1771;484584;457830;73.4;69.3
63;2021-09-03;906;2262;485490;460092;73.5;69.7
63;2021-09-04;717;1411;486207;461503;73.6;69.9
63;2021-09-05;80;258;486287;461761;73.7;69.9
63;2021-09-06;562;1144;486849;462905;73.7;70.1
63;2021-09-07;660;1343;487509;464248;73.8;70.3
63;2021-09-08;706;1456;488215;465704;73.9;70.5
63;2021-09-09;595;1163;488810;466867;74.0;70.7
63;2021-09-10;733;1645;489543;468512;74.1;71.0
63;2021-09-11;459;998;490002;469510;74.2;71.1
63;2021-09-12;51;144;490053;469654;74.2;71.1
63;2021-09-13;457;930;490510;470584;74.3;71.3
63;2021-09-14;530;814;491040;471398;74.4;71.4
63;2021-09-15;635;1288;491675;472686;74.5;71.6
63;2021-09-16;476;872;492151;473558;74.5;71.7
63;2021-09-17;474;1261;492625;474819;74.6;71.9
63;2021-09-18;323;993;492948;475812;74.7;72.1
63;2021-09-19;44;97;492992;475909;74.7;72.1
63;2021-09-20;401;707;493393;476616;74.7;72.2
63;2021-09-21;412;663;493805;477279;74.8;72.3
63;2021-09-22;401;1113;494206;478392;74.9;72.5
63;2021-09-23;299;666;494505;479058;74.9;72.6
63;2021-09-24;486;1182;494991;480240;75.0;72.7
63;2021-09-25;254;816;495245;481056;75.0;72.9
63;2021-09-26;26;100;495271;481156;75.0;72.9
63;2021-09-27;318;643;495589;481799;75.1;73.0
63;2021-09-28;292;617;495881;482416;75.1;73.1
63;2021-09-29;304;734;496185;483150;75.2;73.2
63;2021-09-30;295;657;496480;483807;75.2;73.3
63;2021-10-01;473;859;496953;484666;75.3;73.4
63;2021-10-02;273;558;497226;485224;75.3;73.5
63;2021-10-03;37;69;497263;485293;75.3;73.5
63;2021-10-04;209;403;497472;485696;75.3;73.6
63;2021-10-05;261;456;497733;486152;75.4;73.6
63;2021-10-06;332;603;498065;486755;75.4;73.7
63;2021-10-07;247;462;498312;487217;75.5;73.8
63;2021-10-08;411;714;498723;487931;75.5;73.9
63;2021-10-09;240;418;498963;488349;75.6;74.0
63;2021-10-10;36;57;498999;488406;75.6;74.0
63;2021-10-11;206;431;499205;488837;75.6;74.0
63;2021-10-12;194;380;499399;489217;75.6;74.1
63;2021-10-13;313;550;499712;489767;75.7;74.2
63;2021-10-14;246;339;499958;490106;75.7;74.2
63;2021-10-15;424;648;500382;490754;75.8;74.3
63;2021-10-16;217;369;500599;491123;75.8;74.4
63;2021-10-17;24;37;500623;491160;75.8;74.4
63;2021-10-18;214;424;500837;491584;75.9;74.5
63;2021-10-19;207;253;501044;491837;75.9;74.5
64;2020-12-27;1;0;1;0;0.0;0.0
64;2020-12-28;2;0;3;0;0.0;0.0
64;2020-12-29;0;0;3;0;0.0;0.0
64;2020-12-30;1;0;4;0;0.0;0.0
64;2020-12-31;0;0;4;0;0.0;0.0
64;2021-01-01;1;0;5;0;0.0;0.0
64;2021-01-02;0;0;5;0;0.0;0.0
64;2021-01-03;0;0;5;0;0.0;0.0
64;2021-01-04;29;0;34;0;0.0;0.0
64;2021-01-05;25;0;59;0;0.0;0.0
64;2021-01-06;189;0;248;0;0.0;0.0
64;2021-01-07;842;1;1090;1;0.2;0.0
64;2021-01-08;880;3;1970;4;0.3;0.0
64;2021-01-09;55;1;2025;5;0.3;0.0
64;2021-01-10;2;0;2027;5;0.3;0.0
64;2021-01-11;543;0;2570;5;0.4;0.0
64;2021-01-12;760;4;3330;9;0.5;0.0
64;2021-01-13;866;3;4196;12;0.6;0.0
64;2021-01-14;1046;6;5242;18;0.8;0.0
64;2021-01-15;930;5;6172;23;0.9;0.0
64;2021-01-16;70;0;6242;23;0.9;0.0
64;2021-01-17;8;2;6250;25;0.9;0.0
64;2021-01-18;942;8;7192;33;1.1;0.0
64;2021-01-19;1448;4;8640;37;1.3;0.0
64;2021-01-20;1618;3;10258;40;1.5;0.0
64;2021-01-21;2603;2;12861;42;1.9;0.0
64;2021-01-22;1651;4;14512;46;2.1;0.0
64;2021-01-23;525;1;15037;47;2.2;0.0
64;2021-01-24;89;0;15126;47;2.2;0.0
64;2021-01-25;974;9;16100;56;2.4;0.0
64;2021-01-26;1358;22;17458;78;2.6;0.0
64;2021-01-27;1241;119;18699;197;2.7;0.0
64;2021-01-28;1652;631;20351;828;3.0;0.1
64;2021-01-29;975;651;21326;1479;3.1;0.2
64;2021-01-30;469;59;21795;1538;3.2;0.2
64;2021-01-31;93;0;21888;1538;3.2;0.2
64;2021-02-01;674;311;22562;1849;3.3;0.3
64;2021-02-02;1134;554;23696;2403;3.5;0.4
64;2021-02-03;1044;646;24740;3049;3.6;0.4
64;2021-02-04;1028;535;25768;3584;3.8;0.5
64;2021-02-05;869;456;26637;4040;3.9;0.6
64;2021-02-06;501;32;27138;4072;4.0;0.6
64;2021-02-07;131;5;27269;4077;4.0;0.6
64;2021-02-08;769;311;28038;4388;4.1;0.6
64;2021-02-09;949;714;28987;5102;4.2;0.7
64;2021-02-10;916;790;29903;5892;4.4;0.9
64;2021-02-11;1199;1508;31102;7400;4.6;1.1
64;2021-02-12;1076;1064;32178;8464;4.7;1.2
64;2021-02-13;223;314;32401;8778;4.7;1.3
64;2021-02-14;38;48;32439;8826;4.7;1.3
64;2021-02-15;223;1132;32662;9958;4.8;1.5
64;2021-02-16;261;1405;32923;11363;4.8;1.7
64;2021-02-17;291;1245;33214;12608;4.9;1.8
64;2021-02-18;509;1714;33723;14322;4.9;2.1
64;2021-02-19;413;1289;34136;15611;5.0;2.3
64;2021-02-20;119;435;34255;16046;5.0;2.3
64;2021-02-21;20;83;34275;16129;5.0;2.4
64;2021-02-22;478;984;34753;17113;5.1;2.5
64;2021-02-23;723;1145;35476;18258;5.2;2.7
64;2021-02-24;732;1015;36208;19273;5.3;2.8
64;2021-02-25;1094;955;37302;20228;5.5;3.0
64;2021-02-26;1216;915;38518;21143;5.6;3.1
64;2021-02-27;864;405;39382;21548;5.8;3.2
64;2021-02-28;42;82;39424;21630;5.8;3.2
64;2021-03-01;767;799;40191;22429;5.9;3.3
64;2021-03-02;1078;918;41269;23347;6.0;3.4
64;2021-03-03;1252;1001;42521;24348;6.2;3.6
64;2021-03-04;1883;1184;44404;25532;6.5;3.7
64;2021-03-05;2199;1078;46603;26610;6.8;3.9
64;2021-03-06;1543;518;48146;27128;7.0;4.0
64;2021-03-07;595;113;48741;27241;7.1;4.0
64;2021-03-08;1534;765;50275;28006;7.4;4.1
64;2021-03-09;2071;849;52346;28855;7.7;4.2
64;2021-03-10;2083;765;54429;29620;8.0;4.3
64;2021-03-11;2976;1077;57405;30697;8.4;4.5
64;2021-03-12;3488;608;60893;31305;8.9;4.6
64;2021-03-13;2259;171;63152;31476;9.2;4.6
64;2021-03-14;233;15;63385;31491;9.3;4.6
64;2021-03-15;2341;235;65726;31726;9.6;4.6
64;2021-03-16;2002;269;67728;31995;9.9;4.7
64;2021-03-17;2070;241;69798;32236;10.2;4.7
64;2021-03-18;2465;209;72263;32445;10.6;4.7
64;2021-03-19;3014;288;75277;32733;11.0;4.8
64;2021-03-20;2470;95;77747;32828;11.4;4.8
64;2021-03-21;1283;28;79030;32856;11.6;4.8
64;2021-03-22;2589;557;81619;33413;11.9;4.9
64;2021-03-23;3197;650;84816;34063;12.4;5.0
64;2021-03-24;3564;708;88380;34771;12.9;5.1
64;2021-03-25;4350;805;92730;35576;13.6;5.2
64;2021-03-26;4429;713;97159;36289;14.2;5.3
64;2021-03-27;2974;437;100133;36726;14.7;5.4
64;2021-03-28;521;56;100654;36782;14.7;5.4
64;2021-03-29;3028;890;103682;37672;15.2;5.5
64;2021-03-30;4135;874;107817;38546;15.8;5.6
64;2021-03-31;3594;796;111411;39342;16.3;5.8
64;2021-04-01;4787;944;116198;40286;17.0;5.9
64;2021-04-02;4445;747;120643;41033;17.7;6.0
64;2021-04-03;2061;588;122704;41621;18.0;6.1
64;2021-04-04;310;50;123014;41671;18.0;6.1
64;2021-04-05;1689;144;124703;41815;18.3;6.1
64;2021-04-06;3647;1394;128350;43209;18.8;6.3
64;2021-04-07;3946;1519;132296;44728;19.4;6.5
64;2021-04-08;5191;1602;137487;46330;20.1;6.8
64;2021-04-09;5899;1648;143386;47978;21.0;7.0
64;2021-04-10;3222;1054;146608;49032;21.5;7.2
64;2021-04-11;448;252;147056;49284;21.5;7.2
64;2021-04-12;4047;1867;151103;51151;22.1;7.5
64;2021-04-13;4466;2172;155569;53323;22.8;7.8
64;2021-04-14;4091;2143;159660;55466;23.4;8.1
64;2021-04-15;4393;2300;164053;57766;24.0;8.5
64;2021-04-16;4300;2261;168353;60027;24.6;8.8
64;2021-04-17;2479;1504;170832;61531;25.0;9.0
64;2021-04-18;1096;1181;171928;62712;25.2;9.2
64;2021-04-19;2735;2449;174663;65161;25.6;9.5
64;2021-04-20;3208;2435;177871;67596;26.0;9.9
64;2021-04-21;3225;2567;181096;70163;26.5;10.3
64;2021-04-22;3389;2788;184485;72951;27.0;10.7
64;2021-04-23;3435;2617;187920;75568;27.5;11.1
64;2021-04-24;2068;1591;189988;77159;27.8;11.3
64;2021-04-25;290;237;190278;77396;27.9;11.3
64;2021-04-26;2661;2656;192939;80052;28.2;11.7
64;2021-04-27;3061;3139;196000;83191;28.7;12.2
64;2021-04-28;3604;3066;199604;86257;29.2;12.6
64;2021-04-29;4650;3465;204254;89722;29.9;13.1
64;2021-04-30;4085;3616;208339;93338;30.5;13.7
64;2021-05-01;1486;1032;209825;94370;30.7;13.8
64;2021-05-02;446;325;210271;94695;30.8;13.9
64;2021-05-03;2910;3528;213181;98223;31.2;14.4
64;2021-05-04;3647;3999;216828;102222;31.7;15.0
64;2021-05-05;3358;4011;220186;106233;32.2;15.6
64;2021-05-06;4110;3992;224296;110225;32.8;16.1
64;2021-05-07;3922;4195;228218;114420;33.4;16.7
64;2021-05-08;2623;1236;230841;115656;33.8;16.9
64;2021-05-09;722;305;231563;115961;33.9;17.0
64;2021-05-10;2861;4238;234424;120199;34.3;17.6
64;2021-05-11;4183;4150;238607;124349;34.9;18.2
64;2021-05-12;4489;3945;243096;128294;35.6;18.8
64;2021-05-13;3198;887;246294;129181;36.1;18.9
64;2021-05-14;5153;3150;251447;132331;36.8;19.4
64;2021-05-15;3527;1865;254974;134196;37.3;19.6
64;2021-05-16;498;225;255472;134421;37.4;19.7
64;2021-05-17;4191;2391;259663;136812;38.0;20.0
64;2021-05-18;5164;2305;264827;139117;38.8;20.4
64;2021-05-19;4980;2165;269807;141282;39.5;20.7
64;2021-05-20;5567;2158;275374;143440;40.3;21.0
64;2021-05-21;5268;2249;280642;145689;41.1;21.3
64;2021-05-22;3582;1508;284224;147197;41.6;21.5
64;2021-05-23;431;206;284655;147403;41.7;21.6
64;2021-05-24;2996;1233;287651;148636;42.1;21.8
64;2021-05-25;4332;2852;291983;151488;42.7;22.2
64;2021-05-26;4359;2716;296342;154204;43.4;22.6
64;2021-05-27;5283;3156;301625;157360;44.2;23.0
64;2021-05-28;4620;3439;306245;160799;44.8;23.5
64;2021-05-29;2810;2114;309055;162913;45.2;23.8
64;2021-05-30;439;203;309494;163116;45.3;23.9
64;2021-05-31;3890;3662;313384;166778;45.9;24.4
64;2021-06-01;5334;3570;318718;170348;46.7;24.9
64;2021-06-02;4931;3176;323649;173524;47.4;25.4
64;2021-06-03;6365;3263;330014;176787;48.3;25.9
64;2021-06-04;5150;4558;335164;181345;49.1;26.5
64;2021-06-05;3482;2523;338646;183868;49.6;26.9
64;2021-06-06;2014;330;340660;184198;49.9;27.0
64;2021-06-07;4128;4333;344788;188531;50.5;27.6
64;2021-06-08;5150;4126;349938;192657;51.2;28.2
64;2021-06-09;5151;3660;355089;196317;52.0;28.7
64;2021-06-10;6180;3145;361269;199462;52.9;29.2
64;2021-06-11;5585;4880;366854;204342;53.7;29.9
64;2021-06-12;3950;2336;370804;206678;54.3;30.3
64;2021-06-13;1555;394;372359;207072;54.5;30.3
64;2021-06-14;3669;4793;376028;211865;55.0;31.0
64;2021-06-15;4572;4708;380600;216573;55.7;31.7
64;2021-06-16;4470;4665;385070;221238;56.4;32.4
64;2021-06-17;3641;4306;388711;225544;56.9;33.0
64;2021-06-18;4421;5170;393132;230714;57.5;33.8
64;2021-06-19;2984;3282;396116;233996;58.0;34.3
64;2021-06-20;881;538;396997;234534;58.1;34.3
64;2021-06-21;2314;5125;399311;239659;58.4;35.1
64;2021-06-22;2555;5725;401866;245384;58.8;35.9
64;2021-06-23;3104;5482;404970;250866;59.3;36.7
64;2021-06-24;2719;3810;407689;254676;59.7;37.3
64;2021-06-25;2900;6435;410589;261111;60.1;38.2
64;2021-06-26;1798;3835;412387;264946;60.4;38.8
64;2021-06-27;493;713;412880;265659;60.4;38.9
64;2021-06-28;1935;6070;414815;271729;60.7;39.8
64;2021-06-29;1967;6266;416782;277995;61.0;40.7
64;2021-06-30;2255;6000;419037;283995;61.3;41.6
64;2021-07-01;2406;5342;421443;289337;61.7;42.4
64;2021-07-02;2307;6407;423750;295744;62.0;43.3
64;2021-07-03;1263;3783;425013;299527;62.2;43.8
64;2021-07-04;411;847;425424;300374;62.3;44.0
64;2021-07-05;1376;5406;426800;305780;62.5;44.8
64;2021-07-06;1994;6152;428794;311932;62.8;45.7
64;2021-07-07;2062;5750;430856;317682;63.1;46.5
64;2021-07-08;1804;4397;432660;322079;63.3;47.1
64;2021-07-09;1825;6536;434485;328615;63.6;48.1
64;2021-07-10;1171;3882;435656;332497;63.8;48.7
64;2021-07-11;253;860;435909;333357;63.8;48.8
64;2021-07-12;1501;6086;437410;339443;64.0;49.7
64;2021-07-13;2367;7248;439777;346691;64.4;50.7
64;2021-07-14;2368;3407;442145;350098;64.7;51.2
64;2021-07-15;2105;5480;444250;355578;65.0;52.0
64;2021-07-16;2848;6777;447098;362355;65.4;53.0
64;2021-07-17;2338;4586;449436;366941;65.8;53.7
64;2021-07-18;716;2051;450152;368992;65.9;54.0
64;2021-07-19;2348;6122;452500;375114;66.2;54.9
64;2021-07-20;3129;6560;455629;381674;66.7;55.9
64;2021-07-21;3345;6046;458974;387720;67.2;56.8
64;2021-07-22;3808;5718;462782;393438;67.7;57.6
64;2021-07-23;3724;5621;466506;399059;68.3;58.4
64;2021-07-24;2554;4431;469060;403490;68.7;59.1
64;2021-07-25;754;1062;469814;404552;68.8;59.2
64;2021-07-26;3085;5132;472899;409684;69.2;60.0
64;2021-07-27;4261;5146;477160;414830;69.8;60.7
64;2021-07-28;4315;4598;481475;419428;70.5;61.4
64;2021-07-29;5518;3905;486993;423333;71.3;62.0
64;2021-07-30;5146;4236;492139;427569;72.0;62.6
64;2021-07-31;3171;3346;495310;430915;72.5;63.1
64;2021-08-01;1145;589;496455;431504;72.7;63.2
64;2021-08-02;4371;2633;500826;434137;73.3;63.5
64;2021-08-03;4557;3176;505383;437313;74.0;64.0
64;2021-08-04;4133;3000;509516;440313;74.6;64.5
64;2021-08-05;4037;2614;513553;442927;75.2;64.8
64;2021-08-06;3844;3338;517397;446265;75.7;65.3
64;2021-08-07;2481;2701;519878;448966;76.1;65.7
64;2021-08-08;492;609;520370;449575;76.2;65.8
64;2021-08-09;2740;3201;523110;452776;76.6;66.3
64;2021-08-10;3354;3437;526464;456213;77.1;66.8
64;2021-08-11;3068;3264;529532;459477;77.5;67.3
64;2021-08-12;3191;3308;532723;462785;78.0;67.7
64;2021-08-13;2575;3660;535298;466445;78.4;68.3
64;2021-08-14;1633;2684;536931;469129;78.6;68.7
64;2021-08-15;208;691;537139;469820;78.6;68.8
64;2021-08-16;2101;3235;539240;473055;78.9;69.2
64;2021-08-17;2299;3708;541539;476763;79.3;69.8
64;2021-08-18;2044;3521;543583;480284;79.6;70.3
64;2021-08-19;1939;3525;545522;483809;79.9;70.8
64;2021-08-20;1578;3975;547100;487784;80.1;71.4
64;2021-08-21;975;2883;548075;490667;80.2;71.8
64;2021-08-22;160;895;548235;491562;80.2;72.0
64;2021-08-23;1269;3239;549504;494801;80.4;72.4
64;2021-08-24;1379;4596;550883;499397;80.6;73.1
64;2021-08-25;1260;3747;552143;503144;80.8;73.6
64;2021-08-26;1112;3532;553255;506676;81.0;74.2
64;2021-08-27;1190;4230;554445;510906;81.2;74.8
64;2021-08-28;735;2496;555180;513402;81.3;75.2
64;2021-08-29;90;533;555270;513935;81.3;75.2
64;2021-08-30;989;3518;556259;517453;81.4;75.7
64;2021-08-31;990;3761;557249;521214;81.6;76.3
64;2021-09-01;932;2912;558181;524126;81.7;76.7
64;2021-09-02;901;2814;559082;526940;81.8;77.1
64;2021-09-03;874;2746;559956;529686;82.0;77.5
64;2021-09-04;698;2056;560654;531742;82.1;77.8
64;2021-09-05;74;206;560728;531948;82.1;77.9
64;2021-09-06;533;2130;561261;534078;82.2;78.2
64;2021-09-07;717;1937;561978;536015;82.3;78.5
64;2021-09-08;737;2539;562715;538554;82.4;78.8
64;2021-09-09;482;1719;563197;540273;82.4;79.1
64;2021-09-10;744;2057;563941;542330;82.5;79.4
64;2021-09-11;594;1974;564535;544304;82.6;79.7
64;2021-09-12;63;167;564598;544471;82.6;79.7
64;2021-09-13;443;1404;565041;545875;82.7;79.9
64;2021-09-14;489;1090;565530;546965;82.8;80.1
64;2021-09-15;690;1747;566220;548712;82.9;80.3
64;2021-09-16;487;844;566707;549556;83.0;80.4
64;2021-09-17;567;1354;567274;550910;83.0;80.6
64;2021-09-18;332;1258;567606;552168;83.1;80.8
64;2021-09-19;18;42;567624;552210;83.1;80.8
64;2021-09-20;248;482;567872;552692;83.1;80.9
64;2021-09-21;436;955;568308;553647;83.2;81.0
64;2021-09-22;384;1426;568692;555073;83.2;81.2
64;2021-09-23;278;730;568970;555803;83.3;81.4
64;2021-09-24;401;985;569371;556788;83.3;81.5
64;2021-09-25;298;1033;569669;557821;83.4;81.7
64;2021-09-26;0;4;569669;557825;83.4;81.7
64;2021-09-27;235;568;569904;558393;83.4;81.7
64;2021-09-28;261;672;570165;559065;83.5;81.8
64;2021-09-29;342;983;570507;560048;83.5;82.0
64;2021-09-30;260;441;570767;560489;83.5;82.0
64;2021-10-01;308;727;571075;561216;83.6;82.1
64;2021-10-02;214;566;571289;561782;83.6;82.2
64;2021-10-03;0;2;571289;561784;83.6;82.2
64;2021-10-04;240;426;571529;562210;83.7;82.3
64;2021-10-05;315;635;571844;562845;83.7;82.4
64;2021-10-06;409;911;572253;563756;83.8;82.5
64;2021-10-07;203;502;572456;564258;83.8;82.6
64;2021-10-08;315;706;572771;564964;83.8;82.7
64;2021-10-09;247;403;573018;565367;83.9;82.8
64;2021-10-10;0;8;573018;565375;83.9;82.8
64;2021-10-11;141;256;573159;565631;83.9;82.8
64;2021-10-12;267;611;573426;566242;83.9;82.9
64;2021-10-13;355;588;573781;566830;84.0;83.0
64;2021-10-14;201;255;573982;567085;84.0;83.0
64;2021-10-15;294;557;574276;567642;84.1;83.1
64;2021-10-16;181;273;574457;567915;84.1;83.1
64;2021-10-17;14;6;574471;567921;84.1;83.1
64;2021-10-18;134;261;574605;568182;84.1;83.2
64;2021-10-19;220;345;574825;568527;84.1;83.2
65;2020-12-27;0;0;0;0;0.0;0.0
65;2020-12-28;1;1;1;1;0.0;0.0
65;2020-12-29;0;0;1;1;0.0;0.0
65;2020-12-30;0;0;1;1;0.0;0.0
65;2020-12-31;0;0;1;1;0.0;0.0
65;2021-01-01;1;1;2;2;0.0;0.0
65;2021-01-02;0;0;2;2;0.0;0.0
65;2021-01-03;0;0;2;2;0.0;0.0
65;2021-01-04;0;0;2;2;0.0;0.0
65;2021-01-05;1;0;3;2;0.0;0.0
65;2021-01-06;3;0;6;2;0.0;0.0
65;2021-01-07;168;0;174;2;0.1;0.0
65;2021-01-08;253;1;427;3;0.2;0.0
65;2021-01-09;177;2;604;5;0.3;0.0
65;2021-01-10;1;0;605;5;0.3;0.0
65;2021-01-11;275;3;880;8;0.4;0.0
65;2021-01-12;271;1;1151;9;0.5;0.0
65;2021-01-13;587;1;1738;10;0.8;0.0
65;2021-01-14;581;9;2319;19;1.0;0.0
65;2021-01-15;527;2;2846;21;1.3;0.0
65;2021-01-16;221;2;3067;23;1.4;0.0
65;2021-01-17;0;0;3067;23;1.4;0.0
65;2021-01-18;554;5;3621;28;1.6;0.0
65;2021-01-19;571;2;4192;30;1.8;0.0
65;2021-01-20;585;6;4777;36;2.1;0.0
65;2021-01-21;585;0;5362;36;2.4;0.0
65;2021-01-22;598;2;5960;38;2.6;0.0
65;2021-01-23;174;1;6134;39;2.7;0.0
65;2021-01-24;3;1;6137;40;2.7;0.0
65;2021-01-25;551;4;6688;44;2.9;0.0
65;2021-01-26;883;2;7571;46;3.3;0.0
65;2021-01-27;592;14;8163;60;3.6;0.0
65;2021-01-28;509;71;8672;131;3.8;0.1
65;2021-01-29;426;138;9098;269;4.0;0.1
65;2021-01-30;182;74;9280;343;4.1;0.2
65;2021-01-31;15;0;9295;343;4.1;0.2
65;2021-02-01;351;120;9646;463;4.3;0.2
65;2021-02-02;433;200;10079;663;4.4;0.3
65;2021-02-03;463;245;10542;908;4.6;0.4
65;2021-02-04;310;332;10852;1240;4.8;0.5
65;2021-02-05;284;362;11136;1602;4.9;0.7
65;2021-02-06;99;99;11235;1701;5.0;0.7
65;2021-02-07;10;0;11245;1701;5.0;0.7
65;2021-02-08;426;221;11671;1922;5.1;0.8
65;2021-02-09;272;379;11943;2301;5.3;1.0
65;2021-02-10;298;269;12241;2570;5.4;1.1
65;2021-02-11;320;275;12561;2845;5.5;1.3
65;2021-02-12;277;229;12838;3074;5.7;1.4
65;2021-02-13;126;97;12964;3171;5.7;1.4
65;2021-02-14;3;16;12967;3187;5.7;1.4
65;2021-02-15;203;412;13170;3599;5.8;1.6
65;2021-02-16;489;578;13659;4177;6.0;1.8
65;2021-02-17;231;500;13890;4677;6.1;2.1
65;2021-02-18;284;581;14174;5258;6.2;2.3
65;2021-02-19;156;478;14330;5736;6.3;2.5
65;2021-02-20;53;158;14383;5894;6.3;2.6
65;2021-02-21;3;48;14386;5942;6.3;2.6
65;2021-02-22;167;539;14553;6481;6.4;2.9
65;2021-02-23;249;527;14802;7008;6.5;3.1
65;2021-02-24;231;639;15033;7647;6.6;3.4
65;2021-02-25;215;183;15248;7830;6.7;3.5
65;2021-02-26;349;772;15597;8602;6.9;3.8
65;2021-02-27;109;204;15706;8806;6.9;3.9
65;2021-02-28;1;0;15707;8806;6.9;3.9
65;2021-03-01;379;373;16086;9179;7.1;4.0
65;2021-03-02;455;364;16541;9543;7.3;4.2
65;2021-03-03;381;391;16922;9934;7.5;4.4
65;2021-03-04;699;332;17621;10266;7.8;4.5
65;2021-03-05;679;286;18300;10552;8.1;4.7
65;2021-03-06;1187;89;19487;10641;8.6;4.7
65;2021-03-07;257;12;19744;10653;8.7;4.7
65;2021-03-08;412;345;20156;10998;8.9;4.8
65;2021-03-09;670;339;20826;11337;9.2;5.0
65;2021-03-10;625;371;21451;11708;9.5;5.2
65;2021-03-11;778;362;22229;12070;9.8;5.3
65;2021-03-12;1060;192;23289;12262;10.3;5.4
65;2021-03-13;356;93;23645;12355;10.4;5.4
65;2021-03-14;3;30;23648;12385;10.4;5.5
65;2021-03-15;817;188;24465;12573;10.8;5.5
65;2021-03-16;694;221;25159;12794;11.1;5.6
65;2021-03-17;712;210;25871;13004;11.4;5.7
65;2021-03-18;537;236;26408;13240;11.6;5.8
65;2021-03-19;879;164;27287;13404;12.0;5.9
65;2021-03-20;245;46;27532;13450;12.1;5.9
65;2021-03-21;12;2;27544;13452;12.1;5.9
65;2021-03-22;734;154;28278;13606;12.5;6.0
65;2021-03-23;838;369;29116;13975;12.8;6.2
65;2021-03-24;868;254;29984;14229;13.2;6.3
65;2021-03-25;1252;190;31236;14419;13.8;6.4
65;2021-03-26;1225;148;32461;14567;14.3;6.4
65;2021-03-27;1357;96;33818;14663;14.9;6.5
65;2021-03-28;1;2;33819;14665;14.9;6.5
65;2021-03-29;1490;362;35309;15027;15.6;6.6
65;2021-03-30;1357;407;36666;15434;16.2;6.8
65;2021-03-31;1208;372;37874;15806;16.7;7.0
65;2021-04-01;1509;399;39383;16205;17.4;7.1
65;2021-04-02;1685;289;41068;16494;18.1;7.3
65;2021-04-03;247;45;41315;16539;18.2;7.3
65;2021-04-04;4;2;41319;16541;18.2;7.3
65;2021-04-05;158;44;41477;16585;18.3;7.3
65;2021-04-06;1295;495;42772;17080;18.9;7.5
65;2021-04-07;1958;461;44730;17541;19.7;7.7
65;2021-04-08;1644;421;46374;17962;20.4;7.9
65;2021-04-09;1643;472;48017;18434;21.2;8.1
65;2021-04-10;1592;153;49609;18587;21.9;8.2
65;2021-04-11;3;0;49612;18587;21.9;8.2
65;2021-04-12;1352;737;50964;19324;22.5;8.5
65;2021-04-13;1584;603;52548;19927;23.2;8.8
65;2021-04-14;1905;745;54453;20672;24.0;9.1
65;2021-04-15;1701;678;56154;21350;24.8;9.4
65;2021-04-16;1824;530;57978;21880;25.6;9.6
65;2021-04-17;2156;133;60134;22013;26.5;9.7
65;2021-04-18;7;27;60141;22040;26.5;9.7
65;2021-04-19;1337;776;61478;22816;27.1;10.1
65;2021-04-20;1530;711;63008;23527;27.8;10.4
65;2021-04-21;1052;1049;64060;24576;28.2;10.8
65;2021-04-22;1647;729;65707;25305;29.0;11.2
65;2021-04-23;1160;1149;66867;26454;29.5;11.7
65;2021-04-24;1265;612;68132;27066;30.0;11.9
65;2021-04-25;31;15;68163;27081;30.0;11.9
65;2021-04-26;1611;1299;69774;28380;30.8;12.5
65;2021-04-27;1423;1342;71197;29722;31.4;13.1
65;2021-04-28;1731;1026;72928;30748;32.1;13.6
65;2021-04-29;1959;1038;74887;31786;33.0;14.0
65;2021-04-30;1782;926;76669;32712;33.8;14.4
65;2021-05-01;1574;233;78243;32945;34.5;14.5
65;2021-05-02;671;25;78914;32970;34.8;14.5
65;2021-05-03;1280;1620;80194;34590;35.4;15.2
65;2021-05-04;1537;1245;81731;35835;36.0;15.8
65;2021-05-05;1374;1649;83105;37484;36.6;16.5
65;2021-05-06;1559;1177;84664;38661;37.3;17.0
65;2021-05-07;1275;1571;85939;40232;37.9;17.7
65;2021-05-08;1647;443;87586;40675;38.6;17.9
65;2021-05-09;0;88;87586;40763;38.6;18.0
65;2021-05-10;953;1882;88539;42645;39.0;18.8
65;2021-05-11;1061;1808;89600;44453;39.5;19.6
65;2021-05-12;1236;1637;90836;46090;40.0;20.3
65;2021-05-13;1345;171;92181;46261;40.6;20.4
65;2021-05-14;1575;1094;93756;47355;41.3;20.9
65;2021-05-15;1402;508;95158;47863;41.9;21.1
65;2021-05-16;1444;70;96602;47933;42.6;21.1
65;2021-05-17;1036;1614;97638;49547;43.0;21.8
65;2021-05-18;1612;1207;99250;50754;43.8;22.4
65;2021-05-19;1684;1010;100934;51764;44.5;22.8
65;2021-05-20;1845;1053;102779;52817;45.3;23.3
65;2021-05-21;1790;1230;104569;54047;46.1;23.8
65;2021-05-22;1287;639;105856;54686;46.7;24.1
65;2021-05-23;689;32;106545;54718;47.0;24.1
65;2021-05-24;703;77;107248;54795;47.3;24.2
65;2021-05-25;1359;1547;108607;56342;47.9;24.8
65;2021-05-26;1471;1354;110078;57696;48.5;25.4
65;2021-05-27;1622;1464;111700;59160;49.2;26.1
65;2021-05-28;1599;1674;113299;60834;49.9;26.8
65;2021-05-29;1188;1516;114487;62350;50.5;27.5
65;2021-05-30;7;10;114494;62360;50.5;27.5
65;2021-05-31;1323;1298;115817;63658;51.1;28.1
65;2021-06-01;1832;937;117649;64595;51.9;28.5
65;2021-06-02;1574;950;119223;65545;52.6;28.9
65;2021-06-03;1342;1105;120565;66650;53.2;29.4
65;2021-06-04;1790;1560;122355;68210;53.9;30.1
65;2021-06-05;432;1240;122787;69450;54.1;30.6
65;2021-06-06;3;13;122790;69463;54.1;30.6
65;2021-06-07;675;1984;123465;71447;54.4;31.5
65;2021-06-08;956;1534;124421;72981;54.8;32.2
65;2021-06-09;828;1548;125249;74529;55.2;32.9
65;2021-06-10;739;1155;125988;75684;55.5;33.4
65;2021-06-11;909;1802;126897;77486;55.9;34.2
65;2021-06-12;150;640;127047;78126;56.0;34.4
65;2021-06-13;5;7;127052;78133;56.0;34.4
65;2021-06-14;501;2420;127553;80553;56.2;35.5
65;2021-06-15;942;1802;128495;82355;56.6;36.3
65;2021-06-16;1064;1365;129559;83720;57.1;36.9
65;2021-06-17;814;1046;130373;84766;57.5;37.4
65;2021-06-18;1020;1633;131393;86399;57.9;38.1
65;2021-06-19;690;1690;132083;88089;58.2;38.8
65;2021-06-20;2;2;132085;88091;58.2;38.8
65;2021-06-21;735;1941;132820;90032;58.6;39.7
65;2021-06-22;1045;1479;133865;91511;59.0;40.3
65;2021-06-23;1063;1234;134928;92745;59.5;40.9
65;2021-06-24;977;1143;135905;93888;59.9;41.4
65;2021-06-25;831;1967;136736;95855;60.3;42.3
65;2021-06-26;168;1658;136904;97513;60.4;43.0
65;2021-06-27;15;1100;136919;98613;60.4;43.5
65;2021-06-28;444;2300;137363;100913;60.6;44.5
65;2021-06-29;683;1921;138046;102834;60.9;45.3
65;2021-06-30;934;1678;138980;104512;61.3;46.1
65;2021-07-01;605;749;139585;105261;61.5;46.4
65;2021-07-02;1166;1732;140751;106993;62.0;47.2
65;2021-07-03;197;1915;140948;108908;62.1;48.0
65;2021-07-04;416;186;141364;109094;62.3;48.1
65;2021-07-05;641;1992;142005;111086;62.6;49.0
65;2021-07-06;897;2127;142902;113213;63.0;49.9
65;2021-07-07;978;1517;143880;114730;63.4;50.6
65;2021-07-08;328;664;144208;115394;63.6;50.9
65;2021-07-09;550;1594;144758;116988;63.8;51.6
65;2021-07-10;304;956;145062;117944;63.9;52.0
65;2021-07-11;0;0;145062;117944;63.9;52.0
65;2021-07-12;481;2220;145543;120164;64.2;53.0
65;2021-07-13;700;2148;146243;122312;64.5;53.9
65;2021-07-14;214;52;146457;122364;64.6;53.9
65;2021-07-15;1098;1664;147555;124028;65.0;54.7
65;2021-07-16;1186;1884;148741;125912;65.6;55.5
65;2021-07-17;431;541;149172;126453;65.8;55.7
65;2021-07-18;22;11;149194;126464;65.8;55.8
65;2021-07-19;635;1494;149829;127958;66.1;56.4
65;2021-07-20;1447;1704;151276;129662;66.7;57.2
65;2021-07-21;1420;1663;152696;131325;67.3;57.9
65;2021-07-22;2198;1292;154894;132617;68.3;58.5
65;2021-07-23;1624;1792;156518;134409;69.0;59.3
65;2021-07-24;1041;649;157559;135058;69.5;59.5
65;2021-07-25;24;21;157583;135079;69.5;59.5
65;2021-07-26;1142;1246;158725;136325;70.0;60.1
65;2021-07-27;1793;1954;160518;138279;70.8;61.0
65;2021-07-28;1603;1323;162121;139602;71.5;61.5
65;2021-07-29;2900;1140;165021;140742;72.7;62.0
65;2021-07-30;2449;1399;167470;142141;73.8;62.7
65;2021-07-31;2305;356;169775;142497;74.8;62.8
65;2021-08-01;14;16;169789;142513;74.9;62.8
65;2021-08-02;994;835;170783;143348;75.3;63.2
65;2021-08-03;2103;1071;172886;144419;76.2;63.7
65;2021-08-04;1803;642;174689;145061;77.0;63.9
65;2021-08-05;1822;833;176511;145894;77.8;64.3
65;2021-08-06;1666;977;178177;146871;78.5;64.7
65;2021-08-07;730;487;178907;147358;78.9;65.0
65;2021-08-08;2;9;178909;147367;78.9;65.0
65;2021-08-09;705;944;179614;148311;79.2;65.4
65;2021-08-10;1195;1544;180809;149855;79.7;66.1
65;2021-08-11;732;1266;181541;151121;80.0;66.6
65;2021-08-12;777;1085;182318;152206;80.4;67.1
65;2021-08-13;428;1011;182746;153217;80.6;67.5
65;2021-08-14;602;567;183348;153784;80.8;67.8
65;2021-08-15;9;20;183357;153804;80.8;67.8
65;2021-08-16;405;1538;183762;155342;81.0;68.5
65;2021-08-17;738;2178;184500;157520;81.3;69.4
65;2021-08-18;605;1545;185105;159065;81.6;70.1
65;2021-08-19;731;1319;185836;160384;81.9;70.7
65;2021-08-20;459;1336;186295;161720;82.1;71.3
65;2021-08-21;44;105;186339;161825;82.1;71.3
65;2021-08-22;11;13;186350;161838;82.2;71.3
65;2021-08-23;273;1681;186623;163519;82.3;72.1
65;2021-08-24;551;2446;187174;165965;82.5;73.2
65;2021-08-25;419;1959;187593;167924;82.7;74.0
65;2021-08-26;468;2308;188061;170232;82.9;75.0
65;2021-08-27;447;1949;188508;172181;83.1;75.9
65;2021-08-28;163;195;188671;172376;83.2;76.0
65;2021-08-29;9;18;188680;172394;83.2;76.0
65;2021-08-30;260;1029;188940;173423;83.3;76.5
65;2021-08-31;467;1506;189407;174929;83.5;77.1
65;2021-09-01;459;1077;189866;176006;83.7;77.6
65;2021-09-02;375;883;190241;176889;83.9;78.0
65;2021-09-03;453;1107;190694;177996;84.1;78.5
65;2021-09-04;167;847;190861;178843;84.1;78.8
65;2021-09-05;19;15;190880;178858;84.1;78.8
65;2021-09-06;279;496;191159;179354;84.3;79.1
65;2021-09-07;326;810;191485;180164;84.4;79.4
65;2021-09-08;356;762;191841;180926;84.6;79.8
65;2021-09-09;287;564;192128;181490;84.7;80.0
65;2021-09-10;387;709;192515;182199;84.9;80.3
65;2021-09-11;54;129;192569;182328;84.9;80.4
65;2021-09-12;1;2;192570;182330;84.9;80.4
65;2021-09-13;210;301;192780;182631;85.0;80.5
65;2021-09-14;192;358;192972;182989;85.1;80.7
65;2021-09-15;250;639;193222;183628;85.2;81.0
65;2021-09-16;140;214;193362;183842;85.2;81.0
65;2021-09-17;280;525;193642;184367;85.4;81.3
65;2021-09-18;99;269;193741;184636;85.4;81.4
65;2021-09-19;2;13;193743;184649;85.4;81.4
65;2021-09-20;111;236;193854;184885;85.5;81.5
65;2021-09-21;112;258;193966;185143;85.5;81.6
65;2021-09-22;154;681;194120;185824;85.6;81.9
65;2021-09-23;67;159;194187;185983;85.6;82.0
65;2021-09-24;171;555;194358;186538;85.7;82.2
65;2021-09-25;75;218;194433;186756;85.7;82.3
65;2021-09-26;3;0;194436;186756;85.7;82.3
65;2021-09-27;65;263;194501;187019;85.7;82.4
65;2021-09-28;85;281;194586;187300;85.8;82.6
65;2021-09-29;132;420;194718;187720;85.8;82.8
65;2021-09-30;44;124;194762;187844;85.9;82.8
65;2021-10-01;166;399;194928;188243;85.9;83.0
65;2021-10-02;19;66;194947;188309;85.9;83.0
65;2021-10-03;0;7;194947;188316;85.9;83.0
65;2021-10-04;120;269;195067;188585;86.0;83.1
65;2021-10-05;63;179;195130;188764;86.0;83.2
65;2021-10-06;175;346;195305;189110;86.1;83.4
65;2021-10-07;73;177;195378;189287;86.1;83.4
65;2021-10-08;179;407;195557;189694;86.2;83.6
65;2021-10-09;17;23;195574;189717;86.2;83.6
65;2021-10-10;0;6;195574;189723;86.2;83.6
65;2021-10-11;102;205;195676;189928;86.3;83.7
65;2021-10-12;37;107;195713;190035;86.3;83.8
65;2021-10-13;143;233;195856;190268;86.3;83.9
65;2021-10-14;33;89;195889;190357;86.4;83.9
65;2021-10-15;186;245;196075;190602;86.4;84.0
65;2021-10-16;14;21;196089;190623;86.4;84.0
65;2021-10-17;0;2;196089;190625;86.4;84.0
65;2021-10-18;105;127;196194;190752;86.5;84.1
65;2021-10-19;42;52;196236;190804;86.5;84.1
66;2020-12-27;0;0;0;0;0.0;0.0
66;2020-12-28;3;0;3;0;0.0;0.0
66;2020-12-29;0;0;3;0;0.0;0.0
66;2020-12-30;0;0;3;0;0.0;0.0
66;2020-12-31;1;0;4;0;0.0;0.0
66;2021-01-01;3;0;7;0;0.0;0.0
66;2021-01-02;0;0;7;0;0.0;0.0
66;2021-01-03;0;0;7;0;0.0;0.0
66;2021-01-04;30;0;37;0;0.0;0.0
66;2021-01-05;135;0;172;0;0.0;0.0
66;2021-01-06;194;0;366;0;0.1;0.0
66;2021-01-07;182;0;548;0;0.1;0.0
66;2021-01-08;212;0;760;0;0.2;0.0
66;2021-01-09;233;0;993;0;0.2;0.0
66;2021-01-10;11;0;1004;0;0.2;0.0
66;2021-01-11;404;2;1408;2;0.3;0.0
66;2021-01-12;588;2;1996;4;0.4;0.0
66;2021-01-13;877;9;2873;13;0.6;0.0
66;2021-01-14;892;12;3765;25;0.8;0.0
66;2021-01-15;588;2;4353;27;0.9;0.0
66;2021-01-16;106;3;4459;30;0.9;0.0
66;2021-01-17;46;1;4505;31;0.9;0.0
66;2021-01-18;654;3;5159;34;1.1;0.0
66;2021-01-19;720;3;5879;37;1.2;0.0
66;2021-01-20;1171;5;7050;42;1.5;0.0
66;2021-01-21;2400;7;9450;49;2.0;0.0
66;2021-01-22;1437;10;10887;59;2.3;0.0
66;2021-01-23;399;4;11286;63;2.4;0.0
66;2021-01-24;225;9;11511;72;2.4;0.0
66;2021-01-25;739;40;12250;112;2.6;0.0
66;2021-01-26;787;66;13037;178;2.7;0.0
66;2021-01-27;867;104;13904;282;2.9;0.1
66;2021-01-28;878;130;14782;412;3.1;0.1
66;2021-01-29;820;129;15602;541;3.3;0.1
66;2021-01-30;481;68;16083;609;3.4;0.1
66;2021-01-31;202;27;16285;636;3.4;0.1
66;2021-02-01;562;188;16847;824;3.5;0.2
66;2021-02-02;622;289;17469;1113;3.6;0.2
66;2021-02-03;734;628;18203;1741;3.8;0.4
66;2021-02-04;688;620;18891;2361;3.9;0.5
66;2021-02-05;778;414;19669;2775;4.1;0.6
66;2021-02-06;420;147;20089;2922;4.2;0.6
66;2021-02-07;170;140;20259;3062;4.2;0.6
66;2021-02-08;502;391;20761;3453;4.3;0.7
66;2021-02-09;533;400;21294;3853;4.4;0.8
66;2021-02-10;621;769;21915;4622;4.6;1.0
66;2021-02-11;1104;1569;23019;6191;4.8;1.3
66;2021-02-12;1121;1201;24140;7392;5.0;1.5
66;2021-02-13;367;302;24507;7694;5.1;1.6
66;2021-02-14;111;196;24618;7890;5.1;1.6
66;2021-02-15;425;694;25043;8584;5.2;1.8
66;2021-02-16;304;785;25347;9369;5.3;2.0
66;2021-02-17;377;697;25724;10066;5.4;2.1
66;2021-02-18;366;769;26090;10835;5.4;2.3
66;2021-02-19;400;703;26490;11538;5.5;2.4
66;2021-02-20;184;408;26674;11946;5.6;2.5
66;2021-02-21;41;169;26715;12115;5.6;2.5
66;2021-02-22;415;639;27130;12754;5.7;2.7
66;2021-02-23;509;664;27639;13418;5.8;2.8
66;2021-02-24;347;754;27986;14172;5.8;3.0
66;2021-02-25;717;712;28703;14884;6.0;3.1
66;2021-02-26;954;746;29657;15630;6.2;3.3
66;2021-02-27;363;428;30020;16058;6.3;3.4
66;2021-02-28;59;172;30079;16230;6.3;3.4
66;2021-03-01;378;650;30457;16880;6.4;3.5
66;2021-03-02;336;658;30793;17538;6.4;3.7
66;2021-03-03;530;645;31323;18183;6.5;3.8
66;2021-03-04;991;1060;32314;19243;6.7;4.0
66;2021-03-05;1528;799;33842;20042;7.1;4.2
66;2021-03-06;1147;347;34989;20389;7.3;4.3
66;2021-03-07;1098;100;36087;20489;7.5;4.3
66;2021-03-08;696;545;36783;21034;7.7;4.4
66;2021-03-09;1228;597;38011;21631;7.9;4.5
66;2021-03-10;1303;505;39314;22136;8.2;4.6
66;2021-03-11;1474;592;40788;22728;8.5;4.7
66;2021-03-12;2396;579;43184;23307;9.0;4.9
66;2021-03-13;1081;308;44265;23615;9.2;4.9
66;2021-03-14;192;84;44457;23699;9.3;4.9
66;2021-03-15;1110;396;45567;24095;9.5;5.0
66;2021-03-16;953;259;46520;24354;9.7;5.1
66;2021-03-17;866;399;47386;24753;9.9;5.2
66;2021-03-18;970;346;48356;25099;10.1;5.2
66;2021-03-19;1293;322;49649;25421;10.4;5.3
66;2021-03-20;837;125;50486;25546;10.5;5.3
66;2021-03-21;186;45;50672;25591;10.6;5.3
66;2021-03-22;1115;398;51787;25989;10.8;5.4
66;2021-03-23;1757;389;53544;26378;11.2;5.5
66;2021-03-24;1797;521;55341;26899;11.6;5.6
66;2021-03-25;2537;475;57878;27374;12.1;5.7
66;2021-03-26;2577;369;60455;27743;12.6;5.8
66;2021-03-27;1211;303;61666;28046;12.9;5.9
66;2021-03-28;321;3;61987;28049;12.9;5.9
66;2021-03-29;1832;262;63819;28311;13.3;5.9
66;2021-03-30;2241;177;66060;28488;13.8;5.9
66;2021-03-31;1987;251;68047;28739;14.2;6.0
66;2021-04-01;2673;305;70720;29044;14.8;6.1
66;2021-04-02;2421;261;73141;29305;15.3;6.1
66;2021-04-03;1148;335;74289;29640;15.5;6.2
66;2021-04-04;107;125;74396;29765;15.5;6.2
66;2021-04-05;197;144;74593;29909;15.6;6.2
66;2021-04-06;1334;650;75927;30559;15.9;6.4
66;2021-04-07;1399;598;77326;31157;16.1;6.5
66;2021-04-08;2070;551;79396;31708;16.6;6.6
66;2021-04-09;3507;691;82903;32399;17.3;6.8
66;2021-04-10;2308;527;85211;32926;17.8;6.9
66;2021-04-11;1202;172;86413;33098;18.0;6.9
66;2021-04-12;2703;1026;89116;34124;18.6;7.1
66;2021-04-13;3610;1065;92726;35189;19.4;7.3
66;2021-04-14;3292;926;96018;36115;20.0;7.5
66;2021-04-15;3557;1054;99575;37169;20.8;7.8
66;2021-04-16;3592;1038;103167;38207;21.5;8.0
66;2021-04-17;2264;593;105431;38800;22.0;8.1
66;2021-04-18;1445;132;106876;38932;22.3;8.1
66;2021-04-19;2257;1125;109133;40057;22.8;8.4
66;2021-04-20;2373;1079;111506;41136;23.3;8.6
66;2021-04-21;2871;1181;114377;42317;23.9;8.8
66;2021-04-22;2662;1236;117039;43553;24.4;9.1
66;2021-04-23;2379;1236;119418;44789;24.9;9.4
66;2021-04-24;2743;882;122161;45671;25.5;9.5
66;2021-04-25;1206;267;123367;45938;25.8;9.6
66;2021-04-26;1998;1254;125365;47192;26.2;9.9
66;2021-04-27;2748;1311;128113;48503;26.7;10.1
66;2021-04-28;2424;1662;130537;50165;27.3;10.5
66;2021-04-29;2705;2133;133242;52298;27.8;10.9
66;2021-04-30;3053;1559;136295;53857;28.5;11.2
66;2021-05-01;2000;470;138295;54327;28.9;11.3
66;2021-05-02;1529;264;139824;54591;29.2;11.4
66;2021-05-03;2940;1112;142764;55703;29.8;11.6
66;2021-05-04;3169;1343;145933;57046;30.5;11.9
66;2021-05-05;3055;1550;148988;58596;31.1;12.2
66;2021-05-06;3755;2092;152743;60688;31.9;12.7
66;2021-05-07;2967;3080;155710;63768;32.5;13.3
66;2021-05-08;1730;1170;157440;64938;32.9;13.6
66;2021-05-09;886;1369;158326;66307;33.1;13.8
66;2021-05-10;1802;2970;160128;69277;33.4;14.5
66;2021-05-11;2741;3129;162869;72406;34.0;15.1
66;2021-05-12;2432;2569;165301;74975;34.5;15.7
66;2021-05-13;2259;1386;167560;76361;35.0;15.9
66;2021-05-14;2770;2119;170330;78480;35.6;16.4
66;2021-05-15;2326;1576;172656;80056;36.0;16.7
66;2021-05-16;2286;1246;174942;81302;36.5;17.0
66;2021-05-17;2050;1825;176992;83127;37.0;17.4
66;2021-05-18;3237;1808;180229;84935;37.6;17.7
66;2021-05-19;2876;1340;183105;86275;38.2;18.0
66;2021-05-20;4371;1445;187476;87720;39.1;18.3
66;2021-05-21;3268;1463;190744;89183;39.8;18.6
66;2021-05-22;3066;779;193810;89962;40.5;18.8
66;2021-05-23;1509;236;195319;90198;40.8;18.8
66;2021-05-24;1953;427;197272;90625;41.2;18.9
66;2021-05-25;2795;1689;200067;92314;41.8;19.3
66;2021-05-26;2778;1493;202845;93807;42.3;19.6
66;2021-05-27;3384;2248;206229;96055;43.1;20.1
66;2021-05-28;2683;3049;208912;99104;43.6;20.7
66;2021-05-29;2145;1520;211057;100624;44.1;21.0
66;2021-05-30;786;988;211843;101612;44.2;21.2
66;2021-05-31;2124;1774;213967;103386;44.7;21.6
66;2021-06-01;2636;2005;216603;105391;45.2;22.0
66;2021-06-02;2806;2339;219409;107730;45.8;22.5
66;2021-06-03;2488;2967;221897;110697;46.3;23.1
66;2021-06-04;1959;3356;223856;114053;46.7;23.8
66;2021-06-05;1408;2601;225264;116654;47.0;24.4
66;2021-06-06;294;1228;225558;117882;47.1;24.6
66;2021-06-07;1335;2957;226893;120839;47.4;25.2
66;2021-06-08;1736;3020;228629;123859;47.7;25.9
66;2021-06-09;2064;2787;230693;126646;48.2;26.4
66;2021-06-10;2086;2965;232779;129611;48.6;27.1
66;2021-06-11;2098;3859;234877;133470;49.0;27.9
66;2021-06-12;871;2411;235748;135881;49.2;28.4
66;2021-06-13;516;1333;236264;137214;49.3;28.6
66;2021-06-14;1360;3497;237624;140711;49.6;29.4
66;2021-06-15;2131;3573;239755;144284;50.1;30.1
66;2021-06-16;1792;3570;241547;147854;50.4;30.9
66;2021-06-17;2441;3609;243988;151463;50.9;31.6
66;2021-06-18;2225;3824;246213;155287;51.4;32.4
66;2021-06-19;1542;2320;247755;157607;51.7;32.9
66;2021-06-20;998;1267;248753;158874;51.9;33.2
66;2021-06-21;1163;2879;249916;161753;52.2;33.8
66;2021-06-22;1510;3762;251426;165515;52.5;34.6
66;2021-06-23;1325;3027;252751;168542;52.8;35.2
66;2021-06-24;1527;3227;254278;171769;53.1;35.9
66;2021-06-25;1404;3536;255682;175305;53.4;36.6
66;2021-06-26;962;2680;256644;177985;53.6;37.2
66;2021-06-27;677;1557;257321;179542;53.7;37.5
66;2021-06-28;979;2977;258300;182519;53.9;38.1
66;2021-06-29;1147;3797;259447;186316;54.2;38.9
66;2021-06-30;1279;3307;260726;189623;54.4;39.6
66;2021-07-01;1453;4047;262179;193670;54.7;40.4
66;2021-07-02;1349;3603;263528;197273;55.0;41.2
66;2021-07-03;1152;3899;264680;201172;55.3;42.0
66;2021-07-04;715;1790;265395;202962;55.4;42.4
66;2021-07-05;1293;3005;266688;205967;55.7;43.0
66;2021-07-06;1460;3785;268148;209752;56.0;43.8
66;2021-07-07;1430;3248;269578;213000;56.3;44.5
66;2021-07-08;1386;3384;270964;216384;56.6;45.2
66;2021-07-09;1450;3465;272414;219849;56.9;45.9
66;2021-07-10;1005;2403;273419;222252;57.1;46.4
66;2021-07-11;540;1540;273959;223792;57.2;46.7
66;2021-07-12;1021;3645;274980;227437;57.4;47.5
66;2021-07-13;2223;4263;277203;231700;57.9;48.4
66;2021-07-14;1953;1243;279156;232943;58.3;48.6
66;2021-07-15;2801;3111;281957;236054;58.9;49.3
66;2021-07-16;3374;3214;285331;239268;59.6;50.0
66;2021-07-17;2123;2033;287454;241301;60.0;50.4
66;2021-07-18;1197;1063;288651;242364;60.3;50.6
66;2021-07-19;2794;3084;291445;245448;60.8;51.2
66;2021-07-20;3655;2887;295100;248335;61.6;51.8
66;2021-07-21;3962;2955;299062;251290;62.4;52.5
66;2021-07-22;3917;2821;302979;254111;63.3;53.1
66;2021-07-23;3914;3033;306893;257144;64.1;53.7
66;2021-07-24;2584;1923;309477;259067;64.6;54.1
66;2021-07-25;2020;1242;311497;260309;65.0;54.3
66;2021-07-26;2866;2629;314363;262938;65.6;54.9
66;2021-07-27;3231;2889;317594;265827;66.3;55.5
66;2021-07-28;3355;2583;320949;268410;67.0;56.0
66;2021-07-29;3864;2536;324813;270946;67.8;56.6
66;2021-07-30;4233;2476;329046;273422;68.7;57.1
66;2021-07-31;2231;1716;331277;275138;69.2;57.4
66;2021-08-01;1821;900;333098;276038;69.5;57.6
66;2021-08-02;2392;1920;335490;277958;70.0;58.0
66;2021-08-03;2624;2076;338114;280034;70.6;58.5
66;2021-08-04;2646;1996;340760;282030;71.1;58.9
66;2021-08-05;2445;2439;343205;284469;71.7;59.4
66;2021-08-06;2339;2648;345544;287117;72.1;59.9
66;2021-08-07;1506;2099;347050;289216;72.5;60.4
66;2021-08-08;613;1458;347663;290674;72.6;60.7
66;2021-08-09;1355;2800;349018;293474;72.9;61.3
66;2021-08-10;1649;3075;350667;296549;73.2;61.9
66;2021-08-11;1631;3023;352298;299572;73.5;62.5
66;2021-08-12;1681;2991;353979;302563;73.9;63.2
66;2021-08-13;1474;2984;355453;305547;74.2;63.8
66;2021-08-14;658;2508;356111;308055;74.3;64.3
66;2021-08-15;137;1629;356248;309684;74.4;64.7
66;2021-08-16;1281;2595;357529;312279;74.6;65.2
66;2021-08-17;1496;2980;359025;315259;75.0;65.8
66;2021-08-18;1349;3073;360374;318332;75.2;66.5
66;2021-08-19;1113;2926;361487;321258;75.5;67.1
66;2021-08-20;1020;3324;362507;324582;75.7;67.8
66;2021-08-21;594;2014;363101;326596;75.8;68.2
66;2021-08-22;233;1352;363334;327948;75.9;68.5
66;2021-08-23;1158;2764;364492;330712;76.1;69.0
66;2021-08-24;1064;2952;365556;333664;76.3;69.7
66;2021-08-25;904;2302;366460;335966;76.5;70.1
66;2021-08-26;960;2186;367420;338152;76.7;70.6
66;2021-08-27;917;2367;368337;340519;76.9;71.1
66;2021-08-28;514;1137;368851;341656;77.0;71.3
66;2021-08-29;245;333;369096;341989;77.1;71.4
66;2021-08-30;839;2543;369935;344532;77.2;71.9
66;2021-08-31;835;2657;370770;347189;77.4;72.5
66;2021-09-01;757;1925;371527;349114;77.6;72.9
66;2021-09-02;672;1520;372199;350634;77.7;73.2
66;2021-09-03;716;1747;372915;352381;77.9;73.6
66;2021-09-04;712;1602;373627;353983;78.0;73.9
66;2021-09-05;205;261;373832;354244;78.0;74.0
66;2021-09-06;446;1338;374278;355582;78.1;74.2
66;2021-09-07;383;1177;374661;356759;78.2;74.5
66;2021-09-08;562;1309;375223;358068;78.3;74.8
66;2021-09-09;475;1107;375698;359175;78.4;75.0
66;2021-09-10;497;1159;376195;360334;78.5;75.2
66;2021-09-11;517;1171;376712;361505;78.6;75.5
66;2021-09-12;94;135;376806;361640;78.7;75.5
66;2021-09-13;353;1029;377159;362669;78.7;75.7
66;2021-09-14;389;904;377548;363573;78.8;75.9
66;2021-09-15;483;959;378031;364532;78.9;76.1
66;2021-09-16;393;795;378424;365327;79.0;76.3
66;2021-09-17;341;771;378765;366098;79.1;76.4
66;2021-09-18;360;1099;379125;367197;79.1;76.7
66;2021-09-19;77;241;379202;367438;79.2;76.7
66;2021-09-20;351;672;379553;368110;79.2;76.8
66;2021-09-21;312;585;379865;368695;79.3;77.0
66;2021-09-22;318;793;380183;369488;79.4;77.1
66;2021-09-23;239;508;380422;369996;79.4;77.2
66;2021-09-24;360;772;380782;370768;79.5;77.4
66;2021-09-25;215;878;380997;371646;79.5;77.6
66;2021-09-26;63;213;381060;371859;79.6;77.6
66;2021-09-27;184;500;381244;372359;79.6;77.7
66;2021-09-28;246;545;381490;372904;79.6;77.9
66;2021-09-29;232;576;381722;373480;79.7;78.0
66;2021-09-30;336;454;382058;373934;79.8;78.1
66;2021-10-01;293;519;382351;374453;79.8;78.2
66;2021-10-02;278;621;382629;375074;79.9;78.3
66;2021-10-03;81;125;382710;375199;79.9;78.3
66;2021-10-04;224;376;382934;375575;79.9;78.4
66;2021-10-05;241;444;383175;376019;80.0;78.5
66;2021-10-06;193;379;383368;376398;80.0;78.6
66;2021-10-07;235;459;383603;376857;80.1;78.7
66;2021-10-08;279;554;383882;377411;80.1;78.8
66;2021-10-09;312;537;384194;377948;80.2;78.9
66;2021-10-10;4;12;384198;377960;80.2;78.9
66;2021-10-11;200;397;384398;378357;80.3;79.0
66;2021-10-12;229;344;384627;378701;80.3;79.1
66;2021-10-13;235;421;384862;379122;80.3;79.1
66;2021-10-14;192;302;385054;379424;80.4;79.2
66;2021-10-15;330;413;385384;379837;80.5;79.3
66;2021-10-16;236;323;385620;380160;80.5;79.4
66;2021-10-17;1;10;385621;380170;80.5;79.4
66;2021-10-18;209;313;385830;380483;80.5;79.4
66;2021-10-19;229;303;386059;380786;80.6;79.5
67;2020-12-27;18;1;18;1;0.0;0.0
67;2020-12-28;4;0;22;1;0.0;0.0
67;2020-12-29;2;0;24;1;0.0;0.0
67;2020-12-30;0;0;24;1;0.0;0.0
67;2020-12-31;1;0;25;1;0.0;0.0
67;2021-01-01;6;1;31;2;0.0;0.0
67;2021-01-02;1;0;32;2;0.0;0.0
67;2021-01-03;1;0;33;2;0.0;0.0
67;2021-01-04;43;0;76;2;0.0;0.0
67;2021-01-05;168;7;244;9;0.0;0.0
67;2021-01-06;121;0;365;9;0.0;0.0
67;2021-01-07;235;1;600;10;0.1;0.0
67;2021-01-08;235;1;835;11;0.1;0.0
67;2021-01-09;113;1;948;12;0.1;0.0
67;2021-01-10;67;0;1015;12;0.1;0.0
67;2021-01-11;184;1;1199;13;0.1;0.0
67;2021-01-12;511;2;1710;15;0.2;0.0
67;2021-01-13;660;4;2370;19;0.2;0.0
67;2021-01-14;1096;14;3466;33;0.3;0.0
67;2021-01-15;943;8;4409;41;0.4;0.0
67;2021-01-16;200;4;4609;45;0.4;0.0
67;2021-01-17;101;2;4710;47;0.4;0.0
67;2021-01-18;904;4;5614;51;0.5;0.0
67;2021-01-19;1423;5;7037;56;0.6;0.0
67;2021-01-20;1855;14;8892;70;0.8;0.0
67;2021-01-21;2220;12;11112;82;1.0;0.0
67;2021-01-22;1995;11;13107;93;1.2;0.0
67;2021-01-23;814;6;13921;99;1.2;0.0
67;2021-01-24;380;1;14301;100;1.3;0.0
67;2021-01-25;526;31;14827;131;1.3;0.0
67;2021-01-26;164;110;14991;241;1.3;0.0
67;2021-01-27;1404;141;16395;382;1.4;0.0
67;2021-01-28;3059;233;19454;615;1.7;0.1
67;2021-01-29;2034;168;21488;783;1.9;0.1
67;2021-01-30;1098;82;22586;865;2.0;0.1
67;2021-01-31;1163;32;23749;897;2.1;0.1
67;2021-02-01;3400;253;27149;1150;2.4;0.1
67;2021-02-02;2695;430;29844;1580;2.6;0.1
67;2021-02-03;1578;401;31422;1981;2.8;0.2
67;2021-02-04;1198;755;32620;2736;2.9;0.2
67;2021-02-05;1195;638;33815;3374;3.0;0.3
67;2021-02-06;800;151;34615;3525;3.1;0.3
67;2021-02-07;292;44;34907;3569;3.1;0.3
67;2021-02-08;841;448;35748;4017;3.2;0.4
67;2021-02-09;962;730;36710;4747;3.2;0.4
67;2021-02-10;934;795;37644;5542;3.3;0.5
67;2021-02-11;1152;1131;38796;6673;3.4;0.6
67;2021-02-12;1245;780;40041;7453;3.5;0.7
67;2021-02-13;767;280;40808;7733;3.6;0.7
67;2021-02-14;244;94;41052;7827;3.6;0.7
67;2021-02-15;782;840;41834;8667;3.7;0.8
67;2021-02-16;933;1140;42767;9807;3.8;0.9
67;2021-02-17;786;1186;43553;10993;3.8;1.0
67;2021-02-18;1402;2568;44955;13561;4.0;1.2
67;2021-02-19;1376;2103;46331;15664;4.1;1.4
67;2021-02-20;634;898;46965;16562;4.1;1.5
67;2021-02-21;210;1195;47175;17757;4.2;1.6
67;2021-02-22;1401;2171;48576;19928;4.3;1.8
67;2021-02-23;1461;1562;50037;21490;4.4;1.9
67;2021-02-24;1439;1055;51476;22545;4.5;2.0
67;2021-02-25;1620;1474;53096;24019;4.7;2.1
67;2021-02-26;2227;1412;55323;25431;4.9;2.2
67;2021-02-27;1260;784;56583;26215;5.0;2.3
67;2021-02-28;148;365;56731;26580;5.0;2.3
67;2021-03-01;641;997;57372;27577;5.1;2.4
67;2021-03-02;898;1202;58270;28779;5.1;2.5
67;2021-03-03;1413;1279;59683;30058;5.3;2.7
67;2021-03-04;1963;1064;61646;31122;5.4;2.7
67;2021-03-05;3259;1111;64905;32233;5.7;2.8
67;2021-03-06;2338;775;67243;33008;5.9;2.9
67;2021-03-07;468;283;67711;33291;6.0;2.9
67;2021-03-08;1189;791;68900;34082;6.1;3.0
67;2021-03-09;2227;905;71127;34987;6.3;3.1
67;2021-03-10;2456;1193;73583;36180;6.5;3.2
67;2021-03-11;3208;1369;76791;37549;6.8;3.3
67;2021-03-12;5265;1392;82056;38941;7.2;3.4
67;2021-03-13;3998;902;86054;39843;7.6;3.5
67;2021-03-14;483;390;86537;40233;7.6;3.6
67;2021-03-15;2193;1162;88730;41395;7.8;3.7
67;2021-03-16;1553;1239;90283;42634;8.0;3.8
67;2021-03-17;2072;925;92355;43559;8.2;3.8
67;2021-03-18;2392;740;94747;44299;8.4;3.9
67;2021-03-19;3673;757;98420;45056;8.7;4.0
67;2021-03-20;3065;513;101485;45569;9.0;4.0
67;2021-03-21;338;17;101823;45586;9.0;4.0
67;2021-03-22;2332;781;104155;46367;9.2;4.1
67;2021-03-23;3404;779;107559;47146;9.5;4.2
67;2021-03-24;3912;813;111471;47959;9.8;4.2
67;2021-03-25;5320;543;116791;48502;10.3;4.3
67;2021-03-26;6871;484;123662;48986;10.9;4.3
67;2021-03-27;3927;348;127589;49334;11.3;4.4
67;2021-03-28;580;101;128169;49435;11.3;4.4
67;2021-03-29;3823;431;131992;49866;11.7;4.4
67;2021-03-30;4848;677;136840;50543;12.1;4.5
67;2021-03-31;4849;711;141689;51254;12.5;4.5
67;2021-04-01;5149;933;146838;52187;13.0;4.6
67;2021-04-02;1010;177;147848;52364;13.1;4.6
67;2021-04-03;1689;286;149537;52650;13.2;4.6
67;2021-04-04;328;6;149865;52656;13.2;4.6
67;2021-04-05;371;5;150236;52661;13.3;4.6
67;2021-04-06;3484;1189;153720;53850;13.6;4.8
67;2021-04-07;4535;1287;158255;55137;14.0;4.9
67;2021-04-08;5664;1414;163919;56551;14.5;5.0
67;2021-04-09;7111;1362;171030;57913;15.1;5.1
67;2021-04-10;4334;902;175364;58815;15.5;5.2
67;2021-04-11;857;428;176221;59243;15.6;5.2
67;2021-04-12;3887;1413;180108;60656;15.9;5.4
67;2021-04-13;4895;1583;185003;62239;16.3;5.5
67;2021-04-14;5298;1916;190301;64155;16.8;5.7
67;2021-04-15;6085;2112;196386;66267;17.3;5.9
67;2021-04-16;7836;2437;204222;68704;18.0;6.1
67;2021-04-17;4010;1583;208232;70287;18.4;6.2
67;2021-04-18;1111;646;209343;70933;18.5;6.3
67;2021-04-19;3630;2147;212973;73080;18.8;6.5
67;2021-04-20;4258;1930;217231;75010;19.2;6.6
67;2021-04-21;4071;2516;221302;77526;19.5;6.8
67;2021-04-22;4478;2926;225780;80452;19.9;7.1
67;2021-04-23;5257;3014;231037;83466;20.4;7.4
67;2021-04-24;3101;2023;234138;85489;20.7;7.5
67;2021-04-25;1027;452;235165;85941;20.8;7.6
67;2021-04-26;3191;2619;238356;88560;21.0;7.8
67;2021-04-27;4023;2928;242379;91488;21.4;8.1
67;2021-04-28;4255;3436;246634;94924;21.8;8.4
67;2021-04-29;5125;3518;251759;98442;22.2;8.7
67;2021-04-30;7184;2496;258943;100938;22.9;8.9
67;2021-05-01;2685;793;261628;101731;23.1;9.0
67;2021-05-02;2181;682;263809;102413;23.3;9.0
67;2021-05-03;5561;2619;269370;105032;23.8;9.3
67;2021-05-04;5853;3615;275223;108647;24.3;9.6
67;2021-05-05;5221;4207;280444;112854;24.8;10.0
67;2021-05-06;6714;4928;287158;117782;25.4;10.4
67;2021-05-07;6436;6932;293594;124714;25.9;11.0
67;2021-05-08;3575;1023;297169;125737;26.2;11.1
67;2021-05-09;3366;594;300535;126331;26.5;11.2
67;2021-05-10;4698;4532;305233;130863;26.9;11.6
67;2021-05-11;5649;4933;310882;135796;27.4;12.0
67;2021-05-12;6598;4845;317480;140641;28.0;12.4
67;2021-05-13;7310;1674;324790;142315;28.7;12.6
67;2021-05-14;8884;5358;333674;147673;29.5;13.0
67;2021-05-15;8198;3657;341872;151330;30.2;13.4
67;2021-05-16;6176;969;348048;152299;30.7;13.4
67;2021-05-17;5689;3885;353737;156184;31.2;13.8
67;2021-05-18;6896;3976;360633;160160;31.8;14.1
67;2021-05-19;7376;4166;368009;164326;32.5;14.5
67;2021-05-20;8681;4233;376690;168559;33.3;14.9
67;2021-05-21;8156;5859;384846;174418;34.0;15.4
67;2021-05-22;5933;3420;390779;177838;34.5;15.7
67;2021-05-23;2656;593;393435;178431;34.7;15.8
67;2021-05-24;4415;865;397850;179296;35.1;15.8
67;2021-05-25;5412;4768;403262;184064;35.6;16.3
67;2021-05-26;6063;4876;409325;188940;36.1;16.7
67;2021-05-27;7313;4900;416638;193840;36.8;17.1
67;2021-05-28;7965;6503;424603;200343;37.5;17.7
67;2021-05-29;6646;3871;431249;204214;38.1;18.0
67;2021-05-30;1147;809;432396;205023;38.2;18.1
67;2021-05-31;6405;4058;438801;209081;38.7;18.5
67;2021-06-01;7328;4407;446129;213488;39.4;18.8
67;2021-06-02;8067;4183;454196;217671;40.1;19.2
67;2021-06-03;8841;4866;463037;222537;40.9;19.6
67;2021-06-04;8594;6139;471631;228676;41.6;20.2
67;2021-06-05;6548;3983;478179;232659;42.2;20.5
67;2021-06-06;3468;875;481647;233534;42.5;20.6
67;2021-06-07;7407;4259;489054;237793;43.2;21.0
67;2021-06-08;8616;4931;497670;242724;43.9;21.4
67;2021-06-09;9258;4794;506928;247518;44.8;21.9
67;2021-06-10;9770;5021;516698;252539;45.6;22.3
67;2021-06-11;8065;8325;524763;260864;46.3;23.0
67;2021-06-12;6790;5204;531553;266068;46.9;23.5
67;2021-06-13;3105;1044;534658;267112;47.2;23.6
67;2021-06-14;5504;6460;540162;273572;47.7;24.2
67;2021-06-15;6688;6753;546850;280325;48.3;24.8
67;2021-06-16;6951;6698;553801;287023;48.9;25.3
67;2021-06-17;7275;9045;561076;296068;49.5;26.1
67;2021-06-18;7600;8506;568676;304574;50.2;26.9
67;2021-06-19;6386;5959;575062;310533;50.8;27.4
67;2021-06-20;1446;1411;576508;311944;50.9;27.5
67;2021-06-21;4265;6775;580773;318719;51.3;28.1
67;2021-06-22;4241;9093;585014;327812;51.7;28.9
67;2021-06-23;5292;8184;590306;335996;52.1;29.7
67;2021-06-24;4521;9101;594827;345097;52.5;30.5
67;2021-06-25;5335;9952;600162;355049;53.0;31.3
67;2021-06-26;3463;9104;603625;364153;53.3;32.2
67;2021-06-27;1023;3523;604648;367676;53.4;32.5
67;2021-06-28;2845;8722;607493;376398;53.6;33.2
67;2021-06-29;2898;8612;610391;385010;53.9;34.0
67;2021-06-30;3382;8742;613773;393752;54.2;34.8
67;2021-07-01;3668;8429;617441;402181;54.5;35.5
67;2021-07-02;3736;10937;621177;413118;54.8;36.5
67;2021-07-03;2981;7743;624158;420861;55.1;37.2
67;2021-07-04;764;1869;624922;422730;55.2;37.3
67;2021-07-05;2626;8250;627548;430980;55.4;38.1
67;2021-07-06;3110;8441;630658;439421;55.7;38.8
67;2021-07-07;3926;8742;634584;448163;56.0;39.6
67;2021-07-08;4204;7785;638788;455948;56.4;40.3
67;2021-07-09;3767;11369;642555;467317;56.7;41.3
67;2021-07-10;2860;8205;645415;475522;57.0;42.0
67;2021-07-11;945;1995;646360;477517;57.1;42.2
67;2021-07-12;2481;9725;648841;487242;57.3;43.0
67;2021-07-13;4122;9890;652963;497132;57.7;43.9
67;2021-07-14;3493;4407;656456;501539;58.0;44.3
67;2021-07-15;5143;12230;661599;513769;58.4;45.4
67;2021-07-16;4867;12293;666466;526062;58.8;46.4
67;2021-07-17;3734;8825;670200;534887;59.2;47.2
67;2021-07-18;1466;2551;671666;537438;59.3;47.5
67;2021-07-19;4649;9745;676315;547183;59.7;48.3
67;2021-07-20;5774;9825;682089;557008;60.2;49.2
67;2021-07-21;5869;10649;687958;567657;60.7;50.1
67;2021-07-22;6439;10228;694397;577885;61.3;51.0
67;2021-07-23;7395;11192;701792;589077;62.0;52.0
67;2021-07-24;5422;7581;707214;596658;62.4;52.7
67;2021-07-25;2318;1972;709532;598630;62.6;52.9
67;2021-07-26;5002;7251;714534;605881;63.1;53.5
67;2021-07-27;6623;7331;721157;613212;63.7;54.1
67;2021-07-28;7542;7210;728699;620422;64.3;54.8
67;2021-07-29;8394;6437;737093;626859;65.1;55.3
67;2021-07-30;8670;7312;745763;634171;65.8;56.0
67;2021-07-31;5113;4878;750876;639049;66.3;56.4
67;2021-08-01;2486;1435;753362;640484;66.5;56.5
67;2021-08-02;6423;5096;759785;645580;67.1;57.0
67;2021-08-03;7322;4720;767107;650300;67.7;57.4
67;2021-08-04;6909;4604;774016;654904;68.3;57.8
67;2021-08-05;5753;4232;779769;659136;68.8;58.2
67;2021-08-06;6335;5427;786104;664563;69.4;58.7
67;2021-08-07;4694;4280;790798;668843;69.8;59.1
67;2021-08-08;1311;1440;792109;670283;69.9;59.2
67;2021-08-09;3146;4481;795255;674764;70.2;59.6
67;2021-08-10;3254;4782;798509;679546;70.5;60.0
67;2021-08-11;3435;4677;801944;684223;70.8;60.4
67;2021-08-12;3153;4887;805097;689110;71.1;60.8
67;2021-08-13;3213;5386;808310;694496;71.4;61.3
67;2021-08-14;2198;5086;810508;699582;71.6;61.8
67;2021-08-15;715;1607;811223;701189;71.6;61.9
67;2021-08-16;2097;5242;813320;706431;71.8;62.4
67;2021-08-17;2111;5278;815431;711709;72.0;62.8
67;2021-08-18;2394;6345;817825;718054;72.2;63.4
67;2021-08-19;1927;6153;819752;724207;72.4;63.9
67;2021-08-20;2370;7460;822122;731667;72.6;64.6
67;2021-08-21;1530;5572;823652;737239;72.7;65.1
67;2021-08-22;390;2051;824042;739290;72.8;65.3
67;2021-08-23;1948;6851;825990;746141;72.9;65.9
67;2021-08-24;2002;6613;827992;752754;73.1;66.5
67;2021-08-25;2131;7217;830123;759971;73.3;67.1
67;2021-08-26;1858;5555;831981;765526;73.5;67.6
67;2021-08-27;2222;7057;834203;772583;73.7;68.2
67;2021-08-28;1707;6109;835910;778692;73.8;68.8
67;2021-08-29;439;1600;836349;780292;73.8;68.9
67;2021-08-30;1426;4274;837775;784566;74.0;69.3
67;2021-08-31;1452;3955;839227;788521;74.1;69.6
67;2021-09-01;2014;4059;841241;792580;74.3;70.0
67;2021-09-02;1095;2718;842336;795298;74.4;70.2
67;2021-09-03;1567;3922;843903;799220;74.5;70.6
67;2021-09-04;1491;3773;845394;802993;74.6;70.9
67;2021-09-05;259;842;845653;803835;74.7;71.0
67;2021-09-06;981;1938;846634;805773;74.8;71.1
67;2021-09-07;909;1848;847543;807621;74.8;71.3
67;2021-09-08;1223;2471;848766;810092;74.9;71.5
67;2021-09-09;1133;1795;849899;811887;75.0;71.7
67;2021-09-10;1465;2371;851364;814258;75.2;71.9
67;2021-09-11;1067;2757;852431;817015;75.3;72.1
67;2021-09-12;253;522;852684;817537;75.3;72.2
67;2021-09-13;776;1449;853460;818986;75.4;72.3
67;2021-09-14;959;1476;854419;820462;75.4;72.4
67;2021-09-15;1039;2108;855458;822570;75.5;72.6
67;2021-09-16;769;1307;856227;823877;75.6;72.7
67;2021-09-17;1009;2233;857236;826110;75.7;72.9
67;2021-09-18;813;2425;858049;828535;75.8;73.2
67;2021-09-19;104;411;858153;828946;75.8;73.2
67;2021-09-20;621;1133;858774;830079;75.8;73.3
67;2021-09-21;493;1066;859267;831145;75.9;73.4
67;2021-09-22;669;1951;859936;833096;75.9;73.6
67;2021-09-23;567;943;860503;834039;76.0;73.6
67;2021-09-24;690;1675;861193;835714;76.0;73.8
67;2021-09-25;602;1871;861795;837585;76.1;74.0
67;2021-09-26;73;327;861868;837912;76.1;74.0
67;2021-09-27;401;953;862269;838865;76.1;74.1
67;2021-09-28;405;860;862674;839725;76.2;74.1
67;2021-09-29;620;1362;863294;841087;76.2;74.3
67;2021-09-30;423;932;863717;842019;76.3;74.3
67;2021-10-01;669;1444;864386;843463;76.3;74.5
67;2021-10-02;626;1288;865012;844751;76.4;74.6
67;2021-10-03;95;221;865107;844972;76.4;74.6
67;2021-10-04;314;677;865421;845649;76.4;74.7
67;2021-10-05;325;752;865746;846401;76.4;74.7
67;2021-10-06;579;1133;866325;847534;76.5;74.8
67;2021-10-07;448;775;866773;848309;76.5;74.9
67;2021-10-08;634;1274;867407;849583;76.6;75.0
67;2021-10-09;505;1020;867912;850603;76.6;75.1
67;2021-10-10;80;113;867992;850716;76.6;75.1
67;2021-10-11;338;617;868330;851333;76.7;75.2
67;2021-10-12;361;603;868691;851936;76.7;75.2
67;2021-10-13;580;934;869271;852870;76.7;75.3
67;2021-10-14;385;651;869656;853521;76.8;75.4
67;2021-10-15;659;1071;870315;854592;76.8;75.5
67;2021-10-16;560;937;870875;855529;76.9;75.5
67;2021-10-17;123;114;870998;855643;76.9;75.5
67;2021-10-18;432;647;871430;856290;76.9;75.6
67;2021-10-19;346;649;871776;856939;77.0;75.7
68;2020-12-27;0;0;0;0;0.0;0.0
68;2020-12-28;0;0;0;0;0.0;0.0
68;2020-12-29;0;0;0;0;0.0;0.0
68;2020-12-30;2;0;2;0;0.0;0.0
68;2020-12-31;0;0;2;0;0.0;0.0
68;2021-01-01;0;0;2;0;0.0;0.0
68;2021-01-02;0;0;2;0;0.0;0.0
68;2021-01-03;1;0;3;0;0.0;0.0
68;2021-01-04;3;1;6;1;0.0;0.0
68;2021-01-05;11;0;17;1;0.0;0.0
68;2021-01-06;245;1;262;2;0.0;0.0
68;2021-01-07;75;0;337;2;0.0;0.0
68;2021-01-08;118;1;455;3;0.1;0.0
68;2021-01-09;20;0;475;3;0.1;0.0
68;2021-01-10;1;0;476;3;0.1;0.0
68;2021-01-11;82;0;558;3;0.1;0.0
68;2021-01-12;388;2;946;5;0.1;0.0
68;2021-01-13;704;3;1650;8;0.2;0.0
68;2021-01-14;372;2;2022;10;0.3;0.0
68;2021-01-15;204;1;2226;11;0.3;0.0
68;2021-01-16;1;0;2227;11;0.3;0.0
68;2021-01-17;0;0;2227;11;0.3;0.0
68;2021-01-18;379;5;2606;16;0.3;0.0
68;2021-01-19;560;5;3166;21;0.4;0.0
68;2021-01-20;707;10;3873;31;0.5;0.0
68;2021-01-21;1395;14;5268;45;0.7;0.0
68;2021-01-22;1498;15;6766;60;0.9;0.0
68;2021-01-23;215;3;6981;63;0.9;0.0
68;2021-01-24;699;2;7680;65;1.0;0.0
68;2021-01-25;1390;45;9070;110;1.2;0.0
68;2021-01-26;1555;80;10625;190;1.4;0.0
68;2021-01-27;2779;160;13404;350;1.8;0.0
68;2021-01-28;2358;62;15762;412;2.1;0.1
68;2021-01-29;1509;119;17271;531;2.3;0.1
68;2021-01-30;165;3;17436;534;2.3;0.1
68;2021-01-31;0;0;17436;534;2.3;0.1
68;2021-02-01;737;117;18173;651;2.4;0.1
68;2021-02-02;872;305;19045;956;2.5;0.1
68;2021-02-03;1001;616;20046;1572;2.6;0.2
68;2021-02-04;1001;323;21047;1895;2.8;0.2
68;2021-02-05;948;234;21995;2129;2.9;0.3
68;2021-02-06;140;2;22135;2131;2.9;0.3
68;2021-02-07;2;16;22137;2147;2.9;0.3
68;2021-02-08;893;24;23030;2171;3.0;0.3
68;2021-02-09;1357;47;24387;2218;3.2;0.3
68;2021-02-10;1453;65;25840;2283;3.4;0.3
68;2021-02-11;1486;469;27326;2752;3.6;0.4
68;2021-02-12;1551;446;28877;3198;3.8;0.4
68;2021-02-13;131;1;29008;3199;3.8;0.4
68;2021-02-14;58;232;29066;3431;3.8;0.4
68;2021-02-15;662;1087;29728;4518;3.9;0.6
68;2021-02-16;865;1370;30593;5888;4.0;0.8
68;2021-02-17;1288;2130;31881;8018;4.2;1.1
68;2021-02-18;1671;2067;33552;10085;4.4;1.3
68;2021-02-19;988;1370;34540;11455;4.5;1.5
68;2021-02-20;93;125;34633;11580;4.5;1.5
68;2021-02-21;1;40;34634;11620;4.5;1.5
68;2021-02-22;446;796;35080;12416;4.6;1.6
68;2021-02-23;639;1062;35719;13478;4.7;1.8
68;2021-02-24;854;1158;36573;14636;4.8;1.9
68;2021-02-25;1208;1250;37781;15886;5.0;2.1
68;2021-02-26;1199;990;38980;16876;5.1;2.2
68;2021-02-27;550;178;39530;17054;5.2;2.2
68;2021-02-28;12;1;39542;17055;5.2;2.2
68;2021-03-01;942;769;40484;17824;5.3;2.3
68;2021-03-02;1215;928;41699;18752;5.5;2.5
68;2021-03-03;1593;973;43292;19725;5.7;2.6
68;2021-03-04;1997;1054;45289;20779;5.9;2.7
68;2021-03-05;2356;1054;47645;21833;6.2;2.9
68;2021-03-06;2288;254;49933;22087;6.5;2.9
68;2021-03-07;838;108;50771;22195;6.7;2.9
68;2021-03-08;1476;978;52247;23173;6.8;3.0
68;2021-03-09;1698;1332;53945;24505;7.1;3.2
68;2021-03-10;1966;1805;55911;26310;7.3;3.4
68;2021-03-11;2637;1914;58548;28224;7.7;3.7
68;2021-03-12;2631;1425;61179;29649;8.0;3.9
68;2021-03-13;3343;264;64522;29913;8.5;3.9
68;2021-03-14;1541;68;66063;29981;8.7;3.9
68;2021-03-15;1796;624;67859;30605;8.9;4.0
68;2021-03-16;1998;603;69857;31208;9.2;4.1
68;2021-03-17;1958;736;71815;31944;9.4;4.2
68;2021-03-18;2220;951;74035;32895;9.7;4.3
68;2021-03-19;3084;741;77119;33636;10.1;4.4
68;2021-03-20;974;125;78093;33761;10.2;4.4
68;2021-03-21;69;2;78162;33763;10.2;4.4
68;2021-03-22;1964;597;80126;34360;10.5;4.5
68;2021-03-23;2861;621;82987;34981;10.9;4.6
68;2021-03-24;3177;819;86164;35800;11.3;4.7
68;2021-03-25;3501;796;89665;36596;11.7;4.8
68;2021-03-26;3894;738;93559;37334;12.3;4.9
68;2021-03-27;1102;169;94661;37503;12.4;4.9
68;2021-03-28;56;3;94717;37506;12.4;4.9
68;2021-03-29;2260;1369;96977;38875;12.7;5.1
68;2021-03-30;2933;1306;99910;40181;13.1;5.3
68;2021-03-31;2643;1368;102553;41549;13.4;5.4
68;2021-04-01;2748;1555;105301;43104;13.8;5.6
68;2021-04-02;244;88;105545;43192;13.8;5.7
68;2021-04-03;241;124;105786;43316;13.9;5.7
68;2021-04-04;8;0;105794;43316;13.9;5.7
68;2021-04-05;49;4;105843;43320;13.9;5.7
68;2021-04-06;1793;1327;107636;44647;14.1;5.8
68;2021-04-07;2585;1542;110221;46189;14.4;6.1
68;2021-04-08;3234;1509;113455;47698;14.9;6.2
68;2021-04-09;4200;1538;117655;49236;15.4;6.5
68;2021-04-10;1203;1974;118858;51210;15.6;6.7
68;2021-04-11;127;1317;118985;52527;15.6;6.9
68;2021-04-12;2666;1639;121651;54166;15.9;7.1
68;2021-04-13;2760;2117;124411;56283;16.3;7.4
68;2021-04-14;3606;2272;128017;58555;16.8;7.7
68;2021-04-15;4055;2167;132072;60722;17.3;8.0
68;2021-04-16;3942;2085;136014;62807;17.8;8.2
68;2021-04-17;1075;444;137089;63251;18.0;8.3
68;2021-04-18;85;9;137174;63260;18.0;8.3
68;2021-04-19;2358;1834;139532;65094;18.3;8.5
68;2021-04-20;2442;2330;141974;67424;18.6;8.8
68;2021-04-21;2829;2478;144803;69902;19.0;9.2
68;2021-04-22;3287;1975;148090;71877;19.4;9.4
68;2021-04-23;3412;2077;151502;73954;19.9;9.7
68;2021-04-24;842;489;152344;74443;20.0;9.8
68;2021-04-25;214;20;152558;74463;20.0;9.8
68;2021-04-26;2328;2107;154886;76570;20.3;10.0
68;2021-04-27;2599;2217;157485;78787;20.6;10.3
68;2021-04-28;3572;1767;161057;80554;21.1;10.6
68;2021-04-29;4164;1751;165221;82305;21.6;10.8
68;2021-04-30;4834;1376;170055;83681;22.3;11.0
68;2021-05-01;947;121;171002;83802;22.4;11.0
68;2021-05-02;732;70;171734;83872;22.5;11.0
68;2021-05-03;3620;1820;175354;85692;23.0;11.2
68;2021-05-04;3937;2363;179291;88055;23.5;11.5
68;2021-05-05;3632;3249;182923;91304;24.0;12.0
68;2021-05-06;4804;2864;187727;94168;24.6;12.3
68;2021-05-07;4518;2909;192245;97077;25.2;12.7
68;2021-05-08;1672;210;193917;97287;25.4;12.7
68;2021-05-09;1075;107;194992;97394;25.5;12.8
68;2021-05-10;3160;3721;198152;101115;26.0;13.2
68;2021-05-11;4715;3623;202867;104738;26.6;13.7
68;2021-05-12;5785;3295;208652;108033;27.3;14.2
68;2021-05-13;4766;840;213418;108873;28.0;14.3
68;2021-05-14;5959;2134;219377;111007;28.7;14.5
68;2021-05-15;3558;910;222935;111917;29.2;14.7
68;2021-05-16;670;119;223605;112036;29.3;14.7
68;2021-05-17;4449;2499;228054;114535;29.9;15.0
68;2021-05-18;6139;2307;234193;116842;30.7;15.3
68;2021-05-19;5868;2884;240061;119726;31.5;15.7
68;2021-05-20;5929;2413;245990;122139;32.2;16.0
68;2021-05-21;5778;2870;251768;125009;33.0;16.4
68;2021-05-22;2576;928;254344;125937;33.3;16.5
68;2021-05-23;15;16;254359;125953;33.3;16.5
68;2021-05-24;2304;971;256663;126924;33.6;16.6
68;2021-05-25;4343;3436;261006;130360;34.2;17.1
68;2021-05-26;4884;3384;265890;133744;34.8;17.5
68;2021-05-27;5400;3408;271290;137152;35.5;18.0
68;2021-05-28;5624;3727;276914;140879;36.3;18.5
68;2021-05-29;1540;1186;278454;142065;36.5;18.6
68;2021-05-30;41;46;278495;142111;36.5;18.6
68;2021-05-31;5158;2364;283653;144475;37.2;18.9
68;2021-06-01;5988;2799;289641;147274;38.0;19.3
68;2021-06-02;4886;3006;294527;150280;38.6;19.7
68;2021-06-03;5938;3099;300465;153379;39.4;20.1
68;2021-06-04;4896;3306;305361;156685;40.0;20.5
68;2021-06-05;781;1169;306142;157854;40.1;20.7
68;2021-06-06;69;114;306211;157968;40.1;20.7
68;2021-06-07;4753;3036;310964;161004;40.7;21.1
68;2021-06-08;4933;3556;315897;164560;41.4;21.6
68;2021-06-09;4994;3448;320891;168008;42.0;22.0
68;2021-06-10;5200;3145;326091;171153;42.7;22.4
68;2021-06-11;5055;4149;331146;175302;43.4;23.0
68;2021-06-12;3037;1772;334183;177074;43.8;23.2
68;2021-06-13;514;682;334697;177756;43.9;23.3
68;2021-06-14;2514;4387;337211;182143;44.2;23.9
68;2021-06-15;3112;4724;340323;186867;44.6;24.5
68;2021-06-16;3387;4442;343710;191309;45.0;25.1
68;2021-06-17;2359;4458;346069;195767;45.3;25.7
68;2021-06-18;3357;5171;349426;200938;45.8;26.3
68;2021-06-19;2253;2170;351679;203108;46.1;26.6
68;2021-06-20;258;891;351937;203999;46.1;26.7
68;2021-06-21;2060;5148;353997;209147;46.4;27.4
68;2021-06-22;1900;5174;355897;214321;46.6;28.1
68;2021-06-23;2319;5740;358216;220061;46.9;28.8
68;2021-06-24;2154;4897;360370;224958;47.2;29.5
68;2021-06-25;2288;6660;362658;231618;47.5;30.3
68;2021-06-26;1303;2606;363961;234224;47.7;30.7
68;2021-06-27;151;880;364112;235104;47.7;30.8
68;2021-06-28;1601;6444;365713;241548;47.9;31.6
68;2021-06-29;1539;6632;367252;248180;48.1;32.5
68;2021-06-30;1798;6554;369050;254734;48.4;33.4
68;2021-07-01;2105;5351;371155;260085;48.6;34.1
68;2021-07-02;2098;6481;373253;266566;48.9;34.9
68;2021-07-03;989;1934;374242;268500;49.0;35.2
68;2021-07-04;242;200;374484;268700;49.1;35.2
68;2021-07-05;1456;5513;375940;274213;49.3;35.9
68;2021-07-06;2001;5884;377941;280097;49.5;36.7
68;2021-07-07;2455;4974;380396;285071;49.8;37.4
68;2021-07-08;2434;4750;382830;289821;50.2;38.0
68;2021-07-09;2091;7363;384921;297184;50.4;38.9
68;2021-07-10;1028;2003;385949;299187;50.6;39.2
68;2021-07-11;147;156;386096;299343;50.6;39.2
68;2021-07-12;1646;6771;387742;306114;50.8;40.1
68;2021-07-13;2909;6550;390651;312664;51.2;41.0
68;2021-07-14;1840;984;392491;313648;51.4;41.1
68;2021-07-15;3189;6655;395680;320303;51.8;42.0
68;2021-07-16;3817;6762;399497;327065;52.3;42.9
68;2021-07-17;3361;2302;402858;329367;52.8;43.2
68;2021-07-18;1054;230;403912;329597;52.9;43.2
68;2021-07-19;3051;6081;406963;335678;53.3;44.0
68;2021-07-20;4002;5676;410965;341354;53.8;44.7
68;2021-07-21;4339;5831;415304;347185;54.4;45.5
68;2021-07-22;4188;4850;419492;352035;55.0;46.1
68;2021-07-23;5041;5762;424533;357797;55.6;46.9
68;2021-07-24;3349;2134;427882;359931;56.1;47.2
68;2021-07-25;825;538;428707;360469;56.2;47.2
68;2021-07-26;4835;4450;433542;364919;56.8;47.8
68;2021-07-27;6364;3757;439906;368676;57.6;48.3
68;2021-07-28;6848;3884;446754;372560;58.5;48.8
68;2021-07-29;6398;3428;453152;375988;59.4;49.3
68;2021-07-30;6345;4378;459497;380366;60.2;49.8
68;2021-07-31;3917;1427;463414;381793;60.7;50.0
68;2021-08-01;1651;494;465065;382287;60.9;50.1
68;2021-08-02;4606;3151;469671;385438;61.5;50.5
68;2021-08-03;3550;2454;473221;387892;62.0;50.8
68;2021-08-04;3135;2689;476356;390581;62.4;51.2
68;2021-08-05;2753;2641;479109;393222;62.8;51.5
68;2021-08-06;3995;4326;483104;397548;63.3;52.1
68;2021-08-07;1227;1306;484331;398854;63.5;52.3
68;2021-08-08;364;813;484695;399667;63.5;52.4
68;2021-08-09;2575;3684;487270;403351;63.8;52.8
68;2021-08-10;2218;2785;489488;406136;64.1;53.2
68;2021-08-11;1896;2728;491384;408864;64.4;53.6
68;2021-08-12;1753;2665;493137;411529;64.6;53.9
68;2021-08-13;2716;4759;495853;416288;65.0;54.5
68;2021-08-14;716;1444;496569;417732;65.1;54.7
68;2021-08-15;45;445;496614;418177;65.1;54.8
68;2021-08-16;2005;5062;498619;423239;65.3;55.5
68;2021-08-17;1803;4846;500422;428085;65.6;56.1
68;2021-08-18;1182;3697;501604;431782;65.7;56.6
68;2021-08-19;1367;3741;502971;435523;65.9;57.1
68;2021-08-20;2229;6065;505200;441588;66.2;57.9
68;2021-08-21;492;1382;505692;442970;66.3;58.0
68;2021-08-22;116;457;505808;443427;66.3;58.1
68;2021-08-23;1191;5426;506999;448853;66.4;58.8
68;2021-08-24;1407;5955;508406;454808;66.6;59.6
68;2021-08-25;1661;3753;510067;458561;66.8;60.1
68;2021-08-26;1991;4505;512058;463066;67.1;60.7
68;2021-08-27;1850;6281;513908;469347;67.3;61.5
68;2021-08-28;422;1070;514330;470417;67.4;61.6
68;2021-08-29;36;418;514366;470835;67.4;61.7
68;2021-08-30;1350;4519;515716;475354;67.6;62.3
68;2021-08-31;1305;4107;517021;479461;67.7;62.8
68;2021-09-01;893;2141;517914;481602;67.9;63.1
68;2021-09-02;880;1769;518794;483371;68.0;63.3
68;2021-09-03;1310;4320;520104;487691;68.1;63.9
68;2021-09-04;495;870;520599;488561;68.2;64.0
68;2021-09-05;209;120;520808;488681;68.2;64.0
68;2021-09-06;698;2137;521506;490818;68.3;64.3
68;2021-09-07;607;1263;522113;492081;68.4;64.5
68;2021-09-08;624;1330;522737;493411;68.5;64.6
68;2021-09-09;900;1241;523637;494652;68.6;64.8
68;2021-09-10;1486;3029;525123;497681;68.8;65.2
68;2021-09-11;470;619;525593;498300;68.9;65.3
68;2021-09-12;73;53;525666;498353;68.9;65.3
68;2021-09-13;827;1186;526493;499539;69.0;65.5
68;2021-09-14;976;1347;527469;500886;69.1;65.6
68;2021-09-15;700;1589;528169;502475;69.2;65.8
68;2021-09-16;632;1079;528801;503554;69.3;66.0
68;2021-09-17;989;2331;529790;505885;69.4;66.3
68;2021-09-18;447;766;530237;506651;69.5;66.4
68;2021-09-19;16;48;530253;506699;69.5;66.4
68;2021-09-20;563;967;530816;507666;69.6;66.5
68;2021-09-21;586;1329;531402;508995;69.6;66.7
68;2021-09-22;635;1156;532037;510151;69.7;66.8
68;2021-09-23;369;682;532406;510833;69.8;66.9
68;2021-09-24;650;1607;533056;512440;69.8;67.1
68;2021-09-25;276;669;533332;513109;69.9;67.2
68;2021-09-26;19;56;533351;513165;69.9;67.2
68;2021-09-27;342;689;533693;513854;69.9;67.3
68;2021-09-28;339;546;534032;514400;70.0;67.4
68;2021-09-29;537;879;534569;515279;70.0;67.5
68;2021-09-30;387;790;534956;516069;70.1;67.6
68;2021-10-01;505;1541;535461;517610;70.2;67.8
68;2021-10-02;267;573;535728;518183;70.2;67.9
68;2021-10-03;38;91;535766;518274;70.2;67.9
68;2021-10-04;213;425;535979;518699;70.2;68.0
68;2021-10-05;290;561;536269;519260;70.3;68.0
68;2021-10-06;385;877;536654;520137;70.3;68.2
68;2021-10-07;389;595;537043;520732;70.4;68.2
68;2021-10-08;694;1625;537737;522357;70.5;68.4
68;2021-10-09;308;615;538045;522972;70.5;68.5
68;2021-10-10;29;45;538074;523017;70.5;68.5
68;2021-10-11;237;465;538311;523482;70.5;68.6
68;2021-10-12;243;479;538554;523961;70.6;68.7
68;2021-10-13;496;665;539050;524626;70.6;68.7
68;2021-10-14;374;614;539424;525240;70.7;68.8
68;2021-10-15;688;951;540112;526191;70.8;68.9
68;2021-10-16;218;369;540330;526560;70.8;69.0
68;2021-10-17;29;23;540359;526583;70.8;69.0
68;2021-10-18;233;337;540592;526920;70.8;69.0
68;2021-10-19;248;404;540840;527324;70.9;69.1
69;2020-12-27;5;1;5;1;0.0;0.0
69;2020-12-28;13;3;18;4;0.0;0.0
69;2020-12-29;5;0;23;4;0.0;0.0
69;2020-12-30;6;1;29;5;0.0;0.0
69;2020-12-31;12;4;41;9;0.0;0.0
69;2021-01-01;2;0;43;9;0.0;0.0
69;2021-01-02;2;1;45;10;0.0;0.0
69;2021-01-03;3;2;48;12;0.0;0.0
69;2021-01-04;13;0;61;12;0.0;0.0
69;2021-01-05;218;9;279;21;0.0;0.0
69;2021-01-06;518;5;797;26;0.0;0.0
69;2021-01-07;813;5;1610;31;0.1;0.0
69;2021-01-08;829;1;2439;32;0.1;0.0
69;2021-01-09;42;3;2481;35;0.1;0.0
69;2021-01-10;3;1;2484;36;0.1;0.0
69;2021-01-11;1135;2;3619;38;0.2;0.0
69;2021-01-12;1400;10;5019;48;0.3;0.0
69;2021-01-13;1395;6;6414;54;0.3;0.0
69;2021-01-14;2288;27;8702;81;0.5;0.0
69;2021-01-15;1829;8;10531;89;0.6;0.0
69;2021-01-16;930;4;11461;93;0.6;0.0
69;2021-01-17;260;3;11721;96;0.6;0.0
69;2021-01-18;1695;20;13416;116;0.7;0.0
69;2021-01-19;3513;37;16929;153;0.9;0.0
69;2021-01-20;4456;34;21385;187;1.1;0.0
69;2021-01-21;4078;43;25463;230;1.4;0.0
69;2021-01-22;3184;30;28647;260;1.5;0.0
69;2021-01-23;1287;6;29934;266;1.6;0.0
69;2021-01-24;103;1;30037;267;1.6;0.0
69;2021-01-25;2246;45;32283;312;1.7;0.0
69;2021-01-26;2563;92;34846;404;1.9;0.0
69;2021-01-27;2360;176;37206;580;2.0;0.0
69;2021-01-28;2238;374;39444;954;2.1;0.1
69;2021-01-29;2111;291;41555;1245;2.2;0.1
69;2021-01-30;889;3;42444;1248;2.3;0.1
69;2021-01-31;65;0;42509;1248;2.3;0.1
69;2021-02-01;1112;401;43621;1649;2.3;0.1
69;2021-02-02;1560;427;45181;2076;2.4;0.1
69;2021-02-03;1445;537;46626;2613;2.5;0.1
69;2021-02-04;1798;954;48424;3567;2.6;0.2
69;2021-02-05;820;822;49244;4389;2.6;0.2
69;2021-02-06;370;53;49614;4442;2.6;0.2
69;2021-02-07;0;0;49614;4442;2.6;0.2
69;2021-02-08;1132;1075;50746;5517;2.7;0.3
69;2021-02-09;2052;2117;52798;7634;2.8;0.4
69;2021-02-10;1855;2658;54653;10292;2.9;0.5
69;2021-02-11;1859;3294;56512;13586;3.0;0.7
69;2021-02-12;1906;2101;58418;15687;3.1;0.8
69;2021-02-13;460;789;58878;16476;3.1;0.9
69;2021-02-14;89;39;58967;16515;3.1;0.9
69;2021-02-15;1016;1764;59983;18279;3.2;1.0
69;2021-02-16;984;2438;60967;20717;3.2;1.1
69;2021-02-17;1026;2391;61993;23108;3.3;1.2
69;2021-02-18;968;2302;62961;25410;3.4;1.4
69;2021-02-19;890;1872;63851;27282;3.4;1.5
69;2021-02-20;321;911;64172;28193;3.4;1.5
69;2021-02-21;53;70;64225;28263;3.4;1.5
69;2021-02-22;608;2099;64833;30362;3.5;1.6
69;2021-02-23;740;2221;65573;32583;3.5;1.7
69;2021-02-24;973;2252;66546;34835;3.5;1.9
69;2021-02-25;2214;2689;68760;37524;3.7;2.0
69;2021-02-26;2772;1932;71532;39456;3.8;2.1
69;2021-02-27;925;576;72457;40032;3.9;2.1
69;2021-02-28;148;104;72605;40136;3.9;2.1
69;2021-03-01;2171;914;74776;41050;4.0;2.2
69;2021-03-02;3299;1430;78075;42480;4.2;2.3
69;2021-03-03;3672;1246;81747;43726;4.4;2.3
69;2021-03-04;4888;1319;86635;45045;4.6;2.4
69;2021-03-05;5875;1280;92510;46325;4.9;2.5
69;2021-03-06;3417;434;95927;46759;5.1;2.5
69;2021-03-07;640;44;96567;46803;5.1;2.5
69;2021-03-08;2962;1134;99529;47937;5.3;2.6
69;2021-03-09;4609;1283;104138;49220;5.6;2.6
69;2021-03-10;5075;1070;109213;50290;5.8;2.7
69;2021-03-11;6604;1080;115817;51370;6.2;2.7
69;2021-03-12;8857;1253;124674;52623;6.6;2.8
69;2021-03-13;4927;256;129601;52879;6.9;2.8
69;2021-03-14;2741;160;132342;53039;7.1;2.8
69;2021-03-15;4805;743;137147;53782;7.3;2.9
69;2021-03-16;3820;679;140967;54461;7.5;2.9
69;2021-03-17;3956;907;144923;55368;7.7;3.0
69;2021-03-18;4967;1639;149890;57007;8.0;3.0
69;2021-03-19;6685;1085;156575;58092;8.3;3.1
69;2021-03-20;3593;287;160168;58379;8.5;3.1
69;2021-03-21;1975;104;162143;58483;8.6;3.1
69;2021-03-22;4551;829;166694;59312;8.9;3.2
69;2021-03-23;7365;853;174059;60165;9.3;3.2
69;2021-03-24;6456;1026;180515;61191;9.6;3.3
69;2021-03-25;8594;1142;189109;62333;10.1;3.3
69;2021-03-26;8812;1272;197921;63605;10.5;3.4
69;2021-03-27;3157;803;201078;64408;10.7;3.4
69;2021-03-28;2219;192;203297;64600;10.8;3.4
69;2021-03-29;4095;2198;207392;66798;11.1;3.6
69;2021-03-30;7643;2578;215035;69376;11.5;3.7
69;2021-03-31;6357;3203;221392;72579;11.8;3.9
69;2021-04-01;8463;2763;229855;75342;12.3;4.0
69;2021-04-02;8316;3151;238171;78493;12.7;4.2
69;2021-04-03;5424;2174;243595;80667;13.0;4.3
69;2021-04-04;6610;556;250205;81223;13.3;4.3
69;2021-04-05;6192;823;256397;82046;13.7;4.4
69;2021-04-06;5115;3497;261512;85543;13.9;4.6
69;2021-04-07;5168;3910;266680;89453;14.2;4.8
69;2021-04-08;6430;4060;273110;93513;14.6;5.0
69;2021-04-09;9166;3803;282276;97316;15.0;5.2
69;2021-04-10;3055;2512;285331;99828;15.2;5.3
69;2021-04-11;2035;1904;287366;101732;15.3;5.4
69;2021-04-12;5474;3592;292840;105324;15.6;5.6
69;2021-04-13;7068;4135;299908;109459;16.0;5.8
69;2021-04-14;6717;4171;306625;113630;16.3;6.1
69;2021-04-15;7943;4616;314568;118246;16.8;6.3
69;2021-04-16;7868;4520;322436;122766;17.2;6.5
69;2021-04-17;5036;2319;327472;125085;17.5;6.7
69;2021-04-18;1715;1797;329187;126882;17.5;6.8
69;2021-04-19;7024;3782;336211;130664;17.9;7.0
69;2021-04-20;6485;4779;342696;135443;18.3;7.2
69;2021-04-21;5691;4428;348387;139871;18.6;7.5
69;2021-04-22;6427;5457;354814;145328;18.9;7.7
69;2021-04-23;6737;4918;361551;150246;19.3;8.0
69;2021-04-24;3160;2037;364711;152283;19.4;8.1
69;2021-04-25;2120;1548;366831;153831;19.6;8.2
69;2021-04-26;4495;3887;371326;157718;19.8;8.4
69;2021-04-27;6516;5337;377842;163055;20.1;8.7
69;2021-04-28;6272;4876;384114;167931;20.5;9.0
69;2021-04-29;6706;5408;390820;173339;20.8;9.2
69;2021-04-30;6931;6193;397751;179532;21.2;9.6
69;2021-05-01;3301;646;401052;180178;21.4;9.6
69;2021-05-02;1628;5885;402680;186063;21.5;9.9
69;2021-05-03;5860;8256;408540;194319;21.8;10.4
69;2021-05-04;7608;8181;416148;202500;22.2;10.8
69;2021-05-05;11212;5668;427360;208168;22.8;11.1
69;2021-05-06;12469;6311;439829;214479;23.4;11.4
69;2021-05-07;11685;7174;451514;221653;24.1;11.8
69;2021-05-08;4303;1658;455817;223311;24.3;11.9
69;2021-05-09;6634;2684;462451;225995;24.7;12.0
69;2021-05-10;6935;6075;469386;232070;25.0;12.4
69;2021-05-11;9829;7048;479215;239118;25.5;12.7
69;2021-05-12;12449;6812;491664;245930;26.2;13.1
69;2021-05-13;10839;2562;502503;248492;26.8;13.2
69;2021-05-14;12599;5218;515102;253710;27.5;13.5
69;2021-05-15;9136;2591;524238;256301;27.9;13.7
69;2021-05-16;8403;1877;532641;258178;28.4;13.8
69;2021-05-17;11306;5652;543947;263830;29.0;14.1
69;2021-05-18;13226;6402;557173;270232;29.7;14.4
69;2021-05-19;13696;5888;570869;276120;30.4;14.7
69;2021-05-20;11387;6087;582256;282207;31.0;15.0
69;2021-05-21;11036;6559;593292;288766;31.6;15.4
69;2021-05-22;5575;2576;598867;291342;31.9;15.5
69;2021-05-23;4573;1543;603440;292885;32.2;15.6
69;2021-05-24;8420;1865;611860;294750;32.6;15.7
69;2021-05-25;9741;6179;621601;300929;33.1;16.0
69;2021-05-26;10282;6110;631883;307039;33.7;16.4
69;2021-05-27;10429;6788;642312;313827;34.2;16.7
69;2021-05-28;11610;8752;653922;322579;34.9;17.2
69;2021-05-29;7386;6047;661308;328626;35.3;17.5
69;2021-05-30;7387;3169;668695;331795;35.6;17.7
69;2021-05-31;10955;6382;679650;338177;36.2;18.0
69;2021-06-01;12849;7520;692499;345697;36.9;18.4
69;2021-06-02;14886;6724;707385;352421;37.7;18.8
69;2021-06-03;16641;7433;724026;359854;38.6;19.2
69;2021-06-04;16198;8564;740224;368418;39.5;19.6
69;2021-06-05;10105;3420;750329;371838;40.0;19.8
69;2021-06-06;7488;1720;757817;373558;40.4;19.9
69;2021-06-07;12816;7029;770633;380587;41.1;20.3
69;2021-06-08;16307;8283;786940;388870;41.9;20.7
69;2021-06-09;15212;7361;802152;396231;42.8;21.1
69;2021-06-10;16278;7337;818430;403568;43.6;21.5
69;2021-06-11;16636;9692;835066;413260;44.5;22.0
69;2021-06-12;8529;4189;843595;417449;45.0;22.3
69;2021-06-13;5620;2146;849215;419595;45.3;22.4
69;2021-06-14;8576;9085;857791;428680;45.7;22.9
69;2021-06-15;10932;11014;868723;439694;46.3;23.4
69;2021-06-16;11331;12320;880054;452014;46.9;24.1
69;2021-06-17;11455;13261;891509;465275;47.5;24.8
69;2021-06-18;12044;14775;903553;480050;48.2;25.6
69;2021-06-19;6813;8355;910366;488405;48.5;26.0
69;2021-06-20;5274;4768;915640;493173;48.8;26.3
69;2021-06-21;6538;12120;922178;505293;49.2;26.9
69;2021-06-22;7210;13835;929388;519128;49.5;27.7
69;2021-06-23;8348;13028;937736;532156;50.0;28.4
69;2021-06-24;9294;13745;947030;545901;50.5;29.1
69;2021-06-25;7079;16311;954109;562212;50.9;30.0
69;2021-06-26;3872;9073;957981;571285;51.1;30.5
69;2021-06-27;3291;7420;961272;578705;51.2;30.8
69;2021-06-28;4552;14893;965824;593598;51.5;31.6
69;2021-06-29;5367;15670;971191;609268;51.8;32.5
69;2021-06-30;6386;14452;977577;623720;52.1;33.2
69;2021-07-01;9053;11982;986630;635702;52.6;33.9
69;2021-07-02;10688;14126;997318;649828;53.2;34.6
69;2021-07-03;5994;7770;1003312;657598;53.5;35.1
69;2021-07-04;4128;5551;1007440;663149;53.7;35.3
69;2021-07-05;6230;13021;1013670;676170;54.0;36.0
69;2021-07-06;5915;14281;1019585;690451;54.3;36.8
69;2021-07-07;7319;13564;1026904;704015;54.7;37.5
69;2021-07-08;7586;13409;1034490;717424;55.1;38.2
69;2021-07-09;7582;16481;1042072;733905;55.5;39.1
69;2021-07-10;3124;10315;1045196;744220;55.7;39.7
69;2021-07-11;4331;5830;1049527;750050;55.9;40.0
69;2021-07-12;4212;16969;1053739;767019;56.2;40.9
69;2021-07-13;6452;20720;1060191;787739;56.5;42.0
69;2021-07-14;5054;8482;1065245;796221;56.8;42.4
69;2021-07-15;7498;22582;1072743;818803;57.2;43.6
69;2021-07-16;9963;20120;1082706;838923;57.7;44.7
69;2021-07-17;4883;12239;1087589;851162;58.0;45.4
69;2021-07-18;3411;8894;1091000;860056;58.2;45.8
69;2021-07-19;7072;16464;1098072;876520;58.5;46.7
69;2021-07-20;9579;19306;1107651;895826;59.0;47.8
69;2021-07-21;9387;17424;1117038;913250;59.5;48.7
69;2021-07-22;11474;16403;1128512;929653;60.2;49.6
69;2021-07-23;11139;17689;1139651;947342;60.7;50.5
69;2021-07-24;5707;11047;1145358;958389;61.1;51.1
69;2021-07-25;4706;6630;1150064;965019;61.3;51.4
69;2021-07-26;8929;12955;1158993;977974;61.8;52.1
69;2021-07-27;12939;12099;1171932;990073;62.5;52.8
69;2021-07-28;12092;12157;1184024;1002230;63.1;53.4
69;2021-07-29;14763;12265;1198787;1014495;63.9;54.1
69;2021-07-30;14422;12248;1213209;1026743;64.7;54.7
69;2021-07-31;8269;7257;1221478;1034000;65.1;55.1
69;2021-08-01;5189;5882;1226667;1039882;65.4;55.4
69;2021-08-02;13310;9640;1239977;1049522;66.1;55.9
69;2021-08-03;13291;8991;1253268;1058513;66.8;56.4
69;2021-08-04;14352;8140;1267620;1066653;67.6;56.9
69;2021-08-05;11534;7539;1279154;1074192;68.2;57.3
69;2021-08-06;10631;7799;1289785;1081991;68.7;57.7
69;2021-08-07;5006;4811;1294791;1086802;69.0;57.9
69;2021-08-08;4372;3566;1299163;1090368;69.2;58.1
69;2021-08-09;7779;9219;1306942;1099587;69.7;58.6
69;2021-08-10;8094;7042;1315036;1106629;70.1;59.0
69;2021-08-11;7900;8114;1322936;1114743;70.5;59.4
69;2021-08-12;7320;7334;1330256;1122077;70.9;59.8
69;2021-08-13;6758;8363;1337014;1130440;71.3;60.3
69;2021-08-14;4514;5213;1341528;1135653;71.5;60.5
69;2021-08-15;2491;2522;1344019;1138175;71.6;60.7
69;2021-08-16;5941;8882;1349960;1147057;72.0;61.1
69;2021-08-17;6419;8275;1356379;1155332;72.3;61.6
69;2021-08-18;6251;9472;1362630;1164804;72.6;62.1
69;2021-08-19;6338;9337;1368968;1174141;73.0;62.6
69;2021-08-20;6192;8846;1375160;1182987;73.3;63.1
69;2021-08-21;2863;3958;1378023;1186945;73.5;63.3
69;2021-08-22;1966;2420;1379989;1189365;73.6;63.4
69;2021-08-23;3949;12384;1383938;1201749;73.8;64.1
69;2021-08-24;5195;13645;1389133;1215394;74.0;64.8
69;2021-08-25;4555;12911;1393688;1228305;74.3;65.5
69;2021-08-26;4562;11737;1398250;1240042;74.5;66.1
69;2021-08-27;4310;14451;1402560;1254493;74.8;66.9
69;2021-08-28;1968;8635;1404528;1263128;74.9;67.3
69;2021-08-29;1339;6527;1405867;1269655;74.9;67.7
69;2021-08-30;3261;11733;1409128;1281388;75.1;68.3
69;2021-08-31;4203;9999;1413331;1291387;75.3;68.8
69;2021-09-01;5324;9454;1418655;1300841;75.6;69.3
69;2021-09-02;4536;8373;1423191;1309214;75.9;69.8
69;2021-09-03;4787;10435;1427978;1319649;76.1;70.3
69;2021-09-04;3013;8537;1430991;1328186;76.3;70.8
69;2021-09-05;1434;3618;1432425;1331804;76.4;71.0
69;2021-09-06;2831;6132;1435256;1337936;76.5;71.3
69;2021-09-07;2445;6056;1437701;1343992;76.6;71.6
69;2021-09-08;2835;6822;1440536;1350814;76.8;72.0
69;2021-09-09;2472;5811;1443008;1356625;76.9;72.3
69;2021-09-10;2840;6657;1445848;1363282;77.1;72.7
69;2021-09-11;1806;5066;1447654;1368348;77.2;72.9
69;2021-09-12;538;2224;1448192;1370572;77.2;73.1
69;2021-09-13;2078;4554;1450270;1375126;77.3;73.3
69;2021-09-14;1890;4225;1452160;1379351;77.4;73.5
69;2021-09-15;1959;5053;1454119;1384404;77.5;73.8
69;2021-09-16;1723;3501;1455842;1387905;77.6;74.0
69;2021-09-17;1855;4891;1457697;1392796;77.7;74.2
69;2021-09-18;1213;4091;1458910;1396887;77.8;74.5
69;2021-09-19;510;1523;1459420;1398410;77.8;74.5
69;2021-09-20;1034;2995;1460454;1401405;77.8;74.7
69;2021-09-21;982;3514;1461436;1404919;77.9;74.9
69;2021-09-22;1209;4071;1462645;1408990;78.0;75.1
69;2021-09-23;917;3078;1463562;1412068;78.0;75.3
69;2021-09-24;1280;4188;1464842;1416256;78.1;75.5
69;2021-09-25;730;2737;1465572;1418993;78.1;75.6
69;2021-09-26;297;1211;1465869;1420204;78.1;75.7
69;2021-09-27;666;2048;1466535;1422252;78.2;75.8
69;2021-09-28;928;2114;1467463;1424366;78.2;75.9
69;2021-09-29;1149;3299;1468612;1427665;78.3;76.1
69;2021-09-30;942;2366;1469554;1430031;78.3;76.2
69;2021-10-01;1528;3559;1471082;1433590;78.4;76.4
69;2021-10-02;946;2269;1472028;1435859;78.5;76.5
69;2021-10-03;317;649;1472345;1436508;78.5;76.6
69;2021-10-04;786;2018;1473131;1438526;78.5;76.7
69;2021-10-05;777;1831;1473908;1440357;78.6;76.8
69;2021-10-06;1108;2423;1475016;1442780;78.6;76.9
69;2021-10-07;890;1813;1475906;1444593;78.7;77.0
69;2021-10-08;1253;3021;1477159;1447614;78.7;77.2
69;2021-10-09;740;1566;1477899;1449180;78.8;77.2
69;2021-10-10;60;412;1477959;1449592;78.8;77.3
69;2021-10-11;588;1778;1478547;1451370;78.8;77.4
69;2021-10-12;833;1318;1479380;1452688;78.9;77.4
69;2021-10-13;1132;2091;1480512;1454779;78.9;77.5
69;2021-10-14;822;1669;1481334;1456448;79.0;77.6
69;2021-10-15;1197;2276;1482531;1458724;79.0;77.8
69;2021-10-16;785;1465;1483316;1460189;79.1;77.8
69;2021-10-17;26;297;1483342;1460486;79.1;77.8
69;2021-10-18;578;1262;1483920;1461748;79.1;77.9
69;2021-10-19;589;1329;1484509;1463077;79.1;78.0
70;2020-12-27;0;0;0;0;0.0;0.0
70;2020-12-28;0;0;0;0;0.0;0.0
70;2020-12-29;0;0;0;0;0.0;0.0
70;2020-12-30;0;0;0;0;0.0;0.0
70;2020-12-31;0;0;0;0;0.0;0.0
70;2021-01-01;0;0;0;0;0.0;0.0
70;2021-01-02;0;0;0;0;0.0;0.0
70;2021-01-03;0;0;0;0;0.0;0.0
70;2021-01-04;0;0;0;0;0.0;0.0
70;2021-01-05;1;1;1;1;0.0;0.0
70;2021-01-06;24;0;25;1;0.0;0.0
70;2021-01-07;121;0;146;1;0.1;0.0
70;2021-01-08;22;0;168;1;0.1;0.0
70;2021-01-09;0;0;168;1;0.1;0.0
70;2021-01-10;0;0;168;1;0.1;0.0
70;2021-01-11;148;1;316;2;0.1;0.0
70;2021-01-12;201;1;517;3;0.2;0.0
70;2021-01-13;172;2;689;5;0.3;0.0
70;2021-01-14;148;6;837;11;0.4;0.0
70;2021-01-15;153;1;990;12;0.4;0.0
70;2021-01-16;65;0;1055;12;0.5;0.0
70;2021-01-17;0;0;1055;12;0.5;0.0
70;2021-01-18;399;0;1454;12;0.6;0.0
70;2021-01-19;503;2;1957;14;0.8;0.0
70;2021-01-20;494;2;2451;16;1.1;0.0
70;2021-01-21;675;3;3126;19;1.3;0.0
70;2021-01-22;458;3;3584;22;1.5;0.0
70;2021-01-23;261;2;3845;24;1.6;0.0
70;2021-01-24;4;0;3849;24;1.7;0.0
70;2021-01-25;370;1;4219;25;1.8;0.0
70;2021-01-26;335;1;4554;26;2.0;0.0
70;2021-01-27;332;12;4886;38;2.1;0.0
70;2021-01-28;366;36;5252;74;2.3;0.0
70;2021-01-29;329;52;5581;126;2.4;0.1
70;2021-01-30;228;1;5809;127;2.5;0.1
70;2021-01-31;0;0;5809;127;2.5;0.1
70;2021-02-01;262;52;6071;179;2.6;0.1
70;2021-02-02;272;98;6343;277;2.7;0.1
70;2021-02-03;250;61;6593;338;2.8;0.1
70;2021-02-04;264;125;6857;463;2.9;0.2
70;2021-02-05;254;75;7111;538;3.0;0.2
70;2021-02-06;209;38;7320;576;3.1;0.2
70;2021-02-07;0;0;7320;576;3.1;0.2
70;2021-02-08;179;233;7499;809;3.2;0.3
70;2021-02-09;205;229;7704;1038;3.3;0.4
70;2021-02-10;196;305;7900;1343;3.4;0.6
70;2021-02-11;351;338;8251;1681;3.5;0.7
70;2021-02-12;239;492;8490;2173;3.6;0.9
70;2021-02-13;75;210;8565;2383;3.7;1.0
70;2021-02-14;0;29;8565;2412;3.7;1.0
70;2021-02-15;69;339;8634;2751;3.7;1.2
70;2021-02-16;113;362;8747;3113;3.8;1.3
70;2021-02-17;165;302;8912;3415;3.8;1.5
70;2021-02-18;205;257;9117;3672;3.9;1.6
70;2021-02-19;197;204;9314;3876;4.0;1.7
70;2021-02-20;192;69;9506;3945;4.1;1.7
70;2021-02-21;1;0;9507;3945;4.1;1.7
70;2021-02-22;106;238;9613;4183;4.1;1.8
70;2021-02-23;125;261;9738;4444;4.2;1.9
70;2021-02-24;132;234;9870;4678;4.2;2.0
70;2021-02-25;315;259;10185;4937;4.4;2.1
70;2021-02-26;396;151;10581;5088;4.5;2.2
70;2021-02-27;147;202;10728;5290;4.6;2.3
70;2021-02-28;0;0;10728;5290;4.6;2.3
70;2021-03-01;248;243;10976;5533;4.7;2.4
70;2021-03-02;487;278;11463;5811;4.9;2.5
70;2021-03-03;468;260;11931;6071;5.1;2.6
70;2021-03-04;693;277;12624;6348;5.4;2.7
70;2021-03-05;767;262;13391;6610;5.7;2.8
70;2021-03-06;539;119;13930;6729;6.0;2.9
70;2021-03-07;217;23;14147;6752;6.1;2.9
70;2021-03-08;554;214;14701;6966;6.3;3.0
70;2021-03-09;864;176;15565;7142;6.7;3.1
70;2021-03-10;659;179;16224;7321;7.0;3.1
70;2021-03-11;698;256;16922;7577;7.3;3.2
70;2021-03-12;985;181;17907;7758;7.7;3.3
70;2021-03-13;582;125;18489;7883;7.9;3.4
70;2021-03-14;20;1;18509;7884;7.9;3.4
70;2021-03-15;774;112;19283;7996;8.3;3.4
70;2021-03-16;655;99;19938;8095;8.5;3.5
70;2021-03-17;595;183;20533;8278;8.8;3.5
70;2021-03-18;633;141;21166;8419;9.1;3.6
70;2021-03-19;1019;143;22185;8562;9.5;3.7
70;2021-03-20;641;186;22826;8748;9.8;3.8
70;2021-03-21;9;0;22835;8748;9.8;3.8
70;2021-03-22;757;101;23592;8849;10.1;3.8
70;2021-03-23;1310;165;24902;9014;10.7;3.9
70;2021-03-24;1270;111;26172;9125;11.2;3.9
70;2021-03-25;1247;201;27419;9326;11.8;4.0
70;2021-03-26;1485;304;28904;9630;12.4;4.1
70;2021-03-27;956;129;29860;9759;12.8;4.2
70;2021-03-28;0;10;29860;9769;12.8;4.2
70;2021-03-29;722;417;30582;10186;13.1;4.4
70;2021-03-30;1093;317;31675;10503;13.6;4.5
70;2021-03-31;878;319;32553;10822;14.0;4.6
70;2021-04-01;1153;429;33706;11251;14.5;4.8
70;2021-04-02;1310;348;35016;11599;15.0;5.0
70;2021-04-03;641;323;35657;11922;15.3;5.1
70;2021-04-04;11;1;35668;11923;15.3;5.1
70;2021-04-05;4;2;35672;11925;15.3;5.1
70;2021-04-06;831;559;36503;12484;15.7;5.4
70;2021-04-07;858;590;37361;13074;16.0;5.6
70;2021-04-08;1319;567;38680;13641;16.6;5.8
70;2021-04-09;1402;542;40082;14183;17.2;6.1
70;2021-04-10;859;347;40941;14530;17.6;6.2
70;2021-04-11;23;1;40964;14531;17.6;6.2
70;2021-04-12;696;662;41660;15193;17.9;6.5
70;2021-04-13;921;770;42581;15963;18.3;6.8
70;2021-04-14;816;579;43397;16542;18.6;7.1
70;2021-04-15;1079;609;44476;17151;19.1;7.4
70;2021-04-16;1242;554;45718;17705;19.6;7.6
70;2021-04-17;688;469;46406;18174;19.9;7.8
70;2021-04-18;62;4;46468;18178;19.9;7.8
70;2021-04-19;540;810;47008;18988;20.2;8.1
70;2021-04-20;663;852;47671;19840;20.4;8.5
70;2021-04-21;483;932;48154;20772;20.6;8.9
70;2021-04-22;775;802;48929;21574;21.0;9.3
70;2021-04-23;876;744;49805;22318;21.4;9.6
70;2021-04-24;432;642;50237;22960;21.5;9.8
70;2021-04-25;11;0;50248;22960;21.5;9.8
70;2021-04-26;923;605;51171;23565;21.9;10.1
70;2021-04-27;1208;756;52379;24321;22.5;10.4
70;2021-04-28;889;812;53268;25133;22.8;10.8
70;2021-04-29;1341;934;54609;26067;23.4;11.2
70;2021-04-30;1533;876;56142;26943;24.1;11.6
70;2021-05-01;1694;121;57836;27064;24.8;11.6
70;2021-05-02;2;0;57838;27064;24.8;11.6
70;2021-05-03;1189;582;59027;27646;25.3;11.9
70;2021-05-04;1353;758;60380;28404;25.9;12.2
70;2021-05-05;1188;880;61568;29284;26.4;12.6
70;2021-05-06;1845;1271;63413;30555;27.2;13.1
70;2021-05-07;2126;1245;65539;31800;28.1;13.6
70;2021-05-08;1342;194;66881;31994;28.7;13.7
70;2021-05-09;9;58;66890;32052;28.7;13.7
70;2021-05-10;961;947;67851;32999;29.1;14.2
70;2021-05-11;1240;1081;69091;34080;29.6;14.6
70;2021-05-12;1175;867;70266;34947;30.1;15.0
70;2021-05-13;1544;147;71810;35094;30.8;15.0
70;2021-05-14;2062;757;73872;35851;31.7;15.4
70;2021-05-15;2656;531;76528;36382;32.8;15.6
70;2021-05-16;999;72;77527;36454;33.2;15.6
70;2021-05-17;1237;386;78764;36840;33.8;15.8
70;2021-05-18;1296;591;80060;37431;34.3;16.1
70;2021-05-19;1476;480;81536;37911;35.0;16.3
70;2021-05-20;1779;633;83315;38544;35.7;16.5
70;2021-05-21;1692;824;85007;39368;36.5;16.9
70;2021-05-22;1219;666;86226;40034;37.0;17.2
70;2021-05-23;9;15;86235;40049;37.0;17.2
70;2021-05-24;227;28;86462;40077;37.1;17.2
70;2021-05-25;837;926;87299;41003;37.4;17.6
70;2021-05-26;1049;946;88348;41949;37.9;18.0
70;2021-05-27;1263;998;89611;42947;38.4;18.4
70;2021-05-28;1546;1161;91157;44108;39.1;18.9
70;2021-05-29;1370;588;92527;44696;39.7;19.2
70;2021-05-30;1;8;92528;44704;39.7;19.2
70;2021-05-31;969;679;93497;45383;40.1;19.5
70;2021-06-01;1213;847;94710;46230;40.6;19.8
70;2021-06-02;1265;680;95975;46910;41.2;20.1
70;2021-06-03;1429;837;97404;47747;41.8;20.5
70;2021-06-04;1335;1111;98739;48858;42.3;21.0
70;2021-06-05;1024;663;99763;49521;42.8;21.2
70;2021-06-06;599;79;100362;49600;43.0;21.3
70;2021-06-07;940;847;101302;50447;43.4;21.6
70;2021-06-08;1216;1187;102518;51634;44.0;22.1
70;2021-06-09;1156;987;103674;52621;44.5;22.6
70;2021-06-10;1567;831;105241;53452;45.1;22.9
70;2021-06-11;1586;1959;106827;55411;45.8;23.8
70;2021-06-12;829;1970;107656;57381;46.2;24.6
70;2021-06-13;143;15;107799;57396;46.2;24.6
70;2021-06-14;559;1243;108358;58639;46.5;25.1
70;2021-06-15;451;1506;108809;60145;46.7;25.8
70;2021-06-16;798;1391;109607;61536;47.0;26.4
70;2021-06-17;1154;2098;110761;63634;47.5;27.3
70;2021-06-18;995;2254;111756;65888;47.9;28.3
70;2021-06-19;1092;1639;112848;67527;48.4;29.0
70;2021-06-20;1;3;112849;67530;48.4;29.0
70;2021-06-21;691;1453;113540;68983;48.7;29.6
70;2021-06-22;655;1513;114195;70496;49.0;30.2
70;2021-06-23;662;1569;114857;72065;49.3;30.9
70;2021-06-24;877;2049;115734;74114;49.6;31.8
70;2021-06-25;681;2649;116415;76763;49.9;32.9
70;2021-06-26;943;2136;117358;78899;50.3;33.8
70;2021-06-27;141;763;117499;79662;50.4;34.2
70;2021-06-28;335;1353;117834;81015;50.5;34.7
70;2021-06-29;411;1612;118245;82627;50.7;35.4
70;2021-06-30;390;1633;118635;84260;50.9;36.1
70;2021-07-01;642;1751;119277;86011;51.1;36.9
70;2021-07-02;815;1578;120092;87589;51.5;37.6
70;2021-07-03;841;1084;120933;88673;51.9;38.0
70;2021-07-04;29;70;120962;88743;51.9;38.1
70;2021-07-05;610;1037;121572;89780;52.1;38.5
70;2021-07-06;681;1274;122253;91054;52.4;39.0
70;2021-07-07;508;1425;122761;92479;52.6;39.7
70;2021-07-08;817;1574;123578;94053;53.0;40.3
70;2021-07-09;873;1662;124451;95715;53.4;41.0
70;2021-07-10;831;1033;125282;96748;53.7;41.5
70;2021-07-11;7;20;125289;96768;53.7;41.5
70;2021-07-12;432;1390;125721;98158;53.9;42.1
70;2021-07-13;907;1868;126628;100026;54.3;42.9
70;2021-07-14;33;6;126661;100032;54.3;42.9
70;2021-07-15;1382;1694;128043;101726;54.9;43.6
70;2021-07-16;1632;2061;129675;103787;55.6;44.5
70;2021-07-17;1501;1454;131176;105241;56.3;45.1
70;2021-07-18;1145;641;132321;105882;56.7;45.4
70;2021-07-19;884;976;133205;106858;57.1;45.8
70;2021-07-20;1349;1352;134554;108210;57.7;46.4
70;2021-07-21;1286;1402;135840;109612;58.3;47.0
70;2021-07-22;1867;1828;137707;111440;59.1;47.8
70;2021-07-23;1826;2491;139533;113931;59.8;48.9
70;2021-07-24;1364;1806;140897;115737;60.4;49.6
70;2021-07-25;27;3;140924;115740;60.4;49.6
70;2021-07-26;1055;975;141979;116715;60.9;50.1
70;2021-07-27;1398;976;143377;117691;61.5;50.5
70;2021-07-28;1404;1162;144781;118853;62.1;51.0
70;2021-07-29;1873;1388;146654;120241;62.9;51.6
70;2021-07-30;1975;1348;148629;121589;63.7;52.1
70;2021-07-31;1751;1166;150380;122755;64.5;52.6
70;2021-08-01;2;4;150382;122759;64.5;52.6
70;2021-08-02;776;736;151158;123495;64.8;53.0
70;2021-08-03;1296;1039;152454;124534;65.4;53.4
70;2021-08-04;1210;922;153664;125456;65.9;53.8
70;2021-08-05;1657;1191;155321;126647;66.6;54.3
70;2021-08-06;1795;1336;157116;127983;67.4;54.9
70;2021-08-07;1192;1032;158308;129015;67.9;55.3
70;2021-08-08;35;28;158343;129043;67.9;55.3
70;2021-08-09;534;704;158877;129747;68.1;55.6
70;2021-08-10;898;1130;159775;130877;68.5;56.1
70;2021-08-11;808;722;160583;131599;68.9;56.4
70;2021-08-12;906;1272;161489;132871;69.3;57.0
70;2021-08-13;1040;1621;162529;134492;69.7;57.7
70;2021-08-14;771;977;163300;135469;70.0;58.1
70;2021-08-15;36;28;163336;135497;70.0;58.1
70;2021-08-16;545;910;163881;136407;70.3;58.5
70;2021-08-17;680;1194;164561;137601;70.6;59.0
70;2021-08-18;535;940;165096;138541;70.8;59.4
70;2021-08-19;564;1385;165660;139926;71.0;60.0
70;2021-08-20;510;1900;166170;141826;71.3;60.8
70;2021-08-21;447;1163;166617;142989;71.4;61.3
70;2021-08-22;2;6;166619;142995;71.5;61.3
70;2021-08-23;282;879;166901;143874;71.6;61.7
70;2021-08-24;386;1373;167287;145247;71.7;62.3
70;2021-08-25;354;1344;167641;146591;71.9;62.9
70;2021-08-26;438;1560;168079;148151;72.1;63.5
70;2021-08-27;392;2127;168471;150278;72.2;64.4
70;2021-08-28;367;1706;168838;151984;72.4;65.2
70;2021-08-29;12;6;168850;151990;72.4;65.2
70;2021-08-30;298;831;169148;152821;72.5;65.5
70;2021-08-31;360;1121;169508;153942;72.7;66.0
70;2021-09-01;316;987;169824;154929;72.8;66.4
70;2021-09-02;306;1107;170130;156036;73.0;66.9
70;2021-09-03;280;1067;170410;157103;73.1;67.4
70;2021-09-04;456;1117;170866;158220;73.3;67.8
70;2021-09-05;21;22;170887;158242;73.3;67.9
70;2021-09-06;168;602;171055;158844;73.4;68.1
70;2021-09-07;186;746;171241;159590;73.4;68.4
70;2021-09-08;193;778;171434;160368;73.5;68.8
70;2021-09-09;182;734;171616;161102;73.6;69.1
70;2021-09-10;256;799;171872;161901;73.7;69.4
70;2021-09-11;300;891;172172;162792;73.8;69.8
70;2021-09-12;7;30;172179;162822;73.8;69.8
70;2021-09-13;155;354;172334;163176;73.9;70.0
70;2021-09-14;318;423;172652;163599;74.0;70.2
70;2021-09-15;173;533;172825;164132;74.1;70.4
70;2021-09-16;252;392;173077;164524;74.2;70.6
70;2021-09-17;195;457;173272;164981;74.3;70.7
70;2021-09-18;177;459;173449;165440;74.4;70.9
70;2021-09-19;3;14;173452;165454;74.4;71.0
70;2021-09-20;82;215;173534;165669;74.4;71.0
70;2021-09-21;163;280;173697;165949;74.5;71.2
70;2021-09-22;116;384;173813;166333;74.5;71.3
70;2021-09-23;66;229;173879;166562;74.6;71.4
70;2021-09-24;196;390;174075;166952;74.6;71.6
70;2021-09-25;139;504;174214;167456;74.7;71.8
70;2021-09-26;0;1;174214;167457;74.7;71.8
70;2021-09-27;52;201;174266;167658;74.7;71.9
70;2021-09-28;77;195;174343;167853;74.8;72.0
70;2021-09-29;91;240;174434;168093;74.8;72.1
70;2021-09-30;81;158;174515;168251;74.8;72.2
70;2021-10-01;122;250;174637;168501;74.9;72.3
70;2021-10-02;115;326;174752;168827;74.9;72.4
70;2021-10-03;1;1;174753;168828;74.9;72.4
70;2021-10-04;73;169;174826;168997;75.0;72.5
70;2021-10-05;82;289;174908;169286;75.0;72.6
70;2021-10-06;129;213;175037;169499;75.1;72.7
70;2021-10-07;99;225;175136;169724;75.1;72.8
70;2021-10-08;115;222;175251;169946;75.2;72.9
70;2021-10-09;137;303;175388;170249;75.2;73.0
70;2021-10-10;1;5;175389;170254;75.2;73.0
70;2021-10-11;50;109;175439;170363;75.2;73.1
70;2021-10-12;53;122;175492;170485;75.3;73.1
70;2021-10-13;84;189;175576;170674;75.3;73.2
70;2021-10-14;49;112;175625;170786;75.3;73.2
70;2021-10-15;151;198;175776;170984;75.4;73.3
70;2021-10-16;124;164;175900;171148;75.4;73.4
70;2021-10-17;2;8;175902;171156;75.4;73.4
70;2021-10-18;45;91;175947;171247;75.5;73.4
70;2021-10-19;76;82;176023;171329;75.5;73.5
71;2020-12-27;0;0;0;0;0.0;0.0
71;2020-12-28;1;0;1;0;0.0;0.0
71;2020-12-29;0;0;1;0;0.0;0.0
71;2020-12-30;0;0;1;0;0.0;0.0
71;2020-12-31;0;0;1;0;0.0;0.0
71;2021-01-01;1;0;2;0;0.0;0.0
71;2021-01-02;0;0;2;0;0.0;0.0
71;2021-01-03;2;1;4;1;0.0;0.0
71;2021-01-04;1;0;5;1;0.0;0.0
71;2021-01-05;13;0;18;1;0.0;0.0
71;2021-01-06;72;0;90;1;0.0;0.0
71;2021-01-07;67;2;157;3;0.0;0.0
71;2021-01-08;146;0;303;3;0.1;0.0
71;2021-01-09;117;0;420;3;0.1;0.0
71;2021-01-10;1;0;421;3;0.1;0.0
71;2021-01-11;245;1;666;4;0.1;0.0
71;2021-01-12;845;1;1511;5;0.3;0.0
71;2021-01-13;564;2;2075;7;0.4;0.0
71;2021-01-14;591;12;2666;19;0.5;0.0
71;2021-01-15;665;2;3331;21;0.6;0.0
71;2021-01-16;10;0;3341;21;0.6;0.0
71;2021-01-17;0;0;3341;21;0.6;0.0
71;2021-01-18;1095;8;4436;29;0.8;0.0
71;2021-01-19;1694;8;6130;37;1.1;0.0
71;2021-01-20;1517;7;7647;44;1.4;0.0
71;2021-01-21;2062;20;9709;64;1.8;0.0
71;2021-01-22;1414;6;11123;70;2.0;0.0
71;2021-01-23;816;6;11939;76;2.2;0.0
71;2021-01-24;1;1;11940;77;2.2;0.0
71;2021-01-25;1065;6;13005;83;2.4;0.0
71;2021-01-26;1505;29;14510;112;2.6;0.0
71;2021-01-27;1249;34;15759;146;2.9;0.0
71;2021-01-28;1082;99;16841;245;3.1;0.0
71;2021-01-29;1015;142;17856;387;3.3;0.1
71;2021-01-30;603;2;18459;389;3.4;0.1
71;2021-01-31;1;15;18460;404;3.4;0.1
71;2021-02-01;752;238;19212;642;3.5;0.1
71;2021-02-02;755;356;19967;998;3.6;0.2
71;2021-02-03;817;422;20784;1420;3.8;0.3
71;2021-02-04;784;573;21568;1993;3.9;0.4
71;2021-02-05;704;522;22272;2515;4.1;0.5
71;2021-02-06;539;10;22811;2525;4.2;0.5
71;2021-02-07;4;50;22815;2575;4.2;0.5
71;2021-02-08;603;696;23418;3271;4.3;0.6
71;2021-02-09;371;1009;23789;4280;4.3;0.8
71;2021-02-10;412;992;24201;5272;4.4;1.0
71;2021-02-11;477;1181;24678;6453;4.5;1.2
71;2021-02-12;535;1037;25213;7490;4.6;1.4
71;2021-02-13;124;501;25337;7991;4.6;1.5
71;2021-02-14;2;7;25339;7998;4.6;1.5
71;2021-02-15;322;908;25661;8906;4.7;1.6
71;2021-02-16;445;1353;26106;10259;4.8;1.9
71;2021-02-17;428;1128;26534;11387;4.8;2.1
71;2021-02-18;548;931;27082;12318;4.9;2.2
71;2021-02-19;571;843;27653;13161;5.0;2.4
71;2021-02-20;224;382;27877;13543;5.1;2.5
71;2021-02-21;4;13;27881;13556;5.1;2.5
71;2021-02-22;238;871;28119;14427;5.1;2.6
71;2021-02-23;452;929;28571;15356;5.2;2.8
71;2021-02-24;446;719;29017;16075;5.3;2.9
71;2021-02-25;533;723;29550;16798;5.4;3.1
71;2021-02-26;832;538;30382;17336;5.5;3.2
71;2021-02-27;456;335;30838;17671;5.6;3.2
71;2021-02-28;54;14;30892;17685;5.6;3.2
71;2021-03-01;1188;683;32080;18368;5.9;3.4
71;2021-03-02;1575;650;33655;19018;6.1;3.5
71;2021-03-03;1820;776;35475;19794;6.5;3.6
71;2021-03-04;2003;829;37478;20623;6.8;3.8
71;2021-03-05;2286;699;39764;21322;7.3;3.9
71;2021-03-06;754;66;40518;21388;7.4;3.9
71;2021-03-07;40;21;40558;21409;7.4;3.9
71;2021-03-08;1453;790;42011;22199;7.7;4.1
71;2021-03-09;2162;536;44173;22735;8.1;4.2
71;2021-03-10;2174;482;46347;23217;8.5;4.2
71;2021-03-11;2631;677;48978;23894;8.9;4.4
71;2021-03-12;2603;632;51581;24526;9.4;4.5
71;2021-03-13;995;102;52576;24628;9.6;4.5
71;2021-03-14;36;0;52612;24628;9.6;4.5
71;2021-03-15;1797;501;54409;25129;9.9;4.6
71;2021-03-16;1820;205;56229;25334;10.3;4.6
71;2021-03-17;2135;257;58364;25591;10.7;4.7
71;2021-03-18;1954;441;60318;26032;11.0;4.8
71;2021-03-19;2370;342;62688;26374;11.4;4.8
71;2021-03-20;1084;42;63772;26416;11.6;4.8
71;2021-03-21;17;5;63789;26421;11.6;4.8
71;2021-03-22;2574;384;66363;26805;12.1;4.9
71;2021-03-23;3349;509;69712;27314;12.7;5.0
71;2021-03-24;3347;471;73059;27785;13.3;5.1
71;2021-03-25;4029;606;77088;28391;14.1;5.2
71;2021-03-26;4057;348;81145;28739;14.8;5.2
71;2021-03-27;997;108;82142;28847;15.0;5.3
71;2021-03-28;57;8;82199;28855;15.0;5.3
71;2021-03-29;2408;1176;84607;30031;15.4;5.5
71;2021-03-30;2948;1360;87555;31391;16.0;5.7
71;2021-03-31;2544;1535;90099;32926;16.4;6.0
71;2021-04-01;2718;1305;92817;34231;16.9;6.2
71;2021-04-02;2502;1423;95319;35654;17.4;6.5
71;2021-04-03;268;34;95587;35688;17.4;6.5
71;2021-04-04;6;0;95593;35688;17.4;6.5
71;2021-04-05;61;2;95654;35690;17.5;6.5
71;2021-04-06;2257;1882;97911;37572;17.9;6.9
71;2021-04-07;2387;1797;100298;39369;18.3;7.2
71;2021-04-08;3281;1814;103579;41183;18.9;7.5
71;2021-04-09;4041;1678;107620;42861;19.6;7.8
71;2021-04-10;769;49;108389;42910;19.8;7.8
71;2021-04-11;97;4;108486;42914;19.8;7.8
71;2021-04-12;2352;1705;110838;44619;20.2;8.1
71;2021-04-13;2583;1893;113421;46512;20.7;8.5
71;2021-04-14;2376;1929;115797;48441;21.1;8.8
71;2021-04-15;2780;1696;118577;50137;21.6;9.2
71;2021-04-16;2628;1647;121205;51784;22.1;9.5
71;2021-04-17;952;347;122157;52131;22.3;9.5
71;2021-04-18;106;6;122263;52137;22.3;9.5
71;2021-04-19;1759;2573;124022;54710;22.6;10.0
71;2021-04-20;2220;2604;126242;57314;23.0;10.5
71;2021-04-21;2123;2594;128365;59908;23.4;10.9
71;2021-04-22;2512;2450;130877;62358;23.9;11.4
71;2021-04-23;2922;2271;133799;64629;24.4;11.8
71;2021-04-24;517;52;134316;64681;24.5;11.8
71;2021-04-25;26;0;134342;64681;24.5;11.8
71;2021-04-26;2565;2139;136907;66820;25.0;12.2
71;2021-04-27;2990;2273;139897;69093;25.5;12.6
71;2021-04-28;3073;2129;142970;71222;26.1;13.0
71;2021-04-29;3780;2234;146750;73456;26.8;13.4
71;2021-04-30;3926;1730;150676;75186;27.5;13.7
71;2021-05-01;39;53;150715;75239;27.5;13.7
71;2021-05-02;23;18;150738;75257;27.5;13.7
71;2021-05-03;4290;1385;155028;76642;28.3;14.0
71;2021-05-04;2955;2361;157983;79003;28.8;14.4
71;2021-05-05;3426;2088;161409;81091;29.5;14.8
71;2021-05-06;3467;2373;164876;83464;30.1;15.2
71;2021-05-07;3678;2813;168554;86277;30.8;15.7
71;2021-05-08;179;183;168733;86460;30.8;15.8
71;2021-05-09;44;47;168777;86507;30.8;15.8
71;2021-05-10;3696;2293;172473;88800;31.5;16.2
71;2021-05-11;4663;2360;177136;91160;32.3;16.6
71;2021-05-12;3978;2602;181114;93762;33.1;17.1
71;2021-05-13;1576;155;182690;93917;33.3;17.1
71;2021-05-14;3766;2197;186456;96114;34.0;17.5
71;2021-05-15;243;331;186699;96445;34.1;17.6
71;2021-05-16;2;0;186701;96445;34.1;17.6
71;2021-05-17;3864;1887;190565;98332;34.8;17.9
71;2021-05-18;3498;2429;194063;100761;35.4;18.4
71;2021-05-19;3719;2279;197782;103040;36.1;18.8
71;2021-05-20;4184;2300;201966;105340;36.9;19.2
71;2021-05-21;3722;2567;205688;107907;37.5;19.7
71;2021-05-22;169;304;205857;108211;37.6;19.8
71;2021-05-23;14;55;205871;108266;37.6;19.8
71;2021-05-24;21;96;205892;108362;37.6;19.8
71;2021-05-25;2689;3004;208581;111366;38.1;20.3
71;2021-05-26;2971;2434;211552;113800;38.6;20.8
71;2021-05-27;3387;2590;214939;116390;39.2;21.2
71;2021-05-28;2919;3160;217858;119550;39.8;21.8
71;2021-05-29;482;659;218340;120209;39.9;21.9
71;2021-05-30;76;58;218416;120267;39.9;22.0
71;2021-05-31;2774;3455;221190;123722;40.4;22.6
71;2021-06-01;3671;3543;224861;127265;41.0;23.2
71;2021-06-02;3997;2635;228858;129900;41.8;23.7
71;2021-06-03;4435;2524;233293;132424;42.6;24.2
71;2021-06-04;3716;3715;237009;136139;43.3;24.9
71;2021-06-05;684;647;237693;136786;43.4;25.0
71;2021-06-06;57;91;237750;136877;43.4;25.0
71;2021-06-07;3281;4150;241031;141027;44.0;25.7
71;2021-06-08;3894;4009;244925;145036;44.7;26.5
71;2021-06-09;4695;2753;249620;147789;45.6;27.0
71;2021-06-10;5265;2748;254885;150537;46.5;27.5
71;2021-06-11;4435;3723;259320;154260;47.3;28.2
71;2021-06-12;715;595;260035;154855;47.5;28.3
71;2021-06-13;104;187;260139;155042;47.5;28.3
71;2021-06-14;3511;3787;263650;158829;48.1;29.0
71;2021-06-15;4205;3555;267855;162384;48.9;29.6
71;2021-06-16;4595;2731;272450;165115;49.7;30.1
71;2021-06-17;4267;3001;276717;168116;50.5;30.7
71;2021-06-18;4325;3769;281042;171885;51.3;31.4
71;2021-06-19;1269;654;282311;172539;51.5;31.5
71;2021-06-20;37;27;282348;172566;51.5;31.5
71;2021-06-21;2271;4277;284619;176843;52.0;32.3
71;2021-06-22;2689;4356;287308;181199;52.4;33.1
71;2021-06-23;3061;3421;290369;184620;53.0;33.7
71;2021-06-24;3328;3023;293697;187643;53.6;34.3
71;2021-06-25;2652;4473;296349;192116;54.1;35.1
71;2021-06-26;372;551;296721;192667;54.2;35.2
71;2021-06-27;29;67;296750;192734;54.2;35.2
71;2021-06-28;1535;4624;298285;197358;54.4;36.0
71;2021-06-29;1992;4823;300277;202181;54.8;36.9
71;2021-06-30;2504;3937;302781;206118;55.3;37.6
71;2021-07-01;2826;3899;305607;210017;55.8;38.3
71;2021-07-02;3032;3987;308639;214004;56.3;39.1
71;2021-07-03;319;712;308958;214716;56.4;39.2
71;2021-07-04;28;132;308986;214848;56.4;39.2
71;2021-07-05;2474;4322;311460;219170;56.9;40.0
71;2021-07-06;2462;4562;313922;223732;57.3;40.8
71;2021-07-07;2983;3724;316905;227456;57.8;41.5
71;2021-07-08;2765;4111;319670;231567;58.4;42.3
71;2021-07-09;2383;5023;322053;236590;58.8;43.2
71;2021-07-10;212;656;322265;237246;58.8;43.3
71;2021-07-11;15;65;322280;237311;58.8;43.3
71;2021-07-12;1911;5304;324191;242615;59.2;44.3
71;2021-07-13;2537;5863;326728;248478;59.6;45.4
71;2021-07-14;950;401;327678;248879;59.8;45.4
71;2021-07-15;3025;5735;330703;254614;60.4;46.5
71;2021-07-16;3294;6009;333997;260623;61.0;47.6
71;2021-07-17;505;781;334502;261404;61.1;47.7
71;2021-07-18;89;93;334591;261497;61.1;47.7
71;2021-07-19;2866;5554;337457;267051;61.6;48.7
71;2021-07-20;3367;5914;340824;272965;62.2;49.8
71;2021-07-21;3413;5472;344237;278437;62.8;50.8
71;2021-07-22;3945;5334;348182;283771;63.6;51.8
71;2021-07-23;3233;6002;351415;289773;64.1;52.9
71;2021-07-24;716;602;352131;290375;64.3;53.0
71;2021-07-25;148;82;352279;290457;64.3;53.0
71;2021-07-26;3596;4892;355875;295349;65.0;53.9
71;2021-07-27;4089;5123;359964;300472;65.7;54.8
71;2021-07-28;4248;4813;364212;305285;66.5;55.7
71;2021-07-29;4213;4645;368425;309930;67.3;56.6
71;2021-07-30;4245;4926;372670;314856;68.0;57.5
71;2021-07-31;722;723;373392;315579;68.2;57.6
71;2021-08-01;108;35;373500;315614;68.2;57.6
71;2021-08-02;3967;3760;377467;319374;68.9;58.3
71;2021-08-03;4408;3823;381875;323197;69.7;59.0
71;2021-08-04;4391;2986;386266;326183;70.5;59.5
71;2021-08-05;4189;3272;390455;329455;71.3;60.1
71;2021-08-06;3703;4017;394158;333472;71.9;60.9
71;2021-08-07;495;329;394653;333801;72.0;60.9
71;2021-08-08;51;65;394704;333866;72.0;60.9
71;2021-08-09;3045;3410;397749;337276;72.6;61.6
71;2021-08-10;3074;3389;400823;340665;73.2;62.2
71;2021-08-11;3186;3082;404009;343747;73.7;62.7
71;2021-08-12;3016;3106;407025;346853;74.3;63.3
71;2021-08-13;2691;3334;409716;350187;74.8;63.9
71;2021-08-14;282;518;409998;350705;74.8;64.0
71;2021-08-15;49;110;410047;350815;74.9;64.0
71;2021-08-16;1708;3528;411755;354343;75.2;64.7
71;2021-08-17;1739;3433;413494;357776;75.5;65.3
71;2021-08-18;1453;3160;414947;360936;75.7;65.9
71;2021-08-19;1277;3117;416224;364053;76.0;66.5
71;2021-08-20;1290;3699;417514;367752;76.2;67.1
71;2021-08-21;148;413;417662;368165;76.2;67.2
71;2021-08-22;42;99;417704;368264;76.2;67.2
71;2021-08-23;1427;4543;419131;372807;76.5;68.1
71;2021-08-24;1335;3804;420466;376611;76.8;68.7
71;2021-08-25;950;3773;421416;380384;76.9;69.4
71;2021-08-26;958;3393;422374;383777;77.1;70.1
71;2021-08-27;1151;4463;423525;388240;77.3;70.9
71;2021-08-28;195;413;423720;388653;77.3;70.9
71;2021-08-29;29;106;423749;388759;77.4;71.0
71;2021-08-30;1251;3880;425000;392639;77.6;71.7
71;2021-08-31;1022;3479;426022;396118;77.8;72.3
71;2021-09-01;933;3271;426955;399389;77.9;72.9
71;2021-09-02;602;2837;427557;402226;78.0;73.4
71;2021-09-03;837;3680;428394;405906;78.2;74.1
71;2021-09-04;268;530;428662;406436;78.2;74.2
71;2021-09-05;23;52;428685;406488;78.3;74.2
71;2021-09-06;638;2377;429323;408865;78.4;74.6
71;2021-09-07;517;1712;429840;410577;78.5;74.9
71;2021-09-08;720;2188;430560;412765;78.6;75.3
71;2021-09-09;456;1274;431016;414039;78.7;75.6
71;2021-09-10;819;2148;431835;416187;78.8;76.0
71;2021-09-11;199;266;432034;416453;78.9;76.0
71;2021-09-12;24;37;432058;416490;78.9;76.0
71;2021-09-13;643;1283;432701;417773;79.0;76.3
71;2021-09-14;487;1075;433188;418848;79.1;76.5
71;2021-09-15;605;1498;433793;420346;79.2;76.7
71;2021-09-16;447;824;434240;421170;79.3;76.9
71;2021-09-17;535;1437;434775;422607;79.4;77.1
71;2021-09-18;144;262;434919;422869;79.4;77.2
71;2021-09-19;9;28;434928;422897;79.4;77.2
71;2021-09-20;488;925;435416;423822;79.5;77.4
71;2021-09-21;294;711;435710;424533;79.5;77.5
71;2021-09-22;345;1377;436055;425910;79.6;77.7
71;2021-09-23;313;579;436368;426489;79.7;77.9
71;2021-09-24;369;1031;436737;427520;79.7;78.0
71;2021-09-25;71;176;436808;427696;79.7;78.1
71;2021-09-26;11;35;436819;427731;79.7;78.1
71;2021-09-27;287;757;437106;428488;79.8;78.2
71;2021-09-28;288;477;437394;428965;79.8;78.3
71;2021-09-29;332;740;437726;429705;79.9;78.4
71;2021-09-30;208;500;437934;430205;79.9;78.5
71;2021-10-01;332;894;438266;431099;80.0;78.7
71;2021-10-02;108;226;438374;431325;80.0;78.7
71;2021-10-03;3;7;438377;431332;80.0;78.7
71;2021-10-04;252;556;438629;431888;80.1;78.8
71;2021-10-05;195;392;438824;432280;80.1;78.9
71;2021-10-06;382;658;439206;432938;80.2;79.0
71;2021-10-07;147;349;439353;433287;80.2;79.1
71;2021-10-08;322;647;439675;433934;80.3;79.2
71;2021-10-09;59;163;439734;434097;80.3;79.2
71;2021-10-10;6;17;439740;434114;80.3;79.2
71;2021-10-11;253;518;439993;434632;80.3;79.3
71;2021-10-12;203;414;440196;435046;80.4;79.4
71;2021-10-13;296;470;440492;435516;80.4;79.5
71;2021-10-14;150;293;440642;435809;80.4;79.6
71;2021-10-15;268;552;440910;436361;80.5;79.7
71;2021-10-16;107;122;441017;436483;80.5;79.7
71;2021-10-17;3;14;441020;436497;80.5;79.7
71;2021-10-18;262;375;441282;436872;80.6;79.7
71;2021-10-19;171;288;441453;437160;80.6;79.8
72;2020-12-27;0;0;0;0;0.0;0.0
72;2020-12-28;0;0;0;0;0.0;0.0
72;2020-12-29;0;0;0;0;0.0;0.0
72;2020-12-30;0;0;0;0;0.0;0.0
72;2020-12-31;0;0;0;0;0.0;0.0
72;2021-01-01;2;0;2;0;0.0;0.0
72;2021-01-02;0;0;2;0;0.0;0.0
72;2021-01-03;0;0;2;0;0.0;0.0
72;2021-01-04;0;0;2;0;0.0;0.0
72;2021-01-05;14;0;16;0;0.0;0.0
72;2021-01-06;27;0;43;0;0.0;0.0
72;2021-01-07;110;1;153;1;0.0;0.0
72;2021-01-08;232;1;385;2;0.1;0.0
72;2021-01-09;36;0;421;2;0.1;0.0
72;2021-01-10;0;0;421;2;0.1;0.0
72;2021-01-11;485;1;906;3;0.2;0.0
72;2021-01-12;614;1;1520;4;0.3;0.0
72;2021-01-13;500;1;2020;5;0.4;0.0
72;2021-01-14;644;3;2664;8;0.5;0.0
72;2021-01-15;478;1;3142;9;0.6;0.0
72;2021-01-16;94;0;3236;9;0.6;0.0
72;2021-01-17;0;0;3236;9;0.6;0.0
72;2021-01-18;294;1;3530;10;0.6;0.0
72;2021-01-19;779;4;4309;14;0.8;0.0
72;2021-01-20;1539;6;5848;20;1.0;0.0
72;2021-01-21;1778;6;7626;26;1.4;0.0
72;2021-01-22;1149;6;8775;32;1.6;0.0
72;2021-01-23;32;0;8807;32;1.6;0.0
72;2021-01-24;0;0;8807;32;1.6;0.0
72;2021-01-25;503;7;9310;39;1.7;0.0
72;2021-01-26;1167;21;10477;60;1.9;0.0
72;2021-01-27;883;22;11360;82;2.0;0.0
72;2021-01-28;776;67;12136;149;2.2;0.0
72;2021-01-29;712;68;12848;217;2.3;0.0
72;2021-01-30;58;0;12906;217;2.3;0.0
72;2021-01-31;1;0;12907;217;2.3;0.0
72;2021-02-01;499;228;13406;445;2.4;0.1
72;2021-02-02;506;294;13912;739;2.5;0.1
72;2021-02-03;486;230;14398;969;2.6;0.2
72;2021-02-04;477;341;14875;1310;2.7;0.2
72;2021-02-05;514;407;15389;1717;2.7;0.3
72;2021-02-06;83;14;15472;1731;2.8;0.3
72;2021-02-07;19;3;15491;1734;2.8;0.3
72;2021-02-08;310;401;15801;2135;2.8;0.4
72;2021-02-09;488;530;16289;2665;2.9;0.5
72;2021-02-10;567;930;16856;3595;3.0;0.6
72;2021-02-11;860;1344;17716;4939;3.2;0.9
72;2021-02-12;851;594;18567;5533;3.3;1.0
72;2021-02-13;112;38;18679;5571;3.3;1.0
72;2021-02-14;1;22;18680;5593;3.3;1.0
72;2021-02-15;220;502;18900;6095;3.4;1.1
72;2021-02-16;503;1027;19403;7122;3.5;1.3
72;2021-02-17;463;715;19866;7837;3.5;1.4
72;2021-02-18;596;635;20462;8472;3.7;1.5
72;2021-02-19;521;598;20983;9070;3.7;1.6
72;2021-02-20;81;57;21064;9127;3.8;1.6
72;2021-02-21;0;0;21064;9127;3.8;1.6
72;2021-02-22;329;578;21393;9705;3.8;1.7
72;2021-02-23;569;530;21962;10235;3.9;1.8
72;2021-02-24;435;472;22397;10707;4.0;1.9
72;2021-02-25;922;564;23319;11271;4.2;2.0
72;2021-02-26;600;512;23919;11783;4.3;2.1
72;2021-02-27;322;67;24241;11850;4.3;2.1
72;2021-02-28;15;17;24256;11867;4.3;2.1
72;2021-03-01;379;480;24635;12347;4.4;2.2
72;2021-03-02;503;604;25138;12951;4.5;2.3
72;2021-03-03;733;656;25871;13607;4.6;2.4
72;2021-03-04;742;788;26613;14395;4.8;2.6
72;2021-03-05;935;772;27548;15167;4.9;2.7
72;2021-03-06;761;135;28309;15302;5.1;2.7
72;2021-03-07;448;26;28757;15328;5.1;2.7
72;2021-03-08;561;447;29318;15775;5.2;2.8
72;2021-03-09;1045;645;30363;16420;5.4;2.9
72;2021-03-10;1136;663;31499;17083;5.6;3.0
72;2021-03-11;1610;498;33109;17581;5.9;3.1
72;2021-03-12;1364;519;34473;18100;6.2;3.2
72;2021-03-13;983;122;35456;18222;6.3;3.3
72;2021-03-14;14;10;35470;18232;6.3;3.3
72;2021-03-15;1159;226;36629;18458;6.5;3.3
72;2021-03-16;1053;192;37682;18650;6.7;3.3
72;2021-03-17;1035;263;38717;18913;6.9;3.4
72;2021-03-18;1090;371;39807;19284;7.1;3.4
72;2021-03-19;1276;293;41083;19577;7.3;3.5
72;2021-03-20;488;93;41571;19670;7.4;3.5
72;2021-03-21;19;0;41590;19670;7.4;3.5
72;2021-03-22;1347;345;42937;20015;7.7;3.6
72;2021-03-23;1725;486;44662;20501;8.0;3.7
72;2021-03-24;1842;307;46504;20808;8.3;3.7
72;2021-03-25;2448;468;48952;21276;8.7;3.8
72;2021-03-26;2336;376;51288;21652;9.2;3.9
72;2021-03-27;616;31;51904;21683;9.3;3.9
72;2021-03-28;22;0;51926;21683;9.3;3.9
72;2021-03-29;1616;383;53542;22066;9.6;3.9
72;2021-03-30;2496;390;56038;22456;10.0;4.0
72;2021-03-31;2145;375;58183;22831;10.4;4.1
72;2021-04-01;2850;355;61033;23186;10.9;4.1
72;2021-04-02;2247;405;63280;23591;11.3;4.2
72;2021-04-03;292;39;63572;23630;11.3;4.2
72;2021-04-04;16;5;63588;23635;11.4;4.2
72;2021-04-05;52;49;63640;23684;11.4;4.2
72;2021-04-06;1759;472;65399;24156;11.7;4.3
72;2021-04-07;2575;603;67974;24759;12.1;4.4
72;2021-04-08;2721;785;70695;25544;12.6;4.6
72;2021-04-09;3863;591;74558;26135;13.3;4.7
72;2021-04-10;1112;54;75670;26189;13.5;4.7
72;2021-04-11;8;1;75678;26190;13.5;4.7
72;2021-04-12;1845;906;77523;27096;13.8;4.8
72;2021-04-13;2373;1082;79896;28178;14.3;5.0
72;2021-04-14;2250;1099;82146;29277;14.7;5.2
72;2021-04-15;2420;1120;84566;30397;15.1;5.4
72;2021-04-16;2563;970;87129;31367;15.6;5.6
72;2021-04-17;707;145;87836;31512;15.7;5.6
72;2021-04-18;57;2;87893;31514;15.7;5.6
72;2021-04-19;1396;1098;89289;32612;15.9;5.8
72;2021-04-20;2996;1309;92285;33921;16.5;6.1
72;2021-04-21;2515;1568;94800;35489;16.9;6.3
72;2021-04-22;2814;1794;97614;37283;17.4;6.7
72;2021-04-23;3213;1461;100827;38744;18.0;6.9
72;2021-04-24;1400;270;102227;39014;18.2;7.0
72;2021-04-25;881;18;103108;39032;18.4;7.0
72;2021-04-26;3513;1481;106621;40513;19.0;7.2
72;2021-04-27;4087;1866;110708;42379;19.8;7.6
72;2021-04-28;3835;1880;114543;44259;20.4;7.9
72;2021-04-29;4161;1821;118704;46080;21.2;8.2
72;2021-04-30;3615;1714;122319;47794;21.8;8.5
72;2021-05-01;1641;227;123960;48021;22.1;8.6
72;2021-05-02;1533;161;125493;48182;22.4;8.6
72;2021-05-03;3456;1155;128949;49337;23.0;8.8
72;2021-05-04;4012;1807;132961;51144;23.7;9.1
72;2021-05-05;3866;2182;136827;53326;24.4;9.5
72;2021-05-06;3595;1946;140422;55272;25.1;9.9
72;2021-05-07;3544;2149;143966;57421;25.7;10.2
72;2021-05-08;1900;155;145866;57576;26.0;10.3
72;2021-05-09;2080;213;147946;57789;26.4;10.3
72;2021-05-10;3769;1527;151715;59316;27.1;10.6
72;2021-05-11;4596;1997;156311;61313;27.9;10.9
72;2021-05-12;4080;1819;160391;63132;28.6;11.3
72;2021-05-13;3031;273;163422;63405;29.2;11.3
72;2021-05-14;3663;1400;167085;64805;29.8;11.6
72;2021-05-15;3117;365;170202;65170;30.4;11.6
72;2021-05-16;2500;152;172702;65322;30.8;11.7
72;2021-05-17;3722;1289;176424;66611;31.5;11.9
72;2021-05-18;4330;1691;180754;68302;32.3;12.2
72;2021-05-19;3973;1513;184727;69815;33.0;12.5
72;2021-05-20;4261;1455;188988;71270;33.7;12.7
72;2021-05-21;3788;1392;192776;72662;34.4;13.0
72;2021-05-22;2561;506;195337;73168;34.9;13.1
72;2021-05-23;1391;163;196728;73331;35.1;13.1
72;2021-05-24;2353;295;199081;73626;35.5;13.1
72;2021-05-25;4076;1412;203157;75038;36.3;13.4
72;2021-05-26;4096;1414;207253;76452;37.0;13.6
72;2021-05-27;4345;2049;211598;78501;37.8;14.0
72;2021-05-28;4105;2016;215703;80517;38.5;14.4
72;2021-05-29;2668;811;218371;81328;39.0;14.5
72;2021-05-30;1142;871;219513;82199;39.2;14.7
72;2021-05-31;3121;2331;222634;84530;39.7;15.1
72;2021-06-01;3570;2670;226204;87200;40.4;15.6
72;2021-06-02;3611;2785;229815;89985;41.0;16.1
72;2021-06-03;4242;2997;234057;92982;41.8;16.6
72;2021-06-04;3891;2752;237948;95734;42.5;17.1
72;2021-06-05;1440;2567;239388;98301;42.7;17.5
72;2021-06-06;911;1541;240299;99842;42.9;17.8
72;2021-06-07;1744;3424;242043;103266;43.2;18.4
72;2021-06-08;2930;3835;244973;107101;43.7;19.1
72;2021-06-09;2646;3372;247619;110473;44.2;19.7
72;2021-06-10;2825;3319;250444;113792;44.7;20.3
72;2021-06-11;2839;3775;253283;117567;45.2;21.0
72;2021-06-12;1242;2603;254525;120170;45.4;21.5
72;2021-06-13;388;1860;254913;122030;45.5;21.8
72;2021-06-14;1336;4127;256249;126157;45.7;22.5
72;2021-06-15;2751;3516;259000;129673;46.2;23.1
72;2021-06-16;2428;3581;261428;133254;46.7;23.8
72;2021-06-17;2318;3877;263746;137131;47.1;24.5
72;2021-06-18;2310;4317;266056;141448;47.5;25.2
72;2021-06-19;1128;2763;267184;144211;47.7;25.7
72;2021-06-20;339;2055;267523;146266;47.8;26.1
72;2021-06-21;1564;4034;269087;150300;48.0;26.8
72;2021-06-22;1715;4993;270802;155293;48.3;27.7
72;2021-06-23;2008;4223;272810;159516;48.7;28.5
72;2021-06-24;2233;4013;275043;163529;49.1;29.2
72;2021-06-25;1774;4836;276817;168365;49.4;30.1
72;2021-06-26;1190;2876;278007;171241;49.6;30.6
72;2021-06-27;392;2111;278399;173352;49.7;30.9
72;2021-06-28;1439;4292;279838;177644;50.0;31.7
72;2021-06-29;1770;4741;281608;182385;50.3;32.6
72;2021-06-30;1980;4169;283588;186554;50.6;33.3
72;2021-07-01;1954;4417;285542;190971;51.0;34.1
72;2021-07-02;1853;4714;287395;195685;51.3;34.9
72;2021-07-03;1292;3124;288687;198809;51.5;35.5
72;2021-07-04;579;1947;289266;200756;51.6;35.8
72;2021-07-05;1193;4164;290459;204920;51.8;36.6
72;2021-07-06;1458;5160;291917;210080;52.1;37.5
72;2021-07-07;1582;4609;293499;214689;52.4;38.3
72;2021-07-08;1648;4326;295147;219015;52.7;39.1
72;2021-07-09;2107;4604;297254;223619;53.1;39.9
72;2021-07-10;1589;2691;298843;226310;53.3;40.4
72;2021-07-11;947;1587;299790;227897;53.5;40.7
72;2021-07-12;1592;3757;301382;231654;53.8;41.4
72;2021-07-13;2091;4774;303473;236428;54.2;42.2
72;2021-07-14;1325;2365;304798;238793;54.4;42.6
72;2021-07-15;3485;3423;308283;242216;55.0;43.2
72;2021-07-16;3175;4123;311458;246339;55.6;44.0
72;2021-07-17;2647;1760;314105;248099;56.1;44.3
72;2021-07-18;1710;824;315815;248923;56.4;44.4
72;2021-07-19;2919;3508;318734;252431;56.9;45.1
72;2021-07-20;3040;4285;321774;256716;57.4;45.8
72;2021-07-21;2885;3589;324659;260305;58.0;46.5
72;2021-07-22;3771;2918;328430;263223;58.6;47.0
72;2021-07-23;3478;3791;331908;267014;59.2;47.7
72;2021-07-24;2820;1462;334728;268476;59.7;47.9
72;2021-07-25;1453;1081;336181;269557;60.0;48.1
72;2021-07-26;2726;2918;338907;272475;60.5;48.6
72;2021-07-27;3860;3820;342767;276295;61.2;49.3
72;2021-07-28;3571;3122;346338;279417;61.8;49.9
72;2021-07-29;3572;2712;349910;282129;62.5;50.4
72;2021-07-30;3788;3384;353698;285513;63.1;51.0
72;2021-07-31;2546;1750;356244;287263;63.6;51.3
72;2021-08-01;1835;432;358079;287695;63.9;51.4
72;2021-08-02;3215;2285;361294;289980;64.5;51.8
72;2021-08-03;3236;3297;364530;293277;65.1;52.3
72;2021-08-04;3769;2555;368299;295832;65.7;52.8
72;2021-08-05;3770;2460;372069;298292;66.4;53.2
72;2021-08-06;3342;2695;375411;300987;67.0;53.7
72;2021-08-07;2347;1613;377758;302600;67.4;54.0
72;2021-08-08;1623;702;379381;303302;67.7;54.1
72;2021-08-09;2699;2670;382080;305972;68.2;54.6
72;2021-08-10;2915;2748;384995;308720;68.7;55.1
72;2021-08-11;2368;2204;387363;310924;69.1;55.5
72;2021-08-12;2381;2597;389744;313521;69.6;56.0
72;2021-08-13;2159;2294;391903;315815;70.0;56.4
72;2021-08-14;1167;1546;393070;317361;70.2;56.6
72;2021-08-15;623;614;393693;317975;70.3;56.8
72;2021-08-16;1649;2372;395342;320347;70.6;57.2
72;2021-08-17;1717;2889;397059;323236;70.9;57.7
72;2021-08-18;1709;2872;398768;326108;71.2;58.2
72;2021-08-19;1246;2914;400014;329022;71.4;58.7
72;2021-08-20;1656;3171;401670;332193;71.7;59.3
72;2021-08-21;699;2031;402369;334224;71.8;59.7
72;2021-08-22;261;1150;402630;335374;71.9;59.9
72;2021-08-23;1739;3422;404369;338796;72.2;60.5
72;2021-08-24;1532;4122;405901;342918;72.5;61.2
72;2021-08-25;1602;3453;407503;346371;72.7;61.8
72;2021-08-26;1265;4443;408768;350814;73.0;62.6
72;2021-08-27;1193;4114;409961;354928;73.2;63.4
72;2021-08-28;881;2657;410842;357585;73.3;63.8
72;2021-08-29;357;1683;411199;359268;73.4;64.1
72;2021-08-30;1130;3407;412329;362675;73.6;64.7
72;2021-08-31;1219;3910;413548;366585;73.8;65.4
72;2021-09-01;1070;3162;414618;369747;74.0;66.0
72;2021-09-02;901;3231;415519;372978;74.2;66.6
72;2021-09-03;928;3062;416447;376040;74.3;67.1
72;2021-09-04;702;2554;417149;378594;74.5;67.6
72;2021-09-05;256;1498;417405;380092;74.5;67.8
72;2021-09-06;585;2506;417990;382598;74.6;68.3
72;2021-09-07;507;2582;418497;385180;74.7;68.8
72;2021-09-08;617;2889;419114;388069;74.8;69.3
72;2021-09-09;396;1771;419510;389840;74.9;69.6
72;2021-09-10;626;2394;420136;392234;75.0;70.0
72;2021-09-11;405;2636;420541;394870;75.1;70.5
72;2021-09-12;170;923;420711;395793;75.1;70.6
72;2021-09-13;369;1301;421080;397094;75.2;70.9
72;2021-09-14;489;1224;421569;398318;75.2;71.1
72;2021-09-15;616;1994;422185;400312;75.4;71.5
72;2021-09-16;337;833;422522;401145;75.4;71.6
72;2021-09-17;443;1423;422965;402568;75.5;71.9
72;2021-09-18;355;1520;423320;404088;75.6;72.1
72;2021-09-19;89;359;423409;404447;75.6;72.2
72;2021-09-20;350;793;423759;405240;75.6;72.3
72;2021-09-21;318;787;424077;406027;75.7;72.5
72;2021-09-22;442;1526;424519;407553;75.8;72.7
72;2021-09-23;397;630;424916;408183;75.8;72.9
72;2021-09-24;605;1006;425521;409189;76.0;73.0
72;2021-09-25;259;1005;425780;410194;76.0;73.2
72;2021-09-26;73;216;425853;410410;76.0;73.3
72;2021-09-27;210;640;426063;411050;76.1;73.4
72;2021-09-28;206;431;426269;411481;76.1;73.4
72;2021-09-29;360;1013;426629;412494;76.2;73.6
72;2021-09-30;164;331;426793;412825;76.2;73.7
72;2021-10-01;288;707;427081;413532;76.2;73.8
72;2021-10-02;311;581;427392;414113;76.3;73.9
72;2021-10-03;91;161;427483;414274;76.3;73.9
72;2021-10-04;178;410;427661;414684;76.3;74.0
72;2021-10-05;268;331;427929;415015;76.4;74.1
72;2021-10-06;257;560;428186;415575;76.4;74.2
72;2021-10-07;220;354;428406;415929;76.5;74.2
72;2021-10-08;327;648;428733;416577;76.5;74.4
72;2021-10-09;217;438;428950;417015;76.6;74.4
72;2021-10-10;84;118;429034;417133;76.6;74.5
72;2021-10-11;172;260;429206;417393;76.6;74.5
72;2021-10-12;214;361;429420;417754;76.7;74.6
72;2021-10-13;262;460;429682;418214;76.7;74.7
72;2021-10-14;139;288;429821;418502;76.7;74.7
72;2021-10-15;305;419;430126;418921;76.8;74.8
72;2021-10-16;202;298;430328;419219;76.8;74.8
72;2021-10-17;51;94;430379;419313;76.8;74.8
72;2021-10-18;190;355;430569;419668;76.9;74.9
72;2021-10-19;181;257;430750;419925;76.9;75.0
73;2020-12-27;1;1;1;1;0.0;0.0
73;2020-12-28;1;0;2;1;0.0;0.0
73;2020-12-29;0;0;2;1;0.0;0.0
73;2020-12-30;0;0;2;1;0.0;0.0
73;2020-12-31;0;0;2;1;0.0;0.0
73;2021-01-01;0;0;2;1;0.0;0.0
73;2021-01-02;0;0;2;1;0.0;0.0
73;2021-01-03;0;0;2;1;0.0;0.0
73;2021-01-04;1;0;3;1;0.0;0.0
73;2021-01-05;0;0;3;1;0.0;0.0
73;2021-01-06;1;0;4;1;0.0;0.0
73;2021-01-07;30;0;34;1;0.0;0.0
73;2021-01-08;81;0;115;1;0.0;0.0
73;2021-01-09;0;0;115;1;0.0;0.0
73;2021-01-10;0;0;115;1;0.0;0.0
73;2021-01-11;101;1;216;2;0.0;0.0
73;2021-01-12;303;1;519;3;0.1;0.0
73;2021-01-13;363;1;882;4;0.2;0.0
73;2021-01-14;516;3;1398;7;0.3;0.0
73;2021-01-15;617;1;2015;8;0.5;0.0
73;2021-01-16;128;2;2143;10;0.5;0.0
73;2021-01-17;0;0;2143;10;0.5;0.0
73;2021-01-18;624;0;2767;10;0.6;0.0
73;2021-01-19;1240;4;4007;14;0.9;0.0
73;2021-01-20;950;2;4957;16;1.1;0.0
73;2021-01-21;985;5;5942;21;1.4;0.0
73;2021-01-22;948;0;6890;21;1.6;0.0
73;2021-01-23;389;0;7279;21;1.7;0.0
73;2021-01-24;0;0;7279;21;1.7;0.0
73;2021-01-25;656;6;7935;27;1.8;0.0
73;2021-01-26;761;2;8696;29;2.0;0.0
73;2021-01-27;1107;6;9803;35;2.3;0.0
73;2021-01-28;960;5;10763;40;2.5;0.0
73;2021-01-29;684;7;11447;47;2.6;0.0
73;2021-01-30;346;3;11793;50;2.7;0.0
73;2021-01-31;0;0;11793;50;2.7;0.0
73;2021-02-01;606;42;12399;92;2.9;0.0
73;2021-02-02;752;335;13151;427;3.0;0.1
73;2021-02-03;648;353;13799;780;3.2;0.2
73;2021-02-04;626;236;14425;1016;3.3;0.2
73;2021-02-05;680;408;15105;1424;3.5;0.3
73;2021-02-06;263;39;15368;1463;3.6;0.3
73;2021-02-07;1;0;15369;1463;3.6;0.3
73;2021-02-08;524;253;15893;1716;3.7;0.4
73;2021-02-09;793;455;16686;2171;3.9;0.5
73;2021-02-10;901;395;17587;2566;4.1;0.6
73;2021-02-11;963;718;18550;3284;4.3;0.8
73;2021-02-12;811;512;19361;3796;4.5;0.9
73;2021-02-13;263;59;19624;3855;4.5;0.9
73;2021-02-14;1;0;19625;3855;4.5;0.9
73;2021-02-15;346;528;19971;4383;4.6;1.0
73;2021-02-16;454;764;20425;5147;4.7;1.2
73;2021-02-17;451;965;20876;6112;4.8;1.4
73;2021-02-18;468;559;21344;6671;4.9;1.5
73;2021-02-19;445;640;21789;7311;5.0;1.7
73;2021-02-20;70;249;21859;7560;5.1;1.7
73;2021-02-21;0;0;21859;7560;5.1;1.7
73;2021-02-22;240;445;22099;8005;5.1;1.9
73;2021-02-23;327;522;22426;8527;5.2;2.0
73;2021-02-24;487;748;22913;9275;5.3;2.1
73;2021-02-25;505;515;23418;9790;5.4;2.3
73;2021-02-26;729;570;24147;10360;5.6;2.4
73;2021-02-27;330;237;24477;10597;5.7;2.4
73;2021-02-28;2;1;24479;10598;5.7;2.5
73;2021-03-01;557;509;25036;11107;5.8;2.6
73;2021-03-02;667;902;25703;12009;5.9;2.8
73;2021-03-03;643;1197;26346;13206;6.1;3.1
73;2021-03-04;1040;905;27386;14111;6.3;3.3
73;2021-03-05;1240;614;28626;14725;6.6;3.4
73;2021-03-06;1092;336;29718;15061;6.9;3.5
73;2021-03-07;455;94;30173;15155;7.0;3.5
73;2021-03-08;609;431;30782;15586;7.1;3.6
73;2021-03-09;985;543;31767;16129;7.3;3.7
73;2021-03-10;1035;876;32802;17005;7.6;3.9
73;2021-03-11;1559;665;34361;17670;7.9;4.1
73;2021-03-12;2018;539;36379;18209;8.4;4.2
73;2021-03-13;1180;206;37559;18415;8.7;4.3
73;2021-03-14;66;4;37625;18419;8.7;4.3
73;2021-03-15;1185;401;38810;18820;9.0;4.4
73;2021-03-16;795;400;39605;19220;9.2;4.4
73;2021-03-17;877;481;40482;19701;9.4;4.6
73;2021-03-18;1352;260;41834;19961;9.7;4.6
73;2021-03-19;1767;396;43601;20357;10.1;4.7
73;2021-03-20;888;131;44489;20488;10.3;4.7
73;2021-03-21;123;3;44612;20491;10.3;4.7
73;2021-03-22;1184;405;45796;20896;10.6;4.8
73;2021-03-23;1449;244;47245;21140;10.9;4.9
73;2021-03-24;1604;347;48849;21487;11.3;5.0
73;2021-03-25;2064;390;50913;21877;11.8;5.1
73;2021-03-26;2472;368;53385;22245;12.3;5.1
73;2021-03-27;885;148;54270;22393;12.5;5.2
73;2021-03-28;312;16;54582;22409;12.6;5.2
73;2021-03-29;1508;241;56090;22650;13.0;5.2
73;2021-03-30;2089;487;58179;23137;13.5;5.3
73;2021-03-31;2089;407;60268;23544;13.9;5.4
73;2021-04-01;2087;341;62355;23885;14.4;5.5
73;2021-04-02;2362;236;64717;24121;15.0;5.6
73;2021-04-03;848;147;65565;24268;15.2;5.6
73;2021-04-04;188;18;65753;24286;15.2;5.6
73;2021-04-05;212;26;65965;24312;15.3;5.6
73;2021-04-06;1506;513;67471;24825;15.6;5.7
73;2021-04-07;1947;655;69418;25480;16.0;5.9
73;2021-04-08;2492;835;71910;26315;16.6;6.1
73;2021-04-09;3059;532;74969;26847;17.3;6.2
73;2021-04-10;1134;322;76103;27169;17.6;6.3
73;2021-04-11;164;10;76267;27179;17.6;6.3
73;2021-04-12;1696;989;77963;28168;18.0;6.5
73;2021-04-13;1893;1131;79856;29299;18.5;6.8
73;2021-04-14;2004;1094;81860;30393;18.9;7.0
73;2021-04-15;2416;1193;84276;31586;19.5;7.3
73;2021-04-16;1893;938;86169;32524;19.9;7.5
73;2021-04-17;1173;561;87342;33085;20.2;7.6
73;2021-04-18;155;76;87497;33161;20.2;7.7
73;2021-04-19;1383;1065;88880;34226;20.5;7.9
73;2021-04-20;1790;1327;90670;35553;21.0;8.2
73;2021-04-21;1576;1305;92246;36858;21.3;8.5
73;2021-04-22;1812;1227;94058;38085;21.7;8.8
73;2021-04-23;1896;1254;95954;39339;22.2;9.1
73;2021-04-24;979;679;96933;40018;22.4;9.3
73;2021-04-25;79;97;97012;40115;22.4;9.3
73;2021-04-26;1164;1320;98176;41435;22.7;9.6
73;2021-04-27;1440;1475;99616;42910;23.0;9.9
73;2021-04-28;1731;1461;101347;44371;23.4;10.3
73;2021-04-29;2412;1563;103759;45934;24.0;10.6
73;2021-04-30;2396;1443;106155;47377;24.5;11.0
73;2021-05-01;1068;310;107223;47687;24.8;11.0
73;2021-05-02;34;165;107257;47852;24.8;11.1
73;2021-05-03;1392;1595;108649;49447;25.1;11.4
73;2021-05-04;1713;1834;110362;51281;25.5;11.9
73;2021-05-05;1974;1690;112336;52971;26.0;12.2
73;2021-05-06;2431;1696;114767;54667;26.5;12.6
73;2021-05-07;2259;1849;117026;56516;27.1;13.1
73;2021-05-08;1840;377;118866;56893;27.5;13.2
73;2021-05-09;127;127;118993;57020;27.5;13.2
73;2021-05-10;1608;1892;120601;58912;27.9;13.6
73;2021-05-11;2379;2368;122980;61280;28.4;14.2
73;2021-05-12;3556;2097;126536;63377;29.3;14.7
73;2021-05-13;1554;276;128090;63653;29.6;14.7
73;2021-05-14;1588;1493;129678;65146;30.0;15.1
73;2021-05-15;1447;943;131125;66089;30.3;15.3
73;2021-05-16;131;62;131256;66151;30.3;15.3
73;2021-05-17;1711;1952;132967;68103;30.7;15.7
73;2021-05-18;2495;1735;135462;69838;31.3;16.1
73;2021-05-19;2538;1622;138000;71460;31.9;16.5
73;2021-05-20;3162;1502;141162;72962;32.6;16.9
73;2021-05-21;2473;1849;143635;74811;33.2;17.3
73;2021-05-22;1989;922;145624;75733;33.7;17.5
73;2021-05-23;212;14;145836;75747;33.7;17.5
73;2021-05-24;2563;327;148399;76074;34.3;17.6
73;2021-05-25;2139;1741;150538;77815;34.8;18.0
73;2021-05-26;2343;2001;152881;79816;35.3;18.5
73;2021-05-27;3081;1715;155962;81531;36.1;18.8
73;2021-05-28;2918;2376;158880;83907;36.7;19.4
73;2021-05-29;2316;1322;161196;85229;37.3;19.7
73;2021-05-30;188;14;161384;85243;37.3;19.7
73;2021-05-31;2411;1633;163795;86876;37.9;20.1
73;2021-06-01;3178;1793;166973;88669;38.6;20.5
73;2021-06-02;3108;1459;170081;90128;39.3;20.8
73;2021-06-03;4422;1740;174503;91868;40.3;21.2
73;2021-06-04;4276;2185;178779;94053;41.3;21.7
73;2021-06-05;3165;1282;181944;95335;42.1;22.0
73;2021-06-06;1881;299;183825;95634;42.5;22.1
73;2021-06-07;2759;2150;186584;97784;43.1;22.6
73;2021-06-08;2684;1872;189268;99656;43.8;23.0
73;2021-06-09;2365;1790;191633;101446;44.3;23.5
73;2021-06-10;2005;1648;193638;103094;44.8;23.8
73;2021-06-11;2192;2441;195830;105535;45.3;24.4
73;2021-06-12;2245;1333;198075;106868;45.8;24.7
73;2021-06-13;44;82;198119;106950;45.8;24.7
73;2021-06-14;1347;2927;199466;109877;46.1;25.4
73;2021-06-15;1592;2755;201058;112632;46.5;26.0
73;2021-06-16;1466;2566;202524;115198;46.8;26.6
73;2021-06-17;947;1727;203471;116925;47.0;27.0
73;2021-06-18;1884;2931;205355;119856;47.5;27.7
73;2021-06-19;1424;1986;206779;121842;47.8;28.2
73;2021-06-20;448;307;207227;122149;47.9;28.2
73;2021-06-21;1111;2938;208338;125087;48.2;28.9
73;2021-06-22;1090;2869;209428;127956;48.4;29.6
73;2021-06-23;1086;3137;210514;131093;48.7;30.3
73;2021-06-24;883;1794;211397;132887;48.9;30.7
73;2021-06-25;1324;2796;212721;135683;49.2;31.4
73;2021-06-26;966;2399;213687;138082;49.4;31.9
73;2021-06-27;329;550;214016;138632;49.5;32.1
73;2021-06-28;971;3557;214987;142189;49.7;32.9
73;2021-06-29;1076;3339;216063;145528;50.0;33.6
73;2021-06-30;1239;3117;217302;148645;50.2;34.4
73;2021-07-01;1191;2363;218493;151008;50.5;34.9
73;2021-07-02;1203;3617;219696;154625;50.8;35.7
73;2021-07-03;961;2793;220657;157418;51.0;36.4
73;2021-07-04;301;619;220958;158037;51.1;36.5
73;2021-07-05;1157;3681;222115;161718;51.4;37.4
73;2021-07-06;1251;2952;223366;164670;51.6;38.1
73;2021-07-07;1442;2948;224808;167618;52.0;38.8
73;2021-07-08;1373;2296;226181;169914;52.3;39.3
73;2021-07-09;1431;4026;227612;173940;52.6;40.2
73;2021-07-10;891;3012;228503;176952;52.8;40.9
73;2021-07-11;561;1470;229064;178422;53.0;41.2
73;2021-07-12;1059;4196;230123;182618;53.2;42.2
73;2021-07-13;1729;4225;231852;186843;53.6;43.2
73;2021-07-14;1843;1920;233695;188763;54.0;43.6
73;2021-07-15;2747;3797;236442;192560;54.7;44.5
73;2021-07-16;2416;4016;238858;196576;55.2;45.4
73;2021-07-17;1515;2607;240373;199183;55.6;46.0
73;2021-07-18;1176;1218;241549;200401;55.8;46.3
73;2021-07-19;2449;3251;243998;203652;56.4;47.1
73;2021-07-20;3366;2856;247364;206508;57.2;47.7
73;2021-07-21;3382;2790;250746;209298;58.0;48.4
73;2021-07-22;2733;2216;253479;211514;58.6;48.9
73;2021-07-23;3417;2903;256896;214417;59.4;49.6
73;2021-07-24;2059;2280;258955;216697;59.9;50.1
73;2021-07-25;625;797;259580;217494;60.0;50.3
73;2021-07-26;2632;2497;262212;219991;60.6;50.9
73;2021-07-27;3813;2271;266025;222262;61.5;51.4
73;2021-07-28;3535;2097;269560;224359;62.3;51.9
73;2021-07-29;3980;2154;273540;226513;63.2;52.4
73;2021-07-30;3565;2477;277105;228990;64.1;52.9
73;2021-07-31;2477;1594;279582;230584;64.6;53.3
73;2021-08-01;834;620;280416;231204;64.8;53.5
73;2021-08-02;3104;2105;283520;233309;65.5;53.9
73;2021-08-03;3494;2001;287014;235310;66.4;54.4
73;2021-08-04;3299;2025;290313;237335;67.1;54.9
73;2021-08-05;2875;2233;293188;239568;67.8;55.4
73;2021-08-06;2509;2382;295697;241950;68.4;55.9
73;2021-08-07;1416;1482;297113;243432;68.7;56.3
73;2021-08-08;434;619;297547;244051;68.8;56.4
73;2021-08-09;1785;2397;299332;246448;69.2;57.0
73;2021-08-10;1897;2488;301229;248936;69.6;57.6
73;2021-08-11;1848;2536;303077;251472;70.1;58.1
73;2021-08-12;1682;2503;304759;253975;70.5;58.7
73;2021-08-13;1462;2842;306221;256817;70.8;59.4
73;2021-08-14;991;1534;307212;258351;71.0;59.7
73;2021-08-15;92;162;307304;258513;71.0;59.8
73;2021-08-16;952;1392;308256;259905;71.3;60.1
73;2021-08-17;964;1960;309220;261865;71.5;60.5
73;2021-08-18;1039;2841;310259;264706;71.7;61.2
73;2021-08-19;1045;3055;311304;267761;72.0;61.9
73;2021-08-20;852;3146;312156;270907;72.2;62.6
73;2021-08-21;463;1837;312619;272744;72.3;63.1
73;2021-08-22;268;936;312887;273680;72.3;63.3
73;2021-08-23;677;2970;313564;276650;72.5;64.0
73;2021-08-24;899;3160;314463;279810;72.7;64.7
73;2021-08-25;712;2906;315175;282716;72.9;65.4
73;2021-08-26;691;2424;315866;285140;73.0;65.9
73;2021-08-27;791;2748;316657;287888;73.2;66.6
73;2021-08-28;457;1749;317114;289637;73.3;67.0
73;2021-08-29;303;1018;317417;290655;73.4;67.2
73;2021-08-30;822;2570;318239;293225;73.6;67.8
73;2021-08-31;819;2359;319058;295584;73.8;68.3
73;2021-09-01;749;2098;319807;297682;73.9;68.8
73;2021-09-02;619;1762;320426;299444;74.1;69.2
73;2021-09-03;700;2026;321126;301470;74.2;69.7
73;2021-09-04;531;1370;321657;302840;74.4;70.0
73;2021-09-05;227;703;321884;303543;74.4;70.2
73;2021-09-06;351;1076;322235;304619;74.5;70.4
73;2021-09-07;414;875;322649;305494;74.6;70.6
73;2021-09-08;491;1016;323140;306510;74.7;70.9
73;2021-09-09;467;1020;323607;307530;74.8;71.1
73;2021-09-10;578;1268;324185;308798;74.9;71.4
73;2021-09-11;355;1002;324540;309800;75.0;71.6
73;2021-09-12;96;155;324636;309955;75.1;71.7
73;2021-09-13;343;715;324979;310670;75.1;71.8
73;2021-09-14;413;622;325392;311292;75.2;72.0
73;2021-09-15;427;816;325819;312108;75.3;72.2
73;2021-09-16;332;647;326151;312755;75.4;72.3
73;2021-09-17;377;870;326528;313625;75.5;72.5
73;2021-09-18;261;630;326789;314255;75.5;72.7
73;2021-09-19;48;206;326837;314461;75.6;72.7
73;2021-09-20;164;632;327001;315093;75.6;72.8
73;2021-09-21;298;539;327299;315632;75.7;73.0
73;2021-09-22;275;775;327574;316407;75.7;73.1
73;2021-09-23;283;478;327857;316885;75.8;73.3
73;2021-09-24;293;858;328150;317743;75.9;73.5
73;2021-09-25;189;725;328339;318468;75.9;73.6
73;2021-09-26;73;211;328412;318679;75.9;73.7
73;2021-09-27;245;498;328657;319177;76.0;73.8
73;2021-09-28;185;341;328842;319518;76.0;73.9
73;2021-09-29;220;677;329062;320195;76.1;74.0
73;2021-09-30;193;365;329255;320560;76.1;74.1
73;2021-10-01;211;564;329466;321124;76.2;74.2
73;2021-10-02;197;482;329663;321606;76.2;74.4
73;2021-10-03;8;11;329671;321617;76.2;74.4
73;2021-10-04;213;363;329884;321980;76.3;74.4
73;2021-10-05;166;312;330050;322292;76.3;74.5
73;2021-10-06;315;508;330365;322800;76.4;74.6
73;2021-10-07;164;303;330529;323103;76.4;74.7
73;2021-10-08;254;537;330783;323640;76.5;74.8
73;2021-10-09;158;349;330941;323989;76.5;74.9
73;2021-10-10;3;6;330944;323995;76.5;74.9
73;2021-10-11;191;316;331135;324311;76.6;75.0
73;2021-10-12;133;182;331268;324493;76.6;75.0
73;2021-10-13;228;365;331496;324858;76.6;75.1
73;2021-10-14;190;327;331686;325185;76.7;75.2
73;2021-10-15;187;333;331873;325518;76.7;75.3
73;2021-10-16;99;204;331972;325722;76.7;75.3
73;2021-10-17;4;6;331976;325728;76.7;75.3
73;2021-10-18;183;353;332159;326081;76.8;75.4
73;2021-10-19;206;311;332365;326392;76.8;75.5
74;2020-12-27;10;6;10;6;0.0;0.0
74;2020-12-28;10;1;20;7;0.0;0.0
74;2020-12-29;0;0;20;7;0.0;0.0
74;2020-12-30;5;2;25;9;0.0;0.0
74;2020-12-31;2;0;27;9;0.0;0.0
74;2021-01-01;1;0;28;9;0.0;0.0
74;2021-01-02;1;1;29;10;0.0;0.0
74;2021-01-03;0;0;29;10;0.0;0.0
74;2021-01-04;5;3;34;13;0.0;0.0
74;2021-01-05;4;1;38;14;0.0;0.0
74;2021-01-06;48;2;86;16;0.0;0.0
74;2021-01-07;220;1;306;17;0.0;0.0
74;2021-01-08;297;2;603;19;0.1;0.0
74;2021-01-09;79;0;682;19;0.1;0.0
74;2021-01-10;74;0;756;19;0.1;0.0
74;2021-01-11;375;1;1131;20;0.1;0.0
74;2021-01-12;408;3;1539;23;0.2;0.0
74;2021-01-13;396;0;1935;23;0.2;0.0
74;2021-01-14;482;5;2417;28;0.3;0.0
74;2021-01-15;645;4;3062;32;0.4;0.0
74;2021-01-16;254;1;3316;33;0.4;0.0
74;2021-01-17;138;2;3454;35;0.4;0.0
74;2021-01-18;527;3;3981;38;0.5;0.0
74;2021-01-19;817;3;4798;41;0.6;0.0
74;2021-01-20;1282;4;6080;45;0.7;0.0
74;2021-01-21;1570;3;7650;48;0.9;0.0
74;2021-01-22;1243;7;8893;55;1.1;0.0
74;2021-01-23;345;1;9238;56;1.1;0.0
74;2021-01-24;95;2;9333;58;1.1;0.0
74;2021-01-25;801;3;10134;61;1.2;0.0
74;2021-01-26;1372;26;11506;87;1.4;0.0
74;2021-01-27;1086;17;12592;104;1.5;0.0
74;2021-01-28;1003;42;13595;146;1.6;0.0
74;2021-01-29;883;43;14478;189;1.7;0.0
74;2021-01-30;305;2;14783;191;1.8;0.0
74;2021-01-31;87;1;14870;192;1.8;0.0
74;2021-02-01;632;45;15502;237;1.9;0.0
74;2021-02-02;646;154;16148;391;1.9;0.0
74;2021-02-03;606;120;16754;511;2.0;0.1
74;2021-02-04;617;136;17371;647;2.1;0.1
74;2021-02-05;557;224;17928;871;2.2;0.1
74;2021-02-06;276;136;18204;1007;2.2;0.1
74;2021-02-07;93;123;18297;1130;2.2;0.1
74;2021-02-08;620;349;18917;1479;2.3;0.2
74;2021-02-09;542;534;19459;2013;2.3;0.2
74;2021-02-10;692;517;20151;2530;2.4;0.3
74;2021-02-11;1084;1016;21235;3546;2.6;0.4
74;2021-02-12;918;617;22153;4163;2.7;0.5
74;2021-02-13;407;240;22560;4403;2.7;0.5
74;2021-02-14;320;112;22880;4515;2.8;0.5
74;2021-02-15;281;847;23161;5362;2.8;0.6
74;2021-02-16;492;1064;23653;6426;2.9;0.8
74;2021-02-17;533;1103;24186;7529;2.9;0.9
74;2021-02-18;473;987;24659;8516;3.0;1.0
74;2021-02-19;619;656;25278;9172;3.1;1.1
74;2021-02-20;114;187;25392;9359;3.1;1.1
74;2021-02-21;48;61;25440;9420;3.1;1.1
74;2021-02-22;320;788;25760;10208;3.1;1.2
74;2021-02-23;309;821;26069;11029;3.1;1.3
74;2021-02-24;242;680;26311;11709;3.2;1.4
74;2021-02-25;525;752;26836;12461;3.2;1.5
74;2021-02-26;972;702;27808;13163;3.4;1.6
74;2021-02-27;254;181;28062;13344;3.4;1.6
74;2021-02-28;125;71;28187;13415;3.4;1.6
74;2021-03-01;725;638;28912;14053;3.5;1.7
74;2021-03-02;1096;691;30008;14744;3.6;1.8
74;2021-03-03;1026;643;31034;15387;3.7;1.9
74;2021-03-04;1614;1028;32648;16415;3.9;2.0
74;2021-03-05;2094;898;34742;17313;4.2;2.1
74;2021-03-06;1762;339;36504;17652;4.4;2.1
74;2021-03-07;1388;109;37892;17761;4.6;2.1
74;2021-03-08;1198;961;39090;18722;4.7;2.3
74;2021-03-09;1958;677;41048;19399;5.0;2.3
74;2021-03-10;1749;923;42797;20322;5.2;2.5
74;2021-03-11;2453;738;45250;21060;5.5;2.5
74;2021-03-12;3247;1040;48497;22100;5.9;2.7
74;2021-03-13;2005;282;50502;22382;6.1;2.7
74;2021-03-14;610;105;51112;22487;6.2;2.7
74;2021-03-15;2130;568;53242;23055;6.4;2.8
74;2021-03-16;1965;423;55207;23478;6.7;2.8
74;2021-03-17;1975;327;57182;23805;6.9;2.9
74;2021-03-18;2137;296;59319;24101;7.2;2.9
74;2021-03-19;2637;305;61956;24406;7.5;2.9
74;2021-03-20;1375;106;63331;24512;7.6;3.0
74;2021-03-21;290;34;63621;24546;7.7;3.0
74;2021-03-22;2055;340;65676;24886;7.9;3.0
74;2021-03-23;2723;347;68399;25233;8.3;3.0
74;2021-03-24;2950;317;71349;25550;8.6;3.1
74;2021-03-25;3875;318;75224;25868;9.1;3.1
74;2021-03-26;4096;400;79320;26268;9.6;3.2
74;2021-03-27;1941;265;81261;26533;9.8;3.2
74;2021-03-28;437;78;81698;26611;9.9;3.2
74;2021-03-29;3035;729;84733;27340;10.2;3.3
74;2021-03-30;3543;785;88276;28125;10.7;3.4
74;2021-03-31;3144;747;91420;28872;11.0;3.5
74;2021-04-01;4235;911;95655;29783;11.5;3.6
74;2021-04-02;3711;808;99366;30591;12.0;3.7
74;2021-04-03;1699;547;101065;31138;12.2;3.8
74;2021-04-04;236;122;101301;31260;12.2;3.8
74;2021-04-05;433;17;101734;31277;12.3;3.8
74;2021-04-06;2621;1222;104355;32499;12.6;3.9
74;2021-04-07;3195;1267;107550;33766;13.0;4.1
74;2021-04-08;3863;1200;111413;34966;13.4;4.2
74;2021-04-09;4111;1200;115524;36166;13.9;4.4
74;2021-04-10;1943;1038;117467;37204;14.2;4.5
74;2021-04-11;253;184;117720;37388;14.2;4.5
74;2021-04-12;2724;1789;120444;39177;14.5;4.7
74;2021-04-13;3124;2117;123568;41294;14.9;5.0
74;2021-04-14;2903;1982;126471;43276;15.3;5.2
74;2021-04-15;3463;1927;129934;45203;15.7;5.5
74;2021-04-16;3386;1797;133320;47000;16.1;5.7
74;2021-04-17;1936;1041;135256;48041;16.3;5.8
74;2021-04-18;218;211;135474;48252;16.4;5.8
74;2021-04-19;2101;2109;137575;50361;16.6;6.1
74;2021-04-20;3068;2430;140643;52791;17.0;6.4
74;2021-04-21;2465;2382;143108;55173;17.3;6.7
74;2021-04-22;2630;2345;145738;57518;17.6;6.9
74;2021-04-23;2573;2262;148311;59780;17.9;7.2
74;2021-04-24;1486;1549;149797;61329;18.1;7.4
74;2021-04-25;229;150;150026;61479;18.1;7.4
74;2021-04-26;2396;2472;152422;63951;18.4;7.7
74;2021-04-27;3272;2919;155694;66870;18.8;8.1
74;2021-04-28;3466;2648;159160;69518;19.2;8.4
74;2021-04-29;3909;2701;163069;72219;19.7;8.7
74;2021-04-30;4076;2233;167145;74452;20.2;9.0
74;2021-05-01;2121;400;169266;74852;20.4;9.0
74;2021-05-02;207;240;169473;75092;20.5;9.1
74;2021-05-03;2596;3032;172069;78124;20.8;9.4
74;2021-05-04;3216;3117;175285;81241;21.2;9.8
74;2021-05-05;3392;3021;178677;84262;21.6;10.2
74;2021-05-06;3860;2640;182537;86902;22.0;10.5
74;2021-05-07;3595;3558;186132;90460;22.5;10.9
74;2021-05-08;1145;827;187277;91287;22.6;11.0
74;2021-05-09;195;247;187472;91534;22.6;11.0
74;2021-05-10;3466;3151;190938;94685;23.0;11.4
74;2021-05-11;4317;3426;195255;98111;23.6;11.8
74;2021-05-12;5307;2970;200562;101081;24.2;12.2
74;2021-05-13;2357;950;202919;102031;24.5;12.3
74;2021-05-14;5956;2407;208875;104438;25.2;12.6
74;2021-05-15;4514;1852;213389;106290;25.8;12.8
74;2021-05-16;3012;338;216401;106628;26.1;12.9
74;2021-05-17;5397;2889;221798;109517;26.8;13.2
74;2021-05-18;6794;2819;228592;112336;27.6;13.6
74;2021-05-19;6234;2296;234826;114632;28.3;13.8
74;2021-05-20;6643;2558;241469;117190;29.1;14.1
74;2021-05-21;6526;2994;247995;120184;29.9;14.5
74;2021-05-22;5293;1569;253288;121753;30.6;14.7
74;2021-05-23;2052;282;255340;122035;30.8;14.7
74;2021-05-24;2363;661;257703;122696;31.1;14.8
74;2021-05-25;5072;3334;262775;126030;31.7;15.2
74;2021-05-26;5255;2562;268030;128592;32.4;15.5
74;2021-05-27;6002;2975;274032;131567;33.1;15.9
74;2021-05-28;5656;3588;279688;135155;33.8;16.3
74;2021-05-29;3799;2155;283487;137310;34.2;16.6
74;2021-05-30;489;309;283976;137619;34.3;16.6
74;2021-05-31;5070;3549;289046;141168;34.9;17.0
74;2021-06-01;4931;3730;293977;144898;35.5;17.5
74;2021-06-02;5269;3207;299246;148105;36.1;17.9
74;2021-06-03;6890;3251;306136;151356;37.0;18.3
74;2021-06-04;6912;4432;313048;155788;37.8;18.8
74;2021-06-05;4609;2707;317657;158495;38.3;19.1
74;2021-06-06;124;112;317781;158607;38.4;19.1
74;2021-06-07;5032;4146;322813;162753;39.0;19.6
74;2021-06-08;5025;3951;327838;166704;39.6;20.1
74;2021-06-09;5081;3484;332919;170188;40.2;20.5
74;2021-06-10;5124;2879;338043;173067;40.8;20.9
74;2021-06-11;5214;3814;343257;176881;41.4;21.4
74;2021-06-12;3567;2378;346824;179259;41.9;21.6
74;2021-06-13;120;89;346944;179348;41.9;21.6
74;2021-06-14;3593;4482;350537;183830;42.3;22.2
74;2021-06-15;3671;3899;354208;187729;42.8;22.7
74;2021-06-16;4827;3126;359035;190855;43.3;23.0
74;2021-06-17;3816;2958;362851;193813;43.8;23.4
74;2021-06-18;4115;4671;366966;198484;44.3;24.0
74;2021-06-19;2992;3101;369958;201585;44.7;24.3
74;2021-06-20;125;97;370083;201682;44.7;24.3
74;2021-06-21;2382;5420;372465;207102;45.0;25.0
74;2021-06-22;2493;5313;374958;212415;45.3;25.6
74;2021-06-23;2974;4618;377932;217033;45.6;26.2
74;2021-06-24;2865;4627;380797;221660;46.0;26.8
74;2021-06-25;2929;6768;383726;228428;46.3;27.6
74;2021-06-26;1705;5400;385431;233828;46.5;28.2
74;2021-06-27;66;1664;385497;235492;46.5;28.4
74;2021-06-28;1914;7219;387411;242711;46.8;29.3
74;2021-06-29;2299;7422;389710;250133;47.0;30.2
74;2021-06-30;2748;6546;392458;256679;47.4;31.0
74;2021-07-01;3529;5427;395987;262106;47.8;31.6
74;2021-07-02;3120;6640;399107;268746;48.2;32.4
74;2021-07-03;1698;5082;400805;273828;48.4;33.1
74;2021-07-04;81;1022;400886;274850;48.4;33.2
74;2021-07-05;2078;6829;402964;281679;48.6;34.0
74;2021-07-06;2799;6492;405763;288171;49.0;34.8
74;2021-07-07;3094;5447;408857;293618;49.4;35.4
74;2021-07-08;3868;4923;412725;298541;49.8;36.0
74;2021-07-09;2671;6978;415396;305519;50.1;36.9
74;2021-07-10;1623;5132;417019;310651;50.3;37.5
74;2021-07-11;76;142;417095;310793;50.3;37.5
74;2021-07-12;2098;7899;419193;318692;50.6;38.5
74;2021-07-13;3967;7586;423160;326278;51.1;39.4
74;2021-07-14;1969;2238;425129;328516;51.3;39.7
74;2021-07-15;3593;6876;428722;335392;51.8;40.5
74;2021-07-16;4243;7740;432965;343132;52.3;41.4
74;2021-07-17;3004;5334;435969;348466;52.6;42.1
74;2021-07-18;156;155;436125;348621;52.6;42.1
74;2021-07-19;4295;7352;440420;355973;53.2;43.0
74;2021-07-20;5872;6469;446292;362442;53.9;43.8
74;2021-07-21;5669;6675;451961;369117;54.6;44.6
74;2021-07-22;4773;5323;456734;374440;55.1;45.2
74;2021-07-23;6227;6997;462961;381437;55.9;46.0
74;2021-07-24;3157;4317;466118;385754;56.3;46.6
74;2021-07-25;181;172;466299;385926;56.3;46.6
74;2021-07-26;5618;6135;471917;392061;57.0;47.3
74;2021-07-27;6852;5177;478769;397238;57.8;48.0
74;2021-07-28;6660;5101;485429;402339;58.6;48.6
74;2021-07-29;5280;3931;490709;406270;59.2;49.0
74;2021-07-30;6716;5506;497425;411776;60.0;49.7
74;2021-07-31;4380;3123;501805;414899;60.6;50.1
74;2021-08-01;185;150;501990;415049;60.6;50.1
74;2021-08-02;6273;4410;508263;419459;61.4;50.6
74;2021-08-03;6038;3861;514301;423320;62.1;51.1
74;2021-08-04;6325;3508;520626;426828;62.8;51.5
74;2021-08-05;4937;3271;525563;430099;63.4;51.9
74;2021-08-06;5070;4185;530633;434284;64.1;52.4
74;2021-08-07;3214;2899;533847;437183;64.4;52.8
74;2021-08-08;154;134;534001;437317;64.5;52.8
74;2021-08-09;4977;4829;538978;442146;65.1;53.4
74;2021-08-10;4992;4689;543970;446835;65.7;53.9
74;2021-08-11;4446;4893;548416;451728;66.2;54.5
74;2021-08-12;3626;3608;552042;455336;66.6;55.0
74;2021-08-13;3840;4626;555882;459962;67.1;55.5
74;2021-08-14;2187;3342;558069;463304;67.4;55.9
74;2021-08-15;66;103;558135;463407;67.4;55.9
74;2021-08-16;3913;5880;562048;469287;67.8;56.6
74;2021-08-17;3136;5486;565184;474773;68.2;57.3
74;2021-08-18;3092;5463;568276;480236;68.6;58.0
74;2021-08-19;2361;3897;570637;484133;68.9;58.4
74;2021-08-20;2638;5698;573275;489831;69.2;59.1
74;2021-08-21;1239;4273;574514;494104;69.4;59.6
74;2021-08-22;56;137;574570;494241;69.4;59.7
74;2021-08-23;2197;6697;576767;500938;69.6;60.5
74;2021-08-24;2220;5939;578987;506877;69.9;61.2
74;2021-08-25;1978;6296;580965;513173;70.1;61.9
74;2021-08-26;1562;3788;582527;516961;70.3;62.4
74;2021-08-27;1940;5511;584467;522472;70.6;63.1
74;2021-08-28;924;4042;585391;526514;70.7;63.6
74;2021-08-29;67;188;585458;526702;70.7;63.6
74;2021-08-30;1872;5355;587330;532057;70.9;64.2
74;2021-08-31;1681;4968;589011;537025;71.1;64.8
74;2021-09-01;1989;3879;591000;540904;71.3;65.3
74;2021-09-02;1236;2813;592236;543717;71.5;65.6
74;2021-09-03;1556;3836;593792;547553;71.7;66.1
74;2021-09-04;1160;2749;594952;550302;71.8;66.4
74;2021-09-05;49;92;595001;550394;71.8;66.4
74;2021-09-06;1334;3032;596335;553426;72.0;66.8
74;2021-09-07;1033;2744;597368;556170;72.1;67.1
74;2021-09-08;1319;2869;598687;559039;72.3;67.5
74;2021-09-09;1225;1936;599912;560975;72.4;67.7
74;2021-09-10;1132;2756;601044;563731;72.6;68.1
74;2021-09-11;801;2214;601845;565945;72.7;68.3
74;2021-09-12;40;74;601885;566019;72.7;68.3
74;2021-09-13;1018;2070;602903;568089;72.8;68.6
74;2021-09-14;1098;1975;604001;570064;72.9;68.8
74;2021-09-15;1092;2274;605093;572338;73.0;69.1
74;2021-09-16;778;1033;605871;573371;73.1;69.2
74;2021-09-17;876;1849;606747;575220;73.2;69.4
74;2021-09-18;610;1672;607357;576892;73.3;69.6
74;2021-09-19;3;9;607360;576901;73.3;69.6
74;2021-09-20;820;1888;608180;578789;73.4;69.9
74;2021-09-21;671;1372;608851;580161;73.5;70.0
74;2021-09-22;652;2107;609503;582268;73.6;70.3
74;2021-09-23;644;998;610147;583266;73.7;70.4
74;2021-09-24;731;1971;610878;585237;73.7;70.6
74;2021-09-25;462;1622;611340;586859;73.8;70.8
74;2021-09-26;2;2;611342;586861;73.8;70.8
74;2021-09-27;582;1775;611924;588636;73.9;71.1
74;2021-09-28;401;963;612325;589599;73.9;71.2
74;2021-09-29;547;1565;612872;591164;74.0;71.4
74;2021-09-30;390;1061;613262;592225;74.0;71.5
74;2021-10-01;600;1124;613862;593349;74.1;71.6
74;2021-10-02;434;816;614296;594165;74.2;71.7
74;2021-10-03;5;11;614301;594176;74.2;71.7
74;2021-10-04;531;1108;614832;595284;74.2;71.9
74;2021-10-05;367;1093;615199;596377;74.3;72.0
74;2021-10-06;450;991;615649;597368;74.3;72.1
74;2021-10-07;302;630;615951;597998;74.4;72.2
74;2021-10-08;564;1166;616515;599164;74.4;72.3
74;2021-10-09;408;773;616923;599937;74.5;72.4
74;2021-10-10;5;15;616928;599952;74.5;72.4
74;2021-10-11;384;822;617312;600774;74.5;72.5
74;2021-10-12;359;802;617671;601576;74.6;72.6
74;2021-10-13;428;855;618099;602431;74.6;72.7
74;2021-10-14;292;484;618391;602915;74.6;72.8
74;2021-10-15;550;931;618941;603846;74.7;72.9
74;2021-10-16;265;548;619206;604394;74.7;73.0
74;2021-10-17;2;35;619208;604429;74.7;73.0
74;2021-10-18;394;724;619602;605153;74.8;73.1
74;2021-10-19;341;621;619943;605774;74.8;73.1
75;2020-12-27;79;11;79;11;0.0;0.0
75;2020-12-28;68;2;147;13;0.0;0.0
75;2020-12-29;36;3;183;16;0.0;0.0
75;2020-12-30;91;1;274;17;0.0;0.0
75;2020-12-31;52;4;326;21;0.0;0.0
75;2021-01-01;63;11;389;32;0.0;0.0
75;2021-01-02;67;4;456;36;0.0;0.0
75;2021-01-03;110;6;566;42;0.0;0.0
75;2021-01-04;323;11;889;53;0.0;0.0
75;2021-01-05;883;16;1772;69;0.1;0.0
75;2021-01-06;1373;23;3145;92;0.1;0.0
75;2021-01-07;2072;23;5217;115;0.2;0.0
75;2021-01-08;2882;34;8099;149;0.4;0.0
75;2021-01-09;1101;3;9200;152;0.4;0.0
75;2021-01-10;1101;4;10301;156;0.5;0.0
75;2021-01-11;3119;68;13420;224;0.6;0.0
75;2021-01-12;3495;63;16915;287;0.8;0.0
75;2021-01-13;3578;58;20493;345;1.0;0.0
75;2021-01-14;3804;105;24297;450;1.1;0.0
75;2021-01-15;3344;68;27641;518;1.3;0.0
75;2021-01-16;1149;27;28790;545;1.3;0.0
75;2021-01-17;564;19;29354;564;1.4;0.0
75;2021-01-18;3296;84;32650;648;1.5;0.0
75;2021-01-19;3883;61;36533;709;1.7;0.0
75;2021-01-20;4444;81;40977;790;1.9;0.0
75;2021-01-21;4960;103;45937;893;2.1;0.0
75;2021-01-22;4614;100;50551;993;2.4;0.0
75;2021-01-23;1773;16;52324;1009;2.4;0.0
75;2021-01-24;764;12;53088;1021;2.5;0.0
75;2021-01-25;1743;37;54831;1058;2.6;0.0
75;2021-01-26;2566;100;57397;1158;2.7;0.1
75;2021-01-27;3178;184;60575;1342;2.8;0.1
75;2021-01-28;4791;260;65366;1602;3.0;0.1
75;2021-01-29;4068;275;69434;1877;3.2;0.1
75;2021-01-30;1361;36;70795;1913;3.3;0.1
75;2021-01-31;228;3;71023;1916;3.3;0.1
75;2021-02-01;1641;383;72664;2299;3.4;0.1
75;2021-02-02;2155;652;74819;2951;3.5;0.1
75;2021-02-03;1902;692;76721;3643;3.6;0.2
75;2021-02-04;2156;1131;78877;4774;3.7;0.2
75;2021-02-05;2231;874;81108;5648;3.8;0.3
75;2021-02-06;1146;111;82254;5759;3.8;0.3
75;2021-02-07;179;9;82433;5768;3.8;0.3
75;2021-02-08;1270;1466;83703;7234;3.9;0.3
75;2021-02-09;1803;2388;85506;9622;4.0;0.4
75;2021-02-10;2431;2394;87937;12016;4.1;0.6
75;2021-02-11;2954;6305;90891;18321;4.2;0.9
75;2021-02-12;3149;2412;94040;20733;4.4;1.0
75;2021-02-13;865;1040;94905;21773;4.4;1.0
75;2021-02-14;217;47;95122;21820;4.4;1.0
75;2021-02-15;1014;2443;96136;24263;4.5;1.1
75;2021-02-16;1472;6481;97608;30744;4.5;1.4
75;2021-02-17;1348;3216;98956;33960;4.6;1.6
75;2021-02-18;1780;5814;100736;39774;4.7;1.9
75;2021-02-19;2236;4136;102972;43910;4.8;2.0
75;2021-02-20;486;1674;103458;45584;4.8;2.1
75;2021-02-21;201;168;103659;45752;4.8;2.1
75;2021-02-22;1231;1925;104890;47677;4.9;2.2
75;2021-02-23;1479;2719;106369;50396;5.0;2.3
75;2021-02-24;1705;2336;108074;52732;5.0;2.5
75;2021-02-25;2801;5307;110875;58039;5.2;2.7
75;2021-02-26;3389;2730;114264;60769;5.3;2.8
75;2021-02-27;1414;948;115678;61717;5.4;2.9
75;2021-02-28;332;147;116010;61864;5.4;2.9
75;2021-03-01;2618;1701;118628;63565;5.5;3.0
75;2021-03-02;4204;2243;122832;65808;5.7;3.1
75;2021-03-03;5453;2383;128285;68191;6.0;3.2
75;2021-03-04;8069;2656;136354;70847;6.3;3.3
75;2021-03-05;10591;2818;146945;73665;6.8;3.4
75;2021-03-06;11090;1142;158035;74807;7.4;3.5
75;2021-03-07;9514;1563;167549;76370;7.8;3.6
75;2021-03-08;5932;1619;173481;77989;8.1;3.6
75;2021-03-09;7552;2183;181033;80172;8.4;3.7
75;2021-03-10;7529;2193;188562;82365;8.8;3.8
75;2021-03-11;10373;2612;198935;84977;9.3;4.0
75;2021-03-12;12083;2641;211018;87618;9.8;4.1
75;2021-03-13;8563;819;219581;88437;10.2;4.1
75;2021-03-14;4184;273;223765;88710;10.4;4.1
75;2021-03-15;7490;1018;231255;89728;10.8;4.2
75;2021-03-16;5176;728;236431;90456;11.0;4.2
75;2021-03-17;5440;873;241871;91329;11.3;4.3
75;2021-03-18;6636;914;248507;92243;11.6;4.3
75;2021-03-19;9774;1050;258281;93293;12.0;4.3
75;2021-03-20;5946;627;264227;93920;12.3;4.4
75;2021-03-21;1597;437;265824;94357;12.4;4.4
75;2021-03-22;8671;1064;274495;95421;12.8;4.4
75;2021-03-23;10980;1316;285475;96737;13.3;4.5
75;2021-03-24;11025;1385;296500;98122;13.8;4.6
75;2021-03-25;14227;1613;310727;99735;14.5;4.6
75;2021-03-26;14000;1764;324727;101499;15.1;4.7
75;2021-03-27;7294;799;332021;102298;15.5;4.8
75;2021-03-28;1792;166;333813;102464;15.5;4.8
75;2021-03-29;7986;2238;341799;104702;15.9;4.9
75;2021-03-30;10950;3296;352749;107998;16.4;5.0
75;2021-03-31;9758;3657;362507;111655;16.9;5.2
75;2021-04-01;10727;5259;373234;116914;17.4;5.4
75;2021-04-02;9072;5633;382306;122547;17.8;5.7
75;2021-04-03;4128;4913;386434;127460;18.0;5.9
75;2021-04-04;1424;1502;387858;128962;18.1;6.0
75;2021-04-05;2265;1443;390123;130405;18.2;6.1
75;2021-04-06;6934;4347;397057;134752;18.5;6.3
75;2021-04-07;8111;4461;405168;139213;18.9;6.5
75;2021-04-08;11099;4230;416267;143443;19.4;6.7
75;2021-04-09;12223;4674;428490;148117;19.9;6.9
75;2021-04-10;5853;4294;434343;152411;20.2;7.1
75;2021-04-11;1952;1807;436295;154218;20.3;7.2
75;2021-04-12;7497;3823;443792;158041;20.7;7.4
75;2021-04-13;8577;6878;452369;164919;21.1;7.7
75;2021-04-14;8310;5263;460679;170182;21.4;7.9
75;2021-04-15;8939;6178;469618;176360;21.9;8.2
75;2021-04-16;9400;6150;479018;182510;22.3;8.5
75;2021-04-17;4822;3657;483840;186167;22.5;8.7
75;2021-04-18;1675;885;485515;187052;22.6;8.7
75;2021-04-19;5596;4980;491111;192032;22.9;8.9
75;2021-04-20;6477;5991;497588;198023;23.2;9.2
75;2021-04-21;6884;5600;504472;203623;23.5;9.5
75;2021-04-22;7551;5942;512023;209565;23.8;9.8
75;2021-04-23;8714;6516;520737;216081;24.2;10.1
75;2021-04-24;6186;3368;526923;219449;24.5;10.2
75;2021-04-25;2974;769;529897;220218;24.7;10.3
75;2021-04-26;7034;4735;536931;224953;25.0;10.5
75;2021-04-27;10604;6454;547535;231407;25.5;10.8
75;2021-04-28;12209;6054;559744;237461;26.1;11.1
75;2021-04-29;13767;6379;573511;243840;26.7;11.4
75;2021-04-30;13672;6216;587183;250056;27.3;11.6
75;2021-05-01;5081;1338;592264;251394;27.6;11.7
75;2021-05-02;2393;806;594657;252200;27.7;11.7
75;2021-05-03;10302;13516;604959;265716;28.2;12.4
75;2021-05-04;11203;8101;616162;273817;28.7;12.7
75;2021-05-05;13574;6738;629736;280555;29.3;13.1
75;2021-05-06;14014;8218;643750;288773;30.0;13.4
75;2021-05-07;13991;8602;657741;297375;30.6;13.8
75;2021-05-08;10088;5524;667829;302899;31.1;14.1
75;2021-05-09;3821;3194;671650;306093;31.3;14.2
75;2021-05-10;14305;6732;685955;312825;31.9;14.6
75;2021-05-11;16855;8413;702810;321238;32.7;15.0
75;2021-05-12;17969;8166;720779;329404;33.6;15.3
75;2021-05-13;13650;2496;734429;331900;34.2;15.4
75;2021-05-14;18400;5135;752829;337035;35.0;15.7
75;2021-05-15;12327;2660;765156;339695;35.6;15.8
75;2021-05-16;3864;760;769020;340455;35.8;15.8
75;2021-05-17;16015;4655;785035;345110;36.5;16.1
75;2021-05-18;19166;5326;804201;350436;37.4;16.3
75;2021-05-19;20737;10698;824938;361134;38.4;16.8
75;2021-05-20;21591;8664;846529;369798;39.4;17.2
75;2021-05-21;21034;6553;867563;376351;40.4;17.5
75;2021-05-22;15913;3302;883476;379653;41.1;17.7
75;2021-05-23;5639;1336;889115;380989;41.4;17.7
75;2021-05-24;15638;2560;904753;383549;42.1;17.9
75;2021-05-25;18042;9563;922795;393112;43.0;18.3
75;2021-05-26;18891;8204;941686;401316;43.8;18.7
75;2021-05-27;20152;9794;961838;411110;44.8;19.1
75;2021-05-28;19341;10843;981179;421953;45.7;19.6
75;2021-05-29;16117;5837;997296;427790;46.4;19.9
75;2021-05-30;7039;2156;1004335;429946;46.8;20.0
75;2021-05-31;18099;9436;1022434;439382;47.6;20.5
75;2021-06-01;18704;12982;1041138;452364;48.5;21.1
75;2021-06-02;18123;10303;1059261;462667;49.3;21.5
75;2021-06-03;20256;11957;1079517;474624;50.3;22.1
75;2021-06-04;18122;12846;1097639;487470;51.1;22.7
75;2021-06-05;11990;9614;1109629;497084;51.7;23.1
75;2021-06-06;6729;3163;1116358;500247;52.0;23.3
75;2021-06-07;13894;11830;1130252;512077;52.6;23.8
75;2021-06-08;14807;13969;1145059;526046;53.3;24.5
75;2021-06-09;16516;15235;1161575;541281;54.1;25.2
75;2021-06-10;18371;26294;1179946;567575;54.9;26.4
75;2021-06-11;15313;16459;1195259;584034;55.6;27.2
75;2021-06-12;13286;10004;1208545;594038;56.3;27.7
75;2021-06-13;6278;3794;1214823;597832;56.5;27.8
75;2021-06-14;11827;15394;1226650;613226;57.1;28.5
75;2021-06-15;12734;19553;1239384;632779;57.7;29.5
75;2021-06-16;12217;17240;1251601;650019;58.3;30.3
75;2021-06-17;12666;17679;1264267;667698;58.9;31.1
75;2021-06-18;11280;22610;1275547;690308;59.4;32.1
75;2021-06-19;7535;11823;1283082;702131;59.7;32.7
75;2021-06-20;2827;5478;1285909;707609;59.9;32.9
75;2021-06-21;8517;16332;1294426;723941;60.3;33.7
75;2021-06-22;8810;21791;1303236;745732;60.7;34.7
75;2021-06-23;10309;21431;1313545;767163;61.1;35.7
75;2021-06-24;11320;20639;1324865;787802;61.7;36.7
75;2021-06-25;9875;24687;1334740;812489;62.1;37.8
75;2021-06-26;7937;15420;1342677;827909;62.5;38.5
75;2021-06-27;2702;6324;1345379;834233;62.6;38.8
75;2021-06-28;8482;20156;1353861;854389;63.0;39.8
75;2021-06-29;9349;23831;1363210;878220;63.5;40.9
75;2021-06-30;10220;23626;1373430;901846;63.9;42.0
75;2021-07-01;11440;23516;1384870;925362;64.5;43.1
75;2021-07-02;10897;24772;1395767;950134;65.0;44.2
75;2021-07-03;7820;19805;1403587;969939;65.3;45.1
75;2021-07-04;3909;9557;1407496;979496;65.5;45.6
75;2021-07-05;9352;21583;1416848;1001079;66.0;46.6
75;2021-07-06;10179;24010;1427027;1025089;66.4;47.7
75;2021-07-07;10170;25091;1437197;1050180;66.9;48.9
75;2021-07-08;10675;25028;1447872;1075208;67.4;50.0
75;2021-07-09;10871;24038;1458743;1099246;67.9;51.2
75;2021-07-10;7954;18501;1466697;1117747;68.3;52.0
75;2021-07-11;4351;8528;1471048;1126275;68.5;52.4
75;2021-07-12;9864;23089;1480912;1149364;68.9;53.5
75;2021-07-13;14399;24816;1495311;1174180;69.6;54.7
75;2021-07-14;8359;9728;1503670;1183908;70.0;55.1
75;2021-07-15;15585;25665;1519255;1209573;70.7;56.3
75;2021-07-16;15830;22160;1535085;1231733;71.5;57.3
75;2021-07-17;12200;16913;1547285;1248646;72.0;58.1
75;2021-07-18;6269;6844;1553554;1255490;72.3;58.4
75;2021-07-19;14405;21303;1567959;1276793;73.0;59.4
75;2021-07-20;16077;21902;1584036;1298695;73.7;60.5
75;2021-07-21;15716;20713;1599752;1319408;74.5;61.4
75;2021-07-22;17159;20102;1616911;1339510;75.3;62.4
75;2021-07-23;17171;19116;1634082;1358626;76.1;63.2
75;2021-07-24;11200;14081;1645282;1372707;76.6;63.9
75;2021-07-25;5003;5068;1650285;1377775;76.8;64.1
75;2021-07-26;15182;16878;1665467;1394653;77.5;64.9
75;2021-07-27;18163;16679;1683630;1411332;78.4;65.7
75;2021-07-28;17159;15498;1700789;1426830;79.2;66.4
75;2021-07-29;16783;15101;1717572;1441931;80.0;67.1
75;2021-07-30;17084;14354;1734656;1456285;80.7;67.8
75;2021-07-31;9348;9872;1744004;1466157;81.2;68.2
75;2021-08-01;3730;3255;1747734;1469412;81.4;68.4
75;2021-08-02;10998;11991;1758732;1481403;81.9;69.0
75;2021-08-03;11160;10842;1769892;1492245;82.4;69.5
75;2021-08-04;9747;9485;1779639;1501730;82.8;69.9
75;2021-08-05;8732;9559;1788371;1511289;83.2;70.3
75;2021-08-06;8261;9996;1796632;1521285;83.6;70.8
75;2021-08-07;5716;7159;1802348;1528444;83.9;71.1
75;2021-08-08;1972;3282;1804320;1531726;84.0;71.3
75;2021-08-09;8620;11483;1812940;1543209;84.4;71.8
75;2021-08-10;9338;11597;1822278;1554806;84.8;72.4
75;2021-08-11;7831;10150;1830109;1564956;85.2;72.8
75;2021-08-12;6972;10601;1837081;1575557;85.5;73.3
75;2021-08-13;6273;8869;1843354;1584426;85.8;73.8
75;2021-08-14;4122;7199;1847476;1591625;86.0;74.1
75;2021-08-15;1032;1938;1848508;1593563;86.0;74.2
75;2021-08-16;6164;14033;1854672;1607596;86.3;74.8
75;2021-08-17;5902;13613;1860574;1621209;86.6;75.5
75;2021-08-18;5104;12012;1865678;1633221;86.8;76.0
75;2021-08-19;4808;12689;1870486;1645910;87.1;76.6
75;2021-08-20;4593;11790;1875079;1657700;87.3;77.2
75;2021-08-21;3194;8816;1878273;1666516;87.4;77.6
75;2021-08-22;999;3163;1879272;1669679;87.5;77.7
75;2021-08-23;4933;15308;1884205;1684987;87.7;78.4
75;2021-08-24;4815;14540;1889020;1699527;87.9;79.1
75;2021-08-25;4546;12336;1893566;1711863;88.1;79.7
75;2021-08-26;4109;10283;1897675;1722146;88.3;80.2
75;2021-08-27;4492;11688;1902167;1733834;88.5;80.7
75;2021-08-28;3079;8307;1905246;1742141;88.7;81.1
75;2021-08-29;756;2020;1906002;1744161;88.7;81.2
75;2021-08-30;4548;14032;1910550;1758193;88.9;81.8
75;2021-08-31;4442;12791;1914992;1770984;89.1;82.4
75;2021-09-01;4447;9854;1919439;1780838;89.3;82.9
75;2021-09-02;3471;7869;1922910;1788707;89.5;83.3
75;2021-09-03;3815;8707;1926725;1797414;89.7;83.7
75;2021-09-04;3616;7873;1930341;1805287;89.9;84.0
75;2021-09-05;740;1364;1931081;1806651;89.9;84.1
75;2021-09-06;2711;6568;1933792;1813219;90.0;84.4
75;2021-09-07;2477;6012;1936269;1819231;90.1;84.7
75;2021-09-08;2674;6034;1938943;1825265;90.3;85.0
75;2021-09-09;2505;5311;1941448;1830576;90.4;85.2
75;2021-09-10;3027;6202;1944475;1836778;90.5;85.5
75;2021-09-11;2458;6206;1946933;1842984;90.6;85.8
75;2021-09-12;514;1008;1947447;1843992;90.7;85.8
75;2021-09-13;2374;4917;1949821;1848909;90.8;86.1
75;2021-09-14;2351;4037;1952172;1852946;90.9;86.3
75;2021-09-15;2395;4662;1954567;1857608;91.0;86.5
75;2021-09-16;2015;3721;1956582;1861329;91.1;86.6
75;2021-09-17;2638;4770;1959220;1866099;91.2;86.9
75;2021-09-18;1586;4681;1960806;1870780;91.3;87.1
75;2021-09-19;291;739;1961097;1871519;91.3;87.1
75;2021-09-20;1756;3657;1962853;1875176;91.4;87.3
75;2021-09-21;1725;3207;1964578;1878383;91.4;87.4
75;2021-09-22;1609;3970;1966187;1882353;91.5;87.6
75;2021-09-23;1436;2856;1967623;1885209;91.6;87.8
75;2021-09-24;1819;4039;1969442;1889248;91.7;87.9
75;2021-09-25;1285;4357;1970727;1893605;91.7;88.1
75;2021-09-26;281;532;1971008;1894137;91.7;88.2
75;2021-09-27;1336;3023;1972344;1897160;91.8;88.3
75;2021-09-28;1418;2481;1973762;1899641;91.9;88.4
75;2021-09-29;1382;2882;1975144;1902523;91.9;88.6
75;2021-09-30;1272;2525;1976416;1905048;92.0;88.7
75;2021-10-01;1532;2697;1977948;1907745;92.1;88.8
75;2021-10-02;1425;2766;1979373;1910511;92.1;88.9
75;2021-10-03;224;426;1979597;1910937;92.1;89.0
75;2021-10-04;1363;2523;1980960;1913460;92.2;89.1
75;2021-10-05;1098;2178;1982058;1915638;92.3;89.2
75;2021-10-06;1227;2423;1983285;1918061;92.3;89.3
75;2021-10-07;1142;2071;1984427;1920132;92.4;89.4
75;2021-10-08;1498;3070;1985925;1923202;92.4;89.5
75;2021-10-09;1301;2247;1987226;1925449;92.5;89.6
75;2021-10-10;252;366;1987478;1925815;92.5;89.6
75;2021-10-11;1258;2225;1988736;1928040;92.6;89.7
75;2021-10-12;1230;2111;1989966;1930151;92.6;89.8
75;2021-10-13;1268;2140;1991234;1932291;92.7;89.9
75;2021-10-14;1202;2059;1992436;1934350;92.7;90.0
75;2021-10-15;1401;2497;1993837;1936847;92.8;90.2
75;2021-10-16;1276;2055;1995113;1938902;92.9;90.3
75;2021-10-17;277;502;1995390;1939404;92.9;90.3
75;2021-10-18;1156;2094;1996546;1941498;92.9;90.4
75;2021-10-19;1161;1987;1997707;1943485;93.0;90.5
76;2020-12-27;0;0;0;0;0.0;0.0
76;2020-12-28;1;1;1;1;0.0;0.0
76;2020-12-29;0;0;1;1;0.0;0.0
76;2020-12-30;0;0;1;1;0.0;0.0
76;2020-12-31;0;0;1;1;0.0;0.0
76;2021-01-01;0;0;1;1;0.0;0.0
76;2021-01-02;0;0;1;1;0.0;0.0
76;2021-01-03;0;0;1;1;0.0;0.0
76;2021-01-04;17;0;18;1;0.0;0.0
76;2021-01-05;138;0;156;1;0.0;0.0
76;2021-01-06;682;2;838;3;0.1;0.0
76;2021-01-07;1354;7;2192;10;0.2;0.0
76;2021-01-08;1537;2;3729;12;0.3;0.0
76;2021-01-09;736;2;4465;14;0.4;0.0
76;2021-01-10;492;2;4957;16;0.4;0.0
76;2021-01-11;1358;3;6315;19;0.5;0.0
76;2021-01-12;1358;3;7673;22;0.6;0.0
76;2021-01-13;1187;5;8860;27;0.7;0.0
76;2021-01-14;2178;24;11038;51;0.9;0.0
76;2021-01-15;1910;9;12948;60;1.0;0.0
76;2021-01-16;991;8;13939;68;1.1;0.0
76;2021-01-17;2898;23;16837;91;1.4;0.0
76;2021-01-18;4395;19;21232;110;1.7;0.0
76;2021-01-19;3022;11;24254;121;2.0;0.0
76;2021-01-20;2073;10;26327;131;2.1;0.0
76;2021-01-21;1772;4;28099;135;2.3;0.0
76;2021-01-22;1705;4;29804;139;2.4;0.0
76;2021-01-23;450;4;30254;143;2.4;0.0
76;2021-01-24;100;0;30354;143;2.4;0.0
76;2021-01-25;1476;139;31830;282;2.6;0.0
76;2021-01-26;1394;335;33224;617;2.7;0.0
76;2021-01-27;1341;433;34565;1050;2.8;0.1
76;2021-01-28;1286;385;35851;1435;2.9;0.1
76;2021-01-29;1155;458;37006;1893;3.0;0.2
76;2021-01-30;283;302;37289;2195;3.0;0.2
76;2021-01-31;4;98;37293;2293;3.0;0.2
76;2021-02-01;842;808;38135;3101;3.1;0.2
76;2021-02-02;1056;1018;39191;4119;3.2;0.3
76;2021-02-03;921;996;40112;5115;3.2;0.4
76;2021-02-04;976;1454;41088;6569;3.3;0.5
76;2021-02-05;975;1106;42063;7675;3.4;0.6
76;2021-02-06;264;878;42327;8553;3.4;0.7
76;2021-02-07;468;1654;42795;10207;3.4;0.8
76;2021-02-08;1925;3728;44720;13935;3.6;1.1
76;2021-02-09;1752;2989;46472;16924;3.7;1.4
76;2021-02-10;1490;1809;47962;18733;3.9;1.5
76;2021-02-11;1680;1529;49642;20262;4.0;1.6
76;2021-02-12;1704;1573;51346;21835;4.1;1.8
76;2021-02-13;230;337;51576;22172;4.1;1.8
76;2021-02-14;9;82;51585;22254;4.1;1.8
76;2021-02-15;552;1713;52137;23967;4.2;1.9
76;2021-02-16;742;1642;52879;25609;4.3;2.1
76;2021-02-17;626;1448;53505;27057;4.3;2.2
76;2021-02-18;780;1392;54285;28449;4.4;2.3
76;2021-02-19;870;1341;55155;29790;4.4;2.4
76;2021-02-20;270;287;55425;30077;4.5;2.4
76;2021-02-21;0;0;55425;30077;4.5;2.4
76;2021-02-22;371;1306;55796;31383;4.5;2.5
76;2021-02-23;576;1238;56372;32621;4.5;2.6
76;2021-02-24;601;1198;56973;33819;4.6;2.7
76;2021-02-25;1665;1265;58638;35084;4.7;2.8
76;2021-02-26;2171;1058;60809;36142;4.9;2.9
76;2021-02-27;1109;276;61918;36418;5.0;2.9
76;2021-02-28;27;196;61945;36614;5.0;2.9
76;2021-03-01;831;2090;62776;38704;5.0;3.1
76;2021-03-02;1381;1719;64157;40423;5.2;3.2
76;2021-03-03;1942;1392;66099;41815;5.3;3.4
76;2021-03-04;2818;1120;68917;42935;5.5;3.5
76;2021-03-05;4183;826;73100;43761;5.9;3.5
76;2021-03-06;3365;172;76465;43933;6.1;3.5
76;2021-03-07;1257;36;77722;43969;6.2;3.5
76;2021-03-08;2102;1262;79824;45231;6.4;3.6
76;2021-03-09;3575;1174;83399;46405;6.7;3.7
76;2021-03-10;3595;1075;86994;47480;7.0;3.8
76;2021-03-11;5635;951;92629;48431;7.4;3.9
76;2021-03-12;6830;619;99459;49050;8.0;3.9
76;2021-03-13;4646;157;104105;49207;8.4;4.0
76;2021-03-14;1068;28;105173;49235;8.5;4.0
76;2021-03-15;2920;245;108093;49480;8.7;4.0
76;2021-03-16;2557;404;110650;49884;8.9;4.0
76;2021-03-17;2695;318;113345;50202;9.1;4.0
76;2021-03-18;3004;318;116349;50520;9.4;4.1
76;2021-03-19;4398;441;120747;50961;9.7;4.1
76;2021-03-20;3974;301;124721;51262;10.0;4.1
76;2021-03-21;838;18;125559;51280;10.1;4.1
76;2021-03-22;3993;357;129552;51637;10.4;4.2
76;2021-03-23;5710;370;135262;52007;10.9;4.2
76;2021-03-24;5701;404;140963;52411;11.3;4.2
76;2021-03-25;7505;582;148468;52993;11.9;4.3
76;2021-03-26;8721;606;157189;53599;12.6;4.3
76;2021-03-27;4809;398;161998;53997;13.0;4.3
76;2021-03-28;1021;32;163019;54029;13.1;4.3
76;2021-03-29;5388;837;168407;54866;13.5;4.4
76;2021-03-30;6587;1068;174994;55934;14.1;4.5
76;2021-03-31;6462;1284;181456;57218;14.6;4.6
76;2021-04-01;6784;2045;188240;59263;15.1;4.8
76;2021-04-02;6485;2689;194725;61952;15.7;5.0
76;2021-04-03;2442;1083;197167;63035;15.9;5.1
76;2021-04-04;265;11;197432;63046;15.9;5.1
76;2021-04-05;869;379;198301;63425;15.9;5.1
76;2021-04-06;3557;2798;201858;66223;16.2;5.3
76;2021-04-07;4415;2412;206273;68635;16.6;5.5
76;2021-04-08;5839;2787;212112;71422;17.1;5.7
76;2021-04-09;8803;3087;220915;74509;17.8;6.0
76;2021-04-10;4876;1429;225791;75938;18.2;6.1
76;2021-04-11;814;535;226605;76473;18.2;6.1
76;2021-04-12;4726;2860;231331;79333;18.6;6.4
76;2021-04-13;5926;2872;237257;82205;19.1;6.6
76;2021-04-14;4803;3137;242060;85342;19.5;6.9
76;2021-04-15;5561;3364;247621;88706;19.9;7.1
76;2021-04-16;7356;3448;254977;92154;20.5;7.4
76;2021-04-17;4387;1435;259364;93589;20.9;7.5
76;2021-04-18;339;141;259703;93730;20.9;7.5
76;2021-04-19;3478;3781;263181;97511;21.2;7.8
76;2021-04-20;4344;4287;267525;101798;21.5;8.2
76;2021-04-21;4192;4697;271717;106495;21.8;8.6
76;2021-04-22;4564;5443;276281;111938;22.2;9.0
76;2021-04-23;5444;5980;281725;117918;22.7;9.5
76;2021-04-24;4165;2197;285890;120115;23.0;9.7
76;2021-04-25;895;269;286785;120384;23.1;9.7
76;2021-04-26;4484;4480;291269;124864;23.4;10.0
76;2021-04-27;5000;5010;296269;129874;23.8;10.4
76;2021-04-28;5348;4179;301617;134053;24.2;10.8
76;2021-04-29;6926;4177;308543;138230;24.8;11.1
76;2021-04-30;8219;4658;316762;142888;25.5;11.5
76;2021-05-01;4828;1017;321590;143905;25.9;11.6
76;2021-05-02;1842;265;323432;144170;26.0;11.6
76;2021-05-03;4703;3314;328135;147484;26.4;11.9
76;2021-05-04;4822;4562;332957;152046;26.8;12.2
76;2021-05-05;4783;5182;337740;157228;27.2;12.6
76;2021-05-06;5922;5588;343662;162816;27.6;13.1
76;2021-05-07;6137;6772;349799;169588;28.1;13.6
76;2021-05-08;5056;917;354855;170505;28.5;13.7
76;2021-05-09;2541;235;357396;170740;28.7;13.7
76;2021-05-10;4947;5069;362343;175809;29.1;14.1
76;2021-05-11;6519;5689;368862;181498;29.7;14.6
76;2021-05-12;6263;5086;375125;186584;30.2;15.0
76;2021-05-13;8842;1285;383967;187869;30.9;15.1
76;2021-05-14;10415;4664;394382;192533;31.7;15.5
76;2021-05-15;9122;2458;403504;194991;32.4;15.7
76;2021-05-16;6237;479;409741;195470;32.9;15.7
76;2021-05-17;7227;3276;416968;198746;33.5;16.0
76;2021-05-18;8304;2816;425272;201562;34.2;16.2
76;2021-05-19;8402;3199;433674;204761;34.9;16.5
76;2021-05-20;9650;3427;443324;208188;35.6;16.7
76;2021-05-21;8369;4097;451693;212285;36.3;17.1
76;2021-05-22;7163;2365;458856;214650;36.9;17.3
76;2021-05-23;6388;416;465244;215066;37.4;17.3
76;2021-05-24;6864;1528;472108;216594;38.0;17.4
76;2021-05-25;8024;4091;480132;220685;38.6;17.7
76;2021-05-26;7571;3611;487703;224296;39.2;18.0
76;2021-05-27;8340;4707;496043;229003;39.9;18.4
76;2021-05-28;8231;6572;504274;235575;40.5;18.9
76;2021-05-29;6225;3517;510499;239092;41.0;19.2
76;2021-05-30;3149;431;513648;239523;41.3;19.3
76;2021-05-31;8168;3973;521816;243496;42.0;19.6
76;2021-06-01;9209;5034;531025;248530;42.7;20.0
76;2021-06-02;7930;4447;538955;252977;43.3;20.3
76;2021-06-03;9540;5408;548495;258385;44.1;20.8
76;2021-06-04;9242;6699;557737;265084;44.8;21.3
76;2021-06-05;6285;3816;564022;268900;45.3;21.6
76;2021-06-06;2556;650;566578;269550;45.6;21.7
76;2021-06-07;6978;5455;573556;275005;46.1;22.1
76;2021-06-08;8661;6290;582217;281295;46.8;22.6
76;2021-06-09;7210;6083;589427;287378;47.4;23.1
76;2021-06-10;8000;6564;597427;293942;48.0;23.6
76;2021-06-11;7575;8240;605002;302182;48.6;24.3
76;2021-06-12;7166;5879;612168;308061;49.2;24.8
76;2021-06-13;2962;1295;615130;309356;49.5;24.9
76;2021-06-14;6486;6735;621616;316091;50.0;25.4
76;2021-06-15;6301;7479;627917;323570;50.5;26.0
76;2021-06-16;6651;7485;634568;331055;51.0;26.6
76;2021-06-17;7011;7760;641579;338815;51.6;27.2
76;2021-06-18;7687;9232;649266;348047;52.2;28.0
76;2021-06-19;5988;6260;655254;354307;52.7;28.5
76;2021-06-20;2809;1819;658063;356126;52.9;28.6
76;2021-06-21;5589;8176;663652;364302;53.4;29.3
76;2021-06-22;4923;9882;668575;374184;53.8;30.1
76;2021-06-23;4728;9435;673303;383619;54.1;30.8
76;2021-06-24;4796;9923;678099;393542;54.5;31.6
76;2021-06-25;5221;11585;683320;405127;54.9;32.6
76;2021-06-26;3454;7878;686774;413005;55.2;33.2
76;2021-06-27;1367;5162;688141;418167;55.3;33.6
76;2021-06-28;3612;9950;691753;428117;55.6;34.4
76;2021-06-29;3874;10228;695627;438345;55.9;35.2
76;2021-06-30;4267;9839;699894;448184;56.3;36.0
76;2021-07-01;4596;9909;704490;458093;56.6;36.8
76;2021-07-02;4368;12014;708858;470107;57.0;37.8
76;2021-07-03;3583;8450;712441;478557;57.3;38.5
76;2021-07-04;1487;5305;713928;483862;57.4;38.9
76;2021-07-05;3956;9333;717884;493195;57.7;39.7
76;2021-07-06;4056;10075;721940;503270;58.0;40.5
76;2021-07-07;4011;9328;725951;512598;58.4;41.2
76;2021-07-08;4466;9465;730417;522063;58.7;42.0
76;2021-07-09;4364;12413;734781;534476;59.1;43.0
76;2021-07-10;3138;8555;737919;543031;59.3;43.7
76;2021-07-11;1777;2821;739696;545852;59.5;43.9
76;2021-07-12;3155;11156;742851;557008;59.7;44.8
76;2021-07-13;4933;12264;747784;569272;60.1;45.8
76;2021-07-14;4803;5548;752587;574820;60.5;46.2
76;2021-07-15;5910;11790;758497;586610;61.0;47.2
76;2021-07-16;6719;12020;765216;598630;61.5;48.1
76;2021-07-17;5277;8709;770493;607339;61.9;48.8
76;2021-07-18;2257;3357;772750;610696;62.1;49.1
76;2021-07-19;5160;11155;777910;621851;62.5;50.0
76;2021-07-20;6275;11628;784185;633479;63.0;50.9
76;2021-07-21;6342;10571;790527;644050;63.6;51.8
76;2021-07-22;8241;9656;798768;653706;64.2;52.6
76;2021-07-23;7643;12005;806411;665711;64.8;53.5
76;2021-07-24;4992;7717;811403;673428;65.2;54.1
76;2021-07-25;2873;3138;814276;676566;65.5;54.4
76;2021-07-26;5432;10149;819708;686715;65.9;55.2
76;2021-07-27;8337;9558;828045;696273;66.6;56.0
76;2021-07-28;8269;7824;836314;704097;67.2;56.6
76;2021-07-29;9591;6991;845905;711088;68.0;57.2
76;2021-07-30;8011;7849;853916;718937;68.7;57.8
76;2021-07-31;6616;5336;860532;724273;69.2;58.2
76;2021-08-01;3863;2087;864395;726360;69.5;58.4
76;2021-08-02;6563;7101;870958;733461;70.0;59.0
76;2021-08-03;7973;6362;878931;739823;70.7;59.5
76;2021-08-04;7258;5847;886189;745670;71.2;60.0
76;2021-08-05;8100;5733;894289;751403;71.9;60.4
76;2021-08-06;6810;6877;901099;758280;72.4;61.0
76;2021-08-07;4792;4388;905891;762668;72.8;61.3
76;2021-08-08;2409;2158;908300;764826;73.0;61.5
76;2021-08-09;5638;6740;913938;771566;73.5;62.0
76;2021-08-10;6351;6557;920289;778123;74.0;62.6
76;2021-08-11;6452;5498;926741;783621;74.5;63.0
76;2021-08-12;6046;6063;932787;789684;75.0;63.5
76;2021-08-13;5059;6212;937846;795896;75.4;64.0
76;2021-08-14;3840;4600;941686;800496;75.7;64.4
76;2021-08-15;1579;2356;943265;802852;75.8;64.5
76;2021-08-16;3668;6719;946933;809571;76.1;65.1
76;2021-08-17;3919;6946;950852;816517;76.4;65.6
76;2021-08-18;3747;6738;954599;823255;76.7;66.2
76;2021-08-19;3390;7173;957989;830428;77.0;66.8
76;2021-08-20;3434;7831;961423;838259;77.3;67.4
76;2021-08-21;1825;4221;963248;842480;77.4;67.7
76;2021-08-22;871;3295;964119;845775;77.5;68.0
76;2021-08-23;2624;7761;966743;853536;77.7;68.6
76;2021-08-24;2824;7592;969567;861128;78.0;69.2
76;2021-08-25;2631;7079;972198;868207;78.2;69.8
76;2021-08-26;2074;5800;974272;874007;78.3;70.3
76;2021-08-27;2702;7952;976974;881959;78.5;70.9
76;2021-08-28;2138;6064;979112;888023;78.7;71.4
76;2021-08-29;698;3015;979810;891038;78.8;71.6
76;2021-08-30;2168;7348;981978;898386;79.0;72.2
76;2021-08-31;1945;7139;983923;905525;79.1;72.8
76;2021-09-01;1731;6410;985654;911935;79.2;73.3
76;2021-09-02;1307;4506;986961;916441;79.4;73.7
76;2021-09-03;1593;6603;988554;923044;79.5;74.2
76;2021-09-04;1622;5990;990176;929034;79.6;74.7
76;2021-09-05;637;1820;990813;930854;79.7;74.8
76;2021-09-06;1352;4372;992165;935226;79.8;75.2
76;2021-09-07;1170;3721;993335;938947;79.9;75.5
76;2021-09-08;1278;4459;994613;943406;80.0;75.8
76;2021-09-09;1096;2918;995709;946324;80.1;76.1
76;2021-09-10;1704;4032;997413;950356;80.2;76.4
76;2021-09-11;1167;3204;998580;953560;80.3;76.7
76;2021-09-12;286;828;998866;954388;80.3;76.7
76;2021-09-13;830;2191;999696;956579;80.4;76.9
76;2021-09-14;1379;2623;1001075;959202;80.5;77.1
76;2021-09-15;1175;3272;1002250;962474;80.6;77.4
76;2021-09-16;1276;1960;1003526;964434;80.7;77.5
76;2021-09-17;1413;2904;1004939;967338;80.8;77.8
76;2021-09-18;735;2513;1005674;969851;80.9;78.0
76;2021-09-19;197;778;1005871;970629;80.9;78.0
76;2021-09-20;846;1811;1006717;972440;80.9;78.2
76;2021-09-21;770;1599;1007487;974039;81.0;78.3
76;2021-09-22;677;2298;1008164;976337;81.1;78.5
76;2021-09-23;759;1172;1008923;977509;81.1;78.6
76;2021-09-24;1069;2044;1009992;979553;81.2;78.8
76;2021-09-25;575;2130;1010567;981683;81.2;78.9
76;2021-09-26;126;416;1010693;982099;81.3;79.0
76;2021-09-27;627;1347;1011320;983446;81.3;79.1
76;2021-09-28;505;1126;1011825;984572;81.4;79.2
76;2021-09-29;786;1590;1012611;986162;81.4;79.3
76;2021-09-30;425;884;1013036;987046;81.4;79.4
76;2021-10-01;861;1706;1013897;988752;81.5;79.5
76;2021-10-02;586;1313;1014483;990065;81.6;79.6
76;2021-10-03;129;386;1014612;990451;81.6;79.6
76;2021-10-04;599;1144;1015211;991595;81.6;79.7
76;2021-10-05;483;1021;1015694;992616;81.7;79.8
76;2021-10-06;460;899;1016154;993515;81.7;79.9
76;2021-10-07;386;842;1016540;994357;81.7;79.9
76;2021-10-08;906;1931;1017446;996288;81.8;80.1
76;2021-10-09;587;1003;1018033;997291;81.8;80.2
76;2021-10-10;71;77;1018104;997368;81.9;80.2
76;2021-10-11;509;1061;1018613;998429;81.9;80.3
76;2021-10-12;498;888;1019111;999317;81.9;80.3
76;2021-10-13;586;1043;1019697;1000360;82.0;80.4
76;2021-10-14;387;693;1020084;1001053;82.0;80.5
76;2021-10-15;792;1385;1020876;1002438;82.1;80.6
76;2021-10-16;407;540;1021283;1002978;82.1;80.6
76;2021-10-17;96;242;1021379;1003220;82.1;80.7
76;2021-10-18;401;768;1021780;1003988;82.2;80.7
76;2021-10-19;481;813;1022261;1004801;82.2;80.8
77;2020-12-27;1;0;1;0;0.0;0.0
77;2020-12-28;2;0;3;0;0.0;0.0
77;2020-12-29;0;0;3;0;0.0;0.0
77;2020-12-30;0;0;3;0;0.0;0.0
77;2020-12-31;0;0;3;0;0.0;0.0
77;2021-01-01;4;0;7;0;0.0;0.0
77;2021-01-02;2;2;9;2;0.0;0.0
77;2021-01-03;0;0;9;2;0.0;0.0
77;2021-01-04;7;0;16;2;0.0;0.0
77;2021-01-05;200;0;216;2;0.0;0.0
77;2021-01-06;237;2;453;4;0.0;0.0
77;2021-01-07;522;4;975;8;0.1;0.0
77;2021-01-08;621;1;1596;9;0.1;0.0
77;2021-01-09;273;1;1869;10;0.1;0.0
77;2021-01-10;235;2;2104;12;0.1;0.0
77;2021-01-11;783;4;2887;16;0.2;0.0
77;2021-01-12;884;1;3771;17;0.3;0.0
77;2021-01-13;941;3;4712;20;0.3;0.0
77;2021-01-14;849;7;5561;27;0.4;0.0
77;2021-01-15;860;11;6421;38;0.5;0.0
77;2021-01-16;168;1;6589;39;0.5;0.0
77;2021-01-17;132;2;6721;41;0.5;0.0
77;2021-01-18;1196;5;7917;46;0.6;0.0
77;2021-01-19;1722;24;9639;70;0.7;0.0
77;2021-01-20;2542;13;12181;83;0.9;0.0
77;2021-01-21;2062;30;14243;113;1.0;0.0
77;2021-01-22;1148;8;15391;121;1.1;0.0
77;2021-01-23;348;0;15739;121;1.1;0.0
77;2021-01-24;45;0;15784;121;1.1;0.0
77;2021-01-25;940;25;16724;146;1.2;0.0
77;2021-01-26;1715;27;18439;173;1.3;0.0
77;2021-01-27;1364;29;19803;202;1.4;0.0
77;2021-01-28;1698;94;21501;296;1.5;0.0
77;2021-01-29;1289;148;22790;444;1.6;0.0
77;2021-01-30;211;2;23001;446;1.6;0.0
77;2021-01-31;1;0;23002;446;1.6;0.0
77;2021-02-01;571;211;23573;657;1.7;0.0
77;2021-02-02;872;266;24445;923;1.7;0.1
77;2021-02-03;794;524;25239;1447;1.8;0.1
77;2021-02-04;789;808;26028;2255;1.8;0.2
77;2021-02-05;858;849;26886;3104;1.9;0.2
77;2021-02-06;165;101;27051;3205;1.9;0.2
77;2021-02-07;17;93;27068;3298;1.9;0.2
77;2021-02-08;498;938;27566;4236;1.9;0.3
77;2021-02-09;590;1465;28156;5701;2.0;0.4
77;2021-02-10;1031;1838;29187;7539;2.1;0.5
77;2021-02-11;1059;1655;30246;9194;2.1;0.6
77;2021-02-12;1098;1173;31344;10367;2.2;0.7
77;2021-02-13;189;177;31533;10544;2.2;0.7
77;2021-02-14;12;56;31545;10600;2.2;0.7
77;2021-02-15;555;1023;32100;11623;2.3;0.8
77;2021-02-16;598;1533;32698;13156;2.3;0.9
77;2021-02-17;515;1186;33213;14342;2.3;1.0
77;2021-02-18;839;1615;34052;15957;2.4;1.1
77;2021-02-19;778;1102;34830;17059;2.4;1.2
77;2021-02-20;55;176;34885;17235;2.5;1.2
77;2021-02-21;7;31;34892;17266;2.5;1.2
77;2021-02-22;304;770;35196;18036;2.5;1.3
77;2021-02-23;360;1126;35556;19162;2.5;1.3
77;2021-02-24;512;896;36068;20058;2.5;1.4
77;2021-02-25;793;963;36861;21021;2.6;1.5
77;2021-02-26;840;839;37701;21860;2.6;1.5
77;2021-02-27;459;170;38160;22030;2.7;1.5
77;2021-02-28;33;5;38193;22035;2.7;1.5
77;2021-03-01;680;715;38873;22750;2.7;1.6
77;2021-03-02;1094;1025;39967;23775;2.8;1.7
77;2021-03-03;1957;1193;41924;24968;2.9;1.8
77;2021-03-04;2794;1147;44718;26115;3.1;1.8
77;2021-03-05;3374;1058;48092;27173;3.4;1.9
77;2021-03-06;4827;276;52919;27449;3.7;1.9
77;2021-03-07;3198;118;56117;27567;3.9;1.9
77;2021-03-08;1230;507;57347;28074;4.0;2.0
77;2021-03-09;2507;642;59854;28716;4.2;2.0
77;2021-03-10;2397;584;62251;29300;4.4;2.1
77;2021-03-11;3504;794;65755;30094;4.6;2.1
77;2021-03-12;3891;697;69646;30791;4.9;2.2
77;2021-03-13;4478;213;74124;31004;5.2;2.2
77;2021-03-14;2154;125;76278;31129;5.4;2.2
77;2021-03-15;2511;281;78789;31410;5.5;2.2
77;2021-03-16;2444;381;81233;31791;5.7;2.2
77;2021-03-17;2555;438;83788;32229;5.9;2.3
77;2021-03-18;3010;404;86798;32633;6.1;2.3
77;2021-03-19;3357;440;90155;33073;6.3;2.3
77;2021-03-20;1967;79;92122;33152;6.5;2.3
77;2021-03-21;244;14;92366;33166;6.5;2.3
77;2021-03-22;3019;408;95385;33574;6.7;2.4
77;2021-03-23;4519;537;99904;34111;7.0;2.4
77;2021-03-24;4155;623;104059;34734;7.3;2.4
77;2021-03-25;5907;413;109966;35147;7.7;2.5
77;2021-03-26;6268;455;116234;35602;8.2;2.5
77;2021-03-27;3323;127;119557;35729;8.4;2.5
77;2021-03-28;1731;50;121288;35779;8.5;2.5
77;2021-03-29;2654;693;123942;36472;8.7;2.6
77;2021-03-30;3995;1194;127937;37666;9.0;2.6
77;2021-03-31;3759;1231;131696;38897;9.3;2.7
77;2021-04-01;4141;1843;135837;40740;9.5;2.9
77;2021-04-02;3991;2022;139828;42762;9.8;3.0
77;2021-04-03;1743;2283;141571;45045;9.9;3.2
77;2021-04-04;420;1428;141991;46473;10.0;3.3
77;2021-04-05;162;163;142153;46636;10.0;3.3
77;2021-04-06;2723;1931;144876;48567;10.2;3.4
77;2021-04-07;3321;2090;148197;50657;10.4;3.6
77;2021-04-08;4531;2372;152728;53029;10.7;3.7
77;2021-04-09;4854;2096;157582;55125;11.1;3.9
77;2021-04-10;3075;2756;160657;57881;11.3;4.1
77;2021-04-11;586;720;161243;58601;11.3;4.1
77;2021-04-12;2230;1829;163473;60430;11.5;4.2
77;2021-04-13;3359;2647;166832;63077;11.7;4.4
77;2021-04-14;2518;2657;169350;65734;11.9;4.6
77;2021-04-15;3319;3122;172669;68856;12.1;4.8
77;2021-04-16;3576;2727;176245;71583;12.4;5.0
77;2021-04-17;1386;479;177631;72062;12.5;5.1
77;2021-04-18;150;11;177781;72073;12.5;5.1
77;2021-04-19;2083;2514;179864;74587;12.6;5.2
77;2021-04-20;2572;3383;182436;77970;12.8;5.5
77;2021-04-21;2195;3480;184631;81450;13.0;5.7
77;2021-04-22;3002;3864;187633;85314;13.2;6.0
77;2021-04-23;3532;3638;191165;88952;13.4;6.2
77;2021-04-24;4899;2520;196064;91472;13.8;6.4
77;2021-04-25;4079;1248;200143;92720;14.1;6.5
77;2021-04-26;3224;2044;203367;94764;14.3;6.7
77;2021-04-27;3996;2520;207363;97284;14.6;6.8
77;2021-04-28;4067;2621;211430;99905;14.9;7.0
77;2021-04-29;4480;3085;215910;102990;15.2;7.2
77;2021-04-30;4911;3346;220821;106336;15.5;7.5
77;2021-05-01;2466;600;223287;106936;15.7;7.5
77;2021-05-02;3141;278;226428;107214;15.9;7.5
77;2021-05-03;5991;2082;232419;109296;16.3;7.7
77;2021-05-04;6437;2995;238856;112291;16.8;7.9
77;2021-05-05;6019;3028;244875;115319;17.2;8.1
77;2021-05-06;6886;3599;251761;118918;17.7;8.4
77;2021-05-07;8204;3273;259965;122191;18.3;8.6
77;2021-05-08;5718;816;265683;123007;18.7;8.6
77;2021-05-09;4905;484;270588;123491;19.0;8.7
77;2021-05-10;8086;2330;278674;125821;19.6;8.8
77;2021-05-11;9578;2923;288252;128744;20.2;9.0
77;2021-05-12;8977;2284;297229;131028;20.9;9.2
77;2021-05-13;9302;884;306531;131912;21.5;9.3
77;2021-05-14;10437;1673;316968;133585;22.3;9.4
77;2021-05-15;8991;1248;325959;134833;22.9;9.5
77;2021-05-16;5152;470;331111;135303;23.3;9.5
77;2021-05-17;10373;1481;341484;136784;24.0;9.6
77;2021-05-18;11787;1806;353271;138590;24.8;9.7
77;2021-05-19;10918;1606;364189;140196;25.6;9.8
77;2021-05-20;12215;2157;376404;142353;26.4;10.0
77;2021-05-21;11651;2696;388055;145049;27.3;10.2
77;2021-05-22;9816;1742;397871;146791;27.9;10.3
77;2021-05-23;6977;818;404848;147609;28.4;10.4
77;2021-05-24;6762;779;411610;148388;28.9;10.4
77;2021-05-25;8315;2818;419925;151206;29.5;10.6
77;2021-05-26;7561;2980;427486;154186;30.0;10.8
77;2021-05-27;7552;3968;435038;158154;30.6;11.1
77;2021-05-28;7634;4011;442672;162165;31.1;11.4
77;2021-05-29;7353;2332;450025;164497;31.6;11.6
77;2021-05-30;4356;891;454381;165388;31.9;11.6
77;2021-05-31;8382;3836;462763;169224;32.5;11.9
77;2021-06-01;9644;4383;472407;173607;33.2;12.2
77;2021-06-02;9006;3931;481413;177538;33.8;12.5
77;2021-06-03;9001;5282;490414;182820;34.4;12.8
77;2021-06-04;9114;5496;499528;188316;35.1;13.2
77;2021-06-05;6659;4991;506187;193307;35.6;13.6
77;2021-06-06;4909;3210;511096;196517;35.9;13.8
77;2021-06-07;6421;4540;517517;201057;36.4;14.1
77;2021-06-08;5726;5228;523243;206285;36.8;14.5
77;2021-06-09;5059;4962;528302;211247;37.1;14.8
77;2021-06-10;5014;5459;533316;216706;37.5;15.2
77;2021-06-11;5752;6029;539068;222735;37.9;15.6
77;2021-06-12;6544;4752;545612;227487;38.3;16.0
77;2021-06-13;3508;3053;549120;230540;38.6;16.2
77;2021-06-14;3222;7933;552342;238473;38.8;16.8
77;2021-06-15;4128;8484;556470;246957;39.1;17.3
77;2021-06-16;4803;8378;561273;255335;39.4;17.9
77;2021-06-17;4467;9029;565740;264364;39.7;18.6
77;2021-06-18;4364;9788;570104;274152;40.0;19.3
77;2021-06-19;5306;6931;575410;281083;40.4;19.7
77;2021-06-20;2095;3800;577505;284883;40.6;20.0
77;2021-06-21;3228;9577;580733;294460;40.8;20.7
77;2021-06-22;3665;11378;584398;305838;41.1;21.5
77;2021-06-23;3443;10053;587841;315891;41.3;22.2
77;2021-06-24;3359;10923;591200;326814;41.5;23.0
77;2021-06-25;3623;10800;594823;337614;41.8;23.7
77;2021-06-26;4085;10070;598908;347684;42.1;24.4
77;2021-06-27;2124;6431;601032;354115;42.2;24.9
77;2021-06-28;2797;10831;603829;364946;42.4;25.6
77;2021-06-29;3414;12531;607243;377477;42.7;26.5
77;2021-06-30;3291;11452;610534;388929;42.9;27.3
77;2021-07-01;3296;11657;613830;400586;43.1;28.1
77;2021-07-02;3464;12256;617294;412842;43.4;29.0
77;2021-07-03;3182;10803;620476;423645;43.6;29.8
77;2021-07-04;1996;6490;622472;430135;43.7;30.2
77;2021-07-05;3584;9541;626056;439676;44.0;30.9
77;2021-07-06;3737;9531;629793;449207;44.2;31.6
77;2021-07-07;4051;8952;633844;458159;44.5;32.2
77;2021-07-08;3934;8759;637778;466918;44.8;32.8
77;2021-07-09;4712;10343;642490;477261;45.1;33.5
77;2021-07-10;4043;9842;646533;487103;45.4;34.2
77;2021-07-11;3090;5094;649623;492197;45.6;34.6
77;2021-07-12;3285;10870;652908;503067;45.9;35.3
77;2021-07-13;6163;12041;659071;515108;46.3;36.2
77;2021-07-14;3603;6449;662674;521557;46.5;36.6
77;2021-07-15;7189;11980;669863;533537;47.1;37.5
77;2021-07-16;7825;9893;677688;543430;47.6;38.2
77;2021-07-17;5792;9467;683480;552897;48.0;38.8
77;2021-07-18;4139;5331;687619;558228;48.3;39.2
77;2021-07-19;7516;8958;695135;567186;48.8;39.8
77;2021-07-20;9670;8048;704805;575234;49.5;40.4
77;2021-07-21;9523;7489;714328;582723;50.2;40.9
77;2021-07-22;10561;7562;724889;590285;50.9;41.5
77;2021-07-23;9878;8213;734767;598498;51.6;42.0
77;2021-07-24;7215;7879;741982;606377;52.1;42.6
77;2021-07-25;5897;4038;747879;610415;52.5;42.9
77;2021-07-26;9209;5972;757088;616387;53.2;43.3
77;2021-07-27;10952;6049;768040;622436;54.0;43.7
77;2021-07-28;9490;6429;777530;628865;54.6;44.2
77;2021-07-29;9536;5520;787066;634385;55.3;44.6
77;2021-07-30;9744;6372;796810;640757;56.0;45.0
77;2021-07-31;7265;6634;804075;647391;56.5;45.5
77;2021-08-01;2954;1216;807029;648607;56.7;45.6
77;2021-08-02;7134;5733;814163;654340;57.2;46.0
77;2021-08-03;5856;4530;820019;658870;57.6;46.3
77;2021-08-04;4741;4389;824760;663259;57.9;46.6
77;2021-08-05;3259;2975;828019;666234;58.2;46.8
77;2021-08-06;5979;5265;833998;671499;58.6;47.2
77;2021-08-07;5296;6797;839294;678296;59.0;47.6
77;2021-08-08;1979;1863;841273;680159;59.1;47.8
77;2021-08-09;5093;6584;846366;686743;59.5;48.2
77;2021-08-10;2713;3581;849079;690324;59.6;48.5
77;2021-08-11;3143;6243;852222;696567;59.9;48.9
77;2021-08-12;2282;3577;854504;700144;60.0;49.2
77;2021-08-13;2736;4897;857240;705041;60.2;49.5
77;2021-08-14;2960;7334;860200;712375;60.4;50.0
77;2021-08-15;789;773;860989;713148;60.5;50.1
77;2021-08-16;2479;6985;863468;720133;60.7;50.6
77;2021-08-17;2896;7215;866364;727348;60.9;51.1
77;2021-08-18;2686;6566;869050;733914;61.0;51.6
77;2021-08-19;2654;5106;871704;739020;61.2;51.9
77;2021-08-20;2712;5686;874416;744706;61.4;52.3
77;2021-08-21;2717;7339;877133;752045;61.6;52.8
77;2021-08-22;1735;5346;878868;757391;61.7;53.2
77;2021-08-23;2516;9622;881384;767013;61.9;53.9
77;2021-08-24;3069;9244;884453;776257;62.1;54.5
77;2021-08-25;2564;6542;887017;782799;62.3;55.0
77;2021-08-26;2559;6258;889576;789057;62.5;55.4
77;2021-08-27;2782;6998;892358;796055;62.7;55.9
77;2021-08-28;1976;7253;894334;803308;62.8;56.4
77;2021-08-29;1484;5152;895818;808460;62.9;56.8
77;2021-08-30;2525;8048;898343;816508;63.1;57.4
77;2021-08-31;2851;5601;901194;822109;63.3;57.7
77;2021-09-01;2304;3523;903498;825632;63.5;58.0
77;2021-09-02;1614;2812;905112;828444;63.6;58.2
77;2021-09-03;2138;4139;907250;832583;63.7;58.5
77;2021-09-04;2421;5583;909671;838166;63.9;58.9
77;2021-09-05;903;1371;910574;839537;64.0;59.0
77;2021-09-06;1068;1891;911642;841428;64.0;59.1
77;2021-09-07;849;2020;912491;843448;64.1;59.2
77;2021-09-08;1715;3073;914206;846521;64.2;59.5
77;2021-09-09;986;1844;915192;848365;64.3;59.6
77;2021-09-10;1196;2202;916388;850567;64.4;59.7
77;2021-09-11;2049;5404;918437;855971;64.5;60.1
77;2021-09-12;523;1353;918960;857324;64.6;60.2
77;2021-09-13;882;1725;919842;859049;64.6;60.3
77;2021-09-14;1027;1630;920869;860679;64.7;60.5
77;2021-09-15;1182;2531;922051;863210;64.8;60.6
77;2021-09-16;960;1499;923011;864709;64.8;60.7
77;2021-09-17;1160;2023;924171;866732;64.9;60.9
77;2021-09-18;1307;3583;925478;870315;65.0;61.1
77;2021-09-19;234;1182;925712;871497;65.0;61.2
77;2021-09-20;840;1628;926552;873125;65.1;61.3
77;2021-09-21;802;1506;927354;874631;65.1;61.4
77;2021-09-22;758;2486;928112;877117;65.2;61.6
77;2021-09-23;572;1511;928684;878628;65.2;61.7
77;2021-09-24;839;1951;929523;880579;65.3;61.9
77;2021-09-25;1011;3962;930534;884541;65.4;62.1
77;2021-09-26;205;759;930739;885300;65.4;62.2
77;2021-09-27;653;1313;931392;886613;65.4;62.3
77;2021-09-28;776;846;932168;887459;65.5;62.3
77;2021-09-29;946;1983;933114;889442;65.5;62.5
77;2021-09-30;588;938;933702;890380;65.6;62.5
77;2021-10-01;628;1026;934330;891406;65.6;62.6
77;2021-10-02;948;2107;935278;893513;65.7;62.8
77;2021-10-03;130;471;935408;893984;65.7;62.8
77;2021-10-04;412;720;935820;894704;65.7;62.8
77;2021-10-05;333;733;936153;895437;65.8;62.9
77;2021-10-06;536;1284;936689;896721;65.8;63.0
77;2021-10-07;390;726;937079;897447;65.8;63.0
77;2021-10-08;636;1220;937715;898667;65.9;63.1
77;2021-10-09;846;1988;938561;900655;65.9;63.3
77;2021-10-10;33;55;938594;900710;65.9;63.3
77;2021-10-11;567;859;939161;901569;66.0;63.3
77;2021-10-12;495;884;939656;902453;66.0;63.4
77;2021-10-13;751;974;940407;903427;66.1;63.5
77;2021-10-14;400;602;940807;904029;66.1;63.5
77;2021-10-15;605;1027;941412;905056;66.1;63.6
77;2021-10-16;848;1183;942260;906239;66.2;63.7
77;2021-10-17;35;42;942295;906281;66.2;63.7
77;2021-10-18;527;734;942822;907015;66.2;63.7
77;2021-10-19;376;812;943198;907827;66.3;63.8
78;2020-12-27;2;0;2;0;0.0;0.0
78;2020-12-28;1;1;3;1;0.0;0.0
78;2020-12-29;0;0;3;1;0.0;0.0
78;2020-12-30;1;0;4;1;0.0;0.0
78;2020-12-31;15;0;19;1;0.0;0.0
78;2021-01-01;1;0;20;1;0.0;0.0
78;2021-01-02;1;0;21;1;0.0;0.0
78;2021-01-03;3;1;24;2;0.0;0.0
78;2021-01-04;145;3;169;5;0.0;0.0
78;2021-01-05;175;1;344;6;0.0;0.0
78;2021-01-06;208;4;552;10;0.0;0.0
78;2021-01-07;468;2;1020;12;0.1;0.0
78;2021-01-08;651;5;1671;17;0.1;0.0
78;2021-01-09;22;0;1693;17;0.1;0.0
78;2021-01-10;2;0;1695;17;0.1;0.0
78;2021-01-11;792;4;2487;21;0.2;0.0
78;2021-01-12;945;5;3432;26;0.2;0.0
78;2021-01-13;741;10;4173;36;0.3;0.0
78;2021-01-14;812;10;4985;46;0.3;0.0
78;2021-01-15;849;11;5834;57;0.4;0.0
78;2021-01-16;32;1;5866;58;0.4;0.0
78;2021-01-17;0;0;5866;58;0.4;0.0
78;2021-01-18;1384;21;7250;79;0.5;0.0
78;2021-01-19;1842;27;9092;106;0.6;0.0
78;2021-01-20;1651;19;10743;125;0.7;0.0
78;2021-01-21;3259;18;14002;143;1.0;0.0
78;2021-01-22;2217;20;16219;163;1.1;0.0
78;2021-01-23;280;0;16499;163;1.1;0.0
78;2021-01-24;5;0;16504;163;1.1;0.0
78;2021-01-25;957;31;17461;194;1.2;0.0
78;2021-01-26;1560;22;19021;216;1.3;0.0
78;2021-01-27;2063;51;21084;267;1.5;0.0
78;2021-01-28;2439;113;23523;380;1.6;0.0
78;2021-01-29;1492;64;25015;444;1.7;0.0
78;2021-01-30;210;2;25225;446;1.7;0.0
78;2021-01-31;3;0;25228;446;1.7;0.0
78;2021-02-01;788;224;26016;670;1.8;0.0
78;2021-02-02;967;346;26983;1016;1.9;0.1
78;2021-02-03;977;240;27960;1256;1.9;0.1
78;2021-02-04;1117;446;29077;1702;2.0;0.1
78;2021-02-05;1191;504;30268;2206;2.1;0.2
78;2021-02-06;200;46;30468;2252;2.1;0.2
78;2021-02-07;139;14;30607;2266;2.1;0.2
78;2021-02-08;763;606;31370;2872;2.2;0.2
78;2021-02-09;1121;946;32491;3818;2.2;0.3
78;2021-02-10;1245;1179;33736;4997;2.3;0.3
78;2021-02-11;1820;1894;35556;6891;2.5;0.5
78;2021-02-12;1820;1388;37376;8279;2.6;0.6
78;2021-02-13;173;76;37549;8355;2.6;0.6
78;2021-02-14;27;26;37576;8381;2.6;0.6
78;2021-02-15;447;1431;38023;9812;2.6;0.7
78;2021-02-16;628;1562;38651;11374;2.7;0.8
78;2021-02-17;588;2221;39239;13595;2.7;0.9
78;2021-02-18;997;2278;40236;15873;2.8;1.1
78;2021-02-19;822;1721;41058;17594;2.8;1.2
78;2021-02-20;150;125;41208;17719;2.8;1.2
78;2021-02-21;0;12;41208;17731;2.8;1.2
78;2021-02-22;503;1060;41711;18791;2.9;1.3
78;2021-02-23;540;1126;42251;19917;2.9;1.4
78;2021-02-24;620;1246;42871;21163;3.0;1.5
78;2021-02-25;867;1154;43738;22317;3.0;1.5
78;2021-02-26;1131;1241;44869;23558;3.1;1.6
78;2021-02-27;740;151;45609;23709;3.1;1.6
78;2021-02-28;68;18;45677;23727;3.2;1.6
78;2021-03-01;966;908;46643;24635;3.2;1.7
78;2021-03-02;1727;1059;48370;25694;3.3;1.8
78;2021-03-03;1967;1243;50337;26937;3.5;1.9
78;2021-03-04;2952;1604;53289;28541;3.7;2.0
78;2021-03-05;3260;1674;56549;30215;3.9;2.1
78;2021-03-06;6244;326;62793;30541;4.3;2.1
78;2021-03-07;3444;108;66237;30649;4.6;2.1
78;2021-03-08;1462;764;67699;31413;4.7;2.2
78;2021-03-09;2944;917;70643;32330;4.9;2.2
78;2021-03-10;3083;1131;73726;33461;5.1;2.3
78;2021-03-11;4180;1322;77906;34783;5.4;2.4
78;2021-03-12;5373;1369;83279;36152;5.7;2.5
78;2021-03-13;4657;211;87936;36363;6.1;2.5
78;2021-03-14;1038;42;88974;36405;6.1;2.5
78;2021-03-15;3622;272;92596;36677;6.4;2.5
78;2021-03-16;2570;579;95166;37256;6.6;2.6
78;2021-03-17;2970;449;98136;37705;6.8;2.6
78;2021-03-18;3779;461;101915;38166;7.0;2.6
78;2021-03-19;5318;502;107233;38668;7.4;2.7
78;2021-03-20;2260;134;109493;38802;7.6;2.7
78;2021-03-21;167;7;109660;38809;7.6;2.7
78;2021-03-22;3530;384;113190;39193;7.8;2.7
78;2021-03-23;5231;554;118421;39747;8.2;2.7
78;2021-03-24;4891;563;123312;40310;8.5;2.8
78;2021-03-25;6940;581;130252;40891;9.0;2.8
78;2021-03-26;6944;730;137196;41621;9.5;2.9
78;2021-03-27;3745;203;140941;41824;9.7;2.9
78;2021-03-28;1919;56;142860;41880;9.9;2.9
78;2021-03-29;3863;768;146723;42648;10.1;2.9
78;2021-03-30;5526;1063;152249;43711;10.5;3.0
78;2021-03-31;5334;1308;157583;45019;10.9;3.1
78;2021-04-01;5592;2377;163175;47396;11.3;3.3
78;2021-04-02;5194;2638;168369;50034;11.6;3.5
78;2021-04-03;2197;2568;170566;52602;11.8;3.6
78;2021-04-04;174;14;170740;52616;11.8;3.6
78;2021-04-05;199;20;170939;52636;11.8;3.6
78;2021-04-06;3617;2312;174556;54948;12.0;3.8
78;2021-04-07;4357;2595;178913;57543;12.4;4.0
78;2021-04-08;5523;2679;184436;60222;12.7;4.2
78;2021-04-09;6907;2463;191343;62685;13.2;4.3
78;2021-04-10;3995;1911;195338;64596;13.5;4.5
78;2021-04-11;374;608;195712;65204;13.5;4.5
78;2021-04-12;3530;2370;199242;67574;13.8;4.7
78;2021-04-13;5459;2515;204701;70089;14.1;4.8
78;2021-04-14;4957;3404;209658;73493;14.5;5.1
78;2021-04-15;4617;3858;214275;77351;14.8;5.3
78;2021-04-16;5625;4034;219900;81385;15.2;5.6
78;2021-04-17;3610;720;223510;82105;15.4;5.7
78;2021-04-18;272;42;223782;82147;15.4;5.7
78;2021-04-19;3246;2817;227028;84964;15.7;5.9
78;2021-04-20;4709;3689;231737;88653;16.0;6.1
78;2021-04-21;4535;3512;236272;92165;16.3;6.4
78;2021-04-22;4568;4702;240840;96867;16.6;6.7
78;2021-04-23;5060;4436;245900;101303;17.0;7.0
78;2021-04-24;4865;2631;250765;103934;17.3;7.2
78;2021-04-25;3049;1732;253814;105666;17.5;7.3
78;2021-04-26;4768;3326;258582;108992;17.9;7.5
78;2021-04-27;5475;4320;264057;113312;18.2;7.8
78;2021-04-28;5651;4798;269708;118110;18.6;8.2
78;2021-04-29;6263;4086;275971;122196;19.1;8.4
78;2021-04-30;7207;4466;283178;126662;19.5;8.7
78;2021-05-01;612;255;283790;126917;19.6;8.8
78;2021-05-02;2009;166;285799;127083;19.7;8.8
78;2021-05-03;7466;1289;293265;128372;20.2;8.9
78;2021-05-04;6077;3985;299342;132357;20.7;9.1
78;2021-05-05;7297;4565;306639;136922;21.2;9.5
78;2021-05-06;6480;5179;313119;142101;21.6;9.8
78;2021-05-07;8309;5144;321428;147245;22.2;10.2
78;2021-05-08;2917;1455;324345;148700;22.4;10.3
78;2021-05-09;2820;356;327165;149056;22.6;10.3
78;2021-05-10;7345;4459;334510;153515;23.1;10.6
78;2021-05-11;8143;5423;342653;158938;23.7;11.0
78;2021-05-12;8729;3919;351382;162857;24.3;11.2
78;2021-05-13;6628;604;358010;163461;24.7;11.3
78;2021-05-14;10216;2217;368226;165678;25.4;11.4
78;2021-05-15;4934;2362;373160;168040;25.8;11.6
78;2021-05-16;3697;792;376857;168832;26.0;11.7
78;2021-05-17;8741;1348;385598;170180;26.6;11.7
78;2021-05-18;9885;1894;395483;172074;27.3;11.9
78;2021-05-19;11652;1712;407135;173786;28.1;12.0
78;2021-05-20;11596;2265;418731;176051;28.9;12.2
78;2021-05-21;12121;2630;430852;178681;29.7;12.3
78;2021-05-22;6538;1364;437390;180045;30.2;12.4
78;2021-05-23;3125;390;440515;180435;30.4;12.5
78;2021-05-24;3521;417;444036;180852;30.7;12.5
78;2021-05-25;9984;2509;454020;183361;31.3;12.7
78;2021-05-26;10159;3781;464179;187142;32.0;12.9
78;2021-05-27;10949;4645;475128;191787;32.8;13.2
78;2021-05-28;11405;6030;486533;197817;33.6;13.7
78;2021-05-29;4228;3385;490761;201202;33.9;13.9
78;2021-05-30;135;348;490896;201550;33.9;13.9
78;2021-05-31;7966;5360;498862;206910;34.4;14.3
78;2021-06-01;10023;6525;508885;213435;35.1;14.7
78;2021-06-02;8582;6204;517467;219639;35.7;15.2
78;2021-06-03;9892;6478;527359;226117;36.4;15.6
78;2021-06-04;9794;8145;537153;234262;37.1;16.2
78;2021-06-05;5519;6133;542672;240395;37.5;16.6
78;2021-06-06;2150;2010;544822;242405;37.6;16.7
78;2021-06-07;8113;6519;552935;248924;38.2;17.2
78;2021-06-08;8064;7322;560999;256246;38.7;17.7
78;2021-06-09;7325;6733;568324;262979;39.2;18.2
78;2021-06-10;7105;7106;575429;270085;39.7;18.6
78;2021-06-11;7584;8186;583013;278271;40.2;19.2
78;2021-06-12;6370;2922;589383;281193;40.7;19.4
78;2021-06-13;946;2458;590329;283651;40.8;19.6
78;2021-06-14;3415;9808;593744;293459;41.0;20.3
78;2021-06-15;5794;8287;599538;301746;41.4;20.8
78;2021-06-16;5430;8625;604968;310371;41.8;21.4
78;2021-06-17;5482;8537;610450;318908;42.1;22.0
78;2021-06-18;6103;9801;616553;328709;42.6;22.7
78;2021-06-19;5219;4820;621772;333529;42.9;23.0
78;2021-06-20;625;2838;622397;336367;43.0;23.2
78;2021-06-21;4092;9470;626489;345837;43.2;23.9
78;2021-06-22;3349;10317;629838;356154;43.5;24.6
78;2021-06-23;3839;10395;633677;366549;43.7;25.3
78;2021-06-24;3795;9978;637472;376527;44.0;26.0
78;2021-06-25;3995;13149;641467;389676;44.3;26.9
78;2021-06-26;4209;7950;645676;397626;44.6;27.4
78;2021-06-27;1041;2540;646717;400166;44.6;27.6
78;2021-06-28;3289;10900;650006;411066;44.9;28.4
78;2021-06-29;3535;11246;653541;422312;45.1;29.2
78;2021-06-30;4110;13225;657651;435537;45.4;30.1
78;2021-07-01;4107;12702;661758;448239;45.7;30.9
78;2021-07-02;4260;13938;666018;462177;46.0;31.9
78;2021-07-03;3159;8621;669177;470798;46.2;32.5
78;2021-07-04;778;1742;669955;472540;46.2;32.6
78;2021-07-05;3384;9694;673339;482234;46.5;33.3
78;2021-07-06;3525;12044;676864;494278;46.7;34.1
78;2021-07-07;3824;11606;680688;505884;47.0;34.9
78;2021-07-08;3927;11678;684615;517562;47.3;35.7
78;2021-07-09;4764;12745;689379;530307;47.6;36.6
78;2021-07-10;2626;6613;692005;536920;47.8;37.1
78;2021-07-11;748;2047;692753;538967;47.8;37.2
78;2021-07-12;3038;11745;695791;550712;48.0;38.0
78;2021-07-13;5351;11974;701142;562686;48.4;38.8
78;2021-07-14;2533;4989;703675;567675;48.6;39.2
78;2021-07-15;5663;11955;709338;579630;49.0;40.0
78;2021-07-16;7320;10787;716658;590417;49.5;40.8
78;2021-07-17;4725;4898;721383;595315;49.8;41.1
78;2021-07-18;1158;471;722541;595786;49.9;41.1
78;2021-07-19;3879;10350;726420;606136;50.1;41.8
78;2021-07-20;5616;9926;732036;616062;50.5;42.5
78;2021-07-21;5905;9861;737941;625923;50.9;43.2
78;2021-07-22;5972;9296;743913;635219;51.4;43.8
78;2021-07-23;6258;9231;750171;644450;51.8;44.5
78;2021-07-24;2937;4973;753108;649423;52.0;44.8
78;2021-07-25;987;376;754095;649799;52.1;44.9
78;2021-07-26;4869;6987;758964;656786;52.4;45.3
78;2021-07-27;7600;6915;766564;663701;52.9;45.8
78;2021-07-28;6975;5933;773539;669634;53.4;46.2
78;2021-07-29;7902;6010;781441;675644;53.9;46.6
78;2021-07-30;7740;7052;789181;682696;54.5;47.1
78;2021-07-31;2653;2734;791834;685430;54.7;47.3
78;2021-08-01;109;72;791943;685502;54.7;47.3
78;2021-08-02;2447;2131;794390;687633;54.8;47.5
78;2021-08-03;4302;4255;798692;691888;55.1;47.8
78;2021-08-04;4467;2809;803159;694697;55.4;48.0
78;2021-08-05;3887;3175;807046;697872;55.7;48.2
78;2021-08-06;3980;3719;811026;701591;56.0;48.4
78;2021-08-07;2819;3442;813845;705033;56.2;48.7
78;2021-08-08;483;343;814328;705376;56.2;48.7
78;2021-08-09;1880;1662;816208;707038;56.3;48.8
78;2021-08-10;3437;3983;819645;711021;56.6;49.1
78;2021-08-11;3051;3384;822696;714405;56.8;49.3
78;2021-08-12;2795;3535;825491;717940;57.0;49.6
78;2021-08-13;2868;3189;828359;721129;57.2;49.8
78;2021-08-14;2301;2981;830660;724110;57.3;50.0
78;2021-08-15;315;373;830975;724483;57.4;50.0
78;2021-08-16;942;2342;831917;726825;57.4;50.2
78;2021-08-17;2795;4422;834712;731247;57.6;50.5
78;2021-08-18;2477;3821;837189;735068;57.8;50.7
78;2021-08-19;2241;3584;839430;738652;57.9;51.0
78;2021-08-20;2102;3999;841532;742651;58.1;51.3
78;2021-08-21;1885;3587;843417;746238;58.2;51.5
78;2021-08-22;87;147;843504;746385;58.2;51.5
78;2021-08-23;2162;4248;845666;750633;58.4;51.8
78;2021-08-24;3630;6973;849296;757606;58.6;52.3
78;2021-08-25;3297;6593;852593;764199;58.9;52.8
78;2021-08-26;2988;7238;855581;771437;59.1;53.3
78;2021-08-27;2867;7372;858448;778809;59.3;53.8
78;2021-08-28;2444;5279;860892;784088;59.4;54.1
78;2021-08-29;369;351;861261;784439;59.5;54.2
78;2021-08-30;2859;4977;864120;789416;59.7;54.5
78;2021-08-31;3452;5677;867572;795093;59.9;54.9
78;2021-09-01;2832;4931;870404;800024;60.1;55.2
78;2021-09-02;2103;4011;872507;804035;60.2;55.5
78;2021-09-03;2261;4280;874768;808315;60.4;55.8
78;2021-09-04;2488;3953;877256;812268;60.6;56.1
78;2021-09-05;292;375;877548;812643;60.6;56.1
78;2021-09-06;1318;2497;878866;815140;60.7;56.3
78;2021-09-07;1368;2944;880234;818084;60.8;56.5
78;2021-09-08;1686;3307;881920;821391;60.9;56.7
78;2021-09-09;1094;2749;883014;824140;61.0;56.9
78;2021-09-10;1390;3014;884404;827154;61.1;57.1
78;2021-09-11;2054;3747;886458;830901;61.2;57.4
78;2021-09-12;75;139;886533;831040;61.2;57.4
78;2021-09-13;793;2021;887326;833061;61.3;57.5
78;2021-09-14;1079;2822;888405;835883;61.3;57.7
78;2021-09-15;1231;3534;889636;839417;61.4;57.9
78;2021-09-16;854;2093;890490;841510;61.5;58.1
78;2021-09-17;1191;2841;891681;844351;61.6;58.3
78;2021-09-18;1398;4075;893079;848426;61.7;58.6
78;2021-09-19;147;411;893226;848837;61.7;58.6
78;2021-09-20;673;1711;893899;850548;61.7;58.7
78;2021-09-21;828;1980;894727;852528;61.8;58.9
78;2021-09-22;959;3519;895686;856047;61.8;59.1
78;2021-09-23;891;1640;896577;857687;61.9;59.2
78;2021-09-24;1014;2390;897591;860077;62.0;59.4
78;2021-09-25;1060;3919;898651;863996;62.0;59.6
78;2021-09-26;60;156;898711;864152;62.0;59.7
78;2021-09-27;689;1509;899400;865661;62.1;59.8
78;2021-09-28;833;1500;900233;867161;62.1;59.9
78;2021-09-29;1009;2163;901242;869324;62.2;60.0
78;2021-09-30;559;928;901801;870252;62.3;60.1
78;2021-10-01;933;1825;902734;872077;62.3;60.2
78;2021-10-02;1246;2469;903980;874546;62.4;60.4
78;2021-10-03;54;71;904034;874617;62.4;60.4
78;2021-10-04;488;941;904522;875558;62.4;60.4
78;2021-10-05;441;738;904963;876296;62.5;60.5
78;2021-10-06;806;1570;905769;877866;62.5;60.6
78;2021-10-07;401;784;906170;878650;62.6;60.7
78;2021-10-08;901;1743;907071;880393;62.6;60.8
78;2021-10-09;977;1846;908048;882239;62.7;60.9
78;2021-10-10;101;114;908149;882353;62.7;60.9
78;2021-10-11;454;1004;908603;883357;62.7;61.0
78;2021-10-12;408;642;909011;883999;62.7;61.0
78;2021-10-13;655;1308;909666;885307;62.8;61.1
78;2021-10-14;515;866;910181;886173;62.8;61.2
78;2021-10-15;717;1339;910898;887512;62.9;61.3
78;2021-10-16;861;1378;911759;888890;62.9;61.4
78;2021-10-17;51;66;911810;888956;62.9;61.4
78;2021-10-18;447;747;912257;889703;63.0;61.4
78;2021-10-19;414;630;912671;890333;63.0;61.5
79;2020-12-27;0;0;0;0;0.0;0.0
79;2020-12-28;4;0;4;0;0.0;0.0
79;2020-12-29;0;0;4;0;0.0;0.0
79;2020-12-30;0;0;4;0;0.0;0.0
79;2020-12-31;0;0;4;0;0.0;0.0
79;2021-01-01;0;0;4;0;0.0;0.0
79;2021-01-02;0;0;4;0;0.0;0.0
79;2021-01-03;0;0;4;0;0.0;0.0
79;2021-01-04;1;0;5;0;0.0;0.0
79;2021-01-05;0;0;5;0;0.0;0.0
79;2021-01-06;0;0;5;0;0.0;0.0
79;2021-01-07;158;0;163;0;0.0;0.0
79;2021-01-08;165;0;328;0;0.1;0.0
79;2021-01-09;100;1;428;1;0.1;0.0
79;2021-01-10;3;0;431;1;0.1;0.0
79;2021-01-11;184;1;615;2;0.2;0.0
79;2021-01-12;245;1;860;3;0.2;0.0
79;2021-01-13;258;0;1118;3;0.3;0.0
79;2021-01-14;506;9;1624;12;0.4;0.0
79;2021-01-15;618;7;2242;19;0.6;0.0
79;2021-01-16;66;0;2308;19;0.6;0.0
79;2021-01-17;0;0;2308;19;0.6;0.0
79;2021-01-18;478;2;2786;21;0.7;0.0
79;2021-01-19;1361;3;4147;24;1.1;0.0
79;2021-01-20;1678;2;5825;26;1.6;0.0
79;2021-01-21;1999;8;7824;34;2.1;0.0
79;2021-01-22;875;5;8699;39;2.3;0.0
79;2021-01-23;65;0;8764;39;2.4;0.0
79;2021-01-24;0;0;8764;39;2.4;0.0
79;2021-01-25;646;7;9410;46;2.5;0.0
79;2021-01-26;593;14;10003;60;2.7;0.0
79;2021-01-27;740;84;10743;144;2.9;0.0
79;2021-01-28;733;152;11476;296;3.1;0.1
79;2021-01-29;495;88;11971;384;3.2;0.1
79;2021-01-30;0;0;11971;384;3.2;0.1
79;2021-01-31;0;0;11971;384;3.2;0.1
79;2021-02-01;207;111;12178;495;3.3;0.1
79;2021-02-02;335;74;12513;569;3.4;0.2
79;2021-02-03;391;60;12904;629;3.5;0.2
79;2021-02-04;326;109;13230;738;3.6;0.2
79;2021-02-05;360;275;13590;1013;3.6;0.3
79;2021-02-06;7;1;13597;1014;3.6;0.3
79;2021-02-07;22;0;13619;1014;3.7;0.3
79;2021-02-08;283;167;13902;1181;3.7;0.3
79;2021-02-09;457;785;14359;1966;3.9;0.5
79;2021-02-10;619;1199;14978;3165;4.0;0.8
79;2021-02-11;775;1237;15753;4402;4.2;1.2
79;2021-02-12;471;767;16224;5169;4.4;1.4
79;2021-02-13;53;74;16277;5243;4.4;1.4
79;2021-02-14;0;0;16277;5243;4.4;1.4
79;2021-02-15;186;503;16463;5746;4.4;1.5
79;2021-02-16;333;731;16796;6477;4.5;1.7
79;2021-02-17;248;877;17044;7354;4.6;2.0
79;2021-02-18;353;945;17397;8299;4.7;2.2
79;2021-02-19;268;559;17665;8858;4.7;2.4
79;2021-02-20;5;22;17670;8880;4.7;2.4
79;2021-02-21;1;0;17671;8880;4.7;2.4
79;2021-02-22;137;462;17808;9342;4.8;2.5
79;2021-02-23;247;567;18055;9909;4.8;2.7
79;2021-02-24;246;544;18301;10453;4.9;2.8
79;2021-02-25;520;469;18821;10922;5.1;2.9
79;2021-02-26;599;399;19420;11321;5.2;3.0
79;2021-02-27;408;7;19828;11328;5.3;3.0
79;2021-02-28;35;0;19863;11328;5.3;3.0
79;2021-03-01;89;362;19952;11690;5.4;3.1
79;2021-03-02;302;508;20254;12198;5.4;3.3
79;2021-03-03;662;545;20916;12743;5.6;3.4
79;2021-03-04;904;572;21820;13315;5.9;3.6
79;2021-03-05;1218;449;23038;13764;6.2;3.7
79;2021-03-06;611;8;23649;13772;6.3;3.7
79;2021-03-07;77;1;23726;13773;6.4;3.7
79;2021-03-08;345;311;24071;14084;6.5;3.8
79;2021-03-09;842;343;24913;14427;6.7;3.9
79;2021-03-10;1146;404;26059;14831;7.0;4.0
79;2021-03-11;1642;328;27701;15159;7.4;4.1
79;2021-03-12;1721;122;29422;15281;7.9;4.1
79;2021-03-13;1135;13;30557;15294;8.2;4.1
79;2021-03-14;50;0;30607;15294;8.2;4.1
79;2021-03-15;497;158;31104;15452;8.3;4.1
79;2021-03-16;735;148;31839;15600;8.5;4.2
79;2021-03-17;578;109;32417;15709;8.7;4.2
79;2021-03-18;553;203;32970;15912;8.8;4.3
79;2021-03-19;661;261;33631;16173;9.0;4.3
79;2021-03-20;1007;15;34638;16188;9.3;4.3
79;2021-03-21;3;0;34641;16188;9.3;4.3
79;2021-03-22;957;210;35598;16398;9.6;4.4
79;2021-03-23;1595;172;37193;16570;10.0;4.4
79;2021-03-24;1831;167;39024;16737;10.5;4.5
79;2021-03-25;2499;195;41523;16932;11.1;4.5
79;2021-03-26;2406;138;43929;17070;11.8;4.6
79;2021-03-27;768;18;44697;17088;12.0;4.6
79;2021-03-28;1;0;44698;17088;12.0;4.6
79;2021-03-29;2148;117;46846;17205;12.6;4.6
79;2021-03-30;2817;67;49663;17272;13.3;4.6
79;2021-03-31;2777;381;52440;17653;14.1;4.7
79;2021-04-01;2698;387;55138;18040;14.8;4.8
79;2021-04-02;2823;397;57961;18437;15.6;4.9
79;2021-04-03;634;55;58595;18492;15.7;5.0
79;2021-04-04;3;0;58598;18492;15.7;5.0
79;2021-04-05;382;5;58980;18497;15.8;5.0
79;2021-04-06;1792;587;60772;19084;16.3;5.1
79;2021-04-07;3112;738;63884;19822;17.1;5.3
79;2021-04-08;2632;704;66516;20526;17.9;5.5
79;2021-04-09;3737;550;70253;21076;18.9;5.7
79;2021-04-10;1466;388;71719;21464;19.2;5.8
79;2021-04-11;4;0;71723;21464;19.2;5.8
79;2021-04-12;1753;355;73476;21819;19.7;5.9
79;2021-04-13;2174;756;75650;22575;20.3;6.1
79;2021-04-14;2480;681;78130;23256;21.0;6.2
79;2021-04-15;2216;670;80346;23926;21.6;6.4
79;2021-04-16;1413;446;81759;24372;21.9;6.5
79;2021-04-17;581;354;82340;24726;22.1;6.6
79;2021-04-18;1;14;82341;24740;22.1;6.6
79;2021-04-19;1088;842;83429;25582;22.4;6.9
79;2021-04-20;1506;1228;84935;26810;22.8;7.2
79;2021-04-21;1419;1440;86354;28250;23.2;7.6
79;2021-04-22;1572;1089;87926;29339;23.6;7.9
79;2021-04-23;1316;1192;89242;30531;23.9;8.2
79;2021-04-24;653;463;89895;30994;24.1;8.3
79;2021-04-25;1;0;89896;30994;24.1;8.3
79;2021-04-26;1343;1812;91239;32806;24.5;8.8
79;2021-04-27;1899;2352;93138;35158;25.0;9.4
79;2021-04-28;1458;2867;94596;38025;25.4;10.2
79;2021-04-29;2104;2254;96700;40279;26.0;10.8
79;2021-04-30;2115;2463;98815;42742;26.5;11.5
79;2021-05-01;521;381;99336;43123;26.7;11.6
79;2021-05-02;1;11;99337;43134;26.7;11.6
79;2021-05-03;1182;1293;100519;44427;27.0;11.9
79;2021-05-04;1732;2332;102251;46759;27.4;12.5
79;2021-05-05;1694;2482;103945;49241;27.9;13.2
79;2021-05-06;2327;2223;106272;51464;28.5;13.8
79;2021-05-07;2105;2803;108377;54267;29.1;14.6
79;2021-05-08;198;506;108575;54773;29.1;14.7
79;2021-05-09;0;0;108575;54773;29.1;14.7
79;2021-05-10;1582;1787;110157;56560;29.6;15.2
79;2021-05-11;2309;1653;112466;58213;30.2;15.6
79;2021-05-12;2000;2683;114466;60896;30.7;16.3
79;2021-05-13;640;290;115106;61186;30.9;16.4
79;2021-05-14;2100;675;117206;61861;31.5;16.6
79;2021-05-15;1399;499;118605;62360;31.8;16.7
79;2021-05-16;1;22;118606;62382;31.8;16.7
79;2021-05-17;1873;1087;120479;63469;32.3;17.0
79;2021-05-18;2971;1272;123450;64741;33.1;17.4
79;2021-05-19;2899;969;126349;65710;33.9;17.6
79;2021-05-20;3106;1248;129455;66958;34.7;18.0
79;2021-05-21;2768;1066;132223;68024;35.5;18.3
79;2021-05-22;1084;261;133307;68285;35.8;18.3
79;2021-05-23;1;0;133308;68285;35.8;18.3
79;2021-05-24;161;20;133469;68305;35.8;18.3
79;2021-05-25;3198;991;136667;69296;36.7;18.6
79;2021-05-26;3312;854;139979;70150;37.6;18.8
79;2021-05-27;3589;1719;143568;71869;38.5;19.3
79;2021-05-28;3331;1825;146899;73694;39.4;19.8
79;2021-05-29;1072;450;147971;74144;39.7;19.9
79;2021-05-30;3;1;147974;74145;39.7;19.9
79;2021-05-31;2382;735;150356;74880;40.4;20.1
79;2021-06-01;3021;1577;153377;76457;41.2;20.5
79;2021-06-02;4066;1165;157443;77622;42.3;20.8
79;2021-06-03;4089;1758;161532;79380;43.3;21.3
79;2021-06-04;4141;2037;165673;81417;44.5;21.8
79;2021-06-05;2801;760;168474;82177;45.2;22.1
79;2021-06-06;696;39;169170;82216;45.4;22.1
79;2021-06-07;2805;1414;171975;83630;46.2;22.4
79;2021-06-08;2982;2070;174957;85700;47.0;23.0
79;2021-06-09;3631;1937;178588;87637;47.9;23.5
79;2021-06-10;3020;1971;181608;89608;48.7;24.0
79;2021-06-11;3767;2316;185375;91924;49.7;24.7
79;2021-06-12;1707;613;187082;92537;50.2;24.8
79;2021-06-13;213;24;187295;92561;50.3;24.8
79;2021-06-14;1247;1690;188542;94251;50.6;25.3
79;2021-06-15;1883;2362;190425;96613;51.1;25.9
79;2021-06-16;2204;2247;192629;98860;51.7;26.5
79;2021-06-17;2237;2620;194866;101480;52.3;27.2
79;2021-06-18;2413;2324;197279;103804;52.9;27.9
79;2021-06-19;1246;580;198525;104384;53.3;28.0
79;2021-06-20;3;2;198528;104386;53.3;28.0
79;2021-06-21;1233;2282;199761;106668;53.6;28.6
79;2021-06-22;1547;2877;201308;109545;54.0;29.4
79;2021-06-23;1770;2550;203078;112095;54.5;30.1
79;2021-06-24;2105;2002;205183;114097;55.1;30.6
79;2021-06-25;1488;2840;206671;116937;55.5;31.4
79;2021-06-26;870;808;207541;117745;55.7;31.6
79;2021-06-27;13;6;207554;117751;55.7;31.6
79;2021-06-28;1056;2620;208610;120371;56.0;32.3
79;2021-06-29;1472;3551;210082;123922;56.4;33.3
79;2021-06-30;1354;3447;211436;127369;56.7;34.2
79;2021-07-01;1202;3786;212638;131155;57.1;35.2
79;2021-07-02;1487;3346;214125;134501;57.5;36.1
79;2021-07-03;399;1504;214524;136005;57.6;36.5
79;2021-07-04;2;9;214526;136014;57.6;36.5
79;2021-07-05;754;2119;215280;138133;57.8;37.1
79;2021-07-06;947;3666;216227;141799;58.0;38.1
79;2021-07-07;1332;4308;217559;146107;58.4;39.2
79;2021-07-08;1107;4042;218666;150149;58.7;40.3
79;2021-07-09;836;3718;219502;153867;58.9;41.3
79;2021-07-10;514;1315;220016;155182;59.0;41.6
79;2021-07-11;3;12;220019;155194;59.0;41.6
79;2021-07-12;545;3696;220564;158890;59.2;42.6
79;2021-07-13;999;5187;221563;164077;59.5;44.0
79;2021-07-14;134;874;221697;164951;59.5;44.3
79;2021-07-15;1235;4684;222932;169635;59.8;45.5
79;2021-07-16;1333;4365;224265;174000;60.2;46.7
79;2021-07-17;577;2425;224842;176425;60.3;47.3
79;2021-07-18;44;498;224886;176923;60.4;47.5
79;2021-07-19;737;3316;225623;180239;60.5;48.4
79;2021-07-20;1230;3947;226853;184186;60.9;49.4
79;2021-07-21;1177;4198;228030;188384;61.2;50.6
79;2021-07-22;1354;3976;229384;192360;61.6;51.6
79;2021-07-23;1349;4556;230733;196916;61.9;52.8
79;2021-07-24;865;1499;231598;198415;62.2;53.2
79;2021-07-25;55;327;231653;198742;62.2;53.3
79;2021-07-26;1372;2599;233025;201341;62.5;54.0
79;2021-07-27;2084;2996;235109;204337;63.1;54.8
79;2021-07-28;2497;2496;237606;206833;63.8;55.5
79;2021-07-29;3010;2862;240616;209695;64.6;56.3
79;2021-07-30;2138;2815;242754;212510;65.1;57.0
79;2021-07-31;888;1158;243642;213668;65.4;57.3
79;2021-08-01;5;3;243647;213671;65.4;57.3
79;2021-08-02;1797;1545;245444;215216;65.9;57.8
79;2021-08-03;2823;2052;248267;217268;66.6;58.3
79;2021-08-04;2985;1744;251252;219012;67.4;58.8
79;2021-08-05;2900;2214;254152;221226;68.2;59.4
79;2021-08-06;2529;1636;256681;222862;68.9;59.8
79;2021-08-07;872;813;257553;223675;69.1;60.0
79;2021-08-08;4;3;257557;223678;69.1;60.0
79;2021-08-09;2495;1086;260052;224764;69.8;60.3
79;2021-08-10;2977;1549;263029;226313;70.6;60.7
79;2021-08-11;2587;1662;265616;227975;71.3;61.2
79;2021-08-12;2767;1431;268383;229406;72.0;61.6
79;2021-08-13;2875;1059;271258;230465;72.8;61.8
79;2021-08-14;518;391;271776;230856;72.9;62.0
79;2021-08-15;8;5;271784;230861;72.9;62.0
79;2021-08-16;1766;1196;273550;232057;73.4;62.3
79;2021-08-17;2103;1592;275653;233649;74.0;62.7
79;2021-08-18;1922;1915;277575;235564;74.5;63.2
79;2021-08-19;1617;1709;279192;237273;74.9;63.7
79;2021-08-20;1514;2162;280706;239435;75.3;64.3
79;2021-08-21;243;543;280949;239978;75.4;64.4
79;2021-08-22;1;21;280950;239999;75.4;64.4
79;2021-08-23;864;2176;281814;242175;75.6;65.0
79;2021-08-24;1072;2484;282886;244659;75.9;65.7
79;2021-08-25;1051;2760;283937;247419;76.2;66.4
79;2021-08-26;1017;2330;284954;249749;76.5;67.0
79;2021-08-27;611;2060;285565;251809;76.6;67.6
79;2021-08-28;299;841;285864;252650;76.7;67.8
79;2021-08-29;7;5;285871;252655;76.7;67.8
79;2021-08-30;554;2342;286425;254997;76.9;68.4
79;2021-08-31;633;2505;287058;257502;77.0;69.1
79;2021-09-01;650;2615;287708;260117;77.2;69.8
79;2021-09-02;762;2414;288470;262531;77.4;70.5
79;2021-09-03;637;2689;289107;265220;77.6;71.2
79;2021-09-04;265;700;289372;265920;77.7;71.4
79;2021-09-05;13;17;289385;265937;77.7;71.4
79;2021-09-06;330;1792;289715;267729;77.7;71.8
79;2021-09-07;347;2018;290062;269747;77.8;72.4
79;2021-09-08;542;2121;290604;271868;78.0;73.0
79;2021-09-09;318;1636;290922;273504;78.1;73.4
79;2021-09-10;422;2066;291344;275570;78.2;74.0
79;2021-09-11;162;837;291506;276407;78.2;74.2
79;2021-09-12;0;0;291506;276407;78.2;74.2
79;2021-09-13;364;1060;291870;277467;78.3;74.5
79;2021-09-14;383;1185;292253;278652;78.4;74.8
79;2021-09-15;475;1432;292728;280084;78.6;75.2
79;2021-09-16;464;1095;293192;281179;78.7;75.5
79;2021-09-17;446;1406;293638;282585;78.8;75.8
79;2021-09-18;142;567;293780;283152;78.8;76.0
79;2021-09-19;1;4;293781;283156;78.8;76.0
79;2021-09-20;190;553;293971;283709;78.9;76.1
79;2021-09-21;351;720;294322;284429;79.0;76.3
79;2021-09-22;209;1102;294531;285531;79.0;76.6
79;2021-09-23;414;569;294945;286100;79.2;76.8
79;2021-09-24;245;1350;295190;287450;79.2;77.1
79;2021-09-25;77;326;295267;287776;79.2;77.2
79;2021-09-26;0;1;295267;287777;79.2;77.2
79;2021-09-27;205;528;295472;288305;79.3;77.4
79;2021-09-28;130;410;295602;288715;79.3;77.5
79;2021-09-29;325;743;295927;289458;79.4;77.7
79;2021-09-30;154;279;296081;289737;79.5;77.8
79;2021-10-01;248;541;296329;290278;79.5;77.9
79;2021-10-02;127;248;296456;290526;79.6;78.0
79;2021-10-03;0;0;296456;290526;79.6;78.0
79;2021-10-04;158;332;296614;290858;79.6;78.1
79;2021-10-05;115;260;296729;291118;79.6;78.1
79;2021-10-06;144;336;296873;291454;79.7;78.2
79;2021-10-07;93;223;296966;291677;79.7;78.3
79;2021-10-08;222;549;297188;292226;79.8;78.4
79;2021-10-09;89;151;297277;292377;79.8;78.5
79;2021-10-10;1;3;297278;292380;79.8;78.5
79;2021-10-11;123;281;297401;292661;79.8;78.5
79;2021-10-12;149;345;297550;293006;79.9;78.6
79;2021-10-13;213;284;297763;293290;79.9;78.7
79;2021-10-14;146;324;297909;293614;79.9;78.8
79;2021-10-15;212;569;298121;294183;80.0;78.9
79;2021-10-16;95;113;298216;294296;80.0;79.0
79;2021-10-17;0;0;298216;294296;80.0;79.0
79;2021-10-18;135;232;298351;294528;80.1;79.0
79;2021-10-19;85;147;298436;294675;80.1;79.1
80;2020-12-27;0;0;0;0;0.0;0.0
80;2020-12-28;0;0;0;0;0.0;0.0
80;2020-12-29;11;0;11;0;0.0;0.0
80;2020-12-30;0;0;11;0;0.0;0.0
80;2020-12-31;0;0;11;0;0.0;0.0
80;2021-01-01;0;0;11;0;0.0;0.0
80;2021-01-02;1;0;12;0;0.0;0.0
80;2021-01-03;1;0;13;0;0.0;0.0
80;2021-01-04;0;0;13;0;0.0;0.0
80;2021-01-05;1;0;14;0;0.0;0.0
80;2021-01-06;30;0;44;0;0.0;0.0
80;2021-01-07;276;2;320;2;0.1;0.0
80;2021-01-08;330;1;650;3;0.1;0.0
80;2021-01-09;108;0;758;3;0.1;0.0
80;2021-01-10;21;0;779;3;0.1;0.0
80;2021-01-11;276;0;1055;3;0.2;0.0
80;2021-01-12;429;1;1484;4;0.3;0.0
80;2021-01-13;514;4;1998;8;0.4;0.0
80;2021-01-14;454;4;2452;12;0.4;0.0
80;2021-01-15;331;1;2783;13;0.5;0.0
80;2021-01-16;104;1;2887;14;0.5;0.0
80;2021-01-17;102;1;2989;15;0.5;0.0
80;2021-01-18;412;2;3401;17;0.6;0.0
80;2021-01-19;963;17;4364;34;0.8;0.0
80;2021-01-20;1086;11;5450;45;1.0;0.0
80;2021-01-21;1013;9;6463;54;1.1;0.0
80;2021-01-22;1114;5;7577;59;1.3;0.0
80;2021-01-23;908;18;8485;77;1.5;0.0
80;2021-01-24;823;10;9308;87;1.6;0.0
80;2021-01-25;1544;21;10852;108;1.9;0.0
80;2021-01-26;1480;12;12332;120;2.2;0.0
80;2021-01-27;822;26;13154;146;2.3;0.0
80;2021-01-28;622;172;13776;318;2.4;0.1
80;2021-01-29;637;216;14413;534;2.5;0.1
80;2021-01-30;87;59;14500;593;2.5;0.1
80;2021-01-31;0;0;14500;593;2.5;0.1
80;2021-02-01;26;254;14526;847;2.5;0.1
80;2021-02-02;21;440;14547;1287;2.6;0.2
80;2021-02-03;28;542;14575;1829;2.6;0.3
80;2021-02-04;278;358;14853;2187;2.6;0.4
80;2021-02-05;347;213;15200;2400;2.7;0.4
80;2021-02-06;168;69;15368;2469;2.7;0.4
80;2021-02-07;1;0;15369;2469;2.7;0.4
80;2021-02-08;424;241;15793;2710;2.8;0.5
80;2021-02-09;686;245;16479;2955;2.9;0.5
80;2021-02-10;607;496;17086;3451;3.0;0.6
80;2021-02-11;862;353;17948;3804;3.2;0.7
80;2021-02-12;947;318;18895;4122;3.3;0.7
80;2021-02-13;197;428;19092;4550;3.4;0.8
80;2021-02-14;78;571;19170;5121;3.4;0.9
80;2021-02-15;606;1015;19776;6136;3.5;1.1
80;2021-02-16;688;1133;20464;7269;3.6;1.3
80;2021-02-17;484;1170;20948;8439;3.7;1.5
80;2021-02-18;571;1139;21519;9578;3.8;1.7
80;2021-02-19;502;854;22021;10432;3.9;1.8
80;2021-02-20;22;510;22043;10942;3.9;1.9
80;2021-02-21;47;46;22090;10988;3.9;1.9
80;2021-02-22;146;573;22236;11561;3.9;2.0
80;2021-02-23;471;688;22707;12249;4.0;2.1
80;2021-02-24;431;678;23138;12927;4.1;2.3
80;2021-02-25;814;534;23952;13461;4.2;2.4
80;2021-02-26;1063;522;25015;13983;4.4;2.5
80;2021-02-27;475;71;25490;14054;4.5;2.5
80;2021-02-28;49;24;25539;14078;4.5;2.5
80;2021-03-01;730;68;26269;14146;4.6;2.5
80;2021-03-02;1014;93;27283;14239;4.8;2.5
80;2021-03-03;981;56;28264;14295;5.0;2.5
80;2021-03-04;1391;239;29655;14534;5.2;2.6
80;2021-03-05;1875;335;31530;14869;5.5;2.6
80;2021-03-06;2916;338;34446;15207;6.0;2.7
80;2021-03-07;1842;85;36288;15292;6.4;2.7
80;2021-03-08;714;607;37002;15899;6.5;2.8
80;2021-03-09;1310;910;38312;16809;6.7;3.0
80;2021-03-10;1724;756;40036;17565;7.0;3.1
80;2021-03-11;1909;827;41945;18392;7.4;3.2
80;2021-03-12;3140;753;45085;19145;7.9;3.4
80;2021-03-13;4007;221;49092;19366;8.6;3.4
80;2021-03-14;350;14;49442;19380;8.7;3.4
80;2021-03-15;1015;249;50457;19629;8.9;3.4
80;2021-03-16;884;346;51341;19975;9.0;3.5
80;2021-03-17;665;279;52006;20254;9.1;3.6
80;2021-03-18;1004;297;53010;20551;9.3;3.6
80;2021-03-19;1738;385;54748;20936;9.6;3.7
80;2021-03-20;3821;118;58569;21054;10.3;3.7
80;2021-03-21;486;31;59055;21085;10.4;3.7
80;2021-03-22;902;292;59957;21377;10.5;3.8
80;2021-03-23;1713;418;61670;21795;10.8;3.8
80;2021-03-24;1755;468;63425;22263;11.1;3.9
80;2021-03-25;2714;453;66139;22716;11.6;4.0
80;2021-03-26;3105;425;69244;23141;12.2;4.1
80;2021-03-27;2238;232;71482;23373;12.5;4.1
80;2021-03-28;676;95;72158;23468;12.7;4.1
80;2021-03-29;1979;754;74137;24222;13.0;4.3
80;2021-03-30;1968;874;76105;25096;13.4;4.4
80;2021-03-31;1495;987;77600;26083;13.6;4.6
80;2021-04-01;1950;1490;79550;27573;14.0;4.8
80;2021-04-02;2811;1579;82361;29152;14.5;5.1
80;2021-04-03;3048;864;85409;30016;15.0;5.3
80;2021-04-04;134;8;85543;30024;15.0;5.3
80;2021-04-05;684;201;86227;30225;15.1;5.3
80;2021-04-06;1280;969;87507;31194;15.4;5.5
80;2021-04-07;1624;1202;89131;32396;15.6;5.7
80;2021-04-08;2154;845;91285;33241;16.0;5.8
80;2021-04-09;3533;1359;94818;34600;16.6;6.1
80;2021-04-10;2737;1953;97555;36553;17.1;6.4
80;2021-04-11;187;177;97742;36730;17.2;6.4
80;2021-04-12;1812;491;99554;37221;17.5;6.5
80;2021-04-13;2385;1037;101939;38258;17.9;6.7
80;2021-04-14;2769;1166;104708;39424;18.4;6.9
80;2021-04-15;3731;881;108439;40305;19.0;7.1
80;2021-04-16;3337;878;111776;41183;19.6;7.2
80;2021-04-17;1653;2299;113429;43482;19.9;7.6
80;2021-04-18;372;390;113801;43872;20.0;7.7
80;2021-04-19;951;772;114752;44644;20.1;7.8
80;2021-04-20;1613;823;116365;45467;20.4;8.0
80;2021-04-21;1612;998;117977;46465;20.7;8.2
80;2021-04-22;2167;1253;120144;47718;21.1;8.4
80;2021-04-23;2640;1252;122784;48970;21.5;8.6
80;2021-04-24;1357;1193;124141;50163;21.8;8.8
80;2021-04-25;209;531;124350;50694;21.8;8.9
80;2021-04-26;1294;1445;125644;52139;22.1;9.2
80;2021-04-27;2025;1398;127669;53537;22.4;9.4
80;2021-04-28;2199;1396;129868;54933;22.8;9.6
80;2021-04-29;3219;1888;133087;56821;23.4;10.0
80;2021-04-30;3081;2857;136168;59678;23.9;10.5
80;2021-05-01;987;660;137155;60338;24.1;10.6
80;2021-05-02;371;55;137526;60393;24.1;10.6
80;2021-05-03;2720;1188;140246;61581;24.6;10.8
80;2021-05-04;2494;1708;142740;63289;25.1;11.1
80;2021-05-05;3366;1899;146106;65188;25.6;11.4
80;2021-05-06;3168;2559;149274;67747;26.2;11.9
80;2021-05-07;3455;2699;152729;70446;26.8;12.4
80;2021-05-08;2784;927;155513;71373;27.3;12.5
80;2021-05-09;1407;269;156920;71642;27.5;12.6
80;2021-05-10;1880;1832;158800;73474;27.9;12.9
80;2021-05-11;3274;1806;162074;75280;28.4;13.2
80;2021-05-12;4703;1577;166777;76857;29.3;13.5
80;2021-05-13;3837;366;170614;77223;29.9;13.6
80;2021-05-14;5186;1406;175800;78629;30.9;13.8
80;2021-05-15;5917;1054;181717;79683;31.9;14.0
80;2021-05-16;2678;315;184395;79998;32.4;14.0
80;2021-05-17;2371;819;186766;80817;32.8;14.2
80;2021-05-18;3945;853;190711;81670;33.5;14.3
80;2021-05-19;4018;944;194729;82614;34.2;14.5
80;2021-05-20;4568;1220;199297;83834;35.0;14.7
80;2021-05-21;4890;1670;204187;85504;35.8;15.0
80;2021-05-22;5030;1159;209217;86663;36.7;15.2
80;2021-05-23;1783;242;211000;86905;37.0;15.3
80;2021-05-24;1469;160;212469;87065;37.3;15.3
80;2021-05-25;2622;1138;215091;88203;37.8;15.5
80;2021-05-26;4249;1708;219340;89911;38.5;15.8
80;2021-05-27;3977;2472;223317;92383;39.2;16.2
80;2021-05-28;3865;2978;227182;95361;39.9;16.7
80;2021-05-29;3696;1631;230878;96992;40.5;17.0
80;2021-05-30;1182;198;232060;97190;40.7;17.1
80;2021-05-31;2604;1372;234664;98562;41.2;17.3
80;2021-06-01;4032;2437;238696;100999;41.9;17.7
80;2021-06-02;3334;2009;242030;103008;42.5;18.1
80;2021-06-03;4264;2933;246294;105941;43.2;18.6
80;2021-06-04;4796;3086;251090;109027;44.1;19.1
80;2021-06-05;3554;2073;254644;111100;44.7;19.5
80;2021-06-06;803;211;255447;111311;44.8;19.5
80;2021-06-07;1750;1945;257197;113256;45.1;19.9
80;2021-06-08;2743;2560;259940;115816;45.6;20.3
80;2021-06-09;3012;2735;262952;118551;46.2;20.8
80;2021-06-10;3162;3171;266114;121722;46.7;21.4
80;2021-06-11;3216;3903;269330;125625;47.3;22.0
80;2021-06-12;3042;2329;272372;127954;47.8;22.5
80;2021-06-13;474;404;272846;128358;47.9;22.5
80;2021-06-14;1263;2852;274109;131210;48.1;23.0
80;2021-06-15;2315;3421;276424;134631;48.5;23.6
80;2021-06-16;1563;4212;277987;138843;48.8;24.4
80;2021-06-17;2359;3625;280346;142468;49.2;25.0
80;2021-06-18;2552;3907;282898;146375;49.7;25.7
80;2021-06-19;2986;4342;285884;150717;50.2;26.5
80;2021-06-20;203;1077;286087;151794;50.2;26.6
80;2021-06-21;1015;2620;287102;154414;50.4;27.1
80;2021-06-22;1149;3930;288251;158344;50.6;27.8
80;2021-06-23;1850;5291;290101;163635;50.9;28.7
80;2021-06-24;1695;4685;291796;168320;51.2;29.5
80;2021-06-25;1374;6126;293170;174446;51.5;30.6
80;2021-06-26;1934;6183;295104;180629;51.8;31.7
80;2021-06-27;333;2031;295437;182660;51.9;32.1
80;2021-06-28;903;3170;296340;185830;52.0;32.6
80;2021-06-29;1919;4624;298259;190454;52.3;33.4
80;2021-06-30;1245;4785;299504;195239;52.6;34.3
80;2021-07-01;1593;5000;301097;200239;52.8;35.1
80;2021-07-02;1856;5986;302953;206225;53.2;36.2
80;2021-07-03;1293;5265;304246;211490;53.4;37.1
80;2021-07-04;692;1471;304938;212961;53.5;37.4
80;2021-07-05;878;2963;305816;215924;53.7;37.9
80;2021-07-06;1852;3991;307668;219915;54.0;38.6
80;2021-07-07;1561;4506;309229;224421;54.3;39.4
80;2021-07-08;2082;5003;311311;229424;54.6;40.3
80;2021-07-09;2596;5473;313907;234897;55.1;41.2
80;2021-07-10;1617;4017;315524;238914;55.4;41.9
80;2021-07-11;406;805;315930;239719;55.4;42.1
80;2021-07-12;871;3379;316801;243098;55.6;42.7
80;2021-07-13;2087;5088;318888;248186;56.0;43.6
80;2021-07-14;2802;1750;321690;249936;56.5;43.9
80;2021-07-15;2792;5297;324482;255233;56.9;44.8
80;2021-07-16;3876;5892;328358;261125;57.6;45.8
80;2021-07-17;3368;4461;331726;265586;58.2;46.6
80;2021-07-18;874;896;332600;266482;58.4;46.8
80;2021-07-19;2158;2886;334758;269368;58.8;47.3
80;2021-07-20;3321;4903;338079;274271;59.3;48.1
80;2021-07-21;3497;4497;341576;278768;59.9;48.9
80;2021-07-22;4362;4574;345938;283342;60.7;49.7
80;2021-07-23;5399;4830;351337;288172;61.7;50.6
80;2021-07-24;4367;4346;355704;292518;62.4;51.3
80;2021-07-25;1185;650;356889;293168;62.6;51.5
80;2021-07-26;2681;2340;359570;295508;63.1;51.9
80;2021-07-27;4373;3706;363943;299214;63.9;52.5
80;2021-07-28;5101;2805;369044;302019;64.8;53.0
80;2021-07-29;4991;3230;374035;305249;65.6;53.6
80;2021-07-30;5024;3641;379059;308890;66.5;54.2
80;2021-07-31;4156;2927;383215;311817;67.3;54.7
80;2021-08-01;1288;363;384503;312180;67.5;54.8
80;2021-08-02;2059;1739;386562;313919;67.8;55.1
80;2021-08-03;3716;2363;390278;316282;68.5;55.5
80;2021-08-04;3367;2491;393645;318773;69.1;55.9
80;2021-08-05;3137;2579;396782;321352;69.6;56.4
80;2021-08-06;3248;2878;400030;324230;70.2;56.9
80;2021-08-07;2430;2670;402460;326900;70.6;57.4
80;2021-08-08;621;686;403081;327586;70.7;57.5
80;2021-08-09;1382;2078;404463;329664;71.0;57.9
80;2021-08-10;2353;2849;406816;332513;71.4;58.4
80;2021-08-11;1946;2383;408762;334896;71.7;58.8
80;2021-08-12;2237;2661;410999;337557;72.1;59.2
80;2021-08-13;1882;3154;412881;340711;72.5;59.8
80;2021-08-14;1411;2114;414292;342825;72.7;60.2
80;2021-08-15;318;663;414610;343488;72.8;60.3
80;2021-08-16;896;2418;415506;345906;72.9;60.7
80;2021-08-17;1709;3505;417215;349411;73.2;61.3
80;2021-08-18;1235;3714;418450;353125;73.4;62.0
80;2021-08-19;1569;3821;420019;356946;73.7;62.6
80;2021-08-20;1265;4434;421284;361380;73.9;63.4
80;2021-08-21;1078;2688;422362;364068;74.1;63.9
80;2021-08-22;145;680;422507;364748;74.2;64.0
80;2021-08-23;583;3000;423090;367748;74.3;64.5
80;2021-08-24;1093;4371;424183;372119;74.4;65.3
80;2021-08-25;973;3677;425156;375796;74.6;66.0
80;2021-08-26;956;3819;426112;379615;74.8;66.6
80;2021-08-27;1014;4458;427126;384073;75.0;67.4
80;2021-08-28;723;3347;427849;387420;75.1;68.0
80;2021-08-29;199;555;428048;387975;75.1;68.1
80;2021-08-30;501;2280;428549;390255;75.2;68.5
80;2021-08-31;750;3111;429299;393366;75.3;69.0
80;2021-09-01;680;2316;429979;395682;75.5;69.4
80;2021-09-02;527;2077;430506;397759;75.6;69.8
80;2021-09-03;761;2804;431267;400563;75.7;70.3
80;2021-09-04;958;2599;432225;403162;75.9;70.8
80;2021-09-05;166;341;432391;403503;75.9;70.8
80;2021-09-06;420;1305;432811;404808;76.0;71.0
80;2021-09-07;493;1581;433304;406389;76.0;71.3
80;2021-09-08;497;1549;433801;407938;76.1;71.6
80;2021-09-09;533;1516;434334;409454;76.2;71.9
80;2021-09-10;620;1704;434954;411158;76.3;72.2
80;2021-09-11;520;1959;435474;413117;76.4;72.5
80;2021-09-12;78;303;435552;413420;76.4;72.6
80;2021-09-13;312;784;435864;414204;76.5;72.7
80;2021-09-14;642;1086;436506;415290;76.6;72.9
80;2021-09-15;358;1089;436864;416379;76.7;73.1
80;2021-09-16;477;1029;437341;417408;76.8;73.3
80;2021-09-17;506;1238;437847;418646;76.8;73.5
80;2021-09-18;348;1278;438195;419924;76.9;73.7
80;2021-09-19;19;169;438214;420093;76.9;73.7
80;2021-09-20;327;445;438541;420538;77.0;73.8
80;2021-09-21;298;615;438839;421153;77.0;73.9
80;2021-09-22;285;709;439124;421862;77.1;74.0
80;2021-09-23;305;507;439429;422369;77.1;74.1
80;2021-09-24;371;898;439800;423267;77.2;74.3
80;2021-09-25;284;1134;440084;424401;77.2;74.5
80;2021-09-26;20;109;440104;424510;77.2;74.5
80;2021-09-27;191;537;440295;425047;77.3;74.6
80;2021-09-28;148;382;440443;425429;77.3;74.7
80;2021-09-29;257;512;440700;425941;77.3;74.8
80;2021-09-30;199;330;440899;426271;77.4;74.8
80;2021-10-01;306;722;441205;426993;77.4;74.9
80;2021-10-02;336;895;441541;427888;77.5;75.1
80;2021-10-03;18;64;441559;427952;77.5;75.1
80;2021-10-04;136;321;441695;428273;77.5;75.2
80;2021-10-05;166;461;441861;428734;77.6;75.2
80;2021-10-06;259;445;442120;429179;77.6;75.3
80;2021-10-07;197;432;442317;429611;77.6;75.4
80;2021-10-08;253;689;442570;430300;77.7;75.5
80;2021-10-09;283;479;442853;430779;77.7;75.6
80;2021-10-10;26;34;442879;430813;77.7;75.6
80;2021-10-11;154;225;443033;431038;77.8;75.7
80;2021-10-12;186;418;443219;431456;77.8;75.7
80;2021-10-13;216;271;443435;431727;77.8;75.8
80;2021-10-14;225;314;443660;432041;77.9;75.8
80;2021-10-15;313;536;443973;432577;77.9;75.9
80;2021-10-16;250;398;444223;432975;78.0;76.0
80;2021-10-17;17;15;444240;432990;78.0;76.0
80;2021-10-18;170;353;444410;433343;78.0;76.1
80;2021-10-19;106;162;444516;433505;78.0;76.1
81;2020-12-27;1;0;1;0;0.0;0.0
81;2020-12-28;0;0;1;0;0.0;0.0
81;2020-12-29;0;0;1;0;0.0;0.0
81;2020-12-30;1;0;2;0;0.0;0.0
81;2020-12-31;1;0;3;0;0.0;0.0
81;2021-01-01;0;0;3;0;0.0;0.0
81;2021-01-02;0;0;3;0;0.0;0.0
81;2021-01-03;0;0;3;0;0.0;0.0
81;2021-01-04;1;0;4;0;0.0;0.0
81;2021-01-05;0;0;4;0;0.0;0.0
81;2021-01-06;5;0;9;0;0.0;0.0
81;2021-01-07;265;0;274;0;0.1;0.0
81;2021-01-08;312;1;586;1;0.2;0.0
81;2021-01-09;74;1;660;2;0.2;0.0
81;2021-01-10;1;0;661;2;0.2;0.0
81;2021-01-11;133;0;794;2;0.2;0.0
81;2021-01-12;167;0;961;2;0.2;0.0
81;2021-01-13;234;1;1195;3;0.3;0.0
81;2021-01-14;963;7;2158;10;0.6;0.0
81;2021-01-15;523;3;2681;13;0.7;0.0
81;2021-01-16;71;1;2752;14;0.7;0.0
81;2021-01-17;0;0;2752;14;0.7;0.0
81;2021-01-18;581;3;3333;17;0.9;0.0
81;2021-01-19;662;4;3995;21;1.0;0.0
81;2021-01-20;754;2;4749;23;1.2;0.0
81;2021-01-21;1184;16;5933;39;1.5;0.0
81;2021-01-22;857;3;6790;42;1.8;0.0
81;2021-01-23;221;2;7011;44;1.8;0.0
81;2021-01-24;102;0;7113;44;1.8;0.0
81;2021-01-25;570;6;7683;50;2.0;0.0
81;2021-01-26;634;6;8317;56;2.1;0.0
81;2021-01-27;552;3;8869;59;2.3;0.0
81;2021-01-28;700;209;9569;268;2.5;0.1
81;2021-01-29;303;184;9872;452;2.5;0.1
81;2021-01-30;203;37;10075;489;2.6;0.1
81;2021-01-31;104;1;10179;490;2.6;0.1
81;2021-02-01;321;130;10500;620;2.7;0.2
81;2021-02-02;445;143;10945;763;2.8;0.2
81;2021-02-03;476;220;11421;983;2.9;0.3
81;2021-02-04;1449;725;12870;1708;3.3;0.4
81;2021-02-05;870;316;13740;2024;3.5;0.5
81;2021-02-06;274;19;14014;2043;3.6;0.5
81;2021-02-07;103;0;14117;2043;3.6;0.5
81;2021-02-08;276;219;14393;2262;3.7;0.6
81;2021-02-09;420;217;14813;2479;3.8;0.6
81;2021-02-10;371;286;15184;2765;3.9;0.7
81;2021-02-11;651;397;15835;3162;4.1;0.8
81;2021-02-12;581;544;16416;3706;4.2;1.0
81;2021-02-13;188;156;16604;3862;4.3;1.0
81;2021-02-14;100;1;16704;3863;4.3;1.0
81;2021-02-15;234;482;16938;4345;4.4;1.1
81;2021-02-16;282;617;17220;4962;4.4;1.3
81;2021-02-17;241;521;17461;5483;4.5;1.4
81;2021-02-18;483;671;17944;6154;4.6;1.6
81;2021-02-19;572;416;18516;6570;4.8;1.7
81;2021-02-20;322;282;18838;6852;4.9;1.8
81;2021-02-21;23;80;18861;6932;4.9;1.8
81;2021-02-22;233;535;19094;7467;4.9;1.9
81;2021-02-23;171;591;19265;8058;5.0;2.1
81;2021-02-24;292;629;19557;8687;5.0;2.2
81;2021-02-25;720;1054;20277;9741;5.2;2.5
81;2021-02-26;911;958;21188;10699;5.5;2.8
81;2021-02-27;275;242;21463;10941;5.5;2.8
81;2021-02-28;21;88;21484;11029;5.5;2.8
81;2021-03-01;208;410;21692;11439;5.6;2.9
81;2021-03-02;364;544;22056;11983;5.7;3.1
81;2021-03-03;462;422;22518;12405;5.8;3.2
81;2021-03-04;1061;460;23579;12865;6.1;3.3
81;2021-03-05;1406;397;24985;13262;6.4;3.4
81;2021-03-06;982;171;25967;13433;6.7;3.5
81;2021-03-07;154;102;26121;13535;6.7;3.5
81;2021-03-08;466;362;26587;13897;6.9;3.6
81;2021-03-09;817;373;27404;14270;7.1;3.7
81;2021-03-10;898;396;28302;14666;7.3;3.8
81;2021-03-11;1352;361;29654;15027;7.6;3.9
81;2021-03-12;1690;307;31344;15334;8.1;4.0
81;2021-03-13;1031;190;32375;15524;8.3;4.0
81;2021-03-14;66;82;32441;15606;8.4;4.0
81;2021-03-15;1093;225;33534;15831;8.6;4.1
81;2021-03-16;724;231;34258;16062;8.8;4.1
81;2021-03-17;893;280;35151;16342;9.1;4.2
81;2021-03-18;970;579;36121;16921;9.3;4.4
81;2021-03-19;1271;460;37392;17381;9.6;4.5
81;2021-03-20;677;285;38069;17666;9.8;4.6
81;2021-03-21;139;22;38208;17688;9.9;4.6
81;2021-03-22;932;279;39140;17967;10.1;4.6
81;2021-03-23;1420;224;40560;18191;10.5;4.7
81;2021-03-24;1606;267;42166;18458;10.9;4.8
81;2021-03-25;2028;328;44194;18786;11.4;4.8
81;2021-03-26;2100;289;46294;19075;11.9;4.9
81;2021-03-27;1092;38;47386;19113;12.2;4.9
81;2021-03-28;734;41;48120;19154;12.4;4.9
81;2021-03-29;2866;196;50986;19350;13.1;5.0
81;2021-03-30;3055;218;54041;19568;13.9;5.0
81;2021-03-31;2691;302;56732;19870;14.6;5.1
81;2021-04-01;3315;570;60047;20440;15.5;5.3
81;2021-04-02;2615;376;62662;20816;16.2;5.4
81;2021-04-03;1147;306;63809;21122;16.4;5.4
81;2021-04-04;1403;26;65212;21148;16.8;5.5
81;2021-04-05;718;21;65930;21169;17.0;5.5
81;2021-04-06;1599;520;67529;21689;17.4;5.6
81;2021-04-07;1816;586;69345;22275;17.9;5.7
81;2021-04-08;2619;829;71964;23104;18.6;6.0
81;2021-04-09;3052;479;75016;23583;19.3;6.1
81;2021-04-10;1475;519;76491;24102;19.7;6.2
81;2021-04-11;1299;71;77790;24173;20.1;6.2
81;2021-04-12;1220;685;79010;24858;20.4;6.4
81;2021-04-13;2528;795;81538;25653;21.0;6.6
81;2021-04-14;2506;836;84044;26489;21.7;6.8
81;2021-04-15;3099;1204;87143;27693;22.5;7.1
81;2021-04-16;2823;1098;89966;28791;23.2;7.4
81;2021-04-17;1145;300;91111;29091;23.5;7.5
81;2021-04-18;519;147;91630;29238;23.6;7.5
81;2021-04-19;913;823;92543;30061;23.9;7.7
81;2021-04-20;2271;1170;94814;31231;24.4;8.1
81;2021-04-21;2224;1007;97038;32238;25.0;8.3
81;2021-04-22;2816;1064;99854;33302;25.7;8.6
81;2021-04-23;2887;975;102741;34277;26.5;8.8
81;2021-04-24;1326;742;104067;35019;26.8;9.0
81;2021-04-25;454;716;104521;35735;26.9;9.2
81;2021-04-26;1061;2424;105582;38159;27.2;9.8
81;2021-04-27;1595;2362;107177;40521;27.6;10.4
81;2021-04-28;1427;2400;108604;42921;28.0;11.1
81;2021-04-29;1818;2748;110422;45669;28.5;11.8
81;2021-04-30;2013;2354;112435;48023;29.0;12.4
81;2021-05-01;362;686;112797;48709;29.1;12.6
81;2021-05-02;291;1379;113088;50088;29.2;12.9
81;2021-05-03;1115;1170;114203;51258;29.4;13.2
81;2021-05-04;2620;1912;116823;53170;30.1;13.7
81;2021-05-05;2016;1936;118839;55106;30.6;14.2
81;2021-05-06;2748;3458;121587;58564;31.3;15.1
81;2021-05-07;2128;2882;123715;61446;31.9;15.8
81;2021-05-08;962;878;124677;62324;32.1;16.1
81;2021-05-09;534;1350;125211;63674;32.3;16.4
81;2021-05-10;823;1600;126034;65274;32.5;16.8
81;2021-05-11;1661;2576;127695;67850;32.9;17.5
81;2021-05-12;1640;2464;129335;70314;33.3;18.1
81;2021-05-13;1216;564;130551;70878;33.7;18.3
81;2021-05-14;1890;1725;132441;72603;34.1;18.7
81;2021-05-15;1511;622;133952;73225;34.5;18.9
81;2021-05-16;1368;417;135320;73642;34.9;19.0
81;2021-05-17;1167;863;136487;74505;35.2;19.2
81;2021-05-18;1702;1429;138189;75934;35.6;19.6
81;2021-05-19;2641;1244;140830;77178;36.3;19.9
81;2021-05-20;2968;1353;143798;78531;37.1;20.2
81;2021-05-21;2739;1118;146537;79649;37.8;20.5
81;2021-05-22;2815;523;149352;80172;38.5;20.7
81;2021-05-23;1178;75;150530;80247;38.8;20.7
81;2021-05-24;837;83;151367;80330;39.0;20.7
81;2021-05-25;2490;1104;153857;81434;39.7;21.0
81;2021-05-26;1891;801;155748;82235;40.2;21.2
81;2021-05-27;2555;1547;158303;83782;40.8;21.6
81;2021-05-28;2566;1663;160869;85445;41.5;22.0
81;2021-05-29;1400;544;162269;85989;41.8;22.2
81;2021-05-30;935;219;163204;86208;42.1;22.2
81;2021-05-31;1183;1340;164387;87548;42.4;22.6
81;2021-06-01;1779;2695;166166;90243;42.8;23.3
81;2021-06-02;2006;2447;168172;92690;43.4;23.9
81;2021-06-03;2003;2532;170175;95222;43.9;24.5
81;2021-06-04;1844;2946;172019;98168;44.3;25.3
81;2021-06-05;1757;1307;173776;99475;44.8;25.6
81;2021-06-06;370;366;174146;99841;44.9;25.7
81;2021-06-07;1209;1540;175355;101381;45.2;26.1
81;2021-06-08;2369;2386;177724;103767;45.8;26.8
81;2021-06-09;2437;1867;180161;105634;46.4;27.2
81;2021-06-10;1278;1563;181439;107197;46.8;27.6
81;2021-06-11;2657;2200;184096;109397;47.5;28.2
81;2021-06-12;1659;1039;185755;110436;47.9;28.5
81;2021-06-13;444;476;186199;110912;48.0;28.6
81;2021-06-14;771;1418;186970;112330;48.2;29.0
81;2021-06-15;1677;3501;188647;115831;48.6;29.9
81;2021-06-16;1269;3013;189916;118844;49.0;30.6
81;2021-06-17;1344;2525;191260;121369;49.3;31.3
81;2021-06-18;1836;2770;193096;124139;49.8;32.0
81;2021-06-19;824;951;193920;125090;50.0;32.2
81;2021-06-20;405;536;194325;125626;50.1;32.4
81;2021-06-21;425;1038;194750;126664;50.2;32.7
81;2021-06-22;1061;2568;195811;129232;50.5;33.3
81;2021-06-23;1142;2159;196953;131391;50.8;33.9
81;2021-06-24;1115;1939;198068;133330;51.1;34.4
81;2021-06-25;1238;2866;199306;136196;51.4;35.1
81;2021-06-26;721;1713;200027;137909;51.6;35.6
81;2021-06-27;526;1646;200553;139555;51.7;36.0
81;2021-06-28;476;1540;201029;141095;51.8;36.4
81;2021-06-29;1079;2635;202108;143730;52.1;37.1
81;2021-06-30;1043;3153;203151;146883;52.4;37.9
81;2021-07-01;1101;2627;204252;149510;52.7;38.5
81;2021-07-02;1070;2860;205322;152370;52.9;39.3
81;2021-07-03;732;2830;206054;155200;53.1;40.0
81;2021-07-04;268;1010;206322;156210;53.2;40.3
81;2021-07-05;702;1626;207024;157836;53.4;40.7
81;2021-07-06;975;3176;207999;161012;53.6;41.5
81;2021-07-07;1059;2442;209058;163454;53.9;42.1
81;2021-07-08;1030;2236;210088;165690;54.2;42.7
81;2021-07-09;1147;2704;211235;168394;54.5;43.4
81;2021-07-10;806;1523;212041;169917;54.7;43.8
81;2021-07-11;436;1012;212477;170929;54.8;44.1
81;2021-07-12;785;1725;213262;172654;55.0;44.5
81;2021-07-13;2081;3144;215343;175798;55.5;45.3
81;2021-07-14;1443;1573;216786;177371;55.9;45.7
81;2021-07-15;2545;2765;219331;180136;56.5;46.4
81;2021-07-16;2032;3030;221363;183166;57.1;47.2
81;2021-07-17;1219;2455;222582;185621;57.4;47.9
81;2021-07-18;672;1131;223254;186752;57.6;48.1
81;2021-07-19;1256;1733;224510;188485;57.9;48.6
81;2021-07-20;3064;2807;227574;191292;58.7;49.3
81;2021-07-21;3488;2347;231062;193639;59.6;49.9
81;2021-07-22;3557;2096;234619;195735;60.5;50.5
81;2021-07-23;3172;3250;237791;198985;61.3;51.3
81;2021-07-24;2519;1723;240310;200708;62.0;51.7
81;2021-07-25;1684;711;241994;201419;62.4;51.9
81;2021-07-26;2013;1546;244007;202965;62.9;52.3
81;2021-07-27;3619;2545;247626;205510;63.8;53.0
81;2021-07-28;3052;2210;250678;207720;64.6;53.6
81;2021-07-29;3354;1782;254032;209502;65.5;54.0
81;2021-07-30;2828;2260;256860;211762;66.2;54.6
81;2021-07-31;1947;1015;258807;212777;66.7;54.9
81;2021-08-01;835;639;259642;213416;66.9;55.0
81;2021-08-02;1082;989;260724;214405;67.2;55.3
81;2021-08-03;2362;2116;263086;216521;67.8;55.8
81;2021-08-04;2031;1535;265117;218056;68.3;56.2
81;2021-08-05;1544;1877;266661;219933;68.7;56.7
81;2021-08-06;1725;1971;268386;221904;69.2;57.2
81;2021-08-07;985;1043;269371;222947;69.4;57.5
81;2021-08-08;437;708;269808;223655;69.6;57.7
81;2021-08-09;806;659;270614;224314;69.8;57.8
81;2021-08-10;1610;2757;272224;227071;70.2;58.5
81;2021-08-11;1110;2410;273334;229481;70.5;59.2
81;2021-08-12;1063;2249;274397;231730;70.7;59.7
81;2021-08-13;873;2473;275270;234203;71.0;60.4
81;2021-08-14;501;1873;275771;236076;71.1;60.9
81;2021-08-15;141;1100;275912;237176;71.1;61.1
81;2021-08-16;631;1816;276543;238992;71.3;61.6
81;2021-08-17;1347;3101;277890;242093;71.6;62.4
81;2021-08-18;1067;2360;278957;244453;71.9;63.0
81;2021-08-19;941;2267;279898;246720;72.2;63.6
81;2021-08-20;928;2354;280826;249074;72.4;64.2
81;2021-08-21;471;1538;281297;250612;72.5;64.6
81;2021-08-22;184;931;281481;251543;72.6;64.8
81;2021-08-23;487;1260;281968;252803;72.7;65.2
81;2021-08-24;852;2543;282820;255346;72.9;65.8
81;2021-08-25;718;2054;283538;257400;73.1;66.4
81;2021-08-26;855;2110;284393;259510;73.3;66.9
81;2021-08-27;853;2185;285246;261695;73.5;67.5
81;2021-08-28;484;1418;285730;263113;73.7;67.8
81;2021-08-29;163;832;285893;263945;73.7;68.0
81;2021-08-30;419;1183;286312;265128;73.8;68.3
81;2021-08-31;832;2020;287144;267148;74.0;68.9
81;2021-09-01;659;1232;287803;268380;74.2;69.2
81;2021-09-02;574;1077;288377;269457;74.3;69.5
81;2021-09-03;581;1272;288958;270729;74.5;69.8
81;2021-09-04;496;864;289454;271593;74.6;70.0
81;2021-09-05;97;222;289551;271815;74.6;70.1
81;2021-09-06;279;463;289830;272278;74.7;70.2
81;2021-09-07;387;1092;290217;273370;74.8;70.5
81;2021-09-08;438;1070;290655;274440;74.9;70.8
81;2021-09-09;367;808;291022;275248;75.0;71.0
81;2021-09-10;396;963;291418;276211;75.1;71.2
81;2021-09-11;408;853;291826;277064;75.2;71.4
81;2021-09-12;79;216;291905;277280;75.3;71.5
81;2021-09-13;231;461;292136;277741;75.3;71.6
81;2021-09-14;504;730;292640;278471;75.4;71.8
81;2021-09-15;453;765;293093;279236;75.6;72.0
81;2021-09-16;337;548;293430;279784;75.6;72.1
81;2021-09-17;417;841;293847;280625;75.8;72.3
81;2021-09-18;261;697;294108;281322;75.8;72.5
81;2021-09-19;52;164;294160;281486;75.8;72.6
81;2021-09-20;112;323;294272;281809;75.9;72.7
81;2021-09-21;266;596;294538;282405;75.9;72.8
81;2021-09-22;214;664;294752;283069;76.0;73.0
81;2021-09-23;165;662;294917;283731;76.0;73.1
81;2021-09-24;307;704;295224;284435;76.1;73.3
81;2021-09-25;173;674;295397;285109;76.2;73.5
81;2021-09-26;36;116;295433;285225;76.2;73.5
81;2021-09-27;136;272;295569;285497;76.2;73.6
81;2021-09-28;185;363;295754;285860;76.2;73.7
81;2021-09-29;250;518;296004;286378;76.3;73.8
81;2021-09-30;143;292;296147;286670;76.3;73.9
81;2021-10-01;244;426;296391;287096;76.4;74.0
81;2021-10-02;181;415;296572;287511;76.5;74.1
81;2021-10-03;44;105;296616;287616;76.5;74.1
81;2021-10-04;88;209;296704;287825;76.5;74.2
81;2021-10-05;136;320;296840;288145;76.5;74.3
81;2021-10-06;212;471;297052;288616;76.6;74.4
81;2021-10-07;146;306;297198;288922;76.6;74.5
81;2021-10-08;193;500;297391;289422;76.7;74.6
81;2021-10-09;150;320;297541;289742;76.7;74.7
81;2021-10-10;52;71;297593;289813;76.7;74.7
81;2021-10-11;112;183;297705;289996;76.7;74.8
81;2021-10-12;139;249;297844;290245;76.8;74.8
81;2021-10-13;197;289;298041;290534;76.8;74.9
81;2021-10-14;143;257;298184;290791;76.9;75.0
81;2021-10-15;254;364;298438;291155;76.9;75.1
81;2021-10-16;201;201;298639;291356;77.0;75.1
81;2021-10-17;4;4;298643;291360;77.0;75.1
81;2021-10-18;100;121;298743;291481;77.0;75.1
81;2021-10-19;147;204;298890;291685;77.1;75.2
82;2020-12-27;1;0;1;0;0.0;0.0
82;2020-12-28;2;0;3;0;0.0;0.0
82;2020-12-29;0;0;3;0;0.0;0.0
82;2020-12-30;0;0;3;0;0.0;0.0
82;2020-12-31;0;0;3;0;0.0;0.0
82;2021-01-01;0;0;3;0;0.0;0.0
82;2021-01-02;0;0;3;0;0.0;0.0
82;2021-01-03;0;0;3;0;0.0;0.0
82;2021-01-04;0;0;3;0;0.0;0.0
82;2021-01-05;86;0;89;0;0.0;0.0
82;2021-01-06;1;0;90;0;0.0;0.0
82;2021-01-07;75;0;165;0;0.1;0.0
82;2021-01-08;46;0;211;0;0.1;0.0
82;2021-01-09;77;0;288;0;0.1;0.0
82;2021-01-10;0;0;288;0;0.1;0.0
82;2021-01-11;94;0;382;0;0.1;0.0
82;2021-01-12;285;0;667;0;0.3;0.0
82;2021-01-13;335;1;1002;1;0.4;0.0
82;2021-01-14;443;5;1445;6;0.6;0.0
82;2021-01-15;612;3;2057;9;0.8;0.0
82;2021-01-16;230;3;2287;12;0.9;0.0
82;2021-01-17;89;0;2376;12;0.9;0.0
82;2021-01-18;432;0;2808;12;1.1;0.0
82;2021-01-19;482;1;3290;13;1.3;0.0
82;2021-01-20;663;4;3953;17;1.5;0.0
82;2021-01-21;447;2;4400;19;1.7;0.0
82;2021-01-22;483;2;4883;21;1.9;0.0
82;2021-01-23;151;0;5034;21;1.9;0.0
82;2021-01-24;0;0;5034;21;1.9;0.0
82;2021-01-25;375;0;5409;21;2.1;0.0
82;2021-01-26;468;0;5877;21;2.2;0.0
82;2021-01-27;520;1;6397;22;2.4;0.0
82;2021-01-28;587;35;6984;57;2.7;0.0
82;2021-01-29;405;108;7389;165;2.8;0.1
82;2021-01-30;44;22;7433;187;2.8;0.1
82;2021-01-31;2;0;7435;187;2.8;0.1
82;2021-02-01;292;56;7727;243;2.9;0.1
82;2021-02-02;344;102;8071;345;3.1;0.1
82;2021-02-03;464;66;8535;411;3.2;0.2
82;2021-02-04;768;216;9303;627;3.5;0.2
82;2021-02-05;480;145;9783;772;3.7;0.3
82;2021-02-06;93;39;9876;811;3.8;0.3
82;2021-02-07;29;79;9905;890;3.8;0.3
82;2021-02-08;151;224;10056;1114;3.8;0.4
82;2021-02-09;238;397;10294;1511;3.9;0.6
82;2021-02-10;271;599;10565;2110;4.0;0.8
82;2021-02-11;225;400;10790;2510;4.1;1.0
82;2021-02-12;190;608;10980;3118;4.2;1.2
82;2021-02-13;60;117;11040;3235;4.2;1.2
82;2021-02-14;5;80;11045;3315;4.2;1.3
82;2021-02-15;216;304;11261;3619;4.3;1.4
82;2021-02-16;280;391;11541;4010;4.4;1.5
82;2021-02-17;359;522;11900;4532;4.5;1.7
82;2021-02-18;508;506;12408;5038;4.7;1.9
82;2021-02-19;492;542;12900;5580;4.9;2.1
82;2021-02-20;78;139;12978;5719;4.9;2.2
82;2021-02-21;0;0;12978;5719;4.9;2.2
82;2021-02-22;202;407;13180;6126;5.0;2.3
82;2021-02-23;277;469;13457;6595;5.1;2.5
82;2021-02-24;285;456;13742;7051;5.2;2.7
82;2021-02-25;637;510;14379;7561;5.5;2.9
82;2021-02-26;648;398;15027;7959;5.7;3.0
82;2021-02-27;214;75;15241;8034;5.8;3.1
82;2021-02-28;30;7;15271;8041;5.8;3.1
82;2021-03-01;292;230;15563;8271;5.9;3.1
82;2021-03-02;495;405;16058;8676;6.1;3.3
82;2021-03-03;440;387;16498;9063;6.3;3.5
82;2021-03-04;600;301;17098;9364;6.5;3.6
82;2021-03-05;681;383;17779;9747;6.8;3.7
82;2021-03-06;693;47;18472;9794;7.0;3.7
82;2021-03-07;302;4;18774;9798;7.1;3.7
82;2021-03-08;603;154;19377;9952;7.4;3.8
82;2021-03-09;583;256;19960;10208;7.6;3.9
82;2021-03-10;779;248;20739;10456;7.9;4.0
82;2021-03-11;977;286;21716;10742;8.3;4.1
82;2021-03-12;992;105;22708;10847;8.6;4.1
82;2021-03-13;564;54;23272;10901;8.9;4.2
82;2021-03-14;61;5;23333;10906;8.9;4.2
82;2021-03-15;485;326;23818;11232;9.1;4.3
82;2021-03-16;197;332;24015;11564;9.1;4.4
82;2021-03-17;191;294;24206;11858;9.2;4.5
82;2021-03-18;279;350;24485;12208;9.3;4.6
82;2021-03-19;532;312;25017;12520;9.5;4.8
82;2021-03-20;251;58;25268;12578;9.6;4.8
82;2021-03-21;23;0;25291;12578;9.6;4.8
82;2021-03-22;406;323;25697;12901;9.8;4.9
82;2021-03-23;601;314;26298;13215;10.0;5.0
82;2021-03-24;621;332;26919;13547;10.3;5.2
82;2021-03-25;928;246;27847;13793;10.6;5.3
82;2021-03-26;1216;272;29063;14065;11.1;5.4
82;2021-03-27;479;79;29542;14144;11.2;5.4
82;2021-03-28;136;2;29678;14146;11.3;5.4
82;2021-03-29;926;379;30604;14525;11.7;5.5
82;2021-03-30;1188;280;31792;14805;12.1;5.6
82;2021-03-31;1018;264;32810;15069;12.5;5.7
82;2021-04-01;1070;199;33880;15268;12.9;5.8
82;2021-04-02;1213;286;35093;15554;13.4;5.9
82;2021-04-03;715;132;35808;15686;13.6;6.0
82;2021-04-04;276;14;36084;15700;13.7;6.0
82;2021-04-05;388;20;36472;15720;13.9;6.0
82;2021-04-06;953;512;37425;16232;14.3;6.2
82;2021-04-07;1016;498;38441;16730;14.6;6.4
82;2021-04-08;1454;418;39895;17148;15.2;6.5
82;2021-04-09;1656;474;41551;17622;15.8;6.7
82;2021-04-10;1716;103;43267;17725;16.5;6.7
82;2021-04-11;560;20;43827;17745;16.7;6.8
82;2021-04-12;1348;294;45175;18039;17.2;6.9
82;2021-04-13;1626;275;46801;18314;17.8;7.0
82;2021-04-14;1412;302;48213;18616;18.4;7.1
82;2021-04-15;1781;325;49994;18941;19.0;7.2
82;2021-04-16;1542;336;51536;19277;19.6;7.3
82;2021-04-17;1243;71;52779;19348;20.1;7.4
82;2021-04-18;560;15;53339;19363;20.3;7.4
82;2021-04-19;957;359;54296;19722;20.7;7.5
82;2021-04-20;1267;403;55563;20125;21.2;7.7
82;2021-04-21;1217;374;56780;20499;21.6;7.8
82;2021-04-22;1452;295;58232;20794;22.2;7.9
82;2021-04-23;1076;683;59308;21477;22.6;8.2
82;2021-04-24;1188;265;60496;21742;23.0;8.3
82;2021-04-25;736;49;61232;21791;23.3;8.3
82;2021-04-26;748;810;61980;22601;23.6;8.6
82;2021-04-27;905;925;62885;23526;23.9;9.0
82;2021-04-28;921;898;63806;24424;24.3;9.3
82;2021-04-29;1107;912;64913;25336;24.7;9.6
82;2021-04-30;1042;890;65955;26226;25.1;10.0
82;2021-05-01;1143;258;67098;26484;25.5;10.1
82;2021-05-02;697;145;67795;26629;25.8;10.1
82;2021-05-03;410;1217;68205;27846;26.0;10.6
82;2021-05-04;862;1170;69067;29016;26.3;11.0
82;2021-05-05;568;1176;69635;30192;26.5;11.5
82;2021-05-06;848;1420;70483;31612;26.8;12.0
82;2021-05-07;734;1459;71217;33071;27.1;12.6
82;2021-05-08;934;521;72151;33592;27.5;12.8
82;2021-05-09;753;578;72904;34170;27.8;13.0
82;2021-05-10;850;1366;73754;35536;28.1;13.5
82;2021-05-11;1157;1348;74911;36884;28.5;14.0
82;2021-05-12;1015;1345;75926;38229;28.9;14.6
82;2021-05-13;1454;432;77380;38661;29.5;14.7
82;2021-05-14;1690;1240;79070;39901;30.1;15.2
82;2021-05-15;1934;697;81004;40598;30.8;15.5
82;2021-05-16;558;114;81562;40712;31.1;15.5
82;2021-05-17;1090;1173;82652;41885;31.5;15.9
82;2021-05-18;1465;1190;84117;43075;32.0;16.4
82;2021-05-19;1272;974;85389;44049;32.5;16.8
82;2021-05-20;1408;1160;86797;45209;33.1;17.2
82;2021-05-21;1411;1219;88208;46428;33.6;17.7
82;2021-05-22;2067;631;90275;47059;34.4;17.9
82;2021-05-23;705;117;90980;47176;34.6;18.0
82;2021-05-24;1441;265;92421;47441;35.2;18.1
82;2021-05-25;1444;963;93865;48404;35.7;18.4
82;2021-05-26;1411;920;95276;49324;36.3;18.8
82;2021-05-27;1461;1025;96737;50349;36.8;19.2
82;2021-05-28;1540;1146;98277;51495;37.4;19.6
82;2021-05-29;1496;545;99773;52040;38.0;19.8
82;2021-05-30;402;101;100175;52141;38.1;19.9
82;2021-05-31;1490;991;101665;53132;38.7;20.2
82;2021-06-01;1750;1052;103415;54184;39.4;20.6
82;2021-06-02;1477;1007;104892;55191;39.9;21.0
82;2021-06-03;1489;1184;106381;56375;40.5;21.5
82;2021-06-04;2250;1306;108631;57681;41.4;22.0
82;2021-06-05;2267;987;110898;58668;42.2;22.3
82;2021-06-06;329;133;111227;58801;42.4;22.4
82;2021-06-07;957;1275;112184;60076;42.7;22.9
82;2021-06-08;1445;1139;113629;61215;43.3;23.3
82;2021-06-09;1707;1142;115336;62357;43.9;23.7
82;2021-06-10;1441;1208;116777;63565;44.5;24.2
82;2021-06-11;1922;1128;118699;64693;45.2;24.6
82;2021-06-12;2392;1395;121091;66088;46.1;25.2
82;2021-06-13;379;113;121470;66201;46.3;25.2
82;2021-06-14;1213;1083;122683;67284;46.7;25.6
82;2021-06-15;1462;1245;124145;68529;47.3;26.1
82;2021-06-16;1749;1168;125894;69697;47.9;26.5
82;2021-06-17;1220;1472;127114;71169;48.4;27.1
82;2021-06-18;1469;1439;128583;72608;49.0;27.6
82;2021-06-19;2269;982;130852;73590;49.8;28.0
82;2021-06-20;269;173;131121;73763;49.9;28.1
82;2021-06-21;484;1361;131605;75124;50.1;28.6
82;2021-06-22;893;1710;132498;76834;50.5;29.3
82;2021-06-23;1238;1587;133736;78421;50.9;29.9
82;2021-06-24;756;1904;134492;80325;51.2;30.6
82;2021-06-25;739;1936;135231;82261;51.5;31.3
82;2021-06-26;1239;2146;136470;84407;52.0;32.1
82;2021-06-27;195;440;136665;84847;52.0;32.3
82;2021-06-28;328;1411;136993;86258;52.2;32.8
82;2021-06-29;518;1842;137511;88100;52.4;33.5
82;2021-06-30;947;1912;138458;90012;52.7;34.3
82;2021-07-01;658;1633;139116;91645;53.0;34.9
82;2021-07-02;931;2295;140047;93940;53.3;35.8
82;2021-07-03;858;2340;140905;96280;53.7;36.7
82;2021-07-04;120;439;141025;96719;53.7;36.8
82;2021-07-05;445;1561;141470;98280;53.9;37.4
82;2021-07-06;513;1867;141983;100147;54.1;38.1
82;2021-07-07;793;1775;142776;101922;54.4;38.8
82;2021-07-08;504;1504;143280;103426;54.6;39.4
82;2021-07-09;781;2155;144061;105581;54.9;40.2
82;2021-07-10;706;2218;144767;107799;55.1;41.0
82;2021-07-11;39;380;144806;108179;55.1;41.2
82;2021-07-12;578;1884;145384;110063;55.4;41.9
82;2021-07-13;714;2003;146098;112066;55.6;42.7
82;2021-07-14;617;741;146715;112807;55.9;43.0
82;2021-07-15;859;1751;147574;114558;56.2;43.6
82;2021-07-16;1436;2638;149010;117196;56.7;44.6
82;2021-07-17;560;2182;149570;119378;57.0;45.5
82;2021-07-18;14;41;149584;119419;57.0;45.5
82;2021-07-19;736;2072;150320;121491;57.2;46.3
82;2021-07-20;919;1882;151239;123373;57.6;47.0
82;2021-07-21;1289;1762;152528;125135;58.1;47.6
82;2021-07-22;1083;1767;153611;126902;58.5;48.3
82;2021-07-23;1056;2990;154667;129892;58.9;49.5
82;2021-07-24;1102;1490;155769;131382;59.3;50.0
82;2021-07-25;303;74;156072;131456;59.4;50.1
82;2021-07-26;950;1897;157022;133353;59.8;50.8
82;2021-07-27;1324;1641;158346;134994;60.3;51.4
82;2021-07-28;1469;1500;159815;136494;60.9;52.0
82;2021-07-29;1331;1534;161146;138028;61.4;52.6
82;2021-07-30;1537;2477;162683;140505;61.9;53.5
82;2021-07-31;459;296;163142;140801;62.1;53.6
82;2021-08-01;273;50;163415;140851;62.2;53.6
82;2021-08-02;1271;879;164686;141730;62.7;54.0
82;2021-08-03;1435;832;166121;142562;63.3;54.3
82;2021-08-04;1363;1029;167484;143591;63.8;54.7
82;2021-08-05;1491;601;168975;144192;64.3;54.9
82;2021-08-06;996;648;169971;144840;64.7;55.2
82;2021-08-07;923;1197;170894;146037;65.1;55.6
82;2021-08-08;157;65;171051;146102;65.1;55.6
82;2021-08-09;1071;899;172122;147001;65.5;56.0
82;2021-08-10;1289;916;173411;147917;66.0;56.3
82;2021-08-11;1264;1123;174675;149040;66.5;56.8
82;2021-08-12;1473;946;176148;149986;67.1;57.1
82;2021-08-13;1413;997;177561;150983;67.6;57.5
82;2021-08-14;314;486;177875;151469;67.7;57.7
82;2021-08-15;61;38;177936;151507;67.8;57.7
82;2021-08-16;781;1459;178717;152966;68.1;58.2
82;2021-08-17;1064;1235;179781;154201;68.5;58.7
82;2021-08-18;616;848;180397;155049;68.7;59.0
82;2021-08-19;1013;1147;181410;156196;69.1;59.5
82;2021-08-20;1034;1907;182444;158103;69.5;60.2
82;2021-08-21;495;991;182939;159094;69.7;60.6
82;2021-08-22;21;55;182960;159149;69.7;60.6
82;2021-08-23;745;1292;183705;160441;70.0;61.1
82;2021-08-24;863;1117;184568;161558;70.3;61.5
82;2021-08-25;849;1538;185417;163096;70.6;62.1
82;2021-08-26;598;1108;186015;164204;70.8;62.5
82;2021-08-27;898;1686;186913;165890;71.2;63.2
82;2021-08-28;211;616;187124;166506;71.3;63.4
82;2021-08-29;44;49;187168;166555;71.3;63.4
82;2021-08-30;431;1015;187599;167570;71.4;63.8
82;2021-08-31;339;1005;187938;168575;71.6;64.2
82;2021-09-01;721;1357;188659;169932;71.8;64.7
82;2021-09-02;406;1235;189065;171167;72.0;65.2
82;2021-09-03;500;1738;189565;172905;72.2;65.8
82;2021-09-04;426;691;189991;173596;72.3;66.1
82;2021-09-05;6;23;189997;173619;72.3;66.1
82;2021-09-06;374;1141;190371;174760;72.5;66.5
82;2021-09-07;209;880;190580;175640;72.6;66.9
82;2021-09-08;495;1169;191075;176809;72.8;67.3
82;2021-09-09;249;930;191324;177739;72.9;67.7
82;2021-09-10;491;1249;191815;178988;73.0;68.2
82;2021-09-11;212;475;192027;179463;73.1;68.3
82;2021-09-12;12;29;192039;179492;73.1;68.3
82;2021-09-13;298;850;192337;180342;73.2;68.7
82;2021-09-14;210;802;192547;181144;73.3;69.0
82;2021-09-15;308;1166;192855;182310;73.4;69.4
82;2021-09-16;222;496;193077;182806;73.5;69.6
82;2021-09-17;192;495;193269;183301;73.6;69.8
82;2021-09-18;327;1082;193596;184383;73.7;70.2
82;2021-09-19;1;14;193597;184397;73.7;70.2
82;2021-09-20;142;416;193739;184813;73.8;70.4
82;2021-09-21;94;382;193833;185195;73.8;70.5
82;2021-09-22;137;455;193970;185650;73.9;70.7
82;2021-09-23;114;384;194084;186034;73.9;70.8
82;2021-09-24;214;600;194298;186634;74.0;71.1
82;2021-09-25;231;659;194529;187293;74.1;71.3
82;2021-09-26;5;10;194534;187303;74.1;71.3
82;2021-09-27;100;453;194634;187756;74.1;71.5
82;2021-09-28;90;232;194724;187988;74.1;71.6
82;2021-09-29;231;479;194955;188467;74.2;71.8
82;2021-09-30;110;250;195065;188717;74.3;71.9
82;2021-10-01;197;373;195262;189090;74.4;72.0
82;2021-10-02;133;273;195395;189363;74.4;72.1
82;2021-10-03;4;1;195399;189364;74.4;72.1
82;2021-10-04;120;415;195519;189779;74.4;72.3
82;2021-10-05;129;274;195648;190053;74.5;72.4
82;2021-10-06;167;344;195815;190397;74.6;72.5
82;2021-10-07;65;124;195880;190521;74.6;72.5
82;2021-10-08;292;387;196172;190908;74.7;72.7
82;2021-10-09;122;247;196294;191155;74.7;72.8
82;2021-10-10;2;14;196296;191169;74.7;72.8
82;2021-10-11;94;227;196390;191396;74.8;72.9
82;2021-10-12;89;140;196479;191536;74.8;72.9
82;2021-10-13;189;293;196668;191829;74.9;73.0
82;2021-10-14;43;67;196711;191896;74.9;73.1
82;2021-10-15;172;250;196883;192146;75.0;73.2
82;2021-10-16;120;143;197003;192289;75.0;73.2
82;2021-10-17;2;5;197005;192294;75.0;73.2
82;2021-10-18;136;159;197141;192453;75.1;73.3
82;2021-10-19;109;142;197250;192595;75.1;73.3
83;2020-12-27;2;0;2;0;0.0;0.0
83;2020-12-28;0;0;2;0;0.0;0.0
83;2020-12-29;2;0;4;0;0.0;0.0
83;2020-12-30;3;0;7;0;0.0;0.0
83;2020-12-31;0;0;7;0;0.0;0.0
83;2021-01-01;1;0;8;0;0.0;0.0
83;2021-01-02;0;0;8;0;0.0;0.0
83;2021-01-03;1;0;9;0;0.0;0.0
83;2021-01-04;1;0;10;0;0.0;0.0
83;2021-01-05;4;1;14;1;0.0;0.0
83;2021-01-06;69;0;83;1;0.0;0.0
83;2021-01-07;324;0;407;1;0.0;0.0
83;2021-01-08;421;1;828;2;0.1;0.0
83;2021-01-09;48;0;876;2;0.1;0.0
83;2021-01-10;1;0;877;2;0.1;0.0
83;2021-01-11;475;0;1352;2;0.1;0.0
83;2021-01-12;1015;5;2367;7;0.2;0.0
83;2021-01-13;963;8;3330;15;0.3;0.0
83;2021-01-14;848;9;4178;24;0.4;0.0
83;2021-01-15;714;3;4892;27;0.5;0.0
83;2021-01-16;42;1;4934;28;0.5;0.0
83;2021-01-17;1;0;4935;28;0.5;0.0
83;2021-01-18;1228;4;6163;32;0.6;0.0
83;2021-01-19;2021;8;8184;40;0.8;0.0
83;2021-01-20;1660;9;9844;49;0.9;0.0
83;2021-01-21;2104;8;11948;57;1.1;0.0
83;2021-01-22;1664;8;13612;65;1.3;0.0
83;2021-01-23;246;2;13858;67;1.3;0.0
83;2021-01-24;21;1;13879;68;1.3;0.0
83;2021-01-25;1556;7;15435;75;1.4;0.0
83;2021-01-26;1758;15;17193;90;1.6;0.0
83;2021-01-27;2155;87;19348;177;1.8;0.0
83;2021-01-28;5102;393;24450;570;2.3;0.1
83;2021-01-29;2950;355;27400;925;2.6;0.1
83;2021-01-30;237;47;27637;972;2.6;0.1
83;2021-01-31;46;0;27683;972;2.6;0.1
83;2021-02-01;1283;413;28966;1385;2.7;0.1
83;2021-02-02;1442;720;30408;2105;2.8;0.2
83;2021-02-03;1527;635;31935;2740;3.0;0.3
83;2021-02-04;1485;743;33420;3483;3.1;0.3
83;2021-02-05;1227;681;34647;4164;3.2;0.4
83;2021-02-06;24;15;34671;4179;3.2;0.4
83;2021-02-07;2;0;34673;4179;3.2;0.4
83;2021-02-08;1091;622;35764;4801;3.3;0.4
83;2021-02-09;1325;911;37089;5712;3.5;0.5
83;2021-02-10;1537;804;38626;6516;3.6;0.6
83;2021-02-11;1612;1028;40238;7544;3.7;0.7
83;2021-02-12;1353;825;41591;8369;3.9;0.8
83;2021-02-13;55;26;41646;8395;3.9;0.8
83;2021-02-14;0;0;41646;8395;3.9;0.8
83;2021-02-15;677;1050;42323;9445;3.9;0.9
83;2021-02-16;544;1371;42867;10816;4.0;1.0
83;2021-02-17;805;1831;43672;12647;4.1;1.2
83;2021-02-18;1629;3874;45301;16521;4.2;1.5
83;2021-02-19;1482;2331;46783;18852;4.4;1.8
83;2021-02-20;63;169;46846;19021;4.4;1.8
83;2021-02-21;25;36;46871;19057;4.4;1.8
83;2021-02-22;507;1748;47378;20805;4.4;1.9
83;2021-02-23;673;1441;48051;22246;4.5;2.1
83;2021-02-24;726;1484;48777;23730;4.5;2.2
83;2021-02-25;1252;1410;50029;25140;4.7;2.3
83;2021-02-26;1299;1255;51328;26395;4.8;2.5
83;2021-02-27;552;56;51880;26451;4.8;2.5
83;2021-02-28;10;15;51890;26466;4.8;2.5
83;2021-03-01;808;1239;52698;27705;4.9;2.6
83;2021-03-02;992;1310;53690;29015;5.0;2.7
83;2021-03-03;1439;1528;55129;30543;5.1;2.8
83;2021-03-04;1895;1393;57024;31936;5.3;3.0
83;2021-03-05;2220;1242;59244;33178;5.5;3.1
83;2021-03-06;3010;121;62254;33299;5.8;3.1
83;2021-03-07;2228;49;64482;33348;6.0;3.1
83;2021-03-08;853;1319;65335;34667;6.1;3.2
83;2021-03-09;1938;1230;67273;35897;6.3;3.3
83;2021-03-10;2383;1375;69656;37272;6.5;3.5
83;2021-03-11;3677;2218;73333;39490;6.8;3.7
83;2021-03-12;3662;1519;76995;41009;7.2;3.8
83;2021-03-13;4616;186;81611;41195;7.6;3.8
83;2021-03-14;2343;62;83954;41257;7.8;3.8
83;2021-03-15;3340;676;87294;41933;8.1;3.9
83;2021-03-16;2606;701;89900;42634;8.4;4.0
83;2021-03-17;2848;790;92748;43424;8.6;4.0
83;2021-03-18;3557;797;96305;44221;9.0;4.1
83;2021-03-19;4175;595;100480;44816;9.4;4.2
83;2021-03-20;3478;77;103958;44893;9.7;4.2
83;2021-03-21;2010;32;105968;44925;9.9;4.2
83;2021-03-22;3965;898;109933;45823;10.2;4.3
83;2021-03-23;4751;601;114684;46424;10.7;4.3
83;2021-03-24;5050;731;119734;47155;11.2;4.4
83;2021-03-25;6535;864;126269;48019;11.8;4.5
83;2021-03-26;7176;763;133445;48782;12.4;4.5
83;2021-03-27;3971;389;137416;49171;12.8;4.6
83;2021-03-28;2183;36;139599;49207;13.0;4.6
83;2021-03-29;4559;777;144158;49984;13.4;4.7
83;2021-03-30;5969;963;150127;50947;14.0;4.7
83;2021-03-31;5553;1083;155680;52030;14.5;4.8
83;2021-04-01;5980;1272;161660;53302;15.1;5.0
83;2021-04-02;5762;1077;167422;54379;15.6;5.1
83;2021-04-03;1800;637;169222;55016;15.8;5.1
83;2021-04-04;854;348;170076;55364;15.8;5.2
83;2021-04-05;190;67;170266;55431;15.9;5.2
83;2021-04-06;4733;1412;174999;56843;16.3;5.3
83;2021-04-07;5832;1666;180831;58509;16.8;5.4
83;2021-04-08;7892;2015;188723;60524;17.6;5.6
83;2021-04-09;7598;2212;196321;62736;18.3;5.8
83;2021-04-10;2946;2656;199267;65392;18.6;6.1
83;2021-04-11;1716;2143;200983;67535;18.7;6.3
83;2021-04-12;4951;2885;205934;70420;19.2;6.6
83;2021-04-13;5409;3006;211343;73426;19.7;6.8
83;2021-04-14;5898;2954;217241;76380;20.2;7.1
83;2021-04-15;6776;3045;224017;79425;20.9;7.4
83;2021-04-16;6127;3528;230144;82953;21.4;7.7
83;2021-04-17;3511;2193;233655;85146;21.8;7.9
83;2021-04-18;2179;1300;235834;86446;22.0;8.1
83;2021-04-19;4114;3909;239948;90355;22.3;8.4
83;2021-04-20;4360;3875;244308;94230;22.8;8.8
83;2021-04-21;4300;4157;248608;98387;23.2;9.2
83;2021-04-22;5010;4310;253618;102697;23.6;9.6
83;2021-04-23;4531;4573;258149;107270;24.0;10.0
83;2021-04-24;2629;2722;260778;109992;24.3;10.2
83;2021-04-25;1925;1572;262703;111564;24.5;10.4
83;2021-04-26;3568;3857;266271;115421;24.8;10.7
83;2021-04-27;4140;4560;270411;119981;25.2;11.2
83;2021-04-28;4314;4382;274725;124363;25.6;11.6
83;2021-04-29;5823;5139;280548;129502;26.1;12.1
83;2021-04-30;5787;4314;286335;133816;26.7;12.5
83;2021-05-01;1693;430;288028;134246;26.8;12.5
83;2021-05-02;1237;760;289265;135006;26.9;12.6
83;2021-05-03;3751;4287;293016;139293;27.3;13.0
83;2021-05-04;3345;5104;296361;144397;27.6;13.4
83;2021-05-05;3644;4975;300005;149372;27.9;13.9
83;2021-05-06;4678;4965;304683;154337;28.4;14.4
83;2021-05-07;4167;5317;308850;159654;28.8;14.9
83;2021-05-08;2764;1017;311614;160671;29.0;15.0
83;2021-05-09;2151;1237;313765;161908;29.2;15.1
83;2021-05-10;3200;5428;316965;167336;29.5;15.6
83;2021-05-11;5126;5691;322091;173027;30.0;16.1
83;2021-05-12;6292;4845;328383;177872;30.6;16.6
83;2021-05-13;6582;1345;334965;179217;31.2;16.7
83;2021-05-14;7421;4116;342386;183333;31.9;17.1
83;2021-05-15;7752;2210;350138;185543;32.6;17.3
83;2021-05-16;6624;1247;356762;186790;33.2;17.4
83;2021-05-17;4894;4211;361656;191001;33.7;17.8
83;2021-05-18;5533;3865;367189;194866;34.2;18.1
83;2021-05-19;6207;3412;373396;198278;34.8;18.5
83;2021-05-20;6753;3806;380149;202084;35.4;18.8
83;2021-05-21;7904;3870;388053;205954;36.1;19.2
83;2021-05-22;6087;1720;394140;207674;36.7;19.3
83;2021-05-23;4682;714;398822;208388;37.1;19.4
83;2021-05-24;5809;973;404631;209361;37.7;19.5
83;2021-05-25;5511;4759;410142;214120;38.2;19.9
83;2021-05-26;4857;4447;414999;218567;38.6;20.4
83;2021-05-27;5069;5259;420068;223826;39.1;20.8
83;2021-05-28;4504;5760;424572;229586;39.5;21.4
83;2021-05-29;2706;4271;427278;233857;39.8;21.8
83;2021-05-30;1256;1373;428534;235230;39.9;21.9
83;2021-05-31;5486;4765;434020;239995;40.4;22.3
83;2021-06-01;5733;5310;439753;245305;41.0;22.8
83;2021-06-02;5262;4585;445015;249890;41.4;23.3
83;2021-06-03;5743;5134;450758;255024;42.0;23.7
83;2021-06-04;5445;6045;456203;261069;42.5;24.3
83;2021-06-05;3919;3198;460122;264267;42.8;24.6
83;2021-06-06;1933;1383;462055;265650;43.0;24.7
83;2021-06-07;3912;5093;465967;270743;43.4;25.2
83;2021-06-08;4175;4821;470142;275564;43.8;25.7
83;2021-06-09;4007;4705;474149;280269;44.2;26.1
83;2021-06-10;3999;4264;478148;284533;44.5;26.5
83;2021-06-11;3659;5451;481807;289984;44.9;27.0
83;2021-06-12;2913;2985;484720;292969;45.1;27.3
83;2021-06-13;995;1390;485715;294359;45.2;27.4
83;2021-06-14;2854;5656;488569;300015;45.5;27.9
83;2021-06-15;3167;4861;491736;304876;45.8;28.4
83;2021-06-16;2963;4504;494699;309380;46.1;28.8
83;2021-06-17;2785;5291;497484;314671;46.3;29.3
83;2021-06-18;3160;5965;500644;320636;46.6;29.9
83;2021-06-19;2323;4100;502967;324736;46.8;30.2
83;2021-06-20;676;1889;503643;326625;46.9;30.4
83;2021-06-21;2109;7585;505752;334210;47.1;31.1
83;2021-06-22;2103;7167;507855;341377;47.3;31.8
83;2021-06-23;1936;6929;509791;348306;47.5;32.4
83;2021-06-24;1962;7367;511753;355673;47.7;33.1
83;2021-06-25;2111;8394;513864;364067;47.9;33.9
83;2021-06-26;1462;6807;515326;370874;48.0;34.5
83;2021-06-27;692;3184;516018;374058;48.1;34.8
83;2021-06-28;1570;7882;517588;381940;48.2;35.6
83;2021-06-29;1907;7809;519495;389749;48.4;36.3
83;2021-06-30;2240;7274;521735;397023;48.6;37.0
83;2021-07-01;2563;6567;524298;403590;48.8;37.6
83;2021-07-02;2265;7796;526563;411386;49.0;38.3
83;2021-07-03;1509;5685;528072;417071;49.2;38.8
83;2021-07-04;572;2753;528644;419824;49.2;39.1
83;2021-07-05;1925;7532;530569;427356;49.4;39.8
83;2021-07-06;2571;5941;533140;433297;49.6;40.4
83;2021-07-07;2686;4668;535826;437965;49.9;40.8
83;2021-07-08;3246;4478;539072;442443;50.2;41.2
83;2021-07-09;3045;6965;542117;449408;50.5;41.9
83;2021-07-10;1579;4929;543696;454337;50.6;42.3
83;2021-07-11;1009;1766;544705;456103;50.7;42.5
83;2021-07-12;2142;7689;546847;463792;50.9;43.2
83;2021-07-13;4042;7097;550889;470889;51.3;43.9
83;2021-07-14;2094;1322;552983;472211;51.5;44.0
83;2021-07-15;4580;6845;557563;479056;51.9;44.6
83;2021-07-16;5274;7123;562837;486179;52.4;45.3
83;2021-07-17;3650;5001;566487;491180;52.8;45.7
83;2021-07-18;1604;1311;568091;492491;52.9;45.9
83;2021-07-19;3953;6321;572044;498812;53.3;46.5
83;2021-07-20;5986;6198;578030;505010;53.8;47.0
83;2021-07-21;6031;5216;584061;510226;54.4;47.5
83;2021-07-22;7118;5545;591179;515771;55.1;48.0
83;2021-07-23;7099;5924;598278;521695;55.7;48.6
83;2021-07-24;4650;4571;602928;526266;56.1;49.0
83;2021-07-25;1329;737;604257;527003;56.3;49.1
83;2021-07-26;5546;4939;609803;531942;56.8;49.5
83;2021-07-27;6833;4906;616636;536848;57.4;50.0
83;2021-07-28;6601;4428;623237;541276;58.0;50.4
83;2021-07-29;7500;4863;630737;546139;58.7;50.9
83;2021-07-30;6968;4762;637705;550901;59.4;51.3
83;2021-07-31;4667;3219;642372;554120;59.8;51.6
83;2021-08-01;1066;849;643438;554969;59.9;51.7
83;2021-08-02;5771;3712;649209;558681;60.5;52.0
83;2021-08-03;6387;3999;655596;562680;61.1;52.4
83;2021-08-04;5915;3719;661511;566399;61.6;52.7
83;2021-08-05;6184;4092;667695;570491;62.2;53.1
83;2021-08-06;6162;4918;673857;575409;62.8;53.6
83;2021-08-07;3751;3558;677608;578967;63.1;53.9
83;2021-08-08;1064;823;678672;579790;63.2;54.0
83;2021-08-09;4718;4648;683390;584438;63.6;54.4
83;2021-08-10;5236;5150;688626;589588;64.1;54.9
83;2021-08-11;4593;5069;693219;594657;64.6;55.4
83;2021-08-12;4931;5570;698150;600227;65.0;55.9
83;2021-08-13;4938;5742;703088;605969;65.5;56.4
83;2021-08-14;3223;3892;706311;609861;65.8;56.8
83;2021-08-15;209;393;706520;610254;65.8;56.8
83;2021-08-16;3633;5484;710153;615738;66.1;57.3
83;2021-08-17;3578;5272;713731;621010;66.5;57.8
83;2021-08-18;3609;5005;717340;626015;66.8;58.3
83;2021-08-19;4181;6262;721521;632277;67.2;58.9
83;2021-08-20;3645;6517;725166;638794;67.5;59.5
83;2021-08-21;2348;4490;727514;643284;67.7;59.9
83;2021-08-22;635;1033;728149;644317;67.8;60.0
83;2021-08-23;2506;5787;730655;650104;68.0;60.5
83;2021-08-24;2922;5921;733577;656025;68.3;61.1
83;2021-08-25;2587;5295;736164;661320;68.6;61.6
83;2021-08-26;2804;5846;738968;667166;68.8;62.1
83;2021-08-27;2919;5925;741887;673091;69.1;62.7
83;2021-08-28;1934;4539;743821;677630;69.3;63.1
83;2021-08-29;476;1162;744297;678792;69.3;63.2
83;2021-08-30;2384;4883;746681;683675;69.5;63.7
83;2021-08-31;2509;5295;749190;688970;69.8;64.2
83;2021-09-01;2600;4596;751790;693566;70.0;64.6
83;2021-09-02;2489;4426;754279;697992;70.2;65.0
83;2021-09-03;2338;4649;756617;702641;70.5;65.4
83;2021-09-04;1947;4376;758564;707017;70.6;65.8
83;2021-09-05;568;415;759132;707432;70.7;65.9
83;2021-09-06;1666;3336;760798;710768;70.8;66.2
83;2021-09-07;1669;3169;762467;713937;71.0;66.5
83;2021-09-08;1940;3338;764407;717275;71.2;66.8
83;2021-09-09;1494;3301;765901;720576;71.3;67.1
83;2021-09-10;1784;3620;767685;724196;71.5;67.4
83;2021-09-11;1376;3633;769061;727829;71.6;67.8
83;2021-09-12;204;458;769265;728287;71.6;67.8
83;2021-09-13;1227;2517;770492;730804;71.8;68.1
83;2021-09-14;1335;2496;771827;733300;71.9;68.3
83;2021-09-15;1371;2540;773198;735840;72.0;68.5
83;2021-09-16;1043;2178;774241;738018;72.1;68.7
83;2021-09-17;1043;2528;775284;740546;72.2;69.0
83;2021-09-18;1024;3001;776308;743547;72.3;69.2
83;2021-09-19;97;399;776405;743946;72.3;69.3
83;2021-09-20;691;2035;777096;745981;72.4;69.5
83;2021-09-21;734;1811;777830;747792;72.4;69.6
83;2021-09-22;769;2499;778599;750291;72.5;69.9
83;2021-09-23;718;2114;779317;752405;72.6;70.1
83;2021-09-24;728;2199;780045;754604;72.6;70.3
83;2021-09-25;744;2667;780789;757271;72.7;70.5
83;2021-09-26;70;449;780859;757720;72.7;70.6
83;2021-09-27;614;1733;781473;759453;72.8;70.7
83;2021-09-28;567;1505;782040;760958;72.8;70.9
83;2021-09-29;715;1879;782755;762837;72.9;71.0
83;2021-09-30;638;1507;783393;764344;73.0;71.2
83;2021-10-01;749;1535;784142;765879;73.0;71.3
83;2021-10-02;688;1622;784830;767501;73.1;71.5
83;2021-10-03;108;254;784938;767755;73.1;71.5
83;2021-10-04;488;890;785426;768645;73.1;71.6
83;2021-10-05;594;1118;786020;769763;73.2;71.7
83;2021-10-06;742;1555;786762;771318;73.3;71.8
83;2021-10-07;522;1055;787284;772373;73.3;71.9
83;2021-10-08;737;1342;788021;773715;73.4;72.1
83;2021-10-09;523;990;788544;774705;73.4;72.1
83;2021-10-10;19;39;788563;774744;73.4;72.1
83;2021-10-11;640;1125;789203;775869;73.5;72.3
83;2021-10-12;489;780;789692;776649;73.5;72.3
83;2021-10-13;629;1000;790321;777649;73.6;72.4
83;2021-10-14;514;840;790835;778489;73.6;72.5
83;2021-10-15;691;1060;791526;779549;73.7;72.6
83;2021-10-16;575;878;792101;780427;73.8;72.7
83;2021-10-17;13;29;792114;780456;73.8;72.7
83;2021-10-18;530;812;792644;781268;73.8;72.8
83;2021-10-19;405;634;793049;781902;73.9;72.8
84;2020-12-27;2;1;2;1;0.0;0.0
84;2020-12-28;1;1;3;2;0.0;0.0
84;2020-12-29;3;1;6;3;0.0;0.0
84;2020-12-30;2;0;8;3;0.0;0.0
84;2020-12-31;2;0;10;3;0.0;0.0
84;2021-01-01;0;0;10;3;0.0;0.0
84;2021-01-02;0;0;10;3;0.0;0.0
84;2021-01-03;0;0;10;3;0.0;0.0
84;2021-01-04;1;0;11;3;0.0;0.0
84;2021-01-05;1;0;12;3;0.0;0.0
84;2021-01-06;0;0;12;3;0.0;0.0
84;2021-01-07;69;0;81;3;0.0;0.0
84;2021-01-08;84;0;165;3;0.0;0.0
84;2021-01-09;31;1;196;4;0.0;0.0
84;2021-01-10;0;0;196;4;0.0;0.0
84;2021-01-11;219;0;415;4;0.1;0.0
84;2021-01-12;624;2;1039;6;0.2;0.0
84;2021-01-13;359;1;1398;7;0.2;0.0
84;2021-01-14;960;17;2358;24;0.4;0.0
84;2021-01-15;619;11;2977;35;0.5;0.0
84;2021-01-16;167;1;3144;36;0.6;0.0
84;2021-01-17;30;1;3174;37;0.6;0.0
84;2021-01-18;697;3;3871;40;0.7;0.0
84;2021-01-19;881;6;4752;46;0.8;0.0
84;2021-01-20;1024;6;5776;52;1.0;0.0
84;2021-01-21;1050;6;6826;58;1.2;0.0
84;2021-01-22;1135;2;7961;60;1.4;0.0
84;2021-01-23;250;0;8211;60;1.5;0.0
84;2021-01-24;3;0;8214;60;1.5;0.0
84;2021-01-25;809;4;9023;64;1.6;0.0
84;2021-01-26;940;6;9963;70;1.8;0.0
84;2021-01-27;1072;4;11035;74;2.0;0.0
84;2021-01-28;1623;20;12658;94;2.3;0.0
84;2021-01-29;1202;63;13860;157;2.5;0.0
84;2021-01-30;171;21;14031;178;2.5;0.0
84;2021-01-31;7;0;14038;178;2.5;0.0
84;2021-02-01;663;146;14701;324;2.6;0.1
84;2021-02-02;789;268;15490;592;2.8;0.1
84;2021-02-03;762;243;16252;835;2.9;0.1
84;2021-02-04;913;400;17165;1235;3.1;0.2
84;2021-02-05;728;416;17893;1651;3.2;0.3
84;2021-02-06;127;49;18020;1700;3.2;0.3
84;2021-02-07;1;0;18021;1700;3.2;0.3
84;2021-02-08;569;274;18590;1974;3.3;0.4
84;2021-02-09;694;720;19284;2694;3.4;0.5
84;2021-02-10;560;565;19844;3259;3.5;0.6
84;2021-02-11;549;590;20393;3849;3.6;0.7
84;2021-02-12;562;680;20955;4529;3.7;0.8
84;2021-02-13;48;171;21003;4700;3.7;0.8
84;2021-02-14;3;0;21006;4700;3.7;0.8
84;2021-02-15;207;887;21213;5587;3.8;1.0
84;2021-02-16;223;823;21436;6410;3.8;1.1
84;2021-02-17;448;777;21884;7187;3.9;1.3
84;2021-02-18;557;1102;22441;8289;4.0;1.5
84;2021-02-19;739;1184;23180;9473;4.1;1.7
84;2021-02-20;68;153;23248;9626;4.1;1.7
84;2021-02-21;6;37;23254;9663;4.1;1.7
84;2021-02-22;369;744;23623;10407;4.2;1.9
84;2021-02-23;272;703;23895;11110;4.3;2.0
84;2021-02-24;395;736;24290;11846;4.3;2.1
84;2021-02-25;713;862;25003;12708;4.5;2.3
84;2021-02-26;823;682;25826;13390;4.6;2.4
84;2021-02-27;133;125;25959;13515;4.6;2.4
84;2021-02-28;18;0;25977;13515;4.6;2.4
84;2021-03-01;459;667;26436;14182;4.7;2.5
84;2021-03-02;634;809;27070;14991;4.8;2.7
84;2021-03-03;821;949;27891;15940;5.0;2.8
84;2021-03-04;1101;695;28992;16635;5.2;3.0
84;2021-03-05;1314;527;30306;17162;5.4;3.1
84;2021-03-06;1459;68;31765;17230;5.7;3.1
84;2021-03-07;481;17;32246;17247;5.7;3.1
84;2021-03-08;813;613;33059;17860;5.9;3.2
84;2021-03-09;1390;785;34449;18645;6.1;3.3
84;2021-03-10;1474;675;35923;19320;6.4;3.4
84;2021-03-11;1983;649;37906;19969;6.8;3.6
84;2021-03-12;2083;638;39989;20607;7.1;3.7
84;2021-03-13;747;37;40736;20644;7.3;3.7
84;2021-03-14;247;53;40983;20697;7.3;3.7
84;2021-03-15;1074;311;42057;21008;7.5;3.7
84;2021-03-16;1180;328;43237;21336;7.7;3.8
84;2021-03-17;1147;445;44384;21781;7.9;3.9
84;2021-03-18;1459;399;45843;22180;8.2;4.0
84;2021-03-19;2180;465;48023;22645;8.6;4.0
84;2021-03-20;841;28;48864;22673;8.7;4.0
84;2021-03-21;151;11;49015;22684;8.7;4.0
84;2021-03-22;1162;468;50177;23152;8.9;4.1
84;2021-03-23;1916;440;52093;23592;9.3;4.2
84;2021-03-24;2177;405;54270;23997;9.7;4.3
84;2021-03-25;3656;405;57926;24402;10.3;4.3
84;2021-03-26;3320;489;61246;24891;10.9;4.4
84;2021-03-27;915;60;62161;24951;11.1;4.4
84;2021-03-28;74;3;62235;24954;11.1;4.4
84;2021-03-29;1718;537;63953;25491;11.4;4.5
84;2021-03-30;2674;691;66627;26182;11.9;4.7
84;2021-03-31;2406;652;69033;26834;12.3;4.8
84;2021-04-01;3021;588;72054;27422;12.8;4.9
84;2021-04-02;2452;538;74506;27960;13.3;5.0
84;2021-04-03;512;29;75018;27989;13.4;5.0
84;2021-04-04;15;2;75033;27991;13.4;5.0
84;2021-04-05;814;105;75847;28096;13.5;5.0
84;2021-04-06;2148;850;77995;28946;13.9;5.2
84;2021-04-07;2406;871;80401;29817;14.3;5.3
84;2021-04-08;3654;1053;84055;30870;15.0;5.5
84;2021-04-09;4117;958;88172;31828;15.7;5.7
84;2021-04-10;1310;135;89482;31963;16.0;5.7
84;2021-04-11;37;12;89519;31975;16.0;5.7
84;2021-04-12;2095;814;91614;32789;16.3;5.8
84;2021-04-13;2939;1372;94553;34161;16.9;6.1
84;2021-04-14;2811;1362;97364;35523;17.4;6.3
84;2021-04-15;3272;1426;100636;36949;17.9;6.6
84;2021-04-16;3431;1555;104067;38504;18.6;6.9
84;2021-04-17;1666;201;105733;38705;18.8;6.9
84;2021-04-18;38;1;105771;38706;18.9;6.9
84;2021-04-19;2506;926;108277;39632;19.3;7.1
84;2021-04-20;2628;1535;110905;41167;19.8;7.3
84;2021-04-21;2651;1491;113556;42658;20.2;7.6
84;2021-04-22;3014;1744;116570;44402;20.8;7.9
84;2021-04-23;3042;1911;119612;46313;21.3;8.3
84;2021-04-24;1530;289;121142;46602;21.6;8.3
84;2021-04-25;27;2;121169;46604;21.6;8.3
84;2021-04-26;2198;1377;123367;47981;22.0;8.6
84;2021-04-27;2556;1986;125923;49967;22.4;8.9
84;2021-04-28;2818;1856;128741;51823;22.9;9.2
84;2021-04-29;3420;2057;132161;53880;23.6;9.6
84;2021-04-30;3134;2437;135295;56317;24.1;10.0
84;2021-05-01;457;259;135752;56576;24.2;10.1
84;2021-05-02;2;0;135754;56576;24.2;10.1
84;2021-05-03;2161;1634;137915;58210;24.6;10.4
84;2021-05-04;2487;2547;140402;60757;25.0;10.8
84;2021-05-05;2354;2230;142756;62987;25.4;11.2
84;2021-05-06;3223;2264;145979;65251;26.0;11.6
84;2021-05-07;2766;2564;148745;67815;26.5;12.1
84;2021-05-08;1158;527;149903;68342;26.7;12.2
84;2021-05-09;8;53;149911;68395;26.7;12.2
84;2021-05-10;2159;2466;152070;70861;27.1;12.6
84;2021-05-11;2905;3160;154975;74021;27.6;13.2
84;2021-05-12;2849;2923;157824;76944;28.1;13.7
84;2021-05-13;2160;849;159984;77793;28.5;13.9
84;2021-05-14;2728;2041;162712;79834;29.0;14.2
84;2021-05-15;2001;987;164713;80821;29.4;14.4
84;2021-05-16;1340;188;166053;81009;29.6;14.4
84;2021-05-17;2226;2157;168279;83166;30.0;14.8
84;2021-05-18;2904;2116;171183;85282;30.5;15.2
84;2021-05-19;3230;1667;174413;86949;31.1;15.5
84;2021-05-20;3698;2208;178111;89157;31.7;15.9
84;2021-05-21;3471;2335;181582;91492;32.4;16.3
84;2021-05-22;1582;684;183164;92176;32.6;16.4
84;2021-05-23;6;9;183170;92185;32.7;16.4
84;2021-05-24;1840;426;185010;92611;33.0;16.5
84;2021-05-25;2983;2191;187993;94802;33.5;16.9
84;2021-05-26;3075;2090;191068;96892;34.1;17.3
84;2021-05-27;3857;2320;194925;99212;34.7;17.7
84;2021-05-28;3180;3309;198105;102521;35.3;18.3
84;2021-05-29;1094;1653;199199;104174;35.5;18.6
84;2021-05-30;10;85;199209;104259;35.5;18.6
84;2021-05-31;2191;2642;201400;106901;35.9;19.1
84;2021-06-01;3141;3159;204541;110060;36.5;19.6
84;2021-06-02;3170;2631;207711;112691;37.0;20.1
84;2021-06-03;4115;2999;211826;115690;37.8;20.6
84;2021-06-04;3613;3036;215439;118726;38.4;21.2
84;2021-06-05;1781;1501;217220;120227;38.7;21.4
84;2021-06-06;984;208;218204;120435;38.9;21.5
84;2021-06-07;2451;2760;220655;123195;39.3;22.0
84;2021-06-08;3317;3056;223972;126251;39.9;22.5
84;2021-06-09;3033;2689;227005;128940;40.5;23.0
84;2021-06-10;3512;2799;230517;131739;41.1;23.5
84;2021-06-11;3031;3069;233548;134808;41.6;24.0
84;2021-06-12;1965;1313;235513;136121;42.0;24.3
84;2021-06-13;412;213;235925;136334;42.1;24.3
84;2021-06-14;1930;3155;237855;139489;42.4;24.9
84;2021-06-15;2573;3454;240428;142943;42.9;25.5
84;2021-06-16;2527;2962;242955;145905;43.3;26.0
84;2021-06-17;2994;3481;245949;149386;43.8;26.6
84;2021-06-18;2424;3556;248373;152942;44.3;27.3
84;2021-06-19;1287;1552;249660;154494;44.5;27.5
84;2021-06-20;546;354;250206;154848;44.6;27.6
84;2021-06-21;1570;3137;251776;157985;44.9;28.2
84;2021-06-22;2163;4011;253939;161996;45.3;28.9
84;2021-06-23;2117;3310;256056;165306;45.6;29.5
84;2021-06-24;2201;3483;258257;168789;46.0;30.1
84;2021-06-25;1836;3888;260093;172677;46.4;30.8
84;2021-06-26;1133;1818;261226;174495;46.6;31.1
84;2021-06-27;297;345;261523;174840;46.6;31.2
84;2021-06-28;1207;3224;262730;178064;46.8;31.7
84;2021-06-29;1477;4051;264207;182115;47.1;32.5
84;2021-06-30;1716;3969;265923;186084;47.4;33.2
84;2021-07-01;1821;3957;267744;190041;47.7;33.9
84;2021-07-02;1764;3900;269508;193941;48.0;34.6
84;2021-07-03;1102;2030;270610;195971;48.2;34.9
84;2021-07-04;395;416;271005;196387;48.3;35.0
84;2021-07-05;1550;3540;272555;199927;48.6;35.6
84;2021-07-06;1639;4165;274194;204092;48.9;36.4
84;2021-07-07;1677;3103;275871;207195;49.2;36.9
84;2021-07-08;2158;3743;278029;210938;49.6;37.6
84;2021-07-09;1874;3970;279903;214908;49.9;38.3
84;2021-07-10;1253;2162;281156;217070;50.1;38.7
84;2021-07-11;354;300;281510;217370;50.2;38.7
84;2021-07-12;1408;3836;282918;221206;50.4;39.4
84;2021-07-13;2334;5010;285252;226216;50.8;40.3
84;2021-07-14;1885;1250;287137;227466;51.2;40.5
84;2021-07-15;2708;4561;289845;232027;51.7;41.4
84;2021-07-16;2778;4605;292623;236632;52.2;42.2
84;2021-07-17;1588;2449;294211;239081;52.4;42.6
84;2021-07-18;1017;552;295228;239633;52.6;42.7
84;2021-07-19;2416;3746;297644;243379;53.1;43.4
84;2021-07-20;2955;4169;300599;247548;53.6;44.1
84;2021-07-21;3187;3656;303786;251204;54.2;44.8
84;2021-07-22;3777;3792;307563;254996;54.8;45.5
84;2021-07-23;3520;3681;311083;258677;55.5;46.1
84;2021-07-24;1470;2249;312553;260926;55.7;46.5
84;2021-07-25;1033;513;313586;261439;55.9;46.6
84;2021-07-26;2725;3040;316311;264479;56.4;47.1
84;2021-07-27;3443;3569;319754;268048;57.0;47.8
84;2021-07-28;3869;3309;323623;271357;57.7;48.4
84;2021-07-29;4224;3162;327847;274519;58.4;48.9
84;2021-07-30;4028;3333;331875;277852;59.2;49.5
84;2021-07-31;2000;1694;333875;279546;59.5;49.8
84;2021-08-01;819;437;334694;279983;59.7;49.9
84;2021-08-02;2993;2696;337687;282679;60.2;50.4
84;2021-08-03;4108;2799;341795;285478;60.9;50.9
84;2021-08-04;3918;2616;345713;288094;61.6;51.4
84;2021-08-05;3887;2590;349600;290684;62.3;51.8
84;2021-08-06;3694;2867;353294;293551;63.0;52.3
84;2021-08-07;2077;1747;355371;295298;63.3;52.6
84;2021-08-08;386;735;355757;296033;63.4;52.8
84;2021-08-09;2941;2604;358698;298637;63.9;53.2
84;2021-08-10;3750;2957;362448;301594;64.6;53.8
84;2021-08-11;3269;2677;365717;304271;65.2;54.2
84;2021-08-12;3173;2976;368890;307247;65.8;54.8
84;2021-08-13;2924;2702;371814;309949;66.3;55.2
84;2021-08-14;1737;1747;373551;311696;66.6;55.6
84;2021-08-15;315;227;373866;311923;66.6;55.6
84;2021-08-16;2453;3086;376319;315009;67.1;56.2
84;2021-08-17;2736;3259;379055;318268;67.6;56.7
84;2021-08-18;2421;2802;381476;321070;68.0;57.2
84;2021-08-19;2280;3120;383756;324190;68.4;57.8
84;2021-08-20;2214;3310;385970;327500;68.8;58.4
84;2021-08-21;1228;1886;387198;329386;69.0;58.7
84;2021-08-22;168;738;387366;330124;69.0;58.8
84;2021-08-23;1778;3298;389144;333422;69.4;59.4
84;2021-08-24;1926;3468;391070;336890;69.7;60.1
84;2021-08-25;1845;3354;392915;340244;70.0;60.6
84;2021-08-26;1640;3628;394555;343872;70.3;61.3
84;2021-08-27;1631;3816;396186;347688;70.6;62.0
84;2021-08-28;920;2181;397106;349869;70.8;62.4
84;2021-08-29;175;607;397281;350476;70.8;62.5
84;2021-08-30;1392;3228;398673;353704;71.1;63.0
84;2021-08-31;1366;4080;400039;357784;71.3;63.8
84;2021-09-01;1253;3459;401292;361243;71.5;64.4
84;2021-09-02;1210;2949;402502;364192;71.7;64.9
84;2021-09-03;1285;3364;403787;367556;72.0;65.5
84;2021-09-04;780;2103;404567;369659;72.1;65.9
84;2021-09-05;127;467;404694;370126;72.1;66.0
84;2021-09-06;819;2229;405513;372355;72.3;66.4
84;2021-09-07;1027;2421;406540;374776;72.5;66.8
84;2021-09-08;913;2681;407453;377457;72.6;67.3
84;2021-09-09;889;2065;408342;379522;72.8;67.7
84;2021-09-10;942;2583;409284;382105;73.0;68.1
84;2021-09-11;591;1797;409875;383902;73.1;68.4
84;2021-09-12;116;301;409991;384203;73.1;68.5
84;2021-09-13;715;1517;410706;385720;73.2;68.8
84;2021-09-14;834;1500;411540;387220;73.4;69.0
84;2021-09-15;827;1934;412367;389154;73.5;69.4
84;2021-09-16;609;1338;412976;390492;73.6;69.6
84;2021-09-17;630;1616;413606;392108;73.7;69.9
84;2021-09-18;516;1498;414122;393606;73.8;70.2
84;2021-09-19;46;177;414168;393783;73.8;70.2
84;2021-09-20;339;892;414507;394675;73.9;70.4
84;2021-09-21;372;1114;414879;395789;74.0;70.6
84;2021-09-22;421;1590;415300;397379;74.0;70.8
84;2021-09-23;400;1116;415700;398495;74.1;71.0
84;2021-09-24;397;1252;416097;399747;74.2;71.3
84;2021-09-25;324;1246;416421;400993;74.2;71.5
84;2021-09-26;53;142;416474;401135;74.2;71.5
84;2021-09-27;319;788;416793;401923;74.3;71.6
84;2021-09-28;313;759;417106;402682;74.4;71.8
84;2021-09-29;350;1221;417456;403903;74.4;72.0
84;2021-09-30;375;921;417831;404824;74.5;72.2
84;2021-10-01;441;853;418272;405677;74.6;72.3
84;2021-10-02;247;753;418519;406430;74.6;72.4
84;2021-10-03;37;94;418556;406524;74.6;72.5
84;2021-10-04;297;549;418853;407073;74.7;72.6
84;2021-10-05;332;526;419185;407599;74.7;72.7
84;2021-10-06;345;824;419530;408423;74.8;72.8
84;2021-10-07;357;666;419887;409089;74.8;72.9
84;2021-10-08;415;775;420302;409864;74.9;73.1
84;2021-10-09;227;634;420529;410498;75.0;73.2
84;2021-10-10;28;86;420557;410584;75.0;73.2
84;2021-10-11;254;383;420811;410967;75.0;73.3
84;2021-10-12;304;417;421115;411384;75.1;73.3
84;2021-10-13;401;598;421516;411982;75.1;73.4
84;2021-10-14;311;448;421827;412430;75.2;73.5
84;2021-10-15;292;578;422119;413008;75.2;73.6
84;2021-10-16;312;439;422431;413447;75.3;73.7
84;2021-10-17;17;52;422448;413499;75.3;73.7
84;2021-10-18;271;374;422719;413873;75.4;73.8
84;2021-10-19;216;391;422935;414264;75.4;73.8
85;2020-12-27;1;0;1;0;0.0;0.0
85;2020-12-28;0;0;1;0;0.0;0.0
85;2020-12-29;0;0;1;0;0.0;0.0
85;2020-12-30;0;0;1;0;0.0;0.0
85;2020-12-31;0;0;1;0;0.0;0.0
85;2021-01-01;0;0;1;0;0.0;0.0
85;2021-01-02;0;0;1;0;0.0;0.0
85;2021-01-03;1;0;2;0;0.0;0.0
85;2021-01-04;26;0;28;0;0.0;0.0
85;2021-01-05;62;0;90;0;0.0;0.0
85;2021-01-06;107;1;197;1;0.0;0.0
85;2021-01-07;203;0;400;1;0.1;0.0
85;2021-01-08;293;2;693;3;0.1;0.0
85;2021-01-09;288;1;981;4;0.1;0.0
85;2021-01-10;59;0;1040;4;0.2;0.0
85;2021-01-11;453;0;1493;4;0.2;0.0
85;2021-01-12;584;2;2077;6;0.3;0.0
85;2021-01-13;546;2;2623;8;0.4;0.0
85;2021-01-14;685;5;3308;13;0.5;0.0
85;2021-01-15;439;3;3747;16;0.5;0.0
85;2021-01-16;263;3;4010;19;0.6;0.0
85;2021-01-17;37;0;4047;19;0.6;0.0
85;2021-01-18;999;3;5046;22;0.7;0.0
85;2021-01-19;1429;17;6475;39;0.9;0.0
85;2021-01-20;1891;5;8366;44;1.2;0.0
85;2021-01-21;3222;14;11588;58;1.7;0.0
85;2021-01-22;1700;22;13288;80;1.9;0.0
85;2021-01-23;466;1;13754;81;2.0;0.0
85;2021-01-24;50;0;13804;81;2.0;0.0
85;2021-01-25;577;1;14381;82;2.1;0.0
85;2021-01-26;878;34;15259;116;2.2;0.0
85;2021-01-27;1810;34;17069;150;2.5;0.0
85;2021-01-28;1636;45;18705;195;2.7;0.0
85;2021-01-29;875;64;19580;259;2.9;0.0
85;2021-01-30;149;5;19729;264;2.9;0.0
85;2021-01-31;2;45;19731;309;2.9;0.0
85;2021-02-01;484;103;20215;412;3.0;0.1
85;2021-02-02;535;174;20750;586;3.0;0.1
85;2021-02-03;415;259;21165;845;3.1;0.1
85;2021-02-04;623;265;21788;1110;3.2;0.2
85;2021-02-05;624;264;22412;1374;3.3;0.2
85;2021-02-06;157;244;22569;1618;3.3;0.2
85;2021-02-07;1;0;22570;1618;3.3;0.2
85;2021-02-08;390;650;22960;2268;3.4;0.3
85;2021-02-09;663;1059;23623;3327;3.5;0.5
85;2021-02-10;583;1126;24206;4453;3.5;0.7
85;2021-02-11;1524;3040;25730;7493;3.8;1.1
85;2021-02-12;1015;1264;26745;8757;3.9;1.3
85;2021-02-13;251;501;26996;9258;4.0;1.4
85;2021-02-14;2;131;26998;9389;4.0;1.4
85;2021-02-15;336;807;27334;10196;4.0;1.5
85;2021-02-16;569;1180;27903;11376;4.1;1.7
85;2021-02-17;782;1577;28685;12953;4.2;1.9
85;2021-02-18;1277;1939;29962;14892;4.4;2.2
85;2021-02-19;956;1208;30918;16100;4.5;2.4
85;2021-02-20;174;260;31092;16360;4.6;2.4
85;2021-02-21;2;11;31094;16371;4.6;2.4
85;2021-02-22;815;886;31909;17257;4.7;2.5
85;2021-02-23;828;490;32737;17747;4.8;2.6
85;2021-02-24;757;312;33494;18059;4.9;2.6
85;2021-02-25;1338;402;34832;18461;5.1;2.7
85;2021-02-26;1229;332;36061;18793;5.3;2.8
85;2021-02-27;402;103;36463;18896;5.3;2.8
85;2021-02-28;7;1;36470;18897;5.3;2.8
85;2021-03-01;766;428;37236;19325;5.5;2.8
85;2021-03-02;1100;793;38336;20118;5.6;2.9
85;2021-03-03;844;516;39180;20634;5.7;3.0
85;2021-03-04;1577;1177;40757;21811;6.0;3.2
85;2021-03-05;1741;852;42498;22663;6.2;3.3
85;2021-03-06;1227;133;43725;22796;6.4;3.3
85;2021-03-07;333;36;44058;22832;6.4;3.3
85;2021-03-08;1741;468;45799;23300;6.7;3.4
85;2021-03-09;2239;582;48038;23882;7.0;3.5
85;2021-03-10;1863;652;49901;24534;7.3;3.6
85;2021-03-11;3118;1102;53019;25636;7.8;3.8
85;2021-03-12;2730;873;55749;26509;8.2;3.9
85;2021-03-13;1372;167;57121;26676;8.4;3.9
85;2021-03-14;182;3;57303;26679;8.4;3.9
85;2021-03-15;1919;519;59222;27198;8.7;4.0
85;2021-03-16;1631;523;60853;27721;8.9;4.1
85;2021-03-17;980;528;61833;28249;9.1;4.1
85;2021-03-18;1904;460;63737;28709;9.3;4.2
85;2021-03-19;2198;376;65935;29085;9.7;4.3
85;2021-03-20;1069;179;67004;29264;9.8;4.3
85;2021-03-21;272;5;67276;29269;9.8;4.3
85;2021-03-22;1763;562;69039;29831;10.1;4.4
85;2021-03-23;2419;740;71458;30571;10.5;4.5
85;2021-03-24;2206;532;73664;31103;10.8;4.6
85;2021-03-25;3648;601;77312;31704;11.3;4.6
85;2021-03-26;3357;655;80669;32359;11.8;4.7
85;2021-03-27;1729;124;82398;32483;12.1;4.8
85;2021-03-28;540;6;82938;32489;12.1;4.8
85;2021-03-29;2414;765;85352;33254;12.5;4.9
85;2021-03-30;2866;1028;88218;34282;12.9;5.0
85;2021-03-31;2199;680;90417;34962;13.2;5.1
85;2021-04-01;3880;922;94297;35884;13.8;5.3
85;2021-04-02;2711;1112;97008;36996;14.2;5.4
85;2021-04-03;1411;323;98419;37319;14.4;5.5
85;2021-04-04;324;29;98743;37348;14.5;5.5
85;2021-04-05;104;174;98847;37522;14.5;5.5
85;2021-04-06;2196;1598;101043;39120;14.8;5.7
85;2021-04-07;3092;1198;104135;40318;15.2;5.9
85;2021-04-08;4544;1612;108679;41930;15.9;6.1
85;2021-04-09;4604;1237;113283;43167;16.6;6.3
85;2021-04-10;1866;401;115149;43568;16.9;6.4
85;2021-04-11;27;10;115176;43578;16.9;6.4
85;2021-04-12;4284;1496;119460;45074;17.5;6.6
85;2021-04-13;4837;1885;124297;46959;18.2;6.9
85;2021-04-14;3960;1017;128257;47976;18.8;7.0
85;2021-04-15;5516;1746;133773;49722;19.6;7.3
85;2021-04-16;5241;1546;139014;51268;20.3;7.5
85;2021-04-17;1382;436;140396;51704;20.6;7.6
85;2021-04-18;351;12;140747;51716;20.6;7.6
85;2021-04-19;3368;1705;144115;53421;21.1;7.8
85;2021-04-20;3694;1932;147809;55353;21.6;8.1
85;2021-04-21;2693;1694;150502;57047;22.0;8.4
85;2021-04-22;3805;2238;154307;59285;22.6;8.7
85;2021-04-23;3903;2096;158210;61381;23.2;9.0
85;2021-04-24;1663;1535;159873;62916;23.4;9.2
85;2021-04-25;981;565;160854;63481;23.5;9.3
85;2021-04-26;3589;2357;164443;65838;24.1;9.6
85;2021-04-27;4392;2169;168835;68007;24.7;10.0
85;2021-04-28;5747;1263;174582;69270;25.6;10.1
85;2021-04-29;5635;2010;180217;71280;26.4;10.4
85;2021-04-30;5573;1678;185790;72958;27.2;10.7
85;2021-05-01;1736;638;187526;73596;27.4;10.8
85;2021-05-02;873;471;188399;74067;27.6;10.8
85;2021-05-03;3494;2389;191893;76456;28.1;11.2
85;2021-05-04;3487;3089;195380;79545;28.6;11.6
85;2021-05-05;4532;2170;199912;81715;29.3;12.0
85;2021-05-06;4922;2605;204834;84320;30.0;12.3
85;2021-05-07;3933;3861;208767;88181;30.6;12.9
85;2021-05-08;2246;232;211013;88413;30.9;12.9
85;2021-05-09;1507;183;212520;88596;31.1;13.0
85;2021-05-10;3209;4925;215729;93521;31.6;13.7
85;2021-05-11;4027;4973;219756;98494;32.2;14.4
85;2021-05-12;5019;3936;224775;102430;32.9;15.0
85;2021-05-13;5144;614;229919;103044;33.7;15.1
85;2021-05-14;4356;3167;234275;106211;34.3;15.5
85;2021-05-15;2325;776;236600;106987;34.6;15.7
85;2021-05-16;2213;162;238813;107149;35.0;15.7
85;2021-05-17;4145;3375;242958;110524;35.6;16.2
85;2021-05-18;5215;2854;248173;113378;36.3;16.6
85;2021-05-19;6493;1771;254666;115149;37.3;16.9
85;2021-05-20;6774;2178;261440;117327;38.3;17.2
85;2021-05-21;5497;2742;266937;120069;39.1;17.6
85;2021-05-22;2584;754;269521;120823;39.5;17.7
85;2021-05-23;1329;161;270850;120984;39.6;17.7
85;2021-05-24;4572;436;275422;121420;40.3;17.8
85;2021-05-25;4516;3569;279938;124989;41.0;18.3
85;2021-05-26;4945;2680;284883;127669;41.7;18.7
85;2021-05-27;4959;3695;289842;131364;42.4;19.2
85;2021-05-28;5252;4063;295094;135427;43.2;19.8
85;2021-05-29;3962;1533;299056;136960;43.8;20.0
85;2021-05-30;1291;126;300347;137086;44.0;20.1
85;2021-05-31;4689;3382;305036;140468;44.6;20.6
85;2021-06-01;5405;3400;310441;143868;45.4;21.1
85;2021-06-02;5555;2522;315996;146390;46.3;21.4
85;2021-06-03;5913;3233;321909;149623;47.1;21.9
85;2021-06-04;5837;3823;327746;153446;48.0;22.5
85;2021-06-05;2847;1938;330593;155384;48.4;22.7
85;2021-06-06;1511;804;332104;156188;48.6;22.9
85;2021-06-07;3236;4860;335340;161048;49.1;23.6
85;2021-06-08;4090;4529;339430;165577;49.7;24.2
85;2021-06-09;4844;3516;344274;169093;50.4;24.8
85;2021-06-10;5199;3704;349473;172797;51.2;25.3
85;2021-06-11;4507;4665;353980;177462;51.8;26.0
85;2021-06-12;1491;1800;355471;179262;52.0;26.2
85;2021-06-13;1219;672;356690;179934;52.2;26.3
85;2021-06-14;2682;5094;359372;185028;52.6;27.1
85;2021-06-15;3715;4935;363087;189963;53.1;27.8
85;2021-06-16;4083;3908;367170;193871;53.7;28.4
85;2021-06-17;3939;3902;371109;197773;54.3;28.9
85;2021-06-18;3625;5688;374734;203461;54.9;29.8
85;2021-06-19;1213;2030;375947;205491;55.0;30.1
85;2021-06-20;140;520;376087;206011;55.0;30.2
85;2021-06-21;2375;5811;378462;211822;55.4;31.0
85;2021-06-22;2849;5733;381311;217555;55.8;31.8
85;2021-06-23;3390;4499;384701;222054;56.3;32.5
85;2021-06-24;3642;4562;388343;226616;56.8;33.2
85;2021-06-25;2289;6181;390632;232797;57.2;34.1
85;2021-06-26;791;3757;391423;236554;57.3;34.6
85;2021-06-27;125;1369;391548;237923;57.3;34.8
85;2021-06-28;1186;6713;392734;244636;57.5;35.8
85;2021-06-29;1757;6876;394491;251512;57.7;36.8
85;2021-06-30;2212;6208;396703;257720;58.1;37.7
85;2021-07-01;2842;6056;399545;263776;58.5;38.6
85;2021-07-02;2268;7015;401813;270791;58.8;39.6
85;2021-07-03;618;3165;402431;273956;58.9;40.1
85;2021-07-04;145;1086;402576;275042;58.9;40.3
85;2021-07-05;1064;6649;403640;281691;59.1;41.2
85;2021-07-06;1583;6456;405223;288147;59.3;42.2
85;2021-07-07;1649;5864;406872;294011;59.6;43.0
85;2021-07-08;2165;5440;409037;299451;59.9;43.8
85;2021-07-09;1645;7096;410682;306547;60.1;44.9
85;2021-07-10;566;2835;411248;309382;60.2;45.3
85;2021-07-11;529;1287;411777;310669;60.3;45.5
85;2021-07-12;1408;7046;413185;317715;60.5;46.5
85;2021-07-13;2056;7385;415241;325100;60.8;47.6
85;2021-07-14;1451;2047;416692;327147;61.0;47.9
85;2021-07-15;2681;6943;419373;334090;61.4;48.9
85;2021-07-16;3432;6835;422805;340925;61.9;49.9
85;2021-07-17;1565;2153;424370;343078;62.1;50.2
85;2021-07-18;1150;1154;425520;344232;62.3;50.4
85;2021-07-19;3559;6229;429079;350461;62.8;51.3
85;2021-07-20;4300;6214;433379;356675;63.4;52.2
85;2021-07-21;3996;6199;437375;362874;64.0;53.1
85;2021-07-22;3908;6189;441283;369063;64.6;54.0
85;2021-07-23;4534;6707;445817;375770;65.3;55.0
85;2021-07-24;1045;2296;446862;378066;65.4;55.3
85;2021-07-25;491;303;447353;378369;65.5;55.4
85;2021-07-26;4514;5362;451867;383731;66.1;56.2
85;2021-07-27;5321;5396;457188;389127;66.9;57.0
85;2021-07-28;4962;4972;462150;394099;67.6;57.7
85;2021-07-29;5878;4735;468028;398834;68.5;58.4
85;2021-07-30;6028;4954;474056;403788;69.4;59.1
85;2021-07-31;1226;1577;475282;405365;69.6;59.3
85;2021-08-01;470;195;475752;405560;69.6;59.4
85;2021-08-02;4950;3954;480702;409514;70.4;59.9
85;2021-08-03;6523;3355;487225;412869;71.3;60.4
85;2021-08-04;6632;3426;493857;416295;72.3;60.9
85;2021-08-05;6198;3605;500055;419900;73.2;61.5
85;2021-08-06;5810;4515;505865;424415;74.0;62.1
85;2021-08-07;1506;1180;507371;425595;74.3;62.3
85;2021-08-08;332;232;507703;425827;74.3;62.3
85;2021-08-09;4154;3276;511857;429103;74.9;62.8
85;2021-08-10;4831;3420;516688;432523;75.6;63.3
85;2021-08-11;4672;4218;521360;436741;76.3;63.9
85;2021-08-12;4473;4299;525833;441040;77.0;64.6
85;2021-08-13;3899;3648;529732;444688;77.5;65.1
85;2021-08-14;1028;1088;530760;445776;77.7;65.2
85;2021-08-15;160;237;530920;446013;77.7;65.3
85;2021-08-16;2843;4775;533763;450788;78.1;66.0
85;2021-08-17;2977;4359;536740;455147;78.6;66.6
85;2021-08-18;3155;4109;539895;459256;79.0;67.2
85;2021-08-19;2730;4280;542625;463536;79.4;67.8
85;2021-08-20;2481;5230;545106;468766;79.8;68.6
85;2021-08-21;704;1398;545810;470164;79.9;68.8
85;2021-08-22;344;1019;546154;471183;79.9;69.0
85;2021-08-23;1873;5374;548027;476557;80.2;69.8
85;2021-08-24;1826;4874;549853;481431;80.5;70.5
85;2021-08-25;1648;4834;551501;486265;80.7;71.2
85;2021-08-26;1542;4766;553043;491031;81.0;71.9
85;2021-08-27;1703;5519;554746;496550;81.2;72.7
85;2021-08-28;573;1348;555319;497898;81.3;72.9
85;2021-08-29;128;989;555447;498887;81.3;73.0
85;2021-08-30;1121;4911;556568;503798;81.5;73.7
85;2021-08-31;1132;5361;557700;509159;81.6;74.5
85;2021-09-01;1138;4992;558838;514151;81.8;75.3
85;2021-09-02;993;4146;559831;518297;81.9;75.9
85;2021-09-03;1248;4232;561079;522529;82.1;76.5
85;2021-09-04;370;1294;561449;523823;82.2;76.7
85;2021-09-05;42;168;561491;523991;82.2;76.7
85;2021-09-06;851;3389;562342;527380;82.3;77.2
85;2021-09-07;843;2867;563185;530247;82.4;77.6
85;2021-09-08;870;3377;564055;533624;82.6;78.1
85;2021-09-09;651;2541;564706;536165;82.7;78.5
85;2021-09-10;793;3305;565499;539470;82.8;79.0
85;2021-09-11;243;1303;565742;540773;82.8;79.2
85;2021-09-12;17;34;565759;540807;82.8;79.2
85;2021-09-13;547;2121;566306;542928;82.9;79.5
85;2021-09-14;554;1631;566860;544559;83.0;79.7
85;2021-09-15;612;2529;567472;547088;83.1;80.1
85;2021-09-16;399;1362;567871;548450;83.1;80.3
85;2021-09-17;740;2387;568611;550837;83.2;80.6
85;2021-09-18;192;919;568803;551756;83.3;80.8
85;2021-09-19;5;22;568808;551778;83.3;80.8
85;2021-09-20;353;1355;569161;553133;83.3;81.0
85;2021-09-21;431;1069;569592;554202;83.4;81.1
85;2021-09-22;435;1905;570027;556107;83.4;81.4
85;2021-09-23;816;983;570843;557090;83.6;81.5
85;2021-09-24;591;1929;571434;559019;83.6;81.8
85;2021-09-25;153;882;571587;559901;83.7;82.0
85;2021-09-26;0;12;571587;559913;83.7;82.0
85;2021-09-27;364;929;571951;560842;83.7;82.1
85;2021-09-28;231;565;572182;561407;83.8;82.2
85;2021-09-29;396;1288;572578;562695;83.8;82.4
85;2021-09-30;366;802;572944;563497;83.9;82.5
85;2021-10-01;422;920;573366;564417;83.9;82.6
85;2021-10-02;179;508;573545;564925;84.0;82.7
85;2021-10-03;4;12;573549;564937;84.0;82.7
85;2021-10-04;200;684;573749;565621;84.0;82.8
85;2021-10-05;294;430;574043;566051;84.0;82.9
85;2021-10-06;359;865;574402;566916;84.1;83.0
85;2021-10-07;239;392;574641;567308;84.1;83.0
85;2021-10-08;337;1019;574978;568327;84.2;83.2
85;2021-10-09;105;309;575083;568636;84.2;83.2
85;2021-10-10;14;8;575097;568644;84.2;83.2
85;2021-10-11;207;479;575304;569123;84.2;83.3
85;2021-10-12;169;331;575473;569454;84.2;83.4
85;2021-10-13;318;636;575791;570090;84.3;83.4
85;2021-10-14;212;585;576003;570675;84.3;83.5
85;2021-10-15;243;816;576246;571491;84.3;83.7
85;2021-10-16;99;160;576345;571651;84.4;83.7
85;2021-10-17;32;18;576377;571669;84.4;83.7
85;2021-10-18;242;368;576619;572037;84.4;83.7
85;2021-10-19;138;189;576757;572226;84.4;83.8
86;2020-12-27;0;0;0;0;0.0;0.0
86;2020-12-28;2;0;2;0;0.0;0.0
86;2020-12-29;1;0;3;0;0.0;0.0
86;2020-12-30;0;0;3;0;0.0;0.0
86;2020-12-31;0;0;3;0;0.0;0.0
86;2021-01-01;0;0;3;0;0.0;0.0
86;2021-01-02;1;0;4;0;0.0;0.0
86;2021-01-03;2;0;6;0;0.0;0.0
86;2021-01-04;0;0;6;0;0.0;0.0
86;2021-01-05;1;0;7;0;0.0;0.0
86;2021-01-06;178;1;185;1;0.0;0.0
86;2021-01-07;671;0;856;1;0.2;0.0
86;2021-01-08;609;3;1465;4;0.3;0.0
86;2021-01-09;0;0;1465;4;0.3;0.0
86;2021-01-10;173;0;1638;4;0.4;0.0
86;2021-01-11;305;0;1943;4;0.4;0.0
86;2021-01-12;460;1;2403;5;0.5;0.0
86;2021-01-13;337;1;2740;6;0.6;0.0
86;2021-01-14;552;1;3292;7;0.8;0.0
86;2021-01-15;544;3;3836;10;0.9;0.0
86;2021-01-16;2;0;3838;10;0.9;0.0
86;2021-01-17;0;0;3838;10;0.9;0.0
86;2021-01-18;564;0;4402;10;1.0;0.0
86;2021-01-19;1918;1;6320;11;1.4;0.0
86;2021-01-20;1464;27;7784;38;1.8;0.0
86;2021-01-21;1290;2;9074;40;2.1;0.0
86;2021-01-22;836;1;9910;41;2.3;0.0
86;2021-01-23;314;2;10224;43;2.3;0.0
86;2021-01-24;0;0;10224;43;2.3;0.0
86;2021-01-25;587;109;10811;152;2.5;0.0
86;2021-01-26;752;124;11563;276;2.6;0.1
86;2021-01-27;765;155;12328;431;2.8;0.1
86;2021-01-28;1053;425;13381;856;3.1;0.2
86;2021-01-29;880;217;14261;1073;3.3;0.2
86;2021-01-30;277;103;14538;1176;3.3;0.3
86;2021-01-31;57;157;14595;1333;3.3;0.3
86;2021-02-01;434;209;15029;1542;3.4;0.4
86;2021-02-02;573;385;15602;1927;3.6;0.4
86;2021-02-03;526;224;16128;2151;3.7;0.5
86;2021-02-04;479;366;16607;2517;3.8;0.6
86;2021-02-05;439;739;17046;3256;3.9;0.7
86;2021-02-06;148;204;17194;3460;3.9;0.8
86;2021-02-07;120;8;17314;3468;4.0;0.8
86;2021-02-08;362;327;17676;3795;4.0;0.9
86;2021-02-09;755;1121;18431;4916;4.2;1.1
86;2021-02-10;972;939;19403;5855;4.4;1.3
86;2021-02-11;1009;976;20412;6831;4.7;1.6
86;2021-02-12;746;381;21158;7212;4.8;1.6
86;2021-02-13;193;96;21351;7308;4.9;1.7
86;2021-02-14;1;34;21352;7342;4.9;1.7
86;2021-02-15;243;507;21595;7849;4.9;1.8
86;2021-02-16;384;866;21979;8715;5.0;2.0
86;2021-02-17;453;894;22432;9609;5.1;2.2
86;2021-02-18;422;871;22854;10480;5.2;2.4
86;2021-02-19;602;640;23456;11120;5.4;2.5
86;2021-02-20;115;176;23571;11296;5.4;2.6
86;2021-02-21;1;0;23572;11296;5.4;2.6
86;2021-02-22;241;426;23813;11722;5.4;2.7
86;2021-02-23;369;603;24182;12325;5.5;2.8
86;2021-02-24;409;584;24591;12909;5.6;3.0
86;2021-02-25;903;668;25494;13577;5.8;3.1
86;2021-02-26;1029;538;26523;14115;6.1;3.2
86;2021-02-27;460;151;26983;14266;6.2;3.3
86;2021-02-28;3;2;26986;14268;6.2;3.3
86;2021-03-01;232;526;27218;14794;6.2;3.4
86;2021-03-02;1142;852;28360;15646;6.5;3.6
86;2021-03-03;793;632;29153;16278;6.7;3.7
86;2021-03-04;1496;633;30649;16911;7.0;3.9
86;2021-03-05;1578;315;32227;17226;7.4;3.9
86;2021-03-06;995;169;33222;17395;7.6;4.0
86;2021-03-07;371;32;33593;17427;7.7;4.0
86;2021-03-08;473;542;34066;17969;7.8;4.1
86;2021-03-09;1368;533;35434;18502;8.1;4.2
86;2021-03-10;949;612;36383;19114;8.3;4.4
86;2021-03-11;1798;481;38181;19595;8.7;4.5
86;2021-03-12;2209;444;40390;20039;9.2;4.6
86;2021-03-13;1444;103;41834;20142;9.6;4.6
86;2021-03-14;133;16;41967;20158;9.6;4.6
86;2021-03-15;785;162;42752;20320;9.8;4.6
86;2021-03-16;847;206;43599;20526;10.0;4.7
86;2021-03-17;786;208;44385;20734;10.1;4.7
86;2021-03-18;1005;104;45390;20838;10.4;4.8
86;2021-03-19;2145;330;47535;21168;10.9;4.8
86;2021-03-20;592;133;48127;21301;11.0;4.9
86;2021-03-21;10;0;48137;21301;11.0;4.9
86;2021-03-22;852;278;48989;21579;11.2;4.9
86;2021-03-23;2017;331;51006;21910;11.7;5.0
86;2021-03-24;1557;291;52563;22201;12.0;5.1
86;2021-03-25;2489;357;55052;22558;12.6;5.2
86;2021-03-26;3044;364;58096;22922;13.3;5.2
86;2021-03-27;733;143;58829;23065;13.4;5.3
86;2021-03-28;5;129;58834;23194;13.5;5.3
86;2021-03-29;1260;392;60094;23586;13.7;5.4
86;2021-03-30;2406;828;62500;24414;14.3;5.6
86;2021-03-31;1511;630;64011;25044;14.6;5.7
86;2021-04-01;2246;949;66257;25993;15.1;5.9
86;2021-04-02;1902;560;68159;26553;15.6;6.1
86;2021-04-03;826;327;68985;26880;15.8;6.1
86;2021-04-04;83;110;69068;26990;15.8;6.2
86;2021-04-05;314;5;69382;26995;15.9;6.2
86;2021-04-06;1531;963;70913;27958;16.2;6.4
86;2021-04-07;1633;630;72546;28588;16.6;6.5
86;2021-04-08;2569;765;75115;29353;17.2;6.7
86;2021-04-09;3251;657;78366;30010;17.9;6.9
86;2021-04-10;1662;196;80028;30206;18.3;6.9
86;2021-04-11;442;11;80470;30217;18.4;6.9
86;2021-04-12;819;766;81289;30983;18.6;7.1
86;2021-04-13;2454;941;83743;31924;19.1;7.3
86;2021-04-14;1870;883;85613;32807;19.6;7.5
86;2021-04-15;2276;732;87889;33539;20.1;7.7
86;2021-04-16;2472;1232;90361;34771;20.7;7.9
86;2021-04-17;1040;264;91401;35035;20.9;8.0
86;2021-04-18;119;4;91520;35039;20.9;8.0
86;2021-04-19;746;799;92266;35838;21.1;8.2
86;2021-04-20;2301;1508;94567;37346;21.6;8.5
86;2021-04-21;2108;1128;96675;38474;22.1;8.8
86;2021-04-22;2329;1447;99004;39921;22.6;9.1
86;2021-04-23;2392;1579;101396;41500;23.2;9.5
86;2021-04-24;1299;512;102695;42012;23.5;9.6
86;2021-04-25;825;28;103520;42040;23.7;9.6
86;2021-04-26;2079;896;105599;42936;24.1;9.8
86;2021-04-27;3155;1672;108754;44608;24.9;10.2
86;2021-04-28;3002;1522;111756;46130;25.6;10.5
86;2021-04-29;3558;1835;115314;47965;26.4;11.0
86;2021-04-30;2969;1489;118283;49454;27.0;11.3
86;2021-05-01;1580;200;119863;49654;27.4;11.4
86;2021-05-02;1279;45;121142;49699;27.7;11.4
86;2021-05-03;2563;1009;123705;50708;28.3;11.6
86;2021-05-04;3508;1903;127213;52611;29.1;12.0
86;2021-05-05;3989;1488;131202;54099;30.0;12.4
86;2021-05-06;4289;1658;135491;55757;31.0;12.7
86;2021-05-07;4043;1830;139534;57587;31.9;13.2
86;2021-05-08;1976;400;141510;57987;32.4;13.3
86;2021-05-09;1642;203;143152;58190;32.7;13.3
86;2021-05-10;1957;1176;145109;59366;33.2;13.6
86;2021-05-11;3603;2688;148712;62054;34.0;14.2
86;2021-05-12;2252;1649;150964;63703;34.5;14.6
86;2021-05-13;1687;299;152651;64002;34.9;14.6
86;2021-05-14;2097;789;154748;64791;35.4;14.8
86;2021-05-15;1466;503;156214;65294;35.7;14.9
86;2021-05-16;778;164;156992;65458;35.9;15.0
86;2021-05-17;3218;1060;160210;66518;36.6;15.2
86;2021-05-18;4305;1665;164515;68183;37.6;15.6
86;2021-05-19;3587;1438;168102;69621;38.4;15.9
86;2021-05-20;4370;1625;172472;71246;39.4;16.3
86;2021-05-21;3438;1772;175910;73018;40.2;16.7
86;2021-05-22;2076;665;177986;73683;40.7;16.8
86;2021-05-23;1437;183;179423;73866;41.0;16.9
86;2021-05-24;1845;205;181268;74071;41.4;16.9
86;2021-05-25;2851;1640;184119;75711;42.1;17.3
86;2021-05-26;2725;1530;186844;77241;42.7;17.7
86;2021-05-27;3546;1851;190390;79092;43.5;18.1
86;2021-05-28;2164;2538;192554;81630;44.0;18.7
86;2021-05-29;1527;1286;194081;82916;44.4;19.0
86;2021-05-30;934;133;195015;83049;44.6;19.0
86;2021-05-31;1922;1820;196937;84869;45.0;19.4
86;2021-06-01;2665;2587;199602;87456;45.6;20.0
86;2021-06-02;2306;2664;201908;90120;46.2;20.6
86;2021-06-03;3338;2415;205246;92535;46.9;21.2
86;2021-06-04;2237;2860;207483;95395;47.4;21.8
86;2021-06-05;1503;1582;208986;96977;47.8;22.2
86;2021-06-06;820;900;209806;97877;48.0;22.4
86;2021-06-07;1119;2464;210925;100341;48.2;22.9
86;2021-06-08;1990;3697;212915;104038;48.7;23.8
86;2021-06-09;1901;3319;214816;107357;49.1;24.5
86;2021-06-10;2349;3239;217165;110596;49.6;25.3
86;2021-06-11;1517;2795;218682;113391;50.0;25.9
86;2021-06-12;746;2244;219428;115635;50.2;26.4
86;2021-06-13;214;1477;219642;117112;50.2;26.8
86;2021-06-14;1158;2902;220800;120014;50.5;27.4
86;2021-06-15;1690;4260;222490;124274;50.9;28.4
86;2021-06-16;1808;3136;224298;127410;51.3;29.1
86;2021-06-17;1777;4445;226075;131855;51.7;30.1
86;2021-06-18;1882;4586;227957;136441;52.1;31.2
86;2021-06-19;636;2097;228593;138538;52.3;31.7
86;2021-06-20;172;1319;228765;139857;52.3;32.0
86;2021-06-21;1106;2237;229871;142094;52.6;32.5
86;2021-06-22;1298;3459;231169;145553;52.9;33.3
86;2021-06-23;1364;2403;232533;147956;53.2;33.8
86;2021-06-24;1590;2725;234123;150681;53.5;34.4
86;2021-06-25;1192;3547;235315;154228;53.8;35.3
86;2021-06-26;391;2651;235706;156879;53.9;35.9
86;2021-06-27;138;1633;235844;158512;53.9;36.2
86;2021-06-28;270;3338;236114;161850;54.0;37.0
86;2021-06-29;858;4604;236972;166454;54.2;38.1
86;2021-06-30;1051;2974;238023;169428;54.4;38.7
86;2021-07-01;1549;3004;239572;172432;54.8;39.4
86;2021-07-02;1111;3645;240683;176077;55.0;40.3
86;2021-07-03;517;2393;241200;178470;55.1;40.8
86;2021-07-04;115;1346;241315;179816;55.2;41.1
86;2021-07-05;478;2833;241793;182649;55.3;41.8
86;2021-07-06;988;4108;242781;186757;55.5;42.7
86;2021-07-07;1260;2627;244041;189384;55.8;43.3
86;2021-07-08;1618;3149;245659;192533;56.2;44.0
86;2021-07-09;1746;3083;247405;195616;56.6;44.7
86;2021-07-10;1304;1954;248709;197570;56.9;45.2
86;2021-07-11;482;839;249191;198409;57.0;45.4
86;2021-07-12;848;2403;250039;200812;57.2;45.9
86;2021-07-13;1780;3369;251819;204181;57.6;46.7
86;2021-07-14;785;1232;252604;205413;57.8;47.0
86;2021-07-15;1882;3291;254486;208704;58.2;47.7
86;2021-07-16;1671;2663;256157;211367;58.6;48.3
86;2021-07-17;1351;1599;257508;212966;58.9;48.7
86;2021-07-18;381;908;257889;213874;59.0;48.9
86;2021-07-19;1377;1887;259266;215761;59.3;49.3
86;2021-07-20;2352;2736;261618;218497;59.8;50.0
86;2021-07-21;2305;2165;263923;220662;60.3;50.4
86;2021-07-22;2903;2802;266826;223464;61.0;51.1
86;2021-07-23;2467;2166;269293;225630;61.6;51.6
86;2021-07-24;1546;1226;270839;226856;61.9;51.9
86;2021-07-25;718;322;271557;227178;62.1;51.9
86;2021-07-26;1588;2103;273145;229281;62.4;52.4
86;2021-07-27;3558;2757;276703;232038;63.3;53.0
86;2021-07-28;3284;2141;279987;234179;64.0;53.5
86;2021-07-29;3266;2547;283253;236726;64.8;54.1
86;2021-07-30;2247;2380;285500;239106;65.3;54.7
86;2021-07-31;1429;1059;286929;240165;65.6;54.9
86;2021-08-01;651;338;287580;240503;65.7;55.0
86;2021-08-02;1944;1679;289524;242182;66.2;55.4
86;2021-08-03;3292;1994;292816;244176;66.9;55.8
86;2021-08-04;2739;1789;295555;245965;67.6;56.2
86;2021-08-05;3572;2058;299127;248023;68.4;56.7
86;2021-08-06;2420;1764;301547;249787;68.9;57.1
86;2021-08-07;1576;997;303123;250784;69.3;57.3
86;2021-08-08;958;553;304081;251337;69.5;57.5
86;2021-08-09;1885;1305;305966;252642;70.0;57.8
86;2021-08-10;2683;1780;308649;254422;70.6;58.2
86;2021-08-11;2367;1436;311016;255858;71.1;58.5
86;2021-08-12;2486;1834;313502;257692;71.7;58.9
86;2021-08-13;1838;1489;315340;259181;72.1;59.3
86;2021-08-14;1331;1153;316671;260334;72.4;59.5
86;2021-08-15;562;623;317233;260957;72.5;59.7
86;2021-08-16;1143;1788;318376;262745;72.8;60.1
86;2021-08-17;1559;2215;319935;264960;73.1;60.6
86;2021-08-18;1266;1861;321201;266821;73.4;61.0
86;2021-08-19;1501;2634;322702;269455;73.8;61.6
86;2021-08-20;1257;2609;323959;272064;74.1;62.2
86;2021-08-21;889;2008;324848;274072;74.3;62.7
86;2021-08-22;350;722;325198;274794;74.3;62.8
86;2021-08-23;724;1824;325922;276618;74.5;63.2
86;2021-08-24;1081;2752;327003;279370;74.8;63.9
86;2021-08-25;935;2064;327938;281434;75.0;64.3
86;2021-08-26;920;2813;328858;284247;75.2;65.0
86;2021-08-27;863;2174;329721;286421;75.4;65.5
86;2021-08-28;557;1775;330278;288196;75.5;65.9
86;2021-08-29;114;828;330392;289024;75.5;66.1
86;2021-08-30;686;2100;331078;291124;75.7;66.6
86;2021-08-31;960;3157;332038;294281;75.9;67.3
86;2021-09-01;571;2583;332609;296864;76.0;67.9
86;2021-09-02;757;2610;333366;299474;76.2;68.5
86;2021-09-03;758;2253;334124;301727;76.4;69.0
86;2021-09-04;366;2127;334490;303854;76.5;69.5
86;2021-09-05;27;909;334517;304763;76.5;69.7
86;2021-09-06;360;1571;334877;306334;76.6;70.0
86;2021-09-07;512;1995;335389;308329;76.7;70.5
86;2021-09-08;566;2110;335955;310439;76.8;71.0
86;2021-09-09;577;1785;336532;312224;76.9;71.4
86;2021-09-10;526;1819;337058;314043;77.1;71.8
86;2021-09-11;359;1832;337417;315875;77.1;72.2
86;2021-09-12;102;764;337519;316639;77.2;72.4
86;2021-09-13;324;984;337843;317623;77.2;72.6
86;2021-09-14;409;1359;338252;318982;77.3;72.9
86;2021-09-15;474;1556;338726;320538;77.4;73.3
86;2021-09-16;440;1011;339166;321549;77.5;73.5
86;2021-09-17;495;1061;339661;322610;77.7;73.8
86;2021-09-18;294;1271;339955;323881;77.7;74.0
86;2021-09-19;85;415;340040;324296;77.7;74.1
86;2021-09-20;223;642;340263;324938;77.8;74.3
86;2021-09-21;266;827;340529;325765;77.9;74.5
86;2021-09-22;338;1186;340867;326951;77.9;74.7
86;2021-09-23;355;582;341222;327533;78.0;74.9
86;2021-09-24;313;841;341535;328374;78.1;75.1
86;2021-09-25;290;1063;341825;329437;78.1;75.3
86;2021-09-26;45;166;341870;329603;78.2;75.4
86;2021-09-27;160;360;342030;329963;78.2;75.4
86;2021-09-28;240;369;342270;330332;78.3;75.5
86;2021-09-29;229;686;342499;331018;78.3;75.7
86;2021-09-30;255;496;342754;331514;78.4;75.8
86;2021-10-01;258;525;343012;332039;78.4;75.9
86;2021-10-02;279;578;343291;332617;78.5;76.0
86;2021-10-03;19;73;343310;332690;78.5;76.1
86;2021-10-04;97;319;343407;333009;78.5;76.1
86;2021-10-05;130;275;343537;333284;78.5;76.2
86;2021-10-06;183;451;343720;333735;78.6;76.3
86;2021-10-07;188;449;343908;334184;78.6;76.4
86;2021-10-08;202;483;344110;334667;78.7;76.5
86;2021-10-09;230;453;344340;335120;78.7;76.6
86;2021-10-10;2;5;344342;335125;78.7;76.6
86;2021-10-11;145;302;344487;335427;78.8;76.7
86;2021-10-12;122;306;344609;335733;78.8;76.8
86;2021-10-13;221;383;344830;336116;78.8;76.8
86;2021-10-14;143;325;344973;336441;78.9;76.9
86;2021-10-15;164;306;345137;336747;78.9;77.0
86;2021-10-16;226;357;345363;337104;79.0;77.1
86;2021-10-17;0;1;345363;337105;79.0;77.1
86;2021-10-18;175;329;345538;337434;79.0;77.1
86;2021-10-19;113;273;345651;337707;79.0;77.2
87;2020-12-27;0;0;0;0;0.0;0.0
87;2020-12-28;3;2;3;2;0.0;0.0
87;2020-12-29;0;0;3;2;0.0;0.0
87;2020-12-30;0;0;3;2;0.0;0.0
87;2020-12-31;0;0;3;2;0.0;0.0
87;2021-01-01;0;0;3;2;0.0;0.0
87;2021-01-02;0;0;3;2;0.0;0.0
87;2021-01-03;0;0;3;2;0.0;0.0
87;2021-01-04;2;1;5;3;0.0;0.0
87;2021-01-05;1;0;6;3;0.0;0.0
87;2021-01-06;10;0;16;3;0.0;0.0
87;2021-01-07;301;1;317;4;0.1;0.0
87;2021-01-08;406;0;723;4;0.2;0.0
87;2021-01-09;66;0;789;4;0.2;0.0
87;2021-01-10;35;0;824;4;0.2;0.0
87;2021-01-11;424;0;1248;4;0.3;0.0
87;2021-01-12;654;0;1902;4;0.5;0.0
87;2021-01-13;660;3;2562;7;0.7;0.0
87;2021-01-14;517;11;3079;18;0.8;0.0
87;2021-01-15;534;3;3613;21;1.0;0.0
87;2021-01-16;204;1;3817;22;1.0;0.0
87;2021-01-17;1;0;3818;22;1.0;0.0
87;2021-01-18;645;6;4463;28;1.2;0.0
87;2021-01-19;657;1;5120;29;1.4;0.0
87;2021-01-20;674;4;5794;33;1.6;0.0
87;2021-01-21;716;2;6510;35;1.8;0.0
87;2021-01-22;757;4;7267;39;2.0;0.0
87;2021-01-23;287;1;7554;40;2.0;0.0
87;2021-01-24;1;0;7555;40;2.0;0.0
87;2021-01-25;620;9;8175;49;2.2;0.0
87;2021-01-26;570;52;8745;101;2.4;0.0
87;2021-01-27;572;40;9317;141;2.5;0.0
87;2021-01-28;856;110;10173;251;2.7;0.1
87;2021-01-29;741;272;10914;523;2.9;0.1
87;2021-01-30;325;72;11239;595;3.0;0.2
87;2021-01-31;34;71;11273;666;3.0;0.2
87;2021-02-01;413;309;11686;975;3.2;0.3
87;2021-02-02;452;482;12138;1457;3.3;0.4
87;2021-02-03;540;420;12678;1877;3.4;0.5
87;2021-02-04;613;595;13291;2472;3.6;0.7
87;2021-02-05;344;382;13635;2854;3.7;0.8
87;2021-02-06;55;156;13690;3010;3.7;0.8
87;2021-02-07;20;0;13710;3010;3.7;0.8
87;2021-02-08;246;444;13956;3454;3.8;0.9
87;2021-02-09;219;541;14175;3995;3.8;1.1
87;2021-02-10;262;623;14437;4618;3.9;1.2
87;2021-02-11;286;540;14723;5158;4.0;1.4
87;2021-02-12;287;556;15010;5714;4.0;1.5
87;2021-02-13;26;170;15036;5884;4.1;1.6
87;2021-02-14;0;3;15036;5887;4.1;1.6
87;2021-02-15;237;388;15273;6275;4.1;1.7
87;2021-02-16;332;330;15605;6605;4.2;1.8
87;2021-02-17;329;379;15934;6984;4.3;1.9
87;2021-02-18;478;645;16412;7629;4.4;2.1
87;2021-02-19;406;481;16818;8110;4.5;2.2
87;2021-02-20;124;195;16942;8305;4.6;2.2
87;2021-02-21;2;9;16944;8314;4.6;2.2
87;2021-02-22;440;576;17384;8890;4.7;2.4
87;2021-02-23;557;636;17941;9526;4.8;2.6
87;2021-02-24;451;598;18392;10124;5.0;2.7
87;2021-02-25;790;709;19182;10833;5.2;2.9
87;2021-02-26;842;480;20024;11313;5.4;3.1
87;2021-02-27;405;212;20429;11525;5.5;3.1
87;2021-02-28;3;0;20432;11525;5.5;3.1
87;2021-03-01;518;370;20950;11895;5.7;3.2
87;2021-03-02;1031;392;21981;12287;5.9;3.3
87;2021-03-03;1174;353;23155;12640;6.2;3.4
87;2021-03-04;1405;340;24560;12980;6.6;3.5
87;2021-03-05;1771;288;26331;13268;7.1;3.6
87;2021-03-06;1049;42;27380;13310;7.4;3.6
87;2021-03-07;257;6;27637;13316;7.5;3.6
87;2021-03-08;863;247;28500;13563;7.7;3.7
87;2021-03-09;1287;237;29787;13800;8.0;3.7
87;2021-03-10;1299;237;31086;14037;8.4;3.8
87;2021-03-11;1756;257;32842;14294;8.9;3.9
87;2021-03-12;2129;293;34971;14587;9.4;3.9
87;2021-03-13;1309;22;36280;14609;9.8;3.9
87;2021-03-14;80;1;36360;14610;9.8;3.9
87;2021-03-15;987;358;37347;14968;10.1;4.0
87;2021-03-16;1060;244;38407;15212;10.4;4.1
87;2021-03-17;1070;221;39477;15433;10.6;4.2
87;2021-03-18;1186;349;40663;15782;11.0;4.3
87;2021-03-19;1684;283;42347;16065;11.4;4.3
87;2021-03-20;926;92;43273;16157;11.7;4.4
87;2021-03-21;32;0;43305;16157;11.7;4.4
87;2021-03-22;1049;384;44354;16541;12.0;4.5
87;2021-03-23;1386;432;45740;16973;12.3;4.6
87;2021-03-24;1508;367;47248;17340;12.7;4.7
87;2021-03-25;2499;399;49747;17739;13.4;4.8
87;2021-03-26;2532;460;52279;18199;14.1;4.9
87;2021-03-27;891;126;53170;18325;14.3;4.9
87;2021-03-28;270;18;53440;18343;14.4;4.9
87;2021-03-29;1119;418;54559;18761;14.7;5.1
87;2021-03-30;1907;669;56466;19430;15.2;5.2
87;2021-03-31;1660;699;58126;20129;15.7;5.4
87;2021-04-01;2237;574;60363;20703;16.3;5.6
87;2021-04-02;1843;636;62206;21339;16.8;5.8
87;2021-04-03;455;266;62661;21605;16.9;5.8
87;2021-04-04;2;0;62663;21605;16.9;5.8
87;2021-04-05;82;1;62745;21606;16.9;5.8
87;2021-04-06;1005;911;63750;22517;17.2;6.1
87;2021-04-07;1487;926;65237;23443;17.6;6.3
87;2021-04-08;1785;1034;67022;24477;18.1;6.6
87;2021-04-09;2647;743;69669;25220;18.8;6.8
87;2021-04-10;1189;307;70858;25527;19.1;6.9
87;2021-04-11;69;1;70927;25528;19.1;6.9
87;2021-04-12;1619;830;72546;26358;19.6;7.1
87;2021-04-13;2287;1064;74833;27422;20.2;7.4
87;2021-04-14;2530;1192;77363;28614;20.9;7.7
87;2021-04-15;2223;1078;79586;29692;21.5;8.0
87;2021-04-16;2735;1071;82321;30763;22.2;8.3
87;2021-04-17;731;389;83052;31152;22.4;8.4
87;2021-04-18;111;141;83163;31293;22.4;8.4
87;2021-04-19;1662;837;84825;32130;22.9;8.7
87;2021-04-20;2084;885;86909;33015;23.4;8.9
87;2021-04-21;2295;996;89204;34011;24.1;9.2
87;2021-04-22;2564;1167;91768;35178;24.8;9.5
87;2021-04-23;1997;1184;93765;36362;25.3;9.8
87;2021-04-24;824;621;94589;36983;25.5;10.0
87;2021-04-25;66;103;94655;37086;25.5;10.0
87;2021-04-26;1355;915;96010;38001;25.9;10.2
87;2021-04-27;2398;1206;98408;39207;26.5;10.6
87;2021-04-28;3867;1445;102275;40652;27.6;11.0
87;2021-04-29;3079;1845;105354;42497;28.4;11.5
87;2021-04-30;3172;1363;108526;43860;29.3;11.8
87;2021-05-01;614;61;109140;43921;29.4;11.8
87;2021-05-02;361;5;109501;43926;29.5;11.8
87;2021-05-03;2323;940;111824;44866;30.2;12.1
87;2021-05-04;2902;1074;114726;45940;30.9;12.4
87;2021-05-05;2989;1511;117715;47451;31.7;12.8
87;2021-05-06;2531;1725;120246;49176;32.4;13.3
87;2021-05-07;2946;1727;123192;50903;33.2;13.7
87;2021-05-08;772;295;123964;51198;33.4;13.8
87;2021-05-09;18;133;123982;51331;33.4;13.8
87;2021-05-10;1938;1602;125920;52933;34.0;14.3
87;2021-05-11;2465;1908;128385;54841;34.6;14.8
87;2021-05-12;2623;2066;131008;56907;35.3;15.3
87;2021-05-13;1085;293;132093;57200;35.6;15.4
87;2021-05-14;2245;1775;134338;58975;36.2;15.9
87;2021-05-15;950;409;135288;59384;36.5;16.0
87;2021-05-16;141;73;135429;59457;36.5;16.0
87;2021-05-17;1628;1762;137057;61219;37.0;16.5
87;2021-05-18;2633;1822;139690;63041;37.7;17.0
87;2021-05-19;2821;1554;142511;64595;38.4;17.4
87;2021-05-20;3302;1724;145813;66319;39.3;17.9
87;2021-05-21;2764;1843;148577;68162;40.1;18.4
87;2021-05-22;1457;629;150034;68791;40.5;18.6
87;2021-05-23;211;92;150245;68883;40.5;18.6
87;2021-05-24;1055;143;151300;69026;40.8;18.6
87;2021-05-25;2116;1811;153416;70837;41.4;19.1
87;2021-05-26;3219;2478;156635;73315;42.2;19.8
87;2021-05-27;3022;2357;159657;75672;43.1;20.4
87;2021-05-28;2675;2522;162332;78194;43.8;21.1
87;2021-05-29;1061;1313;163393;79507;44.1;21.4
87;2021-05-30;258;60;163651;79567;44.1;21.5
87;2021-05-31;2287;1361;165938;80928;44.8;21.8
87;2021-06-01;2547;1865;168485;82793;45.4;22.3
87;2021-06-02;2524;1856;171009;84649;46.1;22.8
87;2021-06-03;3213;2529;174222;87178;47.0;23.5
87;2021-06-04;2838;2063;177060;89241;47.8;24.1
87;2021-06-05;1310;574;178370;89815;48.1;24.2
87;2021-06-06;261;95;178631;89910;48.2;24.2
87;2021-06-07;2098;1900;180729;91810;48.7;24.8
87;2021-06-08;2958;2603;183687;94413;49.5;25.5
87;2021-06-09;2303;2812;185990;97225;50.2;26.2
87;2021-06-10;2974;2552;188964;99777;51.0;26.9
87;2021-06-11;2363;3075;191327;102852;51.6;27.7
87;2021-06-12;1219;1103;192546;103955;51.9;28.0
87;2021-06-13;294;485;192840;104440;52.0;28.2
87;2021-06-14;980;2729;193820;107169;52.3;28.9
87;2021-06-15;1362;3319;195182;110488;52.6;29.8
87;2021-06-16;1650;3424;196832;113912;53.1;30.7
87;2021-06-17;2438;2314;199270;116226;53.7;31.3
87;2021-06-18;1791;3019;201061;119245;54.2;32.2
87;2021-06-19;1047;1177;202108;120422;54.5;32.5
87;2021-06-20;205;206;202313;120628;54.6;32.5
87;2021-06-21;1040;2648;203353;123276;54.8;33.2
87;2021-06-22;1029;2880;204382;126156;55.1;34.0
87;2021-06-23;1255;3081;205637;129237;55.5;34.9
87;2021-06-24;1616;2561;207253;131798;55.9;35.5
87;2021-06-25;1448;2710;208701;134508;56.3;36.3
87;2021-06-26;529;1201;209230;135709;56.4;36.6
87;2021-06-27;26;212;209256;135921;56.4;36.7
87;2021-06-28;717;2575;209973;138496;56.6;37.4
87;2021-06-29;1156;3417;211129;141913;56.9;38.3
87;2021-06-30;1125;2652;212254;144565;57.2;39.0
87;2021-07-01;1482;2552;213736;147117;57.6;39.7
87;2021-07-02;1204;3464;214940;150581;58.0;40.6
87;2021-07-03;415;1512;215355;152093;58.1;41.0
87;2021-07-04;24;384;215379;152477;58.1;41.1
87;2021-07-05;685;2393;216064;154870;58.3;41.8
87;2021-07-06;582;3220;216646;158090;58.4;42.6
87;2021-07-07;862;3344;217508;161434;58.7;43.5
87;2021-07-08;1121;3671;218629;165105;59.0;44.5
87;2021-07-09;1113;3702;219742;168807;59.3;45.5
87;2021-07-10;290;1360;220032;170167;59.3;45.9
87;2021-07-11;49;284;220081;170451;59.4;46.0
87;2021-07-12;559;3192;220640;173643;59.5;46.8
87;2021-07-13;833;3512;221473;177155;59.7;47.8
87;2021-07-14;517;538;221990;177693;59.9;47.9
87;2021-07-15;1361;3463;223351;181156;60.2;48.9
87;2021-07-16;1731;3597;225082;184753;60.7;49.8
87;2021-07-17;655;1373;225737;186126;60.9;50.2
87;2021-07-18;81;285;225818;186411;60.9;50.3
87;2021-07-19;1434;3400;227252;189811;61.3;51.2
87;2021-07-20;1805;3591;229057;193402;61.8;52.2
87;2021-07-21;1451;3154;230508;196556;62.2;53.0
87;2021-07-22;1877;3251;232385;199807;62.7;53.9
87;2021-07-23;1875;3172;234260;202979;63.2;54.7
87;2021-07-24;816;1285;235076;204264;63.4;55.1
87;2021-07-25;106;241;235182;204505;63.4;55.2
87;2021-07-26;1541;2329;236723;206834;63.8;55.8
87;2021-07-27;2556;2062;239279;208896;64.5;56.3
87;2021-07-28;2390;2007;241669;210903;65.2;56.9
87;2021-07-29;3011;2000;244680;212903;66.0;57.4
87;2021-07-30;2545;2077;247225;214980;66.7;58.0
87;2021-07-31;1104;837;248329;215817;67.0;58.2
87;2021-08-01;283;151;248612;215968;67.1;58.2
87;2021-08-02;2119;1520;250731;217488;67.6;58.7
87;2021-08-03;2497;1331;253228;218819;68.3;59.0
87;2021-08-04;2314;1063;255542;219882;68.9;59.3
87;2021-08-05;2528;1414;258070;221296;69.6;59.7
87;2021-08-06;2144;1660;260214;222956;70.2;60.1
87;2021-08-07;1110;783;261324;223739;70.5;60.3
87;2021-08-08;208;125;261532;223864;70.5;60.4
87;2021-08-09;1819;1526;263351;225390;71.0;60.8
87;2021-08-10;2201;1533;265552;226923;71.6;61.2
87;2021-08-11;1912;1273;267464;228196;72.1;61.5
87;2021-08-12;2106;1481;269570;229677;72.7;61.9
87;2021-08-13;1724;1621;271294;231298;73.2;62.4
87;2021-08-14;672;733;271966;232031;73.4;62.6
87;2021-08-15;72;104;272038;232135;73.4;62.6
87;2021-08-16;1505;1739;273543;233874;73.8;63.1
87;2021-08-17;1354;1669;274897;235543;74.1;63.5
87;2021-08-18;1246;1998;276143;237541;74.5;64.1
87;2021-08-19;1223;1798;277366;239339;74.8;64.6
87;2021-08-20;917;2207;278283;241546;75.1;65.1
87;2021-08-21;318;966;278601;242512;75.1;65.4
87;2021-08-22;93;235;278694;242747;75.2;65.5
87;2021-08-23;746;2393;279440;245140;75.4;66.1
87;2021-08-24;765;2135;280205;247275;75.6;66.7
87;2021-08-25;710;2062;280915;249337;75.8;67.2
87;2021-08-26;861;2157;281776;251494;76.0;67.8
87;2021-08-27;790;2668;282566;254162;76.2;68.5
87;2021-08-28;332;1302;282898;255464;76.3;68.9
87;2021-08-29;65;244;282963;255708;76.3;69.0
87;2021-08-30;472;2197;283435;257905;76.4;69.6
87;2021-08-31;608;1902;284043;259807;76.6;70.1
87;2021-09-01;751;2351;284794;262158;76.8;70.7
87;2021-09-02;558;2137;285352;264295;77.0;71.3
87;2021-09-03;652;2150;286004;266445;77.1;71.9
87;2021-09-04;277;1065;286281;267510;77.2;72.1
87;2021-09-05;9;6;286290;267516;77.2;72.2
87;2021-09-06;396;1601;286686;269117;77.3;72.6
87;2021-09-07;386;1241;287072;270358;77.4;72.9
87;2021-09-08;460;1468;287532;271826;77.5;73.3
87;2021-09-09;326;965;287858;272791;77.6;73.6
87;2021-09-10;468;1379;288326;274170;77.8;73.9
87;2021-09-11;320;895;288646;275065;77.8;74.2
87;2021-09-12;3;13;288649;275078;77.9;74.2
87;2021-09-13;313;764;288962;275842;77.9;74.4
87;2021-09-14;287;619;289249;276461;78.0;74.6
87;2021-09-15;369;964;289618;277425;78.1;74.8
87;2021-09-16;350;789;289968;278214;78.2;75.0
87;2021-09-17;409;885;290377;279099;78.3;75.3
87;2021-09-18;286;728;290663;279827;78.4;75.5
87;2021-09-19;4;14;290667;279841;78.4;75.5
87;2021-09-20;204;465;290871;280306;78.4;75.6
87;2021-09-21;262;510;291133;280816;78.5;75.7
87;2021-09-22;238;759;291371;281575;78.6;75.9
87;2021-09-23;224;529;291595;282104;78.6;76.1
87;2021-09-24;296;740;291891;282844;78.7;76.3
87;2021-09-25;167;510;292058;283354;78.8;76.4
87;2021-09-26;3;5;292061;283359;78.8;76.4
87;2021-09-27;196;402;292257;283761;78.8;76.5
87;2021-09-28;205;322;292462;284083;78.9;76.6
87;2021-09-29;173;400;292635;284483;78.9;76.7
87;2021-09-30;140;268;292775;284751;79.0;76.8
87;2021-10-01;205;513;292980;285264;79.0;76.9
87;2021-10-02;156;399;293136;285663;79.1;77.0
87;2021-10-03;3;3;293139;285666;79.1;77.0
87;2021-10-04;157;291;293296;285957;79.1;77.1
87;2021-10-05;112;212;293408;286169;79.1;77.2
87;2021-10-06;197;413;293605;286582;79.2;77.3
87;2021-10-07;110;259;293715;286841;79.2;77.4
87;2021-10-08;228;476;293943;287317;79.3;77.5
87;2021-10-09;178;356;294121;287673;79.3;77.6
87;2021-10-10;4;4;294125;287677;79.3;77.6
87;2021-10-11;135;267;294260;287944;79.4;77.7
87;2021-10-12;109;216;294369;288160;79.4;77.7
87;2021-10-13;161;212;294530;288372;79.4;77.8
87;2021-10-14;139;248;294669;288620;79.5;77.8
87;2021-10-15;189;337;294858;288957;79.5;77.9
87;2021-10-16;144;268;295002;289225;79.6;78.0
87;2021-10-17;3;14;295005;289239;79.6;78.0
87;2021-10-18;126;211;295131;289450;79.6;78.1
87;2021-10-19;130;198;295261;289648;79.6;78.1
88;2020-12-27;0;0;0;0;0.0;0.0
88;2020-12-28;0;0;0;0;0.0;0.0
88;2020-12-29;0;0;0;0;0.0;0.0
88;2020-12-30;0;0;0;0;0.0;0.0
88;2020-12-31;0;0;0;0;0.0;0.0
88;2021-01-01;2;0;2;0;0.0;0.0
88;2021-01-02;0;0;2;0;0.0;0.0
88;2021-01-03;0;0;2;0;0.0;0.0
88;2021-01-04;0;0;2;0;0.0;0.0
88;2021-01-05;1;0;3;0;0.0;0.0
88;2021-01-06;3;0;6;0;0.0;0.0
88;2021-01-07;71;1;77;1;0.0;0.0
88;2021-01-08;189;2;266;3;0.1;0.0
88;2021-01-09;190;3;456;6;0.1;0.0
88;2021-01-10;0;0;456;6;0.1;0.0
88;2021-01-11;227;0;683;6;0.2;0.0
88;2021-01-12;422;0;1105;6;0.3;0.0
88;2021-01-13;491;2;1596;8;0.4;0.0
88;2021-01-14;347;3;1943;11;0.5;0.0
88;2021-01-15;380;3;2323;14;0.6;0.0
88;2021-01-16;62;0;2385;14;0.7;0.0
88;2021-01-17;1;0;2386;14;0.7;0.0
88;2021-01-18;461;0;2847;14;0.8;0.0
88;2021-01-19;452;0;3299;14;0.9;0.0
88;2021-01-20;462;2;3761;16;1.0;0.0
88;2021-01-21;1547;7;5308;23;1.5;0.0
88;2021-01-22;1182;2;6490;25;1.8;0.0
88;2021-01-23;285;0;6775;25;1.9;0.0
88;2021-01-24;298;2;7073;27;2.0;0.0
88;2021-01-25;937;4;8010;31;2.2;0.0
88;2021-01-26;388;5;8398;36;2.3;0.0
88;2021-01-27;4;0;8402;36;2.3;0.0
88;2021-01-28;162;38;8564;74;2.4;0.0
88;2021-01-29;527;160;9091;234;2.5;0.1
88;2021-01-30;288;128;9379;362;2.6;0.1
88;2021-01-31;0;0;9379;362;2.6;0.1
88;2021-02-01;405;281;9784;643;2.7;0.2
88;2021-02-02;333;363;10117;1006;2.8;0.3
88;2021-02-03;437;241;10554;1247;2.9;0.3
88;2021-02-04;315;229;10869;1476;3.0;0.4
88;2021-02-05;457;252;11326;1728;3.2;0.5
88;2021-02-06;110;56;11436;1784;3.2;0.5
88;2021-02-07;0;0;11436;1784;3.2;0.5
88;2021-02-08;360;203;11796;1987;3.3;0.6
88;2021-02-09;291;288;12087;2275;3.4;0.6
88;2021-02-10;416;344;12503;2619;3.5;0.7
88;2021-02-11;850;1094;13353;3713;3.7;1.0
88;2021-02-12;939;707;14292;4420;4.0;1.2
88;2021-02-13;162;211;14454;4631;4.0;1.3
88;2021-02-14;81;216;14535;4847;4.0;1.3
88;2021-02-15;639;1076;15174;5923;4.2;1.6
88;2021-02-16;472;723;15646;6646;4.4;1.8
88;2021-02-17;455;437;16101;7083;4.5;2.0
88;2021-02-18;515;385;16616;7468;4.6;2.1
88;2021-02-19;535;461;17151;7929;4.8;2.2
88;2021-02-20;156;101;17307;8030;4.8;2.2
88;2021-02-21;1;25;17308;8055;4.8;2.2
88;2021-02-22;425;342;17733;8397;4.9;2.3
88;2021-02-23;403;232;18136;8629;5.0;2.4
88;2021-02-24;505;210;18641;8839;5.2;2.5
88;2021-02-25;674;286;19315;9125;5.4;2.5
88;2021-02-26;863;277;20178;9402;5.6;2.6
88;2021-02-27;269;34;20447;9436;5.7;2.6
88;2021-02-28;30;1;20477;9437;5.7;2.6
88;2021-03-01;358;463;20835;9900;5.8;2.8
88;2021-03-02;431;497;21266;10397;5.9;2.9
88;2021-03-03;650;466;21916;10863;6.1;3.0
88;2021-03-04;1045;768;22961;11631;6.4;3.2
88;2021-03-05;933;706;23894;12337;6.6;3.4
88;2021-03-06;1873;119;25767;12456;7.2;3.5
88;2021-03-07;1060;82;26827;12538;7.5;3.5
88;2021-03-08;727;693;27554;13231;7.7;3.7
88;2021-03-09;1094;541;28648;13772;8.0;3.8
88;2021-03-10;1083;498;29731;14270;8.3;4.0
88;2021-03-11;1441;404;31172;14674;8.7;4.1
88;2021-03-12;1309;490;32481;15164;9.0;4.2
88;2021-03-13;1211;131;33692;15295;9.4;4.3
88;2021-03-14;166;5;33858;15300;9.4;4.3
88;2021-03-15;928;447;34786;15747;9.7;4.4
88;2021-03-16;1023;345;35809;16092;10.0;4.5
88;2021-03-17;906;424;36715;16516;10.2;4.6
88;2021-03-18;1302;404;38017;16920;10.6;4.7
88;2021-03-19;1466;508;39483;17428;11.0;4.8
88;2021-03-20;1319;57;40802;17485;11.3;4.9
88;2021-03-21;37;0;40839;17485;11.4;4.9
88;2021-03-22;1233;546;42072;18031;11.7;5.0
88;2021-03-23;1780;448;43852;18479;12.2;5.1
88;2021-03-24;1877;475;45729;18954;12.7;5.3
88;2021-03-25;2497;497;48226;19451;13.4;5.4
88;2021-03-26;2480;463;50706;19914;14.1;5.5
88;2021-03-27;884;301;51590;20215;14.3;5.6
88;2021-03-28;61;4;51651;20219;14.4;5.6
88;2021-03-29;1305;449;52956;20668;14.7;5.7
88;2021-03-30;2062;395;55018;21063;15.3;5.9
88;2021-03-31;1619;578;56637;21641;15.8;6.0
88;2021-04-01;2117;721;58754;22362;16.3;6.2
88;2021-04-02;2812;648;61566;23010;17.1;6.4
88;2021-04-03;745;215;62311;23225;17.3;6.5
88;2021-04-04;16;1;62327;23226;17.3;6.5
88;2021-04-05;23;2;62350;23228;17.3;6.5
88;2021-04-06;1140;680;63490;23908;17.7;6.6
88;2021-04-07;1601;716;65091;24624;18.1;6.8
88;2021-04-08;1857;792;66948;25416;18.6;7.1
88;2021-04-09;3079;744;70027;26160;19.5;7.3
88;2021-04-10;724;650;70751;26810;19.7;7.5
88;2021-04-11;33;1;70784;26811;19.7;7.5
88;2021-04-12;1537;989;72321;27800;20.1;7.7
88;2021-04-13;2035;1091;74356;28891;20.7;8.0
88;2021-04-14;1910;953;76266;29844;21.2;8.3
88;2021-04-15;1967;1246;78233;31090;21.8;8.6
88;2021-04-16;2109;1050;80342;32140;22.3;8.9
88;2021-04-17;1430;766;81772;32906;22.7;9.2
88;2021-04-18;268;23;82040;32929;22.8;9.2
88;2021-04-19;1172;1239;83212;34168;23.1;9.5
88;2021-04-20;1190;1398;84402;35566;23.5;9.9
88;2021-04-21;1503;1300;85905;36866;23.9;10.3
88;2021-04-22;1900;1638;87805;38504;24.4;10.7
88;2021-04-23;1825;2047;89630;40551;24.9;11.3
88;2021-04-24;1184;788;90814;41339;25.3;11.5
88;2021-04-25;34;2;90848;41341;25.3;11.5
88;2021-04-26;1182;1176;92030;42517;25.6;11.8
88;2021-04-27;1277;1737;93307;44254;26.0;12.3
88;2021-04-28;1634;1498;94941;45752;26.4;12.7
88;2021-04-29;2081;1468;97022;47220;27.0;13.1
88;2021-04-30;2450;1635;99472;48855;27.7;13.6
88;2021-05-01;2008;290;101480;49145;28.2;13.7
88;2021-05-02;1301;120;102781;49265;28.6;13.7
88;2021-05-03;1559;1218;104340;50483;29.0;14.0
88;2021-05-04;1444;1469;105784;51952;29.4;14.5
88;2021-05-05;2426;1599;108210;53551;30.1;14.9
88;2021-05-06;3211;1214;111421;54765;31.0;15.2
88;2021-05-07;2938;1359;114359;56124;31.8;15.6
88;2021-05-08;1532;470;115891;56594;32.2;15.7
88;2021-05-09;1734;163;117625;56757;32.7;15.8
88;2021-05-10;1763;1571;119388;58328;33.2;16.2
88;2021-05-11;2655;1914;122043;60242;33.9;16.8
88;2021-05-12;2531;1853;124574;62095;34.7;17.3
88;2021-05-13;3258;683;127832;62778;35.6;17.5
88;2021-05-14;2500;1545;130332;64323;36.3;17.9
88;2021-05-15;1624;744;131956;65067;36.7;18.1
88;2021-05-16;1332;104;133288;65171;37.1;18.1
88;2021-05-17;1987;946;135275;66117;37.6;18.4
88;2021-05-18;2255;1117;137530;67234;38.3;18.7
88;2021-05-19;2721;1150;140251;68384;39.0;19.0
88;2021-05-20;3348;1239;143599;69623;39.9;19.4
88;2021-05-21;2875;1151;146474;70774;40.7;19.7
88;2021-05-22;1431;713;147905;71487;41.1;19.9
88;2021-05-23;558;74;148463;71561;41.3;19.9
88;2021-05-24;1675;435;150138;71996;41.8;20.0
88;2021-05-25;1646;1175;151784;73171;42.2;20.4
88;2021-05-26;2368;1141;154152;74312;42.9;20.7
88;2021-05-27;2200;1362;156352;75674;43.5;21.0
88;2021-05-28;1892;1989;158244;77663;44.0;21.6
88;2021-05-29;1230;1755;159474;79418;44.4;22.1
88;2021-05-30;587;418;160061;79836;44.5;22.2
88;2021-05-31;1327;1852;161388;81688;44.9;22.7
88;2021-06-01;1720;1986;163108;83674;45.4;23.3
88;2021-06-02;2076;1871;165184;85545;45.9;23.8
88;2021-06-03;2738;1622;167922;87167;46.7;24.2
88;2021-06-04;2042;1935;169964;89102;47.3;24.8
88;2021-06-05;1531;1139;171495;90241;47.7;25.1
88;2021-06-06;692;156;172187;90397;47.9;25.1
88;2021-06-07;1290;1710;173477;92107;48.3;25.6
88;2021-06-08;1666;1935;175143;94042;48.7;26.2
88;2021-06-09;1619;1911;176762;95953;49.2;26.7
88;2021-06-10;1781;2049;178543;98002;49.7;27.3
88;2021-06-11;1549;2218;180092;100220;50.1;27.9
88;2021-06-12;669;1657;180761;101877;50.3;28.3
88;2021-06-13;464;377;181225;102254;50.4;28.4
88;2021-06-14;1030;2251;182255;104505;50.7;29.1
88;2021-06-15;1928;2458;184183;106963;51.2;29.8
88;2021-06-16;1486;2873;185669;109836;51.6;30.6
88;2021-06-17;1601;2733;187270;112569;52.1;31.3
88;2021-06-18;1355;2461;188625;115030;52.5;32.0
88;2021-06-19;701;1090;189326;116120;52.7;32.3
88;2021-06-20;78;79;189404;116199;52.7;32.3
88;2021-06-21;672;2579;190076;118778;52.9;33.0
88;2021-06-22;869;3434;190945;122212;53.1;34.0
88;2021-06-23;1144;2877;192089;125089;53.4;34.8
88;2021-06-24;702;2604;192791;127693;53.6;35.5
88;2021-06-25;1436;3180;194227;130873;54.0;36.4
88;2021-06-26;903;2073;195130;132946;54.3;37.0
88;2021-06-27;543;635;195673;133581;54.4;37.2
88;2021-06-28;759;2515;196432;136096;54.6;37.9
88;2021-06-29;960;3353;197392;139449;54.9;38.8
88;2021-06-30;1137;3116;198529;142565;55.2;39.7
88;2021-07-01;1056;2686;199585;145251;55.5;40.4
88;2021-07-02;992;3150;200577;148401;55.8;41.3
88;2021-07-03;692;1699;201269;150100;56.0;41.8
88;2021-07-04;258;815;201527;150915;56.1;42.0
88;2021-07-05;993;2021;202520;152936;56.3;42.5
88;2021-07-06;1023;2416;203543;155352;56.6;43.2
88;2021-07-07;1177;2586;204720;157938;56.9;43.9
88;2021-07-08;1082;2063;205802;160001;57.2;44.5
88;2021-07-09;1583;2708;207385;162709;57.7;45.3
88;2021-07-10;721;1820;208106;164529;57.9;45.8
88;2021-07-11;468;696;208574;165225;58.0;46.0
88;2021-07-12;1056;2520;209630;167745;58.3;46.7
88;2021-07-13;1313;2655;210943;170400;58.7;47.4
88;2021-07-14;1207;802;212150;171202;59.0;47.6
88;2021-07-15;1744;3312;213894;174514;59.5;48.5
88;2021-07-16;1469;2964;215363;177478;59.9;49.4
88;2021-07-17;803;1587;216166;179065;60.1;49.8
88;2021-07-18;180;679;216346;179744;60.2;50.0
88;2021-07-19;1563;2231;217909;181975;60.6;50.6
88;2021-07-20;2144;2385;220053;184360;61.2;51.3
88;2021-07-21;1939;2218;221992;186578;61.7;51.9
88;2021-07-22;1699;2108;223691;188686;62.2;52.5
88;2021-07-23;2508;2784;226199;191470;62.9;53.3
88;2021-07-24;1059;1187;227258;192657;63.2;53.6
88;2021-07-25;432;608;227690;193265;63.3;53.8
88;2021-07-26;1715;2076;229405;195341;63.8;54.3
88;2021-07-27;2351;2061;231756;197402;64.5;54.9
88;2021-07-28;2210;2250;233966;199652;65.1;55.5
88;2021-07-29;3033;1636;236999;201288;65.9;56.0
88;2021-07-30;2272;2297;239271;203585;66.6;56.6
88;2021-07-31;1105;1037;240376;204622;66.9;56.9
88;2021-08-01;450;461;240826;205083;67.0;57.0
88;2021-08-02;2376;1770;243202;206853;67.6;57.5
88;2021-08-03;2875;1592;246077;208445;68.4;58.0
88;2021-08-04;2520;1529;248597;209974;69.1;58.4
88;2021-08-05;1994;1378;250591;211352;69.7;58.8
88;2021-08-06;2948;2010;253539;213362;70.5;59.3
88;2021-08-07;1177;912;254716;214274;70.8;59.6
88;2021-08-08;751;320;255467;214594;71.1;59.7
88;2021-08-09;1551;1650;257018;216244;71.5;60.1
88;2021-08-10;1941;2041;258959;218285;72.0;60.7
88;2021-08-11;1871;1760;260830;220045;72.5;61.2
88;2021-08-12;1671;1349;262501;221394;73.0;61.6
88;2021-08-13;1954;2140;264455;223534;73.6;62.2
88;2021-08-14;580;912;265035;224446;73.7;62.4
88;2021-08-15;337;520;265372;224966;73.8;62.6
88;2021-08-16;1149;1988;266521;226954;74.1;63.1
88;2021-08-17;1267;2058;267788;229012;74.5;63.7
88;2021-08-18;1209;1925;268997;230937;74.8;64.2
88;2021-08-19;1042;1582;270039;232519;75.1;64.7
88;2021-08-20;1020;2330;271059;234849;75.4;65.3
88;2021-08-21;404;1144;271463;235993;75.5;65.6
88;2021-08-22;100;479;271563;236472;75.5;65.8
88;2021-08-23;734;1640;272297;238112;75.7;66.2
88;2021-08-24;918;1973;273215;240085;76.0;66.8
88;2021-08-25;891;2460;274106;242545;76.2;67.5
88;2021-08-26;868;2049;274974;244594;76.5;68.0
88;2021-08-27;844;2711;275818;247305;76.7;68.8
88;2021-08-28;490;1351;276308;248656;76.9;69.2
88;2021-08-29;130;693;276438;249349;76.9;69.4
88;2021-08-30;698;2342;277136;251691;77.1;70.0
88;2021-08-31;782;2329;277918;254020;77.3;70.7
88;2021-09-01;686;1993;278604;256013;77.5;71.2
88;2021-09-02;666;1604;279270;257617;77.7;71.7
88;2021-09-03;728;2106;279998;259723;77.9;72.2
88;2021-09-04;429;1104;280427;260827;78.0;72.5
88;2021-09-05;188;370;280615;261197;78.1;72.7
88;2021-09-06;505;1208;281120;262405;78.2;73.0
88;2021-09-07;566;1225;281686;263630;78.4;73.3
88;2021-09-08;459;1331;282145;264961;78.5;73.7
88;2021-09-09;542;770;282687;265731;78.6;73.9
88;2021-09-10;592;1342;283279;267073;78.8;74.3
88;2021-09-11;349;781;283628;267854;78.9;74.5
88;2021-09-12;71;125;283699;267979;78.9;74.5
88;2021-09-13;429;701;284128;268680;79.0;74.7
88;2021-09-14;555;722;284683;269402;79.2;74.9
88;2021-09-15;428;972;285111;270374;79.3;75.2
88;2021-09-16;255;535;285366;270909;79.4;75.4
88;2021-09-17;434;1026;285800;271935;79.5;75.6
88;2021-09-18;237;680;286037;272615;79.6;75.8
88;2021-09-19;52;164;286089;272779;79.6;75.9
88;2021-09-20;223;565;286312;273344;79.6;76.0
88;2021-09-21;209;598;286521;273942;79.7;76.2
88;2021-09-22;207;780;286728;274722;79.8;76.4
88;2021-09-23;289;626;287017;275348;79.8;76.6
88;2021-09-24;279;802;287296;276150;79.9;76.8
88;2021-09-25;131;564;287427;276714;79.9;77.0
88;2021-09-26;18;159;287445;276873;80.0;77.0
88;2021-09-27;165;458;287610;277331;80.0;77.1
88;2021-09-28;175;523;287785;277854;80.0;77.3
88;2021-09-29;174;504;287959;278358;80.1;77.4
88;2021-09-30;127;459;288086;278817;80.1;77.6
88;2021-10-01;207;672;288293;279489;80.2;77.7
88;2021-10-02;129;359;288422;279848;80.2;77.8
88;2021-10-03;23;80;288445;279928;80.2;77.9
88;2021-10-04;137;467;288582;280395;80.3;78.0
88;2021-10-05;178;581;288760;280976;80.3;78.2
88;2021-10-06;198;398;288958;281374;80.4;78.3
88;2021-10-07;62;209;289020;281583;80.4;78.3
88;2021-10-08;266;630;289286;282213;80.5;78.5
88;2021-10-09;118;241;289404;282454;80.5;78.6
88;2021-10-10;22;46;289426;282500;80.5;78.6
88;2021-10-11;99;225;289525;282725;80.5;78.6
88;2021-10-12;150;258;289675;282983;80.6;78.7
88;2021-10-13;147;259;289822;283242;80.6;78.8
88;2021-10-14;71;187;289893;283429;80.6;78.8
88;2021-10-15;210;379;290103;283808;80.7;78.9
88;2021-10-16;112;143;290215;283951;80.7;79.0
88;2021-10-17;0;15;290215;283966;80.7;79.0
88;2021-10-18;183;235;290398;284201;80.8;79.1
88;2021-10-19;158;167;290556;284368;80.8;79.1
89;2020-12-27;0;0;0;0;0.0;0.0
89;2020-12-28;2;1;2;1;0.0;0.0
89;2020-12-29;0;0;2;1;0.0;0.0
89;2020-12-30;0;0;2;1;0.0;0.0
89;2020-12-31;0;0;2;1;0.0;0.0
89;2021-01-01;0;0;2;1;0.0;0.0
89;2021-01-02;0;0;2;1;0.0;0.0
89;2021-01-03;0;0;2;1;0.0;0.0
89;2021-01-04;0;0;2;1;0.0;0.0
89;2021-01-05;0;0;2;1;0.0;0.0
89;2021-01-06;48;0;50;1;0.0;0.0
89;2021-01-07;201;0;251;1;0.1;0.0
89;2021-01-08;48;0;299;1;0.1;0.0
89;2021-01-09;1;0;300;1;0.1;0.0
89;2021-01-10;0;0;300;1;0.1;0.0
89;2021-01-11;221;0;521;1;0.2;0.0
89;2021-01-12;349;0;870;1;0.3;0.0
89;2021-01-13;535;3;1405;4;0.4;0.0
89;2021-01-14;711;8;2116;12;0.6;0.0
89;2021-01-15;278;2;2394;14;0.7;0.0
89;2021-01-16;90;4;2484;18;0.7;0.0
89;2021-01-17;0;0;2484;18;0.7;0.0
89;2021-01-18;503;1;2987;19;0.9;0.0
89;2021-01-19;841;4;3828;23;1.2;0.0
89;2021-01-20;762;0;4590;23;1.4;0.0
89;2021-01-21;939;4;5529;27;1.7;0.0
89;2021-01-22;1020;1;6549;28;2.0;0.0
89;2021-01-23;200;0;6749;28;2.0;0.0
89;2021-01-24;107;1;6856;29;2.1;0.0
89;2021-01-25;483;4;7339;33;2.2;0.0
89;2021-01-26;582;14;7921;47;2.4;0.0
89;2021-01-27;473;38;8394;85;2.5;0.0
89;2021-01-28;551;127;8945;212;2.7;0.1
89;2021-01-29;959;43;9904;255;3.0;0.1
89;2021-01-30;184;67;10088;322;3.0;0.1
89;2021-01-31;24;2;10112;324;3.0;0.1
89;2021-02-01;256;152;10368;476;3.1;0.1
89;2021-02-02;283;333;10651;809;3.2;0.2
89;2021-02-03;292;344;10943;1153;3.3;0.3
89;2021-02-04;434;593;11377;1746;3.4;0.5
89;2021-02-05;387;204;11764;1950;3.5;0.6
89;2021-02-06;77;66;11841;2016;3.6;0.6
89;2021-02-07;0;0;11841;2016;3.6;0.6
89;2021-02-08;287;188;12128;2204;3.7;0.7
89;2021-02-09;284;441;12412;2645;3.7;0.8
89;2021-02-10;396;313;12808;2958;3.9;0.9
89;2021-02-11;333;548;13141;3506;4.0;1.1
89;2021-02-12;434;599;13575;4105;4.1;1.2
89;2021-02-13;51;130;13626;4235;4.1;1.3
89;2021-02-14;21;116;13647;4351;4.1;1.3
89;2021-02-15;217;403;13864;4754;4.2;1.4
89;2021-02-16;134;534;13998;5288;4.2;1.6
89;2021-02-17;263;438;14261;5726;4.3;1.7
89;2021-02-18;225;544;14486;6270;4.4;1.9
89;2021-02-19;246;652;14732;6922;4.4;2.1
89;2021-02-20;33;140;14765;7062;4.4;2.1
89;2021-02-21;0;10;14765;7072;4.4;2.1
89;2021-02-22;233;451;14998;7523;4.5;2.3
89;2021-02-23;170;490;15168;8013;4.6;2.4
89;2021-02-24;344;389;15512;8402;4.7;2.5
89;2021-02-25;370;464;15882;8866;4.8;2.7
89;2021-02-26;385;338;16267;9204;4.9;2.8
89;2021-02-27;138;82;16405;9286;4.9;2.8
89;2021-02-28;6;13;16411;9299;4.9;2.8
89;2021-03-01;541;237;16952;9536;5.1;2.9
89;2021-03-02;755;356;17707;9892;5.3;3.0
89;2021-03-03;647;277;18354;10169;5.5;3.1
89;2021-03-04;633;380;18987;10549;5.7;3.2
89;2021-03-05;728;506;19715;11055;5.9;3.3
89;2021-03-06;549;135;20264;11190;6.1;3.4
89;2021-03-07;288;40;20552;11230;6.2;3.4
89;2021-03-08;562;331;21114;11561;6.4;3.5
89;2021-03-09;1003;278;22117;11839;6.7;3.6
89;2021-03-10;983;257;23100;12096;7.0;3.6
89;2021-03-11;1077;304;24177;12400;7.3;3.7
89;2021-03-12;1280;338;25457;12738;7.7;3.8
89;2021-03-13;637;45;26094;12783;7.9;3.8
89;2021-03-14;1;0;26095;12783;7.9;3.8
89;2021-03-15;816;317;26911;13100;8.1;3.9
89;2021-03-16;948;229;27859;13329;8.4;4.0
89;2021-03-17;920;273;28779;13602;8.7;4.1
89;2021-03-18;885;258;29664;13860;8.9;4.2
89;2021-03-19;1149;198;30813;14058;9.3;4.2
89;2021-03-20;844;33;31657;14091;9.5;4.2
89;2021-03-21;173;6;31830;14097;9.6;4.2
89;2021-03-22;1044;227;32874;14324;9.9;4.3
89;2021-03-23;1744;263;34618;14587;10.4;4.4
89;2021-03-24;1968;333;36586;14920;11.0;4.5
89;2021-03-25;1821;175;38407;15095;11.6;4.5
89;2021-03-26;2629;190;41036;15285;12.4;4.6
89;2021-03-27;1775;52;42811;15337;12.9;4.6
89;2021-03-28;32;3;42843;15340;12.9;4.6
89;2021-03-29;965;580;43808;15920;13.2;4.8
89;2021-03-30;1156;575;44964;16495;13.5;5.0
89;2021-03-31;2004;474;46968;16969;14.1;5.1
89;2021-04-01;2121;463;49089;17432;14.8;5.2
89;2021-04-02;2141;450;51230;17882;15.4;5.4
89;2021-04-03;1004;243;52234;18125;15.7;5.5
89;2021-04-04;16;1;52250;18126;15.7;5.5
89;2021-04-05;92;4;52342;18130;15.8;5.5
89;2021-04-06;1034;758;53376;18888;16.1;5.7
89;2021-04-07;1027;805;54403;19693;16.4;5.9
89;2021-04-08;1730;728;56133;20421;16.9;6.1
89;2021-04-09;2164;773;58297;21194;17.6;6.4
89;2021-04-10;891;180;59188;21374;17.8;6.4
89;2021-04-11;38;51;59226;21425;17.8;6.5
89;2021-04-12;1011;795;60237;22220;18.1;6.7
89;2021-04-13;1356;1082;61593;23302;18.5;7.0
89;2021-04-14;1214;1040;62807;24342;18.9;7.3
89;2021-04-15;1412;948;64219;25290;19.3;7.6
89;2021-04-16;1330;941;65549;26231;19.7;7.9
89;2021-04-17;1070;456;66619;26687;20.1;8.0
89;2021-04-18;28;155;66647;26842;20.1;8.1
89;2021-04-19;748;1040;67395;27882;20.3;8.4
89;2021-04-20;1016;1535;68411;29417;20.6;8.9
89;2021-04-21;814;1107;69225;30524;20.8;9.2
89;2021-04-22;1105;1170;70330;31694;21.2;9.5
89;2021-04-23;1820;1966;72150;33660;21.7;10.1
89;2021-04-24;1173;1175;73323;34835;22.1;10.5
89;2021-04-25;139;6;73462;34841;22.1;10.5
89;2021-04-26;1503;778;74965;35619;22.6;10.7
89;2021-04-27;1734;1055;76699;36674;23.1;11.0
89;2021-04-28;1599;1856;78298;38530;23.6;11.6
89;2021-04-29;1970;1932;80268;40462;24.2;12.2
89;2021-04-30;1803;1770;82071;42232;24.7;12.7
89;2021-05-01;847;722;82918;42954;25.0;12.9
89;2021-05-02;134;31;83052;42985;25.0;12.9
89;2021-05-03;1605;766;84657;43751;25.5;13.2
89;2021-05-04;1617;1133;86274;44884;26.0;13.5
89;2021-05-05;2319;1267;88593;46151;26.7;13.9
89;2021-05-06;2411;1380;91004;47531;27.4;14.3
89;2021-05-07;2718;1318;93722;48849;28.2;14.7
89;2021-05-08;1786;535;95508;49384;28.8;14.9
89;2021-05-09;196;19;95704;49403;28.8;14.9
89;2021-05-10;1202;965;96906;50368;29.2;15.2
89;2021-05-11;2492;1466;99398;51834;29.9;15.6
89;2021-05-12;2060;1217;101458;53051;30.6;16.0
89;2021-05-13;415;332;101873;53383;30.7;16.1
89;2021-05-14;1880;1095;103753;54478;31.2;16.4
89;2021-05-15;2247;394;106000;54872;31.9;16.5
89;2021-05-16;10;35;106010;54907;31.9;16.5
89;2021-05-17;2090;638;108100;55545;32.6;16.7
89;2021-05-18;2324;833;110424;56378;33.3;17.0
89;2021-05-19;2860;882;113284;57260;34.1;17.2
89;2021-05-20;2927;886;116211;58146;35.0;17.5
89;2021-05-21;2481;879;118692;59025;35.7;17.8
89;2021-05-22;1431;572;120123;59597;36.2;17.9
89;2021-05-23;108;10;120231;59607;36.2;17.9
89;2021-05-24;288;226;120519;59833;36.3;18.0
89;2021-05-25;1558;982;122077;60815;36.8;18.3
89;2021-05-26;1815;1024;123892;61839;37.3;18.6
89;2021-05-27;2117;1358;126009;63197;37.9;19.0
89;2021-05-28;2143;1422;128152;64619;38.6;19.5
89;2021-05-29;541;658;128693;65277;38.8;19.7
89;2021-05-30;25;22;128718;65299;38.8;19.7
89;2021-05-31;1248;972;129966;66271;39.1;20.0
89;2021-06-01;1505;981;131471;67252;39.6;20.3
89;2021-06-02;1946;1278;133417;68530;40.2;20.6
89;2021-06-03;2432;1523;135849;70053;40.9;21.1
89;2021-06-04;2140;1888;137989;71941;41.6;21.7
89;2021-06-05;1185;1224;139174;73165;41.9;22.0
89;2021-06-06;24;37;139198;73202;41.9;22.0
89;2021-06-07;2107;1452;141305;74654;42.5;22.5
89;2021-06-08;2195;1452;143500;76106;43.2;22.9
89;2021-06-09;2326;1510;145826;77616;43.9;23.4
89;2021-06-10;2794;1600;148620;79216;44.8;23.9
89;2021-06-11;1951;1750;150571;80966;45.3;24.4
89;2021-06-12;1103;759;151674;81725;45.7;24.6
89;2021-06-13;156;423;151830;82148;45.7;24.7
89;2021-06-14;1313;1825;153143;83973;46.1;25.3
89;2021-06-15;1404;2010;154547;85983;46.5;25.9
89;2021-06-16;1129;2582;155676;88565;46.9;26.7
89;2021-06-17;1435;2335;157111;90900;47.3;27.4
89;2021-06-18;1623;2877;158734;93777;47.8;28.2
89;2021-06-19;686;1660;159420;95437;48.0;28.7
89;2021-06-20;55;127;159475;95564;48.0;28.8
89;2021-06-21;758;1528;160233;97092;48.2;29.2
89;2021-06-22;1049;2679;161282;99771;48.6;30.0
89;2021-06-23;1157;1800;162439;101571;48.9;30.6
89;2021-06-24;1078;1498;163517;103069;49.2;31.0
89;2021-06-25;1008;2425;164525;105494;49.5;31.8
89;2021-06-26;560;2482;165085;107976;49.7;32.5
89;2021-06-27;14;28;165099;108004;49.7;32.5
89;2021-06-28;1033;2494;166132;110498;50.0;33.3
89;2021-06-29;691;2403;166823;112901;50.2;34.0
89;2021-06-30;1083;3181;167906;116082;50.6;35.0
89;2021-07-01;1026;2991;168932;119073;50.9;35.9
89;2021-07-02;1109;2753;170041;121826;51.2;36.7
89;2021-07-03;554;1575;170595;123401;51.4;37.2
89;2021-07-04;11;36;170606;123437;51.4;37.2
89;2021-07-05;1296;1839;171902;125276;51.8;37.7
89;2021-07-06;1058;2313;172960;127589;52.1;38.4
89;2021-07-07;681;1787;173641;129376;52.3;39.0
89;2021-07-08;805;1873;174446;131249;52.5;39.5
89;2021-07-09;1146;2606;175592;133855;52.9;40.3
89;2021-07-10;719;816;176311;134671;53.1;40.6
89;2021-07-11;26;39;176337;134710;53.1;40.6
89;2021-07-12;1429;1901;177766;136611;53.5;41.1
89;2021-07-13;2146;2746;179912;139357;54.2;42.0
89;2021-07-14;325;328;180237;139685;54.3;42.1
89;2021-07-15;2254;3156;182491;142841;55.0;43.0
89;2021-07-16;2391;2865;184882;145706;55.7;43.9
89;2021-07-17;1235;1229;186117;146935;56.0;44.2
89;2021-07-18;277;97;186394;147032;56.1;44.3
89;2021-07-19;1567;2812;187961;149844;56.6;45.1
89;2021-07-20;1929;3283;189890;153127;57.2;46.1
89;2021-07-21;2081;2727;191971;155854;57.8;46.9
89;2021-07-22;2481;2994;194452;158848;58.6;47.8
89;2021-07-23;2475;3105;196927;161953;59.3;48.8
89;2021-07-24;1241;1247;198168;163200;59.7;49.1
89;2021-07-25;69;185;198237;163385;59.7;49.2
89;2021-07-26;1719;2322;199956;165707;60.2;49.9
89;2021-07-27;2345;1911;202301;167618;60.9;50.5
89;2021-07-28;2539;1339;204840;168957;61.7;50.9
89;2021-07-29;2526;1620;207366;170577;62.4;51.4
89;2021-07-30;2679;1627;210045;172204;63.2;51.9
89;2021-07-31;1121;1073;211166;173277;63.6;52.2
89;2021-08-01;69;33;211235;173310;63.6;52.2
89;2021-08-02;1805;1288;213040;174598;64.2;52.6
89;2021-08-03;2501;1255;215541;175853;64.9;53.0
89;2021-08-04;1556;1641;217097;177494;65.4;53.4
89;2021-08-05;1577;1693;218674;179187;65.8;54.0
89;2021-08-06;2220;1651;220894;180838;66.5;54.5
89;2021-08-07;931;1098;221825;181936;66.8;54.8
89;2021-08-08;56;48;221881;181984;66.8;54.8
89;2021-08-09;1120;1175;223001;183159;67.1;55.2
89;2021-08-10;1836;1816;224837;184975;67.7;55.7
89;2021-08-11;1597;1586;226434;186561;68.2;56.2
89;2021-08-12;1455;1393;227889;187954;68.6;56.6
89;2021-08-13;1356;1956;229245;189910;69.0;57.2
89;2021-08-14;529;1025;229774;190935;69.2;57.5
89;2021-08-15;20;43;229794;190978;69.2;57.5
89;2021-08-16;1035;1969;230829;192947;69.5;58.1
89;2021-08-17;864;1573;231693;194520;69.8;58.6
89;2021-08-18;647;1898;232340;196418;70.0;59.1
89;2021-08-19;703;1389;233043;197807;70.2;59.6
89;2021-08-20;1159;2266;234202;200073;70.5;60.2
89;2021-08-21;297;1003;234499;201076;70.6;60.5
89;2021-08-22;32;34;234531;201110;70.6;60.6
89;2021-08-23;835;2252;235366;203362;70.9;61.2
89;2021-08-24;869;2366;236235;205728;71.1;61.9
89;2021-08-25;596;1429;236831;207157;71.3;62.4
89;2021-08-26;618;2053;237449;209210;71.5;63.0
89;2021-08-27;881;2264;238330;211474;71.8;63.7
89;2021-08-28;380;1303;238710;212777;71.9;64.1
89;2021-08-29;30;70;238740;212847;71.9;64.1
89;2021-08-30;664;2210;239404;215057;72.1;64.8
89;2021-08-31;609;1578;240013;216635;72.3;65.2
89;2021-09-01;633;1299;240646;217934;72.5;65.6
89;2021-09-02;485;1327;241131;219261;72.6;66.0
89;2021-09-03;646;1909;241777;221170;72.8;66.6
89;2021-09-04;515;947;242292;222117;73.0;66.9
89;2021-09-05;21;11;242313;222128;73.0;66.9
89;2021-09-06;469;1545;242782;223673;73.1;67.4
89;2021-09-07;399;915;243181;224588;73.2;67.6
89;2021-09-08;385;859;243566;225447;73.3;67.9
89;2021-09-09;290;832;243856;226279;73.4;68.1
89;2021-09-10;519;1383;244375;227662;73.6;68.6
89;2021-09-11;284;763;244659;228425;73.7;68.8
89;2021-09-12;11;38;244670;228463;73.7;68.8
89;2021-09-13;426;1070;245096;229533;73.8;69.1
89;2021-09-14;398;663;245494;230196;73.9;69.3
89;2021-09-15;249;702;245743;230898;74.0;69.5
89;2021-09-16;281;573;246024;231471;74.1;69.7
89;2021-09-17;498;1119;246522;232590;74.2;70.0
89;2021-09-18;181;744;246703;233334;74.3;70.3
89;2021-09-19;6;18;246709;233352;74.3;70.3
89;2021-09-20;253;727;246962;234079;74.4;70.5
89;2021-09-21;301;481;247263;234560;74.5;70.6
89;2021-09-22;201;579;247464;235139;74.5;70.8
89;2021-09-23;234;476;247698;235615;74.6;70.9
89;2021-09-24;305;874;248003;236489;74.7;71.2
89;2021-09-25;109;466;248112;236955;74.7;71.4
89;2021-09-26;3;19;248115;236974;74.7;71.4
89;2021-09-27;195;506;248310;237480;74.8;71.5
89;2021-09-28;240;410;248550;237890;74.8;71.6
89;2021-09-29;187;424;248737;238314;74.9;71.8
89;2021-09-30;170;622;248907;238936;75.0;71.9
89;2021-10-01;255;660;249162;239596;75.0;72.1
89;2021-10-02;120;477;249282;240073;75.1;72.3
89;2021-10-03;8;8;249290;240081;75.1;72.3
89;2021-10-04;122;546;249412;240627;75.1;72.5
89;2021-10-05;138;573;249550;241200;75.1;72.6
89;2021-10-06;228;588;249778;241788;75.2;72.8
89;2021-10-07;88;338;249866;242126;75.2;72.9
89;2021-10-08;233;732;250099;242858;75.3;73.1
89;2021-10-09;111;278;250210;243136;75.3;73.2
89;2021-10-10;0;11;250210;243147;75.3;73.2
89;2021-10-11;126;318;250336;243465;75.4;73.3
89;2021-10-12;104;269;250440;243734;75.4;73.4
89;2021-10-13;140;313;250580;244047;75.5;73.5
89;2021-10-14;112;331;250692;244378;75.5;73.6
89;2021-10-15;214;499;250906;244877;75.6;73.7
89;2021-10-16;107;188;251013;245065;75.6;73.8
89;2021-10-17;5;6;251018;245071;75.6;73.8
89;2021-10-18;121;269;251139;245340;75.6;73.9
89;2021-10-19;141;245;251280;245585;75.7;74.0
90;2020-12-27;0;0;0;0;0.0;0.0
90;2020-12-28;0;0;0;0;0.0;0.0
90;2020-12-29;0;0;0;0;0.0;0.0
90;2020-12-30;1;0;1;0;0.0;0.0
90;2020-12-31;0;0;1;0;0.0;0.0
90;2021-01-01;0;0;1;0;0.0;0.0
90;2021-01-02;1;0;2;0;0.0;0.0
90;2021-01-03;0;0;2;0;0.0;0.0
90;2021-01-04;2;0;4;0;0.0;0.0
90;2021-01-05;0;0;4;0;0.0;0.0
90;2021-01-06;0;0;4;0;0.0;0.0
90;2021-01-07;1;0;5;0;0.0;0.0
90;2021-01-08;170;0;175;0;0.1;0.0
90;2021-01-09;46;0;221;0;0.2;0.0
90;2021-01-10;0;0;221;0;0.2;0.0
90;2021-01-11;200;0;421;0;0.3;0.0
90;2021-01-12;431;1;852;1;0.6;0.0
90;2021-01-13;467;2;1319;3;0.9;0.0
90;2021-01-14;414;2;1733;5;1.2;0.0
90;2021-01-15;404;9;2137;14;1.5;0.0
90;2021-01-16;111;2;2248;16;1.6;0.0
90;2021-01-17;1;0;2249;16;1.6;0.0
90;2021-01-18;365;2;2614;18;1.9;0.0
90;2021-01-19;462;6;3076;24;2.2;0.0
90;2021-01-20;392;2;3468;26;2.5;0.0
90;2021-01-21;351;1;3819;27;2.7;0.0
90;2021-01-22;345;2;4164;29;3.0;0.0
90;2021-01-23;98;0;4262;29;3.0;0.0
90;2021-01-24;0;0;4262;29;3.0;0.0
90;2021-01-25;322;3;4584;32;3.3;0.0
90;2021-01-26;224;0;4808;32;3.4;0.0
90;2021-01-27;254;0;5062;32;3.6;0.0
90;2021-01-28;328;33;5390;65;3.8;0.0
90;2021-01-29;291;163;5681;228;4.1;0.2
90;2021-01-30;175;45;5856;273;4.2;0.2
90;2021-01-31;118;0;5974;273;4.3;0.2
90;2021-02-01;275;116;6249;389;4.5;0.3
90;2021-02-02;290;163;6539;552;4.7;0.4
90;2021-02-03;256;368;6795;920;4.8;0.7
90;2021-02-04;257;306;7052;1226;5.0;0.9
90;2021-02-05;266;272;7318;1498;5.2;1.1
90;2021-02-06;90;68;7408;1566;5.3;1.1
90;2021-02-07;0;0;7408;1566;5.3;1.1
90;2021-02-08;170;217;7578;1783;5.4;1.3
90;2021-02-09;139;166;7717;1949;5.5;1.4
90;2021-02-10;182;32;7899;1981;5.6;1.4
90;2021-02-11;229;109;8128;2090;5.8;1.5
90;2021-02-12;126;239;8254;2329;5.9;1.7
90;2021-02-13;96;46;8350;2375;6.0;1.7
90;2021-02-14;0;0;8350;2375;6.0;1.7
90;2021-02-15;113;280;8463;2655;6.0;1.9
90;2021-02-16;92;275;8555;2930;6.1;2.1
90;2021-02-17;178;204;8733;3134;6.2;2.2
90;2021-02-18;128;242;8861;3376;6.3;2.4
90;2021-02-19;64;271;8925;3647;6.4;2.6
90;2021-02-20;40;72;8965;3719;6.4;2.7
90;2021-02-21;0;0;8965;3719;6.4;2.7
90;2021-02-22;77;334;9042;4053;6.5;2.9
90;2021-02-23;40;257;9082;4310;6.5;3.1
90;2021-02-24;109;291;9191;4601;6.6;3.3
90;2021-02-25;89;314;9280;4915;6.6;3.5
90;2021-02-26;89;393;9369;5308;6.7;3.8
90;2021-02-27;140;175;9509;5483;6.8;3.9
90;2021-02-28;8;113;9517;5596;6.8;4.0
90;2021-03-01;211;231;9728;5827;6.9;4.2
90;2021-03-02;178;284;9906;6111;7.1;4.4
90;2021-03-03;239;355;10145;6466;7.2;4.6
90;2021-03-04;260;278;10405;6744;7.4;4.8
90;2021-03-05;359;271;10764;7015;7.7;5.0
90;2021-03-06;291;104;11055;7119;7.9;5.1
90;2021-03-07;18;1;11073;7120;7.9;5.1
90;2021-03-08;246;249;11319;7369;8.1;5.3
90;2021-03-09;430;167;11749;7536;8.4;5.4
90;2021-03-10;348;197;12097;7733;8.6;5.5
90;2021-03-11;347;120;12444;7853;8.9;5.6
90;2021-03-12;519;130;12963;7983;9.2;5.7
90;2021-03-13;539;49;13502;8032;9.6;5.7
90;2021-03-14;21;0;13523;8032;9.6;5.7
90;2021-03-15;388;118;13911;8150;9.9;5.8
90;2021-03-16;402;103;14313;8253;10.2;5.9
90;2021-03-17;323;76;14636;8329;10.4;5.9
90;2021-03-18;349;84;14985;8413;10.7;6.0
90;2021-03-19;467;79;15452;8492;11.0;6.1
90;2021-03-20;427;48;15879;8540;11.3;6.1
90;2021-03-21;7;1;15886;8541;11.3;6.1
90;2021-03-22;399;31;16285;8572;11.6;6.1
90;2021-03-23;740;79;17025;8651;12.1;6.2
90;2021-03-24;817;47;17842;8698;12.7;6.2
90;2021-03-25;949;79;18791;8777;13.4;6.3
90;2021-03-26;1227;62;20018;8839;14.3;6.3
90;2021-03-27;439;34;20457;8873;14.6;6.3
90;2021-03-28;34;0;20491;8873;14.6;6.3
90;2021-03-29;712;144;21203;9017;15.1;6.4
90;2021-03-30;675;156;21878;9173;15.6;6.5
90;2021-03-31;728;87;22606;9260;16.1;6.6
90;2021-04-01;602;123;23208;9383;16.6;6.7
90;2021-04-02;657;98;23865;9481;17.0;6.8
90;2021-04-03;370;41;24235;9522;17.3;6.8
90;2021-04-04;1;0;24236;9522;17.3;6.8
90;2021-04-05;0;0;24236;9522;17.3;6.8
90;2021-04-06;528;252;24764;9774;17.7;7.0
90;2021-04-07;485;268;25249;10042;18.0;7.2
90;2021-04-08;510;246;25759;10288;18.4;7.3
90;2021-04-09;751;268;26510;10556;18.9;7.5
90;2021-04-10;224;9;26734;10565;19.1;7.5
90;2021-04-11;7;0;26741;10565;19.1;7.5
90;2021-04-12;557;482;27298;11047;19.5;7.9
90;2021-04-13;632;532;27930;11579;19.9;8.3
90;2021-04-14;525;354;28455;11933;20.3;8.5
90;2021-04-15;905;293;29360;12226;20.9;8.7
90;2021-04-16;370;405;29730;12631;21.2;9.0
90;2021-04-17;189;129;29919;12760;21.3;9.1
90;2021-04-18;21;0;29940;12760;21.4;9.1
90;2021-04-19;435;573;30375;13333;21.7;9.5
90;2021-04-20;493;620;30868;13953;22.0;10.0
90;2021-04-21;353;497;31221;14450;22.3;10.3
90;2021-04-22;569;602;31790;15052;22.7;10.7
90;2021-04-23;504;743;32294;15795;23.0;11.3
90;2021-04-24;305;202;32599;15997;23.3;11.4
90;2021-04-25;1;0;32600;15997;23.3;11.4
90;2021-04-26;509;751;33109;16748;23.6;12.0
90;2021-04-27;640;683;33749;17431;24.1;12.4
90;2021-04-28;765;448;34514;17879;24.6;12.8
90;2021-04-29;1003;455;35517;18334;25.3;13.1
90;2021-04-30;1120;460;36637;18794;26.1;13.4
90;2021-05-01;60;42;36697;18836;26.2;13.4
90;2021-05-02;4;0;36701;18836;26.2;13.4
90;2021-05-03;903;287;37604;19123;26.8;13.6
90;2021-05-04;784;639;38388;19762;27.4;14.1
90;2021-05-05;891;504;39279;20266;28.0;14.5
90;2021-05-06;851;626;40130;20892;28.6;14.9
90;2021-05-07;440;507;40570;21399;28.9;15.3
90;2021-05-08;26;27;40596;21426;29.0;15.3
90;2021-05-09;5;33;40601;21459;29.0;15.3
90;2021-05-10;506;585;41107;22044;29.3;15.7
90;2021-05-11;778;638;41885;22682;29.9;16.2
90;2021-05-12;531;598;42416;23280;30.3;16.6
90;2021-05-13;1113;265;43529;23545;31.1;16.8
90;2021-05-14;865;403;44394;23948;31.7;17.1
90;2021-05-15;14;125;44408;24073;31.7;17.2
90;2021-05-16;2;7;44410;24080;31.7;17.2
90;2021-05-17;792;290;45202;24370;32.3;17.4
90;2021-05-18;1024;472;46226;24842;33.0;17.7
90;2021-05-19;1264;384;47490;25226;33.9;18.0
90;2021-05-20;1201;270;48691;25496;34.7;18.2
90;2021-05-21;1265;436;49956;25932;35.6;18.5
90;2021-05-22;9;131;49965;26063;35.7;18.6
90;2021-05-23;4;0;49969;26063;35.7;18.6
90;2021-05-24;368;265;50337;26328;35.9;18.8
90;2021-05-25;635;791;50972;27119;36.4;19.4
90;2021-05-26;630;569;51602;27688;36.8;19.8
90;2021-05-27;962;383;52564;28071;37.5;20.0
90;2021-05-28;668;827;53232;28898;38.0;20.6
90;2021-05-29;93;296;53325;29194;38.0;20.8
90;2021-05-30;4;1;53329;29195;38.1;20.8
90;2021-05-31;808;713;54137;29908;38.6;21.3
90;2021-06-01;969;739;55106;30647;39.3;21.9
90;2021-06-02;760;676;55866;31323;39.9;22.4
90;2021-06-03;758;744;56624;32067;40.4;22.9
90;2021-06-04;833;972;57457;33039;41.0;23.6
90;2021-06-05;54;427;57511;33466;41.0;23.9
90;2021-06-06;1;16;57512;33482;41.0;23.9
90;2021-06-07;1265;1081;58777;34563;41.9;24.7
90;2021-06-08;1482;939;60259;35502;43.0;25.3
90;2021-06-09;964;659;61223;36161;43.7;25.8
90;2021-06-10;627;498;61850;36659;44.1;26.2
90;2021-06-11;787;1126;62637;37785;44.7;27.0
90;2021-06-12;806;297;63443;38082;45.3;27.2
90;2021-06-13;10;12;63453;38094;45.3;27.2
90;2021-06-14;264;972;63717;39066;45.5;27.9
90;2021-06-15;566;882;64283;39948;45.9;28.5
90;2021-06-16;509;548;64792;40496;46.2;28.9
90;2021-06-17;443;638;65235;41134;46.5;29.4
90;2021-06-18;623;997;65858;42131;47.0;30.1
90;2021-06-19;450;171;66308;42302;47.3;30.2
90;2021-06-20;0;28;66308;42330;47.3;30.2
90;2021-06-21;256;1176;66564;43506;47.5;31.0
90;2021-06-22;384;950;66948;44456;47.8;31.7
90;2021-06-23;415;633;67363;45089;48.1;32.2
90;2021-06-24;319;602;67682;45691;48.3;32.6
90;2021-06-25;431;1270;68113;46961;48.6;33.5
90;2021-06-26;420;560;68533;47521;48.9;33.9
90;2021-06-27;2;6;68535;47527;48.9;33.9
90;2021-06-28;381;1298;68916;48825;49.2;34.8
90;2021-06-29;304;1305;69220;50130;49.4;35.8
90;2021-06-30;485;1227;69705;51357;49.7;36.6
90;2021-07-01;355;920;70060;52277;50.0;37.3
90;2021-07-02;506;1205;70566;53482;50.4;38.2
90;2021-07-03;53;129;70619;53611;50.4;38.3
90;2021-07-04;0;21;70619;53632;50.4;38.3
90;2021-07-05;400;1014;71019;54646;50.7;39.0
90;2021-07-06;514;970;71533;55616;51.0;39.7
90;2021-07-07;381;998;71914;56614;51.3;40.4
90;2021-07-08;304;607;72218;57221;51.5;40.8
90;2021-07-09;439;950;72657;58171;51.8;41.5
90;2021-07-10;32;91;72689;58262;51.9;41.6
90;2021-07-11;7;17;72696;58279;51.9;41.6
90;2021-07-12;246;1075;72942;59354;52.0;42.4
90;2021-07-13;476;1161;73418;60515;52.4;43.2
90;2021-07-14;4;9;73422;60524;52.4;43.2
90;2021-07-15;789;1455;74211;61979;53.0;44.2
90;2021-07-16;826;1681;75037;63660;53.5;45.4
90;2021-07-17;484;955;75521;64615;53.9;46.1
90;2021-07-18;4;2;75525;64617;53.9;46.1
90;2021-07-19;1186;1460;76711;66077;54.7;47.1
90;2021-07-20;1339;1135;78050;67212;55.7;48.0
90;2021-07-21;1395;983;79445;68195;56.7;48.7
90;2021-07-22;1127;697;80572;68892;57.5;49.2
90;2021-07-23;968;1020;81540;69912;58.2;49.9
90;2021-07-24;121;66;81661;69978;58.3;49.9
90;2021-07-25;2;1;81663;69979;58.3;49.9
90;2021-07-26;1074;801;82737;70780;59.0;50.5
90;2021-07-27;1081;746;83818;71526;59.8;51.0
90;2021-07-28;825;712;84643;72238;60.4;51.5
90;2021-07-29;843;441;85486;72679;61.0;51.9
90;2021-07-30;786;506;86272;73185;61.6;52.2
90;2021-07-31;484;313;86756;73498;61.9;52.4
90;2021-08-01;0;3;86756;73501;61.9;52.4
90;2021-08-02;847;510;87603;74011;62.5;52.8
90;2021-08-03;929;494;88532;74505;63.2;53.2
90;2021-08-04;1067;460;89599;74965;63.9;53.5
90;2021-08-05;521;223;90120;75188;64.3;53.7
90;2021-08-06;649;388;90769;75576;64.8;53.9
90;2021-08-07;37;63;90806;75639;64.8;54.0
90;2021-08-08;18;3;90824;75642;64.8;54.0
90;2021-08-09;730;947;91554;76589;65.3;54.6
90;2021-08-10;536;1152;92090;77741;65.7;55.5
90;2021-08-11;537;948;92627;78689;66.1;56.1
90;2021-08-12;449;820;93076;79509;66.4;56.7
90;2021-08-13;545;898;93621;80407;66.8;57.4
90;2021-08-14;30;98;93651;80505;66.8;57.4
90;2021-08-15;2;7;93653;80512;66.8;57.4
90;2021-08-16;451;632;94104;81144;67.1;57.9
90;2021-08-17;347;1167;94451;82311;67.4;58.7
90;2021-08-18;275;881;94726;83192;67.6;59.4
90;2021-08-19;248;627;94974;83819;67.8;59.8
90;2021-08-20;361;772;95335;84591;68.0;60.4
90;2021-08-21;32;71;95367;84662;68.0;60.4
90;2021-08-22;0;7;95367;84669;68.0;60.4
90;2021-08-23;320;489;95687;85158;68.3;60.8
90;2021-08-24;337;959;96024;86117;68.5;61.4
90;2021-08-25;254;915;96278;87032;68.7;62.1
90;2021-08-26;247;675;96525;87707;68.9;62.6
90;2021-08-27;279;737;96804;88444;69.1;63.1
90;2021-08-28;21;64;96825;88508;69.1;63.2
90;2021-08-29;3;6;96828;88514;69.1;63.2
90;2021-08-30;328;628;97156;89142;69.3;63.6
90;2021-08-31;281;1010;97437;90152;69.5;64.3
90;2021-09-01;267;676;97704;90828;69.7;64.8
90;2021-09-02;164;386;97868;91214;69.8;65.1
90;2021-09-03;236;517;98104;91731;70.0;65.5
90;2021-09-04;55;139;98159;91870;70.0;65.6
90;2021-09-05;10;23;98169;91893;70.0;65.6
90;2021-09-06;139;722;98308;92615;70.1;66.1
90;2021-09-07;222;570;98530;93185;70.3;66.5
90;2021-09-08;224;575;98754;93760;70.5;66.9
90;2021-09-09;191;257;98945;94017;70.6;67.1
90;2021-09-10;192;472;99137;94489;70.7;67.4
90;2021-09-11;13;4;99150;94493;70.7;67.4
90;2021-09-12;0;4;99150;94497;70.7;67.4
90;2021-09-13;212;371;99362;94868;70.9;67.7
90;2021-09-14;162;337;99524;95205;71.0;67.9
90;2021-09-15;187;392;99711;95597;71.1;68.2
90;2021-09-16;154;239;99865;95836;71.3;68.4
90;2021-09-17;189;340;100054;96176;71.4;68.6
90;2021-09-18;17;24;100071;96200;71.4;68.6
90;2021-09-19;7;4;100078;96204;71.4;68.6
90;2021-09-20;154;250;100232;96454;71.5;68.8
90;2021-09-21;105;248;100337;96702;71.6;69.0
90;2021-09-22;105;353;100442;97055;71.7;69.3
90;2021-09-23;81;138;100523;97193;71.7;69.4
90;2021-09-24;105;286;100628;97479;71.8;69.6
90;2021-09-25;16;31;100644;97510;71.8;69.6
90;2021-09-26;0;7;100644;97517;71.8;69.6
90;2021-09-27;93;199;100737;97716;71.9;69.7
90;2021-09-28;91;140;100828;97856;71.9;69.8
90;2021-09-29;79;236;100907;98092;72.0;70.0
90;2021-09-30;61;131;100968;98223;72.0;70.1
90;2021-10-01;113;234;101081;98457;72.1;70.3
90;2021-10-02;10;28;101091;98485;72.1;70.3
90;2021-10-03;0;11;101091;98496;72.1;70.3
90;2021-10-04;140;209;101231;98705;72.2;70.4
90;2021-10-05;44;133;101275;98838;72.3;70.5
90;2021-10-06;91;186;101366;99024;72.3;70.7
90;2021-10-07;58;135;101424;99159;72.4;70.8
90;2021-10-08;112;240;101536;99399;72.5;70.9
90;2021-10-09;11;20;101547;99419;72.5;70.9
90;2021-10-10;0;4;101547;99423;72.5;70.9
90;2021-10-11;81;120;101628;99543;72.5;71.0
90;2021-10-12;75;124;101703;99667;72.6;71.1
90;2021-10-13;108;156;101811;99823;72.6;71.2
90;2021-10-14;68;110;101879;99933;72.7;71.3
90;2021-10-15;127;191;102006;100124;72.8;71.4
90;2021-10-16;4;21;102010;100145;72.8;71.5
90;2021-10-17;0;5;102010;100150;72.8;71.5
90;2021-10-18;89;143;102099;100293;72.9;71.6
90;2021-10-19;72;118;102171;100411;72.9;71.6
91;2020-12-27;0;0;0;0;0.0;0.0
91;2020-12-28;0;0;0;0;0.0;0.0
91;2020-12-29;1;0;1;0;0.0;0.0
91;2020-12-30;1;0;2;0;0.0;0.0
91;2020-12-31;0;0;2;0;0.0;0.0
91;2021-01-01;5;0;7;0;0.0;0.0
91;2021-01-02;0;0;7;0;0.0;0.0
91;2021-01-03;0;0;7;0;0.0;0.0
91;2021-01-04;1;0;8;0;0.0;0.0
91;2021-01-05;71;0;79;0;0.0;0.0
91;2021-01-06;189;2;268;2;0.0;0.0
91;2021-01-07;522;7;790;9;0.1;0.0
91;2021-01-08;394;1;1184;10;0.1;0.0
91;2021-01-09;89;3;1273;13;0.1;0.0
91;2021-01-10;1;0;1274;13;0.1;0.0
91;2021-01-11;595;2;1869;15;0.1;0.0
91;2021-01-12;899;8;2768;23;0.2;0.0
91;2021-01-13;703;8;3471;31;0.3;0.0
91;2021-01-14;721;12;4192;43;0.3;0.0
91;2021-01-15;570;4;4762;47;0.4;0.0
91;2021-01-16;316;7;5078;54;0.4;0.0
91;2021-01-17;118;2;5196;56;0.4;0.0
91;2021-01-18;991;3;6187;59;0.5;0.0
91;2021-01-19;1877;31;8064;90;0.6;0.0
91;2021-01-20;2376;42;10440;132;0.8;0.0
91;2021-01-21;2109;23;12549;155;1.0;0.0
91;2021-01-22;1863;13;14412;168;1.1;0.0
91;2021-01-23;413;1;14825;169;1.1;0.0
91;2021-01-24;53;0;14878;169;1.1;0.0
91;2021-01-25;1049;4;15927;173;1.2;0.0
91;2021-01-26;1576;54;17503;227;1.3;0.0
91;2021-01-27;2423;128;19926;355;1.5;0.0
91;2021-01-28;1988;229;21914;584;1.7;0.0
91;2021-01-29;1746;70;23660;654;1.8;0.0
91;2021-01-30;422;9;24082;663;1.8;0.1
91;2021-01-31;54;0;24136;663;1.8;0.1
91;2021-02-01;965;219;25101;882;1.9;0.1
91;2021-02-02;859;364;25960;1246;2.0;0.1
91;2021-02-03;938;571;26898;1817;2.0;0.1
91;2021-02-04;885;279;27783;2096;2.1;0.2
91;2021-02-05;1037;359;28820;2455;2.2;0.2
91;2021-02-06;342;92;29162;2547;2.2;0.2
91;2021-02-07;14;1;29176;2548;2.2;0.2
91;2021-02-08;904;606;30080;3154;2.3;0.2
91;2021-02-09;963;862;31043;4016;2.4;0.3
91;2021-02-10;1065;994;32108;5010;2.4;0.4
91;2021-02-11;1123;1023;33231;6033;2.5;0.5
91;2021-02-12;1064;839;34295;6872;2.6;0.5
91;2021-02-13;332;359;34627;7231;2.6;0.5
91;2021-02-14;18;113;34645;7344;2.6;0.6
91;2021-02-15;370;1252;35015;8596;2.7;0.7
91;2021-02-16;556;1746;35571;10342;2.7;0.8
91;2021-02-17;814;2682;36385;13024;2.8;1.0
91;2021-02-18;945;2017;37330;15041;2.8;1.1
91;2021-02-19;874;1379;38204;16420;2.9;1.2
91;2021-02-20;168;357;38372;16777;2.9;1.3
91;2021-02-21;13;49;38385;16826;2.9;1.3
91;2021-02-22;335;1197;38720;18023;2.9;1.4
91;2021-02-23;398;1068;39118;19091;3.0;1.4
91;2021-02-24;475;1055;39593;20146;3.0;1.5
91;2021-02-25;736;1020;40329;21166;3.1;1.6
91;2021-02-26;1096;1059;41425;22225;3.1;1.7
91;2021-02-27;613;328;42038;22553;3.2;1.7
91;2021-02-28;65;66;42103;22619;3.2;1.7
91;2021-03-01;933;1073;43036;23692;3.3;1.8
91;2021-03-02;1261;1091;44297;24783;3.4;1.9
91;2021-03-03;1467;1281;45764;26064;3.5;2.0
91;2021-03-04;2437;1139;48201;27203;3.7;2.1
91;2021-03-05;3358;1185;51559;28388;3.9;2.2
91;2021-03-06;4912;477;56471;28865;4.3;2.2
91;2021-03-07;3207;124;59678;28989;4.5;2.2
91;2021-03-08;1475;1068;61153;30057;4.6;2.3
91;2021-03-09;2625;1003;63778;31060;4.8;2.4
91;2021-03-10;2626;1054;66404;32114;5.0;2.4
91;2021-03-11;3786;1146;70190;33260;5.3;2.5
91;2021-03-12;4794;1065;74984;34325;5.7;2.6
91;2021-03-13;5258;360;80242;34685;6.1;2.6
91;2021-03-14;305;29;80547;34714;6.1;2.6
91;2021-03-15;2988;448;83535;35162;6.3;2.7
91;2021-03-16;2616;393;86151;35555;6.5;2.7
91;2021-03-17;2227;356;88378;35911;6.7;2.7
91;2021-03-18;2395;418;90773;36329;6.9;2.8
91;2021-03-19;4093;389;94866;36718;7.2;2.8
91;2021-03-20;3608;194;98474;36912;7.5;2.8
91;2021-03-21;138;30;98612;36942;7.5;2.8
91;2021-03-22;3152;609;101764;37551;7.7;2.8
91;2021-03-23;4139;706;105903;38257;8.0;2.9
91;2021-03-24;3938;510;109841;38767;8.3;2.9
91;2021-03-25;5060;540;114901;39307;8.7;3.0
91;2021-03-26;5550;562;120451;39869;9.1;3.0
91;2021-03-27;4983;353;125434;40222;9.5;3.0
91;2021-03-28;282;59;125716;40281;9.5;3.1
91;2021-03-29;3305;1046;129021;41327;9.8;3.1
91;2021-03-30;4426;1238;133447;42565;10.1;3.2
91;2021-03-31;3370;1348;136817;43913;10.4;3.3
91;2021-04-01;3739;1693;140556;45606;10.7;3.5
91;2021-04-02;3885;2322;144441;47928;10.9;3.6
91;2021-04-03;1874;2876;146315;50804;11.1;3.9
91;2021-04-04;647;1319;146962;52123;11.1;4.0
91;2021-04-05;562;135;147524;52258;11.2;4.0
91;2021-04-06;3403;1797;150927;54055;11.4;4.1
91;2021-04-07;3420;1946;154347;56001;11.7;4.2
91;2021-04-08;4664;2179;159011;58180;12.1;4.4
91;2021-04-09;5348;2170;164359;60350;12.5;4.6
91;2021-04-10;2734;2824;167093;63174;12.7;4.8
91;2021-04-11;191;141;167284;63315;12.7;4.8
91;2021-04-12;2854;2283;170138;65598;12.9;5.0
91;2021-04-13;3758;2656;173896;68254;13.2;5.2
91;2021-04-14;3708;2332;177604;70586;13.5;5.3
91;2021-04-15;4477;2527;182081;73113;13.8;5.5
91;2021-04-16;4549;2816;186630;75929;14.1;5.8
91;2021-04-17;2983;2084;189613;78013;14.4;5.9
91;2021-04-18;269;73;189882;78086;14.4;5.9
91;2021-04-19;2306;2744;192188;80830;14.6;6.1
91;2021-04-20;3178;2990;195366;83820;14.8;6.4
91;2021-04-21;2991;2904;198357;86724;15.0;6.6
91;2021-04-22;3171;3370;201528;90094;15.3;6.8
91;2021-04-23;3717;3361;205245;93455;15.6;7.1
91;2021-04-24;3480;3736;208725;97191;15.8;7.4
91;2021-04-25;2619;647;211344;97838;16.0;7.4
91;2021-04-26;3486;2813;214830;100651;16.3;7.6
91;2021-04-27;4485;2930;219315;103581;16.6;7.9
91;2021-04-28;4569;2709;223884;106290;17.0;8.1
91;2021-04-29;5746;3069;229630;109359;17.4;8.3
91;2021-04-30;5385;2857;235015;112216;17.8;8.5
91;2021-05-01;3517;529;238532;112745;18.1;8.5
91;2021-05-02;628;134;239160;112879;18.1;8.6
91;2021-05-03;5202;2292;244362;115171;18.5;8.7
91;2021-05-04;5589;3182;249951;118353;18.9;9.0
91;2021-05-05;4852;2878;254803;121231;19.3;9.2
91;2021-05-06;5246;3384;260049;124615;19.7;9.4
91;2021-05-07;6122;3751;266171;128366;20.2;9.7
91;2021-05-08;6519;968;272690;129334;20.7;9.8
91;2021-05-09;4804;570;277494;129904;21.0;9.8
91;2021-05-10;5901;3010;283395;132914;21.5;10.1
91;2021-05-11;6826;3836;290221;136750;22.0;10.4
91;2021-05-12;5895;3444;296116;140194;22.4;10.6
91;2021-05-13;4825;1083;300941;141277;22.8;10.7
91;2021-05-14;6549;2396;307490;143673;23.3;10.9
91;2021-05-15;7793;1931;315283;145604;23.9;11.0
91;2021-05-16;4584;373;319867;145977;24.2;11.1
91;2021-05-17;6952;1706;326819;147683;24.8;11.2
91;2021-05-18;8120;1744;334939;149427;25.4;11.3
91;2021-05-19;7099;1698;342038;151125;25.9;11.5
91;2021-05-20;8201;2143;350239;153268;26.5;11.6
91;2021-05-21;8147;2581;358386;155849;27.2;11.8
91;2021-05-22;7660;1538;366046;157387;27.7;11.9
91;2021-05-23;4792;535;370838;157922;28.1;12.0
91;2021-05-24;5015;597;375853;158519;28.5;12.0
91;2021-05-25;7622;2654;383475;161173;29.1;12.2
91;2021-05-26;6874;2946;390349;164119;29.6;12.4
91;2021-05-27;7971;3449;398320;167568;30.2;12.7
91;2021-05-28;7534;4327;405854;171895;30.8;13.0
91;2021-05-29;9301;3508;415155;175403;31.5;13.3
91;2021-05-30;5948;964;421103;176367;31.9;13.4
91;2021-05-31;6738;3697;427841;180064;32.4;13.6
91;2021-06-01;7788;4781;435629;184845;33.0;14.0
91;2021-06-02;7452;3960;443081;188805;33.6;14.3
91;2021-06-03;7859;4780;450940;193585;34.2;14.7
91;2021-06-04;7195;5728;458135;199313;34.7;15.1
91;2021-06-05;6385;5821;464520;205134;35.2;15.5
91;2021-06-06;4089;2512;468609;207646;35.5;15.7
91;2021-06-07;5878;5481;474487;213127;36.0;16.2
91;2021-06-08;7039;5796;481526;218923;36.5;16.6
91;2021-06-09;6469;5145;487995;224068;37.0;17.0
91;2021-06-10;7177;5779;495172;229847;37.5;17.4
91;2021-06-11;6546;7112;501718;236959;38.0;18.0
91;2021-06-12;6218;7371;507936;244330;38.5;18.5
91;2021-06-13;2846;2316;510782;246646;38.7;18.7
91;2021-06-14;4225;7198;515007;253844;39.0;19.2
91;2021-06-15;5574;7262;520581;261106;39.5;19.8
91;2021-06-16;5296;6448;525877;267554;39.9;20.3
91;2021-06-17;6251;7131;532128;274685;40.3;20.8
91;2021-06-18;4630;8740;536758;283425;40.7;21.5
91;2021-06-19;4190;7157;540948;290582;41.0;22.0
91;2021-06-20;1007;4212;541955;294794;41.1;22.3
91;2021-06-21;3232;7236;545187;302030;41.3;22.9
91;2021-06-22;4157;9229;549344;311259;41.6;23.6
91;2021-06-23;4315;7961;553659;319220;42.0;24.2
91;2021-06-24;4912;8483;558571;327703;42.3;24.8
91;2021-06-25;3477;9166;562048;336869;42.6;25.5
91;2021-06-26;2990;8034;565038;344903;42.8;26.1
91;2021-06-27;550;2996;565588;347899;42.9;26.4
91;2021-06-28;3129;8238;568717;356137;43.1;27.0
91;2021-06-29;3588;9634;572305;365771;43.4;27.7
91;2021-06-30;3953;8700;576258;374471;43.7;28.4
91;2021-07-01;4102;8874;580360;383345;44.0;29.1
91;2021-07-02;3776;9321;584136;392666;44.3;29.8
91;2021-07-03;2883;9791;587019;402457;44.5;30.5
91;2021-07-04;852;4726;587871;407183;44.6;30.9
91;2021-07-05;2662;7258;590533;414441;44.8;31.4
91;2021-07-06;3758;9431;594291;423872;45.0;32.1
91;2021-07-07;3806;8592;598097;432464;45.3;32.8
91;2021-07-08;4358;8992;602455;441456;45.7;33.5
91;2021-07-09;3968;9954;606423;451410;46.0;34.2
91;2021-07-10;3397;10235;609820;461645;46.2;35.0
91;2021-07-11;987;4804;610807;466449;46.3;35.4
91;2021-07-12;2804;8886;613611;475335;46.5;36.0
91;2021-07-13;4468;10392;618079;485727;46.8;36.8
91;2021-07-14;2304;3586;620383;489313;47.0;37.1
91;2021-07-15;4537;9824;624920;499137;47.4;37.8
91;2021-07-16;6288;9769;631208;508906;47.8;38.6
91;2021-07-17;5751;9068;636959;517974;48.3;39.3
91;2021-07-18;3401;3687;640360;521661;48.5;39.5
91;2021-07-19;3777;7539;644137;529200;48.8;40.1
91;2021-07-20;6075;9311;650212;538511;49.3;40.8
91;2021-07-21;6252;7742;656464;546253;49.8;41.4
91;2021-07-22;6496;8402;662960;554655;50.2;42.0
91;2021-07-23;6926;8291;669886;562946;50.8;42.7
91;2021-07-24;5012;6481;674898;569427;51.2;43.2
91;2021-07-25;3267;1408;678165;570835;51.4;43.3
91;2021-07-26;4935;6594;683100;577429;51.8;43.8
91;2021-07-27;7567;7084;690667;584513;52.3;44.3
91;2021-07-28;7365;5924;698032;590437;52.9;44.8
91;2021-07-29;7401;5917;705433;596354;53.5;45.2
91;2021-07-30;6914;5784;712347;602138;54.0;45.6
91;2021-07-31;4910;4792;717257;606930;54.4;46.0
91;2021-08-01;2659;1341;719916;608271;54.6;46.1
91;2021-08-02;4947;4238;724863;612509;54.9;46.4
91;2021-08-03;6202;4698;731065;617207;55.4;46.8
91;2021-08-04;5701;4143;736766;621350;55.8;47.1
91;2021-08-05;5612;4272;742378;625622;56.3;47.4
91;2021-08-06;5711;5630;748089;631252;56.7;47.8
91;2021-08-07;3085;2420;751174;633672;56.9;48.0
91;2021-08-08;622;1103;751796;634775;57.0;48.1
91;2021-08-09;3905;3979;755701;638754;57.3;48.4
91;2021-08-10;4652;4555;760353;643309;57.6;48.8
91;2021-08-11;4151;4487;764504;647796;57.9;49.1
91;2021-08-12;4093;4787;768597;652583;58.3;49.5
91;2021-08-13;4303;4868;772900;657451;58.6;49.8
91;2021-08-14;2246;2403;775146;659854;58.7;50.0
91;2021-08-15;97;172;775243;660026;58.8;50.0
91;2021-08-16;3121;4665;778364;664691;59.0;50.4
91;2021-08-17;3655;5821;782019;670512;59.3;50.8
91;2021-08-18;3031;5800;785050;676312;59.5;51.3
91;2021-08-19;3482;5775;788532;682087;59.8;51.7
91;2021-08-20;3220;6958;791752;689045;60.0;52.2
91;2021-08-21;2464;3355;794216;692400;60.2;52.5
91;2021-08-22;738;1297;794954;693697;60.3;52.6
91;2021-08-23;2429;5310;797383;699007;60.4;53.0
91;2021-08-24;2988;6964;800371;705971;60.7;53.5
91;2021-08-25;3438;6725;803809;712696;60.9;54.0
91;2021-08-26;2749;5957;806558;718653;61.1;54.5
91;2021-08-27;2836;7504;809394;726157;61.3;55.0
91;2021-08-28;2390;4837;811784;730994;61.5;55.4
91;2021-08-29;1782;2800;813566;733794;61.7;55.6
91;2021-08-30;1805;5549;815371;739343;61.8;56.0
91;2021-08-31;2260;5916;817631;745259;62.0;56.5
91;2021-09-01;2828;4383;820459;749642;62.2;56.8
91;2021-09-02;2017;3568;822476;753210;62.3;57.1
91;2021-09-03;2212;4652;824688;757862;62.5;57.4
91;2021-09-04;2094;4095;826782;761957;62.7;57.8
91;2021-09-05;748;881;827530;762838;62.7;57.8
91;2021-09-06;1754;2992;829284;765830;62.9;58.0
91;2021-09-07;1582;2795;830866;768625;63.0;58.3
91;2021-09-08;1804;3085;832670;771710;63.1;58.5
91;2021-09-09;1348;2813;834018;774523;63.2;58.7
91;2021-09-10;1852;3555;835870;778078;63.4;59.0
91;2021-09-11;1756;4288;837626;782366;63.5;59.3
91;2021-09-12;627;945;838253;783311;63.5;59.4
91;2021-09-13;1326;2296;839579;785607;63.6;59.5
91;2021-09-14;1847;2661;841426;788268;63.8;59.7
91;2021-09-15;1686;3289;843112;791557;63.9;60.0
91;2021-09-16;1504;2386;844616;793943;64.0;60.2
91;2021-09-17;1448;3000;846064;796943;64.1;60.4
91;2021-09-18;1402;3669;847466;800612;64.2;60.7
91;2021-09-19;460;1149;847926;801761;64.3;60.8
91;2021-09-20;781;1600;848707;803361;64.3;60.9
91;2021-09-21;935;1752;849642;805113;64.4;61.0
91;2021-09-22;967;2648;850609;807761;64.5;61.2
91;2021-09-23;963;1737;851572;809498;64.5;61.4
91;2021-09-24;901;2203;852473;811701;64.6;61.5
91;2021-09-25;1057;3484;853530;815185;64.7;61.8
91;2021-09-26;217;821;853747;816006;64.7;61.8
91;2021-09-27;742;1573;854489;817579;64.8;62.0
91;2021-09-28;903;1448;855392;819027;64.8;62.1
91;2021-09-29;1015;2228;856407;821255;64.9;62.2
91;2021-09-30;662;1131;857069;822386;65.0;62.3
91;2021-10-01;972;1882;858041;824268;65.0;62.5
91;2021-10-02;1107;2394;859148;826662;65.1;62.7
91;2021-10-03;266;614;859414;827276;65.1;62.7
91;2021-10-04;620;1169;860034;828445;65.2;62.8
91;2021-10-05;593;1117;860627;829562;65.2;62.9
91;2021-10-06;785;1931;861412;831493;65.3;63.0
91;2021-10-07;580;1132;861992;832625;65.3;63.1
91;2021-10-08;787;1755;862779;834380;65.4;63.2
91;2021-10-09;1078;1998;863857;836378;65.5;63.4
91;2021-10-10;281;516;864138;836894;65.5;63.4
91;2021-10-11;583;1151;864721;838045;65.5;63.5
91;2021-10-12;530;1181;865251;839226;65.6;63.6
91;2021-10-13;809;1580;866060;840806;65.6;63.7
91;2021-10-14;490;1140;866550;841946;65.7;63.8
91;2021-10-15;906;1606;867456;843552;65.7;63.9
91;2021-10-16;929;1515;868385;845067;65.8;64.0
91;2021-10-17;221;307;868606;845374;65.8;64.1
91;2021-10-18;552;870;869158;846244;65.9;64.1
91;2021-10-19;504;1066;869662;847310;65.9;64.2
92;2020-12-27;50;5;50;5;0.0;0.0
92;2020-12-28;31;1;81;6;0.0;0.0
92;2020-12-29;67;2;148;8;0.0;0.0
92;2020-12-30;55;5;203;13;0.0;0.0
92;2020-12-31;15;1;218;14;0.0;0.0
92;2021-01-01;44;3;262;17;0.0;0.0
92;2021-01-02;17;0;279;17;0.0;0.0
92;2021-01-03;19;1;298;18;0.0;0.0
92;2021-01-04;82;5;380;23;0.0;0.0
92;2021-01-05;237;4;617;27;0.0;0.0
92;2021-01-06;421;4;1038;31;0.1;0.0
92;2021-01-07;675;9;1713;40;0.1;0.0
92;2021-01-08;852;4;2565;44;0.2;0.0
92;2021-01-09;131;6;2696;50;0.2;0.0
92;2021-01-10;54;2;2750;52;0.2;0.0
92;2021-01-11;853;12;3603;64;0.2;0.0
92;2021-01-12;1309;13;4912;77;0.3;0.0
92;2021-01-13;1254;17;6166;94;0.4;0.0
92;2021-01-14;1250;32;7416;126;0.5;0.0
92;2021-01-15;986;11;8402;137;0.5;0.0
92;2021-01-16;187;4;8589;141;0.5;0.0
92;2021-01-17;37;2;8626;143;0.5;0.0
92;2021-01-18;1558;34;10184;177;0.6;0.0
92;2021-01-19;1579;31;11763;208;0.7;0.0
92;2021-01-20;1827;20;13590;228;0.8;0.0
92;2021-01-21;3455;36;17045;264;1.1;0.0
92;2021-01-22;2632;47;19677;311;1.2;0.0
92;2021-01-23;154;9;19831;320;1.2;0.0
92;2021-01-24;36;3;19867;323;1.2;0.0
92;2021-01-25;863;20;20730;343;1.3;0.0
92;2021-01-26;1224;14;21954;357;1.4;0.0
92;2021-01-27;2228;109;24182;466;1.5;0.0
92;2021-01-28;4201;208;28383;674;1.8;0.0
92;2021-01-29;2723;268;31106;942;1.9;0.1
92;2021-01-30;327;18;31433;960;1.9;0.1
92;2021-01-31;36;6;31469;966;2.0;0.1
92;2021-02-01;880;324;32349;1290;2.0;0.1
92;2021-02-02;1074;355;33423;1645;2.1;0.1
92;2021-02-03;1007;447;34430;2092;2.1;0.1
92;2021-02-04;1057;548;35487;2640;2.2;0.2
92;2021-02-05;1337;503;36824;3143;2.3;0.2
92;2021-02-06;131;24;36955;3167;2.3;0.2
92;2021-02-07;24;19;36979;3186;2.3;0.2
92;2021-02-08;589;734;37568;3920;2.3;0.2
92;2021-02-09;1074;1305;38642;5225;2.4;0.3
92;2021-02-10;1097;1313;39739;6538;2.5;0.4
92;2021-02-11;1522;1941;41261;8479;2.6;0.5
92;2021-02-12;1428;1486;42689;9965;2.6;0.6
92;2021-02-13;80;68;42769;10033;2.7;0.6
92;2021-02-14;31;6;42800;10039;2.7;0.6
92;2021-02-15;586;1653;43386;11692;2.7;0.7
92;2021-02-16;794;2047;44180;13739;2.7;0.9
92;2021-02-17;630;1760;44810;15499;2.8;1.0
92;2021-02-18;1584;3654;46394;19153;2.9;1.2
92;2021-02-19;1738;2665;48132;21818;3.0;1.4
92;2021-02-20;150;400;48282;22218;3.0;1.4
92;2021-02-21;51;55;48333;22273;3.0;1.4
92;2021-02-22;508;1215;48841;23488;3.0;1.5
92;2021-02-23;747;1364;49588;24852;3.1;1.5
92;2021-02-24;620;1291;50208;26143;3.1;1.6
92;2021-02-25;938;1798;51146;27941;3.2;1.7
92;2021-02-26;1469;1372;52615;29313;3.3;1.8
92;2021-02-27;507;190;53122;29503;3.3;1.8
92;2021-02-28;75;58;53197;29561;3.3;1.8
92;2021-03-01;1108;1058;54305;30619;3.4;1.9
92;2021-03-02;1992;1384;56297;32003;3.5;2.0
92;2021-03-03;2815;1110;59112;33113;3.7;2.1
92;2021-03-04;3608;1542;62720;34655;3.9;2.1
92;2021-03-05;4990;1746;67710;36401;4.2;2.3
92;2021-03-06;5729;351;73439;36752;4.6;2.3
92;2021-03-07;2910;245;76349;36997;4.7;2.3
92;2021-03-08;2430;833;78779;37830;4.9;2.3
92;2021-03-09;3449;1049;82228;38879;5.1;2.4
92;2021-03-10;3957;972;86185;39851;5.3;2.5
92;2021-03-11;5030;1430;91215;41281;5.7;2.6
92;2021-03-12;6781;1590;97996;42871;6.1;2.7
92;2021-03-13;5165;257;103161;43128;6.4;2.7
92;2021-03-14;1747;81;104908;43209;6.5;2.7
92;2021-03-15;3812;623;108720;43832;6.7;2.7
92;2021-03-16;3704;615;112424;44447;7.0;2.8
92;2021-03-17;3884;441;116308;44888;7.2;2.8
92;2021-03-18;4152;769;120460;45657;7.5;2.8
92;2021-03-19;5937;764;126397;46421;7.8;2.9
92;2021-03-20;2544;84;128941;46505;8.0;2.9
92;2021-03-21;156;33;129097;46538;8.0;2.9
92;2021-03-22;4121;495;133218;47033;8.3;2.9
92;2021-03-23;6114;896;139332;47929;8.6;3.0
92;2021-03-24;6387;677;145719;48606;9.0;3.0
92;2021-03-25;8447;678;154166;49284;9.6;3.1
92;2021-03-26;8364;915;162530;50199;10.1;3.1
92;2021-03-27;2839;286;165369;50485;10.2;3.1
92;2021-03-28;544;40;165913;50525;10.3;3.1
92;2021-03-29;4673;1076;170586;51601;10.6;3.2
92;2021-03-30;6398;1574;176984;53175;11.0;3.3
92;2021-03-31;5556;2278;182540;55453;11.3;3.4
92;2021-04-01;6281;3701;188821;59154;11.7;3.7
92;2021-04-02;5642;3452;194463;62606;12.1;3.9
92;2021-04-03;878;1425;195341;64031;12.1;4.0
92;2021-04-04;493;1065;195834;65096;12.1;4.0
92;2021-04-05;822;163;196656;65259;12.2;4.0
92;2021-04-06;3668;1975;200324;67234;12.4;4.2
92;2021-04-07;5005;2899;205329;70133;12.7;4.3
92;2021-04-08;5994;3206;211323;73339;13.1;4.5
92;2021-04-09;8039;3091;219362;76430;13.6;4.7
92;2021-04-10;2648;1307;222010;77737;13.8;4.8
92;2021-04-11;171;810;222181;78547;13.8;4.9
92;2021-04-12;3691;2530;225872;81077;14.0;5.0
92;2021-04-13;4390;4444;230262;85521;14.3;5.3
92;2021-04-14;4878;4053;235140;89574;14.6;5.6
92;2021-04-15;5305;3967;240445;93541;14.9;5.8
92;2021-04-16;5082;3876;245527;97417;15.2;6.0
92;2021-04-17;1809;1199;247336;98616;15.3;6.1
92;2021-04-18;352;97;247688;98713;15.3;6.1
92;2021-04-19;2823;2848;250511;101561;15.5;6.3
92;2021-04-20;4200;3764;254711;105325;15.8;6.5
92;2021-04-21;4622;4527;259333;109852;16.1;6.8
92;2021-04-22;4664;5135;263997;114987;16.4;7.1
92;2021-04-23;5267;4742;269264;119729;16.7;7.4
92;2021-04-24;4948;1919;274212;121648;17.0;7.5
92;2021-04-25;1798;153;276010;121801;17.1;7.5
92;2021-04-26;4006;3630;280016;125431;17.4;7.8
92;2021-04-27;6047;5277;286063;130708;17.7;8.1
92;2021-04-28;7385;4519;293448;135227;18.2;8.4
92;2021-04-29;7994;4806;301442;140033;18.7;8.7
92;2021-04-30;8845;4864;310287;144897;19.2;9.0
92;2021-05-01;1203;413;311490;145310;19.3;9.0
92;2021-05-02;670;141;312160;145451;19.3;9.0
92;2021-05-03;6791;3896;318951;149347;19.8;9.3
92;2021-05-04;10435;4382;329386;153729;20.4;9.5
92;2021-05-05;10078;5260;339464;158989;21.0;9.9
92;2021-05-06;11428;4912;350892;163901;21.7;10.2
92;2021-05-07;9867;5310;360759;169211;22.4;10.5
92;2021-05-08;7215;1926;367974;171137;22.8;10.6
92;2021-05-09;3788;602;371762;171739;23.0;10.6
92;2021-05-10;9547;4008;381309;175747;23.6;10.9
92;2021-05-11;13981;5699;395290;181446;24.5;11.2
92;2021-05-12;14288;4586;409578;186032;25.4;11.5
92;2021-05-13;9168;912;418746;186944;25.9;11.6
92;2021-05-14;12032;2313;430778;189257;26.7;11.7
92;2021-05-15;8396;1232;439174;190489;27.2;11.8
92;2021-05-16;4144;453;443318;190942;27.5;11.8
92;2021-05-17;10651;2215;453969;193157;28.1;12.0
92;2021-05-18;16411;3122;470380;196279;29.1;12.2
92;2021-05-19;16050;3720;486430;199999;30.1;12.4
92;2021-05-20;16842;3986;503272;203985;31.2;12.6
92;2021-05-21;14070;3623;517342;207608;32.1;12.9
92;2021-05-22;8317;1515;525659;209123;32.6;13.0
92;2021-05-23;4083;454;529742;209577;32.8;13.0
92;2021-05-24;6127;858;535869;210435;33.2;13.0
92;2021-05-25;13114;4566;548983;215001;34.0;13.3
92;2021-05-26;11927;5039;560910;220040;34.8;13.6
92;2021-05-27;12737;6328;573647;226368;35.5;14.0
92;2021-05-28;11234;6291;584881;232659;36.2;14.4
92;2021-05-29;5453;2304;590334;234963;36.6;14.6
92;2021-05-30;2252;389;592586;235352;36.7;14.6
92;2021-05-31;12050;5300;604636;240652;37.5;14.9
92;2021-06-01;12643;7641;617279;248293;38.3;15.4
92;2021-06-02;14385;7209;631664;255502;39.1;15.8
92;2021-06-03;14600;8034;646264;263536;40.0;16.3
92;2021-06-04;12237;8224;658501;271760;40.8;16.8
92;2021-06-05;7385;6232;665886;277992;41.3;17.2
92;2021-06-06;3598;1676;669484;279668;41.5;17.3
92;2021-06-07;11435;7637;680919;287305;42.2;17.8
92;2021-06-08;12767;9605;693686;296910;43.0;18.4
92;2021-06-09;11662;9473;705348;306383;43.7;19.0
92;2021-06-10;11971;10570;717319;316953;44.5;19.6
92;2021-06-11;8158;11037;725477;327990;45.0;20.3
92;2021-06-12;6364;5092;731841;333082;45.3;20.6
92;2021-06-13;3970;2720;735811;335802;45.6;20.8
92;2021-06-14;5213;11171;741024;346973;45.9;21.5
92;2021-06-15;6540;13129;747564;360102;46.3;22.3
92;2021-06-16;6955;12994;754519;373096;46.8;23.1
92;2021-06-17;7429;14003;761948;387099;47.2;24.0
92;2021-06-18;6908;14387;768856;401486;47.6;24.9
92;2021-06-19;3972;9107;772828;410593;47.9;25.4
92;2021-06-20;1969;5606;774797;416199;48.0;25.8
92;2021-06-21;4843;12275;779640;428474;48.3;26.6
92;2021-06-22;5883;17544;785523;446018;48.7;27.6
92;2021-06-23;5490;15991;791013;462009;49.0;28.6
92;2021-06-24;6211;15120;797224;477129;49.4;29.6
92;2021-06-25;5121;16097;802345;493226;49.7;30.6
92;2021-06-26;4072;10455;806417;503681;50.0;31.2
92;2021-06-27;1858;6046;808275;509727;50.1;31.6
92;2021-06-28;3675;12047;811950;521774;50.3;32.3
92;2021-06-29;4685;18166;816635;539940;50.6;33.5
92;2021-06-30;4458;16226;821093;556166;50.9;34.5
92;2021-07-01;5525;16307;826618;572473;51.2;35.5
92;2021-07-02;4944;15288;831562;587761;51.5;36.4
92;2021-07-03;3312;10186;834874;597947;51.7;37.1
92;2021-07-04;1125;4208;835999;602155;51.8;37.3
92;2021-07-05;4825;12334;840824;614489;52.1;38.1
92;2021-07-06;5289;15813;846113;630302;52.4;39.1
92;2021-07-07;4270;11463;850383;641765;52.7;39.8
92;2021-07-08;5412;14639;855795;656404;53.0;40.7
92;2021-07-09;5900;14205;861695;670609;53.4;41.6
92;2021-07-10;4378;8459;866073;679068;53.7;42.1
92;2021-07-11;1487;2618;867560;681686;53.8;42.2
92;2021-07-12;4421;14644;871981;696330;54.0;43.1
92;2021-07-13;7882;17459;879863;713789;54.5;44.2
92;2021-07-14;5115;5747;884978;719536;54.8;44.6
92;2021-07-15;9570;16257;894548;735793;55.4;45.6
92;2021-07-16;9066;14190;903614;749983;56.0;46.5
92;2021-07-17;6586;7605;910200;757588;56.4;46.9
92;2021-07-18;1842;2482;912042;760070;56.5;47.1
92;2021-07-19;6481;13205;918523;773275;56.9;47.9
92;2021-07-20;10095;14116;928618;787391;57.5;48.8
92;2021-07-21;10474;12126;939092;799517;58.2;49.5
92;2021-07-22;12061;12998;951153;812515;58.9;50.3
92;2021-07-23;11594;11364;962747;823879;59.7;51.1
92;2021-07-24;6741;6272;969488;830151;60.1;51.4
92;2021-07-25;2778;2332;972266;832483;60.2;51.6
92;2021-07-26;9492;9178;981758;841661;60.8;52.2
92;2021-07-27;11526;9624;993284;851285;61.6;52.8
92;2021-07-28;12950;8209;1006234;859494;62.4;53.3
92;2021-07-29;10457;8640;1016691;868134;63.0;53.8
92;2021-07-30;9129;8359;1025820;876493;63.6;54.3
92;2021-07-31;5704;4825;1031524;881318;63.9;54.6
92;2021-08-01;2220;1301;1033744;882619;64.1;54.7
92;2021-08-02;4801;4939;1038545;887558;64.4;55.0
92;2021-08-03;5156;6150;1043701;893708;64.7;55.4
92;2021-08-04;4782;4876;1048483;898584;65.0;55.7
92;2021-08-05;4534;5694;1053017;904278;65.3;56.0
92;2021-08-06;4554;5974;1057571;910252;65.5;56.4
92;2021-08-07;2843;4184;1060414;914436;65.7;56.7
92;2021-08-08;964;1083;1061378;915519;65.8;56.7
92;2021-08-09;3214;4255;1064592;919774;66.0;57.0
92;2021-08-10;3842;5612;1068434;925386;66.2;57.3
92;2021-08-11;3241;4435;1071675;929821;66.4;57.6
92;2021-08-12;3398;5602;1075073;935423;66.6;58.0
92;2021-08-13;3004;5148;1078077;940571;66.8;58.3
92;2021-08-14;1890;3931;1079967;944502;66.9;58.5
92;2021-08-15;597;840;1080564;945342;67.0;58.6
92;2021-08-16;2412;5325;1082976;950667;67.1;58.9
92;2021-08-17;2638;6993;1085614;957660;67.3;59.3
92;2021-08-18;2432;5256;1088046;962916;67.4;59.7
92;2021-08-19;2533;5746;1090579;968662;67.6;60.0
92;2021-08-20;2302;5198;1092881;973860;67.7;60.3
92;2021-08-21;1399;4225;1094280;978085;67.8;60.6
92;2021-08-22;427;1599;1094707;979684;67.8;60.7
92;2021-08-23;2498;6602;1097205;986286;68.0;61.1
92;2021-08-24;3159;8351;1100364;994637;68.2;61.6
92;2021-08-25;2868;7586;1103232;1002223;68.4;62.1
92;2021-08-26;3024;7579;1106256;1009802;68.6;62.6
92;2021-08-27;3112;7017;1109368;1016819;68.7;63.0
92;2021-08-28;1628;4516;1110996;1021335;68.8;63.3
92;2021-08-29;346;789;1111342;1022124;68.9;63.3
92;2021-08-30;2265;4706;1113607;1026830;69.0;63.6
92;2021-08-31;3103;6630;1116710;1033460;69.2;64.0
92;2021-09-01;3392;6892;1120102;1040352;69.4;64.5
92;2021-09-02;2682;6052;1122784;1046404;69.6;64.8
92;2021-09-03;2718;5788;1125502;1052192;69.7;65.2
92;2021-09-04;2404;4777;1127906;1056969;69.9;65.5
92;2021-09-05;447;923;1128353;1057892;69.9;65.6
92;2021-09-06;1349;2990;1129702;1060882;70.0;65.7
92;2021-09-07;1739;3330;1131441;1064212;70.1;65.9
92;2021-09-08;2194;3619;1133635;1067831;70.2;66.2
92;2021-09-09;1262;2618;1134897;1070449;70.3;66.3
92;2021-09-10;1830;3390;1136727;1073839;70.4;66.5
92;2021-09-11;1631;2716;1138358;1076555;70.5;66.7
92;2021-09-12;215;435;1138573;1076990;70.6;66.7
92;2021-09-13;1132;2226;1139705;1079216;70.6;66.9
92;2021-09-14;1243;2406;1140948;1081622;70.7;67.0
92;2021-09-15;1602;3633;1142550;1085255;70.8;67.3
92;2021-09-16;1112;2170;1143662;1087425;70.9;67.4
92;2021-09-17;1450;3102;1145112;1090527;71.0;67.6
92;2021-09-18;1067;2239;1146179;1092766;71.0;67.7
92;2021-09-19;131;290;1146310;1093056;71.0;67.7
92;2021-09-20;787;1833;1147097;1094889;71.1;67.8
92;2021-09-21;827;1873;1147924;1096762;71.1;68.0
92;2021-09-22;1087;3819;1149011;1100581;71.2;68.2
92;2021-09-23;739;1826;1149750;1102407;71.2;68.3
92;2021-09-24;1107;2857;1150857;1105264;71.3;68.5
92;2021-09-25;675;2212;1151532;1107476;71.4;68.6
92;2021-09-26;95;249;1151627;1107725;71.4;68.6
92;2021-09-27;783;1634;1152410;1109359;71.4;68.7
92;2021-09-28;794;1575;1153204;1110934;71.5;68.8
92;2021-09-29;1136;2838;1154340;1113772;71.5;69.0
92;2021-09-30;855;1334;1155195;1115106;71.6;69.1
92;2021-10-01;1130;2101;1156325;1117207;71.7;69.2
92;2021-10-02;801;1810;1157126;1119017;71.7;69.3
92;2021-10-03;89;205;1157215;1119222;71.7;69.4
92;2021-10-04;710;1319;1157925;1120541;71.8;69.4
92;2021-10-05;731;1319;1158656;1121860;71.8;69.5
92;2021-10-06;1061;1992;1159717;1123852;71.9;69.6
92;2021-10-07;544;936;1160261;1124788;71.9;69.7
92;2021-10-08;1113;1865;1161374;1126653;72.0;69.8
92;2021-10-09;708;1366;1162082;1128019;72.0;69.9
92;2021-10-10;104;128;1162186;1128147;72.0;69.9
92;2021-10-11;662;979;1162848;1129126;72.1;70.0
92;2021-10-12;824;1159;1163672;1130285;72.1;70.0
92;2021-10-13;1000;1530;1164672;1131815;72.2;70.1
92;2021-10-14;628;871;1165300;1132686;72.2;70.2
92;2021-10-15;932;1587;1166232;1134273;72.3;70.3
92;2021-10-16;700;1083;1166932;1135356;72.3;70.4
92;2021-10-17;75;90;1167007;1135446;72.3;70.4
92;2021-10-18;568;814;1167575;1136260;72.4;70.4
92;2021-10-19;718;1060;1168293;1137320;72.4;70.5
93;2020-12-27;12;3;12;3;0.0;0.0
93;2020-12-28;6;2;18;5;0.0;0.0
93;2020-12-29;2;0;20;5;0.0;0.0
93;2020-12-30;44;1;64;6;0.0;0.0
93;2020-12-31;11;0;75;6;0.0;0.0
93;2021-01-01;5;0;80;6;0.0;0.0
93;2021-01-02;1;0;81;6;0.0;0.0
93;2021-01-03;4;0;85;6;0.0;0.0
93;2021-01-04;5;1;90;7;0.0;0.0
93;2021-01-05;67;3;157;10;0.0;0.0
93;2021-01-06;179;0;336;10;0.0;0.0
93;2021-01-07;381;3;717;13;0.0;0.0
93;2021-01-08;634;2;1351;15;0.1;0.0
93;2021-01-09;21;0;1372;15;0.1;0.0
93;2021-01-10;3;0;1375;15;0.1;0.0
93;2021-01-11;505;5;1880;20;0.1;0.0
93;2021-01-12;753;7;2633;27;0.2;0.0
93;2021-01-13;752;8;3385;35;0.2;0.0
93;2021-01-14;690;18;4075;53;0.2;0.0
93;2021-01-15;515;4;4590;57;0.3;0.0
93;2021-01-16;138;3;4728;60;0.3;0.0
93;2021-01-17;6;1;4734;61;0.3;0.0
93;2021-01-18;1197;13;5931;74;0.4;0.0
93;2021-01-19;1614;20;7545;94;0.5;0.0
93;2021-01-20;1557;20;9102;114;0.5;0.0
93;2021-01-21;1922;38;11024;152;0.7;0.0
93;2021-01-22;1391;18;12415;170;0.7;0.0
93;2021-01-23;713;8;13128;178;0.8;0.0
93;2021-01-24;0;0;13128;178;0.8;0.0
93;2021-01-25;1209;14;14337;192;0.9;0.0
93;2021-01-26;1298;35;15635;227;0.9;0.0
93;2021-01-27;2158;76;17793;303;1.1;0.0
93;2021-01-28;2268;214;20061;517;1.2;0.0
93;2021-01-29;1625;233;21686;750;1.3;0.0
93;2021-01-30;928;48;22614;798;1.4;0.0
93;2021-01-31;11;8;22625;806;1.4;0.0
93;2021-02-01;1186;175;23811;981;1.4;0.1
93;2021-02-02;1175;306;24986;1287;1.5;0.1
93;2021-02-03;1231;398;26217;1685;1.6;0.1
93;2021-02-04;926;566;27143;2251;1.6;0.1
93;2021-02-05;800;433;27943;2684;1.7;0.2
93;2021-02-06;694;73;28637;2757;1.7;0.2
93;2021-02-07;6;0;28643;2757;1.7;0.2
93;2021-02-08;915;645;29558;3402;1.8;0.2
93;2021-02-09;854;603;30412;4005;1.8;0.2
93;2021-02-10;883;677;31295;4682;1.9;0.3
93;2021-02-11;1244;839;32539;5521;1.9;0.3
93;2021-02-12;1042;642;33581;6163;2.0;0.4
93;2021-02-13;395;267;33976;6430;2.0;0.4
93;2021-02-14;13;59;33989;6489;2.0;0.4
93;2021-02-15;414;1261;34403;7750;2.1;0.5
93;2021-02-16;552;1232;34955;8982;2.1;0.5
93;2021-02-17;541;1751;35496;10733;2.1;0.6
93;2021-02-18;1136;1869;36632;12602;2.2;0.8
93;2021-02-19;994;1542;37626;14144;2.3;0.8
93;2021-02-20;306;665;37932;14809;2.3;0.9
93;2021-02-21;10;24;37942;14833;2.3;0.9
93;2021-02-22;602;1288;38544;16121;2.3;1.0
93;2021-02-23;560;1122;39104;17243;2.3;1.0
93;2021-02-24;646;1217;39750;18460;2.4;1.1
93;2021-02-25;902;1075;40652;19535;2.4;1.2
93;2021-02-26;1120;980;41772;20515;2.5;1.2
93;2021-02-27;543;623;42315;21138;2.5;1.3
93;2021-02-28;88;57;42403;21195;2.5;1.3
93;2021-03-01;1082;1073;43485;22268;2.6;1.3
93;2021-03-02;1448;1152;44933;23420;2.7;1.4
93;2021-03-03;1749;1198;46682;24618;2.8;1.5
93;2021-03-04;2720;1146;49402;25764;3.0;1.5
93;2021-03-05;3820;921;53222;26685;3.2;1.6
93;2021-03-06;5051;593;58273;27278;3.5;1.6
93;2021-03-07;4300;253;62573;27531;3.7;1.6
93;2021-03-08;2037;1277;64610;28808;3.9;1.7
93;2021-03-09;2916;983;67526;29791;4.0;1.8
93;2021-03-10;2862;1131;70388;30922;4.2;1.9
93;2021-03-11;3574;1285;73962;32207;4.4;1.9
93;2021-03-12;4124;1322;78086;33529;4.7;2.0
93;2021-03-13;4291;654;82377;34183;4.9;2.0
93;2021-03-14;884;80;83261;34263;5.0;2.1
93;2021-03-15;3554;702;86815;34965;5.2;2.1
93;2021-03-16;3157;628;89972;35593;5.4;2.1
93;2021-03-17;2656;608;92628;36201;5.5;2.2
93;2021-03-18;3320;740;95948;36941;5.7;2.2
93;2021-03-19;3773;668;99721;37609;6.0;2.3
93;2021-03-20;3460;310;103181;37919;6.2;2.3
93;2021-03-21;814;273;103995;38192;6.2;2.3
93;2021-03-22;3854;636;107849;38828;6.5;2.3
93;2021-03-23;4766;827;112615;39655;6.7;2.4
93;2021-03-24;4115;704;116730;40359;7.0;2.4
93;2021-03-25;5587;883;122317;41242;7.3;2.5
93;2021-03-26;5548;913;127865;42155;7.7;2.5
93;2021-03-27;4283;329;132148;42484;7.9;2.5
93;2021-03-28;613;44;132761;42528;7.9;2.5
93;2021-03-29;3851;978;136612;43506;8.2;2.6
93;2021-03-30;4727;1283;141339;44789;8.5;2.7
93;2021-03-31;3914;1268;145253;46057;8.7;2.8
93;2021-04-01;4053;3158;149306;49215;8.9;2.9
93;2021-04-02;3224;3572;152530;52787;9.1;3.2
93;2021-04-03;2518;2273;155048;55060;9.3;3.3
93;2021-04-04;765;166;155813;55226;9.3;3.3
93;2021-04-05;708;92;156521;55318;9.4;3.3
93;2021-04-06;4564;2370;161085;57688;9.6;3.5
93;2021-04-07;4906;2112;165991;59800;9.9;3.6
93;2021-04-08;5816;2704;171807;62504;10.3;3.7
93;2021-04-09;6097;3212;177904;65716;10.7;3.9
93;2021-04-10;4201;2499;182105;68215;10.9;4.1
93;2021-04-11;575;437;182680;68652;10.9;4.1
93;2021-04-12;4101;2929;186781;71581;11.2;4.3
93;2021-04-13;4606;3673;191387;75254;11.5;4.5
93;2021-04-14;4367;2493;195754;77747;11.7;4.7
93;2021-04-15;4560;3052;200314;80799;12.0;4.8
93;2021-04-16;4442;3008;204756;83807;12.3;5.0
93;2021-04-17;3517;2508;208273;86315;12.5;5.2
93;2021-04-18;289;435;208562;86750;12.5;5.2
93;2021-04-19;3776;2879;212338;89629;12.7;5.4
93;2021-04-20;4309;3284;216647;92913;13.0;5.6
93;2021-04-21;4146;2786;220793;95699;13.2;5.7
93;2021-04-22;4514;4033;225307;99732;13.5;6.0
93;2021-04-23;5628;3266;230935;102998;13.8;6.2
93;2021-04-24;5922;3339;236857;106337;14.2;6.4
93;2021-04-25;1733;598;238590;106935;14.3;6.4
93;2021-04-26;4864;3100;243454;110035;14.6;6.6
93;2021-04-27;6454;3637;249908;113672;15.0;6.8
93;2021-04-28;6071;3444;255979;117116;15.3;7.0
93;2021-04-29;7299;3258;263278;120374;15.8;7.2
93;2021-04-30;8267;3139;271545;123513;16.3;7.4
93;2021-05-01;4948;1199;276493;124712;16.6;7.5
93;2021-05-02;419;649;276912;125361;16.6;7.5
93;2021-05-03;8174;5135;285086;130496;17.1;7.8
93;2021-05-04;7824;5413;292910;135909;17.5;8.1
93;2021-05-05;7579;4818;300489;140727;18.0;8.4
93;2021-05-06;8252;4792;308741;145519;18.5;8.7
93;2021-05-07;7018;5439;315759;150958;18.9;9.0
93;2021-05-08;8365;2399;324124;153357;19.4;9.2
93;2021-05-09;6124;1372;330248;154729;19.8;9.3
93;2021-05-10;8259;4085;338507;158814;20.3;9.5
93;2021-05-11;9309;4815;347816;163629;20.8;9.8
93;2021-05-12;9194;3661;357010;167290;21.4;10.0
93;2021-05-13;8302;1654;365312;168944;21.9;10.1
93;2021-05-14;10420;3533;375732;172477;22.5;10.3
93;2021-05-15;11126;3013;386858;175490;23.2;10.5
93;2021-05-16;5558;729;392416;176219;23.5;10.6
93;2021-05-17;11904;2272;404320;178491;24.2;10.7
93;2021-05-18;14099;2387;418419;180878;25.1;10.8
93;2021-05-19;11433;2946;429852;183824;25.7;11.0
93;2021-05-20;12624;3486;442476;187310;26.5;11.2
93;2021-05-21;13013;2886;455489;190196;27.3;11.4
93;2021-05-22;12376;2202;467865;192398;28.0;11.5
93;2021-05-23;8479;1109;476344;193507;28.5;11.6
93;2021-05-24;11210;1945;487554;195452;29.2;11.7
93;2021-05-25;12292;4322;499846;199774;29.9;12.0
93;2021-05-26;11078;3759;510924;203533;30.6;12.2
93;2021-05-27;12708;3897;523632;207430;31.4;12.4
93;2021-05-28;12653;5258;536285;212688;32.1;12.7
93;2021-05-29;11395;4269;547680;216957;32.8;13.0
93;2021-05-30;8209;1380;555889;218337;33.3;13.1
93;2021-05-31;9180;5178;565069;223515;33.8;13.4
93;2021-06-01;11410;6280;576479;229795;34.5;13.8
93;2021-06-02;10723;5199;587202;234994;35.2;14.1
93;2021-06-03;10821;5519;598023;240513;35.8;14.4
93;2021-06-04;10599;7800;608622;248313;36.4;14.9
93;2021-06-05;9021;7359;617643;255672;37.0;15.3
93;2021-06-06;8407;1746;626050;257418;37.5;15.4
93;2021-06-07;10072;7517;636122;264935;38.1;15.9
93;2021-06-08;10368;7379;646490;272314;38.7;16.3
93;2021-06-09;10245;7296;656735;279610;39.3;16.7
93;2021-06-10;9010;8199;665745;287809;39.9;17.2
93;2021-06-11;8823;8821;674568;296630;40.4;17.8
93;2021-06-12;9862;6664;684430;303294;41.0;18.2
93;2021-06-13;7169;2132;691599;305426;41.4;18.3
93;2021-06-14;5400;9734;696999;315160;41.7;18.9
93;2021-06-15;6244;9665;703243;324825;42.1;19.4
93;2021-06-16;6650;9061;709893;333886;42.5;20.0
93;2021-06-17;5759;8474;715652;342360;42.8;20.5
93;2021-06-18;7227;11124;722879;353484;43.3;21.2
93;2021-06-19;7075;11102;729954;364586;43.7;21.8
93;2021-06-20;4944;6877;734898;371463;44.0;22.2
93;2021-06-21;4071;10730;738969;382193;44.2;22.9
93;2021-06-22;4695;11314;743664;393507;44.5;23.6
93;2021-06-23;4541;10600;748205;404107;44.8;24.2
93;2021-06-24;4199;10298;752404;414405;45.1;24.8
93;2021-06-25;5187;13049;757591;427454;45.4;25.6
93;2021-06-26;5301;13928;762892;441382;45.7;26.4
93;2021-06-27;3285;7104;766177;448486;45.9;26.9
93;2021-06-28;3703;12508;769880;460994;46.1;27.6
93;2021-06-29;4016;12354;773896;473348;46.3;28.3
93;2021-06-30;4146;11305;778042;484653;46.6;29.0
93;2021-07-01;6092;11162;784134;495815;46.9;29.7
93;2021-07-02;5810;12382;789944;508197;47.3;30.4
93;2021-07-03;5550;13464;795494;521661;47.6;31.2
93;2021-07-04;3078;7886;798572;529547;47.8;31.7
93;2021-07-05;4597;10848;803169;540395;48.1;32.4
93;2021-07-06;4865;11762;808034;552157;48.4;33.1
93;2021-07-07;5236;11417;813270;563574;48.7;33.7
93;2021-07-08;5069;10273;818339;573847;49.0;34.4
93;2021-07-09;5953;13036;824292;586883;49.4;35.1
93;2021-07-10;5921;14293;830213;601176;49.7;36.0
93;2021-07-11;3688;9093;833901;610269;49.9;36.5
93;2021-07-12;5608;12081;839509;622350;50.3;37.3
93;2021-07-13;11149;13316;850658;635666;50.9;38.1
93;2021-07-14;10677;6808;861335;642474;51.6;38.5
93;2021-07-15;12561;14144;873896;656618;52.3;39.3
93;2021-07-16;13244;13698;887140;670316;53.1;40.1
93;2021-07-17;11420;13919;898560;684235;53.8;41.0
93;2021-07-18;7401;8960;905961;693195;54.2;41.5
93;2021-07-19;9640;10931;915601;704126;54.8;42.2
93;2021-07-20;12671;10695;928272;714821;55.6;42.8
93;2021-07-21;14410;10960;942682;725781;56.4;43.5
93;2021-07-22;14183;9484;956865;735265;57.3;44.0
93;2021-07-23;14625;10666;971490;745931;58.2;44.7
93;2021-07-24;13926;10658;985416;756589;59.0;45.3
93;2021-07-25;9036;6364;994452;762953;59.5;45.7
93;2021-07-26;12797;7801;1007249;770754;60.3;46.1
93;2021-07-27;15191;7469;1022440;778223;61.2;46.6
93;2021-07-28;15034;8312;1037474;786535;62.1;47.1
93;2021-07-29;13606;7083;1051080;793618;62.9;47.5
93;2021-07-30;14191;7880;1065271;801498;63.8;48.0
93;2021-07-31;12254;7724;1077525;809222;64.5;48.5
93;2021-08-01;7976;4615;1085501;813837;65.0;48.7
93;2021-08-02;14005;5793;1099506;819630;65.8;49.1
93;2021-08-03;8435;6873;1107941;826503;66.3;49.5
93;2021-08-04;8179;8010;1116120;834513;66.8;50.0
93;2021-08-05;6314;6865;1122434;841378;67.2;50.4
93;2021-08-06;7381;8340;1129815;849718;67.6;50.9
93;2021-08-07;7501;9058;1137316;858776;68.1;51.4
93;2021-08-08;4681;5561;1141997;864337;68.4;51.8
93;2021-08-09;7635;8091;1149632;872428;68.8;52.2
93;2021-08-10;7538;8855;1157170;881283;69.3;52.8
93;2021-08-11;7721;9697;1164891;890980;69.7;53.3
93;2021-08-12;6746;9047;1171637;900027;70.2;53.9
93;2021-08-13;6849;9034;1178486;909061;70.6;54.4
93;2021-08-14;7396;10509;1185882;919570;71.0;55.1
93;2021-08-15;3185;3634;1189067;923204;71.2;55.3
93;2021-08-16;6590;11222;1195657;934426;71.6;55.9
93;2021-08-17;6396;10919;1202053;945345;72.0;56.6
93;2021-08-18;5783;11216;1207836;956561;72.3;57.3
93;2021-08-19;5035;9674;1212871;966235;72.6;57.9
93;2021-08-20;5348;11234;1218219;977469;72.9;58.5
93;2021-08-21;4559;11947;1222778;989416;73.2;59.2
93;2021-08-22;2264;7051;1225042;996467;73.3;59.7
93;2021-08-23;4600;9336;1229642;1005803;73.6;60.2
93;2021-08-24;4550;8437;1234192;1014240;73.9;60.7
93;2021-08-25;4318;8612;1238510;1022852;74.2;61.2
93;2021-08-26;3787;7109;1242297;1029961;74.4;61.7
93;2021-08-27;4140;8555;1246437;1038516;74.6;62.2
93;2021-08-28;3994;9593;1250431;1048109;74.9;62.8
93;2021-08-29;1823;4807;1252254;1052916;75.0;63.0
93;2021-08-30;3230;7543;1255484;1060459;75.2;63.5
93;2021-08-31;3129;7659;1258613;1068118;75.4;64.0
93;2021-09-01;5582;7512;1264195;1075630;75.7;64.4
93;2021-09-02;4781;5790;1268976;1081420;76.0;64.7
93;2021-09-03;3048;7051;1272024;1088471;76.2;65.2
93;2021-09-04;3514;8777;1275538;1097248;76.4;65.7
93;2021-09-05;1309;3623;1276847;1100871;76.5;65.9
93;2021-09-06;2085;5085;1278932;1105956;76.6;66.2
93;2021-09-07;2034;4641;1280966;1110597;76.7;66.5
93;2021-09-08;2376;5346;1283342;1115943;76.8;66.8
93;2021-09-09;2110;4609;1285452;1120552;77.0;67.1
93;2021-09-10;3079;5451;1288531;1126003;77.2;67.4
93;2021-09-11;2560;6873;1291091;1132876;77.3;67.8
93;2021-09-12;882;2822;1291973;1135698;77.4;68.0
93;2021-09-13;2670;4544;1294643;1140242;77.5;68.3
93;2021-09-14;1973;4056;1296616;1144298;77.6;68.5
93;2021-09-15;2032;4286;1298648;1148584;77.8;68.8
93;2021-09-16;1660;3048;1300308;1151632;77.9;69.0
93;2021-09-17;2042;4563;1302350;1156195;78.0;69.2
93;2021-09-18;1755;5572;1304105;1161767;78.1;69.6
93;2021-09-19;542;2105;1304647;1163872;78.1;69.7
93;2021-09-20;1399;2940;1306046;1166812;78.2;69.9
93;2021-09-21;1051;2496;1307097;1169308;78.3;70.0
93;2021-09-22;1560;3934;1308657;1173242;78.4;70.2
93;2021-09-23;1074;2436;1309731;1175678;78.4;70.4
93;2021-09-24;1377;3442;1311108;1179120;78.5;70.6
93;2021-09-25;1127;4526;1312235;1183646;78.6;70.9
93;2021-09-26;436;1681;1312671;1185327;78.6;71.0
93;2021-09-27;921;2230;1313592;1187557;78.7;71.1
93;2021-09-28;876;2034;1314468;1189591;78.7;71.2
93;2021-09-29;1237;3256;1315705;1192847;78.8;71.4
93;2021-09-30;924;2372;1316629;1195219;78.8;71.6
93;2021-10-01;1163;2761;1317792;1197980;78.9;71.7
93;2021-10-02;1162;2794;1318954;1200774;79.0;71.9
93;2021-10-03;302;832;1319256;1201606;79.0;71.9
93;2021-10-04;900;2210;1320156;1203816;79.0;72.1
93;2021-10-05;777;2063;1320933;1205879;79.1;72.2
93;2021-10-06;1067;2356;1322000;1208235;79.2;72.3
93;2021-10-07;895;2383;1322895;1210618;79.2;72.5
93;2021-10-08;1088;2602;1323983;1213220;79.3;72.6
93;2021-10-09;1339;2821;1325322;1216041;79.4;72.8
93;2021-10-10;316;991;1325638;1217032;79.4;72.9
93;2021-10-11;736;2003;1326374;1219035;79.4;73.0
93;2021-10-12;703;2013;1327077;1221048;79.5;73.1
93;2021-10-13;1049;2345;1328126;1223393;79.5;73.3
93;2021-10-14;817;2246;1328943;1225639;79.6;73.4
93;2021-10-15;1061;2131;1330004;1227770;79.6;73.5
93;2021-10-16;1100;2282;1331104;1230052;79.7;73.6
93;2021-10-17;223;624;1331327;1230676;79.7;73.7
93;2021-10-18;671;1890;1331998;1232566;79.8;73.8
93;2021-10-19;736;1951;1332734;1234517;79.8;73.9
94;2020-12-27;8;0;8;0;0.0;0.0
94;2020-12-28;11;1;19;1;0.0;0.0
94;2020-12-29;0;0;19;1;0.0;0.0
94;2020-12-30;1;0;20;1;0.0;0.0
94;2020-12-31;7;2;27;3;0.0;0.0
94;2021-01-01;5;0;32;3;0.0;0.0
94;2021-01-02;0;0;32;3;0.0;0.0
94;2021-01-03;3;1;35;4;0.0;0.0
94;2021-01-04;39;2;74;6;0.0;0.0
94;2021-01-05;234;2;308;8;0.0;0.0
94;2021-01-06;334;5;642;13;0.0;0.0
94;2021-01-07;694;11;1336;24;0.1;0.0
94;2021-01-08;925;11;2261;35;0.2;0.0
94;2021-01-09;47;0;2308;35;0.2;0.0
94;2021-01-10;18;0;2326;35;0.2;0.0
94;2021-01-11;1016;13;3342;48;0.2;0.0
94;2021-01-12;1343;26;4685;74;0.3;0.0
94;2021-01-13;1408;26;6093;100;0.4;0.0
94;2021-01-14;1544;31;7637;131;0.5;0.0
94;2021-01-15;1222;26;8859;157;0.6;0.0
94;2021-01-16;197;1;9056;158;0.6;0.0
94;2021-01-17;100;2;9156;160;0.7;0.0
94;2021-01-18;1501;29;10657;189;0.8;0.0
94;2021-01-19;1952;30;12609;219;0.9;0.0
94;2021-01-20;2190;28;14799;247;1.1;0.0
94;2021-01-21;3032;23;17831;270;1.3;0.0
94;2021-01-22;2192;30;20023;300;1.4;0.0
94;2021-01-23;735;4;20758;304;1.5;0.0
94;2021-01-24;286;0;21044;304;1.5;0.0
94;2021-01-25;1474;27;22518;331;1.6;0.0
94;2021-01-26;1581;29;24099;360;1.7;0.0
94;2021-01-27;1848;56;25947;416;1.8;0.0
94;2021-01-28;1559;141;27506;557;2.0;0.0
94;2021-01-29;1380;150;28886;707;2.1;0.1
94;2021-01-30;581;4;29467;711;2.1;0.1
94;2021-01-31;123;9;29590;720;2.1;0.1
94;2021-02-01;931;153;30521;873;2.2;0.1
94;2021-02-02;854;253;31375;1126;2.2;0.1
94;2021-02-03;763;367;32138;1493;2.3;0.1
94;2021-02-04;901;430;33039;1923;2.3;0.1
94;2021-02-05;875;575;33914;2498;2.4;0.2
94;2021-02-06;410;75;34324;2573;2.4;0.2
94;2021-02-07;123;1;34447;2574;2.4;0.2
94;2021-02-08;637;550;35084;3124;2.5;0.2
94;2021-02-09;1036;986;36120;4110;2.6;0.3
94;2021-02-10;1104;1364;37224;5474;2.6;0.4
94;2021-02-11;1430;1558;38654;7032;2.7;0.5
94;2021-02-12;1394;1657;40048;8689;2.8;0.6
94;2021-02-13;301;262;40349;8951;2.9;0.6
94;2021-02-14;30;72;40379;9023;2.9;0.6
94;2021-02-15;756;1768;41135;10791;2.9;0.8
94;2021-02-16;703;2745;41838;13536;3.0;1.0
94;2021-02-17;719;1593;42557;15129;3.0;1.1
94;2021-02-18;798;1704;43355;16833;3.1;1.2
94;2021-02-19;968;1462;44323;18295;3.2;1.3
94;2021-02-20;133;922;44456;19217;3.2;1.4
94;2021-02-21;21;184;44477;19401;3.2;1.4
94;2021-02-22;526;1350;45003;20751;3.2;1.5
94;2021-02-23;625;1278;45628;22029;3.2;1.6
94;2021-02-24;694;928;46322;22957;3.3;1.6
94;2021-02-25;1074;1568;47396;24525;3.4;1.7
94;2021-02-26;1322;1078;48718;25603;3.5;1.8
94;2021-02-27;518;557;49236;26160;3.5;1.9
94;2021-02-28;91;84;49327;26244;3.5;1.9
94;2021-03-01;887;950;50214;27194;3.6;1.9
94;2021-03-02;1569;1006;51783;28200;3.7;2.0
94;2021-03-03;1953;1030;53736;29230;3.8;2.1
94;2021-03-04;2859;1210;56595;30440;4.0;2.2
94;2021-03-05;3839;1375;60434;31815;4.3;2.3
94;2021-03-06;4824;609;65258;32424;4.6;2.3
94;2021-03-07;3690;584;68948;33008;4.9;2.3
94;2021-03-08;1920;821;70868;33829;5.0;2.4
94;2021-03-09;2561;955;73429;34784;5.2;2.5
94;2021-03-10;3201;1066;76630;35850;5.5;2.5
94;2021-03-11;3840;968;80470;36818;5.7;2.6
94;2021-03-12;4586;849;85056;37667;6.0;2.7
94;2021-03-13;4135;415;89191;38082;6.3;2.7
94;2021-03-14;2116;163;91307;38245;6.5;2.7
94;2021-03-15;3172;810;94479;39055;6.7;2.8
94;2021-03-16;2776;459;97255;39514;6.9;2.8
94;2021-03-17;2864;477;100119;39991;7.1;2.8
94;2021-03-18;3267;457;103386;40448;7.4;2.9
94;2021-03-19;4273;738;107659;41186;7.7;2.9
94;2021-03-20;3692;306;111351;41492;7.9;3.0
94;2021-03-21;1466;397;112817;41889;8.0;3.0
94;2021-03-22;3222;689;116039;42578;8.3;3.0
94;2021-03-23;4515;758;120554;43336;8.6;3.1
94;2021-03-24;4628;650;125182;43986;8.9;3.1
94;2021-03-25;6320;710;131502;44696;9.4;3.2
94;2021-03-26;6090;858;137592;45554;9.8;3.2
94;2021-03-27;4471;287;142063;45841;10.1;3.3
94;2021-03-28;1891;119;143954;45960;10.2;3.3
94;2021-03-29;4128;1253;148082;47213;10.5;3.4
94;2021-03-30;5298;1372;153380;48585;10.9;3.5
94;2021-03-31;4913;1844;158293;50429;11.3;3.6
94;2021-04-01;5832;2346;164125;52775;11.7;3.8
94;2021-04-02;5246;2344;169371;55119;12.0;3.9
94;2021-04-03;3087;2540;172458;57659;12.3;4.1
94;2021-04-04;1051;781;173509;58440;12.3;4.2
94;2021-04-05;836;163;174345;58603;12.4;4.2
94;2021-04-06;3582;2615;177927;61218;12.7;4.4
94;2021-04-07;3865;2284;181792;63502;12.9;4.5
94;2021-04-08;4630;2088;186422;65590;13.3;4.7
94;2021-04-09;5368;2503;191790;68093;13.6;4.8
94;2021-04-10;2955;3014;194745;71107;13.9;5.1
94;2021-04-11;1267;1771;196012;72878;13.9;5.2
94;2021-04-12;3442;2302;199454;75180;14.2;5.3
94;2021-04-13;4314;3440;203768;78620;14.5;5.6
94;2021-04-14;3904;2713;207672;81333;14.8;5.8
94;2021-04-15;4454;3015;212126;84348;15.1;6.0
94;2021-04-16;4710;2861;216836;87209;15.4;6.2
94;2021-04-17;2463;2778;219299;89987;15.6;6.4
94;2021-04-18;919;1249;220218;91236;15.7;6.5
94;2021-04-19;2977;2456;223195;93692;15.9;6.7
94;2021-04-20;3275;2723;226470;96415;16.1;6.9
94;2021-04-21;3222;3178;229692;99593;16.3;7.1
94;2021-04-22;3912;3658;233604;103251;16.6;7.3
94;2021-04-23;4121;4012;237725;107263;16.9;7.6
94;2021-04-24;4265;3416;241990;110679;17.2;7.9
94;2021-04-25;2408;1516;244398;112195;17.4;8.0
94;2021-04-26;4011;3291;248409;115486;17.7;8.2
94;2021-04-27;5099;3396;253508;118882;18.0;8.5
94;2021-04-28;4832;3654;258340;122536;18.4;8.7
94;2021-04-29;6414;3833;264754;126369;18.8;9.0
94;2021-04-30;6488;3964;271242;130333;19.3;9.3
94;2021-05-01;4057;1069;275299;131402;19.6;9.3
94;2021-05-02;3049;1478;278348;132880;19.8;9.5
94;2021-05-03;5735;5344;284083;138224;20.2;9.8
94;2021-05-04;6098;3588;290181;141812;20.6;10.1
94;2021-05-05;6183;3437;296364;145249;21.1;10.3
94;2021-05-06;7163;3545;303527;148794;21.6;10.6
94;2021-05-07;6673;4131;310200;152925;22.1;10.9
94;2021-05-08;4907;2565;315107;155490;22.4;11.1
94;2021-05-09;4226;2257;319333;157747;22.7;11.2
94;2021-05-10;7715;3135;327048;160882;23.3;11.4
94;2021-05-11;8971;3944;336019;164826;23.9;11.7
94;2021-05-12;9575;3612;345594;168438;24.6;12.0
94;2021-05-13;8676;1367;354270;169805;25.2;12.1
94;2021-05-14;9867;3315;364137;173120;25.9;12.3
94;2021-05-15;8941;2163;373078;175283;26.5;12.5
94;2021-05-16;5068;912;378146;176195;26.9;12.5
94;2021-05-17;10836;2258;388982;178453;27.7;12.7
94;2021-05-18;11299;2453;400281;180906;28.5;12.9
94;2021-05-19;11675;3601;411956;184507;29.3;13.1
94;2021-05-20;12156;4363;424112;188870;30.2;13.4
94;2021-05-21;11875;3168;435987;192038;31.0;13.7
94;2021-05-22;10283;1971;446270;194009;31.7;13.8
94;2021-05-23;4998;712;451268;194721;32.1;13.8
94;2021-05-24;9669;1349;460937;196070;32.8;13.9
94;2021-05-25;10002;4275;470939;200345;33.5;14.2
94;2021-05-26;10294;3314;481233;203659;34.2;14.5
94;2021-05-27;10864;4589;492097;208248;35.0;14.8
94;2021-05-28;10441;4951;502538;213199;35.7;15.2
94;2021-05-29;9869;3458;512407;216657;36.4;15.4
94;2021-05-30;4785;931;517192;217588;36.8;15.5
94;2021-05-31;9989;4240;527181;221828;37.5;15.8
94;2021-06-01;10307;5101;537488;226929;38.2;16.1
94;2021-06-02;9356;4588;546844;231517;38.9;16.5
94;2021-06-03;9561;5607;556405;237124;39.6;16.9
94;2021-06-04;10404;6539;566809;243663;40.3;17.3
94;2021-06-05;9182;6250;575991;249913;41.0;17.8
94;2021-06-06;3984;1849;579975;251762;41.2;17.9
94;2021-06-07;8664;5977;588639;257739;41.9;18.3
94;2021-06-08;9000;7520;597639;265259;42.5;18.9
94;2021-06-09;8954;8166;606593;273425;43.1;19.4
94;2021-06-10;8803;10974;615396;284399;43.8;20.2
94;2021-06-11;7850;8399;623246;292798;44.3;20.8
94;2021-06-12;10259;6856;633505;299654;45.1;21.3
94;2021-06-13;3469;3263;636974;302917;45.3;21.5
94;2021-06-14;6960;8204;643934;311121;45.8;22.1
94;2021-06-15;7736;8822;651670;319943;46.3;22.8
94;2021-06-16;7246;8272;658916;328215;46.9;23.3
94;2021-06-17;6698;9068;665614;337283;47.3;24.0
94;2021-06-18;6576;11961;672190;349244;47.8;24.8
94;2021-06-19;6002;9587;678192;358831;48.2;25.5
94;2021-06-20;1887;4009;680079;362840;48.4;25.8
94;2021-06-21;4529;11190;684608;374030;48.7;26.6
94;2021-06-22;4845;10811;689453;384841;49.0;27.4
94;2021-06-23;4179;11151;693632;395992;49.3;28.2
94;2021-06-24;4970;10337;698602;406329;49.7;28.9
94;2021-06-25;4285;13733;702887;420062;50.0;29.9
94;2021-06-26;3139;12007;706026;432069;50.2;30.7
94;2021-06-27;1058;4999;707084;437068;50.3;31.1
94;2021-06-28;3494;12077;710578;449145;50.5;31.9
94;2021-06-29;4055;12176;714633;461321;50.8;32.8
94;2021-06-30;4364;11649;718997;472970;51.1;33.6
94;2021-07-01;5680;11120;724677;484090;51.5;34.4
94;2021-07-02;5326;12195;730003;496285;51.9;35.3
94;2021-07-03;3711;11799;733714;508084;52.2;36.1
94;2021-07-04;1519;5093;735233;513177;52.3;36.5
94;2021-07-05;4496;11431;739729;524608;52.6;37.3
94;2021-07-06;4625;10894;744354;535502;52.9;38.1
94;2021-07-07;5047;11083;749401;546585;53.3;38.9
94;2021-07-08;5112;10032;754513;556617;53.7;39.6
94;2021-07-09;6108;11876;760621;568493;54.1;40.4
94;2021-07-10;4123;11358;764744;579851;54.4;41.2
94;2021-07-11;1556;4719;766300;584570;54.5;41.6
94;2021-07-12;4335;11966;770635;596536;54.8;42.4
94;2021-07-13;6491;12051;777126;608587;55.3;43.3
94;2021-07-14;4292;5298;781418;613885;55.6;43.7
94;2021-07-15;7324;12371;788742;626256;56.1;44.5
94;2021-07-16;7852;11327;796594;637583;56.7;45.3
94;2021-07-17;6106;11327;802700;648910;57.1;46.2
94;2021-07-18;2628;4025;805328;652935;57.3;46.4
94;2021-07-19;6915;10448;812243;663383;57.8;47.2
94;2021-07-20;8573;10386;820816;673769;58.4;47.9
94;2021-07-21;8803;9590;829619;683359;59.0;48.6
94;2021-07-22;9797;9434;839416;692793;59.7;49.3
94;2021-07-23;9434;9417;848850;702210;60.4;49.9
94;2021-07-24;7216;8887;856066;711097;60.9;50.6
94;2021-07-25;2190;2742;858256;713839;61.0;50.8
94;2021-07-26;7972;8048;866228;721887;61.6;51.3
94;2021-07-27;8622;7009;874850;728896;62.2;51.8
94;2021-07-28;8812;6325;883662;735221;62.8;52.3
94;2021-07-29;9060;6379;892722;741600;63.5;52.7
94;2021-07-30;8206;6599;900928;748199;64.1;53.2
94;2021-07-31;7214;6314;908142;754513;64.6;53.7
94;2021-08-01;3203;1783;911345;756296;64.8;53.8
94;2021-08-02;6679;5470;918024;761766;65.3;54.2
94;2021-08-03;6383;5214;924407;766980;65.7;54.5
94;2021-08-04;6333;5132;930740;772112;66.2;54.9
94;2021-08-05;5881;5473;936621;777585;66.6;55.3
94;2021-08-06;5817;5848;942438;783433;67.0;55.7
94;2021-08-07;4255;4484;946693;787917;67.3;56.0
94;2021-08-08;1371;1718;948064;789635;67.4;56.2
94;2021-08-09;4902;6532;952966;796167;67.8;56.6
94;2021-08-10;5414;6311;958380;802478;68.2;57.1
94;2021-08-11;4314;5727;962694;808205;68.5;57.5
94;2021-08-12;4453;6506;967147;814711;68.8;57.9
94;2021-08-13;3800;5756;970947;820467;69.1;58.4
94;2021-08-14;2906;5736;973853;826203;69.3;58.8
94;2021-08-15;458;736;974311;826939;69.3;58.8
94;2021-08-16;3510;8282;977821;835221;69.5;59.4
94;2021-08-17;3380;8129;981201;843350;69.8;60.0
94;2021-08-18;3285;8613;984486;851963;70.0;60.6
94;2021-08-19;3350;6912;987836;858875;70.3;61.1
94;2021-08-20;3403;7756;991239;866631;70.5;61.6
94;2021-08-21;2569;7151;993808;873782;70.7;62.1
94;2021-08-22;897;2738;994705;876520;70.7;62.3
94;2021-08-23;2854;8451;997559;884971;70.9;62.9
94;2021-08-24;3152;7516;1000711;892487;71.2;63.5
94;2021-08-25;2752;6748;1003463;899235;71.4;64.0
94;2021-08-26;2597;6147;1006060;905382;71.6;64.4
94;2021-08-27;2653;6572;1008713;911954;71.7;64.9
94;2021-08-28;2579;6495;1011292;918449;71.9;65.3
94;2021-08-29;868;2349;1012160;920798;72.0;65.5
94;2021-08-30;2838;7731;1014998;928529;72.2;66.0
94;2021-08-31;2607;7201;1017605;935730;72.4;66.6
94;2021-09-01;2531;5671;1020136;941401;72.6;67.0
94;2021-09-02;1987;4633;1022123;946034;72.7;67.3
94;2021-09-03;2112;5182;1024235;951216;72.8;67.7
94;2021-09-04;2400;5144;1026635;956360;73.0;68.0
94;2021-09-05;707;1130;1027342;957490;73.1;68.1
94;2021-09-06;1616;3446;1028958;960936;73.2;68.3
94;2021-09-07;1518;3184;1030476;964120;73.3;68.6
94;2021-09-08;1766;3297;1032242;967417;73.4;68.8
94;2021-09-09;1288;2862;1033530;970279;73.5;69.0
94;2021-09-10;1648;3410;1035178;973689;73.6;69.3
94;2021-09-11;1926;4248;1037104;977937;73.8;69.6
94;2021-09-12;423;1105;1037527;979042;73.8;69.6
94;2021-09-13;1057;2277;1038584;981319;73.9;69.8
94;2021-09-14;1340;2593;1039924;983912;74.0;70.0
94;2021-09-15;1327;3114;1041251;987026;74.1;70.2
94;2021-09-16;1044;2184;1042295;989210;74.1;70.4
94;2021-09-17;1182;2692;1043477;991902;74.2;70.5
94;2021-09-18;1113;3693;1044590;995595;74.3;70.8
94;2021-09-19;297;1039;1044887;996634;74.3;70.9
94;2021-09-20;788;1968;1045675;998602;74.4;71.0
94;2021-09-21;1005;1788;1046680;1000390;74.4;71.1
94;2021-09-22;956;2368;1047636;1002758;74.5;71.3
94;2021-09-23;787;1705;1048423;1004463;74.6;71.4
94;2021-09-24;1001;1981;1049424;1006444;74.6;71.6
94;2021-09-25;971;3063;1050395;1009507;74.7;71.8
94;2021-09-26;278;701;1050673;1010208;74.7;71.8
94;2021-09-27;688;1472;1051361;1011680;74.8;72.0
94;2021-09-28;666;1425;1052027;1013105;74.8;72.1
94;2021-09-29;854;1591;1052881;1014696;74.9;72.2
94;2021-09-30;995;1265;1053876;1015961;75.0;72.3
94;2021-10-01;1080;1804;1054956;1017765;75.0;72.4
94;2021-10-02;985;2173;1055941;1019938;75.1;72.5
94;2021-10-03;249;608;1056190;1020546;75.1;72.6
94;2021-10-04;590;1101;1056780;1021647;75.2;72.7
94;2021-10-05;659;1097;1057439;1022744;75.2;72.7
94;2021-10-06;687;1307;1058126;1024051;75.3;72.8
94;2021-10-07;639;1009;1058765;1025060;75.3;72.9
94;2021-10-08;921;1408;1059686;1026468;75.4;73.0
94;2021-10-09;826;1612;1060512;1028080;75.4;73.1
94;2021-10-10;243;412;1060755;1028492;75.4;73.1
94;2021-10-11;525;856;1061280;1029348;75.5;73.2
94;2021-10-12;671;1225;1061951;1030573;75.5;73.3
94;2021-10-13;759;1259;1062710;1031832;75.6;73.4
94;2021-10-14;697;1222;1063407;1033054;75.6;73.5
94;2021-10-15;802;1267;1064209;1034321;75.7;73.6
94;2021-10-16;867;1319;1065076;1035640;75.7;73.7
94;2021-10-17;236;362;1065312;1036002;75.8;73.7
94;2021-10-18;510;763;1065822;1036765;75.8;73.7
94;2021-10-19;467;791;1066289;1037556;75.8;73.8
95;2020-12-27;3;0;3;0;0.0;0.0
95;2020-12-28;6;0;9;0;0.0;0.0
95;2020-12-29;0;0;9;0;0.0;0.0
95;2020-12-30;0;0;9;0;0.0;0.0
95;2020-12-31;2;0;11;0;0.0;0.0
95;2021-01-01;0;0;11;0;0.0;0.0
95;2021-01-02;13;0;24;0;0.0;0.0
95;2021-01-03;1;0;25;0;0.0;0.0
95;2021-01-04;50;0;75;0;0.0;0.0
95;2021-01-05;319;0;394;0;0.0;0.0
95;2021-01-06;191;0;585;0;0.0;0.0
95;2021-01-07;130;1;715;1;0.1;0.0
95;2021-01-08;279;2;994;3;0.1;0.0
95;2021-01-09;251;0;1245;3;0.1;0.0
95;2021-01-10;384;3;1629;6;0.1;0.0
95;2021-01-11;492;3;2121;9;0.2;0.0
95;2021-01-12;864;3;2985;12;0.2;0.0
95;2021-01-13;783;12;3768;24;0.3;0.0
95;2021-01-14;885;13;4653;37;0.4;0.0
95;2021-01-15;758;6;5411;43;0.4;0.0
95;2021-01-16;298;4;5709;47;0.5;0.0
95;2021-01-17;225;2;5934;49;0.5;0.0
95;2021-01-18;1338;7;7272;56;0.6;0.0
95;2021-01-19;1579;9;8851;65;0.7;0.0
95;2021-01-20;2039;6;10890;71;0.9;0.0
95;2021-01-21;1856;7;12746;78;1.0;0.0
95;2021-01-22;1325;7;14071;85;1.1;0.0
95;2021-01-23;648;0;14719;85;1.2;0.0
95;2021-01-24;182;0;14901;85;1.2;0.0
95;2021-01-25;795;37;15696;122;1.3;0.0
95;2021-01-26;989;163;16685;285;1.3;0.0
95;2021-01-27;1251;192;17936;477;1.4;0.0
95;2021-01-28;1721;37;19657;514;1.6;0.0
95;2021-01-29;1251;210;20908;724;1.7;0.1
95;2021-01-30;478;6;21386;730;1.7;0.1
95;2021-01-31;212;2;21598;732;1.7;0.1
95;2021-02-01;566;273;22164;1005;1.8;0.1
95;2021-02-02;528;270;22692;1275;1.8;0.1
95;2021-02-03;615;519;23307;1794;1.9;0.1
95;2021-02-04;1068;369;24375;2163;2.0;0.2
95;2021-02-05;734;306;25109;2469;2.0;0.2
95;2021-02-06;339;255;25448;2724;2.0;0.2
95;2021-02-07;143;407;25591;3131;2.0;0.3
95;2021-02-08;765;342;26356;3473;2.1;0.3
95;2021-02-09;1136;1101;27492;4574;2.2;0.4
95;2021-02-10;1262;1420;28754;5994;2.3;0.5
95;2021-02-11;1387;1148;30141;7142;2.4;0.6
95;2021-02-12;1031;986;31172;8128;2.5;0.7
95;2021-02-13;330;319;31502;8447;2.5;0.7
95;2021-02-14;43;186;31545;8633;2.5;0.7
95;2021-02-15;430;1061;31975;9694;2.6;0.8
95;2021-02-16;493;916;32468;10610;2.6;0.8
95;2021-02-17;654;1134;33122;11744;2.7;0.9
95;2021-02-18;725;1696;33847;13440;2.7;1.1
95;2021-02-19;783;1305;34630;14745;2.8;1.2
95;2021-02-20;306;492;34936;15237;2.8;1.2
95;2021-02-21;165;313;35101;15550;2.8;1.2
95;2021-02-22;327;1022;35428;16572;2.8;1.3
95;2021-02-23;368;727;35796;17299;2.9;1.4
95;2021-02-24;310;880;36106;18179;2.9;1.5
95;2021-02-25;728;1142;36834;19321;3.0;1.5
95;2021-02-26;991;887;37825;20208;3.0;1.6
95;2021-02-27;365;434;38190;20642;3.1;1.7
95;2021-02-28;61;235;38251;20877;3.1;1.7
95;2021-03-01;773;593;39024;21470;3.1;1.7
95;2021-03-02;1323;861;40347;22331;3.2;1.8
95;2021-03-03;1601;989;41948;23320;3.4;1.9
95;2021-03-04;3197;1225;45145;24545;3.6;2.0
95;2021-03-05;3647;1112;48792;25657;3.9;2.1
95;2021-03-06;4005;516;52797;26173;4.2;2.1
95;2021-03-07;4221;344;57018;26517;4.6;2.1
95;2021-03-08;1541;876;58559;27393;4.7;2.2
95;2021-03-09;2622;515;61181;27908;4.9;2.2
95;2021-03-10;2344;863;63525;28771;5.1;2.3
95;2021-03-11;3141;1171;66666;29942;5.3;2.4
95;2021-03-12;3521;820;70187;30762;5.6;2.5
95;2021-03-13;3514;434;73701;31196;5.9;2.5
95;2021-03-14;1981;316;75682;31512;6.1;2.5
95;2021-03-15;2371;331;78053;31843;6.3;2.6
95;2021-03-16;1575;427;79628;32270;6.4;2.6
95;2021-03-17;2103;426;81731;32696;6.5;2.6
95;2021-03-18;2799;384;84530;33080;6.8;2.6
95;2021-03-19;3474;375;88004;33455;7.0;2.7
95;2021-03-20;2592;211;90596;33666;7.3;2.7
95;2021-03-21;1205;259;91801;33925;7.4;2.7
95;2021-03-22;2936;374;94737;34299;7.6;2.7
95;2021-03-23;3440;474;98177;34773;7.9;2.8
95;2021-03-24;3946;533;102123;35306;8.2;2.8
95;2021-03-25;5861;673;107984;35979;8.7;2.9
95;2021-03-26;5429;704;113413;36683;9.1;2.9
95;2021-03-27;3748;231;117161;36914;9.4;3.0
95;2021-03-28;1536;130;118697;37044;9.5;3.0
95;2021-03-29;2894;582;121591;37626;9.7;3.0
95;2021-03-30;3886;1266;125477;38892;10.1;3.1
95;2021-03-31;3658;1693;129135;40585;10.3;3.3
95;2021-04-01;5483;2297;134618;42882;10.8;3.4
95;2021-04-02;3560;2779;138178;45661;11.1;3.7
95;2021-04-03;2096;2496;140274;48157;11.2;3.9
95;2021-04-04;1249;1213;141523;49370;11.3;4.0
95;2021-04-05;596;64;142119;49434;11.4;4.0
95;2021-04-06;1859;1545;143978;50979;11.5;4.1
95;2021-04-07;4953;2215;148931;53194;11.9;4.3
95;2021-04-08;4896;2482;153827;55676;12.3;4.5
95;2021-04-09;5434;2351;159261;58027;12.8;4.6
95;2021-04-10;3709;1443;162970;59470;13.1;4.8
95;2021-04-11;1567;1045;164537;60515;13.2;4.8
95;2021-04-12;3254;1632;167791;62147;13.4;5.0
95;2021-04-13;3141;1700;170932;63847;13.7;5.1
95;2021-04-14;2751;2005;173683;65852;13.9;5.3
95;2021-04-15;3901;3363;177584;69215;14.2;5.5
95;2021-04-16;4064;3044;181648;72259;14.6;5.8
95;2021-04-17;2376;1759;184024;74018;14.7;5.9
95;2021-04-18;1511;1028;185535;75046;14.9;6.0
95;2021-04-19;2570;2375;188105;77421;15.1;6.2
95;2021-04-20;2121;2459;190226;79880;15.2;6.4
95;2021-04-21;3931;2640;194157;82520;15.6;6.6
95;2021-04-22;3413;4639;197570;87159;15.8;7.0
95;2021-04-23;2766;3565;200336;90724;16.0;7.3
95;2021-04-24;3572;2600;203908;93324;16.3;7.5
95;2021-04-25;1959;1554;205867;94878;16.5;7.6
95;2021-04-26;2753;2713;208620;97591;16.7;7.8
95;2021-04-27;3852;2185;212472;99776;17.0;8.0
95;2021-04-28;3890;2677;216362;102453;17.3;8.2
95;2021-04-29;6142;4562;222504;107015;17.8;8.6
95;2021-04-30;6904;2951;229408;109966;18.4;8.8
95;2021-05-01;2371;923;231779;110889;18.6;8.9
95;2021-05-02;2446;1507;234225;112396;18.8;9.0
95;2021-05-03;5128;1940;239353;114336;19.2;9.2
95;2021-05-04;6351;2738;245704;117074;19.7;9.4
95;2021-05-05;5146;3811;250850;120885;20.1;9.7
95;2021-05-06;8206;4938;259056;125823;20.8;10.1
95;2021-05-07;5778;4762;264834;130585;21.2;10.5
95;2021-05-08;5742;1536;270576;132121;21.7;10.6
95;2021-05-09;2832;1596;273408;133717;21.9;10.7
95;2021-05-10;9971;3207;283379;136924;22.7;11.0
95;2021-05-11;8451;3472;291830;140396;23.4;11.2
95;2021-05-12;9465;3229;301295;143625;24.1;11.5
95;2021-05-13;7953;1204;309248;144829;24.8;11.6
95;2021-05-14;7014;1912;316262;146741;25.3;11.8
95;2021-05-15;4512;1071;320774;147812;25.7;11.8
95;2021-05-16;4824;848;325598;148660;26.1;11.9
95;2021-05-17;7738;1354;333336;150014;26.7;12.0
95;2021-05-18;9468;1860;342804;151874;27.5;12.2
95;2021-05-19;9243;2503;352047;154377;28.2;12.4
95;2021-05-20;12585;2447;364632;156824;29.2;12.6
95;2021-05-21;10172;2542;374804;159366;30.0;12.8
95;2021-05-22;9395;1575;384199;160941;30.8;12.9
95;2021-05-23;4145;965;388344;161906;31.1;13.0
95;2021-05-24;2396;536;390740;162442;31.3;13.0
95;2021-05-25;7212;2082;397952;164524;31.9;13.2
95;2021-05-26;8851;3125;406803;167649;32.6;13.4
95;2021-05-27;10359;4442;417162;172091;33.4;13.8
95;2021-05-28;7682;4418;424844;176509;34.0;14.1
95;2021-05-29;5264;2761;430108;179270;34.5;14.4
95;2021-05-30;3732;1710;433840;180980;34.8;14.5
95;2021-05-31;6424;3331;440264;184311;35.3;14.8
95;2021-06-01;8783;3811;449047;188122;36.0;15.1
95;2021-06-02;8730;4748;457777;192870;36.7;15.4
95;2021-06-03;8524;6564;466301;199434;37.4;16.0
95;2021-06-04;8882;4406;475183;203840;38.1;16.3
95;2021-06-05;8336;3748;483519;207588;38.7;16.6
95;2021-06-06;4837;1627;488356;209215;39.1;16.8
95;2021-06-07;6059;4546;494415;213761;39.6;17.1
95;2021-06-08;6550;5514;500965;219275;40.1;17.6
95;2021-06-09;6254;6478;507219;225753;40.6;18.1
95;2021-06-10;6430;6818;513649;232571;41.1;18.6
95;2021-06-11;7222;6445;520871;239016;41.7;19.1
95;2021-06-12;6002;4374;526873;243390;42.2;19.5
95;2021-06-13;2083;3290;528956;246680;42.4;19.8
95;2021-06-14;5373;5995;534329;252675;42.8;20.2
95;2021-06-15;5740;8073;540069;260748;43.3;20.9
95;2021-06-16;5491;7539;545560;268287;43.7;21.5
95;2021-06-17;6599;8165;552159;276452;44.2;22.1
95;2021-06-18;5822;7862;557981;284314;44.7;22.8
95;2021-06-19;4965;8927;562946;293241;45.1;23.5
95;2021-06-20;1426;3316;564372;296557;45.2;23.8
95;2021-06-21;3534;7715;567906;304272;45.5;24.4
95;2021-06-22;5066;9056;572972;313328;45.9;25.1
95;2021-06-23;4774;10878;577746;324206;46.3;26.0
95;2021-06-24;4941;10724;582687;334930;46.7;26.8
95;2021-06-25;4879;10358;587566;345288;47.1;27.7
95;2021-06-26;4320;8476;591886;353764;47.4;28.3
95;2021-06-27;1032;3996;592918;357760;47.5;28.7
95;2021-06-28;2741;9487;595659;367247;47.7;29.4
95;2021-06-29;2537;8788;598196;376035;47.9;30.1
95;2021-06-30;3952;9996;602148;386031;48.2;30.9
95;2021-07-01;4863;11166;607011;397197;48.6;31.8
95;2021-07-02;4260;10546;611271;407743;49.0;32.7
95;2021-07-03;3525;9155;614796;416898;49.2;33.4
95;2021-07-04;1279;3401;616075;420299;49.4;33.7
95;2021-07-05;2358;4375;618433;424674;49.5;34.0
95;2021-07-06;2772;7753;621205;432427;49.8;34.6
95;2021-07-07;3961;9619;625166;442046;50.1;35.4
95;2021-07-08;5313;9821;630479;451867;50.5;36.2
95;2021-07-09;4553;10081;635032;461948;50.9;37.0
95;2021-07-10;3400;7392;638432;469340;51.1;37.6
95;2021-07-11;1526;3603;639958;472943;51.3;37.9
95;2021-07-12;2990;9692;642948;482635;51.5;38.7
95;2021-07-13;5053;10073;648001;492708;51.9;39.5
95;2021-07-14;4428;5744;652429;498452;52.3;39.9
95;2021-07-15;7403;12371;659832;510823;52.9;40.9
95;2021-07-16;7985;12010;667817;522833;53.5;41.9
95;2021-07-17;5053;7824;672870;530657;53.9;42.5
95;2021-07-18;3483;2915;676353;533572;54.2;42.7
95;2021-07-19;4832;6869;681185;540441;54.6;43.3
95;2021-07-20;6959;8387;688144;548828;55.1;44.0
95;2021-07-21;9257;9452;697401;558280;55.9;44.7
95;2021-07-22;10150;9731;707551;568011;56.7;45.5
95;2021-07-23;10918;10207;718469;578218;57.6;46.3
95;2021-07-24;5259;6237;723728;584455;58.0;46.8
95;2021-07-25;2251;2284;725979;586739;58.2;47.0
95;2021-07-26;4522;4026;730501;590765;58.5;47.3
95;2021-07-27;8502;7045;739003;597810;59.2;47.9
95;2021-07-28;9714;7565;748717;605375;60.0;48.5
95;2021-07-29;8428;5475;757145;610850;60.7;48.9
95;2021-07-30;8516;7777;765661;618627;61.3;49.6
95;2021-07-31;4237;4104;769898;622731;61.7;49.9
95;2021-08-01;2339;1375;772237;624106;61.9;50.0
95;2021-08-02;4162;3918;776399;628024;62.2;50.3
95;2021-08-03;6159;5542;782558;633566;62.7;50.8
95;2021-08-04;6514;6088;789072;639654;63.2;51.2
95;2021-08-05;6869;5731;795941;645385;63.8;51.7
95;2021-08-06;6515;7066;802456;652451;64.3;52.3
95;2021-08-07;2844;3038;805300;655489;64.5;52.5
95;2021-08-08;1370;1888;806670;657377;64.6;52.7
95;2021-08-09;3927;5038;810597;662415;64.9;53.1
95;2021-08-10;5273;5843;815870;668258;65.4;53.5
95;2021-08-11;5369;6563;821239;674821;65.8;54.1
95;2021-08-12;5231;6366;826470;681187;66.2;54.6
95;2021-08-13;3918;5478;830388;686665;66.5;55.0
95;2021-08-14;3572;3323;833960;689988;66.8;55.3
95;2021-08-15;284;361;834244;690349;66.8;55.3
95;2021-08-16;2866;6055;837110;696404;67.1;55.8
95;2021-08-17;3623;7265;840733;703669;67.3;56.4
95;2021-08-18;4277;8074;845010;711743;67.7;57.0
95;2021-08-19;3800;6595;848810;718338;68.0;57.5
95;2021-08-20;3795;7931;852605;726269;68.3;58.2
95;2021-08-21;2718;4303;855323;730572;68.5;58.5
95;2021-08-22;859;2399;856182;732971;68.6;58.7
95;2021-08-23;2469;5652;858651;738623;68.8;59.2
95;2021-08-24;2967;6472;861618;745095;69.0;59.7
95;2021-08-25;3776;8293;865394;753388;69.3;60.4
95;2021-08-26;3168;7534;868562;760922;69.6;61.0
95;2021-08-27;3518;8723;872080;769645;69.9;61.7
95;2021-08-28;2803;5495;874883;775140;70.1;62.1
95;2021-08-29;639;1713;875522;776853;70.1;62.2
95;2021-08-30;2763;6102;878285;782955;70.4;62.7
95;2021-08-31;2823;6311;881108;789266;70.6;63.2
95;2021-09-01;2784;6043;883892;795309;70.8;63.7
95;2021-09-02;1710;4230;885602;799539;70.9;64.0
95;2021-09-03;2222;5360;887824;804899;71.1;64.5
95;2021-09-04;2526;5628;890350;810527;71.3;64.9
95;2021-09-05;421;628;890771;811155;71.4;65.0
95;2021-09-06;1254;3140;892025;814295;71.5;65.2
95;2021-09-07;1400;3147;893425;817442;71.6;65.5
95;2021-09-08;1671;3890;895096;821332;71.7;65.8
95;2021-09-09;1302;3247;896398;824579;71.8;66.1
95;2021-09-10;1578;3522;897976;828101;71.9;66.3
95;2021-09-11;1542;3566;899518;831667;72.1;66.6
95;2021-09-12;322;699;899840;832366;72.1;66.7
95;2021-09-13;885;2208;900725;834574;72.2;66.9
95;2021-09-14;1161;2277;901886;836851;72.2;67.0
95;2021-09-15;1406;3576;903292;840427;72.4;67.3
95;2021-09-16;962;1889;904254;842316;72.4;67.5
95;2021-09-17;1264;2883;905518;845199;72.5;67.7
95;2021-09-18;1285;4204;906803;849403;72.6;68.0
95;2021-09-19;247;585;907050;849988;72.7;68.1
95;2021-09-20;654;1415;907704;851403;72.7;68.2
95;2021-09-21;835;1812;908539;853215;72.8;68.3
95;2021-09-22;955;3082;909494;856297;72.9;68.6
95;2021-09-23;757;1195;910251;857492;72.9;68.7
95;2021-09-24;848;2046;911099;859538;73.0;68.9
95;2021-09-25;1015;3805;912114;863343;73.1;69.2
95;2021-09-26;141;411;912255;863754;73.1;69.2
95;2021-09-27;734;1195;912989;864949;73.1;69.3
95;2021-09-28;783;1411;913772;866360;73.2;69.4
95;2021-09-29;811;1903;914583;868263;73.3;69.6
95;2021-09-30;799;1132;915382;869395;73.3;69.6
95;2021-10-01;761;1411;916143;870806;73.4;69.8
95;2021-10-02;1218;2491;917361;873297;73.5;70.0
95;2021-10-03;132;262;917493;873559;73.5;70.0
95;2021-10-04;403;714;917896;874273;73.5;70.0
95;2021-10-05;596;1220;918492;875493;73.6;70.1
95;2021-10-06;716;1289;919208;876782;73.6;70.2
95;2021-10-07;500;816;919708;877598;73.7;70.3
95;2021-10-08;760;1412;920468;879010;73.7;70.4
95;2021-10-09;1015;1737;921483;880747;73.8;70.6
95;2021-10-10;142;253;921625;881000;73.8;70.6
95;2021-10-11;375;575;922000;881575;73.9;70.6
95;2021-10-12;525;850;922525;882425;73.9;70.7
95;2021-10-13;790;1187;923315;883612;74.0;70.8
95;2021-10-14;515;976;923830;884588;74.0;70.9
95;2021-10-15;795;1091;924625;885679;74.1;70.9
95;2021-10-16;913;1431;925538;887110;74.1;71.1
95;2021-10-17;114;222;925652;887332;74.1;71.1
95;2021-10-18;309;549;925961;887881;74.2;71.1
95;2021-10-19;616;839;926577;888720;74.2;71.2
971;2020-12-27;0;0;0;0;0.0;0.0
971;2020-12-28;0;0;0;0;0.0;0.0
971;2020-12-29;0;0;0;0;0.0;0.0
971;2020-12-30;0;0;0;0;0.0;0.0
971;2020-12-31;0;0;0;0;0.0;0.0
971;2021-01-01;1;0;1;0;0.0;0.0
971;2021-01-02;0;0;1;0;0.0;0.0
971;2021-01-03;0;0;1;0;0.0;0.0
971;2021-01-04;1;0;2;0;0.0;0.0
971;2021-01-05;0;0;2;0;0.0;0.0
971;2021-01-06;1;0;3;0;0.0;0.0
971;2021-01-07;0;0;3;0;0.0;0.0
971;2021-01-08;59;1;62;1;0.0;0.0
971;2021-01-09;20;0;82;1;0.0;0.0
971;2021-01-10;0;0;82;1;0.0;0.0
971;2021-01-11;61;0;143;1;0.0;0.0
971;2021-01-12;46;0;189;1;0.1;0.0
971;2021-01-13;47;1;236;2;0.1;0.0
971;2021-01-14;63;0;299;2;0.1;0.0
971;2021-01-15;77;2;376;4;0.1;0.0
971;2021-01-16;0;0;376;4;0.1;0.0
971;2021-01-17;0;0;376;4;0.1;0.0
971;2021-01-18;82;2;458;6;0.1;0.0
971;2021-01-19;148;0;606;6;0.2;0.0
971;2021-01-20;134;0;740;6;0.2;0.0
971;2021-01-21;156;1;896;7;0.2;0.0
971;2021-01-22;135;0;1031;7;0.3;0.0
971;2021-01-23;1;0;1032;7;0.3;0.0
971;2021-01-24;0;0;1032;7;0.3;0.0
971;2021-01-25;204;3;1236;10;0.3;0.0
971;2021-01-26;220;4;1456;14;0.4;0.0
971;2021-01-27;237;2;1693;16;0.4;0.0
971;2021-01-28;242;6;1935;22;0.5;0.0
971;2021-01-29;200;3;2135;25;0.6;0.0
971;2021-01-30;25;1;2160;26;0.6;0.0
971;2021-01-31;1;0;2161;26;0.6;0.0
971;2021-02-01;231;5;2392;31;0.6;0.0
971;2021-02-02;247;27;2639;58;0.7;0.0
971;2021-02-03;228;4;2867;62;0.8;0.0
971;2021-02-04;307;26;3174;88;0.8;0.0
971;2021-02-05;290;36;3464;124;0.9;0.0
971;2021-02-06;49;1;3513;125;0.9;0.0
971;2021-02-07;0;0;3513;125;0.9;0.0
971;2021-02-08;261;23;3774;148;1.0;0.0
971;2021-02-09;323;29;4097;177;1.1;0.0
971;2021-02-10;257;31;4354;208;1.2;0.1
971;2021-02-11;302;113;4656;321;1.2;0.1
971;2021-02-12;291;33;4947;354;1.3;0.1
971;2021-02-13;51;7;4998;361;1.3;0.1
971;2021-02-14;19;36;5017;397;1.3;0.1
971;2021-02-15;86;45;5103;442;1.4;0.1
971;2021-02-16;16;1;5119;443;1.4;0.1
971;2021-02-17;17;1;5136;444;1.4;0.1
971;2021-02-18;257;19;5393;463;1.4;0.1
971;2021-02-19;251;22;5644;485;1.5;0.1
971;2021-02-20;49;0;5693;485;1.5;0.1
971;2021-02-21;2;0;5695;485;1.5;0.1
971;2021-02-22;198;69;5893;554;1.6;0.1
971;2021-02-23;206;78;6099;632;1.6;0.2
971;2021-02-24;348;127;6447;759;1.7;0.2
971;2021-02-25;385;80;6832;839;1.8;0.2
971;2021-02-26;236;86;7068;925;1.9;0.2
971;2021-02-27;65;0;7133;925;1.9;0.2
971;2021-02-28;1;0;7134;925;1.9;0.2
971;2021-03-01;179;87;7313;1012;1.9;0.3
971;2021-03-02;278;131;7591;1143;2.0;0.3
971;2021-03-03;244;122;7835;1265;2.1;0.3
971;2021-03-04;336;87;8171;1352;2.2;0.4
971;2021-03-05;377;150;8548;1502;2.3;0.4
971;2021-03-06;599;16;9147;1518;2.4;0.4
971;2021-03-07;2;0;9149;1518;2.4;0.4
971;2021-03-08;332;149;9481;1667;2.5;0.4
971;2021-03-09;393;164;9874;1831;2.6;0.5
971;2021-03-10;438;168;10312;1999;2.7;0.5
971;2021-03-11;122;46;10434;2045;2.8;0.5
971;2021-03-12;508;236;10942;2281;2.9;0.6
971;2021-03-13;139;4;11081;2285;2.9;0.6
971;2021-03-14;14;23;11095;2308;2.9;0.6
971;2021-03-15;424;49;11519;2357;3.1;0.6
971;2021-03-16;493;88;12012;2445;3.2;0.6
971;2021-03-17;471;79;12483;2524;3.3;0.7
971;2021-03-18;590;88;13073;2612;3.5;0.7
971;2021-03-19;583;98;13656;2710;3.6;0.7
971;2021-03-20;177;21;13833;2731;3.7;0.7
971;2021-03-21;8;0;13841;2731;3.7;0.7
971;2021-03-22;361;93;14202;2824;3.8;0.7
971;2021-03-23;542;160;14744;2984;3.9;0.8
971;2021-03-24;475;111;15219;3095;4.0;0.8
971;2021-03-25;758;187;15977;3282;4.2;0.9
971;2021-03-26;644;124;16621;3406;4.4;0.9
971;2021-03-27;296;40;16917;3446;4.5;0.9
971;2021-03-28;24;2;16941;3448;4.5;0.9
971;2021-03-29;385;85;17326;3533;4.6;0.9
971;2021-03-30;627;171;17953;3704;4.8;1.0
971;2021-03-31;545;134;18498;3838;4.9;1.0
971;2021-04-01;664;200;19162;4038;5.1;1.1
971;2021-04-02;41;37;19203;4075;5.1;1.1
971;2021-04-03;63;8;19266;4083;5.1;1.1
971;2021-04-04;4;19;19270;4102;5.1;1.1
971;2021-04-05;14;0;19284;4102;5.1;1.1
971;2021-04-06;489;200;19773;4302;5.2;1.1
971;2021-04-07;581;124;20354;4426;5.4;1.2
971;2021-04-08;527;164;20881;4590;5.5;1.2
971;2021-04-09;486;213;21367;4803;5.7;1.3
971;2021-04-10;101;5;21468;4808;5.7;1.3
971;2021-04-11;8;12;21476;4820;5.7;1.3
971;2021-04-12;308;267;21784;5087;5.8;1.3
971;2021-04-13;556;328;22340;5415;5.9;1.4
971;2021-04-14;448;232;22788;5647;6.0;1.5
971;2021-04-15;553;314;23341;5961;6.2;1.6
971;2021-04-16;563;275;23904;6236;6.3;1.7
971;2021-04-17;216;5;24120;6241;6.4;1.7
971;2021-04-18;6;14;24126;6255;6.4;1.7
971;2021-04-19;405;244;24531;6499;6.5;1.7
971;2021-04-20;726;348;25257;6847;6.7;1.8
971;2021-04-21;627;322;25884;7169;6.9;1.9
971;2021-04-22;819;341;26703;7510;7.1;2.0
971;2021-04-23;845;252;27548;7762;7.3;2.1
971;2021-04-24;391;82;27939;7844;7.4;2.1
971;2021-04-25;601;66;28540;7910;7.6;2.1
971;2021-04-26;982;234;29522;8144;7.8;2.2
971;2021-04-27;722;238;30244;8382;8.0;2.2
971;2021-04-28;865;272;31109;8654;8.3;2.3
971;2021-04-29;1203;218;32312;8872;8.6;2.4
971;2021-04-30;1269;200;33581;9072;8.9;2.4
971;2021-05-01;608;45;34189;9117;9.1;2.4
971;2021-05-02;357;20;34546;9137;9.2;2.4
971;2021-05-03;925;194;35471;9331;9.4;2.5
971;2021-05-04;962;212;36433;9543;9.7;2.5
971;2021-05-05;1023;252;37456;9795;9.9;2.6
971;2021-05-06;1146;179;38602;9974;10.2;2.6
971;2021-05-07;1265;275;39867;10249;10.6;2.7
971;2021-05-08;323;40;40190;10289;10.7;2.7
971;2021-05-09;183;11;40373;10300;10.7;2.7
971;2021-05-10;852;221;41225;10521;10.9;2.8
971;2021-05-11;966;314;42191;10835;11.2;2.9
971;2021-05-12;917;327;43108;11162;11.4;3.0
971;2021-05-13;212;78;43320;11240;11.5;3.0
971;2021-05-14;861;274;44181;11514;11.7;3.1
971;2021-05-15;487;16;44668;11530;11.9;3.1
971;2021-05-16;182;36;44850;11566;11.9;3.1
971;2021-05-17;724;276;45574;11842;12.1;3.1
971;2021-05-18;743;389;46317;12231;12.3;3.2
971;2021-05-19;705;529;47022;12760;12.5;3.4
971;2021-05-20;812;379;47834;13139;12.7;3.5
971;2021-05-21;827;405;48661;13544;12.9;3.6
971;2021-05-22;508;214;49169;13758;13.0;3.7
971;2021-05-23;199;114;49368;13872;13.1;3.7
971;2021-05-24;201;173;49569;14045;13.2;3.7
971;2021-05-25;551;660;50120;14705;13.3;3.9
971;2021-05-26;596;491;50716;15196;13.5;4.0
971;2021-05-27;133;179;50849;15375;13.5;4.1
971;2021-05-28;520;525;51369;15900;13.6;4.2
971;2021-05-29;238;140;51607;16040;13.7;4.3
971;2021-05-30;75;112;51682;16152;13.7;4.3
971;2021-05-31;452;536;52134;16688;13.8;4.4
971;2021-06-01;595;706;52729;17394;14.0;4.6
971;2021-06-02;576;705;53305;18099;14.1;4.8
971;2021-06-03;509;558;53814;18657;14.3;5.0
971;2021-06-04;834;799;54648;19456;14.5;5.2
971;2021-06-05;317;644;54965;20100;14.6;5.3
971;2021-06-06;139;528;55104;20628;14.6;5.5
971;2021-06-07;418;781;55522;21409;14.7;5.7
971;2021-06-08;485;886;56007;22295;14.9;5.9
971;2021-06-09;504;857;56511;23152;15.0;6.1
971;2021-06-10;538;847;57049;23999;15.1;6.4
971;2021-06-11;474;1233;57523;25232;15.3;6.7
971;2021-06-12;303;659;57826;25891;15.3;6.9
971;2021-06-13;126;312;57952;26203;15.4;7.0
971;2021-06-14;371;3678;58323;29881;15.5;7.9
971;2021-06-15;483;1982;58806;31863;15.6;8.5
971;2021-06-16;479;1431;59285;33294;15.7;8.8
971;2021-06-17;432;1009;59717;34303;15.8;9.1
971;2021-06-18;483;1020;60200;35323;16.0;9.4
971;2021-06-19;313;509;60513;35832;16.1;9.5
971;2021-06-20;111;231;60624;36063;16.1;9.6
971;2021-06-21;348;674;60972;36737;16.2;9.7
971;2021-06-22;333;870;61305;37607;16.3;10.0
971;2021-06-23;371;892;61676;38499;16.4;10.2
971;2021-06-24;417;731;62093;39230;16.5;10.4
971;2021-06-25;456;759;62549;39989;16.6;10.6
971;2021-06-26;302;513;62851;40502;16.7;10.7
971;2021-06-27;116;148;62967;40650;16.7;10.8
971;2021-06-28;302;681;63269;41331;16.8;11.0
971;2021-06-29;389;780;63658;42111;16.9;11.2
971;2021-06-30;442;926;64100;43037;17.0;11.4
971;2021-07-01;364;649;64464;43686;17.1;11.6
971;2021-07-02;435;693;64899;44379;17.2;11.8
971;2021-07-03;277;467;65176;44846;17.3;11.9
971;2021-07-04;112;238;65288;45084;17.3;12.0
971;2021-07-05;331;504;65619;45588;17.4;12.1
971;2021-07-06;388;769;66007;46357;17.5;12.3
971;2021-07-07;378;844;66385;47201;17.6;12.5
971;2021-07-08;416;791;66801;47992;17.7;12.7
971;2021-07-09;437;796;67238;48788;17.8;12.9
971;2021-07-10;245;295;67483;49083;17.9;13.0
971;2021-07-11;169;137;67652;49220;18.0;13.1
971;2021-07-12;477;604;68129;49824;18.1;13.2
971;2021-07-13;884;1001;69013;50825;18.3;13.5
971;2021-07-14;476;284;69489;51109;18.4;13.6
971;2021-07-15;885;844;70374;51953;18.7;13.8
971;2021-07-16;1095;1041;71469;52994;19.0;14.1
971;2021-07-17;647;445;72116;53439;19.1;14.2
971;2021-07-18;401;221;72517;53660;19.2;14.2
971;2021-07-19;577;579;73094;54239;19.4;14.4
971;2021-07-20;842;737;73936;54976;19.6;14.6
971;2021-07-21;767;501;74703;55477;19.8;14.7
971;2021-07-22;988;878;75691;56355;20.1;15.0
971;2021-07-23;1034;759;76725;57114;20.4;15.2
971;2021-07-24;426;387;77151;57501;20.5;15.3
971;2021-07-25;247;262;77398;57763;20.5;15.3
971;2021-07-26;636;567;78034;58330;20.7;15.5
971;2021-07-27;884;590;78918;58920;20.9;15.6
971;2021-07-28;797;656;79715;59576;21.2;15.8
971;2021-07-29;972;675;80687;60251;21.4;16.0
971;2021-07-30;1319;758;82006;61009;21.8;16.2
971;2021-07-31;557;412;82563;61421;21.9;16.3
971;2021-08-01;315;251;82878;61672;22.0;16.4
971;2021-08-02;765;422;83643;62094;22.2;16.5
971;2021-08-03;765;676;84408;62770;22.4;16.7
971;2021-08-04;694;676;85102;63446;22.6;16.8
971;2021-08-05;698;595;85800;64041;22.8;17.0
971;2021-08-06;934;644;86734;64685;23.0;17.2
971;2021-08-07;452;392;87186;65077;23.1;17.3
971;2021-08-08;279;314;87465;65391;23.2;17.4
971;2021-08-09;592;585;88057;65976;23.4;17.5
971;2021-08-10;763;798;88820;66774;23.6;17.7
971;2021-08-11;925;793;89745;67567;23.8;17.9
971;2021-08-12;1025;805;90770;68372;24.1;18.1
971;2021-08-13;980;446;91750;68818;24.3;18.3
971;2021-08-14;635;703;92385;69521;24.5;18.4
971;2021-08-15;437;413;92822;69934;24.6;18.6
971;2021-08-16;825;743;93647;70677;24.8;18.8
971;2021-08-17;909;871;94556;71548;25.1;19.0
971;2021-08-18;1277;977;95833;72525;25.4;19.2
971;2021-08-19;1349;928;97182;73453;25.8;19.5
971;2021-08-20;1536;1050;98718;74503;26.2;19.8
971;2021-08-21;733;519;99451;75022;26.4;19.9
971;2021-08-22;367;274;99818;75296;26.5;20.0
971;2021-08-23;876;630;100694;75926;26.7;20.1
971;2021-08-24;1294;796;101988;76722;27.1;20.4
971;2021-08-25;1392;801;103380;77523;27.4;20.6
971;2021-08-26;1404;776;104784;78299;27.8;20.8
971;2021-08-27;1507;1100;106291;79399;28.2;21.1
971;2021-08-28;939;580;107230;79979;28.5;21.2
971;2021-08-29;222;241;107452;80220;28.5;21.3
971;2021-08-30;932;720;108384;80940;28.8;21.5
971;2021-08-31;1255;864;109639;81804;29.1;21.7
971;2021-09-01;1130;879;110769;82683;29.4;21.9
971;2021-09-02;1086;850;111855;83533;29.7;22.2
971;2021-09-03;989;1098;112844;84631;29.9;22.5
971;2021-09-04;550;624;113394;85255;30.1;22.6
971;2021-09-05;129;238;113523;85493;30.1;22.7
971;2021-09-06;612;665;114135;86158;30.3;22.9
971;2021-09-07;639;700;114774;86858;30.5;23.0
971;2021-09-08;708;1003;115482;87861;30.6;23.3
971;2021-09-09;641;1069;116123;88930;30.8;23.6
971;2021-09-10;747;1288;116870;90218;31.0;23.9
971;2021-09-11;417;686;117287;90904;31.1;24.1
971;2021-09-12;86;357;117373;91261;31.1;24.2
971;2021-09-13;377;619;117750;91880;31.2;24.4
971;2021-09-14;556;1105;118306;92985;31.4;24.7
971;2021-09-15;557;1166;118863;94151;31.5;25.0
971;2021-09-16;457;1086;119320;95237;31.7;25.3
971;2021-09-17;573;1479;119893;96716;31.8;25.7
971;2021-09-18;279;1020;120172;97736;31.9;25.9
971;2021-09-19;92;337;120264;98073;31.9;26.0
971;2021-09-20;237;966;120501;99039;32.0;26.3
971;2021-09-21;288;1191;120789;100230;32.0;26.6
971;2021-09-22;385;1196;121174;101426;32.2;26.9
971;2021-09-23;376;1222;121550;102648;32.3;27.2
971;2021-09-24;458;1282;122008;103930;32.4;27.6
971;2021-09-25;233;777;122241;104707;32.4;27.8
971;2021-09-26;73;228;122314;104935;32.5;27.8
971;2021-09-27;248;665;122562;105600;32.5;28.0
971;2021-09-28;266;835;122828;106435;32.6;28.2
971;2021-09-29;314;891;123142;107326;32.7;28.5
971;2021-09-30;347;761;123489;108087;32.8;28.7
971;2021-10-01;385;863;123874;108950;32.9;28.9
971;2021-10-02;268;541;124142;109491;32.9;29.1
971;2021-10-03;71;167;124213;109658;33.0;29.1
971;2021-10-04;223;443;124436;110101;33.0;29.2
971;2021-10-05;339;613;124775;110714;33.1;29.4
971;2021-10-06;338;635;125113;111349;33.2;29.5
971;2021-10-07;366;575;125479;111924;33.3;29.7
971;2021-10-08;436;779;125915;112703;33.4;29.9
971;2021-10-09;318;449;126233;113152;33.5;30.0
971;2021-10-10;68;148;126301;113300;33.5;30.1
971;2021-10-11;245;357;126546;113657;33.6;30.2
971;2021-10-12;296;488;126842;114145;33.7;30.3
971;2021-10-13;390;433;127232;114578;33.8;30.4
971;2021-10-14;370;536;127602;115114;33.9;30.5
971;2021-10-15;466;578;128068;115692;34.0;30.7
971;2021-10-16;250;338;128318;116030;34.0;30.8
971;2021-10-17;64;85;128382;116115;34.1;30.8
971;2021-10-18;181;266;128563;116381;34.1;30.9
971;2021-10-19;228;343;128791;116724;34.2;31.0
972;2020-12-27;0;0;0;0;0.0;0.0
972;2020-12-28;0;0;0;0;0.0;0.0
972;2020-12-29;0;0;0;0;0.0;0.0
972;2020-12-30;0;0;0;0;0.0;0.0
972;2020-12-31;0;0;0;0;0.0;0.0
972;2021-01-01;0;0;0;0;0.0;0.0
972;2021-01-02;0;0;0;0;0.0;0.0
972;2021-01-03;0;0;0;0;0.0;0.0
972;2021-01-04;0;0;0;0;0.0;0.0
972;2021-01-05;0;0;0;0;0.0;0.0
972;2021-01-06;5;0;5;0;0.0;0.0
972;2021-01-07;31;0;36;0;0.0;0.0
972;2021-01-08;90;1;126;1;0.0;0.0
972;2021-01-09;20;0;146;1;0.0;0.0
972;2021-01-10;0;0;146;1;0.0;0.0
972;2021-01-11;122;0;268;1;0.1;0.0
972;2021-01-12;79;0;347;1;0.1;0.0
972;2021-01-13;65;0;412;1;0.1;0.0
972;2021-01-14;88;1;500;2;0.1;0.0
972;2021-01-15;171;7;671;9;0.2;0.0
972;2021-01-16;51;0;722;9;0.2;0.0
972;2021-01-17;0;0;722;9;0.2;0.0
972;2021-01-18;160;0;882;9;0.2;0.0
972;2021-01-19;168;1;1050;10;0.3;0.0
972;2021-01-20;171;0;1221;10;0.3;0.0
972;2021-01-21;182;2;1403;12;0.4;0.0
972;2021-01-22;173;0;1576;12;0.4;0.0
972;2021-01-23;58;0;1634;12;0.5;0.0
972;2021-01-24;0;0;1634;12;0.5;0.0
972;2021-01-25;161;1;1795;13;0.5;0.0
972;2021-01-26;138;1;1933;14;0.5;0.0
972;2021-01-27;163;5;2096;19;0.6;0.0
972;2021-01-28;152;12;2248;31;0.6;0.0
972;2021-01-29;143;41;2391;72;0.7;0.0
972;2021-01-30;96;16;2487;88;0.7;0.0
972;2021-01-31;0;0;2487;88;0.7;0.0
972;2021-02-01;119;73;2606;161;0.7;0.0
972;2021-02-02;185;94;2791;255;0.8;0.1
972;2021-02-03;132;76;2923;331;0.8;0.1
972;2021-02-04;160;70;3083;401;0.9;0.1
972;2021-02-05;123;93;3206;494;0.9;0.1
972;2021-02-06;63;26;3269;520;0.9;0.1
972;2021-02-07;1;0;3270;520;0.9;0.1
972;2021-02-08;137;79;3407;599;0.9;0.2
972;2021-02-09;178;77;3585;676;1.0;0.2
972;2021-02-10;153;90;3738;766;1.0;0.2
972;2021-02-11;149;101;3887;867;1.1;0.2
972;2021-02-12;152;131;4039;998;1.1;0.3
972;2021-02-13;47;37;4086;1035;1.1;0.3
972;2021-02-14;0;0;4086;1035;1.1;0.3
972;2021-02-15;51;67;4137;1102;1.2;0.3
972;2021-02-16;0;1;4137;1103;1.2;0.3
972;2021-02-17;1;3;4138;1106;1.2;0.3
972;2021-02-18;69;127;4207;1233;1.2;0.3
972;2021-02-19;69;129;4276;1362;1.2;0.4
972;2021-02-20;48;68;4324;1430;1.2;0.4
972;2021-02-21;0;0;4324;1430;1.2;0.4
972;2021-02-22;102;60;4426;1490;1.2;0.4
972;2021-02-23;113;235;4539;1725;1.3;0.5
972;2021-02-24;106;220;4645;1945;1.3;0.5
972;2021-02-25;91;150;4736;2095;1.3;0.6
972;2021-02-26;132;168;4868;2263;1.4;0.6
972;2021-02-27;69;52;4937;2315;1.4;0.6
972;2021-02-28;0;0;4937;2315;1.4;0.6
972;2021-03-01;138;143;5075;2458;1.4;0.7
972;2021-03-02;158;79;5233;2537;1.5;0.7
972;2021-03-03;179;145;5412;2682;1.5;0.7
972;2021-03-04;152;135;5564;2817;1.6;0.8
972;2021-03-05;236;128;5800;2945;1.6;0.8
972;2021-03-06;119;58;5919;3003;1.6;0.8
972;2021-03-07;100;3;6019;3006;1.7;0.8
972;2021-03-08;196;134;6215;3140;1.7;0.9
972;2021-03-09;283;101;6498;3241;1.8;0.9
972;2021-03-10;322;136;6820;3377;1.9;0.9
972;2021-03-11;337;81;7157;3458;2.0;1.0
972;2021-03-12;413;57;7570;3515;2.1;1.0
972;2021-03-13;155;21;7725;3536;2.2;1.0
972;2021-03-14;4;1;7729;3537;2.2;1.0
972;2021-03-15;277;91;8006;3628;2.2;1.0
972;2021-03-16;305;56;8311;3684;2.3;1.0
972;2021-03-17;388;48;8699;3732;2.4;1.0
972;2021-03-18;437;46;9136;3778;2.5;1.1
972;2021-03-19;403;63;9539;3841;2.7;1.1
972;2021-03-20;149;48;9688;3889;2.7;1.1
972;2021-03-21;25;1;9713;3890;2.7;1.1
972;2021-03-22;361;117;10074;4007;2.8;1.1
972;2021-03-23;404;124;10478;4131;2.9;1.2
972;2021-03-24;429;107;10907;4238;3.0;1.2
972;2021-03-25;493;105;11400;4343;3.2;1.2
972;2021-03-26;634;106;12034;4449;3.4;1.2
972;2021-03-27;154;71;12188;4520;3.4;1.3
972;2021-03-28;81;2;12269;4522;3.4;1.3
972;2021-03-29;423;166;12692;4688;3.5;1.3
972;2021-03-30;469;244;13161;4932;3.7;1.4
972;2021-03-31;1151;193;14312;5125;4.0;1.4
972;2021-04-01;955;174;15267;5299;4.3;1.5
972;2021-04-02;896;16;16163;5315;4.5;1.5
972;2021-04-03;789;59;16952;5374;4.7;1.5
972;2021-04-04;751;15;17703;5389;4.9;1.5
972;2021-04-05;828;44;18531;5433;5.2;1.5
972;2021-04-06;885;136;19416;5569;5.4;1.6
972;2021-04-07;1437;332;20853;5901;5.8;1.6
972;2021-04-08;1307;272;22160;6173;6.2;1.7
972;2021-04-09;1239;318;23399;6491;6.5;1.8
972;2021-04-10;838;165;24237;6656;6.8;1.9
972;2021-04-11;620;15;24857;6671;6.9;1.9
972;2021-04-12;869;319;25726;6990;7.2;1.9
972;2021-04-13;880;330;26606;7320;7.4;2.0
972;2021-04-14;959;324;27565;7644;7.7;2.1
972;2021-04-15;960;303;28525;7947;8.0;2.2
972;2021-04-16;996;301;29521;8248;8.2;2.3
972;2021-04-17;529;161;30050;8409;8.4;2.3
972;2021-04-18;339;56;30389;8465;8.5;2.4
972;2021-04-19;668;342;31057;8807;8.7;2.5
972;2021-04-20;865;309;31922;9116;8.9;2.5
972;2021-04-21;1003;354;32925;9470;9.2;2.6
972;2021-04-22;605;312;33530;9782;9.3;2.7
972;2021-04-23;614;465;34144;10247;9.5;2.9
972;2021-04-24;364;197;34508;10444;9.6;2.9
972;2021-04-25;168;200;34676;10644;9.7;3.0
972;2021-04-26;516;541;35192;11185;9.8;3.1
972;2021-04-27;568;607;35760;11792;10.0;3.3
972;2021-04-28;448;691;36208;12483;10.1;3.5
972;2021-04-29;654;643;36862;13126;10.3;3.7
972;2021-04-30;771;686;37633;13812;10.5;3.9
972;2021-05-01;244;246;37877;14058;10.6;3.9
972;2021-05-02;227;513;38104;14571;10.6;4.1
972;2021-05-03;569;770;38673;15341;10.8;4.3
972;2021-05-04;525;678;39198;16019;10.9;4.5
972;2021-05-05;548;897;39746;16916;11.1;4.7
972;2021-05-06;546;785;40292;17701;11.2;4.9
972;2021-05-07;629;1015;40921;18716;11.4;5.2
972;2021-05-08;225;526;41146;19242;11.5;5.4
972;2021-05-09;172;506;41318;19748;11.5;5.5
972;2021-05-10;519;856;41837;20604;11.7;5.7
972;2021-05-11;477;870;42314;21474;11.8;6.0
972;2021-05-12;560;910;42874;22384;12.0;6.2
972;2021-05-13;275;532;43149;22916;12.0;6.4
972;2021-05-14;388;748;43537;23664;12.1;6.6
972;2021-05-15;233;578;43770;24242;12.2;6.8
972;2021-05-16;155;442;43925;24684;12.2;6.9
972;2021-05-17;475;754;44400;25438;12.4;7.1
972;2021-05-18;445;678;44845;26116;12.5;7.3
972;2021-05-19;453;744;45298;26860;12.6;7.5
972;2021-05-20;594;500;45892;27360;12.8;7.6
972;2021-05-21;544;683;46436;28043;12.9;7.8
972;2021-05-22;186;359;46622;28402;13.0;7.9
972;2021-05-23;111;182;46733;28584;13.0;8.0
972;2021-05-24;134;241;46867;28825;13.1;8.0
972;2021-05-25;350;697;47217;29522;13.2;8.2
972;2021-05-26;381;712;47598;30234;13.3;8.4
972;2021-05-27;271;647;47869;30881;13.3;8.6
972;2021-05-28;280;815;48149;31696;13.4;8.8
972;2021-05-29;154;513;48303;32209;13.5;9.0
972;2021-05-30;17;33;48320;32242;13.5;9.0
972;2021-05-31;346;681;48666;32923;13.6;9.2
972;2021-06-01;299;543;48965;33466;13.6;9.3
972;2021-06-02;325;575;49290;34041;13.7;9.5
972;2021-06-03;247;424;49537;34465;13.8;9.6
972;2021-06-04;350;642;49887;35107;13.9;9.8
972;2021-06-05;260;371;50147;35478;14.0;9.9
972;2021-06-06;25;32;50172;35510;14.0;9.9
972;2021-06-07;260;735;50432;36245;14.1;10.1
972;2021-06-08;255;585;50687;36830;14.1;10.3
972;2021-06-09;303;697;50990;37527;14.2;10.5
972;2021-06-10;308;451;51298;37978;14.3;10.6
972;2021-06-11;358;533;51656;38511;14.4;10.7
972;2021-06-12;232;320;51888;38831;14.5;10.8
972;2021-06-13;32;29;51920;38860;14.5;10.8
972;2021-06-14;367;548;52287;39408;14.6;11.0
972;2021-06-15;409;486;52696;39894;14.7;11.1
972;2021-06-16;436;435;53132;40329;14.8;11.2
972;2021-06-17;354;573;53486;40902;14.9;11.4
972;2021-06-18;458;537;53944;41439;15.0;11.6
972;2021-06-19;225;196;54169;41635;15.1;11.6
972;2021-06-20;25;17;54194;41652;15.1;11.6
972;2021-06-21;332;579;54526;42231;15.2;11.8
972;2021-06-22;297;463;54823;42694;15.3;11.9
972;2021-06-23;421;562;55244;43256;15.4;12.1
972;2021-06-24;331;437;55575;43693;15.5;12.2
972;2021-06-25;313;387;55888;44080;15.6;12.3
972;2021-06-26;222;201;56110;44281;15.6;12.3
972;2021-06-27;16;23;56126;44304;15.6;12.3
972;2021-06-28;336;425;56462;44729;15.7;12.5
972;2021-06-29;329;430;56791;45159;15.8;12.6
972;2021-06-30;440;421;57231;45580;16.0;12.7
972;2021-07-01;351;394;57582;45974;16.1;12.8
972;2021-07-02;124;201;57706;46175;16.1;12.9
972;2021-07-03;100;118;57806;46293;16.1;12.9
972;2021-07-04;24;36;57830;46329;16.1;12.9
972;2021-07-05;494;580;58324;46909;16.3;13.1
972;2021-07-06;488;429;58812;47338;16.4;13.2
972;2021-07-07;614;497;59426;47835;16.6;13.3
972;2021-07-08;492;422;59918;48257;16.7;13.5
972;2021-07-09;629;583;60547;48840;16.9;13.6
972;2021-07-10;405;309;60952;49149;17.0;13.7
972;2021-07-11;52;38;61004;49187;17.0;13.7
972;2021-07-12;847;697;61851;49884;17.2;13.9
972;2021-07-13;1475;708;63326;50592;17.7;14.1
972;2021-07-14;133;65;63459;50657;17.7;14.1
972;2021-07-15;1603;681;65062;51338;18.1;14.3
972;2021-07-16;1632;667;66694;52005;18.6;14.5
972;2021-07-17;1094;367;67788;52372;18.9;14.6
972;2021-07-18;56;39;67844;52411;18.9;14.6
972;2021-07-19;1148;654;68992;53065;19.2;14.8
972;2021-07-20;1131;579;70123;53644;19.5;15.0
972;2021-07-21;1089;604;71212;54248;19.9;15.1
972;2021-07-22;906;519;72118;54767;20.1;15.3
972;2021-07-23;969;484;73087;55251;20.4;15.4
972;2021-07-24;506;224;73593;55475;20.5;15.5
972;2021-07-25;50;63;73643;55538;20.5;15.5
972;2021-07-26;685;525;74328;56063;20.7;15.6
972;2021-07-27;1030;516;75358;56579;21.0;15.8
972;2021-07-28;645;562;76003;57141;21.2;15.9
972;2021-07-29;842;550;76845;57691;21.4;16.1
972;2021-07-30;904;615;77749;58306;21.7;16.3
972;2021-07-31;561;276;78310;58582;21.8;16.3
972;2021-08-01;83;33;78393;58615;21.9;16.3
972;2021-08-02;813;817;79206;59432;22.1;16.6
972;2021-08-03;730;743;79936;60175;22.3;16.8
972;2021-08-04;788;572;80724;60747;22.5;16.9
972;2021-08-05;915;590;81639;61337;22.8;17.1
972;2021-08-06;1197;898;82836;62235;23.1;17.3
972;2021-08-07;667;571;83503;62806;23.3;17.5
972;2021-08-08;85;83;83588;62889;23.3;17.5
972;2021-08-09;1130;1064;84718;63953;23.6;17.8
972;2021-08-10;1200;1041;85918;64994;23.9;18.1
972;2021-08-11;1235;921;87153;65915;24.3;18.4
972;2021-08-12;1452;931;88605;66846;24.7;18.6
972;2021-08-13;1317;645;89922;67491;25.1;18.8
972;2021-08-14;851;322;90773;67813;25.3;18.9
972;2021-08-15;70;55;90843;67868;25.3;18.9
972;2021-08-16;1282;1048;92125;68916;25.7;19.2
972;2021-08-17;1177;1187;93302;70103;26.0;19.5
972;2021-08-18;1238;1174;94540;71277;26.4;19.9
972;2021-08-19;1286;892;95826;72169;26.7;20.1
972;2021-08-20;1329;892;97155;73061;27.1;20.4
972;2021-08-21;758;627;97913;73688;27.3;20.5
972;2021-08-22;47;82;97960;73770;27.3;20.6
972;2021-08-23;1182;859;99142;74629;27.6;20.8
972;2021-08-24;1380;881;100522;75510;28.0;21.0
972;2021-08-25;1079;769;101601;76279;28.3;21.3
972;2021-08-26;1280;802;102881;77081;28.7;21.5
972;2021-08-27;1287;1077;104168;78158;29.0;21.8
972;2021-08-28;780;756;104948;78914;29.3;22.0
972;2021-08-29;100;64;105048;78978;29.3;22.0
972;2021-08-30;1142;1111;106190;80089;29.6;22.3
972;2021-08-31;907;1099;107097;81188;29.9;22.6
972;2021-09-01;812;1117;107909;82305;30.1;22.9
972;2021-09-02;879;1189;108788;83494;30.3;23.3
972;2021-09-03;772;1279;109560;84773;30.5;23.6
972;2021-09-04;617;887;110177;85660;30.7;23.9
972;2021-09-05;145;128;110322;85788;30.8;23.9
972;2021-09-06;600;1025;110922;86813;30.9;24.2
972;2021-09-07;639;935;111561;87748;31.1;24.5
972;2021-09-08;593;1128;112154;88876;31.3;24.8
972;2021-09-09;522;1064;112676;89940;31.4;25.1
972;2021-09-10;589;1297;113265;91237;31.6;25.4
972;2021-09-11;490;893;113755;92130;31.7;25.7
972;2021-09-12;109;106;113864;92236;31.7;25.7
972;2021-09-13;489;1085;114353;93321;31.9;26.0
972;2021-09-14;485;1085;114838;94406;32.0;26.3
972;2021-09-15;411;1090;115249;95496;32.1;26.6
972;2021-09-16;403;1069;115652;96565;32.2;26.9
972;2021-09-17;599;1274;116251;97839;32.4;27.3
972;2021-09-18;455;931;116706;98770;32.5;27.5
972;2021-09-19;44;121;116750;98891;32.5;27.6
972;2021-09-20;377;923;117127;99814;32.6;27.8
972;2021-09-21;431;990;117558;100804;32.8;28.1
972;2021-09-22;363;856;117921;101660;32.9;28.3
972;2021-09-23;411;826;118332;102486;33.0;28.6
972;2021-09-24;468;980;118800;103466;33.1;28.8
972;2021-09-25;333;835;119133;104301;33.2;29.1
972;2021-09-26;30;183;119163;104484;33.2;29.1
972;2021-09-27;303;667;119466;105151;33.3;29.3
972;2021-09-28;410;670;119876;105821;33.4;29.5
972;2021-09-29;364;645;120240;106466;33.5;29.7
972;2021-09-30;477;669;120717;107135;33.6;29.9
972;2021-10-01;539;755;121256;107890;33.8;30.1
972;2021-10-02;369;610;121625;108500;33.9;30.2
972;2021-10-03;40;79;121665;108579;33.9;30.3
972;2021-10-04;370;457;122035;109036;34.0;30.4
972;2021-10-05;370;542;122405;109578;34.1;30.5
972;2021-10-06;391;513;122796;110091;34.2;30.7
972;2021-10-07;400;498;123196;110589;34.3;30.8
972;2021-10-08;521;627;123717;111216;34.5;31.0
972;2021-10-09;416;524;124133;111740;34.6;31.1
972;2021-10-10;34;66;124167;111806;34.6;31.2
972;2021-10-11;451;464;124618;112270;34.7;31.3
972;2021-10-12;406;417;125024;112687;34.8;31.4
972;2021-10-13;491;535;125515;113222;35.0;31.6
972;2021-10-14;434;431;125949;113653;35.1;31.7
972;2021-10-15;452;439;126401;114092;35.2;31.8
972;2021-10-16;358;568;126759;114660;35.3;32.0
972;2021-10-17;41;64;126800;114724;35.3;32.0
972;2021-10-18;350;318;127150;115042;35.4;32.1
972;2021-10-19;303;403;127453;115445;35.5;32.2
973;2020-12-27;0;0;0;0;0.0;0.0
973;2020-12-28;0;0;0;0;0.0;0.0
973;2020-12-29;0;0;0;0;0.0;0.0
973;2020-12-30;0;0;0;0;0.0;0.0
973;2020-12-31;0;0;0;0;0.0;0.0
973;2021-01-01;0;0;0;0;0.0;0.0
973;2021-01-02;1;1;1;1;0.0;0.0
973;2021-01-03;0;0;1;1;0.0;0.0
973;2021-01-04;0;0;1;1;0.0;0.0
973;2021-01-05;0;0;1;1;0.0;0.0
973;2021-01-06;0;0;1;1;0.0;0.0
973;2021-01-07;0;0;1;1;0.0;0.0
973;2021-01-08;0;0;1;1;0.0;0.0
973;2021-01-09;0;0;1;1;0.0;0.0
973;2021-01-10;0;0;1;1;0.0;0.0
973;2021-01-11;0;0;1;1;0.0;0.0
973;2021-01-12;0;0;1;1;0.0;0.0
973;2021-01-13;30;0;31;1;0.0;0.0
973;2021-01-14;46;0;77;1;0.0;0.0
973;2021-01-15;35;0;112;1;0.0;0.0
973;2021-01-16;18;1;130;2;0.0;0.0
973;2021-01-17;0;0;130;2;0.0;0.0
973;2021-01-18;63;0;193;2;0.1;0.0
973;2021-01-19;151;1;344;3;0.1;0.0
973;2021-01-20;133;0;477;3;0.2;0.0
973;2021-01-21;118;0;595;3;0.2;0.0
973;2021-01-22;76;0;671;3;0.2;0.0
973;2021-01-23;0;0;671;3;0.2;0.0
973;2021-01-24;0;0;671;3;0.2;0.0
973;2021-01-25;56;0;727;3;0.3;0.0
973;2021-01-26;100;2;827;5;0.3;0.0
973;2021-01-27;109;1;936;6;0.3;0.0
973;2021-01-28;96;3;1032;9;0.4;0.0
973;2021-01-29;104;3;1136;12;0.4;0.0
973;2021-01-30;0;0;1136;12;0.4;0.0
973;2021-01-31;0;0;1136;12;0.4;0.0
973;2021-02-01;54;0;1190;12;0.4;0.0
973;2021-02-02;122;5;1312;17;0.5;0.0
973;2021-02-03;119;7;1431;24;0.5;0.0
973;2021-02-04;79;25;1510;49;0.5;0.0
973;2021-02-05;66;8;1576;57;0.5;0.0
973;2021-02-06;0;0;1576;57;0.5;0.0
973;2021-02-07;0;0;1576;57;0.5;0.0
973;2021-02-08;52;12;1628;69;0.6;0.0
973;2021-02-09;92;39;1720;108;0.6;0.0
973;2021-02-10;101;41;1821;149;0.6;0.1
973;2021-02-11;105;93;1926;242;0.7;0.1
973;2021-02-12;89;63;2015;305;0.7;0.1
973;2021-02-13;0;0;2015;305;0.7;0.1
973;2021-02-14;0;0;2015;305;0.7;0.1
973;2021-02-15;28;65;2043;370;0.7;0.1
973;2021-02-16;123;52;2166;422;0.7;0.1
973;2021-02-17;145;118;2311;540;0.8;0.2
973;2021-02-18;105;139;2416;679;0.8;0.2
973;2021-02-19;122;72;2538;751;0.9;0.3
973;2021-02-20;0;0;2538;751;0.9;0.3
973;2021-02-21;0;0;2538;751;0.9;0.3
973;2021-02-22;78;48;2616;799;0.9;0.3
973;2021-02-23;158;103;2774;902;1.0;0.3
973;2021-02-24;189;124;2963;1026;1.0;0.4
973;2021-02-25;259;92;3222;1118;1.1;0.4
973;2021-02-26;264;71;3486;1189;1.2;0.4
973;2021-02-27;121;2;3607;1191;1.2;0.4
973;2021-02-28;0;0;3607;1191;1.2;0.4
973;2021-03-01;182;88;3789;1279;1.3;0.4
973;2021-03-02;257;108;4046;1387;1.4;0.5
973;2021-03-03;256;131;4302;1518;1.5;0.5
973;2021-03-04;280;87;4582;1605;1.6;0.6
973;2021-03-05;274;48;4856;1653;1.7;0.6
973;2021-03-06;118;2;4974;1655;1.7;0.6
973;2021-03-07;0;0;4974;1655;1.7;0.6
973;2021-03-08;188;42;5162;1697;1.8;0.6
973;2021-03-09;353;93;5515;1790;1.9;0.6
973;2021-03-10;360;120;5875;1910;2.0;0.7
973;2021-03-11;271;113;6146;2023;2.1;0.7
973;2021-03-12;288;97;6434;2120;2.2;0.7
973;2021-03-13;112;4;6546;2124;2.3;0.7
973;2021-03-14;0;0;6546;2124;2.3;0.7
973;2021-03-15;181;27;6727;2151;2.3;0.7
973;2021-03-16;243;142;6970;2293;2.4;0.8
973;2021-03-17;274;129;7244;2422;2.5;0.8
973;2021-03-18;249;157;7493;2579;2.6;0.9
973;2021-03-19;283;129;7776;2708;2.7;0.9
973;2021-03-20;260;22;8036;2730;2.8;0.9
973;2021-03-21;119;4;8155;2734;2.8;0.9
973;2021-03-22;219;109;8374;2843;2.9;1.0
973;2021-03-23;276;195;8650;3038;3.0;1.0
973;2021-03-24;236;214;8886;3252;3.1;1.1
973;2021-03-25;167;180;9053;3432;3.1;1.2
973;2021-03-26;189;307;9242;3739;3.2;1.3
973;2021-03-27;58;94;9300;3833;3.2;1.3
973;2021-03-28;0;0;9300;3833;3.2;1.3
973;2021-03-29;175;249;9475;4082;3.3;1.4
973;2021-03-30;445;239;9920;4321;3.4;1.5
973;2021-03-31;318;293;10238;4614;3.5;1.6
973;2021-04-01;445;262;10683;4876;3.7;1.7
973;2021-04-02;309;283;10992;5159;3.8;1.8
973;2021-04-03;159;126;11151;5285;3.8;1.8
973;2021-04-04;0;0;11151;5285;3.8;1.8
973;2021-04-05;118;15;11269;5300;3.9;1.8
973;2021-04-06;441;337;11710;5637;4.0;1.9
973;2021-04-07;502;345;12212;5982;4.2;2.1
973;2021-04-08;513;270;12725;6252;4.4;2.2
973;2021-04-09;498;227;13223;6479;4.5;2.2
973;2021-04-10;147;91;13370;6570;4.6;2.3
973;2021-04-11;2;0;13372;6570;4.6;2.3
973;2021-04-12;551;270;13923;6840;4.8;2.4
973;2021-04-13;673;245;14596;7085;5.0;2.4
973;2021-04-14;721;316;15317;7401;5.3;2.5
973;2021-04-15;776;248;16093;7649;5.5;2.6
973;2021-04-16;761;306;16854;7955;5.8;2.7
973;2021-04-17;499;138;17353;8093;6.0;2.8
973;2021-04-18;499;47;17852;8140;6.1;2.8
973;2021-04-19;715;254;18567;8394;6.4;2.9
973;2021-04-20;607;280;19174;8674;6.6;3.0
973;2021-04-21;873;251;20047;8925;6.9;3.1
973;2021-04-22;727;233;20774;9158;7.1;3.2
973;2021-04-23;705;234;21479;9392;7.4;3.2
973;2021-04-24;524;99;22003;9491;7.6;3.3
973;2021-04-25;611;50;22614;9541;7.8;3.3
973;2021-04-26;779;233;23393;9774;8.0;3.4
973;2021-04-27;817;349;24210;10123;8.3;3.5
973;2021-04-28;746;332;24956;10455;8.6;3.6
973;2021-04-29;666;287;25622;10742;8.8;3.7
973;2021-04-30;711;261;26333;11003;9.1;3.8
973;2021-05-01;211;29;26544;11032;9.1;3.8
973;2021-05-02;602;86;27146;11118;9.3;3.8
973;2021-05-03;555;395;27701;11513;9.5;4.0
973;2021-05-04;657;327;28358;11840;9.8;4.1
973;2021-05-05;699;457;29057;12297;10.0;4.2
973;2021-05-06;694;479;29751;12776;10.2;4.4
973;2021-05-07;582;474;30333;13250;10.4;4.6
973;2021-05-08;343;60;30676;13310;10.6;4.6
973;2021-05-09;262;72;30938;13382;10.6;4.6
973;2021-05-10;433;612;31371;13994;10.8;4.8
973;2021-05-11;390;497;31761;14491;10.9;5.0
973;2021-05-12;504;647;32265;15138;11.1;5.2
973;2021-05-13;329;99;32594;15237;11.2;5.2
973;2021-05-14;486;555;33080;15792;11.4;5.4
973;2021-05-15;257;348;33337;16140;11.5;5.6
973;2021-05-16;207;210;33544;16350;11.5;5.6
973;2021-05-17;447;599;33991;16949;11.7;5.8
973;2021-05-18;564;568;34555;17517;11.9;6.0
973;2021-05-19;534;552;35089;18069;12.1;6.2
973;2021-05-20;643;451;35732;18520;12.3;6.4
973;2021-05-21;505;609;36237;19129;12.5;6.6
973;2021-05-22;167;500;36404;19629;12.5;6.8
973;2021-05-23;271;475;36675;20104;12.6;6.9
973;2021-05-24;562;249;37237;20353;12.8;7.0
973;2021-05-25;501;745;37738;21098;13.0;7.3
973;2021-05-26;453;684;38191;21782;13.1;7.5
973;2021-05-27;712;528;38903;22310;13.4;7.7
973;2021-05-28;580;554;39483;22864;13.6;7.9
973;2021-05-29;256;360;39739;23224;13.7;8.0
973;2021-05-30;151;399;39890;23623;13.7;8.1
973;2021-05-31;356;573;40246;24196;13.8;8.3
973;2021-06-01;421;468;40667;24664;14.0;8.5
973;2021-06-02;567;554;41234;25218;14.2;8.7
973;2021-06-03;525;470;41759;25688;14.4;8.8
973;2021-06-04;601;495;42360;26183;14.6;9.0
973;2021-06-05;273;292;42633;26475;14.7;9.1
973;2021-06-06;211;301;42844;26776;14.7;9.2
973;2021-06-07;488;450;43332;27226;14.9;9.4
973;2021-06-08;544;316;43876;27542;15.1;9.5
973;2021-06-09;530;390;44406;27932;15.3;9.6
973;2021-06-10;360;291;44766;28223;15.4;9.7
973;2021-06-11;436;466;45202;28689;15.5;9.9
973;2021-06-12;170;283;45372;28972;15.6;10.0
973;2021-06-13;215;269;45587;29241;15.7;10.1
973;2021-06-14;384;549;45971;29790;15.8;10.2
973;2021-06-15;377;445;46348;30235;15.9;10.4
973;2021-06-16;491;459;46839;30694;16.1;10.6
973;2021-06-17;442;578;47281;31272;16.3;10.8
973;2021-06-18;390;562;47671;31834;16.4;11.0
973;2021-06-19;235;260;47906;32094;16.5;11.0
973;2021-06-20;126;270;48032;32364;16.5;11.1
973;2021-06-21;336;601;48368;32965;16.6;11.3
973;2021-06-22;376;462;48744;33427;16.8;11.5
973;2021-06-23;344;539;49088;33966;16.9;11.7
973;2021-06-24;446;500;49534;34466;17.0;11.9
973;2021-06-25;445;559;49979;35025;17.2;12.0
973;2021-06-26;173;320;50152;35345;17.3;12.2
973;2021-06-27;121;170;50273;35515;17.3;12.2
973;2021-06-28;314;593;50587;36108;17.4;12.4
973;2021-06-29;376;506;50963;36614;17.5;12.6
973;2021-06-30;410;680;51373;37294;17.7;12.8
973;2021-07-01;431;399;51804;37693;17.8;13.0
973;2021-07-02;512;525;52316;38218;18.0;13.1
973;2021-07-03;211;275;52527;38493;18.1;13.2
973;2021-07-04;87;243;52614;38736;18.1;13.3
973;2021-07-05;361;546;52975;39282;18.2;13.5
973;2021-07-06;373;474;53348;39756;18.4;13.7
973;2021-07-07;374;415;53722;40171;18.5;13.8
973;2021-07-08;316;328;54038;40499;18.6;13.9
973;2021-07-09;392;434;54430;40933;18.7;14.1
973;2021-07-10;168;278;54598;41211;18.8;14.2
973;2021-07-11;102;163;54700;41374;18.8;14.2
973;2021-07-12;403;497;55103;41871;19.0;14.4
973;2021-07-13;682;558;55785;42429;19.2;14.6
973;2021-07-14;394;161;56179;42590;19.3;14.7
973;2021-07-15;658;527;56837;43117;19.6;14.8
973;2021-07-16;602;485;57439;43602;19.8;15.0
973;2021-07-17;345;285;57784;43887;19.9;15.1
973;2021-07-18;251;124;58035;44011;20.0;15.1
973;2021-07-19;524;459;58559;44470;20.1;15.3
973;2021-07-20;585;494;59144;44964;20.3;15.5
973;2021-07-21;725;397;59869;45361;20.6;15.6
973;2021-07-22;660;452;60529;45813;20.8;15.8
973;2021-07-23;609;370;61138;46183;21.0;15.9
973;2021-07-24;327;241;61465;46424;21.1;16.0
973;2021-07-25;166;111;61631;46535;21.2;16.0
973;2021-07-26;448;347;62079;46882;21.4;16.1
973;2021-07-27;554;358;62633;47240;21.5;16.3
973;2021-07-28;468;370;63101;47610;21.7;16.4
973;2021-07-29;536;432;63637;48042;21.9;16.5
973;2021-07-30;541;408;64178;48450;22.1;16.7
973;2021-07-31;204;163;64382;48613;22.1;16.7
973;2021-08-01;139;132;64521;48745;22.2;16.8
973;2021-08-02;398;432;64919;49177;22.3;16.9
973;2021-08-03;434;402;65353;49579;22.5;17.1
973;2021-08-04;309;375;65662;49954;22.6;17.2
973;2021-08-05;343;363;66005;50317;22.7;17.3
973;2021-08-06;364;524;66369;50841;22.8;17.5
973;2021-08-07;164;266;66533;51107;22.9;17.6
973;2021-08-08;123;177;66656;51284;22.9;17.6
973;2021-08-09;332;473;66988;51757;23.0;17.8
973;2021-08-10;363;516;67351;52273;23.2;18.0
973;2021-08-11;584;519;67935;52792;23.4;18.2
973;2021-08-12;551;584;68486;53376;23.6;18.4
973;2021-08-13;367;234;68853;53610;23.7;18.4
973;2021-08-14;254;401;69107;54011;23.8;18.6
973;2021-08-15;123;138;69230;54149;23.8;18.6
973;2021-08-16;308;473;69538;54622;23.9;18.8
973;2021-08-17;372;401;69910;55023;24.0;18.9
973;2021-08-18;369;446;70279;55469;24.2;19.1
973;2021-08-19;331;483;70610;55952;24.3;19.2
973;2021-08-20;313;401;70923;56353;24.4;19.4
973;2021-08-21;161;257;71084;56610;24.5;19.5
973;2021-08-22;115;183;71199;56793;24.5;19.5
973;2021-08-23;286;385;71485;57178;24.6;19.7
973;2021-08-24;313;465;71798;57643;24.7;19.8
973;2021-08-25;299;351;72097;57994;24.8;20.0
973;2021-08-26;322;404;72419;58398;24.9;20.1
973;2021-08-27;368;426;72787;58824;25.0;20.2
973;2021-08-28;143;266;72930;59090;25.1;20.3
973;2021-08-29;87;187;73017;59277;25.1;20.4
973;2021-08-30;222;338;73239;59615;25.2;20.5
973;2021-08-31;312;371;73551;59986;25.3;20.6
973;2021-09-01;264;393;73815;60379;25.4;20.8
973;2021-09-02;317;386;74132;60765;25.5;20.9
973;2021-09-03;285;342;74417;61107;25.6;21.0
973;2021-09-04;147;199;74564;61306;25.7;21.1
973;2021-09-05;72;88;74636;61394;25.7;21.1
973;2021-09-06;185;232;74821;61626;25.7;21.2
973;2021-09-07;222;257;75043;61883;25.8;21.3
973;2021-09-08;222;397;75265;62280;25.9;21.4
973;2021-09-09;240;290;75505;62570;26.0;21.5
973;2021-09-10;228;314;75733;62884;26.1;21.6
973;2021-09-11;125;292;75858;63176;26.1;21.7
973;2021-09-12;60;95;75918;63271;26.1;21.8
973;2021-09-13;234;226;76152;63497;26.2;21.8
973;2021-09-14;265;295;76417;63792;26.3;21.9
973;2021-09-15;349;332;76766;64124;26.4;22.1
973;2021-09-16;265;240;77031;64364;26.5;22.1
973;2021-09-17;217;243;77248;64607;26.6;22.2
973;2021-09-18;116;244;77364;64851;26.6;22.3
973;2021-09-19;56;150;77420;65001;26.6;22.4
973;2021-09-20;152;187;77572;65188;26.7;22.4
973;2021-09-21;195;209;77767;65397;26.8;22.5
973;2021-09-22;186;350;77953;65747;26.8;22.6
973;2021-09-23;246;241;78199;65988;26.9;22.7
973;2021-09-24;257;308;78456;66296;27.0;22.8
973;2021-09-25;113;257;78569;66553;27.0;22.9
973;2021-09-26;39;94;78608;66647;27.0;22.9
973;2021-09-27;157;168;78765;66815;27.1;23.0
973;2021-09-28;159;205;78924;67020;27.2;23.1
973;2021-09-29;204;237;79128;67257;27.2;23.1
973;2021-09-30;291;304;79419;67561;27.3;23.2
973;2021-10-01;200;219;79619;67780;27.4;23.3
973;2021-10-02;104;169;79723;67949;27.4;23.4
973;2021-10-03;60;92;79783;68041;27.4;23.4
973;2021-10-04;199;209;79982;68250;27.5;23.5
973;2021-10-05;174;177;80156;68427;27.6;23.5
973;2021-10-06;198;205;80354;68632;27.6;23.6
973;2021-10-07;218;174;80572;68806;27.7;23.7
973;2021-10-08;226;202;80798;69008;27.8;23.7
973;2021-10-09;107;153;80905;69161;27.8;23.8
973;2021-10-10;46;74;80951;69235;27.8;23.8
973;2021-10-11;154;176;81105;69411;27.9;23.9
973;2021-10-12;200;180;81305;69591;28.0;23.9
973;2021-10-13;209;288;81514;69879;28.0;24.0
973;2021-10-14;238;293;81752;70172;28.1;24.1
973;2021-10-15;207;209;81959;70381;28.2;24.2
973;2021-10-16;110;126;82069;70507;28.2;24.3
973;2021-10-17;28;58;82097;70565;28.2;24.3
973;2021-10-18;120;131;82217;70696;28.3;24.3
973;2021-10-19;147;161;82364;70857;28.3;24.4
974;2020-12-27;0;0;0;0;0.0;0.0
974;2020-12-28;0;0;0;0;0.0;0.0
974;2020-12-29;0;0;0;0;0.0;0.0
974;2020-12-30;0;0;0;0;0.0;0.0
974;2020-12-31;0;0;0;0;0.0;0.0
974;2021-01-01;1;0;1;0;0.0;0.0
974;2021-01-02;0;0;1;0;0.0;0.0
974;2021-01-03;0;0;1;0;0.0;0.0
974;2021-01-04;0;0;1;0;0.0;0.0
974;2021-01-05;2;0;3;0;0.0;0.0
974;2021-01-06;0;0;3;0;0.0;0.0
974;2021-01-07;0;0;3;0;0.0;0.0
974;2021-01-08;0;0;3;0;0.0;0.0
974;2021-01-09;1;0;4;0;0.0;0.0
974;2021-01-10;0;0;4;0;0.0;0.0
974;2021-01-11;0;0;4;0;0.0;0.0
974;2021-01-12;0;0;4;0;0.0;0.0
974;2021-01-13;0;0;4;0;0.0;0.0
974;2021-01-14;0;0;4;0;0.0;0.0
974;2021-01-15;336;0;340;0;0.0;0.0
974;2021-01-16;28;0;368;0;0.0;0.0
974;2021-01-17;0;0;368;0;0.0;0.0
974;2021-01-18;49;1;417;1;0.0;0.0
974;2021-01-19;394;0;811;1;0.1;0.0
974;2021-01-20;485;1;1296;2;0.2;0.0
974;2021-01-21;614;2;1910;4;0.2;0.0
974;2021-01-22;414;1;2324;5;0.3;0.0
974;2021-01-23;75;0;2399;5;0.3;0.0
974;2021-01-24;0;0;2399;5;0.3;0.0
974;2021-01-25;274;2;2673;7;0.3;0.0
974;2021-01-26;428;0;3101;7;0.4;0.0
974;2021-01-27;316;0;3417;7;0.4;0.0
974;2021-01-28;409;1;3826;8;0.4;0.0
974;2021-01-29;422;3;4248;11;0.5;0.0
974;2021-01-30;421;1;4669;12;0.5;0.0
974;2021-01-31;0;0;4669;12;0.5;0.0
974;2021-02-01;373;4;5042;16;0.6;0.0
974;2021-02-02;503;3;5545;19;0.6;0.0
974;2021-02-03;602;14;6147;33;0.7;0.0
974;2021-02-04;629;21;6776;54;0.8;0.0
974;2021-02-05;564;97;7340;151;0.9;0.0
974;2021-02-06;501;6;7841;157;0.9;0.0
974;2021-02-07;0;8;7841;165;0.9;0.0
974;2021-02-08;470;34;8311;199;1.0;0.0
974;2021-02-09;787;93;9098;292;1.1;0.0
974;2021-02-10;820;87;9918;379;1.2;0.0
974;2021-02-11;795;89;10713;468;1.2;0.1
974;2021-02-12;638;95;11351;563;1.3;0.1
974;2021-02-13;655;76;12006;639;1.4;0.1
974;2021-02-14;1;0;12007;639;1.4;0.1
974;2021-02-15;526;129;12533;768;1.5;0.1
974;2021-02-16;651;532;13184;1300;1.5;0.2
974;2021-02-17;593;327;13777;1627;1.6;0.2
974;2021-02-18;495;409;14272;2036;1.7;0.2
974;2021-02-19;497;318;14769;2354;1.7;0.3
974;2021-02-20;577;116;15346;2470;1.8;0.3
974;2021-02-21;0;0;15346;2470;1.8;0.3
974;2021-02-22;403;237;15749;2707;1.8;0.3
974;2021-02-23;609;241;16358;2948;1.9;0.3
974;2021-02-24;583;254;16941;3202;2.0;0.4
974;2021-02-25;649;296;17590;3498;2.0;0.4
974;2021-02-26;485;468;18075;3966;2.1;0.5
974;2021-02-27;385;466;18460;4432;2.1;0.5
974;2021-02-28;0;0;18460;4432;2.1;0.5
974;2021-03-01;293;384;18753;4816;2.2;0.6
974;2021-03-02;487;500;19240;5316;2.2;0.6
974;2021-03-03;758;537;19998;5853;2.3;0.7
974;2021-03-04;778;492;20776;6345;2.4;0.7
974;2021-03-05;729;519;21505;6864;2.5;0.8
974;2021-03-06;814;526;22319;7390;2.6;0.9
974;2021-03-07;0;0;22319;7390;2.6;0.9
974;2021-03-08;436;554;22755;7944;2.6;0.9
974;2021-03-09;671;771;23426;8715;2.7;1.0
974;2021-03-10;644;837;24070;9552;2.8;1.1
974;2021-03-11;699;626;24769;10178;2.9;1.2
974;2021-03-12;732;656;25501;10834;3.0;1.3
974;2021-03-13;669;599;26170;11433;3.0;1.3
974;2021-03-14;2;0;26172;11433;3.0;1.3
974;2021-03-15;508;491;26680;11924;3.1;1.4
974;2021-03-16;681;693;27361;12617;3.2;1.5
974;2021-03-17;847;522;28208;13139;3.3;1.5
974;2021-03-18;1022;503;29230;13642;3.4;1.6
974;2021-03-19;786;528;30016;14170;3.5;1.6
974;2021-03-20;578;593;30594;14763;3.6;1.7
974;2021-03-21;0;0;30594;14763;3.6;1.7
974;2021-03-22;566;467;31160;15230;3.6;1.8
974;2021-03-23;780;635;31940;15865;3.7;1.8
974;2021-03-24;790;640;32730;16505;3.8;1.9
974;2021-03-25;934;539;33664;17044;3.9;2.0
974;2021-03-26;923;452;34587;17496;4.0;2.0
974;2021-03-27;782;335;35369;17831;4.1;2.1
974;2021-03-28;1;0;35370;17831;4.1;2.1
974;2021-03-29;960;272;36330;18103;4.2;2.1
974;2021-03-30;884;495;37214;18598;4.3;2.2
974;2021-03-31;736;657;37950;19255;4.4;2.2
974;2021-04-01;718;706;38668;19961;4.5;2.3
974;2021-04-02;688;756;39356;20717;4.6;2.4
974;2021-04-03;699;700;40055;21417;4.7;2.5
974;2021-04-04;0;0;40055;21417;4.7;2.5
974;2021-04-05;0;0;40055;21417;4.7;2.5
974;2021-04-06;796;634;40851;22051;4.8;2.6
974;2021-04-07;1367;783;42218;22834;4.9;2.7
974;2021-04-08;1792;771;44010;23605;5.1;2.7
974;2021-04-09;1508;777;45518;24382;5.3;2.8
974;2021-04-10;1137;650;46655;25032;5.4;2.9
974;2021-04-11;2;0;46657;25032;5.4;2.9
974;2021-04-12;1238;548;47895;25580;5.6;3.0
974;2021-04-13;1439;751;49334;26331;5.7;3.1
974;2021-04-14;2066;771;51400;27102;6.0;3.2
974;2021-04-15;2510;957;53910;28059;6.3;3.3
974;2021-04-16;1936;786;55846;28845;6.5;3.4
974;2021-04-17;1290;604;57136;29449;6.6;3.4
974;2021-04-18;0;0;57136;29449;6.6;3.4
974;2021-04-19;1374;564;58510;30013;6.8;3.5
974;2021-04-20;1651;805;60161;30818;7.0;3.6
974;2021-04-21;2124;626;62285;31444;7.2;3.7
974;2021-04-22;2952;822;65237;32266;7.6;3.8
974;2021-04-23;2311;822;67548;33088;7.9;3.8
974;2021-04-24;1111;805;68659;33893;8.0;3.9
974;2021-04-25;3;0;68662;33893;8.0;3.9
974;2021-04-26;1172;911;69834;34804;8.1;4.0
974;2021-04-27;1687;1029;71521;35833;8.3;4.2
974;2021-04-28;2902;752;74423;36585;8.7;4.3
974;2021-04-29;3947;819;78370;37404;9.1;4.3
974;2021-04-30;3450;913;81820;38317;9.5;4.5
974;2021-05-01;2106;231;83926;38548;9.8;4.5
974;2021-05-02;1;0;83927;38548;9.8;4.5
974;2021-05-03;1865;576;85792;39124;10.0;4.5
974;2021-05-04;2127;1093;87919;40217;10.2;4.7
974;2021-05-05;3118;1648;91037;41865;10.6;4.9
974;2021-05-06;4001;1590;95038;43455;11.1;5.1
974;2021-05-07;3228;1525;98266;44980;11.4;5.2
974;2021-05-08;1578;507;99844;45487;11.6;5.3
974;2021-05-09;2;1;99846;45488;11.6;5.3
974;2021-05-10;2412;1001;102258;46489;11.9;5.4
974;2021-05-11;3650;1641;105908;48130;12.3;5.6
974;2021-05-12;4721;2403;110629;50533;12.9;5.9
974;2021-05-13;3553;600;114182;51133;13.3;5.9
974;2021-05-14;5276;2521;119458;53654;13.9;6.2
974;2021-05-15;3157;1537;122615;55191;14.3;6.4
974;2021-05-16;17;19;122632;55210;14.3;6.4
974;2021-05-17;2994;1498;125626;56708;14.6;6.6
974;2021-05-18;3765;1803;129391;58511;15.0;6.8
974;2021-05-19;4687;2435;134078;60946;15.6;7.1
974;2021-05-20;5137;2853;139215;63799;16.2;7.4
974;2021-05-21;4997;2631;144212;66430;16.8;7.7
974;2021-05-22;3372;1256;147584;67686;17.2;7.9
974;2021-05-23;6;3;147590;67689;17.2;7.9
974;2021-05-24;3645;1078;151235;68767;17.6;8.0
974;2021-05-25;4247;1923;155482;70690;18.1;8.2
974;2021-05-26;4984;2992;160466;73682;18.7;8.6
974;2021-05-27;4619;4102;165085;77784;19.2;9.0
974;2021-05-28;4384;3837;169469;81621;19.7;9.5
974;2021-05-29;2554;2457;172023;84078;20.0;9.8
974;2021-05-30;8;14;172031;84092;20.0;9.8
974;2021-05-31;2347;2251;174378;86343;20.3;10.0
974;2021-06-01;3302;2762;177680;89105;20.7;10.4
974;2021-06-02;3969;3366;181649;92471;21.1;10.8
974;2021-06-03;4042;3653;185691;96124;21.6;11.2
974;2021-06-04;3849;3758;189540;99882;22.0;11.6
974;2021-06-05;2213;1932;191753;101814;22.3;11.8
974;2021-06-06;1074;135;192827;101949;22.4;11.9
974;2021-06-07;2012;2526;194839;104475;22.7;12.1
974;2021-06-08;2558;3340;197397;107815;23.0;12.5
974;2021-06-09;2982;4839;200379;112654;23.3;13.1
974;2021-06-10;3411;4466;203790;117120;23.7;13.6
974;2021-06-11;2839;4622;206629;121742;24.0;14.2
974;2021-06-12;1726;3379;208355;125121;24.2;14.5
974;2021-06-13;1324;246;209679;125367;24.4;14.6
974;2021-06-14;1489;3181;211168;128548;24.6;14.9
974;2021-06-15;2060;3617;213228;132165;24.8;15.4
974;2021-06-16;2748;4664;215976;136829;25.1;15.9
974;2021-06-17;2522;4896;218498;141725;25.4;16.5
974;2021-06-18;2596;4890;221094;146615;25.7;17.0
974;2021-06-19;1300;3516;222394;150131;25.9;17.5
974;2021-06-20;633;289;223027;150420;25.9;17.5
974;2021-06-21;1265;3235;224292;153655;26.1;17.9
974;2021-06-22;1618;3761;225910;157416;26.3;18.3
974;2021-06-23;2258;4995;228168;162411;26.5;18.9
974;2021-06-24;2280;4069;230448;166480;26.8;19.4
974;2021-06-25;2188;4107;232636;170587;27.1;19.8
974;2021-06-26;1401;2712;234037;173299;27.2;20.2
974;2021-06-27;664;268;234701;173567;27.3;20.2
974;2021-06-28;1307;2481;236008;176048;27.4;20.5
974;2021-06-29;1755;2846;237763;178894;27.6;20.8
974;2021-06-30;2560;3843;240323;182737;27.9;21.2
974;2021-07-01;2699;3826;243022;186563;28.3;21.7
974;2021-07-02;2511;3708;245533;190271;28.6;22.1
974;2021-07-03;1613;2457;247146;192728;28.7;22.4
974;2021-07-04;881;1039;248027;193767;28.8;22.5
974;2021-07-05;1698;2223;249725;195990;29.0;22.8
974;2021-07-06;2570;2548;252295;198538;29.3;23.1
974;2021-07-07;2665;3135;254960;201673;29.6;23.5
974;2021-07-08;2418;3173;257378;204846;29.9;23.8
974;2021-07-09;2762;3429;260140;208275;30.3;24.2
974;2021-07-10;1618;2192;261758;210467;30.4;24.5
974;2021-07-11;729;1017;262487;211484;30.5;24.6
974;2021-07-12;1745;2605;264232;214089;30.7;24.9
974;2021-07-13;4433;3348;268665;217437;31.2;25.3
974;2021-07-14;3300;608;271965;218045;31.6;25.4
974;2021-07-15;5556;4024;277521;222069;32.3;25.8
974;2021-07-16;6239;3304;283760;225373;33.0;26.2
974;2021-07-17;4374;1913;288134;227286;33.5;26.4
974;2021-07-18;2673;765;290807;228051;33.8;26.5
974;2021-07-19;4650;2031;295457;230082;34.4;26.8
974;2021-07-20;6232;2434;301689;232516;35.1;27.0
974;2021-07-21;6745;2863;308434;235379;35.9;27.4
974;2021-07-22;7141;2825;315575;238204;36.7;27.7
974;2021-07-23;6642;2984;322217;241188;37.5;28.0
974;2021-07-24;3801;2067;326018;243255;37.9;28.3
974;2021-07-25;2522;754;328540;244009;38.2;28.4
974;2021-07-26;4371;2098;332911;246107;38.7;28.6
974;2021-07-27;5444;2563;338355;248670;39.3;28.9
974;2021-07-28;5395;2909;343750;251579;40.0;29.3
974;2021-07-29;5743;2817;349493;254396;40.6;29.6
974;2021-07-30;5877;2583;355370;256979;41.3;29.9
974;2021-07-31;3936;1650;359306;258629;41.8;30.1
974;2021-08-01;1907;716;361213;259345;42.0;30.2
974;2021-08-02;3436;1869;364649;261214;42.4;30.4
974;2021-08-03;4301;4075;368950;265289;42.9;30.8
974;2021-08-04;4878;4232;373828;269521;43.5;31.3
974;2021-08-05;4446;4667;378274;274188;44.0;31.9
974;2021-08-06;4082;5105;382356;279293;44.5;32.5
974;2021-08-07;2748;4043;385104;283336;44.8;32.9
974;2021-08-08;1482;2265;386586;285601;45.0;33.2
974;2021-08-09;2573;4528;389159;290129;45.3;33.7
974;2021-08-10;3789;4966;392948;295095;45.7;34.3
974;2021-08-11;4645;5450;397593;300545;46.2;34.9
974;2021-08-12;4714;5917;402307;306462;46.8;35.6
974;2021-08-13;4458;5828;406765;312290;47.3;36.3
974;2021-08-14;2607;4329;409372;316619;47.6;36.8
974;2021-08-15;1573;2175;410945;318794;47.8;37.1
974;2021-08-16;2345;4182;413290;322976;48.1;37.6
974;2021-08-17;3187;4525;416477;327501;48.4;38.1
974;2021-08-18;3346;5900;419823;333401;48.8;38.8
974;2021-08-19;3311;4908;423134;338309;49.2;39.3
974;2021-08-20;3442;5274;426576;343583;49.6;40.0
974;2021-08-21;1832;4617;428408;348200;49.8;40.5
974;2021-08-22;1019;1944;429427;350144;49.9;40.7
974;2021-08-23;1816;3328;431243;353472;50.1;41.1
974;2021-08-24;2461;3774;433704;357246;50.4;41.5
974;2021-08-25;2908;5217;436612;362463;50.8;42.1
974;2021-08-26;2668;3871;439280;366334;51.1;42.6
974;2021-08-27;2780;4012;442060;370346;51.4;43.1
974;2021-08-28;1864;3884;443924;374230;51.6;43.5
974;2021-08-29;759;1574;444683;375804;51.7;43.7
974;2021-08-30;1565;2529;446248;378333;51.9;44.0
974;2021-08-31;1866;3333;448114;381666;52.1;44.4
974;2021-09-01;2405;4874;450519;386540;52.4;44.9
974;2021-09-02;2259;4281;452778;390821;52.7;45.4
974;2021-09-03;2339;4473;455117;395294;52.9;46.0
974;2021-09-04;1586;3890;456703;399184;53.1;46.4
974;2021-09-05;607;1309;457310;400493;53.2;46.6
974;2021-09-06;1215;2500;458525;402993;53.3;46.9
974;2021-09-07;1365;3111;459890;406104;53.5;47.2
974;2021-09-08;2120;3885;462010;409989;53.7;47.7
974;2021-09-09;1802;3329;463812;413318;53.9;48.1
974;2021-09-10;1932;3723;465744;417041;54.2;48.5
974;2021-09-11;1537;2469;467281;419510;54.3;48.8
974;2021-09-12;391;961;467672;420471;54.4;48.9
974;2021-09-13;1086;1847;468758;422318;54.5;49.1
974;2021-09-14;1521;2329;470279;424647;54.7;49.4
974;2021-09-15;1827;3034;472106;427681;54.9;49.7
974;2021-09-16;1405;2784;473511;430465;55.1;50.1
974;2021-09-17;1503;3065;475014;433530;55.2;50.4
974;2021-09-18;1205;1955;476219;435485;55.4;50.6
974;2021-09-19;293;716;476512;436201;55.4;50.7
974;2021-09-20;725;1633;477237;437834;55.5;50.9
974;2021-09-21;842;1816;478079;439650;55.6;51.1
974;2021-09-22;1263;2518;479342;442168;55.7;51.4
974;2021-09-23;847;2119;480189;444287;55.8;51.7
974;2021-09-24;1103;2477;481292;446764;56.0;52.0
974;2021-09-25;767;1878;482059;448642;56.1;52.2
974;2021-09-26;160;520;482219;449162;56.1;52.2
974;2021-09-27;607;1071;482826;450233;56.1;52.4
974;2021-09-28;850;1537;483676;451770;56.2;52.5
974;2021-09-29;1200;2328;484876;454098;56.4;52.8
974;2021-09-30;999;1753;485875;455851;56.5;53.0
974;2021-10-01;1278;1989;487153;457840;56.6;53.2
974;2021-10-02;945;1469;488098;459309;56.8;53.4
974;2021-10-03;267;387;488365;459696;56.8;53.5
974;2021-10-04;723;1151;489088;460847;56.9;53.6
974;2021-10-05;961;1345;490049;462192;57.0;53.7
974;2021-10-06;1197;1915;491246;464107;57.1;54.0
974;2021-10-07;992;1480;492238;465587;57.2;54.1
974;2021-10-08;1146;1805;493384;467392;57.4;54.4
974;2021-10-09;905;1328;494289;468720;57.5;54.5
974;2021-10-10;211;239;494500;468959;57.5;54.5
974;2021-10-11;1036;946;495536;469905;57.6;54.6
974;2021-10-12;1152;979;496688;470884;57.8;54.8
974;2021-10-13;1355;1484;498043;472368;57.9;54.9
974;2021-10-14;1346;1015;499389;473383;58.1;55.0
974;2021-10-15;1386;1283;500775;474666;58.2;55.2
974;2021-10-16;726;816;501501;475482;58.3;55.3
974;2021-10-17;142;159;501643;475641;58.3;55.3
974;2021-10-18;877;760;502520;476401;58.4;55.4
974;2021-10-19;993;928;503513;477329;58.6;55.5
976;2020-12-27;0;0;0;0;0.0;0.0
976;2020-12-28;0;0;0;0;0.0;0.0
976;2020-12-29;0;0;0;0;0.0;0.0
976;2020-12-30;0;0;0;0;0.0;0.0
976;2020-12-31;0;0;0;0;0.0;0.0
976;2021-01-01;0;0;0;0;0.0;0.0
976;2021-01-02;0;0;0;0;0.0;0.0
976;2021-01-03;0;0;0;0;0.0;0.0
976;2021-01-04;0;0;0;0;0.0;0.0
976;2021-01-05;0;0;0;0;0.0;0.0
976;2021-01-06;0;0;0;0;0.0;0.0
976;2021-01-07;0;0;0;0;0.0;0.0
976;2021-01-08;0;0;0;0;0.0;0.0
976;2021-01-09;0;0;0;0;0.0;0.0
976;2021-01-10;0;0;0;0;0.0;0.0
976;2021-01-11;9;0;9;0;0.0;0.0
976;2021-01-12;0;0;9;0;0.0;0.0
976;2021-01-13;0;0;9;0;0.0;0.0
976;2021-01-14;0;0;9;0;0.0;0.0
976;2021-01-15;1;0;10;0;0.0;0.0
976;2021-01-16;1;0;11;0;0.0;0.0
976;2021-01-17;0;0;11;0;0.0;0.0
976;2021-01-18;1;0;12;0;0.0;0.0
976;2021-01-19;0;0;12;0;0.0;0.0
976;2021-01-20;0;0;12;0;0.0;0.0
976;2021-01-21;1;1;13;1;0.0;0.0
976;2021-01-22;0;0;13;1;0.0;0.0
976;2021-01-23;1;0;14;1;0.0;0.0
976;2021-01-24;0;0;14;1;0.0;0.0
976;2021-01-25;144;3;158;4;0.1;0.0
976;2021-01-26;167;3;325;7;0.1;0.0
976;2021-01-27;250;4;575;11;0.2;0.0
976;2021-01-28;104;9;679;20;0.2;0.0
976;2021-01-29;234;5;913;25;0.3;0.0
976;2021-01-30;286;11;1199;36;0.4;0.0
976;2021-01-31;1;0;1200;36;0.4;0.0
976;2021-02-01;161;2;1361;38;0.5;0.0
976;2021-02-02;328;11;1689;49;0.6;0.0
976;2021-02-03;227;4;1916;53;0.7;0.0
976;2021-02-04;215;10;2131;63;0.8;0.0
976;2021-02-05;213;1;2344;64;0.8;0.0
976;2021-02-06;83;10;2427;74;0.9;0.0
976;2021-02-07;0;0;2427;74;0.9;0.0
976;2021-02-08;82;4;2509;78;0.9;0.0
976;2021-02-09;194;2;2703;80;1.0;0.0
976;2021-02-10;187;5;2890;85;1.0;0.0
976;2021-02-11;236;6;3126;91;1.1;0.0
976;2021-02-12;288;7;3414;98;1.2;0.0
976;2021-02-13;56;0;3470;98;1.2;0.0
976;2021-02-14;2;0;3472;98;1.2;0.0
976;2021-02-15;359;11;3831;109;1.4;0.0
976;2021-02-16;266;11;4097;120;1.5;0.0
976;2021-02-17;167;9;4264;129;1.5;0.0
976;2021-02-18;217;16;4481;145;1.6;0.1
976;2021-02-19;237;24;4718;169;1.7;0.1
976;2021-02-20;138;9;4856;178;1.7;0.1
976;2021-02-21;0;0;4856;178;1.7;0.1
976;2021-02-22;130;121;4986;299;1.8;0.1
976;2021-02-23;185;156;5171;455;1.9;0.2
976;2021-02-24;176;146;5347;601;1.9;0.2
976;2021-02-25;227;278;5574;879;2.0;0.3
976;2021-02-26;242;247;5816;1126;2.1;0.4
976;2021-02-27;0;0;5816;1126;2.1;0.4
976;2021-02-28;0;0;5816;1126;2.1;0.4
976;2021-03-01;147;259;5963;1385;2.1;0.5
976;2021-03-02;228;260;6191;1645;2.2;0.6
976;2021-03-03;202;190;6393;1835;2.3;0.7
976;2021-03-04;205;145;6598;1980;2.4;0.7
976;2021-03-05;225;118;6823;2098;2.4;0.8
976;2021-03-06;1;0;6824;2098;2.4;0.8
976;2021-03-07;1;0;6825;2098;2.4;0.8
976;2021-03-08;189;112;7014;2210;2.5;0.8
976;2021-03-09;390;164;7404;2374;2.6;0.8
976;2021-03-10;179;178;7583;2552;2.7;0.9
976;2021-03-11;167;209;7750;2761;2.8;1.0
976;2021-03-12;237;294;7987;3055;2.9;1.1
976;2021-03-13;3;1;7990;3056;2.9;1.1
976;2021-03-14;0;0;7990;3056;2.9;1.1
976;2021-03-15;157;295;8147;3351;2.9;1.2
976;2021-03-16;238;227;8385;3578;3.0;1.3
976;2021-03-17;264;147;8649;3725;3.1;1.3
976;2021-03-18;174;235;8823;3960;3.2;1.4
976;2021-03-19;174;298;8997;4258;3.2;1.5
976;2021-03-20;0;0;8997;4258;3.2;1.5
976;2021-03-21;0;0;8997;4258;3.2;1.5
976;2021-03-22;97;136;9094;4394;3.3;1.6
976;2021-03-23;136;239;9230;4633;3.3;1.7
976;2021-03-24;160;147;9390;4780;3.4;1.7
976;2021-03-25;184;206;9574;4986;3.4;1.8
976;2021-03-26;160;212;9734;5198;3.5;1.9
976;2021-03-27;18;0;9752;5198;3.5;1.9
976;2021-03-28;1;0;9753;5198;3.5;1.9
976;2021-03-29;0;2;9753;5200;3.5;1.9
976;2021-03-30;272;337;10025;5537;3.6;2.0
976;2021-03-31;225;124;10250;5661;3.7;2.0
976;2021-04-01;246;105;10496;5766;3.8;2.1
976;2021-04-02;286;263;10782;6029;3.9;2.2
976;2021-04-03;905;310;11687;6339;4.2;2.3
976;2021-04-04;2;0;11689;6339;4.2;2.3
976;2021-04-05;1;0;11690;6339;4.2;2.3
976;2021-04-06;161;277;11851;6616;4.2;2.4
976;2021-04-07;236;267;12087;6883;4.3;2.5
976;2021-04-08;283;140;12370;7023;4.4;2.5
976;2021-04-09;248;172;12618;7195;4.5;2.6
976;2021-04-10;181;114;12799;7309;4.6;2.6
976;2021-04-11;7;0;12806;7309;4.6;2.6
976;2021-04-12;0;19;12806;7328;4.6;2.6
976;2021-04-13;395;346;13201;7674;4.7;2.7
976;2021-04-14;239;206;13440;7880;4.8;2.8
976;2021-04-15;209;117;13649;7997;4.9;2.9
976;2021-04-16;216;127;13865;8124;5.0;2.9
976;2021-04-17;225;130;14090;8254;5.0;3.0
976;2021-04-18;1;0;14091;8254;5.0;3.0
976;2021-04-19;7;1;14098;8255;5.0;3.0
976;2021-04-20;367;222;14465;8477;5.2;3.0
976;2021-04-21;412;151;14877;8628;5.3;3.1
976;2021-04-22;410;151;15287;8779;5.5;3.1
976;2021-04-23;366;166;15653;8945;5.6;3.2
976;2021-04-24;414;130;16067;9075;5.7;3.2
976;2021-04-25;3;0;16070;9075;5.8;3.2
976;2021-04-26;55;8;16125;9083;5.8;3.3
976;2021-04-27;350;292;16475;9375;5.9;3.4
976;2021-04-28;355;514;16830;9889;6.0;3.5
976;2021-04-29;559;344;17389;10233;6.2;3.7
976;2021-04-30;408;239;17797;10472;6.4;3.7
976;2021-05-01;672;288;18469;10760;6.6;3.9
976;2021-05-02;0;0;18469;10760;6.6;3.9
976;2021-05-03;140;6;18609;10766;6.7;3.9
976;2021-05-04;355;426;18964;11192;6.8;4.0
976;2021-05-05;447;318;19411;11510;6.9;4.1
976;2021-05-06;320;203;19731;11713;7.1;4.2
976;2021-05-07;341;133;20072;11846;7.2;4.2
976;2021-05-08;309;142;20381;11988;7.3;4.3
976;2021-05-09;0;0;20381;11988;7.3;4.3
976;2021-05-10;9;9;20390;11997;7.3;4.3
976;2021-05-11;363;493;20753;12490;7.4;4.5
976;2021-05-12;334;310;21087;12800;7.5;4.6
976;2021-05-13;126;96;21213;12896;7.6;4.6
976;2021-05-14;0;0;21213;12896;7.6;4.6
976;2021-05-15;485;282;21698;13178;7.8;4.7
976;2021-05-16;1;0;21699;13178;7.8;4.7
976;2021-05-17;124;51;21823;13229;7.8;4.7
976;2021-05-18;518;430;22341;13659;8.0;4.9
976;2021-05-19;651;663;22992;14322;8.2;5.1
976;2021-05-20;1056;499;24048;14821;8.6;5.3
976;2021-05-21;1045;313;25093;15134;9.0;5.4
976;2021-05-22;1241;298;26334;15432;9.4;5.5
976;2021-05-23;0;0;26334;15432;9.4;5.5
976;2021-05-24;1;0;26335;15432;9.4;5.5
976;2021-05-25;890;622;27225;16054;9.7;5.7
976;2021-05-26;1033;843;28258;16897;10.1;6.0
976;2021-05-27;1322;512;29580;17409;10.6;6.2
976;2021-05-28;956;375;30536;17784;10.9;6.4
976;2021-05-29;1130;392;31666;18176;11.3;6.5
976;2021-05-30;1;1;31667;18177;11.3;6.5
976;2021-05-31;107;6;31774;18183;11.4;6.5
976;2021-06-01;1149;653;32923;18836;11.8;6.7
976;2021-06-02;1243;532;34166;19368;12.2;6.9
976;2021-06-03;814;355;34980;19723;12.5;7.1
976;2021-06-04;1000;325;35980;20048;12.9;7.2
976;2021-06-05;680;299;36660;20347;13.1;7.3
976;2021-06-06;1;0;36661;20347;13.1;7.3
976;2021-06-07;93;12;36754;20359;13.2;7.3
976;2021-06-08;952;442;37706;20801;13.5;7.4
976;2021-06-09;969;550;38675;21351;13.8;7.6
976;2021-06-10;713;232;39388;21583;14.1;7.7
976;2021-06-11;851;365;40239;21948;14.4;7.9
976;2021-06-12;583;275;40822;22223;14.6;8.0
976;2021-06-13;4;0;40826;22223;14.6;8.0
976;2021-06-14;187;112;41013;22335;14.7;8.0
976;2021-06-15;412;838;41425;23173;14.8;8.3
976;2021-06-16;891;1441;42316;24614;15.1;8.8
976;2021-06-17;799;661;43115;25275;15.4;9.0
976;2021-06-18;705;620;43820;25895;15.7;9.3
976;2021-06-19;537;645;44357;26540;15.9;9.5
976;2021-06-20;1;0;44358;26540;15.9;9.5
976;2021-06-21;127;132;44485;26672;15.9;9.5
976;2021-06-22;430;1150;44915;27822;16.1;10.0
976;2021-06-23;695;1186;45610;29008;16.3;10.4
976;2021-06-24;480;544;46090;29552;16.5;10.6
976;2021-06-25;542;479;46632;30031;16.7;10.7
976;2021-06-26;386;692;47018;30723;16.8;11.0
976;2021-06-27;1;0;47019;30723;16.8;11.0
976;2021-06-28;109;191;47128;30914;16.9;11.1
976;2021-06-29;746;973;47874;31887;17.1;11.4
976;2021-06-30;716;948;48590;32835;17.4;11.7
976;2021-07-01;591;547;49181;33382;17.6;11.9
976;2021-07-02;451;432;49632;33814;17.8;12.1
976;2021-07-03;443;422;50075;34236;17.9;12.3
976;2021-07-04;2;0;50077;34236;17.9;12.3
976;2021-07-05;121;223;50198;34459;18.0;12.3
976;2021-07-06;498;865;50696;35324;18.1;12.6
976;2021-07-07;772;1014;51468;36338;18.4;13.0
976;2021-07-08;838;636;52306;36974;18.7;13.2
976;2021-07-09;786;519;53092;37493;19.0;13.4
976;2021-07-10;441;319;53533;37812;19.2;13.5
976;2021-07-11;0;0;53533;37812;19.2;13.5
976;2021-07-12;164;170;53697;37982;19.2;13.6
976;2021-07-13;847;1000;54544;38982;19.5;13.9
976;2021-07-14;1;5;54545;38987;19.5;14.0
976;2021-07-15;1223;812;55768;39799;20.0;14.2
976;2021-07-16;1291;656;57059;40455;20.4;14.5
976;2021-07-17;1033;377;58092;40832;20.8;14.6
976;2021-07-18;0;0;58092;40832;20.8;14.6
976;2021-07-19;206;134;58298;40966;20.9;14.7
976;2021-07-20;1155;877;59453;41843;21.3;15.0
976;2021-07-21;34;29;59487;41872;21.3;15.0
976;2021-07-22;1123;666;60610;42538;21.7;15.2
976;2021-07-23;1206;545;61816;43083;22.1;15.4
976;2021-07-24;855;440;62671;43523;22.4;15.6
976;2021-07-25;2;0;62673;43523;22.4;15.6
976;2021-07-26;180;37;62853;43560;22.5;15.6
976;2021-07-27;1139;827;63992;44387;22.9;15.9
976;2021-07-28;1047;635;65039;45022;23.3;16.1
976;2021-07-29;1233;566;66272;45588;23.7;16.3
976;2021-07-30;1216;412;67488;46000;24.1;16.5
976;2021-07-31;760;277;68248;46277;24.4;16.6
976;2021-08-01;5;3;68253;46280;24.4;16.6
976;2021-08-02;344;174;68597;46454;24.5;16.6
976;2021-08-03;1509;935;70106;47389;25.1;17.0
976;2021-08-04;1828;809;71934;48198;25.7;17.2
976;2021-08-05;1467;504;73401;48702;26.3;17.4
976;2021-08-06;1699;511;75100;49213;26.9;17.6
976;2021-08-07;912;358;76012;49571;27.2;17.7
976;2021-08-08;7;1;76019;49572;27.2;17.7
976;2021-08-09;545;236;76564;49808;27.4;17.8
976;2021-08-10;1642;1380;78206;51188;28.0;18.3
976;2021-08-11;2045;1242;80251;52430;28.7;18.8
976;2021-08-12;1718;621;81969;53051;29.3;19.0
976;2021-08-13;1575;537;83544;53588;29.9;19.2
976;2021-08-14;836;458;84380;54046;30.2;19.3
976;2021-08-15;0;0;84380;54046;30.2;19.3
976;2021-08-16;569;291;84949;54337;30.4;19.4
976;2021-08-17;1829;1307;86778;55644;31.1;19.9
976;2021-08-18;2235;1230;89013;56874;31.9;20.4
976;2021-08-19;1982;562;90995;57436;32.6;20.6
976;2021-08-20;1820;561;92815;57997;33.2;20.8
976;2021-08-21;1063;531;93878;58528;33.6;20.9
976;2021-08-22;15;0;93893;58528;33.6;20.9
976;2021-08-23;579;271;94472;58799;33.8;21.0
976;2021-08-24;1067;1010;95539;59809;34.2;21.4
976;2021-08-25;1085;1296;96624;61105;34.6;21.9
976;2021-08-26;913;574;97537;61679;34.9;22.1
976;2021-08-27;741;566;98278;62245;35.2;22.3
976;2021-08-28;472;857;98750;63102;35.3;22.6
976;2021-08-29;0;12;98750;63114;35.3;22.6
976;2021-08-30;160;253;98910;63367;35.4;22.7
976;2021-08-31;655;1159;99565;64526;35.6;23.1
976;2021-09-01;822;1392;100387;65918;35.9;23.6
976;2021-09-02;851;903;101238;66821;36.2;23.9
976;2021-09-03;911;1288;102149;68109;36.6;24.4
976;2021-09-04;435;1002;102584;69111;36.7;24.7
976;2021-09-05;0;1;102584;69112;36.7;24.7
976;2021-09-06;445;397;103029;69509;36.9;24.9
976;2021-09-07;743;699;103772;70208;37.1;25.1
976;2021-09-08;1113;1262;104885;71470;37.5;25.6
976;2021-09-09;895;1009;105780;72479;37.9;25.9
976;2021-09-10;1237;1081;107017;73560;38.3;26.3
976;2021-09-11;537;1035;107554;74595;38.5;26.7
976;2021-09-12;1;32;107555;74627;38.5;26.7
976;2021-09-13;710;616;108265;75243;38.7;26.9
976;2021-09-14;1111;720;109376;75963;39.1;27.2
976;2021-09-15;1691;1185;111067;77148;39.7;27.6
976;2021-09-16;1748;895;112815;78043;40.4;27.9
976;2021-09-17;1853;1063;114668;79106;41.0;28.3
976;2021-09-18;986;781;115654;79887;41.4;28.6
976;2021-09-19;2;52;115656;79939;41.4;28.6
976;2021-09-20;1026;543;116682;80482;41.8;28.8
976;2021-09-21;1691;774;118373;81256;42.4;29.1
976;2021-09-22;1479;972;119852;82228;42.9;29.4
976;2021-09-23;1023;879;120875;83107;43.3;29.7
976;2021-09-24;1115;1013;121990;84120;43.7;30.1
976;2021-09-25;490;482;122480;84602;43.8;30.3
976;2021-09-26;0;21;122480;84623;43.8;30.3
976;2021-09-27;693;423;123173;85046;44.1;30.4
976;2021-09-28;1168;926;124341;85972;44.5;30.8
976;2021-09-29;1335;1059;125676;87031;45.0;31.1
976;2021-09-30;997;689;126673;87720;45.3;31.4
976;2021-10-01;1262;1369;127935;89089;45.8;31.9
976;2021-10-02;456;649;128391;89738;45.9;32.1
976;2021-10-03;0;0;128391;89738;45.9;32.1
976;2021-10-04;746;618;129137;90356;46.2;32.3
976;2021-10-05;780;968;129917;91324;46.5;32.7
976;2021-10-06;1204;1405;131121;92729;46.9;33.2
976;2021-10-07;804;1128;131925;93857;47.2;33.6
976;2021-10-08;1258;1393;133183;95250;47.7;34.1
976;2021-10-09;464;857;133647;96107;47.8;34.4
976;2021-10-10;0;0;133647;96107;47.8;34.4
976;2021-10-11;1047;710;134694;96817;48.2;34.6
976;2021-10-12;1353;1478;136047;98295;48.7;35.2
976;2021-10-13;1511;1732;137558;100027;49.2;35.8
976;2021-10-14;1285;1382;138843;101409;49.7;36.3
976;2021-10-15;1071;1152;139914;102561;50.1;36.7
976;2021-10-16;427;590;140341;103151;50.2;36.9
976;2021-10-17;0;0;140341;103151;50.2;36.9
976;2021-10-18;655;619;140996;103770;50.5;37.1
976;2021-10-19;84;142;141080;103912;50.5;37.2
977;2020-12-27;0;0;0;0;0.0;0.0
977;2020-12-28;0;0;0;0;0.0;0.0
977;2020-12-29;0;0;0;0;0.0;0.0
977;2020-12-30;0;0;0;0;0.0;0.0
977;2020-12-31;0;0;0;0;0.0;0.0
977;2021-01-01;0;0;0;0;0.0;0.0
977;2021-01-02;0;0;0;0;0.0;0.0
977;2021-01-03;0;0;0;0;0.0;0.0
977;2021-01-04;0;0;0;0;0.0;0.0
977;2021-01-05;0;0;0;0;0.0;0.0
977;2021-01-06;0;0;0;0;0.0;0.0
977;2021-01-07;0;0;0;0;0.0;0.0
977;2021-01-08;0;0;0;0;0.0;0.0
977;2021-01-09;0;0;0;0;0.0;0.0
977;2021-01-10;0;0;0;0;0.0;0.0
977;2021-01-11;0;0;0;0;0.0;0.0
977;2021-01-12;0;0;0;0;0.0;0.0
977;2021-01-13;0;0;0;0;0.0;0.0
977;2021-01-14;0;0;0;0;0.0;0.0
977;2021-01-15;0;0;0;0;0.0;0.0
977;2021-01-16;0;0;0;0;0.0;0.0
977;2021-01-17;0;0;0;0;0.0;0.0
977;2021-01-18;1;0;1;0;0.0;0.0
977;2021-01-19;0;0;1;0;0.0;0.0
977;2021-01-20;0;0;1;0;0.0;0.0
977;2021-01-21;12;0;13;0;0.1;0.0
977;2021-01-22;12;0;25;0;0.3;0.0
977;2021-01-23;0;0;25;0;0.3;0.0
977;2021-01-24;0;0;25;0;0.3;0.0
977;2021-01-25;0;0;25;0;0.3;0.0
977;2021-01-26;0;0;25;0;0.3;0.0
977;2021-01-27;12;0;37;0;0.4;0.0
977;2021-01-28;1;0;38;0;0.4;0.0
977;2021-01-29;6;0;44;0;0.4;0.0
977;2021-01-30;0;0;44;0;0.4;0.0
977;2021-01-31;0;0;44;0;0.4;0.0
977;2021-02-01;0;0;44;0;0.4;0.0
977;2021-02-02;0;0;44;0;0.4;0.0
977;2021-02-03;11;0;55;0;0.6;0.0
977;2021-02-04;12;0;67;0;0.7;0.0
977;2021-02-05;11;0;78;0;0.8;0.0
977;2021-02-06;0;0;78;0;0.8;0.0
977;2021-02-07;0;0;78;0;0.8;0.0
977;2021-02-08;0;0;78;0;0.8;0.0
977;2021-02-09;14;0;92;0;0.9;0.0
977;2021-02-10;0;0;92;0;0.9;0.0
977;2021-02-11;18;0;110;0;1.1;0.0
977;2021-02-12;46;0;156;0;1.6;0.0
977;2021-02-13;0;0;156;0;1.6;0.0
977;2021-02-14;0;0;156;0;1.6;0.0
977;2021-02-15;0;0;156;0;1.6;0.0
977;2021-02-16;0;0;156;0;1.6;0.0
977;2021-02-17;0;0;156;0;1.6;0.0
977;2021-02-18;20;0;176;0;1.8;0.0
977;2021-02-19;35;0;211;0;2.1;0.0
977;2021-02-20;0;0;211;0;2.1;0.0
977;2021-02-21;0;0;211;0;2.1;0.0
977;2021-02-22;0;0;211;0;2.1;0.0
977;2021-02-23;0;21;211;21;2.1;0.2
977;2021-02-24;0;0;211;21;2.1;0.2
977;2021-02-25;15;9;226;30;2.3;0.3
977;2021-02-26;33;18;259;48;2.6;0.5
977;2021-02-27;0;0;259;48;2.6;0.5
977;2021-02-28;0;0;259;48;2.6;0.5
977;2021-03-01;0;0;259;48;2.6;0.5
977;2021-03-02;19;11;278;59;2.8;0.6
977;2021-03-03;0;0;278;59;2.8;0.6
977;2021-03-04;16;12;294;71;3.0;0.7
977;2021-03-05;35;18;329;89;3.3;0.9
977;2021-03-06;0;0;329;89;3.3;0.9
977;2021-03-07;0;0;329;89;3.3;0.9
977;2021-03-08;0;0;329;89;3.3;0.9
977;2021-03-09;1;0;330;89;3.3;0.9
977;2021-03-10;0;0;330;89;3.3;0.9
977;2021-03-11;20;30;350;119;3.5;1.2
977;2021-03-12;62;42;412;161;4.1;1.6
977;2021-03-13;0;0;412;161;4.1;1.6
977;2021-03-14;0;0;412;161;4.1;1.6
977;2021-03-15;0;0;412;161;4.1;1.6
977;2021-03-16;30;10;442;171;4.4;1.7
977;2021-03-17;0;0;442;171;4.4;1.7
977;2021-03-18;30;16;472;187;4.7;1.9
977;2021-03-19;58;28;530;215;5.3;2.2
977;2021-03-20;0;0;530;215;5.3;2.2
977;2021-03-21;0;0;530;215;5.3;2.2
977;2021-03-22;0;0;530;215;5.3;2.2
977;2021-03-23;0;0;530;215;5.3;2.2
977;2021-03-24;0;0;530;215;5.3;2.2
977;2021-03-25;65;17;595;232;6.0;2.3
977;2021-03-26;73;26;668;258;6.7;2.6
977;2021-03-27;0;0;668;258;6.7;2.6
977;2021-03-28;0;0;668;258;6.7;2.6
977;2021-03-29;0;0;668;258;6.7;2.6
977;2021-03-30;39;17;707;275;7.1;2.8
977;2021-03-31;26;15;733;290;7.4;2.9
977;2021-04-01;25;32;758;322;7.6;3.2
977;2021-04-02;0;0;758;322;7.6;3.2
977;2021-04-03;0;0;758;322;7.6;3.2
977;2021-04-04;0;0;758;322;7.6;3.2
977;2021-04-05;9;0;767;322;7.7;3.2
977;2021-04-06;0;0;767;322;7.7;3.2
977;2021-04-07;0;0;767;322;7.7;3.2
977;2021-04-08;57;46;824;368;8.3;3.7
977;2021-04-09;58;32;882;400;8.9;4.0
977;2021-04-10;0;0;882;400;8.9;4.0
977;2021-04-11;0;0;882;400;8.9;4.0
977;2021-04-12;0;0;882;400;8.9;4.0
977;2021-04-13;0;0;882;400;8.9;4.0
977;2021-04-14;5;5;887;405;8.9;4.1
977;2021-04-15;57;70;944;475;9.5;4.8
977;2021-04-16;89;35;1033;510;10.4;5.1
977;2021-04-17;0;1;1033;511;10.4;5.1
977;2021-04-18;0;0;1033;511;10.4;5.1
977;2021-04-19;1;0;1034;511;10.4;5.1
977;2021-04-20;335;62;1369;573;13.7;5.8
977;2021-04-21;337;30;1706;603;17.1;6.1
977;2021-04-22;284;48;1990;651;20.0;6.5
977;2021-04-23;260;43;2250;694;22.6;7.0
977;2021-04-24;231;1;2481;695;24.9;7.0
977;2021-04-25;0;0;2481;695;24.9;7.0
977;2021-04-26;284;20;2765;715;27.8;7.2
977;2021-04-27;224;68;2989;783;30.0;7.9
977;2021-04-28;192;26;3181;809;31.9;8.1
977;2021-04-29;170;23;3351;832;33.6;8.4
977;2021-04-30;171;17;3522;849;35.4;8.5
977;2021-05-01;202;12;3724;861;37.4;8.6
977;2021-05-02;0;0;3724;861;37.4;8.6
977;2021-05-03;135;9;3859;870;38.7;8.7
977;2021-05-04;161;54;4020;924;40.4;9.3
977;2021-05-05;221;28;4241;952;42.6;9.6
977;2021-05-06;175;34;4416;986;44.3;9.9
977;2021-05-07;149;32;4565;1018;45.8;10.2
977;2021-05-08;1;0;4566;1018;45.8;10.2
977;2021-05-09;0;0;4566;1018;45.8;10.2
977;2021-05-10;0;0;4566;1018;45.8;10.2
977;2021-05-11;3;41;4569;1059;45.9;10.6
977;2021-05-12;6;36;4575;1095;45.9;11.0
977;2021-05-13;0;0;4575;1095;45.9;11.0
977;2021-05-14;28;98;4603;1193;46.2;12.0
977;2021-05-15;0;0;4603;1193;46.2;12.0
977;2021-05-16;1;0;4604;1193;46.2;12.0
977;2021-05-17;1;14;4605;1207;46.2;12.1
977;2021-05-18;17;32;4622;1239;46.4;12.4
977;2021-05-19;1;2;4623;1241;46.4;12.5
977;2021-05-20;0;8;4623;1249;46.4;12.5
977;2021-05-21;12;31;4635;1280;46.5;12.9
977;2021-05-22;0;0;4635;1280;46.5;12.9
977;2021-05-23;0;0;4635;1280;46.5;12.9
977;2021-05-24;0;0;4635;1280;46.5;12.9
977;2021-05-25;50;331;4685;1611;47.0;16.2
977;2021-05-26;53;360;4738;1971;47.6;19.8
977;2021-05-27;34;317;4772;2288;47.9;23.0
977;2021-05-28;27;256;4799;2544;48.2;25.5
977;2021-05-29;35;375;4834;2919;48.5;29.3
977;2021-05-30;1;0;4835;2919;48.5;29.3
977;2021-05-31;45;216;4880;3135;49.0;31.5
977;2021-06-01;48;227;4928;3362;49.5;33.8
977;2021-06-02;69;273;4997;3635;50.2;36.5
977;2021-06-03;43;252;5040;3887;50.6;39.0
977;2021-06-04;82;270;5122;4157;51.4;41.7
977;2021-06-05;1;0;5123;4157;51.4;41.7
977;2021-06-06;0;0;5123;4157;51.4;41.7
977;2021-06-07;1;1;5124;4158;51.4;41.7
977;2021-06-08;8;2;5132;4160;51.5;41.8
977;2021-06-09;0;3;5132;4163;51.5;41.8
977;2021-06-10;8;4;5140;4167;51.6;41.8
977;2021-06-11;4;8;5144;4175;51.6;41.9
977;2021-06-12;15;59;5159;4234;51.8;42.5
977;2021-06-13;0;0;5159;4234;51.8;42.5
977;2021-06-14;0;0;5159;4234;51.8;42.5
977;2021-06-15;0;1;5159;4235;51.8;42.5
977;2021-06-16;0;0;5159;4235;51.8;42.5
977;2021-06-17;2;6;5161;4241;51.8;42.6
977;2021-06-18;0;2;5161;4243;51.8;42.6
977;2021-06-19;25;49;5186;4292;52.1;43.1
977;2021-06-20;0;0;5186;4292;52.1;43.1
977;2021-06-21;1;2;5187;4294;52.1;43.1
977;2021-06-22;9;0;5196;4294;52.2;43.1
977;2021-06-23;15;9;5211;4303;52.3;43.2
977;2021-06-24;10;5;5221;4308;52.4;43.2
977;2021-06-25;0;0;5221;4308;52.4;43.2
977;2021-06-26;25;45;5246;4353;52.7;43.7
977;2021-06-27;0;0;5246;4353;52.7;43.7
977;2021-06-28;0;0;5246;4353;52.7;43.7
977;2021-06-29;0;0;5246;4353;52.7;43.7
977;2021-06-30;0;0;5246;4353;52.7;43.7
977;2021-07-01;28;36;5274;4389;52.9;44.1
977;2021-07-02;26;31;5300;4420;53.2;44.4
977;2021-07-03;30;215;5330;4635;53.5;46.5
977;2021-07-04;0;0;5330;4635;53.5;46.5
977;2021-07-05;4;8;5334;4643;53.5;46.6
977;2021-07-06;0;0;5334;4643;53.5;46.6
977;2021-07-07;8;0;5342;4643;53.6;46.6
977;2021-07-08;33;23;5375;4666;54.0;46.8
977;2021-07-09;23;31;5398;4697;54.2;47.2
977;2021-07-10;33;45;5431;4742;54.5;47.6
977;2021-07-11;0;0;5431;4742;54.5;47.6
977;2021-07-12;0;1;5431;4743;54.5;47.6
977;2021-07-13;10;10;5441;4753;54.6;47.7
977;2021-07-14;0;0;5441;4753;54.6;47.7
977;2021-07-15;1;11;5442;4764;54.6;47.8
977;2021-07-16;44;51;5486;4815;55.1;48.3
977;2021-07-17;34;39;5520;4854;55.4;48.7
977;2021-07-18;1;0;5521;4854;55.4;48.7
977;2021-07-19;3;2;5524;4856;55.5;48.8
977;2021-07-20;3;1;5527;4857;55.5;48.8
977;2021-07-21;33;16;5560;4873;55.8;48.9
977;2021-07-22;36;33;5596;4906;56.2;49.3
977;2021-07-23;32;31;5628;4937;56.5;49.6
977;2021-07-24;42;25;5670;4962;56.9;49.8
977;2021-07-25;0;0;5670;4962;56.9;49.8
977;2021-07-26;13;10;5683;4972;57.1;49.9
977;2021-07-27;0;10;5683;4982;57.1;50.0
977;2021-07-28;31;14;5714;4996;57.4;50.2
977;2021-07-29;33;32;5747;5028;57.7;50.5
977;2021-07-30;31;28;5778;5056;58.0;50.8
977;2021-07-31;53;24;5831;5080;58.5;51.0
977;2021-08-01;0;0;5831;5080;58.5;51.0
977;2021-08-02;11;1;5842;5081;58.6;51.0
977;2021-08-03;0;0;5842;5081;58.6;51.0
977;2021-08-04;40;14;5882;5095;59.1;51.1
977;2021-08-05;28;30;5910;5125;59.3;51.5
977;2021-08-06;35;35;5945;5160;59.7;51.8
977;2021-08-07;56;25;6001;5185;60.2;52.1
977;2021-08-08;0;0;6001;5185;60.2;52.1
977;2021-08-09;7;5;6008;5190;60.3;52.1
977;2021-08-10;15;9;6023;5199;60.5;52.2
977;2021-08-11;36;18;6059;5217;60.8;52.4
977;2021-08-12;24;30;6083;5247;61.1;52.7
977;2021-08-13;32;14;6115;5261;61.4;52.8
977;2021-08-14;20;26;6135;5287;61.6;53.1
977;2021-08-15;0;0;6135;5287;61.6;53.1
977;2021-08-16;14;29;6149;5316;61.7;53.4
977;2021-08-17;15;8;6164;5324;61.9;53.4
977;2021-08-18;25;28;6189;5352;62.1;53.7
977;2021-08-19;31;36;6220;5388;62.4;54.1
977;2021-08-20;27;41;6247;5429;62.7;54.5
977;2021-08-21;35;41;6282;5470;63.1;54.9
977;2021-08-22;6;0;6288;5470;63.1;54.9
977;2021-08-23;3;11;6291;5481;63.2;55.0
977;2021-08-24;8;3;6299;5484;63.2;55.1
977;2021-08-25;20;37;6319;5521;63.4;55.4
977;2021-08-26;27;41;6346;5562;63.7;55.8
977;2021-08-27;27;35;6373;5597;64.0;56.2
977;2021-08-28;27;56;6400;5653;64.3;56.8
977;2021-08-29;0;0;6400;5653;64.3;56.8
977;2021-08-30;1;4;6401;5657;64.3;56.8
977;2021-08-31;1;2;6402;5659;64.3;56.8
977;2021-09-01;10;25;6412;5684;64.4;57.1
977;2021-09-02;22;32;6434;5716;64.6;57.4
977;2021-09-03;26;24;6460;5740;64.9;57.6
977;2021-09-04;37;44;6497;5784;65.2;58.1
977;2021-09-05;0;0;6497;5784;65.2;58.1
977;2021-09-06;4;16;6501;5800;65.3;58.2
977;2021-09-07;1;4;6502;5804;65.3;58.3
977;2021-09-08;12;11;6514;5815;65.4;58.4
977;2021-09-09;20;31;6534;5846;65.6;58.7
977;2021-09-10;7;31;6541;5877;65.7;59.0
977;2021-09-11;36;29;6577;5906;66.0;59.3
977;2021-09-12;0;6;6577;5912;66.0;59.4
977;2021-09-13;4;3;6581;5915;66.1;59.4
977;2021-09-14;1;0;6582;5915;66.1;59.4
977;2021-09-15;12;26;6594;5941;66.2;59.6
977;2021-09-16;15;31;6609;5972;66.3;60.0
977;2021-09-17;10;33;6619;6005;66.4;60.3
977;2021-09-18;20;39;6639;6044;66.6;60.7
977;2021-09-19;0;0;6639;6044;66.6;60.7
977;2021-09-20;0;2;6639;6046;66.6;60.7
977;2021-09-21;0;1;6639;6047;66.6;60.7
977;2021-09-22;12;11;6651;6058;66.8;60.8
977;2021-09-23;7;30;6658;6088;66.8;61.1
977;2021-09-24;0;0;6658;6088;66.8;61.1
977;2021-09-25;11;49;6669;6137;67.0;61.6
977;2021-09-26;0;0;6669;6137;67.0;61.6
977;2021-09-27;0;0;6669;6137;67.0;61.6
977;2021-09-28;0;1;6669;6138;67.0;61.6
977;2021-09-29;5;15;6674;6153;67.0;61.8
977;2021-09-30;18;19;6692;6172;67.2;62.0
977;2021-10-01;0;3;6692;6175;67.2;62.0
977;2021-10-02;10;39;6702;6214;67.3;62.4
977;2021-10-03;0;0;6702;6214;67.3;62.4
977;2021-10-04;0;0;6702;6214;67.3;62.4
977;2021-10-05;0;0;6702;6214;67.3;62.4
977;2021-10-06;15;23;6717;6237;67.4;62.6
977;2021-10-07;25;31;6742;6268;67.7;62.9
977;2021-10-08;3;2;6745;6270;67.7;62.9
977;2021-10-09;5;15;6750;6285;67.8;63.1
977;2021-10-10;0;0;6750;6285;67.8;63.1
977;2021-10-11;0;1;6750;6286;67.8;63.1
977;2021-10-12;0;0;6750;6286;67.8;63.1
977;2021-10-13;7;21;6757;6307;67.8;63.3
977;2021-10-14;19;16;6776;6323;68.0;63.5
977;2021-10-15;7;8;6783;6331;68.1;63.6
977;2021-10-16;3;1;6786;6332;68.1;63.6
977;2021-10-17;0;0;6786;6332;68.1;63.6
977;2021-10-18;2;1;6788;6333;68.1;63.6
977;2021-10-19;1;0;6789;6333;68.2;63.6
978;2020-12-27;0;0;0;0;0.0;0.0
978;2020-12-28;0;0;0;0;0.0;0.0
978;2020-12-29;0;0;0;0;0.0;0.0
978;2020-12-30;0;0;0;0;0.0;0.0
978;2020-12-31;0;0;0;0;0.0;0.0
978;2021-01-01;0;0;0;0;0.0;0.0
978;2021-01-02;0;0;0;0;0.0;0.0
978;2021-01-03;0;0;0;0;0.0;0.0
978;2021-01-04;0;0;0;0;0.0;0.0
978;2021-01-05;0;0;0;0;0.0;0.0
978;2021-01-06;0;0;0;0;0.0;0.0
978;2021-01-07;0;0;0;0;0.0;0.0
978;2021-01-08;0;0;0;0;0.0;0.0
978;2021-01-09;0;0;0;0;0.0;0.0
978;2021-01-10;0;0;0;0;0.0;0.0
978;2021-01-11;0;0;0;0;0.0;0.0
978;2021-01-12;0;0;0;0;0.0;0.0
978;2021-01-13;10;0;10;0;0.0;0.0
978;2021-01-14;12;1;22;1;0.1;0.0
978;2021-01-15;10;0;32;1;0.1;0.0
978;2021-01-16;0;0;32;1;0.1;0.0
978;2021-01-17;0;0;32;1;0.1;0.0
978;2021-01-18;0;0;32;1;0.1;0.0
978;2021-01-19;12;0;44;1;0.1;0.0
978;2021-01-20;13;0;57;1;0.2;0.0
978;2021-01-21;6;0;63;1;0.2;0.0
978;2021-01-22;0;0;63;1;0.2;0.0
978;2021-01-23;0;0;63;1;0.2;0.0
978;2021-01-24;0;0;63;1;0.2;0.0
978;2021-01-25;0;0;63;1;0.2;0.0
978;2021-01-26;9;0;72;1;0.2;0.0
978;2021-01-27;10;0;82;1;0.2;0.0
978;2021-01-28;6;1;88;2;0.2;0.0
978;2021-01-29;0;0;88;2;0.2;0.0
978;2021-01-30;0;0;88;2;0.2;0.0
978;2021-01-31;0;0;88;2;0.2;0.0
978;2021-02-01;1;0;89;2;0.3;0.0
978;2021-02-02;39;0;128;2;0.4;0.0
978;2021-02-03;11;0;139;2;0.4;0.0
978;2021-02-04;32;0;171;2;0.5;0.0
978;2021-02-05;6;0;177;2;0.5;0.0
978;2021-02-06;0;0;177;2;0.5;0.0
978;2021-02-07;0;0;177;2;0.5;0.0
978;2021-02-08;0;0;177;2;0.5;0.0
978;2021-02-09;38;0;215;2;0.6;0.0
978;2021-02-10;27;1;242;3;0.7;0.0
978;2021-02-11;0;0;242;3;0.7;0.0
978;2021-02-12;36;0;278;3;0.8;0.0
978;2021-02-13;0;0;278;3;0.8;0.0
978;2021-02-14;0;0;278;3;0.8;0.0
978;2021-02-15;50;1;328;4;0.9;0.0
978;2021-02-16;0;0;328;4;0.9;0.0
978;2021-02-17;0;0;328;4;0.9;0.0
978;2021-02-18;28;0;356;4;1.0;0.0
978;2021-02-19;44;0;400;4;1.1;0.0
978;2021-02-20;0;0;400;4;1.1;0.0
978;2021-02-21;0;0;400;4;1.1;0.0
978;2021-02-22;45;4;445;8;1.3;0.0
978;2021-02-23;41;29;486;37;1.4;0.1
978;2021-02-24;36;1;522;38;1.5;0.1
978;2021-02-25;55;36;577;74;1.6;0.2
978;2021-02-26;39;5;616;79;1.7;0.2
978;2021-02-27;0;0;616;79;1.7;0.2
978;2021-02-28;0;0;616;79;1.7;0.2
978;2021-03-01;50;5;666;84;1.9;0.2
978;2021-03-02;7;27;673;111;1.9;0.3
978;2021-03-03;54;29;727;140;2.1;0.4
978;2021-03-04;31;26;758;166;2.1;0.5
978;2021-03-05;46;10;804;176;2.3;0.5
978;2021-03-06;0;0;804;176;2.3;0.5
978;2021-03-07;0;0;804;176;2.3;0.5
978;2021-03-08;32;7;836;183;2.4;0.5
978;2021-03-09;21;27;857;210;2.4;0.6
978;2021-03-10;35;28;892;238;2.5;0.7
978;2021-03-11;2;0;894;238;2.5;0.7
978;2021-03-12;53;22;947;260;2.7;0.7
978;2021-03-13;13;0;960;260;2.7;0.7
978;2021-03-14;0;0;960;260;2.7;0.7
978;2021-03-15;31;41;991;301;2.8;0.9
978;2021-03-16;73;6;1064;307;3.0;0.9
978;2021-03-17;67;13;1131;320;3.2;0.9
978;2021-03-18;82;39;1213;359;3.4;1.0
978;2021-03-19;32;50;1245;409;3.5;1.2
978;2021-03-20;0;0;1245;409;3.5;1.2
978;2021-03-21;0;0;1245;409;3.5;1.2
978;2021-03-22;35;45;1280;454;3.6;1.3
978;2021-03-23;30;43;1310;497;3.7;1.4
978;2021-03-24;38;42;1348;539;3.8;1.5
978;2021-03-25;97;34;1445;573;4.1;1.6
978;2021-03-26;45;33;1490;606;4.2;1.7
978;2021-03-27;94;3;1584;609;4.5;1.7
978;2021-03-28;0;0;1584;609;4.5;1.7
978;2021-03-29;69;48;1653;657;4.7;1.9
978;2021-03-30;99;25;1752;682;5.0;1.9
978;2021-03-31;91;49;1843;731;5.2;2.1
978;2021-04-01;57;48;1900;779;5.4;2.2
978;2021-04-02;0;0;1900;779;5.4;2.2
978;2021-04-03;1;0;1901;779;5.4;2.2
978;2021-04-04;0;0;1901;779;5.4;2.2
978;2021-04-05;2;0;1903;779;5.4;2.2
978;2021-04-06;49;63;1952;842;5.5;2.4
978;2021-04-07;93;33;2045;875;5.8;2.5
978;2021-04-08;122;7;2167;882;6.1;2.5
978;2021-04-09;91;40;2258;922;6.4;2.6
978;2021-04-10;170;13;2428;935;6.9;2.6
978;2021-04-11;0;0;2428;935;6.9;2.6
978;2021-04-12;42;75;2470;1010;7.0;2.9
978;2021-04-13;49;71;2519;1081;7.1;3.1
978;2021-04-14;82;45;2601;1126;7.4;3.2
978;2021-04-15;92;22;2693;1148;7.6;3.2
978;2021-04-16;77;43;2770;1191;7.8;3.4
978;2021-04-17;165;5;2935;1196;8.3;3.4
978;2021-04-18;0;0;2935;1196;8.3;3.4
978;2021-04-19;52;67;2987;1263;8.5;3.6
978;2021-04-20;83;27;3070;1290;8.7;3.7
978;2021-04-21;91;28;3161;1318;8.9;3.7
978;2021-04-22;101;20;3262;1338;9.2;3.8
978;2021-04-23;45;66;3307;1404;9.4;4.0
978;2021-04-24;99;78;3406;1482;9.6;4.2
978;2021-04-25;0;0;3406;1482;9.6;4.2
978;2021-04-26;29;91;3435;1573;9.7;4.5
978;2021-04-27;59;63;3494;1636;9.9;4.6
978;2021-04-28;93;40;3587;1676;10.2;4.7
978;2021-04-29;89;31;3676;1707;10.4;4.8
978;2021-04-30;103;14;3779;1721;10.7;4.9
978;2021-05-01;0;8;3779;1729;10.7;4.9
978;2021-05-02;0;0;3779;1729;10.7;4.9
978;2021-05-03;25;99;3804;1828;10.8;5.2
978;2021-05-04;159;102;3963;1930;11.2;5.5
978;2021-05-05;142;59;4105;1989;11.6;5.6
978;2021-05-06;199;49;4304;2038;12.2;5.8
978;2021-05-07;127;71;4431;2109;12.5;6.0
978;2021-05-08;69;122;4500;2231;12.7;6.3
978;2021-05-09;0;0;4500;2231;12.7;6.3
978;2021-05-10;124;100;4624;2331;13.1;6.6
978;2021-05-11;132;72;4756;2403;13.5;6.8
978;2021-05-12;155;78;4911;2481;13.9;7.0
978;2021-05-13;83;6;4994;2487;14.1;7.0
978;2021-05-14;130;62;5124;2549;14.5;7.2
978;2021-05-15;86;4;5210;2553;14.7;7.2
978;2021-05-16;0;0;5210;2553;14.7;7.2
978;2021-05-17;146;115;5356;2668;15.2;7.6
978;2021-05-18;151;94;5507;2762;15.6;7.8
978;2021-05-19;84;69;5591;2831;15.8;8.0
978;2021-05-20;104;26;5695;2857;16.1;8.1
978;2021-05-21;98;52;5793;2909;16.4;8.2
978;2021-05-22;99;11;5892;2920;16.7;8.3
978;2021-05-23;0;0;5892;2920;16.7;8.3
978;2021-05-24;33;7;5925;2927;16.8;8.3
978;2021-05-25;119;78;6044;3005;17.1;8.5
978;2021-05-26;108;49;6152;3054;17.4;8.6
978;2021-05-27;112;42;6264;3096;17.7;8.8
978;2021-05-28;33;1;6297;3097;17.8;8.8
978;2021-05-29;60;213;6357;3310;18.0;9.4
978;2021-05-30;0;0;6357;3310;18.0;9.4
978;2021-05-31;111;63;6468;3373;18.3;9.5
978;2021-06-01;116;62;6584;3435;18.6;9.7
978;2021-06-02;131;34;6715;3469;19.0;9.8
978;2021-06-03;101;38;6816;3507;19.3;9.9
978;2021-06-04;128;70;6944;3577;19.7;10.1
978;2021-06-05;83;21;7027;3598;19.9;10.2
978;2021-06-06;0;0;7027;3598;19.9;10.2
978;2021-06-07;96;96;7123;3694;20.2;10.5
978;2021-06-08;82;89;7205;3783;20.4;10.7
978;2021-06-09;99;73;7304;3856;20.7;10.9
978;2021-06-10;112;63;7416;3919;21.0;11.1
978;2021-06-11;116;106;7532;4025;21.3;11.4
978;2021-06-12;57;30;7589;4055;21.5;11.5
978;2021-06-13;0;0;7589;4055;21.5;11.5
978;2021-06-14;105;127;7694;4182;21.8;11.8
978;2021-06-15;88;120;7782;4302;22.0;12.2
978;2021-06-16;105;148;7887;4450;22.3;12.6
978;2021-06-17;85;72;7972;4522;22.6;12.8
978;2021-06-18;67;98;8039;4620;22.8;13.1
978;2021-06-19;65;79;8104;4699;22.9;13.3
978;2021-06-20;0;0;8104;4699;22.9;13.3
978;2021-06-21;78;150;8182;4849;23.2;13.7
978;2021-06-22;71;103;8253;4952;23.4;14.0
978;2021-06-23;68;115;8321;5067;23.5;14.3
978;2021-06-24;43;75;8364;5142;23.7;14.6
978;2021-06-25;64;100;8428;5242;23.9;14.8
978;2021-06-26;35;61;8463;5303;24.0;15.0
978;2021-06-27;0;0;8463;5303;24.0;15.0
978;2021-06-28;73;131;8536;5434;24.2;15.4
978;2021-06-29;62;104;8598;5538;24.3;15.7
978;2021-06-30;56;110;8654;5648;24.5;16.0
978;2021-07-01;42;87;8696;5735;24.6;16.2
978;2021-07-02;52;90;8748;5825;24.8;16.5
978;2021-07-03;40;90;8788;5915;24.9;16.7
978;2021-07-04;0;1;8788;5916;24.9;16.7
978;2021-07-05;67;93;8855;6009;25.1;17.0
978;2021-07-06;55;74;8910;6083;25.2;17.2
978;2021-07-07;55;123;8965;6206;25.4;17.6
978;2021-07-08;54;107;9019;6313;25.5;17.9
978;2021-07-09;45;92;9064;6405;25.7;18.1
978;2021-07-10;38;85;9102;6490;25.8;18.4
978;2021-07-11;0;4;9102;6494;25.8;18.4
978;2021-07-12;71;130;9173;6624;26.0;18.7
978;2021-07-13;146;162;9319;6786;26.4;19.2
978;2021-07-14;3;0;9322;6786;26.4;19.2
978;2021-07-15;161;195;9483;6981;26.8;19.8
978;2021-07-16;113;113;9596;7094;27.2;20.1
978;2021-07-17;52;100;9648;7194;27.3;20.4
978;2021-07-18;0;0;9648;7194;27.3;20.4
978;2021-07-19;99;133;9747;7327;27.6;20.7
978;2021-07-20;80;74;9827;7401;27.8;20.9
978;2021-07-21;63;50;9890;7451;28.0;21.1
978;2021-07-22;97;114;9987;7565;28.3;21.4
978;2021-07-23;67;98;10054;7663;28.5;21.7
978;2021-07-24;20;35;10074;7698;28.5;21.8
978;2021-07-25;0;0;10074;7698;28.5;21.8
978;2021-07-26;100;116;10174;7814;28.8;22.1
978;2021-07-27;72;144;10246;7958;29.0;22.5
978;2021-07-28;72;126;10318;8084;29.2;22.9
978;2021-07-29;80;98;10398;8182;29.4;23.2
978;2021-07-30;82;115;10480;8297;29.7;23.5
978;2021-07-31;49;68;10529;8365;29.8;23.7
978;2021-08-01;0;0;10529;8365;29.8;23.7
978;2021-08-02;65;95;10594;8460;30.0;23.9
978;2021-08-03;60;94;10654;8554;30.2;24.2
978;2021-08-04;64;55;10718;8609;30.3;24.4
978;2021-08-05;48;70;10766;8679;30.5;24.6
978;2021-08-06;73;127;10839;8806;30.7;24.9
978;2021-08-07;44;46;10883;8852;30.8;25.1
978;2021-08-08;0;0;10883;8852;30.8;25.1
978;2021-08-09;138;150;11021;9002;31.2;25.5
978;2021-08-10;81;93;11102;9095;31.4;25.7
978;2021-08-11;106;99;11208;9194;31.7;26.0
978;2021-08-12;99;99;11307;9293;32.0;26.3
978;2021-08-13;132;75;11439;9368;32.4;26.5
978;2021-08-14;74;100;11513;9468;32.6;26.8
978;2021-08-15;0;0;11513;9468;32.6;26.8
978;2021-08-16;45;72;11558;9540;32.7;27.0
978;2021-08-17;33;33;11591;9573;32.8;27.1
978;2021-08-18;35;55;11626;9628;32.9;27.2
978;2021-08-19;34;26;11660;9654;33.0;27.3
978;2021-08-20;46;61;11706;9715;33.1;27.5
978;2021-08-21;0;0;11706;9715;33.1;27.5
978;2021-08-22;0;0;11706;9715;33.1;27.5
978;2021-08-23;51;88;11757;9803;33.3;27.7
978;2021-08-24;31;53;11788;9856;33.4;27.9
978;2021-08-25;26;51;11814;9907;33.4;28.0
978;2021-08-26;31;26;11845;9933;33.5;28.1
978;2021-08-27;47;88;11892;10021;33.7;28.4
978;2021-08-28;3;0;11895;10021;33.7;28.4
978;2021-08-29;0;0;11895;10021;33.7;28.4
978;2021-08-30;39;113;11934;10134;33.8;28.7
978;2021-08-31;46;80;11980;10214;33.9;28.9
978;2021-09-01;31;84;12011;10298;34.0;29.1
978;2021-09-02;39;70;12050;10368;34.1;29.3
978;2021-09-03;16;94;12066;10462;34.1;29.6
978;2021-09-04;0;0;12066;10462;34.1;29.6
978;2021-09-05;0;0;12066;10462;34.1;29.6
978;2021-09-06;32;77;12098;10539;34.2;29.8
978;2021-09-07;37;45;12135;10584;34.3;30.0
978;2021-09-08;21;42;12156;10626;34.4;30.1
978;2021-09-09;21;51;12177;10677;34.5;30.2
978;2021-09-10;43;75;12220;10752;34.6;30.4
978;2021-09-11;1;0;12221;10752;34.6;30.4
978;2021-09-12;5;1;12226;10753;34.6;30.4
978;2021-09-13;34;53;12260;10806;34.7;30.6
978;2021-09-14;23;27;12283;10833;34.8;30.7
978;2021-09-15;25;43;12308;10876;34.8;30.8
978;2021-09-16;8;33;12316;10909;34.9;30.9
978;2021-09-17;13;45;12329;10954;34.9;31.0
978;2021-09-18;0;0;12329;10954;34.9;31.0
978;2021-09-19;0;0;12329;10954;34.9;31.0
978;2021-09-20;13;35;12342;10989;34.9;31.1
978;2021-09-21;15;37;12357;11026;35.0;31.2
978;2021-09-22;13;34;12370;11060;35.0;31.3
978;2021-09-23;26;41;12396;11101;35.1;31.4
978;2021-09-24;19;27;12415;11128;35.1;31.5
978;2021-09-25;0;1;12415;11129;35.1;31.5
978;2021-09-26;0;0;12415;11129;35.1;31.5
978;2021-09-27;11;31;12426;11160;35.2;31.6
978;2021-09-28;19;26;12445;11186;35.2;31.7
978;2021-09-29;20;25;12465;11211;35.3;31.7
978;2021-09-30;23;23;12488;11234;35.3;31.8
978;2021-10-01;25;37;12513;11271;35.4;31.9
978;2021-10-02;0;0;12513;11271;35.4;31.9
978;2021-10-03;0;0;12513;11271;35.4;31.9
978;2021-10-04;22;27;12535;11298;35.5;32.0
978;2021-10-05;15;16;12550;11314;35.5;32.0
978;2021-10-06;12;16;12562;11330;35.6;32.1
978;2021-10-07;11;15;12573;11345;35.6;32.1
978;2021-10-08;16;15;12589;11360;35.6;32.2
978;2021-10-09;0;0;12589;11360;35.6;32.2
978;2021-10-10;0;0;12589;11360;35.6;32.2
978;2021-10-11;25;22;12614;11382;35.7;32.2
978;2021-10-12;24;29;12638;11411;35.8;32.3
978;2021-10-13;13;18;12651;11429;35.8;32.3
978;2021-10-14;37;28;12688;11457;35.9;32.4
978;2021-10-15;25;21;12713;11478;36.0;32.5
978;2021-10-16;0;0;12713;11478;36.0;32.5
978;2021-10-17;0;0;12713;11478;36.0;32.5
978;2021-10-18;34;26;12747;11504;36.1;32.6
978;2021-10-19;13;12;12760;11516;36.1;32.6
