dep;jour;n_dose1;n_complet;n_cum_dose1;n_cum_complet;couv_dose1;couv_complet
01;2020-12-27;2;0;2;0;0.0;0.0
01;2020-12-28;0;0;2;0;0.0;0.0
01;2020-12-29;0;0;2;0;0.0;0.0
01;2020-12-30;0;0;2;0;0.0;0.0
01;2020-12-31;0;0;2;0;0.0;0.0
01;2021-01-01;2;0;4;0;0.0;0.0
01;2021-01-02;1;0;5;0;0.0;0.0
01;2021-01-03;0;0;5;0;0.0;0.0
01;2021-01-04;2;0;7;0;0.0;0.0
01;2021-01-05;2;0;9;0;0.0;0.0
01;2021-01-06;1;0;10;0;0.0;0.0
01;2021-01-07;67;0;77;0;0.0;0.0
01;2021-01-08;159;1;236;1;0.0;0.0
01;2021-01-09;2;1;238;2;0.0;0.0
01;2021-01-10;1;0;239;2;0.0;0.0
01;2021-01-11;148;0;387;2;0.1;0.0
01;2021-01-12;318;2;705;4;0.1;0.0
01;2021-01-13;445;1;1150;5;0.2;0.0
01;2021-01-14;530;3;1680;8;0.3;0.0
01;2021-01-15;398;4;2078;12;0.3;0.0
01;2021-01-16;202;0;2280;12;0.3;0.0
01;2021-01-17;128;0;2408;12;0.4;0.0
01;2021-01-18;380;3;2788;15;0.4;0.0
01;2021-01-19;1041;2;3829;17;0.6;0.0
01;2021-01-20;1262;4;5091;21;0.8;0.0
01;2021-01-21;1101;6;6192;27;0.9;0.0
01;2021-01-22;651;4;6843;31;1.0;0.0
01;2021-01-23;223;0;7066;31;1.1;0.0
01;2021-01-24;70;1;7136;32;1.1;0.0
01;2021-01-25;485;1;7621;33;1.2;0.0
01;2021-01-26;744;5;8365;38;1.3;0.0
01;2021-01-27;518;7;8883;45;1.4;0.0
01;2021-01-28;683;57;9566;102;1.5;0.0
01;2021-01-29;640;102;10206;204;1.6;0.0
01;2021-01-30;237;15;10443;219;1.6;0.0
01;2021-01-31;62;0;10505;219;1.6;0.0
01;2021-02-01;459;73;10964;292;1.7;0.0
01;2021-02-02;519;185;11483;477;1.7;0.1
01;2021-02-03;376;299;11859;776;1.8;0.1
01;2021-02-04;480;417;12339;1193;1.9;0.2
01;2021-02-05;444;281;12783;1474;1.9;0.2
01;2021-02-06;264;143;13047;1617;2.0;0.2
01;2021-02-07;2;111;13049;1728;2.0;0.3
01;2021-02-08;507;404;13556;2132;2.1;0.3
01;2021-02-09;776;857;14332;2989;2.2;0.5
01;2021-02-10;957;720;15289;3709;2.3;0.6
01;2021-02-11;795;774;16084;4483;2.4;0.7
01;2021-02-12;640;552;16724;5035;2.5;0.8
01;2021-02-13;161;151;16885;5186;2.6;0.8
01;2021-02-14;2;9;16887;5195;2.6;0.8
01;2021-02-15;438;445;17325;5640;2.6;0.9
01;2021-02-16;660;422;17985;6062;2.7;0.9
01;2021-02-17;524;251;18509;6313;2.8;1.0
01;2021-02-18;592;569;19101;6882;2.9;1.0
01;2021-02-19;580;249;19681;7131;3.0;1.1
01;2021-02-20;201;154;19882;7285;3.0;1.1
01;2021-02-21;1;1;19883;7286;3.0;1.1
01;2021-02-22;429;558;20312;7844;3.1;1.2
01;2021-02-23;483;523;20795;8367;3.2;1.3
01;2021-02-24;435;462;21230;8829;3.2;1.3
01;2021-02-25;827;610;22057;9439;3.4;1.4
01;2021-02-26;874;545;22931;9984;3.5;1.5
01;2021-02-27;480;118;23411;10102;3.6;1.5
01;2021-02-28;20;3;23431;10105;3.6;1.5
01;2021-03-01;636;460;24067;10565;3.7;1.6
01;2021-03-02;964;561;25031;11126;3.8;1.7
01;2021-03-03;945;669;25976;11795;4.0;1.8
01;2021-03-04;1198;646;27174;12441;4.1;1.9
01;2021-03-05;1357;501;28531;12942;4.3;2.0
01;2021-03-06;781;102;29312;13044;4.5;2.0
01;2021-03-07;44;1;29356;13045;4.5;2.0
01;2021-03-08;670;627;30026;13672;4.6;2.1
01;2021-03-09;1341;619;31367;14291;4.8;2.2
01;2021-03-10;1163;560;32530;14851;5.0;2.3
01;2021-03-11;1686;645;34216;15496;5.2;2.4
01;2021-03-12;2008;648;36224;16144;5.5;2.5
01;2021-03-13;1502;102;37726;16246;5.7;2.5
01;2021-03-14;134;59;37860;16305;5.8;2.5
01;2021-03-15;1154;407;39014;16712;5.9;2.5
01;2021-03-16;1014;566;40028;17278;6.1;2.6
01;2021-03-17;839;347;40867;17625;6.2;2.7
01;2021-03-18;1295;475;42162;18100;6.4;2.8
01;2021-03-19;1750;548;43912;18648;6.7;2.8
01;2021-03-20;1447;137;45359;18785;6.9;2.9
01;2021-03-21;99;11;45458;18796;6.9;2.9
01;2021-03-22;1576;493;47034;19289;7.2;2.9
01;2021-03-23;2197;655;49231;19944;7.5;3.0
01;2021-03-24;1616;421;50847;20365;7.7;3.1
01;2021-03-25;2911;636;53758;21001;8.2;3.2
01;2021-03-26;2871;617;56629;21618;8.6;3.3
01;2021-03-27;1311;164;57940;21782;8.8;3.3
01;2021-03-28;22;1;57962;21783;8.8;3.3
01;2021-03-29;1930;548;59892;22331;9.1;3.4
01;2021-03-30;2515;780;62407;23111;9.5;3.5
01;2021-03-31;1869;630;64276;23741;9.8;3.6
01;2021-04-01;2569;860;66845;24601;10.2;3.7
01;2021-04-02;2818;733;69663;25334;10.6;3.9
01;2021-04-03;1256;137;70919;25471;10.8;3.9
01;2021-04-04;3;1;70922;25472;10.8;3.9
01;2021-04-05;1261;67;72183;25539;11.0;3.9
01;2021-04-06;2824;801;75007;26340;11.4;4.0
01;2021-04-07;2741;710;77748;27050;11.8;4.1
01;2021-04-08;3245;1007;80993;28057;12.3;4.3
01;2021-04-09;3983;1336;84976;29393;12.9;4.5
01;2021-04-10;1823;305;86799;29698;13.2;4.5
01;2021-04-11;44;22;86843;29720;13.2;4.5
01;2021-04-12;2716;1228;89559;30948;13.6;4.7
01;2021-04-13;2945;1331;92504;32279;14.1;4.9
01;2021-04-14;3126;1083;95630;33362;14.6;5.1
01;2021-04-15;3074;1484;98704;34846;15.0;5.3
01;2021-04-16;2861;1585;101565;36431;15.5;5.5
01;2021-04-17;1654;682;103219;37113;15.7;5.6
01;2021-04-18;13;0;103232;37113;15.7;5.6
01;2021-04-19;2039;1524;105271;38637;16.0;5.9
01;2021-04-20;2668;1574;107939;40211;16.4;6.1
01;2021-04-21;2690;1352;110629;41563;16.8;6.3
01;2021-04-22;2835;1531;113464;43094;17.3;6.6
01;2021-04-23;2765;1535;116229;44629;17.7;6.8
01;2021-04-24;1448;656;117677;45285;17.9;6.9
01;2021-04-25;9;0;117686;45285;17.9;6.9
01;2021-04-26;1970;1731;119656;47016;18.2;7.2
01;2021-04-27;2572;1559;122228;48575;18.6;7.4
01;2021-04-28;2500;1577;124728;50152;19.0;7.6
01;2021-04-29;2716;1775;127444;51927;19.4;7.9
01;2021-04-30;2982;2252;130426;54179;19.9;8.2
01;2021-05-01;1473;859;131899;55038;20.1;8.4
01;2021-05-02;545;76;132444;55114;20.2;8.4
01;2021-05-03;2296;2482;134740;57596;20.5;8.8
01;2021-05-04;2539;2643;137279;60239;20.9;9.2
01;2021-05-05;2527;2503;139806;62742;21.3;9.6
01;2021-05-06;2995;2530;142801;65272;21.7;9.9
01;2021-05-07;3215;2779;146016;68051;22.2;10.4
01;2021-05-08;1645;922;147661;68973;22.5;10.5
01;2021-05-09;1022;162;148683;69135;22.6;10.5
01;2021-05-10;2500;3071;151183;72206;23.0;11.0
01;2021-05-11;3581;3066;154764;75272;23.6;11.5
01;2021-05-12;3652;3005;158416;78277;24.1;11.9
01;2021-05-13;4089;1503;162505;79780;24.7;12.1
01;2021-05-14;4272;2347;166777;82127;25.4;12.5
01;2021-05-15;3159;1435;169936;83562;25.9;12.7
01;2021-05-16;1413;150;171349;83712;26.1;12.7
01;2021-05-17;3445;2469;174794;86181;26.6;13.1
01;2021-05-18;4075;1959;178869;88140;27.2;13.4
01;2021-05-19;3974;1904;182843;90044;27.8;13.7
01;2021-05-20;4526;2017;187369;92061;28.5;14.0
01;2021-05-21;4621;2198;191990;94259;29.2;14.3
01;2021-05-22;3368;955;195358;95214;29.7;14.5
01;2021-05-23;834;84;196192;95298;29.9;14.5
01;2021-05-24;2765;500;198957;95798;30.3;14.6
01;2021-05-25;3560;2430;202517;98228;30.8;15.0
01;2021-05-26;3569;2252;206086;100480;31.4;15.3
01;2021-05-27;3853;2097;209939;102577;32.0;15.6
01;2021-05-28;3665;2638;213604;105215;32.5;16.0
01;2021-05-29;3055;1305;216659;106520;33.0;16.2
01;2021-05-30;613;88;217272;106608;33.1;16.2
01;2021-05-31;2407;2521;219679;109129;33.4;16.6
01;2021-06-01;2771;2591;222450;111720;33.9;17.0
01;2021-06-02;2883;2203;225333;113923;34.3;17.3
01;2021-06-03;3366;2441;228699;116364;34.8;17.7
01;2021-06-04;4501;3373;233200;119737;35.5;18.2
01;2021-06-05;3252;1732;236452;121469;36.0;18.5
01;2021-06-06;670;78;237122;121547;36.1;18.5
01;2021-06-07;3388;2875;240510;124422;36.6;18.9
01;2021-06-08;3649;2719;244159;127141;37.2;19.4
01;2021-06-09;2949;2637;247108;129778;37.6;19.8
01;2021-06-10;2767;2043;249875;131821;38.0;20.1
01;2021-06-11;3072;3368;252947;135189;38.5;20.6
01;2021-06-12;2402;2197;255349;137386;38.9;20.9
01;2021-06-13;201;479;255550;137865;38.9;21.0
01;2021-06-14;2119;3162;257669;141027;39.2;21.5
01;2021-06-15;2005;3368;259674;144395;39.5;22.0
01;2021-06-16;2175;3287;261849;147682;39.9;22.5
01;2021-06-17;1959;3174;263808;150856;40.2;23.0
01;2021-06-18;2635;4163;266443;155019;40.6;23.6
01;2021-06-19;1727;2556;268170;157575;40.8;24.0
01;2021-06-20;159;498;268329;158073;40.8;24.1
01;2021-06-21;1798;3704;270127;161777;41.1;24.6
01;2021-06-22;1552;4002;271679;165779;41.4;25.2
01;2021-06-23;1583;3754;273262;169533;41.6;25.8
01;2021-06-24;1471;3565;274733;173098;41.8;26.3
01;2021-06-25;1889;4566;276622;177664;42.1;27.0
01;2021-06-26;1209;2946;277831;180610;42.3;27.5
01;2021-06-27;171;339;278002;180949;42.3;27.5
01;2021-06-28;1382;4024;279384;184973;42.5;28.2
01;2021-06-29;1409;3852;280793;188825;42.7;28.7
01;2021-06-30;1381;4157;282174;192982;43.0;29.4
01;2021-07-01;1431;4088;283605;197070;43.2;30.0
01;2021-07-02;1587;4987;285192;202057;43.4;30.8
01;2021-07-03;858;3374;286050;205431;43.5;31.3
01;2021-07-04;105;499;286155;205930;43.6;31.3
01;2021-07-05;1486;4083;287641;210013;43.8;32.0
01;2021-07-06;1105;4275;288746;214288;44.0;32.6
01;2021-07-07;1756;3697;290502;217985;44.2;33.2
01;2021-07-08;1474;3677;291976;221662;44.4;33.7
01;2021-07-09;1885;4365;293861;226027;44.7;34.4
01;2021-07-10;1119;3438;294980;229465;44.9;34.9
01;2021-07-11;105;418;295085;229883;44.9;35.0
01;2021-07-12;1422;3844;296507;233727;45.1;35.6
01;2021-07-13;2058;4116;298565;237843;45.4;36.2
01;2021-07-14;148;179;298713;238022;45.5;36.2
01;2021-07-15;3104;4192;301817;242214;45.9;36.9
01;2021-07-16;3745;4838;305562;247052;46.5;37.6
01;2021-07-17;2203;3045;307765;250097;46.8;38.1
01;2021-07-18;290;551;308055;250648;46.9;38.2
01;2021-07-19;2915;3871;310970;254519;47.3;38.7
01;2021-07-20;3296;3694;314266;258213;47.8;39.3
01;2021-07-21;3935;3569;318201;261782;48.4;39.8
01;2021-07-22;4219;3496;322420;265278;49.1;40.4
01;2021-07-23;3942;4221;326362;269499;49.7;41.0
01;2021-07-24;2731;2713;329093;272212;50.1;41.4
01;2021-07-25;61;60;329154;272272;50.1;41.4
01;2021-07-26;3346;3240;332500;275512;50.6;41.9
01;2021-07-27;4105;2792;336605;278304;51.2;42.4
01;2021-07-28;3989;2652;340594;280956;51.8;42.8
01;2021-07-29;4696;2438;345290;283394;52.6;43.1
01;2021-07-30;4458;3431;349748;286825;53.2;43.7
01;2021-07-31;3641;1773;353389;288598;53.8;43.9
01;2021-08-01;397;76;353786;288674;53.9;43.9
01;2021-08-02;3078;2455;356864;291129;54.3;44.3
01;2021-08-03;3069;2455;359933;293584;54.8;44.7
01;2021-08-04;2543;1737;362476;295321;55.2;45.0
01;2021-08-05;2249;2365;364725;297686;55.5;45.3
01;2021-08-06;2750;3114;367475;300800;55.9;45.8
01;2021-08-07;2072;1837;369547;302637;56.3;46.1
01;2021-08-08;248;257;369795;302894;56.3;46.1
01;2021-08-09;1136;2633;370931;305527;56.5;46.5
01;2021-08-10;1445;2412;372376;307939;56.7;46.9
01;2021-08-11;1472;2596;373848;310535;56.9;47.3
01;2021-08-12;1626;2829;375474;313364;57.2;47.7
01;2021-08-13;1814;2728;377288;316092;57.4;48.1
01;2021-08-14;1392;2233;378680;318325;57.6;48.5
01;2021-08-15;18;21;378698;318346;57.6;48.5
01;2021-08-16;983;3013;379681;321359;57.8;48.9
01;2021-08-17;1355;2761;381036;324120;58.0;49.3
01;2021-08-18;1257;2907;382293;327027;58.2;49.8
01;2021-08-19;1301;2425;383594;329452;58.4;50.1
01;2021-08-20;1458;3951;385052;333403;58.6;50.7
01;2021-08-21;883;2848;385935;336251;58.7;51.2
01;2021-08-22;19;20;385954;336271;58.7;51.2
01;2021-08-23;1116;3020;387070;339291;58.9;51.6
01;2021-08-24;1230;3153;388300;342444;59.1;52.1
01;2021-08-25;1124;2993;389424;345437;59.3;52.6
01;2021-08-26;1649;2740;391073;348177;59.5;53.0
01;2021-08-27;1641;3652;392714;351829;59.8;53.6
01;2021-08-28;1044;2591;393758;354420;59.9;53.9
01;2021-08-29;16;31;393774;354451;59.9;54.0
01;2021-08-30;1187;2708;394961;357159;60.1;54.4
01;2021-08-31;1093;1895;396054;359054;60.3;54.7
01;2021-09-01;924;1697;396978;360751;60.4;54.9
01;2021-09-02;805;1523;397783;362274;60.5;55.1
01;2021-09-03;1130;2197;398913;364471;60.7;55.5
01;2021-09-04;796;1898;399709;366369;60.8;55.8
01;2021-09-05;97;61;399806;366430;60.9;55.8
01;2021-09-06;658;1093;400464;367523;61.0;55.9
01;2021-09-07;578;1021;401042;368544;61.0;56.1
01;2021-09-08;815;1391;401857;369935;61.2;56.3
01;2021-09-09;774;1131;402631;371066;61.3;56.5
01;2021-09-10;1047;1558;403678;372624;61.4;56.7
01;2021-09-11;736;1432;404414;374056;61.6;56.9
01;2021-09-12;25;38;404439;374094;61.6;56.9
01;2021-09-13;578;998;405017;375092;61.7;57.1
01;2021-09-14;620;992;405637;376084;61.7;57.2
01;2021-09-15;723;1447;406360;377531;61.9;57.5
01;2021-09-16;491;922;406851;378453;61.9;57.6
01;2021-09-17;761;1393;407612;379846;62.0;57.8
01;2021-09-18;376;1205;407988;381051;62.1;58.0
01;2021-09-19;10;10;407998;381061;62.1;58.0
01;2021-09-20;375;637;408373;381698;62.2;58.1
01;2021-09-21;386;702;408759;382400;62.2;58.2
01;2021-09-22;347;899;409106;383299;62.3;58.3
01;2021-09-23;298;658;409404;383957;62.3;58.4
01;2021-09-24;402;945;409806;384902;62.4;58.6
01;2021-09-25;307;955;410113;385857;62.4;58.7
01;2021-09-26;2;24;410115;385881;62.4;58.7
01;2021-09-27;174;557;410289;386438;62.5;58.8
01;2021-09-28;310;1194;410599;387632;62.5;59.0
01;2021-09-29;464;1282;411063;388914;62.6;59.2
01;2021-09-30;347;831;411410;389745;62.6;59.3
01;2021-10-01;464;1076;411874;390821;62.7;59.5
01;2021-10-02;396;1307;412270;392128;62.8;59.7
01;2021-10-03;0;0;412270;392128;62.8;59.7
01;2021-10-04;195;512;412465;392640;62.8;59.8
01;2021-10-05;205;536;412670;393176;62.8;59.8
01;2021-10-06;341;744;413011;393920;62.9;60.0
01;2021-10-07;201;490;413212;394410;62.9;60.0
01;2021-10-08;334;720;413546;395130;62.9;60.1
01;2021-10-09;348;696;413894;395826;63.0;60.3
01;2021-10-10;8;18;413902;395844;63.0;60.3
01;2021-10-11;178;403;414080;396247;63.0;60.3
01;2021-10-12;152;327;414232;396574;63.1;60.4
01;2021-10-13;344;508;414576;397082;63.1;60.4
01;2021-10-14;132;506;414708;397588;63.1;60.5
02;2020-12-27;0;0;0;0;0.0;0.0
02;2020-12-28;0;0;0;0;0.0;0.0
02;2020-12-29;0;0;0;0;0.0;0.0
02;2020-12-30;0;0;0;0;0.0;0.0
02;2020-12-31;0;0;0;0;0.0;0.0
02;2021-01-01;0;0;0;0;0.0;0.0
02;2021-01-02;0;0;0;0;0.0;0.0
02;2021-01-03;0;0;0;0;0.0;0.0
02;2021-01-04;0;0;0;0;0.0;0.0
02;2021-01-05;0;0;0;0;0.0;0.0
02;2021-01-06;22;0;22;0;0.0;0.0
02;2021-01-07;261;1;283;1;0.1;0.0
02;2021-01-08;489;3;772;4;0.1;0.0
02;2021-01-09;75;0;847;4;0.2;0.0
02;2021-01-10;49;0;896;4;0.2;0.0
02;2021-01-11;267;0;1163;4;0.2;0.0
02;2021-01-12;354;1;1517;5;0.3;0.0
02;2021-01-13;469;4;1986;9;0.4;0.0
02;2021-01-14;652;11;2638;20;0.5;0.0
02;2021-01-15;630;8;3268;28;0.6;0.0
02;2021-01-16;333;5;3601;33;0.7;0.0
02;2021-01-17;62;0;3663;33;0.7;0.0
02;2021-01-18;811;10;4474;43;0.9;0.0
02;2021-01-19;941;7;5415;50;1.0;0.0
02;2021-01-20;1431;5;6846;55;1.3;0.0
02;2021-01-21;2605;13;9451;68;1.8;0.0
02;2021-01-22;1420;5;10871;73;2.1;0.0
02;2021-01-23;290;2;11161;75;2.1;0.0
02;2021-01-24;67;0;11228;75;2.1;0.0
02;2021-01-25;432;10;11660;85;2.2;0.0
02;2021-01-26;704;17;12364;102;2.4;0.0
02;2021-01-27;162;3;12526;105;2.4;0.0
02;2021-01-28;69;246;12595;351;2.4;0.1
02;2021-01-29;119;418;12714;769;2.4;0.1
02;2021-01-30;4;14;12718;783;2.4;0.1
02;2021-01-31;0;10;12718;793;2.4;0.2
02;2021-02-01;11;211;12729;1004;2.4;0.2
02;2021-02-02;45;329;12774;1333;2.4;0.3
02;2021-02-03;124;338;12898;1671;2.5;0.3
02;2021-02-04;226;357;13124;2028;2.5;0.4
02;2021-02-05;179;413;13303;2441;2.5;0.5
02;2021-02-06;69;176;13372;2617;2.5;0.5
02;2021-02-07;9;0;13381;2617;2.5;0.5
02;2021-02-08;306;433;13687;3050;2.6;0.6
02;2021-02-09;322;680;14009;3730;2.7;0.7
02;2021-02-10;485;1042;14494;4772;2.8;0.9
02;2021-02-11;937;1860;15431;6632;2.9;1.3
02;2021-02-12;885;1119;16316;7751;3.1;1.5
02;2021-02-13;290;129;16606;7880;3.2;1.5
02;2021-02-14;1;5;16607;7885;3.2;1.5
02;2021-02-15;344;681;16951;8566;3.2;1.6
02;2021-02-16;414;561;17365;9127;3.3;1.7
02;2021-02-17;499;631;17864;9758;3.4;1.9
02;2021-02-18;507;446;18371;10204;3.5;1.9
02;2021-02-19;444;569;18815;10773;3.6;2.0
02;2021-02-20;372;234;19187;11007;3.6;2.1
02;2021-02-21;39;17;19226;11024;3.7;2.1
02;2021-02-22;377;317;19603;11341;3.7;2.2
02;2021-02-23;432;362;20035;11703;3.8;2.2
02;2021-02-24;600;146;20635;11849;3.9;2.3
02;2021-02-25;870;137;21505;11986;4.1;2.3
02;2021-02-26;808;76;22313;12062;4.2;2.3
02;2021-02-27;444;16;22757;12078;4.3;2.3
02;2021-02-28;55;2;22812;12080;4.3;2.3
02;2021-03-01;638;26;23450;12106;4.5;2.3
02;2021-03-02;1031;130;24481;12236;4.7;2.3
02;2021-03-03;754;204;25235;12440;4.8;2.4
02;2021-03-04;1161;658;26396;13098;5.0;2.5
02;2021-03-05;1049;510;27445;13608;5.2;2.6
02;2021-03-06;2141;102;29586;13710;5.6;2.6
02;2021-03-07;1504;55;31090;13765;5.9;2.6
02;2021-03-08;574;371;31664;14136;6.0;2.7
02;2021-03-09;997;406;32661;14542;6.2;2.8
02;2021-03-10;895;476;33556;15018;6.4;2.9
02;2021-03-11;1295;392;34851;15410;6.6;2.9
02;2021-03-12;1706;419;36557;15829;6.9;3.0
02;2021-03-13;2592;250;39149;16079;7.4;3.1
02;2021-03-14;1458;45;40607;16124;7.7;3.1
02;2021-03-15;612;457;41219;16581;7.8;3.2
02;2021-03-16;862;407;42081;16988;8.0;3.2
02;2021-03-17;759;456;42840;17444;8.1;3.3
02;2021-03-18;610;624;43450;18068;8.3;3.4
02;2021-03-19;1171;304;44621;18372;8.5;3.5
02;2021-03-20;2430;163;47051;18535;8.9;3.5
02;2021-03-21;1488;84;48539;18619;9.2;3.5
02;2021-03-22;762;497;49301;19116;9.4;3.6
02;2021-03-23;1195;552;50496;19668;9.6;3.7
02;2021-03-24;1582;506;52078;20174;9.9;3.8
02;2021-03-25;1694;599;53772;20773;10.2;3.9
02;2021-03-26;2412;498;56184;21271;10.7;4.0
02;2021-03-27;2494;141;58678;21412;11.2;4.1
02;2021-03-28;638;15;59316;21427;11.3;4.1
02;2021-03-29;1038;861;60354;22288;11.5;4.2
02;2021-03-30;1553;846;61907;23134;11.8;4.4
02;2021-03-31;1298;717;63205;23851;12.0;4.5
02;2021-04-01;1290;865;64495;24716;12.3;4.7
02;2021-04-02;1183;1231;65678;25947;12.5;4.9
02;2021-04-03;2644;853;68322;26800;13.0;5.1
02;2021-04-04;727;240;69049;27040;13.1;5.1
02;2021-04-05;1509;134;70558;27174;13.4;5.2
02;2021-04-06;1539;859;72097;28033;13.7;5.3
02;2021-04-07;1872;780;73969;28813;14.1;5.5
02;2021-04-08;1919;1111;75888;29924;14.4;5.7
02;2021-04-09;2432;1099;78320;31023;14.9;5.9
02;2021-04-10;2430;1215;80750;32238;15.4;6.1
02;2021-04-11;475;418;81225;32656;15.4;6.2
02;2021-04-12;1822;635;83047;33291;15.8;6.3
02;2021-04-13;1601;928;84648;34219;16.1;6.5
02;2021-04-14;2583;979;87231;35198;16.6;6.7
02;2021-04-15;2495;782;89726;35980;17.1;6.8
02;2021-04-16;2439;1132;92165;37112;17.5;7.1
02;2021-04-17;1890;2148;94055;39260;17.9;7.5
02;2021-04-18;270;814;94325;40074;17.9;7.6
02;2021-04-19;1158;636;95483;40710;18.2;7.7
02;2021-04-20;1674;767;97157;41477;18.5;7.9
02;2021-04-21;1550;996;98707;42473;18.8;8.1
02;2021-04-22;1749;709;100456;43182;19.1;8.2
02;2021-04-23;1930;1417;102386;44599;19.5;8.5
02;2021-04-24;1714;1646;104100;46245;19.8;8.8
02;2021-04-25;462;235;104562;46480;19.9;8.8
02;2021-04-26;1339;564;105901;47044;20.1;8.9
02;2021-04-27;1627;1098;107528;48142;20.4;9.2
02;2021-04-28;1592;1440;109120;49582;20.7;9.4
02;2021-04-29;1889;1183;111009;50765;21.1;9.7
02;2021-04-30;2716;1661;113725;52426;21.6;10.0
02;2021-05-01;1991;1235;115716;53661;22.0;10.2
02;2021-05-02;1982;424;117698;54085;22.4;10.3
02;2021-05-03;2224;987;119922;55072;22.8;10.5
02;2021-05-04;1522;1317;121444;56389;23.1;10.7
02;2021-05-05;2327;1844;123771;58233;23.5;11.1
02;2021-05-06;2122;1739;125893;59972;23.9;11.4
02;2021-05-07;2357;2183;128250;62155;24.4;11.8
02;2021-05-08;2917;951;131167;63106;24.9;12.0
02;2021-05-09;1823;424;132990;63530;25.3;12.1
02;2021-05-10;2375;1485;135365;65015;25.7;12.4
02;2021-05-11;2878;1579;138243;66594;26.3;12.7
02;2021-05-12;2675;1628;140918;68222;26.8;13.0
02;2021-05-13;2990;1039;143908;69261;27.4;13.2
02;2021-05-14;3381;1209;147289;70470;28.0;13.4
02;2021-05-15;4374;1086;151663;71556;28.8;13.6
02;2021-05-16;2795;213;154458;71769;29.4;13.6
02;2021-05-17;2147;665;156605;72434;29.8;13.8
02;2021-05-18;2634;979;159239;73413;30.3;14.0
02;2021-05-19;2852;1000;162091;74413;30.8;14.1
02;2021-05-20;3553;1234;165644;75647;31.5;14.4
02;2021-05-21;3818;1075;169462;76722;32.2;14.6
02;2021-05-22;5845;970;175307;77692;33.3;14.8
02;2021-05-23;2658;240;177965;77932;33.8;14.8
02;2021-05-24;3541;544;181506;78476;34.5;14.9
02;2021-05-25;2257;1164;183763;79640;34.9;15.1
02;2021-05-26;3079;1498;186842;81138;35.5;15.4
02;2021-05-27;3649;1493;190491;82631;36.2;15.7
02;2021-05-28;3515;1586;194006;84217;36.9;16.0
02;2021-05-29;4078;1573;198084;85790;37.7;16.3
02;2021-05-30;1449;187;199533;85977;37.9;16.3
02;2021-05-31;2575;1197;202108;87174;38.4;16.6
02;2021-06-01;2870;1870;204978;89044;39.0;16.9
02;2021-06-02;3159;1656;208137;90700;39.6;17.2
02;2021-06-03;2854;1841;210991;92541;40.1;17.6
02;2021-06-04;3142;2063;214133;94604;40.7;18.0
02;2021-06-05;3441;1736;217574;96340;41.4;18.3
02;2021-06-06;1736;259;219310;96599;41.7;18.4
02;2021-06-07;1613;1501;220923;98100;42.0;18.6
02;2021-06-08;2061;1848;222984;99948;42.4;19.0
02;2021-06-09;2057;1653;225041;101601;42.8;19.3
02;2021-06-10;2011;1843;227052;103444;43.2;19.7
02;2021-06-11;2193;3073;229245;106517;43.6;20.2
02;2021-06-12;2310;2598;231555;109115;44.0;20.7
02;2021-06-13;683;1387;232238;110502;44.1;21.0
02;2021-06-14;1049;2392;233287;112894;44.3;21.5
02;2021-06-15;1518;2462;234805;115356;44.6;21.9
02;2021-06-16;1534;2749;236339;118105;44.9;22.5
02;2021-06-17;1782;2860;238121;120965;45.3;23.0
02;2021-06-18;2312;3573;240433;124538;45.7;23.7
02;2021-06-19;1841;3823;242274;128361;46.1;24.4
02;2021-06-20;645;1523;242919;129884;46.2;24.7
02;2021-06-21;806;3190;243725;133074;46.3;25.3
02;2021-06-22;1155;3668;244880;136742;46.6;26.0
02;2021-06-23;1226;3589;246106;140331;46.8;26.7
02;2021-06-24;1327;3150;247433;143481;47.0;27.3
02;2021-06-25;1399;4545;248832;148026;47.3;28.1
02;2021-06-26;1345;4229;250177;152255;47.6;28.9
02;2021-06-27;600;2333;250777;154588;47.7;29.4
02;2021-06-28;877;3021;251654;157609;47.8;30.0
02;2021-06-29;919;2929;252573;160538;48.0;30.5
02;2021-06-30;1510;3162;254083;163700;48.3;31.1
02;2021-07-01;1193;3592;255276;167292;48.5;31.8
02;2021-07-02;1358;5136;256634;172428;48.8;32.8
02;2021-07-03;999;5989;257633;178417;49.0;33.9
02;2021-07-04;509;2370;258142;180787;49.1;34.4
02;2021-07-05;661;3937;258803;184724;49.2;35.1
02;2021-07-06;675;3045;259478;187769;49.3;35.7
02;2021-07-07;1321;3726;260799;191495;49.6;36.4
02;2021-07-08;1394;3871;262193;195366;49.8;37.1
02;2021-07-09;1283;4221;263476;199587;50.1;37.9
02;2021-07-10;1333;4607;264809;204194;50.3;38.8
02;2021-07-11;480;1967;265289;206161;50.4;39.2
02;2021-07-12;1417;3732;266706;209893;50.7;39.9
02;2021-07-13;2065;3662;268771;213555;51.1;40.6
02;2021-07-14;1753;1599;270524;215154;51.4;40.9
02;2021-07-15;2727;3564;273251;218718;51.9;41.6
02;2021-07-16;3164;4219;276415;222937;52.5;42.4
02;2021-07-17;3561;4230;279976;227167;53.2;43.2
02;2021-07-18;2037;1616;282013;228783;53.6;43.5
02;2021-07-19;3440;3038;285453;231821;54.3;44.1
02;2021-07-20;3501;3306;288954;235127;54.9;44.7
02;2021-07-21;3909;2952;292863;238079;55.7;45.3
02;2021-07-22;3322;2805;296185;240884;56.3;45.8
02;2021-07-23;3205;3559;299390;244443;56.9;46.5
02;2021-07-24;4447;3724;303837;248167;57.8;47.2
02;2021-07-25;2192;1089;306029;249256;58.2;47.4
02;2021-07-26;3874;2252;309903;251508;58.9;47.8
02;2021-07-27;3660;2148;313563;253656;59.6;48.2
02;2021-07-28;3279;2102;316842;255758;60.2;48.6
02;2021-07-29;2583;2225;319425;257983;60.7;49.0
02;2021-07-30;3313;2312;322738;260295;61.4;49.5
02;2021-07-31;4183;2281;326921;262576;62.1;49.9
02;2021-08-01;1475;692;328396;263268;62.4;50.0
02;2021-08-02;2042;1602;330438;264870;62.8;50.4
02;2021-08-03;2530;1902;332968;266772;63.3;50.7
02;2021-08-04;2577;1713;335545;268485;63.8;51.0
02;2021-08-05;1849;2266;337394;270751;64.1;51.5
02;2021-08-06;2101;2741;339495;273492;64.5;52.0
02;2021-08-07;2522;2785;342017;276277;65.0;52.5
02;2021-08-08;1025;1572;343042;277849;65.2;52.8
02;2021-08-09;1909;2749;344951;280598;65.6;53.3
02;2021-08-10;1765;2462;346716;283060;65.9;53.8
02;2021-08-11;1481;2109;348197;285169;66.2;54.2
02;2021-08-12;1205;2332;349402;287501;66.4;54.7
02;2021-08-13;1611;2910;351013;290411;66.7;55.2
02;2021-08-14;1666;3696;352679;294107;67.0;55.9
02;2021-08-15;161;572;352840;294679;67.1;56.0
02;2021-08-16;1282;3755;354122;298434;67.3;56.7
02;2021-08-17;1421;2840;355543;301274;67.6;57.3
02;2021-08-18;1578;3184;357121;304458;67.9;57.9
02;2021-08-19;1134;3218;358255;307676;68.1;58.5
02;2021-08-20;1205;2951;359460;310627;68.3;59.0
02;2021-08-21;1449;4082;360909;314709;68.6;59.8
02;2021-08-22;407;1657;361316;316366;68.7;60.1
02;2021-08-23;1157;3080;362473;319446;68.9;60.7
02;2021-08-24;907;2185;363380;321631;69.1;61.1
02;2021-08-25;1021;2596;364401;324227;69.3;61.6
02;2021-08-26;913;2334;365314;326561;69.4;62.1
02;2021-08-27;965;2615;366279;329176;69.6;62.6
02;2021-08-28;1302;3429;367581;332605;69.9;63.2
02;2021-08-29;328;1171;367909;333776;69.9;63.4
02;2021-08-30;996;2431;368905;336207;70.1;63.9
02;2021-08-31;866;2171;369771;338378;70.3;64.3
02;2021-09-01;709;1422;370480;339800;70.4;64.6
02;2021-09-02;651;1610;371131;341410;70.6;64.9
02;2021-09-03;695;1797;371826;343207;70.7;65.2
02;2021-09-04;858;2760;372684;345967;70.8;65.8
02;2021-09-05;226;455;372910;346422;70.9;65.9
02;2021-09-06;406;901;373316;347323;71.0;66.0
02;2021-09-07;456;1195;373772;348518;71.1;66.3
02;2021-09-08;517;1736;374289;350254;71.2;66.6
02;2021-09-09;443;1176;374732;351430;71.2;66.8
02;2021-09-10;563;1364;375295;352794;71.3;67.1
02;2021-09-11;724;2127;376019;354921;71.5;67.5
02;2021-09-12;91;270;376110;355191;71.5;67.5
02;2021-09-13;425;952;376535;356143;71.6;67.7
02;2021-09-14;414;821;376949;356964;71.7;67.9
02;2021-09-15;447;1306;377396;358270;71.7;68.1
02;2021-09-16;457;832;377853;359102;71.8;68.3
02;2021-09-17;584;936;378437;360038;71.9;68.4
02;2021-09-18;567;2030;379004;362068;72.0;68.8
02;2021-09-19;78;259;379082;362327;72.1;68.9
02;2021-09-20;296;654;379378;362981;72.1;69.0
02;2021-09-21;278;626;379656;363607;72.2;69.1
02;2021-09-22;362;906;380018;364513;72.2;69.3
02;2021-09-23;261;563;380279;365076;72.3;69.4
02;2021-09-24;297;763;380576;365839;72.3;69.5
02;2021-09-25;318;1209;380894;367048;72.4;69.8
02;2021-09-26;33;158;380927;367206;72.4;69.8
02;2021-09-27;139;369;381066;367575;72.4;69.9
02;2021-09-28;156;392;381222;367967;72.5;69.9
02;2021-09-29;228;419;381450;368386;72.5;70.0
02;2021-09-30;238;480;381688;368866;72.6;70.1
02;2021-10-01;350;658;382038;369524;72.6;70.2
02;2021-10-02;390;853;382428;370377;72.7;70.4
02;2021-10-03;36;59;382464;370436;72.7;70.4
02;2021-10-04;155;361;382619;370797;72.7;70.5
02;2021-10-05;175;318;382794;371115;72.8;70.5
02;2021-10-06;256;422;383050;371537;72.8;70.6
02;2021-10-07;231;462;383281;371999;72.9;70.7
02;2021-10-08;313;603;383594;372602;72.9;70.8
02;2021-10-09;323;690;383917;373292;73.0;71.0
02;2021-10-10;30;56;383947;373348;73.0;71.0
02;2021-10-11;163;301;384110;373649;73.0;71.0
02;2021-10-12;137;296;384247;373945;73.0;71.1
02;2021-10-13;229;390;384476;374335;73.1;71.2
02;2021-10-14;191;307;384667;374642;73.1;71.2
03;2020-12-27;0;0;0;0;0.0;0.0
03;2020-12-28;1;0;1;0;0.0;0.0
03;2020-12-29;0;0;1;0;0.0;0.0
03;2020-12-30;1;0;2;0;0.0;0.0
03;2020-12-31;0;0;2;0;0.0;0.0
03;2021-01-01;0;0;2;0;0.0;0.0
03;2021-01-02;0;0;2;0;0.0;0.0
03;2021-01-03;0;0;2;0;0.0;0.0
03;2021-01-04;0;0;2;0;0.0;0.0
03;2021-01-05;0;0;2;0;0.0;0.0
03;2021-01-06;10;0;12;0;0.0;0.0
03;2021-01-07;61;0;73;0;0.0;0.0
03;2021-01-08;146;1;219;1;0.1;0.0
03;2021-01-09;122;0;341;1;0.1;0.0
03;2021-01-10;6;0;347;1;0.1;0.0
03;2021-01-11;412;1;759;2;0.2;0.0
03;2021-01-12;631;0;1390;2;0.4;0.0
03;2021-01-13;669;2;2059;4;0.6;0.0
03;2021-01-14;860;4;2919;8;0.9;0.0
03;2021-01-15;387;3;3306;11;1.0;0.0
03;2021-01-16;278;0;3584;11;1.1;0.0
03;2021-01-17;42;0;3626;11;1.1;0.0
03;2021-01-18;878;0;4504;11;1.4;0.0
03;2021-01-19;1151;2;5655;13;1.7;0.0
03;2021-01-20;1292;4;6947;17;2.1;0.0
03;2021-01-21;1202;5;8149;22;2.5;0.0
03;2021-01-22;1117;6;9266;28;2.8;0.0
03;2021-01-23;465;1;9731;29;2.9;0.0
03;2021-01-24;0;0;9731;29;2.9;0.0
03;2021-01-25;187;0;9918;29;3.0;0.0
03;2021-01-26;680;14;10598;43;3.2;0.0
03;2021-01-27;696;11;11294;54;3.4;0.0
03;2021-01-28;1021;50;12315;104;3.7;0.0
03;2021-01-29;856;83;13171;187;4.0;0.1
03;2021-01-30;600;2;13771;189;4.2;0.1
03;2021-01-31;0;0;13771;189;4.2;0.1
03;2021-02-01;160;76;13931;265;4.2;0.1
03;2021-02-02;767;268;14698;533;4.4;0.2
03;2021-02-03;1056;492;15754;1025;4.8;0.3
03;2021-02-04;1557;644;17311;1669;5.2;0.5
03;2021-02-05;948;318;18259;1987;5.5;0.6
03;2021-02-06;152;13;18411;2000;5.6;0.6
03;2021-02-07;5;0;18416;2000;5.6;0.6
03;2021-02-08;128;56;18544;2056;5.6;0.6
03;2021-02-09;612;448;19156;2504;5.8;0.8
03;2021-02-10;485;344;19641;2848;5.9;0.9
03;2021-02-11;1027;585;20668;3433;6.2;1.0
03;2021-02-12;1078;555;21746;3988;6.6;1.2
03;2021-02-13;126;167;21872;4155;6.6;1.3
03;2021-02-14;0;1;21872;4156;6.6;1.3
03;2021-02-15;309;862;22181;5018;6.7;1.5
03;2021-02-16;548;1166;22729;6184;6.9;1.9
03;2021-02-17;452;1356;23181;7540;7.0;2.3
03;2021-02-18;368;1270;23549;8810;7.1;2.7
03;2021-02-19;497;794;24046;9604;7.3;2.9
03;2021-02-20;128;183;24174;9787;7.3;3.0
03;2021-02-21;2;1;24176;9788;7.3;3.0
03;2021-02-22;158;202;24334;9990;7.3;3.0
03;2021-02-23;722;949;25056;10939;7.6;3.3
03;2021-02-24;610;1023;25666;11962;7.7;3.6
03;2021-02-25;1093;1834;26759;13796;8.1;4.2
03;2021-02-26;822;1375;27581;15171;8.3;4.6
03;2021-02-27;96;258;27677;15429;8.4;4.7
03;2021-02-28;0;15;27677;15444;8.4;4.7
03;2021-03-01;178;240;27855;15684;8.4;4.7
03;2021-03-02;818;660;28673;16344;8.7;4.9
03;2021-03-03;904;462;29577;16806;8.9;5.1
03;2021-03-04;1543;590;31120;17396;9.4;5.3
03;2021-03-05;1122;737;32242;18133;9.7;5.5
03;2021-03-06;915;114;33157;18247;10.0;5.5
03;2021-03-07;2;0;33159;18247;10.0;5.5
03;2021-03-08;240;246;33399;18493;10.1;5.6
03;2021-03-09;1016;440;34415;18933;10.4;5.7
03;2021-03-10;941;554;35356;19487;10.7;5.9
03;2021-03-11;1675;659;37031;20146;11.2;6.1
03;2021-03-12;1303;869;38334;21015;11.6;6.3
03;2021-03-13;864;114;39198;21129;11.8;6.4
03;2021-03-14;2;8;39200;21137;11.8;6.4
03;2021-03-15;250;200;39450;21337;11.9;6.4
03;2021-03-16;650;404;40100;21741;12.1;6.6
03;2021-03-17;1304;449;41404;22190;12.5;6.7
03;2021-03-18;1720;399;43124;22589;13.0;6.8
03;2021-03-19;1728;365;44852;22954;13.5;6.9
03;2021-03-20;301;27;45153;22981;13.6;6.9
03;2021-03-21;1;0;45154;22981;13.6;6.9
03;2021-03-22;224;398;45378;23379;13.7;7.1
03;2021-03-23;1355;357;46733;23736;14.1;7.2
03;2021-03-24;1824;352;48557;24088;14.7;7.3
03;2021-03-25;2367;572;50924;24660;15.4;7.4
03;2021-03-26;2240;452;53164;25112;16.0;7.6
03;2021-03-27;817;23;53981;25135;16.3;7.6
03;2021-03-28;1;39;53982;25174;16.3;7.6
03;2021-03-29;659;176;54641;25350;16.5;7.7
03;2021-03-30;1907;459;56548;25809;17.1;7.8
03;2021-03-31;1014;988;57562;26797;17.4;8.1
03;2021-04-01;1374;1127;58936;27924;17.8;8.4
03;2021-04-02;1705;616;60641;28540;18.3;8.6
03;2021-04-03;365;100;61006;28640;18.4;8.6
03;2021-04-04;3;0;61009;28640;18.4;8.6
03;2021-04-05;18;14;61027;28654;18.4;8.6
03;2021-04-06;1073;414;62100;29068;18.7;8.8
03;2021-04-07;1562;524;63662;29592;19.2;8.9
03;2021-04-08;2121;488;65783;30080;19.9;9.1
03;2021-04-09;2056;1165;67839;31245;20.5;9.4
03;2021-04-10;1013;73;68852;31318;20.8;9.5
03;2021-04-11;478;9;69330;31327;20.9;9.5
03;2021-04-12;986;228;70316;31555;21.2;9.5
03;2021-04-13;1873;989;72189;32544;21.8;9.8
03;2021-04-14;2334;1225;74523;33769;22.5;10.2
03;2021-04-15;2621;1405;77144;35174;23.3;10.6
03;2021-04-16;2834;1187;79978;36361;24.1;11.0
03;2021-04-17;1083;443;81061;36804;24.5;11.1
03;2021-04-18;0;0;81061;36804;24.5;11.1
03;2021-04-19;1191;588;82252;37392;24.8;11.3
03;2021-04-20;1747;1277;83999;38669;25.4;11.7
03;2021-04-21;1122;1295;85121;39964;25.7;12.1
03;2021-04-22;1675;1007;86796;40971;26.2;12.4
03;2021-04-23;2478;1274;89274;42245;26.9;12.8
03;2021-04-24;1301;928;90575;43173;27.3;13.0
03;2021-04-25;350;16;90925;43189;27.4;13.0
03;2021-04-26;1332;467;92257;43656;27.8;13.2
03;2021-04-27;1766;1530;94023;45186;28.4;13.6
03;2021-04-28;1930;1125;95953;46311;29.0;14.0
03;2021-04-29;2371;1253;98324;47564;29.7;14.4
03;2021-04-30;1931;810;100255;48374;30.3;14.6
03;2021-05-01;438;493;100693;48867;30.4;14.7
03;2021-05-02;2;1;100695;48868;30.4;14.7
03;2021-05-03;1912;775;102607;49643;31.0;15.0
03;2021-05-04;2847;1637;105454;51280;31.8;15.5
03;2021-05-05;2604;1332;108058;52612;32.6;15.9
03;2021-05-06;3095;2011;111153;54623;33.5;16.5
03;2021-05-07;4729;1800;115882;56423;35.0;17.0
03;2021-05-08;661;381;116543;56804;35.2;17.1
03;2021-05-09;49;511;116592;57315;35.2;17.3
03;2021-05-10;1892;1481;118484;58796;35.8;17.7
03;2021-05-11;3902;1841;122386;60637;36.9;18.3
03;2021-05-12;2972;1523;125358;62160;37.8;18.8
03;2021-05-13;4384;410;129742;62570;39.2;18.9
03;2021-05-14;3657;1700;133399;64270;40.3;19.4
03;2021-05-15;1943;491;135342;64761;40.8;19.5
03;2021-05-16;522;57;135864;64818;41.0;19.6
03;2021-05-17;1277;862;137141;65680;41.4;19.8
03;2021-05-18;3068;1506;140209;67186;42.3;20.3
03;2021-05-19;2623;967;142832;68153;43.1;20.6
03;2021-05-20;3334;1145;146166;69298;44.1;20.9
03;2021-05-21;4194;1285;150360;70583;45.4;21.3
03;2021-05-22;2012;360;152372;70943;46.0;21.4
03;2021-05-23;641;73;153013;71016;46.2;21.4
03;2021-05-24;2654;216;155667;71232;47.0;21.5
03;2021-05-25;3067;1692;158734;72924;47.9;22.0
03;2021-05-26;2336;1044;161070;73968;48.6;22.3
03;2021-05-27;2945;1126;164015;75094;49.5;22.7
03;2021-05-28;3848;2287;167863;77381;50.7;23.4
03;2021-05-29;1747;603;169610;77984;51.2;23.5
03;2021-05-30;242;23;169852;78007;51.3;23.5
03;2021-05-31;697;575;170549;78582;51.5;23.7
03;2021-06-01;2302;2347;172851;80929;52.2;24.4
03;2021-06-02;1534;1749;174385;82678;52.6;25.0
03;2021-06-03;2060;2755;176445;85433;53.3;25.8
03;2021-06-04;1698;2508;178143;87941;53.8;26.5
03;2021-06-05;1076;1144;179219;89085;54.1;26.9
03;2021-06-06;59;7;179278;89092;54.1;26.9
03;2021-06-07;785;1815;180063;90907;54.3;27.4
03;2021-06-08;1458;2557;181521;93464;54.8;28.2
03;2021-06-09;1267;1877;182788;95341;55.2;28.8
03;2021-06-10;1381;2124;184169;97465;55.6;29.4
03;2021-06-11;1503;3450;185672;100915;56.0;30.5
03;2021-06-12;831;823;186503;101738;56.3;30.7
03;2021-06-13;20;10;186523;101748;56.3;30.7
03;2021-06-14;381;2177;186904;103925;56.4;31.4
03;2021-06-15;1317;3837;188221;107762;56.8;32.5
03;2021-06-16;788;2890;189009;110652;57.0;33.4
03;2021-06-17;1083;3334;190092;113986;57.4;34.4
03;2021-06-18;1107;3981;191199;117967;57.7;35.6
03;2021-06-19;641;1618;191840;119585;57.9;36.1
03;2021-06-20;20;8;191860;119593;57.9;36.1
03;2021-06-21;461;2636;192321;122229;58.0;36.9
03;2021-06-22;1027;4003;193348;126232;58.4;38.1
03;2021-06-23;716;3285;194064;129517;58.6;39.1
03;2021-06-24;982;3862;195046;133379;58.9;40.3
03;2021-06-25;1016;3893;196062;137272;59.2;41.4
03;2021-06-26;513;2040;196575;139312;59.3;42.0
03;2021-06-27;65;486;196640;139798;59.4;42.2
03;2021-06-28;642;2101;197282;141899;59.5;42.8
03;2021-06-29;1028;3330;198310;145229;59.9;43.8
03;2021-06-30;831;3119;199141;148348;60.1;44.8
03;2021-07-01;987;2936;200128;151284;60.4;45.7
03;2021-07-02;920;4094;201048;155378;60.7;46.9
03;2021-07-03;487;1884;201535;157262;60.8;47.5
03;2021-07-04;20;332;201555;157594;60.8;47.6
03;2021-07-05;818;2381;202373;159975;61.1;48.3
03;2021-07-06;1172;3462;203545;163437;61.4;49.3
03;2021-07-07;804;2618;204349;166055;61.7;50.1
03;2021-07-08;1060;3043;205409;169098;62.0;51.0
03;2021-07-09;1470;3626;206879;172724;62.4;52.1
03;2021-07-10;508;1925;207387;174649;62.6;52.7
03;2021-07-11;61;492;207448;175141;62.6;52.9
03;2021-07-12;939;1148;208387;176289;62.9;53.2
03;2021-07-13;2613;3153;211000;179442;63.7;54.2
03;2021-07-14;195;25;211195;179467;63.7;54.2
03;2021-07-15;2613;2454;213808;181921;64.5;54.9
03;2021-07-16;2737;2275;216545;184196;65.4;55.6
03;2021-07-17;1032;1626;217577;185822;65.7;56.1
03;2021-07-18;33;8;217610;185830;65.7;56.1
03;2021-07-19;2391;1277;220001;187107;66.4;56.5
03;2021-07-20;3075;3033;223076;190140;67.3;57.4
03;2021-07-21;3214;1440;226290;191580;68.3;57.8
03;2021-07-22;2851;1887;229141;193467;69.2;58.4
03;2021-07-23;3205;1307;232346;194774;70.1;58.8
03;2021-07-24;590;581;232936;195355;70.3;59.0
03;2021-07-25;18;5;232954;195360;70.3;59.0
03;2021-07-26;2043;1579;234997;196939;70.9;59.4
03;2021-07-27;3321;2230;238318;199169;71.9;60.1
03;2021-07-28;2719;1118;241037;200287;72.8;60.5
03;2021-07-29;2549;1662;243586;201949;73.5;61.0
03;2021-07-30;2136;1455;245722;203404;74.2;61.4
03;2021-07-31;964;893;246686;204297;74.5;61.7
03;2021-08-01;13;20;246699;204317;74.5;61.7
03;2021-08-02;1679;1605;248378;205922;75.0;62.2
03;2021-08-03;2223;2778;250601;208700;75.6;63.0
03;2021-08-04;2195;894;252796;209594;76.3;63.3
03;2021-08-05;1265;1939;254061;211533;76.7;63.8
03;2021-08-06;1281;1028;255342;212561;77.1;64.2
03;2021-08-07;614;496;255956;213057;77.3;64.3
03;2021-08-08;66;29;256022;213086;77.3;64.3
03;2021-08-09;597;1304;256619;214390;77.5;64.7
03;2021-08-10;1676;3471;258295;217861;78.0;65.8
03;2021-08-11;1333;2529;259628;220390;78.4;66.5
03;2021-08-12;1135;3514;260763;223904;78.7;67.6
03;2021-08-13;776;1052;261539;224956;78.9;67.9
03;2021-08-14;380;566;261919;225522;79.1;68.1
03;2021-08-15;9;61;261928;225583;79.1;68.1
03;2021-08-16;725;2693;262653;228276;79.3;68.9
03;2021-08-17;1076;3218;263729;231494;79.6;69.9
03;2021-08-18;1164;2157;264893;233651;80.0;70.5
03;2021-08-19;1010;3049;265903;236700;80.3;71.4
03;2021-08-20;718;1138;266621;237838;80.5;71.8
03;2021-08-21;418;727;267039;238565;80.6;72.0
03;2021-08-22;8;6;267047;238571;80.6;72.0
03;2021-08-23;784;2289;267831;240860;80.8;72.7
03;2021-08-24;893;2406;268724;243266;81.1;73.4
03;2021-08-25;935;2029;269659;245295;81.4;74.0
03;2021-08-26;574;1435;270233;246730;81.6;74.5
03;2021-08-27;457;1581;270690;248311;81.7;74.9
03;2021-08-28;219;674;270909;248985;81.8;75.2
03;2021-08-29;4;0;270913;248985;81.8;75.2
03;2021-08-30;768;1450;271681;250435;82.0;75.6
03;2021-08-31;706;1949;272387;252384;82.2;76.2
03;2021-09-01;604;1292;272991;253676;82.4;76.6
03;2021-09-02;479;1091;273470;254767;82.5;76.9
03;2021-09-03;494;1074;273964;255841;82.7;77.2
03;2021-09-04;251;608;274215;256449;82.8;77.4
03;2021-09-05;7;14;274222;256463;82.8;77.4
03;2021-09-06;321;688;274543;257151;82.9;77.6
03;2021-09-07;579;1172;275122;258323;83.0;78.0
03;2021-09-08;424;1244;275546;259567;83.2;78.3
03;2021-09-09;276;661;275822;260228;83.3;78.5
03;2021-09-10;414;911;276236;261139;83.4;78.8
03;2021-09-11;209;651;276445;261790;83.4;79.0
03;2021-09-12;2;20;276447;261810;83.4;79.0
03;2021-09-13;285;660;276732;262470;83.5;79.2
03;2021-09-14;449;931;277181;263401;83.7;79.5
03;2021-09-15;359;996;277540;264397;83.8;79.8
03;2021-09-16;219;555;277759;264952;83.8;80.0
03;2021-09-17;161;356;277920;265308;83.9;80.1
03;2021-09-18;132;311;278052;265619;83.9;80.2
03;2021-09-19;0;11;278052;265630;83.9;80.2
03;2021-09-20;187;424;278239;266054;84.0;80.3
03;2021-09-21;252;721;278491;266775;84.1;80.5
03;2021-09-22;268;685;278759;267460;84.1;80.7
03;2021-09-23;178;461;278937;267921;84.2;80.9
03;2021-09-24;148;321;279085;268242;84.2;81.0
03;2021-09-25;51;257;279136;268499;84.3;81.0
03;2021-09-26;3;0;279139;268499;84.3;81.0
03;2021-09-27;116;326;279255;268825;84.3;81.1
03;2021-09-28;193;617;279448;269442;84.3;81.3
03;2021-09-29;213;505;279661;269947;84.4;81.5
03;2021-09-30;122;251;279783;270198;84.4;81.6
03;2021-10-01;155;489;279938;270687;84.5;81.7
03;2021-10-02;82;176;280020;270863;84.5;81.8
03;2021-10-03;0;0;280020;270863;84.5;81.8
03;2021-10-04;42;102;280062;270965;84.5;81.8
03;2021-10-05;169;390;280231;271355;84.6;81.9
03;2021-10-06;274;546;280505;271901;84.7;82.1
03;2021-10-07;99;207;280604;272108;84.7;82.1
03;2021-10-08;129;282;280733;272390;84.7;82.2
03;2021-10-09;109;165;280842;272555;84.8;82.3
03;2021-10-10;5;2;280847;272557;84.8;82.3
03;2021-10-11;161;293;281008;272850;84.8;82.4
03;2021-10-12;180;285;281188;273135;84.9;82.4
03;2021-10-13;241;383;281429;273518;84.9;82.6
03;2021-10-14;89;154;281518;273672;85.0;82.6
04;2020-12-27;0;0;0;0;0.0;0.0
04;2020-12-28;1;0;1;0;0.0;0.0
04;2020-12-29;0;0;1;0;0.0;0.0
04;2020-12-30;0;0;1;0;0.0;0.0
04;2020-12-31;0;0;1;0;0.0;0.0
04;2021-01-01;0;0;1;0;0.0;0.0
04;2021-01-02;0;0;1;0;0.0;0.0
04;2021-01-03;0;0;1;0;0.0;0.0
04;2021-01-04;0;0;1;0;0.0;0.0
04;2021-01-05;4;0;5;0;0.0;0.0
04;2021-01-06;0;0;5;0;0.0;0.0
04;2021-01-07;61;0;66;0;0.0;0.0
04;2021-01-08;88;0;154;0;0.1;0.0
04;2021-01-09;57;0;211;0;0.1;0.0
04;2021-01-10;0;0;211;0;0.1;0.0
04;2021-01-11;77;0;288;0;0.2;0.0
04;2021-01-12;421;0;709;0;0.4;0.0
04;2021-01-13;244;2;953;2;0.6;0.0
04;2021-01-14;90;2;1043;4;0.6;0.0
04;2021-01-15;164;4;1207;8;0.7;0.0
04;2021-01-16;106;3;1313;11;0.8;0.0
04;2021-01-17;14;0;1327;11;0.8;0.0
04;2021-01-18;236;9;1563;20;0.9;0.0
04;2021-01-19;469;4;2032;24;1.2;0.0
04;2021-01-20;574;10;2606;34;1.6;0.0
04;2021-01-21;615;6;3221;40;1.9;0.0
04;2021-01-22;638;1;3859;41;2.3;0.0
04;2021-01-23;111;0;3970;41;2.4;0.0
04;2021-01-24;0;0;3970;41;2.4;0.0
04;2021-01-25;240;0;4210;41;2.5;0.0
04;2021-01-26;656;1;4866;42;2.9;0.0
04;2021-01-27;480;0;5346;42;3.2;0.0
04;2021-01-28;665;22;6011;64;3.6;0.0
04;2021-01-29;368;43;6379;107;3.9;0.1
04;2021-01-30;65;41;6444;148;3.9;0.1
04;2021-01-31;1;5;6445;153;3.9;0.1
04;2021-02-01;268;150;6713;303;4.1;0.2
04;2021-02-02;562;225;7275;528;4.4;0.3
04;2021-02-03;367;159;7642;687;4.6;0.4
04;2021-02-04;359;54;8001;741;4.8;0.4
04;2021-02-05;379;219;8380;960;5.1;0.6
04;2021-02-06;50;93;8430;1053;5.1;0.6
04;2021-02-07;2;22;8432;1075;5.1;0.7
04;2021-02-08;163;71;8595;1146;5.2;0.7
04;2021-02-09;196;143;8791;1289;5.3;0.8
04;2021-02-10;253;170;9044;1459;5.5;0.9
04;2021-02-11;363;291;9407;1750;5.7;1.1
04;2021-02-12;293;317;9700;2067;5.9;1.3
04;2021-02-13;27;94;9727;2161;5.9;1.3
04;2021-02-14;0;0;9727;2161;5.9;1.3
04;2021-02-15;31;164;9758;2325;5.9;1.4
04;2021-02-16;81;520;9839;2845;6.0;1.7
04;2021-02-17;67;431;9906;3276;6.0;2.0
04;2021-02-18;45;614;9951;3890;6.0;2.4
04;2021-02-19;53;371;10004;4261;6.1;2.6
04;2021-02-20;5;71;10009;4332;6.1;2.6
04;2021-02-21;0;0;10009;4332;6.1;2.6
04;2021-02-22;7;297;10016;4629;6.1;2.8
04;2021-02-23;19;594;10035;5223;6.1;3.2
04;2021-02-24;38;447;10073;5670;6.1;3.4
04;2021-02-25;73;377;10146;6047;6.1;3.7
04;2021-02-26;216;335;10362;6382;6.3;3.9
04;2021-02-27;179;75;10541;6457;6.4;3.9
04;2021-02-28;1;0;10542;6457;6.4;3.9
04;2021-03-01;18;74;10560;6531;6.4;4.0
04;2021-03-02;135;41;10695;6572;6.5;4.0
04;2021-03-03;375;644;11070;7216;6.7;4.4
04;2021-03-04;208;490;11278;7706;6.8;4.7
04;2021-03-05;236;358;11514;8064;7.0;4.9
04;2021-03-06;912;78;12426;8142;7.5;4.9
04;2021-03-07;498;26;12924;8168;7.8;4.9
04;2021-03-08;45;84;12969;8252;7.9;5.0
04;2021-03-09;215;258;13184;8510;8.0;5.2
04;2021-03-10;401;375;13585;8885;8.2;5.4
04;2021-03-11;496;342;14081;9227;8.5;5.6
04;2021-03-12;697;210;14778;9437;8.9;5.7
04;2021-03-13;1088;64;15866;9501;9.6;5.8
04;2021-03-14;460;4;16326;9505;9.9;5.8
04;2021-03-15;93;14;16419;9519;9.9;5.8
04;2021-03-16;74;9;16493;9528;10.0;5.8
04;2021-03-17;534;86;17027;9614;10.3;5.8
04;2021-03-18;814;25;17841;9639;10.8;5.8
04;2021-03-19;723;33;18564;9672;11.2;5.9
04;2021-03-20;159;3;18723;9675;11.3;5.9
04;2021-03-21;0;0;18723;9675;11.3;5.9
04;2021-03-22;105;13;18828;9688;11.4;5.9
04;2021-03-23;245;7;19073;9695;11.5;5.9
04;2021-03-24;1024;54;20097;9749;12.2;5.9
04;2021-03-25;1326;48;21423;9797;13.0;5.9
04;2021-03-26;1448;69;22871;9866;13.8;6.0
04;2021-03-27;266;22;23137;9888;14.0;6.0
04;2021-03-28;2;0;23139;9888;14.0;6.0
04;2021-03-29;680;13;23819;9901;14.4;6.0
04;2021-03-30;1086;150;24905;10051;15.1;6.1
04;2021-03-31;1327;107;26232;10158;15.9;6.1
04;2021-04-01;1133;133;27365;10291;16.6;6.2
04;2021-04-02;1185;114;28550;10405;17.3;6.3
04;2021-04-03;250;21;28800;10426;17.4;6.3
04;2021-04-04;1;0;28801;10426;17.4;6.3
04;2021-04-05;36;1;28837;10427;17.5;6.3
04;2021-04-06;929;155;29766;10582;18.0;6.4
04;2021-04-07;881;438;30647;11020;18.6;6.7
04;2021-04-08;926;696;31573;11716;19.1;7.1
04;2021-04-09;678;423;32251;12139;19.5;7.3
04;2021-04-10;231;192;32482;12331;19.7;7.5
04;2021-04-11;154;65;32636;12396;19.8;7.5
04;2021-04-12;593;103;33229;12499;20.1;7.6
04;2021-04-13;1189;242;34418;12741;20.8;7.7
04;2021-04-14;994;500;35412;13241;21.4;8.0
04;2021-04-15;921;673;36333;13914;22.0;8.4
04;2021-04-16;819;457;37152;14371;22.5;8.7
04;2021-04-17;209;69;37361;14440;22.6;8.7
04;2021-04-18;0;13;37361;14453;22.6;8.7
04;2021-04-19;338;288;37699;14741;22.8;8.9
04;2021-04-20;1003;446;38702;15187;23.4;9.2
04;2021-04-21;656;747;39358;15934;23.8;9.6
04;2021-04-22;758;855;40116;16789;24.3;10.2
04;2021-04-23;696;540;40812;17329;24.7;10.5
04;2021-04-24;165;65;40977;17394;24.8;10.5
04;2021-04-25;0;0;40977;17394;24.8;10.5
04;2021-04-26;172;613;41149;18007;24.9;10.9
04;2021-04-27;395;967;41544;18974;25.1;11.5
04;2021-04-28;431;1089;41975;20063;25.4;12.1
04;2021-04-29;688;1130;42663;21193;25.8;12.8
04;2021-04-30;436;850;43099;22043;26.1;13.3
04;2021-05-01;104;22;43203;22065;26.2;13.4
04;2021-05-02;8;131;43211;22196;26.2;13.4
04;2021-05-03;151;551;43362;22747;26.2;13.8
04;2021-05-04;564;839;43926;23586;26.6;14.3
04;2021-05-05;514;927;44440;24513;26.9;14.8
04;2021-05-06;1161;592;45601;25105;27.6;15.2
04;2021-05-07;656;765;46257;25870;28.0;15.7
04;2021-05-08;48;99;46305;25969;28.0;15.7
04;2021-05-09;0;0;46305;25969;28.0;15.7
04;2021-05-10;467;297;46772;26266;28.3;15.9
04;2021-05-11;1198;907;47970;27173;29.0;16.4
04;2021-05-12;1387;741;49357;27914;29.9;16.9
04;2021-05-13;378;131;49735;28045;30.1;17.0
04;2021-05-14;441;296;50176;28341;30.4;17.2
04;2021-05-15;99;162;50275;28503;30.4;17.3
04;2021-05-16;4;6;50279;28509;30.4;17.3
04;2021-05-17;155;297;50434;28806;30.5;17.4
04;2021-05-18;392;975;50826;29781;30.8;18.0
04;2021-05-19;773;688;51599;30469;31.2;18.4
04;2021-05-20;1256;548;52855;31017;32.0;18.8
04;2021-05-21;853;787;53708;31804;32.5;19.3
04;2021-05-22;105;146;53813;31950;32.6;19.3
04;2021-05-23;1;1;53814;31951;32.6;19.3
04;2021-05-24;2;36;53816;31987;32.6;19.4
04;2021-05-25;868;596;54684;32583;33.1;19.7
04;2021-05-26;1048;791;55732;33374;33.7;20.2
04;2021-05-27;1356;632;57088;34006;34.6;20.6
04;2021-05-28;1119;656;58207;34662;35.2;21.0
04;2021-05-29;90;398;58297;35060;35.3;21.2
04;2021-05-30;3;1;58300;35061;35.3;21.2
04;2021-05-31;420;416;58720;35477;35.5;21.5
04;2021-06-01;640;641;59360;36118;35.9;21.9
04;2021-06-02;871;1063;60231;37181;36.5;22.5
04;2021-06-03;1196;851;61427;38032;37.2;23.0
04;2021-06-04;978;779;62405;38811;37.8;23.5
04;2021-06-05;142;203;62547;39014;37.9;23.6
04;2021-06-06;7;13;62554;39027;37.9;23.6
04;2021-06-07;563;317;63117;39344;38.2;23.8
04;2021-06-08;839;595;63956;39939;38.7;24.2
04;2021-06-09;1146;689;65102;40628;39.4;24.6
04;2021-06-10;1142;585;66244;41213;40.1;24.9
04;2021-06-11;944;615;67188;41828;40.7;25.3
04;2021-06-12;212;148;67400;41976;40.8;25.4
04;2021-06-13;1;1;67401;41977;40.8;25.4
04;2021-06-14;478;303;67879;42280;41.1;25.6
04;2021-06-15;644;1003;68523;43283;41.5;26.2
04;2021-06-16;1023;787;69546;44070;42.1;26.7
04;2021-06-17;1001;959;70547;45029;42.7;27.3
04;2021-06-18;761;886;71308;45915;43.2;27.8
04;2021-06-19;40;85;71348;46000;43.2;27.8
04;2021-06-20;7;9;71355;46009;43.2;27.9
04;2021-06-21;304;613;71659;46622;43.4;28.2
04;2021-06-22;361;1308;72020;47930;43.6;29.0
04;2021-06-23;474;1311;72494;49241;43.9;29.8
04;2021-06-24;852;820;73346;50061;44.4;30.3
04;2021-06-25;461;639;73807;50700;44.7;30.7
04;2021-06-26;57;130;73864;50830;44.7;30.8
04;2021-06-27;4;4;73868;50834;44.7;30.8
04;2021-06-28;158;341;74026;51175;44.8;31.0
04;2021-06-29;370;838;74396;52013;45.0;31.5
04;2021-06-30;541;1121;74937;53134;45.4;32.2
04;2021-07-01;578;1219;75515;54353;45.7;32.9
04;2021-07-02;557;1090;76072;55443;46.0;33.6
04;2021-07-03;65;162;76137;55605;46.1;33.7
04;2021-07-04;6;6;76143;55611;46.1;33.7
04;2021-07-05;106;297;76249;55908;46.2;33.8
04;2021-07-06;503;1383;76752;57291;46.5;34.7
04;2021-07-07;494;1341;77246;58632;46.8;35.5
04;2021-07-08;725;1361;77971;59993;47.2;36.3
04;2021-07-09;580;1063;78551;61056;47.5;37.0
04;2021-07-10;92;177;78643;61233;47.6;37.1
04;2021-07-11;0;21;78643;61254;47.6;37.1
04;2021-07-12;128;652;78771;61906;47.7;37.5
04;2021-07-13;883;1541;79654;63447;48.2;38.4
04;2021-07-14;26;43;79680;63490;48.2;38.4
04;2021-07-15;1219;1736;80899;65226;49.0;39.5
04;2021-07-16;1082;1118;81981;66344;49.6;40.2
04;2021-07-17;446;235;82427;66579;49.9;40.3
04;2021-07-18;114;18;82541;66597;50.0;40.3
04;2021-07-19;484;655;83025;67252;50.3;40.7
04;2021-07-20;1313;1469;84338;68721;51.1;41.6
04;2021-07-21;1126;1166;85464;69887;51.7;42.3
04;2021-07-22;1500;1372;86964;71259;52.6;43.1
04;2021-07-23;1150;1142;88114;72401;53.3;43.8
04;2021-07-24;685;215;88799;72616;53.8;44.0
04;2021-07-25;42;20;88841;72636;53.8;44.0
04;2021-07-26;445;639;89286;73275;54.0;44.4
04;2021-07-27;1370;1046;90656;74321;54.9;45.0
04;2021-07-28;1073;1037;91729;75358;55.5;45.6
04;2021-07-29;1561;1302;93290;76660;56.5;46.4
04;2021-07-30;1244;924;94534;77584;57.2;47.0
04;2021-07-31;251;176;94785;77760;57.4;47.1
04;2021-08-01;48;19;94833;77779;57.4;47.1
04;2021-08-02;196;110;95029;77889;57.5;47.1
04;2021-08-03;1348;1119;96377;79008;58.3;47.8
04;2021-08-04;1178;864;97555;79872;59.1;48.3
04;2021-08-05;1194;738;98749;80610;59.8;48.8
04;2021-08-06;516;396;99265;81006;60.1;49.0
04;2021-08-07;162;162;99427;81168;60.2;49.1
04;2021-08-08;25;12;99452;81180;60.2;49.1
04;2021-08-09;102;117;99554;81297;60.3;49.2
04;2021-08-10;655;981;100209;82278;60.7;49.8
04;2021-08-11;1147;1020;101356;83298;61.4;50.4
04;2021-08-12;1124;1308;102480;84606;62.0;51.2
04;2021-08-13;443;386;102923;84992;62.3;51.4
04;2021-08-14;100;73;103023;85065;62.4;51.5
04;2021-08-15;1;0;103024;85065;62.4;51.5
04;2021-08-16;103;138;103127;85203;62.4;51.6
04;2021-08-17;496;1015;103623;86218;62.7;52.2
04;2021-08-18;720;1318;104343;87536;63.2;53.0
04;2021-08-19;740;1413;105083;88949;63.6;53.8
04;2021-08-20;748;1363;105831;90312;64.1;54.7
04;2021-08-21;66;111;105897;90423;64.1;54.7
04;2021-08-22;15;45;105912;90468;64.1;54.8
04;2021-08-23;55;110;105967;90578;64.1;54.8
04;2021-08-24;685;1494;106652;92072;64.6;55.7
04;2021-08-25;658;1183;107310;93255;65.0;56.5
04;2021-08-26;488;1217;107798;94472;65.3;57.2
04;2021-08-27;452;929;108250;95401;65.5;57.7
04;2021-08-28;132;245;108382;95646;65.6;57.9
04;2021-08-29;27;23;108409;95669;65.6;57.9
04;2021-08-30;122;240;108531;95909;65.7;58.1
04;2021-08-31;511;976;109042;96885;66.0;58.6
04;2021-09-01;511;1200;109553;98085;66.3;59.4
04;2021-09-02;336;855;109889;98940;66.5;59.9
04;2021-09-03;289;766;110178;99706;66.7;60.4
04;2021-09-04;148;227;110326;99933;66.8;60.5
04;2021-09-05;14;9;110340;99942;66.8;60.5
04;2021-09-06;57;103;110397;100045;66.8;60.6
04;2021-09-07;371;834;110768;100879;67.1;61.1
04;2021-09-08;328;740;111096;101619;67.3;61.5
04;2021-09-09;341;724;111437;102343;67.5;62.0
04;2021-09-10;280;667;111717;103010;67.6;62.4
04;2021-09-11;93;114;111810;103124;67.7;62.4
04;2021-09-12;18;23;111828;103147;67.7;62.4
04;2021-09-13;95;72;111923;103219;67.8;62.5
04;2021-09-14;335;609;112258;103828;68.0;62.9
04;2021-09-15;309;702;112567;104530;68.1;63.3
04;2021-09-16;312;523;112879;105053;68.3;63.6
04;2021-09-17;185;565;113064;105618;68.4;63.9
04;2021-09-18;48;123;113112;105741;68.5;64.0
04;2021-09-19;0;5;113112;105746;68.5;64.0
04;2021-09-20;79;51;113191;105797;68.5;64.0
04;2021-09-21;188;570;113379;106367;68.6;64.4
04;2021-09-22;162;677;113541;107044;68.7;64.8
04;2021-09-23;205;377;113746;107421;68.9;65.0
04;2021-09-24;143;436;113889;107857;68.9;65.3
04;2021-09-25;42;99;113931;107956;69.0;65.3
04;2021-09-26;6;26;113937;107982;69.0;65.4
04;2021-09-27;19;66;113956;108048;69.0;65.4
04;2021-09-28;139;277;114095;108325;69.1;65.6
04;2021-09-29;136;383;114231;108708;69.1;65.8
04;2021-09-30;123;274;114354;108982;69.2;66.0
04;2021-10-01;120;183;114474;109165;69.3;66.1
04;2021-10-02;60;135;114534;109300;69.3;66.2
04;2021-10-03;3;5;114537;109305;69.3;66.2
04;2021-10-04;35;45;114572;109350;69.4;66.2
04;2021-10-05;171;341;114743;109691;69.5;66.4
04;2021-10-06;183;343;114926;110034;69.6;66.6
04;2021-10-07;94;282;115020;110316;69.6;66.8
04;2021-10-08;99;171;115119;110487;69.7;66.9
04;2021-10-09;25;88;115144;110575;69.7;66.9
04;2021-10-10;2;2;115146;110577;69.7;66.9
04;2021-10-11;33;118;115179;110695;69.7;67.0
04;2021-10-12;112;187;115291;110882;69.8;67.1
04;2021-10-13;169;271;115460;111153;69.9;67.3
04;2021-10-14;70;198;115530;111351;69.9;67.4
05;2020-12-27;0;0;0;0;0.0;0.0
05;2020-12-28;1;0;1;0;0.0;0.0
05;2020-12-29;1;0;2;0;0.0;0.0
05;2020-12-30;2;0;4;0;0.0;0.0
05;2020-12-31;0;0;4;0;0.0;0.0
05;2021-01-01;2;0;6;0;0.0;0.0
05;2021-01-02;2;0;8;0;0.0;0.0
05;2021-01-03;1;0;9;0;0.0;0.0
05;2021-01-04;2;0;11;0;0.0;0.0
05;2021-01-05;0;0;11;0;0.0;0.0
05;2021-01-06;22;1;33;1;0.0;0.0
05;2021-01-07;128;0;161;1;0.1;0.0
05;2021-01-08;146;1;307;2;0.2;0.0
05;2021-01-09;11;0;318;2;0.2;0.0
05;2021-01-10;0;0;318;2;0.2;0.0
05;2021-01-11;44;0;362;2;0.3;0.0
05;2021-01-12;104;0;466;2;0.3;0.0
05;2021-01-13;139;0;605;2;0.4;0.0
05;2021-01-14;167;0;772;2;0.5;0.0
05;2021-01-15;127;1;899;3;0.6;0.0
05;2021-01-16;15;0;914;3;0.6;0.0
05;2021-01-17;0;0;914;3;0.6;0.0
05;2021-01-18;226;1;1140;4;0.8;0.0
05;2021-01-19;227;0;1367;4;1.0;0.0
05;2021-01-20;213;0;1580;4;1.1;0.0
05;2021-01-21;255;0;1835;4;1.3;0.0
05;2021-01-22;196;1;2031;5;1.4;0.0
05;2021-01-23;113;0;2144;5;1.5;0.0
05;2021-01-24;0;0;2144;5;1.5;0.0
05;2021-01-25;316;0;2460;5;1.7;0.0
05;2021-01-26;486;0;2946;5;2.1;0.0
05;2021-01-27;389;4;3335;9;2.4;0.0
05;2021-01-28;363;56;3698;65;2.6;0.0
05;2021-01-29;364;113;4062;178;2.9;0.1
05;2021-01-30;97;9;4159;187;2.9;0.1
05;2021-01-31;4;0;4163;187;2.9;0.1
05;2021-02-01;177;21;4340;208;3.1;0.1
05;2021-02-02;187;120;4527;328;3.2;0.2
05;2021-02-03;208;63;4735;391;3.3;0.3
05;2021-02-04;197;125;4932;516;3.5;0.4
05;2021-02-05;183;109;5115;625;3.6;0.4
05;2021-02-06;76;24;5191;649;3.7;0.5
05;2021-02-07;0;5;5191;654;3.7;0.5
05;2021-02-08;84;124;5275;778;3.7;0.5
05;2021-02-09;97;113;5372;891;3.8;0.6
05;2021-02-10;81;175;5453;1066;3.8;0.8
05;2021-02-11;87;137;5540;1203;3.9;0.8
05;2021-02-12;85;148;5625;1351;4.0;1.0
05;2021-02-13;75;31;5700;1382;4.0;1.0
05;2021-02-14;0;0;5700;1382;4.0;1.0
05;2021-02-15;98;190;5798;1572;4.1;1.1
05;2021-02-16;111;286;5909;1858;4.2;1.3
05;2021-02-17;136;231;6045;2089;4.3;1.5
05;2021-02-18;154;299;6199;2388;4.4;1.7
05;2021-02-19;158;322;6357;2710;4.5;1.9
05;2021-02-20;31;87;6388;2797;4.5;2.0
05;2021-02-21;0;0;6388;2797;4.5;2.0
05;2021-02-22;70;247;6458;3044;4.6;2.1
05;2021-02-23;18;237;6476;3281;4.6;2.3
05;2021-02-24;20;190;6496;3471;4.6;2.4
05;2021-02-25;56;174;6552;3645;4.6;2.6
05;2021-02-26;145;215;6697;3860;4.7;2.7
05;2021-02-27;65;171;6762;4031;4.8;2.8
05;2021-02-28;11;0;6773;4031;4.8;2.8
05;2021-03-01;92;169;6865;4200;4.8;3.0
05;2021-03-02;92;198;6957;4398;4.9;3.1
05;2021-03-03;112;233;7069;4631;5.0;3.3
05;2021-03-04;242;167;7311;4798;5.2;3.4
05;2021-03-05;578;193;7889;4991;5.6;3.5
05;2021-03-06;670;60;8559;5051;6.0;3.6
05;2021-03-07;516;21;9075;5072;6.4;3.6
05;2021-03-08;556;139;9631;5211;6.8;3.7
05;2021-03-09;520;167;10151;5378;7.2;3.8
05;2021-03-10;498;145;10649;5523;7.5;3.9
05;2021-03-11;377;141;11026;5664;7.8;4.0
05;2021-03-12;437;93;11463;5757;8.1;4.1
05;2021-03-13;797;99;12260;5856;8.6;4.1
05;2021-03-14;670;12;12930;5868;9.1;4.1
05;2021-03-15;354;125;13284;5993;9.4;4.2
05;2021-03-16;149;144;13433;6137;9.5;4.3
05;2021-03-17;262;120;13695;6257;9.7;4.4
05;2021-03-18;364;35;14059;6292;9.9;4.4
05;2021-03-19;450;59;14509;6351;10.2;4.5
05;2021-03-20;167;32;14676;6383;10.4;4.5
05;2021-03-21;1;0;14677;6383;10.4;4.5
05;2021-03-22;718;39;15395;6422;10.9;4.5
05;2021-03-23;805;18;16200;6440;11.4;4.5
05;2021-03-24;789;78;16989;6518;12.0;4.6
05;2021-03-25;901;59;17890;6577;12.6;4.6
05;2021-03-26;1023;49;18913;6626;13.3;4.7
05;2021-03-27;467;35;19380;6661;13.7;4.7
05;2021-03-28;10;0;19390;6661;13.7;4.7
05;2021-03-29;905;67;20295;6728;14.3;4.7
05;2021-03-30;1142;79;21437;6807;15.1;4.8
05;2021-03-31;824;255;22261;7062;15.7;5.0
05;2021-04-01;901;244;23162;7306;16.3;5.2
05;2021-04-02;664;380;23826;7686;16.8;5.4
05;2021-04-03;551;187;24377;7873;17.2;5.6
05;2021-04-04;350;64;24727;7937;17.4;5.6
05;2021-04-05;158;12;24885;7949;17.6;5.6
05;2021-04-06;646;276;25531;8225;18.0;5.8
05;2021-04-07;773;324;26304;8549;18.6;6.0
05;2021-04-08;733;338;27037;8887;19.1;6.3
05;2021-04-09;883;413;27920;9300;19.7;6.6
05;2021-04-10;714;389;28634;9689;20.2;6.8
05;2021-04-11;191;174;28825;9863;20.3;7.0
05;2021-04-12;732;265;29557;10128;20.9;7.1
05;2021-04-13;921;249;30478;10377;21.5;7.3
05;2021-04-14;666;329;31144;10706;22.0;7.6
05;2021-04-15;768;400;31912;11106;22.5;7.8
05;2021-04-16;730;411;32642;11517;23.0;8.1
05;2021-04-17;671;242;33313;11759;23.5;8.3
05;2021-04-18;305;23;33618;11782;23.7;8.3
05;2021-04-19;363;538;33981;12320;24.0;8.7
05;2021-04-20;482;631;34463;12951;24.3;9.1
05;2021-04-21;494;629;34957;13580;24.7;9.6
05;2021-04-22;385;549;35342;14129;24.9;10.0
05;2021-04-23;523;657;35865;14786;25.3;10.4
05;2021-04-24;347;384;36212;15170;25.5;10.7
05;2021-04-25;288;23;36500;15193;25.7;10.7
05;2021-04-26;367;708;36867;15901;26.0;11.2
05;2021-04-27;657;751;37524;16652;26.5;11.7
05;2021-04-28;468;721;37992;17373;26.8;12.3
05;2021-04-29;702;750;38694;18123;27.3;12.8
05;2021-04-30;509;756;39203;18879;27.7;13.3
05;2021-05-01;138;110;39341;18989;27.8;13.4
05;2021-05-02;267;115;39608;19104;27.9;13.5
05;2021-05-03;458;494;40066;19598;28.3;13.8
05;2021-05-04;384;503;40450;20101;28.5;14.2
05;2021-05-05;461;671;40911;20772;28.9;14.7
05;2021-05-06;644;726;41555;21498;29.3;15.2
05;2021-05-07;595;800;42150;22298;29.7;15.7
05;2021-05-08;481;177;42631;22475;30.1;15.9
05;2021-05-09;208;57;42839;22532;30.2;15.9
05;2021-05-10;500;697;43339;23229;30.6;16.4
05;2021-05-11;669;916;44008;24145;31.0;17.0
05;2021-05-12;647;733;44655;24878;31.5;17.5
05;2021-05-13;960;116;45615;24994;32.2;17.6
05;2021-05-14;826;495;46441;25489;32.8;18.0
05;2021-05-15;1044;353;47485;25842;33.5;18.2
05;2021-05-16;235;52;47720;25894;33.7;18.3
05;2021-05-17;484;430;48204;26324;34.0;18.6
05;2021-05-18;519;419;48723;26743;34.4;18.9
05;2021-05-19;727;459;49450;27202;34.9;19.2
05;2021-05-20;747;434;50197;27636;35.4;19.5
05;2021-05-21;705;513;50902;28149;35.9;19.9
05;2021-05-22;607;239;51509;28388;36.3;20.0
05;2021-05-23;277;59;51786;28447;36.5;20.1
05;2021-05-24;510;157;52296;28604;36.9;20.2
05;2021-05-25;515;483;52811;29087;37.3;20.5
05;2021-05-26;695;362;53506;29449;37.7;20.8
05;2021-05-27;799;572;54305;30021;38.3;21.2
05;2021-05-28;666;648;54971;30669;38.8;21.6
05;2021-05-29;566;544;55537;31213;39.2;22.0
05;2021-05-30;212;82;55749;31295;39.3;22.1
05;2021-05-31;576;495;56325;31790;39.7;22.4
05;2021-06-01;590;586;56915;32376;40.1;22.8
05;2021-06-02;684;703;57599;33079;40.6;23.3
05;2021-06-03;716;651;58315;33730;41.1;23.8
05;2021-06-04;1017;818;59332;34548;41.9;24.4
05;2021-06-05;807;508;60139;35056;42.4;24.7
05;2021-06-06;203;89;60342;35145;42.6;24.8
05;2021-06-07;605;833;60947;35978;43.0;25.4
05;2021-06-08;702;661;61649;36639;43.5;25.8
05;2021-06-09;648;783;62297;37422;43.9;26.4
05;2021-06-10;545;719;62842;38141;44.3;26.9
05;2021-06-11;765;723;63607;38864;44.9;27.4
05;2021-06-12;593;485;64200;39349;45.3;27.8
05;2021-06-13;113;91;64313;39440;45.4;27.8
05;2021-06-14;403;669;64716;40109;45.7;28.3
05;2021-06-15;542;912;65258;41021;46.0;28.9
05;2021-06-16;433;671;65691;41692;46.3;29.4
05;2021-06-17;360;805;66051;42497;46.6;30.0
05;2021-06-18;400;725;66451;43222;46.9;30.5
05;2021-06-19;421;570;66872;43792;47.2;30.9
05;2021-06-20;64;77;66936;43869;47.2;30.9
05;2021-06-21;319;641;67255;44510;47.4;31.4
05;2021-06-22;356;829;67611;45339;47.7;32.0
05;2021-06-23;354;763;67965;46102;47.9;32.5
05;2021-06-24;388;1022;68353;47124;48.2;33.2
05;2021-06-25;229;893;68582;48017;48.4;33.9
05;2021-06-26;292;1074;68874;49091;48.6;34.6
05;2021-06-27;128;170;69002;49261;48.7;34.8
05;2021-06-28;254;792;69256;50053;48.9;35.3
05;2021-06-29;250;785;69506;50838;49.0;35.9
05;2021-06-30;329;790;69835;51628;49.3;36.4
05;2021-07-01;385;793;70220;52421;49.5;37.0
05;2021-07-02;369;871;70589;53292;49.8;37.6
05;2021-07-03;305;741;70894;54033;50.0;38.1
05;2021-07-04;179;175;71073;54208;50.1;38.2
05;2021-07-05;264;780;71337;54988;50.3;38.8
05;2021-07-06;336;858;71673;55846;50.6;39.4
05;2021-07-07;400;781;72073;56627;50.8;39.9
05;2021-07-08;431;848;72504;57475;51.1;40.5
05;2021-07-09;422;994;72926;58469;51.4;41.2
05;2021-07-10;314;729;73240;59198;51.7;41.8
05;2021-07-11;176;120;73416;59318;51.8;41.8
05;2021-07-12;416;1013;73832;60331;52.1;42.6
05;2021-07-13;482;869;74314;61200;52.4;43.2
05;2021-07-14;837;300;75151;61500;53.0;43.4
05;2021-07-15;709;993;75860;62493;53.5;44.1
05;2021-07-16;1027;1456;76887;63949;54.2;45.1
05;2021-07-17;672;1306;77559;65255;54.7;46.0
05;2021-07-18;286;132;77845;65387;54.9;46.1
05;2021-07-19;572;792;78417;66179;55.3;46.7
05;2021-07-20;763;801;79180;66980;55.9;47.3
05;2021-07-21;882;841;80062;67821;56.5;47.8
05;2021-07-22;812;870;80874;68691;57.1;48.5
05;2021-07-23;1446;1239;82320;69930;58.1;49.3
05;2021-07-24;864;836;83184;70766;58.7;49.9
05;2021-07-25;305;160;83489;70926;58.9;50.0
05;2021-07-26;778;561;84267;71487;59.4;50.4
05;2021-07-27;1259;757;85526;72244;60.3;51.0
05;2021-07-28;1523;720;87049;72964;61.4;51.5
05;2021-07-29;1346;724;88395;73688;62.4;52.0
05;2021-07-30;959;595;89354;74283;63.0;52.4
05;2021-07-31;782;526;90136;74809;63.6;52.8
05;2021-08-01;192;178;90328;74987;63.7;52.9
05;2021-08-02;835;549;91163;75536;64.3;53.3
05;2021-08-03;828;610;91991;76146;64.9;53.7
05;2021-08-04;992;758;92983;76904;65.6;54.3
05;2021-08-05;981;727;93964;77631;66.3;54.8
05;2021-08-06;873;793;94837;78424;66.9;55.3
05;2021-08-07;631;642;95468;79066;67.3;55.8
05;2021-08-08;196;270;95664;79336;67.5;56.0
05;2021-08-09;775;847;96439;80183;68.0;56.6
05;2021-08-10;651;700;97090;80883;68.5;57.1
05;2021-08-11;743;857;97833;81740;69.0;57.7
05;2021-08-12;795;786;98628;82526;69.6;58.2
05;2021-08-13;626;893;99254;83419;70.0;58.8
05;2021-08-14;410;781;99664;84200;70.3;59.4
05;2021-08-15;188;224;99852;84424;70.4;59.6
05;2021-08-16;488;1086;100340;85510;70.8;60.3
05;2021-08-17;433;880;100773;86390;71.1;60.9
05;2021-08-18;438;974;101211;87364;71.4;61.6
05;2021-08-19;500;964;101711;88328;71.8;62.3
05;2021-08-20;478;1115;102189;89443;72.1;63.1
05;2021-08-21;359;851;102548;90294;72.3;63.7
05;2021-08-22;117;254;102665;90548;72.4;63.9
05;2021-08-23;321;828;102986;91376;72.7;64.5
05;2021-08-24;404;781;103390;92157;72.9;65.0
05;2021-08-25;408;926;103798;93083;73.2;65.7
05;2021-08-26;307;816;104105;93899;73.4;66.2
05;2021-08-27;334;921;104439;94820;73.7;66.9
05;2021-08-28;245;655;104684;95475;73.8;67.4
05;2021-08-29;66;255;104750;95730;73.9;67.5
05;2021-08-30;268;774;105018;96504;74.1;68.1
05;2021-08-31;253;686;105271;97190;74.3;68.6
05;2021-09-01;271;581;105542;97771;74.5;69.0
05;2021-09-02;255;603;105797;98374;74.6;69.4
05;2021-09-03;253;533;106050;98907;74.8;69.8
05;2021-09-04;203;607;106253;99514;75.0;70.2
05;2021-09-05;55;158;106308;99672;75.0;70.3
05;2021-09-06;164;328;106472;100000;75.1;70.5
05;2021-09-07;218;496;106690;100496;75.3;70.9
05;2021-09-08;177;521;106867;101017;75.4;71.3
05;2021-09-09;196;435;107063;101452;75.5;71.6
05;2021-09-10;183;329;107246;101781;75.7;71.8
05;2021-09-11;148;441;107394;102222;75.8;72.1
05;2021-09-12;25;105;107419;102327;75.8;72.2
05;2021-09-13;171;282;107590;102609;75.9;72.4
05;2021-09-14;224;269;107814;102878;76.1;72.6
05;2021-09-15;177;376;107991;103254;76.2;72.8
05;2021-09-16;174;254;108165;103508;76.3;73.0
05;2021-09-17;147;319;108312;103827;76.4;73.2
05;2021-09-18;120;359;108432;104186;76.5;73.5
05;2021-09-19;16;38;108448;104224;76.5;73.5
05;2021-09-20;59;166;108507;104390;76.5;73.6
05;2021-09-21;81;246;108588;104636;76.6;73.8
05;2021-09-22;108;290;108696;104926;76.7;74.0
05;2021-09-23;99;238;108795;105164;76.7;74.2
05;2021-09-24;85;281;108880;105445;76.8;74.4
05;2021-09-25;85;225;108965;105670;76.9;74.5
05;2021-09-26;17;31;108982;105701;76.9;74.6
05;2021-09-27;63;144;109045;105845;76.9;74.7
05;2021-09-28;68;159;109113;106004;77.0;74.8
05;2021-09-29;85;199;109198;106203;77.0;74.9
05;2021-09-30;59;102;109257;106305;77.1;75.0
05;2021-10-01;116;240;109373;106545;77.2;75.2
05;2021-10-02;93;194;109466;106739;77.2;75.3
05;2021-10-03;14;31;109480;106770;77.2;75.3
05;2021-10-04;64;160;109544;106930;77.3;75.4
05;2021-10-05;66;180;109610;107110;77.3;75.6
05;2021-10-06;84;164;109694;107274;77.4;75.7
05;2021-10-07;53;114;109747;107388;77.4;75.8
05;2021-10-08;87;144;109834;107532;77.5;75.9
05;2021-10-09;80;177;109914;107709;77.5;76.0
05;2021-10-10;14;22;109928;107731;77.5;76.0
05;2021-10-11;60;103;109988;107834;77.6;76.1
05;2021-10-12;37;105;110025;107939;77.6;76.1
05;2021-10-13;72;122;110097;108061;77.7;76.2
05;2021-10-14;59;99;110156;108160;77.7;76.3
06;2020-12-27;16;4;16;4;0.0;0.0
06;2020-12-28;27;3;43;7;0.0;0.0
06;2020-12-29;12;3;55;10;0.0;0.0
06;2020-12-30;10;1;65;11;0.0;0.0
06;2020-12-31;30;1;95;12;0.0;0.0
06;2021-01-01;26;4;121;16;0.0;0.0
06;2021-01-02;9;0;130;16;0.0;0.0
06;2021-01-03;11;3;141;19;0.0;0.0
06;2021-01-04;160;3;301;22;0.0;0.0
06;2021-01-05;195;11;496;33;0.0;0.0
06;2021-01-06;256;10;752;43;0.1;0.0
06;2021-01-07;529;7;1281;50;0.1;0.0
06;2021-01-08;695;5;1976;55;0.2;0.0
06;2021-01-09;391;5;2367;60;0.2;0.0
06;2021-01-10;83;2;2450;62;0.2;0.0
06;2021-01-11;1167;7;3617;69;0.3;0.0
06;2021-01-12;2253;13;5870;82;0.5;0.0
06;2021-01-13;1758;15;7628;97;0.7;0.0
06;2021-01-14;2189;30;9817;127;0.9;0.0
06;2021-01-15;1894;7;11711;134;1.1;0.0
06;2021-01-16;995;7;12706;141;1.2;0.0
06;2021-01-17;248;0;12954;141;1.2;0.0
06;2021-01-18;2515;26;15469;167;1.4;0.0
06;2021-01-19;2782;26;18251;193;1.7;0.0
06;2021-01-20;3396;21;21647;214;2.0;0.0
06;2021-01-21;3068;34;24715;248;2.3;0.0
06;2021-01-22;3037;39;27752;287;2.6;0.0
06;2021-01-23;1311;5;29063;292;2.7;0.0
06;2021-01-24;34;0;29097;292;2.7;0.0
06;2021-01-25;2098;16;31195;308;2.9;0.0
06;2021-01-26;3421;55;34616;363;3.2;0.0
06;2021-01-27;2580;114;37196;477;3.4;0.0
06;2021-01-28;2832;218;40028;695;3.7;0.1
06;2021-01-29;2534;329;42562;1024;3.9;0.1
06;2021-01-30;674;47;43236;1071;4.0;0.1
06;2021-01-31;4;1;43240;1072;4.0;0.1
06;2021-02-01;1031;470;44271;1542;4.1;0.1
06;2021-02-02;1520;420;45791;1962;4.2;0.2
06;2021-02-03;342;139;46133;2101;4.3;0.2
06;2021-02-04;727;894;46860;2995;4.3;0.3
06;2021-02-05;1019;1107;47879;4102;4.4;0.4
06;2021-02-06;173;465;48052;4567;4.5;0.4
06;2021-02-07;14;49;48066;4616;4.5;0.4
06;2021-02-08;547;1087;48613;5703;4.5;0.5
06;2021-02-09;331;736;48944;6439;4.5;0.6
06;2021-02-10;390;666;49334;7105;4.6;0.7
06;2021-02-11;487;1064;49821;8169;4.6;0.8
06;2021-02-12;662;1311;50483;9480;4.7;0.9
06;2021-02-13;207;518;50690;9998;4.7;0.9
06;2021-02-14;21;5;50711;10003;4.7;0.9
06;2021-02-15;469;1261;51180;11264;4.7;1.0
06;2021-02-16;877;2004;52057;13268;4.8;1.2
06;2021-02-17;848;2120;52905;15388;4.9;1.4
06;2021-02-18;1833;2683;54738;18071;5.1;1.7
06;2021-02-19;1779;2152;56517;20223;5.2;1.9
06;2021-02-20;291;525;56808;20748;5.3;1.9
06;2021-02-21;25;56;56833;20804;5.3;1.9
06;2021-02-22;1093;1623;57926;22427;5.4;2.1
06;2021-02-23;1777;1555;59703;23982;5.5;2.2
06;2021-02-24;2130;1298;61833;25280;5.7;2.3
06;2021-02-25;3874;1692;65707;26972;6.1;2.5
06;2021-02-26;3418;1630;69125;28602;6.4;2.6
06;2021-02-27;1444;338;70569;28940;6.5;2.7
06;2021-02-28;104;25;70673;28965;6.5;2.7
06;2021-03-01;2444;839;73117;29804;6.8;2.8
06;2021-03-02;2477;997;75594;30801;7.0;2.9
06;2021-03-03;2883;588;78477;31389;7.3;2.9
06;2021-03-04;4648;632;83125;32021;7.7;3.0
06;2021-03-05;3932;1050;87057;33071;8.1;3.1
06;2021-03-06;11990;402;99047;33473;9.2;3.1
06;2021-03-07;10226;353;109273;33826;10.1;3.1
06;2021-03-08;4193;1219;113466;35045;10.5;3.2
06;2021-03-09;5024;981;118490;36026;11.0;3.3
06;2021-03-10;4744;892;123234;36918;11.4;3.4
06;2021-03-11;6748;942;129982;37860;12.0;3.5
06;2021-03-12;6899;1043;136881;38903;12.7;3.6
06;2021-03-13;11286;400;148167;39303;13.7;3.6
06;2021-03-14;519;56;148686;39359;13.8;3.6
06;2021-03-15;4856;787;153542;40146;14.2;3.7
06;2021-03-16;3785;1072;157327;41218;14.6;3.8
06;2021-03-17;6218;1917;163545;43135;15.2;4.0
06;2021-03-18;5140;1860;168685;44995;15.6;4.2
06;2021-03-19;6846;2064;175531;47059;16.3;4.4
06;2021-03-20;2381;560;177912;47619;16.5;4.4
06;2021-03-21;416;27;178328;47646;16.5;4.4
06;2021-03-22;4001;720;182329;48366;16.9;4.5
06;2021-03-23;6000;1238;188329;49604;17.4;4.6
06;2021-03-24;4236;3347;192565;52951;17.8;4.9
06;2021-03-25;5891;3274;198456;56225;18.4;5.2
06;2021-03-26;6375;2019;204831;58244;19.0;5.4
06;2021-03-27;2044;373;206875;58617;19.2;5.4
06;2021-03-28;219;8;207094;58625;19.2;5.4
06;2021-03-29;3213;2110;210307;60735;19.5;5.6
06;2021-03-30;5199;2549;215506;63284;20.0;5.9
06;2021-03-31;8066;1704;223572;64988;20.7;6.0
06;2021-04-01;7679;2522;231251;67510;21.4;6.3
06;2021-04-02;7262;2744;238513;70254;22.1;6.5
06;2021-04-03;2723;1378;241236;71632;22.3;6.6
06;2021-04-04;305;550;241541;72182;22.4;6.7
06;2021-04-05;1417;702;242958;72884;22.5;6.8
06;2021-04-06;6689;3341;249647;76225;23.1;7.1
06;2021-04-07;6238;3924;255885;80149;23.7;7.4
06;2021-04-08;5757;5691;261642;85840;24.2;8.0
06;2021-04-09;9403;5907;271045;91747;25.1;8.5
06;2021-04-10;2396;2789;273441;94536;25.3;8.8
06;2021-04-11;189;60;273630;94596;25.4;8.8
06;2021-04-12;4392;3549;278022;98145;25.8;9.1
06;2021-04-13;6395;5157;284417;103302;26.3;9.6
06;2021-04-14;5481;4520;289898;107822;26.9;10.0
06;2021-04-15;5561;4414;295459;112236;27.4;10.4
06;2021-04-16;7095;5219;302554;117455;28.0;10.9
06;2021-04-17;2789;3063;305343;120518;28.3;11.2
06;2021-04-18;272;228;305615;120746;28.3;11.2
06;2021-04-19;5507;4062;311122;124808;28.8;11.6
06;2021-04-20;5674;4894;316796;129702;29.3;12.0
06;2021-04-21;8339;4213;325135;133915;30.1;12.4
06;2021-04-22;8585;4231;333720;138146;30.9;12.8
06;2021-04-23;8857;4321;342577;142467;31.7;13.2
06;2021-04-24;2358;1500;344935;143967;32.0;13.3
06;2021-04-25;122;29;345057;143996;32.0;13.3
06;2021-04-26;4163;2328;349220;146324;32.4;13.6
06;2021-04-27;4596;4063;353816;150387;32.8;13.9
06;2021-04-28;4166;4591;357982;154978;33.2;14.4
06;2021-04-29;6099;5480;364081;160458;33.7;14.9
06;2021-04-30;6791;5206;370872;165664;34.4;15.3
06;2021-05-01;4168;846;375040;166510;34.7;15.4
06;2021-05-02;495;161;375535;166671;34.8;15.4
06;2021-05-03;6932;3581;382467;170252;35.4;15.8
06;2021-05-04;5758;5421;388225;175673;36.0;16.3
06;2021-05-05;4553;3925;392778;179598;36.4;16.6
06;2021-05-06;5236;4759;398014;184357;36.9;17.1
06;2021-05-07;5663;5687;403677;190044;37.4;17.6
06;2021-05-08;4879;1338;408556;191382;37.9;17.7
06;2021-05-09;206;308;408762;191690;37.9;17.8
06;2021-05-10;4838;5057;413600;196747;38.3;18.2
06;2021-05-11;4949;5570;418549;202317;38.8;18.7
06;2021-05-12;9113;4910;427662;207227;39.6;19.2
06;2021-05-13;9283;2151;436945;209378;40.5;19.4
06;2021-05-14;10865;3374;447810;212752;41.5;19.7
06;2021-05-15;9315;2246;457125;214998;42.4;19.9
06;2021-05-16;1506;288;458631;215286;42.5;19.9
06;2021-05-17;7528;3766;466159;219052;43.2;20.3
06;2021-05-18;9753;3235;475912;222287;44.1;20.6
06;2021-05-19;7721;2992;483633;225279;44.8;20.9
06;2021-05-20;7987;3684;491620;228963;45.5;21.2
06;2021-05-21;8836;3956;500456;232919;46.4;21.6
06;2021-05-22;3033;1326;503489;234245;46.6;21.7
06;2021-05-23;134;631;503623;234876;46.7;21.8
06;2021-05-24;3209;1002;506832;235878;47.0;21.9
06;2021-05-25;4766;4934;511598;240812;47.4;22.3
06;2021-05-26;5696;6634;517294;247446;47.9;22.9
06;2021-05-27;5592;6287;522886;253733;48.4;23.5
06;2021-05-28;4988;7298;527874;261031;48.9;24.2
06;2021-05-29;1638;2925;529512;263956;49.1;24.5
06;2021-05-30;258;1122;529770;265078;49.1;24.6
06;2021-05-31;4421;5133;534191;270211;49.5;25.0
06;2021-06-01;5760;7436;539951;277647;50.0;25.7
06;2021-06-02;3327;8556;543278;286203;50.3;26.5
06;2021-06-03;4554;8309;547832;294512;50.8;27.3
06;2021-06-04;5491;7734;553323;302246;51.3;28.0
06;2021-06-05;2468;3350;555791;305596;51.5;28.3
06;2021-06-06;186;237;555977;305833;51.5;28.3
06;2021-06-07;4150;5586;560127;311419;51.9;28.9
06;2021-06-08;4490;5228;564617;316647;52.3;29.3
06;2021-06-09;4126;7366;568743;324013;52.7;30.0
06;2021-06-10;4797;6873;573540;330886;53.1;30.7
06;2021-06-11;3931;8364;577471;339250;53.5;31.4
06;2021-06-12;1748;3752;579219;343002;53.7;31.8
06;2021-06-13;151;439;579370;343441;53.7;31.8
06;2021-06-14;2746;8608;582116;352049;53.9;32.6
06;2021-06-15;3298;9496;585414;361545;54.2;33.5
06;2021-06-16;3518;7024;588932;368569;54.6;34.1
06;2021-06-17;3688;7194;592620;375763;54.9;34.8
06;2021-06-18;2645;5931;595265;381694;55.1;35.4
06;2021-06-19;1322;1689;596587;383383;55.3;35.5
06;2021-06-20;211;349;596798;383732;55.3;35.6
06;2021-06-21;1737;6296;598535;390028;55.5;36.1
06;2021-06-22;2377;7364;600912;397392;55.7;36.8
06;2021-06-23;2098;6547;603010;403939;55.9;37.4
06;2021-06-24;3500;8977;606510;412916;56.2;38.3
06;2021-06-25;2310;9607;608820;422523;56.4;39.1
06;2021-06-26;893;2288;609713;424811;56.5;39.4
06;2021-06-27;379;1192;610092;426003;56.5;39.5
06;2021-06-28;2503;8124;612595;434127;56.8;40.2
06;2021-06-29;2396;7732;614991;441859;57.0;40.9
06;2021-06-30;1522;7693;616513;449552;57.1;41.6
06;2021-07-01;3574;7484;620087;457036;57.4;42.3
06;2021-07-02;4477;8284;624564;465320;57.9;43.1
06;2021-07-03;1241;4307;625805;469627;58.0;43.5
06;2021-07-04;318;303;626123;469930;58.0;43.5
06;2021-07-05;4081;5146;630204;475076;58.4;44.0
06;2021-07-06;2152;5817;632356;480893;58.6;44.6
06;2021-07-07;4190;5984;636546;486877;59.0;45.1
06;2021-07-08;3732;6336;640278;493213;59.3;45.7
06;2021-07-09;4868;6242;645146;499455;59.8;46.3
06;2021-07-10;1779;2332;646925;501787;59.9;46.5
06;2021-07-11;333;323;647258;502110;60.0;46.5
06;2021-07-12;4214;7154;651472;509264;60.4;47.2
06;2021-07-13;6127;9027;657599;518291;60.9;48.0
06;2021-07-14;1253;442;658852;518733;61.0;48.1
06;2021-07-15;6854;8041;665706;526774;61.7;48.8
06;2021-07-16;8541;9042;674247;535816;62.5;49.6
06;2021-07-17;3167;5478;677414;541294;62.8;50.1
06;2021-07-18;1079;5333;678493;546627;62.9;50.6
06;2021-07-19;6171;8038;684664;554665;63.4;51.4
06;2021-07-20;7607;10266;692271;564931;64.1;52.3
06;2021-07-21;8481;8720;700752;573651;64.9;53.1
06;2021-07-22;10458;7890;711210;581541;65.9;53.9
06;2021-07-23;9576;6934;720786;588475;66.8;54.5
06;2021-07-24;3306;3107;724092;591582;67.1;54.8
06;2021-07-25;1005;482;725097;592064;67.2;54.9
06;2021-07-26;7666;6893;732763;598957;67.9;55.5
06;2021-07-27;9280;5602;742043;604559;68.7;56.0
06;2021-07-28;7497;5417;749540;609976;69.4;56.5
06;2021-07-29;8894;5791;758434;615767;70.3;57.0
06;2021-07-30;8562;5569;766996;621336;71.1;57.6
06;2021-07-31;3831;3084;770827;624420;71.4;57.8
06;2021-08-01;902;438;771729;624858;71.5;57.9
06;2021-08-02;7154;4634;778883;629492;72.2;58.3
06;2021-08-03;6869;5510;785752;635002;72.8;58.8
06;2021-08-04;5843;3527;791595;638529;73.3;59.2
06;2021-08-05;6790;4478;798385;643007;74.0;59.6
06;2021-08-06;6124;6124;804509;649131;74.5;60.1
06;2021-08-07;2327;2473;806836;651604;74.7;60.4
06;2021-08-08;617;635;807453;652239;74.8;60.4
06;2021-08-09;4886;6042;812339;658281;75.3;61.0
06;2021-08-10;5522;6917;817861;665198;75.8;61.6
06;2021-08-11;4464;6219;822325;671417;76.2;62.2
06;2021-08-12;4747;6744;827072;678161;76.6;62.8
06;2021-08-13;3883;6455;830955;684616;77.0;63.4
06;2021-08-14;1599;2275;832554;686891;77.1;63.6
06;2021-08-15;420;639;832974;687530;77.2;63.7
06;2021-08-16;3299;6911;836273;694441;77.5;64.3
06;2021-08-17;3848;7779;840121;702220;77.8;65.1
06;2021-08-18;3002;6412;843123;708632;78.1;65.7
06;2021-08-19;4029;8128;847152;716760;78.5;66.4
06;2021-08-20;3330;6536;850482;723296;78.8;67.0
06;2021-08-21;1847;3595;852329;726891;79.0;67.3
06;2021-08-22;390;713;852719;727604;79.0;67.4
06;2021-08-23;2573;6531;855292;734135;79.2;68.0
06;2021-08-24;2905;6476;858197;740611;79.5;68.6
06;2021-08-25;2646;5683;860843;746294;79.8;69.1
06;2021-08-26;2738;6891;863581;753185;80.0;69.8
06;2021-08-27;2671;7080;866252;760265;80.3;70.4
06;2021-08-28;1299;3335;867551;763600;80.4;70.7
06;2021-08-29;300;827;867851;764427;80.4;70.8
06;2021-08-30;2472;6186;870323;770613;80.6;71.4
06;2021-08-31;2779;6857;873102;777470;80.9;72.0
06;2021-09-01;3045;5293;876147;782763;81.2;72.5
06;2021-09-02;2494;5494;878641;788257;81.4;73.0
06;2021-09-03;2218;5964;880859;794221;81.6;73.6
06;2021-09-04;1386;3496;882245;797717;81.7;73.9
06;2021-09-05;287;498;882532;798215;81.8;74.0
06;2021-09-06;1671;3929;884203;802144;81.9;74.3
06;2021-09-07;1662;4135;885865;806279;82.1;74.7
06;2021-09-08;1641;3221;887506;809500;82.2;75.0
06;2021-09-09;1466;3352;888972;812852;82.4;75.3
06;2021-09-10;1931;3506;890903;816358;82.5;75.6
06;2021-09-11;1089;2278;891992;818636;82.6;75.8
06;2021-09-12;147;325;892139;818961;82.7;75.9
06;2021-09-13;1328;2651;893467;821612;82.8;76.1
06;2021-09-14;1546;2283;895013;823895;82.9;76.3
06;2021-09-15;1518;2763;896531;826658;83.1;76.6
06;2021-09-16;1388;2429;897919;829087;83.2;76.8
06;2021-09-17;1524;2882;899443;831969;83.3;77.1
06;2021-09-18;697;1963;900140;833932;83.4;77.3
06;2021-09-19;111;289;900251;834221;83.4;77.3
06;2021-09-20;748;2137;900999;836358;83.5;77.5
06;2021-09-21;1004;2482;902003;838840;83.6;77.7
06;2021-09-22;1061;2514;903064;841354;83.7;77.9
06;2021-09-23;833;2201;903897;843555;83.7;78.2
06;2021-09-24;930;2353;904827;845908;83.8;78.4
06;2021-09-25;492;1782;905319;847690;83.9;78.5
06;2021-09-26;101;224;905420;847914;83.9;78.6
06;2021-09-27;672;1620;906092;849534;83.9;78.7
06;2021-09-28;581;1605;906673;851139;84.0;78.9
06;2021-09-29;822;1792;907495;852931;84.1;79.0
06;2021-09-30;760;1707;908255;854638;84.1;79.2
06;2021-10-01;951;2089;909206;856727;84.2;79.4
06;2021-10-02;500;1349;909706;858076;84.3;79.5
06;2021-10-03;105;171;909811;858247;84.3;79.5
06;2021-10-04;430;1184;910241;859431;84.3;79.6
06;2021-10-05;621;1643;910862;861074;84.4;79.8
06;2021-10-06;769;1743;911631;862817;84.5;79.9
06;2021-10-07;652;1569;912283;864386;84.5;80.1
06;2021-10-08;876;1737;913159;866123;84.6;80.2
06;2021-10-09;528;1151;913687;867274;84.6;80.3
06;2021-10-10;137;210;913824;867484;84.7;80.4
06;2021-10-11;577;1260;914401;868744;84.7;80.5
06;2021-10-12;565;1156;914966;869900;84.8;80.6
06;2021-10-13;735;1396;915701;871296;84.8;80.7
06;2021-10-14;598;1155;916299;872451;84.9;80.8
07;2020-12-27;0;0;0;0;0.0;0.0
07;2020-12-28;0;0;0;0;0.0;0.0
07;2020-12-29;0;0;0;0;0.0;0.0
07;2020-12-30;0;0;0;0;0.0;0.0
07;2020-12-31;0;0;0;0;0.0;0.0
07;2021-01-01;7;0;7;0;0.0;0.0
07;2021-01-02;0;0;7;0;0.0;0.0
07;2021-01-03;0;0;7;0;0.0;0.0
07;2021-01-04;0;0;7;0;0.0;0.0
07;2021-01-05;0;0;7;0;0.0;0.0
07;2021-01-06;31;0;38;0;0.0;0.0
07;2021-01-07;130;1;168;1;0.1;0.0
07;2021-01-08;45;1;213;2;0.1;0.0
07;2021-01-09;17;0;230;2;0.1;0.0
07;2021-01-10;0;0;230;2;0.1;0.0
07;2021-01-11;157;1;387;3;0.1;0.0
07;2021-01-12;310;1;697;4;0.2;0.0
07;2021-01-13;308;4;1005;8;0.3;0.0
07;2021-01-14;475;0;1480;8;0.5;0.0
07;2021-01-15;188;0;1668;8;0.5;0.0
07;2021-01-16;17;0;1685;8;0.5;0.0
07;2021-01-17;2;0;1687;8;0.5;0.0
07;2021-01-18;364;5;2051;13;0.6;0.0
07;2021-01-19;830;3;2881;16;0.9;0.0
07;2021-01-20;605;8;3486;24;1.1;0.0
07;2021-01-21;454;3;3940;27;1.2;0.0
07;2021-01-22;292;0;4232;27;1.3;0.0
07;2021-01-23;107;0;4339;27;1.3;0.0
07;2021-01-24;0;0;4339;27;1.3;0.0
07;2021-01-25;164;0;4503;27;1.4;0.0
07;2021-01-26;491;4;4994;31;1.5;0.0
07;2021-01-27;558;14;5552;45;1.7;0.0
07;2021-01-28;1207;103;6759;148;2.1;0.0
07;2021-01-29;714;19;7473;167;2.3;0.1
07;2021-01-30;212;4;7685;171;2.4;0.1
07;2021-01-31;7;0;7692;171;2.4;0.1
07;2021-02-01;267;33;7959;204;2.4;0.1
07;2021-02-02;664;240;8623;444;2.6;0.1
07;2021-02-03;1046;235;9669;679;3.0;0.2
07;2021-02-04;723;270;10392;949;3.2;0.3
07;2021-02-05;484;255;10876;1204;3.3;0.4
07;2021-02-06;98;2;10974;1206;3.4;0.4
07;2021-02-07;12;1;10986;1207;3.4;0.4
07;2021-02-08;239;175;11225;1382;3.4;0.4
07;2021-02-09;490;331;11715;1713;3.6;0.5
07;2021-02-10;539;397;12254;2110;3.7;0.6
07;2021-02-11;400;282;12654;2392;3.9;0.7
07;2021-02-12;266;162;12920;2554;4.0;0.8
07;2021-02-13;69;20;12989;2574;4.0;0.8
07;2021-02-14;1;0;12990;2574;4.0;0.8
07;2021-02-15;270;130;13260;2704;4.1;0.8
07;2021-02-16;352;364;13612;3068;4.2;0.9
07;2021-02-17;466;330;14078;3398;4.3;1.0
07;2021-02-18;564;767;14642;4165;4.5;1.3
07;2021-02-19;460;508;15102;4673;4.6;1.4
07;2021-02-20;109;69;15211;4742;4.7;1.5
07;2021-02-21;15;0;15226;4742;4.7;1.5
07;2021-02-22;425;217;15651;4959;4.8;1.5
07;2021-02-23;648;622;16299;5581;5.0;1.7
07;2021-02-24;927;710;17226;6291;5.3;1.9
07;2021-02-25;709;539;17935;6830;5.5;2.1
07;2021-02-26;844;295;18779;7125;5.7;2.2
07;2021-02-27;190;145;18969;7270;5.8;2.2
07;2021-02-28;1;0;18970;7270;5.8;2.2
07;2021-03-01;438;215;19408;7485;5.9;2.3
07;2021-03-02;658;566;20066;8051;6.1;2.5
07;2021-03-03;696;537;20762;8588;6.4;2.6
07;2021-03-04;1101;360;21863;8948;6.7;2.7
07;2021-03-05;1083;378;22946;9326;7.0;2.9
07;2021-03-06;1127;99;24073;9425;7.4;2.9
07;2021-03-07;717;21;24790;9446;7.6;2.9
07;2021-03-08;353;320;25143;9766;7.7;3.0
07;2021-03-09;1091;439;26234;10205;8.0;3.1
07;2021-03-10;868;522;27102;10727;8.3;3.3
07;2021-03-11;1373;473;28475;11200;8.7;3.4
07;2021-03-12;1618;572;30093;11772;9.2;3.6
07;2021-03-13;683;105;30776;11877;9.4;3.6
07;2021-03-14;4;0;30780;11877;9.4;3.6
07;2021-03-15;525;292;31305;12169;9.6;3.7
07;2021-03-16;1209;487;32514;12656;9.9;3.9
07;2021-03-17;1188;774;33702;13430;10.3;4.1
07;2021-03-18;1217;418;34919;13848;10.7;4.2
07;2021-03-19;1269;426;36188;14274;11.1;4.4
07;2021-03-20;467;109;36655;14383;11.2;4.4
07;2021-03-21;3;2;36658;14385;11.2;4.4
07;2021-03-22;791;537;37449;14922;11.5;4.6
07;2021-03-23;1519;727;38968;15649;11.9;4.8
07;2021-03-24;1280;673;40248;16322;12.3;5.0
07;2021-03-25;1852;521;42100;16843;12.9;5.2
07;2021-03-26;1834;446;43934;17289;13.4;5.3
07;2021-03-27;384;101;44318;17390;13.6;5.3
07;2021-03-28;6;1;44324;17391;13.6;5.3
07;2021-03-29;789;361;45113;17752;13.8;5.4
07;2021-03-30;1526;516;46639;18268;14.3;5.6
07;2021-03-31;1662;508;48301;18776;14.8;5.7
07;2021-04-01;1590;667;49891;19443;15.3;5.9
07;2021-04-02;1522;443;51413;19886;15.7;6.1
07;2021-04-03;230;106;51643;19992;15.8;6.1
07;2021-04-04;3;1;51646;19993;15.8;6.1
07;2021-04-05;0;66;51646;20059;15.8;6.1
07;2021-04-06;1156;761;52802;20820;16.2;6.4
07;2021-04-07;1316;907;54118;21727;16.6;6.6
07;2021-04-08;1969;1183;56087;22910;17.2;7.0
07;2021-04-09;2423;576;58510;23486;17.9;7.2
07;2021-04-10;807;164;59317;23650;18.1;7.2
07;2021-04-11;340;13;59657;23663;18.3;7.2
07;2021-04-12;1288;604;60945;24267;18.6;7.4
07;2021-04-13;1767;1340;62712;25607;19.2;7.8
07;2021-04-14;1687;1020;64399;26627;19.7;8.1
07;2021-04-15;1443;848;65842;27475;20.1;8.4
07;2021-04-16;1506;918;67348;28393;20.6;8.7
07;2021-04-17;870;217;68218;28610;20.9;8.8
07;2021-04-18;699;39;68917;28649;21.1;8.8
07;2021-04-19;1161;574;70078;29223;21.4;8.9
07;2021-04-20;1440;1321;71518;30544;21.9;9.3
07;2021-04-21;1719;919;73237;31463;22.4;9.6
07;2021-04-22;1816;971;75053;32434;23.0;9.9
07;2021-04-23;1411;972;76464;33406;23.4;10.2
07;2021-04-24;962;254;77426;33660;23.7;10.3
07;2021-04-25;717;69;78143;33729;23.9;10.3
07;2021-04-26;1137;680;79280;34409;24.3;10.5
07;2021-04-27;1394;1567;80674;35976;24.7;11.0
07;2021-04-28;1635;1760;82309;37736;25.2;11.5
07;2021-04-29;1938;1536;84247;39272;25.8;12.0
07;2021-04-30;1661;1487;85908;40759;26.3;12.5
07;2021-05-01;960;120;86868;40879;26.6;12.5
07;2021-05-02;844;155;87712;41034;26.8;12.6
07;2021-05-03;1279;435;88991;41469;27.2;12.7
07;2021-05-04;2170;1568;91161;43037;27.9;13.2
07;2021-05-05;1744;1388;92905;44425;28.4;13.6
07;2021-05-06;2101;1588;95006;46013;29.1;14.1
07;2021-05-07;1597;1557;96603;47570;29.6;14.6
07;2021-05-08;1230;406;97833;47976;29.9;14.7
07;2021-05-09;1030;327;98863;48303;30.2;14.8
07;2021-05-10;1406;1177;100269;49480;30.7;15.1
07;2021-05-11;2470;1698;102739;51178;31.4;15.7
07;2021-05-12;2165;1279;104904;52457;32.1;16.0
07;2021-05-13;1712;273;106616;52730;32.6;16.1
07;2021-05-14;1734;999;108350;53729;33.1;16.4
07;2021-05-15;1626;500;109976;54229;33.6;16.6
07;2021-05-16;1442;214;111418;54443;34.1;16.7
07;2021-05-17;1771;859;113189;55302;34.6;16.9
07;2021-05-18;2295;1303;115484;56605;35.3;17.3
07;2021-05-19;2375;1000;117859;57605;36.1;17.6
07;2021-05-20;2165;1308;120024;58913;36.7;18.0
07;2021-05-21;1758;1312;121782;60225;37.3;18.4
07;2021-05-22;935;543;122717;60768;37.5;18.6
07;2021-05-23;856;157;123573;60925;37.8;18.6
07;2021-05-24;1648;339;125221;61264;38.3;18.7
07;2021-05-25;2184;1481;127405;62745;39.0;19.2
07;2021-05-26;1526;1379;128931;64124;39.4;19.6
07;2021-05-27;2014;1412;130945;65536;40.1;20.0
07;2021-05-28;1771;2079;132716;67615;40.6;20.7
07;2021-05-29;942;683;133658;68298;40.9;20.9
07;2021-05-30;622;570;134280;68868;41.1;21.1
07;2021-05-31;1133;1284;135413;70152;41.4;21.5
07;2021-06-01;2152;2001;137565;72153;42.1;22.1
07;2021-06-02;1531;1653;139096;73806;42.6;22.6
07;2021-06-03;1712;1254;140808;75060;43.1;23.0
07;2021-06-04;1676;1594;142484;76654;43.6;23.5
07;2021-06-05;987;955;143471;77609;43.9;23.7
07;2021-06-06;598;624;144069;78233;44.1;23.9
07;2021-06-07;961;1193;145030;79426;44.4;24.3
07;2021-06-08;1547;1772;146577;81198;44.8;24.8
07;2021-06-09;1030;1421;147607;82619;45.2;25.3
07;2021-06-10;789;1388;148396;84007;45.4;25.7
07;2021-06-11;1154;2032;149550;86039;45.8;26.3
07;2021-06-12;643;1217;150193;87256;45.9;26.7
07;2021-06-13;395;444;150588;87700;46.1;26.8
07;2021-06-14;566;1957;151154;89657;46.2;27.4
07;2021-06-15;936;2552;152090;92209;46.5;28.2
07;2021-06-16;1023;1854;153113;94063;46.8;28.8
07;2021-06-17;885;1949;153998;96012;47.1;29.4
07;2021-06-18;868;2282;154866;98294;47.4;30.1
07;2021-06-19;603;1452;155469;99746;47.6;30.5
07;2021-06-20;369;729;155838;100475;47.7;30.7
07;2021-06-21;516;2143;156354;102618;47.8;31.4
07;2021-06-22;655;2662;157009;105280;48.0;32.2
07;2021-06-23;680;1960;157689;107240;48.2;32.8
07;2021-06-24;646;1852;158335;109092;48.4;33.4
07;2021-06-25;701;2177;159036;111269;48.7;34.0
07;2021-06-26;362;1430;159398;112699;48.8;34.5
07;2021-06-27;285;1073;159683;113772;48.9;34.8
07;2021-06-28;506;2241;160189;116013;49.0;35.5
07;2021-06-29;540;2988;160729;119001;49.2;36.4
07;2021-06-30;822;2278;161551;121279;49.4;37.1
07;2021-07-01;776;1951;162327;123230;49.7;37.7
07;2021-07-02;880;2298;163207;125528;49.9;38.4
07;2021-07-03;421;1137;163628;126665;50.1;38.8
07;2021-07-04;211;852;163839;127517;50.1;39.0
07;2021-07-05;670;1685;164509;129202;50.3;39.5
07;2021-07-06;880;2630;165389;131832;50.6;40.3
07;2021-07-07;969;1951;166358;133783;50.9;40.9
07;2021-07-08;928;1959;167286;135742;51.2;41.5
07;2021-07-09;995;2262;168281;138004;51.5;42.2
07;2021-07-10;598;1100;168879;139104;51.7;42.6
07;2021-07-11;239;614;169118;139718;51.7;42.7
07;2021-07-12;807;1769;169925;141487;52.0;43.3
07;2021-07-13;1770;3173;171695;144660;52.5;44.3
07;2021-07-14;167;133;171862;144793;52.6;44.3
07;2021-07-15;1962;2468;173824;147261;53.2;45.1
07;2021-07-16;2057;1988;175881;149249;53.8;45.7
07;2021-07-17;1484;1250;177365;150499;54.3;46.0
07;2021-07-18;771;480;178136;150979;54.5;46.2
07;2021-07-19;1516;1689;179652;152668;55.0;46.7
07;2021-07-20;2518;2678;182170;155346;55.7;47.5
07;2021-07-21;1856;1917;184026;157263;56.3;48.1
07;2021-07-22;1918;1374;185944;158637;56.9;48.5
07;2021-07-23;2264;1688;188208;160325;57.6;49.0
07;2021-07-24;1642;1112;189850;161437;58.1;49.4
07;2021-07-25;34;22;189884;161459;58.1;49.4
07;2021-07-26;2199;1546;192083;163005;58.8;49.9
07;2021-07-27;3017;1915;195100;164920;59.7;50.5
07;2021-07-28;1643;1309;196743;166229;60.2;50.9
07;2021-07-29;2540;1275;199283;167504;61.0;51.2
07;2021-07-30;1356;1415;200639;168919;61.4;51.7
07;2021-07-31;1506;922;202145;169841;61.8;52.0
07;2021-08-01;74;26;202219;169867;61.9;52.0
07;2021-08-02;1516;1133;203735;171000;62.3;52.3
07;2021-08-03;2418;1911;206153;172911;63.1;52.9
07;2021-08-04;1947;1033;208100;173944;63.7;53.2
07;2021-08-05;1893;1296;209993;175240;64.2;53.6
07;2021-08-06;2033;1711;212026;176951;64.9;54.1
07;2021-08-07;998;556;213024;177507;65.2;54.3
07;2021-08-08;12;23;213036;177530;65.2;54.3
07;2021-08-09;1258;1382;214294;178912;65.6;54.7
07;2021-08-10;1599;2260;215893;181172;66.0;55.4
07;2021-08-11;1399;1600;217292;182772;66.5;55.9
07;2021-08-12;1105;1486;218397;184258;66.8;56.4
07;2021-08-13;1182;1790;219579;186048;67.2;56.9
07;2021-08-14;512;766;220091;186814;67.3;57.2
07;2021-08-15;9;28;220100;186842;67.3;57.2
07;2021-08-16;754;1328;220854;188170;67.6;57.6
07;2021-08-17;1339;2278;222193;190448;68.0;58.3
07;2021-08-18;880;1518;223073;191966;68.2;58.7
07;2021-08-19;1149;1697;224222;193663;68.6;59.2
07;2021-08-20;899;2086;225121;195749;68.9;59.9
07;2021-08-21;364;549;225485;196298;69.0;60.1
07;2021-08-22;7;23;225492;196321;69.0;60.1
07;2021-08-23;467;1307;225959;197628;69.1;60.5
07;2021-08-24;1125;2312;227084;199940;69.5;61.2
07;2021-08-25;692;1838;227776;201778;69.7;61.7
07;2021-08-26;690;2021;228466;203799;69.9;62.3
07;2021-08-27;784;1830;229250;205629;70.1;62.9
07;2021-08-28;338;608;229588;206237;70.2;63.1
07;2021-08-29;1;33;229589;206270;70.2;63.1
07;2021-08-30;430;1304;230019;207574;70.4;63.5
07;2021-08-31;1095;2203;231114;209777;70.7;64.2
07;2021-09-01;543;1346;231657;211123;70.9;64.6
07;2021-09-02;605;1384;232262;212507;71.1;65.0
07;2021-09-03;741;1775;233003;214282;71.3;65.6
07;2021-09-04;309;696;233312;214978;71.4;65.8
07;2021-09-05;26;28;233338;215006;71.4;65.8
07;2021-09-06;402;906;233740;215912;71.5;66.1
07;2021-09-07;524;1297;234264;217209;71.7;66.5
07;2021-09-08;445;1042;234709;218251;71.8;66.8
07;2021-09-09;479;858;235188;219109;72.0;67.0
07;2021-09-10;518;1245;235706;220354;72.1;67.4
07;2021-09-11;168;628;235874;220982;72.2;67.6
07;2021-09-12;0;7;235874;220989;72.2;67.6
07;2021-09-13;351;524;236225;221513;72.3;67.8
07;2021-09-14;537;887;236762;222400;72.4;68.0
07;2021-09-15;304;744;237066;223144;72.5;68.3
07;2021-09-16;430;568;237496;223712;72.7;68.4
07;2021-09-17;318;802;237814;224514;72.8;68.7
07;2021-09-18;100;455;237914;224969;72.8;68.8
07;2021-09-19;3;32;237917;225001;72.8;68.8
07;2021-09-20;239;365;238156;225366;72.9;68.9
07;2021-09-21;287;695;238443;226061;72.9;69.2
07;2021-09-22;172;727;238615;226788;73.0;69.4
07;2021-09-23;190;533;238805;227321;73.1;69.5
07;2021-09-24;277;838;239082;228159;73.1;69.8
07;2021-09-25;51;208;239133;228367;73.2;69.9
07;2021-09-26;6;17;239139;228384;73.2;69.9
07;2021-09-27;145;459;239284;228843;73.2;70.0
07;2021-09-28;178;522;239462;229365;73.3;70.2
07;2021-09-29;127;513;239589;229878;73.3;70.3
07;2021-09-30;174;451;239763;230329;73.4;70.5
07;2021-10-01;220;594;239983;230923;73.4;70.6
07;2021-10-02;76;137;240059;231060;73.4;70.7
07;2021-10-03;10;15;240069;231075;73.4;70.7
07;2021-10-04;161;366;240230;231441;73.5;70.8
07;2021-10-05;207;446;240437;231887;73.6;70.9
07;2021-10-06;161;331;240598;232218;73.6;71.0
07;2021-10-07;141;438;240739;232656;73.6;71.2
07;2021-10-08;207;428;240946;233084;73.7;71.3
07;2021-10-09;65;95;241011;233179;73.7;71.3
07;2021-10-10;0;1;241011;233180;73.7;71.3
07;2021-10-11;101;269;241112;233449;73.8;71.4
07;2021-10-12;188;405;241300;233854;73.8;71.5
07;2021-10-13;131;233;241431;234087;73.9;71.6
07;2021-10-14;142;235;241573;234322;73.9;71.7
08;2020-12-27;1;0;1;0;0.0;0.0
08;2020-12-28;0;0;1;0;0.0;0.0
08;2020-12-29;0;0;1;0;0.0;0.0
08;2020-12-30;0;0;1;0;0.0;0.0
08;2020-12-31;0;0;1;0;0.0;0.0
08;2021-01-01;0;0;1;0;0.0;0.0
08;2021-01-02;0;0;1;0;0.0;0.0
08;2021-01-03;2;0;3;0;0.0;0.0
08;2021-01-04;24;0;27;0;0.0;0.0
08;2021-01-05;1;0;28;0;0.0;0.0
08;2021-01-06;0;0;28;0;0.0;0.0
08;2021-01-07;188;0;216;0;0.1;0.0
08;2021-01-08;315;1;531;1;0.2;0.0
08;2021-01-09;115;0;646;1;0.2;0.0
08;2021-01-10;1;0;647;1;0.2;0.0
08;2021-01-11;66;0;713;1;0.3;0.0
08;2021-01-12;157;0;870;1;0.3;0.0
08;2021-01-13;480;1;1350;2;0.5;0.0
08;2021-01-14;538;9;1888;11;0.7;0.0
08;2021-01-15;288;2;2176;13;0.8;0.0
08;2021-01-16;107;0;2283;13;0.9;0.0
08;2021-01-17;2;0;2285;13;0.9;0.0
08;2021-01-18;371;2;2656;15;1.0;0.0
08;2021-01-19;873;2;3529;17;1.3;0.0
08;2021-01-20;909;4;4438;21;1.7;0.0
08;2021-01-21;743;1;5181;22;2.0;0.0
08;2021-01-22;678;1;5859;23;2.2;0.0
08;2021-01-23;237;0;6096;23;2.3;0.0
08;2021-01-24;0;0;6096;23;2.3;0.0
08;2021-01-25;209;0;6305;23;2.4;0.0
08;2021-01-26;303;2;6608;25;2.5;0.0
08;2021-01-27;410;1;7018;26;2.6;0.0
08;2021-01-28;565;183;7583;209;2.9;0.1
08;2021-01-29;588;182;8171;391;3.1;0.1
08;2021-01-30;222;63;8393;454;3.2;0.2
08;2021-01-31;0;0;8393;454;3.2;0.2
08;2021-02-01;80;46;8473;500;3.2;0.2
08;2021-02-02;192;172;8665;672;3.3;0.3
08;2021-02-03;140;169;8805;841;3.3;0.3
08;2021-02-04;309;287;9114;1128;3.4;0.4
08;2021-02-05;499;360;9613;1488;3.6;0.6
08;2021-02-06;149;75;9762;1563;3.7;0.6
08;2021-02-07;8;0;9770;1563;3.7;0.6
08;2021-02-08;40;172;9810;1735;3.7;0.7
08;2021-02-09;221;646;10031;2381;3.8;0.9
08;2021-02-10;334;639;10365;3020;3.9;1.1
08;2021-02-11;467;365;10832;3385;4.1;1.3
08;2021-02-12;676;386;11508;3771;4.3;1.4
08;2021-02-13;140;115;11648;3886;4.4;1.5
08;2021-02-14;3;60;11651;3946;4.4;1.5
08;2021-02-15;227;208;11878;4154;4.5;1.6
08;2021-02-16;130;374;12008;4528;4.5;1.7
08;2021-02-17;112;414;12120;4942;4.6;1.9
08;2021-02-18;215;518;12335;5460;4.6;2.1
08;2021-02-19;305;423;12640;5883;4.8;2.2
08;2021-02-20;7;206;12647;6089;4.8;2.3
08;2021-02-21;0;0;12647;6089;4.8;2.3
08;2021-02-22;131;180;12778;6269;4.8;2.4
08;2021-02-23;150;319;12928;6588;4.9;2.5
08;2021-02-24;163;388;13091;6976;4.9;2.6
08;2021-02-25;500;529;13591;7505;5.1;2.8
08;2021-02-26;603;626;14194;8131;5.3;3.1
08;2021-02-27;318;194;14512;8325;5.5;3.1
08;2021-02-28;19;1;14531;8326;5.5;3.1
08;2021-03-01;200;105;14731;8431;5.5;3.2
08;2021-03-02;654;281;15385;8712;5.8;3.3
08;2021-03-03;899;202;16284;8914;6.1;3.4
08;2021-03-04;735;335;17019;9249;6.4;3.5
08;2021-03-05;1021;543;18040;9792;6.8;3.7
08;2021-03-06;695;141;18735;9933;7.1;3.7
08;2021-03-07;75;2;18810;9935;7.1;3.7
08;2021-03-08;217;125;19027;10060;7.2;3.8
08;2021-03-09;688;156;19715;10216;7.4;3.8
08;2021-03-10;1038;124;20753;10340;7.8;3.9
08;2021-03-11;982;255;21735;10595;8.2;4.0
08;2021-03-12;1632;519;23367;11114;8.8;4.2
08;2021-03-13;798;125;24165;11239;9.1;4.2
08;2021-03-14;22;0;24187;11239;9.1;4.2
08;2021-03-15;291;73;24478;11312;9.2;4.3
08;2021-03-16;563;40;25041;11352;9.4;4.3
08;2021-03-17;804;66;25845;11418;9.7;4.3
08;2021-03-18;817;162;26662;11580;10.0;4.4
08;2021-03-19;1134;286;27796;11866;10.5;4.5
08;2021-03-20;511;20;28307;11886;10.7;4.5
08;2021-03-21;13;1;28320;11887;10.7;4.5
08;2021-03-22;367;45;28687;11932;10.8;4.5
08;2021-03-23;733;63;29420;11995;11.1;4.5
08;2021-03-24;1327;75;30747;12070;11.6;4.5
08;2021-03-25;1906;98;32653;12168;12.3;4.6
08;2021-03-26;2571;174;35224;12342;13.3;4.6
08;2021-03-27;898;125;36122;12467;13.6;4.7
08;2021-03-28;228;7;36350;12474;13.7;4.7
08;2021-03-29;261;184;36611;12658;13.8;4.8
08;2021-03-30;832;488;37443;13146;14.1;5.0
08;2021-03-31;852;534;38295;13680;14.4;5.2
08;2021-04-01;1687;453;39982;14133;15.1;5.3
08;2021-04-02;1497;523;41479;14656;15.6;5.5
08;2021-04-03;1329;205;42808;14861;16.1;5.6
08;2021-04-04;134;4;42942;14865;16.2;5.6
08;2021-04-05;17;0;42959;14865;16.2;5.6
08;2021-04-06;702;484;43661;15349;16.4;5.8
08;2021-04-07;909;705;44570;16054;16.8;6.0
08;2021-04-08;1745;524;46315;16578;17.4;6.2
08;2021-04-09;2347;730;48662;17308;18.3;6.5
08;2021-04-10;1445;229;50107;17537;18.9;6.6
08;2021-04-11;10;6;50117;17543;18.9;6.6
08;2021-04-12;671;218;50788;17761;19.1;6.7
08;2021-04-13;1309;613;52097;18374;19.6;6.9
08;2021-04-14;1280;867;53377;19241;20.1;7.2
08;2021-04-15;1606;810;54983;20051;20.7;7.6
08;2021-04-16;1873;884;56856;20935;21.4;7.9
08;2021-04-17;1112;403;57968;21338;21.8;8.0
08;2021-04-18;23;14;57991;21352;21.8;8.0
08;2021-04-19;1151;301;59142;21653;22.3;8.2
08;2021-04-20;1120;544;60262;22197;22.7;8.4
08;2021-04-21;1139;747;61401;22944;23.1;8.6
08;2021-04-22;1326;880;62727;23824;23.6;9.0
08;2021-04-23;1675;1174;64402;24998;24.3;9.4
08;2021-04-24;1325;647;65727;25645;24.8;9.7
08;2021-04-25;26;198;65753;25843;24.8;9.7
08;2021-04-26;1040;157;66793;26000;25.2;9.8
08;2021-04-27;1338;601;68131;26601;25.7;10.0
08;2021-04-28;1453;682;69584;27283;26.2;10.3
08;2021-04-29;1174;1316;70758;28599;26.6;10.8
08;2021-04-30;1769;1618;72527;30217;27.3;11.4
08;2021-05-01;1049;497;73576;30714;27.7;11.6
08;2021-05-02;627;183;74203;30897;27.9;11.6
08;2021-05-03;1172;376;75375;31273;28.4;11.8
08;2021-05-04;1328;876;76703;32149;28.9;12.1
08;2021-05-05;1567;1335;78270;33484;29.5;12.6
08;2021-05-06;1971;1664;80241;35148;30.2;13.2
08;2021-05-07;1860;2102;82101;37250;30.9;14.0
08;2021-05-08;922;768;83023;38018;31.3;14.3
08;2021-05-09;443;71;83466;38089;31.4;14.3
08;2021-05-10;1192;665;84658;38754;31.9;14.6
08;2021-05-11;1907;946;86565;39700;32.6;15.0
08;2021-05-12;1809;1240;88374;40940;33.3;15.4
08;2021-05-13;1306;620;89680;41560;33.8;15.7
08;2021-05-14;2535;1038;92215;42598;34.7;16.0
08;2021-05-15;1820;712;94035;43310;35.4;16.3
08;2021-05-16;820;102;94855;43412;35.7;16.3
08;2021-05-17;700;906;95555;44318;36.0;16.7
08;2021-05-18;1250;841;96805;45159;36.5;17.0
08;2021-05-19;1611;960;98416;46119;37.1;17.4
08;2021-05-20;2147;963;100563;47082;37.9;17.7
08;2021-05-21;2339;1274;102902;48356;38.8;18.2
08;2021-05-22;1817;763;104719;49119;39.4;18.5
08;2021-05-23;864;90;105583;49209;39.8;18.5
08;2021-05-24;716;106;106299;49315;40.0;18.6
08;2021-05-25;1456;669;107755;49984;40.6;18.8
08;2021-05-26;1529;1011;109284;50995;41.2;19.2
08;2021-05-27;2006;1146;111290;52141;41.9;19.6
08;2021-05-28;1973;1822;113263;53963;42.7;20.3
08;2021-05-29;1767;966;115030;54929;43.3;20.7
08;2021-05-30;836;102;115866;55031;43.6;20.7
08;2021-05-31;755;570;116621;55601;43.9;20.9
08;2021-06-01;1350;879;117971;56480;44.4;21.3
08;2021-06-02;1295;1194;119266;57674;44.9;21.7
08;2021-06-03;1386;1524;120652;59198;45.4;22.3
08;2021-06-04;1778;2420;122430;61618;46.1;23.2
08;2021-06-05;1176;1381;123606;62999;46.6;23.7
08;2021-06-06;907;107;124513;63106;46.9;23.8
08;2021-06-07;661;1174;125174;64280;47.1;24.2
08;2021-06-08;931;1496;126105;65776;47.5;24.8
08;2021-06-09;840;1391;126945;67167;47.8;25.3
08;2021-06-10;1719;1563;128664;68730;48.5;25.9
08;2021-06-11;1721;2211;130385;70941;49.1;26.7
08;2021-06-12;1417;1528;131802;72469;49.6;27.3
08;2021-06-13;385;598;132187;73067;49.8;27.5
08;2021-06-14;380;1304;132567;74371;49.9;28.0
08;2021-06-15;742;1548;133309;75919;50.2;28.6
08;2021-06-16;808;2054;134117;77973;50.5;29.4
08;2021-06-17;1285;1854;135402;79827;51.0;30.1
08;2021-06-18;1610;2594;137012;82421;51.6;31.0
08;2021-06-19;1324;1407;138336;83828;52.1;31.6
08;2021-06-20;117;423;138453;84251;52.1;31.7
08;2021-06-21;494;1395;138947;85646;52.3;32.3
08;2021-06-22;812;2023;139759;87669;52.6;33.0
08;2021-06-23;859;1672;140618;89341;53.0;33.6
08;2021-06-24;1038;1923;141656;91264;53.3;34.4
08;2021-06-25;1084;2735;142740;93999;53.8;35.4
08;2021-06-26;1010;1784;143750;95783;54.1;36.1
08;2021-06-27;351;643;144101;96426;54.3;36.3
08;2021-06-28;397;1324;144498;97750;54.4;36.8
08;2021-06-29;627;1472;145125;99222;54.7;37.4
08;2021-06-30;857;1689;145982;100911;55.0;38.0
08;2021-07-01;887;2193;146869;103104;55.3;38.8
08;2021-07-02;939;2645;147808;105749;55.7;39.8
08;2021-07-03;784;2145;148592;107894;56.0;40.6
08;2021-07-04;128;861;148720;108755;56.0;41.0
08;2021-07-05;104;1195;148824;109950;56.0;41.4
08;2021-07-06;425;1835;149249;111785;56.2;42.1
08;2021-07-07;364;1780;149613;113565;56.3;42.8
08;2021-07-08;716;2016;150329;115581;56.6;43.5
08;2021-07-09;732;2432;151061;118013;56.9;44.4
08;2021-07-10;652;2003;151713;120016;57.1;45.2
08;2021-07-11;238;725;151951;120741;57.2;45.5
08;2021-07-12;312;1192;152263;121933;57.3;45.9
08;2021-07-13;947;1788;153210;123721;57.7;46.6
08;2021-07-14;179;329;153389;124050;57.8;46.7
08;2021-07-15;759;2448;154148;126498;58.1;47.6
08;2021-07-16;1084;2408;155232;128906;58.5;48.5
08;2021-07-17;993;2108;156225;131014;58.8;49.3
08;2021-07-18;346;741;156571;131755;59.0;49.6
08;2021-07-19;459;918;157030;132673;59.1;50.0
08;2021-07-20;878;1435;157908;134108;59.5;50.5
08;2021-07-21;1237;1717;159145;135825;59.9;51.2
08;2021-07-22;1150;2167;160295;137992;60.4;52.0
08;2021-07-23;1584;2444;161879;140436;61.0;52.9
08;2021-07-24;1309;1924;163188;142360;61.5;53.6
08;2021-07-25;774;445;163962;142805;61.7;53.8
08;2021-07-26;1324;846;165286;143651;62.2;54.1
08;2021-07-27;2186;1408;167472;145059;63.1;54.6
08;2021-07-28;2413;1455;169885;146514;64.0;55.2
08;2021-07-29;2601;1347;172486;147861;65.0;55.7
08;2021-07-30;2601;1587;175087;149448;65.9;56.3
08;2021-07-31;1972;1075;177059;150523;66.7;56.7
08;2021-08-01;935;301;177994;150824;67.0;56.8
08;2021-08-02;1255;682;179249;151506;67.5;57.1
08;2021-08-03;1634;824;180883;152330;68.1;57.4
08;2021-08-04;1493;665;182376;152995;68.7;57.6
08;2021-08-05;1905;977;184281;153972;69.4;58.0
08;2021-08-06;2589;1099;186870;155071;70.4;58.4
08;2021-08-07;1673;1162;188543;156233;71.0;58.8
08;2021-08-08;585;374;189128;156607;71.2;59.0
08;2021-08-09;672;534;189800;157141;71.5;59.2
08;2021-08-10;879;750;190679;157891;71.8;59.5
08;2021-08-11;525;791;191204;158682;72.0;59.8
08;2021-08-12;1161;1080;192365;159762;72.4;60.2
08;2021-08-13;1157;1013;193522;160775;72.9;60.5
08;2021-08-14;587;913;194109;161688;73.1;60.9
08;2021-08-15;137;273;194246;161961;73.2;61.0
08;2021-08-16;218;1177;194464;163138;73.2;61.4
08;2021-08-17;514;1210;194978;164348;73.4;61.9
08;2021-08-18;281;1263;195259;165611;73.5;62.4
08;2021-08-19;606;1888;195865;167499;73.8;63.1
08;2021-08-20;685;2178;196550;169677;74.0;63.9
08;2021-08-21;273;1340;196823;171017;74.1;64.4
08;2021-08-22;104;900;196927;171917;74.2;64.7
08;2021-08-23;160;1448;197087;173365;74.2;65.3
08;2021-08-24;365;1752;197452;175117;74.4;65.9
08;2021-08-25;323;1248;197775;176365;74.5;66.4
08;2021-08-26;502;2064;198277;178429;74.7;67.2
08;2021-08-27;451;2324;198728;180753;74.8;68.1
08;2021-08-28;262;1289;198990;182042;74.9;68.6
08;2021-08-29;169;563;199159;182605;75.0;68.8
08;2021-08-30;302;1156;199461;183761;75.1;69.2
08;2021-08-31;360;1248;199821;185009;75.3;69.7
08;2021-09-01;417;1232;200238;186241;75.4;70.1
08;2021-09-02;466;1150;200704;187391;75.6;70.6
08;2021-09-03;464;1553;201168;188944;75.8;71.2
08;2021-09-04;349;1413;201517;190357;75.9;71.7
08;2021-09-05;106;173;201623;190530;75.9;71.8
08;2021-09-06;196;404;201819;190934;76.0;71.9
08;2021-09-07;205;488;202024;191422;76.1;72.1
08;2021-09-08;281;500;202305;191922;76.2;72.3
08;2021-09-09;344;590;202649;192512;76.3;72.5
08;2021-09-10;495;780;203144;193292;76.5;72.8
08;2021-09-11;383;732;203527;194024;76.6;73.1
08;2021-09-12;52;71;203579;194095;76.7;73.1
08;2021-09-13;386;174;203965;194269;76.8;73.2
08;2021-09-14;247;275;204212;194544;76.9;73.3
08;2021-09-15;219;318;204431;194862;77.0;73.4
08;2021-09-16;231;422;204662;195284;77.1;73.5
08;2021-09-17;321;501;204983;195785;77.2;73.7
08;2021-09-18;173;430;205156;196215;77.3;73.9
08;2021-09-19;29;90;205185;196305;77.3;73.9
08;2021-09-20;54;237;205239;196542;77.3;74.0
08;2021-09-21;123;277;205362;196819;77.3;74.1
08;2021-09-22;130;368;205492;197187;77.4;74.3
08;2021-09-23;173;412;205665;197599;77.5;74.4
08;2021-09-24;162;517;205827;198116;77.5;74.6
08;2021-09-25;121;415;205948;198531;77.6;74.8
08;2021-09-26;23;105;205971;198636;77.6;74.8
08;2021-09-27;49;211;206020;198847;77.6;74.9
08;2021-09-28;80;226;206100;199073;77.6;75.0
08;2021-09-29;116;339;206216;199412;77.7;75.1
08;2021-09-30;147;376;206363;199788;77.7;75.2
08;2021-10-01;165;466;206528;200254;77.8;75.4
08;2021-10-02;141;288;206669;200542;77.8;75.5
08;2021-10-03;24;67;206693;200609;77.8;75.6
08;2021-10-04;58;347;206751;200956;77.9;75.7
08;2021-10-05;79;172;206830;201128;77.9;75.7
08;2021-10-06;92;242;206922;201370;77.9;75.8
08;2021-10-07;105;196;207027;201566;78.0;75.9
08;2021-10-08;154;356;207181;201922;78.0;76.0
08;2021-10-09;136;331;207317;202253;78.1;76.2
08;2021-10-10;34;47;207351;202300;78.1;76.2
08;2021-10-11;58;83;207409;202383;78.1;76.2
08;2021-10-12;76;133;207485;202516;78.1;76.3
08;2021-10-13;116;159;207601;202675;78.2;76.3
08;2021-10-14;55;154;207656;202829;78.2;76.4
09;2020-12-27;0;0;0;0;0.0;0.0
09;2020-12-28;1;0;1;0;0.0;0.0
09;2020-12-29;0;0;1;0;0.0;0.0
09;2020-12-30;0;0;1;0;0.0;0.0
09;2020-12-31;0;0;1;0;0.0;0.0
09;2021-01-01;0;0;1;0;0.0;0.0
09;2021-01-02;0;0;1;0;0.0;0.0
09;2021-01-03;0;0;1;0;0.0;0.0
09;2021-01-04;2;1;3;1;0.0;0.0
09;2021-01-05;0;0;3;1;0.0;0.0
09;2021-01-06;3;0;6;1;0.0;0.0
09;2021-01-07;257;2;263;3;0.2;0.0
09;2021-01-08;228;0;491;3;0.3;0.0
09;2021-01-09;103;0;594;3;0.4;0.0
09;2021-01-10;60;0;654;3;0.4;0.0
09;2021-01-11;176;0;830;3;0.5;0.0
09;2021-01-12;303;0;1133;3;0.7;0.0
09;2021-01-13;196;0;1329;3;0.9;0.0
09;2021-01-14;432;7;1761;10;1.2;0.0
09;2021-01-15;223;1;1984;11;1.3;0.0
09;2021-01-16;192;3;2176;14;1.4;0.0
09;2021-01-17;123;0;2299;14;1.5;0.0
09;2021-01-18;263;2;2562;16;1.7;0.0
09;2021-01-19;255;1;2817;17;1.8;0.0
09;2021-01-20;346;2;3163;19;2.1;0.0
09;2021-01-21;330;1;3493;20;2.3;0.0
09;2021-01-22;327;1;3820;21;2.5;0.0
09;2021-01-23;237;0;4057;21;2.7;0.0
09;2021-01-24;87;1;4144;22;2.7;0.0
09;2021-01-25;208;12;4352;34;2.9;0.0
09;2021-01-26;629;25;4981;59;3.3;0.0
09;2021-01-27;472;49;5453;108;3.6;0.1
09;2021-01-28;287;205;5740;313;3.8;0.2
09;2021-01-29;251;129;5991;442;3.9;0.3
09;2021-01-30;143;55;6134;497;4.0;0.3
09;2021-01-31;56;10;6190;507;4.1;0.3
09;2021-02-01;81;142;6271;649;4.1;0.4
09;2021-02-02;58;295;6329;944;4.2;0.6
09;2021-02-03;87;204;6416;1148;4.2;0.8
09;2021-02-04;49;299;6465;1447;4.2;0.9
09;2021-02-05;90;154;6555;1601;4.3;1.1
09;2021-02-06;68;51;6623;1652;4.3;1.1
09;2021-02-07;6;71;6629;1723;4.3;1.1
09;2021-02-08;23;177;6652;1900;4.4;1.2
09;2021-02-09;55;290;6707;2190;4.4;1.4
09;2021-02-10;14;195;6721;2385;4.4;1.6
09;2021-02-11;6;219;6727;2604;4.4;1.7
09;2021-02-12;147;176;6874;2780;4.5;1.8
09;2021-02-13;8;144;6882;2924;4.5;1.9
09;2021-02-14;0;52;6882;2976;4.5;2.0
09;2021-02-15;76;133;6958;3109;4.6;2.0
09;2021-02-16;227;509;7185;3618;4.7;2.4
09;2021-02-17;83;387;7268;4005;4.8;2.6
09;2021-02-18;87;446;7355;4451;4.8;2.9
09;2021-02-19;63;284;7418;4735;4.9;3.1
09;2021-02-20;58;199;7476;4934;4.9;3.2
09;2021-02-21;0;51;7476;4985;4.9;3.3
09;2021-02-22;127;217;7603;5202;5.0;3.4
09;2021-02-23;161;145;7764;5347;5.1;3.5
09;2021-02-24;74;178;7838;5525;5.1;3.6
09;2021-02-25;211;169;8049;5694;5.3;3.7
09;2021-02-26;162;177;8211;5871;5.4;3.9
09;2021-02-27;65;71;8276;5942;5.4;3.9
09;2021-02-28;44;17;8320;5959;5.5;3.9
09;2021-03-01;248;95;8568;6054;5.6;4.0
09;2021-03-02;282;77;8850;6131;5.8;4.0
09;2021-03-03;252;132;9102;6263;6.0;4.1
09;2021-03-04;414;33;9516;6296;6.2;4.1
09;2021-03-05;331;65;9847;6361;6.5;4.2
09;2021-03-06;397;46;10244;6407;6.7;4.2
09;2021-03-07;124;4;10368;6411;6.8;4.2
09;2021-03-08;379;64;10747;6475;7.1;4.2
09;2021-03-09;437;144;11184;6619;7.3;4.3
09;2021-03-10;562;73;11746;6692;7.7;4.4
09;2021-03-11;695;79;12441;6771;8.2;4.4
09;2021-03-12;661;35;13102;6806;8.6;4.5
09;2021-03-13;384;3;13486;6809;8.8;4.5
09;2021-03-14;122;5;13608;6814;8.9;4.5
09;2021-03-15;465;50;14073;6864;9.2;4.5
09;2021-03-16;370;80;14443;6944;9.5;4.6
09;2021-03-17;399;71;14842;7015;9.7;4.6
09;2021-03-18;454;43;15296;7058;10.0;4.6
09;2021-03-19;526;56;15822;7114;10.4;4.7
09;2021-03-20;314;39;16136;7153;10.6;4.7
09;2021-03-21;105;0;16241;7153;10.7;4.7
09;2021-03-22;424;120;16665;7273;10.9;4.8
09;2021-03-23;566;174;17231;7447;11.3;4.9
09;2021-03-24;710;44;17941;7491;11.8;4.9
09;2021-03-25;869;139;18810;7630;12.3;5.0
09;2021-03-26;751;47;19561;7677;12.8;5.0
09;2021-03-27;620;70;20181;7747;13.2;5.1
09;2021-03-28;132;24;20313;7771;13.3;5.1
09;2021-03-29;498;279;20811;8050;13.7;5.3
09;2021-03-30;729;157;21540;8207;14.1;5.4
09;2021-03-31;803;182;22343;8389;14.7;5.5
09;2021-04-01;734;257;23077;8646;15.1;5.7
09;2021-04-02;692;269;23769;8915;15.6;5.8
09;2021-04-03;772;117;24541;9032;16.1;5.9
09;2021-04-04;122;57;24663;9089;16.2;6.0
09;2021-04-05;237;61;24900;9150;16.3;6.0
09;2021-04-06;1059;396;25959;9546;17.0;6.3
09;2021-04-07;1208;364;27167;9910;17.8;6.5
09;2021-04-08;1470;414;28637;10324;18.8;6.8
09;2021-04-09;1137;417;29774;10741;19.5;7.0
09;2021-04-10;1349;196;31123;10937;20.4;7.2
09;2021-04-11;173;102;31296;11039;20.5;7.2
09;2021-04-12;737;345;32033;11384;21.0;7.5
09;2021-04-13;1047;417;33080;11801;21.7;7.7
09;2021-04-14;1332;512;34412;12313;22.6;8.1
09;2021-04-15;1148;508;35560;12821;23.3;8.4
09;2021-04-16;1032;415;36592;13236;24.0;8.7
09;2021-04-17;1192;358;37784;13594;24.8;8.9
09;2021-04-18;102;96;37886;13690;24.9;9.0
09;2021-04-19;697;408;38583;14098;25.3;9.3
09;2021-04-20;766;532;39349;14630;25.8;9.6
09;2021-04-21;938;590;40287;15220;26.4;10.0
09;2021-04-22;666;609;40953;15829;26.9;10.4
09;2021-04-23;773;432;41726;16261;27.4;10.7
09;2021-04-24;741;670;42467;16931;27.9;11.1
09;2021-04-25;75;113;42542;17044;27.9;11.2
09;2021-04-26;382;533;42924;17577;28.2;11.5
09;2021-04-27;444;722;43368;18299;28.5;12.0
09;2021-04-28;806;795;44174;19094;29.0;12.5
09;2021-04-29;549;775;44723;19869;29.3;13.0
09;2021-04-30;622;724;45345;20593;29.8;13.5
09;2021-05-01;478;455;45823;21048;30.1;13.8
09;2021-05-02;52;100;45875;21148;30.1;13.9
09;2021-05-03;521;664;46396;21812;30.4;14.3
09;2021-05-04;554;1349;46950;23161;30.8;15.2
09;2021-05-05;822;1348;47772;24509;31.3;16.1
09;2021-05-06;848;1032;48620;25541;31.9;16.8
09;2021-05-07;978;822;49598;26363;32.5;17.3
09;2021-05-08;395;461;49993;26824;32.8;17.6
09;2021-05-09;265;85;50258;26909;33.0;17.7
09;2021-05-10;504;966;50762;27875;33.3;18.3
09;2021-05-11;741;1052;51503;28927;33.8;19.0
09;2021-05-12;1535;1405;53038;30332;34.8;19.9
09;2021-05-13;1383;425;54421;30757;35.7;20.2
09;2021-05-14;987;656;55408;31413;36.4;20.6
09;2021-05-15;1236;789;56644;32202;37.2;21.1
09;2021-05-16;296;48;56940;32250;37.4;21.2
09;2021-05-17;873;413;57813;32663;37.9;21.4
09;2021-05-18;1290;395;59103;33058;38.8;21.7
09;2021-05-19;1495;371;60598;33429;39.8;21.9
09;2021-05-20;1379;404;61977;33833;40.7;22.2
09;2021-05-21;1162;495;63139;34328;41.4;22.5
09;2021-05-22;1544;364;64683;34692;42.4;22.8
09;2021-05-23;272;24;64955;34716;42.6;22.8
09;2021-05-24;177;100;65132;34816;42.7;22.8
09;2021-05-25;998;500;66130;35316;43.4;23.2
09;2021-05-26;1285;448;67415;35764;44.2;23.5
09;2021-05-27;965;403;68380;36167;44.9;23.7
09;2021-05-28;958;513;69338;36680;45.5;24.1
09;2021-05-29;1793;601;71131;37281;46.7;24.5
09;2021-05-30;541;197;71672;37478;47.0;24.6
09;2021-05-31;717;593;72389;38071;47.5;25.0
09;2021-06-01;970;642;73359;38713;48.1;25.4
09;2021-06-02;1009;897;74368;39610;48.8;26.0
09;2021-06-03;809;681;75177;40291;49.3;26.4
09;2021-06-04;877;798;76054;41089;49.9;27.0
09;2021-06-05;1320;875;77374;41964;50.8;27.5
09;2021-06-06;304;108;77678;42072;51.0;27.6
09;2021-06-07;623;518;78301;42590;51.4;27.9
09;2021-06-08;821;488;79122;43078;51.9;28.3
09;2021-06-09;805;834;79927;43912;52.4;28.8
09;2021-06-10;642;534;80569;44446;52.9;29.2
09;2021-06-11;830;761;81399;45207;53.4;29.7
09;2021-06-12;635;808;82034;46015;53.8;30.2
09;2021-06-13;94;130;82128;46145;53.9;30.3
09;2021-06-14;628;708;82756;46853;54.3;30.7
09;2021-06-15;824;889;83580;47742;54.8;31.3
09;2021-06-16;627;1079;84207;48821;55.3;32.0
09;2021-06-17;779;852;84986;49673;55.8;32.6
09;2021-06-18;636;1150;85622;50823;56.2;33.3
09;2021-06-19;516;1580;86138;52403;56.5;34.4
09;2021-06-20;8;279;86146;52682;56.5;34.6
09;2021-06-21;473;698;86619;53380;56.8;35.0
09;2021-06-22;463;1066;87082;54446;57.1;35.7
09;2021-06-23;435;1224;87517;55670;57.4;36.5
09;2021-06-24;581;769;88098;56439;57.8;37.0
09;2021-06-25;410;1064;88508;57503;58.1;37.7
09;2021-06-26;443;1087;88951;58590;58.4;38.4
09;2021-06-27;2;275;88953;58865;58.4;38.6
09;2021-06-28;239;1047;89192;59912;58.5;39.3
09;2021-06-29;314;1229;89506;61141;58.7;40.1
09;2021-06-30;456;1492;89962;62633;59.0;41.1
09;2021-07-01;384;1434;90346;64067;59.3;42.0
09;2021-07-02;308;1162;90654;65229;59.5;42.8
09;2021-07-03;210;1617;90864;66846;59.6;43.9
09;2021-07-04;4;253;90868;67099;59.6;44.0
09;2021-07-05;188;713;91056;67812;59.7;44.5
09;2021-07-06;293;1222;91349;69034;59.9;45.3
09;2021-07-07;419;1399;91768;70433;60.2;46.2
09;2021-07-08;325;1058;92093;71491;60.4;46.9
09;2021-07-09;292;1153;92385;72644;60.6;47.7
09;2021-07-10;345;1725;92730;74369;60.8;48.8
09;2021-07-11;147;392;92877;74761;60.9;49.1
09;2021-07-12;187;1074;93064;75835;61.1;49.8
09;2021-07-13;641;1308;93705;77143;61.5;50.6
09;2021-07-14;490;220;94195;77363;61.8;50.8
09;2021-07-15;819;1166;95014;78529;62.3;51.5
09;2021-07-16;610;1191;95624;79720;62.7;52.3
09;2021-07-17;1015;1444;96639;81164;63.4;53.3
09;2021-07-18;302;221;96941;81385;63.6;53.4
09;2021-07-19;483;973;97424;82358;63.9;54.0
09;2021-07-20;830;1260;98254;83618;64.5;54.9
09;2021-07-21;1016;1165;99270;84783;65.1;55.6
09;2021-07-22;846;910;100116;85693;65.7;56.2
09;2021-07-23;724;912;100840;86605;66.2;56.8
09;2021-07-24;927;463;101767;87068;66.8;57.1
09;2021-07-25;560;134;102327;87202;67.1;57.2
09;2021-07-26;647;765;102974;87967;67.6;57.7
09;2021-07-27;1177;949;104151;88916;68.3;58.3
09;2021-07-28;1197;988;105348;89904;69.1;59.0
09;2021-07-29;1042;739;106390;90643;69.8;59.5
09;2021-07-30;779;623;107169;91266;70.3;59.9
09;2021-07-31;1379;419;108548;91685;71.2;60.2
09;2021-08-01;141;125;108689;91810;71.3;60.2
09;2021-08-02;614;478;109303;92288;71.7;60.6
09;2021-08-03;1254;767;110557;93055;72.5;61.1
09;2021-08-04;1400;654;111957;93709;73.5;61.5
09;2021-08-05;997;677;112954;94386;74.1;61.9
09;2021-08-06;1017;641;113971;95027;74.8;62.4
09;2021-08-07;825;430;114796;95457;75.3;62.6
09;2021-08-08;129;131;114925;95588;75.4;62.7
09;2021-08-09;690;650;115615;96238;75.9;63.1
09;2021-08-10;940;695;116555;96933;76.5;63.6
09;2021-08-11;896;866;117451;97799;77.1;64.2
09;2021-08-12;631;731;118082;98530;77.5;64.7
09;2021-08-13;465;645;118547;99175;77.8;65.1
09;2021-08-14;311;828;118858;100003;78.0;65.6
09;2021-08-15;67;138;118925;100141;78.0;65.7
09;2021-08-16;547;620;119472;100761;78.4;66.1
09;2021-08-17;674;777;120146;101538;78.8;66.6
09;2021-08-18;620;931;120766;102469;79.2;67.2
09;2021-08-19;432;722;121198;103191;79.5;67.7
09;2021-08-20;363;749;121561;103940;79.8;68.2
09;2021-08-21;343;1384;121904;105324;80.0;69.1
09;2021-08-22;67;168;121971;105492;80.0;69.2
09;2021-08-23;341;759;122312;106251;80.3;69.7
09;2021-08-24;407;955;122719;107206;80.5;70.3
09;2021-08-25;283;1003;123002;108209;80.7;71.0
09;2021-08-26;316;928;123318;109137;80.9;71.6
09;2021-08-27;226;740;123544;109877;81.1;72.1
09;2021-08-28;257;970;123801;110847;81.2;72.7
09;2021-08-29;15;144;123816;110991;81.2;72.8
09;2021-08-30;275;720;124091;111711;81.4;73.3
09;2021-08-31;314;1064;124405;112775;81.6;74.0
09;2021-09-01;361;770;124766;113545;81.9;74.5
09;2021-09-02;159;494;124925;114039;82.0;74.8
09;2021-09-03;223;743;125148;114782;82.1;75.3
09;2021-09-04;200;474;125348;115256;82.3;75.6
09;2021-09-05;25;80;125373;115336;82.3;75.7
09;2021-09-06;182;521;125555;115857;82.4;76.0
09;2021-09-07;157;548;125712;116405;82.5;76.4
09;2021-09-08;204;827;125916;117232;82.6;76.9
09;2021-09-09;160;434;126076;117666;82.7;77.2
09;2021-09-10;130;429;126206;118095;82.8;77.5
09;2021-09-11;175;400;126381;118495;82.9;77.8
09;2021-09-12;27;71;126408;118566;82.9;77.8
09;2021-09-13;129;418;126537;118984;83.0;78.1
09;2021-09-14;144;502;126681;119486;83.1;78.4
09;2021-09-15;188;603;126869;120089;83.2;78.8
09;2021-09-16;130;324;126999;120413;83.3;79.0
09;2021-09-17;146;405;127145;120818;83.4;79.3
09;2021-09-18;158;345;127303;121163;83.5;79.5
09;2021-09-19;2;0;127305;121163;83.5;79.5
09;2021-09-20;71;290;127376;121453;83.6;79.7
09;2021-09-21;101;205;127477;121658;83.6;79.8
09;2021-09-22;141;471;127618;122129;83.7;80.1
09;2021-09-23;71;164;127689;122293;83.8;80.2
09;2021-09-24;117;289;127806;122582;83.9;80.4
09;2021-09-25;62;195;127868;122777;83.9;80.6
09;2021-09-26;0;17;127868;122794;83.9;80.6
09;2021-09-27;82;327;127950;123121;84.0;80.8
09;2021-09-28;74;175;128024;123296;84.0;80.9
09;2021-09-29;97;235;128121;123531;84.1;81.1
09;2021-09-30;43;119;128164;123650;84.1;81.1
09;2021-10-01;82;125;128246;123775;84.2;81.2
09;2021-10-02;83;230;128329;124005;84.2;81.4
09;2021-10-03;2;8;128331;124013;84.2;81.4
09;2021-10-04;53;114;128384;124127;84.2;81.4
09;2021-10-05;70;125;128454;124252;84.3;81.5
09;2021-10-06;123;221;128577;124473;84.4;81.7
09;2021-10-07;60;165;128637;124638;84.4;81.8
09;2021-10-08;109;180;128746;124818;84.5;81.9
09;2021-10-09;55;133;128801;124951;84.5;82.0
09;2021-10-10;0;7;128801;124958;84.5;82.0
09;2021-10-11;69;107;128870;125065;84.6;82.1
09;2021-10-12;45;77;128915;125142;84.6;82.1
09;2021-10-13;88;155;129003;125297;84.6;82.2
09;2021-10-14;53;90;129056;125387;84.7;82.3
10;2020-12-27;0;0;0;0;0.0;0.0
10;2020-12-28;0;0;0;0;0.0;0.0
10;2020-12-29;0;0;0;0;0.0;0.0
10;2020-12-30;0;0;0;0;0.0;0.0
10;2020-12-31;0;0;0;0;0.0;0.0
10;2021-01-01;0;0;0;0;0.0;0.0
10;2021-01-02;1;0;1;0;0.0;0.0
10;2021-01-03;0;0;1;0;0.0;0.0
10;2021-01-04;0;0;1;0;0.0;0.0
10;2021-01-05;1;0;2;0;0.0;0.0
10;2021-01-06;0;0;2;0;0.0;0.0
10;2021-01-07;85;0;87;0;0.0;0.0
10;2021-01-08;255;0;342;0;0.1;0.0
10;2021-01-09;0;0;342;0;0.1;0.0
10;2021-01-10;1;0;343;0;0.1;0.0
10;2021-01-11;118;1;461;1;0.1;0.0
10;2021-01-12;195;4;656;5;0.2;0.0
10;2021-01-13;314;0;970;5;0.3;0.0
10;2021-01-14;392;10;1362;15;0.4;0.0
10;2021-01-15;359;3;1721;18;0.6;0.0
10;2021-01-16;56;0;1777;18;0.6;0.0
10;2021-01-17;1;0;1778;18;0.6;0.0
10;2021-01-18;702;4;2480;22;0.8;0.0
10;2021-01-19;1392;8;3872;30;1.2;0.0
10;2021-01-20;1084;9;4956;39;1.6;0.0
10;2021-01-21;1152;2;6108;41;2.0;0.0
10;2021-01-22;818;2;6926;43;2.2;0.0
10;2021-01-23;309;0;7235;43;2.3;0.0
10;2021-01-24;0;0;7235;43;2.3;0.0
10;2021-01-25;445;8;7680;51;2.5;0.0
10;2021-01-26;487;17;8167;68;2.6;0.0
10;2021-01-27;458;15;8625;83;2.8;0.0
10;2021-01-28;358;49;8983;132;2.9;0.0
10;2021-01-29;430;191;9413;323;3.0;0.1
10;2021-01-30;30;0;9443;323;3.0;0.1
10;2021-01-31;0;0;9443;323;3.0;0.1
10;2021-02-01;409;139;9852;462;3.2;0.1
10;2021-02-02;182;151;10034;613;3.2;0.2
10;2021-02-03;361;215;10395;828;3.4;0.3
10;2021-02-04;342;269;10737;1097;3.5;0.4
10;2021-02-05;328;322;11065;1419;3.6;0.5
10;2021-02-06;3;35;11068;1454;3.6;0.5
10;2021-02-07;0;0;11068;1454;3.6;0.5
10;2021-02-08;190;411;11258;1865;3.6;0.6
10;2021-02-09;485;586;11743;2451;3.8;0.8
10;2021-02-10;667;482;12410;2933;4.0;0.9
10;2021-02-11;781;596;13191;3529;4.3;1.1
10;2021-02-12;580;549;13771;4078;4.4;1.3
10;2021-02-13;37;120;13808;4198;4.5;1.4
10;2021-02-14;0;0;13808;4198;4.5;1.4
10;2021-02-15;143;442;13951;4640;4.5;1.5
10;2021-02-16;116;541;14067;5181;4.5;1.7
10;2021-02-17;129;603;14196;5784;4.6;1.9
10;2021-02-18;217;555;14413;6339;4.7;2.0
10;2021-02-19;188;473;14601;6812;4.7;2.2
10;2021-02-20;24;183;14625;6995;4.7;2.3
10;2021-02-21;0;0;14625;6995;4.7;2.3
10;2021-02-22;77;445;14702;7440;4.7;2.4
10;2021-02-23;76;557;14778;7997;4.8;2.6
10;2021-02-24;114;373;14892;8370;4.8;2.7
10;2021-02-25;322;373;15214;8743;4.9;2.8
10;2021-02-26;351;283;15565;9026;5.0;2.9
10;2021-02-27;275;129;15840;9155;5.1;3.0
10;2021-02-28;0;0;15840;9155;5.1;3.0
10;2021-03-01;257;332;16097;9487;5.2;3.1
10;2021-03-02;435;369;16532;9856;5.3;3.2
10;2021-03-03;454;583;16986;10439;5.5;3.4
10;2021-03-04;636;501;17622;10940;5.7;3.5
10;2021-03-05;677;254;18299;11194;5.9;3.6
10;2021-03-06;950;46;19249;11240;6.2;3.6
10;2021-03-07;769;7;20018;11247;6.5;3.6
10;2021-03-08;502;442;20520;11689;6.6;3.8
10;2021-03-09;673;435;21193;12124;6.8;3.9
10;2021-03-10;662;365;21855;12489;7.1;4.0
10;2021-03-11;1174;238;23029;12727;7.4;4.1
10;2021-03-12;1338;250;24367;12977;7.9;4.2
10;2021-03-13;891;39;25258;13016;8.2;4.2
10;2021-03-14;1381;17;26639;13033;8.6;4.2
10;2021-03-15;821;83;27460;13116;8.9;4.2
10;2021-03-16;688;64;28148;13180;9.1;4.3
10;2021-03-17;831;68;28979;13248;9.4;4.3
10;2021-03-18;886;84;29865;13332;9.6;4.3
10;2021-03-19;952;71;30817;13403;9.9;4.3
10;2021-03-20;552;19;31369;13422;10.1;4.3
10;2021-03-21;1848;43;33217;13465;10.7;4.3
10;2021-03-22;879;76;34096;13541;11.0;4.4
10;2021-03-23;1243;94;35339;13635;11.4;4.4
10;2021-03-24;1311;60;36650;13695;11.8;4.4
10;2021-03-25;1676;232;38326;13927;12.4;4.5
10;2021-03-26;1432;116;39758;14043;12.8;4.5
10;2021-03-27;762;80;40520;14123;13.1;4.6
10;2021-03-28;1221;31;41741;14154;13.5;4.6
10;2021-03-29;648;305;42389;14459;13.7;4.7
10;2021-03-30;927;376;43316;14835;14.0;4.8
10;2021-03-31;617;361;43933;15196;14.2;4.9
10;2021-04-01;882;687;44815;15883;14.5;5.1
10;2021-04-02;1069;589;45884;16472;14.8;5.3
10;2021-04-03;540;606;46424;17078;15.0;5.5
10;2021-04-04;1826;264;48250;17342;15.6;5.6
10;2021-04-05;1843;43;50093;17385;16.2;5.6
10;2021-04-06;514;651;50607;18036;16.3;5.8
10;2021-04-07;592;541;51199;18577;16.5;6.0
10;2021-04-08;1062;610;52261;19187;16.9;6.2
10;2021-04-09;1130;613;53391;19800;17.2;6.4
10;2021-04-10;1769;352;55160;20152;17.8;6.5
10;2021-04-11;55;1221;55215;21373;17.8;6.9
10;2021-04-12;1001;808;56216;22181;18.1;7.2
10;2021-04-13;1506;896;57722;23077;18.6;7.4
10;2021-04-14;827;603;58549;23680;18.9;7.6
10;2021-04-15;1454;899;60003;24579;19.4;7.9
10;2021-04-16;1109;697;61112;25276;19.7;8.2
10;2021-04-17;2391;363;63503;25639;20.5;8.3
10;2021-04-18;1422;1789;64925;27428;20.9;8.9
10;2021-04-19;837;833;65762;28261;21.2;9.1
10;2021-04-20;548;1037;66310;29298;21.4;9.5
10;2021-04-21;636;975;66946;30273;21.6;9.8
10;2021-04-22;932;963;67878;31236;21.9;10.1
10;2021-04-23;2172;779;70050;32015;22.6;10.3
10;2021-04-24;2296;380;72346;32395;23.3;10.5
10;2021-04-25;1991;1217;74337;33612;24.0;10.8
10;2021-04-26;773;623;75110;34235;24.2;11.0
10;2021-04-27;895;537;76005;34772;24.5;11.2
10;2021-04-28;873;407;76878;35179;24.8;11.4
10;2021-04-29;1433;674;78311;35853;25.3;11.6
10;2021-04-30;2172;771;80483;36624;26.0;11.8
10;2021-05-01;1988;2169;82471;38793;26.6;12.5
10;2021-05-02;1948;1898;84419;40691;27.2;13.1
10;2021-05-03;622;447;85041;41138;27.4;13.3
10;2021-05-04;1144;1248;86185;42386;27.8;13.7
10;2021-05-05;1753;1022;87938;43408;28.4;14.0
10;2021-05-06;2257;951;90195;44359;29.1;14.3
10;2021-05-07;2219;1141;92414;45500;29.8;14.7
10;2021-05-08;2270;860;94684;46360;30.6;15.0
10;2021-05-09;2004;100;96688;46460;31.2;15.0
10;2021-05-10;531;1094;97219;47554;31.4;15.3
10;2021-05-11;1052;1034;98271;48588;31.7;15.7
10;2021-05-12;2062;884;100333;49472;32.4;16.0
10;2021-05-13;2181;436;102514;49908;33.1;16.1
10;2021-05-14;2728;673;105242;50581;34.0;16.3
10;2021-05-15;2423;2053;107665;52634;34.7;17.0
10;2021-05-16;2080;1448;109745;54082;35.4;17.5
10;2021-05-17;1451;442;111196;54524;35.9;17.6
10;2021-05-18;2510;640;113706;55164;36.7;17.8
10;2021-05-19;1554;642;115260;55806;37.2;18.0
10;2021-05-20;1896;847;117156;56653;37.8;18.3
10;2021-05-21;2318;618;119474;57271;38.6;18.5
10;2021-05-22;2179;422;121653;57693;39.3;18.6
10;2021-05-23;1816;138;123469;57831;39.8;18.7
10;2021-05-24;1968;177;125437;58008;40.5;18.7
10;2021-05-25;2195;491;127632;58499;41.2;18.9
10;2021-05-26;1679;421;129311;58920;41.7;19.0
10;2021-05-27;1659;753;130970;59673;42.3;19.3
10;2021-05-28;1720;1186;132690;60859;42.8;19.6
10;2021-05-29;2170;643;134860;61502;43.5;19.8
10;2021-05-30;1029;136;135889;61638;43.8;19.9
10;2021-05-31;1039;750;136928;62388;44.2;20.1
10;2021-06-01;1135;887;138063;63275;44.5;20.4
10;2021-06-02;1035;720;139098;63995;44.9;20.6
10;2021-06-03;1473;1069;140571;65064;45.4;21.0
10;2021-06-04;1768;2598;142339;67662;45.9;21.8
10;2021-06-05;1518;2451;143857;70113;46.4;22.6
10;2021-06-06;1005;1874;144862;71987;46.7;23.2
10;2021-06-07;700;1112;145562;73099;47.0;23.6
10;2021-06-08;896;1172;146458;74271;47.3;24.0
10;2021-06-09;880;915;147338;75186;47.5;24.3
10;2021-06-10;678;1070;148016;76256;47.8;24.6
10;2021-06-11;1200;2209;149216;78465;48.1;25.3
10;2021-06-12;856;2389;150072;80854;48.4;26.1
10;2021-06-13;401;1834;150473;82688;48.6;26.7
10;2021-06-14;538;743;151011;83431;48.7;26.9
10;2021-06-15;741;2132;151752;85563;49.0;27.6
10;2021-06-16;741;1858;152493;87421;49.2;28.2
10;2021-06-17;851;2457;153344;89878;49.5;29.0
10;2021-06-18;1030;2471;154374;92349;49.8;29.8
10;2021-06-19;981;2595;155355;94944;50.1;30.6
10;2021-06-20;549;1597;155904;96541;50.3;31.2
10;2021-06-21;684;1045;156588;97586;50.5;31.5
10;2021-06-22;745;1526;157333;99112;50.8;32.0
10;2021-06-23;653;2406;157986;101518;51.0;32.8
10;2021-06-24;790;2617;158776;104135;51.2;33.6
10;2021-06-25;730;3047;159506;107182;51.5;34.6
10;2021-06-26;514;2746;160020;109928;51.6;35.5
10;2021-06-27;402;1940;160422;111868;51.8;36.1
10;2021-06-28;683;1784;161105;113652;52.0;36.7
10;2021-06-29;616;2698;161721;116350;52.2;37.5
10;2021-06-30;534;1524;162255;117874;52.4;38.0
10;2021-07-01;555;2172;162810;120046;52.5;38.7
10;2021-07-02;664;2726;163474;122772;52.7;39.6
10;2021-07-03;529;2600;164003;125372;52.9;40.5
10;2021-07-04;411;1726;164414;127098;53.1;41.0
10;2021-07-05;667;2224;165081;129322;53.3;41.7
10;2021-07-06;651;2188;165732;131510;53.5;42.4
10;2021-07-07;639;1703;166371;133213;53.7;43.0
10;2021-07-08;751;1459;167122;134672;53.9;43.5
10;2021-07-09;820;1949;167942;136621;54.2;44.1
10;2021-07-10;632;2096;168574;138717;54.4;44.8
10;2021-07-11;500;1384;169074;140101;54.6;45.2
10;2021-07-12;783;1624;169857;141725;54.8;45.7
10;2021-07-13;1126;1874;170983;143599;55.2;46.3
10;2021-07-14;1169;1054;172152;144653;55.5;46.7
10;2021-07-15;1477;1980;173629;146633;56.0;47.3
10;2021-07-16;1241;2276;174870;148909;56.4;48.0
10;2021-07-17;1287;1738;176157;150647;56.8;48.6
10;2021-07-18;942;1225;177099;151872;57.1;49.0
10;2021-07-19;1361;1622;178460;153494;57.6;49.5
10;2021-07-20;1685;1433;180145;154927;58.1;50.0
10;2021-07-21;1395;1485;181540;156412;58.6;50.5
10;2021-07-22;1941;1598;183481;158010;59.2;51.0
10;2021-07-23;1606;1544;185087;159554;59.7;51.5
10;2021-07-24;1389;1228;186476;160782;60.2;51.9
10;2021-07-25;1251;789;187727;161571;60.6;52.1
10;2021-07-26;1914;1318;189641;162889;61.2;52.6
10;2021-07-27;2139;1071;191780;163960;61.9;52.9
10;2021-07-28;2094;1018;193874;164978;62.6;53.2
10;2021-07-29;2444;1204;196318;166182;63.3;53.6
10;2021-07-30;2176;1311;198494;167493;64.0;54.0
10;2021-07-31;1680;938;200174;168431;64.6;54.3
10;2021-08-01;1236;570;201410;169001;65.0;54.5
10;2021-08-02;1463;1337;202873;170338;65.5;55.0
10;2021-08-03;1635;897;204508;171235;66.0;55.3
10;2021-08-04;1370;1068;205878;172303;66.4;55.6
10;2021-08-05;1654;1345;207532;173648;67.0;56.0
10;2021-08-06;1835;1333;209367;174981;67.6;56.5
10;2021-08-07;1156;1133;210523;176114;67.9;56.8
10;2021-08-08;660;751;211183;176865;68.1;57.1
10;2021-08-09;1311;1542;212494;178407;68.6;57.6
10;2021-08-10;1670;1353;214164;179760;69.1;58.0
10;2021-08-11;854;1108;215018;180868;69.4;58.4
10;2021-08-12;1055;1225;216073;182093;69.7;58.8
10;2021-08-13;739;1075;216812;183168;70.0;59.1
10;2021-08-14;587;1235;217399;184403;70.1;59.5
10;2021-08-15;317;781;217716;185184;70.3;59.8
10;2021-08-16;725;1618;218441;186802;70.5;60.3
10;2021-08-17;877;1776;219318;188578;70.8;60.8
10;2021-08-18;723;1620;220041;190198;71.0;61.4
10;2021-08-19;551;1571;220592;191769;71.2;61.9
10;2021-08-20;644;1733;221236;193502;71.4;62.4
10;2021-08-21;452;1419;221688;194921;71.5;62.9
10;2021-08-22;189;1061;221877;195982;71.6;63.2
10;2021-08-23;481;1562;222358;197544;71.7;63.7
10;2021-08-24;669;1771;223027;199315;72.0;64.3
10;2021-08-25;460;1381;223487;200696;72.1;64.8
10;2021-08-26;432;1486;223919;202182;72.3;65.2
10;2021-08-27;626;1588;224545;203770;72.5;65.8
10;2021-08-28;396;1333;224941;205103;72.6;66.2
10;2021-08-29;225;946;225166;206049;72.7;66.5
10;2021-08-30;433;1376;225599;207425;72.8;66.9
10;2021-08-31;470;1426;226069;208851;72.9;67.4
10;2021-09-01;298;1104;226367;209955;73.0;67.7
10;2021-09-02;273;972;226640;210927;73.1;68.1
10;2021-09-03;404;1062;227044;211989;73.3;68.4
10;2021-09-04;342;1014;227386;213003;73.4;68.7
10;2021-09-05;174;409;227560;213412;73.4;68.9
10;2021-09-06;272;595;227832;214007;73.5;69.1
10;2021-09-07;303;601;228135;214608;73.6;69.2
10;2021-09-08;255;607;228390;215215;73.7;69.4
10;2021-09-09;333;720;228723;215935;73.8;69.7
10;2021-09-10;433;762;229156;216697;73.9;69.9
10;2021-09-11;264;634;229420;217331;74.0;70.1
10;2021-09-12;93;210;229513;217541;74.1;70.2
10;2021-09-13;226;473;229739;218014;74.1;70.3
10;2021-09-14;249;597;229988;218611;74.2;70.5
10;2021-09-15;237;637;230225;219248;74.3;70.7
10;2021-09-16;281;598;230506;219846;74.4;70.9
10;2021-09-17;270;859;230776;220705;74.5;71.2
10;2021-09-18;197;611;230973;221316;74.5;71.4
10;2021-09-19;62;224;231035;221540;74.5;71.5
10;2021-09-20;138;627;231173;222167;74.6;71.7
10;2021-09-21;151;554;231324;222721;74.6;71.9
10;2021-09-22;132;305;231456;223026;74.7;72.0
10;2021-09-23;215;353;231671;223379;74.8;72.1
10;2021-09-24;211;547;231882;223926;74.8;72.3
10;2021-09-25;112;420;231994;224346;74.9;72.4
10;2021-09-26;58;215;232052;224561;74.9;72.5
10;2021-09-27;221;268;232273;224829;74.9;72.5
10;2021-09-28;204;362;232477;225191;75.0;72.7
10;2021-09-29;190;292;232667;225483;75.1;72.8
10;2021-09-30;157;221;232824;225704;75.1;72.8
10;2021-10-01;202;447;233026;226151;75.2;73.0
10;2021-10-02;145;285;233171;226436;75.2;73.1
10;2021-10-03;58;128;233229;226564;75.3;73.1
10;2021-10-04;98;194;233327;226758;75.3;73.2
10;2021-10-05;107;216;233434;226974;75.3;73.2
10;2021-10-06;136;225;233570;227199;75.4;73.3
10;2021-10-07;138;319;233708;227518;75.4;73.4
10;2021-10-08;184;286;233892;227804;75.5;73.5
10;2021-10-09;123;247;234015;228051;75.5;73.6
10;2021-10-10;53;87;234068;228138;75.5;73.6
10;2021-10-11;113;191;234181;228329;75.6;73.7
10;2021-10-12;110;190;234291;228519;75.6;73.7
10;2021-10-13;119;180;234410;228699;75.6;73.8
10;2021-10-14;113;223;234523;228922;75.7;73.9
11;2020-12-27;0;0;0;0;0.0;0.0
11;2020-12-28;1;0;1;0;0.0;0.0
11;2020-12-29;1;0;2;0;0.0;0.0
11;2020-12-30;0;0;2;0;0.0;0.0
11;2020-12-31;0;0;2;0;0.0;0.0
11;2021-01-01;0;0;2;0;0.0;0.0
11;2021-01-02;4;0;6;0;0.0;0.0
11;2021-01-03;0;0;6;0;0.0;0.0
11;2021-01-04;1;0;7;0;0.0;0.0
11;2021-01-05;95;0;102;0;0.0;0.0
11;2021-01-06;26;0;128;0;0.0;0.0
11;2021-01-07;119;0;247;0;0.1;0.0
11;2021-01-08;91;1;338;1;0.1;0.0
11;2021-01-09;86;0;424;1;0.1;0.0
11;2021-01-10;67;0;491;1;0.1;0.0
11;2021-01-11;136;0;627;1;0.2;0.0
11;2021-01-12;545;3;1172;4;0.3;0.0
11;2021-01-13;409;1;1581;5;0.4;0.0
11;2021-01-14;647;10;2228;15;0.6;0.0
11;2021-01-15;342;3;2570;18;0.7;0.0
11;2021-01-16;77;1;2647;19;0.7;0.0
11;2021-01-17;47;2;2694;21;0.7;0.0
11;2021-01-18;388;0;3082;21;0.8;0.0
11;2021-01-19;540;12;3622;33;1.0;0.0
11;2021-01-20;693;7;4315;40;1.2;0.0
11;2021-01-21;650;7;4965;47;1.3;0.0
11;2021-01-22;526;2;5491;49;1.5;0.0
11;2021-01-23;165;1;5656;50;1.5;0.0
11;2021-01-24;139;0;5795;50;1.6;0.0
11;2021-01-25;377;19;6172;69;1.7;0.0
11;2021-01-26;852;85;7024;154;1.9;0.0
11;2021-01-27;804;27;7828;181;2.1;0.0
11;2021-01-28;652;61;8480;242;2.3;0.1
11;2021-01-29;442;123;8922;365;2.4;0.1
11;2021-01-30;138;4;9060;369;2.4;0.1
11;2021-01-31;83;0;9143;369;2.5;0.1
11;2021-02-01;344;197;9487;566;2.5;0.2
11;2021-02-02;412;407;9899;973;2.7;0.3
11;2021-02-03;392;352;10291;1325;2.8;0.4
11;2021-02-04;376;499;10667;1824;2.9;0.5
11;2021-02-05;322;336;10989;2160;2.9;0.6
11;2021-02-06;211;65;11200;2225;3.0;0.6
11;2021-02-07;109;14;11309;2239;3.0;0.6
11;2021-02-08;317;160;11626;2399;3.1;0.6
11;2021-02-09;300;280;11926;2679;3.2;0.7
11;2021-02-10;344;446;12270;3125;3.3;0.8
11;2021-02-11;609;631;12879;3756;3.5;1.0
11;2021-02-12;407;380;13286;4136;3.6;1.1
11;2021-02-13;197;118;13483;4254;3.6;1.1
11;2021-02-14;73;26;13556;4280;3.6;1.1
11;2021-02-15;241;209;13797;4489;3.7;1.2
11;2021-02-16;264;509;14061;4998;3.8;1.3
11;2021-02-17;454;620;14515;5618;3.9;1.5
11;2021-02-18;456;571;14971;6189;4.0;1.7
11;2021-02-19;300;535;15271;6724;4.1;1.8
11;2021-02-20;148;75;15419;6799;4.1;1.8
11;2021-02-21;59;46;15478;6845;4.2;1.8
11;2021-02-22;124;328;15602;7173;4.2;1.9
11;2021-02-23;283;318;15885;7491;4.3;2.0
11;2021-02-24;252;366;16137;7857;4.3;2.1
11;2021-02-25;563;332;16700;8189;4.5;2.2
11;2021-02-26;524;315;17224;8504;4.6;2.3
11;2021-02-27;319;100;17543;8604;4.7;2.3
11;2021-02-28;95;24;17638;8628;4.7;2.3
11;2021-03-01;339;315;17977;8943;4.8;2.4
11;2021-03-02;563;390;18540;9333;5.0;2.5
11;2021-03-03;601;432;19141;9765;5.1;2.6
11;2021-03-04;1078;410;20219;10175;5.4;2.7
11;2021-03-05;1002;412;21221;10587;5.7;2.8
11;2021-03-06;1096;207;22317;10794;6.0;2.9
11;2021-03-07;658;33;22975;10827;6.2;2.9
11;2021-03-08;367;353;23342;11180;6.3;3.0
11;2021-03-09;999;401;24341;11581;6.5;3.1
11;2021-03-10;1175;545;25516;12126;6.8;3.3
11;2021-03-11;1572;450;27088;12576;7.3;3.4
11;2021-03-12;1457;445;28545;13021;7.7;3.5
11;2021-03-13;1160;240;29705;13261;8.0;3.6
11;2021-03-14;523;54;30228;13315;8.1;3.6
11;2021-03-15;651;241;30879;13556;8.3;3.6
11;2021-03-16;854;201;31733;13757;8.5;3.7
11;2021-03-17;907;221;32640;13978;8.8;3.8
11;2021-03-18;1172;287;33812;14265;9.1;3.8
11;2021-03-19;1372;248;35184;14513;9.4;3.9
11;2021-03-20;790;176;35974;14689;9.7;3.9
11;2021-03-21;225;68;36199;14757;9.7;4.0
11;2021-03-22;809;221;37008;14978;9.9;4.0
11;2021-03-23;1807;393;38815;15371;10.4;4.1
11;2021-03-24;1847;322;40662;15693;10.9;4.2
11;2021-03-25;2190;375;42852;16068;11.5;4.3
11;2021-03-26;2125;450;44977;16518;12.1;4.4
11;2021-03-27;1178;147;46155;16665;12.4;4.5
11;2021-03-28;265;44;46420;16709;12.5;4.5
11;2021-03-29;1182;224;47602;16933;12.8;4.5
11;2021-03-30;1996;329;49598;17262;13.3;4.6
11;2021-03-31;1614;386;51212;17648;13.7;4.7
11;2021-04-01;2145;430;53357;18078;14.3;4.9
11;2021-04-02;1642;429;54999;18507;14.8;5.0
11;2021-04-03;720;146;55719;18653;14.9;5.0
11;2021-04-04;198;76;55917;18729;15.0;5.0
11;2021-04-05;257;4;56174;18733;15.1;5.0
11;2021-04-06;1574;555;57748;19288;15.5;5.2
11;2021-04-07;1778;576;59526;19864;16.0;5.3
11;2021-04-08;1785;686;61311;20550;16.5;5.5
11;2021-04-09;2261;608;63572;21158;17.1;5.7
11;2021-04-10;1168;181;64740;21339;17.4;5.7
11;2021-04-11;551;106;65291;21445;17.5;5.8
11;2021-04-12;1614;545;66905;21990;18.0;5.9
11;2021-04-13;2262;890;69167;22880;18.6;6.1
11;2021-04-14;1661;1020;70828;23900;19.0;6.4
11;2021-04-15;1843;1134;72671;25034;19.5;6.7
11;2021-04-16;1838;851;74509;25885;20.0;6.9
11;2021-04-17;1772;564;76281;26449;20.5;7.1
11;2021-04-18;114;155;76395;26604;20.5;7.1
11;2021-04-19;1384;739;77779;27343;20.9;7.3
11;2021-04-20;1729;1284;79508;28627;21.3;7.7
11;2021-04-21;1780;1323;81288;29950;21.8;8.0
11;2021-04-22;1749;1326;83037;31276;22.3;8.4
11;2021-04-23;2014;1239;85051;32515;22.8;8.7
11;2021-04-24;1735;469;86786;32984;23.3;8.8
11;2021-04-25;659;183;87445;33167;23.5;8.9
11;2021-04-26;1380;839;88825;34006;23.8;9.1
11;2021-04-27;1839;1556;90664;35562;24.3;9.5
11;2021-04-28;2008;1470;92672;37032;24.9;9.9
11;2021-04-29;2247;1642;94919;38674;25.5;10.4
11;2021-04-30;2158;1427;97077;40101;26.0;10.8
11;2021-05-01;1338;345;98415;40446;26.4;10.9
11;2021-05-02;588;336;99003;40782;26.6;10.9
11;2021-05-03;1487;739;100490;41521;27.0;11.1
11;2021-05-04;1878;1431;102368;42952;27.5;11.5
11;2021-05-05;1896;1441;104264;44393;28.0;11.9
11;2021-05-06;2191;1475;106455;45868;28.6;12.3
11;2021-05-07;2105;1560;108560;47428;29.1;12.7
11;2021-05-08;898;728;109458;48156;29.4;12.9
11;2021-05-09;628;543;110086;48699;29.5;13.1
11;2021-05-10;1327;1652;111413;50351;29.9;13.5
11;2021-05-11;2041;1874;113454;52225;30.4;14.0
11;2021-05-12;1848;1653;115302;53878;30.9;14.5
11;2021-05-13;1405;414;116707;54292;31.3;14.6
11;2021-05-14;1718;1184;118425;55476;31.8;14.9
11;2021-05-15;1158;897;119583;56373;32.1;15.1
11;2021-05-16;808;164;120391;56537;32.3;15.2
11;2021-05-17;1470;1046;121861;57583;32.7;15.5
11;2021-05-18;1898;1192;123759;58775;33.2;15.8
11;2021-05-19;1846;1124;125605;59899;33.7;16.1
11;2021-05-20;1971;1091;127576;60990;34.2;16.4
11;2021-05-21;2276;1093;129852;62083;34.8;16.7
11;2021-05-22;1485;727;131337;62810;35.2;16.9
11;2021-05-23;768;72;132105;62882;35.4;16.9
11;2021-05-24;1411;224;133516;63106;35.8;16.9
11;2021-05-25;1811;1353;135327;64459;36.3;17.3
11;2021-05-26;1934;1299;137261;65758;36.8;17.6
11;2021-05-27;1989;1722;139250;67480;37.4;18.1
11;2021-05-28;1754;1901;141004;69381;37.8;18.6
11;2021-05-29;1428;1601;142432;70982;38.2;19.0
11;2021-05-30;486;395;142918;71377;38.3;19.2
11;2021-05-31;1261;1616;144179;72993;38.7;19.6
11;2021-06-01;1856;1903;146035;74896;39.2;20.1
11;2021-06-02;1761;2068;147796;76964;39.7;20.7
11;2021-06-03;2598;2409;150394;79373;40.4;21.3
11;2021-06-04;2147;2668;152541;82041;40.9;22.0
11;2021-06-05;1588;1903;154129;83944;41.4;22.5
11;2021-06-06;877;857;155006;84801;41.6;22.8
11;2021-06-07;1527;1709;156533;86510;42.0;23.2
11;2021-06-08;2042;1996;158575;88506;42.5;23.7
11;2021-06-09;1786;2184;160361;90690;43.0;24.3
11;2021-06-10;1806;2427;162167;93117;43.5;25.0
11;2021-06-11;1864;2495;164031;95612;44.0;25.7
11;2021-06-12;1455;1624;165486;97236;44.4;26.1
11;2021-06-13;713;723;166199;97959;44.6;26.3
11;2021-06-14;1032;1968;167231;99927;44.9;26.8
11;2021-06-15;1395;2685;168626;102612;45.2;27.5
11;2021-06-16;1335;2528;169961;105140;45.6;28.2
11;2021-06-17;1474;2522;171435;107662;46.0;28.9
11;2021-06-18;1518;2487;172953;110149;46.4;29.6
11;2021-06-19;1236;1410;174189;111559;46.7;29.9
11;2021-06-20;299;599;174488;112158;46.8;30.1
11;2021-06-21;838;2122;175326;114280;47.0;30.7
11;2021-06-22;1016;2606;176342;116886;47.3;31.4
11;2021-06-23;1094;2089;177436;118975;47.6;31.9
11;2021-06-24;909;2244;178345;121219;47.9;32.5
11;2021-06-25;993;2547;179338;123766;48.1;33.2
11;2021-06-26;773;1655;180111;125421;48.3;33.7
11;2021-06-27;210;688;180321;126109;48.4;33.8
11;2021-06-28;697;2297;181018;128406;48.6;34.5
11;2021-06-29;963;2603;181981;131009;48.8;35.2
11;2021-06-30;906;2520;182887;133529;49.1;35.8
11;2021-07-01;1004;1889;183891;135418;49.3;36.3
11;2021-07-02;966;2540;184857;137958;49.6;37.0
11;2021-07-03;729;1807;185586;139765;49.8;37.5
11;2021-07-04;340;1109;185926;140874;49.9;37.8
11;2021-07-05;695;2132;186621;143006;50.1;38.4
11;2021-07-06;972;2521;187593;145527;50.3;39.0
11;2021-07-07;946;2512;188539;148039;50.6;39.7
11;2021-07-08;1191;1911;189730;149950;50.9;40.2
11;2021-07-09;824;1796;190554;151746;51.1;40.7
11;2021-07-10;369;1302;190923;153048;51.2;41.1
11;2021-07-11;313;564;191236;153612;51.3;41.2
11;2021-07-12;505;2672;191741;156284;51.4;41.9
11;2021-07-13;1304;3064;193045;159348;51.8;42.8
11;2021-07-14;210;233;193255;159581;51.9;42.8
11;2021-07-15;1451;2961;194706;162542;52.2;43.6
11;2021-07-16;1876;2734;196582;165276;52.7;44.3
11;2021-07-17;1075;2166;197657;167442;53.0;44.9
11;2021-07-18;652;946;198309;168388;53.2;45.2
11;2021-07-19;1355;2089;199664;170477;53.6;45.7
11;2021-07-20;1998;2403;201662;172880;54.1;46.4
11;2021-07-21;2015;2441;203677;175321;54.6;47.0
11;2021-07-22;2414;1884;206091;177205;55.3;47.5
11;2021-07-23;2232;2283;208323;179488;55.9;48.2
11;2021-07-24;1274;1629;209597;181117;56.2;48.6
11;2021-07-25;749;693;210346;181810;56.4;48.8
11;2021-07-26;1667;1427;212013;183237;56.9;49.2
11;2021-07-27;2340;1999;214353;185236;57.5;49.7
11;2021-07-28;2480;1991;216833;187227;58.2;50.2
11;2021-07-29;2771;1795;219604;189022;58.9;50.7
11;2021-07-30;2575;1803;222179;190825;59.6;51.2
11;2021-07-31;2008;1143;224187;191968;60.2;51.5
11;2021-08-01;1011;482;225198;192450;60.4;51.6
11;2021-08-02;1929;1151;227127;193601;60.9;51.9
11;2021-08-03;2443;1602;229570;195203;61.6;52.4
11;2021-08-04;2560;1270;232130;196473;62.3;52.7
11;2021-08-05;2382;1334;234512;197807;62.9;53.1
11;2021-08-06;2252;1661;236764;199468;63.5;53.5
11;2021-08-07;1665;1172;238429;200640;64.0;53.8
11;2021-08-08;599;210;239028;200850;64.1;53.9
11;2021-08-09;1033;1434;240061;202284;64.4;54.3
11;2021-08-10;1747;1987;241808;204271;64.9;54.8
11;2021-08-11;1717;1689;243525;205960;65.3;55.3
11;2021-08-12;1716;1858;245241;207818;65.8;55.8
11;2021-08-13;1348;1655;246589;209473;66.2;56.2
11;2021-08-14;984;1596;247573;211069;66.4;56.6
11;2021-08-15;138;125;247711;211194;66.5;56.7
11;2021-08-16;731;1914;248442;213108;66.7;57.2
11;2021-08-17;1046;2391;249488;215499;66.9;57.8
11;2021-08-18;1108;2032;250596;217531;67.2;58.4
11;2021-08-19;1006;2291;251602;219822;67.5;59.0
11;2021-08-20;976;2291;252578;222113;67.8;59.6
11;2021-08-21;576;1838;253154;223951;67.9;60.1
11;2021-08-22;192;512;253346;224463;68.0;60.2
11;2021-08-23;522;1816;253868;226279;68.1;60.7
11;2021-08-24;799;2255;254667;228534;68.3;61.3
11;2021-08-25;796;2158;255463;230692;68.5;61.9
11;2021-08-26;759;2001;256222;232693;68.7;62.4
11;2021-08-27;701;2223;256923;234916;68.9;63.0
11;2021-08-28;437;1745;257360;236661;69.1;63.5
11;2021-08-29;143;514;257503;237175;69.1;63.6
11;2021-08-30;455;1322;257958;238497;69.2;64.0
11;2021-08-31;585;1866;258543;240363;69.4;64.5
11;2021-09-01;608;1716;259151;242079;69.5;65.0
11;2021-09-02;557;1557;259708;243636;69.7;65.4
11;2021-09-03;538;1549;260246;245185;69.8;65.8
11;2021-09-04;489;1483;260735;246668;70.0;66.2
11;2021-09-05;153;237;260888;246905;70.0;66.2
11;2021-09-06;299;673;261187;247578;70.1;66.4
11;2021-09-07;357;895;261544;248473;70.2;66.7
11;2021-09-08;478;1156;262022;249629;70.3;67.0
11;2021-09-09;394;863;262416;250492;70.4;67.2
11;2021-09-10;381;990;262797;251482;70.5;67.5
11;2021-09-11;378;985;263175;252467;70.6;67.7
11;2021-09-12;61;127;263236;252594;70.6;67.8
11;2021-09-13;239;731;263475;253325;70.7;68.0
11;2021-09-14;363;623;263838;253948;70.8;68.1
11;2021-09-15;360;973;264198;254921;70.9;68.4
11;2021-09-16;307;585;264505;255506;71.0;68.6
11;2021-09-17;313;682;264818;256188;71.1;68.7
11;2021-09-18;269;731;265087;256919;71.1;68.9
11;2021-09-19;59;123;265146;257042;71.1;69.0
11;2021-09-20;166;333;265312;257375;71.2;69.1
11;2021-09-21;289;417;265601;257792;71.3;69.2
11;2021-09-22;229;769;265830;258561;71.3;69.4
11;2021-09-23;179;398;266009;258959;71.4;69.5
11;2021-09-24;275;519;266284;259478;71.4;69.6
11;2021-09-25;236;674;266520;260152;71.5;69.8
11;2021-09-26;35;131;266555;260283;71.5;69.8
11;2021-09-27;105;385;266660;260668;71.5;69.9
11;2021-09-28;213;355;266873;261023;71.6;70.0
11;2021-09-29;221;537;267094;261560;71.7;70.2
11;2021-09-30;194;360;267288;261920;71.7;70.3
11;2021-10-01;226;389;267514;262309;71.8;70.4
11;2021-10-02;232;447;267746;262756;71.8;70.5
11;2021-10-03;2;1;267748;262757;71.8;70.5
11;2021-10-04;138;295;267886;263052;71.9;70.6
11;2021-10-05;177;322;268063;263374;71.9;70.7
11;2021-10-06;261;447;268324;263821;72.0;70.8
11;2021-10-07;168;290;268492;264111;72.0;70.9
11;2021-10-08;211;420;268703;264531;72.1;71.0
11;2021-10-09;147;365;268850;264896;72.1;71.1
11;2021-10-10;0;1;268850;264897;72.1;71.1
11;2021-10-11;130;250;268980;265147;72.2;71.1
11;2021-10-12;151;314;269131;265461;72.2;71.2
11;2021-10-13;232;289;269363;265750;72.3;71.3
11;2021-10-14;182;244;269545;265994;72.3;71.4
12;2020-12-27;0;0;0;0;0.0;0.0
12;2020-12-28;0;0;0;0;0.0;0.0
12;2020-12-29;0;0;0;0;0.0;0.0
12;2020-12-30;0;0;0;0;0.0;0.0
12;2020-12-31;0;0;0;0;0.0;0.0
12;2021-01-01;0;0;0;0;0.0;0.0
12;2021-01-02;0;0;0;0;0.0;0.0
12;2021-01-03;2;0;2;0;0.0;0.0
12;2021-01-04;1;0;3;0;0.0;0.0
12;2021-01-05;1;0;4;0;0.0;0.0
12;2021-01-06;12;0;16;0;0.0;0.0
12;2021-01-07;202;0;218;0;0.1;0.0
12;2021-01-08;65;0;283;0;0.1;0.0
12;2021-01-09;0;0;283;0;0.1;0.0
12;2021-01-10;1;0;284;0;0.1;0.0
12;2021-01-11;100;0;384;0;0.1;0.0
12;2021-01-12;361;2;745;2;0.3;0.0
12;2021-01-13;285;0;1030;2;0.4;0.0
12;2021-01-14;602;12;1632;14;0.6;0.0
12;2021-01-15;367;10;1999;24;0.7;0.0
12;2021-01-16;138;2;2137;26;0.8;0.0
12;2021-01-17;1;0;2138;26;0.8;0.0
12;2021-01-18;452;0;2590;26;0.9;0.0
12;2021-01-19;611;4;3201;30;1.1;0.0
12;2021-01-20;879;5;4080;35;1.5;0.0
12;2021-01-21;736;0;4816;35;1.7;0.0
12;2021-01-22;799;1;5615;36;2.0;0.0
12;2021-01-23;382;0;5997;36;2.2;0.0
12;2021-01-24;0;0;5997;36;2.2;0.0
12;2021-01-25;453;0;6450;36;2.3;0.0
12;2021-01-26;650;0;7100;36;2.6;0.0
12;2021-01-27;1887;40;8987;76;3.2;0.0
12;2021-01-28;1886;232;10873;308;3.9;0.1
12;2021-01-29;1331;46;12204;354;4.4;0.1
12;2021-01-30;359;2;12563;356;4.5;0.1
12;2021-01-31;0;0;12563;356;4.5;0.1
12;2021-02-01;335;89;12898;445;4.6;0.2
12;2021-02-02;459;241;13357;686;4.8;0.2
12;2021-02-03;459;168;13816;854;5.0;0.3
12;2021-02-04;459;526;14275;1380;5.1;0.5
12;2021-02-05;449;183;14724;1563;5.3;0.6
12;2021-02-06;220;66;14944;1629;5.4;0.6
12;2021-02-07;8;0;14952;1629;5.4;0.6
12;2021-02-08;104;313;15056;1942;5.4;0.7
12;2021-02-09;209;341;15265;2283;5.5;0.8
12;2021-02-10;468;475;15733;2758;5.7;1.0
12;2021-02-11;539;344;16272;3102;5.8;1.1
12;2021-02-12;570;345;16842;3447;6.1;1.2
12;2021-02-13;175;132;17017;3579;6.1;1.3
12;2021-02-14;1;0;17018;3579;6.1;1.3
12;2021-02-15;175;374;17193;3953;6.2;1.4
12;2021-02-16;171;509;17364;4462;6.2;1.6
12;2021-02-17;366;1431;17730;5893;6.4;2.1
12;2021-02-18;678;1662;18408;7555;6.6;2.7
12;2021-02-19;594;974;19002;8529;6.8;3.1
12;2021-02-20;103;392;19105;8921;6.9;3.2
12;2021-02-21;0;0;19105;8921;6.9;3.2
12;2021-02-22;150;398;19255;9319;6.9;3.3
12;2021-02-23;157;558;19412;9877;7.0;3.5
12;2021-02-24;156;685;19568;10562;7.0;3.8
12;2021-02-25;201;769;19769;11331;7.1;4.1
12;2021-02-26;320;650;20089;11981;7.2;4.3
12;2021-02-27;191;350;20280;12331;7.3;4.4
12;2021-02-28;13;0;20293;12331;7.3;4.4
12;2021-03-01;50;349;20343;12680;7.3;4.6
12;2021-03-02;190;507;20533;13187;7.4;4.7
12;2021-03-03;245;388;20778;13575;7.5;4.9
12;2021-03-04;278;363;21056;13938;7.6;5.0
12;2021-03-05;421;370;21477;14308;7.7;5.1
12;2021-03-06;793;129;22270;14437;8.0;5.2
12;2021-03-07;140;33;22410;14470;8.1;5.2
12;2021-03-08;234;208;22644;14678;8.1;5.3
12;2021-03-09;716;234;23360;14912;8.4;5.4
12;2021-03-10;785;744;24145;15656;8.7;5.6
12;2021-03-11;919;663;25064;16319;9.0;5.9
12;2021-03-12;1259;530;26323;16849;9.5;6.1
12;2021-03-13;896;140;27219;16989;9.8;6.1
12;2021-03-14;45;2;27264;16991;9.8;6.1
12;2021-03-15;559;157;27823;17148;10.0;6.2
12;2021-03-16;818;162;28641;17310;10.3;6.2
12;2021-03-17;1504;167;30145;17477;10.8;6.3
12;2021-03-18;997;255;31142;17732;11.2;6.4
12;2021-03-19;1383;283;32525;18015;11.7;6.5
12;2021-03-20;725;82;33250;18097;11.9;6.5
12;2021-03-21;264;10;33514;18107;12.0;6.5
12;2021-03-22;606;175;34120;18282;12.3;6.6
12;2021-03-23;1214;178;35334;18460;12.7;6.6
12;2021-03-24;1422;210;36756;18670;13.2;6.7
12;2021-03-25;1843;206;38599;18876;13.9;6.8
12;2021-03-26;1978;233;40577;19109;14.6;6.9
12;2021-03-27;981;68;41558;19177;14.9;6.9
12;2021-03-28;60;1;41618;19178;15.0;6.9
12;2021-03-29;963;85;42581;19263;15.3;6.9
12;2021-03-30;1737;125;44318;19388;15.9;7.0
12;2021-03-31;1460;107;45778;19495;16.4;7.0
12;2021-04-01;1957;167;47735;19662;17.1;7.1
12;2021-04-02;1613;346;49348;20008;17.7;7.2
12;2021-04-03;882;96;50230;20104;18.0;7.2
12;2021-04-04;1;0;50231;20104;18.0;7.2
12;2021-04-05;645;15;50876;20119;18.3;7.2
12;2021-04-06;1151;538;52027;20657;18.7;7.4
12;2021-04-07;1652;645;53679;21302;19.3;7.7
12;2021-04-08;2098;575;55777;21877;20.0;7.9
12;2021-04-09;2112;657;57889;22534;20.8;8.1
12;2021-04-10;1427;222;59316;22756;21.3;8.2
12;2021-04-11;120;1;59436;22757;21.4;8.2
12;2021-04-12;1836;506;61272;23263;22.0;8.4
12;2021-04-13;1907;780;63179;24043;22.7;8.6
12;2021-04-14;1832;1322;65011;25365;23.4;9.1
12;2021-04-15;1937;901;66948;26266;24.1;9.4
12;2021-04-16;1675;1205;68623;27471;24.7;9.9
12;2021-04-17;1553;568;70176;28039;25.2;10.1
12;2021-04-18;0;0;70176;28039;25.2;10.1
12;2021-04-19;1687;550;71863;28589;25.8;10.3
12;2021-04-20;1546;986;73409;29575;26.4;10.6
12;2021-04-21;1693;1183;75102;30758;27.0;11.0
12;2021-04-22;1689;1097;76791;31855;27.6;11.4
12;2021-04-23;1382;1335;78173;33190;28.1;11.9
12;2021-04-24;1450;720;79623;33910;28.6;12.2
12;2021-04-25;60;0;79683;33910;28.6;12.2
12;2021-04-26;1459;898;81142;34808;29.2;12.5
12;2021-04-27;1321;1281;82463;36089;29.6;13.0
12;2021-04-28;1113;1870;83576;37959;30.0;13.6
12;2021-04-29;1571;1911;85147;39870;30.6;14.3
12;2021-04-30;1815;1839;86962;41709;31.2;15.0
12;2021-05-01;1617;261;88579;41970;31.8;15.1
12;2021-05-02;9;0;88588;41970;31.8;15.1
12;2021-05-03;1713;1252;90301;43222;32.4;15.5
12;2021-05-04;1482;1396;91783;44618;33.0;16.0
12;2021-05-05;1296;1677;93079;46295;33.4;16.6
12;2021-05-06;1753;1379;94832;47674;34.1;17.1
12;2021-05-07;1483;1780;96315;49454;34.6;17.8
12;2021-05-08;1330;461;97645;49915;35.1;17.9
12;2021-05-09;13;34;97658;49949;35.1;17.9
12;2021-05-10;829;2216;98487;52165;35.4;18.7
12;2021-05-11;928;1851;99415;54016;35.7;19.4
12;2021-05-12;948;1820;100363;55836;36.1;20.1
12;2021-05-13;1587;811;101950;56647;36.6;20.4
12;2021-05-14;1235;1534;103185;58181;37.1;20.9
12;2021-05-15;1067;1115;104252;59296;37.5;21.3
12;2021-05-16;2;19;104254;59315;37.5;21.3
12;2021-05-17;1082;1810;105336;61125;37.8;22.0
12;2021-05-18;1427;1535;106763;62660;38.4;22.5
12;2021-05-19;1915;1330;108678;63990;39.0;23.0
12;2021-05-20;2118;876;110796;64866;39.8;23.3
12;2021-05-21;1821;1253;112617;66119;40.5;23.8
12;2021-05-22;1207;1016;113824;67135;40.9;24.1
12;2021-05-23;7;12;113831;67147;40.9;24.1
12;2021-05-24;1956;538;115787;67685;41.6;24.3
12;2021-05-25;1742;1159;117529;68844;42.2;24.7
12;2021-05-26;1998;780;119527;69624;42.9;25.0
12;2021-05-27;2165;744;121692;70368;43.7;25.3
12;2021-05-28;1927;1031;123619;71399;44.4;25.6
12;2021-05-29;1637;805;125256;72204;45.0;25.9
12;2021-05-30;9;43;125265;72247;45.0;26.0
12;2021-05-31;1699;817;126964;73064;45.6;26.2
12;2021-06-01;1887;1028;128851;74092;46.3;26.6
12;2021-06-02;1979;1051;130830;75143;47.0;27.0
12;2021-06-03;2123;831;132953;75974;47.8;27.3
12;2021-06-04;1967;1418;134920;77392;48.5;27.8
12;2021-06-05;1738;985;136658;78377;49.1;28.2
12;2021-06-06;6;6;136664;78383;49.1;28.2
12;2021-06-07;1092;1811;137756;80194;49.5;28.8
12;2021-06-08;1332;1201;139088;81395;50.0;29.2
12;2021-06-09;895;1294;139983;82689;50.3;29.7
12;2021-06-10;1022;921;141005;83610;50.7;30.0
12;2021-06-11;1204;2081;142209;85691;51.1;30.8
12;2021-06-12;1033;1322;143242;87013;51.5;31.3
12;2021-06-13;6;47;143248;87060;51.5;31.3
12;2021-06-14;662;1830;143910;88890;51.7;31.9
12;2021-06-15;745;1885;144655;90775;52.0;32.6
12;2021-06-16;820;1818;145475;92593;52.3;33.3
12;2021-06-17;678;995;146153;93588;52.5;33.6
12;2021-06-18;1134;1840;147287;95428;52.9;34.3
12;2021-06-19;914;1406;148201;96834;53.2;34.8
12;2021-06-20;4;10;148205;96844;53.2;34.8
12;2021-06-21;511;1737;148716;98581;53.4;35.4
12;2021-06-22;502;1474;149218;100055;53.6;35.9
12;2021-06-23;579;1306;149797;101361;53.8;36.4
12;2021-06-24;249;545;150046;101906;53.9;36.6
12;2021-06-25;876;1842;150922;103748;54.2;37.3
12;2021-06-26;673;1527;151595;105275;54.5;37.8
12;2021-06-27;1;9;151596;105284;54.5;37.8
12;2021-06-28;467;2454;152063;107738;54.6;38.7
12;2021-06-29;565;1958;152628;109696;54.8;39.4
12;2021-06-30;828;2132;153456;111828;55.1;40.2
12;2021-07-01;345;1086;153801;112914;55.3;40.6
12;2021-07-02;796;2629;154597;115543;55.5;41.5
12;2021-07-03;565;1872;155162;117415;55.7;42.2
12;2021-07-04;1;0;155163;117415;55.7;42.2
12;2021-07-05;440;2406;155603;119821;55.9;43.0
12;2021-07-06;640;2495;156243;122316;56.1;43.9
12;2021-07-07;688;2116;156931;124432;56.4;44.7
12;2021-07-08;295;913;157226;125345;56.5;45.0
12;2021-07-09;724;2589;157950;127934;56.7;46.0
12;2021-07-10;445;2077;158395;130011;56.9;46.7
12;2021-07-11;0;0;158395;130011;56.9;46.7
12;2021-07-12;587;2439;158982;132450;57.1;47.6
12;2021-07-13;840;2593;159822;135043;57.4;48.5
12;2021-07-14;44;25;159866;135068;57.4;48.5
12;2021-07-15;795;2107;160661;137175;57.7;49.3
12;2021-07-16;1247;2556;161908;139731;58.2;50.2
12;2021-07-17;790;2007;162698;141738;58.4;50.9
12;2021-07-18;25;11;162723;141749;58.5;50.9
12;2021-07-19;1319;2005;164042;143754;58.9;51.6
12;2021-07-20;1422;1475;165464;145229;59.4;52.2
12;2021-07-21;1022;941;166486;146170;59.8;52.5
12;2021-07-22;2236;1308;168722;147478;60.6;53.0
12;2021-07-23;1865;2064;170587;149542;61.3;53.7
12;2021-07-24;1604;1566;172191;151108;61.9;54.3
12;2021-07-25;97;28;172288;151136;61.9;54.3
12;2021-07-26;1931;1438;174219;152574;62.6;54.8
12;2021-07-27;2236;1011;176455;153585;63.4;55.2
12;2021-07-28;1715;675;178170;154260;64.0;55.4
12;2021-07-29;1189;807;179359;155067;64.4;55.7
12;2021-07-30;2507;1284;181866;156351;65.3;56.2
12;2021-07-31;1967;1005;183833;157356;66.0;56.5
12;2021-08-01;225;38;184058;157394;66.1;56.5
12;2021-08-02;1815;833;185873;158227;66.8;56.8
12;2021-08-03;1960;776;187833;159003;67.5;57.1
12;2021-08-04;1695;833;189528;159836;68.1;57.4
12;2021-08-05;1636;688;191164;160524;68.7;57.7
12;2021-08-06;1706;1314;192870;161838;69.3;58.1
12;2021-08-07;1448;744;194318;162582;69.8;58.4
12;2021-08-08;0;3;194318;162585;69.8;58.4
12;2021-08-09;1351;1415;195669;164000;70.3;58.9
12;2021-08-10;1343;1254;197012;165254;70.8;59.4
12;2021-08-11;820;1195;197832;166449;71.1;59.8
12;2021-08-12;737;1070;198569;167519;71.3;60.2
12;2021-08-13;1075;1335;199644;168854;71.7;60.7
12;2021-08-14;739;1354;200383;170208;72.0;61.1
12;2021-08-15;255;75;200638;170283;72.1;61.2
12;2021-08-16;670;1817;201308;172100;72.3;61.8
12;2021-08-17;905;1991;202213;174091;72.6;62.5
12;2021-08-18;448;1522;202661;175613;72.8;63.1
12;2021-08-19;641;1115;203302;176728;73.0;63.5
12;2021-08-20;797;1888;204099;178616;73.3;64.2
12;2021-08-21;473;1526;204572;180142;73.5;64.7
12;2021-08-22;93;27;204665;180169;73.5;64.7
12;2021-08-23;453;1921;205118;182090;73.7;65.4
12;2021-08-24;486;1918;205604;184008;73.9;66.1
12;2021-08-25;333;1579;205937;185587;74.0;66.7
12;2021-08-26;487;1607;206424;187194;74.2;67.2
12;2021-08-27;599;1699;207023;188893;74.4;67.9
12;2021-08-28;332;1553;207355;190446;74.5;68.4
12;2021-08-29;176;143;207531;190589;74.6;68.5
12;2021-08-30;563;1870;208094;192459;74.8;69.1
12;2021-08-31;419;1344;208513;193803;74.9;69.6
12;2021-09-01;426;923;208939;194726;75.1;70.0
12;2021-09-02;267;735;209206;195461;75.2;70.2
12;2021-09-03;490;1190;209696;196651;75.3;70.6
12;2021-09-04;432;1092;210128;197743;75.5;71.0
12;2021-09-05;52;192;210180;197935;75.5;71.1
12;2021-09-06;214;592;210394;198527;75.6;71.3
12;2021-09-07;270;482;210664;199009;75.7;71.5
12;2021-09-08;245;464;210909;199473;75.8;71.7
12;2021-09-09;174;394;211083;199867;75.8;71.8
12;2021-09-10;500;1006;211583;200873;76.0;72.2
12;2021-09-11;386;936;211969;201809;76.1;72.5
12;2021-09-12;17;102;211986;201911;76.2;72.5
12;2021-09-13;157;389;212143;202300;76.2;72.7
12;2021-09-14;281;350;212424;202650;76.3;72.8
12;2021-09-15;249;407;212673;203057;76.4;72.9
12;2021-09-16;387;412;213060;203469;76.5;73.1
12;2021-09-17;345;505;213405;203974;76.7;73.3
12;2021-09-18;242;687;213647;204661;76.8;73.5
12;2021-09-19;0;4;213647;204665;76.8;73.5
12;2021-09-20;107;432;213754;205097;76.8;73.7
12;2021-09-21;112;220;213866;205317;76.8;73.8
12;2021-09-22;132;578;213998;205895;76.9;74.0
12;2021-09-23;106;161;214104;206056;76.9;74.0
12;2021-09-24;216;535;214320;206591;77.0;74.2
12;2021-09-25;161;667;214481;207258;77.1;74.5
12;2021-09-26;0;1;214481;207259;77.1;74.5
12;2021-09-27;81;242;214562;207501;77.1;74.5
12;2021-09-28;97;252;214659;207753;77.1;74.6
12;2021-09-29;112;325;214771;208078;77.2;74.8
12;2021-09-30;51;124;214822;208202;77.2;74.8
12;2021-10-01;162;405;214984;208607;77.2;74.9
12;2021-10-02;182;479;215166;209086;77.3;75.1
12;2021-10-03;0;2;215166;209088;77.3;75.1
12;2021-10-04;84;169;215250;209257;77.3;75.2
12;2021-10-05;67;191;215317;209448;77.4;75.2
12;2021-10-06;117;266;215434;209714;77.4;75.3
12;2021-10-07;67;317;215501;210031;77.4;75.5
12;2021-10-08;153;402;215654;210433;77.5;75.6
12;2021-10-09;168;349;215822;210782;77.5;75.7
12;2021-10-10;1;0;215823;210782;77.5;75.7
12;2021-10-11;57;100;215880;210882;77.6;75.8
12;2021-10-12;40;114;215920;210996;77.6;75.8
12;2021-10-13;150;286;216070;211282;77.6;75.9
12;2021-10-14;69;137;216139;211419;77.6;76.0
13;2020-12-27;5;0;5;0;0.0;0.0
13;2020-12-28;6;0;11;0;0.0;0.0
13;2020-12-29;1;0;12;0;0.0;0.0
13;2020-12-30;3;0;15;0;0.0;0.0
13;2020-12-31;6;0;21;0;0.0;0.0
13;2021-01-01;4;1;25;1;0.0;0.0
13;2021-01-02;4;0;29;1;0.0;0.0
13;2021-01-03;11;3;40;4;0.0;0.0
13;2021-01-04;1;1;41;5;0.0;0.0
13;2021-01-05;80;1;121;6;0.0;0.0
13;2021-01-06;122;0;243;6;0.0;0.0
13;2021-01-07;174;1;417;7;0.0;0.0
13;2021-01-08;189;0;606;7;0.0;0.0
13;2021-01-09;13;0;619;7;0.0;0.0
13;2021-01-10;3;0;622;7;0.0;0.0
13;2021-01-11;482;2;1104;9;0.1;0.0
13;2021-01-12;813;2;1917;11;0.1;0.0
13;2021-01-13;1087;2;3004;13;0.1;0.0
13;2021-01-14;1589;30;4593;43;0.2;0.0
13;2021-01-15;1539;9;6132;52;0.3;0.0
13;2021-01-16;406;3;6538;55;0.3;0.0
13;2021-01-17;44;0;6582;55;0.3;0.0
13;2021-01-18;2389;10;8971;65;0.4;0.0
13;2021-01-19;7423;54;16394;119;0.8;0.0
13;2021-01-20;5585;32;21979;151;1.1;0.0
13;2021-01-21;5366;34;27345;185;1.3;0.0
13;2021-01-22;4007;26;31352;211;1.5;0.0
13;2021-01-23;1358;8;32710;219;1.6;0.0
13;2021-01-24;491;6;33201;225;1.6;0.0
13;2021-01-25;2342;31;35543;256;1.7;0.0
13;2021-01-26;2951;92;38494;348;1.9;0.0
13;2021-01-27;3121;126;41615;474;2.0;0.0
13;2021-01-28;3252;198;44867;672;2.2;0.0
13;2021-01-29;2513;138;47380;810;2.3;0.0
13;2021-01-30;1025;12;48405;822;2.4;0.0
13;2021-01-31;252;2;48657;824;2.4;0.0
13;2021-02-01;1864;291;50521;1115;2.5;0.1
13;2021-02-02;2260;614;52781;1729;2.6;0.1
13;2021-02-03;1869;580;54650;2309;2.7;0.1
13;2021-02-04;1907;929;56557;3238;2.8;0.2
13;2021-02-05;2629;1556;59186;4794;2.9;0.2
13;2021-02-06;857;312;60043;5106;3.0;0.3
13;2021-02-07;279;6;60322;5112;3.0;0.3
13;2021-02-08;1906;1543;62228;6655;3.1;0.3
13;2021-02-09;3321;4465;65549;11120;3.2;0.5
13;2021-02-10;3259;3419;68808;14539;3.4;0.7
13;2021-02-11;3584;3594;72392;18133;3.6;0.9
13;2021-02-12;2839;3149;75231;21282;3.7;1.0
13;2021-02-13;734;597;75965;21879;3.7;1.1
13;2021-02-14;73;378;76038;22257;3.7;1.1
13;2021-02-15;971;2026;77009;24283;3.8;1.2
13;2021-02-16;1396;2629;78405;26912;3.9;1.3
13;2021-02-17;1350;3002;79755;29914;3.9;1.5
13;2021-02-18;1903;2687;81658;32601;4.0;1.6
13;2021-02-19;1517;2184;83175;34785;4.1;1.7
13;2021-02-20;458;783;83633;35568;4.1;1.7
13;2021-02-21;33;284;83666;35852;4.1;1.8
13;2021-02-22;1023;2262;84689;38114;4.2;1.9
13;2021-02-23;1290;2678;85979;40792;4.2;2.0
13;2021-02-24;1519;2623;87498;43415;4.3;2.1
13;2021-02-25;2384;2151;89882;45566;4.4;2.2
13;2021-02-26;2459;2130;92341;47696;4.5;2.3
13;2021-02-27;983;750;93324;48446;4.6;2.4
13;2021-02-28;194;208;93518;48654;4.6;2.4
13;2021-03-01;1928;1538;95446;50192;4.7;2.5
13;2021-03-02;3013;2643;98459;52835;4.8;2.6
13;2021-03-03;3491;2583;101950;55418;5.0;2.7
13;2021-03-04;4208;3155;106158;58573;5.2;2.9
13;2021-03-05;4043;2800;110201;61373;5.4;3.0
13;2021-03-06;5304;841;115505;62214;5.7;3.1
13;2021-03-07;4297;384;119802;62598;5.9;3.1
13;2021-03-08;3930;2014;123732;64612;6.1;3.2
13;2021-03-09;5082;2293;128814;66905;6.3;3.3
13;2021-03-10;5179;2004;133993;68909;6.6;3.4
13;2021-03-11;7314;2166;141307;71075;6.9;3.5
13;2021-03-12;8335;2139;149642;73214;7.4;3.6
13;2021-03-13;6379;750;156021;73964;7.7;3.6
13;2021-03-14;2313;175;158334;74139;7.8;3.6
13;2021-03-15;6358;1334;164692;75473;8.1;3.7
13;2021-03-16;5078;1562;169770;77035;8.3;3.8
13;2021-03-17;5174;1436;174944;78471;8.6;3.9
13;2021-03-18;5815;1900;180759;80371;8.9;4.0
13;2021-03-19;6814;1625;187573;81996;9.2;4.0
13;2021-03-20;4045;708;191618;82704;9.4;4.1
13;2021-03-21;727;89;192345;82793;9.5;4.1
13;2021-03-22;7296;1573;199641;84366;9.8;4.1
13;2021-03-23;9132;1778;208773;86144;10.3;4.2
13;2021-03-24;8869;2206;217642;88350;10.7;4.3
13;2021-03-25;10917;2136;228559;90486;11.2;4.4
13;2021-03-26;10716;1940;239275;92426;11.8;4.5
13;2021-03-27;4869;842;244144;93268;12.0;4.6
13;2021-03-28;1120;83;245264;93351;12.1;4.6
13;2021-03-29;7580;2023;252844;95374;12.4;4.7
13;2021-03-30;12617;2557;265461;97931;13.0;4.8
13;2021-03-31;10810;3207;276271;101138;13.6;5.0
13;2021-04-01;12277;3127;288548;104265;14.2;5.1
13;2021-04-02;9792;3916;298340;108181;14.7;5.3
13;2021-04-03;4007;2819;302347;111000;14.9;5.5
13;2021-04-04;631;307;302978;111307;14.9;5.5
13;2021-04-05;3537;734;306515;112041;15.1;5.5
13;2021-04-06;8521;4272;315036;116313;15.5;5.7
13;2021-04-07;10078;4712;325114;121025;16.0;5.9
13;2021-04-08;10117;5488;335231;126513;16.5;6.2
13;2021-04-09;11282;5147;346513;131660;17.0;6.5
13;2021-04-10;7300;2108;353813;133768;17.4;6.6
13;2021-04-11;1380;535;355193;134303;17.5;6.6
13;2021-04-12;7984;4825;363177;139128;17.9;6.8
13;2021-04-13;9146;5531;372323;144659;18.3;7.1
13;2021-04-14;9535;5836;381858;150495;18.8;7.4
13;2021-04-15;9878;5979;391736;156474;19.3;7.7
13;2021-04-16;9968;5586;401704;162060;19.7;8.0
13;2021-04-17;4079;2028;405783;164088;19.9;8.1
13;2021-04-18;2527;1426;408310;165514;20.1;8.1
13;2021-04-19;6457;6420;414767;171934;20.4;8.5
13;2021-04-20;7404;7617;422171;179551;20.8;8.8
13;2021-04-21;7771;7393;429942;186944;21.1;9.2
13;2021-04-22;8461;7940;438403;194884;21.5;9.6
13;2021-04-23;8395;6848;446798;201732;22.0;9.9
13;2021-04-24;4624;3820;451422;205552;22.2;10.1
13;2021-04-25;877;528;452299;206080;22.2;10.1
13;2021-04-26;6167;7123;458466;213203;22.5;10.5
13;2021-04-27;7264;8044;465730;221247;22.9;10.9
13;2021-04-28;9453;7733;475183;228980;23.4;11.3
13;2021-04-29;11408;7636;486591;236616;23.9;11.6
13;2021-04-30;10918;7388;497509;244004;24.5;12.0
13;2021-05-01;5365;3799;502874;247803;24.7;12.2
13;2021-05-02;2101;750;504975;248553;24.8;12.2
13;2021-05-03;7295;7875;512270;256428;25.2;12.6
13;2021-05-04;8455;8524;520725;264952;25.6;13.0
13;2021-05-05;8226;8982;528951;273934;26.0;13.5
13;2021-05-06;10143;8598;539094;282532;26.5;13.9
13;2021-05-07;8852;10047;547946;292579;26.9;14.4
13;2021-05-08;4569;3939;552515;296518;27.2;14.6
13;2021-05-09;939;688;553454;297206;27.2;14.6
13;2021-05-10;7710;8772;561164;305978;27.6;15.0
13;2021-05-11;10979;9583;572143;315561;28.1;15.5
13;2021-05-12;12841;8735;584984;324296;28.8;15.9
13;2021-05-13;9508;3642;594492;327938;29.2;16.1
13;2021-05-14;13657;6456;608149;334394;29.9;16.4
13;2021-05-15;10196;4540;618345;338934;30.4;16.7
13;2021-05-16;3129;795;621474;339729;30.5;16.7
13;2021-05-17;10843;6813;632317;346542;31.1;17.0
13;2021-05-18;11929;6486;644246;353028;31.7;17.4
13;2021-05-19;12158;6361;656404;359389;32.3;17.7
13;2021-05-20;13444;6472;669848;365861;32.9;18.0
13;2021-05-21;12991;6784;682839;372645;33.6;18.3
13;2021-05-22;7514;3638;690353;376283;33.9;18.5
13;2021-05-23;862;638;691215;376921;34.0;18.5
13;2021-05-24;6761;2469;697976;379390;34.3;18.6
13;2021-05-25;9270;7595;707246;386985;34.8;19.0
13;2021-05-26;10143;7838;717389;394823;35.3;19.4
13;2021-05-27;10339;8422;727728;403245;35.8;19.8
13;2021-05-28;9005;9175;736733;412420;36.2;20.3
13;2021-05-29;7173;4625;743906;417045;36.6;20.5
13;2021-05-30;891;527;744797;417572;36.6;20.5
13;2021-05-31;8184;8032;752981;425604;37.0;20.9
13;2021-06-01;9582;9302;762563;434906;37.5;21.4
13;2021-06-02;10082;8786;772645;443692;38.0;21.8
13;2021-06-03;12296;9500;784941;453192;38.6;22.3
13;2021-06-04;12025;10047;796966;463239;39.2;22.8
13;2021-06-05;7822;5597;804788;468836;39.6;23.0
13;2021-06-06;1671;887;806459;469723;39.6;23.1
13;2021-06-07;6686;9883;813145;479606;40.0;23.6
13;2021-06-08;8317;9995;821462;489601;40.4;24.1
13;2021-06-09;8398;9742;829860;499343;40.8;24.5
13;2021-06-10;8953;9787;838813;509130;41.2;25.0
13;2021-06-11;8230;12716;847043;521846;41.6;25.7
13;2021-06-12;5778;6704;852821;528550;41.9;26.0
13;2021-06-13;950;1216;853771;529766;42.0;26.0
13;2021-06-14;5995;11143;859766;540909;42.3;26.6
13;2021-06-15;7285;11408;867051;552317;42.6;27.1
13;2021-06-16;7340;9867;874391;562184;43.0;27.6
13;2021-06-17;7445;10717;881836;572901;43.3;28.2
13;2021-06-18;7550;11076;889386;583977;43.7;28.7
13;2021-06-19;4617;7500;894003;591477;43.9;29.1
13;2021-06-20;1876;1045;895879;592522;44.0;29.1
13;2021-06-21;4463;12262;900342;604784;44.3;29.7
13;2021-06-22;4941;13878;905283;618662;44.5;30.4
13;2021-06-23;5148;13578;910431;632240;44.8;31.1
13;2021-06-24;5341;12855;915772;645095;45.0;31.7
13;2021-06-25;5244;14683;921016;659778;45.3;32.4
13;2021-06-26;3016;9681;924032;669459;45.4;32.9
13;2021-06-27;537;931;924569;670390;45.4;33.0
13;2021-06-28;3731;12564;928300;682954;45.6;33.6
13;2021-06-29;4500;12905;932800;695859;45.8;34.2
13;2021-06-30;4904;12698;937704;708557;46.1;34.8
13;2021-07-01;5580;11500;943284;720057;46.4;35.4
13;2021-07-02;5572;12397;948856;732454;46.6;36.0
13;2021-07-03;3504;9161;952360;741615;46.8;36.5
13;2021-07-04;476;867;952836;742482;46.8;36.5
13;2021-07-05;3872;11778;956708;754260;47.0;37.1
13;2021-07-06;5461;11681;962169;765941;47.3;37.6
13;2021-07-07;5822;10707;967991;776648;47.6;38.2
13;2021-07-08;6230;10329;974221;786977;47.9;38.7
13;2021-07-09;5933;11935;980154;798912;48.2;39.3
13;2021-07-10;3163;8638;983317;807550;48.3;39.7
13;2021-07-11;478;1012;983795;808562;48.4;39.7
13;2021-07-12;4493;10951;988288;819513;48.6;40.3
13;2021-07-13;8980;13189;997268;832702;49.0;40.9
13;2021-07-14;5610;4873;1002878;837575;49.3;41.2
13;2021-07-15;11438;12950;1014316;850525;49.9;41.8
13;2021-07-16;12195;12939;1026511;863464;50.5;42.4
13;2021-07-17;6584;8494;1033095;871958;50.8;42.9
13;2021-07-18;727;1062;1033822;873020;50.8;42.9
13;2021-07-19;9809;11153;1043631;884173;51.3;43.5
13;2021-07-20;12272;11664;1055903;895837;51.9;44.0
13;2021-07-21;12690;10363;1068593;906200;52.5;44.5
13;2021-07-22;14557;10469;1083150;916669;53.2;45.1
13;2021-07-23;14485;10983;1097635;927652;54.0;45.6
13;2021-07-24;8343;7981;1105978;935633;54.4;46.0
13;2021-07-25;1017;785;1106995;936418;54.4;46.0
13;2021-07-26;11649;9124;1118644;945542;55.0;46.5
13;2021-07-27;13610;9426;1132254;954968;55.7;46.9
13;2021-07-28;12341;8189;1144595;963157;56.3;47.3
13;2021-07-29;13765;8097;1158360;971254;56.9;47.7
13;2021-07-30;13715;8645;1172075;979899;57.6;48.2
13;2021-07-31;8678;5846;1180753;985745;58.0;48.5
13;2021-08-01;1107;729;1181860;986474;58.1;48.5
13;2021-08-02;10054;6734;1191914;993208;58.6;48.8
13;2021-08-03;11073;7302;1202987;1000510;59.1;49.2
13;2021-08-04;9429;6575;1212416;1007085;59.6;49.5
13;2021-08-05;9530;7587;1221946;1014672;60.1;49.9
13;2021-08-06;9199;9007;1231145;1023679;60.5;50.3
13;2021-08-07;5441;5586;1236586;1029265;60.8;50.6
13;2021-08-08;905;805;1237491;1030070;60.8;50.6
13;2021-08-09;8398;9079;1245889;1039149;61.2;51.1
13;2021-08-10;9150;8913;1255039;1048062;61.7;51.5
13;2021-08-11;7911;8546;1262950;1056608;62.1;51.9
13;2021-08-12;7791;9674;1270741;1066282;62.5;52.4
13;2021-08-13;6960;9192;1277701;1075474;62.8;52.9
13;2021-08-14;3691;6456;1281392;1081930;63.0;53.2
13;2021-08-15;485;731;1281877;1082661;63.0;53.2
13;2021-08-16;6581;11081;1288458;1093742;63.3;53.8
13;2021-08-17;6674;10617;1295132;1104359;63.7;54.3
13;2021-08-18;6343;10182;1301475;1114541;64.0;54.8
13;2021-08-19;6670;10617;1308145;1125158;64.3;55.3
13;2021-08-20;5832;11238;1313977;1136396;64.6;55.9
13;2021-08-21;2617;7569;1316594;1143965;64.7;56.2
13;2021-08-22;369;1090;1316963;1145055;64.7;56.3
13;2021-08-23;4978;11223;1321941;1156278;65.0;56.8
13;2021-08-24;5447;10920;1327388;1167198;65.2;57.4
13;2021-08-25;5213;10100;1332601;1177298;65.5;57.9
13;2021-08-26;5133;9784;1337734;1187082;65.8;58.3
13;2021-08-27;5093;10637;1342827;1197719;66.0;58.9
13;2021-08-28;2361;6461;1345188;1204180;66.1;59.2
13;2021-08-29;338;1140;1345526;1205320;66.1;59.2
13;2021-08-30;4245;9721;1349771;1215041;66.3;59.7
13;2021-08-31;4871;9915;1354642;1224956;66.6;60.2
13;2021-09-01;4793;8266;1359435;1233222;66.8;60.6
13;2021-09-02;4776;8008;1364211;1241230;67.1;61.0
13;2021-09-03;4277;8658;1368488;1249888;67.3;61.4
13;2021-09-04;2173;5409;1370661;1255297;67.4;61.7
13;2021-09-05;185;348;1370846;1255645;67.4;61.7
13;2021-09-06;3143;6033;1373989;1261678;67.5;62.0
13;2021-09-07;3222;6246;1377211;1267924;67.7;62.3
13;2021-09-08;3520;6352;1380731;1274276;67.9;62.6
13;2021-09-09;3169;5731;1383900;1280007;68.0;62.9
13;2021-09-10;3673;6749;1387573;1286756;68.2;63.2
13;2021-09-11;2292;5143;1389865;1291899;68.3;63.5
13;2021-09-12;232;294;1390097;1292193;68.3;63.5
13;2021-09-13;2506;4266;1392603;1296459;68.5;63.7
13;2021-09-14;3215;4615;1395818;1301074;68.6;64.0
13;2021-09-15;2887;5521;1398705;1306595;68.8;64.2
13;2021-09-16;2224;3905;1400929;1310500;68.9;64.4
13;2021-09-17;2336;4875;1403265;1315375;69.0;64.7
13;2021-09-18;1532;4251;1404797;1319626;69.0;64.9
13;2021-09-19;125;176;1404922;1319802;69.1;64.9
13;2021-09-20;1544;3307;1406466;1323109;69.1;65.0
13;2021-09-21;1477;2927;1407943;1326036;69.2;65.2
13;2021-09-22;1697;4543;1409640;1330579;69.3;65.4
13;2021-09-23;1650;3538;1411290;1334117;69.4;65.6
13;2021-09-24;1619;4273;1412909;1338390;69.4;65.8
13;2021-09-25;1229;3967;1414138;1342357;69.5;66.0
13;2021-09-26;87;258;1414225;1342615;69.5;66.0
13;2021-09-27;1252;3158;1415477;1345773;69.6;66.1
13;2021-09-28;1327;2637;1416804;1348410;69.6;66.3
13;2021-09-29;1607;3555;1418411;1351965;69.7;66.5
13;2021-09-30;1360;3203;1419771;1355168;69.8;66.6
13;2021-10-01;1566;3569;1421337;1358737;69.9;66.8
13;2021-10-02;1176;2816;1422513;1361553;69.9;66.9
13;2021-10-03;101;418;1422614;1361971;69.9;66.9
13;2021-10-04;622;1593;1423236;1363564;70.0;67.0
13;2021-10-05;1135;2460;1424371;1366024;70.0;67.1
13;2021-10-06;1262;3146;1425633;1369170;70.1;67.3
13;2021-10-07;1027;2498;1426660;1371668;70.1;67.4
13;2021-10-08;1366;3259;1428026;1374927;70.2;67.6
13;2021-10-09;916;2324;1428942;1377251;70.2;67.7
13;2021-10-10;81;120;1429023;1377371;70.2;67.7
13;2021-10-11;924;1710;1429947;1379081;70.3;67.8
13;2021-10-12;1136;1779;1431083;1380860;70.3;67.9
13;2021-10-13;1196;2142;1432279;1383002;70.4;68.0
13;2021-10-14;984;1768;1433263;1384770;70.4;68.1
14;2020-12-27;0;0;0;0;0.0;0.0
14;2020-12-28;1;1;1;1;0.0;0.0
14;2020-12-29;1;0;2;1;0.0;0.0
14;2020-12-30;0;0;2;1;0.0;0.0
14;2020-12-31;3;0;5;1;0.0;0.0
14;2021-01-01;2;0;7;1;0.0;0.0
14;2021-01-02;1;0;8;1;0.0;0.0
14;2021-01-03;0;0;8;1;0.0;0.0
14;2021-01-04;10;0;18;1;0.0;0.0
14;2021-01-05;24;0;42;1;0.0;0.0
14;2021-01-06;352;0;394;1;0.1;0.0
14;2021-01-07;402;2;796;3;0.1;0.0
14;2021-01-08;631;5;1427;8;0.2;0.0
14;2021-01-09;127;0;1554;8;0.2;0.0
14;2021-01-10;41;0;1595;8;0.2;0.0
14;2021-01-11;674;5;2269;13;0.3;0.0
14;2021-01-12;954;7;3223;20;0.5;0.0
14;2021-01-13;850;1;4073;21;0.6;0.0
14;2021-01-14;2841;28;6914;49;1.0;0.0
14;2021-01-15;1899;22;8813;71;1.3;0.0
14;2021-01-16;271;3;9084;74;1.3;0.0
14;2021-01-17;145;7;9229;81;1.3;0.0
14;2021-01-18;1087;6;10316;87;1.5;0.0
14;2021-01-19;1155;3;11471;90;1.7;0.0
14;2021-01-20;1987;5;13458;95;1.9;0.0
14;2021-01-21;1817;7;15275;102;2.2;0.0
14;2021-01-22;1494;6;16769;108;2.4;0.0
14;2021-01-23;297;1;17066;109;2.5;0.0
14;2021-01-24;73;1;17139;110;2.5;0.0
14;2021-01-25;911;10;18050;120;2.6;0.0
14;2021-01-26;848;37;18898;157;2.7;0.0
14;2021-01-27;884;160;19782;317;2.9;0.0
14;2021-01-28;782;145;20564;462;3.0;0.1
14;2021-01-29;786;230;21350;692;3.1;0.1
14;2021-01-30;270;12;21620;704;3.1;0.1
14;2021-01-31;58;3;21678;707;3.1;0.1
14;2021-02-01;729;226;22407;933;3.2;0.1
14;2021-02-02;830;420;23237;1353;3.4;0.2
14;2021-02-03;761;387;23998;1740;3.5;0.3
14;2021-02-04;1170;2056;25168;3796;3.6;0.5
14;2021-02-05;1296;1315;26464;5111;3.8;0.7
14;2021-02-06;398;237;26862;5348;3.9;0.8
14;2021-02-07;180;72;27042;5420;3.9;0.8
14;2021-02-08;773;822;27815;6242;4.0;0.9
14;2021-02-09;723;1009;28538;7251;4.1;1.0
14;2021-02-10;825;1607;29363;8858;4.2;1.3
14;2021-02-11;1351;1430;30714;10288;4.4;1.5
14;2021-02-12;1383;1080;32097;11368;4.6;1.6
14;2021-02-13;308;186;32405;11554;4.7;1.7
14;2021-02-14;84;64;32489;11618;4.7;1.7
14;2021-02-15;443;1077;32932;12695;4.8;1.8
14;2021-02-16;679;976;33611;13671;4.9;2.0
14;2021-02-17;405;978;34016;14649;4.9;2.1
14;2021-02-18;707;884;34723;15533;5.0;2.2
14;2021-02-19;734;777;35457;16310;5.1;2.4
14;2021-02-20;91;268;35548;16578;5.1;2.4
14;2021-02-21;6;90;35554;16668;5.1;2.4
14;2021-02-22;432;1040;35986;17708;5.2;2.6
14;2021-02-23;487;920;36473;18628;5.3;2.7
14;2021-02-24;441;890;36914;19518;5.3;2.8
14;2021-02-25;1224;1177;38138;20695;5.5;3.0
14;2021-02-26;1576;1161;39714;21856;5.7;3.2
14;2021-02-27;507;269;40221;22125;5.8;3.2
14;2021-02-28;27;41;40248;22166;5.8;3.2
14;2021-03-01;522;929;40770;23095;5.9;3.3
14;2021-03-02;966;807;41736;23902;6.0;3.5
14;2021-03-03;1080;841;42816;24743;6.2;3.6
14;2021-03-04;1950;794;44766;25537;6.5;3.7
14;2021-03-05;2433;881;47199;26418;6.8;3.8
14;2021-03-06;3078;210;50277;26628;7.3;3.9
14;2021-03-07;1196;64;51473;26692;7.4;3.9
14;2021-03-08;1254;816;52727;27508;7.6;4.0
14;2021-03-09;1742;700;54469;28208;7.9;4.1
14;2021-03-10;1835;594;56304;28802;8.1;4.2
14;2021-03-11;2760;480;59064;29282;8.5;4.2
14;2021-03-12;4047;583;63111;29865;9.1;4.3
14;2021-03-13;1854;179;64965;30044;9.4;4.3
14;2021-03-14;31;39;64996;30083;9.4;4.4
14;2021-03-15;2006;143;67002;30226;9.7;4.4
14;2021-03-16;1401;279;68403;30505;9.9;4.4
14;2021-03-17;1155;197;69558;30702;10.1;4.4
14;2021-03-18;1481;305;71039;31007;10.3;4.5
14;2021-03-19;2608;272;73647;31279;10.7;4.5
14;2021-03-20;2660;43;76307;31322;11.0;4.5
14;2021-03-21;454;9;76761;31331;11.1;4.5
14;2021-03-22;1872;363;78633;31694;11.4;4.6
14;2021-03-23;2179;327;80812;32021;11.7;4.6
14;2021-03-24;2432;195;83244;32216;12.0;4.7
14;2021-03-25;3292;327;86536;32543;12.5;4.7
14;2021-03-26;4609;485;91145;33028;13.2;4.8
14;2021-03-27;2230;234;93375;33262;13.5;4.8
14;2021-03-28;36;1;93411;33263;13.5;4.8
14;2021-03-29;1614;487;95025;33750;13.7;4.9
14;2021-03-30;2722;519;97747;34269;14.1;5.0
14;2021-03-31;2326;931;100073;35200;14.5;5.1
14;2021-04-01;4177;1688;104250;36888;15.1;5.3
14;2021-04-02;3867;1275;108117;38163;15.6;5.5
14;2021-04-03;1126;1206;109243;39369;15.8;5.7
14;2021-04-04;25;483;109268;39852;15.8;5.8
14;2021-04-05;1218;325;110486;40177;16.0;5.8
14;2021-04-06;2383;1001;112869;41178;16.3;6.0
14;2021-04-07;2730;1037;115599;42215;16.7;6.1
14;2021-04-08;4303;1125;119902;43340;17.3;6.3
14;2021-04-09;6031;1193;125933;44533;18.2;6.4
14;2021-04-10;2896;444;128829;44977;18.6;6.5
14;2021-04-11;629;125;129458;45102;18.7;6.5
14;2021-04-12;2915;1589;132373;46691;19.1;6.8
14;2021-04-13;3471;1450;135844;48141;19.6;7.0
14;2021-04-14;3123;1175;138967;49316;20.1;7.1
14;2021-04-15;4398;1520;143365;50836;20.7;7.4
14;2021-04-16;4598;1570;147963;52406;21.4;7.6
14;2021-04-17;2312;1667;150275;54073;21.7;7.8
14;2021-04-18;539;328;150814;54401;21.8;7.9
14;2021-04-19;2760;1706;153574;56107;22.2;8.1
14;2021-04-20;3390;1836;156964;57943;22.7;8.4
14;2021-04-21;3015;1477;159979;59420;23.1;8.6
14;2021-04-22;4230;2095;164209;61515;23.7;8.9
14;2021-04-23;4651;2316;168860;63831;24.4;9.2
14;2021-04-24;1851;1757;170711;65588;24.7;9.5
14;2021-04-25;456;28;171167;65616;24.8;9.5
14;2021-04-26;3379;1572;174546;67188;25.2;9.7
14;2021-04-27;3502;2579;178048;69767;25.7;10.1
14;2021-04-28;3245;1899;181293;71666;26.2;10.4
14;2021-04-29;4544;2316;185837;73982;26.9;10.7
14;2021-04-30;5124;2653;190961;76635;27.6;11.1
14;2021-05-01;3554;204;194515;76839;28.1;11.1
14;2021-05-02;1238;56;195753;76895;28.3;11.1
14;2021-05-03;2482;2770;198235;79665;28.7;11.5
14;2021-05-04;3128;2913;201363;82578;29.1;11.9
14;2021-05-05;3687;2760;205050;85338;29.7;12.3
14;2021-05-06;4929;3490;209979;88828;30.4;12.8
14;2021-05-07;4870;3854;214849;92682;31.1;13.4
14;2021-05-08;2728;1265;217577;93947;31.5;13.6
14;2021-05-09;1914;671;219491;94618;31.7;13.7
14;2021-05-10;3637;3152;223128;97770;32.3;14.1
14;2021-05-11;4346;3610;227474;101380;32.9;14.7
14;2021-05-12;4053;3223;231527;104603;33.5;15.1
14;2021-05-13;4688;1132;236215;105735;34.2;15.3
14;2021-05-14;6674;2629;242889;108364;35.1;15.7
14;2021-05-15;5148;778;248037;109142;35.9;15.8
14;2021-05-16;2320;120;250357;109262;36.2;15.8
14;2021-05-17;2820;2261;253177;111523;36.6;16.1
14;2021-05-18;4089;2244;257266;113767;37.2;16.5
14;2021-05-19;3752;2022;261018;115789;37.7;16.7
14;2021-05-20;4482;2768;265500;118557;38.4;17.1
14;2021-05-21;4276;3528;269776;122085;39.0;17.7
14;2021-05-22;1669;866;271445;122951;39.3;17.8
14;2021-05-23;649;71;272094;123022;39.4;17.8
14;2021-05-24;2845;751;274939;123773;39.8;17.9
14;2021-05-25;3635;3387;278574;127160;40.3;18.4
14;2021-05-26;3438;2407;282012;129567;40.8;18.7
14;2021-05-27;4771;3241;286783;132808;41.5;19.2
14;2021-05-28;5090;3893;291873;136701;42.2;19.8
14;2021-05-29;2342;2458;294215;139159;42.6;20.1
14;2021-05-30;759;237;294974;139396;42.7;20.2
14;2021-05-31;4089;2967;299063;142363;43.3;20.6
14;2021-06-01;5738;3218;304801;145581;44.1;21.1
14;2021-06-02;5024;2862;309825;148443;44.8;21.5
14;2021-06-03;6658;4019;316483;152462;45.8;22.0
14;2021-06-04;6444;5142;322927;157604;46.7;22.8
14;2021-06-05;4359;1866;327286;159470;47.3;23.1
14;2021-06-06;2043;83;329329;159553;47.6;23.1
14;2021-06-07;4253;3452;333582;163005;48.2;23.6
14;2021-06-08;5234;3132;338816;166137;49.0;24.0
14;2021-06-09;4270;2967;343086;169104;49.6;24.5
14;2021-06-10;5080;2973;348166;172077;50.4;24.9
14;2021-06-11;4840;4887;353006;176964;51.1;25.6
14;2021-06-12;3677;4520;356683;181484;51.6;26.2
14;2021-06-13;848;1089;357531;182573;51.7;26.4
14;2021-06-14;2185;3792;359716;186365;52.0;27.0
14;2021-06-15;3315;3970;363031;190335;52.5;27.5
14;2021-06-16;3445;4556;366476;194891;53.0;28.2
14;2021-06-17;4230;5269;370706;200160;53.6;28.9
14;2021-06-18;3732;6121;374438;206281;54.2;29.8
14;2021-06-19;2591;2951;377029;209232;54.5;30.3
14;2021-06-20;581;1556;377610;210788;54.6;30.5
14;2021-06-21;2121;4359;379731;215147;54.9;31.1
14;2021-06-22;2582;5180;382313;220327;55.3;31.9
14;2021-06-23;2504;4348;384817;224675;55.7;32.5
14;2021-06-24;3450;5811;388267;230486;56.2;33.3
14;2021-06-25;2752;7277;391019;237763;56.6;34.4
14;2021-06-26;2177;4539;393196;242302;56.9;35.0
14;2021-06-27;440;1829;393636;244131;56.9;35.3
14;2021-06-28;1311;3970;394947;248101;57.1;35.9
14;2021-06-29;1789;5365;396736;253466;57.4;36.7
14;2021-06-30;2024;4618;398760;258084;57.7;37.3
14;2021-07-01;2931;5072;401691;263156;58.1;38.1
14;2021-07-02;2600;6669;404291;269825;58.5;39.0
14;2021-07-03;1430;2647;405721;272472;58.7;39.4
14;2021-07-04;422;713;406143;273185;58.7;39.5
14;2021-07-05;1191;4777;407334;277962;58.9;40.2
14;2021-07-06;2090;6002;409424;283964;59.2;41.1
14;2021-07-07;2257;4578;411681;288542;59.5;41.7
14;2021-07-08;2912;5527;414593;294069;60.0;42.5
14;2021-07-09;2771;6433;417364;300502;60.4;43.5
14;2021-07-10;2037;3203;419401;303705;60.7;43.9
14;2021-07-11;900;871;420301;304576;60.8;44.0
14;2021-07-12;1634;5904;421935;310480;61.0;44.9
14;2021-07-13;3081;7340;425016;317820;61.5;46.0
14;2021-07-14;2260;3065;427276;320885;61.8;46.4
14;2021-07-15;4172;7655;431448;328540;62.4;47.5
14;2021-07-16;4708;7696;436156;336236;63.1;48.6
14;2021-07-17;2114;4214;438270;340450;63.4;49.2
14;2021-07-18;821;1870;439091;342320;63.5;49.5
14;2021-07-19;2599;6128;441690;348448;63.9;50.4
14;2021-07-20;3247;7258;444937;355706;64.3;51.4
14;2021-07-21;4105;5847;449042;361553;64.9;52.3
14;2021-07-22;4852;6604;453894;368157;65.6;53.2
14;2021-07-23;5384;6770;459278;374927;66.4;54.2
14;2021-07-24;3084;3795;462362;378722;66.9;54.8
14;2021-07-25;1504;1249;463866;379971;67.1;55.0
14;2021-07-26;4682;4186;468548;384157;67.8;55.6
14;2021-07-27;5404;4364;473952;388521;68.5;56.2
14;2021-07-28;5117;3975;479069;392496;69.3;56.8
14;2021-07-29;6446;4888;485515;397384;70.2;57.5
14;2021-07-30;5843;5171;491358;402555;71.1;58.2
14;2021-07-31;2774;2513;494132;405068;71.5;58.6
14;2021-08-01;1895;934;496027;406002;71.7;58.7
14;2021-08-02;3948;4293;499975;410295;72.3;59.3
14;2021-08-03;4482;4173;504457;414468;73.0;59.9
14;2021-08-04;4650;3538;509107;418006;73.6;60.5
14;2021-08-05;4658;4039;513765;422045;74.3;61.0
14;2021-08-06;4431;4808;518196;426853;74.9;61.7
14;2021-08-07;2133;2295;520329;429148;75.3;62.1
14;2021-08-08;638;854;520967;430002;75.3;62.2
14;2021-08-09;2129;2877;523096;432879;75.7;62.6
14;2021-08-10;3663;4171;526759;437050;76.2;63.2
14;2021-08-11;3076;3456;529835;440506;76.6;63.7
14;2021-08-12;3482;4351;533317;444857;77.1;64.3
14;2021-08-13;2638;4139;535955;448996;77.5;64.9
14;2021-08-14;1423;2009;537378;451005;77.7;65.2
14;2021-08-15;389;1484;537767;452489;77.8;65.4
14;2021-08-16;1833;2785;539600;455274;78.0;65.8
14;2021-08-17;2263;4570;541863;459844;78.4;66.5
14;2021-08-18;2064;4528;543927;464372;78.7;67.2
14;2021-08-19;2336;5086;546263;469458;79.0;67.9
14;2021-08-20;2189;5403;548452;474861;79.3;68.7
14;2021-08-21;1016;2837;549468;477698;79.5;69.1
14;2021-08-22;170;1564;549638;479262;79.5;69.3
14;2021-08-23;1269;4170;550907;483432;79.7;69.9
14;2021-08-24;1348;4302;552255;487734;79.9;70.5
14;2021-08-25;1400;4398;553655;492132;80.1;71.2
14;2021-08-26;1433;5081;555088;497213;80.3;71.9
14;2021-08-27;1467;5289;556555;502502;80.5;72.7
14;2021-08-28;735;3005;557290;505507;80.6;73.1
14;2021-08-29;186;1015;557476;506522;80.6;73.3
14;2021-08-30;1016;3549;558492;510071;80.8;73.8
14;2021-08-31;1330;4642;559822;514713;81.0;74.4
14;2021-09-01;1069;3627;560891;518340;81.1;75.0
14;2021-09-02;864;3039;561755;521379;81.2;75.4
14;2021-09-03;1183;3862;562938;525241;81.4;76.0
14;2021-09-04;665;2225;563603;527466;81.5;76.3
14;2021-09-05;126;372;563729;527838;81.5;76.3
14;2021-09-06;468;1852;564197;529690;81.6;76.6
14;2021-09-07;499;1860;564696;531550;81.7;76.9
14;2021-09-08;681;2706;565377;534256;81.8;77.3
14;2021-09-09;595;1777;565972;536033;81.9;77.5
14;2021-09-10;771;2362;566743;538395;82.0;77.9
14;2021-09-11;522;1486;567265;539881;82.0;78.1
14;2021-09-12;67;240;567332;540121;82.0;78.1
14;2021-09-13;311;1154;567643;541275;82.1;78.3
14;2021-09-14;659;1262;568302;542537;82.2;78.5
14;2021-09-15;716;1997;569018;544534;82.3;78.8
14;2021-09-16;592;1340;569610;545874;82.4;78.9
14;2021-09-17;632;1454;570242;547328;82.5;79.2
14;2021-09-18;218;971;570460;548299;82.5;79.3
14;2021-09-19;40;137;570500;548436;82.5;79.3
14;2021-09-20;332;811;570832;549247;82.6;79.4
14;2021-09-21;544;846;571376;550093;82.6;79.6
14;2021-09-22;485;1753;571861;551846;82.7;79.8
14;2021-09-23;447;784;572308;552630;82.8;79.9
14;2021-09-24;405;1310;572713;553940;82.8;80.1
14;2021-09-25;191;690;572904;554630;82.9;80.2
14;2021-09-26;41;140;572945;554770;82.9;80.2
14;2021-09-27;276;710;573221;555480;82.9;80.3
14;2021-09-28;359;674;573580;556154;83.0;80.4
14;2021-09-29;307;920;573887;557074;83.0;80.6
14;2021-09-30;340;687;574227;557761;83.0;80.7
14;2021-10-01;449;831;574676;558592;83.1;80.8
14;2021-10-02;247;514;574923;559106;83.1;80.9
14;2021-10-03;37;61;574960;559167;83.2;80.9
14;2021-10-04;281;502;575241;559669;83.2;80.9
14;2021-10-05;272;447;575513;560116;83.2;81.0
14;2021-10-06;387;794;575900;560910;83.3;81.1
14;2021-10-07;224;408;576124;561318;83.3;81.2
14;2021-10-08;425;835;576549;562153;83.4;81.3
14;2021-10-09;186;339;576735;562492;83.4;81.3
14;2021-10-10;3;2;576738;562494;83.4;81.3
14;2021-10-11;180;463;576918;562957;83.4;81.4
14;2021-10-12;302;592;577220;563549;83.5;81.5
14;2021-10-13;352;517;577572;564066;83.5;81.6
14;2021-10-14;212;439;577784;564505;83.6;81.6
15;2020-12-27;2;0;2;0;0.0;0.0
15;2020-12-28;0;0;2;0;0.0;0.0
15;2020-12-29;0;0;2;0;0.0;0.0
15;2020-12-30;0;0;2;0;0.0;0.0
15;2020-12-31;0;0;2;0;0.0;0.0
15;2021-01-01;1;0;3;0;0.0;0.0
15;2021-01-02;0;0;3;0;0.0;0.0
15;2021-01-03;0;0;3;0;0.0;0.0
15;2021-01-04;0;0;3;0;0.0;0.0
15;2021-01-05;0;0;3;0;0.0;0.0
15;2021-01-06;0;0;3;0;0.0;0.0
15;2021-01-07;72;0;75;0;0.1;0.0
15;2021-01-08;109;2;184;2;0.1;0.0
15;2021-01-09;0;0;184;2;0.1;0.0
15;2021-01-10;2;0;186;2;0.1;0.0
15;2021-01-11;99;1;285;3;0.2;0.0
15;2021-01-12;94;0;379;3;0.3;0.0
15;2021-01-13;230;0;609;3;0.4;0.0
15;2021-01-14;313;5;922;8;0.6;0.0
15;2021-01-15;138;0;1060;8;0.7;0.0
15;2021-01-16;90;0;1150;8;0.8;0.0
15;2021-01-17;0;0;1150;8;0.8;0.0
15;2021-01-18;404;2;1554;10;1.1;0.0
15;2021-01-19;550;0;2104;10;1.5;0.0
15;2021-01-20;629;2;2733;12;1.9;0.0
15;2021-01-21;576;4;3309;16;2.3;0.0
15;2021-01-22;503;3;3812;19;2.7;0.0
15;2021-01-23;432;1;4244;20;3.0;0.0
15;2021-01-24;6;0;4250;20;3.0;0.0
15;2021-01-25;401;0;4651;20;3.3;0.0
15;2021-01-26;436;0;5087;20;3.6;0.0
15;2021-01-27;735;8;5822;28;4.1;0.0
15;2021-01-28;623;52;6445;80;4.5;0.1
15;2021-01-29;336;82;6781;162;4.7;0.1
15;2021-01-30;218;3;6999;165;4.9;0.1
15;2021-01-31;1;1;7000;166;4.9;0.1
15;2021-02-01;239;94;7239;260;5.1;0.2
15;2021-02-02;189;89;7428;349;5.2;0.2
15;2021-02-03;267;159;7695;508;5.4;0.4
15;2021-02-04;663;204;8358;712;5.9;0.5
15;2021-02-05;296;256;8654;968;6.1;0.7
15;2021-02-06;98;77;8752;1045;6.1;0.7
15;2021-02-07;0;0;8752;1045;6.1;0.7
15;2021-02-08;233;108;8985;1153;6.3;0.8
15;2021-02-09;206;119;9191;1272;6.4;0.9
15;2021-02-10;338;301;9529;1573;6.7;1.1
15;2021-02-11;118;239;9647;1812;6.8;1.3
15;2021-02-12;136;159;9783;1971;6.9;1.4
15;2021-02-13;92;77;9875;2048;6.9;1.4
15;2021-02-14;0;0;9875;2048;6.9;1.4
15;2021-02-15;64;215;9939;2263;7.0;1.6
15;2021-02-16;52;294;9991;2557;7.0;1.8
15;2021-02-17;134;473;10125;3030;7.1;2.1
15;2021-02-18;87;754;10212;3784;7.2;2.6
15;2021-02-19;90;429;10302;4213;7.2;3.0
15;2021-02-20;20;258;10322;4471;7.2;3.1
15;2021-02-21;0;0;10322;4471;7.2;3.1
15;2021-02-22;23;496;10345;4967;7.2;3.5
15;2021-02-23;180;457;10525;5424;7.4;3.8
15;2021-02-24;31;456;10556;5880;7.4;4.1
15;2021-02-25;228;1001;10784;6881;7.6;4.8
15;2021-02-26;186;475;10970;7356;7.7;5.2
15;2021-02-27;145;89;11115;7445;7.8;5.2
15;2021-02-28;1;0;11116;7445;7.8;5.2
15;2021-03-01;121;223;11237;7668;7.9;5.4
15;2021-03-02;251;307;11488;7975;8.0;5.6
15;2021-03-03;207;29;11695;8004;8.2;5.6
15;2021-03-04;246;248;11941;8252;8.4;5.8
15;2021-03-05;348;175;12289;8427;8.6;5.9
15;2021-03-06;680;11;12969;8438;9.1;5.9
15;2021-03-07;81;2;13050;8440;9.1;5.9
15;2021-03-08;93;107;13143;8547;9.2;6.0
15;2021-03-09;281;294;13424;8841;9.4;6.2
15;2021-03-10;417;180;13841;9021;9.7;6.3
15;2021-03-11;434;296;14275;9317;10.0;6.5
15;2021-03-12;525;96;14800;9413;10.4;6.6
15;2021-03-13;355;7;15155;9420;10.6;6.6
15;2021-03-14;18;0;15173;9420;10.6;6.6
15;2021-03-15;542;65;15715;9485;11.0;6.6
15;2021-03-16;328;22;16043;9507;11.2;6.7
15;2021-03-17;130;53;16173;9560;11.3;6.7
15;2021-03-18;250;96;16423;9656;11.5;6.8
15;2021-03-19;669;33;17092;9689;12.0;6.8
15;2021-03-20;148;38;17240;9727;12.1;6.8
15;2021-03-21;6;0;17246;9727;12.1;6.8
15;2021-03-22;574;82;17820;9809;12.5;6.9
15;2021-03-23;776;102;18596;9911;13.0;6.9
15;2021-03-24;936;36;19532;9947;13.7;7.0
15;2021-03-25;1282;33;20814;9980;14.6;7.0
15;2021-03-26;1010;63;21824;10043;15.3;7.0
15;2021-03-27;301;7;22125;10050;15.5;7.0
15;2021-03-28;20;0;22145;10050;15.5;7.0
15;2021-03-29;782;19;22927;10069;16.1;7.1
15;2021-03-30;1135;205;24062;10274;16.8;7.2
15;2021-03-31;941;28;25003;10302;17.5;7.2
15;2021-04-01;1233;65;26236;10367;18.4;7.3
15;2021-04-02;1141;62;27377;10429;19.2;7.3
15;2021-04-03;120;18;27497;10447;19.3;7.3
15;2021-04-04;0;0;27497;10447;19.3;7.3
15;2021-04-05;33;3;27530;10450;19.3;7.3
15;2021-04-06;834;87;28364;10537;19.9;7.4
15;2021-04-07;663;108;29027;10645;20.3;7.5
15;2021-04-08;1246;151;30273;10796;21.2;7.6
15;2021-04-09;1277;106;31550;10902;22.1;7.6
15;2021-04-10;364;21;31914;10923;22.3;7.6
15;2021-04-11;14;0;31928;10923;22.4;7.6
15;2021-04-12;644;461;32572;11384;22.8;8.0
15;2021-04-13;1124;324;33696;11708;23.6;8.2
15;2021-04-14;1038;199;34734;11907;24.3;8.3
15;2021-04-15;1183;314;35917;12221;25.2;8.6
15;2021-04-16;1038;555;36955;12776;25.9;8.9
15;2021-04-17;445;15;37400;12791;26.2;9.0
15;2021-04-18;0;10;37400;12801;26.2;9.0
15;2021-04-19;537;514;37937;13315;26.6;9.3
15;2021-04-20;847;616;38784;13931;27.2;9.8
15;2021-04-21;592;651;39376;14582;27.6;10.2
15;2021-04-22;728;777;40104;15359;28.1;10.8
15;2021-04-23;730;681;40834;16040;28.6;11.2
15;2021-04-24;363;123;41197;16163;28.8;11.3
15;2021-04-25;1;3;41198;16166;28.8;11.3
15;2021-04-26;325;632;41523;16798;29.1;11.8
15;2021-04-27;467;941;41990;17739;29.4;12.4
15;2021-04-28;383;789;42373;18528;29.7;13.0
15;2021-04-29;587;1014;42960;19542;30.1;13.7
15;2021-04-30;547;1077;43507;20619;30.5;14.4
15;2021-05-01;283;29;43790;20648;30.7;14.5
15;2021-05-02;0;0;43790;20648;30.7;14.5
15;2021-05-03;881;331;44671;20979;31.3;14.7
15;2021-05-04;801;857;45472;21836;31.8;15.3
15;2021-05-05;676;680;46148;22516;32.3;15.8
15;2021-05-06;826;967;46974;23483;32.9;16.4
15;2021-05-07;1154;906;48128;24389;33.7;17.1
15;2021-05-08;491;55;48619;24444;34.0;17.1
15;2021-05-09;24;9;48643;24453;34.1;17.1
15;2021-05-10;704;913;49347;25366;34.6;17.8
15;2021-05-11;1186;1186;50533;26552;35.4;18.6
15;2021-05-12;1147;837;51680;27389;36.2;19.2
15;2021-05-13;1165;440;52845;27829;37.0;19.5
15;2021-05-14;1503;583;54348;28412;38.1;19.9
15;2021-05-15;1410;418;55758;28830;39.0;20.2
15;2021-05-16;1;10;55759;28840;39.0;20.2
15;2021-05-17;999;605;56758;29445;39.7;20.6
15;2021-05-18;1221;970;57979;30415;40.6;21.3
15;2021-05-19;1020;459;58999;30874;41.3;21.6
15;2021-05-20;1239;782;60238;31656;42.2;22.2
15;2021-05-21;1348;749;61586;32405;43.1;22.7
15;2021-05-22;527;188;62113;32593;43.5;22.8
15;2021-05-23;2;11;62115;32604;43.5;22.8
15;2021-05-24;693;257;62808;32861;44.0;23.0
15;2021-05-25;1151;620;63959;33481;44.8;23.4
15;2021-05-26;1093;459;65052;33940;45.6;23.8
15;2021-05-27;1271;660;66323;34600;46.4;24.2
15;2021-05-28;1509;887;67832;35487;47.5;24.8
15;2021-05-29;984;361;68816;35848;48.2;25.1
15;2021-05-30;14;25;68830;35873;48.2;25.1
15;2021-05-31;1199;480;70029;36353;49.0;25.5
15;2021-06-01;1398;570;71427;36923;50.0;25.9
15;2021-06-02;863;418;72290;37341;50.6;26.1
15;2021-06-03;932;704;73222;38045;51.3;26.6
15;2021-06-04;1076;719;74298;38764;52.0;27.1
15;2021-06-05;651;264;74949;39028;52.5;27.3
15;2021-06-06;16;20;74965;39048;52.5;27.3
15;2021-06-07;797;351;75762;39399;53.1;27.6
15;2021-06-08;477;397;76239;39796;53.4;27.9
15;2021-06-09;376;377;76615;40173;53.6;28.1
15;2021-06-10;276;423;76891;40596;53.8;28.4
15;2021-06-11;660;1100;77551;41696;54.3;29.2
15;2021-06-12;377;467;77928;42163;54.6;29.5
15;2021-06-13;11;6;77939;42169;54.6;29.5
15;2021-06-14;542;977;78481;43146;55.0;30.2
15;2021-06-15;450;1164;78931;44310;55.3;31.0
15;2021-06-16;543;899;79474;45209;55.6;31.7
15;2021-06-17;292;934;79766;46143;55.9;32.3
15;2021-06-18;740;1205;80506;47348;56.4;33.2
15;2021-06-19;542;704;81048;48052;56.8;33.6
15;2021-06-20;11;1;81059;48053;56.8;33.6
15;2021-06-21;279;1042;81338;49095;57.0;34.4
15;2021-06-22;232;1480;81570;50575;57.1;35.4
15;2021-06-23;346;1445;81916;52020;57.4;36.4
15;2021-06-24;291;1094;82207;53114;57.6;37.2
15;2021-06-25;378;1641;82585;54755;57.8;38.3
15;2021-06-26;164;908;82749;55663;57.9;39.0
15;2021-06-27;0;0;82749;55663;57.9;39.0
15;2021-06-28;176;1228;82925;56891;58.1;39.8
15;2021-06-29;302;1264;83227;58155;58.3;40.7
15;2021-06-30;268;982;83495;59137;58.5;41.4
15;2021-07-01;380;1220;83875;60357;58.7;42.3
15;2021-07-02;410;1348;84285;61705;59.0;43.2
15;2021-07-03;252;707;84537;62412;59.2;43.7
15;2021-07-04;1;1;84538;62413;59.2;43.7
15;2021-07-05;248;1257;84786;63670;59.4;44.6
15;2021-07-06;275;1469;85061;65139;59.6;45.6
15;2021-07-07;255;1344;85316;66483;59.7;46.6
15;2021-07-08;489;1353;85805;67836;60.1;47.5
15;2021-07-09;488;1784;86293;69620;60.4;48.7
15;2021-07-10;215;862;86508;70482;60.6;49.4
15;2021-07-11;9;5;86517;70487;60.6;49.4
15;2021-07-12;278;1484;86795;71971;60.8;50.4
15;2021-07-13;587;1776;87382;73747;61.2;51.6
15;2021-07-14;16;130;87398;73877;61.2;51.7
15;2021-07-15;1132;729;88530;74606;62.0;52.2
15;2021-07-16;1139;1336;89669;75942;62.8;53.2
15;2021-07-17;819;953;90488;76895;63.4;53.8
15;2021-07-18;0;2;90488;76897;63.4;53.8
15;2021-07-19;1074;1270;91562;78167;64.1;54.7
15;2021-07-20;1612;570;93174;78737;65.2;55.1
15;2021-07-21;1189;603;94363;79340;66.1;55.6
15;2021-07-22;894;512;95257;79852;66.7;55.9
15;2021-07-23;1341;1065;96598;80917;67.6;56.7
15;2021-07-24;628;770;97226;81687;68.1;57.2
15;2021-07-25;1;24;97227;81711;68.1;57.2
15;2021-07-26;1247;594;98474;82305;69.0;57.6
15;2021-07-27;1691;576;100165;82881;70.1;58.0
15;2021-07-28;1238;584;101403;83465;71.0;58.4
15;2021-07-29;838;402;102241;83867;71.6;58.7
15;2021-07-30;1007;1131;103248;84998;72.3;59.5
15;2021-07-31;603;636;103851;85634;72.7;60.0
15;2021-08-01;21;12;103872;85646;72.7;60.0
15;2021-08-02;1143;543;105015;86189;73.5;60.4
15;2021-08-03;1162;383;106177;86572;74.3;60.6
15;2021-08-04;788;408;106965;86980;74.9;60.9
15;2021-08-05;383;284;107348;87264;75.2;61.1
15;2021-08-06;788;1236;108136;88500;75.7;62.0
15;2021-08-07;265;1160;108401;89660;75.9;62.8
15;2021-08-08;3;6;108404;89666;75.9;62.8
15;2021-08-09;511;1164;108915;90830;76.3;63.6
15;2021-08-10;435;725;109350;91555;76.6;64.1
15;2021-08-11;411;1007;109761;92562;76.9;64.8
15;2021-08-12;520;1182;110281;93744;77.2;65.6
15;2021-08-13;681;1136;110962;94880;77.7;66.4
15;2021-08-14;179;552;111141;95432;77.8;66.8
15;2021-08-15;17;9;111158;95441;77.8;66.8
15;2021-08-16;387;1134;111545;96575;78.1;67.6
15;2021-08-17;402;1140;111947;97715;78.4;68.4
15;2021-08-18;367;803;112314;98518;78.6;69.0
15;2021-08-19;300;878;112614;99396;78.9;69.6
15;2021-08-20;601;1215;113215;100611;79.3;70.5
15;2021-08-21;218;867;113433;101478;79.4;71.1
15;2021-08-22;12;26;113445;101504;79.4;71.1
15;2021-08-23;229;611;113674;102115;79.6;71.5
15;2021-08-24;245;590;113919;102705;79.8;71.9
15;2021-08-25;155;493;114074;103198;79.9;72.3
15;2021-08-26;136;363;114210;103561;80.0;72.5
15;2021-08-27;366;1337;114576;104898;80.2;73.5
15;2021-08-28;214;857;114790;105755;80.4;74.1
15;2021-08-29;7;13;114797;105768;80.4;74.1
15;2021-08-30;225;1056;115022;106824;80.5;74.8
15;2021-08-31;404;649;115426;107473;80.8;75.3
15;2021-09-01;182;402;115608;107875;81.0;75.5
15;2021-09-02;97;229;115705;108104;81.0;75.7
15;2021-09-03;201;889;115906;108993;81.2;76.3
15;2021-09-04;157;358;116063;109351;81.3;76.6
15;2021-09-05;0;2;116063;109353;81.3;76.6
15;2021-09-06;98;303;116161;109656;81.3;76.8
15;2021-09-07;100;197;116261;109853;81.4;76.9
15;2021-09-08;201;410;116462;110263;81.5;77.2
15;2021-09-09;100;314;116562;110577;81.6;77.4
15;2021-09-10;233;760;116795;111337;81.8;78.0
15;2021-09-11;95;290;116890;111627;81.8;78.2
15;2021-09-12;0;0;116890;111627;81.8;78.2
15;2021-09-13;102;265;116992;111892;81.9;78.3
15;2021-09-14;124;107;117116;111999;82.0;78.4
15;2021-09-15;69;247;117185;112246;82.1;78.6
15;2021-09-16;34;101;117219;112347;82.1;78.7
15;2021-09-17;266;605;117485;112952;82.3;79.1
15;2021-09-18;79;380;117564;113332;82.3;79.4
15;2021-09-19;0;0;117564;113332;82.3;79.4
15;2021-09-20;123;217;117687;113549;82.4;79.5
15;2021-09-21;41;107;117728;113656;82.4;79.6
15;2021-09-22;84;355;117812;114011;82.5;79.8
15;2021-09-23;37;109;117849;114120;82.5;79.9
15;2021-09-24;138;334;117987;114454;82.6;80.1
15;2021-09-25;42;217;118029;114671;82.6;80.3
15;2021-09-26;1;5;118030;114676;82.6;80.3
15;2021-09-27;88;133;118118;114809;82.7;80.4
15;2021-09-28;74;131;118192;114940;82.8;80.5
15;2021-09-29;69;191;118261;115131;82.8;80.6
15;2021-09-30;37;94;118298;115225;82.8;80.7
15;2021-10-01;117;216;118415;115441;82.9;80.8
15;2021-10-02;30;143;118445;115584;82.9;80.9
15;2021-10-03;0;2;118445;115586;82.9;80.9
15;2021-10-04;59;59;118504;115645;83.0;81.0
15;2021-10-05;35;51;118539;115696;83.0;81.0
15;2021-10-06;79;105;118618;115801;83.1;81.1
15;2021-10-07;46;91;118664;115892;83.1;81.2
15;2021-10-08;54;174;118718;116066;83.1;81.3
15;2021-10-09;54;107;118772;116173;83.2;81.3
15;2021-10-10;1;6;118773;116179;83.2;81.4
15;2021-10-11;50;163;118823;116342;83.2;81.5
15;2021-10-12;36;60;118859;116402;83.2;81.5
15;2021-10-13;76;152;118935;116554;83.3;81.6
15;2021-10-14;24;21;118959;116575;83.3;81.6
16;2020-12-27;0;0;0;0;0.0;0.0
16;2020-12-28;2;0;2;0;0.0;0.0
16;2020-12-29;0;0;2;0;0.0;0.0
16;2020-12-30;1;0;3;0;0.0;0.0
16;2020-12-31;0;0;3;0;0.0;0.0
16;2021-01-01;0;0;3;0;0.0;0.0
16;2021-01-02;0;0;3;0;0.0;0.0
16;2021-01-03;0;0;3;0;0.0;0.0
16;2021-01-04;1;0;4;0;0.0;0.0
16;2021-01-05;1;0;5;0;0.0;0.0
16;2021-01-06;88;0;93;0;0.0;0.0
16;2021-01-07;240;0;333;0;0.1;0.0
16;2021-01-08;465;2;798;2;0.2;0.0
16;2021-01-09;1;0;799;2;0.2;0.0
16;2021-01-10;1;0;800;2;0.2;0.0
16;2021-01-11;304;0;1104;2;0.3;0.0
16;2021-01-12;437;1;1541;3;0.4;0.0
16;2021-01-13;480;1;2021;4;0.6;0.0
16;2021-01-14;601;7;2622;11;0.8;0.0
16;2021-01-15;503;3;3125;14;0.9;0.0
16;2021-01-16;0;0;3125;14;0.9;0.0
16;2021-01-17;0;0;3125;14;0.9;0.0
16;2021-01-18;432;5;3557;19;1.0;0.0
16;2021-01-19;835;2;4392;21;1.3;0.0
16;2021-01-20;1188;3;5580;24;1.6;0.0
16;2021-01-21;1384;13;6964;37;2.0;0.0
16;2021-01-22;1115;3;8079;40;2.3;0.0
16;2021-01-23;183;2;8262;42;2.4;0.0
16;2021-01-24;0;0;8262;42;2.4;0.0
16;2021-01-25;641;3;8903;45;2.6;0.0
16;2021-01-26;1026;2;9929;47;2.9;0.0
16;2021-01-27;1406;105;11335;152;3.3;0.0
16;2021-01-28;1276;72;12611;224;3.6;0.1
16;2021-01-29;742;141;13353;365;3.8;0.1
16;2021-01-30;36;0;13389;365;3.8;0.1
16;2021-01-31;0;0;13389;365;3.8;0.1
16;2021-02-01;395;203;13784;568;4.0;0.2
16;2021-02-02;576;175;14360;743;4.1;0.2
16;2021-02-03;621;350;14981;1093;4.3;0.3
16;2021-02-04;465;269;15446;1362;4.4;0.4
16;2021-02-05;505;275;15951;1637;4.6;0.5
16;2021-02-06;4;80;15955;1717;4.6;0.5
16;2021-02-07;41;3;15996;1720;4.6;0.5
16;2021-02-08;357;217;16353;1937;4.7;0.6
16;2021-02-09;650;294;17003;2231;4.9;0.6
16;2021-02-10;694;677;17697;2908;5.1;0.8
16;2021-02-11;805;617;18502;3525;5.3;1.0
16;2021-02-12;622;835;19124;4360;5.5;1.3
16;2021-02-13;43;79;19167;4439;5.5;1.3
16;2021-02-14;3;7;19170;4446;5.5;1.3
16;2021-02-15;217;661;19387;5107;5.6;1.5
16;2021-02-16;375;952;19762;6059;5.7;1.7
16;2021-02-17;346;1306;20108;7365;5.8;2.1
16;2021-02-18;511;1249;20619;8614;5.9;2.5
16;2021-02-19;389;784;21008;9398;6.0;2.7
16;2021-02-20;3;8;21011;9406;6.0;2.7
16;2021-02-21;2;0;21013;9406;6.0;2.7
16;2021-02-22;136;529;21149;9935;6.1;2.9
16;2021-02-23;207;922;21356;10857;6.1;3.1
16;2021-02-24;277;894;21633;11751;6.2;3.4
16;2021-02-25;395;689;22028;12440;6.3;3.6
16;2021-02-26;478;501;22506;12941;6.5;3.7
16;2021-02-27;249;1;22755;12942;6.5;3.7
16;2021-02-28;5;5;22760;12947;6.5;3.7
16;2021-03-01;152;329;22912;13276;6.6;3.8
16;2021-03-02;271;671;23183;13947;6.7;4.0
16;2021-03-03;391;725;23574;14672;6.8;4.2
16;2021-03-04;804;571;24378;15243;7.0;4.4
16;2021-03-05;1143;545;25521;15788;7.3;4.5
16;2021-03-06;753;16;26274;15804;7.5;4.5
16;2021-03-07;94;18;26368;15822;7.6;4.5
16;2021-03-08;437;321;26805;16143;7.7;4.6
16;2021-03-09;774;699;27579;16842;7.9;4.8
16;2021-03-10;606;665;28185;17507;8.1;5.0
16;2021-03-11;1448;539;29633;18046;8.5;5.2
16;2021-03-12;1165;462;30798;18508;8.8;5.3
16;2021-03-13;765;15;31563;18523;9.1;5.3
16;2021-03-14;1;0;31564;18523;9.1;5.3
16;2021-03-15;462;185;32026;18708;9.2;5.4
16;2021-03-16;860;423;32886;19131;9.4;5.5
16;2021-03-17;591;284;33477;19415;9.6;5.6
16;2021-03-18;1033;283;34510;19698;9.9;5.7
16;2021-03-19;1103;247;35613;19945;10.2;5.7
16;2021-03-20;396;5;36009;19950;10.3;5.7
16;2021-03-21;9;0;36018;19950;10.3;5.7
16;2021-03-22;728;101;36746;20051;10.6;5.8
16;2021-03-23;1464;107;38210;20158;11.0;5.8
16;2021-03-24;1123;186;39333;20344;11.3;5.8
16;2021-03-25;2047;94;41380;20438;11.9;5.9
16;2021-03-26;1918;99;43298;20537;12.4;5.9
16;2021-03-27;432;22;43730;20559;12.6;5.9
16;2021-03-28;0;0;43730;20559;12.6;5.9
16;2021-03-29;923;60;44653;20619;12.8;5.9
16;2021-03-30;1882;179;46535;20798;13.4;6.0
16;2021-03-31;1513;135;48048;20933;13.8;6.0
16;2021-04-01;2009;402;50057;21335;14.4;6.1
16;2021-04-02;1442;381;51499;21716;14.8;6.2
16;2021-04-03;288;5;51787;21721;14.9;6.2
16;2021-04-04;1;0;51788;21721;14.9;6.2
16;2021-04-05;2;0;51790;21721;14.9;6.2
16;2021-04-06;2013;548;53803;22269;15.5;6.4
16;2021-04-07;1953;407;55756;22676;16.0;6.5
16;2021-04-08;2823;591;58579;23267;16.8;6.7
16;2021-04-09;2694;555;61273;23822;17.6;6.8
16;2021-04-10;1290;38;62563;23860;18.0;6.9
16;2021-04-11;2;0;62565;23860;18.0;6.9
16;2021-04-12;1430;316;63995;24176;18.4;6.9
16;2021-04-13;2124;841;66119;25017;19.0;7.2
16;2021-04-14;1951;634;68070;25651;19.6;7.4
16;2021-04-15;2102;985;70172;26636;20.2;7.7
16;2021-04-16;2043;790;72215;27426;20.7;7.9
16;2021-04-17;1507;93;73722;27519;21.2;7.9
16;2021-04-18;197;3;73919;27522;21.2;7.9
16;2021-04-19;1440;524;75359;28046;21.6;8.1
16;2021-04-20;2053;1234;77412;29280;22.2;8.4
16;2021-04-21;1776;752;79188;30032;22.7;8.6
16;2021-04-22;2290;1010;81478;31042;23.4;8.9
16;2021-04-23;2362;1174;83840;32216;24.1;9.3
16;2021-04-24;829;38;84669;32254;24.3;9.3
16;2021-04-25;117;6;84786;32260;24.4;9.3
16;2021-04-26;1400;810;86186;33070;24.8;9.5
16;2021-04-27;2055;1417;88241;34487;25.3;9.9
16;2021-04-28;1592;1127;89833;35614;25.8;10.2
16;2021-04-29;2250;1501;92083;37115;26.4;10.7
16;2021-04-30;2856;1344;94939;38459;27.3;11.0
16;2021-05-01;353;60;95292;38519;27.4;11.1
16;2021-05-02;155;13;95447;38532;27.4;11.1
16;2021-05-03;2611;538;98058;39070;28.2;11.2
16;2021-05-04;2057;2046;100115;41116;28.8;11.8
16;2021-05-05;1688;1832;101803;42948;29.2;12.3
16;2021-05-06;1886;2248;103689;45196;29.8;13.0
16;2021-05-07;3072;2123;106761;47319;30.7;13.6
16;2021-05-08;1197;468;107958;47787;31.0;13.7
16;2021-05-09;530;27;108488;47814;31.2;13.7
16;2021-05-10;1930;1624;110418;49438;31.7;14.2
16;2021-05-11;2354;1965;112772;51403;32.4;14.8
16;2021-05-12;1734;1799;114506;53202;32.9;15.3
16;2021-05-13;1461;355;115967;53557;33.3;15.4
16;2021-05-14;1989;1563;117956;55120;33.9;15.8
16;2021-05-15;596;895;118552;56015;34.0;16.1
16;2021-05-16;132;6;118684;56021;34.1;16.1
16;2021-05-17;1609;1286;120293;57307;34.5;16.5
16;2021-05-18;2756;1426;123049;58733;35.3;16.9
16;2021-05-19;2006;1241;125055;59974;35.9;17.2
16;2021-05-20;2832;1389;127887;61363;36.7;17.6
16;2021-05-21;2943;1396;130830;62759;37.6;18.0
16;2021-05-22;411;711;131241;63470;37.7;18.2
16;2021-05-23;210;11;131451;63481;37.8;18.2
16;2021-05-24;1262;234;132713;63715;38.1;18.3
16;2021-05-25;2759;1461;135472;65176;38.9;18.7
16;2021-05-26;1833;1186;137305;66362;39.4;19.1
16;2021-05-27;2416;1583;139721;67945;40.1;19.5
16;2021-05-28;2899;1565;142620;69510;41.0;20.0
16;2021-05-29;814;883;143434;70393;41.2;20.2
16;2021-05-30;1;4;143435;70397;41.2;20.2
16;2021-05-31;1984;1105;145419;71502;41.8;20.5
16;2021-06-01;2344;1713;147763;73215;42.4;21.0
16;2021-06-02;1820;1502;149583;74717;43.0;21.5
16;2021-06-03;2622;1761;152205;76478;43.7;22.0
16;2021-06-04;2833;2030;155038;78508;44.5;22.5
16;2021-06-05;1006;549;156044;79057;44.8;22.7
16;2021-06-06;161;29;156205;79086;44.9;22.7
16;2021-06-07;1991;1281;158196;80367;45.4;23.1
16;2021-06-08;2394;1998;160590;82365;46.1;23.7
16;2021-06-09;2528;1616;163118;83981;46.8;24.1
16;2021-06-10;2569;2003;165687;85984;47.6;24.7
16;2021-06-11;2152;2733;167839;88717;48.2;25.5
16;2021-06-12;1613;517;169452;89234;48.7;25.6
16;2021-06-13;260;72;169712;89306;48.7;25.6
16;2021-06-14;797;2798;170509;92104;49.0;26.5
16;2021-06-15;1866;2623;172375;94727;49.5;27.2
16;2021-06-16;1575;2083;173950;96810;50.0;27.8
16;2021-06-17;2040;2509;175990;99319;50.5;28.5
16;2021-06-18;2060;3217;178050;102536;51.1;29.4
16;2021-06-19;1351;1311;179401;103847;51.5;29.8
16;2021-06-20;243;28;179644;103875;51.6;29.8
16;2021-06-21;1411;2168;181055;106043;52.0;30.5
16;2021-06-22;1675;2943;182730;108986;52.5;31.3
16;2021-06-23;1562;2016;184292;111002;52.9;31.9
16;2021-06-24;1928;2167;186220;113169;53.5;32.5
16;2021-06-25;1983;2727;188203;115896;54.1;33.3
16;2021-06-26;1060;725;189263;116621;54.4;33.5
16;2021-06-27;132;25;189395;116646;54.4;33.5
16;2021-06-28;1164;1964;190559;118610;54.7;34.1
16;2021-06-29;1282;3365;191841;121975;55.1;35.0
16;2021-06-30;1337;2714;193178;124689;55.5;35.8
16;2021-07-01;1865;3156;195043;127845;56.0;36.7
16;2021-07-02;1422;3580;196465;131425;56.4;37.7
16;2021-07-03;696;1111;197161;132536;56.6;38.1
16;2021-07-04;3;15;197164;132551;56.6;38.1
16;2021-07-05;815;2298;197979;134849;56.9;38.7
16;2021-07-06;1278;3366;199257;138215;57.2;39.7
16;2021-07-07;871;2276;200128;140491;57.5;40.4
16;2021-07-08;1234;2736;201362;143227;57.8;41.1
16;2021-07-09;1113;3709;202475;146936;58.2;42.2
16;2021-07-10;338;1338;202813;148274;58.2;42.6
16;2021-07-11;2;13;202815;148287;58.3;42.6
16;2021-07-12;634;2436;203449;150723;58.4;43.3
16;2021-07-13;1385;3530;204834;154253;58.8;44.3
16;2021-07-14;797;877;205631;155130;59.1;44.6
16;2021-07-15;1250;3408;206881;158538;59.4;45.5
16;2021-07-16;1498;3383;208379;161921;59.8;46.5
16;2021-07-17;539;1188;208918;163109;60.0;46.8
16;2021-07-18;14;6;208932;163115;60.0;46.8
16;2021-07-19;618;2853;209550;165968;60.2;47.7
16;2021-07-20;1125;3288;210675;169256;60.5;48.6
16;2021-07-21;1117;2619;211792;171875;60.8;49.4
16;2021-07-22;1872;2862;213664;174737;61.4;50.2
16;2021-07-23;1552;3545;215216;178282;61.8;51.2
16;2021-07-24;639;1212;215855;179494;62.0;51.6
16;2021-07-25;11;11;215866;179505;62.0;51.6
16;2021-07-26;1529;2129;217395;181634;62.4;52.2
16;2021-07-27;1866;2819;219261;184453;63.0;53.0
16;2021-07-28;1864;2311;221125;186764;63.5;53.6
16;2021-07-29;2241;2477;223366;189241;64.2;54.4
16;2021-07-30;2355;3109;225721;192350;64.8;55.2
16;2021-07-31;960;1353;226681;193703;65.1;55.6
16;2021-08-01;192;22;226873;193725;65.2;55.6
16;2021-08-02;2121;1829;228994;195554;65.8;56.2
16;2021-08-03;2120;2328;231114;197882;66.4;56.8
16;2021-08-04;2122;1886;233236;199768;67.0;57.4
16;2021-08-05;2775;1655;236011;201423;67.8;57.9
16;2021-08-06;2512;2365;238523;203788;68.5;58.5
16;2021-08-07;828;559;239351;204347;68.7;58.7
16;2021-08-08;37;33;239388;204380;68.8;58.7
16;2021-08-09;2183;1061;241571;205441;69.4;59.0
16;2021-08-10;2886;1586;244457;207027;70.2;59.5
16;2021-08-11;2603;1232;247060;208259;71.0;59.8
16;2021-08-12;2012;1735;249072;209994;71.5;60.3
16;2021-08-13;2686;1468;251758;211462;72.3;60.7
16;2021-08-14;758;455;252516;211917;72.5;60.9
16;2021-08-15;29;4;252545;211921;72.5;60.9
16;2021-08-16;1339;1582;253884;213503;72.9;61.3
16;2021-08-17;1837;1628;255721;215131;73.4;61.8
16;2021-08-18;1591;1471;257312;216602;73.9;62.2
16;2021-08-19;1517;1777;258829;218379;74.3;62.7
16;2021-08-20;1602;1902;260431;220281;74.8;63.3
16;2021-08-21;564;827;260995;221108;75.0;63.5
16;2021-08-22;4;5;260999;221113;75.0;63.5
16;2021-08-23;993;2064;261992;223177;75.2;64.1
16;2021-08-24;1040;2376;263032;225553;75.5;64.8
16;2021-08-25;887;1781;263919;227334;75.8;65.3
16;2021-08-26;880;2531;264799;229865;76.1;66.0
16;2021-08-27;853;2408;265652;232273;76.3;66.7
16;2021-08-28;261;771;265913;233044;76.4;66.9
16;2021-08-29;2;15;265915;233059;76.4;66.9
16;2021-08-30;638;2373;266553;235432;76.6;67.6
16;2021-08-31;668;2545;267221;237977;76.7;68.3
16;2021-09-01;469;2355;267690;240332;76.9;69.0
16;2021-09-02;544;2078;268234;242410;77.0;69.6
16;2021-09-03;544;2543;268778;244953;77.2;70.4
16;2021-09-04;365;904;269143;245857;77.3;70.6
16;2021-09-05;6;29;269149;245886;77.3;70.6
16;2021-09-06;318;1457;269467;247343;77.4;71.0
16;2021-09-07;355;1673;269822;249016;77.5;71.5
16;2021-09-08;392;1989;270214;251005;77.6;72.1
16;2021-09-09;351;1497;270565;252502;77.7;72.5
16;2021-09-10;440;1767;271005;254269;77.8;73.0
16;2021-09-11;185;786;271190;255055;77.9;73.3
16;2021-09-12;6;21;271196;255076;77.9;73.3
16;2021-09-13;256;1066;271452;256142;78.0;73.6
16;2021-09-14;372;956;271824;257098;78.1;73.8
16;2021-09-15;349;1349;272173;258447;78.2;74.2
16;2021-09-16;303;888;272476;259335;78.3;74.5
16;2021-09-17;500;1376;272976;260711;78.4;74.9
16;2021-09-18;100;535;273076;261246;78.4;75.0
16;2021-09-19;0;9;273076;261255;78.4;75.0
16;2021-09-20;195;722;273271;261977;78.5;75.2
16;2021-09-21;184;674;273455;262651;78.5;75.4
16;2021-09-22;186;990;273641;263641;78.6;75.7
16;2021-09-23;170;559;273811;264200;78.6;75.9
16;2021-09-24;338;1049;274149;265249;78.7;76.2
16;2021-09-25;64;439;274213;265688;78.8;76.3
16;2021-09-26;1;6;274214;265694;78.8;76.3
16;2021-09-27;193;582;274407;266276;78.8;76.5
16;2021-09-28;145;536;274552;266812;78.9;76.6
16;2021-09-29;198;606;274750;267418;78.9;76.8
16;2021-09-30;115;482;274865;267900;78.9;76.9
16;2021-10-01;241;540;275106;268440;79.0;77.1
16;2021-10-02;81;324;275187;268764;79.0;77.2
16;2021-10-03;0;7;275187;268771;79.0;77.2
16;2021-10-04;117;356;275304;269127;79.1;77.3
16;2021-10-05;122;375;275426;269502;79.1;77.4
16;2021-10-06;182;510;275608;270012;79.2;77.5
16;2021-10-07;122;315;275730;270327;79.2;77.6
16;2021-10-08;232;673;275962;271000;79.3;77.8
16;2021-10-09;76;181;276038;271181;79.3;77.9
16;2021-10-10;1;10;276039;271191;79.3;77.9
16;2021-10-11;106;274;276145;271465;79.3;78.0
16;2021-10-12;96;221;276241;271686;79.3;78.0
16;2021-10-13;198;341;276439;272027;79.4;78.1
16;2021-10-14;85;163;276524;272190;79.4;78.2
17;2020-12-27;0;0;0;0;0.0;0.0
17;2020-12-28;0;0;0;0;0.0;0.0
17;2020-12-29;0;0;0;0;0.0;0.0
17;2020-12-30;1;0;1;0;0.0;0.0
17;2020-12-31;0;0;1;0;0.0;0.0
17;2021-01-01;1;0;2;0;0.0;0.0
17;2021-01-02;1;0;3;0;0.0;0.0
17;2021-01-03;0;0;3;0;0.0;0.0
17;2021-01-04;56;0;59;0;0.0;0.0
17;2021-01-05;98;0;157;0;0.0;0.0
17;2021-01-06;132;0;289;0;0.0;0.0
17;2021-01-07;484;1;773;1;0.1;0.0
17;2021-01-08;418;1;1191;2;0.2;0.0
17;2021-01-09;0;0;1191;2;0.2;0.0
17;2021-01-10;1;0;1192;2;0.2;0.0
17;2021-01-11;381;2;1573;4;0.2;0.0
17;2021-01-12;751;1;2324;5;0.4;0.0
17;2021-01-13;655;2;2979;7;0.5;0.0
17;2021-01-14;616;9;3595;16;0.6;0.0
17;2021-01-15;681;2;4276;18;0.7;0.0
17;2021-01-16;129;2;4405;20;0.7;0.0
17;2021-01-17;19;0;4424;20;0.7;0.0
17;2021-01-18;887;5;5311;25;0.8;0.0
17;2021-01-19;1910;17;7221;42;1.1;0.0
17;2021-01-20;2396;4;9617;46;1.5;0.0
17;2021-01-21;2500;6;12117;52;1.9;0.0
17;2021-01-22;1893;15;14010;67;2.2;0.0
17;2021-01-23;738;1;14748;68;2.3;0.0
17;2021-01-24;50;0;14798;68;2.3;0.0
17;2021-01-25;1382;5;16180;73;2.5;0.0
17;2021-01-26;2110;5;18290;78;2.8;0.0
17;2021-01-27;1676;33;19966;111;3.1;0.0
17;2021-01-28;2476;232;22442;343;3.5;0.1
17;2021-01-29;1740;222;24182;565;3.7;0.1
17;2021-01-30;528;5;24710;570;3.8;0.1
17;2021-01-31;37;2;24747;572;3.8;0.1
17;2021-02-01;741;210;25488;782;3.9;0.1
17;2021-02-02;1202;347;26690;1129;4.1;0.2
17;2021-02-03;1300;401;27990;1530;4.3;0.2
17;2021-02-04;1162;503;29152;2033;4.5;0.3
17;2021-02-05;603;757;29755;2790;4.6;0.4
17;2021-02-06;25;43;29780;2833;4.6;0.4
17;2021-02-07;31;13;29811;2846;4.6;0.4
17;2021-02-08;706;400;30517;3246;4.7;0.5
17;2021-02-09;1102;1316;31619;4562;4.9;0.7
17;2021-02-10;866;1288;32485;5850;5.0;0.9
17;2021-02-11;1241;1402;33726;7252;5.2;1.1
17;2021-02-12;774;966;34500;8218;5.3;1.3
17;2021-02-13;43;104;34543;8322;5.3;1.3
17;2021-02-14;1;10;34544;8332;5.3;1.3
17;2021-02-15;621;1221;35165;9553;5.4;1.5
17;2021-02-16;752;1827;35917;11380;5.6;1.8
17;2021-02-17;795;1356;36712;12736;5.7;2.0
17;2021-02-18;965;2185;37677;14921;5.8;2.3
17;2021-02-19;1069;1539;38746;16460;6.0;2.5
17;2021-02-20;105;311;38851;16771;6.0;2.6
17;2021-02-21;9;2;38860;16773;6.0;2.6
17;2021-02-22;650;1630;39510;18403;6.1;2.8
17;2021-02-23;782;1535;40292;19938;6.2;3.1
17;2021-02-24;1080;1586;41372;21524;6.4;3.3
17;2021-02-25;1087;1708;42459;23232;6.6;3.6
17;2021-02-26;1308;1296;43767;24528;6.8;3.8
17;2021-02-27;529;248;44296;24776;6.8;3.8
17;2021-02-28;19;9;44315;24785;6.8;3.8
17;2021-03-01;638;1042;44953;25827;6.9;4.0
17;2021-03-02;1095;870;46048;26697;7.1;4.1
17;2021-03-03;1617;795;47665;27492;7.4;4.2
17;2021-03-04;2426;1143;50091;28635;7.7;4.4
17;2021-03-05;2665;683;52756;29318;8.2;4.5
17;2021-03-06;1028;32;53784;29350;8.3;4.5
17;2021-03-07;183;47;53967;29397;8.3;4.5
17;2021-03-08;1019;836;54986;30233;8.5;4.7
17;2021-03-09;1745;621;56731;30854;8.8;4.8
17;2021-03-10;2048;648;58779;31502;9.1;4.9
17;2021-03-11;3228;999;62007;32501;9.6;5.0
17;2021-03-12;3356;630;65363;33131;10.1;5.1
17;2021-03-13;1203;13;66566;33144;10.3;5.1
17;2021-03-14;33;0;66599;33144;10.3;5.1
17;2021-03-15;1243;996;67842;34140;10.5;5.3
17;2021-03-16;892;536;68734;34676;10.6;5.4
17;2021-03-17;1460;707;70194;35383;10.8;5.5
17;2021-03-18;1683;766;71877;36149;11.1;5.6
17;2021-03-19;2096;549;73973;36698;11.4;5.7
17;2021-03-20;1086;59;75059;36757;11.6;5.7
17;2021-03-21;37;43;75096;36800;11.6;5.7
17;2021-03-22;1577;693;76673;37493;11.8;5.8
17;2021-03-23;2491;583;79164;38076;12.2;5.9
17;2021-03-24;3545;861;82709;38937;12.8;6.0
17;2021-03-25;4713;650;87422;39587;13.5;6.1
17;2021-03-26;4943;478;92365;40065;14.3;6.2
17;2021-03-27;1737;69;94102;40134;14.5;6.2
17;2021-03-28;369;45;94471;40179;14.6;6.2
17;2021-03-29;2361;569;96832;40748;15.0;6.3
17;2021-03-30;2654;990;99486;41738;15.4;6.5
17;2021-03-31;3843;912;103329;42650;16.0;6.6
17;2021-04-01;4013;1170;107342;43820;16.6;6.8
17;2021-04-02;3708;841;111050;44661;17.2;6.9
17;2021-04-03;1152;187;112202;44848;17.3;6.9
17;2021-04-04;501;6;112703;44854;17.4;6.9
17;2021-04-05;445;128;113148;44982;17.5;7.0
17;2021-04-06;3479;1032;116627;46014;18.0;7.1
17;2021-04-07;4132;1159;120759;47173;18.7;7.3
17;2021-04-08;4567;1482;125326;48655;19.4;7.5
17;2021-04-09;6498;846;131824;49501;20.4;7.6
17;2021-04-10;2582;72;134406;49573;20.8;7.7
17;2021-04-11;790;18;135196;49591;20.9;7.7
17;2021-04-12;2889;1624;138085;51215;21.3;7.9
17;2021-04-13;4152;1289;142237;52504;22.0;8.1
17;2021-04-14;4419;1214;146656;53718;22.7;8.3
17;2021-04-15;4601;1140;151257;54858;23.4;8.5
17;2021-04-16;4298;1155;155555;56013;24.0;8.7
17;2021-04-17;1682;384;157237;56397;24.3;8.7
17;2021-04-18;471;81;157708;56478;24.4;8.7
17;2021-04-19;2336;2063;160044;58541;24.7;9.0
17;2021-04-20;2927;2558;162971;61099;25.2;9.4
17;2021-04-21;2974;1942;165945;63041;25.6;9.7
17;2021-04-22;3121;2366;169066;65407;26.1;10.1
17;2021-04-23;2446;2731;171512;68138;26.5;10.5
17;2021-04-24;1669;929;173181;69067;26.8;10.7
17;2021-04-25;664;246;173845;69313;26.9;10.7
17;2021-04-26;2578;2627;176423;71940;27.3;11.1
17;2021-04-27;3151;2672;179574;74612;27.8;11.5
17;2021-04-28;3102;2940;182676;77552;28.2;12.0
17;2021-04-29;4149;2867;186825;80419;28.9;12.4
17;2021-04-30;4355;2640;191180;83059;29.5;12.8
17;2021-05-01;849;543;192029;83602;29.7;12.9
17;2021-05-02;553;839;192582;84441;29.8;13.0
17;2021-05-03;2546;2963;195128;87404;30.2;13.5
17;2021-05-04;2315;3726;197443;91130;30.5;14.1
17;2021-05-05;2907;3704;200350;94834;31.0;14.7
17;2021-05-06;4120;3405;204470;98239;31.6;15.2
17;2021-05-07;4359;3633;208829;101872;32.3;15.7
17;2021-05-08;1306;753;210135;102625;32.5;15.9
17;2021-05-09;1311;706;211446;103331;32.7;16.0
17;2021-05-10;2726;3694;214172;107025;33.1;16.5
17;2021-05-11;3500;3997;217672;111022;33.6;17.2
17;2021-05-12;3529;3813;221201;114835;34.2;17.7
17;2021-05-13;2542;693;223743;115528;34.6;17.9
17;2021-05-14;3031;2394;226774;117922;35.0;18.2
17;2021-05-15;2127;662;228901;118584;35.4;18.3
17;2021-05-16;1733;318;230634;118902;35.6;18.4
17;2021-05-17;4288;1999;234922;120901;36.3;18.7
17;2021-05-18;4746;1637;239668;122538;37.0;18.9
17;2021-05-19;5071;1281;244739;123819;37.8;19.1
17;2021-05-20;4940;1947;249679;125766;38.6;19.4
17;2021-05-21;4994;1955;254673;127721;39.4;19.7
17;2021-05-22;2390;532;257063;128253;39.7;19.8
17;2021-05-23;1900;128;258963;128381;40.0;19.8
17;2021-05-24;1426;210;260389;128591;40.2;19.9
17;2021-05-25;4031;1769;264420;130360;40.9;20.1
17;2021-05-26;4368;2040;268788;132400;41.5;20.5
17;2021-05-27;5211;2139;273999;134539;42.3;20.8
17;2021-05-28;4469;3437;278468;137976;43.0;21.3
17;2021-05-29;1559;1707;280027;139683;43.3;21.6
17;2021-05-30;857;410;280884;140093;43.4;21.7
17;2021-05-31;2947;3013;283831;143106;43.9;22.1
17;2021-06-01;4295;2927;288126;146033;44.5;22.6
17;2021-06-02;4203;3177;292329;149210;45.2;23.1
17;2021-06-03;5058;3167;297387;152377;46.0;23.5
17;2021-06-04;4513;3859;301900;156236;46.7;24.1
17;2021-06-05;1991;1603;303891;157839;47.0;24.4
17;2021-06-06;852;735;304743;158574;47.1;24.5
17;2021-06-07;3138;4345;307881;162919;47.6;25.2
17;2021-06-08;3790;4496;311671;167415;48.2;25.9
17;2021-06-09;4345;3055;316016;170470;48.8;26.3
17;2021-06-10;4927;2794;320943;173264;49.6;26.8
17;2021-06-11;4794;3693;325737;176957;50.3;27.3
17;2021-06-12;1813;1405;327550;178362;50.6;27.6
17;2021-06-13;612;415;328162;178777;50.7;27.6
17;2021-06-14;2834;4538;330996;183315;51.2;28.3
17;2021-06-15;3625;4382;334621;187697;51.7;29.0
17;2021-06-16;4127;3695;338748;191392;52.4;29.6
17;2021-06-17;4367;4125;343115;195517;53.0;30.2
17;2021-06-18;4059;4441;347174;199958;53.7;30.9
17;2021-06-19;1450;1988;348624;201946;53.9;31.2
17;2021-06-20;595;1036;349219;202982;54.0;31.4
17;2021-06-21;2558;4371;351777;207353;54.4;32.0
17;2021-06-22;3532;4453;355309;211806;54.9;32.7
17;2021-06-23;3795;3998;359104;215804;55.5;33.4
17;2021-06-24;3600;3959;362704;219763;56.1;34.0
17;2021-06-25;2718;4991;365422;224754;56.5;34.7
17;2021-06-26;905;2334;366327;227088;56.6;35.1
17;2021-06-27;397;1904;366724;228992;56.7;35.4
17;2021-06-28;1522;5416;368246;234408;56.9;36.2
17;2021-06-29;1684;5892;369930;240300;57.2;37.1
17;2021-06-30;2030;5549;371960;245849;57.5;38.0
17;2021-07-01;2267;5562;374227;251411;57.8;38.9
17;2021-07-02;2485;5983;376712;257394;58.2;39.8
17;2021-07-03;627;2544;377339;259938;58.3;40.2
17;2021-07-04;155;1250;377494;261188;58.3;40.4
17;2021-07-05;1887;5176;379381;266364;58.6;41.2
17;2021-07-06;2128;5600;381509;271964;59.0;42.0
17;2021-07-07;2406;5500;383915;277464;59.3;42.9
17;2021-07-08;2915;5446;386830;282910;59.8;43.7
17;2021-07-09;2526;6078;389356;288988;60.2;44.7
17;2021-07-10;826;2470;390182;291458;60.3;45.0
17;2021-07-11;379;906;390561;292364;60.4;45.2
17;2021-07-12;2002;5617;392563;297981;60.7;46.1
17;2021-07-13;2372;6720;394935;304701;61.0;47.1
17;2021-07-14;71;71;395006;304772;61.0;47.1
17;2021-07-15;2190;6862;397196;311634;61.4;48.2
17;2021-07-16;2777;6965;399973;318599;61.8;49.2
17;2021-07-17;1051;2274;401024;320873;62.0;49.6
17;2021-07-18;312;1036;401336;321909;62.0;49.7
17;2021-07-19;2634;5908;403970;327817;62.4;50.7
17;2021-07-20;3315;6319;407285;334136;62.9;51.6
17;2021-07-21;3802;6029;411087;340165;63.5;52.6
17;2021-07-22;4248;6269;415335;346434;64.2;53.5
17;2021-07-23;3903;6566;419238;353000;64.8;54.6
17;2021-07-24;2067;1403;421305;354403;65.1;54.8
17;2021-07-25;1040;417;422345;354820;65.3;54.8
17;2021-07-26;3735;5425;426080;360245;65.8;55.7
17;2021-07-27;4728;5442;430808;365687;66.6;56.5
17;2021-07-28;5215;5178;436023;370865;67.4;57.3
17;2021-07-29;5166;5343;441189;376208;68.2;58.1
17;2021-07-30;5512;5577;446701;381785;69.0;59.0
17;2021-07-31;2117;1215;448818;383000;69.4;59.2
17;2021-08-01;1095;359;449913;383359;69.5;59.2
17;2021-08-02;4621;4393;454534;387752;70.2;59.9
17;2021-08-03;5762;4165;460296;391917;71.1;60.6
17;2021-08-04;6202;3379;466498;395296;72.1;61.1
17;2021-08-05;6390;3150;472888;398446;73.1;61.6
17;2021-08-06;5888;3601;478776;402047;74.0;62.1
17;2021-08-07;1993;870;480769;402917;74.3;62.3
17;2021-08-08;978;219;481747;403136;74.4;62.3
17;2021-08-09;3923;3696;485670;406832;75.1;62.9
17;2021-08-10;5087;3488;490757;410320;75.8;63.4
17;2021-08-11;4919;3812;495676;414132;76.6;64.0
17;2021-08-12;4897;3959;500573;418091;77.4;64.6
17;2021-08-13;4521;4142;505094;422233;78.1;65.3
17;2021-08-14;1239;1383;506333;423616;78.2;65.5
17;2021-08-15;407;377;506740;423993;78.3;65.5
17;2021-08-16;2855;4065;509595;428058;78.8;66.2
17;2021-08-17;3051;4291;512646;432349;79.2;66.8
17;2021-08-18;2622;4555;515268;436904;79.6;67.5
17;2021-08-19;2733;4372;518001;441276;80.1;68.2
17;2021-08-20;2501;5025;520502;446301;80.4;69.0
17;2021-08-21;685;1355;521187;447656;80.5;69.2
17;2021-08-22;221;457;521408;448113;80.6;69.3
17;2021-08-23;1987;4956;523395;453069;80.9;70.0
17;2021-08-24;1941;5091;525336;458160;81.2;70.8
17;2021-08-25;1660;5506;526996;463666;81.4;71.7
17;2021-08-26;1603;5761;528599;469427;81.7;72.5
17;2021-08-27;1551;5954;530150;475381;81.9;73.5
17;2021-08-28;521;1455;530671;476836;82.0;73.7
17;2021-08-29;87;575;530758;477411;82.0;73.8
17;2021-08-30;1436;5049;532194;482460;82.2;74.6
17;2021-08-31;1327;5238;533521;487698;82.5;75.4
17;2021-09-01;1195;4758;534716;492456;82.6;76.1
17;2021-09-02;1141;4144;535857;496600;82.8;76.7
17;2021-09-03;1169;4919;537026;501519;83.0;77.5
17;2021-09-04;287;917;537313;502436;83.0;77.6
17;2021-09-05;55;103;537368;502539;83.0;77.7
17;2021-09-06;730;3208;538098;505747;83.2;78.2
17;2021-09-07;720;2636;538818;508383;83.3;78.6
17;2021-09-08;823;3590;539641;511973;83.4;79.1
17;2021-09-09;819;2403;540460;514376;83.5;79.5
17;2021-09-10;803;3330;541263;517706;83.6;80.0
17;2021-09-11;304;852;541567;518558;83.7;80.1
17;2021-09-12;10;13;541577;518571;83.7;80.1
17;2021-09-13;653;1933;542230;520504;83.8;80.4
17;2021-09-14;618;1631;542848;522135;83.9;80.7
17;2021-09-15;942;2376;543790;524511;84.0;81.1
17;2021-09-16;545;1454;544335;525965;84.1;81.3
17;2021-09-17;621;1921;544956;527886;84.2;81.6
17;2021-09-18;193;583;545149;528469;84.2;81.7
17;2021-09-19;13;6;545162;528475;84.2;81.7
17;2021-09-20;432;1226;545594;529701;84.3;81.9
17;2021-09-21;326;893;545920;530594;84.4;82.0
17;2021-09-22;420;1694;546340;532288;84.4;82.3
17;2021-09-23;359;972;546699;533260;84.5;82.4
17;2021-09-24;385;1821;547084;535081;84.5;82.7
17;2021-09-25;127;472;547211;535553;84.6;82.8
17;2021-09-26;0;16;547211;535569;84.6;82.8
17;2021-09-27;437;1177;547648;536746;84.6;82.9
17;2021-09-28;275;688;547923;537434;84.7;83.1
17;2021-09-29;454;1215;548377;538649;84.7;83.2
17;2021-09-30;374;715;548751;539364;84.8;83.4
17;2021-10-01;360;742;549111;540106;84.9;83.5
17;2021-10-02;110;310;549221;540416;84.9;83.5
17;2021-10-03;4;29;549225;540445;84.9;83.5
17;2021-10-04;366;860;549591;541305;84.9;83.7
17;2021-10-05;379;580;549970;541885;85.0;83.7
17;2021-10-06;424;1132;550394;543017;85.1;83.9
17;2021-10-07;275;556;550669;543573;85.1;84.0
17;2021-10-08;423;888;551092;544461;85.2;84.1
17;2021-10-09;156;317;551248;544778;85.2;84.2
17;2021-10-10;1;23;551249;544801;85.2;84.2
17;2021-10-11;388;563;551637;545364;85.3;84.3
17;2021-10-12;218;364;551855;545728;85.3;84.3
17;2021-10-13;365;672;552220;546400;85.3;84.4
17;2021-10-14;221;412;552441;546812;85.4;84.5
18;2020-12-27;0;0;0;0;0.0;0.0
18;2020-12-28;0;0;0;0;0.0;0.0
18;2020-12-29;0;0;0;0;0.0;0.0
18;2020-12-30;1;0;1;0;0.0;0.0
18;2020-12-31;0;0;1;0;0.0;0.0
18;2021-01-01;0;0;1;0;0.0;0.0
18;2021-01-02;0;0;1;0;0.0;0.0
18;2021-01-03;0;0;1;0;0.0;0.0
18;2021-01-04;3;0;4;0;0.0;0.0
18;2021-01-05;0;0;4;0;0.0;0.0
18;2021-01-06;1;0;5;0;0.0;0.0
18;2021-01-07;30;1;35;1;0.0;0.0
18;2021-01-08;65;0;100;1;0.0;0.0
18;2021-01-09;225;1;325;2;0.1;0.0
18;2021-01-10;146;0;471;2;0.2;0.0
18;2021-01-11;169;0;640;2;0.2;0.0
18;2021-01-12;371;0;1011;2;0.3;0.0
18;2021-01-13;270;2;1281;4;0.4;0.0
18;2021-01-14;269;2;1550;6;0.5;0.0
18;2021-01-15;332;2;1882;8;0.6;0.0
18;2021-01-16;288;3;2170;11;0.7;0.0
18;2021-01-17;1;0;2171;11;0.7;0.0
18;2021-01-18;291;0;2462;11;0.8;0.0
18;2021-01-19;1373;5;3835;16;1.3;0.0
18;2021-01-20;1239;2;5074;18;1.7;0.0
18;2021-01-21;963;0;6037;18;2.0;0.0
18;2021-01-22;780;2;6817;20;2.3;0.0
18;2021-01-23;249;2;7066;22;2.4;0.0
18;2021-01-24;0;0;7066;22;2.4;0.0
18;2021-01-25;509;1;7575;23;2.6;0.0
18;2021-01-26;395;1;7970;24;2.7;0.0
18;2021-01-27;390;2;8360;26;2.8;0.0
18;2021-01-28;566;8;8926;34;3.0;0.0
18;2021-01-29;490;73;9416;107;3.2;0.0
18;2021-01-30;431;159;9847;266;3.3;0.1
18;2021-01-31;82;116;9929;382;3.3;0.1
18;2021-02-01;328;139;10257;521;3.5;0.2
18;2021-02-02;507;240;10764;761;3.6;0.3
18;2021-02-03;398;204;11162;965;3.8;0.3
18;2021-02-04;630;228;11792;1193;4.0;0.4
18;2021-02-05;448;194;12240;1387;4.1;0.5
18;2021-02-06;283;100;12523;1487;4.2;0.5
18;2021-02-07;108;1;12631;1488;4.3;0.5
18;2021-02-08;268;230;12899;1718;4.4;0.6
18;2021-02-09;583;780;13482;2498;4.5;0.8
18;2021-02-10;742;695;14224;3193;4.8;1.1
18;2021-02-11;655;451;14879;3644;5.0;1.2
18;2021-02-12;502;330;15381;3974;5.2;1.3
18;2021-02-13;286;124;15667;4098;5.3;1.4
18;2021-02-14;364;98;16031;4196;5.4;1.4
18;2021-02-15;378;394;16409;4590;5.5;1.5
18;2021-02-16;401;402;16810;4992;5.7;1.7
18;2021-02-17;404;456;17214;5448;5.8;1.8
18;2021-02-18;344;535;17558;5983;5.9;2.0
18;2021-02-19;471;305;18029;6288;6.1;2.1
18;2021-02-20;720;241;18749;6529;6.3;2.2
18;2021-02-21;317;4;19066;6533;6.4;2.2
18;2021-02-22;218;369;19284;6902;6.5;2.3
18;2021-02-23;204;350;19488;7252;6.6;2.4
18;2021-02-24;241;274;19729;7526;6.7;2.5
18;2021-02-25;294;519;20023;8045;6.8;2.7
18;2021-02-26;583;236;20606;8281;7.0;2.8
18;2021-02-27;510;388;21116;8669;7.1;2.9
18;2021-02-28;7;68;21123;8737;7.1;2.9
18;2021-03-01;237;412;21360;9149;7.2;3.1
18;2021-03-02;284;520;21644;9669;7.3;3.3
18;2021-03-03;346;586;21990;10255;7.4;3.5
18;2021-03-04;475;571;22465;10826;7.6;3.7
18;2021-03-05;524;372;22989;11198;7.8;3.8
18;2021-03-06;1071;347;24060;11545;8.1;3.9
18;2021-03-07;7;140;24067;11685;8.1;3.9
18;2021-03-08;336;363;24403;12048;8.2;4.1
18;2021-03-09;410;367;24813;12415;8.4;4.2
18;2021-03-10;423;453;25236;12868;8.5;4.3
18;2021-03-11;518;426;25754;13294;8.7;4.5
18;2021-03-12;705;305;26459;13599;8.9;4.6
18;2021-03-13;1164;252;27623;13851;9.3;4.7
18;2021-03-14;301;215;27924;14066;9.4;4.7
18;2021-03-15;492;382;28416;14448;9.6;4.9
18;2021-03-16;392;314;28808;14762;9.7;5.0
18;2021-03-17;383;414;29191;15176;9.8;5.1
18;2021-03-18;512;230;29703;15406;10.0;5.2
18;2021-03-19;755;228;30458;15634;10.3;5.3
18;2021-03-20;986;622;31444;16256;10.6;5.5
18;2021-03-21;308;308;31752;16564;10.7;5.6
18;2021-03-22;602;299;32354;16863;10.9;5.7
18;2021-03-23;706;295;33060;17158;11.2;5.8
18;2021-03-24;1052;299;34112;17457;11.5;5.9
18;2021-03-25;1049;304;35161;17761;11.9;6.0
18;2021-03-26;1208;351;36369;18112;12.3;6.1
18;2021-03-27;1488;322;37857;18434;12.8;6.2
18;2021-03-28;215;0;38072;18434;12.8;6.2
18;2021-03-29;1101;200;39173;18634;13.2;6.3
18;2021-03-30;1084;305;40257;18939;13.6;6.4
18;2021-03-31;1305;256;41562;19195;14.0;6.5
18;2021-04-01;1375;350;42937;19545;14.5;6.6
18;2021-04-02;1229;312;44166;19857;14.9;6.7
18;2021-04-03;581;181;44747;20038;15.1;6.8
18;2021-04-04;71;5;44818;20043;15.1;6.8
18;2021-04-05;199;0;45017;20043;15.2;6.8
18;2021-04-06;1027;353;46044;20396;15.5;6.9
18;2021-04-07;1322;368;47366;20764;16.0;7.0
18;2021-04-08;1692;351;49058;21115;16.6;7.1
18;2021-04-09;1833;284;50891;21399;17.2;7.2
18;2021-04-10;2632;653;53523;22052;18.1;7.4
18;2021-04-11;1986;322;55509;22374;18.7;7.5
18;2021-04-12;1401;404;56910;22778;19.2;7.7
18;2021-04-13;1785;470;58695;23248;19.8;7.8
18;2021-04-14;1378;518;60073;23766;20.3;8.0
18;2021-04-15;1532;534;61605;24300;20.8;8.2
18;2021-04-16;1614;594;63219;24894;21.3;8.4
18;2021-04-17;1599;524;64818;25418;21.9;8.6
18;2021-04-18;377;232;65195;25650;22.0;8.7
18;2021-04-19;1317;593;66512;26243;22.4;8.9
18;2021-04-20;1445;716;67957;26959;22.9;9.1
18;2021-04-21;1270;910;69227;27869;23.4;9.4
18;2021-04-22;1403;705;70630;28574;23.8;9.6
18;2021-04-23;1387;738;72017;29312;24.3;9.9
18;2021-04-24;1355;1274;73372;30586;24.8;10.3
18;2021-04-25;287;217;73659;30803;24.9;10.4
18;2021-04-26;1205;957;74864;31760;25.3;10.7
18;2021-04-27;1544;766;76408;32526;25.8;11.0
18;2021-04-28;1358;879;77766;33405;26.2;11.3
18;2021-04-29;1851;735;79617;34140;26.9;11.5
18;2021-04-30;1569;999;81186;35139;27.4;11.9
18;2021-05-01;788;212;81974;35351;27.7;11.9
18;2021-05-02;806;61;82780;35412;27.9;11.9
18;2021-05-03;1627;1015;84407;36427;28.5;12.3
18;2021-05-04;1729;1287;86136;37714;29.1;12.7
18;2021-05-05;1735;1216;87871;38930;29.6;13.1
18;2021-05-06;2162;1368;90033;40298;30.4;13.6
18;2021-05-07;1234;1404;91267;41702;30.8;14.1
18;2021-05-08;994;1471;92261;43173;31.1;14.6
18;2021-05-09;500;2261;92761;45434;31.3;15.3
18;2021-05-10;1157;1509;93918;46943;31.7;15.8
18;2021-05-11;1696;1752;95614;48695;32.3;16.4
18;2021-05-12;1806;1497;97420;50192;32.9;16.9
18;2021-05-13;1061;370;98481;50562;33.2;17.1
18;2021-05-14;1345;942;99826;51504;33.7;17.4
18;2021-05-15;1809;1164;101635;52668;34.3;17.8
18;2021-05-16;537;581;102172;53249;34.5;18.0
18;2021-05-17;1245;1091;103417;54340;34.9;18.3
18;2021-05-18;2146;933;105563;55273;35.6;18.6
18;2021-05-19;2162;920;107725;56193;36.3;19.0
18;2021-05-20;2276;983;110001;57176;37.1;19.3
18;2021-05-21;1495;765;111496;57941;37.6;19.5
18;2021-05-22;1724;1075;113220;59016;38.2;19.9
18;2021-05-23;486;336;113706;59352;38.4;20.0
18;2021-05-24;461;293;114167;59645;38.5;20.1
18;2021-05-25;1841;1061;116008;60706;39.1;20.5
18;2021-05-26;2153;846;118161;61552;39.9;20.8
18;2021-05-27;2209;1231;120370;62783;40.6;21.2
18;2021-05-28;1712;1308;122082;64091;41.2;21.6
18;2021-05-29;2621;1663;124703;65754;42.1;22.2
18;2021-05-30;1482;504;126185;66258;42.6;22.4
18;2021-05-31;1786;693;127971;66951;43.2;22.6
18;2021-06-01;2039;947;130010;67898;43.9;22.9
18;2021-06-02;2010;1018;132020;68916;44.5;23.3
18;2021-06-03;2283;1202;134303;70118;45.3;23.7
18;2021-06-04;1912;1123;136215;71241;46.0;24.0
18;2021-06-05;2800;1450;139015;72691;46.9;24.5
18;2021-06-06;364;381;139379;73072;47.0;24.7
18;2021-06-07;1294;1232;140673;74304;47.5;25.1
18;2021-06-08;1490;1394;142163;75698;48.0;25.5
18;2021-06-09;1330;1068;143493;76766;48.4;25.9
18;2021-06-10;1631;1410;145124;78176;49.0;26.4
18;2021-06-11;1496;1404;146620;79580;49.5;26.8
18;2021-06-12;1245;2510;147865;82090;49.9;27.7
18;2021-06-13;126;263;147991;82353;49.9;27.8
18;2021-06-14;656;1828;148647;84181;50.2;28.4
18;2021-06-15;1093;1823;149740;86004;50.5;29.0
18;2021-06-16;1255;1441;150995;87445;50.9;29.5
18;2021-06-17;1205;1670;152200;89115;51.3;30.1
18;2021-06-18;1290;1667;153490;90782;51.8;30.6
18;2021-06-19;1564;1251;155054;92033;52.3;31.0
18;2021-06-20;246;159;155300;92192;52.4;31.1
18;2021-06-21;665;1601;155965;93793;52.6;31.6
18;2021-06-22;1068;1645;157033;95438;53.0;32.2
18;2021-06-23;944;1642;157977;97080;53.3;32.8
18;2021-06-24;1033;1062;159010;98142;53.6;33.1
18;2021-06-25;892;1746;159902;99888;53.9;33.7
18;2021-06-26;1097;1474;160999;101362;54.3;34.2
18;2021-06-27;31;372;161030;101734;54.3;34.3
18;2021-06-28;422;1922;161452;103656;54.5;35.0
18;2021-06-29;597;2379;162049;106035;54.7;35.8
18;2021-06-30;600;2543;162649;108578;54.9;36.6
18;2021-07-01;964;2157;163613;110735;55.2;37.4
18;2021-07-02;614;1685;164227;112420;55.4;37.9
18;2021-07-03;754;2574;164981;114994;55.7;38.8
18;2021-07-04;164;1032;165145;116026;55.7;39.1
18;2021-07-05;765;1877;165910;117903;56.0;39.8
18;2021-07-06;559;2301;166469;120204;56.2;40.6
18;2021-07-07;766;2115;167235;122319;56.4;41.3
18;2021-07-08;1031;1984;168266;124303;56.8;41.9
18;2021-07-09;703;2307;168969;126610;57.0;42.7
18;2021-07-10;781;3175;169750;129785;57.3;43.8
18;2021-07-11;84;668;169834;130453;57.3;44.0
18;2021-07-12;223;2253;170057;132706;57.4;44.8
18;2021-07-13;619;2904;170676;135610;57.6;45.8
18;2021-07-14;194;937;170870;136547;57.6;46.1
18;2021-07-15;1396;2816;172266;139363;58.1;47.0
18;2021-07-16;1185;2122;173451;141485;58.5;47.7
18;2021-07-17;1130;2472;174581;143957;58.9;48.6
18;2021-07-18;228;332;174809;144289;59.0;48.7
18;2021-07-19;1055;1657;175864;145946;59.3;49.2
18;2021-07-20;1625;2269;177489;148215;59.9;50.0
18;2021-07-21;1901;2062;179390;150277;60.5;50.7
18;2021-07-22;2211;1901;181601;152178;61.3;51.3
18;2021-07-23;1395;1613;182996;153791;61.7;51.9
18;2021-07-24;891;1534;183887;155325;62.0;52.4
18;2021-07-25;192;396;184079;155721;62.1;52.5
18;2021-07-26;1397;1502;185476;157223;62.6;53.0
18;2021-07-27;1824;1539;187300;158762;63.2;53.6
18;2021-07-28;2198;1797;189498;160559;63.9;54.2
18;2021-07-29;2140;1817;191638;162376;64.7;54.8
18;2021-07-30;1585;1344;193223;163720;65.2;55.2
18;2021-07-31;1237;1281;194460;165001;65.6;55.7
18;2021-08-01;90;34;194550;165035;65.6;55.7
18;2021-08-02;1410;765;195960;165800;66.1;55.9
18;2021-08-03;1719;1630;197679;167430;66.7;56.5
18;2021-08-04;2440;1102;200119;168532;67.5;56.9
18;2021-08-05;1529;1247;201648;169779;68.0;57.3
18;2021-08-06;1582;1142;203230;170921;68.6;57.7
18;2021-08-07;610;764;203840;171685;68.8;57.9
18;2021-08-08;49;60;203889;171745;68.8;57.9
18;2021-08-09;1105;874;204994;172619;69.2;58.2
18;2021-08-10;1208;1511;206202;174130;69.6;58.7
18;2021-08-11;1608;1510;207810;175640;70.1;59.3
18;2021-08-12;1554;1594;209364;177234;70.6;59.8
18;2021-08-13;1087;1172;210451;178406;71.0;60.2
18;2021-08-14;759;603;211210;179009;71.3;60.4
18;2021-08-15;35;17;211245;179026;71.3;60.4
18;2021-08-16;830;1201;212075;180227;71.5;60.8
18;2021-08-17;979;1999;213054;182226;71.9;61.5
18;2021-08-18;1158;1961;214212;184187;72.3;62.1
18;2021-08-19;1105;1612;215317;185799;72.6;62.7
18;2021-08-20;911;1758;216228;187557;73.0;63.3
18;2021-08-21;420;705;216648;188262;73.1;63.5
18;2021-08-22;22;73;216670;188335;73.1;63.5
18;2021-08-23;487;1680;217157;190015;73.3;64.1
18;2021-08-24;903;1494;218060;191509;73.6;64.6
18;2021-08-25;840;1864;218900;193373;73.9;65.2
18;2021-08-26;772;1532;219672;194905;74.1;65.8
18;2021-08-27;575;1994;220247;196899;74.3;66.4
18;2021-08-28;501;873;220748;197772;74.5;66.7
18;2021-08-29;92;176;220840;197948;74.5;66.8
18;2021-08-30;528;1409;221368;199357;74.7;67.3
18;2021-08-31;507;1397;221875;200754;74.9;67.7
18;2021-09-01;578;1509;222453;202263;75.1;68.2
18;2021-09-02;398;1108;222851;203371;75.2;68.6
18;2021-09-03;455;1141;223306;204512;75.3;69.0
18;2021-09-04;357;735;223663;205247;75.5;69.2
18;2021-09-05;29;56;223692;205303;75.5;69.3
18;2021-09-06;279;872;223971;206175;75.6;69.6
18;2021-09-07;281;828;224252;207003;75.7;69.8
18;2021-09-08;404;1032;224656;208035;75.8;70.2
18;2021-09-09;357;988;225013;209023;75.9;70.5
18;2021-09-10;414;933;225427;209956;76.1;70.8
18;2021-09-11;262;783;225689;210739;76.1;71.1
18;2021-09-12;8;19;225697;210758;76.1;71.1
18;2021-09-13;311;704;226008;211462;76.2;71.3
18;2021-09-14;283;775;226291;212237;76.3;71.6
18;2021-09-15;323;1053;226614;213290;76.5;72.0
18;2021-09-16;471;878;227085;214168;76.6;72.3
18;2021-09-17;337;737;227422;214905;76.7;72.5
18;2021-09-18;184;618;227606;215523;76.8;72.7
18;2021-09-19;6;4;227612;215527;76.8;72.7
18;2021-09-20;157;550;227769;216077;76.8;72.9
18;2021-09-21;113;424;227882;216501;76.9;73.0
18;2021-09-22;193;870;228075;217371;76.9;73.3
18;2021-09-23;249;466;228324;217837;77.0;73.5
18;2021-09-24;141;489;228465;218326;77.1;73.7
18;2021-09-25;159;690;228624;219016;77.1;73.9
18;2021-09-26;15;89;228639;219105;77.1;73.9
18;2021-09-27;109;315;228748;219420;77.2;74.0
18;2021-09-28;70;273;228818;219693;77.2;74.1
18;2021-09-29;68;281;228886;219974;77.2;74.2
18;2021-09-30;116;280;229002;220254;77.3;74.3
18;2021-10-01;144;289;229146;220543;77.3;74.4
18;2021-10-02;62;163;229208;220706;77.3;74.5
18;2021-10-03;6;10;229214;220716;77.3;74.5
18;2021-10-04;143;457;229357;221173;77.4;74.6
18;2021-10-05;161;336;229518;221509;77.4;74.7
18;2021-10-06;134;442;229652;221951;77.5;74.9
18;2021-10-07;99;372;229751;222323;77.5;75.0
18;2021-10-08;146;520;229897;222843;77.6;75.2
18;2021-10-09;119;314;230016;223157;77.6;75.3
18;2021-10-10;4;13;230020;223170;77.6;75.3
18;2021-10-11;156;199;230176;223369;77.7;75.4
18;2021-10-12;140;205;230316;223574;77.7;75.4
18;2021-10-13;168;219;230484;223793;77.8;75.5
18;2021-10-14;57;220;230541;224013;77.8;75.6
19;2020-12-27;0;0;0;0;0.0;0.0
19;2020-12-28;0;0;0;0;0.0;0.0
19;2020-12-29;1;0;1;0;0.0;0.0
19;2020-12-30;0;0;1;0;0.0;0.0
19;2020-12-31;0;0;1;0;0.0;0.0
19;2021-01-01;0;0;1;0;0.0;0.0
19;2021-01-02;0;0;1;0;0.0;0.0
19;2021-01-03;0;0;1;0;0.0;0.0
19;2021-01-04;0;0;1;0;0.0;0.0
19;2021-01-05;0;0;1;0;0.0;0.0
19;2021-01-06;0;0;1;0;0.0;0.0
19;2021-01-07;344;2;345;2;0.1;0.0
19;2021-01-08;248;1;593;3;0.2;0.0
19;2021-01-09;1;0;594;3;0.2;0.0
19;2021-01-10;1;0;595;3;0.2;0.0
19;2021-01-11;38;0;633;3;0.3;0.0
19;2021-01-12;416;2;1049;5;0.4;0.0
19;2021-01-13;429;11;1478;16;0.6;0.0
19;2021-01-14;475;1;1953;17;0.8;0.0
19;2021-01-15;226;18;2179;35;0.9;0.0
19;2021-01-16;0;0;2179;35;0.9;0.0
19;2021-01-17;1;0;2180;35;0.9;0.0
19;2021-01-18;251;2;2431;37;1.0;0.0
19;2021-01-19;521;0;2952;37;1.2;0.0
19;2021-01-20;921;9;3873;46;1.6;0.0
19;2021-01-21;507;5;4380;51;1.8;0.0
19;2021-01-22;1318;18;5698;69;2.4;0.0
19;2021-01-23;281;0;5979;69;2.5;0.0
19;2021-01-24;38;0;6017;69;2.5;0.0
19;2021-01-25;233;0;6250;69;2.6;0.0
19;2021-01-26;608;4;6858;73;2.9;0.0
19;2021-01-27;334;5;7192;78;3.0;0.0
19;2021-01-28;297;251;7489;329;3.1;0.1
19;2021-01-29;348;61;7837;390;3.3;0.2
19;2021-01-30;130;26;7967;416;3.3;0.2
19;2021-01-31;41;1;8008;417;3.3;0.2
19;2021-02-01;158;95;8166;512;3.4;0.2
19;2021-02-02;303;429;8469;941;3.5;0.4
19;2021-02-03;285;246;8754;1187;3.6;0.5
19;2021-02-04;255;375;9009;1562;3.7;0.6
19;2021-02-05;311;76;9320;1638;3.9;0.7
19;2021-02-06;215;2;9535;1640;4.0;0.7
19;2021-02-07;48;2;9583;1642;4.0;0.7
19;2021-02-08;177;150;9760;1792;4.1;0.7
19;2021-02-09;333;274;10093;2066;4.2;0.9
19;2021-02-10;517;296;10610;2362;4.4;1.0
19;2021-02-11;414;319;11024;2681;4.6;1.1
19;2021-02-12;799;1162;11823;3843;4.9;1.6
19;2021-02-13;352;187;12175;4030;5.1;1.7
19;2021-02-14;99;13;12274;4043;5.1;1.7
19;2021-02-15;200;243;12474;4286;5.2;1.8
19;2021-02-16;386;171;12860;4457;5.4;1.9
19;2021-02-17;306;468;13166;4925;5.5;2.0
19;2021-02-18;174;508;13340;5433;5.6;2.3
19;2021-02-19;469;299;13809;5732;5.7;2.4
19;2021-02-20;133;207;13942;5939;5.8;2.5
19;2021-02-21;20;40;13962;5979;5.8;2.5
19;2021-02-22;221;211;14183;6190;5.9;2.6
19;2021-02-23;268;345;14451;6535;6.0;2.7
19;2021-02-24;361;208;14812;6743;6.2;2.8
19;2021-02-25;519;382;15331;7125;6.4;3.0
19;2021-02-26;395;318;15726;7443;6.5;3.1
19;2021-02-27;348;162;16074;7605;6.7;3.2
19;2021-02-28;68;36;16142;7641;6.7;3.2
19;2021-03-01;266;221;16408;7862;6.8;3.3
19;2021-03-02;428;258;16836;8120;7.0;3.4
19;2021-03-03;692;340;17528;8460;7.3;3.5
19;2021-03-04;826;353;18354;8813;7.6;3.7
19;2021-03-05;891;737;19245;9550;8.0;4.0
19;2021-03-06;1072;216;20317;9766;8.5;4.1
19;2021-03-07;463;38;20780;9804;8.6;4.1
19;2021-03-08;640;166;21420;9970;8.9;4.1
19;2021-03-09;836;251;22256;10221;9.3;4.3
19;2021-03-10;1155;321;23411;10542;9.7;4.4
19;2021-03-11;1274;310;24685;10852;10.3;4.5
19;2021-03-12;1136;407;25821;11259;10.7;4.7
19;2021-03-13;1110;169;26931;11428;11.2;4.8
19;2021-03-14;161;85;27092;11513;11.3;4.8
19;2021-03-15;699;137;27791;11650;11.6;4.8
19;2021-03-16;688;304;28479;11954;11.8;5.0
19;2021-03-17;839;283;29318;12237;12.2;5.1
19;2021-03-18;767;283;30085;12520;12.5;5.2
19;2021-03-19;1014;488;31099;13008;12.9;5.4
19;2021-03-20;784;132;31883;13140;13.3;5.5
19;2021-03-21;128;4;32011;13144;13.3;5.5
19;2021-03-22;548;177;32559;13321;13.5;5.5
19;2021-03-23;1045;234;33604;13555;14.0;5.6
19;2021-03-24;1172;373;34776;13928;14.5;5.8
19;2021-03-25;1189;415;35965;14343;15.0;6.0
19;2021-03-26;1325;279;37290;14622;15.5;6.1
19;2021-03-27;854;192;38144;14814;15.9;6.2
19;2021-03-28;63;60;38207;14874;15.9;6.2
19;2021-03-29;612;177;38819;15051;16.2;6.3
19;2021-03-30;971;344;39790;15395;16.6;6.4
19;2021-03-31;1157;498;40947;15893;17.0;6.6
19;2021-04-01;1491;429;42438;16322;17.7;6.8
19;2021-04-02;1008;527;43446;16849;18.1;7.0
19;2021-04-03;597;285;44043;17134;18.3;7.1
19;2021-04-04;130;3;44173;17137;18.4;7.1
19;2021-04-05;40;76;44213;17213;18.4;7.2
19;2021-04-06;734;604;44947;17817;18.7;7.4
19;2021-04-07;976;732;45923;18549;19.1;7.7
19;2021-04-08;1116;1020;47039;19569;19.6;8.1
19;2021-04-09;1641;616;48680;20185;20.3;8.4
19;2021-04-10;946;560;49626;20745;20.6;8.6
19;2021-04-11;557;74;50183;20819;20.9;8.7
19;2021-04-12;681;524;50864;21343;21.2;8.9
19;2021-04-13;915;576;51779;21919;21.5;9.1
19;2021-04-14;1333;852;53112;22771;22.1;9.5
19;2021-04-15;1229;873;54341;23644;22.6;9.8
19;2021-04-16;1505;823;55846;24467;23.2;10.2
19;2021-04-17;761;480;56607;24947;23.6;10.4
19;2021-04-18;661;72;57268;25019;23.8;10.4
19;2021-04-19;730;440;57998;25459;24.1;10.6
19;2021-04-20;979;751;58977;26210;24.5;10.9
19;2021-04-21;1271;700;60248;26910;25.1;11.2
19;2021-04-22;1188;900;61436;27810;25.6;11.6
19;2021-04-23;1127;1021;62563;28831;26.0;12.0
19;2021-04-24;678;676;63241;29507;26.3;12.3
19;2021-04-25;675;70;63916;29577;26.6;12.3
19;2021-04-26;1056;332;64972;29909;27.0;12.4
19;2021-04-27;1027;569;65999;30478;27.5;12.7
19;2021-04-28;1553;557;67552;31035;28.1;12.9
19;2021-04-29;1453;1197;69005;32232;28.7;13.4
19;2021-04-30;1876;1062;70881;33294;29.5;13.9
19;2021-05-01;671;175;71552;33469;29.8;13.9
19;2021-05-02;551;152;72103;33621;30.0;14.0
19;2021-05-03;854;547;72957;34168;30.4;14.2
19;2021-05-04;1025;709;73982;34877;30.8;14.5
19;2021-05-05;1256;741;75238;35618;31.3;14.8
19;2021-05-06;1127;1200;76365;36818;31.8;15.3
19;2021-05-07;1663;1191;78028;38009;32.5;15.8
19;2021-05-08;712;206;78740;38215;32.8;15.9
19;2021-05-09;487;547;79227;38762;33.0;16.1
19;2021-05-10;1164;671;80391;39433;33.4;16.4
19;2021-05-11;1639;858;82030;40291;34.1;16.8
19;2021-05-12;1945;1322;83975;41613;34.9;17.3
19;2021-05-13;571;242;84546;41855;35.2;17.4
19;2021-05-14;1646;988;86192;42843;35.9;17.8
19;2021-05-15;1443;593;87635;43436;36.5;18.1
19;2021-05-16;350;82;87985;43518;36.6;18.1
19;2021-05-17;1498;559;89483;44077;37.2;18.3
19;2021-05-18;1669;500;91152;44577;37.9;18.5
19;2021-05-19;2009;829;93161;45406;38.8;18.9
19;2021-05-20;1722;892;94883;46298;39.5;19.3
19;2021-05-21;1964;814;96847;47112;40.3;19.6
19;2021-05-22;1271;651;98118;47763;40.8;19.9
19;2021-05-23;324;131;98442;47894;41.0;19.9
19;2021-05-24;139;46;98581;47940;41.0;19.9
19;2021-05-25;1503;492;100084;48432;41.6;20.2
19;2021-05-26;1924;666;102008;49098;42.4;20.4
19;2021-05-27;1786;837;103794;49935;43.2;20.8
19;2021-05-28;1937;991;105731;50926;44.0;21.2
19;2021-05-29;1375;705;107106;51631;44.6;21.5
19;2021-05-30;191;497;107297;52128;44.6;21.7
19;2021-05-31;1199;537;108496;52665;45.1;21.9
19;2021-06-01;1284;886;109780;53551;45.7;22.3
19;2021-06-02;1816;958;111596;54509;46.4;22.7
19;2021-06-03;1447;1255;113043;55764;47.0;23.2
19;2021-06-04;1848;1358;114891;57122;47.8;23.8
19;2021-06-05;1210;815;116101;57937;48.3;24.1
19;2021-06-06;87;648;116188;58585;48.3;24.4
19;2021-06-07;923;935;117111;59520;48.7;24.8
19;2021-06-08;1104;906;118215;60426;49.2;25.1
19;2021-06-09;1328;1463;119543;61889;49.7;25.8
19;2021-06-10;1283;1580;120826;63469;50.3;26.4
19;2021-06-11;1306;1921;122132;65390;50.8;27.2
19;2021-06-12;1356;1317;123488;66707;51.4;27.8
19;2021-06-13;542;424;124030;67131;51.6;27.9
19;2021-06-14;736;1016;124766;68147;51.9;28.4
19;2021-06-15;979;1143;125745;69290;52.3;28.8
19;2021-06-16;1222;1363;126967;70653;52.8;29.4
19;2021-06-17;868;1788;127835;72441;53.2;30.1
19;2021-06-18;1056;2135;128891;74576;53.6;31.0
19;2021-06-19;919;1302;129810;75878;54.0;31.6
19;2021-06-20;395;327;130205;76205;54.2;31.7
19;2021-06-21;500;1074;130705;77279;54.4;32.2
19;2021-06-22;698;1490;131403;78769;54.7;32.8
19;2021-06-23;744;1989;132147;80758;55.0;33.6
19;2021-06-24;687;1663;132834;82421;55.3;34.3
19;2021-06-25;562;2216;133396;84637;55.5;35.2
19;2021-06-26;474;1741;133870;86378;55.7;35.9
19;2021-06-27;289;446;134159;86824;55.8;36.1
19;2021-06-28;315;1499;134474;88323;56.0;36.7
19;2021-06-29;353;1893;134827;90216;56.1;37.5
19;2021-06-30;796;2152;135623;92368;56.4;38.4
19;2021-07-01;361;2322;135984;94690;56.6;39.4
19;2021-07-02;798;2316;136782;97006;56.9;40.4
19;2021-07-03;513;1744;137295;98750;57.1;41.1
19;2021-07-04;1;73;137296;98823;57.1;41.1
19;2021-07-05;600;1015;137896;99838;57.4;41.5
19;2021-07-06;504;1541;138400;101379;57.6;42.2
19;2021-07-07;706;2046;139106;103425;57.9;43.0
19;2021-07-08;770;2148;139876;105573;58.2;43.9
19;2021-07-09;716;2659;140592;108232;58.5;45.0
19;2021-07-10;586;1708;141178;109940;58.7;45.7
19;2021-07-11;45;212;141223;110152;58.8;45.8
19;2021-07-12;446;1487;141669;111639;58.9;46.5
19;2021-07-13;687;1828;142356;113467;59.2;47.2
19;2021-07-14;201;272;142557;113739;59.3;47.3
19;2021-07-15;870;2050;143427;115789;59.7;48.2
19;2021-07-16;1228;2445;144655;118234;60.2;49.2
19;2021-07-17;703;1718;145358;119952;60.5;49.9
19;2021-07-18;365;672;145723;120624;60.6;50.2
19;2021-07-19;968;1401;146691;122025;61.0;50.8
19;2021-07-20;967;1676;147658;123701;61.4;51.5
19;2021-07-21;1083;1711;148741;125412;61.9;52.2
19;2021-07-22;1392;1857;150133;127269;62.5;53.0
19;2021-07-23;1784;1996;151917;129265;63.2;53.8
19;2021-07-24;908;1753;152825;131018;63.6;54.5
19;2021-07-25;164;513;152989;131531;63.7;54.7
19;2021-07-26;911;911;153900;132442;64.0;55.1
19;2021-07-27;1424;1117;155324;133559;64.6;55.6
19;2021-07-28;2045;1224;157369;134783;65.5;56.1
19;2021-07-29;1623;1204;158992;135987;66.2;56.6
19;2021-07-30;1909;1027;160901;137014;66.9;57.0
19;2021-07-31;1129;1018;162030;138032;67.4;57.4
19;2021-08-01;347;372;162377;138404;67.6;57.6
19;2021-08-02;1195;810;163572;139214;68.1;57.9
19;2021-08-03;1453;1055;165025;140269;68.7;58.4
19;2021-08-04;1983;763;167008;141032;69.5;58.7
19;2021-08-05;1630;958;168638;141990;70.2;59.1
19;2021-08-06;1962;1219;170600;143209;71.0;59.6
19;2021-08-07;1335;1001;171935;144210;71.5;60.0
19;2021-08-08;187;234;172122;144444;71.6;60.1
19;2021-08-09;1009;784;173131;145228;72.0;60.4
19;2021-08-10;1280;1014;174411;146242;72.6;60.8
19;2021-08-11;1356;1006;175767;147248;73.1;61.3
19;2021-08-12;1016;1276;176783;148524;73.6;61.8
19;2021-08-13;1181;1275;177964;149799;74.0;62.3
19;2021-08-14;979;1165;178943;150964;74.5;62.8
19;2021-08-15;30;54;178973;151018;74.5;62.8
19;2021-08-16;592;1029;179565;152047;74.7;63.3
19;2021-08-17;633;1167;180198;153214;75.0;63.7
19;2021-08-18;656;979;180854;154193;75.3;64.2
19;2021-08-19;438;1258;181292;155451;75.4;64.7
19;2021-08-20;867;1927;182159;157378;75.8;65.5
19;2021-08-21;495;1376;182654;158754;76.0;66.1
19;2021-08-22;52;93;182706;158847;76.0;66.1
19;2021-08-23;226;1158;182932;160005;76.1;66.6
19;2021-08-24;538;1317;183470;161322;76.3;67.1
19;2021-08-25;649;1557;184119;162879;76.6;67.8
19;2021-08-26;477;1463;184596;164342;76.8;68.4
19;2021-08-27;501;1689;185097;166031;77.0;69.1
19;2021-08-28;360;1277;185457;167308;77.2;69.6
19;2021-08-29;60;182;185517;167490;77.2;69.7
19;2021-08-30;224;1089;185741;168579;77.3;70.1
19;2021-08-31;326;1352;186067;169931;77.4;70.7
19;2021-09-01;365;1433;186432;171364;77.6;71.3
19;2021-09-02;346;1193;186778;172557;77.7;71.8
19;2021-09-03;412;1423;187190;173980;77.9;72.4
19;2021-09-04;302;1361;187492;175341;78.0;73.0
19;2021-09-05;32;106;187524;175447;78.0;73.0
19;2021-09-06;197;630;187721;176077;78.1;73.3
19;2021-09-07;229;755;187950;176832;78.2;73.6
19;2021-09-08;287;741;188237;177573;78.3;73.9
19;2021-09-09;253;536;188490;178109;78.4;74.1
19;2021-09-10;252;709;188742;178818;78.5;74.4
19;2021-09-11;295;1055;189037;179873;78.7;74.8
19;2021-09-12;42;70;189079;179943;78.7;74.9
19;2021-09-13;107;245;189186;180188;78.7;75.0
19;2021-09-14;171;387;189357;180575;78.8;75.1
19;2021-09-15;245;670;189602;181245;78.9;75.4
19;2021-09-16;234;411;189836;181656;79.0;75.6
19;2021-09-17;255;531;190091;182187;79.1;75.8
19;2021-09-18;183;689;190274;182876;79.2;76.1
19;2021-09-19;17;34;190291;182910;79.2;76.1
19;2021-09-20;112;205;190403;183115;79.2;76.2
19;2021-09-21;143;295;190546;183410;79.3;76.3
19;2021-09-22;152;398;190698;183808;79.3;76.5
19;2021-09-23;87;300;190785;184108;79.4;76.6
19;2021-09-24;123;360;190908;184468;79.4;76.8
19;2021-09-25;140;568;191048;185036;79.5;77.0
19;2021-09-26;14;25;191062;185061;79.5;77.0
19;2021-09-27;43;215;191105;185276;79.5;77.1
19;2021-09-28;67;202;191172;185478;79.5;77.2
19;2021-09-29;82;341;191254;185819;79.6;77.3
19;2021-09-30;104;272;191358;186091;79.6;77.4
19;2021-10-01;115;233;191473;186324;79.7;77.5
19;2021-10-02;151;340;191624;186664;79.7;77.7
19;2021-10-03;9;11;191633;186675;79.7;77.7
19;2021-10-04;56;134;191689;186809;79.8;77.7
19;2021-10-05;100;187;191789;186996;79.8;77.8
19;2021-10-06;108;249;191897;187245;79.8;77.9
19;2021-10-07;65;242;191962;187487;79.9;78.0
19;2021-10-08;80;222;192042;187709;79.9;78.1
19;2021-10-09;146;276;192188;187985;80.0;78.2
19;2021-10-10;3;10;192191;187995;80.0;78.2
19;2021-10-11;55;164;192246;188159;80.0;78.3
19;2021-10-12;102;184;192348;188343;80.0;78.4
19;2021-10-13;98;186;192446;188529;80.1;78.4
19;2021-10-14;74;102;192520;188631;80.1;78.5
21;2020-12-27;4;0;4;0;0.0;0.0
21;2020-12-28;2;0;6;0;0.0;0.0
21;2020-12-29;19;0;25;0;0.0;0.0
21;2020-12-30;22;0;47;0;0.0;0.0
21;2020-12-31;0;0;47;0;0.0;0.0
21;2021-01-01;0;0;47;0;0.0;0.0
21;2021-01-02;1;0;48;0;0.0;0.0
21;2021-01-03;1;0;49;0;0.0;0.0
21;2021-01-04;23;0;72;0;0.0;0.0
21;2021-01-05;250;2;322;2;0.1;0.0
21;2021-01-06;300;0;622;2;0.1;0.0
21;2021-01-07;389;1;1011;3;0.2;0.0
21;2021-01-08;455;2;1466;5;0.3;0.0
21;2021-01-09;252;0;1718;5;0.3;0.0
21;2021-01-10;2;1;1720;6;0.3;0.0
21;2021-01-11;624;1;2344;7;0.4;0.0
21;2021-01-12;656;0;3000;7;0.6;0.0
21;2021-01-13;706;2;3706;9;0.7;0.0
21;2021-01-14;1190;10;4896;19;0.9;0.0
21;2021-01-15;719;5;5615;24;1.1;0.0
21;2021-01-16;162;1;5777;25;1.1;0.0
21;2021-01-17;5;0;5782;25;1.1;0.0
21;2021-01-18;1318;7;7100;32;1.3;0.0
21;2021-01-19;1370;5;8470;37;1.6;0.0
21;2021-01-20;1300;48;9770;85;1.8;0.0
21;2021-01-21;1543;8;11313;93;2.1;0.0
21;2021-01-22;1246;5;12559;98;2.4;0.0
21;2021-01-23;490;1;13049;99;2.4;0.0
21;2021-01-24;124;0;13173;99;2.5;0.0
21;2021-01-25;928;20;14101;119;2.6;0.0
21;2021-01-26;1546;147;15647;266;2.9;0.0
21;2021-01-27;2061;172;17708;438;3.3;0.1
21;2021-01-28;1460;240;19168;678;3.6;0.1
21;2021-01-29;1022;212;20190;890;3.8;0.2
21;2021-01-30;470;32;20660;922;3.9;0.2
21;2021-01-31;97;3;20757;925;3.9;0.2
21;2021-02-01;453;287;21210;1212;4.0;0.2
21;2021-02-02;456;442;21666;1654;4.1;0.3
21;2021-02-03;446;284;22112;1938;4.1;0.4
21;2021-02-04;417;541;22529;2479;4.2;0.5
21;2021-02-05;489;526;23018;3005;4.3;0.6
21;2021-02-06;162;228;23180;3233;4.3;0.6
21;2021-02-07;2;2;23182;3235;4.4;0.6
21;2021-02-08;433;390;23615;3625;4.4;0.7
21;2021-02-09;516;524;24131;4149;4.5;0.8
21;2021-02-10;461;584;24592;4733;4.6;0.9
21;2021-02-11;486;750;25078;5483;4.7;1.0
21;2021-02-12;356;936;25434;6419;4.8;1.2
21;2021-02-13;365;325;25799;6744;4.8;1.3
21;2021-02-14;239;149;26038;6893;4.9;1.3
21;2021-02-15;120;1406;26158;8299;4.9;1.6
21;2021-02-16;207;1567;26365;9866;4.9;1.9
21;2021-02-17;405;1989;26770;11855;5.0;2.2
21;2021-02-18;604;1353;27374;13208;5.1;2.5
21;2021-02-19;218;1136;27592;14344;5.2;2.7
21;2021-02-20;121;425;27713;14769;5.2;2.8
21;2021-02-21;1;83;27714;14852;5.2;2.8
21;2021-02-22;84;773;27798;15625;5.2;2.9
21;2021-02-23;169;1040;27967;16665;5.2;3.1
21;2021-02-24;226;745;28193;17410;5.3;3.3
21;2021-02-25;647;831;28840;18241;5.4;3.4
21;2021-02-26;927;720;29767;18961;5.6;3.6
21;2021-02-27;532;300;30299;19261;5.7;3.6
21;2021-02-28;24;133;30323;19394;5.7;3.6
21;2021-03-01;680;630;31003;20024;5.8;3.8
21;2021-03-02;1055;556;32058;20580;6.0;3.9
21;2021-03-03;1169;449;33227;21029;6.2;3.9
21;2021-03-04;1689;522;34916;21551;6.6;4.0
21;2021-03-05;2196;668;37112;22219;7.0;4.2
21;2021-03-06;1595;202;38707;22421;7.3;4.2
21;2021-03-07;4;16;38711;22437;7.3;4.2
21;2021-03-08;773;449;39484;22886;7.4;4.3
21;2021-03-09;1572;577;41056;23463;7.7;4.4
21;2021-03-10;1627;565;42683;24028;8.0;4.5
21;2021-03-11;2198;705;44881;24733;8.4;4.6
21;2021-03-12;2904;442;47785;25175;9.0;4.7
21;2021-03-13;1932;190;49717;25365;9.3;4.8
21;2021-03-14;38;48;49755;25413;9.3;4.8
21;2021-03-15;1416;87;51171;25500;9.6;4.8
21;2021-03-16;1884;159;53055;25659;10.0;4.8
21;2021-03-17;1810;120;54865;25779;10.3;4.8
21;2021-03-18;2128;272;56993;26051;10.7;4.9
21;2021-03-19;1964;151;58957;26202;11.1;4.9
21;2021-03-20;1228;39;60185;26241;11.3;4.9
21;2021-03-21;2;0;60187;26241;11.3;4.9
21;2021-03-22;1556;93;61743;26334;11.6;4.9
21;2021-03-23;2696;109;64439;26443;12.1;5.0
21;2021-03-24;2896;165;67335;26608;12.6;5.0
21;2021-03-25;3731;249;71066;26857;13.3;5.0
21;2021-03-26;3655;207;74721;27064;14.0;5.1
21;2021-03-27;1732;62;76453;27126;14.3;5.1
21;2021-03-28;200;38;76653;27164;14.4;5.1
21;2021-03-29;1788;522;78441;27686;14.7;5.2
21;2021-03-30;2347;810;80788;28496;15.2;5.3
21;2021-03-31;2718;656;83506;29152;15.7;5.5
21;2021-04-01;2694;725;86200;29877;16.2;5.6
21;2021-04-02;2250;749;88450;30626;16.6;5.7
21;2021-04-03;1018;282;89468;30908;16.8;5.8
21;2021-04-04;2;12;89470;30920;16.8;5.8
21;2021-04-05;9;0;89479;30920;16.8;5.8
21;2021-04-06;1359;1140;90838;32060;17.0;6.0
21;2021-04-07;1750;970;92588;33030;17.4;6.2
21;2021-04-08;3217;1151;95805;34181;18.0;6.4
21;2021-04-09;3482;1190;99287;35371;18.6;6.6
21;2021-04-10;1376;750;100663;36121;18.9;6.8
21;2021-04-11;145;4;100808;36125;18.9;6.8
21;2021-04-12;1118;1348;101926;37473;19.1;7.0
21;2021-04-13;1654;1787;103580;39260;19.4;7.4
21;2021-04-14;1485;1475;105065;40735;19.7;7.6
21;2021-04-15;1899;1594;106964;42329;20.1;7.9
21;2021-04-16;2322;1316;109286;43645;20.5;8.2
21;2021-04-17;1020;977;110306;44622;20.7;8.4
21;2021-04-18;15;4;110321;44626;20.7;8.4
21;2021-04-19;1110;1323;111431;45949;20.9;8.6
21;2021-04-20;1245;1837;112676;47786;21.1;9.0
21;2021-04-21;1096;1723;113772;49509;21.4;9.3
21;2021-04-22;1275;2219;115047;51728;21.6;9.7
21;2021-04-23;1984;1732;117031;53460;22.0;10.0
21;2021-04-24;1002;874;118033;54334;22.1;10.2
21;2021-04-25;9;169;118042;54503;22.2;10.2
21;2021-04-26;1013;1598;119055;56101;22.3;10.5
21;2021-04-27;1843;1943;120898;58044;22.7;10.9
21;2021-04-28;2231;2231;123129;60275;23.1;11.3
21;2021-04-29;3135;2272;126264;62547;23.7;11.7
21;2021-04-30;3563;1866;129827;64413;24.4;12.1
21;2021-05-01;962;227;130789;64640;24.5;12.1
21;2021-05-02;2;5;130791;64645;24.5;12.1
21;2021-05-03;2081;1351;132872;65996;24.9;12.4
21;2021-05-04;2578;1651;135450;67647;25.4;12.7
21;2021-05-05;2247;1692;137697;69339;25.8;13.0
21;2021-05-06;3016;2252;140713;71591;26.4;13.4
21;2021-05-07;2805;2181;143518;73772;26.9;13.8
21;2021-05-08;1067;272;144585;74044;27.1;13.9
21;2021-05-09;26;177;144611;74221;27.1;13.9
21;2021-05-10;3169;1730;147780;75951;27.7;14.3
21;2021-05-11;4923;2006;152703;77957;28.7;14.6
21;2021-05-12;4805;1750;157508;79707;29.6;15.0
21;2021-05-13;3845;369;161353;80076;30.3;15.0
21;2021-05-14;5197;1472;166550;81548;31.3;15.3
21;2021-05-15;3428;647;169978;82195;31.9;15.4
21;2021-05-16;49;4;170027;82199;31.9;15.4
21;2021-05-17;4128;1259;174155;83458;32.7;15.7
21;2021-05-18;4360;1504;178515;84962;33.5;15.9
21;2021-05-19;3470;1128;181985;86090;34.2;16.2
21;2021-05-20;3898;1362;185883;87452;34.9;16.4
21;2021-05-21;3628;2157;189511;89609;35.6;16.8
21;2021-05-22;1669;771;191180;90380;35.9;17.0
21;2021-05-23;4;17;191184;90397;35.9;17.0
21;2021-05-24;1815;266;192999;90663;36.2;17.0
21;2021-05-25;2648;1963;195647;92626;36.7;17.4
21;2021-05-26;2604;2000;198251;94626;37.2;17.8
21;2021-05-27;4014;2099;202265;96725;38.0;18.2
21;2021-05-28;3572;2822;205837;99547;38.6;18.7
21;2021-05-29;1932;1469;207769;101016;39.0;19.0
21;2021-05-30;98;13;207867;101029;39.0;19.0
21;2021-05-31;2501;1781;210368;102810;39.5;19.3
21;2021-06-01;3449;2254;213817;105064;40.1;19.7
21;2021-06-02;2617;1761;216434;106825;40.6;20.0
21;2021-06-03;3146;2077;219580;108902;41.2;20.4
21;2021-06-04;3286;2591;222866;111493;41.8;20.9
21;2021-06-05;2921;1653;225787;113146;42.4;21.2
21;2021-06-06;51;85;225838;113231;42.4;21.2
21;2021-06-07;4314;1347;230152;114578;43.2;21.5
21;2021-06-08;4935;2146;235087;116724;44.1;21.9
21;2021-06-09;4500;1631;239587;118355;45.0;22.2
21;2021-06-10;3933;2596;243520;120951;45.7;22.7
21;2021-06-11;4164;3109;247684;124060;46.5;23.3
21;2021-06-12;2199;1608;249883;125668;46.9;23.6
21;2021-06-13;29;11;249912;125679;46.9;23.6
21;2021-06-14;2198;2565;252110;128244;47.3;24.1
21;2021-06-15;2959;3092;255069;131336;47.9;24.6
21;2021-06-16;2850;2612;257919;133948;48.4;25.1
21;2021-06-17;3422;3041;261341;136989;49.0;25.7
21;2021-06-18;2424;3802;263765;140791;49.5;26.4
21;2021-06-19;2045;1865;265810;142656;49.9;26.8
21;2021-06-20;26;13;265836;142669;49.9;26.8
21;2021-06-21;1840;3407;267676;146076;50.2;27.4
21;2021-06-22;1885;5829;269561;151905;50.6;28.5
21;2021-06-23;2030;5011;271591;156916;51.0;29.4
21;2021-06-24;2367;4666;273958;161582;51.4;30.3
21;2021-06-25;1530;5895;275488;167477;51.7;31.4
21;2021-06-26;1441;3899;276929;171376;52.0;32.2
21;2021-06-27;18;125;276947;171501;52.0;32.2
21;2021-06-28;1397;4017;278344;175518;52.2;32.9
21;2021-06-29;1633;4174;279977;179692;52.5;33.7
21;2021-06-30;1568;3372;281545;183064;52.8;34.4
21;2021-07-01;1663;4147;283208;187211;53.1;35.1
21;2021-07-02;2179;4231;285387;191442;53.6;35.9
21;2021-07-03;1096;2101;286483;193543;53.8;36.3
21;2021-07-04;37;55;286520;193598;53.8;36.3
21;2021-07-05;1611;3628;288131;197226;54.1;37.0
21;2021-07-06;1349;3583;289480;200809;54.3;37.7
21;2021-07-07;1455;3240;290935;204049;54.6;38.3
21;2021-07-08;1884;4160;292819;208209;54.9;39.1
21;2021-07-09;2081;4350;294900;212559;55.3;39.9
21;2021-07-10;1089;2547;295989;215106;55.5;40.4
21;2021-07-11;21;74;296010;215180;55.5;40.4
21;2021-07-12;1656;3727;297666;218907;55.9;41.1
21;2021-07-13;2343;4889;300009;223796;56.3;42.0
21;2021-07-14;2874;2017;302883;225813;56.8;42.4
21;2021-07-15;3814;4551;306697;230364;57.6;43.2
21;2021-07-16;3889;5254;310586;235618;58.3;44.2
21;2021-07-17;2775;4170;313361;239788;58.8;45.0
21;2021-07-18;158;82;313519;239870;58.8;45.0
21;2021-07-19;2376;4624;315895;244494;59.3;45.9
21;2021-07-20;2760;5487;318655;249981;59.8;46.9
21;2021-07-21;2908;4787;321563;254768;60.3;47.8
21;2021-07-22;3026;4721;324589;259489;60.9;48.7
21;2021-07-23;4352;4896;328941;264385;61.7;49.6
21;2021-07-24;3034;3021;331975;267406;62.3;50.2
21;2021-07-25;68;40;332043;267446;62.3;50.2
21;2021-07-26;2663;3590;334706;271036;62.8;50.9
21;2021-07-27;3412;3772;338118;274808;63.5;51.6
21;2021-07-28;3574;3355;341692;278163;64.1;52.2
21;2021-07-29;4135;3366;345827;281529;64.9;52.8
21;2021-07-30;4622;3353;350449;284882;65.8;53.5
21;2021-07-31;3427;2378;353876;287260;66.4;53.9
21;2021-08-01;331;57;354207;287317;66.5;53.9
21;2021-08-02;2541;3168;356748;290485;66.9;54.5
21;2021-08-03;2624;2761;359372;293246;67.4;55.0
21;2021-08-04;2365;2487;361737;295733;67.9;55.5
21;2021-08-05;2219;3079;363956;298812;68.3;56.1
21;2021-08-06;2591;3312;366547;302124;68.8;56.7
21;2021-08-07;1905;2660;368452;304784;69.1;57.2
21;2021-08-08;75;70;368527;304854;69.2;57.2
21;2021-08-09;1651;2930;370178;307784;69.5;57.8
21;2021-08-10;1413;2715;371591;310499;69.7;58.3
21;2021-08-11;1666;2446;373257;312945;70.0;58.7
21;2021-08-12;1176;2419;374433;315364;70.3;59.2
21;2021-08-13;1525;2747;375958;318111;70.6;59.7
21;2021-08-14;860;2435;376818;320546;70.7;60.2
21;2021-08-15;51;64;376869;320610;70.7;60.2
21;2021-08-16;1400;2822;378269;323432;71.0;60.7
21;2021-08-17;1205;2775;379474;326207;71.2;61.2
21;2021-08-18;1030;2873;380504;329080;71.4;61.8
21;2021-08-19;957;3068;381461;332148;71.6;62.3
21;2021-08-20;1065;4192;382526;336340;71.8;63.1
21;2021-08-21;844;3143;383370;339483;71.9;63.7
21;2021-08-22;35;117;383405;339600;71.9;63.7
21;2021-08-23;938;3220;384343;342820;72.1;64.3
21;2021-08-24;987;2877;385330;345697;72.3;64.9
21;2021-08-25;870;2551;386200;348248;72.5;65.4
21;2021-08-26;728;2427;386928;350675;72.6;65.8
21;2021-08-27;1035;3398;387963;354073;72.8;66.4
21;2021-08-28;711;2757;388674;356830;72.9;67.0
21;2021-08-29;48;215;388722;357045;72.9;67.0
21;2021-08-30;790;2214;389512;359259;73.1;67.4
21;2021-08-31;944;1990;390456;361249;73.3;67.8
21;2021-09-01;625;1613;391081;362862;73.4;68.1
21;2021-09-02;551;1214;391632;364076;73.5;68.3
21;2021-09-03;787;1714;392419;365790;73.6;68.6
21;2021-09-04;752;1445;393171;367235;73.8;68.9
21;2021-09-05;69;79;393240;367314;73.8;68.9
21;2021-09-06;412;1243;393652;368557;73.9;69.2
21;2021-09-07;396;1033;394048;369590;73.9;69.4
21;2021-09-08;556;1285;394604;370875;74.1;69.6
21;2021-09-09;406;933;395010;371808;74.1;69.8
21;2021-09-10;673;1390;395683;373198;74.3;70.0
21;2021-09-11;474;1300;396157;374498;74.3;70.3
21;2021-09-12;20;34;396177;374532;74.3;70.3
21;2021-09-13;258;703;396435;375235;74.4;70.4
21;2021-09-14;479;956;396914;376191;74.5;70.6
21;2021-09-15;488;905;397402;377096;74.6;70.8
21;2021-09-16;343;759;397745;377855;74.6;70.9
21;2021-09-17;555;1057;398300;378912;74.7;71.1
21;2021-09-18;328;1007;398628;379919;74.8;71.3
21;2021-09-19;5;21;398633;379940;74.8;71.3
21;2021-09-20;254;620;398887;380560;74.9;71.4
21;2021-09-21;375;664;399262;381224;74.9;71.5
21;2021-09-22;336;906;399598;382130;75.0;71.7
21;2021-09-23;274;522;399872;382652;75.0;71.8
21;2021-09-24;359;806;400231;383458;75.1;72.0
21;2021-09-25;215;866;400446;384324;75.1;72.1
21;2021-09-26;6;21;400452;384345;75.1;72.1
21;2021-09-27;243;447;400695;384792;75.2;72.2
21;2021-09-28;211;489;400906;385281;75.2;72.3
21;2021-09-29;245;535;401151;385816;75.3;72.4
21;2021-09-30;290;404;401441;386220;75.3;72.5
21;2021-10-01;363;834;401804;387054;75.4;72.6
21;2021-10-02;223;574;402027;387628;75.4;72.7
21;2021-10-03;6;22;402033;387650;75.4;72.7
21;2021-10-04;196;330;402229;387980;75.5;72.8
21;2021-10-05;153;461;402382;388441;75.5;72.9
21;2021-10-06;240;508;402622;388949;75.6;73.0
21;2021-10-07;140;335;402762;389284;75.6;73.1
21;2021-10-08;384;737;403146;390021;75.7;73.2
21;2021-10-09;249;442;403395;390463;75.7;73.3
21;2021-10-10;4;13;403399;390476;75.7;73.3
21;2021-10-11;132;313;403531;390789;75.7;73.3
21;2021-10-12;164;440;403695;391229;75.8;73.4
21;2021-10-13;241;398;403936;391627;75.8;73.5
21;2021-10-14;158;343;404094;391970;75.8;73.6
22;2020-12-27;0;0;0;0;0.0;0.0
22;2020-12-28;0;0;0;0;0.0;0.0
22;2020-12-29;0;0;0;0;0.0;0.0
22;2020-12-30;0;0;0;0;0.0;0.0
22;2020-12-31;0;0;0;0;0.0;0.0
22;2021-01-01;0;0;0;0;0.0;0.0
22;2021-01-02;2;0;2;0;0.0;0.0
22;2021-01-03;0;0;2;0;0.0;0.0
22;2021-01-04;5;0;7;0;0.0;0.0
22;2021-01-05;61;0;68;0;0.0;0.0
22;2021-01-06;114;1;182;1;0.0;0.0
22;2021-01-07;67;0;249;1;0.0;0.0
22;2021-01-08;174;0;423;1;0.1;0.0
22;2021-01-09;1;0;424;1;0.1;0.0
22;2021-01-10;0;0;424;1;0.1;0.0
22;2021-01-11;234;3;658;4;0.1;0.0
22;2021-01-12;627;0;1285;4;0.2;0.0
22;2021-01-13;677;1;1962;5;0.3;0.0
22;2021-01-14;718;8;2680;13;0.4;0.0
22;2021-01-15;529;2;3209;15;0.5;0.0
22;2021-01-16;96;0;3305;15;0.6;0.0
22;2021-01-17;1;0;3306;15;0.6;0.0
22;2021-01-18;312;2;3618;17;0.6;0.0
22;2021-01-19;686;1;4304;18;0.7;0.0
22;2021-01-20;598;1;4902;19;0.8;0.0
22;2021-01-21;947;2;5849;21;1.0;0.0
22;2021-01-22;840;2;6689;23;1.1;0.0
22;2021-01-23;219;0;6908;23;1.2;0.0
22;2021-01-24;2;0;6910;23;1.2;0.0
22;2021-01-25;751;11;7661;34;1.3;0.0
22;2021-01-26;1018;59;8679;93;1.5;0.0
22;2021-01-27;3858;118;12537;211;2.1;0.0
22;2021-01-28;4511;89;17048;300;2.9;0.1
22;2021-01-29;1898;130;18946;430;3.2;0.1
22;2021-01-30;289;0;19235;430;3.2;0.1
22;2021-01-31;3;0;19238;430;3.2;0.1
22;2021-02-01;642;81;19880;511;3.3;0.1
22;2021-02-02;903;436;20783;947;3.5;0.2
22;2021-02-03;691;503;21474;1450;3.6;0.2
22;2021-02-04;965;639;22439;2089;3.8;0.4
22;2021-02-05;723;565;23162;2654;3.9;0.4
22;2021-02-06;256;2;23418;2656;3.9;0.4
22;2021-02-07;0;0;23418;2656;3.9;0.4
22;2021-02-08;531;134;23949;2790;4.0;0.5
22;2021-02-09;614;347;24563;3137;4.1;0.5
22;2021-02-10;425;201;24988;3338;4.2;0.6
22;2021-02-11;1085;325;26073;3663;4.4;0.6
22;2021-02-12;595;329;26668;3992;4.5;0.7
22;2021-02-13;319;78;26987;4070;4.5;0.7
22;2021-02-14;0;5;26987;4075;4.5;0.7
22;2021-02-15;672;430;27659;4505;4.6;0.8
22;2021-02-16;1042;702;28701;5207;4.8;0.9
22;2021-02-17;1203;2457;29904;7664;5.0;1.3
22;2021-02-18;2146;3009;32050;10673;5.4;1.8
22;2021-02-19;1637;1947;33687;12620;5.7;2.1
22;2021-02-20;480;214;34167;12834;5.7;2.2
22;2021-02-21;7;49;34174;12883;5.7;2.2
22;2021-02-22;401;718;34575;13601;5.8;2.3
22;2021-02-23;665;934;35240;14535;5.9;2.4
22;2021-02-24;695;947;35935;15482;6.0;2.6
22;2021-02-25;1200;1202;37135;16684;6.2;2.8
22;2021-02-26;1066;710;38201;17394;6.4;2.9
22;2021-02-27;564;285;38765;17679;6.5;3.0
22;2021-02-28;16;8;38781;17687;6.5;3.0
22;2021-03-01;960;524;39741;18211;6.7;3.1
22;2021-03-02;1209;879;40950;19090;6.9;3.2
22;2021-03-03;1325;864;42275;19954;7.1;3.3
22;2021-03-04;1602;935;43877;20889;7.4;3.5
22;2021-03-05;2110;808;45987;21697;7.7;3.6
22;2021-03-06;1114;302;47101;21999;7.9;3.7
22;2021-03-07;219;1;47320;22000;7.9;3.7
22;2021-03-08;1291;661;48611;22661;8.2;3.8
22;2021-03-09;1824;756;50435;23417;8.5;3.9
22;2021-03-10;1987;1006;52422;24423;8.8;4.1
22;2021-03-11;2375;1661;54797;26084;9.2;4.4
22;2021-03-12;3101;968;57898;27052;9.7;4.5
22;2021-03-13;1722;296;59620;27348;10.0;4.6
22;2021-03-14;245;25;59865;27373;10.0;4.6
22;2021-03-15;1621;570;61486;27943;10.3;4.7
22;2021-03-16;1603;859;63089;28802;10.6;4.8
22;2021-03-17;2651;708;65740;29510;11.0;4.9
22;2021-03-18;2553;1108;68293;30618;11.5;5.1
22;2021-03-19;3281;803;71574;31421;12.0;5.3
22;2021-03-20;2208;288;73782;31709;12.4;5.3
22;2021-03-21;16;0;73798;31709;12.4;5.3
22;2021-03-22;2363;367;76161;32076;12.8;5.4
22;2021-03-23;3142;787;79303;32863;13.3;5.5
22;2021-03-24;3485;692;82788;33555;13.9;5.6
22;2021-03-25;3961;610;86749;34165;14.6;5.7
22;2021-03-26;4003;491;90752;34656;15.2;5.8
22;2021-03-27;2093;183;92845;34839;15.6;5.8
22;2021-03-28;67;1;92912;34840;15.6;5.8
22;2021-03-29;2765;914;95677;35754;16.0;6.0
22;2021-03-30;3567;1159;99244;36913;16.6;6.2
22;2021-03-31;3674;1091;102918;38004;17.3;6.4
22;2021-04-01;4943;1135;107861;39139;18.1;6.6
22;2021-04-02;4391;1042;112252;40181;18.8;6.7
22;2021-04-03;1998;404;114250;40585;19.2;6.8
22;2021-04-04;37;0;114287;40585;19.2;6.8
22;2021-04-05;15;0;114302;40585;19.2;6.8
22;2021-04-06;3288;1143;117590;41728;19.7;7.0
22;2021-04-07;3429;1376;121019;43104;20.3;7.2
22;2021-04-08;4446;1327;125465;44431;21.0;7.5
22;2021-04-09;5183;1370;130648;45801;21.9;7.7
22;2021-04-10;2447;371;133095;46172;22.3;7.7
22;2021-04-11;485;10;133580;46182;22.4;7.7
22;2021-04-12;2987;1013;136567;47195;22.9;7.9
22;2021-04-13;3318;1520;139885;48715;23.5;8.2
22;2021-04-14;3166;2492;143051;51207;24.0;8.6
22;2021-04-15;3599;2437;146650;53644;24.6;9.0
22;2021-04-16;3633;2494;150283;56138;25.2;9.4
22;2021-04-17;1920;1794;152203;57932;25.5;9.7
22;2021-04-18;17;0;152220;57932;25.5;9.7
22;2021-04-19;3022;2151;155242;60083;26.0;10.1
22;2021-04-20;3310;2798;158552;62881;26.6;10.5
22;2021-04-21;3223;2742;161775;65623;27.1;11.0
22;2021-04-22;3593;3139;165368;68762;27.7;11.5
22;2021-04-23;3727;3177;169095;71939;28.4;12.1
22;2021-04-24;2005;1967;171100;73906;28.7;12.4
22;2021-04-25;17;0;171117;73906;28.7;12.4
22;2021-04-26;3213;2858;174330;76764;29.2;12.9
22;2021-04-27;3371;3146;177701;79910;29.8;13.4
22;2021-04-28;3488;3159;181189;83069;30.4;13.9
22;2021-04-29;4080;3277;185269;86346;31.1;14.5
22;2021-04-30;3905;3230;189174;89576;31.7;15.0
22;2021-05-01;60;69;189234;89645;31.7;15.0
22;2021-05-02;1237;59;190471;89704;31.9;15.0
22;2021-05-03;2029;2714;192500;92418;32.3;15.5
22;2021-05-04;2155;2899;194655;95317;32.7;16.0
22;2021-05-05;2049;3005;196704;98322;33.0;16.5
22;2021-05-06;2508;3498;199212;101820;33.4;17.1
22;2021-05-07;2829;3408;202041;105228;33.9;17.7
22;2021-05-08;45;121;202086;105349;33.9;17.7
22;2021-05-09;602;438;202688;105787;34.0;17.7
22;2021-05-10;4473;2733;207161;108520;34.7;18.2
22;2021-05-11;5106;2903;212267;111423;35.6;18.7
22;2021-05-12;6599;1025;218866;112448;36.7;18.9
22;2021-05-13;528;35;219394;112483;36.8;18.9
22;2021-05-14;6407;1089;225801;113572;37.9;19.0
22;2021-05-15;3988;429;229789;114001;38.5;19.1
22;2021-05-16;419;37;230208;114038;38.6;19.1
22;2021-05-17;5668;521;235876;114559;39.6;19.2
22;2021-05-18;6012;955;241888;115514;40.6;19.4
22;2021-05-19;6130;711;248018;116225;41.6;19.5
22;2021-05-20;6587;1375;254605;117600;42.7;19.7
22;2021-05-21;5899;1455;260504;119055;43.7;20.0
22;2021-05-22;4093;772;264597;119827;44.4;20.1
22;2021-05-23;407;17;265004;119844;44.4;20.1
22;2021-05-24;5315;226;270319;120070;45.3;20.1
22;2021-05-25;5638;1180;275957;121250;46.3;20.3
22;2021-05-26;4226;2811;280183;124061;47.0;20.8
22;2021-05-27;4504;3841;284687;127902;47.8;21.5
22;2021-05-28;4384;4436;289071;132338;48.5;22.2
22;2021-05-29;3046;1771;292117;134109;49.0;22.5
22;2021-05-30;19;7;292136;134116;49.0;22.5
22;2021-05-31;3653;3154;295789;137270;49.6;23.0
22;2021-06-01;3520;3690;299309;140960;50.2;23.6
22;2021-06-02;3085;3387;302394;144347;50.7;24.2
22;2021-06-03;3196;4099;305590;148446;51.3;24.9
22;2021-06-04;3371;4540;308961;152986;51.8;25.7
22;2021-06-05;3543;2027;312504;155013;52.4;26.0
22;2021-06-06;214;30;312718;155043;52.5;26.0
22;2021-06-07;3042;3256;315760;158299;53.0;26.6
22;2021-06-08;2798;3530;318558;161829;53.4;27.1
22;2021-06-09;2543;3506;321101;165335;53.9;27.7
22;2021-06-10;2516;4249;323617;169584;54.3;28.4
22;2021-06-11;2551;4227;326168;173811;54.7;29.2
22;2021-06-12;2411;1454;328579;175265;55.1;29.4
22;2021-06-13;134;1093;328713;176358;55.1;29.6
22;2021-06-14;2644;2470;331357;178828;55.6;30.0
22;2021-06-15;3095;2996;334452;181824;56.1;30.5
22;2021-06-16;3008;2812;337460;184636;56.6;31.0
22;2021-06-17;2560;3182;340020;187818;57.0;31.5
22;2021-06-18;3102;4116;343122;191934;57.6;32.2
22;2021-06-19;2984;1455;346106;193389;58.1;32.4
22;2021-06-20;157;8;346263;193397;58.1;32.4
22;2021-06-21;1783;5021;348046;198418;58.4;33.3
22;2021-06-22;2403;5554;350449;203972;58.8;34.2
22;2021-06-23;1285;6203;351734;210175;59.0;35.3
22;2021-06-24;2578;3912;354312;214087;59.4;35.9
22;2021-06-25;1568;6812;355880;220899;59.7;37.1
22;2021-06-26;783;3853;356663;224752;59.8;37.7
22;2021-06-27;4;511;356667;225263;59.8;37.8
22;2021-06-28;1051;5586;357718;230849;60.0;38.7
22;2021-06-29;1375;5954;359093;236803;60.2;39.7
22;2021-06-30;1129;5738;360222;242541;60.4;40.7
22;2021-07-01;1383;6037;361605;248578;60.7;41.7
22;2021-07-02;1708;6094;363313;254672;60.9;42.7
22;2021-07-03;1009;3819;364322;258491;61.1;43.4
22;2021-07-04;149;365;364471;258856;61.1;43.4
22;2021-07-05;1598;5804;366069;264660;61.4;44.4
22;2021-07-06;2312;5992;368381;270652;61.8;45.4
22;2021-07-07;2292;4933;370673;275585;62.2;46.2
22;2021-07-08;2503;5097;373176;280682;62.6;47.1
22;2021-07-09;2496;5386;375672;286068;63.0;48.0
22;2021-07-10;1808;3359;377480;289427;63.3;48.5
22;2021-07-11;484;75;377964;289502;63.4;48.6
22;2021-07-12;2335;4733;380299;294235;63.8;49.4
22;2021-07-13;3782;5055;384081;299290;64.4;50.2
22;2021-07-14;700;2490;384781;301780;64.5;50.6
22;2021-07-15;3871;4622;388652;306402;65.2;51.4
22;2021-07-16;3835;5293;392487;311695;65.8;52.3
22;2021-07-17;2558;3412;395045;315107;66.3;52.9
22;2021-07-18;571;88;395616;315195;66.4;52.9
22;2021-07-19;2773;4104;398389;319299;66.8;53.6
22;2021-07-20;3923;4133;402312;323432;67.5;54.3
22;2021-07-21;3999;3420;406311;326852;68.2;54.8
22;2021-07-22;4861;3707;411172;330559;69.0;55.4
22;2021-07-23;4452;4220;415624;334779;69.7;56.2
22;2021-07-24;2260;2616;417884;337395;70.1;56.6
22;2021-07-25;118;150;418002;337545;70.1;56.6
22;2021-07-26;3021;3921;421023;341466;70.6;57.3
22;2021-07-27;3728;4918;424751;346384;71.2;58.1
22;2021-07-28;3705;3662;428456;350046;71.9;58.7
22;2021-07-29;4294;3780;432750;353826;72.6;59.3
22;2021-07-30;4038;3978;436788;357804;73.3;60.0
22;2021-07-31;2403;2806;439191;360610;73.7;60.5
22;2021-08-01;119;150;439310;360760;73.7;60.5
22;2021-08-02;4670;2552;443980;363312;74.5;60.9
22;2021-08-03;4787;3427;448767;366739;75.3;61.5
22;2021-08-04;5774;2499;454541;369238;76.2;61.9
22;2021-08-05;4128;3804;458669;373042;76.9;62.6
22;2021-08-06;3654;3811;462323;376853;77.5;63.2
22;2021-08-07;2355;2269;464678;379122;77.9;63.6
22;2021-08-08;427;71;465105;379193;78.0;63.6
22;2021-08-09;2722;2708;467827;381901;78.5;64.1
22;2021-08-10;2735;3513;470562;385414;78.9;64.6
22;2021-08-11;2429;3114;472991;388528;79.3;65.2
22;2021-08-12;2215;3478;475206;392006;79.7;65.8
22;2021-08-13;1938;2973;477144;394979;80.0;66.3
22;2021-08-14;1342;1911;478486;396890;80.3;66.6
22;2021-08-15;87;199;478573;397089;80.3;66.6
22;2021-08-16;1470;3178;480043;400267;80.5;67.1
22;2021-08-17;1758;3459;481801;403726;80.8;67.7
22;2021-08-18;1406;3302;483207;407028;81.0;68.3
22;2021-08-19;1350;3609;484557;410637;81.3;68.9
22;2021-08-20;1462;3605;486019;414242;81.5;69.5
22;2021-08-21;814;2261;486833;416503;81.7;69.9
22;2021-08-22;151;308;486984;416811;81.7;69.9
22;2021-08-23;1966;3609;488950;420420;82.0;70.5
22;2021-08-24;1432;3246;490382;423666;82.3;71.1
22;2021-08-25;844;2507;491226;426173;82.4;71.5
22;2021-08-26;1055;4294;492281;430467;82.6;72.2
22;2021-08-27;1326;4602;493607;435069;82.8;73.0
22;2021-08-28;737;2517;494344;437586;82.9;73.4
22;2021-08-29;35;26;494379;437612;82.9;73.4
22;2021-08-30;927;2926;495306;440538;83.1;73.9
22;2021-08-31;968;3740;496274;444278;83.2;74.5
22;2021-09-01;972;3252;497246;447530;83.4;75.1
22;2021-09-02;840;2833;498086;450363;83.5;75.5
22;2021-09-03;943;2768;499029;453131;83.7;76.0
22;2021-09-04;783;2606;499812;455737;83.8;76.4
22;2021-09-05;97;28;499909;455765;83.9;76.4
22;2021-09-06;491;1862;500400;457627;83.9;76.8
22;2021-09-07;513;2014;500913;459641;84.0;77.1
22;2021-09-08;634;1879;501547;461520;84.1;77.4
22;2021-09-09;679;1924;502226;463444;84.2;77.7
22;2021-09-10;706;2122;502932;465566;84.4;78.1
22;2021-09-11;586;1693;503518;467259;84.5;78.4
22;2021-09-12;31;81;503549;467340;84.5;78.4
22;2021-09-13;486;2097;504035;469437;84.5;78.7
22;2021-09-14;592;1572;504627;471009;84.6;79.0
22;2021-09-15;463;1703;505090;472712;84.7;79.3
22;2021-09-16;551;1042;505641;473754;84.8;79.5
22;2021-09-17;626;1631;506267;475385;84.9;79.7
22;2021-09-18;284;2161;506551;477546;85.0;80.1
22;2021-09-19;1;8;506552;477554;85.0;80.1
22;2021-09-20;363;709;506915;478263;85.0;80.2
22;2021-09-21;363;956;507278;479219;85.1;80.4
22;2021-09-22;302;1160;507580;480379;85.1;80.6
22;2021-09-23;405;720;507985;481099;85.2;80.7
22;2021-09-24;362;1099;508347;482198;85.3;80.9
22;2021-09-25;219;1386;508566;483584;85.3;81.1
22;2021-09-26;12;70;508578;483654;85.3;81.1
22;2021-09-27;336;744;508914;484398;85.4;81.2
22;2021-09-28;203;576;509117;484974;85.4;81.3
22;2021-09-29;232;887;509349;485861;85.4;81.5
22;2021-09-30;271;740;509620;486601;85.5;81.6
22;2021-10-01;278;776;509898;487377;85.5;81.7
22;2021-10-02;332;915;510230;488292;85.6;81.9
22;2021-10-03;0;0;510230;488292;85.6;81.9
22;2021-10-04;119;427;510349;488719;85.6;82.0
22;2021-10-05;220;644;510569;489363;85.6;82.1
22;2021-10-06;225;369;510794;489732;85.7;82.1
22;2021-10-07;243;689;511037;490421;85.7;82.3
22;2021-10-08;319;775;511356;491196;85.8;82.4
22;2021-10-09;238;461;511594;491657;85.8;82.5
22;2021-10-10;4;8;511598;491665;85.8;82.5
22;2021-10-11;130;260;511728;491925;85.8;82.5
22;2021-10-12;84;151;511812;492076;85.8;82.5
22;2021-10-13;179;249;511991;492325;85.9;82.6
22;2021-10-14;224;763;512215;493088;85.9;82.7
23;2020-12-27;0;0;0;0;0.0;0.0
23;2020-12-28;2;0;2;0;0.0;0.0
23;2020-12-29;0;0;2;0;0.0;0.0
23;2020-12-30;0;0;2;0;0.0;0.0
23;2020-12-31;0;0;2;0;0.0;0.0
23;2021-01-01;0;0;2;0;0.0;0.0
23;2021-01-02;1;0;3;0;0.0;0.0
23;2021-01-03;1;1;4;1;0.0;0.0
23;2021-01-04;1;0;5;1;0.0;0.0
23;2021-01-05;3;0;8;1;0.0;0.0
23;2021-01-06;10;0;18;1;0.0;0.0
23;2021-01-07;116;1;134;2;0.1;0.0
23;2021-01-08;117;0;251;2;0.2;0.0
23;2021-01-09;36;0;287;2;0.2;0.0
23;2021-01-10;1;0;288;2;0.2;0.0
23;2021-01-11;176;2;464;4;0.4;0.0
23;2021-01-12;237;6;701;10;0.6;0.0
23;2021-01-13;310;0;1011;10;0.9;0.0
23;2021-01-14;293;5;1304;15;1.1;0.0
23;2021-01-15;334;5;1638;20;1.4;0.0
23;2021-01-16;163;1;1801;21;1.5;0.0
23;2021-01-17;0;0;1801;21;1.5;0.0
23;2021-01-18;342;3;2143;24;1.8;0.0
23;2021-01-19;498;2;2641;26;2.3;0.0
23;2021-01-20;363;1;3004;27;2.6;0.0
23;2021-01-21;700;1;3704;28;3.2;0.0
23;2021-01-22;481;0;4185;28;3.6;0.0
23;2021-01-23;368;1;4553;29;3.9;0.0
23;2021-01-24;0;0;4553;29;3.9;0.0
23;2021-01-25;382;17;4935;46;4.2;0.0
23;2021-01-26;301;5;5236;51;4.5;0.0
23;2021-01-27;227;3;5463;54;4.7;0.0
23;2021-01-28;232;45;5695;99;4.9;0.1
23;2021-01-29;304;104;5999;203;5.2;0.2
23;2021-01-30;100;28;6099;231;5.2;0.2
23;2021-01-31;2;33;6101;264;5.2;0.2
23;2021-02-01;148;105;6249;369;5.4;0.3
23;2021-02-02;157;123;6406;492;5.5;0.4
23;2021-02-03;105;207;6511;699;5.6;0.6
23;2021-02-04;77;263;6588;962;5.7;0.8
23;2021-02-05;117;312;6705;1274;5.8;1.1
23;2021-02-06;14;167;6719;1441;5.8;1.2
23;2021-02-07;1;0;6720;1441;5.8;1.2
23;2021-02-08;123;216;6843;1657;5.9;1.4
23;2021-02-09;89;298;6932;1955;6.0;1.7
23;2021-02-10;92;281;7024;2236;6.0;1.9
23;2021-02-11;246;588;7270;2824;6.3;2.4
23;2021-02-12;174;284;7444;3108;6.4;2.7
23;2021-02-13;8;191;7452;3299;6.4;2.8
23;2021-02-14;8;0;7460;3299;6.4;2.8
23;2021-02-15;157;366;7617;3665;6.6;3.2
23;2021-02-16;103;439;7720;4104;6.6;3.5
23;2021-02-17;65;490;7785;4594;6.7;4.0
23;2021-02-18;142;368;7927;4962;6.8;4.3
23;2021-02-19;109;254;8036;5216;6.9;4.5
23;2021-02-20;2;93;8038;5309;6.9;4.6
23;2021-02-21;0;0;8038;5309;6.9;4.6
23;2021-02-22;104;212;8142;5521;7.0;4.7
23;2021-02-23;108;218;8250;5739;7.1;4.9
23;2021-02-24;176;168;8426;5907;7.2;5.1
23;2021-02-25;184;110;8610;6017;7.4;5.2
23;2021-02-26;287;168;8897;6185;7.7;5.3
23;2021-02-27;112;11;9009;6196;7.7;5.3
23;2021-02-28;1;31;9010;6227;7.7;5.4
23;2021-03-01;88;201;9098;6428;7.8;5.5
23;2021-03-02;229;132;9327;6560;8.0;5.6
23;2021-03-03;133;90;9460;6650;8.1;5.7
23;2021-03-04;307;138;9767;6788;8.4;5.8
23;2021-03-05;517;111;10284;6899;8.8;5.9
23;2021-03-06;495;7;10779;6906;9.3;5.9
23;2021-03-07;313;3;11092;6909;9.5;5.9
23;2021-03-08;198;73;11290;6982;9.7;6.0
23;2021-03-09;421;103;11711;7085;10.1;6.1
23;2021-03-10;349;39;12060;7124;10.4;6.1
23;2021-03-11;324;48;12384;7172;10.7;6.2
23;2021-03-12;621;35;13005;7207;11.2;6.2
23;2021-03-13;288;12;13293;7219;11.4;6.2
23;2021-03-14;47;34;13340;7253;11.5;6.2
23;2021-03-15;220;125;13560;7378;11.7;6.3
23;2021-03-16;192;91;13752;7469;11.8;6.4
23;2021-03-17;131;101;13883;7570;11.9;6.5
23;2021-03-18;192;99;14075;7669;12.1;6.6
23;2021-03-19;209;123;14284;7792;12.3;6.7
23;2021-03-20;631;37;14915;7829;12.8;6.7
23;2021-03-21;128;0;15043;7829;12.9;6.7
23;2021-03-22;274;157;15317;7986;13.2;6.9
23;2021-03-23;504;104;15821;8090;13.6;7.0
23;2021-03-24;422;124;16243;8214;14.0;7.1
23;2021-03-25;820;190;17063;8404;14.7;7.2
23;2021-03-26;735;195;17798;8599;15.3;7.4
23;2021-03-27;507;50;18305;8649;15.7;7.4
23;2021-03-28;3;9;18308;8658;15.7;7.4
23;2021-03-29;358;111;18666;8769;16.1;7.5
23;2021-03-30;537;178;19203;8947;16.5;7.7
23;2021-03-31;411;175;19614;9122;16.9;7.8
23;2021-04-01;600;175;20214;9297;17.4;8.0
23;2021-04-02;498;299;20712;9596;17.8;8.3
23;2021-04-03;715;44;21427;9640;18.4;8.3
23;2021-04-04;4;0;21431;9640;18.4;8.3
23;2021-04-05;2;3;21433;9643;18.4;8.3
23;2021-04-06;382;293;21815;9936;18.8;8.5
23;2021-04-07;706;310;22521;10246;19.4;8.8
23;2021-04-08;805;239;23326;10485;20.1;9.0
23;2021-04-09;940;370;24266;10855;20.9;9.3
23;2021-04-10;1097;111;25363;10966;21.8;9.4
23;2021-04-11;21;2;25384;10968;21.8;9.4
23;2021-04-12;692;236;26076;11204;22.4;9.6
23;2021-04-13;670;303;26746;11507;23.0;9.9
23;2021-04-14;586;178;27332;11685;23.5;10.0
23;2021-04-15;929;186;28261;11871;24.3;10.2
23;2021-04-16;905;217;29166;12088;25.1;10.4
23;2021-04-17;996;555;30162;12643;25.9;10.9
23;2021-04-18;3;136;30165;12779;25.9;11.0
23;2021-04-19;613;297;30778;13076;26.5;11.2
23;2021-04-20;720;297;31498;13373;27.1;11.5
23;2021-04-21;733;397;32231;13770;27.7;11.8
23;2021-04-22;655;474;32886;14244;28.3;12.3
23;2021-04-23;596;347;33482;14591;28.8;12.5
23;2021-04-24;855;450;34337;15041;29.5;12.9
23;2021-04-25;0;0;34337;15041;29.5;12.9
23;2021-04-26;615;255;34952;15296;30.1;13.2
23;2021-04-27;675;429;35627;15725;30.6;13.5
23;2021-04-28;628;277;36255;16002;31.2;13.8
23;2021-04-29;883;379;37138;16381;31.9;14.1
23;2021-04-30;719;787;37857;17168;32.6;14.8
23;2021-05-01;1229;44;39086;17212;33.6;14.8
23;2021-05-02;14;0;39100;17212;33.6;14.8
23;2021-05-03;430;522;39530;17734;34.0;15.3
23;2021-05-04;617;513;40147;18247;34.5;15.7
23;2021-05-05;540;715;40687;18962;35.0;16.3
23;2021-05-06;728;702;41415;19664;35.6;16.9
23;2021-05-07;685;645;42100;20309;36.2;17.5
23;2021-05-08;1411;589;43511;20898;37.4;18.0
23;2021-05-09;4;1;43515;20899;37.4;18.0
23;2021-05-10;555;656;44070;21555;37.9;18.5
23;2021-05-11;560;765;44630;22320;38.4;19.2
23;2021-05-12;720;662;45350;22982;39.0;19.8
23;2021-05-13;538;56;45888;23038;39.5;19.8
23;2021-05-14;787;456;46675;23494;40.1;20.2
23;2021-05-15;995;235;47670;23729;41.0;20.4
23;2021-05-16;0;0;47670;23729;41.0;20.4
23;2021-05-17;566;448;48236;24177;41.5;20.8
23;2021-05-18;777;292;49013;24469;42.2;21.0
23;2021-05-19;1051;259;50064;24728;43.1;21.3
23;2021-05-20;838;314;50902;25042;43.8;21.5
23;2021-05-21;1108;311;52010;25353;44.7;21.8
23;2021-05-22;740;125;52750;25478;45.4;21.9
23;2021-05-23;3;20;52753;25498;45.4;21.9
23;2021-05-24;363;166;53116;25664;45.7;22.1
23;2021-05-25;908;336;54024;26000;46.5;22.4
23;2021-05-26;1077;227;55101;26227;47.4;22.6
23;2021-05-27;931;437;56032;26664;48.2;22.9
23;2021-05-28;781;744;56813;27408;48.9;23.6
23;2021-05-29;638;1102;57451;28510;49.4;24.5
23;2021-05-30;6;63;57457;28573;49.4;24.6
23;2021-05-31;433;541;57890;29114;49.8;25.0
23;2021-06-01;582;827;58472;29941;50.3;25.8
23;2021-06-02;624;520;59096;30461;50.8;26.2
23;2021-06-03;708;552;59804;31013;51.4;26.7
23;2021-06-04;778;614;60582;31627;52.1;27.2
23;2021-06-05;543;777;61125;32404;52.6;27.9
23;2021-06-06;0;0;61125;32404;52.6;27.9
23;2021-06-07;393;697;61518;33101;52.9;28.5
23;2021-06-08;323;776;61841;33877;53.2;29.1
23;2021-06-09;287;648;62128;34525;53.4;29.7
23;2021-06-10;374;692;62502;35217;53.8;30.3
23;2021-06-11;384;808;62886;36025;54.1;31.0
23;2021-06-12;376;1265;63262;37290;54.4;32.1
23;2021-06-13;13;5;63275;37295;54.4;32.1
23;2021-06-14;236;589;63511;37884;54.6;32.6
23;2021-06-15;229;861;63740;38745;54.8;33.3
23;2021-06-16;362;579;64102;39324;55.1;33.8
23;2021-06-17;339;810;64441;40134;55.4;34.5
23;2021-06-18;356;767;64797;40901;55.7;35.2
23;2021-06-19;492;1522;65289;42423;56.2;36.5
23;2021-06-20;2;11;65291;42434;56.2;36.5
23;2021-06-21;205;620;65496;43054;56.3;37.0
23;2021-06-22;216;687;65712;43741;56.5;37.6
23;2021-06-23;221;750;65933;44491;56.7;38.3
23;2021-06-24;200;606;66133;45097;56.9;38.8
23;2021-06-25;302;816;66435;45913;57.1;39.5
23;2021-06-26;221;999;66656;46912;57.3;40.3
23;2021-06-27;3;0;66659;46912;57.3;40.3
23;2021-06-28;115;690;66774;47602;57.4;40.9
23;2021-06-29;189;823;66963;48425;57.6;41.6
23;2021-06-30;169;944;67132;49369;57.7;42.5
23;2021-07-01;168;870;67300;50239;57.9;43.2
23;2021-07-02;192;1069;67492;51308;58.0;44.1
23;2021-07-03;250;979;67742;52287;58.3;45.0
23;2021-07-04;1;0;67743;52287;58.3;45.0
23;2021-07-05;160;804;67903;53091;58.4;45.7
23;2021-07-06;215;1043;68118;54134;58.6;46.6
23;2021-07-07;211;853;68329;54987;58.8;47.3
23;2021-07-08;254;740;68583;55727;59.0;47.9
23;2021-07-09;275;1013;68858;56740;59.2;48.8
23;2021-07-10;234;644;69092;57384;59.4;49.4
23;2021-07-11;0;0;69092;57384;59.4;49.4
23;2021-07-12;232;702;69324;58086;59.6;50.0
23;2021-07-13;471;917;69795;59003;60.0;50.7
23;2021-07-14;212;320;70007;59323;60.2;51.0
23;2021-07-15;484;810;70491;60133;60.6;51.7
23;2021-07-16;764;568;71255;60701;61.3;52.2
23;2021-07-17;220;478;71475;61179;61.5;52.6
23;2021-07-18;0;1;71475;61180;61.5;52.6
23;2021-07-19;704;630;72179;61810;62.1;53.2
23;2021-07-20;633;569;72812;62379;62.6;53.7
23;2021-07-21;702;636;73514;63015;63.2;54.2
23;2021-07-22;945;439;74459;63454;64.0;54.6
23;2021-07-23;840;508;75299;63962;64.8;55.0
23;2021-07-24;1013;439;76312;64401;65.6;55.4
23;2021-07-25;13;16;76325;64417;65.6;55.4
23;2021-07-26;788;563;77113;64980;66.3;55.9
23;2021-07-27;928;436;78041;65416;67.1;56.3
23;2021-07-28;877;411;78918;65827;67.9;56.6
23;2021-07-29;1049;400;79967;66227;68.8;57.0
23;2021-07-30;947;521;80914;66748;69.6;57.4
23;2021-07-31;1165;306;82079;67054;70.6;57.7
23;2021-08-01;19;8;82098;67062;70.6;57.7
23;2021-08-02;674;506;82772;67568;71.2;58.1
23;2021-08-03;768;458;83540;68026;71.9;58.5
23;2021-08-04;613;298;84153;68324;72.4;58.8
23;2021-08-05;692;365;84845;68689;73.0;59.1
23;2021-08-06;421;482;85266;69171;73.3;59.5
23;2021-08-07;299;188;85565;69359;73.6;59.7
23;2021-08-08;146;38;85711;69397;73.7;59.7
23;2021-08-09;492;492;86203;69889;74.1;60.1
23;2021-08-10;467;608;86670;70497;74.5;60.6
23;2021-08-11;428;487;87098;70984;74.9;61.1
23;2021-08-12;514;567;87612;71551;75.4;61.5
23;2021-08-13;420;578;88032;72129;75.7;62.0
23;2021-08-14;287;390;88319;72519;76.0;62.4
23;2021-08-15;27;9;88346;72528;76.0;62.4
23;2021-08-16;276;710;88622;73238;76.2;63.0
23;2021-08-17;277;732;88899;73970;76.5;63.6
23;2021-08-18;180;637;89079;74607;76.6;64.2
23;2021-08-19;257;726;89336;75333;76.8;64.8
23;2021-08-20;215;682;89551;76015;77.0;65.4
23;2021-08-21;140;500;89691;76515;77.1;65.8
23;2021-08-22;54;48;89745;76563;77.2;65.8
23;2021-08-23;149;816;89894;77379;77.3;66.6
23;2021-08-24;265;911;90159;78290;77.5;67.3
23;2021-08-25;187;791;90346;79081;77.7;68.0
23;2021-08-26;220;744;90566;79825;77.9;68.7
23;2021-08-27;213;639;90779;80464;78.1;69.2
23;2021-08-28;222;454;91001;80918;78.3;69.6
23;2021-08-29;15;88;91016;81006;78.3;69.7
23;2021-08-30;187;651;91203;81657;78.4;70.2
23;2021-08-31;229;663;91432;82320;78.6;70.8
23;2021-09-01;162;391;91594;82711;78.8;71.1
23;2021-09-02;119;306;91713;83017;78.9;71.4
23;2021-09-03;210;508;91923;83525;79.1;71.8
23;2021-09-04;178;793;92101;84318;79.2;72.5
23;2021-09-05;5;5;92106;84323;79.2;72.5
23;2021-09-06;133;379;92239;84702;79.3;72.8
23;2021-09-07;98;343;92337;85045;79.4;73.1
23;2021-09-08;121;357;92458;85402;79.5;73.5
23;2021-09-09;118;306;92576;85708;79.6;73.7
23;2021-09-10;150;312;92726;86020;79.8;74.0
23;2021-09-11;102;202;92828;86222;79.8;74.2
23;2021-09-12;5;7;92833;86229;79.8;74.2
23;2021-09-13;113;323;92946;86552;79.9;74.4
23;2021-09-14;113;288;93059;86840;80.0;74.7
23;2021-09-15;97;242;93156;87082;80.1;74.9
23;2021-09-16;127;153;93283;87235;80.2;75.0
23;2021-09-17;140;227;93423;87462;80.4;75.2
23;2021-09-18;44;224;93467;87686;80.4;75.4
23;2021-09-19;0;1;93467;87687;80.4;75.4
23;2021-09-20;58;221;93525;87908;80.4;75.6
23;2021-09-21;85;186;93610;88094;80.5;75.8
23;2021-09-22;71;261;93681;88355;80.6;76.0
23;2021-09-23;59;133;93740;88488;80.6;76.1
23;2021-09-24;64;234;93804;88722;80.7;76.3
23;2021-09-25;27;138;93831;88860;80.7;76.4
23;2021-09-26;0;1;93831;88861;80.7;76.4
23;2021-09-27;34;159;93865;89020;80.7;76.6
23;2021-09-28;34;133;93899;89153;80.8;76.7
23;2021-09-29;64;156;93963;89309;80.8;76.8
23;2021-09-30;43;64;94006;89373;80.9;76.9
23;2021-10-01;82;178;94088;89551;80.9;77.0
23;2021-10-02;22;97;94110;89648;80.9;77.1
23;2021-10-03;1;4;94111;89652;80.9;77.1
23;2021-10-04;42;93;94153;89745;81.0;77.2
23;2021-10-05;34;83;94187;89828;81.0;77.3
23;2021-10-06;56;97;94243;89925;81.1;77.3
23;2021-10-07;61;126;94304;90051;81.1;77.4
23;2021-10-08;52;191;94356;90242;81.2;77.6
23;2021-10-09;16;44;94372;90286;81.2;77.7
23;2021-10-10;0;0;94372;90286;81.2;77.7
23;2021-10-11;21;98;94393;90384;81.2;77.7
23;2021-10-12;51;86;94444;90470;81.2;77.8
23;2021-10-13;49;76;94493;90546;81.3;77.9
23;2021-10-14;31;66;94524;90612;81.3;77.9
24;2020-12-27;2;1;2;1;0.0;0.0
24;2020-12-28;1;0;3;1;0.0;0.0
24;2020-12-29;2;0;5;1;0.0;0.0
24;2020-12-30;1;0;6;1;0.0;0.0
24;2020-12-31;1;0;7;1;0.0;0.0
24;2021-01-01;2;1;9;2;0.0;0.0
24;2021-01-02;1;0;10;2;0.0;0.0
24;2021-01-03;1;0;11;2;0.0;0.0
24;2021-01-04;1;0;12;2;0.0;0.0
24;2021-01-05;1;0;13;2;0.0;0.0
24;2021-01-06;3;0;16;2;0.0;0.0
24;2021-01-07;190;0;206;2;0.1;0.0
24;2021-01-08;282;0;488;2;0.1;0.0
24;2021-01-09;185;13;673;15;0.2;0.0
24;2021-01-10;35;0;708;15;0.2;0.0
24;2021-01-11;269;0;977;15;0.2;0.0
24;2021-01-12;280;0;1257;15;0.3;0.0
24;2021-01-13;233;1;1490;16;0.4;0.0
24;2021-01-14;1024;31;2514;47;0.6;0.0
24;2021-01-15;608;6;3122;53;0.8;0.0
24;2021-01-16;88;0;3210;53;0.8;0.0
24;2021-01-17;2;1;3212;54;0.8;0.0
24;2021-01-18;300;1;3512;55;0.9;0.0
24;2021-01-19;468;1;3980;56;1.0;0.0
24;2021-01-20;557;3;4537;59;1.1;0.0
24;2021-01-21;647;6;5184;65;1.3;0.0
24;2021-01-22;517;1;5701;66;1.4;0.0
24;2021-01-23;154;1;5855;67;1.4;0.0
24;2021-01-24;4;1;5859;68;1.4;0.0
24;2021-01-25;443;1;6302;69;1.5;0.0
24;2021-01-26;638;65;6940;134;1.7;0.0
24;2021-01-27;1267;15;8207;149;2.0;0.0
24;2021-01-28;986;131;9193;280;2.3;0.1
24;2021-01-29;933;139;10126;419;2.5;0.1
24;2021-01-30;282;1;10408;420;2.5;0.1
24;2021-01-31;0;0;10408;420;2.5;0.1
24;2021-02-01;379;170;10787;590;2.6;0.1
24;2021-02-02;616;308;11403;898;2.8;0.2
24;2021-02-03;654;491;12057;1389;3.0;0.3
24;2021-02-04;977;392;13034;1781;3.2;0.4
24;2021-02-05;689;410;13723;2191;3.4;0.5
24;2021-02-06;142;36;13865;2227;3.4;0.5
24;2021-02-07;33;1;13898;2228;3.4;0.5
24;2021-02-08;310;237;14208;2465;3.5;0.6
24;2021-02-09;454;231;14662;2696;3.6;0.7
24;2021-02-10;378;112;15040;2808;3.7;0.7
24;2021-02-11;561;515;15601;3323;3.8;0.8
24;2021-02-12;498;390;16099;3713;3.9;0.9
24;2021-02-13;202;45;16301;3758;4.0;0.9
24;2021-02-14;89;0;16390;3758;4.0;0.9
24;2021-02-15;188;241;16578;3999;4.1;1.0
24;2021-02-16;336;520;16914;4519;4.1;1.1
24;2021-02-17;586;848;17500;5367;4.3;1.3
24;2021-02-18;446;734;17946;6101;4.4;1.5
24;2021-02-19;462;679;18408;6780;4.5;1.7
24;2021-02-20;164;140;18572;6920;4.5;1.7
24;2021-02-21;112;0;18684;6920;4.6;1.7
24;2021-02-22;427;527;19111;7447;4.7;1.8
24;2021-02-23;565;683;19676;8130;4.8;2.0
24;2021-02-24;539;831;20215;8961;4.9;2.2
24;2021-02-25;727;864;20942;9825;5.1;2.4
24;2021-02-26;978;973;21920;10798;5.4;2.6
24;2021-02-27;363;266;22283;11064;5.5;2.7
24;2021-02-28;25;4;22308;11068;5.5;2.7
24;2021-03-01;291;371;22599;11439;5.5;2.8
24;2021-03-02;542;420;23141;11859;5.7;2.9
24;2021-03-03;681;343;23822;12202;5.8;3.0
24;2021-03-04;914;506;24736;12708;6.1;3.1
24;2021-03-05;1067;570;25803;13278;6.3;3.3
24;2021-03-06;1125;145;26928;13423;6.6;3.3
24;2021-03-07;232;63;27160;13486;6.7;3.3
24;2021-03-08;529;256;27689;13742;6.8;3.4
24;2021-03-09;1175;443;28864;14185;7.1;3.5
24;2021-03-10;1142;452;30006;14637;7.3;3.6
24;2021-03-11;1610;470;31616;15107;7.7;3.7
24;2021-03-12;2059;443;33675;15550;8.2;3.8
24;2021-03-13;1348;204;35023;15754;8.6;3.9
24;2021-03-14;141;93;35164;15847;8.6;3.9
24;2021-03-15;953;172;36117;16019;8.8;3.9
24;2021-03-16;1145;234;37262;16253;9.1;4.0
24;2021-03-17;1217;292;38479;16545;9.4;4.1
24;2021-03-18;1055;561;39534;17106;9.7;4.2
24;2021-03-19;1252;543;40786;17649;10.0;4.3
24;2021-03-20;1054;150;41840;17799;10.2;4.4
24;2021-03-21;25;11;41865;17810;10.3;4.4
24;2021-03-22;1224;424;43089;18234;10.6;4.5
24;2021-03-23;1878;400;44967;18634;11.0;4.6
24;2021-03-24;1892;390;46859;19024;11.5;4.7
24;2021-03-25;1992;476;48851;19500;12.0;4.8
24;2021-03-26;2375;285;51226;19785;12.5;4.8
24;2021-03-27;1349;43;52575;19828;12.9;4.9
24;2021-03-28;63;9;52638;19837;12.9;4.9
24;2021-03-29;1672;329;54310;20166;13.3;4.9
24;2021-03-30;2409;403;56719;20569;13.9;5.0
24;2021-03-31;2187;317;58906;20886;14.4;5.1
24;2021-04-01;2195;315;61101;21201;15.0;5.2
24;2021-04-02;2072;396;63173;21597;15.5;5.3
24;2021-04-03;1376;123;64549;21720;15.8;5.3
24;2021-04-04;74;1;64623;21721;15.8;5.3
24;2021-04-05;948;61;65571;21782;16.1;5.3
24;2021-04-06;2356;704;67927;22486;16.6;5.5
24;2021-04-07;2716;696;70643;23182;17.3;5.7
24;2021-04-08;3001;965;73644;24147;18.0;5.9
24;2021-04-09;3486;1012;77130;25159;18.9;6.2
24;2021-04-10;2596;315;79726;25474;19.5;6.2
24;2021-04-11;1103;22;80829;25496;19.8;6.2
24;2021-04-12;2497;817;83326;26313;20.4;6.4
24;2021-04-13;2902;1208;86228;27521;21.1;6.7
24;2021-04-14;2939;1200;89167;28721;21.8;7.0
24;2021-04-15;2790;1104;91957;29825;22.5;7.3
24;2021-04-16;3264;977;95221;30802;23.3;7.5
24;2021-04-17;2272;503;97493;31305;23.9;7.7
24;2021-04-18;424;6;97917;31311;24.0;7.7
24;2021-04-19;1598;1013;99515;32324;24.4;7.9
24;2021-04-20;2268;1437;101783;33761;24.9;8.3
24;2021-04-21;2146;1445;103929;35206;25.4;8.6
24;2021-04-22;2061;1262;105990;36468;26.0;8.9
24;2021-04-23;1960;1341;107950;37809;26.4;9.3
24;2021-04-24;863;724;108813;38533;26.6;9.4
24;2021-04-25;54;4;108867;38537;26.7;9.4
24;2021-04-26;1295;1480;110162;40017;27.0;9.8
24;2021-04-27;1848;1881;112010;41898;27.4;10.3
24;2021-04-28;1507;1957;113517;43855;27.8;10.7
24;2021-04-29;1732;1894;115249;45749;28.2;11.2
24;2021-04-30;2271;1780;117520;47529;28.8;11.6
24;2021-05-01;2059;1072;119579;48601;29.3;11.9
24;2021-05-02;1924;217;121503;48818;29.8;12.0
24;2021-05-03;1475;1837;122978;50655;30.1;12.4
24;2021-05-04;2227;2306;125205;52961;30.7;13.0
24;2021-05-05;1891;2722;127096;55683;31.1;13.6
24;2021-05-06;1890;2800;128986;58483;31.6;14.3
24;2021-05-07;2263;2795;131249;61278;32.1;15.0
24;2021-05-08;1285;1154;132534;62432;32.5;15.3
24;2021-05-09;1169;903;133703;63335;32.7;15.5
24;2021-05-10;1097;2627;134800;65962;33.0;16.2
24;2021-05-11;2037;2798;136837;68760;33.5;16.8
24;2021-05-12;1924;2258;138761;71018;34.0;17.4
24;2021-05-13;1465;1217;140226;72235;34.3;17.7
24;2021-05-14;2378;1333;142604;73568;34.9;18.0
24;2021-05-15;2048;816;144652;74384;35.4;18.2
24;2021-05-16;1172;347;145824;74731;35.7;18.3
24;2021-05-17;2240;1255;148064;75986;36.3;18.6
24;2021-05-18;2485;1820;150549;77806;36.9;19.1
24;2021-05-19;2283;1377;152832;79183;37.4;19.4
24;2021-05-20;2376;1577;155208;80760;38.0;19.8
24;2021-05-21;2434;1415;157642;82175;38.6;20.1
24;2021-05-22;1719;409;159361;82584;39.0;20.2
24;2021-05-23;950;72;160311;82656;39.3;20.2
24;2021-05-24;1518;333;161829;82989;39.6;20.3
24;2021-05-25;2298;1387;164127;84376;40.2;20.7
24;2021-05-26;2148;1320;166275;85696;40.7;21.0
24;2021-05-27;1750;2193;168025;87889;41.1;21.5
24;2021-05-28;2144;2004;170169;89893;41.7;22.0
24;2021-05-29;1153;2084;171322;91977;42.0;22.5
24;2021-05-30;1418;171;172740;92148;42.3;22.6
24;2021-05-31;1740;1365;174480;93513;42.7;22.9
24;2021-06-01;2582;1978;177062;95491;43.4;23.4
24;2021-06-02;2654;1785;179716;97276;44.0;23.8
24;2021-06-03;2289;1464;182005;98740;44.6;24.2
24;2021-06-04;2378;1899;184383;100639;45.1;24.6
24;2021-06-05;2007;1415;186390;102054;45.6;25.0
24;2021-06-06;767;222;187157;102276;45.8;25.0
24;2021-06-07;1432;1497;188589;103773;46.2;25.4
24;2021-06-08;1677;1905;190266;105678;46.6;25.9
24;2021-06-09;1322;1596;191588;107274;46.9;26.3
24;2021-06-10;1579;1914;193167;109188;47.3;26.7
24;2021-06-11;1334;2080;194501;111268;47.6;27.2
24;2021-06-12;1117;2543;195618;113811;47.9;27.9
24;2021-06-13;1238;919;196856;114730;48.2;28.1
24;2021-06-14;1166;1857;198022;116587;48.5;28.5
24;2021-06-15;1488;2993;199510;119580;48.9;29.3
24;2021-06-16;1670;2733;201180;122313;49.3;29.9
24;2021-06-17;1545;2180;202725;124493;49.6;30.5
24;2021-06-18;1400;2861;204125;127354;50.0;31.2
24;2021-06-19;1273;1522;205398;128876;50.3;31.6
24;2021-06-20;514;501;205912;129377;50.4;31.7
24;2021-06-21;932;1833;206844;131210;50.6;32.1
24;2021-06-22;1451;2591;208295;133801;51.0;32.8
24;2021-06-23;1425;2419;209720;136220;51.4;33.4
24;2021-06-24;1137;1917;210857;138137;51.6;33.8
24;2021-06-25;968;2818;211825;140955;51.9;34.5
24;2021-06-26;866;2104;212691;143059;52.1;35.0
24;2021-06-27;402;979;213093;144038;52.2;35.3
24;2021-06-28;818;2482;213911;146520;52.4;35.9
24;2021-06-29;938;2867;214849;149387;52.6;36.6
24;2021-06-30;1111;2456;215960;151843;52.9;37.2
24;2021-07-01;1131;2303;217091;154146;53.2;37.7
24;2021-07-02;1097;2746;218188;156892;53.4;38.4
24;2021-07-03;811;1905;218999;158797;53.6;38.9
24;2021-07-04;411;1013;219410;159810;53.7;39.1
24;2021-07-05;793;2316;220203;162126;53.9;39.7
24;2021-07-06;879;3354;221082;165480;54.1;40.5
24;2021-07-07;1087;3041;222169;168521;54.4;41.3
24;2021-07-08;1340;2121;223509;170642;54.7;41.8
24;2021-07-09;1177;3216;224686;173858;55.0;42.6
24;2021-07-10;481;1964;225167;175822;55.1;43.1
24;2021-07-11;587;1190;225754;177012;55.3;43.3
24;2021-07-12;908;2516;226662;179528;55.5;44.0
24;2021-07-13;1323;3219;227985;182747;55.8;44.7
24;2021-07-14;619;1189;228604;183936;56.0;45.0
24;2021-07-15;1697;2777;230301;186713;56.4;45.7
24;2021-07-16;2150;2598;232451;189311;56.9;46.4
24;2021-07-17;1528;2239;233979;191550;57.3;46.9
24;2021-07-18;709;887;234688;192437;57.5;47.1
24;2021-07-19;1580;2187;236268;194624;57.9;47.7
24;2021-07-20;2018;2440;238286;197064;58.3;48.3
24;2021-07-21;1875;2330;240161;199394;58.8;48.8
24;2021-07-22;2351;2443;242512;201837;59.4;49.4
24;2021-07-23;2303;2623;244815;204460;59.9;50.1
24;2021-07-24;1807;1545;246622;206005;60.4;50.4
24;2021-07-25;816;875;247438;206880;60.6;50.7
24;2021-07-26;1572;2015;249010;208895;61.0;51.2
24;2021-07-27;2848;2289;251858;211184;61.7;51.7
24;2021-07-28;2766;1940;254624;213124;62.3;52.2
24;2021-07-29;3063;2259;257687;215383;63.1;52.7
24;2021-07-30;2466;1921;260153;217304;63.7;53.2
24;2021-07-31;1654;1570;261807;218874;64.1;53.6
24;2021-08-01;1117;658;262924;219532;64.4;53.8
24;2021-08-02;1946;1623;264870;221155;64.9;54.2
24;2021-08-03;2888;1908;267758;223063;65.6;54.6
24;2021-08-04;3078;1631;270836;224694;66.3;55.0
24;2021-08-05;3049;1441;273885;226135;67.1;55.4
24;2021-08-06;2538;1540;276423;227675;67.7;55.7
24;2021-08-07;1792;1120;278215;228795;68.1;56.0
24;2021-08-08;1108;687;279323;229482;68.4;56.2
24;2021-08-09;1740;1383;281063;230865;68.8;56.5
24;2021-08-10;2266;1786;283329;232651;69.4;57.0
24;2021-08-11;2279;1698;285608;234349;69.9;57.4
24;2021-08-12;1917;1957;287525;236306;70.4;57.9
24;2021-08-13;1530;1625;289055;237931;70.8;58.3
24;2021-08-14;1171;1242;290226;239173;71.1;58.6
24;2021-08-15;741;583;290967;239756;71.2;58.7
24;2021-08-16;1123;1706;292090;241462;71.5;59.1
24;2021-08-17;1634;2109;293724;243571;71.9;59.6
24;2021-08-18;1562;1925;295286;245496;72.3;60.1
24;2021-08-19;1127;2635;296413;248131;72.6;60.8
24;2021-08-20;1107;2429;297520;250560;72.9;61.4
24;2021-08-21;875;1635;298395;252195;73.1;61.8
24;2021-08-22;350;1101;298745;253296;73.2;62.0
24;2021-08-23;673;2036;299418;255332;73.3;62.5
24;2021-08-24;818;2395;300236;257727;73.5;63.1
24;2021-08-25;814;2323;301050;260050;73.7;63.7
24;2021-08-26;747;2840;301797;262890;73.9;64.4
24;2021-08-27;801;2765;302598;265655;74.1;65.0
24;2021-08-28;522;1909;303120;267564;74.2;65.5
24;2021-08-29;171;1029;303291;268593;74.3;65.8
24;2021-08-30;376;1951;303667;270544;74.4;66.2
24;2021-08-31;593;2430;304260;272974;74.5;66.8
24;2021-09-01;627;2378;304887;275352;74.7;67.4
24;2021-09-02;465;1779;305352;277131;74.8;67.9
24;2021-09-03;550;2046;305902;279177;74.9;68.4
24;2021-09-04;365;1938;306267;281115;75.0;68.8
24;2021-09-05;245;931;306512;282046;75.1;69.1
24;2021-09-06;345;1465;306857;283511;75.1;69.4
24;2021-09-07;478;1647;307335;285158;75.3;69.8
24;2021-09-08;401;1760;307736;286918;75.4;70.3
24;2021-09-09;335;1102;308071;288020;75.4;70.5
24;2021-09-10;388;1583;308459;289603;75.5;70.9
24;2021-09-11;317;1609;308776;291212;75.6;71.3
24;2021-09-12;92;374;308868;291586;75.6;71.4
24;2021-09-13;294;1014;309162;292600;75.7;71.6
24;2021-09-14;432;911;309594;293511;75.8;71.9
24;2021-09-15;413;1267;310007;294778;75.9;72.2
24;2021-09-16;250;890;310257;295668;76.0;72.4
24;2021-09-17;410;1037;310667;296705;76.1;72.7
24;2021-09-18;312;1111;310979;297816;76.1;72.9
24;2021-09-19;45;347;311024;298163;76.2;73.0
24;2021-09-20;154;577;311178;298740;76.2;73.2
24;2021-09-21;383;411;311561;299151;76.3;73.3
24;2021-09-22;226;697;311787;299848;76.3;73.4
24;2021-09-23;135;389;311922;300237;76.4;73.5
24;2021-09-24;249;812;312171;301049;76.4;73.7
24;2021-09-25;215;592;312386;301641;76.5;73.9
24;2021-09-26;32;107;312418;301748;76.5;73.9
24;2021-09-27;180;494;312598;302242;76.5;74.0
24;2021-09-28;209;328;312807;302570;76.6;74.1
24;2021-09-29;227;588;313034;303158;76.7;74.2
24;2021-09-30;253;439;313287;303597;76.7;74.3
24;2021-10-01;229;487;313516;304084;76.8;74.5
24;2021-10-02;195;483;313711;304567;76.8;74.6
24;2021-10-03;17;39;313728;304606;76.8;74.6
24;2021-10-04;112;288;313840;304894;76.8;74.7
24;2021-10-05;102;341;313942;305235;76.9;74.7
24;2021-10-06;200;439;314142;305674;76.9;74.8
24;2021-10-07;105;175;314247;305849;76.9;74.9
24;2021-10-08;186;440;314433;306289;77.0;75.0
24;2021-10-09;169;470;314602;306759;77.0;75.1
24;2021-10-10;14;31;314616;306790;77.0;75.1
24;2021-10-11;86;189;314702;306979;77.1;75.2
24;2021-10-12;129;392;314831;307371;77.1;75.3
24;2021-10-13;125;302;314956;307673;77.1;75.3
24;2021-10-14;121;211;315077;307884;77.2;75.4
25;2020-12-27;0;0;0;0;0.0;0.0
25;2020-12-28;1;0;1;0;0.0;0.0
25;2020-12-29;0;0;1;0;0.0;0.0
25;2020-12-30;0;0;1;0;0.0;0.0
25;2020-12-31;3;1;4;1;0.0;0.0
25;2021-01-01;0;0;4;1;0.0;0.0
25;2021-01-02;1;0;5;1;0.0;0.0
25;2021-01-03;0;0;5;1;0.0;0.0
25;2021-01-04;1;0;6;1;0.0;0.0
25;2021-01-05;1;0;7;1;0.0;0.0
25;2021-01-06;75;1;82;2;0.0;0.0
25;2021-01-07;235;1;317;3;0.1;0.0
25;2021-01-08;345;1;662;4;0.1;0.0
25;2021-01-09;102;0;764;4;0.1;0.0
25;2021-01-10;0;0;764;4;0.1;0.0
25;2021-01-11;503;6;1267;10;0.2;0.0
25;2021-01-12;682;2;1949;12;0.4;0.0
25;2021-01-13;627;11;2576;23;0.5;0.0
25;2021-01-14;896;19;3472;42;0.6;0.0
25;2021-01-15;787;9;4259;51;0.8;0.0
25;2021-01-16;206;1;4465;52;0.8;0.0
25;2021-01-17;112;0;4577;52;0.8;0.0
25;2021-01-18;1299;6;5876;58;1.1;0.0
25;2021-01-19;1416;5;7292;63;1.4;0.0
25;2021-01-20;1421;6;8713;69;1.6;0.0
25;2021-01-21;1843;4;10556;73;2.0;0.0
25;2021-01-22;1509;8;12065;81;2.2;0.0
25;2021-01-23;499;1;12564;82;2.3;0.0
25;2021-01-24;119;0;12683;82;2.4;0.0
25;2021-01-25;990;0;13673;82;2.5;0.0
25;2021-01-26;1490;42;15163;124;2.8;0.0
25;2021-01-27;1247;70;16410;194;3.0;0.0
25;2021-01-28;1090;75;17500;269;3.2;0.0
25;2021-01-29;906;234;18406;503;3.4;0.1
25;2021-01-30;293;91;18699;594;3.5;0.1
25;2021-01-31;2;0;18701;594;3.5;0.1
25;2021-02-01;613;222;19314;816;3.6;0.2
25;2021-02-02;674;415;19988;1231;3.7;0.2
25;2021-02-03;758;248;20746;1479;3.8;0.3
25;2021-02-04;716;444;21462;1923;4.0;0.4
25;2021-02-05;521;468;21983;2391;4.1;0.4
25;2021-02-06;197;156;22180;2547;4.1;0.5
25;2021-02-07;2;34;22182;2581;4.1;0.5
25;2021-02-08;612;508;22794;3089;4.2;0.6
25;2021-02-09;615;490;23409;3579;4.3;0.7
25;2021-02-10;818;503;24227;4082;4.5;0.8
25;2021-02-11;589;849;24816;4931;4.6;0.9
25;2021-02-12;413;550;25229;5481;4.7;1.0
25;2021-02-13;98;141;25327;5622;4.7;1.0
25;2021-02-14;0;0;25327;5622;4.7;1.0
25;2021-02-15;186;1032;25513;6654;4.7;1.2
25;2021-02-16;212;1454;25725;8108;4.8;1.5
25;2021-02-17;107;1337;25832;9445;4.8;1.8
25;2021-02-18;147;1428;25979;10873;4.8;2.0
25;2021-02-19;102;1269;26081;12142;4.8;2.3
25;2021-02-20;27;491;26108;12633;4.8;2.3
25;2021-02-21;1;143;26109;12776;4.8;2.4
25;2021-02-22;83;1061;26192;13837;4.9;2.6
25;2021-02-23;195;1076;26387;14913;4.9;2.8
25;2021-02-24;105;975;26492;15888;4.9;2.9
25;2021-02-25;522;1003;27014;16891;5.0;3.1
25;2021-02-26;607;981;27621;17872;5.1;3.3
25;2021-02-27;228;374;27849;18246;5.2;3.4
25;2021-02-28;6;1;27855;18247;5.2;3.4
25;2021-03-01;443;623;28298;18870;5.2;3.5
25;2021-03-02;653;834;28951;19704;5.4;3.7
25;2021-03-03;544;736;29495;20440;5.5;3.8
25;2021-03-04;1159;663;30654;21103;5.7;3.9
25;2021-03-05;1853;398;32507;21501;6.0;4.0
25;2021-03-06;1171;227;33678;21728;6.2;4.0
25;2021-03-07;9;9;33687;21737;6.2;4.0
25;2021-03-08;548;709;34235;22446;6.3;4.2
25;2021-03-09;1040;783;35275;23229;6.5;4.3
25;2021-03-10;1151;656;36426;23885;6.8;4.4
25;2021-03-11;1659;590;38085;24475;7.1;4.5
25;2021-03-12;1998;466;40083;24941;7.4;4.6
25;2021-03-13;1121;101;41204;25042;7.6;4.6
25;2021-03-14;35;0;41239;25042;7.6;4.6
25;2021-03-15;1125;148;42364;25190;7.9;4.7
25;2021-03-16;1288;127;43652;25317;8.1;4.7
25;2021-03-17;1413;144;45065;25461;8.4;4.7
25;2021-03-18;1526;86;46591;25547;8.6;4.7
25;2021-03-19;1595;132;48186;25679;8.9;4.8
25;2021-03-20;822;43;49008;25722;9.1;4.8
25;2021-03-21;24;0;49032;25722;9.1;4.8
25;2021-03-22;1486;88;50518;25810;9.4;4.8
25;2021-03-23;2161;164;52679;25974;9.8;4.8
25;2021-03-24;2418;100;55097;26074;10.2;4.8
25;2021-03-25;2837;201;57934;26275;10.7;4.9
25;2021-03-26;3160;183;61094;26458;11.3;4.9
25;2021-03-27;1112;91;62206;26549;11.5;4.9
25;2021-03-28;121;65;62327;26614;11.6;4.9
25;2021-03-29;1790;286;64117;26900;11.9;5.0
25;2021-03-30;2213;403;66330;27303;12.3;5.1
25;2021-03-31;2220;368;68550;27671;12.7;5.1
25;2021-04-01;2451;530;71001;28201;13.2;5.2
25;2021-04-02;2026;613;73027;28814;13.5;5.3
25;2021-04-03;447;110;73474;28924;13.6;5.4
25;2021-04-04;39;21;73513;28945;13.6;5.4
25;2021-04-05;145;4;73658;28949;13.7;5.4
25;2021-04-06;1937;691;75595;29640;14.0;5.5
25;2021-04-07;1878;857;77473;30497;14.4;5.7
25;2021-04-08;2435;832;79908;31329;14.8;5.8
25;2021-04-09;2597;998;82505;32327;15.3;6.0
25;2021-04-10;978;292;83483;32619;15.5;6.0
25;2021-04-11;105;28;83588;32647;15.5;6.1
25;2021-04-12;1556;968;85144;33615;15.8;6.2
25;2021-04-13;1988;1326;87132;34941;16.2;6.5
25;2021-04-14;1750;1222;88882;36163;16.5;6.7
25;2021-04-15;1997;1329;90879;37492;16.8;7.0
25;2021-04-16;2085;1009;92964;38501;17.2;7.1
25;2021-04-17;1104;417;94068;38918;17.4;7.2
25;2021-04-18;118;18;94186;38936;17.5;7.2
25;2021-04-19;1327;1246;95513;40182;17.7;7.4
25;2021-04-20;1615;1466;97128;41648;18.0;7.7
25;2021-04-21;1717;1636;98845;43284;18.3;8.0
25;2021-04-22;1855;1713;100700;44997;18.7;8.3
25;2021-04-23;1904;1771;102604;46768;19.0;8.7
25;2021-04-24;1278;705;103882;47473;19.3;8.8
25;2021-04-25;140;114;104022;47587;19.3;8.8
25;2021-04-26;1722;1686;105744;49273;19.6;9.1
25;2021-04-27;2804;1524;108548;50797;20.1;9.4
25;2021-04-28;2425;1563;110973;52360;20.6;9.7
25;2021-04-29;2648;1837;113621;54197;21.1;10.0
25;2021-04-30;3109;1581;116730;55778;21.6;10.3
25;2021-05-01;1789;333;118519;56111;22.0;10.4
25;2021-05-02;442;22;118961;56133;22.1;10.4
25;2021-05-03;2900;847;121861;56980;22.6;10.6
25;2021-05-04;2639;1884;124500;58864;23.1;10.9
25;2021-05-05;2597;1670;127097;60534;23.6;11.2
25;2021-05-06;2927;2170;130024;62704;24.1;11.6
25;2021-05-07;3063;2129;133087;64833;24.7;12.0
25;2021-05-08;1334;230;134421;65063;24.9;12.1
25;2021-05-09;244;87;134665;65150;25.0;12.1
25;2021-05-10;3129;1639;137794;66789;25.5;12.4
25;2021-05-11;3747;2042;141541;68831;26.2;12.8
25;2021-05-12;3688;1791;145229;70622;26.9;13.1
25;2021-05-13;3523;599;148752;71221;27.6;13.2
25;2021-05-14;4482;1307;153234;72528;28.4;13.4
25;2021-05-15;3282;710;156516;73238;29.0;13.6
25;2021-05-16;723;93;157239;73331;29.1;13.6
25;2021-05-17;4089;1099;161328;74430;29.9;13.8
25;2021-05-18;5205;1194;166533;75624;30.9;14.0
25;2021-05-19;5247;1135;171780;76759;31.8;14.2
25;2021-05-20;5134;1455;176914;78214;32.8;14.5
25;2021-05-21;5764;1982;182678;80196;33.9;14.9
25;2021-05-22;3174;723;185852;80919;34.5;15.0
25;2021-05-23;781;157;186633;81076;34.6;15.0
25;2021-05-24;1529;152;188162;81228;34.9;15.1
25;2021-05-25;3513;1651;191675;82879;35.5;15.4
25;2021-05-26;3974;1561;195649;84440;36.3;15.7
25;2021-05-27;4519;1897;200168;86337;37.1;16.0
25;2021-05-28;3994;2653;204162;88990;37.8;16.5
25;2021-05-29;2016;1021;206178;90011;38.2;16.7
25;2021-05-30;174;96;206352;90107;38.3;16.7
25;2021-05-31;2672;1708;209024;91815;38.7;17.0
25;2021-06-01;2729;2156;211753;93971;39.3;17.4
25;2021-06-02;2608;2251;214361;96222;39.7;17.8
25;2021-06-03;3274;2046;217635;98268;40.3;18.2
25;2021-06-04;3209;2411;220844;100679;40.9;18.7
25;2021-06-05;1491;1403;222335;102082;41.2;18.9
25;2021-06-06;987;259;223322;102341;41.4;19.0
25;2021-06-07;2782;2575;226104;104916;41.9;19.4
25;2021-06-08;2602;2761;228706;107677;42.4;20.0
25;2021-06-09;2382;2763;231088;110440;42.8;20.5
25;2021-06-10;2325;2654;233413;113094;43.3;21.0
25;2021-06-11;2709;3305;236122;116399;43.8;21.6
25;2021-06-12;1571;1861;237693;118260;44.1;21.9
25;2021-06-13;497;259;238190;118519;44.2;22.0
25;2021-06-14;1421;3753;239611;122272;44.4;22.7
25;2021-06-15;1641;3568;241252;125840;44.7;23.3
25;2021-06-16;1954;3273;243206;129113;45.1;23.9
25;2021-06-17;1474;3323;244680;132436;45.4;24.6
25;2021-06-18;2286;4297;246966;136733;45.8;25.3
25;2021-06-19;1350;1979;248316;138712;46.0;25.7
25;2021-06-20;59;239;248375;138951;46.0;25.8
25;2021-06-21;1139;4139;249514;143090;46.3;26.5
25;2021-06-22;1151;4673;250665;147763;46.5;27.4
25;2021-06-23;1404;4072;252069;151835;46.7;28.1
25;2021-06-24;1191;4085;253260;155920;46.9;28.9
25;2021-06-25;1640;5603;254900;161523;47.3;29.9
25;2021-06-26;626;3384;255526;164907;47.4;30.6
25;2021-06-27;451;877;255977;165784;47.5;30.7
25;2021-06-28;907;4476;256884;170260;47.6;31.6
25;2021-06-29;1130;5469;258014;175729;47.8;32.6
25;2021-06-30;1311;5371;259325;181100;48.1;33.6
25;2021-07-01;1706;5230;261031;186330;48.4;34.5
25;2021-07-02;1748;5061;262779;191391;48.7;35.5
25;2021-07-03;1042;2692;263821;194083;48.9;36.0
25;2021-07-04;409;722;264230;194805;49.0;36.1
25;2021-07-05;1299;2579;265529;197384;49.2;36.6
25;2021-07-06;1568;4748;267097;202132;49.5;37.5
25;2021-07-07;1597;4501;268694;206633;49.8;38.3
25;2021-07-08;1554;3932;270248;210565;50.1;39.0
25;2021-07-09;1796;4591;272044;215156;50.4;39.9
25;2021-07-10;781;2371;272825;217527;50.6;40.3
25;2021-07-11;127;307;272952;217834;50.6;40.4
25;2021-07-12;1404;3859;274356;221693;50.9;41.1
25;2021-07-13;2470;4770;276826;226463;51.3;42.0
25;2021-07-14;379;561;277205;227024;51.4;42.1
25;2021-07-15;2403;3658;279608;230682;51.8;42.8
25;2021-07-16;3485;3834;283093;234516;52.5;43.5
25;2021-07-17;2207;2040;285300;236556;52.9;43.9
25;2021-07-18;808;1300;286108;237856;53.0;44.1
25;2021-07-19;2544;4210;288652;242066;53.5;44.9
25;2021-07-20;3384;3714;292036;245780;54.1;45.6
25;2021-07-21;3300;3369;295336;249149;54.7;46.2
25;2021-07-22;3351;2986;298687;252135;55.4;46.7
25;2021-07-23;3566;3357;302253;255492;56.0;47.4
25;2021-07-24;1412;2269;303665;257761;56.3;47.8
25;2021-07-25;679;710;304344;258471;56.4;47.9
25;2021-07-26;3056;3012;307400;261483;57.0;48.5
25;2021-07-27;3835;2127;311235;263610;57.7;48.9
25;2021-07-28;3692;2120;314927;265730;58.4;49.3
25;2021-07-29;4321;2093;319248;267823;59.2;49.6
25;2021-07-30;4292;2492;323540;270315;60.0;50.1
25;2021-07-31;1821;1469;325361;271784;60.3;50.4
25;2021-08-01;1352;201;326713;271985;60.6;50.4
25;2021-08-02;2743;2214;329456;274199;61.1;50.8
25;2021-08-03;2840;2203;332296;276402;61.6;51.2
25;2021-08-04;2941;1429;335237;277831;62.1;51.5
25;2021-08-05;2207;1732;337444;279563;62.6;51.8
25;2021-08-06;2289;2349;339733;281912;63.0;52.3
25;2021-08-07;1294;1206;341027;283118;63.2;52.5
25;2021-08-08;325;477;341352;283595;63.3;52.6
25;2021-08-09;2025;2231;343377;285826;63.7;53.0
25;2021-08-10;1975;2524;345352;288350;64.0;53.5
25;2021-08-11;1831;2033;347183;290383;64.4;53.8
25;2021-08-12;2149;2503;349332;292886;64.8;54.3
25;2021-08-13;1712;2023;351044;294909;65.1;54.7
25;2021-08-14;970;1791;352014;296700;65.3;55.0
25;2021-08-15;9;45;352023;296745;65.3;55.0
25;2021-08-16;1262;3261;353285;300006;65.5;55.6
25;2021-08-17;1458;3284;354743;303290;65.8;56.2
25;2021-08-18;1236;2804;355979;306094;66.0;56.7
25;2021-08-19;988;2868;356967;308962;66.2;57.3
25;2021-08-20;1435;3693;358402;312655;66.4;58.0
25;2021-08-21;568;1782;358970;314437;66.5;58.3
25;2021-08-22;212;1273;359182;315710;66.6;58.5
25;2021-08-23;1116;3336;360298;319046;66.8;59.1
25;2021-08-24;1071;3234;361369;322280;67.0;59.7
25;2021-08-25;1018;3062;362387;325342;67.2;60.3
25;2021-08-26;1145;3007;363532;328349;67.4;60.9
25;2021-08-27;1206;3064;364738;331413;67.6;61.4
25;2021-08-28;588;1791;365326;333204;67.7;61.8
25;2021-08-29;162;513;365488;333717;67.8;61.9
25;2021-08-30;942;2787;366430;336504;67.9;62.4
25;2021-08-31;974;2304;367404;338808;68.1;62.8
25;2021-09-01;844;2221;368248;341029;68.3;63.2
25;2021-09-02;798;1667;369046;342696;68.4;63.5
25;2021-09-03;803;1887;369849;344583;68.6;63.9
25;2021-09-04;691;1358;370540;345941;68.7;64.1
25;2021-09-05;128;183;370668;346124;68.7;64.2
25;2021-09-06;632;1344;371300;347468;68.8;64.4
25;2021-09-07;490;1107;371790;348575;68.9;64.6
25;2021-09-08;623;1607;372413;350182;69.0;64.9
25;2021-09-09;426;989;372839;351171;69.1;65.1
25;2021-09-10;849;1626;373688;352797;69.3;65.4
25;2021-09-11;375;1034;374063;353831;69.3;65.6
25;2021-09-12;111;203;374174;354034;69.4;65.6
25;2021-09-13;728;962;374902;354996;69.5;65.8
25;2021-09-14;627;855;375529;355851;69.6;66.0
25;2021-09-15;761;1480;376290;357331;69.8;66.2
25;2021-09-16;503;829;376793;358160;69.8;66.4
25;2021-09-17;747;1339;377540;359499;70.0;66.6
25;2021-09-18;321;871;377861;360370;70.0;66.8
25;2021-09-19;78;166;377939;360536;70.1;66.8
25;2021-09-20;454;741;378393;361277;70.1;67.0
25;2021-09-21;205;592;378598;361869;70.2;67.1
25;2021-09-22;451;1193;379049;363062;70.3;67.3
25;2021-09-23;254;457;379303;363519;70.3;67.4
25;2021-09-24;491;1053;379794;364572;70.4;67.6
25;2021-09-25;282;896;380076;365468;70.5;67.7
25;2021-09-26;8;5;380084;365473;70.5;67.7
25;2021-09-27;293;586;380377;366059;70.5;67.9
25;2021-09-28;209;442;380586;366501;70.6;67.9
25;2021-09-29;459;822;381045;367323;70.6;68.1
25;2021-09-30;224;363;381269;367686;70.7;68.2
25;2021-10-01;425;888;381694;368574;70.8;68.3
25;2021-10-02;276;578;381970;369152;70.8;68.4
25;2021-10-03;9;6;381979;369158;70.8;68.4
25;2021-10-04;322;730;382301;369888;70.9;68.6
25;2021-10-05;114;365;382415;370253;70.9;68.6
25;2021-10-06;412;764;382827;371017;71.0;68.8
25;2021-10-07;127;278;382954;371295;71.0;68.8
25;2021-10-08;483;896;383437;372191;71.1;69.0
25;2021-10-09;293;511;383730;372702;71.1;69.1
25;2021-10-10;6;28;383736;372730;71.1;69.1
25;2021-10-11;265;597;384001;373327;71.2;69.2
25;2021-10-12;129;199;384130;373526;71.2;69.2
25;2021-10-13;495;772;384625;374298;71.3;69.4
25;2021-10-14;110;183;384735;374481;71.3;69.4
26;2020-12-27;0;0;0;0;0.0;0.0
26;2020-12-28;0;0;0;0;0.0;0.0
26;2020-12-29;0;0;0;0;0.0;0.0
26;2020-12-30;0;0;0;0;0.0;0.0
26;2020-12-31;0;0;0;0;0.0;0.0
26;2021-01-01;1;0;1;0;0.0;0.0
26;2021-01-02;0;0;1;0;0.0;0.0
26;2021-01-03;0;0;1;0;0.0;0.0
26;2021-01-04;0;0;1;0;0.0;0.0
26;2021-01-05;0;0;1;0;0.0;0.0
26;2021-01-06;0;0;1;0;0.0;0.0
26;2021-01-07;168;0;169;0;0.0;0.0
26;2021-01-08;126;0;295;0;0.1;0.0
26;2021-01-09;2;0;297;0;0.1;0.0
26;2021-01-10;0;0;297;0;0.1;0.0
26;2021-01-11;267;2;564;2;0.1;0.0
26;2021-01-12;177;1;741;3;0.1;0.0
26;2021-01-13;418;1;1159;4;0.2;0.0
26;2021-01-14;501;2;1660;6;0.3;0.0
26;2021-01-15;563;2;2223;8;0.4;0.0
26;2021-01-16;250;1;2473;9;0.5;0.0
26;2021-01-17;0;0;2473;9;0.5;0.0
26;2021-01-18;637;1;3110;10;0.6;0.0
26;2021-01-19;785;3;3895;13;0.7;0.0
26;2021-01-20;742;0;4637;13;0.9;0.0
26;2021-01-21;807;5;5444;18;1.0;0.0
26;2021-01-22;787;5;6231;23;1.2;0.0
26;2021-01-23;563;3;6794;26;1.3;0.0
26;2021-01-24;24;0;6818;26;1.3;0.0
26;2021-01-25;696;2;7514;28;1.4;0.0
26;2021-01-26;800;4;8314;32;1.6;0.0
26;2021-01-27;823;9;9137;41;1.8;0.0
26;2021-01-28;1332;169;10469;210;2.0;0.0
26;2021-01-29;971;67;11440;277;2.2;0.1
26;2021-01-30;606;5;12046;282;2.3;0.1
26;2021-01-31;24;0;12070;282;2.3;0.1
26;2021-02-01;708;189;12778;471;2.5;0.1
26;2021-02-02;1276;216;14054;687;2.7;0.1
26;2021-02-03;1265;279;15319;966;2.9;0.2
26;2021-02-04;985;459;16304;1425;3.1;0.3
26;2021-02-05;674;336;16978;1761;3.3;0.3
26;2021-02-06;407;238;17385;1999;3.3;0.4
26;2021-02-07;57;2;17442;2001;3.4;0.4
26;2021-02-08;545;416;17987;2417;3.5;0.5
26;2021-02-09;618;475;18605;2892;3.6;0.6
26;2021-02-10;666;341;19271;3233;3.7;0.6
26;2021-02-11;753;328;20024;3561;3.8;0.7
26;2021-02-12;591;447;20615;4008;4.0;0.8
26;2021-02-13;388;332;21003;4340;4.0;0.8
26;2021-02-14;36;0;21039;4340;4.0;0.8
26;2021-02-15;414;526;21453;4866;4.1;0.9
26;2021-02-16;294;550;21747;5416;4.2;1.0
26;2021-02-17;194;737;21941;6153;4.2;1.2
26;2021-02-18;337;890;22278;7043;4.3;1.4
26;2021-02-19;341;803;22619;7846;4.3;1.5
26;2021-02-20;96;487;22715;8333;4.4;1.6
26;2021-02-21;3;24;22718;8357;4.4;1.6
26;2021-02-22;144;706;22862;9063;4.4;1.7
26;2021-02-23;398;1002;23260;10065;4.5;1.9
26;2021-02-24;346;1225;23606;11290;4.5;2.2
26;2021-02-25;748;1073;24354;12363;4.7;2.4
26;2021-02-26;925;642;25279;13005;4.9;2.5
26;2021-02-27;278;508;25557;13513;4.9;2.6
26;2021-02-28;3;30;25560;13543;4.9;2.6
26;2021-03-01;459;661;26019;14204;5.0;2.7
26;2021-03-02;742;634;26761;14838;5.1;2.9
26;2021-03-03;733;683;27494;15521;5.3;3.0
26;2021-03-04;1045;584;28539;16105;5.5;3.1
26;2021-03-05;1710;533;30249;16638;5.8;3.2
26;2021-03-06;2773;506;33022;17144;6.3;3.3
26;2021-03-07;2989;226;36011;17370;6.9;3.3
26;2021-03-08;908;652;36919;18022;7.1;3.5
26;2021-03-09;1325;558;38244;18580;7.3;3.6
26;2021-03-10;1219;514;39463;19094;7.6;3.7
26;2021-03-11;1612;656;41075;19750;7.9;3.8
26;2021-03-12;2216;489;43291;20239;8.3;3.9
26;2021-03-13;1886;347;45177;20586;8.7;4.0
26;2021-03-14;68;38;45245;20624;8.7;4.0
26;2021-03-15;1653;252;46898;20876;9.0;4.0
26;2021-03-16;1232;520;48130;21396;9.2;4.1
26;2021-03-17;1369;307;49499;21703;9.5;4.2
26;2021-03-18;1587;285;51086;21988;9.8;4.2
26;2021-03-19;2445;354;53531;22342;10.3;4.3
26;2021-03-20;1290;152;54821;22494;10.5;4.3
26;2021-03-21;61;21;54882;22515;10.5;4.3
26;2021-03-22;1847;202;56729;22717;10.9;4.4
26;2021-03-23;2474;283;59203;23000;11.4;4.4
26;2021-03-24;2551;249;61754;23249;11.9;4.5
26;2021-03-25;3044;347;64798;23596;12.4;4.5
26;2021-03-26;3053;364;67851;23960;13.0;4.6
26;2021-03-27;1243;163;69094;24123;13.3;4.6
26;2021-03-28;94;7;69188;24130;13.3;4.6
26;2021-03-29;1908;409;71096;24539;13.7;4.7
26;2021-03-30;2384;553;73480;25092;14.1;4.8
26;2021-03-31;2229;587;75709;25679;14.5;4.9
26;2021-04-01;2279;786;77988;26465;15.0;5.1
26;2021-04-02;2213;996;80201;27461;15.4;5.3
26;2021-04-03;551;1204;80752;28665;15.5;5.5
26;2021-04-04;215;887;80967;29552;15.6;5.7
26;2021-04-05;557;52;81524;29604;15.7;5.7
26;2021-04-06;1486;833;83010;30437;15.9;5.8
26;2021-04-07;1793;900;84803;31337;16.3;6.0
26;2021-04-08;3008;946;87811;32283;16.9;6.2
26;2021-04-09;3415;1013;91226;33296;17.5;6.4
26;2021-04-10;1356;929;92582;34225;17.8;6.6
26;2021-04-11;88;35;92670;34260;17.8;6.6
26;2021-04-12;1713;1128;94383;35388;18.1;6.8
26;2021-04-13;2797;1459;97180;36847;18.7;7.1
26;2021-04-14;2204;1490;99384;38337;19.1;7.4
26;2021-04-15;2282;1602;101666;39939;19.5;7.7
26;2021-04-16;2272;1596;103938;41535;20.0;8.0
26;2021-04-17;1095;841;105033;42376;20.2;8.1
26;2021-04-18;36;52;105069;42428;20.2;8.2
26;2021-04-19;1547;1575;106616;44003;20.5;8.5
26;2021-04-20;1796;1732;108412;45735;20.8;8.8
26;2021-04-21;2012;1517;110424;47252;21.2;9.1
26;2021-04-22;2291;1606;112715;48858;21.7;9.4
26;2021-04-23;2012;1644;114727;50502;22.0;9.7
26;2021-04-24;1655;846;116382;51348;22.4;9.9
26;2021-04-25;629;97;117011;51445;22.5;9.9
26;2021-04-26;1377;1599;118388;53044;22.7;10.2
26;2021-04-27;1986;1687;120374;54731;23.1;10.5
26;2021-04-28;1865;1546;122239;56277;23.5;10.8
26;2021-04-29;2866;1898;125105;58175;24.0;11.2
26;2021-04-30;2626;1769;127731;59944;24.5;11.5
26;2021-05-01;1538;380;129269;60324;24.8;11.6
26;2021-05-02;1084;118;130353;60442;25.0;11.6
26;2021-05-03;2200;1792;132553;62234;25.5;12.0
26;2021-05-04;2614;2365;135167;64599;26.0;12.4
26;2021-05-05;2772;2202;137939;66801;26.5;12.8
26;2021-05-06;3322;2228;141261;69029;27.1;13.3
26;2021-05-07;2860;2262;144121;71291;27.7;13.7
26;2021-05-08;1960;622;146081;71913;28.1;13.8
26;2021-05-09;713;123;146794;72036;28.2;13.8
26;2021-05-10;3021;1831;149815;73867;28.8;14.2
26;2021-05-11;4445;2188;154260;76055;29.6;14.6
26;2021-05-12;4828;1696;159088;77751;30.6;14.9
26;2021-05-13;4363;617;163451;78368;31.4;15.1
26;2021-05-14;4640;1551;168091;79919;32.3;15.4
26;2021-05-15;4467;626;172558;80545;33.1;15.5
26;2021-05-16;3629;345;176187;80890;33.8;15.5
26;2021-05-17;3657;1487;179844;82377;34.5;15.8
26;2021-05-18;4474;1743;184318;84120;35.4;16.2
26;2021-05-19;4486;1451;188804;85571;36.3;16.4
26;2021-05-20;4684;1770;193488;87341;37.2;16.8
26;2021-05-21;4728;1804;198216;89145;38.1;17.1
26;2021-05-22;3189;690;201405;89835;38.7;17.3
26;2021-05-23;1597;183;203002;90018;39.0;17.3
26;2021-05-24;3788;743;206790;90761;39.7;17.4
26;2021-05-25;3590;2348;210380;93109;40.4;17.9
26;2021-05-26;4177;2272;214557;95381;41.2;18.3
26;2021-05-27;4211;2460;218768;97841;42.0;18.8
26;2021-05-28;3776;2768;222544;100609;42.8;19.3
26;2021-05-29;3087;1653;225631;102262;43.3;19.6
26;2021-05-30;320;70;225951;102332;43.4;19.7
26;2021-05-31;3082;1854;229033;104186;44.0;20.0
26;2021-06-01;3110;2309;232143;106495;44.6;20.5
26;2021-06-02;2869;2220;235012;108715;45.1;20.9
26;2021-06-03;2849;2491;237861;111206;45.7;21.4
26;2021-06-04;2667;2917;240528;114123;46.2;21.9
26;2021-06-05;1806;1694;242334;115817;46.6;22.2
26;2021-06-06;9;0;242343;115817;46.6;22.2
26;2021-06-07;2346;2431;244689;118248;47.0;22.7
26;2021-06-08;2453;2293;247142;120541;47.5;23.2
26;2021-06-09;2096;2391;249238;122932;47.9;23.6
26;2021-06-10;1980;2763;251218;125695;48.3;24.1
26;2021-06-11;1887;3272;253105;128967;48.6;24.8
26;2021-06-12;1219;1790;254324;130757;48.9;25.1
26;2021-06-13;97;214;254421;130971;48.9;25.2
26;2021-06-14;1415;3498;255836;134469;49.1;25.8
26;2021-06-15;1586;3964;257422;138433;49.5;26.6
26;2021-06-16;1784;3473;259206;141906;49.8;27.3
26;2021-06-17;1509;3167;260715;145073;50.1;27.9
26;2021-06-18;1797;4368;262512;149441;50.4;28.7
26;2021-06-19;934;3180;263446;152621;50.6;29.3
26;2021-06-20;263;876;263709;153497;50.7;29.5
26;2021-06-21;1005;4558;264714;158055;50.9;30.4
26;2021-06-22;1061;5119;265775;163174;51.1;31.3
26;2021-06-23;1168;5072;266943;168246;51.3;32.3
26;2021-06-24;1258;4544;268201;172790;51.5;33.2
26;2021-06-25;1014;5542;269215;178332;51.7;34.3
26;2021-06-26;662;3822;269877;182154;51.8;35.0
26;2021-06-27;299;1273;270176;183427;51.9;35.2
26;2021-06-28;778;4757;270954;188184;52.1;36.2
26;2021-06-29;1097;4956;272051;193140;52.3;37.1
26;2021-06-30;1411;4891;273462;198031;52.5;38.0
26;2021-07-01;1651;4389;275113;202420;52.8;38.9
26;2021-07-02;1333;5163;276446;207583;53.1;39.9
26;2021-07-03;769;3321;277215;210904;53.3;40.5
26;2021-07-04;331;633;277546;211537;53.3;40.6
26;2021-07-05;887;4673;278433;216210;53.5;41.5
26;2021-07-06;1266;4199;279699;220409;53.7;42.3
26;2021-07-07;1440;3797;281139;224206;54.0;43.1
26;2021-07-08;2387;3330;283526;227536;54.5;43.7
26;2021-07-09;1558;4789;285084;232325;54.8;44.6
26;2021-07-10;910;2913;285994;235238;54.9;45.2
26;2021-07-11;332;347;286326;235585;55.0;45.3
26;2021-07-12;1113;4218;287439;239803;55.2;46.1
26;2021-07-13;2301;4343;289740;244146;55.7;46.9
26;2021-07-14;1060;814;290800;244960;55.9;47.1
26;2021-07-15;3166;3659;293966;248619;56.5;47.8
26;2021-07-16;3000;3688;296966;252307;57.0;48.5
26;2021-07-17;1877;1814;298843;254121;57.4;48.8
26;2021-07-18;20;24;298863;254145;57.4;48.8
26;2021-07-19;2724;3265;301587;257410;57.9;49.4
26;2021-07-20;3706;3370;305293;260780;58.6;50.1
26;2021-07-21;3588;3087;308881;263867;59.3;50.7
26;2021-07-22;4119;2974;313000;266841;60.1;51.3
26;2021-07-23;3860;3403;316860;270244;60.9;51.9
26;2021-07-24;2344;1363;319204;271607;61.3;52.2
26;2021-07-25;608;97;319812;271704;61.4;52.2
26;2021-07-26;3429;2584;323241;274288;62.1;52.7
26;2021-07-27;4840;2621;328081;276909;63.0;53.2
26;2021-07-28;4534;2390;332615;279299;63.9;53.7
26;2021-07-29;3902;2900;336517;282199;64.6;54.2
26;2021-07-30;3484;2675;340001;284874;65.3;54.7
26;2021-07-31;1144;1010;341145;285884;65.5;54.9
26;2021-08-01;420;108;341565;285992;65.6;54.9
26;2021-08-02;2953;2364;344518;288356;66.2;55.4
26;2021-08-03;3299;2297;347817;290653;66.8;55.8
26;2021-08-04;3999;2016;351816;292669;67.6;56.2
26;2021-08-05;3154;2207;354970;294876;68.2;56.6
26;2021-08-06;3174;2639;358144;297515;68.8;57.2
26;2021-08-07;640;845;358784;298360;68.9;57.3
26;2021-08-08;29;13;358813;298373;68.9;57.3
26;2021-08-09;2191;3061;361004;301434;69.3;57.9
26;2021-08-10;2341;3049;363345;304483;69.8;58.5
26;2021-08-11;2078;2719;365423;307202;70.2;59.0
26;2021-08-12;1775;2587;367198;309789;70.5;59.5
26;2021-08-13;1742;2424;368940;312213;70.9;60.0
26;2021-08-14;272;872;369212;313085;70.9;60.1
26;2021-08-15;6;8;369218;313093;70.9;60.1
26;2021-08-16;1190;3291;370408;316384;71.2;60.8
26;2021-08-17;1523;3154;371931;319538;71.4;61.4
26;2021-08-18;1631;3376;373562;322914;71.8;62.0
26;2021-08-19;1552;3069;375114;325983;72.1;62.6
26;2021-08-20;1447;2980;376561;328963;72.3;63.2
26;2021-08-21;599;1090;377160;330053;72.5;63.4
26;2021-08-22;58;379;377218;330432;72.5;63.5
26;2021-08-23;1601;3621;378819;334053;72.8;64.2
26;2021-08-24;1749;3596;380568;337649;73.1;64.9
26;2021-08-25;1605;3660;382173;341309;73.4;65.6
26;2021-08-26;1494;3160;383667;344469;73.7;66.2
26;2021-08-27;1570;3607;385237;348076;74.0;66.9
26;2021-08-28;395;1104;385632;349180;74.1;67.1
26;2021-08-29;10;25;385642;349205;74.1;67.1
26;2021-08-30;1466;3385;387108;352590;74.4;67.7
26;2021-08-31;1286;3312;388394;355902;74.6;68.4
26;2021-09-01;1378;2599;389772;358501;74.9;68.9
26;2021-09-02;1116;1948;390888;360449;75.1;69.2
26;2021-09-03;1104;2520;391992;362969;75.3;69.7
26;2021-09-04;431;654;392423;363623;75.4;69.9
26;2021-09-05;25;18;392448;363641;75.4;69.9
26;2021-09-06;736;1445;393184;365086;75.5;70.1
26;2021-09-07;760;1417;393944;366503;75.7;70.4
26;2021-09-08;852;1665;394796;368168;75.8;70.7
26;2021-09-09;520;1322;395316;369490;75.9;71.0
26;2021-09-10;837;1750;396153;371240;76.1;71.3
26;2021-09-11;307;715;396460;371955;76.2;71.5
26;2021-09-12;0;5;396460;371960;76.2;71.5
26;2021-09-13;545;1292;397005;373252;76.3;71.7
26;2021-09-14;736;1279;397741;374531;76.4;71.9
26;2021-09-15;720;1831;398461;376362;76.5;72.3
26;2021-09-16;499;1008;398960;377370;76.6;72.5
26;2021-09-17;618;1732;399578;379102;76.8;72.8
26;2021-09-18;272;743;399850;379845;76.8;73.0
26;2021-09-19;3;13;399853;379858;76.8;73.0
26;2021-09-20;335;1095;400188;380953;76.9;73.2
26;2021-09-21;417;1013;400605;381966;77.0;73.4
26;2021-09-22;426;1519;401031;383485;77.0;73.7
26;2021-09-23;361;782;401392;384267;77.1;73.8
26;2021-09-24;442;1431;401834;385698;77.2;74.1
26;2021-09-25;180;601;402014;386299;77.2;74.2
26;2021-09-26;2;19;402016;386318;77.2;74.2
26;2021-09-27;312;811;402328;387129;77.3;74.4
26;2021-09-28;245;610;402573;387739;77.3;74.5
26;2021-09-29;385;1010;402958;388749;77.4;74.7
26;2021-09-30;225;517;403183;389266;77.5;74.8
26;2021-10-01;446;999;403629;390265;77.5;75.0
26;2021-10-02;189;340;403818;390605;77.6;75.0
26;2021-10-03;5;4;403823;390609;77.6;75.0
26;2021-10-04;320;631;404143;391240;77.6;75.2
26;2021-10-05;155;503;404298;391743;77.7;75.3
26;2021-10-06;385;797;404683;392540;77.7;75.4
26;2021-10-07;166;400;404849;392940;77.8;75.5
26;2021-10-08;379;844;405228;393784;77.8;75.6
26;2021-10-09;205;317;405433;394101;77.9;75.7
26;2021-10-10;1;17;405434;394118;77.9;75.7
26;2021-10-11;262;525;405696;394643;77.9;75.8
26;2021-10-12;175;331;405871;394974;78.0;75.9
26;2021-10-13;320;593;406191;395567;78.0;76.0
26;2021-10-14;181;361;406372;395928;78.1;76.1
27;2020-12-27;2;0;2;0;0.0;0.0
27;2020-12-28;1;0;3;0;0.0;0.0
27;2020-12-29;2;0;5;0;0.0;0.0
27;2020-12-30;0;0;5;0;0.0;0.0
27;2020-12-31;0;0;5;0;0.0;0.0
27;2021-01-01;0;0;5;0;0.0;0.0
27;2021-01-02;0;0;5;0;0.0;0.0
27;2021-01-03;2;0;7;0;0.0;0.0
27;2021-01-04;0;0;7;0;0.0;0.0
27;2021-01-05;15;0;22;0;0.0;0.0
27;2021-01-06;161;0;183;0;0.0;0.0
27;2021-01-07;373;1;556;1;0.1;0.0
27;2021-01-08;443;2;999;3;0.2;0.0
27;2021-01-09;72;1;1071;4;0.2;0.0
27;2021-01-10;100;0;1171;4;0.2;0.0
27;2021-01-11;383;0;1554;4;0.3;0.0
27;2021-01-12;409;2;1963;6;0.3;0.0
27;2021-01-13;840;3;2803;9;0.5;0.0
27;2021-01-14;1629;32;4432;41;0.7;0.0
27;2021-01-15;1224;6;5656;47;0.9;0.0
27;2021-01-16;332;2;5988;49;1.0;0.0
27;2021-01-17;205;0;6193;49;1.0;0.0
27;2021-01-18;800;3;6993;52;1.2;0.0
27;2021-01-19;772;3;7765;55;1.3;0.0
27;2021-01-20;871;1;8636;56;1.4;0.0
27;2021-01-21;654;4;9290;60;1.5;0.0
27;2021-01-22;778;5;10068;65;1.7;0.0
27;2021-01-23;350;0;10418;65;1.7;0.0
27;2021-01-24;169;6;10587;71;1.8;0.0
27;2021-01-25;635;15;11222;86;1.9;0.0
27;2021-01-26;462;17;11684;103;1.9;0.0
27;2021-01-27;506;104;12190;207;2.0;0.0
27;2021-01-28;517;294;12707;501;2.1;0.1
27;2021-01-29;509;108;13216;609;2.2;0.1
27;2021-01-30;242;29;13458;638;2.2;0.1
27;2021-01-31;27;24;13485;662;2.2;0.1
27;2021-02-01;348;194;13833;856;2.3;0.1
27;2021-02-02;308;280;14141;1136;2.4;0.2
27;2021-02-03;487;400;14628;1536;2.4;0.3
27;2021-02-04;717;884;15345;2420;2.6;0.4
27;2021-02-05;664;1141;16009;3561;2.7;0.6
27;2021-02-06;126;220;16135;3781;2.7;0.6
27;2021-02-07;25;42;16160;3823;2.7;0.6
27;2021-02-08;312;378;16472;4201;2.7;0.7
27;2021-02-09;341;554;16813;4755;2.8;0.8
27;2021-02-10;305;521;17118;5276;2.8;0.9
27;2021-02-11;318;453;17436;5729;2.9;1.0
27;2021-02-12;230;542;17666;6271;2.9;1.0
27;2021-02-13;151;133;17817;6404;3.0;1.1
27;2021-02-14;6;92;17823;6496;3.0;1.1
27;2021-02-15;389;598;18212;7094;3.0;1.2
27;2021-02-16;296;733;18508;7827;3.1;1.3
27;2021-02-17;247;635;18755;8462;3.1;1.4
27;2021-02-18;363;681;19118;9143;3.2;1.5
27;2021-02-19;218;689;19336;9832;3.2;1.6
27;2021-02-20;129;250;19465;10082;3.2;1.7
27;2021-02-21;12;136;19477;10218;3.2;1.7
27;2021-02-22;482;566;19959;10784;3.3;1.8
27;2021-02-23;496;622;20455;11406;3.4;1.9
27;2021-02-24;543;648;20998;12054;3.5;2.0
27;2021-02-25;848;759;21846;12813;3.6;2.1
27;2021-02-26;955;693;22801;13506;3.8;2.2
27;2021-02-27;408;162;23209;13668;3.9;2.3
27;2021-02-28;174;30;23383;13698;3.9;2.3
27;2021-03-01;488;442;23871;14140;4.0;2.4
27;2021-03-02;765;371;24636;14511;4.1;2.4
27;2021-03-03;853;363;25489;14874;4.2;2.5
27;2021-03-04;886;237;26375;15111;4.4;2.5
27;2021-03-05;1304;242;27679;15353;4.6;2.6
27;2021-03-06;1639;110;29318;15463;4.9;2.6
27;2021-03-07;620;18;29938;15481;5.0;2.6
27;2021-03-08;1204;304;31142;15785;5.2;2.6
27;2021-03-09;1828;270;32970;16055;5.5;2.7
27;2021-03-10;2116;352;35086;16407;5.8;2.7
27;2021-03-11;2162;233;37248;16640;6.2;2.8
27;2021-03-12;2816;204;40064;16844;6.7;2.8
27;2021-03-13;1919;129;41983;16973;7.0;2.8
27;2021-03-14;655;16;42638;16989;7.1;2.8
27;2021-03-15;1558;218;44196;17207;7.4;2.9
27;2021-03-16;1490;242;45686;17449;7.6;2.9
27;2021-03-17;1856;375;47542;17824;7.9;3.0
27;2021-03-18;1687;349;49229;18173;8.2;3.0
27;2021-03-19;1835;177;51064;18350;8.5;3.1
27;2021-03-20;905;43;51969;18393;8.7;3.1
27;2021-03-21;258;3;52227;18396;8.7;3.1
27;2021-03-22;1235;548;53462;18944;8.9;3.2
27;2021-03-23;1627;460;55089;19404;9.2;3.2
27;2021-03-24;1523;480;56612;19884;9.4;3.3
27;2021-03-25;2165;521;58777;20405;9.8;3.4
27;2021-03-26;2531;446;61308;20851;10.2;3.5
27;2021-03-27;1568;202;62876;21053;10.5;3.5
27;2021-03-28;1149;50;64025;21103;10.7;3.5
27;2021-03-29;1375;835;65400;21938;10.9;3.7
27;2021-03-30;1391;850;66791;22788;11.1;3.8
27;2021-03-31;1485;877;68276;23665;11.4;3.9
27;2021-04-01;1956;815;70232;24480;11.7;4.1
27;2021-04-02;1999;1187;72231;25667;12.0;4.3
27;2021-04-03;1563;741;73794;26408;12.3;4.4
27;2021-04-04;979;176;74773;26584;12.4;4.4
27;2021-04-05;283;7;75056;26591;12.5;4.4
27;2021-04-06;1413;1804;76469;28395;12.7;4.7
27;2021-04-07;1322;1746;77791;30141;13.0;5.0
27;2021-04-08;1685;1684;79476;31825;13.2;5.3
27;2021-04-09;2944;1569;82420;33394;13.7;5.6
27;2021-04-10;2033;988;84453;34382;14.1;5.7
27;2021-04-11;946;212;85399;34594;14.2;5.8
27;2021-04-12;2434;1518;87833;36112;14.6;6.0
27;2021-04-13;2393;1548;90226;37660;15.0;6.3
27;2021-04-14;2085;1632;92311;39292;15.4;6.5
27;2021-04-15;1874;1662;94185;40954;15.7;6.8
27;2021-04-16;2751;1118;96936;42072;16.1;7.0
27;2021-04-17;2168;498;99104;42570;16.5;7.1
27;2021-04-18;452;18;99556;42588;16.6;7.1
27;2021-04-19;1712;1175;101268;43763;16.9;7.3
27;2021-04-20;2388;1310;103656;45073;17.3;7.5
27;2021-04-21;2210;1083;105866;46156;17.6;7.7
27;2021-04-22;2180;1423;108046;47579;18.0;7.9
27;2021-04-23;2446;1183;110492;48762;18.4;8.1
27;2021-04-24;3260;1151;113752;49913;18.9;8.3
27;2021-04-25;1130;1052;114882;50965;19.1;8.5
27;2021-04-26;1925;1148;116807;52113;19.4;8.7
27;2021-04-27;2528;1094;119335;53207;19.9;8.9
27;2021-04-28;2395;1320;121730;54527;20.3;9.1
27;2021-04-29;2491;1476;124221;56003;20.7;9.3
27;2021-04-30;2371;1616;126592;57619;21.1;9.6
27;2021-05-01;2638;892;129230;58511;21.5;9.7
27;2021-05-02;1952;901;131182;59412;21.8;9.9
27;2021-05-03;3064;882;134246;60294;22.3;10.0
27;2021-05-04;2782;1652;137028;61946;22.8;10.3
27;2021-05-05;2816;1653;139844;63599;23.3;10.6
27;2021-05-06;3184;1298;143028;64897;23.8;10.8
27;2021-05-07;3322;2003;146350;66900;24.4;11.1
27;2021-05-08;2805;1332;149155;68232;24.8;11.4
27;2021-05-09;1698;298;150853;68530;25.1;11.4
27;2021-05-10;2950;2272;153803;70802;25.6;11.8
27;2021-05-11;3358;1759;157161;72561;26.2;12.1
27;2021-05-12;3464;1729;160625;74290;26.7;12.4
27;2021-05-13;1892;255;162517;74545;27.1;12.4
27;2021-05-14;3884;1790;166401;76335;27.7;12.7
27;2021-05-15;6601;953;173002;77288;28.8;12.9
27;2021-05-16;3668;438;176670;77726;29.4;12.9
27;2021-05-17;2774;1161;179444;78887;29.9;13.1
27;2021-05-18;3845;1296;183289;80183;30.5;13.3
27;2021-05-19;3967;1154;187256;81337;31.2;13.5
27;2021-05-20;3874;1174;191130;82511;31.8;13.7
27;2021-05-21;3968;1801;195098;84312;32.5;14.0
27;2021-05-22;4367;802;199465;85114;33.2;14.2
27;2021-05-23;799;173;200264;85287;33.3;14.2
27;2021-05-24;1489;342;201753;85629;33.6;14.3
27;2021-05-25;3510;1608;205263;87237;34.2;14.5
27;2021-05-26;3855;1740;209118;88977;34.8;14.8
27;2021-05-27;3789;1487;212907;90464;35.4;15.1
27;2021-05-28;3403;2634;216310;93098;36.0;15.5
27;2021-05-29;4822;2302;221132;95400;36.8;15.9
27;2021-05-30;1117;247;222249;95647;37.0;15.9
27;2021-05-31;3464;2274;225713;97921;37.6;16.3
27;2021-06-01;3813;2250;229526;100171;38.2;16.7
27;2021-06-02;3341;2183;232867;102354;38.8;17.0
27;2021-06-03;4430;2126;237297;104480;39.5;17.4
27;2021-06-04;3603;2978;240900;107458;40.1;17.9
27;2021-06-05;3207;3351;244107;110809;40.6;18.4
27;2021-06-06;2004;1005;246111;111814;41.0;18.6
27;2021-06-07;2570;2357;248681;114171;41.4;19.0
27;2021-06-08;3126;2379;251807;116550;41.9;19.4
27;2021-06-09;2305;2471;254112;119021;42.3;19.8
27;2021-06-10;2431;2041;256543;121062;42.7;20.2
27;2021-06-11;2889;3772;259432;124834;43.2;20.8
27;2021-06-12;1982;4191;261414;129025;43.5;21.5
27;2021-06-13;1083;2687;262497;131712;43.7;21.9
27;2021-06-14;1996;3113;264493;134825;44.0;22.4
27;2021-06-15;2689;3022;267182;137847;44.5;22.9
27;2021-06-16;2502;3261;269684;141108;44.9;23.5
27;2021-06-17;2298;3291;271982;144399;45.3;24.0
27;2021-06-18;2746;4420;274728;148819;45.7;24.8
27;2021-06-19;1863;3392;276591;152211;46.0;25.3
27;2021-06-20;607;710;277198;152921;46.1;25.5
27;2021-06-21;1703;3496;278901;156417;46.4;26.0
27;2021-06-22;2385;3719;281286;160136;46.8;26.7
27;2021-06-23;2073;3572;283359;163708;47.2;27.3
27;2021-06-24;2256;3413;285615;167121;47.5;27.8
27;2021-06-25;1936;4460;287551;171581;47.9;28.6
27;2021-06-26;884;5352;288435;176933;48.0;29.5
27;2021-06-27;377;1427;288812;178360;48.1;29.7
27;2021-06-28;1129;3405;289941;181765;48.3;30.3
27;2021-06-29;1703;4365;291644;186130;48.6;31.0
27;2021-06-30;2115;4096;293759;190226;48.9;31.7
27;2021-07-01;2224;3908;295983;194134;49.3;32.3
27;2021-07-02;1589;4620;297572;198754;49.5;33.1
27;2021-07-03;1309;4774;298881;203528;49.8;33.9
27;2021-07-04;504;1403;299385;204931;49.8;34.1
27;2021-07-05;1417;3529;300802;208460;50.1;34.7
27;2021-07-06;1366;4180;302168;212640;50.3;35.4
27;2021-07-07;1756;4905;303924;217545;50.6;36.2
27;2021-07-08;2089;4356;306013;221901;50.9;36.9
27;2021-07-09;1984;5287;307997;227188;51.3;37.8
27;2021-07-10;1167;4179;309164;231367;51.5;38.5
27;2021-07-11;426;1139;309590;232506;51.5;38.7
27;2021-07-12;1254;4374;310844;236880;51.7;39.4
27;2021-07-13;2759;5347;313603;242227;52.2;40.3
27;2021-07-14;1518;1753;315121;243980;52.5;40.6
27;2021-07-15;3033;5468;318154;249448;53.0;41.5
27;2021-07-16;3820;5290;321974;254738;53.6;42.4
27;2021-07-17;2732;3878;324706;258616;54.1;43.1
27;2021-07-18;553;1266;325259;259882;54.1;43.3
27;2021-07-19;3687;3791;328946;263673;54.8;43.9
27;2021-07-20;3460;3593;332406;267266;55.3;44.5
27;2021-07-21;4250;3901;336656;271167;56.0;45.1
27;2021-07-22;4750;3716;341406;274883;56.8;45.8
27;2021-07-23;3592;3400;344998;278283;57.4;46.3
27;2021-07-24;3114;2329;348112;280612;58.0;46.7
27;2021-07-25;493;545;348605;281157;58.0;46.8
27;2021-07-26;3072;3175;351677;284332;58.5;47.3
27;2021-07-27;3595;3104;355272;287436;59.1;47.9
27;2021-07-28;3592;3242;358864;290678;59.7;48.4
27;2021-07-29;4590;3511;363454;294189;60.5;49.0
27;2021-07-30;3817;3146;367271;297335;61.1;49.5
27;2021-07-31;3062;2588;370333;299923;61.7;49.9
27;2021-08-01;540;498;370873;300421;61.7;50.0
27;2021-08-02;3319;2585;374192;303006;62.3;50.4
27;2021-08-03;3427;2770;377619;305776;62.9;50.9
27;2021-08-04;3060;2335;380679;308111;63.4;51.3
27;2021-08-05;2676;2358;383355;310469;63.8;51.7
27;2021-08-06;3269;3244;386624;313713;64.4;52.2
27;2021-08-07;1801;2558;388425;316271;64.7;52.7
27;2021-08-08;218;197;388643;316468;64.7;52.7
27;2021-08-09;2210;2807;390853;319275;65.1;53.2
27;2021-08-10;2811;3514;393664;322789;65.5;53.7
27;2021-08-11;2637;3099;396301;325888;66.0;54.3
27;2021-08-12;2363;3905;398664;329793;66.4;54.9
27;2021-08-13;1745;2572;400409;332365;66.7;55.3
27;2021-08-14;1164;2890;401573;335255;66.9;55.8
27;2021-08-15;18;23;401591;335278;66.9;55.8
27;2021-08-16;1811;3816;403402;339094;67.2;56.5
27;2021-08-17;2046;3444;405448;342538;67.5;57.0
27;2021-08-18;1457;2987;406905;345525;67.7;57.5
27;2021-08-19;1711;3357;408616;348882;68.0;58.1
27;2021-08-20;1636;3440;410252;352322;68.3;58.7
27;2021-08-21;988;2842;411240;355164;68.5;59.1
27;2021-08-22;184;162;411424;355326;68.5;59.2
27;2021-08-23;1080;4008;412504;359334;68.7;59.8
27;2021-08-24;1440;3970;413944;363304;68.9;60.5
27;2021-08-25;1717;3414;415661;366718;69.2;61.0
27;2021-08-26;1157;2932;416818;369650;69.4;61.5
27;2021-08-27;1265;3223;418083;372873;69.6;62.1
27;2021-08-28;912;2870;418995;375743;69.8;62.6
27;2021-08-29;87;135;419082;375878;69.8;62.6
27;2021-08-30;905;3278;419987;379156;69.9;63.1
27;2021-08-31;1225;3083;421212;382239;70.1;63.6
27;2021-09-01;998;2922;422210;385161;70.3;64.1
27;2021-09-02;874;2187;423084;387348;70.4;64.5
27;2021-09-03;847;2170;423931;389518;70.6;64.8
27;2021-09-04;731;1957;424662;391475;70.7;65.2
27;2021-09-05;36;154;424698;391629;70.7;65.2
27;2021-09-06;538;1457;425236;393086;70.8;65.4
27;2021-09-07;698;2086;425934;395172;70.9;65.8
27;2021-09-08;771;2088;426705;397260;71.0;66.1
27;2021-09-09;683;1648;427388;398908;71.1;66.4
27;2021-09-10;903;1927;428291;400835;71.3;66.7
27;2021-09-11;610;1811;428901;402646;71.4;67.0
27;2021-09-12;42;171;428943;402817;71.4;67.1
27;2021-09-13;351;928;429294;403745;71.5;67.2
27;2021-09-14;596;1095;429890;404840;71.6;67.4
27;2021-09-15;557;1670;430447;406510;71.7;67.7
27;2021-09-16;600;1134;431047;407644;71.8;67.9
27;2021-09-17;790;1292;431837;408936;71.9;68.1
27;2021-09-18;364;1247;432201;410183;72.0;68.3
27;2021-09-19;56;161;432257;410344;72.0;68.3
27;2021-09-20;260;773;432517;411117;72.0;68.4
27;2021-09-21;428;964;432945;412081;72.1;68.6
27;2021-09-22;306;1030;433251;413111;72.1;68.8
27;2021-09-23;345;756;433596;413867;72.2;68.9
27;2021-09-24;578;1244;434174;415111;72.3;69.1
27;2021-09-25;291;1122;434465;416233;72.3;69.3
27;2021-09-26;4;12;434469;416245;72.3;69.3
27;2021-09-27;190;474;434659;416719;72.4;69.4
27;2021-09-28;313;725;434972;417444;72.4;69.5
27;2021-09-29;242;727;435214;418171;72.5;69.6
27;2021-09-30;162;521;435376;418692;72.5;69.7
27;2021-10-01;344;999;435720;419691;72.5;69.9
27;2021-10-02;364;797;436084;420488;72.6;70.0
27;2021-10-03;13;12;436097;420500;72.6;70.0
27;2021-10-04;178;374;436275;420874;72.6;70.1
27;2021-10-05;262;465;436537;421339;72.7;70.1
27;2021-10-06;282;693;436819;422032;72.7;70.3
27;2021-10-07;144;281;436963;422313;72.7;70.3
27;2021-10-08;329;824;437292;423137;72.8;70.4
27;2021-10-09;254;538;437546;423675;72.8;70.5
27;2021-10-10;12;35;437558;423710;72.8;70.5
27;2021-10-11;159;388;437717;424098;72.9;70.6
27;2021-10-12;250;474;437967;424572;72.9;70.7
27;2021-10-13;279;421;438246;424993;73.0;70.8
27;2021-10-14;142;360;438388;425353;73.0;70.8
28;2020-12-27;0;0;0;0;0.0;0.0
28;2020-12-28;0;0;0;0;0.0;0.0
28;2020-12-29;0;0;0;0;0.0;0.0
28;2020-12-30;0;0;0;0;0.0;0.0
28;2020-12-31;0;0;0;0;0.0;0.0
28;2021-01-01;1;0;1;0;0.0;0.0
28;2021-01-02;0;0;1;0;0.0;0.0
28;2021-01-03;0;0;1;0;0.0;0.0
28;2021-01-04;0;0;1;0;0.0;0.0
28;2021-01-05;5;0;6;0;0.0;0.0
28;2021-01-06;84;0;90;0;0.0;0.0
28;2021-01-07;102;0;192;0;0.0;0.0
28;2021-01-08;134;2;326;2;0.1;0.0
28;2021-01-09;79;0;405;2;0.1;0.0
28;2021-01-10;1;0;406;2;0.1;0.0
28;2021-01-11;204;0;610;2;0.1;0.0
28;2021-01-12;265;2;875;4;0.2;0.0
28;2021-01-13;398;3;1273;7;0.3;0.0
28;2021-01-14;452;6;1725;13;0.4;0.0
28;2021-01-15;374;3;2099;16;0.5;0.0
28;2021-01-16;206;2;2305;18;0.5;0.0
28;2021-01-17;21;0;2326;18;0.5;0.0
28;2021-01-18;373;2;2699;20;0.6;0.0
28;2021-01-19;503;4;3202;24;0.7;0.0
28;2021-01-20;636;1;3838;25;0.9;0.0
28;2021-01-21;796;3;4634;28;1.1;0.0
28;2021-01-22;478;1;5112;29;1.2;0.0
28;2021-01-23;353;0;5465;29;1.3;0.0
28;2021-01-24;1;0;5466;29;1.3;0.0
28;2021-01-25;456;4;5922;33;1.4;0.0
28;2021-01-26;717;9;6639;42;1.5;0.0
28;2021-01-27;1211;52;7850;94;1.8;0.0
28;2021-01-28;1587;95;9437;189;2.2;0.0
28;2021-01-29;895;99;10332;288;2.4;0.1
28;2021-01-30;249;53;10581;341;2.5;0.1
28;2021-01-31;2;22;10583;363;2.5;0.1
28;2021-02-01;325;121;10908;484;2.5;0.1
28;2021-02-02;368;239;11276;723;2.6;0.2
28;2021-02-03;473;258;11749;981;2.7;0.2
28;2021-02-04;526;279;12275;1260;2.9;0.3
28;2021-02-05;436;230;12711;1490;3.0;0.3
28;2021-02-06;201;130;12912;1620;3.0;0.4
28;2021-02-07;0;0;12912;1620;3.0;0.4
28;2021-02-08;331;250;13243;1870;3.1;0.4
28;2021-02-09;281;344;13524;2214;3.1;0.5
28;2021-02-10;443;399;13967;2613;3.3;0.6
28;2021-02-11;562;492;14529;3105;3.4;0.7
28;2021-02-12;453;431;14982;3536;3.5;0.8
28;2021-02-13;181;191;15163;3727;3.5;0.9
28;2021-02-14;0;2;15163;3729;3.5;0.9
28;2021-02-15;280;473;15443;4202;3.6;1.0
28;2021-02-16;396;710;15839;4912;3.7;1.1
28;2021-02-17;584;1153;16423;6065;3.8;1.4
28;2021-02-18;666;1408;17089;7473;4.0;1.7
28;2021-02-19;548;766;17637;8239;4.1;1.9
28;2021-02-20;114;145;17751;8384;4.1;2.0
28;2021-02-21;7;33;17758;8417;4.1;2.0
28;2021-02-22;223;521;17981;8938;4.2;2.1
28;2021-02-23;203;379;18184;9317;4.2;2.2
28;2021-02-24;244;474;18428;9791;4.3;2.3
28;2021-02-25;574;454;19002;10245;4.4;2.4
28;2021-02-26;764;378;19766;10623;4.6;2.5
28;2021-02-27;265;86;20031;10709;4.7;2.5
28;2021-02-28;23;17;20054;10726;4.7;2.5
28;2021-03-01;292;215;20346;10941;4.7;2.5
28;2021-03-02;396;293;20742;11234;4.8;2.6
28;2021-03-03;367;399;21109;11633;4.9;2.7
28;2021-03-04;720;494;21829;12127;5.1;2.8
28;2021-03-05;1319;419;23148;12546;5.4;2.9
28;2021-03-06;1999;95;25147;12641;5.9;2.9
28;2021-03-07;974;42;26121;12683;6.1;3.0
28;2021-03-08;398;308;26519;12991;6.2;3.0
28;2021-03-09;981;364;27500;13355;6.4;3.1
28;2021-03-10;1358;558;28858;13913;6.7;3.2
28;2021-03-11;1535;710;30393;14623;7.1;3.4
28;2021-03-12;2256;645;32649;15268;7.6;3.6
28;2021-03-13;1235;134;33884;15402;7.9;3.6
28;2021-03-14;519;18;34403;15420;8.0;3.6
28;2021-03-15;755;234;35158;15654;8.2;3.6
28;2021-03-16;716;224;35874;15878;8.4;3.7
28;2021-03-17;746;290;36620;16168;8.5;3.8
28;2021-03-18;1203;278;37823;16446;8.8;3.8
28;2021-03-19;1558;340;39381;16786;9.2;3.9
28;2021-03-20;639;21;40020;16807;9.3;3.9
28;2021-03-21;29;8;40049;16815;9.3;3.9
28;2021-03-22;765;324;40814;17139;9.5;4.0
28;2021-03-23;1027;193;41841;17332;9.7;4.0
28;2021-03-24;1315;281;43156;17613;10.0;4.1
28;2021-03-25;1796;291;44952;17904;10.5;4.2
28;2021-03-26;2084;348;47036;18252;11.0;4.3
28;2021-03-27;402;38;47438;18290;11.0;4.3
28;2021-03-28;12;0;47450;18290;11.0;4.3
28;2021-03-29;1139;358;48589;18648;11.3;4.3
28;2021-03-30;1710;255;50299;18903;11.7;4.4
28;2021-03-31;2017;482;52316;19385;12.2;4.5
28;2021-04-01;1796;591;54112;19976;12.6;4.7
28;2021-04-02;1583;1321;55695;21297;13.0;5.0
28;2021-04-03;607;1071;56302;22368;13.1;5.2
28;2021-04-04;33;302;56335;22670;13.1;5.3
28;2021-04-05;40;3;56375;22673;13.1;5.3
28;2021-04-06;1222;464;57597;23137;13.4;5.4
28;2021-04-07;1890;1008;59487;24145;13.9;5.6
28;2021-04-08;2085;1076;61572;25221;14.3;5.9
28;2021-04-09;3230;924;64802;26145;15.1;6.1
28;2021-04-10;1581;203;66383;26348;15.5;6.1
28;2021-04-11;141;451;66524;26799;15.5;6.2
28;2021-04-12;1672;568;68196;27367;15.9;6.4
28;2021-04-13;1875;673;70071;28040;16.3;6.5
28;2021-04-14;2771;906;72842;28946;17.0;6.7
28;2021-04-15;2557;1153;75399;30099;17.6;7.0
28;2021-04-16;2554;810;77953;30909;18.2;7.2
28;2021-04-17;2309;134;80262;31043;18.7;7.2
28;2021-04-18;45;8;80307;31051;18.7;7.2
28;2021-04-19;1576;651;81883;31702;19.1;7.4
28;2021-04-20;1836;598;83719;32300;19.5;7.5
28;2021-04-21;2680;965;86399;33265;20.1;7.7
28;2021-04-22;1783;1224;88182;34489;20.5;8.0
28;2021-04-23;2325;1109;90507;35598;21.1;8.3
28;2021-04-24;3656;143;94163;35741;21.9;8.3
28;2021-04-25;1012;39;95175;35780;22.2;8.3
28;2021-04-26;1331;930;96506;36710;22.5;8.5
28;2021-04-27;1436;1287;97942;37997;22.8;8.8
28;2021-04-28;2373;1834;100315;39831;23.4;9.3
28;2021-04-29;2131;1515;102446;41346;23.9;9.6
28;2021-04-30;2973;1231;105419;42577;24.5;9.9
28;2021-05-01;127;121;105546;42698;24.6;9.9
28;2021-05-02;2;65;105548;42763;24.6;10.0
28;2021-05-03;1049;1022;106597;43785;24.8;10.2
28;2021-05-04;1359;1673;107956;45458;25.1;10.6
28;2021-05-05;2830;1654;110786;47112;25.8;11.0
28;2021-05-06;2456;1473;113242;48585;26.4;11.3
28;2021-05-07;2311;1934;115553;50519;26.9;11.8
28;2021-05-08;1078;118;116631;50637;27.2;11.8
28;2021-05-09;105;610;116736;51247;27.2;11.9
28;2021-05-10;1308;1894;118044;53141;27.5;12.4
28;2021-05-11;2024;2344;120068;55485;28.0;12.9
28;2021-05-12;2620;3237;122688;58722;28.6;13.7
28;2021-05-13;289;452;122977;59174;28.6;13.8
28;2021-05-14;1900;1616;124877;60790;29.1;14.2
28;2021-05-15;1433;1673;126310;62463;29.4;14.5
28;2021-05-16;1986;131;128296;62594;29.9;14.6
28;2021-05-17;2874;1493;131170;64087;30.5;14.9
28;2021-05-18;3382;1381;134552;65468;31.3;15.2
28;2021-05-19;5089;1282;139641;66750;32.5;15.5
28;2021-05-20;4149;1230;143790;67980;33.5;15.8
28;2021-05-21;3464;1587;147254;69567;34.3;16.2
28;2021-05-22;729;1161;147983;70728;34.5;16.5
28;2021-05-23;1956;139;149939;70867;34.9;16.5
28;2021-05-24;1428;395;151367;71262;35.2;16.6
28;2021-05-25;1876;1408;153243;72670;35.7;16.9
28;2021-05-26;2765;1346;156008;74016;36.3;17.2
28;2021-05-27;2754;1234;158762;75250;37.0;17.5
28;2021-05-28;3080;1732;161842;76982;37.7;17.9
28;2021-05-29;1868;873;163710;77855;38.1;18.1
28;2021-05-30;16;47;163726;77902;38.1;18.1
28;2021-05-31;2014;937;165740;78839;38.6;18.4
28;2021-06-01;2133;1662;167873;80501;39.1;18.7
28;2021-06-02;2077;2457;169950;82958;39.6;19.3
28;2021-06-03;2498;1562;172448;84520;40.2;19.7
28;2021-06-04;2608;2358;175056;86878;40.8;20.2
28;2021-06-05;1909;2522;176965;89400;41.2;20.8
28;2021-06-06;1060;1046;178025;90446;41.5;21.1
28;2021-06-07;3575;1575;181600;92021;42.3;21.4
28;2021-06-08;3196;1520;184796;93541;43.0;21.8
28;2021-06-09;3675;2130;188471;95671;43.9;22.3
28;2021-06-10;3140;1262;191611;96933;44.6;22.6
28;2021-06-11;3790;2135;195401;99068;45.5;23.1
28;2021-06-12;1304;560;196705;99628;45.8;23.2
28;2021-06-13;385;108;197090;99736;45.9;23.2
28;2021-06-14;2207;1995;199297;101731;46.4;23.7
28;2021-06-15;2092;2224;201389;103955;46.9;24.2
28;2021-06-16;2508;3982;203897;107937;47.5;25.1
28;2021-06-17;1940;3135;205837;111072;47.9;25.9
28;2021-06-18;2487;3789;208324;114861;48.5;26.7
28;2021-06-19;776;1612;209100;116473;48.7;27.1
28;2021-06-20;23;24;209123;116497;48.7;27.1
28;2021-06-21;1682;1989;210805;118486;49.1;27.6
28;2021-06-22;1372;2108;212177;120594;49.4;28.1
28;2021-06-23;1782;3164;213959;123758;49.8;28.8
28;2021-06-24;734;929;214693;124687;50.0;29.0
28;2021-06-25;1888;3028;216581;127715;50.4;29.7
28;2021-06-26;310;2114;216891;129829;50.5;30.2
28;2021-06-27;588;1284;217479;131113;50.6;30.5
28;2021-06-28;1225;3655;218704;134768;50.9;31.4
28;2021-06-29;1342;3791;220046;138559;51.2;32.3
28;2021-06-30;1494;4261;221540;142820;51.6;33.3
28;2021-07-01;1277;3500;222817;146320;51.9;34.1
28;2021-07-02;1313;4651;224130;150971;52.2;35.2
28;2021-07-03;1131;2372;225261;153343;52.5;35.7
28;2021-07-04;145;1325;225406;154668;52.5;36.0
28;2021-07-05;1359;2512;226765;157180;52.8;36.6
28;2021-07-06;1508;2870;228273;160050;53.2;37.3
28;2021-07-07;1636;4143;229909;164193;53.5;38.2
28;2021-07-08;1467;3241;231376;167434;53.9;39.0
28;2021-07-09;1393;4520;232769;171954;54.2;40.0
28;2021-07-10;528;2206;233297;174160;54.3;40.6
28;2021-07-11;2;1;233299;174161;54.3;40.6
28;2021-07-12;1526;3929;234825;178090;54.7;41.5
28;2021-07-13;2261;4143;237086;182233;55.2;42.4
28;2021-07-14;1328;1395;238414;183628;55.5;42.8
28;2021-07-15;2985;3973;241399;187601;56.2;43.7
28;2021-07-16;2444;4752;243843;192353;56.8;44.8
28;2021-07-17;1263;2431;245106;194784;57.1;45.4
28;2021-07-18;368;945;245474;195729;57.2;45.6
28;2021-07-19;1806;4339;247280;200068;57.6;46.6
28;2021-07-20;2476;4091;249756;204159;58.2;47.5
28;2021-07-21;2959;4286;252715;208445;58.8;48.5
28;2021-07-22;3670;3432;256385;211877;59.7;49.3
28;2021-07-23;2959;3998;259344;215875;60.4;50.3
28;2021-07-24;1715;1484;261059;217359;60.8;50.6
28;2021-07-25;67;60;261126;217419;60.8;50.6
28;2021-07-26;2930;3387;264056;220806;61.5;51.4
28;2021-07-27;3885;2621;267941;223427;62.4;52.0
28;2021-07-28;3946;2746;271887;226173;63.3;52.7
28;2021-07-29;4466;2092;276353;228265;64.4;53.2
28;2021-07-30;3825;2848;280178;231113;65.2;53.8
28;2021-07-31;763;826;280941;231939;65.4;54.0
28;2021-08-01;378;65;281319;232004;65.5;54.0
28;2021-08-02;1793;1520;283112;233524;65.9;54.4
28;2021-08-03;2684;2168;285796;235692;66.6;54.9
28;2021-08-04;1932;2303;287728;237995;67.0;55.4
28;2021-08-05;1663;1731;289391;239726;67.4;55.8
28;2021-08-06;1618;1970;291009;241696;67.8;56.3
28;2021-08-07;798;1002;291807;242698;68.0;56.5
28;2021-08-08;22;33;291829;242731;68.0;56.5
28;2021-08-09;1388;1102;293217;243833;68.3;56.8
28;2021-08-10;1714;2027;294931;245860;68.7;57.3
28;2021-08-11;1273;1572;296204;247432;69.0;57.6
28;2021-08-12;1165;1881;297369;249313;69.2;58.1
28;2021-08-13;1320;1649;298689;250962;69.6;58.4
28;2021-08-14;659;844;299348;251806;69.7;58.6
28;2021-08-15;264;59;299612;251865;69.8;58.7
28;2021-08-16;862;2145;300474;254010;70.0;59.2
28;2021-08-17;1126;2798;301600;256808;70.2;59.8
28;2021-08-18;891;2412;302491;259220;70.4;60.4
28;2021-08-19;889;2616;303380;261836;70.6;61.0
28;2021-08-20;939;2753;304319;264589;70.9;61.6
28;2021-08-21;381;1001;304700;265590;71.0;61.8
28;2021-08-22;9;31;304709;265621;71.0;61.9
28;2021-08-23;1041;2149;305750;267770;71.2;62.4
28;2021-08-24;867;2582;306617;270352;71.4;63.0
28;2021-08-25;1077;2210;307694;272562;71.7;63.5
28;2021-08-26;701;1817;308395;274379;71.8;63.9
28;2021-08-27;749;2369;309144;276748;72.0;64.4
28;2021-08-28;524;1098;309668;277846;72.1;64.7
28;2021-08-29;7;23;309675;277869;72.1;64.7
28;2021-08-30;994;2164;310669;280033;72.3;65.2
28;2021-08-31;798;2186;311467;282219;72.5;65.7
28;2021-09-01;748;2433;312215;284652;72.7;66.3
28;2021-09-02;540;1958;312755;286610;72.8;66.7
28;2021-09-03;668;2365;313423;288975;73.0;67.3
28;2021-09-04;585;2503;314008;291478;73.1;67.9
28;2021-09-05;210;139;314218;291617;73.2;67.9
28;2021-09-06;405;1388;314623;293005;73.3;68.2
28;2021-09-07;352;1299;314975;294304;73.3;68.5
28;2021-09-08;544;1426;315519;295730;73.5;68.9
28;2021-09-09;319;982;315838;296712;73.5;69.1
28;2021-09-10;591;1417;316429;298129;73.7;69.4
28;2021-09-11;298;1257;316727;299386;73.8;69.7
28;2021-09-12;40;28;316767;299414;73.8;69.7
28;2021-09-13;312;734;317079;300148;73.8;69.9
28;2021-09-14;322;941;317401;301089;73.9;70.1
28;2021-09-15;526;1027;317927;302116;74.0;70.4
28;2021-09-16;252;689;318179;302805;74.1;70.5
28;2021-09-17;301;1048;318480;303853;74.2;70.8
28;2021-09-18;124;237;318604;304090;74.2;70.8
28;2021-09-19;7;17;318611;304107;74.2;70.8
28;2021-09-20;154;459;318765;304566;74.2;70.9
28;2021-09-21;394;935;319159;305501;74.3;71.1
28;2021-09-22;330;1068;319489;306569;74.4;71.4
28;2021-09-23;190;507;319679;307076;74.4;71.5
28;2021-09-24;255;969;319934;308045;74.5;71.7
28;2021-09-25;99;326;320033;308371;74.5;71.8
28;2021-09-26;21;34;320054;308405;74.5;71.8
28;2021-09-27;167;665;320221;309070;74.6;72.0
28;2021-09-28;172;440;320393;309510;74.6;72.1
28;2021-09-29;352;687;320745;310197;74.7;72.2
28;2021-09-30;234;451;320979;310648;74.7;72.3
28;2021-10-01;250;726;321229;311374;74.8;72.5
28;2021-10-02;76;151;321305;311525;74.8;72.5
28;2021-10-03;0;6;321305;311531;74.8;72.5
28;2021-10-04;132;255;321437;311786;74.9;72.6
28;2021-10-05;159;369;321596;312155;74.9;72.7
28;2021-10-06;198;608;321794;312763;74.9;72.8
28;2021-10-07;130;272;321924;313035;75.0;72.9
28;2021-10-08;254;464;322178;313499;75.0;73.0
28;2021-10-09;75;142;322253;313641;75.0;73.0
28;2021-10-10;10;12;322263;313653;75.0;73.0
28;2021-10-11;158;223;322421;313876;75.1;73.1
28;2021-10-12;182;379;322603;314255;75.1;73.2
28;2021-10-13;190;404;322793;314659;75.2;73.3
28;2021-10-14;171;257;322964;314916;75.2;73.3
29;2020-12-27;0;0;0;0;0.0;0.0
29;2020-12-28;1;1;1;1;0.0;0.0
29;2020-12-29;0;0;1;1;0.0;0.0
29;2020-12-30;0;0;1;1;0.0;0.0
29;2020-12-31;0;0;1;1;0.0;0.0
29;2021-01-01;3;0;4;1;0.0;0.0
29;2021-01-02;2;0;6;1;0.0;0.0
29;2021-01-03;1;0;7;1;0.0;0.0
29;2021-01-04;33;0;40;1;0.0;0.0
29;2021-01-05;32;0;72;1;0.0;0.0
29;2021-01-06;43;0;115;1;0.0;0.0
29;2021-01-07;139;0;254;1;0.0;0.0
29;2021-01-08;408;1;662;2;0.1;0.0
29;2021-01-09;2;0;664;2;0.1;0.0
29;2021-01-10;2;0;666;2;0.1;0.0
29;2021-01-11;668;0;1334;2;0.1;0.0
29;2021-01-12;1121;0;2455;2;0.3;0.0
29;2021-01-13;1101;2;3556;4;0.4;0.0
29;2021-01-14;895;4;4451;8;0.5;0.0
29;2021-01-15;1222;7;5673;15;0.6;0.0
29;2021-01-16;168;1;5841;16;0.6;0.0
29;2021-01-17;111;1;5952;17;0.7;0.0
29;2021-01-18;842;6;6794;23;0.7;0.0
29;2021-01-19;1314;3;8108;26;0.9;0.0
29;2021-01-20;2393;3;10501;29;1.2;0.0
29;2021-01-21;5662;16;16163;45;1.8;0.0
29;2021-01-22;3809;8;19972;53;2.2;0.0
29;2021-01-23;539;0;20511;53;2.3;0.0
29;2021-01-24;200;1;20711;54;2.3;0.0
29;2021-01-25;573;7;21284;61;2.3;0.0
29;2021-01-26;951;34;22235;95;2.5;0.0
29;2021-01-27;1286;53;23521;148;2.6;0.0
29;2021-01-28;803;137;24324;285;2.7;0.0
29;2021-01-29;780;205;25104;490;2.8;0.1
29;2021-01-30;282;4;25386;494;2.8;0.1
29;2021-01-31;80;5;25466;499;2.8;0.1
29;2021-02-01;429;448;25895;947;2.9;0.1
29;2021-02-02;879;825;26774;1772;3.0;0.2
29;2021-02-03;810;895;27584;2667;3.0;0.3
29;2021-02-04;870;644;28454;3311;3.1;0.4
29;2021-02-05;676;584;29130;3895;3.2;0.4
29;2021-02-06;250;104;29380;3999;3.2;0.4
29;2021-02-07;78;104;29458;4103;3.2;0.5
29;2021-02-08;384;445;29842;4548;3.3;0.5
29;2021-02-09;864;852;30706;5400;3.4;0.6
29;2021-02-10;1150;1017;31856;6417;3.5;0.7
29;2021-02-11;1802;4163;33658;10580;3.7;1.2
29;2021-02-12;2328;2502;35986;13082;4.0;1.4
29;2021-02-13;639;413;36625;13495;4.0;1.5
29;2021-02-14;12;228;36637;13723;4.0;1.5
29;2021-02-15;268;945;36905;14668;4.1;1.6
29;2021-02-16;887;1054;37792;15722;4.2;1.7
29;2021-02-17;800;852;38592;16574;4.3;1.8
29;2021-02-18;1530;844;40122;17418;4.4;1.9
29;2021-02-19;1417;1008;41539;18426;4.6;2.0
29;2021-02-20;204;366;41743;18792;4.6;2.1
29;2021-02-21;163;167;41906;18959;4.6;2.1
29;2021-02-22;773;560;42679;19519;4.7;2.2
29;2021-02-23;1270;905;43949;20424;4.8;2.3
29;2021-02-24;1472;826;45421;21250;5.0;2.3
29;2021-02-25;2511;909;47932;22159;5.3;2.4
29;2021-02-26;2679;716;50611;22875;5.6;2.5
29;2021-02-27;1285;280;51896;23155;5.7;2.6
29;2021-02-28;200;73;52096;23228;5.7;2.6
29;2021-03-01;948;480;53044;23708;5.9;2.6
29;2021-03-02;1817;798;54861;24506;6.1;2.7
29;2021-03-03;2094;1021;56955;25527;6.3;2.8
29;2021-03-04;2843;1557;59798;27084;6.6;3.0
29;2021-03-05;3539;1685;63337;28769;7.0;3.2
29;2021-03-06;2000;441;65337;29210;7.2;3.2
29;2021-03-07;412;83;65749;29293;7.3;3.2
29;2021-03-08;1273;595;67022;29888;7.4;3.3
29;2021-03-09;2603;977;69625;30865;7.7;3.4
29;2021-03-10;2426;872;72051;31737;7.9;3.5
29;2021-03-11;4520;1006;76571;32743;8.4;3.6
29;2021-03-12;5272;973;81843;33716;9.0;3.7
29;2021-03-13;2825;414;84668;34130;9.3;3.8
29;2021-03-14;367;3;85035;34133;9.4;3.8
29;2021-03-15;2050;272;87085;34405;9.6;3.8
29;2021-03-16;1825;748;88910;35153;9.8;3.9
29;2021-03-17;1862;716;90772;35869;10.0;4.0
29;2021-03-18;1868;1038;92640;36907;10.2;4.1
29;2021-03-19;3270;885;95910;37792;10.6;4.2
29;2021-03-20;1914;225;97824;38017;10.8;4.2
29;2021-03-21;132;11;97956;38028;10.8;4.2
29;2021-03-22;1647;559;99603;38587;11.0;4.3
29;2021-03-23;3443;1042;103046;39629;11.4;4.4
29;2021-03-24;3781;1025;106827;40654;11.8;4.5
29;2021-03-25;4822;1078;111649;41732;12.3;4.6
29;2021-03-26;5423;1172;117072;42904;12.9;4.7
29;2021-03-27;2429;335;119501;43239;13.2;4.8
29;2021-03-28;198;50;119699;43289;13.2;4.8
29;2021-03-29;2042;825;121741;44114;13.4;4.9
29;2021-03-30;3976;1334;125717;45448;13.9;5.0
29;2021-03-31;3937;1162;129654;46610;14.3;5.1
29;2021-04-01;5028;1154;134682;47764;14.9;5.3
29;2021-04-02;4765;1172;139447;48936;15.4;5.4
29;2021-04-03;2500;538;141947;49474;15.7;5.5
29;2021-04-04;146;33;142093;49507;15.7;5.5
29;2021-04-05;972;333;143065;49840;15.8;5.5
29;2021-04-06;3198;1246;146263;51086;16.1;5.6
29;2021-04-07;3652;944;149915;52030;16.5;5.7
29;2021-04-08;5285;2059;155200;54089;17.1;6.0
29;2021-04-09;6760;1570;161960;55659;17.9;6.1
29;2021-04-10;3507;717;165467;56376;18.3;6.2
29;2021-04-11;120;80;165587;56456;18.3;6.2
29;2021-04-12;3853;1486;169440;57942;18.7;6.4
29;2021-04-13;5865;1764;175305;59706;19.3;6.6
29;2021-04-14;4761;1745;180066;61451;19.9;6.8
29;2021-04-15;7174;1734;187240;63185;20.7;7.0
29;2021-04-16;6703;1358;193943;64543;21.4;7.1
29;2021-04-17;3830;971;197773;65514;21.8;7.2
29;2021-04-18;489;41;198262;65555;21.9;7.2
29;2021-04-19;3881;1466;202143;67021;22.3;7.4
29;2021-04-20;4397;2137;206540;69158;22.8;7.6
29;2021-04-21;4379;2199;210919;71357;23.3;7.9
29;2021-04-22;6638;2857;217557;74214;24.0;8.2
29;2021-04-23;6050;2210;223607;76424;24.7;8.4
29;2021-04-24;4008;1323;227615;77747;25.1;8.6
29;2021-04-25;435;172;228050;77919;25.2;8.6
29;2021-04-26;5260;1880;233310;79799;25.7;8.8
29;2021-04-27;5336;3198;238646;82997;26.3;9.2
29;2021-04-28;5359;2913;244005;85910;26.9;9.5
29;2021-04-29;6594;3353;250599;89263;27.6;9.8
29;2021-04-30;6265;3909;256864;93172;28.3;10.3
29;2021-05-01;1986;981;258850;94153;28.6;10.4
29;2021-05-02;1249;196;260099;94349;28.7;10.4
29;2021-05-03;4539;2293;264638;96642;29.2;10.7
29;2021-05-04;4107;3741;268745;100383;29.6;11.1
29;2021-05-05;4526;3414;273271;103797;30.1;11.4
29;2021-05-06;6239;3727;279510;107524;30.8;11.9
29;2021-05-07;5985;4624;285495;112148;31.5;12.4
29;2021-05-08;2097;564;287592;112712;31.7;12.4
29;2021-05-09;1731;141;289323;112853;31.9;12.4
29;2021-05-10;4767;3770;294090;116623;32.4;12.9
29;2021-05-11;4708;4999;298798;121622;33.0;13.4
29;2021-05-12;5023;4381;303821;126003;33.5;13.9
29;2021-05-13;3441;1500;307262;127503;33.9;14.1
29;2021-05-14;5649;4001;312911;131504;34.5;14.5
29;2021-05-15;4049;2312;316960;133816;35.0;14.8
29;2021-05-16;1588;294;318548;134110;35.1;14.8
29;2021-05-17;5562;3130;324110;137240;35.8;15.1
29;2021-05-18;5732;3097;329842;140337;36.4;15.5
29;2021-05-19;6214;2970;336056;143307;37.1;15.8
29;2021-05-20;7172;4568;343228;147875;37.9;16.3
29;2021-05-21;7211;3814;350439;151689;38.7;16.7
29;2021-05-22;5343;2128;355782;153817;39.2;17.0
29;2021-05-23;1631;65;357413;153882;39.4;17.0
29;2021-05-24;3485;534;360898;154416;39.8;17.0
29;2021-05-25;5835;3043;366733;157459;40.5;17.4
29;2021-05-26;5889;2996;372622;160455;41.1;17.7
29;2021-05-27;6825;3987;379447;164442;41.9;18.1
29;2021-05-28;6544;4448;385991;168890;42.6;18.6
29;2021-05-29;4382;2808;390373;171698;43.1;18.9
29;2021-05-30;1113;360;391486;172058;43.2;19.0
29;2021-05-31;6384;3459;397870;175517;43.9;19.4
29;2021-06-01;6603;4351;404473;179868;44.6;19.8
29;2021-06-02;6162;4132;410635;184000;45.3;20.3
29;2021-06-03;7689;4525;418324;188525;46.1;20.8
29;2021-06-04;6812;6164;425136;194689;46.9;21.5
29;2021-06-05;5350;3037;430486;197726;47.5;21.8
29;2021-06-06;1284;538;431770;198264;47.6;21.9
29;2021-06-07;4659;5564;436429;203828;48.1;22.5
29;2021-06-08;7171;5210;443600;209038;48.9;23.1
29;2021-06-09;6404;4753;450004;213791;49.6;23.6
29;2021-06-10;7775;5063;457779;218854;50.5;24.1
29;2021-06-11;8473;5875;466252;224729;51.4;24.8
29;2021-06-12;6562;2816;472814;227545;52.2;25.1
29;2021-06-13;2351;1372;475165;228917;52.4;25.3
29;2021-06-14;4034;6320;479199;235237;52.9;25.9
29;2021-06-15;5477;6181;484676;241418;53.5;26.6
29;2021-06-16;5570;5630;490246;247048;54.1;27.3
29;2021-06-17;6370;6319;496616;253367;54.8;27.9
29;2021-06-18;6116;7492;502732;260859;55.5;28.8
29;2021-06-19;4619;3527;507351;264386;56.0;29.2
29;2021-06-20;891;1452;508242;265838;56.1;29.3
29;2021-06-21;3761;6495;512003;272333;56.5;30.0
29;2021-06-22;4490;6425;516493;278758;57.0;30.7
29;2021-06-23;4673;6132;521166;284890;57.5;31.4
29;2021-06-24;4810;6746;525976;291636;58.0;32.2
29;2021-06-25;3600;7533;529576;299169;58.4;33.0
29;2021-06-26;2132;4093;531708;303262;58.7;33.5
29;2021-06-27;967;1631;532675;304893;58.8;33.6
29;2021-06-28;2844;6862;535519;311755;59.1;34.4
29;2021-06-29;2813;7731;538332;319486;59.4;35.2
29;2021-06-30;3048;7510;541380;326996;59.7;36.1
29;2021-07-01;3792;8426;545172;335422;60.1;37.0
29;2021-07-02;3608;9669;548780;345091;60.5;38.1
29;2021-07-03;2327;6053;551107;351144;60.8;38.7
29;2021-07-04;814;1771;551921;352915;60.9;38.9
29;2021-07-05;1914;7156;553835;360071;61.1;39.7
29;2021-07-06;1543;8006;555378;368077;61.3;40.6
29;2021-07-07;1707;7039;557085;375116;61.5;41.4
29;2021-07-08;2454;8208;559539;383324;61.7;42.3
29;2021-07-09;2627;9069;562166;392393;62.0;43.3
29;2021-07-10;1917;6104;564083;398497;62.2;44.0
29;2021-07-11;449;1064;564532;399561;62.3;44.1
29;2021-07-12;1982;8375;566514;407936;62.5;45.0
29;2021-07-13;2755;8665;569269;416601;62.8;46.0
29;2021-07-14;2086;3372;571355;419973;63.0;46.3
29;2021-07-15;3859;9734;575214;429707;63.5;47.4
29;2021-07-16;4621;9199;579835;438906;64.0;48.4
29;2021-07-17;3223;6117;583058;445023;64.3;49.1
29;2021-07-18;668;1079;583726;446102;64.4;49.2
29;2021-07-19;3157;7545;586883;453647;64.7;50.0
29;2021-07-20;3556;9434;590439;463081;65.1;51.1
29;2021-07-21;3664;7711;594103;470792;65.5;51.9
29;2021-07-22;3429;8538;597532;479330;65.9;52.9
29;2021-07-23;4066;10707;601598;490037;66.4;54.1
29;2021-07-24;2536;5957;604134;495994;66.6;54.7
29;2021-07-25;655;2359;604789;498353;66.7;55.0
29;2021-07-26;3400;7282;608189;505635;67.1;55.8
29;2021-07-27;3721;7112;611910;512747;67.5;56.6
29;2021-07-28;4210;6036;616120;518783;68.0;57.2
29;2021-07-29;5706;6365;621826;525148;68.6;57.9
29;2021-07-30;5473;6538;627299;531686;69.2;58.6
29;2021-07-31;2939;4932;630238;536618;69.5;59.2
29;2021-08-01;659;921;630897;537539;69.6;59.3
29;2021-08-02;4309;5221;635206;542760;70.1;59.9
29;2021-08-03;5490;4410;640696;547170;70.7;60.4
29;2021-08-04;5744;3610;646440;550780;71.3;60.8
29;2021-08-05;6655;4111;653095;554891;72.0;61.2
29;2021-08-06;6217;4336;659312;559227;72.7;61.7
29;2021-08-07;4294;2960;663606;562187;73.2;62.0
29;2021-08-08;855;754;664461;562941;73.3;62.1
29;2021-08-09;3084;4741;667545;567682;73.6;62.6
29;2021-08-10;4494;3865;672039;571547;74.1;63.0
29;2021-08-11;3976;3189;676015;574736;74.6;63.4
29;2021-08-12;4652;4501;680667;579237;75.1;63.9
29;2021-08-13;4239;3720;684906;582957;75.6;64.3
29;2021-08-14;2968;2845;687874;585802;75.9;64.6
29;2021-08-15;338;405;688212;586207;75.9;64.7
29;2021-08-16;3289;4375;691501;590582;76.3;65.1
29;2021-08-17;4411;3421;695912;594003;76.8;65.5
29;2021-08-18;3686;3620;699598;597623;77.2;65.9
29;2021-08-19;3916;4719;703514;602342;77.6;66.4
29;2021-08-20;3512;4600;707026;606942;78.0;67.0
29;2021-08-21;2277;3164;709303;610106;78.2;67.3
29;2021-08-22;218;415;709521;610521;78.3;67.3
29;2021-08-23;2505;4627;712026;615148;78.5;67.9
29;2021-08-24;2468;4954;714494;620102;78.8;68.4
29;2021-08-25;2170;4230;716664;624332;79.1;68.9
29;2021-08-26;2362;5341;719026;629673;79.3;69.5
29;2021-08-27;2066;5914;721092;635587;79.5;70.1
29;2021-08-28;1475;4001;722567;639588;79.7;70.6
29;2021-08-29;453;1318;723020;640906;79.8;70.7
29;2021-08-30;1457;4158;724477;645064;79.9;71.2
29;2021-08-31;1631;4405;726108;649469;80.1;71.6
29;2021-09-01;1343;3756;727451;653225;80.2;72.1
29;2021-09-02;1176;4059;728627;657284;80.4;72.5
29;2021-09-03;1443;4765;730070;662049;80.5;73.0
29;2021-09-04;1419;3775;731489;665824;80.7;73.4
29;2021-09-05;228;687;731717;666511;80.7;73.5
29;2021-09-06;741;3351;732458;669862;80.8;73.9
29;2021-09-07;931;3448;733389;673310;80.9;74.3
29;2021-09-08;913;3435;734302;676745;81.0;74.7
29;2021-09-09;965;3459;735267;680204;81.1;75.0
29;2021-09-10;1200;4375;736467;684579;81.2;75.5
29;2021-09-11;734;3452;737201;688031;81.3;75.9
29;2021-09-12;117;410;737318;688441;81.3;75.9
29;2021-09-13;840;3235;738158;691676;81.4;76.3
29;2021-09-14;736;3010;738894;694686;81.5;76.6
29;2021-09-15;717;3226;739611;697912;81.6;77.0
29;2021-09-16;842;2789;740453;700701;81.7;77.3
29;2021-09-17;933;3243;741386;703944;81.8;77.7
29;2021-09-18;598;3449;741984;707393;81.8;78.0
29;2021-09-19;85;443;742069;707836;81.9;78.1
29;2021-09-20;492;2170;742561;710006;81.9;78.3
29;2021-09-21;474;1918;743035;711924;82.0;78.5
29;2021-09-22;365;2241;743400;714165;82.0;78.8
29;2021-09-23;467;1755;743867;715920;82.1;79.0
29;2021-09-24;485;2230;744352;718150;82.1;79.2
29;2021-09-25;340;2734;744692;720884;82.1;79.5
29;2021-09-26;56;239;744748;721123;82.2;79.5
29;2021-09-27;328;1639;745076;722762;82.2;79.7
29;2021-09-28;264;1567;745340;724329;82.2;79.9
29;2021-09-29;399;1678;745739;726007;82.3;80.1
29;2021-09-30;321;1327;746060;727334;82.3;80.2
29;2021-10-01;460;1536;746520;728870;82.3;80.4
29;2021-10-02;359;1675;746879;730545;82.4;80.6
29;2021-10-03;7;30;746886;730575;82.4;80.6
29;2021-10-04;298;1318;747184;731893;82.4;80.7
29;2021-10-05;240;1066;747424;732959;82.4;80.9
29;2021-10-06;302;1176;747726;734135;82.5;81.0
29;2021-10-07;315;916;748041;735051;82.5;81.1
29;2021-10-08;449;1268;748490;736319;82.6;81.2
29;2021-10-09;336;998;748826;737317;82.6;81.3
29;2021-10-10;5;12;748831;737329;82.6;81.3
29;2021-10-11;295;918;749126;738247;82.6;81.4
29;2021-10-12;241;605;749367;738852;82.7;81.5
29;2021-10-13;293;772;749660;739624;82.7;81.6
29;2021-10-14;293;649;749953;740273;82.7;81.7
2A;2020-12-27;0;0;0;0;0.0;0.0
2A;2020-12-28;0;0;0;0;0.0;0.0
2A;2020-12-29;0;0;0;0;0.0;0.0
2A;2020-12-30;0;0;0;0;0.0;0.0
2A;2020-12-31;0;0;0;0;0.0;0.0
2A;2021-01-01;0;0;0;0;0.0;0.0
2A;2021-01-02;1;0;1;0;0.0;0.0
2A;2021-01-03;0;0;1;0;0.0;0.0
2A;2021-01-04;0;0;1;0;0.0;0.0
2A;2021-01-05;0;0;1;0;0.0;0.0
2A;2021-01-06;6;0;7;0;0.0;0.0
2A;2021-01-07;122;1;129;1;0.1;0.0
2A;2021-01-08;114;2;243;3;0.1;0.0
2A;2021-01-09;39;0;282;3;0.2;0.0
2A;2021-01-10;33;0;315;3;0.2;0.0
2A;2021-01-11;78;0;393;3;0.2;0.0
2A;2021-01-12;85;0;478;3;0.3;0.0
2A;2021-01-13;113;1;591;4;0.4;0.0
2A;2021-01-14;192;1;783;5;0.5;0.0
2A;2021-01-15;149;0;932;5;0.6;0.0
2A;2021-01-16;160;2;1092;7;0.7;0.0
2A;2021-01-17;86;1;1178;8;0.7;0.0
2A;2021-01-18;201;2;1379;10;0.8;0.0
2A;2021-01-19;488;5;1867;15;1.1;0.0
2A;2021-01-20;356;1;2223;16;1.4;0.0
2A;2021-01-21;453;1;2676;17;1.6;0.0
2A;2021-01-22;367;0;3043;17;1.9;0.0
2A;2021-01-23;183;0;3226;17;2.0;0.0
2A;2021-01-24;118;1;3344;18;2.1;0.0
2A;2021-01-25;215;0;3559;18;2.2;0.0
2A;2021-01-26;402;9;3961;27;2.4;0.0
2A;2021-01-27;325;7;4286;34;2.6;0.0
2A;2021-01-28;335;79;4621;113;2.8;0.1
2A;2021-01-29;342;63;4963;176;3.1;0.1
2A;2021-01-30;128;38;5091;214;3.1;0.1
2A;2021-01-31;92;12;5183;226;3.2;0.1
2A;2021-02-01;230;49;5413;275;3.3;0.2
2A;2021-02-02;288;118;5701;393;3.5;0.2
2A;2021-02-03;265;75;5966;468;3.7;0.3
2A;2021-02-04;256;123;6222;591;3.8;0.4
2A;2021-02-05;267;106;6489;697;4.0;0.4
2A;2021-02-06;121;60;6610;757;4.1;0.5
2A;2021-02-07;68;54;6678;811;4.1;0.5
2A;2021-02-08;92;210;6770;1021;4.2;0.6
2A;2021-02-09;128;302;6898;1323;4.2;0.8
2A;2021-02-10;167;237;7065;1560;4.3;1.0
2A;2021-02-11;299;363;7364;1923;4.5;1.2
2A;2021-02-12;346;302;7710;2225;4.7;1.4
2A;2021-02-13;225;60;7935;2285;4.9;1.4
2A;2021-02-14;135;79;8070;2364;5.0;1.5
2A;2021-02-15;198;182;8268;2546;5.1;1.6
2A;2021-02-16;384;320;8652;2866;5.3;1.8
2A;2021-02-17;298;168;8950;3034;5.5;1.9
2A;2021-02-18;340;199;9290;3233;5.7;2.0
2A;2021-02-19;145;298;9435;3531;5.8;2.2
2A;2021-02-20;243;138;9678;3669;6.0;2.3
2A;2021-02-21;58;54;9736;3723;6.0;2.3
2A;2021-02-22;77;215;9813;3938;6.0;2.4
2A;2021-02-23;122;289;9935;4227;6.1;2.6
2A;2021-02-24;82;297;10017;4524;6.2;2.8
2A;2021-02-25;104;265;10121;4789;6.2;2.9
2A;2021-02-26;123;272;10244;5061;6.3;3.1
2A;2021-02-27;308;70;10552;5131;6.5;3.2
2A;2021-02-28;69;66;10621;5197;6.5;3.2
2A;2021-03-01;117;152;10738;5349;6.6;3.3
2A;2021-03-02;199;265;10937;5614;6.7;3.5
2A;2021-03-03;249;258;11186;5872;6.9;3.6
2A;2021-03-04;508;227;11694;6099;7.2;3.8
2A;2021-03-05;973;291;12667;6390;7.8;3.9
2A;2021-03-06;1166;75;13833;6465;8.5;4.0
2A;2021-03-07;1021;48;14854;6513;9.1;4.0
2A;2021-03-08;933;93;15787;6606;9.7;4.1
2A;2021-03-09;938;153;16725;6759;10.3;4.2
2A;2021-03-10;636;141;17361;6900;10.7;4.2
2A;2021-03-11;723;281;18084;7181;11.1;4.4
2A;2021-03-12;562;318;18646;7499;11.5;4.6
2A;2021-03-13;613;199;19259;7698;11.9;4.7
2A;2021-03-14;312;126;19571;7824;12.0;4.8
2A;2021-03-15;377;204;19948;8028;12.3;4.9
2A;2021-03-16;498;371;20446;8399;12.6;5.2
2A;2021-03-17;703;278;21149;8677;13.0;5.3
2A;2021-03-18;447;304;21596;8981;13.3;5.5
2A;2021-03-19;489;160;22085;9141;13.6;5.6
2A;2021-03-20;1079;265;23164;9406;14.3;5.8
2A;2021-03-21;695;54;23859;9460;14.7;5.8
2A;2021-03-22;347;68;24206;9528;14.9;5.9
2A;2021-03-23;519;59;24725;9587;15.2;5.9
2A;2021-03-24;864;92;25589;9679;15.8;6.0
2A;2021-03-25;930;142;26519;9821;16.3;6.0
2A;2021-03-26;1080;166;27599;9987;17.0;6.1
2A;2021-03-27;1189;201;28788;10188;17.7;6.3
2A;2021-03-28;241;97;29029;10285;17.9;6.3
2A;2021-03-29;283;138;29312;10423;18.0;6.4
2A;2021-03-30;384;238;29696;10661;18.3;6.6
2A;2021-03-31;445;226;30141;10887;18.6;6.7
2A;2021-04-01;638;453;30779;11340;19.0;7.0
2A;2021-04-02;904;787;31683;12127;19.5;7.5
2A;2021-04-03;644;982;32327;13109;19.9;8.1
2A;2021-04-04;578;785;32905;13894;20.3;8.6
2A;2021-04-05;525;700;33430;14594;20.6;9.0
2A;2021-04-06;548;561;33978;15155;20.9;9.3
2A;2021-04-07;795;429;34773;15584;21.4;9.6
2A;2021-04-08;1047;358;35820;15942;22.1;9.8
2A;2021-04-09;935;399;36755;16341;22.6;10.1
2A;2021-04-10;1058;384;37813;16725;23.3;10.3
2A;2021-04-11;362;256;38175;16981;23.5;10.5
2A;2021-04-12;671;343;38846;17324;23.9;10.7
2A;2021-04-13;329;381;39175;17705;24.1;10.9
2A;2021-04-14;1045;591;40220;18296;24.8;11.3
2A;2021-04-15;1044;529;41264;18825;25.4;11.6
2A;2021-04-16;872;394;42136;19219;25.9;11.8
2A;2021-04-17;1368;938;43504;20157;26.8;12.4
2A;2021-04-18;981;949;44485;21106;27.4;13.0
2A;2021-04-19;270;343;44755;21449;27.6;13.2
2A;2021-04-20;354;344;45109;21793;27.8;13.4
2A;2021-04-21;729;736;45838;22529;28.2;13.9
2A;2021-04-22;897;649;46735;23178;28.8;14.3
2A;2021-04-23;986;779;47721;23957;29.4;14.7
2A;2021-04-24;1750;985;49471;24942;30.5;15.4
2A;2021-04-25;976;306;50447;25248;31.1;15.5
2A;2021-04-26;308;228;50755;25476;31.2;15.7
2A;2021-04-27;342;349;51097;25825;31.5;15.9
2A;2021-04-28;1676;426;52773;26251;32.5;16.2
2A;2021-04-29;1053;361;53826;26612;33.1;16.4
2A;2021-04-30;1131;1063;54957;27675;33.8;17.0
2A;2021-05-01;970;575;55927;28250;34.4;17.4
2A;2021-05-02;674;708;56601;28958;34.8;17.8
2A;2021-05-03;583;576;57184;29534;35.2;18.2
2A;2021-05-04;752;536;57936;30070;35.7;18.5
2A;2021-05-05;1011;985;58947;31055;36.3;19.1
2A;2021-05-06;904;911;59851;31966;36.8;19.7
2A;2021-05-07;1157;834;61008;32800;37.6;20.2
2A;2021-05-08;422;502;61430;33302;37.8;20.5
2A;2021-05-09;783;636;62213;33938;38.3;20.9
2A;2021-05-10;454;741;62667;34679;38.6;21.4
2A;2021-05-11;652;417;63319;35096;39.0;21.6
2A;2021-05-12;925;488;64244;35584;39.6;21.9
2A;2021-05-13;920;138;65164;35722;40.1;22.0
2A;2021-05-14;797;678;65961;36400;40.6;22.4
2A;2021-05-15;778;649;66739;37049;41.1;22.8
2A;2021-05-16;740;501;67479;37550;41.5;23.1
2A;2021-05-17;584;558;68063;38108;41.9;23.5
2A;2021-05-18;614;475;68677;38583;42.3;23.8
2A;2021-05-19;787;481;69464;39064;42.8;24.1
2A;2021-05-20;692;539;70156;39603;43.2;24.4
2A;2021-05-21;536;483;70692;40086;43.5;24.7
2A;2021-05-22;440;310;71132;40396;43.8;24.9
2A;2021-05-23;533;284;71665;40680;44.1;25.0
2A;2021-05-24;125;33;71790;40713;44.2;25.1
2A;2021-05-25;421;503;72211;41216;44.5;25.4
2A;2021-05-26;425;1166;72636;42382;44.7;26.1
2A;2021-05-27;435;1111;73071;43493;45.0;26.8
2A;2021-05-28;298;915;73369;44408;45.2;27.3
2A;2021-05-29;334;900;73703;45308;45.4;27.9
2A;2021-05-30;181;507;73884;45815;45.5;28.2
2A;2021-05-31;191;413;74075;46228;45.6;28.5
2A;2021-06-01;342;727;74417;46955;45.8;28.9
2A;2021-06-02;285;940;74702;47895;46.0;29.5
2A;2021-06-03;306;850;75008;48745;46.2;30.0
2A;2021-06-04;271;1091;75279;49836;46.3;30.7
2A;2021-06-05;319;1443;75598;51279;46.5;31.6
2A;2021-06-06;173;907;75771;52186;46.7;32.1
2A;2021-06-07;171;658;75942;52844;46.8;32.5
2A;2021-06-08;324;706;76266;53550;47.0;33.0
2A;2021-06-09;304;1320;76570;54870;47.1;33.8
2A;2021-06-10;329;857;76899;55727;47.3;34.3
2A;2021-06-11;277;1021;77176;56748;47.5;34.9
2A;2021-06-12;232;665;77408;57413;47.7;35.3
2A;2021-06-13;189;797;77597;58210;47.8;35.8
2A;2021-06-14;251;922;77848;59132;47.9;36.4
2A;2021-06-15;217;507;78065;59639;48.1;36.7
2A;2021-06-16;213;776;78278;60415;48.2;37.2
2A;2021-06-17;235;591;78513;61006;48.3;37.6
2A;2021-06-18;246;912;78759;61918;48.5;38.1
2A;2021-06-19;208;689;78967;62607;48.6;38.5
2A;2021-06-20;150;692;79117;63299;48.7;39.0
2A;2021-06-21;184;795;79301;64094;48.8;39.5
2A;2021-06-22;236;841;79537;64935;49.0;40.0
2A;2021-06-23;217;568;79754;65503;49.1;40.3
2A;2021-06-24;149;369;79903;65872;49.2;40.6
2A;2021-06-25;167;470;80070;66342;49.3;40.8
2A;2021-06-26;203;872;80273;67214;49.4;41.4
2A;2021-06-27;175;794;80448;68008;49.5;41.9
2A;2021-06-28;194;704;80642;68712;49.6;42.3
2A;2021-06-29;216;689;80858;69401;49.8;42.7
2A;2021-06-30;245;494;81103;69895;49.9;43.0
2A;2021-07-01;211;484;81314;70379;50.1;43.3
2A;2021-07-02;294;368;81608;70747;50.2;43.6
2A;2021-07-03;211;617;81819;71364;50.4;43.9
2A;2021-07-04;179;664;81998;72028;50.5;44.3
2A;2021-07-05;164;235;82162;72263;50.6;44.5
2A;2021-07-06;252;389;82414;72652;50.7;44.7
2A;2021-07-07;433;611;82847;73263;51.0;45.1
2A;2021-07-08;592;705;83439;73968;51.4;45.5
2A;2021-07-09;384;420;83823;74388;51.6;45.8
2A;2021-07-10;281;346;84104;74734;51.8;46.0
2A;2021-07-11;92;161;84196;74895;51.8;46.1
2A;2021-07-12;317;348;84513;75243;52.0;46.3
2A;2021-07-13;1178;535;85691;75778;52.8;46.7
2A;2021-07-14;1623;342;87314;76120;53.8;46.9
2A;2021-07-15;1436;836;88750;76956;54.6;47.4
2A;2021-07-16;1168;467;89918;77423;55.4;47.7
2A;2021-07-17;1096;348;91014;77771;56.0;47.9
2A;2021-07-18;635;136;91649;77907;56.4;48.0
2A;2021-07-19;918;430;92567;78337;57.0;48.2
2A;2021-07-20;1283;475;93850;78812;57.8;48.5
2A;2021-07-21;1426;725;95276;79537;58.7;49.0
2A;2021-07-22;1401;767;96677;80304;59.5;49.4
2A;2021-07-23;1439;463;98116;80767;60.4;49.7
2A;2021-07-24;896;290;99012;81057;61.0;49.9
2A;2021-07-25;451;81;99463;81138;61.2;50.0
2A;2021-07-26;1198;507;100661;81645;62.0;50.3
2A;2021-07-27;1297;520;101958;82165;62.8;50.6
2A;2021-07-28;1199;593;103157;82758;63.5;51.0
2A;2021-07-29;1230;657;104387;83415;64.3;51.4
2A;2021-07-30;961;610;105348;84025;64.9;51.7
2A;2021-07-31;548;340;105896;84365;65.2;51.9
2A;2021-08-01;570;124;106466;84489;65.5;52.0
2A;2021-08-02;451;494;106917;84983;65.8;52.3
2A;2021-08-03;814;881;107731;85864;66.3;52.9
2A;2021-08-04;724;1161;108455;87025;66.8;53.6
2A;2021-08-05;956;1348;109411;88373;67.4;54.4
2A;2021-08-06;390;815;109801;89188;67.6;54.9
2A;2021-08-07;352;888;110153;90076;67.8;55.5
2A;2021-08-08;78;185;110231;90261;67.9;55.6
2A;2021-08-09;663;1142;110894;91403;68.3;56.3
2A;2021-08-10;642;1209;111536;92612;68.7;57.0
2A;2021-08-11;593;1064;112129;93676;69.0;57.7
2A;2021-08-12;742;1491;112871;95167;69.5;58.6
2A;2021-08-13;486;1066;113357;96233;69.8;59.2
2A;2021-08-14;414;766;113771;96999;70.0;59.7
2A;2021-08-15;27;26;113798;97025;70.1;59.7
2A;2021-08-16;481;1292;114279;98317;70.4;60.5
2A;2021-08-17;940;1557;115219;99874;70.9;61.5
2A;2021-08-18;525;1123;115744;100997;71.3;62.2
2A;2021-08-19;431;1010;116175;102007;71.5;62.8
2A;2021-08-20;328;574;116503;102581;71.7;63.2
2A;2021-08-21;240;535;116743;103116;71.9;63.5
2A;2021-08-22;197;617;116940;103733;72.0;63.9
2A;2021-08-23;325;744;117265;104477;72.2;64.3
2A;2021-08-24;326;858;117591;105335;72.4;64.9
2A;2021-08-25;401;881;117992;106216;72.6;65.4
2A;2021-08-26;342;769;118334;106985;72.9;65.9
2A;2021-08-27;245;716;118579;107701;73.0;66.3
2A;2021-08-28;256;352;118835;108053;73.2;66.5
2A;2021-08-29;97;116;118932;108169;73.2;66.6
2A;2021-08-30;244;605;119176;108774;73.4;67.0
2A;2021-08-31;172;493;119348;109267;73.5;67.3
2A;2021-09-01;344;758;119692;110025;73.7;67.7
2A;2021-09-02;314;610;120006;110635;73.9;68.1
2A;2021-09-03;243;457;120249;111092;74.0;68.4
2A;2021-09-04;151;406;120400;111498;74.1;68.6
2A;2021-09-05;29;23;120429;111521;74.1;68.7
2A;2021-09-06;111;342;120540;111863;74.2;68.9
2A;2021-09-07;191;630;120731;112493;74.3;69.3
2A;2021-09-08;221;651;120952;113144;74.5;69.7
2A;2021-09-09;211;461;121163;113605;74.6;69.9
2A;2021-09-10;155;344;121318;113949;74.7;70.2
2A;2021-09-11;135;282;121453;114231;74.8;70.3
2A;2021-09-12;42;82;121495;114313;74.8;70.4
2A;2021-09-13;102;181;121597;114494;74.9;70.5
2A;2021-09-14;227;232;121824;114726;75.0;70.6
2A;2021-09-15;191;542;122015;115268;75.1;71.0
2A;2021-09-16;215;366;122230;115634;75.3;71.2
2A;2021-09-17;134;176;122364;115810;75.3;71.3
2A;2021-09-18;104;302;122468;116112;75.4;71.5
2A;2021-09-19;10;49;122478;116161;75.4;71.5
2A;2021-09-20;37;130;122515;116291;75.4;71.6
2A;2021-09-21;89;246;122604;116537;75.5;71.7
2A;2021-09-22;100;448;122704;116985;75.5;72.0
2A;2021-09-23;90;325;122794;117310;75.6;72.2
2A;2021-09-24;59;259;122853;117569;75.6;72.4
2A;2021-09-25;63;143;122916;117712;75.7;72.5
2A;2021-09-26;10;29;122926;117741;75.7;72.5
2A;2021-09-27;43;104;122969;117845;75.7;72.6
2A;2021-09-28;102;172;123071;118017;75.8;72.7
2A;2021-09-29;108;297;123179;118314;75.8;72.8
2A;2021-09-30;74;209;123253;118523;75.9;73.0
2A;2021-10-01;81;119;123334;118642;75.9;73.0
2A;2021-10-02;78;137;123412;118779;76.0;73.1
2A;2021-10-03;18;33;123430;118812;76.0;73.2
2A;2021-10-04;44;81;123474;118893;76.0;73.2
2A;2021-10-05;38;114;123512;119007;76.0;73.3
2A;2021-10-06;56;119;123568;119126;76.1;73.3
2A;2021-10-07;56;111;123624;119237;76.1;73.4
2A;2021-10-08;51;135;123675;119372;76.1;73.5
2A;2021-10-09;78;263;123753;119635;76.2;73.7
2A;2021-10-10;71;80;123824;119715;76.2;73.7
2A;2021-10-11;33;68;123857;119783;76.3;73.7
2A;2021-10-12;34;57;123891;119840;76.3;73.8
2A;2021-10-13;54;118;123945;119958;76.3;73.9
2A;2021-10-14;72;133;124017;120091;76.4;73.9
2B;2020-12-27;0;0;0;0;0.0;0.0
2B;2020-12-28;0;0;0;0;0.0;0.0
2B;2020-12-29;0;0;0;0;0.0;0.0
2B;2020-12-30;0;0;0;0;0.0;0.0
2B;2020-12-31;0;0;0;0;0.0;0.0
2B;2021-01-01;0;0;0;0;0.0;0.0
2B;2021-01-02;0;0;0;0;0.0;0.0
2B;2021-01-03;0;0;0;0;0.0;0.0
2B;2021-01-04;2;0;2;0;0.0;0.0
2B;2021-01-05;0;0;2;0;0.0;0.0
2B;2021-01-06;48;1;50;1;0.0;0.0
2B;2021-01-07;210;0;260;1;0.1;0.0
2B;2021-01-08;197;3;457;4;0.3;0.0
2B;2021-01-09;40;0;497;4;0.3;0.0
2B;2021-01-10;1;0;498;4;0.3;0.0
2B;2021-01-11;74;0;572;4;0.3;0.0
2B;2021-01-12;128;1;700;5;0.4;0.0
2B;2021-01-13;93;0;793;5;0.4;0.0
2B;2021-01-14;72;0;865;5;0.5;0.0
2B;2021-01-15;259;2;1124;7;0.6;0.0
2B;2021-01-16;44;0;1168;7;0.6;0.0
2B;2021-01-17;8;0;1176;7;0.6;0.0
2B;2021-01-18;271;1;1447;8;0.8;0.0
2B;2021-01-19;507;1;1954;9;1.1;0.0
2B;2021-01-20;462;3;2416;12;1.3;0.0
2B;2021-01-21;358;0;2774;12;1.5;0.0
2B;2021-01-22;382;1;3156;13;1.7;0.0
2B;2021-01-23;61;0;3217;13;1.8;0.0
2B;2021-01-24;29;0;3246;13;1.8;0.0
2B;2021-01-25;210;2;3456;15;1.9;0.0
2B;2021-01-26;392;1;3848;16;2.1;0.0
2B;2021-01-27;342;48;4190;64;2.3;0.0
2B;2021-01-28;365;146;4555;210;2.5;0.1
2B;2021-01-29;296;162;4851;372;2.7;0.2
2B;2021-01-30;80;33;4931;405;2.7;0.2
2B;2021-01-31;60;0;4991;405;2.7;0.2
2B;2021-02-01;233;94;5224;499;2.9;0.3
2B;2021-02-02;358;78;5582;577;3.1;0.3
2B;2021-02-03;520;91;6102;668;3.3;0.4
2B;2021-02-04;458;173;6560;841;3.6;0.5
2B;2021-02-05;395;95;6955;936;3.8;0.5
2B;2021-02-06;87;14;7042;950;3.9;0.5
2B;2021-02-07;60;0;7102;950;3.9;0.5
2B;2021-02-08;231;153;7333;1103;4.0;0.6
2B;2021-02-09;586;313;7919;1416;4.3;0.8
2B;2021-02-10;484;196;8403;1612;4.6;0.9
2B;2021-02-11;382;129;8785;1741;4.8;1.0
2B;2021-02-12;299;125;9084;1866;5.0;1.0
2B;2021-02-13;77;13;9161;1879;5.0;1.0
2B;2021-02-14;62;1;9223;1880;5.1;1.0
2B;2021-02-15;190;128;9413;2008;5.2;1.1
2B;2021-02-16;249;287;9662;2295;5.3;1.3
2B;2021-02-17;312;318;9974;2613;5.5;1.4
2B;2021-02-18;215;347;10189;2960;5.6;1.6
2B;2021-02-19;163;306;10352;3266;5.7;1.8
2B;2021-02-20;32;62;10384;3328;5.7;1.8
2B;2021-02-21;28;29;10412;3357;5.7;1.8
2B;2021-02-22;133;188;10545;3545;5.8;1.9
2B;2021-02-23;232;355;10777;3900;5.9;2.1
2B;2021-02-24;229;310;11006;4210;6.0;2.3
2B;2021-02-25;245;340;11251;4550;6.2;2.5
2B;2021-02-26;301;282;11552;4832;6.3;2.7
2B;2021-02-27;60;86;11612;4918;6.4;2.7
2B;2021-02-28;1;57;11613;4975;6.4;2.7
2B;2021-03-01;246;261;11859;5236;6.5;2.9
2B;2021-03-02;352;390;12211;5626;6.7;3.1
2B;2021-03-03;299;433;12510;6059;6.9;3.3
2B;2021-03-04;447;409;12957;6468;7.1;3.5
2B;2021-03-05;619;384;13576;6852;7.4;3.8
2B;2021-03-06;682;101;14258;6953;7.8;3.8
2B;2021-03-07;361;60;14619;7013;8.0;3.8
2B;2021-03-08;301;240;14920;7253;8.2;4.0
2B;2021-03-09;384;506;15304;7759;8.4;4.3
2B;2021-03-10;631;446;15935;8205;8.7;4.5
2B;2021-03-11;585;355;16520;8560;9.1;4.7
2B;2021-03-12;967;231;17487;8791;9.6;4.8
2B;2021-03-13;511;110;17998;8901;9.9;4.9
2B;2021-03-14;226;64;18224;8965;10.0;4.9
2B;2021-03-15;516;202;18740;9167;10.3;5.0
2B;2021-03-16;571;279;19311;9446;10.6;5.2
2B;2021-03-17;530;263;19841;9709;10.9;5.3
2B;2021-03-18;551;230;20392;9939;11.2;5.5
2B;2021-03-19;805;195;21197;10134;11.6;5.6
2B;2021-03-20;656;38;21853;10172;12.0;5.6
2B;2021-03-21;428;37;22281;10209;12.2;5.6
2B;2021-03-22;546;126;22827;10335;12.5;5.7
2B;2021-03-23;788;260;23615;10595;13.0;5.8
2B;2021-03-24;832;215;24447;10810;13.4;5.9
2B;2021-03-25;825;164;25272;10974;13.9;6.0
2B;2021-03-26;958;191;26230;11165;14.4;6.1
2B;2021-03-27;1092;40;27322;11205;15.0;6.1
2B;2021-03-28;830;126;28152;11331;15.4;6.2
2B;2021-03-29;745;181;28897;11512;15.9;6.3
2B;2021-03-30;971;333;29868;11845;16.4;6.5
2B;2021-03-31;981;266;30849;12111;16.9;6.6
2B;2021-04-01;1003;230;31852;12341;17.5;6.8
2B;2021-04-02;967;414;32819;12755;18.0;7.0
2B;2021-04-03;1247;154;34066;12909;18.7;7.1
2B;2021-04-04;197;61;34263;12970;18.8;7.1
2B;2021-04-05;109;113;34372;13083;18.9;7.2
2B;2021-04-06;1032;362;35404;13445;19.4;7.4
2B;2021-04-07;1231;431;36635;13876;20.1;7.6
2B;2021-04-08;1128;409;37763;14285;20.7;7.8
2B;2021-04-09;1166;568;38929;14853;21.4;8.1
2B;2021-04-10;1352;267;40281;15120;22.1;8.3
2B;2021-04-11;815;65;41096;15185;22.5;8.3
2B;2021-04-12;853;559;41949;15744;23.0;8.6
2B;2021-04-13;1064;632;43013;16376;23.6;9.0
2B;2021-04-14;1046;494;44059;16870;24.2;9.3
2B;2021-04-15;886;520;44945;17390;24.7;9.5
2B;2021-04-16;910;649;45855;18039;25.2;9.9
2B;2021-04-17;386;447;46241;18486;25.4;10.1
2B;2021-04-18;253;343;46494;18829;25.5;10.3
2B;2021-04-19;822;438;47316;19267;26.0;10.6
2B;2021-04-20;898;846;48214;20113;26.5;11.0
2B;2021-04-21;1055;610;49269;20723;27.0;11.4
2B;2021-04-22;937;734;50206;21457;27.5;11.8
2B;2021-04-23;662;630;50868;22087;27.9;12.1
2B;2021-04-24;288;772;51156;22859;28.1;12.5
2B;2021-04-25;285;477;51441;23336;28.2;12.8
2B;2021-04-26;708;921;52149;24257;28.6;13.3
2B;2021-04-27;966;876;53115;25133;29.1;13.8
2B;2021-04-28;918;865;54033;25998;29.6;14.3
2B;2021-04-29;925;873;54958;26871;30.2;14.7
2B;2021-04-30;1133;832;56091;27703;30.8;15.2
2B;2021-05-01;460;1116;56551;28819;31.0;15.8
2B;2021-05-02;335;245;56886;29064;31.2;15.9
2B;2021-05-03;1016;496;57902;29560;31.8;16.2
2B;2021-05-04;811;1154;58713;30714;32.2;16.9
2B;2021-05-05;800;1377;59513;32091;32.7;17.6
2B;2021-05-06;1285;905;60798;32996;33.4;18.1
2B;2021-05-07;1062;990;61860;33986;33.9;18.6
2B;2021-05-08;459;853;62319;34839;34.2;19.1
2B;2021-05-09;392;683;62711;35522;34.4;19.5
2B;2021-05-10;925;805;63636;36327;34.9;19.9
2B;2021-05-11;933;1163;64569;37490;35.4;20.6
2B;2021-05-12;859;893;65428;38383;35.9;21.1
2B;2021-05-13;1028;376;66456;38759;36.5;21.3
2B;2021-05-14;719;578;67175;39337;36.9;21.6
2B;2021-05-15;701;353;67876;39690;37.2;21.8
2B;2021-05-16;300;180;68176;39870;37.4;21.9
2B;2021-05-17;1004;406;69180;40276;38.0;22.1
2B;2021-05-18;990;382;70170;40658;38.5;22.3
2B;2021-05-19;773;416;70943;41074;38.9;22.5
2B;2021-05-20;668;359;71611;41433;39.3;22.7
2B;2021-05-21;707;502;72318;41935;39.7;23.0
2B;2021-05-22;576;392;72894;42327;40.0;23.2
2B;2021-05-23;170;46;73064;42373;40.1;23.2
2B;2021-05-24;40;115;73104;42488;40.1;23.3
2B;2021-05-25;548;354;73652;42842;40.4;23.5
2B;2021-05-26;545;787;74197;43629;40.7;23.9
2B;2021-05-27;407;1131;74604;44760;40.9;24.6
2B;2021-05-28;550;905;75154;45665;41.2;25.1
2B;2021-05-29;311;353;75465;46018;41.4;25.2
2B;2021-05-30;46;45;75511;46063;41.4;25.3
2B;2021-05-31;375;831;75886;46894;41.6;25.7
2B;2021-06-01;414;1037;76300;47931;41.9;26.3
2B;2021-06-02;363;988;76663;48919;42.1;26.8
2B;2021-06-03;498;806;77161;49725;42.3;27.3
2B;2021-06-04;343;1253;77504;50978;42.5;28.0
2B;2021-06-05;257;494;77761;51472;42.7;28.2
2B;2021-06-06;51;129;77812;51601;42.7;28.3
2B;2021-06-07;280;949;78092;52550;42.8;28.8
2B;2021-06-08;399;1167;78491;53717;43.1;29.5
2B;2021-06-09;519;1177;79010;54894;43.4;30.1
2B;2021-06-10;369;939;79379;55833;43.6;30.6
2B;2021-06-11;432;1275;79811;57108;43.8;31.3
2B;2021-06-12;152;545;79963;57653;43.9;31.6
2B;2021-06-13;27;59;79990;57712;43.9;31.7
2B;2021-06-14;195;1115;80185;58827;44.0;32.3
2B;2021-06-15;344;1217;80529;60044;44.2;32.9
2B;2021-06-16;383;935;80912;60979;44.4;33.5
2B;2021-06-17;402;1049;81314;62028;44.6;34.0
2B;2021-06-18;348;960;81662;62988;44.8;34.6
2B;2021-06-19;144;330;81806;63318;44.9;34.7
2B;2021-06-20;44;194;81850;63512;44.9;34.8
2B;2021-06-21;265;962;82115;64474;45.1;35.4
2B;2021-06-22;317;1115;82432;65589;45.2;36.0
2B;2021-06-23;209;871;82641;66460;45.3;36.5
2B;2021-06-24;337;758;82978;67218;45.5;36.9
2B;2021-06-25;210;1074;83188;68292;45.6;37.5
2B;2021-06-26;105;550;83293;68842;45.7;37.8
2B;2021-06-27;31;214;83324;69056;45.7;37.9
2B;2021-06-28;329;954;83653;70010;45.9;38.4
2B;2021-06-29;270;985;83923;70995;46.0;39.0
2B;2021-06-30;380;948;84303;71943;46.3;39.5
2B;2021-07-01;226;507;84529;72450;46.4;39.8
2B;2021-07-02;219;557;84748;73007;46.5;40.1
2B;2021-07-03;92;398;84840;73405;46.5;40.3
2B;2021-07-04;2;0;84842;73405;46.6;40.3
2B;2021-07-05;263;666;85105;74071;46.7;40.6
2B;2021-07-06;450;707;85555;74778;46.9;41.0
2B;2021-07-07;381;911;85936;75689;47.2;41.5
2B;2021-07-08;183;351;86119;76040;47.3;41.7
2B;2021-07-09;250;378;86369;76418;47.4;41.9
2B;2021-07-10;197;199;86566;76617;47.5;42.0
2B;2021-07-11;13;14;86579;76631;47.5;42.0
2B;2021-07-12;497;747;87076;77378;47.8;42.5
2B;2021-07-13;822;1021;87898;78399;48.2;43.0
2B;2021-07-14;344;100;88242;78499;48.4;43.1
2B;2021-07-15;1270;589;89512;79088;49.1;43.4
2B;2021-07-16;1120;564;90632;79652;49.7;43.7
2B;2021-07-17;710;318;91342;79970;50.1;43.9
2B;2021-07-18;179;49;91521;80019;50.2;43.9
2B;2021-07-19;857;708;92378;80727;50.7;44.3
2B;2021-07-20;1210;683;93588;81410;51.3;44.7
2B;2021-07-21;1396;726;94984;82136;52.1;45.1
2B;2021-07-22;1330;604;96314;82740;52.8;45.4
2B;2021-07-23;1330;503;97644;83243;53.6;45.7
2B;2021-07-24;534;315;98178;83558;53.9;45.8
2B;2021-07-25;203;71;98381;83629;54.0;45.9
2B;2021-07-26;913;634;99294;84263;54.5;46.2
2B;2021-07-27;1578;711;100872;84974;55.3;46.6
2B;2021-07-28;1177;633;102049;85607;56.0;47.0
2B;2021-07-29;1144;449;103193;86056;56.6;47.2
2B;2021-07-30;763;350;103956;86406;57.0;47.4
2B;2021-07-31;539;234;104495;86640;57.3;47.5
2B;2021-08-01;230;57;104725;86697;57.5;47.6
2B;2021-08-02;799;472;105524;87169;57.9;47.8
2B;2021-08-03;1138;786;106662;87955;58.5;48.3
2B;2021-08-04;810;454;107472;88409;59.0;48.5
2B;2021-08-05;1026;560;108498;88969;59.5;48.8
2B;2021-08-06;704;526;109202;89495;59.9;49.1
2B;2021-08-07;306;408;109508;89903;60.1;49.3
2B;2021-08-08;93;142;109601;90045;60.1;49.4
2B;2021-08-09;536;747;110137;90792;60.4;49.8
2B;2021-08-10;739;1133;110876;91925;60.8;50.4
2B;2021-08-11;753;902;111629;92827;61.2;50.9
2B;2021-08-12;692;1045;112321;93872;61.6;51.5
2B;2021-08-13;494;948;112815;94820;61.9;52.0
2B;2021-08-14;200;437;113015;95257;62.0;52.3
2B;2021-08-15;117;173;113132;95430;62.1;52.4
2B;2021-08-16;509;1063;113641;96493;62.4;52.9
2B;2021-08-17;587;1308;114228;97801;62.7;53.7
2B;2021-08-18;506;1193;114734;98994;63.0;54.3
2B;2021-08-19;434;900;115168;99894;63.2;54.8
2B;2021-08-20;369;813;115537;100707;63.4;55.3
2B;2021-08-21;158;474;115695;101181;63.5;55.5
2B;2021-08-22;79;208;115774;101389;63.5;55.6
2B;2021-08-23;376;945;116150;102334;63.7;56.1
2B;2021-08-24;498;1214;116648;103548;64.0;56.8
2B;2021-08-25;347;971;116995;104519;64.2;57.3
2B;2021-08-26;404;817;117399;105336;64.4;57.8
2B;2021-08-27;262;572;117661;105908;64.6;58.1
2B;2021-08-28;168;442;117829;106350;64.6;58.4
2B;2021-08-29;53;126;117882;106476;64.7;58.4
2B;2021-08-30;365;836;118247;107312;64.9;58.9
2B;2021-08-31;380;863;118627;108175;65.1;59.4
2B;2021-09-01;369;913;118996;109088;65.3;59.9
2B;2021-09-02;307;654;119303;109742;65.5;60.2
2B;2021-09-03;222;422;119525;110164;65.6;60.4
2B;2021-09-04;124;306;119649;110470;65.6;60.6
2B;2021-09-05;17;102;119666;110572;65.7;60.7
2B;2021-09-06;165;570;119831;111142;65.7;61.0
2B;2021-09-07;259;759;120090;111901;65.9;61.4
2B;2021-09-08;203;621;120293;112522;66.0;61.7
2B;2021-09-09;185;405;120478;112927;66.1;62.0
2B;2021-09-10;201;367;120679;113294;66.2;62.2
2B;2021-09-11;130;249;120809;113543;66.3;62.3
2B;2021-09-12;17;94;120826;113637;66.3;62.3
2B;2021-09-13;191;464;121017;114101;66.4;62.6
2B;2021-09-14;284;634;121301;114735;66.6;63.0
2B;2021-09-15;160;598;121461;115333;66.6;63.3
2B;2021-09-16;220;301;121681;115634;66.8;63.4
2B;2021-09-17;115;194;121796;115828;66.8;63.6
2B;2021-09-18;51;157;121847;115985;66.9;63.6
2B;2021-09-19;15;18;121862;116003;66.9;63.6
2B;2021-09-20;106;409;121968;116412;66.9;63.9
2B;2021-09-21;102;410;122070;116822;67.0;64.1
2B;2021-09-22;117;404;122187;117226;67.0;64.3
2B;2021-09-23;103;228;122290;117454;67.1;64.4
2B;2021-09-24;87;213;122377;117667;67.1;64.6
2B;2021-09-25;36;123;122413;117790;67.2;64.6
2B;2021-09-26;2;23;122415;117813;67.2;64.6
2B;2021-09-27;70;229;122485;118042;67.2;64.8
2B;2021-09-28;99;194;122584;118236;67.3;64.9
2B;2021-09-29;121;345;122705;118581;67.3;65.1
2B;2021-09-30;71;133;122776;118714;67.4;65.1
2B;2021-10-01;113;163;122889;118877;67.4;65.2
2B;2021-10-02;54;114;122943;118991;67.5;65.3
2B;2021-10-03;13;15;122956;119006;67.5;65.3
2B;2021-10-04;84;156;123040;119162;67.5;65.4
2B;2021-10-05;90;225;123130;119387;67.6;65.5
2B;2021-10-06;125;285;123255;119672;67.6;65.7
2B;2021-10-07;49;137;123304;119809;67.7;65.7
2B;2021-10-08;86;171;123390;119980;67.7;65.8
2B;2021-10-09;67;108;123457;120088;67.7;65.9
2B;2021-10-10;11;22;123468;120110;67.7;65.9
2B;2021-10-11;60;146;123528;120256;67.8;66.0
2B;2021-10-12;75;163;123603;120419;67.8;66.1
2B;2021-10-13;128;226;123731;120645;67.9;66.2
2B;2021-10-14;90;176;123821;120821;67.9;66.3
30;2020-12-27;3;0;3;0;0.0;0.0
30;2020-12-28;2;0;5;0;0.0;0.0
30;2020-12-29;0;0;5;0;0.0;0.0
30;2020-12-30;0;0;5;0;0.0;0.0
30;2020-12-31;0;0;5;0;0.0;0.0
30;2021-01-01;0;0;5;0;0.0;0.0
30;2021-01-02;0;0;5;0;0.0;0.0
30;2021-01-03;0;0;5;0;0.0;0.0
30;2021-01-04;0;0;5;0;0.0;0.0
30;2021-01-05;4;0;9;0;0.0;0.0
30;2021-01-06;128;0;137;0;0.0;0.0
30;2021-01-07;314;0;451;0;0.1;0.0
30;2021-01-08;532;2;983;2;0.1;0.0
30;2021-01-09;270;0;1253;2;0.2;0.0
30;2021-01-10;0;0;1253;2;0.2;0.0
30;2021-01-11;536;0;1789;2;0.2;0.0
30;2021-01-12;801;3;2590;5;0.3;0.0
30;2021-01-13;641;0;3231;5;0.4;0.0
30;2021-01-14;654;5;3885;10;0.5;0.0
30;2021-01-15;756;2;4641;12;0.6;0.0
30;2021-01-16;313;0;4954;12;0.7;0.0
30;2021-01-17;4;0;4958;12;0.7;0.0
30;2021-01-18;949;11;5907;23;0.8;0.0
30;2021-01-19;1735;6;7642;29;1.0;0.0
30;2021-01-20;1303;3;8945;32;1.2;0.0
30;2021-01-21;1230;3;10175;35;1.4;0.0
30;2021-01-22;1078;7;11253;42;1.5;0.0
30;2021-01-23;634;2;11887;44;1.6;0.0
30;2021-01-24;0;0;11887;44;1.6;0.0
30;2021-01-25;830;5;12717;49;1.7;0.0
30;2021-01-26;1060;17;13777;66;1.8;0.0
30;2021-01-27;983;110;14760;176;2.0;0.0
30;2021-01-28;714;272;15474;448;2.1;0.1
30;2021-01-29;671;440;16145;888;2.2;0.1
30;2021-01-30;473;285;16618;1173;2.2;0.2
30;2021-01-31;3;7;16621;1180;2.2;0.2
30;2021-02-01;816;441;17437;1621;2.3;0.2
30;2021-02-02;1875;683;19312;2304;2.6;0.3
30;2021-02-03;1185;486;20497;2790;2.7;0.4
30;2021-02-04;970;661;21467;3451;2.9;0.5
30;2021-02-05;599;762;22066;4213;2.9;0.6
30;2021-02-06;296;261;22362;4474;3.0;0.6
30;2021-02-07;3;9;22365;4483;3.0;0.6
30;2021-02-08;574;735;22939;5218;3.1;0.7
30;2021-02-09;986;1008;23925;6226;3.2;0.8
30;2021-02-10;985;1093;24910;7319;3.3;1.0
30;2021-02-11;929;1031;25839;8350;3.5;1.1
30;2021-02-12;619;997;26458;9347;3.5;1.2
30;2021-02-13;435;383;26893;9730;3.6;1.3
30;2021-02-14;3;23;26896;9753;3.6;1.3
30;2021-02-15;450;616;27346;10369;3.7;1.4
30;2021-02-16;460;847;27806;11216;3.7;1.5
30;2021-02-17;683;619;28489;11835;3.8;1.6
30;2021-02-18;799;527;29288;12362;3.9;1.7
30;2021-02-19;578;670;29866;13032;4.0;1.7
30;2021-02-20;224;228;30090;13260;4.0;1.8
30;2021-02-21;5;3;30095;13263;4.0;1.8
30;2021-02-22;502;764;30597;14027;4.1;1.9
30;2021-02-23;973;1467;31570;15494;4.2;2.1
30;2021-02-24;931;1196;32501;16690;4.3;2.2
30;2021-02-25;1211;893;33712;17583;4.5;2.3
30;2021-02-26;1336;599;35048;18182;4.7;2.4
30;2021-02-27;564;542;35612;18724;4.8;2.5
30;2021-02-28;6;7;35618;18731;4.8;2.5
30;2021-03-01;1343;830;36961;19561;4.9;2.6
30;2021-03-02;1716;915;38677;20476;5.2;2.7
30;2021-03-03;2311;769;40988;21245;5.5;2.8
30;2021-03-04;2638;879;43626;22124;5.8;3.0
30;2021-03-05;2766;622;46392;22746;6.2;3.0
30;2021-03-06;2998;370;49390;23116;6.6;3.1
30;2021-03-07;1862;50;51252;23166;6.8;3.1
30;2021-03-08;1556;789;52808;23955;7.1;3.2
30;2021-03-09;2277;873;55085;24828;7.4;3.3
30;2021-03-10;2360;663;57445;25491;7.7;3.4
30;2021-03-11;3053;710;60498;26201;8.1;3.5
30;2021-03-12;3114;404;63612;26605;8.5;3.6
30;2021-03-13;2227;298;65839;26903;8.8;3.6
30;2021-03-14;83;3;65922;26906;8.8;3.6
30;2021-03-15;1580;570;67502;27476;9.0;3.7
30;2021-03-16;1297;1072;68799;28548;9.2;3.8
30;2021-03-17;1456;650;70255;29198;9.4;3.9
30;2021-03-18;1647;716;71902;29914;9.6;4.0
30;2021-03-19;2250;553;74152;30467;9.9;4.1
30;2021-03-20;1400;149;75552;30616;10.1;4.1
30;2021-03-21;58;9;75610;30625;10.1;4.1
30;2021-03-22;2394;727;78004;31352;10.4;4.2
30;2021-03-23;3512;822;81516;32174;10.9;4.3
30;2021-03-24;3637;835;85153;33009;11.4;4.4
30;2021-03-25;4406;854;89559;33863;12.0;4.5
30;2021-03-26;4361;652;93920;34515;12.5;4.6
30;2021-03-27;1971;381;95891;34896;12.8;4.7
30;2021-03-28;35;29;95926;34925;12.8;4.7
30;2021-03-29;2816;1660;98742;36585;13.2;4.9
30;2021-03-30;3777;1890;102519;38475;13.7;5.1
30;2021-03-31;3505;1655;106024;40130;14.2;5.4
30;2021-04-01;4015;1473;110039;41603;14.7;5.6
30;2021-04-02;3605;1235;113644;42838;15.2;5.7
30;2021-04-03;1061;1230;114705;44068;15.3;5.9
30;2021-04-04;30;189;114735;44257;15.3;5.9
30;2021-04-05;765;292;115500;44549;15.4;6.0
30;2021-04-06;3045;1582;118545;46131;15.8;6.2
30;2021-04-07;2719;1634;121264;47765;16.2;6.4
30;2021-04-08;3920;1499;125184;49264;16.7;6.6
30;2021-04-09;4889;1529;130073;50793;17.4;6.8
30;2021-04-10;2426;1179;132499;51972;17.7;6.9
30;2021-04-11;951;60;133450;52032;17.8;7.0
30;2021-04-12;3142;1499;136592;53531;18.2;7.2
30;2021-04-13;4019;1941;140611;55472;18.8;7.4
30;2021-04-14;3386;1548;143997;57020;19.2;7.6
30;2021-04-15;3827;1476;147824;58496;19.8;7.8
30;2021-04-16;3704;1549;151528;60045;20.2;8.0
30;2021-04-17;1493;959;153021;61004;20.4;8.2
30;2021-04-18;961;67;153982;61071;20.6;8.2
30;2021-04-19;2446;2301;156428;63372;20.9;8.5
30;2021-04-20;2817;2837;159245;66209;21.3;8.8
30;2021-04-21;2599;2580;161844;68789;21.6;9.2
30;2021-04-22;3525;2323;165369;71112;22.1;9.5
30;2021-04-23;3580;2311;168949;73423;22.6;9.8
30;2021-04-24;1347;1231;170296;74654;22.8;10.0
30;2021-04-25;748;92;171044;74746;22.9;10.0
30;2021-04-26;2015;2392;173059;77138;23.1;10.3
30;2021-04-27;2952;2605;176011;79743;23.5;10.7
30;2021-04-28;2839;2495;178850;82238;23.9;11.0
30;2021-04-29;3621;2333;182471;84571;24.4;11.3
30;2021-04-30;3409;2032;185880;86603;24.8;11.6
30;2021-05-01;1746;604;187626;87207;25.1;11.7
30;2021-05-02;667;246;188293;87453;25.2;11.7
30;2021-05-03;3750;2512;192043;89965;25.7;12.0
30;2021-05-04;3976;3547;196019;93512;26.2;12.5
30;2021-05-05;3941;3126;199960;96638;26.7;12.9
30;2021-05-06;4202;3378;204162;100016;27.3;13.4
30;2021-05-07;4080;3071;208242;103087;27.8;13.8
30;2021-05-08;1606;723;209848;103810;28.0;13.9
30;2021-05-09;372;613;210220;104423;28.1;14.0
30;2021-05-10;2922;3121;213142;107544;28.5;14.4
30;2021-05-11;5388;3655;218530;111199;29.2;14.9
30;2021-05-12;5303;3219;223833;114418;29.9;15.3
30;2021-05-13;3230;1029;227063;115447;30.3;15.4
30;2021-05-14;4890;2461;231953;117908;31.0;15.8
30;2021-05-15;3407;1206;235360;119114;31.4;15.9
30;2021-05-16;398;338;235758;119452;31.5;16.0
30;2021-05-17;3793;3033;239551;122485;32.0;16.4
30;2021-05-18;4826;3036;244377;125521;32.7;16.8
30;2021-05-19;4774;2547;249151;128068;33.3;17.1
30;2021-05-20;5014;2577;254165;130645;34.0;17.5
30;2021-05-21;4884;2474;259049;133119;34.6;17.8
30;2021-05-22;3155;1286;262204;134405;35.0;18.0
30;2021-05-23;289;344;262493;134749;35.1;18.0
30;2021-05-24;785;766;263278;135515;35.2;18.1
30;2021-05-25;2654;3158;265932;138673;35.5;18.5
30;2021-05-26;2888;2572;268820;141245;35.9;18.9
30;2021-05-27;3757;2716;272577;143961;36.4;19.2
30;2021-05-28;3325;3263;275902;147224;36.9;19.7
30;2021-05-29;1687;1797;277589;149021;37.1;19.9
30;2021-05-30;360;584;277949;149605;37.1;20.0
30;2021-05-31;2830;2298;280779;151903;37.5;20.3
30;2021-06-01;3657;2795;284436;154698;38.0;20.7
30;2021-06-02;3320;2451;287756;157149;38.4;21.0
30;2021-06-03;4129;3358;291885;160507;39.0;21.4
30;2021-06-04;3896;3400;295781;163907;39.5;21.9
30;2021-06-05;1904;1313;297685;165220;39.8;22.1
30;2021-06-06;684;265;298369;165485;39.9;22.1
30;2021-06-07;4722;2527;303091;168012;40.5;22.4
30;2021-06-08;4830;3330;307921;171342;41.1;22.9
30;2021-06-09;4151;2992;312072;174334;41.7;23.3
30;2021-06-10;4613;3358;316685;177692;42.3;23.7
30;2021-06-11;4583;3811;321268;181503;42.9;24.2
30;2021-06-12;2485;1709;323753;183212;43.3;24.5
30;2021-06-13;493;344;324246;183556;43.3;24.5
30;2021-06-14;2470;4712;326716;188268;43.7;25.2
30;2021-06-15;3199;5312;329915;193580;44.1;25.9
30;2021-06-16;3107;4648;333022;198228;44.5;26.5
30;2021-06-17;3923;4377;336945;202605;45.0;27.1
30;2021-06-18;3714;4699;340659;207304;45.5;27.7
30;2021-06-19;1441;2004;342100;209308;45.7;28.0
30;2021-06-20;357;491;342457;209799;45.8;28.0
30;2021-06-21;2379;4911;344836;214710;46.1;28.7
30;2021-06-22;2365;5742;347201;220452;46.4;29.5
30;2021-06-23;2529;5344;349730;225796;46.7;30.2
30;2021-06-24;2336;4709;352066;230505;47.0;30.8
30;2021-06-25;2611;5603;354677;236108;47.4;31.5
30;2021-06-26;909;2941;355586;239049;47.5;31.9
30;2021-06-27;222;527;355808;239576;47.5;32.0
30;2021-06-28;1670;6024;357478;245600;47.8;32.8
30;2021-06-29;1837;6023;359315;251623;48.0;33.6
30;2021-06-30;2001;5255;361316;256878;48.3;34.3
30;2021-07-01;3107;4719;364423;261597;48.7;35.0
30;2021-07-02;2833;4626;367256;266223;49.1;35.6
30;2021-07-03;1154;3047;368410;269270;49.2;36.0
30;2021-07-04;116;393;368526;269663;49.2;36.0
30;2021-07-05;2026;4030;370552;273693;49.5;36.6
30;2021-07-06;2663;4975;373215;278668;49.9;37.2
30;2021-07-07;2538;4224;375753;282892;50.2;37.8
30;2021-07-08;2012;3418;377765;286310;50.5;38.3
30;2021-07-09;2410;5314;380175;291624;50.8;39.0
30;2021-07-10;1504;2159;381679;293783;51.0;39.3
30;2021-07-11;47;415;381726;294198;51.0;39.3
30;2021-07-12;2527;5154;384253;299352;51.3;40.0
30;2021-07-13;3300;6029;387553;305381;51.8;40.8
30;2021-07-14;502;550;388055;305931;51.8;40.9
30;2021-07-15;4127;5477;392182;311408;52.4;41.6
30;2021-07-16;5038;5729;397220;317137;53.1;42.4
30;2021-07-17;1706;2469;398926;319606;53.3;42.7
30;2021-07-18;146;602;399072;320208;53.3;42.8
30;2021-07-19;3374;6315;402446;326523;53.8;43.6
30;2021-07-20;4641;6524;407087;333047;54.4;44.5
30;2021-07-21;4063;5415;411150;338462;54.9;45.2
30;2021-07-22;4900;5745;416050;344207;55.6;46.0
30;2021-07-23;4998;5872;421048;350079;56.3;46.8
30;2021-07-24;2240;3257;423288;353336;56.6;47.2
30;2021-07-25;137;310;423425;353646;56.6;47.2
30;2021-07-26;4414;4134;427839;357780;57.2;47.8
30;2021-07-27;4856;4654;432695;362434;57.8;48.4
30;2021-07-28;4877;4026;437572;366460;58.5;49.0
30;2021-07-29;5929;4142;443501;370602;59.3;49.5
30;2021-07-30;5343;4396;448844;374998;60.0;50.1
30;2021-07-31;2656;1965;451500;376963;60.3;50.4
30;2021-08-01;735;311;452235;377274;60.4;50.4
30;2021-08-02;3686;4015;455921;381289;60.9;50.9
30;2021-08-03;4887;3957;460808;385246;61.6;51.5
30;2021-08-04;5286;3055;466094;388301;62.3;51.9
30;2021-08-05;4617;3797;470711;392098;62.9;52.4
30;2021-08-06;4333;4066;475044;396164;63.5;52.9
30;2021-08-07;1841;1954;476885;398118;63.7;53.2
30;2021-08-08;620;280;477505;398398;63.8;53.2
30;2021-08-09;3343;3762;480848;402160;64.2;53.7
30;2021-08-10;3926;4402;484774;406562;64.8;54.3
30;2021-08-11;3402;3481;488176;410043;65.2;54.8
30;2021-08-12;3763;4224;491939;414267;65.7;55.3
30;2021-08-13;3309;3341;495248;417608;66.2;55.8
30;2021-08-14;1134;2048;496382;419656;66.3;56.1
30;2021-08-15;270;176;496652;419832;66.4;56.1
30;2021-08-16;2201;4867;498853;424699;66.6;56.7
30;2021-08-17;2746;4199;501599;428898;67.0;57.3
30;2021-08-18;2844;3836;504443;432734;67.4;57.8
30;2021-08-19;2859;4318;507302;437052;67.8;58.4
30;2021-08-20;2609;4468;509911;441520;68.1;59.0
30;2021-08-21;1018;2888;510929;444408;68.3;59.4
30;2021-08-22;227;516;511156;444924;68.3;59.4
30;2021-08-23;1687;4476;512843;449400;68.5;60.0
30;2021-08-24;1955;4526;514798;453926;68.8;60.6
30;2021-08-25;1691;4345;516489;458271;69.0;61.2
30;2021-08-26;1852;4258;518341;462529;69.3;61.8
30;2021-08-27;1779;4358;520120;466887;69.5;62.4
30;2021-08-28;681;2476;520801;469363;69.6;62.7
30;2021-08-29;182;614;520983;469977;69.6;62.8
30;2021-08-30;1408;4249;522391;474226;69.8;63.4
30;2021-08-31;1340;4073;523731;478299;70.0;63.9
30;2021-09-01;1246;3447;524977;481746;70.1;64.4
30;2021-09-02;1399;3312;526376;485058;70.3;64.8
30;2021-09-03;1601;3755;527977;488813;70.5;65.3
30;2021-09-04;686;1808;528663;490621;70.6;65.6
30;2021-09-05;136;486;528799;491107;70.7;65.6
30;2021-09-06;806;2278;529605;493385;70.8;65.9
30;2021-09-07;703;2110;530308;495495;70.9;66.2
30;2021-09-08;868;2551;531176;498046;71.0;66.5
30;2021-09-09;911;2164;532087;500210;71.1;66.8
30;2021-09-10;941;2614;533028;502824;71.2;67.2
30;2021-09-11;553;1584;533581;504408;71.3;67.4
30;2021-09-12;95;224;533676;504632;71.3;67.4
30;2021-09-13;690;1603;534366;506235;71.4;67.6
30;2021-09-14;652;1522;535018;507757;71.5;67.8
30;2021-09-15;733;1837;535751;509594;71.6;68.1
30;2021-09-16;753;1476;536504;511070;71.7;68.3
30;2021-09-17;802;2030;537306;513100;71.8;68.6
30;2021-09-18;399;1011;537705;514111;71.8;68.7
30;2021-09-19;69;158;537774;514269;71.8;68.7
30;2021-09-20;397;1204;538171;515473;71.9;68.9
30;2021-09-21;451;1162;538622;516635;72.0;69.0
30;2021-09-22;483;1384;539105;518019;72.0;69.2
30;2021-09-23;627;1203;539732;519222;72.1;69.4
30;2021-09-24;560;1629;540292;520851;72.2;69.6
30;2021-09-25;324;857;540616;521708;72.2;69.7
30;2021-09-26;54;168;540670;521876;72.2;69.7
30;2021-09-27;380;893;541050;522769;72.3;69.8
30;2021-09-28;576;894;541626;523663;72.4;70.0
30;2021-09-29;456;1066;542082;524729;72.4;70.1
30;2021-09-30;405;912;542487;525641;72.5;70.2
30;2021-10-01;500;1001;542987;526642;72.5;70.4
30;2021-10-02;267;580;543254;527222;72.6;70.4
30;2021-10-03;25;47;543279;527269;72.6;70.4
30;2021-10-04;329;787;543608;528056;72.6;70.6
30;2021-10-05;310;660;543918;528716;72.7;70.6
30;2021-10-06;377;854;544295;529570;72.7;70.8
30;2021-10-07;381;843;544676;530413;72.8;70.9
30;2021-10-08;429;1054;545105;531467;72.8;71.0
30;2021-10-09;284;562;545389;532029;72.9;71.1
30;2021-10-10;5;34;545394;532063;72.9;71.1
30;2021-10-11;243;543;545637;532606;72.9;71.2
30;2021-10-12;366;708;546003;533314;72.9;71.3
30;2021-10-13;290;680;546293;533994;73.0;71.3
30;2021-10-14;350;679;546643;534673;73.0;71.4
31;2020-12-27;0;0;0;0;0.0;0.0
31;2020-12-28;2;0;2;0;0.0;0.0
31;2020-12-29;0;0;2;0;0.0;0.0
31;2020-12-30;0;0;2;0;0.0;0.0
31;2020-12-31;1;0;3;0;0.0;0.0
31;2021-01-01;4;0;7;0;0.0;0.0
31;2021-01-02;1;0;8;0;0.0;0.0
31;2021-01-03;2;0;10;0;0.0;0.0
31;2021-01-04;5;0;15;0;0.0;0.0
31;2021-01-05;50;0;65;0;0.0;0.0
31;2021-01-06;211;1;276;1;0.0;0.0
31;2021-01-07;284;1;560;2;0.0;0.0
31;2021-01-08;546;1;1106;3;0.1;0.0
31;2021-01-09;275;0;1381;3;0.1;0.0
31;2021-01-10;286;0;1667;3;0.1;0.0
31;2021-01-11;983;4;2650;7;0.2;0.0
31;2021-01-12;1192;1;3842;8;0.3;0.0
31;2021-01-13;1158;5;5000;13;0.4;0.0
31;2021-01-14;1179;20;6179;33;0.4;0.0
31;2021-01-15;1048;3;7227;36;0.5;0.0
31;2021-01-16;243;1;7470;37;0.5;0.0
31;2021-01-17;176;0;7646;37;0.5;0.0
31;2021-01-18;1616;6;9262;43;0.7;0.0
31;2021-01-19;2938;12;12200;55;0.9;0.0
31;2021-01-20;3683;14;15883;69;1.1;0.0
31;2021-01-21;2997;9;18880;78;1.3;0.0
31;2021-01-22;2275;7;21155;85;1.5;0.0
31;2021-01-23;728;2;21883;87;1.6;0.0
31;2021-01-24;212;1;22095;88;1.6;0.0
31;2021-01-25;1744;9;23839;97;1.7;0.0
31;2021-01-26;1839;64;25678;161;1.8;0.0
31;2021-01-27;1574;151;27252;312;1.9;0.0
31;2021-01-28;1385;299;28637;611;2.0;0.0
31;2021-01-29;1361;351;29998;962;2.1;0.1
31;2021-01-30;446;186;30444;1148;2.2;0.1
31;2021-01-31;61;209;30505;1357;2.2;0.1
31;2021-02-01;1184;732;31689;2089;2.3;0.1
31;2021-02-02;3056;809;34745;2898;2.5;0.2
31;2021-02-03;1922;787;36667;3685;2.6;0.3
31;2021-02-04;1814;846;38481;4531;2.7;0.3
31;2021-02-05;1343;579;39824;5110;2.8;0.4
31;2021-02-06;385;57;40209;5167;2.9;0.4
31;2021-02-07;37;42;40246;5209;2.9;0.4
31;2021-02-08;1116;666;41362;5875;3.0;0.4
31;2021-02-09;1680;1575;43042;7450;3.1;0.5
31;2021-02-10;1964;2475;45006;9925;3.2;0.7
31;2021-02-11;1813;1826;46819;11751;3.3;0.8
31;2021-02-12;1540;797;48359;12548;3.5;0.9
31;2021-02-13;504;228;48863;12776;3.5;0.9
31;2021-02-14;56;216;48919;12992;3.5;0.9
31;2021-02-15;445;1368;49364;14360;3.5;1.0
31;2021-02-16;463;1543;49827;15903;3.6;1.1
31;2021-02-17;473;1633;50300;17536;3.6;1.3
31;2021-02-18;477;1766;50777;19302;3.6;1.4
31;2021-02-19;393;1564;51170;20866;3.7;1.5
31;2021-02-20;69;529;51239;21395;3.7;1.5
31;2021-02-21;77;161;51316;21556;3.7;1.5
31;2021-02-22;434;1731;51750;23287;3.7;1.7
31;2021-02-23;863;3011;52613;26298;3.8;1.9
31;2021-02-24;653;2187;53266;28485;3.8;2.0
31;2021-02-25;1435;1846;54701;30331;3.9;2.2
31;2021-02-26;1711;1234;56412;31565;4.0;2.3
31;2021-02-27;638;404;57050;31969;4.1;2.3
31;2021-02-28;78;54;57128;32023;4.1;2.3
31;2021-03-01;875;1134;58003;33157;4.1;2.4
31;2021-03-02;1239;1667;59242;34824;4.2;2.5
31;2021-03-03;1357;1814;60599;36638;4.3;2.6
31;2021-03-04;2424;1508;63023;38146;4.5;2.7
31;2021-03-05;3053;1606;66076;39752;4.7;2.8
31;2021-03-06;2834;413;68910;40165;4.9;2.9
31;2021-03-07;5368;113;74278;40278;5.3;2.9
31;2021-03-08;1599;1097;75877;41375;5.4;3.0
31;2021-03-09;2792;1198;78669;42573;5.6;3.0
31;2021-03-10;2574;1104;81243;43677;5.8;3.1
31;2021-03-11;4382;1169;85625;44846;6.1;3.2
31;2021-03-12;5321;1212;90946;46058;6.5;3.3
31;2021-03-13;2839;510;93785;46568;6.7;3.3
31;2021-03-14;235;49;94020;46617;6.7;3.3
31;2021-03-15;2584;435;96604;47052;6.9;3.4
31;2021-03-16;1746;823;98350;47875;7.0;3.4
31;2021-03-17;1656;563;100006;48438;7.1;3.5
31;2021-03-18;1988;714;101994;49152;7.3;3.5
31;2021-03-19;3185;534;105179;49686;7.5;3.5
31;2021-03-20;1797;142;106976;49828;7.6;3.6
31;2021-03-21;211;35;107187;49863;7.7;3.6
31;2021-03-22;2580;375;109767;50238;7.8;3.6
31;2021-03-23;4057;328;113824;50566;8.1;3.6
31;2021-03-24;4357;299;118181;50865;8.4;3.6
31;2021-03-25;6042;537;124223;51402;8.9;3.7
31;2021-03-26;5466;525;129689;51927;9.3;3.7
31;2021-03-27;4350;213;134039;52140;9.6;3.7
31;2021-03-28;2291;48;136330;52188;9.7;3.7
31;2021-03-29;4206;435;140536;52623;10.0;3.8
31;2021-03-30;6595;560;147131;53183;10.5;3.8
31;2021-03-31;5650;394;152781;53577;10.9;3.8
31;2021-04-01;6968;568;159749;54145;11.4;3.9
31;2021-04-02;6102;596;165851;54741;11.8;3.9
31;2021-04-03;3927;159;169778;54900;12.1;3.9
31;2021-04-04;2060;116;171838;55016;12.3;3.9
31;2021-04-05;481;70;172319;55086;12.3;3.9
31;2021-04-06;4165;1159;176484;56245;12.6;4.0
31;2021-04-07;5988;993;182472;57238;13.0;4.1
31;2021-04-08;7569;1043;190041;58281;13.6;4.2
31;2021-04-09;8385;1262;198426;59543;14.2;4.3
31;2021-04-10;4718;549;203144;60092;14.5;4.3
31;2021-04-11;2069;140;205213;60232;14.6;4.3
31;2021-04-12;6001;1847;211214;62079;15.1;4.4
31;2021-04-13;8048;2040;219262;64119;15.7;4.6
31;2021-04-14;6655;1932;225917;66051;16.1;4.7
31;2021-04-15;7771;2254;233688;68305;16.7;4.9
31;2021-04-16;7178;2103;240866;70408;17.2;5.0
31;2021-04-17;4414;915;245280;71323;17.5;5.1
31;2021-04-18;2513;358;247793;71681;17.7;5.1
31;2021-04-19;5220;2035;253013;73716;18.1;5.3
31;2021-04-20;6074;2854;259087;76570;18.5;5.5
31;2021-04-21;5974;2803;265061;79373;18.9;5.7
31;2021-04-22;6377;3251;271438;82624;19.4;5.9
31;2021-04-23;6283;2566;277721;85190;19.8;6.1
31;2021-04-24;1616;3143;279337;88333;19.9;6.3
31;2021-04-25;688;2096;280025;90429;20.0;6.5
31;2021-04-26;3794;3229;283819;93658;20.3;6.7
31;2021-04-27;4516;3902;288335;97560;20.6;7.0
31;2021-04-28;4544;3560;292879;101120;20.9;7.2
31;2021-04-29;5183;4056;298062;105176;21.3;7.5
31;2021-04-30;5039;4148;303101;109324;21.6;7.8
31;2021-05-01;1487;3120;304588;112444;21.7;8.0
31;2021-05-02;1416;1979;306004;114423;21.8;8.2
31;2021-05-03;5658;2425;311662;116848;22.2;8.3
31;2021-05-04;4779;4749;316441;121597;22.6;8.7
31;2021-05-05;2994;5731;319435;127328;22.8;9.1
31;2021-05-06;3635;7386;323070;134714;23.1;9.6
31;2021-05-07;5258;7178;328328;141892;23.4;10.1
31;2021-05-08;3634;3103;331962;144995;23.7;10.3
31;2021-05-09;3760;2310;335722;147305;24.0;10.5
31;2021-05-10;5683;5482;341405;152787;24.4;10.9
31;2021-05-11;6605;6704;348010;159491;24.8;11.4
31;2021-05-12;6172;5939;354182;165430;25.3;11.8
31;2021-05-13;4642;2068;358824;167498;25.6;12.0
31;2021-05-14;6911;3982;365735;171480;26.1;12.2
31;2021-05-15;5145;1756;370880;173236;26.5;12.4
31;2021-05-16;3300;634;374180;173870;26.7;12.4
31;2021-05-17;5143;4151;379323;178021;27.1;12.7
31;2021-05-18;5589;4279;384912;182300;27.5;13.0
31;2021-05-19;5782;3763;390694;186063;27.9;13.3
31;2021-05-20;6473;4806;397167;190869;28.4;13.6
31;2021-05-21;5984;4605;403151;195474;28.8;14.0
31;2021-05-22;4082;1628;407233;197102;29.1;14.1
31;2021-05-23;3583;342;410816;197444;29.3;14.1
31;2021-05-24;3881;707;414697;198151;29.6;14.1
31;2021-05-25;6190;3612;420887;201763;30.0;14.4
31;2021-05-26;5608;4644;426495;206407;30.4;14.7
31;2021-05-27;4788;6193;431283;212600;30.8;15.2
31;2021-05-28;4116;6349;435399;218949;31.1;15.6
31;2021-05-29;1917;4032;437316;222981;31.2;15.9
31;2021-05-30;751;2362;438067;225343;31.3;16.1
31;2021-05-31;4397;5083;442464;230426;31.6;16.4
31;2021-06-01;5954;6565;448418;236991;32.0;16.9
31;2021-06-02;5803;6308;454221;243299;32.4;17.4
31;2021-06-03;7308;8139;461529;251438;32.9;17.9
31;2021-06-04;7541;7165;469070;258603;33.5;18.5
31;2021-06-05;9078;2778;478148;261381;34.1;18.7
31;2021-06-06;8106;1580;486254;262961;34.7;18.8
31;2021-06-07;7986;5473;494240;268434;35.3;19.2
31;2021-06-08;9106;6052;503346;274486;35.9;19.6
31;2021-06-09;8918;5558;512264;280044;36.6;20.0
31;2021-06-10;9781;6362;522045;286406;37.3;20.4
31;2021-06-11;10050;6638;532095;293044;38.0;20.9
31;2021-06-12;8788;3026;540883;296070;38.6;21.1
31;2021-06-13;8378;2018;549261;298088;39.2;21.3
31;2021-06-14;8429;6731;557690;304819;39.8;21.8
31;2021-06-15;9773;7445;567463;312264;40.5;22.3
31;2021-06-16;8735;5261;576198;317525;41.1;22.7
31;2021-06-17;8277;6609;584475;324134;41.7;23.1
31;2021-06-18;8551;7756;593026;331890;42.3;23.7
31;2021-06-19;7364;5442;600390;337332;42.9;24.1
31;2021-06-20;5572;3727;605962;341059;43.3;24.3
31;2021-06-21;5374;6918;611336;347977;43.6;24.8
31;2021-06-22;4986;8231;616322;356208;44.0;25.4
31;2021-06-23;5105;7284;621427;363492;44.4;25.9
31;2021-06-24;4634;8340;626061;371832;44.7;26.5
31;2021-06-25;5014;9313;631075;381145;45.0;27.2
31;2021-06-26;4283;6398;635358;387543;45.4;27.7
31;2021-06-27;3596;4106;638954;391649;45.6;28.0
31;2021-06-28;4098;6646;643052;398295;45.9;28.4
31;2021-06-29;3798;7563;646850;405858;46.2;29.0
31;2021-06-30;4280;7821;651130;413679;46.5;29.5
31;2021-07-01;4122;8472;655252;422151;46.8;30.1
31;2021-07-02;4113;9329;659365;431480;47.1;30.8
31;2021-07-03;4100;6113;663465;437593;47.4;31.2
31;2021-07-04;3205;4812;666670;442405;47.6;31.6
31;2021-07-05;4057;7094;670727;449499;47.9;32.1
31;2021-07-06;3889;8363;674616;457862;48.2;32.7
31;2021-07-07;3964;7962;678580;465824;48.4;33.3
31;2021-07-08;4054;8540;682634;474364;48.7;33.9
31;2021-07-09;4462;8800;687096;483164;49.0;34.5
31;2021-07-10;3918;5498;691014;488662;49.3;34.9
31;2021-07-11;3137;4138;694151;492800;49.5;35.2
31;2021-07-12;3825;8641;697976;501441;49.8;35.8
31;2021-07-13;6921;9448;704897;510889;50.3;36.5
31;2021-07-14;6167;3938;711064;514827;50.8;36.7
31;2021-07-15;8515;9451;719579;524278;51.4;37.4
31;2021-07-16;7775;9921;727354;534199;51.9;38.1
31;2021-07-17;8357;10558;735711;544757;52.5;38.9
31;2021-07-18;6620;9474;742331;554231;53.0;39.6
31;2021-07-19;4794;10778;747125;565009;53.3;40.3
31;2021-07-20;7160;11484;754285;576493;53.8;41.2
31;2021-07-21;7040;11532;761325;588025;54.3;42.0
31;2021-07-22;8165;11768;769490;599793;54.9;42.8
31;2021-07-23;7475;11819;776965;611612;55.5;43.7
31;2021-07-24;10310;10576;787275;622188;56.2;44.4
31;2021-07-25;7560;8803;794835;630991;56.7;45.0
31;2021-07-26;5514;9545;800349;640536;57.1;45.7
31;2021-07-27;7961;9199;808310;649735;57.7;46.4
31;2021-07-28;8677;8285;816987;658020;58.3;47.0
31;2021-07-29;8856;8056;825843;666076;58.9;47.5
31;2021-07-30;7674;7988;833517;674064;59.5;48.1
31;2021-07-31;6015;7394;839532;681458;59.9;48.6
31;2021-08-01;4431;4305;843963;685763;60.2;49.0
31;2021-08-02;5490;5419;849453;691182;60.6;49.3
31;2021-08-03;5896;5187;855349;696369;61.1;49.7
31;2021-08-04;5925;4808;861274;701177;61.5;50.1
31;2021-08-05;5586;7232;866860;708409;61.9;50.6
31;2021-08-06;5303;7344;872163;715753;62.3;51.1
31;2021-08-07;4596;6652;876759;722405;62.6;51.6
31;2021-08-08;3385;5579;880144;727984;62.8;52.0
31;2021-08-09;4396;7011;884540;734995;63.1;52.5
31;2021-08-10;4686;6286;889226;741281;63.5;52.9
31;2021-08-11;4527;5860;893753;747141;63.8;53.3
31;2021-08-12;4524;6759;898277;753900;64.1;53.8
31;2021-08-13;4174;6204;902451;760104;64.4;54.3
31;2021-08-14;3033;6462;905484;766566;64.6;54.7
31;2021-08-15;1309;4098;906793;770664;64.7;55.0
31;2021-08-16;3219;8118;910012;778782;65.0;55.6
31;2021-08-17;3435;7098;913447;785880;65.2;56.1
31;2021-08-18;3314;7008;916761;792888;65.4;56.6
31;2021-08-19;2987;6994;919748;799882;65.7;57.1
31;2021-08-20;3025;7396;922773;807278;65.9;57.6
31;2021-08-21;1980;6801;924753;814079;66.0;58.1
31;2021-08-22;1486;5638;926239;819717;66.1;58.5
31;2021-08-23;2385;7729;928624;827446;66.3;59.1
31;2021-08-24;2609;6174;931233;833620;66.5;59.5
31;2021-08-25;2413;5729;933646;839349;66.6;59.9
31;2021-08-26;2280;5801;935926;845150;66.8;60.3
31;2021-08-27;2363;6663;938289;851813;67.0;60.8
31;2021-08-28;1846;6790;940135;858603;67.1;61.3
31;2021-08-29;1282;5067;941417;863670;67.2;61.6
31;2021-08-30;2190;6586;943607;870256;67.4;62.1
31;2021-08-31;2257;5451;945864;875707;67.5;62.5
31;2021-09-01;1753;4656;947617;880363;67.6;62.8
31;2021-09-02;1770;4050;949387;884413;67.8;63.1
31;2021-09-03;1832;4715;951219;889128;67.9;63.5
31;2021-09-04;2008;5690;953227;894818;68.0;63.9
31;2021-09-05;1129;2172;954356;896990;68.1;64.0
31;2021-09-06;1368;3041;955724;900031;68.2;64.2
31;2021-09-07;1264;2868;956988;902899;68.3;64.4
31;2021-09-08;1424;3424;958412;906323;68.4;64.7
31;2021-09-09;1110;2565;959522;908888;68.5;64.9
31;2021-09-10;1677;3420;961199;912308;68.6;65.1
31;2021-09-11;1292;3775;962491;916083;68.7;65.4
31;2021-09-12;541;1683;963032;917766;68.7;65.5
31;2021-09-13;1015;1994;964047;919760;68.8;65.7
31;2021-09-14;1248;2013;965295;921773;68.9;65.8
31;2021-09-15;1088;2692;966383;924465;69.0;66.0
31;2021-09-16;900;1680;967283;926145;69.0;66.1
31;2021-09-17;1076;2508;968359;928653;69.1;66.3
31;2021-09-18;855;2798;969214;931451;69.2;66.5
31;2021-09-19;322;1241;969536;932692;69.2;66.6
31;2021-09-20;608;1597;970144;934289;69.2;66.7
31;2021-09-21;825;1561;970969;935850;69.3;66.8
31;2021-09-22;835;2060;971804;937910;69.4;66.9
31;2021-09-23;773;1548;972577;939458;69.4;67.1
31;2021-09-24;830;2008;973407;941466;69.5;67.2
31;2021-09-25;663;2535;974070;944001;69.5;67.4
31;2021-09-26;249;1127;974319;945128;69.5;67.5
31;2021-09-27;690;1509;975009;946637;69.6;67.6
31;2021-09-28;728;1350;975737;947987;69.6;67.7
31;2021-09-29;759;1668;976496;949655;69.7;67.8
31;2021-09-30;719;1245;977215;950900;69.8;67.9
31;2021-10-01;825;1852;978040;952752;69.8;68.0
31;2021-10-02;765;1761;978805;954513;69.9;68.1
31;2021-10-03;107;349;978912;954862;69.9;68.2
31;2021-10-04;390;694;979302;955556;69.9;68.2
31;2021-10-05;540;1320;979842;956876;69.9;68.3
31;2021-10-06;603;1192;980445;958068;70.0;68.4
31;2021-10-07;642;1389;981087;959457;70.0;68.5
31;2021-10-08;761;1186;981848;960643;70.1;68.6
31;2021-10-09;508;1276;982356;961919;70.1;68.7
31;2021-10-10;20;57;982376;961976;70.1;68.7
31;2021-10-11;373;508;982749;962484;70.1;68.7
31;2021-10-12;585;1056;983334;963540;70.2;68.8
31;2021-10-13;568;1055;983902;964595;70.2;68.9
31;2021-10-14;634;1115;984536;965710;70.3;68.9
32;2020-12-27;0;0;0;0;0.0;0.0
32;2020-12-28;0;0;0;0;0.0;0.0
32;2020-12-29;0;0;0;0;0.0;0.0
32;2020-12-30;0;0;0;0;0.0;0.0
32;2020-12-31;0;0;0;0;0.0;0.0
32;2021-01-01;0;0;0;0;0.0;0.0
32;2021-01-02;0;0;0;0;0.0;0.0
32;2021-01-03;1;0;1;0;0.0;0.0
32;2021-01-04;3;0;4;0;0.0;0.0
32;2021-01-05;2;0;6;0;0.0;0.0
32;2021-01-06;3;0;9;0;0.0;0.0
32;2021-01-07;155;0;164;0;0.1;0.0
32;2021-01-08;70;0;234;0;0.1;0.0
32;2021-01-09;5;0;239;0;0.1;0.0
32;2021-01-10;0;0;239;0;0.1;0.0
32;2021-01-11;11;0;250;0;0.1;0.0
32;2021-01-12;96;0;346;0;0.2;0.0
32;2021-01-13;325;1;671;1;0.4;0.0
32;2021-01-14;389;3;1060;4;0.6;0.0
32;2021-01-15;449;3;1509;7;0.8;0.0
32;2021-01-16;17;2;1526;9;0.8;0.0
32;2021-01-17;1;0;1527;9;0.8;0.0
32;2021-01-18;345;1;1872;10;1.0;0.0
32;2021-01-19;420;0;2292;10;1.2;0.0
32;2021-01-20;358;0;2650;10;1.4;0.0
32;2021-01-21;582;2;3232;12;1.7;0.0
32;2021-01-22;372;0;3604;12;1.9;0.0
32;2021-01-23;189;0;3793;12;2.0;0.0
32;2021-01-24;5;0;3798;12;2.0;0.0
32;2021-01-25;468;1;4266;13;2.2;0.0
32;2021-01-26;612;0;4878;13;2.6;0.0
32;2021-01-27;703;4;5581;17;2.9;0.0
32;2021-01-28;687;15;6268;32;3.3;0.0
32;2021-01-29;461;54;6729;86;3.5;0.0
32;2021-01-30;260;0;6989;86;3.7;0.0
32;2021-01-31;4;5;6993;91;3.7;0.0
32;2021-02-01;289;58;7282;149;3.8;0.1
32;2021-02-02;641;139;7923;288;4.2;0.2
32;2021-02-03;338;200;8261;488;4.3;0.3
32;2021-02-04;427;279;8688;767;4.6;0.4
32;2021-02-05;346;360;9034;1127;4.8;0.6
32;2021-02-06;148;0;9182;1127;4.8;0.6
32;2021-02-07;0;36;9182;1163;4.8;0.6
32;2021-02-08;278;121;9460;1284;5.0;0.7
32;2021-02-09;310;229;9770;1513;5.1;0.8
32;2021-02-10;272;254;10042;1767;5.3;0.9
32;2021-02-11;383;317;10425;2084;5.5;1.1
32;2021-02-12;298;280;10723;2364;5.6;1.2
32;2021-02-13;249;1;10972;2365;5.8;1.2
32;2021-02-14;0;28;10972;2393;5.8;1.3
32;2021-02-15;25;212;10997;2605;5.8;1.4
32;2021-02-16;395;368;11392;2973;6.0;1.6
32;2021-02-17;191;474;11583;3447;6.1;1.8
32;2021-02-18;333;493;11916;3940;6.3;2.1
32;2021-02-19;184;278;12100;4218;6.4;2.2
32;2021-02-20;1;120;12101;4338;6.4;2.3
32;2021-02-21;0;0;12101;4338;6.4;2.3
32;2021-02-22;158;385;12259;4723;6.5;2.5
32;2021-02-23;432;571;12691;5294;6.7;2.8
32;2021-02-24;276;381;12967;5675;6.8;3.0
32;2021-02-25;480;527;13447;6202;7.1;3.3
32;2021-02-26;444;384;13891;6586;7.3;3.5
32;2021-02-27;157;246;14048;6832;7.4;3.6
32;2021-02-28;4;0;14052;6832;7.4;3.6
32;2021-03-01;51;300;14103;7132;7.4;3.8
32;2021-03-02;414;449;14517;7581;7.6;4.0
32;2021-03-03;276;292;14793;7873;7.8;4.1
32;2021-03-04;541;340;15334;8213;8.1;4.3
32;2021-03-05;438;248;15772;8461;8.3;4.5
32;2021-03-06;520;173;16292;8634;8.6;4.5
32;2021-03-07;25;5;16317;8639;8.6;4.5
32;2021-03-08;234;295;16551;8934;8.7;4.7
32;2021-03-09;644;332;17195;9266;9.0;4.9
32;2021-03-10;482;329;17677;9595;9.3;5.0
32;2021-03-11;855;295;18532;9890;9.8;5.2
32;2021-03-12;881;344;19413;10234;10.2;5.4
32;2021-03-13;492;246;19905;10480;10.5;5.5
32;2021-03-14;1;0;19906;10480;10.5;5.5
32;2021-03-15;264;26;20170;10506;10.6;5.5
32;2021-03-16;314;310;20484;10816;10.8;5.7
32;2021-03-17;150;156;20634;10972;10.9;5.8
32;2021-03-18;375;308;21009;11280;11.1;5.9
32;2021-03-19;405;183;21414;11463;11.3;6.0
32;2021-03-20;136;33;21550;11496;11.3;6.0
32;2021-03-21;0;0;21550;11496;11.3;6.0
32;2021-03-22;340;170;21890;11666;11.5;6.1
32;2021-03-23;560;399;22450;12065;11.8;6.3
32;2021-03-24;643;271;23093;12336;12.2;6.5
32;2021-03-25;899;418;23992;12754;12.6;6.7
32;2021-03-26;657;294;24649;13048;13.0;6.9
32;2021-03-27;165;3;24814;13051;13.1;6.9
32;2021-03-28;1;1;24815;13052;13.1;6.9
32;2021-03-29;371;49;25186;13101;13.3;6.9
32;2021-03-30;766;290;25952;13391;13.7;7.0
32;2021-03-31;654;174;26606;13565;14.0;7.1
32;2021-04-01;1237;320;27843;13885;14.7;7.3
32;2021-04-02;575;167;28418;14052;15.0;7.4
32;2021-04-03;113;0;28531;14052;15.0;7.4
32;2021-04-04;0;0;28531;14052;15.0;7.4
32;2021-04-05;0;0;28531;14052;15.0;7.4
32;2021-04-06;2650;316;31181;14368;16.4;7.6
32;2021-04-07;1178;206;32359;14574;17.0;7.7
32;2021-04-08;1736;407;34095;14981;17.9;7.9
32;2021-04-09;883;218;34978;15199;18.4;8.0
32;2021-04-10;809;30;35787;15229;18.8;8.0
32;2021-04-11;14;0;35801;15229;18.8;8.0
32;2021-04-12;477;23;36278;15252;19.1;8.0
32;2021-04-13;2469;389;38747;15641;20.4;8.2
32;2021-04-14;1226;264;39973;15905;21.0;8.4
32;2021-04-15;1704;396;41677;16301;21.9;8.6
32;2021-04-16;638;284;42315;16585;22.3;8.7
32;2021-04-17;783;39;43098;16624;22.7;8.7
32;2021-04-18;13;1;43111;16625;22.7;8.7
32;2021-04-19;502;46;43613;16671;22.9;8.8
32;2021-04-20;2472;394;46085;17065;24.3;9.0
32;2021-04-21;1009;302;47094;17367;24.8;9.1
32;2021-04-22;1662;321;48756;17688;25.7;9.3
32;2021-04-23;549;159;49305;17847;25.9;9.4
32;2021-04-24;1392;58;50697;17905;26.7;9.4
32;2021-04-25;0;11;50697;17916;26.7;9.4
32;2021-04-26;387;359;51084;18275;26.9;9.6
32;2021-04-27;2551;559;53635;18834;28.2;9.9
32;2021-04-28;972;357;54607;19191;28.7;10.1
32;2021-04-29;1008;885;55615;20076;29.3;10.6
32;2021-04-30;453;363;56068;20439;29.5;10.8
32;2021-05-01;2607;98;58675;20537;30.9;10.8
32;2021-05-02;0;0;58675;20537;30.9;10.8
32;2021-05-03;170;321;58845;20858;31.0;11.0
32;2021-05-04;785;2497;59630;23355;31.4;12.3
32;2021-05-05;2360;1101;61990;24456;32.6;12.9
32;2021-05-06;516;1661;62506;26117;32.9;13.7
32;2021-05-07;2286;539;64792;26656;34.1;14.0
32;2021-05-08;70;516;64862;27172;34.1;14.3
32;2021-05-09;21;179;64883;27351;34.1;14.4
32;2021-05-10;1994;553;66877;27904;35.2;14.7
32;2021-05-11;651;2278;67528;30182;35.5;15.9
32;2021-05-12;2313;1137;69841;31319;36.8;16.5
32;2021-05-13;280;1417;70121;32736;36.9;17.2
32;2021-05-14;2223;328;72344;33064;38.1;17.4
32;2021-05-15;134;712;72478;33776;38.1;17.8
32;2021-05-16;2;0;72480;33776;38.1;17.8
32;2021-05-17;353;170;72833;33946;38.3;17.9
32;2021-05-18;1642;298;74475;34244;39.2;18.0
32;2021-05-19;2474;273;76949;34517;40.5;18.2
32;2021-05-20;2885;471;79834;34988;42.0;18.4
32;2021-05-21;2532;500;82366;35488;43.3;18.7
32;2021-05-22;334;110;82700;35598;43.5;18.7
32;2021-05-23;2;13;82702;35611;43.5;18.7
32;2021-05-24;3;0;82705;35611;43.5;18.7
32;2021-05-25;1982;374;84687;35985;44.6;18.9
32;2021-05-26;2547;558;87234;36543;45.9;19.2
32;2021-05-27;2876;626;90110;37169;47.4;19.6
32;2021-05-28;2308;767;92418;37936;48.6;20.0
32;2021-05-29;372;314;92790;38250;48.8;20.1
32;2021-05-30;4;6;92794;38256;48.8;20.1
32;2021-05-31;1413;626;94207;38882;49.6;20.5
32;2021-06-01;567;2889;94774;41771;49.9;22.0
32;2021-06-02;1580;1351;96354;43122;50.7;22.7
32;2021-06-03;395;2086;96749;45208;50.9;23.8
32;2021-06-04;1836;831;98585;46039;51.9;24.2
32;2021-06-05;207;1660;98792;47699;52.0;25.1
32;2021-06-06;8;14;98800;47713;52.0;25.1
32;2021-06-07;102;418;98902;48131;52.0;25.3
32;2021-06-08;663;2538;99565;50669;52.4;26.7
32;2021-06-09;1191;1056;100756;51725;53.0;27.2
32;2021-06-10;684;1225;101440;52950;53.4;27.9
32;2021-06-11;926;663;102366;53613;53.9;28.2
32;2021-06-12;150;2679;102516;56292;53.9;29.6
32;2021-06-13;1;1;102517;56293;53.9;29.6
32;2021-06-14;528;210;103045;56503;54.2;29.7
32;2021-06-15;1733;1027;104778;57530;55.1;30.3
32;2021-06-16;850;2778;105628;60308;55.6;31.7
32;2021-06-17;859;829;106487;61137;56.0;32.2
32;2021-06-18;315;2724;106802;63861;56.2;33.6
32;2021-06-19;914;437;107716;64298;56.7;33.8
32;2021-06-20;5;13;107721;64311;56.7;33.8
32;2021-06-21;67;1994;107788;66305;56.7;34.9
32;2021-06-22;1042;971;108830;67276;57.3;35.4
32;2021-06-23;517;2183;109347;69459;57.5;36.5
32;2021-06-24;528;517;109875;69976;57.8;36.8
32;2021-06-25;501;2360;110376;72336;58.1;38.1
32;2021-06-26;108;171;110484;72507;58.1;38.2
32;2021-06-27;2;5;110486;72512;58.1;38.2
32;2021-06-28;630;603;111116;73115;58.5;38.5
32;2021-06-29;800;1982;111916;75097;58.9;39.5
32;2021-06-30;757;2726;112673;77823;59.3;41.0
32;2021-07-01;538;2638;113211;80461;59.6;42.3
32;2021-07-02;641;2335;113852;82796;59.9;43.6
32;2021-07-03;481;506;114333;83302;60.2;43.8
32;2021-07-04;2;12;114335;83314;60.2;43.8
32;2021-07-05;76;390;114411;83704;60.2;44.0
32;2021-07-06;878;2083;115289;85787;60.7;45.1
32;2021-07-07;781;2757;116070;88544;61.1;46.6
32;2021-07-08;479;2268;116549;90812;61.3;47.8
32;2021-07-09;615;2226;117164;93038;61.7;49.0
32;2021-07-10;536;520;117700;93558;61.9;49.2
32;2021-07-11;0;5;117700;93563;61.9;49.2
32;2021-07-12;526;1244;118226;94807;62.2;49.9
32;2021-07-13;1695;1817;119921;96624;63.1;50.8
32;2021-07-14;492;36;120413;96660;63.4;50.9
32;2021-07-15;2096;892;122509;97552;64.5;51.3
32;2021-07-16;1170;1914;123679;99466;65.1;52.3
32;2021-07-17;78;128;123757;99594;65.1;52.4
32;2021-07-18;2;5;123759;99599;65.1;52.4
32;2021-07-19;1997;147;125756;99746;66.2;52.5
32;2021-07-20;2036;1272;127792;101018;67.2;53.2
32;2021-07-21;1614;1692;129406;102710;68.1;54.0
32;2021-07-22;1946;513;131352;103223;69.1;54.3
32;2021-07-23;1408;1731;132760;104954;69.9;55.2
32;2021-07-24;139;118;132899;105072;69.9;55.3
32;2021-07-25;34;10;132933;105082;70.0;55.3
32;2021-07-26;1071;1070;134004;106152;70.5;55.9
32;2021-07-27;1730;2100;135734;108252;71.4;57.0
32;2021-07-28;694;975;136428;109227;71.8;57.5
32;2021-07-29;1694;1608;138122;110835;72.7;58.3
32;2021-07-30;363;349;138485;111184;72.9;58.5
32;2021-07-31;186;350;138671;111534;73.0;58.7
32;2021-08-01;18;4;138689;111538;73.0;58.7
32;2021-08-02;82;76;138771;111614;73.0;58.7
32;2021-08-03;1173;1792;139944;113406;73.6;59.7
32;2021-08-04;634;652;140578;114058;74.0;60.0
32;2021-08-05;1104;1944;141682;116002;74.6;61.0
32;2021-08-06;563;495;142245;116497;74.9;61.3
32;2021-08-07;148;92;142393;116589;74.9;61.3
32;2021-08-08;1;0;142394;116589;74.9;61.3
32;2021-08-09;263;1826;142657;118415;75.1;62.3
32;2021-08-10;715;2078;143372;120493;75.4;63.4
32;2021-08-11;579;446;143951;120939;75.7;63.6
32;2021-08-12;931;2102;144882;123041;76.2;64.7
32;2021-08-13;178;249;145060;123290;76.3;64.9
32;2021-08-14;113;117;145173;123407;76.4;64.9
32;2021-08-15;13;21;145186;123428;76.4;64.9
32;2021-08-16;44;40;145230;123468;76.4;65.0
32;2021-08-17;572;2301;145802;125769;76.7;66.2
32;2021-08-18;312;559;146114;126328;76.9;66.5
32;2021-08-19;956;1410;147070;127738;77.4;67.2
32;2021-08-20;208;166;147278;127904;77.5;67.3
32;2021-08-21;150;194;147428;128098;77.6;67.4
32;2021-08-22;8;3;147436;128101;77.6;67.4
32;2021-08-23;45;101;147481;128202;77.6;67.5
32;2021-08-24;585;1449;148066;129651;77.9;68.2
32;2021-08-25;94;191;148160;129842;78.0;68.3
32;2021-08-26;321;2261;148481;132103;78.1;69.5
32;2021-08-27;276;553;148757;132656;78.3;69.8
32;2021-08-28;70;109;148827;132765;78.3;69.9
32;2021-08-29;1;8;148828;132773;78.3;69.9
32;2021-08-30;20;49;148848;132822;78.3;69.9
32;2021-08-31;195;1516;149043;134338;78.4;70.7
32;2021-09-01;680;785;149723;135123;78.8;71.1
32;2021-09-02;318;1579;150041;136702;79.0;71.9
32;2021-09-03;194;294;150235;136996;79.1;72.1
32;2021-09-04;49;90;150284;137086;79.1;72.1
32;2021-09-05;12;15;150296;137101;79.1;72.1
32;2021-09-06;50;72;150346;137173;79.1;72.2
32;2021-09-07;438;810;150784;137983;79.3;72.6
32;2021-09-08;255;483;151039;138466;79.5;72.9
32;2021-09-09;227;885;151266;139351;79.6;73.3
32;2021-09-10;203;196;151469;139547;79.7;73.4
32;2021-09-11;88;137;151557;139684;79.8;73.5
32;2021-09-12;7;11;151564;139695;79.8;73.5
32;2021-09-13;4;10;151568;139705;79.8;73.5
32;2021-09-14;324;573;151892;140278;79.9;73.8
32;2021-09-15;200;145;152092;140423;80.0;73.9
32;2021-09-16;184;216;152276;140639;80.1;74.0
32;2021-09-17;199;345;152475;140984;80.2;74.2
32;2021-09-18;40;62;152515;141046;80.3;74.2
32;2021-09-19;0;2;152515;141048;80.3;74.2
32;2021-09-20;4;18;152519;141066;80.3;74.2
32;2021-09-21;241;459;152760;141525;80.4;74.5
32;2021-09-22;233;548;152993;142073;80.5;74.8
32;2021-09-23;133;217;153126;142290;80.6;74.9
32;2021-09-24;101;288;153227;142578;80.6;75.0
32;2021-09-25;28;51;153255;142629;80.6;75.1
32;2021-09-26;3;5;153258;142634;80.6;75.1
32;2021-09-27;9;29;153267;142663;80.6;75.1
32;2021-09-28;113;515;153380;143178;80.7;75.3
32;2021-09-29;88;334;153468;143512;80.8;75.5
32;2021-09-30;170;201;153638;143713;80.8;75.6
32;2021-10-01;103;246;153741;143959;80.9;75.8
32;2021-10-02;28;103;153769;144062;80.9;75.8
32;2021-10-03;0;8;153769;144070;80.9;75.8
32;2021-10-04;13;19;153782;144089;80.9;75.8
32;2021-10-05;59;287;153841;144376;81.0;76.0
32;2021-10-06;41;260;153882;144636;81.0;76.1
32;2021-10-07;56;218;153938;144854;81.0;76.2
32;2021-10-08;65;257;154003;145111;81.0;76.4
32;2021-10-09;25;52;154028;145163;81.1;76.4
32;2021-10-10;0;0;154028;145163;81.1;76.4
32;2021-10-11;11;44;154039;145207;81.1;76.4
32;2021-10-12;61;187;154100;145394;81.1;76.5
32;2021-10-13;55;201;154155;145595;81.1;76.6
32;2021-10-14;93;268;154248;145863;81.2;76.8
33;2020-12-27;4;0;4;0;0.0;0.0
33;2020-12-28;4;0;8;0;0.0;0.0
33;2020-12-29;0;0;8;0;0.0;0.0
33;2020-12-30;0;0;8;0;0.0;0.0
33;2020-12-31;1;0;9;0;0.0;0.0
33;2021-01-01;0;0;9;0;0.0;0.0
33;2021-01-02;2;1;11;1;0.0;0.0
33;2021-01-03;2;1;13;2;0.0;0.0
33;2021-01-04;2;0;15;2;0.0;0.0
33;2021-01-05;2;0;17;2;0.0;0.0
33;2021-01-06;134;1;151;3;0.0;0.0
33;2021-01-07;1309;4;1460;7;0.1;0.0
33;2021-01-08;1200;3;2660;10;0.2;0.0
33;2021-01-09;298;1;2958;11;0.2;0.0
33;2021-01-10;229;0;3187;11;0.2;0.0
33;2021-01-11;628;0;3815;11;0.2;0.0
33;2021-01-12;1416;2;5231;13;0.3;0.0
33;2021-01-13;1313;9;6544;22;0.4;0.0
33;2021-01-14;1293;19;7837;41;0.5;0.0
33;2021-01-15;1610;14;9447;55;0.6;0.0
33;2021-01-16;568;10;10015;65;0.6;0.0
33;2021-01-17;406;4;10421;69;0.6;0.0
33;2021-01-18;1226;14;11647;83;0.7;0.0
33;2021-01-19;2937;12;14584;95;0.9;0.0
33;2021-01-20;3423;17;18007;112;1.1;0.0
33;2021-01-21;2866;9;20873;121;1.3;0.0
33;2021-01-22;2328;13;23201;134;1.4;0.0
33;2021-01-23;853;3;24054;137;1.5;0.0
33;2021-01-24;532;2;24586;139;1.5;0.0
33;2021-01-25;2172;63;26758;202;1.6;0.0
33;2021-01-26;2263;164;29021;366;1.8;0.0
33;2021-01-27;2263;209;31284;575;1.9;0.0
33;2021-01-28;2160;438;33444;1013;2.0;0.1
33;2021-01-29;1825;684;35269;1697;2.2;0.1
33;2021-01-30;707;172;35976;1869;2.2;0.1
33;2021-01-31;390;158;36366;2027;2.2;0.1
33;2021-02-01;1457;648;37823;2675;2.3;0.2
33;2021-02-02;2645;1113;40468;3788;2.5;0.2
33;2021-02-03;2942;874;43410;4662;2.7;0.3
33;2021-02-04;4033;1352;47443;6014;2.9;0.4
33;2021-02-05;2193;1172;49636;7186;3.0;0.4
33;2021-02-06;648;199;50284;7385;3.1;0.5
33;2021-02-07;219;229;50503;7614;3.1;0.5
33;2021-02-08;1265;756;51768;8370;3.2;0.5
33;2021-02-09;1328;1675;53096;10045;3.3;0.6
33;2021-02-10;1267;1747;54363;11792;3.3;0.7
33;2021-02-11;1305;1442;55668;13234;3.4;0.8
33;2021-02-12;1121;1250;56789;14484;3.5;0.9
33;2021-02-13;204;292;56993;14776;3.5;0.9
33;2021-02-14;47;245;57040;15021;3.5;0.9
33;2021-02-15;684;1718;57724;16739;3.5;1.0
33;2021-02-16;816;2053;58540;18792;3.6;1.2
33;2021-02-17;668;2048;59208;20840;3.6;1.3
33;2021-02-18;899;2242;60107;23082;3.7;1.4
33;2021-02-19;920;2014;61027;25096;3.7;1.5
33;2021-02-20;78;656;61105;25752;3.7;1.6
33;2021-02-21;37;460;61142;26212;3.7;1.6
33;2021-02-22;709;1885;61851;28097;3.8;1.7
33;2021-02-23;1235;2746;63086;30843;3.9;1.9
33;2021-02-24;1407;2523;64493;33366;3.9;2.0
33;2021-02-25;2840;3759;67333;37125;4.1;2.3
33;2021-02-26;4059;2334;71392;39459;4.4;2.4
33;2021-02-27;1361;722;72753;40181;4.5;2.5
33;2021-02-28;127;514;72880;40695;4.5;2.5
33;2021-03-01;1537;1856;74417;42551;4.6;2.6
33;2021-03-02;2326;1747;76743;44298;4.7;2.7
33;2021-03-03;2312;1709;79055;46007;4.8;2.8
33;2021-03-04;3937;1672;82992;47679;5.1;2.9
33;2021-03-05;5764;1745;88756;49424;5.4;3.0
33;2021-03-06;3416;566;92172;49990;5.6;3.1
33;2021-03-07;741;160;92913;50150;5.7;3.1
33;2021-03-08;2712;1153;95625;51303;5.9;3.1
33;2021-03-09;4404;1341;100029;52644;6.1;3.2
33;2021-03-10;5122;1244;105151;53888;6.4;3.3
33;2021-03-11;7548;1237;112699;55125;6.9;3.4
33;2021-03-12;10118;1179;122817;56304;7.5;3.4
33;2021-03-13;5155;219;127972;56523;7.8;3.5
33;2021-03-14;714;29;128686;56552;7.9;3.5
33;2021-03-15;4445;685;133131;57237;8.2;3.5
33;2021-03-16;3582;883;136713;58120;8.4;3.6
33;2021-03-17;3644;954;140357;59074;8.6;3.6
33;2021-03-18;4037;1417;144394;60491;8.8;3.7
33;2021-03-19;6272;1042;150666;61533;9.2;3.8
33;2021-03-20;3368;109;154034;61642;9.4;3.8
33;2021-03-21;462;30;154496;61672;9.5;3.8
33;2021-03-22;4901;456;159397;62128;9.8;3.8
33;2021-03-23;6324;613;165721;62741;10.1;3.8
33;2021-03-24;7076;530;172797;63271;10.6;3.9
33;2021-03-25;8843;662;181640;63933;11.1;3.9
33;2021-03-26;10041;864;191681;64797;11.7;4.0
33;2021-03-27;3619;84;195300;64881;12.0;4.0
33;2021-03-28;577;34;195877;64915;12.0;4.0
33;2021-03-29;6765;708;202642;65623;12.4;4.0
33;2021-03-30;8103;1051;210745;66674;12.9;4.1
33;2021-03-31;7577;1071;218322;67745;13.4;4.1
33;2021-04-01;8824;1204;227146;68949;13.9;4.2
33;2021-04-02;8411;1567;235557;70516;14.4;4.3
33;2021-04-03;2832;526;238389;71042;14.6;4.3
33;2021-04-04;218;160;238607;71202;14.6;4.4
33;2021-04-05;694;125;239301;71327;14.7;4.4
33;2021-04-06;6049;2690;245350;74017;15.0;4.5
33;2021-04-07;7422;2552;252772;76569;15.5;4.7
33;2021-04-08;10330;2790;263102;79359;16.1;4.9
33;2021-04-09;12687;3103;275789;82462;16.9;5.0
33;2021-04-10;5357;1395;281146;83857;17.2;5.1
33;2021-04-11;1002;353;282148;84210;17.3;5.2
33;2021-04-12;7427;3285;289575;87495;17.7;5.4
33;2021-04-13;9322;3500;298897;90995;18.3;5.6
33;2021-04-14;9040;3649;307937;94644;18.9;5.8
33;2021-04-15;10110;3891;318047;98535;19.5;6.0
33;2021-04-16;9718;4233;327765;102768;20.1;6.3
33;2021-04-17;4652;1662;332417;104430;20.4;6.4
33;2021-04-18;929;414;333346;104844;20.4;6.4
33;2021-04-19;5616;3844;338962;108688;20.8;6.7
33;2021-04-20;7294;4273;346256;112961;21.2;6.9
33;2021-04-21;6594;4355;352850;117316;21.6;7.2
33;2021-04-22;7350;4494;360200;121810;22.1;7.5
33;2021-04-23;7702;4837;367902;126647;22.5;7.8
33;2021-04-24;4500;1804;372402;128451;22.8;7.9
33;2021-04-25;1652;418;374054;128869;22.9;7.9
33;2021-04-26;5270;5090;379324;133959;23.2;8.2
33;2021-04-27;6579;5633;385903;139592;23.6;8.5
33;2021-04-28;6783;5583;392686;145175;24.0;8.9
33;2021-04-29;8425;6250;401111;151425;24.6;9.3
33;2021-04-30;8741;6135;409852;157560;25.1;9.6
33;2021-05-01;2902;516;412754;158076;25.3;9.7
33;2021-05-02;1835;348;414589;158424;25.4;9.7
33;2021-05-03;7018;5221;421607;163645;25.8;10.0
33;2021-05-04;6826;6672;428433;170317;26.2;10.4
33;2021-05-05;7139;7574;435572;177891;26.7;10.9
33;2021-05-06;8704;8246;444276;186137;27.2;11.4
33;2021-05-07;8609;8924;452885;195061;27.7;11.9
33;2021-05-08;3543;1600;456428;196661;27.9;12.0
33;2021-05-09;1118;969;457546;197630;28.0;12.1
33;2021-05-10;6873;7312;464419;204942;28.4;12.5
33;2021-05-11;8634;7882;473053;212824;29.0;13.0
33;2021-05-12;9175;6704;482228;219528;29.5;13.4
33;2021-05-13;5212;2115;487440;221643;29.8;13.6
33;2021-05-14;8129;5354;495569;226997;30.3;13.9
33;2021-05-15;5179;2866;500748;229863;30.7;14.1
33;2021-05-16;1842;803;502590;230666;30.8;14.1
33;2021-05-17;8861;5112;511451;235778;31.3;14.4
33;2021-05-18;10625;4889;522076;240667;32.0;14.7
33;2021-05-19;10900;4784;532976;245451;32.6;15.0
33;2021-05-20;10907;5588;543883;251039;33.3;15.4
33;2021-05-21;10915;6251;554798;257290;34.0;15.8
33;2021-05-22;5121;2751;559919;260041;34.3;15.9
33;2021-05-23;1751;385;561670;260426;34.4;15.9
33;2021-05-24;5412;1001;567082;261427;34.7;16.0
33;2021-05-25;9391;5783;576473;267210;35.3;16.4
33;2021-05-26;9675;6048;586148;273258;35.9;16.7
33;2021-05-27;10902;7725;597050;280983;36.6;17.2
33;2021-05-28;10062;9519;607112;290502;37.2;17.8
33;2021-05-29;5042;4117;612154;294619;37.5;18.0
33;2021-05-30;1703;667;613857;295286;37.6;18.1
33;2021-05-31;8550;6421;622407;301707;38.1;18.5
33;2021-06-01;11802;8722;634209;310429;38.8;19.0
33;2021-06-02;11711;8215;645920;318644;39.5;19.5
33;2021-06-03;12715;9209;658635;327853;40.3;20.1
33;2021-06-04;12933;10957;671568;338810;41.1;20.7
33;2021-06-05;5272;5063;676840;343873;41.4;21.1
33;2021-06-06;2526;1194;679366;345067;41.6;21.1
33;2021-06-07;9758;8503;689124;353570;42.2;21.6
33;2021-06-08;11938;9465;701062;363035;42.9;22.2
33;2021-06-09;11775;8533;712837;371568;43.6;22.7
33;2021-06-10;12951;8397;725788;379965;44.4;23.3
33;2021-06-11;12516;11171;738304;391136;45.2;23.9
33;2021-06-12;6185;4480;744489;395616;45.6;24.2
33;2021-06-13;2613;1283;747102;396899;45.7;24.3
33;2021-06-14;8581;10157;755683;407056;46.3;24.9
33;2021-06-15;12054;10274;767737;417330;47.0;25.5
33;2021-06-16;12058;8879;779795;426209;47.7;26.1
33;2021-06-17;13116;9623;792911;435832;48.5;26.7
33;2021-06-18;11797;11445;804708;447277;49.3;27.4
33;2021-06-19;5610;4821;810318;452098;49.6;27.7
33;2021-06-20;2946;1475;813264;453573;49.8;27.8
33;2021-06-21;7875;10166;821139;463739;50.3;28.4
33;2021-06-22;9065;11085;830204;474824;50.8;29.1
33;2021-06-23;8672;10847;838876;485671;51.4;29.7
33;2021-06-24;9744;9981;848620;495652;52.0;30.3
33;2021-06-25;8047;13716;856667;509368;52.4;31.2
33;2021-06-26;4345;5920;861012;515288;52.7;31.5
33;2021-06-27;2467;1959;863479;517247;52.9;31.7
33;2021-06-28;4871;12763;868350;530010;53.2;32.4
33;2021-06-29;6443;13657;874793;543667;53.6;33.3
33;2021-06-30;6680;13394;881473;557061;54.0;34.1
33;2021-07-01;8046;11809;889519;568870;54.5;34.8
33;2021-07-02;6843;15110;896362;583980;54.9;35.8
33;2021-07-03;3227;6785;899589;590765;55.1;36.2
33;2021-07-04;2066;2379;901655;593144;55.2;36.3
33;2021-07-05;4397;12907;906052;606051;55.5;37.1
33;2021-07-06;6142;14593;912194;620644;55.8;38.0
33;2021-07-07;6871;13053;919065;633697;56.3;38.8
33;2021-07-08;7966;12758;927031;646455;56.8;39.6
33;2021-07-09;6469;15112;933500;661567;57.1;40.5
33;2021-07-10;3114;7162;936614;668729;57.3;40.9
33;2021-07-11;1844;2303;938458;671032;57.5;41.1
33;2021-07-12;3950;14705;942408;685737;57.7;42.0
33;2021-07-13;7152;16107;949560;701844;58.1;43.0
33;2021-07-14;3689;5315;953249;707159;58.4;43.3
33;2021-07-15;7627;15983;960876;723142;58.8;44.3
33;2021-07-16;8589;15150;969465;738292;59.4;45.2
33;2021-07-17;3156;6433;972621;744725;59.5;45.6
33;2021-07-18;1702;3205;974323;747930;59.6;45.8
33;2021-07-19;5871;15096;980194;763026;60.0;46.7
33;2021-07-20;7430;16134;987624;779160;60.5;47.7
33;2021-07-21;8370;14543;995994;793703;61.0;48.6
33;2021-07-22;9365;15112;1005359;808815;61.5;49.5
33;2021-07-23;9666;16350;1015025;825165;62.1;50.5
33;2021-07-24;3838;7554;1018863;832719;62.4;51.0
33;2021-07-25;2093;2667;1020956;835386;62.5;51.1
33;2021-07-26;6966;13421;1027922;848807;62.9;52.0
33;2021-07-27;10090;13403;1038012;862210;63.5;52.8
33;2021-07-28;10931;11977;1048943;874187;64.2;53.5
33;2021-07-29;11673;11913;1060616;886100;64.9;54.2
33;2021-07-30;11401;12225;1072017;898325;65.6;55.0
33;2021-07-31;4761;5650;1076778;903975;65.9;55.3
33;2021-08-01;2484;1951;1079262;905926;66.1;55.5
33;2021-08-02;8418;9891;1087680;915817;66.6;56.1
33;2021-08-03;11560;9027;1099240;924844;67.3;56.6
33;2021-08-04;12287;7372;1111527;932216;68.0;57.1
33;2021-08-05;11936;8046;1123463;940262;68.8;57.6
33;2021-08-06;11231;9057;1134694;949319;69.5;58.1
33;2021-08-07;5929;4516;1140623;953835;69.8;58.4
33;2021-08-08;3186;1770;1143809;955605;70.0;58.5
33;2021-08-09;8661;8721;1152470;964326;70.6;59.0
33;2021-08-10;9374;8452;1161844;972778;71.1;59.6
33;2021-08-11;8115;7590;1169959;980368;71.6;60.0
33;2021-08-12;7980;8021;1177939;988389;72.1;60.5
33;2021-08-13;7848;7682;1185787;996071;72.6;61.0
33;2021-08-14;3526;4332;1189313;1000403;72.8;61.2
33;2021-08-15;1211;1881;1190524;1002284;72.9;61.4
33;2021-08-16;6429;8629;1196953;1010913;73.3;61.9
33;2021-08-17;6639;9070;1203592;1019983;73.7;62.4
33;2021-08-18;5631;8771;1209223;1028754;74.0;63.0
33;2021-08-19;5505;9120;1214728;1037874;74.4;63.5
33;2021-08-20;4962;9837;1219690;1047711;74.7;64.1
33;2021-08-21;2208;5037;1221898;1052748;74.8;64.4
33;2021-08-22;565;2366;1222463;1055114;74.8;64.6
33;2021-08-23;3922;10289;1226385;1065403;75.1;65.2
33;2021-08-24;4144;11094;1230529;1076497;75.3;65.9
33;2021-08-25;3725;10489;1234254;1086986;75.6;66.5
33;2021-08-26;3662;11057;1237916;1098043;75.8;67.2
33;2021-08-27;3830;12588;1241746;1110631;76.0;68.0
33;2021-08-28;1583;6639;1243329;1117270;76.1;68.4
33;2021-08-29;455;2426;1243784;1119696;76.1;68.5
33;2021-08-30;2377;10460;1246161;1130156;76.3;69.2
33;2021-08-31;3252;10862;1249413;1141018;76.5;69.9
33;2021-09-01;2869;8286;1252282;1149304;76.7;70.4
33;2021-09-02;2712;7787;1254994;1157091;76.8;70.8
33;2021-09-03;3119;9376;1258113;1166467;77.0;71.4
33;2021-09-04;1656;5793;1259769;1172260;77.1;71.8
33;2021-09-05;414;1459;1260183;1173719;77.1;71.9
33;2021-09-06;1625;6439;1261808;1180158;77.2;72.2
33;2021-09-07;2083;5717;1263891;1185875;77.4;72.6
33;2021-09-08;1769;5905;1265660;1191780;77.5;73.0
33;2021-09-09;1924;5652;1267584;1197432;77.6;73.3
33;2021-09-10;2105;6304;1269689;1203736;77.7;73.7
33;2021-09-11;1002;4232;1270691;1207968;77.8;74.0
33;2021-09-12;131;556;1270822;1208524;77.8;74.0
33;2021-09-13;1510;3615;1272332;1212139;77.9;74.2
33;2021-09-14;1568;3488;1273900;1215627;78.0;74.4
33;2021-09-15;1547;4451;1275447;1220078;78.1;74.7
33;2021-09-16;1489;3349;1276936;1223427;78.2;74.9
33;2021-09-17;1803;4517;1278739;1227944;78.3;75.2
33;2021-09-18;606;3052;1279345;1230996;78.3;75.4
33;2021-09-19;115;398;1279460;1231394;78.3;75.4
33;2021-09-20;1057;2161;1280517;1233555;78.4;75.5
33;2021-09-21;959;2453;1281476;1236008;78.5;75.7
33;2021-09-22;964;3447;1282440;1239455;78.5;75.9
33;2021-09-23;913;2307;1283353;1241762;78.6;76.0
33;2021-09-24;1294;3721;1284647;1245483;78.6;76.2
33;2021-09-25;516;2354;1285163;1247837;78.7;76.4
33;2021-09-26;64;333;1285227;1248170;78.7;76.4
33;2021-09-27;667;2014;1285894;1250184;78.7;76.5
33;2021-09-28;830;2150;1286724;1252334;78.8;76.7
33;2021-09-29;888;2212;1287612;1254546;78.8;76.8
33;2021-09-30;694;1686;1288306;1256232;78.9;76.9
33;2021-10-01;1058;2683;1289364;1258915;78.9;77.1
33;2021-10-02;556;1352;1289920;1260267;79.0;77.2
33;2021-10-03;10;45;1289930;1260312;79.0;77.2
33;2021-10-04;647;1400;1290577;1261712;79.0;77.2
33;2021-10-05;546;1425;1291123;1263137;79.0;77.3
33;2021-10-06;785;1686;1291908;1264823;79.1;77.4
33;2021-10-07;589;1479;1292497;1266302;79.1;77.5
33;2021-10-08;865;2112;1293362;1268414;79.2;77.7
33;2021-10-09;499;928;1293861;1269342;79.2;77.7
33;2021-10-10;5;42;1293866;1269384;79.2;77.7
33;2021-10-11;490;1184;1294356;1270568;79.2;77.8
33;2021-10-12;544;1138;1294900;1271706;79.3;77.9
33;2021-10-13;777;1377;1295677;1273083;79.3;77.9
33;2021-10-14;538;1115;1296215;1274198;79.4;78.0
34;2020-12-27;1;0;1;0;0.0;0.0
34;2020-12-28;3;0;4;0;0.0;0.0
34;2020-12-29;0;0;4;0;0.0;0.0
34;2020-12-30;0;0;4;0;0.0;0.0
34;2020-12-31;0;0;4;0;0.0;0.0
34;2021-01-01;1;0;5;0;0.0;0.0
34;2021-01-02;2;0;7;0;0.0;0.0
34;2021-01-03;0;0;7;0;0.0;0.0
34;2021-01-04;23;0;30;0;0.0;0.0
34;2021-01-05;108;2;138;2;0.0;0.0
34;2021-01-06;199;7;337;9;0.0;0.0
34;2021-01-07;364;0;701;9;0.1;0.0
34;2021-01-08;606;0;1307;9;0.1;0.0
34;2021-01-09;244;0;1551;9;0.1;0.0
34;2021-01-10;94;1;1645;10;0.1;0.0
34;2021-01-11;567;2;2212;12;0.2;0.0
34;2021-01-12;1009;1;3221;13;0.3;0.0
34;2021-01-13;1098;7;4319;20;0.4;0.0
34;2021-01-14;1957;14;6276;34;0.5;0.0
34;2021-01-15;1471;7;7747;41;0.7;0.0
34;2021-01-16;333;7;8080;48;0.7;0.0
34;2021-01-17;235;1;8315;49;0.7;0.0
34;2021-01-18;1125;5;9440;54;0.8;0.0
34;2021-01-19;1610;8;11050;62;0.9;0.0
34;2021-01-20;2091;23;13141;85;1.1;0.0
34;2021-01-21;4234;20;17375;105;1.5;0.0
34;2021-01-22;2556;10;19931;115;1.7;0.0
34;2021-01-23;600;2;20531;117;1.7;0.0
34;2021-01-24;3;0;20534;117;1.7;0.0
34;2021-01-25;1242;6;21776;123;1.9;0.0
34;2021-01-26;1460;20;23236;143;2.0;0.0
34;2021-01-27;1472;24;24708;167;2.1;0.0
34;2021-01-28;1393;124;26101;291;2.2;0.0
34;2021-01-29;1260;139;27361;430;2.3;0.0
34;2021-01-30;479;25;27840;455;2.4;0.0
34;2021-01-31;4;0;27844;455;2.4;0.0
34;2021-02-01;1028;247;28872;702;2.5;0.1
34;2021-02-02;1464;443;30336;1145;2.6;0.1
34;2021-02-03;2655;525;32991;1670;2.8;0.1
34;2021-02-04;2318;887;35309;2557;3.0;0.2
34;2021-02-05;1891;1175;37200;3732;3.2;0.3
34;2021-02-06;497;241;37697;3973;3.2;0.3
34;2021-02-07;34;108;37731;4081;3.2;0.3
34;2021-02-08;860;1060;38591;5141;3.3;0.4
34;2021-02-09;1035;1301;39626;6442;3.4;0.5
34;2021-02-10;1296;1503;40922;7945;3.5;0.7
34;2021-02-11;1795;2706;42717;10651;3.6;0.9
34;2021-02-12;1923;1645;44640;12296;3.8;1.0
34;2021-02-13;357;513;44997;12809;3.8;1.1
34;2021-02-14;22;286;45019;13095;3.8;1.1
34;2021-02-15;673;1203;45692;14298;3.9;1.2
34;2021-02-16;666;1523;46358;15821;3.9;1.3
34;2021-02-17;715;1519;47073;17340;4.0;1.5
34;2021-02-18;838;1490;47911;18830;4.1;1.6
34;2021-02-19;816;1225;48727;20055;4.1;1.7
34;2021-02-20;300;479;49027;20534;4.2;1.7
34;2021-02-21;64;18;49091;20552;4.2;1.7
34;2021-02-22;632;1296;49723;21848;4.2;1.9
34;2021-02-23;566;1479;50289;23327;4.3;2.0
34;2021-02-24;942;2333;51231;25660;4.4;2.2
34;2021-02-25;1608;2276;52839;27936;4.5;2.4
34;2021-02-26;1850;1632;54689;29568;4.6;2.5
34;2021-02-27;702;431;55391;29999;4.7;2.6
34;2021-02-28;86;64;55477;30063;4.7;2.6
34;2021-03-01;932;1162;56409;31225;4.8;2.7
34;2021-03-02;1592;1279;58001;32504;4.9;2.8
34;2021-03-03;1835;1407;59836;33911;5.1;2.9
34;2021-03-04;2868;1629;62704;35540;5.3;3.0
34;2021-03-05;3686;1544;66390;37084;5.6;3.2
34;2021-03-06;2641;208;69031;37292;5.9;3.2
34;2021-03-07;1242;78;70273;37370;6.0;3.2
34;2021-03-08;2782;1014;73055;38384;6.2;3.3
34;2021-03-09;4019;1458;77074;39842;6.6;3.4
34;2021-03-10;3992;1342;81066;41184;6.9;3.5
34;2021-03-11;5436;1317;86502;42501;7.4;3.6
34;2021-03-12;6492;941;92994;43442;7.9;3.7
34;2021-03-13;3139;182;96133;43624;8.2;3.7
34;2021-03-14;1003;56;97136;43680;8.3;3.7
34;2021-03-15;3308;574;100444;44254;8.5;3.8
34;2021-03-16;2913;674;103357;44928;8.8;3.8
34;2021-03-17;3305;747;106662;45675;9.1;3.9
34;2021-03-18;3451;948;110113;46623;9.4;4.0
34;2021-03-19;4692;809;114805;47432;9.8;4.0
34;2021-03-20;3148;71;117953;47503;10.0;4.0
34;2021-03-21;1997;63;119950;47566;10.2;4.0
34;2021-03-22;3683;475;123633;48041;10.5;4.1
34;2021-03-23;4961;544;128594;48585;10.9;4.1
34;2021-03-24;5221;655;133815;49240;11.4;4.2
34;2021-03-25;7197;732;141012;49972;12.0;4.2
34;2021-03-26;7168;583;148180;50555;12.6;4.3
34;2021-03-27;2374;87;150554;50642;12.8;4.3
34;2021-03-28;700;22;151254;50664;12.9;4.3
34;2021-03-29;4187;769;155441;51433;13.2;4.4
34;2021-03-30;5220;974;160661;52407;13.7;4.5
34;2021-03-31;5069;1219;165730;53626;14.1;4.6
34;2021-04-01;7032;1068;172762;54694;14.7;4.7
34;2021-04-02;5823;1201;178585;55895;15.2;4.8
34;2021-04-03;1137;88;179722;55983;15.3;4.8
34;2021-04-04;166;5;179888;55988;15.3;4.8
34;2021-04-05;433;26;180321;56014;15.3;4.8
34;2021-04-06;3136;2460;183457;58474;15.6;5.0
34;2021-04-07;3387;2648;186844;61122;15.9;5.2
34;2021-04-08;5251;2816;192095;63938;16.3;5.4
34;2021-04-09;8075;2510;200170;66448;17.0;5.6
34;2021-04-10;3164;1378;203334;67826;17.3;5.8
34;2021-04-11;1715;808;205049;68634;17.4;5.8
34;2021-04-12;4501;2539;209550;71173;17.8;6.1
34;2021-04-13;5240;3063;214790;74236;18.3;6.3
34;2021-04-14;5621;3253;220411;77489;18.7;6.6
34;2021-04-15;6997;3181;227408;80670;19.3;6.9
34;2021-04-16;6580;3178;233988;83848;19.9;7.1
34;2021-04-17;2378;2076;236366;85924;20.1;7.3
34;2021-04-18;988;1723;237354;87647;20.2;7.5
34;2021-04-19;3422;3123;240776;90770;20.5;7.7
34;2021-04-20;3768;3666;244544;94436;20.8;8.0
34;2021-04-21;4241;3732;248785;98168;21.2;8.3
34;2021-04-22;4490;4621;253275;102789;21.5;8.7
34;2021-04-23;5379;3536;258654;106325;22.0;9.0
34;2021-04-24;3164;1588;261818;107913;22.3;9.2
34;2021-04-25;1919;650;263737;108563;22.4;9.2
34;2021-04-26;4223;3482;267960;112045;22.8;9.5
34;2021-04-27;5128;4031;273088;116076;23.2;9.9
34;2021-04-28;5771;3558;278859;119634;23.7;10.2
34;2021-04-29;6421;3953;285280;123587;24.3;10.5
34;2021-04-30;7870;3301;293150;126888;24.9;10.8
34;2021-05-01;2405;508;295555;127396;25.1;10.8
34;2021-05-02;3260;329;298815;127725;25.4;10.9
34;2021-05-03;6577;2918;305392;130643;26.0;11.1
34;2021-05-04;7111;3818;312503;134461;26.6;11.4
34;2021-05-05;6497;4537;319000;138998;27.1;11.8
34;2021-05-06;6945;5219;325945;144217;27.7;12.3
34;2021-05-07;6928;5692;332873;149909;28.3;12.7
34;2021-05-08;3609;1174;336482;151083;28.6;12.8
34;2021-05-09;2178;1290;338660;152373;28.8;13.0
34;2021-05-10;5853;4809;344513;157182;29.3;13.4
34;2021-05-11;7411;5332;351924;162514;29.9;13.8
34;2021-05-12;7756;4470;359680;166984;30.6;14.2
34;2021-05-13;6128;786;365808;167770;31.1;14.3
34;2021-05-14;7491;3747;373299;171517;31.7;14.6
34;2021-05-15;4863;1686;378162;173203;32.2;14.7
34;2021-05-16;4949;460;383111;173663;32.6;14.8
34;2021-05-17;8693;1987;391804;175650;33.3;14.9
34;2021-05-18;9143;1979;400947;177629;34.1;15.1
34;2021-05-19;8625;1812;409572;179441;34.8;15.3
34;2021-05-20;8866;2520;418438;181961;35.6;15.5
34;2021-05-21;8784;3229;427222;185190;36.3;15.7
34;2021-05-22;5787;1155;433009;186345;36.8;15.8
34;2021-05-23;3883;549;436892;186894;37.1;15.9
34;2021-05-24;1898;853;438790;187747;37.3;16.0
34;2021-05-25;7142;3816;445932;191563;37.9;16.3
34;2021-05-26;8318;3039;454250;194602;38.6;16.5
34;2021-05-27;8317;4307;462567;198909;39.3;16.9
34;2021-05-28;8062;5456;470629;204365;40.0;17.4
34;2021-05-29;4006;3110;474635;207475;40.4;17.6
34;2021-05-30;1985;1389;476620;208864;40.5;17.8
34;2021-05-31;5878;5260;482498;214124;41.0;18.2
34;2021-06-01;6948;6111;489446;220235;41.6;18.7
34;2021-06-02;6136;5814;495582;226049;42.1;19.2
34;2021-06-03;7704;6487;503286;232536;42.8;19.8
34;2021-06-04;7651;7591;510937;240127;43.4;20.4
34;2021-06-05;4140;3680;515077;243807;43.8;20.7
34;2021-06-06;3266;1865;518343;245672;44.1;20.9
34;2021-06-07;4415;6767;522758;252439;44.4;21.5
34;2021-06-08;5854;6829;528612;259268;44.9;22.0
34;2021-06-09;5826;6845;534438;266113;45.4;22.6
34;2021-06-10;6323;6879;540761;272992;46.0;23.2
34;2021-06-11;5400;9278;546161;282270;46.4;24.0
34;2021-06-12;3166;4728;549327;286998;46.7;24.4
34;2021-06-13;1081;1908;550408;288906;46.8;24.6
34;2021-06-14;3443;7814;553851;296720;47.1;25.2
34;2021-06-15;3951;8793;557802;305513;47.4;26.0
34;2021-06-16;4620;7858;562422;313371;47.8;26.6
34;2021-06-17;4228;7954;566650;321325;48.2;27.3
34;2021-06-18;4351;9330;571001;330655;48.5;28.1
34;2021-06-19;2729;4406;573730;335061;48.8;28.5
34;2021-06-20;888;2873;574618;337934;48.9;28.7
34;2021-06-21;2181;8556;576799;346490;49.0;29.5
34;2021-06-22;2975;9405;579774;355895;49.3;30.3
34;2021-06-23;3528;8965;583302;364860;49.6;31.0
34;2021-06-24;3559;8677;586861;373537;49.9;31.8
34;2021-06-25;3378;10440;590239;383977;50.2;32.6
34;2021-06-26;1641;6191;591880;390168;50.3;33.2
34;2021-06-27;308;4268;592188;394436;50.3;33.5
34;2021-06-28;2266;9429;594454;403865;50.5;34.3
34;2021-06-29;2683;10298;597137;414163;50.8;35.2
34;2021-06-30;3356;9548;600493;423711;51.1;36.0
34;2021-07-01;3530;9449;604023;433160;51.4;36.8
34;2021-07-02;3434;9742;607457;442902;51.6;37.7
34;2021-07-03;1682;6158;609139;449060;51.8;38.2
34;2021-07-04;312;2763;609451;451823;51.8;38.4
34;2021-07-05;3234;7999;612685;459822;52.1;39.1
34;2021-07-06;3531;9176;616216;468998;52.4;39.9
34;2021-07-07;3273;8654;619489;477652;52.7;40.6
34;2021-07-08;4302;8876;623791;486528;53.0;41.4
34;2021-07-09;4010;9349;627801;495877;53.4;42.2
34;2021-07-10;2140;5717;629941;501594;53.6;42.6
34;2021-07-11;924;2576;630865;504170;53.6;42.9
34;2021-07-12;2929;8970;633794;513140;53.9;43.6
34;2021-07-13;4656;10048;638450;523188;54.3;44.5
34;2021-07-14;784;357;639234;523545;54.3;44.5
34;2021-07-15;5910;10400;645144;533945;54.9;45.4
34;2021-07-16;5859;10737;651003;544682;55.4;46.3
34;2021-07-17;4500;4420;655503;549102;55.7;46.7
34;2021-07-18;235;199;655738;549301;55.8;46.7
34;2021-07-19;5119;8336;660857;557637;56.2;47.4
34;2021-07-20;6897;8392;667754;566029;56.8;48.1
34;2021-07-21;7649;7832;675403;573861;57.4;48.8
34;2021-07-22;7443;8181;682846;582042;58.1;49.5
34;2021-07-23;7843;8167;690689;590209;58.7;50.2
34;2021-07-24;6151;3062;696840;593271;59.2;50.4
34;2021-07-25;3210;547;700050;593818;59.5;50.5
34;2021-07-26;6238;6434;706288;600252;60.1;51.0
34;2021-07-27;8755;6058;715043;606310;60.8;51.6
34;2021-07-28;9711;5933;724754;612243;61.6;52.1
34;2021-07-29;11326;6055;736080;618298;62.6;52.6
34;2021-07-30;9848;6545;745928;624843;63.4;53.1
34;2021-07-31;6445;2197;752373;627040;64.0;53.3
34;2021-08-01;3317;621;755690;627661;64.3;53.4
34;2021-08-02;7361;5072;763051;632733;64.9;53.8
34;2021-08-03;8144;5403;771195;638136;65.6;54.3
34;2021-08-04;8446;4570;779641;642706;66.3;54.6
34;2021-08-05;7136;5032;786777;647738;66.9;55.1
34;2021-08-06;6224;5236;793001;652974;67.4;55.5
34;2021-08-07;3110;2437;796111;655411;67.7;55.7
34;2021-08-08;202;204;796313;655615;67.7;55.7
34;2021-08-09;4781;6180;801094;661795;68.1;56.3
34;2021-08-10;5398;6486;806492;668281;68.6;56.8
34;2021-08-11;4832;6544;811324;674825;69.0;57.4
34;2021-08-12;4576;6201;815900;681026;69.4;57.9
34;2021-08-13;4111;5739;820011;686765;69.7;58.4
34;2021-08-14;1796;2881;821807;689646;69.9;58.6
34;2021-08-15;211;194;822018;689840;69.9;58.7
34;2021-08-16;2904;7551;824922;697391;70.1;59.3
34;2021-08-17;3595;8282;828517;705673;70.4;60.0
34;2021-08-18;3207;7564;831724;713237;70.7;60.6
34;2021-08-19;3272;7789;834996;721026;71.0;61.3
34;2021-08-20;2724;7722;837720;728748;71.2;62.0
34;2021-08-21;1414;3578;839134;732326;71.3;62.3
34;2021-08-22;163;308;839297;732634;71.4;62.3
34;2021-08-23;2330;8656;841627;741290;71.6;63.0
34;2021-08-24;2730;8962;844357;750252;71.8;63.8
34;2021-08-25;2346;8543;846703;758795;72.0;64.5
34;2021-08-26;2608;7890;849311;766685;72.2;65.2
34;2021-08-27;2198;7573;851509;774258;72.4;65.8
34;2021-08-28;1118;3561;852627;777819;72.5;66.1
34;2021-08-29;368;1357;852995;779176;72.5;66.2
34;2021-08-30;2054;6769;855049;785945;72.7;66.8
34;2021-08-31;2122;6583;857171;792528;72.9;67.4
34;2021-09-01;2062;5883;859233;798411;73.1;67.9
34;2021-09-02;1669;4090;860902;802501;73.2;68.2
34;2021-09-03;1777;4926;862679;807427;73.3;68.7
34;2021-09-04;1366;3090;864045;810517;73.5;68.9
34;2021-09-05;142;220;864187;810737;73.5;68.9
34;2021-09-06;1210;3172;865397;813909;73.6;69.2
34;2021-09-07;1383;3294;866780;817203;73.7;69.5
34;2021-09-08;1629;4074;868409;821277;73.8;69.8
34;2021-09-09;1194;3104;869603;824381;73.9;70.1
34;2021-09-10;1532;3302;871135;827683;74.1;70.4
34;2021-09-11;1285;1847;872420;829530;74.2;70.5
34;2021-09-12;92;81;872512;829611;74.2;70.5
34;2021-09-13;1006;2528;873518;832139;74.3;70.8
34;2021-09-14;1239;2272;874757;834411;74.4;70.9
34;2021-09-15;1487;2955;876244;837366;74.5;71.2
34;2021-09-16;886;1880;877130;839246;74.6;71.4
34;2021-09-17;1127;2415;878257;841661;74.7;71.6
34;2021-09-18;793;1763;879050;843424;74.7;71.7
34;2021-09-19;36;59;879086;843483;74.7;71.7
34;2021-09-20;618;1912;879704;845395;74.8;71.9
34;2021-09-21;612;1780;880316;847175;74.8;72.0
34;2021-09-22;838;2531;881154;849706;74.9;72.2
34;2021-09-23;670;1657;881824;851363;75.0;72.4
34;2021-09-24;843;2220;882667;853583;75.0;72.6
34;2021-09-25;492;1555;883159;855138;75.1;72.7
34;2021-09-26;51;142;883210;855280;75.1;72.7
34;2021-09-27;626;1484;883836;856764;75.1;72.8
34;2021-09-28;630;1129;884466;857893;75.2;72.9
34;2021-09-29;857;1812;885323;859705;75.3;73.1
34;2021-09-30;610;1351;885933;861056;75.3;73.2
34;2021-10-01;719;1501;886652;862557;75.4;73.3
34;2021-10-02;653;1390;887305;863947;75.4;73.5
34;2021-10-03;60;162;887365;864109;75.4;73.5
34;2021-10-04;597;1084;887962;865193;75.5;73.6
34;2021-10-05;531;1035;888493;866228;75.5;73.6
34;2021-10-06;840;1710;889333;867938;75.6;73.8
34;2021-10-07;549;1000;889882;868938;75.7;73.9
34;2021-10-08;846;1397;890728;870335;75.7;74.0
34;2021-10-09;580;1011;891308;871346;75.8;74.1
34;2021-10-10;66;73;891374;871419;75.8;74.1
34;2021-10-11;690;1061;892064;872480;75.8;74.2
34;2021-10-12;490;686;892554;873166;75.9;74.2
34;2021-10-13;618;1098;893172;874264;75.9;74.3
34;2021-10-14;482;629;893654;874893;76.0;74.4
35;2020-12-27;0;0;0;0;0.0;0.0
35;2020-12-28;0;0;0;0;0.0;0.0
35;2020-12-29;2;0;2;0;0.0;0.0
35;2020-12-30;0;0;2;0;0.0;0.0
35;2020-12-31;3;0;5;0;0.0;0.0
35;2021-01-01;3;0;8;0;0.0;0.0
35;2021-01-02;1;0;9;0;0.0;0.0
35;2021-01-03;0;0;9;0;0.0;0.0
35;2021-01-04;11;0;20;0;0.0;0.0
35;2021-01-05;110;0;130;0;0.0;0.0
35;2021-01-06;175;0;305;0;0.0;0.0
35;2021-01-07;440;1;745;1;0.1;0.0
35;2021-01-08;513;1;1258;2;0.1;0.0
35;2021-01-09;31;0;1289;2;0.1;0.0
35;2021-01-10;2;0;1291;2;0.1;0.0
35;2021-01-11;538;0;1829;2;0.2;0.0
35;2021-01-12;886;3;2715;5;0.3;0.0
35;2021-01-13;971;4;3686;9;0.3;0.0
35;2021-01-14;1261;18;4947;27;0.5;0.0
35;2021-01-15;732;3;5679;30;0.5;0.0
35;2021-01-16;189;3;5868;33;0.5;0.0
35;2021-01-17;44;0;5912;33;0.5;0.0
35;2021-01-18;1222;2;7134;35;0.7;0.0
35;2021-01-19;5408;18;12542;53;1.2;0.0
35;2021-01-20;3238;10;15780;63;1.5;0.0
35;2021-01-21;3644;17;19424;80;1.8;0.0
35;2021-01-22;2087;10;21511;90;2.0;0.0
35;2021-01-23;421;1;21932;91;2.0;0.0
35;2021-01-24;51;0;21983;91;2.0;0.0
35;2021-01-25;918;17;22901;108;2.1;0.0
35;2021-01-26;1130;142;24031;250;2.2;0.0
35;2021-01-27;1029;125;25060;375;2.3;0.0
35;2021-01-28;916;298;25976;673;2.4;0.1
35;2021-01-29;725;290;26701;963;2.5;0.1
35;2021-01-30;140;19;26841;982;2.5;0.1
35;2021-01-31;0;0;26841;982;2.5;0.1
35;2021-02-01;673;333;27514;1315;2.5;0.1
35;2021-02-02;725;483;28239;1798;2.6;0.2
35;2021-02-03;662;506;28901;2304;2.7;0.2
35;2021-02-04;590;657;29491;2961;2.7;0.3
35;2021-02-05;624;563;30115;3524;2.8;0.3
35;2021-02-06;175;8;30290;3532;2.8;0.3
35;2021-02-07;1;0;30291;3532;2.8;0.3
35;2021-02-08;446;653;30737;4185;2.8;0.4
35;2021-02-09;1715;3559;32452;7744;3.0;0.7
35;2021-02-10;1370;2728;33822;10472;3.1;1.0
35;2021-02-11;1945;3236;35767;13708;3.3;1.3
35;2021-02-12;1663;1730;37430;15438;3.5;1.4
35;2021-02-13;58;254;37488;15692;3.5;1.5
35;2021-02-14;8;69;37496;15761;3.5;1.5
35;2021-02-15;771;1099;38267;16860;3.5;1.6
35;2021-02-16;920;1020;39187;17880;3.6;1.7
35;2021-02-17;895;1087;40082;18967;3.7;1.8
35;2021-02-18;1020;996;41102;19963;3.8;1.8
35;2021-02-19;1013;968;42115;20931;3.9;1.9
35;2021-02-20;143;49;42258;20980;3.9;1.9
35;2021-02-21;5;0;42263;20980;3.9;1.9
35;2021-02-22;776;831;43039;21811;4.0;2.0
35;2021-02-23;1288;868;44327;22679;4.1;2.1
35;2021-02-24;1404;815;45731;23494;4.2;2.2
35;2021-02-25;2249;790;47980;24284;4.4;2.2
35;2021-02-26;2599;736;50579;25020;4.7;2.3
35;2021-02-27;869;104;51448;25124;4.8;2.3
35;2021-02-28;10;1;51458;25125;4.8;2.3
35;2021-03-01;959;691;52417;25816;4.8;2.4
35;2021-03-02;1634;1995;54051;27811;5.0;2.6
35;2021-03-03;1914;972;55965;28783;5.2;2.7
35;2021-03-04;2916;1418;58881;30201;5.4;2.8
35;2021-03-05;3715;1352;62596;31553;5.8;2.9
35;2021-03-06;1337;87;63933;31640;5.9;2.9
35;2021-03-07;1;40;63934;31680;5.9;2.9
35;2021-03-08;1475;589;65409;32269;6.0;3.0
35;2021-03-09;3238;620;68647;32889;6.3;3.0
35;2021-03-10;2902;566;71549;33455;6.6;3.1
35;2021-03-11;4199;727;75748;34182;7.0;3.2
35;2021-03-12;6049;571;81797;34753;7.6;3.2
35;2021-03-13;2428;136;84225;34889;7.8;3.2
35;2021-03-14;18;25;84243;34914;7.8;3.2
35;2021-03-15;1966;676;86209;35590;8.0;3.3
35;2021-03-16;2505;734;88714;36324;8.2;3.4
35;2021-03-17;2397;603;91111;36927;8.4;3.4
35;2021-03-18;2334;599;93445;37526;8.6;3.5
35;2021-03-19;3547;514;96992;38040;9.0;3.5
35;2021-03-20;1543;114;98535;38154;9.1;3.5
35;2021-03-21;38;1;98573;38155;9.1;3.5
35;2021-03-22;1749;844;100322;38999;9.3;3.6
35;2021-03-23;3626;1187;103948;40186;9.6;3.7
35;2021-03-24;3730;993;107678;41179;10.0;3.8
35;2021-03-25;5328;1012;113006;42191;10.4;3.9
35;2021-03-26;5853;824;118859;43015;11.0;4.0
35;2021-03-27;1416;211;120275;43226;11.1;4.0
35;2021-03-28;4;0;120279;43226;11.1;4.0
35;2021-03-29;2778;912;123057;44138;11.4;4.1
35;2021-03-30;4292;1338;127349;45476;11.8;4.2
35;2021-03-31;3471;1349;130820;46825;12.1;4.3
35;2021-04-01;4250;1244;135070;48069;12.5;4.4
35;2021-04-02;4861;1215;139931;49284;12.9;4.6
35;2021-04-03;763;216;140694;49500;13.0;4.6
35;2021-04-04;6;0;140700;49500;13.0;4.6
35;2021-04-05;24;2;140724;49502;13.0;4.6
35;2021-04-06;3279;2032;144003;51534;13.3;4.8
35;2021-04-07;3967;1847;147970;53381;13.7;4.9
35;2021-04-08;5803;1597;153773;54978;14.2;5.1
35;2021-04-09;7431;1430;161204;56408;14.9;5.2
35;2021-04-10;1860;255;163064;56663;15.1;5.2
35;2021-04-11;35;23;163099;56686;15.1;5.2
35;2021-04-12;5137;1603;168236;58289;15.5;5.4
35;2021-04-13;7625;2793;175861;61082;16.3;5.6
35;2021-04-14;6315;2306;182176;63388;16.8;5.9
35;2021-04-15;7565;2189;189741;65577;17.5;6.1
35;2021-04-16;8081;1766;197822;67343;18.3;6.2
35;2021-04-17;1571;223;199393;67566;18.4;6.2
35;2021-04-18;10;4;199403;67570;18.4;6.2
35;2021-04-19;4819;1674;204222;69244;18.9;6.4
35;2021-04-20;5165;2648;209387;71892;19.4;6.6
35;2021-04-21;5134;2218;214521;74110;19.8;6.8
35;2021-04-22;6429;2334;220950;76444;20.4;7.1
35;2021-04-23;6821;2374;227771;78818;21.0;7.3
35;2021-04-24;1132;265;228903;79083;21.2;7.3
35;2021-04-25;8;16;228911;79099;21.2;7.3
35;2021-04-26;5099;2163;234010;81262;21.6;7.5
35;2021-04-27;6090;3213;240100;84475;22.2;7.8
35;2021-04-28;6173;2572;246273;87047;22.8;8.0
35;2021-04-29;7117;2769;253390;89816;23.4;8.3
35;2021-04-30;7564;2551;260954;92367;24.1;8.5
35;2021-05-01;618;239;261572;92606;24.2;8.6
35;2021-05-02;15;21;261587;92627;24.2;8.6
35;2021-05-03;5307;2335;266894;94962;24.7;8.8
35;2021-05-04;5066;5344;271960;100306;25.1;9.3
35;2021-05-05;4881;4450;276841;104756;25.6;9.7
35;2021-05-06;6176;5280;283017;110036;26.2;10.2
35;2021-05-07;5620;5251;288637;115287;26.7;10.7
35;2021-05-08;1719;136;290356;115423;26.8;10.7
35;2021-05-09;698;75;291054;115498;26.9;10.7
35;2021-05-10;3719;4954;294773;120452;27.2;11.1
35;2021-05-11;4774;5810;299547;126262;27.7;11.7
35;2021-05-12;5292;5501;304839;131763;28.2;12.2
35;2021-05-13;2699;1424;307538;133187;28.4;12.3
35;2021-05-14;5460;4334;312998;137521;28.9;12.7
35;2021-05-15;2929;718;315927;138239;29.2;12.8
35;2021-05-16;997;61;316924;138300;29.3;12.8
35;2021-05-17;4474;3882;321398;142182;29.7;13.1
35;2021-05-18;5839;4329;327237;146511;30.2;13.5
35;2021-05-19;5866;3633;333103;150144;30.8;13.9
35;2021-05-20;6448;4009;339551;154153;31.4;14.2
35;2021-05-21;6140;4771;345691;158924;31.9;14.7
35;2021-05-22;2118;739;347809;159663;32.1;14.8
35;2021-05-23;688;46;348497;159709;32.2;14.8
35;2021-05-24;3206;1298;351703;161007;32.5;14.9
35;2021-05-25;5541;4278;357244;165285;33.0;15.3
35;2021-05-26;5721;4166;362965;169451;33.5;15.7
35;2021-05-27;6527;4778;369492;174229;34.1;16.1
35;2021-05-28;6330;5573;375822;179802;34.7;16.6
35;2021-05-29;2873;1147;378695;180949;35.0;16.7
35;2021-05-30;878;39;379573;180988;35.1;16.7
35;2021-05-31;6309;4393;385882;185381;35.7;17.1
35;2021-06-01;7365;5124;393247;190505;36.3;17.6
35;2021-06-02;7219;3798;400466;194303;37.0;18.0
35;2021-06-03;8156;4999;408622;199302;37.8;18.4
35;2021-06-04;7274;7468;415896;206770;38.4;19.1
35;2021-06-05;4138;1588;420034;208358;38.8;19.3
35;2021-06-06;3053;147;423087;208505;39.1;19.3
35;2021-06-07;5782;5778;428869;214283;39.6;19.8
35;2021-06-08;7603;5956;436472;220239;40.3;20.4
35;2021-06-09;8461;4818;444933;225057;41.1;20.8
35;2021-06-10;9346;4752;454279;229809;42.0;21.2
35;2021-06-11;8632;7472;462911;237281;42.8;21.9
35;2021-06-12;4684;1209;467595;238490;43.2;22.0
35;2021-06-13;3386;227;470981;238717;43.5;22.1
35;2021-06-14;6231;6519;477212;245236;44.1;22.7
35;2021-06-15;7504;6966;484716;252202;44.8;23.3
35;2021-06-16;8323;5626;493039;257828;45.6;23.8
35;2021-06-17;8898;5912;501937;263740;46.4;24.4
35;2021-06-18;8718;8098;510655;271838;47.2;25.1
35;2021-06-19;1504;2510;512159;274348;47.3;25.4
35;2021-06-20;2953;883;515112;275231;47.6;25.4
35;2021-06-21;5930;6378;521042;281609;48.2;26.0
35;2021-06-22;6841;7500;527883;289109;48.8;26.7
35;2021-06-23;7254;6144;535137;295253;49.5;27.3
35;2021-06-24;8367;5925;543504;301178;50.2;27.8
35;2021-06-25;6627;8481;550131;309659;50.8;28.6
35;2021-06-26;1107;3077;551238;312736;50.9;28.9
35;2021-06-27;2635;1031;553873;313767;51.2;29.0
35;2021-06-28;4298;7761;558171;321528;51.6;29.7
35;2021-06-29;5090;7973;563261;329501;52.1;30.5
35;2021-06-30;5602;7897;568863;337398;52.6;31.2
35;2021-07-01;6588;7551;575451;344949;53.2;31.9
35;2021-07-02;5333;9862;580784;354811;53.7;32.8
35;2021-07-03;1083;2839;581867;357650;53.8;33.1
35;2021-07-04;2149;1554;584016;359204;54.0;33.2
35;2021-07-05;3735;8209;587751;367413;54.3;34.0
35;2021-07-06;4787;9478;592538;376891;54.8;34.8
35;2021-07-07;5060;8323;597598;385214;55.2;35.6
35;2021-07-08;5386;8490;602984;393704;55.7;36.4
35;2021-07-09;3907;11548;606891;405252;56.1;37.5
35;2021-07-10;892;3148;607783;408400;56.2;37.7
35;2021-07-11;1300;2355;609083;410755;56.3;38.0
35;2021-07-12;3121;9145;612204;419900;56.6;38.8
35;2021-07-13;3981;10749;616185;430649;56.9;39.8
35;2021-07-14;2154;4452;618339;435101;57.1;40.2
35;2021-07-15;4293;10181;622632;445282;57.5;41.2
35;2021-07-16;4802;11009;627434;456291;58.0;42.2
35;2021-07-17;1988;4064;629422;460355;58.2;42.5
35;2021-07-18;844;2571;630266;462926;58.2;42.8
35;2021-07-19;3251;8974;633517;471900;58.5;43.6
35;2021-07-20;4242;10592;637759;482492;58.9;44.6
35;2021-07-21;4372;9388;642131;491880;59.3;45.5
35;2021-07-22;4852;9657;646983;501537;59.8;46.3
35;2021-07-23;4564;11012;651547;512549;60.2;47.4
35;2021-07-24;1587;4267;653134;516816;60.4;47.8
35;2021-07-25;815;2846;653949;519662;60.4;48.0
35;2021-07-26;3893;8737;657842;528399;60.8;48.8
35;2021-07-27;5281;9659;663123;538058;61.3;49.7
35;2021-07-28;5318;8673;668441;546731;61.8;50.5
35;2021-07-29;6114;8342;674555;555073;62.3;51.3
35;2021-07-30;5904;9084;680459;564157;62.9;52.1
35;2021-07-31;2322;3656;682781;567813;63.1;52.5
35;2021-08-01;1526;2415;684307;570228;63.2;52.7
35;2021-08-02;4757;6949;689064;577177;63.7;53.3
35;2021-08-03;6712;7582;695776;584759;64.3;54.0
35;2021-08-04;6714;6594;702490;591353;64.9;54.7
35;2021-08-05;6687;6985;709177;598338;65.5;55.3
35;2021-08-06;6067;7322;715244;605660;66.1;56.0
35;2021-08-07;2109;3151;717353;608811;66.3;56.3
35;2021-08-08;1523;2257;718876;611068;66.4;56.5
35;2021-08-09;4617;5535;723493;616603;66.9;57.0
35;2021-08-10;6565;6381;730058;622984;67.5;57.6
35;2021-08-11;6474;5865;736532;628849;68.1;58.1
35;2021-08-12;7013;5586;743545;634435;68.7;58.6
35;2021-08-13;6697;5068;750242;639503;69.3;59.1
35;2021-08-14;3049;1985;753291;641488;69.6;59.3
35;2021-08-15;2471;1261;755762;642749;69.8;59.4
35;2021-08-16;4871;5296;760633;648045;70.3;59.9
35;2021-08-17;6408;6082;767041;654127;70.9;60.5
35;2021-08-18;6487;5633;773528;659760;71.5;61.0
35;2021-08-19;6302;5765;779830;665525;72.1;61.5
35;2021-08-20;5134;6350;784964;671875;72.5;62.1
35;2021-08-21;2384;2634;787348;674509;72.8;62.3
35;2021-08-22;1765;1797;789113;676306;72.9;62.5
35;2021-08-23;3105;6013;792218;682319;73.2;63.1
35;2021-08-24;3503;7221;795721;689540;73.5;63.7
35;2021-08-25;3314;6616;799035;696156;73.8;64.3
35;2021-08-26;2641;6895;801676;703051;74.1;65.0
35;2021-08-27;2784;7261;804460;710312;74.3;65.6
35;2021-08-28;1179;2954;805639;713266;74.5;65.9
35;2021-08-29;517;1760;806156;715026;74.5;66.1
35;2021-08-30;1978;5389;808134;720415;74.7;66.6
35;2021-08-31;2389;6360;810523;726775;74.9;67.2
35;2021-09-01;1924;5760;812447;732535;75.1;67.7
35;2021-09-02;1845;5752;814292;738287;75.3;68.2
35;2021-09-03;2032;6631;816324;744918;75.4;68.8
35;2021-09-04;1134;4010;817458;748928;75.5;69.2
35;2021-09-05;517;2007;817975;750935;75.6;69.4
35;2021-09-06;1139;4592;819114;755527;75.7;69.8
35;2021-09-07;1326;4868;820440;760395;75.8;70.3
35;2021-09-08;1336;5819;821776;766214;75.9;70.8
35;2021-09-09;1263;4845;823039;771059;76.1;71.3
35;2021-09-10;1588;5976;824627;777035;76.2;71.8
35;2021-09-11;625;3798;825252;780833;76.3;72.2
35;2021-09-12;285;2324;825537;783157;76.3;72.4
35;2021-09-13;1325;3834;826862;786991;76.4;72.7
35;2021-09-14;1385;3397;828247;790388;76.5;73.0
35;2021-09-15;1233;4596;829480;794984;76.7;73.5
35;2021-09-16;1131;2853;830611;797837;76.8;73.7
35;2021-09-17;1278;3896;831889;801733;76.9;74.1
35;2021-09-18;518;2877;832407;804610;76.9;74.4
35;2021-09-19;168;1020;832575;805630;76.9;74.5
35;2021-09-20;1154;2649;833729;808279;77.0;74.7
35;2021-09-21;666;1926;834395;810205;77.1;74.9
35;2021-09-22;858;3625;835253;813830;77.2;75.2
35;2021-09-23;565;1532;835818;815362;77.2;75.4
35;2021-09-24;973;3039;836791;818401;77.3;75.6
35;2021-09-25;421;1958;837212;820359;77.4;75.8
35;2021-09-26;16;164;837228;820523;77.4;75.8
35;2021-09-27;518;1626;837746;822149;77.4;76.0
35;2021-09-28;463;1185;838209;823334;77.5;76.1
35;2021-09-29;610;1982;838819;825316;77.5;76.3
35;2021-09-30;352;835;839171;826151;77.6;76.3
35;2021-10-01;810;2166;839981;828317;77.6;76.5
35;2021-10-02;359;1135;840340;829452;77.7;76.7
35;2021-10-03;2;12;840342;829464;77.7;76.7
35;2021-10-04;514;1011;840856;830475;77.7;76.7
35;2021-10-05;433;984;841289;831459;77.7;76.8
35;2021-10-06;604;1332;841893;832791;77.8;77.0
35;2021-10-07;379;980;842272;833771;77.8;77.1
35;2021-10-08;697;2073;842969;835844;77.9;77.2
35;2021-10-09;373;881;843342;836725;77.9;77.3
35;2021-10-10;0;4;843342;836729;77.9;77.3
35;2021-10-11;428;918;843770;837647;78.0;77.4
35;2021-10-12;405;736;844175;838383;78.0;77.5
35;2021-10-13;511;829;844686;839212;78.1;77.6
35;2021-10-14;350;648;845036;839860;78.1;77.6
36;2020-12-27;0;0;0;0;0.0;0.0
36;2020-12-28;0;0;0;0;0.0;0.0
36;2020-12-29;0;0;0;0;0.0;0.0
36;2020-12-30;0;0;0;0;0.0;0.0
36;2020-12-31;0;0;0;0;0.0;0.0
36;2021-01-01;0;0;0;0;0.0;0.0
36;2021-01-02;0;0;0;0;0.0;0.0
36;2021-01-03;0;0;0;0;0.0;0.0
36;2021-01-04;2;0;2;0;0.0;0.0
36;2021-01-05;0;0;2;0;0.0;0.0
36;2021-01-06;24;0;26;0;0.0;0.0
36;2021-01-07;51;0;77;0;0.0;0.0
36;2021-01-08;111;0;188;0;0.1;0.0
36;2021-01-09;84;0;272;0;0.1;0.0
36;2021-01-10;142;0;414;0;0.2;0.0
36;2021-01-11;240;1;654;1;0.3;0.0
36;2021-01-12;282;0;936;1;0.4;0.0
36;2021-01-13;198;1;1134;2;0.5;0.0
36;2021-01-14;506;4;1640;6;0.8;0.0
36;2021-01-15;179;1;1819;7;0.8;0.0
36;2021-01-16;24;1;1843;8;0.8;0.0
36;2021-01-17;19;1;1862;9;0.9;0.0
36;2021-01-18;611;5;2473;14;1.1;0.0
36;2021-01-19;1173;2;3646;16;1.7;0.0
36;2021-01-20;1102;4;4748;20;2.2;0.0
36;2021-01-21;721;1;5469;21;2.5;0.0
36;2021-01-22;858;2;6327;23;2.9;0.0
36;2021-01-23;294;0;6621;23;3.0;0.0
36;2021-01-24;185;1;6806;24;3.1;0.0
36;2021-01-25;640;5;7446;29;3.4;0.0
36;2021-01-26;609;1;8055;30;3.7;0.0
36;2021-01-27;853;20;8908;50;4.1;0.0
36;2021-01-28;478;44;9386;94;4.3;0.0
36;2021-01-29;573;96;9959;190;4.6;0.1
36;2021-01-30;288;71;10247;261;4.7;0.1
36;2021-01-31;115;130;10362;391;4.8;0.2
36;2021-02-01;379;100;10741;491;4.9;0.2
36;2021-02-02;410;175;11151;666;5.1;0.3
36;2021-02-03;473;264;11624;930;5.4;0.4
36;2021-02-04;275;272;11899;1202;5.5;0.6
36;2021-02-05;301;164;12200;1366;5.6;0.6
36;2021-02-06;1;0;12201;1366;5.6;0.6
36;2021-02-07;1;0;12202;1366;5.6;0.6
36;2021-02-08;280;258;12482;1624;5.7;0.7
36;2021-02-09;328;605;12810;2229;5.9;1.0
36;2021-02-10;491;656;13301;2885;6.1;1.3
36;2021-02-11;384;593;13685;3478;6.3;1.6
36;2021-02-12;303;459;13988;3937;6.4;1.8
36;2021-02-13;126;80;14114;4017;6.5;1.8
36;2021-02-14;22;43;14136;4060;6.5;1.9
36;2021-02-15;42;575;14178;4635;6.5;2.1
36;2021-02-16;107;412;14285;5047;6.6;2.3
36;2021-02-17;117;622;14402;5669;6.6;2.6
36;2021-02-18;161;616;14563;6285;6.7;2.9
36;2021-02-19;181;540;14744;6825;6.8;3.1
36;2021-02-20;86;239;14830;7064;6.8;3.3
36;2021-02-21;87;156;14917;7220;6.9;3.3
36;2021-02-22;162;512;15079;7732;6.9;3.6
36;2021-02-23;62;574;15141;8306;7.0;3.8
36;2021-02-24;110;680;15251;8986;7.0;4.1
36;2021-02-25;251;281;15502;9267;7.1;4.3
36;2021-02-26;339;468;15841;9735;7.3;4.5
36;2021-02-27;73;277;15914;10012;7.3;4.6
36;2021-02-28;13;97;15927;10109;7.3;4.7
36;2021-03-01;218;341;16145;10450;7.4;4.8
36;2021-03-02;352;367;16497;10817;7.6;5.0
36;2021-03-03;394;532;16891;11349;7.8;5.2
36;2021-03-04;662;358;17553;11707;8.1;5.4
36;2021-03-05;800;298;18353;12005;8.5;5.5
36;2021-03-06;410;18;18763;12023;8.6;5.5
36;2021-03-07;339;9;19102;12032;8.8;5.5
36;2021-03-08;251;316;19353;12348;8.9;5.7
36;2021-03-09;449;270;19802;12618;9.1;5.8
36;2021-03-10;724;409;20526;13027;9.5;6.0
36;2021-03-11;840;246;21366;13273;9.8;6.1
36;2021-03-12;1446;300;22812;13573;10.5;6.3
36;2021-03-13;576;129;23388;13702;10.8;6.3
36;2021-03-14;113;1;23501;13703;10.8;6.3
36;2021-03-15;648;158;24149;13861;11.1;6.4
36;2021-03-16;445;67;24594;13928;11.3;6.4
36;2021-03-17;766;92;25360;14020;11.7;6.5
36;2021-03-18;414;72;25774;14092;11.9;6.5
36;2021-03-19;737;40;26511;14132;12.2;6.5
36;2021-03-20;450;27;26961;14159;12.4;6.5
36;2021-03-21;0;0;26961;14159;12.4;6.5
36;2021-03-22;497;60;27458;14219;12.6;6.5
36;2021-03-23;777;60;28235;14279;13.0;6.6
36;2021-03-24;1089;78;29324;14357;13.5;6.6
36;2021-03-25;1339;90;30663;14447;14.1;6.7
36;2021-03-26;1418;158;32081;14605;14.8;6.7
36;2021-03-27;475;43;32556;14648;15.0;6.7
36;2021-03-28;68;57;32624;14705;15.0;6.8
36;2021-03-29;462;187;33086;14892;15.2;6.9
36;2021-03-30;583;263;33669;15155;15.5;7.0
36;2021-03-31;1262;172;34931;15327;16.1;7.1
36;2021-04-01;1086;432;36017;15759;16.6;7.3
36;2021-04-02;966;144;36983;15903;17.0;7.3
36;2021-04-03;282;195;37265;16098;17.2;7.4
36;2021-04-04;42;2;37307;16100;17.2;7.4
36;2021-04-05;15;46;37322;16146;17.2;7.4
36;2021-04-06;820;362;38142;16508;17.6;7.6
36;2021-04-07;1072;545;39214;17053;18.1;7.9
36;2021-04-08;1347;481;40561;17534;18.7;8.1
36;2021-04-09;1936;406;42497;17940;19.6;8.3
36;2021-04-10;591;243;43088;18183;19.8;8.4
36;2021-04-11;256;90;43344;18273;20.0;8.4
36;2021-04-12;848;561;44192;18834;20.4;8.7
36;2021-04-13;1140;519;45332;19353;20.9;8.9
36;2021-04-14;1582;866;46914;20219;21.6;9.3
36;2021-04-15;1654;474;48568;20693;22.4;9.5
36;2021-04-16;1486;470;50054;21163;23.1;9.7
36;2021-04-17;893;251;50947;21414;23.5;9.9
36;2021-04-18;383;7;51330;21421;23.6;9.9
36;2021-04-19;874;444;52204;21865;24.0;10.1
36;2021-04-20;1145;524;53349;22389;24.6;10.3
36;2021-04-21;1240;881;54589;23270;25.1;10.7
36;2021-04-22;1593;873;56182;24143;25.9;11.1
36;2021-04-23;1329;618;57511;24761;26.5;11.4
36;2021-04-24;677;380;58188;25141;26.8;11.6
36;2021-04-25;413;95;58601;25236;27.0;11.6
36;2021-04-26;1134;450;59735;25686;27.5;11.8
36;2021-04-27;1278;553;61013;26239;28.1;12.1
36;2021-04-28;1488;1065;62501;27304;28.8;12.6
36;2021-04-29;2016;715;64517;28019;29.7;12.9
36;2021-04-30;1553;458;66070;28477;30.4;13.1
36;2021-05-01;724;64;66794;28541;30.8;13.1
36;2021-05-02;498;64;67292;28605;31.0;13.2
36;2021-05-03;1293;320;68585;28925;31.6;13.3
36;2021-05-04;780;805;69365;29730;31.9;13.7
36;2021-05-05;1282;1306;70647;31036;32.5;14.3
36;2021-05-06;2137;797;72784;31833;33.5;14.7
36;2021-05-07;1469;771;74253;32604;34.2;15.0
36;2021-05-08;306;105;74559;32709;34.3;15.1
36;2021-05-09;174;343;74733;33052;34.4;15.2
36;2021-05-10;1216;818;75949;33870;35.0;15.6
36;2021-05-11;1725;1251;77674;35121;35.8;16.2
36;2021-05-12;1827;1487;79501;36608;36.6;16.9
36;2021-05-13;548;304;80049;36912;36.9;17.0
36;2021-05-14;701;1037;80750;37949;37.2;17.5
36;2021-05-15;635;592;81385;38541;37.5;17.7
36;2021-05-16;337;377;81722;38918;37.6;17.9
36;2021-05-17;615;944;82337;39862;37.9;18.4
36;2021-05-18;874;937;83211;40799;38.3;18.8
36;2021-05-19;1333;845;84544;41644;38.9;19.2
36;2021-05-20;1611;1209;86155;42853;39.7;19.7
36;2021-05-21;1106;1070;87261;43923;40.2;20.2
36;2021-05-22;678;342;87939;44265;40.5;20.4
36;2021-05-23;428;297;88367;44562;40.7;20.5
36;2021-05-24;506;469;88873;45031;40.9;20.7
36;2021-05-25;1045;686;89918;45717;41.4;21.1
36;2021-05-26;1472;1165;91390;46882;42.1;21.6
36;2021-05-27;1398;977;92788;47859;42.7;22.0
36;2021-05-28;921;1480;93709;49339;43.2;22.7
36;2021-05-29;700;507;94409;49846;43.5;23.0
36;2021-05-30;111;572;94520;50418;43.5;23.2
36;2021-05-31;1137;764;95657;51182;44.1;23.6
36;2021-06-01;1413;830;97070;52012;44.7;24.0
36;2021-06-02;2062;614;99132;52626;45.7;24.2
36;2021-06-03;1902;1201;101034;53827;46.5;24.8
36;2021-06-04;1772;1045;102806;54872;47.3;25.3
36;2021-06-05;693;658;103499;55530;47.7;25.6
36;2021-06-06;336;272;103835;55802;47.8;25.7
36;2021-06-07;983;808;104818;56610;48.3;26.1
36;2021-06-08;957;981;105775;57591;48.7;26.5
36;2021-06-09;1675;1071;107450;58662;49.5;27.0
36;2021-06-10;1530;1382;108980;60044;50.2;27.7
36;2021-06-11;1288;1499;110268;61543;50.8;28.3
36;2021-06-12;921;784;111189;62327;51.2;28.7
36;2021-06-13;343;269;111532;62596;51.4;28.8
36;2021-06-14;605;1269;112137;63865;51.6;29.4
36;2021-06-15;733;1215;112870;65080;52.0;30.0
36;2021-06-16;903;1519;113773;66599;52.4;30.7
36;2021-06-17;749;1904;114522;68503;52.7;31.5
36;2021-06-18;706;1879;115228;70382;53.1;32.4
36;2021-06-19;295;395;115523;70777;53.2;32.6
36;2021-06-20;235;327;115758;71104;53.3;32.7
36;2021-06-21;692;1449;116450;72553;53.6;33.4
36;2021-06-22;841;1552;117291;74105;54.0;34.1
36;2021-06-23;774;1791;118065;75896;54.4;35.0
36;2021-06-24;855;1522;118920;77418;54.8;35.7
36;2021-06-25;942;1221;119862;78639;55.2;36.2
36;2021-06-26;324;602;120186;79241;55.3;36.5
36;2021-06-27;105;267;120291;79508;55.4;36.6
36;2021-06-28;696;923;120987;80431;55.7;37.0
36;2021-06-29;688;1459;121675;81890;56.0;37.7
36;2021-06-30;836;2149;122511;84039;56.4;38.7
36;2021-07-01;353;1081;122864;85120;56.6;39.2
36;2021-07-02;749;1843;123613;86963;56.9;40.0
36;2021-07-03;465;885;124078;87848;57.1;40.5
36;2021-07-04;185;326;124263;88174;57.2;40.6
36;2021-07-05;493;1335;124756;89509;57.5;41.2
36;2021-07-06;491;1220;125247;90729;57.7;41.8
36;2021-07-07;586;1791;125833;92520;58.0;42.6
36;2021-07-08;549;1707;126382;94227;58.2;43.4
36;2021-07-09;786;1654;127168;95881;58.6;44.2
36;2021-07-10;469;1119;127637;97000;58.8;44.7
36;2021-07-11;257;154;127894;97154;58.9;44.7
36;2021-07-12;332;1628;128226;98782;59.1;45.5
36;2021-07-13;311;1936;128537;100718;59.2;46.4
36;2021-07-14;376;763;128913;101481;59.4;46.7
36;2021-07-15;917;2165;129830;103646;59.8;47.7
36;2021-07-16;628;1873;130458;105519;60.1;48.6
36;2021-07-17;400;859;130858;106378;60.3;49.0
36;2021-07-18;199;408;131057;106786;60.4;49.2
36;2021-07-19;552;1456;131609;108242;60.6;49.8
36;2021-07-20;776;1407;132385;109649;61.0;50.5
36;2021-07-21;713;1984;133098;111633;61.3;51.4
36;2021-07-22;1138;1687;134236;113320;61.8;52.2
36;2021-07-23;968;1746;135204;115066;62.3;53.0
36;2021-07-24;605;801;135809;115867;62.5;53.4
36;2021-07-25;148;404;135957;116271;62.6;53.5
36;2021-07-26;948;1086;136905;117357;63.0;54.0
36;2021-07-27;816;1355;137721;118712;63.4;54.7
36;2021-07-28;1385;1402;139106;120114;64.1;55.3
36;2021-07-29;1708;1310;140814;121424;64.8;55.9
36;2021-07-30;1445;1322;142259;122746;65.5;56.5
36;2021-07-31;933;537;143192;123283;65.9;56.8
36;2021-08-01;210;239;143402;123522;66.0;56.9
36;2021-08-02;1116;893;144518;124415;66.6;57.3
36;2021-08-03;1271;999;145789;125414;67.1;57.8
36;2021-08-04;1695;940;147484;126354;67.9;58.2
36;2021-08-05;1825;911;149309;127265;68.8;58.6
36;2021-08-06;1418;877;150727;128142;69.4;59.0
36;2021-08-07;541;527;151268;128669;69.7;59.3
36;2021-08-08;292;153;151560;128822;69.8;59.3
36;2021-08-09;817;846;152377;129668;70.2;59.7
36;2021-08-10;1067;1012;153444;130680;70.7;60.2
36;2021-08-11;1356;858;154800;131538;71.3;60.6
36;2021-08-12;1161;854;155961;132392;71.8;61.0
36;2021-08-13;1193;778;157154;133170;72.4;61.3
36;2021-08-14;426;836;157580;134006;72.6;61.7
36;2021-08-15;365;113;157945;134119;72.7;61.8
36;2021-08-16;606;954;158551;135073;73.0;62.2
36;2021-08-17;766;1002;159317;136075;73.4;62.7
36;2021-08-18;1039;1164;160356;137239;73.8;63.2
36;2021-08-19;840;1178;161196;138417;74.2;63.7
36;2021-08-20;489;1481;161685;139898;74.5;64.4
36;2021-08-21;309;468;161994;140366;74.6;64.6
36;2021-08-22;27;65;162021;140431;74.6;64.7
36;2021-08-23;551;1179;162572;141610;74.9;65.2
36;2021-08-24;589;1204;163161;142814;75.1;65.8
36;2021-08-25;466;1094;163627;143908;75.4;66.3
36;2021-08-26;666;1480;164293;145388;75.7;67.0
36;2021-08-27;529;1409;164822;146797;75.9;67.6
36;2021-08-28;368;580;165190;147377;76.1;67.9
36;2021-08-29;222;241;165412;147618;76.2;68.0
36;2021-08-30;246;726;165658;148344;76.3;68.3
36;2021-08-31;387;833;166045;149177;76.5;68.7
36;2021-09-01;388;1060;166433;150237;76.6;69.2
36;2021-09-02;324;910;166757;151147;76.8;69.6
36;2021-09-03;297;1362;167054;152509;76.9;70.2
36;2021-09-04;248;781;167302;153290;77.0;70.6
36;2021-09-05;119;327;167421;153617;77.1;70.7
36;2021-09-06;150;872;167571;154489;77.2;71.1
36;2021-09-07;192;690;167763;155179;77.3;71.5
36;2021-09-08;236;1121;167999;156300;77.4;72.0
36;2021-09-09;293;834;168292;157134;77.5;72.4
36;2021-09-10;270;951;168562;158085;77.6;72.8
36;2021-09-11;165;724;168727;158809;77.7;73.1
36;2021-09-12;82;190;168809;158999;77.7;73.2
36;2021-09-13;168;550;168977;159549;77.8;73.5
36;2021-09-14;170;439;169147;159988;77.9;73.7
36;2021-09-15;303;569;169450;160557;78.0;73.9
36;2021-09-16;252;670;169702;161227;78.2;74.3
36;2021-09-17;256;567;169958;161794;78.3;74.5
36;2021-09-18;123;427;170081;162221;78.3;74.7
36;2021-09-19;43;214;170124;162435;78.3;74.8
36;2021-09-20;131;325;170255;162760;78.4;75.0
36;2021-09-21;132;300;170387;163060;78.5;75.1
36;2021-09-22;119;674;170506;163734;78.5;75.4
36;2021-09-23;135;438;170641;164172;78.6;75.6
36;2021-09-24;128;497;170769;164669;78.6;75.8
36;2021-09-25;119;502;170888;165171;78.7;76.1
36;2021-09-26;15;318;170903;165489;78.7;76.2
36;2021-09-27;66;224;170969;165713;78.7;76.3
36;2021-09-28;69;233;171038;165946;78.8;76.4
36;2021-09-29;107;387;171145;166333;78.8;76.6
36;2021-09-30;110;252;171255;166585;78.9;76.7
36;2021-10-01;163;308;171418;166893;78.9;76.9
36;2021-10-02;43;183;171461;167076;79.0;76.9
36;2021-10-03;4;23;171465;167099;79.0;77.0
36;2021-10-04;54;195;171519;167294;79.0;77.0
36;2021-10-05;115;163;171634;167457;79.0;77.1
36;2021-10-06;99;293;171733;167750;79.1;77.3
36;2021-10-07;84;204;171817;167954;79.1;77.3
36;2021-10-08;131;269;171948;168223;79.2;77.5
36;2021-10-09;83;208;172031;168431;79.2;77.6
36;2021-10-10;4;11;172035;168442;79.2;77.6
36;2021-10-11;87;141;172122;168583;79.3;77.6
36;2021-10-12;79;94;172201;168677;79.3;77.7
36;2021-10-13;149;249;172350;168926;79.4;77.8
36;2021-10-14;50;56;172400;168982;79.4;77.8
37;2020-12-27;1;0;1;0;0.0;0.0
37;2020-12-28;17;0;18;0;0.0;0.0
37;2020-12-29;10;0;28;0;0.0;0.0
37;2020-12-30;0;0;28;0;0.0;0.0
37;2020-12-31;0;0;28;0;0.0;0.0
37;2021-01-01;0;0;28;0;0.0;0.0
37;2021-01-02;0;0;28;0;0.0;0.0
37;2021-01-03;2;0;30;0;0.0;0.0
37;2021-01-04;23;0;53;0;0.0;0.0
37;2021-01-05;47;0;100;0;0.0;0.0
37;2021-01-06;79;0;179;0;0.0;0.0
37;2021-01-07;116;1;295;1;0.0;0.0
37;2021-01-08;442;1;737;2;0.1;0.0
37;2021-01-09;80;2;817;4;0.1;0.0
37;2021-01-10;83;0;900;4;0.1;0.0
37;2021-01-11;281;0;1181;4;0.2;0.0
37;2021-01-12;658;5;1839;9;0.3;0.0
37;2021-01-13;561;1;2400;10;0.4;0.0
37;2021-01-14;526;4;2926;14;0.5;0.0
37;2021-01-15;628;1;3554;15;0.6;0.0
37;2021-01-16;304;2;3858;17;0.6;0.0
37;2021-01-17;263;1;4121;18;0.7;0.0
37;2021-01-18;733;9;4854;27;0.8;0.0
37;2021-01-19;1244;11;6098;38;1.0;0.0
37;2021-01-20;1039;5;7137;43;1.2;0.0
37;2021-01-21;858;1;7995;44;1.3;0.0
37;2021-01-22;769;2;8764;46;1.4;0.0
37;2021-01-23;173;0;8937;46;1.5;0.0
37;2021-01-24;2;0;8939;46;1.5;0.0
37;2021-01-25;543;17;9482;63;1.6;0.0
37;2021-01-26;1814;69;11296;132;1.9;0.0
37;2021-01-27;1523;77;12819;209;2.1;0.0
37;2021-01-28;1535;95;14354;304;2.4;0.1
37;2021-01-29;634;310;14988;614;2.5;0.1
37;2021-01-30;204;61;15192;675;2.5;0.1
37;2021-01-31;15;64;15207;739;2.5;0.1
37;2021-02-01;333;198;15540;937;2.6;0.2
37;2021-02-02;522;526;16062;1463;2.7;0.2
37;2021-02-03;660;350;16722;1813;2.8;0.3
37;2021-02-04;549;408;17271;2221;2.9;0.4
37;2021-02-05;468;443;17739;2664;2.9;0.4
37;2021-02-06;191;2;17930;2666;3.0;0.4
37;2021-02-07;21;1;17951;2667;3.0;0.4
37;2021-02-08;333;323;18284;2990;3.0;0.5
37;2021-02-09;627;709;18911;3699;3.1;0.6
37;2021-02-10;664;509;19575;4208;3.2;0.7
37;2021-02-11;613;562;20188;4770;3.3;0.8
37;2021-02-12;489;552;20677;5322;3.4;0.9
37;2021-02-13;160;204;20837;5526;3.4;0.9
37;2021-02-14;2;72;20839;5598;3.4;0.9
37;2021-02-15;427;480;21266;6078;3.5;1.0
37;2021-02-16;841;1444;22107;7522;3.7;1.2
37;2021-02-17;633;1372;22740;8894;3.8;1.5
37;2021-02-18;914;1417;23654;10311;3.9;1.7
37;2021-02-19;797;836;24451;11147;4.0;1.8
37;2021-02-20;245;209;24696;11356;4.1;1.9
37;2021-02-21;5;1;24701;11357;4.1;1.9
37;2021-02-22;335;581;25036;11938;4.1;2.0
37;2021-02-23;605;632;25641;12570;4.2;2.1
37;2021-02-24;573;623;26214;13193;4.3;2.2
37;2021-02-25;875;613;27089;13806;4.5;2.3
37;2021-02-26;1118;577;28207;14383;4.7;2.4
37;2021-02-27;585;188;28792;14571;4.8;2.4
37;2021-02-28;23;0;28815;14571;4.8;2.4
37;2021-03-01;603;361;29418;14932;4.9;2.5
37;2021-03-02;1090;543;30508;15475;5.0;2.6
37;2021-03-03;973;549;31481;16024;5.2;2.6
37;2021-03-04;1608;485;33089;16509;5.5;2.7
37;2021-03-05;2132;568;35221;17077;5.8;2.8
37;2021-03-06;1165;216;36386;17293;6.0;2.9
37;2021-03-07;472;68;36858;17361;6.1;2.9
37;2021-03-08;670;401;37528;17762;6.2;2.9
37;2021-03-09;1654;704;39182;18466;6.5;3.1
37;2021-03-10;1609;755;40791;19221;6.7;3.2
37;2021-03-11;2051;707;42842;19928;7.1;3.3
37;2021-03-12;3209;481;46051;20409;7.6;3.4
37;2021-03-13;1948;192;47999;20601;7.9;3.4
37;2021-03-14;208;4;48207;20605;8.0;3.4
37;2021-03-15;1071;252;49278;20857;8.1;3.4
37;2021-03-16;1050;535;50328;21392;8.3;3.5
37;2021-03-17;936;282;51264;21674;8.5;3.6
37;2021-03-18;1039;528;52303;22202;8.6;3.7
37;2021-03-19;2218;345;54521;22547;9.0;3.7
37;2021-03-20;1336;145;55857;22692;9.2;3.7
37;2021-03-21;205;4;56062;22696;9.3;3.7
37;2021-03-22;1288;245;57350;22941;9.5;3.8
37;2021-03-23;2257;573;59607;23514;9.8;3.9
37;2021-03-24;2245;469;61852;23983;10.2;4.0
37;2021-03-25;2985;449;64837;24432;10.7;4.0
37;2021-03-26;3525;413;68362;24845;11.3;4.1
37;2021-03-27;1176;129;69538;24974;11.5;4.1
37;2021-03-28;139;1;69677;24975;11.5;4.1
37;2021-03-29;1606;350;71283;25325;11.8;4.2
37;2021-03-30;2525;629;73808;25954;12.2;4.3
37;2021-03-31;2050;485;75858;26439;12.5;4.4
37;2021-04-01;2600;972;78458;27411;13.0;4.5
37;2021-04-02;2808;672;81266;28083;13.4;4.6
37;2021-04-03;818;226;82084;28309;13.6;4.7
37;2021-04-04;104;1;82188;28310;13.6;4.7
37;2021-04-05;4;0;82192;28310;13.6;4.7
37;2021-04-06;2243;785;84435;29095;13.9;4.8
37;2021-04-07;3173;881;87608;29976;14.5;5.0
37;2021-04-08;4045;971;91653;30947;15.1;5.1
37;2021-04-09;4544;960;96197;31907;15.9;5.3
37;2021-04-10;1331;438;97528;32345;16.1;5.3
37;2021-04-11;104;1;97632;32346;16.1;5.3
37;2021-04-12;2642;680;100274;33026;16.6;5.5
37;2021-04-13;4114;1168;104388;34194;17.2;5.6
37;2021-04-14;3043;896;107431;35090;17.7;5.8
37;2021-04-15;3757;1022;111188;36112;18.4;6.0
37;2021-04-16;4359;1231;115547;37343;19.1;6.2
37;2021-04-17;1147;228;116694;37571;19.3;6.2
37;2021-04-18;98;3;116792;37574;19.3;6.2
37;2021-04-19;2481;852;119273;38426;19.7;6.3
37;2021-04-20;3233;1340;122506;39766;20.2;6.6
37;2021-04-21;2928;1163;125434;40929;20.7;6.8
37;2021-04-22;3456;1405;128890;42334;21.3;7.0
37;2021-04-23;3694;1819;132584;44153;21.9;7.3
37;2021-04-24;1007;387;133591;44540;22.1;7.4
37;2021-04-25;46;2;133637;44542;22.1;7.4
37;2021-04-26;2971;1350;136608;45892;22.6;7.6
37;2021-04-27;4186;1817;140794;47709;23.3;7.9
37;2021-04-28;3466;1957;144260;49666;23.8;8.2
37;2021-04-29;4585;2027;148845;51693;24.6;8.5
37;2021-04-30;5056;1995;153901;53688;25.4;8.9
37;2021-05-01;638;214;154539;53902;25.5;8.9
37;2021-05-02;104;15;154643;53917;25.5;8.9
37;2021-05-03;2672;1960;157315;55877;26.0;9.2
37;2021-05-04;3731;2721;161046;58598;26.6;9.7
37;2021-05-05;3498;2092;164544;60690;27.2;10.0
37;2021-05-06;4992;1954;169536;62644;28.0;10.3
37;2021-05-07;4685;2887;174221;65531;28.8;10.8
37;2021-05-08;538;312;174759;65843;28.9;10.9
37;2021-05-09;63;41;174822;65884;28.9;10.9
37;2021-05-10;2161;3486;176983;69370;29.2;11.5
37;2021-05-11;3868;3882;180851;73252;29.9;12.1
37;2021-05-12;4041;2547;184892;75799;30.5;12.5
37;2021-05-13;1139;517;186031;76316;30.7;12.6
37;2021-05-14;4046;2680;190077;78996;31.4;13.0
37;2021-05-15;2322;744;192399;79740;31.8;13.2
37;2021-05-16;22;70;192421;79810;31.8;13.2
37;2021-05-17;2765;2046;195186;81856;32.2;13.5
37;2021-05-18;3876;2362;199062;84218;32.9;13.9
37;2021-05-19;3495;1808;202557;86026;33.5;14.2
37;2021-05-20;4751;1778;207308;87804;34.2;14.5
37;2021-05-21;4525;2572;211833;90376;35.0;14.9
37;2021-05-22;1078;752;212911;91128;35.2;15.1
37;2021-05-23;73;89;212984;91217;35.2;15.1
37;2021-05-24;513;107;213497;91324;35.3;15.1
37;2021-05-25;5123;2176;218620;93500;36.1;15.4
37;2021-05-26;4930;2101;223550;95601;36.9;15.8
37;2021-05-27;5983;2367;229533;97968;37.9;16.2
37;2021-05-28;6019;3268;235552;101236;38.9;16.7
37;2021-05-29;1520;1167;237072;102403;39.2;16.9
37;2021-05-30;55;160;237127;102563;39.2;16.9
37;2021-05-31;3647;2529;240774;105092;39.8;17.4
37;2021-06-01;5841;3623;246615;108715;40.7;18.0
37;2021-06-02;5079;2459;251694;111174;41.6;18.4
37;2021-06-03;6086;2884;257780;114058;42.6;18.8
37;2021-06-04;5510;4209;263290;118267;43.5;19.5
37;2021-06-05;1853;1306;265143;119573;43.8;19.8
37;2021-06-06;49;197;265192;119770;43.8;19.8
37;2021-06-07;3021;4168;268213;123938;44.3;20.5
37;2021-06-08;4201;4658;272414;128596;45.0;21.2
37;2021-06-09;3883;3573;276297;132169;45.6;21.8
37;2021-06-10;5271;3622;281568;135791;46.5;22.4
37;2021-06-11;4972;4840;286540;140631;47.3;23.2
37;2021-06-12;3552;1349;290092;141980;47.9;23.5
37;2021-06-13;15;164;290107;142144;47.9;23.5
37;2021-06-14;2666;4039;292773;146183;48.4;24.1
37;2021-06-15;3898;4780;296671;150963;49.0;24.9
37;2021-06-16;3261;3602;299932;154565;49.5;25.5
37;2021-06-17;4013;4497;303945;159062;50.2;26.3
37;2021-06-18;4704;5075;308649;164137;51.0;27.1
37;2021-06-19;2519;1101;311168;165238;51.4;27.3
37;2021-06-20;10;183;311178;165421;51.4;27.3
37;2021-06-21;2418;3827;313596;169248;51.8;28.0
37;2021-06-22;2968;5008;316564;174256;52.3;28.8
37;2021-06-23;2625;3644;319189;177900;52.7;29.4
37;2021-06-24;2873;3544;322062;181444;53.2;30.0
37;2021-06-25;3308;4882;325370;186326;53.7;30.8
37;2021-06-26;1238;3086;326608;189412;54.0;31.3
37;2021-06-27;23;142;326631;189554;54.0;31.3
37;2021-06-28;1703;4510;328334;194064;54.2;32.1
37;2021-06-29;1904;6225;330238;200289;54.6;33.1
37;2021-06-30;1870;4443;332108;204732;54.9;33.8
37;2021-07-01;2124;4796;334232;209528;55.2;34.6
37;2021-07-02;2681;5595;336913;215123;55.7;35.5
37;2021-07-03;944;2138;337857;217261;55.8;35.9
37;2021-07-04;5;105;337862;217366;55.8;35.9
37;2021-07-05;1709;5137;339571;222503;56.1;36.8
37;2021-07-06;2003;6760;341574;229263;56.4;37.9
37;2021-07-07;1944;5466;343518;234729;56.7;38.8
37;2021-07-08;2465;6662;345983;241391;57.2;39.9
37;2021-07-09;1986;7645;347969;249036;57.5;41.1
37;2021-07-10;1016;2619;348985;251655;57.6;41.6
37;2021-07-11;26;96;349011;251751;57.7;41.6
37;2021-07-12;1130;5984;350141;257735;57.8;42.6
37;2021-07-13;1614;7817;351755;265552;58.1;43.9
37;2021-07-14;525;408;352280;265960;58.2;43.9
37;2021-07-15;2625;7502;354905;273462;58.6;45.2
37;2021-07-16;2757;7804;357662;281266;59.1;46.5
37;2021-07-17;1202;2447;358864;283713;59.3;46.9
37;2021-07-18;50;53;358914;283766;59.3;46.9
37;2021-07-19;1652;6127;360566;289893;59.6;47.9
37;2021-07-20;2906;7065;363472;296958;60.0;49.1
37;2021-07-21;2981;5785;366453;302743;60.5;50.0
37;2021-07-22;4057;6533;370510;309276;61.2;51.1
37;2021-07-23;3808;7109;374318;316385;61.8;52.3
37;2021-07-24;1775;3308;376093;319693;62.1;52.8
37;2021-07-25;66;77;376159;319770;62.1;52.8
37;2021-07-26;3236;4322;379395;324092;62.7;53.5
37;2021-07-27;4429;4963;383824;329055;63.4;54.4
37;2021-07-28;4136;3664;387960;332719;64.1;55.0
37;2021-07-29;5086;4195;393046;336914;64.9;55.7
37;2021-07-30;5247;4939;398293;341853;65.8;56.5
37;2021-07-31;1921;1846;400214;343699;66.1;56.8
37;2021-08-01;31;52;400245;343751;66.1;56.8
37;2021-08-02;3293;3296;403538;347047;66.7;57.3
37;2021-08-03;5262;3146;408800;350193;67.5;57.8
37;2021-08-04;4559;1931;413359;352124;68.3;58.2
37;2021-08-05;4788;2599;418147;354723;69.1;58.6
37;2021-08-06;4852;3307;422999;358030;69.9;59.1
37;2021-08-07;1626;1125;424625;359155;70.1;59.3
37;2021-08-08;34;177;424659;359332;70.1;59.4
37;2021-08-09;2435;2258;427094;361590;70.5;59.7
37;2021-08-10;3027;2639;430121;364229;71.0;60.2
37;2021-08-11;2099;2108;432220;366337;71.4;60.5
37;2021-08-12;2613;2692;434833;369029;71.8;61.0
37;2021-08-13;2485;2777;437318;371806;72.2;61.4
37;2021-08-14;756;814;438074;372620;72.4;61.6
37;2021-08-15;12;57;438086;372677;72.4;61.6
37;2021-08-16;1466;3160;439552;375837;72.6;62.1
37;2021-08-17;1797;3974;441349;379811;72.9;62.7
37;2021-08-18;1400;3141;442749;382952;73.1;63.3
37;2021-08-19;1598;3842;444347;386794;73.4;63.9
37;2021-08-20;1598;4554;445945;391348;73.7;64.6
37;2021-08-21;610;1201;446555;392549;73.8;64.8
37;2021-08-22;3;31;446558;392580;73.8;64.8
37;2021-08-23;1291;3985;447849;396565;74.0;65.5
37;2021-08-24;1541;4852;449390;401417;74.2;66.3
37;2021-08-25;1055;4222;450445;405639;74.4;67.0
37;2021-08-26;1279;4513;451724;410152;74.6;67.8
37;2021-08-27;1456;5663;453180;415815;74.9;68.7
37;2021-08-28;407;1462;453587;417277;74.9;68.9
37;2021-08-29;1;18;453588;417295;74.9;68.9
37;2021-08-30;1076;3879;454664;421174;75.1;69.6
37;2021-08-31;1280;3715;455944;424889;75.3;70.2
37;2021-09-01;977;2494;456921;427383;75.5;70.6
37;2021-09-02;896;2529;457817;429912;75.6;71.0
37;2021-09-03;1046;3567;458863;433479;75.8;71.6
37;2021-09-04;672;1323;459535;434802;75.9;71.8
37;2021-09-05;1;28;459536;434830;75.9;71.8
37;2021-09-06;378;1091;459914;435921;76.0;72.0
37;2021-09-07;536;1299;460450;437220;76.1;72.2
37;2021-09-08;820;1870;461270;439090;76.2;72.5
37;2021-09-09;556;1272;461826;440362;76.3;72.7
37;2021-09-10;817;1610;462643;441972;76.4;73.0
37;2021-09-11;403;939;463046;442911;76.5;73.2
37;2021-09-12;15;15;463061;442926;76.5;73.2
37;2021-09-13;449;1058;463510;443984;76.6;73.3
37;2021-09-14;509;1090;464019;445074;76.6;73.5
37;2021-09-15;625;1478;464644;446552;76.8;73.8
37;2021-09-16;354;770;464998;447322;76.8;73.9
37;2021-09-17;637;1473;465635;448795;76.9;74.1
37;2021-09-18;306;841;465941;449636;77.0;74.3
37;2021-09-19;16;42;465957;449678;77.0;74.3
37;2021-09-20;271;681;466228;450359;77.0;74.4
37;2021-09-21;441;1325;466669;451684;77.1;74.6
37;2021-09-22;428;1289;467097;452973;77.2;74.8
37;2021-09-23;427;1047;467524;454020;77.2;75.0
37;2021-09-24;502;1406;468026;455426;77.3;75.2
37;2021-09-25;231;769;468257;456195;77.3;75.4
37;2021-09-26;1;22;468258;456217;77.3;75.4
37;2021-09-27;290;692;468548;456909;77.4;75.5
37;2021-09-28;396;661;468944;457570;77.5;75.6
37;2021-09-29;368;940;469312;458510;77.5;75.7
37;2021-09-30;372;496;469684;459006;77.6;75.8
37;2021-10-01;438;804;470122;459810;77.7;76.0
37;2021-10-02;223;561;470345;460371;77.7;76.0
37;2021-10-03;19;23;470364;460394;77.7;76.1
37;2021-10-04;259;521;470623;460915;77.7;76.1
37;2021-10-05;323;433;470946;461348;77.8;76.2
37;2021-10-06;371;699;471317;462047;77.9;76.3
37;2021-10-07;283;416;471600;462463;77.9;76.4
37;2021-10-08;392;645;471992;463108;78.0;76.5
37;2021-10-09;205;487;472197;463595;78.0;76.6
37;2021-10-10;3;8;472200;463603;78.0;76.6
37;2021-10-11;216;344;472416;463947;78.0;76.6
37;2021-10-12;242;461;472658;464408;78.1;76.7
37;2021-10-13;289;505;472947;464913;78.1;76.8
37;2021-10-14;216;392;473163;465305;78.2;76.9
38;2020-12-27;1;0;1;0;0.0;0.0
38;2020-12-28;1;0;2;0;0.0;0.0
38;2020-12-29;0;0;2;0;0.0;0.0
38;2020-12-30;2;0;4;0;0.0;0.0
38;2020-12-31;5;0;9;0;0.0;0.0
38;2021-01-01;4;0;13;0;0.0;0.0
38;2021-01-02;1;0;14;0;0.0;0.0
38;2021-01-03;3;0;17;0;0.0;0.0
38;2021-01-04;163;0;180;0;0.0;0.0
38;2021-01-05;258;1;438;1;0.0;0.0
38;2021-01-06;364;0;802;1;0.1;0.0
38;2021-01-07;636;1;1438;2;0.1;0.0
38;2021-01-08;695;0;2133;2;0.2;0.0
38;2021-01-09;30;0;2163;2;0.2;0.0
38;2021-01-10;2;0;2165;2;0.2;0.0
38;2021-01-11;801;2;2966;4;0.2;0.0
38;2021-01-12;1471;5;4437;9;0.4;0.0
38;2021-01-13;1084;5;5521;14;0.4;0.0
38;2021-01-14;1683;15;7204;29;0.6;0.0
38;2021-01-15;1675;9;8879;38;0.7;0.0
38;2021-01-16;307;2;9186;40;0.7;0.0
38;2021-01-17;3;0;9189;40;0.7;0.0
38;2021-01-18;1179;6;10368;46;0.8;0.0
38;2021-01-19;2242;6;12610;52;1.0;0.0
38;2021-01-20;1889;10;14499;62;1.1;0.0
38;2021-01-21;1644;13;16143;75;1.3;0.0
38;2021-01-22;1401;9;17544;84;1.4;0.0
38;2021-01-23;379;3;17923;87;1.4;0.0
38;2021-01-24;1;0;17924;87;1.4;0.0
38;2021-01-25;795;107;18719;194;1.5;0.0
38;2021-01-26;855;183;19574;377;1.5;0.0
38;2021-01-27;1094;278;20668;655;1.6;0.1
38;2021-01-28;1175;480;21843;1135;1.7;0.1
38;2021-01-29;954;376;22797;1511;1.8;0.1
38;2021-01-30;304;0;23101;1511;1.8;0.1
38;2021-01-31;0;0;23101;1511;1.8;0.1
38;2021-02-01;703;598;23804;2109;1.9;0.2
38;2021-02-02;964;954;24768;3063;2.0;0.2
38;2021-02-03;1230;700;25998;3763;2.1;0.3
38;2021-02-04;1278;971;27276;4734;2.2;0.4
38;2021-02-05;1400;845;28676;5579;2.3;0.4
38;2021-02-06;188;95;28864;5674;2.3;0.4
38;2021-02-07;3;48;28867;5722;2.3;0.5
38;2021-02-08;862;791;29729;6513;2.4;0.5
38;2021-02-09;1537;1309;31266;7822;2.5;0.6
38;2021-02-10;1581;1284;32847;9106;2.6;0.7
38;2021-02-11;1871;1156;34718;10262;2.7;0.8
38;2021-02-12;1510;1125;36228;11387;2.9;0.9
38;2021-02-13;467;191;36695;11578;2.9;0.9
38;2021-02-14;1;7;36696;11585;2.9;0.9
38;2021-02-15;976;940;37672;12525;3.0;1.0
38;2021-02-16;1378;975;39050;13500;3.1;1.1
38;2021-02-17;1376;1061;40426;14561;3.2;1.2
38;2021-02-18;1791;1061;42217;15622;3.3;1.2
38;2021-02-19;1257;869;43474;16491;3.4;1.3
38;2021-02-20;470;316;43944;16807;3.5;1.3
38;2021-02-21;1;1;43945;16808;3.5;1.3
38;2021-02-22;1075;903;45020;17711;3.6;1.4
38;2021-02-23;1543;952;46563;18663;3.7;1.5
38;2021-02-24;1743;1143;48306;19806;3.8;1.6
38;2021-02-25;2501;1058;50807;20864;4.0;1.6
38;2021-02-26;3312;1001;54119;21865;4.3;1.7
38;2021-02-27;1511;442;55630;22307;4.4;1.8
38;2021-02-28;33;2;55663;22309;4.4;1.8
38;2021-03-01;2511;799;58174;23108;4.6;1.8
38;2021-03-02;4048;1070;62222;24178;4.9;1.9
38;2021-03-03;3367;1263;65589;25441;5.2;2.0
38;2021-03-04;4489;1403;70078;26844;5.5;2.1
38;2021-03-05;5234;1230;75312;28074;6.0;2.2
38;2021-03-06;3044;276;78356;28350;6.2;2.2
38;2021-03-07;115;2;78471;28352;6.2;2.2
38;2021-03-08;2440;910;80911;29262;6.4;2.3
38;2021-03-09;4031;1329;84942;30591;6.7;2.4
38;2021-03-10;3507;1102;88449;31693;7.0;2.5
38;2021-03-11;5143;1552;93592;33245;7.4;2.6
38;2021-03-12;7094;1202;100686;34447;8.0;2.7
38;2021-03-13;3772;236;104458;34683;8.3;2.7
38;2021-03-14;544;15;105002;34698;8.3;2.7
38;2021-03-15;2702;1020;107704;35718;8.5;2.8
38;2021-03-16;2082;1357;109786;37075;8.7;2.9
38;2021-03-17;2025;1215;111811;38290;8.8;3.0
38;2021-03-18;2641;1378;114452;39668;9.0;3.1
38;2021-03-19;4008;1076;118460;40744;9.4;3.2
38;2021-03-20;1826;252;120286;40996;9.5;3.2
38;2021-03-21;132;8;120418;41004;9.5;3.2
38;2021-03-22;2865;1012;123283;42016;9.7;3.3
38;2021-03-23;4780;1502;128063;43518;10.1;3.4
38;2021-03-24;3707;1587;131770;45105;10.4;3.6
38;2021-03-25;5791;1560;137561;46665;10.9;3.7
38;2021-03-26;6599;1756;144160;48421;11.4;3.8
38;2021-03-27;2513;765;146673;49186;11.6;3.9
38;2021-03-28;926;48;147599;49234;11.7;3.9
38;2021-03-29;2679;1852;150278;51086;11.9;4.0
38;2021-03-30;4564;2554;154842;53640;12.2;4.2
38;2021-03-31;3665;2233;158507;55873;12.5;4.4
38;2021-04-01;5137;2539;163644;58412;12.9;4.6
38;2021-04-02;3876;2539;167520;60951;13.2;4.8
38;2021-04-03;1418;945;168938;61896;13.4;4.9
38;2021-04-04;430;46;169368;61942;13.4;4.9
38;2021-04-05;2178;354;171546;62296;13.6;4.9
38;2021-04-06;4346;2411;175892;64707;13.9;5.1
38;2021-04-07;4415;2751;180307;67458;14.3;5.3
38;2021-04-08;5652;2680;185959;70138;14.7;5.5
38;2021-04-09;8563;2747;194522;72885;15.4;5.8
38;2021-04-10;3597;1499;198119;74384;15.7;5.9
38;2021-04-11;1049;112;199168;74496;15.7;5.9
38;2021-04-12;4203;2260;203371;76756;16.1;6.1
38;2021-04-13;6123;2479;209494;79235;16.6;6.3
38;2021-04-14;5118;2468;214612;81703;17.0;6.5
38;2021-04-15;6361;2776;220973;84479;17.5;6.7
38;2021-04-16;6214;2729;227187;87208;18.0;6.9
38;2021-04-17;2588;997;229775;88205;18.2;7.0
38;2021-04-18;1331;72;231106;88277;18.3;7.0
38;2021-04-19;3949;2842;235055;91119;18.6;7.2
38;2021-04-20;5425;2862;240480;93981;19.0;7.4
38;2021-04-21;4976;2712;245456;96693;19.4;7.6
38;2021-04-22;5790;2841;251246;99534;19.9;7.9
38;2021-04-23;6043;2830;257289;102364;20.3;8.1
38;2021-04-24;2665;1351;259954;103715;20.6;8.2
38;2021-04-25;805;592;260759;104307;20.6;8.2
38;2021-04-26;4487;2483;265246;106790;21.0;8.4
38;2021-04-27;6040;2741;271286;109531;21.4;8.7
38;2021-04-28;6197;2512;277483;112043;21.9;8.9
38;2021-04-29;8332;3079;285815;115122;22.6;9.1
38;2021-04-30;7673;4068;293488;119190;23.2;9.4
38;2021-05-01;1546;204;295034;119394;23.3;9.4
38;2021-05-02;847;74;295881;119468;23.4;9.4
38;2021-05-03;5299;3592;301180;123060;23.8;9.7
38;2021-05-04;6203;5091;307383;128151;24.3;10.1
38;2021-05-05;6067;4612;313450;132763;24.8;10.5
38;2021-05-06;6709;5339;320159;138102;25.3;10.9
38;2021-05-07;7284;6448;327443;144550;25.9;11.4
38;2021-05-08;3777;724;331220;145274;26.2;11.5
38;2021-05-09;2854;1933;334074;147207;26.4;11.6
38;2021-05-10;6158;5311;340232;152518;26.9;12.1
38;2021-05-11;8226;6028;348458;158546;27.5;12.5
38;2021-05-12;9045;4710;357503;163256;28.3;12.9
38;2021-05-13;6635;1417;364138;164673;28.8;13.0
38;2021-05-14;9566;3425;373704;168098;29.5;13.3
38;2021-05-15;6864;1452;380568;169550;30.1;13.4
38;2021-05-16;5475;650;386043;170200;30.5;13.5
38;2021-05-17;7672;3007;393715;173207;31.1;13.7
38;2021-05-18;8622;4035;402337;177242;31.8;14.0
38;2021-05-19;8159;3348;410496;180590;32.5;14.3
38;2021-05-20;8978;4496;419474;185086;33.2;14.6
38;2021-05-21;9960;4586;429434;189672;33.9;15.0
38;2021-05-22;7457;1908;436891;191580;34.5;15.1
38;2021-05-23;5589;580;442480;192160;35.0;15.2
38;2021-05-24;7502;1627;449982;193787;35.6;15.3
38;2021-05-25;9544;4852;459526;198639;36.3;15.7
38;2021-05-26;8126;4727;467652;203366;37.0;16.1
38;2021-05-27;9134;5664;476786;209030;37.7;16.5
38;2021-05-28;8786;6500;485572;215530;38.4;17.0
38;2021-05-29;5821;3256;491393;218786;38.8;17.3
38;2021-05-30;2695;1593;494088;220379;39.1;17.4
38;2021-05-31;8272;5136;502360;225515;39.7;17.8
38;2021-06-01;7964;6433;510324;231948;40.3;18.3
38;2021-06-02;7141;5624;517465;237572;40.9;18.8
38;2021-06-03;7393;6834;524858;244406;41.5;19.3
38;2021-06-04;8130;7615;532988;252021;42.1;19.9
38;2021-06-05;5794;3949;538782;255970;42.6;20.2
38;2021-06-06;2509;1463;541291;257433;42.8;20.4
38;2021-06-07;5554;6870;546845;264303;43.2;20.9
38;2021-06-08;5880;7529;552725;271832;43.7;21.5
38;2021-06-09;5047;6472;557772;278304;44.1;22.0
38;2021-06-10;5427;6790;563199;285094;44.5;22.5
38;2021-06-11;5888;7786;569087;292880;45.0;23.2
38;2021-06-12;3945;3259;573032;296139;45.3;23.4
38;2021-06-13;1257;1299;574289;297438;45.4;23.5
38;2021-06-14;3868;7663;578157;305101;45.7;24.1
38;2021-06-15;5233;8147;583390;313248;46.1;24.8
38;2021-06-16;5125;7408;588515;320656;46.5;25.3
38;2021-06-17;4523;7058;593038;327714;46.9;25.9
38;2021-06-18;6164;9232;599202;336946;47.4;26.6
38;2021-06-19;3596;4972;602798;341918;47.7;27.0
38;2021-06-20;1038;2901;603836;344819;47.7;27.3
38;2021-06-21;3748;8709;607584;353528;48.0;27.9
38;2021-06-22;3789;10107;611373;363635;48.3;28.7
38;2021-06-23;3156;9544;614529;373179;48.6;29.5
38;2021-06-24;3381;8589;617910;381768;48.8;30.2
38;2021-06-25;3787;11492;621697;393260;49.1;31.1
38;2021-06-26;2229;7851;623926;401111;49.3;31.7
38;2021-06-27;1098;4356;625024;405467;49.4;32.1
38;2021-06-28;2952;10304;627976;415771;49.6;32.9
38;2021-06-29;3785;10451;631761;426222;49.9;33.7
38;2021-06-30;4061;9945;635822;436167;50.3;34.5
38;2021-07-01;3548;9012;639370;445179;50.5;35.2
38;2021-07-02;3726;11618;643096;456797;50.8;36.1
38;2021-07-03;1739;8788;644835;465585;51.0;36.8
38;2021-07-04;1244;3209;646079;468794;51.1;37.1
38;2021-07-05;3058;10545;649137;479339;51.3;37.9
38;2021-07-06;3460;10233;652597;489572;51.6;38.7
38;2021-07-07;3569;9400;656166;498972;51.9;39.4
38;2021-07-08;3549;8226;659715;507198;52.2;40.1
38;2021-07-09;3897;10738;663612;517936;52.5;40.9
38;2021-07-10;2405;7808;666017;525744;52.7;41.6
38;2021-07-11;777;2030;666794;527774;52.7;41.7
38;2021-07-12;3483;10678;670277;538452;53.0;42.6
38;2021-07-13;6600;10934;676877;549386;53.5;43.4
38;2021-07-14;4672;3333;681549;552719;53.9;43.7
38;2021-07-15;8733;9668;690282;562387;54.6;44.5
38;2021-07-16;8759;10704;699041;573091;55.3;45.3
38;2021-07-17;4739;7486;703780;580577;55.6;45.9
38;2021-07-18;2570;2488;706350;583065;55.8;46.1
38;2021-07-19;5824;9223;712174;592288;56.3;46.8
38;2021-07-20;6289;8305;718463;600593;56.8;47.5
38;2021-07-21;7866;8028;726329;608621;57.4;48.1
38;2021-07-22;7598;6998;733927;615619;58.0;48.7
38;2021-07-23;8942;9047;742869;624666;58.7;49.4
38;2021-07-24;5576;5535;748445;630201;59.2;49.8
38;2021-07-25;2868;1656;751313;631857;59.4;49.9
38;2021-07-26;7870;7500;759183;639357;60.0;50.5
38;2021-07-27;7628;6275;766811;645632;60.6;51.0
38;2021-07-28;8621;5717;775432;651349;61.3;51.5
38;2021-07-29;7684;4685;783116;656034;61.9;51.9
38;2021-07-30;7810;6666;790926;662700;62.5;52.4
38;2021-07-31;4359;3606;795285;666306;62.9;52.7
38;2021-08-01;1298;1084;796583;667390;63.0;52.8
38;2021-08-02;3943;4453;800526;671843;63.3;53.1
38;2021-08-03;4592;4558;805118;676401;63.6;53.5
38;2021-08-04;4639;4356;809757;680757;64.0;53.8
38;2021-08-05;3742;4641;813499;685398;64.3;54.2
38;2021-08-06;4159;5949;817658;691347;64.6;54.7
38;2021-08-07;2319;3532;819977;694879;64.8;54.9
38;2021-08-08;791;2015;820768;696894;64.9;55.1
38;2021-08-09;3612;5577;824380;702471;65.2;55.5
38;2021-08-10;4930;6255;829310;708726;65.6;56.0
38;2021-08-11;3979;4666;833289;713392;65.9;56.4
38;2021-08-12;3403;4608;836692;718000;66.1;56.8
38;2021-08-13;4206;6033;840898;724033;66.5;57.2
38;2021-08-14;1785;4020;842683;728053;66.6;57.6
38;2021-08-15;538;1917;843221;729970;66.7;57.7
38;2021-08-16;2979;7924;846200;737894;66.9;58.3
38;2021-08-17;3446;5963;849646;743857;67.2;58.8
38;2021-08-18;2995;7142;852641;750999;67.4;59.4
38;2021-08-19;2615;4830;855256;755829;67.6;59.8
38;2021-08-20;2911;8430;858167;764259;67.8;60.4
38;2021-08-21;1206;5015;859373;769274;67.9;60.8
38;2021-08-22;511;1510;859884;770784;68.0;60.9
38;2021-08-23;2592;7626;862476;778410;68.2;61.5
38;2021-08-24;2570;5331;865046;783741;68.4;62.0
38;2021-08-25;2616;5876;867662;789617;68.6;62.4
38;2021-08-26;2282;4244;869944;793861;68.8;62.8
38;2021-08-27;2505;5932;872449;799793;69.0;63.2
38;2021-08-28;1425;3690;873874;803483;69.1;63.5
38;2021-08-29;377;1085;874251;804568;69.1;63.6
38;2021-08-30;2335;5677;876586;810245;69.3;64.1
38;2021-08-31;2224;4592;878810;814837;69.5;64.4
38;2021-09-01;2217;4055;881027;818892;69.6;64.7
38;2021-09-02;1671;3025;882698;821917;69.8;65.0
38;2021-09-03;2061;4585;884759;826502;69.9;65.3
38;2021-09-04;1154;2658;885913;829160;70.0;65.5
38;2021-09-05;390;664;886303;829824;70.1;65.6
38;2021-09-06;1207;2964;887510;832788;70.2;65.8
38;2021-09-07;1318;2880;888828;835668;70.3;66.1
38;2021-09-08;1732;3256;890560;838924;70.4;66.3
38;2021-09-09;1124;1970;891684;840894;70.5;66.5
38;2021-09-10;1599;3271;893283;844165;70.6;66.7
38;2021-09-11;1041;2268;894324;846433;70.7;66.9
38;2021-09-12;218;525;894542;846958;70.7;67.0
38;2021-09-13;919;2130;895461;849088;70.8;67.1
38;2021-09-14;919;1870;896380;850958;70.9;67.3
38;2021-09-15;1333;2762;897713;853720;71.0;67.5
38;2021-09-16;718;1558;898431;855278;71.0;67.6
38;2021-09-17;894;2501;899325;857779;71.1;67.8
38;2021-09-18;709;2221;900034;860000;71.2;68.0
38;2021-09-19;104;371;900138;860371;71.2;68.0
38;2021-09-20;633;1722;900771;862093;71.2;68.2
38;2021-09-21;514;1400;901285;863493;71.2;68.3
38;2021-09-22;706;2733;901991;866226;71.3;68.5
38;2021-09-23;450;1399;902441;867625;71.3;68.6
38;2021-09-24;772;2195;903213;869820;71.4;68.8
38;2021-09-25;493;1935;903706;871755;71.4;68.9
38;2021-09-26;94;378;903800;872133;71.4;68.9
38;2021-09-27;427;1228;904227;873361;71.5;69.0
38;2021-09-28;508;1116;904735;874477;71.5;69.1
38;2021-09-29;681;1906;905416;876383;71.6;69.3
38;2021-09-30;443;826;905859;877209;71.6;69.3
38;2021-10-01;611;1391;906470;878600;71.7;69.5
38;2021-10-02;482;1162;906952;879762;71.7;69.5
38;2021-10-03;94;193;907046;879955;71.7;69.6
38;2021-10-04;459;954;907505;880909;71.7;69.6
38;2021-10-05;408;870;907913;881779;71.8;69.7
38;2021-10-06;620;1250;908533;883029;71.8;69.8
38;2021-10-07;412;872;908945;883901;71.9;69.9
38;2021-10-08;662;1292;909607;885193;71.9;70.0
38;2021-10-09;505;868;910112;886061;71.9;70.0
38;2021-10-10;40;108;910152;886169;71.9;70.1
38;2021-10-11;378;788;910530;886957;72.0;70.1
38;2021-10-12;468;620;910998;887577;72.0;70.2
38;2021-10-13;550;978;911548;888555;72.1;70.2
38;2021-10-14;376;559;911924;889114;72.1;70.3
39;2020-12-27;0;0;0;0;0.0;0.0
39;2020-12-28;0;0;0;0;0.0;0.0
39;2020-12-29;0;0;0;0;0.0;0.0
39;2020-12-30;0;0;0;0;0.0;0.0
39;2020-12-31;0;0;0;0;0.0;0.0
39;2021-01-01;0;0;0;0;0.0;0.0
39;2021-01-02;0;0;0;0;0.0;0.0
39;2021-01-03;0;0;0;0;0.0;0.0
39;2021-01-04;3;0;3;0;0.0;0.0
39;2021-01-05;3;0;6;0;0.0;0.0
39;2021-01-06;57;3;63;3;0.0;0.0
39;2021-01-07;333;3;396;6;0.2;0.0
39;2021-01-08;657;2;1053;8;0.4;0.0
39;2021-01-09;169;0;1222;8;0.5;0.0
39;2021-01-10;1;0;1223;8;0.5;0.0
39;2021-01-11;474;1;1697;9;0.7;0.0
39;2021-01-12;431;1;2128;10;0.8;0.0
39;2021-01-13;408;2;2536;12;1.0;0.0
39;2021-01-14;574;4;3110;16;1.2;0.0
39;2021-01-15;471;2;3581;18;1.4;0.0
39;2021-01-16;141;1;3722;19;1.4;0.0
39;2021-01-17;0;1;3722;20;1.4;0.0
39;2021-01-18;924;7;4646;27;1.8;0.0
39;2021-01-19;1180;7;5826;34;2.3;0.0
39;2021-01-20;905;4;6731;38;2.6;0.0
39;2021-01-21;1179;2;7910;40;3.1;0.0
39;2021-01-22;985;3;8895;43;3.4;0.0
39;2021-01-23;383;1;9278;44;3.6;0.0
39;2021-01-24;0;0;9278;44;3.6;0.0
39;2021-01-25;642;2;9920;46;3.8;0.0
39;2021-01-26;1123;13;11043;59;4.3;0.0
39;2021-01-27;928;19;11971;78;4.6;0.0
39;2021-01-28;741;242;12712;320;4.9;0.1
39;2021-01-29;583;424;13295;744;5.2;0.3
39;2021-01-30;264;110;13559;854;5.3;0.3
39;2021-01-31;1;0;13560;854;5.3;0.3
39;2021-02-01;562;263;14122;1117;5.5;0.4
39;2021-02-02;754;321;14876;1438;5.8;0.6
39;2021-02-03;531;515;15407;1953;6.0;0.8
39;2021-02-04;556;462;15963;2415;6.2;0.9
39;2021-02-05;438;429;16401;2844;6.4;1.1
39;2021-02-06;265;111;16666;2955;6.5;1.1
39;2021-02-07;0;1;16666;2956;6.5;1.1
39;2021-02-08;321;374;16987;3330;6.6;1.3
39;2021-02-09;383;483;17370;3813;6.7;1.5
39;2021-02-10;253;336;17623;4149;6.8;1.6
39;2021-02-11;586;511;18209;4660;7.1;1.8
39;2021-02-12;385;417;18594;5077;7.2;2.0
39;2021-02-13;100;69;18694;5146;7.2;2.0
39;2021-02-14;0;0;18694;5146;7.2;2.0
39;2021-02-15;99;756;18793;5902;7.3;2.3
39;2021-02-16;99;910;18892;6812;7.3;2.6
39;2021-02-17;58;694;18950;7506;7.3;2.9
39;2021-02-18;109;864;19059;8370;7.4;3.2
39;2021-02-19;100;485;19159;8855;7.4;3.4
39;2021-02-20;18;364;19177;9219;7.4;3.6
39;2021-02-21;0;0;19177;9219;7.4;3.6
39;2021-02-22;100;729;19277;9948;7.5;3.9
39;2021-02-23;4;764;19281;10712;7.5;4.2
39;2021-02-24;125;869;19406;11581;7.5;4.5
39;2021-02-25;214;753;19620;12334;7.6;4.8
39;2021-02-26;218;470;19838;12804;7.7;5.0
39;2021-02-27;169;298;20007;13102;7.8;5.1
39;2021-02-28;1;0;20008;13102;7.8;5.1
39;2021-03-01;218;640;20226;13742;7.8;5.3
39;2021-03-02;329;826;20555;14568;8.0;5.6
39;2021-03-03;602;534;21157;15102;8.2;5.9
39;2021-03-04;658;486;21815;15588;8.5;6.0
39;2021-03-05;670;332;22485;15920;8.7;6.2
39;2021-03-06;775;250;23260;16170;9.0;6.3
39;2021-03-07;242;84;23502;16254;9.1;6.3
39;2021-03-08;285;449;23787;16703;9.2;6.5
39;2021-03-09;844;467;24631;17170;9.6;6.7
39;2021-03-10;985;343;25616;17513;9.9;6.8
39;2021-03-11;829;469;26445;17982;10.3;7.0
39;2021-03-12;805;293;27250;18275;10.6;7.1
39;2021-03-13;789;105;28039;18380;10.9;7.1
39;2021-03-14;35;10;28074;18390;10.9;7.1
39;2021-03-15;513;110;28587;18500;11.1;7.2
39;2021-03-16;555;57;29142;18557;11.3;7.2
39;2021-03-17;611;57;29753;18614;11.5;7.2
39;2021-03-18;600;73;30353;18687;11.8;7.2
39;2021-03-19;393;72;30746;18759;11.9;7.3
39;2021-03-20;312;12;31058;18771;12.0;7.3
39;2021-03-21;3;0;31061;18771;12.0;7.3
39;2021-03-22;755;118;31816;18889;12.3;7.3
39;2021-03-23;1129;46;32945;18935;12.8;7.3
39;2021-03-24;1179;102;34124;19037;13.2;7.4
39;2021-03-25;2042;135;36166;19172;14.0;7.4
39;2021-03-26;797;116;36963;19288;14.3;7.5
39;2021-03-27;345;7;37308;19295;14.5;7.5
39;2021-03-28;36;4;37344;19299;14.5;7.5
39;2021-03-29;1036;198;38380;19497;14.9;7.6
39;2021-03-30;1400;271;39780;19768;15.4;7.7
39;2021-03-31;658;531;40438;20299;15.7;7.9
39;2021-04-01;1310;319;41748;20618;16.2;8.0
39;2021-04-02;626;131;42374;20749;16.4;8.0
39;2021-04-03;180;8;42554;20757;16.5;8.1
39;2021-04-04;4;1;42558;20758;16.5;8.1
39;2021-04-05;1;0;42559;20758;16.5;8.1
39;2021-04-06;824;634;43383;21392;16.8;8.3
39;2021-04-07;1134;685;44517;22077;17.3;8.6
39;2021-04-08;1790;583;46307;22660;18.0;8.8
39;2021-04-09;1675;294;47982;22954;18.6;8.9
39;2021-04-10;348;188;48330;23142;18.7;9.0
39;2021-04-11;2;0;48332;23142;18.7;9.0
39;2021-04-12;680;400;49012;23542;19.0;9.1
39;2021-04-13;1200;583;50212;24125;19.5;9.4
39;2021-04-14;845;641;51057;24766;19.8;9.6
39;2021-04-15;1479;722;52536;25488;20.4;9.9
39;2021-04-16;1090;176;53626;25664;20.8;10.0
39;2021-04-17;197;61;53823;25725;20.9;10.0
39;2021-04-18;0;0;53823;25725;20.9;10.0
39;2021-04-19;523;699;54346;26424;21.1;10.2
39;2021-04-20;766;547;55112;26971;21.4;10.5
39;2021-04-21;1142;724;56254;27695;21.8;10.7
39;2021-04-22;1012;1132;57266;28827;22.2;11.2
39;2021-04-23;457;364;57723;29191;22.4;11.3
39;2021-04-24;275;149;57998;29340;22.5;11.4
39;2021-04-25;12;3;58010;29343;22.5;11.4
39;2021-04-26;568;1041;58578;30384;22.7;11.8
39;2021-04-27;788;984;59366;31368;23.0;12.2
39;2021-04-28;1720;419;61086;31787;23.7;12.3
39;2021-04-29;2570;976;63656;32763;24.7;12.7
39;2021-04-30;2473;394;66129;33157;25.6;12.9
39;2021-05-01;41;53;66170;33210;25.7;12.9
39;2021-05-02;0;0;66170;33210;25.7;12.9
39;2021-05-03;917;812;67087;34022;26.0;13.2
39;2021-05-04;948;1128;68035;35150;26.4;13.6
39;2021-05-05;1955;893;69990;36043;27.1;14.0
39;2021-05-06;2425;1349;72415;37392;28.1;14.5
39;2021-05-07;1286;576;73701;37968;28.6;14.7
39;2021-05-08;179;55;73880;38023;28.7;14.7
39;2021-05-09;10;8;73890;38031;28.7;14.7
39;2021-05-10;1762;853;75652;38884;29.3;15.1
39;2021-05-11;1774;1515;77426;40399;30.0;15.7
39;2021-05-12;1810;1500;79236;41899;30.7;16.2
39;2021-05-13;246;23;79482;41922;30.8;16.3
39;2021-05-14;2392;335;81874;42257;31.8;16.4
39;2021-05-15;1848;256;83722;42513;32.5;16.5
39;2021-05-16;0;0;83722;42513;32.5;16.5
39;2021-05-17;1986;726;85708;43239;33.2;16.8
39;2021-05-18;1690;1180;87398;44419;33.9;17.2
39;2021-05-19;2496;558;89894;44977;34.9;17.4
39;2021-05-20;2465;756;92359;45733;35.8;17.7
39;2021-05-21;1800;561;94159;46294;36.5;18.0
39;2021-05-22;322;218;94481;46512;36.6;18.0
39;2021-05-23;8;36;94489;46548;36.6;18.1
39;2021-05-24;8;28;94497;46576;36.6;18.1
39;2021-05-25;1725;1197;96222;47773;37.3;18.5
39;2021-05-26;1643;1377;97865;49150;38.0;19.1
39;2021-05-27;1485;1624;99350;50774;38.5;19.7
39;2021-05-28;856;1220;100206;51994;38.9;20.2
39;2021-05-29;261;276;100467;52270;39.0;20.3
39;2021-05-30;2;40;100469;52310;39.0;20.3
39;2021-05-31;1625;1245;102094;53555;39.6;20.8
39;2021-06-01;1893;1321;103987;54876;40.3;21.3
39;2021-06-02;1705;1167;105692;56043;41.0;21.7
39;2021-06-03;1326;1160;107018;57203;41.5;22.2
39;2021-06-04;940;1073;107958;58276;41.9;22.6
39;2021-06-05;766;516;108724;58792;42.2;22.8
39;2021-06-06;1;36;108725;58828;42.2;22.8
39;2021-06-07;2106;918;110831;59746;43.0;23.2
39;2021-06-08;2208;1155;113039;60901;43.8;23.6
39;2021-06-09;1733;1240;114772;62141;44.5;24.1
39;2021-06-10;1616;2080;116388;64221;45.1;24.9
39;2021-06-11;1568;1270;117956;65491;45.7;25.4
39;2021-06-12;1264;350;119220;65841;46.2;25.5
39;2021-06-13;11;18;119231;65859;46.2;25.5
39;2021-06-14;1335;1894;120566;67753;46.8;26.3
39;2021-06-15;1386;1259;121952;69012;47.3;26.8
39;2021-06-16;1171;1536;123123;70548;47.8;27.4
39;2021-06-17;1044;1718;124167;72266;48.2;28.0
39;2021-06-18;1638;1180;125805;73446;48.8;28.5
39;2021-06-19;249;411;126054;73857;48.9;28.6
39;2021-06-20;2;18;126056;73875;48.9;28.7
39;2021-06-21;351;2495;126407;76370;49.0;29.6
39;2021-06-22;815;2294;127222;78664;49.3;30.5
39;2021-06-23;1200;1301;128422;79965;49.8;31.0
39;2021-06-24;736;1044;129158;81009;50.1;31.4
39;2021-06-25;679;2961;129837;83970;50.4;32.6
39;2021-06-26;206;1564;130043;85534;50.4;33.2
39;2021-06-27;0;0;130043;85534;50.4;33.2
39;2021-06-28;305;2743;130348;88277;50.6;34.2
39;2021-06-29;497;2697;130845;90974;50.7;35.3
39;2021-06-30;895;2426;131740;93400;51.1;36.2
39;2021-07-01;645;1939;132385;95339;51.3;37.0
39;2021-07-02;1111;1406;133496;96745;51.8;37.5
39;2021-07-03;554;524;134050;97269;52.0;37.7
39;2021-07-04;2;1;134052;97270;52.0;37.7
39;2021-07-05;601;2589;134653;99859;52.2;38.7
39;2021-07-06;835;1887;135488;101746;52.5;39.5
39;2021-07-07;591;1389;136079;103135;52.8;40.0
39;2021-07-08;700;906;136779;104041;53.0;40.3
39;2021-07-09;1078;1585;137857;105626;53.5;41.0
39;2021-07-10;739;476;138596;106102;53.8;41.1
39;2021-07-11;28;8;138624;106110;53.8;41.2
39;2021-07-12;577;2599;139201;108709;54.0;42.2
39;2021-07-13;1638;2660;140839;111369;54.6;43.2
39;2021-07-14;17;21;140856;111390;54.6;43.2
39;2021-07-15;1906;1837;142762;113227;55.4;43.9
39;2021-07-16;3226;2053;145988;115280;56.6;44.7
39;2021-07-17;2225;1163;148213;116443;57.5;45.2
39;2021-07-18;164;52;148377;116495;57.5;45.2
39;2021-07-19;1399;2952;149776;119447;58.1;46.3
39;2021-07-20;1842;2813;151618;122260;58.8;47.4
39;2021-07-21;2587;2583;154205;124843;59.8;48.4
39;2021-07-22;1934;1845;156139;126688;60.6;49.1
39;2021-07-23;1813;1933;157952;128621;61.3;49.9
39;2021-07-24;1400;1428;159352;130049;61.8;50.4
39;2021-07-25;0;1;159352;130050;61.8;50.4
39;2021-07-26;1318;2001;160670;132051;62.3;51.2
39;2021-07-27;2343;1905;163013;133956;63.2;52.0
39;2021-07-28;2688;1475;165701;135431;64.3;52.5
39;2021-07-29;2200;1743;167901;137174;65.1;53.2
39;2021-07-30;2045;1466;169946;138640;65.9;53.8
39;2021-07-31;1367;657;171313;139297;66.4;54.0
39;2021-08-01;10;18;171323;139315;66.4;54.0
39;2021-08-02;1205;1401;172528;140716;66.9;54.6
39;2021-08-03;1920;1486;174448;142202;67.7;55.1
39;2021-08-04;1047;659;175495;142861;68.1;55.4
39;2021-08-05;1242;740;176737;143601;68.5;55.7
39;2021-08-06;1375;2289;178112;145890;69.1;56.6
39;2021-08-07;1069;1213;179181;147103;69.5;57.1
39;2021-08-08;26;10;179207;147113;69.5;57.1
39;2021-08-09;436;304;179643;147417;69.7;57.2
39;2021-08-10;1230;932;180873;148349;70.1;57.5
39;2021-08-11;893;1532;181766;149881;70.5;58.1
39;2021-08-12;1596;2171;183362;152052;71.1;59.0
39;2021-08-13;1334;2119;184696;154171;71.6;59.8
39;2021-08-14;361;1106;185057;155277;71.8;60.2
39;2021-08-15;1;1;185058;155278;71.8;60.2
39;2021-08-16;488;736;185546;156014;72.0;60.5
39;2021-08-17;574;1443;186120;157457;72.2;61.1
39;2021-08-18;862;1727;186982;159184;72.5;61.7
39;2021-08-19;906;1593;187888;160777;72.9;62.4
39;2021-08-20;640;2500;188528;163277;73.1;63.3
39;2021-08-21;467;1291;188995;164568;73.3;63.8
39;2021-08-22;7;11;189002;164579;73.3;63.8
39;2021-08-23;267;972;189269;165551;73.4;64.2
39;2021-08-24;456;1607;189725;167158;73.6;64.8
39;2021-08-25;631;1604;190356;168762;73.8;65.4
39;2021-08-26;718;1860;191074;170622;74.1;66.2
39;2021-08-27;405;2060;191479;172682;74.3;67.0
39;2021-08-28;325;1369;191804;174051;74.4;67.5
39;2021-08-29;0;1;191804;174052;74.4;67.5
39;2021-08-30;345;1009;192149;175061;74.5;67.9
39;2021-08-31;399;1006;192548;176067;74.7;68.3
39;2021-09-01;512;1425;193060;177492;74.9;68.8
39;2021-09-02;333;1369;193393;178861;75.0;69.4
39;2021-09-03;478;2248;193871;181109;75.2;70.2
39;2021-09-04;148;183;194019;181292;75.2;70.3
39;2021-09-05;0;1;194019;181293;75.2;70.3
39;2021-09-06;243;481;194262;181774;75.3;70.5
39;2021-09-07;228;253;194490;182027;75.4;70.6
39;2021-09-08;441;677;194931;182704;75.6;70.9
39;2021-09-09;439;843;195370;183547;75.8;71.2
39;2021-09-10;198;586;195568;184133;75.8;71.4
39;2021-09-11;282;817;195850;184950;76.0;71.7
39;2021-09-12;0;32;195850;184982;76.0;71.7
39;2021-09-13;143;150;195993;185132;76.0;71.8
39;2021-09-14;182;296;196175;185428;76.1;71.9
39;2021-09-15;267;585;196442;186013;76.2;72.1
39;2021-09-16;476;1053;196918;187066;76.4;72.5
39;2021-09-17;424;671;197342;187737;76.5;72.8
39;2021-09-18;96;237;197438;187974;76.6;72.9
39;2021-09-19;3;3;197441;187977;76.6;72.9
39;2021-09-20;70;128;197511;188105;76.6;73.0
39;2021-09-21;87;125;197598;188230;76.6;73.0
39;2021-09-22;269;780;197867;189010;76.7;73.3
39;2021-09-23;173;312;198040;189322;76.8;73.4
39;2021-09-24;206;584;198246;189906;76.9;73.7
39;2021-09-25;65;250;198311;190156;76.9;73.7
39;2021-09-26;0;0;198311;190156;76.9;73.7
39;2021-09-27;131;318;198442;190474;77.0;73.9
39;2021-09-28;55;139;198497;190613;77.0;73.9
39;2021-09-29;195;511;198692;191124;77.1;74.1
39;2021-09-30;201;448;198893;191572;77.1;74.3
39;2021-10-01;104;199;198997;191771;77.2;74.4
39;2021-10-02;97;227;199094;191998;77.2;74.5
39;2021-10-03;2;1;199096;191999;77.2;74.5
39;2021-10-04;40;131;199136;192130;77.2;74.5
39;2021-10-05;55;125;199191;192255;77.3;74.6
39;2021-10-06;183;347;199374;192602;77.3;74.7
39;2021-10-07;135;464;199509;193066;77.4;74.9
39;2021-10-08;225;495;199734;193561;77.5;75.1
39;2021-10-09;49;47;199783;193608;77.5;75.1
39;2021-10-10;0;1;199783;193609;77.5;75.1
39;2021-10-11;16;53;199799;193662;77.5;75.1
39;2021-10-12;82;91;199881;193753;77.5;75.1
39;2021-10-13;86;152;199967;193905;77.6;75.2
39;2021-10-14;143;225;200110;194130;77.6;75.3
40;2020-12-27;0;0;0;0;0.0;0.0
40;2020-12-28;0;0;0;0;0.0;0.0
40;2020-12-29;0;0;0;0;0.0;0.0
40;2020-12-30;0;0;0;0;0.0;0.0
40;2020-12-31;1;0;1;0;0.0;0.0
40;2021-01-01;0;0;1;0;0.0;0.0
40;2021-01-02;1;0;2;0;0.0;0.0
40;2021-01-03;0;0;2;0;0.0;0.0
40;2021-01-04;0;0;2;0;0.0;0.0
40;2021-01-05;0;0;2;0;0.0;0.0
40;2021-01-06;1;0;3;0;0.0;0.0
40;2021-01-07;212;0;215;0;0.1;0.0
40;2021-01-08;391;4;606;4;0.1;0.0
40;2021-01-09;0;0;606;4;0.1;0.0
40;2021-01-10;1;0;607;4;0.1;0.0
40;2021-01-11;111;0;718;4;0.2;0.0
40;2021-01-12;0;0;718;4;0.2;0.0
40;2021-01-13;681;6;1399;10;0.3;0.0
40;2021-01-14;901;9;2300;19;0.6;0.0
40;2021-01-15;811;4;3111;23;0.8;0.0
40;2021-01-16;157;0;3268;23;0.8;0.0
40;2021-01-17;1;1;3269;24;0.8;0.0
40;2021-01-18;406;0;3675;24;0.9;0.0
40;2021-01-19;1203;4;4878;28;1.2;0.0
40;2021-01-20;881;2;5759;30;1.4;0.0
40;2021-01-21;1265;6;7024;36;1.7;0.0
40;2021-01-22;811;2;7835;38;1.9;0.0
40;2021-01-23;289;0;8124;38;2.0;0.0
40;2021-01-24;2;0;8126;38;2.0;0.0
40;2021-01-25;394;2;8520;40;2.1;0.0
40;2021-01-26;802;6;9322;46;2.3;0.0
40;2021-01-27;1118;12;10440;58;2.5;0.0
40;2021-01-28;709;112;11149;170;2.7;0.0
40;2021-01-29;601;230;11750;400;2.9;0.1
40;2021-01-30;237;4;11987;404;2.9;0.1
40;2021-01-31;1;0;11988;404;2.9;0.1
40;2021-02-01;359;132;12347;536;3.0;0.1
40;2021-02-02;922;52;13269;588;3.2;0.1
40;2021-02-03;895;300;14164;888;3.4;0.2
40;2021-02-04;1059;602;15223;1490;3.7;0.4
40;2021-02-05;794;422;16017;1912;3.9;0.5
40;2021-02-06;382;84;16399;1996;4.0;0.5
40;2021-02-07;10;0;16409;1996;4.0;0.5
40;2021-02-08;375;121;16784;2117;4.1;0.5
40;2021-02-09;815;541;17599;2658;4.3;0.6
40;2021-02-10;749;469;18348;3127;4.5;0.8
40;2021-02-11;739;682;19087;3809;4.6;0.9
40;2021-02-12;627;641;19714;4450;4.8;1.1
40;2021-02-13;400;94;20114;4544;4.9;1.1
40;2021-02-14;0;0;20114;4544;4.9;1.1
40;2021-02-15;48;385;20162;4929;4.9;1.2
40;2021-02-16;284;600;20446;5529;5.0;1.3
40;2021-02-17;359;891;20805;6420;5.1;1.6
40;2021-02-18;383;694;21188;7114;5.1;1.7
40;2021-02-19;145;643;21333;7757;5.2;1.9
40;2021-02-20;39;94;21372;7851;5.2;1.9
40;2021-02-21;1;66;21373;7917;5.2;1.9
40;2021-02-22;53;561;21426;8478;5.2;2.1
40;2021-02-23;180;835;21606;9313;5.2;2.3
40;2021-02-24;283;684;21889;9997;5.3;2.4
40;2021-02-25;726;989;22615;10986;5.5;2.7
40;2021-02-26;656;632;23271;11618;5.6;2.8
40;2021-02-27;384;101;23655;11719;5.7;2.8
40;2021-02-28;2;0;23657;11719;5.7;2.8
40;2021-03-01;418;509;24075;12228;5.8;3.0
40;2021-03-02;733;1040;24808;13268;6.0;3.2
40;2021-03-03;934;910;25742;14178;6.2;3.4
40;2021-03-04;1326;827;27068;15005;6.6;3.6
40;2021-03-05;1233;741;28301;15746;6.9;3.8
40;2021-03-06;868;393;29169;16139;7.1;3.9
40;2021-03-07;93;10;29262;16149;7.1;3.9
40;2021-03-08;838;504;30100;16653;7.3;4.0
40;2021-03-09;1507;642;31607;17295;7.7;4.2
40;2021-03-10;1754;717;33361;18012;8.1;4.4
40;2021-03-11;1986;698;35347;18710;8.6;4.5
40;2021-03-12;2051;551;37398;19261;9.1;4.7
40;2021-03-13;972;255;38370;19516;9.3;4.7
40;2021-03-14;98;0;38468;19516;9.3;4.7
40;2021-03-15;924;88;39392;19604;9.6;4.8
40;2021-03-16;989;275;40381;19879;9.8;4.8
40;2021-03-17;1577;349;41958;20228;10.2;4.9
40;2021-03-18;1559;339;43517;20567;10.6;5.0
40;2021-03-19;1808;145;45325;20712;11.0;5.0
40;2021-03-20;706;15;46031;20727;11.2;5.0
40;2021-03-21;52;1;46083;20728;11.2;5.0
40;2021-03-22;1174;35;47257;20763;11.5;5.0
40;2021-03-23;2325;170;49582;20933;12.0;5.1
40;2021-03-24;2327;232;51909;21165;12.6;5.1
40;2021-03-25;2768;384;54677;21549;13.3;5.2
40;2021-03-26;3123;212;57800;21761;14.0;5.3
40;2021-03-27;923;49;58723;21810;14.3;5.3
40;2021-03-28;178;47;58901;21857;14.3;5.3
40;2021-03-29;1153;382;60054;22239;14.6;5.4
40;2021-03-30;2298;390;62352;22629;15.1;5.5
40;2021-03-31;1994;309;64346;22938;15.6;5.6
40;2021-04-01;2413;335;66759;23273;16.2;5.6
40;2021-04-02;2361;222;69120;23495;16.8;5.7
40;2021-04-03;741;122;69861;23617;17.0;5.7
40;2021-04-04;363;9;70224;23626;17.0;5.7
40;2021-04-05;523;40;70747;23666;17.2;5.7
40;2021-04-06;2095;809;72842;24475;17.7;5.9
40;2021-04-07;2664;876;75506;25351;18.3;6.2
40;2021-04-08;3063;901;78569;26252;19.1;6.4
40;2021-04-09;3826;612;82395;26864;20.0;6.5
40;2021-04-10;1600;343;83995;27207;20.4;6.6
40;2021-04-11;52;6;84047;27213;20.4;6.6
40;2021-04-12;2179;736;86226;27949;20.9;6.8
40;2021-04-13;2567;1092;88793;29041;21.6;7.0
40;2021-04-14;2571;1377;91364;30418;22.2;7.4
40;2021-04-15;2987;1516;94351;31934;22.9;7.8
40;2021-04-16;2878;1185;97229;33119;23.6;8.0
40;2021-04-17;1464;348;98693;33467;24.0;8.1
40;2021-04-18;57;24;98750;33491;24.0;8.1
40;2021-04-19;1056;1023;99806;34514;24.2;8.4
40;2021-04-20;1622;1745;101428;36259;24.6;8.8
40;2021-04-21;1777;1740;103205;37999;25.1;9.2
40;2021-04-22;2112;1776;105317;39775;25.6;9.7
40;2021-04-23;2163;1398;107480;41173;26.1;10.0
40;2021-04-24;1329;627;108809;41800;26.4;10.1
40;2021-04-25;37;57;108846;41857;26.4;10.2
40;2021-04-26;1251;1137;110097;42994;26.7;10.4
40;2021-04-27;1487;2033;111584;45027;27.1;10.9
40;2021-04-28;2052;1371;113636;46398;27.6;11.3
40;2021-04-29;2609;1901;116245;48299;28.2;11.7
40;2021-04-30;2700;1617;118945;49916;28.9;12.1
40;2021-05-01;1228;781;120173;50697;29.2;12.3
40;2021-05-02;143;323;120316;51020;29.2;12.4
40;2021-05-03;1857;1502;122173;52522;29.7;12.7
40;2021-05-04;1880;2467;124053;54989;30.1;13.3
40;2021-05-05;2187;2669;126240;57658;30.6;14.0
40;2021-05-06;2237;2866;128477;60524;31.2;14.7
40;2021-05-07;1901;3007;130378;63531;31.6;15.4
40;2021-05-08;675;469;131053;64000;31.8;15.5
40;2021-05-09;316;22;131369;64022;31.9;15.5
40;2021-05-10;1400;2057;132769;66079;32.2;16.0
40;2021-05-11;2196;2512;134965;68591;32.8;16.6
40;2021-05-12;2731;1945;137696;70536;33.4;17.1
40;2021-05-13;1985;515;139681;71051;33.9;17.2
40;2021-05-14;2324;1658;142005;72709;34.5;17.6
40;2021-05-15;1340;961;143345;73670;34.8;17.9
40;2021-05-16;434;24;143779;73694;34.9;17.9
40;2021-05-17;2118;1311;145897;75005;35.4;18.2
40;2021-05-18;2508;1416;148405;76421;36.0;18.5
40;2021-05-19;2954;1105;151359;77526;36.7;18.8
40;2021-05-20;3584;1163;154943;78689;37.6;19.1
40;2021-05-21;2925;1329;157868;80018;38.3;19.4
40;2021-05-22;1146;797;159014;80815;38.6;19.6
40;2021-05-23;631;29;159645;80844;38.8;19.6
40;2021-05-24;1212;332;160857;81176;39.0;19.7
40;2021-05-25;2168;1309;163025;82485;39.6;20.0
40;2021-05-26;2614;1563;165639;84048;40.2;20.4
40;2021-05-27;2733;2002;168372;86050;40.9;20.9
40;2021-05-28;2567;2275;170939;88325;41.5;21.4
40;2021-05-29;1558;1257;172497;89582;41.9;21.7
40;2021-05-30;4;52;172501;89634;41.9;21.8
40;2021-05-31;2568;1207;175069;90841;42.5;22.0
40;2021-06-01;3011;1770;178080;92611;43.2;22.5
40;2021-06-02;3170;1992;181250;94603;44.0;23.0
40;2021-06-03;3589;2330;184839;96933;44.9;23.5
40;2021-06-04;3015;2804;187854;99737;45.6;24.2
40;2021-06-05;1779;1394;189633;101131;46.0;24.5
40;2021-06-06;458;79;190091;101210;46.1;24.6
40;2021-06-07;2184;2025;192275;103235;46.7;25.1
40;2021-06-08;2954;2101;195229;105336;47.4;25.6
40;2021-06-09;3212;2266;198441;107602;48.2;26.1
40;2021-06-10;2994;2097;201435;109699;48.9;26.6
40;2021-06-11;3142;2799;204577;112498;49.7;27.3
40;2021-06-12;1963;1634;206540;114132;50.1;27.7
40;2021-06-13;645;162;207185;114294;50.3;27.7
40;2021-06-14;1457;2495;208642;116789;50.6;28.3
40;2021-06-15;2235;2818;210877;119607;51.2;29.0
40;2021-06-16;2608;2459;213485;122066;51.8;29.6
40;2021-06-17;2431;2439;215916;124505;52.4;30.2
40;2021-06-18;2326;2902;218242;127407;53.0;30.9
40;2021-06-19;1798;1229;220040;128636;53.4;31.2
40;2021-06-20;346;276;220386;128912;53.5;31.3
40;2021-06-21;1395;2318;221781;131230;53.8;31.9
40;2021-06-22;1690;2996;223471;134226;54.2;32.6
40;2021-06-23;1603;3343;225074;137569;54.6;33.4
40;2021-06-24;1733;2384;226807;139953;55.1;34.0
40;2021-06-25;1757;3264;228564;143217;55.5;34.8
40;2021-06-26;1328;1712;229892;144929;55.8;35.2
40;2021-06-27;262;354;230154;145283;55.9;35.3
40;2021-06-28;1334;2817;231488;148100;56.2;35.9
40;2021-06-29;1713;3392;233201;151492;56.6;36.8
40;2021-06-30;1776;3643;234977;155135;57.0;37.7
40;2021-07-01;1715;3954;236692;159089;57.5;38.6
40;2021-07-02;1560;3811;238252;162900;57.8;39.5
40;2021-07-03;676;1923;238928;164823;58.0;40.0
40;2021-07-04;219;483;239147;165306;58.0;40.1
40;2021-07-05;1477;3020;240624;168326;58.4;40.9
40;2021-07-06;1768;3613;242392;171939;58.8;41.7
40;2021-07-07;1973;3850;244365;175789;59.3;42.7
40;2021-07-08;2099;3409;246464;179198;59.8;43.5
40;2021-07-09;2108;3947;248572;183145;60.3;44.5
40;2021-07-10;1004;2155;249576;185300;60.6;45.0
40;2021-07-11;207;294;249783;185594;60.6;45.0
40;2021-07-12;1314;4047;251097;189641;60.9;46.0
40;2021-07-13;2428;4698;253525;194339;61.5;47.2
40;2021-07-14;2198;2061;255723;196400;62.1;47.7
40;2021-07-15;2841;4860;258564;201260;62.8;48.9
40;2021-07-16;3311;3944;261875;205204;63.6;49.8
40;2021-07-17;2110;2595;263985;207799;64.1;50.4
40;2021-07-18;472;542;264457;208341;64.2;50.6
40;2021-07-19;2565;3701;267022;212042;64.8;51.5
40;2021-07-20;3065;4052;270087;216094;65.6;52.5
40;2021-07-21;3203;3886;273290;219980;66.3;53.4
40;2021-07-22;3857;3934;277147;223914;67.3;54.4
40;2021-07-23;4092;4110;281239;228024;68.3;55.3
40;2021-07-24;2795;2113;284034;230137;68.9;55.9
40;2021-07-25;958;491;284992;230628;69.2;56.0
40;2021-07-26;2942;3076;287934;233704;69.9;56.7
40;2021-07-27;3526;3602;291460;237306;70.7;57.6
40;2021-07-28;3379;3398;294839;240704;71.6;58.4
40;2021-07-29;3546;3432;298385;244136;72.4;59.3
40;2021-07-30;3137;3405;301522;247541;73.2;60.1
40;2021-07-31;1781;1908;303303;249449;73.6;60.5
40;2021-08-01;342;287;303645;249736;73.7;60.6
40;2021-08-02;2004;2383;305649;252119;74.2;61.2
40;2021-08-03;2335;2697;307984;254816;74.8;61.9
40;2021-08-04;2094;2323;310078;257139;75.3;62.4
40;2021-08-05;1971;2669;312049;259808;75.7;63.1
40;2021-08-06;1886;3068;313935;262876;76.2;63.8
40;2021-08-07;1218;1746;315153;264622;76.5;64.2
40;2021-08-08;84;154;315237;264776;76.5;64.3
40;2021-08-09;1600;3124;316837;267900;76.9;65.0
40;2021-08-10;1430;3159;318267;271059;77.3;65.8
40;2021-08-11;1424;2844;319691;273903;77.6;66.5
40;2021-08-12;1277;3102;320968;277005;77.9;67.2
40;2021-08-13;1139;2980;322107;279985;78.2;68.0
40;2021-08-14;618;2033;322725;282018;78.3;68.5
40;2021-08-15;5;172;322730;282190;78.3;68.5
40;2021-08-16;1108;3382;323838;285572;78.6;69.3
40;2021-08-17;1161;3418;324999;288990;78.9;70.1
40;2021-08-18;989;3258;325988;292248;79.1;70.9
40;2021-08-19;856;2972;326844;295220;79.3;71.7
40;2021-08-20;811;3033;327655;298253;79.5;72.4
40;2021-08-21;523;1901;328178;300154;79.7;72.9
40;2021-08-22;71;464;328249;300618;79.7;73.0
40;2021-08-23;732;2818;328981;303436;79.9;73.7
40;2021-08-24;697;2540;329678;305976;80.0;74.3
40;2021-08-25;678;2002;330356;307978;80.2;74.8
40;2021-08-26;493;1674;330849;309652;80.3;75.2
40;2021-08-27;638;2467;331487;312119;80.5;75.8
40;2021-08-28;328;1215;331815;313334;80.5;76.1
40;2021-08-29;1;9;331816;313343;80.5;76.1
40;2021-08-30;600;2116;332416;315459;80.7;76.6
40;2021-08-31;470;1381;332886;316840;80.8;76.9
40;2021-09-01;452;1349;333338;318189;80.9;77.2
40;2021-09-02;406;1276;333744;319465;81.0;77.5
40;2021-09-03;444;1354;334188;320819;81.1;77.9
40;2021-09-04;368;1051;334556;321870;81.2;78.1
40;2021-09-05;4;10;334560;321880;81.2;78.1
40;2021-09-06;246;698;334806;322578;81.3;78.3
40;2021-09-07;294;774;335100;323352;81.3;78.5
40;2021-09-08;423;895;335523;324247;81.4;78.7
40;2021-09-09;266;718;335789;324965;81.5;78.9
40;2021-09-10;363;933;336152;325898;81.6;79.1
40;2021-09-11;249;755;336401;326653;81.7;79.3
40;2021-09-12;8;7;336409;326660;81.7;79.3
40;2021-09-13;471;597;336880;327257;81.8;79.4
40;2021-09-14;359;379;337239;327636;81.9;79.5
40;2021-09-15;502;897;337741;328533;82.0;79.7
40;2021-09-16;290;348;338031;328881;82.1;79.8
40;2021-09-17;368;788;338399;329669;82.1;80.0
40;2021-09-18;179;633;338578;330302;82.2;80.2
40;2021-09-19;0;9;338578;330311;82.2;80.2
40;2021-09-20;154;382;338732;330693;82.2;80.3
40;2021-09-21;150;288;338882;330981;82.3;80.3
40;2021-09-22;233;559;339115;331540;82.3;80.5
40;2021-09-23;168;299;339283;331839;82.4;80.5
40;2021-09-24;237;606;339520;332445;82.4;80.7
40;2021-09-25;134;427;339654;332872;82.4;80.8
40;2021-09-26;0;2;339654;332874;82.4;80.8
40;2021-09-27;86;224;339740;333098;82.5;80.9
40;2021-09-28;82;229;339822;333327;82.5;80.9
40;2021-09-29;206;585;340028;333912;82.5;81.1
40;2021-09-30;98;221;340126;334133;82.6;81.1
40;2021-10-01;225;437;340351;334570;82.6;81.2
40;2021-10-02;181;321;340532;334891;82.7;81.3
40;2021-10-03;0;2;340532;334893;82.7;81.3
40;2021-10-04;130;249;340662;335142;82.7;81.3
40;2021-10-05;79;205;340741;335347;82.7;81.4
40;2021-10-06;255;461;340996;335808;82.8;81.5
40;2021-10-07;98;198;341094;336006;82.8;81.6
40;2021-10-08;167;451;341261;336457;82.8;81.7
40;2021-10-09;140;212;341401;336669;82.9;81.7
40;2021-10-10;2;8;341403;336677;82.9;81.7
40;2021-10-11;69;255;341472;336932;82.9;81.8
40;2021-10-12;73;227;341545;337159;82.9;81.8
40;2021-10-13;224;460;341769;337619;83.0;82.0
40;2021-10-14;56;197;341825;337816;83.0;82.0
41;2020-12-27;0;0;0;0;0.0;0.0
41;2020-12-28;0;0;0;0;0.0;0.0
41;2020-12-29;0;0;0;0;0.0;0.0
41;2020-12-30;0;0;0;0;0.0;0.0
41;2020-12-31;0;0;0;0;0.0;0.0
41;2021-01-01;0;0;0;0;0.0;0.0
41;2021-01-02;3;0;3;0;0.0;0.0
41;2021-01-03;0;0;3;0;0.0;0.0
41;2021-01-04;0;0;3;0;0.0;0.0
41;2021-01-05;35;0;38;0;0.0;0.0
41;2021-01-06;71;0;109;0;0.0;0.0
41;2021-01-07;21;0;130;0;0.0;0.0
41;2021-01-08;1;0;131;0;0.0;0.0
41;2021-01-09;0;0;131;0;0.0;0.0
41;2021-01-10;0;0;131;0;0.0;0.0
41;2021-01-11;133;0;264;0;0.1;0.0
41;2021-01-12;321;1;585;1;0.2;0.0
41;2021-01-13;271;0;856;1;0.3;0.0
41;2021-01-14;284;2;1140;3;0.3;0.0
41;2021-01-15;215;1;1355;4;0.4;0.0
41;2021-01-16;0;0;1355;4;0.4;0.0
41;2021-01-17;0;0;1355;4;0.4;0.0
41;2021-01-18;397;2;1752;6;0.5;0.0
41;2021-01-19;857;2;2609;8;0.8;0.0
41;2021-01-20;1059;5;3668;13;1.1;0.0
41;2021-01-21;1567;9;5235;22;1.6;0.0
41;2021-01-22;840;1;6075;23;1.9;0.0
41;2021-01-23;92;0;6167;23;1.9;0.0
41;2021-01-24;0;0;6167;23;1.9;0.0
41;2021-01-25;421;1;6588;24;2.0;0.0
41;2021-01-26;473;4;7061;28;2.2;0.0
41;2021-01-27;441;2;7502;30;2.3;0.0
41;2021-01-28;604;56;8106;86;2.5;0.0
41;2021-01-29;260;30;8366;116;2.6;0.0
41;2021-01-30;0;0;8366;116;2.6;0.0
41;2021-01-31;0;0;8366;116;2.6;0.0
41;2021-02-01;349;148;8715;264;2.7;0.1
41;2021-02-02;470;230;9185;494;2.8;0.2
41;2021-02-03;342;203;9527;697;2.9;0.2
41;2021-02-04;559;154;10086;851;3.1;0.3
41;2021-02-05;329;188;10415;1039;3.2;0.3
41;2021-02-06;5;0;10420;1039;3.2;0.3
41;2021-02-07;2;0;10422;1039;3.2;0.3
41;2021-02-08;305;306;10727;1345;3.3;0.4
41;2021-02-09;599;454;11326;1799;3.5;0.5
41;2021-02-10;486;695;11812;2494;3.6;0.8
41;2021-02-11;1067;1158;12879;3652;3.9;1.1
41;2021-02-12;688;361;13567;4013;4.1;1.2
41;2021-02-13;9;5;13576;4018;4.1;1.2
41;2021-02-14;3;27;13579;4045;4.1;1.2
41;2021-02-15;314;306;13893;4351;4.2;1.3
41;2021-02-16;354;567;14247;4918;4.3;1.5
41;2021-02-17;317;457;14564;5375;4.4;1.6
41;2021-02-18;617;326;15181;5701;4.6;1.7
41;2021-02-19;456;337;15637;6038;4.8;1.8
41;2021-02-20;68;58;15705;6096;4.8;1.9
41;2021-02-21;0;0;15705;6096;4.8;1.9
41;2021-02-22;311;414;16016;6510;4.9;2.0
41;2021-02-23;454;346;16470;6856;5.0;2.1
41;2021-02-24;284;442;16754;7298;5.1;2.2
41;2021-02-25;675;461;17429;7759;5.3;2.4
41;2021-02-26;630;253;18059;8012;5.5;2.4
41;2021-02-27;161;4;18220;8016;5.6;2.4
41;2021-02-28;4;31;18224;8047;5.6;2.5
41;2021-03-01;311;315;18535;8362;5.7;2.6
41;2021-03-02;650;410;19185;8772;5.9;2.7
41;2021-03-03;496;411;19681;9183;6.0;2.8
41;2021-03-04;785;840;20466;10023;6.2;3.1
41;2021-03-05;840;675;21306;10698;6.5;3.3
41;2021-03-06;715;23;22021;10721;6.7;3.3
41;2021-03-07;498;20;22519;10741;6.9;3.3
41;2021-03-08;301;376;22820;11117;7.0;3.4
41;2021-03-09;1043;452;23863;11569;7.3;3.5
41;2021-03-10;721;458;24584;12027;7.5;3.7
41;2021-03-11;1184;686;25768;12713;7.9;3.9
41;2021-03-12;1115;414;26883;13127;8.2;4.0
41;2021-03-13;1224;20;28107;13147;8.6;4.0
41;2021-03-14;392;7;28499;13154;8.7;4.0
41;2021-03-15;798;353;29297;13507;8.9;4.1
41;2021-03-16;1061;412;30358;13919;9.3;4.2
41;2021-03-17;586;240;30944;14159;9.4;4.3
41;2021-03-18;926;399;31870;14558;9.7;4.4
41;2021-03-19;911;335;32781;14893;10.0;4.5
41;2021-03-20;543;22;33324;14915;10.2;4.5
41;2021-03-21;1;0;33325;14915;10.2;4.5
41;2021-03-22;810;275;34135;15190;10.4;4.6
41;2021-03-23;1309;495;35444;15685;10.8;4.8
41;2021-03-24;1231;367;36675;16052;11.2;4.9
41;2021-03-25;2026;439;38701;16491;11.8;5.0
41;2021-03-26;1655;327;40356;16818;12.3;5.1
41;2021-03-27;451;58;40807;16876;12.4;5.1
41;2021-03-28;1;0;40808;16876;12.4;5.1
41;2021-03-29;939;310;41747;17186;12.7;5.2
41;2021-03-30;1496;599;43243;17785;13.2;5.4
41;2021-03-31;1148;497;44391;18282;13.5;5.6
41;2021-04-01;2252;567;46643;18849;14.2;5.7
41;2021-04-02;1242;475;47885;19324;14.6;5.9
41;2021-04-03;321;6;48206;19330;14.7;5.9
41;2021-04-04;39;0;48245;19330;14.7;5.9
41;2021-04-05;140;2;48385;19332;14.8;5.9
41;2021-04-06;1301;626;49686;19958;15.2;6.1
41;2021-04-07;1852;710;51538;20668;15.7;6.3
41;2021-04-08;2294;920;53832;21588;16.4;6.6
41;2021-04-09;2568;613;56400;22201;17.2;6.8
41;2021-04-10;954;498;57354;22699;17.5;6.9
41;2021-04-11;279;376;57633;23075;17.6;7.0
41;2021-04-12;1689;659;59322;23734;18.1;7.2
41;2021-04-13;2259;988;61581;24722;18.8;7.5
41;2021-04-14;1794;554;63375;25276;19.3;7.7
41;2021-04-15;2384;980;65759;26256;20.1;8.0
41;2021-04-16;1929;628;67688;26884;20.6;8.2
41;2021-04-17;647;138;68335;27022;20.8;8.2
41;2021-04-18;5;0;68340;27022;20.8;8.2
41;2021-04-19;1260;745;69600;27767;21.2;8.5
41;2021-04-20;2004;1203;71604;28970;21.8;8.8
41;2021-04-21;1503;920;73107;29890;22.3;9.1
41;2021-04-22;2236;1604;75343;31494;23.0;9.6
41;2021-04-23;1736;1080;77079;32574;23.5;9.9
41;2021-04-24;1544;283;78623;32857;24.0;10.0
41;2021-04-25;1007;21;79630;32878;24.3;10.0
41;2021-04-26;1354;625;80984;33503;24.7;10.2
41;2021-04-27;2093;1040;83077;34543;25.3;10.5
41;2021-04-28;1563;865;84640;35408;25.8;10.8
41;2021-04-29;2210;1380;86850;36788;26.5;11.2
41;2021-04-30;1963;878;88813;37666;27.1;11.5
41;2021-05-01;189;12;89002;37678;27.1;11.5
41;2021-05-02;107;17;89109;37695;27.2;11.5
41;2021-05-03;1863;896;90972;38591;27.7;11.8
41;2021-05-04;2092;1543;93064;40134;28.4;12.2
41;2021-05-05;1882;1193;94946;41327;29.0;12.6
41;2021-05-06;2447;1695;97393;43022;29.7;13.1
41;2021-05-07;2016;1805;99409;44827;30.3;13.7
41;2021-05-08;202;154;99611;44981;30.4;13.7
41;2021-05-09;11;354;99622;45335;30.4;13.8
41;2021-05-10;1590;1558;101212;46893;30.9;14.3
41;2021-05-11;2085;2102;103297;48995;31.5;14.9
41;2021-05-12;1951;1678;105248;50673;32.1;15.5
41;2021-05-13;1485;949;106733;51622;32.6;15.7
41;2021-05-14;1577;1305;108310;52927;33.0;16.1
41;2021-05-15;206;295;108516;53222;33.1;16.2
41;2021-05-16;4;0;108520;53222;33.1;16.2
41;2021-05-17;2484;564;111004;53786;33.9;16.4
41;2021-05-18;3138;1032;114142;54818;34.8;16.7
41;2021-05-19;2553;675;116695;55493;35.6;16.9
41;2021-05-20;3349;1152;120044;56645;36.6;17.3
41;2021-05-21;2727;968;122771;57613;37.4;17.6
41;2021-05-22;396;237;123167;57850;37.6;17.6
41;2021-05-23;6;2;123173;57852;37.6;17.6
41;2021-05-24;2605;150;125778;58002;38.4;17.7
41;2021-05-25;2991;577;128769;58579;39.3;17.9
41;2021-05-26;3037;652;131806;59231;40.2;18.1
41;2021-05-27;3294;1111;135100;60342;41.2;18.4
41;2021-05-28;3144;979;138244;61321;42.2;18.7
41;2021-05-29;2073;429;140317;61750;42.8;18.8
41;2021-05-30;344;22;140661;61772;42.9;18.8
41;2021-05-31;1710;1505;142371;63277;43.4;19.3
41;2021-06-01;2263;2012;144634;65289;44.1;19.9
41;2021-06-02;1832;1289;146466;66578;44.7;20.3
41;2021-06-03;2597;1942;149063;68520;45.5;20.9
41;2021-06-04;2303;1967;151366;70487;46.2;21.5
41;2021-06-05;611;1583;151977;72070;46.4;22.0
41;2021-06-06;109;927;152086;72997;46.4;22.3
41;2021-06-07;1515;1529;153601;74526;46.9;22.7
41;2021-06-08;1712;2413;155313;76939;47.4;23.5
41;2021-06-09;1615;1641;156928;78580;47.9;24.0
41;2021-06-10;1917;1819;158845;80399;48.5;24.5
41;2021-06-11;1572;1793;160417;82192;48.9;25.1
41;2021-06-12;664;649;161081;82841;49.1;25.3
41;2021-06-13;13;77;161094;82918;49.1;25.3
41;2021-06-14;1269;1963;162363;84881;49.5;25.9
41;2021-06-15;1834;2761;164197;87642;50.1;26.7
41;2021-06-16;1724;2309;165921;89951;50.6;27.4
41;2021-06-17;1810;2574;167731;92525;51.2;28.2
41;2021-06-18;1662;2400;169393;94925;51.7;29.0
41;2021-06-19;412;531;169805;95456;51.8;29.1
41;2021-06-20;11;32;169816;95488;51.8;29.1
41;2021-06-21;1325;1779;171141;97267;52.2;29.7
41;2021-06-22;1619;2563;172760;99830;52.7;30.5
41;2021-06-23;1375;2046;174135;101876;53.1;31.1
41;2021-06-24;1483;2308;175618;104184;53.6;31.8
41;2021-06-25;1294;2617;176912;106801;54.0;32.6
41;2021-06-26;433;614;177345;107415;54.1;32.8
41;2021-06-27;1;4;177346;107419;54.1;32.8
41;2021-06-28;404;2696;177750;110115;54.2;33.6
41;2021-06-29;664;3442;178414;113557;54.4;34.6
41;2021-06-30;552;3068;178966;116625;54.6;35.6
41;2021-07-01;765;3106;179731;119731;54.8;36.5
41;2021-07-02;589;3501;180320;123232;55.0;37.6
41;2021-07-03;158;647;180478;123879;55.1;37.8
41;2021-07-04;2;2;180480;123881;55.1;37.8
41;2021-07-05;284;2818;180764;126699;55.1;38.6
41;2021-07-06;667;3634;181431;130333;55.3;39.8
41;2021-07-07;479;3137;181910;133470;55.5;40.7
41;2021-07-08;940;3366;182850;136836;55.8;41.7
41;2021-07-09;540;3641;183390;140477;55.9;42.8
41;2021-07-10;247;2088;183637;142565;56.0;43.5
41;2021-07-11;5;280;183642;142845;56.0;43.6
41;2021-07-12;861;2291;184503;145136;56.3;44.3
41;2021-07-13;1198;3285;185701;148421;56.6;45.3
41;2021-07-14;141;1080;185842;149501;56.7;45.6
41;2021-07-15;1333;3320;187175;152821;57.1;46.6
41;2021-07-16;1091;3389;188266;156210;57.4;47.6
41;2021-07-17;344;807;188610;157017;57.5;47.9
41;2021-07-18;24;32;188634;157049;57.5;47.9
41;2021-07-19;1191;2319;189825;159368;57.9;48.6
41;2021-07-20;1643;2745;191468;162113;58.4;49.4
41;2021-07-21;1709;2086;193177;164199;58.9;50.1
41;2021-07-22;2263;2300;195440;166499;59.6;50.8
41;2021-07-23;2104;2468;197544;168967;60.3;51.5
41;2021-07-24;330;842;197874;169809;60.4;51.8
41;2021-07-25;19;23;197893;169832;60.4;51.8
41;2021-07-26;1902;1679;199795;171511;60.9;52.3
41;2021-07-27;2534;2345;202329;173856;61.7;53.0
41;2021-07-28;2161;1831;204490;175687;62.4;53.6
41;2021-07-29;2345;2027;206835;177714;63.1;54.2
41;2021-07-30;2151;2084;208986;179798;63.7;54.8
41;2021-07-31;380;581;209366;180379;63.9;55.0
41;2021-08-01;21;7;209387;180386;63.9;55.0
41;2021-08-02;1550;1605;210937;181991;64.3;55.5
41;2021-08-03;2517;1857;213454;183848;65.1;56.1
41;2021-08-04;2302;1199;215756;185047;65.8;56.4
41;2021-08-05;3047;1266;218803;186313;66.7;56.8
41;2021-08-06;2214;1305;221017;187618;67.4;57.2
41;2021-08-07;511;347;221528;187965;67.6;57.3
41;2021-08-08;13;20;221541;187985;67.6;57.3
41;2021-08-09;1689;1357;223230;189342;68.1;57.8
41;2021-08-10;2563;1423;225793;190765;68.9;58.2
41;2021-08-11;1593;1440;227386;192205;69.4;58.6
41;2021-08-12;1942;1339;229328;193544;70.0;59.0
41;2021-08-13;1474;1697;230802;195241;70.4;59.6
41;2021-08-14;365;209;231167;195450;70.5;59.6
41;2021-08-15;0;16;231167;195466;70.5;59.6
41;2021-08-16;864;2069;232031;197535;70.8;60.3
41;2021-08-17;1498;1634;233529;199169;71.2;60.8
41;2021-08-18;1135;1971;234664;201140;71.6;61.4
41;2021-08-19;1312;1554;235976;202694;72.0;61.8
41;2021-08-20;915;2313;236891;205007;72.3;62.5
41;2021-08-21;120;227;237011;205234;72.3;62.6
41;2021-08-22;1;32;237012;205266;72.3;62.6
41;2021-08-23;694;2295;237706;207561;72.5;63.3
41;2021-08-24;1415;2313;239121;209874;72.9;64.0
41;2021-08-25;620;2200;239741;212074;73.1;64.7
41;2021-08-26;843;2821;240584;214895;73.4;65.5
41;2021-08-27;621;2763;241205;217658;73.6;66.4
41;2021-08-28;99;622;241304;218280;73.6;66.6
41;2021-08-29;46;24;241350;218304;73.6;66.6
41;2021-08-30;668;2114;242018;220418;73.8;67.2
41;2021-08-31;765;2556;242783;222974;74.1;68.0
41;2021-09-01;501;1711;243284;224685;74.2;68.5
41;2021-09-02;628;2011;243912;226696;74.4;69.1
41;2021-09-03;650;2101;244562;228797;74.6;69.8
41;2021-09-04;194;555;244756;229352;74.7;70.0
41;2021-09-05;3;0;244759;229352;74.7;70.0
41;2021-09-06;291;958;245050;230310;74.7;70.3
41;2021-09-07;415;1195;245465;231505;74.9;70.6
41;2021-09-08;314;1172;245779;232677;75.0;71.0
41;2021-09-09;295;1164;246074;233841;75.1;71.3
41;2021-09-10;381;1197;246455;235038;75.2;71.7
41;2021-09-11;85;366;246540;235404;75.2;71.8
41;2021-09-12;0;9;246540;235413;75.2;71.8
41;2021-09-13;200;647;246740;236060;75.3;72.0
41;2021-09-14;364;826;247104;236886;75.4;72.3
41;2021-09-15;279;1070;247383;237956;75.5;72.6
41;2021-09-16;237;833;247620;238789;75.5;72.8
41;2021-09-17;360;713;247980;239502;75.6;73.1
41;2021-09-18;78;169;248058;239671;75.7;73.1
41;2021-09-19;0;7;248058;239678;75.7;73.1
41;2021-09-20;177;515;248235;240193;75.7;73.3
41;2021-09-21;182;515;248417;240708;75.8;73.4
41;2021-09-22;268;802;248685;241510;75.9;73.7
41;2021-09-23;237;662;248922;242172;75.9;73.9
41;2021-09-24;313;630;249235;242802;76.0;74.1
41;2021-09-25;70;233;249305;243035;76.0;74.1
41;2021-09-26;0;3;249305;243038;76.0;74.1
41;2021-09-27;165;342;249470;243380;76.1;74.2
41;2021-09-28;156;421;249626;243801;76.1;74.4
41;2021-09-29;178;490;249804;244291;76.2;74.5
41;2021-09-30;112;337;249916;244628;76.2;74.6
41;2021-10-01;210;390;250126;245018;76.3;74.7
41;2021-10-02;80;140;250206;245158;76.3;74.8
41;2021-10-03;0;0;250206;245158;76.3;74.8
41;2021-10-04;106;264;250312;245422;76.4;74.9
41;2021-10-05;117;297;250429;245719;76.4;75.0
41;2021-10-06;224;412;250653;246131;76.5;75.1
41;2021-10-07;120;176;250773;246307;76.5;75.1
41;2021-10-08;201;511;250974;246818;76.6;75.3
41;2021-10-09;51;119;251025;246937;76.6;75.3
41;2021-10-10;0;18;251025;246955;76.6;75.3
41;2021-10-11;118;171;251143;247126;76.6;75.4
41;2021-10-12;67;167;251210;247293;76.6;75.4
41;2021-10-13;183;286;251393;247579;76.7;75.5
41;2021-10-14;87;125;251480;247704;76.7;75.6
42;2020-12-27;1;0;1;0;0.0;0.0
42;2020-12-28;0;0;1;0;0.0;0.0
42;2020-12-29;0;0;1;0;0.0;0.0
42;2020-12-30;0;0;1;0;0.0;0.0
42;2020-12-31;0;0;1;0;0.0;0.0
42;2021-01-01;0;0;1;0;0.0;0.0
42;2021-01-02;0;0;1;0;0.0;0.0
42;2021-01-03;0;0;1;0;0.0;0.0
42;2021-01-04;1;0;2;0;0.0;0.0
42;2021-01-05;1;0;3;0;0.0;0.0
42;2021-01-06;178;1;181;1;0.0;0.0
42;2021-01-07;256;0;437;1;0.1;0.0
42;2021-01-08;264;5;701;6;0.1;0.0
42;2021-01-09;136;0;837;6;0.1;0.0
42;2021-01-10;0;0;837;6;0.1;0.0
42;2021-01-11;293;2;1130;8;0.1;0.0
42;2021-01-12;412;1;1542;9;0.2;0.0
42;2021-01-13;527;2;2069;11;0.3;0.0
42;2021-01-14;775;4;2844;15;0.4;0.0
42;2021-01-15;707;4;3551;19;0.5;0.0
42;2021-01-16;298;2;3849;21;0.5;0.0
42;2021-01-17;219;0;4068;21;0.5;0.0
42;2021-01-18;968;1;5036;22;0.7;0.0
42;2021-01-19;1329;10;6365;32;0.8;0.0
42;2021-01-20;956;4;7321;36;1.0;0.0
42;2021-01-21;1023;6;8344;42;1.1;0.0
42;2021-01-22;992;7;9336;49;1.2;0.0
42;2021-01-23;401;0;9737;49;1.3;0.0
42;2021-01-24;359;0;10096;49;1.3;0.0
42;2021-01-25;1100;13;11196;62;1.5;0.0
42;2021-01-26;1750;21;12946;83;1.7;0.0
42;2021-01-27;1456;126;14402;209;1.9;0.0
42;2021-01-28;1667;146;16069;355;2.1;0.0
42;2021-01-29;946;120;17015;475;2.2;0.1
42;2021-01-30;257;110;17272;585;2.3;0.1
42;2021-01-31;258;2;17530;587;2.3;0.1
42;2021-02-01;738;63;18268;650;2.4;0.1
42;2021-02-02;1854;322;20122;972;2.6;0.1
42;2021-02-03;1518;492;21640;1464;2.8;0.2
42;2021-02-04;1279;616;22919;2080;3.0;0.3
42;2021-02-05;684;528;23603;2608;3.1;0.3
42;2021-02-06;304;151;23907;2759;3.1;0.4
42;2021-02-07;276;154;24183;2913;3.2;0.4
42;2021-02-08;506;615;24689;3528;3.2;0.5
42;2021-02-09;703;798;25392;4326;3.3;0.6
42;2021-02-10;742;689;26134;5015;3.4;0.7
42;2021-02-11;773;688;26907;5703;3.5;0.7
42;2021-02-12;675;754;27582;6457;3.6;0.8
42;2021-02-13;428;304;28010;6761;3.7;0.9
42;2021-02-14;186;221;28196;6982;3.7;0.9
42;2021-02-15;520;820;28716;7802;3.8;1.0
42;2021-02-16;489;1240;29205;9042;3.8;1.2
42;2021-02-17;518;1531;29723;10573;3.9;1.4
42;2021-02-18;757;1388;30480;11961;4.0;1.6
42;2021-02-19;768;1023;31248;12984;4.1;1.7
42;2021-02-20;248;424;31496;13408;4.1;1.8
42;2021-02-21;63;327;31559;13735;4.1;1.8
42;2021-02-22;574;961;32133;14696;4.2;1.9
42;2021-02-23;1211;1440;33344;16136;4.4;2.1
42;2021-02-24;1244;1221;34588;17357;4.5;2.3
42;2021-02-25;1667;1420;36255;18777;4.7;2.5
42;2021-02-26;1646;927;37901;19704;5.0;2.6
42;2021-02-27;580;297;38481;20001;5.0;2.6
42;2021-02-28;167;126;38648;20127;5.1;2.6
42;2021-03-01;807;847;39455;20974;5.2;2.7
42;2021-03-02;1275;822;40730;21796;5.3;2.9
42;2021-03-03;1368;811;42098;22607;5.5;3.0
42;2021-03-04;1705;729;43803;23336;5.7;3.1
42;2021-03-05;2623;678;46426;24014;6.1;3.1
42;2021-03-06;1934;276;48360;24290;6.3;3.2
42;2021-03-07;1491;97;49851;24387;6.5;3.2
42;2021-03-08;1405;518;51256;24905;6.7;3.3
42;2021-03-09;1983;464;53239;25369;7.0;3.3
42;2021-03-10;2053;514;55292;25883;7.2;3.4
42;2021-03-11;3048;641;58340;26524;7.6;3.5
42;2021-03-12;3008;837;61348;27361;8.0;3.6
42;2021-03-13;1479;374;62827;27735;8.2;3.6
42;2021-03-14;472;177;63299;27912;8.3;3.6
42;2021-03-15;1572;609;64871;28521;8.5;3.7
42;2021-03-16;1472;782;66343;29303;8.7;3.8
42;2021-03-17;1723;1085;68066;30388;8.9;4.0
42;2021-03-18;1803;1033;69869;31421;9.1;4.1
42;2021-03-19;2566;691;72435;32112;9.5;4.2
42;2021-03-20;1672;236;74107;32348;9.7;4.2
42;2021-03-21;526;102;74633;32450;9.8;4.2
42;2021-03-22;1426;747;76059;33197;9.9;4.3
42;2021-03-23;2507;875;78566;34072;10.3;4.5
42;2021-03-24;2783;797;81349;34869;10.6;4.6
42;2021-03-25;3720;944;85069;35813;11.1;4.7
42;2021-03-26;3759;793;88828;36606;11.6;4.8
42;2021-03-27;1806;454;90634;37060;11.9;4.8
42;2021-03-28;1039;217;91673;37277;12.0;4.9
42;2021-03-29;2064;933;93737;38210;12.3;5.0
42;2021-03-30;3146;881;96883;39091;12.7;5.1
42;2021-03-31;2444;1084;99327;40175;13.0;5.3
42;2021-04-01;3391;1060;102718;41235;13.4;5.4
42;2021-04-02;2849;1236;105567;42471;13.8;5.6
42;2021-04-03;1418;612;106985;43083;14.0;5.6
42;2021-04-04;1403;397;108388;43480;14.2;5.7
42;2021-04-05;1901;304;110289;43784;14.4;5.7
42;2021-04-06;2292;1420;112581;45204;14.7;5.9
42;2021-04-07;2761;1845;115342;47049;15.1;6.2
42;2021-04-08;4025;1606;119367;48655;15.6;6.4
42;2021-04-09;5136;1570;124503;50225;16.3;6.6
42;2021-04-10;2591;777;127094;51002;16.6;6.7
42;2021-04-11;1957;434;129051;51436;16.9;6.7
42;2021-04-12;3699;1555;132750;52991;17.4;6.9
42;2021-04-13;4659;1816;137409;54807;18.0;7.2
42;2021-04-14;4308;1914;141717;56721;18.5;7.4
42;2021-04-15;4809;1849;146526;58570;19.2;7.7
42;2021-04-16;4621;1899;151147;60469;19.8;7.9
42;2021-04-17;2982;1079;154129;61548;20.2;8.0
42;2021-04-18;1887;417;156016;61965;20.4;8.1
42;2021-04-19;3090;1544;159106;63509;20.8;8.3
42;2021-04-20;3468;1962;162574;65471;21.3;8.6
42;2021-04-21;3479;1755;166053;67226;21.7;8.8
42;2021-04-22;3768;1959;169821;69185;22.2;9.0
42;2021-04-23;3842;2025;173663;71210;22.7;9.3
42;2021-04-24;2363;1520;176026;72730;23.0;9.5
42;2021-04-25;1658;949;177684;73679;23.2;9.6
42;2021-04-26;3280;1740;180964;75419;23.7;9.9
42;2021-04-27;3253;2217;184217;77636;24.1;10.2
42;2021-04-28;3463;2629;187680;80265;24.5;10.5
42;2021-04-29;3768;2822;191448;83087;25.0;10.9
42;2021-04-30;3360;3037;194808;86124;25.5;11.3
42;2021-05-01;2968;1055;197776;87179;25.9;11.4
42;2021-05-02;1934;1264;199710;88443;26.1;11.6
42;2021-05-03;2868;2772;202578;91215;26.5;11.9
42;2021-05-04;3416;3136;205994;94351;26.9;12.3
42;2021-05-05;3328;3405;209322;97756;27.4;12.8
42;2021-05-06;3888;3776;213210;101532;27.9;13.3
42;2021-05-07;3732;4044;216942;105576;28.4;13.8
42;2021-05-08;3164;1075;220106;106651;28.8;13.9
42;2021-05-09;1505;2213;221611;108864;29.0;14.2
42;2021-05-10;3250;3832;224861;112696;29.4;14.7
42;2021-05-11;5574;3917;230435;116613;30.1;15.2
42;2021-05-12;5339;3571;235774;120184;30.8;15.7
42;2021-05-13;5450;1152;241224;121336;31.5;15.9
42;2021-05-14;5237;2928;246461;124264;32.2;16.2
42;2021-05-15;4880;2127;251341;126391;32.9;16.5
42;2021-05-16;2873;1036;254214;127427;33.2;16.7
42;2021-05-17;5885;2840;260099;130267;34.0;17.0
42;2021-05-18;6251;2982;266350;133249;34.8;17.4
42;2021-05-19;6523;2753;272873;136002;35.7;17.8
42;2021-05-20;7103;2898;279976;138900;36.6;18.2
42;2021-05-21;6351;3276;286327;142176;37.4;18.6
42;2021-05-22;5834;2134;292161;144310;38.2;18.9
42;2021-05-23;2832;874;294993;145184;38.6;19.0
42;2021-05-24;5246;1434;300239;146618;39.3;19.2
42;2021-05-25;5152;3941;305391;150559;39.9;19.7
42;2021-05-26;5160;3459;310551;154018;40.6;20.1
42;2021-05-27;5366;3639;315917;157657;41.3;20.6
42;2021-05-28;5044;4208;320961;161865;42.0;21.2
42;2021-05-29;4340;2988;325301;164853;42.5;21.6
42;2021-05-30;1983;1210;327284;166063;42.8;21.7
42;2021-05-31;4241;3424;331525;169487;43.4;22.2
42;2021-06-01;4592;3570;336117;173057;44.0;22.6
42;2021-06-02;4482;3018;340599;176075;44.5;23.0
42;2021-06-03;4930;3844;345529;179919;45.2;23.5
42;2021-06-04;4765;4217;350294;184136;45.8;24.1
42;2021-06-05;3689;2427;353983;186563;46.3;24.4
42;2021-06-06;1445;1295;355428;187858;46.5;24.6
42;2021-06-07;3992;3377;359420;191235;47.0;25.0
42;2021-06-08;3466;3248;362886;194483;47.5;25.4
42;2021-06-09;2964;3206;365850;197689;47.8;25.9
42;2021-06-10;3242;2934;369092;200623;48.3;26.2
42;2021-06-11;3585;4118;372677;204741;48.7;26.8
42;2021-06-12;2863;2882;375540;207623;49.1;27.1
42;2021-06-13;944;1278;376484;208901;49.2;27.3
42;2021-06-14;2313;4062;378797;212963;49.5;27.8
42;2021-06-15;2830;4070;381627;217033;49.9;28.4
42;2021-06-16;2919;3552;384546;220585;50.3;28.8
42;2021-06-17;2635;3738;387181;224323;50.6;29.3
42;2021-06-18;3093;5146;390274;229469;51.0;30.0
42;2021-06-19;2845;4243;393119;233712;51.4;30.6
42;2021-06-20;857;1844;393976;235556;51.5;30.8
42;2021-06-21;1909;6277;395885;241833;51.8;31.6
42;2021-06-22;1875;5891;397760;247724;52.0;32.4
42;2021-06-23;1845;5321;399605;253045;52.3;33.1
42;2021-06-24;1785;4683;401390;257728;52.5;33.7
42;2021-06-25;2036;6952;403426;264680;52.8;34.6
42;2021-06-26;1408;5818;404834;270498;52.9;35.4
42;2021-06-27;756;2858;405590;273356;53.0;35.7
42;2021-06-28;1746;7063;407336;280419;53.3;36.7
42;2021-06-29;1526;6566;408862;286985;53.5;37.5
42;2021-06-30;1969;5766;410831;292751;53.7;38.3
42;2021-07-01;1779;5119;412610;297870;54.0;39.0
42;2021-07-02;2048;6740;414658;304610;54.2;39.8
42;2021-07-03;1760;5979;416418;310589;54.5;40.6
42;2021-07-04;853;2514;417271;313103;54.6;40.9
42;2021-07-05;1716;6289;418987;319392;54.8;41.8
42;2021-07-06;2106;5576;421093;324968;55.1;42.5
42;2021-07-07;2338;4656;423431;329624;55.4;43.1
42;2021-07-08;2271;3958;425702;333582;55.7;43.6
42;2021-07-09;2416;6096;428118;339678;56.0;44.4
42;2021-07-10;1693;5581;429811;345259;56.2;45.1
42;2021-07-11;921;2304;430732;347563;56.3;45.4
42;2021-07-12;1777;6290;432509;353853;56.6;46.3
42;2021-07-13;3610;6290;436119;360143;57.0;47.1
42;2021-07-14;4480;2055;440599;362198;57.6;47.4
42;2021-07-15;4558;5630;445157;367828;58.2;48.1
42;2021-07-16;4442;6198;449599;374026;58.8;48.9
42;2021-07-17;3219;4710;452818;378736;59.2;49.5
42;2021-07-18;1838;1743;454656;380479;59.5;49.8
42;2021-07-19;3806;5074;458462;385553;60.0;50.4
42;2021-07-20;4719;4821;463181;390374;60.6;51.0
42;2021-07-21;5176;4720;468357;395094;61.2;51.7
42;2021-07-22;5501;3939;473858;399033;62.0;52.2
42;2021-07-23;5500;5120;479358;404153;62.7;52.8
42;2021-07-24;4038;3834;483396;407987;63.2;53.3
42;2021-07-25;1656;1391;485052;409378;63.4;53.5
42;2021-07-26;4731;4314;489783;413692;64.0;54.1
42;2021-07-27;5333;3957;495116;417649;64.7;54.6
42;2021-07-28;5783;3676;500899;421325;65.5;55.1
42;2021-07-29;5678;3435;506577;424760;66.2;55.5
42;2021-07-30;5141;3776;511718;428536;66.9;56.0
42;2021-07-31;4765;3057;516483;431593;67.5;56.4
42;2021-08-01;2498;1318;518981;432911;67.9;56.6
42;2021-08-02;4367;3106;523348;436017;68.4;57.0
42;2021-08-03;3826;3285;527174;439302;68.9;57.4
42;2021-08-04;3473;3225;530647;442527;69.4;57.9
42;2021-08-05;3403;3315;534050;445842;69.8;58.3
42;2021-08-06;3640;3995;537690;449837;70.3;58.8
42;2021-08-07;3022;3067;540712;452904;70.7;59.2
42;2021-08-08;1200;1717;541912;454621;70.9;59.4
42;2021-08-09;2808;3859;544720;458480;71.2;60.0
42;2021-08-10;3275;3909;547995;462389;71.7;60.5
42;2021-08-11;2593;3521;550588;465910;72.0;60.9
42;2021-08-12;2518;3569;553106;469479;72.3;61.4
42;2021-08-13;2334;3909;555440;473388;72.6;61.9
42;2021-08-14;1652;3269;557092;476657;72.8;62.3
42;2021-08-15;600;1027;557692;477684;72.9;62.5
42;2021-08-16;2078;4572;559770;482256;73.2;63.1
42;2021-08-17;2246;4176;562016;486432;73.5;63.6
42;2021-08-18;2053;4146;564069;490578;73.8;64.1
42;2021-08-19;1931;3370;566000;493948;74.0;64.6
42;2021-08-20;2270;4612;568270;498560;74.3;65.2
42;2021-08-21;1083;3866;569353;502426;74.5;65.7
42;2021-08-22;501;2020;569854;504446;74.5;66.0
42;2021-08-23;1625;4668;571479;509114;74.7;66.6
42;2021-08-24;1748;4044;573227;513158;75.0;67.1
42;2021-08-25;1748;3900;574975;517058;75.2;67.6
42;2021-08-26;1445;3048;576420;520106;75.4;68.0
42;2021-08-27;1776;4564;578196;524670;75.6;68.6
42;2021-08-28;1311;3707;579507;528377;75.8;69.1
42;2021-08-29;376;1428;579883;529805;75.8;69.3
42;2021-08-30;1285;3345;581168;533150;76.0;69.7
42;2021-08-31;1238;2713;582406;535863;76.2;70.1
42;2021-09-01;1253;2813;583659;538676;76.3;70.4
42;2021-09-02;1322;2615;584981;541291;76.5;70.8
42;2021-09-03;1573;2940;586554;544231;76.7;71.2
42;2021-09-04;1046;2816;587600;547047;76.8;71.5
42;2021-09-05;382;742;587982;547789;76.9;71.6
42;2021-09-06;763;1781;588745;549570;77.0;71.9
42;2021-09-07;824;1583;589569;551153;77.1;72.1
42;2021-09-08;920;1919;590489;553072;77.2;72.3
42;2021-09-09;658;1463;591147;554535;77.3;72.5
42;2021-09-10;928;1984;592075;556519;77.4;72.8
42;2021-09-11;728;2307;592803;558826;77.5;73.1
42;2021-09-12;163;518;592966;559344;77.5;73.1
42;2021-09-13;551;1161;593517;560505;77.6;73.3
42;2021-09-14;773;1363;594290;561868;77.7;73.5
42;2021-09-15;704;1569;594994;563437;77.8;73.7
42;2021-09-16;526;824;595520;564261;77.9;73.8
42;2021-09-17;737;1637;596257;565898;78.0;74.0
42;2021-09-18;577;1800;596834;567698;78.0;74.2
42;2021-09-19;100;367;596934;568065;78.1;74.3
42;2021-09-20;400;850;597334;568915;78.1;74.4
42;2021-09-21;343;738;597677;569653;78.2;74.5
42;2021-09-22;473;1383;598150;571036;78.2;74.7
42;2021-09-23;378;909;598528;571945;78.3;74.8
42;2021-09-24;471;1563;598999;573508;78.3;75.0
42;2021-09-25;388;1274;599387;574782;78.4;75.2
42;2021-09-26;61;289;599448;575071;78.4;75.2
42;2021-09-27;331;792;599779;575863;78.4;75.3
42;2021-09-28;342;707;600121;576570;78.5;75.4
42;2021-09-29;405;957;600526;577527;78.5;75.5
42;2021-09-30;359;690;600885;578217;78.6;75.6
42;2021-10-01;487;1018;601372;579235;78.6;75.7
42;2021-10-02;378;781;601750;580016;78.7;75.8
42;2021-10-03;90;176;601840;580192;78.7;75.9
42;2021-10-04;269;524;602109;580716;78.7;75.9
42;2021-10-05;286;465;602395;581181;78.8;76.0
42;2021-10-06;412;799;602807;581980;78.8;76.1
42;2021-10-07;287;574;603094;582554;78.9;76.2
42;2021-10-08;405;841;603499;583395;78.9;76.3
42;2021-10-09;381;670;603880;584065;79.0;76.4
42;2021-10-10;89;113;603969;584178;79.0;76.4
42;2021-10-11;263;441;604232;584619;79.0;76.4
42;2021-10-12;204;355;604436;584974;79.0;76.5
42;2021-10-13;436;619;604872;585593;79.1;76.6
42;2021-10-14;284;359;605156;585952;79.1;76.6
43;2020-12-27;0;0;0;0;0.0;0.0
43;2020-12-28;0;0;0;0;0.0;0.0
43;2020-12-29;0;0;0;0;0.0;0.0
43;2020-12-30;0;0;0;0;0.0;0.0
43;2020-12-31;0;0;0;0;0.0;0.0
43;2021-01-01;0;0;0;0;0.0;0.0
43;2021-01-02;0;0;0;0;0.0;0.0
43;2021-01-03;0;0;0;0;0.0;0.0
43;2021-01-04;2;0;2;0;0.0;0.0
43;2021-01-05;0;0;2;0;0.0;0.0
43;2021-01-06;0;0;2;0;0.0;0.0
43;2021-01-07;167;0;169;0;0.1;0.0
43;2021-01-08;151;1;320;1;0.1;0.0
43;2021-01-09;0;0;320;1;0.1;0.0
43;2021-01-10;0;0;320;1;0.1;0.0
43;2021-01-11;137;0;457;1;0.2;0.0
43;2021-01-12;244;1;701;2;0.3;0.0
43;2021-01-13;244;2;945;4;0.4;0.0
43;2021-01-14;294;2;1239;6;0.5;0.0
43;2021-01-15;303;2;1542;8;0.7;0.0
43;2021-01-16;32;0;1574;8;0.7;0.0
43;2021-01-17;0;0;1574;8;0.7;0.0
43;2021-01-18;760;6;2334;14;1.0;0.0
43;2021-01-19;776;5;3110;19;1.4;0.0
43;2021-01-20;519;2;3629;21;1.6;0.0
43;2021-01-21;447;2;4076;23;1.8;0.0
43;2021-01-22;467;7;4543;30;2.0;0.0
43;2021-01-23;1;0;4544;30;2.0;0.0
43;2021-01-24;2;0;4546;30;2.0;0.0
43;2021-01-25;539;0;5085;30;2.2;0.0
43;2021-01-26;614;6;5699;36;2.5;0.0
43;2021-01-27;740;0;6439;36;2.8;0.0
43;2021-01-28;747;31;7186;67;3.2;0.0
43;2021-01-29;722;84;7908;151;3.5;0.1
43;2021-01-30;109;0;8017;151;3.5;0.1
43;2021-01-31;0;0;8017;151;3.5;0.1
43;2021-02-01;403;101;8420;252;3.7;0.1
43;2021-02-02;717;151;9137;403;4.0;0.2
43;2021-02-03;690;44;9827;447;4.3;0.2
43;2021-02-04;525;170;10352;617;4.6;0.3
43;2021-02-05;544;170;10896;787;4.8;0.3
43;2021-02-06;167;19;11063;806;4.9;0.4
43;2021-02-07;0;0;11063;806;4.9;0.4
43;2021-02-08;411;304;11474;1110;5.1;0.5
43;2021-02-09;368;432;11842;1542;5.2;0.7
43;2021-02-10;401;361;12243;1903;5.4;0.8
43;2021-02-11;388;396;12631;2299;5.6;1.0
43;2021-02-12;425;201;13056;2500;5.8;1.1
43;2021-02-13;570;42;13626;2542;6.0;1.1
43;2021-02-14;0;0;13626;2542;6.0;1.1
43;2021-02-15;69;477;13695;3019;6.0;1.3
43;2021-02-16;41;372;13736;3391;6.1;1.5
43;2021-02-17;87;483;13823;3874;6.1;1.7
43;2021-02-18;147;379;13970;4253;6.2;1.9
43;2021-02-19;279;513;14249;4766;6.3;2.1
43;2021-02-20;22;4;14271;4770;6.3;2.1
43;2021-02-21;0;0;14271;4770;6.3;2.1
43;2021-02-22;16;500;14287;5270;6.3;2.3
43;2021-02-23;202;800;14489;6070;6.4;2.7
43;2021-02-24;147;730;14636;6800;6.5;3.0
43;2021-02-25;228;694;14864;7494;6.6;3.3
43;2021-02-26;222;673;15086;8167;6.6;3.6
43;2021-02-27;139;76;15225;8243;6.7;3.6
43;2021-02-28;1;0;15226;8243;6.7;3.6
43;2021-03-01;208;480;15434;8723;6.8;3.8
43;2021-03-02;342;579;15776;9302;7.0;4.1
43;2021-03-03;338;588;16114;9890;7.1;4.4
43;2021-03-04;551;466;16665;10356;7.3;4.6
43;2021-03-05;566;456;17231;10812;7.6;4.8
43;2021-03-06;489;182;17720;10994;7.8;4.8
43;2021-03-07;12;0;17732;10994;7.8;4.8
43;2021-03-08;447;447;18179;11441;8.0;5.0
43;2021-03-09;621;361;18800;11802;8.3;5.2
43;2021-03-10;674;505;19474;12307;8.6;5.4
43;2021-03-11;955;447;20429;12754;9.0;5.6
43;2021-03-12;944;431;21373;13185;9.4;5.8
43;2021-03-13;792;117;22165;13302;9.8;5.9
43;2021-03-14;2;1;22167;13303;9.8;5.9
43;2021-03-15;706;148;22873;13451;10.1;5.9
43;2021-03-16;847;289;23720;13740;10.5;6.1
43;2021-03-17;638;140;24358;13880;10.7;6.1
43;2021-03-18;676;142;25034;14022;11.0;6.2
43;2021-03-19;839;110;25873;14132;11.4;6.2
43;2021-03-20;450;61;26323;14193;11.6;6.3
43;2021-03-21;0;0;26323;14193;11.6;6.3
43;2021-03-22;742;41;27065;14234;11.9;6.3
43;2021-03-23;872;49;27937;14283;12.3;6.3
43;2021-03-24;1174;97;29111;14380;12.8;6.3
43;2021-03-25;1594;162;30705;14542;13.5;6.4
43;2021-03-26;1609;192;32314;14734;14.2;6.5
43;2021-03-27;1449;80;33763;14814;14.9;6.5
43;2021-03-28;420;20;34183;14834;15.1;6.5
43;2021-03-29;1096;171;35279;15005;15.5;6.6
43;2021-03-30;1314;245;36593;15250;16.1;6.7
43;2021-03-31;1306;267;37899;15517;16.7;6.8
43;2021-04-01;1347;344;39246;15861;17.3;7.0
43;2021-04-02;1052;357;40298;16218;17.8;7.1
43;2021-04-03;340;199;40638;16417;17.9;7.2
43;2021-04-04;0;0;40638;16417;17.9;7.2
43;2021-04-05;3;0;40641;16417;17.9;7.2
43;2021-04-06;687;608;41328;17025;18.2;7.5
43;2021-04-07;868;578;42196;17603;18.6;7.8
43;2021-04-08;1086;463;43282;18066;19.1;8.0
43;2021-04-09;1147;663;44429;18729;19.6;8.3
43;2021-04-10;626;265;45055;18994;19.9;8.4
43;2021-04-11;0;0;45055;18994;19.9;8.4
43;2021-04-12;681;650;45736;19644;20.2;8.7
43;2021-04-13;917;726;46653;20370;20.6;9.0
43;2021-04-14;723;672;47376;21042;20.9;9.3
43;2021-04-15;959;702;48335;21744;21.3;9.6
43;2021-04-16;1008;694;49343;22438;21.7;9.9
43;2021-04-17;423;305;49766;22743;21.9;10.0
43;2021-04-18;3;5;49769;22748;21.9;10.0
43;2021-04-19;628;568;50397;23316;22.2;10.3
43;2021-04-20;839;677;51236;23993;22.6;10.6
43;2021-04-21;320;988;51556;24981;22.7;11.0
43;2021-04-22;680;1017;52236;25998;23.0;11.5
43;2021-04-23;401;1103;52637;27101;23.2;11.9
43;2021-04-24;347;1041;52984;28142;23.4;12.4
43;2021-04-25;23;403;53007;28545;23.4;12.6
43;2021-04-26;385;965;53392;29510;23.5;13.0
43;2021-04-27;825;989;54217;30499;23.9;13.4
43;2021-04-28;794;1110;55011;31609;24.2;13.9
43;2021-04-29;1236;1141;56247;32750;24.8;14.4
43;2021-04-30;1199;1070;57446;33820;25.3;14.9
43;2021-05-01;400;27;57846;33847;25.5;14.9
43;2021-05-02;1;0;57847;33847;25.5;14.9
43;2021-05-03;1218;409;59065;34256;26.0;15.1
43;2021-05-04;1237;958;60302;35214;26.6;15.5
43;2021-05-05;1144;849;61446;36063;27.1;15.9
43;2021-05-06;1405;941;62851;37004;27.7;16.3
43;2021-05-07;1089;1173;63940;38177;28.2;16.8
43;2021-05-08;521;136;64461;38313;28.4;16.9
43;2021-05-09;0;2;64461;38315;28.4;16.9
43;2021-05-10;1084;725;65545;39040;28.9;17.2
43;2021-05-11;1553;1010;67098;40050;29.6;17.7
43;2021-05-12;1482;810;68580;40860;30.2;18.0
43;2021-05-13;936;378;69516;41238;30.6;18.2
43;2021-05-14;2204;1112;71720;42350;31.6;18.7
43;2021-05-15;1271;315;72991;42665;32.2;18.8
43;2021-05-16;272;47;73263;42712;32.3;18.8
43;2021-05-17;1625;631;74888;43343;33.0;19.1
43;2021-05-18;1966;676;76854;44019;33.9;19.4
43;2021-05-19;2065;576;78919;44595;34.8;19.7
43;2021-05-20;2338;805;81257;45400;35.8;20.0
43;2021-05-21;2385;709;83642;46109;36.9;20.3
43;2021-05-22;1208;342;84850;46451;37.4;20.5
43;2021-05-23;1;0;84851;46451;37.4;20.5
43;2021-05-24;382;99;85233;46550;37.6;20.5
43;2021-05-25;1407;654;86640;47204;38.2;20.8
43;2021-05-26;1347;559;87987;47763;38.8;21.1
43;2021-05-27;1388;713;89375;48476;39.4;21.4
43;2021-05-28;1348;735;90723;49211;40.0;21.7
43;2021-05-29;1135;604;91858;49815;40.5;22.0
43;2021-05-30;149;17;92007;49832;40.5;22.0
43;2021-05-31;1207;442;93214;50274;41.1;22.2
43;2021-06-01;1281;986;94495;51260;41.6;22.6
43;2021-06-02;1086;700;95581;51960;42.1;22.9
43;2021-06-03;1192;857;96773;52817;42.6;23.3
43;2021-06-04;1351;860;98124;53677;43.2;23.7
43;2021-06-05;823;454;98947;54131;43.6;23.9
43;2021-06-06;10;5;98957;54136;43.6;23.9
43;2021-06-07;748;518;99705;54654;43.9;24.1
43;2021-06-08;664;706;100369;55360;44.2;24.4
43;2021-06-09;538;760;100907;56120;44.5;24.7
43;2021-06-10;807;1120;101714;57240;44.8;25.2
43;2021-06-11;761;1348;102475;58588;45.2;25.8
43;2021-06-12;914;514;103389;59102;45.6;26.0
43;2021-06-13;3;27;103392;59129;45.6;26.1
43;2021-06-14;446;1087;103838;60216;45.8;26.5
43;2021-06-15;629;1195;104467;61411;46.0;27.1
43;2021-06-16;549;974;105016;62385;46.3;27.5
43;2021-06-17;601;1502;105617;63887;46.5;28.2
43;2021-06-18;898;1464;106515;65351;46.9;28.8
43;2021-06-19;447;781;106962;66132;47.1;29.1
43;2021-06-20;0;12;106962;66144;47.1;29.2
43;2021-06-21;424;1307;107386;67451;47.3;29.7
43;2021-06-22;533;1959;107919;69410;47.6;30.6
43;2021-06-23;343;1742;108262;71152;47.7;31.4
43;2021-06-24;511;1494;108773;72646;47.9;32.0
43;2021-06-25;597;2345;109370;74991;48.2;33.1
43;2021-06-26;505;1245;109875;76236;48.4;33.6
43;2021-06-27;10;20;109885;76256;48.4;33.6
43;2021-06-28;341;1784;110226;78040;48.6;34.4
43;2021-06-29;525;2382;110751;80422;48.8;35.4
43;2021-06-30;460;2276;111211;82698;49.0;36.4
43;2021-07-01;473;1910;111684;84608;49.2;37.3
43;2021-07-02;500;1964;112184;86572;49.4;38.2
43;2021-07-03;258;1108;112442;87680;49.6;38.6
43;2021-07-04;1;0;112443;87680;49.6;38.6
43;2021-07-05;526;1202;112969;88882;49.8;39.2
43;2021-07-06;633;1681;113602;90563;50.1;39.9
43;2021-07-07;524;1423;114126;91986;50.3;40.5
43;2021-07-08;837;1417;114963;93403;50.7;41.2
43;2021-07-09;549;1500;115512;94903;50.9;41.8
43;2021-07-10;401;1337;115913;96240;51.1;42.4
43;2021-07-11;23;99;115936;96339;51.1;42.5
43;2021-07-12;604;1685;116540;98024;51.4;43.2
43;2021-07-13;1186;1849;117726;99873;51.9;44.0
43;2021-07-14;848;161;118574;100034;52.3;44.1
43;2021-07-15;1932;1843;120506;101877;53.1;44.9
43;2021-07-16;1752;1616;122258;103493;53.9;45.6
43;2021-07-17;1544;1202;123802;104695;54.6;46.1
43;2021-07-18;4;19;123806;104714;54.6;46.1
43;2021-07-19;1441;1258;125247;105972;55.2;46.7
43;2021-07-20;1895;1451;127142;107423;56.0;47.3
43;2021-07-21;1854;1113;128996;108536;56.9;47.8
43;2021-07-22;2110;1333;131106;109869;57.8;48.4
43;2021-07-23;1619;1326;132725;111195;58.5;49.0
43;2021-07-24;576;1000;133301;112195;58.7;49.4
43;2021-07-25;0;1;133301;112196;58.7;49.4
43;2021-07-26;1643;1072;134944;113268;59.5;49.9
43;2021-07-27;2284;1228;137228;114496;60.5;50.5
43;2021-07-28;1954;1093;139182;115589;61.3;50.9
43;2021-07-29;1986;1019;141168;116608;62.2;51.4
43;2021-07-30;1867;1339;143035;117947;63.0;52.0
43;2021-07-31;706;611;143741;118558;63.3;52.3
43;2021-08-01;13;21;143754;118579;63.4;52.3
43;2021-08-02;1534;970;145288;119549;64.0;52.7
43;2021-08-03;1405;1171;146693;120720;64.7;53.2
43;2021-08-04;1263;1109;147956;121829;65.2;53.7
43;2021-08-05;1254;1285;149210;123114;65.8;54.3
43;2021-08-06;1129;1466;150339;124580;66.3;54.9
43;2021-08-07;758;759;151097;125339;66.6;55.2
43;2021-08-08;5;0;151102;125339;66.6;55.2
43;2021-08-09;822;1636;151924;126975;67.0;56.0
43;2021-08-10;1023;1585;152947;128560;67.4;56.7
43;2021-08-11;680;1340;153627;129900;67.7;57.2
43;2021-08-12;875;1605;154502;131505;68.1;58.0
43;2021-08-13;681;1179;155183;132684;68.4;58.5
43;2021-08-14;364;557;155547;133241;68.6;58.7
43;2021-08-15;5;9;155552;133250;68.6;58.7
43;2021-08-16;686;1675;156238;134925;68.9;59.5
43;2021-08-17;712;1511;156950;136436;69.2;60.1
43;2021-08-18;558;1513;157508;137949;69.4;60.8
43;2021-08-19;641;1614;158149;139563;69.7;61.5
43;2021-08-20;518;1597;158667;141160;69.9;62.2
43;2021-08-21;239;555;158906;141715;70.0;62.5
43;2021-08-22;7;7;158913;141722;70.0;62.5
43;2021-08-23;500;1588;159413;143310;70.3;63.2
43;2021-08-24;518;1398;159931;144708;70.5;63.8
43;2021-08-25;522;1298;160453;146006;70.7;64.3
43;2021-08-26;475;1138;160928;147144;70.9;64.8
43;2021-08-27;529;1360;161457;148504;71.2;65.4
43;2021-08-28;178;499;161635;149003;71.2;65.7
43;2021-08-29;0;1;161635;149004;71.2;65.7
43;2021-08-30;500;1041;162135;150045;71.5;66.1
43;2021-08-31;382;834;162517;150879;71.6;66.5
43;2021-09-01;309;884;162826;151763;71.8;66.9
43;2021-09-02;311;870;163137;152633;71.9;67.3
43;2021-09-03;503;914;163640;153547;72.1;67.7
43;2021-09-04;319;545;163959;154092;72.3;67.9
43;2021-09-05;39;9;163998;154101;72.3;67.9
43;2021-09-06;250;679;164248;154780;72.4;68.2
43;2021-09-07;237;614;164485;155394;72.5;68.5
43;2021-09-08;207;694;164692;156088;72.6;68.8
43;2021-09-09;268;640;164960;156728;72.7;69.1
43;2021-09-10;329;609;165289;157337;72.8;69.3
43;2021-09-11;267;402;165556;157739;73.0;69.5
43;2021-09-12;0;4;165556;157743;73.0;69.5
43;2021-09-13;148;375;165704;158118;73.0;69.7
43;2021-09-14;213;332;165917;158450;73.1;69.8
43;2021-09-15;224;499;166141;158949;73.2;70.1
43;2021-09-16;197;356;166338;159305;73.3;70.2
43;2021-09-17;234;530;166572;159835;73.4;70.4
43;2021-09-18;157;350;166729;160185;73.5;70.6
43;2021-09-19;2;4;166731;160189;73.5;70.6
43;2021-09-20;102;306;166833;160495;73.5;70.7
43;2021-09-21;152;321;166985;160816;73.6;70.9
43;2021-09-22;124;393;167109;161209;73.6;71.0
43;2021-09-23;71;292;167180;161501;73.7;71.2
43;2021-09-24;170;488;167350;161989;73.8;71.4
43;2021-09-25;101;296;167451;162285;73.8;71.5
43;2021-09-26;0;0;167451;162285;73.8;71.5
43;2021-09-27;152;341;167603;162626;73.9;71.7
43;2021-09-28;388;220;167991;162846;74.0;71.8
43;2021-09-29;145;302;168136;163148;74.1;71.9
43;2021-09-30;79;181;168215;163329;74.1;72.0
43;2021-10-01;139;321;168354;163650;74.2;72.1
43;2021-10-02;102;244;168456;163894;74.2;72.2
43;2021-10-03;3;7;168459;163901;74.2;72.2
43;2021-10-04;113;176;168572;164077;74.3;72.3
43;2021-10-05;108;181;168680;164258;74.3;72.4
43;2021-10-06;121;224;168801;164482;74.4;72.5
43;2021-10-07;55;146;168856;164628;74.4;72.6
43;2021-10-08;169;314;169025;164942;74.5;72.7
43;2021-10-09;101;210;169126;165152;74.5;72.8
43;2021-10-10;1;1;169127;165153;74.5;72.8
43;2021-10-11;107;128;169234;165281;74.6;72.8
43;2021-10-12;107;189;169341;165470;74.6;72.9
43;2021-10-13;90;119;169431;165589;74.7;73.0
43;2021-10-14;91;136;169522;165725;74.7;73.0
44;2020-12-27;1;0;1;0;0.0;0.0
44;2020-12-28;3;0;4;0;0.0;0.0
44;2020-12-29;1;0;5;0;0.0;0.0
44;2020-12-30;2;0;7;0;0.0;0.0
44;2020-12-31;1;0;8;0;0.0;0.0
44;2021-01-01;2;1;10;1;0.0;0.0
44;2021-01-02;0;0;10;1;0.0;0.0
44;2021-01-03;4;0;14;1;0.0;0.0
44;2021-01-04;0;0;14;1;0.0;0.0
44;2021-01-05;2;0;16;1;0.0;0.0
44;2021-01-06;20;1;36;2;0.0;0.0
44;2021-01-07;187;0;223;2;0.0;0.0
44;2021-01-08;528;0;751;2;0.1;0.0
44;2021-01-09;473;0;1224;2;0.1;0.0
44;2021-01-10;456;1;1680;3;0.1;0.0
44;2021-01-11;800;1;2480;4;0.2;0.0
44;2021-01-12;910;3;3390;7;0.2;0.0
44;2021-01-13;1086;1;4476;8;0.3;0.0
44;2021-01-14;1116;6;5592;14;0.4;0.0
44;2021-01-15;998;5;6590;19;0.5;0.0
44;2021-01-16;336;3;6926;22;0.5;0.0
44;2021-01-17;328;1;7254;23;0.5;0.0
44;2021-01-18;856;3;8110;26;0.6;0.0
44;2021-01-19;2625;10;10735;36;0.7;0.0
44;2021-01-20;2746;6;13481;42;0.9;0.0
44;2021-01-21;4538;12;18019;54;1.3;0.0
44;2021-01-22;2431;8;20450;62;1.4;0.0
44;2021-01-23;767;1;21217;63;1.5;0.0
44;2021-01-24;120;0;21337;63;1.5;0.0
44;2021-01-25;841;9;22178;72;1.5;0.0
44;2021-01-26;2563;20;24741;92;1.7;0.0
44;2021-01-27;2103;71;26844;163;1.9;0.0
44;2021-01-28;3732;203;30576;366;2.1;0.0
44;2021-01-29;2370;488;32946;854;2.3;0.1
44;2021-01-30;628;211;33574;1065;2.3;0.1
44;2021-01-31;14;210;33588;1275;2.3;0.1
44;2021-02-01;594;544;34182;1819;2.4;0.1
44;2021-02-02;879;757;35061;2576;2.4;0.2
44;2021-02-03;888;889;35949;3465;2.5;0.2
44;2021-02-04;938;724;36887;4189;2.6;0.3
44;2021-02-05;897;636;37784;4825;2.6;0.3
44;2021-02-06;471;270;38255;5095;2.7;0.4
44;2021-02-07;72;203;38327;5298;2.7;0.4
44;2021-02-08;522;460;38849;5758;2.7;0.4
44;2021-02-09;993;1253;39842;7011;2.8;0.5
44;2021-02-10;1144;1307;40986;8318;2.9;0.6
44;2021-02-11;2293;3075;43279;11393;3.0;0.8
44;2021-02-12;1662;1776;44941;13169;3.1;0.9
44;2021-02-13;433;506;45374;13675;3.2;1.0
44;2021-02-14;10;176;45384;13851;3.2;1.0
44;2021-02-15;505;1097;45889;14948;3.2;1.0
44;2021-02-16;1440;2558;47329;17506;3.3;1.2
44;2021-02-17;1106;2167;48435;19673;3.4;1.4
44;2021-02-18;1959;3717;50394;23390;3.5;1.6
44;2021-02-19;1580;2533;51974;25923;3.6;1.8
44;2021-02-20;409;642;52383;26565;3.6;1.8
44;2021-02-21;6;177;52389;26742;3.6;1.9
44;2021-02-22;717;834;53106;27576;3.7;1.9
44;2021-02-23;1248;1126;54354;28702;3.8;2.0
44;2021-02-24;1238;1099;55592;29801;3.9;2.1
44;2021-02-25;2446;1086;58038;30887;4.0;2.1
44;2021-02-26;2291;964;60329;31851;4.2;2.2
44;2021-02-27;975;451;61304;32302;4.3;2.2
44;2021-02-28;7;32;61311;32334;4.3;2.2
44;2021-03-01;988;563;62299;32897;4.3;2.3
44;2021-03-02;1814;1059;64113;33956;4.5;2.4
44;2021-03-03;1859;1137;65972;35093;4.6;2.4
44;2021-03-04;2882;1588;68854;36681;4.8;2.6
44;2021-03-05;3481;1339;72335;38020;5.0;2.6
44;2021-03-06;2507;497;74842;38517;5.2;2.7
44;2021-03-07;988;90;75830;38607;5.3;2.7
44;2021-03-08;1783;624;77613;39231;5.4;2.7
44;2021-03-09;3352;1150;80965;40381;5.6;2.8
44;2021-03-10;3079;1120;84044;41501;5.8;2.9
44;2021-03-11;4439;1794;88483;43295;6.2;3.0
44;2021-03-12;5893;1321;94376;44616;6.6;3.1
44;2021-03-13;3630;306;98006;44922;6.8;3.1
44;2021-03-14;431;64;98437;44986;6.8;3.1
44;2021-03-15;2687;378;101124;45364;7.0;3.2
44;2021-03-16;2149;631;103273;45995;7.2;3.2
44;2021-03-17;1960;682;105233;46677;7.3;3.2
44;2021-03-18;2169;641;107402;47318;7.5;3.3
44;2021-03-19;3784;371;111186;47689;7.7;3.3
44;2021-03-20;3213;302;114399;47991;8.0;3.3
44;2021-03-21;914;23;115313;48014;8.0;3.3
44;2021-03-22;2460;445;117773;48459;8.2;3.4
44;2021-03-23;3960;708;121733;49167;8.5;3.4
44;2021-03-24;4303;636;126036;49803;8.8;3.5
44;2021-03-25;5636;946;131672;50749;9.2;3.5
44;2021-03-26;6510;772;138182;51521;9.6;3.6
44;2021-03-27;3216;438;141398;51959;9.8;3.6
44;2021-03-28;1244;45;142642;52004;9.9;3.6
44;2021-03-29;3120;792;145762;52796;10.1;3.7
44;2021-03-30;5138;1120;150900;53916;10.5;3.8
44;2021-03-31;4613;1317;155513;55233;10.8;3.8
44;2021-04-01;6140;1024;161653;56257;11.2;3.9
44;2021-04-02;5795;965;167448;57222;11.7;4.0
44;2021-04-03;2434;654;169882;57876;11.8;4.0
44;2021-04-04;667;23;170549;57899;11.9;4.0
44;2021-04-05;692;288;171241;58187;11.9;4.0
44;2021-04-06;4216;1390;175457;59577;12.2;4.1
44;2021-04-07;5076;1654;180533;61231;12.6;4.3
44;2021-04-08;7182;1678;187715;62909;13.1;4.4
44;2021-04-09;10066;1834;197781;64743;13.8;4.5
44;2021-04-10;4563;1460;202344;66203;14.1;4.6
44;2021-04-11;2148;431;204492;66634;14.2;4.6
44;2021-04-12;5464;1594;209956;68228;14.6;4.7
44;2021-04-13;6727;2265;216683;70493;15.1;4.9
44;2021-04-14;5911;2242;222594;72735;15.5;5.1
44;2021-04-15;6709;2223;229303;74958;16.0;5.2
44;2021-04-16;7785;2056;237088;77014;16.5;5.4
44;2021-04-17;4300;1391;241388;78405;16.8;5.5
44;2021-04-18;2253;822;243641;79227;17.0;5.5
44;2021-04-19;5042;1912;248683;81139;17.3;5.6
44;2021-04-20;6282;2650;254965;83789;17.7;5.8
44;2021-04-21;6006;2793;260971;86582;18.2;6.0
44;2021-04-22;6958;2517;267929;89099;18.6;6.2
44;2021-04-23;7335;3190;275264;92289;19.2;6.4
44;2021-04-24;3971;2057;279235;94346;19.4;6.6
44;2021-04-25;2076;1060;281311;95406;19.6;6.6
44;2021-04-26;5648;2765;286959;98171;20.0;6.8
44;2021-04-27;7415;4105;294374;102276;20.5;7.1
44;2021-04-28;7608;3793;301982;106069;21.0;7.4
44;2021-04-29;8964;4286;310946;110355;21.6;7.7
44;2021-04-30;9570;4714;320516;115069;22.3;8.0
44;2021-05-01;2848;928;323364;115997;22.5;8.1
44;2021-05-02;1903;618;325267;116615;22.6;8.1
44;2021-05-03;5548;4085;330815;120700;23.0;8.4
44;2021-05-04;6326;5137;337141;125837;23.5;8.8
44;2021-05-05;6071;4636;343212;130473;23.9;9.1
44;2021-05-06;7255;4884;350467;135357;24.4;9.4
44;2021-05-07;7451;5726;357918;141083;24.9;9.8
44;2021-05-08;2583;1269;360501;142352;25.1;9.9
44;2021-05-09;1801;1812;362302;144164;25.2;10.0
44;2021-05-10;6573;5778;368875;149942;25.7;10.4
44;2021-05-11;7787;6280;376662;156222;26.2;10.9
44;2021-05-12;8195;5723;384857;161945;26.8;11.3
44;2021-05-13;5304;1194;390161;163139;27.1;11.4
44;2021-05-14;7586;3974;397747;167113;27.7;11.6
44;2021-05-15;5008;2234;402755;169347;28.0;11.8
44;2021-05-16;2791;741;405546;170088;28.2;11.8
44;2021-05-17;6744;5149;412290;175237;28.7;12.2
44;2021-05-18;7962;5235;420252;180472;29.2;12.6
44;2021-05-19;8165;4283;428417;184755;29.8;12.9
44;2021-05-20;8367;4650;436784;189405;30.4;13.2
44;2021-05-21;8846;5217;445630;194622;31.0;13.5
44;2021-05-22;5097;2232;450727;196854;31.4;13.7
44;2021-05-23;1759;826;452486;197680;31.5;13.8
44;2021-05-24;4884;1615;457370;199295;31.8;13.9
44;2021-05-25;7740;5552;465110;204847;32.4;14.3
44;2021-05-26;8181;5044;473291;209891;32.9;14.6
44;2021-05-27;9659;5358;482950;215249;33.6;15.0
44;2021-05-28;9182;6912;492132;222161;34.2;15.5
44;2021-05-29;5884;3333;498016;225494;34.7;15.7
44;2021-05-30;1775;705;499791;226199;34.8;15.7
44;2021-05-31;8059;6184;507850;232383;35.3;16.2
44;2021-06-01;9905;6571;517755;238954;36.0;16.6
44;2021-06-02;9534;5701;527289;244655;36.7;17.0
44;2021-06-03;10853;5888;538142;250543;37.4;17.4
44;2021-06-04;9959;8075;548101;258618;38.1;18.0
44;2021-06-05;5780;4344;553881;262962;38.5;18.3
44;2021-06-06;2361;1130;556242;264092;38.7;18.4
44;2021-06-07;9549;6936;565791;271028;39.4;18.9
44;2021-06-08;10907;7509;576698;278537;40.1;19.4
44;2021-06-09;10552;6329;587250;284866;40.9;19.8
44;2021-06-10;11424;6043;598674;290909;41.7;20.2
44;2021-06-11;11959;8647;610633;299556;42.5;20.8
44;2021-06-12;7761;4096;618394;303652;43.0;21.1
44;2021-06-13;2792;1004;621186;304656;43.2;21.2
44;2021-06-14;8761;8414;629947;313070;43.8;21.8
44;2021-06-15;11706;8259;641653;321329;44.6;22.4
44;2021-06-16;10976;7661;652629;328990;45.4;22.9
44;2021-06-17;11726;8686;664355;337676;46.2;23.5
44;2021-06-18;10900;10117;675255;347793;47.0;24.2
44;2021-06-19;5884;4324;681139;352117;47.4;24.5
44;2021-06-20;2535;1339;683674;353456;47.6;24.6
44;2021-06-21;7349;10015;691023;363471;48.1;25.3
44;2021-06-22;8469;10627;699492;374098;48.7;26.0
44;2021-06-23;8554;9139;708046;383237;49.3;26.7
44;2021-06-24;9122;8570;717168;391807;49.9;27.3
44;2021-06-25;7643;10817;724811;402624;50.4;28.0
44;2021-06-26;2957;6470;727768;409094;50.6;28.5
44;2021-06-27;816;2403;728584;411497;50.7;28.6
44;2021-06-28;5230;10056;733814;421553;51.1;29.3
44;2021-06-29;6179;12086;739993;433639;51.5;30.2
44;2021-06-30;6183;10448;746176;444087;51.9;30.9
44;2021-07-01;6930;10483;753106;454570;52.4;31.6
44;2021-07-02;6693;12551;759799;467121;52.9;32.5
44;2021-07-03;2584;7005;762383;474126;53.0;33.0
44;2021-07-04;995;2235;763378;476361;53.1;33.1
44;2021-07-05;5316;11872;768694;488233;53.5;34.0
44;2021-07-06;6058;12599;774752;500832;53.9;34.8
44;2021-07-07;6512;11102;781264;511934;54.4;35.6
44;2021-07-08;7391;11959;788655;523893;54.9;36.5
44;2021-07-09;6259;14253;794914;538146;55.3;37.4
44;2021-07-10;2446;7007;797360;545153;55.5;37.9
44;2021-07-11;731;2262;798091;547415;55.5;38.1
44;2021-07-12;4395;14053;802486;561468;55.8;39.1
44;2021-07-13;5767;14851;808253;576319;56.2;40.1
44;2021-07-14;3688;5810;811941;582129;56.5;40.5
44;2021-07-15;7228;14291;819169;596420;57.0;41.5
44;2021-07-16;8234;14994;827403;611414;57.6;42.5
44;2021-07-17;3371;7578;830774;618992;57.8;43.1
44;2021-07-18;1433;2548;832207;621540;57.9;43.2
44;2021-07-19;4871;14697;837078;636237;58.2;44.3
44;2021-07-20;6034;15672;843112;651909;58.7;45.4
44;2021-07-21;5843;13987;848955;665896;59.1;46.3
44;2021-07-22;6722;13750;855677;679646;59.5;47.3
44;2021-07-23;6161;15637;861838;695283;60.0;48.4
44;2021-07-24;2856;8718;864694;704001;60.2;49.0
44;2021-07-25;945;3088;865639;707089;60.2;49.2
44;2021-07-26;6081;12687;871720;719776;60.7;50.1
44;2021-07-27;9714;12192;881434;731968;61.3;50.9
44;2021-07-28;9262;10846;890696;742814;62.0;51.7
44;2021-07-29;10286;10848;900982;753662;62.7;52.4
44;2021-07-30;9185;10927;910167;764589;63.3;53.2
44;2021-07-31;4791;5652;914958;770241;63.7;53.6
44;2021-08-01;2575;1409;917533;771650;63.8;53.7
44;2021-08-02;6632;9477;924165;781127;64.3;54.4
44;2021-08-03;8466;8537;932631;789664;64.9;54.9
44;2021-08-04;9128;6987;941759;796651;65.5;55.4
44;2021-08-05;11570;7524;953329;804175;66.3;56.0
44;2021-08-06;9701;8204;963030;812379;67.0;56.5
44;2021-08-07;4609;3704;967639;816083;67.3;56.8
44;2021-08-08;2540;1727;970179;817810;67.5;56.9
44;2021-08-09;8904;7980;979083;825790;68.1;57.5
44;2021-08-10;10272;7625;989355;833415;68.8;58.0
44;2021-08-11;10425;6790;999780;840205;69.6;58.5
44;2021-08-12;10422;7347;1010202;847552;70.3;59.0
44;2021-08-13;8467;6167;1018669;853719;70.9;59.4
44;2021-08-14;3233;3222;1021902;856941;71.1;59.6
44;2021-08-15;716;933;1022618;857874;71.2;59.7
44;2021-08-16;5854;8307;1028472;866181;71.6;60.3
44;2021-08-17;5607;8179;1034079;874360;72.0;60.8
44;2021-08-18;4824;7621;1038903;881981;72.3;61.4
44;2021-08-19;4977;8351;1043880;890332;72.6;62.0
44;2021-08-20;4503;8922;1048383;899254;72.9;62.6
44;2021-08-21;1960;4612;1050343;903866;73.1;62.9
44;2021-08-22;712;2441;1051055;906307;73.1;63.1
44;2021-08-23;3680;9434;1054735;915741;73.4;63.7
44;2021-08-24;3646;8699;1058381;924440;73.6;64.3
44;2021-08-25;3149;8587;1061530;933027;73.9;64.9
44;2021-08-26;2969;10339;1064499;943366;74.1;65.6
44;2021-08-27;3086;10452;1067585;953818;74.3;66.4
44;2021-08-28;1388;5849;1068973;959667;74.4;66.8
44;2021-08-29;565;2706;1069538;962373;74.4;67.0
44;2021-08-30;2666;10874;1072204;973247;74.6;67.7
44;2021-08-31;2827;10972;1075031;984219;74.8;68.5
44;2021-09-01;2754;9512;1077785;993731;75.0;69.1
44;2021-09-02;2322;8289;1080107;1002020;75.2;69.7
44;2021-09-03;2185;9700;1082292;1011720;75.3;70.4
44;2021-09-04;1456;5828;1083748;1017548;75.4;70.8
44;2021-09-05;442;1318;1084190;1018866;75.4;70.9
44;2021-09-06;1660;6053;1085850;1024919;75.6;71.3
44;2021-09-07;1489;5206;1087339;1030125;75.7;71.7
44;2021-09-08;1916;6052;1089255;1036177;75.8;72.1
44;2021-09-09;1521;4537;1090776;1040714;75.9;72.4
44;2021-09-10;1846;5892;1092622;1046606;76.0;72.8
44;2021-09-11;1091;3940;1093713;1050546;76.1;73.1
44;2021-09-12;239;813;1093952;1051359;76.1;73.2
44;2021-09-13;1206;3573;1095158;1054932;76.2;73.4
44;2021-09-14;1124;3300;1096282;1058232;76.3;73.6
44;2021-09-15;1452;4489;1097734;1062721;76.4;73.9
44;2021-09-16;998;2382;1098732;1065103;76.5;74.1
44;2021-09-17;1264;3851;1099996;1068954;76.5;74.4
44;2021-09-18;779;3133;1100775;1072087;76.6;74.6
44;2021-09-19;217;703;1100992;1072790;76.6;74.6
44;2021-09-20;926;2206;1101918;1074996;76.7;74.8
44;2021-09-21;754;1869;1102672;1076865;76.7;74.9
44;2021-09-22;944;3548;1103616;1080413;76.8;75.2
44;2021-09-23;832;1932;1104448;1082345;76.9;75.3
44;2021-09-24;1106;3000;1105554;1085345;76.9;75.5
44;2021-09-25;499;2292;1106053;1087637;77.0;75.7
44;2021-09-26;185;487;1106238;1088124;77.0;75.7
44;2021-09-27;770;1788;1107008;1089912;77.0;75.8
44;2021-09-28;659;1679;1107667;1091591;77.1;76.0
44;2021-09-29;965;2509;1108632;1094100;77.1;76.1
44;2021-09-30;724;1519;1109356;1095619;77.2;76.2
44;2021-10-01;920;2276;1110276;1097895;77.3;76.4
44;2021-10-02;476;1321;1110752;1099216;77.3;76.5
44;2021-10-03;219;362;1110971;1099578;77.3;76.5
44;2021-10-04;504;964;1111475;1100542;77.3;76.6
44;2021-10-05;464;967;1111939;1101509;77.4;76.6
44;2021-10-06;718;1531;1112657;1103040;77.4;76.8
44;2021-10-07;582;1072;1113239;1104112;77.5;76.8
44;2021-10-08;849;1553;1114088;1105665;77.5;76.9
44;2021-10-09;415;961;1114503;1106626;77.6;77.0
44;2021-10-10;113;228;1114616;1106854;77.6;77.0
44;2021-10-11;522;998;1115138;1107852;77.6;77.1
44;2021-10-12;469;830;1115607;1108682;77.6;77.1
44;2021-10-13;595;1121;1116202;1109803;77.7;77.2
44;2021-10-14;534;957;1116736;1110760;77.7;77.3
45;2020-12-27;0;0;0;0;0.0;0.0
45;2020-12-28;1;0;1;0;0.0;0.0
45;2020-12-29;0;0;1;0;0.0;0.0
45;2020-12-30;0;0;1;0;0.0;0.0
45;2020-12-31;1;0;2;0;0.0;0.0
45;2021-01-01;0;0;2;0;0.0;0.0
45;2021-01-02;0;0;2;0;0.0;0.0
45;2021-01-03;0;0;2;0;0.0;0.0
45;2021-01-04;0;0;2;0;0.0;0.0
45;2021-01-05;76;0;78;0;0.0;0.0
45;2021-01-06;68;0;146;0;0.0;0.0
45;2021-01-07;220;1;366;1;0.1;0.0
45;2021-01-08;199;1;565;2;0.1;0.0
45;2021-01-09;42;0;607;2;0.1;0.0
45;2021-01-10;23;0;630;2;0.1;0.0
45;2021-01-11;254;0;884;2;0.1;0.0
45;2021-01-12;680;3;1564;5;0.2;0.0
45;2021-01-13;496;2;2060;7;0.3;0.0
45;2021-01-14;495;40;2555;47;0.4;0.0
45;2021-01-15;391;3;2946;50;0.4;0.0
45;2021-01-16;39;1;2985;51;0.4;0.0
45;2021-01-17;24;0;3009;51;0.4;0.0
45;2021-01-18;816;1;3825;52;0.6;0.0
45;2021-01-19;1197;8;5022;60;0.7;0.0
45;2021-01-20;2119;13;7141;73;1.0;0.0
45;2021-01-21;2521;7;9662;80;1.4;0.0
45;2021-01-22;1408;7;11070;87;1.6;0.0
45;2021-01-23;124;0;11194;87;1.6;0.0
45;2021-01-24;39;0;11233;87;1.6;0.0
45;2021-01-25;557;3;11790;90;1.7;0.0
45;2021-01-26;870;19;12660;109;1.9;0.0
45;2021-01-27;650;45;13310;154;1.9;0.0
45;2021-01-28;881;212;14191;366;2.1;0.1
45;2021-01-29;578;124;14769;490;2.2;0.1
45;2021-01-30;40;41;14809;531;2.2;0.1
45;2021-01-31;37;23;14846;554;2.2;0.1
45;2021-02-01;461;205;15307;759;2.2;0.1
45;2021-02-02;761;467;16068;1226;2.4;0.2
45;2021-02-03;773;479;16841;1705;2.5;0.2
45;2021-02-04;716;274;17557;1979;2.6;0.3
45;2021-02-05;418;152;17975;2131;2.6;0.3
45;2021-02-06;39;29;18014;2160;2.6;0.3
45;2021-02-07;7;31;18021;2191;2.6;0.3
45;2021-02-08;455;194;18476;2385;2.7;0.3
45;2021-02-09;1006;411;19482;2796;2.9;0.4
45;2021-02-10;1280;811;20762;3607;3.0;0.5
45;2021-02-11;1384;1528;22146;5135;3.2;0.8
45;2021-02-12;1052;1140;23198;6275;3.4;0.9
45;2021-02-13;85;158;23283;6433;3.4;0.9
45;2021-02-14;40;11;23323;6444;3.4;0.9
45;2021-02-15;524;607;23847;7051;3.5;1.0
45;2021-02-16;758;933;24605;7984;3.6;1.2
45;2021-02-17;642;1046;25247;9030;3.7;1.3
45;2021-02-18;842;849;26089;9879;3.8;1.4
45;2021-02-19;827;761;26916;10640;3.9;1.6
45;2021-02-20;59;94;26975;10734;4.0;1.6
45;2021-02-21;17;44;26992;10778;4.0;1.6
45;2021-02-22;409;632;27401;11410;4.0;1.7
45;2021-02-23;816;790;28217;12200;4.1;1.8
45;2021-02-24;656;917;28873;13117;4.2;1.9
45;2021-02-25;963;781;29836;13898;4.4;2.0
45;2021-02-26;1044;684;30880;14582;4.5;2.1
45;2021-02-27;291;52;31171;14634;4.6;2.1
45;2021-02-28;29;5;31200;14639;4.6;2.1
45;2021-03-01;536;336;31736;14975;4.6;2.2
45;2021-03-02;668;726;32404;15701;4.7;2.3
45;2021-03-03;981;898;33385;16599;4.9;2.4
45;2021-03-04;1108;995;34493;17594;5.1;2.6
45;2021-03-05;1444;875;35937;18469;5.3;2.7
45;2021-03-06;2021;141;37958;18610;5.6;2.7
45;2021-03-07;143;59;38101;18669;5.6;2.7
45;2021-03-08;753;848;38854;19517;5.7;2.9
45;2021-03-09;1256;720;40110;20237;5.9;3.0
45;2021-03-10;1591;906;41701;21143;6.1;3.1
45;2021-03-11;1722;757;43423;21900;6.4;3.2
45;2021-03-12;2072;615;45495;22515;6.7;3.3
45;2021-03-13;988;48;46483;22563;6.8;3.3
45;2021-03-14;24;43;46507;22606;6.8;3.3
45;2021-03-15;810;597;47317;23203;6.9;3.4
45;2021-03-16;942;839;48259;24042;7.1;3.5
45;2021-03-17;1054;689;49313;24731;7.2;3.6
45;2021-03-18;997;585;50310;25316;7.4;3.7
45;2021-03-19;1619;431;51929;25747;7.6;3.8
45;2021-03-20;498;82;52427;25829;7.7;3.8
45;2021-03-21;20;35;52447;25864;7.7;3.8
45;2021-03-22;914;533;53361;26397;7.8;3.9
45;2021-03-23;1985;731;55346;27128;8.1;4.0
45;2021-03-24;1896;556;57242;27684;8.4;4.1
45;2021-03-25;2983;458;60225;28142;8.8;4.1
45;2021-03-26;3390;489;63615;28631;9.3;4.2
45;2021-03-27;1796;126;65411;28757;9.6;4.2
45;2021-03-28;89;40;65500;28797;9.6;4.2
45;2021-03-29;1531;543;67031;29340;9.8;4.3
45;2021-03-30;2785;791;69816;30131;10.2;4.4
45;2021-03-31;2135;585;71951;30716;10.5;4.5
45;2021-04-01;2968;569;74919;31285;11.0;4.6
45;2021-04-02;2827;522;77746;31807;11.4;4.7
45;2021-04-03;810;73;78556;31880;11.5;4.7
45;2021-04-04;113;33;78669;31913;11.5;4.7
45;2021-04-05;15;2;78684;31915;11.5;4.7
45;2021-04-06;1735;798;80419;32713;11.8;4.8
45;2021-04-07;1775;1118;82194;33831;12.0;5.0
45;2021-04-08;2772;1024;84966;34855;12.4;5.1
45;2021-04-09;3676;650;88642;35505;13.0;5.2
45;2021-04-10;2323;120;90965;35625;13.3;5.2
45;2021-04-11;153;25;91118;35650;13.3;5.2
45;2021-04-12;2606;679;93724;36329;13.7;5.3
45;2021-04-13;3848;1096;97572;37425;14.3;5.5
45;2021-04-14;2929;1225;100501;38650;14.7;5.7
45;2021-04-15;3519;1045;104020;39695;15.2;5.8
45;2021-04-16;3775;694;107795;40389;15.8;5.9
45;2021-04-17;1614;116;109409;40505;16.0;5.9
45;2021-04-18;200;43;109609;40548;16.1;5.9
45;2021-04-19;1938;946;111547;41494;16.3;6.1
45;2021-04-20;3074;1701;114621;43195;16.8;6.3
45;2021-04-21;2726;1310;117347;44505;17.2;6.5
45;2021-04-22;3420;1845;120767;46350;17.7;6.8
45;2021-04-23;3278;1788;124045;48138;18.2;7.0
45;2021-04-24;2023;870;126068;49008;18.5;7.2
45;2021-04-25;291;87;126359;49095;18.5;7.2
45;2021-04-26;2229;1166;128588;50261;18.8;7.4
45;2021-04-27;3351;2354;131939;52615;19.3;7.7
45;2021-04-28;2801;1947;134740;54562;19.7;8.0
45;2021-04-29;3854;2346;138594;56908;20.3;8.3
45;2021-04-30;4391;1816;142985;58724;20.9;8.6
45;2021-05-01;451;62;143436;58786;21.0;8.6
45;2021-05-02;627;122;144063;58908;21.1;8.6
45;2021-05-03;2821;994;146884;59902;21.5;8.8
45;2021-05-04;3157;2351;150041;62253;22.0;9.1
45;2021-05-05;2715;2164;152756;64417;22.4;9.4
45;2021-05-06;3330;2543;156086;66960;22.9;9.8
45;2021-05-07;2871;3199;158957;70159;23.3;10.3
45;2021-05-08;613;251;159570;70410;23.4;10.3
45;2021-05-09;1498;133;161068;70543;23.6;10.3
45;2021-05-10;4139;2982;165207;73525;24.2;10.8
45;2021-05-11;5030;2975;170237;76500;24.9;11.2
45;2021-05-12;6078;2786;176315;79286;25.8;11.6
45;2021-05-13;2449;598;178764;79884;26.2;11.7
45;2021-05-14;4965;1633;183729;81517;26.9;11.9
45;2021-05-15;4066;618;187795;82135;27.5;12.0
45;2021-05-16;289;33;188084;82168;27.5;12.0
45;2021-05-17;3359;1538;191443;83706;28.0;12.3
45;2021-05-18;5117;1682;196560;85388;28.8;12.5
45;2021-05-19;4494;2064;201054;87452;29.4;12.8
45;2021-05-20;5267;2142;206321;89594;30.2;13.1
45;2021-05-21;5141;2226;211462;91820;31.0;13.4
45;2021-05-22;3042;632;214504;92452;31.4;13.5
45;2021-05-23;15;94;214519;92546;31.4;13.6
45;2021-05-24;2826;216;217345;92762;31.8;13.6
45;2021-05-25;4961;3034;222306;95796;32.6;14.0
45;2021-05-26;5106;2338;227412;98134;33.3;14.4
45;2021-05-27;5306;3237;232718;101371;34.1;14.8
45;2021-05-28;5665;3593;238383;104964;34.9;15.4
45;2021-05-29;3671;1290;242054;106254;35.4;15.6
45;2021-05-30;33;182;242087;106436;35.5;15.6
45;2021-05-31;4331;2520;246418;108956;36.1;16.0
45;2021-06-01;6090;3007;252508;111963;37.0;16.4
45;2021-06-02;4937;3108;257445;115071;37.7;16.9
45;2021-06-03;5615;3207;263060;118278;38.5;17.3
45;2021-06-04;5895;3186;268955;121464;39.4;17.8
45;2021-06-05;2035;1338;270990;122802;39.7;18.0
45;2021-06-06;88;198;271078;123000;39.7;18.0
45;2021-06-07;4081;2724;275159;125724;40.3;18.4
45;2021-06-08;4646;4080;279805;129804;41.0;19.0
45;2021-06-09;4356;3345;284161;133149;41.6;19.5
45;2021-06-10;4646;2687;288807;135836;42.3;19.9
45;2021-06-11;4121;3669;292928;139505;42.9;20.4
45;2021-06-12;2440;1507;295368;141012;43.3;20.6
45;2021-06-13;21;424;295389;141436;43.3;20.7
45;2021-06-14;3142;4158;298531;145594;43.7;21.3
45;2021-06-15;3388;4325;301919;149919;44.2;22.0
45;2021-06-16;3908;3457;305827;153376;44.8;22.5
45;2021-06-17;3522;3538;309349;156914;45.3;23.0
45;2021-06-18;3799;5028;313148;161942;45.9;23.7
45;2021-06-19;2393;1761;315541;163703;46.2;24.0
45;2021-06-20;48;142;315589;163845;46.2;24.0
45;2021-06-21;2164;5851;317753;169696;46.5;24.8
45;2021-06-22;2417;6530;320170;176226;46.9;25.8
45;2021-06-23;2282;5600;322452;181826;47.2;26.6
45;2021-06-24;2137;3531;324589;185357;47.5;27.1
45;2021-06-25;2444;6446;327033;191803;47.9;28.1
45;2021-06-26;1948;3094;328981;194897;48.2;28.5
45;2021-06-27;53;138;329034;195035;48.2;28.6
45;2021-06-28;2083;4835;331117;199870;48.5;29.3
45;2021-06-29;2848;6817;333965;206687;48.9;30.3
45;2021-06-30;2888;5854;336853;212541;49.3;31.1
45;2021-07-01;2398;5039;339251;217580;49.7;31.9
45;2021-07-02;2378;6284;341629;223864;50.0;32.8
45;2021-07-03;754;2540;342383;226404;50.1;33.2
45;2021-07-04;6;12;342389;226416;50.1;33.2
45;2021-07-05;2143;4992;344532;231408;50.5;33.9
45;2021-07-06;2806;6776;347338;238184;50.9;34.9
45;2021-07-07;2447;6064;349785;244248;51.2;35.8
45;2021-07-08;2827;5377;352612;249625;51.6;36.6
45;2021-07-09;2158;6986;354770;256611;52.0;37.6
45;2021-07-10;1552;3862;356322;260473;52.2;38.1
45;2021-07-11;24;31;356346;260504;52.2;38.1
45;2021-07-12;1591;5996;357937;266500;52.4;39.0
45;2021-07-13;3042;8236;360979;274736;52.9;40.2
45;2021-07-14;1480;1520;362459;276256;53.1;40.5
45;2021-07-15;3734;7291;366193;283547;53.6;41.5
45;2021-07-16;3255;7447;369448;290994;54.1;42.6
45;2021-07-17;1285;2332;370733;293326;54.3;43.0
45;2021-07-18;15;19;370748;293345;54.3;43.0
45;2021-07-19;1870;5936;372618;299281;54.6;43.8
45;2021-07-20;4756;6904;377374;306185;55.3;44.8
45;2021-07-21;5176;5480;382550;311665;56.0;45.6
45;2021-07-22;6179;4904;388729;316569;56.9;46.4
45;2021-07-23;4260;5483;392989;322052;57.5;47.2
45;2021-07-24;1864;2825;394853;324877;57.8;47.6
45;2021-07-25;5;14;394858;324891;57.8;47.6
45;2021-07-26;2913;4985;397771;329876;58.2;48.3
45;2021-07-27;5464;5084;403235;334960;59.0;49.1
45;2021-07-28;4989;4181;408224;339141;59.8;49.7
45;2021-07-29;5281;3257;413505;342398;60.6;50.1
45;2021-07-30;4762;4708;418267;347106;61.2;50.8
45;2021-07-31;849;1950;419116;349056;61.4;51.1
45;2021-08-01;2;4;419118;349060;61.4;51.1
45;2021-08-02;3639;3245;422757;352305;61.9;51.6
45;2021-08-03;4878;3011;427635;355316;62.6;52.0
45;2021-08-04;3744;2236;431379;357552;63.2;52.4
45;2021-08-05;3327;2641;434706;360193;63.7;52.7
45;2021-08-06;3747;3271;438453;363464;64.2;53.2
45;2021-08-07;1680;1050;440133;364514;64.5;53.4
45;2021-08-08;9;18;440142;364532;64.5;53.4
45;2021-08-09;2627;3015;442769;367547;64.8;53.8
45;2021-08-10;3517;3808;446286;371355;65.4;54.4
45;2021-08-11;2701;3721;448987;375076;65.7;54.9
45;2021-08-12;2093;3430;451080;378506;66.1;55.4
45;2021-08-13;1743;4224;452823;382730;66.3;56.0
45;2021-08-14;681;956;453504;383686;66.4;56.2
45;2021-08-15;62;31;453566;383717;66.4;56.2
45;2021-08-16;1158;2318;454724;386035;66.6;56.5
45;2021-08-17;1859;3448;456583;389483;66.9;57.0
45;2021-08-18;1782;4050;458365;393533;67.1;57.6
45;2021-08-19;1445;4268;459810;397801;67.3;58.3
45;2021-08-20;1424;3681;461234;401482;67.5;58.8
45;2021-08-21;905;1154;462139;402636;67.7;59.0
45;2021-08-22;4;8;462143;402644;67.7;59.0
45;2021-08-23;1333;4245;463476;406889;67.9;59.6
45;2021-08-24;1736;4522;465212;411411;68.1;60.2
45;2021-08-25;1585;3726;466797;415137;68.4;60.8
45;2021-08-26;1010;3450;467807;418587;68.5;61.3
45;2021-08-27;1432;4982;469239;423569;68.7;62.0
45;2021-08-28;878;2029;470117;425598;68.8;62.3
45;2021-08-29;100;37;470217;425635;68.9;62.3
45;2021-08-30;1222;4040;471439;429675;69.0;62.9
45;2021-08-31;1077;4391;472516;434066;69.2;63.6
45;2021-09-01;1105;3385;473621;437451;69.4;64.1
45;2021-09-02;925;3116;474546;440567;69.5;64.5
45;2021-09-03;1090;3595;475636;444162;69.7;65.0
45;2021-09-04;495;1261;476131;445423;69.7;65.2
45;2021-09-05;1;16;476132;445439;69.7;65.2
45;2021-09-06;885;2361;477017;447800;69.9;65.6
45;2021-09-07;712;1725;477729;449525;70.0;65.8
45;2021-09-08;859;2218;478588;451743;70.1;66.2
45;2021-09-09;799;1443;479387;453186;70.2;66.4
45;2021-09-10;787;1608;480174;454794;70.3;66.6
45;2021-09-11;444;1520;480618;456314;70.4;66.8
45;2021-09-12;372;161;480990;456475;70.4;66.8
45;2021-09-13;441;973;481431;457448;70.5;67.0
45;2021-09-14;759;1439;482190;458887;70.6;67.2
45;2021-09-15;800;1829;482990;460716;70.7;67.5
45;2021-09-16;804;963;483794;461679;70.8;67.6
45;2021-09-17;766;1655;484560;463334;71.0;67.8
45;2021-09-18;483;991;485043;464325;71.0;68.0
45;2021-09-19;2;29;485045;464354;71.0;68.0
45;2021-09-20;413;979;485458;465333;71.1;68.1
45;2021-09-21;448;749;485906;466082;71.2;68.3
45;2021-09-22;442;1703;486348;467785;71.2;68.5
45;2021-09-23;531;840;486879;468625;71.3;68.6
45;2021-09-24;579;1381;487458;470006;71.4;68.8
45;2021-09-25;351;783;487809;470789;71.4;68.9
45;2021-09-26;2;11;487811;470800;71.4;68.9
45;2021-09-27;435;758;488246;471558;71.5;69.1
45;2021-09-28;451;754;488697;472312;71.6;69.2
45;2021-09-29;477;969;489174;473281;71.6;69.3
45;2021-09-30;357;823;489531;474104;71.7;69.4
45;2021-10-01;317;768;489848;474872;71.7;69.5
45;2021-10-02;293;546;490141;475418;71.8;69.6
45;2021-10-03;98;369;490239;475787;71.8;69.7
45;2021-10-04;219;341;490458;476128;71.8;69.7
45;2021-10-05;347;655;490805;476783;71.9;69.8
45;2021-10-06;436;720;491241;477503;71.9;69.9
45;2021-10-07;282;760;491523;478263;72.0;70.0
45;2021-10-08;342;667;491865;478930;72.0;70.1
45;2021-10-09;418;721;492283;479651;72.1;70.2
45;2021-10-10;4;7;492287;479658;72.1;70.2
45;2021-10-11;200;413;492487;480071;72.1;70.3
45;2021-10-12;342;532;492829;480603;72.2;70.4
45;2021-10-13;333;619;493162;481222;72.2;70.5
45;2021-10-14;255;392;493417;481614;72.3;70.5
46;2020-12-27;4;0;4;0;0.0;0.0
46;2020-12-28;0;0;4;0;0.0;0.0
46;2020-12-29;0;0;4;0;0.0;0.0
46;2020-12-30;0;0;4;0;0.0;0.0
46;2020-12-31;0;0;4;0;0.0;0.0
46;2021-01-01;0;0;4;0;0.0;0.0
46;2021-01-02;0;0;4;0;0.0;0.0
46;2021-01-03;1;0;5;0;0.0;0.0
46;2021-01-04;0;0;5;0;0.0;0.0
46;2021-01-05;0;0;5;0;0.0;0.0
46;2021-01-06;3;0;8;0;0.0;0.0
46;2021-01-07;135;1;143;1;0.1;0.0
46;2021-01-08;181;0;324;1;0.2;0.0
46;2021-01-09;1;0;325;1;0.2;0.0
46;2021-01-10;2;0;327;1;0.2;0.0
46;2021-01-11;118;0;445;1;0.3;0.0
46;2021-01-12;141;0;586;1;0.3;0.0
46;2021-01-13;235;2;821;3;0.5;0.0
46;2021-01-14;244;3;1065;6;0.6;0.0
46;2021-01-15;306;2;1371;8;0.8;0.0
46;2021-01-16;18;0;1389;8;0.8;0.0
46;2021-01-17;0;0;1389;8;0.8;0.0
46;2021-01-18;276;3;1665;11;1.0;0.0
46;2021-01-19;390;1;2055;12;1.2;0.0
46;2021-01-20;939;3;2994;15;1.7;0.0
46;2021-01-21;998;1;3992;16;2.3;0.0
46;2021-01-22;391;2;4383;18;2.5;0.0
46;2021-01-23;0;0;4383;18;2.5;0.0
46;2021-01-24;0;0;4383;18;2.5;0.0
46;2021-01-25;204;2;4587;20;2.6;0.0
46;2021-01-26;264;1;4851;21;2.8;0.0
46;2021-01-27;276;0;5127;21;3.0;0.0
46;2021-01-28;279;43;5406;64;3.1;0.0
46;2021-01-29;233;91;5639;155;3.3;0.1
46;2021-01-30;1;0;5640;155;3.3;0.1
46;2021-01-31;1;0;5641;155;3.3;0.1
46;2021-02-01;234;173;5875;328;3.4;0.2
46;2021-02-02;210;238;6085;566;3.5;0.3
46;2021-02-03;227;97;6312;663;3.6;0.4
46;2021-02-04;372;86;6684;749;3.9;0.4
46;2021-02-05;226;177;6910;926;4.0;0.5
46;2021-02-06;9;0;6919;926;4.0;0.5
46;2021-02-07;43;0;6962;926;4.0;0.5
46;2021-02-08;197;156;7159;1082;4.1;0.6
46;2021-02-09;271;225;7430;1307;4.3;0.8
46;2021-02-10;280;546;7710;1853;4.5;1.1
46;2021-02-11;655;557;8365;2410;4.8;1.4
46;2021-02-12;324;342;8689;2752;5.0;1.6
46;2021-02-13;2;0;8691;2752;5.0;1.6
46;2021-02-14;0;62;8691;2814;5.0;1.6
46;2021-02-15;196;293;8887;3107;5.1;1.8
46;2021-02-16;217;284;9104;3391;5.3;2.0
46;2021-02-17;201;328;9305;3719;5.4;2.1
46;2021-02-18;337;267;9642;3986;5.6;2.3
46;2021-02-19;277;234;9919;4220;5.7;2.4
46;2021-02-20;0;0;9919;4220;5.7;2.4
46;2021-02-21;1;0;9920;4220;5.7;2.4
46;2021-02-22;131;193;10051;4413;5.8;2.5
46;2021-02-23;225;169;10276;4582;5.9;2.6
46;2021-02-24;179;324;10455;4906;6.0;2.8
46;2021-02-25;248;341;10703;5247;6.2;3.0
46;2021-02-26;403;344;11106;5591;6.4;3.2
46;2021-02-27;120;1;11226;5592;6.5;3.2
46;2021-02-28;0;3;11226;5595;6.5;3.2
46;2021-03-01;169;181;11395;5776;6.6;3.3
46;2021-03-02;406;233;11801;6009;6.8;3.5
46;2021-03-03;460;331;12261;6340;7.1;3.7
46;2021-03-04;607;456;12868;6796;7.4;3.9
46;2021-03-05;808;365;13676;7161;7.9;4.1
46;2021-03-06;476;17;14152;7178;8.2;4.1
46;2021-03-07;101;19;14253;7197;8.2;4.2
46;2021-03-08;348;249;14601;7446;8.4;4.3
46;2021-03-09;746;271;15347;7717;8.9;4.5
46;2021-03-10;686;248;16033;7965;9.3;4.6
46;2021-03-11;851;257;16884;8222;9.8;4.7
46;2021-03-12;927;228;17811;8450;10.3;4.9
46;2021-03-13;512;4;18323;8454;10.6;4.9
46;2021-03-14;1;0;18324;8454;10.6;4.9
46;2021-03-15;505;166;18829;8620;10.9;5.0
46;2021-03-16;752;174;19581;8794;11.3;5.1
46;2021-03-17;674;207;20255;9001;11.7;5.2
46;2021-03-18;758;216;21013;9217;12.1;5.3
46;2021-03-19;811;153;21824;9370;12.6;5.4
46;2021-03-20;294;5;22118;9375;12.8;5.4
46;2021-03-21;2;0;22120;9375;12.8;5.4
46;2021-03-22;555;241;22675;9616;13.1;5.6
46;2021-03-23;702;212;23377;9828;13.5;5.7
46;2021-03-24;673;240;24050;10068;13.9;5.8
46;2021-03-25;1135;187;25185;10255;14.5;5.9
46;2021-03-26;1023;342;26208;10597;15.1;6.1
46;2021-03-27;420;73;26628;10670;15.4;6.2
46;2021-03-28;127;1;26755;10671;15.5;6.2
46;2021-03-29;733;253;27488;10924;15.9;6.3
46;2021-03-30;767;365;28255;11289;16.3;6.5
46;2021-03-31;865;421;29120;11710;16.8;6.8
46;2021-04-01;1172;351;30292;12061;17.5;7.0
46;2021-04-02;922;396;31214;12457;18.0;7.2
46;2021-04-03;167;166;31381;12623;18.1;7.3
46;2021-04-04;0;71;31381;12694;18.1;7.3
46;2021-04-05;3;0;31384;12694;18.1;7.3
46;2021-04-06;544;517;31928;13211;18.4;7.6
46;2021-04-07;784;647;32712;13858;18.9;8.0
46;2021-04-08;960;542;33672;14400;19.4;8.3
46;2021-04-09;1018;506;34690;14906;20.0;8.6
46;2021-04-10;506;211;35196;15117;20.3;8.7
46;2021-04-11;232;1;35428;15118;20.5;8.7
46;2021-04-12;845;547;36273;15665;20.9;9.0
46;2021-04-13;1186;721;37459;16386;21.6;9.5
46;2021-04-14;1533;615;38992;17001;22.5;9.8
46;2021-04-15;1505;665;40497;17666;23.4;10.2
46;2021-04-16;1584;566;42081;18232;24.3;10.5
46;2021-04-17;995;137;43076;18369;24.9;10.6
46;2021-04-18;517;10;43593;18379;25.2;10.6
46;2021-04-19;1070;573;44663;18952;25.8;10.9
46;2021-04-20;1229;734;45892;19686;26.5;11.4
46;2021-04-21;1230;714;47122;20400;27.2;11.8
46;2021-04-22;1391;730;48513;21130;28.0;12.2
46;2021-04-23;1132;733;49645;21863;28.7;12.6
46;2021-04-24;472;19;50117;21882;28.9;12.6
46;2021-04-25;351;11;50468;21893;29.1;12.6
46;2021-04-26;852;730;51320;22623;29.6;13.1
46;2021-04-27;1221;668;52541;23291;30.3;13.5
46;2021-04-28;1289;669;53830;23960;31.1;13.8
46;2021-04-29;1417;527;55247;24487;31.9;14.1
46;2021-04-30;1438;569;56685;25056;32.7;14.5
46;2021-05-01;697;74;57382;25130;33.1;14.5
46;2021-05-02;346;4;57728;25134;33.3;14.5
46;2021-05-03;853;570;58581;25704;33.8;14.8
46;2021-05-04;1037;1063;59618;26767;34.4;15.5
46;2021-05-05;1373;789;60991;27556;35.2;15.9
46;2021-05-06;1377;743;62368;28299;36.0;16.3
46;2021-05-07;1396;791;63764;29090;36.8;16.8
46;2021-05-08;280;412;64044;29502;37.0;17.0
46;2021-05-09;23;225;64067;29727;37.0;17.2
46;2021-05-10;515;1137;64582;30864;37.3;17.8
46;2021-05-11;1031;1256;65613;32120;37.9;18.5
46;2021-05-12;993;1564;66606;33684;38.5;19.5
46;2021-05-13;598;143;67204;33827;38.8;19.5
46;2021-05-14;958;1097;68162;34924;39.4;20.2
46;2021-05-15;254;654;68416;35578;39.5;20.5
46;2021-05-16;77;297;68493;35875;39.6;20.7
46;2021-05-17;652;960;69145;36835;39.9;21.3
46;2021-05-18;1402;1024;70547;37859;40.7;21.9
46;2021-05-19;1305;904;71852;38763;41.5;22.4
46;2021-05-20;1453;813;73305;39576;42.3;22.9
46;2021-05-21;997;1158;74302;40734;42.9;23.5
46;2021-05-22;146;369;74448;41103;43.0;23.7
46;2021-05-23;451;26;74899;41129;43.3;23.8
46;2021-05-24;411;113;75310;41242;43.5;23.8
46;2021-05-25;960;1333;76270;42575;44.0;24.6
46;2021-05-26;1237;1149;77507;43724;44.8;25.2
46;2021-05-27;1431;1195;78938;44919;45.6;25.9
46;2021-05-28;1428;1211;80366;46130;46.4;26.6
46;2021-05-29;1049;397;81415;46527;47.0;26.9
46;2021-05-30;409;39;81824;46566;47.3;26.9
46;2021-05-31;968;976;82792;47542;47.8;27.5
46;2021-06-01;1277;999;84069;48541;48.5;28.0
46;2021-06-02;1319;1116;85388;49657;49.3;28.7
46;2021-06-03;1415;1012;86803;50669;50.1;29.3
46;2021-06-04;1330;977;88133;51646;50.9;29.8
46;2021-06-05;381;414;88514;52060;51.1;30.1
46;2021-06-06;209;96;88723;52156;51.2;30.1
46;2021-06-07;814;617;89537;52773;51.7;30.5
46;2021-06-08;1020;896;90557;53669;52.3;31.0
46;2021-06-09;1505;974;92062;54643;53.2;31.6
46;2021-06-10;981;852;93043;55495;53.7;32.0
46;2021-06-11;969;1322;94012;56817;54.3;32.8
46;2021-06-12;459;549;94471;57366;54.6;33.1
46;2021-06-13;27;86;94498;57452;54.6;33.2
46;2021-06-14;593;1138;95091;58590;54.9;33.8
46;2021-06-15;751;1247;95842;59837;55.3;34.6
46;2021-06-16;1002;1113;96844;60950;55.9;35.2
46;2021-06-17;527;897;97371;61847;56.2;35.7
46;2021-06-18;656;1253;98027;63100;56.6;36.4
46;2021-06-19;457;313;98484;63413;56.9;36.6
46;2021-06-20;39;161;98523;63574;56.9;36.7
46;2021-06-21;429;946;98952;64520;57.1;37.3
46;2021-06-22;350;1177;99302;65697;57.3;37.9
46;2021-06-23;519;1074;99821;66771;57.6;38.6
46;2021-06-24;251;820;100072;67591;57.8;39.0
46;2021-06-25;491;1118;100563;68709;58.1;39.7
46;2021-06-26;398;553;100961;69262;58.3;40.0
46;2021-06-27;3;4;100964;69266;58.3;40.0
46;2021-06-28;315;1341;101279;70607;58.5;40.8
46;2021-06-29;375;1680;101654;72287;58.7;41.7
46;2021-06-30;509;1577;102163;73864;59.0;42.7
46;2021-07-01;487;1153;102650;75017;59.3;43.3
46;2021-07-02;455;1087;103105;76104;59.5;43.9
46;2021-07-03;120;454;103225;76558;59.6;44.2
46;2021-07-04;57;127;103282;76685;59.6;44.3
46;2021-07-05;347;1185;103629;77870;59.8;45.0
46;2021-07-06;449;1457;104078;79327;60.1;45.8
46;2021-07-07;583;1728;104661;81055;60.4;46.8
46;2021-07-08;340;1164;105001;82219;60.6;47.5
46;2021-07-09;395;1706;105396;83925;60.9;48.5
46;2021-07-10;285;1039;105681;84964;61.0;49.1
46;2021-07-11;15;375;105696;85339;61.0;49.3
46;2021-07-12;248;1259;105944;86598;61.2;50.0
46;2021-07-13;626;1670;106570;88268;61.5;51.0
46;2021-07-14;73;144;106643;88412;61.6;51.1
46;2021-07-15;917;1464;107560;89876;62.1;51.9
46;2021-07-16;766;1394;108326;91270;62.6;52.7
46;2021-07-17;364;539;108690;91809;62.8;53.0
46;2021-07-18;2;0;108692;91809;62.8;53.0
46;2021-07-19;729;1188;109421;92997;63.2;53.7
46;2021-07-20;983;1438;110404;94435;63.8;54.5
46;2021-07-21;1001;1379;111405;95814;64.3;55.3
46;2021-07-22;1404;1118;112809;96932;65.1;56.0
46;2021-07-23;768;1322;113577;98254;65.6;56.7
46;2021-07-24;957;665;114534;98919;66.1;57.1
46;2021-07-25;136;17;114670;98936;66.2;57.1
46;2021-07-26;881;878;115551;99814;66.7;57.6
46;2021-07-27;1220;978;116771;100792;67.4;58.2
46;2021-07-28;1284;1114;118055;101906;68.2;58.8
46;2021-07-29;1580;849;119635;102755;69.1;59.3
46;2021-07-30;1933;956;121568;103711;70.2;59.9
46;2021-07-31;958;662;122526;104373;70.8;60.3
46;2021-08-01;12;3;122538;104376;70.8;60.3
46;2021-08-02;974;591;123512;104967;71.3;60.6
46;2021-08-03;1365;679;124877;105646;72.1;61.0
46;2021-08-04;1735;586;126612;106232;73.1;61.3
46;2021-08-05;1382;843;127994;107075;73.9;61.8
46;2021-08-06;1422;848;129416;107923;74.7;62.3
46;2021-08-07;707;544;130123;108467;75.1;62.6
46;2021-08-08;152;66;130275;108533;75.2;62.7
46;2021-08-09;1018;694;131293;109227;75.8;63.1
46;2021-08-10;1206;892;132499;110119;76.5;63.6
46;2021-08-11;1260;1064;133759;111183;77.2;64.2
46;2021-08-12;990;800;134749;111983;77.8;64.7
46;2021-08-13;953;1005;135702;112988;78.4;65.2
46;2021-08-14;588;774;136290;113762;78.7;65.7
46;2021-08-15;8;27;136298;113789;78.7;65.7
46;2021-08-16;795;811;137093;114600;79.2;66.2
46;2021-08-17;889;1288;137982;115888;79.7;66.9
46;2021-08-18;770;1051;138752;116939;80.1;67.5
46;2021-08-19;673;1362;139425;118301;80.5;68.3
46;2021-08-20;520;1557;139945;119858;80.8;69.2
46;2021-08-21;378;649;140323;120507;81.0;69.6
46;2021-08-22;2;31;140325;120538;81.0;69.6
46;2021-08-23;424;1204;140749;121742;81.3;70.3
46;2021-08-24;555;1338;141304;123080;81.6;71.1
46;2021-08-25;530;1398;141834;124478;81.9;71.9
46;2021-08-26;392;1095;142226;125573;82.1;72.5
46;2021-08-27;436;1912;142662;127485;82.4;73.6
46;2021-08-28;272;652;142934;128137;82.5;74.0
46;2021-08-29;5;11;142939;128148;82.5;74.0
46;2021-08-30;295;1112;143234;129260;82.7;74.6
46;2021-08-31;340;1239;143574;130499;82.9;75.4
46;2021-09-01;393;1083;143967;131582;83.1;76.0
46;2021-09-02;271;963;144238;132545;83.3;76.5
46;2021-09-03;322;1155;144560;133700;83.5;77.2
46;2021-09-04;188;635;144748;134335;83.6;77.6
46;2021-09-05;8;15;144756;134350;83.6;77.6
46;2021-09-06;219;655;144975;135005;83.7;78.0
46;2021-09-07;252;683;145227;135688;83.9;78.4
46;2021-09-08;277;798;145504;136486;84.0;78.8
46;2021-09-09;201;531;145705;137017;84.1;79.1
46;2021-09-10;277;851;145982;137868;84.3;79.6
46;2021-09-11;151;354;146133;138222;84.4;79.8
46;2021-09-12;8;22;146141;138244;84.4;79.8
46;2021-09-13;179;503;146320;138747;84.5;80.1
46;2021-09-14;266;403;146586;139150;84.7;80.4
46;2021-09-15;257;677;146843;139827;84.8;80.7
46;2021-09-16;132;265;146975;140092;84.9;80.9
46;2021-09-17;234;555;147209;140647;85.0;81.2
46;2021-09-18;100;364;147309;141011;85.1;81.4
46;2021-09-19;3;9;147312;141020;85.1;81.4
46;2021-09-20;70;350;147382;141370;85.1;81.6
46;2021-09-21;70;238;147452;141608;85.2;81.8
46;2021-09-22;128;482;147580;142090;85.2;82.1
46;2021-09-23;83;226;147663;142316;85.3;82.2
46;2021-09-24;76;400;147739;142716;85.3;82.4
46;2021-09-25;69;221;147808;142937;85.4;82.5
46;2021-09-26;3;8;147811;142945;85.4;82.5
46;2021-09-27;76;229;147887;143174;85.4;82.7
46;2021-09-28;48;225;147935;143399;85.4;82.8
46;2021-09-29;84;291;148019;143690;85.5;83.0
46;2021-09-30;63;146;148082;143836;85.5;83.1
46;2021-10-01;101;296;148183;144132;85.6;83.2
46;2021-10-02;80;191;148263;144323;85.6;83.3
46;2021-10-03;0;0;148263;144323;85.6;83.3
46;2021-10-04;63;189;148326;144512;85.7;83.5
46;2021-10-05;66;220;148392;144732;85.7;83.6
46;2021-10-06;72;219;148464;144951;85.7;83.7
46;2021-10-07;61;177;148525;145128;85.8;83.8
46;2021-10-08;123;267;148648;145395;85.8;84.0
46;2021-10-09;71;139;148719;145534;85.9;84.0
46;2021-10-10;4;7;148723;145541;85.9;84.0
46;2021-10-11;57;132;148780;145673;85.9;84.1
46;2021-10-12;40;71;148820;145744;85.9;84.2
46;2021-10-13;71;154;148891;145898;86.0;84.3
46;2021-10-14;53;113;148944;146011;86.0;84.3
47;2020-12-27;0;0;0;0;0.0;0.0
47;2020-12-28;0;0;0;0;0.0;0.0
47;2020-12-29;0;0;0;0;0.0;0.0
47;2020-12-30;0;0;0;0;0.0;0.0
47;2020-12-31;0;0;0;0;0.0;0.0
47;2021-01-01;4;0;4;0;0.0;0.0
47;2021-01-02;0;0;4;0;0.0;0.0
47;2021-01-03;0;0;4;0;0.0;0.0
47;2021-01-04;0;0;4;0;0.0;0.0
47;2021-01-05;1;0;5;0;0.0;0.0
47;2021-01-06;0;0;5;0;0.0;0.0
47;2021-01-07;71;1;76;1;0.0;0.0
47;2021-01-08;314;0;390;1;0.1;0.0
47;2021-01-09;113;0;503;1;0.2;0.0
47;2021-01-10;0;0;503;1;0.2;0.0
47;2021-01-11;249;1;752;2;0.2;0.0
47;2021-01-12;327;0;1079;2;0.3;0.0
47;2021-01-13;349;0;1428;2;0.4;0.0
47;2021-01-14;370;4;1798;6;0.5;0.0
47;2021-01-15;287;2;2085;8;0.6;0.0
47;2021-01-16;176;4;2261;12;0.7;0.0
47;2021-01-17;0;0;2261;12;0.7;0.0
47;2021-01-18;487;2;2748;14;0.8;0.0
47;2021-01-19;468;3;3216;17;1.0;0.0
47;2021-01-20;518;1;3734;18;1.1;0.0
47;2021-01-21;586;1;4320;19;1.3;0.0
47;2021-01-22;471;1;4791;20;1.5;0.0
47;2021-01-23;390;0;5181;20;1.6;0.0
47;2021-01-24;0;0;5181;20;1.6;0.0
47;2021-01-25;434;0;5615;20;1.7;0.0
47;2021-01-26;792;7;6407;27;1.9;0.0
47;2021-01-27;731;1;7138;28;2.2;0.0
47;2021-01-28;575;67;7713;95;2.3;0.0
47;2021-01-29;461;170;8174;265;2.5;0.1
47;2021-01-30;301;39;8475;304;2.6;0.1
47;2021-01-31;0;0;8475;304;2.6;0.1
47;2021-02-01;372;117;8847;421;2.7;0.1
47;2021-02-02;759;316;9606;737;2.9;0.2
47;2021-02-03;426;163;10032;900;3.0;0.3
47;2021-02-04;370;317;10402;1217;3.1;0.4
47;2021-02-05;300;309;10702;1526;3.2;0.5
47;2021-02-06;297;99;10999;1625;3.3;0.5
47;2021-02-07;0;0;10999;1625;3.3;0.5
47;2021-02-08;183;285;11182;1910;3.4;0.6
47;2021-02-09;231;258;11413;2168;3.5;0.7
47;2021-02-10;254;245;11667;2413;3.5;0.7
47;2021-02-11;356;378;12023;2791;3.6;0.8
47;2021-02-12;243;412;12266;3203;3.7;1.0
47;2021-02-13;226;111;12492;3314;3.8;1.0
47;2021-02-14;0;0;12492;3314;3.8;1.0
47;2021-02-15;194;381;12686;3695;3.8;1.1
47;2021-02-16;303;588;12989;4283;3.9;1.3
47;2021-02-17;326;455;13315;4738;4.0;1.4
47;2021-02-18;201;597;13516;5335;4.1;1.6
47;2021-02-19;193;365;13709;5700;4.2;1.7
47;2021-02-20;117;268;13826;5968;4.2;1.8
47;2021-02-21;0;0;13826;5968;4.2;1.8
47;2021-02-22;75;406;13901;6374;4.2;1.9
47;2021-02-23;149;651;14050;7025;4.3;2.1
47;2021-02-24;261;564;14311;7589;4.3;2.3
47;2021-02-25;304;412;14615;8001;4.4;2.4
47;2021-02-26;467;323;15082;8324;4.6;2.5
47;2021-02-27;324;213;15406;8537;4.7;2.6
47;2021-02-28;0;0;15406;8537;4.7;2.6
47;2021-03-01;124;398;15530;8935;4.7;2.7
47;2021-03-02;199;366;15729;9301;4.8;2.8
47;2021-03-03;244;350;15973;9651;4.8;2.9
47;2021-03-04;593;333;16566;9984;5.0;3.0
47;2021-03-05;845;287;17411;10271;5.3;3.1
47;2021-03-06;506;194;17917;10465;5.4;3.2
47;2021-03-07;331;6;18248;10471;5.5;3.2
47;2021-03-08;459;226;18707;10697;5.7;3.2
47;2021-03-09;508;494;19215;11191;5.8;3.4
47;2021-03-10;666;301;19881;11492;6.0;3.5
47;2021-03-11;940;383;20821;11875;6.3;3.6
47;2021-03-12;1373;301;22194;12176;6.7;3.7
47;2021-03-13;950;110;23144;12286;7.0;3.7
47;2021-03-14;51;0;23195;12286;7.0;3.7
47;2021-03-15;593;163;23788;12449;7.2;3.8
47;2021-03-16;750;178;24538;12627;7.4;3.8
47;2021-03-17;861;213;25399;12840;7.7;3.9
47;2021-03-18;917;177;26316;13017;8.0;3.9
47;2021-03-19;1272;129;27588;13146;8.4;4.0
47;2021-03-20;1088;60;28676;13206;8.7;4.0
47;2021-03-21;344;1;29020;13207;8.8;4.0
47;2021-03-22;1009;96;30029;13303;9.1;4.0
47;2021-03-23;1146;149;31175;13452;9.4;4.1
47;2021-03-24;1214;133;32389;13585;9.8;4.1
47;2021-03-25;1567;156;33956;13741;10.3;4.2
47;2021-03-26;1882;202;35838;13943;10.8;4.2
47;2021-03-27;980;131;36818;14074;11.1;4.3
47;2021-03-28;699;6;37517;14080;11.4;4.3
47;2021-03-29;1511;82;39028;14162;11.8;4.3
47;2021-03-30;1645;128;40673;14290;12.3;4.3
47;2021-03-31;1605;157;42278;14447;12.8;4.4
47;2021-04-01;1682;270;43960;14717;13.3;4.5
47;2021-04-02;1932;457;45892;15174;13.9;4.6
47;2021-04-03;1202;184;47094;15358;14.3;4.6
47;2021-04-04;475;13;47569;15371;14.4;4.7
47;2021-04-05;1297;61;48866;15432;14.8;4.7
47;2021-04-06;1386;390;50252;15822;15.2;4.8
47;2021-04-07;1698;598;51950;16420;15.7;5.0
47;2021-04-08;1834;479;53784;16899;16.3;5.1
47;2021-04-09;2085;547;55869;17446;16.9;5.3
47;2021-04-10;1565;326;57434;17772;17.4;5.4
47;2021-04-11;530;9;57964;17781;17.5;5.4
47;2021-04-12;1438;619;59402;18400;18.0;5.6
47;2021-04-13;1813;765;61215;19165;18.5;5.8
47;2021-04-14;1750;722;62965;19887;19.1;6.0
47;2021-04-15;2012;849;64977;20736;19.7;6.3
47;2021-04-16;1768;898;66745;21634;20.2;6.5
47;2021-04-17;1471;969;68216;22603;20.7;6.8
47;2021-04-18;23;0;68239;22603;20.7;6.8
47;2021-04-19;1331;932;69570;23535;21.1;7.1
47;2021-04-20;1625;910;71195;24445;21.6;7.4
47;2021-04-21;1623;775;72818;25220;22.0;7.6
47;2021-04-22;1880;1059;74698;26279;22.6;8.0
47;2021-04-23;1729;1077;76427;27356;23.1;8.3
47;2021-04-24;1549;807;77976;28163;23.6;8.5
47;2021-04-25;242;345;78218;28508;23.7;8.6
47;2021-04-26;1491;1366;79709;29874;24.1;9.0
47;2021-04-27;1921;1476;81630;31350;24.7;9.5
47;2021-04-28;2090;1595;83720;32945;25.3;10.0
47;2021-04-29;2532;1514;86252;34459;26.1;10.4
47;2021-04-30;2044;1780;88296;36239;26.7;11.0
47;2021-05-01;2263;986;90559;37225;27.4;11.3
47;2021-05-02;21;358;90580;37583;27.4;11.4
47;2021-05-03;1596;1422;92176;39005;27.9;11.8
47;2021-05-04;1645;1732;93821;40737;28.4;12.3
47;2021-05-05;1926;1643;95747;42380;29.0;12.8
47;2021-05-06;2105;1509;97852;43889;29.6;13.3
47;2021-05-07;2001;1623;99853;45512;30.2;13.8
47;2021-05-08;2097;464;101950;45976;30.9;13.9
47;2021-05-09;24;359;101974;46335;30.9;14.0
47;2021-05-10;1202;1672;103176;48007;31.2;14.5
47;2021-05-11;2172;1987;105348;49994;31.9;15.1
47;2021-05-12;2624;1451;107972;51445;32.7;15.6
47;2021-05-13;2380;656;110352;52101;33.4;15.8
47;2021-05-14;2061;859;112413;52960;34.0;16.0
47;2021-05-15;1934;865;114347;53825;34.6;16.3
47;2021-05-16;367;9;114714;53834;34.7;16.3
47;2021-05-17;1884;1124;116598;54958;35.3;16.6
47;2021-05-18;2359;1140;118957;56098;36.0;17.0
47;2021-05-19;2344;759;121301;56857;36.7;17.2
47;2021-05-20;2589;973;123890;57830;37.5;17.5
47;2021-05-21;1538;1134;125428;58964;38.0;17.8
47;2021-05-22;2369;839;127797;59803;38.7;18.1
47;2021-05-23;25;186;127822;59989;38.7;18.2
47;2021-05-24;1549;237;129371;60226;39.2;18.2
47;2021-05-25;1481;1318;130852;61544;39.6;18.6
47;2021-05-26;1599;1091;132451;62635;40.1;19.0
47;2021-05-27;1944;1269;134395;63904;40.7;19.3
47;2021-05-28;1459;1537;135854;65441;41.1;19.8
47;2021-05-29;1153;1124;137007;66565;41.5;20.2
47;2021-05-30;12;45;137019;66610;41.5;20.2
47;2021-05-31;1868;1424;138887;68034;42.0;20.6
47;2021-06-01;1921;1344;140808;69378;42.6;21.0
47;2021-06-02;2100;1332;142908;70710;43.3;21.4
47;2021-06-03;2486;1614;145394;72324;44.0;21.9
47;2021-06-04;1965;2118;147359;74442;44.6;22.5
47;2021-06-05;1640;1475;148999;75917;45.1;23.0
47;2021-06-06;211;70;149210;75987;45.2;23.0
47;2021-06-07;1659;2238;150869;78225;45.7;23.7
47;2021-06-08;1629;1904;152498;80129;46.2;24.3
47;2021-06-09;1824;2124;154322;82253;46.7;24.9
47;2021-06-10;2377;1620;156699;83873;47.4;25.4
47;2021-06-11;1826;2101;158525;85974;48.0;26.0
47;2021-06-12;1351;2102;159876;88076;48.4;26.7
47;2021-06-13;4;10;159880;88086;48.4;26.7
47;2021-06-14;1281;2444;161161;90530;48.8;27.4
47;2021-06-15;1464;2033;162625;92563;49.2;28.0
47;2021-06-16;1203;2189;163828;94752;49.6;28.7
47;2021-06-17;1657;1524;165485;96276;50.1;29.1
47;2021-06-18;1439;2496;166924;98772;50.5;29.9
47;2021-06-19;1542;2453;168466;101225;51.0;30.6
47;2021-06-20;5;33;168471;101258;51.0;30.7
47;2021-06-21;1136;2513;169607;103771;51.3;31.4
47;2021-06-22;762;2507;170369;106278;51.6;32.2
47;2021-06-23;999;2015;171368;108293;51.9;32.8
47;2021-06-24;1211;1937;172579;110230;52.2;33.4
47;2021-06-25;1006;2608;173585;112838;52.5;34.2
47;2021-06-26;986;2789;174571;115627;52.8;35.0
47;2021-06-27;16;349;174587;115976;52.9;35.1
47;2021-06-28;875;2407;175462;118383;53.1;35.8
47;2021-06-29;797;2313;176259;120696;53.4;36.5
47;2021-06-30;730;2303;176989;122999;53.6;37.2
47;2021-07-01;923;2107;177912;125106;53.9;37.9
47;2021-07-02;885;2274;178797;127380;54.1;38.6
47;2021-07-03;726;3042;179523;130422;54.3;39.5
47;2021-07-04;34;12;179557;130434;54.4;39.5
47;2021-07-05;978;2147;180535;132581;54.7;40.1
47;2021-07-06;1007;1957;181542;134538;55.0;40.7
47;2021-07-07;1298;2064;182840;136602;55.3;41.4
47;2021-07-08;1143;2193;183983;138795;55.7;42.0
47;2021-07-09;1047;2405;185030;141200;56.0;42.7
47;2021-07-10;951;2131;185981;143331;56.3;43.4
47;2021-07-11;1;6;185982;143337;56.3;43.4
47;2021-07-12;556;2580;186538;145917;56.5;44.2
47;2021-07-13;1094;2585;187632;148502;56.8;45.0
47;2021-07-14;1165;1577;188797;150079;57.2;45.4
47;2021-07-15;1717;3135;190514;153214;57.7;46.4
47;2021-07-16;1722;2677;192236;155891;58.2;47.2
47;2021-07-17;1201;2458;193437;158349;58.6;47.9
47;2021-07-18;36;188;193473;158537;58.6;48.0
47;2021-07-19;1113;2561;194586;161098;58.9;48.8
47;2021-07-20;1638;2341;196224;163439;59.4;49.5
47;2021-07-21;2192;2240;198416;165679;60.1;50.2
47;2021-07-22;2157;2298;200573;167977;60.7;50.9
47;2021-07-23;2124;2251;202697;170228;61.4;51.5
47;2021-07-24;1114;1915;203811;172143;61.7;52.1
47;2021-07-25;20;1;203831;172144;61.7;52.1
47;2021-07-26;1236;1946;205067;174090;62.1;52.7
47;2021-07-27;2123;1634;207190;175724;62.7;53.2
47;2021-07-28;1880;1606;209070;177330;63.3;53.7
47;2021-07-29;2340;1605;211410;178935;64.0;54.2
47;2021-07-30;1865;1627;213275;180562;64.6;54.7
47;2021-07-31;1486;1668;214761;182230;65.0;55.2
47;2021-08-01;18;8;214779;182238;65.0;55.2
47;2021-08-02;2053;1219;216832;183457;65.6;55.5
47;2021-08-03;2159;1106;218991;184563;66.3;55.9
47;2021-08-04;2192;1528;221183;186091;67.0;56.3
47;2021-08-05;2408;1447;223591;187538;67.7;56.8
47;2021-08-06;1999;1841;225590;189379;68.3;57.3
47;2021-08-07;1628;1418;227218;190797;68.8;57.8
47;2021-08-08;24;22;227242;190819;68.8;57.8
47;2021-08-09;1883;1214;229125;192033;69.4;58.1
47;2021-08-10;1919;1298;231044;193331;69.9;58.5
47;2021-08-11;1804;1401;232848;194732;70.5;58.9
47;2021-08-12;2059;1340;234907;196072;71.1;59.4
47;2021-08-13;1424;1668;236331;197740;71.5;59.9
47;2021-08-14;1349;1443;237680;199183;72.0;60.3
47;2021-08-15;11;18;237691;199201;72.0;60.3
47;2021-08-16;1436;1445;239127;200646;72.4;60.7
47;2021-08-17;1124;1684;240251;202330;72.7;61.2
47;2021-08-18;1181;1714;241432;204044;73.1;61.8
47;2021-08-19;1039;1813;242471;205857;73.4;62.3
47;2021-08-20;972;1708;243443;207565;73.7;62.8
47;2021-08-21;829;1277;244272;208842;73.9;63.2
47;2021-08-22;19;31;244291;208873;74.0;63.2
47;2021-08-23;615;1827;244906;210700;74.1;63.8
47;2021-08-24;811;1622;245717;212322;74.4;64.3
47;2021-08-25;811;1787;246528;214109;74.6;64.8
47;2021-08-26;741;2080;247269;216189;74.9;65.4
47;2021-08-27;700;1979;247969;218168;75.1;66.0
47;2021-08-28;568;1670;248537;219838;75.2;66.5
47;2021-08-29;2;16;248539;219854;75.2;66.6
47;2021-08-30;459;1908;248998;221762;75.4;67.1
47;2021-08-31;583;1793;249581;223555;75.6;67.7
47;2021-09-01;422;1956;250003;225511;75.7;68.3
47;2021-09-02;436;1945;250439;227456;75.8;68.9
47;2021-09-03;504;1844;250943;229300;76.0;69.4
47;2021-09-04;479;1743;251422;231043;76.1;69.9
47;2021-09-05;12;35;251434;231078;76.1;70.0
47;2021-09-06;344;1251;251778;232329;76.2;70.3
47;2021-09-07;478;1114;252256;233443;76.4;70.7
47;2021-09-08;419;1484;252675;234927;76.5;71.1
47;2021-09-09;423;1098;253098;236025;76.6;71.4
47;2021-09-10;473;1163;253571;237188;76.8;71.8
47;2021-09-11;438;1373;254009;238561;76.9;72.2
47;2021-09-12;5;6;254014;238567;76.9;72.2
47;2021-09-13;256;731;254270;239298;77.0;72.4
47;2021-09-14;402;797;254672;240095;77.1;72.7
47;2021-09-15;342;940;255014;241035;77.2;73.0
47;2021-09-16;324;560;255338;241595;77.3;73.1
47;2021-09-17;398;646;255736;242241;77.4;73.3
47;2021-09-18;263;956;255999;243197;77.5;73.6
47;2021-09-19;4;4;256003;243201;77.5;73.6
47;2021-09-20;166;470;256169;243671;77.5;73.8
47;2021-09-21;285;455;256454;244126;77.6;73.9
47;2021-09-22;219;617;256673;244743;77.7;74.1
47;2021-09-23;209;378;256882;245121;77.8;74.2
47;2021-09-24;283;614;257165;245735;77.8;74.4
47;2021-09-25;215;628;257380;246363;77.9;74.6
47;2021-09-26;6;6;257386;246369;77.9;74.6
47;2021-09-27;112;377;257498;246746;78.0;74.7
47;2021-09-28;127;375;257625;247121;78.0;74.8
47;2021-09-29;148;473;257773;247594;78.0;75.0
47;2021-09-30;160;356;257933;247950;78.1;75.1
47;2021-10-01;182;519;258115;248469;78.1;75.2
47;2021-10-02;195;486;258310;248955;78.2;75.4
47;2021-10-03;0;5;258310;248960;78.2;75.4
47;2021-10-04;132;362;258442;249322;78.2;75.5
47;2021-10-05;110;307;258552;249629;78.3;75.6
47;2021-10-06;228;459;258780;250088;78.3;75.7
47;2021-10-07;155;367;258935;250455;78.4;75.8
47;2021-10-08;171;413;259106;250868;78.4;75.9
47;2021-10-09;246;378;259352;251246;78.5;76.1
47;2021-10-10;0;3;259352;251249;78.5;76.1
47;2021-10-11;139;207;259491;251456;78.6;76.1
47;2021-10-12;133;286;259624;251742;78.6;76.2
47;2021-10-13;139;287;259763;252029;78.6;76.3
47;2021-10-14;97;219;259860;252248;78.7;76.4
48;2020-12-27;0;0;0;0;0.0;0.0
48;2020-12-28;0;0;0;0;0.0;0.0
48;2020-12-29;0;0;0;0;0.0;0.0
48;2020-12-30;0;0;0;0;0.0;0.0
48;2020-12-31;0;0;0;0;0.0;0.0
48;2021-01-01;0;0;0;0;0.0;0.0
48;2021-01-02;0;0;0;0;0.0;0.0
48;2021-01-03;0;0;0;0;0.0;0.0
48;2021-01-04;0;0;0;0;0.0;0.0
48;2021-01-05;0;0;0;0;0.0;0.0
48;2021-01-06;0;0;0;0;0.0;0.0
48;2021-01-07;56;0;56;0;0.1;0.0
48;2021-01-08;88;1;144;1;0.2;0.0
48;2021-01-09;1;0;145;1;0.2;0.0
48;2021-01-10;0;0;145;1;0.2;0.0
48;2021-01-11;13;0;158;1;0.2;0.0
48;2021-01-12;20;1;178;2;0.2;0.0
48;2021-01-13;104;0;282;2;0.4;0.0
48;2021-01-14;90;1;372;3;0.5;0.0
48;2021-01-15;63;0;435;3;0.6;0.0
48;2021-01-16;0;0;435;3;0.6;0.0
48;2021-01-17;0;0;435;3;0.6;0.0
48;2021-01-18;117;0;552;3;0.7;0.0
48;2021-01-19;345;2;897;5;1.2;0.0
48;2021-01-20;364;0;1261;5;1.7;0.0
48;2021-01-21;466;1;1727;6;2.3;0.0
48;2021-01-22;269;0;1996;6;2.6;0.0
48;2021-01-23;36;0;2032;6;2.7;0.0
48;2021-01-24;0;0;2032;6;2.7;0.0
48;2021-01-25;109;2;2141;8;2.8;0.0
48;2021-01-26;261;0;2402;8;3.1;0.0
48;2021-01-27;257;2;2659;10;3.5;0.0
48;2021-01-28;273;11;2932;21;3.8;0.0
48;2021-01-29;175;60;3107;81;4.1;0.1
48;2021-01-30;1;7;3108;88;4.1;0.1
48;2021-01-31;0;6;3108;94;4.1;0.1
48;2021-02-01;100;48;3208;142;4.2;0.2
48;2021-02-02;195;36;3403;178;4.5;0.2
48;2021-02-03;177;82;3580;260;4.7;0.3
48;2021-02-04;234;14;3814;274;5.0;0.4
48;2021-02-05;145;37;3959;311;5.2;0.4
48;2021-02-06;34;1;3993;312;5.2;0.4
48;2021-02-07;0;0;3993;312;5.2;0.4
48;2021-02-08;50;60;4043;372;5.3;0.5
48;2021-02-09;66;167;4109;539;5.4;0.7
48;2021-02-10;65;303;4174;842;5.5;1.1
48;2021-02-11;165;407;4339;1249;5.7;1.6
48;2021-02-12;120;155;4459;1404;5.8;1.8
48;2021-02-13;8;55;4467;1459;5.9;1.9
48;2021-02-14;0;0;4467;1459;5.9;1.9
48;2021-02-15;51;106;4518;1565;5.9;2.1
48;2021-02-16;43;173;4561;1738;6.0;2.3
48;2021-02-17;35;284;4596;2022;6.0;2.7
48;2021-02-18;252;113;4848;2135;6.4;2.8
48;2021-02-19;60;183;4908;2318;6.4;3.0
48;2021-02-20;0;1;4908;2319;6.4;3.0
48;2021-02-21;0;14;4908;2333;6.4;3.1
48;2021-02-22;24;129;4932;2462;6.5;3.2
48;2021-02-23;74;221;5006;2683;6.6;3.5
48;2021-02-24;68;265;5074;2948;6.7;3.9
48;2021-02-25;148;263;5222;3211;6.8;4.2
48;2021-02-26;51;229;5273;3440;6.9;4.5
48;2021-02-27;28;1;5301;3441;6.9;4.5
48;2021-02-28;3;14;5304;3455;7.0;4.5
48;2021-03-01;102;97;5406;3552;7.1;4.7
48;2021-03-02;199;87;5605;3639;7.3;4.8
48;2021-03-03;152;109;5757;3748;7.5;4.9
48;2021-03-04;195;183;5952;3931;7.8;5.2
48;2021-03-05;136;141;6088;4072;8.0;5.3
48;2021-03-06;180;53;6268;4125;8.2;5.4
48;2021-03-07;75;2;6343;4127;8.3;5.4
48;2021-03-08;352;148;6695;4275;8.8;5.6
48;2021-03-09;377;106;7072;4381;9.3;5.7
48;2021-03-10;263;61;7335;4442;9.6;5.8
48;2021-03-11;334;91;7669;4533;10.1;5.9
48;2021-03-12;256;153;7925;4686;10.4;6.1
48;2021-03-13;301;5;8226;4691;10.8;6.1
48;2021-03-14;8;0;8234;4691;10.8;6.1
48;2021-03-15;174;64;8408;4755;11.0;6.2
48;2021-03-16;167;66;8575;4821;11.2;6.3
48;2021-03-17;156;110;8731;4931;11.4;6.5
48;2021-03-18;191;104;8922;5035;11.7;6.6
48;2021-03-19;116;96;9038;5131;11.8;6.7
48;2021-03-20;101;0;9139;5131;12.0;6.7
48;2021-03-21;0;0;9139;5131;12.0;6.7
48;2021-03-22;160;21;9299;5152;12.2;6.8
48;2021-03-23;329;103;9628;5255;12.6;6.9
48;2021-03-24;284;100;9912;5355;13.0;7.0
48;2021-03-25;757;123;10669;5478;14.0;7.2
48;2021-03-26;269;62;10938;5540;14.3;7.3
48;2021-03-27;104;1;11042;5541;14.5;7.3
48;2021-03-28;80;21;11122;5562;14.6;7.3
48;2021-03-29;305;81;11427;5643;15.0;7.4
48;2021-03-30;365;132;11792;5775;15.5;7.6
48;2021-03-31;448;88;12240;5863;16.0;7.7
48;2021-04-01;732;73;12972;5936;17.0;7.8
48;2021-04-02;487;136;13459;6072;17.6;8.0
48;2021-04-03;140;83;13599;6155;17.8;8.1
48;2021-04-04;0;0;13599;6155;17.8;8.1
48;2021-04-05;43;1;13642;6156;17.9;8.1
48;2021-04-06;465;160;14107;6316;18.5;8.3
48;2021-04-07;465;142;14572;6458;19.1;8.5
48;2021-04-08;620;188;15192;6646;19.9;8.7
48;2021-04-09;446;123;15638;6769;20.5;8.9
48;2021-04-10;95;60;15733;6829;20.6;9.0
48;2021-04-11;2;0;15735;6829;20.6;9.0
48;2021-04-12;364;71;16099;6900;21.1;9.0
48;2021-04-13;361;93;16460;6993;21.6;9.2
48;2021-04-14;624;187;17084;7180;22.4;9.4
48;2021-04-15;701;363;17785;7543;23.3;9.9
48;2021-04-16;538;229;18323;7772;24.0;10.2
48;2021-04-17;89;73;18412;7845;24.1;10.3
48;2021-04-18;0;0;18412;7845;24.1;10.3
48;2021-04-19;196;106;18608;7951;24.4;10.4
48;2021-04-20;216;182;18824;8133;24.7;10.7
48;2021-04-21;284;207;19108;8340;25.0;10.9
48;2021-04-22;306;482;19414;8822;25.4;11.6
48;2021-04-23;255;242;19669;9064;25.8;11.9
48;2021-04-24;97;95;19766;9159;25.9;12.0
48;2021-04-25;1;9;19767;9168;25.9;12.0
48;2021-04-26;87;211;19854;9379;26.0;12.3
48;2021-04-27;172;292;20026;9671;26.3;12.7
48;2021-04-28;149;415;20175;10086;26.4;13.2
48;2021-04-29;203;490;20378;10576;26.7;13.9
48;2021-04-30;172;226;20550;10802;26.9;14.2
48;2021-05-01;0;0;20550;10802;26.9;14.2
48;2021-05-02;0;0;20550;10802;26.9;14.2
48;2021-05-03;105;386;20655;11188;27.1;14.7
48;2021-05-04;227;421;20882;11609;27.4;15.2
48;2021-05-05;84;486;20966;12095;27.5;15.9
48;2021-05-06;775;642;21741;12737;28.5;16.7
48;2021-05-07;96;503;21837;13240;28.6;17.4
48;2021-05-08;309;43;22146;13283;29.0;17.4
48;2021-05-09;285;9;22431;13292;29.4;17.4
48;2021-05-10;55;325;22486;13617;29.5;17.8
48;2021-05-11;221;290;22707;13907;29.8;18.2
48;2021-05-12;249;313;22956;14220;30.1;18.6
48;2021-05-13;472;158;23428;14378;30.7;18.8
48;2021-05-14;244;222;23672;14600;31.0;19.1
48;2021-05-15;84;46;23756;14646;31.1;19.2
48;2021-05-16;1;6;23757;14652;31.1;19.2
48;2021-05-17;474;267;24231;14919;31.8;19.6
48;2021-05-18;263;229;24494;15148;32.1;19.9
48;2021-05-19;207;277;24701;15425;32.4;20.2
48;2021-05-20;318;256;25019;15681;32.8;20.6
48;2021-05-21;174;267;25193;15948;33.0;20.9
48;2021-05-22;25;50;25218;15998;33.1;21.0
48;2021-05-23;0;6;25218;16004;33.1;21.0
48;2021-05-24;0;14;25218;16018;33.1;21.0
48;2021-05-25;181;267;25399;16285;33.3;21.3
48;2021-05-26;416;298;25815;16583;33.8;21.7
48;2021-05-27;1178;380;26993;16963;35.4;22.2
48;2021-05-28;315;350;27308;17313;35.8;22.7
48;2021-05-29;79;50;27387;17363;35.9;22.8
48;2021-05-30;0;1;27387;17364;35.9;22.8
48;2021-05-31;624;263;28011;17627;36.7;23.1
48;2021-06-01;272;305;28283;17932;37.1;23.5
48;2021-06-02;407;424;28690;18356;37.6;24.1
48;2021-06-03;629;431;29319;18787;38.4;24.6
48;2021-06-04;291;283;29610;19070;38.8;25.0
48;2021-06-05;121;77;29731;19147;39.0;25.1
48;2021-06-06;1;1;29732;19148;39.0;25.1
48;2021-06-07;440;161;30172;19309;39.6;25.3
48;2021-06-08;616;309;30788;19618;40.4;25.7
48;2021-06-09;379;190;31167;19808;40.9;26.0
48;2021-06-10;1003;242;32170;20050;42.2;26.3
48;2021-06-11;371;161;32541;20211;42.7;26.5
48;2021-06-12;74;57;32615;20268;42.8;26.6
48;2021-06-13;0;2;32615;20270;42.8;26.6
48;2021-06-14;124;115;32739;20385;42.9;26.7
48;2021-06-15;407;386;33146;20771;43.4;27.2
48;2021-06-16;260;144;33406;20915;43.8;27.4
48;2021-06-17;486;575;33892;21490;44.4;28.2
48;2021-06-18;254;315;34146;21805;44.8;28.6
48;2021-06-19;35;291;34181;22096;44.8;29.0
48;2021-06-20;123;224;34304;22320;45.0;29.3
48;2021-06-21;125;134;34429;22454;45.1;29.4
48;2021-06-22;258;335;34687;22789;45.5;29.9
48;2021-06-23;111;545;34798;23334;45.6;30.6
48;2021-06-24;364;610;35162;23944;46.1;31.4
48;2021-06-25;154;276;35316;24220;46.3;31.7
48;2021-06-26;15;45;35331;24265;46.3;31.8
48;2021-06-27;1;1;35332;24266;46.3;31.8
48;2021-06-28;81;177;35413;24443;46.4;32.0
48;2021-06-29;297;415;35710;24858;46.8;32.6
48;2021-06-30;98;465;35808;25323;46.9;33.2
48;2021-07-01;194;669;36002;25992;47.2;34.1
48;2021-07-02;148;369;36150;26361;47.4;34.6
48;2021-07-03;42;89;36192;26450;47.4;34.7
48;2021-07-04;7;0;36199;26450;47.5;34.7
48;2021-07-05;40;117;36239;26567;47.5;34.8
48;2021-07-06;277;598;36516;27165;47.9;35.6
48;2021-07-07;201;489;36717;27654;48.1;36.3
48;2021-07-08;223;1189;36940;28843;48.4;37.8
48;2021-07-09;159;553;37099;29396;48.6;38.5
48;2021-07-10;95;147;37194;29543;48.8;38.7
48;2021-07-11;0;4;37194;29547;48.8;38.7
48;2021-07-12;139;672;37333;30219;48.9;39.6
48;2021-07-13;211;430;37544;30649;49.2;40.2
48;2021-07-14;179;145;37723;30794;49.4;40.4
48;2021-07-15;187;459;37910;31253;49.7;41.0
48;2021-07-16;234;315;38144;31568;50.0;41.4
48;2021-07-17;129;118;38273;31686;50.2;41.5
48;2021-07-18;4;5;38277;31691;50.2;41.5
48;2021-07-19;105;306;38382;31997;50.3;41.9
48;2021-07-20;677;993;39059;32990;51.2;43.2
48;2021-07-21;68;371;39127;33361;51.3;43.7
48;2021-07-22;777;1125;39904;34486;52.3;45.2
48;2021-07-23;367;439;40271;34925;52.8;45.8
48;2021-07-24;509;170;40780;35095;53.5;46.0
48;2021-07-25;138;46;40918;35141;53.6;46.1
48;2021-07-26;101;199;41019;35340;53.8;46.3
48;2021-07-27;1195;644;42214;35984;55.3;47.2
48;2021-07-28;177;316;42391;36300;55.6;47.6
48;2021-07-29;716;646;43107;36946;56.5;48.4
48;2021-07-30;200;292;43307;37238;56.8;48.8
48;2021-07-31;339;178;43646;37416;57.2;49.0
48;2021-08-01;18;55;43664;37471;57.2;49.1
48;2021-08-02;228;164;43892;37635;57.5;49.3
48;2021-08-03;925;575;44817;38210;58.7;50.1
48;2021-08-04;328;220;45145;38430;59.2;50.4
48;2021-08-05;673;474;45818;38904;60.1;51.0
48;2021-08-06;442;275;46260;39179;60.6;51.4
48;2021-08-07;249;125;46509;39304;61.0;51.5
48;2021-08-08;2;5;46511;39309;61.0;51.5
48;2021-08-09;170;141;46681;39450;61.2;51.7
48;2021-08-10;726;555;47407;40005;62.1;52.4
48;2021-08-11;295;238;47702;40243;62.5;52.8
48;2021-08-12;419;414;48121;40657;63.1;53.3
48;2021-08-13;229;212;48350;40869;63.4;53.6
48;2021-08-14;137;165;48487;41034;63.6;53.8
48;2021-08-15;131;81;48618;41115;63.7;53.9
48;2021-08-16;121;192;48739;41307;63.9;54.1
48;2021-08-17;364;1188;49103;42495;64.4;55.7
48;2021-08-18;211;201;49314;42696;64.6;56.0
48;2021-08-19;240;325;49554;43021;65.0;56.4
48;2021-08-20;215;284;49769;43305;65.2;56.8
48;2021-08-21;85;232;49854;43537;65.4;57.1
48;2021-08-22;0;0;49854;43537;65.4;57.1
48;2021-08-23;65;153;49919;43690;65.4;57.3
48;2021-08-24;308;953;50227;44643;65.8;58.5
48;2021-08-25;156;351;50383;44994;66.0;59.0
48;2021-08-26;180;499;50563;45493;66.3;59.6
48;2021-08-27;153;339;50716;45832;66.5;60.1
48;2021-08-28;127;303;50843;46135;66.6;60.5
48;2021-08-29;0;1;50843;46136;66.6;60.5
48;2021-08-30;54;143;50897;46279;66.7;60.7
48;2021-08-31;257;1051;51154;47330;67.1;62.0
48;2021-09-01;124;334;51278;47664;67.2;62.5
48;2021-09-02;131;388;51409;48052;67.4;63.0
48;2021-09-03;138;297;51547;48349;67.6;63.4
48;2021-09-04;122;209;51669;48558;67.7;63.7
48;2021-09-05;3;25;51672;48583;67.7;63.7
48;2021-09-06;34;178;51706;48761;67.8;63.9
48;2021-09-07;160;347;51866;49108;68.0;64.4
48;2021-09-08;96;181;51962;49289;68.1;64.6
48;2021-09-09;96;235;52058;49524;68.2;64.9
48;2021-09-10;128;263;52186;49787;68.4;65.3
48;2021-09-11;89;195;52275;49982;68.5;65.5
48;2021-09-12;1;2;52276;49984;68.5;65.5
48;2021-09-13;78;66;52354;50050;68.6;65.6
48;2021-09-14;205;259;52559;50309;68.9;65.9
48;2021-09-15;68;164;52627;50473;69.0;66.2
48;2021-09-16;122;221;52749;50694;69.1;66.5
48;2021-09-17;101;183;52850;50877;69.3;66.7
48;2021-09-18;33;90;52883;50967;69.3;66.8
48;2021-09-19;0;0;52883;50967;69.3;66.8
48;2021-09-20;30;88;52913;51055;69.4;66.9
48;2021-09-21;64;183;52977;51238;69.4;67.2
48;2021-09-22;49;151;53026;51389;69.5;67.4
48;2021-09-23;28;100;53054;51489;69.5;67.5
48;2021-09-24;43;118;53097;51607;69.6;67.6
48;2021-09-25;27;78;53124;51685;69.6;67.8
48;2021-09-26;1;0;53125;51685;69.6;67.8
48;2021-09-27;11;43;53136;51728;69.7;67.8
48;2021-09-28;66;155;53202;51883;69.7;68.0
48;2021-09-29;51;133;53253;52016;69.8;68.2
48;2021-09-30;42;87;53295;52103;69.9;68.3
48;2021-10-01;56;141;53351;52244;69.9;68.5
48;2021-10-02;33;51;53384;52295;70.0;68.6
48;2021-10-03;0;1;53384;52296;70.0;68.6
48;2021-10-04;19;62;53403;52358;70.0;68.6
48;2021-10-05;49;151;53452;52509;70.1;68.8
48;2021-10-06;66;94;53518;52603;70.2;69.0
48;2021-10-07;33;112;53551;52715;70.2;69.1
48;2021-10-08;37;113;53588;52828;70.2;69.2
48;2021-10-09;14;55;53602;52883;70.3;69.3
48;2021-10-10;0;1;53602;52884;70.3;69.3
48;2021-10-11;6;25;53608;52909;70.3;69.4
48;2021-10-12;38;94;53646;53003;70.3;69.5
48;2021-10-13;38;80;53684;53083;70.4;69.6
48;2021-10-14;37;69;53721;53152;70.4;69.7
49;2020-12-27;0;0;0;0;0.0;0.0
49;2020-12-28;2;0;2;0;0.0;0.0
49;2020-12-29;0;0;2;0;0.0;0.0
49;2020-12-30;0;0;2;0;0.0;0.0
49;2020-12-31;0;0;2;0;0.0;0.0
49;2021-01-01;2;0;4;0;0.0;0.0
49;2021-01-02;1;1;5;1;0.0;0.0
49;2021-01-03;0;0;5;1;0.0;0.0
49;2021-01-04;10;0;15;1;0.0;0.0
49;2021-01-05;92;0;107;1;0.0;0.0
49;2021-01-06;233;0;340;1;0.0;0.0
49;2021-01-07;367;1;707;2;0.1;0.0
49;2021-01-08;328;1;1035;3;0.1;0.0
49;2021-01-09;118;0;1153;3;0.1;0.0
49;2021-01-10;114;0;1267;3;0.2;0.0
49;2021-01-11;287;0;1554;3;0.2;0.0
49;2021-01-12;623;0;2177;3;0.3;0.0
49;2021-01-13;602;2;2779;5;0.3;0.0
49;2021-01-14;590;7;3369;12;0.4;0.0
49;2021-01-15;764;1;4133;13;0.5;0.0
49;2021-01-16;148;0;4281;13;0.5;0.0
49;2021-01-17;111;2;4392;15;0.5;0.0
49;2021-01-18;691;0;5083;15;0.6;0.0
49;2021-01-19;1204;8;6287;23;0.8;0.0
49;2021-01-20;1511;7;7798;30;1.0;0.0
49;2021-01-21;1943;14;9741;44;1.2;0.0
49;2021-01-22;1305;6;11046;50;1.4;0.0
49;2021-01-23;263;1;11309;51;1.4;0.0
49;2021-01-24;1;0;11310;51;1.4;0.0
49;2021-01-25;552;5;11862;56;1.5;0.0
49;2021-01-26;989;75;12851;131;1.6;0.0
49;2021-01-27;1861;50;14712;181;1.8;0.0
49;2021-01-28;2877;91;17589;272;2.2;0.0
49;2021-01-29;1588;92;19177;364;2.4;0.0
49;2021-01-30;300;46;19477;410;2.4;0.1
49;2021-01-31;62;51;19539;461;2.4;0.1
49;2021-02-01;661;163;20200;624;2.5;0.1
49;2021-02-02;745;384;20945;1008;2.6;0.1
49;2021-02-03;677;382;21622;1390;2.7;0.2
49;2021-02-04;758;445;22380;1835;2.7;0.2
49;2021-02-05;708;591;23088;2426;2.8;0.3
49;2021-02-06;228;110;23316;2536;2.9;0.3
49;2021-02-07;59;83;23375;2619;2.9;0.3
49;2021-02-08;548;480;23923;3099;2.9;0.4
49;2021-02-09;716;648;24639;3747;3.0;0.5
49;2021-02-10;807;950;25446;4697;3.1;0.6
49;2021-02-11;1028;1409;26474;6106;3.2;0.7
49;2021-02-12;869;960;27343;7066;3.4;0.9
49;2021-02-13;266;120;27609;7186;3.4;0.9
49;2021-02-14;9;106;27618;7292;3.4;0.9
49;2021-02-15;730;664;28348;7956;3.5;1.0
49;2021-02-16;1107;1121;29455;9077;3.6;1.1
49;2021-02-17;1160;1872;30615;10949;3.8;1.3
49;2021-02-18;1810;2438;32425;13387;4.0;1.6
49;2021-02-19;1397;1108;33822;14495;4.1;1.8
49;2021-02-20;232;381;34054;14876;4.2;1.8
49;2021-02-21;0;64;34054;14940;4.2;1.8
49;2021-02-22;647;573;34701;15513;4.3;1.9
49;2021-02-23;734;857;35435;16370;4.3;2.0
49;2021-02-24;824;641;36259;17011;4.4;2.1
49;2021-02-25;1208;809;37467;17820;4.6;2.2
49;2021-02-26;1678;848;39145;18668;4.8;2.3
49;2021-02-27;435;282;39580;18950;4.9;2.3
49;2021-02-28;49;38;39629;18988;4.9;2.3
49;2021-03-01;768;587;40397;19575;5.0;2.4
49;2021-03-02;1082;701;41479;20276;5.1;2.5
49;2021-03-03;1559;676;43038;20952;5.3;2.6
49;2021-03-04;1769;942;44807;21894;5.5;2.7
49;2021-03-05;2215;700;47022;22594;5.8;2.8
49;2021-03-06;717;190;47739;22784;5.9;2.8
49;2021-03-07;627;13;48366;22797;5.9;2.8
49;2021-03-08;1398;717;49764;23514;6.1;2.9
49;2021-03-09;2052;745;51816;24259;6.4;3.0
49;2021-03-10;2528;874;54344;25133;6.7;3.1
49;2021-03-11;3195;1477;57539;26610;7.1;3.3
49;2021-03-12;3765;1025;61304;27635;7.5;3.4
49;2021-03-13;1501;218;62805;27853;7.7;3.4
49;2021-03-14;6;0;62811;27853;7.7;3.4
49;2021-03-15;2083;536;64894;28389;8.0;3.5
49;2021-03-16;1732;965;66626;29354;8.2;3.6
49;2021-03-17;1810;681;68436;30035;8.4;3.7
49;2021-03-18;2206;736;70642;30771;8.7;3.8
49;2021-03-19;3333;567;73975;31338;9.1;3.8
49;2021-03-20;1743;210;75718;31548;9.3;3.9
49;2021-03-21;499;23;76217;31571;9.3;3.9
49;2021-03-22;2248;554;78465;32125;9.6;3.9
49;2021-03-23;3406;688;81871;32813;10.0;4.0
49;2021-03-24;3604;508;85475;33321;10.5;4.1
49;2021-03-25;4224;653;89699;33974;11.0;4.2
49;2021-03-26;4886;513;94585;34487;11.6;4.2
49;2021-03-27;1675;105;96260;34592;11.8;4.2
49;2021-03-28;400;28;96660;34620;11.8;4.2
49;2021-03-29;2371;613;99031;35233;12.1;4.3
49;2021-03-30;3267;947;102298;36180;12.5;4.4
49;2021-03-31;2980;754;105278;36934;12.9;4.5
49;2021-04-01;4117;878;109395;37812;13.4;4.6
49;2021-04-02;4298;964;113693;38776;13.9;4.8
49;2021-04-03;971;193;114664;38969;14.1;4.8
49;2021-04-04;315;3;114979;38972;14.1;4.8
49;2021-04-05;944;23;115923;38995;14.2;4.8
49;2021-04-06;2329;1327;118252;40322;14.5;4.9
49;2021-04-07;3309;1371;121561;41693;14.9;5.1
49;2021-04-08;5185;1435;126746;43128;15.5;5.3
49;2021-04-09;6207;1443;132953;44571;16.3;5.5
49;2021-04-10;2065;502;135018;45073;16.5;5.5
49;2021-04-11;390;9;135408;45082;16.6;5.5
49;2021-04-12;4073;1583;139481;46665;17.1;5.7
49;2021-04-13;5380;1921;144861;48586;17.8;6.0
49;2021-04-14;4542;1882;149403;50468;18.3;6.2
49;2021-04-15;5381;1896;154784;52364;19.0;6.4
49;2021-04-16;5761;2145;160545;54509;19.7;6.7
49;2021-04-17;3335;855;163880;55364;20.1;6.8
49;2021-04-18;381;476;164261;55840;20.1;6.8
49;2021-04-19;3710;2061;167971;57901;20.6;7.1
49;2021-04-20;4371;2112;172342;60013;21.1;7.4
49;2021-04-21;3955;2210;176297;62223;21.6;7.6
49;2021-04-22;4837;2114;181134;64337;22.2;7.9
49;2021-04-23;4814;2339;185948;66676;22.8;8.2
49;2021-04-24;2938;1159;188886;67835;23.2;8.3
49;2021-04-25;40;282;188926;68117;23.2;8.3
49;2021-04-26;3744;2113;192670;70230;23.6;8.6
49;2021-04-27;4471;2511;197141;72741;24.2;8.9
49;2021-04-28;4615;2501;201756;75242;24.7;9.2
49;2021-04-29;5206;3027;206962;78269;25.4;9.6
49;2021-04-30;5558;3216;212520;81485;26.0;10.0
49;2021-05-01;2365;667;214885;82152;26.3;10.1
49;2021-05-02;5;40;214890;82192;26.3;10.1
49;2021-05-03;5012;2408;219902;84600;27.0;10.4
49;2021-05-04;4972;3047;224874;87647;27.6;10.7
49;2021-05-05;4789;3008;229663;90655;28.1;11.1
49;2021-05-06;5328;3099;234991;93754;28.8;11.5
49;2021-05-07;4281;5031;239272;98785;29.3;12.1
49;2021-05-08;3577;440;242849;99225;29.8;12.2
49;2021-05-09;10;41;242859;99266;29.8;12.2
49;2021-05-10;4829;4282;247688;103548;30.4;12.7
49;2021-05-11;5397;5092;253085;108640;31.0;13.3
49;2021-05-12;4800;4595;257885;113235;31.6;13.9
49;2021-05-13;4778;691;262663;113926;32.2;14.0
49;2021-05-14;5170;3271;267833;117197;32.8;14.4
49;2021-05-15;4157;1806;271990;119003;33.3;14.6
49;2021-05-16;2786;119;274776;119122;33.7;14.6
49;2021-05-17;4835;3692;279611;122814;34.3;15.1
49;2021-05-18;5472;3769;285083;126583;34.9;15.5
49;2021-05-19;5916;3228;290999;129811;35.7;15.9
49;2021-05-20;6807;2966;297806;132777;36.5;16.3
49;2021-05-21;6450;3746;304256;136523;37.3;16.7
49;2021-05-22;5183;1199;309439;137722;37.9;16.9
49;2021-05-23;1;12;309440;137734;37.9;16.9
49;2021-05-24;4212;448;313652;138182;38.4;16.9
49;2021-05-25;6326;3308;319978;141490;39.2;17.3
49;2021-05-26;6273;2665;326251;144155;40.0;17.7
49;2021-05-27;7114;2728;333365;146883;40.9;18.0
49;2021-05-28;6875;4028;340240;150911;41.7;18.5
49;2021-05-29;5023;1901;345263;152812;42.3;18.7
49;2021-05-30;21;14;345284;152826;42.3;18.7
49;2021-05-31;6036;3221;351320;156047;43.1;19.1
49;2021-06-01;6592;3992;357912;160039;43.9;19.6
49;2021-06-02;5794;3742;363706;163781;44.6;20.1
49;2021-06-03;6602;3421;370308;167202;45.4;20.5
49;2021-06-04;6470;4867;376778;172069;46.2;21.1
49;2021-06-05;4385;2698;381163;174767;46.7;21.4
49;2021-06-06;39;50;381202;174817;46.7;21.4
49;2021-06-07;4634;4761;385836;179578;47.3;22.0
49;2021-06-08;5185;5106;391021;184684;47.9;22.6
49;2021-06-09;5325;4505;396346;189189;48.6;23.2
49;2021-06-10;6005;3785;402351;192974;49.3;23.7
49;2021-06-11;4872;6041;407223;199015;49.9;24.4
49;2021-06-12;4097;3203;411320;202218;50.4;24.8
49;2021-06-13;20;989;411340;203207;50.4;24.9
49;2021-06-14;3410;6016;414750;209223;50.8;25.6
49;2021-06-15;4241;6396;418991;215619;51.4;26.4
49;2021-06-16;4150;5682;423141;221301;51.9;27.1
49;2021-06-17;5069;5078;428210;226379;52.5;27.7
49;2021-06-18;4134;6888;432344;233267;53.0;28.6
49;2021-06-19;3526;3975;435870;237242;53.4;29.1
49;2021-06-20;33;25;435903;237267;53.4;29.1
49;2021-06-21;2828;6512;438731;243779;53.8;29.9
49;2021-06-22;3208;7009;441939;250788;54.2;30.7
49;2021-06-23;3253;6313;445192;257101;54.6;31.5
49;2021-06-24;4317;4979;449509;262080;55.1;32.1
49;2021-06-25;3325;7448;452834;269528;55.5;33.0
49;2021-06-26;2570;4627;455404;274155;55.8;33.6
49;2021-06-27;15;1544;455419;275699;55.8;33.8
49;2021-06-28;2234;7184;457653;282883;56.1;34.7
49;2021-06-29;3028;7272;460681;290155;56.5;35.6
49;2021-06-30;2824;6805;463505;296960;56.8;36.4
49;2021-07-01;3393;6274;466898;303234;57.2;37.2
49;2021-07-02;3063;8067;469961;311301;57.6;38.2
49;2021-07-03;2007;5486;471968;316787;57.8;38.8
49;2021-07-04;7;53;471975;316840;57.8;38.8
49;2021-07-05;1738;7078;473713;323918;58.1;39.7
49;2021-07-06;1894;7551;475607;331469;58.3;40.6
49;2021-07-07;2100;6625;477707;338094;58.6;41.4
49;2021-07-08;2689;6357;480396;344451;58.9;42.2
49;2021-07-09;2361;8251;482757;352702;59.2;43.2
49;2021-07-10;1802;5345;484559;358047;59.4;43.9
49;2021-07-11;12;35;484571;358082;59.4;43.9
49;2021-07-12;1948;7714;486519;365796;59.6;44.8
49;2021-07-13;2572;8304;489091;374100;59.9;45.9
49;2021-07-14;2893;3375;491984;377475;60.3;46.3
49;2021-07-15;3167;7554;495151;385029;60.7;47.2
49;2021-07-16;3396;8299;498547;393328;61.1;48.2
49;2021-07-17;2103;5481;500650;398809;61.4;48.9
49;2021-07-18;3751;583;504401;399392;61.8;49.0
49;2021-07-19;2667;7452;507068;406844;62.1;49.9
49;2021-07-20;3588;7484;510656;414328;62.6;50.8
49;2021-07-21;4228;6464;514884;420792;63.1;51.6
49;2021-07-22;4815;5867;519699;426659;63.7;52.3
49;2021-07-23;5111;6630;524810;433289;64.3;53.1
49;2021-07-24;3690;5004;528500;438293;64.8;53.7
49;2021-07-25;67;33;528567;438326;64.8;53.7
49;2021-07-26;4517;5903;533084;444229;65.3;54.4
49;2021-07-27;5753;5446;538837;449675;66.0;55.1
49;2021-07-28;6019;4362;544856;454037;66.8;55.6
49;2021-07-29;6702;4158;551558;458195;67.6;56.2
49;2021-07-30;6173;4792;557731;462987;68.4;56.7
49;2021-07-31;3959;3422;561690;466409;68.8;57.2
49;2021-08-01;21;22;561711;466431;68.8;57.2
49;2021-08-02;4271;4659;565982;471090;69.4;57.7
49;2021-08-03;5434;3804;571416;474894;70.0;58.2
49;2021-08-04;5276;3722;576692;478616;70.7;58.7
49;2021-08-05;5307;3289;581999;481905;71.3;59.1
49;2021-08-06;5718;4284;587717;486189;72.0;59.6
49;2021-08-07;3926;3044;591643;489233;72.5;60.0
49;2021-08-08;24;36;591667;489269;72.5;60.0
49;2021-08-09;3500;4682;595167;493951;72.9;60.5
49;2021-08-10;4251;3903;599418;497854;73.5;61.0
49;2021-08-11;4007;3654;603425;501508;74.0;61.5
49;2021-08-12;2665;3055;606090;504563;74.3;61.8
49;2021-08-13;3926;4270;610016;508833;74.8;62.4
49;2021-08-14;2279;3149;612295;511982;75.0;62.8
49;2021-08-15;31;26;612326;512008;75.1;62.8
49;2021-08-16;2831;5061;615157;517069;75.4;63.4
49;2021-08-17;3276;4911;618433;521980;75.8;64.0
49;2021-08-18;2977;4114;621410;526094;76.2;64.5
49;2021-08-19;1549;3663;622959;529757;76.4;64.9
49;2021-08-20;2733;5773;625692;535530;76.7;65.6
49;2021-08-21;1400;4151;627092;539681;76.9;66.1
49;2021-08-22;6;41;627098;539722;76.9;66.2
49;2021-08-23;2257;5627;629355;545349;77.1;66.8
49;2021-08-24;2747;5787;632102;551136;77.5;67.6
49;2021-08-25;2330;5431;634432;556567;77.8;68.2
49;2021-08-26;1717;4827;636149;561394;78.0;68.8
49;2021-08-27;2455;6813;638604;568207;78.3;69.6
49;2021-08-28;906;4302;639510;572509;78.4;70.2
49;2021-08-29;5;94;639515;572603;78.4;70.2
49;2021-08-30;1154;4255;640669;576858;78.5;70.7
49;2021-08-31;2249;5915;642918;582773;78.8;71.4
49;2021-09-01;1684;4297;644602;587070;79.0;72.0
49;2021-09-02;1064;2620;645666;589690;79.1;72.3
49;2021-09-03;1461;3952;647127;593642;79.3;72.8
49;2021-09-04;1211;3451;648338;597093;79.5;73.2
49;2021-09-05;5;5;648343;597098;79.5;73.2
49;2021-09-06;1098;2623;649441;599721;79.6;73.5
49;2021-09-07;1191;2539;650632;602260;79.7;73.8
49;2021-09-08;989;3069;651621;605329;79.9;74.2
49;2021-09-09;772;1608;652393;606937;80.0;74.4
49;2021-09-10;973;2840;653366;609777;80.1;74.7
49;2021-09-11;726;2524;654092;612301;80.2;75.0
49;2021-09-12;12;7;654104;612308;80.2;75.0
49;2021-09-13;746;2087;654850;614395;80.3;75.3
49;2021-09-14;644;1709;655494;616104;80.3;75.5
49;2021-09-15;622;2231;656116;618335;80.4;75.8
49;2021-09-16;526;1288;656642;619623;80.5;75.9
49;2021-09-17;932;2518;657574;622141;80.6;76.3
49;2021-09-18;542;2005;658116;624146;80.7;76.5
49;2021-09-19;2;8;658118;624154;80.7;76.5
49;2021-09-20;522;1246;658640;625400;80.7;76.7
49;2021-09-21;433;1598;659073;626998;80.8;76.8
49;2021-09-22;337;1996;659410;628994;80.8;77.1
49;2021-09-23;328;1169;659738;630163;80.9;77.2
49;2021-09-24;566;2242;660304;632405;80.9;77.5
49;2021-09-25;198;1014;660502;633419;81.0;77.6
49;2021-09-26;0;0;660502;633419;81.0;77.6
49;2021-09-27;383;1374;660885;634793;81.0;77.8
49;2021-09-28;413;1061;661298;635854;81.1;77.9
49;2021-09-29;378;1242;661676;637096;81.1;78.1
49;2021-09-30;319;708;661995;637804;81.1;78.2
49;2021-10-01;545;1505;662540;639309;81.2;78.4
49;2021-10-02;354;1134;662894;640443;81.2;78.5
49;2021-10-03;4;13;662898;640456;81.2;78.5
49;2021-10-04;314;759;663212;641215;81.3;78.6
49;2021-10-05;188;553;663400;641768;81.3;78.7
49;2021-10-06;405;751;663805;642519;81.4;78.8
49;2021-10-07;221;410;664026;642929;81.4;78.8
49;2021-10-08;563;1263;664589;644192;81.5;79.0
49;2021-10-09;262;649;664851;644841;81.5;79.0
49;2021-10-10;3;2;664854;644843;81.5;79.0
49;2021-10-11;308;711;665162;645554;81.5;79.1
49;2021-10-12;240;318;665402;645872;81.6;79.2
49;2021-10-13;316;525;665718;646397;81.6;79.2
49;2021-10-14;228;370;665946;646767;81.6;79.3
50;2020-12-27;0;0;0;0;0.0;0.0
50;2020-12-28;0;0;0;0;0.0;0.0
50;2020-12-29;1;0;1;0;0.0;0.0
50;2020-12-30;0;0;1;0;0.0;0.0
50;2020-12-31;0;0;1;0;0.0;0.0
50;2021-01-01;0;0;1;0;0.0;0.0
50;2021-01-02;0;0;1;0;0.0;0.0
50;2021-01-03;0;0;1;0;0.0;0.0
50;2021-01-04;1;0;2;0;0.0;0.0
50;2021-01-05;0;0;2;0;0.0;0.0
50;2021-01-06;126;0;128;0;0.0;0.0
50;2021-01-07;324;0;452;0;0.1;0.0
50;2021-01-08;436;2;888;2;0.2;0.0
50;2021-01-09;237;0;1125;2;0.2;0.0
50;2021-01-10;23;0;1148;2;0.2;0.0
50;2021-01-11;391;1;1539;3;0.3;0.0
50;2021-01-12;599;0;2138;3;0.4;0.0
50;2021-01-13;695;5;2833;8;0.6;0.0
50;2021-01-14;1051;11;3884;19;0.8;0.0
50;2021-01-15;710;4;4594;23;0.9;0.0
50;2021-01-16;215;3;4809;26;1.0;0.0
50;2021-01-17;1;0;4810;26;1.0;0.0
50;2021-01-18;620;2;5430;28;1.1;0.0
50;2021-01-19;902;8;6332;36;1.3;0.0
50;2021-01-20;964;1;7296;37;1.5;0.0
50;2021-01-21;917;4;8213;41;1.7;0.0
50;2021-01-22;716;4;8929;45;1.8;0.0
50;2021-01-23;668;4;9597;49;2.0;0.0
50;2021-01-24;882;3;10479;52;2.1;0.0
50;2021-01-25;2708;16;13187;68;2.7;0.0
50;2021-01-26;1336;16;14523;84;3.0;0.0
50;2021-01-27;769;56;15292;140;3.1;0.0
50;2021-01-28;716;170;16008;310;3.3;0.1
50;2021-01-29;581;307;16589;617;3.4;0.1
50;2021-01-30;382;164;16971;781;3.5;0.2
50;2021-01-31;0;0;16971;781;3.5;0.2
50;2021-02-01;451;224;17422;1005;3.6;0.2
50;2021-02-02;417;235;17839;1240;3.6;0.3
50;2021-02-03;391;375;18230;1615;3.7;0.3
50;2021-02-04;486;448;18716;2063;3.8;0.4
50;2021-02-05;426;448;19142;2511;3.9;0.5
50;2021-02-06;179;114;19321;2625;3.9;0.5
50;2021-02-07;0;0;19321;2625;3.9;0.5
50;2021-02-08;254;505;19575;3130;4.0;0.6
50;2021-02-09;246;640;19821;3770;4.0;0.8
50;2021-02-10;571;557;20392;4327;4.2;0.9
50;2021-02-11;436;915;20828;5242;4.2;1.1
50;2021-02-12;330;671;21158;5913;4.3;1.2
50;2021-02-13;307;487;21465;6400;4.4;1.3
50;2021-02-14;186;826;21651;7226;4.4;1.5
50;2021-02-15;664;2030;22315;9256;4.5;1.9
50;2021-02-16;747;1615;23062;10871;4.7;2.2
50;2021-02-17;632;823;23694;11694;4.8;2.4
50;2021-02-18;569;809;24263;12503;4.9;2.5
50;2021-02-19;631;519;24894;13022;5.1;2.7
50;2021-02-20;423;191;25317;13213;5.2;2.7
50;2021-02-21;85;29;25402;13242;5.2;2.7
50;2021-02-22;291;720;25693;13962;5.2;2.8
50;2021-02-23;503;565;26196;14527;5.3;3.0
50;2021-02-24;624;572;26820;15099;5.5;3.1
50;2021-02-25;780;594;27600;15693;5.6;3.2
50;2021-02-26;998;398;28598;16091;5.8;3.3
50;2021-02-27;887;115;29485;16206;6.0;3.3
50;2021-02-28;111;0;29596;16206;6.0;3.3
50;2021-03-01;488;557;30084;16763;6.1;3.4
50;2021-03-02;651;521;30735;17284;6.3;3.5
50;2021-03-03;798;457;31533;17741;6.4;3.6
50;2021-03-04;1247;340;32780;18081;6.7;3.7
50;2021-03-05;1553;354;34333;18435;7.0;3.8
50;2021-03-06;1321;161;35654;18596;7.3;3.8
50;2021-03-07;550;42;36204;18638;7.4;3.8
50;2021-03-08;1026;625;37230;19263;7.6;3.9
50;2021-03-09;1557;587;38787;19850;7.9;4.0
50;2021-03-10;1607;323;40394;20173;8.2;4.1
50;2021-03-11;2352;362;42746;20535;8.7;4.2
50;2021-03-12;2863;251;45609;20786;9.3;4.2
50;2021-03-13;1995;141;47604;20927;9.7;4.3
50;2021-03-14;280;43;47884;20970;9.8;4.3
50;2021-03-15;1378;301;49262;21271;10.0;4.3
50;2021-03-16;1341;285;50603;21556;10.3;4.4
50;2021-03-17;1296;416;51899;21972;10.6;4.5
50;2021-03-18;1162;435;53061;22407;10.8;4.6
50;2021-03-19;1733;595;54794;23002;11.2;4.7
50;2021-03-20;1688;234;56482;23236;11.5;4.7
50;2021-03-21;794;12;57276;23248;11.7;4.7
50;2021-03-22;1508;343;58784;23591;12.0;4.8
50;2021-03-23;2078;403;60862;23994;12.4;4.9
50;2021-03-24;2281;558;63143;24552;12.9;5.0
50;2021-03-25;2813;476;65956;25028;13.4;5.1
50;2021-03-26;3204;480;69160;25508;14.1;5.2
50;2021-03-27;1825;380;70985;25888;14.5;5.3
50;2021-03-28;403;20;71388;25908;14.5;5.3
50;2021-03-29;2139;723;73527;26631;15.0;5.4
50;2021-03-30;2283;648;75810;27279;15.5;5.6
50;2021-03-31;2479;576;78289;27855;16.0;5.7
50;2021-04-01;3104;876;81393;28731;16.6;5.9
50;2021-04-02;2960;935;84353;29666;17.2;6.0
50;2021-04-03;1245;686;85598;30352;17.4;6.2
50;2021-04-04;320;135;85918;30487;17.5;6.2
50;2021-04-05;400;28;86318;30515;17.6;6.2
50;2021-04-06;2127;1226;88445;31741;18.0;6.5
50;2021-04-07;2558;1185;91003;32926;18.5;6.7
50;2021-04-08;3597;1215;94600;34141;19.3;7.0
50;2021-04-09;3936;1304;98536;35445;20.1;7.2
50;2021-04-10;2534;878;101070;36323;20.6;7.4
50;2021-04-11;411;146;101481;36469;20.7;7.4
50;2021-04-12;2438;1381;103919;37850;21.2;7.7
50;2021-04-13;2679;1523;106598;39373;21.7;8.0
50;2021-04-14;2608;1360;109206;40733;22.3;8.3
50;2021-04-15;3161;1120;112367;41853;22.9;8.5
50;2021-04-16;3363;1105;115730;42958;23.6;8.8
50;2021-04-17;2397;1188;118127;44146;24.1;9.0
50;2021-04-18;425;667;118552;44813;24.2;9.1
50;2021-04-19;1996;1473;120548;46286;24.6;9.4
50;2021-04-20;2273;1594;122821;47880;25.0;9.8
50;2021-04-21;2548;1764;125369;49644;25.6;10.1
50;2021-04-22;3078;1829;128447;51473;26.2;10.5
50;2021-04-23;2757;1924;131204;53397;26.7;10.9
50;2021-04-24;1900;1439;133104;54836;27.1;11.2
50;2021-04-25;470;273;133574;55109;27.2;11.2
50;2021-04-26;2119;1891;135693;57000;27.7;11.6
50;2021-04-27;2412;2005;138105;59005;28.1;12.0
50;2021-04-28;2708;1977;140813;60982;28.7;12.4
50;2021-04-29;3285;2053;144098;63035;29.4;12.8
50;2021-04-30;2999;1937;147097;64972;30.0;13.2
50;2021-05-01;1015;597;148112;65569;30.2;13.4
50;2021-05-02;522;448;148634;66017;30.3;13.5
50;2021-05-03;1771;1806;150405;67823;30.7;13.8
50;2021-05-04;1771;2332;152176;70155;31.0;14.3
50;2021-05-05;1659;2955;153835;73110;31.4;14.9
50;2021-05-06;2530;2590;156365;75700;31.9;15.4
50;2021-05-07;2150;2861;158515;78561;32.3;16.0
50;2021-05-08;1170;796;159685;79357;32.5;16.2
50;2021-05-09;624;362;160309;79719;32.7;16.2
50;2021-05-10;1705;2604;162014;82323;33.0;16.8
50;2021-05-11;2542;2848;164556;85171;33.5;17.4
50;2021-05-12;3179;2440;167735;87611;34.2;17.9
50;2021-05-13;3382;612;171117;88223;34.9;18.0
50;2021-05-14;3568;2279;174685;90502;35.6;18.4
50;2021-05-15;4001;1875;178686;92377;36.4;18.8
50;2021-05-16;947;267;179633;92644;36.6;18.9
50;2021-05-17;2140;1879;181773;94523;37.0;19.3
50;2021-05-18;2523;1619;184296;96142;37.6;19.6
50;2021-05-19;2503;1447;186799;97589;38.1;19.9
50;2021-05-20;3261;1623;190060;99212;38.7;20.2
50;2021-05-21;3156;1912;193216;101124;39.4;20.6
50;2021-05-22;2651;1328;195867;102452;39.9;20.9
50;2021-05-23;604;284;196471;102736;40.0;20.9
50;2021-05-24;1527;489;197998;103225;40.4;21.0
50;2021-05-25;2448;1671;200446;104896;40.9;21.4
50;2021-05-26;3002;1461;203448;106357;41.5;21.7
50;2021-05-27;3036;1972;206484;108329;42.1;22.1
50;2021-05-28;2941;2126;209425;110455;42.7;22.5
50;2021-05-29;2761;1404;212186;111859;43.2;22.8
50;2021-05-30;812;327;212998;112186;43.4;22.9
50;2021-05-31;2651;1817;215649;114003;43.9;23.2
50;2021-06-01;3333;2069;218982;116072;44.6;23.7
50;2021-06-02;3259;1785;222241;117857;45.3;24.0
50;2021-06-03;3914;2060;226155;119917;46.1;24.4
50;2021-06-04;3822;2886;229977;122803;46.9;25.0
50;2021-06-05;2958;1847;232935;124650;47.5;25.4
50;2021-06-06;813;442;233748;125092;47.6;25.5
50;2021-06-07;3512;2082;237260;127174;48.4;25.9
50;2021-06-08;4073;2228;241333;129402;49.2;26.4
50;2021-06-09;4253;1998;245586;131400;50.1;26.8
50;2021-06-10;4193;2118;249779;133518;50.9;27.2
50;2021-06-11;4223;2712;254002;136230;51.8;27.8
50;2021-06-12;3738;1613;257740;137843;52.5;28.1
50;2021-06-13;1143;451;258883;138294;52.8;28.2
50;2021-06-14;2693;2967;261576;141261;53.3;28.8
50;2021-06-15;3016;2602;264592;143863;53.9;29.3
50;2021-06-16;3097;1976;267689;145839;54.6;29.7
50;2021-06-17;2798;2486;270487;148325;55.1;30.2
50;2021-06-18;3239;3055;273726;151380;55.8;30.9
50;2021-06-19;3176;1927;276902;153307;56.4;31.2
50;2021-06-20;731;710;277633;154017;56.6;31.4
50;2021-06-21;1819;3133;279452;157150;57.0;32.0
50;2021-06-22;2064;3393;281516;160543;57.4;32.7
50;2021-06-23;1871;3875;283387;164418;57.8;33.5
50;2021-06-24;1711;4008;285098;168426;58.1;34.3
50;2021-06-25;2134;4009;287232;172435;58.5;35.1
50;2021-06-26;2147;3695;289379;176130;59.0;35.9
50;2021-06-27;615;895;289994;177025;59.1;36.1
50;2021-06-28;1927;3349;291921;180374;59.5;36.8
50;2021-06-29;1881;3409;293802;183783;59.9;37.5
50;2021-06-30;2179;3411;295981;187194;60.3;38.2
50;2021-07-01;1945;3288;297926;190482;60.7;38.8
50;2021-07-02;1898;3935;299824;194417;61.1;39.6
50;2021-07-03;1448;3447;301272;197864;61.4;40.3
50;2021-07-04;445;1066;301717;198930;61.5;40.5
50;2021-07-05;1262;3412;302979;202342;61.7;41.2
50;2021-07-06;1573;3896;304552;206238;62.1;42.0
50;2021-07-07;1804;3617;306356;209855;62.4;42.8
50;2021-07-08;1374;4101;307730;213956;62.7;43.6
50;2021-07-09;1394;4572;309124;218528;63.0;44.5
50;2021-07-10;1023;3599;310147;222127;63.2;45.3
50;2021-07-11;373;1018;310520;223145;63.3;45.5
50;2021-07-12;1317;4625;311837;227770;63.6;46.4
50;2021-07-13;1624;4857;313461;232627;63.9;47.4
50;2021-07-14;1476;2359;314937;234986;64.2;47.9
50;2021-07-15;1688;5056;316625;240042;64.5;48.9
50;2021-07-16;2992;5244;319617;245286;65.1;50.0
50;2021-07-17;2149;3733;321766;249019;65.6;50.8
50;2021-07-18;402;1092;322168;250111;65.7;51.0
50;2021-07-19;1571;5186;323739;255297;66.0;52.0
50;2021-07-20;1924;5407;325663;260704;66.4;53.1
50;2021-07-21;1802;5259;327465;265963;66.7;54.2
50;2021-07-22;1947;5004;329412;270967;67.1;55.2
50;2021-07-23;2072;5385;331484;276352;67.6;56.3
50;2021-07-24;1311;3836;332795;280188;67.8;57.1
50;2021-07-25;274;1037;333069;281225;67.9;57.3
50;2021-07-26;2290;3487;335359;284712;68.3;58.0
50;2021-07-27;2899;3347;338258;288059;68.9;58.7
50;2021-07-28;2998;3689;341256;291748;69.5;59.5
50;2021-07-29;3581;3233;344837;294981;70.3;60.1
50;2021-07-30;3075;3009;347912;297990;70.9;60.7
50;2021-07-31;2406;2672;350318;300662;71.4;61.3
50;2021-08-01;484;686;350802;301348;71.5;61.4
50;2021-08-02;2474;2741;353276;304089;72.0;62.0
50;2021-08-03;3404;2470;356680;306559;72.7;62.5
50;2021-08-04;3602;2323;360282;308882;73.4;63.0
50;2021-08-05;3189;2159;363471;311041;74.1;63.4
50;2021-08-06;3659;2801;367130;313842;74.8;64.0
50;2021-08-07;2462;2156;369592;315998;75.3;64.4
50;2021-08-08;511;712;370103;316710;75.4;64.5
50;2021-08-09;2493;2135;372596;318845;75.9;65.0
50;2021-08-10;2987;1989;375583;320834;76.5;65.4
50;2021-08-11;2852;2018;378435;322852;77.1;65.8
50;2021-08-12;2596;2440;381031;325292;77.7;66.3
50;2021-08-13;2506;1980;383537;327272;78.2;66.7
50;2021-08-14;1811;1748;385348;329020;78.5;67.1
50;2021-08-15;399;334;385747;329354;78.6;67.1
50;2021-08-16;1721;2228;387468;331582;79.0;67.6
50;2021-08-17;1973;2704;389441;334286;79.4;68.1
50;2021-08-18;1846;2389;391287;336675;79.7;68.6
50;2021-08-19;1710;2579;392997;339254;80.1;69.1
50;2021-08-20;1621;2739;394618;341993;80.4;69.7
50;2021-08-21;1017;2727;395635;344720;80.6;70.3
50;2021-08-22;384;519;396019;345239;80.7;70.4
50;2021-08-23;1138;2906;397157;348145;80.9;71.0
50;2021-08-24;1246;3222;398403;351367;81.2;71.6
50;2021-08-25;1107;2649;399510;354016;81.4;72.1
50;2021-08-26;866;3156;400376;357172;81.6;72.8
50;2021-08-27;940;3181;401316;360353;81.8;73.4
50;2021-08-28;795;2887;402111;363240;82.0;74.0
50;2021-08-29;283;575;402394;363815;82.0;74.1
50;2021-08-30;774;2875;403168;366690;82.2;74.7
50;2021-08-31;824;2928;403992;369618;82.3;75.3
50;2021-09-01;710;2659;404702;372277;82.5;75.9
50;2021-09-02;536;2221;405238;374498;82.6;76.3
50;2021-09-03;705;2543;405943;377041;82.7;76.8
50;2021-09-04;620;2852;406563;379893;82.9;77.4
50;2021-09-05;194;669;406757;380562;82.9;77.6
50;2021-09-06;435;1898;407192;382460;83.0;77.9
50;2021-09-07;330;1473;407522;383933;83.1;78.2
50;2021-09-08;502;1934;408024;385867;83.2;78.6
50;2021-09-09;420;1274;408444;387141;83.2;78.9
50;2021-09-10;530;1689;408974;388830;83.4;79.2
50;2021-09-11;365;2179;409339;391009;83.4;79.7
50;2021-09-12;71;369;409410;391378;83.4;79.8
50;2021-09-13;414;1022;409824;392400;83.5;80.0
50;2021-09-14;418;939;410242;393339;83.6;80.2
50;2021-09-15;419;1087;410661;394426;83.7;80.4
50;2021-09-16;464;749;411125;395175;83.8;80.5
50;2021-09-17;462;1032;411587;396207;83.9;80.7
50;2021-09-18;314;1467;411901;397674;83.9;81.0
50;2021-09-19;46;276;411947;397950;84.0;81.1
50;2021-09-20;384;589;412331;398539;84.0;81.2
50;2021-09-21;432;625;412763;399164;84.1;81.4
50;2021-09-22;218;867;412981;400031;84.2;81.5
50;2021-09-23;272;452;413253;400483;84.2;81.6
50;2021-09-24;253;819;413506;401302;84.3;81.8
50;2021-09-25;213;934;413719;402236;84.3;82.0
50;2021-09-26;20;181;413739;402417;84.3;82.0
50;2021-09-27;110;392;413849;402809;84.3;82.1
50;2021-09-28;160;385;414009;403194;84.4;82.2
50;2021-09-29;156;526;414165;403720;84.4;82.3
50;2021-09-30;165;424;414330;404144;84.4;82.4
50;2021-10-01;208;594;414538;404738;84.5;82.5
50;2021-10-02;224;540;414762;405278;84.5;82.6
50;2021-10-03;2;5;414764;405283;84.5;82.6
50;2021-10-04;180;484;414944;405767;84.6;82.7
50;2021-10-05;135;399;415079;406166;84.6;82.8
50;2021-10-06;191;490;415270;406656;84.6;82.9
50;2021-10-07;112;361;415382;407017;84.7;83.0
50;2021-10-08;212;499;415594;407516;84.7;83.1
50;2021-10-09;218;515;415812;408031;84.7;83.2
50;2021-10-10;0;0;415812;408031;84.7;83.2
50;2021-10-11;99;233;415911;408264;84.8;83.2
50;2021-10-12;136;346;416047;408610;84.8;83.3
50;2021-10-13;148;298;416195;408908;84.8;83.3
50;2021-10-14;100;296;416295;409204;84.8;83.4
51;2020-12-27;0;0;0;0;0.0;0.0
51;2020-12-28;0;0;0;0;0.0;0.0
51;2020-12-29;0;0;0;0;0.0;0.0
51;2020-12-30;0;0;0;0;0.0;0.0
51;2020-12-31;1;0;1;0;0.0;0.0
51;2021-01-01;0;0;1;0;0.0;0.0
51;2021-01-02;0;0;1;0;0.0;0.0
51;2021-01-03;0;0;1;0;0.0;0.0
51;2021-01-04;1;0;2;0;0.0;0.0
51;2021-01-05;1;0;3;0;0.0;0.0
51;2021-01-06;6;0;9;0;0.0;0.0
51;2021-01-07;262;1;271;1;0.0;0.0
51;2021-01-08;508;1;779;2;0.1;0.0
51;2021-01-09;91;1;870;3;0.2;0.0
51;2021-01-10;0;0;870;3;0.2;0.0
51;2021-01-11;546;2;1416;5;0.3;0.0
51;2021-01-12;1542;5;2958;10;0.5;0.0
51;2021-01-13;1289;7;4247;17;0.8;0.0
51;2021-01-14;1475;8;5722;25;1.0;0.0
51;2021-01-15;607;4;6329;29;1.1;0.0
51;2021-01-16;177;1;6506;30;1.2;0.0
51;2021-01-17;102;0;6608;30;1.2;0.0
51;2021-01-18;845;4;7453;34;1.3;0.0
51;2021-01-19;997;5;8450;39;1.5;0.0
51;2021-01-20;955;11;9405;50;1.7;0.0
51;2021-01-21;790;3;10195;53;1.8;0.0
51;2021-01-22;394;2;10589;55;1.9;0.0
51;2021-01-23;294;0;10883;55;1.9;0.0
51;2021-01-24;130;1;11013;56;2.0;0.0
51;2021-01-25;712;3;11725;59;2.1;0.0
51;2021-01-26;779;5;12504;64;2.2;0.0
51;2021-01-27;656;4;13160;68;2.3;0.0
51;2021-01-28;646;68;13806;136;2.4;0.0
51;2021-01-29;474;142;14280;278;2.5;0.0
51;2021-01-30;126;5;14406;283;2.6;0.1
51;2021-01-31;83;0;14489;283;2.6;0.1
51;2021-02-01;275;58;14764;341;2.6;0.1
51;2021-02-02;738;723;15502;1064;2.7;0.2
51;2021-02-03;642;472;16144;1536;2.9;0.3
51;2021-02-04;968;816;17112;2352;3.0;0.4
51;2021-02-05;972;513;18084;2865;3.2;0.5
51;2021-02-06;30;147;18114;3012;3.2;0.5
51;2021-02-07;0;18;18114;3030;3.2;0.5
51;2021-02-08;115;412;18229;3442;3.2;0.6
51;2021-02-09;221;470;18450;3912;3.3;0.7
51;2021-02-10;220;637;18670;4549;3.3;0.8
51;2021-02-11;302;530;18972;5079;3.4;0.9
51;2021-02-12;341;564;19313;5643;3.4;1.0
51;2021-02-13;8;115;19321;5758;3.4;1.0
51;2021-02-14;8;171;19329;5929;3.4;1.1
51;2021-02-15;266;848;19595;6777;3.5;1.2
51;2021-02-16;402;969;19997;7746;3.5;1.4
51;2021-02-17;367;877;20364;8623;3.6;1.5
51;2021-02-18;437;593;20801;9216;3.7;1.6
51;2021-02-19;528;424;21329;9640;3.8;1.7
51;2021-02-20;205;293;21534;9933;3.8;1.8
51;2021-02-21;10;101;21544;10034;3.8;1.8
51;2021-02-22;195;689;21739;10723;3.9;1.9
51;2021-02-23;262;1099;22001;11822;3.9;2.1
51;2021-02-24;414;689;22415;12511;4.0;2.2
51;2021-02-25;1049;887;23464;13398;4.2;2.4
51;2021-02-26;1228;668;24692;14066;4.4;2.5
51;2021-02-27;590;124;25282;14190;4.5;2.5
51;2021-02-28;7;71;25289;14261;4.5;2.5
51;2021-03-01;768;314;26057;14575;4.6;2.6
51;2021-03-02;1128;467;27185;15042;4.8;2.7
51;2021-03-03;1195;467;28380;15509;5.0;2.8
51;2021-03-04;1061;701;29441;16210;5.2;2.9
51;2021-03-05;1562;674;31003;16884;5.5;3.0
51;2021-03-06;1434;60;32437;16944;5.8;3.0
51;2021-03-07;251;6;32688;16950;5.8;3.0
51;2021-03-08;992;101;33680;17051;6.0;3.0
51;2021-03-09;1666;195;35346;17246;6.3;3.1
51;2021-03-10;1999;114;37345;17360;6.6;3.1
51;2021-03-11;2371;175;39716;17535;7.0;3.1
51;2021-03-12;3255;167;42971;17702;7.6;3.1
51;2021-03-13;2549;54;45520;17756;8.1;3.1
51;2021-03-14;190;5;45710;17761;8.1;3.2
51;2021-03-15;1580;151;47290;17912;8.4;3.2
51;2021-03-16;1478;186;48768;18098;8.6;3.2
51;2021-03-17;1497;211;50265;18309;8.9;3.2
51;2021-03-18;1615;288;51880;18597;9.2;3.3
51;2021-03-19;2311;303;54191;18900;9.6;3.4
51;2021-03-20;1661;220;55852;19120;9.9;3.4
51;2021-03-21;133;5;55985;19125;9.9;3.4
51;2021-03-22;1416;126;57401;19251;10.2;3.4
51;2021-03-23;2469;169;59870;19420;10.6;3.4
51;2021-03-24;2846;138;62716;19558;11.1;3.5
51;2021-03-25;3254;339;65970;19897;11.7;3.5
51;2021-03-26;3411;511;69381;20408;12.3;3.6
51;2021-03-27;1842;253;71223;20661;12.6;3.7
51;2021-03-28;213;3;71436;20664;12.7;3.7
51;2021-03-29;991;641;72427;21305;12.8;3.8
51;2021-03-30;1747;862;74174;22167;13.2;3.9
51;2021-03-31;1739;761;75913;22928;13.5;4.1
51;2021-04-01;2280;464;78193;23392;13.9;4.1
51;2021-04-02;2425;645;80618;24037;14.3;4.3
51;2021-04-03;1301;414;81919;24451;14.5;4.3
51;2021-04-04;106;2;82025;24453;14.5;4.3
51;2021-04-05;72;141;82097;24594;14.6;4.4
51;2021-04-06;763;1233;82860;25827;14.7;4.6
51;2021-04-07;1312;1412;84172;27239;14.9;4.8
51;2021-04-08;2208;1783;86380;29022;15.3;5.1
51;2021-04-09;2863;1737;89243;30759;15.8;5.5
51;2021-04-10;2219;503;91462;31262;16.2;5.5
51;2021-04-11;105;85;91567;31347;16.2;5.6
51;2021-04-12;1450;1343;93017;32690;16.5;5.8
51;2021-04-13;1936;1682;94953;34372;16.8;6.1
51;2021-04-14;2460;1560;97413;35932;17.3;6.4
51;2021-04-15;2855;1675;100268;37607;17.8;6.7
51;2021-04-16;3214;1609;103482;39216;18.4;7.0
51;2021-04-17;1966;776;105448;39992;18.7;7.1
51;2021-04-18;296;114;105744;40106;18.8;7.1
51;2021-04-19;1561;1162;107305;41268;19.0;7.3
51;2021-04-20;1791;1665;109096;42933;19.3;7.6
51;2021-04-21;2002;1745;111098;44678;19.7;7.9
51;2021-04-22;2406;1666;113504;46344;20.1;8.2
51;2021-04-23;2982;1831;116486;48175;20.7;8.5
51;2021-04-24;1749;955;118235;49130;21.0;8.7
51;2021-04-25;123;161;118358;49291;21.0;8.7
51;2021-04-26;1851;760;120209;50051;21.3;8.9
51;2021-04-27;2442;1237;122651;51288;21.8;9.1
51;2021-04-28;2552;1315;125203;52603;22.2;9.3
51;2021-04-29;2676;1464;127879;54067;22.7;9.6
51;2021-04-30;2975;1679;130854;55746;23.2;9.9
51;2021-05-01;1453;411;132307;56157;23.5;10.0
51;2021-05-02;107;99;132414;56256;23.5;10.0
51;2021-05-03;2484;766;134898;57022;23.9;10.1
51;2021-05-04;2788;1358;137686;58380;24.4;10.4
51;2021-05-05;2861;1643;140547;60023;24.9;10.6
51;2021-05-06;5344;1956;145891;61979;25.9;11.0
51;2021-05-07;3705;1940;149596;63919;26.5;11.3
51;2021-05-08;2862;820;152458;64739;27.0;11.5
51;2021-05-09;212;92;152670;64831;27.1;11.5
51;2021-05-10;3214;1869;155884;66700;27.6;11.8
51;2021-05-11;3643;2042;159527;68742;28.3;12.2
51;2021-05-12;4182;2237;163709;70979;29.0;12.6
51;2021-05-13;1777;505;165486;71484;29.4;12.7
51;2021-05-14;5401;1744;170887;73228;30.3;13.0
51;2021-05-15;4227;1355;175114;74583;31.1;13.2
51;2021-05-16;284;47;175398;74630;31.1;13.2
51;2021-05-17;3131;1524;178529;76154;31.7;13.5
51;2021-05-18;3918;1767;182447;77921;32.4;13.8
51;2021-05-19;4031;1724;186478;79645;33.1;14.1
51;2021-05-20;4649;1969;191127;81614;33.9;14.5
51;2021-05-21;3597;2473;194724;84087;34.5;14.9
51;2021-05-22;2075;1549;196799;85636;34.9;15.2
51;2021-05-23;308;210;197107;85846;35.0;15.2
51;2021-05-24;2018;720;199125;86566;35.3;15.4
51;2021-05-25;3130;1829;202255;88395;35.9;15.7
51;2021-05-26;3297;1711;205552;90106;36.5;16.0
51;2021-05-27;3267;2062;208819;92168;37.0;16.3
51;2021-05-28;3605;2823;212424;94991;37.7;16.8
51;2021-05-29;2401;1995;214825;96986;38.1;17.2
51;2021-05-30;401;133;215226;97119;38.2;17.2
51;2021-05-31;3348;1784;218574;98903;38.8;17.5
51;2021-06-01;3854;2334;222428;101237;39.4;18.0
51;2021-06-02;6095;2332;228523;103569;40.5;18.4
51;2021-06-03;3580;2427;232103;105996;41.2;18.8
51;2021-06-04;6346;2943;238449;108939;42.3;19.3
51;2021-06-05;2597;1822;241046;110761;42.8;19.6
51;2021-06-06;172;157;241218;110918;42.8;19.7
51;2021-06-07;4302;2166;245520;113084;43.5;20.1
51;2021-06-08;3925;2533;249445;115617;44.2;20.5
51;2021-06-09;4016;2750;253461;118367;45.0;21.0
51;2021-06-10;3208;2491;256669;120858;45.5;21.4
51;2021-06-11;3358;3429;260027;124287;46.1;22.0
51;2021-06-12;2165;2170;262192;126457;46.5;22.4
51;2021-06-13;191;149;262383;126606;46.5;22.5
51;2021-06-14;1627;3331;264010;129937;46.8;23.0
51;2021-06-15;3189;3577;267199;133514;47.4;23.7
51;2021-06-16;2208;3685;269407;137199;47.8;24.3
51;2021-06-17;2609;5402;272016;142601;48.2;25.3
51;2021-06-18;2355;5212;274371;147813;48.7;26.2
51;2021-06-19;1683;4425;276054;152238;49.0;27.0
51;2021-06-20;184;228;276238;152466;49.0;27.0
51;2021-06-21;1230;4440;277468;156906;49.2;27.8
51;2021-06-22;1558;4044;279026;160950;49.5;28.5
51;2021-06-23;3670;4239;282696;165189;50.1;29.3
51;2021-06-24;2246;3226;284942;168415;50.5;29.9
51;2021-06-25;1905;6526;286847;174941;50.9;31.0
51;2021-06-26;1203;5065;288050;180006;51.1;31.9
51;2021-06-27;103;336;288153;180342;51.1;32.0
51;2021-06-28;1401;4413;289554;184755;51.4;32.8
51;2021-06-29;1174;4463;290728;189218;51.6;33.6
51;2021-06-30;1685;6044;292413;195262;51.9;34.6
51;2021-07-01;1978;3765;294391;199027;52.2;35.3
51;2021-07-02;1838;6887;296229;205914;52.5;36.5
51;2021-07-03;1003;3198;297232;209112;52.7;37.1
51;2021-07-04;171;254;297403;209366;52.7;37.1
51;2021-07-05;771;5530;298174;214896;52.9;38.1
51;2021-07-06;1246;4781;299420;219677;53.1;39.0
51;2021-07-07;1617;4935;301037;224612;53.4;39.8
51;2021-07-08;2067;3431;303104;228043;53.8;40.4
51;2021-07-09;1854;5056;304958;233099;54.1;41.3
51;2021-07-10;1238;3204;306196;236303;54.3;41.9
51;2021-07-11;190;281;306386;236584;54.3;42.0
51;2021-07-12;996;4379;307382;240963;54.5;42.7
51;2021-07-13;1480;4775;308862;245738;54.8;43.6
51;2021-07-14;1071;1691;309933;247429;55.0;43.9
51;2021-07-15;2938;4915;312871;252344;55.5;44.8
51;2021-07-16;2367;5275;315238;257619;55.9;45.7
51;2021-07-17;1821;3481;317059;261100;56.2;46.3
51;2021-07-18;163;331;317222;261431;56.3;46.4
51;2021-07-19;1892;3978;319114;265409;56.6;47.1
51;2021-07-20;2585;5143;321699;270552;57.1;48.0
51;2021-07-21;3611;4069;325310;274621;57.7;48.7
51;2021-07-22;4412;3758;329722;278379;58.5;49.4
51;2021-07-23;3641;4381;333363;282760;59.1;50.2
51;2021-07-24;2086;2726;335449;285486;59.5;50.6
51;2021-07-25;356;258;335805;285744;59.6;50.7
51;2021-07-26;3113;2808;338918;288552;60.1;51.2
51;2021-07-27;5864;3277;344782;291829;61.2;51.8
51;2021-07-28;4139;4321;348921;296150;61.9;52.5
51;2021-07-29;4701;2722;353622;298872;62.7;53.0
51;2021-07-30;3628;3163;357250;302035;63.4;53.6
51;2021-07-31;2526;2132;359776;304167;63.8;53.9
51;2021-08-01;375;236;360151;304403;63.9;54.0
51;2021-08-02;3287;2310;363438;306713;64.5;54.4
51;2021-08-03;3776;1913;367214;308626;65.1;54.7
51;2021-08-04;4450;2126;371664;310752;65.9;55.1
51;2021-08-05;2655;1536;374319;312288;66.4;55.4
51;2021-08-06;3044;2552;377363;314840;66.9;55.8
51;2021-08-07;2161;1700;379524;316540;67.3;56.1
51;2021-08-08;368;208;379892;316748;67.4;56.2
51;2021-08-09;2604;1852;382496;318600;67.8;56.5
51;2021-08-10;2372;1984;384868;320584;68.3;56.9
51;2021-08-11;2917;2341;387785;322925;68.8;57.3
51;2021-08-12;1754;1958;389539;324883;69.1;57.6
51;2021-08-13;2066;2670;391605;327553;69.5;58.1
51;2021-08-14;1583;2027;393188;329580;69.7;58.5
51;2021-08-15;149;150;393337;329730;69.8;58.5
51;2021-08-16;1356;3016;394693;332746;70.0;59.0
51;2021-08-17;1560;3283;396253;336029;70.3;59.6
51;2021-08-18;1899;3693;398152;339722;70.6;60.3
51;2021-08-19;1409;2549;399561;342271;70.9;60.7
51;2021-08-20;1708;3974;401269;346245;71.2;61.4
51;2021-08-21;988;2497;402257;348742;71.3;61.9
51;2021-08-22;101;343;402358;349085;71.4;61.9
51;2021-08-23;1112;3607;403470;352692;71.6;62.6
51;2021-08-24;1175;3644;404645;356336;71.8;63.2
51;2021-08-25;1321;4488;405966;360824;72.0;64.0
51;2021-08-26;1058;2548;407024;363372;72.2;64.4
51;2021-08-27;1214;4178;408238;367550;72.4;65.2
51;2021-08-28;655;2632;408893;370182;72.5;65.7
51;2021-08-29;84;360;408977;370542;72.5;65.7
51;2021-08-30;1332;4788;410309;375330;72.8;66.6
51;2021-08-31;778;2916;411087;378246;72.9;67.1
51;2021-09-01;738;3217;411825;381463;73.0;67.7
51;2021-09-02;800;2048;412625;383511;73.2;68.0
51;2021-09-03;905;2628;413530;386139;73.3;68.5
51;2021-09-04;622;2706;414152;388845;73.5;69.0
51;2021-09-05;122;194;414274;389039;73.5;69.0
51;2021-09-06;436;1509;414710;390548;73.6;69.3
51;2021-09-07;519;1256;415229;391804;73.6;69.5
51;2021-09-08;627;1925;415856;393729;73.8;69.8
51;2021-09-09;470;1190;416326;394919;73.8;70.0
51;2021-09-10;672;1787;416998;396706;74.0;70.4
51;2021-09-11;562;1828;417560;398534;74.1;70.7
51;2021-09-12;19;79;417579;398613;74.1;70.7
51;2021-09-13;427;851;418006;399464;74.1;70.8
51;2021-09-14;595;873;418601;400337;74.2;71.0
51;2021-09-15;494;1425;419095;401762;74.3;71.3
51;2021-09-16;307;657;419402;402419;74.4;71.4
51;2021-09-17;552;1129;419954;403548;74.5;71.6
51;2021-09-18;470;1421;420424;404969;74.6;71.8
51;2021-09-19;14;64;420438;405033;74.6;71.8
51;2021-09-20;282;539;420720;405572;74.6;71.9
51;2021-09-21;257;490;420977;406062;74.7;72.0
51;2021-09-22;318;1353;421295;407415;74.7;72.3
51;2021-09-23;196;602;421491;408017;74.8;72.4
51;2021-09-24;366;978;421857;408995;74.8;72.5
51;2021-09-25;283;984;422140;409979;74.9;72.7
51;2021-09-26;7;129;422147;410108;74.9;72.7
51;2021-09-27;259;446;422406;410554;74.9;72.8
51;2021-09-28;298;363;422704;410917;75.0;72.9
51;2021-09-29;348;775;423052;411692;75.0;73.0
51;2021-09-30;264;416;423316;412108;75.1;73.1
51;2021-10-01;355;717;423671;412825;75.1;73.2
51;2021-10-02;371;761;424042;413586;75.2;73.4
51;2021-10-03;0;1;424042;413587;75.2;73.4
51;2021-10-04;180;445;424222;414032;75.2;73.4
51;2021-10-05;205;433;424427;414465;75.3;73.5
51;2021-10-06;314;553;424741;415018;75.3;73.6
51;2021-10-07;163;368;424904;415386;75.4;73.7
51;2021-10-08;313;590;425217;415976;75.4;73.8
51;2021-10-09;322;604;425539;416580;75.5;73.9
51;2021-10-10;2;2;425541;416582;75.5;73.9
51;2021-10-11;168;299;425709;416881;75.5;73.9
51;2021-10-12;156;372;425865;417253;75.5;74.0
51;2021-10-13;291;433;426156;417686;75.6;74.1
51;2021-10-14;153;200;426309;417886;75.6;74.1
52;2020-12-27;0;0;0;0;0.0;0.0
52;2020-12-28;1;0;1;0;0.0;0.0
52;2020-12-29;0;0;1;0;0.0;0.0
52;2020-12-30;0;0;1;0;0.0;0.0
52;2020-12-31;0;0;1;0;0.0;0.0
52;2021-01-01;0;0;1;0;0.0;0.0
52;2021-01-02;1;0;2;0;0.0;0.0
52;2021-01-03;0;0;2;0;0.0;0.0
52;2021-01-04;0;0;2;0;0.0;0.0
52;2021-01-05;0;0;2;0;0.0;0.0
52;2021-01-06;2;0;4;0;0.0;0.0
52;2021-01-07;0;0;4;0;0.0;0.0
52;2021-01-08;200;1;204;1;0.1;0.0
52;2021-01-09;93;0;297;1;0.2;0.0
52;2021-01-10;0;0;297;1;0.2;0.0
52;2021-01-11;207;0;504;1;0.3;0.0
52;2021-01-12;171;0;675;1;0.4;0.0
52;2021-01-13;563;3;1238;4;0.7;0.0
52;2021-01-14;677;10;1915;14;1.1;0.0
52;2021-01-15;411;1;2326;15;1.4;0.0
52;2021-01-16;16;1;2342;16;1.4;0.0
52;2021-01-17;0;0;2342;16;1.4;0.0
52;2021-01-18;427;0;2769;16;1.6;0.0
52;2021-01-19;440;1;3209;17;1.9;0.0
52;2021-01-20;422;0;3631;17;2.1;0.0
52;2021-01-21;423;2;4054;19;2.4;0.0
52;2021-01-22;320;2;4374;21;2.6;0.0
52;2021-01-23;73;2;4447;23;2.6;0.0
52;2021-01-24;0;0;4447;23;2.6;0.0
52;2021-01-25;236;0;4683;23;2.8;0.0
52;2021-01-26;308;0;4991;23;2.9;0.0
52;2021-01-27;238;1;5229;24;3.1;0.0
52;2021-01-28;174;4;5403;28;3.2;0.0
52;2021-01-29;74;122;5477;150;3.2;0.1
52;2021-01-30;91;95;5568;245;3.3;0.1
52;2021-01-31;0;0;5568;245;3.3;0.1
52;2021-02-01;117;189;5685;434;3.4;0.3
52;2021-02-02;61;176;5746;610;3.4;0.4
52;2021-02-03;89;410;5835;1020;3.4;0.6
52;2021-02-04;231;592;6066;1612;3.6;1.0
52;2021-02-05;113;505;6179;2117;3.7;1.3
52;2021-02-06;22;0;6201;2117;3.7;1.3
52;2021-02-07;0;1;6201;2118;3.7;1.3
52;2021-02-08;34;208;6235;2326;3.7;1.4
52;2021-02-09;47;216;6282;2542;3.7;1.5
52;2021-02-10;88;189;6370;2731;3.8;1.6
52;2021-02-11;129;148;6499;2879;3.8;1.7
52;2021-02-12;187;128;6686;3007;4.0;1.8
52;2021-02-13;5;1;6691;3008;4.0;1.8
52;2021-02-14;0;16;6691;3024;4.0;1.8
52;2021-02-15;79;277;6770;3301;4.0;2.0
52;2021-02-16;50;358;6820;3659;4.0;2.2
52;2021-02-17;38;313;6858;3972;4.1;2.3
52;2021-02-18;82;279;6940;4251;4.1;2.5
52;2021-02-19;50;192;6990;4443;4.1;2.6
52;2021-02-20;14;106;7004;4549;4.1;2.7
52;2021-02-21;0;0;7004;4549;4.1;2.7
52;2021-02-22;42;382;7046;4931;4.2;2.9
52;2021-02-23;56;278;7102;5209;4.2;3.1
52;2021-02-24;81;246;7183;5455;4.2;3.2
52;2021-02-25;161;238;7344;5693;4.3;3.4
52;2021-02-26;296;182;7640;5875;4.5;3.5
52;2021-02-27;149;49;7789;5924;4.6;3.5
52;2021-02-28;0;0;7789;5924;4.6;3.5
52;2021-03-01;162;14;7951;5938;4.7;3.5
52;2021-03-02;247;52;8198;5990;4.8;3.5
52;2021-03-03;356;38;8554;6028;5.1;3.6
52;2021-03-04;381;58;8935;6086;5.3;3.6
52;2021-03-05;531;54;9466;6140;5.6;3.6
52;2021-03-06;409;36;9875;6176;5.8;3.6
52;2021-03-07;0;0;9875;6176;5.8;3.6
52;2021-03-08;398;112;10273;6288;6.1;3.7
52;2021-03-09;549;111;10822;6399;6.4;3.8
52;2021-03-10;308;109;11130;6508;6.6;3.8
52;2021-03-11;587;36;11717;6544;6.9;3.9
52;2021-03-12;603;70;12320;6614;7.3;3.9
52;2021-03-13;494;11;12814;6625;7.6;3.9
52;2021-03-14;15;3;12829;6628;7.6;3.9
52;2021-03-15;318;28;13147;6656;7.8;3.9
52;2021-03-16;203;16;13350;6672;7.9;3.9
52;2021-03-17;369;16;13719;6688;8.1;4.0
52;2021-03-18;442;12;14161;6700;8.4;4.0
52;2021-03-19;453;55;14614;6755;8.6;4.0
52;2021-03-20;259;12;14873;6767;8.8;4.0
52;2021-03-21;15;1;14888;6768;8.8;4.0
52;2021-03-22;375;49;15263;6817;9.0;4.0
52;2021-03-23;686;148;15949;6965;9.4;4.1
52;2021-03-24;771;74;16720;7039;9.9;4.2
52;2021-03-25;1145;89;17865;7128;10.6;4.2
52;2021-03-26;1038;139;18903;7267;11.2;4.3
52;2021-03-27;477;77;19380;7344;11.5;4.3
52;2021-03-28;53;0;19433;7344;11.5;4.3
52;2021-03-29;507;185;19940;7529;11.8;4.4
52;2021-03-30;868;345;20808;7874;12.3;4.7
52;2021-03-31;956;293;21764;8167;12.9;4.8
52;2021-04-01;1145;183;22909;8350;13.5;4.9
52;2021-04-02;958;111;23867;8461;14.1;5.0
52;2021-04-03;462;3;24329;8464;14.4;5.0
52;2021-04-04;1;1;24330;8465;14.4;5.0
52;2021-04-05;1;0;24331;8465;14.4;5.0
52;2021-04-06;434;296;24765;8761;14.6;5.2
52;2021-04-07;506;451;25271;9212;14.9;5.4
52;2021-04-08;861;212;26132;9424;15.4;5.6
52;2021-04-09;1059;131;27191;9555;16.1;5.6
52;2021-04-10;850;102;28041;9657;16.6;5.7
52;2021-04-11;96;1;28137;9658;16.6;5.7
52;2021-04-12;933;282;29070;9940;17.2;5.9
52;2021-04-13;1251;381;30321;10321;17.9;6.1
52;2021-04-14;1345;459;31666;10780;18.7;6.4
52;2021-04-15;1505;443;33171;11223;19.6;6.6
52;2021-04-16;1569;371;34740;11594;20.5;6.9
52;2021-04-17;1312;137;36052;11731;21.3;6.9
52;2021-04-18;510;29;36562;11760;21.6;6.9
52;2021-04-19;697;612;37259;12372;22.0;7.3
52;2021-04-20;1079;679;38338;13051;22.7;7.7
52;2021-04-21;1058;675;39396;13726;23.3;8.1
52;2021-04-22;1468;738;40864;14464;24.1;8.5
52;2021-04-23;1250;671;42114;15135;24.9;8.9
52;2021-04-24;477;293;42591;15428;25.2;9.1
52;2021-04-25;3;77;42594;15505;25.2;9.2
52;2021-04-26;631;565;43225;16070;25.5;9.5
52;2021-04-27;932;672;44157;16742;26.1;9.9
52;2021-04-28;1444;571;45601;17313;26.9;10.2
52;2021-04-29;1452;583;47053;17896;27.8;10.6
52;2021-04-30;1316;618;48369;18514;28.6;10.9
52;2021-05-01;8;232;48377;18746;28.6;11.1
52;2021-05-02;0;1;48377;18747;28.6;11.1
52;2021-05-03;1159;630;49536;19377;29.3;11.4
52;2021-05-04;1445;723;50981;20100;30.1;11.9
52;2021-05-05;1767;648;52748;20748;31.2;12.3
52;2021-05-06;1962;537;54710;21285;32.3;12.6
52;2021-05-07;1441;1170;56151;22455;33.2;13.3
52;2021-05-08;587;318;56738;22773;33.5;13.5
52;2021-05-09;1;47;56739;22820;33.5;13.5
52;2021-05-10;792;1101;57531;23921;34.0;14.1
52;2021-05-11;868;1391;58399;25312;34.5;15.0
52;2021-05-12;1206;1382;59605;26694;35.2;15.8
52;2021-05-13;67;184;59672;26878;35.3;15.9
52;2021-05-14;1185;1366;60857;28244;36.0;16.7
52;2021-05-15;492;929;61349;29173;36.2;17.2
52;2021-05-16;8;43;61357;29216;36.3;17.3
52;2021-05-17;1141;705;62498;29921;36.9;17.7
52;2021-05-18;1218;677;63716;30598;37.6;18.1
52;2021-05-19;1541;415;65257;31013;38.6;18.3
52;2021-05-20;1546;422;66803;31435;39.5;18.6
52;2021-05-21;1625;611;68428;32046;40.4;18.9
52;2021-05-22;1089;210;69517;32256;41.1;19.1
52;2021-05-23;1;0;69518;32256;41.1;19.1
52;2021-05-24;405;33;69923;32289;41.3;19.1
52;2021-05-25;1352;385;71275;32674;42.1;19.3
52;2021-05-26;1476;672;72751;33346;43.0;19.7
52;2021-05-27;1564;787;74315;34133;43.9;20.2
52;2021-05-28;1494;673;75809;34806;44.8;20.6
52;2021-05-29;695;834;76504;35640;45.2;21.1
52;2021-05-30;16;551;76520;36191;45.2;21.4
52;2021-05-31;825;829;77345;37020;45.7;21.9
52;2021-06-01;956;816;78301;37836;46.3;22.4
52;2021-06-02;896;754;79197;38590;46.8;22.8
52;2021-06-03;825;825;80022;39415;47.3;23.3
52;2021-06-04;883;1340;80905;40755;47.8;24.1
52;2021-06-05;581;637;81486;41392;48.1;24.5
52;2021-06-06;27;55;81513;41447;48.2;24.5
52;2021-06-07;359;931;81872;42378;48.4;25.0
52;2021-06-08;556;1471;82428;43849;48.7;25.9
52;2021-06-09;611;1474;83039;45323;49.1;26.8
52;2021-06-10;794;1159;83833;46482;49.5;27.5
52;2021-06-11;832;1348;84665;47830;50.0;28.3
52;2021-06-12;423;586;85088;48416;50.3;28.6
52;2021-06-13;2;6;85090;48422;50.3;28.6
52;2021-06-14;170;1413;85260;49835;50.4;29.4
52;2021-06-15;221;1807;85481;51642;50.5;30.5
52;2021-06-16;351;1996;85832;53638;50.7;31.7
52;2021-06-17;265;1156;86097;54794;50.9;32.4
52;2021-06-18;308;1553;86405;56347;51.1;33.3
52;2021-06-19;502;690;86907;57037;51.3;33.7
52;2021-06-20;1;17;86908;57054;51.3;33.7
52;2021-06-21;523;898;87431;57952;51.7;34.2
52;2021-06-22;503;1047;87934;58999;52.0;34.9
52;2021-06-23;563;1041;88497;60040;52.3;35.5
52;2021-06-24;610;715;89107;60755;52.6;35.9
52;2021-06-25;661;1314;89768;62069;53.0;36.7
52;2021-06-26;264;722;90032;62791;53.2;37.1
52;2021-06-27;1;8;90033;62799;53.2;37.1
52;2021-06-28;184;1442;90217;64241;53.3;38.0
52;2021-06-29;163;1414;90380;65655;53.4;38.8
52;2021-06-30;221;1468;90601;67123;53.5;39.7
52;2021-07-01;320;1020;90921;68143;53.7;40.3
52;2021-07-02;430;1454;91351;69597;54.0;41.1
52;2021-07-03;302;1148;91653;70745;54.2;41.8
52;2021-07-04;0;11;91653;70756;54.2;41.8
52;2021-07-05;175;1448;91828;72204;54.3;42.7
52;2021-07-06;284;1449;92112;73653;54.4;43.5
52;2021-07-07;309;1163;92421;74816;54.6;44.2
52;2021-07-08;473;1166;92894;75982;54.9;44.9
52;2021-07-09;288;1620;93182;77602;55.1;45.9
52;2021-07-10;155;822;93337;78424;55.1;46.3
52;2021-07-11;13;12;93350;78436;55.2;46.3
52;2021-07-12;299;1467;93649;79903;55.3;47.2
52;2021-07-13;590;1369;94239;81272;55.7;48.0
52;2021-07-14;437;153;94676;81425;55.9;48.1
52;2021-07-15;614;1428;95290;82853;56.3;49.0
52;2021-07-16;899;1339;96189;84192;56.8;49.7
52;2021-07-17;530;343;96719;84535;57.1;49.9
52;2021-07-18;3;12;96722;84547;57.1;50.0
52;2021-07-19;691;987;97413;85534;57.6;50.5
52;2021-07-20;1110;831;98523;86365;58.2;51.0
52;2021-07-21;1161;738;99684;87103;58.9;51.5
52;2021-07-22;1447;869;101131;87972;59.8;52.0
52;2021-07-23;1399;956;102530;88928;60.6;52.5
52;2021-07-24;873;487;103403;89415;61.1;52.8
52;2021-07-25;22;21;103425;89436;61.1;52.8
52;2021-07-26;1010;614;104435;90050;61.7;53.2
52;2021-07-27;1342;658;105777;90708;62.5;53.6
52;2021-07-28;1382;644;107159;91352;63.3;54.0
52;2021-07-29;1263;622;108422;91974;64.1;54.3
52;2021-07-30;1365;713;109787;92687;64.9;54.8
52;2021-07-31;873;549;110660;93236;65.4;55.1
52;2021-08-01;1;14;110661;93250;65.4;55.1
52;2021-08-02;1185;561;111846;93811;66.1;55.4
52;2021-08-03;1363;540;113209;94351;66.9;55.7
52;2021-08-04;1157;579;114366;94930;67.6;56.1
52;2021-08-05;1026;574;115392;95504;68.2;56.4
52;2021-08-06;1057;698;116449;96202;68.8;56.8
52;2021-08-07;519;422;116968;96624;69.1;57.1
52;2021-08-08;0;6;116968;96630;69.1;57.1
52;2021-08-09;469;871;117437;97501;69.4;57.6
52;2021-08-10;717;748;118154;98249;69.8;58.0
52;2021-08-11;535;837;118689;99086;70.1;58.5
52;2021-08-12;623;750;119312;99836;70.5;59.0
52;2021-08-13;420;1029;119732;100865;70.7;59.6
52;2021-08-14;421;360;120153;101225;71.0;59.8
52;2021-08-15;13;13;120166;101238;71.0;59.8
52;2021-08-16;327;934;120493;102172;71.2;60.4
52;2021-08-17;416;911;120909;103083;71.4;60.9
52;2021-08-18;489;944;121398;104027;71.7;61.5
52;2021-08-19;461;836;121859;104863;72.0;62.0
52;2021-08-20;384;1210;122243;106073;72.2;62.7
52;2021-08-21;394;605;122637;106678;72.5;63.0
52;2021-08-22;5;11;122642;106689;72.5;63.0
52;2021-08-23;431;1058;123073;107747;72.7;63.7
52;2021-08-24;307;1077;123380;108824;72.9;64.3
52;2021-08-25;254;1061;123634;109885;73.0;64.9
52;2021-08-26;303;914;123937;110799;73.2;65.5
52;2021-08-27;429;1276;124366;112075;73.5;66.2
52;2021-08-28;243;495;124609;112570;73.6;66.5
52;2021-08-29;3;25;124612;112595;73.6;66.5
52;2021-08-30;204;977;124816;113572;73.7;67.1
52;2021-08-31;205;1034;125021;114606;73.9;67.7
52;2021-09-01;183;1041;125204;115647;74.0;68.3
52;2021-09-02;194;698;125398;116345;74.1;68.7
52;2021-09-03;243;857;125641;117202;74.2;69.2
52;2021-09-04;189;527;125830;117729;74.3;69.6
52;2021-09-05;2;13;125832;117742;74.3;69.6
52;2021-09-06;126;511;125958;118253;74.4;69.9
52;2021-09-07;163;420;126121;118673;74.5;70.1
52;2021-09-08;143;571;126264;119244;74.6;70.5
52;2021-09-09;140;362;126404;119606;74.7;70.7
52;2021-09-10;256;640;126660;120246;74.8;71.0
52;2021-09-11;151;292;126811;120538;74.9;71.2
52;2021-09-12;2;9;126813;120547;74.9;71.2
52;2021-09-13;176;494;126989;121041;75.0;71.5
52;2021-09-14;146;325;127135;121366;75.1;71.7
52;2021-09-15;150;448;127285;121814;75.2;72.0
52;2021-09-16;136;309;127421;122123;75.3;72.2
52;2021-09-17;232;543;127653;122666;75.4;72.5
52;2021-09-18;135;243;127788;122909;75.5;72.6
52;2021-09-19;4;18;127792;122927;75.5;72.6
52;2021-09-20;106;355;127898;123282;75.6;72.8
52;2021-09-21;95;208;127993;123490;75.6;73.0
52;2021-09-22;107;320;128100;123810;75.7;73.2
52;2021-09-23;139;207;128239;124017;75.8;73.3
52;2021-09-24;128;284;128367;124301;75.8;73.4
52;2021-09-25;93;250;128460;124551;75.9;73.6
52;2021-09-26;0;0;128460;124551;75.9;73.6
52;2021-09-27;116;181;128576;124732;76.0;73.7
52;2021-09-28;120;144;128696;124876;76.0;73.8
52;2021-09-29;93;207;128789;125083;76.1;73.9
52;2021-09-30;117;125;128906;125208;76.2;74.0
52;2021-10-01;117;226;129023;125434;76.2;74.1
52;2021-10-02;63;150;129086;125584;76.3;74.2
52;2021-10-03;0;6;129086;125590;76.3;74.2
52;2021-10-04;83;179;129169;125769;76.3;74.3
52;2021-10-05;57;133;129226;125902;76.4;74.4
52;2021-10-06;120;171;129346;126073;76.4;74.5
52;2021-10-07;54;101;129400;126174;76.5;74.5
52;2021-10-08;112;225;129512;126399;76.5;74.7
52;2021-10-09;66;132;129578;126531;76.6;74.8
52;2021-10-10;0;1;129578;126532;76.6;74.8
52;2021-10-11;43;164;129621;126696;76.6;74.9
52;2021-10-12;65;117;129686;126813;76.6;74.9
52;2021-10-13;70;102;129756;126915;76.7;75.0
52;2021-10-14;38;58;129794;126973;76.7;75.0
53;2020-12-27;0;0;0;0;0.0;0.0
53;2020-12-28;0;0;0;0;0.0;0.0
53;2020-12-29;0;0;0;0;0.0;0.0
53;2020-12-30;0;0;0;0;0.0;0.0
53;2020-12-31;0;0;0;0;0.0;0.0
53;2021-01-01;0;0;0;0;0.0;0.0
53;2021-01-02;3;1;3;1;0.0;0.0
53;2021-01-03;0;0;3;1;0.0;0.0
53;2021-01-04;1;0;4;1;0.0;0.0
53;2021-01-05;0;0;4;1;0.0;0.0
53;2021-01-06;0;0;4;1;0.0;0.0
53;2021-01-07;102;0;106;1;0.0;0.0
53;2021-01-08;284;1;390;2;0.1;0.0
53;2021-01-09;134;1;524;3;0.2;0.0
53;2021-01-10;15;0;539;3;0.2;0.0
53;2021-01-11;176;1;715;4;0.2;0.0
53;2021-01-12;456;1;1171;5;0.4;0.0
53;2021-01-13;254;0;1425;5;0.5;0.0
53;2021-01-14;290;7;1715;12;0.6;0.0
53;2021-01-15;343;4;2058;16;0.7;0.0
53;2021-01-16;60;0;2118;16;0.7;0.0
53;2021-01-17;25;2;2143;18;0.7;0.0
53;2021-01-18;364;0;2507;18;0.8;0.0
53;2021-01-19;594;0;3101;18;1.0;0.0
53;2021-01-20;742;0;3843;18;1.3;0.0
53;2021-01-21;772;3;4615;21;1.5;0.0
53;2021-01-22;703;10;5318;31;1.7;0.0
53;2021-01-23;160;1;5478;32;1.8;0.0
53;2021-01-24;6;0;5484;32;1.8;0.0
53;2021-01-25;550;0;6034;32;2.0;0.0
53;2021-01-26;1199;7;7233;39;2.4;0.0
53;2021-01-27;696;6;7929;45;2.6;0.0
53;2021-01-28;737;97;8666;142;2.8;0.0
53;2021-01-29;422;187;9088;329;3.0;0.1
53;2021-01-30;130;0;9218;329;3.0;0.1
53;2021-01-31;0;0;9218;329;3.0;0.1
53;2021-02-01;298;149;9516;478;3.1;0.2
53;2021-02-02;309;232;9825;710;3.2;0.2
53;2021-02-03;228;377;10053;1087;3.3;0.4
53;2021-02-04;184;332;10237;1419;3.4;0.5
53;2021-02-05;234;303;10471;1722;3.4;0.6
53;2021-02-06;153;23;10624;1745;3.5;0.6
53;2021-02-07;0;0;10624;1745;3.5;0.6
53;2021-02-08;168;106;10792;1851;3.5;0.6
53;2021-02-09;369;216;11161;2067;3.7;0.7
53;2021-02-10;266;433;11427;2500;3.7;0.8
53;2021-02-11;433;491;11860;2991;3.9;1.0
53;2021-02-12;318;572;12178;3563;4.0;1.2
53;2021-02-13;96;66;12274;3629;4.0;1.2
53;2021-02-14;0;99;12274;3728;4.0;1.2
53;2021-02-15;239;431;12513;4159;4.1;1.4
53;2021-02-16;527;840;13040;4999;4.3;1.6
53;2021-02-17;391;614;13431;5613;4.4;1.8
53;2021-02-18;547;579;13978;6192;4.6;2.0
53;2021-02-19;895;429;14873;6621;4.9;2.2
53;2021-02-20;139;113;15012;6734;4.9;2.2
53;2021-02-21;1;20;15013;6754;4.9;2.2
53;2021-02-22;161;584;15174;7338;5.0;2.4
53;2021-02-23;59;655;15233;7993;5.0;2.6
53;2021-02-24;137;517;15370;8510;5.0;2.8
53;2021-02-25;457;360;15827;8870;5.2;2.9
53;2021-02-26;437;262;16264;9132;5.3;3.0
53;2021-02-27;86;115;16350;9247;5.4;3.0
53;2021-02-28;0;0;16350;9247;5.4;3.0
53;2021-03-01;231;278;16581;9525;5.4;3.1
53;2021-03-02;246;255;16827;9780;5.5;3.2
53;2021-03-03;321;393;17148;10173;5.6;3.3
53;2021-03-04;859;347;18007;10520;5.9;3.4
53;2021-03-05;660;281;18667;10801;6.1;3.5
53;2021-03-06;447;212;19114;11013;6.3;3.6
53;2021-03-07;276;5;19390;11018;6.3;3.6
53;2021-03-08;375;181;19765;11199;6.5;3.7
53;2021-03-09;878;247;20643;11446;6.8;3.7
53;2021-03-10;807;111;21450;11557;7.0;3.8
53;2021-03-11;1247;229;22697;11786;7.4;3.9
53;2021-03-12;1603;149;24300;11935;8.0;3.9
53;2021-03-13;824;15;25124;11950;8.2;3.9
53;2021-03-14;1;0;25125;11950;8.2;3.9
53;2021-03-15;1001;301;26126;12251;8.6;4.0
53;2021-03-16;1035;332;27161;12583;8.9;4.1
53;2021-03-17;687;261;27848;12844;9.1;4.2
53;2021-03-18;972;345;28820;13189;9.4;4.3
53;2021-03-19;1346;600;30166;13789;9.9;4.5
53;2021-03-20;592;17;30758;13806;10.1;4.5
53;2021-03-21;3;1;30761;13807;10.1;4.5
53;2021-03-22;1214;159;31975;13966;10.5;4.6
53;2021-03-23;1699;72;33674;14038;11.0;4.6
53;2021-03-24;1323;118;34997;14156;11.5;4.6
53;2021-03-25;2322;245;37319;14401;12.2;4.7
53;2021-03-26;1882;153;39201;14554;12.8;4.8
53;2021-03-27;339;3;39540;14557;12.9;4.8
53;2021-03-28;2;0;39542;14557;12.9;4.8
53;2021-03-29;1474;213;41016;14770;13.4;4.8
53;2021-03-30;1944;205;42960;14975;14.1;4.9
53;2021-03-31;1791;224;44751;15199;14.7;5.0
53;2021-04-01;1948;675;46699;15874;15.3;5.2
53;2021-04-02;2075;230;48774;16104;16.0;5.3
53;2021-04-03;414;2;49188;16106;16.1;5.3
53;2021-04-04;11;0;49199;16106;16.1;5.3
53;2021-04-05;9;15;49208;16121;16.1;5.3
53;2021-04-06;1305;507;50513;16628;16.5;5.4
53;2021-04-07;1172;927;51685;17555;16.9;5.7
53;2021-04-08;1663;1010;53348;18565;17.5;6.1
53;2021-04-09;1959;408;55307;18973;18.1;6.2
53;2021-04-10;543;13;55850;18986;18.3;6.2
53;2021-04-11;13;0;55863;18986;18.3;6.2
53;2021-04-12;694;1069;56557;20055;18.5;6.6
53;2021-04-13;1470;1110;58027;21165;19.0;6.9
53;2021-04-14;1021;738;59048;21903;19.3;7.2
53;2021-04-15;1156;1109;60204;23012;19.7;7.5
53;2021-04-16;1271;816;61475;23828;20.1;7.8
53;2021-04-17;279;274;61754;24102;20.2;7.9
53;2021-04-18;0;0;61754;24102;20.2;7.9
53;2021-04-19;681;1068;62435;25170;20.4;8.2
53;2021-04-20;936;1453;63371;26623;20.8;8.7
53;2021-04-21;852;1014;64223;27637;21.0;9.1
53;2021-04-22;1045;1617;65268;29254;21.4;9.6
53;2021-04-23;1329;1055;66597;30309;21.8;9.9
53;2021-04-24;68;7;66665;30316;21.8;9.9
53;2021-04-25;6;39;66671;30355;21.8;9.9
53;2021-04-26;368;1238;67039;31593;22.0;10.3
53;2021-04-27;723;1975;67762;33568;22.2;11.0
53;2021-04-28;977;1392;68739;34960;22.5;11.4
53;2021-04-29;1052;1715;69791;36675;22.9;12.0
53;2021-04-30;1366;1316;71157;37991;23.3;12.4
53;2021-05-01;36;51;71193;38042;23.3;12.5
53;2021-05-02;0;0;71193;38042;23.3;12.5
53;2021-05-03;1570;709;72763;38751;23.8;12.7
53;2021-05-04;1303;1442;74066;40193;24.3;13.2
53;2021-05-05;1611;827;75677;41020;24.8;13.4
53;2021-05-06;1390;1404;77067;42424;25.2;13.9
53;2021-05-07;1537;1306;78604;43730;25.7;14.3
53;2021-05-08;939;36;79543;43766;26.0;14.3
53;2021-05-09;11;2;79554;43768;26.1;14.3
53;2021-05-10;2414;815;81968;44583;26.8;14.6
53;2021-05-11;3097;1286;85065;45869;27.9;15.0
53;2021-05-12;2751;1094;87816;46963;28.8;15.4
53;2021-05-13;350;27;88166;46990;28.9;15.4
53;2021-05-14;2021;678;90187;47668;29.5;15.6
53;2021-05-15;1058;63;91245;47731;29.9;15.6
53;2021-05-16;3;0;91248;47731;29.9;15.6
53;2021-05-17;1701;1196;92949;48927;30.4;16.0
53;2021-05-18;1880;1551;94829;50478;31.1;16.5
53;2021-05-19;2302;748;97131;51226;31.8;16.8
53;2021-05-20;3216;867;100347;52093;32.9;17.1
53;2021-05-21;2798;829;103145;52922;33.8;17.3
53;2021-05-22;21;60;103166;52982;33.8;17.4
53;2021-05-23;1;0;103167;52982;33.8;17.4
53;2021-05-24;8;6;103175;52988;33.8;17.4
53;2021-05-25;1820;803;104995;53791;34.4;17.6
53;2021-05-26;1853;908;106848;54699;35.0;17.9
53;2021-05-27;3072;1080;109920;55779;36.0;18.3
53;2021-05-28;2562;884;112482;56663;36.8;18.6
53;2021-05-29;846;244;113328;56907;37.1;18.6
53;2021-05-30;18;6;113346;56913;37.1;18.6
53;2021-05-31;2565;802;115911;57715;38.0;18.9
53;2021-06-01;3489;1258;119400;58973;39.1;19.3
53;2021-06-02;3183;526;122583;59499;40.1;19.5
53;2021-06-03;4198;789;126781;60288;41.5;19.7
53;2021-06-04;3179;1265;129960;61553;42.6;20.2
53;2021-06-05;137;245;130097;61798;42.6;20.2
53;2021-06-06;1;4;130098;61802;42.6;20.2
53;2021-06-07;2629;922;132727;62724;43.5;20.5
53;2021-06-08;3588;1130;136315;63854;44.6;20.9
53;2021-06-09;2455;944;138770;64798;45.4;21.2
53;2021-06-10;3521;848;142291;65646;46.6;21.5
53;2021-06-11;2964;1213;145255;66859;47.6;21.9
53;2021-06-12;108;138;145363;66997;47.6;21.9
53;2021-06-13;10;2;145373;66999;47.6;21.9
53;2021-06-14;1600;1789;146973;68788;48.1;22.5
53;2021-06-15;1898;2265;148871;71053;48.8;23.3
53;2021-06-16;1828;1733;150699;72786;49.4;23.8
53;2021-06-17;3011;1651;153710;74437;50.3;24.4
53;2021-06-18;2705;1808;156415;76245;51.2;25.0
53;2021-06-19;761;1165;157176;77410;51.5;25.3
53;2021-06-20;3;479;157179;77889;51.5;25.5
53;2021-06-21;918;2525;158097;80414;51.8;26.3
53;2021-06-22;1299;3452;159396;83866;52.2;27.5
53;2021-06-23;1362;2892;160758;86758;52.6;28.4
53;2021-06-24;1802;2033;162560;88791;53.2;29.1
53;2021-06-25;1785;2045;164345;90836;53.8;29.7
53;2021-06-26;977;351;165322;91187;54.1;29.9
53;2021-06-27;8;8;165330;91195;54.1;29.9
53;2021-06-28;662;2899;165992;94094;54.4;30.8
53;2021-06-29;858;3648;166850;97742;54.6;32.0
53;2021-06-30;749;1518;167599;99260;54.9;32.5
53;2021-07-01;1507;2630;169106;101890;55.4;33.4
53;2021-07-02;1530;2026;170636;103916;55.9;34.0
53;2021-07-03;858;574;171494;104490;56.2;34.2
53;2021-07-04;0;4;171494;104494;56.2;34.2
53;2021-07-05;542;2058;172036;106552;56.3;34.9
53;2021-07-06;859;3615;172895;110167;56.6;36.1
53;2021-07-07;1025;2652;173920;112819;57.0;36.9
53;2021-07-08;1314;3116;175234;115935;57.4;38.0
53;2021-07-09;1131;3399;176365;119334;57.8;39.1
53;2021-07-10;422;1001;176787;120335;57.9;39.4
53;2021-07-11;12;20;176799;120355;57.9;39.4
53;2021-07-12;503;3707;177302;124062;58.1;40.6
53;2021-07-13;894;4763;178196;128825;58.4;42.2
53;2021-07-14;104;284;178300;129109;58.4;42.3
53;2021-07-15;1112;4346;179412;133455;58.8;43.7
53;2021-07-16;1248;3847;180660;137302;59.2;45.0
53;2021-07-17;1318;300;181978;137602;59.6;45.1
53;2021-07-18;27;20;182005;137622;59.6;45.1
53;2021-07-19;734;3426;182739;141048;59.8;46.2
53;2021-07-20;985;4123;183724;145171;60.2;47.5
53;2021-07-21;686;3274;184410;148445;60.4;48.6
53;2021-07-22;1513;3525;185923;151970;60.9;49.8
53;2021-07-23;1603;3761;187526;155731;61.4;51.0
53;2021-07-24;956;280;188482;156011;61.7;51.1
53;2021-07-25;60;24;188542;156035;61.7;51.1
53;2021-07-26;1727;1941;190269;157976;62.3;51.7
53;2021-07-27;2356;2824;192625;160800;63.1;52.7
53;2021-07-28;2145;2813;194770;163613;63.8;53.6
53;2021-07-29;2491;2546;197261;166159;64.6;54.4
53;2021-07-30;1828;2647;199089;168806;65.2;55.3
53;2021-07-31;626;232;199715;169038;65.4;55.4
53;2021-08-01;37;25;199752;169063;65.4;55.4
53;2021-08-02;2083;1733;201835;170796;66.1;55.9
53;2021-08-03;2417;1905;204252;172701;66.9;56.6
53;2021-08-04;2476;1863;206728;174564;67.7;57.2
53;2021-08-05;2870;1542;209598;176106;68.6;57.7
53;2021-08-06;2517;1720;212115;177826;69.5;58.2
53;2021-08-07;483;272;212598;178098;69.6;58.3
53;2021-08-08;6;19;212604;178117;69.6;58.3
53;2021-08-09;1839;1650;214443;179767;70.2;58.9
53;2021-08-10;2325;1748;216768;181515;71.0;59.4
53;2021-08-11;1680;867;218448;182382;71.5;59.7
53;2021-08-12;2007;984;220455;183366;72.2;60.0
53;2021-08-13;2039;1315;222494;184681;72.9;60.5
53;2021-08-14;66;63;222560;184744;72.9;60.5
53;2021-08-15;1;2;222561;184746;72.9;60.5
53;2021-08-16;1337;1596;223898;186342;73.3;61.0
53;2021-08-17;1548;1657;225446;187999;73.8;61.6
53;2021-08-18;1515;1600;226961;189599;74.3;62.1
53;2021-08-19;1375;1973;228336;191572;74.8;62.7
53;2021-08-20;1099;2082;229435;193654;75.1;63.4
53;2021-08-21;189;341;229624;193995;75.2;63.5
53;2021-08-22;0;0;229624;193995;75.2;63.5
53;2021-08-23;843;1915;230467;195910;75.5;64.2
53;2021-08-24;903;2117;231370;198027;75.8;64.8
53;2021-08-25;916;2273;232286;200300;76.1;65.6
53;2021-08-26;666;2614;232952;202914;76.3;66.4
53;2021-08-27;754;2645;233706;205559;76.5;67.3
53;2021-08-28;48;133;233754;205692;76.5;67.4
53;2021-08-29;12;31;233766;205723;76.6;67.4
53;2021-08-30;620;2085;234386;207808;76.8;68.1
53;2021-08-31;762;2859;235148;210667;77.0;69.0
53;2021-09-01;342;1544;235490;212211;77.1;69.5
53;2021-09-02;443;1703;235933;213914;77.3;70.1
53;2021-09-03;449;2338;236382;216252;77.4;70.8
53;2021-09-04;115;188;236497;216440;77.4;70.9
53;2021-09-05;1;12;236498;216452;77.4;70.9
53;2021-09-06;299;1468;236797;217920;77.5;71.4
53;2021-09-07;288;1782;237085;219702;77.6;71.9
53;2021-09-08;421;2007;237506;221709;77.8;72.6
53;2021-09-09;237;1351;237743;223060;77.9;73.0
53;2021-09-10;383;1838;238126;224898;78.0;73.6
53;2021-09-11;39;86;238165;224984;78.0;73.7
53;2021-09-12;0;1;238165;224985;78.0;73.7
53;2021-09-13;231;974;238396;225959;78.1;74.0
53;2021-09-14;243;841;238639;226800;78.1;74.3
53;2021-09-15;334;1071;238973;227871;78.3;74.6
53;2021-09-16;306;380;239279;228251;78.4;74.7
53;2021-09-17;430;1057;239709;229308;78.5;75.1
53;2021-09-18;44;70;239753;229378;78.5;75.1
53;2021-09-19;8;14;239761;229392;78.5;75.1
53;2021-09-20;123;382;239884;229774;78.6;75.2
53;2021-09-21;250;651;240134;230425;78.6;75.5
53;2021-09-22;193;665;240327;231090;78.7;75.7
53;2021-09-23;132;395;240459;231485;78.7;75.8
53;2021-09-24;197;639;240656;232124;78.8;76.0
53;2021-09-25;27;50;240683;232174;78.8;76.0
53;2021-09-26;0;0;240683;232174;78.8;76.0
53;2021-09-27;160;374;240843;232548;78.9;76.2
53;2021-09-28;163;281;241006;232829;78.9;76.2
53;2021-09-29;159;488;241165;233317;79.0;76.4
53;2021-09-30;87;213;241252;233530;79.0;76.5
53;2021-10-01;267;621;241519;234151;79.1;76.7
53;2021-10-02;28;52;241547;234203;79.1;76.7
53;2021-10-03;3;7;241550;234210;79.1;76.7
53;2021-10-04;132;277;241682;234487;79.1;76.8
53;2021-10-05;109;210;241791;234697;79.2;76.9
53;2021-10-06;187;345;241978;235042;79.2;77.0
53;2021-10-07;82;287;242060;235329;79.3;77.1
53;2021-10-08;245;539;242305;235868;79.3;77.2
53;2021-10-09;14;27;242319;235895;79.4;77.3
53;2021-10-10;0;0;242319;235895;79.4;77.3
53;2021-10-11;108;159;242427;236054;79.4;77.3
53;2021-10-12;102;230;242529;236284;79.4;77.4
53;2021-10-13;130;229;242659;236513;79.5;77.5
53;2021-10-14;87;109;242746;236622;79.5;77.5
54;2020-12-27;0;0;0;0;0.0;0.0
54;2020-12-28;1;0;1;0;0.0;0.0
54;2020-12-29;0;0;1;0;0.0;0.0
54;2020-12-30;1;0;2;0;0.0;0.0
54;2020-12-31;10;0;12;0;0.0;0.0
54;2021-01-01;0;0;12;0;0.0;0.0
54;2021-01-02;0;0;12;0;0.0;0.0
54;2021-01-03;2;0;14;0;0.0;0.0
54;2021-01-04;163;0;177;0;0.0;0.0
54;2021-01-05;396;2;573;2;0.1;0.0
54;2021-01-06;650;1;1223;3;0.2;0.0
54;2021-01-07;816;2;2039;5;0.3;0.0
54;2021-01-08;706;3;2745;8;0.4;0.0
54;2021-01-09;81;0;2826;8;0.4;0.0
54;2021-01-10;78;0;2904;8;0.4;0.0
54;2021-01-11;974;3;3878;11;0.5;0.0
54;2021-01-12;1182;1;5060;12;0.7;0.0
54;2021-01-13;2428;9;7488;21;1.0;0.0
54;2021-01-14;3401;28;10889;49;1.5;0.0
54;2021-01-15;2718;19;13607;68;1.9;0.0
54;2021-01-16;815;4;14422;72;2.0;0.0
54;2021-01-17;209;0;14631;72;2.0;0.0
54;2021-01-18;1558;7;16189;79;2.2;0.0
54;2021-01-19;1707;2;17896;81;2.5;0.0
54;2021-01-20;1525;5;19421;86;2.7;0.0
54;2021-01-21;1373;5;20794;91;2.8;0.0
54;2021-01-22;1093;8;21887;99;3.0;0.0
54;2021-01-23;477;1;22364;100;3.1;0.0
54;2021-01-24;66;0;22430;100;3.1;0.0
54;2021-01-25;946;35;23376;135;3.2;0.0
54;2021-01-26;142;5;23518;140;3.2;0.0
54;2021-01-27;12;166;23530;306;3.2;0.0
54;2021-01-28;32;229;23562;535;3.2;0.1
54;2021-01-29;19;275;23581;810;3.2;0.1
54;2021-01-30;7;1;23588;811;3.2;0.1
54;2021-01-31;1;0;23589;811;3.2;0.1
54;2021-02-01;13;784;23602;1595;3.2;0.2
54;2021-02-02;25;966;23627;2561;3.2;0.4
54;2021-02-03;364;1530;23991;4091;3.3;0.6
54;2021-02-04;739;2454;24730;6545;3.4;0.9
54;2021-02-05;799;1888;25529;8433;3.5;1.2
54;2021-02-06;204;333;25733;8766;3.5;1.2
54;2021-02-07;4;124;25737;8890;3.5;1.2
54;2021-02-08;117;994;25854;9884;3.5;1.4
54;2021-02-09;306;1067;26160;10951;3.6;1.5
54;2021-02-10;386;795;26546;11746;3.6;1.6
54;2021-02-11;294;813;26840;12559;3.7;1.7
54;2021-02-12;446;1292;27286;13851;3.7;1.9
54;2021-02-13;148;236;27434;14087;3.8;1.9
54;2021-02-14;9;11;27443;14098;3.8;1.9
54;2021-02-15;428;1128;27871;15226;3.8;2.1
54;2021-02-16;401;1222;28272;16448;3.9;2.3
54;2021-02-17;518;956;28790;17404;3.9;2.4
54;2021-02-18;594;780;29384;18184;4.0;2.5
54;2021-02-19;519;777;29903;18961;4.1;2.6
54;2021-02-20;34;282;29937;19243;4.1;2.6
54;2021-02-21;3;24;29940;19267;4.1;2.6
54;2021-02-22;483;598;30423;19865;4.2;2.7
54;2021-02-23;679;560;31102;20425;4.3;2.8
54;2021-02-24;728;354;31830;20779;4.4;2.8
54;2021-02-25;1474;724;33304;21503;4.6;2.9
54;2021-02-26;1776;792;35080;22295;4.8;3.1
54;2021-02-27;699;111;35779;22406;4.9;3.1
54;2021-02-28;11;28;35790;22434;4.9;3.1
54;2021-03-01;625;218;36415;22652;5.0;3.1
54;2021-03-02;1451;151;37866;22803;5.2;3.1
54;2021-03-03;1736;63;39602;22866;5.4;3.1
54;2021-03-04;2014;102;41616;22968;5.7;3.1
54;2021-03-05;2797;146;44413;23114;6.1;3.2
54;2021-03-06;4016;119;48429;23233;6.6;3.2
54;2021-03-07;2625;72;51054;23305;7.0;3.2
54;2021-03-08;1338;68;52392;23373;7.2;3.2
54;2021-03-09;2621;107;55013;23480;7.5;3.2
54;2021-03-10;3178;114;58191;23594;8.0;3.2
54;2021-03-11;3372;101;61563;23695;8.4;3.2
54;2021-03-12;4925;200;66488;23895;9.1;3.3
54;2021-03-13;4194;134;70682;24029;9.7;3.3
54;2021-03-14;543;40;71225;24069;9.8;3.3
54;2021-03-15;1719;105;72944;24174;10.0;3.3
54;2021-03-16;1723;158;74667;24332;10.2;3.3
54;2021-03-17;2080;137;76747;24469;10.5;3.4
54;2021-03-18;2063;166;78810;24635;10.8;3.4
54;2021-03-19;3313;267;82123;24902;11.2;3.4
54;2021-03-20;2308;79;84431;24981;11.6;3.4
54;2021-03-21;293;14;84724;24995;11.6;3.4
54;2021-03-22;1032;301;85756;25296;11.7;3.5
54;2021-03-23;1937;449;87693;25745;12.0;3.5
54;2021-03-24;2194;698;89887;26443;12.3;3.6
54;2021-03-25;3171;721;93058;27164;12.7;3.7
54;2021-03-26;3511;804;96569;27968;13.2;3.8
54;2021-03-27;2418;275;98987;28243;13.6;3.9
54;2021-03-28;280;7;99267;28250;13.6;3.9
54;2021-03-29;1668;355;100935;28605;13.8;3.9
54;2021-03-30;2558;898;103493;29503;14.2;4.0
54;2021-03-31;2599;1133;106092;30636;14.5;4.2
54;2021-04-01;3237;1271;109329;31907;15.0;4.4
54;2021-04-02;2961;1680;112290;33587;15.4;4.6
54;2021-04-03;1264;1310;113554;34897;15.5;4.8
54;2021-04-04;137;421;113691;35318;15.6;4.8
54;2021-04-05;144;574;113835;35892;15.6;4.9
54;2021-04-06;1265;1645;115100;37537;15.8;5.1
54;2021-04-07;923;2236;116023;39773;15.9;5.4
54;2021-04-08;2325;2440;118348;42213;16.2;5.8
54;2021-04-09;4113;3126;122461;45339;16.8;6.2
54;2021-04-10;3204;1674;125665;47013;17.2;6.4
54;2021-04-11;206;1001;125871;48014;17.2;6.6
54;2021-04-12;2198;1526;128069;49540;17.5;6.8
54;2021-04-13;3001;1976;131070;51516;17.9;7.1
54;2021-04-14;3259;1869;134329;53385;18.4;7.3
54;2021-04-15;2876;2302;137205;55687;18.8;7.6
54;2021-04-16;3141;2595;140346;58282;19.2;8.0
54;2021-04-17;3475;1487;143821;59769;19.7;8.2
54;2021-04-18;64;245;143885;60014;19.7;8.2
54;2021-04-19;2464;1090;146349;61104;20.0;8.4
54;2021-04-20;3011;1256;149360;62360;20.4;8.5
54;2021-04-21;4400;1643;153760;64003;21.1;8.8
54;2021-04-22;3723;2391;157483;66394;21.6;9.1
54;2021-04-23;3868;2091;161351;68485;22.1;9.4
54;2021-04-24;2347;1040;163698;69525;22.4;9.5
54;2021-04-25;284;277;163982;69802;22.5;9.6
54;2021-04-26;2306;1273;166288;71075;22.8;9.7
54;2021-04-27;3288;1442;169576;72517;23.2;9.9
54;2021-04-28;2974;1961;172550;74478;23.6;10.2
54;2021-04-29;3795;2089;176345;76567;24.1;10.5
54;2021-04-30;4493;1981;180838;78548;24.8;10.8
54;2021-05-01;2265;808;183103;79356;25.1;10.9
54;2021-05-02;229;68;183332;79424;25.1;10.9
54;2021-05-03;3097;949;186429;80373;25.5;11.0
54;2021-05-04;3514;1459;189943;81832;26.0;11.2
54;2021-05-05;4891;1420;194834;83252;26.7;11.4
54;2021-05-06;4434;2803;199268;86055;27.3;11.8
54;2021-05-07;4823;3418;204091;89473;27.9;12.2
54;2021-05-08;2030;644;206121;90117;28.2;12.3
54;2021-05-09;375;136;206496;90253;28.3;12.4
54;2021-05-10;3207;2242;209703;92495;28.7;12.7
54;2021-05-11;5492;2939;215195;95434;29.5;13.1
54;2021-05-12;4146;3390;219341;98824;30.0;13.5
54;2021-05-13;2648;492;221989;99316;30.4;13.6
54;2021-05-14;6883;2003;228872;101319;31.3;13.9
54;2021-05-15;5484;1324;234356;102643;32.1;14.1
54;2021-05-16;944;108;235300;102751;32.2;14.1
54;2021-05-17;3799;830;239099;103581;32.7;14.2
54;2021-05-18;3288;1104;242387;104685;33.2;14.3
54;2021-05-19;3464;1515;245851;106200;33.7;14.5
54;2021-05-20;4538;1621;250389;107821;34.3;14.8
54;2021-05-21;6754;2523;257143;110344;35.2;15.1
54;2021-05-22;5662;1377;262805;111721;36.0;15.3
54;2021-05-23;504;55;263309;111776;36.1;15.3
54;2021-05-24;1444;343;264753;112119;36.2;15.4
54;2021-05-25;4200;1544;268953;113663;36.8;15.6
54;2021-05-26;3536;2218;272489;115881;37.3;15.9
54;2021-05-27;4179;2434;276668;118315;37.9;16.2
54;2021-05-28;4990;3574;281658;121889;38.6;16.7
54;2021-05-29;3844;3999;285502;125888;39.1;17.2
54;2021-05-30;127;83;285629;125971;39.1;17.2
54;2021-05-31;2940;3067;288569;129038;39.5;17.7
54;2021-06-01;2622;4192;291191;133230;39.9;18.2
54;2021-06-02;2167;4097;293358;137327;40.2;18.8
54;2021-06-03;3145;5655;296503;142982;40.6;19.6
54;2021-06-04;5103;5493;301606;148475;41.3;20.3
54;2021-06-05;2342;3283;303948;151758;41.6;20.8
54;2021-06-06;72;236;304020;151994;41.6;20.8
54;2021-06-07;3706;2937;307726;154931;42.1;21.2
54;2021-06-08;4544;4275;312270;159206;42.8;21.8
54;2021-06-09;6004;3319;318274;162525;43.6;22.3
54;2021-06-10;5296;4454;323570;166979;44.3;22.9
54;2021-06-11;5023;4923;328593;171902;45.0;23.5
54;2021-06-12;4242;3233;332835;175135;45.6;24.0
54;2021-06-13;54;210;332889;175345;45.6;24.0
54;2021-06-14;2334;3595;335223;178940;45.9;24.5
54;2021-06-15;2830;4730;338053;183670;46.3;25.1
54;2021-06-16;3491;5658;341544;189328;46.8;25.9
54;2021-06-17;3138;5222;344682;194550;47.2;26.6
54;2021-06-18;4157;6242;348839;200792;47.8;27.5
54;2021-06-19;2648;3129;351487;203921;48.1;27.9
54;2021-06-20;101;339;351588;204260;48.1;28.0
54;2021-06-21;2556;4772;354144;209032;48.5;28.6
54;2021-06-22;2047;6223;356191;215255;48.8;29.5
54;2021-06-23;2246;5597;358437;220852;49.1;30.2
54;2021-06-24;2090;3455;360527;224307;49.4;30.7
54;2021-06-25;2196;7061;362723;231368;49.7;31.7
54;2021-06-26;2383;5674;365106;237042;50.0;32.5
54;2021-06-27;134;608;365240;237650;50.0;32.5
54;2021-06-28;1959;4357;367199;242007;50.3;33.1
54;2021-06-29;1941;5205;369140;247212;50.5;33.8
54;2021-06-30;1983;5123;371123;252335;50.8;34.5
54;2021-07-01;2143;5983;373266;258318;51.1;35.4
54;2021-07-02;2815;7563;376081;265881;51.5;36.4
54;2021-07-03;2838;4098;378919;269979;51.9;37.0
54;2021-07-04;196;499;379115;270478;51.9;37.0
54;2021-07-05;1668;4251;380783;274729;52.1;37.6
54;2021-07-06;2000;5080;382783;279809;52.4;38.3
54;2021-07-07;1906;4845;384689;284654;52.7;39.0
54;2021-07-08;1679;4114;386368;288768;52.9;39.5
54;2021-07-09;3205;6026;389573;294794;53.3;40.4
54;2021-07-10;2547;4376;392120;299170;53.7;41.0
54;2021-07-11;9;103;392129;299273;53.7;41.0
54;2021-07-12;2100;4698;394229;303971;54.0;41.6
54;2021-07-13;2619;4974;396848;308945;54.3;42.3
54;2021-07-14;1535;1506;398383;310451;54.5;42.5
54;2021-07-15;3172;4836;401555;315287;55.0;43.2
54;2021-07-16;4666;6224;406221;321511;55.6;44.0
54;2021-07-17;4005;4773;410226;326284;56.2;44.7
54;2021-07-18;1804;1688;412030;327972;56.4;44.9
54;2021-07-19;2591;4046;414621;332018;56.8;45.5
54;2021-07-20;2910;4814;417531;336832;57.2;46.1
54;2021-07-21;3133;6335;420664;343167;57.6;47.0
54;2021-07-22;3283;5735;423947;348902;58.0;47.8
54;2021-07-23;3982;6989;427929;355891;58.6;48.7
54;2021-07-24;2945;5334;430874;361225;59.0;49.5
54;2021-07-25;71;50;430945;361275;59.0;49.5
54;2021-07-26;2980;4179;433925;365454;59.4;50.0
54;2021-07-27;3718;4008;437643;369462;59.9;50.6
54;2021-07-28;5211;3879;442854;373341;60.6;51.1
54;2021-07-29;5157;3209;448011;376550;61.3;51.6
54;2021-07-30;5132;5003;453143;381553;62.0;52.2
54;2021-07-31;4538;3232;457681;384785;62.7;52.7
54;2021-08-01;257;73;457938;384858;62.7;52.7
54;2021-08-02;3098;3704;461036;388562;63.1;53.2
54;2021-08-03;4109;2921;465145;391483;63.7;53.6
54;2021-08-04;4428;2707;469573;394190;64.3;54.0
54;2021-08-05;4624;2434;474197;396624;64.9;54.3
54;2021-08-06;5456;3995;479653;400619;65.7;54.8
54;2021-08-07;3676;2829;483329;403448;66.2;55.2
54;2021-08-08;248;114;483577;403562;66.2;55.3
54;2021-08-09;2980;2695;486557;406257;66.6;55.6
54;2021-08-10;2564;3769;489121;410026;67.0;56.1
54;2021-08-11;2335;2565;491456;412591;67.3;56.5
54;2021-08-12;2192;3010;493648;415601;67.6;56.9
54;2021-08-13;2633;4449;496281;420050;67.9;57.5
54;2021-08-14;1436;2077;497717;422127;68.1;57.8
54;2021-08-15;31;43;497748;422170;68.1;57.8
54;2021-08-16;1865;3433;499613;425603;68.4;58.3
54;2021-08-17;1951;3312;501564;428915;68.7;58.7
54;2021-08-18;1501;4107;503065;433022;68.9;59.3
54;2021-08-19;1258;2790;504323;435812;69.0;59.7
54;2021-08-20;1876;4932;506199;440744;69.3;60.3
54;2021-08-21;1471;4016;507670;444760;69.5;60.9
54;2021-08-22;63;28;507733;444788;69.5;60.9
54;2021-08-23;1224;3859;508957;448647;69.7;61.4
54;2021-08-24;1141;3157;510098;451804;69.8;61.9
54;2021-08-25;1427;4382;511525;456186;70.0;62.5
54;2021-08-26;1006;3111;512531;459297;70.2;62.9
54;2021-08-27;1531;5326;514062;464623;70.4;63.6
54;2021-08-28;1148;4284;515210;468907;70.5;64.2
54;2021-08-29;17;50;515227;468957;70.5;64.2
54;2021-08-30;1216;4124;516443;473081;70.7;64.8
54;2021-08-31;1072;4462;517515;477543;70.9;65.4
54;2021-09-01;1109;3400;518624;480943;71.0;65.8
54;2021-09-02;730;1982;519354;482925;71.1;66.1
54;2021-09-03;985;2976;520339;485901;71.2;66.5
54;2021-09-04;1178;3160;521517;489061;71.4;67.0
54;2021-09-05;27;22;521544;489083;71.4;67.0
54;2021-09-06;499;1354;522043;490437;71.5;67.1
54;2021-09-07;606;1465;522649;491902;71.6;67.3
54;2021-09-08;636;1687;523285;493589;71.6;67.6
54;2021-09-09;944;1754;524229;495343;71.8;67.8
54;2021-09-10;1020;2388;525249;497731;71.9;68.1
54;2021-09-11;746;2556;525995;500287;72.0;68.5
54;2021-09-12;93;116;526088;500403;72.0;68.5
54;2021-09-13;651;943;526739;501346;72.1;68.6
54;2021-09-14;624;977;527363;502323;72.2;68.8
54;2021-09-15;640;1747;528003;504070;72.3;69.0
54;2021-09-16;649;714;528652;504784;72.4;69.1
54;2021-09-17;887;1534;529539;506318;72.5;69.3
54;2021-09-18;490;1437;530029;507755;72.6;69.5
54;2021-09-19;29;38;530058;507793;72.6;69.5
54;2021-09-20;375;658;530433;508451;72.6;69.6
54;2021-09-21;447;940;530880;509391;72.7;69.7
54;2021-09-22;409;1120;531289;510511;72.7;69.9
54;2021-09-23;326;845;531615;511356;72.8;70.0
54;2021-09-24;522;1180;532137;512536;72.9;70.2
54;2021-09-25;342;1077;532479;513613;72.9;70.3
54;2021-09-26;9;30;532488;513643;72.9;70.3
54;2021-09-27;232;677;532720;514320;72.9;70.4
54;2021-09-28;340;632;533060;514952;73.0;70.5
54;2021-09-29;392;806;533452;515758;73.0;70.6
54;2021-09-30;229;467;533681;516225;73.1;70.7
54;2021-10-01;481;1011;534162;517236;73.1;70.8
54;2021-10-02;392;961;534554;518197;73.2;70.9
54;2021-10-03;2;10;534556;518207;73.2;70.9
54;2021-10-04;201;528;534757;518735;73.2;71.0
54;2021-10-05;297;943;535054;519678;73.3;71.1
54;2021-10-06;369;807;535423;520485;73.3;71.3
54;2021-10-07;269;686;535692;521171;73.3;71.4
54;2021-10-08;412;972;536104;522143;73.4;71.5
54;2021-10-09;416;733;536520;522876;73.5;71.6
54;2021-10-10;9;18;536529;522894;73.5;71.6
54;2021-10-11;262;432;536791;523326;73.5;71.6
54;2021-10-12;236;614;537027;523940;73.5;71.7
54;2021-10-13;332;525;537359;524465;73.6;71.8
54;2021-10-14;276;556;537635;525021;73.6;71.9
55;2020-12-27;0;0;0;0;0.0;0.0
55;2020-12-28;2;0;2;0;0.0;0.0
55;2020-12-29;0;0;2;0;0.0;0.0
55;2020-12-30;0;0;2;0;0.0;0.0
55;2020-12-31;0;0;2;0;0.0;0.0
55;2021-01-01;0;0;2;0;0.0;0.0
55;2021-01-02;0;0;2;0;0.0;0.0
55;2021-01-03;0;0;2;0;0.0;0.0
55;2021-01-04;1;0;3;0;0.0;0.0
55;2021-01-05;0;0;3;0;0.0;0.0
55;2021-01-06;0;0;3;0;0.0;0.0
55;2021-01-07;122;0;125;0;0.1;0.0
55;2021-01-08;127;0;252;0;0.1;0.0
55;2021-01-09;52;0;304;0;0.2;0.0
55;2021-01-10;0;0;304;0;0.2;0.0
55;2021-01-11;128;1;432;1;0.2;0.0
55;2021-01-12;119;0;551;1;0.3;0.0
55;2021-01-13;134;0;685;1;0.4;0.0
55;2021-01-14;645;8;1330;9;0.7;0.0
55;2021-01-15;237;0;1567;9;0.9;0.0
55;2021-01-16;64;0;1631;9;0.9;0.0
55;2021-01-17;1;0;1632;9;0.9;0.0
55;2021-01-18;414;1;2046;10;1.1;0.0
55;2021-01-19;352;3;2398;13;1.3;0.0
55;2021-01-20;456;2;2854;15;1.6;0.0
55;2021-01-21;430;0;3284;15;1.8;0.0
55;2021-01-22;390;0;3674;15;2.0;0.0
55;2021-01-23;49;0;3723;15;2.0;0.0
55;2021-01-24;0;0;3723;15;2.0;0.0
55;2021-01-25;436;0;4159;15;2.3;0.0
55;2021-01-26;431;0;4590;15;2.5;0.0
55;2021-01-27;424;0;5014;15;2.8;0.0
55;2021-01-28;486;97;5500;112;3.0;0.1
55;2021-01-29;159;54;5659;166;3.1;0.1
55;2021-01-30;92;28;5751;194;3.2;0.1
55;2021-01-31;0;0;5751;194;3.2;0.1
55;2021-02-01;153;176;5904;370;3.3;0.2
55;2021-02-02;159;147;6063;517;3.3;0.3
55;2021-02-03;53;156;6116;673;3.4;0.4
55;2021-02-04;236;399;6352;1072;3.5;0.6
55;2021-02-05;174;140;6526;1212;3.6;0.7
55;2021-02-06;62;56;6588;1268;3.6;0.7
55;2021-02-07;2;53;6590;1321;3.6;0.7
55;2021-02-08;0;18;6590;1339;3.6;0.7
55;2021-02-09;92;116;6682;1455;3.7;0.8
55;2021-02-10;65;23;6747;1478;3.7;0.8
55;2021-02-11;175;98;6922;1576;3.8;0.9
55;2021-02-12;95;28;7017;1604;3.9;0.9
55;2021-02-13;0;0;7017;1604;3.9;0.9
55;2021-02-14;0;0;7017;1604;3.9;0.9
55;2021-02-15;15;417;7032;2021;3.9;1.1
55;2021-02-16;143;394;7175;2415;4.0;1.3
55;2021-02-17;26;489;7201;2904;4.0;1.6
55;2021-02-18;20;341;7221;3245;4.0;1.8
55;2021-02-19;125;287;7346;3532;4.0;1.9
55;2021-02-20;11;0;7357;3532;4.1;1.9
55;2021-02-21;0;0;7357;3532;4.1;1.9
55;2021-02-22;55;458;7412;3990;4.1;2.2
55;2021-02-23;85;439;7497;4429;4.1;2.4
55;2021-02-24;72;415;7569;4844;4.2;2.7
55;2021-02-25;270;684;7839;5528;4.3;3.0
55;2021-02-26;324;236;8163;5764;4.5;3.2
55;2021-02-27;125;87;8288;5851;4.6;3.2
55;2021-02-28;2;8;8290;5859;4.6;3.2
55;2021-03-01;77;141;8367;6000;4.6;3.3
55;2021-03-02;125;170;8492;6170;4.7;3.4
55;2021-03-03;198;3;8690;6173;4.8;3.4
55;2021-03-04;238;43;8928;6216;4.9;3.4
55;2021-03-05;362;47;9290;6263;5.1;3.4
55;2021-03-06;224;6;9514;6269;5.2;3.5
55;2021-03-07;74;5;9588;6274;5.3;3.5
55;2021-03-08;329;52;9917;6326;5.5;3.5
55;2021-03-09;635;50;10552;6376;5.8;3.5
55;2021-03-10;397;26;10949;6402;6.0;3.5
55;2021-03-11;597;147;11546;6549;6.4;3.6
55;2021-03-12;817;94;12363;6643;6.8;3.7
55;2021-03-13;522;13;12885;6656;7.1;3.7
55;2021-03-14;14;0;12899;6656;7.1;3.7
55;2021-03-15;393;24;13292;6680;7.3;3.7
55;2021-03-16;568;111;13860;6791;7.6;3.7
55;2021-03-17;682;22;14542;6813;8.0;3.8
55;2021-03-18;323;23;14865;6836;8.2;3.8
55;2021-03-19;471;60;15336;6896;8.4;3.8
55;2021-03-20;254;16;15590;6912;8.6;3.8
55;2021-03-21;1;1;15591;6913;8.6;3.8
55;2021-03-22;474;21;16065;6934;8.8;3.8
55;2021-03-23;973;66;17038;7000;9.4;3.9
55;2021-03-24;802;43;17840;7043;9.8;3.9
55;2021-03-25;1097;83;18937;7126;10.4;3.9
55;2021-03-26;602;37;19539;7163;10.8;3.9
55;2021-03-27;256;23;19795;7186;10.9;4.0
55;2021-03-28;0;0;19795;7186;10.9;4.0
55;2021-03-29;944;41;20739;7227;11.4;4.0
55;2021-03-30;1425;76;22164;7303;12.2;4.0
55;2021-03-31;1483;73;23647;7376;13.0;4.1
55;2021-04-01;1207;131;24854;7507;13.7;4.1
55;2021-04-02;902;75;25756;7582;14.2;4.2
55;2021-04-03;93;12;25849;7594;14.2;4.2
55;2021-04-04;2;0;25851;7594;14.2;4.2
55;2021-04-05;6;12;25857;7606;14.2;4.2
55;2021-04-06;933;276;26790;7882;14.7;4.3
55;2021-04-07;993;240;27783;8122;15.3;4.5
55;2021-04-08;1649;421;29432;8543;16.2;4.7
55;2021-04-09;1431;263;30863;8806;17.0;4.8
55;2021-04-10;243;175;31106;8981;17.1;4.9
55;2021-04-11;452;23;31558;9004;17.4;5.0
55;2021-04-12;855;330;32413;9334;17.8;5.1
55;2021-04-13;1355;530;33768;9864;18.6;5.4
55;2021-04-14;1372;727;35140;10591;19.3;5.8
55;2021-04-15;1637;461;36777;11052;20.2;6.1
55;2021-04-16;704;379;37481;11431;20.6;6.3
55;2021-04-17;677;32;38158;11463;21.0;6.3
55;2021-04-18;38;19;38196;11482;21.0;6.3
55;2021-04-19;961;348;39157;11830;21.6;6.5
55;2021-04-20;1173;776;40330;12606;22.2;6.9
55;2021-04-21;990;641;41320;13247;22.7;7.3
55;2021-04-22;1099;683;42419;13930;23.4;7.7
55;2021-04-23;1424;600;43843;14530;24.1;8.0
55;2021-04-24;313;124;44156;14654;24.3;8.1
55;2021-04-25;384;51;44540;14705;24.5;8.1
55;2021-04-26;478;815;45018;15520;24.8;8.5
55;2021-04-27;570;996;45588;16516;25.1;9.1
55;2021-04-28;931;815;46519;17331;25.6;9.5
55;2021-04-29;1118;859;47637;18190;26.2;10.0
55;2021-04-30;1280;624;48917;18814;26.9;10.4
55;2021-05-01;153;132;49070;18946;27.0;10.4
55;2021-05-02;2;3;49072;18949;27.0;10.4
55;2021-05-03;1209;630;50281;19579;27.7;10.8
55;2021-05-04;683;1180;50964;20759;28.1;11.4
55;2021-05-05;657;1074;51621;21833;28.4;12.0
55;2021-05-06;1350;1163;52971;22996;29.2;12.7
55;2021-05-07;1433;556;54404;23552;30.0;13.0
55;2021-05-08;156;77;54560;23629;30.0;13.0
55;2021-05-09;62;523;54622;24152;30.1;13.3
55;2021-05-10;859;1030;55481;25182;30.5;13.9
55;2021-05-11;1072;1380;56553;26562;31.1;14.6
55;2021-05-12;1031;1765;57584;28327;31.7;15.6
55;2021-05-13;99;75;57683;28402;31.8;15.6
55;2021-05-14;352;556;58035;28958;32.0;15.9
55;2021-05-15;291;492;58326;29450;32.1;16.2
55;2021-05-16;3;10;58329;29460;32.1;16.2
55;2021-05-17;1028;841;59357;30301;32.7;16.7
55;2021-05-18;1567;893;60924;31194;33.5;17.2
55;2021-05-19;1809;777;62733;31971;34.5;17.6
55;2021-05-20;2215;730;64948;32701;35.8;18.0
55;2021-05-21;2010;800;66958;33501;36.9;18.4
55;2021-05-22;198;167;67156;33668;37.0;18.5
55;2021-05-23;23;120;67179;33788;37.0;18.6
55;2021-05-24;0;0;67179;33788;37.0;18.6
55;2021-05-25;1347;653;68526;34441;37.7;19.0
55;2021-05-26;1675;1018;70201;35459;38.6;19.5
55;2021-05-27;1322;983;71523;36442;39.4;20.1
55;2021-05-28;1521;930;73044;37372;40.2;20.6
55;2021-05-29;1403;698;74447;38070;41.0;21.0
55;2021-05-30;15;205;74462;38275;41.0;21.1
55;2021-05-31;1048;1130;75510;39405;41.6;21.7
55;2021-06-01;919;955;76429;40360;42.1;22.2
55;2021-06-02;1162;983;77591;41343;42.7;22.8
55;2021-06-03;703;545;78294;41888;43.1;23.1
55;2021-06-04;1388;1100;79682;42988;43.9;23.7
55;2021-06-05;1366;278;81048;43266;44.6;23.8
55;2021-06-06;0;2;81048;43268;44.6;23.8
55;2021-06-07;791;714;81839;43982;45.1;24.2
55;2021-06-08;700;1072;82539;45054;45.4;24.8
55;2021-06-09;852;872;83391;45926;45.9;25.3
55;2021-06-10;378;275;83769;46201;46.1;25.4
55;2021-06-11;528;1287;84297;47488;46.4;26.1
55;2021-06-12;761;519;85058;48007;46.8;26.4
55;2021-06-13;265;33;85323;48040;47.0;26.4
55;2021-06-14;391;1362;85714;49402;47.2;27.2
55;2021-06-15;574;1212;86288;50614;47.5;27.9
55;2021-06-16;735;832;87023;51446;47.9;28.3
55;2021-06-17;425;858;87448;52304;48.1;28.8
55;2021-06-18;667;1474;88115;53778;48.5;29.6
55;2021-06-19;593;456;88708;54234;48.8;29.9
55;2021-06-20;0;0;88708;54234;48.8;29.9
55;2021-06-21;441;1023;89149;55257;49.1;30.4
55;2021-06-22;335;1011;89484;56268;49.3;31.0
55;2021-06-23;626;1210;90110;57478;49.6;31.6
55;2021-06-24;164;433;90274;57911;49.7;31.9
55;2021-06-25;642;1227;90916;59138;50.1;32.6
55;2021-06-26;418;341;91334;59479;50.3;32.7
55;2021-06-27;1;2;91335;59481;50.3;32.7
55;2021-06-28;149;1379;91484;60860;50.4;33.5
55;2021-06-29;201;1288;91685;62148;50.5;34.2
55;2021-06-30;272;1930;91957;64078;50.6;35.3
55;2021-07-01;388;1977;92345;66055;50.8;36.4
55;2021-07-02;392;1719;92737;67774;51.1;37.3
55;2021-07-03;107;262;92844;68036;51.1;37.5
55;2021-07-04;12;19;92856;68055;51.1;37.5
55;2021-07-05;222;1508;93078;69563;51.2;38.3
55;2021-07-06;327;900;93405;70463;51.4;38.8
55;2021-07-07;389;1801;93794;72264;51.6;39.8
55;2021-07-08;535;1594;94329;73858;51.9;40.7
55;2021-07-09;457;1478;94786;75336;52.2;41.5
55;2021-07-10;356;1112;95142;76448;52.4;42.1
55;2021-07-11;0;9;95142;76457;52.4;42.1
55;2021-07-12;608;1166;95750;77623;52.7;42.7
55;2021-07-13;599;1487;96349;79110;53.0;43.6
55;2021-07-14;1;13;96350;79123;53.0;43.6
55;2021-07-15;782;1646;97132;80769;53.5;44.5
55;2021-07-16;1255;1810;98387;82579;54.2;45.5
55;2021-07-17;1284;822;99671;83401;54.9;45.9
55;2021-07-18;1;2;99672;83403;54.9;45.9
55;2021-07-19;597;785;100269;84188;55.2;46.3
55;2021-07-20;1001;1024;101270;85212;55.8;46.9
55;2021-07-21;1482;1371;102752;86583;56.6;47.7
55;2021-07-22;1174;568;103926;87151;57.2;48.0
55;2021-07-23;1113;1356;105039;88507;57.8;48.7
55;2021-07-24;819;762;105858;89269;58.3;49.1
55;2021-07-25;120;229;105978;89498;58.3;49.3
55;2021-07-26;668;444;106646;89942;58.7;49.5
55;2021-07-27;1166;479;107812;90421;59.4;49.8
55;2021-07-28;1039;1066;108851;91487;59.9;50.4
55;2021-07-29;670;446;109521;91933;60.3;50.6
55;2021-07-30;1272;966;110793;92899;61.0;51.1
55;2021-07-31;714;613;111507;93512;61.4;51.5
55;2021-08-01;9;5;111516;93517;61.4;51.5
55;2021-08-02;820;443;112336;93960;61.8;51.7
55;2021-08-03;791;419;113127;94379;62.3;52.0
55;2021-08-04;1248;951;114375;95330;63.0;52.5
55;2021-08-05;1055;324;115430;95654;63.5;52.7
55;2021-08-06;819;1096;116249;96750;64.0;53.3
55;2021-08-07;596;336;116845;97086;64.3;53.4
55;2021-08-08;0;0;116845;97086;64.3;53.4
55;2021-08-09;402;306;117247;97392;64.5;53.6
55;2021-08-10;447;776;117694;98168;64.8;54.0
55;2021-08-11;596;640;118290;98808;65.1;54.4
55;2021-08-12;327;489;118617;99297;65.3;54.7
55;2021-08-13;439;1110;119056;100407;65.5;55.3
55;2021-08-14;144;190;119200;100597;65.6;55.4
55;2021-08-15;11;5;119211;100602;65.6;55.4
55;2021-08-16;246;739;119457;101341;65.8;55.8
55;2021-08-17;259;289;119716;101630;65.9;56.0
55;2021-08-18;576;1241;120292;102871;66.2;56.6
55;2021-08-19;451;960;120743;103831;66.5;57.2
55;2021-08-20;623;1012;121366;104843;66.8;57.7
55;2021-08-21;292;772;121658;105615;67.0;58.1
55;2021-08-22;8;6;121666;105621;67.0;58.1
55;2021-08-23;357;612;122023;106233;67.2;58.5
55;2021-08-24;338;833;122361;107066;67.4;58.9
55;2021-08-25;678;1173;123039;108239;67.7;59.6
55;2021-08-26;473;1253;123512;109492;68.0;60.3
55;2021-08-27;336;1247;123848;110739;68.2;61.0
55;2021-08-28;389;578;124237;111317;68.4;61.3
55;2021-08-29;217;59;124454;111376;68.5;61.3
55;2021-08-30;175;670;124629;112046;68.6;61.7
55;2021-08-31;289;802;124918;112848;68.8;62.1
55;2021-09-01;742;1213;125660;114061;69.2;62.8
55;2021-09-02;271;820;125931;114881;69.3;63.2
55;2021-09-03;489;1046;126420;115927;69.6;63.8
55;2021-09-04;290;576;126710;116503;69.8;64.1
55;2021-09-05;18;91;126728;116594;69.8;64.2
55;2021-09-06;103;122;126831;116716;69.8;64.3
55;2021-09-07;284;402;127115;117118;70.0;64.5
55;2021-09-08;276;275;127391;117393;70.1;64.6
55;2021-09-09;199;544;127590;117937;70.2;64.9
55;2021-09-10;253;420;127843;118357;70.4;65.2
55;2021-09-11;101;281;127944;118638;70.4;65.3
55;2021-09-12;1;2;127945;118640;70.4;65.3
55;2021-09-13;103;328;128048;118968;70.5;65.5
55;2021-09-14;279;174;128327;119142;70.6;65.6
55;2021-09-15;308;638;128635;119780;70.8;65.9
55;2021-09-16;121;181;128756;119961;70.9;66.0
55;2021-09-17;90;123;128846;120084;70.9;66.1
55;2021-09-18;142;391;128988;120475;71.0;66.3
55;2021-09-19;1;59;128989;120534;71.0;66.4
55;2021-09-20;83;192;129072;120726;71.1;66.5
55;2021-09-21;100;332;129172;121058;71.1;66.6
55;2021-09-22;152;396;129324;121454;71.2;66.9
55;2021-09-23;95;427;129419;121881;71.2;67.1
55;2021-09-24;88;369;129507;122250;71.3;67.3
55;2021-09-25;57;160;129564;122410;71.3;67.4
55;2021-09-26;0;34;129564;122444;71.3;67.4
55;2021-09-27;48;129;129612;122573;71.4;67.5
55;2021-09-28;51;124;129663;122697;71.4;67.5
55;2021-09-29;157;861;129820;123558;71.5;68.0
55;2021-09-30;58;331;129878;123889;71.5;68.2
55;2021-10-01;57;274;129935;124163;71.5;68.4
55;2021-10-02;91;372;130026;124535;71.6;68.6
55;2021-10-03;0;59;130026;124594;71.6;68.6
55;2021-10-04;108;391;130134;124985;71.6;68.8
55;2021-10-05;71;259;130205;125244;71.7;69.0
55;2021-10-06;101;378;130306;125622;71.7;69.2
55;2021-10-07;58;152;130364;125774;71.8;69.2
55;2021-10-08;61;143;130425;125917;71.8;69.3
55;2021-10-09;55;240;130480;126157;71.8;69.5
55;2021-10-10;20;194;130500;126351;71.8;69.6
55;2021-10-11;70;173;130570;126524;71.9;69.7
55;2021-10-12;78;365;130648;126889;71.9;69.9
55;2021-10-13;89;165;130737;127054;72.0;69.9
55;2021-10-14;33;153;130770;127207;72.0;70.0
56;2020-12-27;0;0;0;0;0.0;0.0
56;2020-12-28;1;0;1;0;0.0;0.0
56;2020-12-29;0;0;1;0;0.0;0.0
56;2020-12-30;0;0;1;0;0.0;0.0
56;2020-12-31;0;0;1;0;0.0;0.0
56;2021-01-01;0;0;1;0;0.0;0.0
56;2021-01-02;1;0;2;0;0.0;0.0
56;2021-01-03;2;2;4;2;0.0;0.0
56;2021-01-04;2;1;6;3;0.0;0.0
56;2021-01-05;1;0;7;3;0.0;0.0
56;2021-01-06;2;0;9;3;0.0;0.0
56;2021-01-07;198;0;207;3;0.0;0.0
56;2021-01-08;119;0;326;3;0.0;0.0
56;2021-01-09;1;0;327;3;0.0;0.0
56;2021-01-10;1;0;328;3;0.0;0.0
56;2021-01-11;242;0;570;3;0.1;0.0
56;2021-01-12;755;15;1325;18;0.2;0.0
56;2021-01-13;638;1;1963;19;0.3;0.0
56;2021-01-14;971;19;2934;38;0.4;0.0
56;2021-01-15;844;5;3778;43;0.5;0.0
56;2021-01-16;235;3;4013;46;0.5;0.0
56;2021-01-17;27;0;4040;46;0.5;0.0
56;2021-01-18;1007;1;5047;47;0.7;0.0
56;2021-01-19;866;24;5913;71;0.8;0.0
56;2021-01-20;885;1;6798;72;0.9;0.0
56;2021-01-21;1450;16;8248;88;1.1;0.0
56;2021-01-22;1183;4;9431;92;1.2;0.0
56;2021-01-23;319;3;9750;95;1.3;0.0
56;2021-01-24;6;0;9756;95;1.3;0.0
56;2021-01-25;830;4;10586;99;1.4;0.0
56;2021-01-26;1034;4;11620;103;1.5;0.0
56;2021-01-27;1082;62;12702;165;1.7;0.0
56;2021-01-28;976;123;13678;288;1.8;0.0
56;2021-01-29;875;107;14553;395;1.9;0.1
56;2021-01-30;139;19;14692;414;1.9;0.1
56;2021-01-31;0;0;14692;414;1.9;0.1
56;2021-02-01;480;155;15172;569;2.0;0.1
56;2021-02-02;941;258;16113;827;2.1;0.1
56;2021-02-03;1025;270;17138;1097;2.3;0.1
56;2021-02-04;4705;360;21843;1457;2.9;0.2
56;2021-02-05;3596;436;25439;1893;3.4;0.3
56;2021-02-06;550;171;25989;2064;3.4;0.3
56;2021-02-07;136;26;26125;2090;3.5;0.3
56;2021-02-08;297;291;26422;2381;3.5;0.3
56;2021-02-09;795;506;27217;2887;3.6;0.4
56;2021-02-10;864;700;28081;3587;3.7;0.5
56;2021-02-11;973;1081;29054;4668;3.8;0.6
56;2021-02-12;1153;645;30207;5313;4.0;0.7
56;2021-02-13;220;103;30427;5416;4.0;0.7
56;2021-02-14;6;46;30433;5462;4.0;0.7
56;2021-02-15;622;1087;31055;6549;4.1;0.9
56;2021-02-16;1219;735;32274;7284;4.3;1.0
56;2021-02-17;1189;959;33463;8243;4.4;1.1
56;2021-02-18;1351;882;34814;9125;4.6;1.2
56;2021-02-19;1323;916;36137;10041;4.8;1.3
56;2021-02-20;365;259;36502;10300;4.8;1.4
56;2021-02-21;2;0;36504;10300;4.8;1.4
56;2021-02-22;376;704;36880;11004;4.9;1.5
56;2021-02-23;742;951;37622;11955;5.0;1.6
56;2021-02-24;918;1187;38540;13142;5.1;1.7
56;2021-02-25;2032;4258;40572;17400;5.4;2.3
56;2021-02-26;2356;2255;42928;19655;5.7;2.6
56;2021-02-27;748;445;43676;20100;5.8;2.7
56;2021-02-28;15;114;43691;20214;5.8;2.7
56;2021-03-01;649;559;44340;20773;5.9;2.7
56;2021-03-02;981;789;45321;21562;6.0;2.9
56;2021-03-03;1150;910;46471;22472;6.2;3.0
56;2021-03-04;1965;1040;48436;23512;6.4;3.1
56;2021-03-05;2584;1436;51020;24948;6.8;3.3
56;2021-03-06;1209;223;52229;25171;6.9;3.3
56;2021-03-07;282;24;52511;25195;6.9;3.3
56;2021-03-08;1141;395;53652;25590;7.1;3.4
56;2021-03-09;2044;633;55696;26223;7.4;3.5
56;2021-03-10;2000;939;57696;27162;7.6;3.6
56;2021-03-11;3252;744;60948;27906;8.1;3.7
56;2021-03-12;4208;834;65156;28740;8.6;3.8
56;2021-03-13;1884;151;67040;28891;8.9;3.8
56;2021-03-14;195;4;67235;28895;8.9;3.8
56;2021-03-15;1286;531;68521;29426;9.1;3.9
56;2021-03-16;1088;1029;69609;30455;9.2;4.0
56;2021-03-17;1371;778;70980;31233;9.4;4.1
56;2021-03-18;2001;1863;72981;33096;9.7;4.4
56;2021-03-19;2947;1398;75928;34494;10.0;4.6
56;2021-03-20;1492;207;77420;34701;10.2;4.6
56;2021-03-21;209;22;77629;34723;10.3;4.6
56;2021-03-22;1612;407;79241;35130;10.5;4.6
56;2021-03-23;2810;687;82051;35817;10.9;4.7
56;2021-03-24;3450;527;85501;36344;11.3;4.8
56;2021-03-25;4238;731;89739;37075;11.9;4.9
56;2021-03-26;5092;774;94831;37849;12.6;5.0
56;2021-03-27;1502;296;96333;38145;12.7;5.0
56;2021-03-28;264;11;96597;38156;12.8;5.0
56;2021-03-29;2236;507;98833;38663;13.1;5.1
56;2021-03-30;3519;787;102352;39450;13.5;5.2
56;2021-03-31;3115;723;105467;40173;14.0;5.3
56;2021-04-01;4079;827;109546;41000;14.5;5.4
56;2021-04-02;3925;954;113471;41954;15.0;5.6
56;2021-04-03;1186;270;114657;42224;15.2;5.6
56;2021-04-04;233;4;114890;42228;15.2;5.6
56;2021-04-05;245;8;115135;42236;15.2;5.6
56;2021-04-06;2828;1238;117963;43474;15.6;5.8
56;2021-04-07;4023;1196;121986;44670;16.1;5.9
56;2021-04-08;5296;1170;127282;45840;16.8;6.1
56;2021-04-09;7396;1289;134678;47129;17.8;6.2
56;2021-04-10;2576;430;137254;47559;18.2;6.3
56;2021-04-11;194;101;137448;47660;18.2;6.3
56;2021-04-12;3932;838;141380;48498;18.7;6.4
56;2021-04-13;5965;1268;147345;49766;19.5;6.6
56;2021-04-14;5168;1434;152513;51200;20.2;6.8
56;2021-04-15;7153;1779;159666;52979;21.1;7.0
56;2021-04-16;7842;2020;167508;54999;22.2;7.3
56;2021-04-17;3130;649;170638;55648;22.6;7.4
56;2021-04-18;528;110;171166;55758;22.7;7.4
56;2021-04-19;3719;1264;174885;57022;23.1;7.5
56;2021-04-20;4107;1981;178992;59003;23.7;7.8
56;2021-04-21;4059;2327;183051;61330;24.2;8.1
56;2021-04-22;5173;1928;188224;63258;24.9;8.4
56;2021-04-23;5172;2424;193396;65682;25.6;8.7
56;2021-04-24;2899;649;196295;66331;26.0;8.8
56;2021-04-25;465;149;196760;66480;26.0;8.8
56;2021-04-26;4710;1672;201470;68152;26.7;9.0
56;2021-04-27;5098;2554;206568;70706;27.3;9.4
56;2021-04-28;4966;2250;211534;72956;28.0;9.7
56;2021-04-29;5842;2944;217376;75900;28.8;10.0
56;2021-04-30;6246;2804;223622;78704;29.6;10.4
56;2021-05-01;2490;365;226112;79069;29.9;10.5
56;2021-05-02;307;254;226419;79323;30.0;10.5
56;2021-05-03;3863;2069;230282;81392;30.5;10.8
56;2021-05-04;4379;3911;234661;85303;31.1;11.3
56;2021-05-05;3522;3879;238183;89182;31.5;11.8
56;2021-05-06;4377;5447;242560;94629;32.1;12.5
56;2021-05-07;4267;5015;246827;99644;32.7;13.2
56;2021-05-08;1645;324;248472;99968;32.9;13.2
56;2021-05-09;494;227;248966;100195;33.0;13.3
56;2021-05-10;3751;3809;252717;104004;33.4;13.8
56;2021-05-11;4169;5053;256886;109057;34.0;14.4
56;2021-05-12;4342;4777;261228;113834;34.6;15.1
56;2021-05-13;2397;1014;263625;114848;34.9;15.2
56;2021-05-14;4227;4362;267852;119210;35.5;15.8
56;2021-05-15;2488;1895;270340;121105;35.8;16.0
56;2021-05-16;237;488;270577;121593;35.8;16.1
56;2021-05-17;2513;3668;273090;125261;36.1;16.6
56;2021-05-18;3522;4102;276612;129363;36.6;17.1
56;2021-05-19;3527;3398;280139;132761;37.1;17.6
56;2021-05-20;3805;4819;283944;137580;37.6;18.2
56;2021-05-21;3748;5228;287692;142808;38.1;18.9
56;2021-05-22;1696;2207;289388;145015;38.3;19.2
56;2021-05-23;284;197;289672;145212;38.3;19.2
56;2021-05-24;2058;497;291730;145709;38.6;19.3
56;2021-05-25;3141;4471;294871;150180;39.0;19.9
56;2021-05-26;3735;3938;298606;154118;39.5;20.4
56;2021-05-27;4362;4868;302968;158986;40.1;21.0
56;2021-05-28;4640;5960;307608;164946;40.7;21.8
56;2021-05-29;1886;1635;309494;166581;41.0;22.0
56;2021-05-30;318;67;309812;166648;41.0;22.1
56;2021-05-31;4502;3222;314314;169870;41.6;22.5
56;2021-06-01;5664;3386;319978;173256;42.3;22.9
56;2021-06-02;5631;2953;325609;176209;43.1;23.3
56;2021-06-03;6189;3304;331798;179513;43.9;23.8
56;2021-06-04;5814;4413;337612;183926;44.7;24.3
56;2021-06-05;4346;2385;341958;186311;45.3;24.7
56;2021-06-06;496;615;342454;186926;45.3;24.7
56;2021-06-07;5101;3172;347555;190098;46.0;25.2
56;2021-06-08;6070;3375;353625;193473;46.8;25.6
56;2021-06-09;6431;2815;360056;196288;47.7;26.0
56;2021-06-10;7479;2874;367535;199162;48.6;26.4
56;2021-06-11;6769;3867;374304;203029;49.5;26.9
56;2021-06-12;5103;2064;379407;205093;50.2;27.1
56;2021-06-13;1978;439;381385;205532;50.5;27.2
56;2021-06-14;3313;4595;384698;210127;50.9;27.8
56;2021-06-15;4201;4898;388899;215025;51.5;28.5
56;2021-06-16;4497;4504;393396;219529;52.1;29.1
56;2021-06-17;4257;4752;397653;224281;52.6;29.7
56;2021-06-18;4513;5973;402166;230254;53.2;30.5
56;2021-06-19;3832;2144;405998;232398;53.7;30.8
56;2021-06-20;1503;340;407501;232738;53.9;30.8
56;2021-06-21;3306;4462;410807;237200;54.4;31.4
56;2021-06-22;3483;5441;414290;242641;54.8;32.1
56;2021-06-23;3763;5061;418053;247702;55.3;32.8
56;2021-06-24;3478;5320;421531;253022;55.8;33.5
56;2021-06-25;3884;6281;425415;259303;56.3;34.3
56;2021-06-26;3202;2916;428617;262219;56.7;34.7
56;2021-06-27;305;163;428922;262382;56.8;34.7
56;2021-06-28;1575;3982;430497;266364;57.0;35.3
56;2021-06-29;2433;5769;432930;272133;57.3;36.0
56;2021-06-30;2499;5561;435429;277694;57.6;36.8
56;2021-07-01;2735;4960;438164;282654;58.0;37.4
56;2021-07-02;2671;6205;440835;288859;58.3;38.2
56;2021-07-03;2203;2684;443038;291543;58.6;38.6
56;2021-07-04;778;811;443816;292354;58.7;38.7
56;2021-07-05;1872;5442;445688;297796;59.0;39.4
56;2021-07-06;2190;5933;447878;303729;59.3;40.2
56;2021-07-07;2844;5642;450722;309371;59.7;40.9
56;2021-07-08;3086;6036;453808;315407;60.1;41.7
56;2021-07-09;2213;7098;456021;322505;60.4;42.7
56;2021-07-10;1126;3004;457147;325509;60.5;43.1
56;2021-07-11;256;344;457403;325853;60.5;43.1
56;2021-07-12;2181;6605;459584;332458;60.8;44.0
56;2021-07-13;3259;7467;462843;339925;61.3;45.0
56;2021-07-14;1785;2591;464628;342516;61.5;45.3
56;2021-07-15;3819;7070;468447;349586;62.0;46.3
56;2021-07-16;4076;8096;472523;357682;62.5;47.3
56;2021-07-17;2320;3525;474843;361207;62.8;47.8
56;2021-07-18;256;478;475099;361685;62.9;47.9
56;2021-07-19;2869;6359;477968;368044;63.3;48.7
56;2021-07-20;3722;7913;481690;375957;63.8;49.8
56;2021-07-21;3096;7519;484786;383476;64.2;50.8
56;2021-07-22;4391;8034;489177;391510;64.7;51.8
56;2021-07-23;4389;8413;493566;399923;65.3;52.9
56;2021-07-24;1687;4602;495253;404525;65.5;53.5
56;2021-07-25;551;1916;495804;406441;65.6;53.8
56;2021-07-26;3680;5461;499484;411902;66.1;54.5
56;2021-07-27;5375;6201;504859;418103;66.8;55.3
56;2021-07-28;4687;5465;509546;423568;67.4;56.1
56;2021-07-29;5378;5628;514924;429196;68.2;56.8
56;2021-07-30;5383;5864;520307;435060;68.9;57.6
56;2021-07-31;2158;2693;522465;437753;69.1;57.9
56;2021-08-01;1255;977;523720;438730;69.3;58.1
56;2021-08-02;4537;4600;528257;443330;69.9;58.7
56;2021-08-03;6387;4962;534644;448292;70.8;59.3
56;2021-08-04;5952;4363;540596;452655;71.5;59.9
56;2021-08-05;6097;4605;546693;457260;72.4;60.5
56;2021-08-06;5855;4925;552548;462185;73.1;61.2
56;2021-08-07;2859;2228;555407;464413;73.5;61.5
56;2021-08-08;1830;566;557237;464979;73.8;61.5
56;2021-08-09;3936;4268;561173;469247;74.3;62.1
56;2021-08-10;4928;4612;566101;473859;74.9;62.7
56;2021-08-11;4566;4138;570667;477997;75.5;63.3
56;2021-08-12;4488;4550;575155;482547;76.1;63.9
56;2021-08-13;4214;4814;579369;487361;76.7;64.5
56;2021-08-14;1793;2136;581162;489497;76.9;64.8
56;2021-08-15;348;485;581510;489982;77.0;64.8
56;2021-08-16;3066;4522;584576;494504;77.4;65.4
56;2021-08-17;3761;5056;588337;499560;77.9;66.1
56;2021-08-18;3740;4609;592077;504169;78.4;66.7
56;2021-08-19;3069;4992;595146;509161;78.8;67.4
56;2021-08-20;2905;5259;598051;514420;79.2;68.1
56;2021-08-21;1159;2399;599210;516819;79.3;68.4
56;2021-08-22;129;503;599339;517322;79.3;68.5
56;2021-08-23;1928;4969;601267;522291;79.6;69.1
56;2021-08-24;1924;5513;603191;527804;79.8;69.9
56;2021-08-25;1710;5056;604901;532860;80.1;70.5
56;2021-08-26;1409;5326;606310;538186;80.2;71.2
56;2021-08-27;1757;5878;608067;544064;80.5;72.0
56;2021-08-28;605;2802;608672;546866;80.6;72.4
56;2021-08-29;79;476;608751;547342;80.6;72.4
56;2021-08-30;1382;4627;610133;551969;80.8;73.1
56;2021-08-31;1473;4648;611606;556617;80.9;73.7
56;2021-09-01;1321;3927;612927;560544;81.1;74.2
56;2021-09-02;1086;3711;614013;564255;81.3;74.7
56;2021-09-03;1102;4240;615115;568495;81.4;75.2
56;2021-09-04;766;2340;615881;570835;81.5;75.6
56;2021-09-05;128;365;616009;571200;81.5;75.6
56;2021-09-06;885;3115;616894;574315;81.6;76.0
56;2021-09-07;820;3001;617714;577316;81.8;76.4
56;2021-09-08;967;3235;618681;580551;81.9;76.8
56;2021-09-09;800;2669;619481;583220;82.0;77.2
56;2021-09-10;942;3160;620423;586380;82.1;77.6
56;2021-09-11;474;2017;620897;588397;82.2;77.9
56;2021-09-12;34;167;620931;588564;82.2;77.9
56;2021-09-13;765;2072;621696;590636;82.3;78.2
56;2021-09-14;700;1869;622396;592505;82.4;78.4
56;2021-09-15;715;2499;623111;595004;82.5;78.7
56;2021-09-16;710;1591;623821;596595;82.6;79.0
56;2021-09-17;761;2148;624582;598743;82.7;79.2
56;2021-09-18;305;1706;624887;600449;82.7;79.5
56;2021-09-19;32;112;624919;600561;82.7;79.5
56;2021-09-20;426;1287;625345;601848;82.8;79.7
56;2021-09-21;502;1164;625847;603012;82.8;79.8
56;2021-09-22;464;1704;626311;604716;82.9;80.0
56;2021-09-23;544;1049;626855;605765;83.0;80.2
56;2021-09-24;581;1613;627436;607378;83.0;80.4
56;2021-09-25;256;1029;627692;608407;83.1;80.5
56;2021-09-26;12;79;627704;608486;83.1;80.5
56;2021-09-27;475;1000;628179;609486;83.1;80.7
56;2021-09-28;436;958;628615;610444;83.2;80.8
56;2021-09-29;387;1168;629002;611612;83.2;80.9
56;2021-09-30;333;606;629335;612218;83.3;81.0
56;2021-10-01;514;1256;629849;613474;83.4;81.2
56;2021-10-02;161;403;630010;613877;83.4;81.2
56;2021-10-03;5;77;630015;613954;83.4;81.3
56;2021-10-04;295;762;630310;614716;83.4;81.4
56;2021-10-05;239;619;630549;615335;83.5;81.4
56;2021-10-06;403;945;630952;616280;83.5;81.6
56;2021-10-07;310;880;631262;617160;83.5;81.7
56;2021-10-08;426;911;631688;618071;83.6;81.8
56;2021-10-09;152;383;631840;618454;83.6;81.9
56;2021-10-10;11;58;631851;618512;83.6;81.9
56;2021-10-11;281;620;632132;619132;83.7;81.9
56;2021-10-12;275;664;632407;619796;83.7;82.0
56;2021-10-13;226;380;632633;620176;83.7;82.1
56;2021-10-14;284;720;632917;620896;83.8;82.2
57;2020-12-27;2;0;2;0;0.0;0.0
57;2020-12-28;0;0;2;0;0.0;0.0
57;2020-12-29;3;0;5;0;0.0;0.0
57;2020-12-30;1;0;6;0;0.0;0.0
57;2020-12-31;0;0;6;0;0.0;0.0
57;2021-01-01;1;1;7;1;0.0;0.0
57;2021-01-02;3;0;10;1;0.0;0.0
57;2021-01-03;0;0;10;1;0.0;0.0
57;2021-01-04;17;0;27;1;0.0;0.0
57;2021-01-05;199;0;226;1;0.0;0.0
57;2021-01-06;226;1;452;2;0.0;0.0
57;2021-01-07;586;2;1038;4;0.1;0.0
57;2021-01-08;509;2;1547;6;0.1;0.0
57;2021-01-09;203;0;1750;6;0.2;0.0
57;2021-01-10;109;1;1859;7;0.2;0.0
57;2021-01-11;470;1;2329;8;0.2;0.0
57;2021-01-12;612;7;2941;15;0.3;0.0
57;2021-01-13;696;2;3637;17;0.4;0.0
57;2021-01-14;708;6;4345;23;0.4;0.0
57;2021-01-15;636;5;4981;28;0.5;0.0
57;2021-01-16;452;1;5433;29;0.5;0.0
57;2021-01-17;493;1;5926;30;0.6;0.0
57;2021-01-18;2717;23;8643;53;0.8;0.0
57;2021-01-19;2567;22;11210;75;1.1;0.0
57;2021-01-20;2771;23;13981;98;1.3;0.0
57;2021-01-21;1803;9;15784;107;1.5;0.0
57;2021-01-22;1325;8;17109;115;1.7;0.0
57;2021-01-23;543;15;17652;130;1.7;0.0
57;2021-01-24;1;0;17653;130;1.7;0.0
57;2021-01-25;869;186;18522;316;1.8;0.0
57;2021-01-26;1112;214;19634;530;1.9;0.1
57;2021-01-27;1070;183;20704;713;2.0;0.1
57;2021-01-28;1041;296;21745;1009;2.1;0.1
57;2021-01-29;983;392;22728;1401;2.2;0.1
57;2021-01-30;440;93;23168;1494;2.2;0.1
57;2021-01-31;11;27;23179;1521;2.2;0.1
57;2021-02-01;828;351;24007;1872;2.3;0.2
57;2021-02-02;989;363;24996;2235;2.4;0.2
57;2021-02-03;987;318;25983;2553;2.5;0.2
57;2021-02-04;1138;803;27121;3356;2.6;0.3
57;2021-02-05;929;354;28050;3710;2.7;0.4
57;2021-02-06;482;347;28532;4057;2.8;0.4
57;2021-02-07;103;336;28635;4393;2.8;0.4
57;2021-02-08;1258;1548;29893;5941;2.9;0.6
57;2021-02-09;1763;1676;31656;7617;3.1;0.7
57;2021-02-10;1711;2075;33367;9692;3.2;0.9
57;2021-02-11;1488;1326;34855;11018;3.4;1.1
57;2021-02-12;1227;677;36082;11695;3.5;1.1
57;2021-02-13;1152;179;37234;11874;3.6;1.1
57;2021-02-14;1211;28;38445;11902;3.7;1.1
57;2021-02-15;766;858;39211;12760;3.8;1.2
57;2021-02-16;1076;798;40287;13558;3.9;1.3
57;2021-02-17;1008;962;41295;14520;4.0;1.4
57;2021-02-18;976;1157;42271;15677;4.1;1.5
57;2021-02-19;956;934;43227;16611;4.2;1.6
57;2021-02-20;1172;614;44399;17225;4.3;1.7
57;2021-02-21;323;13;44722;17238;4.3;1.7
57;2021-02-22;1230;912;45952;18150;4.4;1.8
57;2021-02-23;2234;1087;48186;19237;4.7;1.9
57;2021-02-24;2287;1004;50473;20241;4.9;2.0
57;2021-02-25;3297;1128;53770;21369;5.2;2.1
57;2021-02-26;3593;962;57363;22331;5.5;2.2
57;2021-02-27;3698;543;61061;22874;5.9;2.2
57;2021-02-28;1897;62;62958;22936;6.1;2.2
57;2021-03-01;2083;1344;65041;24280;6.3;2.3
57;2021-03-02;2871;1613;67912;25893;6.6;2.5
57;2021-03-03;2836;1619;70748;27512;6.8;2.7
57;2021-03-04;3289;1303;74037;28815;7.1;2.8
57;2021-03-05;4461;1258;78498;30073;7.6;2.9
57;2021-03-06;7273;798;85771;30871;8.3;3.0
57;2021-03-07;6069;286;91840;31157;8.9;3.0
57;2021-03-08;2300;1018;94140;32175;9.1;3.1
57;2021-03-09;3414;1314;97554;33489;9.4;3.2
57;2021-03-10;3598;981;101152;34470;9.8;3.3
57;2021-03-11;4055;1267;105207;35737;10.2;3.4
57;2021-03-12;5146;1225;110353;36962;10.7;3.6
57;2021-03-13;6295;996;116648;37958;11.3;3.7
57;2021-03-14;2425;431;119073;38389;11.5;3.7
57;2021-03-15;2966;887;122039;39276;11.8;3.8
57;2021-03-16;3069;1306;125108;40582;12.1;3.9
57;2021-03-17;3053;1159;128161;41741;12.4;4.0
57;2021-03-18;3403;1088;131564;42829;12.7;4.1
57;2021-03-19;4631;1065;136195;43894;13.1;4.2
57;2021-03-20;4704;1039;140899;44933;13.6;4.3
57;2021-03-21;1897;257;142796;45190;13.8;4.4
57;2021-03-22;2481;1508;145277;46698;14.0;4.5
57;2021-03-23;3443;2370;148720;49068;14.4;4.7
57;2021-03-24;3898;2169;152618;51237;14.7;4.9
57;2021-03-25;4743;2614;157361;53851;15.2;5.2
57;2021-03-26;4841;2285;162202;56136;15.7;5.4
57;2021-03-27;3710;3170;165912;59306;16.0;5.7
57;2021-03-28;1398;1849;167310;61155;16.2;5.9
57;2021-03-29;1932;2210;169242;63365;16.3;6.1
57;2021-03-30;3303;2529;172545;65894;16.7;6.4
57;2021-03-31;2826;2339;175371;68233;16.9;6.6
57;2021-04-01;3223;3191;178594;71424;17.2;6.9
57;2021-04-02;2392;2599;180986;74023;17.5;7.1
57;2021-04-03;2565;2668;183551;76691;17.7;7.4
57;2021-04-04;596;970;184147;77661;17.8;7.5
57;2021-04-05;1922;676;186069;78337;18.0;7.6
57;2021-04-06;2453;2864;188522;81201;18.2;7.8
57;2021-04-07;3816;3139;192338;84340;18.6;8.1
57;2021-04-08;5613;2935;197951;87275;19.1;8.4
57;2021-04-09;5014;2780;202965;90055;19.6;8.7
57;2021-04-10;2353;3654;205318;93709;19.8;9.0
57;2021-04-11;1099;1892;206417;95601;19.9;9.2
57;2021-04-12;1795;2764;208212;98365;20.1;9.5
57;2021-04-13;1976;3039;210188;101404;20.3;9.8
57;2021-04-14;1922;2997;212110;104401;20.5;10.1
57;2021-04-15;2364;3435;214474;107836;20.7;10.4
57;2021-04-16;2700;3304;217174;111140;21.0;10.7
57;2021-04-17;2474;3185;219648;114325;21.2;11.0
57;2021-04-18;1241;1774;220889;116099;21.3;11.2
57;2021-04-19;2142;2260;223031;118359;21.5;11.4
57;2021-04-20;2513;2787;225544;121146;21.8;11.7
57;2021-04-21;2568;2382;228112;123528;22.0;11.9
57;2021-04-22;3209;2253;231321;125781;22.3;12.1
57;2021-04-23;4060;2586;235381;128367;22.7;12.4
57;2021-04-24;3396;2565;238777;130932;23.1;12.6
57;2021-04-25;757;1127;239534;132059;23.1;12.7
57;2021-04-26;2972;2003;242506;134062;23.4;12.9
57;2021-04-27;3898;2385;246404;136447;23.8;13.2
57;2021-04-28;4213;2596;250617;139043;24.2;13.4
57;2021-04-29;5261;3465;255878;142508;24.7;13.8
57;2021-04-30;4729;3555;260607;146063;25.2;14.1
57;2021-05-01;2356;1687;262963;147750;25.4;14.3
57;2021-05-02;790;915;263753;148665;25.5;14.4
57;2021-05-03;3561;2995;267314;151660;25.8;14.6
57;2021-05-04;4871;3176;272185;154836;26.3;14.9
57;2021-05-05;6123;3173;278308;158009;26.9;15.3
57;2021-05-06;5990;3282;284298;161291;27.4;15.6
57;2021-05-07;6852;3449;291150;164740;28.1;15.9
57;2021-05-08;4051;1605;295201;166345;28.5;16.1
57;2021-05-09;2049;1114;297250;167459;28.7;16.2
57;2021-05-10;5129;3067;302379;170526;29.2;16.5
57;2021-05-11;7453;2850;309832;173376;29.9;16.7
57;2021-05-12;7843;3248;317675;176624;30.7;17.1
57;2021-05-13;4509;915;322184;177539;31.1;17.1
57;2021-05-14;7840;2633;330024;180172;31.9;17.4
57;2021-05-15;5965;2047;335989;182219;32.4;17.6
57;2021-05-16;3307;578;339296;182797;32.8;17.6
57;2021-05-17;3867;2064;343163;184861;33.1;17.8
57;2021-05-18;6292;2105;349455;186966;33.7;18.0
57;2021-05-19;7018;2327;356473;189293;34.4;18.3
57;2021-05-20;6047;2180;362520;191473;35.0;18.5
57;2021-05-21;7563;2925;370083;194398;35.7;18.8
57;2021-05-22;4895;2171;374978;196569;36.2;19.0
57;2021-05-23;1964;430;376942;196999;36.4;19.0
57;2021-05-24;3027;1060;379969;198059;36.7;19.1
57;2021-05-25;5571;2806;385540;200865;37.2;19.4
57;2021-05-26;6375;3178;391915;204043;37.8;19.7
57;2021-05-27;5794;3124;397709;207167;38.4;20.0
57;2021-05-28;7024;4739;404733;211906;39.1;20.5
57;2021-05-29;5220;4244;409953;216150;39.6;20.9
57;2021-05-30;1968;1743;411921;217893;39.8;21.0
57;2021-05-31;4315;3340;416236;221233;40.2;21.4
57;2021-06-01;5934;3718;422170;224951;40.8;21.7
57;2021-06-02;6340;3907;428510;228858;41.4;22.1
57;2021-06-03;6209;3702;434719;232560;42.0;22.5
57;2021-06-04;7569;4993;442288;237553;42.7;22.9
57;2021-06-05;4764;4032;447052;241585;43.2;23.3
57;2021-06-06;1992;890;449044;242475;43.3;23.4
57;2021-06-07;4315;4034;453359;246509;43.8;23.8
57;2021-06-08;6721;4314;460080;250823;44.4;24.2
57;2021-06-09;6876;4156;466956;254979;45.1;24.6
57;2021-06-10;6218;4597;473174;259576;45.7;25.1
57;2021-06-11;5360;5366;478534;264942;46.2;25.6
57;2021-06-12;5741;4452;484275;269394;46.8;26.0
57;2021-06-13;1500;1142;485775;270536;46.9;26.1
57;2021-06-14;3381;4698;489156;275234;47.2;26.6
57;2021-06-15;3815;6024;492971;281258;47.6;27.2
57;2021-06-16;4400;6597;497371;287855;48.0;27.8
57;2021-06-17;4201;6073;501572;293928;48.4;28.4
57;2021-06-18;4273;7308;505845;301236;48.8;29.1
57;2021-06-19;4158;6292;510003;307528;49.2;29.7
57;2021-06-20;986;1665;510989;309193;49.3;29.8
57;2021-06-21;2065;5966;513054;315159;49.5;30.4
57;2021-06-22;2644;7987;515698;323146;49.8;31.2
57;2021-06-23;3071;8385;518769;331531;50.1;32.0
57;2021-06-24;2457;5289;521226;336820;50.3;32.5
57;2021-06-25;2856;7826;524082;344646;50.6;33.3
57;2021-06-26;2872;7258;526954;351904;50.9;34.0
57;2021-06-27;752;2985;527706;354889;50.9;34.3
57;2021-06-28;1591;5079;529297;359968;51.1;34.8
57;2021-06-29;2081;6832;531378;366800;51.3;35.4
57;2021-06-30;3069;7321;534447;374121;51.6;36.1
57;2021-07-01;2707;5957;537154;380078;51.9;36.7
57;2021-07-02;2697;8073;539851;388151;52.1;37.5
57;2021-07-03;3238;6528;543089;394679;52.4;38.1
57;2021-07-04;942;2467;544031;397146;52.5;38.3
57;2021-07-05;1713;4608;545744;401754;52.7;38.8
57;2021-07-06;2425;6480;548169;408234;52.9;39.4
57;2021-07-07;2734;7088;550903;415322;53.2;40.1
57;2021-07-08;2495;5876;553398;421198;53.4;40.7
57;2021-07-09;3424;8415;556822;429613;53.8;41.5
57;2021-07-10;3096;6943;559918;436556;54.1;42.1
57;2021-07-11;854;2233;560772;438789;54.1;42.4
57;2021-07-12;2441;6433;563213;445222;54.4;43.0
57;2021-07-13;4415;7507;567628;452729;54.8;43.7
57;2021-07-14;2823;3844;570451;456573;55.1;44.1
57;2021-07-15;3962;7790;574413;464363;55.5;44.8
57;2021-07-16;5643;9831;580056;474194;56.0;45.8
57;2021-07-17;5823;7287;585879;481481;56.6;46.5
57;2021-07-18;1491;2660;587370;484141;56.7;46.7
57;2021-07-19;2375;6201;589745;490342;56.9;47.3
57;2021-07-20;4333;6915;594078;497257;57.4;48.0
57;2021-07-21;5304;6909;599382;504166;57.9;48.7
57;2021-07-22;5982;5958;605364;510124;58.4;49.2
57;2021-07-23;7016;6407;612380;516531;59.1;49.9
57;2021-07-24;4536;7037;616916;523568;59.6;50.5
57;2021-07-25;1334;1770;618250;525338;59.7;50.7
57;2021-07-26;3724;4496;621974;529834;60.0;51.1
57;2021-07-27;6867;4954;628841;534788;60.7;51.6
57;2021-07-28;7489;4568;636330;539356;61.4;52.1
57;2021-07-29;7636;4603;643966;543959;62.2;52.5
57;2021-07-30;6874;4900;650840;548859;62.8;53.0
57;2021-07-31;5708;5025;656548;553884;63.4;53.5
57;2021-08-01;2027;1116;658575;555000;63.6;53.6
57;2021-08-02;3543;3182;662118;558182;63.9;53.9
57;2021-08-03;5804;4284;667922;562466;64.5;54.3
57;2021-08-04;5229;3464;673151;565930;65.0;54.6
57;2021-08-05;5377;3786;678528;569716;65.5;55.0
57;2021-08-06;5624;4855;684152;574571;66.0;55.5
57;2021-08-07;4586;5169;688738;579740;66.5;56.0
57;2021-08-08;1480;1507;690218;581247;66.6;56.1
57;2021-08-09;2625;3177;692843;584424;66.9;56.4
57;2021-08-10;3520;3788;696363;588212;67.2;56.8
57;2021-08-11;3726;4024;700089;592236;67.6;57.2
57;2021-08-12;3161;5217;703250;597453;67.9;57.7
57;2021-08-13;3497;4733;706747;602186;68.2;58.1
57;2021-08-14;2166;5186;708913;607372;68.4;58.6
57;2021-08-15;529;1093;709442;608465;68.5;58.7
57;2021-08-16;1791;3569;711233;612034;68.7;59.1
57;2021-08-17;2380;5355;713613;617389;68.9;59.6
57;2021-08-18;2473;5375;716086;622764;69.1;60.1
57;2021-08-19;2214;5486;718300;628250;69.3;60.6
57;2021-08-20;2058;6034;720358;634284;69.5;61.2
57;2021-08-21;1874;5395;722232;639679;69.7;61.8
57;2021-08-22;454;1530;722686;641209;69.8;61.9
57;2021-08-23;1144;3719;723830;644928;69.9;62.3
57;2021-08-24;1817;5614;725647;650542;70.1;62.8
57;2021-08-25;1619;5319;727266;655861;70.2;63.3
57;2021-08-26;1609;4674;728875;660535;70.4;63.8
57;2021-08-27;1770;5897;730645;666432;70.5;64.3
57;2021-08-28;2013;5386;732658;671818;70.7;64.9
57;2021-08-29;342;1090;733000;672908;70.8;65.0
57;2021-08-30;1033;3210;734033;676118;70.9;65.3
57;2021-08-31;1553;4295;735586;680413;71.0;65.7
57;2021-09-01;1460;3844;737046;684257;71.2;66.1
57;2021-09-02;1179;3107;738225;687364;71.3;66.4
57;2021-09-03;1569;3958;739794;691322;71.4;66.7
57;2021-09-04;1685;3743;741479;695065;71.6;67.1
57;2021-09-05;383;847;741862;695912;71.6;67.2
57;2021-09-06;773;1771;742635;697683;71.7;67.4
57;2021-09-07;706;1857;743341;699540;71.8;67.5
57;2021-09-08;941;2507;744282;702047;71.9;67.8
57;2021-09-09;614;1970;744896;704017;71.9;68.0
57;2021-09-10;1083;2471;745979;706488;72.0;68.2
57;2021-09-11;1182;2976;747161;709464;72.1;68.5
57;2021-09-12;248;491;747409;709955;72.2;68.5
57;2021-09-13;589;1350;747998;711305;72.2;68.7
57;2021-09-14;780;1703;748778;713008;72.3;68.8
57;2021-09-15;776;1994;749554;715002;72.4;69.0
57;2021-09-16;717;1229;750271;716231;72.4;69.1
57;2021-09-17;1115;1789;751386;718020;72.5;69.3
57;2021-09-18;808;2586;752194;720606;72.6;69.6
57;2021-09-19;120;346;752314;720952;72.6;69.6
57;2021-09-20;411;865;752725;721817;72.7;69.7
57;2021-09-21;509;827;753234;722644;72.7;69.8
57;2021-09-22;495;1307;753729;723951;72.8;69.9
57;2021-09-23;487;1216;754216;725167;72.8;70.0
57;2021-09-24;744;1435;754960;726602;72.9;70.1
57;2021-09-25;503;1999;755463;728601;72.9;70.3
57;2021-09-26;121;326;755584;728927;72.9;70.4
57;2021-09-27;440;845;756024;729772;73.0;70.5
57;2021-09-28;314;598;756338;730370;73.0;70.5
57;2021-09-29;557;1111;756895;731481;73.1;70.6
57;2021-09-30;289;615;757184;732096;73.1;70.7
57;2021-10-01;522;1328;757706;733424;73.1;70.8
57;2021-10-02;663;1564;758369;734988;73.2;71.0
57;2021-10-03;121;232;758490;735220;73.2;71.0
57;2021-10-04;363;618;758853;735838;73.3;71.0
57;2021-10-05;284;576;759137;736414;73.3;71.1
57;2021-10-06;456;772;759593;737186;73.3;71.2
57;2021-10-07;314;627;759907;737813;73.4;71.2
57;2021-10-08;503;1036;760410;738849;73.4;71.3
57;2021-10-09;607;1152;761017;740001;73.5;71.4
57;2021-10-10;101;121;761118;740122;73.5;71.4
57;2021-10-11;341;612;761459;740734;73.5;71.5
57;2021-10-12;303;462;761762;741196;73.5;71.6
57;2021-10-13;555;718;762317;741914;73.6;71.6
57;2021-10-14;315;483;762632;742397;73.6;71.7
58;2020-12-27;0;0;0;0;0.0;0.0
58;2020-12-28;0;0;0;0;0.0;0.0
58;2020-12-29;1;0;1;0;0.0;0.0
58;2020-12-30;0;0;1;0;0.0;0.0
58;2020-12-31;0;0;1;0;0.0;0.0
58;2021-01-01;0;0;1;0;0.0;0.0
58;2021-01-02;0;0;1;0;0.0;0.0
58;2021-01-03;1;0;2;0;0.0;0.0
58;2021-01-04;0;0;2;0;0.0;0.0
58;2021-01-05;2;0;4;0;0.0;0.0
58;2021-01-06;145;0;149;0;0.1;0.0
58;2021-01-07;241;0;390;0;0.2;0.0
58;2021-01-08;63;0;453;0;0.2;0.0
58;2021-01-09;1;0;454;0;0.2;0.0
58;2021-01-10;0;0;454;0;0.2;0.0
58;2021-01-11;55;0;509;0;0.3;0.0
58;2021-01-12;260;0;769;0;0.4;0.0
58;2021-01-13;412;4;1181;4;0.6;0.0
58;2021-01-14;292;2;1473;6;0.7;0.0
58;2021-01-15;143;0;1616;6;0.8;0.0
58;2021-01-16;10;1;1626;7;0.8;0.0
58;2021-01-17;0;0;1626;7;0.8;0.0
58;2021-01-18;414;1;2040;8;1.0;0.0
58;2021-01-19;987;3;3027;11;1.5;0.0
58;2021-01-20;1208;2;4235;13;2.1;0.0
58;2021-01-21;962;5;5197;18;2.6;0.0
58;2021-01-22;779;3;5976;21;3.0;0.0
58;2021-01-23;253;0;6229;21;3.1;0.0
58;2021-01-24;2;0;6231;21;3.1;0.0
58;2021-01-25;439;1;6670;22;3.3;0.0
58;2021-01-26;651;4;7321;26;3.7;0.0
58;2021-01-27;604;44;7925;70;4.0;0.0
58;2021-01-28;758;66;8683;136;4.4;0.1
58;2021-01-29;838;7;9521;143;4.8;0.1
58;2021-01-30;281;0;9802;143;4.9;0.1
58;2021-01-31;10;0;9812;143;4.9;0.1
58;2021-02-01;200;73;10012;216;5.0;0.1
58;2021-02-02;566;83;10578;299;5.3;0.1
58;2021-02-03;279;147;10857;446;5.4;0.2
58;2021-02-04;284;93;11141;539;5.6;0.3
58;2021-02-05;184;93;11325;632;5.7;0.3
58;2021-02-06;89;0;11414;632;5.7;0.3
58;2021-02-07;0;0;11414;632;5.7;0.3
58;2021-02-08;306;72;11720;704;5.9;0.4
58;2021-02-09;503;315;12223;1019;6.1;0.5
58;2021-02-10;350;379;12573;1398;6.3;0.7
58;2021-02-11;286;381;12859;1779;6.4;0.9
58;2021-02-12;243;204;13102;1983;6.6;1.0
58;2021-02-13;84;29;13186;2012;6.6;1.0
58;2021-02-14;0;3;13186;2015;6.6;1.0
58;2021-02-15;114;526;13300;2541;6.7;1.3
58;2021-02-16;207;937;13507;3478;6.8;1.7
58;2021-02-17;221;760;13728;4238;6.9;2.1
58;2021-02-18;186;787;13914;5025;7.0;2.5
58;2021-02-19;238;722;14152;5747;7.1;2.9
58;2021-02-20;62;228;14214;5975;7.1;3.0
58;2021-02-21;0;30;14214;6005;7.1;3.0
58;2021-02-22;78;403;14292;6408;7.2;3.2
58;2021-02-23;49;617;14341;7025;7.2;3.5
58;2021-02-24;39;628;14380;7653;7.2;3.8
58;2021-02-25;252;702;14632;8355;7.3;4.2
58;2021-02-26;246;621;14878;8976;7.5;4.5
58;2021-02-27;104;189;14982;9165;7.5;4.6
58;2021-02-28;11;8;14993;9173;7.5;4.6
58;2021-03-01;145;246;15138;9419;7.6;4.7
58;2021-03-02;415;642;15553;10061;7.8;5.0
58;2021-03-03;523;295;16076;10356;8.1;5.2
58;2021-03-04;725;279;16801;10635;8.4;5.3
58;2021-03-05;866;205;17667;10840;8.9;5.4
58;2021-03-06;577;87;18244;10927;9.1;5.5
58;2021-03-07;63;12;18307;10939;9.2;5.5
58;2021-03-08;156;300;18463;11239;9.3;5.6
58;2021-03-09;545;548;19008;11787;9.5;5.9
58;2021-03-10;841;245;19849;12032;9.9;6.0
58;2021-03-11;858;277;20707;12309;10.4;6.2
58;2021-03-12;863;201;21570;12510;10.8;6.3
58;2021-03-13;506;67;22076;12577;11.1;6.3
58;2021-03-14;34;1;22110;12578;11.1;6.3
58;2021-03-15;531;118;22641;12696;11.3;6.4
58;2021-03-16;725;224;23366;12920;11.7;6.5
58;2021-03-17;755;198;24121;13118;12.1;6.6
58;2021-03-18;584;180;24705;13298;12.4;6.7
58;2021-03-19;540;108;25245;13406;12.6;6.7
58;2021-03-20;322;64;25567;13470;12.8;6.7
58;2021-03-21;17;1;25584;13471;12.8;6.7
58;2021-03-22;796;26;26380;13497;13.2;6.8
58;2021-03-23;1636;44;28016;13541;14.0;6.8
58;2021-03-24;1371;82;29387;13623;14.7;6.8
58;2021-03-25;1840;49;31227;13672;15.6;6.8
58;2021-03-26;1414;57;32641;13729;16.4;6.9
58;2021-03-27;358;8;32999;13737;16.5;6.9
58;2021-03-28;20;0;33019;13737;16.5;6.9
58;2021-03-29;636;154;33655;13891;16.9;7.0
58;2021-03-30;1187;259;34842;14150;17.5;7.1
58;2021-03-31;1116;396;35958;14546;18.0;7.3
58;2021-04-01;1547;407;37505;14953;18.8;7.5
58;2021-04-02;1463;369;38968;15322;19.5;7.7
58;2021-04-03;568;152;39536;15474;19.8;7.8
58;2021-04-04;1;1;39537;15475;19.8;7.8
58;2021-04-05;48;0;39585;15475;19.8;7.8
58;2021-04-06;823;347;40408;15822;20.2;7.9
58;2021-04-07;697;552;41105;16374;20.6;8.2
58;2021-04-08;1493;427;42598;16801;21.3;8.4
58;2021-04-09;1775;487;44373;17288;22.2;8.7
58;2021-04-10;650;202;45023;17490;22.6;8.8
58;2021-04-11;17;3;45040;17493;22.6;8.8
58;2021-04-12;1116;504;46156;17997;23.1;9.0
58;2021-04-13;1435;630;47591;18627;23.8;9.3
58;2021-04-14;1360;700;48951;19327;24.5;9.7
58;2021-04-15;1441;613;50392;19940;25.2;10.0
58;2021-04-16;1734;516;52126;20456;26.1;10.2
58;2021-04-17;721;234;52847;20690;26.5;10.4
58;2021-04-18;20;7;52867;20697;26.5;10.4
58;2021-04-19;530;606;53397;21303;26.8;10.7
58;2021-04-20;487;1120;53884;22423;27.0;11.2
58;2021-04-21;628;970;54512;23393;27.3;11.7
58;2021-04-22;768;1525;55280;24918;27.7;12.5
58;2021-04-23;919;787;56199;25705;28.2;12.9
58;2021-04-24;211;208;56410;25913;28.3;13.0
58;2021-04-25;109;9;56519;25922;28.3;13.0
58;2021-04-26;761;247;57280;26169;28.7;13.1
58;2021-04-27;1499;1120;58779;27289;29.4;13.7
58;2021-04-28;1536;1054;60315;28343;30.2;14.2
58;2021-04-29;1444;1048;61759;29391;30.9;14.7
58;2021-04-30;1258;943;63017;30334;31.6;15.2
58;2021-05-01;6;17;63023;30351;31.6;15.2
58;2021-05-02;4;2;63027;30353;31.6;15.2
58;2021-05-03;1042;407;64069;30760;32.1;15.4
58;2021-05-04;1073;1347;65142;32107;32.6;16.1
58;2021-05-05;955;1095;66097;33202;33.1;16.6
58;2021-05-06;1363;1061;67460;34263;33.8;17.2
58;2021-05-07;1111;1092;68571;35355;34.4;17.7
58;2021-05-08;59;60;68630;35415;34.4;17.7
58;2021-05-09;7;21;68637;35436;34.4;17.8
58;2021-05-10;875;992;69512;36428;34.8;18.3
58;2021-05-11;1184;1985;70696;38413;35.4;19.2
58;2021-05-12;1660;1558;72356;39971;36.3;20.0
58;2021-05-13;49;183;72405;40154;36.3;20.1
58;2021-05-14;2311;909;74716;41063;37.4;20.6
58;2021-05-15;1726;456;76442;41519;38.3;20.8
58;2021-05-16;118;33;76560;41552;38.4;20.8
58;2021-05-17;793;611;77353;42163;38.8;21.1
58;2021-05-18;1333;1182;78686;43345;39.4;21.7
58;2021-05-19;1738;548;80424;43893;40.3;22.0
58;2021-05-20;1701;674;82125;44567;41.1;22.3
58;2021-05-21;854;730;82979;45297;41.6;22.7
58;2021-05-22;304;240;83283;45537;41.7;22.8
58;2021-05-23;2;21;83285;45558;41.7;22.8
58;2021-05-24;21;42;83306;45600;41.7;22.8
58;2021-05-25;1386;1155;84692;46755;42.4;23.4
58;2021-05-26;845;839;85537;47594;42.9;23.8
58;2021-05-27;753;943;86290;48537;43.2;24.3
58;2021-05-28;429;909;86719;49446;43.4;24.8
58;2021-05-29;151;212;86870;49658;43.5;24.9
58;2021-05-30;21;19;86891;49677;43.5;24.9
58;2021-05-31;757;398;87648;50075;43.9;25.1
58;2021-06-01;1372;1656;89020;51731;44.6;25.9
58;2021-06-02;1467;1048;90487;52779;45.3;26.4
58;2021-06-03;1024;958;91511;53737;45.8;26.9
58;2021-06-04;842;909;92353;54646;46.3;27.4
58;2021-06-05;272;263;92625;54909;46.4;27.5
58;2021-06-06;26;50;92651;54959;46.4;27.5
58;2021-06-07;712;793;93363;55752;46.8;27.9
58;2021-06-08;1321;1758;94684;57510;47.4;28.8
58;2021-06-09;1417;1008;96101;58518;48.1;29.3
58;2021-06-10;1106;982;97207;59500;48.7;29.8
58;2021-06-11;1023;907;98230;60407;49.2;30.3
58;2021-06-12;1056;415;99286;60822;49.7;30.5
58;2021-06-13;36;33;99322;60855;49.8;30.5
58;2021-06-14;516;1016;99838;61871;50.0;31.0
58;2021-06-15;1592;1757;101430;63628;50.8;31.9
58;2021-06-16;1806;994;103236;64622;51.7;32.4
58;2021-06-17;2023;1109;105259;65731;52.7;32.9
58;2021-06-18;986;1061;106245;66792;53.2;33.5
58;2021-06-19;581;320;106826;67112;53.5;33.6
58;2021-06-20;9;2;106835;67114;53.5;33.6
58;2021-06-21;472;553;107307;67667;53.8;33.9
58;2021-06-22;1028;1965;108335;69632;54.3;34.9
58;2021-06-23;1477;1511;109812;71143;55.0;35.6
58;2021-06-24;729;1024;110541;72167;55.4;36.2
58;2021-06-25;824;1719;111365;73886;55.8;37.0
58;2021-06-26;554;1228;111919;75114;56.1;37.6
58;2021-06-27;18;26;111937;75140;56.1;37.6
58;2021-06-28;463;987;112400;76127;56.3;38.1
58;2021-06-29;623;2161;113023;78288;56.6;39.2
58;2021-06-30;999;1625;114022;79913;57.1;40.0
58;2021-07-01;760;1674;114782;81587;57.5;40.9
58;2021-07-02;444;851;115226;82438;57.7;41.3
58;2021-07-03;249;512;115475;82950;57.9;41.6
58;2021-07-04;12;30;115487;82980;57.9;41.6
58;2021-07-05;510;768;115997;83748;58.1;42.0
58;2021-07-06;695;2121;116692;85869;58.5;43.0
58;2021-07-07;388;955;117080;86824;58.7;43.5
58;2021-07-08;399;1019;117479;87843;58.9;44.0
58;2021-07-09;709;1422;118188;89265;59.2;44.7
58;2021-07-10;261;412;118449;89677;59.3;44.9
58;2021-07-11;175;53;118624;89730;59.4;45.0
58;2021-07-12;197;968;118821;90698;59.5;45.4
58;2021-07-13;933;2503;119754;93201;60.0;46.7
58;2021-07-14;27;60;119781;93261;60.0;46.7
58;2021-07-15;1135;1936;120916;95197;60.6;47.7
58;2021-07-16;1411;1446;122327;96643;61.3;48.4
58;2021-07-17;463;289;122790;96932;61.5;48.6
58;2021-07-18;102;21;122892;96953;61.6;48.6
58;2021-07-19;1655;987;124547;97940;62.4;49.1
58;2021-07-20;1408;2455;125955;100395;63.1;50.3
58;2021-07-21;1178;2010;127133;102405;63.7;51.3
58;2021-07-22;1143;1670;128276;104075;64.3;52.1
58;2021-07-23;1268;1446;129544;105521;64.9;52.9
58;2021-07-24;1000;1272;130544;106793;65.4;53.5
58;2021-07-25;89;40;130633;106833;65.4;53.5
58;2021-07-26;980;860;131613;107693;65.9;54.0
58;2021-07-27;1566;2569;133179;110262;66.7;55.2
58;2021-07-28;1570;1974;134749;112236;67.5;56.2
58;2021-07-29;1581;1629;136330;113865;68.3;57.0
58;2021-07-30;1466;1427;137796;115292;69.0;57.8
58;2021-07-31;568;525;138364;115817;69.3;58.0
58;2021-08-01;35;13;138399;115830;69.3;58.0
58;2021-08-02;1589;863;139988;116693;70.1;58.5
58;2021-08-03;2051;1781;142039;118474;71.2;59.4
58;2021-08-04;1307;1185;143346;119659;71.8;60.0
58;2021-08-05;1621;1175;144967;120834;72.6;60.5
58;2021-08-06;1360;1032;146327;121866;73.3;61.1
58;2021-08-07;318;401;146645;122267;73.5;61.3
58;2021-08-08;30;58;146675;122325;73.5;61.3
58;2021-08-09;1083;1388;147758;123713;74.0;62.0
58;2021-08-10;1778;1388;149536;125101;74.9;62.7
58;2021-08-11;1134;780;150670;125881;75.5;63.1
58;2021-08-12;1067;1109;151737;126990;76.0;63.6
58;2021-08-13;930;955;152667;127945;76.5;64.1
58;2021-08-14;232;317;152899;128262;76.6;64.3
58;2021-08-15;14;27;152913;128289;76.6;64.3
58;2021-08-16;311;1402;153224;129691;76.8;65.0
58;2021-08-17;805;1337;154029;131028;77.2;65.6
58;2021-08-18;767;1171;154796;132199;77.6;66.2
58;2021-08-19;731;1342;155527;133541;77.9;66.9
58;2021-08-20;708;1298;156235;134839;78.3;67.6
58;2021-08-21;254;476;156489;135315;78.4;67.8
58;2021-08-22;9;86;156498;135401;78.4;67.8
58;2021-08-23;418;816;156916;136217;78.6;68.2
58;2021-08-24;513;1481;157429;137698;78.9;69.0
58;2021-08-25;436;1542;157865;139240;79.1;69.8
58;2021-08-26;553;1731;158418;140971;79.4;70.6
58;2021-08-27;494;1565;158912;142536;79.6;71.4
58;2021-08-28;244;640;159156;143176;79.7;71.7
58;2021-08-29;9;42;159165;143218;79.7;71.8
58;2021-08-30;356;783;159521;144001;79.9;72.1
58;2021-08-31;493;1530;160014;145531;80.2;72.9
58;2021-09-01;429;1495;160443;147026;80.4;73.7
58;2021-09-02;291;1238;160734;148264;80.5;74.3
58;2021-09-03;364;1323;161098;149587;80.7;74.9
58;2021-09-04;206;637;161304;150224;80.8;75.3
58;2021-09-05;5;27;161309;150251;80.8;75.3
58;2021-09-06;117;395;161426;150646;80.9;75.5
58;2021-09-07;320;809;161746;151455;81.0;75.9
58;2021-09-08;240;1036;161986;152491;81.2;76.4
58;2021-09-09;248;472;162234;152963;81.3;76.6
58;2021-09-10;260;680;162494;153643;81.4;77.0
58;2021-09-11;128;440;162622;154083;81.5;77.2
58;2021-09-12;5;6;162627;154089;81.5;77.2
58;2021-09-13;207;439;162834;154528;81.6;77.4
58;2021-09-14;290;664;163124;155192;81.7;77.8
58;2021-09-15;189;573;163313;155765;81.8;78.0
58;2021-09-16;205;451;163518;156216;81.9;78.3
58;2021-09-17;197;376;163715;156592;82.0;78.5
58;2021-09-18;118;362;163833;156954;82.1;78.6
58;2021-09-19;5;4;163838;156958;82.1;78.6
58;2021-09-20;174;230;164012;157188;82.2;78.8
58;2021-09-21;139;421;164151;157609;82.2;79.0
58;2021-09-22;161;535;164312;158144;82.3;79.2
58;2021-09-23;135;288;164447;158432;82.4;79.4
58;2021-09-24;113;391;164560;158823;82.4;79.6
58;2021-09-25;93;374;164653;159197;82.5;79.8
58;2021-09-26;6;13;164659;159210;82.5;79.8
58;2021-09-27;91;232;164750;159442;82.5;79.9
58;2021-09-28;126;330;164876;159772;82.6;80.0
58;2021-09-29;99;346;164975;160118;82.7;80.2
58;2021-09-30;67;217;165042;160335;82.7;80.3
58;2021-10-01;89;220;165131;160555;82.7;80.4
58;2021-10-02;85;220;165216;160775;82.8;80.6
58;2021-10-03;0;6;165216;160781;82.8;80.6
58;2021-10-04;61;204;165277;160985;82.8;80.7
58;2021-10-05;136;326;165413;161311;82.9;80.8
58;2021-10-06;65;310;165478;161621;82.9;81.0
58;2021-10-07;90;161;165568;161782;83.0;81.1
58;2021-10-08;104;225;165672;162007;83.0;81.2
58;2021-10-09;59;139;165731;162146;83.0;81.2
58;2021-10-10;3;8;165734;162154;83.0;81.2
58;2021-10-11;57;160;165791;162314;83.1;81.3
58;2021-10-12;108;212;165899;162526;83.1;81.4
58;2021-10-13;147;256;166046;162782;83.2;81.6
58;2021-10-14;67;233;166113;163015;83.2;81.7
59;2020-12-27;1;0;1;0;0.0;0.0
59;2020-12-28;27;0;28;0;0.0;0.0
59;2020-12-29;0;0;28;0;0.0;0.0
59;2020-12-30;0;0;28;0;0.0;0.0
59;2020-12-31;2;0;30;0;0.0;0.0
59;2021-01-01;3;0;33;0;0.0;0.0
59;2021-01-02;4;2;37;2;0.0;0.0
59;2021-01-03;4;0;41;2;0.0;0.0
59;2021-01-04;79;0;120;2;0.0;0.0
59;2021-01-05;217;0;337;2;0.0;0.0
59;2021-01-06;428;2;765;4;0.0;0.0
59;2021-01-07;1314;1;2079;5;0.1;0.0
59;2021-01-08;1262;10;3341;15;0.1;0.0
59;2021-01-09;608;3;3949;18;0.2;0.0
59;2021-01-10;431;1;4380;19;0.2;0.0
59;2021-01-11;1846;7;6226;26;0.2;0.0
59;2021-01-12;2489;2;8715;28;0.3;0.0
59;2021-01-13;2370;3;11085;31;0.4;0.0
59;2021-01-14;2757;28;13842;59;0.5;0.0
59;2021-01-15;2275;17;16117;76;0.6;0.0
59;2021-01-16;771;3;16888;79;0.7;0.0
59;2021-01-17;560;4;17448;83;0.7;0.0
59;2021-01-18;3512;15;20960;98;0.8;0.0
59;2021-01-19;4760;12;25720;110;1.0;0.0
59;2021-01-20;4135;13;29855;123;1.2;0.0
59;2021-01-21;4731;42;34586;165;1.3;0.0
59;2021-01-22;4026;14;38612;179;1.5;0.0
59;2021-01-23;1217;3;39829;182;1.5;0.0
59;2021-01-24;170;0;39999;182;1.5;0.0
59;2021-01-25;2730;60;42729;242;1.7;0.0
59;2021-01-26;2825;140;45554;382;1.8;0.0
59;2021-01-27;1736;307;47290;689;1.8;0.0
59;2021-01-28;3399;763;50689;1452;2.0;0.1
59;2021-01-29;2544;798;53233;2250;2.1;0.1
59;2021-01-30;288;174;53521;2424;2.1;0.1
59;2021-01-31;24;0;53545;2424;2.1;0.1
59;2021-02-01;79;863;53624;3287;2.1;0.1
59;2021-02-02;691;1464;54315;4751;2.1;0.2
59;2021-02-03;3755;1460;58070;6211;2.2;0.2
59;2021-02-04;2968;1736;61038;7947;2.4;0.3
59;2021-02-05;1071;1408;62109;9355;2.4;0.4
59;2021-02-06;208;354;62317;9709;2.4;0.4
59;2021-02-07;268;49;62585;9758;2.4;0.4
59;2021-02-08;684;1609;63269;11367;2.4;0.4
59;2021-02-09;1016;1840;64285;13207;2.5;0.5
59;2021-02-10;975;1626;65260;14833;2.5;0.6
59;2021-02-11;1349;1809;66609;16642;2.6;0.6
59;2021-02-12;1416;1645;68025;18287;2.6;0.7
59;2021-02-13;208;739;68233;19026;2.6;0.7
59;2021-02-14;14;42;68247;19068;2.6;0.7
59;2021-02-15;1397;3097;69644;22165;2.7;0.9
59;2021-02-16;1438;3758;71082;25923;2.7;1.0
59;2021-02-17;1624;3813;72706;29736;2.8;1.1
59;2021-02-18;3107;5183;75813;34919;2.9;1.3
59;2021-02-19;3208;3621;79021;38540;3.1;1.5
59;2021-02-20;1412;1584;80433;40124;3.1;1.5
59;2021-02-21;241;263;80674;40387;3.1;1.6
59;2021-02-22;1431;2565;82105;42952;3.2;1.7
59;2021-02-23;2658;2869;84763;45821;3.3;1.8
59;2021-02-24;4107;4072;88870;49893;3.4;1.9
59;2021-02-25;6921;3733;95791;53626;3.7;2.1
59;2021-02-26;6499;1896;102290;55522;4.0;2.1
59;2021-02-27;3095;194;105385;55716;4.1;2.2
59;2021-02-28;208;60;105593;55776;4.1;2.2
59;2021-03-01;3692;672;109285;56448;4.2;2.2
59;2021-03-02;4795;577;114080;57025;4.4;2.2
59;2021-03-03;5749;1020;119829;58045;4.6;2.2
59;2021-03-04;7086;967;126915;59012;4.9;2.3
59;2021-03-05;7841;1015;134756;60027;5.2;2.3
59;2021-03-06;11562;565;146318;60592;5.7;2.3
59;2021-03-07;7586;362;153904;60954;5.9;2.4
59;2021-03-08;4498;1122;158402;62076;6.1;2.4
59;2021-03-09;6578;1455;164980;63531;6.4;2.5
59;2021-03-10;7027;1218;172007;64749;6.6;2.5
59;2021-03-11;9474;1910;181481;66659;7.0;2.6
59;2021-03-12;12159;1585;193640;68244;7.5;2.6
59;2021-03-13;16559;1132;210199;69376;8.1;2.7
59;2021-03-14;6964;343;217163;69719;8.4;2.7
59;2021-03-15;5613;1513;222776;71232;8.6;2.8
59;2021-03-16;3740;1341;226516;72573;8.7;2.8
59;2021-03-17;3856;2106;230372;74679;8.9;2.9
59;2021-03-18;3958;2517;234330;77196;9.1;3.0
59;2021-03-19;7744;1844;242074;79040;9.4;3.1
59;2021-03-20;16022;1300;258096;80340;10.0;3.1
59;2021-03-21;6319;458;264415;80798;10.2;3.1
59;2021-03-22;5449;1789;269864;82587;10.4;3.2
59;2021-03-23;7773;2838;277637;85425;10.7;3.3
59;2021-03-24;6860;2995;284497;88420;11.0;3.4
59;2021-03-25;10535;2589;295032;91009;11.4;3.5
59;2021-03-26;12254;2864;307286;93873;11.9;3.6
59;2021-03-27;15275;1170;322561;95043;12.5;3.7
59;2021-03-28;7985;367;330546;95410;12.8;3.7
59;2021-03-29;5494;3214;336040;98624;13.0;3.8
59;2021-03-30;7540;3765;343580;102389;13.3;4.0
59;2021-03-31;6157;4124;349737;106513;13.5;4.1
59;2021-04-01;7494;4932;357231;111445;13.8;4.3
59;2021-04-02;7645;5532;364876;116977;14.1;4.5
59;2021-04-03;13018;4316;377894;121293;14.6;4.7
59;2021-04-04;5348;2192;383242;123485;14.8;4.8
59;2021-04-05;6021;1545;389263;125030;15.0;4.8
59;2021-04-06;5404;4506;394667;129536;15.2;5.0
59;2021-04-07;7624;5459;402291;134995;15.5;5.2
59;2021-04-08;10393;5785;412684;140780;15.9;5.4
59;2021-04-09;13422;5957;426106;146737;16.5;5.7
59;2021-04-10;11478;6158;437584;152895;16.9;5.9
59;2021-04-11;4636;3570;442220;156465;17.1;6.0
59;2021-04-12;6304;4354;448524;160819;17.3;6.2
59;2021-04-13;8934;4807;457458;165626;17.7;6.4
59;2021-04-14;8789;4350;466247;169976;18.0;6.6
59;2021-04-15;10306;4863;476553;174839;18.4;6.8
59;2021-04-16;10880;5509;487433;180348;18.8;7.0
59;2021-04-17;7296;9086;494729;189434;19.1;7.3
59;2021-04-18;3234;4175;497963;193609;19.2;7.5
59;2021-04-19;5044;4302;503007;197911;19.4;7.6
59;2021-04-20;6898;4226;509905;202137;19.7;7.8
59;2021-04-21;6271;4438;516176;206575;19.9;8.0
59;2021-04-22;8612;5527;524788;212102;20.3;8.2
59;2021-04-23;8457;5709;533245;217811;20.6;8.4
59;2021-04-24;5537;8066;538782;225877;20.8;8.7
59;2021-04-25;3242;6081;542024;231958;20.9;9.0
59;2021-04-26;6493;3801;548517;235759;21.2;9.1
59;2021-04-27;8367;5209;556884;240968;21.5;9.3
59;2021-04-28;8766;6585;565650;247553;21.8;9.6
59;2021-04-29;9418;8588;575068;256141;22.2;9.9
59;2021-04-30;10608;8564;585676;264705;22.6;10.2
59;2021-05-01;11998;7610;597674;272315;23.1;10.5
59;2021-05-02;8642;6001;606316;278316;23.4;10.7
59;2021-05-03;9554;5073;615870;283389;23.8;10.9
59;2021-05-04;11427;6019;627297;289408;24.2;11.2
59;2021-05-05;10294;6229;637591;295637;24.6;11.4
59;2021-05-06;11198;8467;648789;304104;25.1;11.7
59;2021-05-07;13297;9636;662086;313740;25.6;12.1
59;2021-05-08;14742;4181;676828;317921;26.1;12.3
59;2021-05-09;11492;3336;688320;321257;26.6;12.4
59;2021-05-10;12746;6660;701066;327917;27.1;12.7
59;2021-05-11;15111;8335;716177;336252;27.7;13.0
59;2021-05-12;16626;8653;732803;344905;28.3;13.3
59;2021-05-13;18441;3462;751244;348367;29.0;13.5
59;2021-05-14;15783;6971;767027;355338;29.6;13.7
59;2021-05-15;23444;5295;790471;360633;30.5;13.9
59;2021-05-16;21176;2417;811647;363050;31.3;14.0
59;2021-05-17;15066;5274;826713;368324;31.9;14.2
59;2021-05-18;16925;5678;843638;374002;32.6;14.4
59;2021-05-19;18319;5114;861957;379116;33.3;14.6
59;2021-05-20;17934;6997;879891;386113;34.0;14.9
59;2021-05-21;18370;8286;898261;394399;34.7;15.2
59;2021-05-22;23812;5687;922073;400086;35.6;15.5
59;2021-05-23;17922;2276;939995;402362;36.3;15.5
59;2021-05-24;16691;2145;956686;404507;37.0;15.6
59;2021-05-25;14990;6674;971676;411181;37.5;15.9
59;2021-05-26;15894;7046;987570;418227;38.1;16.2
59;2021-05-27;16151;9177;1003721;427404;38.8;16.5
59;2021-05-28;15885;11475;1019606;438879;39.4;17.0
59;2021-05-29;14370;8713;1033976;447592;39.9;17.3
59;2021-05-30;8406;1840;1042382;449432;40.3;17.4
59;2021-05-31;14203;7978;1056585;457410;40.8;17.7
59;2021-06-01;15085;10422;1071670;467832;41.4;18.1
59;2021-06-02;14769;9933;1086439;477765;42.0;18.5
59;2021-06-03;15630;12139;1102069;489904;42.6;18.9
59;2021-06-04;15608;13478;1117677;503382;43.2;19.4
59;2021-06-05;14979;9347;1132656;512729;43.7;19.8
59;2021-06-06;8827;3207;1141483;515936;44.1;19.9
59;2021-06-07;10527;9435;1152010;525371;44.5;20.3
59;2021-06-08;11760;11090;1163770;536461;45.0;20.7
59;2021-06-09;10758;11913;1174528;548374;45.4;21.2
59;2021-06-10;11504;12330;1186032;560704;45.8;21.7
59;2021-06-11;10972;15994;1197004;576698;46.2;22.3
59;2021-06-12;11069;13685;1208073;590383;46.7;22.8
59;2021-06-13;6344;7029;1214417;597412;46.9;23.1
59;2021-06-14;6506;12692;1220923;610104;47.2;23.6
59;2021-06-15;8230;15955;1229153;626059;47.5;24.2
59;2021-06-16;9205;13553;1238358;639612;47.8;24.7
59;2021-06-17;9187;15659;1247545;655271;48.2;25.3
59;2021-06-18;9081;20067;1256626;675338;48.5;26.1
59;2021-06-19;8953;17491;1265579;692829;48.9;26.8
59;2021-06-20;4900;10189;1270479;703018;49.1;27.2
59;2021-06-21;5279;15975;1275758;718993;49.3;27.8
59;2021-06-22;6336;18687;1282094;737680;49.5;28.5
59;2021-06-23;6168;19084;1288262;756764;49.8;29.2
59;2021-06-24;7338;20540;1295600;777304;50.0;30.0
59;2021-06-25;6508;21196;1302108;798500;50.3;30.8
59;2021-06-26;6489;23751;1308597;822251;50.5;31.8
59;2021-06-27;4752;17079;1313349;839330;50.7;32.4
59;2021-06-28;5004;19823;1318353;859153;50.9;33.2
59;2021-06-29;5549;20384;1323902;879537;51.1;34.0
59;2021-06-30;6133;20098;1330035;899635;51.4;34.7
59;2021-07-01;6772;20842;1336807;920477;51.6;35.6
59;2021-07-02;6836;23241;1343643;943718;51.9;36.5
59;2021-07-03;5562;24607;1349205;968325;52.1;37.4
59;2021-07-04;4415;15975;1353620;984300;52.3;38.0
59;2021-07-05;5672;17486;1359292;1001786;52.5;38.7
59;2021-07-06;6610;18801;1365902;1020587;52.8;39.4
59;2021-07-07;6940;17452;1372842;1038039;53.0;40.1
59;2021-07-08;8026;17699;1380868;1055738;53.3;40.8
59;2021-07-09;7705;20304;1388573;1076042;53.6;41.6
59;2021-07-10;7450;18539;1396023;1094581;53.9;42.3
59;2021-07-11;4448;10233;1400471;1104814;54.1;42.7
59;2021-07-12;5919;18048;1406390;1122862;54.3;43.4
59;2021-07-13;9910;20759;1416300;1143621;54.7;44.2
59;2021-07-14;9782;8456;1426082;1152077;55.1;44.5
59;2021-07-15;11638;20410;1437720;1172487;55.5;45.3
59;2021-07-16;13216;20514;1450936;1193001;56.0;46.1
59;2021-07-17;12398;17475;1463334;1210476;56.5;46.8
59;2021-07-18;7962;8684;1471296;1219160;56.8;47.1
59;2021-07-19;10404;16455;1481700;1235615;57.2;47.7
59;2021-07-20;13409;17127;1495109;1252742;57.7;48.4
59;2021-07-21;14528;15606;1509637;1268348;58.3;49.0
59;2021-07-22;17064;15226;1526701;1283574;59.0;49.6
59;2021-07-23;15729;15844;1542430;1299418;59.6;50.2
59;2021-07-24;16357;12314;1558787;1311732;60.2;50.7
59;2021-07-25;11916;7341;1570703;1319073;60.7;50.9
59;2021-07-26;13041;12625;1583744;1331698;61.2;51.4
59;2021-07-27;16229;11972;1599973;1343670;61.8;51.9
59;2021-07-28;17457;11680;1617430;1355350;62.5;52.4
59;2021-07-29;17423;11683;1634853;1367033;63.1;52.8
59;2021-07-30;15922;11621;1650775;1378654;63.8;53.3
59;2021-07-31;14022;9210;1664797;1387864;64.3;53.6
59;2021-08-01;9959;4575;1674756;1392439;64.7;53.8
59;2021-08-02;12215;10035;1686971;1402474;65.2;54.2
59;2021-08-03;13454;10061;1700425;1412535;65.7;54.6
59;2021-08-04;11240;8292;1711665;1420827;66.1;54.9
59;2021-08-05;12723;9795;1724388;1430622;66.6;55.3
59;2021-08-06;12561;11047;1736949;1441669;67.1;55.7
59;2021-08-07;9739;9300;1746688;1450969;67.5;56.0
59;2021-08-08;6960;5269;1753648;1456238;67.7;56.2
59;2021-08-09;8411;10831;1762059;1467069;68.1;56.7
59;2021-08-10;10405;10757;1772464;1477826;68.5;57.1
59;2021-08-11;8676;9323;1781140;1487149;68.8;57.4
59;2021-08-12;9004;12078;1790144;1499227;69.1;57.9
59;2021-08-13;8638;11753;1798782;1510980;69.5;58.4
59;2021-08-14;5953;10394;1804735;1521374;69.7;58.8
59;2021-08-15;3377;4666;1808112;1526040;69.8;58.9
59;2021-08-16;5878;13868;1813990;1539908;70.1;59.5
59;2021-08-17;6993;12767;1820983;1552675;70.3;60.0
59;2021-08-18;5956;11470;1826939;1564145;70.6;60.4
59;2021-08-19;6355;13875;1833294;1578020;70.8;61.0
59;2021-08-20;5837;14589;1839131;1592609;71.0;61.5
59;2021-08-21;4188;10296;1843319;1602905;71.2;61.9
59;2021-08-22;2852;7651;1846171;1610556;71.3;62.2
59;2021-08-23;4785;15733;1850956;1626289;71.5;62.8
59;2021-08-24;5302;15194;1856258;1641483;71.7;63.4
59;2021-08-25;4667;13087;1860925;1654570;71.9;63.9
59;2021-08-26;5211;14349;1866136;1668919;72.1;64.5
59;2021-08-27;5009;15432;1871145;1684351;72.3;65.1
59;2021-08-28;3808;12372;1874953;1696723;72.4;65.5
59;2021-08-29;1946;8436;1876899;1705159;72.5;65.9
59;2021-08-30;3896;12671;1880795;1717830;72.6;66.4
59;2021-08-31;3831;12398;1884626;1730228;72.8;66.8
59;2021-09-01;3316;9770;1887942;1739998;72.9;67.2
59;2021-09-02;3216;9909;1891158;1749907;73.0;67.6
59;2021-09-03;3830;10907;1894988;1760814;73.2;68.0
59;2021-09-04;3398;9395;1898386;1770209;73.3;68.4
59;2021-09-05;1242;3454;1899628;1773663;73.4;68.5
59;2021-09-06;2161;6203;1901789;1779866;73.5;68.7
59;2021-09-07;2263;6031;1904052;1785897;73.5;69.0
59;2021-09-08;2600;6547;1906652;1792444;73.6;69.2
59;2021-09-09;2446;5734;1909098;1798178;73.7;69.5
59;2021-09-10;3325;6795;1912423;1804973;73.9;69.7
59;2021-09-11;2600;7022;1915023;1811995;74.0;70.0
59;2021-09-12;914;2785;1915937;1814780;74.0;70.1
59;2021-09-13;1956;4262;1917893;1819042;74.1;70.3
59;2021-09-14;2349;4273;1920242;1823315;74.2;70.4
59;2021-09-15;2279;5367;1922521;1828682;74.3;70.6
59;2021-09-16;2187;4260;1924708;1832942;74.3;70.8
59;2021-09-17;2931;5457;1927639;1838399;74.5;71.0
59;2021-09-18;1788;5919;1929427;1844318;74.5;71.2
59;2021-09-19;384;1302;1929811;1845620;74.5;71.3
59;2021-09-20;1361;3301;1931172;1848921;74.6;71.4
59;2021-09-21;1338;2940;1932510;1851861;74.6;71.5
59;2021-09-22;1417;4741;1933927;1856602;74.7;71.7
59;2021-09-23;1522;2824;1935449;1859426;74.8;71.8
59;2021-09-24;1902;4241;1937351;1863667;74.8;72.0
59;2021-09-25;1156;4021;1938507;1867688;74.9;72.1
59;2021-09-26;314;1209;1938821;1868897;74.9;72.2
59;2021-09-27;1089;2534;1939910;1871431;74.9;72.3
59;2021-09-28;1076;2196;1940986;1873627;75.0;72.4
59;2021-09-29;1289;2959;1942275;1876586;75.0;72.5
59;2021-09-30;1240;2262;1943515;1878848;75.1;72.6
59;2021-10-01;1678;3394;1945193;1882242;75.1;72.7
59;2021-10-02;1465;3258;1946658;1885500;75.2;72.8
59;2021-10-03;263;632;1946921;1886132;75.2;72.9
59;2021-10-04;1079;1983;1948000;1888115;75.2;72.9
59;2021-10-05;1152;2169;1949152;1890284;75.3;73.0
59;2021-10-06;1260;2503;1950412;1892787;75.3;73.1
59;2021-10-07;975;1777;1951387;1894564;75.4;73.2
59;2021-10-08;1691;3306;1953078;1897870;75.4;73.3
59;2021-10-09;1313;2306;1954391;1900176;75.5;73.4
59;2021-10-10;284;450;1954675;1900626;75.5;73.4
59;2021-10-11;1038;1622;1955713;1902248;75.5;73.5
59;2021-10-12;1091;1677;1956804;1903925;75.6;73.5
59;2021-10-13;1216;1890;1958020;1905815;75.6;73.6
59;2021-10-14;944;1511;1958964;1907326;75.7;73.7
60;2020-12-27;0;0;0;0;0.0;0.0
60;2020-12-28;0;0;0;0;0.0;0.0
60;2020-12-29;1;0;1;0;0.0;0.0
60;2020-12-30;1;0;2;0;0.0;0.0
60;2020-12-31;0;0;2;0;0.0;0.0
60;2021-01-01;0;0;2;0;0.0;0.0
60;2021-01-02;5;0;7;0;0.0;0.0
60;2021-01-03;1;0;8;0;0.0;0.0
60;2021-01-04;1;0;9;0;0.0;0.0
60;2021-01-05;37;0;46;0;0.0;0.0
60;2021-01-06;188;4;234;4;0.0;0.0
60;2021-01-07;235;4;469;8;0.1;0.0
60;2021-01-08;380;4;849;12;0.1;0.0
60;2021-01-09;3;0;852;12;0.1;0.0
60;2021-01-10;60;0;912;12;0.1;0.0
60;2021-01-11;345;5;1257;17;0.2;0.0
60;2021-01-12;537;5;1794;22;0.2;0.0
60;2021-01-13;477;6;2271;28;0.3;0.0
60;2021-01-14;509;7;2780;35;0.3;0.0
60;2021-01-15;705;10;3485;45;0.4;0.0
60;2021-01-16;123;1;3608;46;0.4;0.0
60;2021-01-17;32;0;3640;46;0.4;0.0
60;2021-01-18;861;9;4501;55;0.5;0.0
60;2021-01-19;1207;14;5708;69;0.7;0.0
60;2021-01-20;1721;15;7429;84;0.9;0.0
60;2021-01-21;2266;14;9695;98;1.2;0.0
60;2021-01-22;1548;23;11243;121;1.4;0.0
60;2021-01-23;499;4;11742;125;1.4;0.0
60;2021-01-24;61;1;11803;126;1.4;0.0
60;2021-01-25;898;15;12701;141;1.5;0.0
60;2021-01-26;951;17;13652;158;1.7;0.0
60;2021-01-27;646;9;14298;167;1.7;0.0
60;2021-01-28;396;168;14694;335;1.8;0.0
60;2021-01-29;77;106;14771;441;1.8;0.1
60;2021-01-30;0;1;14771;442;1.8;0.1
60;2021-01-31;22;61;14793;503;1.8;0.1
60;2021-02-01;42;105;14835;608;1.8;0.1
60;2021-02-02;26;159;14861;767;1.8;0.1
60;2021-02-03;165;238;15026;1005;1.8;0.1
60;2021-02-04;170;339;15196;1344;1.8;0.2
60;2021-02-05;314;471;15510;1815;1.9;0.2
60;2021-02-06;65;79;15575;1894;1.9;0.2
60;2021-02-07;31;32;15606;1926;1.9;0.2
60;2021-02-08;330;516;15936;2442;1.9;0.3
60;2021-02-09;321;468;16257;2910;2.0;0.4
60;2021-02-10;557;993;16814;3903;2.0;0.5
60;2021-02-11;944;1132;17758;5035;2.2;0.6
60;2021-02-12;921;860;18679;5895;2.3;0.7
60;2021-02-13;92;309;18771;6204;2.3;0.8
60;2021-02-14;25;87;18796;6291;2.3;0.8
60;2021-02-15;614;805;19410;7096;2.4;0.9
60;2021-02-16;580;921;19990;8017;2.4;1.0
60;2021-02-17;632;934;20622;8951;2.5;1.1
60;2021-02-18;684;826;21306;9777;2.6;1.2
60;2021-02-19;641;763;21947;10540;2.7;1.3
60;2021-02-20;104;187;22051;10727;2.7;1.3
60;2021-02-21;23;121;22074;10848;2.7;1.3
60;2021-02-22;461;871;22535;11719;2.7;1.4
60;2021-02-23;535;784;23070;12503;2.8;1.5
60;2021-02-24;794;556;23864;13059;2.9;1.6
60;2021-02-25;1095;313;24959;13372;3.0;1.6
60;2021-02-26;1299;199;26258;13571;3.2;1.6
60;2021-02-27;669;35;26927;13606;3.3;1.6
60;2021-02-28;7;10;26934;13616;3.3;1.7
60;2021-03-01;895;50;27829;13666;3.4;1.7
60;2021-03-02;1012;169;28841;13835;3.5;1.7
60;2021-03-03;1324;460;30165;14295;3.7;1.7
60;2021-03-04;1726;528;31891;14823;3.9;1.8
60;2021-03-05;1823;304;33714;15127;4.1;1.8
60;2021-03-06;1920;151;35634;15278;4.3;1.9
60;2021-03-07;885;40;36519;15318;4.4;1.9
60;2021-03-08;980;319;37499;15637;4.5;1.9
60;2021-03-09;1643;364;39142;16001;4.7;1.9
60;2021-03-10;1938;436;41080;16437;5.0;2.0
60;2021-03-11;2325;390;43405;16827;5.3;2.0
60;2021-03-12;2597;555;46002;17382;5.6;2.1
60;2021-03-13;3838;218;49840;17600;6.0;2.1
60;2021-03-14;1782;65;51622;17665;6.3;2.1
60;2021-03-15;2093;507;53715;18172;6.5;2.2
60;2021-03-16;1584;633;55299;18805;6.7;2.3
60;2021-03-17;1658;626;56957;19431;6.9;2.4
60;2021-03-18;1760;743;58717;20174;7.1;2.4
60;2021-03-19;2591;534;61308;20708;7.4;2.5
60;2021-03-20;3241;202;64549;20910;7.8;2.5
60;2021-03-21;2124;99;66673;21009;8.1;2.5
60;2021-03-22;2132;721;68805;21730;8.3;2.6
60;2021-03-23;3309;732;72114;22462;8.7;2.7
60;2021-03-24;3070;881;75184;23343;9.1;2.8
60;2021-03-25;3848;863;79032;24206;9.6;2.9
60;2021-03-26;4218;883;83250;25089;10.1;3.0
60;2021-03-27;4141;329;87391;25418;10.6;3.1
60;2021-03-28;2450;87;89841;25505;10.9;3.1
60;2021-03-29;2612;1091;92453;26596;11.2;3.2
60;2021-03-30;3286;1081;95739;27677;11.6;3.4
60;2021-03-31;2669;1152;98408;28829;11.9;3.5
60;2021-04-01;2562;1105;100970;29934;12.2;3.6
60;2021-04-02;3310;1115;104280;31049;12.6;3.8
60;2021-04-03;3172;1019;107452;32068;13.0;3.9
60;2021-04-04;874;488;108326;32556;13.1;3.9
60;2021-04-05;458;85;108784;32641;13.2;4.0
60;2021-04-06;1969;1626;110753;34267;13.4;4.2
60;2021-04-07;1984;1759;112737;36026;13.7;4.4
60;2021-04-08;2610;1503;115347;37529;14.0;4.5
60;2021-04-09;2999;1532;118346;39061;14.3;4.7
60;2021-04-10;2927;1594;121273;40655;14.7;4.9
60;2021-04-11;1045;1002;122318;41657;14.8;5.0
60;2021-04-12;2044;1725;124362;43382;15.1;5.3
60;2021-04-13;2750;1790;127112;45172;15.4;5.5
60;2021-04-14;3144;1831;130256;47003;15.8;5.7
60;2021-04-15;3561;1903;133817;48906;16.2;5.9
60;2021-04-16;3288;1962;137105;50868;16.6;6.2
60;2021-04-17;2848;2177;139953;53045;17.0;6.4
60;2021-04-18;573;1834;140526;54879;17.0;6.7
60;2021-04-19;1743;2218;142269;57097;17.2;6.9
60;2021-04-20;2129;2679;144398;59776;17.5;7.2
60;2021-04-21;2653;2212;147051;61988;17.8;7.5
60;2021-04-22;2628;2514;149679;64502;18.1;7.8
60;2021-04-23;2651;2507;152330;67009;18.5;8.1
60;2021-04-24;2470;3461;154800;70470;18.8;8.5
60;2021-04-25;1159;1965;155959;72435;18.9;8.8
60;2021-04-26;1890;2537;157849;74972;19.1;9.1
60;2021-04-27;2312;2853;160161;77825;19.4;9.4
60;2021-04-28;3061;2403;163222;80228;19.8;9.7
60;2021-04-29;3153;2629;166375;82857;20.2;10.0
60;2021-04-30;3459;2969;169834;85826;20.6;10.4
60;2021-05-01;2353;1127;172187;86953;20.9;10.5
60;2021-05-02;2147;847;174334;87800;21.1;10.6
60;2021-05-03;2955;1861;177289;89661;21.5;10.9
60;2021-05-04;3016;2361;180305;92022;21.9;11.2
60;2021-05-05;3260;2812;183565;94834;22.2;11.5
60;2021-05-06;3648;2486;187213;97320;22.7;11.8
60;2021-05-07;3986;2528;191199;99848;23.2;12.1
60;2021-05-08;3582;973;194781;100821;23.6;12.2
60;2021-05-09;3458;959;198239;101780;24.0;12.3
60;2021-05-10;2392;2295;200631;104075;24.3;12.6
60;2021-05-11;3672;2472;204303;106547;24.8;12.9
60;2021-05-12;4717;2558;209020;109105;25.3;13.2
60;2021-05-13;5292;1131;214312;110236;26.0;13.4
60;2021-05-14;5602;1811;219914;112047;26.7;13.6
60;2021-05-15;6172;1721;226086;113768;27.4;13.8
60;2021-05-16;4858;690;230944;114458;28.0;13.9
60;2021-05-17;3715;1673;234659;116131;28.4;14.1
60;2021-05-18;4046;2078;238705;118209;28.9;14.3
60;2021-05-19;5097;1857;243802;120066;29.5;14.6
60;2021-05-20;5460;1814;249262;121880;30.2;14.8
60;2021-05-21;5969;1974;255231;123854;30.9;15.0
60;2021-05-22;5354;1982;260585;125836;31.6;15.3
60;2021-05-23;4263;658;264848;126494;32.1;15.3
60;2021-05-24;2950;534;267798;127028;32.5;15.4
60;2021-05-25;4136;2005;271934;129033;33.0;15.6
60;2021-05-26;4466;1833;276400;130866;33.5;15.9
60;2021-05-27;4611;1998;281011;132864;34.1;16.1
60;2021-05-28;4626;2508;285637;135372;34.6;16.4
60;2021-05-29;4612;2275;290249;137647;35.2;16.7
60;2021-05-30;1086;348;291335;137995;35.3;16.7
60;2021-05-31;3832;2085;295167;140080;35.8;17.0
60;2021-06-01;4445;2854;299612;142934;36.3;17.3
60;2021-06-02;3916;2449;303528;145383;36.8;17.6
60;2021-06-03;3904;2382;307432;147765;37.3;17.9
60;2021-06-04;4652;2910;312084;150675;37.8;18.3
60;2021-06-05;4302;3419;316386;154094;38.3;18.7
60;2021-06-06;2159;795;318545;154889;38.6;18.8
60;2021-06-07;2778;2763;321323;157652;38.9;19.1
60;2021-06-08;3802;3012;325125;160664;39.4;19.5
60;2021-06-09;3249;3402;328374;164066;39.8;19.9
60;2021-06-10;3454;3368;331828;167434;40.2;20.3
60;2021-06-11;3881;4194;335709;171628;40.7;20.8
60;2021-06-12;3780;4282;339489;175910;41.1;21.3
60;2021-06-13;1154;2225;340643;178135;41.3;21.6
60;2021-06-14;1911;3307;342554;181442;41.5;22.0
60;2021-06-15;3015;4165;345569;185607;41.9;22.5
60;2021-06-16;3250;4488;348819;190095;42.3;23.0
60;2021-06-17;2978;4784;351797;194879;42.6;23.6
60;2021-06-18;2982;4606;354779;199485;43.0;24.2
60;2021-06-19;3144;4728;357923;204213;43.4;24.8
60;2021-06-20;1431;1936;359354;206149;43.6;25.0
60;2021-06-21;1408;4042;360762;210191;43.7;25.5
60;2021-06-22;1758;5293;362520;215484;43.9;26.1
60;2021-06-23;1860;5237;364380;220721;44.2;26.8
60;2021-06-24;1803;5601;366183;226322;44.4;27.4
60;2021-06-25;1907;5730;368090;232052;44.6;28.1
60;2021-06-26;1860;6973;369950;239025;44.8;29.0
60;2021-06-27;713;2593;370663;241618;44.9;29.3
60;2021-06-28;1781;4142;372444;245760;45.1;29.8
60;2021-06-29;2010;5467;374454;251227;45.4;30.4
60;2021-06-30;2296;5360;376750;256587;45.7;31.1
60;2021-07-01;1888;4919;378638;261506;45.9;31.7
60;2021-07-02;2370;5878;381008;267384;46.2;32.4
60;2021-07-03;2400;6160;383408;273544;46.5;33.2
60;2021-07-04;792;2724;384200;276268;46.6;33.5
60;2021-07-05;1659;4406;385859;280674;46.8;34.0
60;2021-07-06;2146;4501;388005;285175;47.0;34.6
60;2021-07-07;2174;5119;390179;290294;47.3;35.2
60;2021-07-08;2672;4692;392851;294986;47.6;35.8
60;2021-07-09;2640;5568;395491;300554;47.9;36.4
60;2021-07-10;2579;5875;398070;306429;48.2;37.1
60;2021-07-11;1212;1942;399282;308371;48.4;37.4
60;2021-07-12;1447;4737;400729;313108;48.6;37.9
60;2021-07-13;2912;5019;403641;318127;48.9;38.6
60;2021-07-14;2584;1411;406225;319538;49.2;38.7
60;2021-07-15;3430;4873;409655;324411;49.7;39.3
60;2021-07-16;3698;5243;413353;329654;50.1;40.0
60;2021-07-17;4079;5135;417432;334789;50.6;40.6
60;2021-07-18;2186;2131;419618;336920;50.9;40.8
60;2021-07-19;2542;3892;422160;340812;51.2;41.3
60;2021-07-20;4197;4904;426357;345716;51.7;41.9
60;2021-07-21;4352;4289;430709;350005;52.2;42.4
60;2021-07-22;4627;4337;435336;354342;52.8;42.9
60;2021-07-23;4981;4903;440317;359245;53.4;43.5
60;2021-07-24;4314;4676;444631;363921;53.9;44.1
60;2021-07-25;2604;1831;447235;365752;54.2;44.3
60;2021-07-26;3377;3757;450612;369509;54.6;44.8
60;2021-07-27;4437;4634;455049;374143;55.2;45.3
60;2021-07-28;4554;3771;459603;377914;55.7;45.8
60;2021-07-29;4901;3714;464504;381628;56.3;46.3
60;2021-07-30;5025;4263;469529;385891;56.9;46.8
60;2021-07-31;4063;3969;473592;389860;57.4;47.3
60;2021-08-01;1684;863;475276;390723;57.6;47.4
60;2021-08-02;3198;2755;478474;393478;58.0;47.7
60;2021-08-03;3605;2894;482079;396372;58.4;48.0
60;2021-08-04;3317;2801;485396;399173;58.8;48.4
60;2021-08-05;3032;2261;488428;401434;59.2;48.7
60;2021-08-06;3830;3057;492258;404491;59.7;49.0
60;2021-08-07;3370;3078;495628;407569;60.1;49.4
60;2021-08-08;1535;911;497163;408480;60.3;49.5
60;2021-08-09;2207;2874;499370;411354;60.5;49.9
60;2021-08-10;3276;3313;502646;414667;60.9;50.3
60;2021-08-11;2788;3239;505434;417906;61.3;50.7
60;2021-08-12;2355;2665;507789;420571;61.5;51.0
60;2021-08-13;2751;2999;510540;423570;61.9;51.3
60;2021-08-14;2542;2735;513082;426305;62.2;51.7
60;2021-08-15;1362;553;514444;426858;62.4;51.7
60;2021-08-16;2040;3776;516484;430634;62.6;52.2
60;2021-08-17;2347;3820;518831;434454;62.9;52.7
60;2021-08-18;1943;3284;520774;437738;63.1;53.1
60;2021-08-19;1647;3074;522421;440812;63.3;53.4
60;2021-08-20;1867;3999;524288;444811;63.5;53.9
60;2021-08-21;1613;3492;525901;448303;63.7;54.3
60;2021-08-22;576;1339;526477;449642;63.8;54.5
60;2021-08-23;1107;3223;527584;452865;63.9;54.9
60;2021-08-24;1371;4496;528955;457361;64.1;55.4
60;2021-08-25;1431;3586;530386;460947;64.3;55.9
60;2021-08-26;1432;3459;531818;464406;64.5;56.3
60;2021-08-27;1435;4173;533253;468579;64.6;56.8
60;2021-08-28;1379;4479;534632;473058;64.8;57.3
60;2021-08-29;550;2041;535182;475099;64.9;57.6
60;2021-08-30;1231;2964;536413;478063;65.0;57.9
60;2021-08-31;1644;3799;538057;481862;65.2;58.4
60;2021-09-01;1237;2664;539294;484526;65.4;58.7
60;2021-09-02;1058;2568;540352;487094;65.5;59.0
60;2021-09-03;1024;2975;541376;490069;65.6;59.4
60;2021-09-04;1521;3605;542897;493674;65.8;59.8
60;2021-09-05;367;1332;543264;495006;65.8;60.0
60;2021-09-06;798;2382;544062;497388;65.9;60.3
60;2021-09-07;840;2776;544902;500164;66.0;60.6
60;2021-09-08;887;2709;545789;502873;66.2;60.9
60;2021-09-09;685;2158;546474;505031;66.2;61.2
60;2021-09-10;1052;2770;547526;507801;66.4;61.5
60;2021-09-11;1062;3332;548588;511133;66.5;61.9
60;2021-09-12;308;1108;548896;512241;66.5;62.1
60;2021-09-13;611;1720;549507;513961;66.6;62.3
60;2021-09-14;760;1496;550267;515457;66.7;62.5
60;2021-09-15;570;1243;550837;516700;66.8;62.6
60;2021-09-16;919;1327;551756;518027;66.9;62.8
60;2021-09-17;717;1465;552473;519492;67.0;63.0
60;2021-09-18;819;2609;553292;522101;67.1;63.3
60;2021-09-19;191;497;553483;522598;67.1;63.3
60;2021-09-20;460;1097;553943;523695;67.1;63.5
60;2021-09-21;500;983;554443;524678;67.2;63.6
60;2021-09-22;442;1306;554885;525984;67.3;63.7
60;2021-09-23;628;901;555513;526885;67.3;63.9
60;2021-09-24;488;1195;556001;528080;67.4;64.0
60;2021-09-25;493;1876;556494;529956;67.4;64.2
60;2021-09-26;78;294;556572;530250;67.5;64.3
60;2021-09-27;335;765;556907;531015;67.5;64.4
60;2021-09-28;320;883;557227;531898;67.5;64.5
60;2021-09-29;407;1048;557634;532946;67.6;64.6
60;2021-09-30;367;736;558001;533682;67.6;64.7
60;2021-10-01;412;1036;558413;534718;67.7;64.8
60;2021-10-02;588;1466;559001;536184;67.8;65.0
60;2021-10-03;80;305;559081;536489;67.8;65.0
60;2021-10-04;358;680;559439;537169;67.8;65.1
60;2021-10-05;264;533;559703;537702;67.8;65.2
60;2021-10-06;363;762;560066;538464;67.9;65.3
60;2021-10-07;184;556;560250;539020;67.9;65.3
60;2021-10-08;431;790;560681;539810;68.0;65.4
60;2021-10-09;613;1273;561294;541083;68.0;65.6
60;2021-10-10;49;188;561343;541271;68.0;65.6
60;2021-10-11;289;518;561632;541789;68.1;65.7
60;2021-10-12;219;471;561851;542260;68.1;65.7
60;2021-10-13;360;611;562211;542871;68.1;65.8
60;2021-10-14;267;624;562478;543495;68.2;65.9
61;2020-12-27;0;0;0;0;0.0;0.0
61;2020-12-28;0;0;0;0;0.0;0.0
61;2020-12-29;0;0;0;0;0.0;0.0
61;2020-12-30;0;0;0;0;0.0;0.0
61;2020-12-31;0;0;0;0;0.0;0.0
61;2021-01-01;2;0;2;0;0.0;0.0
61;2021-01-02;1;0;3;0;0.0;0.0
61;2021-01-03;0;0;3;0;0.0;0.0
61;2021-01-04;1;0;4;0;0.0;0.0
61;2021-01-05;3;0;7;0;0.0;0.0
61;2021-01-06;77;0;84;0;0.0;0.0
61;2021-01-07;175;2;259;2;0.1;0.0
61;2021-01-08;405;1;664;3;0.2;0.0
61;2021-01-09;165;1;829;4;0.3;0.0
61;2021-01-10;49;0;878;4;0.3;0.0
61;2021-01-11;396;1;1274;5;0.5;0.0
61;2021-01-12;681;3;1955;8;0.7;0.0
61;2021-01-13;740;2;2695;10;1.0;0.0
61;2021-01-14;530;9;3225;19;1.2;0.0
61;2021-01-15;537;4;3762;23;1.4;0.0
61;2021-01-16;289;1;4051;24;1.5;0.0
61;2021-01-17;891;12;4942;36;1.8;0.0
61;2021-01-18;1914;3;6856;39;2.5;0.0
61;2021-01-19;1327;5;8183;44;3.0;0.0
61;2021-01-20;685;0;8868;44;3.2;0.0
61;2021-01-21;848;1;9716;45;3.5;0.0
61;2021-01-22;764;1;10480;46;3.8;0.0
61;2021-01-23;257;2;10737;48;3.9;0.0
61;2021-01-24;229;2;10966;50;4.0;0.0
61;2021-01-25;578;1;11544;51;4.2;0.0
61;2021-01-26;568;2;12112;53;4.4;0.0
61;2021-01-27;572;14;12684;67;4.6;0.0
61;2021-01-28;466;53;13150;120;4.7;0.0
61;2021-01-29;479;204;13629;324;4.9;0.1
61;2021-01-30;212;3;13841;327;5.0;0.1
61;2021-01-31;109;3;13950;330;5.0;0.1
61;2021-02-01;430;190;14380;520;5.2;0.2
61;2021-02-02;389;424;14769;944;5.3;0.3
61;2021-02-03;412;491;15181;1435;5.5;0.5
61;2021-02-04;390;338;15571;1773;5.6;0.6
61;2021-02-05;536;361;16107;2134;5.8;0.8
61;2021-02-06;206;93;16313;2227;5.9;0.8
61;2021-02-07;45;199;16358;2426;5.9;0.9
61;2021-02-08;541;1405;16899;3831;6.1;1.4
61;2021-02-09;404;810;17303;4641;6.2;1.7
61;2021-02-10;280;560;17583;5201;6.3;1.9
61;2021-02-11;432;558;18015;5759;6.5;2.1
61;2021-02-12;401;736;18416;6495;6.7;2.3
61;2021-02-13;133;431;18549;6926;6.7;2.5
61;2021-02-14;3;315;18552;7241;6.7;2.6
61;2021-02-15;169;841;18721;8082;6.8;2.9
61;2021-02-16;203;679;18924;8761;6.8;3.2
61;2021-02-17;44;638;18968;9399;6.9;3.4
61;2021-02-18;161;524;19129;9923;6.9;3.6
61;2021-02-19;101;391;19230;10314;6.9;3.7
61;2021-02-20;40;236;19270;10550;7.0;3.8
61;2021-02-21;2;155;19272;10705;7.0;3.9
61;2021-02-22;88;566;19360;11271;7.0;4.1
61;2021-02-23;102;494;19462;11765;7.0;4.2
61;2021-02-24;173;570;19635;12335;7.1;4.5
61;2021-02-25;265;445;19900;12780;7.2;4.6
61;2021-02-26;266;465;20166;13245;7.3;4.8
61;2021-02-27;110;228;20276;13473;7.3;4.9
61;2021-02-28;4;122;20280;13595;7.3;4.9
61;2021-03-01;215;611;20495;14206;7.4;5.1
61;2021-03-02;148;700;20643;14906;7.5;5.4
61;2021-03-03;143;448;20786;15354;7.5;5.5
61;2021-03-04;429;444;21215;15798;7.7;5.7
61;2021-03-05;703;302;21918;16100;7.9;5.8
61;2021-03-06;436;232;22354;16332;8.1;5.9
61;2021-03-07;155;2;22509;16334;8.1;5.9
61;2021-03-08;295;314;22804;16648;8.2;6.0
61;2021-03-09;622;186;23426;16834;8.5;6.1
61;2021-03-10;672;189;24098;17023;8.7;6.1
61;2021-03-11;1120;131;25218;17154;9.1;6.2
61;2021-03-12;1466;105;26684;17259;9.6;6.2
61;2021-03-13;775;56;27459;17315;9.9;6.3
61;2021-03-14;226;6;27685;17321;10.0;6.3
61;2021-03-15;814;37;28499;17358;10.3;6.3
61;2021-03-16;723;23;29222;17381;10.6;6.3
61;2021-03-17;761;12;29983;17393;10.8;6.3
61;2021-03-18;858;29;30841;17422;11.1;6.3
61;2021-03-19;1026;51;31867;17473;11.5;6.3
61;2021-03-20;478;17;32345;17490;11.7;6.3
61;2021-03-21;72;3;32417;17493;11.7;6.3
61;2021-03-22;797;94;33214;17587;12.0;6.4
61;2021-03-23;920;41;34134;17628;12.3;6.4
61;2021-03-24;1373;70;35507;17698;12.8;6.4
61;2021-03-25;1876;69;37383;17767;13.5;6.4
61;2021-03-26;1800;47;39183;17814;14.2;6.4
61;2021-03-27;1082;19;40265;17833;14.5;6.4
61;2021-03-28;359;9;40624;17842;14.7;6.4
61;2021-03-29;1273;184;41897;18026;15.1;6.5
61;2021-03-30;1470;102;43367;18128;15.7;6.5
61;2021-03-31;1687;54;45054;18182;16.3;6.6
61;2021-04-01;2051;233;47105;18415;17.0;6.7
61;2021-04-02;1519;435;48624;18850;17.6;6.8
61;2021-04-03;640;290;49264;19140;17.8;6.9
61;2021-04-04;193;1;49457;19141;17.9;6.9
61;2021-04-05;534;8;49991;19149;18.1;6.9
61;2021-04-06;1350;621;51341;19770;18.5;7.1
61;2021-04-07;1695;663;53036;20433;19.2;7.4
61;2021-04-08;2266;837;55302;21270;20.0;7.7
61;2021-04-09;2133;837;57435;22107;20.7;8.0
61;2021-04-10;1534;489;58969;22596;21.3;8.2
61;2021-04-11;238;202;59207;22798;21.4;8.2
61;2021-04-12;1284;737;60491;23535;21.8;8.5
61;2021-04-13;1742;707;62233;24242;22.5;8.8
61;2021-04-14;1734;788;63967;25030;23.1;9.0
61;2021-04-15;2268;789;66235;25819;23.9;9.3
61;2021-04-16;2227;691;68462;26510;24.7;9.6
61;2021-04-17;1483;321;69945;26831;25.3;9.7
61;2021-04-18;538;99;70483;26930;25.5;9.7
61;2021-04-19;936;750;71419;27680;25.8;10.0
61;2021-04-20;1523;786;72942;28466;26.3;10.3
61;2021-04-21;1351;1041;74293;29507;26.8;10.7
61;2021-04-22;1292;1222;75585;30729;27.3;11.1
61;2021-04-23;1213;1154;76798;31883;27.7;11.5
61;2021-04-24;1437;822;78235;32705;28.3;11.8
61;2021-04-25;361;333;78596;33038;28.4;11.9
61;2021-04-26;671;1146;79267;34184;28.6;12.3
61;2021-04-27;1465;1146;80732;35330;29.2;12.8
61;2021-04-28;1386;1392;82118;36722;29.7;13.3
61;2021-04-29;1246;1861;83364;38583;30.1;13.9
61;2021-04-30;1719;1177;85083;39760;30.7;14.4
61;2021-05-01;789;324;85872;40084;31.0;14.5
61;2021-05-02;439;227;86311;40311;31.2;14.6
61;2021-05-03;843;1251;87154;41562;31.5;15.0
61;2021-05-04;1323;1753;88477;43315;32.0;15.6
61;2021-05-05;1008;2032;89485;45347;32.3;16.4
61;2021-05-06;1772;2215;91257;47562;33.0;17.2
61;2021-05-07;1376;1974;92633;49536;33.5;17.9
61;2021-05-08;929;473;93562;50009;33.8;18.1
61;2021-05-09;395;293;93957;50302;33.9;18.2
61;2021-05-10;987;1756;94944;52058;34.3;18.8
61;2021-05-11;1377;1516;96321;53574;34.8;19.3
61;2021-05-12;1869;1595;98190;55169;35.5;19.9
61;2021-05-13;889;491;99079;55660;35.8;20.1
61;2021-05-14;1851;1191;100930;56851;36.4;20.5
61;2021-05-15;2111;1121;103041;57972;37.2;20.9
61;2021-05-16;984;300;104025;58272;37.6;21.0
61;2021-05-17;1312;914;105337;59186;38.0;21.4
61;2021-05-18;2422;894;107759;60080;38.9;21.7
61;2021-05-19;2400;804;110159;60884;39.8;22.0
61;2021-05-20;2212;819;112371;61703;40.6;22.3
61;2021-05-21;2149;861;114520;62564;41.4;22.6
61;2021-05-22;1780;718;116300;63282;42.0;22.9
61;2021-05-23;714;54;117014;63336;42.3;22.9
61;2021-05-24;914;112;117928;63448;42.6;22.9
61;2021-05-25;1991;921;119919;64369;43.3;23.2
61;2021-05-26;2046;932;121965;65301;44.0;23.6
61;2021-05-27;2042;1094;124007;66395;44.8;24.0
61;2021-05-28;2052;1378;126059;67773;45.5;24.5
61;2021-05-29;1466;557;127525;68330;46.1;24.7
61;2021-05-30;450;44;127975;68374;46.2;24.7
61;2021-05-31;1559;938;129534;69312;46.8;25.0
61;2021-06-01;1875;1389;131409;70701;47.5;25.5
61;2021-06-02;1676;1137;133085;71838;48.1;25.9
61;2021-06-03;2250;1110;135335;72948;48.9;26.3
61;2021-06-04;1898;1346;137233;74294;49.6;26.8
61;2021-06-05;1669;1240;138902;75534;50.2;27.3
61;2021-06-06;318;230;139220;75764;50.3;27.4
61;2021-06-07;2189;867;141409;76631;51.1;27.7
61;2021-06-08;1847;1570;143256;78201;51.7;28.2
61;2021-06-09;1975;1185;145231;79386;52.4;28.7
61;2021-06-10;1974;1192;147205;80578;53.2;29.1
61;2021-06-11;1822;1581;149027;82159;53.8;29.7
61;2021-06-12;1424;999;150451;83158;54.3;30.0
61;2021-06-13;340;377;150791;83535;54.5;30.2
61;2021-06-14;1107;1188;151898;84723;54.9;30.6
61;2021-06-15;1214;1694;153112;86417;55.3;31.2
61;2021-06-16;1114;1363;154226;87780;55.7;31.7
61;2021-06-17;1019;1730;155245;89510;56.1;32.3
61;2021-06-18;1523;1671;156768;91181;56.6;32.9
61;2021-06-19;1245;1303;158013;92484;57.1;33.4
61;2021-06-20;289;345;158302;92829;57.2;33.5
61;2021-06-21;807;1629;159109;94458;57.5;34.1
61;2021-06-22;1024;1683;160133;96141;57.8;34.7
61;2021-06-23;967;2436;161100;98577;58.2;35.6
61;2021-06-24;650;1361;161750;99938;58.4;36.1
61;2021-06-25;839;2167;162589;102105;58.7;36.9
61;2021-06-26;620;1955;163209;104060;58.9;37.6
61;2021-06-27;139;799;163348;104859;59.0;37.9
61;2021-06-28;478;2247;163826;107106;59.2;38.7
61;2021-06-29;699;2858;164525;109964;59.4;39.7
61;2021-06-30;771;2463;165296;112427;59.7;40.6
61;2021-07-01;633;1699;165929;114126;59.9;41.2
61;2021-07-02;842;2496;166771;116622;60.2;42.1
61;2021-07-03;417;1910;167188;118532;60.4;42.8
61;2021-07-04;75;638;167263;119170;60.4;43.0
61;2021-07-05;682;1774;167945;120944;60.7;43.7
61;2021-07-06;991;2794;168936;123738;61.0;44.7
61;2021-07-07;734;2360;169670;126098;61.3;45.5
61;2021-07-08;840;1944;170510;128042;61.6;46.2
61;2021-07-09;723;2375;171233;130417;61.8;47.1
61;2021-07-10;463;1767;171696;132184;62.0;47.7
61;2021-07-11;244;489;171940;132673;62.1;47.9
61;2021-07-12;438;2290;172378;134963;62.3;48.7
61;2021-07-13;643;2488;173021;137451;62.5;49.6
61;2021-07-14;150;334;173171;137785;62.5;49.8
61;2021-07-15;815;2814;173986;140599;62.8;50.8
61;2021-07-16;967;2574;174953;143173;63.2;51.7
61;2021-07-17;708;2232;175661;145405;63.4;52.5
61;2021-07-18;339;368;176000;145773;63.6;52.6
61;2021-07-19;934;2403;176934;148176;63.9;53.5
61;2021-07-20;1327;2356;178261;150532;64.4;54.4
61;2021-07-21;1503;2181;179764;152713;64.9;55.2
61;2021-07-22;1750;2188;181514;154901;65.6;55.9
61;2021-07-23;1793;2306;183307;157207;66.2;56.8
61;2021-07-24;1457;2008;184764;159215;66.7;57.5
61;2021-07-25;323;393;185087;159608;66.8;57.6
61;2021-07-26;1252;1933;186339;161541;67.3;58.3
61;2021-07-27;2420;1583;188759;163124;68.2;58.9
61;2021-07-28;2457;1355;191216;164479;69.1;59.4
61;2021-07-29;2563;1577;193779;166056;70.0;60.0
61;2021-07-30;2396;1393;196175;167449;70.8;60.5
61;2021-07-31;1282;1301;197457;168750;71.3;60.9
61;2021-08-01;504;259;197961;169009;71.5;61.0
61;2021-08-02;1913;1123;199874;170132;72.2;61.4
61;2021-08-03;2452;915;202326;171047;73.1;61.8
61;2021-08-04;2344;781;204670;171828;73.9;62.1
61;2021-08-05;1901;992;206571;172820;74.6;62.4
61;2021-08-06;2164;1163;208735;173983;75.4;62.8
61;2021-08-07;1422;799;210157;174782;75.9;63.1
61;2021-08-08;447;263;210604;175045;76.1;63.2
61;2021-08-09;1310;1112;211914;176157;76.5;63.6
61;2021-08-10;1315;1107;213229;177264;77.0;64.0
61;2021-08-11;1118;1258;214347;178522;77.4;64.5
61;2021-08-12;1038;1321;215385;179843;77.8;64.9
61;2021-08-13;880;1610;216265;181453;78.1;65.5
61;2021-08-14;717;864;216982;182317;78.4;65.8
61;2021-08-15;94;183;217076;182500;78.4;65.9
61;2021-08-16;913;1541;217989;184041;78.7;66.5
61;2021-08-17;1153;1702;219142;185743;79.1;67.1
61;2021-08-18;811;1479;219953;187222;79.4;67.6
61;2021-08-19;745;1570;220698;188792;79.7;68.2
61;2021-08-20;800;2131;221498;190923;80.0;68.9
61;2021-08-21;492;1345;221990;192268;80.2;69.4
61;2021-08-22;137;447;222127;192715;80.2;69.6
61;2021-08-23;415;1702;222542;194417;80.4;70.2
61;2021-08-24;528;1899;223070;196316;80.6;70.9
61;2021-08-25;412;1735;223482;198051;80.7;71.5
61;2021-08-26;429;1598;223911;199649;80.9;72.1
61;2021-08-27;515;1889;224426;201538;81.0;72.8
61;2021-08-28;286;1365;224712;202903;81.2;73.3
61;2021-08-29;50;417;224762;203320;81.2;73.4
61;2021-08-30;400;1618;225162;204938;81.3;74.0
61;2021-08-31;505;1672;225667;206610;81.5;74.6
61;2021-09-01;454;1312;226121;207922;81.7;75.1
61;2021-09-02;421;1097;226542;209019;81.8;75.5
61;2021-09-03;476;1296;227018;210315;82.0;76.0
61;2021-09-04;348;1254;227366;211569;82.1;76.4
61;2021-09-05;76;181;227442;211750;82.1;76.5
61;2021-09-06;286;973;227728;212723;82.2;76.8
61;2021-09-07;362;1391;228090;214114;82.4;77.3
61;2021-09-08;274;1193;228364;215307;82.5;77.8
61;2021-09-09;295;886;228659;216193;82.6;78.1
61;2021-09-10;366;889;229025;217082;82.7;78.4
61;2021-09-11;270;1021;229295;218103;82.8;78.8
61;2021-09-12;37;109;229332;218212;82.8;78.8
61;2021-09-13;208;526;229540;218738;82.9;79.0
61;2021-09-14;197;362;229737;219100;83.0;79.1
61;2021-09-15;258;595;229995;219695;83.1;79.3
61;2021-09-16;221;269;230216;219964;83.1;79.4
61;2021-09-17;243;533;230459;220497;83.2;79.6
61;2021-09-18;217;612;230676;221109;83.3;79.9
61;2021-09-19;1;0;230677;221109;83.3;79.9
61;2021-09-20;179;267;230856;221376;83.4;79.9
61;2021-09-21;236;189;231092;221565;83.5;80.0
61;2021-09-22;158;692;231250;222257;83.5;80.3
61;2021-09-23;163;228;231413;222485;83.6;80.3
61;2021-09-24;135;378;231548;222863;83.6;80.5
61;2021-09-25;171;596;231719;223459;83.7;80.7
61;2021-09-26;9;16;231728;223475;83.7;80.7
61;2021-09-27;125;293;231853;223768;83.7;80.8
61;2021-09-28;95;248;231948;224016;83.8;80.9
61;2021-09-29;105;217;232053;224233;83.8;81.0
61;2021-09-30;204;237;232257;224470;83.9;81.1
61;2021-10-01;87;265;232344;224735;83.9;81.2
61;2021-10-02;197;565;232541;225300;84.0;81.4
61;2021-10-03;1;8;232542;225308;84.0;81.4
61;2021-10-04;108;287;232650;225595;84.0;81.5
61;2021-10-05;112;289;232762;225884;84.1;81.6
61;2021-10-06;155;321;232917;226205;84.1;81.7
61;2021-10-07;141;259;233058;226464;84.2;81.8
61;2021-10-08;157;243;233215;226707;84.2;81.9
61;2021-10-09;89;168;233304;226875;84.3;81.9
61;2021-10-10;1;2;233305;226877;84.3;81.9
61;2021-10-11;140;386;233445;227263;84.3;82.1
61;2021-10-12;70;185;233515;227448;84.3;82.1
61;2021-10-13;115;203;233630;227651;84.4;82.2
61;2021-10-14;65;207;233695;227858;84.4;82.3
62;2020-12-27;2;0;2;0;0.0;0.0
62;2020-12-28;1;0;3;0;0.0;0.0
62;2020-12-29;0;0;3;0;0.0;0.0
62;2020-12-30;0;0;3;0;0.0;0.0
62;2020-12-31;0;0;3;0;0.0;0.0
62;2021-01-01;0;0;3;0;0.0;0.0
62;2021-01-02;3;2;6;2;0.0;0.0
62;2021-01-03;0;0;6;2;0.0;0.0
62;2021-01-04;3;0;9;2;0.0;0.0
62;2021-01-05;47;0;56;2;0.0;0.0
62;2021-01-06;123;0;179;2;0.0;0.0
62;2021-01-07;352;0;531;2;0.0;0.0
62;2021-01-08;713;9;1244;11;0.1;0.0
62;2021-01-09;164;1;1408;12;0.1;0.0
62;2021-01-10;84;0;1492;12;0.1;0.0
62;2021-01-11;557;3;2049;15;0.1;0.0
62;2021-01-12;1260;6;3309;21;0.2;0.0
62;2021-01-13;1139;17;4448;38;0.3;0.0
62;2021-01-14;1386;9;5834;47;0.4;0.0
62;2021-01-15;1300;13;7134;60;0.5;0.0
62;2021-01-16;309;3;7443;63;0.5;0.0
62;2021-01-17;107;1;7550;64;0.5;0.0
62;2021-01-18;1667;10;9217;74;0.6;0.0
62;2021-01-19;2104;6;11321;80;0.8;0.0
62;2021-01-20;2056;7;13377;87;0.9;0.0
62;2021-01-21;2244;10;15621;97;1.1;0.0
62;2021-01-22;1835;7;17456;104;1.2;0.0
62;2021-01-23;512;1;17968;105;1.2;0.0
62;2021-01-24;0;0;17968;105;1.2;0.0
62;2021-01-25;1286;8;19254;113;1.3;0.0
62;2021-01-26;1546;21;20800;134;1.4;0.0
62;2021-01-27;1518;179;22318;313;1.5;0.0
62;2021-01-28;4184;402;26502;715;1.8;0.0
62;2021-01-29;2048;340;28550;1055;2.0;0.1
62;2021-01-30;159;151;28709;1206;2.0;0.1
62;2021-01-31;22;3;28731;1209;2.0;0.1
62;2021-02-01;46;355;28777;1564;2.0;0.1
62;2021-02-02;59;785;28836;2349;2.0;0.2
62;2021-02-03;44;627;28880;2976;2.0;0.2
62;2021-02-04;81;801;28961;3777;2.0;0.3
62;2021-02-05;80;748;29041;4525;2.0;0.3
62;2021-02-06;32;199;29073;4724;2.0;0.3
62;2021-02-07;236;31;29309;4755;2.0;0.3
62;2021-02-08;133;841;29442;5596;2.0;0.4
62;2021-02-09;227;1093;29669;6689;2.0;0.5
62;2021-02-10;385;1165;30054;7854;2.1;0.5
62;2021-02-11;726;996;30780;8850;2.1;0.6
62;2021-02-12;968;778;31748;9628;2.2;0.7
62;2021-02-13;162;266;31910;9894;2.2;0.7
62;2021-02-14;0;0;31910;9894;2.2;0.7
62;2021-02-15;666;1265;32576;11159;2.2;0.8
62;2021-02-16;923;1775;33499;12934;2.3;0.9
62;2021-02-17;1082;2070;34581;15004;2.4;1.0
62;2021-02-18;2228;3773;36809;18777;2.5;1.3
62;2021-02-19;2315;2548;39124;21325;2.7;1.5
62;2021-02-20;616;480;39740;21805;2.7;1.5
62;2021-02-21;88;50;39828;21855;2.7;1.5
62;2021-02-22;849;963;40677;22818;2.8;1.6
62;2021-02-23;1419;1212;42096;24030;2.9;1.7
62;2021-02-24;1547;656;43643;24686;3.0;1.7
62;2021-02-25;3169;425;46812;25111;3.2;1.7
62;2021-02-26;2912;355;49724;25466;3.4;1.8
62;2021-02-27;1829;99;51553;25565;3.5;1.8
62;2021-02-28;52;42;51605;25607;3.6;1.8
62;2021-03-01;1322;125;52927;25732;3.6;1.8
62;2021-03-02;3154;189;56081;25921;3.9;1.8
62;2021-03-03;3274;141;59355;26062;4.1;1.8
62;2021-03-04;3809;228;63164;26290;4.3;1.8
62;2021-03-05;4647;250;67811;26540;4.7;1.8
62;2021-03-06;9621;292;77432;26832;5.3;1.8
62;2021-03-07;8074;247;85506;27079;5.9;1.9
62;2021-03-08;2197;273;87703;27352;6.0;1.9
62;2021-03-09;3810;398;91513;27750;6.3;1.9
62;2021-03-10;4233;630;95746;28380;6.6;2.0
62;2021-03-11;5993;1551;101739;29931;7.0;2.1
62;2021-03-12;6639;1446;108378;31377;7.5;2.2
62;2021-03-13;14724;834;123102;32211;8.5;2.2
62;2021-03-14;9582;444;132684;32655;9.1;2.2
62;2021-03-15;3761;1026;136445;33681;9.4;2.3
62;2021-03-16;2736;864;139181;34545;9.6;2.4
62;2021-03-17;2805;745;141986;35290;9.8;2.4
62;2021-03-18;2726;956;144712;36246;10.0;2.5
62;2021-03-19;4784;941;149496;37187;10.3;2.6
62;2021-03-20;11066;636;160562;37823;11.1;2.6
62;2021-03-21;9447;384;170009;38207;11.7;2.6
62;2021-03-22;2944;1120;172953;39327;11.9;2.7
62;2021-03-23;4997;1504;177950;40831;12.2;2.8
62;2021-03-24;4696;1393;182646;42224;12.6;2.9
62;2021-03-25;6555;1493;189201;43717;13.0;3.0
62;2021-03-26;7048;1517;196249;45234;13.5;3.1
62;2021-03-27;12593;768;208842;46002;14.4;3.2
62;2021-03-28;6941;291;215783;46293;14.9;3.2
62;2021-03-29;3470;1219;219253;47512;15.1;3.3
62;2021-03-30;4549;2223;223802;49735;15.4;3.4
62;2021-03-31;4225;2489;228027;52224;15.7;3.6
62;2021-04-01;4977;2776;233004;55000;16.0;3.8
62;2021-04-02;5067;3245;238071;58245;16.4;4.0
62;2021-04-03;8207;3373;246278;61618;17.0;4.2
62;2021-04-04;4582;1946;250860;63564;17.3;4.4
62;2021-04-05;944;468;251804;64032;17.3;4.4
62;2021-04-06;4122;3023;255926;67055;17.6;4.6
62;2021-04-07;5071;3539;260997;70594;18.0;4.9
62;2021-04-08;6492;4016;267489;74610;18.4;5.1
62;2021-04-09;7629;3497;275118;78107;18.9;5.4
62;2021-04-10;6637;8091;281755;86198;19.4;5.9
62;2021-04-11;2804;6903;284559;93101;19.6;6.4
62;2021-04-12;3419;2389;287978;95490;19.8;6.6
62;2021-04-13;6170;3175;294148;98665;20.2;6.8
62;2021-04-14;5306;3072;299454;101737;20.6;7.0
62;2021-04-15;5734;3019;305188;104756;21.0;7.2
62;2021-04-16;5418;3216;310606;107972;21.4;7.4
62;2021-04-17;4355;7378;314961;115350;21.7;7.9
62;2021-04-18;1957;6859;316918;122209;21.8;8.4
62;2021-04-19;2777;1939;319695;124148;22.0;8.5
62;2021-04-20;4148;3900;323843;128048;22.3;8.8
62;2021-04-21;3746;3989;327589;132037;22.5;9.1
62;2021-04-22;3948;5193;331537;137230;22.8;9.4
62;2021-04-23;4064;5333;335601;142563;23.1;9.8
62;2021-04-24;4401;6738;340002;149301;23.4;10.3
62;2021-04-25;1911;3504;341913;152805;23.5;10.5
62;2021-04-26;2224;2436;344137;155241;23.7;10.7
62;2021-04-27;4408;3773;348545;159014;24.0;10.9
62;2021-04-28;4591;4421;353136;163435;24.3;11.2
62;2021-04-29;4787;5909;357923;169344;24.6;11.7
62;2021-04-30;5215;5742;363138;175086;25.0;12.1
62;2021-05-01;5725;3482;368863;178568;25.4;12.3
62;2021-05-02;7826;3163;376689;181731;25.9;12.5
62;2021-05-03;4510;2352;381199;184083;26.2;12.7
62;2021-05-04;5398;4992;386597;189075;26.6;13.0
62;2021-05-05;4736;4843;391333;193918;26.9;13.3
62;2021-05-06;5619;4956;396952;198874;27.3;13.7
62;2021-05-07;7691;4691;404643;203565;27.9;14.0
62;2021-05-08;10659;2351;415302;205916;28.6;14.2
62;2021-05-09;8625;1642;423927;207558;29.2;14.3
62;2021-05-10;4867;4032;428794;211590;29.5;14.6
62;2021-05-11;6414;5060;435208;216650;30.0;14.9
62;2021-05-12;8624;4609;443832;221259;30.6;15.2
62;2021-05-13;9999;1492;453831;222751;31.2;15.3
62;2021-05-14;11880;3414;465711;226165;32.1;15.6
62;2021-05-15;19781;3303;485492;229468;33.4;15.8
62;2021-05-16;16399;1424;501891;230892;34.5;15.9
62;2021-05-17;8180;2659;510071;233551;35.1;16.1
62;2021-05-18;9325;3133;519396;236684;35.8;16.3
62;2021-05-19;8614;2934;528010;239618;36.3;16.5
62;2021-05-20;8341;3843;536351;243461;36.9;16.8
62;2021-05-21;9397;4223;545748;247684;37.6;17.0
62;2021-05-22;17874;3538;563622;251222;38.8;17.3
62;2021-05-23;12373;1164;575995;252386;39.6;17.4
62;2021-05-24;3911;587;579906;252973;39.9;17.4
62;2021-05-25;7220;4098;587126;257071;40.4;17.7
62;2021-05-26;6782;4913;593908;261984;40.9;18.0
62;2021-05-27;6382;5693;600290;267677;41.3;18.4
62;2021-05-28;6518;6772;606808;274449;41.8;18.9
62;2021-05-29;10849;5547;617657;279996;42.5;19.3
62;2021-05-30;4036;985;621693;280981;42.8;19.3
62;2021-05-31;4794;3970;626487;284951;43.1;19.6
62;2021-06-01;6520;6533;633007;291484;43.6;20.1
62;2021-06-02;7444;5820;640451;297304;44.1;20.5
62;2021-06-03;7854;5898;648305;303202;44.6;20.9
62;2021-06-04;7903;6264;656208;309466;45.2;21.3
62;2021-06-05;8274;6239;664482;315705;45.7;21.7
62;2021-06-06;3128;1292;667610;316997;46.0;21.8
62;2021-06-07;4625;3772;672235;320769;46.3;22.1
62;2021-06-08;6207;5911;678442;326680;46.7;22.5
62;2021-06-09;5499;4768;683941;331448;47.1;22.8
62;2021-06-10;5207;5890;689148;337338;47.4;23.2
62;2021-06-11;6208;8876;695356;346214;47.9;23.8
62;2021-06-12;5936;8647;701292;354861;48.3;24.4
62;2021-06-13;3225;3803;704517;358664;48.5;24.7
62;2021-06-14;2610;6781;707127;365445;48.7;25.2
62;2021-06-15;4675;8540;711802;373985;49.0;25.7
62;2021-06-16;5082;7431;716884;381416;49.3;26.3
62;2021-06-17;5235;8045;722119;389461;49.7;26.8
62;2021-06-18;4825;10494;726944;399955;50.0;27.5
62;2021-06-19;5792;13442;732736;413397;50.4;28.5
62;2021-06-20;2101;4369;734837;417766;50.6;28.8
62;2021-06-21;2976;8928;737813;426694;50.8;29.4
62;2021-06-22;3431;10170;741244;436864;51.0;30.1
62;2021-06-23;3388;10324;744632;447188;51.3;30.8
62;2021-06-24;3346;11786;747978;458974;51.5;31.6
62;2021-06-25;3724;15768;751702;474742;51.7;32.7
62;2021-06-26;3549;18426;755251;493168;52.0;33.9
62;2021-06-27;1121;9814;756372;502982;52.1;34.6
62;2021-06-28;1923;8870;758295;511852;52.2;35.2
62;2021-06-29;2974;11463;761269;523315;52.4;36.0
62;2021-06-30;4143;10816;765412;534131;52.7;36.8
62;2021-07-01;4483;10486;769895;544617;53.0;37.5
62;2021-07-02;4161;11985;774056;556602;53.3;38.3
62;2021-07-03;2996;18053;777052;574655;53.5;39.6
62;2021-07-04;1451;9196;778503;583851;53.6;40.2
62;2021-07-05;2416;6916;780919;590767;53.8;40.7
62;2021-07-06;3821;10016;784740;600783;54.0;41.4
62;2021-07-07;3917;8918;788657;609701;54.3;42.0
62;2021-07-08;5248;9089;793905;618790;54.6;42.6
62;2021-07-09;4473;10851;798378;629641;55.0;43.3
62;2021-07-10;4976;11891;803354;641532;55.3;44.2
62;2021-07-11;1337;2091;804691;643623;55.4;44.3
62;2021-07-12;2327;7135;807018;650758;55.5;44.8
62;2021-07-13;5175;12161;812193;662919;55.9;45.6
62;2021-07-14;3634;3164;815827;666083;56.2;45.8
62;2021-07-15;7588;11501;823415;677584;56.7;46.6
62;2021-07-16;7625;11046;831040;688630;57.2;47.4
62;2021-07-17;9719;10335;840759;698965;57.9;48.1
62;2021-07-18;2712;3458;843471;702423;58.1;48.4
62;2021-07-19;6013;7025;849484;709448;58.5;48.8
62;2021-07-20;7935;10725;857419;720173;59.0;49.6
62;2021-07-21;9777;9414;867196;729587;59.7;50.2
62;2021-07-22;9802;9026;876998;738613;60.4;50.8
62;2021-07-23;10630;8412;887628;747025;61.1;51.4
62;2021-07-24;9664;10321;897292;757346;61.8;52.1
62;2021-07-25;5549;1877;902841;759223;62.1;52.3
62;2021-07-26;6239;5390;909080;764613;62.6;52.6
62;2021-07-27;9851;8130;918931;772743;63.3;53.2
62;2021-07-28;10405;7489;929336;780232;64.0;53.7
62;2021-07-29;12005;7661;941341;787893;64.8;54.2
62;2021-07-30;9096;6296;950437;794189;65.4;54.7
62;2021-07-31;6639;4026;957076;798215;65.9;54.9
62;2021-08-01;2342;1103;959418;799318;66.0;55.0
62;2021-08-02;6866;4760;966284;804078;66.5;55.3
62;2021-08-03;8629;7476;974913;811554;67.1;55.9
62;2021-08-04;9491;5485;984404;817039;67.8;56.2
62;2021-08-05;8377;5635;992781;822674;68.3;56.6
62;2021-08-06;7322;5935;1000103;828609;68.8;57.0
62;2021-08-07;5493;4959;1005596;833568;69.2;57.4
62;2021-08-08;1877;1301;1007473;834869;69.3;57.5
62;2021-08-09;5262;5033;1012735;839902;69.7;57.8
62;2021-08-10;6222;7360;1018957;847262;70.1;58.3
62;2021-08-11;5415;7383;1024372;854645;70.5;58.8
62;2021-08-12;6007;7004;1030379;861649;70.9;59.3
62;2021-08-13;4522;6061;1034901;867710;71.2;59.7
62;2021-08-14;3838;6868;1038739;874578;71.5;60.2
62;2021-08-15;1141;1212;1039880;875790;71.6;60.3
62;2021-08-16;3188;5868;1043068;881658;71.8;60.7
62;2021-08-17;4172;7349;1047240;889007;72.1;61.2
62;2021-08-18;4362;7244;1051602;896251;72.4;61.7
62;2021-08-19;4392;8581;1055994;904832;72.7;62.3
62;2021-08-20;3447;8465;1059441;913297;72.9;62.9
62;2021-08-21;2459;9766;1061900;923063;73.1;63.5
62;2021-08-22;392;2817;1062292;925880;73.1;63.7
62;2021-08-23;2744;7830;1065036;933710;73.3;64.3
62;2021-08-24;3840;10409;1068876;944119;73.6;65.0
62;2021-08-25;3509;9196;1072385;953315;73.8;65.6
62;2021-08-26;3193;9774;1075578;963089;74.0;66.3
62;2021-08-27;2599;8826;1078177;971915;74.2;66.9
62;2021-08-28;2044;7997;1080221;979912;74.4;67.5
62;2021-08-29;864;2253;1081085;982165;74.4;67.6
62;2021-08-30;2049;7287;1083134;989452;74.6;68.1
62;2021-08-31;2142;7831;1085276;997283;74.7;68.6
62;2021-09-01;1848;5812;1087124;1003095;74.8;69.0
62;2021-09-02;1853;6450;1088977;1009545;75.0;69.5
62;2021-09-03;2072;6900;1091049;1016445;75.1;70.0
62;2021-09-04;2123;6276;1093172;1022721;75.2;70.4
62;2021-09-05;319;1198;1093491;1023919;75.3;70.5
62;2021-09-06;1032;3360;1094523;1027279;75.3;70.7
62;2021-09-07;1247;3859;1095770;1031138;75.4;71.0
62;2021-09-08;1290;4174;1097060;1035312;75.5;71.3
62;2021-09-09;1276;4263;1098336;1039575;75.6;71.6
62;2021-09-10;1593;4403;1099929;1043978;75.7;71.9
62;2021-09-11;1277;3953;1101206;1047931;75.8;72.1
62;2021-09-12;202;495;1101408;1048426;75.8;72.2
62;2021-09-13;783;2235;1102191;1050661;75.9;72.3
62;2021-09-14;1287;3381;1103478;1054042;76.0;72.6
62;2021-09-15;1345;4221;1104823;1058263;76.0;72.8
62;2021-09-16;1384;2920;1106207;1061183;76.1;73.0
62;2021-09-17;1337;2418;1107544;1063601;76.2;73.2
62;2021-09-18;1089;2883;1108633;1066484;76.3;73.4
62;2021-09-19;138;448;1108771;1066932;76.3;73.4
62;2021-09-20;617;1483;1109388;1068415;76.4;73.5
62;2021-09-21;902;2423;1110290;1070838;76.4;73.7
62;2021-09-22;790;2673;1111080;1073511;76.5;73.9
62;2021-09-23;730;1839;1111810;1075350;76.5;74.0
62;2021-09-24;812;1985;1112622;1077335;76.6;74.2
62;2021-09-25;717;2671;1113339;1080006;76.6;74.3
62;2021-09-26;73;373;1113412;1080379;76.6;74.4
62;2021-09-27;318;1055;1113730;1081434;76.7;74.4
62;2021-09-28;585;1704;1114315;1083138;76.7;74.6
62;2021-09-29;759;1902;1115074;1085040;76.8;74.7
62;2021-09-30;448;1008;1115522;1086048;76.8;74.8
62;2021-10-01;701;1664;1116223;1087712;76.8;74.9
62;2021-10-02;699;1497;1116922;1089209;76.9;75.0
62;2021-10-03;81;236;1117003;1089445;76.9;75.0
62;2021-10-04;375;790;1117378;1090235;76.9;75.0
62;2021-10-05;603;1453;1117981;1091688;77.0;75.1
62;2021-10-06;564;1244;1118545;1092932;77.0;75.2
62;2021-10-07;481;1256;1119026;1094188;77.0;75.3
62;2021-10-08;745;1590;1119771;1095778;77.1;75.4
62;2021-10-09;623;1393;1120394;1097171;77.1;75.5
62;2021-10-10;64;199;1120458;1097370;77.1;75.5
62;2021-10-11;338;654;1120796;1098024;77.1;75.6
62;2021-10-12;468;1342;1121264;1099366;77.2;75.7
62;2021-10-13;525;884;1121789;1100250;77.2;75.7
62;2021-10-14;399;764;1122188;1101014;77.2;75.8
63;2020-12-27;0;0;0;0;0.0;0.0
63;2020-12-28;1;0;1;0;0.0;0.0
63;2020-12-29;0;0;1;0;0.0;0.0
63;2020-12-30;0;0;1;0;0.0;0.0
63;2020-12-31;0;0;1;0;0.0;0.0
63;2021-01-01;1;0;2;0;0.0;0.0
63;2021-01-02;0;0;2;0;0.0;0.0
63;2021-01-03;1;0;3;0;0.0;0.0
63;2021-01-04;0;0;3;0;0.0;0.0
63;2021-01-05;1;0;4;0;0.0;0.0
63;2021-01-06;4;1;8;1;0.0;0.0
63;2021-01-07;310;1;318;2;0.0;0.0
63;2021-01-08;217;6;535;8;0.1;0.0
63;2021-01-09;91;0;626;8;0.1;0.0
63;2021-01-10;82;0;708;8;0.1;0.0
63;2021-01-11;432;4;1140;12;0.2;0.0
63;2021-01-12;661;1;1801;13;0.3;0.0
63;2021-01-13;873;8;2674;21;0.4;0.0
63;2021-01-14;547;10;3221;31;0.5;0.0
63;2021-01-15;432;5;3653;36;0.6;0.0
63;2021-01-16;157;0;3810;36;0.6;0.0
63;2021-01-17;133;0;3943;36;0.6;0.0
63;2021-01-18;634;3;4577;39;0.7;0.0
63;2021-01-19;868;2;5445;41;0.8;0.0
63;2021-01-20;1069;12;6514;53;1.0;0.0
63;2021-01-21;1018;3;7532;56;1.1;0.0
63;2021-01-22;970;3;8502;59;1.3;0.0
63;2021-01-23;192;0;8694;59;1.3;0.0
63;2021-01-24;165;2;8859;61;1.3;0.0
63;2021-01-25;829;4;9688;65;1.5;0.0
63;2021-01-26;974;2;10662;67;1.6;0.0
63;2021-01-27;1003;5;11665;72;1.8;0.0
63;2021-01-28;1323;69;12988;141;2.0;0.0
63;2021-01-29;1066;66;14054;207;2.1;0.0
63;2021-01-30;68;0;14122;207;2.1;0.0
63;2021-01-31;6;0;14128;207;2.1;0.0
63;2021-02-01;575;181;14703;388;2.2;0.1
63;2021-02-02;886;235;15589;623;2.4;0.1
63;2021-02-03;1475;287;17064;910;2.6;0.1
63;2021-02-04;2120;521;19184;1431;2.9;0.2
63;2021-02-05;1144;272;20328;1703;3.1;0.3
63;2021-02-06;116;0;20444;1703;3.1;0.3
63;2021-02-07;9;1;20453;1704;3.1;0.3
63;2021-02-08;539;405;20992;2109;3.2;0.3
63;2021-02-09;671;433;21663;2542;3.3;0.4
63;2021-02-10;609;602;22272;3144;3.4;0.5
63;2021-02-11;751;473;23023;3617;3.5;0.5
63;2021-02-12;819;808;23842;4425;3.6;0.7
63;2021-02-13;82;1;23924;4426;3.6;0.7
63;2021-02-14;0;65;23924;4491;3.6;0.7
63;2021-02-15;202;782;24126;5273;3.7;0.8
63;2021-02-16;409;1136;24535;6409;3.7;1.0
63;2021-02-17;359;876;24894;7285;3.8;1.1
63;2021-02-18;608;824;25502;8109;3.9;1.2
63;2021-02-19;449;970;25951;9079;3.9;1.4
63;2021-02-20;35;32;25986;9111;3.9;1.4
63;2021-02-21;2;17;25988;9128;3.9;1.4
63;2021-02-22;292;928;26280;10056;4.0;1.5
63;2021-02-23;580;1134;26860;11190;4.1;1.7
63;2021-02-24;696;1415;27556;12605;4.2;1.9
63;2021-02-25;1603;1665;29159;14270;4.4;2.2
63;2021-02-26;1623;1364;30782;15634;4.7;2.4
63;2021-02-27;641;72;31423;15706;4.8;2.4
63;2021-02-28;4;178;31427;15884;4.8;2.4
63;2021-03-01;586;518;32013;16402;4.8;2.5
63;2021-03-02;907;803;32920;17205;5.0;2.6
63;2021-03-03;1036;727;33956;17932;5.1;2.7
63;2021-03-04;1754;502;35710;18434;5.4;2.8
63;2021-03-05;2612;701;38322;19135;5.8;2.9
63;2021-03-06;1551;55;39873;19190;6.0;2.9
63;2021-03-07;512;21;40385;19211;6.1;2.9
63;2021-03-08;967;648;41352;19859;6.3;3.0
63;2021-03-09;1539;1065;42891;20924;6.5;3.2
63;2021-03-10;1655;617;44546;21541;6.7;3.3
63;2021-03-11;3056;898;47602;22439;7.2;3.4
63;2021-03-12;3515;396;51117;22835;7.7;3.5
63;2021-03-13;2050;86;53167;22921;8.1;3.5
63;2021-03-14;61;22;53228;22943;8.1;3.5
63;2021-03-15;1773;374;55001;23317;8.3;3.5
63;2021-03-16;1747;416;56748;23733;8.6;3.6
63;2021-03-17;1642;692;58390;24425;8.8;3.7
63;2021-03-18;1945;753;60335;25178;9.1;3.8
63;2021-03-19;2741;498;63076;25676;9.6;3.9
63;2021-03-20;1122;72;64198;25748;9.7;3.9
63;2021-03-21;50;45;64248;25793;9.7;3.9
63;2021-03-22;1984;261;66232;26054;10.0;3.9
63;2021-03-23;2885;348;69117;26402;10.5;4.0
63;2021-03-24;3224;353;72341;26755;11.0;4.1
63;2021-03-25;4598;398;76939;27153;11.7;4.1
63;2021-03-26;4692;577;81631;27730;12.4;4.2
63;2021-03-27;2457;235;84088;27965;12.7;4.2
63;2021-03-28;1047;83;85135;28048;12.9;4.2
63;2021-03-29;2480;525;87615;28573;13.3;4.3
63;2021-03-30;3283;632;90898;29205;13.8;4.4
63;2021-03-31;2968;761;93866;29966;14.2;4.5
63;2021-04-01;3845;543;97711;30509;14.8;4.6
63;2021-04-02;3484;713;101195;31222;15.3;4.7
63;2021-04-03;1174;181;102369;31403;15.5;4.8
63;2021-04-04;877;29;103246;31432;15.6;4.8
63;2021-04-05;801;86;104047;31518;15.8;4.8
63;2021-04-06;2483;943;106530;32461;16.1;4.9
63;2021-04-07;3208;875;109738;33336;16.6;5.0
63;2021-04-08;4720;1230;114458;34566;17.3;5.2
63;2021-04-09;5314;1012;119772;35578;18.1;5.4
63;2021-04-10;2221;481;121993;36059;18.5;5.5
63;2021-04-11;835;41;122828;36100;18.6;5.5
63;2021-04-12;1591;1315;124419;37415;18.8;5.7
63;2021-04-13;1986;1968;126405;39383;19.1;6.0
63;2021-04-14;2630;1440;129035;40823;19.5;6.2
63;2021-04-15;3809;1548;132844;42371;20.1;6.4
63;2021-04-16;2840;2167;135684;44538;20.6;6.7
63;2021-04-17;1233;673;136917;45211;20.7;6.8
63;2021-04-18;803;67;137720;45278;20.9;6.9
63;2021-04-19;1657;2107;139377;47385;21.1;7.2
63;2021-04-20;1702;2302;141079;49687;21.4;7.5
63;2021-04-21;1514;2413;142593;52100;21.6;7.9
63;2021-04-22;1916;2269;144509;54369;21.9;8.2
63;2021-04-23;2019;3115;146528;57484;22.2;8.7
63;2021-04-24;1192;1128;147720;58612;22.4;8.9
63;2021-04-25;554;412;148274;59024;22.5;8.9
63;2021-04-26;1438;2242;149712;61266;22.7;9.3
63;2021-04-27;2326;2616;152038;63882;23.0;9.7
63;2021-04-28;2345;3170;154383;67052;23.4;10.2
63;2021-04-29;2882;2841;157265;69893;23.8;10.6
63;2021-04-30;2862;2824;160127;72717;24.3;11.0
63;2021-05-01;1127;1052;161254;73769;24.4;11.2
63;2021-05-02;897;640;162151;74409;24.6;11.3
63;2021-05-03;2685;2253;164836;76662;25.0;11.6
63;2021-05-04;2877;2699;167713;79361;25.4;12.0
63;2021-05-05;2939;3126;170652;82487;25.8;12.5
63;2021-05-06;3673;3060;174325;85547;26.4;13.0
63;2021-05-07;4032;3546;178357;89093;27.0;13.5
63;2021-05-08;2002;655;180359;89748;27.3;13.6
63;2021-05-09;1802;608;182161;90356;27.6;13.7
63;2021-05-10;4194;2765;186355;93121;28.2;14.1
63;2021-05-11;5339;2769;191694;95890;29.0;14.5
63;2021-05-12;5274;2914;196968;98804;29.8;15.0
63;2021-05-13;4136;700;201104;99504;30.5;15.1
63;2021-05-14;4772;1514;205876;101018;31.2;15.3
63;2021-05-15;3727;986;209603;102004;31.7;15.4
63;2021-05-16;3521;448;213124;102452;32.3;15.5
63;2021-05-17;3902;1992;217026;104444;32.9;15.8
63;2021-05-18;5124;1615;222150;106059;33.6;16.1
63;2021-05-19;5229;1629;227379;107688;34.4;16.3
63;2021-05-20;6806;2092;234185;109780;35.5;16.6
63;2021-05-21;6256;2334;240441;112114;36.4;17.0
63;2021-05-22;3352;848;243793;112962;36.9;17.1
63;2021-05-23;2388;245;246181;113207;37.3;17.1
63;2021-05-24;2643;581;248824;113788;37.7;17.2
63;2021-05-25;4270;2646;253094;116434;38.3;17.6
63;2021-05-26;5452;2422;258546;118856;39.2;18.0
63;2021-05-27;6502;2801;265048;121657;40.1;18.4
63;2021-05-28;5422;3906;270470;125563;41.0;19.0
63;2021-05-29;3361;1503;273831;127066;41.5;19.2
63;2021-05-30;1579;217;275410;127283;41.7;19.3
63;2021-05-31;4157;2288;279567;129571;42.3;19.6
63;2021-06-01;3805;2962;283372;132533;42.9;20.1
63;2021-06-02;3886;2535;287258;135068;43.5;20.5
63;2021-06-03;4902;3142;292160;138210;44.3;20.9
63;2021-06-04;5100;3624;297260;141834;45.0;21.5
63;2021-06-05;2816;1747;300076;143581;45.4;21.7
63;2021-06-06;1309;698;301385;144279;45.6;21.9
63;2021-06-07;3163;2519;304548;146798;46.1;22.2
63;2021-06-08;2882;2755;307430;149553;46.6;22.7
63;2021-06-09;3025;2271;310455;151824;47.0;23.0
63;2021-06-10;3226;2691;313681;154515;47.5;23.4
63;2021-06-11;3099;4047;316780;158562;48.0;24.0
63;2021-06-12;1640;1969;318420;160531;48.2;24.3
63;2021-06-13;482;1098;318902;161629;48.3;24.5
63;2021-06-14;1824;3472;320726;165101;48.6;25.0
63;2021-06-15;2210;3480;322936;168581;48.9;25.5
63;2021-06-16;2576;3315;325512;171896;49.3;26.0
63;2021-06-17;2398;4316;327910;176212;49.7;26.7
63;2021-06-18;2480;5827;330390;182039;50.0;27.6
63;2021-06-19;1643;2835;332033;184874;50.3;28.0
63;2021-06-20;678;2441;332711;187315;50.4;28.4
63;2021-06-21;1272;5389;333983;192704;50.6;29.2
63;2021-06-22;1233;5539;335216;198243;50.8;30.0
63;2021-06-23;1531;4764;336747;203007;51.0;30.7
63;2021-06-24;1925;5383;338672;208390;51.3;31.6
63;2021-06-25;1751;5899;340423;214289;51.6;32.5
63;2021-06-26;1073;3352;341496;217641;51.7;33.0
63;2021-06-27;712;3487;342208;221128;51.8;33.5
63;2021-06-28;1136;5663;343344;226791;52.0;34.3
63;2021-06-29;1226;5160;344570;231951;52.2;35.1
63;2021-06-30;1606;5294;346176;237245;52.4;35.9
63;2021-07-01;1928;8069;348104;245314;52.7;37.2
63;2021-07-02;2061;6540;350165;251854;53.0;38.1
63;2021-07-03;965;2929;351130;254783;53.2;38.6
63;2021-07-04;1066;1885;352196;256668;53.3;38.9
63;2021-07-05;1540;6280;353736;262948;53.6;39.8
63;2021-07-06;1609;4808;355345;267756;53.8;40.6
63;2021-07-07;1973;4089;357318;271845;54.1;41.2
63;2021-07-08;2204;4587;359522;276432;54.5;41.9
63;2021-07-09;1911;5720;361433;282152;54.7;42.7
63;2021-07-10;1534;3415;362967;285567;55.0;43.3
63;2021-07-11;910;1538;363877;287105;55.1;43.5
63;2021-07-12;1597;8702;365474;295807;55.4;44.8
63;2021-07-13;3598;6134;369072;301941;55.9;45.7
63;2021-07-14;3618;1790;372690;303731;56.4;46.0
63;2021-07-15;4415;5035;377105;308766;57.1;46.8
63;2021-07-16;4693;5788;381798;314554;57.8;47.6
63;2021-07-17;3012;2473;384810;317027;58.3;48.0
63;2021-07-18;2825;1091;387635;318118;58.7;48.2
63;2021-07-19;4002;4848;391637;322966;59.3;48.9
63;2021-07-20;4737;5460;396374;328426;60.0;49.7
63;2021-07-21;4789;3979;401163;332405;60.8;50.3
63;2021-07-22;5509;4402;406672;336807;61.6;51.0
63;2021-07-23;5161;4652;411833;341459;62.4;51.7
63;2021-07-24;3679;1952;415512;343411;62.9;52.0
63;2021-07-25;3065;1438;418577;344849;63.4;52.2
63;2021-07-26;4040;3230;422617;348079;64.0;52.7
63;2021-07-27;3933;3165;426550;351244;64.6;53.2
63;2021-07-28;3851;2716;430401;353960;65.2;53.6
63;2021-07-29;4453;3159;434854;357119;65.9;54.1
63;2021-07-30;3807;3575;438661;360694;66.4;54.6
63;2021-07-31;2161;1721;440822;362415;66.8;54.9
63;2021-08-01;1197;837;442019;363252;66.9;55.0
63;2021-08-02;2227;3067;444246;366319;67.3;55.5
63;2021-08-03;2728;3255;446974;369574;67.7;56.0
63;2021-08-04;2808;3245;449782;372819;68.1;56.5
63;2021-08-05;2444;3481;452226;376300;68.5;57.0
63;2021-08-06;2352;4153;454578;380453;68.9;57.6
63;2021-08-07;1305;2808;455883;383261;69.0;58.0
63;2021-08-08;324;1205;456207;384466;69.1;58.2
63;2021-08-09;1849;4210;458056;388676;69.4;58.9
63;2021-08-10;2218;3994;460274;392670;69.7;59.5
63;2021-08-11;2100;3627;462374;396297;70.0;60.0
63;2021-08-12;1855;4620;464229;400917;70.3;60.7
63;2021-08-13;1677;4009;465906;404926;70.6;61.3
63;2021-08-14;842;3239;466748;408165;70.7;61.8
63;2021-08-15;184;1451;466932;409616;70.7;62.0
63;2021-08-16;1171;4396;468103;414012;70.9;62.7
63;2021-08-17;1601;4052;469704;418064;71.1;63.3
63;2021-08-18;1452;3305;471156;421369;71.4;63.8
63;2021-08-19;1322;3443;472478;424812;71.6;64.3
63;2021-08-20;1387;3712;473865;428524;71.8;64.9
63;2021-08-21;674;2166;474539;430690;71.9;65.2
63;2021-08-22;212;1092;474751;431782;71.9;65.4
63;2021-08-23;1075;3591;475826;435373;72.1;65.9
63;2021-08-24;1091;2990;476917;438363;72.2;66.4
63;2021-08-25;1005;2787;477922;441150;72.4;66.8
63;2021-08-26;1130;2708;479052;443858;72.6;67.2
63;2021-08-27;1149;3162;480201;447020;72.7;67.7
63;2021-08-28;698;1709;480899;448729;72.8;68.0
63;2021-08-29;107;577;481006;449306;72.9;68.1
63;2021-08-30;790;2398;481796;451704;73.0;68.4
63;2021-08-31;992;2472;482788;454176;73.1;68.8
63;2021-09-01;942;1867;483730;456043;73.3;69.1
63;2021-09-02;820;1769;484550;457812;73.4;69.3
63;2021-09-03;905;2262;485455;460074;73.5;69.7
63;2021-09-04;710;1411;486165;461485;73.6;69.9
63;2021-09-05;80;258;486245;461743;73.6;69.9
63;2021-09-06;561;1144;486806;462887;73.7;70.1
63;2021-09-07;660;1343;487466;464230;73.8;70.3
63;2021-09-08;705;1457;488171;465687;73.9;70.5
63;2021-09-09;595;1163;488766;466850;74.0;70.7
63;2021-09-10;732;1645;489498;468495;74.1;71.0
63;2021-09-11;459;998;489957;469493;74.2;71.1
63;2021-09-12;51;144;490008;469637;74.2;71.1
63;2021-09-13;457;930;490465;470567;74.3;71.3
63;2021-09-14;530;814;490995;471381;74.4;71.4
63;2021-09-15;634;1288;491629;472669;74.5;71.6
63;2021-09-16;477;872;492106;473541;74.5;71.7
63;2021-09-17;474;1261;492580;474802;74.6;71.9
63;2021-09-18;319;992;492899;475794;74.7;72.1
63;2021-09-19;44;97;492943;475891;74.7;72.1
63;2021-09-20;365;707;493308;476598;74.7;72.2
63;2021-09-21;412;663;493720;477261;74.8;72.3
63;2021-09-22;401;1113;494121;478374;74.8;72.5
63;2021-09-23;299;666;494420;479040;74.9;72.6
63;2021-09-24;484;1181;494904;480221;75.0;72.7
63;2021-09-25;253;816;495157;481037;75.0;72.9
63;2021-09-26;26;100;495183;481137;75.0;72.9
63;2021-09-27;317;643;495500;481780;75.0;73.0
63;2021-09-28;292;617;495792;482397;75.1;73.1
63;2021-09-29;304;734;496096;483131;75.1;73.2
63;2021-09-30;295;657;496391;483788;75.2;73.3
63;2021-10-01;472;856;496863;484644;75.3;73.4
63;2021-10-02;273;558;497136;485202;75.3;73.5
63;2021-10-03;37;69;497173;485271;75.3;73.5
63;2021-10-04;208;401;497381;485672;75.3;73.6
63;2021-10-05;260;456;497641;486128;75.4;73.6
63;2021-10-06;332;603;497973;486731;75.4;73.7
63;2021-10-07;244;461;498217;487192;75.5;73.8
63;2021-10-08;408;711;498625;487903;75.5;73.9
63;2021-10-09;240;417;498865;488320;75.6;74.0
63;2021-10-10;36;57;498901;488377;75.6;74.0
63;2021-10-11;206;431;499107;488808;75.6;74.0
63;2021-10-12;188;380;499295;489188;75.6;74.1
63;2021-10-13;311;549;499606;489737;75.7;74.2
63;2021-10-14;239;336;499845;490073;75.7;74.2
64;2020-12-27;1;0;1;0;0.0;0.0
64;2020-12-28;2;0;3;0;0.0;0.0
64;2020-12-29;0;0;3;0;0.0;0.0
64;2020-12-30;1;0;4;0;0.0;0.0
64;2020-12-31;0;0;4;0;0.0;0.0
64;2021-01-01;1;0;5;0;0.0;0.0
64;2021-01-02;0;0;5;0;0.0;0.0
64;2021-01-03;0;0;5;0;0.0;0.0
64;2021-01-04;29;0;34;0;0.0;0.0
64;2021-01-05;25;0;59;0;0.0;0.0
64;2021-01-06;189;0;248;0;0.0;0.0
64;2021-01-07;842;1;1090;1;0.2;0.0
64;2021-01-08;880;3;1970;4;0.3;0.0
64;2021-01-09;55;0;2025;4;0.3;0.0
64;2021-01-10;2;0;2027;4;0.3;0.0
64;2021-01-11;543;0;2570;4;0.4;0.0
64;2021-01-12;760;4;3330;8;0.5;0.0
64;2021-01-13;866;3;4196;11;0.6;0.0
64;2021-01-14;1046;6;5242;17;0.8;0.0
64;2021-01-15;930;5;6172;22;0.9;0.0
64;2021-01-16;70;0;6242;22;0.9;0.0
64;2021-01-17;8;2;6250;24;0.9;0.0
64;2021-01-18;942;8;7192;32;1.1;0.0
64;2021-01-19;1448;4;8640;36;1.3;0.0
64;2021-01-20;1618;3;10258;39;1.5;0.0
64;2021-01-21;2603;2;12861;41;1.9;0.0
64;2021-01-22;1651;4;14512;45;2.1;0.0
64;2021-01-23;525;1;15037;46;2.2;0.0
64;2021-01-24;89;0;15126;46;2.2;0.0
64;2021-01-25;974;9;16100;55;2.4;0.0
64;2021-01-26;1358;22;17458;77;2.6;0.0
64;2021-01-27;1241;119;18699;196;2.7;0.0
64;2021-01-28;1652;631;20351;827;3.0;0.1
64;2021-01-29;975;651;21326;1478;3.1;0.2
64;2021-01-30;469;59;21795;1537;3.2;0.2
64;2021-01-31;93;0;21888;1537;3.2;0.2
64;2021-02-01;675;311;22563;1848;3.3;0.3
64;2021-02-02;1134;554;23697;2402;3.5;0.4
64;2021-02-03;1044;646;24741;3048;3.6;0.4
64;2021-02-04;1028;535;25769;3583;3.8;0.5
64;2021-02-05;869;456;26638;4039;3.9;0.6
64;2021-02-06;501;32;27139;4071;4.0;0.6
64;2021-02-07;131;5;27270;4076;4.0;0.6
64;2021-02-08;769;311;28039;4387;4.1;0.6
64;2021-02-09;949;714;28988;5101;4.2;0.7
64;2021-02-10;916;790;29904;5891;4.4;0.9
64;2021-02-11;1199;1508;31103;7399;4.6;1.1
64;2021-02-12;1076;1064;32179;8463;4.7;1.2
64;2021-02-13;223;314;32402;8777;4.7;1.3
64;2021-02-14;38;48;32440;8825;4.7;1.3
64;2021-02-15;223;1132;32663;9957;4.8;1.5
64;2021-02-16;261;1405;32924;11362;4.8;1.7
64;2021-02-17;291;1245;33215;12607;4.9;1.8
64;2021-02-18;509;1714;33724;14321;4.9;2.1
64;2021-02-19;413;1288;34137;15609;5.0;2.3
64;2021-02-20;119;435;34256;16044;5.0;2.3
64;2021-02-21;20;83;34276;16127;5.0;2.4
64;2021-02-22;478;985;34754;17112;5.1;2.5
64;2021-02-23;722;1145;35476;18257;5.2;2.7
64;2021-02-24;731;1014;36207;19271;5.3;2.8
64;2021-02-25;1094;955;37301;20226;5.5;3.0
64;2021-02-26;1216;915;38517;21141;5.6;3.1
64;2021-02-27;864;405;39381;21546;5.8;3.2
64;2021-02-28;42;82;39423;21628;5.8;3.2
64;2021-03-01;767;799;40190;22427;5.9;3.3
64;2021-03-02;1078;918;41268;23345;6.0;3.4
64;2021-03-03;1252;1000;42520;24345;6.2;3.6
64;2021-03-04;1883;1184;44403;25529;6.5;3.7
64;2021-03-05;2199;1078;46602;26607;6.8;3.9
64;2021-03-06;1543;518;48145;27125;7.0;4.0
64;2021-03-07;595;113;48740;27238;7.1;4.0
64;2021-03-08;1534;765;50274;28003;7.4;4.1
64;2021-03-09;2071;849;52345;28852;7.7;4.2
64;2021-03-10;2082;765;54427;29617;8.0;4.3
64;2021-03-11;2976;1078;57403;30695;8.4;4.5
64;2021-03-12;3489;608;60892;31303;8.9;4.6
64;2021-03-13;2259;171;63151;31474;9.2;4.6
64;2021-03-14;233;15;63384;31489;9.3;4.6
64;2021-03-15;2337;234;65721;31723;9.6;4.6
64;2021-03-16;2002;269;67723;31992;9.9;4.7
64;2021-03-17;2070;241;69793;32233;10.2;4.7
64;2021-03-18;2463;209;72256;32442;10.6;4.7
64;2021-03-19;3014;288;75270;32730;11.0;4.8
64;2021-03-20;2470;95;77740;32825;11.4;4.8
64;2021-03-21;1282;28;79022;32853;11.6;4.8
64;2021-03-22;2589;556;81611;33409;11.9;4.9
64;2021-03-23;3197;650;84808;34059;12.4;5.0
64;2021-03-24;3564;708;88372;34767;12.9;5.1
64;2021-03-25;4350;805;92722;35572;13.6;5.2
64;2021-03-26;4429;712;97151;36284;14.2;5.3
64;2021-03-27;2974;437;100125;36721;14.7;5.4
64;2021-03-28;521;56;100646;36777;14.7;5.4
64;2021-03-29;3028;891;103674;37668;15.2;5.5
64;2021-03-30;4135;874;107809;38542;15.8;5.6
64;2021-03-31;3594;796;111403;39338;16.3;5.8
64;2021-04-01;4787;944;116190;40282;17.0;5.9
64;2021-04-02;4444;747;120634;41029;17.7;6.0
64;2021-04-03;2061;588;122695;41617;18.0;6.1
64;2021-04-04;310;50;123005;41667;18.0;6.1
64;2021-04-05;1689;144;124694;41811;18.3;6.1
64;2021-04-06;3647;1394;128341;43205;18.8;6.3
64;2021-04-07;3946;1518;132287;44723;19.4;6.5
64;2021-04-08;5192;1602;137479;46325;20.1;6.8
64;2021-04-09;5899;1648;143378;47973;21.0;7.0
64;2021-04-10;3222;1055;146600;49028;21.5;7.2
64;2021-04-11;448;253;147048;49281;21.5;7.2
64;2021-04-12;4047;1869;151095;51150;22.1;7.5
64;2021-04-13;4466;2171;155561;53321;22.8;7.8
64;2021-04-14;4091;2143;159652;55464;23.4;8.1
64;2021-04-15;4394;2300;164046;57764;24.0;8.5
64;2021-04-16;4300;2261;168346;60025;24.6;8.8
64;2021-04-17;2479;1504;170825;61529;25.0;9.0
64;2021-04-18;1096;1181;171921;62710;25.2;9.2
64;2021-04-19;2735;2450;174656;65160;25.6;9.5
64;2021-04-20;3208;2434;177864;67594;26.0;9.9
64;2021-04-21;3225;2567;181089;70161;26.5;10.3
64;2021-04-22;3389;2787;184478;72948;27.0;10.7
64;2021-04-23;3435;2617;187913;75565;27.5;11.1
64;2021-04-24;2068;1591;189981;77156;27.8;11.3
64;2021-04-25;290;237;190271;77393;27.9;11.3
64;2021-04-26;2661;2656;192932;80049;28.2;11.7
64;2021-04-27;3060;3137;195992;83186;28.7;12.2
64;2021-04-28;3604;3066;199596;86252;29.2;12.6
64;2021-04-29;4650;3465;204246;89717;29.9;13.1
64;2021-04-30;4085;3616;208331;93333;30.5;13.7
64;2021-05-01;1486;1032;209817;94365;30.7;13.8
64;2021-05-02;446;325;210263;94690;30.8;13.9
64;2021-05-03;2910;3528;213173;98218;31.2;14.4
64;2021-05-04;3646;4001;216819;102219;31.7;15.0
64;2021-05-05;3358;4011;220177;106230;32.2;15.5
64;2021-05-06;4110;3992;224287;110222;32.8;16.1
64;2021-05-07;3922;4196;228209;114418;33.4;16.7
64;2021-05-08;2623;1236;230832;115654;33.8;16.9
64;2021-05-09;722;305;231554;115959;33.9;17.0
64;2021-05-10;2862;4238;234416;120197;34.3;17.6
64;2021-05-11;4183;4150;238599;124347;34.9;18.2
64;2021-05-12;4489;3945;243088;128292;35.6;18.8
64;2021-05-13;3198;887;246286;129179;36.1;18.9
64;2021-05-14;5153;3150;251439;132329;36.8;19.4
64;2021-05-15;3526;1865;254965;134194;37.3;19.6
64;2021-05-16;498;225;255463;134419;37.4;19.7
64;2021-05-17;4191;2391;259654;136810;38.0;20.0
64;2021-05-18;5164;2305;264818;139115;38.8;20.4
64;2021-05-19;4980;2165;269798;141280;39.5;20.7
64;2021-05-20;5567;2158;275365;143438;40.3;21.0
64;2021-05-21;5268;2249;280633;145687;41.1;21.3
64;2021-05-22;3581;1508;284214;147195;41.6;21.5
64;2021-05-23;431;206;284645;147401;41.7;21.6
64;2021-05-24;2996;1232;287641;148633;42.1;21.8
64;2021-05-25;4332;2851;291973;151484;42.7;22.2
64;2021-05-26;4359;2716;296332;154200;43.4;22.6
64;2021-05-27;5283;3156;301615;157356;44.1;23.0
64;2021-05-28;4620;3439;306235;160795;44.8;23.5
64;2021-05-29;2810;2114;309045;162909;45.2;23.8
64;2021-05-30;439;203;309484;163112;45.3;23.9
64;2021-05-31;3890;3662;313374;166774;45.9;24.4
64;2021-06-01;5335;3570;318709;170344;46.7;24.9
64;2021-06-02;4931;3176;323640;173520;47.4;25.4
64;2021-06-03;6365;3263;330005;176783;48.3;25.9
64;2021-06-04;5150;4558;335155;181341;49.1;26.5
64;2021-06-05;3482;2524;338637;183865;49.6;26.9
64;2021-06-06;2014;330;340651;184195;49.9;27.0
64;2021-06-07;4128;4333;344779;188528;50.5;27.6
64;2021-06-08;5151;4126;349930;192654;51.2;28.2
64;2021-06-09;5151;3660;355081;196314;52.0;28.7
64;2021-06-10;6180;3145;361261;199459;52.9;29.2
64;2021-06-11;5585;4880;366846;204339;53.7;29.9
64;2021-06-12;3950;2336;370796;206675;54.3;30.3
64;2021-06-13;1555;394;372351;207069;54.5;30.3
64;2021-06-14;3669;4793;376020;211862;55.0;31.0
64;2021-06-15;4572;4708;380592;216570;55.7;31.7
64;2021-06-16;4470;4664;385062;221234;56.4;32.4
64;2021-06-17;3641;4307;388703;225541;56.9;33.0
64;2021-06-18;4421;5170;393124;230711;57.5;33.8
64;2021-06-19;2984;3282;396108;233993;58.0;34.3
64;2021-06-20;881;539;396989;234532;58.1;34.3
64;2021-06-21;2314;5125;399303;239657;58.4;35.1
64;2021-06-22;2555;5726;401858;245383;58.8;35.9
64;2021-06-23;3104;5482;404962;250865;59.3;36.7
64;2021-06-24;2719;3810;407681;254675;59.7;37.3
64;2021-06-25;2900;6436;410581;261111;60.1;38.2
64;2021-06-26;1798;3835;412379;264946;60.4;38.8
64;2021-06-27;493;713;412872;265659;60.4;38.9
64;2021-06-28;1935;6070;414807;271729;60.7;39.8
64;2021-06-29;1967;6265;416774;277994;61.0;40.7
64;2021-06-30;2255;6000;419029;283994;61.3;41.6
64;2021-07-01;2406;5342;421435;289336;61.7;42.4
64;2021-07-02;2307;6406;423742;295742;62.0;43.3
64;2021-07-03;1263;3783;425005;299525;62.2;43.8
64;2021-07-04;411;847;425416;300372;62.3;44.0
64;2021-07-05;1376;5405;426792;305777;62.5;44.8
64;2021-07-06;1994;6152;428786;311929;62.8;45.7
64;2021-07-07;2062;5750;430848;317679;63.1;46.5
64;2021-07-08;1804;4397;432652;322076;63.3;47.1
64;2021-07-09;1825;6536;434477;328612;63.6;48.1
64;2021-07-10;1171;3881;435648;332493;63.8;48.7
64;2021-07-11;253;860;435901;333353;63.8;48.8
64;2021-07-12;1501;6086;437402;339439;64.0;49.7
64;2021-07-13;2366;7248;439768;346687;64.4;50.7
64;2021-07-14;2368;3407;442136;350094;64.7;51.2
64;2021-07-15;2105;5480;444241;355574;65.0;52.0
64;2021-07-16;2848;6777;447089;362351;65.4;53.0
64;2021-07-17;2338;4586;449427;366937;65.8;53.7
64;2021-07-18;716;2051;450143;368988;65.9;54.0
64;2021-07-19;2348;6122;452491;375110;66.2;54.9
64;2021-07-20;3130;6560;455621;381670;66.7;55.9
64;2021-07-21;3345;6046;458966;387716;67.2;56.8
64;2021-07-22;3808;5718;462774;393434;67.7;57.6
64;2021-07-23;3724;5620;466498;399054;68.3;58.4
64;2021-07-24;2553;4431;469051;403485;68.7;59.1
64;2021-07-25;754;1062;469805;404547;68.8;59.2
64;2021-07-26;3085;5131;472890;409678;69.2;60.0
64;2021-07-27;4261;5146;477151;414824;69.8;60.7
64;2021-07-28;4315;4598;481466;419422;70.5;61.4
64;2021-07-29;5518;3905;486984;423327;71.3;62.0
64;2021-07-30;5146;4234;492130;427561;72.0;62.6
64;2021-07-31;3171;3346;495301;430907;72.5;63.1
64;2021-08-01;1145;589;496446;431496;72.7;63.2
64;2021-08-02;4369;2632;500815;434128;73.3;63.5
64;2021-08-03;4557;3176;505372;437304;74.0;64.0
64;2021-08-04;4133;3000;509505;440304;74.6;64.5
64;2021-08-05;4037;2614;513542;442918;75.2;64.8
64;2021-08-06;3843;3338;517385;446256;75.7;65.3
64;2021-08-07;2481;2701;519866;448957;76.1;65.7
64;2021-08-08;492;609;520358;449566;76.2;65.8
64;2021-08-09;2740;3201;523098;452767;76.6;66.3
64;2021-08-10;3354;3437;526452;456204;77.1;66.8
64;2021-08-11;3068;3264;529520;459468;77.5;67.3
64;2021-08-12;3191;3308;532711;462776;78.0;67.7
64;2021-08-13;2575;3660;535286;466436;78.4;68.3
64;2021-08-14;1633;2684;536919;469120;78.6;68.7
64;2021-08-15;208;691;537127;469811;78.6;68.8
64;2021-08-16;2102;3236;539229;473047;78.9;69.2
64;2021-08-17;2299;3708;541528;476755;79.3;69.8
64;2021-08-18;2044;3521;543572;480276;79.6;70.3
64;2021-08-19;1938;3525;545510;483801;79.8;70.8
64;2021-08-20;1578;3975;547088;487776;80.1;71.4
64;2021-08-21;975;2883;548063;490659;80.2;71.8
64;2021-08-22;160;895;548223;491554;80.2;72.0
64;2021-08-23;1269;3239;549492;494793;80.4;72.4
64;2021-08-24;1378;4596;550870;499389;80.6;73.1
64;2021-08-25;1260;3747;552130;503136;80.8;73.6
64;2021-08-26;1111;3532;553241;506668;81.0;74.2
64;2021-08-27;1189;4230;554430;510898;81.2;74.8
64;2021-08-28;735;2496;555165;513394;81.3;75.1
64;2021-08-29;90;533;555255;513927;81.3;75.2
64;2021-08-30;989;3518;556244;517445;81.4;75.7
64;2021-08-31;990;3761;557234;521206;81.6;76.3
64;2021-09-01;932;2912;558166;524118;81.7;76.7
64;2021-09-02;900;2814;559066;526932;81.8;77.1
64;2021-09-03;874;2746;559940;529678;82.0;77.5
64;2021-09-04;698;2055;560638;531733;82.1;77.8
64;2021-09-05;74;206;560712;531939;82.1;77.9
64;2021-09-06;533;2130;561245;534069;82.2;78.2
64;2021-09-07;717;1937;561962;536006;82.3;78.5
64;2021-09-08;737;2539;562699;538545;82.4;78.8
64;2021-09-09;482;1720;563181;540265;82.4;79.1
64;2021-09-10;744;2057;563925;542322;82.5;79.4
64;2021-09-11;594;1973;564519;544295;82.6;79.7
64;2021-09-12;62;167;564581;544462;82.6;79.7
64;2021-09-13;441;1405;565022;545867;82.7;79.9
64;2021-09-14;489;1089;565511;546956;82.8;80.1
64;2021-09-15;690;1747;566201;548703;82.9;80.3
64;2021-09-16;486;844;566687;549547;82.9;80.4
64;2021-09-17;566;1353;567253;550900;83.0;80.6
64;2021-09-18;332;1258;567585;552158;83.1;80.8
64;2021-09-19;18;42;567603;552200;83.1;80.8
64;2021-09-20;248;481;567851;552681;83.1;80.9
64;2021-09-21;433;954;568284;553635;83.2;81.0
64;2021-09-22;384;1426;568668;555061;83.2;81.2
64;2021-09-23;278;730;568946;555791;83.3;81.4
64;2021-09-24;398;986;569344;556777;83.3;81.5
64;2021-09-25;298;1033;569642;557810;83.4;81.7
64;2021-09-26;0;4;569642;557814;83.4;81.7
64;2021-09-27;234;567;569876;558381;83.4;81.7
64;2021-09-28;260;671;570136;559052;83.5;81.8
64;2021-09-29;342;984;570478;560036;83.5;82.0
64;2021-09-30;259;440;570737;560476;83.5;82.0
64;2021-10-01;308;727;571045;561203;83.6;82.1
64;2021-10-02;214;566;571259;561769;83.6;82.2
64;2021-10-03;0;2;571259;561771;83.6;82.2
64;2021-10-04;240;426;571499;562197;83.7;82.3
64;2021-10-05;315;634;571814;562831;83.7;82.4
64;2021-10-06;409;911;572223;563742;83.8;82.5
64;2021-10-07;203;502;572426;564244;83.8;82.6
64;2021-10-08;315;706;572741;564950;83.8;82.7
64;2021-10-09;247;403;572988;565353;83.9;82.8
64;2021-10-10;0;8;572988;565361;83.9;82.8
64;2021-10-11;141;256;573129;565617;83.9;82.8
64;2021-10-12;267;611;573396;566228;83.9;82.9
64;2021-10-13;353;586;573749;566814;84.0;83.0
64;2021-10-14;200;255;573949;567069;84.0;83.0
65;2020-12-27;0;0;0;0;0.0;0.0
65;2020-12-28;1;1;1;1;0.0;0.0
65;2020-12-29;0;0;1;1;0.0;0.0
65;2020-12-30;0;0;1;1;0.0;0.0
65;2020-12-31;0;0;1;1;0.0;0.0
65;2021-01-01;1;1;2;2;0.0;0.0
65;2021-01-02;0;0;2;2;0.0;0.0
65;2021-01-03;0;0;2;2;0.0;0.0
65;2021-01-04;0;0;2;2;0.0;0.0
65;2021-01-05;1;0;3;2;0.0;0.0
65;2021-01-06;3;0;6;2;0.0;0.0
65;2021-01-07;168;0;174;2;0.1;0.0
65;2021-01-08;253;1;427;3;0.2;0.0
65;2021-01-09;177;2;604;5;0.3;0.0
65;2021-01-10;1;0;605;5;0.3;0.0
65;2021-01-11;275;3;880;8;0.4;0.0
65;2021-01-12;271;1;1151;9;0.5;0.0
65;2021-01-13;587;1;1738;10;0.8;0.0
65;2021-01-14;581;7;2319;17;1.0;0.0
65;2021-01-15;527;2;2846;19;1.3;0.0
65;2021-01-16;221;2;3067;21;1.4;0.0
65;2021-01-17;0;0;3067;21;1.4;0.0
65;2021-01-18;554;5;3621;26;1.6;0.0
65;2021-01-19;571;2;4192;28;1.8;0.0
65;2021-01-20;585;6;4777;34;2.1;0.0
65;2021-01-21;585;0;5362;34;2.4;0.0
65;2021-01-22;598;2;5960;36;2.6;0.0
65;2021-01-23;174;1;6134;37;2.7;0.0
65;2021-01-24;3;1;6137;38;2.7;0.0
65;2021-01-25;551;4;6688;42;2.9;0.0
65;2021-01-26;883;2;7571;44;3.3;0.0
65;2021-01-27;592;14;8163;58;3.6;0.0
65;2021-01-28;509;71;8672;129;3.8;0.1
65;2021-01-29;426;138;9098;267;4.0;0.1
65;2021-01-30;182;74;9280;341;4.1;0.2
65;2021-01-31;15;0;9295;341;4.1;0.2
65;2021-02-01;351;95;9646;436;4.3;0.2
65;2021-02-02;432;190;10078;626;4.4;0.3
65;2021-02-03;463;245;10541;871;4.6;0.4
65;2021-02-04;310;330;10851;1201;4.8;0.5
65;2021-02-05;284;362;11135;1563;4.9;0.7
65;2021-02-06;99;99;11234;1662;5.0;0.7
65;2021-02-07;10;0;11244;1662;5.0;0.7
65;2021-02-08;426;221;11670;1883;5.1;0.8
65;2021-02-09;272;379;11942;2262;5.3;1.0
65;2021-02-10;298;269;12240;2531;5.4;1.1
65;2021-02-11;320;275;12560;2806;5.5;1.2
65;2021-02-12;277;229;12837;3035;5.7;1.3
65;2021-02-13;126;97;12963;3132;5.7;1.4
65;2021-02-14;3;16;12966;3148;5.7;1.4
65;2021-02-15;203;412;13169;3560;5.8;1.6
65;2021-02-16;489;578;13658;4138;6.0;1.8
65;2021-02-17;231;500;13889;4638;6.1;2.0
65;2021-02-18;284;581;14173;5219;6.2;2.3
65;2021-02-19;156;478;14329;5697;6.3;2.5
65;2021-02-20;53;158;14382;5855;6.3;2.6
65;2021-02-21;3;48;14385;5903;6.3;2.6
65;2021-02-22;167;539;14552;6442;6.4;2.8
65;2021-02-23;249;527;14801;6969;6.5;3.1
65;2021-02-24;231;639;15032;7608;6.6;3.4
65;2021-02-25;215;183;15247;7791;6.7;3.4
65;2021-02-26;349;772;15596;8563;6.9;3.8
65;2021-02-27;109;204;15705;8767;6.9;3.9
65;2021-02-28;1;0;15706;8767;6.9;3.9
65;2021-03-01;379;373;16085;9140;7.1;4.0
65;2021-03-02;455;364;16540;9504;7.3;4.2
65;2021-03-03;381;391;16921;9895;7.5;4.4
65;2021-03-04;696;332;17617;10227;7.8;4.5
65;2021-03-05;679;286;18296;10513;8.1;4.6
65;2021-03-06;1187;89;19483;10602;8.6;4.7
65;2021-03-07;257;12;19740;10614;8.7;4.7
65;2021-03-08;412;345;20152;10959;8.9;4.8
65;2021-03-09;670;339;20822;11298;9.2;5.0
65;2021-03-10;624;371;21446;11669;9.5;5.1
65;2021-03-11;778;362;22224;12031;9.8;5.3
65;2021-03-12;1060;192;23284;12223;10.3;5.4
65;2021-03-13;356;93;23640;12316;10.4;5.4
65;2021-03-14;3;30;23643;12346;10.4;5.4
65;2021-03-15;816;188;24459;12534;10.8;5.5
65;2021-03-16;694;221;25153;12755;11.1;5.6
65;2021-03-17;712;209;25865;12964;11.4;5.7
65;2021-03-18;537;236;26402;13200;11.6;5.8
65;2021-03-19;879;164;27281;13364;12.0;5.9
65;2021-03-20;245;46;27526;13410;12.1;5.9
65;2021-03-21;12;2;27538;13412;12.1;5.9
65;2021-03-22;734;154;28272;13566;12.5;6.0
65;2021-03-23;838;369;29110;13935;12.8;6.1
65;2021-03-24;868;254;29978;14189;13.2;6.3
65;2021-03-25;1253;191;31231;14380;13.8;6.3
65;2021-03-26;1225;148;32456;14528;14.3;6.4
65;2021-03-27;1357;96;33813;14624;14.9;6.4
65;2021-03-28;1;2;33814;14626;14.9;6.4
65;2021-03-29;1490;362;35304;14988;15.6;6.6
65;2021-03-30;1357;407;36661;15395;16.2;6.8
65;2021-03-31;1208;372;37869;15767;16.7;7.0
65;2021-04-01;1509;399;39378;16166;17.4;7.1
65;2021-04-02;1685;289;41063;16455;18.1;7.3
65;2021-04-03;247;45;41310;16500;18.2;7.3
65;2021-04-04;4;2;41314;16502;18.2;7.3
65;2021-04-05;158;44;41472;16546;18.3;7.3
65;2021-04-06;1294;494;42766;17040;18.9;7.5
65;2021-04-07;1958;461;44724;17501;19.7;7.7
65;2021-04-08;1644;421;46368;17922;20.4;7.9
65;2021-04-09;1643;472;48011;18394;21.2;8.1
65;2021-04-10;1592;153;49603;18547;21.9;8.2
65;2021-04-11;3;0;49606;18547;21.9;8.2
65;2021-04-12;1352;737;50958;19284;22.5;8.5
65;2021-04-13;1584;595;52542;19879;23.2;8.8
65;2021-04-14;1905;745;54447;20624;24.0;9.1
65;2021-04-15;1701;678;56148;21302;24.8;9.4
65;2021-04-16;1824;530;57972;21832;25.6;9.6
65;2021-04-17;2156;133;60128;21965;26.5;9.7
65;2021-04-18;7;27;60135;21992;26.5;9.7
65;2021-04-19;1337;776;61472;22768;27.1;10.0
65;2021-04-20;1530;711;63002;23479;27.8;10.4
65;2021-04-21;1052;1049;64054;24528;28.2;10.8
65;2021-04-22;1647;729;65701;25257;29.0;11.1
65;2021-04-23;1160;1149;66861;26406;29.5;11.6
65;2021-04-24;1265;612;68126;27018;30.0;11.9
65;2021-04-25;31;15;68157;27033;30.0;11.9
65;2021-04-26;1611;1299;69768;28332;30.8;12.5
65;2021-04-27;1423;1342;71191;29674;31.4;13.1
65;2021-04-28;1731;1026;72922;30700;32.1;13.5
65;2021-04-29;1959;1038;74881;31738;33.0;14.0
65;2021-04-30;1782;926;76663;32664;33.8;14.4
65;2021-05-01;1574;233;78237;32897;34.5;14.5
65;2021-05-02;671;25;78908;32922;34.8;14.5
65;2021-05-03;1280;1620;80188;34542;35.4;15.2
65;2021-05-04;1537;1245;81725;35787;36.0;15.8
65;2021-05-05;1374;1648;83099;37435;36.6;16.5
65;2021-05-06;1558;1177;84657;38612;37.3;17.0
65;2021-05-07;1275;1571;85932;40183;37.9;17.7
65;2021-05-08;1647;443;87579;40626;38.6;17.9
65;2021-05-09;0;88;87579;40714;38.6;17.9
65;2021-05-10;953;1883;88532;42597;39.0;18.8
65;2021-05-11;1061;1808;89593;44405;39.5;19.6
65;2021-05-12;1236;1637;90829;46042;40.0;20.3
65;2021-05-13;1345;171;92174;46213;40.6;20.4
65;2021-05-14;1575;1094;93749;47307;41.3;20.9
65;2021-05-15;1402;509;95151;47816;41.9;21.1
65;2021-05-16;1444;70;96595;47886;42.6;21.1
65;2021-05-17;1036;1614;97631;49500;43.0;21.8
65;2021-05-18;1612;1207;99243;50707;43.8;22.4
65;2021-05-19;1684;1010;100927;51717;44.5;22.8
65;2021-05-20;1845;1053;102772;52770;45.3;23.3
65;2021-05-21;1790;1230;104562;54000;46.1;23.8
65;2021-05-22;1287;639;105849;54639;46.7;24.1
65;2021-05-23;689;32;106538;54671;47.0;24.1
65;2021-05-24;703;77;107241;54748;47.3;24.1
65;2021-05-25;1359;1547;108600;56295;47.9;24.8
65;2021-05-26;1471;1354;110071;57649;48.5;25.4
65;2021-05-27;1622;1464;111693;59113;49.2;26.1
65;2021-05-28;1598;1673;113291;60786;49.9;26.8
65;2021-05-29;1188;1515;114479;62301;50.5;27.5
65;2021-05-30;7;10;114486;62311;50.5;27.5
65;2021-05-31;1323;1298;115809;63609;51.1;28.0
65;2021-06-01;1832;937;117641;64546;51.9;28.5
65;2021-06-02;1574;950;119215;65496;52.6;28.9
65;2021-06-03;1342;1105;120557;66601;53.1;29.4
65;2021-06-04;1790;1560;122347;68161;53.9;30.0
65;2021-06-05;432;1240;122779;69401;54.1;30.6
65;2021-06-06;3;13;122782;69414;54.1;30.6
65;2021-06-07;675;1984;123457;71398;54.4;31.5
65;2021-06-08;956;1534;124413;72932;54.8;32.2
65;2021-06-09;828;1548;125241;74480;55.2;32.8
65;2021-06-10;739;1155;125980;75635;55.5;33.3
65;2021-06-11;909;1802;126889;77437;55.9;34.1
65;2021-06-12;150;640;127039;78077;56.0;34.4
65;2021-06-13;5;7;127044;78084;56.0;34.4
65;2021-06-14;502;2421;127546;80505;56.2;35.5
65;2021-06-15;942;1802;128488;82307;56.6;36.3
65;2021-06-16;1064;1365;129552;83672;57.1;36.9
65;2021-06-17;814;1046;130366;84718;57.5;37.3
65;2021-06-18;1019;1633;131385;86351;57.9;38.1
65;2021-06-19;690;1689;132075;88040;58.2;38.8
65;2021-06-20;2;2;132077;88042;58.2;38.8
65;2021-06-21;735;1941;132812;89983;58.5;39.7
65;2021-06-22;1045;1479;133857;91462;59.0;40.3
65;2021-06-23;1063;1234;134920;92696;59.5;40.9
65;2021-06-24;976;1143;135896;93839;59.9;41.4
65;2021-06-25;831;1967;136727;95806;60.3;42.2
65;2021-06-26;168;1658;136895;97464;60.3;43.0
65;2021-06-27;15;1100;136910;98564;60.4;43.5
65;2021-06-28;444;2301;137354;100865;60.6;44.5
65;2021-06-29;683;1921;138037;102786;60.9;45.3
65;2021-06-30;934;1678;138971;104464;61.3;46.1
65;2021-07-01;605;749;139576;105213;61.5;46.4
65;2021-07-02;1166;1732;140742;106945;62.0;47.1
65;2021-07-03;197;1915;140939;108860;62.1;48.0
65;2021-07-04;416;186;141355;109046;62.3;48.1
65;2021-07-05;641;1992;141996;111038;62.6;49.0
65;2021-07-06;897;2127;142893;113165;63.0;49.9
65;2021-07-07;978;1517;143871;114682;63.4;50.6
65;2021-07-08;328;664;144199;115346;63.6;50.8
65;2021-07-09;550;1594;144749;116940;63.8;51.6
65;2021-07-10;304;956;145053;117896;63.9;52.0
65;2021-07-11;0;0;145053;117896;63.9;52.0
65;2021-07-12;481;2220;145534;120116;64.2;53.0
65;2021-07-13;700;2148;146234;122264;64.5;53.9
65;2021-07-14;214;52;146448;122316;64.6;53.9
65;2021-07-15;1098;1664;147546;123980;65.0;54.7
65;2021-07-16;1186;1884;148732;125864;65.6;55.5
65;2021-07-17;431;541;149163;126405;65.8;55.7
65;2021-07-18;22;11;149185;126416;65.8;55.7
65;2021-07-19;635;1494;149820;127910;66.0;56.4
65;2021-07-20;1447;1704;151267;129614;66.7;57.1
65;2021-07-21;1420;1663;152687;131277;67.3;57.9
65;2021-07-22;2198;1291;154885;132568;68.3;58.4
65;2021-07-23;1623;1791;156508;134359;69.0;59.2
65;2021-07-24;1041;649;157549;135008;69.5;59.5
65;2021-07-25;24;21;157573;135029;69.5;59.5
65;2021-07-26;1142;1246;158715;136275;70.0;60.1
65;2021-07-27;1793;1954;160508;138229;70.8;60.9
65;2021-07-28;1603;1323;162111;139552;71.5;61.5
65;2021-07-29;2900;1140;165011;140692;72.7;62.0
65;2021-07-30;2449;1399;167460;142091;73.8;62.6
65;2021-07-31;2305;356;169765;142447;74.8;62.8
65;2021-08-01;14;16;169779;142463;74.8;62.8
65;2021-08-02;994;835;170773;143298;75.3;63.2
65;2021-08-03;2103;1071;172876;144369;76.2;63.6
65;2021-08-04;1803;642;174679;145011;77.0;63.9
65;2021-08-05;1822;833;176501;145844;77.8;64.3
65;2021-08-06;1666;977;178167;146821;78.5;64.7
65;2021-08-07;730;487;178897;147308;78.9;64.9
65;2021-08-08;2;9;178899;147317;78.9;64.9
65;2021-08-09;705;944;179604;148261;79.2;65.4
65;2021-08-10;1195;1544;180799;149805;79.7;66.0
65;2021-08-11;731;1265;181530;151070;80.0;66.6
65;2021-08-12;777;1085;182307;152155;80.4;67.1
65;2021-08-13;428;1011;182735;153166;80.6;67.5
65;2021-08-14;602;567;183337;153733;80.8;67.8
65;2021-08-15;8;19;183345;153752;80.8;67.8
65;2021-08-16;405;1538;183750;155290;81.0;68.5
65;2021-08-17;738;2178;184488;157468;81.3;69.4
65;2021-08-18;605;1545;185093;159013;81.6;70.1
65;2021-08-19;731;1319;185824;160332;81.9;70.7
65;2021-08-20;459;1336;186283;161668;82.1;71.3
65;2021-08-21;44;105;186327;161773;82.1;71.3
65;2021-08-22;11;13;186338;161786;82.1;71.3
65;2021-08-23;273;1681;186611;163467;82.3;72.1
65;2021-08-24;551;2446;187162;165913;82.5;73.1
65;2021-08-25;419;1959;187581;167872;82.7;74.0
65;2021-08-26;468;2308;188049;170180;82.9;75.0
65;2021-08-27;447;1949;188496;172129;83.1;75.9
65;2021-08-28;163;195;188659;172324;83.2;76.0
65;2021-08-29;9;18;188668;172342;83.2;76.0
65;2021-08-30;260;1029;188928;173371;83.3;76.4
65;2021-08-31;467;1507;189395;174878;83.5;77.1
65;2021-09-01;459;1077;189854;175955;83.7;77.6
65;2021-09-02;374;883;190228;176838;83.9;78.0
65;2021-09-03;453;1108;190681;177946;84.1;78.4
65;2021-09-04;167;847;190848;178793;84.1;78.8
65;2021-09-05;19;15;190867;178808;84.1;78.8
65;2021-09-06;278;499;191145;179307;84.3;79.0
65;2021-09-07;326;809;191471;180116;84.4;79.4
65;2021-09-08;356;762;191827;180878;84.6;79.7
65;2021-09-09;287;579;192114;181457;84.7;80.0
65;2021-09-10;387;722;192501;182179;84.9;80.3
65;2021-09-11;54;129;192555;182308;84.9;80.4
65;2021-09-12;1;2;192556;182310;84.9;80.4
65;2021-09-13;210;309;192766;182619;85.0;80.5
65;2021-09-14;191;364;192957;182983;85.1;80.7
65;2021-09-15;250;639;193207;183622;85.2;80.9
65;2021-09-16;140;214;193347;183836;85.2;81.0
65;2021-09-17;280;525;193627;184361;85.4;81.3
65;2021-09-18;98;269;193725;184630;85.4;81.4
65;2021-09-19;2;13;193727;184643;85.4;81.4
65;2021-09-20;110;234;193837;184877;85.5;81.5
65;2021-09-21;111;258;193948;185135;85.5;81.6
65;2021-09-22;154;680;194102;185815;85.6;81.9
65;2021-09-23;67;159;194169;185974;85.6;82.0
65;2021-09-24;171;556;194340;186530;85.7;82.2
65;2021-09-25;73;218;194413;186748;85.7;82.3
65;2021-09-26;3;0;194416;186748;85.7;82.3
65;2021-09-27;62;263;194478;187011;85.7;82.4
65;2021-09-28;85;281;194563;187292;85.8;82.6
65;2021-09-29;132;419;194695;187711;85.8;82.8
65;2021-09-30;44;124;194739;187835;85.8;82.8
65;2021-10-01;166;399;194905;188234;85.9;83.0
65;2021-10-02;19;66;194924;188300;85.9;83.0
65;2021-10-03;0;7;194924;188307;85.9;83.0
65;2021-10-04;121;269;195045;188576;86.0;83.1
65;2021-10-05;63;179;195108;188755;86.0;83.2
65;2021-10-06;174;346;195282;189101;86.1;83.4
65;2021-10-07;73;177;195355;189278;86.1;83.4
65;2021-10-08;179;406;195534;189684;86.2;83.6
65;2021-10-09;17;23;195551;189707;86.2;83.6
65;2021-10-10;0;6;195551;189713;86.2;83.6
65;2021-10-11;101;205;195652;189918;86.3;83.7
65;2021-10-12;37;107;195689;190025;86.3;83.8
65;2021-10-13;142;233;195831;190258;86.3;83.9
65;2021-10-14;32;89;195863;190347;86.3;83.9
66;2020-12-27;0;0;0;0;0.0;0.0
66;2020-12-28;3;0;3;0;0.0;0.0
66;2020-12-29;0;0;3;0;0.0;0.0
66;2020-12-30;0;0;3;0;0.0;0.0
66;2020-12-31;1;0;4;0;0.0;0.0
66;2021-01-01;3;0;7;0;0.0;0.0
66;2021-01-02;0;0;7;0;0.0;0.0
66;2021-01-03;0;0;7;0;0.0;0.0
66;2021-01-04;30;0;37;0;0.0;0.0
66;2021-01-05;135;0;172;0;0.0;0.0
66;2021-01-06;194;0;366;0;0.1;0.0
66;2021-01-07;182;0;548;0;0.1;0.0
66;2021-01-08;212;0;760;0;0.2;0.0
66;2021-01-09;233;0;993;0;0.2;0.0
66;2021-01-10;11;0;1004;0;0.2;0.0
66;2021-01-11;404;2;1408;2;0.3;0.0
66;2021-01-12;588;2;1996;4;0.4;0.0
66;2021-01-13;877;9;2873;13;0.6;0.0
66;2021-01-14;892;12;3765;25;0.8;0.0
66;2021-01-15;588;2;4353;27;0.9;0.0
66;2021-01-16;106;3;4459;30;0.9;0.0
66;2021-01-17;46;1;4505;31;0.9;0.0
66;2021-01-18;654;3;5159;34;1.1;0.0
66;2021-01-19;720;3;5879;37;1.2;0.0
66;2021-01-20;1170;4;7049;41;1.5;0.0
66;2021-01-21;2398;7;9447;48;2.0;0.0
66;2021-01-22;1438;10;10885;58;2.3;0.0
66;2021-01-23;399;4;11284;62;2.4;0.0
66;2021-01-24;225;9;11509;71;2.4;0.0
66;2021-01-25;739;40;12248;111;2.6;0.0
66;2021-01-26;787;66;13035;177;2.7;0.0
66;2021-01-27;867;104;13902;281;2.9;0.1
66;2021-01-28;878;130;14780;411;3.1;0.1
66;2021-01-29;820;129;15600;540;3.3;0.1
66;2021-01-30;481;68;16081;608;3.4;0.1
66;2021-01-31;202;27;16283;635;3.4;0.1
66;2021-02-01;562;188;16845;823;3.5;0.2
66;2021-02-02;622;289;17467;1112;3.6;0.2
66;2021-02-03;734;628;18201;1740;3.8;0.4
66;2021-02-04;688;620;18889;2360;3.9;0.5
66;2021-02-05;778;414;19667;2774;4.1;0.6
66;2021-02-06;420;147;20087;2921;4.2;0.6
66;2021-02-07;170;140;20257;3061;4.2;0.6
66;2021-02-08;502;391;20759;3452;4.3;0.7
66;2021-02-09;533;400;21292;3852;4.4;0.8
66;2021-02-10;621;769;21913;4621;4.6;1.0
66;2021-02-11;1104;1569;23017;6190;4.8;1.3
66;2021-02-12;1122;1203;24139;7393;5.0;1.5
66;2021-02-13;367;302;24506;7695;5.1;1.6
66;2021-02-14;111;196;24617;7891;5.1;1.6
66;2021-02-15;425;694;25042;8585;5.2;1.8
66;2021-02-16;304;785;25346;9370;5.3;2.0
66;2021-02-17;377;697;25723;10067;5.4;2.1
66;2021-02-18;366;769;26089;10836;5.4;2.3
66;2021-02-19;400;703;26489;11539;5.5;2.4
66;2021-02-20;184;408;26673;11947;5.6;2.5
66;2021-02-21;41;169;26714;12116;5.6;2.5
66;2021-02-22;415;638;27129;12754;5.7;2.7
66;2021-02-23;509;664;27638;13418;5.8;2.8
66;2021-02-24;347;754;27985;14172;5.8;3.0
66;2021-02-25;717;712;28702;14884;6.0;3.1
66;2021-02-26;954;746;29656;15630;6.2;3.3
66;2021-02-27;363;428;30019;16058;6.3;3.4
66;2021-02-28;59;172;30078;16230;6.3;3.4
66;2021-03-01;378;650;30456;16880;6.4;3.5
66;2021-03-02;336;658;30792;17538;6.4;3.7
66;2021-03-03;530;645;31322;18183;6.5;3.8
66;2021-03-04;991;1060;32313;19243;6.7;4.0
66;2021-03-05;1528;799;33841;20042;7.1;4.2
66;2021-03-06;1147;347;34988;20389;7.3;4.3
66;2021-03-07;1098;100;36086;20489;7.5;4.3
66;2021-03-08;696;545;36782;21034;7.7;4.4
66;2021-03-09;1228;597;38010;21631;7.9;4.5
66;2021-03-10;1303;505;39313;22136;8.2;4.6
66;2021-03-11;1474;592;40787;22728;8.5;4.7
66;2021-03-12;2396;580;43183;23308;9.0;4.9
66;2021-03-13;1081;308;44264;23616;9.2;4.9
66;2021-03-14;192;84;44456;23700;9.3;4.9
66;2021-03-15;1109;395;45565;24095;9.5;5.0
66;2021-03-16;953;259;46518;24354;9.7;5.1
66;2021-03-17;866;398;47384;24752;9.9;5.2
66;2021-03-18;970;346;48354;25098;10.1;5.2
66;2021-03-19;1293;322;49647;25420;10.4;5.3
66;2021-03-20;837;125;50484;25545;10.5;5.3
66;2021-03-21;186;45;50670;25590;10.6;5.3
66;2021-03-22;1115;398;51785;25988;10.8;5.4
66;2021-03-23;1756;389;53541;26377;11.2;5.5
66;2021-03-24;1797;521;55338;26898;11.6;5.6
66;2021-03-25;2537;474;57875;27372;12.1;5.7
66;2021-03-26;2577;370;60452;27742;12.6;5.8
66;2021-03-27;1211;303;61663;28045;12.9;5.9
66;2021-03-28;321;3;61984;28048;12.9;5.9
66;2021-03-29;1831;262;63815;28310;13.3;5.9
66;2021-03-30;2241;177;66056;28487;13.8;5.9
66;2021-03-31;1987;251;68043;28738;14.2;6.0
66;2021-04-01;2674;305;70717;29043;14.8;6.1
66;2021-04-02;2421;261;73138;29304;15.3;6.1
66;2021-04-03;1148;335;74286;29639;15.5;6.2
66;2021-04-04;107;125;74393;29764;15.5;6.2
66;2021-04-05;197;144;74590;29908;15.6;6.2
66;2021-04-06;1334;650;75924;30558;15.9;6.4
66;2021-04-07;1399;598;77323;31156;16.1;6.5
66;2021-04-08;2070;550;79393;31706;16.6;6.6
66;2021-04-09;3507;691;82900;32397;17.3;6.8
66;2021-04-10;2308;527;85208;32924;17.8;6.9
66;2021-04-11;1202;171;86410;33095;18.0;6.9
66;2021-04-12;2703;1026;89113;34121;18.6;7.1
66;2021-04-13;3609;1064;92722;35185;19.4;7.3
66;2021-04-14;3292;926;96014;36111;20.0;7.5
66;2021-04-15;3557;1054;99571;37165;20.8;7.8
66;2021-04-16;3592;1039;103163;38204;21.5;8.0
66;2021-04-17;2263;593;105426;38797;22.0;8.1
66;2021-04-18;1445;132;106871;38929;22.3;8.1
66;2021-04-19;2256;1125;109127;40054;22.8;8.4
66;2021-04-20;2373;1079;111500;41133;23.3;8.6
66;2021-04-21;2871;1181;114371;42314;23.9;8.8
66;2021-04-22;2662;1236;117033;43550;24.4;9.1
66;2021-04-23;2379;1236;119412;44786;24.9;9.3
66;2021-04-24;2743;882;122155;45668;25.5;9.5
66;2021-04-25;1206;267;123361;45935;25.8;9.6
66;2021-04-26;1998;1254;125359;47189;26.2;9.9
66;2021-04-27;2748;1311;128107;48500;26.7;10.1
66;2021-04-28;2421;1659;130528;50159;27.3;10.5
66;2021-04-29;2705;2133;133233;52292;27.8;10.9
66;2021-04-30;3053;1559;136286;53851;28.5;11.2
66;2021-05-01;2000;470;138286;54321;28.9;11.3
66;2021-05-02;1529;264;139815;54585;29.2;11.4
66;2021-05-03;2940;1112;142755;55697;29.8;11.6
66;2021-05-04;3169;1343;145924;57040;30.5;11.9
66;2021-05-05;3055;1549;148979;58589;31.1;12.2
66;2021-05-06;3755;2092;152734;60681;31.9;12.7
66;2021-05-07;2967;3080;155701;63761;32.5;13.3
66;2021-05-08;1730;1170;157431;64931;32.9;13.6
66;2021-05-09;886;1369;158317;66300;33.1;13.8
66;2021-05-10;1802;2970;160119;69270;33.4;14.5
66;2021-05-11;2741;3129;162860;72399;34.0;15.1
66;2021-05-12;2432;2569;165292;74968;34.5;15.7
66;2021-05-13;2259;1386;167551;76354;35.0;15.9
66;2021-05-14;2770;2119;170321;78473;35.6;16.4
66;2021-05-15;2326;1576;172647;80049;36.0;16.7
66;2021-05-16;2286;1246;174933;81295;36.5;17.0
66;2021-05-17;2051;1825;176984;83120;36.9;17.4
66;2021-05-18;3237;1808;180221;84928;37.6;17.7
66;2021-05-19;2876;1340;183097;86268;38.2;18.0
66;2021-05-20;4372;1445;187469;87713;39.1;18.3
66;2021-05-21;3268;1463;190737;89176;39.8;18.6
66;2021-05-22;3066;779;193803;89955;40.5;18.8
66;2021-05-23;1509;236;195312;90191;40.8;18.8
66;2021-05-24;1953;427;197265;90618;41.2;18.9
66;2021-05-25;2795;1689;200060;92307;41.8;19.3
66;2021-05-26;2778;1493;202838;93800;42.3;19.6
66;2021-05-27;3384;2248;206222;96048;43.1;20.1
66;2021-05-28;2683;3049;208905;99097;43.6;20.7
66;2021-05-29;2145;1520;211050;100617;44.1;21.0
66;2021-05-30;786;988;211836;101605;44.2;21.2
66;2021-05-31;2124;1774;213960;103379;44.7;21.6
66;2021-06-01;2636;2005;216596;105384;45.2;22.0
66;2021-06-02;2806;2339;219402;107723;45.8;22.5
66;2021-06-03;2488;2967;221890;110690;46.3;23.1
66;2021-06-04;1958;3355;223848;114045;46.7;23.8
66;2021-06-05;1409;2601;225257;116646;47.0;24.4
66;2021-06-06;294;1228;225551;117874;47.1;24.6
66;2021-06-07;1335;2957;226886;120831;47.4;25.2
66;2021-06-08;1736;3020;228622;123851;47.7;25.9
66;2021-06-09;2064;2787;230686;126638;48.2;26.4
66;2021-06-10;2085;2964;232771;129602;48.6;27.1
66;2021-06-11;2098;3859;234869;133461;49.0;27.9
66;2021-06-12;871;2411;235740;135872;49.2;28.4
66;2021-06-13;516;1333;236256;137205;49.3;28.6
66;2021-06-14;1360;3497;237616;140702;49.6;29.4
66;2021-06-15;2131;3573;239747;144275;50.1;30.1
66;2021-06-16;1792;3570;241539;147845;50.4;30.9
66;2021-06-17;2441;3608;243980;151453;50.9;31.6
66;2021-06-18;2225;3824;246205;155277;51.4;32.4
66;2021-06-19;1542;2320;247747;157597;51.7;32.9
66;2021-06-20;998;1267;248745;158864;51.9;33.2
66;2021-06-21;1163;2879;249908;161743;52.2;33.8
66;2021-06-22;1510;3762;251418;165505;52.5;34.6
66;2021-06-23;1325;3027;252743;168532;52.8;35.2
66;2021-06-24;1527;3227;254270;171759;53.1;35.9
66;2021-06-25;1404;3536;255674;175295;53.4;36.6
66;2021-06-26;962;2680;256636;177975;53.6;37.2
66;2021-06-27;677;1557;257313;179532;53.7;37.5
66;2021-06-28;980;2975;258293;182507;53.9;38.1
66;2021-06-29;1147;3797;259440;186304;54.2;38.9
66;2021-06-30;1278;3306;260718;189610;54.4;39.6
66;2021-07-01;1453;4047;262171;193657;54.7;40.4
66;2021-07-02;1349;3603;263520;197260;55.0;41.2
66;2021-07-03;1152;3899;264672;201159;55.3;42.0
66;2021-07-04;715;1790;265387;202949;55.4;42.4
66;2021-07-05;1293;3005;266680;205954;55.7;43.0
66;2021-07-06;1458;3785;268138;209739;56.0;43.8
66;2021-07-07;1430;3248;269568;212987;56.3;44.5
66;2021-07-08;1387;3385;270955;216372;56.6;45.2
66;2021-07-09;1450;3465;272405;219837;56.9;45.9
66;2021-07-10;1005;2403;273410;222240;57.1;46.4
66;2021-07-11;540;1540;273950;223780;57.2;46.7
66;2021-07-12;1021;3645;274971;227425;57.4;47.5
66;2021-07-13;2223;4263;277194;231688;57.9;48.4
66;2021-07-14;1953;1243;279147;232931;58.3;48.6
66;2021-07-15;2801;3111;281948;236042;58.9;49.3
66;2021-07-16;3410;3214;285358;239256;59.6;49.9
66;2021-07-17;2123;2033;287481;241289;60.0;50.4
66;2021-07-18;1197;1063;288678;242352;60.3;50.6
66;2021-07-19;2794;3083;291472;245435;60.9;51.2
66;2021-07-20;3654;2886;295126;248321;61.6;51.8
66;2021-07-21;3962;2955;299088;251276;62.4;52.5
66;2021-07-22;3917;2821;303005;254097;63.3;53.0
66;2021-07-23;3914;3033;306919;257130;64.1;53.7
66;2021-07-24;2584;1923;309503;259053;64.6;54.1
66;2021-07-25;2020;1241;311523;260294;65.0;54.3
66;2021-07-26;2865;2629;314388;262923;65.6;54.9
66;2021-07-27;3231;2889;317619;265812;66.3;55.5
66;2021-07-28;3355;2583;320974;268395;67.0;56.0
66;2021-07-29;3864;2536;324838;270931;67.8;56.6
66;2021-07-30;4233;2476;329071;273407;68.7;57.1
66;2021-07-31;2231;1716;331302;275123;69.2;57.4
66;2021-08-01;1821;900;333123;276023;69.5;57.6
66;2021-08-02;2391;1919;335514;277942;70.0;58.0
66;2021-08-03;2623;2075;338137;280017;70.6;58.5
66;2021-08-04;2646;1996;340783;282013;71.1;58.9
66;2021-08-05;2444;2439;343227;284452;71.7;59.4
66;2021-08-06;2339;2648;345566;287100;72.1;59.9
66;2021-08-07;1506;2099;347072;289199;72.5;60.4
66;2021-08-08;613;1458;347685;290657;72.6;60.7
66;2021-08-09;1356;2800;349041;293457;72.9;61.3
66;2021-08-10;1649;3075;350690;296532;73.2;61.9
66;2021-08-11;1628;3021;352318;299553;73.6;62.5
66;2021-08-12;1678;2991;353996;302544;73.9;63.2
66;2021-08-13;1473;2984;355469;305528;74.2;63.8
66;2021-08-14;658;2508;356127;308036;74.3;64.3
66;2021-08-15;137;1629;356264;309665;74.4;64.6
66;2021-08-16;1281;2595;357545;312260;74.6;65.2
66;2021-08-17;1496;2980;359041;315240;75.0;65.8
66;2021-08-18;1348;3073;360389;318313;75.2;66.5
66;2021-08-19;1113;2925;361502;321238;75.5;67.1
66;2021-08-20;1020;3324;362522;324562;75.7;67.8
66;2021-08-21;594;2014;363116;326576;75.8;68.2
66;2021-08-22;233;1352;363349;327928;75.9;68.5
66;2021-08-23;1158;2764;364507;330692;76.1;69.0
66;2021-08-24;1064;2952;365571;333644;76.3;69.7
66;2021-08-25;914;2301;366485;335945;76.5;70.1
66;2021-08-26;960;2186;367445;338131;76.7;70.6
66;2021-08-27;917;2367;368362;340498;76.9;71.1
66;2021-08-28;514;1137;368876;341635;77.0;71.3
66;2021-08-29;245;333;369121;341968;77.1;71.4
66;2021-08-30;838;2542;369959;344510;77.2;71.9
66;2021-08-31;835;2657;370794;347167;77.4;72.5
66;2021-09-01;744;1925;371538;349092;77.6;72.9
66;2021-09-02;671;1519;372209;350611;77.7;73.2
66;2021-09-03;717;1747;372926;352358;77.9;73.6
66;2021-09-04;722;1602;373648;353960;78.0;73.9
66;2021-09-05;205;261;373853;354221;78.0;74.0
66;2021-09-06;431;1338;374284;355559;78.1;74.2
66;2021-09-07;382;1177;374666;356736;78.2;74.5
66;2021-09-08;561;1309;375227;358045;78.3;74.7
66;2021-09-09;467;1107;375694;359152;78.4;75.0
66;2021-09-10;495;1159;376189;360311;78.5;75.2
66;2021-09-11;516;1172;376705;361483;78.6;75.5
66;2021-09-12;94;135;376799;361618;78.7;75.5
66;2021-09-13;340;1029;377139;362647;78.7;75.7
66;2021-09-14;386;904;377525;363551;78.8;75.9
66;2021-09-15;478;958;378003;364509;78.9;76.1
66;2021-09-16;391;795;378394;365304;79.0;76.3
66;2021-09-17;341;770;378735;366074;79.1;76.4
66;2021-09-18;358;1099;379093;367173;79.1;76.7
66;2021-09-19;77;241;379170;367414;79.2;76.7
66;2021-09-20;293;672;379463;368086;79.2;76.8
66;2021-09-21;309;585;379772;368671;79.3;77.0
66;2021-09-22;316;792;380088;369463;79.4;77.1
66;2021-09-23;238;508;380326;369971;79.4;77.2
66;2021-09-24;360;772;380686;370743;79.5;77.4
66;2021-09-25;216;941;380902;371684;79.5;77.6
66;2021-09-26;63;213;380965;371897;79.5;77.6
66;2021-09-27;184;499;381149;372396;79.6;77.7
66;2021-09-28;246;545;381395;372941;79.6;77.9
66;2021-09-29;232;576;381627;373517;79.7;78.0
66;2021-09-30;336;454;381963;373971;79.7;78.1
66;2021-10-01;293;519;382256;374490;79.8;78.2
66;2021-10-02;277;620;382533;375110;79.9;78.3
66;2021-10-03;81;125;382614;375235;79.9;78.3
66;2021-10-04;223;374;382837;375609;79.9;78.4
66;2021-10-05;241;444;383078;376053;80.0;78.5
66;2021-10-06;192;378;383270;376431;80.0;78.6
66;2021-10-07;234;458;383504;376889;80.1;78.7
66;2021-10-08;278;554;383782;377443;80.1;78.8
66;2021-10-09;313;538;384095;377981;80.2;78.9
66;2021-10-10;4;12;384099;377993;80.2;78.9
66;2021-10-11;197;395;384296;378388;80.2;79.0
66;2021-10-12;227;342;384523;378730;80.3;79.1
66;2021-10-13;234;419;384757;379149;80.3;79.2
66;2021-10-14;192;302;384949;379451;80.4;79.2
67;2020-12-27;18;1;18;1;0.0;0.0
67;2020-12-28;4;0;22;1;0.0;0.0
67;2020-12-29;2;0;24;1;0.0;0.0
67;2020-12-30;0;0;24;1;0.0;0.0
67;2020-12-31;1;0;25;1;0.0;0.0
67;2021-01-01;6;1;31;2;0.0;0.0
67;2021-01-02;1;0;32;2;0.0;0.0
67;2021-01-03;1;0;33;2;0.0;0.0
67;2021-01-04;43;0;76;2;0.0;0.0
67;2021-01-05;167;7;243;9;0.0;0.0
67;2021-01-06;121;0;364;9;0.0;0.0
67;2021-01-07;235;1;599;10;0.1;0.0
67;2021-01-08;235;1;834;11;0.1;0.0
67;2021-01-09;113;1;947;12;0.1;0.0
67;2021-01-10;67;0;1014;12;0.1;0.0
67;2021-01-11;184;1;1198;13;0.1;0.0
67;2021-01-12;511;2;1709;15;0.2;0.0
67;2021-01-13;660;4;2369;19;0.2;0.0
67;2021-01-14;1096;14;3465;33;0.3;0.0
67;2021-01-15;943;8;4408;41;0.4;0.0
67;2021-01-16;200;4;4608;45;0.4;0.0
67;2021-01-17;101;2;4709;47;0.4;0.0
67;2021-01-18;903;4;5612;51;0.5;0.0
67;2021-01-19;1423;5;7035;56;0.6;0.0
67;2021-01-20;1855;14;8890;70;0.8;0.0
67;2021-01-21;2218;12;11108;82;1.0;0.0
67;2021-01-22;1995;9;13103;91;1.2;0.0
67;2021-01-23;814;6;13917;97;1.2;0.0
67;2021-01-24;380;1;14297;98;1.3;0.0
67;2021-01-25;526;31;14823;129;1.3;0.0
67;2021-01-26;164;110;14987;239;1.3;0.0
67;2021-01-27;1404;141;16391;380;1.4;0.0
67;2021-01-28;3060;233;19451;613;1.7;0.1
67;2021-01-29;2034;168;21485;781;1.9;0.1
67;2021-01-30;1098;82;22583;863;2.0;0.1
67;2021-01-31;1163;32;23746;895;2.1;0.1
67;2021-02-01;3398;253;27144;1148;2.4;0.1
67;2021-02-02;2695;430;29839;1578;2.6;0.1
67;2021-02-03;1578;401;31417;1979;2.8;0.2
67;2021-02-04;1197;755;32614;2734;2.9;0.2
67;2021-02-05;1195;638;33809;3372;3.0;0.3
67;2021-02-06;799;151;34608;3523;3.1;0.3
67;2021-02-07;292;44;34900;3567;3.1;0.3
67;2021-02-08;841;448;35741;4015;3.2;0.4
67;2021-02-09;963;730;36704;4745;3.2;0.4
67;2021-02-10;934;795;37638;5540;3.3;0.5
67;2021-02-11;1152;1131;38790;6671;3.4;0.6
67;2021-02-12;1245;780;40035;7451;3.5;0.7
67;2021-02-13;767;280;40802;7731;3.6;0.7
67;2021-02-14;244;94;41046;7825;3.6;0.7
67;2021-02-15;782;840;41828;8665;3.7;0.8
67;2021-02-16;932;1140;42760;9805;3.8;0.9
67;2021-02-17;786;1186;43546;10991;3.8;1.0
67;2021-02-18;1402;2568;44948;13559;4.0;1.2
67;2021-02-19;1376;2103;46324;15662;4.1;1.4
67;2021-02-20;634;898;46958;16560;4.1;1.5
67;2021-02-21;209;1195;47167;17755;4.2;1.6
67;2021-02-22;1401;2171;48568;19926;4.3;1.8
67;2021-02-23;1461;1562;50029;21488;4.4;1.9
67;2021-02-24;1439;1054;51468;22542;4.5;2.0
67;2021-02-25;1619;1474;53087;24016;4.7;2.1
67;2021-02-26;2227;1412;55314;25428;4.9;2.2
67;2021-02-27;1260;784;56574;26212;5.0;2.3
67;2021-02-28;148;365;56722;26577;5.0;2.3
67;2021-03-01;641;998;57363;27575;5.1;2.4
67;2021-03-02;898;1201;58261;28776;5.1;2.5
67;2021-03-03;1413;1279;59674;30055;5.3;2.7
67;2021-03-04;1963;1064;61637;31119;5.4;2.7
67;2021-03-05;3258;1110;64895;32229;5.7;2.8
67;2021-03-06;2337;775;67232;33004;5.9;2.9
67;2021-03-07;468;283;67700;33287;6.0;2.9
67;2021-03-08;1188;792;68888;34079;6.1;3.0
67;2021-03-09;2227;906;71115;34985;6.3;3.1
67;2021-03-10;2456;1191;73571;36176;6.5;3.2
67;2021-03-11;3208;1369;76779;37545;6.8;3.3
67;2021-03-12;5264;1392;82043;38937;7.2;3.4
67;2021-03-13;3998;902;86041;39839;7.6;3.5
67;2021-03-14;483;390;86524;40229;7.6;3.6
67;2021-03-15;2193;1162;88717;41391;7.8;3.7
67;2021-03-16;1552;1239;90269;42630;8.0;3.8
67;2021-03-17;2072;925;92341;43555;8.2;3.8
67;2021-03-18;2392;740;94733;44295;8.4;3.9
67;2021-03-19;3673;757;98406;45052;8.7;4.0
67;2021-03-20;3064;514;101470;45566;9.0;4.0
67;2021-03-21;338;17;101808;45583;9.0;4.0
67;2021-03-22;2332;781;104140;46364;9.2;4.1
67;2021-03-23;3403;779;107543;47143;9.5;4.2
67;2021-03-24;3912;813;111455;47956;9.8;4.2
67;2021-03-25;5315;543;116770;48499;10.3;4.3
67;2021-03-26;6870;484;123640;48983;10.9;4.3
67;2021-03-27;3927;348;127567;49331;11.3;4.4
67;2021-03-28;580;101;128147;49432;11.3;4.4
67;2021-03-29;3824;430;131971;49862;11.7;4.4
67;2021-03-30;4848;677;136819;50539;12.1;4.5
67;2021-03-31;4849;709;141668;51248;12.5;4.5
67;2021-04-01;5149;932;146817;52180;13.0;4.6
67;2021-04-02;1009;177;147826;52357;13.1;4.6
67;2021-04-03;1689;286;149515;52643;13.2;4.6
67;2021-04-04;328;6;149843;52649;13.2;4.6
67;2021-04-05;371;5;150214;52654;13.3;4.6
67;2021-04-06;3484;1189;153698;53843;13.6;4.8
67;2021-04-07;4534;1287;158232;55130;14.0;4.9
67;2021-04-08;5664;1414;163896;56544;14.5;5.0
67;2021-04-09;7111;1361;171007;57905;15.1;5.1
67;2021-04-10;4334;902;175341;58807;15.5;5.2
67;2021-04-11;857;428;176198;59235;15.6;5.2
67;2021-04-12;3887;1414;180085;60649;15.9;5.4
67;2021-04-13;4891;1583;184976;62232;16.3;5.5
67;2021-04-14;5297;1916;190273;64148;16.8;5.7
67;2021-04-15;6085;2112;196358;66260;17.3;5.9
67;2021-04-16;7836;2436;204194;68696;18.0;6.1
67;2021-04-17;4010;1582;208204;70278;18.4;6.2
67;2021-04-18;1111;646;209315;70924;18.5;6.3
67;2021-04-19;3630;2147;212945;73071;18.8;6.5
67;2021-04-20;4257;1930;217202;75001;19.2;6.6
67;2021-04-21;4071;2516;221273;77517;19.5;6.8
67;2021-04-22;4478;2926;225751;80443;19.9;7.1
67;2021-04-23;5257;3014;231008;83457;20.4;7.4
67;2021-04-24;3101;2023;234109;85480;20.7;7.5
67;2021-04-25;1027;452;235136;85932;20.8;7.6
67;2021-04-26;3191;2619;238327;88551;21.0;7.8
67;2021-04-27;4023;2928;242350;91479;21.4;8.1
67;2021-04-28;4255;3438;246605;94917;21.8;8.4
67;2021-04-29;5125;3518;251730;98435;22.2;8.7
67;2021-04-30;7184;2497;258914;100932;22.9;8.9
67;2021-05-01;2685;793;261599;101725;23.1;9.0
67;2021-05-02;2181;682;263780;102407;23.3;9.0
67;2021-05-03;5561;2619;269341;105026;23.8;9.3
67;2021-05-04;5853;3615;275194;108641;24.3;9.6
67;2021-05-05;5221;4206;280415;112847;24.8;10.0
67;2021-05-06;6714;4928;287129;117775;25.4;10.4
67;2021-05-07;6436;6932;293565;124707;25.9;11.0
67;2021-05-08;3575;1023;297140;125730;26.2;11.1
67;2021-05-09;3366;594;300506;126324;26.5;11.2
67;2021-05-10;4698;4532;305204;130856;26.9;11.6
67;2021-05-11;5649;4932;310853;135788;27.4;12.0
67;2021-05-12;6597;4846;317450;140634;28.0;12.4
67;2021-05-13;7310;1674;324760;142308;28.7;12.6
67;2021-05-14;8880;5358;333640;147666;29.5;13.0
67;2021-05-15;8198;3657;341838;151323;30.2;13.4
67;2021-05-16;6176;969;348014;152292;30.7;13.4
67;2021-05-17;5689;3884;353703;156176;31.2;13.8
67;2021-05-18;6896;3976;360599;160152;31.8;14.1
67;2021-05-19;7376;4166;367975;164318;32.5;14.5
67;2021-05-20;8681;4233;376656;168551;33.3;14.9
67;2021-05-21;8156;5859;384812;174410;34.0;15.4
67;2021-05-22;5933;3420;390745;177830;34.5;15.7
67;2021-05-23;2656;593;393401;178423;34.7;15.8
67;2021-05-24;4415;865;397816;179288;35.1;15.8
67;2021-05-25;5412;4767;403228;184055;35.6;16.3
67;2021-05-26;6063;4876;409291;188931;36.1;16.7
67;2021-05-27;7311;4900;416602;193831;36.8;17.1
67;2021-05-28;7965;6503;424567;200334;37.5;17.7
67;2021-05-29;6646;3871;431213;204205;38.1;18.0
67;2021-05-30;1147;809;432360;205014;38.2;18.1
67;2021-05-31;6405;4058;438765;209072;38.7;18.5
67;2021-06-01;7328;4407;446093;213479;39.4;18.8
67;2021-06-02;8066;4182;454159;217661;40.1;19.2
67;2021-06-03;8841;4866;463000;222527;40.9;19.6
67;2021-06-04;8594;6139;471594;228666;41.6;20.2
67;2021-06-05;6548;3983;478142;232649;42.2;20.5
67;2021-06-06;3468;875;481610;233524;42.5;20.6
67;2021-06-07;7407;4259;489017;237783;43.2;21.0
67;2021-06-08;8616;4931;497633;242714;43.9;21.4
67;2021-06-09;9258;4794;506891;247508;44.8;21.9
67;2021-06-10;9770;5021;516661;252529;45.6;22.3
67;2021-06-11;8066;8325;524727;260854;46.3;23.0
67;2021-06-12;6789;5203;531516;266057;46.9;23.5
67;2021-06-13;3105;1044;534621;267101;47.2;23.6
67;2021-06-14;5504;6460;540125;273561;47.7;24.2
67;2021-06-15;6688;6753;546813;280314;48.3;24.7
67;2021-06-16;6950;6698;553763;287012;48.9;25.3
67;2021-06-17;7275;9045;561038;296057;49.5;26.1
67;2021-06-18;7600;8506;568638;304563;50.2;26.9
67;2021-06-19;6387;5960;575025;310523;50.8;27.4
67;2021-06-20;1446;1411;576471;311934;50.9;27.5
67;2021-06-21;4266;6775;580737;318709;51.3;28.1
67;2021-06-22;4241;9093;584978;327802;51.6;28.9
67;2021-06-23;5292;8184;590270;335986;52.1;29.7
67;2021-06-24;4521;9101;594791;345087;52.5;30.5
67;2021-06-25;5334;9951;600125;355038;53.0;31.3
67;2021-06-26;3463;9104;603588;364142;53.3;32.2
67;2021-06-27;1023;3523;604611;367665;53.4;32.5
67;2021-06-28;2845;8722;607456;376387;53.6;33.2
67;2021-06-29;2898;8612;610354;384999;53.9;34.0
67;2021-06-30;3382;8742;613736;393741;54.2;34.8
67;2021-07-01;3668;8429;617404;402170;54.5;35.5
67;2021-07-02;3736;10938;621140;413108;54.8;36.5
67;2021-07-03;2981;7742;624121;420850;55.1;37.2
67;2021-07-04;764;1869;624885;422719;55.2;37.3
67;2021-07-05;2626;8250;627511;430969;55.4;38.1
67;2021-07-06;3110;8441;630621;439410;55.7;38.8
67;2021-07-07;3926;8742;634547;448152;56.0;39.6
67;2021-07-08;4204;7785;638751;455937;56.4;40.3
67;2021-07-09;3767;11369;642518;467306;56.7;41.3
67;2021-07-10;2860;8205;645378;475511;57.0;42.0
67;2021-07-11;945;1995;646323;477506;57.1;42.2
67;2021-07-12;2479;9726;648802;487232;57.3;43.0
67;2021-07-13;4122;9890;652924;497122;57.6;43.9
67;2021-07-14;3493;4408;656417;501530;58.0;44.3
67;2021-07-15;5142;12230;661559;513760;58.4;45.4
67;2021-07-16;4867;12293;666426;526053;58.8;46.4
67;2021-07-17;3734;8824;670160;534877;59.2;47.2
67;2021-07-18;1465;2550;671625;537427;59.3;47.5
67;2021-07-19;4649;9745;676274;547172;59.7;48.3
67;2021-07-20;5774;9824;682048;556996;60.2;49.2
67;2021-07-21;5869;10649;687917;567645;60.7;50.1
67;2021-07-22;6439;10228;694356;577873;61.3;51.0
67;2021-07-23;7394;11191;701750;589064;62.0;52.0
67;2021-07-24;5422;7581;707172;596645;62.4;52.7
67;2021-07-25;2317;1972;709489;598617;62.6;52.9
67;2021-07-26;5003;7250;714492;605867;63.1;53.5
67;2021-07-27;6623;7330;721115;613197;63.7;54.1
67;2021-07-28;7542;7210;728657;620407;64.3;54.8
67;2021-07-29;8394;6437;737051;626844;65.1;55.3
67;2021-07-30;8669;7312;745720;634156;65.8;56.0
67;2021-07-31;5113;4878;750833;639034;66.3;56.4
67;2021-08-01;2486;1434;753319;640468;66.5;56.5
67;2021-08-02;6422;5096;759741;645564;67.1;57.0
67;2021-08-03;7322;4719;767063;650283;67.7;57.4
67;2021-08-04;6909;4604;773972;654887;68.3;57.8
67;2021-08-05;5753;4232;779725;659119;68.8;58.2
67;2021-08-06;6334;5427;786059;664546;69.4;58.7
67;2021-08-07;4693;4280;790752;668826;69.8;59.1
67;2021-08-08;1311;1440;792063;670266;69.9;59.2
67;2021-08-09;3145;4479;795208;674745;70.2;59.6
67;2021-08-10;3254;4782;798462;679527;70.5;60.0
67;2021-08-11;3434;4677;801896;684204;70.8;60.4
67;2021-08-12;3148;4887;805044;689091;71.1;60.8
67;2021-08-13;3210;5386;808254;694477;71.4;61.3
67;2021-08-14;2198;5086;810452;699563;71.6;61.8
67;2021-08-15;714;1606;811166;701169;71.6;61.9
67;2021-08-16;2095;5242;813261;706411;71.8;62.4
67;2021-08-17;2108;5278;815369;711689;72.0;62.8
67;2021-08-18;2385;6346;817754;718035;72.2;63.4
67;2021-08-19;1903;6153;819657;724188;72.4;63.9
67;2021-08-20;2362;7460;822019;731648;72.6;64.6
67;2021-08-21;1530;5572;823549;737220;72.7;65.1
67;2021-08-22;390;2051;823939;739271;72.7;65.3
67;2021-08-23;1946;6851;825885;746122;72.9;65.9
67;2021-08-24;1999;6613;827884;752735;73.1;66.5
67;2021-08-25;2127;7217;830011;759952;73.3;67.1
67;2021-08-26;1856;5553;831867;765505;73.4;67.6
67;2021-08-27;2221;7057;834088;772562;73.6;68.2
67;2021-08-28;1707;6109;835795;778671;73.8;68.8
67;2021-08-29;439;1600;836234;780271;73.8;68.9
67;2021-08-30;1423;4274;837657;784545;74.0;69.3
67;2021-08-31;1448;3955;839105;788500;74.1;69.6
67;2021-09-01;1887;4058;840992;792558;74.3;70.0
67;2021-09-02;1093;2718;842085;795276;74.3;70.2
67;2021-09-03;1564;3921;843649;799197;74.5;70.6
67;2021-09-04;1483;3773;845132;802970;74.6;70.9
67;2021-09-05;259;842;845391;803812;74.6;71.0
67;2021-09-06;977;1938;846368;805750;74.7;71.1
67;2021-09-07;906;1848;847274;807598;74.8;71.3
67;2021-09-08;1210;2471;848484;810069;74.9;71.5
67;2021-09-09;1124;1794;849608;811863;75.0;71.7
67;2021-09-10;1440;2369;851048;814232;75.1;71.9
67;2021-09-11;1065;2756;852113;816988;75.2;72.1
67;2021-09-12;253;522;852366;817510;75.3;72.2
67;2021-09-13;752;1448;853118;818958;75.3;72.3
67;2021-09-14;953;1476;854071;820434;75.4;72.4
67;2021-09-15;1031;2107;855102;822541;75.5;72.6
67;2021-09-16;766;1306;855868;823847;75.6;72.7
67;2021-09-17;972;2230;856840;826077;75.7;72.9
67;2021-09-18;809;2423;857649;828500;75.7;73.1
67;2021-09-19;104;411;857753;828911;75.7;73.2
67;2021-09-20;607;1132;858360;830043;75.8;73.3
67;2021-09-21;492;1066;858852;831109;75.8;73.4
67;2021-09-22;669;1951;859521;833060;75.9;73.6
67;2021-09-23;567;943;860088;834003;75.9;73.6
67;2021-09-24;688;1674;860776;835677;76.0;73.8
67;2021-09-25;602;1869;861378;837546;76.1;73.9
67;2021-09-26;73;327;861451;837873;76.1;74.0
67;2021-09-27;399;950;861850;838823;76.1;74.1
67;2021-09-28;404;860;862254;839683;76.1;74.1
67;2021-09-29;619;1362;862873;841045;76.2;74.3
67;2021-09-30;423;932;863296;841977;76.2;74.3
67;2021-10-01;662;1439;863958;843416;76.3;74.5
67;2021-10-02;625;1288;864583;844704;76.3;74.6
67;2021-10-03;95;221;864678;844925;76.3;74.6
67;2021-10-04;314;677;864992;845602;76.4;74.7
67;2021-10-05;324;751;865316;846353;76.4;74.7
67;2021-10-06;579;1133;865895;847486;76.5;74.8
67;2021-10-07;448;775;866343;848261;76.5;74.9
67;2021-10-08;631;1270;866974;849531;76.5;75.0
67;2021-10-09;505;1020;867479;850551;76.6;75.1
67;2021-10-10;79;111;867558;850662;76.6;75.1
67;2021-10-11;326;604;867884;851266;76.6;75.2
67;2021-10-12;361;602;868245;851868;76.7;75.2
67;2021-10-13;576;933;868821;852801;76.7;75.3
67;2021-10-14;378;650;869199;853451;76.7;75.4
68;2020-12-27;0;0;0;0;0.0;0.0
68;2020-12-28;0;0;0;0;0.0;0.0
68;2020-12-29;0;0;0;0;0.0;0.0
68;2020-12-30;2;0;2;0;0.0;0.0
68;2020-12-31;0;0;2;0;0.0;0.0
68;2021-01-01;0;0;2;0;0.0;0.0
68;2021-01-02;0;0;2;0;0.0;0.0
68;2021-01-03;1;0;3;0;0.0;0.0
68;2021-01-04;2;1;5;1;0.0;0.0
68;2021-01-05;11;0;16;1;0.0;0.0
68;2021-01-06;245;1;261;2;0.0;0.0
68;2021-01-07;75;0;336;2;0.0;0.0
68;2021-01-08;118;1;454;3;0.1;0.0
68;2021-01-09;20;0;474;3;0.1;0.0
68;2021-01-10;1;0;475;3;0.1;0.0
68;2021-01-11;82;0;557;3;0.1;0.0
68;2021-01-12;388;1;945;4;0.1;0.0
68;2021-01-13;704;3;1649;7;0.2;0.0
68;2021-01-14;372;2;2021;9;0.3;0.0
68;2021-01-15;204;1;2225;10;0.3;0.0
68;2021-01-16;1;0;2226;10;0.3;0.0
68;2021-01-17;0;0;2226;10;0.3;0.0
68;2021-01-18;379;5;2605;15;0.3;0.0
68;2021-01-19;559;5;3164;20;0.4;0.0
68;2021-01-20;707;10;3871;30;0.5;0.0
68;2021-01-21;1395;14;5266;44;0.7;0.0
68;2021-01-22;1498;15;6764;59;0.9;0.0
68;2021-01-23;215;3;6979;62;0.9;0.0
68;2021-01-24;699;2;7678;64;1.0;0.0
68;2021-01-25;1390;45;9068;109;1.2;0.0
68;2021-01-26;1555;80;10623;189;1.4;0.0
68;2021-01-27;2779;160;13402;349;1.8;0.0
68;2021-01-28;2358;62;15760;411;2.1;0.1
68;2021-01-29;1509;119;17269;530;2.3;0.1
68;2021-01-30;165;3;17434;533;2.3;0.1
68;2021-01-31;0;0;17434;533;2.3;0.1
68;2021-02-01;737;118;18171;651;2.4;0.1
68;2021-02-02;872;305;19043;956;2.5;0.1
68;2021-02-03;1001;616;20044;1572;2.6;0.2
68;2021-02-04;1001;323;21045;1895;2.8;0.2
68;2021-02-05;948;234;21993;2129;2.9;0.3
68;2021-02-06;140;2;22133;2131;2.9;0.3
68;2021-02-07;2;16;22135;2147;2.9;0.3
68;2021-02-08;893;24;23028;2171;3.0;0.3
68;2021-02-09;1357;47;24385;2218;3.2;0.3
68;2021-02-10;1453;65;25838;2283;3.4;0.3
68;2021-02-11;1486;469;27324;2752;3.6;0.4
68;2021-02-12;1551;446;28875;3198;3.8;0.4
68;2021-02-13;131;1;29006;3199;3.8;0.4
68;2021-02-14;58;232;29064;3431;3.8;0.4
68;2021-02-15;662;1087;29726;4518;3.9;0.6
68;2021-02-16;865;1370;30591;5888;4.0;0.8
68;2021-02-17;1288;2130;31879;8018;4.2;1.1
68;2021-02-18;1668;2067;33547;10085;4.4;1.3
68;2021-02-19;988;1370;34535;11455;4.5;1.5
68;2021-02-20;93;125;34628;11580;4.5;1.5
68;2021-02-21;1;40;34629;11620;4.5;1.5
68;2021-02-22;447;796;35076;12416;4.6;1.6
68;2021-02-23;639;1062;35715;13478;4.7;1.8
68;2021-02-24;854;1158;36569;14636;4.8;1.9
68;2021-02-25;1208;1250;37777;15886;4.9;2.1
68;2021-02-26;1199;990;38976;16876;5.1;2.2
68;2021-02-27;550;178;39526;17054;5.2;2.2
68;2021-02-28;12;1;39538;17055;5.2;2.2
68;2021-03-01;942;768;40480;17823;5.3;2.3
68;2021-03-02;1215;928;41695;18751;5.5;2.5
68;2021-03-03;1593;973;43288;19724;5.7;2.6
68;2021-03-04;1995;1052;45283;20776;5.9;2.7
68;2021-03-05;2355;1053;47638;21829;6.2;2.9
68;2021-03-06;2288;254;49926;22083;6.5;2.9
68;2021-03-07;838;108;50764;22191;6.7;2.9
68;2021-03-08;1476;978;52240;23169;6.8;3.0
68;2021-03-09;1698;1332;53938;24501;7.1;3.2
68;2021-03-10;1966;1805;55904;26306;7.3;3.4
68;2021-03-11;2637;1914;58541;28220;7.7;3.7
68;2021-03-12;2631;1425;61172;29645;8.0;3.9
68;2021-03-13;3342;264;64514;29909;8.5;3.9
68;2021-03-14;1541;68;66055;29977;8.7;3.9
68;2021-03-15;1796;623;67851;30600;8.9;4.0
68;2021-03-16;1998;603;69849;31203;9.2;4.1
68;2021-03-17;1958;736;71807;31939;9.4;4.2
68;2021-03-18;2220;951;74027;32890;9.7;4.3
68;2021-03-19;3084;741;77111;33631;10.1;4.4
68;2021-03-20;974;125;78085;33756;10.2;4.4
68;2021-03-21;68;2;78153;33758;10.2;4.4
68;2021-03-22;1964;598;80117;34356;10.5;4.5
68;2021-03-23;2861;621;82978;34977;10.9;4.6
68;2021-03-24;3177;819;86155;35796;11.3;4.7
68;2021-03-25;3501;796;89656;36592;11.7;4.8
68;2021-03-26;3894;738;93550;37330;12.3;4.9
68;2021-03-27;1101;169;94651;37499;12.4;4.9
68;2021-03-28;56;3;94707;37502;12.4;4.9
68;2021-03-29;2260;1368;96967;38870;12.7;5.1
68;2021-03-30;2933;1305;99900;40175;13.1;5.3
68;2021-03-31;2643;1368;102543;41543;13.4;5.4
68;2021-04-01;2747;1553;105290;43096;13.8;5.6
68;2021-04-02;244;88;105534;43184;13.8;5.7
68;2021-04-03;241;124;105775;43308;13.9;5.7
68;2021-04-04;6;0;105781;43308;13.9;5.7
68;2021-04-05;49;4;105830;43312;13.9;5.7
68;2021-04-06;1793;1327;107623;44639;14.1;5.8
68;2021-04-07;2585;1542;110208;46181;14.4;6.1
68;2021-04-08;3234;1509;113442;47690;14.9;6.2
68;2021-04-09;4200;1536;117642;49226;15.4;6.4
68;2021-04-10;1203;1974;118845;51200;15.6;6.7
68;2021-04-11;127;1317;118972;52517;15.6;6.9
68;2021-04-12;2666;1639;121638;54156;15.9;7.1
68;2021-04-13;2760;2113;124398;56269;16.3;7.4
68;2021-04-14;3606;2272;128004;58541;16.8;7.7
68;2021-04-15;4055;2167;132059;60708;17.3;8.0
68;2021-04-16;3942;2085;136001;62793;17.8;8.2
68;2021-04-17;1075;444;137076;63237;18.0;8.3
68;2021-04-18;85;9;137161;63246;18.0;8.3
68;2021-04-19;2358;1834;139519;65080;18.3;8.5
68;2021-04-20;2442;2330;141961;67410;18.6;8.8
68;2021-04-21;2829;2478;144790;69888;19.0;9.2
68;2021-04-22;3287;1974;148077;71862;19.4;9.4
68;2021-04-23;3412;2077;151489;73939;19.8;9.7
68;2021-04-24;842;489;152331;74428;20.0;9.8
68;2021-04-25;214;20;152545;74448;20.0;9.8
68;2021-04-26;2328;2107;154873;76555;20.3;10.0
68;2021-04-27;2599;2217;157472;78772;20.6;10.3
68;2021-04-28;3572;1767;161044;80539;21.1;10.6
68;2021-04-29;4164;1751;165208;82290;21.6;10.8
68;2021-04-30;4834;1376;170042;83666;22.3;11.0
68;2021-05-01;947;121;170989;83787;22.4;11.0
68;2021-05-02;732;70;171721;83857;22.5;11.0
68;2021-05-03;3620;1820;175341;85677;23.0;11.2
68;2021-05-04;3937;2363;179278;88040;23.5;11.5
68;2021-05-05;3632;3249;182910;91289;24.0;12.0
68;2021-05-06;4804;2864;187714;94153;24.6;12.3
68;2021-05-07;4518;2909;192232;97062;25.2;12.7
68;2021-05-08;1672;210;193904;97272;25.4;12.7
68;2021-05-09;1075;107;194979;97379;25.5;12.8
68;2021-05-10;3160;3721;198139;101100;26.0;13.2
68;2021-05-11;4715;3623;202854;104723;26.6;13.7
68;2021-05-12;5785;3295;208639;108018;27.3;14.2
68;2021-05-13;4766;840;213405;108858;28.0;14.3
68;2021-05-14;5959;2134;219364;110992;28.7;14.5
68;2021-05-15;3558;910;222922;111902;29.2;14.7
68;2021-05-16;670;119;223592;112021;29.3;14.7
68;2021-05-17;4449;2499;228041;114520;29.9;15.0
68;2021-05-18;6139;2307;234180;116827;30.7;15.3
68;2021-05-19;5868;2884;240048;119711;31.5;15.7
68;2021-05-20;5929;2413;245977;122124;32.2;16.0
68;2021-05-21;5778;2870;251755;124994;33.0;16.4
68;2021-05-22;2576;927;254331;125921;33.3;16.5
68;2021-05-23;15;16;254346;125937;33.3;16.5
68;2021-05-24;2304;971;256650;126908;33.6;16.6
68;2021-05-25;4343;3436;260993;130344;34.2;17.1
68;2021-05-26;4884;3384;265877;133728;34.8;17.5
68;2021-05-27;5400;3408;271277;137136;35.5;18.0
68;2021-05-28;5624;3728;276901;140864;36.3;18.5
68;2021-05-29;1540;1186;278441;142050;36.5;18.6
68;2021-05-30;41;46;278482;142096;36.5;18.6
68;2021-05-31;5158;2364;283640;144460;37.2;18.9
68;2021-06-01;5989;2799;289629;147259;37.9;19.3
68;2021-06-02;4886;3006;294515;150265;38.6;19.7
68;2021-06-03;5938;3099;300453;153364;39.4;20.1
68;2021-06-04;4896;3306;305349;156670;40.0;20.5
68;2021-06-05;781;1169;306130;157839;40.1;20.7
68;2021-06-06;69;114;306199;157953;40.1;20.7
68;2021-06-07;4753;3036;310952;160989;40.7;21.1
68;2021-06-08;4934;3556;315886;164545;41.4;21.6
68;2021-06-09;4994;3448;320880;167993;42.0;22.0
68;2021-06-10;5200;3145;326080;171138;42.7;22.4
68;2021-06-11;5055;4149;331135;175287;43.4;23.0
68;2021-06-12;3036;1771;334171;177058;43.8;23.2
68;2021-06-13;514;682;334685;177740;43.9;23.3
68;2021-06-14;2516;4390;337201;182130;44.2;23.9
68;2021-06-15;3112;4724;340313;186854;44.6;24.5
68;2021-06-16;3387;4442;343700;191296;45.0;25.1
68;2021-06-17;2359;4458;346059;195754;45.3;25.6
68;2021-06-18;3357;5172;349416;200926;45.8;26.3
68;2021-06-19;2253;2170;351669;203096;46.1;26.6
68;2021-06-20;258;891;351927;203987;46.1;26.7
68;2021-06-21;2059;5148;353986;209135;46.4;27.4
68;2021-06-22;1900;5174;355886;214309;46.6;28.1
68;2021-06-23;2319;5740;358205;220049;46.9;28.8
68;2021-06-24;2154;4897;360359;224946;47.2;29.5
68;2021-06-25;2287;6660;362646;231606;47.5;30.3
68;2021-06-26;1303;2606;363949;234212;47.7;30.7
68;2021-06-27;151;880;364100;235092;47.7;30.8
68;2021-06-28;1601;6444;365701;241536;47.9;31.6
68;2021-06-29;1539;6632;367240;248168;48.1;32.5
68;2021-06-30;1797;6554;369037;254722;48.4;33.4
68;2021-07-01;2105;5351;371142;260073;48.6;34.1
68;2021-07-02;2098;6482;373240;266555;48.9;34.9
68;2021-07-03;989;1934;374229;268489;49.0;35.2
68;2021-07-04;242;200;374471;268689;49.1;35.2
68;2021-07-05;1456;5513;375927;274202;49.3;35.9
68;2021-07-06;2001;5884;377928;280086;49.5;36.7
68;2021-07-07;2455;4974;380383;285060;49.8;37.4
68;2021-07-08;2434;4750;382817;289810;50.2;38.0
68;2021-07-09;2091;7364;384908;297174;50.4;38.9
68;2021-07-10;1028;2003;385936;299177;50.6;39.2
68;2021-07-11;147;156;386083;299333;50.6;39.2
68;2021-07-12;1646;6771;387729;306104;50.8;40.1
68;2021-07-13;2909;6550;390638;312654;51.2;41.0
68;2021-07-14;1840;984;392478;313638;51.4;41.1
68;2021-07-15;3187;6655;395665;320293;51.8;42.0
68;2021-07-16;3817;6762;399482;327055;52.3;42.9
68;2021-07-17;3361;2302;402843;329357;52.8;43.2
68;2021-07-18;1054;230;403897;329587;52.9;43.2
68;2021-07-19;3050;6081;406947;335668;53.3;44.0
68;2021-07-20;4002;5677;410949;341345;53.8;44.7
68;2021-07-21;4339;5831;415288;347176;54.4;45.5
68;2021-07-22;4188;4848;419476;352024;55.0;46.1
68;2021-07-23;5041;5761;424517;357785;55.6;46.9
68;2021-07-24;3349;2134;427866;359919;56.1;47.2
68;2021-07-25;825;537;428691;360456;56.2;47.2
68;2021-07-26;4835;4450;433526;364906;56.8;47.8
68;2021-07-27;6364;3756;439890;368662;57.6;48.3
68;2021-07-28;6848;3884;446738;372546;58.5;48.8
68;2021-07-29;6398;3428;453136;375974;59.4;49.3
68;2021-07-30;6342;4378;459478;380352;60.2;49.8
68;2021-07-31;3917;1427;463395;381779;60.7;50.0
68;2021-08-01;1651;494;465046;382273;60.9;50.1
68;2021-08-02;4606;3151;469652;385424;61.5;50.5
68;2021-08-03;3550;2453;473202;387877;62.0;50.8
68;2021-08-04;3135;2689;476337;390566;62.4;51.2
68;2021-08-05;2753;2641;479090;393207;62.8;51.5
68;2021-08-06;3995;4327;483085;397534;63.3;52.1
68;2021-08-07;1227;1305;484312;398839;63.5;52.3
68;2021-08-08;364;813;484676;399652;63.5;52.4
68;2021-08-09;2575;3683;487251;403335;63.8;52.8
68;2021-08-10;2217;2784;489468;406119;64.1;53.2
68;2021-08-11;1896;2728;491364;408847;64.4;53.6
68;2021-08-12;1752;2666;493116;411513;64.6;53.9
68;2021-08-13;2716;4759;495832;416272;65.0;54.5
68;2021-08-14;715;1444;496547;417716;65.1;54.7
68;2021-08-15;45;445;496592;418161;65.1;54.8
68;2021-08-16;2005;5062;498597;423223;65.3;55.5
68;2021-08-17;1803;4846;500400;428069;65.6;56.1
68;2021-08-18;1182;3697;501582;431766;65.7;56.6
68;2021-08-19;1367;3741;502949;435507;65.9;57.1
68;2021-08-20;2229;6065;505178;441572;66.2;57.9
68;2021-08-21;492;1382;505670;442954;66.3;58.0
68;2021-08-22;116;457;505786;443411;66.3;58.1
68;2021-08-23;1191;5426;506977;448837;66.4;58.8
68;2021-08-24;1407;5955;508384;454792;66.6;59.6
68;2021-08-25;1661;3752;510045;458544;66.8;60.1
68;2021-08-26;1991;4505;512036;463049;67.1;60.7
68;2021-08-27;1850;6281;513886;469330;67.3;61.5
68;2021-08-28;422;1070;514308;470400;67.4;61.6
68;2021-08-29;36;418;514344;470818;67.4;61.7
68;2021-08-30;1350;4519;515694;475337;67.6;62.3
68;2021-08-31;1304;4113;516998;479450;67.7;62.8
68;2021-09-01;890;2141;517888;481591;67.9;63.1
68;2021-09-02;879;1769;518767;483360;68.0;63.3
68;2021-09-03;1308;4321;520075;487681;68.1;63.9
68;2021-09-04;495;870;520570;488551;68.2;64.0
68;2021-09-05;209;120;520779;488671;68.2;64.0
68;2021-09-06;698;2137;521477;490808;68.3;64.3
68;2021-09-07;607;1262;522084;492070;68.4;64.5
68;2021-09-08;618;1330;522702;493400;68.5;64.6
68;2021-09-09;900;1241;523602;494641;68.6;64.8
68;2021-09-10;1485;3028;525087;497669;68.8;65.2
68;2021-09-11;470;619;525557;498288;68.9;65.3
68;2021-09-12;73;53;525630;498341;68.9;65.3
68;2021-09-13;816;1185;526446;499526;69.0;65.5
68;2021-09-14;976;1347;527422;500873;69.1;65.6
68;2021-09-15;697;1587;528119;502460;69.2;65.8
68;2021-09-16;632;1079;528751;503539;69.3;66.0
68;2021-09-17;987;2331;529738;505870;69.4;66.3
68;2021-09-18;446;766;530184;506636;69.5;66.4
68;2021-09-19;16;48;530200;506684;69.5;66.4
68;2021-09-20;553;967;530753;507651;69.5;66.5
68;2021-09-21;585;1327;531338;508978;69.6;66.7
68;2021-09-22;635;1155;531973;510133;69.7;66.8
68;2021-09-23;368;681;532341;510814;69.8;66.9
68;2021-09-24;646;1607;532987;512421;69.8;67.1
68;2021-09-25;276;669;533263;513090;69.9;67.2
68;2021-09-26;19;56;533282;513146;69.9;67.2
68;2021-09-27;339;688;533621;513834;69.9;67.3
68;2021-09-28;339;546;533960;514380;70.0;67.4
68;2021-09-29;538;877;534498;515257;70.0;67.5
68;2021-09-30;387;790;534885;516047;70.1;67.6
68;2021-10-01;505;1541;535390;517588;70.2;67.8
68;2021-10-02;267;572;535657;518160;70.2;67.9
68;2021-10-03;38;91;535695;518251;70.2;67.9
68;2021-10-04;213;424;535908;518675;70.2;68.0
68;2021-10-05;290;561;536198;519236;70.3;68.0
68;2021-10-06;383;876;536581;520112;70.3;68.1
68;2021-10-07;389;594;536970;520706;70.4;68.2
68;2021-10-08;694;1622;537664;522328;70.4;68.4
68;2021-10-09;308;615;537972;522943;70.5;68.5
68;2021-10-10;29;45;538001;522988;70.5;68.5
68;2021-10-11;235;463;538236;523451;70.5;68.6
68;2021-10-12;243;479;538479;523930;70.6;68.6
68;2021-10-13;495;665;538974;524595;70.6;68.7
68;2021-10-14;372;614;539346;525209;70.7;68.8
69;2020-12-27;5;1;5;1;0.0;0.0
69;2020-12-28;13;3;18;4;0.0;0.0
69;2020-12-29;5;0;23;4;0.0;0.0
69;2020-12-30;6;1;29;5;0.0;0.0
69;2020-12-31;12;4;41;9;0.0;0.0
69;2021-01-01;2;0;43;9;0.0;0.0
69;2021-01-02;2;1;45;10;0.0;0.0
69;2021-01-03;3;2;48;12;0.0;0.0
69;2021-01-04;13;0;61;12;0.0;0.0
69;2021-01-05;218;9;279;21;0.0;0.0
69;2021-01-06;518;5;797;26;0.0;0.0
69;2021-01-07;813;5;1610;31;0.1;0.0
69;2021-01-08;829;1;2439;32;0.1;0.0
69;2021-01-09;42;3;2481;35;0.1;0.0
69;2021-01-10;3;1;2484;36;0.1;0.0
69;2021-01-11;1135;2;3619;38;0.2;0.0
69;2021-01-12;1399;10;5018;48;0.3;0.0
69;2021-01-13;1395;6;6413;54;0.3;0.0
69;2021-01-14;2287;27;8700;81;0.5;0.0
69;2021-01-15;1829;8;10529;89;0.6;0.0
69;2021-01-16;930;4;11459;93;0.6;0.0
69;2021-01-17;260;3;11719;96;0.6;0.0
69;2021-01-18;1695;19;13414;115;0.7;0.0
69;2021-01-19;3513;37;16927;152;0.9;0.0
69;2021-01-20;4456;34;21383;186;1.1;0.0
69;2021-01-21;4078;43;25461;229;1.4;0.0
69;2021-01-22;3184;30;28645;259;1.5;0.0
69;2021-01-23;1287;6;29932;265;1.6;0.0
69;2021-01-24;103;1;30035;266;1.6;0.0
69;2021-01-25;2245;45;32280;311;1.7;0.0
69;2021-01-26;2563;92;34843;403;1.9;0.0
69;2021-01-27;2360;176;37203;579;2.0;0.0
69;2021-01-28;2238;374;39441;953;2.1;0.1
69;2021-01-29;2111;291;41552;1244;2.2;0.1
69;2021-01-30;889;3;42441;1247;2.3;0.1
69;2021-01-31;65;0;42506;1247;2.3;0.1
69;2021-02-01;1112;401;43618;1648;2.3;0.1
69;2021-02-02;1560;425;45178;2073;2.4;0.1
69;2021-02-03;1444;537;46622;2610;2.5;0.1
69;2021-02-04;1797;954;48419;3564;2.6;0.2
69;2021-02-05;820;822;49239;4386;2.6;0.2
69;2021-02-06;370;53;49609;4439;2.6;0.2
69;2021-02-07;0;0;49609;4439;2.6;0.2
69;2021-02-08;1132;1075;50741;5514;2.7;0.3
69;2021-02-09;2052;2117;52793;7631;2.8;0.4
69;2021-02-10;1855;2658;54648;10289;2.9;0.5
69;2021-02-11;1860;3295;56508;13584;3.0;0.7
69;2021-02-12;1906;2101;58414;15685;3.1;0.8
69;2021-02-13;460;788;58874;16473;3.1;0.9
69;2021-02-14;89;39;58963;16512;3.1;0.9
69;2021-02-15;1016;1764;59979;18276;3.2;1.0
69;2021-02-16;984;2438;60963;20714;3.2;1.1
69;2021-02-17;1026;2391;61989;23105;3.3;1.2
69;2021-02-18;968;2302;62957;25407;3.4;1.4
69;2021-02-19;890;1873;63847;27280;3.4;1.5
69;2021-02-20;321;911;64168;28191;3.4;1.5
69;2021-02-21;53;70;64221;28261;3.4;1.5
69;2021-02-22;608;2099;64829;30360;3.5;1.6
69;2021-02-23;741;2221;65570;32581;3.5;1.7
69;2021-02-24;973;2252;66543;34833;3.5;1.9
69;2021-02-25;2214;2689;68757;37522;3.7;2.0
69;2021-02-26;2772;1932;71529;39454;3.8;2.1
69;2021-02-27;925;576;72454;40030;3.9;2.1
69;2021-02-28;148;104;72602;40134;3.9;2.1
69;2021-03-01;2171;914;74773;41048;4.0;2.2
69;2021-03-02;3299;1430;78072;42478;4.2;2.3
69;2021-03-03;3671;1246;81743;43724;4.4;2.3
69;2021-03-04;4888;1319;86631;45043;4.6;2.4
69;2021-03-05;5874;1280;92505;46323;4.9;2.5
69;2021-03-06;3417;434;95922;46757;5.1;2.5
69;2021-03-07;640;44;96562;46801;5.1;2.5
69;2021-03-08;2962;1134;99524;47935;5.3;2.6
69;2021-03-09;4606;1282;104130;49217;5.6;2.6
69;2021-03-10;5075;1071;109205;50288;5.8;2.7
69;2021-03-11;6603;1081;115808;51369;6.2;2.7
69;2021-03-12;8857;1253;124665;52622;6.6;2.8
69;2021-03-13;4928;257;129593;52879;6.9;2.8
69;2021-03-14;2741;158;132334;53037;7.1;2.8
69;2021-03-15;4804;742;137138;53779;7.3;2.9
69;2021-03-16;3820;679;140958;54458;7.5;2.9
69;2021-03-17;3953;906;144911;55364;7.7;3.0
69;2021-03-18;4967;1637;149878;57001;8.0;3.0
69;2021-03-19;6684;1086;156562;58087;8.3;3.1
69;2021-03-20;3593;285;160155;58372;8.5;3.1
69;2021-03-21;1975;104;162130;58476;8.6;3.1
69;2021-03-22;4550;829;166680;59305;8.9;3.2
69;2021-03-23;7364;852;174044;60157;9.3;3.2
69;2021-03-24;6456;1025;180500;61182;9.6;3.3
69;2021-03-25;8595;1144;189095;62326;10.1;3.3
69;2021-03-26;8813;1273;197908;63599;10.5;3.4
69;2021-03-27;3157;803;201065;64402;10.7;3.4
69;2021-03-28;2219;192;203284;64594;10.8;3.4
69;2021-03-29;4095;2198;207379;66792;11.1;3.6
69;2021-03-30;7640;2572;215019;69364;11.5;3.7
69;2021-03-31;6356;3201;221375;72565;11.8;3.9
69;2021-04-01;8463;2763;229838;75328;12.3;4.0
69;2021-04-02;8315;3151;238153;78479;12.7;4.2
69;2021-04-03;5424;2174;243577;80653;13.0;4.3
69;2021-04-04;6610;556;250187;81209;13.3;4.3
69;2021-04-05;6192;823;256379;82032;13.7;4.4
69;2021-04-06;5115;3497;261494;85529;13.9;4.6
69;2021-04-07;5168;3910;266662;89439;14.2;4.8
69;2021-04-08;6430;4059;273092;93498;14.6;5.0
69;2021-04-09;9164;3802;282256;97300;15.0;5.2
69;2021-04-10;3055;2512;285311;99812;15.2;5.3
69;2021-04-11;2035;1904;287346;101716;15.3;5.4
69;2021-04-12;5474;3592;292820;105308;15.6;5.6
69;2021-04-13;7068;4135;299888;109443;16.0;5.8
69;2021-04-14;6717;4169;306605;113612;16.3;6.1
69;2021-04-15;7943;4617;314548;118229;16.8;6.3
69;2021-04-16;7868;4520;322416;122749;17.2;6.5
69;2021-04-17;5036;2319;327452;125068;17.5;6.7
69;2021-04-18;1715;1796;329167;126864;17.5;6.8
69;2021-04-19;7020;3782;336187;130646;17.9;7.0
69;2021-04-20;6485;4779;342672;135425;18.3;7.2
69;2021-04-21;5691;4428;348363;139853;18.6;7.5
69;2021-04-22;6427;5457;354790;145310;18.9;7.7
69;2021-04-23;6737;4918;361527;150228;19.3;8.0
69;2021-04-24;3160;2037;364687;152265;19.4;8.1
69;2021-04-25;2120;1548;366807;153813;19.6;8.2
69;2021-04-26;4495;3887;371302;157700;19.8;8.4
69;2021-04-27;6516;5337;377818;163037;20.1;8.7
69;2021-04-28;6272;4875;384090;167912;20.5;9.0
69;2021-04-29;6706;5408;390796;173320;20.8;9.2
69;2021-04-30;6931;6193;397727;179513;21.2;9.6
69;2021-05-01;3301;646;401028;180159;21.4;9.6
69;2021-05-02;1628;5885;402656;186044;21.5;9.9
69;2021-05-03;5860;8256;408516;194300;21.8;10.4
69;2021-05-04;7608;8181;416124;202481;22.2;10.8
69;2021-05-05;11212;5668;427336;208149;22.8;11.1
69;2021-05-06;12470;6311;439806;214460;23.4;11.4
69;2021-05-07;11685;7173;451491;221633;24.1;11.8
69;2021-05-08;4303;1658;455794;223291;24.3;11.9
69;2021-05-09;6634;2684;462428;225975;24.6;12.0
69;2021-05-10;6935;6076;469363;232051;25.0;12.4
69;2021-05-11;9829;7048;479192;239099;25.5;12.7
69;2021-05-12;12450;6813;491642;245912;26.2;13.1
69;2021-05-13;10838;2562;502480;248474;26.8;13.2
69;2021-05-14;12599;5217;515079;253691;27.5;13.5
69;2021-05-15;9136;2591;524215;256282;27.9;13.7
69;2021-05-16;8403;1876;532618;258158;28.4;13.8
69;2021-05-17;11306;5652;543924;263810;29.0;14.1
69;2021-05-18;13226;6401;557150;270211;29.7;14.4
69;2021-05-19;13696;5888;570846;276099;30.4;14.7
69;2021-05-20;11387;6087;582233;282186;31.0;15.0
69;2021-05-21;11036;6559;593269;288745;31.6;15.4
69;2021-05-22;5574;2577;598843;291322;31.9;15.5
69;2021-05-23;4573;1543;603416;292865;32.2;15.6
69;2021-05-24;8419;1864;611835;294729;32.6;15.7
69;2021-05-25;9742;6179;621577;300908;33.1;16.0
69;2021-05-26;10282;6110;631859;307018;33.7;16.4
69;2021-05-27;10429;6788;642288;313806;34.2;16.7
69;2021-05-28;11610;8754;653898;322560;34.9;17.2
69;2021-05-29;7387;6047;661285;328607;35.2;17.5
69;2021-05-30;7387;3169;668672;331776;35.6;17.7
69;2021-05-31;10955;6381;679627;338157;36.2;18.0
69;2021-06-01;12849;7520;692476;345677;36.9;18.4
69;2021-06-02;14887;6724;707363;352401;37.7;18.8
69;2021-06-03;16641;7432;724004;359833;38.6;19.2
69;2021-06-04;16198;8564;740202;368397;39.5;19.6
69;2021-06-05;10105;3420;750307;371817;40.0;19.8
69;2021-06-06;7488;1720;757795;373537;40.4;19.9
69;2021-06-07;12815;7029;770610;380566;41.1;20.3
69;2021-06-08;16308;8283;786918;388849;41.9;20.7
69;2021-06-09;15212;7361;802130;396210;42.8;21.1
69;2021-06-10;16278;7337;818408;403547;43.6;21.5
69;2021-06-11;16635;9691;835043;413238;44.5;22.0
69;2021-06-12;8529;4189;843572;417427;45.0;22.3
69;2021-06-13;5620;2146;849192;419573;45.3;22.4
69;2021-06-14;8575;9085;857767;428658;45.7;22.8
69;2021-06-15;10932;11015;868699;439673;46.3;23.4
69;2021-06-16;11332;12321;880031;451994;46.9;24.1
69;2021-06-17;11455;13261;891486;465255;47.5;24.8
69;2021-06-18;12043;14775;903529;480030;48.2;25.6
69;2021-06-19;6813;8355;910342;488385;48.5;26.0
69;2021-06-20;5274;4768;915616;493153;48.8;26.3
69;2021-06-21;6538;12119;922154;505272;49.2;26.9
69;2021-06-22;7210;13835;929364;519107;49.5;27.7
69;2021-06-23;8347;13028;937711;532135;50.0;28.4
69;2021-06-24;9293;13745;947004;545880;50.5;29.1
69;2021-06-25;7079;16311;954083;562191;50.9;30.0
69;2021-06-26;3871;9073;957954;571264;51.1;30.5
69;2021-06-27;3291;7420;961245;578684;51.2;30.8
69;2021-06-28;4551;14893;965796;593577;51.5;31.6
69;2021-06-29;5367;15670;971163;609247;51.8;32.5
69;2021-06-30;6386;14452;977549;623699;52.1;33.2
69;2021-07-01;9054;11980;986603;635679;52.6;33.9
69;2021-07-02;10688;14129;997291;649808;53.2;34.6
69;2021-07-03;5994;7771;1003285;657579;53.5;35.1
69;2021-07-04;4126;5550;1007411;663129;53.7;35.3
69;2021-07-05;6231;13021;1013642;676150;54.0;36.0
69;2021-07-06;5914;14280;1019556;690430;54.3;36.8
69;2021-07-07;7318;13563;1026874;703993;54.7;37.5
69;2021-07-08;7587;13409;1034461;717402;55.1;38.2
69;2021-07-09;7582;16480;1042043;733882;55.5;39.1
69;2021-07-10;3124;10312;1045167;744194;55.7;39.7
69;2021-07-11;4331;5830;1049498;750024;55.9;40.0
69;2021-07-12;4212;16969;1053710;766993;56.2;40.9
69;2021-07-13;6451;20720;1060161;787713;56.5;42.0
69;2021-07-14;5054;8482;1065215;796195;56.8;42.4
69;2021-07-15;7498;22583;1072713;818778;57.2;43.6
69;2021-07-16;9963;20120;1082676;838898;57.7;44.7
69;2021-07-17;4882;12239;1087558;851137;58.0;45.4
69;2021-07-18;3411;8894;1090969;860031;58.2;45.8
69;2021-07-19;7072;16464;1098041;876495;58.5;46.7
69;2021-07-20;9580;19307;1107621;895802;59.0;47.7
69;2021-07-21;9387;17423;1117008;913225;59.5;48.7
69;2021-07-22;11472;16402;1128480;929627;60.2;49.6
69;2021-07-23;11140;17688;1139620;947315;60.7;50.5
69;2021-07-24;5707;11049;1145327;958364;61.0;51.1
69;2021-07-25;4706;6630;1150033;964994;61.3;51.4
69;2021-07-26;8927;12953;1158960;977947;61.8;52.1
69;2021-07-27;12939;12097;1171899;990044;62.5;52.8
69;2021-07-28;12092;12158;1183991;1002202;63.1;53.4
69;2021-07-29;14763;12264;1198754;1014466;63.9;54.1
69;2021-07-30;14418;12245;1213172;1026711;64.7;54.7
69;2021-07-31;8270;7256;1221442;1033967;65.1;55.1
69;2021-08-01;5189;5881;1226631;1039848;65.4;55.4
69;2021-08-02;13272;9640;1239903;1049488;66.1;55.9
69;2021-08-03;13291;8991;1253194;1058479;66.8;56.4
69;2021-08-04;14353;8141;1267547;1066620;67.6;56.9
69;2021-08-05;11533;7540;1279080;1074160;68.2;57.3
69;2021-08-06;10610;7799;1289690;1081959;68.7;57.7
69;2021-08-07;5007;4811;1294697;1086770;69.0;57.9
69;2021-08-08;4372;3566;1299069;1090336;69.2;58.1
69;2021-08-09;7779;9219;1306848;1099555;69.7;58.6
69;2021-08-10;8091;7041;1314939;1106596;70.1;59.0
69;2021-08-11;7898;8113;1322837;1114709;70.5;59.4
69;2021-08-12;7317;7334;1330154;1122043;70.9;59.8
69;2021-08-13;6749;8361;1336903;1130404;71.3;60.3
69;2021-08-14;4513;5210;1341416;1135614;71.5;60.5
69;2021-08-15;2490;2522;1343906;1138136;71.6;60.7
69;2021-08-16;5940;8882;1349846;1147018;72.0;61.1
69;2021-08-17;6418;8275;1356264;1155293;72.3;61.6
69;2021-08-18;6251;9473;1362515;1164766;72.6;62.1
69;2021-08-19;6338;9335;1368853;1174101;73.0;62.6
69;2021-08-20;6189;8846;1375042;1182947;73.3;63.1
69;2021-08-21;2863;3958;1377905;1186905;73.4;63.3
69;2021-08-22;1965;2420;1379870;1189325;73.6;63.4
69;2021-08-23;3949;12384;1383819;1201709;73.8;64.1
69;2021-08-24;5192;13644;1389011;1215353;74.0;64.8
69;2021-08-25;4553;12910;1393564;1228263;74.3;65.5
69;2021-08-26;4561;11737;1398125;1240000;74.5;66.1
69;2021-08-27;4309;14451;1402434;1254451;74.8;66.9
69;2021-08-28;1966;8635;1404400;1263086;74.9;67.3
69;2021-08-29;1339;6527;1405739;1269613;74.9;67.7
69;2021-08-30;3259;11734;1408998;1281347;75.1;68.3
69;2021-08-31;4199;9998;1413197;1291345;75.3;68.8
69;2021-09-01;5147;9452;1418344;1300797;75.6;69.3
69;2021-09-02;4496;8373;1422840;1309170;75.8;69.8
69;2021-09-03;4531;10435;1427371;1319605;76.1;70.3
69;2021-09-04;3002;8540;1430373;1328145;76.2;70.8
69;2021-09-05;1434;3618;1431807;1331763;76.3;71.0
69;2021-09-06;2538;6131;1434345;1337894;76.5;71.3
69;2021-09-07;2406;6055;1436751;1343949;76.6;71.6
69;2021-09-08;2703;6822;1439454;1350771;76.7;72.0
69;2021-09-09;2422;5812;1441876;1356583;76.9;72.3
69;2021-09-10;2708;6655;1444584;1363238;77.0;72.7
69;2021-09-11;1744;5065;1446328;1368303;77.1;72.9
69;2021-09-12;526;2225;1446854;1370528;77.1;73.1
69;2021-09-13;1782;4553;1448636;1375081;77.2;73.3
69;2021-09-14;1862;4221;1450498;1379302;77.3;73.5
69;2021-09-15;1915;5053;1452413;1384355;77.4;73.8
69;2021-09-16;1562;3495;1453975;1387850;77.5;74.0
69;2021-09-17;1796;4888;1455771;1392738;77.6;74.2
69;2021-09-18;1113;4090;1456884;1396828;77.7;74.5
69;2021-09-19;479;1523;1457363;1398351;77.7;74.5
69;2021-09-20;992;2994;1458355;1401345;77.7;74.7
69;2021-09-21;980;3515;1459335;1404860;77.8;74.9
69;2021-09-22;1160;4071;1460495;1408931;77.8;75.1
69;2021-09-23;916;3071;1461411;1412002;77.9;75.3
69;2021-09-24;1245;4186;1462656;1416188;78.0;75.5
69;2021-09-25;723;2737;1463379;1418925;78.0;75.6
69;2021-09-26;296;1211;1463675;1420136;78.0;75.7
69;2021-09-27;663;2044;1464338;1422180;78.1;75.8
69;2021-09-28;925;2110;1465263;1424290;78.1;75.9
69;2021-09-29;1145;3294;1466408;1427584;78.2;76.1
69;2021-09-30;941;2364;1467349;1429948;78.2;76.2
69;2021-10-01;1519;3548;1468868;1433496;78.3;76.4
69;2021-10-02;946;2268;1469814;1435764;78.3;76.5
69;2021-10-03;317;649;1470131;1436413;78.4;76.6
69;2021-10-04;784;2017;1470915;1438430;78.4;76.7
69;2021-10-05;774;1830;1471689;1440260;78.4;76.8
69;2021-10-06;1103;2419;1472792;1442679;78.5;76.9
69;2021-10-07;875;1797;1473667;1444476;78.6;77.0
69;2021-10-08;1250;3020;1474917;1447496;78.6;77.2
69;2021-10-09;733;1558;1475650;1449054;78.7;77.2
69;2021-10-10;60;412;1475710;1449466;78.7;77.3
69;2021-10-11;572;1769;1476282;1451235;78.7;77.4
69;2021-10-12;826;1315;1477108;1452550;78.7;77.4
69;2021-10-13;1123;2086;1478231;1454636;78.8;77.5
69;2021-10-14;802;1664;1479033;1456300;78.8;77.6
70;2020-12-27;0;0;0;0;0.0;0.0
70;2020-12-28;0;0;0;0;0.0;0.0
70;2020-12-29;0;0;0;0;0.0;0.0
70;2020-12-30;0;0;0;0;0.0;0.0
70;2020-12-31;0;0;0;0;0.0;0.0
70;2021-01-01;0;0;0;0;0.0;0.0
70;2021-01-02;0;0;0;0;0.0;0.0
70;2021-01-03;0;0;0;0;0.0;0.0
70;2021-01-04;0;0;0;0;0.0;0.0
70;2021-01-05;1;1;1;1;0.0;0.0
70;2021-01-06;24;0;25;1;0.0;0.0
70;2021-01-07;121;0;146;1;0.1;0.0
70;2021-01-08;22;0;168;1;0.1;0.0
70;2021-01-09;0;0;168;1;0.1;0.0
70;2021-01-10;0;0;168;1;0.1;0.0
70;2021-01-11;148;1;316;2;0.1;0.0
70;2021-01-12;201;1;517;3;0.2;0.0
70;2021-01-13;172;2;689;5;0.3;0.0
70;2021-01-14;148;6;837;11;0.4;0.0
70;2021-01-15;153;1;990;12;0.4;0.0
70;2021-01-16;65;0;1055;12;0.5;0.0
70;2021-01-17;0;0;1055;12;0.5;0.0
70;2021-01-18;398;0;1453;12;0.6;0.0
70;2021-01-19;503;2;1956;14;0.8;0.0
70;2021-01-20;494;2;2450;16;1.1;0.0
70;2021-01-21;675;3;3125;19;1.3;0.0
70;2021-01-22;458;3;3583;22;1.5;0.0
70;2021-01-23;261;2;3844;24;1.6;0.0
70;2021-01-24;4;0;3848;24;1.7;0.0
70;2021-01-25;370;1;4218;25;1.8;0.0
70;2021-01-26;335;1;4553;26;2.0;0.0
70;2021-01-27;331;12;4884;38;2.1;0.0
70;2021-01-28;366;36;5250;74;2.3;0.0
70;2021-01-29;329;52;5579;126;2.4;0.1
70;2021-01-30;228;1;5807;127;2.5;0.1
70;2021-01-31;0;0;5807;127;2.5;0.1
70;2021-02-01;262;52;6069;179;2.6;0.1
70;2021-02-02;272;98;6341;277;2.7;0.1
70;2021-02-03;250;61;6591;338;2.8;0.1
70;2021-02-04;265;125;6856;463;2.9;0.2
70;2021-02-05;254;75;7110;538;3.0;0.2
70;2021-02-06;209;38;7319;576;3.1;0.2
70;2021-02-07;0;0;7319;576;3.1;0.2
70;2021-02-08;179;233;7498;809;3.2;0.3
70;2021-02-09;206;229;7704;1038;3.3;0.4
70;2021-02-10;196;305;7900;1343;3.4;0.6
70;2021-02-11;351;338;8251;1681;3.5;0.7
70;2021-02-12;239;492;8490;2173;3.6;0.9
70;2021-02-13;75;210;8565;2383;3.7;1.0
70;2021-02-14;0;29;8565;2412;3.7;1.0
70;2021-02-15;69;339;8634;2751;3.7;1.2
70;2021-02-16;113;362;8747;3113;3.8;1.3
70;2021-02-17;165;302;8912;3415;3.8;1.5
70;2021-02-18;205;257;9117;3672;3.9;1.6
70;2021-02-19;197;204;9314;3876;4.0;1.7
70;2021-02-20;192;69;9506;3945;4.1;1.7
70;2021-02-21;1;0;9507;3945;4.1;1.7
70;2021-02-22;106;238;9613;4183;4.1;1.8
70;2021-02-23;125;261;9738;4444;4.2;1.9
70;2021-02-24;132;234;9870;4678;4.2;2.0
70;2021-02-25;315;259;10185;4937;4.4;2.1
70;2021-02-26;395;151;10580;5088;4.5;2.2
70;2021-02-27;147;202;10727;5290;4.6;2.3
70;2021-02-28;0;0;10727;5290;4.6;2.3
70;2021-03-01;248;243;10975;5533;4.7;2.4
70;2021-03-02;487;278;11462;5811;4.9;2.5
70;2021-03-03;468;260;11930;6071;5.1;2.6
70;2021-03-04;693;278;12623;6349;5.4;2.7
70;2021-03-05;767;262;13390;6611;5.7;2.8
70;2021-03-06;539;119;13929;6730;6.0;2.9
70;2021-03-07;216;23;14145;6753;6.1;2.9
70;2021-03-08;554;214;14699;6967;6.3;3.0
70;2021-03-09;864;176;15563;7143;6.7;3.1
70;2021-03-10;659;179;16222;7322;7.0;3.1
70;2021-03-11;698;256;16920;7578;7.3;3.2
70;2021-03-12;985;181;17905;7759;7.7;3.3
70;2021-03-13;582;125;18487;7884;7.9;3.4
70;2021-03-14;20;1;18507;7885;7.9;3.4
70;2021-03-15;774;112;19281;7997;8.3;3.4
70;2021-03-16;655;99;19936;8096;8.5;3.5
70;2021-03-17;595;183;20531;8279;8.8;3.6
70;2021-03-18;633;141;21164;8420;9.1;3.6
70;2021-03-19;1019;143;22183;8563;9.5;3.7
70;2021-03-20;641;186;22824;8749;9.8;3.8
70;2021-03-21;9;0;22833;8749;9.8;3.8
70;2021-03-22;757;101;23590;8850;10.1;3.8
70;2021-03-23;1310;165;24900;9015;10.7;3.9
70;2021-03-24;1270;111;26170;9126;11.2;3.9
70;2021-03-25;1247;201;27417;9327;11.8;4.0
70;2021-03-26;1485;304;28902;9631;12.4;4.1
70;2021-03-27;956;129;29858;9760;12.8;4.2
70;2021-03-28;0;10;29858;9770;12.8;4.2
70;2021-03-29;721;417;30579;10187;13.1;4.4
70;2021-03-30;1093;317;31672;10504;13.6;4.5
70;2021-03-31;878;318;32550;10822;14.0;4.6
70;2021-04-01;1153;429;33703;11251;14.5;4.8
70;2021-04-02;1310;348;35013;11599;15.0;5.0
70;2021-04-03;639;323;35652;11922;15.3;5.1
70;2021-04-04;11;1;35663;11923;15.3;5.1
70;2021-04-05;4;2;35667;11925;15.3;5.1
70;2021-04-06;831;558;36498;12483;15.7;5.4
70;2021-04-07;858;590;37356;13073;16.0;5.6
70;2021-04-08;1319;567;38675;13640;16.6;5.8
70;2021-04-09;1402;542;40077;14182;17.2;6.1
70;2021-04-10;859;346;40936;14528;17.6;6.2
70;2021-04-11;23;1;40959;14529;17.6;6.2
70;2021-04-12;696;662;41655;15191;17.9;6.5
70;2021-04-13;921;770;42576;15961;18.3;6.8
70;2021-04-14;816;579;43392;16540;18.6;7.1
70;2021-04-15;1079;608;44471;17148;19.1;7.4
70;2021-04-16;1242;554;45713;17702;19.6;7.6
70;2021-04-17;688;469;46401;18171;19.9;7.8
70;2021-04-18;62;4;46463;18175;19.9;7.8
70;2021-04-19;540;810;47003;18985;20.2;8.1
70;2021-04-20;663;852;47666;19837;20.4;8.5
70;2021-04-21;483;932;48149;20769;20.6;8.9
70;2021-04-22;775;802;48924;21571;21.0;9.3
70;2021-04-23;875;743;49799;22314;21.4;9.6
70;2021-04-24;432;642;50231;22956;21.5;9.8
70;2021-04-25;11;0;50242;22956;21.5;9.8
70;2021-04-26;923;605;51165;23561;21.9;10.1
70;2021-04-27;1208;756;52373;24317;22.5;10.4
70;2021-04-28;889;812;53262;25129;22.8;10.8
70;2021-04-29;1342;935;54604;26064;23.4;11.2
70;2021-04-30;1533;876;56137;26940;24.1;11.6
70;2021-05-01;1694;121;57831;27061;24.8;11.6
70;2021-05-02;2;0;57833;27061;24.8;11.6
70;2021-05-03;1189;582;59022;27643;25.3;11.9
70;2021-05-04;1353;758;60375;28401;25.9;12.2
70;2021-05-05;1188;880;61563;29281;26.4;12.6
70;2021-05-06;1845;1271;63408;30552;27.2;13.1
70;2021-05-07;2127;1247;65535;31799;28.1;13.6
70;2021-05-08;1342;194;66877;31993;28.7;13.7
70;2021-05-09;9;58;66886;32051;28.7;13.7
70;2021-05-10;961;947;67847;32998;29.1;14.2
70;2021-05-11;1240;1080;69087;34078;29.6;14.6
70;2021-05-12;1175;867;70262;34945;30.1;15.0
70;2021-05-13;1544;147;71806;35092;30.8;15.0
70;2021-05-14;2062;757;73868;35849;31.7;15.4
70;2021-05-15;2656;531;76524;36380;32.8;15.6
70;2021-05-16;999;72;77523;36452;33.2;15.6
70;2021-05-17;1237;386;78760;36838;33.8;15.8
70;2021-05-18;1296;591;80056;37429;34.3;16.1
70;2021-05-19;1476;480;81532;37909;35.0;16.3
70;2021-05-20;1779;632;83311;38541;35.7;16.5
70;2021-05-21;1692;823;85003;39364;36.5;16.9
70;2021-05-22;1219;666;86222;40030;37.0;17.2
70;2021-05-23;8;14;86230;40044;37.0;17.2
70;2021-05-24;227;28;86457;40072;37.1;17.2
70;2021-05-25;837;926;87294;40998;37.4;17.6
70;2021-05-26;1048;946;88342;41944;37.9;18.0
70;2021-05-27;1263;998;89605;42942;38.4;18.4
70;2021-05-28;1546;1161;91151;44103;39.1;18.9
70;2021-05-29;1370;588;92521;44691;39.7;19.2
70;2021-05-30;1;8;92522;44699;39.7;19.2
70;2021-05-31;969;679;93491;45378;40.1;19.5
70;2021-06-01;1213;847;94704;46225;40.6;19.8
70;2021-06-02;1265;680;95969;46905;41.2;20.1
70;2021-06-03;1429;837;97398;47742;41.8;20.5
70;2021-06-04;1335;1111;98733;48853;42.3;20.9
70;2021-06-05;1024;663;99757;49516;42.8;21.2
70;2021-06-06;599;79;100356;49595;43.0;21.3
70;2021-06-07;941;848;101297;50443;43.4;21.6
70;2021-06-08;1216;1187;102513;51630;44.0;22.1
70;2021-06-09;1156;987;103669;52617;44.5;22.6
70;2021-06-10;1567;831;105236;53448;45.1;22.9
70;2021-06-11;1586;1959;106822;55407;45.8;23.8
70;2021-06-12;829;1970;107651;57377;46.2;24.6
70;2021-06-13;143;15;107794;57392;46.2;24.6
70;2021-06-14;559;1243;108353;58635;46.5;25.1
70;2021-06-15;451;1506;108804;60141;46.7;25.8
70;2021-06-16;798;1391;109602;61532;47.0;26.4
70;2021-06-17;1154;2098;110756;63630;47.5;27.3
70;2021-06-18;995;2254;111751;65884;47.9;28.3
70;2021-06-19;1092;1639;112843;67523;48.4;29.0
70;2021-06-20;1;3;112844;67526;48.4;29.0
70;2021-06-21;691;1453;113535;68979;48.7;29.6
70;2021-06-22;655;1513;114190;70492;49.0;30.2
70;2021-06-23;662;1569;114852;72061;49.3;30.9
70;2021-06-24;877;2049;115729;74110;49.6;31.8
70;2021-06-25;681;2649;116410;76759;49.9;32.9
70;2021-06-26;943;2136;117353;78895;50.3;33.8
70;2021-06-27;141;763;117494;79658;50.4;34.2
70;2021-06-28;335;1353;117829;81011;50.5;34.7
70;2021-06-29;411;1611;118240;82622;50.7;35.4
70;2021-06-30;390;1633;118630;84255;50.9;36.1
70;2021-07-01;642;1751;119272;86006;51.1;36.9
70;2021-07-02;815;1578;120087;87584;51.5;37.6
70;2021-07-03;841;1084;120928;88668;51.9;38.0
70;2021-07-04;29;70;120957;88738;51.9;38.1
70;2021-07-05;610;1037;121567;89775;52.1;38.5
70;2021-07-06;681;1274;122248;91049;52.4;39.0
70;2021-07-07;508;1425;122756;92474;52.6;39.7
70;2021-07-08;817;1574;123573;94048;53.0;40.3
70;2021-07-09;873;1662;124446;95710;53.4;41.0
70;2021-07-10;831;1033;125277;96743;53.7;41.5
70;2021-07-11;7;20;125284;96763;53.7;41.5
70;2021-07-12;432;1391;125716;98154;53.9;42.1
70;2021-07-13;907;1868;126623;100022;54.3;42.9
70;2021-07-14;33;6;126656;100028;54.3;42.9
70;2021-07-15;1382;1694;128038;101722;54.9;43.6
70;2021-07-16;1632;2061;129670;103783;55.6;44.5
70;2021-07-17;1501;1454;131171;105237;56.2;45.1
70;2021-07-18;1145;641;132316;105878;56.7;45.4
70;2021-07-19;884;976;133200;106854;57.1;45.8
70;2021-07-20;1349;1352;134549;108206;57.7;46.4
70;2021-07-21;1286;1402;135835;109608;58.2;47.0
70;2021-07-22;1867;1828;137702;111436;59.1;47.8
70;2021-07-23;1826;2491;139528;113927;59.8;48.9
70;2021-07-24;1364;1806;140892;115733;60.4;49.6
70;2021-07-25;27;3;140919;115736;60.4;49.6
70;2021-07-26;1055;975;141974;116711;60.9;50.0
70;2021-07-27;1398;976;143372;117687;61.5;50.5
70;2021-07-28;1404;1162;144776;118849;62.1;51.0
70;2021-07-29;1873;1387;146649;120236;62.9;51.6
70;2021-07-30;1975;1348;148624;121584;63.7;52.1
70;2021-07-31;1751;1166;150375;122750;64.5;52.6
70;2021-08-01;2;4;150377;122754;64.5;52.6
70;2021-08-02;776;736;151153;123490;64.8;53.0
70;2021-08-03;1296;1039;152449;124529;65.4;53.4
70;2021-08-04;1210;922;153659;125451;65.9;53.8
70;2021-08-05;1657;1191;155316;126642;66.6;54.3
70;2021-08-06;1795;1336;157111;127978;67.4;54.9
70;2021-08-07;1192;1032;158303;129010;67.9;55.3
70;2021-08-08;35;28;158338;129038;67.9;55.3
70;2021-08-09;534;704;158872;129742;68.1;55.6
70;2021-08-10;898;1129;159770;130871;68.5;56.1
70;2021-08-11;808;722;160578;131593;68.9;56.4
70;2021-08-12;906;1272;161484;132865;69.2;57.0
70;2021-08-13;1040;1621;162524;134486;69.7;57.7
70;2021-08-14;771;977;163295;135463;70.0;58.1
70;2021-08-15;36;28;163331;135491;70.0;58.1
70;2021-08-16;545;910;163876;136401;70.3;58.5
70;2021-08-17;680;1194;164556;137595;70.6;59.0
70;2021-08-18;535;940;165091;138535;70.8;59.4
70;2021-08-19;565;1385;165656;139920;71.0;60.0
70;2021-08-20;510;1900;166166;141820;71.3;60.8
70;2021-08-21;447;1163;166613;142983;71.4;61.3
70;2021-08-22;2;6;166615;142989;71.4;61.3
70;2021-08-23;282;879;166897;143868;71.6;61.7
70;2021-08-24;386;1373;167283;145241;71.7;62.3
70;2021-08-25;354;1344;167637;146585;71.9;62.9
70;2021-08-26;439;1560;168076;148145;72.1;63.5
70;2021-08-27;392;2127;168468;150272;72.2;64.4
70;2021-08-28;367;1706;168835;151978;72.4;65.2
70;2021-08-29;12;6;168847;151984;72.4;65.2
70;2021-08-30;298;831;169145;152815;72.5;65.5
70;2021-08-31;360;1121;169505;153936;72.7;66.0
70;2021-09-01;316;987;169821;154923;72.8;66.4
70;2021-09-02;305;1107;170126;156030;73.0;66.9
70;2021-09-03;280;1067;170406;157097;73.1;67.4
70;2021-09-04;455;1117;170861;158214;73.3;67.8
70;2021-09-05;21;22;170882;158236;73.3;67.9
70;2021-09-06;168;602;171050;158838;73.4;68.1
70;2021-09-07;186;746;171236;159584;73.4;68.4
70;2021-09-08;193;778;171429;160362;73.5;68.8
70;2021-09-09;182;734;171611;161096;73.6;69.1
70;2021-09-10;256;798;171867;161894;73.7;69.4
70;2021-09-11;300;891;172167;162785;73.8;69.8
70;2021-09-12;7;30;172174;162815;73.8;69.8
70;2021-09-13;155;354;172329;163169;73.9;70.0
70;2021-09-14;318;423;172647;163592;74.0;70.2
70;2021-09-15;171;533;172818;164125;74.1;70.4
70;2021-09-16;251;392;173069;164517;74.2;70.5
70;2021-09-17;195;457;173264;164974;74.3;70.7
70;2021-09-18;177;459;173441;165433;74.4;70.9
70;2021-09-19;3;14;173444;165447;74.4;70.9
70;2021-09-20;82;215;173526;165662;74.4;71.0
70;2021-09-21;163;280;173689;165942;74.5;71.2
70;2021-09-22;115;384;173804;166326;74.5;71.3
70;2021-09-23;66;229;173870;166555;74.6;71.4
70;2021-09-24;196;389;174066;166944;74.6;71.6
70;2021-09-25;139;504;174205;167448;74.7;71.8
70;2021-09-26;0;1;174205;167449;74.7;71.8
70;2021-09-27;51;201;174256;167650;74.7;71.9
70;2021-09-28;77;195;174333;167845;74.8;72.0
70;2021-09-29;91;240;174424;168085;74.8;72.1
70;2021-09-30;81;158;174505;168243;74.8;72.1
70;2021-10-01;122;250;174627;168493;74.9;72.3
70;2021-10-02;115;326;174742;168819;74.9;72.4
70;2021-10-03;1;1;174743;168820;74.9;72.4
70;2021-10-04;73;169;174816;168989;75.0;72.5
70;2021-10-05;82;289;174898;169278;75.0;72.6
70;2021-10-06;129;213;175027;169491;75.1;72.7
70;2021-10-07;99;225;175126;169716;75.1;72.8
70;2021-10-08;113;222;175239;169938;75.1;72.9
70;2021-10-09;137;302;175376;170240;75.2;73.0
70;2021-10-10;1;5;175377;170245;75.2;73.0
70;2021-10-11;50;109;175427;170354;75.2;73.1
70;2021-10-12;53;122;175480;170476;75.3;73.1
70;2021-10-13;84;188;175564;170664;75.3;73.2
70;2021-10-14;49;112;175613;170776;75.3;73.2
71;2020-12-27;0;0;0;0;0.0;0.0
71;2020-12-28;1;0;1;0;0.0;0.0
71;2020-12-29;0;0;1;0;0.0;0.0
71;2020-12-30;0;0;1;0;0.0;0.0
71;2020-12-31;0;0;1;0;0.0;0.0
71;2021-01-01;1;0;2;0;0.0;0.0
71;2021-01-02;0;0;2;0;0.0;0.0
71;2021-01-03;2;1;4;1;0.0;0.0
71;2021-01-04;1;0;5;1;0.0;0.0
71;2021-01-05;13;0;18;1;0.0;0.0
71;2021-01-06;72;0;90;1;0.0;0.0
71;2021-01-07;67;2;157;3;0.0;0.0
71;2021-01-08;146;0;303;3;0.1;0.0
71;2021-01-09;117;0;420;3;0.1;0.0
71;2021-01-10;1;0;421;3;0.1;0.0
71;2021-01-11;245;1;666;4;0.1;0.0
71;2021-01-12;845;1;1511;5;0.3;0.0
71;2021-01-13;564;2;2075;7;0.4;0.0
71;2021-01-14;591;12;2666;19;0.5;0.0
71;2021-01-15;665;2;3331;21;0.6;0.0
71;2021-01-16;10;0;3341;21;0.6;0.0
71;2021-01-17;0;0;3341;21;0.6;0.0
71;2021-01-18;1095;8;4436;29;0.8;0.0
71;2021-01-19;1694;7;6130;36;1.1;0.0
71;2021-01-20;1517;7;7647;43;1.4;0.0
71;2021-01-21;2062;20;9709;63;1.8;0.0
71;2021-01-22;1414;6;11123;69;2.0;0.0
71;2021-01-23;816;6;11939;75;2.2;0.0
71;2021-01-24;1;1;11940;76;2.2;0.0
71;2021-01-25;1065;6;13005;82;2.4;0.0
71;2021-01-26;1505;29;14510;111;2.6;0.0
71;2021-01-27;1249;34;15759;145;2.9;0.0
71;2021-01-28;1082;99;16841;244;3.1;0.0
71;2021-01-29;1015;142;17856;386;3.3;0.1
71;2021-01-30;604;2;18460;388;3.4;0.1
71;2021-01-31;1;15;18461;403;3.4;0.1
71;2021-02-01;752;238;19213;641;3.5;0.1
71;2021-02-02;755;356;19968;997;3.6;0.2
71;2021-02-03;817;422;20785;1419;3.8;0.3
71;2021-02-04;784;573;21569;1992;3.9;0.4
71;2021-02-05;704;522;22273;2514;4.1;0.5
71;2021-02-06;539;10;22812;2524;4.2;0.5
71;2021-02-07;4;50;22816;2574;4.2;0.5
71;2021-02-08;603;696;23419;3270;4.3;0.6
71;2021-02-09;371;1009;23790;4279;4.3;0.8
71;2021-02-10;412;991;24202;5270;4.4;1.0
71;2021-02-11;477;1181;24679;6451;4.5;1.2
71;2021-02-12;535;1037;25214;7488;4.6;1.4
71;2021-02-13;124;500;25338;7988;4.6;1.5
71;2021-02-14;2;7;25340;7995;4.6;1.5
71;2021-02-15;322;908;25662;8903;4.7;1.6
71;2021-02-16;445;1353;26107;10256;4.8;1.9
71;2021-02-17;428;1128;26535;11384;4.8;2.1
71;2021-02-18;548;930;27083;12314;4.9;2.2
71;2021-02-19;571;844;27654;13158;5.0;2.4
71;2021-02-20;224;382;27878;13540;5.1;2.5
71;2021-02-21;4;13;27882;13553;5.1;2.5
71;2021-02-22;238;871;28120;14424;5.1;2.6
71;2021-02-23;452;929;28572;15353;5.2;2.8
71;2021-02-24;446;719;29018;16072;5.3;2.9
71;2021-02-25;533;724;29551;16796;5.4;3.1
71;2021-02-26;832;539;30383;17335;5.5;3.2
71;2021-02-27;456;335;30839;17670;5.6;3.2
71;2021-02-28;54;14;30893;17684;5.6;3.2
71;2021-03-01;1188;683;32081;18367;5.9;3.4
71;2021-03-02;1574;650;33655;19017;6.1;3.5
71;2021-03-03;1819;774;35474;19791;6.5;3.6
71;2021-03-04;2003;828;37477;20619;6.8;3.8
71;2021-03-05;2286;699;39763;21318;7.3;3.9
71;2021-03-06;754;66;40517;21384;7.4;3.9
71;2021-03-07;40;21;40557;21405;7.4;3.9
71;2021-03-08;1454;789;42011;22194;7.7;4.1
71;2021-03-09;2162;536;44173;22730;8.1;4.1
71;2021-03-10;2173;482;46346;23212;8.5;4.2
71;2021-03-11;2630;677;48976;23889;8.9;4.4
71;2021-03-12;2603;632;51579;24521;9.4;4.5
71;2021-03-13;995;102;52574;24623;9.6;4.5
71;2021-03-14;36;0;52610;24623;9.6;4.5
71;2021-03-15;1797;501;54407;25124;9.9;4.6
71;2021-03-16;1820;204;56227;25328;10.3;4.6
71;2021-03-17;2135;257;58362;25585;10.7;4.7
71;2021-03-18;1954;441;60316;26026;11.0;4.8
71;2021-03-19;2370;342;62686;26368;11.4;4.8
71;2021-03-20;1084;42;63770;26410;11.6;4.8
71;2021-03-21;17;5;63787;26415;11.6;4.8
71;2021-03-22;2574;384;66361;26799;12.1;4.9
71;2021-03-23;3349;509;69710;27308;12.7;5.0
71;2021-03-24;3347;471;73057;27779;13.3;5.1
71;2021-03-25;4029;606;77086;28385;14.1;5.2
71;2021-03-26;4057;348;81143;28733;14.8;5.2
71;2021-03-27;997;107;82140;28840;15.0;5.3
71;2021-03-28;57;8;82197;28848;15.0;5.3
71;2021-03-29;2408;1177;84605;30025;15.4;5.5
71;2021-03-30;2948;1359;87553;31384;16.0;5.7
71;2021-03-31;2545;1534;90098;32918;16.4;6.0
71;2021-04-01;2718;1305;92816;34223;16.9;6.2
71;2021-04-02;2501;1423;95317;35646;17.4;6.5
71;2021-04-03;268;34;95585;35680;17.4;6.5
71;2021-04-04;6;0;95591;35680;17.4;6.5
71;2021-04-05;61;2;95652;35682;17.5;6.5
71;2021-04-06;2257;1883;97909;37565;17.9;6.9
71;2021-04-07;2387;1797;100296;39362;18.3;7.2
71;2021-04-08;3283;1814;103579;41176;18.9;7.5
71;2021-04-09;4040;1678;107619;42854;19.6;7.8
71;2021-04-10;769;49;108388;42903;19.8;7.8
71;2021-04-11;97;4;108485;42907;19.8;7.8
71;2021-04-12;2352;1705;110837;44612;20.2;8.1
71;2021-04-13;2583;1894;113420;46506;20.7;8.5
71;2021-04-14;2375;1929;115795;48435;21.1;8.8
71;2021-04-15;2779;1696;118574;50131;21.6;9.2
71;2021-04-16;2628;1647;121202;51778;22.1;9.5
71;2021-04-17;952;347;122154;52125;22.3;9.5
71;2021-04-18;106;6;122260;52131;22.3;9.5
71;2021-04-19;1758;2573;124018;54704;22.6;10.0
71;2021-04-20;2220;2604;126238;57308;23.0;10.5
71;2021-04-21;2123;2594;128361;59902;23.4;10.9
71;2021-04-22;2512;2450;130873;62352;23.9;11.4
71;2021-04-23;2922;2271;133795;64623;24.4;11.8
71;2021-04-24;517;52;134312;64675;24.5;11.8
71;2021-04-25;26;0;134338;64675;24.5;11.8
71;2021-04-26;2565;2139;136903;66814;25.0;12.2
71;2021-04-27;2990;2274;139893;69088;25.5;12.6
71;2021-04-28;3073;2129;142966;71217;26.1;13.0
71;2021-04-29;3780;2234;146746;73451;26.8;13.4
71;2021-04-30;3926;1730;150672;75181;27.5;13.7
71;2021-05-01;39;53;150711;75234;27.5;13.7
71;2021-05-02;23;18;150734;75252;27.5;13.7
71;2021-05-03;4290;1384;155024;76636;28.3;14.0
71;2021-05-04;2955;2360;157979;78996;28.8;14.4
71;2021-05-05;3426;2088;161405;81084;29.5;14.8
71;2021-05-06;3467;2373;164872;83457;30.1;15.2
71;2021-05-07;3678;2813;168550;86270;30.8;15.7
71;2021-05-08;179;183;168729;86453;30.8;15.8
71;2021-05-09;44;47;168773;86500;30.8;15.8
71;2021-05-10;3696;2293;172469;88793;31.5;16.2
71;2021-05-11;4663;2360;177132;91153;32.3;16.6
71;2021-05-12;3978;2602;181110;93755;33.1;17.1
71;2021-05-13;1576;155;182686;93910;33.3;17.1
71;2021-05-14;3766;2197;186452;96107;34.0;17.5
71;2021-05-15;243;331;186695;96438;34.1;17.6
71;2021-05-16;2;0;186697;96438;34.1;17.6
71;2021-05-17;3864;1887;190561;98325;34.8;17.9
71;2021-05-18;3498;2429;194059;100754;35.4;18.4
71;2021-05-19;3719;2279;197778;103033;36.1;18.8
71;2021-05-20;4184;2300;201962;105333;36.9;19.2
71;2021-05-21;3722;2567;205684;107900;37.5;19.7
71;2021-05-22;169;304;205853;108204;37.6;19.8
71;2021-05-23;14;55;205867;108259;37.6;19.8
71;2021-05-24;21;96;205888;108355;37.6;19.8
71;2021-05-25;2689;3004;208577;111359;38.1;20.3
71;2021-05-26;2972;2434;211549;113793;38.6;20.8
71;2021-05-27;3387;2589;214936;116382;39.2;21.2
71;2021-05-28;2919;3160;217855;119542;39.8;21.8
71;2021-05-29;482;659;218337;120201;39.9;21.9
71;2021-05-30;76;58;218413;120259;39.9;22.0
71;2021-05-31;2774;3455;221187;123714;40.4;22.6
71;2021-06-01;3671;3543;224858;127257;41.0;23.2
71;2021-06-02;3997;2635;228855;129892;41.8;23.7
71;2021-06-03;4435;2524;233290;132416;42.6;24.2
71;2021-06-04;3716;3715;237006;136131;43.3;24.8
71;2021-06-05;684;647;237690;136778;43.4;25.0
71;2021-06-06;57;91;237747;136869;43.4;25.0
71;2021-06-07;3281;4151;241028;141020;44.0;25.7
71;2021-06-08;3894;4010;244922;145030;44.7;26.5
71;2021-06-09;4695;2753;249617;147783;45.6;27.0
71;2021-06-10;5265;2748;254882;150531;46.5;27.5
71;2021-06-11;4435;3723;259317;154254;47.3;28.2
71;2021-06-12;715;595;260032;154849;47.5;28.3
71;2021-06-13;104;187;260136;155036;47.5;28.3
71;2021-06-14;3511;3787;263647;158823;48.1;29.0
71;2021-06-15;4205;3555;267852;162378;48.9;29.6
71;2021-06-16;4595;2731;272447;165109;49.7;30.1
71;2021-06-17;4267;3001;276714;168110;50.5;30.7
71;2021-06-18;4325;3770;281039;171880;51.3;31.4
71;2021-06-19;1269;654;282308;172534;51.5;31.5
71;2021-06-20;37;27;282345;172561;51.5;31.5
71;2021-06-21;2271;4277;284616;176838;52.0;32.3
71;2021-06-22;2689;4356;287305;181194;52.4;33.1
71;2021-06-23;3061;3421;290366;184615;53.0;33.7
71;2021-06-24;3328;3023;293694;187638;53.6;34.3
71;2021-06-25;2652;4473;296346;192111;54.1;35.1
71;2021-06-26;372;551;296718;192662;54.2;35.2
71;2021-06-27;29;67;296747;192729;54.2;35.2
71;2021-06-28;1535;4624;298282;197353;54.4;36.0
71;2021-06-29;1992;4823;300274;202176;54.8;36.9
71;2021-06-30;2504;3937;302778;206113;55.3;37.6
71;2021-07-01;2826;3899;305604;210012;55.8;38.3
71;2021-07-02;3032;3987;308636;213999;56.3;39.1
71;2021-07-03;319;712;308955;214711;56.4;39.2
71;2021-07-04;28;132;308983;214843;56.4;39.2
71;2021-07-05;2474;4322;311457;219165;56.9;40.0
71;2021-07-06;2462;4562;313919;223727;57.3;40.8
71;2021-07-07;2983;3724;316902;227451;57.8;41.5
71;2021-07-08;2766;4111;319668;231562;58.4;42.3
71;2021-07-09;2383;5023;322051;236585;58.8;43.2
71;2021-07-10;212;656;322263;237241;58.8;43.3
71;2021-07-11;15;65;322278;237306;58.8;43.3
71;2021-07-12;1911;5304;324189;242610;59.2;44.3
71;2021-07-13;2537;5863;326726;248473;59.6;45.4
71;2021-07-14;950;401;327676;248874;59.8;45.4
71;2021-07-15;3025;5735;330701;254609;60.4;46.5
71;2021-07-16;3294;6010;333995;260619;61.0;47.6
71;2021-07-17;505;781;334500;261400;61.1;47.7
71;2021-07-18;89;93;334589;261493;61.1;47.7
71;2021-07-19;2865;5554;337454;267047;61.6;48.7
71;2021-07-20;3367;5914;340821;272961;62.2;49.8
71;2021-07-21;3413;5472;344234;278433;62.8;50.8
71;2021-07-22;3945;5334;348179;283767;63.6;51.8
71;2021-07-23;3233;6002;351412;289769;64.1;52.9
71;2021-07-24;716;602;352128;290371;64.3;53.0
71;2021-07-25;148;82;352276;290453;64.3;53.0
71;2021-07-26;3596;4891;355872;295344;65.0;53.9
71;2021-07-27;4089;5123;359961;300467;65.7;54.8
71;2021-07-28;4248;4813;364209;305280;66.5;55.7
71;2021-07-29;4213;4645;368422;309925;67.3;56.6
71;2021-07-30;4241;4926;372663;314851;68.0;57.5
71;2021-07-31;722;723;373385;315574;68.2;57.6
71;2021-08-01;108;35;373493;315609;68.2;57.6
71;2021-08-02;3967;3760;377460;319369;68.9;58.3
71;2021-08-03;4408;3823;381868;323192;69.7;59.0
71;2021-08-04;4391;2986;386259;326178;70.5;59.5
71;2021-08-05;4189;3271;390448;329449;71.3;60.1
71;2021-08-06;3702;4016;394150;333465;71.9;60.9
71;2021-08-07;495;329;394645;333794;72.0;60.9
71;2021-08-08;51;65;394696;333859;72.0;60.9
71;2021-08-09;3045;3410;397741;337269;72.6;61.6
71;2021-08-10;3074;3389;400815;340658;73.2;62.2
71;2021-08-11;3186;3082;404001;343740;73.7;62.7
71;2021-08-12;3016;3106;407017;346846;74.3;63.3
71;2021-08-13;2691;3334;409708;350180;74.8;63.9
71;2021-08-14;282;518;409990;350698;74.8;64.0
71;2021-08-15;49;110;410039;350808;74.8;64.0
71;2021-08-16;1708;3528;411747;354336;75.2;64.7
71;2021-08-17;1739;3433;413486;357769;75.5;65.3
71;2021-08-18;1453;3160;414939;360929;75.7;65.9
71;2021-08-19;1277;3117;416216;364046;76.0;66.5
71;2021-08-20;1290;3699;417506;367745;76.2;67.1
71;2021-08-21;148;413;417654;368158;76.2;67.2
71;2021-08-22;42;99;417696;368257;76.2;67.2
71;2021-08-23;1427;4543;419123;372800;76.5;68.1
71;2021-08-24;1335;3804;420458;376604;76.8;68.7
71;2021-08-25;950;3773;421408;380377;76.9;69.4
71;2021-08-26;958;3393;422366;383770;77.1;70.1
71;2021-08-27;1151;4462;423517;388232;77.3;70.9
71;2021-08-28;195;413;423712;388645;77.3;70.9
71;2021-08-29;29;106;423741;388751;77.3;71.0
71;2021-08-30;1251;3880;424992;392631;77.6;71.7
71;2021-08-31;1022;3480;426014;396111;77.8;72.3
71;2021-09-01;933;3271;426947;399382;77.9;72.9
71;2021-09-02;602;2837;427549;402219;78.0;73.4
71;2021-09-03;836;3680;428385;405899;78.2;74.1
71;2021-09-04;267;530;428652;406429;78.2;74.2
71;2021-09-05;23;52;428675;406481;78.3;74.2
71;2021-09-06;638;2377;429313;408858;78.4;74.6
71;2021-09-07;517;1712;429830;410570;78.5;74.9
71;2021-09-08;720;2188;430550;412758;78.6;75.3
71;2021-09-09;456;1274;431006;414032;78.7;75.6
71;2021-09-10;819;2148;431825;416180;78.8;76.0
71;2021-09-11;199;266;432024;416446;78.9;76.0
71;2021-09-12;19;37;432043;416483;78.9;76.0
71;2021-09-13;643;1283;432686;417766;79.0;76.3
71;2021-09-14;487;1076;433173;418842;79.1;76.5
71;2021-09-15;603;1497;433776;420339;79.2;76.7
71;2021-09-16;447;823;434223;421162;79.3;76.9
71;2021-09-17;534;1437;434757;422599;79.4;77.1
71;2021-09-18;144;262;434901;422861;79.4;77.2
71;2021-09-19;9;28;434910;422889;79.4;77.2
71;2021-09-20;487;925;435397;423814;79.5;77.4
71;2021-09-21;294;711;435691;424525;79.5;77.5
71;2021-09-22;342;1377;436033;425902;79.6;77.7
71;2021-09-23;311;578;436344;426480;79.7;77.8
71;2021-09-24;367;1030;436711;427510;79.7;78.0
71;2021-09-25;71;176;436782;427686;79.7;78.1
71;2021-09-26;11;35;436793;427721;79.7;78.1
71;2021-09-27;287;757;437080;428478;79.8;78.2
71;2021-09-28;288;477;437368;428955;79.8;78.3
71;2021-09-29;332;740;437700;429695;79.9;78.4
71;2021-09-30;208;500;437908;430195;79.9;78.5
71;2021-10-01;332;894;438240;431089;80.0;78.7
71;2021-10-02;108;226;438348;431315;80.0;78.7
71;2021-10-03;3;7;438351;431322;80.0;78.7
71;2021-10-04;252;555;438603;431877;80.1;78.8
71;2021-10-05;195;392;438798;432269;80.1;78.9
71;2021-10-06;382;657;439180;432926;80.2;79.0
71;2021-10-07;147;349;439327;433275;80.2;79.1
71;2021-10-08;322;647;439649;433922;80.3;79.2
71;2021-10-09;59;163;439708;434085;80.3;79.2
71;2021-10-10;5;17;439713;434102;80.3;79.2
71;2021-10-11;253;517;439966;434619;80.3;79.3
71;2021-10-12;203;415;440169;435034;80.3;79.4
71;2021-10-13;295;470;440464;435504;80.4;79.5
71;2021-10-14;148;291;440612;435795;80.4;79.6
72;2020-12-27;0;0;0;0;0.0;0.0
72;2020-12-28;0;0;0;0;0.0;0.0
72;2020-12-29;0;0;0;0;0.0;0.0
72;2020-12-30;0;0;0;0;0.0;0.0
72;2020-12-31;0;0;0;0;0.0;0.0
72;2021-01-01;2;0;2;0;0.0;0.0
72;2021-01-02;0;0;2;0;0.0;0.0
72;2021-01-03;0;0;2;0;0.0;0.0
72;2021-01-04;0;0;2;0;0.0;0.0
72;2021-01-05;14;0;16;0;0.0;0.0
72;2021-01-06;27;0;43;0;0.0;0.0
72;2021-01-07;110;1;153;1;0.0;0.0
72;2021-01-08;232;1;385;2;0.1;0.0
72;2021-01-09;36;0;421;2;0.1;0.0
72;2021-01-10;0;0;421;2;0.1;0.0
72;2021-01-11;485;1;906;3;0.2;0.0
72;2021-01-12;614;1;1520;4;0.3;0.0
72;2021-01-13;500;1;2020;5;0.4;0.0
72;2021-01-14;644;3;2664;8;0.5;0.0
72;2021-01-15;478;1;3142;9;0.6;0.0
72;2021-01-16;94;0;3236;9;0.6;0.0
72;2021-01-17;0;0;3236;9;0.6;0.0
72;2021-01-18;294;1;3530;10;0.6;0.0
72;2021-01-19;779;4;4309;14;0.8;0.0
72;2021-01-20;1539;6;5848;20;1.0;0.0
72;2021-01-21;1778;6;7626;26;1.4;0.0
72;2021-01-22;1149;6;8775;32;1.6;0.0
72;2021-01-23;32;0;8807;32;1.6;0.0
72;2021-01-24;0;0;8807;32;1.6;0.0
72;2021-01-25;503;7;9310;39;1.7;0.0
72;2021-01-26;1166;21;10476;60;1.9;0.0
72;2021-01-27;883;22;11359;82;2.0;0.0
72;2021-01-28;776;67;12135;149;2.2;0.0
72;2021-01-29;712;68;12847;217;2.3;0.0
72;2021-01-30;58;0;12905;217;2.3;0.0
72;2021-01-31;1;0;12906;217;2.3;0.0
72;2021-02-01;499;228;13405;445;2.4;0.1
72;2021-02-02;506;294;13911;739;2.5;0.1
72;2021-02-03;486;230;14397;969;2.6;0.2
72;2021-02-04;477;341;14874;1310;2.7;0.2
72;2021-02-05;514;407;15388;1717;2.7;0.3
72;2021-02-06;83;14;15471;1731;2.8;0.3
72;2021-02-07;19;3;15490;1734;2.8;0.3
72;2021-02-08;310;401;15800;2135;2.8;0.4
72;2021-02-09;488;530;16288;2665;2.9;0.5
72;2021-02-10;567;929;16855;3594;3.0;0.6
72;2021-02-11;860;1343;17715;4937;3.2;0.9
72;2021-02-12;851;594;18566;5531;3.3;1.0
72;2021-02-13;112;38;18678;5569;3.3;1.0
72;2021-02-14;1;22;18679;5591;3.3;1.0
72;2021-02-15;220;502;18899;6093;3.4;1.1
72;2021-02-16;503;1027;19402;7120;3.5;1.3
72;2021-02-17;463;715;19865;7835;3.5;1.4
72;2021-02-18;596;635;20461;8470;3.7;1.5
72;2021-02-19;521;598;20982;9068;3.7;1.6
72;2021-02-20;81;57;21063;9125;3.8;1.6
72;2021-02-21;0;0;21063;9125;3.8;1.6
72;2021-02-22;329;578;21392;9703;3.8;1.7
72;2021-02-23;569;531;21961;10234;3.9;1.8
72;2021-02-24;435;472;22396;10706;4.0;1.9
72;2021-02-25;922;564;23318;11270;4.2;2.0
72;2021-02-26;600;512;23918;11782;4.3;2.1
72;2021-02-27;322;67;24240;11849;4.3;2.1
72;2021-02-28;15;17;24255;11866;4.3;2.1
72;2021-03-01;379;480;24634;12346;4.4;2.2
72;2021-03-02;503;604;25137;12950;4.5;2.3
72;2021-03-03;733;655;25870;13605;4.6;2.4
72;2021-03-04;742;787;26612;14392;4.8;2.6
72;2021-03-05;935;772;27547;15164;4.9;2.7
72;2021-03-06;761;136;28308;15300;5.1;2.7
72;2021-03-07;448;26;28756;15326;5.1;2.7
72;2021-03-08;561;446;29317;15772;5.2;2.8
72;2021-03-09;1045;645;30362;16417;5.4;2.9
72;2021-03-10;1134;662;31496;17079;5.6;3.0
72;2021-03-11;1610;497;33106;17576;5.9;3.1
72;2021-03-12;1364;518;34470;18094;6.2;3.2
72;2021-03-13;983;122;35453;18216;6.3;3.3
72;2021-03-14;14;10;35467;18226;6.3;3.3
72;2021-03-15;1159;225;36626;18451;6.5;3.3
72;2021-03-16;1053;191;37679;18642;6.7;3.3
72;2021-03-17;1035;263;38714;18905;6.9;3.4
72;2021-03-18;1090;371;39804;19276;7.1;3.4
72;2021-03-19;1275;293;41079;19569;7.3;3.5
72;2021-03-20;488;93;41567;19662;7.4;3.5
72;2021-03-21;19;0;41586;19662;7.4;3.5
72;2021-03-22;1347;345;42933;20007;7.7;3.6
72;2021-03-23;1725;486;44658;20493;8.0;3.7
72;2021-03-24;1841;307;46499;20800;8.3;3.7
72;2021-03-25;2448;468;48947;21268;8.7;3.8
72;2021-03-26;2336;374;51283;21642;9.2;3.9
72;2021-03-27;616;31;51899;21673;9.3;3.9
72;2021-03-28;22;0;51921;21673;9.3;3.9
72;2021-03-29;1616;383;53537;22056;9.6;3.9
72;2021-03-30;2496;390;56033;22446;10.0;4.0
72;2021-03-31;2145;374;58178;22820;10.4;4.1
72;2021-04-01;2850;354;61028;23174;10.9;4.1
72;2021-04-02;2247;405;63275;23579;11.3;4.2
72;2021-04-03;292;39;63567;23618;11.3;4.2
72;2021-04-04;16;5;63583;23623;11.3;4.2
72;2021-04-05;52;49;63635;23672;11.4;4.2
72;2021-04-06;1759;472;65394;24144;11.7;4.3
72;2021-04-07;2577;603;67971;24747;12.1;4.4
72;2021-04-08;2721;785;70692;25532;12.6;4.6
72;2021-04-09;3863;591;74555;26123;13.3;4.7
72;2021-04-10;1112;54;75667;26177;13.5;4.7
72;2021-04-11;8;1;75675;26178;13.5;4.7
72;2021-04-12;1845;906;77520;27084;13.8;4.8
72;2021-04-13;2373;1082;79893;28166;14.3;5.0
72;2021-04-14;2250;1099;82143;29265;14.7;5.2
72;2021-04-15;2420;1120;84563;30385;15.1;5.4
72;2021-04-16;2563;970;87126;31355;15.6;5.6
72;2021-04-17;707;145;87833;31500;15.7;5.6
72;2021-04-18;57;2;87890;31502;15.7;5.6
72;2021-04-19;1396;1098;89286;32600;15.9;5.8
72;2021-04-20;2996;1309;92282;33909;16.5;6.1
72;2021-04-21;2515;1567;94797;35476;16.9;6.3
72;2021-04-22;2814;1794;97611;37270;17.4;6.7
72;2021-04-23;3213;1461;100824;38731;18.0;6.9
72;2021-04-24;1400;270;102224;39001;18.2;7.0
72;2021-04-25;881;18;103105;39019;18.4;7.0
72;2021-04-26;3513;1482;106618;40501;19.0;7.2
72;2021-04-27;4088;1867;110706;42368;19.8;7.6
72;2021-04-28;3835;1880;114541;44248;20.4;7.9
72;2021-04-29;4161;1821;118702;46069;21.2;8.2
72;2021-04-30;3615;1714;122317;47783;21.8;8.5
72;2021-05-01;1641;227;123958;48010;22.1;8.6
72;2021-05-02;1533;161;125491;48171;22.4;8.6
72;2021-05-03;3456;1155;128947;49326;23.0;8.8
72;2021-05-04;4013;1807;132960;51133;23.7;9.1
72;2021-05-05;3866;2182;136826;53315;24.4;9.5
72;2021-05-06;3596;1947;140422;55262;25.1;9.9
72;2021-05-07;3544;2149;143966;57411;25.7;10.2
72;2021-05-08;1900;155;145866;57566;26.0;10.3
72;2021-05-09;2080;213;147946;57779;26.4;10.3
72;2021-05-10;3769;1527;151715;59306;27.1;10.6
72;2021-05-11;4596;1997;156311;61303;27.9;10.9
72;2021-05-12;4080;1819;160391;63122;28.6;11.3
72;2021-05-13;3031;273;163422;63395;29.2;11.3
72;2021-05-14;3663;1399;167085;64794;29.8;11.6
72;2021-05-15;3117;365;170202;65159;30.4;11.6
72;2021-05-16;2500;152;172702;65311;30.8;11.7
72;2021-05-17;3723;1289;176425;66600;31.5;11.9
72;2021-05-18;4330;1690;180755;68290;32.3;12.2
72;2021-05-19;3973;1513;184728;69803;33.0;12.5
72;2021-05-20;4261;1455;188989;71258;33.7;12.7
72;2021-05-21;3788;1392;192777;72650;34.4;13.0
72;2021-05-22;2561;506;195338;73156;34.9;13.1
72;2021-05-23;1391;163;196729;73319;35.1;13.1
72;2021-05-24;2353;295;199082;73614;35.5;13.1
72;2021-05-25;4076;1412;203158;75026;36.3;13.4
72;2021-05-26;4096;1414;207254;76440;37.0;13.6
72;2021-05-27;4345;2049;211599;78489;37.8;14.0
72;2021-05-28;4105;2016;215704;80505;38.5;14.4
72;2021-05-29;2668;811;218372;81316;39.0;14.5
72;2021-05-30;1142;871;219514;82187;39.2;14.7
72;2021-05-31;3121;2331;222635;84518;39.7;15.1
72;2021-06-01;3570;2670;226205;87188;40.4;15.6
72;2021-06-02;3611;2785;229816;89973;41.0;16.1
72;2021-06-03;4242;2997;234058;92970;41.8;16.6
72;2021-06-04;3891;2752;237949;95722;42.5;17.1
72;2021-06-05;1440;2567;239389;98289;42.7;17.5
72;2021-06-06;911;1541;240300;99830;42.9;17.8
72;2021-06-07;1744;3424;242044;103254;43.2;18.4
72;2021-06-08;2930;3835;244974;107089;43.7;19.1
72;2021-06-09;2646;3371;247620;110460;44.2;19.7
72;2021-06-10;2825;3319;250445;113779;44.7;20.3
72;2021-06-11;2840;3775;253285;117554;45.2;21.0
72;2021-06-12;1242;2603;254527;120157;45.4;21.4
72;2021-06-13;388;1860;254915;122017;45.5;21.8
72;2021-06-14;1336;4127;256251;126144;45.7;22.5
72;2021-06-15;2751;3516;259002;129660;46.2;23.1
72;2021-06-16;2428;3581;261430;133241;46.7;23.8
72;2021-06-17;2318;3877;263748;137118;47.1;24.5
72;2021-06-18;2310;4317;266058;141435;47.5;25.2
72;2021-06-19;1128;2763;267186;144198;47.7;25.7
72;2021-06-20;339;2055;267525;146253;47.8;26.1
72;2021-06-21;1564;4034;269089;150287;48.0;26.8
72;2021-06-22;1715;4993;270804;155280;48.3;27.7
72;2021-06-23;2008;4223;272812;159503;48.7;28.5
72;2021-06-24;2233;4013;275045;163516;49.1;29.2
72;2021-06-25;1774;4836;276819;168352;49.4;30.1
72;2021-06-26;1190;2876;278009;171228;49.6;30.6
72;2021-06-27;392;2111;278401;173339;49.7;30.9
72;2021-06-28;1439;4292;279840;177631;50.0;31.7
72;2021-06-29;1770;4741;281610;182372;50.3;32.6
72;2021-06-30;1980;4169;283590;186541;50.6;33.3
72;2021-07-01;1954;4417;285544;190958;51.0;34.1
72;2021-07-02;1853;4714;287397;195672;51.3;34.9
72;2021-07-03;1292;3124;288689;198796;51.5;35.5
72;2021-07-04;579;1947;289268;200743;51.6;35.8
72;2021-07-05;1193;4164;290461;204907;51.8;36.6
72;2021-07-06;1458;5160;291919;210067;52.1;37.5
72;2021-07-07;1582;4609;293501;214676;52.4;38.3
72;2021-07-08;1648;4326;295149;219002;52.7;39.1
72;2021-07-09;2107;4603;297256;223605;53.1;39.9
72;2021-07-10;1589;2691;298845;226296;53.3;40.4
72;2021-07-11;947;1587;299792;227883;53.5;40.7
72;2021-07-12;1592;3757;301384;231640;53.8;41.3
72;2021-07-13;2091;4774;303475;236414;54.2;42.2
72;2021-07-14;1325;2365;304800;238779;54.4;42.6
72;2021-07-15;3485;3423;308285;242202;55.0;43.2
72;2021-07-16;3175;4124;311460;246326;55.6;44.0
72;2021-07-17;2646;1760;314106;248086;56.1;44.3
72;2021-07-18;1710;824;315816;248910;56.4;44.4
72;2021-07-19;2919;3507;318735;252417;56.9;45.1
72;2021-07-20;3040;4284;321775;256701;57.4;45.8
72;2021-07-21;2885;3589;324660;260290;58.0;46.5
72;2021-07-22;3772;2918;328432;263208;58.6;47.0
72;2021-07-23;3478;3792;331910;267000;59.2;47.7
72;2021-07-24;2820;1462;334730;268462;59.7;47.9
72;2021-07-25;1453;1081;336183;269543;60.0;48.1
72;2021-07-26;2726;2918;338909;272461;60.5;48.6
72;2021-07-27;3859;3822;342768;276283;61.2;49.3
72;2021-07-28;3571;3122;346339;279405;61.8;49.9
72;2021-07-29;3572;2712;349911;282117;62.5;50.4
72;2021-07-30;3788;3384;353699;285501;63.1;51.0
72;2021-07-31;2546;1750;356245;287251;63.6;51.3
72;2021-08-01;1835;432;358080;287683;63.9;51.4
72;2021-08-02;3215;2285;361295;289968;64.5;51.8
72;2021-08-03;3236;3297;364531;293265;65.1;52.3
72;2021-08-04;3769;2554;368300;295819;65.7;52.8
72;2021-08-05;3770;2460;372070;298279;66.4;53.2
72;2021-08-06;3342;2695;375412;300974;67.0;53.7
72;2021-08-07;2347;1613;377759;302587;67.4;54.0
72;2021-08-08;1623;701;379382;303288;67.7;54.1
72;2021-08-09;2699;2670;382081;305958;68.2;54.6
72;2021-08-10;2915;2748;384996;308706;68.7;55.1
72;2021-08-11;2368;2204;387364;310910;69.1;55.5
72;2021-08-12;2381;2597;389745;313507;69.6;56.0
72;2021-08-13;2158;2295;391903;315802;70.0;56.4
72;2021-08-14;1167;1546;393070;317348;70.2;56.6
72;2021-08-15;623;614;393693;317962;70.3;56.8
72;2021-08-16;1649;2372;395342;320334;70.6;57.2
72;2021-08-17;1717;2889;397059;323223;70.9;57.7
72;2021-08-18;1709;2872;398768;326095;71.2;58.2
72;2021-08-19;1245;2914;400013;329009;71.4;58.7
72;2021-08-20;1656;3170;401669;332179;71.7;59.3
72;2021-08-21;699;2031;402368;334210;71.8;59.7
72;2021-08-22;261;1150;402629;335360;71.9;59.9
72;2021-08-23;1738;3422;404367;338782;72.2;60.5
72;2021-08-24;1532;4122;405899;342904;72.5;61.2
72;2021-08-25;1602;3453;407501;346357;72.7;61.8
72;2021-08-26;1265;4443;408766;350800;73.0;62.6
72;2021-08-27;1192;4113;409958;354913;73.2;63.4
72;2021-08-28;881;2656;410839;357569;73.3;63.8
72;2021-08-29;357;1683;411196;359252;73.4;64.1
72;2021-08-30;1130;3407;412326;362659;73.6;64.7
72;2021-08-31;1219;3911;413545;366570;73.8;65.4
72;2021-09-01;1070;3163;414615;369733;74.0;66.0
72;2021-09-02;901;3231;415516;372964;74.2;66.6
72;2021-09-03;928;3064;416444;376028;74.3;67.1
72;2021-09-04;702;2554;417146;378582;74.5;67.6
72;2021-09-05;256;1498;417402;380080;74.5;67.8
72;2021-09-06;585;2506;417987;382586;74.6;68.3
72;2021-09-07;507;2583;418494;385169;74.7;68.8
72;2021-09-08;617;2889;419111;388058;74.8;69.3
72;2021-09-09;396;1770;419507;389828;74.9;69.6
72;2021-09-10;625;2395;420132;392223;75.0;70.0
72;2021-09-11;405;2636;420537;394859;75.1;70.5
72;2021-09-12;170;923;420707;395782;75.1;70.6
72;2021-09-13;369;1302;421076;397084;75.2;70.9
72;2021-09-14;489;1225;421565;398309;75.2;71.1
72;2021-09-15;616;1994;422181;400303;75.4;71.5
72;2021-09-16;336;832;422517;401135;75.4;71.6
72;2021-09-17;443;1423;422960;402558;75.5;71.9
72;2021-09-18;355;1520;423315;404078;75.6;72.1
72;2021-09-19;89;359;423404;404437;75.6;72.2
72;2021-09-20;350;793;423754;405230;75.6;72.3
72;2021-09-21;318;787;424072;406017;75.7;72.5
72;2021-09-22;442;1526;424514;407543;75.8;72.7
72;2021-09-23;396;630;424910;408173;75.8;72.9
72;2021-09-24;601;1006;425511;409179;76.0;73.0
72;2021-09-25;259;1004;425770;410183;76.0;73.2
72;2021-09-26;73;216;425843;410399;76.0;73.3
72;2021-09-27;210;640;426053;411039;76.1;73.4
72;2021-09-28;206;427;426259;411466;76.1;73.4
72;2021-09-29;360;1013;426619;412479;76.2;73.6
72;2021-09-30;164;331;426783;412810;76.2;73.7
72;2021-10-01;288;707;427071;413517;76.2;73.8
72;2021-10-02;311;581;427382;414098;76.3;73.9
72;2021-10-03;91;161;427473;414259;76.3;73.9
72;2021-10-04;178;410;427651;414669;76.3;74.0
72;2021-10-05;268;331;427919;415000;76.4;74.1
72;2021-10-06;257;560;428176;415560;76.4;74.2
72;2021-10-07;220;354;428396;415914;76.5;74.2
72;2021-10-08;328;648;428724;416562;76.5;74.4
72;2021-10-09;217;437;428941;416999;76.6;74.4
72;2021-10-10;84;117;429025;417116;76.6;74.5
72;2021-10-11;173;259;429198;417375;76.6;74.5
72;2021-10-12;213;361;429411;417736;76.6;74.6
72;2021-10-13;262;460;429673;418196;76.7;74.6
72;2021-10-14;140;288;429813;418484;76.7;74.7
73;2020-12-27;1;1;1;1;0.0;0.0
73;2020-12-28;1;0;2;1;0.0;0.0
73;2020-12-29;0;0;2;1;0.0;0.0
73;2020-12-30;0;0;2;1;0.0;0.0
73;2020-12-31;0;0;2;1;0.0;0.0
73;2021-01-01;0;0;2;1;0.0;0.0
73;2021-01-02;0;0;2;1;0.0;0.0
73;2021-01-03;0;0;2;1;0.0;0.0
73;2021-01-04;1;0;3;1;0.0;0.0
73;2021-01-05;0;0;3;1;0.0;0.0
73;2021-01-06;1;0;4;1;0.0;0.0
73;2021-01-07;30;0;34;1;0.0;0.0
73;2021-01-08;81;0;115;1;0.0;0.0
73;2021-01-09;0;0;115;1;0.0;0.0
73;2021-01-10;0;0;115;1;0.0;0.0
73;2021-01-11;101;1;216;2;0.0;0.0
73;2021-01-12;303;1;519;3;0.1;0.0
73;2021-01-13;363;1;882;4;0.2;0.0
73;2021-01-14;516;3;1398;7;0.3;0.0
73;2021-01-15;617;1;2015;8;0.5;0.0
73;2021-01-16;128;2;2143;10;0.5;0.0
73;2021-01-17;0;0;2143;10;0.5;0.0
73;2021-01-18;624;0;2767;10;0.6;0.0
73;2021-01-19;1240;4;4007;14;0.9;0.0
73;2021-01-20;950;2;4957;16;1.1;0.0
73;2021-01-21;984;5;5941;21;1.4;0.0
73;2021-01-22;948;0;6889;21;1.6;0.0
73;2021-01-23;389;0;7278;21;1.7;0.0
73;2021-01-24;0;0;7278;21;1.7;0.0
73;2021-01-25;656;6;7934;27;1.8;0.0
73;2021-01-26;761;2;8695;29;2.0;0.0
73;2021-01-27;1107;6;9802;35;2.3;0.0
73;2021-01-28;961;5;10763;40;2.5;0.0
73;2021-01-29;684;7;11447;47;2.6;0.0
73;2021-01-30;345;3;11792;50;2.7;0.0
73;2021-01-31;0;0;11792;50;2.7;0.0
73;2021-02-01;606;42;12398;92;2.9;0.0
73;2021-02-02;752;336;13150;428;3.0;0.1
73;2021-02-03;648;353;13798;781;3.2;0.2
73;2021-02-04;626;236;14424;1017;3.3;0.2
73;2021-02-05;680;408;15104;1425;3.5;0.3
73;2021-02-06;263;39;15367;1464;3.6;0.3
73;2021-02-07;1;0;15368;1464;3.6;0.3
73;2021-02-08;524;253;15892;1717;3.7;0.4
73;2021-02-09;793;454;16685;2171;3.9;0.5
73;2021-02-10;901;395;17586;2566;4.1;0.6
73;2021-02-11;963;718;18549;3284;4.3;0.8
73;2021-02-12;811;512;19360;3796;4.5;0.9
73;2021-02-13;263;59;19623;3855;4.5;0.9
73;2021-02-14;1;0;19624;3855;4.5;0.9
73;2021-02-15;346;528;19970;4383;4.6;1.0
73;2021-02-16;455;764;20425;5147;4.7;1.2
73;2021-02-17;451;966;20876;6113;4.8;1.4
73;2021-02-18;468;559;21344;6672;4.9;1.5
73;2021-02-19;445;640;21789;7312;5.0;1.7
73;2021-02-20;70;249;21859;7561;5.1;1.7
73;2021-02-21;0;0;21859;7561;5.1;1.7
73;2021-02-22;240;444;22099;8005;5.1;1.9
73;2021-02-23;327;522;22426;8527;5.2;2.0
73;2021-02-24;487;748;22913;9275;5.3;2.1
73;2021-02-25;504;515;23417;9790;5.4;2.3
73;2021-02-26;730;569;24147;10359;5.6;2.4
73;2021-02-27;330;237;24477;10596;5.7;2.4
73;2021-02-28;2;1;24479;10597;5.7;2.4
73;2021-03-01;557;509;25036;11106;5.8;2.6
73;2021-03-02;667;902;25703;12008;5.9;2.8
73;2021-03-03;643;1197;26346;13205;6.1;3.1
73;2021-03-04;1040;905;27386;14110;6.3;3.3
73;2021-03-05;1240;614;28626;14724;6.6;3.4
73;2021-03-06;1091;336;29717;15060;6.9;3.5
73;2021-03-07;455;94;30172;15154;7.0;3.5
73;2021-03-08;609;430;30781;15584;7.1;3.6
73;2021-03-09;985;543;31766;16127;7.3;3.7
73;2021-03-10;1035;876;32801;17003;7.6;3.9
73;2021-03-11;1559;663;34360;17666;7.9;4.1
73;2021-03-12;2018;539;36378;18205;8.4;4.2
73;2021-03-13;1180;206;37558;18411;8.7;4.3
73;2021-03-14;66;3;37624;18414;8.7;4.3
73;2021-03-15;1185;400;38809;18814;9.0;4.3
73;2021-03-16;795;400;39604;19214;9.2;4.4
73;2021-03-17;877;481;40481;19695;9.4;4.6
73;2021-03-18;1352;260;41833;19955;9.7;4.6
73;2021-03-19;1767;396;43600;20351;10.1;4.7
73;2021-03-20;888;131;44488;20482;10.3;4.7
73;2021-03-21;123;3;44611;20485;10.3;4.7
73;2021-03-22;1184;403;45795;20888;10.6;4.8
73;2021-03-23;1449;244;47244;21132;10.9;4.9
73;2021-03-24;1604;347;48848;21479;11.3;5.0
73;2021-03-25;2064;390;50912;21869;11.8;5.1
73;2021-03-26;2472;368;53384;22237;12.3;5.1
73;2021-03-27;885;148;54269;22385;12.5;5.2
73;2021-03-28;312;16;54581;22401;12.6;5.2
73;2021-03-29;1508;241;56089;22642;13.0;5.2
73;2021-03-30;2088;487;58177;23129;13.4;5.3
73;2021-03-31;2089;407;60266;23536;13.9;5.4
73;2021-04-01;2087;339;62353;23875;14.4;5.5
73;2021-04-02;2362;236;64715;24111;15.0;5.6
73;2021-04-03;848;147;65563;24258;15.2;5.6
73;2021-04-04;188;18;65751;24276;15.2;5.6
73;2021-04-05;212;26;65963;24302;15.2;5.6
73;2021-04-06;1506;513;67469;24815;15.6;5.7
73;2021-04-07;1947;654;69416;25469;16.0;5.9
73;2021-04-08;2492;831;71908;26300;16.6;6.1
73;2021-04-09;3059;532;74967;26832;17.3;6.2
73;2021-04-10;1134;322;76101;27154;17.6;6.3
73;2021-04-11;164;10;76265;27164;17.6;6.3
73;2021-04-12;1696;988;77961;28152;18.0;6.5
73;2021-04-13;1893;1131;79854;29283;18.5;6.8
73;2021-04-14;2004;1093;81858;30376;18.9;7.0
73;2021-04-15;2416;1192;84274;31568;19.5;7.3
73;2021-04-16;1893;936;86167;32504;19.9;7.5
73;2021-04-17;1173;561;87340;33065;20.2;7.6
73;2021-04-18;155;76;87495;33141;20.2;7.7
73;2021-04-19;1383;1066;88878;34207;20.5;7.9
73;2021-04-20;1790;1327;90668;35534;21.0;8.2
73;2021-04-21;1576;1305;92244;36839;21.3;8.5
73;2021-04-22;1812;1226;94056;38065;21.7;8.8
73;2021-04-23;1896;1254;95952;39319;22.2;9.1
73;2021-04-24;980;679;96932;39998;22.4;9.2
73;2021-04-25;79;97;97011;40095;22.4;9.3
73;2021-04-26;1164;1320;98175;41415;22.7;9.6
73;2021-04-27;1440;1475;99615;42890;23.0;9.9
73;2021-04-28;1731;1461;101346;44351;23.4;10.3
73;2021-04-29;2413;1565;103759;45916;24.0;10.6
73;2021-04-30;2396;1445;106155;47361;24.5;10.9
73;2021-05-01;1068;310;107223;47671;24.8;11.0
73;2021-05-02;34;165;107257;47836;24.8;11.1
73;2021-05-03;1392;1595;108649;49431;25.1;11.4
73;2021-05-04;1713;1835;110362;51266;25.5;11.9
73;2021-05-05;1974;1690;112336;52956;26.0;12.2
73;2021-05-06;2431;1696;114767;54652;26.5;12.6
73;2021-05-07;2259;1849;117026;56501;27.1;13.1
73;2021-05-08;1840;377;118866;56878;27.5;13.1
73;2021-05-09;127;127;118993;57005;27.5;13.2
73;2021-05-10;1608;1892;120601;58897;27.9;13.6
73;2021-05-11;2378;2368;122979;61265;28.4;14.2
73;2021-05-12;3556;2098;126535;63363;29.3;14.6
73;2021-05-13;1554;276;128089;63639;29.6;14.7
73;2021-05-14;1588;1493;129677;65132;30.0;15.1
73;2021-05-15;1447;943;131124;66075;30.3;15.3
73;2021-05-16;131;62;131255;66137;30.3;15.3
73;2021-05-17;1711;1953;132966;68090;30.7;15.7
73;2021-05-18;2495;1735;135461;69825;31.3;16.1
73;2021-05-19;2538;1622;137999;71447;31.9;16.5
73;2021-05-20;3162;1502;141161;72949;32.6;16.9
73;2021-05-21;2473;1850;143634;74799;33.2;17.3
73;2021-05-22;1989;923;145623;75722;33.7;17.5
73;2021-05-23;212;14;145835;75736;33.7;17.5
73;2021-05-24;2563;327;148398;76063;34.3;17.6
73;2021-05-25;2139;1741;150537;77804;34.8;18.0
73;2021-05-26;2343;2001;152880;79805;35.3;18.4
73;2021-05-27;3081;1715;155961;81520;36.1;18.8
73;2021-05-28;2918;2376;158879;83896;36.7;19.4
73;2021-05-29;2316;1322;161195;85218;37.3;19.7
73;2021-05-30;188;14;161383;85232;37.3;19.7
73;2021-05-31;2410;1632;163793;86864;37.9;20.1
73;2021-06-01;3178;1792;166971;88656;38.6;20.5
73;2021-06-02;3108;1459;170079;90115;39.3;20.8
73;2021-06-03;4422;1741;174501;91856;40.3;21.2
73;2021-06-04;4276;2184;178777;94040;41.3;21.7
73;2021-06-05;3165;1282;181942;95322;42.1;22.0
73;2021-06-06;1881;299;183823;95621;42.5;22.1
73;2021-06-07;2759;2150;186582;97771;43.1;22.6
73;2021-06-08;2684;1872;189266;99643;43.8;23.0
73;2021-06-09;2365;1790;191631;101433;44.3;23.5
73;2021-06-10;2005;1648;193636;103081;44.8;23.8
73;2021-06-11;2192;2441;195828;105522;45.3;24.4
73;2021-06-12;2245;1333;198073;106855;45.8;24.7
73;2021-06-13;44;82;198117;106937;45.8;24.7
73;2021-06-14;1347;2927;199464;109864;46.1;25.4
73;2021-06-15;1592;2755;201056;112619;46.5;26.0
73;2021-06-16;1466;2566;202522;115185;46.8;26.6
73;2021-06-17;947;1727;203469;116912;47.0;27.0
73;2021-06-18;1884;2933;205353;119845;47.5;27.7
73;2021-06-19;1424;1986;206777;121831;47.8;28.2
73;2021-06-20;448;307;207225;122138;47.9;28.2
73;2021-06-21;1111;2938;208336;125076;48.2;28.9
73;2021-06-22;1090;2869;209426;127945;48.4;29.6
73;2021-06-23;1086;3137;210512;131082;48.7;30.3
73;2021-06-24;883;1794;211395;132876;48.9;30.7
73;2021-06-25;1324;2796;212719;135672;49.2;31.4
73;2021-06-26;966;2399;213685;138071;49.4;31.9
73;2021-06-27;329;550;214014;138621;49.5;32.0
73;2021-06-28;971;3557;214985;142178;49.7;32.9
73;2021-06-29;1076;3340;216061;145518;50.0;33.6
73;2021-06-30;1239;3117;217300;148635;50.2;34.4
73;2021-07-01;1191;2363;218491;150998;50.5;34.9
73;2021-07-02;1203;3617;219694;154615;50.8;35.7
73;2021-07-03;961;2793;220655;157408;51.0;36.4
73;2021-07-04;301;619;220956;158027;51.1;36.5
73;2021-07-05;1157;3681;222113;161708;51.3;37.4
73;2021-07-06;1251;2952;223364;164660;51.6;38.1
73;2021-07-07;1443;2948;224807;167608;52.0;38.7
73;2021-07-08;1373;2297;226180;169905;52.3;39.3
73;2021-07-09;1431;4026;227611;173931;52.6;40.2
73;2021-07-10;891;3012;228502;176943;52.8;40.9
73;2021-07-11;561;1470;229063;178413;53.0;41.2
73;2021-07-12;1059;4196;230122;182609;53.2;42.2
73;2021-07-13;1729;4225;231851;186834;53.6;43.2
73;2021-07-14;1843;1920;233694;188754;54.0;43.6
73;2021-07-15;2747;3797;236441;192551;54.7;44.5
73;2021-07-16;2416;4016;238857;196567;55.2;45.4
73;2021-07-17;1515;2607;240372;199174;55.6;46.0
73;2021-07-18;1176;1218;241548;200392;55.8;46.3
73;2021-07-19;2449;3251;243997;203643;56.4;47.1
73;2021-07-20;3366;2856;247363;206499;57.2;47.7
73;2021-07-21;3382;2790;250745;209289;58.0;48.4
73;2021-07-22;2733;2216;253478;211505;58.6;48.9
73;2021-07-23;3417;2903;256895;214408;59.4;49.6
73;2021-07-24;2059;2280;258954;216688;59.9;50.1
73;2021-07-25;625;797;259579;217485;60.0;50.3
73;2021-07-26;2632;2496;262211;219981;60.6;50.9
73;2021-07-27;3813;2271;266024;222252;61.5;51.4
73;2021-07-28;3535;2097;269559;224349;62.3;51.9
73;2021-07-29;3980;2154;273539;226503;63.2;52.4
73;2021-07-30;3565;2477;277104;228980;64.1;52.9
73;2021-07-31;2477;1594;279581;230574;64.6;53.3
73;2021-08-01;834;620;280415;231194;64.8;53.4
73;2021-08-02;3104;2105;283519;233299;65.5;53.9
73;2021-08-03;3494;2000;287013;235299;66.4;54.4
73;2021-08-04;3299;2025;290312;237324;67.1;54.9
73;2021-08-05;2875;2233;293187;239557;67.8;55.4
73;2021-08-06;2509;2382;295696;241939;68.4;55.9
73;2021-08-07;1416;1482;297112;243421;68.7;56.3
73;2021-08-08;434;619;297546;244040;68.8;56.4
73;2021-08-09;1785;2396;299331;246436;69.2;57.0
73;2021-08-10;1897;2490;301228;248926;69.6;57.5
73;2021-08-11;1848;2535;303076;251461;70.1;58.1
73;2021-08-12;1682;2503;304758;253964;70.5;58.7
73;2021-08-13;1461;2842;306219;256806;70.8;59.4
73;2021-08-14;990;1534;307209;258340;71.0;59.7
73;2021-08-15;92;161;307301;258501;71.0;59.8
73;2021-08-16;952;1392;308253;259893;71.3;60.1
73;2021-08-17;964;1960;309217;261853;71.5;60.5
73;2021-08-18;1038;2841;310255;264694;71.7;61.2
73;2021-08-19;1045;3055;311300;267749;72.0;61.9
73;2021-08-20;852;3146;312152;270895;72.2;62.6
73;2021-08-21;463;1837;312615;272732;72.3;63.1
73;2021-08-22;268;936;312883;273668;72.3;63.3
73;2021-08-23;677;2970;313560;276638;72.5;64.0
73;2021-08-24;899;3160;314459;279798;72.7;64.7
73;2021-08-25;712;2907;315171;282705;72.9;65.4
73;2021-08-26;691;2424;315862;285129;73.0;65.9
73;2021-08-27;791;2748;316653;287877;73.2;66.6
73;2021-08-28;457;1749;317110;289626;73.3;67.0
73;2021-08-29;303;1018;317413;290644;73.4;67.2
73;2021-08-30;820;2569;318233;293213;73.6;67.8
73;2021-08-31;819;2360;319052;295573;73.8;68.3
73;2021-09-01;749;2098;319801;297671;73.9;68.8
73;2021-09-02;619;1762;320420;299433;74.1;69.2
73;2021-09-03;697;2025;321117;301458;74.2;69.7
73;2021-09-04;531;1372;321648;302830;74.4;70.0
73;2021-09-05;227;703;321875;303533;74.4;70.2
73;2021-09-06;351;1076;322226;304609;74.5;70.4
73;2021-09-07;414;875;322640;305484;74.6;70.6
73;2021-09-08;491;1016;323131;306500;74.7;70.9
73;2021-09-09;467;1020;323598;307520;74.8;71.1
73;2021-09-10;578;1269;324176;308789;74.9;71.4
73;2021-09-11;355;1002;324531;309791;75.0;71.6
73;2021-09-12;96;154;324627;309945;75.0;71.7
73;2021-09-13;343;715;324970;310660;75.1;71.8
73;2021-09-14;412;621;325382;311281;75.2;72.0
73;2021-09-15;427;815;325809;312096;75.3;72.2
73;2021-09-16;332;647;326141;312743;75.4;72.3
73;2021-09-17;377;870;326518;313613;75.5;72.5
73;2021-09-18;261;630;326779;314243;75.5;72.6
73;2021-09-19;47;205;326826;314448;75.6;72.7
73;2021-09-20;163;632;326989;315080;75.6;72.8
73;2021-09-21;298;538;327287;315618;75.7;73.0
73;2021-09-22;275;774;327562;316392;75.7;73.1
73;2021-09-23;282;478;327844;316870;75.8;73.3
73;2021-09-24;292;857;328136;317727;75.9;73.5
73;2021-09-25;189;724;328325;318451;75.9;73.6
73;2021-09-26;73;211;328398;318662;75.9;73.7
73;2021-09-27;243;498;328641;319160;76.0;73.8
73;2021-09-28;185;340;328826;319500;76.0;73.9
73;2021-09-29;220;675;329046;320175;76.1;74.0
73;2021-09-30;193;365;329239;320540;76.1;74.1
73;2021-10-01;211;564;329450;321104;76.2;74.2
73;2021-10-02;197;482;329647;321586;76.2;74.3
73;2021-10-03;8;11;329655;321597;76.2;74.3
73;2021-10-04;213;363;329868;321960;76.3;74.4
73;2021-10-05;166;312;330034;322272;76.3;74.5
73;2021-10-06;315;508;330349;322780;76.4;74.6
73;2021-10-07;164;302;330513;323082;76.4;74.7
73;2021-10-08;254;536;330767;323618;76.5;74.8
73;2021-10-09;158;348;330925;323966;76.5;74.9
73;2021-10-10;3;6;330928;323972;76.5;74.9
73;2021-10-11;191;316;331119;324288;76.6;75.0
73;2021-10-12;133;182;331252;324470;76.6;75.0
73;2021-10-13;228;365;331480;324835;76.6;75.1
73;2021-10-14;189;327;331669;325162;76.7;75.2
74;2020-12-27;10;6;10;6;0.0;0.0
74;2020-12-28;10;1;20;7;0.0;0.0
74;2020-12-29;0;0;20;7;0.0;0.0
74;2020-12-30;5;2;25;9;0.0;0.0
74;2020-12-31;1;0;26;9;0.0;0.0
74;2021-01-01;1;0;27;9;0.0;0.0
74;2021-01-02;1;1;28;10;0.0;0.0
74;2021-01-03;0;0;28;10;0.0;0.0
74;2021-01-04;4;3;32;13;0.0;0.0
74;2021-01-05;4;1;36;14;0.0;0.0
74;2021-01-06;48;2;84;16;0.0;0.0
74;2021-01-07;220;1;304;17;0.0;0.0
74;2021-01-08;296;2;600;19;0.1;0.0
74;2021-01-09;79;0;679;19;0.1;0.0
74;2021-01-10;74;0;753;19;0.1;0.0
74;2021-01-11;375;1;1128;20;0.1;0.0
74;2021-01-12;408;3;1536;23;0.2;0.0
74;2021-01-13;396;0;1932;23;0.2;0.0
74;2021-01-14;482;5;2414;28;0.3;0.0
74;2021-01-15;645;4;3059;32;0.4;0.0
74;2021-01-16;254;1;3313;33;0.4;0.0
74;2021-01-17;137;2;3450;35;0.4;0.0
74;2021-01-18;527;3;3977;38;0.5;0.0
74;2021-01-19;816;3;4793;41;0.6;0.0
74;2021-01-20;1282;4;6075;45;0.7;0.0
74;2021-01-21;1570;3;7645;48;0.9;0.0
74;2021-01-22;1242;7;8887;55;1.1;0.0
74;2021-01-23;345;1;9232;56;1.1;0.0
74;2021-01-24;94;2;9326;58;1.1;0.0
74;2021-01-25;801;3;10127;61;1.2;0.0
74;2021-01-26;1372;26;11499;87;1.4;0.0
74;2021-01-27;1084;17;12583;104;1.5;0.0
74;2021-01-28;1003;40;13586;144;1.6;0.0
74;2021-01-29;883;43;14469;187;1.7;0.0
74;2021-01-30;305;1;14774;188;1.8;0.0
74;2021-01-31;87;1;14861;189;1.8;0.0
74;2021-02-01;631;45;15492;234;1.9;0.0
74;2021-02-02;646;154;16138;388;1.9;0.0
74;2021-02-03;606;121;16744;509;2.0;0.1
74;2021-02-04;617;136;17361;645;2.1;0.1
74;2021-02-05;557;224;17918;869;2.2;0.1
74;2021-02-06;276;136;18194;1005;2.2;0.1
74;2021-02-07;93;123;18287;1128;2.2;0.1
74;2021-02-08;620;349;18907;1477;2.3;0.2
74;2021-02-09;542;534;19449;2011;2.3;0.2
74;2021-02-10;692;518;20141;2529;2.4;0.3
74;2021-02-11;1084;1016;21225;3545;2.6;0.4
74;2021-02-12;917;617;22142;4162;2.7;0.5
74;2021-02-13;407;240;22549;4402;2.7;0.5
74;2021-02-14;320;112;22869;4514;2.8;0.5
74;2021-02-15;281;847;23150;5361;2.8;0.6
74;2021-02-16;492;1064;23642;6425;2.9;0.8
74;2021-02-17;533;1103;24175;7528;2.9;0.9
74;2021-02-18;473;987;24648;8515;3.0;1.0
74;2021-02-19;620;656;25268;9171;3.1;1.1
74;2021-02-20;114;187;25382;9358;3.1;1.1
74;2021-02-21;48;61;25430;9419;3.1;1.1
74;2021-02-22;320;787;25750;10206;3.1;1.2
74;2021-02-23;308;821;26058;11027;3.1;1.3
74;2021-02-24;242;680;26300;11707;3.2;1.4
74;2021-02-25;524;752;26824;12459;3.2;1.5
74;2021-02-26;972;702;27796;13161;3.4;1.6
74;2021-02-27;254;181;28050;13342;3.4;1.6
74;2021-02-28;125;71;28175;13413;3.4;1.6
74;2021-03-01;724;638;28899;14051;3.5;1.7
74;2021-03-02;1095;691;29994;14742;3.6;1.8
74;2021-03-03;1026;643;31020;15385;3.7;1.9
74;2021-03-04;1614;1028;32634;16413;3.9;2.0
74;2021-03-05;2095;898;34729;17311;4.2;2.1
74;2021-03-06;1762;339;36491;17650;4.4;2.1
74;2021-03-07;1388;109;37879;17759;4.6;2.1
74;2021-03-08;1198;961;39077;18720;4.7;2.3
74;2021-03-09;1958;677;41035;19397;5.0;2.3
74;2021-03-10;1749;923;42784;20320;5.2;2.5
74;2021-03-11;2452;738;45236;21058;5.5;2.5
74;2021-03-12;3246;1040;48482;22098;5.9;2.7
74;2021-03-13;2004;282;50486;22380;6.1;2.7
74;2021-03-14;609;105;51095;22485;6.2;2.7
74;2021-03-15;2130;571;53225;23056;6.4;2.8
74;2021-03-16;1965;422;55190;23478;6.7;2.8
74;2021-03-17;1975;326;57165;23804;6.9;2.9
74;2021-03-18;2137;296;59302;24100;7.2;2.9
74;2021-03-19;2637;305;61939;24405;7.5;2.9
74;2021-03-20;1375;105;63314;24510;7.6;3.0
74;2021-03-21;290;33;63604;24543;7.7;3.0
74;2021-03-22;2055;339;65659;24882;7.9;3.0
74;2021-03-23;2723;347;68382;25229;8.3;3.0
74;2021-03-24;2947;317;71329;25546;8.6;3.1
74;2021-03-25;3875;318;75204;25864;9.1;3.1
74;2021-03-26;4096;397;79300;26261;9.6;3.2
74;2021-03-27;1941;265;81241;26526;9.8;3.2
74;2021-03-28;437;78;81678;26604;9.9;3.2
74;2021-03-29;3035;728;84713;27332;10.2;3.3
74;2021-03-30;3543;785;88256;28117;10.7;3.4
74;2021-03-31;3144;747;91400;28864;11.0;3.5
74;2021-04-01;4235;913;95635;29777;11.5;3.6
74;2021-04-02;3711;808;99346;30585;12.0;3.7
74;2021-04-03;1697;547;101043;31132;12.2;3.8
74;2021-04-04;236;122;101279;31254;12.2;3.8
74;2021-04-05;433;17;101712;31271;12.3;3.8
74;2021-04-06;2621;1223;104333;32494;12.6;3.9
74;2021-04-07;3195;1267;107528;33761;13.0;4.1
74;2021-04-08;3864;1199;111392;34960;13.4;4.2
74;2021-04-09;4111;1200;115503;36160;13.9;4.4
74;2021-04-10;1944;1038;117447;37198;14.2;4.5
74;2021-04-11;253;184;117700;37382;14.2;4.5
74;2021-04-12;2724;1789;120424;39171;14.5;4.7
74;2021-04-13;3123;2117;123547;41288;14.9;5.0
74;2021-04-14;2903;1983;126450;43271;15.3;5.2
74;2021-04-15;3463;1928;129913;45199;15.7;5.5
74;2021-04-16;3386;1796;133299;46995;16.1;5.7
74;2021-04-17;1936;1041;135235;48036;16.3;5.8
74;2021-04-18;218;211;135453;48247;16.4;5.8
74;2021-04-19;2101;2108;137554;50355;16.6;6.1
74;2021-04-20;3068;2430;140622;52785;17.0;6.4
74;2021-04-21;2465;2382;143087;55167;17.3;6.7
74;2021-04-22;2630;2345;145717;57512;17.6;6.9
74;2021-04-23;2573;2260;148290;59772;17.9;7.2
74;2021-04-24;1485;1548;149775;61320;18.1;7.4
74;2021-04-25;229;150;150004;61470;18.1;7.4
74;2021-04-26;2396;2472;152400;63942;18.4;7.7
74;2021-04-27;3272;2919;155672;66861;18.8;8.1
74;2021-04-28;3465;2648;159137;69509;19.2;8.4
74;2021-04-29;3908;2701;163045;72210;19.7;8.7
74;2021-04-30;4076;2233;167121;74443;20.2;9.0
74;2021-05-01;2121;400;169242;74843;20.4;9.0
74;2021-05-02;206;239;169448;75082;20.5;9.1
74;2021-05-03;2597;3032;172045;78114;20.8;9.4
74;2021-05-04;3216;3118;175261;81232;21.2;9.8
74;2021-05-05;3392;3021;178653;84253;21.6;10.2
74;2021-05-06;3860;2639;182513;86892;22.0;10.5
74;2021-05-07;3595;3559;186108;90451;22.5;10.9
74;2021-05-08;1145;827;187253;91278;22.6;11.0
74;2021-05-09;195;247;187448;91525;22.6;11.0
74;2021-05-10;3466;3150;190914;94675;23.0;11.4
74;2021-05-11;4317;3426;195231;98101;23.6;11.8
74;2021-05-12;5306;2970;200537;101071;24.2;12.2
74;2021-05-13;2357;950;202894;102021;24.5;12.3
74;2021-05-14;5956;2407;208850;104428;25.2;12.6
74;2021-05-15;4514;1852;213364;106280;25.8;12.8
74;2021-05-16;3012;338;216376;106618;26.1;12.9
74;2021-05-17;5397;2890;221773;109508;26.8;13.2
74;2021-05-18;6792;2818;228565;112326;27.6;13.6
74;2021-05-19;6234;2296;234799;114622;28.3;13.8
74;2021-05-20;6643;2558;241442;117180;29.1;14.1
74;2021-05-21;6526;2994;247968;120174;29.9;14.5
74;2021-05-22;5293;1569;253261;121743;30.6;14.7
74;2021-05-23;2052;282;255313;122025;30.8;14.7
74;2021-05-24;2363;660;257676;122685;31.1;14.8
74;2021-05-25;5072;3334;262748;126019;31.7;15.2
74;2021-05-26;5255;2563;268003;128582;32.4;15.5
74;2021-05-27;6002;2975;274005;131557;33.1;15.9
74;2021-05-28;5656;3587;279661;135144;33.8;16.3
74;2021-05-29;3799;2156;283460;137300;34.2;16.6
74;2021-05-30;489;309;283949;137609;34.3;16.6
74;2021-05-31;5069;3549;289018;141158;34.9;17.0
74;2021-06-01;4931;3730;293949;144888;35.5;17.5
74;2021-06-02;5269;3207;299218;148095;36.1;17.9
74;2021-06-03;6890;3251;306108;151346;37.0;18.3
74;2021-06-04;6912;4432;313020;155778;37.8;18.8
74;2021-06-05;4610;2707;317630;158485;38.3;19.1
74;2021-06-06;124;112;317754;158597;38.4;19.1
74;2021-06-07;5032;4146;322786;162743;39.0;19.6
74;2021-06-08;5025;3951;327811;166694;39.6;20.1
74;2021-06-09;5081;3484;332892;170178;40.2;20.5
74;2021-06-10;5124;2879;338016;173057;40.8;20.9
74;2021-06-11;5214;3814;343230;176871;41.4;21.4
74;2021-06-12;3567;2378;346797;179249;41.9;21.6
74;2021-06-13;120;89;346917;179338;41.9;21.6
74;2021-06-14;3593;4482;350510;183820;42.3;22.2
74;2021-06-15;3671;3899;354181;187719;42.8;22.7
74;2021-06-16;4827;3126;359008;190845;43.3;23.0
74;2021-06-17;3816;2957;362824;193802;43.8;23.4
74;2021-06-18;4115;4671;366939;198473;44.3;24.0
74;2021-06-19;2992;3101;369931;201574;44.7;24.3
74;2021-06-20;125;97;370056;201671;44.7;24.3
74;2021-06-21;2382;5420;372438;207091;45.0;25.0
74;2021-06-22;2493;5313;374931;212404;45.3;25.6
74;2021-06-23;2974;4619;377905;217023;45.6;26.2
74;2021-06-24;2865;4627;380770;221650;46.0;26.8
74;2021-06-25;2930;6768;383700;228418;46.3;27.6
74;2021-06-26;1705;5400;385405;233818;46.5;28.2
74;2021-06-27;66;1664;385471;235482;46.5;28.4
74;2021-06-28;1915;7219;387386;242701;46.8;29.3
74;2021-06-29;2299;7422;389685;250123;47.0;30.2
74;2021-06-30;2747;6545;392432;256668;47.4;31.0
74;2021-07-01;3529;5426;395961;262094;47.8;31.6
74;2021-07-02;3120;6640;399081;268734;48.2;32.4
74;2021-07-03;1698;5084;400779;273818;48.4;33.1
74;2021-07-04;81;1022;400860;274840;48.4;33.2
74;2021-07-05;2078;6829;402938;281669;48.6;34.0
74;2021-07-06;2799;6491;405737;288160;49.0;34.8
74;2021-07-07;3094;5447;408831;293607;49.4;35.4
74;2021-07-08;3867;4923;412698;298530;49.8;36.0
74;2021-07-09;2671;6978;415369;305508;50.1;36.9
74;2021-07-10;1623;5132;416992;310640;50.3;37.5
74;2021-07-11;76;142;417068;310782;50.3;37.5
74;2021-07-12;2098;7899;419166;318681;50.6;38.5
74;2021-07-13;3967;7586;423133;326267;51.1;39.4
74;2021-07-14;1968;2238;425101;328505;51.3;39.7
74;2021-07-15;3593;6876;428694;335381;51.7;40.5
74;2021-07-16;4243;7741;432937;343122;52.3;41.4
74;2021-07-17;3004;5334;435941;348456;52.6;42.1
74;2021-07-18;156;155;436097;348611;52.6;42.1
74;2021-07-19;4295;7352;440392;355963;53.2;43.0
74;2021-07-20;5872;6469;446264;362432;53.9;43.8
74;2021-07-21;5669;6675;451933;369107;54.6;44.6
74;2021-07-22;4773;5323;456706;374430;55.1;45.2
74;2021-07-23;6227;6996;462933;381426;55.9;46.0
74;2021-07-24;3157;4316;466090;385742;56.3;46.6
74;2021-07-25;181;172;466271;385914;56.3;46.6
74;2021-07-26;5618;6135;471889;392049;57.0;47.3
74;2021-07-27;6852;5177;478741;397226;57.8;48.0
74;2021-07-28;6660;5102;485401;402328;58.6;48.6
74;2021-07-29;5280;3931;490681;406259;59.2;49.0
74;2021-07-30;6716;5506;497397;411765;60.0;49.7
74;2021-07-31;4380;3123;501777;414888;60.6;50.1
74;2021-08-01;184;149;501961;415037;60.6;50.1
74;2021-08-02;6274;4410;508235;419447;61.4;50.6
74;2021-08-03;6038;3860;514273;423307;62.1;51.1
74;2021-08-04;6325;3508;520598;426815;62.8;51.5
74;2021-08-05;4935;3270;525533;430085;63.4;51.9
74;2021-08-06;5069;4183;530602;434268;64.1;52.4
74;2021-08-07;3213;2899;533815;437167;64.4;52.8
74;2021-08-08;154;134;533969;437301;64.5;52.8
74;2021-08-09;4977;4829;538946;442130;65.1;53.4
74;2021-08-10;4992;4689;543938;446819;65.7;53.9
74;2021-08-11;4447;4892;548385;451711;66.2;54.5
74;2021-08-12;3626;3608;552011;455319;66.6;55.0
74;2021-08-13;3837;4625;555848;459944;67.1;55.5
74;2021-08-14;2184;3342;558032;463286;67.4;55.9
74;2021-08-15;66;103;558098;463389;67.4;55.9
74;2021-08-16;3912;5880;562010;469269;67.8;56.6
74;2021-08-17;3136;5486;565146;474755;68.2;57.3
74;2021-08-18;3092;5462;568238;480217;68.6;58.0
74;2021-08-19;2357;3897;570595;484114;68.9;58.4
74;2021-08-20;2638;5698;573233;489812;69.2;59.1
74;2021-08-21;1239;4273;574472;494085;69.3;59.6
74;2021-08-22;56;137;574528;494222;69.4;59.7
74;2021-08-23;2197;6698;576725;500920;69.6;60.5
74;2021-08-24;2220;5939;578945;506859;69.9;61.2
74;2021-08-25;1978;6296;580923;513155;70.1;61.9
74;2021-08-26;1562;3788;582485;516943;70.3;62.4
74;2021-08-27;1940;5512;584425;522455;70.5;63.1
74;2021-08-28;925;4042;585350;526497;70.7;63.6
74;2021-08-29;67;188;585417;526685;70.7;63.6
74;2021-08-30;1872;5356;587289;532041;70.9;64.2
74;2021-08-31;1681;4968;588970;537009;71.1;64.8
74;2021-09-01;1984;3879;590954;540888;71.3;65.3
74;2021-09-02;1225;2813;592179;543701;71.5;65.6
74;2021-09-03;1552;3836;593731;547537;71.7;66.1
74;2021-09-04;1158;2749;594889;550286;71.8;66.4
74;2021-09-05;49;92;594938;550378;71.8;66.4
74;2021-09-06;1332;3032;596270;553410;72.0;66.8
74;2021-09-07;1031;2745;597301;556155;72.1;67.1
74;2021-09-08;1316;2870;598617;559025;72.3;67.5
74;2021-09-09;1222;1936;599839;560961;72.4;67.7
74;2021-09-10;1124;2755;600963;563716;72.5;68.0
74;2021-09-11;766;2214;601729;565930;72.6;68.3
74;2021-09-12;40;74;601769;566004;72.6;68.3
74;2021-09-13;1002;2070;602771;568074;72.8;68.6
74;2021-09-14;1095;1972;603866;570046;72.9;68.8
74;2021-09-15;1067;2274;604933;572320;73.0;69.1
74;2021-09-16;752;1032;605685;573352;73.1;69.2
74;2021-09-17;840;1848;606525;575200;73.2;69.4
74;2021-09-18;608;1671;607133;576871;73.3;69.6
74;2021-09-19;3;9;607136;576880;73.3;69.6
74;2021-09-20;812;1887;607948;578767;73.4;69.9
74;2021-09-21;643;1373;608591;580140;73.5;70.0
74;2021-09-22;650;2105;609241;582245;73.5;70.3
74;2021-09-23;639;997;609880;583242;73.6;70.4
74;2021-09-24;724;1970;610604;585212;73.7;70.6
74;2021-09-25;461;1623;611065;586835;73.8;70.8
74;2021-09-26;1;2;611066;586837;73.8;70.8
74;2021-09-27;574;1775;611640;588612;73.8;71.1
74;2021-09-28;400;963;612040;589575;73.9;71.2
74;2021-09-29;547;1564;612587;591139;73.9;71.4
74;2021-09-30;389;1061;612976;592200;74.0;71.5
74;2021-10-01;600;1122;613576;593322;74.1;71.6
74;2021-10-02;434;816;614010;594138;74.1;71.7
74;2021-10-03;5;11;614015;594149;74.1;71.7
74;2021-10-04;531;1108;614546;595257;74.2;71.9
74;2021-10-05;367;1089;614913;596346;74.2;72.0
74;2021-10-06;449;991;615362;597337;74.3;72.1
74;2021-10-07;301;630;615663;597967;74.3;72.2
74;2021-10-08;561;1160;616224;599127;74.4;72.3
74;2021-10-09;408;771;616632;599898;74.4;72.4
74;2021-10-10;5;15;616637;599913;74.4;72.4
74;2021-10-11;383;818;617020;600731;74.5;72.5
74;2021-10-12;353;799;617373;601530;74.5;72.6
74;2021-10-13;429;852;617802;602382;74.6;72.7
74;2021-10-14;291;483;618093;602865;74.6;72.8
75;2020-12-27;77;11;77;11;0.0;0.0
75;2020-12-28;67;2;144;13;0.0;0.0
75;2020-12-29;34;3;178;16;0.0;0.0
75;2020-12-30;89;1;267;17;0.0;0.0
75;2020-12-31;50;4;317;21;0.0;0.0
75;2021-01-01;63;11;380;32;0.0;0.0
75;2021-01-02;67;4;447;36;0.0;0.0
75;2021-01-03;110;6;557;42;0.0;0.0
75;2021-01-04;323;11;880;53;0.0;0.0
75;2021-01-05;883;16;1763;69;0.1;0.0
75;2021-01-06;1372;23;3135;92;0.1;0.0
75;2021-01-07;2072;23;5207;115;0.2;0.0
75;2021-01-08;2881;33;8088;148;0.4;0.0
75;2021-01-09;1101;3;9189;151;0.4;0.0
75;2021-01-10;1100;4;10289;155;0.5;0.0
75;2021-01-11;3120;69;13409;224;0.6;0.0
75;2021-01-12;3494;64;16903;288;0.8;0.0
75;2021-01-13;3577;58;20480;346;1.0;0.0
75;2021-01-14;3803;104;24283;450;1.1;0.0
75;2021-01-15;3343;68;27626;518;1.3;0.0
75;2021-01-16;1148;26;28774;544;1.3;0.0
75;2021-01-17;564;19;29338;563;1.4;0.0
75;2021-01-18;3296;84;32634;647;1.5;0.0
75;2021-01-19;3881;61;36515;708;1.7;0.0
75;2021-01-20;4442;81;40957;789;1.9;0.0
75;2021-01-21;4954;103;45911;892;2.1;0.0
75;2021-01-22;4611;100;50522;992;2.4;0.0
75;2021-01-23;1772;16;52294;1008;2.4;0.0
75;2021-01-24;764;12;53058;1020;2.5;0.0
75;2021-01-25;1743;37;54801;1057;2.6;0.0
75;2021-01-26;2564;100;57365;1157;2.7;0.1
75;2021-01-27;3177;184;60542;1341;2.8;0.1
75;2021-01-28;4791;260;65333;1601;3.0;0.1
75;2021-01-29;4067;276;69400;1877;3.2;0.1
75;2021-01-30;1361;36;70761;1913;3.3;0.1
75;2021-01-31;228;3;70989;1916;3.3;0.1
75;2021-02-01;1640;383;72629;2299;3.4;0.1
75;2021-02-02;2155;652;74784;2951;3.5;0.1
75;2021-02-03;1900;692;76684;3643;3.6;0.2
75;2021-02-04;2155;1131;78839;4774;3.7;0.2
75;2021-02-05;2229;874;81068;5648;3.8;0.3
75;2021-02-06;1143;111;82211;5759;3.8;0.3
75;2021-02-07;179;9;82390;5768;3.8;0.3
75;2021-02-08;1270;1466;83660;7234;3.9;0.3
75;2021-02-09;1803;2388;85463;9622;4.0;0.4
75;2021-02-10;2431;2394;87894;12016;4.1;0.6
75;2021-02-11;2952;6306;90846;18322;4.2;0.9
75;2021-02-12;3144;2411;93990;20733;4.4;1.0
75;2021-02-13;865;1040;94855;21773;4.4;1.0
75;2021-02-14;215;47;95070;21820;4.4;1.0
75;2021-02-15;1013;2444;96083;24264;4.5;1.1
75;2021-02-16;1471;6482;97554;30746;4.5;1.4
75;2021-02-17;1348;3217;98902;33963;4.6;1.6
75;2021-02-18;1780;5814;100682;39777;4.7;1.9
75;2021-02-19;2234;4135;102916;43912;4.8;2.0
75;2021-02-20;485;1674;103401;45586;4.8;2.1
75;2021-02-21;201;168;103602;45754;4.8;2.1
75;2021-02-22;1230;1925;104832;47679;4.9;2.2
75;2021-02-23;1477;2719;106309;50398;4.9;2.3
75;2021-02-24;1703;2336;108012;52734;5.0;2.5
75;2021-02-25;2800;5307;110812;58041;5.2;2.7
75;2021-02-26;3389;2730;114201;60771;5.3;2.8
75;2021-02-27;1411;947;115612;61718;5.4;2.9
75;2021-02-28;332;147;115944;61865;5.4;2.9
75;2021-03-01;2614;1701;118558;63566;5.5;3.0
75;2021-03-02;4203;2242;122761;65808;5.7;3.1
75;2021-03-03;5450;2383;128211;68191;6.0;3.2
75;2021-03-04;8066;2655;136277;70846;6.3;3.3
75;2021-03-05;10590;2816;146867;73662;6.8;3.4
75;2021-03-06;11091;1140;157958;74802;7.4;3.5
75;2021-03-07;9513;1563;167471;76365;7.8;3.6
75;2021-03-08;5929;1619;173400;77984;8.1;3.6
75;2021-03-09;7547;2183;180947;80167;8.4;3.7
75;2021-03-10;7527;2191;188474;82358;8.8;3.8
75;2021-03-11;10371;2612;198845;84970;9.3;4.0
75;2021-03-12;12080;2640;210925;87610;9.8;4.1
75;2021-03-13;8563;819;219488;88429;10.2;4.1
75;2021-03-14;4184;272;223672;88701;10.4;4.1
75;2021-03-15;7485;1017;231157;89718;10.8;4.2
75;2021-03-16;5173;728;236330;90446;11.0;4.2
75;2021-03-17;5439;873;241769;91319;11.3;4.3
75;2021-03-18;6634;914;248403;92233;11.6;4.3
75;2021-03-19;9774;1050;258177;93283;12.0;4.3
75;2021-03-20;5945;626;264122;93909;12.3;4.4
75;2021-03-21;1597;437;265719;94346;12.4;4.4
75;2021-03-22;8671;1065;274390;95411;12.8;4.4
75;2021-03-23;10977;1315;285367;96726;13.3;4.5
75;2021-03-24;11022;1384;296389;98110;13.8;4.6
75;2021-03-25;14225;1612;310614;99722;14.5;4.6
75;2021-03-26;13998;1764;324612;101486;15.1;4.7
75;2021-03-27;7293;799;331905;102285;15.4;4.8
75;2021-03-28;1791;166;333696;102451;15.5;4.8
75;2021-03-29;7986;2238;341682;104689;15.9;4.9
75;2021-03-30;10949;3296;352631;107985;16.4;5.0
75;2021-03-31;9757;3657;362388;111642;16.9;5.2
75;2021-04-01;10723;5257;373111;116899;17.4;5.4
75;2021-04-02;9070;5633;382181;122532;17.8;5.7
75;2021-04-03;4129;4913;386310;127445;18.0;5.9
75;2021-04-04;1424;1502;387734;128947;18.0;6.0
75;2021-04-05;2264;1443;389998;130390;18.2;6.1
75;2021-04-06;6934;4347;396932;134737;18.5;6.3
75;2021-04-07;8110;4461;405042;139198;18.9;6.5
75;2021-04-08;11097;4230;416139;143428;19.4;6.7
75;2021-04-09;12222;4674;428361;148102;19.9;6.9
75;2021-04-10;5852;4293;434213;152395;20.2;7.1
75;2021-04-11;1952;1807;436165;154202;20.3;7.2
75;2021-04-12;7493;3822;443658;158024;20.7;7.4
75;2021-04-13;8576;6880;452234;164904;21.1;7.7
75;2021-04-14;8309;5263;460543;170167;21.4;7.9
75;2021-04-15;8939;6177;469482;176344;21.9;8.2
75;2021-04-16;9399;6151;478881;182495;22.3;8.5
75;2021-04-17;4822;3656;483703;186151;22.5;8.7
75;2021-04-18;1675;885;485378;187036;22.6;8.7
75;2021-04-19;5596;4981;490974;192017;22.9;8.9
75;2021-04-20;6476;5991;497450;198008;23.2;9.2
75;2021-04-21;6883;5601;504333;203609;23.5;9.5
75;2021-04-22;7551;5942;511884;209551;23.8;9.8
75;2021-04-23;8707;6511;520591;216062;24.2;10.1
75;2021-04-24;6185;3368;526776;219430;24.5;10.2
75;2021-04-25;2974;770;529750;220200;24.7;10.3
75;2021-04-26;7033;4736;536783;224936;25.0;10.5
75;2021-04-27;10604;6454;547387;231390;25.5;10.8
75;2021-04-28;12207;6053;559594;237443;26.0;11.1
75;2021-04-29;13764;6378;573358;243821;26.7;11.3
75;2021-04-30;13670;6216;587028;250037;27.3;11.6
75;2021-05-01;5081;1337;592109;251374;27.6;11.7
75;2021-05-02;2392;806;594501;252180;27.7;11.7
75;2021-05-03;10298;13515;604799;265695;28.2;12.4
75;2021-05-04;11201;8100;616000;273795;28.7;12.7
75;2021-05-05;13568;6736;629568;280531;29.3;13.1
75;2021-05-06;14013;8217;643581;288748;30.0;13.4
75;2021-05-07;13990;8601;657571;297349;30.6;13.8
75;2021-05-08;10087;5524;667658;302873;31.1;14.1
75;2021-05-09;3821;3194;671479;306067;31.3;14.2
75;2021-05-10;14302;6732;685781;312799;31.9;14.6
75;2021-05-11;16853;8414;702634;321213;32.7;15.0
75;2021-05-12;17967;8165;720601;329378;33.5;15.3
75;2021-05-13;13649;2495;734250;331873;34.2;15.4
75;2021-05-14;18398;5134;752648;337007;35.0;15.7
75;2021-05-15;12326;2660;764974;339667;35.6;15.8
75;2021-05-16;3863;760;768837;340427;35.8;15.8
75;2021-05-17;16014;4652;784851;345079;36.5;16.1
75;2021-05-18;19166;5327;804017;350406;37.4;16.3
75;2021-05-19;20734;10700;824751;361106;38.4;16.8
75;2021-05-20;21587;8663;846338;369769;39.4;17.2
75;2021-05-21;21033;6553;867371;376322;40.4;17.5
75;2021-05-22;15911;3301;883282;379623;41.1;17.7
75;2021-05-23;5639;1336;888921;380959;41.4;17.7
75;2021-05-24;15637;2559;904558;383518;42.1;17.9
75;2021-05-25;18038;9564;922596;393082;42.9;18.3
75;2021-05-26;18890;8204;941486;401286;43.8;18.7
75;2021-05-27;20152;9794;961638;411080;44.8;19.1
75;2021-05-28;19341;10842;980979;421922;45.7;19.6
75;2021-05-29;16115;5838;997094;427760;46.4;19.9
75;2021-05-30;7039;2157;1004133;429917;46.7;20.0
75;2021-05-31;18096;9438;1022229;439355;47.6;20.5
75;2021-06-01;18702;12983;1040931;452338;48.5;21.1
75;2021-06-02;18122;10301;1059053;462639;49.3;21.5
75;2021-06-03;20256;11957;1079309;474596;50.2;22.1
75;2021-06-04;18121;12844;1097430;487440;51.1;22.7
75;2021-06-05;11991;9614;1109421;497054;51.6;23.1
75;2021-06-06;6728;3163;1116149;500217;52.0;23.3
75;2021-06-07;13893;11827;1130042;512044;52.6;23.8
75;2021-06-08;14805;13966;1144847;526010;53.3;24.5
75;2021-06-09;16510;15235;1161357;541245;54.1;25.2
75;2021-06-10;18367;26292;1179724;567537;54.9;26.4
75;2021-06-11;15312;16458;1195036;583995;55.6;27.2
75;2021-06-12;13285;10003;1208321;593998;56.2;27.7
75;2021-06-13;6279;3794;1214600;597792;56.5;27.8
75;2021-06-14;11827;15396;1226427;613188;57.1;28.5
75;2021-06-15;12729;19551;1239156;632739;57.7;29.5
75;2021-06-16;12214;17241;1251370;649980;58.3;30.3
75;2021-06-17;12661;17677;1264031;667657;58.8;31.1
75;2021-06-18;11279;22609;1275310;690266;59.4;32.1
75;2021-06-19;7535;11823;1282845;702089;59.7;32.7
75;2021-06-20;2821;5477;1285666;707566;59.8;32.9
75;2021-06-21;8517;16331;1294183;723897;60.2;33.7
75;2021-06-22;8810;21793;1302993;745690;60.7;34.7
75;2021-06-23;10309;21431;1313302;767121;61.1;35.7
75;2021-06-24;11320;20639;1324622;787760;61.7;36.7
75;2021-06-25;9877;24686;1334499;812446;62.1;37.8
75;2021-06-26;7937;15420;1342436;827866;62.5;38.5
75;2021-06-27;2701;6325;1345137;834191;62.6;38.8
75;2021-06-28;8482;20157;1353619;854348;63.0;39.8
75;2021-06-29;9348;23832;1362967;878180;63.4;40.9
75;2021-06-30;10219;23626;1373186;901806;63.9;42.0
75;2021-07-01;11439;23516;1384625;925322;64.5;43.1
75;2021-07-02;10894;24771;1395519;950093;65.0;44.2
75;2021-07-03;7819;19805;1403338;969898;65.3;45.1
75;2021-07-04;3909;9556;1407247;979454;65.5;45.6
75;2021-07-05;9350;21583;1416597;1001037;65.9;46.6
75;2021-07-06;10178;24011;1426775;1025048;66.4;47.7
75;2021-07-07;10170;25091;1436945;1050139;66.9;48.9
75;2021-07-08;10674;25026;1447619;1075165;67.4;50.0
75;2021-07-09;10869;24038;1458488;1099203;67.9;51.2
75;2021-07-10;7954;18500;1466442;1117703;68.3;52.0
75;2021-07-11;4350;8528;1470792;1126231;68.5;52.4
75;2021-07-12;9864;23090;1480656;1149321;68.9;53.5
75;2021-07-13;14397;24814;1495053;1174135;69.6;54.7
75;2021-07-14;8353;9728;1503406;1183863;70.0;55.1
75;2021-07-15;15584;25665;1518990;1209528;70.7;56.3
75;2021-07-16;15828;22159;1534818;1231687;71.4;57.3
75;2021-07-17;12196;16912;1547014;1248599;72.0;58.1
75;2021-07-18;6268;6843;1553282;1255442;72.3;58.4
75;2021-07-19;14405;21302;1567687;1276744;73.0;59.4
75;2021-07-20;16074;21902;1583761;1298646;73.7;60.5
75;2021-07-21;15715;20711;1599476;1319357;74.5;61.4
75;2021-07-22;17156;20100;1616632;1339457;75.3;62.4
75;2021-07-23;17168;19112;1633800;1358569;76.1;63.2
75;2021-07-24;11199;14081;1644999;1372650;76.6;63.9
75;2021-07-25;5004;5069;1650003;1377719;76.8;64.1
75;2021-07-26;15182;16876;1665185;1394595;77.5;64.9
75;2021-07-27;18159;16674;1683344;1411269;78.4;65.7
75;2021-07-28;17159;15498;1700503;1426767;79.2;66.4
75;2021-07-29;16780;15098;1717283;1441865;79.9;67.1
75;2021-07-30;16943;14354;1734226;1456219;80.7;67.8
75;2021-07-31;9348;9868;1743574;1466087;81.2;68.2
75;2021-08-01;3727;3256;1747301;1469343;81.3;68.4
75;2021-08-02;10986;11989;1758287;1481332;81.8;69.0
75;2021-08-03;11137;10842;1769424;1492174;82.4;69.5
75;2021-08-04;9736;9485;1779160;1501659;82.8;69.9
75;2021-08-05;8725;9558;1787885;1511217;83.2;70.3
75;2021-08-06;8260;9994;1796145;1521211;83.6;70.8
75;2021-08-07;5714;7159;1801859;1528370;83.9;71.1
75;2021-08-08;1971;3282;1803830;1531652;84.0;71.3
75;2021-08-09;8616;11481;1812446;1543133;84.4;71.8
75;2021-08-10;9307;11592;1821753;1554725;84.8;72.4
75;2021-08-11;7799;10146;1829552;1564871;85.2;72.8
75;2021-08-12;6954;10601;1836506;1575472;85.5;73.3
75;2021-08-13;6267;8869;1842773;1584341;85.8;73.7
75;2021-08-14;4122;7200;1846895;1591541;86.0;74.1
75;2021-08-15;1032;1938;1847927;1593479;86.0;74.2
75;2021-08-16;6153;14033;1854080;1607512;86.3;74.8
75;2021-08-17;5823;13610;1859903;1621122;86.6;75.5
75;2021-08-18;5084;12011;1864987;1633133;86.8;76.0
75;2021-08-19;4780;12689;1869767;1645822;87.0;76.6
75;2021-08-20;4576;11791;1874343;1657613;87.2;77.2
75;2021-08-21;3193;8814;1877536;1666427;87.4;77.6
75;2021-08-22;998;3163;1878534;1669590;87.4;77.7
75;2021-08-23;4929;15308;1883463;1684898;87.7;78.4
75;2021-08-24;4813;14539;1888276;1699437;87.9;79.1
75;2021-08-25;4544;12335;1892820;1711772;88.1;79.7
75;2021-08-26;4100;10281;1896920;1722053;88.3;80.2
75;2021-08-27;4487;11685;1901407;1733738;88.5;80.7
75;2021-08-28;3076;8306;1904483;1742044;88.7;81.1
75;2021-08-29;755;2020;1905238;1744064;88.7;81.2
75;2021-08-30;4534;14027;1909772;1758091;88.9;81.8
75;2021-08-31;4431;12791;1914203;1770882;89.1;82.4
75;2021-09-01;4133;9853;1918336;1780735;89.3;82.9
75;2021-09-02;3416;7869;1921752;1788604;89.5;83.3
75;2021-09-03;3764;8706;1925516;1797310;89.6;83.7
75;2021-09-04;3604;7871;1929120;1805181;89.8;84.0
75;2021-09-05;710;1364;1929830;1806545;89.8;84.1
75;2021-09-06;2650;6566;1932480;1813111;90.0;84.4
75;2021-09-07;2419;6011;1934899;1819122;90.1;84.7
75;2021-09-08;2640;6033;1937539;1825155;90.2;85.0
75;2021-09-09;2481;5307;1940020;1830462;90.3;85.2
75;2021-09-10;2813;6198;1942833;1836660;90.4;85.5
75;2021-09-11;2451;6205;1945284;1842865;90.6;85.8
75;2021-09-12;511;1008;1945795;1843873;90.6;85.8
75;2021-09-13;2348;4918;1948143;1848791;90.7;86.1
75;2021-09-14;2317;4035;1950460;1852826;90.8;86.2
75;2021-09-15;2368;4657;1952828;1857483;90.9;86.5
75;2021-09-16;1972;3717;1954800;1861200;91.0;86.6
75;2021-09-17;2600;4768;1957400;1865968;91.1;86.9
75;2021-09-18;1579;4681;1958979;1870649;91.2;87.1
75;2021-09-19;291;739;1959270;1871388;91.2;87.1
75;2021-09-20;1734;3655;1961004;1875043;91.3;87.3
75;2021-09-21;1641;3206;1962645;1878249;91.4;87.4
75;2021-09-22;1602;3968;1964247;1882217;91.4;87.6
75;2021-09-23;1432;2855;1965679;1885072;91.5;87.7
75;2021-09-24;1801;4036;1967480;1889108;91.6;87.9
75;2021-09-25;1263;4354;1968743;1893462;91.6;88.1
75;2021-09-26;281;531;1969024;1893993;91.7;88.2
75;2021-09-27;1314;3018;1970338;1897011;91.7;88.3
75;2021-09-28;1408;2475;1971746;1899486;91.8;88.4
75;2021-09-29;1379;2878;1973125;1902364;91.8;88.6
75;2021-09-30;1268;2521;1974393;1904885;91.9;88.7
75;2021-10-01;1521;2685;1975914;1907570;92.0;88.8
75;2021-10-02;1421;2759;1977335;1910329;92.0;88.9
75;2021-10-03;224;424;1977559;1910753;92.1;88.9
75;2021-10-04;1352;2512;1978911;1913265;92.1;89.1
75;2021-10-05;1090;2169;1980001;1915434;92.2;89.2
75;2021-10-06;1226;2422;1981227;1917856;92.2;89.3
75;2021-10-07;1135;2070;1982362;1919926;92.3;89.4
75;2021-10-08;1488;3061;1983850;1922987;92.3;89.5
75;2021-10-09;1299;2242;1985149;1925229;92.4;89.6
75;2021-10-10;250;363;1985399;1925592;92.4;89.6
75;2021-10-11;1250;2218;1986649;1927810;92.5;89.7
75;2021-10-12;1223;2103;1987872;1929913;92.5;89.8
75;2021-10-13;1264;2135;1989136;1932048;92.6;89.9
75;2021-10-14;1185;2050;1990321;1934098;92.6;90.0
76;2020-12-27;0;0;0;0;0.0;0.0
76;2020-12-28;1;1;1;1;0.0;0.0
76;2020-12-29;0;0;1;1;0.0;0.0
76;2020-12-30;0;0;1;1;0.0;0.0
76;2020-12-31;0;0;1;1;0.0;0.0
76;2021-01-01;0;0;1;1;0.0;0.0
76;2021-01-02;0;0;1;1;0.0;0.0
76;2021-01-03;0;0;1;1;0.0;0.0
76;2021-01-04;17;0;18;1;0.0;0.0
76;2021-01-05;138;0;156;1;0.0;0.0
76;2021-01-06;682;2;838;3;0.1;0.0
76;2021-01-07;1354;7;2192;10;0.2;0.0
76;2021-01-08;1537;2;3729;12;0.3;0.0
76;2021-01-09;736;2;4465;14;0.4;0.0
76;2021-01-10;492;2;4957;16;0.4;0.0
76;2021-01-11;1358;3;6315;19;0.5;0.0
76;2021-01-12;1358;3;7673;22;0.6;0.0
76;2021-01-13;1187;5;8860;27;0.7;0.0
76;2021-01-14;2178;24;11038;51;0.9;0.0
76;2021-01-15;1910;9;12948;60;1.0;0.0
76;2021-01-16;991;8;13939;68;1.1;0.0
76;2021-01-17;2898;23;16837;91;1.4;0.0
76;2021-01-18;4395;19;21232;110;1.7;0.0
76;2021-01-19;3022;11;24254;121;2.0;0.0
76;2021-01-20;2072;10;26326;131;2.1;0.0
76;2021-01-21;1772;4;28098;135;2.3;0.0
76;2021-01-22;1705;4;29803;139;2.4;0.0
76;2021-01-23;450;4;30253;143;2.4;0.0
76;2021-01-24;100;0;30353;143;2.4;0.0
76;2021-01-25;1476;139;31829;282;2.6;0.0
76;2021-01-26;1394;335;33223;617;2.7;0.0
76;2021-01-27;1341;433;34564;1050;2.8;0.1
76;2021-01-28;1286;385;35850;1435;2.9;0.1
76;2021-01-29;1155;458;37005;1893;3.0;0.2
76;2021-01-30;283;302;37288;2195;3.0;0.2
76;2021-01-31;4;98;37292;2293;3.0;0.2
76;2021-02-01;842;808;38134;3101;3.1;0.2
76;2021-02-02;1056;1017;39190;4118;3.2;0.3
76;2021-02-03;921;996;40111;5114;3.2;0.4
76;2021-02-04;976;1454;41087;6568;3.3;0.5
76;2021-02-05;975;1105;42062;7673;3.4;0.6
76;2021-02-06;264;878;42326;8551;3.4;0.7
76;2021-02-07;468;1654;42794;10205;3.4;0.8
76;2021-02-08;1924;3728;44718;13933;3.6;1.1
76;2021-02-09;1752;2989;46470;16922;3.7;1.4
76;2021-02-10;1489;1809;47959;18731;3.9;1.5
76;2021-02-11;1680;1528;49639;20259;4.0;1.6
76;2021-02-12;1706;1573;51345;21832;4.1;1.8
76;2021-02-13;230;337;51575;22169;4.1;1.8
76;2021-02-14;9;82;51584;22251;4.1;1.8
76;2021-02-15;552;1713;52136;23964;4.2;1.9
76;2021-02-16;742;1642;52878;25606;4.3;2.1
76;2021-02-17;626;1448;53504;27054;4.3;2.2
76;2021-02-18;780;1392;54284;28446;4.4;2.3
76;2021-02-19;870;1341;55154;29787;4.4;2.4
76;2021-02-20;270;287;55424;30074;4.5;2.4
76;2021-02-21;0;0;55424;30074;4.5;2.4
76;2021-02-22;371;1306;55795;31380;4.5;2.5
76;2021-02-23;576;1238;56371;32618;4.5;2.6
76;2021-02-24;601;1198;56972;33816;4.6;2.7
76;2021-02-25;1665;1265;58637;35081;4.7;2.8
76;2021-02-26;2171;1058;60808;36139;4.9;2.9
76;2021-02-27;1109;276;61917;36415;5.0;2.9
76;2021-02-28;27;196;61944;36611;5.0;2.9
76;2021-03-01;831;2087;62775;38698;5.0;3.1
76;2021-03-02;1382;1719;64157;40417;5.2;3.2
76;2021-03-03;1942;1392;66099;41809;5.3;3.4
76;2021-03-04;2818;1119;68917;42928;5.5;3.5
76;2021-03-05;4183;826;73100;43754;5.9;3.5
76;2021-03-06;3365;172;76465;43926;6.1;3.5
76;2021-03-07;1257;35;77722;43961;6.2;3.5
76;2021-03-08;2102;1261;79824;45222;6.4;3.6
76;2021-03-09;3575;1174;83399;46396;6.7;3.7
76;2021-03-10;3595;1074;86994;47470;7.0;3.8
76;2021-03-11;5635;952;92629;48422;7.4;3.9
76;2021-03-12;6830;620;99459;49042;8.0;3.9
76;2021-03-13;4646;158;104105;49200;8.4;4.0
76;2021-03-14;1068;28;105173;49228;8.5;4.0
76;2021-03-15;2919;245;108092;49473;8.7;4.0
76;2021-03-16;2557;404;110649;49877;8.9;4.0
76;2021-03-17;2695;318;113344;50195;9.1;4.0
76;2021-03-18;3003;318;116347;50513;9.4;4.1
76;2021-03-19;4397;441;120744;50954;9.7;4.1
76;2021-03-20;3974;301;124718;51255;10.0;4.1
76;2021-03-21;838;18;125556;51273;10.1;4.1
76;2021-03-22;3992;357;129548;51630;10.4;4.2
76;2021-03-23;5709;368;135257;51998;10.9;4.2
76;2021-03-24;5701;404;140958;52402;11.3;4.2
76;2021-03-25;7505;582;148463;52984;11.9;4.3
76;2021-03-26;8721;605;157184;53589;12.6;4.3
76;2021-03-27;4809;397;161993;53986;13.0;4.3
76;2021-03-28;1021;32;163014;54018;13.1;4.3
76;2021-03-29;5388;836;168402;54854;13.5;4.4
76;2021-03-30;6587;1068;174989;55922;14.1;4.5
76;2021-03-31;6462;1284;181451;57206;14.6;4.6
76;2021-04-01;6784;2045;188235;59251;15.1;4.8
76;2021-04-02;6485;2689;194720;61940;15.7;5.0
76;2021-04-03;2442;1083;197162;63023;15.9;5.1
76;2021-04-04;265;11;197427;63034;15.9;5.1
76;2021-04-05;869;379;198296;63413;15.9;5.1
76;2021-04-06;3557;2798;201853;66211;16.2;5.3
76;2021-04-07;4415;2412;206268;68623;16.6;5.5
76;2021-04-08;5839;2787;212107;71410;17.1;5.7
76;2021-04-09;8803;3085;220910;74495;17.8;6.0
76;2021-04-10;4876;1429;225786;75924;18.2;6.1
76;2021-04-11;814;535;226600;76459;18.2;6.1
76;2021-04-12;4726;2860;231326;79319;18.6;6.4
76;2021-04-13;5926;2873;237252;82192;19.1;6.6
76;2021-04-14;4803;3137;242055;85329;19.5;6.9
76;2021-04-15;5560;3363;247615;88692;19.9;7.1
76;2021-04-16;7356;3448;254971;92140;20.5;7.4
76;2021-04-17;4387;1436;259358;93576;20.9;7.5
76;2021-04-18;339;141;259697;93717;20.9;7.5
76;2021-04-19;3478;3779;263175;97496;21.2;7.8
76;2021-04-20;4344;4286;267519;101782;21.5;8.2
76;2021-04-21;4192;4697;271711;106479;21.8;8.6
76;2021-04-22;4564;5443;276275;111922;22.2;9.0
76;2021-04-23;5444;5980;281719;117902;22.7;9.5
76;2021-04-24;4165;2197;285884;120099;23.0;9.7
76;2021-04-25;895;269;286779;120368;23.1;9.7
76;2021-04-26;4484;4480;291263;124848;23.4;10.0
76;2021-04-27;5000;5010;296263;129858;23.8;10.4
76;2021-04-28;5348;4179;301611;134037;24.2;10.8
76;2021-04-29;6926;4177;308537;138214;24.8;11.1
76;2021-04-30;8219;4658;316756;142872;25.5;11.5
76;2021-05-01;4828;1017;321584;143889;25.9;11.6
76;2021-05-02;1842;265;323426;144154;26.0;11.6
76;2021-05-03;4703;3314;328129;147468;26.4;11.9
76;2021-05-04;4822;4563;332951;152031;26.8;12.2
76;2021-05-05;4783;5182;337734;157213;27.2;12.6
76;2021-05-06;5922;5588;343656;162801;27.6;13.1
76;2021-05-07;6137;6772;349793;169573;28.1;13.6
76;2021-05-08;5056;917;354849;170490;28.5;13.7
76;2021-05-09;2541;235;357390;170725;28.7;13.7
76;2021-05-10;4947;5069;362337;175794;29.1;14.1
76;2021-05-11;6519;5690;368856;181484;29.7;14.6
76;2021-05-12;6263;5085;375119;186569;30.2;15.0
76;2021-05-13;8842;1284;383961;187853;30.9;15.1
76;2021-05-14;10415;4664;394376;192517;31.7;15.5
76;2021-05-15;9122;2458;403498;194975;32.4;15.7
76;2021-05-16;6237;479;409735;195454;32.9;15.7
76;2021-05-17;7227;3278;416962;198732;33.5;16.0
76;2021-05-18;8304;2816;425266;201548;34.2;16.2
76;2021-05-19;8402;3200;433668;204748;34.9;16.5
76;2021-05-20;9650;3427;443318;208175;35.6;16.7
76;2021-05-21;8369;4097;451687;212272;36.3;17.1
76;2021-05-22;7163;2365;458850;214637;36.9;17.3
76;2021-05-23;6388;416;465238;215053;37.4;17.3
76;2021-05-24;6864;1529;472102;216582;38.0;17.4
76;2021-05-25;8024;4091;480126;220673;38.6;17.7
76;2021-05-26;7571;3611;487697;224284;39.2;18.0
76;2021-05-27;8340;4709;496037;228993;39.9;18.4
76;2021-05-28;8231;6572;504268;235565;40.5;18.9
76;2021-05-29;6225;3517;510493;239082;41.0;19.2
76;2021-05-30;3149;431;513642;239513;41.3;19.3
76;2021-05-31;8168;3973;521810;243486;42.0;19.6
76;2021-06-01;9209;5035;531019;248521;42.7;20.0
76;2021-06-02;7930;4447;538949;252968;43.3;20.3
76;2021-06-03;9540;5408;548489;258376;44.1;20.8
76;2021-06-04;9242;6699;557731;265075;44.8;21.3
76;2021-06-05;6285;3816;564016;268891;45.3;21.6
76;2021-06-06;2556;650;566572;269541;45.6;21.7
76;2021-06-07;6978;5455;573550;274996;46.1;22.1
76;2021-06-08;8661;6290;582211;281286;46.8;22.6
76;2021-06-09;7210;6083;589421;287369;47.4;23.1
76;2021-06-10;8000;6564;597421;293933;48.0;23.6
76;2021-06-11;7575;8240;604996;302173;48.6;24.3
76;2021-06-12;7166;5879;612162;308052;49.2;24.8
76;2021-06-13;2962;1295;615124;309347;49.5;24.9
76;2021-06-14;6487;6735;621611;316082;50.0;25.4
76;2021-06-15;6301;7479;627912;323561;50.5;26.0
76;2021-06-16;6651;7485;634563;331046;51.0;26.6
76;2021-06-17;7011;7760;641574;338806;51.6;27.2
76;2021-06-18;7687;9232;649261;348038;52.2;28.0
76;2021-06-19;5988;6260;655249;354298;52.7;28.5
76;2021-06-20;2809;1818;658058;356116;52.9;28.6
76;2021-06-21;5589;8176;663647;364292;53.4;29.3
76;2021-06-22;4923;9882;668570;374174;53.8;30.1
76;2021-06-23;4728;9435;673298;383609;54.1;30.8
76;2021-06-24;4796;9922;678094;393531;54.5;31.6
76;2021-06-25;5220;11584;683314;405115;54.9;32.6
76;2021-06-26;3454;7878;686768;412993;55.2;33.2
76;2021-06-27;1367;5162;688135;418155;55.3;33.6
76;2021-06-28;3612;9950;691747;428105;55.6;34.4
76;2021-06-29;3873;10227;695620;438332;55.9;35.2
76;2021-06-30;4267;9838;699887;448170;56.3;36.0
76;2021-07-01;4596;9909;704483;458079;56.6;36.8
76;2021-07-02;4368;12014;708851;470093;57.0;37.8
76;2021-07-03;3583;8450;712434;478543;57.3;38.5
76;2021-07-04;1487;5305;713921;483848;57.4;38.9
76;2021-07-05;3956;9332;717877;493180;57.7;39.7
76;2021-07-06;4056;10075;721933;503255;58.0;40.5
76;2021-07-07;4011;9327;725944;512582;58.4;41.2
76;2021-07-08;4466;9464;730410;522046;58.7;42.0
76;2021-07-09;4364;12413;734774;534459;59.1;43.0
76;2021-07-10;3138;8556;737912;543015;59.3;43.7
76;2021-07-11;1777;2821;739689;545836;59.5;43.9
76;2021-07-12;3155;11156;742844;556992;59.7;44.8
76;2021-07-13;4933;12264;747777;569256;60.1;45.8
76;2021-07-14;4803;5548;752580;574804;60.5;46.2
76;2021-07-15;5911;11790;758491;586594;61.0;47.2
76;2021-07-16;6719;12019;765210;598613;61.5;48.1
76;2021-07-17;5277;8709;770487;607322;61.9;48.8
76;2021-07-18;2257;3357;772744;610679;62.1;49.1
76;2021-07-19;5160;11155;777904;621834;62.5;50.0
76;2021-07-20;6275;11628;784179;633462;63.0;50.9
76;2021-07-21;6342;10571;790521;644033;63.6;51.8
76;2021-07-22;8240;9655;798761;653688;64.2;52.6
76;2021-07-23;7643;12004;806404;665692;64.8;53.5
76;2021-07-24;4992;7717;811396;673409;65.2;54.1
76;2021-07-25;2873;3138;814269;676547;65.5;54.4
76;2021-07-26;5432;10149;819701;686696;65.9;55.2
76;2021-07-27;8337;9557;828038;696253;66.6;56.0
76;2021-07-28;8268;7824;836306;704077;67.2;56.6
76;2021-07-29;9591;6991;845897;711068;68.0;57.2
76;2021-07-30;8011;7849;853908;718917;68.7;57.8
76;2021-07-31;6614;5333;860522;724250;69.2;58.2
76;2021-08-01;3863;2087;864385;726337;69.5;58.4
76;2021-08-02;6563;7101;870948;733438;70.0;59.0
76;2021-08-03;7973;6362;878921;739800;70.7;59.5
76;2021-08-04;7258;5847;886179;745647;71.2;59.9
76;2021-08-05;8100;5732;894279;751379;71.9;60.4
76;2021-08-06;6810;6877;901089;758256;72.4;61.0
76;2021-08-07;4792;4387;905881;762643;72.8;61.3
76;2021-08-08;2409;2158;908290;764801;73.0;61.5
76;2021-08-09;5638;6740;913928;771541;73.5;62.0
76;2021-08-10;6351;6557;920279;778098;74.0;62.6
76;2021-08-11;6452;5498;926731;783596;74.5;63.0
76;2021-08-12;6046;6063;932777;789659;75.0;63.5
76;2021-08-13;5059;6212;937836;795871;75.4;64.0
76;2021-08-14;3840;4599;941676;800470;75.7;64.4
76;2021-08-15;1579;2356;943255;802826;75.8;64.5
76;2021-08-16;3667;6719;946922;809545;76.1;65.1
76;2021-08-17;3919;6946;950841;816491;76.4;65.6
76;2021-08-18;3747;6738;954588;823229;76.7;66.2
76;2021-08-19;3390;7172;957978;830401;77.0;66.8
76;2021-08-20;3434;7831;961412;838232;77.3;67.4
76;2021-08-21;1825;4221;963237;842453;77.4;67.7
76;2021-08-22;871;3295;964108;845748;77.5;68.0
76;2021-08-23;2624;7761;966732;853509;77.7;68.6
76;2021-08-24;2824;7591;969556;861100;78.0;69.2
76;2021-08-25;2631;7079;972187;868179;78.2;69.8
76;2021-08-26;2074;5800;974261;873979;78.3;70.3
76;2021-08-27;2702;7952;976963;881931;78.5;70.9
76;2021-08-28;2137;6064;979100;887995;78.7;71.4
76;2021-08-29;698;3014;979798;891009;78.8;71.6
76;2021-08-30;2168;7348;981966;898357;78.9;72.2
76;2021-08-31;1945;7139;983911;905496;79.1;72.8
76;2021-09-01;1730;6410;985641;911906;79.2;73.3
76;2021-09-02;1307;4506;986948;916412;79.4;73.7
76;2021-09-03;1593;6604;988541;923016;79.5;74.2
76;2021-09-04;1618;5990;990159;929006;79.6;74.7
76;2021-09-05;636;1820;990795;930826;79.7;74.8
76;2021-09-06;1347;4372;992142;935198;79.8;75.2
76;2021-09-07;1169;3721;993311;938919;79.9;75.5
76;2021-09-08;1277;4459;994588;943378;80.0;75.8
76;2021-09-09;1095;2918;995683;946296;80.1;76.1
76;2021-09-10;1702;4032;997385;950328;80.2;76.4
76;2021-09-11;1167;3203;998552;953531;80.3;76.7
76;2021-09-12;286;828;998838;954359;80.3;76.7
76;2021-09-13;830;2191;999668;956550;80.4;76.9
76;2021-09-14;1379;2623;1001047;959173;80.5;77.1
76;2021-09-15;1175;3270;1002222;962443;80.6;77.4
76;2021-09-16;1274;1960;1003496;964403;80.7;77.5
76;2021-09-17;1412;2902;1004908;967305;80.8;77.8
76;2021-09-18;735;2512;1005643;969817;80.9;78.0
76;2021-09-19;197;777;1005840;970594;80.9;78.0
76;2021-09-20;846;1811;1006686;972405;80.9;78.2
76;2021-09-21;768;1598;1007454;974003;81.0;78.3
76;2021-09-22;677;2297;1008131;976300;81.1;78.5
76;2021-09-23;757;1172;1008888;977472;81.1;78.6
76;2021-09-24;1063;2043;1009951;979515;81.2;78.8
76;2021-09-25;574;2130;1010525;981645;81.2;78.9
76;2021-09-26;125;416;1010650;982061;81.3;79.0
76;2021-09-27;627;1347;1011277;983408;81.3;79.1
76;2021-09-28;504;1126;1011781;984534;81.3;79.2
76;2021-09-29;786;1589;1012567;986123;81.4;79.3
76;2021-09-30;425;884;1012992;987007;81.4;79.4
76;2021-10-01;858;1705;1013850;988712;81.5;79.5
76;2021-10-02;585;1313;1014435;990025;81.6;79.6
76;2021-10-03;129;386;1014564;990411;81.6;79.6
76;2021-10-04;599;1143;1015163;991554;81.6;79.7
76;2021-10-05;482;1021;1015645;992575;81.7;79.8
76;2021-10-06;460;899;1016105;993474;81.7;79.9
76;2021-10-07;386;842;1016491;994316;81.7;79.9
76;2021-10-08;906;1928;1017397;996244;81.8;80.1
76;2021-10-09;587;1003;1017984;997247;81.8;80.2
76;2021-10-10;71;77;1018055;997324;81.9;80.2
76;2021-10-11;487;1058;1018542;998382;81.9;80.3
76;2021-10-12;497;886;1019039;999268;81.9;80.3
76;2021-10-13;583;1042;1019622;1000310;82.0;80.4
76;2021-10-14;384;692;1020006;1001002;82.0;80.5
77;2020-12-27;1;0;1;0;0.0;0.0
77;2020-12-28;2;0;3;0;0.0;0.0
77;2020-12-29;0;0;3;0;0.0;0.0
77;2020-12-30;0;0;3;0;0.0;0.0
77;2020-12-31;0;0;3;0;0.0;0.0
77;2021-01-01;4;0;7;0;0.0;0.0
77;2021-01-02;2;2;9;2;0.0;0.0
77;2021-01-03;0;0;9;2;0.0;0.0
77;2021-01-04;7;0;16;2;0.0;0.0
77;2021-01-05;200;0;216;2;0.0;0.0
77;2021-01-06;237;2;453;4;0.0;0.0
77;2021-01-07;522;4;975;8;0.1;0.0
77;2021-01-08;621;1;1596;9;0.1;0.0
77;2021-01-09;273;1;1869;10;0.1;0.0
77;2021-01-10;235;2;2104;12;0.1;0.0
77;2021-01-11;782;4;2886;16;0.2;0.0
77;2021-01-12;884;1;3770;17;0.3;0.0
77;2021-01-13;941;3;4711;20;0.3;0.0
77;2021-01-14;849;7;5560;27;0.4;0.0
77;2021-01-15;859;11;6419;38;0.5;0.0
77;2021-01-16;168;1;6587;39;0.5;0.0
77;2021-01-17;132;2;6719;41;0.5;0.0
77;2021-01-18;1196;5;7915;46;0.6;0.0
77;2021-01-19;1722;24;9637;70;0.7;0.0
77;2021-01-20;2542;13;12179;83;0.9;0.0
77;2021-01-21;2062;30;14241;113;1.0;0.0
77;2021-01-22;1148;8;15389;121;1.1;0.0
77;2021-01-23;348;0;15737;121;1.1;0.0
77;2021-01-24;45;0;15782;121;1.1;0.0
77;2021-01-25;940;25;16722;146;1.2;0.0
77;2021-01-26;1715;27;18437;173;1.3;0.0
77;2021-01-27;1364;29;19801;202;1.4;0.0
77;2021-01-28;1698;94;21499;296;1.5;0.0
77;2021-01-29;1289;148;22788;444;1.6;0.0
77;2021-01-30;211;2;22999;446;1.6;0.0
77;2021-01-31;1;0;23000;446;1.6;0.0
77;2021-02-01;571;211;23571;657;1.7;0.0
77;2021-02-02;872;266;24443;923;1.7;0.1
77;2021-02-03;794;524;25237;1447;1.8;0.1
77;2021-02-04;789;808;26026;2255;1.8;0.2
77;2021-02-05;858;849;26884;3104;1.9;0.2
77;2021-02-06;165;101;27049;3205;1.9;0.2
77;2021-02-07;17;93;27066;3298;1.9;0.2
77;2021-02-08;498;938;27564;4236;1.9;0.3
77;2021-02-09;590;1465;28154;5701;2.0;0.4
77;2021-02-10;1030;1838;29184;7539;2.1;0.5
77;2021-02-11;1059;1655;30243;9194;2.1;0.6
77;2021-02-12;1098;1173;31341;10367;2.2;0.7
77;2021-02-13;189;176;31530;10543;2.2;0.7
77;2021-02-14;12;56;31542;10599;2.2;0.7
77;2021-02-15;555;1023;32097;11622;2.3;0.8
77;2021-02-16;598;1532;32695;13154;2.3;0.9
77;2021-02-17;515;1186;33210;14340;2.3;1.0
77;2021-02-18;839;1615;34049;15955;2.4;1.1
77;2021-02-19;778;1102;34827;17057;2.4;1.2
77;2021-02-20;55;176;34882;17233;2.5;1.2
77;2021-02-21;7;31;34889;17264;2.5;1.2
77;2021-02-22;303;770;35192;18034;2.5;1.3
77;2021-02-23;360;1126;35552;19160;2.5;1.3
77;2021-02-24;512;896;36064;20056;2.5;1.4
77;2021-02-25;793;964;36857;21020;2.6;1.5
77;2021-02-26;840;838;37697;21858;2.6;1.5
77;2021-02-27;459;170;38156;22028;2.7;1.5
77;2021-02-28;33;5;38189;22033;2.7;1.5
77;2021-03-01;680;715;38869;22748;2.7;1.6
77;2021-03-02;1091;1025;39960;23773;2.8;1.7
77;2021-03-03;1958;1193;41918;24966;2.9;1.8
77;2021-03-04;2794;1147;44712;26113;3.1;1.8
77;2021-03-05;3374;1059;48086;27172;3.4;1.9
77;2021-03-06;4827;276;52913;27448;3.7;1.9
77;2021-03-07;3198;118;56111;27566;3.9;1.9
77;2021-03-08;1230;507;57341;28073;4.0;2.0
77;2021-03-09;2508;642;59849;28715;4.2;2.0
77;2021-03-10;2397;584;62246;29299;4.4;2.1
77;2021-03-11;3503;795;65749;30094;4.6;2.1
77;2021-03-12;3891;697;69640;30791;4.9;2.2
77;2021-03-13;4478;213;74118;31004;5.2;2.2
77;2021-03-14;2154;125;76272;31129;5.4;2.2
77;2021-03-15;2511;281;78783;31410;5.5;2.2
77;2021-03-16;2444;381;81227;31791;5.7;2.2
77;2021-03-17;2555;438;83782;32229;5.9;2.3
77;2021-03-18;3010;404;86792;32633;6.1;2.3
77;2021-03-19;3357;440;90149;33073;6.3;2.3
77;2021-03-20;1967;79;92116;33152;6.5;2.3
77;2021-03-21;244;14;92360;33166;6.5;2.3
77;2021-03-22;3019;408;95379;33574;6.7;2.4
77;2021-03-23;4520;537;99899;34111;7.0;2.4
77;2021-03-24;4155;622;104054;34733;7.3;2.4
77;2021-03-25;5907;414;109961;35147;7.7;2.5
77;2021-03-26;6267;455;116228;35602;8.2;2.5
77;2021-03-27;3323;127;119551;35729;8.4;2.5
77;2021-03-28;1730;50;121281;35779;8.5;2.5
77;2021-03-29;2654;691;123935;36470;8.7;2.6
77;2021-03-30;3996;1194;127931;37664;9.0;2.6
77;2021-03-31;3758;1231;131689;38895;9.3;2.7
77;2021-04-01;4141;1830;135830;40725;9.5;2.9
77;2021-04-02;3992;2022;139822;42747;9.8;3.0
77;2021-04-03;1743;2282;141565;45029;9.9;3.2
77;2021-04-04;420;1427;141985;46456;10.0;3.3
77;2021-04-05;161;163;142146;46619;10.0;3.3
77;2021-04-06;2723;1931;144869;48550;10.2;3.4
77;2021-04-07;3320;2091;148189;50641;10.4;3.6
77;2021-04-08;4531;2372;152720;53013;10.7;3.7
77;2021-04-09;4854;2096;157574;55109;11.1;3.9
77;2021-04-10;3075;2757;160649;57866;11.3;4.1
77;2021-04-11;586;720;161235;58586;11.3;4.1
77;2021-04-12;2230;1828;163465;60414;11.5;4.2
77;2021-04-13;3359;2646;166824;63060;11.7;4.4
77;2021-04-14;2518;2657;169342;65717;11.9;4.6
77;2021-04-15;3319;3123;172661;68840;12.1;4.8
77;2021-04-16;3575;2727;176236;71567;12.4;5.0
77;2021-04-17;1386;479;177622;72046;12.5;5.1
77;2021-04-18;150;11;177772;72057;12.5;5.1
77;2021-04-19;2083;2514;179855;74571;12.6;5.2
77;2021-04-20;2572;3384;182427;77955;12.8;5.5
77;2021-04-21;2195;3480;184622;81435;13.0;5.7
77;2021-04-22;3002;3864;187624;85299;13.2;6.0
77;2021-04-23;3531;3640;191155;88939;13.4;6.2
77;2021-04-24;4899;2519;196054;91458;13.8;6.4
77;2021-04-25;4079;1248;200133;92706;14.1;6.5
77;2021-04-26;3224;2045;203357;94751;14.3;6.7
77;2021-04-27;3996;2520;207353;97271;14.6;6.8
77;2021-04-28;4067;2621;211420;99892;14.9;7.0
77;2021-04-29;4480;3085;215900;102977;15.2;7.2
77;2021-04-30;4911;3346;220811;106323;15.5;7.5
77;2021-05-01;2466;600;223277;106923;15.7;7.5
77;2021-05-02;3141;278;226418;107201;15.9;7.5
77;2021-05-03;5991;2082;232409;109283;16.3;7.7
77;2021-05-04;6437;2995;238846;112278;16.8;7.9
77;2021-05-05;6018;3028;244864;115306;17.2;8.1
77;2021-05-06;6886;3599;251750;118905;17.7;8.4
77;2021-05-07;8204;3273;259954;122178;18.3;8.6
77;2021-05-08;5718;816;265672;122994;18.7;8.6
77;2021-05-09;4904;484;270576;123478;19.0;8.7
77;2021-05-10;8087;2330;278663;125808;19.6;8.8
77;2021-05-11;9576;2921;288239;128729;20.2;9.0
77;2021-05-12;8977;2284;297216;131013;20.9;9.2
77;2021-05-13;9302;885;306518;131898;21.5;9.3
77;2021-05-14;10437;1673;316955;133571;22.3;9.4
77;2021-05-15;8991;1248;325946;134819;22.9;9.5
77;2021-05-16;5152;470;331098;135289;23.3;9.5
77;2021-05-17;10371;1481;341469;136770;24.0;9.6
77;2021-05-18;11786;1806;353255;138576;24.8;9.7
77;2021-05-19;10918;1606;364173;140182;25.6;9.8
77;2021-05-20;12215;2157;376388;142339;26.4;10.0
77;2021-05-21;11652;2696;388040;145035;27.3;10.2
77;2021-05-22;9817;1741;397857;146776;27.9;10.3
77;2021-05-23;6978;818;404835;147594;28.4;10.4
77;2021-05-24;6762;779;411597;148373;28.9;10.4
77;2021-05-25;8315;2817;419912;151190;29.5;10.6
77;2021-05-26;7561;2980;427473;154170;30.0;10.8
77;2021-05-27;7552;3968;435025;158138;30.6;11.1
77;2021-05-28;7634;4010;442659;162148;31.1;11.4
77;2021-05-29;7353;2332;450012;164480;31.6;11.6
77;2021-05-30;4356;891;454368;165371;31.9;11.6
77;2021-05-31;8382;3836;462750;169207;32.5;11.9
77;2021-06-01;9644;4383;472394;173590;33.2;12.2
77;2021-06-02;9006;3931;481400;177521;33.8;12.5
77;2021-06-03;9001;5282;490401;182803;34.4;12.8
77;2021-06-04;9115;5496;499516;188299;35.1;13.2
77;2021-06-05;6660;4992;506176;193291;35.6;13.6
77;2021-06-06;4909;3210;511085;196501;35.9;13.8
77;2021-06-07;6421;4540;517506;201041;36.4;14.1
77;2021-06-08;5726;5228;523232;206269;36.8;14.5
77;2021-06-09;5059;4964;528291;211233;37.1;14.8
77;2021-06-10;5014;5459;533305;216692;37.5;15.2
77;2021-06-11;5752;6028;539057;222720;37.9;15.6
77;2021-06-12;6544;4752;545601;227472;38.3;16.0
77;2021-06-13;3507;3053;549108;230525;38.6;16.2
77;2021-06-14;3220;7933;552328;238458;38.8;16.8
77;2021-06-15;4127;8484;556455;246942;39.1;17.3
77;2021-06-16;4803;8378;561258;255320;39.4;17.9
77;2021-06-17;4467;9029;565725;264349;39.7;18.6
77;2021-06-18;4364;9788;570089;274137;40.0;19.3
77;2021-06-19;5306;6931;575395;281068;40.4;19.7
77;2021-06-20;2096;3801;577491;284869;40.6;20.0
77;2021-06-21;3228;9577;580719;294446;40.8;20.7
77;2021-06-22;3665;11377;584384;305823;41.0;21.5
77;2021-06-23;3443;10053;587827;315876;41.3;22.2
77;2021-06-24;3359;10923;591186;326799;41.5;23.0
77;2021-06-25;3623;10800;594809;337599;41.8;23.7
77;2021-06-26;4085;10070;598894;347669;42.1;24.4
77;2021-06-27;2124;6430;601018;354099;42.2;24.9
77;2021-06-28;2797;10831;603815;364930;42.4;25.6
77;2021-06-29;3415;12532;607230;377462;42.7;26.5
77;2021-06-30;3291;11452;610521;388914;42.9;27.3
77;2021-07-01;3296;11657;613817;400571;43.1;28.1
77;2021-07-02;3464;12256;617281;412827;43.4;29.0
77;2021-07-03;3182;10803;620463;423630;43.6;29.8
77;2021-07-04;1996;6491;622459;430121;43.7;30.2
77;2021-07-05;3584;9541;626043;439662;44.0;30.9
77;2021-07-06;3737;9531;629780;449193;44.2;31.6
77;2021-07-07;4051;8952;633831;458145;44.5;32.2
77;2021-07-08;3934;8760;637765;466905;44.8;32.8
77;2021-07-09;4712;10343;642477;477248;45.1;33.5
77;2021-07-10;4043;9842;646520;487090;45.4;34.2
77;2021-07-11;3090;5093;649610;492183;45.6;34.6
77;2021-07-12;3285;10870;652895;503053;45.9;35.3
77;2021-07-13;6163;12042;659058;515095;46.3;36.2
77;2021-07-14;3602;6448;662660;521543;46.5;36.6
77;2021-07-15;7189;11980;669849;533523;47.1;37.5
77;2021-07-16;7824;9893;677673;543416;47.6;38.2
77;2021-07-17;5792;9466;683465;552882;48.0;38.8
77;2021-07-18;4139;5331;687604;558213;48.3;39.2
77;2021-07-19;7517;8955;695121;567168;48.8;39.8
77;2021-07-20;9671;8047;704792;575215;49.5;40.4
77;2021-07-21;9523;7483;714315;582698;50.2;40.9
77;2021-07-22;10561;7561;724876;590259;50.9;41.5
77;2021-07-23;9877;8207;734753;598466;51.6;42.0
77;2021-07-24;7215;7879;741968;606345;52.1;42.6
77;2021-07-25;5897;4038;747865;610383;52.5;42.9
77;2021-07-26;9209;5972;757074;616355;53.2;43.3
77;2021-07-27;10952;6047;768026;622402;53.9;43.7
77;2021-07-28;9491;6429;777517;628831;54.6;44.2
77;2021-07-29;9538;5520;787055;634351;55.3;44.6
77;2021-07-30;9745;6370;796800;640721;56.0;45.0
77;2021-07-31;7265;6634;804065;647355;56.5;45.5
77;2021-08-01;2954;1216;807019;648571;56.7;45.6
77;2021-08-02;7134;5733;814153;654304;57.2;46.0
77;2021-08-03;5856;4528;820009;658832;57.6;46.3
77;2021-08-04;4741;4389;824750;663221;57.9;46.6
77;2021-08-05;3259;2973;828009;666194;58.2;46.8
77;2021-08-06;5979;5265;833988;671459;58.6;47.2
77;2021-08-07;5296;6797;839284;678256;59.0;47.6
77;2021-08-08;1977;1863;841261;680119;59.1;47.8
77;2021-08-09;5092;6584;846353;686703;59.5;48.2
77;2021-08-10;2713;3581;849066;690284;59.6;48.5
77;2021-08-11;3144;6242;852210;696526;59.9;48.9
77;2021-08-12;2281;3577;854491;700103;60.0;49.2
77;2021-08-13;2736;4896;857227;704999;60.2;49.5
77;2021-08-14;2960;7333;860187;712332;60.4;50.0
77;2021-08-15;789;773;860976;713105;60.5;50.1
77;2021-08-16;2478;6985;863454;720090;60.7;50.6
77;2021-08-17;2896;7215;866350;727305;60.9;51.1
77;2021-08-18;2686;6565;869036;733870;61.0;51.6
77;2021-08-19;2653;5105;871689;738975;61.2;51.9
77;2021-08-20;2711;5687;874400;744662;61.4;52.3
77;2021-08-21;2717;7339;877117;752001;61.6;52.8
77;2021-08-22;1735;5344;878852;757345;61.7;53.2
77;2021-08-23;2516;9622;881368;766967;61.9;53.9
77;2021-08-24;3069;9244;884437;776211;62.1;54.5
77;2021-08-25;2565;6541;887002;782752;62.3;55.0
77;2021-08-26;2559;6257;889561;789009;62.5;55.4
77;2021-08-27;2782;6996;892343;796005;62.7;55.9
77;2021-08-28;1975;7253;894318;803258;62.8;56.4
77;2021-08-29;1484;5152;895802;808410;62.9;56.8
77;2021-08-30;2525;8049;898327;816459;63.1;57.4
77;2021-08-31;2851;5601;901178;822060;63.3;57.7
77;2021-09-01;2302;3521;903480;825581;63.5;58.0
77;2021-09-02;1612;2820;905092;828401;63.6;58.2
77;2021-09-03;2137;4138;907229;832539;63.7;58.5
77;2021-09-04;2421;5583;909650;838122;63.9;58.9
77;2021-09-05;902;1371;910552;839493;64.0;59.0
77;2021-09-06;1067;1890;911619;841383;64.0;59.1
77;2021-09-07;845;2024;912464;843407;64.1;59.2
77;2021-09-08;1714;3071;914178;846478;64.2;59.5
77;2021-09-09;985;1842;915163;848320;64.3;59.6
77;2021-09-10;1195;2203;916358;850523;64.4;59.7
77;2021-09-11;2048;5403;918406;855926;64.5;60.1
77;2021-09-12;523;1353;918929;857279;64.5;60.2
77;2021-09-13;882;1723;919811;859002;64.6;60.3
77;2021-09-14;1027;1630;920838;860632;64.7;60.5
77;2021-09-15;1182;2531;922020;863163;64.8;60.6
77;2021-09-16;960;1498;922980;864661;64.8;60.7
77;2021-09-17;1157;2023;924137;866684;64.9;60.9
77;2021-09-18;1304;3581;925441;870265;65.0;61.1
77;2021-09-19;233;1182;925674;871447;65.0;61.2
77;2021-09-20;837;1627;926511;873074;65.1;61.3
77;2021-09-21;797;1504;927308;874578;65.1;61.4
77;2021-09-22;756;2486;928064;877064;65.2;61.6
77;2021-09-23;569;1510;928633;878574;65.2;61.7
77;2021-09-24;833;1950;929466;880524;65.3;61.9
77;2021-09-25;1002;3958;930468;884482;65.4;62.1
77;2021-09-26;205;759;930673;885241;65.4;62.2
77;2021-09-27;648;1312;931321;886553;65.4;62.3
77;2021-09-28;773;846;932094;887399;65.5;62.3
77;2021-09-29;939;1977;933033;889376;65.5;62.5
77;2021-09-30;587;938;933620;890314;65.6;62.5
77;2021-10-01;625;1025;934245;891339;65.6;62.6
77;2021-10-02;948;2105;935193;893444;65.7;62.8
77;2021-10-03;129;470;935322;893914;65.7;62.8
77;2021-10-04;412;720;935734;894634;65.7;62.8
77;2021-10-05;333;732;936067;895366;65.8;62.9
77;2021-10-06;536;1284;936603;896650;65.8;63.0
77;2021-10-07;390;724;936993;897374;65.8;63.0
77;2021-10-08;636;1219;937629;898593;65.9;63.1
77;2021-10-09;845;1986;938474;900579;65.9;63.3
77;2021-10-10;33;55;938507;900634;65.9;63.3
77;2021-10-11;566;856;939073;901490;66.0;63.3
77;2021-10-12;492;881;939565;902371;66.0;63.4
77;2021-10-13;747;970;940312;903341;66.1;63.5
77;2021-10-14;393;599;940705;903940;66.1;63.5
78;2020-12-27;2;0;2;0;0.0;0.0
78;2020-12-28;1;1;3;1;0.0;0.0
78;2020-12-29;0;0;3;1;0.0;0.0
78;2020-12-30;1;0;4;1;0.0;0.0
78;2020-12-31;15;0;19;1;0.0;0.0
78;2021-01-01;1;0;20;1;0.0;0.0
78;2021-01-02;1;0;21;1;0.0;0.0
78;2021-01-03;3;1;24;2;0.0;0.0
78;2021-01-04;145;3;169;5;0.0;0.0
78;2021-01-05;175;1;344;6;0.0;0.0
78;2021-01-06;208;4;552;10;0.0;0.0
78;2021-01-07;469;2;1021;12;0.1;0.0
78;2021-01-08;651;5;1672;17;0.1;0.0
78;2021-01-09;22;0;1694;17;0.1;0.0
78;2021-01-10;2;0;1696;17;0.1;0.0
78;2021-01-11;791;4;2487;21;0.2;0.0
78;2021-01-12;945;5;3432;26;0.2;0.0
78;2021-01-13;741;10;4173;36;0.3;0.0
78;2021-01-14;812;10;4985;46;0.3;0.0
78;2021-01-15;849;11;5834;57;0.4;0.0
78;2021-01-16;32;1;5866;58;0.4;0.0
78;2021-01-17;0;0;5866;58;0.4;0.0
78;2021-01-18;1384;21;7250;79;0.5;0.0
78;2021-01-19;1841;27;9091;106;0.6;0.0
78;2021-01-20;1651;19;10742;125;0.7;0.0
78;2021-01-21;3258;18;14000;143;1.0;0.0
78;2021-01-22;2216;20;16216;163;1.1;0.0
78;2021-01-23;280;0;16496;163;1.1;0.0
78;2021-01-24;5;0;16501;163;1.1;0.0
78;2021-01-25;957;31;17458;194;1.2;0.0
78;2021-01-26;1560;22;19018;216;1.3;0.0
78;2021-01-27;2063;52;21081;268;1.5;0.0
78;2021-01-28;2439;113;23520;381;1.6;0.0
78;2021-01-29;1492;64;25012;445;1.7;0.0
78;2021-01-30;210;2;25222;447;1.7;0.0
78;2021-01-31;3;0;25225;447;1.7;0.0
78;2021-02-01;788;224;26013;671;1.8;0.0
78;2021-02-02;967;346;26980;1017;1.9;0.1
78;2021-02-03;977;240;27957;1257;1.9;0.1
78;2021-02-04;1117;446;29074;1703;2.0;0.1
78;2021-02-05;1191;504;30265;2207;2.1;0.2
78;2021-02-06;200;46;30465;2253;2.1;0.2
78;2021-02-07;139;14;30604;2267;2.1;0.2
78;2021-02-08;763;606;31367;2873;2.2;0.2
78;2021-02-09;1121;945;32488;3818;2.2;0.3
78;2021-02-10;1245;1179;33733;4997;2.3;0.3
78;2021-02-11;1820;1894;35553;6891;2.5;0.5
78;2021-02-12;1820;1387;37373;8278;2.6;0.6
78;2021-02-13;173;76;37546;8354;2.6;0.6
78;2021-02-14;27;26;37573;8380;2.6;0.6
78;2021-02-15;448;1432;38021;9812;2.6;0.7
78;2021-02-16;628;1562;38649;11374;2.7;0.8
78;2021-02-17;588;2221;39237;13595;2.7;0.9
78;2021-02-18;997;2278;40234;15873;2.8;1.1
78;2021-02-19;821;1722;41055;17595;2.8;1.2
78;2021-02-20;150;125;41205;17720;2.8;1.2
78;2021-02-21;0;12;41205;17732;2.8;1.2
78;2021-02-22;502;1060;41707;18792;2.9;1.3
78;2021-02-23;540;1126;42247;19918;2.9;1.4
78;2021-02-24;620;1246;42867;21164;3.0;1.5
78;2021-02-25;867;1154;43734;22318;3.0;1.5
78;2021-02-26;1131;1241;44865;23559;3.1;1.6
78;2021-02-27;740;151;45605;23710;3.1;1.6
78;2021-02-28;68;18;45673;23728;3.2;1.6
78;2021-03-01;966;908;46639;24636;3.2;1.7
78;2021-03-02;1727;1059;48366;25695;3.3;1.8
78;2021-03-03;1967;1243;50333;26938;3.5;1.9
78;2021-03-04;2952;1604;53285;28542;3.7;2.0
78;2021-03-05;3259;1674;56544;30216;3.9;2.1
78;2021-03-06;6244;326;62788;30542;4.3;2.1
78;2021-03-07;3444;108;66232;30650;4.6;2.1
78;2021-03-08;1462;764;67694;31414;4.7;2.2
78;2021-03-09;2944;917;70638;32331;4.9;2.2
78;2021-03-10;3081;1128;73719;33459;5.1;2.3
78;2021-03-11;4179;1321;77898;34780;5.4;2.4
78;2021-03-12;5373;1368;83271;36148;5.7;2.5
78;2021-03-13;4657;210;87928;36358;6.1;2.5
78;2021-03-14;1038;42;88966;36400;6.1;2.5
78;2021-03-15;3622;272;92588;36672;6.4;2.5
78;2021-03-16;2570;579;95158;37251;6.6;2.6
78;2021-03-17;2970;449;98128;37700;6.8;2.6
78;2021-03-18;3780;460;101908;38160;7.0;2.6
78;2021-03-19;5317;502;107225;38662;7.4;2.7
78;2021-03-20;2260;134;109485;38796;7.6;2.7
78;2021-03-21;167;7;109652;38803;7.6;2.7
78;2021-03-22;3530;384;113182;39187;7.8;2.7
78;2021-03-23;5231;554;118413;39741;8.2;2.7
78;2021-03-24;4891;562;123304;40303;8.5;2.8
78;2021-03-25;6940;581;130244;40884;9.0;2.8
78;2021-03-26;6944;730;137188;41614;9.5;2.9
78;2021-03-27;3746;204;140934;41818;9.7;2.9
78;2021-03-28;1919;56;142853;41874;9.9;2.9
78;2021-03-29;3863;768;146716;42642;10.1;2.9
78;2021-03-30;5526;1063;152242;43705;10.5;3.0
78;2021-03-31;5334;1307;157576;45012;10.9;3.1
78;2021-04-01;5590;2377;163166;47389;11.3;3.3
78;2021-04-02;5194;2637;168360;50026;11.6;3.5
78;2021-04-03;2197;2568;170557;52594;11.8;3.6
78;2021-04-04;174;14;170731;52608;11.8;3.6
78;2021-04-05;199;20;170930;52628;11.8;3.6
78;2021-04-06;3617;2311;174547;54939;12.0;3.8
78;2021-04-07;4357;2594;178904;57533;12.3;4.0
78;2021-04-08;5523;2679;184427;60212;12.7;4.2
78;2021-04-09;6907;2463;191334;62675;13.2;4.3
78;2021-04-10;3995;1911;195329;64586;13.5;4.5
78;2021-04-11;374;607;195703;65193;13.5;4.5
78;2021-04-12;3530;2369;199233;67562;13.8;4.7
78;2021-04-13;5460;2515;204693;70077;14.1;4.8
78;2021-04-14;4957;3404;209650;73481;14.5;5.1
78;2021-04-15;4616;3859;214266;77340;14.8;5.3
78;2021-04-16;5626;4035;219892;81375;15.2;5.6
78;2021-04-17;3610;720;223502;82095;15.4;5.7
78;2021-04-18;272;42;223774;82137;15.4;5.7
78;2021-04-19;3246;2817;227020;84954;15.7;5.9
78;2021-04-20;4709;3690;231729;88644;16.0;6.1
78;2021-04-21;4535;3512;236264;92156;16.3;6.4
78;2021-04-22;4567;4701;240831;96857;16.6;6.7
78;2021-04-23;5060;4436;245891;101293;17.0;7.0
78;2021-04-24;4865;2631;250756;103924;17.3;7.2
78;2021-04-25;3049;1732;253805;105656;17.5;7.3
78;2021-04-26;4768;3326;258573;108982;17.8;7.5
78;2021-04-27;5475;4320;264048;113302;18.2;7.8
78;2021-04-28;5650;4797;269698;118099;18.6;8.2
78;2021-04-29;6263;4086;275961;122185;19.0;8.4
78;2021-04-30;7207;4466;283168;126651;19.5;8.7
78;2021-05-01;612;255;283780;126906;19.6;8.8
78;2021-05-02;2009;166;285789;127072;19.7;8.8
78;2021-05-03;7465;1289;293254;128361;20.2;8.9
78;2021-05-04;6077;3985;299331;132346;20.7;9.1
78;2021-05-05;7296;4565;306627;136911;21.2;9.5
78;2021-05-06;6480;5179;313107;142090;21.6;9.8
78;2021-05-07;8309;5144;321416;147234;22.2;10.2
78;2021-05-08;2916;1454;324332;148688;22.4;10.3
78;2021-05-09;2820;356;327152;149044;22.6;10.3
78;2021-05-10;7345;4459;334497;153503;23.1;10.6
78;2021-05-11;8143;5423;342640;158926;23.7;11.0
78;2021-05-12;8729;3918;351369;162844;24.3;11.2
78;2021-05-13;6628;603;357997;163447;24.7;11.3
78;2021-05-14;10216;2217;368213;165664;25.4;11.4
78;2021-05-15;4934;2362;373147;168026;25.8;11.6
78;2021-05-16;3697;792;376844;168818;26.0;11.7
78;2021-05-17;8741;1348;385585;170166;26.6;11.7
78;2021-05-18;9885;1894;395470;172060;27.3;11.9
78;2021-05-19;11652;1712;407122;173772;28.1;12.0
78;2021-05-20;11596;2265;418718;176037;28.9;12.2
78;2021-05-21;12121;2630;430839;178667;29.7;12.3
78;2021-05-22;6538;1364;437377;180031;30.2;12.4
78;2021-05-23;3125;390;440502;180421;30.4;12.5
78;2021-05-24;3521;417;444023;180838;30.7;12.5
78;2021-05-25;9984;2509;454007;183347;31.3;12.7
78;2021-05-26;10159;3781;464166;187128;32.0;12.9
78;2021-05-27;10948;4645;475114;191773;32.8;13.2
78;2021-05-28;11405;6030;486519;197803;33.6;13.7
78;2021-05-29;4227;3385;490746;201188;33.9;13.9
78;2021-05-30;135;348;490881;201536;33.9;13.9
78;2021-05-31;7966;5360;498847;206896;34.4;14.3
78;2021-06-01;10023;6525;508870;213421;35.1;14.7
78;2021-06-02;8582;6204;517452;219625;35.7;15.2
78;2021-06-03;9892;6478;527344;226103;36.4;15.6
78;2021-06-04;9794;8145;537138;234248;37.1;16.2
78;2021-06-05;5519;6133;542657;240381;37.5;16.6
78;2021-06-06;2150;2010;544807;242391;37.6;16.7
78;2021-06-07;8113;6519;552920;248910;38.2;17.2
78;2021-06-08;8064;7322;560984;256232;38.7;17.7
78;2021-06-09;7325;6733;568309;262965;39.2;18.2
78;2021-06-10;7105;7106;575414;270071;39.7;18.6
78;2021-06-11;7584;8186;582998;278257;40.2;19.2
78;2021-06-12;6372;2922;589370;281179;40.7;19.4
78;2021-06-13;946;2458;590316;283637;40.8;19.6
78;2021-06-14;3415;9808;593731;293445;41.0;20.3
78;2021-06-15;5794;8287;599525;301732;41.4;20.8
78;2021-06-16;5430;8624;604955;310356;41.8;21.4
78;2021-06-17;5482;8537;610437;318893;42.1;22.0
78;2021-06-18;6103;9801;616540;328694;42.6;22.7
78;2021-06-19;5219;4820;621759;333514;42.9;23.0
78;2021-06-20;625;2838;622384;336352;43.0;23.2
78;2021-06-21;4092;9470;626476;345822;43.2;23.9
78;2021-06-22;3349;10317;629825;356139;43.5;24.6
78;2021-06-23;3839;10394;633664;366533;43.7;25.3
78;2021-06-24;3795;9978;637459;376511;44.0;26.0
78;2021-06-25;3995;13149;641454;389660;44.3;26.9
78;2021-06-26;4209;7951;645663;397611;44.6;27.4
78;2021-06-27;1041;2540;646704;400151;44.6;27.6
78;2021-06-28;3289;10900;649993;411051;44.9;28.4
78;2021-06-29;3535;11246;653528;422297;45.1;29.2
78;2021-06-30;4110;13225;657638;435522;45.4;30.1
78;2021-07-01;4107;12702;661745;448224;45.7;30.9
78;2021-07-02;4260;13938;666005;462162;46.0;31.9
78;2021-07-03;3159;8621;669164;470783;46.2;32.5
78;2021-07-04;778;1742;669942;472525;46.2;32.6
78;2021-07-05;3384;9694;673326;482219;46.5;33.3
78;2021-07-06;3525;12044;676851;494263;46.7;34.1
78;2021-07-07;3824;11606;680675;505869;47.0;34.9
78;2021-07-08;3927;11678;684602;517547;47.3;35.7
78;2021-07-09;4759;12743;689361;530290;47.6;36.6
78;2021-07-10;2626;6613;691987;536903;47.8;37.1
78;2021-07-11;748;2047;692735;538950;47.8;37.2
78;2021-07-12;3038;11745;695773;550695;48.0;38.0
78;2021-07-13;5351;11974;701124;562669;48.4;38.8
78;2021-07-14;2533;4989;703657;567658;48.6;39.2
78;2021-07-15;5662;11954;709319;579612;49.0;40.0
78;2021-07-16;7320;10787;716639;590399;49.5;40.8
78;2021-07-17;4725;4898;721364;595297;49.8;41.1
78;2021-07-18;1158;471;722522;595768;49.9;41.1
78;2021-07-19;3879;10350;726401;606118;50.1;41.8
78;2021-07-20;5616;9926;732017;616044;50.5;42.5
78;2021-07-21;5905;9860;737922;625904;50.9;43.2
78;2021-07-22;5972;9296;743894;635200;51.4;43.8
78;2021-07-23;6258;9230;750152;644430;51.8;44.5
78;2021-07-24;2937;4973;753089;649403;52.0;44.8
78;2021-07-25;987;376;754076;649779;52.1;44.9
78;2021-07-26;4869;6987;758945;656766;52.4;45.3
78;2021-07-27;7600;6915;766545;663681;52.9;45.8
78;2021-07-28;6976;5933;773521;669614;53.4;46.2
78;2021-07-29;7902;6010;781423;675624;53.9;46.6
78;2021-07-30;7740;7052;789163;682676;54.5;47.1
78;2021-07-31;2653;2734;791816;685410;54.7;47.3
78;2021-08-01;109;72;791925;685482;54.7;47.3
78;2021-08-02;2446;2131;794371;687613;54.8;47.5
78;2021-08-03;4304;4255;798675;691868;55.1;47.8
78;2021-08-04;4467;2809;803142;694677;55.4;48.0
78;2021-08-05;3887;3174;807029;697851;55.7;48.2
78;2021-08-06;3979;3719;811008;701570;56.0;48.4
78;2021-08-07;2819;3442;813827;705012;56.2;48.7
78;2021-08-08;483;343;814310;705355;56.2;48.7
78;2021-08-09;1880;1662;816190;707017;56.3;48.8
78;2021-08-10;3420;3983;819610;711000;56.6;49.1
78;2021-08-11;3051;3383;822661;714383;56.8;49.3
78;2021-08-12;2794;3535;825455;717918;57.0;49.6
78;2021-08-13;2867;3187;828322;721105;57.2;49.8
78;2021-08-14;2301;2981;830623;724086;57.3;50.0
78;2021-08-15;315;373;830938;724459;57.4;50.0
78;2021-08-16;942;2342;831880;726801;57.4;50.2
78;2021-08-17;2795;4422;834675;731223;57.6;50.5
78;2021-08-18;2476;3820;837151;735043;57.8;50.7
78;2021-08-19;2241;3584;839392;738627;57.9;51.0
78;2021-08-20;2101;4000;841493;742627;58.1;51.3
78;2021-08-21;1885;3587;843378;746214;58.2;51.5
78;2021-08-22;87;147;843465;746361;58.2;51.5
78;2021-08-23;2162;4248;845627;750609;58.4;51.8
78;2021-08-24;3630;6973;849257;757582;58.6;52.3
78;2021-08-25;3297;6593;852554;764175;58.9;52.8
78;2021-08-26;2981;7237;855535;771412;59.1;53.3
78;2021-08-27;2866;7372;858401;778784;59.3;53.8
78;2021-08-28;2443;5278;860844;784062;59.4;54.1
78;2021-08-29;369;351;861213;784413;59.5;54.1
78;2021-08-30;2860;4976;864073;789389;59.6;54.5
78;2021-08-31;3451;5676;867524;795065;59.9;54.9
78;2021-09-01;2829;4931;870353;799996;60.1;55.2
78;2021-09-02;2103;4010;872456;804006;60.2;55.5
78;2021-09-03;2260;4279;874716;808285;60.4;55.8
78;2021-09-04;2488;3951;877204;812236;60.6;56.1
78;2021-09-05;292;375;877496;812611;60.6;56.1
78;2021-09-06;1318;2498;878814;815109;60.7;56.3
78;2021-09-07;1363;2943;880177;818052;60.8;56.5
78;2021-09-08;1686;3308;881863;821360;60.9;56.7
78;2021-09-09;1094;2750;882957;824110;61.0;56.9
78;2021-09-10;1389;3014;884346;827124;61.0;57.1
78;2021-09-11;2054;3747;886400;830871;61.2;57.4
78;2021-09-12;73;139;886473;831010;61.2;57.4
78;2021-09-13;788;2020;887261;833030;61.2;57.5
78;2021-09-14;1072;2819;888333;835849;61.3;57.7
78;2021-09-15;1226;3532;889559;839381;61.4;57.9
78;2021-09-16;853;2090;890412;841471;61.5;58.1
78;2021-09-17;1186;2839;891598;844310;61.5;58.3
78;2021-09-18;1394;4073;892992;848383;61.6;58.6
78;2021-09-19;147;411;893139;848794;61.7;58.6
78;2021-09-20;671;1711;893810;850505;61.7;58.7
78;2021-09-21;826;1979;894636;852484;61.8;58.8
78;2021-09-22;958;3518;895594;856002;61.8;59.1
78;2021-09-23;886;1641;896480;857643;61.9;59.2
78;2021-09-24;1010;2386;897490;860029;62.0;59.4
78;2021-09-25;1055;3919;898545;863948;62.0;59.6
78;2021-09-26;59;155;898604;864103;62.0;59.6
78;2021-09-27;684;1507;899288;865610;62.1;59.8
78;2021-09-28;831;1498;900119;867108;62.1;59.9
78;2021-09-29;1009;2163;901128;869271;62.2;60.0
78;2021-09-30;559;928;901687;870199;62.2;60.1
78;2021-10-01;932;1823;902619;872022;62.3;60.2
78;2021-10-02;1246;2468;903865;874490;62.4;60.4
78;2021-10-03;54;70;903919;874560;62.4;60.4
78;2021-10-04;486;939;904405;875499;62.4;60.4
78;2021-10-05;436;732;904841;876231;62.5;60.5
78;2021-10-06;806;1569;905647;877800;62.5;60.6
78;2021-10-07;395;784;906042;878584;62.5;60.6
78;2021-10-08;897;1741;906939;880325;62.6;60.8
78;2021-10-09;977;1845;907916;882170;62.7;60.9
78;2021-10-10;101;115;908017;882285;62.7;60.9
78;2021-10-11;454;1002;908471;883287;62.7;61.0
78;2021-10-12;407;639;908878;883926;62.7;61.0
78;2021-10-13;653;1305;909531;885231;62.8;61.1
78;2021-10-14;511;865;910042;886096;62.8;61.2
79;2020-12-27;0;0;0;0;0.0;0.0
79;2020-12-28;4;0;4;0;0.0;0.0
79;2020-12-29;0;0;4;0;0.0;0.0
79;2020-12-30;0;0;4;0;0.0;0.0
79;2020-12-31;0;0;4;0;0.0;0.0
79;2021-01-01;0;0;4;0;0.0;0.0
79;2021-01-02;0;0;4;0;0.0;0.0
79;2021-01-03;0;0;4;0;0.0;0.0
79;2021-01-04;1;0;5;0;0.0;0.0
79;2021-01-05;0;0;5;0;0.0;0.0
79;2021-01-06;0;0;5;0;0.0;0.0
79;2021-01-07;158;0;163;0;0.0;0.0
79;2021-01-08;165;0;328;0;0.1;0.0
79;2021-01-09;100;1;428;1;0.1;0.0
79;2021-01-10;3;0;431;1;0.1;0.0
79;2021-01-11;184;1;615;2;0.2;0.0
79;2021-01-12;245;1;860;3;0.2;0.0
79;2021-01-13;258;0;1118;3;0.3;0.0
79;2021-01-14;506;9;1624;12;0.4;0.0
79;2021-01-15;618;7;2242;19;0.6;0.0
79;2021-01-16;66;0;2308;19;0.6;0.0
79;2021-01-17;0;0;2308;19;0.6;0.0
79;2021-01-18;478;2;2786;21;0.7;0.0
79;2021-01-19;1361;3;4147;24;1.1;0.0
79;2021-01-20;1678;2;5825;26;1.6;0.0
79;2021-01-21;1999;8;7824;34;2.1;0.0
79;2021-01-22;875;5;8699;39;2.3;0.0
79;2021-01-23;65;0;8764;39;2.4;0.0
79;2021-01-24;0;0;8764;39;2.4;0.0
79;2021-01-25;646;7;9410;46;2.5;0.0
79;2021-01-26;593;14;10003;60;2.7;0.0
79;2021-01-27;740;84;10743;144;2.9;0.0
79;2021-01-28;733;152;11476;296;3.1;0.1
79;2021-01-29;495;88;11971;384;3.2;0.1
79;2021-01-30;0;0;11971;384;3.2;0.1
79;2021-01-31;0;0;11971;384;3.2;0.1
79;2021-02-01;207;111;12178;495;3.3;0.1
79;2021-02-02;334;74;12512;569;3.4;0.2
79;2021-02-03;391;60;12903;629;3.5;0.2
79;2021-02-04;326;109;13229;738;3.6;0.2
79;2021-02-05;360;275;13589;1013;3.6;0.3
79;2021-02-06;6;1;13595;1014;3.6;0.3
79;2021-02-07;22;0;13617;1014;3.7;0.3
79;2021-02-08;283;167;13900;1181;3.7;0.3
79;2021-02-09;457;785;14357;1966;3.9;0.5
79;2021-02-10;619;1199;14976;3165;4.0;0.8
79;2021-02-11;775;1237;15751;4402;4.2;1.2
79;2021-02-12;471;767;16222;5169;4.4;1.4
79;2021-02-13;53;74;16275;5243;4.4;1.4
79;2021-02-14;0;0;16275;5243;4.4;1.4
79;2021-02-15;186;503;16461;5746;4.4;1.5
79;2021-02-16;333;731;16794;6477;4.5;1.7
79;2021-02-17;248;877;17042;7354;4.6;2.0
79;2021-02-18;353;945;17395;8299;4.7;2.2
79;2021-02-19;268;560;17663;8859;4.7;2.4
79;2021-02-20;5;22;17668;8881;4.7;2.4
79;2021-02-21;1;0;17669;8881;4.7;2.4
79;2021-02-22;137;462;17806;9343;4.8;2.5
79;2021-02-23;247;567;18053;9910;4.8;2.7
79;2021-02-24;246;544;18299;10454;4.9;2.8
79;2021-02-25;520;469;18819;10923;5.1;2.9
79;2021-02-26;599;399;19418;11322;5.2;3.0
79;2021-02-27;408;7;19826;11329;5.3;3.0
79;2021-02-28;35;0;19861;11329;5.3;3.0
79;2021-03-01;89;362;19950;11691;5.4;3.1
79;2021-03-02;302;508;20252;12199;5.4;3.3
79;2021-03-03;662;545;20914;12744;5.6;3.4
79;2021-03-04;904;572;21818;13316;5.9;3.6
79;2021-03-05;1218;449;23036;13765;6.2;3.7
79;2021-03-06;611;8;23647;13773;6.3;3.7
79;2021-03-07;77;1;23724;13774;6.4;3.7
79;2021-03-08;345;310;24069;14084;6.5;3.8
79;2021-03-09;842;343;24911;14427;6.7;3.9
79;2021-03-10;1146;404;26057;14831;7.0;4.0
79;2021-03-11;1642;328;27699;15159;7.4;4.1
79;2021-03-12;1721;122;29420;15281;7.9;4.1
79;2021-03-13;1135;13;30555;15294;8.2;4.1
79;2021-03-14;50;0;30605;15294;8.2;4.1
79;2021-03-15;497;158;31102;15452;8.3;4.1
79;2021-03-16;735;148;31837;15600;8.5;4.2
79;2021-03-17;578;109;32415;15709;8.7;4.2
79;2021-03-18;553;203;32968;15912;8.8;4.3
79;2021-03-19;661;261;33629;16173;9.0;4.3
79;2021-03-20;1007;15;34636;16188;9.3;4.3
79;2021-03-21;3;0;34639;16188;9.3;4.3
79;2021-03-22;957;210;35596;16398;9.6;4.4
79;2021-03-23;1595;172;37191;16570;10.0;4.4
79;2021-03-24;1831;167;39022;16737;10.5;4.5
79;2021-03-25;2499;195;41521;16932;11.1;4.5
79;2021-03-26;2406;138;43927;17070;11.8;4.6
79;2021-03-27;768;18;44695;17088;12.0;4.6
79;2021-03-28;1;0;44696;17088;12.0;4.6
79;2021-03-29;2148;117;46844;17205;12.6;4.6
79;2021-03-30;2817;67;49661;17272;13.3;4.6
79;2021-03-31;2777;381;52438;17653;14.1;4.7
79;2021-04-01;2698;387;55136;18040;14.8;4.8
79;2021-04-02;2823;397;57959;18437;15.6;4.9
79;2021-04-03;634;55;58593;18492;15.7;5.0
79;2021-04-04;3;0;58596;18492;15.7;5.0
79;2021-04-05;382;5;58978;18497;15.8;5.0
79;2021-04-06;1792;587;60770;19084;16.3;5.1
79;2021-04-07;3112;738;63882;19822;17.1;5.3
79;2021-04-08;2632;704;66514;20526;17.9;5.5
79;2021-04-09;3737;550;70251;21076;18.9;5.7
79;2021-04-10;1466;388;71717;21464;19.2;5.8
79;2021-04-11;4;0;71721;21464;19.2;5.8
79;2021-04-12;1753;355;73474;21819;19.7;5.9
79;2021-04-13;2174;756;75648;22575;20.3;6.1
79;2021-04-14;2480;681;78128;23256;21.0;6.2
79;2021-04-15;2216;670;80344;23926;21.6;6.4
79;2021-04-16;1413;446;81757;24372;21.9;6.5
79;2021-04-17;581;354;82338;24726;22.1;6.6
79;2021-04-18;1;14;82339;24740;22.1;6.6
79;2021-04-19;1088;842;83427;25582;22.4;6.9
79;2021-04-20;1506;1229;84933;26811;22.8;7.2
79;2021-04-21;1419;1440;86352;28251;23.2;7.6
79;2021-04-22;1572;1089;87924;29340;23.6;7.9
79;2021-04-23;1316;1192;89240;30532;23.9;8.2
79;2021-04-24;653;463;89893;30995;24.1;8.3
79;2021-04-25;1;0;89894;30995;24.1;8.3
79;2021-04-26;1343;1813;91237;32808;24.5;8.8
79;2021-04-27;1899;2352;93136;35160;25.0;9.4
79;2021-04-28;1458;2867;94594;38027;25.4;10.2
79;2021-04-29;2103;2254;96697;40281;26.0;10.8
79;2021-04-30;2115;2463;98812;42744;26.5;11.5
79;2021-05-01;521;381;99333;43125;26.7;11.6
79;2021-05-02;1;11;99334;43136;26.7;11.6
79;2021-05-03;1182;1293;100516;44429;27.0;11.9
79;2021-05-04;1732;2332;102248;46761;27.4;12.5
79;2021-05-05;1694;2482;103942;49243;27.9;13.2
79;2021-05-06;2326;2223;106268;51466;28.5;13.8
79;2021-05-07;2105;2803;108373;54269;29.1;14.6
79;2021-05-08;198;506;108571;54775;29.1;14.7
79;2021-05-09;0;0;108571;54775;29.1;14.7
79;2021-05-10;1582;1787;110153;56562;29.6;15.2
79;2021-05-11;2309;1653;112462;58215;30.2;15.6
79;2021-05-12;2000;2683;114462;60898;30.7;16.3
79;2021-05-13;640;290;115102;61188;30.9;16.4
79;2021-05-14;2100;675;117202;61863;31.5;16.6
79;2021-05-15;1399;499;118601;62362;31.8;16.7
79;2021-05-16;1;22;118602;62384;31.8;16.7
79;2021-05-17;1873;1087;120475;63471;32.3;17.0
79;2021-05-18;2971;1272;123446;64743;33.1;17.4
79;2021-05-19;2899;969;126345;65712;33.9;17.6
79;2021-05-20;3106;1248;129451;66960;34.7;18.0
79;2021-05-21;2768;1066;132219;68026;35.5;18.3
79;2021-05-22;1084;261;133303;68287;35.8;18.3
79;2021-05-23;1;0;133304;68287;35.8;18.3
79;2021-05-24;161;20;133465;68307;35.8;18.3
79;2021-05-25;3198;991;136663;69298;36.7;18.6
79;2021-05-26;3312;854;139975;70152;37.6;18.8
79;2021-05-27;3589;1719;143564;71871;38.5;19.3
79;2021-05-28;3331;1825;146895;73696;39.4;19.8
79;2021-05-29;1072;450;147967;74146;39.7;19.9
79;2021-05-30;3;1;147970;74147;39.7;19.9
79;2021-05-31;2382;735;150352;74882;40.3;20.1
79;2021-06-01;3021;1577;153373;76459;41.2;20.5
79;2021-06-02;4066;1165;157439;77624;42.3;20.8
79;2021-06-03;4089;1758;161528;79382;43.3;21.3
79;2021-06-04;4141;2037;165669;81419;44.5;21.9
79;2021-06-05;2801;760;168470;82179;45.2;22.1
79;2021-06-06;696;39;169166;82218;45.4;22.1
79;2021-06-07;2805;1414;171971;83632;46.2;22.4
79;2021-06-08;2982;2070;174953;85702;47.0;23.0
79;2021-06-09;3631;1937;178584;87639;47.9;23.5
79;2021-06-10;3020;1971;181604;89610;48.7;24.0
79;2021-06-11;3767;2316;185371;91926;49.7;24.7
79;2021-06-12;1707;612;187078;92538;50.2;24.8
79;2021-06-13;213;24;187291;92562;50.3;24.8
79;2021-06-14;1247;1690;188538;94252;50.6;25.3
79;2021-06-15;1883;2362;190421;96614;51.1;25.9
79;2021-06-16;2204;2247;192625;98861;51.7;26.5
79;2021-06-17;2237;2620;194862;101481;52.3;27.2
79;2021-06-18;2413;2324;197275;103805;52.9;27.9
79;2021-06-19;1246;580;198521;104385;53.3;28.0
79;2021-06-20;3;2;198524;104387;53.3;28.0
79;2021-06-21;1233;2282;199757;106669;53.6;28.6
79;2021-06-22;1547;2877;201304;109546;54.0;29.4
79;2021-06-23;1770;2550;203074;112096;54.5;30.1
79;2021-06-24;2105;2002;205179;114098;55.1;30.6
79;2021-06-25;1488;2840;206667;116938;55.5;31.4
79;2021-06-26;870;808;207537;117746;55.7;31.6
79;2021-06-27;13;6;207550;117752;55.7;31.6
79;2021-06-28;1056;2620;208606;120372;56.0;32.3
79;2021-06-29;1473;3552;210079;123924;56.4;33.3
79;2021-06-30;1354;3447;211433;127371;56.7;34.2
79;2021-07-01;1202;3786;212635;131157;57.1;35.2
79;2021-07-02;1487;3346;214122;134503;57.5;36.1
79;2021-07-03;399;1504;214521;136007;57.6;36.5
79;2021-07-04;2;9;214523;136016;57.6;36.5
79;2021-07-05;754;2119;215277;138135;57.8;37.1
79;2021-07-06;947;3666;216224;141801;58.0;38.1
79;2021-07-07;1332;4308;217556;146109;58.4;39.2
79;2021-07-08;1107;4042;218663;150151;58.7;40.3
79;2021-07-09;836;3718;219499;153869;58.9;41.3
79;2021-07-10;514;1315;220013;155184;59.0;41.6
79;2021-07-11;3;12;220016;155196;59.0;41.6
79;2021-07-12;545;3696;220561;158892;59.2;42.6
79;2021-07-13;999;5187;221560;164079;59.5;44.0
79;2021-07-14;134;874;221694;164953;59.5;44.3
79;2021-07-15;1235;4684;222929;169637;59.8;45.5
79;2021-07-16;1333;4365;224262;174002;60.2;46.7
79;2021-07-17;576;2425;224838;176427;60.3;47.3
79;2021-07-18;44;498;224882;176925;60.4;47.5
79;2021-07-19;737;3316;225619;180241;60.5;48.4
79;2021-07-20;1230;3947;226849;184188;60.9;49.4
79;2021-07-21;1177;4198;228026;188386;61.2;50.6
79;2021-07-22;1354;3976;229380;192362;61.6;51.6
79;2021-07-23;1349;4556;230729;196918;61.9;52.8
79;2021-07-24;865;1499;231594;198417;62.2;53.2
79;2021-07-25;55;327;231649;198744;62.2;53.3
79;2021-07-26;1372;2599;233021;201343;62.5;54.0
79;2021-07-27;2084;2996;235105;204339;63.1;54.8
79;2021-07-28;2497;2496;237602;206835;63.8;55.5
79;2021-07-29;3010;2862;240612;209697;64.6;56.3
79;2021-07-30;2138;2815;242750;212512;65.1;57.0
79;2021-07-31;888;1157;243638;213669;65.4;57.3
79;2021-08-01;5;3;243643;213672;65.4;57.3
79;2021-08-02;1797;1545;245440;215217;65.9;57.8
79;2021-08-03;2823;2052;248263;217269;66.6;58.3
79;2021-08-04;2985;1744;251248;219013;67.4;58.8
79;2021-08-05;2900;2214;254148;221227;68.2;59.4
79;2021-08-06;2529;1636;256677;222863;68.9;59.8
79;2021-08-07;872;813;257549;223676;69.1;60.0
79;2021-08-08;4;3;257553;223679;69.1;60.0
79;2021-08-09;2495;1086;260048;224765;69.8;60.3
79;2021-08-10;2977;1549;263025;226314;70.6;60.7
79;2021-08-11;2587;1662;265612;227976;71.3;61.2
79;2021-08-12;2767;1431;268379;229407;72.0;61.6
79;2021-08-13;2875;1059;271254;230466;72.8;61.8
79;2021-08-14;518;391;271772;230857;72.9;62.0
79;2021-08-15;8;5;271780;230862;72.9;62.0
79;2021-08-16;1766;1196;273546;232058;73.4;62.3
79;2021-08-17;2103;1592;275649;233650;74.0;62.7
79;2021-08-18;1922;1915;277571;235565;74.5;63.2
79;2021-08-19;1617;1709;279188;237274;74.9;63.7
79;2021-08-20;1513;2162;280701;239436;75.3;64.3
79;2021-08-21;243;543;280944;239979;75.4;64.4
79;2021-08-22;1;21;280945;240000;75.4;64.4
79;2021-08-23;864;2176;281809;242176;75.6;65.0
79;2021-08-24;1072;2484;282881;244660;75.9;65.7
79;2021-08-25;1051;2760;283932;247420;76.2;66.4
79;2021-08-26;1017;2330;284949;249750;76.5;67.0
79;2021-08-27;611;2059;285560;251809;76.6;67.6
79;2021-08-28;299;841;285859;252650;76.7;67.8
79;2021-08-29;7;5;285866;252655;76.7;67.8
79;2021-08-30;554;2342;286420;254997;76.9;68.4
79;2021-08-31;633;2505;287053;257502;77.0;69.1
79;2021-09-01;650;2615;287703;260117;77.2;69.8
79;2021-09-02;762;2414;288465;262531;77.4;70.5
79;2021-09-03;637;2689;289102;265220;77.6;71.2
79;2021-09-04;265;700;289367;265920;77.7;71.4
79;2021-09-05;13;17;289380;265937;77.7;71.4
79;2021-09-06;330;1792;289710;267729;77.7;71.8
79;2021-09-07;347;2018;290057;269747;77.8;72.4
79;2021-09-08;542;2120;290599;271867;78.0;73.0
79;2021-09-09;318;1636;290917;273503;78.1;73.4
79;2021-09-10;422;2065;291339;275568;78.2;74.0
79;2021-09-11;162;836;291501;276404;78.2;74.2
79;2021-09-12;0;0;291501;276404;78.2;74.2
79;2021-09-13;364;1060;291865;277464;78.3;74.5
79;2021-09-14;383;1185;292248;278649;78.4;74.8
79;2021-09-15;475;1432;292723;280081;78.6;75.2
79;2021-09-16;464;1095;293187;281176;78.7;75.5
79;2021-09-17;445;1406;293632;282582;78.8;75.8
79;2021-09-18;141;567;293773;283149;78.8;76.0
79;2021-09-19;1;4;293774;283153;78.8;76.0
79;2021-09-20;190;553;293964;283706;78.9;76.1
79;2021-09-21;351;720;294315;284426;79.0;76.3
79;2021-09-22;209;1102;294524;285528;79.0;76.6
79;2021-09-23;414;567;294938;286095;79.2;76.8
79;2021-09-24;244;1349;295182;287444;79.2;77.1
79;2021-09-25;75;325;295257;287769;79.2;77.2
79;2021-09-26;0;1;295257;287770;79.2;77.2
79;2021-09-27;205;527;295462;288297;79.3;77.4
79;2021-09-28;130;409;295592;288706;79.3;77.5
79;2021-09-29;325;743;295917;289449;79.4;77.7
79;2021-09-30;154;279;296071;289728;79.5;77.8
79;2021-10-01;248;541;296319;290269;79.5;77.9
79;2021-10-02;127;248;296446;290517;79.6;78.0
79;2021-10-03;0;0;296446;290517;79.6;78.0
79;2021-10-04;158;332;296604;290849;79.6;78.1
79;2021-10-05;115;260;296719;291109;79.6;78.1
79;2021-10-06;144;336;296863;291445;79.7;78.2
79;2021-10-07;93;223;296956;291668;79.7;78.3
79;2021-10-08;222;549;297178;292217;79.8;78.4
79;2021-10-09;89;151;297267;292368;79.8;78.5
79;2021-10-10;1;3;297268;292371;79.8;78.5
79;2021-10-11;123;281;297391;292652;79.8;78.5
79;2021-10-12;147;345;297538;292997;79.8;78.6
79;2021-10-13;213;283;297751;293280;79.9;78.7
79;2021-10-14;142;324;297893;293604;79.9;78.8
80;2020-12-27;0;0;0;0;0.0;0.0
80;2020-12-28;0;0;0;0;0.0;0.0
80;2020-12-29;11;0;11;0;0.0;0.0
80;2020-12-30;0;0;11;0;0.0;0.0
80;2020-12-31;0;0;11;0;0.0;0.0
80;2021-01-01;0;0;11;0;0.0;0.0
80;2021-01-02;1;0;12;0;0.0;0.0
80;2021-01-03;1;0;13;0;0.0;0.0
80;2021-01-04;0;0;13;0;0.0;0.0
80;2021-01-05;1;0;14;0;0.0;0.0
80;2021-01-06;30;0;44;0;0.0;0.0
80;2021-01-07;276;2;320;2;0.1;0.0
80;2021-01-08;330;1;650;3;0.1;0.0
80;2021-01-09;108;0;758;3;0.1;0.0
80;2021-01-10;21;0;779;3;0.1;0.0
80;2021-01-11;276;0;1055;3;0.2;0.0
80;2021-01-12;430;1;1485;4;0.3;0.0
80;2021-01-13;514;4;1999;8;0.4;0.0
80;2021-01-14;454;4;2453;12;0.4;0.0
80;2021-01-15;331;1;2784;13;0.5;0.0
80;2021-01-16;103;1;2887;14;0.5;0.0
80;2021-01-17;102;1;2989;15;0.5;0.0
80;2021-01-18;412;2;3401;17;0.6;0.0
80;2021-01-19;963;17;4364;34;0.8;0.0
80;2021-01-20;1086;11;5450;45;1.0;0.0
80;2021-01-21;1013;9;6463;54;1.1;0.0
80;2021-01-22;1114;5;7577;59;1.3;0.0
80;2021-01-23;907;18;8484;77;1.5;0.0
80;2021-01-24;823;10;9307;87;1.6;0.0
80;2021-01-25;1544;21;10851;108;1.9;0.0
80;2021-01-26;1480;12;12331;120;2.2;0.0
80;2021-01-27;822;26;13153;146;2.3;0.0
80;2021-01-28;622;172;13775;318;2.4;0.1
80;2021-01-29;637;216;14412;534;2.5;0.1
80;2021-01-30;87;59;14499;593;2.5;0.1
80;2021-01-31;0;0;14499;593;2.5;0.1
80;2021-02-01;26;254;14525;847;2.5;0.1
80;2021-02-02;21;441;14546;1288;2.6;0.2
80;2021-02-03;28;542;14574;1830;2.6;0.3
80;2021-02-04;278;358;14852;2188;2.6;0.4
80;2021-02-05;347;213;15199;2401;2.7;0.4
80;2021-02-06;168;69;15367;2470;2.7;0.4
80;2021-02-07;1;0;15368;2470;2.7;0.4
80;2021-02-08;424;241;15792;2711;2.8;0.5
80;2021-02-09;686;245;16478;2956;2.9;0.5
80;2021-02-10;607;496;17085;3452;3.0;0.6
80;2021-02-11;862;353;17947;3805;3.1;0.7
80;2021-02-12;947;317;18894;4122;3.3;0.7
80;2021-02-13;197;428;19091;4550;3.4;0.8
80;2021-02-14;78;571;19169;5121;3.4;0.9
80;2021-02-15;606;1015;19775;6136;3.5;1.1
80;2021-02-16;688;1133;20463;7269;3.6;1.3
80;2021-02-17;484;1170;20947;8439;3.7;1.5
80;2021-02-18;571;1138;21518;9577;3.8;1.7
80;2021-02-19;502;854;22020;10431;3.9;1.8
80;2021-02-20;22;510;22042;10941;3.9;1.9
80;2021-02-21;47;46;22089;10987;3.9;1.9
80;2021-02-22;146;573;22235;11560;3.9;2.0
80;2021-02-23;471;688;22706;12248;4.0;2.1
80;2021-02-24;431;678;23137;12926;4.1;2.3
80;2021-02-25;814;534;23951;13460;4.2;2.4
80;2021-02-26;1063;522;25014;13982;4.4;2.5
80;2021-02-27;475;71;25489;14053;4.5;2.5
80;2021-02-28;49;24;25538;14077;4.5;2.5
80;2021-03-01;730;68;26268;14145;4.6;2.5
80;2021-03-02;1014;93;27282;14238;4.8;2.5
80;2021-03-03;981;56;28263;14294;5.0;2.5
80;2021-03-04;1389;239;29652;14533;5.2;2.6
80;2021-03-05;1874;335;31526;14868;5.5;2.6
80;2021-03-06;2916;338;34442;15206;6.0;2.7
80;2021-03-07;1842;85;36284;15291;6.4;2.7
80;2021-03-08;714;608;36998;15899;6.5;2.8
80;2021-03-09;1310;910;38308;16809;6.7;3.0
80;2021-03-10;1724;756;40032;17565;7.0;3.1
80;2021-03-11;1909;826;41941;18391;7.4;3.2
80;2021-03-12;3140;752;45081;19143;7.9;3.4
80;2021-03-13;4006;221;49087;19364;8.6;3.4
80;2021-03-14;350;14;49437;19378;8.7;3.4
80;2021-03-15;1014;249;50451;19627;8.9;3.4
80;2021-03-16;884;346;51335;19973;9.0;3.5
80;2021-03-17;665;279;52000;20252;9.1;3.6
80;2021-03-18;1003;297;53003;20549;9.3;3.6
80;2021-03-19;1738;385;54741;20934;9.6;3.7
80;2021-03-20;3821;118;58562;21052;10.3;3.7
80;2021-03-21;486;31;59048;21083;10.4;3.7
80;2021-03-22;902;291;59950;21374;10.5;3.8
80;2021-03-23;1713;418;61663;21792;10.8;3.8
80;2021-03-24;1755;468;63418;22260;11.1;3.9
80;2021-03-25;2714;453;66132;22713;11.6;4.0
80;2021-03-26;3105;424;69237;23137;12.2;4.1
80;2021-03-27;2237;232;71474;23369;12.5;4.1
80;2021-03-28;676;95;72150;23464;12.7;4.1
80;2021-03-29;1978;754;74128;24218;13.0;4.3
80;2021-03-30;1968;874;76096;25092;13.4;4.4
80;2021-03-31;1495;986;77591;26078;13.6;4.6
80;2021-04-01;1950;1490;79541;27568;14.0;4.8
80;2021-04-02;2811;1579;82352;29147;14.5;5.1
80;2021-04-03;3048;863;85400;30010;15.0;5.3
80;2021-04-04;134;8;85534;30018;15.0;5.3
80;2021-04-05;684;201;86218;30219;15.1;5.3
80;2021-04-06;1280;968;87498;31187;15.4;5.5
80;2021-04-07;1624;1202;89122;32389;15.6;5.7
80;2021-04-08;2155;844;91277;33233;16.0;5.8
80;2021-04-09;3533;1359;94810;34592;16.6;6.1
80;2021-04-10;2737;1952;97547;36544;17.1;6.4
80;2021-04-11;187;177;97734;36721;17.2;6.4
80;2021-04-12;1814;491;99548;37212;17.5;6.5
80;2021-04-13;2385;1037;101933;38249;17.9;6.7
80;2021-04-14;2769;1167;104702;39416;18.4;6.9
80;2021-04-15;3731;882;108433;40298;19.0;7.1
80;2021-04-16;3337;878;111770;41176;19.6;7.2
80;2021-04-17;1653;2299;113423;43475;19.9;7.6
80;2021-04-18;372;390;113795;43865;20.0;7.7
80;2021-04-19;951;772;114746;44637;20.1;7.8
80;2021-04-20;1613;823;116359;45460;20.4;8.0
80;2021-04-21;1612;998;117971;46458;20.7;8.2
80;2021-04-22;2167;1253;120138;47711;21.1;8.4
80;2021-04-23;2640;1252;122778;48963;21.5;8.6
80;2021-04-24;1357;1193;124135;50156;21.8;8.8
80;2021-04-25;209;531;124344;50687;21.8;8.9
80;2021-04-26;1295;1445;125639;52132;22.1;9.1
80;2021-04-27;2025;1398;127664;53530;22.4;9.4
80;2021-04-28;2199;1396;129863;54926;22.8;9.6
80;2021-04-29;3219;1888;133082;56814;23.4;10.0
80;2021-04-30;3081;2857;136163;59671;23.9;10.5
80;2021-05-01;987;660;137150;60331;24.1;10.6
80;2021-05-02;371;54;137521;60385;24.1;10.6
80;2021-05-03;2720;1188;140241;61573;24.6;10.8
80;2021-05-04;2494;1708;142735;63281;25.1;11.1
80;2021-05-05;3366;1899;146101;65180;25.6;11.4
80;2021-05-06;3168;2558;149269;67738;26.2;11.9
80;2021-05-07;3455;2699;152724;70437;26.8;12.4
80;2021-05-08;2784;927;155508;71364;27.3;12.5
80;2021-05-09;1407;269;156915;71633;27.5;12.6
80;2021-05-10;1880;1832;158795;73465;27.9;12.9
80;2021-05-11;3274;1806;162069;75271;28.4;13.2
80;2021-05-12;4703;1576;166772;76847;29.3;13.5
80;2021-05-13;3837;367;170609;77214;29.9;13.6
80;2021-05-14;5186;1406;175795;78620;30.9;13.8
80;2021-05-15;5917;1054;181712;79674;31.9;14.0
80;2021-05-16;2678;315;184390;79989;32.4;14.0
80;2021-05-17;2371;819;186761;80808;32.8;14.2
80;2021-05-18;3945;853;190706;81661;33.5;14.3
80;2021-05-19;4018;944;194724;82605;34.2;14.5
80;2021-05-20;4568;1221;199292;83826;35.0;14.7
80;2021-05-21;4890;1670;204182;85496;35.8;15.0
80;2021-05-22;5030;1159;209212;86655;36.7;15.2
80;2021-05-23;1783;242;210995;86897;37.0;15.3
80;2021-05-24;1469;160;212464;87057;37.3;15.3
80;2021-05-25;2622;1137;215086;88194;37.7;15.5
80;2021-05-26;4249;1708;219335;89902;38.5;15.8
80;2021-05-27;3977;2471;223312;92373;39.2;16.2
80;2021-05-28;3865;2978;227177;95351;39.9;16.7
80;2021-05-29;3697;1631;230874;96982;40.5;17.0
80;2021-05-30;1182;198;232056;97180;40.7;17.1
80;2021-05-31;2604;1372;234660;98552;41.2;17.3
80;2021-06-01;4031;2437;238691;100989;41.9;17.7
80;2021-06-02;3334;2009;242025;102998;42.5;18.1
80;2021-06-03;4264;2933;246289;105931;43.2;18.6
80;2021-06-04;4796;3086;251085;109017;44.1;19.1
80;2021-06-05;3554;2073;254639;111090;44.7;19.5
80;2021-06-06;803;211;255442;111301;44.8;19.5
80;2021-06-07;1750;1945;257192;113246;45.1;19.9
80;2021-06-08;2743;2561;259935;115807;45.6;20.3
80;2021-06-09;3012;2735;262947;118542;46.1;20.8
80;2021-06-10;3162;3171;266109;121713;46.7;21.4
80;2021-06-11;3216;3902;269325;125615;47.3;22.0
80;2021-06-12;3042;2329;272367;127944;47.8;22.5
80;2021-06-13;474;404;272841;128348;47.9;22.5
80;2021-06-14;1263;2852;274104;131200;48.1;23.0
80;2021-06-15;2315;3421;276419;134621;48.5;23.6
80;2021-06-16;1563;4212;277982;138833;48.8;24.4
80;2021-06-17;2359;3625;280341;142458;49.2;25.0
80;2021-06-18;2552;3907;282893;146365;49.7;25.7
80;2021-06-19;2986;4342;285879;150707;50.2;26.5
80;2021-06-20;203;1077;286082;151784;50.2;26.6
80;2021-06-21;1015;2620;287097;154404;50.4;27.1
80;2021-06-22;1149;3930;288246;158334;50.6;27.8
80;2021-06-23;1850;5291;290096;163625;50.9;28.7
80;2021-06-24;1695;4685;291791;168310;51.2;29.5
80;2021-06-25;1374;6126;293165;174436;51.5;30.6
80;2021-06-26;1934;6183;295099;180619;51.8;31.7
80;2021-06-27;333;2031;295432;182650;51.9;32.1
80;2021-06-28;903;3170;296335;185820;52.0;32.6
80;2021-06-29;1919;4624;298254;190444;52.3;33.4
80;2021-06-30;1245;4785;299499;195229;52.6;34.3
80;2021-07-01;1593;5000;301092;200229;52.8;35.1
80;2021-07-02;1856;5986;302948;206215;53.2;36.2
80;2021-07-03;1293;5265;304241;211480;53.4;37.1
80;2021-07-04;692;1471;304933;212951;53.5;37.4
80;2021-07-05;879;2964;305812;215915;53.7;37.9
80;2021-07-06;1852;3991;307664;219906;54.0;38.6
80;2021-07-07;1561;4506;309225;224412;54.3;39.4
80;2021-07-08;2082;5003;311307;229415;54.6;40.3
80;2021-07-09;2596;5473;313903;234888;55.1;41.2
80;2021-07-10;1617;4017;315520;238905;55.4;41.9
80;2021-07-11;406;805;315926;239710;55.4;42.1
80;2021-07-12;871;3379;316797;243089;55.6;42.7
80;2021-07-13;2087;5088;318884;248177;56.0;43.6
80;2021-07-14;2802;1750;321686;249927;56.5;43.9
80;2021-07-15;2792;5297;324478;255224;56.9;44.8
80;2021-07-16;3876;5892;328354;261116;57.6;45.8
80;2021-07-17;3368;4461;331722;265577;58.2;46.6
80;2021-07-18;874;896;332596;266473;58.4;46.8
80;2021-07-19;2158;2886;334754;269359;58.8;47.3
80;2021-07-20;3321;4903;338075;274262;59.3;48.1
80;2021-07-21;3497;4497;341572;278759;59.9;48.9
80;2021-07-22;4362;4573;345934;283332;60.7;49.7
80;2021-07-23;5399;4830;351333;288162;61.7;50.6
80;2021-07-24;4367;4346;355700;292508;62.4;51.3
80;2021-07-25;1185;650;356885;293158;62.6;51.5
80;2021-07-26;2681;2340;359566;295498;63.1;51.9
80;2021-07-27;4373;3706;363939;299204;63.9;52.5
80;2021-07-28;5101;2803;369040;302007;64.8;53.0
80;2021-07-29;4991;3231;374031;305238;65.6;53.6
80;2021-07-30;5024;3641;379055;308879;66.5;54.2
80;2021-07-31;4156;2927;383211;311806;67.3;54.7
80;2021-08-01;1288;363;384499;312169;67.5;54.8
80;2021-08-02;2059;1739;386558;313908;67.8;55.1
80;2021-08-03;3716;2363;390274;316271;68.5;55.5
80;2021-08-04;3367;2491;393641;318762;69.1;55.9
80;2021-08-05;3137;2579;396778;321341;69.6;56.4
80;2021-08-06;3248;2878;400026;324219;70.2;56.9
80;2021-08-07;2430;2670;402456;326889;70.6;57.4
80;2021-08-08;621;686;403077;327575;70.7;57.5
80;2021-08-09;1382;2078;404459;329653;71.0;57.9
80;2021-08-10;2353;2849;406812;332502;71.4;58.4
80;2021-08-11;1946;2383;408758;334885;71.7;58.8
80;2021-08-12;2237;2661;410995;337546;72.1;59.2
80;2021-08-13;1882;3154;412877;340700;72.5;59.8
80;2021-08-14;1411;2113;414288;342813;72.7;60.2
80;2021-08-15;318;663;414606;343476;72.8;60.3
80;2021-08-16;897;2419;415503;345895;72.9;60.7
80;2021-08-17;1709;3505;417212;349400;73.2;61.3
80;2021-08-18;1234;3714;418446;353114;73.4;62.0
80;2021-08-19;1569;3821;420015;356935;73.7;62.6
80;2021-08-20;1265;4434;421280;361369;73.9;63.4
80;2021-08-21;1078;2687;422358;364056;74.1;63.9
80;2021-08-22;145;680;422503;364736;74.2;64.0
80;2021-08-23;583;3000;423086;367736;74.3;64.5
80;2021-08-24;1092;4371;424178;372107;74.4;65.3
80;2021-08-25;973;3677;425151;375784;74.6;66.0
80;2021-08-26;956;3819;426107;379603;74.8;66.6
80;2021-08-27;1014;4458;427121;384061;75.0;67.4
80;2021-08-28;723;3347;427844;387408;75.1;68.0
80;2021-08-29;199;555;428043;387963;75.1;68.1
80;2021-08-30;501;2280;428544;390243;75.2;68.5
80;2021-08-31;750;3112;429294;393355;75.3;69.0
80;2021-09-01;675;2316;429969;395671;75.5;69.4
80;2021-09-02;527;2077;430496;397748;75.6;69.8
80;2021-09-03;761;2804;431257;400552;75.7;70.3
80;2021-09-04;958;2598;432215;403150;75.9;70.8
80;2021-09-05;166;341;432381;403491;75.9;70.8
80;2021-09-06;420;1305;432801;404796;76.0;71.0
80;2021-09-07;491;1581;433292;406377;76.0;71.3
80;2021-09-08;495;1549;433787;407926;76.1;71.6
80;2021-09-09;532;1515;434319;409441;76.2;71.9
80;2021-09-10;620;1704;434939;411145;76.3;72.2
80;2021-09-11;520;1959;435459;413104;76.4;72.5
80;2021-09-12;78;303;435537;413407;76.4;72.6
80;2021-09-13;312;785;435849;414192;76.5;72.7
80;2021-09-14;642;1086;436491;415278;76.6;72.9
80;2021-09-15;358;1089;436849;416367;76.7;73.1
80;2021-09-16;477;1029;437326;417396;76.8;73.3
80;2021-09-17;506;1237;437832;418633;76.8;73.5
80;2021-09-18;348;1278;438180;419911;76.9;73.7
80;2021-09-19;19;169;438199;420080;76.9;73.7
80;2021-09-20;327;445;438526;420525;77.0;73.8
80;2021-09-21;297;615;438823;421140;77.0;73.9
80;2021-09-22;284;709;439107;421849;77.1;74.0
80;2021-09-23;305;507;439412;422356;77.1;74.1
80;2021-09-24;371;897;439783;423253;77.2;74.3
80;2021-09-25;283;1133;440066;424386;77.2;74.5
80;2021-09-26;20;109;440086;424495;77.2;74.5
80;2021-09-27;190;536;440276;425031;77.3;74.6
80;2021-09-28;148;382;440424;425413;77.3;74.7
80;2021-09-29;257;512;440681;425925;77.3;74.8
80;2021-09-30;199;330;440880;426255;77.4;74.8
80;2021-10-01;306;721;441186;426976;77.4;74.9
80;2021-10-02;335;894;441521;427870;77.5;75.1
80;2021-10-03;18;64;441539;427934;77.5;75.1
80;2021-10-04;136;321;441675;428255;77.5;75.2
80;2021-10-05;166;460;441841;428715;77.5;75.2
80;2021-10-06;259;445;442100;429160;77.6;75.3
80;2021-10-07;195;428;442295;429588;77.6;75.4
80;2021-10-08;253;689;442548;430277;77.7;75.5
80;2021-10-09;283;479;442831;430756;77.7;75.6
80;2021-10-10;26;34;442857;430790;77.7;75.6
80;2021-10-11;153;224;443010;431014;77.8;75.6
80;2021-10-12;186;418;443196;431432;77.8;75.7
80;2021-10-13;215;269;443411;431701;77.8;75.8
80;2021-10-14;223;311;443634;432012;77.9;75.8
81;2020-12-27;1;0;1;0;0.0;0.0
81;2020-12-28;0;0;1;0;0.0;0.0
81;2020-12-29;0;0;1;0;0.0;0.0
81;2020-12-30;1;0;2;0;0.0;0.0
81;2020-12-31;1;0;3;0;0.0;0.0
81;2021-01-01;0;0;3;0;0.0;0.0
81;2021-01-02;0;0;3;0;0.0;0.0
81;2021-01-03;0;0;3;0;0.0;0.0
81;2021-01-04;1;0;4;0;0.0;0.0
81;2021-01-05;0;0;4;0;0.0;0.0
81;2021-01-06;5;0;9;0;0.0;0.0
81;2021-01-07;265;0;274;0;0.1;0.0
81;2021-01-08;312;1;586;1;0.2;0.0
81;2021-01-09;74;1;660;2;0.2;0.0
81;2021-01-10;1;0;661;2;0.2;0.0
81;2021-01-11;133;0;794;2;0.2;0.0
81;2021-01-12;167;0;961;2;0.2;0.0
81;2021-01-13;234;1;1195;3;0.3;0.0
81;2021-01-14;963;7;2158;10;0.6;0.0
81;2021-01-15;523;3;2681;13;0.7;0.0
81;2021-01-16;71;1;2752;14;0.7;0.0
81;2021-01-17;0;0;2752;14;0.7;0.0
81;2021-01-18;581;3;3333;17;0.9;0.0
81;2021-01-19;662;4;3995;21;1.0;0.0
81;2021-01-20;754;2;4749;23;1.2;0.0
81;2021-01-21;1184;16;5933;39;1.5;0.0
81;2021-01-22;857;3;6790;42;1.8;0.0
81;2021-01-23;221;2;7011;44;1.8;0.0
81;2021-01-24;102;0;7113;44;1.8;0.0
81;2021-01-25;570;6;7683;50;2.0;0.0
81;2021-01-26;634;6;8317;56;2.1;0.0
81;2021-01-27;552;3;8869;59;2.3;0.0
81;2021-01-28;700;209;9569;268;2.5;0.1
81;2021-01-29;303;184;9872;452;2.5;0.1
81;2021-01-30;203;37;10075;489;2.6;0.1
81;2021-01-31;104;1;10179;490;2.6;0.1
81;2021-02-01;321;130;10500;620;2.7;0.2
81;2021-02-02;445;143;10945;763;2.8;0.2
81;2021-02-03;476;220;11421;983;2.9;0.3
81;2021-02-04;1449;725;12870;1708;3.3;0.4
81;2021-02-05;870;316;13740;2024;3.5;0.5
81;2021-02-06;274;18;14014;2042;3.6;0.5
81;2021-02-07;103;0;14117;2042;3.6;0.5
81;2021-02-08;276;219;14393;2261;3.7;0.6
81;2021-02-09;420;217;14813;2478;3.8;0.6
81;2021-02-10;371;286;15184;2764;3.9;0.7
81;2021-02-11;651;397;15835;3161;4.1;0.8
81;2021-02-12;581;544;16416;3705;4.2;1.0
81;2021-02-13;188;156;16604;3861;4.3;1.0
81;2021-02-14;100;1;16704;3862;4.3;1.0
81;2021-02-15;234;482;16938;4344;4.4;1.1
81;2021-02-16;282;617;17220;4961;4.4;1.3
81;2021-02-17;241;521;17461;5482;4.5;1.4
81;2021-02-18;483;671;17944;6153;4.6;1.6
81;2021-02-19;572;416;18516;6569;4.8;1.7
81;2021-02-20;322;282;18838;6851;4.9;1.8
81;2021-02-21;23;80;18861;6931;4.9;1.8
81;2021-02-22;233;535;19094;7466;4.9;1.9
81;2021-02-23;169;591;19263;8057;5.0;2.1
81;2021-02-24;291;629;19554;8686;5.0;2.2
81;2021-02-25;720;1054;20274;9740;5.2;2.5
81;2021-02-26;911;957;21185;10697;5.5;2.8
81;2021-02-27;275;242;21460;10939;5.5;2.8
81;2021-02-28;21;88;21481;11027;5.5;2.8
81;2021-03-01;208;410;21689;11437;5.6;2.9
81;2021-03-02;364;544;22053;11981;5.7;3.1
81;2021-03-03;462;422;22515;12403;5.8;3.2
81;2021-03-04;1061;460;23576;12863;6.1;3.3
81;2021-03-05;1406;397;24982;13260;6.4;3.4
81;2021-03-06;982;171;25964;13431;6.7;3.5
81;2021-03-07;154;102;26118;13533;6.7;3.5
81;2021-03-08;466;362;26584;13895;6.9;3.6
81;2021-03-09;816;373;27400;14268;7.1;3.7
81;2021-03-10;898;396;28298;14664;7.3;3.8
81;2021-03-11;1352;360;29650;15024;7.6;3.9
81;2021-03-12;1690;307;31340;15331;8.1;4.0
81;2021-03-13;1031;190;32371;15521;8.3;4.0
81;2021-03-14;66;82;32437;15603;8.4;4.0
81;2021-03-15;1093;225;33530;15828;8.6;4.1
81;2021-03-16;724;231;34254;16059;8.8;4.1
81;2021-03-17;893;280;35147;16339;9.1;4.2
81;2021-03-18;970;579;36117;16918;9.3;4.4
81;2021-03-19;1271;460;37388;17378;9.6;4.5
81;2021-03-20;677;285;38065;17663;9.8;4.6
81;2021-03-21;139;22;38204;17685;9.8;4.6
81;2021-03-22;932;279;39136;17964;10.1;4.6
81;2021-03-23;1420;224;40556;18188;10.5;4.7
81;2021-03-24;1606;267;42162;18455;10.9;4.8
81;2021-03-25;2028;327;44190;18782;11.4;4.8
81;2021-03-26;2100;289;46290;19071;11.9;4.9
81;2021-03-27;1092;38;47382;19109;12.2;4.9
81;2021-03-28;734;41;48116;19150;12.4;4.9
81;2021-03-29;2866;196;50982;19346;13.1;5.0
81;2021-03-30;3055;218;54037;19564;13.9;5.0
81;2021-03-31;2691;302;56728;19866;14.6;5.1
81;2021-04-01;3315;570;60043;20436;15.5;5.3
81;2021-04-02;2615;376;62658;20812;16.2;5.4
81;2021-04-03;1147;306;63805;21118;16.4;5.4
81;2021-04-04;1403;25;65208;21143;16.8;5.5
81;2021-04-05;718;21;65926;21164;17.0;5.5
81;2021-04-06;1599;520;67525;21684;17.4;5.6
81;2021-04-07;1817;586;69342;22270;17.9;5.7
81;2021-04-08;2619;828;71961;23098;18.6;6.0
81;2021-04-09;3052;479;75013;23577;19.3;6.1
81;2021-04-10;1475;519;76488;24096;19.7;6.2
81;2021-04-11;1299;71;77787;24167;20.1;6.2
81;2021-04-12;1220;685;79007;24852;20.4;6.4
81;2021-04-13;2528;795;81535;25647;21.0;6.6
81;2021-04-14;2506;836;84041;26483;21.7;6.8
81;2021-04-15;3099;1204;87140;27687;22.5;7.1
81;2021-04-16;2823;1098;89963;28785;23.2;7.4
81;2021-04-17;1145;300;91108;29085;23.5;7.5
81;2021-04-18;519;146;91627;29231;23.6;7.5
81;2021-04-19;913;823;92540;30054;23.9;7.7
81;2021-04-20;2270;1170;94810;31224;24.4;8.0
81;2021-04-21;2224;1007;97034;32231;25.0;8.3
81;2021-04-22;2816;1065;99850;33296;25.7;8.6
81;2021-04-23;2886;975;102736;34271;26.5;8.8
81;2021-04-24;1326;742;104062;35013;26.8;9.0
81;2021-04-25;454;716;104516;35729;26.9;9.2
81;2021-04-26;1061;2424;105577;38153;27.2;9.8
81;2021-04-27;1595;2362;107172;40515;27.6;10.4
81;2021-04-28;1427;2400;108599;42915;28.0;11.1
81;2021-04-29;1818;2748;110417;45663;28.5;11.8
81;2021-04-30;2013;2354;112430;48017;29.0;12.4
81;2021-05-01;362;686;112792;48703;29.1;12.6
81;2021-05-02;291;1379;113083;50082;29.2;12.9
81;2021-05-03;1115;1170;114198;51252;29.4;13.2
81;2021-05-04;2620;1912;116818;53164;30.1;13.7
81;2021-05-05;2016;1936;118834;55100;30.6;14.2
81;2021-05-06;2748;3458;121582;58558;31.3;15.1
81;2021-05-07;2128;2882;123710;61440;31.9;15.8
81;2021-05-08;962;878;124672;62318;32.1;16.1
81;2021-05-09;534;1350;125206;63668;32.3;16.4
81;2021-05-10;823;1600;126029;65268;32.5;16.8
81;2021-05-11;1661;2576;127690;67844;32.9;17.5
81;2021-05-12;1640;2464;129330;70308;33.3;18.1
81;2021-05-13;1216;564;130546;70872;33.7;18.3
81;2021-05-14;1890;1725;132436;72597;34.1;18.7
81;2021-05-15;1511;622;133947;73219;34.5;18.9
81;2021-05-16;1368;417;135315;73636;34.9;19.0
81;2021-05-17;1167;864;136482;74500;35.2;19.2
81;2021-05-18;1702;1429;138184;75929;35.6;19.6
81;2021-05-19;2641;1244;140825;77173;36.3;19.9
81;2021-05-20;2968;1352;143793;78525;37.1;20.2
81;2021-05-21;2739;1118;146532;79643;37.8;20.5
81;2021-05-22;2815;523;149347;80166;38.5;20.7
81;2021-05-23;1178;74;150525;80240;38.8;20.7
81;2021-05-24;837;83;151362;80323;39.0;20.7
81;2021-05-25;2490;1104;153852;81427;39.7;21.0
81;2021-05-26;1891;801;155743;82228;40.2;21.2
81;2021-05-27;2555;1547;158298;83775;40.8;21.6
81;2021-05-28;2566;1663;160864;85438;41.5;22.0
81;2021-05-29;1400;544;162264;85982;41.8;22.2
81;2021-05-30;935;219;163199;86201;42.1;22.2
81;2021-05-31;1183;1340;164382;87541;42.4;22.6
81;2021-06-01;1779;2695;166161;90236;42.8;23.3
81;2021-06-02;2006;2447;168167;92683;43.4;23.9
81;2021-06-03;2003;2532;170170;95215;43.9;24.5
81;2021-06-04;1844;2946;172014;98161;44.3;25.3
81;2021-06-05;1757;1307;173771;99468;44.8;25.6
81;2021-06-06;370;366;174141;99834;44.9;25.7
81;2021-06-07;1209;1540;175350;101374;45.2;26.1
81;2021-06-08;2369;2386;177719;103760;45.8;26.7
81;2021-06-09;2438;1868;180157;105628;46.4;27.2
81;2021-06-10;1278;1563;181435;107191;46.8;27.6
81;2021-06-11;2657;2200;184092;109391;47.5;28.2
81;2021-06-12;1659;1039;185751;110430;47.9;28.5
81;2021-06-13;444;476;186195;110906;48.0;28.6
81;2021-06-14;771;1418;186966;112324;48.2;29.0
81;2021-06-15;1677;3501;188643;115825;48.6;29.9
81;2021-06-16;1269;3013;189912;118838;49.0;30.6
81;2021-06-17;1344;2525;191256;121363;49.3;31.3
81;2021-06-18;1836;2770;193092;124133;49.8;32.0
81;2021-06-19;824;951;193916;125084;50.0;32.2
81;2021-06-20;405;536;194321;125620;50.1;32.4
81;2021-06-21;425;1038;194746;126658;50.2;32.7
81;2021-06-22;1061;2568;195807;129226;50.5;33.3
81;2021-06-23;1142;2159;196949;131385;50.8;33.9
81;2021-06-24;1115;1939;198064;133324;51.1;34.4
81;2021-06-25;1238;2866;199302;136190;51.4;35.1
81;2021-06-26;721;1713;200023;137903;51.6;35.6
81;2021-06-27;526;1646;200549;139549;51.7;36.0
81;2021-06-28;476;1540;201025;141089;51.8;36.4
81;2021-06-29;1079;2635;202104;143724;52.1;37.1
81;2021-06-30;1043;3153;203147;146877;52.4;37.9
81;2021-07-01;1101;2627;204248;149504;52.7;38.5
81;2021-07-02;1070;2860;205318;152364;52.9;39.3
81;2021-07-03;732;2829;206050;155193;53.1;40.0
81;2021-07-04;268;1010;206318;156203;53.2;40.3
81;2021-07-05;702;1626;207020;157829;53.4;40.7
81;2021-07-06;975;3176;207995;161005;53.6;41.5
81;2021-07-07;1059;2442;209054;163447;53.9;42.1
81;2021-07-08;1030;2236;210084;165683;54.2;42.7
81;2021-07-09;1147;2704;211231;168387;54.5;43.4
81;2021-07-10;806;1523;212037;169910;54.7;43.8
81;2021-07-11;436;1012;212473;170922;54.8;44.1
81;2021-07-12;785;1725;213258;172647;55.0;44.5
81;2021-07-13;2081;3144;215339;175791;55.5;45.3
81;2021-07-14;1443;1573;216782;177364;55.9;45.7
81;2021-07-15;2545;2765;219327;180129;56.5;46.4
81;2021-07-16;2032;3030;221359;183159;57.1;47.2
81;2021-07-17;1219;2455;222578;185614;57.4;47.9
81;2021-07-18;672;1131;223250;186745;57.6;48.1
81;2021-07-19;1256;1733;224506;188478;57.9;48.6
81;2021-07-20;3064;2807;227570;191285;58.7;49.3
81;2021-07-21;3488;2347;231058;193632;59.6;49.9
81;2021-07-22;3557;2096;234615;195728;60.5;50.5
81;2021-07-23;3172;3250;237787;198978;61.3;51.3
81;2021-07-24;2519;1723;240306;200701;62.0;51.7
81;2021-07-25;1684;711;241990;201412;62.4;51.9
81;2021-07-26;2015;1548;244005;202960;62.9;52.3
81;2021-07-27;3619;2545;247624;205505;63.8;53.0
81;2021-07-28;3052;2210;250676;207715;64.6;53.5
81;2021-07-29;3354;1782;254030;209497;65.5;54.0
81;2021-07-30;2828;2260;256858;211757;66.2;54.6
81;2021-07-31;1947;1015;258805;212772;66.7;54.9
81;2021-08-01;835;639;259640;213411;66.9;55.0
81;2021-08-02;1082;989;260722;214400;67.2;55.3
81;2021-08-03;2362;2116;263084;216516;67.8;55.8
81;2021-08-04;2031;1535;265115;218051;68.3;56.2
81;2021-08-05;1544;1877;266659;219928;68.7;56.7
81;2021-08-06;1725;1970;268384;221898;69.2;57.2
81;2021-08-07;985;1043;269369;222941;69.4;57.5
81;2021-08-08;437;708;269806;223649;69.6;57.7
81;2021-08-09;806;659;270612;224308;69.8;57.8
81;2021-08-10;1610;2757;272222;227065;70.2;58.5
81;2021-08-11;1110;2410;273332;229475;70.5;59.2
81;2021-08-12;1063;2249;274395;231724;70.7;59.7
81;2021-08-13;873;2473;275268;234197;71.0;60.4
81;2021-08-14;501;1873;275769;236070;71.1;60.9
81;2021-08-15;141;1100;275910;237170;71.1;61.1
81;2021-08-16;631;1816;276541;238986;71.3;61.6
81;2021-08-17;1347;3101;277888;242087;71.6;62.4
81;2021-08-18;1067;2360;278955;244447;71.9;63.0
81;2021-08-19;941;2267;279896;246714;72.2;63.6
81;2021-08-20;928;2354;280824;249068;72.4;64.2
81;2021-08-21;471;1538;281295;250606;72.5;64.6
81;2021-08-22;184;931;281479;251537;72.6;64.8
81;2021-08-23;487;1260;281966;252797;72.7;65.2
81;2021-08-24;852;2543;282818;255340;72.9;65.8
81;2021-08-25;718;2054;283536;257394;73.1;66.4
81;2021-08-26;855;2110;284391;259504;73.3;66.9
81;2021-08-27;853;2185;285244;261689;73.5;67.5
81;2021-08-28;484;1417;285728;263106;73.7;67.8
81;2021-08-29;163;832;285891;263938;73.7;68.0
81;2021-08-30;419;1183;286310;265121;73.8;68.3
81;2021-08-31;832;2020;287142;267141;74.0;68.9
81;2021-09-01;659;1232;287801;268373;74.2;69.2
81;2021-09-02;574;1077;288375;269450;74.3;69.5
81;2021-09-03;581;1272;288956;270722;74.5;69.8
81;2021-09-04;496;864;289452;271586;74.6;70.0
81;2021-09-05;97;222;289549;271808;74.6;70.1
81;2021-09-06;279;463;289828;272271;74.7;70.2
81;2021-09-07;387;1092;290215;273363;74.8;70.5
81;2021-09-08;438;1069;290653;274432;74.9;70.7
81;2021-09-09;367;809;291020;275241;75.0;71.0
81;2021-09-10;395;962;291415;276203;75.1;71.2
81;2021-09-11;407;853;291822;277056;75.2;71.4
81;2021-09-12;79;216;291901;277272;75.3;71.5
81;2021-09-13;231;461;292132;277733;75.3;71.6
81;2021-09-14;504;730;292636;278463;75.4;71.8
81;2021-09-15;452;765;293088;279228;75.6;72.0
81;2021-09-16;336;548;293424;279776;75.6;72.1
81;2021-09-17;415;841;293839;280617;75.8;72.3
81;2021-09-18;260;697;294099;281314;75.8;72.5
81;2021-09-19;52;164;294151;281478;75.8;72.6
81;2021-09-20;112;323;294263;281801;75.9;72.6
81;2021-09-21;266;596;294529;282397;75.9;72.8
81;2021-09-22;214;664;294743;283061;76.0;73.0
81;2021-09-23;165;662;294908;283723;76.0;73.1
81;2021-09-24;307;704;295215;284427;76.1;73.3
81;2021-09-25;173;674;295388;285101;76.2;73.5
81;2021-09-26;36;116;295424;285217;76.2;73.5
81;2021-09-27;136;272;295560;285489;76.2;73.6
81;2021-09-28;185;362;295745;285851;76.2;73.7
81;2021-09-29;248;517;295993;286368;76.3;73.8
81;2021-09-30;143;292;296136;286660;76.3;73.9
81;2021-10-01;244;426;296380;287086;76.4;74.0
81;2021-10-02;181;415;296561;287501;76.5;74.1
81;2021-10-03;44;105;296605;287606;76.5;74.1
81;2021-10-04;88;209;296693;287815;76.5;74.2
81;2021-10-05;135;320;296828;288135;76.5;74.3
81;2021-10-06;212;471;297040;288606;76.6;74.4
81;2021-10-07;146;306;297186;288912;76.6;74.5
81;2021-10-08;193;500;297379;289412;76.7;74.6
81;2021-10-09;150;320;297529;289732;76.7;74.7
81;2021-10-10;52;71;297581;289803;76.7;74.7
81;2021-10-11;107;181;297688;289984;76.7;74.8
81;2021-10-12;139;249;297827;290233;76.8;74.8
81;2021-10-13;197;288;298024;290521;76.8;74.9
81;2021-10-14;143;257;298167;290778;76.9;75.0
82;2020-12-27;1;0;1;0;0.0;0.0
82;2020-12-28;2;0;3;0;0.0;0.0
82;2020-12-29;0;0;3;0;0.0;0.0
82;2020-12-30;0;0;3;0;0.0;0.0
82;2020-12-31;0;0;3;0;0.0;0.0
82;2021-01-01;0;0;3;0;0.0;0.0
82;2021-01-02;0;0;3;0;0.0;0.0
82;2021-01-03;0;0;3;0;0.0;0.0
82;2021-01-04;0;0;3;0;0.0;0.0
82;2021-01-05;86;0;89;0;0.0;0.0
82;2021-01-06;1;0;90;0;0.0;0.0
82;2021-01-07;75;0;165;0;0.1;0.0
82;2021-01-08;46;0;211;0;0.1;0.0
82;2021-01-09;77;0;288;0;0.1;0.0
82;2021-01-10;0;0;288;0;0.1;0.0
82;2021-01-11;94;0;382;0;0.1;0.0
82;2021-01-12;285;0;667;0;0.3;0.0
82;2021-01-13;336;1;1003;1;0.4;0.0
82;2021-01-14;443;5;1446;6;0.6;0.0
82;2021-01-15;612;3;2058;9;0.8;0.0
82;2021-01-16;230;3;2288;12;0.9;0.0
82;2021-01-17;89;0;2377;12;0.9;0.0
82;2021-01-18;432;0;2809;12;1.1;0.0
82;2021-01-19;482;1;3291;13;1.3;0.0
82;2021-01-20;663;4;3954;17;1.5;0.0
82;2021-01-21;447;2;4401;19;1.7;0.0
82;2021-01-22;483;2;4884;21;1.9;0.0
82;2021-01-23;151;0;5035;21;1.9;0.0
82;2021-01-24;0;0;5035;21;1.9;0.0
82;2021-01-25;375;0;5410;21;2.1;0.0
82;2021-01-26;468;0;5878;21;2.2;0.0
82;2021-01-27;520;1;6398;22;2.4;0.0
82;2021-01-28;587;35;6985;57;2.7;0.0
82;2021-01-29;405;108;7390;165;2.8;0.1
82;2021-01-30;44;22;7434;187;2.8;0.1
82;2021-01-31;2;0;7436;187;2.8;0.1
82;2021-02-01;292;55;7728;242;2.9;0.1
82;2021-02-02;344;102;8072;344;3.1;0.1
82;2021-02-03;462;66;8534;410;3.2;0.2
82;2021-02-04;768;216;9302;626;3.5;0.2
82;2021-02-05;480;145;9782;771;3.7;0.3
82;2021-02-06;93;39;9875;810;3.8;0.3
82;2021-02-07;29;79;9904;889;3.8;0.3
82;2021-02-08;151;225;10055;1114;3.8;0.4
82;2021-02-09;238;397;10293;1511;3.9;0.6
82;2021-02-10;271;599;10564;2110;4.0;0.8
82;2021-02-11;225;400;10789;2510;4.1;1.0
82;2021-02-12;190;608;10979;3118;4.2;1.2
82;2021-02-13;60;117;11039;3235;4.2;1.2
82;2021-02-14;5;80;11044;3315;4.2;1.3
82;2021-02-15;216;304;11260;3619;4.3;1.4
82;2021-02-16;280;391;11540;4010;4.4;1.5
82;2021-02-17;359;522;11899;4532;4.5;1.7
82;2021-02-18;508;506;12407;5038;4.7;1.9
82;2021-02-19;492;542;12899;5580;4.9;2.1
82;2021-02-20;78;139;12977;5719;4.9;2.2
82;2021-02-21;0;0;12977;5719;4.9;2.2
82;2021-02-22;200;407;13177;6126;5.0;2.3
82;2021-02-23;277;469;13454;6595;5.1;2.5
82;2021-02-24;285;456;13739;7051;5.2;2.7
82;2021-02-25;637;510;14376;7561;5.5;2.9
82;2021-02-26;648;398;15024;7959;5.7;3.0
82;2021-02-27;214;75;15238;8034;5.8;3.1
82;2021-02-28;30;7;15268;8041;5.8;3.1
82;2021-03-01;291;230;15559;8271;5.9;3.1
82;2021-03-02;495;405;16054;8676;6.1;3.3
82;2021-03-03;440;387;16494;9063;6.3;3.5
82;2021-03-04;600;301;17094;9364;6.5;3.6
82;2021-03-05;681;382;17775;9746;6.8;3.7
82;2021-03-06;693;47;18468;9793;7.0;3.7
82;2021-03-07;302;4;18770;9797;7.1;3.7
82;2021-03-08;603;154;19373;9951;7.4;3.8
82;2021-03-09;582;256;19955;10207;7.6;3.9
82;2021-03-10;779;248;20734;10455;7.9;4.0
82;2021-03-11;977;286;21711;10741;8.3;4.1
82;2021-03-12;992;105;22703;10846;8.6;4.1
82;2021-03-13;564;54;23267;10900;8.9;4.2
82;2021-03-14;61;5;23328;10905;8.9;4.2
82;2021-03-15;485;326;23813;11231;9.1;4.3
82;2021-03-16;197;332;24010;11563;9.1;4.4
82;2021-03-17;191;294;24201;11857;9.2;4.5
82;2021-03-18;279;350;24480;12207;9.3;4.6
82;2021-03-19;531;312;25011;12519;9.5;4.8
82;2021-03-20;251;58;25262;12577;9.6;4.8
82;2021-03-21;23;0;25285;12577;9.6;4.8
82;2021-03-22;406;323;25691;12900;9.8;4.9
82;2021-03-23;601;314;26292;13214;10.0;5.0
82;2021-03-24;621;332;26913;13546;10.2;5.2
82;2021-03-25;928;246;27841;13792;10.6;5.3
82;2021-03-26;1216;272;29057;14064;11.1;5.4
82;2021-03-27;479;79;29536;14143;11.2;5.4
82;2021-03-28;136;2;29672;14145;11.3;5.4
82;2021-03-29;925;379;30597;14524;11.7;5.5
82;2021-03-30;1188;280;31785;14804;12.1;5.6
82;2021-03-31;1018;263;32803;15067;12.5;5.7
82;2021-04-01;1070;199;33873;15266;12.9;5.8
82;2021-04-02;1213;286;35086;15552;13.4;5.9
82;2021-04-03;715;132;35801;15684;13.6;6.0
82;2021-04-04;276;14;36077;15698;13.7;6.0
82;2021-04-05;388;20;36465;15718;13.9;6.0
82;2021-04-06;953;512;37418;16230;14.2;6.2
82;2021-04-07;1016;498;38434;16728;14.6;6.4
82;2021-04-08;1454;418;39888;17146;15.2;6.5
82;2021-04-09;1656;474;41544;17620;15.8;6.7
82;2021-04-10;1716;103;43260;17723;16.5;6.7
82;2021-04-11;560;20;43820;17743;16.7;6.8
82;2021-04-12;1348;294;45168;18037;17.2;6.9
82;2021-04-13;1626;275;46794;18312;17.8;7.0
82;2021-04-14;1412;302;48206;18614;18.4;7.1
82;2021-04-15;1781;325;49987;18939;19.0;7.2
82;2021-04-16;1542;336;51529;19275;19.6;7.3
82;2021-04-17;1243;71;52772;19346;20.1;7.4
82;2021-04-18;560;15;53332;19361;20.3;7.4
82;2021-04-19;958;360;54290;19721;20.7;7.5
82;2021-04-20;1267;403;55557;20124;21.2;7.7
82;2021-04-21;1217;374;56774;20498;21.6;7.8
82;2021-04-22;1452;295;58226;20793;22.2;7.9
82;2021-04-23;1076;683;59302;21476;22.6;8.2
82;2021-04-24;1188;265;60490;21741;23.0;8.3
82;2021-04-25;736;49;61226;21790;23.3;8.3
82;2021-04-26;748;810;61974;22600;23.6;8.6
82;2021-04-27;905;925;62879;23525;23.9;9.0
82;2021-04-28;921;898;63800;24423;24.3;9.3
82;2021-04-29;1107;912;64907;25335;24.7;9.6
82;2021-04-30;1042;891;65949;26226;25.1;10.0
82;2021-05-01;1143;258;67092;26484;25.5;10.1
82;2021-05-02;697;145;67789;26629;25.8;10.1
82;2021-05-03;410;1217;68199;27846;26.0;10.6
82;2021-05-04;862;1170;69061;29016;26.3;11.0
82;2021-05-05;568;1176;69629;30192;26.5;11.5
82;2021-05-06;848;1420;70477;31612;26.8;12.0
82;2021-05-07;734;1459;71211;33071;27.1;12.6
82;2021-05-08;934;520;72145;33591;27.5;12.8
82;2021-05-09;753;578;72898;34169;27.8;13.0
82;2021-05-10;850;1366;73748;35535;28.1;13.5
82;2021-05-11;1157;1348;74905;36883;28.5;14.0
82;2021-05-12;1015;1345;75920;38228;28.9;14.6
82;2021-05-13;1454;432;77374;38660;29.5;14.7
82;2021-05-14;1690;1240;79064;39900;30.1;15.2
82;2021-05-15;1934;697;80998;40597;30.8;15.5
82;2021-05-16;558;114;81556;40711;31.1;15.5
82;2021-05-17;1090;1173;82646;41884;31.5;15.9
82;2021-05-18;1465;1190;84111;43074;32.0;16.4
82;2021-05-19;1272;974;85383;44048;32.5;16.8
82;2021-05-20;1408;1160;86791;45208;33.0;17.2
82;2021-05-21;1411;1219;88202;46427;33.6;17.7
82;2021-05-22;2067;631;90269;47058;34.4;17.9
82;2021-05-23;705;117;90974;47175;34.6;18.0
82;2021-05-24;1441;265;92415;47440;35.2;18.1
82;2021-05-25;1444;963;93859;48403;35.7;18.4
82;2021-05-26;1411;920;95270;49323;36.3;18.8
82;2021-05-27;1461;1025;96731;50348;36.8;19.2
82;2021-05-28;1540;1146;98271;51494;37.4;19.6
82;2021-05-29;1496;545;99767;52039;38.0;19.8
82;2021-05-30;402;101;100169;52140;38.1;19.9
82;2021-05-31;1490;991;101659;53131;38.7;20.2
82;2021-06-01;1750;1052;103409;54183;39.4;20.6
82;2021-06-02;1477;1007;104886;55190;39.9;21.0
82;2021-06-03;1489;1184;106375;56374;40.5;21.5
82;2021-06-04;2250;1306;108625;57680;41.4;22.0
82;2021-06-05;2267;987;110892;58667;42.2;22.3
82;2021-06-06;329;133;111221;58800;42.4;22.4
82;2021-06-07;957;1275;112178;60075;42.7;22.9
82;2021-06-08;1445;1138;113623;61213;43.3;23.3
82;2021-06-09;1707;1142;115330;62355;43.9;23.7
82;2021-06-10;1441;1208;116771;63563;44.5;24.2
82;2021-06-11;1922;1128;118693;64691;45.2;24.6
82;2021-06-12;2392;1395;121085;66086;46.1;25.2
82;2021-06-13;379;113;121464;66199;46.3;25.2
82;2021-06-14;1213;1082;122677;67281;46.7;25.6
82;2021-06-15;1462;1245;124139;68526;47.3;26.1
82;2021-06-16;1749;1168;125888;69694;47.9;26.5
82;2021-06-17;1219;1472;127107;71166;48.4;27.1
82;2021-06-18;1469;1439;128576;72605;49.0;27.6
82;2021-06-19;2269;981;130845;73586;49.8;28.0
82;2021-06-20;269;173;131114;73759;49.9;28.1
82;2021-06-21;484;1361;131598;75120;50.1;28.6
82;2021-06-22;893;1710;132491;76830;50.5;29.3
82;2021-06-23;1238;1587;133729;78417;50.9;29.9
82;2021-06-24;756;1904;134485;80321;51.2;30.6
82;2021-06-25;739;1936;135224;82257;51.5;31.3
82;2021-06-26;1239;2146;136463;84403;52.0;32.1
82;2021-06-27;195;440;136658;84843;52.0;32.3
82;2021-06-28;328;1411;136986;86254;52.2;32.8
82;2021-06-29;518;1842;137504;88096;52.4;33.5
82;2021-06-30;947;1912;138451;90008;52.7;34.3
82;2021-07-01;658;1633;139109;91641;53.0;34.9
82;2021-07-02;931;2295;140040;93936;53.3;35.8
82;2021-07-03;858;2340;140898;96276;53.7;36.7
82;2021-07-04;120;439;141018;96715;53.7;36.8
82;2021-07-05;445;1561;141463;98276;53.9;37.4
82;2021-07-06;513;1867;141976;100143;54.1;38.1
82;2021-07-07;793;1775;142769;101918;54.4;38.8
82;2021-07-08;504;1504;143273;103422;54.6;39.4
82;2021-07-09;781;2155;144054;105577;54.9;40.2
82;2021-07-10;706;2218;144760;107795;55.1;41.0
82;2021-07-11;39;380;144799;108175;55.1;41.2
82;2021-07-12;578;1884;145377;110059;55.4;41.9
82;2021-07-13;714;2003;146091;112062;55.6;42.7
82;2021-07-14;617;741;146708;112803;55.9;43.0
82;2021-07-15;859;1751;147567;114554;56.2;43.6
82;2021-07-16;1436;2638;149003;117192;56.7;44.6
82;2021-07-17;560;2182;149563;119374;57.0;45.5
82;2021-07-18;14;41;149577;119415;57.0;45.5
82;2021-07-19;736;2072;150313;121487;57.2;46.3
82;2021-07-20;920;1883;151233;123370;57.6;47.0
82;2021-07-21;1289;1762;152522;125132;58.1;47.6
82;2021-07-22;1083;1767;153605;126899;58.5;48.3
82;2021-07-23;1056;2990;154661;129889;58.9;49.5
82;2021-07-24;1102;1490;155763;131379;59.3;50.0
82;2021-07-25;303;74;156066;131453;59.4;50.1
82;2021-07-26;950;1896;157016;133349;59.8;50.8
82;2021-07-27;1324;1641;158340;134990;60.3;51.4
82;2021-07-28;1469;1499;159809;136489;60.9;52.0
82;2021-07-29;1331;1534;161140;138023;61.4;52.6
82;2021-07-30;1537;2477;162677;140500;61.9;53.5
82;2021-07-31;459;296;163136;140796;62.1;53.6
82;2021-08-01;273;50;163409;140846;62.2;53.6
82;2021-08-02;1271;879;164680;141725;62.7;54.0
82;2021-08-03;1435;832;166115;142557;63.3;54.3
82;2021-08-04;1363;1029;167478;143586;63.8;54.7
82;2021-08-05;1491;601;168969;144187;64.3;54.9
82;2021-08-06;996;648;169965;144835;64.7;55.2
82;2021-08-07;923;1197;170888;146032;65.1;55.6
82;2021-08-08;157;65;171045;146097;65.1;55.6
82;2021-08-09;1071;899;172116;146996;65.5;56.0
82;2021-08-10;1289;916;173405;147912;66.0;56.3
82;2021-08-11;1264;1123;174669;149035;66.5;56.7
82;2021-08-12;1473;946;176142;149981;67.1;57.1
82;2021-08-13;1413;997;177555;150978;67.6;57.5
82;2021-08-14;314;486;177869;151464;67.7;57.7
82;2021-08-15;61;38;177930;151502;67.8;57.7
82;2021-08-16;781;1459;178711;152961;68.0;58.2
82;2021-08-17;1064;1235;179775;154196;68.5;58.7
82;2021-08-18;616;848;180391;155044;68.7;59.0
82;2021-08-19;1012;1147;181403;156191;69.1;59.5
82;2021-08-20;1034;1907;182437;158098;69.5;60.2
82;2021-08-21;495;991;182932;159089;69.7;60.6
82;2021-08-22;21;55;182953;159144;69.7;60.6
82;2021-08-23;745;1292;183698;160436;69.9;61.1
82;2021-08-24;863;1117;184561;161553;70.3;61.5
82;2021-08-25;849;1538;185410;163091;70.6;62.1
82;2021-08-26;598;1108;186008;164199;70.8;62.5
82;2021-08-27;898;1686;186906;165885;71.2;63.2
82;2021-08-28;211;616;187117;166501;71.3;63.4
82;2021-08-29;44;49;187161;166550;71.3;63.4
82;2021-08-30;431;1015;187592;167565;71.4;63.8
82;2021-08-31;339;1004;187931;168569;71.6;64.2
82;2021-09-01;721;1356;188652;169925;71.8;64.7
82;2021-09-02;406;1235;189058;171160;72.0;65.2
82;2021-09-03;500;1738;189558;172898;72.2;65.8
82;2021-09-04;426;691;189984;173589;72.3;66.1
82;2021-09-05;6;23;189990;173612;72.3;66.1
82;2021-09-06;374;1141;190364;174753;72.5;66.5
82;2021-09-07;209;880;190573;175633;72.6;66.9
82;2021-09-08;495;1169;191068;176802;72.8;67.3
82;2021-09-09;249;930;191317;177732;72.8;67.7
82;2021-09-10;490;1249;191807;178981;73.0;68.2
82;2021-09-11;212;475;192019;179456;73.1;68.3
82;2021-09-12;12;29;192031;179485;73.1;68.3
82;2021-09-13;298;851;192329;180336;73.2;68.7
82;2021-09-14;210;802;192539;181138;73.3;69.0
82;2021-09-15;308;1166;192847;182304;73.4;69.4
82;2021-09-16;221;496;193068;182800;73.5;69.6
82;2021-09-17;189;495;193257;183295;73.6;69.8
82;2021-09-18;326;1082;193583;184377;73.7;70.2
82;2021-09-19;1;14;193584;184391;73.7;70.2
82;2021-09-20;141;416;193725;184807;73.8;70.4
82;2021-09-21;94;382;193819;185189;73.8;70.5
82;2021-09-22;137;455;193956;185644;73.9;70.7
82;2021-09-23;112;383;194068;186027;73.9;70.8
82;2021-09-24;211;600;194279;186627;74.0;71.1
82;2021-09-25;231;659;194510;187286;74.1;71.3
82;2021-09-26;5;10;194515;187296;74.1;71.3
82;2021-09-27;100;453;194615;187749;74.1;71.5
82;2021-09-28;90;229;194705;187978;74.1;71.6
82;2021-09-29;231;479;194936;188457;74.2;71.8
82;2021-09-30;111;250;195047;188707;74.3;71.9
82;2021-10-01;197;372;195244;189079;74.3;72.0
82;2021-10-02;133;273;195377;189352;74.4;72.1
82;2021-10-03;4;1;195381;189353;74.4;72.1
82;2021-10-04;120;415;195501;189768;74.4;72.3
82;2021-10-05;129;274;195630;190042;74.5;72.4
82;2021-10-06;167;343;195797;190385;74.6;72.5
82;2021-10-07;63;124;195860;190509;74.6;72.5
82;2021-10-08;291;387;196151;190896;74.7;72.7
82;2021-10-09;122;247;196273;191143;74.7;72.8
82;2021-10-10;2;14;196275;191157;74.7;72.8
82;2021-10-11;94;227;196369;191384;74.8;72.9
82;2021-10-12;88;140;196457;191524;74.8;72.9
82;2021-10-13;187;293;196644;191817;74.9;73.0
82;2021-10-14;42;67;196686;191884;74.9;73.1
83;2020-12-27;2;0;2;0;0.0;0.0
83;2020-12-28;0;0;2;0;0.0;0.0
83;2020-12-29;2;0;4;0;0.0;0.0
83;2020-12-30;3;0;7;0;0.0;0.0
83;2020-12-31;0;0;7;0;0.0;0.0
83;2021-01-01;1;0;8;0;0.0;0.0
83;2021-01-02;0;0;8;0;0.0;0.0
83;2021-01-03;1;0;9;0;0.0;0.0
83;2021-01-04;1;0;10;0;0.0;0.0
83;2021-01-05;4;1;14;1;0.0;0.0
83;2021-01-06;69;0;83;1;0.0;0.0
83;2021-01-07;324;0;407;1;0.0;0.0
83;2021-01-08;421;1;828;2;0.1;0.0
83;2021-01-09;48;0;876;2;0.1;0.0
83;2021-01-10;1;0;877;2;0.1;0.0
83;2021-01-11;475;0;1352;2;0.1;0.0
83;2021-01-12;1015;5;2367;7;0.2;0.0
83;2021-01-13;963;8;3330;15;0.3;0.0
83;2021-01-14;848;9;4178;24;0.4;0.0
83;2021-01-15;714;3;4892;27;0.5;0.0
83;2021-01-16;42;1;4934;28;0.5;0.0
83;2021-01-17;1;0;4935;28;0.5;0.0
83;2021-01-18;1227;4;6162;32;0.6;0.0
83;2021-01-19;2021;8;8183;40;0.8;0.0
83;2021-01-20;1660;9;9843;49;0.9;0.0
83;2021-01-21;2101;8;11944;57;1.1;0.0
83;2021-01-22;1663;8;13607;65;1.3;0.0
83;2021-01-23;246;2;13853;67;1.3;0.0
83;2021-01-24;21;1;13874;68;1.3;0.0
83;2021-01-25;1556;7;15430;75;1.4;0.0
83;2021-01-26;1758;15;17188;90;1.6;0.0
83;2021-01-27;2156;87;19344;177;1.8;0.0
83;2021-01-28;5100;392;24444;569;2.3;0.1
83;2021-01-29;2949;355;27393;924;2.6;0.1
83;2021-01-30;237;47;27630;971;2.6;0.1
83;2021-01-31;46;0;27676;971;2.6;0.1
83;2021-02-01;1283;413;28959;1384;2.7;0.1
83;2021-02-02;1441;720;30400;2104;2.8;0.2
83;2021-02-03;1527;635;31927;2739;3.0;0.3
83;2021-02-04;1485;743;33412;3482;3.1;0.3
83;2021-02-05;1227;681;34639;4163;3.2;0.4
83;2021-02-06;24;15;34663;4178;3.2;0.4
83;2021-02-07;2;0;34665;4178;3.2;0.4
83;2021-02-08;1090;622;35755;4800;3.3;0.4
83;2021-02-09;1325;911;37080;5711;3.5;0.5
83;2021-02-10;1538;804;38618;6515;3.6;0.6
83;2021-02-11;1612;1028;40230;7543;3.7;0.7
83;2021-02-12;1352;825;41582;8368;3.9;0.8
83;2021-02-13;55;26;41637;8394;3.9;0.8
83;2021-02-14;0;0;41637;8394;3.9;0.8
83;2021-02-15;677;1050;42314;9444;3.9;0.9
83;2021-02-16;543;1371;42857;10815;4.0;1.0
83;2021-02-17;805;1831;43662;12646;4.1;1.2
83;2021-02-18;1630;3873;45292;16519;4.2;1.5
83;2021-02-19;1482;2331;46774;18850;4.4;1.8
83;2021-02-20;63;169;46837;19019;4.4;1.8
83;2021-02-21;25;36;46862;19055;4.4;1.8
83;2021-02-22;507;1748;47369;20803;4.4;1.9
83;2021-02-23;673;1441;48042;22244;4.5;2.1
83;2021-02-24;726;1484;48768;23728;4.5;2.2
83;2021-02-25;1252;1410;50020;25138;4.7;2.3
83;2021-02-26;1298;1255;51318;26393;4.8;2.5
83;2021-02-27;552;56;51870;26449;4.8;2.5
83;2021-02-28;10;15;51880;26464;4.8;2.5
83;2021-03-01;808;1239;52688;27703;4.9;2.6
83;2021-03-02;992;1310;53680;29013;5.0;2.7
83;2021-03-03;1439;1528;55119;30541;5.1;2.8
83;2021-03-04;1895;1393;57014;31934;5.3;3.0
83;2021-03-05;2221;1242;59235;33176;5.5;3.1
83;2021-03-06;3010;121;62245;33297;5.8;3.1
83;2021-03-07;2227;49;64472;33346;6.0;3.1
83;2021-03-08;853;1320;65325;34666;6.1;3.2
83;2021-03-09;1938;1230;67263;35896;6.3;3.3
83;2021-03-10;2382;1375;69645;37271;6.5;3.5
83;2021-03-11;3677;2216;73322;39487;6.8;3.7
83;2021-03-12;3662;1519;76984;41006;7.2;3.8
83;2021-03-13;4614;186;81598;41192;7.6;3.8
83;2021-03-14;2343;62;83941;41254;7.8;3.8
83;2021-03-15;3339;676;87280;41930;8.1;3.9
83;2021-03-16;2603;701;89883;42631;8.4;4.0
83;2021-03-17;2846;790;92729;43421;8.6;4.0
83;2021-03-18;3555;797;96284;44218;9.0;4.1
83;2021-03-19;4175;595;100459;44813;9.4;4.2
83;2021-03-20;3476;77;103935;44890;9.7;4.2
83;2021-03-21;2011;32;105946;44922;9.9;4.2
83;2021-03-22;3965;898;109911;45820;10.2;4.3
83;2021-03-23;4751;601;114662;46421;10.7;4.3
83;2021-03-24;5048;731;119710;47152;11.1;4.4
83;2021-03-25;6535;863;126245;48015;11.8;4.5
83;2021-03-26;7176;763;133421;48778;12.4;4.5
83;2021-03-27;3969;390;137390;49168;12.8;4.6
83;2021-03-28;2183;36;139573;49204;13.0;4.6
83;2021-03-29;4559;777;144132;49981;13.4;4.7
83;2021-03-30;5969;962;150101;50943;14.0;4.7
83;2021-03-31;5553;1083;155654;52026;14.5;4.8
83;2021-04-01;5980;1272;161634;53298;15.1;5.0
83;2021-04-02;5763;1078;167397;54376;15.6;5.1
83;2021-04-03;1800;636;169197;55012;15.8;5.1
83;2021-04-04;854;348;170051;55360;15.8;5.2
83;2021-04-05;190;67;170241;55427;15.9;5.2
83;2021-04-06;4733;1411;174974;56838;16.3;5.3
83;2021-04-07;5832;1667;180806;58505;16.8;5.4
83;2021-04-08;7893;2015;188699;60520;17.6;5.6
83;2021-04-09;7599;2213;196298;62733;18.3;5.8
83;2021-04-10;2948;2656;199246;65389;18.6;6.1
83;2021-04-11;1716;2143;200962;67532;18.7;6.3
83;2021-04-12;4951;2885;205913;70417;19.2;6.6
83;2021-04-13;5409;3007;211322;73424;19.7;6.8
83;2021-04-14;5897;2954;217219;76378;20.2;7.1
83;2021-04-15;6776;3045;223995;79423;20.9;7.4
83;2021-04-16;6127;3530;230122;82953;21.4;7.7
83;2021-04-17;3511;2194;233633;85147;21.8;7.9
83;2021-04-18;2179;1301;235812;86448;22.0;8.1
83;2021-04-19;4113;3909;239925;90357;22.3;8.4
83;2021-04-20;4360;3875;244285;94232;22.7;8.8
83;2021-04-21;4300;4157;248585;98389;23.1;9.2
83;2021-04-22;5009;4309;253594;102698;23.6;9.6
83;2021-04-23;4529;4571;258123;107269;24.0;10.0
83;2021-04-24;2629;2721;260752;109990;24.3;10.2
83;2021-04-25;1925;1572;262677;111562;24.5;10.4
83;2021-04-26;3568;3857;266245;115419;24.8;10.7
83;2021-04-27;4140;4560;270385;119979;25.2;11.2
83;2021-04-28;4314;4382;274699;124361;25.6;11.6
83;2021-04-29;5823;5139;280522;129500;26.1;12.1
83;2021-04-30;5786;4316;286308;133816;26.7;12.5
83;2021-05-01;1693;431;288001;134247;26.8;12.5
83;2021-05-02;1237;760;289238;135007;26.9;12.6
83;2021-05-03;3751;4287;292989;139294;27.3;13.0
83;2021-05-04;3345;5104;296334;144398;27.6;13.4
83;2021-05-05;3644;4977;299978;149375;27.9;13.9
83;2021-05-06;4678;4966;304656;154341;28.4;14.4
83;2021-05-07;4166;5317;308822;159658;28.8;14.9
83;2021-05-08;2764;1017;311586;160675;29.0;15.0
83;2021-05-09;2151;1237;313737;161912;29.2;15.1
83;2021-05-10;3201;5428;316938;167340;29.5;15.6
83;2021-05-11;5126;5690;322064;173030;30.0;16.1
83;2021-05-12;6292;4845;328356;177875;30.6;16.6
83;2021-05-13;6582;1345;334938;179220;31.2;16.7
83;2021-05-14;7422;4117;342360;183337;31.9;17.1
83;2021-05-15;7752;2210;350112;185547;32.6;17.3
83;2021-05-16;6624;1247;356736;186794;33.2;17.4
83;2021-05-17;4894;4211;361630;191005;33.7;17.8
83;2021-05-18;5533;3865;367163;194870;34.2;18.1
83;2021-05-19;6207;3410;373370;198280;34.8;18.5
83;2021-05-20;6753;3806;380123;202086;35.4;18.8
83;2021-05-21;7904;3870;388027;205956;36.1;19.2
83;2021-05-22;6087;1720;394114;207676;36.7;19.3
83;2021-05-23;4682;713;398796;208389;37.1;19.4
83;2021-05-24;5809;973;404605;209362;37.7;19.5
83;2021-05-25;5510;4758;410115;214120;38.2;19.9
83;2021-05-26;4858;4447;414973;218567;38.6;20.4
83;2021-05-27;5069;5259;420042;223826;39.1;20.8
83;2021-05-28;4504;5760;424546;229586;39.5;21.4
83;2021-05-29;2706;4271;427252;233857;39.8;21.8
83;2021-05-30;1256;1373;428508;235230;39.9;21.9
83;2021-05-31;5486;4765;433994;239995;40.4;22.3
83;2021-06-01;5732;5308;439726;245303;40.9;22.8
83;2021-06-02;5262;4585;444988;249888;41.4;23.3
83;2021-06-03;5744;5134;450732;255022;42.0;23.7
83;2021-06-04;5445;6043;456177;261065;42.5;24.3
83;2021-06-05;3919;3198;460096;264263;42.8;24.6
83;2021-06-06;1933;1383;462029;265646;43.0;24.7
83;2021-06-07;3912;5093;465941;270739;43.4;25.2
83;2021-06-08;4175;4821;470116;275560;43.8;25.7
83;2021-06-09;4007;4704;474123;280264;44.2;26.1
83;2021-06-10;3999;4264;478122;284528;44.5;26.5
83;2021-06-11;3659;5451;481781;289979;44.9;27.0
83;2021-06-12;2913;2985;484694;292964;45.1;27.3
83;2021-06-13;995;1390;485689;294354;45.2;27.4
83;2021-06-14;2854;5656;488543;300010;45.5;27.9
83;2021-06-15;3166;4861;491709;304871;45.8;28.4
83;2021-06-16;2963;4504;494672;309375;46.1;28.8
83;2021-06-17;2785;5291;497457;314666;46.3;29.3
83;2021-06-18;3160;5965;500617;320631;46.6;29.9
83;2021-06-19;2323;4100;502940;324731;46.8;30.2
83;2021-06-20;676;1889;503616;326620;46.9;30.4
83;2021-06-21;2109;7585;505725;334205;47.1;31.1
83;2021-06-22;2103;7167;507828;341372;47.3;31.8
83;2021-06-23;1935;6929;509763;348301;47.5;32.4
83;2021-06-24;1962;7367;511725;355668;47.7;33.1
83;2021-06-25;2111;8394;513836;364062;47.9;33.9
83;2021-06-26;1462;6807;515298;370869;48.0;34.5
83;2021-06-27;692;3184;515990;374053;48.1;34.8
83;2021-06-28;1570;7882;517560;381935;48.2;35.6
83;2021-06-29;1907;7809;519467;389744;48.4;36.3
83;2021-06-30;2240;7274;521707;397018;48.6;37.0
83;2021-07-01;2562;6567;524269;403585;48.8;37.6
83;2021-07-02;2265;7798;526534;411383;49.0;38.3
83;2021-07-03;1509;5685;528043;417068;49.2;38.8
83;2021-07-04;572;2752;528615;419820;49.2;39.1
83;2021-07-05;1925;7532;530540;427352;49.4;39.8
83;2021-07-06;2571;5941;533111;433293;49.6;40.4
83;2021-07-07;2686;4667;535797;437960;49.9;40.8
83;2021-07-08;3246;4477;539043;442437;50.2;41.2
83;2021-07-09;3045;6965;542088;449402;50.5;41.9
83;2021-07-10;1579;4929;543667;454331;50.6;42.3
83;2021-07-11;1009;1766;544676;456097;50.7;42.5
83;2021-07-12;2142;7689;546818;463786;50.9;43.2
83;2021-07-13;4042;7097;550860;470883;51.3;43.9
83;2021-07-14;2094;1322;552954;472205;51.5;44.0
83;2021-07-15;4580;6845;557534;479050;51.9;44.6
83;2021-07-16;5274;7123;562808;486173;52.4;45.3
83;2021-07-17;3650;5002;566458;491175;52.8;45.7
83;2021-07-18;1604;1311;568062;492486;52.9;45.9
83;2021-07-19;3954;6320;572016;498806;53.3;46.5
83;2021-07-20;5986;6197;578002;505003;53.8;47.0
83;2021-07-21;6031;5216;584033;510219;54.4;47.5
83;2021-07-22;7118;5545;591151;515764;55.1;48.0
83;2021-07-23;7098;5921;598249;521685;55.7;48.6
83;2021-07-24;4650;4570;602899;526255;56.1;49.0
83;2021-07-25;1329;737;604228;526992;56.3;49.1
83;2021-07-26;5546;4939;609774;531931;56.8;49.5
83;2021-07-27;6833;4906;616607;536837;57.4;50.0
83;2021-07-28;6601;4427;623208;541264;58.0;50.4
83;2021-07-29;7500;4862;630708;546126;58.7;50.9
83;2021-07-30;6968;4762;637676;550888;59.4;51.3
83;2021-07-31;4667;3218;642343;554106;59.8;51.6
83;2021-08-01;1066;849;643409;554955;59.9;51.7
83;2021-08-02;5771;3711;649180;558666;60.5;52.0
83;2021-08-03;6387;3998;655567;562664;61.0;52.4
83;2021-08-04;5916;3717;661483;566381;61.6;52.7
83;2021-08-05;6184;4091;667667;570472;62.2;53.1
83;2021-08-06;6162;4918;673829;575390;62.7;53.6
83;2021-08-07;3751;3557;677580;578947;63.1;53.9
83;2021-08-08;1064;823;678644;579770;63.2;54.0
83;2021-08-09;4718;4647;683362;584417;63.6;54.4
83;2021-08-10;5236;5149;688598;589566;64.1;54.9
83;2021-08-11;4593;5069;693191;594635;64.6;55.4
83;2021-08-12;4930;5570;698121;600205;65.0;55.9
83;2021-08-13;4938;5742;703059;605947;65.5;56.4
83;2021-08-14;3223;3892;706282;609839;65.8;56.8
83;2021-08-15;208;392;706490;610231;65.8;56.8
83;2021-08-16;3633;5483;710123;615714;66.1;57.3
83;2021-08-17;3577;5272;713700;620986;66.5;57.8
83;2021-08-18;3609;5004;717309;625990;66.8;58.3
83;2021-08-19;4181;6262;721490;632252;67.2;58.9
83;2021-08-20;3644;6516;725134;638768;67.5;59.5
83;2021-08-21;2348;4490;727482;643258;67.7;59.9
83;2021-08-22;635;1033;728117;644291;67.8;60.0
83;2021-08-23;2506;5787;730623;650078;68.0;60.5
83;2021-08-24;2924;5922;733547;656000;68.3;61.1
83;2021-08-25;2586;5294;736133;661294;68.6;61.6
83;2021-08-26;2802;5846;738935;667140;68.8;62.1
83;2021-08-27;2918;5925;741853;673065;69.1;62.7
83;2021-08-28;1934;4539;743787;677604;69.3;63.1
83;2021-08-29;476;1162;744263;678766;69.3;63.2
83;2021-08-30;2384;4883;746647;683649;69.5;63.7
83;2021-08-31;2509;5297;749156;688946;69.8;64.2
83;2021-09-01;2549;4593;751705;693539;70.0;64.6
83;2021-09-02;2485;4428;754190;697967;70.2;65.0
83;2021-09-03;2337;4648;756527;702615;70.5;65.4
83;2021-09-04;1946;4376;758473;706991;70.6;65.8
83;2021-09-05;568;415;759041;707406;70.7;65.9
83;2021-09-06;1660;3336;760701;710742;70.8;66.2
83;2021-09-07;1669;3167;762370;713909;71.0;66.5
83;2021-09-08;1939;3337;764309;717246;71.2;66.8
83;2021-09-09;1494;3301;765803;720547;71.3;67.1
83;2021-09-10;1781;3619;767584;724166;71.5;67.4
83;2021-09-11;1374;3633;768958;727799;71.6;67.8
83;2021-09-12;204;458;769162;728257;71.6;67.8
83;2021-09-13;1226;2516;770388;730773;71.7;68.1
83;2021-09-14;1331;2496;771719;733269;71.9;68.3
83;2021-09-15;1370;2539;773089;735808;72.0;68.5
83;2021-09-16;1042;2176;774131;737984;72.1;68.7
83;2021-09-17;1040;2527;775171;740511;72.2;69.0
83;2021-09-18;1023;3001;776194;743512;72.3;69.2
83;2021-09-19;97;399;776291;743911;72.3;69.3
83;2021-09-20;680;2035;776971;745946;72.4;69.5
83;2021-09-21;719;1811;777690;747757;72.4;69.6
83;2021-09-22;769;2498;778459;750255;72.5;69.9
83;2021-09-23;717;2114;779176;752369;72.6;70.1
83;2021-09-24;724;2197;779900;754566;72.6;70.3
83;2021-09-25;741;2666;780641;757232;72.7;70.5
83;2021-09-26;70;449;780711;757681;72.7;70.6
83;2021-09-27;593;1730;781304;759411;72.8;70.7
83;2021-09-28;542;1503;781846;760914;72.8;70.9
83;2021-09-29;715;1879;782561;762793;72.9;71.0
83;2021-09-30;638;1507;783199;764300;72.9;71.2
83;2021-10-01;747;1534;783946;765834;73.0;71.3
83;2021-10-02;688;1621;784634;767455;73.1;71.5
83;2021-10-03;108;254;784742;767709;73.1;71.5
83;2021-10-04;484;890;785226;768599;73.1;71.6
83;2021-10-05;594;1117;785820;769716;73.2;71.7
83;2021-10-06;741;1553;786561;771269;73.2;71.8
83;2021-10-07;522;1052;787083;772321;73.3;71.9
83;2021-10-08;731;1335;787814;773656;73.4;72.0
83;2021-10-09;522;989;788336;774645;73.4;72.1
83;2021-10-10;16;39;788352;774684;73.4;72.1
83;2021-10-11;631;1124;788983;775808;73.5;72.2
83;2021-10-12;487;780;789470;776588;73.5;72.3
83;2021-10-13;623;997;790093;777585;73.6;72.4
83;2021-10-14;502;837;790595;778422;73.6;72.5
84;2020-12-27;2;1;2;1;0.0;0.0
84;2020-12-28;1;1;3;2;0.0;0.0
84;2020-12-29;3;1;6;3;0.0;0.0
84;2020-12-30;2;0;8;3;0.0;0.0
84;2020-12-31;2;0;10;3;0.0;0.0
84;2021-01-01;0;0;10;3;0.0;0.0
84;2021-01-02;0;0;10;3;0.0;0.0
84;2021-01-03;0;0;10;3;0.0;0.0
84;2021-01-04;0;0;10;3;0.0;0.0
84;2021-01-05;0;0;10;3;0.0;0.0
84;2021-01-06;0;0;10;3;0.0;0.0
84;2021-01-07;69;0;79;3;0.0;0.0
84;2021-01-08;84;0;163;3;0.0;0.0
84;2021-01-09;31;1;194;4;0.0;0.0
84;2021-01-10;0;0;194;4;0.0;0.0
84;2021-01-11;219;0;413;4;0.1;0.0
84;2021-01-12;624;2;1037;6;0.2;0.0
84;2021-01-13;359;1;1396;7;0.2;0.0
84;2021-01-14;960;16;2356;23;0.4;0.0
84;2021-01-15;619;11;2975;34;0.5;0.0
84;2021-01-16;167;1;3142;35;0.6;0.0
84;2021-01-17;29;1;3171;36;0.6;0.0
84;2021-01-18;697;3;3868;39;0.7;0.0
84;2021-01-19;881;6;4749;45;0.8;0.0
84;2021-01-20;1023;6;5772;51;1.0;0.0
84;2021-01-21;1050;6;6822;57;1.2;0.0
84;2021-01-22;1135;2;7957;59;1.4;0.0
84;2021-01-23;250;0;8207;59;1.5;0.0
84;2021-01-24;3;0;8210;59;1.5;0.0
84;2021-01-25;809;4;9019;63;1.6;0.0
84;2021-01-26;940;7;9959;70;1.8;0.0
84;2021-01-27;1072;4;11031;74;2.0;0.0
84;2021-01-28;1622;19;12653;93;2.3;0.0
84;2021-01-29;1202;63;13855;156;2.5;0.0
84;2021-01-30;171;21;14026;177;2.5;0.0
84;2021-01-31;7;0;14033;177;2.5;0.0
84;2021-02-01;662;146;14695;323;2.6;0.1
84;2021-02-02;789;268;15484;591;2.8;0.1
84;2021-02-03;762;243;16246;834;2.9;0.1
84;2021-02-04;913;400;17159;1234;3.1;0.2
84;2021-02-05;728;416;17887;1650;3.2;0.3
84;2021-02-06;127;49;18014;1699;3.2;0.3
84;2021-02-07;1;0;18015;1699;3.2;0.3
84;2021-02-08;569;274;18584;1973;3.3;0.4
84;2021-02-09;694;720;19278;2693;3.4;0.5
84;2021-02-10;560;565;19838;3258;3.5;0.6
84;2021-02-11;549;590;20387;3848;3.6;0.7
84;2021-02-12;562;680;20949;4528;3.7;0.8
84;2021-02-13;48;170;20997;4698;3.7;0.8
84;2021-02-14;3;0;21000;4698;3.7;0.8
84;2021-02-15;207;887;21207;5585;3.8;1.0
84;2021-02-16;223;823;21430;6408;3.8;1.1
84;2021-02-17;448;778;21878;7186;3.9;1.3
84;2021-02-18;557;1102;22435;8288;4.0;1.5
84;2021-02-19;739;1184;23174;9472;4.1;1.7
84;2021-02-20;68;153;23242;9625;4.1;1.7
84;2021-02-21;6;37;23248;9662;4.1;1.7
84;2021-02-22;369;744;23617;10406;4.2;1.9
84;2021-02-23;272;704;23889;11110;4.3;2.0
84;2021-02-24;395;736;24284;11846;4.3;2.1
84;2021-02-25;713;862;24997;12708;4.5;2.3
84;2021-02-26;823;682;25820;13390;4.6;2.4
84;2021-02-27;133;125;25953;13515;4.6;2.4
84;2021-02-28;18;0;25971;13515;4.6;2.4
84;2021-03-01;459;667;26430;14182;4.7;2.5
84;2021-03-02;634;809;27064;14991;4.8;2.7
84;2021-03-03;820;949;27884;15940;5.0;2.8
84;2021-03-04;1100;695;28984;16635;5.2;3.0
84;2021-03-05;1313;526;30297;17161;5.4;3.1
84;2021-03-06;1459;68;31756;17229;5.7;3.1
84;2021-03-07;481;17;32237;17246;5.7;3.1
84;2021-03-08;813;613;33050;17859;5.9;3.2
84;2021-03-09;1390;785;34440;18644;6.1;3.3
84;2021-03-10;1474;674;35914;19318;6.4;3.4
84;2021-03-11;1983;649;37897;19967;6.8;3.6
84;2021-03-12;2083;638;39980;20605;7.1;3.7
84;2021-03-13;747;37;40727;20642;7.3;3.7
84;2021-03-14;247;53;40974;20695;7.3;3.7
84;2021-03-15;1073;311;42047;21006;7.5;3.7
84;2021-03-16;1180;328;43227;21334;7.7;3.8
84;2021-03-17;1147;445;44374;21779;7.9;3.9
84;2021-03-18;1459;399;45833;22178;8.2;4.0
84;2021-03-19;2179;465;48012;22643;8.6;4.0
84;2021-03-20;841;28;48853;22671;8.7;4.0
84;2021-03-21;151;11;49004;22682;8.7;4.0
84;2021-03-22;1162;468;50166;23150;8.9;4.1
84;2021-03-23;1916;440;52082;23590;9.3;4.2
84;2021-03-24;2177;405;54259;23995;9.7;4.3
84;2021-03-25;3656;406;57915;24401;10.3;4.3
84;2021-03-26;3319;489;61234;24890;10.9;4.4
84;2021-03-27;915;60;62149;24950;11.1;4.4
84;2021-03-28;74;3;62223;24953;11.1;4.4
84;2021-03-29;1718;537;63941;25490;11.4;4.5
84;2021-03-30;2674;692;66615;26182;11.9;4.7
84;2021-03-31;2405;651;69020;26833;12.3;4.8
84;2021-04-01;3021;587;72041;27420;12.8;4.9
84;2021-04-02;2452;538;74493;27958;13.3;5.0
84;2021-04-03;512;29;75005;27987;13.4;5.0
84;2021-04-04;15;2;75020;27989;13.4;5.0
84;2021-04-05;814;105;75834;28094;13.5;5.0
84;2021-04-06;2147;850;77981;28944;13.9;5.2
84;2021-04-07;2406;871;80387;29815;14.3;5.3
84;2021-04-08;3653;1052;84040;30867;15.0;5.5
84;2021-04-09;4116;958;88156;31825;15.7;5.7
84;2021-04-10;1310;135;89466;31960;15.9;5.7
84;2021-04-11;37;12;89503;31972;16.0;5.7
84;2021-04-12;2095;814;91598;32786;16.3;5.8
84;2021-04-13;2940;1373;94538;34159;16.9;6.1
84;2021-04-14;2811;1362;97349;35521;17.4;6.3
84;2021-04-15;3272;1426;100621;36947;17.9;6.6
84;2021-04-16;3432;1556;104053;38503;18.5;6.9
84;2021-04-17;1666;201;105719;38704;18.8;6.9
84;2021-04-18;38;1;105757;38705;18.9;6.9
84;2021-04-19;2507;927;108264;39632;19.3;7.1
84;2021-04-20;2628;1535;110892;41167;19.8;7.3
84;2021-04-21;2651;1491;113543;42658;20.2;7.6
84;2021-04-22;3014;1744;116557;44402;20.8;7.9
84;2021-04-23;3042;1912;119599;46314;21.3;8.3
84;2021-04-24;1530;289;121129;46603;21.6;8.3
84;2021-04-25;27;2;121156;46605;21.6;8.3
84;2021-04-26;2198;1377;123354;47982;22.0;8.6
84;2021-04-27;2556;1986;125910;49968;22.4;8.9
84;2021-04-28;2818;1856;128728;51824;22.9;9.2
84;2021-04-29;3420;2057;132148;53881;23.6;9.6
84;2021-04-30;3134;2437;135282;56318;24.1;10.0
84;2021-05-01;457;259;135739;56577;24.2;10.1
84;2021-05-02;2;0;135741;56577;24.2;10.1
84;2021-05-03;2161;1634;137902;58211;24.6;10.4
84;2021-05-04;2488;2546;140390;60757;25.0;10.8
84;2021-05-05;2354;2230;142744;62987;25.4;11.2
84;2021-05-06;3223;2264;145967;65251;26.0;11.6
84;2021-05-07;2766;2564;148733;67815;26.5;12.1
84;2021-05-08;1158;527;149891;68342;26.7;12.2
84;2021-05-09;8;53;149899;68395;26.7;12.2
84;2021-05-10;2159;2466;152058;70861;27.1;12.6
84;2021-05-11;2905;3160;154963;74021;27.6;13.2
84;2021-05-12;2849;2923;157812;76944;28.1;13.7
84;2021-05-13;2160;849;159972;77793;28.5;13.9
84;2021-05-14;2728;2039;162700;79832;29.0;14.2
84;2021-05-15;2001;987;164701;80819;29.4;14.4
84;2021-05-16;1340;188;166041;81007;29.6;14.4
84;2021-05-17;2226;2157;168267;83164;30.0;14.8
84;2021-05-18;2904;2116;171171;85280;30.5;15.2
84;2021-05-19;3230;1667;174401;86947;31.1;15.5
84;2021-05-20;3698;2208;178099;89155;31.7;15.9
84;2021-05-21;3471;2335;181570;91490;32.4;16.3
84;2021-05-22;1582;684;183152;92174;32.6;16.4
84;2021-05-23;6;9;183158;92183;32.6;16.4
84;2021-05-24;1840;426;184998;92609;33.0;16.5
84;2021-05-25;2983;2191;187981;94800;33.5;16.9
84;2021-05-26;3075;2089;191056;96889;34.1;17.3
84;2021-05-27;3857;2320;194913;99209;34.7;17.7
84;2021-05-28;3180;3309;198093;102518;35.3;18.3
84;2021-05-29;1093;1653;199186;104171;35.5;18.6
84;2021-05-30;10;85;199196;104256;35.5;18.6
84;2021-05-31;2191;2642;201387;106898;35.9;19.1
84;2021-06-01;3141;3159;204528;110057;36.5;19.6
84;2021-06-02;3170;2631;207698;112688;37.0;20.1
84;2021-06-03;4116;3000;211814;115688;37.8;20.6
84;2021-06-04;3613;3036;215427;118724;38.4;21.2
84;2021-06-05;1781;1501;217208;120225;38.7;21.4
84;2021-06-06;984;208;218192;120433;38.9;21.5
84;2021-06-07;2451;2760;220643;123193;39.3;22.0
84;2021-06-08;3317;3056;223960;126249;39.9;22.5
84;2021-06-09;3033;2689;226993;128938;40.5;23.0
84;2021-06-10;3512;2798;230505;131736;41.1;23.5
84;2021-06-11;3031;3069;233536;134805;41.6;24.0
84;2021-06-12;1965;1313;235501;136118;42.0;24.3
84;2021-06-13;412;213;235913;136331;42.1;24.3
84;2021-06-14;1930;3155;237843;139486;42.4;24.9
84;2021-06-15;2573;3454;240416;142940;42.9;25.5
84;2021-06-16;2527;2962;242943;145902;43.3;26.0
84;2021-06-17;2994;3481;245937;149383;43.8;26.6
84;2021-06-18;2424;3555;248361;152938;44.3;27.3
84;2021-06-19;1287;1552;249648;154490;44.5;27.5
84;2021-06-20;546;354;250194;154844;44.6;27.6
84;2021-06-21;1570;3135;251764;157979;44.9;28.2
84;2021-06-22;2163;4011;253927;161990;45.3;28.9
84;2021-06-23;2117;3310;256044;165300;45.6;29.5
84;2021-06-24;2201;3483;258245;168783;46.0;30.1
84;2021-06-25;1836;3888;260081;172671;46.4;30.8
84;2021-06-26;1133;1818;261214;174489;46.6;31.1
84;2021-06-27;297;345;261511;174834;46.6;31.2
84;2021-06-28;1207;3224;262718;178058;46.8;31.7
84;2021-06-29;1477;4051;264195;182109;47.1;32.5
84;2021-06-30;1716;3969;265911;186078;47.4;33.2
84;2021-07-01;1819;3957;267730;190035;47.7;33.9
84;2021-07-02;1764;3900;269494;193935;48.0;34.6
84;2021-07-03;1102;2030;270596;195965;48.2;34.9
84;2021-07-04;395;416;270991;196381;48.3;35.0
84;2021-07-05;1550;3540;272541;199921;48.6;35.6
84;2021-07-06;1638;4165;274179;204086;48.9;36.4
84;2021-07-07;1676;3103;275855;207189;49.2;36.9
84;2021-07-08;2158;3743;278013;210932;49.6;37.6
84;2021-07-09;1874;3970;279887;214902;49.9;38.3
84;2021-07-10;1253;2162;281140;217064;50.1;38.7
84;2021-07-11;354;300;281494;217364;50.2;38.7
84;2021-07-12;1408;3836;282902;221200;50.4;39.4
84;2021-07-13;2334;5010;285236;226210;50.8;40.3
84;2021-07-14;1885;1249;287121;227459;51.2;40.5
84;2021-07-15;2708;4561;289829;232020;51.7;41.4
84;2021-07-16;2778;4605;292607;236625;52.2;42.2
84;2021-07-17;1588;2449;294195;239074;52.4;42.6
84;2021-07-18;1017;552;295212;239626;52.6;42.7
84;2021-07-19;2416;3746;297628;243372;53.1;43.4
84;2021-07-20;2954;4169;300582;247541;53.6;44.1
84;2021-07-21;3187;3656;303769;251197;54.1;44.8
84;2021-07-22;3777;3791;307546;254988;54.8;45.5
84;2021-07-23;3520;3681;311066;258669;55.4;46.1
84;2021-07-24;1470;2249;312536;260918;55.7;46.5
84;2021-07-25;1033;513;313569;261431;55.9;46.6
84;2021-07-26;2725;3040;316294;264471;56.4;47.1
84;2021-07-27;3443;3569;319737;268040;57.0;47.8
84;2021-07-28;3867;3308;323604;271348;57.7;48.4
84;2021-07-29;4224;3162;327828;274510;58.4;48.9
84;2021-07-30;4027;3330;331855;277840;59.2;49.5
84;2021-07-31;2000;1694;333855;279534;59.5;49.8
84;2021-08-01;819;437;334674;279971;59.7;49.9
84;2021-08-02;2993;2696;337667;282667;60.2;50.4
84;2021-08-03;4108;2798;341775;285465;60.9;50.9
84;2021-08-04;3918;2615;345693;288080;61.6;51.4
84;2021-08-05;3888;2590;349581;290670;62.3;51.8
84;2021-08-06;3694;2867;353275;293537;63.0;52.3
84;2021-08-07;2078;1747;355353;295284;63.3;52.6
84;2021-08-08;386;735;355739;296019;63.4;52.8
84;2021-08-09;2940;2604;358679;298623;63.9;53.2
84;2021-08-10;3749;2957;362428;301580;64.6;53.8
84;2021-08-11;3269;2677;365697;304257;65.2;54.2
84;2021-08-12;3173;2976;368870;307233;65.8;54.8
84;2021-08-13;2924;2702;371794;309935;66.3;55.2
84;2021-08-14;1736;1747;373530;311682;66.6;55.6
84;2021-08-15;315;227;373845;311909;66.6;55.6
84;2021-08-16;2453;3086;376298;314995;67.1;56.1
84;2021-08-17;2736;3259;379034;318254;67.6;56.7
84;2021-08-18;2421;2802;381455;321056;68.0;57.2
84;2021-08-19;2280;3120;383735;324176;68.4;57.8
84;2021-08-20;2214;3308;385949;327484;68.8;58.4
84;2021-08-21;1228;1886;387177;329370;69.0;58.7
84;2021-08-22;167;738;387344;330108;69.0;58.8
84;2021-08-23;1779;3298;389123;333406;69.4;59.4
84;2021-08-24;1925;3468;391048;336874;69.7;60.0
84;2021-08-25;1845;3352;392893;340226;70.0;60.6
84;2021-08-26;1640;3628;394533;343854;70.3;61.3
84;2021-08-27;1631;3815;396164;347669;70.6;62.0
84;2021-08-28;920;2181;397084;349850;70.8;62.4
84;2021-08-29;174;607;397258;350457;70.8;62.5
84;2021-08-30;1392;3228;398650;353685;71.1;63.0
84;2021-08-31;1366;4079;400016;357764;71.3;63.8
84;2021-09-01;1251;3460;401267;361224;71.5;64.4
84;2021-09-02;1210;2950;402477;364174;71.7;64.9
84;2021-09-03;1285;3364;403762;367538;72.0;65.5
84;2021-09-04;779;2103;404541;369641;72.1;65.9
84;2021-09-05;127;467;404668;370108;72.1;66.0
84;2021-09-06;817;2229;405485;372337;72.3;66.4
84;2021-09-07;1027;2421;406512;374758;72.5;66.8
84;2021-09-08;911;2681;407423;377439;72.6;67.3
84;2021-09-09;889;2065;408312;379504;72.8;67.6
84;2021-09-10;942;2583;409254;382087;73.0;68.1
84;2021-09-11;591;1797;409845;383884;73.1;68.4
84;2021-09-12;117;301;409962;384185;73.1;68.5
84;2021-09-13;710;1517;410672;385702;73.2;68.8
84;2021-09-14;831;1500;411503;387202;73.4;69.0
84;2021-09-15;825;1934;412328;389136;73.5;69.4
84;2021-09-16;609;1338;412937;390474;73.6;69.6
84;2021-09-17;617;1615;413554;392089;73.7;69.9
84;2021-09-18;516;1498;414070;393587;73.8;70.2
84;2021-09-19;46;177;414116;393764;73.8;70.2
84;2021-09-20;329;891;414445;394655;73.9;70.3
84;2021-09-21;364;1114;414809;395769;73.9;70.5
84;2021-09-22;421;1590;415230;397359;74.0;70.8
84;2021-09-23;398;1116;415628;398475;74.1;71.0
84;2021-09-24;396;1250;416024;399725;74.2;71.3
84;2021-09-25;323;1246;416347;400971;74.2;71.5
84;2021-09-26;53;142;416400;401113;74.2;71.5
84;2021-09-27;313;787;416713;401900;74.3;71.6
84;2021-09-28;310;758;417023;402658;74.3;71.8
84;2021-09-29;350;1221;417373;403879;74.4;72.0
84;2021-09-30;374;919;417747;404798;74.5;72.2
84;2021-10-01;440;852;418187;405650;74.5;72.3
84;2021-10-02;247;753;418434;406403;74.6;72.4
84;2021-10-03;37;94;418471;406497;74.6;72.5
84;2021-10-04;297;549;418768;407046;74.6;72.6
84;2021-10-05;332;525;419100;407571;74.7;72.7
84;2021-10-06;345;823;419445;408394;74.8;72.8
84;2021-10-07;357;665;419802;409059;74.8;72.9
84;2021-10-08;415;775;420217;409834;74.9;73.1
84;2021-10-09;225;634;420442;410468;74.9;73.2
84;2021-10-10;28;86;420470;410554;75.0;73.2
84;2021-10-11;252;382;420722;410936;75.0;73.3
84;2021-10-12;304;415;421026;411351;75.0;73.3
84;2021-10-13;400;594;421426;411945;75.1;73.4
84;2021-10-14;297;438;421723;412383;75.2;73.5
85;2020-12-27;1;0;1;0;0.0;0.0
85;2020-12-28;0;0;1;0;0.0;0.0
85;2020-12-29;0;0;1;0;0.0;0.0
85;2020-12-30;0;0;1;0;0.0;0.0
85;2020-12-31;0;0;1;0;0.0;0.0
85;2021-01-01;0;0;1;0;0.0;0.0
85;2021-01-02;0;0;1;0;0.0;0.0
85;2021-01-03;1;0;2;0;0.0;0.0
85;2021-01-04;26;0;28;0;0.0;0.0
85;2021-01-05;62;0;90;0;0.0;0.0
85;2021-01-06;107;1;197;1;0.0;0.0
85;2021-01-07;203;0;400;1;0.1;0.0
85;2021-01-08;293;2;693;3;0.1;0.0
85;2021-01-09;288;1;981;4;0.1;0.0
85;2021-01-10;59;0;1040;4;0.2;0.0
85;2021-01-11;453;0;1493;4;0.2;0.0
85;2021-01-12;584;2;2077;6;0.3;0.0
85;2021-01-13;545;2;2622;8;0.4;0.0
85;2021-01-14;685;4;3307;12;0.5;0.0
85;2021-01-15;439;3;3746;15;0.5;0.0
85;2021-01-16;263;3;4009;18;0.6;0.0
85;2021-01-17;37;0;4046;18;0.6;0.0
85;2021-01-18;999;3;5045;21;0.7;0.0
85;2021-01-19;1429;17;6474;38;0.9;0.0
85;2021-01-20;1891;4;8365;42;1.2;0.0
85;2021-01-21;3222;13;11587;55;1.7;0.0
85;2021-01-22;1700;22;13287;77;1.9;0.0
85;2021-01-23;466;1;13753;78;2.0;0.0
85;2021-01-24;50;0;13803;78;2.0;0.0
85;2021-01-25;577;1;14380;79;2.1;0.0
85;2021-01-26;878;34;15258;113;2.2;0.0
85;2021-01-27;1810;34;17068;147;2.5;0.0
85;2021-01-28;1636;41;18704;188;2.7;0.0
85;2021-01-29;875;64;19579;252;2.9;0.0
85;2021-01-30;149;5;19728;257;2.9;0.0
85;2021-01-31;2;45;19730;302;2.9;0.0
85;2021-02-01;484;103;20214;405;3.0;0.1
85;2021-02-02;535;174;20749;579;3.0;0.1
85;2021-02-03;415;259;21164;838;3.1;0.1
85;2021-02-04;623;265;21787;1103;3.2;0.2
85;2021-02-05;624;264;22411;1367;3.3;0.2
85;2021-02-06;157;244;22568;1611;3.3;0.2
85;2021-02-07;1;0;22569;1611;3.3;0.2
85;2021-02-08;390;650;22959;2261;3.4;0.3
85;2021-02-09;663;1059;23622;3320;3.5;0.5
85;2021-02-10;583;1126;24205;4446;3.5;0.7
85;2021-02-11;1524;3040;25729;7486;3.8;1.1
85;2021-02-12;1015;1264;26744;8750;3.9;1.3
85;2021-02-13;251;501;26995;9251;4.0;1.4
85;2021-02-14;2;131;26997;9382;4.0;1.4
85;2021-02-15;336;807;27333;10189;4.0;1.5
85;2021-02-16;569;1180;27902;11369;4.1;1.7
85;2021-02-17;782;1576;28684;12945;4.2;1.9
85;2021-02-18;1277;1939;29961;14884;4.4;2.2
85;2021-02-19;956;1208;30917;16092;4.5;2.4
85;2021-02-20;174;260;31091;16352;4.6;2.4
85;2021-02-21;1;11;31092;16363;4.6;2.4
85;2021-02-22;815;886;31907;17249;4.7;2.5
85;2021-02-23;828;490;32735;17739;4.8;2.6
85;2021-02-24;757;312;33492;18051;4.9;2.6
85;2021-02-25;1335;401;34827;18452;5.1;2.7
85;2021-02-26;1229;332;36056;18784;5.3;2.7
85;2021-02-27;402;103;36458;18887;5.3;2.8
85;2021-02-28;7;1;36465;18888;5.3;2.8
85;2021-03-01;766;428;37231;19316;5.4;2.8
85;2021-03-02;1100;793;38331;20109;5.6;2.9
85;2021-03-03;844;516;39175;20625;5.7;3.0
85;2021-03-04;1577;1177;40752;21802;6.0;3.2
85;2021-03-05;1741;852;42493;22654;6.2;3.3
85;2021-03-06;1227;133;43720;22787;6.4;3.3
85;2021-03-07;333;36;44053;22823;6.4;3.3
85;2021-03-08;1741;468;45794;23291;6.7;3.4
85;2021-03-09;2239;582;48033;23873;7.0;3.5
85;2021-03-10;1863;652;49896;24525;7.3;3.6
85;2021-03-11;3118;1102;53014;25627;7.8;3.8
85;2021-03-12;2730;873;55744;26500;8.2;3.9
85;2021-03-13;1372;167;57116;26667;8.4;3.9
85;2021-03-14;182;3;57298;26670;8.4;3.9
85;2021-03-15;1919;519;59217;27189;8.7;4.0
85;2021-03-16;1631;523;60848;27712;8.9;4.1
85;2021-03-17;980;528;61828;28240;9.0;4.1
85;2021-03-18;1904;459;63732;28699;9.3;4.2
85;2021-03-19;2198;376;65930;29075;9.7;4.3
85;2021-03-20;1069;179;66999;29254;9.8;4.3
85;2021-03-21;272;5;67271;29259;9.8;4.3
85;2021-03-22;1763;562;69034;29821;10.1;4.4
85;2021-03-23;2420;740;71454;30561;10.5;4.5
85;2021-03-24;2206;532;73660;31093;10.8;4.6
85;2021-03-25;3649;602;77309;31695;11.3;4.6
85;2021-03-26;3357;655;80666;32350;11.8;4.7
85;2021-03-27;1729;124;82395;32474;12.1;4.8
85;2021-03-28;540;6;82935;32480;12.1;4.8
85;2021-03-29;2414;765;85349;33245;12.5;4.9
85;2021-03-30;2866;1028;88215;34273;12.9;5.0
85;2021-03-31;2199;680;90414;34953;13.2;5.1
85;2021-04-01;3880;922;94294;35875;13.8;5.3
85;2021-04-02;2711;1112;97005;36987;14.2;5.4
85;2021-04-03;1411;323;98416;37310;14.4;5.5
85;2021-04-04;324;29;98740;37339;14.5;5.5
85;2021-04-05;104;174;98844;37513;14.5;5.5
85;2021-04-06;2196;1599;101040;39112;14.8;5.7
85;2021-04-07;3092;1198;104132;40310;15.2;5.9
85;2021-04-08;4544;1612;108676;41922;15.9;6.1
85;2021-04-09;4604;1237;113280;43159;16.6;6.3
85;2021-04-10;1866;401;115146;43560;16.9;6.4
85;2021-04-11;27;10;115173;43570;16.9;6.4
85;2021-04-12;4284;1496;119457;45066;17.5;6.6
85;2021-04-13;4837;1885;124294;46951;18.2;6.9
85;2021-04-14;3960;1016;128254;47967;18.8;7.0
85;2021-04-15;5516;1746;133770;49713;19.6;7.3
85;2021-04-16;5241;1546;139011;51259;20.3;7.5
85;2021-04-17;1382;436;140393;51695;20.5;7.6
85;2021-04-18;351;12;140744;51707;20.6;7.6
85;2021-04-19;3368;1705;144112;53412;21.1;7.8
85;2021-04-20;3694;1932;147806;55344;21.6;8.1
85;2021-04-21;2693;1694;150499;57038;22.0;8.3
85;2021-04-22;3805;2238;154304;59276;22.6;8.7
85;2021-04-23;3903;2096;158207;61372;23.2;9.0
85;2021-04-24;1663;1535;159870;62907;23.4;9.2
85;2021-04-25;981;565;160851;63472;23.5;9.3
85;2021-04-26;3589;2357;164440;65829;24.1;9.6
85;2021-04-27;4392;2169;168832;67998;24.7;10.0
85;2021-04-28;5747;1263;174579;69261;25.6;10.1
85;2021-04-29;5635;2010;180214;71271;26.4;10.4
85;2021-04-30;5573;1678;185787;72949;27.2;10.7
85;2021-05-01;1736;638;187523;73587;27.4;10.8
85;2021-05-02;873;471;188396;74058;27.6;10.8
85;2021-05-03;3494;2389;191890;76447;28.1;11.2
85;2021-05-04;3487;3089;195377;79536;28.6;11.6
85;2021-05-05;4532;2170;199909;81706;29.3;12.0
85;2021-05-06;4922;2605;204831;84311;30.0;12.3
85;2021-05-07;3933;3861;208764;88172;30.6;12.9
85;2021-05-08;2246;232;211010;88404;30.9;12.9
85;2021-05-09;1507;183;212517;88587;31.1;13.0
85;2021-05-10;3209;4925;215726;93512;31.6;13.7
85;2021-05-11;4027;4973;219753;98485;32.2;14.4
85;2021-05-12;5019;3936;224772;102421;32.9;15.0
85;2021-05-13;5144;614;229916;103035;33.7;15.1
85;2021-05-14;4356;3167;234272;106202;34.3;15.5
85;2021-05-15;2325;776;236597;106978;34.6;15.7
85;2021-05-16;2213;162;238810;107140;35.0;15.7
85;2021-05-17;4145;3375;242955;110515;35.6;16.2
85;2021-05-18;5215;2854;248170;113369;36.3;16.6
85;2021-05-19;6493;1771;254663;115140;37.3;16.9
85;2021-05-20;6773;2177;261436;117317;38.3;17.2
85;2021-05-21;5497;2742;266933;120059;39.1;17.6
85;2021-05-22;2584;754;269517;120813;39.4;17.7
85;2021-05-23;1329;161;270846;120974;39.6;17.7
85;2021-05-24;4572;436;275418;121410;40.3;17.8
85;2021-05-25;4516;3569;279934;124979;41.0;18.3
85;2021-05-26;4945;2680;284879;127659;41.7;18.7
85;2021-05-27;4959;3695;289838;131354;42.4;19.2
85;2021-05-28;5252;4063;295090;135417;43.2;19.8
85;2021-05-29;3962;1533;299052;136950;43.8;20.0
85;2021-05-30;1291;126;300343;137076;44.0;20.1
85;2021-05-31;4689;3382;305032;140458;44.6;20.6
85;2021-06-01;5405;3400;310437;143858;45.4;21.1
85;2021-06-02;5554;2522;315991;146380;46.3;21.4
85;2021-06-03;5915;3235;321906;149615;47.1;21.9
85;2021-06-04;5837;3823;327743;153438;48.0;22.5
85;2021-06-05;2847;1938;330590;155376;48.4;22.7
85;2021-06-06;1511;804;332101;156180;48.6;22.9
85;2021-06-07;3236;4860;335337;161040;49.1;23.6
85;2021-06-08;4090;4529;339427;165569;49.7;24.2
85;2021-06-09;4844;3516;344271;169085;50.4;24.7
85;2021-06-10;5199;3703;349470;172788;51.2;25.3
85;2021-06-11;4507;4665;353977;177453;51.8;26.0
85;2021-06-12;1491;1800;355468;179253;52.0;26.2
85;2021-06-13;1219;672;356687;179925;52.2;26.3
85;2021-06-14;2682;5094;359369;185019;52.6;27.1
85;2021-06-15;3715;4935;363084;189954;53.1;27.8
85;2021-06-16;4083;3908;367167;193862;53.7;28.4
85;2021-06-17;3939;3902;371106;197764;54.3;28.9
85;2021-06-18;3625;5686;374731;203450;54.9;29.8
85;2021-06-19;1213;2030;375944;205480;55.0;30.1
85;2021-06-20;140;520;376084;206000;55.0;30.2
85;2021-06-21;2375;5811;378459;211811;55.4;31.0
85;2021-06-22;2849;5733;381308;217544;55.8;31.8
85;2021-06-23;3390;4499;384698;222043;56.3;32.5
85;2021-06-24;3642;4562;388340;226605;56.8;33.2
85;2021-06-25;2289;6181;390629;232786;57.2;34.1
85;2021-06-26;791;3757;391420;236543;57.3;34.6
85;2021-06-27;125;1369;391545;237912;57.3;34.8
85;2021-06-28;1186;6713;392731;244625;57.5;35.8
85;2021-06-29;1757;6876;394488;251501;57.7;36.8
85;2021-06-30;2212;6208;396700;257709;58.1;37.7
85;2021-07-01;2842;6056;399542;263765;58.5;38.6
85;2021-07-02;2268;7015;401810;270780;58.8;39.6
85;2021-07-03;618;3165;402428;273945;58.9;40.1
85;2021-07-04;145;1086;402573;275031;58.9;40.3
85;2021-07-05;1064;6649;403637;281680;59.1;41.2
85;2021-07-06;1582;6455;405219;288135;59.3;42.2
85;2021-07-07;1649;5864;406868;293999;59.6;43.0
85;2021-07-08;2165;5440;409033;299439;59.9;43.8
85;2021-07-09;1645;7096;410678;306535;60.1;44.9
85;2021-07-10;566;2835;411244;309370;60.2;45.3
85;2021-07-11;529;1287;411773;310657;60.3;45.5
85;2021-07-12;1408;7046;413181;317703;60.5;46.5
85;2021-07-13;2059;7388;415240;325091;60.8;47.6
85;2021-07-14;1451;2047;416691;327138;61.0;47.9
85;2021-07-15;2681;6943;419372;334081;61.4;48.9
85;2021-07-16;3432;6835;422804;340916;61.9;49.9
85;2021-07-17;1565;2153;424369;343069;62.1;50.2
85;2021-07-18;1150;1154;425519;344223;62.3;50.4
85;2021-07-19;3559;6229;429078;350452;62.8;51.3
85;2021-07-20;4300;6214;433378;356666;63.4;52.2
85;2021-07-21;3996;6199;437374;362865;64.0;53.1
85;2021-07-22;3908;6189;441282;369054;64.6;54.0
85;2021-07-23;4534;6707;445816;375761;65.3;55.0
85;2021-07-24;1045;2296;446861;378057;65.4;55.3
85;2021-07-25;491;303;447352;378360;65.5;55.4
85;2021-07-26;4514;5362;451866;383722;66.1;56.2
85;2021-07-27;5321;5396;457187;389118;66.9;57.0
85;2021-07-28;4962;4972;462149;394090;67.6;57.7
85;2021-07-29;5879;4736;468028;398826;68.5;58.4
85;2021-07-30;6028;4953;474056;403779;69.4;59.1
85;2021-07-31;1226;1577;475282;405356;69.6;59.3
85;2021-08-01;470;195;475752;405551;69.6;59.4
85;2021-08-02;4950;3954;480702;409505;70.4;59.9
85;2021-08-03;6523;3355;487225;412860;71.3;60.4
85;2021-08-04;6631;3426;493856;416286;72.3;60.9
85;2021-08-05;6199;3605;500055;419891;73.2;61.5
85;2021-08-06;5810;4515;505865;424406;74.0;62.1
85;2021-08-07;1506;1180;507371;425586;74.3;62.3
85;2021-08-08;332;232;507703;425818;74.3;62.3
85;2021-08-09;4154;3276;511857;429094;74.9;62.8
85;2021-08-10;4830;3420;516687;432514;75.6;63.3
85;2021-08-11;4672;4218;521359;436732;76.3;63.9
85;2021-08-12;4473;4298;525832;441030;77.0;64.6
85;2021-08-13;3899;3648;529731;444678;77.5;65.1
85;2021-08-14;1028;1088;530759;445766;77.7;65.2
85;2021-08-15;160;237;530919;446003;77.7;65.3
85;2021-08-16;2843;4775;533762;450778;78.1;66.0
85;2021-08-17;2977;4359;536739;455137;78.6;66.6
85;2021-08-18;3155;4109;539894;459246;79.0;67.2
85;2021-08-19;2730;4280;542624;463526;79.4;67.8
85;2021-08-20;2481;5230;545105;468756;79.8;68.6
85;2021-08-21;704;1398;545809;470154;79.9;68.8
85;2021-08-22;344;1019;546153;471173;79.9;69.0
85;2021-08-23;1873;5374;548026;476547;80.2;69.8
85;2021-08-24;1825;4873;549851;481420;80.5;70.5
85;2021-08-25;1648;4834;551499;486254;80.7;71.2
85;2021-08-26;1542;4766;553041;491020;81.0;71.9
85;2021-08-27;1703;5519;554744;496539;81.2;72.7
85;2021-08-28;573;1348;555317;497887;81.3;72.9
85;2021-08-29;128;989;555445;498876;81.3;73.0
85;2021-08-30;1121;4911;556566;503787;81.5;73.7
85;2021-08-31;1132;5361;557698;509148;81.6;74.5
85;2021-09-01;1138;4992;558836;514140;81.8;75.3
85;2021-09-02;993;4146;559829;518286;81.9;75.9
85;2021-09-03;1246;4232;561075;522518;82.1;76.5
85;2021-09-04;370;1294;561445;523812;82.2;76.7
85;2021-09-05;42;168;561487;523980;82.2;76.7
85;2021-09-06;851;3389;562338;527369;82.3;77.2
85;2021-09-07;843;2868;563181;530237;82.4;77.6
85;2021-09-08;870;3381;564051;533618;82.6;78.1
85;2021-09-09;651;2541;564702;536159;82.7;78.5
85;2021-09-10;793;3305;565495;539464;82.8;79.0
85;2021-09-11;243;1303;565738;540767;82.8;79.2
85;2021-09-12;17;35;565755;540802;82.8;79.2
85;2021-09-13;547;2122;566302;542924;82.9;79.5
85;2021-09-14;551;1631;566853;544555;83.0;79.7
85;2021-09-15;611;2529;567464;547084;83.1;80.1
85;2021-09-16;399;1363;567863;548447;83.1;80.3
85;2021-09-17;738;2387;568601;550834;83.2;80.6
85;2021-09-18;190;919;568791;551753;83.3;80.8
85;2021-09-19;5;22;568796;551775;83.3;80.8
85;2021-09-20;353;1355;569149;553130;83.3;81.0
85;2021-09-21;431;1069;569580;554199;83.4;81.1
85;2021-09-22;434;1905;570014;556104;83.4;81.4
85;2021-09-23;815;983;570829;557087;83.6;81.5
85;2021-09-24;590;1929;571419;559016;83.6;81.8
85;2021-09-25;153;882;571572;559898;83.7;82.0
85;2021-09-26;0;12;571572;559910;83.7;82.0
85;2021-09-27;364;929;571936;560839;83.7;82.1
85;2021-09-28;231;565;572167;561404;83.7;82.2
85;2021-09-29;396;1288;572563;562692;83.8;82.4
85;2021-09-30;366;801;572929;563493;83.9;82.5
85;2021-10-01;423;921;573352;564414;83.9;82.6
85;2021-10-02;179;508;573531;564922;83.9;82.7
85;2021-10-03;4;12;573535;564934;83.9;82.7
85;2021-10-04;200;685;573735;565619;84.0;82.8
85;2021-10-05;294;430;574029;566049;84.0;82.9
85;2021-10-06;359;866;574388;566915;84.1;83.0
85;2021-10-07;239;392;574627;567307;84.1;83.0
85;2021-10-08;338;1018;574965;568325;84.2;83.2
85;2021-10-09;105;309;575070;568634;84.2;83.2
85;2021-10-10;14;8;575084;568642;84.2;83.2
85;2021-10-11;207;479;575291;569121;84.2;83.3
85;2021-10-12;169;331;575460;569452;84.2;83.4
85;2021-10-13;317;636;575777;570088;84.3;83.4
85;2021-10-14;201;585;575978;570673;84.3;83.5
86;2020-12-27;0;0;0;0;0.0;0.0
86;2020-12-28;2;0;2;0;0.0;0.0
86;2020-12-29;1;0;3;0;0.0;0.0
86;2020-12-30;0;0;3;0;0.0;0.0
86;2020-12-31;0;0;3;0;0.0;0.0
86;2021-01-01;0;0;3;0;0.0;0.0
86;2021-01-02;1;0;4;0;0.0;0.0
86;2021-01-03;2;0;6;0;0.0;0.0
86;2021-01-04;0;0;6;0;0.0;0.0
86;2021-01-05;1;0;7;0;0.0;0.0
86;2021-01-06;178;1;185;1;0.0;0.0
86;2021-01-07;671;0;856;1;0.2;0.0
86;2021-01-08;609;3;1465;4;0.3;0.0
86;2021-01-09;0;0;1465;4;0.3;0.0
86;2021-01-10;173;0;1638;4;0.4;0.0
86;2021-01-11;305;0;1943;4;0.4;0.0
86;2021-01-12;460;1;2403;5;0.5;0.0
86;2021-01-13;337;1;2740;6;0.6;0.0
86;2021-01-14;552;1;3292;7;0.8;0.0
86;2021-01-15;544;3;3836;10;0.9;0.0
86;2021-01-16;2;0;3838;10;0.9;0.0
86;2021-01-17;0;0;3838;10;0.9;0.0
86;2021-01-18;564;0;4402;10;1.0;0.0
86;2021-01-19;1918;1;6320;11;1.4;0.0
86;2021-01-20;1464;27;7784;38;1.8;0.0
86;2021-01-21;1291;2;9075;40;2.1;0.0
86;2021-01-22;836;0;9911;40;2.3;0.0
86;2021-01-23;314;1;10225;41;2.3;0.0
86;2021-01-24;0;0;10225;41;2.3;0.0
86;2021-01-25;587;109;10812;150;2.5;0.0
86;2021-01-26;752;124;11564;274;2.6;0.1
86;2021-01-27;765;155;12329;429;2.8;0.1
86;2021-01-28;1053;425;13382;854;3.1;0.2
86;2021-01-29;880;217;14262;1071;3.3;0.2
86;2021-01-30;276;103;14538;1174;3.3;0.3
86;2021-01-31;57;157;14595;1331;3.3;0.3
86;2021-02-01;434;209;15029;1540;3.4;0.4
86;2021-02-02;573;385;15602;1925;3.6;0.4
86;2021-02-03;525;224;16127;2149;3.7;0.5
86;2021-02-04;479;366;16606;2515;3.8;0.6
86;2021-02-05;437;739;17043;3254;3.9;0.7
86;2021-02-06;148;204;17191;3458;3.9;0.8
86;2021-02-07;120;8;17311;3466;4.0;0.8
86;2021-02-08;362;327;17673;3793;4.0;0.9
86;2021-02-09;755;1121;18428;4914;4.2;1.1
86;2021-02-10;972;939;19400;5853;4.4;1.3
86;2021-02-11;1009;977;20409;6830;4.7;1.6
86;2021-02-12;746;381;21155;7211;4.8;1.6
86;2021-02-13;193;96;21348;7307;4.9;1.7
86;2021-02-14;1;34;21349;7341;4.9;1.7
86;2021-02-15;243;507;21592;7848;4.9;1.8
86;2021-02-16;384;866;21976;8714;5.0;2.0
86;2021-02-17;453;894;22429;9608;5.1;2.2
86;2021-02-18;422;871;22851;10479;5.2;2.4
86;2021-02-19;602;640;23453;11119;5.4;2.5
86;2021-02-20;115;176;23568;11295;5.4;2.6
86;2021-02-21;1;0;23569;11295;5.4;2.6
86;2021-02-22;241;426;23810;11721;5.4;2.7
86;2021-02-23;369;603;24179;12324;5.5;2.8
86;2021-02-24;409;584;24588;12908;5.6;3.0
86;2021-02-25;903;668;25491;13576;5.8;3.1
86;2021-02-26;1029;538;26520;14114;6.1;3.2
86;2021-02-27;460;151;26980;14265;6.2;3.3
86;2021-02-28;3;2;26983;14267;6.2;3.3
86;2021-03-01;232;526;27215;14793;6.2;3.4
86;2021-03-02;1142;853;28357;15646;6.5;3.6
86;2021-03-03;794;632;29151;16278;6.7;3.7
86;2021-03-04;1496;632;30647;16910;7.0;3.9
86;2021-03-05;1577;315;32224;17225;7.4;3.9
86;2021-03-06;995;169;33219;17394;7.6;4.0
86;2021-03-07;371;32;33590;17426;7.7;4.0
86;2021-03-08;473;542;34063;17968;7.8;4.1
86;2021-03-09;1368;533;35431;18501;8.1;4.2
86;2021-03-10;949;612;36380;19113;8.3;4.4
86;2021-03-11;1798;481;38178;19594;8.7;4.5
86;2021-03-12;2209;443;40387;20037;9.2;4.6
86;2021-03-13;1444;103;41831;20140;9.6;4.6
86;2021-03-14;133;16;41964;20156;9.6;4.6
86;2021-03-15;785;160;42749;20316;9.8;4.6
86;2021-03-16;847;206;43596;20522;10.0;4.7
86;2021-03-17;786;208;44382;20730;10.1;4.7
86;2021-03-18;1005;104;45387;20834;10.4;4.8
86;2021-03-19;2145;330;47532;21164;10.9;4.8
86;2021-03-20;592;133;48124;21297;11.0;4.9
86;2021-03-21;10;0;48134;21297;11.0;4.9
86;2021-03-22;852;278;48986;21575;11.2;4.9
86;2021-03-23;2017;331;51003;21906;11.7;5.0
86;2021-03-24;1557;291;52560;22197;12.0;5.1
86;2021-03-25;2489;357;55049;22554;12.6;5.2
86;2021-03-26;3044;364;58093;22918;13.3;5.2
86;2021-03-27;733;143;58826;23061;13.4;5.3
86;2021-03-28;5;128;58831;23189;13.5;5.3
86;2021-03-29;1260;391;60091;23580;13.7;5.4
86;2021-03-30;2406;827;62497;24407;14.3;5.6
86;2021-03-31;1511;630;64008;25037;14.6;5.7
86;2021-04-01;2246;949;66254;25986;15.1;5.9
86;2021-04-02;1902;560;68156;26546;15.6;6.1
86;2021-04-03;826;327;68982;26873;15.8;6.1
86;2021-04-04;83;110;69065;26983;15.8;6.2
86;2021-04-05;314;5;69379;26988;15.9;6.2
86;2021-04-06;1531;963;70910;27951;16.2;6.4
86;2021-04-07;1633;630;72543;28581;16.6;6.5
86;2021-04-08;2569;764;75112;29345;17.2;6.7
86;2021-04-09;3250;657;78362;30002;17.9;6.9
86;2021-04-10;1662;196;80024;30198;18.3;6.9
86;2021-04-11;442;11;80466;30209;18.4;6.9
86;2021-04-12;819;766;81285;30975;18.6;7.1
86;2021-04-13;2454;941;83739;31916;19.1;7.3
86;2021-04-14;1870;883;85609;32799;19.6;7.5
86;2021-04-15;2276;732;87885;33531;20.1;7.7
86;2021-04-16;2471;1232;90356;34763;20.7;7.9
86;2021-04-17;1040;264;91396;35027;20.9;8.0
86;2021-04-18;119;4;91515;35031;20.9;8.0
86;2021-04-19;745;799;92260;35830;21.1;8.2
86;2021-04-20;2301;1508;94561;37338;21.6;8.5
86;2021-04-21;2108;1128;96669;38466;22.1;8.8
86;2021-04-22;2329;1447;98998;39913;22.6;9.1
86;2021-04-23;2392;1579;101390;41492;23.2;9.5
86;2021-04-24;1299;512;102689;42004;23.5;9.6
86;2021-04-25;825;28;103514;42032;23.7;9.6
86;2021-04-26;2079;895;105593;42927;24.1;9.8
86;2021-04-27;3155;1671;108748;44598;24.9;10.2
86;2021-04-28;3002;1522;111750;46120;25.5;10.5
86;2021-04-29;3558;1835;115308;47955;26.4;11.0
86;2021-04-30;2969;1488;118277;49443;27.0;11.3
86;2021-05-01;1580;200;119857;49643;27.4;11.3
86;2021-05-02;1279;45;121136;49688;27.7;11.4
86;2021-05-03;2563;1009;123699;50697;28.3;11.6
86;2021-05-04;3508;1903;127207;52600;29.1;12.0
86;2021-05-05;3989;1488;131196;54088;30.0;12.4
86;2021-05-06;4289;1658;135485;55746;31.0;12.7
86;2021-05-07;4043;1830;139528;57576;31.9;13.2
86;2021-05-08;1976;399;141504;57975;32.4;13.3
86;2021-05-09;1642;203;143146;58178;32.7;13.3
86;2021-05-10;1958;1176;145104;59354;33.2;13.6
86;2021-05-11;3603;2688;148707;62042;34.0;14.2
86;2021-05-12;2252;1649;150959;63691;34.5;14.6
86;2021-05-13;1687;299;152646;63990;34.9;14.6
86;2021-05-14;2097;789;154743;64779;35.4;14.8
86;2021-05-15;1466;503;156209;65282;35.7;14.9
86;2021-05-16;778;164;156987;65446;35.9;15.0
86;2021-05-17;3218;1060;160205;66506;36.6;15.2
86;2021-05-18;4305;1664;164510;68170;37.6;15.6
86;2021-05-19;3587;1438;168097;69608;38.4;15.9
86;2021-05-20;4370;1625;172467;71233;39.4;16.3
86;2021-05-21;3438;1772;175905;73005;40.2;16.7
86;2021-05-22;2076;665;177981;73670;40.7;16.8
86;2021-05-23;1437;183;179418;73853;41.0;16.9
86;2021-05-24;1845;204;181263;74057;41.4;16.9
86;2021-05-25;2851;1640;184114;75697;42.1;17.3
86;2021-05-26;2725;1530;186839;77227;42.7;17.7
86;2021-05-27;3546;1851;190385;79078;43.5;18.1
86;2021-05-28;2164;2539;192549;81617;44.0;18.7
86;2021-05-29;1527;1286;194076;82903;44.4;19.0
86;2021-05-30;934;133;195010;83036;44.6;19.0
86;2021-05-31;1922;1820;196932;84856;45.0;19.4
86;2021-06-01;2665;2588;199597;87444;45.6;20.0
86;2021-06-02;2306;2664;201903;90108;46.2;20.6
86;2021-06-03;3337;2413;205240;92521;46.9;21.2
86;2021-06-04;2237;2860;207477;95381;47.4;21.8
86;2021-06-05;1503;1582;208980;96963;47.8;22.2
86;2021-06-06;820;900;209800;97863;48.0;22.4
86;2021-06-07;1119;2464;210919;100327;48.2;22.9
86;2021-06-08;1990;3697;212909;104024;48.7;23.8
86;2021-06-09;1901;3319;214810;107343;49.1;24.5
86;2021-06-10;2349;3239;217159;110582;49.6;25.3
86;2021-06-11;1517;2796;218676;113378;50.0;25.9
86;2021-06-12;746;2244;219422;115622;50.2;26.4
86;2021-06-13;214;1477;219636;117099;50.2;26.8
86;2021-06-14;1158;2902;220794;120001;50.5;27.4
86;2021-06-15;1690;4260;222484;124261;50.9;28.4
86;2021-06-16;1808;3136;224292;127397;51.3;29.1
86;2021-06-17;1777;4445;226069;131842;51.7;30.1
86;2021-06-18;1882;4586;227951;136428;52.1;31.2
86;2021-06-19;636;2097;228587;138525;52.3;31.7
86;2021-06-20;172;1319;228759;139844;52.3;32.0
86;2021-06-21;1106;2237;229865;142081;52.6;32.5
86;2021-06-22;1298;3459;231163;145540;52.8;33.3
86;2021-06-23;1364;2403;232527;147943;53.2;33.8
86;2021-06-24;1590;2725;234117;150668;53.5;34.4
86;2021-06-25;1192;3546;235309;154214;53.8;35.3
86;2021-06-26;391;2651;235700;156865;53.9;35.9
86;2021-06-27;138;1633;235838;158498;53.9;36.2
86;2021-06-28;270;3338;236108;161836;54.0;37.0
86;2021-06-29;858;4604;236966;166440;54.2;38.1
86;2021-06-30;1051;2974;238017;169414;54.4;38.7
86;2021-07-01;1549;3004;239566;172418;54.8;39.4
86;2021-07-02;1111;3643;240677;176061;55.0;40.3
86;2021-07-03;517;2393;241194;178454;55.1;40.8
86;2021-07-04;115;1346;241309;179800;55.2;41.1
86;2021-07-05;478;2833;241787;182633;55.3;41.8
86;2021-07-06;988;4108;242775;186741;55.5;42.7
86;2021-07-07;1260;2627;244035;189368;55.8;43.3
86;2021-07-08;1618;3149;245653;192517;56.2;44.0
86;2021-07-09;1746;3083;247399;195600;56.6;44.7
86;2021-07-10;1304;1954;248703;197554;56.9;45.2
86;2021-07-11;482;839;249185;198393;57.0;45.4
86;2021-07-12;848;2403;250033;200796;57.2;45.9
86;2021-07-13;1780;3369;251813;204165;57.6;46.7
86;2021-07-14;785;1232;252598;205397;57.8;47.0
86;2021-07-15;1882;3291;254480;208688;58.2;47.7
86;2021-07-16;1671;2663;256151;211351;58.6;48.3
86;2021-07-17;1351;1599;257502;212950;58.9;48.7
86;2021-07-18;381;908;257883;213858;59.0;48.9
86;2021-07-19;1377;1887;259260;215745;59.3;49.3
86;2021-07-20;2352;2736;261612;218481;59.8;50.0
86;2021-07-21;2305;2165;263917;220646;60.3;50.4
86;2021-07-22;2903;2801;266820;223447;61.0;51.1
86;2021-07-23;2466;2166;269286;225613;61.6;51.6
86;2021-07-24;1546;1226;270832;226839;61.9;51.9
86;2021-07-25;718;322;271550;227161;62.1;51.9
86;2021-07-26;1588;2103;273138;229264;62.4;52.4
86;2021-07-27;3558;2757;276696;232021;63.3;53.0
86;2021-07-28;3284;2141;279980;234162;64.0;53.5
86;2021-07-29;3266;2547;283246;236709;64.8;54.1
86;2021-07-30;2247;2380;285493;239089;65.3;54.7
86;2021-07-31;1429;1059;286922;240148;65.6;54.9
86;2021-08-01;651;338;287573;240486;65.7;55.0
86;2021-08-02;1944;1679;289517;242165;66.2;55.4
86;2021-08-03;3290;1992;292807;244157;66.9;55.8
86;2021-08-04;2739;1789;295546;245946;67.6;56.2
86;2021-08-05;3572;2057;299118;248003;68.4;56.7
86;2021-08-06;2420;1764;301538;249767;68.9;57.1
86;2021-08-07;1576;997;303114;250764;69.3;57.3
86;2021-08-08;958;553;304072;251317;69.5;57.5
86;2021-08-09;1885;1305;305957;252622;69.9;57.8
86;2021-08-10;2683;1780;308640;254402;70.6;58.2
86;2021-08-11;2367;1436;311007;255838;71.1;58.5
86;2021-08-12;2486;1834;313493;257672;71.7;58.9
86;2021-08-13;1838;1488;315331;259160;72.1;59.3
86;2021-08-14;1331;1153;316662;260313;72.4;59.5
86;2021-08-15;562;623;317224;260936;72.5;59.7
86;2021-08-16;1144;1788;318368;262724;72.8;60.1
86;2021-08-17;1559;2215;319927;264939;73.1;60.6
86;2021-08-18;1266;1861;321193;266800;73.4;61.0
86;2021-08-19;1501;2634;322694;269434;73.8;61.6
86;2021-08-20;1257;2609;323951;272043;74.1;62.2
86;2021-08-21;889;2008;324840;274051;74.3;62.7
86;2021-08-22;350;721;325190;274772;74.3;62.8
86;2021-08-23;724;1824;325914;276596;74.5;63.2
86;2021-08-24;1081;2752;326995;279348;74.8;63.9
86;2021-08-25;935;2064;327930;281412;75.0;64.3
86;2021-08-26;920;2813;328850;284225;75.2;65.0
86;2021-08-27;863;2174;329713;286399;75.4;65.5
86;2021-08-28;557;1775;330270;288174;75.5;65.9
86;2021-08-29;114;828;330384;289002;75.5;66.1
86;2021-08-30;686;2101;331070;291103;75.7;66.6
86;2021-08-31;960;3156;332030;294259;75.9;67.3
86;2021-09-01;571;2583;332601;296842;76.0;67.9
86;2021-09-02;757;2610;333358;299452;76.2;68.5
86;2021-09-03;758;2251;334116;301703;76.4;69.0
86;2021-09-04;366;2127;334482;303830;76.5;69.5
86;2021-09-05;27;909;334509;304739;76.5;69.7
86;2021-09-06;359;1572;334868;306311;76.6;70.0
86;2021-09-07;511;1995;335379;308306;76.7;70.5
86;2021-09-08;566;2112;335945;310418;76.8;71.0
86;2021-09-09;577;1785;336522;312203;76.9;71.4
86;2021-09-10;525;1819;337047;314022;77.1;71.8
86;2021-09-11;359;1832;337406;315854;77.1;72.2
86;2021-09-12;102;764;337508;316618;77.2;72.4
86;2021-09-13;324;984;337832;317602;77.2;72.6
86;2021-09-14;410;1359;338242;318961;77.3;72.9
86;2021-09-15;474;1556;338716;320517;77.4;73.3
86;2021-09-16;437;1011;339153;321528;77.5;73.5
86;2021-09-17;491;1061;339644;322589;77.7;73.8
86;2021-09-18;294;1271;339938;323860;77.7;74.0
86;2021-09-19;85;415;340023;324275;77.7;74.1
86;2021-09-20;223;641;340246;324916;77.8;74.3
86;2021-09-21;266;827;340512;325743;77.8;74.5
86;2021-09-22;337;1185;340849;326928;77.9;74.7
86;2021-09-23;355;582;341204;327510;78.0;74.9
86;2021-09-24;309;841;341513;328351;78.1;75.1
86;2021-09-25;289;1063;341802;329414;78.1;75.3
86;2021-09-26;45;166;341847;329580;78.2;75.4
86;2021-09-27;160;359;342007;329939;78.2;75.4
86;2021-09-28;239;368;342246;330307;78.2;75.5
86;2021-09-29;229;686;342475;330993;78.3;75.7
86;2021-09-30;255;496;342730;331489;78.4;75.8
86;2021-10-01;258;524;342988;332013;78.4;75.9
86;2021-10-02;279;578;343267;332591;78.5;76.0
86;2021-10-03;19;73;343286;332664;78.5;76.1
86;2021-10-04;97;319;343383;332983;78.5;76.1
86;2021-10-05;130;275;343513;333258;78.5;76.2
86;2021-10-06;183;451;343696;333709;78.6;76.3
86;2021-10-07;188;449;343884;334158;78.6;76.4
86;2021-10-08;202;483;344086;334641;78.7;76.5
86;2021-10-09;230;451;344316;335092;78.7;76.6
86;2021-10-10;2;5;344318;335097;78.7;76.6
86;2021-10-11;145;302;344463;335399;78.8;76.7
86;2021-10-12;116;306;344579;335705;78.8;76.8
86;2021-10-13;220;382;344799;336087;78.8;76.8
86;2021-10-14;143;325;344942;336412;78.9;76.9
87;2020-12-27;0;0;0;0;0.0;0.0
87;2020-12-28;3;2;3;2;0.0;0.0
87;2020-12-29;0;0;3;2;0.0;0.0
87;2020-12-30;0;0;3;2;0.0;0.0
87;2020-12-31;0;0;3;2;0.0;0.0
87;2021-01-01;0;0;3;2;0.0;0.0
87;2021-01-02;0;0;3;2;0.0;0.0
87;2021-01-03;0;0;3;2;0.0;0.0
87;2021-01-04;2;1;5;3;0.0;0.0
87;2021-01-05;1;0;6;3;0.0;0.0
87;2021-01-06;10;0;16;3;0.0;0.0
87;2021-01-07;301;1;317;4;0.1;0.0
87;2021-01-08;407;0;724;4;0.2;0.0
87;2021-01-09;66;0;790;4;0.2;0.0
87;2021-01-10;35;0;825;4;0.2;0.0
87;2021-01-11;424;0;1249;4;0.3;0.0
87;2021-01-12;654;0;1903;4;0.5;0.0
87;2021-01-13;660;3;2563;7;0.7;0.0
87;2021-01-14;517;11;3080;18;0.8;0.0
87;2021-01-15;534;3;3614;21;1.0;0.0
87;2021-01-16;204;1;3818;22;1.0;0.0
87;2021-01-17;1;0;3819;22;1.0;0.0
87;2021-01-18;645;6;4464;28;1.2;0.0
87;2021-01-19;657;1;5121;29;1.4;0.0
87;2021-01-20;674;4;5795;33;1.6;0.0
87;2021-01-21;717;2;6512;35;1.8;0.0
87;2021-01-22;757;4;7269;39;2.0;0.0
87;2021-01-23;287;1;7556;40;2.0;0.0
87;2021-01-24;1;0;7557;40;2.0;0.0
87;2021-01-25;620;10;8177;50;2.2;0.0
87;2021-01-26;570;52;8747;102;2.4;0.0
87;2021-01-27;572;40;9319;142;2.5;0.0
87;2021-01-28;856;110;10175;252;2.7;0.1
87;2021-01-29;741;273;10916;525;2.9;0.1
87;2021-01-30;325;72;11241;597;3.0;0.2
87;2021-01-31;34;71;11275;668;3.0;0.2
87;2021-02-01;413;309;11688;977;3.2;0.3
87;2021-02-02;452;482;12140;1459;3.3;0.4
87;2021-02-03;540;420;12680;1879;3.4;0.5
87;2021-02-04;613;595;13293;2474;3.6;0.7
87;2021-02-05;344;382;13637;2856;3.7;0.8
87;2021-02-06;55;156;13692;3012;3.7;0.8
87;2021-02-07;20;0;13712;3012;3.7;0.8
87;2021-02-08;246;444;13958;3456;3.8;0.9
87;2021-02-09;219;541;14177;3997;3.8;1.1
87;2021-02-10;262;623;14439;4620;3.9;1.2
87;2021-02-11;286;539;14725;5159;4.0;1.4
87;2021-02-12;287;556;15012;5715;4.0;1.5
87;2021-02-13;25;170;15037;5885;4.1;1.6
87;2021-02-14;0;3;15037;5888;4.1;1.6
87;2021-02-15;237;388;15274;6276;4.1;1.7
87;2021-02-16;332;330;15606;6606;4.2;1.8
87;2021-02-17;329;379;15935;6985;4.3;1.9
87;2021-02-18;478;646;16413;7631;4.4;2.1
87;2021-02-19;406;481;16819;8112;4.5;2.2
87;2021-02-20;124;195;16943;8307;4.6;2.2
87;2021-02-21;2;9;16945;8316;4.6;2.2
87;2021-02-22;440;576;17385;8892;4.7;2.4
87;2021-02-23;557;636;17942;9528;4.8;2.6
87;2021-02-24;451;598;18393;10126;5.0;2.7
87;2021-02-25;790;709;19183;10835;5.2;2.9
87;2021-02-26;842;480;20025;11315;5.4;3.1
87;2021-02-27;405;212;20430;11527;5.5;3.1
87;2021-02-28;3;0;20433;11527;5.5;3.1
87;2021-03-01;518;370;20951;11897;5.7;3.2
87;2021-03-02;1031;392;21982;12289;5.9;3.3
87;2021-03-03;1174;353;23156;12642;6.2;3.4
87;2021-03-04;1406;341;24562;12983;6.6;3.5
87;2021-03-05;1770;287;26332;13270;7.1;3.6
87;2021-03-06;1049;42;27381;13312;7.4;3.6
87;2021-03-07;257;6;27638;13318;7.5;3.6
87;2021-03-08;863;247;28501;13565;7.7;3.7
87;2021-03-09;1287;236;29788;13801;8.0;3.7
87;2021-03-10;1299;237;31087;14038;8.4;3.8
87;2021-03-11;1756;257;32843;14295;8.9;3.9
87;2021-03-12;2129;293;34972;14588;9.4;3.9
87;2021-03-13;1309;22;36281;14610;9.8;3.9
87;2021-03-14;80;1;36361;14611;9.8;3.9
87;2021-03-15;987;358;37348;14969;10.1;4.0
87;2021-03-16;1060;244;38408;15213;10.4;4.1
87;2021-03-17;1070;221;39478;15434;10.6;4.2
87;2021-03-18;1186;349;40664;15783;11.0;4.3
87;2021-03-19;1684;283;42348;16066;11.4;4.3
87;2021-03-20;926;92;43274;16158;11.7;4.4
87;2021-03-21;32;0;43306;16158;11.7;4.4
87;2021-03-22;1048;384;44354;16542;12.0;4.5
87;2021-03-23;1386;432;45740;16974;12.3;4.6
87;2021-03-24;1508;367;47248;17341;12.7;4.7
87;2021-03-25;2500;399;49748;17740;13.4;4.8
87;2021-03-26;2532;460;52280;18200;14.1;4.9
87;2021-03-27;891;126;53171;18326;14.3;4.9
87;2021-03-28;270;18;53441;18344;14.4;4.9
87;2021-03-29;1119;418;54560;18762;14.7;5.1
87;2021-03-30;1907;669;56467;19431;15.2;5.2
87;2021-03-31;1660;697;58127;20128;15.7;5.4
87;2021-04-01;2237;574;60364;20702;16.3;5.6
87;2021-04-02;1843;636;62207;21338;16.8;5.8
87;2021-04-03;455;266;62662;21604;16.9;5.8
87;2021-04-04;2;0;62664;21604;16.9;5.8
87;2021-04-05;82;1;62746;21605;16.9;5.8
87;2021-04-06;1005;910;63751;22515;17.2;6.1
87;2021-04-07;1487;926;65238;23441;17.6;6.3
87;2021-04-08;1785;1034;67023;24475;18.1;6.6
87;2021-04-09;2647;743;69670;25218;18.8;6.8
87;2021-04-10;1189;307;70859;25525;19.1;6.9
87;2021-04-11;69;1;70928;25526;19.1;6.9
87;2021-04-12;1619;829;72547;26355;19.6;7.1
87;2021-04-13;2288;1065;74835;27420;20.2;7.4
87;2021-04-14;2530;1192;77365;28612;20.9;7.7
87;2021-04-15;2223;1078;79588;29690;21.5;8.0
87;2021-04-16;2735;1071;82323;30761;22.2;8.3
87;2021-04-17;731;389;83054;31150;22.4;8.4
87;2021-04-18;111;141;83165;31291;22.4;8.4
87;2021-04-19;1662;839;84827;32130;22.9;8.7
87;2021-04-20;2084;885;86911;33015;23.4;8.9
87;2021-04-21;2295;996;89206;34011;24.1;9.2
87;2021-04-22;2564;1167;91770;35178;24.8;9.5
87;2021-04-23;1997;1184;93767;36362;25.3;9.8
87;2021-04-24;824;621;94591;36983;25.5;10.0
87;2021-04-25;66;103;94657;37086;25.5;10.0
87;2021-04-26;1356;916;96013;38002;25.9;10.2
87;2021-04-27;2398;1206;98411;39208;26.5;10.6
87;2021-04-28;3867;1445;102278;40653;27.6;11.0
87;2021-04-29;3078;1845;105356;42498;28.4;11.5
87;2021-04-30;3172;1363;108528;43861;29.3;11.8
87;2021-05-01;614;61;109142;43922;29.4;11.8
87;2021-05-02;361;5;109503;43927;29.5;11.8
87;2021-05-03;2323;940;111826;44867;30.2;12.1
87;2021-05-04;2902;1074;114728;45941;30.9;12.4
87;2021-05-05;2989;1511;117717;47452;31.7;12.8
87;2021-05-06;2531;1725;120248;49177;32.4;13.3
87;2021-05-07;2945;1725;123193;50902;33.2;13.7
87;2021-05-08;772;295;123965;51197;33.4;13.8
87;2021-05-09;18;133;123983;51330;33.4;13.8
87;2021-05-10;1938;1602;125921;52932;34.0;14.3
87;2021-05-11;2465;1908;128386;54840;34.6;14.8
87;2021-05-12;2623;2066;131009;56906;35.3;15.3
87;2021-05-13;1085;293;132094;57199;35.6;15.4
87;2021-05-14;2245;1775;134339;58974;36.2;15.9
87;2021-05-15;950;409;135289;59383;36.5;16.0
87;2021-05-16;141;73;135430;59456;36.5;16.0
87;2021-05-17;1628;1762;137058;61218;37.0;16.5
87;2021-05-18;2633;1822;139691;63040;37.7;17.0
87;2021-05-19;2821;1554;142512;64594;38.4;17.4
87;2021-05-20;3302;1724;145814;66318;39.3;17.9
87;2021-05-21;2764;1843;148578;68161;40.1;18.4
87;2021-05-22;1457;629;150035;68790;40.5;18.6
87;2021-05-23;211;92;150246;68882;40.5;18.6
87;2021-05-24;1055;143;151301;69025;40.8;18.6
87;2021-05-25;2117;1811;153418;70836;41.4;19.1
87;2021-05-26;3219;2478;156637;73314;42.2;19.8
87;2021-05-27;3022;2357;159659;75671;43.1;20.4
87;2021-05-28;2675;2522;162334;78193;43.8;21.1
87;2021-05-29;1061;1313;163395;79506;44.1;21.4
87;2021-05-30;258;60;163653;79566;44.1;21.5
87;2021-05-31;2287;1361;165940;80927;44.8;21.8
87;2021-06-01;2547;1865;168487;82792;45.4;22.3
87;2021-06-02;2524;1856;171011;84648;46.1;22.8
87;2021-06-03;3213;2529;174224;87177;47.0;23.5
87;2021-06-04;2838;2063;177062;89240;47.8;24.1
87;2021-06-05;1310;574;178372;89814;48.1;24.2
87;2021-06-06;261;95;178633;89909;48.2;24.2
87;2021-06-07;2098;1900;180731;91809;48.7;24.8
87;2021-06-08;2958;2603;183689;94412;49.5;25.5
87;2021-06-09;2303;2812;185992;97224;50.2;26.2
87;2021-06-10;2974;2552;188966;99776;51.0;26.9
87;2021-06-11;2363;3075;191329;102851;51.6;27.7
87;2021-06-12;1219;1103;192548;103954;51.9;28.0
87;2021-06-13;294;485;192842;104439;52.0;28.2
87;2021-06-14;980;2729;193822;107168;52.3;28.9
87;2021-06-15;1362;3319;195184;110487;52.6;29.8
87;2021-06-16;1650;3424;196834;113911;53.1;30.7
87;2021-06-17;2438;2314;199272;116225;53.7;31.3
87;2021-06-18;1791;3019;201063;119244;54.2;32.2
87;2021-06-19;1047;1177;202110;120421;54.5;32.5
87;2021-06-20;205;206;202315;120627;54.6;32.5
87;2021-06-21;1040;2648;203355;123275;54.8;33.2
87;2021-06-22;1029;2880;204384;126155;55.1;34.0
87;2021-06-23;1255;3081;205639;129236;55.5;34.9
87;2021-06-24;1616;2561;207255;131797;55.9;35.5
87;2021-06-25;1448;2710;208703;134507;56.3;36.3
87;2021-06-26;529;1201;209232;135708;56.4;36.6
87;2021-06-27;26;212;209258;135920;56.4;36.7
87;2021-06-28;717;2575;209975;138495;56.6;37.4
87;2021-06-29;1156;3417;211131;141912;56.9;38.3
87;2021-06-30;1125;2652;212256;144564;57.2;39.0
87;2021-07-01;1482;2552;213738;147116;57.6;39.7
87;2021-07-02;1204;3463;214942;150579;58.0;40.6
87;2021-07-03;415;1512;215357;152091;58.1;41.0
87;2021-07-04;24;384;215381;152475;58.1;41.1
87;2021-07-05;685;2393;216066;154868;58.3;41.8
87;2021-07-06;582;3220;216648;158088;58.4;42.6
87;2021-07-07;862;3344;217510;161432;58.7;43.5
87;2021-07-08;1119;3671;218629;165103;59.0;44.5
87;2021-07-09;1113;3702;219742;168805;59.3;45.5
87;2021-07-10;290;1360;220032;170165;59.3;45.9
87;2021-07-11;49;284;220081;170449;59.4;46.0
87;2021-07-12;559;3192;220640;173641;59.5;46.8
87;2021-07-13;833;3512;221473;177153;59.7;47.8
87;2021-07-14;517;538;221990;177691;59.9;47.9
87;2021-07-15;1361;3463;223351;181154;60.2;48.9
87;2021-07-16;1731;3597;225082;184751;60.7;49.8
87;2021-07-17;655;1373;225737;186124;60.9;50.2
87;2021-07-18;81;285;225818;186409;60.9;50.3
87;2021-07-19;1434;3400;227252;189809;61.3;51.2
87;2021-07-20;1805;3591;229057;193400;61.8;52.2
87;2021-07-21;1451;3153;230508;196553;62.2;53.0
87;2021-07-22;1877;3251;232385;199804;62.7;53.9
87;2021-07-23;1875;3172;234260;202976;63.2;54.7
87;2021-07-24;816;1284;235076;204260;63.4;55.1
87;2021-07-25;106;241;235182;204501;63.4;55.2
87;2021-07-26;1541;2329;236723;206830;63.8;55.8
87;2021-07-27;2556;2063;239279;208893;64.5;56.3
87;2021-07-28;2390;2007;241669;210900;65.2;56.9
87;2021-07-29;3011;2000;244680;212900;66.0;57.4
87;2021-07-30;2543;2077;247223;214977;66.7;58.0
87;2021-07-31;1103;837;248326;215814;67.0;58.2
87;2021-08-01;283;151;248609;215965;67.1;58.2
87;2021-08-02;2119;1520;250728;217485;67.6;58.7
87;2021-08-03;2496;1331;253224;218816;68.3;59.0
87;2021-08-04;2314;1063;255538;219879;68.9;59.3
87;2021-08-05;2528;1414;258066;221293;69.6;59.7
87;2021-08-06;2144;1660;260210;222953;70.2;60.1
87;2021-08-07;1110;783;261320;223736;70.5;60.3
87;2021-08-08;208;125;261528;223861;70.5;60.4
87;2021-08-09;1818;1526;263346;225387;71.0;60.8
87;2021-08-10;2201;1533;265547;226920;71.6;61.2
87;2021-08-11;1912;1273;267459;228193;72.1;61.5
87;2021-08-12;2106;1481;269565;229674;72.7;61.9
87;2021-08-13;1724;1621;271289;231295;73.2;62.4
87;2021-08-14;672;733;271961;232028;73.3;62.6
87;2021-08-15;72;104;272033;232132;73.4;62.6
87;2021-08-16;1505;1739;273538;233871;73.8;63.1
87;2021-08-17;1354;1669;274892;235540;74.1;63.5
87;2021-08-18;1246;1998;276138;237538;74.5;64.1
87;2021-08-19;1223;1798;277361;239336;74.8;64.6
87;2021-08-20;917;2207;278278;241543;75.1;65.1
87;2021-08-21;318;966;278596;242509;75.1;65.4
87;2021-08-22;93;235;278689;242744;75.2;65.5
87;2021-08-23;746;2393;279435;245137;75.4;66.1
87;2021-08-24;765;2135;280200;247272;75.6;66.7
87;2021-08-25;710;2062;280910;249334;75.8;67.2
87;2021-08-26;860;2157;281770;251491;76.0;67.8
87;2021-08-27;790;2668;282560;254159;76.2;68.5
87;2021-08-28;332;1301;282892;255460;76.3;68.9
87;2021-08-29;65;244;282957;255704;76.3;69.0
87;2021-08-30;472;2198;283429;257902;76.4;69.6
87;2021-08-31;608;1902;284037;259804;76.6;70.1
87;2021-09-01;750;2351;284787;262155;76.8;70.7
87;2021-09-02;557;2137;285344;264292;77.0;71.3
87;2021-09-03;651;2150;285995;266442;77.1;71.9
87;2021-09-04;277;1065;286272;267507;77.2;72.1
87;2021-09-05;9;6;286281;267513;77.2;72.1
87;2021-09-06;396;1601;286677;269114;77.3;72.6
87;2021-09-07;386;1241;287063;270355;77.4;72.9
87;2021-09-08;460;1467;287523;271822;77.5;73.3
87;2021-09-09;326;965;287849;272787;77.6;73.6
87;2021-09-10;466;1380;288315;274167;77.8;73.9
87;2021-09-11;320;894;288635;275061;77.8;74.2
87;2021-09-12;3;13;288638;275074;77.8;74.2
87;2021-09-13;313;764;288951;275838;77.9;74.4
87;2021-09-14;287;619;289238;276457;78.0;74.6
87;2021-09-15;369;964;289607;277421;78.1;74.8
87;2021-09-16;348;789;289955;278210;78.2;75.0
87;2021-09-17;408;885;290363;279095;78.3;75.3
87;2021-09-18;286;728;290649;279823;78.4;75.5
87;2021-09-19;4;14;290653;279837;78.4;75.5
87;2021-09-20;204;465;290857;280302;78.4;75.6
87;2021-09-21;262;510;291119;280812;78.5;75.7
87;2021-09-22;238;758;291357;281570;78.6;75.9
87;2021-09-23;221;529;291578;282099;78.6;76.1
87;2021-09-24;293;740;291871;282839;78.7;76.3
87;2021-09-25;167;511;292038;283350;78.8;76.4
87;2021-09-26;2;5;292040;283355;78.8;76.4
87;2021-09-27;195;402;292235;283757;78.8;76.5
87;2021-09-28;204;322;292439;284079;78.9;76.6
87;2021-09-29;173;400;292612;284479;78.9;76.7
87;2021-09-30;140;268;292752;284747;79.0;76.8
87;2021-10-01;205;513;292957;285260;79.0;76.9
87;2021-10-02;156;399;293113;285659;79.1;77.0
87;2021-10-03;3;3;293116;285662;79.1;77.0
87;2021-10-04;157;290;293273;285952;79.1;77.1
87;2021-10-05;112;212;293385;286164;79.1;77.2
87;2021-10-06;197;413;293582;286577;79.2;77.3
87;2021-10-07;110;259;293692;286836;79.2;77.4
87;2021-10-08;228;476;293920;287312;79.3;77.5
87;2021-10-09;178;356;294098;287668;79.3;77.6
87;2021-10-10;4;4;294102;287672;79.3;77.6
87;2021-10-11;135;267;294237;287939;79.4;77.7
87;2021-10-12;108;215;294345;288154;79.4;77.7
87;2021-10-13;160;211;294505;288365;79.4;77.8
87;2021-10-14;137;248;294642;288613;79.5;77.8
88;2020-12-27;0;0;0;0;0.0;0.0
88;2020-12-28;0;0;0;0;0.0;0.0
88;2020-12-29;0;0;0;0;0.0;0.0
88;2020-12-30;0;0;0;0;0.0;0.0
88;2020-12-31;0;0;0;0;0.0;0.0
88;2021-01-01;2;0;2;0;0.0;0.0
88;2021-01-02;0;0;2;0;0.0;0.0
88;2021-01-03;0;0;2;0;0.0;0.0
88;2021-01-04;0;0;2;0;0.0;0.0
88;2021-01-05;1;0;3;0;0.0;0.0
88;2021-01-06;3;0;6;0;0.0;0.0
88;2021-01-07;71;1;77;1;0.0;0.0
88;2021-01-08;189;2;266;3;0.1;0.0
88;2021-01-09;190;3;456;6;0.1;0.0
88;2021-01-10;0;0;456;6;0.1;0.0
88;2021-01-11;227;0;683;6;0.2;0.0
88;2021-01-12;422;0;1105;6;0.3;0.0
88;2021-01-13;491;2;1596;8;0.4;0.0
88;2021-01-14;347;3;1943;11;0.5;0.0
88;2021-01-15;380;3;2323;14;0.6;0.0
88;2021-01-16;62;0;2385;14;0.7;0.0
88;2021-01-17;1;0;2386;14;0.7;0.0
88;2021-01-18;461;0;2847;14;0.8;0.0
88;2021-01-19;452;0;3299;14;0.9;0.0
88;2021-01-20;462;1;3761;15;1.0;0.0
88;2021-01-21;1547;7;5308;22;1.5;0.0
88;2021-01-22;1182;2;6490;24;1.8;0.0
88;2021-01-23;285;0;6775;24;1.9;0.0
88;2021-01-24;298;2;7073;26;2.0;0.0
88;2021-01-25;937;4;8010;30;2.2;0.0
88;2021-01-26;388;5;8398;35;2.3;0.0
88;2021-01-27;4;0;8402;35;2.3;0.0
88;2021-01-28;162;38;8564;73;2.4;0.0
88;2021-01-29;527;160;9091;233;2.5;0.1
88;2021-01-30;288;128;9379;361;2.6;0.1
88;2021-01-31;0;0;9379;361;2.6;0.1
88;2021-02-01;405;281;9784;642;2.7;0.2
88;2021-02-02;333;363;10117;1005;2.8;0.3
88;2021-02-03;437;241;10554;1246;2.9;0.3
88;2021-02-04;315;229;10869;1475;3.0;0.4
88;2021-02-05;457;252;11326;1727;3.2;0.5
88;2021-02-06;110;56;11436;1783;3.2;0.5
88;2021-02-07;0;0;11436;1783;3.2;0.5
88;2021-02-08;360;203;11796;1986;3.3;0.6
88;2021-02-09;291;288;12087;2274;3.4;0.6
88;2021-02-10;416;344;12503;2618;3.5;0.7
88;2021-02-11;850;1094;13353;3712;3.7;1.0
88;2021-02-12;939;707;14292;4419;4.0;1.2
88;2021-02-13;162;211;14454;4630;4.0;1.3
88;2021-02-14;81;216;14535;4846;4.0;1.3
88;2021-02-15;639;1076;15174;5922;4.2;1.6
88;2021-02-16;472;723;15646;6645;4.4;1.8
88;2021-02-17;455;437;16101;7082;4.5;2.0
88;2021-02-18;516;385;16617;7467;4.6;2.1
88;2021-02-19;535;461;17152;7928;4.8;2.2
88;2021-02-20;156;101;17308;8029;4.8;2.2
88;2021-02-21;1;25;17309;8054;4.8;2.2
88;2021-02-22;425;342;17734;8396;4.9;2.3
88;2021-02-23;403;232;18137;8628;5.0;2.4
88;2021-02-24;505;210;18642;8838;5.2;2.5
88;2021-02-25;674;286;19316;9124;5.4;2.5
88;2021-02-26;863;277;20179;9401;5.6;2.6
88;2021-02-27;269;34;20448;9435;5.7;2.6
88;2021-02-28;30;1;20478;9436;5.7;2.6
88;2021-03-01;358;463;20836;9899;5.8;2.8
88;2021-03-02;431;497;21267;10396;5.9;2.9
88;2021-03-03;650;466;21917;10862;6.1;3.0
88;2021-03-04;1045;768;22962;11630;6.4;3.2
88;2021-03-05;933;706;23895;12336;6.6;3.4
88;2021-03-06;1873;119;25768;12455;7.2;3.5
88;2021-03-07;1060;82;26828;12537;7.5;3.5
88;2021-03-08;727;693;27555;13230;7.7;3.7
88;2021-03-09;1095;541;28650;13771;8.0;3.8
88;2021-03-10;1083;498;29733;14269;8.3;4.0
88;2021-03-11;1441;404;31174;14673;8.7;4.1
88;2021-03-12;1309;490;32483;15163;9.0;4.2
88;2021-03-13;1211;131;33694;15294;9.4;4.3
88;2021-03-14;166;5;33860;15299;9.4;4.3
88;2021-03-15;928;447;34788;15746;9.7;4.4
88;2021-03-16;1023;345;35811;16091;10.0;4.5
88;2021-03-17;905;425;36716;16516;10.2;4.6
88;2021-03-18;1302;405;38018;16921;10.6;4.7
88;2021-03-19;1466;508;39484;17429;11.0;4.8
88;2021-03-20;1319;57;40803;17486;11.3;4.9
88;2021-03-21;37;0;40840;17486;11.4;4.9
88;2021-03-22;1233;546;42073;18032;11.7;5.0
88;2021-03-23;1780;448;43853;18480;12.2;5.1
88;2021-03-24;1877;475;45730;18955;12.7;5.3
88;2021-03-25;2497;497;48227;19452;13.4;5.4
88;2021-03-26;2480;463;50707;19915;14.1;5.5
88;2021-03-27;884;301;51591;20216;14.3;5.6
88;2021-03-28;61;4;51652;20220;14.4;5.6
88;2021-03-29;1305;449;52957;20669;14.7;5.7
88;2021-03-30;2062;395;55019;21064;15.3;5.9
88;2021-03-31;1619;578;56638;21642;15.8;6.0
88;2021-04-01;2116;720;58754;22362;16.3;6.2
88;2021-04-02;2812;648;61566;23010;17.1;6.4
88;2021-04-03;745;215;62311;23225;17.3;6.5
88;2021-04-04;16;1;62327;23226;17.3;6.5
88;2021-04-05;23;2;62350;23228;17.3;6.5
88;2021-04-06;1140;680;63490;23908;17.7;6.6
88;2021-04-07;1601;715;65091;24623;18.1;6.8
88;2021-04-08;1857;792;66948;25415;18.6;7.1
88;2021-04-09;3079;744;70027;26159;19.5;7.3
88;2021-04-10;724;650;70751;26809;19.7;7.5
88;2021-04-11;33;1;70784;26810;19.7;7.5
88;2021-04-12;1537;989;72321;27799;20.1;7.7
88;2021-04-13;2035;1091;74356;28890;20.7;8.0
88;2021-04-14;1910;952;76266;29842;21.2;8.3
88;2021-04-15;1967;1246;78233;31088;21.8;8.6
88;2021-04-16;2109;1050;80342;32138;22.3;8.9
88;2021-04-17;1430;766;81772;32904;22.7;9.2
88;2021-04-18;268;23;82040;32927;22.8;9.2
88;2021-04-19;1172;1239;83212;34166;23.1;9.5
88;2021-04-20;1190;1398;84402;35564;23.5;9.9
88;2021-04-21;1503;1300;85905;36864;23.9;10.3
88;2021-04-22;1900;1637;87805;38501;24.4;10.7
88;2021-04-23;1825;2047;89630;40548;24.9;11.3
88;2021-04-24;1184;788;90814;41336;25.3;11.5
88;2021-04-25;34;2;90848;41338;25.3;11.5
88;2021-04-26;1182;1176;92030;42514;25.6;11.8
88;2021-04-27;1277;1737;93307;44251;26.0;12.3
88;2021-04-28;1634;1498;94941;45749;26.4;12.7
88;2021-04-29;2081;1468;97022;47217;27.0;13.1
88;2021-04-30;2450;1634;99472;48851;27.7;13.6
88;2021-05-01;2008;290;101480;49141;28.2;13.7
88;2021-05-02;1301;120;102781;49261;28.6;13.7
88;2021-05-03;1559;1218;104340;50479;29.0;14.0
88;2021-05-04;1444;1469;105784;51948;29.4;14.4
88;2021-05-05;2426;1599;108210;53547;30.1;14.9
88;2021-05-06;3211;1214;111421;54761;31.0;15.2
88;2021-05-07;2938;1359;114359;56120;31.8;15.6
88;2021-05-08;1532;470;115891;56590;32.2;15.7
88;2021-05-09;1734;163;117625;56753;32.7;15.8
88;2021-05-10;1763;1571;119388;58324;33.2;16.2
88;2021-05-11;2655;1914;122043;60238;33.9;16.8
88;2021-05-12;2531;1853;124574;62091;34.7;17.3
88;2021-05-13;3258;683;127832;62774;35.6;17.5
88;2021-05-14;2500;1545;130332;64319;36.3;17.9
88;2021-05-15;1624;744;131956;65063;36.7;18.1
88;2021-05-16;1332;104;133288;65167;37.1;18.1
88;2021-05-17;1987;946;135275;66113;37.6;18.4
88;2021-05-18;2255;1117;137530;67230;38.3;18.7
88;2021-05-19;2721;1150;140251;68380;39.0;19.0
88;2021-05-20;3348;1239;143599;69619;39.9;19.4
88;2021-05-21;2875;1151;146474;70770;40.7;19.7
88;2021-05-22;1431;713;147905;71483;41.1;19.9
88;2021-05-23;558;74;148463;71557;41.3;19.9
88;2021-05-24;1675;435;150138;71992;41.8;20.0
88;2021-05-25;1646;1175;151784;73167;42.2;20.4
88;2021-05-26;2368;1141;154152;74308;42.9;20.7
88;2021-05-27;2200;1363;156352;75671;43.5;21.0
88;2021-05-28;1892;1989;158244;77660;44.0;21.6
88;2021-05-29;1230;1755;159474;79415;44.4;22.1
88;2021-05-30;587;418;160061;79833;44.5;22.2
88;2021-05-31;1327;1852;161388;81685;44.9;22.7
88;2021-06-01;1720;1986;163108;83671;45.4;23.3
88;2021-06-02;2076;1871;165184;85542;45.9;23.8
88;2021-06-03;2738;1622;167922;87164;46.7;24.2
88;2021-06-04;2042;1935;169964;89099;47.3;24.8
88;2021-06-05;1531;1139;171495;90238;47.7;25.1
88;2021-06-06;692;156;172187;90394;47.9;25.1
88;2021-06-07;1290;1710;173477;92104;48.3;25.6
88;2021-06-08;1666;1935;175143;94039;48.7;26.2
88;2021-06-09;1619;1911;176762;95950;49.2;26.7
88;2021-06-10;1781;2049;178543;97999;49.7;27.3
88;2021-06-11;1549;2218;180092;100217;50.1;27.9
88;2021-06-12;669;1657;180761;101874;50.3;28.3
88;2021-06-13;464;377;181225;102251;50.4;28.4
88;2021-06-14;1030;2251;182255;104502;50.7;29.1
88;2021-06-15;1928;2458;184183;106960;51.2;29.8
88;2021-06-16;1486;2873;185669;109833;51.6;30.5
88;2021-06-17;1601;2733;187270;112566;52.1;31.3
88;2021-06-18;1355;2461;188625;115027;52.5;32.0
88;2021-06-19;701;1090;189326;116117;52.7;32.3
88;2021-06-20;78;79;189404;116196;52.7;32.3
88;2021-06-21;672;2579;190076;118775;52.9;33.0
88;2021-06-22;869;3433;190945;122208;53.1;34.0
88;2021-06-23;1144;2877;192089;125085;53.4;34.8
88;2021-06-24;702;2604;192791;127689;53.6;35.5
88;2021-06-25;1436;3180;194227;130869;54.0;36.4
88;2021-06-26;903;2073;195130;132942;54.3;37.0
88;2021-06-27;543;635;195673;133577;54.4;37.2
88;2021-06-28;758;2515;196431;136092;54.6;37.9
88;2021-06-29;960;3353;197391;139445;54.9;38.8
88;2021-06-30;1137;3116;198528;142561;55.2;39.7
88;2021-07-01;1056;2686;199584;145247;55.5;40.4
88;2021-07-02;992;3150;200576;148397;55.8;41.3
88;2021-07-03;692;1699;201268;150096;56.0;41.7
88;2021-07-04;258;815;201526;150911;56.1;42.0
88;2021-07-05;993;2021;202519;152932;56.3;42.5
88;2021-07-06;1022;2416;203541;155348;56.6;43.2
88;2021-07-07;1177;2586;204718;157934;56.9;43.9
88;2021-07-08;1082;2063;205800;159997;57.2;44.5
88;2021-07-09;1583;2708;207383;162705;57.7;45.3
88;2021-07-10;721;1820;208104;164525;57.9;45.8
88;2021-07-11;468;696;208572;165221;58.0;46.0
88;2021-07-12;1056;2520;209628;167741;58.3;46.7
88;2021-07-13;1313;2655;210941;170396;58.7;47.4
88;2021-07-14;1207;802;212148;171198;59.0;47.6
88;2021-07-15;1744;3312;213892;174510;59.5;48.5
88;2021-07-16;1469;2964;215361;177474;59.9;49.4
88;2021-07-17;802;1587;216163;179061;60.1;49.8
88;2021-07-18;180;679;216343;179740;60.2;50.0
88;2021-07-19;1563;2231;217906;181971;60.6;50.6
88;2021-07-20;2144;2385;220050;184356;61.2;51.3
88;2021-07-21;1939;2218;221989;186574;61.7;51.9
88;2021-07-22;1699;2108;223688;188682;62.2;52.5
88;2021-07-23;2508;2784;226196;191466;62.9;53.3
88;2021-07-24;1059;1187;227255;192653;63.2;53.6
88;2021-07-25;432;608;227687;193261;63.3;53.8
88;2021-07-26;1715;2076;229402;195337;63.8;54.3
88;2021-07-27;2351;2061;231753;197398;64.5;54.9
88;2021-07-28;2210;2250;233963;199648;65.1;55.5
88;2021-07-29;3033;1636;236996;201284;65.9;56.0
88;2021-07-30;2272;2297;239268;203581;66.6;56.6
88;2021-07-31;1105;1037;240373;204618;66.9;56.9
88;2021-08-01;450;461;240823;205079;67.0;57.0
88;2021-08-02;2376;1770;243199;206849;67.6;57.5
88;2021-08-03;2875;1592;246074;208441;68.4;58.0
88;2021-08-04;2520;1529;248594;209970;69.1;58.4
88;2021-08-05;1994;1378;250588;211348;69.7;58.8
88;2021-08-06;2948;2010;253536;213358;70.5;59.3
88;2021-08-07;1176;912;254712;214270;70.8;59.6
88;2021-08-08;751;319;255463;214589;71.1;59.7
88;2021-08-09;1551;1650;257014;216239;71.5;60.1
88;2021-08-10;1941;2041;258955;218280;72.0;60.7
88;2021-08-11;1871;1759;260826;220039;72.5;61.2
88;2021-08-12;1671;1349;262497;221388;73.0;61.6
88;2021-08-13;1952;2137;264449;223525;73.6;62.2
88;2021-08-14;580;912;265029;224437;73.7;62.4
88;2021-08-15;337;520;265366;224957;73.8;62.6
88;2021-08-16;1149;1988;266515;226945;74.1;63.1
88;2021-08-17;1267;2058;267782;229003;74.5;63.7
88;2021-08-18;1209;1925;268991;230928;74.8;64.2
88;2021-08-19;1042;1582;270033;232510;75.1;64.7
88;2021-08-20;1020;2330;271053;234840;75.4;65.3
88;2021-08-21;405;1144;271458;235984;75.5;65.6
88;2021-08-22;100;479;271558;236463;75.5;65.8
88;2021-08-23;734;1640;272292;238103;75.7;66.2
88;2021-08-24;918;1973;273210;240076;76.0;66.8
88;2021-08-25;891;2460;274101;242536;76.2;67.5
88;2021-08-26;868;2049;274969;244585;76.5;68.0
88;2021-08-27;844;2711;275813;247296;76.7;68.8
88;2021-08-28;491;1351;276304;248647;76.9;69.2
88;2021-08-29;130;693;276434;249340;76.9;69.4
88;2021-08-30;698;2342;277132;251682;77.1;70.0
88;2021-08-31;782;2330;277914;254012;77.3;70.7
88;2021-09-01;686;1991;278600;256003;77.5;71.2
88;2021-09-02;666;1603;279266;257606;77.7;71.7
88;2021-09-03;728;2106;279994;259712;77.9;72.2
88;2021-09-04;429;1104;280423;260816;78.0;72.5
88;2021-09-05;188;370;280611;261186;78.1;72.6
88;2021-09-06;505;1208;281116;262394;78.2;73.0
88;2021-09-07;566;1225;281682;263619;78.3;73.3
88;2021-09-08;459;1330;282141;264949;78.5;73.7
88;2021-09-09;541;769;282682;265718;78.6;73.9
88;2021-09-10;592;1342;283274;267060;78.8;74.3
88;2021-09-11;349;781;283623;267841;78.9;74.5
88;2021-09-12;71;125;283694;267966;78.9;74.5
88;2021-09-13;429;701;284123;268667;79.0;74.7
88;2021-09-14;555;722;284678;269389;79.2;74.9
88;2021-09-15;428;971;285106;270360;79.3;75.2
88;2021-09-16;255;535;285361;270895;79.4;75.3
88;2021-09-17;434;1026;285795;271921;79.5;75.6
88;2021-09-18;237;680;286032;272601;79.6;75.8
88;2021-09-19;52;164;286084;272765;79.6;75.9
88;2021-09-20;222;565;286306;273330;79.6;76.0
88;2021-09-21;208;598;286514;273928;79.7;76.2
88;2021-09-22;207;780;286721;274708;79.8;76.4
88;2021-09-23;289;626;287010;275334;79.8;76.6
88;2021-09-24;280;802;287290;276136;79.9;76.8
88;2021-09-25;131;564;287421;276700;79.9;77.0
88;2021-09-26;18;159;287439;276859;80.0;77.0
88;2021-09-27;165;457;287604;277316;80.0;77.1
88;2021-09-28;175;523;287779;277839;80.0;77.3
88;2021-09-29;174;504;287953;278343;80.1;77.4
88;2021-09-30;127;459;288080;278802;80.1;77.5
88;2021-10-01;207;672;288287;279474;80.2;77.7
88;2021-10-02;129;359;288416;279833;80.2;77.8
88;2021-10-03;22;80;288438;279913;80.2;77.9
88;2021-10-04;137;467;288575;280380;80.3;78.0
88;2021-10-05;178;581;288753;280961;80.3;78.1
88;2021-10-06;198;398;288951;281359;80.4;78.3
88;2021-10-07;61;209;289012;281568;80.4;78.3
88;2021-10-08;266;630;289278;282198;80.5;78.5
88;2021-10-09;118;241;289396;282439;80.5;78.6
88;2021-10-10;22;46;289418;282485;80.5;78.6
88;2021-10-11;93;225;289511;282710;80.5;78.6
88;2021-10-12;149;258;289660;282968;80.6;78.7
88;2021-10-13;146;259;289806;283227;80.6;78.8
88;2021-10-14;69;185;289875;283412;80.6;78.8
89;2020-12-27;0;0;0;0;0.0;0.0
89;2020-12-28;2;1;2;1;0.0;0.0
89;2020-12-29;0;0;2;1;0.0;0.0
89;2020-12-30;0;0;2;1;0.0;0.0
89;2020-12-31;0;0;2;1;0.0;0.0
89;2021-01-01;0;0;2;1;0.0;0.0
89;2021-01-02;0;0;2;1;0.0;0.0
89;2021-01-03;0;0;2;1;0.0;0.0
89;2021-01-04;0;0;2;1;0.0;0.0
89;2021-01-05;0;0;2;1;0.0;0.0
89;2021-01-06;48;0;50;1;0.0;0.0
89;2021-01-07;201;0;251;1;0.1;0.0
89;2021-01-08;48;0;299;1;0.1;0.0
89;2021-01-09;1;0;300;1;0.1;0.0
89;2021-01-10;0;0;300;1;0.1;0.0
89;2021-01-11;221;0;521;1;0.2;0.0
89;2021-01-12;349;0;870;1;0.3;0.0
89;2021-01-13;535;3;1405;4;0.4;0.0
89;2021-01-14;711;8;2116;12;0.6;0.0
89;2021-01-15;278;2;2394;14;0.7;0.0
89;2021-01-16;90;4;2484;18;0.7;0.0
89;2021-01-17;0;0;2484;18;0.7;0.0
89;2021-01-18;503;1;2987;19;0.9;0.0
89;2021-01-19;841;4;3828;23;1.2;0.0
89;2021-01-20;762;0;4590;23;1.4;0.0
89;2021-01-21;939;4;5529;27;1.7;0.0
89;2021-01-22;1020;1;6549;28;2.0;0.0
89;2021-01-23;200;0;6749;28;2.0;0.0
89;2021-01-24;107;1;6856;29;2.1;0.0
89;2021-01-25;483;4;7339;33;2.2;0.0
89;2021-01-26;582;14;7921;47;2.4;0.0
89;2021-01-27;473;38;8394;85;2.5;0.0
89;2021-01-28;551;127;8945;212;2.7;0.1
89;2021-01-29;959;43;9904;255;3.0;0.1
89;2021-01-30;184;67;10088;322;3.0;0.1
89;2021-01-31;24;2;10112;324;3.0;0.1
89;2021-02-01;256;152;10368;476;3.1;0.1
89;2021-02-02;283;333;10651;809;3.2;0.2
89;2021-02-03;292;344;10943;1153;3.3;0.3
89;2021-02-04;434;593;11377;1746;3.4;0.5
89;2021-02-05;387;204;11764;1950;3.5;0.6
89;2021-02-06;77;66;11841;2016;3.6;0.6
89;2021-02-07;0;0;11841;2016;3.6;0.6
89;2021-02-08;287;188;12128;2204;3.7;0.7
89;2021-02-09;284;441;12412;2645;3.7;0.8
89;2021-02-10;396;313;12808;2958;3.9;0.9
89;2021-02-11;333;548;13141;3506;4.0;1.1
89;2021-02-12;434;599;13575;4105;4.1;1.2
89;2021-02-13;51;130;13626;4235;4.1;1.3
89;2021-02-14;21;116;13647;4351;4.1;1.3
89;2021-02-15;217;403;13864;4754;4.2;1.4
89;2021-02-16;134;534;13998;5288;4.2;1.6
89;2021-02-17;263;438;14261;5726;4.3;1.7
89;2021-02-18;225;544;14486;6270;4.4;1.9
89;2021-02-19;246;652;14732;6922;4.4;2.1
89;2021-02-20;33;140;14765;7062;4.4;2.1
89;2021-02-21;0;10;14765;7072;4.4;2.1
89;2021-02-22;233;451;14998;7523;4.5;2.3
89;2021-02-23;170;490;15168;8013;4.6;2.4
89;2021-02-24;344;389;15512;8402;4.7;2.5
89;2021-02-25;370;464;15882;8866;4.8;2.7
89;2021-02-26;385;338;16267;9204;4.9;2.8
89;2021-02-27;138;82;16405;9286;4.9;2.8
89;2021-02-28;6;13;16411;9299;4.9;2.8
89;2021-03-01;541;237;16952;9536;5.1;2.9
89;2021-03-02;755;356;17707;9892;5.3;3.0
89;2021-03-03;647;277;18354;10169;5.5;3.1
89;2021-03-04;633;380;18987;10549;5.7;3.2
89;2021-03-05;728;506;19715;11055;5.9;3.3
89;2021-03-06;549;135;20264;11190;6.1;3.4
89;2021-03-07;288;40;20552;11230;6.2;3.4
89;2021-03-08;560;331;21112;11561;6.4;3.5
89;2021-03-09;1003;278;22115;11839;6.7;3.6
89;2021-03-10;984;257;23099;12096;7.0;3.6
89;2021-03-11;1077;304;24176;12400;7.3;3.7
89;2021-03-12;1280;338;25456;12738;7.7;3.8
89;2021-03-13;637;45;26093;12783;7.9;3.8
89;2021-03-14;1;0;26094;12783;7.9;3.8
89;2021-03-15;816;317;26910;13100;8.1;3.9
89;2021-03-16;948;229;27858;13329;8.4;4.0
89;2021-03-17;920;273;28778;13602;8.7;4.1
89;2021-03-18;885;258;29663;13860;8.9;4.2
89;2021-03-19;1149;198;30812;14058;9.3;4.2
89;2021-03-20;844;33;31656;14091;9.5;4.2
89;2021-03-21;173;6;31829;14097;9.6;4.2
89;2021-03-22;1044;227;32873;14324;9.9;4.3
89;2021-03-23;1744;263;34617;14587;10.4;4.4
89;2021-03-24;1968;333;36585;14920;11.0;4.5
89;2021-03-25;1821;175;38406;15095;11.6;4.5
89;2021-03-26;2628;190;41034;15285;12.4;4.6
89;2021-03-27;1775;52;42809;15337;12.9;4.6
89;2021-03-28;32;3;42841;15340;12.9;4.6
89;2021-03-29;965;579;43806;15919;13.2;4.8
89;2021-03-30;1156;574;44962;16493;13.5;5.0
89;2021-03-31;2004;474;46966;16967;14.1;5.1
89;2021-04-01;2121;463;49087;17430;14.8;5.2
89;2021-04-02;2140;450;51227;17880;15.4;5.4
89;2021-04-03;1004;243;52231;18123;15.7;5.5
89;2021-04-04;16;1;52247;18124;15.7;5.5
89;2021-04-05;92;4;52339;18128;15.8;5.5
89;2021-04-06;1034;758;53373;18886;16.1;5.7
89;2021-04-07;1027;806;54400;19692;16.4;5.9
89;2021-04-08;1731;728;56131;20420;16.9;6.1
89;2021-04-09;2164;773;58295;21193;17.6;6.4
89;2021-04-10;891;180;59186;21373;17.8;6.4
89;2021-04-11;38;51;59224;21424;17.8;6.5
89;2021-04-12;1011;795;60235;22219;18.1;6.7
89;2021-04-13;1356;1082;61591;23301;18.5;7.0
89;2021-04-14;1214;1040;62805;24341;18.9;7.3
89;2021-04-15;1412;948;64217;25289;19.3;7.6
89;2021-04-16;1330;941;65547;26230;19.7;7.9
89;2021-04-17;1070;456;66617;26686;20.1;8.0
89;2021-04-18;27;154;66644;26840;20.1;8.1
89;2021-04-19;748;1040;67392;27880;20.3;8.4
89;2021-04-20;1016;1535;68408;29415;20.6;8.9
89;2021-04-21;814;1107;69222;30522;20.8;9.2
89;2021-04-22;1106;1169;70328;31691;21.2;9.5
89;2021-04-23;1820;1966;72148;33657;21.7;10.1
89;2021-04-24;1173;1175;73321;34832;22.1;10.5
89;2021-04-25;139;6;73460;34838;22.1;10.5
89;2021-04-26;1503;778;74963;35616;22.6;10.7
89;2021-04-27;1734;1054;76697;36670;23.1;11.0
89;2021-04-28;1599;1856;78296;38526;23.6;11.6
89;2021-04-29;1970;1932;80266;40458;24.2;12.2
89;2021-04-30;1803;1770;82069;42228;24.7;12.7
89;2021-05-01;846;722;82915;42950;25.0;12.9
89;2021-05-02;134;31;83049;42981;25.0;12.9
89;2021-05-03;1606;766;84655;43747;25.5;13.2
89;2021-05-04;1617;1132;86272;44879;26.0;13.5
89;2021-05-05;2319;1267;88591;46146;26.7;13.9
89;2021-05-06;2411;1381;91002;47527;27.4;14.3
89;2021-05-07;2718;1318;93720;48845;28.2;14.7
89;2021-05-08;1786;535;95506;49380;28.8;14.9
89;2021-05-09;196;19;95702;49399;28.8;14.9
89;2021-05-10;1202;963;96904;50362;29.2;15.2
89;2021-05-11;2491;1466;99395;51828;29.9;15.6
89;2021-05-12;2060;1217;101455;53045;30.5;16.0
89;2021-05-13;415;332;101870;53377;30.7;16.1
89;2021-05-14;1880;1095;103750;54472;31.2;16.4
89;2021-05-15;2247;394;105997;54866;31.9;16.5
89;2021-05-16;10;35;106007;54901;31.9;16.5
89;2021-05-17;2090;638;108097;55539;32.5;16.7
89;2021-05-18;2324;832;110421;56371;33.2;17.0
89;2021-05-19;2860;882;113281;57253;34.1;17.2
89;2021-05-20;2927;886;116208;58139;35.0;17.5
89;2021-05-21;2481;879;118689;59018;35.7;17.8
89;2021-05-22;1431;572;120120;59590;36.2;17.9
89;2021-05-23;108;10;120228;59600;36.2;17.9
89;2021-05-24;288;226;120516;59826;36.3;18.0
89;2021-05-25;1558;982;122074;60808;36.8;18.3
89;2021-05-26;1815;1024;123889;61832;37.3;18.6
89;2021-05-27;2117;1358;126006;63190;37.9;19.0
89;2021-05-28;2143;1422;128149;64612;38.6;19.5
89;2021-05-29;541;658;128690;65270;38.8;19.7
89;2021-05-30;25;22;128715;65292;38.8;19.7
89;2021-05-31;1248;972;129963;66264;39.1;20.0
89;2021-06-01;1505;981;131468;67245;39.6;20.2
89;2021-06-02;1946;1278;133414;68523;40.2;20.6
89;2021-06-03;2432;1523;135846;70046;40.9;21.1
89;2021-06-04;2140;1888;137986;71934;41.6;21.7
89;2021-06-05;1185;1224;139171;73158;41.9;22.0
89;2021-06-06;24;37;139195;73195;41.9;22.0
89;2021-06-07;2107;1452;141302;74647;42.5;22.5
89;2021-06-08;2196;1452;143498;76099;43.2;22.9
89;2021-06-09;2326;1510;145824;77609;43.9;23.4
89;2021-06-10;2794;1600;148618;79209;44.8;23.9
89;2021-06-11;1951;1750;150569;80959;45.3;24.4
89;2021-06-12;1103;759;151672;81718;45.7;24.6
89;2021-06-13;156;423;151828;82141;45.7;24.7
89;2021-06-14;1313;1825;153141;83966;46.1;25.3
89;2021-06-15;1404;2010;154545;85976;46.5;25.9
89;2021-06-16;1129;2582;155674;88558;46.9;26.7
89;2021-06-17;1434;2335;157108;90893;47.3;27.4
89;2021-06-18;1623;2877;158731;93770;47.8;28.2
89;2021-06-19;686;1660;159417;95430;48.0;28.7
89;2021-06-20;55;127;159472;95557;48.0;28.8
89;2021-06-21;758;1528;160230;97085;48.2;29.2
89;2021-06-22;1049;2679;161279;99764;48.6;30.0
89;2021-06-23;1157;1800;162436;101564;48.9;30.6
89;2021-06-24;1078;1498;163514;103062;49.2;31.0
89;2021-06-25;1008;2425;164522;105487;49.5;31.8
89;2021-06-26;560;2482;165082;107969;49.7;32.5
89;2021-06-27;14;28;165096;107997;49.7;32.5
89;2021-06-28;1033;2494;166129;110491;50.0;33.3
89;2021-06-29;691;2403;166820;112894;50.2;34.0
89;2021-06-30;1083;3181;167903;116075;50.6;35.0
89;2021-07-01;1026;2989;168929;119064;50.9;35.9
89;2021-07-02;1109;2753;170038;121817;51.2;36.7
89;2021-07-03;554;1575;170592;123392;51.4;37.2
89;2021-07-04;11;36;170603;123428;51.4;37.2
89;2021-07-05;1296;1839;171899;125267;51.8;37.7
89;2021-07-06;1057;2312;172956;127579;52.1;38.4
89;2021-07-07;682;1787;173638;129366;52.3;39.0
89;2021-07-08;805;1873;174443;131239;52.5;39.5
89;2021-07-09;1146;2606;175589;133845;52.9;40.3
89;2021-07-10;719;816;176308;134661;53.1;40.5
89;2021-07-11;26;39;176334;134700;53.1;40.6
89;2021-07-12;1428;1901;177762;136601;53.5;41.1
89;2021-07-13;2145;2746;179907;139347;54.2;42.0
89;2021-07-14;322;326;180229;139673;54.3;42.1
89;2021-07-15;2253;3156;182482;142829;54.9;43.0
89;2021-07-16;2391;2865;184873;145694;55.7;43.9
89;2021-07-17;1235;1229;186108;146923;56.0;44.2
89;2021-07-18;277;97;186385;147020;56.1;44.3
89;2021-07-19;1566;2812;187951;149832;56.6;45.1
89;2021-07-20;1929;3283;189880;153115;57.2;46.1
89;2021-07-21;2081;2725;191961;155840;57.8;46.9
89;2021-07-22;2481;2994;194442;158834;58.5;47.8
89;2021-07-23;2474;3105;196916;161939;59.3;48.8
89;2021-07-24;1241;1247;198157;163186;59.7;49.1
89;2021-07-25;69;185;198226;163371;59.7;49.2
89;2021-07-26;1719;2322;199945;165693;60.2;49.9
89;2021-07-27;2345;1911;202290;167604;60.9;50.5
89;2021-07-28;2539;1339;204829;168943;61.7;50.9
89;2021-07-29;2525;1620;207354;170563;62.4;51.4
89;2021-07-30;2679;1627;210033;172190;63.2;51.8
89;2021-07-31;1121;1073;211154;173263;63.6;52.2
89;2021-08-01;69;33;211223;173296;63.6;52.2
89;2021-08-02;1805;1288;213028;174584;64.1;52.6
89;2021-08-03;2502;1255;215530;175839;64.9;52.9
89;2021-08-04;1556;1641;217086;177480;65.4;53.4
89;2021-08-05;1577;1693;218663;179173;65.8;54.0
89;2021-08-06;2219;1651;220882;180824;66.5;54.4
89;2021-08-07;931;1098;221813;181922;66.8;54.8
89;2021-08-08;56;48;221869;181970;66.8;54.8
89;2021-08-09;1119;1175;222988;183145;67.1;55.1
89;2021-08-10;1832;1816;224820;184961;67.7;55.7
89;2021-08-11;1594;1585;226414;186546;68.2;56.2
89;2021-08-12;1452;1393;227866;187939;68.6;56.6
89;2021-08-13;1353;1956;229219;189895;69.0;57.2
89;2021-08-14;529;1024;229748;190919;69.2;57.5
89;2021-08-15;20;43;229768;190962;69.2;57.5
89;2021-08-16;1035;1969;230803;192931;69.5;58.1
89;2021-08-17;863;1573;231666;194504;69.8;58.6
89;2021-08-18;641;1898;232307;196402;70.0;59.1
89;2021-08-19;696;1389;233003;197791;70.2;59.6
89;2021-08-20;1156;2266;234159;200057;70.5;60.2
89;2021-08-21;297;1003;234456;201060;70.6;60.5
89;2021-08-22;32;34;234488;201094;70.6;60.6
89;2021-08-23;835;2252;235323;203346;70.9;61.2
89;2021-08-24;869;2366;236192;205712;71.1;61.9
89;2021-08-25;595;1429;236787;207141;71.3;62.4
89;2021-08-26;617;2053;237404;209194;71.5;63.0
89;2021-08-27;879;2264;238283;211458;71.8;63.7
89;2021-08-28;380;1303;238663;212761;71.9;64.1
89;2021-08-29;30;70;238693;212831;71.9;64.1
89;2021-08-30;664;2210;239357;215041;72.1;64.8
89;2021-08-31;610;1578;239967;216619;72.3;65.2
89;2021-09-01;615;1299;240582;217918;72.4;65.6
89;2021-09-02;470;1326;241052;219244;72.6;66.0
89;2021-09-03;639;1908;241691;221152;72.8;66.6
89;2021-09-04;515;947;242206;222099;72.9;66.9
89;2021-09-05;21;11;242227;222110;72.9;66.9
89;2021-09-06;467;1545;242694;223655;73.1;67.3
89;2021-09-07;399;914;243093;224569;73.2;67.6
89;2021-09-08;380;857;243473;225426;73.3;67.9
89;2021-09-09;290;832;243763;226258;73.4;68.1
89;2021-09-10;519;1382;244282;227640;73.6;68.5
89;2021-09-11;283;763;244565;228403;73.6;68.8
89;2021-09-12;11;38;244576;228441;73.6;68.8
89;2021-09-13;412;1069;244988;229510;73.8;69.1
89;2021-09-14;376;660;245364;230170;73.9;69.3
89;2021-09-15;239;700;245603;230870;74.0;69.5
89;2021-09-16;250;571;245853;231441;74.0;69.7
89;2021-09-17;497;1118;246350;232559;74.2;70.0
89;2021-09-18;180;744;246530;233303;74.2;70.3
89;2021-09-19;5;18;246535;233321;74.2;70.3
89;2021-09-20;253;726;246788;234047;74.3;70.5
89;2021-09-21;300;480;247088;234527;74.4;70.6
89;2021-09-22;201;579;247289;235106;74.5;70.8
89;2021-09-23;234;476;247523;235582;74.5;70.9
89;2021-09-24;303;872;247826;236454;74.6;71.2
89;2021-09-25;108;465;247934;236919;74.7;71.3
89;2021-09-26;3;19;247937;236938;74.7;71.3
89;2021-09-27;195;506;248132;237444;74.7;71.5
89;2021-09-28;240;410;248372;237854;74.8;71.6
89;2021-09-29;188;425;248560;238279;74.8;71.8
89;2021-09-30;170;622;248730;238901;74.9;71.9
89;2021-10-01;254;659;248984;239560;75.0;72.1
89;2021-10-02;120;479;249104;240039;75.0;72.3
89;2021-10-03;8;8;249112;240047;75.0;72.3
89;2021-10-04;121;545;249233;240592;75.0;72.4
89;2021-10-05;138;573;249371;241165;75.1;72.6
89;2021-10-06;228;588;249599;241753;75.2;72.8
89;2021-10-07;88;338;249687;242091;75.2;72.9
89;2021-10-08;234;730;249921;242821;75.3;73.1
89;2021-10-09;111;279;250032;243100;75.3;73.2
89;2021-10-10;0;11;250032;243111;75.3;73.2
89;2021-10-11;125;318;250157;243429;75.3;73.3
89;2021-10-12;103;268;250260;243697;75.4;73.4
89;2021-10-13;134;313;250394;244010;75.4;73.5
89;2021-10-14;110;332;250504;244342;75.4;73.6
90;2020-12-27;0;0;0;0;0.0;0.0
90;2020-12-28;0;0;0;0;0.0;0.0
90;2020-12-29;0;0;0;0;0.0;0.0
90;2020-12-30;1;0;1;0;0.0;0.0
90;2020-12-31;0;0;1;0;0.0;0.0
90;2021-01-01;0;0;1;0;0.0;0.0
90;2021-01-02;1;0;2;0;0.0;0.0
90;2021-01-03;0;0;2;0;0.0;0.0
90;2021-01-04;2;0;4;0;0.0;0.0
90;2021-01-05;0;0;4;0;0.0;0.0
90;2021-01-06;0;0;4;0;0.0;0.0
90;2021-01-07;1;0;5;0;0.0;0.0
90;2021-01-08;170;0;175;0;0.1;0.0
90;2021-01-09;46;0;221;0;0.2;0.0
90;2021-01-10;0;0;221;0;0.2;0.0
90;2021-01-11;200;0;421;0;0.3;0.0
90;2021-01-12;431;1;852;1;0.6;0.0
90;2021-01-13;467;2;1319;3;0.9;0.0
90;2021-01-14;414;2;1733;5;1.2;0.0
90;2021-01-15;404;9;2137;14;1.5;0.0
90;2021-01-16;111;2;2248;16;1.6;0.0
90;2021-01-17;1;0;2249;16;1.6;0.0
90;2021-01-18;365;2;2614;18;1.9;0.0
90;2021-01-19;462;6;3076;24;2.2;0.0
90;2021-01-20;393;2;3469;26;2.5;0.0
90;2021-01-21;351;1;3820;27;2.7;0.0
90;2021-01-22;345;2;4165;29;3.0;0.0
90;2021-01-23;98;0;4263;29;3.0;0.0
90;2021-01-24;0;0;4263;29;3.0;0.0
90;2021-01-25;322;3;4585;32;3.3;0.0
90;2021-01-26;224;0;4809;32;3.4;0.0
90;2021-01-27;254;0;5063;32;3.6;0.0
90;2021-01-28;328;33;5391;65;3.8;0.0
90;2021-01-29;291;163;5682;228;4.1;0.2
90;2021-01-30;175;45;5857;273;4.2;0.2
90;2021-01-31;118;0;5975;273;4.3;0.2
90;2021-02-01;275;116;6250;389;4.5;0.3
90;2021-02-02;290;163;6540;552;4.7;0.4
90;2021-02-03;256;368;6796;920;4.8;0.7
90;2021-02-04;257;306;7053;1226;5.0;0.9
90;2021-02-05;266;271;7319;1497;5.2;1.1
90;2021-02-06;90;68;7409;1565;5.3;1.1
90;2021-02-07;0;0;7409;1565;5.3;1.1
90;2021-02-08;170;217;7579;1782;5.4;1.3
90;2021-02-09;139;166;7718;1948;5.5;1.4
90;2021-02-10;182;32;7900;1980;5.6;1.4
90;2021-02-11;229;109;8129;2089;5.8;1.5
90;2021-02-12;126;239;8255;2328;5.9;1.7
90;2021-02-13;96;46;8351;2374;6.0;1.7
90;2021-02-14;0;0;8351;2374;6.0;1.7
90;2021-02-15;113;280;8464;2654;6.0;1.9
90;2021-02-16;92;275;8556;2929;6.1;2.1
90;2021-02-17;178;204;8734;3133;6.2;2.2
90;2021-02-18;128;242;8862;3375;6.3;2.4
90;2021-02-19;64;271;8926;3646;6.4;2.6
90;2021-02-20;40;72;8966;3718;6.4;2.7
90;2021-02-21;0;0;8966;3718;6.4;2.7
90;2021-02-22;77;334;9043;4052;6.5;2.9
90;2021-02-23;40;258;9083;4310;6.5;3.1
90;2021-02-24;109;290;9192;4600;6.6;3.3
90;2021-02-25;89;314;9281;4914;6.6;3.5
90;2021-02-26;89;393;9370;5307;6.7;3.8
90;2021-02-27;140;175;9510;5482;6.8;3.9
90;2021-02-28;8;113;9518;5595;6.8;4.0
90;2021-03-01;211;231;9729;5826;6.9;4.2
90;2021-03-02;178;284;9907;6110;7.1;4.4
90;2021-03-03;239;355;10146;6465;7.2;4.6
90;2021-03-04;260;278;10406;6743;7.4;4.8
90;2021-03-05;359;271;10765;7014;7.7;5.0
90;2021-03-06;291;104;11056;7118;7.9;5.1
90;2021-03-07;18;1;11074;7119;7.9;5.1
90;2021-03-08;246;249;11320;7368;8.1;5.3
90;2021-03-09;430;167;11750;7535;8.4;5.4
90;2021-03-10;348;197;12098;7732;8.6;5.5
90;2021-03-11;347;120;12445;7852;8.9;5.6
90;2021-03-12;519;130;12964;7982;9.3;5.7
90;2021-03-13;539;49;13503;8031;9.6;5.7
90;2021-03-14;21;0;13524;8031;9.7;5.7
90;2021-03-15;388;118;13912;8149;9.9;5.8
90;2021-03-16;402;103;14314;8252;10.2;5.9
90;2021-03-17;323;76;14637;8328;10.4;5.9
90;2021-03-18;349;84;14986;8412;10.7;6.0
90;2021-03-19;467;79;15453;8491;11.0;6.1
90;2021-03-20;427;48;15880;8539;11.3;6.1
90;2021-03-21;7;1;15887;8540;11.3;6.1
90;2021-03-22;399;31;16286;8571;11.6;6.1
90;2021-03-23;740;79;17026;8650;12.1;6.2
90;2021-03-24;817;47;17843;8697;12.7;6.2
90;2021-03-25;949;79;18792;8776;13.4;6.3
90;2021-03-26;1227;62;20019;8838;14.3;6.3
90;2021-03-27;439;34;20458;8872;14.6;6.3
90;2021-03-28;34;0;20492;8872;14.6;6.3
90;2021-03-29;712;144;21204;9016;15.1;6.4
90;2021-03-30;675;156;21879;9172;15.6;6.5
90;2021-03-31;728;87;22607;9259;16.1;6.6
90;2021-04-01;602;123;23209;9382;16.6;6.7
90;2021-04-02;657;98;23866;9480;17.0;6.8
90;2021-04-03;370;41;24236;9521;17.3;6.8
90;2021-04-04;1;0;24237;9521;17.3;6.8
90;2021-04-05;0;0;24237;9521;17.3;6.8
90;2021-04-06;528;252;24765;9773;17.7;7.0
90;2021-04-07;485;268;25250;10041;18.0;7.2
90;2021-04-08;510;246;25760;10287;18.4;7.3
90;2021-04-09;751;268;26511;10555;18.9;7.5
90;2021-04-10;224;9;26735;10564;19.1;7.5
90;2021-04-11;7;0;26742;10564;19.1;7.5
90;2021-04-12;557;482;27299;11046;19.5;7.9
90;2021-04-13;632;531;27931;11577;19.9;8.3
90;2021-04-14;525;354;28456;11931;20.3;8.5
90;2021-04-15;905;293;29361;12224;21.0;8.7
90;2021-04-16;370;405;29731;12629;21.2;9.0
90;2021-04-17;189;129;29920;12758;21.3;9.1
90;2021-04-18;21;0;29941;12758;21.4;9.1
90;2021-04-19;435;573;30376;13331;21.7;9.5
90;2021-04-20;493;620;30869;13951;22.0;10.0
90;2021-04-21;353;497;31222;14448;22.3;10.3
90;2021-04-22;569;602;31791;15050;22.7;10.7
90;2021-04-23;504;743;32295;15793;23.0;11.3
90;2021-04-24;305;202;32600;15995;23.3;11.4
90;2021-04-25;1;0;32601;15995;23.3;11.4
90;2021-04-26;509;751;33110;16746;23.6;11.9
90;2021-04-27;640;683;33750;17429;24.1;12.4
90;2021-04-28;765;448;34515;17877;24.6;12.8
90;2021-04-29;1003;455;35518;18332;25.3;13.1
90;2021-04-30;1120;460;36638;18792;26.1;13.4
90;2021-05-01;60;42;36698;18834;26.2;13.4
90;2021-05-02;4;0;36702;18834;26.2;13.4
90;2021-05-03;903;286;37605;19120;26.8;13.6
90;2021-05-04;784;638;38389;19758;27.4;14.1
90;2021-05-05;891;504;39280;20262;28.0;14.5
90;2021-05-06;851;626;40131;20888;28.6;14.9
90;2021-05-07;440;507;40571;21395;28.9;15.3
90;2021-05-08;26;27;40597;21422;29.0;15.3
90;2021-05-09;5;33;40602;21455;29.0;15.3
90;2021-05-10;506;585;41108;22040;29.3;15.7
90;2021-05-11;778;638;41886;22678;29.9;16.2
90;2021-05-12;531;598;42417;23276;30.3;16.6
90;2021-05-13;1113;265;43530;23541;31.1;16.8
90;2021-05-14;865;403;44395;23944;31.7;17.1
90;2021-05-15;14;125;44409;24069;31.7;17.2
90;2021-05-16;2;7;44411;24076;31.7;17.2
90;2021-05-17;792;290;45203;24366;32.3;17.4
90;2021-05-18;1024;472;46227;24838;33.0;17.7
90;2021-05-19;1264;384;47491;25222;33.9;18.0
90;2021-05-20;1201;270;48692;25492;34.7;18.2
90;2021-05-21;1265;436;49957;25928;35.6;18.5
90;2021-05-22;9;131;49966;26059;35.7;18.6
90;2021-05-23;4;0;49970;26059;35.7;18.6
90;2021-05-24;368;265;50338;26324;35.9;18.8
90;2021-05-25;635;791;50973;27115;36.4;19.3
90;2021-05-26;630;569;51603;27684;36.8;19.8
90;2021-05-27;962;383;52565;28067;37.5;20.0
90;2021-05-28;668;827;53233;28894;38.0;20.6
90;2021-05-29;93;296;53326;29190;38.1;20.8
90;2021-05-30;4;1;53330;29191;38.1;20.8
90;2021-05-31;808;713;54138;29904;38.6;21.3
90;2021-06-01;969;739;55107;30643;39.3;21.9
90;2021-06-02;760;676;55867;31319;39.9;22.3
90;2021-06-03;758;744;56625;32063;40.4;22.9
90;2021-06-04;833;972;57458;33035;41.0;23.6
90;2021-06-05;54;427;57512;33462;41.0;23.9
90;2021-06-06;1;16;57513;33478;41.0;23.9
90;2021-06-07;1265;1081;58778;34559;41.9;24.7
90;2021-06-08;1482;939;60260;35498;43.0;25.3
90;2021-06-09;964;659;61224;36157;43.7;25.8
90;2021-06-10;627;498;61851;36655;44.1;26.2
90;2021-06-11;787;1126;62638;37781;44.7;27.0
90;2021-06-12;806;297;63444;38078;45.3;27.2
90;2021-06-13;10;12;63454;38090;45.3;27.2
90;2021-06-14;264;972;63718;39062;45.5;27.9
90;2021-06-15;566;882;64284;39944;45.9;28.5
90;2021-06-16;509;548;64793;40492;46.2;28.9
90;2021-06-17;443;638;65236;41130;46.5;29.3
90;2021-06-18;623;997;65859;42127;47.0;30.1
90;2021-06-19;450;171;66309;42298;47.3;30.2
90;2021-06-20;0;28;66309;42326;47.3;30.2
90;2021-06-21;256;1176;66565;43502;47.5;31.0
90;2021-06-22;384;950;66949;44452;47.8;31.7
90;2021-06-23;415;633;67364;45085;48.1;32.2
90;2021-06-24;319;602;67683;45687;48.3;32.6
90;2021-06-25;431;1270;68114;46957;48.6;33.5
90;2021-06-26;420;560;68534;47517;48.9;33.9
90;2021-06-27;2;6;68536;47523;48.9;33.9
90;2021-06-28;381;1298;68917;48821;49.2;34.8
90;2021-06-29;305;1305;69222;50126;49.4;35.8
90;2021-06-30;485;1227;69707;51353;49.7;36.6
90;2021-07-01;355;920;70062;52273;50.0;37.3
90;2021-07-02;506;1205;70568;53478;50.4;38.2
90;2021-07-03;53;129;70621;53607;50.4;38.3
90;2021-07-04;0;21;70621;53628;50.4;38.3
90;2021-07-05;400;1014;71021;54642;50.7;39.0
90;2021-07-06;514;970;71535;55612;51.0;39.7
90;2021-07-07;381;998;71916;56610;51.3;40.4
90;2021-07-08;304;607;72220;57217;51.5;40.8
90;2021-07-09;439;950;72659;58167;51.8;41.5
90;2021-07-10;32;91;72691;58258;51.9;41.6
90;2021-07-11;7;17;72698;58275;51.9;41.6
90;2021-07-12;246;1075;72944;59350;52.0;42.3
90;2021-07-13;476;1162;73420;60512;52.4;43.2
90;2021-07-14;4;9;73424;60521;52.4;43.2
90;2021-07-15;789;1455;74213;61976;53.0;44.2
90;2021-07-16;826;1681;75039;63657;53.5;45.4
90;2021-07-17;484;955;75523;64612;53.9;46.1
90;2021-07-18;4;2;75527;64614;53.9;46.1
90;2021-07-19;1186;1460;76713;66074;54.7;47.1
90;2021-07-20;1339;1135;78052;67209;55.7;48.0
90;2021-07-21;1395;983;79447;68192;56.7;48.7
90;2021-07-22;1127;697;80574;68889;57.5;49.2
90;2021-07-23;968;1020;81542;69909;58.2;49.9
90;2021-07-24;121;66;81663;69975;58.3;49.9
90;2021-07-25;2;1;81665;69976;58.3;49.9
90;2021-07-26;1074;801;82739;70777;59.0;50.5
90;2021-07-27;1081;746;83820;71523;59.8;51.0
90;2021-07-28;825;712;84645;72235;60.4;51.5
90;2021-07-29;843;441;85488;72676;61.0;51.9
90;2021-07-30;786;506;86274;73182;61.6;52.2
90;2021-07-31;484;313;86758;73495;61.9;52.4
90;2021-08-01;0;3;86758;73498;61.9;52.4
90;2021-08-02;847;510;87605;74008;62.5;52.8
90;2021-08-03;929;494;88534;74502;63.2;53.2
90;2021-08-04;1067;460;89601;74962;63.9;53.5
90;2021-08-05;521;223;90122;75185;64.3;53.6
90;2021-08-06;649;388;90771;75573;64.8;53.9
90;2021-08-07;37;63;90808;75636;64.8;54.0
90;2021-08-08;18;3;90826;75639;64.8;54.0
90;2021-08-09;730;947;91556;76586;65.3;54.6
90;2021-08-10;536;1152;92092;77738;65.7;55.5
90;2021-08-11;537;948;92629;78686;66.1;56.1
90;2021-08-12;449;820;93078;79506;66.4;56.7
90;2021-08-13;545;898;93623;80404;66.8;57.4
90;2021-08-14;30;98;93653;80502;66.8;57.4
90;2021-08-15;2;7;93655;80509;66.8;57.4
90;2021-08-16;451;632;94106;81141;67.1;57.9
90;2021-08-17;347;1167;94453;82308;67.4;58.7
90;2021-08-18;275;881;94728;83189;67.6;59.4
90;2021-08-19;248;627;94976;83816;67.8;59.8
90;2021-08-20;361;772;95337;84588;68.0;60.4
90;2021-08-21;32;71;95369;84659;68.1;60.4
90;2021-08-22;0;7;95369;84666;68.1;60.4
90;2021-08-23;320;489;95689;85155;68.3;60.8
90;2021-08-24;337;959;96026;86114;68.5;61.4
90;2021-08-25;254;915;96280;87029;68.7;62.1
90;2021-08-26;247;675;96527;87704;68.9;62.6
90;2021-08-27;279;737;96806;88441;69.1;63.1
90;2021-08-28;21;64;96827;88505;69.1;63.2
90;2021-08-29;3;6;96830;88511;69.1;63.2
90;2021-08-30;328;629;97158;89140;69.3;63.6
90;2021-08-31;281;1010;97439;90150;69.5;64.3
90;2021-09-01;267;676;97706;90826;69.7;64.8
90;2021-09-02;159;386;97865;91212;69.8;65.1
90;2021-09-03;223;517;98088;91729;70.0;65.5
90;2021-09-04;55;139;98143;91868;70.0;65.6
90;2021-09-05;10;23;98153;91891;70.0;65.6
90;2021-09-06;135;722;98288;92613;70.1;66.1
90;2021-09-07;220;570;98508;93183;70.3;66.5
90;2021-09-08;224;575;98732;93758;70.4;66.9
90;2021-09-09;189;257;98921;94015;70.6;67.1
90;2021-09-10;192;472;99113;94487;70.7;67.4
90;2021-09-11;12;4;99125;94491;70.7;67.4
90;2021-09-12;0;4;99125;94495;70.7;67.4
90;2021-09-13;211;371;99336;94866;70.9;67.7
90;2021-09-14;162;337;99498;95203;71.0;67.9
90;2021-09-15;187;392;99685;95595;71.1;68.2
90;2021-09-16;154;239;99839;95834;71.2;68.4
90;2021-09-17;187;340;100026;96174;71.4;68.6
90;2021-09-18;17;24;100043;96198;71.4;68.6
90;2021-09-19;7;4;100050;96202;71.4;68.6
90;2021-09-20;153;250;100203;96452;71.5;68.8
90;2021-09-21;105;248;100308;96700;71.6;69.0
90;2021-09-22;105;353;100413;97053;71.6;69.3
90;2021-09-23;80;138;100493;97191;71.7;69.4
90;2021-09-24;102;285;100595;97476;71.8;69.6
90;2021-09-25;16;31;100611;97507;71.8;69.6
90;2021-09-26;0;7;100611;97514;71.8;69.6
90;2021-09-27;93;199;100704;97713;71.9;69.7
90;2021-09-28;91;140;100795;97853;71.9;69.8
90;2021-09-29;79;236;100874;98089;72.0;70.0
90;2021-09-30;61;131;100935;98220;72.0;70.1
90;2021-10-01;111;232;101046;98452;72.1;70.3
90;2021-10-02;10;28;101056;98480;72.1;70.3
90;2021-10-03;0;11;101056;98491;72.1;70.3
90;2021-10-04;140;209;101196;98700;72.2;70.4
90;2021-10-05;44;133;101240;98833;72.2;70.5
90;2021-10-06;91;186;101331;99019;72.3;70.7
90;2021-10-07;58;135;101389;99154;72.3;70.8
90;2021-10-08;112;239;101501;99393;72.4;70.9
90;2021-10-09;11;20;101512;99413;72.4;70.9
90;2021-10-10;0;4;101512;99417;72.4;70.9
90;2021-10-11;80;120;101592;99537;72.5;71.0
90;2021-10-12;70;120;101662;99657;72.5;71.1
90;2021-10-13;108;156;101770;99813;72.6;71.2
90;2021-10-14;66;110;101836;99923;72.7;71.3
91;2020-12-27;0;0;0;0;0.0;0.0
91;2020-12-28;0;0;0;0;0.0;0.0
91;2020-12-29;1;0;1;0;0.0;0.0
91;2020-12-30;1;0;2;0;0.0;0.0
91;2020-12-31;0;0;2;0;0.0;0.0
91;2021-01-01;5;0;7;0;0.0;0.0
91;2021-01-02;0;0;7;0;0.0;0.0
91;2021-01-03;0;0;7;0;0.0;0.0
91;2021-01-04;1;0;8;0;0.0;0.0
91;2021-01-05;70;0;78;0;0.0;0.0
91;2021-01-06;189;2;267;2;0.0;0.0
91;2021-01-07;522;7;789;9;0.1;0.0
91;2021-01-08;394;1;1183;10;0.1;0.0
91;2021-01-09;89;3;1272;13;0.1;0.0
91;2021-01-10;1;0;1273;13;0.1;0.0
91;2021-01-11;595;2;1868;15;0.1;0.0
91;2021-01-12;899;8;2767;23;0.2;0.0
91;2021-01-13;703;8;3470;31;0.3;0.0
91;2021-01-14;722;12;4192;43;0.3;0.0
91;2021-01-15;570;4;4762;47;0.4;0.0
91;2021-01-16;316;7;5078;54;0.4;0.0
91;2021-01-17;118;2;5196;56;0.4;0.0
91;2021-01-18;991;3;6187;59;0.5;0.0
91;2021-01-19;1877;31;8064;90;0.6;0.0
91;2021-01-20;2376;42;10440;132;0.8;0.0
91;2021-01-21;2109;24;12549;156;1.0;0.0
91;2021-01-22;1863;12;14412;168;1.1;0.0
91;2021-01-23;413;1;14825;169;1.1;0.0
91;2021-01-24;53;0;14878;169;1.1;0.0
91;2021-01-25;1049;4;15927;173;1.2;0.0
91;2021-01-26;1576;54;17503;227;1.3;0.0
91;2021-01-27;2423;128;19926;355;1.5;0.0
91;2021-01-28;1988;230;21914;585;1.7;0.0
91;2021-01-29;1746;70;23660;655;1.8;0.0
91;2021-01-30;422;9;24082;664;1.8;0.1
91;2021-01-31;54;0;24136;664;1.8;0.1
91;2021-02-01;965;219;25101;883;1.9;0.1
91;2021-02-02;859;363;25960;1246;2.0;0.1
91;2021-02-03;938;570;26898;1816;2.0;0.1
91;2021-02-04;885;279;27783;2095;2.1;0.2
91;2021-02-05;1037;359;28820;2454;2.2;0.2
91;2021-02-06;341;92;29161;2546;2.2;0.2
91;2021-02-07;14;1;29175;2547;2.2;0.2
91;2021-02-08;904;606;30079;3153;2.3;0.2
91;2021-02-09;963;861;31042;4014;2.4;0.3
91;2021-02-10;1065;994;32107;5008;2.4;0.4
91;2021-02-11;1123;1021;33230;6029;2.5;0.5
91;2021-02-12;1064;839;34294;6868;2.6;0.5
91;2021-02-13;332;359;34626;7227;2.6;0.5
91;2021-02-14;18;113;34644;7340;2.6;0.6
91;2021-02-15;370;1252;35014;8592;2.7;0.7
91;2021-02-16;555;1744;35569;10336;2.7;0.8
91;2021-02-17;814;2682;36383;13018;2.8;1.0
91;2021-02-18;944;2017;37327;15035;2.8;1.1
91;2021-02-19;874;1380;38201;16415;2.9;1.2
91;2021-02-20;168;357;38369;16772;2.9;1.3
91;2021-02-21;13;49;38382;16821;2.9;1.3
91;2021-02-22;335;1195;38717;18016;2.9;1.4
91;2021-02-23;398;1068;39115;19084;3.0;1.4
91;2021-02-24;475;1055;39590;20139;3.0;1.5
91;2021-02-25;736;1020;40326;21159;3.1;1.6
91;2021-02-26;1096;1059;41422;22218;3.1;1.7
91;2021-02-27;613;329;42035;22547;3.2;1.7
91;2021-02-28;65;66;42100;22613;3.2;1.7
91;2021-03-01;933;1074;43033;23687;3.3;1.8
91;2021-03-02;1261;1091;44294;24778;3.4;1.9
91;2021-03-03;1467;1281;45761;26059;3.5;2.0
91;2021-03-04;2435;1139;48196;27198;3.7;2.1
91;2021-03-05;3358;1185;51554;28383;3.9;2.2
91;2021-03-06;4913;477;56467;28860;4.3;2.2
91;2021-03-07;3208;123;59675;28983;4.5;2.2
91;2021-03-08;1474;1068;61149;30051;4.6;2.3
91;2021-03-09;2625;1002;63774;31053;4.8;2.4
91;2021-03-10;2626;1054;66400;32107;5.0;2.4
91;2021-03-11;3786;1146;70186;33253;5.3;2.5
91;2021-03-12;4794;1064;74980;34317;5.7;2.6
91;2021-03-13;5258;360;80238;34677;6.1;2.6
91;2021-03-14;305;29;80543;34706;6.1;2.6
91;2021-03-15;2988;447;83531;35153;6.3;2.7
91;2021-03-16;2617;393;86148;35546;6.5;2.7
91;2021-03-17;2227;356;88375;35902;6.7;2.7
91;2021-03-18;2394;418;90769;36320;6.9;2.8
91;2021-03-19;4093;389;94862;36709;7.2;2.8
91;2021-03-20;3608;192;98470;36901;7.5;2.8
91;2021-03-21;138;30;98608;36931;7.5;2.8
91;2021-03-22;3152;609;101760;37540;7.7;2.8
91;2021-03-23;4139;706;105899;38246;8.0;2.9
91;2021-03-24;3937;510;109836;38756;8.3;2.9
91;2021-03-25;5060;539;114896;39295;8.7;3.0
91;2021-03-26;5550;562;120446;39857;9.1;3.0
91;2021-03-27;4982;352;125428;40209;9.5;3.0
91;2021-03-28;282;59;125710;40268;9.5;3.1
91;2021-03-29;3305;1046;129015;41314;9.8;3.1
91;2021-03-30;4426;1239;133441;42553;10.1;3.2
91;2021-03-31;3370;1349;136811;43902;10.4;3.3
91;2021-04-01;3739;1693;140550;45595;10.7;3.5
91;2021-04-02;3886;2321;144436;47916;10.9;3.6
91;2021-04-03;1874;2877;146310;50793;11.1;3.8
91;2021-04-04;647;1320;146957;52113;11.1;3.9
91;2021-04-05;562;135;147519;52248;11.2;4.0
91;2021-04-06;3403;1797;150922;54045;11.4;4.1
91;2021-04-07;3420;1946;154342;55991;11.7;4.2
91;2021-04-08;4664;2179;159006;58170;12.1;4.4
91;2021-04-09;5348;2170;164354;60340;12.5;4.6
91;2021-04-10;2734;2825;167088;63165;12.7;4.8
91;2021-04-11;191;141;167279;63306;12.7;4.8
91;2021-04-12;2854;2283;170133;65589;12.9;5.0
91;2021-04-13;3758;2657;173891;68246;13.2;5.2
91;2021-04-14;3707;2332;177598;70578;13.5;5.3
91;2021-04-15;4477;2527;182075;73105;13.8;5.5
91;2021-04-16;4548;2816;186623;75921;14.1;5.8
91;2021-04-17;2983;2084;189606;78005;14.4;5.9
91;2021-04-18;269;73;189875;78078;14.4;5.9
91;2021-04-19;2306;2743;192181;80821;14.6;6.1
91;2021-04-20;3178;2990;195359;83811;14.8;6.4
91;2021-04-21;2990;2904;198349;86715;15.0;6.6
91;2021-04-22;3171;3370;201520;90085;15.3;6.8
91;2021-04-23;3717;3361;205237;93446;15.6;7.1
91;2021-04-24;3480;3736;208717;97182;15.8;7.4
91;2021-04-25;2619;647;211336;97829;16.0;7.4
91;2021-04-26;3486;2812;214822;100641;16.3;7.6
91;2021-04-27;4486;2930;219308;103571;16.6;7.8
91;2021-04-28;4569;2709;223877;106280;17.0;8.1
91;2021-04-29;5746;3069;229623;109349;17.4;8.3
91;2021-04-30;5385;2857;235008;112206;17.8;8.5
91;2021-05-01;3517;529;238525;112735;18.1;8.5
91;2021-05-02;628;134;239153;112869;18.1;8.6
91;2021-05-03;5202;2292;244355;115161;18.5;8.7
91;2021-05-04;5589;3181;249944;118342;18.9;9.0
91;2021-05-05;4852;2878;254796;121220;19.3;9.2
91;2021-05-06;5246;3381;260042;124601;19.7;9.4
91;2021-05-07;6122;3751;266164;128352;20.2;9.7
91;2021-05-08;6519;968;272683;129320;20.7;9.8
91;2021-05-09;4804;570;277487;129890;21.0;9.8
91;2021-05-10;5902;3011;283389;132901;21.5;10.1
91;2021-05-11;6826;3835;290215;136736;22.0;10.4
91;2021-05-12;5895;3444;296110;140180;22.4;10.6
91;2021-05-13;4825;1083;300935;141263;22.8;10.7
91;2021-05-14;6549;2396;307484;143659;23.3;10.9
91;2021-05-15;7793;1931;315277;145590;23.9;11.0
91;2021-05-16;4584;373;319861;145963;24.2;11.1
91;2021-05-17;6952;1706;326813;147669;24.8;11.2
91;2021-05-18;8120;1743;334933;149412;25.4;11.3
91;2021-05-19;7099;1697;342032;151109;25.9;11.5
91;2021-05-20;8201;2143;350233;153252;26.5;11.6
91;2021-05-21;8147;2580;358380;155832;27.2;11.8
91;2021-05-22;7660;1538;366040;157370;27.7;11.9
91;2021-05-23;4792;535;370832;157905;28.1;12.0
91;2021-05-24;5014;597;375846;158502;28.5;12.0
91;2021-05-25;7622;2654;383468;161156;29.1;12.2
91;2021-05-26;6874;2946;390342;164102;29.6;12.4
91;2021-05-27;7971;3448;398313;167550;30.2;12.7
91;2021-05-28;7534;4326;405847;171876;30.8;13.0
91;2021-05-29;9301;3508;415148;175384;31.5;13.3
91;2021-05-30;5948;964;421096;176348;31.9;13.4
91;2021-05-31;6738;3698;427834;180046;32.4;13.6
91;2021-06-01;7788;4781;435622;184827;33.0;14.0
91;2021-06-02;7454;3961;443076;188788;33.6;14.3
91;2021-06-03;7859;4780;450935;193568;34.2;14.7
91;2021-06-04;7194;5724;458129;199292;34.7;15.1
91;2021-06-05;6385;5821;464514;205113;35.2;15.5
91;2021-06-06;4087;2512;468601;207625;35.5;15.7
91;2021-06-07;5878;5481;474479;213106;36.0;16.2
91;2021-06-08;7039;5796;481518;218902;36.5;16.6
91;2021-06-09;6469;5145;487987;224047;37.0;17.0
91;2021-06-10;7177;5779;495164;229826;37.5;17.4
91;2021-06-11;6546;7112;501710;236938;38.0;18.0
91;2021-06-12;6218;7368;507928;244306;38.5;18.5
91;2021-06-13;2846;2316;510774;246622;38.7;18.7
91;2021-06-14;4225;7198;514999;253820;39.0;19.2
91;2021-06-15;5575;7262;520574;261082;39.5;19.8
91;2021-06-16;5297;6447;525871;267529;39.9;20.3
91;2021-06-17;6251;7131;532122;274660;40.3;20.8
91;2021-06-18;4630;8740;536752;283400;40.7;21.5
91;2021-06-19;4190;7156;540942;290556;41.0;22.0
91;2021-06-20;1007;4212;541949;294768;41.1;22.3
91;2021-06-21;3232;7236;545181;302004;41.3;22.9
91;2021-06-22;4157;9229;549338;311233;41.6;23.6
91;2021-06-23;4315;7962;553653;319195;42.0;24.2
91;2021-06-24;4912;8483;558565;327678;42.3;24.8
91;2021-06-25;3477;9166;562042;336844;42.6;25.5
91;2021-06-26;2990;8034;565032;344878;42.8;26.1
91;2021-06-27;550;2996;565582;347874;42.9;26.4
91;2021-06-28;3129;8238;568711;356112;43.1;27.0
91;2021-06-29;3588;9634;572299;365746;43.4;27.7
91;2021-06-30;3953;8701;576252;374447;43.7;28.4
91;2021-07-01;4103;8873;580355;383320;44.0;29.1
91;2021-07-02;3775;9320;584130;392640;44.3;29.8
91;2021-07-03;2881;9789;587011;402429;44.5;30.5
91;2021-07-04;852;4726;587863;407155;44.6;30.9
91;2021-07-05;2662;7258;590525;414413;44.8;31.4
91;2021-07-06;3758;9431;594283;423844;45.0;32.1
91;2021-07-07;3806;8592;598089;432436;45.3;32.8
91;2021-07-08;4358;8992;602447;441428;45.7;33.5
91;2021-07-09;3968;9953;606415;451381;46.0;34.2
91;2021-07-10;3397;10236;609812;461617;46.2;35.0
91;2021-07-11;987;4804;610799;466421;46.3;35.4
91;2021-07-12;2804;8886;613603;475307;46.5;36.0
91;2021-07-13;4467;10393;618070;485700;46.8;36.8
91;2021-07-14;2304;3586;620374;489286;47.0;37.1
91;2021-07-15;4537;9824;624911;499110;47.4;37.8
91;2021-07-16;6287;9769;631198;508879;47.8;38.6
91;2021-07-17;5751;9069;636949;517948;48.3;39.3
91;2021-07-18;3402;3686;640351;521634;48.5;39.5
91;2021-07-19;3777;7538;644128;529172;48.8;40.1
91;2021-07-20;6075;9311;650203;538483;49.3;40.8
91;2021-07-21;6252;7741;656455;546224;49.8;41.4
91;2021-07-22;6497;8402;662952;554626;50.2;42.0
91;2021-07-23;6926;8290;669878;562916;50.8;42.7
91;2021-07-24;5012;6481;674890;569397;51.2;43.2
91;2021-07-25;3267;1408;678157;570805;51.4;43.3
91;2021-07-26;4935;6594;683092;577399;51.8;43.8
91;2021-07-27;7567;7084;690659;584483;52.3;44.3
91;2021-07-28;7365;5924;698024;590407;52.9;44.7
91;2021-07-29;7401;5916;705425;596323;53.5;45.2
91;2021-07-30;6914;5783;712339;602106;54.0;45.6
91;2021-07-31;4910;4790;717249;606896;54.4;46.0
91;2021-08-01;2659;1340;719908;608236;54.6;46.1
91;2021-08-02;4909;4238;724817;612474;54.9;46.4
91;2021-08-03;6202;4697;731019;617171;55.4;46.8
91;2021-08-04;5701;4143;736720;621314;55.8;47.1
91;2021-08-05;5608;4272;742328;625586;56.3;47.4
91;2021-08-06;5711;5630;748039;631216;56.7;47.8
91;2021-08-07;3085;2420;751124;633636;56.9;48.0
91;2021-08-08;622;1102;751746;634738;57.0;48.1
91;2021-08-09;3906;3978;755652;638716;57.3;48.4
91;2021-08-10;4652;4555;760304;643271;57.6;48.8
91;2021-08-11;4151;4487;764455;647758;57.9;49.1
91;2021-08-12;4091;4786;768546;652544;58.2;49.5
91;2021-08-13;4303;4866;772849;657410;58.6;49.8
91;2021-08-14;2246;2402;775095;659812;58.7;50.0
91;2021-08-15;95;171;775190;659983;58.8;50.0
91;2021-08-16;3120;4664;778310;664647;59.0;50.4
91;2021-08-17;3654;5822;781964;670469;59.3;50.8
91;2021-08-18;3031;5799;784995;676268;59.5;51.3
91;2021-08-19;3481;5775;788476;682043;59.8;51.7
91;2021-08-20;3220;6958;791696;689001;60.0;52.2
91;2021-08-21;2464;3355;794160;692356;60.2;52.5
91;2021-08-22;738;1297;794898;693653;60.2;52.6
91;2021-08-23;2428;5310;797326;698963;60.4;53.0
91;2021-08-24;2987;6964;800313;705927;60.7;53.5
91;2021-08-25;3438;6723;803751;712650;60.9;54.0
91;2021-08-26;2749;5955;806500;718605;61.1;54.5
91;2021-08-27;2836;7504;809336;726109;61.3;55.0
91;2021-08-28;2390;4836;811726;730945;61.5;55.4
91;2021-08-29;1782;2800;813508;733745;61.7;55.6
91;2021-08-30;1805;5548;815313;739293;61.8;56.0
91;2021-08-31;2258;5916;817571;745209;62.0;56.5
91;2021-09-01;2640;4379;820211;749588;62.2;56.8
91;2021-09-02;1997;3568;822208;753156;62.3;57.1
91;2021-09-03;2208;4653;824416;757809;62.5;57.4
91;2021-09-04;2089;4095;826505;761904;62.6;57.7
91;2021-09-05;748;880;827253;762784;62.7;57.8
91;2021-09-06;1738;2992;828991;765776;62.8;58.0
91;2021-09-07;1575;2795;830566;768571;63.0;58.3
91;2021-09-08;1799;3083;832365;771654;63.1;58.5
91;2021-09-09;1318;2816;833683;774470;63.2;58.7
91;2021-09-10;1824;3554;835507;778024;63.3;59.0
91;2021-09-11;1754;4287;837261;782311;63.5;59.3
91;2021-09-12;627;945;837888;783256;63.5;59.4
91;2021-09-13;1312;2295;839200;785551;63.6;59.5
91;2021-09-14;1833;2657;841033;788208;63.7;59.7
91;2021-09-15;1687;3288;842720;791496;63.9;60.0
91;2021-09-16;1501;2386;844221;793882;64.0;60.2
91;2021-09-17;1447;3000;845668;796882;64.1;60.4
91;2021-09-18;1392;3669;847060;800551;64.2;60.7
91;2021-09-19;460;1149;847520;801700;64.2;60.8
91;2021-09-20;775;1600;848295;803300;64.3;60.9
91;2021-09-21;929;1751;849224;805051;64.4;61.0
91;2021-09-22;966;2645;850190;807696;64.4;61.2
91;2021-09-23;954;1736;851144;809432;64.5;61.3
91;2021-09-24;896;2201;852040;811633;64.6;61.5
91;2021-09-25;1052;3483;853092;815116;64.7;61.8
91;2021-09-26;217;822;853309;815938;64.7;61.8
91;2021-09-27;729;1570;854038;817508;64.7;62.0
91;2021-09-28;900;1444;854938;818952;64.8;62.1
91;2021-09-29;1014;2227;855952;821179;64.9;62.2
91;2021-09-30;662;1131;856614;822310;64.9;62.3
91;2021-10-01;970;1880;857584;824190;65.0;62.5
91;2021-10-02;1106;2392;858690;826582;65.1;62.6
91;2021-10-03;266;613;858956;827195;65.1;62.7
91;2021-10-04;620;1168;859576;828363;65.1;62.8
91;2021-10-05;593;1116;860169;829479;65.2;62.9
91;2021-10-06;779;1926;860948;831405;65.3;63.0
91;2021-10-07;579;1130;861527;832535;65.3;63.1
91;2021-10-08;787;1755;862314;834290;65.4;63.2
91;2021-10-09;1081;1997;863395;836287;65.4;63.4
91;2021-10-10;281;516;863676;836803;65.5;63.4
91;2021-10-11;580;1147;864256;837950;65.5;63.5
91;2021-10-12;528;1181;864784;839131;65.5;63.6
91;2021-10-13;806;1576;865590;840707;65.6;63.7
91;2021-10-14;482;1141;866072;841848;65.6;63.8
92;2020-12-27;49;5;49;5;0.0;0.0
92;2020-12-28;31;1;80;6;0.0;0.0
92;2020-12-29;66;2;146;8;0.0;0.0
92;2020-12-30;55;5;201;13;0.0;0.0
92;2020-12-31;14;1;215;14;0.0;0.0
92;2021-01-01;44;3;259;17;0.0;0.0
92;2021-01-02;17;0;276;17;0.0;0.0
92;2021-01-03;19;1;295;18;0.0;0.0
92;2021-01-04;82;5;377;23;0.0;0.0
92;2021-01-05;237;4;614;27;0.0;0.0
92;2021-01-06;421;4;1035;31;0.1;0.0
92;2021-01-07;674;9;1709;40;0.1;0.0
92;2021-01-08;851;4;2560;44;0.2;0.0
92;2021-01-09;130;6;2690;50;0.2;0.0
92;2021-01-10;54;2;2744;52;0.2;0.0
92;2021-01-11;853;12;3597;64;0.2;0.0
92;2021-01-12;1309;13;4906;77;0.3;0.0
92;2021-01-13;1254;17;6160;94;0.4;0.0
92;2021-01-14;1246;32;7406;126;0.5;0.0
92;2021-01-15;986;11;8392;137;0.5;0.0
92;2021-01-16;187;4;8579;141;0.5;0.0
92;2021-01-17;37;2;8616;143;0.5;0.0
92;2021-01-18;1557;34;10173;177;0.6;0.0
92;2021-01-19;1579;31;11752;208;0.7;0.0
92;2021-01-20;1826;20;13578;228;0.8;0.0
92;2021-01-21;3455;36;17033;264;1.1;0.0
92;2021-01-22;2630;47;19663;311;1.2;0.0
92;2021-01-23;154;9;19817;320;1.2;0.0
92;2021-01-24;36;3;19853;323;1.2;0.0
92;2021-01-25;863;20;20716;343;1.3;0.0
92;2021-01-26;1221;14;21937;357;1.4;0.0
92;2021-01-27;2227;108;24164;465;1.5;0.0
92;2021-01-28;4201;208;28365;673;1.8;0.0
92;2021-01-29;2721;267;31086;940;1.9;0.1
92;2021-01-30;327;18;31413;958;1.9;0.1
92;2021-01-31;36;6;31449;964;1.9;0.1
92;2021-02-01;878;324;32327;1288;2.0;0.1
92;2021-02-02;1073;355;33400;1643;2.1;0.1
92;2021-02-03;1007;447;34407;2090;2.1;0.1
92;2021-02-04;1058;548;35465;2638;2.2;0.2
92;2021-02-05;1336;503;36801;3141;2.3;0.2
92;2021-02-06;129;24;36930;3165;2.3;0.2
92;2021-02-07;24;19;36954;3184;2.3;0.2
92;2021-02-08;589;733;37543;3917;2.3;0.2
92;2021-02-09;1074;1305;38617;5222;2.4;0.3
92;2021-02-10;1095;1313;39712;6535;2.5;0.4
92;2021-02-11;1521;1941;41233;8476;2.6;0.5
92;2021-02-12;1427;1486;42660;9962;2.6;0.6
92;2021-02-13;80;68;42740;10030;2.6;0.6
92;2021-02-14;31;6;42771;10036;2.7;0.6
92;2021-02-15;584;1653;43355;11689;2.7;0.7
92;2021-02-16;793;2047;44148;13736;2.7;0.9
92;2021-02-17;630;1760;44778;15496;2.8;1.0
92;2021-02-18;1584;3654;46362;19150;2.9;1.2
92;2021-02-19;1737;2665;48099;21815;3.0;1.4
92;2021-02-20;150;400;48249;22215;3.0;1.4
92;2021-02-21;51;55;48300;22270;3.0;1.4
92;2021-02-22;506;1214;48806;23484;3.0;1.5
92;2021-02-23;746;1364;49552;24848;3.1;1.5
92;2021-02-24;621;1291;50173;26139;3.1;1.6
92;2021-02-25;937;1797;51110;27936;3.2;1.7
92;2021-02-26;1469;1372;52579;29308;3.3;1.8
92;2021-02-27;507;190;53086;29498;3.3;1.8
92;2021-02-28;75;58;53161;29556;3.3;1.8
92;2021-03-01;1108;1058;54269;30614;3.4;1.9
92;2021-03-02;1991;1384;56260;31998;3.5;2.0
92;2021-03-03;2814;1110;59074;33108;3.7;2.1
92;2021-03-04;3606;1543;62680;34651;3.9;2.1
92;2021-03-05;4987;1746;67667;36397;4.2;2.3
92;2021-03-06;5727;351;73394;36748;4.5;2.3
92;2021-03-07;2909;243;76303;36991;4.7;2.3
92;2021-03-08;2430;833;78733;37824;4.9;2.3
92;2021-03-09;3449;1049;82182;38873;5.1;2.4
92;2021-03-10;3953;971;86135;39844;5.3;2.5
92;2021-03-11;5029;1429;91164;41273;5.6;2.6
92;2021-03-12;6780;1590;97944;42863;6.1;2.7
92;2021-03-13;5163;256;103107;43119;6.4;2.7
92;2021-03-14;1747;81;104854;43200;6.5;2.7
92;2021-03-15;3811;624;108665;43824;6.7;2.7
92;2021-03-16;3704;615;112369;44439;7.0;2.8
92;2021-03-17;3881;440;116250;44879;7.2;2.8
92;2021-03-18;4151;769;120401;45648;7.5;2.8
92;2021-03-19;5937;764;126338;46412;7.8;2.9
92;2021-03-20;2544;84;128882;46496;8.0;2.9
92;2021-03-21;156;33;129038;46529;8.0;2.9
92;2021-03-22;4120;494;133158;47023;8.3;2.9
92;2021-03-23;6114;896;139272;47919;8.6;3.0
92;2021-03-24;6386;678;145658;48597;9.0;3.0
92;2021-03-25;8446;675;154104;49272;9.5;3.1
92;2021-03-26;8364;915;162468;50187;10.1;3.1
92;2021-03-27;2838;286;165306;50473;10.2;3.1
92;2021-03-28;543;40;165849;50513;10.3;3.1
92;2021-03-29;4673;1076;170522;51589;10.6;3.2
92;2021-03-30;6396;1571;176918;53160;11.0;3.3
92;2021-03-31;5556;2275;182474;55435;11.3;3.4
92;2021-04-01;6280;3701;188754;59136;11.7;3.7
92;2021-04-02;5640;3450;194394;62586;12.0;3.9
92;2021-04-03;878;1425;195272;64011;12.1;4.0
92;2021-04-04;493;1065;195765;65076;12.1;4.0
92;2021-04-05;820;163;196585;65239;12.2;4.0
92;2021-04-06;3668;1975;200253;67214;12.4;4.2
92;2021-04-07;5005;2899;205258;70113;12.7;4.3
92;2021-04-08;5994;3206;211252;73319;13.1;4.5
92;2021-04-09;8039;3091;219291;76410;13.6;4.7
92;2021-04-10;2647;1306;221938;77716;13.8;4.8
92;2021-04-11;171;810;222109;78526;13.8;4.9
92;2021-04-12;3690;2528;225799;81054;14.0;5.0
92;2021-04-13;4389;4444;230188;85498;14.3;5.3
92;2021-04-14;4878;4054;235066;89552;14.6;5.5
92;2021-04-15;5305;3968;240371;93520;14.9;5.8
92;2021-04-16;5082;3876;245453;97396;15.2;6.0
92;2021-04-17;1808;1198;247261;98594;15.3;6.1
92;2021-04-18;351;97;247612;98691;15.3;6.1
92;2021-04-19;2821;2848;250433;101539;15.5;6.3
92;2021-04-20;4200;3764;254633;105303;15.8;6.5
92;2021-04-21;4620;4527;259253;109830;16.1;6.8
92;2021-04-22;4664;5135;263917;114965;16.4;7.1
92;2021-04-23;5264;4740;269181;119705;16.7;7.4
92;2021-04-24;4944;1919;274125;121624;17.0;7.5
92;2021-04-25;1798;153;275923;121777;17.1;7.5
92;2021-04-26;4004;3630;279927;125407;17.3;7.8
92;2021-04-27;6048;5276;285975;130683;17.7;8.1
92;2021-04-28;7385;4519;293360;135202;18.2;8.4
92;2021-04-29;7995;4806;301355;140008;18.7;8.7
92;2021-04-30;8847;4865;310202;144873;19.2;9.0
92;2021-05-01;1203;413;311405;145286;19.3;9.0
92;2021-05-02;670;141;312075;145427;19.3;9.0
92;2021-05-03;6792;3894;318867;149321;19.8;9.3
92;2021-05-04;10435;4381;329302;153702;20.4;9.5
92;2021-05-05;10078;5260;339380;158962;21.0;9.9
92;2021-05-06;11428;4912;350808;163874;21.7;10.2
92;2021-05-07;9867;5310;360675;169184;22.3;10.5
92;2021-05-08;7215;1925;367890;171109;22.8;10.6
92;2021-05-09;3787;602;371677;171711;23.0;10.6
92;2021-05-10;9547;4009;381224;175720;23.6;10.9
92;2021-05-11;13981;5699;395205;181419;24.5;11.2
92;2021-05-12;14287;4585;409492;186004;25.4;11.5
92;2021-05-13;9168;911;418660;186915;25.9;11.6
92;2021-05-14;12030;2313;430690;189228;26.7;11.7
92;2021-05-15;8394;1231;439084;190459;27.2;11.8
92;2021-05-16;4144;453;443228;190912;27.5;11.8
92;2021-05-17;10650;2215;453878;193127;28.1;12.0
92;2021-05-18;16410;3122;470288;196249;29.1;12.2
92;2021-05-19;16049;3718;486337;199967;30.1;12.4
92;2021-05-20;16841;3986;503178;203953;31.2;12.6
92;2021-05-21;14070;3622;517248;207575;32.1;12.9
92;2021-05-22;8318;1515;525566;209090;32.6;13.0
92;2021-05-23;4083;454;529649;209544;32.8;13.0
92;2021-05-24;6122;856;535771;210400;33.2;13.0
92;2021-05-25;13114;4566;548885;214966;34.0;13.3
92;2021-05-26;11927;5039;560812;220005;34.8;13.6
92;2021-05-27;12736;6328;573548;226333;35.5;14.0
92;2021-05-28;11234;6290;584782;232623;36.2;14.4
92;2021-05-29;5453;2304;590235;234927;36.6;14.6
92;2021-05-30;2252;389;592487;235316;36.7;14.6
92;2021-05-31;12049;5299;604536;240615;37.5;14.9
92;2021-06-01;12637;7640;617173;248255;38.2;15.4
92;2021-06-02;14382;7209;631555;255464;39.1;15.8
92;2021-06-03;14599;8032;646154;263496;40.0;16.3
92;2021-06-04;12237;8226;658391;271722;40.8;16.8
92;2021-06-05;7383;6232;665774;277954;41.3;17.2
92;2021-06-06;3598;1676;669372;279630;41.5;17.3
92;2021-06-07;11435;7637;680807;287267;42.2;17.8
92;2021-06-08;12766;9605;693573;296872;43.0;18.4
92;2021-06-09;11663;9474;705236;306346;43.7;19.0
92;2021-06-10;11971;10570;717207;316916;44.4;19.6
92;2021-06-11;8156;11038;725363;327954;44.9;20.3
92;2021-06-12;6364;5092;731727;333046;45.3;20.6
92;2021-06-13;3970;2720;735697;335766;45.6;20.8
92;2021-06-14;5213;11171;740910;346937;45.9;21.5
92;2021-06-15;6540;13129;747450;360066;46.3;22.3
92;2021-06-16;6955;12994;754405;373060;46.7;23.1
92;2021-06-17;7429;14002;761834;387062;47.2;24.0
92;2021-06-18;6908;14387;768742;401449;47.6;24.9
92;2021-06-19;3969;9107;772711;410556;47.9;25.4
92;2021-06-20;1968;5606;774679;416162;48.0;25.8
92;2021-06-21;4841;12276;779520;428438;48.3;26.5
92;2021-06-22;5880;17540;785400;445978;48.7;27.6
92;2021-06-23;5486;15992;790886;461970;49.0;28.6
92;2021-06-24;6211;15119;797097;477089;49.4;29.6
92;2021-06-25;5121;16097;802218;493186;49.7;30.6
92;2021-06-26;4071;10455;806289;503641;50.0;31.2
92;2021-06-27;1858;6046;808147;509687;50.1;31.6
92;2021-06-28;3674;12047;811821;521734;50.3;32.3
92;2021-06-29;4679;18155;816500;539889;50.6;33.5
92;2021-06-30;4455;16226;820955;556115;50.9;34.5
92;2021-07-01;5525;16306;826480;572421;51.2;35.5
92;2021-07-02;4943;15287;831423;587708;51.5;36.4
92;2021-07-03;3309;10185;834732;597893;51.7;37.0
92;2021-07-04;1125;4208;835857;602101;51.8;37.3
92;2021-07-05;4825;12332;840682;614433;52.1;38.1
92;2021-07-06;5290;15814;845972;630247;52.4;39.1
92;2021-07-07;4269;11463;850241;641710;52.7;39.8
92;2021-07-08;5409;14638;855650;656348;53.0;40.7
92;2021-07-09;5899;14204;861549;670552;53.4;41.6
92;2021-07-10;4378;8458;865927;679010;53.7;42.1
92;2021-07-11;1487;2617;867414;681627;53.8;42.2
92;2021-07-12;4421;14646;871835;696273;54.0;43.1
92;2021-07-13;7881;17460;879716;713733;54.5;44.2
92;2021-07-14;5115;5746;884831;719479;54.8;44.6
92;2021-07-15;9571;16257;894402;735736;55.4;45.6
92;2021-07-16;9066;14190;903468;749926;56.0;46.5
92;2021-07-17;6583;7605;910051;757531;56.4;46.9
92;2021-07-18;1842;2482;911893;760013;56.5;47.1
92;2021-07-19;6481;13204;918374;773217;56.9;47.9
92;2021-07-20;10096;14114;928470;787331;57.5;48.8
92;2021-07-21;10473;12126;938943;799457;58.2;49.5
92;2021-07-22;12061;12997;951004;812454;58.9;50.3
92;2021-07-23;11594;11363;962598;823817;59.6;51.0
92;2021-07-24;6736;6272;969334;830089;60.1;51.4
92;2021-07-25;2778;2329;972112;832418;60.2;51.6
92;2021-07-26;9491;9178;981603;841596;60.8;52.2
92;2021-07-27;11526;9624;993129;851220;61.5;52.7
92;2021-07-28;12949;8209;1006078;859429;62.3;53.3
92;2021-07-29;10457;8640;1016535;868069;63.0;53.8
92;2021-07-30;9129;8359;1025664;876428;63.6;54.3
92;2021-07-31;5703;4825;1031367;881253;63.9;54.6
92;2021-08-01;2220;1301;1033587;882554;64.0;54.7
92;2021-08-02;4799;4939;1038386;887493;64.3;55.0
92;2021-08-03;5147;6150;1043533;893643;64.7;55.4
92;2021-08-04;4781;4875;1048314;898518;65.0;55.7
92;2021-08-05;4533;5694;1052847;904212;65.2;56.0
92;2021-08-06;4553;5974;1057400;910186;65.5;56.4
92;2021-08-07;2840;4183;1060240;914369;65.7;56.7
92;2021-08-08;964;1083;1061204;915452;65.8;56.7
92;2021-08-09;3212;4255;1064416;919707;66.0;57.0
92;2021-08-10;3839;5613;1068255;925320;66.2;57.3
92;2021-08-11;3239;4436;1071494;929756;66.4;57.6
92;2021-08-12;3398;5602;1074892;935358;66.6;58.0
92;2021-08-13;3003;5148;1077895;940506;66.8;58.3
92;2021-08-14;1889;3931;1079784;944437;66.9;58.5
92;2021-08-15;596;840;1080380;945277;66.9;58.6
92;2021-08-16;2410;5326;1082790;950603;67.1;58.9
92;2021-08-17;2638;6993;1085428;957596;67.3;59.3
92;2021-08-18;2433;5256;1087861;962852;67.4;59.7
92;2021-08-19;2529;5745;1090390;968597;67.6;60.0
92;2021-08-20;2286;5199;1092676;973796;67.7;60.3
92;2021-08-21;1398;4225;1094074;978021;67.8;60.6
92;2021-08-22;427;1599;1094501;979620;67.8;60.7
92;2021-08-23;2497;6602;1096998;986222;68.0;61.1
92;2021-08-24;3158;8351;1100156;994573;68.2;61.6
92;2021-08-25;2867;7586;1103023;1002159;68.4;62.1
92;2021-08-26;3021;7579;1106044;1009738;68.5;62.6
92;2021-08-27;3108;7017;1109152;1016755;68.7;63.0
92;2021-08-28;1626;4516;1110778;1021271;68.8;63.3
92;2021-08-29;346;789;1111124;1022060;68.9;63.3
92;2021-08-30;2259;4706;1113383;1026766;69.0;63.6
92;2021-08-31;3097;6629;1116480;1033395;69.2;64.0
92;2021-09-01;3381;6893;1119861;1040288;69.4;64.5
92;2021-09-02;2674;6051;1122535;1046339;69.6;64.8
92;2021-09-03;2711;5787;1125246;1052126;69.7;65.2
92;2021-09-04;2371;4775;1127617;1056901;69.9;65.5
92;2021-09-05;447;924;1128064;1057825;69.9;65.6
92;2021-09-06;1345;2989;1129409;1060814;70.0;65.7
92;2021-09-07;1725;3330;1131134;1064144;70.1;65.9
92;2021-09-08;2192;3618;1133326;1067762;70.2;66.2
92;2021-09-09;1251;2617;1134577;1070379;70.3;66.3
92;2021-09-10;1814;3388;1136391;1073767;70.4;66.5
92;2021-09-11;1614;2714;1138005;1076481;70.5;66.7
92;2021-09-12;213;433;1138218;1076914;70.5;66.7
92;2021-09-13;1127;2225;1139345;1079139;70.6;66.9
92;2021-09-14;1242;2406;1140587;1081545;70.7;67.0
92;2021-09-15;1600;3632;1142187;1085177;70.8;67.2
92;2021-09-16;1092;2168;1143279;1087345;70.8;67.4
92;2021-09-17;1444;3102;1144723;1090447;70.9;67.6
92;2021-09-18;1013;2236;1145736;1092683;71.0;67.7
92;2021-09-19;131;290;1145867;1092973;71.0;67.7
92;2021-09-20;786;1833;1146653;1094806;71.1;67.8
92;2021-09-21;795;1872;1147448;1096678;71.1;68.0
92;2021-09-22;1084;3819;1148532;1100497;71.2;68.2
92;2021-09-23;739;1825;1149271;1102322;71.2;68.3
92;2021-09-24;1095;2855;1150366;1105177;71.3;68.5
92;2021-09-25;620;2212;1150986;1107389;71.3;68.6
92;2021-09-26;95;249;1151081;1107638;71.3;68.6
92;2021-09-27;769;1631;1151850;1109269;71.4;68.7
92;2021-09-28;788;1573;1152638;1110842;71.4;68.8
92;2021-09-29;1135;2836;1153773;1113678;71.5;69.0
92;2021-09-30;854;1334;1154627;1115012;71.5;69.1
92;2021-10-01;1130;2101;1155757;1117113;71.6;69.2
92;2021-10-02;798;1805;1156555;1118918;71.7;69.3
92;2021-10-03;89;205;1156644;1119123;71.7;69.3
92;2021-10-04;703;1314;1157347;1120437;71.7;69.4
92;2021-10-05;731;1317;1158078;1121754;71.8;69.5
92;2021-10-06;1061;1992;1159139;1123746;71.8;69.6
92;2021-10-07;543;936;1159682;1124682;71.9;69.7
92;2021-10-08;1111;1860;1160793;1126542;71.9;69.8
92;2021-10-09;708;1365;1161501;1127907;72.0;69.9
92;2021-10-10;101;126;1161602;1128033;72.0;69.9
92;2021-10-11;660;976;1162262;1129009;72.0;70.0
92;2021-10-12;825;1160;1163087;1130169;72.1;70.0
92;2021-10-13;999;1525;1164086;1131694;72.1;70.1
92;2021-10-14;620;870;1164706;1132564;72.2;70.2
93;2020-12-27;12;3;12;3;0.0;0.0
93;2020-12-28;6;2;18;5;0.0;0.0
93;2020-12-29;2;0;20;5;0.0;0.0
93;2020-12-30;44;1;64;6;0.0;0.0
93;2020-12-31;11;0;75;6;0.0;0.0
93;2021-01-01;5;0;80;6;0.0;0.0
93;2021-01-02;1;0;81;6;0.0;0.0
93;2021-01-03;4;0;85;6;0.0;0.0
93;2021-01-04;3;1;88;7;0.0;0.0
93;2021-01-05;67;3;155;10;0.0;0.0
93;2021-01-06;179;0;334;10;0.0;0.0
93;2021-01-07;381;3;715;13;0.0;0.0
93;2021-01-08;634;2;1349;15;0.1;0.0
93;2021-01-09;21;0;1370;15;0.1;0.0
93;2021-01-10;2;0;1372;15;0.1;0.0
93;2021-01-11;505;5;1877;20;0.1;0.0
93;2021-01-12;753;7;2630;27;0.2;0.0
93;2021-01-13;752;7;3382;34;0.2;0.0
93;2021-01-14;690;18;4072;52;0.2;0.0
93;2021-01-15;515;4;4587;56;0.3;0.0
93;2021-01-16;138;3;4725;59;0.3;0.0
93;2021-01-17;6;1;4731;60;0.3;0.0
93;2021-01-18;1197;13;5928;73;0.4;0.0
93;2021-01-19;1614;20;7542;93;0.5;0.0
93;2021-01-20;1557;20;9099;113;0.5;0.0
93;2021-01-21;1922;38;11021;151;0.7;0.0
93;2021-01-22;1391;18;12412;169;0.7;0.0
93;2021-01-23;713;8;13125;177;0.8;0.0
93;2021-01-24;0;0;13125;177;0.8;0.0
93;2021-01-25;1209;14;14334;191;0.9;0.0
93;2021-01-26;1297;35;15631;226;0.9;0.0
93;2021-01-27;2158;76;17789;302;1.1;0.0
93;2021-01-28;2268;213;20057;515;1.2;0.0
93;2021-01-29;1625;233;21682;748;1.3;0.0
93;2021-01-30;928;48;22610;796;1.4;0.0
93;2021-01-31;10;8;22620;804;1.4;0.0
93;2021-02-01;1186;175;23806;979;1.4;0.1
93;2021-02-02;1175;306;24981;1285;1.5;0.1
93;2021-02-03;1231;398;26212;1683;1.6;0.1
93;2021-02-04;926;566;27138;2249;1.6;0.1
93;2021-02-05;800;433;27938;2682;1.7;0.2
93;2021-02-06;694;73;28632;2755;1.7;0.2
93;2021-02-07;6;0;28638;2755;1.7;0.2
93;2021-02-08;915;645;29553;3400;1.8;0.2
93;2021-02-09;853;603;30406;4003;1.8;0.2
93;2021-02-10;883;677;31289;4680;1.9;0.3
93;2021-02-11;1244;839;32533;5519;1.9;0.3
93;2021-02-12;1041;641;33574;6160;2.0;0.4
93;2021-02-13;395;267;33969;6427;2.0;0.4
93;2021-02-14;13;59;33982;6486;2.0;0.4
93;2021-02-15;414;1261;34396;7747;2.1;0.5
93;2021-02-16;552;1232;34948;8979;2.1;0.5
93;2021-02-17;541;1751;35489;10730;2.1;0.6
93;2021-02-18;1136;1869;36625;12599;2.2;0.8
93;2021-02-19;994;1542;37619;14141;2.3;0.8
93;2021-02-20;305;664;37924;14805;2.3;0.9
93;2021-02-21;10;24;37934;14829;2.3;0.9
93;2021-02-22;602;1288;38536;16117;2.3;1.0
93;2021-02-23;560;1122;39096;17239;2.3;1.0
93;2021-02-24;646;1218;39742;18457;2.4;1.1
93;2021-02-25;901;1075;40643;19532;2.4;1.2
93;2021-02-26;1120;980;41763;20512;2.5;1.2
93;2021-02-27;543;623;42306;21135;2.5;1.3
93;2021-02-28;88;57;42394;21192;2.5;1.3
93;2021-03-01;1083;1073;43477;22265;2.6;1.3
93;2021-03-02;1448;1152;44925;23417;2.7;1.4
93;2021-03-03;1749;1198;46674;24615;2.8;1.5
93;2021-03-04;2719;1146;49393;25761;3.0;1.5
93;2021-03-05;3820;919;53213;26680;3.2;1.6
93;2021-03-06;5051;593;58264;27273;3.5;1.6
93;2021-03-07;4300;254;62564;27527;3.7;1.6
93;2021-03-08;2037;1277;64601;28804;3.9;1.7
93;2021-03-09;2916;984;67517;29788;4.0;1.8
93;2021-03-10;2862;1130;70379;30918;4.2;1.9
93;2021-03-11;3574;1284;73953;32202;4.4;1.9
93;2021-03-12;4124;1321;78077;33523;4.7;2.0
93;2021-03-13;4291;654;82368;34177;4.9;2.0
93;2021-03-14;884;80;83252;34257;5.0;2.1
93;2021-03-15;3556;703;86808;34960;5.2;2.1
93;2021-03-16;3157;627;89965;35587;5.4;2.1
93;2021-03-17;2656;608;92621;36195;5.5;2.2
93;2021-03-18;3319;739;95940;36934;5.7;2.2
93;2021-03-19;3770;668;99710;37602;6.0;2.3
93;2021-03-20;3460;309;103170;37911;6.2;2.3
93;2021-03-21;814;273;103984;38184;6.2;2.3
93;2021-03-22;3852;636;107836;38820;6.5;2.3
93;2021-03-23;4766;825;112602;39645;6.7;2.4
93;2021-03-24;4114;702;116716;40347;7.0;2.4
93;2021-03-25;5587;882;122303;41229;7.3;2.5
93;2021-03-26;5547;913;127850;42142;7.7;2.5
93;2021-03-27;4282;328;132132;42470;7.9;2.5
93;2021-03-28;613;44;132745;42514;7.9;2.5
93;2021-03-29;3851;978;136596;43492;8.2;2.6
93;2021-03-30;4727;1283;141323;44775;8.5;2.7
93;2021-03-31;3914;1266;145237;46041;8.7;2.8
93;2021-04-01;4055;3159;149292;49200;8.9;2.9
93;2021-04-02;3224;3572;152516;52772;9.1;3.2
93;2021-04-03;2517;2272;155033;55044;9.3;3.3
93;2021-04-04;765;166;155798;55210;9.3;3.3
93;2021-04-05;708;92;156506;55302;9.4;3.3
93;2021-04-06;4564;2370;161070;57672;9.6;3.5
93;2021-04-07;4905;2112;165975;59784;9.9;3.6
93;2021-04-08;5816;2704;171791;62488;10.3;3.7
93;2021-04-09;6097;3212;177888;65700;10.7;3.9
93;2021-04-10;4201;2500;182089;68200;10.9;4.1
93;2021-04-11;575;437;182664;68637;10.9;4.1
93;2021-04-12;4100;2929;186764;71566;11.2;4.3
93;2021-04-13;4607;3674;191371;75240;11.5;4.5
93;2021-04-14;4367;2493;195738;77733;11.7;4.7
93;2021-04-15;4560;3051;200298;80784;12.0;4.8
93;2021-04-16;4442;3008;204740;83792;12.3;5.0
93;2021-04-17;3517;2508;208257;86300;12.5;5.2
93;2021-04-18;289;434;208546;86734;12.5;5.2
93;2021-04-19;3775;2879;212321;89613;12.7;5.4
93;2021-04-20;4308;3284;216629;92897;13.0;5.6
93;2021-04-21;4145;2787;220774;95684;13.2;5.7
93;2021-04-22;4513;4033;225287;99717;13.5;6.0
93;2021-04-23;5628;3265;230915;102982;13.8;6.2
93;2021-04-24;5921;3339;236836;106321;14.2;6.4
93;2021-04-25;1733;599;238569;106920;14.3;6.4
93;2021-04-26;4864;3100;243433;110020;14.6;6.6
93;2021-04-27;6454;3638;249887;113658;15.0;6.8
93;2021-04-28;6071;3444;255958;117102;15.3;7.0
93;2021-04-29;7299;3258;263257;120360;15.8;7.2
93;2021-04-30;8268;3137;271525;123497;16.3;7.4
93;2021-05-01;4948;1199;276473;124696;16.6;7.5
93;2021-05-02;419;649;276892;125345;16.6;7.5
93;2021-05-03;8175;5134;285067;130479;17.1;7.8
93;2021-05-04;7824;5412;292891;135891;17.5;8.1
93;2021-05-05;7577;4818;300468;140709;18.0;8.4
93;2021-05-06;8252;4791;308720;145500;18.5;8.7
93;2021-05-07;7016;5438;315736;150938;18.9;9.0
93;2021-05-08;8363;2399;324099;153337;19.4;9.2
93;2021-05-09;6124;1372;330223;154709;19.8;9.3
93;2021-05-10;8259;4084;338482;158793;20.3;9.5
93;2021-05-11;9309;4815;347791;163608;20.8;9.8
93;2021-05-12;9194;3660;356985;167268;21.4;10.0
93;2021-05-13;8302;1654;365287;168922;21.9;10.1
93;2021-05-14;10421;3533;375708;172455;22.5;10.3
93;2021-05-15;11126;3011;386834;175466;23.2;10.5
93;2021-05-16;5558;728;392392;176194;23.5;10.5
93;2021-05-17;11903;2269;404295;178463;24.2;10.7
93;2021-05-18;14099;2387;418394;180850;25.1;10.8
93;2021-05-19;11433;2945;429827;183795;25.7;11.0
93;2021-05-20;12623;3486;442450;187281;26.5;11.2
93;2021-05-21;13014;2887;455464;190168;27.3;11.4
93;2021-05-22;12376;2202;467840;192370;28.0;11.5
93;2021-05-23;8478;1109;476318;193479;28.5;11.6
93;2021-05-24;11210;1945;487528;195424;29.2;11.7
93;2021-05-25;12292;4322;499820;199746;29.9;12.0
93;2021-05-26;11079;3759;510899;203505;30.6;12.2
93;2021-05-27;12708;3897;523607;207402;31.4;12.4
93;2021-05-28;12653;5260;536260;212662;32.1;12.7
93;2021-05-29;11395;4269;547655;216931;32.8;13.0
93;2021-05-30;8209;1380;555864;218311;33.3;13.1
93;2021-05-31;9180;5177;565044;223488;33.8;13.4
93;2021-06-01;11410;6280;576454;229768;34.5;13.8
93;2021-06-02;10721;5198;587175;234966;35.2;14.1
93;2021-06-03;10821;5519;597996;240485;35.8;14.4
93;2021-06-04;10599;7799;608595;248284;36.4;14.9
93;2021-06-05;9022;7361;617617;255645;37.0;15.3
93;2021-06-06;8404;1746;626021;257391;37.5;15.4
93;2021-06-07;10072;7516;636093;264907;38.1;15.9
93;2021-06-08;10367;7379;646460;272286;38.7;16.3
93;2021-06-09;10243;7296;656703;279582;39.3;16.7
93;2021-06-10;9010;8198;665713;287780;39.9;17.2
93;2021-06-11;8823;8821;674536;296601;40.4;17.8
93;2021-06-12;9862;6663;684398;303264;41.0;18.2
93;2021-06-13;7169;2132;691567;305396;41.4;18.3
93;2021-06-14;5401;9735;696968;315131;41.7;18.9
93;2021-06-15;6243;9664;703211;324795;42.1;19.4
93;2021-06-16;6650;9061;709861;333856;42.5;20.0
93;2021-06-17;5758;8474;715619;342330;42.8;20.5
93;2021-06-18;7226;11123;722845;353453;43.3;21.2
93;2021-06-19;7076;11102;729921;364555;43.7;21.8
93;2021-06-20;4945;6878;734866;371433;44.0;22.2
93;2021-06-21;4072;10729;738938;382162;44.2;22.9
93;2021-06-22;4695;11314;743633;393476;44.5;23.6
93;2021-06-23;4539;10598;748172;404074;44.8;24.2
93;2021-06-24;4200;10297;752372;414371;45.0;24.8
93;2021-06-25;5187;13052;757559;427423;45.4;25.6
93;2021-06-26;5300;13927;762859;441350;45.7;26.4
93;2021-06-27;3285;7104;766144;448454;45.9;26.9
93;2021-06-28;3703;12508;769847;460962;46.1;27.6
93;2021-06-29;4016;12355;773863;473317;46.3;28.3
93;2021-06-30;4146;11304;778009;484621;46.6;29.0
93;2021-07-01;6084;11162;784093;495783;46.9;29.7
93;2021-07-02;5810;12382;789903;508165;47.3;30.4
93;2021-07-03;5551;13464;795454;521629;47.6;31.2
93;2021-07-04;3078;7886;798532;529515;47.8;31.7
93;2021-07-05;4595;10848;803127;540363;48.1;32.4
93;2021-07-06;4866;11761;807993;552124;48.4;33.1
93;2021-07-07;5236;11417;813229;563541;48.7;33.7
93;2021-07-08;5068;10273;818297;573814;49.0;34.4
93;2021-07-09;5927;13037;824224;586851;49.4;35.1
93;2021-07-10;5920;14293;830144;601144;49.7;36.0
93;2021-07-11;3688;9093;833832;610237;49.9;36.5
93;2021-07-12;5607;12080;839439;622317;50.3;37.3
93;2021-07-13;11148;13313;850587;635630;50.9;38.1
93;2021-07-14;10676;6803;861263;642433;51.6;38.5
93;2021-07-15;12559;14142;873822;656575;52.3;39.3
93;2021-07-16;13244;13697;887066;670272;53.1;40.1
93;2021-07-17;11420;13919;898486;684191;53.8;41.0
93;2021-07-18;7401;8960;905887;693151;54.2;41.5
93;2021-07-19;9639;10931;915526;704082;54.8;42.2
93;2021-07-20;12670;10694;928196;714776;55.6;42.8
93;2021-07-21;14410;10958;942606;725734;56.4;43.5
93;2021-07-22;14181;9484;956787;735218;57.3;44.0
93;2021-07-23;14624;10665;971411;745883;58.2;44.7
93;2021-07-24;13925;10655;985336;756538;59.0;45.3
93;2021-07-25;9037;6364;994373;762902;59.5;45.7
93;2021-07-26;12796;7801;1007169;770703;60.3;46.1
93;2021-07-27;15186;7468;1022355;778171;61.2;46.6
93;2021-07-28;15034;8311;1037389;786482;62.1;47.1
93;2021-07-29;13605;7082;1050994;793564;62.9;47.5
93;2021-07-30;14191;7879;1065185;801443;63.8;48.0
93;2021-07-31;12254;7723;1077439;809166;64.5;48.4
93;2021-08-01;7778;4613;1085217;813779;65.0;48.7
93;2021-08-02;13485;5789;1098702;819568;65.8;49.1
93;2021-08-03;8434;6871;1107136;826439;66.3;49.5
93;2021-08-04;8178;8010;1115314;834449;66.8;50.0
93;2021-08-05;6300;6865;1121614;841314;67.2;50.4
93;2021-08-06;7380;8340;1128994;849654;67.6;50.9
93;2021-08-07;7480;9058;1136474;858712;68.0;51.4
93;2021-08-08;4679;5561;1141153;864273;68.3;51.7
93;2021-08-09;7632;8090;1148785;872363;68.8;52.2
93;2021-08-10;7497;8855;1156282;881218;69.2;52.8
93;2021-08-11;7695;9696;1163977;890914;69.7;53.3
93;2021-08-12;6733;9045;1170710;899959;70.1;53.9
93;2021-08-13;6847;9032;1177557;908991;70.5;54.4
93;2021-08-14;7394;10508;1184951;919499;70.9;55.1
93;2021-08-15;3015;3626;1187966;923125;71.1;55.3
93;2021-08-16;6589;11222;1194555;934347;71.5;55.9
93;2021-08-17;6390;10919;1200945;945266;71.9;56.6
93;2021-08-18;5732;11214;1206677;956480;72.2;57.3
93;2021-08-19;5035;9674;1211712;966154;72.6;57.8
93;2021-08-20;5345;11234;1217057;977388;72.9;58.5
93;2021-08-21;4558;11947;1221615;989335;73.1;59.2
93;2021-08-22;2264;7050;1223879;996385;73.3;59.7
93;2021-08-23;4596;9336;1228475;1005721;73.6;60.2
93;2021-08-24;4549;8437;1233024;1014158;73.8;60.7
93;2021-08-25;4317;8610;1237341;1022768;74.1;61.2
93;2021-08-26;3785;7109;1241126;1029877;74.3;61.7
93;2021-08-27;4137;8550;1245263;1038427;74.6;62.2
93;2021-08-28;3993;9593;1249256;1048020;74.8;62.8
93;2021-08-29;1822;4807;1251078;1052827;74.9;63.0
93;2021-08-30;3231;7542;1254309;1060369;75.1;63.5
93;2021-08-31;3126;7660;1257435;1068029;75.3;63.9
93;2021-09-01;5380;7510;1262815;1075539;75.6;64.4
93;2021-09-02;4110;5787;1266925;1081326;75.9;64.7
93;2021-09-03;3017;7046;1269942;1088372;76.0;65.2
93;2021-09-04;3474;8775;1273416;1097147;76.2;65.7
93;2021-09-05;1305;3623;1274721;1100770;76.3;65.9
93;2021-09-06;2060;5084;1276781;1105854;76.4;66.2
93;2021-09-07;1905;4638;1278686;1110492;76.6;66.5
93;2021-09-08;2351;5346;1281037;1115838;76.7;66.8
93;2021-09-09;2066;4609;1283103;1120447;76.8;67.1
93;2021-09-10;3006;5448;1286109;1125895;77.0;67.4
93;2021-09-11;2439;6868;1288548;1132763;77.2;67.8
93;2021-09-12;880;2821;1289428;1135584;77.2;68.0
93;2021-09-13;2208;4542;1291636;1140126;77.3;68.3
93;2021-09-14;1957;4055;1293593;1144181;77.5;68.5
93;2021-09-15;1966;4286;1295559;1148467;77.6;68.8
93;2021-09-16;1634;3048;1297193;1151515;77.7;68.9
93;2021-09-17;2013;4562;1299206;1156077;77.8;69.2
93;2021-09-18;1665;5570;1300871;1161647;77.9;69.6
93;2021-09-19;539;2105;1301410;1163752;77.9;69.7
93;2021-09-20;1367;2931;1302777;1166683;78.0;69.9
93;2021-09-21;1042;2494;1303819;1169177;78.1;70.0
93;2021-09-22;1546;3935;1305365;1173112;78.2;70.2
93;2021-09-23;1058;2435;1306423;1175547;78.2;70.4
93;2021-09-24;1356;3438;1307779;1178985;78.3;70.6
93;2021-09-25;1116;4528;1308895;1183513;78.4;70.9
93;2021-09-26;433;1679;1309328;1185192;78.4;71.0
93;2021-09-27;896;2227;1310224;1187419;78.4;71.1
93;2021-09-28;871;2032;1311095;1189451;78.5;71.2
93;2021-09-29;1232;3258;1312327;1192709;78.6;71.4
93;2021-09-30;904;2364;1313231;1195073;78.6;71.6
93;2021-10-01;1142;2751;1314373;1197824;78.7;71.7
93;2021-10-02;1157;2789;1315530;1200613;78.8;71.9
93;2021-10-03;302;832;1315832;1201445;78.8;71.9
93;2021-10-04;890;2208;1316722;1203653;78.8;72.1
93;2021-10-05;772;2062;1317494;1205715;78.9;72.2
93;2021-10-06;1060;2350;1318554;1208065;78.9;72.3
93;2021-10-07;893;2381;1319447;1210446;79.0;72.5
93;2021-10-08;1067;2582;1320514;1213028;79.1;72.6
93;2021-10-09;1316;2796;1321830;1215824;79.1;72.8
93;2021-10-10;313;988;1322143;1216812;79.2;72.9
93;2021-10-11;714;1982;1322857;1218794;79.2;73.0
93;2021-10-12;681;1992;1323538;1220786;79.2;73.1
93;2021-10-13;1047;2342;1324585;1223128;79.3;73.2
93;2021-10-14;796;2256;1325381;1225384;79.4;73.4
94;2020-12-27;8;0;8;0;0.0;0.0
94;2020-12-28;11;1;19;1;0.0;0.0
94;2020-12-29;0;0;19;1;0.0;0.0
94;2020-12-30;1;0;20;1;0.0;0.0
94;2020-12-31;7;2;27;3;0.0;0.0
94;2021-01-01;5;0;32;3;0.0;0.0
94;2021-01-02;0;0;32;3;0.0;0.0
94;2021-01-03;3;1;35;4;0.0;0.0
94;2021-01-04;39;2;74;6;0.0;0.0
94;2021-01-05;233;2;307;8;0.0;0.0
94;2021-01-06;333;5;640;13;0.0;0.0
94;2021-01-07;694;11;1334;24;0.1;0.0
94;2021-01-08;925;11;2259;35;0.2;0.0
94;2021-01-09;47;0;2306;35;0.2;0.0
94;2021-01-10;18;0;2324;35;0.2;0.0
94;2021-01-11;1015;13;3339;48;0.2;0.0
94;2021-01-12;1343;26;4682;74;0.3;0.0
94;2021-01-13;1408;26;6090;100;0.4;0.0
94;2021-01-14;1544;31;7634;131;0.5;0.0
94;2021-01-15;1222;25;8856;156;0.6;0.0
94;2021-01-16;197;1;9053;157;0.6;0.0
94;2021-01-17;100;2;9153;159;0.7;0.0
94;2021-01-18;1501;29;10654;188;0.8;0.0
94;2021-01-19;1952;30;12606;218;0.9;0.0
94;2021-01-20;2190;28;14796;246;1.1;0.0
94;2021-01-21;3032;23;17828;269;1.3;0.0
94;2021-01-22;2193;30;20021;299;1.4;0.0
94;2021-01-23;735;4;20756;303;1.5;0.0
94;2021-01-24;286;0;21042;303;1.5;0.0
94;2021-01-25;1474;27;22516;330;1.6;0.0
94;2021-01-26;1581;29;24097;359;1.7;0.0
94;2021-01-27;1848;56;25945;415;1.8;0.0
94;2021-01-28;1559;141;27504;556;2.0;0.0
94;2021-01-29;1380;150;28884;706;2.1;0.1
94;2021-01-30;581;4;29465;710;2.1;0.1
94;2021-01-31;123;9;29588;719;2.1;0.1
94;2021-02-01;931;153;30519;872;2.2;0.1
94;2021-02-02;854;253;31373;1125;2.2;0.1
94;2021-02-03;763;368;32136;1493;2.3;0.1
94;2021-02-04;901;430;33037;1923;2.3;0.1
94;2021-02-05;875;574;33912;2497;2.4;0.2
94;2021-02-06;409;75;34321;2572;2.4;0.2
94;2021-02-07;123;1;34444;2573;2.4;0.2
94;2021-02-08;637;550;35081;3123;2.5;0.2
94;2021-02-09;1036;986;36117;4109;2.6;0.3
94;2021-02-10;1104;1364;37221;5473;2.6;0.4
94;2021-02-11;1430;1558;38651;7031;2.7;0.5
94;2021-02-12;1395;1657;40046;8688;2.8;0.6
94;2021-02-13;300;262;40346;8950;2.9;0.6
94;2021-02-14;30;72;40376;9022;2.9;0.6
94;2021-02-15;755;1768;41131;10790;2.9;0.8
94;2021-02-16;703;2745;41834;13535;3.0;1.0
94;2021-02-17;719;1593;42553;15128;3.0;1.1
94;2021-02-18;798;1704;43351;16832;3.1;1.2
94;2021-02-19;968;1463;44319;18295;3.2;1.3
94;2021-02-20;133;922;44452;19217;3.2;1.4
94;2021-02-21;21;184;44473;19401;3.2;1.4
94;2021-02-22;525;1350;44998;20751;3.2;1.5
94;2021-02-23;625;1278;45623;22029;3.2;1.6
94;2021-02-24;694;928;46317;22957;3.3;1.6
94;2021-02-25;1073;1568;47390;24525;3.4;1.7
94;2021-02-26;1322;1077;48712;25602;3.5;1.8
94;2021-02-27;518;557;49230;26159;3.5;1.9
94;2021-02-28;91;84;49321;26243;3.5;1.9
94;2021-03-01;887;950;50208;27193;3.6;1.9
94;2021-03-02;1568;1006;51776;28199;3.7;2.0
94;2021-03-03;1952;1029;53728;29228;3.8;2.1
94;2021-03-04;2859;1210;56587;30438;4.0;2.2
94;2021-03-05;3839;1374;60426;31812;4.3;2.3
94;2021-03-06;4823;607;65249;32419;4.6;2.3
94;2021-03-07;3689;583;68938;33002;4.9;2.3
94;2021-03-08;1919;821;70857;33823;5.0;2.4
94;2021-03-09;2561;954;73418;34777;5.2;2.5
94;2021-03-10;3201;1066;76619;35843;5.4;2.5
94;2021-03-11;3840;968;80459;36811;5.7;2.6
94;2021-03-12;4587;849;85046;37660;6.0;2.7
94;2021-03-13;4135;415;89181;38075;6.3;2.7
94;2021-03-14;2115;163;91296;38238;6.5;2.7
94;2021-03-15;3172;810;94468;39048;6.7;2.8
94;2021-03-16;2776;458;97244;39506;6.9;2.8
94;2021-03-17;2863;477;100107;39983;7.1;2.8
94;2021-03-18;3267;457;103374;40440;7.4;2.9
94;2021-03-19;4273;737;107647;41177;7.7;2.9
94;2021-03-20;3692;306;111339;41483;7.9;3.0
94;2021-03-21;1465;397;112804;41880;8.0;3.0
94;2021-03-22;3222;687;116026;42567;8.3;3.0
94;2021-03-23;4515;756;120541;43323;8.6;3.1
94;2021-03-24;4629;649;125170;43972;8.9;3.1
94;2021-03-25;6320;710;131490;44682;9.4;3.2
94;2021-03-26;6090;858;137580;45540;9.8;3.2
94;2021-03-27;4471;287;142051;45827;10.1;3.3
94;2021-03-28;1891;119;143942;45946;10.2;3.3
94;2021-03-29;4128;1253;148070;47199;10.5;3.4
94;2021-03-30;5298;1371;153368;48570;10.9;3.5
94;2021-03-31;4914;1844;158282;50414;11.3;3.6
94;2021-04-01;5834;2344;164116;52758;11.7;3.8
94;2021-04-02;5246;2344;169362;55102;12.0;3.9
94;2021-04-03;3087;2540;172449;57642;12.3;4.1
94;2021-04-04;1051;781;173500;58423;12.3;4.2
94;2021-04-05;837;163;174337;58586;12.4;4.2
94;2021-04-06;3582;2616;177919;61202;12.7;4.4
94;2021-04-07;3865;2284;181784;63486;12.9;4.5
94;2021-04-08;4630;2089;186414;65575;13.3;4.7
94;2021-04-09;5368;2503;191782;68078;13.6;4.8
94;2021-04-10;2955;3014;194737;71092;13.9;5.1
94;2021-04-11;1267;1771;196004;72863;13.9;5.2
94;2021-04-12;3441;2302;199445;75165;14.2;5.3
94;2021-04-13;4314;3439;203759;78604;14.5;5.6
94;2021-04-14;3904;2713;207663;81317;14.8;5.8
94;2021-04-15;4453;3014;212116;84331;15.1;6.0
94;2021-04-16;4710;2861;216826;87192;15.4;6.2
94;2021-04-17;2463;2778;219289;89970;15.6;6.4
94;2021-04-18;919;1249;220208;91219;15.7;6.5
94;2021-04-19;2977;2457;223185;93676;15.9;6.7
94;2021-04-20;3275;2723;226460;96399;16.1;6.9
94;2021-04-21;3221;3179;229681;99578;16.3;7.1
94;2021-04-22;3912;3658;233593;103236;16.6;7.3
94;2021-04-23;4121;4012;237714;107248;16.9;7.6
94;2021-04-24;4265;3416;241979;110664;17.2;7.9
94;2021-04-25;2408;1517;244387;112181;17.4;8.0
94;2021-04-26;4011;3291;248398;115472;17.7;8.2
94;2021-04-27;5098;3396;253496;118868;18.0;8.5
94;2021-04-28;4832;3655;258328;122523;18.4;8.7
94;2021-04-29;6414;3832;264742;126355;18.8;9.0
94;2021-04-30;6487;3965;271229;130320;19.3;9.3
94;2021-05-01;4057;1069;275286;131389;19.6;9.3
94;2021-05-02;3049;1478;278335;132867;19.8;9.4
94;2021-05-03;5734;5346;284069;138213;20.2;9.8
94;2021-05-04;6098;3587;290167;141800;20.6;10.1
94;2021-05-05;6183;3437;296350;145237;21.1;10.3
94;2021-05-06;7163;3544;303513;148781;21.6;10.6
94;2021-05-07;6673;4130;310186;152911;22.1;10.9
94;2021-05-08;4907;2563;315093;155474;22.4;11.1
94;2021-05-09;4226;2257;319319;157731;22.7;11.2
94;2021-05-10;7713;3135;327032;160866;23.3;11.4
94;2021-05-11;8971;3944;336003;164810;23.9;11.7
94;2021-05-12;9575;3612;345578;168422;24.6;12.0
94;2021-05-13;8675;1368;354253;169790;25.2;12.1
94;2021-05-14;9867;3315;364120;173105;25.9;12.3
94;2021-05-15;8941;2163;373061;175268;26.5;12.5
94;2021-05-16;5068;912;378129;176180;26.9;12.5
94;2021-05-17;10835;2257;388964;178437;27.7;12.7
94;2021-05-18;11297;2453;400261;180890;28.5;12.9
94;2021-05-19;11675;3601;411936;184491;29.3;13.1
94;2021-05-20;12156;4363;424092;188854;30.2;13.4
94;2021-05-21;11874;3166;435966;192020;31.0;13.7
94;2021-05-22;10283;1972;446249;193992;31.7;13.8
94;2021-05-23;4998;712;451247;194704;32.1;13.8
94;2021-05-24;9669;1349;460916;196053;32.8;13.9
94;2021-05-25;10002;4274;470918;200327;33.5;14.2
94;2021-05-26;10294;3313;481212;203640;34.2;14.5
94;2021-05-27;10864;4590;492076;208230;35.0;14.8
94;2021-05-28;10441;4952;502517;213182;35.7;15.2
94;2021-05-29;9868;3459;512385;216641;36.4;15.4
94;2021-05-30;4785;931;517170;217572;36.8;15.5
94;2021-05-31;9989;4240;527159;221812;37.5;15.8
94;2021-06-01;10307;5101;537466;226913;38.2;16.1
94;2021-06-02;9355;4588;546821;231501;38.9;16.5
94;2021-06-03;9561;5608;556382;237109;39.6;16.9
94;2021-06-04;10404;6539;566786;243648;40.3;17.3
94;2021-06-05;9182;6250;575968;249898;41.0;17.8
94;2021-06-06;3984;1849;579952;251747;41.2;17.9
94;2021-06-07;8664;5977;588616;257724;41.9;18.3
94;2021-06-08;9000;7521;597616;265245;42.5;18.9
94;2021-06-09;8954;8166;606570;273411;43.1;19.4
94;2021-06-10;8802;10973;615372;284384;43.8;20.2
94;2021-06-11;7850;8399;623222;292783;44.3;20.8
94;2021-06-12;10259;6855;633481;299638;45.1;21.3
94;2021-06-13;3469;3263;636950;302901;45.3;21.5
94;2021-06-14;6959;8204;643909;311105;45.8;22.1
94;2021-06-15;7736;8822;651645;319927;46.3;22.8
94;2021-06-16;7246;8271;658891;328198;46.9;23.3
94;2021-06-17;6698;9067;665589;337265;47.3;24.0
94;2021-06-18;6575;11959;672164;349224;47.8;24.8
94;2021-06-19;6002;9587;678166;358811;48.2;25.5
94;2021-06-20;1887;4008;680053;362819;48.4;25.8
94;2021-06-21;4529;11190;684582;374009;48.7;26.6
94;2021-06-22;4843;10811;689425;384820;49.0;27.4
94;2021-06-23;4179;11151;693604;395971;49.3;28.2
94;2021-06-24;4970;10337;698574;406308;49.7;28.9
94;2021-06-25;4285;13734;702859;420042;50.0;29.9
94;2021-06-26;3139;12007;705998;432049;50.2;30.7
94;2021-06-27;1059;4998;707057;437047;50.3;31.1
94;2021-06-28;3494;12076;710551;449123;50.5;31.9
94;2021-06-29;4054;12175;714605;461298;50.8;32.8
94;2021-06-30;4364;11649;718969;472947;51.1;33.6
94;2021-07-01;5673;11118;724642;484065;51.5;34.4
94;2021-07-02;5327;12196;729969;496261;51.9;35.3
94;2021-07-03;3711;11799;733680;508060;52.2;36.1
94;2021-07-04;1518;5092;735198;513152;52.3;36.5
94;2021-07-05;4496;11430;739694;524582;52.6;37.3
94;2021-07-06;4626;10893;744320;535475;52.9;38.1
94;2021-07-07;5046;11083;749366;546558;53.3;38.9
94;2021-07-08;5112;10032;754478;556590;53.7;39.6
94;2021-07-09;6110;11876;760588;568466;54.1;40.4
94;2021-07-10;4122;11358;764710;579824;54.4;41.2
94;2021-07-11;1555;4719;766265;584543;54.5;41.6
94;2021-07-12;4337;11966;770602;596509;54.8;42.4
94;2021-07-13;6490;12051;777092;608560;55.3;43.3
94;2021-07-14;4293;5297;781385;613857;55.6;43.7
94;2021-07-15;7321;12370;788706;626227;56.1;44.5
94;2021-07-16;7852;11327;796558;637554;56.7;45.3
94;2021-07-17;6106;11327;802664;648881;57.1;46.1
94;2021-07-18;2628;4024;805292;652905;57.3;46.4
94;2021-07-19;6915;10448;812207;663353;57.8;47.2
94;2021-07-20;8572;10386;820779;673739;58.4;47.9
94;2021-07-21;8803;9588;829582;683327;59.0;48.6
94;2021-07-22;9796;9432;839378;692759;59.7;49.3
94;2021-07-23;9434;9415;848812;702174;60.4;49.9
94;2021-07-24;7216;8885;856028;711059;60.9;50.6
94;2021-07-25;2191;2743;858219;713802;61.0;50.8
94;2021-07-26;7971;8046;866190;721848;61.6;51.3
94;2021-07-27;8621;7007;874811;728855;62.2;51.8
94;2021-07-28;8812;6325;883623;735180;62.8;52.3
94;2021-07-29;9060;6377;892683;741557;63.5;52.7
94;2021-07-30;8207;6599;900890;748156;64.1;53.2
94;2021-07-31;7214;6312;908104;754468;64.6;53.7
94;2021-08-01;3203;1783;911307;756251;64.8;53.8
94;2021-08-02;6677;5471;917984;761722;65.3;54.2
94;2021-08-03;6381;5212;924365;766934;65.7;54.5
94;2021-08-04;6332;5132;930697;772066;66.2;54.9
94;2021-08-05;5880;5473;936577;777539;66.6;55.3
94;2021-08-06;5815;5848;942392;783387;67.0;55.7
94;2021-08-07;4255;4483;946647;787870;67.3;56.0
94;2021-08-08;1371;1718;948018;789588;67.4;56.2
94;2021-08-09;4901;6532;952919;796120;67.8;56.6
94;2021-08-10;5411;6311;958330;802431;68.2;57.1
94;2021-08-11;4314;5727;962644;808158;68.5;57.5
94;2021-08-12;4448;6506;967092;814664;68.8;57.9
94;2021-08-13;3801;5756;970893;820420;69.1;58.3
94;2021-08-14;2906;5736;973799;826156;69.3;58.8
94;2021-08-15;458;736;974257;826892;69.3;58.8
94;2021-08-16;3509;8283;977766;835175;69.5;59.4
94;2021-08-17;3379;8129;981145;843304;69.8;60.0
94;2021-08-18;3282;8614;984427;851918;70.0;60.6
94;2021-08-19;3344;6911;987771;858829;70.3;61.1
94;2021-08-20;3400;7754;991171;866583;70.5;61.6
94;2021-08-21;2569;7151;993740;873734;70.7;62.1
94;2021-08-22;897;2737;994637;876471;70.7;62.3
94;2021-08-23;2849;8451;997486;884922;70.9;62.9
94;2021-08-24;3151;7516;1000637;892438;71.2;63.5
94;2021-08-25;2747;6747;1003384;899185;71.4;64.0
94;2021-08-26;2597;6146;1005981;905331;71.5;64.4
94;2021-08-27;2653;6572;1008634;911903;71.7;64.9
94;2021-08-28;2578;6494;1011212;918397;71.9;65.3
94;2021-08-29;868;2348;1012080;920745;72.0;65.5
94;2021-08-30;2839;7731;1014919;928476;72.2;66.0
94;2021-08-31;2606;7202;1017525;935678;72.4;66.5
94;2021-09-01;2522;5670;1020047;941348;72.5;67.0
94;2021-09-02;1986;4634;1022033;945982;72.7;67.3
94;2021-09-03;2106;5180;1024139;951162;72.8;67.6
94;2021-09-04;2399;5143;1026538;956305;73.0;68.0
94;2021-09-05;707;1130;1027245;957435;73.1;68.1
94;2021-09-06;1583;3446;1028828;960881;73.2;68.3
94;2021-09-07;1517;3183;1030345;964064;73.3;68.6
94;2021-09-08;1572;3294;1031917;967358;73.4;68.8
94;2021-09-09;1280;2861;1033197;970219;73.5;69.0
94;2021-09-10;1646;3410;1034843;973629;73.6;69.2
94;2021-09-11;1921;4247;1036764;977876;73.7;69.5
94;2021-09-12;421;1105;1037185;978981;73.8;69.6
94;2021-09-13;1055;2274;1038240;981255;73.8;69.8
94;2021-09-14;1336;2602;1039576;983857;73.9;70.0
94;2021-09-15;1313;3112;1040889;986969;74.0;70.2
94;2021-09-16;1040;2181;1041929;989150;74.1;70.4
94;2021-09-17;1177;2691;1043106;991841;74.2;70.5
94;2021-09-18;1111;3693;1044217;995534;74.3;70.8
94;2021-09-19;296;1039;1044513;996573;74.3;70.9
94;2021-09-20;785;1967;1045298;998540;74.3;71.0
94;2021-09-21;1004;1788;1046302;1000328;74.4;71.1
94;2021-09-22;954;2368;1047256;1002696;74.5;71.3
94;2021-09-23;780;1701;1048036;1004397;74.5;71.4
94;2021-09-24;997;1979;1049033;1006376;74.6;71.6
94;2021-09-25;965;3064;1049998;1009440;74.7;71.8
94;2021-09-26;270;700;1050268;1010140;74.7;71.8
94;2021-09-27;681;1471;1050949;1011611;74.7;71.9
94;2021-09-28;662;1425;1051611;1013036;74.8;72.0
94;2021-09-29;851;1591;1052462;1014627;74.9;72.2
94;2021-09-30;996;1264;1053458;1015891;74.9;72.3
94;2021-10-01;1079;1802;1054537;1017693;75.0;72.4
94;2021-10-02;985;2173;1055522;1019866;75.1;72.5
94;2021-10-03;249;609;1055771;1020475;75.1;72.6
94;2021-10-04;589;1098;1056360;1021573;75.1;72.7
94;2021-10-05;656;1094;1057016;1022667;75.2;72.7
94;2021-10-06;687;1307;1057703;1023974;75.2;72.8
94;2021-10-07;641;1009;1058344;1024983;75.3;72.9
94;2021-10-08;914;1395;1059258;1026378;75.3;73.0
94;2021-10-09;812;1599;1060070;1027977;75.4;73.1
94;2021-10-10;241;411;1060311;1028388;75.4;73.1
94;2021-10-11;516;855;1060827;1029243;75.4;73.2
94;2021-10-12;670;1222;1061497;1030465;75.5;73.3
94;2021-10-13;754;1253;1062251;1031718;75.5;73.4
94;2021-10-14;684;1216;1062935;1032934;75.6;73.5
95;2020-12-27;3;0;3;0;0.0;0.0
95;2020-12-28;6;0;9;0;0.0;0.0
95;2020-12-29;0;0;9;0;0.0;0.0
95;2020-12-30;0;0;9;0;0.0;0.0
95;2020-12-31;2;0;11;0;0.0;0.0
95;2021-01-01;0;0;11;0;0.0;0.0
95;2021-01-02;13;0;24;0;0.0;0.0
95;2021-01-03;1;0;25;0;0.0;0.0
95;2021-01-04;50;0;75;0;0.0;0.0
95;2021-01-05;319;0;394;0;0.0;0.0
95;2021-01-06;191;0;585;0;0.0;0.0
95;2021-01-07;130;1;715;1;0.1;0.0
95;2021-01-08;279;2;994;3;0.1;0.0
95;2021-01-09;251;0;1245;3;0.1;0.0
95;2021-01-10;384;3;1629;6;0.1;0.0
95;2021-01-11;492;3;2121;9;0.2;0.0
95;2021-01-12;864;3;2985;12;0.2;0.0
95;2021-01-13;782;12;3767;24;0.3;0.0
95;2021-01-14;886;13;4653;37;0.4;0.0
95;2021-01-15;758;6;5411;43;0.4;0.0
95;2021-01-16;298;4;5709;47;0.5;0.0
95;2021-01-17;225;2;5934;49;0.5;0.0
95;2021-01-18;1338;7;7272;56;0.6;0.0
95;2021-01-19;1579;9;8851;65;0.7;0.0
95;2021-01-20;2039;6;10890;71;0.9;0.0
95;2021-01-21;1856;7;12746;78;1.0;0.0
95;2021-01-22;1326;7;14072;85;1.1;0.0
95;2021-01-23;648;0;14720;85;1.2;0.0
95;2021-01-24;182;0;14902;85;1.2;0.0
95;2021-01-25;795;37;15697;122;1.3;0.0
95;2021-01-26;989;163;16686;285;1.3;0.0
95;2021-01-27;1251;192;17937;477;1.4;0.0
95;2021-01-28;1721;37;19658;514;1.6;0.0
95;2021-01-29;1251;210;20909;724;1.7;0.1
95;2021-01-30;478;6;21387;730;1.7;0.1
95;2021-01-31;212;2;21599;732;1.7;0.1
95;2021-02-01;566;273;22165;1005;1.8;0.1
95;2021-02-02;528;270;22693;1275;1.8;0.1
95;2021-02-03;614;519;23307;1794;1.9;0.1
95;2021-02-04;1068;369;24375;2163;2.0;0.2
95;2021-02-05;734;306;25109;2469;2.0;0.2
95;2021-02-06;338;255;25447;2724;2.0;0.2
95;2021-02-07;142;407;25589;3131;2.0;0.3
95;2021-02-08;765;342;26354;3473;2.1;0.3
95;2021-02-09;1136;1101;27490;4574;2.2;0.4
95;2021-02-10;1262;1420;28752;5994;2.3;0.5
95;2021-02-11;1387;1149;30139;7143;2.4;0.6
95;2021-02-12;1031;986;31170;8129;2.5;0.7
95;2021-02-13;330;319;31500;8448;2.5;0.7
95;2021-02-14;43;186;31543;8634;2.5;0.7
95;2021-02-15;430;1061;31973;9695;2.6;0.8
95;2021-02-16;493;916;32466;10611;2.6;0.8
95;2021-02-17;654;1134;33120;11745;2.7;0.9
95;2021-02-18;725;1696;33845;13441;2.7;1.1
95;2021-02-19;783;1305;34628;14746;2.8;1.2
95;2021-02-20;306;492;34934;15238;2.8;1.2
95;2021-02-21;165;313;35099;15551;2.8;1.2
95;2021-02-22;327;1022;35426;16573;2.8;1.3
95;2021-02-23;368;727;35794;17300;2.9;1.4
95;2021-02-24;310;880;36104;18180;2.9;1.5
95;2021-02-25;728;1142;36832;19322;3.0;1.5
95;2021-02-26;991;887;37823;20209;3.0;1.6
95;2021-02-27;365;434;38188;20643;3.1;1.7
95;2021-02-28;61;235;38249;20878;3.1;1.7
95;2021-03-01;773;593;39022;21471;3.1;1.7
95;2021-03-02;1322;861;40344;22332;3.2;1.8
95;2021-03-03;1601;989;41945;23321;3.4;1.9
95;2021-03-04;3197;1225;45142;24546;3.6;2.0
95;2021-03-05;3647;1111;48789;25657;3.9;2.1
95;2021-03-06;4005;515;52794;26172;4.2;2.1
95;2021-03-07;4221;344;57015;26516;4.6;2.1
95;2021-03-08;1541;876;58556;27392;4.7;2.2
95;2021-03-09;2622;516;61178;27908;4.9;2.2
95;2021-03-10;2344;863;63522;28771;5.1;2.3
95;2021-03-11;3141;1171;66663;29942;5.3;2.4
95;2021-03-12;3521;821;70184;30763;5.6;2.5
95;2021-03-13;3515;434;73699;31197;5.9;2.5
95;2021-03-14;1981;315;75680;31512;6.1;2.5
95;2021-03-15;2371;330;78051;31842;6.3;2.6
95;2021-03-16;1575;427;79626;32269;6.4;2.6
95;2021-03-17;2103;427;81729;32696;6.5;2.6
95;2021-03-18;2799;384;84528;33080;6.8;2.6
95;2021-03-19;3474;375;88002;33455;7.0;2.7
95;2021-03-20;2593;211;90595;33666;7.3;2.7
95;2021-03-21;1205;258;91800;33924;7.4;2.7
95;2021-03-22;2936;374;94736;34298;7.6;2.7
95;2021-03-23;3440;474;98176;34772;7.9;2.8
95;2021-03-24;3946;534;102122;35306;8.2;2.8
95;2021-03-25;5861;673;107983;35979;8.7;2.9
95;2021-03-26;5429;704;113412;36683;9.1;2.9
95;2021-03-27;3748;231;117160;36914;9.4;3.0
95;2021-03-28;1536;130;118696;37044;9.5;3.0
95;2021-03-29;2894;582;121590;37626;9.7;3.0
95;2021-03-30;3886;1266;125476;38892;10.1;3.1
95;2021-03-31;3658;1693;129134;40585;10.3;3.3
95;2021-04-01;5483;2297;134617;42882;10.8;3.4
95;2021-04-02;3560;2778;138177;45660;11.1;3.7
95;2021-04-03;2096;2496;140273;48156;11.2;3.9
95;2021-04-04;1249;1213;141522;49369;11.3;4.0
95;2021-04-05;596;64;142118;49433;11.4;4.0
95;2021-04-06;1859;1545;143977;50978;11.5;4.1
95;2021-04-07;4953;2213;148930;53191;11.9;4.3
95;2021-04-08;4896;2482;153826;55673;12.3;4.5
95;2021-04-09;5434;2351;159260;58024;12.8;4.6
95;2021-04-10;3709;1443;162969;59467;13.1;4.8
95;2021-04-11;1567;1045;164536;60512;13.2;4.8
95;2021-04-12;3254;1630;167790;62142;13.4;5.0
95;2021-04-13;3141;1700;170931;63842;13.7;5.1
95;2021-04-14;2751;2005;173682;65847;13.9;5.3
95;2021-04-15;3901;3363;177583;69210;14.2;5.5
95;2021-04-16;4064;3044;181647;72254;14.6;5.8
95;2021-04-17;2376;1760;184023;74014;14.7;5.9
95;2021-04-18;1511;1028;185534;75042;14.9;6.0
95;2021-04-19;2570;2376;188104;77418;15.1;6.2
95;2021-04-20;2121;2460;190225;79878;15.2;6.4
95;2021-04-21;3931;2640;194156;82518;15.6;6.6
95;2021-04-22;3413;4639;197569;87157;15.8;7.0
95;2021-04-23;2765;3564;200334;90721;16.0;7.3
95;2021-04-24;3571;2599;203905;93320;16.3;7.5
95;2021-04-25;1959;1554;205864;94874;16.5;7.6
95;2021-04-26;2753;2713;208617;97587;16.7;7.8
95;2021-04-27;3852;2185;212469;99772;17.0;8.0
95;2021-04-28;3890;2677;216359;102449;17.3;8.2
95;2021-04-29;6142;4563;222501;107012;17.8;8.6
95;2021-04-30;6904;2951;229405;109963;18.4;8.8
95;2021-05-01;2371;923;231776;110886;18.6;8.9
95;2021-05-02;2446;1507;234222;112393;18.8;9.0
95;2021-05-03;5128;1939;239350;114332;19.2;9.2
95;2021-05-04;6351;2737;245701;117069;19.7;9.4
95;2021-05-05;5146;3811;250847;120880;20.1;9.7
95;2021-05-06;8206;4938;259053;125818;20.8;10.1
95;2021-05-07;5778;4761;264831;130579;21.2;10.5
95;2021-05-08;5742;1536;270573;132115;21.7;10.6
95;2021-05-09;2831;1596;273404;133711;21.9;10.7
95;2021-05-10;9972;3204;283376;136915;22.7;11.0
95;2021-05-11;8451;3470;291827;140385;23.4;11.2
95;2021-05-12;9465;3228;301292;143613;24.1;11.5
95;2021-05-13;7954;1205;309246;144818;24.8;11.6
95;2021-05-14;7014;1911;316260;146729;25.3;11.8
95;2021-05-15;4513;1071;320773;147800;25.7;11.8
95;2021-05-16;4824;848;325597;148648;26.1;11.9
95;2021-05-17;7738;1354;333335;150002;26.7;12.0
95;2021-05-18;9468;1861;342803;151863;27.5;12.2
95;2021-05-19;9243;2503;352046;154366;28.2;12.4
95;2021-05-20;12586;2447;364632;156813;29.2;12.6
95;2021-05-21;10172;2541;374804;159354;30.0;12.8
95;2021-05-22;9395;1575;384199;160929;30.8;12.9
95;2021-05-23;4145;965;388344;161894;31.1;13.0
95;2021-05-24;2396;535;390740;162429;31.3;13.0
95;2021-05-25;7212;2082;397952;164511;31.9;13.2
95;2021-05-26;8851;3125;406803;167636;32.6;13.4
95;2021-05-27;10361;4441;417164;172077;33.4;13.8
95;2021-05-28;7682;4418;424846;176495;34.0;14.1
95;2021-05-29;5264;2761;430110;179256;34.5;14.4
95;2021-05-30;3732;1710;433842;180966;34.8;14.5
95;2021-05-31;6424;3331;440266;184297;35.3;14.8
95;2021-06-01;8783;3811;449049;188108;36.0;15.1
95;2021-06-02;8729;4748;457778;192856;36.7;15.4
95;2021-06-03;8524;6564;466302;199420;37.4;16.0
95;2021-06-04;8882;4406;475184;203826;38.1;16.3
95;2021-06-05;8335;3747;483519;207573;38.7;16.6
95;2021-06-06;4836;1626;488355;209199;39.1;16.8
95;2021-06-07;6059;4546;494414;213745;39.6;17.1
95;2021-06-08;6550;5514;500964;219259;40.1;17.6
95;2021-06-09;6254;6478;507218;225737;40.6;18.1
95;2021-06-10;6430;6818;513648;232555;41.1;18.6
95;2021-06-11;7222;6444;520870;238999;41.7;19.1
95;2021-06-12;6002;4374;526872;243373;42.2;19.5
95;2021-06-13;2083;3289;528955;246662;42.4;19.8
95;2021-06-14;5372;5995;534327;252657;42.8;20.2
95;2021-06-15;5740;8074;540067;260731;43.3;20.9
95;2021-06-16;5491;7539;545558;268270;43.7;21.5
95;2021-06-17;6599;8165;552157;276435;44.2;22.1
95;2021-06-18;5822;7862;557979;284297;44.7;22.8
95;2021-06-19;4965;8927;562944;293224;45.1;23.5
95;2021-06-20;1426;3316;564370;296540;45.2;23.8
95;2021-06-21;3534;7715;567904;304255;45.5;24.4
95;2021-06-22;5066;9055;572970;313310;45.9;25.1
95;2021-06-23;4774;10877;577744;324187;46.3;26.0
95;2021-06-24;4941;10724;582685;334911;46.7;26.8
95;2021-06-25;4878;10358;587563;345269;47.1;27.7
95;2021-06-26;4320;8477;591883;353746;47.4;28.3
95;2021-06-27;1032;3996;592915;357742;47.5;28.7
95;2021-06-28;2742;9488;595657;367230;47.7;29.4
95;2021-06-29;2537;8788;598194;376018;47.9;30.1
95;2021-06-30;3952;9996;602146;386014;48.2;30.9
95;2021-07-01;4863;11166;607009;397180;48.6;31.8
95;2021-07-02;4260;10546;611269;407726;49.0;32.7
95;2021-07-03;3525;9155;614794;416881;49.2;33.4
95;2021-07-04;1279;3401;616073;420282;49.4;33.7
95;2021-07-05;2358;4375;618431;424657;49.5;34.0
95;2021-07-06;2772;7753;621203;432410;49.8;34.6
95;2021-07-07;3961;9620;625164;442030;50.1;35.4
95;2021-07-08;5313;9820;630477;451850;50.5;36.2
95;2021-07-09;4553;10080;635030;461930;50.9;37.0
95;2021-07-10;3400;7392;638430;469322;51.1;37.6
95;2021-07-11;1526;3603;639956;472925;51.3;37.9
95;2021-07-12;2990;9692;642946;482617;51.5;38.7
95;2021-07-13;5054;10073;648000;492690;51.9;39.5
95;2021-07-14;4428;5743;652428;498433;52.3;39.9
95;2021-07-15;7403;12371;659831;510804;52.9;40.9
95;2021-07-16;7985;12007;667816;522811;53.5;41.9
95;2021-07-17;5053;7822;672869;530633;53.9;42.5
95;2021-07-18;3482;2914;676351;533547;54.2;42.7
95;2021-07-19;4832;6869;681183;540416;54.6;43.3
95;2021-07-20;6960;8386;688143;548802;55.1;44.0
95;2021-07-21;9257;9452;697400;558254;55.9;44.7
95;2021-07-22;10150;9729;707550;567983;56.7;45.5
95;2021-07-23;10918;10207;718468;578190;57.6;46.3
95;2021-07-24;5259;6237;723727;584427;58.0;46.8
95;2021-07-25;2251;2284;725978;586711;58.2;47.0
95;2021-07-26;4522;4026;730500;590737;58.5;47.3
95;2021-07-27;8502;7045;739002;597782;59.2;47.9
95;2021-07-28;9714;7564;748716;605346;60.0;48.5
95;2021-07-29;8428;5474;757144;610820;60.7;48.9
95;2021-07-30;8516;7776;765660;618596;61.3;49.6
95;2021-07-31;4237;4104;769897;622700;61.7;49.9
95;2021-08-01;2339;1375;772236;624075;61.9;50.0
95;2021-08-02;4160;3918;776396;627993;62.2;50.3
95;2021-08-03;6154;5541;782550;633534;62.7;50.7
95;2021-08-04;6512;6088;789062;639622;63.2;51.2
95;2021-08-05;6868;5732;795930;645354;63.8;51.7
95;2021-08-06;6514;7066;802444;652420;64.3;52.3
95;2021-08-07;2843;3038;805287;655458;64.5;52.5
95;2021-08-08;1370;1888;806657;657346;64.6;52.7
95;2021-08-09;3927;5038;810584;662384;64.9;53.1
95;2021-08-10;5274;5844;815858;668228;65.4;53.5
95;2021-08-11;5370;6563;821228;674791;65.8;54.1
95;2021-08-12;5228;6365;826456;681156;66.2;54.6
95;2021-08-13;3917;5477;830373;686633;66.5;55.0
95;2021-08-14;3571;3323;833944;689956;66.8;55.3
95;2021-08-15;284;361;834228;690317;66.8;55.3
95;2021-08-16;2862;6055;837090;696372;67.1;55.8
95;2021-08-17;3624;7265;840714;703637;67.3;56.4
95;2021-08-18;4276;8074;844990;711711;67.7;57.0
95;2021-08-19;3797;6595;848787;718306;68.0;57.5
95;2021-08-20;3793;7931;852580;726237;68.3;58.2
95;2021-08-21;2717;4303;855297;730540;68.5;58.5
95;2021-08-22;858;2399;856155;732939;68.6;58.7
95;2021-08-23;2469;5652;858624;738591;68.8;59.2
95;2021-08-24;2967;6472;861591;745063;69.0;59.7
95;2021-08-25;3775;8293;865366;753356;69.3;60.3
95;2021-08-26;3167;7534;868533;760890;69.6;61.0
95;2021-08-27;3517;8722;872050;769612;69.9;61.7
95;2021-08-28;2803;5496;874853;775108;70.1;62.1
95;2021-08-29;638;1713;875491;776821;70.1;62.2
95;2021-08-30;2762;6101;878253;782922;70.4;62.7
95;2021-08-31;2823;6311;881076;789233;70.6;63.2
95;2021-09-01;2757;6042;883833;795275;70.8;63.7
95;2021-09-02;1700;4229;885533;799504;70.9;64.0
95;2021-09-03;2222;5359;887755;804863;71.1;64.5
95;2021-09-04;2526;5627;890281;810490;71.3;64.9
95;2021-09-05;421;628;890702;811118;71.4;65.0
95;2021-09-06;1251;3139;891953;814257;71.5;65.2
95;2021-09-07;1397;3144;893350;817401;71.6;65.5
95;2021-09-08;1667;3890;895017;821291;71.7;65.8
95;2021-09-09;1300;3247;896317;824538;71.8;66.1
95;2021-09-10;1576;3518;897893;828056;71.9;66.3
95;2021-09-11;1541;3565;899434;831621;72.0;66.6
95;2021-09-12;322;697;899756;832318;72.1;66.7
95;2021-09-13;879;2207;900635;834525;72.1;66.9
95;2021-09-14;1153;2274;901788;836799;72.2;67.0
95;2021-09-15;1395;3574;903183;840373;72.3;67.3
95;2021-09-16;915;1889;904098;842262;72.4;67.5
95;2021-09-17;1260;2882;905358;845144;72.5;67.7
95;2021-09-18;1278;4204;906636;849348;72.6;68.0
95;2021-09-19;244;585;906880;849933;72.6;68.1
95;2021-09-20;646;1415;907526;851348;72.7;68.2
95;2021-09-21;829;1807;908355;853155;72.8;68.3
95;2021-09-22;946;3080;909301;856235;72.8;68.6
95;2021-09-23;755;1195;910056;857430;72.9;68.7
95;2021-09-24;774;2047;910830;859477;73.0;68.8
95;2021-09-25;1012;3803;911842;863280;73.0;69.2
95;2021-09-26;136;411;911978;863691;73.1;69.2
95;2021-09-27;687;1195;912665;864886;73.1;69.3
95;2021-09-28;773;1410;913438;866296;73.2;69.4
95;2021-09-29;809;1903;914247;868199;73.2;69.5
95;2021-09-30;799;1131;915046;869330;73.3;69.6
95;2021-10-01;758;1406;915804;870736;73.4;69.8
95;2021-10-02;1219;2488;917023;873224;73.5;70.0
95;2021-10-03;132;262;917155;873486;73.5;70.0
95;2021-10-04;402;710;917557;874196;73.5;70.0
95;2021-10-05;595;1218;918152;875414;73.5;70.1
95;2021-10-06;716;1287;918868;876701;73.6;70.2
95;2021-10-07;499;815;919367;877516;73.6;70.3
95;2021-10-08;760;1410;920127;878926;73.7;70.4
95;2021-10-09;1013;1734;921140;880660;73.8;70.5
95;2021-10-10;140;250;921280;880910;73.8;70.6
95;2021-10-11;375;574;921655;881484;73.8;70.6
95;2021-10-12;522;847;922177;882331;73.9;70.7
95;2021-10-13;789;1183;922966;883514;73.9;70.8
95;2021-10-14;507;973;923473;884487;74.0;70.9
971;2020-12-27;0;0;0;0;0.0;0.0
971;2020-12-28;0;0;0;0;0.0;0.0
971;2020-12-29;0;0;0;0;0.0;0.0
971;2020-12-30;0;0;0;0;0.0;0.0
971;2020-12-31;0;0;0;0;0.0;0.0
971;2021-01-01;1;0;1;0;0.0;0.0
971;2021-01-02;0;0;1;0;0.0;0.0
971;2021-01-03;0;0;1;0;0.0;0.0
971;2021-01-04;1;0;2;0;0.0;0.0
971;2021-01-05;0;0;2;0;0.0;0.0
971;2021-01-06;1;0;3;0;0.0;0.0
971;2021-01-07;0;0;3;0;0.0;0.0
971;2021-01-08;59;1;62;1;0.0;0.0
971;2021-01-09;20;0;82;1;0.0;0.0
971;2021-01-10;0;0;82;1;0.0;0.0
971;2021-01-11;61;0;143;1;0.0;0.0
971;2021-01-12;46;0;189;1;0.1;0.0
971;2021-01-13;47;1;236;2;0.1;0.0
971;2021-01-14;63;0;299;2;0.1;0.0
971;2021-01-15;77;2;376;4;0.1;0.0
971;2021-01-16;0;0;376;4;0.1;0.0
971;2021-01-17;0;0;376;4;0.1;0.0
971;2021-01-18;82;2;458;6;0.1;0.0
971;2021-01-19;148;0;606;6;0.2;0.0
971;2021-01-20;134;0;740;6;0.2;0.0
971;2021-01-21;156;1;896;7;0.2;0.0
971;2021-01-22;135;0;1031;7;0.3;0.0
971;2021-01-23;1;0;1032;7;0.3;0.0
971;2021-01-24;0;0;1032;7;0.3;0.0
971;2021-01-25;204;3;1236;10;0.3;0.0
971;2021-01-26;220;4;1456;14;0.4;0.0
971;2021-01-27;237;1;1693;15;0.4;0.0
971;2021-01-28;242;6;1935;21;0.5;0.0
971;2021-01-29;200;3;2135;24;0.6;0.0
971;2021-01-30;25;1;2160;25;0.6;0.0
971;2021-01-31;1;0;2161;25;0.6;0.0
971;2021-02-01;231;5;2392;30;0.6;0.0
971;2021-02-02;247;27;2639;57;0.7;0.0
971;2021-02-03;228;4;2867;61;0.8;0.0
971;2021-02-04;307;26;3174;87;0.8;0.0
971;2021-02-05;289;36;3463;123;0.9;0.0
971;2021-02-06;49;1;3512;124;0.9;0.0
971;2021-02-07;0;0;3512;124;0.9;0.0
971;2021-02-08;261;23;3773;147;1.0;0.0
971;2021-02-09;323;29;4096;176;1.1;0.0
971;2021-02-10;256;31;4352;207;1.2;0.1
971;2021-02-11;302;113;4654;320;1.2;0.1
971;2021-02-12;291;31;4945;351;1.3;0.1
971;2021-02-13;51;7;4996;358;1.3;0.1
971;2021-02-14;19;36;5015;394;1.3;0.1
971;2021-02-15;85;45;5100;439;1.4;0.1
971;2021-02-16;16;1;5116;440;1.4;0.1
971;2021-02-17;17;1;5133;441;1.4;0.1
971;2021-02-18;257;19;5390;460;1.4;0.1
971;2021-02-19;250;22;5640;482;1.5;0.1
971;2021-02-20;49;0;5689;482;1.5;0.1
971;2021-02-21;2;0;5691;482;1.5;0.1
971;2021-02-22;197;68;5888;550;1.6;0.1
971;2021-02-23;206;78;6094;628;1.6;0.2
971;2021-02-24;347;127;6441;755;1.7;0.2
971;2021-02-25;385;80;6826;835;1.8;0.2
971;2021-02-26;236;86;7062;921;1.9;0.2
971;2021-02-27;65;0;7127;921;1.9;0.2
971;2021-02-28;1;0;7128;921;1.9;0.2
971;2021-03-01;179;87;7307;1008;1.9;0.3
971;2021-03-02;278;131;7585;1139;2.0;0.3
971;2021-03-03;244;122;7829;1261;2.1;0.3
971;2021-03-04;336;87;8165;1348;2.2;0.4
971;2021-03-05;377;150;8542;1498;2.3;0.4
971;2021-03-06;598;16;9140;1514;2.4;0.4
971;2021-03-07;2;0;9142;1514;2.4;0.4
971;2021-03-08;331;149;9473;1663;2.5;0.4
971;2021-03-09;393;164;9866;1827;2.6;0.5
971;2021-03-10;438;168;10304;1995;2.7;0.5
971;2021-03-11;122;46;10426;2041;2.8;0.5
971;2021-03-12;505;235;10931;2276;2.9;0.6
971;2021-03-13;139;4;11070;2280;2.9;0.6
971;2021-03-14;14;23;11084;2303;2.9;0.6
971;2021-03-15;424;49;11508;2352;3.1;0.6
971;2021-03-16;492;88;12000;2440;3.2;0.6
971;2021-03-17;471;79;12471;2519;3.3;0.7
971;2021-03-18;590;88;13061;2607;3.5;0.7
971;2021-03-19;583;98;13644;2705;3.6;0.7
971;2021-03-20;177;21;13821;2726;3.7;0.7
971;2021-03-21;8;0;13829;2726;3.7;0.7
971;2021-03-22;361;92;14190;2818;3.8;0.7
971;2021-03-23;541;160;14731;2978;3.9;0.8
971;2021-03-24;475;111;15206;3089;4.0;0.8
971;2021-03-25;758;187;15964;3276;4.2;0.9
971;2021-03-26;644;124;16608;3400;4.4;0.9
971;2021-03-27;296;40;16904;3440;4.5;0.9
971;2021-03-28;24;2;16928;3442;4.5;0.9
971;2021-03-29;385;85;17313;3527;4.6;0.9
971;2021-03-30;627;170;17940;3697;4.8;1.0
971;2021-03-31;545;134;18485;3831;4.9;1.0
971;2021-04-01;663;200;19148;4031;5.1;1.1
971;2021-04-02;41;37;19189;4068;5.1;1.1
971;2021-04-03;63;8;19252;4076;5.1;1.1
971;2021-04-04;4;19;19256;4095;5.1;1.1
971;2021-04-05;14;0;19270;4095;5.1;1.1
971;2021-04-06;489;200;19759;4295;5.2;1.1
971;2021-04-07;581;124;20340;4419;5.4;1.2
971;2021-04-08;527;164;20867;4583;5.5;1.2
971;2021-04-09;486;213;21353;4796;5.7;1.3
971;2021-04-10;101;5;21454;4801;5.7;1.3
971;2021-04-11;8;12;21462;4813;5.7;1.3
971;2021-04-12;307;266;21769;5079;5.8;1.3
971;2021-04-13;556;328;22325;5407;5.9;1.4
971;2021-04-14;448;232;22773;5639;6.0;1.5
971;2021-04-15;553;314;23326;5953;6.2;1.6
971;2021-04-16;563;275;23889;6228;6.3;1.7
971;2021-04-17;216;5;24105;6233;6.4;1.7
971;2021-04-18;6;14;24111;6247;6.4;1.7
971;2021-04-19;405;244;24516;6491;6.5;1.7
971;2021-04-20;726;348;25242;6839;6.7;1.8
971;2021-04-21;627;322;25869;7161;6.9;1.9
971;2021-04-22;819;341;26688;7502;7.1;2.0
971;2021-04-23;845;252;27533;7754;7.3;2.1
971;2021-04-24;390;82;27923;7836;7.4;2.1
971;2021-04-25;601;66;28524;7902;7.6;2.1
971;2021-04-26;982;232;29506;8134;7.8;2.2
971;2021-04-27;721;238;30227;8372;8.0;2.2
971;2021-04-28;865;273;31092;8645;8.2;2.3
971;2021-04-29;1203;218;32295;8863;8.6;2.4
971;2021-04-30;1269;197;33564;9060;8.9;2.4
971;2021-05-01;608;44;34172;9104;9.1;2.4
971;2021-05-02;357;20;34529;9124;9.2;2.4
971;2021-05-03;925;194;35454;9318;9.4;2.5
971;2021-05-04;962;212;36416;9530;9.7;2.5
971;2021-05-05;1023;252;37439;9782;9.9;2.6
971;2021-05-06;1146;179;38585;9961;10.2;2.6
971;2021-05-07;1266;275;39851;10236;10.6;2.7
971;2021-05-08;323;40;40174;10276;10.7;2.7
971;2021-05-09;183;11;40357;10287;10.7;2.7
971;2021-05-10;852;221;41209;10508;10.9;2.8
971;2021-05-11;965;314;42174;10822;11.2;2.9
971;2021-05-12;913;326;43087;11148;11.4;3.0
971;2021-05-13;212;78;43299;11226;11.5;3.0
971;2021-05-14;861;274;44160;11500;11.7;3.1
971;2021-05-15;486;15;44646;11515;11.8;3.1
971;2021-05-16;182;36;44828;11551;11.9;3.1
971;2021-05-17;723;276;45551;11827;12.1;3.1
971;2021-05-18;743;389;46294;12216;12.3;3.2
971;2021-05-19;705;529;46999;12745;12.5;3.4
971;2021-05-20;811;379;47810;13124;12.7;3.5
971;2021-05-21;827;405;48637;13529;12.9;3.6
971;2021-05-22;508;214;49145;13743;13.0;3.6
971;2021-05-23;199;114;49344;13857;13.1;3.7
971;2021-05-24;201;173;49545;14030;13.1;3.7
971;2021-05-25;551;660;50096;14690;13.3;3.9
971;2021-05-26;596;491;50692;15181;13.5;4.0
971;2021-05-27;133;179;50825;15360;13.5;4.1
971;2021-05-28;520;525;51345;15885;13.6;4.2
971;2021-05-29;238;140;51583;16025;13.7;4.3
971;2021-05-30;75;112;51658;16137;13.7;4.3
971;2021-05-31;452;535;52110;16672;13.8;4.4
971;2021-06-01;595;706;52705;17378;14.0;4.6
971;2021-06-02;576;705;53281;18083;14.1;4.8
971;2021-06-03;509;558;53790;18641;14.3;4.9
971;2021-06-04;834;799;54624;19440;14.5;5.2
971;2021-06-05;317;644;54941;20084;14.6;5.3
971;2021-06-06;139;528;55080;20612;14.6;5.5
971;2021-06-07;419;781;55499;21393;14.7;5.7
971;2021-06-08;485;886;55984;22279;14.9;5.9
971;2021-06-09;504;857;56488;23136;15.0;6.1
971;2021-06-10;538;848;57026;23984;15.1;6.4
971;2021-06-11;474;1233;57500;25217;15.3;6.7
971;2021-06-12;303;659;57803;25876;15.3;6.9
971;2021-06-13;126;312;57929;26188;15.4;6.9
971;2021-06-14;371;3678;58300;29866;15.5;7.9
971;2021-06-15;483;1981;58783;31847;15.6;8.5
971;2021-06-16;479;1431;59262;33278;15.7;8.8
971;2021-06-17;432;1009;59694;34287;15.8;9.1
971;2021-06-18;483;1020;60177;35307;16.0;9.4
971;2021-06-19;313;508;60490;35815;16.1;9.5
971;2021-06-20;111;231;60601;36046;16.1;9.6
971;2021-06-21;348;674;60949;36720;16.2;9.7
971;2021-06-22;333;870;61282;37590;16.3;10.0
971;2021-06-23;371;892;61653;38482;16.4;10.2
971;2021-06-24;417;731;62070;39213;16.5;10.4
971;2021-06-25;456;759;62526;39972;16.6;10.6
971;2021-06-26;301;512;62827;40484;16.7;10.7
971;2021-06-27;116;148;62943;40632;16.7;10.8
971;2021-06-28;303;682;63246;41314;16.8;11.0
971;2021-06-29;388;780;63634;42094;16.9;11.2
971;2021-06-30;442;926;64076;43020;17.0;11.4
971;2021-07-01;364;649;64440;43669;17.1;11.6
971;2021-07-02;435;693;64875;44362;17.2;11.8
971;2021-07-03;277;467;65152;44829;17.3;11.9
971;2021-07-04;112;238;65264;45067;17.3;12.0
971;2021-07-05;331;504;65595;45571;17.4;12.1
971;2021-07-06;388;769;65983;46340;17.5;12.3
971;2021-07-07;378;844;66361;47184;17.6;12.5
971;2021-07-08;416;791;66777;47975;17.7;12.7
971;2021-07-09;437;796;67214;48771;17.8;12.9
971;2021-07-10;245;295;67459;49066;17.9;13.0
971;2021-07-11;169;137;67628;49203;17.9;13.1
971;2021-07-12;477;603;68105;49806;18.1;13.2
971;2021-07-13;883;1001;68988;50807;18.3;13.5
971;2021-07-14;476;283;69464;51090;18.4;13.6
971;2021-07-15;885;842;70349;51932;18.7;13.8
971;2021-07-16;1095;1041;71444;52973;19.0;14.1
971;2021-07-17;647;445;72091;53418;19.1;14.2
971;2021-07-18;401;221;72492;53639;19.2;14.2
971;2021-07-19;579;579;73071;54218;19.4;14.4
971;2021-07-20;841;736;73912;54954;19.6;14.6
971;2021-07-21;767;501;74679;55455;19.8;14.7
971;2021-07-22;988;878;75667;56333;20.1;14.9
971;2021-07-23;1034;759;76701;57092;20.4;15.1
971;2021-07-24;426;387;77127;57479;20.5;15.3
971;2021-07-25;247;262;77374;57741;20.5;15.3
971;2021-07-26;636;566;78010;58307;20.7;15.5
971;2021-07-27;884;590;78894;58897;20.9;15.6
971;2021-07-28;797;655;79691;59552;21.1;15.8
971;2021-07-29;971;674;80662;60226;21.4;16.0
971;2021-07-30;1320;758;81982;60984;21.8;16.2
971;2021-07-31;557;412;82539;61396;21.9;16.3
971;2021-08-01;315;251;82854;61647;22.0;16.4
971;2021-08-02;765;422;83619;62069;22.2;16.5
971;2021-08-03;764;677;84383;62746;22.4;16.6
971;2021-08-04;694;675;85077;63421;22.6;16.8
971;2021-08-05;699;595;85776;64016;22.8;17.0
971;2021-08-06;934;644;86710;64660;23.0;17.2
971;2021-08-07;452;392;87162;65052;23.1;17.3
971;2021-08-08;279;313;87441;65365;23.2;17.3
971;2021-08-09;592;585;88033;65950;23.4;17.5
971;2021-08-10;762;797;88795;66747;23.6;17.7
971;2021-08-11;925;793;89720;67540;23.8;17.9
971;2021-08-12;1025;804;90745;68344;24.1;18.1
971;2021-08-13;980;444;91725;68788;24.3;18.3
971;2021-08-14;635;703;92360;69491;24.5;18.4
971;2021-08-15;437;413;92797;69904;24.6;18.5
971;2021-08-16;825;742;93622;70646;24.8;18.7
971;2021-08-17;909;871;94531;71517;25.1;19.0
971;2021-08-18;1277;977;95808;72494;25.4;19.2
971;2021-08-19;1349;928;97157;73422;25.8;19.5
971;2021-08-20;1535;1050;98692;74472;26.2;19.8
971;2021-08-21;733;519;99425;74991;26.4;19.9
971;2021-08-22;367;273;99792;75264;26.5;20.0
971;2021-08-23;876;630;100668;75894;26.7;20.1
971;2021-08-24;1294;795;101962;76689;27.1;20.3
971;2021-08-25;1392;801;103354;77490;27.4;20.6
971;2021-08-26;1404;776;104758;78266;27.8;20.8
971;2021-08-27;1506;1100;106264;79366;28.2;21.1
971;2021-08-28;939;580;107203;79946;28.4;21.2
971;2021-08-29;222;241;107425;80187;28.5;21.3
971;2021-08-30;932;720;108357;80907;28.8;21.5
971;2021-08-31;1255;863;109612;81770;29.1;21.7
971;2021-09-01;1129;879;110741;82649;29.4;21.9
971;2021-09-02;1076;852;111817;83501;29.7;22.2
971;2021-09-03;989;1098;112806;84599;29.9;22.4
971;2021-09-04;550;624;113356;85223;30.1;22.6
971;2021-09-05;129;238;113485;85461;30.1;22.7
971;2021-09-06;612;665;114097;86126;30.3;22.9
971;2021-09-07;639;700;114736;86826;30.4;23.0
971;2021-09-08;708;1003;115444;87829;30.6;23.3
971;2021-09-09;641;1071;116085;88900;30.8;23.6
971;2021-09-10;746;1288;116831;90188;31.0;23.9
971;2021-09-11;399;686;117230;90874;31.1;24.1
971;2021-09-12;86;357;117316;91231;31.1;24.2
971;2021-09-13;377;620;117693;91851;31.2;24.4
971;2021-09-14;555;1104;118248;92955;31.4;24.7
971;2021-09-15;557;1166;118805;94121;31.5;25.0
971;2021-09-16;455;1084;119260;95205;31.6;25.3
971;2021-09-17;566;1479;119826;96684;31.8;25.7
971;2021-09-18;279;1021;120105;97705;31.9;25.9
971;2021-09-19;92;336;120197;98041;31.9;26.0
971;2021-09-20;237;966;120434;99007;32.0;26.3
971;2021-09-21;284;1191;120718;100198;32.0;26.6
971;2021-09-22;383;1196;121101;101394;32.1;26.9
971;2021-09-23;375;1222;121476;102616;32.2;27.2
971;2021-09-24;452;1282;121928;103898;32.4;27.6
971;2021-09-25;233;777;122161;104675;32.4;27.8
971;2021-09-26;73;228;122234;104903;32.4;27.8
971;2021-09-27;248;665;122482;105568;32.5;28.0
971;2021-09-28;262;835;122744;106403;32.6;28.2
971;2021-09-29;313;890;123057;107293;32.7;28.5
971;2021-09-30;347;759;123404;108052;32.7;28.7
971;2021-10-01;385;863;123789;108915;32.8;28.9
971;2021-10-02;268;541;124057;109456;32.9;29.0
971;2021-10-03;71;167;124128;109623;32.9;29.1
971;2021-10-04;223;443;124351;110066;33.0;29.2
971;2021-10-05;338;613;124689;110679;33.1;29.4
971;2021-10-06;334;630;125023;111309;33.2;29.5
971;2021-10-07;365;575;125388;111884;33.3;29.7
971;2021-10-08;426;778;125814;112662;33.4;29.9
971;2021-10-09;318;449;126132;113111;33.5;30.0
971;2021-10-10;68;148;126200;113259;33.5;30.1
971;2021-10-11;244;358;126444;113617;33.6;30.1
971;2021-10-12;290;488;126734;114105;33.6;30.3
971;2021-10-13;377;431;127111;114536;33.7;30.4
971;2021-10-14;330;526;127441;115062;33.8;30.5
972;2020-12-27;0;0;0;0;0.0;0.0
972;2020-12-28;0;0;0;0;0.0;0.0
972;2020-12-29;0;0;0;0;0.0;0.0
972;2020-12-30;0;0;0;0;0.0;0.0
972;2020-12-31;0;0;0;0;0.0;0.0
972;2021-01-01;0;0;0;0;0.0;0.0
972;2021-01-02;0;0;0;0;0.0;0.0
972;2021-01-03;0;0;0;0;0.0;0.0
972;2021-01-04;0;0;0;0;0.0;0.0
972;2021-01-05;0;0;0;0;0.0;0.0
972;2021-01-06;5;0;5;0;0.0;0.0
972;2021-01-07;31;0;36;0;0.0;0.0
972;2021-01-08;90;1;126;1;0.0;0.0
972;2021-01-09;20;0;146;1;0.0;0.0
972;2021-01-10;0;0;146;1;0.0;0.0
972;2021-01-11;122;0;268;1;0.1;0.0
972;2021-01-12;79;0;347;1;0.1;0.0
972;2021-01-13;65;0;412;1;0.1;0.0
972;2021-01-14;88;1;500;2;0.1;0.0
972;2021-01-15;171;7;671;9;0.2;0.0
972;2021-01-16;51;0;722;9;0.2;0.0
972;2021-01-17;0;0;722;9;0.2;0.0
972;2021-01-18;158;0;880;9;0.2;0.0
972;2021-01-19;168;1;1048;10;0.3;0.0
972;2021-01-20;171;0;1219;10;0.3;0.0
972;2021-01-21;181;2;1400;12;0.4;0.0
972;2021-01-22;173;0;1573;12;0.4;0.0
972;2021-01-23;58;0;1631;12;0.5;0.0
972;2021-01-24;0;0;1631;12;0.5;0.0
972;2021-01-25;161;1;1792;13;0.5;0.0
972;2021-01-26;138;1;1930;14;0.5;0.0
972;2021-01-27;163;5;2093;19;0.6;0.0
972;2021-01-28;152;12;2245;31;0.6;0.0
972;2021-01-29;143;41;2388;72;0.7;0.0
972;2021-01-30;96;16;2484;88;0.7;0.0
972;2021-01-31;0;0;2484;88;0.7;0.0
972;2021-02-01;119;73;2603;161;0.7;0.0
972;2021-02-02;184;94;2787;255;0.8;0.1
972;2021-02-03;132;76;2919;331;0.8;0.1
972;2021-02-04;160;70;3079;401;0.9;0.1
972;2021-02-05;123;93;3202;494;0.9;0.1
972;2021-02-06;63;26;3265;520;0.9;0.1
972;2021-02-07;1;0;3266;520;0.9;0.1
972;2021-02-08;137;79;3403;599;0.9;0.2
972;2021-02-09;177;77;3580;676;1.0;0.2
972;2021-02-10;153;90;3733;766;1.0;0.2
972;2021-02-11;149;101;3882;867;1.1;0.2
972;2021-02-12;152;131;4034;998;1.1;0.3
972;2021-02-13;47;37;4081;1035;1.1;0.3
972;2021-02-14;0;0;4081;1035;1.1;0.3
972;2021-02-15;51;67;4132;1102;1.2;0.3
972;2021-02-16;0;1;4132;1103;1.2;0.3
972;2021-02-17;1;3;4133;1106;1.2;0.3
972;2021-02-18;69;127;4202;1233;1.2;0.3
972;2021-02-19;69;129;4271;1362;1.2;0.4
972;2021-02-20;48;68;4319;1430;1.2;0.4
972;2021-02-21;0;0;4319;1430;1.2;0.4
972;2021-02-22;102;60;4421;1490;1.2;0.4
972;2021-02-23;113;235;4534;1725;1.3;0.5
972;2021-02-24;106;220;4640;1945;1.3;0.5
972;2021-02-25;93;150;4733;2095;1.3;0.6
972;2021-02-26;132;168;4865;2263;1.4;0.6
972;2021-02-27;69;52;4934;2315;1.4;0.6
972;2021-02-28;0;0;4934;2315;1.4;0.6
972;2021-03-01;138;143;5072;2458;1.4;0.7
972;2021-03-02;158;79;5230;2537;1.5;0.7
972;2021-03-03;179;145;5409;2682;1.5;0.7
972;2021-03-04;152;135;5561;2817;1.6;0.8
972;2021-03-05;236;128;5797;2945;1.6;0.8
972;2021-03-06;119;58;5916;3003;1.6;0.8
972;2021-03-07;100;3;6016;3006;1.7;0.8
972;2021-03-08;196;134;6212;3140;1.7;0.9
972;2021-03-09;283;101;6495;3241;1.8;0.9
972;2021-03-10;322;136;6817;3377;1.9;0.9
972;2021-03-11;337;81;7154;3458;2.0;1.0
972;2021-03-12;413;57;7567;3515;2.1;1.0
972;2021-03-13;155;21;7722;3536;2.2;1.0
972;2021-03-14;4;1;7726;3537;2.2;1.0
972;2021-03-15;277;91;8003;3628;2.2;1.0
972;2021-03-16;305;56;8308;3684;2.3;1.0
972;2021-03-17;388;48;8696;3732;2.4;1.0
972;2021-03-18;437;46;9133;3778;2.5;1.1
972;2021-03-19;402;63;9535;3841;2.7;1.1
972;2021-03-20;149;48;9684;3889;2.7;1.1
972;2021-03-21;25;1;9709;3890;2.7;1.1
972;2021-03-22;361;117;10070;4007;2.8;1.1
972;2021-03-23;404;124;10474;4131;2.9;1.2
972;2021-03-24;429;107;10903;4238;3.0;1.2
972;2021-03-25;492;99;11395;4337;3.2;1.2
972;2021-03-26;634;106;12029;4443;3.4;1.2
972;2021-03-27;154;71;12183;4514;3.4;1.3
972;2021-03-28;81;2;12264;4516;3.4;1.3
972;2021-03-29;423;166;12687;4682;3.5;1.3
972;2021-03-30;469;244;13156;4926;3.7;1.4
972;2021-03-31;1151;193;14307;5119;4.0;1.4
972;2021-04-01;955;174;15262;5293;4.3;1.5
972;2021-04-02;896;16;16158;5309;4.5;1.5
972;2021-04-03;789;58;16947;5367;4.7;1.5
972;2021-04-04;751;15;17698;5382;4.9;1.5
972;2021-04-05;828;44;18526;5426;5.2;1.5
972;2021-04-06;885;136;19411;5562;5.4;1.6
972;2021-04-07;1437;332;20848;5894;5.8;1.6
972;2021-04-08;1307;272;22155;6166;6.2;1.7
972;2021-04-09;1239;316;23394;6482;6.5;1.8
972;2021-04-10;838;165;24232;6647;6.8;1.9
972;2021-04-11;620;15;24852;6662;6.9;1.9
972;2021-04-12;869;318;25721;6980;7.2;1.9
972;2021-04-13;880;330;26601;7310;7.4;2.0
972;2021-04-14;959;324;27560;7634;7.7;2.1
972;2021-04-15;960;303;28520;7937;7.9;2.2
972;2021-04-16;996;301;29516;8238;8.2;2.3
972;2021-04-17;529;161;30045;8399;8.4;2.3
972;2021-04-18;339;56;30384;8455;8.5;2.4
972;2021-04-19;668;342;31052;8797;8.7;2.5
972;2021-04-20;865;309;31917;9106;8.9;2.5
972;2021-04-21;1002;354;32919;9460;9.2;2.6
972;2021-04-22;605;312;33524;9772;9.3;2.7
972;2021-04-23;614;465;34138;10237;9.5;2.9
972;2021-04-24;364;197;34502;10434;9.6;2.9
972;2021-04-25;168;200;34670;10634;9.7;3.0
972;2021-04-26;516;541;35186;11175;9.8;3.1
972;2021-04-27;568;607;35754;11782;10.0;3.3
972;2021-04-28;448;691;36202;12473;10.1;3.5
972;2021-04-29;654;643;36856;13116;10.3;3.7
972;2021-04-30;771;686;37627;13802;10.5;3.8
972;2021-05-01;244;246;37871;14048;10.6;3.9
972;2021-05-02;227;513;38098;14561;10.6;4.1
972;2021-05-03;569;770;38667;15331;10.8;4.3
972;2021-05-04;525;678;39192;16009;10.9;4.5
972;2021-05-05;548;897;39740;16906;11.1;4.7
972;2021-05-06;546;785;40286;17691;11.2;4.9
972;2021-05-07;629;1015;40915;18706;11.4;5.2
972;2021-05-08;225;526;41140;19232;11.5;5.4
972;2021-05-09;172;506;41312;19738;11.5;5.5
972;2021-05-10;519;856;41831;20594;11.7;5.7
972;2021-05-11;477;870;42308;21464;11.8;6.0
972;2021-05-12;560;910;42868;22374;11.9;6.2
972;2021-05-13;275;532;43143;22906;12.0;6.4
972;2021-05-14;388;748;43531;23654;12.1;6.6
972;2021-05-15;233;578;43764;24232;12.2;6.8
972;2021-05-16;155;442;43919;24674;12.2;6.9
972;2021-05-17;475;754;44394;25428;12.4;7.1
972;2021-05-18;445;678;44839;26106;12.5;7.3
972;2021-05-19;453;744;45292;26850;12.6;7.5
972;2021-05-20;594;500;45886;27350;12.8;7.6
972;2021-05-21;544;683;46430;28033;12.9;7.8
972;2021-05-22;186;359;46616;28392;13.0;7.9
972;2021-05-23;111;182;46727;28574;13.0;8.0
972;2021-05-24;134;241;46861;28815;13.1;8.0
972;2021-05-25;350;697;47211;29512;13.2;8.2
972;2021-05-26;381;712;47592;30224;13.3;8.4
972;2021-05-27;271;647;47863;30871;13.3;8.6
972;2021-05-28;280;815;48143;31686;13.4;8.8
972;2021-05-29;154;513;48297;32199;13.5;9.0
972;2021-05-30;17;33;48314;32232;13.5;9.0
972;2021-05-31;346;680;48660;32912;13.6;9.2
972;2021-06-01;299;543;48959;33455;13.6;9.3
972;2021-06-02;325;575;49284;34030;13.7;9.5
972;2021-06-03;247;424;49531;34454;13.8;9.6
972;2021-06-04;350;642;49881;35096;13.9;9.8
972;2021-06-05;260;371;50141;35467;14.0;9.9
972;2021-06-06;25;32;50166;35499;14.0;9.9
972;2021-06-07;260;735;50426;36234;14.1;10.1
972;2021-06-08;255;585;50681;36819;14.1;10.3
972;2021-06-09;303;697;50984;37516;14.2;10.5
972;2021-06-10;308;451;51292;37967;14.3;10.6
972;2021-06-11;358;533;51650;38500;14.4;10.7
972;2021-06-12;232;320;51882;38820;14.5;10.8
972;2021-06-13;32;29;51914;38849;14.5;10.8
972;2021-06-14;367;548;52281;39397;14.6;11.0
972;2021-06-15;409;486;52690;39883;14.7;11.1
972;2021-06-16;436;435;53126;40318;14.8;11.2
972;2021-06-17;354;573;53480;40891;14.9;11.4
972;2021-06-18;458;537;53938;41428;15.0;11.5
972;2021-06-19;225;196;54163;41624;15.1;11.6
972;2021-06-20;25;17;54188;41641;15.1;11.6
972;2021-06-21;332;579;54520;42220;15.2;11.8
972;2021-06-22;297;463;54817;42683;15.3;11.9
972;2021-06-23;421;562;55238;43245;15.4;12.1
972;2021-06-24;330;437;55568;43682;15.5;12.2
972;2021-06-25;313;387;55881;44069;15.6;12.3
972;2021-06-26;222;201;56103;44270;15.6;12.3
972;2021-06-27;16;23;56119;44293;15.6;12.3
972;2021-06-28;336;425;56455;44718;15.7;12.5
972;2021-06-29;329;430;56784;45148;15.8;12.6
972;2021-06-30;440;421;57224;45569;16.0;12.7
972;2021-07-01;351;394;57575;45963;16.0;12.8
972;2021-07-02;124;201;57699;46164;16.1;12.9
972;2021-07-03;100;118;57799;46282;16.1;12.9
972;2021-07-04;24;36;57823;46318;16.1;12.9
972;2021-07-05;494;580;58317;46898;16.3;13.1
972;2021-07-06;488;429;58805;47327;16.4;13.2
972;2021-07-07;613;496;59418;47823;16.6;13.3
972;2021-07-08;492;422;59910;48245;16.7;13.4
972;2021-07-09;629;583;60539;48828;16.9;13.6
972;2021-07-10;405;309;60944;49137;17.0;13.7
972;2021-07-11;52;38;60996;49175;17.0;13.7
972;2021-07-12;847;697;61843;49872;17.2;13.9
972;2021-07-13;1475;707;63318;50579;17.6;14.1
972;2021-07-14;133;65;63451;50644;17.7;14.1
972;2021-07-15;1603;681;65054;51325;18.1;14.3
972;2021-07-16;1632;664;66686;51989;18.6;14.5
972;2021-07-17;1094;367;67780;52356;18.9;14.6
972;2021-07-18;56;39;67836;52395;18.9;14.6
972;2021-07-19;1148;654;68984;53049;19.2;14.8
972;2021-07-20;1131;579;70115;53628;19.5;14.9
972;2021-07-21;1089;604;71204;54232;19.8;15.1
972;2021-07-22;906;519;72110;54751;20.1;15.3
972;2021-07-23;969;484;73079;55235;20.4;15.4
972;2021-07-24;506;224;73585;55459;20.5;15.5
972;2021-07-25;50;63;73635;55522;20.5;15.5
972;2021-07-26;685;525;74320;56047;20.7;15.6
972;2021-07-27;1029;516;75349;56563;21.0;15.8
972;2021-07-28;645;562;75994;57125;21.2;15.9
972;2021-07-29;842;548;76836;57673;21.4;16.1
972;2021-07-30;904;615;77740;58288;21.7;16.2
972;2021-07-31;561;275;78301;58563;21.8;16.3
972;2021-08-01;83;33;78384;58596;21.8;16.3
972;2021-08-02;813;816;79197;59412;22.1;16.6
972;2021-08-03;730;743;79927;60155;22.3;16.8
972;2021-08-04;788;572;80715;60727;22.5;16.9
972;2021-08-05;915;590;81630;61317;22.8;17.1
972;2021-08-06;1196;896;82826;62213;23.1;17.3
972;2021-08-07;667;571;83493;62784;23.3;17.5
972;2021-08-08;85;83;83578;62867;23.3;17.5
972;2021-08-09;1130;1064;84708;63931;23.6;17.8
972;2021-08-10;1200;1041;85908;64972;23.9;18.1
972;2021-08-11;1235;921;87143;65893;24.3;18.4
972;2021-08-12;1452;931;88595;66824;24.7;18.6
972;2021-08-13;1317;645;89912;67469;25.1;18.8
972;2021-08-14;851;322;90763;67791;25.3;18.9
972;2021-08-15;70;55;90833;67846;25.3;18.9
972;2021-08-16;1282;1048;92115;68894;25.7;19.2
972;2021-08-17;1177;1187;93292;70081;26.0;19.5
972;2021-08-18;1238;1174;94530;71255;26.3;19.9
972;2021-08-19;1286;892;95816;72147;26.7;20.1
972;2021-08-20;1329;892;97145;73039;27.1;20.4
972;2021-08-21;758;627;97903;73666;27.3;20.5
972;2021-08-22;47;82;97950;73748;27.3;20.6
972;2021-08-23;1182;859;99132;74607;27.6;20.8
972;2021-08-24;1380;880;100512;75487;28.0;21.0
972;2021-08-25;1079;769;101591;76256;28.3;21.3
972;2021-08-26;1280;802;102871;77058;28.7;21.5
972;2021-08-27;1286;1077;104157;78135;29.0;21.8
972;2021-08-28;779;756;104936;78891;29.3;22.0
972;2021-08-29;100;64;105036;78955;29.3;22.0
972;2021-08-30;1141;1111;106177;80066;29.6;22.3
972;2021-08-31;907;1099;107084;81165;29.8;22.6
972;2021-09-01;812;1117;107896;82282;30.1;22.9
972;2021-09-02;879;1189;108775;83471;30.3;23.3
972;2021-09-03;772;1279;109547;84750;30.5;23.6
972;2021-09-04;616;887;110163;85637;30.7;23.9
972;2021-09-05;145;128;110308;85765;30.7;23.9
972;2021-09-06;600;1026;110908;86791;30.9;24.2
972;2021-09-07;638;935;111546;87726;31.1;24.5
972;2021-09-08;593;1128;112139;88854;31.3;24.8
972;2021-09-09;521;1070;112660;89924;31.4;25.1
972;2021-09-10;588;1297;113248;91221;31.6;25.4
972;2021-09-11;490;893;113738;92114;31.7;25.7
972;2021-09-12;109;106;113847;92220;31.7;25.7
972;2021-09-13;489;1084;114336;93304;31.9;26.0
972;2021-09-14;485;1085;114821;94389;32.0;26.3
972;2021-09-15;404;1090;115225;95479;32.1;26.6
972;2021-09-16;386;1069;115611;96548;32.2;26.9
972;2021-09-17;599;1274;116210;97822;32.4;27.3
972;2021-09-18;455;931;116665;98753;32.5;27.5
972;2021-09-19;43;121;116708;98874;32.5;27.6
972;2021-09-20;377;922;117085;99796;32.6;27.8
972;2021-09-21;431;990;117516;100786;32.8;28.1
972;2021-09-22;363;856;117879;101642;32.9;28.3
972;2021-09-23;409;826;118288;102468;33.0;28.6
972;2021-09-24;460;979;118748;103447;33.1;28.8
972;2021-09-25;333;835;119081;104282;33.2;29.1
972;2021-09-26;30;183;119111;104465;33.2;29.1
972;2021-09-27;303;666;119414;105131;33.3;29.3
972;2021-09-28;409;670;119823;105801;33.4;29.5
972;2021-09-29;364;645;120187;106446;33.5;29.7
972;2021-09-30;477;668;120664;107114;33.6;29.9
972;2021-10-01;539;755;121203;107869;33.8;30.1
972;2021-10-02;369;610;121572;108479;33.9;30.2
972;2021-10-03;40;79;121612;108558;33.9;30.3
972;2021-10-04;368;456;121980;109014;34.0;30.4
972;2021-10-05;368;542;122348;109556;34.1;30.5
972;2021-10-06;391;511;122739;110067;34.2;30.7
972;2021-10-07;398;496;123137;110563;34.3;30.8
972;2021-10-08;520;624;123657;111187;34.5;31.0
972;2021-10-09;414;521;124071;111708;34.6;31.1
972;2021-10-10;34;66;124105;111774;34.6;31.2
972;2021-10-11;451;464;124556;112238;34.7;31.3
972;2021-10-12;406;417;124962;112655;34.8;31.4
972;2021-10-13;480;533;125442;113188;35.0;31.6
972;2021-10-14;383;423;125825;113611;35.1;31.7
973;2020-12-27;0;0;0;0;0.0;0.0
973;2020-12-28;0;0;0;0;0.0;0.0
973;2020-12-29;0;0;0;0;0.0;0.0
973;2020-12-30;0;0;0;0;0.0;0.0
973;2020-12-31;0;0;0;0;0.0;0.0
973;2021-01-01;0;0;0;0;0.0;0.0
973;2021-01-02;1;1;1;1;0.0;0.0
973;2021-01-03;0;0;1;1;0.0;0.0
973;2021-01-04;0;0;1;1;0.0;0.0
973;2021-01-05;0;0;1;1;0.0;0.0
973;2021-01-06;0;0;1;1;0.0;0.0
973;2021-01-07;0;0;1;1;0.0;0.0
973;2021-01-08;0;0;1;1;0.0;0.0
973;2021-01-09;0;0;1;1;0.0;0.0
973;2021-01-10;0;0;1;1;0.0;0.0
973;2021-01-11;0;0;1;1;0.0;0.0
973;2021-01-12;0;0;1;1;0.0;0.0
973;2021-01-13;30;0;31;1;0.0;0.0
973;2021-01-14;46;0;77;1;0.0;0.0
973;2021-01-15;35;0;112;1;0.0;0.0
973;2021-01-16;18;1;130;2;0.0;0.0
973;2021-01-17;0;0;130;2;0.0;0.0
973;2021-01-18;63;0;193;2;0.1;0.0
973;2021-01-19;151;1;344;3;0.1;0.0
973;2021-01-20;134;0;478;3;0.2;0.0
973;2021-01-21;118;0;596;3;0.2;0.0
973;2021-01-22;76;0;672;3;0.2;0.0
973;2021-01-23;0;0;672;3;0.2;0.0
973;2021-01-24;0;0;672;3;0.2;0.0
973;2021-01-25;56;0;728;3;0.3;0.0
973;2021-01-26;100;2;828;5;0.3;0.0
973;2021-01-27;109;1;937;6;0.3;0.0
973;2021-01-28;96;3;1033;9;0.4;0.0
973;2021-01-29;104;3;1137;12;0.4;0.0
973;2021-01-30;0;0;1137;12;0.4;0.0
973;2021-01-31;0;0;1137;12;0.4;0.0
973;2021-02-01;54;0;1191;12;0.4;0.0
973;2021-02-02;122;5;1313;17;0.5;0.0
973;2021-02-03;119;7;1432;24;0.5;0.0
973;2021-02-04;79;25;1511;49;0.5;0.0
973;2021-02-05;66;8;1577;57;0.5;0.0
973;2021-02-06;0;0;1577;57;0.5;0.0
973;2021-02-07;0;0;1577;57;0.5;0.0
973;2021-02-08;52;12;1629;69;0.6;0.0
973;2021-02-09;92;39;1721;108;0.6;0.0
973;2021-02-10;101;41;1822;149;0.6;0.1
973;2021-02-11;105;93;1927;242;0.7;0.1
973;2021-02-12;89;63;2016;305;0.7;0.1
973;2021-02-13;0;0;2016;305;0.7;0.1
973;2021-02-14;0;0;2016;305;0.7;0.1
973;2021-02-15;28;65;2044;370;0.7;0.1
973;2021-02-16;123;52;2167;422;0.7;0.1
973;2021-02-17;145;119;2312;541;0.8;0.2
973;2021-02-18;103;139;2415;680;0.8;0.2
973;2021-02-19;122;72;2537;752;0.9;0.3
973;2021-02-20;0;0;2537;752;0.9;0.3
973;2021-02-21;0;0;2537;752;0.9;0.3
973;2021-02-22;78;48;2615;800;0.9;0.3
973;2021-02-23;158;103;2773;903;1.0;0.3
973;2021-02-24;189;124;2962;1027;1.0;0.4
973;2021-02-25;259;92;3221;1119;1.1;0.4
973;2021-02-26;264;71;3485;1190;1.2;0.4
973;2021-02-27;121;2;3606;1192;1.2;0.4
973;2021-02-28;0;0;3606;1192;1.2;0.4
973;2021-03-01;182;88;3788;1280;1.3;0.4
973;2021-03-02;257;107;4045;1387;1.4;0.5
973;2021-03-03;256;131;4301;1518;1.5;0.5
973;2021-03-04;281;87;4582;1605;1.6;0.6
973;2021-03-05;274;48;4856;1653;1.7;0.6
973;2021-03-06;118;2;4974;1655;1.7;0.6
973;2021-03-07;0;0;4974;1655;1.7;0.6
973;2021-03-08;188;42;5162;1697;1.8;0.6
973;2021-03-09;353;93;5515;1790;1.9;0.6
973;2021-03-10;360;120;5875;1910;2.0;0.7
973;2021-03-11;271;113;6146;2023;2.1;0.7
973;2021-03-12;288;97;6434;2120;2.2;0.7
973;2021-03-13;112;4;6546;2124;2.3;0.7
973;2021-03-14;0;0;6546;2124;2.3;0.7
973;2021-03-15;181;27;6727;2151;2.3;0.7
973;2021-03-16;243;142;6970;2293;2.4;0.8
973;2021-03-17;274;129;7244;2422;2.5;0.8
973;2021-03-18;249;157;7493;2579;2.6;0.9
973;2021-03-19;283;129;7776;2708;2.7;0.9
973;2021-03-20;260;22;8036;2730;2.8;0.9
973;2021-03-21;119;4;8155;2734;2.8;0.9
973;2021-03-22;219;109;8374;2843;2.9;1.0
973;2021-03-23;276;195;8650;3038;3.0;1.0
973;2021-03-24;236;214;8886;3252;3.1;1.1
973;2021-03-25;167;180;9053;3432;3.1;1.2
973;2021-03-26;189;307;9242;3739;3.2;1.3
973;2021-03-27;58;94;9300;3833;3.2;1.3
973;2021-03-28;0;0;9300;3833;3.2;1.3
973;2021-03-29;175;249;9475;4082;3.3;1.4
973;2021-03-30;446;239;9921;4321;3.4;1.5
973;2021-03-31;318;293;10239;4614;3.5;1.6
973;2021-04-01;446;263;10685;4877;3.7;1.7
973;2021-04-02;309;283;10994;5160;3.8;1.8
973;2021-04-03;159;126;11153;5286;3.8;1.8
973;2021-04-04;0;0;11153;5286;3.8;1.8
973;2021-04-05;118;15;11271;5301;3.9;1.8
973;2021-04-06;441;337;11712;5638;4.0;1.9
973;2021-04-07;502;345;12214;5983;4.2;2.1
973;2021-04-08;513;270;12727;6253;4.4;2.2
973;2021-04-09;498;227;13225;6480;4.5;2.2
973;2021-04-10;147;91;13372;6571;4.6;2.3
973;2021-04-11;2;0;13374;6571;4.6;2.3
973;2021-04-12;551;270;13925;6841;4.8;2.4
973;2021-04-13;673;245;14598;7086;5.0;2.4
973;2021-04-14;721;316;15319;7402;5.3;2.5
973;2021-04-15;776;248;16095;7650;5.5;2.6
973;2021-04-16;761;306;16856;7956;5.8;2.7
973;2021-04-17;499;138;17355;8094;6.0;2.8
973;2021-04-18;499;47;17854;8141;6.1;2.8
973;2021-04-19;715;254;18569;8395;6.4;2.9
973;2021-04-20;607;280;19176;8675;6.6;3.0
973;2021-04-21;873;251;20049;8926;6.9;3.1
973;2021-04-22;727;233;20776;9159;7.1;3.2
973;2021-04-23;705;234;21481;9393;7.4;3.2
973;2021-04-24;524;99;22005;9492;7.6;3.3
973;2021-04-25;611;50;22616;9542;7.8;3.3
973;2021-04-26;779;233;23395;9775;8.0;3.4
973;2021-04-27;817;349;24212;10124;8.3;3.5
973;2021-04-28;746;332;24958;10456;8.6;3.6
973;2021-04-29;666;287;25624;10743;8.8;3.7
973;2021-04-30;711;261;26335;11004;9.1;3.8
973;2021-05-01;211;29;26546;11033;9.1;3.8
973;2021-05-02;602;86;27148;11119;9.3;3.8
973;2021-05-03;554;395;27702;11514;9.5;4.0
973;2021-05-04;666;327;28368;11841;9.8;4.1
973;2021-05-05;700;457;29068;12298;10.0;4.2
973;2021-05-06;695;479;29763;12777;10.2;4.4
973;2021-05-07;594;474;30357;13251;10.4;4.6
973;2021-05-08;343;60;30700;13311;10.6;4.6
973;2021-05-09;262;72;30962;13383;10.7;4.6
973;2021-05-10;440;612;31402;13995;10.8;4.8
973;2021-05-11;399;497;31801;14492;10.9;5.0
973;2021-05-12;514;647;32315;15139;11.1;5.2
973;2021-05-13;333;99;32648;15238;11.2;5.2
973;2021-05-14;485;555;33133;15793;11.4;5.4
973;2021-05-15;257;348;33390;16141;11.5;5.6
973;2021-05-16;207;210;33597;16351;11.6;5.6
973;2021-05-17;447;599;34044;16950;11.7;5.8
973;2021-05-18;564;568;34608;17518;11.9;6.0
973;2021-05-19;534;552;35142;18070;12.1;6.2
973;2021-05-20;643;451;35785;18521;12.3;6.4
973;2021-05-21;505;609;36290;19130;12.5;6.6
973;2021-05-22;167;500;36457;19630;12.5;6.8
973;2021-05-23;271;475;36728;20105;12.6;6.9
973;2021-05-24;562;249;37290;20354;12.8;7.0
973;2021-05-25;501;745;37791;21099;13.0;7.3
973;2021-05-26;453;684;38244;21783;13.2;7.5
973;2021-05-27;712;528;38956;22311;13.4;7.7
973;2021-05-28;580;554;39536;22865;13.6;7.9
973;2021-05-29;257;360;39793;23225;13.7;8.0
973;2021-05-30;151;399;39944;23624;13.7;8.1
973;2021-05-31;356;573;40300;24197;13.9;8.3
973;2021-06-01;421;468;40721;24665;14.0;8.5
973;2021-06-02;567;554;41288;25219;14.2;8.7
973;2021-06-03;525;470;41813;25689;14.4;8.8
973;2021-06-04;601;496;42414;26185;14.6;9.0
973;2021-06-05;273;292;42687;26477;14.7;9.1
973;2021-06-06;211;301;42898;26778;14.8;9.2
973;2021-06-07;488;452;43386;27230;14.9;9.4
973;2021-06-08;544;315;43930;27545;15.1;9.5
973;2021-06-09;530;390;44460;27935;15.3;9.6
973;2021-06-10;360;291;44820;28226;15.4;9.7
973;2021-06-11;436;466;45256;28692;15.6;9.9
973;2021-06-12;170;283;45426;28975;15.6;10.0
973;2021-06-13;215;269;45641;29244;15.7;10.1
973;2021-06-14;384;549;46025;29793;15.8;10.2
973;2021-06-15;377;445;46402;30238;16.0;10.4
973;2021-06-16;491;459;46893;30697;16.1;10.6
973;2021-06-17;442;578;47335;31275;16.3;10.8
973;2021-06-18;390;562;47725;31837;16.4;11.0
973;2021-06-19;235;260;47960;32097;16.5;11.0
973;2021-06-20;126;270;48086;32367;16.5;11.1
973;2021-06-21;335;601;48421;32968;16.7;11.3
973;2021-06-22;376;462;48797;33430;16.8;11.5
973;2021-06-23;343;539;49140;33969;16.9;11.7
973;2021-06-24;446;500;49586;34469;17.1;11.9
973;2021-06-25;445;559;50031;35028;17.2;12.0
973;2021-06-26;172;320;50203;35348;17.3;12.2
973;2021-06-27;121;170;50324;35518;17.3;12.2
973;2021-06-28;314;593;50638;36111;17.4;12.4
973;2021-06-29;376;506;51014;36617;17.5;12.6
973;2021-06-30;410;680;51424;37297;17.7;12.8
973;2021-07-01;431;399;51855;37696;17.8;13.0
973;2021-07-02;511;524;52366;38220;18.0;13.1
973;2021-07-03;210;275;52576;38495;18.1;13.2
973;2021-07-04;86;243;52662;38738;18.1;13.3
973;2021-07-05;361;546;53023;39284;18.2;13.5
973;2021-07-06;373;474;53396;39758;18.4;13.7
973;2021-07-07;374;415;53770;40173;18.5;13.8
973;2021-07-08;316;328;54086;40501;18.6;13.9
973;2021-07-09;392;434;54478;40935;18.7;14.1
973;2021-07-10;168;278;54646;41213;18.8;14.2
973;2021-07-11;102;163;54748;41376;18.8;14.2
973;2021-07-12;403;497;55151;41873;19.0;14.4
973;2021-07-13;682;558;55833;42431;19.2;14.6
973;2021-07-14;394;161;56227;42592;19.3;14.7
973;2021-07-15;658;528;56885;43120;19.6;14.8
973;2021-07-16;602;485;57487;43605;19.8;15.0
973;2021-07-17;345;285;57832;43890;19.9;15.1
973;2021-07-18;251;124;58083;44014;20.0;15.1
973;2021-07-19;524;459;58607;44473;20.2;15.3
973;2021-07-20;585;494;59192;44967;20.4;15.5
973;2021-07-21;725;397;59917;45364;20.6;15.6
973;2021-07-22;660;452;60577;45816;20.8;15.8
973;2021-07-23;609;370;61186;46186;21.0;15.9
973;2021-07-24;326;241;61512;46427;21.2;16.0
973;2021-07-25;166;111;61678;46538;21.2;16.0
973;2021-07-26;446;345;62124;46883;21.4;16.1
973;2021-07-27;554;358;62678;47241;21.6;16.3
973;2021-07-28;468;370;63146;47611;21.7;16.4
973;2021-07-29;536;432;63682;48043;21.9;16.5
973;2021-07-30;541;408;64223;48451;22.1;16.7
973;2021-07-31;204;163;64427;48614;22.2;16.7
973;2021-08-01;139;132;64566;48746;22.2;16.8
973;2021-08-02;398;432;64964;49178;22.3;16.9
973;2021-08-03;434;402;65398;49580;22.5;17.1
973;2021-08-04;309;375;65707;49955;22.6;17.2
973;2021-08-05;343;363;66050;50318;22.7;17.3
973;2021-08-06;365;524;66415;50842;22.8;17.5
973;2021-08-07;164;266;66579;51108;22.9;17.6
973;2021-08-08;123;177;66702;51285;22.9;17.6
973;2021-08-09;332;473;67034;51758;23.1;17.8
973;2021-08-10;363;516;67397;52274;23.2;18.0
973;2021-08-11;584;519;67981;52793;23.4;18.2
973;2021-08-12;551;584;68532;53377;23.6;18.4
973;2021-08-13;367;234;68899;53611;23.7;18.4
973;2021-08-14;253;401;69152;54012;23.8;18.6
973;2021-08-15;122;138;69274;54150;23.8;18.6
973;2021-08-16;307;473;69581;54623;23.9;18.8
973;2021-08-17;372;401;69953;55024;24.1;18.9
973;2021-08-18;369;446;70322;55470;24.2;19.1
973;2021-08-19;331;483;70653;55953;24.3;19.2
973;2021-08-20;313;401;70966;56354;24.4;19.4
973;2021-08-21;161;257;71127;56611;24.5;19.5
973;2021-08-22;115;183;71242;56794;24.5;19.5
973;2021-08-23;286;384;71528;57178;24.6;19.7
973;2021-08-24;313;465;71841;57643;24.7;19.8
973;2021-08-25;296;351;72137;57994;24.8;20.0
973;2021-08-26;322;404;72459;58398;24.9;20.1
973;2021-08-27;368;426;72827;58824;25.1;20.2
973;2021-08-28;143;266;72970;59090;25.1;20.3
973;2021-08-29;87;187;73057;59277;25.1;20.4
973;2021-08-30;222;338;73279;59615;25.2;20.5
973;2021-08-31;312;371;73591;59986;25.3;20.6
973;2021-09-01;262;393;73853;60379;25.4;20.8
973;2021-09-02;317;386;74170;60765;25.5;20.9
973;2021-09-03;285;342;74455;61107;25.6;21.0
973;2021-09-04;147;197;74602;61304;25.7;21.1
973;2021-09-05;72;88;74674;61392;25.7;21.1
973;2021-09-06;185;232;74859;61624;25.8;21.2
973;2021-09-07;219;257;75078;61881;25.8;21.3
973;2021-09-08;221;397;75299;62278;25.9;21.4
973;2021-09-09;239;290;75538;62568;26.0;21.5
973;2021-09-10;228;314;75766;62882;26.1;21.6
973;2021-09-11;125;292;75891;63174;26.1;21.7
973;2021-09-12;59;95;75950;63269;26.1;21.8
973;2021-09-13;234;226;76184;63495;26.2;21.8
973;2021-09-14;265;296;76449;63791;26.3;21.9
973;2021-09-15;348;332;76797;64123;26.4;22.1
973;2021-09-16;265;240;77062;64363;26.5;22.1
973;2021-09-17;215;242;77277;64605;26.6;22.2
973;2021-09-18;114;244;77391;64849;26.6;22.3
973;2021-09-19;56;150;77447;64999;26.6;22.4
973;2021-09-20;152;187;77599;65186;26.7;22.4
973;2021-09-21;193;203;77792;65389;26.8;22.5
973;2021-09-22;186;350;77978;65739;26.8;22.6
973;2021-09-23;246;240;78224;65979;26.9;22.7
973;2021-09-24;257;307;78481;66286;27.0;22.8
973;2021-09-25;113;257;78594;66543;27.0;22.9
973;2021-09-26;39;94;78633;66637;27.1;22.9
973;2021-09-27;158;168;78791;66805;27.1;23.0
973;2021-09-28;159;205;78950;67010;27.2;23.1
973;2021-09-29;204;237;79154;67247;27.2;23.1
973;2021-09-30;291;304;79445;67551;27.3;23.2
973;2021-10-01;200;219;79645;67770;27.4;23.3
973;2021-10-02;104;169;79749;67939;27.4;23.4
973;2021-10-03;60;92;79809;68031;27.5;23.4
973;2021-10-04;199;209;80008;68240;27.5;23.5
973;2021-10-05;174;177;80182;68417;27.6;23.5
973;2021-10-06;198;205;80380;68622;27.7;23.6
973;2021-10-07;218;174;80598;68796;27.7;23.7
973;2021-10-08;226;202;80824;68998;27.8;23.7
973;2021-10-09;107;153;80931;69151;27.8;23.8
973;2021-10-10;46;73;80977;69224;27.9;23.8
973;2021-10-11;155;176;81132;69400;27.9;23.9
973;2021-10-12;180;177;81312;69577;28.0;23.9
973;2021-10-13;207;282;81519;69859;28.0;24.0
973;2021-10-14;226;292;81745;70151;28.1;24.1
974;2020-12-27;0;0;0;0;0.0;0.0
974;2020-12-28;0;0;0;0;0.0;0.0
974;2020-12-29;0;0;0;0;0.0;0.0
974;2020-12-30;0;0;0;0;0.0;0.0
974;2020-12-31;0;0;0;0;0.0;0.0
974;2021-01-01;1;0;1;0;0.0;0.0
974;2021-01-02;0;0;1;0;0.0;0.0
974;2021-01-03;0;0;1;0;0.0;0.0
974;2021-01-04;0;0;1;0;0.0;0.0
974;2021-01-05;2;0;3;0;0.0;0.0
974;2021-01-06;0;0;3;0;0.0;0.0
974;2021-01-07;0;0;3;0;0.0;0.0
974;2021-01-08;0;0;3;0;0.0;0.0
974;2021-01-09;1;0;4;0;0.0;0.0
974;2021-01-10;0;0;4;0;0.0;0.0
974;2021-01-11;0;0;4;0;0.0;0.0
974;2021-01-12;0;0;4;0;0.0;0.0
974;2021-01-13;0;0;4;0;0.0;0.0
974;2021-01-14;0;0;4;0;0.0;0.0
974;2021-01-15;335;0;339;0;0.0;0.0
974;2021-01-16;28;0;367;0;0.0;0.0
974;2021-01-17;0;0;367;0;0.0;0.0
974;2021-01-18;49;1;416;1;0.0;0.0
974;2021-01-19;395;0;811;1;0.1;0.0
974;2021-01-20;485;1;1296;2;0.2;0.0
974;2021-01-21;614;2;1910;4;0.2;0.0
974;2021-01-22;414;1;2324;5;0.3;0.0
974;2021-01-23;75;0;2399;5;0.3;0.0
974;2021-01-24;0;0;2399;5;0.3;0.0
974;2021-01-25;274;2;2673;7;0.3;0.0
974;2021-01-26;428;0;3101;7;0.4;0.0
974;2021-01-27;316;0;3417;7;0.4;0.0
974;2021-01-28;409;1;3826;8;0.4;0.0
974;2021-01-29;422;3;4248;11;0.5;0.0
974;2021-01-30;421;1;4669;12;0.5;0.0
974;2021-01-31;0;0;4669;12;0.5;0.0
974;2021-02-01;373;4;5042;16;0.6;0.0
974;2021-02-02;503;3;5545;19;0.6;0.0
974;2021-02-03;602;14;6147;33;0.7;0.0
974;2021-02-04;629;21;6776;54;0.8;0.0
974;2021-02-05;564;97;7340;151;0.9;0.0
974;2021-02-06;501;6;7841;157;0.9;0.0
974;2021-02-07;0;8;7841;165;0.9;0.0
974;2021-02-08;470;34;8311;199;1.0;0.0
974;2021-02-09;787;93;9098;292;1.1;0.0
974;2021-02-10;820;87;9918;379;1.2;0.0
974;2021-02-11;795;89;10713;468;1.2;0.1
974;2021-02-12;638;95;11351;563;1.3;0.1
974;2021-02-13;655;76;12006;639;1.4;0.1
974;2021-02-14;1;0;12007;639;1.4;0.1
974;2021-02-15;526;129;12533;768;1.5;0.1
974;2021-02-16;651;533;13184;1301;1.5;0.2
974;2021-02-17;593;327;13777;1628;1.6;0.2
974;2021-02-18;495;409;14272;2037;1.7;0.2
974;2021-02-19;497;318;14769;2355;1.7;0.3
974;2021-02-20;577;116;15346;2471;1.8;0.3
974;2021-02-21;0;0;15346;2471;1.8;0.3
974;2021-02-22;403;237;15749;2708;1.8;0.3
974;2021-02-23;608;241;16357;2949;1.9;0.3
974;2021-02-24;583;254;16940;3203;2.0;0.4
974;2021-02-25;649;296;17589;3499;2.0;0.4
974;2021-02-26;485;468;18074;3967;2.1;0.5
974;2021-02-27;384;466;18458;4433;2.1;0.5
974;2021-02-28;0;0;18458;4433;2.1;0.5
974;2021-03-01;293;384;18751;4817;2.2;0.6
974;2021-03-02;487;500;19238;5317;2.2;0.6
974;2021-03-03;758;537;19996;5854;2.3;0.7
974;2021-03-04;778;492;20774;6346;2.4;0.7
974;2021-03-05;729;519;21503;6865;2.5;0.8
974;2021-03-06;814;526;22317;7391;2.6;0.9
974;2021-03-07;0;0;22317;7391;2.6;0.9
974;2021-03-08;435;554;22752;7945;2.6;0.9
974;2021-03-09;671;771;23423;8716;2.7;1.0
974;2021-03-10;644;837;24067;9553;2.8;1.1
974;2021-03-11;700;626;24767;10179;2.9;1.2
974;2021-03-12;732;656;25499;10835;3.0;1.3
974;2021-03-13;669;599;26168;11434;3.0;1.3
974;2021-03-14;2;0;26170;11434;3.0;1.3
974;2021-03-15;508;491;26678;11925;3.1;1.4
974;2021-03-16;681;693;27359;12618;3.2;1.5
974;2021-03-17;847;522;28206;13140;3.3;1.5
974;2021-03-18;1022;503;29228;13643;3.4;1.6
974;2021-03-19;786;528;30014;14171;3.5;1.6
974;2021-03-20;578;593;30592;14764;3.6;1.7
974;2021-03-21;0;0;30592;14764;3.6;1.7
974;2021-03-22;566;467;31158;15231;3.6;1.8
974;2021-03-23;780;635;31938;15866;3.7;1.8
974;2021-03-24;790;640;32728;16506;3.8;1.9
974;2021-03-25;934;539;33662;17045;3.9;2.0
974;2021-03-26;923;452;34585;17497;4.0;2.0
974;2021-03-27;782;335;35367;17832;4.1;2.1
974;2021-03-28;1;0;35368;17832;4.1;2.1
974;2021-03-29;960;272;36328;18104;4.2;2.1
974;2021-03-30;883;495;37211;18599;4.3;2.2
974;2021-03-31;736;657;37947;19256;4.4;2.2
974;2021-04-01;718;706;38665;19962;4.5;2.3
974;2021-04-02;688;756;39353;20718;4.6;2.4
974;2021-04-03;699;700;40052;21418;4.7;2.5
974;2021-04-04;0;0;40052;21418;4.7;2.5
974;2021-04-05;0;0;40052;21418;4.7;2.5
974;2021-04-06;796;634;40848;22052;4.7;2.6
974;2021-04-07;1367;783;42215;22835;4.9;2.7
974;2021-04-08;1792;772;44007;23607;5.1;2.7
974;2021-04-09;1508;777;45515;24384;5.3;2.8
974;2021-04-10;1137;650;46652;25034;5.4;2.9
974;2021-04-11;2;0;46654;25034;5.4;2.9
974;2021-04-12;1238;548;47892;25582;5.6;3.0
974;2021-04-13;1439;751;49331;26333;5.7;3.1
974;2021-04-14;2066;771;51397;27104;6.0;3.2
974;2021-04-15;2510;957;53907;28061;6.3;3.3
974;2021-04-16;1936;786;55843;28847;6.5;3.4
974;2021-04-17;1290;604;57133;29451;6.6;3.4
974;2021-04-18;0;0;57133;29451;6.6;3.4
974;2021-04-19;1374;564;58507;30015;6.8;3.5
974;2021-04-20;1651;805;60158;30820;7.0;3.6
974;2021-04-21;2124;626;62282;31446;7.2;3.7
974;2021-04-22;2952;822;65234;32268;7.6;3.8
974;2021-04-23;2311;822;67545;33090;7.9;3.8
974;2021-04-24;1111;805;68656;33895;8.0;3.9
974;2021-04-25;3;0;68659;33895;8.0;3.9
974;2021-04-26;1172;911;69831;34806;8.1;4.0
974;2021-04-27;1687;1029;71518;35835;8.3;4.2
974;2021-04-28;2902;752;74420;36587;8.7;4.3
974;2021-04-29;3947;819;78367;37406;9.1;4.3
974;2021-04-30;3450;912;81817;38318;9.5;4.5
974;2021-05-01;2106;231;83923;38549;9.8;4.5
974;2021-05-02;1;0;83924;38549;9.8;4.5
974;2021-05-03;1865;576;85789;39125;10.0;4.5
974;2021-05-04;2127;1093;87916;40218;10.2;4.7
974;2021-05-05;3119;1648;91035;41866;10.6;4.9
974;2021-05-06;4001;1590;95036;43456;11.1;5.1
974;2021-05-07;3228;1525;98264;44981;11.4;5.2
974;2021-05-08;1578;506;99842;45487;11.6;5.3
974;2021-05-09;2;1;99844;45488;11.6;5.3
974;2021-05-10;2412;1001;102256;46489;11.9;5.4
974;2021-05-11;3650;1640;105906;48129;12.3;5.6
974;2021-05-12;4721;2403;110627;50532;12.9;5.9
974;2021-05-13;3553;600;114180;51132;13.3;5.9
974;2021-05-14;5276;2521;119456;53653;13.9;6.2
974;2021-05-15;3157;1537;122613;55190;14.3;6.4
974;2021-05-16;17;19;122630;55209;14.3;6.4
974;2021-05-17;2995;1498;125625;56707;14.6;6.6
974;2021-05-18;3765;1803;129390;58510;15.0;6.8
974;2021-05-19;4687;2435;134077;60945;15.6;7.1
974;2021-05-20;5139;2853;139216;63798;16.2;7.4
974;2021-05-21;4996;2630;144212;66428;16.8;7.7
974;2021-05-22;3372;1256;147584;67684;17.2;7.9
974;2021-05-23;6;3;147590;67687;17.2;7.9
974;2021-05-24;3645;1078;151235;68765;17.6;8.0
974;2021-05-25;4248;1923;155483;70688;18.1;8.2
974;2021-05-26;4984;2992;160467;73680;18.7;8.6
974;2021-05-27;4620;4101;165087;77781;19.2;9.0
974;2021-05-28;4384;3837;169471;81618;19.7;9.5
974;2021-05-29;2554;2457;172025;84075;20.0;9.8
974;2021-05-30;8;14;172033;84089;20.0;9.8
974;2021-05-31;2347;2251;174380;86340;20.3;10.0
974;2021-06-01;3301;2762;177681;89102;20.7;10.4
974;2021-06-02;3969;3366;181650;92468;21.1;10.8
974;2021-06-03;4042;3653;185692;96121;21.6;11.2
974;2021-06-04;3849;3758;189541;99879;22.0;11.6
974;2021-06-05;2213;1931;191754;101810;22.3;11.8
974;2021-06-06;1074;135;192828;101945;22.4;11.9
974;2021-06-07;2012;2526;194840;104471;22.7;12.1
974;2021-06-08;2558;3340;197398;107811;23.0;12.5
974;2021-06-09;2982;4839;200380;112650;23.3;13.1
974;2021-06-10;3411;4466;203791;117116;23.7;13.6
974;2021-06-11;2840;4623;206631;121739;24.0;14.2
974;2021-06-12;1726;3379;208357;125118;24.2;14.5
974;2021-06-13;1324;246;209681;125364;24.4;14.6
974;2021-06-14;1489;3181;211170;128545;24.6;14.9
974;2021-06-15;2060;3617;213230;132162;24.8;15.4
974;2021-06-16;2748;4664;215978;136826;25.1;15.9
974;2021-06-17;2522;4896;218500;141722;25.4;16.5
974;2021-06-18;2597;4890;221097;146612;25.7;17.0
974;2021-06-19;1300;3516;222397;150128;25.9;17.5
974;2021-06-20;633;289;223030;150417;25.9;17.5
974;2021-06-21;1265;3235;224295;153652;26.1;17.9
974;2021-06-22;1618;3761;225913;157413;26.3;18.3
974;2021-06-23;2258;4995;228171;162408;26.5;18.9
974;2021-06-24;2280;4069;230451;166477;26.8;19.4
974;2021-06-25;2188;4107;232639;170584;27.1;19.8
974;2021-06-26;1401;2712;234040;173296;27.2;20.2
974;2021-06-27;664;268;234704;173564;27.3;20.2
974;2021-06-28;1307;2481;236011;176045;27.4;20.5
974;2021-06-29;1755;2846;237766;178891;27.6;20.8
974;2021-06-30;2560;3843;240326;182734;27.9;21.2
974;2021-07-01;2699;3826;243025;186560;28.3;21.7
974;2021-07-02;2511;3708;245536;190268;28.6;22.1
974;2021-07-03;1613;2457;247149;192725;28.7;22.4
974;2021-07-04;881;1039;248030;193764;28.8;22.5
974;2021-07-05;1698;2223;249728;195987;29.0;22.8
974;2021-07-06;2569;2545;252297;198532;29.3;23.1
974;2021-07-07;2665;3135;254962;201667;29.6;23.5
974;2021-07-08;2418;3173;257380;204840;29.9;23.8
974;2021-07-09;2762;3429;260142;208269;30.3;24.2
974;2021-07-10;1618;2192;261760;210461;30.4;24.5
974;2021-07-11;729;1017;262489;211478;30.5;24.6
974;2021-07-12;1745;2605;264234;214083;30.7;24.9
974;2021-07-13;4434;3348;268668;217431;31.2;25.3
974;2021-07-14;3300;608;271968;218039;31.6;25.4
974;2021-07-15;5557;4024;277525;222063;32.3;25.8
974;2021-07-16;6239;3304;283764;225367;33.0;26.2
974;2021-07-17;4374;1913;288138;227280;33.5;26.4
974;2021-07-18;2673;765;290811;228045;33.8;26.5
974;2021-07-19;4650;2031;295461;230076;34.4;26.8
974;2021-07-20;6231;2432;301692;232508;35.1;27.0
974;2021-07-21;6745;2863;308437;235371;35.9;27.4
974;2021-07-22;7141;2826;315578;238197;36.7;27.7
974;2021-07-23;6642;2983;322220;241180;37.5;28.0
974;2021-07-24;3800;2066;326020;243246;37.9;28.3
974;2021-07-25;2522;754;328542;244000;38.2;28.4
974;2021-07-26;4372;2099;332914;246099;38.7;28.6
974;2021-07-27;5443;2563;338357;248662;39.3;28.9
974;2021-07-28;5395;2909;343752;251571;40.0;29.3
974;2021-07-29;5743;2816;349495;254387;40.6;29.6
974;2021-07-30;5878;2583;355373;256970;41.3;29.9
974;2021-07-31;3936;1650;359309;258620;41.8;30.1
974;2021-08-01;1907;716;361216;259336;42.0;30.2
974;2021-08-02;3436;1869;364652;261205;42.4;30.4
974;2021-08-03;4300;4075;368952;265280;42.9;30.8
974;2021-08-04;4878;4232;373830;269512;43.5;31.3
974;2021-08-05;4446;4667;378276;274179;44.0;31.9
974;2021-08-06;4082;5105;382358;279284;44.5;32.5
974;2021-08-07;2748;4042;385106;283326;44.8;32.9
974;2021-08-08;1481;2265;386587;285591;45.0;33.2
974;2021-08-09;2573;4525;389160;290116;45.3;33.7
974;2021-08-10;3789;4964;392949;295080;45.7;34.3
974;2021-08-11;4644;5450;397593;300530;46.2;34.9
974;2021-08-12;4714;5917;402307;306447;46.8;35.6
974;2021-08-13;4458;5828;406765;312275;47.3;36.3
974;2021-08-14;2608;4329;409373;316604;47.6;36.8
974;2021-08-15;1573;2175;410946;318779;47.8;37.1
974;2021-08-16;2345;4182;413291;322961;48.1;37.6
974;2021-08-17;3187;4525;416478;327486;48.4;38.1
974;2021-08-18;3346;5900;419824;333386;48.8;38.8
974;2021-08-19;3311;4908;423135;338294;49.2;39.3
974;2021-08-20;3442;5274;426577;343568;49.6;40.0
974;2021-08-21;1832;4617;428409;348185;49.8;40.5
974;2021-08-22;1019;1944;429428;350129;49.9;40.7
974;2021-08-23;1816;3328;431244;353457;50.1;41.1
974;2021-08-24;2461;3774;433705;357231;50.4;41.5
974;2021-08-25;2908;5217;436613;362448;50.8;42.1
974;2021-08-26;2668;3871;439281;366319;51.1;42.6
974;2021-08-27;2780;4011;442061;370330;51.4;43.1
974;2021-08-28;1864;3884;443925;374214;51.6;43.5
974;2021-08-29;760;1574;444685;375788;51.7;43.7
974;2021-08-30;1565;2528;446250;378316;51.9;44.0
974;2021-08-31;1866;3333;448116;381649;52.1;44.4
974;2021-09-01;2407;4874;450523;386523;52.4;44.9
974;2021-09-02;2258;4280;452781;390803;52.7;45.4
974;2021-09-03;2339;4473;455120;395276;52.9;46.0
974;2021-09-04;1586;3890;456706;399166;53.1;46.4
974;2021-09-05;607;1309;457313;400475;53.2;46.6
974;2021-09-06;1215;2499;458528;402974;53.3;46.9
974;2021-09-07;1365;3110;459893;406084;53.5;47.2
974;2021-09-08;2119;3884;462012;409968;53.7;47.7
974;2021-09-09;1802;3329;463814;413297;53.9;48.1
974;2021-09-10;1932;3723;465746;417020;54.2;48.5
974;2021-09-11;1537;2469;467283;419489;54.3;48.8
974;2021-09-12;391;960;467674;420449;54.4;48.9
974;2021-09-13;1086;1847;468760;422296;54.5;49.1
974;2021-09-14;1521;2329;470281;424625;54.7;49.4
974;2021-09-15;1827;3033;472108;427658;54.9;49.7
974;2021-09-16;1403;2783;473511;430441;55.1;50.1
974;2021-09-17;1500;3064;475011;433505;55.2;50.4
974;2021-09-18;1203;1955;476214;435460;55.4;50.6
974;2021-09-19;291;716;476505;436176;55.4;50.7
974;2021-09-20;724;1632;477229;437808;55.5;50.9
974;2021-09-21;838;1816;478067;439624;55.6;51.1
974;2021-09-22;1262;2518;479329;442142;55.7;51.4
974;2021-09-23;846;2119;480175;444261;55.8;51.7
974;2021-09-24;1099;2475;481274;446736;56.0;51.9
974;2021-09-25;766;1878;482040;448614;56.1;52.2
974;2021-09-26;160;518;482200;449132;56.1;52.2
974;2021-09-27;607;1072;482807;450204;56.1;52.4
974;2021-09-28;850;1536;483657;451740;56.2;52.5
974;2021-09-29;1199;2328;484856;454068;56.4;52.8
974;2021-09-30;998;1753;485854;455821;56.5;53.0
974;2021-10-01;1278;1989;487132;457810;56.6;53.2
974;2021-10-02;945;1469;488077;459279;56.8;53.4
974;2021-10-03;267;387;488344;459666;56.8;53.5
974;2021-10-04;723;1151;489067;460817;56.9;53.6
974;2021-10-05;961;1345;490028;462162;57.0;53.7
974;2021-10-06;1197;1914;491225;464076;57.1;54.0
974;2021-10-07;991;1478;492216;465554;57.2;54.1
974;2021-10-08;1145;1806;493361;467360;57.4;54.3
974;2021-10-09;905;1326;494266;468686;57.5;54.5
974;2021-10-10;211;238;494477;468924;57.5;54.5
974;2021-10-11;1036;946;495513;469870;57.6;54.6
974;2021-10-12;1151;978;496664;470848;57.8;54.8
974;2021-10-13;1344;1478;498008;472326;57.9;54.9
974;2021-10-14;1333;1013;499341;473339;58.1;55.0
976;2020-12-27;0;0;0;0;0.0;0.0
976;2020-12-28;0;0;0;0;0.0;0.0
976;2020-12-29;0;0;0;0;0.0;0.0
976;2020-12-30;0;0;0;0;0.0;0.0
976;2020-12-31;0;0;0;0;0.0;0.0
976;2021-01-01;0;0;0;0;0.0;0.0
976;2021-01-02;0;0;0;0;0.0;0.0
976;2021-01-03;0;0;0;0;0.0;0.0
976;2021-01-04;0;0;0;0;0.0;0.0
976;2021-01-05;0;0;0;0;0.0;0.0
976;2021-01-06;0;0;0;0;0.0;0.0
976;2021-01-07;0;0;0;0;0.0;0.0
976;2021-01-08;0;0;0;0;0.0;0.0
976;2021-01-09;0;0;0;0;0.0;0.0
976;2021-01-10;0;0;0;0;0.0;0.0
976;2021-01-11;9;0;9;0;0.0;0.0
976;2021-01-12;0;0;9;0;0.0;0.0
976;2021-01-13;0;0;9;0;0.0;0.0
976;2021-01-14;0;0;9;0;0.0;0.0
976;2021-01-15;1;0;10;0;0.0;0.0
976;2021-01-16;1;0;11;0;0.0;0.0
976;2021-01-17;0;0;11;0;0.0;0.0
976;2021-01-18;1;0;12;0;0.0;0.0
976;2021-01-19;0;0;12;0;0.0;0.0
976;2021-01-20;0;0;12;0;0.0;0.0
976;2021-01-21;1;1;13;1;0.0;0.0
976;2021-01-22;0;0;13;1;0.0;0.0
976;2021-01-23;1;0;14;1;0.0;0.0
976;2021-01-24;0;0;14;1;0.0;0.0
976;2021-01-25;144;3;158;4;0.1;0.0
976;2021-01-26;167;3;325;7;0.1;0.0
976;2021-01-27;250;4;575;11;0.2;0.0
976;2021-01-28;104;9;679;20;0.2;0.0
976;2021-01-29;233;5;912;25;0.3;0.0
976;2021-01-30;286;11;1198;36;0.4;0.0
976;2021-01-31;1;0;1199;36;0.4;0.0
976;2021-02-01;161;2;1360;38;0.5;0.0
976;2021-02-02;328;11;1688;49;0.6;0.0
976;2021-02-03;227;4;1915;53;0.7;0.0
976;2021-02-04;215;10;2130;63;0.8;0.0
976;2021-02-05;213;1;2343;64;0.8;0.0
976;2021-02-06;83;10;2426;74;0.9;0.0
976;2021-02-07;0;0;2426;74;0.9;0.0
976;2021-02-08;82;4;2508;78;0.9;0.0
976;2021-02-09;194;2;2702;80;1.0;0.0
976;2021-02-10;187;5;2889;85;1.0;0.0
976;2021-02-11;236;6;3125;91;1.1;0.0
976;2021-02-12;288;7;3413;98;1.2;0.0
976;2021-02-13;56;0;3469;98;1.2;0.0
976;2021-02-14;2;0;3471;98;1.2;0.0
976;2021-02-15;359;11;3830;109;1.4;0.0
976;2021-02-16;266;10;4096;119;1.5;0.0
976;2021-02-17;167;9;4263;128;1.5;0.0
976;2021-02-18;217;16;4480;144;1.6;0.1
976;2021-02-19;237;24;4717;168;1.7;0.1
976;2021-02-20;138;9;4855;177;1.7;0.1
976;2021-02-21;0;0;4855;177;1.7;0.1
976;2021-02-22;130;121;4985;298;1.8;0.1
976;2021-02-23;185;156;5170;454;1.8;0.2
976;2021-02-24;176;146;5346;600;1.9;0.2
976;2021-02-25;227;278;5573;878;2.0;0.3
976;2021-02-26;242;247;5815;1125;2.1;0.4
976;2021-02-27;0;0;5815;1125;2.1;0.4
976;2021-02-28;0;0;5815;1125;2.1;0.4
976;2021-03-01;146;258;5961;1383;2.1;0.5
976;2021-03-02;228;260;6189;1643;2.2;0.6
976;2021-03-03;202;190;6391;1833;2.3;0.7
976;2021-03-04;205;145;6596;1978;2.4;0.7
976;2021-03-05;225;118;6821;2096;2.4;0.7
976;2021-03-06;1;0;6822;2096;2.4;0.7
976;2021-03-07;1;0;6823;2096;2.4;0.7
976;2021-03-08;189;112;7012;2208;2.5;0.8
976;2021-03-09;390;164;7402;2372;2.6;0.8
976;2021-03-10;179;178;7581;2550;2.7;0.9
976;2021-03-11;167;209;7748;2759;2.8;1.0
976;2021-03-12;237;294;7985;3053;2.9;1.1
976;2021-03-13;3;1;7988;3054;2.9;1.1
976;2021-03-14;0;0;7988;3054;2.9;1.1
976;2021-03-15;157;295;8145;3349;2.9;1.2
976;2021-03-16;238;227;8383;3576;3.0;1.3
976;2021-03-17;264;147;8647;3723;3.1;1.3
976;2021-03-18;174;235;8821;3958;3.2;1.4
976;2021-03-19;174;298;8995;4256;3.2;1.5
976;2021-03-20;0;0;8995;4256;3.2;1.5
976;2021-03-21;0;0;8995;4256;3.2;1.5
976;2021-03-22;97;136;9092;4392;3.3;1.6
976;2021-03-23;136;239;9228;4631;3.3;1.7
976;2021-03-24;160;147;9388;4778;3.4;1.7
976;2021-03-25;184;206;9572;4984;3.4;1.8
976;2021-03-26;160;212;9732;5196;3.5;1.9
976;2021-03-27;18;0;9750;5196;3.5;1.9
976;2021-03-28;1;0;9751;5196;3.5;1.9
976;2021-03-29;0;2;9751;5198;3.5;1.9
976;2021-03-30;272;337;10023;5535;3.6;2.0
976;2021-03-31;225;124;10248;5659;3.7;2.0
976;2021-04-01;246;105;10494;5764;3.8;2.1
976;2021-04-02;286;263;10780;6027;3.9;2.2
976;2021-04-03;905;310;11685;6337;4.2;2.3
976;2021-04-04;2;0;11687;6337;4.2;2.3
976;2021-04-05;1;0;11688;6337;4.2;2.3
976;2021-04-06;161;277;11849;6614;4.2;2.4
976;2021-04-07;236;267;12085;6881;4.3;2.5
976;2021-04-08;283;140;12368;7021;4.4;2.5
976;2021-04-09;248;172;12616;7193;4.5;2.6
976;2021-04-10;181;114;12797;7307;4.6;2.6
976;2021-04-11;7;0;12804;7307;4.6;2.6
976;2021-04-12;0;19;12804;7326;4.6;2.6
976;2021-04-13;395;346;13199;7672;4.7;2.7
976;2021-04-14;239;206;13438;7878;4.8;2.8
976;2021-04-15;209;117;13647;7995;4.9;2.9
976;2021-04-16;215;127;13862;8122;5.0;2.9
976;2021-04-17;225;130;14087;8252;5.0;3.0
976;2021-04-18;1;0;14088;8252;5.0;3.0
976;2021-04-19;7;1;14095;8253;5.0;3.0
976;2021-04-20;367;222;14462;8475;5.2;3.0
976;2021-04-21;412;151;14874;8626;5.3;3.1
976;2021-04-22;410;151;15284;8777;5.5;3.1
976;2021-04-23;366;166;15650;8943;5.6;3.2
976;2021-04-24;414;130;16064;9073;5.7;3.2
976;2021-04-25;3;0;16067;9073;5.7;3.2
976;2021-04-26;55;8;16122;9081;5.8;3.2
976;2021-04-27;350;292;16472;9373;5.9;3.4
976;2021-04-28;355;514;16827;9887;6.0;3.5
976;2021-04-29;559;344;17386;10231;6.2;3.7
976;2021-04-30;408;239;17794;10470;6.4;3.7
976;2021-05-01;672;288;18466;10758;6.6;3.8
976;2021-05-02;0;0;18466;10758;6.6;3.8
976;2021-05-03;140;6;18606;10764;6.7;3.9
976;2021-05-04;355;426;18961;11190;6.8;4.0
976;2021-05-05;447;318;19408;11508;6.9;4.1
976;2021-05-06;320;203;19728;11711;7.1;4.2
976;2021-05-07;341;133;20069;11844;7.2;4.2
976;2021-05-08;309;142;20378;11986;7.3;4.3
976;2021-05-09;0;0;20378;11986;7.3;4.3
976;2021-05-10;9;9;20387;11995;7.3;4.3
976;2021-05-11;363;493;20750;12488;7.4;4.5
976;2021-05-12;334;310;21084;12798;7.5;4.6
976;2021-05-13;126;96;21210;12894;7.6;4.6
976;2021-05-14;0;0;21210;12894;7.6;4.6
976;2021-05-15;485;282;21695;13176;7.8;4.7
976;2021-05-16;1;0;21696;13176;7.8;4.7
976;2021-05-17;124;51;21820;13227;7.8;4.7
976;2021-05-18;518;430;22338;13657;8.0;4.9
976;2021-05-19;651;663;22989;14320;8.2;5.1
976;2021-05-20;1056;499;24045;14819;8.6;5.3
976;2021-05-21;1045;313;25090;15132;9.0;5.4
976;2021-05-22;1241;298;26331;15430;9.4;5.5
976;2021-05-23;0;0;26331;15430;9.4;5.5
976;2021-05-24;1;0;26332;15430;9.4;5.5
976;2021-05-25;890;622;27222;16052;9.7;5.7
976;2021-05-26;1033;843;28255;16895;10.1;6.0
976;2021-05-27;1322;512;29577;17407;10.6;6.2
976;2021-05-28;956;375;30533;17782;10.9;6.4
976;2021-05-29;1130;392;31663;18174;11.3;6.5
976;2021-05-30;1;1;31664;18175;11.3;6.5
976;2021-05-31;107;6;31771;18181;11.4;6.5
976;2021-06-01;1149;653;32920;18834;11.8;6.7
976;2021-06-02;1244;532;34164;19366;12.2;6.9
976;2021-06-03;813;355;34977;19721;12.5;7.1
976;2021-06-04;1000;325;35977;20046;12.9;7.2
976;2021-06-05;680;299;36657;20345;13.1;7.3
976;2021-06-06;1;0;36658;20345;13.1;7.3
976;2021-06-07;93;12;36751;20357;13.2;7.3
976;2021-06-08;952;442;37703;20799;13.5;7.4
976;2021-06-09;969;550;38672;21349;13.8;7.6
976;2021-06-10;704;232;39376;21581;14.1;7.7
976;2021-06-11;850;365;40226;21946;14.4;7.9
976;2021-06-12;583;275;40809;22221;14.6;8.0
976;2021-06-13;4;0;40813;22221;14.6;8.0
976;2021-06-14;187;112;41000;22333;14.7;8.0
976;2021-06-15;412;838;41412;23171;14.8;8.3
976;2021-06-16;891;1441;42303;24612;15.1;8.8
976;2021-06-17;799;661;43102;25273;15.4;9.0
976;2021-06-18;705;620;43807;25893;15.7;9.3
976;2021-06-19;537;645;44344;26538;15.9;9.5
976;2021-06-20;1;0;44345;26538;15.9;9.5
976;2021-06-21;127;132;44472;26670;15.9;9.5
976;2021-06-22;430;1150;44902;27820;16.1;10.0
976;2021-06-23;695;1186;45597;29006;16.3;10.4
976;2021-06-24;480;544;46077;29550;16.5;10.6
976;2021-06-25;542;479;46619;30029;16.7;10.7
976;2021-06-26;386;692;47005;30721;16.8;11.0
976;2021-06-27;1;0;47006;30721;16.8;11.0
976;2021-06-28;109;191;47115;30912;16.9;11.1
976;2021-06-29;746;973;47861;31885;17.1;11.4
976;2021-06-30;714;948;48575;32833;17.4;11.7
976;2021-07-01;591;547;49166;33380;17.6;11.9
976;2021-07-02;451;432;49617;33812;17.8;12.1
976;2021-07-03;443;422;50060;34234;17.9;12.2
976;2021-07-04;2;0;50062;34234;17.9;12.2
976;2021-07-05;121;223;50183;34457;18.0;12.3
976;2021-07-06;498;865;50681;35322;18.1;12.6
976;2021-07-07;771;1014;51452;36336;18.4;13.0
976;2021-07-08;836;636;52288;36972;18.7;13.2
976;2021-07-09;786;519;53074;37491;19.0;13.4
976;2021-07-10;441;319;53515;37810;19.1;13.5
976;2021-07-11;0;0;53515;37810;19.1;13.5
976;2021-07-12;164;170;53679;37980;19.2;13.6
976;2021-07-13;847;1000;54526;38980;19.5;13.9
976;2021-07-14;1;5;54527;38985;19.5;13.9
976;2021-07-15;1223;812;55750;39797;19.9;14.2
976;2021-07-16;1291;656;57041;40453;20.4;14.5
976;2021-07-17;1033;377;58074;40830;20.8;14.6
976;2021-07-18;0;0;58074;40830;20.8;14.6
976;2021-07-19;206;134;58280;40964;20.9;14.7
976;2021-07-20;1155;877;59435;41841;21.3;15.0
976;2021-07-21;34;29;59469;41870;21.3;15.0
976;2021-07-22;1123;666;60592;42536;21.7;15.2
976;2021-07-23;1206;545;61798;43081;22.1;15.4
976;2021-07-24;855;440;62653;43521;22.4;15.6
976;2021-07-25;2;0;62655;43521;22.4;15.6
976;2021-07-26;180;37;62835;43558;22.5;15.6
976;2021-07-27;1139;827;63974;44385;22.9;15.9
976;2021-07-28;1046;635;65020;45020;23.3;16.1
976;2021-07-29;1233;566;66253;45586;23.7;16.3
976;2021-07-30;1217;411;67470;45997;24.1;16.5
976;2021-07-31;760;277;68230;46274;24.4;16.6
976;2021-08-01;5;3;68235;46277;24.4;16.6
976;2021-08-02;344;174;68579;46451;24.5;16.6
976;2021-08-03;1508;935;70087;47386;25.1;17.0
976;2021-08-04;1828;809;71915;48195;25.7;17.2
976;2021-08-05;1466;504;73381;48699;26.3;17.4
976;2021-08-06;1698;509;75079;49208;26.9;17.6
976;2021-08-07;912;358;75991;49566;27.2;17.7
976;2021-08-08;7;1;75998;49567;27.2;17.7
976;2021-08-09;539;236;76537;49803;27.4;17.8
976;2021-08-10;1641;1380;78178;51183;28.0;18.3
976;2021-08-11;2044;1242;80222;52425;28.7;18.8
976;2021-08-12;1714;621;81936;53046;29.3;19.0
976;2021-08-13;1575;536;83511;53582;29.9;19.2
976;2021-08-14;834;458;84345;54040;30.2;19.3
976;2021-08-15;0;0;84345;54040;30.2;19.3
976;2021-08-16;569;291;84914;54331;30.4;19.4
976;2021-08-17;1829;1306;86743;55637;31.0;19.9
976;2021-08-18;2234;1229;88977;56866;31.8;20.3
976;2021-08-19;1981;562;90958;57428;32.5;20.5
976;2021-08-20;1817;560;92775;57988;33.2;20.7
976;2021-08-21;1059;531;93834;58519;33.6;20.9
976;2021-08-22;15;0;93849;58519;33.6;20.9
976;2021-08-23;578;271;94427;58790;33.8;21.0
976;2021-08-24;1067;1010;95494;59800;34.2;21.4
976;2021-08-25;1085;1296;96579;61096;34.6;21.9
976;2021-08-26;913;574;97492;61670;34.9;22.1
976;2021-08-27;741;566;98233;62236;35.1;22.3
976;2021-08-28;472;857;98705;63093;35.3;22.6
976;2021-08-29;0;12;98705;63105;35.3;22.6
976;2021-08-30;160;253;98865;63358;35.4;22.7
976;2021-08-31;655;1159;99520;64517;35.6;23.1
976;2021-09-01;821;1392;100341;65909;35.9;23.6
976;2021-09-02;850;903;101191;66812;36.2;23.9
976;2021-09-03;911;1288;102102;68100;36.5;24.4
976;2021-09-04;433;1001;102535;69101;36.7;24.7
976;2021-09-05;0;1;102535;69102;36.7;24.7
976;2021-09-06;445;397;102980;69499;36.8;24.9
976;2021-09-07;743;699;103723;70198;37.1;25.1
976;2021-09-08;1112;1262;104835;71460;37.5;25.6
976;2021-09-09;892;1009;105727;72469;37.8;25.9
976;2021-09-10;1233;1081;106960;73550;38.3;26.3
976;2021-09-11;536;1035;107496;74585;38.5;26.7
976;2021-09-12;1;32;107497;74617;38.5;26.7
976;2021-09-13;708;616;108205;75233;38.7;26.9
976;2021-09-14;1106;719;109311;75952;39.1;27.2
976;2021-09-15;1689;1185;111000;77137;39.7;27.6
976;2021-09-16;1746;894;112746;78031;40.3;27.9
976;2021-09-17;1850;1063;114596;79094;41.0;28.3
976;2021-09-18;977;781;115573;79875;41.4;28.6
976;2021-09-19;2;52;115575;79927;41.4;28.6
976;2021-09-20;1022;543;116597;80470;41.7;28.8
976;2021-09-21;1672;774;118269;81244;42.3;29.1
976;2021-09-22;1469;972;119738;82216;42.8;29.4
976;2021-09-23;1022;879;120760;83095;43.2;29.7
976;2021-09-24;1089;1011;121849;84106;43.6;30.1
976;2021-09-25;489;479;122338;84585;43.8;30.3
976;2021-09-26;0;21;122338;84606;43.8;30.3
976;2021-09-27;691;423;123029;85029;44.0;30.4
976;2021-09-28;1166;924;124195;85953;44.4;30.8
976;2021-09-29;1332;1059;125527;87012;44.9;31.1
976;2021-09-30;996;688;126523;87700;45.3;31.4
976;2021-10-01;1262;1368;127785;89068;45.7;31.9
976;2021-10-02;456;649;128241;89717;45.9;32.1
976;2021-10-03;0;0;128241;89717;45.9;32.1
976;2021-10-04;746;618;128987;90335;46.2;32.3
976;2021-10-05;780;968;129767;91303;46.4;32.7
976;2021-10-06;1204;1405;130971;92708;46.9;33.2
976;2021-10-07;804;1127;131775;93835;47.2;33.6
976;2021-10-08;1258;1393;133033;95228;47.6;34.1
976;2021-10-09;463;857;133496;96085;47.8;34.4
976;2021-10-10;0;0;133496;96085;47.8;34.4
976;2021-10-11;1042;710;134538;96795;48.1;34.6
976;2021-10-12;1350;1475;135888;98270;48.6;35.2
976;2021-10-13;1508;1731;137396;100001;49.2;35.8
976;2021-10-14;1270;1375;138666;101376;49.6;36.3
977;2020-12-27;0;0;0;0;0.0;0.0
977;2020-12-28;0;0;0;0;0.0;0.0
977;2020-12-29;0;0;0;0;0.0;0.0
977;2020-12-30;0;0;0;0;0.0;0.0
977;2020-12-31;0;0;0;0;0.0;0.0
977;2021-01-01;0;0;0;0;0.0;0.0
977;2021-01-02;0;0;0;0;0.0;0.0
977;2021-01-03;0;0;0;0;0.0;0.0
977;2021-01-04;0;0;0;0;0.0;0.0
977;2021-01-05;0;0;0;0;0.0;0.0
977;2021-01-06;0;0;0;0;0.0;0.0
977;2021-01-07;0;0;0;0;0.0;0.0
977;2021-01-08;0;0;0;0;0.0;0.0
977;2021-01-09;0;0;0;0;0.0;0.0
977;2021-01-10;0;0;0;0;0.0;0.0
977;2021-01-11;0;0;0;0;0.0;0.0
977;2021-01-12;0;0;0;0;0.0;0.0
977;2021-01-13;0;0;0;0;0.0;0.0
977;2021-01-14;0;0;0;0;0.0;0.0
977;2021-01-15;0;0;0;0;0.0;0.0
977;2021-01-16;0;0;0;0;0.0;0.0
977;2021-01-17;0;0;0;0;0.0;0.0
977;2021-01-18;1;0;1;0;0.0;0.0
977;2021-01-19;0;0;1;0;0.0;0.0
977;2021-01-20;0;0;1;0;0.0;0.0
977;2021-01-21;12;0;13;0;0.1;0.0
977;2021-01-22;12;0;25;0;0.3;0.0
977;2021-01-23;0;0;25;0;0.3;0.0
977;2021-01-24;0;0;25;0;0.3;0.0
977;2021-01-25;0;0;25;0;0.3;0.0
977;2021-01-26;0;0;25;0;0.3;0.0
977;2021-01-27;12;0;37;0;0.4;0.0
977;2021-01-28;1;0;38;0;0.4;0.0
977;2021-01-29;6;0;44;0;0.4;0.0
977;2021-01-30;0;0;44;0;0.4;0.0
977;2021-01-31;0;0;44;0;0.4;0.0
977;2021-02-01;0;0;44;0;0.4;0.0
977;2021-02-02;0;0;44;0;0.4;0.0
977;2021-02-03;11;0;55;0;0.6;0.0
977;2021-02-04;12;0;67;0;0.7;0.0
977;2021-02-05;11;0;78;0;0.8;0.0
977;2021-02-06;0;0;78;0;0.8;0.0
977;2021-02-07;0;0;78;0;0.8;0.0
977;2021-02-08;0;0;78;0;0.8;0.0
977;2021-02-09;14;0;92;0;0.9;0.0
977;2021-02-10;0;0;92;0;0.9;0.0
977;2021-02-11;18;0;110;0;1.1;0.0
977;2021-02-12;46;0;156;0;1.6;0.0
977;2021-02-13;0;0;156;0;1.6;0.0
977;2021-02-14;0;0;156;0;1.6;0.0
977;2021-02-15;0;0;156;0;1.6;0.0
977;2021-02-16;0;0;156;0;1.6;0.0
977;2021-02-17;0;0;156;0;1.6;0.0
977;2021-02-18;20;0;176;0;1.8;0.0
977;2021-02-19;35;0;211;0;2.1;0.0
977;2021-02-20;0;0;211;0;2.1;0.0
977;2021-02-21;0;0;211;0;2.1;0.0
977;2021-02-22;0;0;211;0;2.1;0.0
977;2021-02-23;0;21;211;21;2.1;0.2
977;2021-02-24;0;0;211;21;2.1;0.2
977;2021-02-25;15;9;226;30;2.3;0.3
977;2021-02-26;33;18;259;48;2.6;0.5
977;2021-02-27;0;0;259;48;2.6;0.5
977;2021-02-28;0;0;259;48;2.6;0.5
977;2021-03-01;0;0;259;48;2.6;0.5
977;2021-03-02;19;11;278;59;2.8;0.6
977;2021-03-03;0;0;278;59;2.8;0.6
977;2021-03-04;16;12;294;71;3.0;0.7
977;2021-03-05;35;18;329;89;3.3;0.9
977;2021-03-06;0;0;329;89;3.3;0.9
977;2021-03-07;0;0;329;89;3.3;0.9
977;2021-03-08;0;0;329;89;3.3;0.9
977;2021-03-09;1;0;330;89;3.3;0.9
977;2021-03-10;0;0;330;89;3.3;0.9
977;2021-03-11;20;30;350;119;3.5;1.2
977;2021-03-12;62;42;412;161;4.1;1.6
977;2021-03-13;0;0;412;161;4.1;1.6
977;2021-03-14;0;0;412;161;4.1;1.6
977;2021-03-15;0;0;412;161;4.1;1.6
977;2021-03-16;30;10;442;171;4.4;1.7
977;2021-03-17;0;0;442;171;4.4;1.7
977;2021-03-18;30;16;472;187;4.7;1.9
977;2021-03-19;58;28;530;215;5.3;2.2
977;2021-03-20;0;0;530;215;5.3;2.2
977;2021-03-21;0;0;530;215;5.3;2.2
977;2021-03-22;0;0;530;215;5.3;2.2
977;2021-03-23;0;0;530;215;5.3;2.2
977;2021-03-24;0;0;530;215;5.3;2.2
977;2021-03-25;65;17;595;232;6.0;2.3
977;2021-03-26;73;26;668;258;6.7;2.6
977;2021-03-27;0;0;668;258;6.7;2.6
977;2021-03-28;0;0;668;258;6.7;2.6
977;2021-03-29;0;0;668;258;6.7;2.6
977;2021-03-30;39;17;707;275;7.1;2.8
977;2021-03-31;26;15;733;290;7.4;2.9
977;2021-04-01;25;32;758;322;7.6;3.2
977;2021-04-02;0;0;758;322;7.6;3.2
977;2021-04-03;0;0;758;322;7.6;3.2
977;2021-04-04;0;0;758;322;7.6;3.2
977;2021-04-05;9;0;767;322;7.7;3.2
977;2021-04-06;0;0;767;322;7.7;3.2
977;2021-04-07;0;0;767;322;7.7;3.2
977;2021-04-08;57;46;824;368;8.3;3.7
977;2021-04-09;58;32;882;400;8.9;4.0
977;2021-04-10;0;0;882;400;8.9;4.0
977;2021-04-11;0;0;882;400;8.9;4.0
977;2021-04-12;0;0;882;400;8.9;4.0
977;2021-04-13;0;0;882;400;8.9;4.0
977;2021-04-14;5;5;887;405;8.9;4.1
977;2021-04-15;57;70;944;475;9.5;4.8
977;2021-04-16;89;35;1033;510;10.4;5.1
977;2021-04-17;0;1;1033;511;10.4;5.1
977;2021-04-18;0;0;1033;511;10.4;5.1
977;2021-04-19;1;0;1034;511;10.4;5.1
977;2021-04-20;335;62;1369;573;13.7;5.8
977;2021-04-21;337;30;1706;603;17.1;6.1
977;2021-04-22;284;48;1990;651;20.0;6.5
977;2021-04-23;260;43;2250;694;22.6;7.0
977;2021-04-24;231;1;2481;695;24.9;7.0
977;2021-04-25;0;0;2481;695;24.9;7.0
977;2021-04-26;284;20;2765;715;27.8;7.2
977;2021-04-27;224;68;2989;783;30.0;7.9
977;2021-04-28;192;26;3181;809;31.9;8.1
977;2021-04-29;170;23;3351;832;33.6;8.4
977;2021-04-30;171;17;3522;849;35.4;8.5
977;2021-05-01;202;12;3724;861;37.4;8.6
977;2021-05-02;0;0;3724;861;37.4;8.6
977;2021-05-03;135;9;3859;870;38.7;8.7
977;2021-05-04;161;54;4020;924;40.4;9.3
977;2021-05-05;221;28;4241;952;42.6;9.6
977;2021-05-06;175;34;4416;986;44.3;9.9
977;2021-05-07;149;32;4565;1018;45.8;10.2
977;2021-05-08;1;0;4566;1018;45.8;10.2
977;2021-05-09;0;0;4566;1018;45.8;10.2
977;2021-05-10;0;0;4566;1018;45.8;10.2
977;2021-05-11;3;41;4569;1059;45.9;10.6
977;2021-05-12;6;36;4575;1095;45.9;11.0
977;2021-05-13;0;0;4575;1095;45.9;11.0
977;2021-05-14;28;98;4603;1193;46.2;12.0
977;2021-05-15;0;0;4603;1193;46.2;12.0
977;2021-05-16;1;0;4604;1193;46.2;12.0
977;2021-05-17;1;14;4605;1207;46.2;12.1
977;2021-05-18;17;32;4622;1239;46.4;12.4
977;2021-05-19;1;2;4623;1241;46.4;12.5
977;2021-05-20;0;8;4623;1249;46.4;12.5
977;2021-05-21;12;31;4635;1280;46.5;12.9
977;2021-05-22;0;0;4635;1280;46.5;12.9
977;2021-05-23;0;0;4635;1280;46.5;12.9
977;2021-05-24;0;0;4635;1280;46.5;12.9
977;2021-05-25;50;331;4685;1611;47.0;16.2
977;2021-05-26;54;360;4739;1971;47.6;19.8
977;2021-05-27;34;317;4773;2288;47.9;23.0
977;2021-05-28;27;256;4800;2544;48.2;25.5
977;2021-05-29;35;375;4835;2919;48.5;29.3
977;2021-05-30;1;0;4836;2919;48.5;29.3
977;2021-05-31;45;216;4881;3135;49.0;31.5
977;2021-06-01;48;227;4929;3362;49.5;33.8
977;2021-06-02;69;273;4998;3635;50.2;36.5
977;2021-06-03;43;252;5041;3887;50.6;39.0
977;2021-06-04;82;270;5123;4157;51.4;41.7
977;2021-06-05;1;0;5124;4157;51.4;41.7
977;2021-06-06;0;0;5124;4157;51.4;41.7
977;2021-06-07;1;1;5125;4158;51.5;41.7
977;2021-06-08;8;2;5133;4160;51.5;41.8
977;2021-06-09;0;3;5133;4163;51.5;41.8
977;2021-06-10;8;4;5141;4167;51.6;41.8
977;2021-06-11;4;8;5145;4175;51.7;41.9
977;2021-06-12;15;59;5160;4234;51.8;42.5
977;2021-06-13;0;0;5160;4234;51.8;42.5
977;2021-06-14;0;0;5160;4234;51.8;42.5
977;2021-06-15;0;1;5160;4235;51.8;42.5
977;2021-06-16;0;0;5160;4235;51.8;42.5
977;2021-06-17;2;6;5162;4241;51.8;42.6
977;2021-06-18;0;2;5162;4243;51.8;42.6
977;2021-06-19;25;49;5187;4292;52.1;43.1
977;2021-06-20;0;0;5187;4292;52.1;43.1
977;2021-06-21;1;2;5188;4294;52.1;43.1
977;2021-06-22;9;0;5197;4294;52.2;43.1
977;2021-06-23;15;9;5212;4303;52.3;43.2
977;2021-06-24;10;5;5222;4308;52.4;43.2
977;2021-06-25;0;0;5222;4308;52.4;43.2
977;2021-06-26;25;45;5247;4353;52.7;43.7
977;2021-06-27;0;0;5247;4353;52.7;43.7
977;2021-06-28;0;0;5247;4353;52.7;43.7
977;2021-06-29;0;0;5247;4353;52.7;43.7
977;2021-06-30;0;0;5247;4353;52.7;43.7
977;2021-07-01;28;36;5275;4389;53.0;44.1
977;2021-07-02;26;31;5301;4420;53.2;44.4
977;2021-07-03;30;215;5331;4635;53.5;46.5
977;2021-07-04;0;0;5331;4635;53.5;46.5
977;2021-07-05;4;8;5335;4643;53.6;46.6
977;2021-07-06;0;0;5335;4643;53.6;46.6
977;2021-07-07;8;0;5343;4643;53.6;46.6
977;2021-07-08;33;23;5376;4666;54.0;46.8
977;2021-07-09;23;31;5399;4697;54.2;47.2
977;2021-07-10;33;45;5432;4742;54.5;47.6
977;2021-07-11;0;0;5432;4742;54.5;47.6
977;2021-07-12;0;1;5432;4743;54.5;47.6
977;2021-07-13;10;10;5442;4753;54.6;47.7
977;2021-07-14;0;0;5442;4753;54.6;47.7
977;2021-07-15;1;11;5443;4764;54.6;47.8
977;2021-07-16;44;51;5487;4815;55.1;48.3
977;2021-07-17;34;39;5521;4854;55.4;48.7
977;2021-07-18;1;0;5522;4854;55.4;48.7
977;2021-07-19;3;2;5525;4856;55.5;48.8
977;2021-07-20;3;1;5528;4857;55.5;48.8
977;2021-07-21;33;16;5561;4873;55.8;48.9
977;2021-07-22;36;33;5597;4906;56.2;49.3
977;2021-07-23;32;31;5629;4937;56.5;49.6
977;2021-07-24;42;25;5671;4962;56.9;49.8
977;2021-07-25;0;0;5671;4962;56.9;49.8
977;2021-07-26;13;10;5684;4972;57.1;49.9
977;2021-07-27;0;10;5684;4982;57.1;50.0
977;2021-07-28;31;14;5715;4996;57.4;50.2
977;2021-07-29;33;32;5748;5028;57.7;50.5
977;2021-07-30;31;28;5779;5056;58.0;50.8
977;2021-07-31;53;24;5832;5080;58.5;51.0
977;2021-08-01;0;0;5832;5080;58.5;51.0
977;2021-08-02;11;1;5843;5081;58.7;51.0
977;2021-08-03;0;0;5843;5081;58.7;51.0
977;2021-08-04;40;14;5883;5095;59.1;51.1
977;2021-08-05;28;30;5911;5125;59.3;51.5
977;2021-08-06;35;35;5946;5160;59.7;51.8
977;2021-08-07;56;25;6002;5185;60.3;52.1
977;2021-08-08;0;0;6002;5185;60.3;52.1
977;2021-08-09;7;5;6009;5190;60.3;52.1
977;2021-08-10;15;9;6024;5199;60.5;52.2
977;2021-08-11;36;18;6060;5217;60.8;52.4
977;2021-08-12;24;30;6084;5247;61.1;52.7
977;2021-08-13;32;14;6116;5261;61.4;52.8
977;2021-08-14;20;26;6136;5287;61.6;53.1
977;2021-08-15;0;0;6136;5287;61.6;53.1
977;2021-08-16;14;29;6150;5316;61.7;53.4
977;2021-08-17;15;8;6165;5324;61.9;53.4
977;2021-08-18;25;28;6190;5352;62.1;53.7
977;2021-08-19;31;36;6221;5388;62.5;54.1
977;2021-08-20;27;41;6248;5429;62.7;54.5
977;2021-08-21;35;41;6283;5470;63.1;54.9
977;2021-08-22;6;0;6289;5470;63.1;54.9
977;2021-08-23;3;11;6292;5481;63.2;55.0
977;2021-08-24;8;3;6300;5484;63.2;55.1
977;2021-08-25;20;37;6320;5521;63.4;55.4
977;2021-08-26;27;41;6347;5562;63.7;55.8
977;2021-08-27;27;35;6374;5597;64.0;56.2
977;2021-08-28;27;56;6401;5653;64.3;56.8
977;2021-08-29;0;0;6401;5653;64.3;56.8
977;2021-08-30;1;4;6402;5657;64.3;56.8
977;2021-08-31;1;2;6403;5659;64.3;56.8
977;2021-09-01;10;25;6413;5684;64.4;57.1
977;2021-09-02;22;32;6435;5716;64.6;57.4
977;2021-09-03;26;24;6461;5740;64.9;57.6
977;2021-09-04;37;44;6498;5784;65.2;58.1
977;2021-09-05;0;0;6498;5784;65.2;58.1
977;2021-09-06;4;16;6502;5800;65.3;58.2
977;2021-09-07;1;4;6503;5804;65.3;58.3
977;2021-09-08;12;11;6515;5815;65.4;58.4
977;2021-09-09;20;31;6535;5846;65.6;58.7
977;2021-09-10;7;31;6542;5877;65.7;59.0
977;2021-09-11;36;29;6578;5906;66.0;59.3
977;2021-09-12;0;6;6578;5912;66.0;59.4
977;2021-09-13;4;3;6582;5915;66.1;59.4
977;2021-09-14;1;0;6583;5915;66.1;59.4
977;2021-09-15;12;26;6595;5941;66.2;59.6
977;2021-09-16;15;31;6610;5972;66.4;60.0
977;2021-09-17;10;33;6620;6005;66.5;60.3
977;2021-09-18;20;39;6640;6044;66.7;60.7
977;2021-09-19;0;0;6640;6044;66.7;60.7
977;2021-09-20;0;2;6640;6046;66.7;60.7
977;2021-09-21;0;1;6640;6047;66.7;60.7
977;2021-09-22;12;11;6652;6058;66.8;60.8
977;2021-09-23;7;30;6659;6088;66.9;61.1
977;2021-09-24;0;0;6659;6088;66.9;61.1
977;2021-09-25;11;49;6670;6137;67.0;61.6
977;2021-09-26;0;0;6670;6137;67.0;61.6
977;2021-09-27;0;0;6670;6137;67.0;61.6
977;2021-09-28;0;1;6670;6138;67.0;61.6
977;2021-09-29;5;15;6675;6153;67.0;61.8
977;2021-09-30;18;19;6693;6172;67.2;62.0
977;2021-10-01;0;3;6693;6175;67.2;62.0
977;2021-10-02;10;39;6703;6214;67.3;62.4
977;2021-10-03;0;0;6703;6214;67.3;62.4
977;2021-10-04;0;0;6703;6214;67.3;62.4
977;2021-10-05;0;0;6703;6214;67.3;62.4
977;2021-10-06;15;23;6718;6237;67.4;62.6
977;2021-10-07;25;31;6743;6268;67.7;62.9
977;2021-10-08;3;2;6746;6270;67.7;62.9
977;2021-10-09;5;15;6751;6285;67.8;63.1
977;2021-10-10;0;0;6751;6285;67.8;63.1
977;2021-10-11;0;1;6751;6286;67.8;63.1
977;2021-10-12;0;0;6751;6286;67.8;63.1
977;2021-10-13;7;21;6758;6307;67.8;63.3
977;2021-10-14;19;16;6777;6323;68.0;63.5
978;2020-12-27;0;0;0;0;0.0;0.0
978;2020-12-28;0;0;0;0;0.0;0.0
978;2020-12-29;0;0;0;0;0.0;0.0
978;2020-12-30;0;0;0;0;0.0;0.0
978;2020-12-31;0;0;0;0;0.0;0.0
978;2021-01-01;0;0;0;0;0.0;0.0
978;2021-01-02;0;0;0;0;0.0;0.0
978;2021-01-03;0;0;0;0;0.0;0.0
978;2021-01-04;0;0;0;0;0.0;0.0
978;2021-01-05;0;0;0;0;0.0;0.0
978;2021-01-06;0;0;0;0;0.0;0.0
978;2021-01-07;0;0;0;0;0.0;0.0
978;2021-01-08;0;0;0;0;0.0;0.0
978;2021-01-09;0;0;0;0;0.0;0.0
978;2021-01-10;0;0;0;0;0.0;0.0
978;2021-01-11;0;0;0;0;0.0;0.0
978;2021-01-12;0;0;0;0;0.0;0.0
978;2021-01-13;10;0;10;0;0.0;0.0
978;2021-01-14;12;1;22;1;0.1;0.0
978;2021-01-15;10;0;32;1;0.1;0.0
978;2021-01-16;0;0;32;1;0.1;0.0
978;2021-01-17;0;0;32;1;0.1;0.0
978;2021-01-18;0;0;32;1;0.1;0.0
978;2021-01-19;12;0;44;1;0.1;0.0
978;2021-01-20;13;0;57;1;0.2;0.0
978;2021-01-21;6;0;63;1;0.2;0.0
978;2021-01-22;0;0;63;1;0.2;0.0
978;2021-01-23;0;0;63;1;0.2;0.0
978;2021-01-24;0;0;63;1;0.2;0.0
978;2021-01-25;0;0;63;1;0.2;0.0
978;2021-01-26;9;0;72;1;0.2;0.0
978;2021-01-27;10;0;82;1;0.2;0.0
978;2021-01-28;6;1;88;2;0.2;0.0
978;2021-01-29;0;0;88;2;0.2;0.0
978;2021-01-30;0;0;88;2;0.2;0.0
978;2021-01-31;0;0;88;2;0.2;0.0
978;2021-02-01;1;0;89;2;0.3;0.0
978;2021-02-02;39;0;128;2;0.4;0.0
978;2021-02-03;11;0;139;2;0.4;0.0
978;2021-02-04;32;0;171;2;0.5;0.0
978;2021-02-05;6;0;177;2;0.5;0.0
978;2021-02-06;0;0;177;2;0.5;0.0
978;2021-02-07;0;0;177;2;0.5;0.0
978;2021-02-08;0;0;177;2;0.5;0.0
978;2021-02-09;38;0;215;2;0.6;0.0
978;2021-02-10;27;1;242;3;0.7;0.0
978;2021-02-11;0;0;242;3;0.7;0.0
978;2021-02-12;36;0;278;3;0.8;0.0
978;2021-02-13;0;0;278;3;0.8;0.0
978;2021-02-14;0;0;278;3;0.8;0.0
978;2021-02-15;50;1;328;4;0.9;0.0
978;2021-02-16;0;0;328;4;0.9;0.0
978;2021-02-17;0;0;328;4;0.9;0.0
978;2021-02-18;28;0;356;4;1.0;0.0
978;2021-02-19;44;0;400;4;1.1;0.0
978;2021-02-20;0;0;400;4;1.1;0.0
978;2021-02-21;0;0;400;4;1.1;0.0
978;2021-02-22;45;4;445;8;1.3;0.0
978;2021-02-23;41;29;486;37;1.4;0.1
978;2021-02-24;36;1;522;38;1.5;0.1
978;2021-02-25;55;36;577;74;1.6;0.2
978;2021-02-26;39;5;616;79;1.7;0.2
978;2021-02-27;0;0;616;79;1.7;0.2
978;2021-02-28;0;0;616;79;1.7;0.2
978;2021-03-01;50;5;666;84;1.9;0.2
978;2021-03-02;7;27;673;111;1.9;0.3
978;2021-03-03;53;29;726;140;2.1;0.4
978;2021-03-04;31;26;757;166;2.1;0.5
978;2021-03-05;46;10;803;176;2.3;0.5
978;2021-03-06;0;0;803;176;2.3;0.5
978;2021-03-07;0;0;803;176;2.3;0.5
978;2021-03-08;32;7;835;183;2.4;0.5
978;2021-03-09;21;27;856;210;2.4;0.6
978;2021-03-10;35;28;891;238;2.5;0.7
978;2021-03-11;2;0;893;238;2.5;0.7
978;2021-03-12;53;22;946;260;2.7;0.7
978;2021-03-13;13;0;959;260;2.7;0.7
978;2021-03-14;0;0;959;260;2.7;0.7
978;2021-03-15;31;41;990;301;2.8;0.9
978;2021-03-16;73;6;1063;307;3.0;0.9
978;2021-03-17;67;13;1130;320;3.2;0.9
978;2021-03-18;82;39;1212;359;3.4;1.0
978;2021-03-19;32;50;1244;409;3.5;1.2
978;2021-03-20;0;0;1244;409;3.5;1.2
978;2021-03-21;0;0;1244;409;3.5;1.2
978;2021-03-22;35;45;1279;454;3.6;1.3
978;2021-03-23;30;43;1309;497;3.7;1.4
978;2021-03-24;38;42;1347;539;3.8;1.5
978;2021-03-25;97;34;1444;573;4.1;1.6
978;2021-03-26;45;33;1489;606;4.2;1.7
978;2021-03-27;94;3;1583;609;4.5;1.7
978;2021-03-28;0;0;1583;609;4.5;1.7
978;2021-03-29;69;48;1652;657;4.7;1.9
978;2021-03-30;99;25;1751;682;5.0;1.9
978;2021-03-31;91;49;1842;731;5.2;2.1
978;2021-04-01;57;48;1899;779;5.4;2.2
978;2021-04-02;0;0;1899;779;5.4;2.2
978;2021-04-03;1;0;1900;779;5.4;2.2
978;2021-04-04;0;0;1900;779;5.4;2.2
978;2021-04-05;2;0;1902;779;5.4;2.2
978;2021-04-06;49;63;1951;842;5.5;2.4
978;2021-04-07;93;33;2044;875;5.8;2.5
978;2021-04-08;122;7;2166;882;6.1;2.5
978;2021-04-09;91;40;2257;922;6.4;2.6
978;2021-04-10;170;13;2427;935;6.9;2.6
978;2021-04-11;0;0;2427;935;6.9;2.6
978;2021-04-12;42;75;2469;1010;7.0;2.9
978;2021-04-13;49;71;2518;1081;7.1;3.1
978;2021-04-14;82;45;2600;1126;7.4;3.2
978;2021-04-15;92;22;2692;1148;7.6;3.2
978;2021-04-16;77;43;2769;1191;7.8;3.4
978;2021-04-17;165;5;2934;1196;8.3;3.4
978;2021-04-18;0;0;2934;1196;8.3;3.4
978;2021-04-19;52;67;2986;1263;8.5;3.6
978;2021-04-20;83;27;3069;1290;8.7;3.7
978;2021-04-21;91;28;3160;1318;8.9;3.7
978;2021-04-22;101;20;3261;1338;9.2;3.8
978;2021-04-23;45;66;3306;1404;9.4;4.0
978;2021-04-24;99;78;3405;1482;9.6;4.2
978;2021-04-25;0;0;3405;1482;9.6;4.2
978;2021-04-26;29;91;3434;1573;9.7;4.5
978;2021-04-27;59;63;3493;1636;9.9;4.6
978;2021-04-28;93;40;3586;1676;10.1;4.7
978;2021-04-29;89;31;3675;1707;10.4;4.8
978;2021-04-30;103;14;3778;1721;10.7;4.9
978;2021-05-01;0;8;3778;1729;10.7;4.9
978;2021-05-02;0;0;3778;1729;10.7;4.9
978;2021-05-03;25;99;3803;1828;10.8;5.2
978;2021-05-04;159;102;3962;1930;11.2;5.5
978;2021-05-05;142;59;4104;1989;11.6;5.6
978;2021-05-06;199;49;4303;2038;12.2;5.8
978;2021-05-07;127;71;4430;2109;12.5;6.0
978;2021-05-08;69;122;4499;2231;12.7;6.3
978;2021-05-09;0;0;4499;2231;12.7;6.3
978;2021-05-10;124;100;4623;2331;13.1;6.6
978;2021-05-11;132;72;4755;2403;13.5;6.8
978;2021-05-12;155;78;4910;2481;13.9;7.0
978;2021-05-13;83;6;4993;2487;14.1;7.0
978;2021-05-14;130;62;5123;2549;14.5;7.2
978;2021-05-15;86;4;5209;2553;14.7;7.2
978;2021-05-16;0;0;5209;2553;14.7;7.2
978;2021-05-17;146;115;5355;2668;15.2;7.6
978;2021-05-18;151;94;5506;2762;15.6;7.8
978;2021-05-19;84;69;5590;2831;15.8;8.0
978;2021-05-20;104;26;5694;2857;16.1;8.1
978;2021-05-21;98;52;5792;2909;16.4;8.2
978;2021-05-22;99;11;5891;2920;16.7;8.3
978;2021-05-23;0;0;5891;2920;16.7;8.3
978;2021-05-24;33;7;5924;2927;16.8;8.3
978;2021-05-25;119;78;6043;3005;17.1;8.5
978;2021-05-26;108;49;6151;3054;17.4;8.6
978;2021-05-27;112;42;6263;3096;17.7;8.8
978;2021-05-28;33;1;6296;3097;17.8;8.8
978;2021-05-29;60;213;6356;3310;18.0;9.4
978;2021-05-30;0;0;6356;3310;18.0;9.4
978;2021-05-31;111;63;6467;3373;18.3;9.5
978;2021-06-01;116;62;6583;3435;18.6;9.7
978;2021-06-02;131;33;6714;3468;19.0;9.8
978;2021-06-03;101;38;6815;3506;19.3;9.9
978;2021-06-04;128;70;6943;3576;19.6;10.1
978;2021-06-05;83;21;7026;3597;19.9;10.2
978;2021-06-06;0;0;7026;3597;19.9;10.2
978;2021-06-07;96;96;7122;3693;20.2;10.5
978;2021-06-08;82;89;7204;3782;20.4;10.7
978;2021-06-09;99;73;7303;3855;20.7;10.9
978;2021-06-10;112;63;7415;3918;21.0;11.1
978;2021-06-11;116;106;7531;4024;21.3;11.4
978;2021-06-12;57;30;7588;4054;21.5;11.5
978;2021-06-13;0;0;7588;4054;21.5;11.5
978;2021-06-14;105;127;7693;4181;21.8;11.8
978;2021-06-15;88;120;7781;4301;22.0;12.2
978;2021-06-16;105;148;7886;4449;22.3;12.6
978;2021-06-17;85;72;7971;4521;22.6;12.8
978;2021-06-18;67;98;8038;4619;22.7;13.1
978;2021-06-19;65;79;8103;4698;22.9;13.3
978;2021-06-20;0;0;8103;4698;22.9;13.3
978;2021-06-21;78;150;8181;4848;23.2;13.7
978;2021-06-22;71;103;8252;4951;23.4;14.0
978;2021-06-23;68;115;8320;5066;23.5;14.3
978;2021-06-24;43;75;8363;5141;23.7;14.5
978;2021-06-25;64;100;8427;5241;23.8;14.8
978;2021-06-26;35;61;8462;5302;23.9;15.0
978;2021-06-27;0;0;8462;5302;23.9;15.0
978;2021-06-28;73;131;8535;5433;24.2;15.4
978;2021-06-29;62;104;8597;5537;24.3;15.7
978;2021-06-30;56;110;8653;5647;24.5;16.0
978;2021-07-01;42;87;8695;5734;24.6;16.2
978;2021-07-02;52;90;8747;5824;24.8;16.5
978;2021-07-03;40;90;8787;5914;24.9;16.7
978;2021-07-04;0;1;8787;5915;24.9;16.7
978;2021-07-05;67;93;8854;6008;25.1;17.0
978;2021-07-06;55;74;8909;6082;25.2;17.2
978;2021-07-07;55;123;8964;6205;25.4;17.6
978;2021-07-08;54;107;9018;6312;25.5;17.9
978;2021-07-09;45;92;9063;6404;25.6;18.1
978;2021-07-10;38;85;9101;6489;25.8;18.4
978;2021-07-11;0;4;9101;6493;25.8;18.4
978;2021-07-12;71;130;9172;6623;26.0;18.7
978;2021-07-13;146;162;9318;6785;26.4;19.2
978;2021-07-14;3;0;9321;6785;26.4;19.2
978;2021-07-15;161;195;9482;6980;26.8;19.8
978;2021-07-16;113;113;9595;7093;27.2;20.1
978;2021-07-17;52;100;9647;7193;27.3;20.4
978;2021-07-18;0;0;9647;7193;27.3;20.4
978;2021-07-19;99;133;9746;7326;27.6;20.7
978;2021-07-20;80;74;9826;7400;27.8;20.9
978;2021-07-21;63;50;9889;7450;28.0;21.1
978;2021-07-22;97;114;9986;7564;28.3;21.4
978;2021-07-23;67;98;10053;7662;28.5;21.7
978;2021-07-24;20;35;10073;7697;28.5;21.8
978;2021-07-25;0;0;10073;7697;28.5;21.8
978;2021-07-26;100;116;10173;7813;28.8;22.1
978;2021-07-27;72;144;10245;7957;29.0;22.5
978;2021-07-28;72;126;10317;8083;29.2;22.9
978;2021-07-29;80;98;10397;8181;29.4;23.2
978;2021-07-30;82;115;10479;8296;29.7;23.5
978;2021-07-31;49;68;10528;8364;29.8;23.7
978;2021-08-01;0;0;10528;8364;29.8;23.7
978;2021-08-02;65;95;10593;8459;30.0;23.9
978;2021-08-03;60;94;10653;8553;30.1;24.2
978;2021-08-04;64;55;10717;8608;30.3;24.4
978;2021-08-05;48;70;10765;8678;30.5;24.6
978;2021-08-06;73;127;10838;8805;30.7;24.9
978;2021-08-07;44;46;10882;8851;30.8;25.0
978;2021-08-08;0;0;10882;8851;30.8;25.0
978;2021-08-09;138;150;11020;9001;31.2;25.5
978;2021-08-10;81;93;11101;9094;31.4;25.7
978;2021-08-11;106;99;11207;9193;31.7;26.0
978;2021-08-12;99;99;11306;9292;32.0;26.3
978;2021-08-13;132;75;11438;9367;32.4;26.5
978;2021-08-14;74;100;11512;9467;32.6;26.8
978;2021-08-15;0;0;11512;9467;32.6;26.8
978;2021-08-16;45;72;11557;9539;32.7;27.0
978;2021-08-17;33;33;11590;9572;32.8;27.1
978;2021-08-18;35;55;11625;9627;32.9;27.2
978;2021-08-19;34;26;11659;9653;33.0;27.3
978;2021-08-20;46;61;11705;9714;33.1;27.5
978;2021-08-21;0;0;11705;9714;33.1;27.5
978;2021-08-22;0;0;11705;9714;33.1;27.5
978;2021-08-23;51;87;11756;9801;33.3;27.7
978;2021-08-24;31;53;11787;9854;33.4;27.9
978;2021-08-25;26;51;11813;9905;33.4;28.0
978;2021-08-26;31;26;11844;9931;33.5;28.1
978;2021-08-27;47;88;11891;10019;33.7;28.4
978;2021-08-28;3;0;11894;10019;33.7;28.4
978;2021-08-29;0;0;11894;10019;33.7;28.4
978;2021-08-30;39;113;11933;10132;33.8;28.7
978;2021-08-31;46;80;11979;10212;33.9;28.9
978;2021-09-01;31;84;12010;10296;34.0;29.1
978;2021-09-02;39;70;12049;10366;34.1;29.3
978;2021-09-03;16;94;12065;10460;34.1;29.6
978;2021-09-04;0;0;12065;10460;34.1;29.6
978;2021-09-05;0;0;12065;10460;34.1;29.6
978;2021-09-06;32;77;12097;10537;34.2;29.8
978;2021-09-07;37;45;12134;10582;34.3;29.9
978;2021-09-08;21;42;12155;10624;34.4;30.1
978;2021-09-09;21;51;12176;10675;34.5;30.2
978;2021-09-10;43;75;12219;10750;34.6;30.4
978;2021-09-11;1;0;12220;10750;34.6;30.4
978;2021-09-12;5;1;12225;10751;34.6;30.4
978;2021-09-13;34;53;12259;10804;34.7;30.6
978;2021-09-14;23;27;12282;10831;34.8;30.7
978;2021-09-15;25;43;12307;10874;34.8;30.8
978;2021-09-16;8;33;12315;10907;34.9;30.9
978;2021-09-17;13;45;12328;10952;34.9;31.0
978;2021-09-18;0;0;12328;10952;34.9;31.0
978;2021-09-19;0;0;12328;10952;34.9;31.0
978;2021-09-20;13;35;12341;10987;34.9;31.1
978;2021-09-21;15;37;12356;11024;35.0;31.2
978;2021-09-22;13;34;12369;11058;35.0;31.3
978;2021-09-23;26;41;12395;11099;35.1;31.4
978;2021-09-24;19;27;12414;11126;35.1;31.5
978;2021-09-25;0;1;12414;11127;35.1;31.5
978;2021-09-26;0;0;12414;11127;35.1;31.5
978;2021-09-27;11;31;12425;11158;35.2;31.6
978;2021-09-28;19;25;12444;11183;35.2;31.6
978;2021-09-29;20;25;12464;11208;35.3;31.7
978;2021-09-30;23;23;12487;11231;35.3;31.8
978;2021-10-01;25;37;12512;11268;35.4;31.9
978;2021-10-02;0;0;12512;11268;35.4;31.9
978;2021-10-03;0;0;12512;11268;35.4;31.9
978;2021-10-04;22;27;12534;11295;35.5;32.0
978;2021-10-05;15;16;12549;11311;35.5;32.0
978;2021-10-06;12;16;12561;11327;35.5;32.1
978;2021-10-07;11;15;12572;11342;35.6;32.1
978;2021-10-08;16;15;12588;11357;35.6;32.1
978;2021-10-09;0;0;12588;11357;35.6;32.1
978;2021-10-10;0;0;12588;11357;35.6;32.1
978;2021-10-11;25;22;12613;11379;35.7;32.2
978;2021-10-12;24;29;12637;11408;35.8;32.3
978;2021-10-13;13;18;12650;11426;35.8;32.3
978;2021-10-14;37;28;12687;11454;35.9;32.4
