reg;jour;n_dose1;n_complet;n_cum_dose1;n_cum_complet;couv_dose1;couv_complet
01;2020-12-27;0;0;0;0;0.0;0.0
01;2020-12-28;0;0;0;0;0.0;0.0
01;2020-12-29;0;0;0;0;0.0;0.0
01;2020-12-30;0;0;0;0;0.0;0.0
01;2020-12-31;0;0;0;0;0.0;0.0
01;2021-01-01;1;0;1;0;0.0;0.0
01;2021-01-02;0;0;1;0;0.0;0.0
01;2021-01-03;0;0;1;0;0.0;0.0
01;2021-01-04;1;0;2;0;0.0;0.0
01;2021-01-05;0;0;2;0;0.0;0.0
01;2021-01-06;0;0;2;0;0.0;0.0
01;2021-01-07;0;0;2;0;0.0;0.0
01;2021-01-08;35;0;37;0;0.0;0.0
01;2021-01-09;18;0;55;0;0.0;0.0
01;2021-01-10;0;0;55;0;0.0;0.0
01;2021-01-11;52;0;107;0;0.0;0.0
01;2021-01-12;39;0;146;0;0.0;0.0
01;2021-01-13;45;0;191;0;0.1;0.0
01;2021-01-14;60;0;251;0;0.1;0.0
01;2021-01-15;76;0;327;0;0.1;0.0
01;2021-01-16;0;0;327;0;0.1;0.0
01;2021-01-17;0;0;327;0;0.1;0.0
01;2021-01-18;75;0;402;0;0.1;0.0
01;2021-01-19;137;0;539;0;0.1;0.0
01;2021-01-20;134;0;673;0;0.2;0.0
01;2021-01-21;146;1;819;1;0.2;0.0
01;2021-01-22;131;0;950;1;0.3;0.0
01;2021-01-23;1;0;951;1;0.3;0.0
01;2021-01-24;0;0;951;1;0.3;0.0
01;2021-01-25;203;0;1154;1;0.3;0.0
01;2021-01-26;199;1;1353;2;0.4;0.0
01;2021-01-27;232;0;1585;2;0.4;0.0
01;2021-01-28;228;3;1813;5;0.5;0.0
01;2021-01-29;197;1;2010;6;0.5;0.0
01;2021-01-30;16;0;2026;6;0.5;0.0
01;2021-01-31;1;0;2027;6;0.5;0.0
01;2021-02-01;220;4;2247;10;0.6;0.0
01;2021-02-02;240;25;2487;35;0.7;0.0
01;2021-02-03;207;2;2694;37;0.7;0.0
01;2021-02-04;297;20;2991;57;0.8;0.0
01;2021-02-05;244;32;3235;89;0.9;0.0
01;2021-02-06;46;1;3281;90;0.9;0.0
01;2021-02-07;0;0;3281;90;0.9;0.0
01;2021-02-08;215;23;3496;113;0.9;0.0
01;2021-02-09;283;29;3779;142;1.0;0.0
01;2021-02-10;214;29;3993;171;1.1;0.0
01;2021-02-11;291;109;4284;280;1.1;0.1
01;2021-02-12;283;24;4567;304;1.2;0.1
01;2021-02-13;49;7;4616;311;1.2;0.1
01;2021-02-14;19;36;4635;347;1.2;0.1
01;2021-02-15;66;45;4701;392;1.2;0.1
01;2021-02-16;16;1;4717;393;1.3;0.1
01;2021-02-17;17;1;4734;394;1.3;0.1
01;2021-02-18;210;17;4944;411;1.3;0.1
01;2021-02-19;221;20;5165;431;1.4;0.1
01;2021-02-20;47;0;5212;431;1.4;0.1
01;2021-02-21;1;0;5213;431;1.4;0.1
01;2021-02-22;149;63;5362;494;1.4;0.1
01;2021-02-23;186;73;5548;567;1.5;0.2
01;2021-02-24;304;126;5852;693;1.6;0.2
01;2021-02-25;364;79;6216;772;1.6;0.2
01;2021-02-26;164;83;6380;855;1.7;0.2
01;2021-02-27;63;0;6443;855;1.7;0.2
01;2021-02-28;1;0;6444;855;1.7;0.2
01;2021-03-01;127;81;6571;936;1.7;0.2
01;2021-03-02;236;131;6807;1067;1.8;0.3
01;2021-03-03;194;118;7001;1185;1.9;0.3
01;2021-03-04;296;84;7297;1269;1.9;0.3
01;2021-03-05;311;141;7608;1410;2.0;0.4
01;2021-03-06;572;3;8180;1413;2.2;0.4
01;2021-03-07;1;0;8181;1413;2.2;0.4
01;2021-03-08;263;137;8444;1550;2.2;0.4
01;2021-03-09;348;150;8792;1700;2.3;0.5
01;2021-03-10;348;160;9140;1860;2.4;0.5
01;2021-03-11;119;45;9259;1905;2.5;0.5
01;2021-03-12;367;212;9626;2117;2.6;0.6
01;2021-03-13;129;2;9755;2119;2.6;0.6
01;2021-03-14;13;23;9768;2142;2.6;0.6
01;2021-03-15;400;43;10168;2185;2.7;0.6
01;2021-03-16;435;78;10603;2263;2.8;0.6
01;2021-03-17;411;83;11014;2346;2.9;0.6
01;2021-03-18;532;109;11546;2455;3.1;0.7
01;2021-03-19;515;98;12061;2553;3.2;0.7
01;2021-03-20;173;44;12234;2597;3.2;0.7
01;2021-03-21;8;0;12242;2597;3.2;0.7
01;2021-03-22;331;87;12573;2684;3.3;0.7
01;2021-03-23;479;156;13052;2840;3.5;0.8
01;2021-03-24;452;107;13504;2947;3.6;0.8
01;2021-03-25;727;178;14231;3125;3.8;0.8
01;2021-03-26;630;120;14861;3245;3.9;0.9
01;2021-03-27;262;48;15123;3293;4.0;0.9
01;2021-03-28;7;0;15130;3293;4.0;0.9
01;2021-03-29;360;81;15490;3374;4.1;0.9
01;2021-03-30;593;162;16083;3536;4.3;0.9
01;2021-03-31;511;126;16594;3662;4.4;1.0
01;2021-04-01;616;200;17210;3862;4.6;1.0
01;2021-04-02;38;35;17248;3897;4.6;1.0
01;2021-04-03;41;2;17289;3899;4.6;1.0
01;2021-04-04;4;18;17293;3917;4.6;1.0
01;2021-04-05;4;0;17297;3917;4.6;1.0
01;2021-04-06;411;187;17708;4104;4.7;1.1
01;2021-04-07;563;114;18271;4218;4.8;1.1
01;2021-04-08;470;159;18741;4377;5.0;1.2
01;2021-04-09;458;209;19199;4586;5.1;1.2
01;2021-04-10;97;4;19296;4590;5.1;1.2
01;2021-04-11;2;25;19298;4615;5.1;1.2
01;2021-04-12;273;257;19571;4872;5.2;1.3
01;2021-04-13;541;318;20112;5190;5.3;1.4
01;2021-04-14;412;221;20524;5411;5.4;1.4
01;2021-04-15;541;316;21065;5727;5.6;1.5
01;2021-04-16;543;266;21608;5993;5.7;1.6
01;2021-04-17;183;2;21791;5995;5.8;1.6
01;2021-04-18;4;14;21795;6009;5.8;1.6
01;2021-04-19;383;238;22178;6247;5.9;1.7
01;2021-04-20;706;342;22884;6589;6.1;1.7
01;2021-04-21;607;309;23491;6898;6.2;1.8
01;2021-04-22;789;329;24280;7227;6.4;1.9
01;2021-04-23;836;248;25116;7475;6.7;2.0
01;2021-04-24;332;74;25448;7549;6.8;2.0
01;2021-04-25;595;64;26043;7613;6.9;2.0
01;2021-04-26;935;209;26978;7822;7.2;2.1
01;2021-04-27;624;226;27602;8048;7.3;2.1
01;2021-04-28;829;262;28431;8310;7.5;2.2
01;2021-04-29;1188;187;29619;8497;7.9;2.3
01;2021-04-30;1245;165;30864;8662;8.2;2.3
01;2021-05-01;592;38;31456;8700;8.3;2.3
01;2021-05-02;339;15;31795;8715;8.4;2.3
01;2021-05-03;915;168;32710;8883;8.7;2.4
01;2021-05-04;936;194;33646;9077;8.9;2.4
01;2021-05-05;959;241;34605;9318;9.2;2.5
01;2021-05-06;1106;165;35711;9483;9.5;2.5
01;2021-05-07;1203;256;36914;9739;9.8;2.6
01;2021-05-08;312;29;37226;9768;9.9;2.6
01;2021-05-09;178;8;37404;9776;9.9;2.6
01;2021-05-10;828;208;38232;9984;10.1;2.6
01;2021-05-11;921;307;39153;10291;10.4;2.7
01;2021-05-12;879;320;40032;10611;10.6;2.8
01;2021-05-13;208;80;40240;10691;10.7;2.8
01;2021-05-14;845;269;41085;10960;10.9;2.9
01;2021-05-15;436;13;41521;10973;11.0;2.9
01;2021-05-16;180;34;41701;11007;11.1;2.9
01;2021-05-17;694;268;42395;11275;11.2;3.0
01;2021-05-18;692;388;43087;11663;11.4;3.1
01;2021-05-19;672;520;43759;12183;11.6;3.2
01;2021-05-20;748;364;44507;12547;11.8;3.3
01;2021-05-21;786;398;45293;12945;12.0;3.4
01;2021-05-22;474;217;45767;13162;12.1;3.5
01;2021-05-23;197;115;45964;13277;12.2;3.5
01;2021-05-24;194;176;46158;13453;12.2;3.6
01;2021-05-25;477;664;46635;14117;12.4;3.7
01;2021-05-26;548;494;47183;14611;12.5;3.9
01;2021-05-27;127;185;47310;14796;12.6;3.9
01;2021-05-28;471;521;47781;15317;12.7;4.1
01;2021-05-29;220;138;48001;15455;12.7;4.1
01;2021-05-30;71;111;48072;15566;12.8;4.1
01;2021-05-31;410;536;48482;16102;12.9;4.3
01;2021-06-01;476;714;48958;16816;13.0;4.5
01;2021-06-02;475;708;49433;17524;13.1;4.6
01;2021-06-03;407;561;49840;18085;13.2;4.8
01;2021-06-04;601;799;50441;18884;13.4;5.0
01;2021-06-05;264;641;50705;19525;13.5;5.2
01;2021-06-06;121;530;50826;20055;13.5;5.3
01;2021-06-07;340;783;51166;20838;13.6;5.5
01;2021-06-08;486;891;51652;21729;13.7;5.8
01;2021-06-09;378;858;52030;22587;13.8;6.0
01;2021-06-10;454;850;52484;23437;13.9;6.2
01;2021-06-11;439;1229;52923;24666;14.0;6.5
01;2021-06-12;289;660;53212;25326;14.1;6.7
01;2021-06-13;129;314;53341;25640;14.2;6.8
01;2021-06-14;349;3807;53690;29447;14.2;7.8
01;2021-06-15;445;2010;54135;31457;14.4;8.3
01;2021-06-16;445;1490;54580;32947;14.5;8.7
01;2021-06-17;409;1009;54989;33956;14.6;9.0
01;2021-06-18;451;1016;55440;34972;14.7;9.3
01;2021-06-19;294;507;55734;35479;14.8;9.4
01;2021-06-20;107;232;55841;35711;14.8;9.5
01;2021-06-21;299;680;56140;36391;14.9;9.7
02;2020-12-27;0;0;0;0;0.0;0.0
02;2020-12-28;0;0;0;0;0.0;0.0
02;2020-12-29;0;0;0;0;0.0;0.0
02;2020-12-30;0;0;0;0;0.0;0.0
02;2020-12-31;0;0;0;0;0.0;0.0
02;2021-01-01;0;0;0;0;0.0;0.0
02;2021-01-02;0;0;0;0;0.0;0.0
02;2021-01-03;0;0;0;0;0.0;0.0
02;2021-01-04;0;0;0;0;0.0;0.0
02;2021-01-05;0;0;0;0;0.0;0.0
02;2021-01-06;5;0;5;0;0.0;0.0
02;2021-01-07;31;0;36;0;0.0;0.0
02;2021-01-08;80;1;116;1;0.0;0.0
02;2021-01-09;20;0;136;1;0.0;0.0
02;2021-01-10;0;0;136;1;0.0;0.0
02;2021-01-11;122;0;258;1;0.1;0.0
02;2021-01-12;78;0;336;1;0.1;0.0
02;2021-01-13;64;0;400;1;0.1;0.0
02;2021-01-14;88;1;488;2;0.1;0.0
02;2021-01-15;136;0;624;2;0.2;0.0
02;2021-01-16;51;0;675;2;0.2;0.0
02;2021-01-17;0;0;675;2;0.2;0.0
02;2021-01-18;157;0;832;2;0.2;0.0
02;2021-01-19;168;0;1000;2;0.3;0.0
02;2021-01-20;163;0;1163;2;0.3;0.0
02;2021-01-21;181;1;1344;3;0.4;0.0
02;2021-01-22;156;0;1500;3;0.4;0.0
02;2021-01-23;58;0;1558;3;0.4;0.0
02;2021-01-24;0;0;1558;3;0.4;0.0
02;2021-01-25;159;0;1717;3;0.5;0.0
02;2021-01-26;137;0;1854;3;0.5;0.0
02;2021-01-27;161;5;2015;8;0.6;0.0
02;2021-01-28;143;12;2158;20;0.6;0.0
02;2021-01-29;142;41;2300;61;0.6;0.0
02;2021-01-30;96;16;2396;77;0.7;0.0
02;2021-01-31;0;0;2396;77;0.7;0.0
02;2021-02-01;119;74;2515;151;0.7;0.0
02;2021-02-02;184;95;2699;246;0.8;0.1
02;2021-02-03;130;80;2829;326;0.8;0.1
02;2021-02-04;158;73;2987;399;0.8;0.1
02;2021-02-05;120;97;3107;496;0.9;0.1
02;2021-02-06;62;26;3169;522;0.9;0.1
02;2021-02-07;1;0;3170;522;0.9;0.1
02;2021-02-08;136;80;3306;602;0.9;0.2
02;2021-02-09;175;78;3481;680;1.0;0.2
02;2021-02-10;138;90;3619;770;1.0;0.2
02;2021-02-11;150;103;3769;873;1.1;0.2
02;2021-02-12;124;128;3893;1001;1.1;0.3
02;2021-02-13;38;37;3931;1038;1.1;0.3
02;2021-02-14;0;0;3931;1038;1.1;0.3
02;2021-02-15;51;67;3982;1105;1.1;0.3
02;2021-02-16;0;1;3982;1106;1.1;0.3
02;2021-02-17;1;3;3983;1109;1.1;0.3
02;2021-02-18;68;128;4051;1237;1.1;0.3
02;2021-02-19;69;131;4120;1368;1.1;0.4
02;2021-02-20;48;69;4168;1437;1.2;0.4
02;2021-02-21;0;0;4168;1437;1.2;0.4
02;2021-02-22;100;60;4268;1497;1.2;0.4
02;2021-02-23;113;238;4381;1735;1.2;0.5
02;2021-02-24;106;223;4487;1958;1.3;0.5
02;2021-02-25;89;151;4576;2109;1.3;0.6
02;2021-02-26;126;169;4702;2278;1.3;0.6
02;2021-02-27;69;52;4771;2330;1.3;0.6
02;2021-02-28;0;0;4771;2330;1.3;0.6
02;2021-03-01;138;144;4909;2474;1.4;0.7
02;2021-03-02;158;78;5067;2552;1.4;0.7
02;2021-03-03;178;145;5245;2697;1.5;0.8
02;2021-03-04;146;134;5391;2831;1.5;0.8
02;2021-03-05;238;127;5629;2958;1.6;0.8
02;2021-03-06;119;59;5748;3017;1.6;0.8
02;2021-03-07;100;1;5848;3018;1.6;0.8
02;2021-03-08;196;132;6044;3150;1.7;0.9
02;2021-03-09;269;102;6313;3252;1.8;0.9
02;2021-03-10;324;134;6637;3386;1.9;0.9
02;2021-03-11;331;83;6968;3469;1.9;1.0
02;2021-03-12;398;53;7366;3522;2.1;1.0
02;2021-03-13;155;21;7521;3543;2.1;1.0
02;2021-03-14;4;1;7525;3544;2.1;1.0
02;2021-03-15;276;92;7801;3636;2.2;1.0
02;2021-03-16;305;55;8106;3691;2.3;1.0
02;2021-03-17;387;49;8493;3740;2.4;1.0
02;2021-03-18;435;44;8928;3784;2.5;1.1
02;2021-03-19;396;61;9324;3845;2.6;1.1
02;2021-03-20;149;47;9473;3892;2.6;1.1
02;2021-03-21;25;1;9498;3893;2.6;1.1
02;2021-03-22;362;116;9860;4009;2.7;1.1
02;2021-03-23;401;123;10261;4132;2.9;1.2
02;2021-03-24;425;104;10686;4236;3.0;1.2
02;2021-03-25;470;99;11156;4335;3.1;1.2
02;2021-03-26;632;100;11788;4435;3.3;1.2
02;2021-03-27;152;71;11940;4506;3.3;1.3
02;2021-03-28;81;2;12021;4508;3.4;1.3
02;2021-03-29;421;165;12442;4673;3.5;1.3
02;2021-03-30;468;244;12910;4917;3.6;1.4
02;2021-03-31;1143;187;14053;5104;3.9;1.4
02;2021-04-01;951;169;15004;5273;4.2;1.5
02;2021-04-02;895;7;15899;5280;4.4;1.5
02;2021-04-03;787;49;16686;5329;4.7;1.5
02;2021-04-04;750;10;17436;5339;4.9;1.5
02;2021-04-05;828;39;18264;5378;5.1;1.5
02;2021-04-06;883;133;19147;5511;5.3;1.5
02;2021-04-07;1430;324;20577;5835;5.7;1.6
02;2021-04-08;1303;268;21880;6103;6.1;1.7
02;2021-04-09;1239;317;23119;6420;6.4;1.8
02;2021-04-10;837;164;23956;6584;6.7;1.8
02;2021-04-11;621;12;24577;6596;6.9;1.8
02;2021-04-12;868;313;25445;6909;7.1;1.9
02;2021-04-13;865;326;26310;7235;7.3;2.0
02;2021-04-14;957;323;27267;7558;7.6;2.1
02;2021-04-15;958;294;28225;7852;7.9;2.2
02;2021-04-16;991;298;29216;8150;8.1;2.3
02;2021-04-17;528;161;29744;8311;8.3;2.3
02;2021-04-18;339;56;30083;8367;8.4;2.3
02;2021-04-19;668;347;30751;8714;8.6;2.4
02;2021-04-20;868;310;31619;9024;8.8;2.5
02;2021-04-21;998;358;32617;9382;9.1;2.6
02;2021-04-22;602;313;33219;9695;9.3;2.7
02;2021-04-23;604;466;33823;10161;9.4;2.8
02;2021-04-24;360;197;34183;10358;9.5;2.9
02;2021-04-25;168;200;34351;10558;9.6;2.9
02;2021-04-26;515;543;34866;11101;9.7;3.1
02;2021-04-27;558;609;35424;11710;9.9;3.3
02;2021-04-28;449;693;35873;12403;10.0;3.5
02;2021-04-29;651;643;36524;13046;10.2;3.6
02;2021-04-30;770;688;37294;13734;10.4;3.8
02;2021-05-01;243;245;37537;13979;10.5;3.9
02;2021-05-02;226;513;37763;14492;10.5;4.0
02;2021-05-03;569;771;38332;15263;10.7;4.3
02;2021-05-04;524;677;38856;15940;10.8;4.4
02;2021-05-05;541;898;39397;16838;11.0;4.7
02;2021-05-06;546;782;39943;17620;11.1;4.9
02;2021-05-07;629;1016;40572;18636;11.3;5.2
02;2021-05-08;223;526;40795;19162;11.4;5.3
02;2021-05-09;175;506;40970;19668;11.4;5.5
02;2021-05-10;520;861;41490;20529;11.6;5.7
02;2021-05-11;477;875;41967;21404;11.7;6.0
02;2021-05-12;554;914;42521;22318;11.9;6.2
02;2021-05-13;271;534;42792;22852;11.9;6.4
02;2021-05-14;386;753;43178;23605;12.0;6.6
02;2021-05-15;231;581;43409;24186;12.1;6.7
02;2021-05-16;155;442;43564;24628;12.1;6.9
02;2021-05-17;471;756;44035;25384;12.3;7.1
02;2021-05-18;443;676;44478;26060;12.4;7.3
02;2021-05-19;438;741;44916;26801;12.5;7.5
02;2021-05-20;587;501;45503;27302;12.7;7.6
02;2021-05-21;542;705;46045;28007;12.8;7.8
02;2021-05-22;182;365;46227;28372;12.9;7.9
02;2021-05-23;109;181;46336;28553;12.9;8.0
02;2021-05-24;131;242;46467;28795;13.0;8.0
02;2021-05-25;345;705;46812;29500;13.0;8.2
02;2021-05-26;372;713;47184;30213;13.2;8.4
02;2021-05-27;262;648;47446;30861;13.2;8.6
02;2021-05-28;264;820;47710;31681;13.3;8.8
02;2021-05-29;148;512;47858;32193;13.3;9.0
02;2021-05-30;16;33;47874;32226;13.3;9.0
02;2021-05-31;342;686;48216;32912;13.4;9.2
02;2021-06-01;289;548;48505;33460;13.5;9.3
02;2021-06-02;307;574;48812;34034;13.6;9.5
02;2021-06-03;246;431;49058;34465;13.7;9.6
02;2021-06-04;348;651;49406;35116;13.8;9.8
02;2021-06-05;234;362;49640;35478;13.8;9.9
02;2021-06-06;21;31;49661;35509;13.8;9.9
02;2021-06-07;257;741;49918;36250;13.9;10.1
02;2021-06-08;259;593;50177;36843;14.0;10.3
02;2021-06-09;286;704;50463;37547;14.1;10.5
02;2021-06-10;299;454;50762;38001;14.1;10.6
02;2021-06-11;334;543;51096;38544;14.2;10.7
02;2021-06-12;243;323;51339;38867;14.3;10.8
02;2021-06-13;32;29;51371;38896;14.3;10.8
02;2021-06-14;363;553;51734;39449;14.4;11.0
02;2021-06-15;407;494;52141;39943;14.5;11.1
02;2021-06-16;411;444;52552;40387;14.6;11.3
02;2021-06-17;345;578;52897;40965;14.7;11.4
02;2021-06-18;416;542;53313;41507;14.9;11.6
02;2021-06-19;225;195;53538;41702;14.9;11.6
02;2021-06-20;25;17;53563;41719;14.9;11.6
02;2021-06-21;305;577;53868;42296;15.0;11.8
03;2020-12-27;0;0;0;0;0.0;0.0
03;2020-12-28;0;0;0;0;0.0;0.0
03;2020-12-29;0;0;0;0;0.0;0.0
03;2020-12-30;0;0;0;0;0.0;0.0
03;2020-12-31;0;0;0;0;0.0;0.0
03;2021-01-01;0;0;0;0;0.0;0.0
03;2021-01-02;0;0;0;0;0.0;0.0
03;2021-01-03;0;0;0;0;0.0;0.0
03;2021-01-04;0;0;0;0;0.0;0.0
03;2021-01-05;0;0;0;0;0.0;0.0
03;2021-01-06;0;0;0;0;0.0;0.0
03;2021-01-07;0;0;0;0;0.0;0.0
03;2021-01-08;0;0;0;0;0.0;0.0
03;2021-01-09;0;0;0;0;0.0;0.0
03;2021-01-10;0;0;0;0;0.0;0.0
03;2021-01-11;0;0;0;0;0.0;0.0
03;2021-01-12;0;0;0;0;0.0;0.0
03;2021-01-13;30;0;30;0;0.0;0.0
03;2021-01-14;46;0;76;0;0.0;0.0
03;2021-01-15;34;0;110;0;0.0;0.0
03;2021-01-16;18;0;128;0;0.0;0.0
03;2021-01-17;0;0;128;0;0.0;0.0
03;2021-01-18;63;0;191;0;0.1;0.0
03;2021-01-19;149;1;340;1;0.1;0.0
03;2021-01-20;132;0;472;1;0.2;0.0
03;2021-01-21;118;0;590;1;0.2;0.0
03;2021-01-22;76;0;666;1;0.2;0.0
03;2021-01-23;0;0;666;1;0.2;0.0
03;2021-01-24;0;0;666;1;0.2;0.0
03;2021-01-25;56;0;722;1;0.2;0.0
03;2021-01-26;100;0;822;1;0.3;0.0
03;2021-01-27;109;1;931;2;0.3;0.0
03;2021-01-28;96;2;1027;4;0.4;0.0
03;2021-01-29;104;3;1131;7;0.4;0.0
03;2021-01-30;0;0;1131;7;0.4;0.0
03;2021-01-31;0;0;1131;7;0.4;0.0
03;2021-02-01;54;0;1185;7;0.4;0.0
03;2021-02-02;122;4;1307;11;0.4;0.0
03;2021-02-03;116;7;1423;18;0.5;0.0
03;2021-02-04;79;26;1502;44;0.5;0.0
03;2021-02-05;65;8;1567;52;0.5;0.0
03;2021-02-06;0;0;1567;52;0.5;0.0
03;2021-02-07;0;0;1567;52;0.5;0.0
03;2021-02-08;51;13;1618;65;0.6;0.0
03;2021-02-09;92;39;1710;104;0.6;0.0
03;2021-02-10;101;42;1811;146;0.6;0.1
03;2021-02-11;102;93;1913;239;0.7;0.1
03;2021-02-12;86;65;1999;304;0.7;0.1
03;2021-02-13;0;0;1999;304;0.7;0.1
03;2021-02-14;0;0;1999;304;0.7;0.1
03;2021-02-15;27;65;2026;369;0.7;0.1
03;2021-02-16;123;53;2149;422;0.7;0.1
03;2021-02-17;145;119;2294;541;0.8;0.2
03;2021-02-18;102;143;2396;684;0.8;0.2
03;2021-02-19;121;72;2517;756;0.9;0.3
03;2021-02-20;0;0;2517;756;0.9;0.3
03;2021-02-21;0;0;2517;756;0.9;0.3
03;2021-02-22;78;49;2595;805;0.9;0.3
03;2021-02-23;158;100;2753;905;0.9;0.3
03;2021-02-24;190;120;2943;1025;1.0;0.4
03;2021-02-25;258;87;3201;1112;1.1;0.4
03;2021-02-26;264;69;3465;1181;1.2;0.4
03;2021-02-27;121;1;3586;1182;1.2;0.4
03;2021-02-28;0;0;3586;1182;1.2;0.4
03;2021-03-01;180;85;3766;1267;1.3;0.4
03;2021-03-02;255;108;4021;1375;1.4;0.5
03;2021-03-03;255;129;4276;1504;1.5;0.5
03;2021-03-04;281;81;4557;1585;1.6;0.5
03;2021-03-05;270;44;4827;1629;1.7;0.6
03;2021-03-06;116;1;4943;1630;1.7;0.6
03;2021-03-07;0;0;4943;1630;1.7;0.6
03;2021-03-08;187;41;5130;1671;1.8;0.6
03;2021-03-09;349;91;5479;1762;1.9;0.6
03;2021-03-10;357;98;5836;1860;2.0;0.6
03;2021-03-11;270;118;6106;1978;2.1;0.7
03;2021-03-12;285;92;6391;2070;2.2;0.7
03;2021-03-13;110;2;6501;2072;2.2;0.7
03;2021-03-14;0;0;6501;2072;2.2;0.7
03;2021-03-15;180;26;6681;2098;2.3;0.7
03;2021-03-16;241;139;6922;2237;2.4;0.8
03;2021-03-17;273;128;7195;2365;2.5;0.8
03;2021-03-18;250;153;7445;2518;2.6;0.9
03;2021-03-19;284;126;7729;2644;2.7;0.9
03;2021-03-20;255;14;7984;2658;2.7;0.9
03;2021-03-21;119;0;8103;2658;2.8;0.9
03;2021-03-22;219;112;8322;2770;2.9;1.0
03;2021-03-23;261;186;8583;2956;3.0;1.0
03;2021-03-24;224;208;8807;3164;3.0;1.1
03;2021-03-25;167;176;8974;3340;3.1;1.1
03;2021-03-26;188;306;9162;3646;3.2;1.3
03;2021-03-27;55;93;9217;3739;3.2;1.3
03;2021-03-28;0;0;9217;3739;3.2;1.3
03;2021-03-29;174;244;9391;3983;3.2;1.4
03;2021-03-30;445;234;9836;4217;3.4;1.5
03;2021-03-31;314;289;10150;4506;3.5;1.6
03;2021-04-01;444;261;10594;4767;3.6;1.6
03;2021-04-02;306;279;10900;5046;3.7;1.7
03;2021-04-03;151;122;11051;5168;3.8;1.8
03;2021-04-04;0;0;11051;5168;3.8;1.8
03;2021-04-05;118;14;11169;5182;3.8;1.8
03;2021-04-06;439;330;11608;5512;4.0;1.9
03;2021-04-07;493;341;12101;5853;4.2;2.0
03;2021-04-08;494;255;12595;6108;4.3;2.1
03;2021-04-09;471;225;13066;6333;4.5;2.2
03;2021-04-10;146;91;13212;6424;4.5;2.2
03;2021-04-11;2;0;13214;6424;4.5;2.2
03;2021-04-12;497;264;13711;6688;4.7;2.3
03;2021-04-13;634;237;14345;6925;4.9;2.4
03;2021-04-14;670;310;15015;7235;5.2;2.5
03;2021-04-15;724;242;15739;7477;5.4;2.6
03;2021-04-16;709;297;16448;7774;5.7;2.7
03;2021-04-17;476;125;16924;7899;5.8;2.7
03;2021-04-18;489;36;17413;7935;6.0;2.7
03;2021-04-19;682;248;18095;8183;6.2;2.8
03;2021-04-20;550;268;18645;8451;6.4;2.9
03;2021-04-21;791;235;19436;8686;6.7;3.0
03;2021-04-22;656;216;20092;8902;6.9;3.1
03;2021-04-23;662;220;20754;9122;7.1;3.1
03;2021-04-24;523;95;21277;9217;7.3;3.2
03;2021-04-25;602;42;21879;9259;7.5;3.2
03;2021-04-26;734;223;22613;9482;7.8;3.3
03;2021-04-27;765;337;23378;9819;8.0;3.4
03;2021-04-28;670;321;24048;10140;8.3;3.5
03;2021-04-29;609;276;24657;10416;8.5;3.6
03;2021-04-30;672;252;25329;10668;8.7;3.7
03;2021-05-01;209;26;25538;10694;8.8;3.7
03;2021-05-02;594;76;26132;10770;9.0;3.7
03;2021-05-03;554;389;26686;11159;9.2;3.8
03;2021-05-04;613;311;27299;11470;9.4;3.9
03;2021-05-05;643;443;27942;11913;9.6;4.1
03;2021-05-06;624;461;28566;12374;9.8;4.3
03;2021-05-07;539;462;29105;12836;10.0;4.4
03;2021-05-08;340;57;29445;12893;10.1;4.4
03;2021-05-09;262;73;29707;12966;10.2;4.5
03;2021-05-10;417;613;30124;13579;10.4;4.7
03;2021-05-11;372;491;30496;14070;10.5;4.8
03;2021-05-12;447;639;30943;14709;10.6;5.1
03;2021-05-13;331;98;31274;14807;10.8;5.1
03;2021-05-14;427;548;31701;15355;10.9;5.3
03;2021-05-15;253;344;31954;15699;11.0;5.4
03;2021-05-16;206;210;32160;15909;11.1;5.5
03;2021-05-17;442;600;32602;16509;11.2;5.7
03;2021-05-18;555;562;33157;17071;11.4;5.9
03;2021-05-19;483;547;33640;17618;11.6;6.1
03;2021-05-20;584;445;34224;18063;11.8;6.2
03;2021-05-21;473;600;34697;18663;11.9;6.4
03;2021-05-22;167;500;34864;19163;12.0;6.6
03;2021-05-23;264;472;35128;19635;12.1;6.8
03;2021-05-24;552;242;35680;19877;12.3;6.8
03;2021-05-25;491;741;36171;20618;12.4;7.1
03;2021-05-26;368;680;36539;21298;12.6;7.3
03;2021-05-27;646;515;37185;21813;12.8;7.5
03;2021-05-28;475;546;37660;22359;13.0;7.7
03;2021-05-29;230;362;37890;22721;13.0;7.8
03;2021-05-30;146;401;38036;23122;13.1;8.0
03;2021-05-31;335;571;38371;23693;13.2;8.2
03;2021-06-01;382;466;38753;24159;13.3;8.3
03;2021-06-02;490;549;39243;24708;13.5;8.5
03;2021-06-03;413;466;39656;25174;13.6;8.7
03;2021-06-04;518;489;40174;25663;13.8;8.8
03;2021-06-05;269;291;40443;25954;13.9;8.9
03;2021-06-06;208;299;40651;26253;14.0;9.0
03;2021-06-07;457;448;41108;26701;14.1;9.2
03;2021-06-08;499;312;41607;27013;14.3;9.3
03;2021-06-09;471;379;42078;27392;14.5;9.4
03;2021-06-10;345;290;42423;27682;14.6;9.5
03;2021-06-11;389;468;42812;28150;14.7;9.7
03;2021-06-12;163;285;42975;28435;14.8;9.8
03;2021-06-13;200;267;43175;28702;14.9;9.9
03;2021-06-14;350;547;43525;29249;15.0;10.1
03;2021-06-15;355;439;43880;29688;15.1;10.2
03;2021-06-16;389;449;44269;30137;15.2;10.4
03;2021-06-17;364;575;44633;30712;15.4;10.6
03;2021-06-18;336;561;44969;31273;15.5;10.8
03;2021-06-19;229;259;45198;31532;15.5;10.8
03;2021-06-20;123;270;45321;31802;15.6;10.9
03;2021-06-21;249;594;45570;32396;15.7;11.1
04;2020-12-27;0;0;0;0;0.0;0.0
04;2020-12-28;0;0;0;0;0.0;0.0
04;2020-12-29;0;0;0;0;0.0;0.0
04;2020-12-30;0;0;0;0;0.0;0.0
04;2020-12-31;0;0;0;0;0.0;0.0
04;2021-01-01;1;0;1;0;0.0;0.0
04;2021-01-02;0;0;1;0;0.0;0.0
04;2021-01-03;0;0;1;0;0.0;0.0
04;2021-01-04;0;0;1;0;0.0;0.0
04;2021-01-05;2;0;3;0;0.0;0.0
04;2021-01-06;0;0;3;0;0.0;0.0
04;2021-01-07;0;0;3;0;0.0;0.0
04;2021-01-08;0;0;3;0;0.0;0.0
04;2021-01-09;1;0;4;0;0.0;0.0
04;2021-01-10;0;0;4;0;0.0;0.0
04;2021-01-11;0;0;4;0;0.0;0.0
04;2021-01-12;0;0;4;0;0.0;0.0
04;2021-01-13;0;0;4;0;0.0;0.0
04;2021-01-14;0;0;4;0;0.0;0.0
04;2021-01-15;332;0;336;0;0.0;0.0
04;2021-01-16;27;0;363;0;0.0;0.0
04;2021-01-17;0;0;363;0;0.0;0.0
04;2021-01-18;49;1;412;1;0.0;0.0
04;2021-01-19;393;0;805;1;0.1;0.0
04;2021-01-20;482;1;1287;2;0.1;0.0
04;2021-01-21;614;1;1901;3;0.2;0.0
04;2021-01-22;409;1;2310;4;0.3;0.0
04;2021-01-23;75;0;2385;4;0.3;0.0
04;2021-01-24;0;0;2385;4;0.3;0.0
04;2021-01-25;272;0;2657;4;0.3;0.0
04;2021-01-26;429;0;3086;4;0.4;0.0
04;2021-01-27;317;0;3403;4;0.4;0.0
04;2021-01-28;406;0;3809;4;0.4;0.0
04;2021-01-29;421;3;4230;7;0.5;0.0
04;2021-01-30;419;0;4649;7;0.5;0.0
04;2021-01-31;0;0;4649;7;0.5;0.0
04;2021-02-01;372;3;5021;10;0.6;0.0
04;2021-02-02;498;4;5519;14;0.6;0.0
04;2021-02-03;602;14;6121;28;0.7;0.0
04;2021-02-04;626;22;6747;50;0.8;0.0
04;2021-02-05;564;98;7311;148;0.9;0.0
04;2021-02-06;501;4;7812;152;0.9;0.0
04;2021-02-07;0;8;7812;160;0.9;0.0
04;2021-02-08;472;34;8284;194;1.0;0.0
04;2021-02-09;783;90;9067;284;1.1;0.0
04;2021-02-10;820;85;9887;369;1.1;0.0
04;2021-02-11;796;86;10683;455;1.2;0.1
04;2021-02-12;637;95;11320;550;1.3;0.1
04;2021-02-13;651;74;11971;624;1.4;0.1
04;2021-02-14;1;0;11972;624;1.4;0.1
04;2021-02-15;524;126;12496;750;1.5;0.1
04;2021-02-16;649;535;13145;1285;1.5;0.1
04;2021-02-17;592;329;13737;1614;1.6;0.2
04;2021-02-18;493;414;14230;2028;1.7;0.2
04;2021-02-19;496;321;14726;2349;1.7;0.3
04;2021-02-20;576;117;15302;2466;1.8;0.3
04;2021-02-21;0;0;15302;2466;1.8;0.3
04;2021-02-22;401;238;15703;2704;1.8;0.3
04;2021-02-23;607;238;16310;2942;1.9;0.3
04;2021-02-24;583;255;16893;3197;2.0;0.4
04;2021-02-25;645;298;17538;3495;2.0;0.4
04;2021-02-26;483;473;18021;3968;2.1;0.5
04;2021-02-27;385;471;18406;4439;2.1;0.5
04;2021-02-28;0;0;18406;4439;2.1;0.5
04;2021-03-01;289;392;18695;4831;2.2;0.6
04;2021-03-02;487;504;19182;5335;2.2;0.6
04;2021-03-03;755;559;19937;5894;2.3;0.7
04;2021-03-04;775;543;20712;6437;2.4;0.7
04;2021-03-05;727;542;21439;6979;2.5;0.8
04;2021-03-06;812;530;22251;7509;2.6;0.9
04;2021-03-07;0;0;22251;7509;2.6;0.9
04;2021-03-08;436;591;22687;8100;2.6;0.9
04;2021-03-09;670;777;23357;8877;2.7;1.0
04;2021-03-10;644;849;24001;9726;2.8;1.1
04;2021-03-11;699;648;24700;10374;2.9;1.2
04;2021-03-12;729;666;25429;11040;3.0;1.3
04;2021-03-13;667;610;26096;11650;3.0;1.4
04;2021-03-14;2;0;26098;11650;3.0;1.4
04;2021-03-15;504;506;26602;12156;3.1;1.4
04;2021-03-16;680;711;27282;12867;3.2;1.5
04;2021-03-17;847;538;28129;13405;3.3;1.6
04;2021-03-18;1021;556;29150;13961;3.4;1.6
04;2021-03-19;784;543;29934;14504;3.5;1.7
04;2021-03-20;576;600;30510;15104;3.5;1.8
04;2021-03-21;0;0;30510;15104;3.5;1.8
04;2021-03-22;565;482;31075;15586;3.6;1.8
04;2021-03-23;780;640;31855;16226;3.7;1.9
04;2021-03-24;792;671;32647;16897;3.8;2.0
04;2021-03-25;929;555;33576;17452;3.9;2.0
04;2021-03-26;921;450;34497;17902;4.0;2.1
04;2021-03-27;782;340;35279;18242;4.1;2.1
04;2021-03-28;1;0;35280;18242;4.1;2.1
04;2021-03-29;960;271;36240;18513;4.2;2.2
04;2021-03-30;883;502;37123;19015;4.3;2.2
04;2021-03-31;733;673;37856;19688;4.4;2.3
04;2021-04-01;716;709;38572;20397;4.5;2.4
04;2021-04-02;687;761;39259;21158;4.6;2.5
04;2021-04-03;699;707;39958;21865;4.6;2.5
04;2021-04-04;0;0;39958;21865;4.6;2.5
04;2021-04-05;0;2;39958;21867;4.6;2.5
04;2021-04-06;796;642;40754;22509;4.7;2.6
04;2021-04-07;1369;789;42123;23298;4.9;2.7
04;2021-04-08;1792;780;43915;24078;5.1;2.8
04;2021-04-09;1506;786;45421;24864;5.3;2.9
04;2021-04-10;1137;651;46558;25515;5.4;3.0
04;2021-04-11;2;0;46560;25515;5.4;3.0
04;2021-04-12;1239;553;47799;26068;5.6;3.0
04;2021-04-13;1438;754;49237;26822;5.7;3.1
04;2021-04-14;2068;777;51305;27599;6.0;3.2
04;2021-04-15;2502;956;53807;28555;6.3;3.3
04;2021-04-16;1931;785;55738;29340;6.5;3.4
04;2021-04-17;1288;604;57026;29944;6.6;3.5
04;2021-04-18;0;0;57026;29944;6.6;3.5
04;2021-04-19;1377;565;58403;30509;6.8;3.5
04;2021-04-20;1649;807;60052;31316;7.0;3.6
04;2021-04-21;2128;606;62180;31922;7.2;3.7
04;2021-04-22;2945;804;65125;32726;7.6;3.8
04;2021-04-23;2309;813;67434;33539;7.8;3.9
04;2021-04-24;1102;797;68536;34336;8.0;4.0
04;2021-04-25;2;0;68538;34336;8.0;4.0
04;2021-04-26;1164;921;69702;35257;8.1;4.1
04;2021-04-27;1679;1027;71381;36284;8.3;4.2
04;2021-04-28;2894;753;74275;37037;8.6;4.3
04;2021-04-29;3944;812;78219;37849;9.1;4.4
04;2021-04-30;3433;906;81652;38755;9.5;4.5
04;2021-05-01;2106;220;83758;38975;9.7;4.5
04;2021-05-02;2;0;83760;38975;9.7;4.5
04;2021-05-03;1865;572;85625;39547;10.0;4.6
04;2021-05-04;2127;1096;87752;40643;10.2;4.7
04;2021-05-05;3117;1641;90869;42284;10.6;4.9
04;2021-05-06;4004;1589;94873;43873;11.0;5.1
04;2021-05-07;3228;1527;98101;45400;11.4;5.3
04;2021-05-08;1566;503;99667;45903;11.6;5.3
04;2021-05-09;1;0;99668;45903;11.6;5.3
04;2021-05-10;2411;994;102079;46897;11.9;5.5
04;2021-05-11;3651;1642;105730;48539;12.3;5.6
04;2021-05-12;4716;2397;110446;50936;12.8;5.9
04;2021-05-13;3554;585;114000;51521;13.3;6.0
04;2021-05-14;5263;2510;119263;54031;13.9;6.3
04;2021-05-15;3159;1537;122422;55568;14.2;6.5
04;2021-05-16;15;18;122437;55586;14.2;6.5
04;2021-05-17;2997;1480;125434;57066;14.6;6.6
04;2021-05-18;3734;1779;129168;58845;15.0;6.8
04;2021-05-19;4677;2335;133845;61180;15.6;7.1
04;2021-05-20;5137;2805;138982;63985;16.2;7.4
04;2021-05-21;4986;2634;143968;66619;16.7;7.7
04;2021-05-22;3356;1253;147324;67872;17.1;7.9
04;2021-05-23;4;3;147328;67875;17.1;7.9
04;2021-05-24;3632;1078;150960;68953;17.6;8.0
04;2021-05-25;4193;1912;155153;70865;18.0;8.2
04;2021-05-26;4885;2962;160038;73827;18.6;8.6
04;2021-05-27;4575;4092;164613;77919;19.1;9.1
04;2021-05-28;4355;3827;168968;81746;19.6;9.5
04;2021-05-29;2529;2461;171497;84207;19.9;9.8
04;2021-05-30;6;14;171503;84221;19.9;9.8
04;2021-05-31;2341;2249;173844;86470;20.2;10.1
04;2021-06-01;3265;2722;177109;89192;20.6;10.4
04;2021-06-02;3904;3351;181013;92543;21.0;10.8
04;2021-06-03;4006;3663;185019;96206;21.5;11.2
04;2021-06-04;3817;3751;188836;99957;22.0;11.6
04;2021-06-05;2193;1923;191029;101880;22.2;11.8
04;2021-06-06;1060;129;192089;102009;22.3;11.9
04;2021-06-07;1999;2530;194088;104539;22.6;12.2
04;2021-06-08;2562;3320;196650;107859;22.9;12.5
04;2021-06-09;2899;4767;199549;112626;23.2;13.1
04;2021-06-10;3340;4445;202889;117071;23.6;13.6
04;2021-06-11;2820;4614;205709;121685;23.9;14.2
04;2021-06-12;1711;3379;207420;125064;24.1;14.5
04;2021-06-13;1312;242;208732;125306;24.3;14.6
04;2021-06-14;1480;3179;210212;128485;24.4;14.9
04;2021-06-15;2034;3615;212246;132100;24.7;15.4
04;2021-06-16;2687;4641;214933;136741;25.0;15.9
04;2021-06-17;2493;4897;217426;141638;25.3;16.5
04;2021-06-18;2555;4897;219981;146535;25.6;17.0
04;2021-06-19;1284;3508;221265;150043;25.7;17.4
04;2021-06-20;626;287;221891;150330;25.8;17.5
04;2021-06-21;1229;3220;223120;153550;25.9;17.9
05;2020-12-27;0;0;0;0;0.0;0.0
05;2020-12-28;0;0;0;0;0.0;0.0
05;2020-12-29;0;0;0;0;0.0;0.0
05;2020-12-30;0;0;0;0;0.0;0.0
05;2020-12-31;0;0;0;0;0.0;0.0
05;2021-01-01;0;0;0;0;0.0;0.0
05;2021-01-02;0;0;0;0;0.0;0.0
05;2021-01-03;0;0;0;0;0.0;0.0
05;2021-01-04;0;0;0;0;0.0;0.0
05;2021-01-05;0;0;0;0;0.0;0.0
05;2021-01-06;0;0;0;0;0.0;0.0
05;2021-01-07;0;0;0;0;0.0;0.0
05;2021-01-08;0;0;0;0;0.0;0.0
05;2021-01-09;0;0;0;0;0.0;0.0
05;2021-01-10;0;0;0;0;0.0;0.0
05;2021-01-11;0;0;0;0;0.0;0.0
05;2021-01-12;0;0;0;0;0.0;0.0
05;2021-01-13;0;0;0;0;0.0;0.0
05;2021-01-14;0;0;0;0;0.0;0.0
05;2021-01-15;0;0;0;0;0.0;0.0
05;2021-01-16;0;0;0;0;0.0;0.0
05;2021-01-17;0;0;0;0;0.0;0.0
05;2021-01-18;0;0;0;0;0.0;0.0
05;2021-01-19;0;0;0;0;0.0;0.0
05;2021-01-20;0;0;0;0;0.0;0.0
05;2021-01-21;0;0;0;0;0.0;0.0
05;2021-01-22;0;0;0;0;0.0;0.0
05;2021-01-23;0;0;0;0;0.0;0.0
05;2021-01-24;0;0;0;0;0.0;0.0
05;2021-01-25;0;0;0;0;0.0;0.0
05;2021-01-26;0;0;0;0;0.0;0.0
05;2021-01-27;0;0;0;0;0.0;0.0
05;2021-01-28;0;0;0;0;0.0;0.0
05;2021-01-29;0;0;0;0;0.0;0.0
05;2021-01-30;0;0;0;0;0.0;0.0
05;2021-01-31;0;0;0;0;0.0;0.0
05;2021-02-01;0;0;0;0;0.0;0.0
05;2021-02-02;0;0;0;0;0.0;0.0
05;2021-02-03;0;0;0;0;0.0;0.0
05;2021-02-04;0;0;0;0;0.0;0.0
05;2021-02-05;0;0;0;0;0.0;0.0
05;2021-02-06;0;0;0;0;0.0;0.0
05;2021-02-07;0;0;0;0;0.0;0.0
05;2021-02-08;0;0;0;0;0.0;0.0
05;2021-02-09;0;0;0;0;0.0;0.0
05;2021-02-10;0;0;0;0;0.0;0.0
05;2021-02-11;0;0;0;0;0.0;0.0
05;2021-02-12;0;0;0;0;0.0;0.0
05;2021-02-13;0;0;0;0;0.0;0.0
05;2021-02-14;0;0;0;0;0.0;0.0
05;2021-02-15;0;0;0;0;0.0;0.0
05;2021-02-16;0;0;0;0;0.0;0.0
05;2021-02-17;0;0;0;0;0.0;0.0
05;2021-02-18;0;0;0;0;0.0;0.0
05;2021-02-19;0;0;0;0;0.0;0.0
05;2021-02-20;0;0;0;0;0.0;0.0
05;2021-02-21;0;0;0;0;0.0;0.0
05;2021-02-22;0;0;0;0;0.0;0.0
05;2021-02-23;0;0;0;0;0.0;0.0
05;2021-02-24;0;0;0;0;0.0;0.0
05;2021-02-25;0;0;0;0;0.0;0.0
05;2021-02-26;0;0;0;0;0.0;0.0
05;2021-02-27;0;0;0;0;0.0;0.0
05;2021-02-28;0;0;0;0;0.0;0.0
05;2021-03-01;0;0;0;0;0.0;0.0
05;2021-03-02;0;0;0;0;0.0;0.0
05;2021-03-03;0;0;0;0;0.0;0.0
05;2021-03-04;0;0;0;0;0.0;0.0
05;2021-03-05;0;0;0;0;0.0;0.0
05;2021-03-06;0;0;0;0;0.0;0.0
05;2021-03-07;0;0;0;0;0.0;0.0
05;2021-03-08;0;0;0;0;0.0;0.0
05;2021-03-09;0;0;0;0;0.0;0.0
05;2021-03-10;0;0;0;0;0.0;0.0
05;2021-03-11;0;0;0;0;0.0;0.0
05;2021-03-12;0;0;0;0;0.0;0.0
05;2021-03-13;0;0;0;0;0.0;0.0
05;2021-03-14;0;0;0;0;0.0;0.0
05;2021-03-15;0;0;0;0;0.0;0.0
05;2021-03-16;0;0;0;0;0.0;0.0
05;2021-03-17;0;0;0;0;0.0;0.0
05;2021-03-18;0;0;0;0;0.0;0.0
05;2021-03-19;0;0;0;0;0.0;0.0
05;2021-03-20;0;0;0;0;0.0;0.0
05;2021-03-21;0;0;0;0;0.0;0.0
05;2021-03-22;0;0;0;0;0.0;0.0
05;2021-03-23;0;0;0;0;0.0;0.0
05;2021-03-24;0;0;0;0;0.0;0.0
05;2021-03-25;0;0;0;0;0.0;0.0
05;2021-03-26;0;0;0;0;0.0;0.0
05;2021-03-27;0;0;0;0;0.0;0.0
05;2021-03-28;0;0;0;0;0.0;0.0
05;2021-03-29;2;0;2;0;0.0;0.0
05;2021-03-30;0;0;2;0;0.0;0.0
05;2021-03-31;0;0;2;0;0.0;0.0
05;2021-04-01;0;0;2;0;0.0;0.0
05;2021-04-02;0;0;2;0;0.0;0.0
05;2021-04-03;0;0;2;0;0.0;0.0
05;2021-04-04;0;0;2;0;0.0;0.0
05;2021-04-05;0;0;2;0;0.0;0.0
05;2021-04-06;0;0;2;0;0.0;0.0
05;2021-04-07;0;0;2;0;0.0;0.0
05;2021-04-08;1;0;3;0;0.1;0.0
05;2021-04-09;0;0;3;0;0.1;0.0
05;2021-04-10;0;0;3;0;0.1;0.0
05;2021-04-11;0;0;3;0;0.1;0.0
05;2021-04-12;0;0;3;0;0.1;0.0
05;2021-04-13;0;0;3;0;0.1;0.0
05;2021-04-14;0;0;3;0;0.1;0.0
05;2021-04-15;0;0;3;0;0.1;0.0
05;2021-04-16;0;0;3;0;0.1;0.0
05;2021-04-17;0;0;3;0;0.1;0.0
05;2021-04-18;0;0;3;0;0.1;0.0
05;2021-04-19;0;0;3;0;0.1;0.0
05;2021-04-20;0;0;3;0;0.1;0.0
05;2021-04-21;0;0;3;0;0.1;0.0
05;2021-04-22;0;0;3;0;0.1;0.0
05;2021-04-23;0;0;3;0;0.1;0.0
05;2021-04-24;0;0;3;0;0.1;0.0
05;2021-04-25;0;0;3;0;0.1;0.0
05;2021-04-26;0;0;3;0;0.1;0.0
05;2021-04-27;0;0;3;0;0.1;0.0
05;2021-04-28;0;0;3;0;0.1;0.0
05;2021-04-29;0;0;3;0;0.1;0.0
05;2021-04-30;0;0;3;0;0.1;0.0
05;2021-05-01;0;0;3;0;0.1;0.0
05;2021-05-02;0;0;3;0;0.1;0.0
05;2021-05-03;0;0;3;0;0.1;0.0
05;2021-05-04;0;0;3;0;0.1;0.0
05;2021-05-05;0;0;3;0;0.1;0.0
05;2021-05-06;0;0;3;0;0.1;0.0
05;2021-05-07;0;0;3;0;0.1;0.0
05;2021-05-08;0;0;3;0;0.1;0.0
05;2021-05-09;0;0;3;0;0.1;0.0
05;2021-05-10;0;0;3;0;0.1;0.0
05;2021-05-11;0;0;3;0;0.1;0.0
05;2021-05-12;0;0;3;0;0.1;0.0
05;2021-05-13;0;0;3;0;0.1;0.0
05;2021-05-14;0;0;3;0;0.1;0.0
05;2021-05-15;0;0;3;0;0.1;0.0
05;2021-05-16;0;0;3;0;0.1;0.0
05;2021-05-17;0;0;3;0;0.1;0.0
05;2021-05-18;0;0;3;0;0.1;0.0
05;2021-05-19;0;0;3;0;0.1;0.0
05;2021-05-20;0;0;3;0;0.1;0.0
05;2021-05-21;0;0;3;0;0.1;0.0
05;2021-05-22;0;0;3;0;0.1;0.0
05;2021-05-23;0;0;3;0;0.1;0.0
05;2021-05-24;0;0;3;0;0.1;0.0
05;2021-05-25;0;0;3;0;0.1;0.0
05;2021-05-26;0;0;3;0;0.1;0.0
05;2021-05-27;0;0;3;0;0.1;0.0
05;2021-05-28;0;0;3;0;0.1;0.0
05;2021-05-29;0;2;3;2;0.1;0.0
05;2021-05-30;0;0;3;2;0.1;0.0
05;2021-05-31;0;0;3;2;0.1;0.0
05;2021-06-01;0;0;3;2;0.1;0.0
05;2021-06-02;0;0;3;2;0.1;0.0
05;2021-06-03;0;0;3;2;0.1;0.0
05;2021-06-04;0;0;3;2;0.1;0.0
05;2021-06-05;0;0;3;2;0.1;0.0
05;2021-06-06;0;0;3;2;0.1;0.0
05;2021-06-07;0;0;3;2;0.1;0.0
05;2021-06-08;0;0;3;2;0.1;0.0
05;2021-06-09;0;0;3;2;0.1;0.0
05;2021-06-10;0;0;3;2;0.1;0.0
05;2021-06-11;0;0;3;2;0.1;0.0
05;2021-06-12;0;0;3;2;0.1;0.0
05;2021-06-13;0;0;3;2;0.1;0.0
05;2021-06-14;0;0;3;2;0.1;0.0
05;2021-06-15;0;0;3;2;0.1;0.0
05;2021-06-16;0;0;3;2;0.1;0.0
05;2021-06-17;0;0;3;2;0.1;0.0
05;2021-06-18;0;0;3;2;0.1;0.0
05;2021-06-19;0;0;3;2;0.1;0.0
05;2021-06-20;0;0;3;2;0.1;0.0
05;2021-06-21;0;0;3;2;0.1;0.0
06;2020-12-27;0;0;0;0;0.0;0.0
06;2020-12-28;0;0;0;0;0.0;0.0
06;2020-12-29;0;0;0;0;0.0;0.0
06;2020-12-30;0;0;0;0;0.0;0.0
06;2020-12-31;0;0;0;0;0.0;0.0
06;2021-01-01;0;0;0;0;0.0;0.0
06;2021-01-02;0;0;0;0;0.0;0.0
06;2021-01-03;0;0;0;0;0.0;0.0
06;2021-01-04;0;0;0;0;0.0;0.0
06;2021-01-05;0;0;0;0;0.0;0.0
06;2021-01-06;0;0;0;0;0.0;0.0
06;2021-01-07;0;0;0;0;0.0;0.0
06;2021-01-08;0;0;0;0;0.0;0.0
06;2021-01-09;0;0;0;0;0.0;0.0
06;2021-01-10;0;0;0;0;0.0;0.0
06;2021-01-11;9;0;9;0;0.0;0.0
06;2021-01-12;0;0;9;0;0.0;0.0
06;2021-01-13;0;0;9;0;0.0;0.0
06;2021-01-14;0;0;9;0;0.0;0.0
06;2021-01-15;1;0;10;0;0.0;0.0
06;2021-01-16;1;0;11;0;0.0;0.0
06;2021-01-17;0;0;11;0;0.0;0.0
06;2021-01-18;1;0;12;0;0.0;0.0
06;2021-01-19;0;0;12;0;0.0;0.0
06;2021-01-20;0;0;12;0;0.0;0.0
06;2021-01-21;0;0;12;0;0.0;0.0
06;2021-01-22;0;0;12;0;0.0;0.0
06;2021-01-23;1;0;13;0;0.0;0.0
06;2021-01-24;0;0;13;0;0.0;0.0
06;2021-01-25;140;1;153;1;0.1;0.0
06;2021-01-26;166;4;319;5;0.1;0.0
06;2021-01-27;250;2;569;7;0.2;0.0
06;2021-01-28;101;5;670;12;0.2;0.0
06;2021-01-29;230;2;900;14;0.3;0.0
06;2021-01-30;286;8;1186;22;0.4;0.0
06;2021-01-31;1;0;1187;22;0.4;0.0
06;2021-02-01;160;0;1347;22;0.5;0.0
06;2021-02-02;329;4;1676;26;0.6;0.0
06;2021-02-03;228;1;1904;27;0.7;0.0
06;2021-02-04;215;7;2119;34;0.8;0.0
06;2021-02-05;214;1;2333;35;0.8;0.0
06;2021-02-06;83;10;2416;45;0.9;0.0
06;2021-02-07;0;0;2416;45;0.9;0.0
06;2021-02-08;82;3;2498;48;0.9;0.0
06;2021-02-09;193;0;2691;48;1.0;0.0
06;2021-02-10;187;2;2878;50;1.0;0.0
06;2021-02-11;235;1;3113;51;1.1;0.0
06;2021-02-12;287;4;3400;55;1.2;0.0
06;2021-02-13;56;0;3456;55;1.2;0.0
06;2021-02-14;1;0;3457;55;1.2;0.0
06;2021-02-15;359;2;3816;57;1.4;0.0
06;2021-02-16;266;6;4082;63;1.5;0.0
06;2021-02-17;167;5;4249;68;1.5;0.0
06;2021-02-18;216;11;4465;79;1.6;0.0
06;2021-02-19;235;21;4700;100;1.7;0.0
06;2021-02-20;138;7;4838;107;1.7;0.0
06;2021-02-21;0;0;4838;107;1.7;0.0
06;2021-02-22;131;121;4969;228;1.8;0.1
06;2021-02-23;186;151;5155;379;1.8;0.1
06;2021-02-24;176;144;5331;523;1.9;0.2
06;2021-02-25;227;283;5558;806;2.0;0.3
06;2021-02-26;242;259;5800;1065;2.1;0.4
06;2021-02-27;0;0;5800;1065;2.1;0.4
06;2021-02-28;0;0;5800;1065;2.1;0.4
06;2021-03-01;144;259;5944;1324;2.1;0.5
06;2021-03-02;228;257;6172;1581;2.2;0.6
06;2021-03-03;202;187;6374;1768;2.3;0.6
06;2021-03-04;205;139;6579;1907;2.4;0.7
06;2021-03-05;224;113;6803;2020;2.4;0.7
06;2021-03-06;1;0;6804;2020;2.4;0.7
06;2021-03-07;0;0;6804;2020;2.4;0.7
06;2021-03-08;189;125;6993;2145;2.5;0.8
06;2021-03-09;390;154;7383;2299;2.6;0.8
06;2021-03-10;180;178;7563;2477;2.7;0.9
06;2021-03-11;167;207;7730;2684;2.8;1.0
06;2021-03-12;238;288;7968;2972;2.9;1.1
06;2021-03-13;2;0;7970;2972;2.9;1.1
06;2021-03-14;0;0;7970;2972;2.9;1.1
06;2021-03-15;156;292;8126;3264;2.9;1.2
06;2021-03-16;236;222;8362;3486;3.0;1.2
06;2021-03-17;264;139;8626;3625;3.1;1.3
06;2021-03-18;172;232;8798;3857;3.1;1.4
06;2021-03-19;172;296;8970;4153;3.2;1.5
06;2021-03-20;0;0;8970;4153;3.2;1.5
06;2021-03-21;0;0;8970;4153;3.2;1.5
06;2021-03-22;97;136;9067;4289;3.2;1.5
06;2021-03-23;136;240;9203;4529;3.3;1.6
06;2021-03-24;160;146;9363;4675;3.4;1.7
06;2021-03-25;186;206;9549;4881;3.4;1.7
06;2021-03-26;160;211;9709;5092;3.5;1.8
06;2021-03-27;18;0;9727;5092;3.5;1.8
06;2021-03-28;0;0;9727;5092;3.5;1.8
06;2021-03-29;0;2;9727;5094;3.5;1.8
06;2021-03-30;272;334;9999;5428;3.6;1.9
06;2021-03-31;225;125;10224;5553;3.7;2.0
06;2021-04-01;243;105;10467;5658;3.7;2.0
06;2021-04-02;285;262;10752;5920;3.8;2.1
06;2021-04-03;906;307;11658;6227;4.2;2.2
06;2021-04-04;1;0;11659;6227;4.2;2.2
06;2021-04-05;1;0;11660;6227;4.2;2.2
06;2021-04-06;158;281;11818;6508;4.2;2.3
06;2021-04-07;237;264;12055;6772;4.3;2.4
06;2021-04-08;286;140;12341;6912;4.4;2.5
06;2021-04-09;248;171;12589;7083;4.5;2.5
06;2021-04-10;181;114;12770;7197;4.6;2.6
06;2021-04-11;7;0;12777;7197;4.6;2.6
06;2021-04-12;0;19;12777;7216;4.6;2.6
06;2021-04-13;393;343;13170;7559;4.7;2.7
06;2021-04-14;239;205;13409;7764;4.8;2.8
06;2021-04-15;207;117;13616;7881;4.9;2.8
06;2021-04-16;214;127;13830;8008;4.9;2.9
06;2021-04-17;226;132;14056;8140;5.0;2.9
06;2021-04-18;1;0;14057;8140;5.0;2.9
06;2021-04-19;6;1;14063;8141;5.0;2.9
06;2021-04-20;368;224;14431;8365;5.2;3.0
06;2021-04-21;412;150;14843;8515;5.3;3.0
06;2021-04-22;410;150;15253;8665;5.5;3.1
06;2021-04-23;367;166;15620;8831;5.6;3.2
06;2021-04-24;413;127;16033;8958;5.7;3.2
06;2021-04-25;2;0;16035;8958;5.7;3.2
06;2021-04-26;54;8;16089;8966;5.8;3.2
06;2021-04-27;351;293;16440;9259;5.9;3.3
06;2021-04-28;354;514;16794;9773;6.0;3.5
06;2021-04-29;556;342;17350;10115;6.2;3.6
06;2021-04-30;402;238;17752;10353;6.4;3.7
06;2021-05-01;669;285;18421;10638;6.6;3.8
06;2021-05-02;0;0;18421;10638;6.6;3.8
06;2021-05-03;134;6;18555;10644;6.6;3.8
06;2021-05-04;353;426;18908;11070;6.8;4.0
06;2021-05-05;443;317;19351;11387;6.9;4.1
06;2021-05-06;319;200;19670;11587;7.0;4.1
06;2021-05-07;341;134;20011;11721;7.2;4.2
06;2021-05-08;300;140;20311;11861;7.3;4.2
06;2021-05-09;0;0;20311;11861;7.3;4.2
06;2021-05-10;8;9;20319;11870;7.3;4.2
06;2021-05-11;359;489;20678;12359;7.4;4.4
06;2021-05-12;331;310;21009;12669;7.5;4.5
06;2021-05-13;127;97;21136;12766;7.6;4.6
06;2021-05-14;0;0;21136;12766;7.6;4.6
06;2021-05-15;484;283;21620;13049;7.7;4.7
06;2021-05-16;0;0;21620;13049;7.7;4.7
06;2021-05-17;124;51;21744;13100;7.8;4.7
06;2021-05-18;514;429;22258;13529;8.0;4.8
06;2021-05-19;649;663;22907;14192;8.2;5.1
06;2021-05-20;1055;496;23962;14688;8.6;5.3
06;2021-05-21;1046;316;25008;15004;8.9;5.4
06;2021-05-22;1238;299;26246;15303;9.4;5.5
06;2021-05-23;0;0;26246;15303;9.4;5.5
06;2021-05-24;1;0;26247;15303;9.4;5.5
06;2021-05-25;867;621;27114;15924;9.7;5.7
06;2021-05-26;1023;841;28137;16765;10.1;6.0
06;2021-05-27;1289;505;29426;17270;10.5;6.2
06;2021-05-28;938;371;30364;17641;10.9;6.3
06;2021-05-29;1111;388;31475;18029;11.3;6.5
06;2021-05-30;0;1;31475;18030;11.3;6.5
06;2021-05-31;99;6;31574;18036;11.3;6.5
06;2021-06-01;1127;649;32701;18685;11.7;6.7
06;2021-06-02;1142;490;33843;19175;12.1;6.9
06;2021-06-03;791;332;34634;19507;12.4;7.0
06;2021-06-04;977;320;35611;19827;12.7;7.1
06;2021-06-05;654;297;36265;20124;13.0;7.2
06;2021-06-06;0;0;36265;20124;13.0;7.2
06;2021-06-07;75;11;36340;20135;13.0;7.2
06;2021-06-08;797;442;37137;20577;13.3;7.4
06;2021-06-09;950;539;38087;21116;13.6;7.6
06;2021-06-10;649;222;38736;21338;13.9;7.6
06;2021-06-11;819;367;39555;21705;14.2;7.8
06;2021-06-12;563;273;40118;21978;14.4;7.9
06;2021-06-13;0;0;40118;21978;14.4;7.9
06;2021-06-14;178;112;40296;22090;14.4;7.9
06;2021-06-15;399;838;40695;22928;14.6;8.2
06;2021-06-16;880;1436;41575;24364;14.9;8.7
06;2021-06-17;755;648;42330;25012;15.1;8.9
06;2021-06-18;686;612;43016;25624;15.4;9.2
06;2021-06-19;527;638;43543;26262;15.6;9.4
06;2021-06-20;0;0;43543;26262;15.6;9.4
06;2021-06-21;122;128;43665;26390;15.6;9.4
07;2020-12-27;0;0;0;0;0.0;0.0
07;2020-12-28;0;0;0;0;0.0;0.0
07;2020-12-29;0;0;0;0;0.0;0.0
07;2020-12-30;0;0;0;0;0.0;0.0
07;2020-12-31;0;0;0;0;0.0;0.0
07;2021-01-01;0;0;0;0;0.0;0.0
07;2021-01-02;0;0;0;0;0.0;0.0
07;2021-01-03;0;0;0;0;0.0;0.0
07;2021-01-04;0;0;0;0;0.0;0.0
07;2021-01-05;0;0;0;0;0.0;0.0
07;2021-01-06;0;0;0;0;0.0;0.0
07;2021-01-07;0;0;0;0;0.0;0.0
07;2021-01-08;0;0;0;0;0.0;0.0
07;2021-01-09;0;0;0;0;0.0;0.0
07;2021-01-10;0;0;0;0;0.0;0.0
07;2021-01-11;0;0;0;0;0.0;0.0
07;2021-01-12;0;0;0;0;0.0;0.0
07;2021-01-13;0;0;0;0;0.0;0.0
07;2021-01-14;0;0;0;0;0.0;0.0
07;2021-01-15;0;0;0;0;0.0;0.0
07;2021-01-16;0;0;0;0;0.0;0.0
07;2021-01-17;0;0;0;0;0.0;0.0
07;2021-01-18;1;0;1;0;0.0;0.0
07;2021-01-19;0;0;1;0;0.0;0.0
07;2021-01-20;0;0;1;0;0.0;0.0
07;2021-01-21;12;0;13;0;0.1;0.0
07;2021-01-22;12;0;25;0;0.3;0.0
07;2021-01-23;0;0;25;0;0.3;0.0
07;2021-01-24;0;0;25;0;0.3;0.0
07;2021-01-25;0;0;25;0;0.3;0.0
07;2021-01-26;0;0;25;0;0.3;0.0
07;2021-01-27;12;0;37;0;0.4;0.0
07;2021-01-28;1;0;38;0;0.4;0.0
07;2021-01-29;6;0;44;0;0.4;0.0
07;2021-01-30;0;0;44;0;0.4;0.0
07;2021-01-31;0;0;44;0;0.4;0.0
07;2021-02-01;0;0;44;0;0.4;0.0
07;2021-02-02;0;0;44;0;0.4;0.0
07;2021-02-03;11;0;55;0;0.6;0.0
07;2021-02-04;12;0;67;0;0.7;0.0
07;2021-02-05;11;0;78;0;0.8;0.0
07;2021-02-06;0;0;78;0;0.8;0.0
07;2021-02-07;0;0;78;0;0.8;0.0
07;2021-02-08;0;0;78;0;0.8;0.0
07;2021-02-09;13;0;91;0;0.9;0.0
07;2021-02-10;0;0;91;0;0.9;0.0
07;2021-02-11;16;0;107;0;1.1;0.0
07;2021-02-12;45;0;152;0;1.5;0.0
07;2021-02-13;0;0;152;0;1.5;0.0
07;2021-02-14;0;0;152;0;1.5;0.0
07;2021-02-15;0;0;152;0;1.5;0.0
07;2021-02-16;0;0;152;0;1.5;0.0
07;2021-02-17;0;0;152;0;1.5;0.0
07;2021-02-18;18;0;170;0;1.7;0.0
07;2021-02-19;34;0;204;0;2.0;0.0
07;2021-02-20;0;0;204;0;2.0;0.0
07;2021-02-21;0;0;204;0;2.0;0.0
07;2021-02-22;0;0;204;0;2.0;0.0
07;2021-02-23;0;22;204;22;2.0;0.2
07;2021-02-24;0;0;204;22;2.0;0.2
07;2021-02-25;15;10;219;32;2.2;0.3
07;2021-02-26;33;21;252;53;2.5;0.5
07;2021-02-27;0;0;252;53;2.5;0.5
07;2021-02-28;0;0;252;53;2.5;0.5
07;2021-03-01;0;0;252;53;2.5;0.5
07;2021-03-02;17;11;269;64;2.7;0.6
07;2021-03-03;0;0;269;64;2.7;0.6
07;2021-03-04;16;11;285;75;2.9;0.8
07;2021-03-05;33;19;318;94;3.2;0.9
07;2021-03-06;0;0;318;94;3.2;0.9
07;2021-03-07;0;0;318;94;3.2;0.9
07;2021-03-08;0;0;318;94;3.2;0.9
07;2021-03-09;1;0;319;94;3.2;0.9
07;2021-03-10;0;0;319;94;3.2;0.9
07;2021-03-11;20;30;339;124;3.4;1.2
07;2021-03-12;62;42;401;166;4.0;1.7
07;2021-03-13;0;0;401;166;4.0;1.7
07;2021-03-14;0;0;401;166;4.0;1.7
07;2021-03-15;0;0;401;166;4.0;1.7
07;2021-03-16;30;9;431;175;4.3;1.8
07;2021-03-17;0;0;431;175;4.3;1.8
07;2021-03-18;29;16;460;191;4.6;1.9
07;2021-03-19;56;31;516;222;5.2;2.2
07;2021-03-20;0;0;516;222;5.2;2.2
07;2021-03-21;0;0;516;222;5.2;2.2
07;2021-03-22;0;0;516;222;5.2;2.2
07;2021-03-23;0;0;516;222;5.2;2.2
07;2021-03-24;0;0;516;222;5.2;2.2
07;2021-03-25;65;17;581;239;5.8;2.4
07;2021-03-26;73;26;654;265;6.6;2.7
07;2021-03-27;0;0;654;265;6.6;2.7
07;2021-03-28;0;0;654;265;6.6;2.7
07;2021-03-29;0;0;654;265;6.6;2.7
07;2021-03-30;40;18;694;283;7.0;2.8
07;2021-03-31;26;15;720;298;7.2;3.0
07;2021-04-01;25;32;745;330;7.5;3.3
07;2021-04-02;0;0;745;330;7.5;3.3
07;2021-04-03;0;0;745;330;7.5;3.3
07;2021-04-04;0;0;745;330;7.5;3.3
07;2021-04-05;9;0;754;330;7.6;3.3
07;2021-04-06;0;0;754;330;7.6;3.3
07;2021-04-07;0;0;754;330;7.6;3.3
07;2021-04-08;57;46;811;376;8.1;3.8
07;2021-04-09;59;31;870;407;8.7;4.1
07;2021-04-10;0;0;870;407;8.7;4.1
07;2021-04-11;0;0;870;407;8.7;4.1
07;2021-04-12;0;0;870;407;8.7;4.1
07;2021-04-13;0;0;870;407;8.7;4.1
07;2021-04-14;5;6;875;413;8.8;4.1
07;2021-04-15;56;71;931;484;9.3;4.9
07;2021-04-16;90;35;1021;519;10.2;5.2
07;2021-04-17;0;1;1021;520;10.2;5.2
07;2021-04-18;0;0;1021;520;10.2;5.2
07;2021-04-19;1;0;1022;520;10.3;5.2
07;2021-04-20;335;66;1357;586;13.6;5.9
07;2021-04-21;337;29;1694;615;17.0;6.2
07;2021-04-22;284;49;1978;664;19.9;6.7
07;2021-04-23;258;41;2236;705;22.4;7.1
07;2021-04-24;231;1;2467;706;24.8;7.1
07;2021-04-25;0;0;2467;706;24.8;7.1
07;2021-04-26;283;20;2750;726;27.6;7.3
07;2021-04-27;224;69;2974;795;29.9;8.0
07;2021-04-28;192;26;3166;821;31.8;8.2
07;2021-04-29;170;22;3336;843;33.5;8.5
07;2021-04-30;172;15;3508;858;35.2;8.6
07;2021-05-01;200;12;3708;870;37.2;8.7
07;2021-05-02;0;0;3708;870;37.2;8.7
07;2021-05-03;134;10;3842;880;38.6;8.8
07;2021-05-04;161;54;4003;934;40.2;9.4
07;2021-05-05;221;30;4224;964;42.4;9.7
07;2021-05-06;175;31;4399;995;44.2;10.0
07;2021-05-07;149;31;4548;1026;45.7;10.3
07;2021-05-08;1;0;4549;1026;45.7;10.3
07;2021-05-09;0;2;4549;1028;45.7;10.3
07;2021-05-10;0;0;4549;1028;45.7;10.3
07;2021-05-11;2;41;4551;1069;45.7;10.7
07;2021-05-12;6;36;4557;1105;45.7;11.1
07;2021-05-13;0;0;4557;1105;45.7;11.1
07;2021-05-14;28;98;4585;1203;46.0;12.1
07;2021-05-15;0;0;4585;1203;46.0;12.1
07;2021-05-16;0;0;4585;1203;46.0;12.1
07;2021-05-17;1;14;4586;1217;46.0;12.2
07;2021-05-18;17;32;4603;1249;46.2;12.5
07;2021-05-19;0;1;4603;1250;46.2;12.5
07;2021-05-20;0;8;4603;1258;46.2;12.6
07;2021-05-21;12;32;4615;1290;46.3;13.0
07;2021-05-22;0;0;4615;1290;46.3;13.0
07;2021-05-23;0;0;4615;1290;46.3;13.0
07;2021-05-24;0;0;4615;1290;46.3;13.0
07;2021-05-25;50;334;4665;1624;46.8;16.3
07;2021-05-26;54;359;4719;1983;47.4;19.9
07;2021-05-27;34;317;4753;2300;47.7;23.1
07;2021-05-28;27;256;4780;2556;48.0;25.7
07;2021-05-29;35;376;4815;2932;48.3;29.4
07;2021-05-30;0;0;4815;2932;48.3;29.4
07;2021-05-31;45;218;4860;3150;48.8;31.6
07;2021-06-01;47;226;4907;3376;49.3;33.9
07;2021-06-02;69;273;4976;3649;50.0;36.6
07;2021-06-03;41;252;5017;3901;50.4;39.2
07;2021-06-04;70;269;5087;4170;51.1;41.9
07;2021-06-05;1;0;5088;4170;51.1;41.9
07;2021-06-06;0;0;5088;4170;51.1;41.9
07;2021-06-07;0;1;5088;4171;51.1;41.9
07;2021-06-08;4;2;5092;4173;51.1;41.9
07;2021-06-09;0;3;5092;4176;51.1;41.9
07;2021-06-10;8;4;5100;4180;51.2;42.0
07;2021-06-11;3;8;5103;4188;51.2;42.0
07;2021-06-12;15;59;5118;4247;51.4;42.6
07;2021-06-13;0;0;5118;4247;51.4;42.6
07;2021-06-14;0;0;5118;4247;51.4;42.6
07;2021-06-15;0;1;5118;4248;51.4;42.6
07;2021-06-16;0;0;5118;4248;51.4;42.6
07;2021-06-17;2;6;5120;4254;51.4;42.7
07;2021-06-18;0;2;5120;4256;51.4;42.7
07;2021-06-19;24;49;5144;4305;51.6;43.2
07;2021-06-20;0;0;5144;4305;51.6;43.2
07;2021-06-21;0;2;5144;4307;51.6;43.2
08;2020-12-27;0;0;0;0;0.0;0.0
08;2020-12-28;0;0;0;0;0.0;0.0
08;2020-12-29;0;0;0;0;0.0;0.0
08;2020-12-30;0;0;0;0;0.0;0.0
08;2020-12-31;0;0;0;0;0.0;0.0
08;2021-01-01;0;0;0;0;0.0;0.0
08;2021-01-02;0;0;0;0;0.0;0.0
08;2021-01-03;0;0;0;0;0.0;0.0
08;2021-01-04;0;0;0;0;0.0;0.0
08;2021-01-05;0;0;0;0;0.0;0.0
08;2021-01-06;0;0;0;0;0.0;0.0
08;2021-01-07;0;0;0;0;0.0;0.0
08;2021-01-08;0;0;0;0;0.0;0.0
08;2021-01-09;0;0;0;0;0.0;0.0
08;2021-01-10;0;0;0;0;0.0;0.0
08;2021-01-11;0;0;0;0;0.0;0.0
08;2021-01-12;0;0;0;0;0.0;0.0
08;2021-01-13;10;0;10;0;0.0;0.0
08;2021-01-14;12;0;22;0;0.1;0.0
08;2021-01-15;7;0;29;0;0.1;0.0
08;2021-01-16;0;0;29;0;0.1;0.0
08;2021-01-17;0;0;29;0;0.1;0.0
08;2021-01-18;0;0;29;0;0.1;0.0
08;2021-01-19;12;0;41;0;0.1;0.0
08;2021-01-20;12;0;53;0;0.1;0.0
08;2021-01-21;6;0;59;0;0.2;0.0
08;2021-01-22;0;0;59;0;0.2;0.0
08;2021-01-23;0;0;59;0;0.2;0.0
08;2021-01-24;0;0;59;0;0.2;0.0
08;2021-01-25;0;0;59;0;0.2;0.0
08;2021-01-26;9;0;68;0;0.2;0.0
08;2021-01-27;10;0;78;0;0.2;0.0
08;2021-01-28;6;0;84;0;0.2;0.0
08;2021-01-29;0;0;84;0;0.2;0.0
08;2021-01-30;0;0;84;0;0.2;0.0
08;2021-01-31;0;0;84;0;0.2;0.0
08;2021-02-01;0;0;84;0;0.2;0.0
08;2021-02-02;38;0;122;0;0.3;0.0
08;2021-02-03;10;0;132;0;0.4;0.0
08;2021-02-04;29;0;161;0;0.5;0.0
08;2021-02-05;7;0;168;0;0.5;0.0
08;2021-02-06;0;0;168;0;0.5;0.0
08;2021-02-07;0;0;168;0;0.5;0.0
08;2021-02-08;0;0;168;0;0.5;0.0
08;2021-02-09;38;0;206;0;0.6;0.0
08;2021-02-10;27;1;233;1;0.7;0.0
08;2021-02-11;0;0;233;1;0.7;0.0
08;2021-02-12;36;0;269;1;0.8;0.0
08;2021-02-13;0;0;269;1;0.8;0.0
08;2021-02-14;0;0;269;1;0.8;0.0
08;2021-02-15;50;0;319;1;0.9;0.0
08;2021-02-16;0;0;319;1;0.9;0.0
08;2021-02-17;0;0;319;1;0.9;0.0
08;2021-02-18;27;0;346;1;1.0;0.0
08;2021-02-19;44;0;390;1;1.1;0.0
08;2021-02-20;0;0;390;1;1.1;0.0
08;2021-02-21;0;0;390;1;1.1;0.0
08;2021-02-22;46;4;436;5;1.2;0.0
08;2021-02-23;41;29;477;34;1.3;0.1
08;2021-02-24;35;1;512;35;1.4;0.1
08;2021-02-25;55;36;567;71;1.6;0.2
08;2021-02-26;39;5;606;76;1.7;0.2
08;2021-02-27;0;0;606;76;1.7;0.2
08;2021-02-28;0;0;606;76;1.7;0.2
08;2021-03-01;48;5;654;81;1.9;0.2
08;2021-03-02;7;27;661;108;1.9;0.3
08;2021-03-03;38;27;699;135;2.0;0.4
08;2021-03-04;30;26;729;161;2.1;0.5
08;2021-03-05;46;11;775;172;2.2;0.5
08;2021-03-06;0;0;775;172;2.2;0.5
08;2021-03-07;0;0;775;172;2.2;0.5
08;2021-03-08;30;7;805;179;2.3;0.5
08;2021-03-09;19;27;824;206;2.3;0.6
08;2021-03-10;32;28;856;234;2.4;0.7
08;2021-03-11;2;0;858;234;2.4;0.7
08;2021-03-12;52;21;910;255;2.6;0.7
08;2021-03-13;11;0;921;255;2.6;0.7
08;2021-03-14;0;0;921;255;2.6;0.7
08;2021-03-15;31;43;952;298;2.7;0.8
08;2021-03-16;73;6;1025;304;2.9;0.9
08;2021-03-17;67;13;1092;317;3.1;0.9
08;2021-03-18;82;39;1174;356;3.3;1.0
08;2021-03-19;30;51;1204;407;3.4;1.2
08;2021-03-20;0;0;1204;407;3.4;1.2
08;2021-03-21;0;0;1204;407;3.4;1.2
08;2021-03-22;33;45;1237;452;3.5;1.3
08;2021-03-23;30;43;1267;495;3.6;1.4
08;2021-03-24;38;42;1305;537;3.7;1.5
08;2021-03-25;90;34;1395;571;3.9;1.6
08;2021-03-26;45;33;1440;604;4.1;1.7
08;2021-03-27;93;3;1533;607;4.3;1.7
08;2021-03-28;0;0;1533;607;4.3;1.7
08;2021-03-29;69;49;1602;656;4.5;1.9
08;2021-03-30;98;24;1700;680;4.8;1.9
08;2021-03-31;89;47;1789;727;5.1;2.1
08;2021-04-01;56;48;1845;775;5.2;2.2
08;2021-04-02;0;0;1845;775;5.2;2.2
08;2021-04-03;0;0;1845;775;5.2;2.2
08;2021-04-04;0;0;1845;775;5.2;2.2
08;2021-04-05;0;0;1845;775;5.2;2.2
08;2021-04-06;49;63;1894;838;5.4;2.4
08;2021-04-07;91;32;1985;870;5.6;2.5
08;2021-04-08;120;7;2105;877;6.0;2.5
08;2021-04-09;89;39;2194;916;6.2;2.6
08;2021-04-10;162;8;2356;924;6.7;2.6
08;2021-04-11;0;0;2356;924;6.7;2.6
08;2021-04-12;41;76;2397;1000;6.8;2.8
08;2021-04-13;48;71;2445;1071;6.9;3.0
08;2021-04-14;81;45;2526;1116;7.1;3.2
08;2021-04-15;92;25;2618;1141;7.4;3.2
08;2021-04-16;77;42;2695;1183;7.6;3.3
08;2021-04-17;165;4;2860;1187;8.1;3.4
08;2021-04-18;0;0;2860;1187;8.1;3.4
08;2021-04-19;52;67;2912;1254;8.2;3.5
08;2021-04-20;83;27;2995;1281;8.5;3.6
08;2021-04-21;90;29;3085;1310;8.7;3.7
08;2021-04-22;101;20;3186;1330;9.0;3.8
08;2021-04-23;44;66;3230;1396;9.1;4.0
08;2021-04-24;99;78;3329;1474;9.4;4.2
08;2021-04-25;0;0;3329;1474;9.4;4.2
08;2021-04-26;28;93;3357;1567;9.5;4.4
08;2021-04-27;58;63;3415;1630;9.7;4.6
08;2021-04-28;88;39;3503;1669;9.9;4.7
08;2021-04-29;90;34;3593;1703;10.2;4.8
08;2021-04-30;104;15;3697;1718;10.5;4.9
08;2021-05-01;0;8;3697;1726;10.5;4.9
08;2021-05-02;0;0;3697;1726;10.5;4.9
08;2021-05-03;24;102;3721;1828;10.5;5.2
08;2021-05-04;157;103;3878;1931;11.0;5.5
08;2021-05-05;142;59;4020;1990;11.4;5.6
08;2021-05-06;199;49;4219;2039;11.9;5.8
08;2021-05-07;127;71;4346;2110;12.3;6.0
08;2021-05-08;69;122;4415;2232;12.5;6.3
08;2021-05-09;0;0;4415;2232;12.5;6.3
08;2021-05-10;123;102;4538;2334;12.8;6.6
08;2021-05-11;131;77;4669;2411;13.2;6.8
08;2021-05-12;154;76;4823;2487;13.6;7.0
08;2021-05-13;74;8;4897;2495;13.9;7.1
08;2021-05-14;129;61;5026;2556;14.2;7.2
08;2021-05-15;85;4;5111;2560;14.5;7.2
08;2021-05-16;0;0;5111;2560;14.5;7.2
08;2021-05-17;145;112;5256;2672;14.9;7.6
08;2021-05-18;150;95;5406;2767;15.3;7.8
08;2021-05-19;84;70;5490;2837;15.5;8.0
08;2021-05-20;103;26;5593;2863;15.8;8.1
08;2021-05-21;97;52;5690;2915;16.1;8.2
08;2021-05-22;99;11;5789;2926;16.4;8.3
08;2021-05-23;0;0;5789;2926;16.4;8.3
08;2021-05-24;33;7;5822;2933;16.5;8.3
08;2021-05-25;119;78;5941;3011;16.8;8.5
08;2021-05-26;106;50;6047;3061;17.1;8.7
08;2021-05-27;109;42;6156;3103;17.4;8.8
08;2021-05-28;33;1;6189;3104;17.5;8.8
08;2021-05-29;59;215;6248;3319;17.7;9.4
08;2021-05-30;0;0;6248;3319;17.7;9.4
08;2021-05-31;108;65;6356;3384;18.0;9.6
08;2021-06-01;112;63;6468;3447;18.3;9.8
08;2021-06-02;130;33;6598;3480;18.7;9.8
08;2021-06-03;100;38;6698;3518;19.0;10.0
08;2021-06-04;126;71;6824;3589;19.3;10.2
08;2021-06-05;82;21;6906;3610;19.5;10.2
08;2021-06-06;0;0;6906;3610;19.5;10.2
08;2021-06-07;96;95;7002;3705;19.8;10.5
08;2021-06-08;82;89;7084;3794;20.0;10.7
08;2021-06-09;96;74;7180;3868;20.3;10.9
08;2021-06-10;111;65;7291;3933;20.6;11.1
08;2021-06-11;116;108;7407;4041;21.0;11.4
08;2021-06-12;57;30;7464;4071;21.1;11.5
08;2021-06-13;0;0;7464;4071;21.1;11.5
08;2021-06-14;106;128;7570;4199;21.4;11.9
08;2021-06-15;86;118;7656;4317;21.7;12.2
08;2021-06-16;103;148;7759;4465;22.0;12.6
08;2021-06-17;84;72;7843;4537;22.2;12.8
08;2021-06-18;65;98;7908;4635;22.4;13.1
08;2021-06-19;64;80;7972;4715;22.6;13.3
08;2021-06-20;0;0;7972;4715;22.6;13.3
08;2021-06-21;76;149;8048;4864;22.8;13.8
11;2020-12-27;13;2;13;2;0.0;0.0
11;2020-12-28;11;0;24;2;0.0;0.0
11;2020-12-29;56;0;80;2;0.0;0.0
11;2020-12-30;91;0;171;2;0.0;0.0
11;2020-12-31;39;0;210;2;0.0;0.0
11;2021-01-01;30;1;240;3;0.0;0.0
11;2021-01-02;64;1;304;4;0.0;0.0
11;2021-01-03;78;0;382;4;0.0;0.0
11;2021-01-04;551;5;933;9;0.0;0.0
11;2021-01-05;2066;17;2999;26;0.0;0.0
11;2021-01-06;3018;22;6017;48;0.0;0.0
11;2021-01-07;5372;37;11389;85;0.1;0.0
11;2021-01-08;7115;46;18504;131;0.2;0.0
11;2021-01-09;1886;6;20390;137;0.2;0.0
11;2021-01-10;1748;8;22138;145;0.2;0.0
11;2021-01-11;8001;63;30139;208;0.2;0.0
11;2021-01-12;10347;100;40486;308;0.3;0.0
11;2021-01-13;10008;96;50494;404;0.4;0.0
11;2021-01-14;10097;133;60591;537;0.5;0.0
11;2021-01-15;8895;84;69486;621;0.6;0.0
11;2021-01-16;2400;34;71886;655;0.6;0.0
11;2021-01-17;1083;19;72969;674;0.6;0.0
11;2021-01-18;12238;130;85207;804;0.7;0.0
11;2021-01-19;15814;127;101021;931;0.8;0.0
11;2021-01-20;18358;117;119379;1048;1.0;0.0
11;2021-01-21;22258;144;141637;1192;1.2;0.0
11;2021-01-22;17057;162;158694;1354;1.3;0.0
11;2021-01-23;4958;20;163652;1374;1.3;0.0
11;2021-01-24;1279;6;164931;1380;1.3;0.0
11;2021-01-25;8867;190;173798;1570;1.4;0.0
11;2021-01-26;12332;382;186130;1952;1.5;0.0
11;2021-01-27;16224;690;202354;2642;1.6;0.0
11;2021-01-28;20295;1195;222649;3837;1.8;0.0
11;2021-01-29;15391;1377;238040;5214;1.9;0.0
11;2021-01-30;4460;102;242500;5316;2.0;0.0
11;2021-01-31;582;22;243082;5338;2.0;0.0
11;2021-02-01;7385;1959;250467;7297;2.0;0.1
11;2021-02-02;8347;2820;258814;10117;2.1;0.1
11;2021-02-03;8121;3807;266935;13924;2.2;0.1
11;2021-02-04;8781;4595;275716;18519;2.2;0.2
11;2021-02-05;8950;4431;284666;22950;2.3;0.2
11;2021-02-06;3268;750;287934;23700;2.3;0.2
11;2021-02-07;588;541;288522;24241;2.3;0.2
11;2021-02-08;6228;5922;294750;30163;2.4;0.2
11;2021-02-09;8429;9682;303179;39845;2.5;0.3
11;2021-02-10;9955;11216;313134;51061;2.6;0.4
11;2021-02-11;12360;16509;325494;67570;2.7;0.6
11;2021-02-12;11857;10603;337351;78173;2.7;0.6
11;2021-02-13;2592;2589;339943;80762;2.8;0.7
11;2021-02-14;311;560;340254;81322;2.8;0.7
11;2021-02-15;4448;12023;344702;93345;2.8;0.8
11;2021-02-16;5656;18501;350358;111846;2.9;0.9
11;2021-02-17;5669;15619;356027;127465;2.9;1.0
11;2021-02-18;8634;20810;364661;148275;3.0;1.2
11;2021-02-19;9032;15441;373693;163716;3.0;1.3
11;2021-02-20;1690;4847;375383;168563;3.1;1.4
11;2021-02-21;396;831;375779;169394;3.1;1.4
11;2021-02-22;4223;9929;380002;179323;3.1;1.5
11;2021-02-23;4941;10544;384943;189867;3.1;1.5
11;2021-02-24;5395;9885;390338;199752;3.2;1.6
11;2021-02-25;8603;14170;398941;213922;3.2;1.7
11;2021-02-26;11168;10180;410109;224102;3.3;1.8
11;2021-02-27;5063;3333;415172;227435;3.4;1.9
11;2021-02-28;738;662;415910;228097;3.4;1.9
11;2021-03-01;8832;7985;424742;236082;3.5;1.9
11;2021-03-02;14374;9654;439116;245736;3.6;2.0
11;2021-03-03;18642;10120;457758;255856;3.7;2.1
11;2021-03-04;28227;11120;485985;266976;4.0;2.2
11;2021-03-05;36464;11082;522449;278058;4.3;2.3
11;2021-03-06;46396;3542;568845;281600;4.6;2.3
11;2021-03-07;34285;2757;603130;284357;4.9;2.3
11;2021-03-08;17742;7405;620872;291762;5.1;2.4
11;2021-03-09;26827;7722;647699;299484;5.3;2.4
11;2021-03-10;27608;8347;675307;307831;5.5;2.5
11;2021-03-11;37002;9881;712309;317712;5.8;2.6
11;2021-03-12;44742;9423;757051;327135;6.2;2.7
11;2021-03-13;39853;2663;796904;329798;6.5;2.7
11;2021-03-14;14270;797;811174;330595;6.6;2.7
11;2021-03-15;29190;4019;840364;334614;6.8;2.7
11;2021-03-16;23737;3870;864101;338484;7.0;2.8
11;2021-03-17;24370;3678;888471;342162;7.2;2.8
11;2021-03-18;28995;4124;917466;346286;7.5;2.8
11;2021-03-19;39629;4326;957095;350612;7.8;2.9
11;2021-03-20;25828;1600;982923;352212;8.0;2.9
11;2021-03-21;5622;1328;988545;353540;8.1;2.9
11;2021-03-22;32099;4259;1020644;357799;8.3;2.9
11;2021-03-23;43258;5468;1063902;363267;8.7;3.0
11;2021-03-24;42586;5066;1106488;368333;9.0;3.0
11;2021-03-25;57867;5244;1164355;373577;9.5;3.0
11;2021-03-26;57670;6009;1222025;379586;10.0;3.1
11;2021-03-27;34472;2118;1256497;381704;10.2;3.1
11;2021-03-28;10154;484;1266651;382188;10.3;3.1
11;2021-03-29;32991;8194;1299642;390382;10.6;3.2
11;2021-03-30;44807;11612;1344449;401994;10.9;3.3
11;2021-03-31;39808;13949;1384257;415943;11.3;3.4
11;2021-04-01;45257;21836;1429514;437779;11.6;3.6
11;2021-04-02;39276;24132;1468790;461911;12.0;3.8
11;2021-04-03;18356;21169;1487146;483080;12.1;3.9
11;2021-04-04;6099;7350;1493245;490430;12.2;4.0
11;2021-04-05;5944;2161;1499189;492591;12.2;4.0
11;2021-04-06;29935;18462;1529124;511053;12.5;4.2
11;2021-04-07;37472;20044;1566596;531097;12.8;4.3
11;2021-04-08;46606;21155;1613202;552252;13.1;4.5
11;2021-04-09;53711;21628;1666913;573880;13.6;4.7
11;2021-04-10;28924;19736;1695837;593616;13.8;4.8
11;2021-04-11;6545;7225;1702382;600841;13.9;4.9
11;2021-04-12;30262;19297;1732644;620138;14.1;5.1
11;2021-04-13;37266;27621;1769910;647759;14.4;5.3
11;2021-04-14;34928;24395;1804838;672154;14.7;5.5
11;2021-04-15;39114;28533;1843952;700687;15.0;5.7
11;2021-04-16;40988;27864;1884940;728551;15.4;5.9
11;2021-04-17;22743;15009;1907683;743560;15.5;6.1
11;2021-04-18;5287;3741;1912970;747301;15.6;6.1
11;2021-04-19;25070;23229;1938040;770530;15.8;6.3
11;2021-04-20;30531;27946;1968571;798476;16.0;6.5
11;2021-04-21;32172;28256;2000743;826732;16.3;6.7
11;2021-04-22;34452;34786;2035195;861518;16.6;7.0
11;2021-04-23;37881;32358;2073076;893876;16.9;7.3
11;2021-04-24;37934;23219;2111010;917095;17.2;7.5
11;2021-04-25;20510;8018;2131520;925113;17.4;7.5
11;2021-04-26;33839;25281;2165359;950394;17.6;7.7
11;2021-04-27;45704;30146;2211063;980540;18.0;8.0
11;2021-04-28;48393;29888;2259456;1010428;18.4;8.2
11;2021-04-29;57738;32372;2317194;1042800;18.9;8.5
11;2021-04-30;61277;31174;2378471;1073974;19.4;8.7
11;2021-05-01;24088;6053;2402559;1080027;19.6;8.8
11;2021-05-02;14620;5021;2417179;1085048;19.7;8.8
11;2021-05-03;54352;35316;2471531;1120364;20.1;9.1
11;2021-05-04;59685;33980;2531216;1154344;20.6;9.4
11;2021-05-05;60259;34198;2591475;1188542;21.1;9.7
11;2021-05-06;67192;38146;2658667;1226688;21.7;10.0
11;2021-05-07;65486;40076;2724153;1266764;22.2;10.3
11;2021-05-08;51055;16950;2775208;1283714;22.6;10.5
11;2021-05-09;33152;10226;2808360;1293940;22.9;10.5
11;2021-05-10;70642;30623;2879002;1324563;23.4;10.8
11;2021-05-11;81408;38098;2960410;1362661;24.1;11.1
11;2021-05-12;82861;32449;3043271;1395110;24.8;11.4
11;2021-05-13;67741;9986;3111012;1405096;25.3;11.4
11;2021-05-14;84041;22103;3195053;1427199;26.0;11.6
11;2021-05-15;66296;15389;3261349;1442588;26.6;11.7
11;2021-05-16;36363;5151;3297712;1447739;26.9;11.8
11;2021-05-17;82276;16885;3379988;1464624;27.5;11.9
11;2021-05-18;98130;19882;3478118;1484506;28.3;12.1
11;2021-05-19;97659;27831;3575777;1512337;29.1;12.3
11;2021-05-20;106372;28808;3682149;1541145;30.0;12.6
11;2021-05-21;100773;26010;3782922;1567155;30.8;12.8
11;2021-05-22;79333;14846;3862255;1582001;31.5;12.9
11;2021-05-23;41608;6047;3903863;1588048;31.8;12.9
11;2021-05-24;59540;8803;3963403;1596851;32.3;13.0
11;2021-05-25;85163;32235;4048566;1629086;33.0;13.3
11;2021-05-26;83599;32509;4132165;1661595;33.7;13.5
11;2021-05-27;91798;40579;4223963;1702174;34.4;13.9
11;2021-05-28;86565;45607;4310528;1747781;35.1;14.2
11;2021-05-29;67934;27548;4378462;1775329;35.7;14.5
11;2021-05-30;35864;8511;4414326;1783840;36.0;14.5
11;2021-05-31;77710;39957;4492036;1823797;36.6;14.9
11;2021-06-01;86617;50960;4578653;1874757;37.3;15.3
11;2021-06-02;82670;45540;4661323;1920297;38.0;15.6
11;2021-06-03;88563;53711;4749886;1974008;38.7;16.1
11;2021-06-04;84456;58762;4834342;2032770;39.4;16.6
11;2021-06-05;63448;49926;4897790;2082696;39.9;17.0
11;2021-06-06;37831;17568;4935621;2100264;40.2;17.1
11;2021-06-07;68776;53627;5004397;2153891;40.8;17.5
11;2021-06-08;73325;62010;5077722;2215901;41.4;18.0
11;2021-06-09;69645;63033;5147367;2278934;41.9;18.6
11;2021-06-10;70671;80755;5218038;2359689;42.5;19.2
11;2021-06-11;65434;72089;5283472;2431778;43.0;19.8
11;2021-06-12;63617;47641;5347089;2479419;43.5;20.2
11;2021-06-13;29507;22858;5376596;2502277;43.8;20.4
11;2021-06-14;43075;75249;5419671;2577526;44.1;21.0
11;2021-06-15;50886;82892;5470557;2660418;44.6;21.7
11;2021-06-16;52138;78140;5522695;2738558;45.0;22.3
11;2021-06-17;53738;81643;5576433;2820201;45.4;23.0
11;2021-06-18;49365;95795;5625798;2915996;45.8;23.7
11;2021-06-19;43195;69063;5668993;2985059;46.2;24.3
11;2021-06-20;16154;36004;5685147;3021063;46.3;24.6
11;2021-06-21;33729;84114;5718876;3105177;46.6;25.3
24;2020-12-27;0;0;0;0;0.0;0.0
24;2020-12-28;17;0;17;0;0.0;0.0
24;2020-12-29;10;0;27;0;0.0;0.0
24;2020-12-30;1;0;28;0;0.0;0.0
24;2020-12-31;0;0;28;0;0.0;0.0
24;2021-01-01;1;0;29;0;0.0;0.0
24;2021-01-02;0;0;29;0;0.0;0.0
24;2021-01-03;0;0;29;0;0.0;0.0
24;2021-01-04;24;0;53;0;0.0;0.0
24;2021-01-05;163;0;216;0;0.0;0.0
24;2021-01-06;328;0;544;0;0.0;0.0
24;2021-01-07;492;0;1036;0;0.0;0.0
24;2021-01-08;952;2;1988;2;0.1;0.0
24;2021-01-09;504;0;2492;2;0.1;0.0
24;2021-01-10;395;0;2887;2;0.1;0.0
24;2021-01-11;1279;0;4166;2;0.2;0.0
24;2021-01-12;2575;9;6741;11;0.3;0.0
24;2021-01-13;2189;6;8930;17;0.3;0.0
24;2021-01-14;2502;52;11432;69;0.4;0.0
24;2021-01-15;2114;7;13546;76;0.5;0.0
24;2021-01-16;857;5;14403;81;0.6;0.0
24;2021-01-17;322;3;14725;84;0.6;0.0
24;2021-01-18;3214;16;17939;100;0.7;0.0
24;2021-01-19;6324;17;24263;117;0.9;0.0
24;2021-01-20;7166;10;31429;127;1.2;0.0
24;2021-01-21;7418;4;38847;131;1.5;0.0
24;2021-01-22;5117;3;43964;134;1.7;0.0
24;2021-01-23;1274;1;45238;135;1.8;0.0
24;2021-01-24;225;1;45463;136;1.8;0.0
24;2021-01-25;3113;24;48576;160;1.9;0.0
24;2021-01-26;4847;88;53423;248;2.1;0.0
24;2021-01-27;5045;183;58468;431;2.3;0.0
24;2021-01-28;5634;508;64102;939;2.5;0.0
24;2021-01-29;3422;731;67524;1670;2.6;0.1
24;2021-01-30;1207;398;68731;2068;2.7;0.1
24;2021-01-31;251;368;68982;2436;2.7;0.1
24;2021-02-01;2170;927;71152;3363;2.8;0.1
24;2021-02-02;3032;1891;74184;5254;2.9;0.2
24;2021-02-03;3110;1768;77294;7022;3.0;0.3
24;2021-02-04;3234;1618;80528;8640;3.1;0.3
24;2021-02-05;2394;1370;82922;10010;3.2;0.4
24;2021-02-06;707;262;83629;10272;3.3;0.4
24;2021-02-07;134;32;83763;10304;3.3;0.4
24;2021-02-08;1967;1570;85730;11874;3.4;0.5
24;2021-02-09;3412;3315;89142;15189;3.5;0.6
24;2021-02-10;4085;3754;93227;18943;3.6;0.7
24;2021-02-11;4654;4775;97881;23718;3.8;0.9
24;2021-02-12;3481;3271;101362;26989;4.0;1.1
24;2021-02-13;839;770;102201;27759;4.0;1.1
24;2021-02-14;426;256;102627;28015;4.0;1.1
24;2021-02-15;1963;2860;104590;30875;4.1;1.2
24;2021-02-16;2849;4497;107439;35372;4.2;1.4
24;2021-02-17;2692;5102;110131;40474;4.3;1.6
24;2021-02-18;3519;5167;113650;45641;4.4;1.8
24;2021-02-19;3196;3557;116846;49198;4.6;1.9
24;2021-02-20;1288;985;118134;50183;4.6;2.0
24;2021-02-21;433;239;118567;50422;4.6;2.0
24;2021-02-22;1650;3061;120217;53483;4.7;2.1
24;2021-02-23;2339;3139;122556;56622;4.8;2.2
24;2021-02-24;2093;3467;124649;60089;4.9;2.3
24;2021-02-25;3620;3165;128269;63254;5.0;2.5
24;2021-02-26;4465;2619;132734;65873;5.2;2.6
24;2021-02-27;1877;995;134611;66868;5.3;2.6
24;2021-02-28;97;219;134708;67087;5.3;2.6
24;2021-03-01;2171;2022;136879;69109;5.3;2.7
24;2021-03-02;3430;2890;140309;71999;5.5;2.8
24;2021-03-03;3548;3411;143857;75410;5.6;2.9
24;2021-03-04;5336;3703;149193;79113;5.8;3.1
24;2021-03-05;7036;3169;156229;82282;6.1;3.2
24;2021-03-06;7375;749;163604;83031;6.4;3.2
24;2021-03-07;2428;289;166032;83320;6.5;3.3
24;2021-03-08;2689;2624;168721;85944;6.6;3.4
24;2021-03-09;5778;2847;174499;88791;6.8;3.5
24;2021-03-10;6405;3522;180904;92313;7.1;3.6
24;2021-03-11;7800;3506;188704;95819;7.4;3.7
24;2021-03-12;10787;2681;199491;98500;7.8;3.8
24;2021-03-13;7118;720;206609;99220;8.1;3.9
24;2021-03-14;1550;270;208159;99490;8.1;3.9
24;2021-03-15;4559;1974;212718;101464;8.3;4.0
24;2021-03-16;4595;2369;217313;103833;8.5;4.1
24;2021-03-17;4462;1985;221775;105818;8.7;4.1
24;2021-03-18;5063;2091;226838;107909;8.9;4.2
24;2021-03-19;7776;1681;234614;109590;9.2;4.3
24;2021-03-20;4431;879;239045;110469;9.3;4.3
24;2021-03-21;557;349;239602;110818;9.4;4.3
24;2021-03-22;4860;1716;244462;112534;9.6;4.4
24;2021-03-23;8036;2295;252498;114829;9.9;4.5
24;2021-03-24;8814;2006;261312;116835;10.2;4.6
24;2021-03-25;12138;1959;273450;118794;10.7;4.6
24;2021-03-26;13270;1977;286720;120771;11.2;4.7
24;2021-03-27;5776;672;292496;121443;11.4;4.7
24;2021-03-28;520;97;293016;121540;11.5;4.7
24;2021-03-29;6758;1870;299774;123410;11.7;4.8
24;2021-03-30;10169;2785;309943;126195;12.1;4.9
24;2021-03-31;9886;2337;319829;128532;12.5;5.0
24;2021-04-01;12038;3396;331867;131928;13.0;5.2
24;2021-04-02;10611;3332;342478;135260;13.4;5.3
24;2021-04-03;3401;1713;345879;136973;13.5;5.4
24;2021-04-04;394;341;346273;137314;13.5;5.4
24;2021-04-05;396;51;346669;137365;13.5;5.4
24;2021-04-06;8313;3410;354982;140775;13.9;5.5
24;2021-04-07;11061;4548;366043;145323;14.3;5.7
24;2021-04-08;14174;4741;380217;150064;14.9;5.9
24;2021-04-09;17736;3712;397953;153776;15.6;6.0
24;2021-04-10;9380;2080;407333;155856;15.9;6.1
24;2021-04-11;2908;1248;410241;157104;16.0;6.1
24;2021-04-12;10839;3437;421080;160541;16.5;6.3
24;2021-04-13;14989;4819;436069;165360;17.0;6.5
24;2021-04-14;13459;4919;449528;170279;17.6;6.7
24;2021-04-15;15334;5121;464862;175400;18.2;6.9
24;2021-04-16;15665;4332;480527;179732;18.8;7.0
24;2021-04-17;8189;1318;488716;181050;19.1;7.1
24;2021-04-18;1099;286;489815;181336;19.1;7.1
24;2021-04-19;9436;4138;499251;185474;19.5;7.2
24;2021-04-20;12720;5968;511971;191442;20.0;7.5
24;2021-04-21;12326;5994;524297;197436;20.5;7.7
24;2021-04-22;13857;7532;538154;204968;21.0;8.0
24;2021-04-23;13694;7039;551848;212007;21.6;8.3
24;2021-04-24;10236;3247;562084;215254;22.0;8.4
24;2021-04-25;3048;433;565132;215687;22.1;8.4
24;2021-04-26;10201;5425;575333;221112;22.5;8.6
24;2021-04-27;13870;7752;589203;228864;23.0;8.9
24;2021-04-28;13021;8450;602224;237314;23.5;9.3
24;2021-04-29;16577;8582;618801;245896;24.2;9.6
24;2021-04-30;17473;7229;636274;253125;24.9;9.9
24;2021-05-01;2911;670;639185;253795;25.0;9.9
24;2021-05-02;2140;318;641325;254113;25.1;9.9
24;2021-05-03;11282;6111;652607;260224;25.5;10.2
24;2021-05-04;12799;10291;665406;270515;26.0;10.6
24;2021-05-05;13872;9576;679278;280091;26.5;10.9
24;2021-05-06;17477;9667;696755;289758;27.2;11.3
24;2021-05-07;14532;11983;711287;301741;27.8;11.8
24;2021-05-08;3704;2374;714991;304115;27.9;11.9
24;2021-05-09;2326;3730;717317;307845;28.0;12.0
24;2021-05-10;11503;12193;728820;320038;28.5;12.5
24;2021-05-11;16344;14200;745164;334238;29.1;13.1
24;2021-05-12;18174;13143;763338;347381;29.8;13.6
24;2021-05-13;6915;3161;770253;350542;30.1;13.7
24;2021-05-14;14482;9173;784735;359715;30.7;14.1
24;2021-05-15;10460;5049;795195;364764;31.1;14.3
24;2021-05-16;3157;1182;798352;365946;31.2;14.3
24;2021-05-17;13290;7655;811642;373601;31.7;14.6
24;2021-05-18;18381;8203;830023;381804;32.4;14.9
24;2021-05-19;19006;7490;849029;389294;33.2;15.2
24;2021-05-20;21296;8447;870325;397741;34.0;15.5
24;2021-05-21;18361;9080;888686;406821;34.7;15.9
24;2021-05-22;7616;4187;896302;411008;35.0;16.1
24;2021-05-23;2976;942;899278;411950;35.1;16.1
24;2021-05-24;8329;1591;907607;413541;35.5;16.2
24;2021-05-25;17717;8843;925324;422384;36.2;16.5
24;2021-05-26;19224;8282;944548;430666;36.9;16.8
24;2021-05-27;20865;10030;965413;440696;37.7;17.2
24;2021-05-28;20433;12253;985846;452949;38.5;17.7
24;2021-05-29;12402;5900;998248;458849;39.0;17.9
24;2021-05-30;2032;1485;1000280;460334;39.1;18.0
24;2021-05-31;14572;8906;1014852;469240;39.7;18.3
24;2021-06-01;19668;12017;1034520;481257;40.4;18.8
24;2021-06-02;17737;10791;1052257;492048;41.1;19.2
24;2021-06-03;20838;11897;1073095;503945;41.9;19.7
24;2021-06-04;19903;13849;1092998;517794;42.7;20.2
24;2021-06-05;9855;8844;1102853;526638;43.1;20.6
24;2021-06-06;1991;3020;1104844;529658;43.2;20.7
24;2021-06-07;14402;12011;1119246;541669;43.7;21.2
24;2021-06-08;16271;15014;1135517;556683;44.4;21.8
24;2021-06-09;16196;12727;1151713;569410;45.0;22.3
24;2021-06-10;17814;12097;1169527;581507;45.7;22.7
24;2021-06-11;17154;15291;1186681;596798;46.4;23.3
24;2021-06-12;10063;7322;1196744;604120;46.8;23.6
24;2021-06-13;892;1313;1197636;605433;46.8;23.7
24;2021-06-14;10444;15259;1208080;620692;47.2;24.3
24;2021-06-15;12959;17111;1221039;637803;47.7;24.9
24;2021-06-16;13420;16260;1234459;654063;48.2;25.6
24;2021-06-17;13100;17299;1247559;671362;48.8;26.2
24;2021-06-18;14508;19798;1262067;691160;49.3;27.0
24;2021-06-19;7889;6630;1269956;697790;49.6;27.3
24;2021-06-20;549;853;1270505;698643;49.6;27.3
24;2021-06-21;8805;16463;1279310;715106;50.0;27.9
27;2020-12-27;4;0;4;0;0.0;0.0
27;2020-12-28;0;0;4;0;0.0;0.0
27;2020-12-29;19;0;23;0;0.0;0.0
27;2020-12-30;20;0;43;0;0.0;0.0
27;2020-12-31;2;0;45;0;0.0;0.0
27;2021-01-01;0;0;45;0;0.0;0.0
27;2021-01-02;1;0;46;0;0.0;0.0
27;2021-01-03;1;0;47;0;0.0;0.0
27;2021-01-04;27;0;74;0;0.0;0.0
27;2021-01-05;263;0;337;0;0.0;0.0
27;2021-01-06;718;1;1055;1;0.0;0.0
27;2021-01-07;1555;3;2610;4;0.1;0.0
27;2021-01-08;1895;3;4505;7;0.2;0.0
27;2021-01-09;689;0;5194;7;0.2;0.0
27;2021-01-10;3;0;5197;7;0.2;0.0
27;2021-01-11;2419;3;7616;10;0.3;0.0
27;2021-01-12;3823;4;11439;14;0.4;0.0
27;2021-01-13;3847;8;15286;22;0.5;0.0
27;2021-01-14;4751;48;20037;70;0.7;0.0
27;2021-01-15;3593;22;23630;92;0.8;0.0
27;2021-01-16;793;11;24423;103;0.9;0.0
27;2021-01-17;116;1;24539;104;0.9;0.0
27;2021-01-18;6249;19;30788;123;1.1;0.0
27;2021-01-19;8392;23;39180;146;1.4;0.0
27;2021-01-20;7903;59;47083;205;1.7;0.0
27;2021-01-21;9452;21;56535;226;2.0;0.0
27;2021-01-22;7705;17;64240;243;2.3;0.0
27;2021-01-23;2985;6;67225;249;2.4;0.0
27;2021-01-24;347;0;67572;249;2.4;0.0
27;2021-01-25;5219;30;72791;279;2.6;0.0
27;2021-01-26;7389;228;80180;507;2.9;0.0
27;2021-01-27;7096;349;87276;856;3.1;0.0
27;2021-01-28;6333;894;93609;1750;3.4;0.1
27;2021-01-29;5908;1265;99517;3015;3.6;0.1
27;2021-01-30;2485;347;102002;3362;3.7;0.1
27;2021-01-31;252;22;102254;3384;3.7;0.1
27;2021-02-01;3358;1403;105612;4787;3.8;0.2
27;2021-02-02;4040;2225;109652;7012;3.9;0.3
27;2021-02-03;3618;2396;113270;9408;4.1;0.3
27;2021-02-04;3703;3152;116973;12560;4.2;0.5
27;2021-02-05;3241;2588;120214;15148;4.3;0.5
27;2021-02-06;1608;671;121822;15819;4.4;0.6
27;2021-02-07;5;87;121827;15906;4.4;0.6
27;2021-02-08;2911;2685;124738;18591;4.5;0.7
27;2021-02-09;3015;3661;127753;22252;4.6;0.8
27;2021-02-10;3055;3411;130808;25663;4.7;0.9
27;2021-02-11;3316;4651;134124;30314;4.8;1.1
27;2021-02-12;2726;4463;136850;34777;4.9;1.2
27;2021-02-13;985;1467;137835;36244;5.0;1.3
27;2021-02-14;258;300;138093;36544;5.0;1.3
27;2021-02-15;1240;5759;139333;42303;5.0;1.5
27;2021-02-16;1507;7439;140840;49742;5.1;1.8
27;2021-02-17;1807;6917;142647;56659;5.1;2.0
27;2021-02-18;2143;6471;144790;63130;5.2;2.3
27;2021-02-19;1733;5672;146523;68802;5.3;2.5
27;2021-02-20;711;2180;147234;70982;5.3;2.6
27;2021-02-21;2;280;147236;71262;5.3;2.6
27;2021-02-22;978;4902;148214;76164;5.3;2.7
27;2021-02-23;1203;5450;149417;81614;5.4;2.9
27;2021-02-24;1507;4871;150924;86485;5.4;3.1
27;2021-02-25;2921;5062;153845;91547;5.5;3.3
27;2021-02-26;3684;4216;157529;95763;5.7;3.4
27;2021-02-27;1911;1957;159440;97720;5.7;3.5
27;2021-02-28;107;282;159547;98002;5.7;3.5
27;2021-03-01;3669;3509;163216;101511;5.9;3.6
27;2021-03-02;5410;4342;168626;105853;6.1;3.8
27;2021-03-03;5960;3573;174586;109426;6.3;3.9
27;2021-03-04;7705;3566;182291;112992;6.6;4.1
27;2021-03-05;9697;3192;191988;116184;6.9;4.2
27;2021-03-06;6226;1082;198214;117266;7.1;4.2
27;2021-03-07;872;187;199086;117453;7.2;4.2
27;2021-03-08;4542;3424;203628;120877;7.3;4.3
27;2021-03-09;8420;3391;212048;124268;7.6;4.5
27;2021-03-10;8717;2813;220765;127081;7.9;4.6
27;2021-03-11;10264;3200;231029;130281;8.3;4.7
27;2021-03-12;11888;2467;242917;132748;8.7;4.8
27;2021-03-13;7048;695;249965;133443;9.0;4.8
27;2021-03-14;212;60;250177;133503;9.0;4.8
27;2021-03-15;7321;1382;257498;134885;9.3;4.8
27;2021-03-16;8246;1091;265744;135976;9.5;4.9
27;2021-03-17;8535;1179;274279;137155;9.9;4.9
27;2021-03-18;8626;1419;282905;138574;10.2;5.0
27;2021-03-19;9442;1091;292347;139665;10.5;5.0
27;2021-03-20;5670;396;298017;140061;10.7;5.0
27;2021-03-21;238;11;298255;140072;10.7;5.0
27;2021-03-22;9332;958;307587;141030;11.1;5.1
27;2021-03-23;14711;1186;322298;142216;11.6;5.1
27;2021-03-24;15180;1245;337478;143461;12.1;5.2
27;2021-03-25;18373;1456;355851;144917;12.8;5.2
27;2021-03-26;18386;1249;374237;146166;13.4;5.3
27;2021-03-27;7684;408;381921;146574;13.7;5.3
27;2021-03-28;492;124;382413;146698;13.7;5.3
27;2021-03-29;10028;3399;392441;150097;14.1;5.4
27;2021-03-30;12957;4000;405398;154097;14.6;5.5
27;2021-03-31;12836;4195;418234;158292;15.0;5.7
27;2021-04-01;14542;4130;432776;162422;15.6;5.8
27;2021-04-02;12939;4044;445715;166466;16.0;6.0
27;2021-04-03;4476;1135;450191;167601;16.2;6.0
27;2021-04-04;69;35;450260;167636;16.2;6.0
27;2021-04-05;345;7;450605;167643;16.2;6.0
27;2021-04-06;9558;6177;460163;173820;16.5;6.2
27;2021-04-07;10192;6462;470355;180282;16.9;6.5
27;2021-04-08;15716;6144;486071;186426;17.5;6.7
27;2021-04-09;17828;5989;503899;192415;18.1;6.9
27;2021-04-10;6062;1946;509961;194361;18.3;7.0
27;2021-04-11;419;83;510380;194444;18.3;7.0
27;2021-04-12;9059;6794;519439;201238;18.7;7.2
27;2021-04-13;11733;8501;531172;209739;19.1;7.5
27;2021-04-14;10282;7838;541454;217577;19.5;7.8
27;2021-04-15;12955;7660;554409;225237;19.9;8.1
27;2021-04-16;12752;6437;567161;231674;20.4;8.3
27;2021-04-17;5916;3024;573077;234698;20.6;8.4
27;2021-04-18;354;189;573431;234887;20.6;8.4
27;2021-04-19;6969;8857;580400;243744;20.9;8.8
27;2021-04-20;8473;10530;588873;254274;21.2;9.1
27;2021-04-21;8326;10137;597199;264411;21.5;9.5
27;2021-04-22;9851;11521;607050;275932;21.8;9.9
27;2021-04-23;11331;10291;618381;286223;22.2;10.3
27;2021-04-24;5162;3949;623543;290172;22.4;10.4
27;2021-04-25;440;294;623983;290466;22.4;10.4
27;2021-04-26;9537;8742;633520;299208;22.8;10.8
27;2021-04-27;13456;10235;646976;309443;23.2;11.1
27;2021-04-28;14188;10349;661164;319792;23.8;11.5
27;2021-04-29;17872;11514;679036;331306;24.4;11.9
27;2021-04-30;18716;9500;697752;340806;25.1;12.2
27;2021-05-01;5426;1539;703178;342345;25.3;12.3
27;2021-05-02;601;73;703779;342418;25.3;12.3
27;2021-05-03;14898;6313;718677;348731;25.8;12.5
27;2021-05-04;13929;10784;732606;359515;26.3;12.9
27;2021-05-05;15551;10012;748157;369527;26.9;13.3
27;2021-05-06;18267;12325;766424;381852;27.5;13.7
27;2021-05-07;17211;11737;783635;393589;28.2;14.1
27;2021-05-08;5943;1507;789578;395096;28.4;14.2
27;2021-05-09;533;439;790111;395535;28.4;14.2
27;2021-05-10;15253;9866;805364;405401;28.9;14.6
27;2021-05-11;20718;12861;826082;418262;29.7;15.0
27;2021-05-12;19543;11703;845625;429965;30.4;15.4
27;2021-05-13;12274;2014;857899;431979;30.8;15.5
27;2021-05-14;22853;8342;880752;440321;31.6;15.8
27;2021-05-15;15366;3387;896118;443708;32.2;15.9
27;2021-05-16;1881;234;897999;443942;32.3;16.0
27;2021-05-17;18920;6767;916919;450709;32.9;16.2
27;2021-05-18;20500;9266;937419;459975;33.7;16.5
27;2021-05-19;22205;7273;959624;467248;34.5;16.8
27;2021-05-20;23171;8172;982795;475420;35.3;17.1
27;2021-05-21;21064;10023;1003859;485443;36.1;17.4
27;2021-05-22;8255;3595;1012114;489038;36.4;17.6
27;2021-05-23;901;304;1013015;489342;36.4;17.6
27;2021-05-24;4223;1080;1017238;490422;36.6;17.6
27;2021-05-25;14840;11608;1032078;502030;37.1;18.0
27;2021-05-26;15343;10625;1047421;512655;37.6;18.4
27;2021-05-27;18362;11793;1065783;524448;38.3;18.8
27;2021-05-28;16057;14107;1081840;538555;38.9;19.4
27;2021-05-29;6808;5148;1088648;543703;39.1;19.5
27;2021-05-30;390;255;1089038;543958;39.1;19.5
27;2021-05-31;13300;10920;1102338;554878;39.6;19.9
27;2021-06-01;16490;13420;1118828;568298;40.2;20.4
27;2021-06-02;16140;11435;1134968;579733;40.8;20.8
27;2021-06-03;17717;11850;1152685;591583;41.4;21.3
27;2021-06-04;16159;14609;1168844;606192;42.0;21.8
27;2021-06-05;8336;6748;1177180;612940;42.3;22.0
27;2021-06-06;1717;644;1178897;613584;42.4;22.0
27;2021-06-07;17422;13082;1196319;626666;43.0;22.5
27;2021-06-08;19858;15363;1216177;642029;43.7;23.1
27;2021-06-09;18685;12465;1234862;654494;44.4;23.5
27;2021-06-10;18970;13877;1253832;668371;45.1;24.0
27;2021-06-11;18089;17070;1271921;685441;45.7;24.6
27;2021-06-12;9464;7832;1281385;693273;46.0;24.9
27;2021-06-13;934;940;1282319;694213;46.1;24.9
27;2021-06-14;11051;17035;1293370;711248;46.5;25.6
27;2021-06-15;14111;17603;1307481;728851;47.0;26.2
27;2021-06-16;14654;15581;1322135;744432;47.5;26.7
27;2021-06-17;15132;17233;1337267;761665;48.1;27.4
27;2021-06-18;14733;20145;1352000;781810;48.6;28.1
27;2021-06-19;7631;8639;1359631;790449;48.9;28.4
27;2021-06-20;169;457;1359800;790906;48.9;28.4
27;2021-06-21;7724;19003;1367524;809909;49.1;29.1
28;2020-12-27;0;0;0;0;0.0;0.0
28;2020-12-28;1;0;1;0;0.0;0.0
28;2020-12-29;2;0;3;0;0.0;0.0
28;2020-12-30;0;0;3;0;0.0;0.0
28;2020-12-31;1;0;4;0;0.0;0.0
28;2021-01-01;2;0;6;0;0.0;0.0
28;2021-01-02;1;0;7;0;0.0;0.0
28;2021-01-03;1;0;8;0;0.0;0.0
28;2021-01-04;16;0;24;0;0.0;0.0
28;2021-01-05;169;0;193;0;0.0;0.0
28;2021-01-06;1393;2;1586;2;0.0;0.0
28;2021-01-07;2599;9;4185;11;0.1;0.0
28;2021-01-08;3428;3;7613;14;0.2;0.0
28;2021-01-09;1331;3;8944;17;0.3;0.0
28;2021-01-10;705;1;9649;18;0.3;0.0
28;2021-01-11;3179;4;12828;22;0.4;0.0
28;2021-01-12;3977;3;16805;25;0.5;0.0
28;2021-01-13;4302;6;21107;31;0.6;0.0
28;2021-01-14;8097;72;29204;103;0.9;0.0
28;2021-01-15;6219;25;35423;128;1.1;0.0
28;2021-01-16;2086;9;37509;137;1.1;0.0
28;2021-01-17;4071;21;41580;158;1.3;0.0
28;2021-01-18;8783;12;50363;170;1.5;0.0
28;2021-01-19;7141;13;57504;183;1.7;0.0
28;2021-01-20;6505;11;64009;194;1.9;0.0
28;2021-01-21;5992;10;70001;204;2.1;0.0
28;2021-01-22;5440;12;75441;216;2.3;0.0
28;2021-01-23;2019;7;77460;223;2.3;0.0
28;2021-01-24;1447;11;78907;234;2.4;0.0
28;2021-01-25;6238;179;85145;413;2.6;0.0
28;2021-01-26;4575;394;89720;807;2.7;0.0
28;2021-01-27;4034;765;93754;1572;2.8;0.0
28;2021-01-28;3755;1049;97509;2621;3.0;0.1
28;2021-01-29;3487;1306;100996;3927;3.1;0.1
28;2021-01-30;1386;517;102382;4444;3.1;0.1
28;2021-01-31;195;126;102577;4570;3.1;0.1
28;2021-02-01;2780;1661;105357;6231;3.2;0.2
28;2021-02-02;2985;2392;108342;8623;3.3;0.3
28;2021-02-03;2947;2671;111289;11294;3.4;0.3
28;2021-02-04;3725;5209;115014;16503;3.5;0.5
28;2021-02-05;3885;4393;118899;20896;3.6;0.6
28;2021-02-06;1138;1548;120037;22444;3.6;0.7
28;2021-02-07;715;1975;120752;24419;3.7;0.7
28;2021-02-08;3800;6861;124552;31280;3.8;0.9
28;2021-02-09;3459;6032;128011;37312;3.9;1.1
28;2021-02-10;3455;5075;131466;42387;4.0;1.3
28;2021-02-11;4208;4897;135674;47284;4.1;1.4
28;2021-02-12;4043;4614;139717;51898;4.2;1.6
28;2021-02-13;1124;1583;140841;53481;4.3;1.6
28;2021-02-14;285;1388;141126;54869;4.3;1.7
28;2021-02-15;2212;6282;143338;61151;4.3;1.9
28;2021-02-16;2654;5667;145992;66818;4.4;2.0
28;2021-02-17;1951;4557;147943;71375;4.5;2.2
28;2021-02-18;2568;4312;150511;75687;4.6;2.3
28;2021-02-19;2547;3721;153058;79408;4.6;2.4
28;2021-02-20;945;1260;154003;80668;4.7;2.4
28;2021-02-21;102;416;154105;81084;4.7;2.5
28;2021-02-22;1668;4234;155773;85318;4.7;2.6
28;2021-02-23;2172;3841;157945;89159;4.8;2.7
28;2021-02-24;2372;3897;160317;93056;4.9;2.8
28;2021-02-25;4771;4201;165088;97257;5.0;2.9
28;2021-02-26;5959;3739;171047;100996;5.2;3.1
28;2021-02-27;3008;1030;174055;102026;5.3;3.1
28;2021-02-28;340;387;174395;102413;5.3;3.1
28;2021-03-01;2524;4659;176919;107072;5.4;3.2
28;2021-03-02;3899;4099;180818;111171;5.5;3.4
28;2021-03-03;4789;3485;185607;114656;5.6;3.5
28;2021-03-04;7301;2860;192908;117516;5.8;3.6
28;2021-03-05;10143;2493;203051;120009;6.1;3.6
28;2021-03-06;9807;787;212858;120796;6.4;3.7
28;2021-03-07;3771;127;216629;120923;6.6;3.7
28;2021-03-08;5865;3277;222494;124200;6.7;3.8
28;2021-03-09;9283;2817;231777;127017;7.0;3.8
28;2021-03-10;9801;2441;241578;129458;7.3;3.9
28;2021-03-11;13957;2008;255535;131466;7.7;4.0
28;2021-03-12;17984;1546;273519;133012;8.3;4.0
28;2021-03-13;11145;522;284664;133534;8.6;4.0
28;2021-03-14;2258;99;286922;133633;8.7;4.0
28;2021-03-15;8643;868;295565;134501;8.9;4.1
28;2021-03-16;7486;1187;303051;135688;9.2;4.1
28;2021-03-17;7716;1186;310767;136874;9.4;4.1
28;2021-03-18;8162;1370;318929;138244;9.7;4.2
28;2021-03-19;11562;1457;330491;139701;10.0;4.2
28;2021-03-20;9667;539;340158;140240;10.3;4.2
28;2021-03-21;2409;21;342567;140261;10.4;4.2
28;2021-03-22;9382;1632;351949;141893;10.7;4.3
28;2021-03-23;12482;1507;364431;143400;11.0;4.3
28;2021-03-24;13249;1589;377680;144989;11.4;4.4
28;2021-03-25;17614;1809;395294;146798;12.0;4.4
28;2021-03-26;20815;1869;416109;148667;12.6;4.5
28;2021-03-27;11491;1121;427600;149788;12.9;4.5
28;2021-03-28;2964;88;430564;149876;13.0;4.5
28;2021-03-29;11760;2955;442324;152831;13.4;4.6
28;2021-03-30;14404;3064;456728;155895;13.8;4.7
28;2021-03-31;14361;3560;471089;159455;14.3;4.8
28;2021-04-01;18012;5536;489101;164991;14.8;5.0
28;2021-04-02;16800;6380;505901;171371;15.3;5.2
28;2021-04-03;6995;3965;512896;175336;15.5;5.3
28;2021-04-04;1776;797;514672;176133;15.6;5.3
28;2021-04-05;3288;737;517960;176870;15.7;5.4
28;2021-04-06;10805;7372;528765;184242;16.0;5.6
28;2021-04-07;12682;6947;541447;191189;16.4;5.8
28;2021-04-08;17653;7538;559100;198727;16.9;6.0
28;2021-04-09;23799;7829;582899;206556;17.6;6.3
28;2021-04-10;13820;4120;596719;210676;18.1;6.4
28;2021-04-11;3028;1192;599747;211868;18.2;6.4
28;2021-04-12;13762;8030;613509;219898;18.6;6.7
28;2021-04-13;16170;8042;629679;227940;19.1;6.9
28;2021-04-14;14287;8018;643966;235958;19.5;7.1
28;2021-04-15;17209;8395;661175;244353;20.0;7.4
28;2021-04-16;20256;7828;681431;252181;20.6;7.6
28;2021-04-17;12731;5020;694162;257201;21.0;7.8
28;2021-04-18;2287;1241;696449;258442;21.1;7.8
28;2021-04-19;10863;8869;707312;267311;21.4;8.1
28;2021-04-20;13897;9770;721209;277081;21.8;8.4
28;2021-04-21;13275;9993;734484;287074;22.2;8.7
28;2021-04-22;15281;11897;749765;298971;22.7;9.1
28;2021-04-23;16418;12317;766183;311288;23.2;9.4
28;2021-04-24;12575;7263;778758;318551;23.6;9.6
28;2021-04-25;3293;1913;782051;320464;23.7;9.7
28;2021-04-26;12533;10180;794584;330644;24.1;10.0
28;2021-04-27;14851;11738;809435;342382;24.5;10.4
28;2021-04-28;15045;10704;824480;353086;25.0;10.7
28;2021-04-29;18437;11756;842917;364842;25.5;11.0
28;2021-04-30;20364;11887;863281;376729;26.1;11.4
28;2021-05-01;12806;2969;876087;379698;26.5;11.5
28;2021-05-02;5983;1837;882070;381535;26.7;11.5
28;2021-05-03;12847;10000;894917;391535;27.1;11.9
28;2021-05-04;13805;13132;908722;404667;27.5;12.2
28;2021-05-05;13936;14463;922658;419130;27.9;12.7
28;2021-05-06;18298;15095;940956;434225;28.5;13.1
28;2021-05-07;17803;17373;958759;451598;29.0;13.7
28;2021-05-08;12611;4693;971370;456291;29.4;13.8
28;2021-05-09;7144;1823;978514;458114;29.6;13.9
28;2021-05-10;14187;14796;992701;472910;30.0;14.3
28;2021-05-11;18076;15329;1010777;488239;30.6;14.8
28;2021-05-12;18713;13950;1029490;502189;31.2;15.2
28;2021-05-13;19619;3711;1049109;505900;31.8;15.3
28;2021-05-14;26277;12497;1075386;518397;32.6;15.7
28;2021-05-15;26866;7059;1102252;525456;33.4;15.9
28;2021-05-16;14101;1566;1116353;527022;33.8;16.0
28;2021-05-17;16143;9416;1132496;536438;34.3;16.2
28;2021-05-18;20997;8755;1153493;545193;34.9;16.5
28;2021-05-19;20846;8467;1174339;553660;35.5;16.8
28;2021-05-20;23074;9637;1197413;563297;36.2;17.1
28;2021-05-21;21353;12066;1218766;575363;36.9;17.4
28;2021-05-22;17533;5968;1236299;581331;37.4;17.6
28;2021-05-23;9106;925;1245405;582256;37.7;17.6
28;2021-05-24;13391;3163;1258796;585419;38.1;17.7
28;2021-05-25;19110;11579;1277906;596998;38.7;18.1
28;2021-05-26;19226;10001;1297132;606999;39.3;18.4
28;2021-05-27;21688;12361;1318820;619360;39.9;18.7
28;2021-05-28;21564;16500;1340384;635860;40.6;19.2
28;2021-05-29;17542;10158;1357926;646018;41.1;19.6
28;2021-05-30;6266;1265;1364192;647283;41.3;19.6
28;2021-05-31;19810;11925;1384002;659208;41.9;20.0
28;2021-06-01;23680;13831;1407682;673039;42.6;20.4
28;2021-06-02;20777;12312;1428459;685351;43.2;20.7
28;2021-06-03;26442;14644;1454901;699995;44.0;21.2
28;2021-06-04;24537;18904;1479438;718899;44.8;21.8
28;2021-06-05;18345;12075;1497783;730974;45.3;22.1
28;2021-06-06;7654;2403;1505437;733377;45.6;22.2
28;2021-06-07;19209;14153;1524646;747530;46.2;22.6
28;2021-06-08;22869;15561;1547515;763091;46.8;23.1
28;2021-06-09;19452;14645;1566967;777736;47.4;23.5
28;2021-06-10;21138;14758;1588105;792494;48.1;24.0
28;2021-06-11;21002;21120;1609107;813614;48.7;24.6
28;2021-06-12;17907;17119;1627014;830733;49.3;25.1
28;2021-06-13;6337;5880;1633351;836613;49.4;25.3
28;2021-06-14;13855;17708;1647206;854321;49.9;25.9
28;2021-06-15;16185;18695;1663391;873016;50.4;26.4
28;2021-06-16;16655;18548;1680046;891564;50.9;27.0
28;2021-06-17;17189;20479;1697235;912043;51.4;27.6
28;2021-06-18;18453;24388;1715688;936431;51.9;28.3
28;2021-06-19;14780;15763;1730468;952194;52.4;28.8
28;2021-06-20;4981;5115;1735449;957309;52.5;29.0
28;2021-06-21;11291;20705;1746740;978014;52.9;29.6
32;2020-12-27;1;0;1;0;0.0;0.0
32;2020-12-28;26;0;27;0;0.0;0.0
32;2020-12-29;12;0;39;0;0.0;0.0
32;2020-12-30;0;0;39;0;0.0;0.0
32;2020-12-31;0;0;39;0;0.0;0.0
32;2021-01-01;1;0;40;0;0.0;0.0
32;2021-01-02;6;0;46;0;0.0;0.0
32;2021-01-03;4;0;50;0;0.0;0.0
32;2021-01-04;82;0;132;0;0.0;0.0
32;2021-01-05;300;0;432;0;0.0;0.0
32;2021-01-06;787;2;1219;2;0.0;0.0
32;2021-01-07;2431;4;3650;6;0.1;0.0
32;2021-01-08;3165;9;6815;15;0.1;0.0
32;2021-01-09;957;3;7772;18;0.1;0.0
32;2021-01-10;639;0;8411;18;0.1;0.0
32;2021-01-11;3268;6;11679;24;0.2;0.0
32;2021-01-12;5004;6;16683;30;0.3;0.0
32;2021-01-13;4940;11;21623;41;0.4;0.0
32;2021-01-14;5723;44;27346;85;0.5;0.0
32;2021-01-15;5223;24;32569;109;0.5;0.0
32;2021-01-16;1636;11;34205;120;0.6;0.0
32;2021-01-17;860;3;35065;123;0.6;0.0
32;2021-01-18;7232;20;42297;143;0.7;0.0
32;2021-01-19;9898;35;52195;178;0.9;0.0
32;2021-01-20;10346;29;62541;207;1.0;0.0
32;2021-01-21;12701;43;75242;250;1.3;0.0
32;2021-01-22;9875;27;85117;277;1.4;0.0
32;2021-01-23;3409;4;88526;281;1.5;0.0
32;2021-01-24;1119;3;89645;284;1.5;0.0
32;2021-01-25;6865;84;96510;368;1.6;0.0
32;2021-01-26;7447;180;103957;548;1.7;0.0
32;2021-01-27;4828;512;108785;1060;1.8;0.0
32;2021-01-28;8589;1689;117374;2749;2.0;0.0
32;2021-01-29;5379;1860;122753;4609;2.1;0.1
32;2021-01-30;534;413;123287;5022;2.1;0.1
32;2021-01-31;67;74;123354;5096;2.1;0.1
32;2021-02-01;191;1816;123545;6912;2.1;0.1
32;2021-02-02;786;3170;124331;10082;2.1;0.2
32;2021-02-03;4069;3190;128400;13272;2.2;0.2
32;2021-02-04;3682;3620;132082;16892;2.2;0.3
32;2021-02-05;1962;3280;134044;20172;2.2;0.3
32;2021-02-06;516;874;134560;21046;2.3;0.4
32;2021-02-07;539;97;135099;21143;2.3;0.4
32;2021-02-08;1866;3683;136965;24826;2.3;0.4
32;2021-02-09;2550;4368;139515;29194;2.3;0.5
32;2021-02-10;2983;5345;142498;34539;2.4;0.6
32;2021-02-11;4776;6198;147274;40737;2.5;0.7
32;2021-02-12;5088;4665;152362;45402;2.6;0.8
32;2021-02-13;939;1893;153301;47295;2.6;0.8
32;2021-02-14;116;711;153417;48006;2.6;0.8
32;2021-02-15;3613;6927;157030;54933;2.6;0.9
32;2021-02-16;4028;8241;161058;63174;2.7;1.1
32;2021-02-17;4279;8693;165337;71867;2.8;1.2
32;2021-02-18;7024;11436;172361;83303;2.9;1.4
32;2021-02-19;7079;8311;179440;91614;3.0;1.5
32;2021-02-20;2515;3016;181955;94630;3.1;1.6
32;2021-02-21;434;489;182389;95119;3.1;1.6
32;2021-02-22;3259;5331;185648;100450;3.1;1.7
32;2021-02-23;5504;5925;191152;106375;3.2;1.8
32;2021-02-24;7441;6061;198593;112436;3.3;1.9
32;2021-02-25;12826;5022;211419;117458;3.5;2.0
32;2021-02-26;12534;2882;223953;120340;3.8;2.0
32;2021-02-27;6485;314;230438;120654;3.9;2.0
32;2021-02-28;364;134;230802;120788;3.9;2.0
32;2021-03-01;7241;857;238043;121645;4.0;2.0
32;2021-03-02;10959;986;249002;122631;4.2;2.1
32;2021-03-03;11983;1733;260985;124364;4.4;2.1
32;2021-03-04;15095;2442;276080;126806;4.6;2.1
32;2021-03-05;17120;2099;293200;128905;4.9;2.2
32;2021-03-06;28086;1042;321286;129947;5.4;2.2
32;2021-03-07;19862;486;341148;130433;5.7;2.2
32;2021-03-08;8913;2563;350061;132996;5.9;2.2
32;2021-03-09;14281;3311;364342;136307;6.1;2.3
32;2021-03-10;15761;3214;380103;139521;6.4;2.3
32;2021-03-11;20923;4695;401026;144216;6.7;2.4
32;2021-03-12;26045;4226;427071;148442;7.2;2.5
32;2021-03-13;41570;1992;468641;150434;7.9;2.5
32;2021-03-14;20099;577;488740;151011;8.2;2.5
32;2021-03-15;13046;3585;501786;154596;8.4;2.6
32;2021-03-16;9789;3478;511575;158074;8.6;2.7
32;2021-03-17;9712;4127;521287;162201;8.7;2.7
32;2021-03-18;10010;5036;531297;167237;8.9;2.8
32;2021-03-19;17941;3808;549238;171045;9.2;2.9
32;2021-03-20;36476;1960;585714;173005;9.8;2.9
32;2021-03-21;19837;766;605551;173771;10.2;2.9
32;2021-03-22;12143;4277;617694;178048;10.4;3.0
32;2021-03-23;18908;5926;636602;183974;10.7;3.1
32;2021-03-24;17898;6141;654500;190115;11.0;3.2
32;2021-03-25;25263;5697;679763;195812;11.4;3.3
32;2021-03-26;28975;5889;708738;201701;11.9;3.4
32;2021-03-27;36643;2150;745381;203851;12.5;3.4
32;2021-03-28;18637;610;764018;204461;12.8;3.4
32;2021-03-29;14573;7037;778591;211498;13.1;3.5
32;2021-03-30;18854;8647;797445;220145;13.4;3.7
32;2021-03-31;15763;9301;813208;229446;13.6;3.8
32;2021-04-01;18194;11030;831402;240476;13.9;4.0
32;2021-04-02;19945;12545;851347;253021;14.3;4.2
32;2021-04-03;30003;10153;881350;263174;14.8;4.4
32;2021-04-04;11650;4724;893000;267898;15.0;4.5
32;2021-04-05;9587;2324;902587;270222;15.1;4.5
32;2021-04-06;14239;10872;916826;281094;15.4;4.7
32;2021-04-07;18029;12540;934855;293634;15.7;4.9
32;2021-04-08;23476;12936;958331;306570;16.1;5.1
32;2021-04-09;29865;13107;988196;319677;16.6;5.4
32;2021-04-10;26094;18787;1014290;338464;17.0;5.7
32;2021-04-11;9134;12003;1023424;350467;17.2;5.9
32;2021-04-12;15400;9492;1038824;359959;17.4;6.0
32;2021-04-13;21773;11552;1060597;371511;17.8;6.2
32;2021-04-14;22436;11108;1083033;382619;18.2;6.4
32;2021-04-15;25695;11109;1108728;393728;18.6;6.6
32;2021-04-16;25273;12425;1134001;406153;19.0;6.8
32;2021-04-17;17926;22975;1151927;429128;19.3;7.2
32;2021-04-18;6387;14039;1158314;443167;19.4;7.4
32;2021-04-19;11637;9796;1169951;452963;19.6;7.6
32;2021-04-20;16402;12278;1186353;465241;19.9;7.8
32;2021-04-21;15775;12564;1202128;477805;20.2;8.0
32;2021-04-22;19021;14974;1221149;492779;20.5;8.3
32;2021-04-23;19625;15951;1240774;508730;20.8;8.5
32;2021-04-24;15421;21015;1256195;529745;21.1;8.9
32;2021-04-25;6948;12284;1263143;542029;21.2;9.1
32;2021-04-26;13207;10707;1276350;552736;21.4;9.3
32;2021-04-27;18669;14097;1295019;566833;21.7;9.5
32;2021-04-28;20159;16018;1315178;582851;22.1;9.8
32;2021-04-29;22381;19921;1337559;602772;22.4;10.1
32;2021-04-30;24995;21548;1362554;624320;22.9;10.5
32;2021-05-01;23027;13917;1385581;638237;23.2;10.7
32;2021-05-02;20944;10326;1406525;648563;23.6;10.9
32;2021-05-03;21923;11277;1428448;659840;24.0;11.1
32;2021-05-04;23832;16266;1452280;676106;24.4;11.3
32;2021-05-05;23923;17404;1476203;693510;24.8;11.6
32;2021-05-06;25711;19870;1501914;713380;25.2;12.0
32;2021-05-07;30727;21481;1532641;734861;25.7;12.3
32;2021-05-08;34510;9027;1567151;743888;26.3;12.5
32;2021-05-09;26794;6496;1593945;750384;26.7;12.6
32;2021-05-10;24203;16108;1618148;766492;27.1;12.9
32;2021-05-11;31254;19001;1649402;785493;27.7;13.2
32;2021-05-12;37062;18745;1686464;804238;28.3;13.5
32;2021-05-13;40436;7275;1726900;811513;29.0;13.6
32;2021-05-14;41682;14546;1768582;826059;29.7;13.9
32;2021-05-15;59485;12072;1828067;838131;30.7;14.1
32;2021-05-16;47772;4785;1875839;842916;31.5;14.1
32;2021-05-17;31376;10904;1907215;853820;32.0;14.3
32;2021-05-18;36514;12427;1943729;866247;32.6;14.5
32;2021-05-19;38715;11507;1982444;877754;33.2;14.7
32;2021-05-20;39685;14881;2022129;892635;33.9;15.0
32;2021-05-21;42267;16933;2064396;909568;34.6;15.3
32;2021-05-22;57668;13028;2122064;922596;35.6;15.5
32;2021-05-23;38865;4366;2160929;926962;36.2;15.5
32;2021-05-24;28423;3815;2189352;930777;36.7;15.6
32;2021-05-25;31029;14853;2220381;945630;37.2;15.9
32;2021-05-26;33920;16743;2254301;962373;37.8;16.1
32;2021-05-27;34564;20641;2288865;983014;38.4;16.5
32;2021-05-28;34246;25141;2323111;1008155;39.0;16.9
32;2021-05-29;37376;19597;2360487;1027752;39.6;17.2
32;2021-05-30;16087;3510;2376574;1031262;39.9;17.3
32;2021-05-31;27863;16512;2404437;1047774;40.3;17.6
32;2021-06-01;32721;24001;2437158;1071775;40.9;18.0
32;2021-06-02;32166;21658;2469324;1093433;41.4;18.3
32;2021-06-03;34262;25045;2503586;1118478;42.0;18.8
32;2021-06-04;35827;27683;2539413;1146161;42.6;19.2
32;2021-06-05;34313;22752;2573726;1168913;43.2;19.6
32;2021-06-06;16509;5706;2590235;1174619;43.4;19.7
32;2021-06-07;21161;19339;2611396;1193958;43.8;20.0
32;2021-06-08;26636;24392;2638032;1218350;44.2;20.4
32;2021-06-09;23899;24320;2661931;1242670;44.6;20.8
32;2021-06-10;24865;26402;2686796;1269072;45.1;21.3
32;2021-06-11;26305;36030;2713101;1305102;45.5;21.9
32;2021-06-12;25938;31486;2739039;1336588;45.9;22.4
32;2021-06-13;11795;14803;2750834;1351391;46.1;22.7
32;2021-06-14;13188;28024;2764022;1379415;46.4;23.1
32;2021-06-15;19560;34576;2783582;1413991;46.7;23.7
32;2021-06-16;20411;32405;2803993;1446396;47.0;24.3
32;2021-06-17;21348;34909;2825341;1481305;47.4;24.8
32;2021-06-18;21453;42547;2846794;1523852;47.7;25.6
32;2021-06-19;22473;43757;2869267;1567609;48.1;26.3
32;2021-06-20;9192;19074;2878459;1586683;48.3;26.6
32;2021-06-21;11235;34800;2889694;1621483;48.5;27.2
44;2020-12-27;0;0;0;0;0.0;0.0
44;2020-12-28;0;0;0;0;0.0;0.0
44;2020-12-29;0;0;0;0;0.0;0.0
44;2020-12-30;0;0;0;0;0.0;0.0
44;2020-12-31;11;0;11;0;0.0;0.0
44;2021-01-01;1;0;12;0;0.0;0.0
44;2021-01-02;3;0;15;0;0.0;0.0
44;2021-01-03;3;0;18;0;0.0;0.0
44;2021-01-04;243;0;261;0;0.0;0.0
44;2021-01-05;770;0;1031;0;0.0;0.0
44;2021-01-06;1243;2;2274;2;0.0;0.0
44;2021-01-07;2425;4;4699;6;0.1;0.0
44;2021-01-08;3130;8;7829;14;0.1;0.0
44;2021-01-09;942;2;8771;16;0.2;0.0
44;2021-01-10;238;0;9009;16;0.2;0.0
44;2021-01-11;2982;7;11991;23;0.2;0.0
44;2021-01-12;5279;7;17270;30;0.3;0.0
44;2021-01-13;7662;18;24932;48;0.5;0.0
44;2021-01-14;9548;82;34480;130;0.6;0.0
44;2021-01-15;6696;28;41176;158;0.7;0.0
44;2021-01-16;1917;10;43093;168;0.8;0.0
44;2021-01-17;902;1;43995;169;0.8;0.0
44;2021-01-18;8711;25;52706;194;1.0;0.0
44;2021-01-19;10655;17;63361;211;1.1;0.0
44;2021-01-20;11025;42;74386;253;1.3;0.0
44;2021-01-21;11723;27;86109;280;1.6;0.0
44;2021-01-22;9631;30;95740;310;1.7;0.0
44;2021-01-23;3286;20;99026;330;1.8;0.0
44;2021-01-24;1567;5;100593;335;1.8;0.0
44;2021-01-25;6627;303;107220;638;1.9;0.0
44;2021-01-26;5643;435;112863;1073;2.0;0.0
44;2021-01-27;7374;600;120237;1673;2.2;0.0
44;2021-01-28;8795;1250;129032;2923;2.3;0.1
44;2021-01-29;6756;1801;135788;4724;2.5;0.1
44;2021-01-30;2548;496;138336;5220;2.5;0.1
44;2021-01-31;1252;55;139588;5275;2.5;0.1
44;2021-02-01;6381;2382;145969;7657;2.6;0.1
44;2021-02-02;6214;3812;152183;11469;2.8;0.2
44;2021-02-03;5596;4553;157779;16022;2.9;0.3
44;2021-02-04;6441;6970;164220;22992;3.0;0.4
44;2021-02-05;6389;5237;170609;28229;3.1;0.5
44;2021-02-06;1972;1207;172581;29436;3.1;0.5
44;2021-02-07;406;594;172987;30030;3.1;0.5
44;2021-02-08;3822;4470;176809;34500;3.2;0.6
44;2021-02-09;5718;5843;182527;40343;3.3;0.7
44;2021-02-10;6250;6044;188777;46387;3.4;0.8
44;2021-02-11;7060;6570;195837;52957;3.6;1.0
44;2021-02-12;7279;5555;203116;58512;3.7;1.1
44;2021-02-13;2544;1258;205660;59770;3.7;1.1
44;2021-02-14;1612;826;207272;60596;3.8;1.1
44;2021-02-15;3995;7212;211267;67808;3.8;1.2
44;2021-02-16;4563;7982;215830;75790;3.9;1.4
44;2021-02-17;4705;8549;220535;84339;4.0;1.5
44;2021-02-18;6029;9281;226564;93620;4.1;1.7
44;2021-02-19;5541;7505;232105;101125;4.2;1.8
44;2021-02-20;2337;2843;234442;103968;4.3;1.9
44;2021-02-21;541;1401;234983;105369;4.3;1.9
44;2021-02-22;4486;7031;239469;112400;4.3;2.0
44;2021-02-23;6025;7264;245494;119664;4.5;2.2
44;2021-02-24;6601;5944;252095;125608;4.6;2.3
44;2021-02-25;10518;7569;262613;133177;4.8;2.4
44;2021-02-26;12368;6355;274981;139532;5.0;2.5
44;2021-02-27;7886;2161;282867;141693;5.1;2.6
44;2021-02-28;2116;519;284983;142212;5.2;2.6
44;2021-03-01;6078;4673;291061;146885;5.3;2.7
44;2021-03-02;9388;5661;300449;152546;5.5;2.8
44;2021-03-03;11268;5585;311717;158131;5.7;2.9
44;2021-03-04;13258;5782;324975;163913;5.9;3.0
44;2021-03-05;17871;5679;342846;169592;6.2;3.1
44;2021-03-06;21334;2156;364180;171748;6.6;3.1
44;2021-03-07;12198;738;376378;172486;6.8;3.1
44;2021-03-08;9400;4258;385778;176744;7.0;3.2
44;2021-03-09;15184;4953;400962;181697;7.3;3.3
44;2021-03-10;16598;5174;417560;186871;7.6;3.4
44;2021-03-11;20343;5650;437903;192521;7.9;3.5
44;2021-03-12;26783;5505;464686;198026;8.4;3.6
44;2021-03-13;24202;2394;488888;200420;8.9;3.6
44;2021-03-14;6765;874;495653;201294;9.0;3.7
44;2021-03-15;12954;3464;508607;204758;9.2;3.7
44;2021-03-16;12831;3973;521438;208731;9.5;3.8
44;2021-03-17;14188;3630;535626;212361;9.7;3.9
44;2021-03-18;15401;3758;551027;216119;10.0;3.9
44;2021-03-19;21404;3886;572431;220005;10.4;4.0
44;2021-03-20;15555;1942;587986;221947;10.7;4.0
44;2021-03-21;4617;285;592603;222232;10.8;4.0
44;2021-03-22;12519;3906;605122;226138;11.0;4.1
44;2021-03-23;19432;5067;624554;231205;11.3;4.2
44;2021-03-24;22042;5179;646596;236384;11.7;4.3
44;2021-03-25;28179;5758;674775;242142;12.2;4.4
44;2021-03-26;30330;5471;705105;247613;12.8;4.5
44;2021-03-27;16211;4680;721316;252293;13.1;4.6
44;2021-03-28;4076;1972;725392;254265;13.2;4.6
44;2021-03-29;14303;6110;739695;260375;13.4;4.7
44;2021-03-30;21384;7812;761079;268187;13.8;4.9
44;2021-03-31;20091;7993;781170;276180;14.2;5.0
44;2021-04-01;23526;9316;804696;285496;14.6;5.2
44;2021-04-02;16220;6882;820916;292378;14.9;5.3
44;2021-04-03;10184;5760;831100;298138;15.1;5.4
44;2021-04-04;3131;1650;834231;299788;15.1;5.4
44;2021-04-05;4423;1411;838654;301199;15.2;5.5
44;2021-04-06;13405;10543;852059;311742;15.5;5.7
44;2021-04-07;17640;12097;869699;323839;15.8;5.9
44;2021-04-08;25990;12381;895689;336220;16.3;6.1
44;2021-04-09;32189;12721;927878;348941;16.8;6.3
44;2021-04-10;18230;10043;946108;358984;17.2;6.5
44;2021-04-11;3028;5966;949136;364950;17.2;6.6
44;2021-04-12;16948;11232;966084;376182;17.5;6.8
44;2021-04-13;21959;13755;988043;389937;17.9;7.1
44;2021-04-14;23075;14039;1011118;403976;18.3;7.3
44;2021-04-15;26235;15345;1037353;419321;18.8;7.6
44;2021-04-16;28064;15182;1065417;434503;19.3;7.9
44;2021-04-17;19797;9018;1085214;443521;19.7;8.0
44;2021-04-18;5047;4629;1090261;448150;19.8;8.1
44;2021-04-19;16921;11735;1107182;459885;20.1;8.3
44;2021-04-20;19083;14281;1126265;474166;20.4;8.6
44;2021-04-21;21110;14932;1147375;489098;20.8;8.9
44;2021-04-22;23678;15856;1171053;504954;21.2;9.2
44;2021-04-23;27772;16530;1198825;521484;21.8;9.5
44;2021-04-24;16960;9144;1215785;530628;22.1;9.6
44;2021-04-25;4818;3559;1220603;534187;22.1;9.7
44;2021-04-26;16691;12002;1237294;546189;22.4;9.9
44;2021-04-27;21142;14605;1258436;560794;22.8;10.2
44;2021-04-28;23760;14776;1282196;575570;23.3;10.4
44;2021-04-29;28117;16911;1310313;592481;23.8;10.7
44;2021-04-30;33093;15978;1343406;608459;24.4;11.0
44;2021-05-01;14843;7004;1358249;615463;24.6;11.2
44;2021-05-02;7895;3986;1366144;619449;24.8;11.2
44;2021-05-03;23991;12346;1390135;631795;25.2;11.5
44;2021-05-04;26941;17237;1417076;649032;25.7;11.8
44;2021-05-05;30787;19116;1447863;668148;26.3;12.1
44;2021-05-06;37961;21040;1485824;689188;27.0;12.5
44;2021-05-07;36093;24759;1521917;713947;27.6;13.0
44;2021-05-08;19523;6673;1541440;720620;28.0;13.1
44;2021-05-09;11293;2896;1552733;723516;28.2;13.1
44;2021-05-10;24436;20723;1577169;744239;28.6;13.5
44;2021-05-11;34348;22846;1611517;767085;29.2;13.9
44;2021-05-12;36915;23915;1648432;791000;29.9;14.4
44;2021-05-13;27793;6336;1676225;797336;30.4;14.5
44;2021-05-14;43991;18766;1720216;816102;31.2;14.8
44;2021-05-15;33901;14021;1754117;830123;31.8;15.1
44;2021-05-16;15532;3481;1769649;833604;32.1;15.1
44;2021-05-17;27064;14461;1796713;848065;32.6;15.4
44;2021-05-18;34990;15210;1831703;863275;33.2;15.7
44;2021-05-19;36763;16282;1868466;879557;33.9;16.0
44;2021-05-20;40726;16372;1909192;895929;34.6;16.3
44;2021-05-21;42701;20830;1951893;916759;35.4;16.6
44;2021-05-22;27631;11521;1979524;928280;35.9;16.8
44;2021-05-23;8648;1708;1988172;929988;36.1;16.9
44;2021-05-24;17868;4634;2006040;934622;36.4;17.0
44;2021-05-25;30133;17553;2036173;952175;36.9;17.3
44;2021-05-26;32271;19447;2068444;971622;37.5;17.6
44;2021-05-27;34480;20776;2102924;992398;38.2;18.0
44;2021-05-28;37426;27756;2140350;1020154;38.8;18.5
44;2021-05-29;26734;20094;2167084;1040248;39.3;18.9
44;2021-05-30;6116;4205;2173200;1044453;39.4;18.9
44;2021-05-31;26951;19652;2200151;1064105;39.9;19.3
44;2021-06-01;31437;22850;2231588;1086955;40.5;19.7
44;2021-06-02;33464;22859;2265052;1109814;41.1;20.1
44;2021-06-03;34495;25222;2299547;1135036;41.7;20.6
44;2021-06-04;39880;32128;2339427;1167164;42.4;21.2
44;2021-06-05;23018;20069;2362445;1187233;42.9;21.5
44;2021-06-06;8297;4449;2370742;1191682;43.0;21.6
44;2021-06-07;28052;22025;2398794;1213707;43.5;22.0
44;2021-06-08;33473;26687;2432267;1240394;44.1;22.5
44;2021-06-09;34896;24777;2467163;1265171;44.8;23.0
44;2021-06-10;34423;25533;2501586;1290704;45.4;23.4
44;2021-06-11;32237;35317;2533823;1326021;46.0;24.1
44;2021-06-12;25591;23405;2559414;1349426;46.4;24.5
44;2021-06-13;6761;6052;2566175;1355478;46.6;24.6
44;2021-06-14;17443;29525;2583618;1385003;46.9;25.1
44;2021-06-15;23387;34891;2607005;1419894;47.3;25.8
44;2021-06-16;24128;36526;2631133;1456420;47.7;26.4
44;2021-06-17;23503;39130;2654636;1495550;48.2;27.1
44;2021-06-18;26133;42853;2680769;1538403;48.6;27.9
44;2021-06-19;20845;28144;2701614;1566547;49.0;28.4
44;2021-06-20;3655;6636;2705269;1573183;49.1;28.5
44;2021-06-21;14625;33964;2719894;1607147;49.3;29.2
52;2020-12-27;0;0;0;0;0.0;0.0
52;2020-12-28;1;0;1;0;0.0;0.0
52;2020-12-29;0;0;1;0;0.0;0.0
52;2020-12-30;0;0;1;0;0.0;0.0
52;2020-12-31;0;0;1;0;0.0;0.0
52;2021-01-01;5;0;6;0;0.0;0.0
52;2021-01-02;1;0;7;0;0.0;0.0
52;2021-01-03;1;0;8;0;0.0;0.0
52;2021-01-04;34;0;42;0;0.0;0.0
52;2021-01-05;168;0;210;0;0.0;0.0
52;2021-01-06;384;1;594;1;0.0;0.0
52;2021-01-07;963;0;1557;1;0.0;0.0
52;2021-01-08;1664;2;3221;3;0.1;0.0
52;2021-01-09;1049;2;4270;5;0.1;0.0
52;2021-01-10;643;1;4913;6;0.1;0.0
52;2021-01-11;2197;0;7110;6;0.2;0.0
52;2021-01-12;3168;4;10278;10;0.3;0.0
52;2021-01-13;2983;4;13261;14;0.3;0.0
52;2021-01-14;3303;24;16564;38;0.4;0.0
52;2021-01-15;3015;9;19579;47;0.5;0.0
52;2021-01-16;894;7;20473;54;0.5;0.0
52;2021-01-17;499;3;20972;57;0.6;0.0
52;2021-01-18;3200;6;24172;63;0.6;0.0
52;2021-01-19;6553;8;30725;71;0.8;0.0
52;2021-01-20;8329;11;39054;82;1.0;0.0
52;2021-01-21;12166;11;51220;93;1.3;0.0
52;2021-01-22;7273;28;58493;121;1.5;0.0
52;2021-01-23;1677;5;60170;126;1.6;0.0
52;2021-01-24;174;0;60344;126;1.6;0.0
52;2021-01-25;3006;11;63350;137;1.7;0.0
52;2021-01-26;6737;154;70087;291;1.8;0.0
52;2021-01-27;7284;150;77371;441;2.0;0.0
52;2021-01-28;9728;467;87099;908;2.3;0.0
52;2021-01-29;5957;910;93056;1818;2.4;0.0
52;2021-01-30;1258;271;94314;2089;2.5;0.1
52;2021-01-31;79;314;94393;2403;2.5;0.1
52;2021-02-01;2521;1191;96914;3594;2.5;0.1
52;2021-02-02;2970;1859;99884;5453;2.6;0.1
52;2021-02-03;2685;2161;102569;7614;2.7;0.2
52;2021-02-04;2962;2115;105531;9729;2.8;0.3
52;2021-02-05;2965;2206;108496;11935;2.9;0.3
52;2021-02-06;1075;662;109571;12597;2.9;0.3
52;2021-02-07;151;297;109722;12894;2.9;0.3
52;2021-02-08;1929;2117;111651;15011;2.9;0.4
52;2021-02-09;3174;3719;114825;18730;3.0;0.5
52;2021-02-10;3319;4762;118144;23492;3.1;0.6
52;2021-02-11;6099;9300;124243;32792;3.3;0.9
52;2021-02-12;4704;5147;128947;37939;3.4;1.0
52;2021-02-13;1150;1242;130097;39181;3.4;1.0
52;2021-02-14;22;541;130119;39722;3.4;1.0
52;2021-02-15;2030;3533;132149;43255;3.5;1.1
52;2021-02-16;4111;6757;136260;50012;3.6;1.3
52;2021-02-17;3874;6950;140134;56962;3.7;1.5
52;2021-02-18;6138;9295;146272;66257;3.8;1.7
52;2021-02-19;5329;5830;151601;72087;4.0;1.9
52;2021-02-20;1028;1476;152629;73563;4.0;1.9
52;2021-02-21;6;274;152635;73837;4.0;1.9
52;2021-02-22;2644;3493;155279;77330;4.1;2.0
52;2021-02-23;3424;3700;158703;81030;4.2;2.1
52;2021-02-24;3298;3039;162001;84069;4.3;2.2
52;2021-02-25;6344;3215;168345;87284;4.4;2.3
52;2021-02-26;6211;2924;174556;90208;4.6;2.4
52;2021-02-27;2215;1047;176771;91255;4.6;2.4
52;2021-02-28;76;88;176847;91343;4.7;2.4
52;2021-03-01;3112;2332;179959;93675;4.7;2.5
52;2021-03-02;4723;3435;184682;97110;4.9;2.6
52;2021-03-03;5277;3412;189959;100522;5.0;2.6
52;2021-03-04;7787;4777;197746;105299;5.2;2.8
52;2021-03-05;9005;3930;206751;109229;5.4;2.9
52;2021-03-06;5635;1154;212386;110383;5.6;2.9
52;2021-03-07;2661;132;215047;110515;5.7;2.9
52;2021-03-08;5840;2423;220887;112938;5.8;3.0
52;2021-03-09;9545;3329;230432;116267;6.1;3.1
52;2021-03-10;9387;3396;239819;119663;6.3;3.1
52;2021-03-11;13572;5046;253391;124709;6.7;3.3
52;2021-03-12;15328;3750;268719;128459;7.1;3.4
52;2021-03-13;8283;758;277002;129217;7.3;3.4
52;2021-03-14;624;72;277626;129289;7.3;3.4
52;2021-03-15;8834;1915;286460;131204;7.5;3.5
52;2021-03-16;7573;2617;294033;133821;7.7;3.5
52;2021-03-17;6457;2383;300490;136204;7.9;3.6
52;2021-03-18;8298;2515;308788;138719;8.1;3.6
52;2021-03-19;11886;2130;320674;140849;8.4;3.7
52;2021-03-20;7084;762;327758;141611;8.6;3.7
52;2021-03-21;1688;47;329446;141658;8.7;3.7
52;2021-03-22;9012;2008;338458;143666;8.9;3.8
52;2021-03-23;13179;2592;351637;146258;9.2;3.8
52;2021-03-24;13256;2036;364893;148294;9.6;3.9
52;2021-03-25;18190;2800;383083;151094;10.1;4.0
52;2021-03-26;18923;2369;402006;153463;10.6;4.0
52;2021-03-27;7546;651;409552;154114;10.8;4.1
52;2021-03-28;2193;67;411745;154181;10.8;4.1
52;2021-03-29;10959;2721;422704;156902;11.1;4.1
52;2021-03-30;15652;3600;438356;160502;11.5;4.2
52;2021-03-31;13677;3261;452033;163763;11.9;4.3
52;2021-04-01;18853;3682;470886;167445;12.4;4.4
52;2021-04-02;17073;3503;487959;170948;12.8;4.5
52;2021-04-03;5513;1192;493472;172140;13.0;4.5
52;2021-04-04;1324;50;494796;172190;13.0;4.5
52;2021-04-05;1780;536;496576;172726;13.1;4.5
52;2021-04-06;11777;5248;508353;177974;13.4;4.7
52;2021-04-07;15183;5688;523536;183662;13.8;4.8
52;2021-04-08;21200;6382;544736;190044;14.3;5.0
52;2021-04-09;26604;5288;571340;195332;15.0;5.1
52;2021-04-10;10111;2360;581451;197692;15.3;5.2
52;2021-04-11;2567;434;584018;198126;15.4;5.2
52;2021-04-12;16326;6577;600344;204703;15.8;5.4
52;2021-04-13;20719;8162;621063;212865;16.3;5.6
52;2021-04-14;17635;6916;638698;219781;16.8;5.8
52;2021-04-15;21139;8026;659837;227807;17.4;6.0
52;2021-04-16;22580;7460;682417;235267;17.9;6.2
52;2021-04-17;9966;3029;692383;238296;18.2;6.3
52;2021-04-18;3036;1303;695419;239599;18.3;6.3
52;2021-04-19;14169;7812;709588;247411;18.7;6.5
52;2021-04-20;18255;9387;727843;256798;19.1;6.8
52;2021-04-21;15968;9154;743811;265952;19.6;7.0
52;2021-04-22;19402;10156;763213;276108;20.1;7.3
52;2021-04-23;20504;9963;783717;286071;20.6;7.5
52;2021-04-24;10010;4974;793727;291045;20.9;7.7
52;2021-04-25;3978;1945;797705;292990;21.0;7.7
52;2021-04-26;16818;9901;814523;302891;21.4;8.0
52;2021-04-27;21056;12550;835579;315441;22.0;8.3
52;2021-04-28;22752;10654;858331;326095;22.6;8.6
52;2021-04-29;25002;12666;883333;338761;23.2;8.9
52;2021-04-30;25633;12476;908966;351237;23.9;9.2
52;2021-05-01;8615;2475;917581;353712;24.1;9.3
52;2021-05-02;4298;1270;921879;354982;24.2;9.3
52;2021-05-03;19060;10620;940939;365602;24.7;9.6
52;2021-05-04;20064;14377;961003;379979;25.3;10.0
52;2021-05-05;20851;12756;981854;392735;25.8;10.3
52;2021-05-06;22463;13829;1004317;406564;26.4;10.7
52;2021-05-07;20683;18013;1025000;424577;27.0;11.2
52;2021-05-08;11220;2078;1036220;426655;27.3;11.2
52;2021-05-09;5395;2226;1041615;428881;27.4;11.3
52;2021-05-10;20756;17280;1062371;446161;27.9;11.7
52;2021-05-11;24831;19535;1087202;465696;28.6;12.2
52;2021-05-12;24685;17082;1111887;482778;29.2;12.7
52;2021-05-13;18557;2704;1130444;485482;29.7;12.8
52;2021-05-14;22665;12382;1153109;497864;30.3;13.1
52;2021-05-15;15615;5179;1168724;503043;30.7;13.2
52;2021-05-16;10272;1144;1178996;504187;31.0;13.3
52;2021-05-17;21085;14646;1200081;518833;31.6;13.6
52;2021-05-18;24670;14969;1224751;533802;32.2;14.0
52;2021-05-19;26692;11411;1251443;545213;32.9;14.3
52;2021-05-20;29255;11991;1280698;557204;33.7;14.7
52;2021-05-21;27311;13825;1308009;571029;34.4;15.0
52;2021-05-22;15405;4699;1323414;575728;34.8;15.1
52;2021-05-23;4470;1140;1327884;576868;34.9;15.2
52;2021-05-24;15986;2747;1343870;579615;35.3;15.2
52;2021-05-25;24412;14521;1368282;594136;36.0;15.6
52;2021-05-26;25128;12651;1393410;606787;36.7;16.0
52;2021-05-27;29052;14803;1422462;621590;37.4;16.3
52;2021-05-28;27892;17849;1450354;639439;38.1;16.8
52;2021-05-29;18309;7767;1468663;647206;38.6;17.0
52;2021-05-30;4229;1717;1472892;648923;38.7;17.1
52;2021-05-31;24394;15853;1497286;664776;39.4;17.5
52;2021-06-01;28799;17795;1526085;682571;40.1;18.0
52;2021-06-02;27402;15204;1553487;697775;40.9;18.4
52;2021-06-03;31699;16267;1585186;714042;41.7;18.8
52;2021-06-04;29200;20719;1614386;734761;42.5;19.3
52;2021-06-05;14530;11795;1628916;746556;42.8;19.6
52;2021-06-06;4773;3530;1633689;750086;43.0;19.7
52;2021-06-07;21693;20865;1655382;770951;43.5;20.3
52;2021-06-08;26875;22087;1682257;793038;44.2;20.9
52;2021-06-09;25312;18575;1707569;811613;44.9;21.3
52;2021-06-10;28698;17572;1736267;829185;45.7;21.8
52;2021-06-11;26948;24295;1763215;853480;46.4;22.4
52;2021-06-12;14588;11838;1777803;865318;46.8;22.8
52;2021-06-13;4379;4515;1782182;869833;46.9;22.9
52;2021-06-14;17586;25381;1799768;895214;47.3;23.5
52;2021-06-15;23683;25317;1823451;920531;48.0;24.2
52;2021-06-16;23254;22451;1846705;942982;48.6;24.8
52;2021-06-17;25878;23059;1872583;966041;49.3;25.4
52;2021-06-18;23212;28691;1895795;994732;49.9;26.2
52;2021-06-19;12417;14231;1908212;1008963;50.2;26.5
52;2021-06-20;3010;4417;1911222;1013380;50.3;26.7
52;2021-06-21;14751;28841;1925973;1042221;50.7;27.4
53;2020-12-27;0;0;0;0;0.0;0.0
53;2020-12-28;0;0;0;0;0.0;0.0
53;2020-12-29;0;0;0;0;0.0;0.0
53;2020-12-30;0;0;0;0;0.0;0.0
53;2020-12-31;0;0;0;0;0.0;0.0
53;2021-01-01;3;0;3;0;0.0;0.0
53;2021-01-02;4;0;7;0;0.0;0.0
53;2021-01-03;0;0;7;0;0.0;0.0
53;2021-01-04;43;0;50;0;0.0;0.0
53;2021-01-05;200;0;250;0;0.0;0.0
53;2021-01-06;331;1;581;1;0.0;0.0
53;2021-01-07;834;1;1415;2;0.0;0.0
53;2021-01-08;1213;0;2628;2;0.1;0.0
53;2021-01-09;34;0;2662;2;0.1;0.0
53;2021-01-10;4;0;2666;2;0.1;0.0
53;2021-01-11;1661;3;4327;5;0.1;0.0
53;2021-01-12;3379;1;7706;6;0.2;0.0
53;2021-01-13;3355;4;11061;10;0.3;0.0
53;2021-01-14;3813;30;14874;40;0.4;0.0
53;2021-01-15;3297;17;18171;57;0.5;0.0
53;2021-01-16;683;4;18854;61;0.6;0.0
53;2021-01-17;180;1;19034;62;0.6;0.0
53;2021-01-18;3361;7;22395;69;0.7;0.0
53;2021-01-19;8175;4;30570;73;0.9;0.0
53;2021-01-20;7058;4;37628;77;1.1;0.0
53;2021-01-21;11477;6;49105;83;1.5;0.0
53;2021-01-22;7811;13;56916;96;1.7;0.0
53;2021-01-23;1492;2;58408;98;1.7;0.0
53;2021-01-24;255;1;58663;99;1.8;0.0
53;2021-01-25;3056;35;61719;134;1.8;0.0
53;2021-01-26;4111;232;65830;366;2.0;0.0
53;2021-01-27;7238;326;73068;692;2.2;0.0
53;2021-01-28;7132;639;80200;1331;2.4;0.0
53;2021-01-29;4230;730;84430;2061;2.5;0.1
53;2021-01-30;844;43;85274;2104;2.6;0.1
53;2021-01-31;79;3;85353;2107;2.6;0.1
53;2021-02-01;2210;1027;87563;3134;2.6;0.1
53;2021-02-02;3438;2014;91001;5148;2.7;0.2
53;2021-02-03;3174;2184;94175;7332;2.8;0.2
53;2021-02-04;7095;2270;101270;9602;3.0;0.3
53;2021-02-05;5584;2136;106854;11738;3.2;0.4
53;2021-02-06;1201;277;108055;12015;3.2;0.4
53;2021-02-07;214;132;108269;12147;3.2;0.4
53;2021-02-08;1651;1532;109920;13679;3.3;0.4
53;2021-02-09;3973;5258;113893;18937;3.4;0.6
53;2021-02-10;3791;4650;117684;23587;3.5;0.7
53;2021-02-11;5733;8794;123417;32381;3.7;1.0
53;2021-02-12;5661;5250;129078;37631;3.9;1.1
53;2021-02-13;1232;851;130310;38482;3.9;1.2
53;2021-02-14;25;348;130335;38830;3.9;1.2
53;2021-02-15;2325;3584;132660;42414;4.0;1.3
53;2021-02-16;4051;3543;136711;45957;4.1;1.4
53;2021-02-17;4073;5375;140784;51332;4.2;1.5
53;2021-02-18;5948;5742;146732;57074;4.4;1.7
53;2021-02-19;5355;4853;152087;61927;4.6;1.9
53;2021-02-20;1189;891;153276;62818;4.6;1.9
53;2021-02-21;165;218;153441;63036;4.6;1.9
53;2021-02-22;2318;2832;155759;65868;4.7;2.0
53;2021-02-23;3947;3674;159706;69542;4.8;2.1
53;2021-02-24;4467;3782;164173;73324;4.9;2.2
53;2021-02-25;7946;7144;172119;80468;5.2;2.4
53;2021-02-26;8676;4406;180795;84874;5.4;2.5
53;2021-02-27;3448;1106;184243;85980;5.5;2.6
53;2021-02-28;228;194;184471;86174;5.5;2.6
53;2021-03-01;3478;2264;187949;88438;5.6;2.6
53;2021-03-02;5617;4460;193566;92898;5.8;2.8
53;2021-03-03;6437;3790;200003;96688;6.0;2.9
53;2021-03-04;9280;4925;209283;101613;6.3;3.0
53;2021-03-05;11909;5215;221192;106828;6.6;3.2
53;2021-03-06;5630;1020;226822;107848;6.8;3.2
53;2021-03-07;913;145;227735;107993;6.8;3.2
53;2021-03-08;5163;2212;232898;110205;7.0;3.3
53;2021-03-09;9662;2935;242560;113140;7.3;3.4
53;2021-03-10;9275;3371;251835;116511;7.5;3.5
53;2021-03-11;14298;4047;266133;120558;8.0;3.6
53;2021-03-12;18599;3248;284732;123806;8.5;3.7
53;2021-03-13;8802;947;293534;124753;8.8;3.7
53;2021-03-14;812;50;294346;124803;8.8;3.7
53;2021-03-15;6888;2029;301234;126832;9.0;3.8
53;2021-03-16;6982;3407;308216;130239;9.2;3.9
53;2021-03-17;8226;2825;316442;133064;9.5;4.0
53;2021-03-18;8714;4657;325156;137721;9.7;4.1
53;2021-03-19;12990;3649;338146;141370;10.1;4.2
53;2021-03-20;7124;817;345270;142187;10.3;4.3
53;2021-03-21;382;32;345652;142219;10.3;4.3
53;2021-03-22;7342;2164;352994;144383;10.6;4.3
53;2021-03-23;12984;3664;365978;148047;11.0;4.4
53;2021-03-24;14383;3236;380361;151283;11.4;4.5
53;2021-03-25;18271;3363;398632;154646;11.9;4.6
53;2021-03-26;20303;3197;418935;157843;12.5;4.7
53;2021-03-27;7402;1014;426337;158857;12.8;4.8
53;2021-03-28;527;86;426864;158943;12.8;4.8
53;2021-03-29;9794;3165;436658;162108;13.1;4.9
53;2021-03-30;15295;4594;451953;166702;13.5;5.0
53;2021-03-31;14124;4262;466077;170964;14.0;5.1
53;2021-04-01;18174;4268;484251;175232;14.5;5.2
53;2021-04-02;17862;4352;502113;179584;15.0;5.4
53;2021-04-03;6424;1424;508537;181008;15.2;5.4
53;2021-04-04;413;32;508950;181040;15.2;5.4
53;2021-04-05;1227;334;510177;181374;15.3;5.4
53;2021-04-06;12516;5673;522693;187047;15.6;5.6
53;2021-04-07;15012;5332;537705;192379;16.1;5.8
53;2021-04-08;20616;6091;558321;198470;16.7;5.9
53;2021-04-09;26620;5567;584941;204037;17.5;6.1
53;2021-04-10;10327;1723;595268;205760;17.8;6.2
53;2021-04-11;814;213;596082;205973;17.8;6.2
53;2021-04-12;15818;4910;611900;210883;18.3;6.3
53;2021-04-13;22685;7234;634585;218117;19.0;6.5
53;2021-04-14;19332;7919;653917;226036;19.6;6.8
53;2021-04-15;25335;8053;679252;234089;20.3;7.0
53;2021-04-16;26166;7535;705418;241624;21.1;7.2
53;2021-04-17;10383;3575;715801;245199;21.4;7.3
53;2021-04-18;1033;148;716834;245347;21.5;7.3
53;2021-04-19;15397;6529;732231;251876;21.9;7.5
53;2021-04-20;16916;9513;749147;261389;22.4;7.8
53;2021-04-21;16739;9437;765886;270826;22.9;8.1
53;2021-04-22;21728;10172;787614;280998;23.6;8.4
53;2021-04-23;21630;10076;809244;291074;24.2;8.7
53;2021-04-24;9984;4165;819228;295239;24.5;8.8
53;2021-04-25;905;332;820133;295571;24.6;8.8
53;2021-04-26;18214;8474;838347;304045;25.1;9.1
53;2021-04-27;19852;12061;858199;316106;25.7;9.5
53;2021-04-28;19941;10806;878140;326912;26.3;9.8
53;2021-04-29;23536;12275;901676;339187;27.0;10.2
53;2021-04-30;23891;12435;925567;351622;27.7;10.5
53;2021-05-01;5118;1631;930685;353253;27.9;10.6
53;2021-05-02;2793;520;933478;353773;27.9;10.6
53;2021-05-03;15710;9378;949188;363151;28.4;10.9
53;2021-05-04;15686;15786;964874;378937;28.9;11.3
53;2021-05-05;14933;14686;979807;393623;29.3;11.8
53;2021-05-06;19254;17840;999061;411463;29.9;12.3
53;2021-05-07;18631;18218;1017692;429681;30.5;12.9
53;2021-05-08;5485;1120;1023177;430801;30.6;12.9
53;2021-05-09;3511;860;1026688;431661;30.7;12.9
53;2021-05-10;16667;15220;1043355;446881;31.2;13.4
53;2021-05-11;18534;18734;1061889;465615;31.8;13.9
53;2021-05-12;21043;15632;1082932;481247;32.4;14.4
53;2021-05-13;9009;3945;1091941;485192;32.7;14.5
53;2021-05-14;21646;13732;1113587;498924;33.3;14.9
53;2021-05-15;13378;5325;1126965;504249;33.7;15.1
53;2021-05-16;3215;875;1130180;505124;33.8;15.1
53;2021-05-17;18103;11167;1148283;516291;34.4;15.5
53;2021-05-18;20874;12388;1169157;528679;35.0;15.8
53;2021-05-19;21545;10625;1190702;539304;35.6;16.1
53;2021-05-20;23810;14713;1214512;554017;36.4;16.6
53;2021-05-21;22818;15230;1237330;569247;37.0;17.0
53;2021-05-22;13134;5835;1250464;575082;37.4;17.2
53;2021-05-23;2970;310;1253434;575392;37.5;17.2
53;2021-05-24;13930;2496;1267364;577888;37.9;17.3
53;2021-05-25;19907;12812;1287271;590700;38.5;17.7
53;2021-05-26;19242;13789;1306513;604489;39.1;18.1
53;2021-05-27;22028;17409;1328541;621898;39.8;18.6
53;2021-05-28;21745;20403;1350286;642301;40.4;19.2
53;2021-05-29;12132;7329;1362418;649630;40.8;19.4
53;2021-05-30;2305;472;1364723;650102;40.9;19.5
53;2021-05-31;20670;14088;1385393;664190;41.5;19.9
53;2021-06-01;22904;16473;1408297;680663;42.2;20.4
53;2021-06-02;21674;14222;1429971;694885;42.8;20.8
53;2021-06-03;25018;16850;1454989;711735;43.6;21.3
53;2021-06-04;23057;22559;1478046;734294;44.2;22.0
53;2021-06-05;17294;8991;1495340;743285;44.8;22.3
53;2021-06-06;4997;1324;1500337;744609;44.9;22.3
53;2021-06-07;18370;17786;1518707;762395;45.5;22.8
53;2021-06-08;23607;18098;1542314;780493;46.2;23.4
53;2021-06-09;23236;15853;1565550;796346;46.9;23.8
53;2021-06-10;26670;16860;1592220;813206;47.7;24.3
53;2021-06-11;26165;21412;1618385;834618;48.4;25.0
53;2021-06-12;18594;7504;1636979;842122;49.0;25.2
53;2021-06-13;7794;3118;1644773;845240;49.2;25.3
53;2021-06-14;16017;19794;1660790;865034;49.7;25.9
53;2021-06-15;20041;20945;1680831;885979;50.3;26.5
53;2021-06-16;21165;18531;1701996;904510;51.0;27.1
53;2021-06-17;21860;20076;1723856;924586;51.6;27.7
53;2021-06-18;22181;25637;1746037;950223;52.3;28.4
53;2021-06-19;12824;9601;1758861;959824;52.7;28.7
53;2021-06-20;5452;2678;1764313;962502;52.8;28.8
53;2021-06-21;14507;22334;1778820;984836;53.3;29.5
75;2020-12-27;1;0;1;0;0.0;0.0
75;2020-12-28;2;0;3;0;0.0;0.0
75;2020-12-29;3;0;6;0;0.0;0.0
75;2020-12-30;2;0;8;0;0.0;0.0
75;2020-12-31;0;0;8;0;0.0;0.0
75;2021-01-01;4;0;12;0;0.0;0.0
75;2021-01-02;2;0;14;0;0.0;0.0
75;2021-01-03;0;0;14;0;0.0;0.0
75;2021-01-04;90;0;104;0;0.0;0.0
75;2021-01-05;124;0;228;0;0.0;0.0
75;2021-01-06;736;1;964;1;0.0;0.0
75;2021-01-07;4923;2;5887;3;0.1;0.0
75;2021-01-08;5466;4;11353;7;0.2;0.0
75;2021-01-09;845;1;12198;8;0.2;0.0
75;2021-01-10;479;0;12677;8;0.2;0.0
75;2021-01-11;3585;1;16262;9;0.3;0.0
75;2021-01-12;5949;6;22211;15;0.4;0.0
75;2021-01-13;6551;15;28762;30;0.5;0.0
75;2021-01-14;8123;62;36885;92;0.6;0.0
75;2021-01-15;7627;29;44512;121;0.7;0.0
75;2021-01-16;1607;14;46119;135;0.8;0.0
75;2021-01-17;425;5;46544;140;0.8;0.0
75;2021-01-18;6888;30;53432;170;0.9;0.0
75;2021-01-19;14047;13;67479;183;1.1;0.0
75;2021-01-20;15535;26;83014;209;1.4;0.0
75;2021-01-21;16962;19;99976;228;1.7;0.0
75;2021-01-22;12970;22;112946;250;1.9;0.0
75;2021-01-23;4421;3;117367;253;2.0;0.0
75;2021-01-24;700;1;118067;254;2.0;0.0
75;2021-01-25;8867;218;126934;472;2.1;0.0
75;2021-01-26;11721;453;138655;925;2.3;0.0
75;2021-01-27;12277;770;150932;1695;2.5;0.0
75;2021-01-28;12940;2659;163872;4354;2.7;0.1
75;2021-01-29;10001;2986;173873;7340;2.9;0.1
75;2021-01-30;3379;516;177252;7856;3.0;0.1
75;2021-01-31;646;420;177898;8276;3.0;0.1
75;2021-02-01;5714;2640;183612;10916;3.1;0.2
75;2021-02-02;9609;4356;193221;15272;3.2;0.3
75;2021-02-03;9594;4369;202815;19641;3.4;0.3
75;2021-02-04;10762;5683;213577;25324;3.6;0.4
75;2021-02-05;7488;5636;221065;30960;3.7;0.5
75;2021-02-06;2378;1106;223443;32066;3.7;0.5
75;2021-02-07;673;252;224116;32318;3.7;0.5
75;2021-02-08;5135;3653;229251;35971;3.8;0.6
75;2021-02-09;7315;8079;236566;44050;3.9;0.7
75;2021-02-10;7542;8740;244108;52790;4.1;0.9
75;2021-02-11;8855;10272;252963;63062;4.2;1.1
75;2021-02-12;7405;8836;260368;71898;4.3;1.2
75;2021-02-13;1952;1760;262320;73658;4.4;1.2
75;2021-02-14;274;364;262594;74022;4.4;1.2
75;2021-02-15;3152;7839;265746;81861;4.4;1.4
75;2021-02-16;4608;10529;270354;92390;4.5;1.5
75;2021-02-17;4757;11303;275111;103693;4.6;1.7
75;2021-02-18;5451;12842;280562;116535;4.7;1.9
75;2021-02-19;5419;9635;285981;126170;4.8;2.1
75;2021-02-20;987;2633;286968;128803;4.8;2.1
75;2021-02-21;186;667;287154;129470;4.8;2.2
75;2021-02-22;3649;8516;290803;137986;4.8;2.3
75;2021-02-23;5355;10953;296158;148939;4.9;2.5
75;2021-02-24;6128;10288;302286;159227;5.0;2.7
75;2021-02-25;10042;11722;312328;170949;5.2;2.8
75;2021-02-26;12265;8866;324593;179815;5.4;3.0
75;2021-02-27;5785;2486;330378;182301;5.5;3.0
75;2021-02-28;312;694;330690;182995;5.5;3.0
75;2021-03-01;5089;7016;335779;190011;5.6;3.2
75;2021-03-02;9350;8166;345129;198177;5.8;3.3
75;2021-03-03;10818;7768;355947;205945;5.9;3.4
75;2021-03-04;16735;8170;372682;214115;6.2;3.6
75;2021-03-05;20793;7462;393475;221577;6.6;3.7
75;2021-03-06;13408;2231;406883;223808;6.8;3.7
75;2021-03-07;3721;466;410604;224274;6.8;3.7
75;2021-03-08;9985;5386;420589;229660;7.0;3.8
75;2021-03-09;16851;6482;437440;236142;7.3;3.9
75;2021-03-10;18252;6308;455692;242450;7.6;4.0
75;2021-03-11;26429;6678;482121;249128;8.0;4.2
75;2021-03-12;31291;5249;513412;254377;8.6;4.2
75;2021-03-13;17857;1197;531269;255574;8.9;4.3
75;2021-03-14;1701;247;532970;255821;8.9;4.3
75;2021-03-15;14075;3421;547045;259242;9.1;4.3
75;2021-03-16;13685;3712;560730;262954;9.3;4.4
75;2021-03-17;14745;3880;575475;266834;9.6;4.4
75;2021-03-18;16381;4688;591856;271522;9.9;4.5
75;2021-03-19;22434;4288;614290;275810;10.2;4.6
75;2021-03-20;14026;819;628316;276629;10.5;4.6
75;2021-03-21;2464;107;630780;276736;10.5;4.6
75;2021-03-22;16793;3458;647573;280194;10.8;4.7
75;2021-03-23;25262;3891;672835;284085;11.2;4.7
75;2021-03-24;27141;4307;699976;288392;11.7;4.8
75;2021-03-25;35634;4629;735610;293021;12.3;4.9
75;2021-03-26;38607;4181;774217;297202;12.9;5.0
75;2021-03-27;15709;1276;789926;298478;13.2;5.0
75;2021-03-28;2725;393;792651;298871;13.2;5.0
75;2021-03-29;22831;4139;815482;303010;13.6;5.1
75;2021-03-30;31627;5965;847109;308975;14.1;5.1
75;2021-03-31;29733;5940;876842;314915;14.6;5.2
75;2021-04-01;34999;6943;911841;321858;15.2;5.4
75;2021-04-02;32325;6869;944166;328727;15.7;5.5
75;2021-04-03;12818;2634;956984;331361;15.9;5.5
75;2021-04-04;2135;340;959119;331701;16.0;5.5
75;2021-04-05;6368;603;965487;332304;16.1;5.5
75;2021-04-06;26373;10827;991860;343131;16.5;5.7
75;2021-04-07;32354;11016;1024214;354147;17.1;5.9
75;2021-04-08;39556;12356;1063770;366503;17.7;6.1
75;2021-04-09;49231;10987;1113001;377490;18.6;6.3
75;2021-04-10;24440;4968;1137441;382458;19.0;6.4
75;2021-04-11;4969;718;1142410;383176;19.0;6.4
75;2021-04-12;27370;11846;1169780;395022;19.5;6.6
75;2021-04-13;35702;14336;1205482;409358;20.1;6.8
75;2021-04-14;35424;14484;1240906;423842;20.7;7.1
75;2021-04-15;37665;15060;1278571;438902;21.3;7.3
75;2021-04-16;37124;15119;1315695;454021;21.9;7.6
75;2021-04-17;19557;7379;1335252;461400;22.3;7.7
75;2021-04-18;4073;2054;1339325;463454;22.3;7.7
75;2021-04-19;20888;14955;1360213;478409;22.7;8.0
75;2021-04-20;28482;19109;1388695;497518;23.1;8.3
75;2021-04-21;27809;18089;1416504;515607;23.6;8.6
75;2021-04-22;30360;19681;1446864;535288;24.1;8.9
75;2021-04-23;29049;20244;1475913;555532;24.6;9.3
75;2021-04-24;17003;9136;1492916;564668;24.9;9.4
75;2021-04-25;4596;1499;1497512;566167;25.0;9.4
75;2021-04-26;22311;19296;1519823;585463;25.3;9.8
75;2021-04-27;29186;24320;1549009;609783;25.8;10.2
75;2021-04-28;31140;24020;1580149;633803;26.3;10.6
75;2021-04-29;37254;26642;1617403;660445;27.0;11.0
75;2021-04-30;37745;25879;1655148;686324;27.6;11.4
75;2021-05-01;15684;5746;1670832;692070;27.8;11.5
75;2021-05-02;7254;2596;1678086;694666;28.0;11.6
75;2021-05-03;27253;21180;1705339;715846;28.4;11.9
75;2021-05-04;30350;29295;1735689;745141;28.9;12.4
75;2021-05-05;31483;30989;1767172;776130;29.5;12.9
75;2021-05-06;35937;32394;1803109;808524;30.1;13.5
75;2021-05-07;37426;34368;1840535;842892;30.7;14.0
75;2021-05-08;17695;8093;1858230;850985;31.0;14.2
75;2021-05-09;7312;4153;1865542;855138;31.1;14.3
75;2021-05-10;25194;29018;1890736;884156;31.5;14.7
75;2021-05-11;35537;32964;1926273;917120;32.1;15.3
75;2021-05-12;35485;30140;1961758;947260;32.7;15.8
75;2021-05-13;22644;7521;1984402;954781;33.1;15.9
75;2021-05-14;33795;20842;2018197;975623;33.6;16.3
75;2021-05-15;22869;11092;2041066;986715;34.0;16.4
75;2021-05-16;7384;2060;2048450;988775;34.1;16.5
75;2021-05-17;33787;19211;2082237;1007986;34.7;16.8
75;2021-05-18;42592;19922;2124829;1027908;35.4;17.1
75;2021-05-19;42623;17603;2167452;1045511;36.1;17.4
75;2021-05-20;45865;20352;2213317;1065863;36.9;17.8
75;2021-05-21;42806;21382;2256123;1087245;37.6;18.1
75;2021-05-22;23229;9795;2279352;1097040;38.0;18.3
75;2021-05-23;7801;1420;2287153;1098460;38.1;18.3
75;2021-05-24;18835;4070;2305988;1102530;38.4;18.4
75;2021-05-25;36788;20960;2342776;1123490;39.0;18.7
75;2021-05-26;38231;21477;2381007;1144967;39.7;19.1
75;2021-05-27;42864;27073;2423871;1172040;40.4;19.5
75;2021-05-28;38830;32275;2462701;1204315;41.0;20.1
75;2021-05-29;19632;18097;2482333;1222412;41.4;20.4
75;2021-05-30;5771;2284;2488104;1224696;41.5;20.4
75;2021-05-31;31606;23118;2519710;1247814;42.0;20.8
75;2021-06-01;40956;29605;2560666;1277419;42.7;21.3
75;2021-06-02;41306;28226;2601972;1305645;43.4;21.8
75;2021-06-03;47579;31206;2649551;1336851;44.2;22.3
75;2021-06-04;44364;36956;2693915;1373807;44.9;22.9
75;2021-06-05;24379;18512;2718294;1392319;45.3;23.2
75;2021-06-06;8727;4317;2727021;1396636;45.5;23.3
75;2021-06-07;31365;31520;2758386;1428156;46.0;23.8
75;2021-06-08;39104;36021;2797490;1464177;46.6;24.4
75;2021-06-09;38747;32889;2836237;1497066;47.3;25.0
75;2021-06-10;42889;31794;2879126;1528860;48.0;25.5
75;2021-06-11;40234;40308;2919360;1569168;48.7;26.2
75;2021-06-12;23185;21517;2942545;1590685;49.0;26.5
75;2021-06-13;8100;5651;2950645;1596336;49.2;26.6
75;2021-06-14;23950;37923;2974595;1634259;49.6;27.2
75;2021-06-15;33103;41659;3007698;1675918;50.1;27.9
75;2021-06-16;34593;37258;3042291;1713176;50.7;28.6
75;2021-06-17;36016;38541;3078307;1751717;51.3;29.2
75;2021-06-18;34621;45269;3112928;1796986;51.9;29.9
75;2021-06-19;20106;23224;3133034;1820210;52.2;30.3
75;2021-06-20;6210;5727;3139244;1825937;52.3;30.4
75;2021-06-21;21330;37284;3160574;1863221;52.7;31.1
76;2020-12-27;0;0;0;0;0.0;0.0
76;2020-12-28;4;0;4;0;0.0;0.0
76;2020-12-29;0;0;4;0;0.0;0.0
76;2020-12-30;0;0;4;0;0.0;0.0
76;2020-12-31;1;0;5;0;0.0;0.0
76;2021-01-01;3;0;8;0;0.0;0.0
76;2021-01-02;2;0;10;0;0.0;0.0
76;2021-01-03;2;0;12;0;0.0;0.0
76;2021-01-04;59;1;71;1;0.0;0.0
76;2021-01-05;473;1;544;2;0.0;0.0
76;2021-01-06;784;2;1328;4;0.0;0.0
76;2021-01-07;2538;3;3866;7;0.1;0.0
76;2021-01-08;3214;2;7080;9;0.1;0.0
76;2021-01-09;1537;1;8617;10;0.1;0.0
76;2021-01-10;517;0;9134;10;0.2;0.0
76;2021-01-11;3524;8;12658;18;0.2;0.0
76;2021-01-12;5743;9;18401;27;0.3;0.0
76;2021-01-13;6474;9;24875;36;0.4;0.0
76;2021-01-14;8997;85;33872;121;0.6;0.0
76;2021-01-15;7250;31;41122;152;0.7;0.0
76;2021-01-16;1953;21;43075;173;0.7;0.0
76;2021-01-17;710;3;43785;176;0.7;0.0
76;2021-01-18;7701;21;51486;197;0.9;0.0
76;2021-01-19;11198;26;62684;223;1.1;0.0
76;2021-01-20;13703;24;76387;247;1.3;0.0
76;2021-01-21;16701;21;93088;268;1.6;0.0
76;2021-01-22;11871;31;104959;299;1.8;0.0
76;2021-01-23;3881;8;108840;307;1.8;0.0
76;2021-01-24;768;11;109608;318;1.8;0.0
76;2021-01-25;7829;97;117437;415;2.0;0.0
76;2021-01-26;10345;283;127782;698;2.2;0.0
76;2021-01-27;10848;481;138630;1179;2.3;0.0
76;2021-01-28;10136;1695;148766;2874;2.5;0.0
76;2021-01-29;8086;1988;156852;4862;2.6;0.1
76;2021-01-30;3185;772;160037;5634;2.7;0.1
76;2021-01-31;518;267;160555;5901;2.7;0.1
76;2021-02-01;5855;2603;166410;8504;2.8;0.1
76;2021-02-02;10056;3999;176466;12503;3.0;0.2
76;2021-02-03;9516;4067;185982;16570;3.1;0.3
76;2021-02-04;10100;5960;196082;22530;3.3;0.4
76;2021-02-05;7773;5027;203855;27557;3.4;0.5
76;2021-02-06;2694;1051;206549;28608;3.5;0.5
76;2021-02-07;542;497;207091;29105;3.5;0.5
76;2021-02-08;4840;4530;211931;33635;3.6;0.6
76;2021-02-09;6317;6820;218248;40455;3.7;0.7
76;2021-02-10;7174;9239;225422;49694;3.8;0.8
76;2021-02-11;9126;10738;234548;60432;4.0;1.0
76;2021-02-12;8045;7688;242593;68120;4.1;1.1
76;2021-02-13;2646;2272;245239;70392;4.1;1.2
76;2021-02-14;357;994;245596;71386;4.1;1.2
76;2021-02-15;3380;6468;248976;77854;4.2;1.3
76;2021-02-16;4244;8695;253220;86549;4.3;1.5
76;2021-02-17;4374;9654;257594;96203;4.3;1.6
76;2021-02-18;5869;9988;263463;106191;4.4;1.8
76;2021-02-19;4840;8129;268303;114320;4.5;1.9
76;2021-02-20;1529;3041;269832;117361;4.6;2.0
76;2021-02-21;262;595;270094;117956;4.6;2.0
76;2021-02-22;3277;7664;273371;125620;4.6;2.1
76;2021-02-23;4918;10245;278289;135865;4.7;2.3
76;2021-02-24;4644;10422;282933;146287;4.8;2.5
76;2021-02-25;8310;9908;291243;156195;4.9;2.6
76;2021-02-26;9635;8400;300878;164595;5.1;2.8
76;2021-02-27;3728;3096;304606;167691;5.1;2.8
76;2021-02-28;431;453;305037;168144;5.1;2.8
76;2021-03-01;5304;6146;310341;174290;5.2;2.9
76;2021-03-02;8212;7567;318553;181857;5.4;3.1
76;2021-03-03;9240;7491;327793;189348;5.5;3.2
76;2021-03-04;14316;7889;342109;197237;5.8;3.3
76;2021-03-05;16868;7112;358977;204349;6.1;3.4
76;2021-03-06;15883;2156;374860;206505;6.3;3.5
76;2021-03-07;11377;466;386237;206971;6.5;3.5
76;2021-03-08;9975;5519;396212;212490;6.7;3.6
76;2021-03-09;16220;6466;412432;218956;7.0;3.7
76;2021-03-10;16408;6488;428840;225444;7.2;3.8
76;2021-03-11;22589;6386;451429;231830;7.6;3.9
76;2021-03-12;26396;5255;477825;237085;8.1;4.0
76;2021-03-13;14910;2154;492735;239239;8.3;4.0
76;2021-03-14;2323;355;495058;239594;8.4;4.0
76;2021-03-15;13509;3295;508567;242889;8.6;4.1
76;2021-03-16;11756;4523;520323;247412;8.8;4.2
76;2021-03-17;12839;3967;533162;251379;9.0;4.2
76;2021-03-18;13700;4985;546862;256364;9.2;4.3
76;2021-03-19;18641;4002;565503;260366;9.5;4.4
76;2021-03-20;10655;1127;576158;261493;9.7;4.4
76;2021-03-21;3194;221;579352;261714;9.8;4.4
76;2021-03-22;14662;3578;594014;265292;10.0;4.5
76;2021-03-23;22228;4317;616242;269609;10.4;4.6
76;2021-03-24;23588;4179;639830;273788;10.8;4.6
76;2021-03-25;32004;4604;671834;278392;11.3;4.7
76;2021-03-26;30829;4061;702663;282453;11.9;4.8
76;2021-03-27;16220;1410;718883;283863;12.1;4.8
76;2021-03-28;4868;191;723751;284054;12.2;4.8
76;2021-03-29;22291;4874;746042;288928;12.6;4.9
76;2021-03-30;29689;5706;775731;294634;13.1;5.0
76;2021-03-31;26849;5581;802580;300215;13.5;5.1
76;2021-04-01;34422;5884;837002;306099;14.1;5.2
76;2021-04-02;29311;5752;866313;311851;14.6;5.3
76;2021-04-03;12130;2847;878443;314698;14.8;5.3
76;2021-04-04;4352;657;882795;315355;14.9;5.3
76;2021-04-05;4287;674;887082;316029;15.0;5.3
76;2021-04-06;22826;9739;909908;325768;15.4;5.5
76;2021-04-07;25228;9853;935136;335621;15.8;5.7
76;2021-04-08;33086;10230;968222;345851;16.3;5.8
76;2021-04-09;38864;9606;1007086;355457;17.0;6.0
76;2021-04-10;22683;5148;1029769;360605;17.4;6.1
76;2021-04-11;8856;1431;1038625;362036;17.5;6.1
76;2021-04-12;26007;10503;1064632;372539;18.0;6.3
76;2021-04-13;35737;12844;1100369;385383;18.6;6.5
76;2021-04-14;32835;13245;1133204;398628;19.1;6.7
76;2021-04-15;37414;13823;1170618;412451;19.8;7.0
76;2021-04-16;34380;13135;1204998;425586;20.3;7.2
76;2021-04-17;21359;6645;1226357;432231;20.7;7.3
76;2021-04-18;7708;2687;1234065;434918;20.8;7.3
76;2021-04-19;22037;12916;1256102;447834;21.2;7.6
76;2021-04-20;27952;16728;1284054;464562;21.7;7.8
76;2021-04-21;27005;16922;1311059;481484;22.1;8.1
76;2021-04-22;30335;17916;1341394;499400;22.6;8.4
76;2021-04-23;28661;16388;1370055;515788;23.1;8.7
76;2021-04-24;18458;10396;1388513;526184;23.4;8.9
76;2021-04-25;6907;4196;1395420;530380;23.6;9.0
76;2021-04-26;19920;18391;1415340;548771;23.9;9.3
76;2021-04-27;26705;21397;1442045;570168;24.3;9.6
76;2021-04-28;25875;20961;1467920;591129;24.8;10.0
76;2021-04-29;29707;23197;1497627;614326;25.3;10.4
76;2021-04-30;30762;20128;1528389;634454;25.8;10.7
76;2021-05-01;17416;7017;1545805;641471;26.1;10.8
76;2021-05-02;9478;4782;1555283;646253;26.3;10.9
76;2021-05-03;26513;16775;1581796;663028;26.7;11.2
76;2021-05-04;29979;25819;1611775;688847;27.2;11.6
76;2021-05-05;28146;26396;1639921;715243;27.7;12.1
76;2021-05-06;30995;30863;1670916;746106;28.2;12.6
76;2021-05-07;31600;30781;1702516;776887;28.7;13.1
76;2021-05-08;17326;10549;1719842;787436;29.0;13.3
76;2021-05-09;9708;8675;1729550;796111;29.2;13.4
76;2021-05-10;24060;28049;1753610;824160;29.6;13.9
76;2021-05-11;31572;33059;1785182;857219;30.1;14.5
76;2021-05-12;33128;29378;1818310;886597;30.7;15.0
76;2021-05-13;25851;9712;1844161;896309;31.1;15.1
76;2021-05-14;34388;21279;1878549;917588;31.7;15.5
76;2021-05-15;24405;12165;1902954;929753;32.1;15.7
76;2021-05-16;15383;3782;1918337;933535;32.4;15.8
76;2021-05-17;27751;19224;1946088;952759;32.8;16.1
76;2021-05-18;35042;19460;1981130;972219;33.4;16.4
76;2021-05-19;36684;16808;2017814;989027;34.1;16.7
76;2021-05-20;40820;18624;2058634;1007651;34.7;17.0
76;2021-05-21;37610;19942;2096244;1027593;35.4;17.3
76;2021-05-22;26907;9242;2123151;1036835;35.8;17.5
76;2021-05-23;13259;1797;2136410;1038632;36.1;17.5
76;2021-05-24;15367;4101;2151777;1042733;36.3;17.6
76;2021-05-25;31471;20737;2183248;1063470;36.8;17.9
76;2021-05-26;33259;19188;2216507;1082658;37.4;18.3
76;2021-05-27;36206;24393;2252713;1107051;38.0;18.7
76;2021-05-28;32367;28241;2285080;1135292;38.6;19.2
76;2021-05-29;19449;16736;2304529;1152028;38.9;19.4
76;2021-05-30;6141;6311;2310670;1158339;39.0;19.6
76;2021-05-31;25685;22868;2336355;1181207;39.4;19.9
76;2021-06-01;31102;29806;2367457;1211013;40.0;20.4
76;2021-06-02;30651;28033;2398108;1239046;40.5;20.9
76;2021-06-03;34091;33083;2432199;1272129;41.1;21.5
76;2021-06-04;34986;34208;2467185;1306337;41.6;22.0
76;2021-06-05;25961;19709;2493146;1326046;42.1;22.4
76;2021-06-06;14068;6457;2507214;1332503;42.3;22.5
76;2021-06-07;25694;27645;2532908;1360148;42.8;23.0
76;2021-06-08;32926;31620;2565834;1391768;43.3;23.5
76;2021-06-09;32182;28986;2598016;1420754;43.8;24.0
76;2021-06-10;31855;29427;2629871;1450181;44.4;24.5
76;2021-06-11;33456;36095;2663327;1486276;45.0;25.1
76;2021-06-12;23157;21883;2686484;1508159;45.3;25.5
76;2021-06-13;12017;7129;2698501;1515288;45.5;25.6
76;2021-06-14;21507;33590;2720008;1548878;45.9;26.1
76;2021-06-15;28631;39668;2748639;1588546;46.4;26.8
76;2021-06-16;26950;36313;2775589;1624859;46.8;27.4
76;2021-06-17;26670;34124;2802259;1658983;47.3;28.0
76;2021-06-18;27295;41060;2829554;1700043;47.8;28.7
76;2021-06-19;20770;23071;2850324;1723114;48.1;29.1
76;2021-06-20;8900;10324;2859224;1733438;48.3;29.3
76;2021-06-21;14927;35149;2874151;1768587;48.5;29.9
84;2020-12-27;1;0;1;0;0.0;0.0
84;2020-12-28;7;0;8;0;0.0;0.0
84;2020-12-29;5;0;13;0;0.0;0.0
84;2020-12-30;6;0;19;0;0.0;0.0
84;2020-12-31;15;0;34;0;0.0;0.0
84;2021-01-01;10;0;44;0;0.0;0.0
84;2021-01-02;2;1;46;1;0.0;0.0
84;2021-01-03;0;0;46;1;0.0;0.0
84;2021-01-04;174;0;220;1;0.0;0.0
84;2021-01-05;467;1;687;2;0.0;0.0
84;2021-01-06;1135;0;1822;2;0.0;0.0
84;2021-01-07;2847;3;4669;5;0.1;0.0
84;2021-01-08;3077;3;7746;8;0.1;0.0
84;2021-01-09;513;1;8259;9;0.1;0.0
84;2021-01-10;161;0;8420;9;0.1;0.0
84;2021-01-11;4293;8;12713;17;0.2;0.0
84;2021-01-12;6360;15;19073;32;0.2;0.0
84;2021-01-13;6840;14;25913;46;0.3;0.0
84;2021-01-14;9071;57;34984;103;0.4;0.0
84;2021-01-15;7764;30;42748;133;0.5;0.0
84;2021-01-16;2953;7;45701;140;0.6;0.0
84;2021-01-17;920;3;46621;143;0.6;0.0
84;2021-01-18;8963;34;55584;177;0.7;0.0
84;2021-01-19;15046;81;70630;258;0.9;0.0
84;2021-01-20;15491;34;86121;292;1.1;0.0
84;2021-01-21;14575;49;100696;341;1.3;0.0
84;2021-01-22;12407;43;113103;384;1.4;0.0
84;2021-01-23;4758;3;117861;387;1.5;0.0
84;2021-01-24;810;1;118671;388;1.5;0.0
84;2021-01-25;8761;147;127432;535;1.6;0.0
84;2021-01-26;11894;320;139326;855;1.7;0.0
84;2021-01-27;12065;616;151391;1471;1.9;0.0
84;2021-01-28;13815;1540;165206;3011;2.1;0.0
84;2021-01-29;10791;1310;175997;4321;2.2;0.1
84;2021-01-30;4139;147;180136;4468;2.2;0.1
84;2021-01-31;499;1;180635;4469;2.2;0.1
84;2021-02-01;6533;1887;187168;6356;2.3;0.1
84;2021-02-02;10589;3518;197757;9874;2.5;0.1
84;2021-02-03;11528;3926;209285;13800;2.6;0.2
84;2021-02-04;12554;5539;221839;19339;2.8;0.2
84;2021-02-05;8610;4695;230449;24034;2.9;0.3
84;2021-02-06;2650;958;233099;24992;2.9;0.3
84;2021-02-07;451;441;233550;25433;2.9;0.3
84;2021-02-08;6222;4968;239772;30401;3.0;0.4
84;2021-02-09;9342;8269;249114;38670;3.1;0.5
84;2021-02-10;9677;8615;258791;47285;3.2;0.6
84;2021-02-11;10690;9907;269481;57192;3.4;0.7
84;2021-02-12;9711;7940;279192;65132;3.5;0.8
84;2021-02-13;3497;2347;282689;67479;3.5;0.8
84;2021-02-14;623;457;283312;67936;3.5;0.8
84;2021-02-15;4871;8363;288183;76299;3.6;0.9
84;2021-02-16;6096;10777;294279;87076;3.7;1.1
84;2021-02-17;6054;11575;300333;98651;3.7;1.2
84;2021-02-18;7100;11768;307433;110419;3.8;1.4
84;2021-02-19;6643;9350;314076;119769;3.9;1.5
84;2021-02-20;1837;3272;315913;123041;3.9;1.5
84;2021-02-21;180;504;316093;123545;3.9;1.5
84;2021-02-22;4287;8853;320380;132398;4.0;1.6
84;2021-02-23;7279;11425;327659;143823;4.1;1.8
84;2021-02-24;7792;12030;335451;155853;4.2;1.9
84;2021-02-25;12724;13803;348175;169656;4.3;2.1
84;2021-02-26;14873;10354;363048;180010;4.5;2.2
84;2021-02-27;5558;2922;368606;182932;4.6;2.3
84;2021-02-28;500;514;369106;183446;4.6;2.3
84;2021-03-01;9287;6420;378393;189866;4.7;2.4
84;2021-03-02;14959;8806;393352;198672;4.9;2.5
84;2021-03-03;14793;8667;408145;207339;5.1;2.6
84;2021-03-04;20988;8448;429133;215787;5.3;2.7
84;2021-03-05;25775;7696;454908;223483;5.7;2.8
84;2021-03-06;19492;2383;474400;225866;5.9;2.8
84;2021-03-07;8414;468;482814;226334;6.0;2.8
84;2021-03-08;12203;6804;495017;233138;6.2;2.9
84;2021-03-09;20668;7697;515685;240835;6.4;3.0
84;2021-03-10;20223;7534;535908;248369;6.7;3.1
84;2021-03-11;29451;8142;565359;256511;7.0;3.2
84;2021-03-12;36173;7689;601532;264200;7.5;3.3
84;2021-03-13;21423;1875;622955;266075;7.8;3.3
84;2021-03-14;4683;471;627638;266546;7.8;3.3
84;2021-03-15;18857;4791;646495;271337;8.0;3.4
84;2021-03-16;17052;6105;663547;277442;8.3;3.5
84;2021-03-17;17575;6468;681122;283910;8.5;3.5
84;2021-03-18;21499;6943;702621;290853;8.7;3.6
84;2021-03-19;28970;5507;731591;296360;9.1;3.7
84;2021-03-20;14536;1406;746127;297766;9.3;3.7
84;2021-03-21;3237;272;749364;298038;9.3;3.7
84;2021-03-22;19729;5136;769093;303174;9.6;3.8
84;2021-03-23;30776;5965;799869;309139;10.0;3.8
84;2021-03-24;29948;5873;829817;315012;10.3;3.9
84;2021-03-25;41544;6481;871361;321493;10.8;4.0
84;2021-03-26;42965;6766;914326;328259;11.4;4.1
84;2021-03-27;18201;2928;932527;331187;11.6;4.1
84;2021-03-28;6505;592;939032;331779;11.7;4.1
84;2021-03-29;22936;7929;961968;339708;12.0;4.2
84;2021-03-30;34920;10190;996888;349898;12.4;4.4
84;2021-03-31;29569;11027;1026457;360925;12.8;4.5
84;2021-04-01;37225;11442;1063682;372367;13.2;4.6
84;2021-04-02;34859;11367;1098541;383734;13.7;4.8
84;2021-04-03;14784;6226;1113325;389960;13.9;4.9
84;2021-04-04;9928;2000;1123253;391960;14.0;4.9
84;2021-04-05;13524;1669;1136777;393629;14.2;4.9
84;2021-04-06;26269;13239;1163046;406868;14.5;5.1
84;2021-04-07;29477;14684;1192523;421552;14.8;5.2
84;2021-04-08;39631;15467;1232154;437019;15.3;5.4
84;2021-04-09;49363;15088;1281517;452107;16.0;5.6
84;2021-04-10;20444;8138;1301961;460245;16.2;5.7
84;2021-04-11;7221;2701;1309182;462946;16.3;5.8
84;2021-04-12;27282;15586;1336464;478532;16.6;6.0
84;2021-04-13;36075;19387;1372539;497919;17.1;6.2
84;2021-04-14;34598;18275;1407137;516194;17.5;6.4
84;2021-04-15;40080;19702;1447217;535896;18.0;6.7
84;2021-04-16;38182;20098;1485399;555994;18.5;6.9
84;2021-04-17;20455;9034;1505854;565028;18.7;7.0
84;2021-04-18;6837;2712;1512691;567740;18.8;7.1
84;2021-04-19;26210;18594;1538901;586334;19.2;7.3
84;2021-04-20;31174;22514;1570075;608848;19.5;7.6
84;2021-04-21;28021;21481;1598096;630329;19.9;7.8
84;2021-04-22;32216;22641;1630312;652970;20.3;8.1
84;2021-04-23;32672;23116;1662984;676086;20.7;8.4
84;2021-04-24;17849;11903;1680833;687989;20.9;8.6
84;2021-04-25;7133;4288;1687966;692277;21.0;8.6
84;2021-04-26;23700;20050;1711666;712327;21.3;8.9
84;2021-04-27;31745;25281;1743411;737608;21.7;9.2
84;2021-04-28;32465;24853;1775876;762461;22.1;9.5
84;2021-04-29;39628;26570;1815504;789031;22.6;9.8
84;2021-04-30;38131;27873;1853635;816904;23.1;10.2
84;2021-05-01;17153;5376;1870788;822280;23.3;10.2
84;2021-05-02;7973;8582;1878761;830862;23.4;10.3
84;2021-05-03;30297;27513;1909058;858375;23.8;10.7
84;2021-05-04;37129;33768;1946187;892143;24.2;11.1
84;2021-05-05;40213;30188;1986400;922331;24.7;11.5
84;2021-05-06;46569;32656;2032969;954987;25.3;11.9
84;2021-05-07;46965;36821;2079934;991808;25.9;12.3
84;2021-05-08;22205;7649;2102139;999457;26.2;12.4
84;2021-05-09;15896;8915;2118035;1008372;26.4;12.6
84;2021-05-10;36026;32008;2154061;1040380;26.8;13.0
84;2021-05-11;52548;36278;2206609;1076658;27.5;13.4
84;2021-05-12;56533;31861;2263142;1108519;28.2;13.8
84;2021-05-13;47223;10500;2310365;1119019;28.8;13.9
84;2021-05-14;57161;24975;2367526;1143994;29.5;14.2
84;2021-05-15;43919;13600;2411445;1157594;30.0;14.4
84;2021-05-16;30347;5113;2441792;1162707;30.4;14.5
84;2021-05-17;48175;24920;2489967;1187627;31.0;14.8
84;2021-05-18;58831;27352;2548798;1214979;31.7;15.1
84;2021-05-19;58198;23525;2606996;1238504;32.5;15.4
84;2021-05-20;61454;27022;2668450;1265526;33.2;15.8
84;2021-05-21;60797;29379;2729247;1294905;34.0;16.1
84;2021-05-22;40372;12895;2769619;1307800;34.5;16.3
84;2021-05-23;21326;3974;2790945;1311774;34.7;16.3
84;2021-05-24;39499;8528;2830444;1320302;35.2;16.4
84;2021-05-25;50187;31658;2880631;1351960;35.9;16.8
84;2021-05-26;49637;28917;2930268;1380877;36.5;17.2
84;2021-05-27;55594;31828;2985862;1412705;37.2;17.6
84;2021-05-28;54676;40493;3040538;1453198;37.9;18.1
84;2021-05-29;37559;22371;3078097;1475569;38.3;18.4
84;2021-05-30;16109;7261;3094206;1482830;38.5;18.5
84;2021-05-31;44255;29408;3138461;1512238;39.1;18.8
84;2021-06-01;48256;36638;3186717;1548876;39.7;19.3
84;2021-06-02;47659;31197;3234376;1580073;40.3;19.7
84;2021-06-03;55974;36558;3290350;1616631;41.0;20.1
84;2021-06-04;54546;42354;3344896;1658985;41.6;20.7
84;2021-06-05;38038;21673;3382934;1680658;42.1;20.9
84;2021-06-06;15897;6279;3398831;1686937;42.3;21.0
84;2021-06-07;41303;35147;3440134;1722084;42.8;21.4
84;2021-06-08;45658;37991;3485792;1760075;43.4;21.9
84;2021-06-09;40552;33790;3526344;1793865;43.9;22.3
84;2021-06-10;41122;33830;3567466;1827695;44.4;22.8
84;2021-06-11;43225;46308;3610691;1874003;45.0;23.3
84;2021-06-12;28102;22915;3638793;1896918;45.3;23.6
84;2021-06-13;8602;7118;3647395;1904036;45.4;23.7
84;2021-06-14;25506;44530;3672901;1948566;45.7;24.3
84;2021-06-15;31521;49266;3704422;1997832;46.1;24.9
84;2021-06-16;33205;45380;3737627;2043212;46.5;25.4
84;2021-06-17;30432;46887;3768059;2090099;46.9;26.0
84;2021-06-18;34723;59829;3802782;2149928;47.3;26.8
84;2021-06-19;22631;35664;3825413;2185592;47.6;27.2
84;2021-06-20;8642;14351;3834055;2199943;47.7;27.4
84;2021-06-21;19784;56067;3853839;2256010;48.0;28.1
93;2020-12-27;0;0;0;0;0.0;0.0
93;2020-12-28;2;0;2;0;0.0;0.0
93;2020-12-29;1;0;3;0;0.0;0.0
93;2020-12-30;3;0;6;0;0.0;0.0
93;2020-12-31;19;0;25;0;0.0;0.0
93;2021-01-01;13;0;38;0;0.0;0.0
93;2021-01-02;2;0;40;0;0.0;0.0
93;2021-01-03;2;0;42;0;0.0;0.0
93;2021-01-04;133;1;175;1;0.0;0.0
93;2021-01-05;251;1;426;2;0.0;0.0
93;2021-01-06;410;0;836;2;0.0;0.0
93;2021-01-07;1245;2;2081;4;0.0;0.0
93;2021-01-08;1562;2;3643;6;0.1;0.0
93;2021-01-09;540;1;4183;7;0.1;0.0
93;2021-01-10;74;0;4257;7;0.1;0.0
93;2021-01-11;2410;1;6667;8;0.1;0.0
93;2021-01-12;5088;6;11755;14;0.2;0.0
93;2021-01-13;4448;14;16203;28;0.3;0.0
93;2021-01-14;5543;50;21746;78;0.4;0.0
93;2021-01-15;4925;15;26671;93;0.5;0.0
93;2021-01-16;1678;4;28349;97;0.6;0.0
93;2021-01-17;299;1;28648;98;0.6;0.0
93;2021-01-18;7155;29;35803;127;0.7;0.0
93;2021-01-19;13521;33;49324;160;1.0;0.0
93;2021-01-20;12245;33;61569;193;1.2;0.0
93;2021-01-21;12305;46;73874;239;1.5;0.0
93;2021-01-22;10179;26;84053;265;1.7;0.0
93;2021-01-23;3326;6;87379;271;1.7;0.0
93;2021-01-24;537;4;87916;275;1.7;0.0
93;2021-01-25;7248;39;95164;314;1.9;0.0
93;2021-01-26;10067;136;105231;450;2.1;0.0
93;2021-01-27;9689;289;114920;739;2.3;0.0
93;2021-01-28;13663;833;128583;1572;2.5;0.0
93;2021-01-29;9844;978;138427;2550;2.7;0.1
93;2021-01-30;2240;159;140667;2709;2.8;0.1
93;2021-01-31;303;5;140970;2714;2.8;0.1
93;2021-02-01;5160;1518;146130;4232;2.9;0.1
93;2021-02-02;6644;2379;152774;6611;3.0;0.1
93;2021-02-03;5023;1821;157797;8432;3.1;0.2
93;2021-02-04;5533;3159;163330;11591;3.2;0.2
93;2021-02-05;6106;4126;169436;15717;3.4;0.3
93;2021-02-06;1246;972;170682;16689;3.4;0.3
93;2021-02-07;280;81;170962;16770;3.4;0.3
93;2021-02-08;4301;3746;175263;20516;3.5;0.4
93;2021-02-09;5889;7103;181152;27619;3.6;0.5
93;2021-02-10;5955;5887;187107;33506;3.7;0.7
93;2021-02-11;6595;6720;193702;40226;3.8;0.8
93;2021-02-12;5720;6479;199422;46705;3.9;0.9
93;2021-02-13;1127;1449;200549;48154;4.0;1.0
93;2021-02-14;73;384;200622;48538;4.0;1.0
93;2021-02-15;2413;5638;203035;54176;4.0;1.1
93;2021-02-16;3190;7705;206225;61881;4.1;1.2
93;2021-02-17;3604;8527;209829;70408;4.2;1.4
93;2021-02-18;6007;11418;215836;81826;4.3;1.6
93;2021-02-19;5637;8672;221473;90498;4.4;1.8
93;2021-02-20;879;1800;222352;92298;4.4;1.8
93;2021-02-21;68;417;222420;92715;4.4;1.8
93;2021-02-22;3027;6995;225447;99710;4.5;2.0
93;2021-02-23;3960;7245;229407;106955;4.5;2.1
93;2021-02-24;4748;6797;234155;113752;4.6;2.2
93;2021-02-25;8243;6659;242398;120411;4.8;2.4
93;2021-02-26;8273;6177;250671;126588;5.0;2.5
93;2021-02-27;3285;1488;253956;128076;5.0;2.5
93;2021-02-28;303;238;254259;128314;5.0;2.5
93;2021-03-01;5646;4483;259905;132797;5.1;2.6
93;2021-03-02;7213;5928;267118;138725;5.3;2.7
93;2021-03-03;8984;6551;276102;145276;5.5;2.9
93;2021-03-04;12056;6448;288158;151724;5.7;3.0
93;2021-03-05;12193;6091;300351;157815;5.9;3.1
93;2021-03-06;22812;1293;323163;159108;6.4;3.1
93;2021-03-07;17981;598;341144;159706;6.7;3.2
93;2021-03-08;10238;5259;351382;164965;7.0;3.3
93;2021-03-09;13950;5560;365332;170525;7.2;3.4
93;2021-03-10;14488;5265;379820;175790;7.5;3.5
93;2021-03-11;20380;6142;400200;181932;7.9;3.6
93;2021-03-12;21903;5292;422103;187224;8.3;3.7
93;2021-03-13;24584;1220;446687;188444;8.8;3.7
93;2021-03-14;6471;258;453158;188702;9.0;3.7
93;2021-03-15;15935;3104;469093;191806;9.3;3.8
93;2021-03-16;12715;3637;481808;195443;9.5;3.9
93;2021-03-17;15990;4630;497798;200073;9.8;4.0
93;2021-03-18;17032;4887;514830;204960;10.2;4.1
93;2021-03-19;21013;4686;535843;209646;10.6;4.1
93;2021-03-20;10988;1315;546831;210961;10.8;4.2
93;2021-03-21;3255;129;550086;211090;10.9;4.2
93;2021-03-22;17090;3553;567176;214643;11.2;4.2
93;2021-03-23;22645;3867;589821;218510;11.7;4.3
93;2021-03-24;21975;6626;611796;225136;12.1;4.5
93;2021-03-25;29003;6506;640799;231642;12.7;4.6
93;2021-03-26;29900;5013;670699;236655;13.3;4.7
93;2021-03-27;12448;1626;683147;238281;13.5;4.7
93;2021-03-28;3574;99;686721;238380;13.6;4.7
93;2021-03-29;18504;5326;705225;243706;13.9;4.8
93;2021-03-30;28460;6664;733685;250370;14.5;5.0
93;2021-03-31;28763;6615;762448;256985;15.1;5.1
93;2021-04-01;30711;7467;793159;264452;15.7;5.2
93;2021-04-02;26901;8471;820060;272923;16.2;5.4
93;2021-04-03;9745;4976;829805;277899;16.4;5.5
93;2021-04-04;2116;1250;831921;279149;16.5;5.5
93;2021-04-05;6055;1559;837976;280708;16.6;5.6
93;2021-04-06;23400;10012;861376;290720;17.0;5.8
93;2021-04-07;26058;11661;887434;302381;17.6;6.0
93;2021-04-08;28821;14953;916255;317334;18.1;6.3
93;2021-04-09;33568;14598;949823;331932;18.8;6.6
93;2021-04-10;14803;8160;964626;340092;19.1;6.7
93;2021-04-11;3624;2959;968250;343051;19.2;6.8
93;2021-04-12;20579;12195;988829;355246;19.6;7.0
93;2021-04-13;25505;15212;1014334;370458;20.1;7.3
93;2021-04-14;25168;15231;1039502;385689;20.6;7.6
93;2021-04-15;26973;15631;1066475;401320;21.1;7.9
93;2021-04-16;27871;16435;1094346;417755;21.6;8.3
93;2021-04-17;12818;7723;1107164;425478;21.9;8.4
93;2021-04-18;5247;2957;1112411;428435;22.0;8.5
93;2021-04-19;19074;15951;1131485;444386;22.4;8.8
93;2021-04-20;21324;18737;1152809;463123;22.8;9.2
93;2021-04-21;23861;18295;1176670;481418;23.3;9.5
93;2021-04-22;25813;19223;1202483;500641;23.8;9.9
93;2021-04-23;25324;18144;1227807;518785;24.3;10.3
93;2021-04-24;11534;8694;1239341;527479;24.5;10.4
93;2021-04-25;3202;2140;1242543;529619;24.6;10.5
93;2021-04-26;16427;15852;1258970;545471;24.9;10.8
93;2021-04-27;19424;20155;1278394;565626;25.3;11.2
93;2021-04-28;21483;20090;1299877;585716;25.7;11.6
93;2021-04-29;27863;21757;1327740;607473;26.3;12.0
93;2021-04-30;27232;20588;1354972;628061;26.8;12.4
93;2021-05-01;11598;5275;1366570;633336;27.0;12.5
93;2021-05-02;4060;1885;1370630;635221;27.1;12.6
93;2021-05-03;20425;18166;1391055;653387;27.5;12.9
93;2021-05-04;20727;22716;1411782;676103;27.9;13.4
93;2021-05-05;19403;21500;1431185;697603;28.3;13.8
93;2021-05-06;24732;21631;1455917;719234;28.8;14.2
93;2021-05-07;22394;24996;1478311;744230;29.2;14.7
93;2021-05-08;13465;6869;1491776;751099;29.5;14.9
93;2021-05-09;3463;2317;1495239;753416;29.6;14.9
93;2021-05-10;18591;22571;1513830;775987;29.9;15.3
93;2021-05-11;25260;25623;1539090;801610;30.4;15.9
93;2021-05-12;32293;22505;1571383;824115;31.1;16.3
93;2021-05-13;27762;7847;1599145;831962;31.6;16.5
93;2021-05-14;34986;16355;1634131;848317;32.3;16.8
93;2021-05-15;29240;10221;1663371;858538;32.9;17.0
93;2021-05-16;12729;2504;1676100;861042;33.2;17.0
93;2021-05-17;25465;17445;1701565;878487;33.7;17.4
93;2021-05-18;30034;16702;1731599;895189;34.3;17.7
93;2021-05-19;29914;15146;1761513;910335;34.8;18.0
93;2021-05-20;32589;16675;1794102;927010;35.5;18.3
93;2021-05-21;33590;17844;1827692;944854;36.2;18.7
93;2021-05-22;18522;7668;1846214;952522;36.5;18.8
93;2021-05-23;5896;2016;1852110;954538;36.6;18.9
93;2021-05-24;17431;4980;1869541;959518;37.0;19.0
93;2021-05-25;23496;20436;1893037;979954;37.4;19.4
93;2021-05-26;24456;21890;1917493;1001844;37.9;19.8
93;2021-05-27;26280;23294;1943773;1025138;38.4;20.3
93;2021-05-28;22735;26610;1966508;1051748;38.9;20.8
93;2021-05-29;13125;14356;1979633;1066104;39.2;21.1
93;2021-05-30;2582;3182;1982215;1069286;39.2;21.2
93;2021-05-31;20784;21286;2002999;1090572;39.6;21.6
93;2021-06-01;24302;26127;2027301;1116699;40.1;22.1
93;2021-06-02;22144;26070;2049445;1142769;40.5;22.6
93;2021-06-03;27506;27262;2076951;1170031;41.1;23.1
93;2021-06-04;27903;28309;2104854;1198340;41.6;23.7
93;2021-06-05;16256;14213;2121110;1212553;42.0;24.0
93;2021-06-06;4859;2792;2125969;1215345;42.1;24.0
93;2021-06-07;17144;24290;2143113;1239635;42.4;24.5
93;2021-06-08;21128;24094;2164241;1263729;42.8;25.0
93;2021-06-09;20165;25616;2184406;1289345;43.2;25.5
93;2021-06-10;21033;24524;2205439;1313869;43.6;26.0
93;2021-06-11;18964;30636;2224403;1344505;44.0;26.6
93;2021-06-12;12280;15216;2236683;1359721;44.2;26.9
93;2021-06-13;2546;3317;2239229;1363038;44.3;27.0
93;2021-06-14;12982;29332;2252211;1392370;44.5;27.5
93;2021-06-15;16018;30899;2268229;1423269;44.9;28.2
93;2021-06-16;16678;25577;2284907;1448846;45.2;28.7
93;2021-06-17;16746;28056;2301653;1476902;45.5;29.2
93;2021-06-18;16126;27923;2317779;1504825;45.8;29.8
93;2021-06-19;9181;15278;2326960;1520103;46.0;30.1
93;2021-06-20;2387;3693;2329347;1523796;46.1;30.1
93;2021-06-21;9762;30363;2339109;1554159;46.3;30.7
94;2020-12-27;0;0;0;0;0.0;0.0
94;2020-12-28;0;0;0;0;0.0;0.0
94;2020-12-29;0;0;0;0;0.0;0.0
94;2020-12-30;0;0;0;0;0.0;0.0
94;2020-12-31;0;0;0;0;0.0;0.0
94;2021-01-01;0;0;0;0;0.0;0.0
94;2021-01-02;0;0;0;0;0.0;0.0
94;2021-01-03;0;0;0;0;0.0;0.0
94;2021-01-04;2;0;2;0;0.0;0.0
94;2021-01-05;0;0;2;0;0.0;0.0
94;2021-01-06;53;1;55;1;0.0;0.0
94;2021-01-07;333;1;388;2;0.1;0.0
94;2021-01-08;310;0;698;2;0.2;0.0
94;2021-01-09;78;0;776;2;0.2;0.0
94;2021-01-10;34;0;810;2;0.2;0.0
94;2021-01-11;152;2;962;4;0.3;0.0
94;2021-01-12;209;1;1171;5;0.3;0.0
94;2021-01-13;203;0;1374;5;0.4;0.0
94;2021-01-14;264;1;1638;6;0.5;0.0
94;2021-01-15;403;0;2041;6;0.6;0.0
94;2021-01-16;200;1;2241;7;0.7;0.0
94;2021-01-17;91;1;2332;8;0.7;0.0
94;2021-01-18;471;2;2803;10;0.8;0.0
94;2021-01-19;982;0;3785;10;1.1;0.0
94;2021-01-20;808;0;4593;10;1.3;0.0
94;2021-01-21;808;1;5401;11;1.6;0.0
94;2021-01-22;724;0;6125;11;1.8;0.0
94;2021-01-23;243;0;6368;11;1.8;0.0
94;2021-01-24;147;0;6515;11;1.9;0.0
94;2021-01-25;422;2;6937;13;2.0;0.0
94;2021-01-26;790;7;7727;20;2.2;0.0
94;2021-01-27;663;55;8390;75;2.4;0.0
94;2021-01-28;699;230;9089;305;2.6;0.1
94;2021-01-29;620;229;9709;534;2.8;0.2
94;2021-01-30;204;74;9913;608;2.9;0.2
94;2021-01-31;150;12;10063;620;2.9;0.2
94;2021-02-01;459;147;10522;767;3.1;0.2
94;2021-02-02;643;196;11165;963;3.2;0.3
94;2021-02-03;783;167;11948;1130;3.5;0.3
94;2021-02-04;714;298;12662;1428;3.7;0.4
94;2021-02-05;647;201;13309;1629;3.9;0.5
94;2021-02-06;207;75;13516;1704;3.9;0.5
94;2021-02-07;126;58;13642;1762;4.0;0.5
94;2021-02-08;322;366;13964;2128;4.1;0.6
94;2021-02-09;713;616;14677;2744;4.3;0.8
94;2021-02-10;643;430;15320;3174;4.4;0.9
94;2021-02-11;678;497;15998;3671;4.6;1.1
94;2021-02-12;635;428;16633;4099;4.8;1.2
94;2021-02-13;301;72;16934;4171;4.9;1.2
94;2021-02-14;195;78;17129;4249;5.0;1.2
94;2021-02-15;380;310;17509;4559;5.1;1.3
94;2021-02-16;634;604;18143;5163;5.3;1.5
94;2021-02-17;592;482;18735;5645;5.4;1.6
94;2021-02-18;550;545;19285;6190;5.6;1.8
94;2021-02-19;309;610;19594;6800;5.7;2.0
94;2021-02-20;275;200;19869;7000;5.8;2.0
94;2021-02-21;84;84;19953;7084;5.8;2.1
94;2021-02-22;211;406;20164;7490;5.9;2.2
94;2021-02-23;352;648;20516;8138;6.0;2.4
94;2021-02-24;298;609;20814;8747;6.0;2.5
94;2021-02-25;348;608;21162;9355;6.1;2.7
94;2021-02-26;420;555;21582;9910;6.3;2.9
94;2021-02-27;368;152;21950;10062;6.4;2.9
94;2021-02-28;70;123;22020;10185;6.4;3.0
94;2021-03-01;360;413;22380;10598;6.5;3.1
94;2021-03-02;549;654;22929;11252;6.7;3.3
94;2021-03-03;530;692;23459;11944;6.8;3.5
94;2021-03-04;950;635;24409;12579;7.1;3.6
94;2021-03-05;1584;674;25993;13253;7.5;3.8
94;2021-03-06;1843;164;27836;13417;8.1;3.9
94;2021-03-07;1381;100;29217;13517;8.5;3.9
94;2021-03-08;1228;324;30445;13841;8.8;4.0
94;2021-03-09;1312;655;31757;14496;9.2;4.2
94;2021-03-10;1259;578;33016;15074;9.6;4.4
94;2021-03-11;1307;635;34323;15709;10.0;4.6
94;2021-03-12;1515;540;35838;16249;10.4;4.7
94;2021-03-13;1117;303;36955;16552;10.7;4.8
94;2021-03-14;537;184;37492;16736;10.9;4.9
94;2021-03-15;886;400;38378;17136;11.1;5.0
94;2021-03-16;1064;639;39442;17775;11.4;5.2
94;2021-03-17;1225;529;40667;18304;11.8;5.3
94;2021-03-18;994;530;41661;18834;12.1;5.5
94;2021-03-19;1284;341;42945;19175;12.5;5.6
94;2021-03-20;1730;288;44675;19463;13.0;5.6
94;2021-03-21;1126;83;45801;19546;13.3;5.7
94;2021-03-22;888;187;46689;19733;13.5;5.7
94;2021-03-23;1302;319;47991;20052;13.9;5.8
94;2021-03-24;1686;303;49677;20355;14.4;5.9
94;2021-03-25;1752;294;51429;20649;14.9;6.0
94;2021-03-26;2024;343;53453;20992;15.5;6.1
94;2021-03-27;2271;226;55724;21218;16.2;6.2
94;2021-03-28;1070;217;56794;21435;16.5;6.2
94;2021-03-29;1021;312;57815;21747;16.8;6.3
94;2021-03-30;1350;556;59165;22303;17.2;6.5
94;2021-03-31;1426;488;60591;22791;17.6;6.6
94;2021-04-01;1636;679;62227;23470;18.1;6.8
94;2021-04-02;1858;1189;64085;24659;18.6;7.2
94;2021-04-03;1890;1127;65975;25786;19.1;7.5
94;2021-04-04;770;842;66745;26628;19.4;7.7
94;2021-04-05;629;806;67374;27434;19.5;8.0
94;2021-04-06;1580;912;68954;28346;20.0;8.2
94;2021-04-07;2006;848;70960;29194;20.6;8.5
94;2021-04-08;2174;756;73134;29950;21.2;8.7
94;2021-04-09;2098;946;75232;30896;21.8;9.0
94;2021-04-10;2402;624;77634;31520;22.5;9.1
94;2021-04-11;1173;314;78807;31834;22.9;9.2
94;2021-04-12;1517;896;80324;32730;23.3;9.5
94;2021-04-13;1384;1007;81708;33737;23.7;9.8
94;2021-04-14;2084;1075;83792;34812;24.3;10.1
94;2021-04-15;1909;1027;85701;35839;24.9;10.4
94;2021-04-16;1775;1038;87476;36877;25.4;10.7
94;2021-04-17;1749;1373;89225;38250;25.9;11.1
94;2021-04-18;1232;1278;90457;39528;26.2;11.5
94;2021-04-19;1089;772;91546;40300;26.6;11.7
94;2021-04-20;1249;1191;92795;41491;26.9;12.0
94;2021-04-21;1780;1333;94575;42824;27.4;12.4
94;2021-04-22;1821;1372;96396;44196;28.0;12.8
94;2021-04-23;1645;1401;98041;45597;28.4;13.2
94;2021-04-24;2030;1742;100071;47339;29.0;13.7
94;2021-04-25;1260;775;101331;48114;29.4;14.0
94;2021-04-26;1015;1145;102346;49259;29.7;14.3
94;2021-04-27;1308;1216;103654;50475;30.1;14.6
94;2021-04-28;2588;1269;106242;51744;30.8;15.0
94;2021-04-29;1969;1220;108211;52964;31.4;15.4
94;2021-04-30;2262;1877;110473;54841;32.1;15.9
94;2021-05-01;1423;1686;111896;56527;32.5;16.4
94;2021-05-02;1005;947;112901;57474;32.8;16.7
94;2021-05-03;1597;1066;114498;58540;33.2;17.0
94;2021-05-04;1555;1684;116053;60224;33.7;17.5
94;2021-05-05;1805;2357;117858;62581;34.2;18.2
94;2021-05-06;2187;1810;120045;64391;34.8;18.7
94;2021-05-07;2209;1815;122254;66206;35.5;19.2
94;2021-05-08;872;1352;123126;67558;35.7;19.6
94;2021-05-09;1173;1317;124299;68875;36.1;20.0
94;2021-05-10;1371;1536;125670;70411;36.5;20.4
94;2021-05-11;1561;1573;127231;71984;36.9;20.9
94;2021-05-12;1745;1371;128976;73355;37.4;21.3
94;2021-05-13;1917;503;130893;73858;38.0;21.4
94;2021-05-14;1505;1252;132398;75110;38.4;21.8
94;2021-05-15;1450;993;133848;76103;38.8;22.1
94;2021-05-16;1004;666;134852;76769;39.1;22.3
94;2021-05-17;1573;965;136425;77734;39.6;22.6
94;2021-05-18;1546;854;137971;78588;40.0;22.8
94;2021-05-19;1530;892;139501;79480;40.5;23.1
94;2021-05-20;1334;886;140835;80366;40.9;23.3
94;2021-05-21;1202;977;142037;81343;41.2;23.6
94;2021-05-22;997;694;143034;82037;41.5;23.8
94;2021-05-23;681;328;143715;82365;41.7;23.9
94;2021-05-24;161;146;143876;82511;41.7;23.9
94;2021-05-25;945;856;144821;83367;42.0;24.2
94;2021-05-26;944;1953;145765;85320;42.3;24.8
94;2021-05-27;820;2240;146585;87560;42.5;25.4
94;2021-05-28;813;1820;147398;89380;42.8;25.9
94;2021-05-29;637;1252;148035;90632;42.9;26.3
94;2021-05-30;222;548;148257;91180;43.0;26.5
94;2021-05-31;547;1241;148804;92421;43.2;26.8
94;2021-06-01;731;1767;149535;94188;43.4;27.3
94;2021-06-02;610;1925;150145;96113;43.6;27.9
94;2021-06-03;773;1642;150918;97755;43.8;28.4
94;2021-06-04;601;2343;151519;100098;44.0;29.0
94;2021-06-05;552;1934;152071;102032;44.1;29.6
94;2021-06-06;213;1040;152284;103072;44.2;29.9
94;2021-06-07;437;1607;152721;104679;44.3;30.4
94;2021-06-08;741;1870;153462;106549;44.5;30.9
94;2021-06-09;799;2487;154261;109036;44.8;31.6
94;2021-06-10;669;1792;154930;110828;44.9;32.2
94;2021-06-11;693;2293;155623;113121;45.2;32.8
94;2021-06-12;346;1202;155969;114323;45.3;33.2
94;2021-06-13;202;854;156171;115177;45.3;33.4
94;2021-06-14;420;2036;156591;117213;45.4;34.0
94;2021-06-15;541;1723;157132;118936;45.6;34.5
94;2021-06-16;572;1711;157704;120647;45.8;35.0
94;2021-06-17;607;1632;158311;122279;45.9;35.5
94;2021-06-18;564;1868;158875;124147;46.1;36.0
94;2021-06-19;333;1014;159208;125161;46.2;36.3
94;2021-06-20;188;888;159396;126049;46.2;36.6
94;2021-06-21;417;1750;159813;127799;46.4;37.1
