reg;jour;n_dose1;n_complet;n_cum_dose1;n_cum_complet;couv_dose1;couv_complet
01;2020-12-27;0;0;0;0;0.0;0.0
01;2020-12-28;0;0;0;0;0.0;0.0
01;2020-12-29;0;0;0;0;0.0;0.0
01;2020-12-30;0;0;0;0;0.0;0.0
01;2020-12-31;0;0;0;0;0.0;0.0
01;2021-01-01;1;0;1;0;0.0;0.0
01;2021-01-02;0;0;1;0;0.0;0.0
01;2021-01-03;0;0;1;0;0.0;0.0
01;2021-01-04;1;0;2;0;0.0;0.0
01;2021-01-05;0;0;2;0;0.0;0.0
01;2021-01-06;1;0;3;0;0.0;0.0
01;2021-01-07;0;0;3;0;0.0;0.0
01;2021-01-08;48;0;51;0;0.0;0.0
01;2021-01-09;18;0;69;0;0.0;0.0
01;2021-01-10;0;0;69;0;0.0;0.0
01;2021-01-11;55;0;124;0;0.0;0.0
01;2021-01-12;40;0;164;0;0.0;0.0
01;2021-01-13;45;0;209;0;0.1;0.0
01;2021-01-14;60;0;269;0;0.1;0.0
01;2021-01-15;76;0;345;0;0.1;0.0
01;2021-01-16;0;0;345;0;0.1;0.0
01;2021-01-17;0;0;345;0;0.1;0.0
01;2021-01-18;75;0;420;0;0.1;0.0
01;2021-01-19;142;0;562;0;0.1;0.0
01;2021-01-20;134;0;696;0;0.2;0.0
01;2021-01-21;148;1;844;1;0.2;0.0
01;2021-01-22;131;0;975;1;0.3;0.0
01;2021-01-23;1;0;976;1;0.3;0.0
01;2021-01-24;0;0;976;1;0.3;0.0
01;2021-01-25;203;0;1179;1;0.3;0.0
01;2021-01-26;210;1;1389;2;0.4;0.0
01;2021-01-27;233;0;1622;2;0.4;0.0
01;2021-01-28;229;3;1851;5;0.5;0.0
01;2021-01-29;197;1;2048;6;0.5;0.0
01;2021-01-30;17;0;2065;6;0.5;0.0
01;2021-01-31;1;0;2066;6;0.5;0.0
01;2021-02-01;221;4;2287;10;0.6;0.0
01;2021-02-02;241;26;2528;36;0.7;0.0
01;2021-02-03;210;2;2738;38;0.7;0.0
01;2021-02-04;299;20;3037;58;0.8;0.0
01;2021-02-05;247;32;3284;90;0.9;0.0
01;2021-02-06;47;1;3331;91;0.9;0.0
01;2021-02-07;0;0;3331;91;0.9;0.0
01;2021-02-08;217;23;3548;114;0.9;0.0
01;2021-02-09;287;29;3835;143;1.0;0.0
01;2021-02-10;220;29;4055;172;1.1;0.0
01;2021-02-11;292;110;4347;282;1.2;0.1
01;2021-02-12;285;25;4632;307;1.2;0.1
01;2021-02-13;49;7;4681;314;1.2;0.1
01;2021-02-14;19;36;4700;350;1.2;0.1
01;2021-02-15;69;46;4769;396;1.3;0.1
01;2021-02-16;16;1;4785;397;1.3;0.1
01;2021-02-17;17;1;4802;398;1.3;0.1
01;2021-02-18;216;18;5018;416;1.3;0.1
01;2021-02-19;227;20;5245;436;1.4;0.1
01;2021-02-20;47;0;5292;436;1.4;0.1
01;2021-02-21;1;0;5293;436;1.4;0.1
01;2021-02-22;151;63;5444;499;1.4;0.1
01;2021-02-23;188;73;5632;572;1.5;0.2
01;2021-02-24;305;126;5937;698;1.6;0.2
01;2021-02-25;368;79;6305;777;1.7;0.2
01;2021-02-26;203;84;6508;861;1.7;0.2
01;2021-02-27;63;0;6571;861;1.7;0.2
01;2021-02-28;1;0;6572;861;1.7;0.2
01;2021-03-01;132;81;6704;942;1.8;0.2
01;2021-03-02;235;131;6939;1073;1.8;0.3
01;2021-03-03;207;120;7146;1193;1.9;0.3
01;2021-03-04;299;84;7445;1277;2.0;0.3
01;2021-03-05;321;143;7766;1420;2.1;0.4
01;2021-03-06;585;3;8351;1423;2.2;0.4
01;2021-03-07;1;0;8352;1423;2.2;0.4
01;2021-03-08;276;138;8628;1561;2.3;0.4
01;2021-03-09;351;150;8979;1711;2.4;0.5
01;2021-03-10;359;163;9338;1874;2.5;0.5
01;2021-03-11;119;45;9457;1919;2.5;0.5
01;2021-03-12;377;212;9834;2131;2.6;0.6
01;2021-03-13;130;2;9964;2133;2.6;0.6
01;2021-03-14;13;24;9977;2157;2.6;0.6
01;2021-03-15;404;44;10381;2201;2.8;0.6
01;2021-03-16;449;78;10830;2279;2.9;0.6
01;2021-03-17;413;84;11243;2363;3.0;0.6
01;2021-03-18;539;111;11782;2474;3.1;0.7
01;2021-03-19;521;99;12303;2573;3.3;0.7
01;2021-03-20;173;44;12476;2617;3.3;0.7
01;2021-03-21;8;0;12484;2617;3.3;0.7
01;2021-03-22;332;87;12816;2704;3.4;0.7
01;2021-03-23;482;156;13298;2860;3.5;0.8
01;2021-03-24;455;108;13753;2968;3.6;0.8
01;2021-03-25;727;178;14480;3146;3.8;0.8
01;2021-03-26;635;120;15115;3266;4.0;0.9
01;2021-03-27;265;49;15380;3315;4.1;0.9
01;2021-03-28;7;0;15387;3315;4.1;0.9
01;2021-03-29;358;82;15745;3397;4.2;0.9
01;2021-03-30;596;162;16341;3559;4.3;0.9
01;2021-03-31;517;129;16858;3688;4.5;1.0
01;2021-04-01;620;199;17478;3887;4.6;1.0
01;2021-04-02;38;35;17516;3922;4.6;1.0
01;2021-04-03;42;2;17558;3924;4.7;1.0
01;2021-04-04;4;18;17562;3942;4.7;1.0
01;2021-04-05;11;0;17573;3942;4.7;1.0
01;2021-04-06;426;189;17999;4131;4.8;1.1
01;2021-04-07;566;115;18565;4246;4.9;1.1
01;2021-04-08;481;160;19046;4406;5.1;1.2
01;2021-04-09;480;209;19526;4615;5.2;1.2
01;2021-04-10;97;4;19623;4619;5.2;1.2
01;2021-04-11;2;25;19625;4644;5.2;1.2
01;2021-04-12;284;257;19909;4901;5.3;1.3
01;2021-04-13;544;318;20453;5219;5.4;1.4
01;2021-04-14;421;221;20874;5440;5.5;1.4
01;2021-04-15;545;316;21419;5756;5.7;1.5
01;2021-04-16;546;268;21965;6024;5.8;1.6
01;2021-04-17;187;3;22152;6027;5.9;1.6
01;2021-04-18;4;14;22156;6041;5.9;1.6
01;2021-04-19;385;239;22541;6280;6.0;1.7
01;2021-04-20;709;343;23250;6623;6.2;1.8
01;2021-04-21;610;312;23860;6935;6.3;1.8
01;2021-04-22;799;330;24659;7265;6.5;1.9
01;2021-04-23;837;248;25496;7513;6.8;2.0
01;2021-04-24;336;75;25832;7588;6.9;2.0
01;2021-04-25;589;64;26421;7652;7.0;2.0
01;2021-04-26;937;212;27358;7864;7.3;2.1
01;2021-04-27;633;227;27991;8091;7.4;2.1
01;2021-04-28;833;264;28824;8355;7.6;2.2
01;2021-04-29;1193;190;30017;8545;8.0;2.3
01;2021-04-30;1257;170;31274;8715;8.3;2.3
01;2021-05-01;594;38;31868;8753;8.5;2.3
01;2021-05-02;342;17;32210;8770;8.5;2.3
01;2021-05-03;918;171;33128;8941;8.8;2.4
01;2021-05-04;945;198;34073;9139;9.0;2.4
01;2021-05-05;966;242;35039;9381;9.3;2.5
01;2021-05-06;1110;167;36149;9548;9.6;2.5
01;2021-05-07;1221;257;37370;9805;9.9;2.6
01;2021-05-08;314;33;37684;9838;10.0;2.6
01;2021-05-09;178;9;37862;9847;10.0;2.6
01;2021-05-10;829;209;38691;10056;10.3;2.7
01;2021-05-11;934;309;39625;10365;10.5;2.8
01;2021-05-12;892;321;40517;10686;10.8;2.8
01;2021-05-13;210;80;40727;10766;10.8;2.9
01;2021-05-14;857;270;41584;11036;11.0;2.9
01;2021-05-15;468;14;42052;11050;11.2;2.9
01;2021-05-16;182;35;42234;11085;11.2;2.9
01;2021-05-17;703;269;42937;11354;11.4;3.0
01;2021-05-18;702;388;43639;11742;11.6;3.1
01;2021-05-19;683;520;44322;12262;11.8;3.3
01;2021-05-20;763;365;45085;12627;12.0;3.4
01;2021-05-21;793;399;45878;13026;12.2;3.5
01;2021-05-22;476;217;46354;13243;12.3;3.5
01;2021-05-23;199;115;46553;13358;12.4;3.5
01;2021-05-24;198;175;46751;13533;12.4;3.6
01;2021-05-25;524;663;47275;14196;12.5;3.8
01;2021-05-26;559;493;47834;14689;12.7;3.9
01;2021-05-27;127;186;47961;14875;12.7;3.9
01;2021-05-28;506;524;48467;15399;12.9;4.1
01;2021-05-29;221;138;48688;15537;12.9;4.1
01;2021-05-30;72;111;48760;15648;12.9;4.2
01;2021-05-31;413;536;49173;16184;13.0;4.3
01;2021-06-01;526;712;49699;16896;13.2;4.5
01;2021-06-02;540;709;50239;17605;13.3;4.7
01;2021-06-03;474;561;50713;18166;13.5;4.8
01;2021-06-04;670;799;51383;18965;13.6;5.0
01;2021-06-05;296;645;51679;19610;13.7;5.2
01;2021-06-06;122;530;51801;20140;13.7;5.3
01;2021-06-07;324;783;52125;20923;13.8;5.6
01;2021-06-08;459;889;52584;21812;14.0;5.8
01;2021-06-09;402;857;52986;22669;14.1;6.0
01;2021-06-10;468;850;53454;23519;14.2;6.2
01;2021-06-11;444;1231;53898;24750;14.3;6.6
01;2021-06-12;290;660;54188;25410;14.4;6.7
01;2021-06-13;129;314;54317;25724;14.4;6.8
01;2021-06-14;350;3807;54667;29531;14.5;7.8
01;2021-06-15;445;2011;55112;31542;14.6;8.4
01;2021-06-16;447;1490;55559;33032;14.7;8.8
01;2021-06-17;413;1012;55972;34044;14.9;9.0
01;2021-06-18;451;1016;56423;35060;15.0;9.3
01;2021-06-19;294;508;56717;35568;15.0;9.4
01;2021-06-20;108;232;56825;35800;15.1;9.5
01;2021-06-21;315;681;57140;36481;15.2;9.7
01;2021-06-22;313;867;57453;37348;15.2;9.9
01;2021-06-23;343;891;57796;38239;15.3;10.1
01;2021-06-24;378;731;58174;38970;15.4;10.3
01;2021-06-25;433;763;58607;39733;15.6;10.5
01;2021-06-26;291;513;58898;40246;15.6;10.7
01;2021-06-27;106;169;59004;40415;15.7;10.7
01;2021-06-28;285;690;59289;41105;15.7;10.9
01;2021-06-29;348;763;59637;41868;15.8;11.1
02;2020-12-27;0;0;0;0;0.0;0.0
02;2020-12-28;0;0;0;0;0.0;0.0
02;2020-12-29;0;0;0;0;0.0;0.0
02;2020-12-30;0;0;0;0;0.0;0.0
02;2020-12-31;0;0;0;0;0.0;0.0
02;2021-01-01;0;0;0;0;0.0;0.0
02;2021-01-02;0;0;0;0;0.0;0.0
02;2021-01-03;0;0;0;0;0.0;0.0
02;2021-01-04;0;0;0;0;0.0;0.0
02;2021-01-05;0;0;0;0;0.0;0.0
02;2021-01-06;5;0;5;0;0.0;0.0
02;2021-01-07;31;0;36;0;0.0;0.0
02;2021-01-08;80;1;116;1;0.0;0.0
02;2021-01-09;20;0;136;1;0.0;0.0
02;2021-01-10;0;0;136;1;0.0;0.0
02;2021-01-11;122;0;258;1;0.1;0.0
02;2021-01-12;78;0;336;1;0.1;0.0
02;2021-01-13;64;0;400;1;0.1;0.0
02;2021-01-14;88;1;488;2;0.1;0.0
02;2021-01-15;136;0;624;2;0.2;0.0
02;2021-01-16;51;0;675;2;0.2;0.0
02;2021-01-17;0;0;675;2;0.2;0.0
02;2021-01-18;157;0;832;2;0.2;0.0
02;2021-01-19;168;1;1000;3;0.3;0.0
02;2021-01-20;163;0;1163;3;0.3;0.0
02;2021-01-21;181;1;1344;4;0.4;0.0
02;2021-01-22;156;0;1500;4;0.4;0.0
02;2021-01-23;58;0;1558;4;0.4;0.0
02;2021-01-24;0;0;1558;4;0.4;0.0
02;2021-01-25;160;0;1718;4;0.5;0.0
02;2021-01-26;137;0;1855;4;0.5;0.0
02;2021-01-27;161;5;2016;9;0.6;0.0
02;2021-01-28;143;12;2159;21;0.6;0.0
02;2021-01-29;142;41;2301;62;0.6;0.0
02;2021-01-30;96;16;2397;78;0.7;0.0
02;2021-01-31;0;0;2397;78;0.7;0.0
02;2021-02-01;119;74;2516;152;0.7;0.0
02;2021-02-02;184;96;2700;248;0.8;0.1
02;2021-02-03;130;80;2830;328;0.8;0.1
02;2021-02-04;158;73;2988;401;0.8;0.1
02;2021-02-05;120;97;3108;498;0.9;0.1
02;2021-02-06;62;26;3170;524;0.9;0.1
02;2021-02-07;1;0;3171;524;0.9;0.1
02;2021-02-08;137;80;3308;604;0.9;0.2
02;2021-02-09;175;78;3483;682;1.0;0.2
02;2021-02-10;138;90;3621;772;1.0;0.2
02;2021-02-11;150;103;3771;875;1.1;0.2
02;2021-02-12;124;130;3895;1005;1.1;0.3
02;2021-02-13;38;37;3933;1042;1.1;0.3
02;2021-02-14;0;0;3933;1042;1.1;0.3
02;2021-02-15;51;67;3984;1109;1.1;0.3
02;2021-02-16;0;1;3984;1110;1.1;0.3
02;2021-02-17;1;3;3985;1113;1.1;0.3
02;2021-02-18;69;127;4054;1240;1.1;0.3
02;2021-02-19;69;131;4123;1371;1.1;0.4
02;2021-02-20;48;69;4171;1440;1.2;0.4
02;2021-02-21;0;0;4171;1440;1.2;0.4
02;2021-02-22;102;60;4273;1500;1.2;0.4
02;2021-02-23;113;238;4386;1738;1.2;0.5
02;2021-02-24;106;223;4492;1961;1.3;0.5
02;2021-02-25;89;151;4581;2112;1.3;0.6
02;2021-02-26;126;169;4707;2281;1.3;0.6
02;2021-02-27;69;52;4776;2333;1.3;0.7
02;2021-02-28;0;0;4776;2333;1.3;0.7
02;2021-03-01;138;144;4914;2477;1.4;0.7
02;2021-03-02;158;78;5072;2555;1.4;0.7
02;2021-03-03;178;145;5250;2700;1.5;0.8
02;2021-03-04;145;135;5395;2835;1.5;0.8
02;2021-03-05;238;129;5633;2964;1.6;0.8
02;2021-03-06;119;59;5752;3023;1.6;0.8
02;2021-03-07;100;1;5852;3024;1.6;0.8
02;2021-03-08;197;132;6049;3156;1.7;0.9
02;2021-03-09;270;101;6319;3257;1.8;0.9
02;2021-03-10;324;134;6643;3391;1.9;0.9
02;2021-03-11;331;83;6974;3474;1.9;1.0
02;2021-03-12;398;53;7372;3527;2.1;1.0
02;2021-03-13;155;21;7527;3548;2.1;1.0
02;2021-03-14;4;1;7531;3549;2.1;1.0
02;2021-03-15;277;91;7808;3640;2.2;1.0
02;2021-03-16;305;55;8113;3695;2.3;1.0
02;2021-03-17;387;49;8500;3744;2.4;1.0
02;2021-03-18;435;44;8935;3788;2.5;1.1
02;2021-03-19;396;62;9331;3850;2.6;1.1
02;2021-03-20;149;48;9480;3898;2.6;1.1
02;2021-03-21;25;1;9505;3899;2.6;1.1
02;2021-03-22;362;117;9867;4016;2.8;1.1
02;2021-03-23;401;123;10268;4139;2.9;1.2
02;2021-03-24;427;104;10695;4243;3.0;1.2
02;2021-03-25;470;100;11165;4343;3.1;1.2
02;2021-03-26;633;99;11798;4442;3.3;1.2
02;2021-03-27;153;70;11951;4512;3.3;1.3
02;2021-03-28;81;2;12032;4514;3.4;1.3
02;2021-03-29;421;165;12453;4679;3.5;1.3
02;2021-03-30;468;244;12921;4923;3.6;1.4
02;2021-03-31;1143;187;14064;5110;3.9;1.4
02;2021-04-01;951;170;15015;5280;4.2;1.5
02;2021-04-02;895;8;15910;5288;4.4;1.5
02;2021-04-03;788;50;16698;5338;4.7;1.5
02;2021-04-04;750;10;17448;5348;4.9;1.5
02;2021-04-05;828;40;18276;5388;5.1;1.5
02;2021-04-06;884;133;19160;5521;5.3;1.5
02;2021-04-07;1434;325;20594;5846;5.7;1.6
02;2021-04-08;1303;267;21897;6113;6.1;1.7
02;2021-04-09;1239;317;23136;6430;6.4;1.8
02;2021-04-10;838;164;23974;6594;6.7;1.8
02;2021-04-11;621;12;24595;6606;6.9;1.8
02;2021-04-12;868;314;25463;6920;7.1;1.9
02;2021-04-13;868;325;26331;7245;7.3;2.0
02;2021-04-14;958;323;27289;7568;7.6;2.1
02;2021-04-15;958;294;28247;7862;7.9;2.2
02;2021-04-16;991;298;29238;8160;8.1;2.3
02;2021-04-17;528;161;29766;8321;8.3;2.3
02;2021-04-18;339;56;30105;8377;8.4;2.3
02;2021-04-19;669;346;30774;8723;8.6;2.4
02;2021-04-20;868;310;31642;9033;8.8;2.5
02;2021-04-21;999;358;32641;9391;9.1;2.6
02;2021-04-22;602;313;33243;9704;9.3;2.7
02;2021-04-23;605;466;33848;10170;9.4;2.8
02;2021-04-24;360;197;34208;10367;9.5;2.9
02;2021-04-25;168;200;34376;10567;9.6;2.9
02;2021-04-26;515;543;34891;11110;9.7;3.1
02;2021-04-27;559;609;35450;11719;9.9;3.3
02;2021-04-28;449;693;35899;12412;10.0;3.5
02;2021-04-29;653;642;36552;13054;10.2;3.6
02;2021-04-30;771;687;37323;13741;10.4;3.8
02;2021-05-01;243;246;37566;13987;10.5;3.9
02;2021-05-02;226;513;37792;14500;10.5;4.0
02;2021-05-03;569;772;38361;15272;10.7;4.3
02;2021-05-04;524;677;38885;15949;10.8;4.4
02;2021-05-05;543;896;39428;16845;11.0;4.7
02;2021-05-06;546;783;39974;17628;11.1;4.9
02;2021-05-07;629;1016;40603;18644;11.3;5.2
02;2021-05-08;224;526;40827;19170;11.4;5.3
02;2021-05-09;174;506;41001;19676;11.4;5.5
02;2021-05-10;521;859;41522;20535;11.6;5.7
02;2021-05-11;479;873;42001;21408;11.7;6.0
02;2021-05-12;558;912;42559;22320;11.9;6.2
02;2021-05-13;272;534;42831;22854;11.9;6.4
02;2021-05-14;389;752;43220;23606;12.0;6.6
02;2021-05-15;235;580;43455;24186;12.1;6.7
02;2021-05-16;155;442;43610;24628;12.2;6.9
02;2021-05-17;474;754;44084;25382;12.3;7.1
02;2021-05-18;446;678;44530;26060;12.4;7.3
02;2021-05-19;446;742;44976;26802;12.5;7.5
02;2021-05-20;590;500;45566;27302;12.7;7.6
02;2021-05-21;545;705;46111;28007;12.9;7.8
02;2021-05-22;184;365;46295;28372;12.9;7.9
02;2021-05-23;110;181;46405;28553;12.9;8.0
02;2021-05-24;135;241;46540;28794;13.0;8.0
02;2021-05-25;356;699;46896;29493;13.1;8.2
02;2021-05-26;380;710;47276;30203;13.2;8.4
02;2021-05-27;267;644;47543;30847;13.3;8.6
02;2021-05-28;276;817;47819;31664;13.3;8.8
02;2021-05-29;151;510;47970;32174;13.4;9.0
02;2021-05-30;16;33;47986;32207;13.4;9.0
02;2021-05-31;346;682;48332;32889;13.5;9.2
02;2021-06-01;292;546;48624;33435;13.6;9.3
02;2021-06-02;318;574;48942;34009;13.6;9.5
02;2021-06-03;247;431;49189;34440;13.7;9.6
02;2021-06-04;348;652;49537;35092;13.8;9.8
02;2021-06-05;235;362;49772;35454;13.9;9.9
02;2021-06-06;21;31;49793;35485;13.9;9.9
02;2021-06-07;258;741;50051;36226;14.0;10.1
02;2021-06-08;253;591;50304;36817;14.0;10.3
02;2021-06-09;296;704;50600;37521;14.1;10.5
02;2021-06-10;300;454;50900;37975;14.2;10.6
02;2021-06-11;336;544;51236;38519;14.3;10.7
02;2021-06-12;244;323;51480;38842;14.3;10.8
02;2021-06-13;32;29;51512;38871;14.4;10.8
02;2021-06-14;366;553;51878;39424;14.5;11.0
02;2021-06-15;407;494;52285;39918;14.6;11.1
02;2021-06-16;412;444;52697;40362;14.7;11.3
02;2021-06-17;347;578;53044;40940;14.8;11.4
02;2021-06-18;420;542;53464;41482;14.9;11.6
02;2021-06-19;225;196;53689;41678;15.0;11.6
02;2021-06-20;25;17;53714;41695;15.0;11.6
02;2021-06-21;320;578;54034;42273;15.1;11.8
02;2021-06-22;291;464;54325;42737;15.1;11.9
02;2021-06-23;408;562;54733;43299;15.3;12.1
02;2021-06-24;316;432;55049;43731;15.3;12.2
02;2021-06-25;309;388;55358;44119;15.4;12.3
02;2021-06-26;195;199;55553;44318;15.5;12.4
02;2021-06-27;15;23;55568;44341;15.5;12.4
02;2021-06-28;301;420;55869;44761;15.6;12.5
02;2021-06-29;304;417;56173;45178;15.7;12.6
03;2020-12-27;0;0;0;0;0.0;0.0
03;2020-12-28;0;0;0;0;0.0;0.0
03;2020-12-29;0;0;0;0;0.0;0.0
03;2020-12-30;0;0;0;0;0.0;0.0
03;2020-12-31;0;0;0;0;0.0;0.0
03;2021-01-01;0;0;0;0;0.0;0.0
03;2021-01-02;2;2;2;2;0.0;0.0
03;2021-01-03;0;0;2;2;0.0;0.0
03;2021-01-04;0;0;2;2;0.0;0.0
03;2021-01-05;0;0;2;2;0.0;0.0
03;2021-01-06;0;0;2;2;0.0;0.0
03;2021-01-07;0;0;2;2;0.0;0.0
03;2021-01-08;0;0;2;2;0.0;0.0
03;2021-01-09;0;0;2;2;0.0;0.0
03;2021-01-10;0;0;2;2;0.0;0.0
03;2021-01-11;0;0;2;2;0.0;0.0
03;2021-01-12;0;0;2;2;0.0;0.0
03;2021-01-13;30;0;32;2;0.0;0.0
03;2021-01-14;46;0;78;2;0.0;0.0
03;2021-01-15;35;0;113;2;0.0;0.0
03;2021-01-16;18;0;131;2;0.0;0.0
03;2021-01-17;0;0;131;2;0.0;0.0
03;2021-01-18;63;0;194;2;0.1;0.0
03;2021-01-19;149;1;343;3;0.1;0.0
03;2021-01-20;132;0;475;3;0.2;0.0
03;2021-01-21;118;0;593;3;0.2;0.0
03;2021-01-22;76;0;669;3;0.2;0.0
03;2021-01-23;0;0;669;3;0.2;0.0
03;2021-01-24;0;0;669;3;0.2;0.0
03;2021-01-25;56;0;725;3;0.2;0.0
03;2021-01-26;100;0;825;3;0.3;0.0
03;2021-01-27;109;1;934;4;0.3;0.0
03;2021-01-28;96;2;1030;6;0.4;0.0
03;2021-01-29;104;3;1134;9;0.4;0.0
03;2021-01-30;0;0;1134;9;0.4;0.0
03;2021-01-31;0;0;1134;9;0.4;0.0
03;2021-02-01;54;0;1188;9;0.4;0.0
03;2021-02-02;122;4;1310;13;0.5;0.0
03;2021-02-03;116;7;1426;20;0.5;0.0
03;2021-02-04;79;26;1505;46;0.5;0.0
03;2021-02-05;65;8;1570;54;0.5;0.0
03;2021-02-06;0;0;1570;54;0.5;0.0
03;2021-02-07;0;0;1570;54;0.5;0.0
03;2021-02-08;52;13;1622;67;0.6;0.0
03;2021-02-09;92;39;1714;106;0.6;0.0
03;2021-02-10;101;42;1815;148;0.6;0.1
03;2021-02-11;105;93;1920;241;0.7;0.1
03;2021-02-12;87;65;2007;306;0.7;0.1
03;2021-02-13;0;0;2007;306;0.7;0.1
03;2021-02-14;0;0;2007;306;0.7;0.1
03;2021-02-15;27;65;2034;371;0.7;0.1
03;2021-02-16;123;54;2157;425;0.7;0.1
03;2021-02-17;145;120;2302;545;0.8;0.2
03;2021-02-18;102;143;2404;688;0.8;0.2
03;2021-02-19;121;72;2525;760;0.9;0.3
03;2021-02-20;0;0;2525;760;0.9;0.3
03;2021-02-21;0;0;2525;760;0.9;0.3
03;2021-02-22;78;49;2603;809;0.9;0.3
03;2021-02-23;158;100;2761;909;0.9;0.3
03;2021-02-24;190;120;2951;1029;1.0;0.4
03;2021-02-25;258;87;3209;1116;1.1;0.4
03;2021-02-26;264;69;3473;1185;1.2;0.4
03;2021-02-27;121;1;3594;1186;1.2;0.4
03;2021-02-28;0;0;3594;1186;1.2;0.4
03;2021-03-01;180;85;3774;1271;1.3;0.4
03;2021-03-02;255;108;4029;1379;1.4;0.5
03;2021-03-03;255;131;4284;1510;1.5;0.5
03;2021-03-04;281;81;4565;1591;1.6;0.5
03;2021-03-05;270;44;4835;1635;1.7;0.6
03;2021-03-06;116;1;4951;1636;1.7;0.6
03;2021-03-07;0;0;4951;1636;1.7;0.6
03;2021-03-08;189;40;5140;1676;1.8;0.6
03;2021-03-09;349;91;5489;1767;1.9;0.6
03;2021-03-10;357;100;5846;1867;2.0;0.6
03;2021-03-11;270;120;6116;1987;2.1;0.7
03;2021-03-12;286;92;6402;2079;2.2;0.7
03;2021-03-13;110;2;6512;2081;2.2;0.7
03;2021-03-14;0;0;6512;2081;2.2;0.7
03;2021-03-15;180;26;6692;2107;2.3;0.7
03;2021-03-16;241;139;6933;2246;2.4;0.8
03;2021-03-17;273;128;7206;2374;2.5;0.8
03;2021-03-18;250;153;7456;2527;2.6;0.9
03;2021-03-19;284;126;7740;2653;2.7;0.9
03;2021-03-20;255;14;7995;2667;2.8;0.9
03;2021-03-21;119;0;8114;2667;2.8;0.9
03;2021-03-22;219;112;8333;2779;2.9;1.0
03;2021-03-23;261;186;8594;2965;3.0;1.0
03;2021-03-24;225;209;8819;3174;3.0;1.1
03;2021-03-25;167;176;8986;3350;3.1;1.2
03;2021-03-26;189;307;9175;3657;3.2;1.3
03;2021-03-27;56;93;9231;3750;3.2;1.3
03;2021-03-28;0;0;9231;3750;3.2;1.3
03;2021-03-29;175;245;9406;3995;3.2;1.4
03;2021-03-30;446;235;9852;4230;3.4;1.5
03;2021-03-31;318;291;10170;4521;3.5;1.6
03;2021-04-01;445;261;10615;4782;3.7;1.6
03;2021-04-02;306;279;10921;5061;3.8;1.7
03;2021-04-03;151;122;11072;5183;3.8;1.8
03;2021-04-04;0;0;11072;5183;3.8;1.8
03;2021-04-05;118;14;11190;5197;3.8;1.8
03;2021-04-06;439;331;11629;5528;4.0;1.9
03;2021-04-07;501;341;12130;5869;4.2;2.0
03;2021-04-08;510;263;12640;6132;4.3;2.1
03;2021-04-09;493;225;13133;6357;4.5;2.2
03;2021-04-10;146;91;13279;6448;4.6;2.2
03;2021-04-11;2;0;13281;6448;4.6;2.2
03;2021-04-12;552;269;13833;6717;4.8;2.3
03;2021-04-13;671;241;14504;6958;5.0;2.4
03;2021-04-14;718;310;15222;7268;5.2;2.5
03;2021-04-15;770;242;15992;7510;5.5;2.6
03;2021-04-16;748;297;16740;7807;5.8;2.7
03;2021-04-17;495;128;17235;7935;5.9;2.7
03;2021-04-18;499;39;17734;7974;6.1;2.7
03;2021-04-19;712;249;18446;8223;6.3;2.8
03;2021-04-20;604;276;19050;8499;6.6;2.9
03;2021-04-21;801;237;19851;8736;6.8;3.0
03;2021-04-22;656;216;20507;8952;7.1;3.1
03;2021-04-23;663;220;21170;9172;7.3;3.2
03;2021-04-24;524;95;21694;9267;7.5;3.2
03;2021-04-25;602;42;22296;9309;7.7;3.2
03;2021-04-26;735;223;23031;9532;7.9;3.3
03;2021-04-27;766;337;23797;9869;8.2;3.4
03;2021-04-28;684;324;24481;10193;8.4;3.5
03;2021-04-29;625;277;25106;10470;8.6;3.6
03;2021-04-30;672;252;25778;10722;8.9;3.7
03;2021-05-01;209;26;25987;10748;8.9;3.7
03;2021-05-02;594;76;26581;10824;9.1;3.7
03;2021-05-03;554;390;27135;11214;9.3;3.9
03;2021-05-04;614;312;27749;11526;9.5;4.0
03;2021-05-05;654;445;28403;11971;9.8;4.1
03;2021-05-06;624;461;29027;12432;10.0;4.3
03;2021-05-07;540;462;29567;12894;10.2;4.4
03;2021-05-08;341;57;29908;12951;10.3;4.5
03;2021-05-09;262;73;30170;13024;10.4;4.5
03;2021-05-10;418;612;30588;13636;10.5;4.7
03;2021-05-11;376;491;30964;14127;10.7;4.9
03;2021-05-12;482;641;31446;14768;10.8;5.1
03;2021-05-13;332;98;31778;14866;10.9;5.1
03;2021-05-14;471;549;32249;15415;11.1;5.3
03;2021-05-15;253;345;32502;15760;11.2;5.4
03;2021-05-16;207;210;32709;15970;11.3;5.5
03;2021-05-17;443;600;33152;16570;11.4;5.7
03;2021-05-18;559;563;33711;17133;11.6;5.9
03;2021-05-19;511;548;34222;17681;11.8;6.1
03;2021-05-20;612;444;34834;18125;12.0;6.2
03;2021-05-21;483;601;35317;18726;12.1;6.4
03;2021-05-22;168;501;35485;19227;12.2;6.6
03;2021-05-23;268;474;35753;19701;12.3;6.8
03;2021-05-24;560;245;36313;19946;12.5;6.9
03;2021-05-25;495;740;36808;20686;12.7;7.1
03;2021-05-26;415;681;37223;21367;12.8;7.4
03;2021-05-27;663;515;37886;21882;13.0;7.5
03;2021-05-28;490;549;38376;22431;13.2;7.7
03;2021-05-29;238;361;38614;22792;13.3;7.8
03;2021-05-30;150;401;38764;23193;13.3;8.0
03;2021-05-31;338;573;39102;23766;13.5;8.2
03;2021-06-01;398;463;39500;24229;13.6;8.3
03;2021-06-02;503;549;40003;24778;13.8;8.5
03;2021-06-03;414;466;40417;25244;13.9;8.7
03;2021-06-04;523;489;40940;25733;14.1;8.9
03;2021-06-05;269;293;41209;26026;14.2;9.0
03;2021-06-06;208;299;41417;26325;14.2;9.1
03;2021-06-07;459;448;41876;26773;14.4;9.2
03;2021-06-08;512;313;42388;27086;14.6;9.3
03;2021-06-09;480;379;42868;27465;14.7;9.4
03;2021-06-10;344;290;43212;27755;14.9;9.5
03;2021-06-11;389;468;43601;28223;15.0;9.7
03;2021-06-12;162;285;43763;28508;15.1;9.8
03;2021-06-13;200;267;43963;28775;15.1;9.9
03;2021-06-14;350;547;44313;29322;15.2;10.1
03;2021-06-15;355;439;44668;29761;15.4;10.2
03;2021-06-16;389;449;45057;30210;15.5;10.4
03;2021-06-17;364;575;45421;30785;15.6;10.6
03;2021-06-18;335;561;45756;31346;15.7;10.8
03;2021-06-19;230;259;45986;31605;15.8;10.9
03;2021-06-20;123;272;46109;31877;15.9;11.0
03;2021-06-21;264;597;46373;32474;16.0;11.2
03;2021-06-22;306;456;46679;32930;16.1;11.3
03;2021-06-23;271;530;46950;33460;16.2;11.5
03;2021-06-24;343;494;47293;33954;16.3;11.7
03;2021-06-25;361;544;47654;34498;16.4;11.9
03;2021-06-26;164;322;47818;34820;16.4;12.0
03;2021-06-27;117;170;47935;34990;16.5;12.0
03;2021-06-28;280;588;48215;35578;16.6;12.2
03;2021-06-29;329;496;48544;36074;16.7;12.4
04;2020-12-27;0;0;0;0;0.0;0.0
04;2020-12-28;0;0;0;0;0.0;0.0
04;2020-12-29;0;0;0;0;0.0;0.0
04;2020-12-30;0;0;0;0;0.0;0.0
04;2020-12-31;0;0;0;0;0.0;0.0
04;2021-01-01;1;0;1;0;0.0;0.0
04;2021-01-02;0;0;1;0;0.0;0.0
04;2021-01-03;0;0;1;0;0.0;0.0
04;2021-01-04;0;0;1;0;0.0;0.0
04;2021-01-05;2;0;3;0;0.0;0.0
04;2021-01-06;0;0;3;0;0.0;0.0
04;2021-01-07;0;0;3;0;0.0;0.0
04;2021-01-08;0;0;3;0;0.0;0.0
04;2021-01-09;1;0;4;0;0.0;0.0
04;2021-01-10;0;0;4;0;0.0;0.0
04;2021-01-11;0;0;4;0;0.0;0.0
04;2021-01-12;0;0;4;0;0.0;0.0
04;2021-01-13;0;0;4;0;0.0;0.0
04;2021-01-14;0;0;4;0;0.0;0.0
04;2021-01-15;332;0;336;0;0.0;0.0
04;2021-01-16;27;0;363;0;0.0;0.0
04;2021-01-17;0;0;363;0;0.0;0.0
04;2021-01-18;49;1;412;1;0.0;0.0
04;2021-01-19;393;0;805;1;0.1;0.0
04;2021-01-20;482;1;1287;2;0.1;0.0
04;2021-01-21;614;1;1901;3;0.2;0.0
04;2021-01-22;409;1;2310;4;0.3;0.0
04;2021-01-23;75;0;2385;4;0.3;0.0
04;2021-01-24;0;0;2385;4;0.3;0.0
04;2021-01-25;272;0;2657;4;0.3;0.0
04;2021-01-26;429;0;3086;4;0.4;0.0
04;2021-01-27;317;0;3403;4;0.4;0.0
04;2021-01-28;406;0;3809;4;0.4;0.0
04;2021-01-29;421;3;4230;7;0.5;0.0
04;2021-01-30;419;0;4649;7;0.5;0.0
04;2021-01-31;0;0;4649;7;0.5;0.0
04;2021-02-01;372;3;5021;10;0.6;0.0
04;2021-02-02;499;4;5520;14;0.6;0.0
04;2021-02-03;602;14;6122;28;0.7;0.0
04;2021-02-04;626;22;6748;50;0.8;0.0
04;2021-02-05;564;98;7312;148;0.9;0.0
04;2021-02-06;501;4;7813;152;0.9;0.0
04;2021-02-07;0;8;7813;160;0.9;0.0
04;2021-02-08;472;34;8285;194;1.0;0.0
04;2021-02-09;783;90;9068;284;1.1;0.0
04;2021-02-10;820;85;9888;369;1.1;0.0
04;2021-02-11;796;86;10684;455;1.2;0.1
04;2021-02-12;637;95;11321;550;1.3;0.1
04;2021-02-13;651;74;11972;624;1.4;0.1
04;2021-02-14;1;0;11973;624;1.4;0.1
04;2021-02-15;524;126;12497;750;1.5;0.1
04;2021-02-16;651;534;13148;1284;1.5;0.1
04;2021-02-17;592;329;13740;1613;1.6;0.2
04;2021-02-18;493;414;14233;2027;1.7;0.2
04;2021-02-19;496;321;14729;2348;1.7;0.3
04;2021-02-20;576;117;15305;2465;1.8;0.3
04;2021-02-21;0;0;15305;2465;1.8;0.3
04;2021-02-22;401;238;15706;2703;1.8;0.3
04;2021-02-23;607;238;16313;2941;1.9;0.3
04;2021-02-24;583;255;16896;3196;2.0;0.4
04;2021-02-25;646;297;17542;3493;2.0;0.4
04;2021-02-26;483;473;18025;3966;2.1;0.5
04;2021-02-27;386;472;18411;4438;2.1;0.5
04;2021-02-28;0;0;18411;4438;2.1;0.5
04;2021-03-01;291;390;18702;4828;2.2;0.6
04;2021-03-02;487;504;19189;5332;2.2;0.6
04;2021-03-03;758;556;19947;5888;2.3;0.7
04;2021-03-04;777;541;20724;6429;2.4;0.7
04;2021-03-05;729;540;21453;6969;2.5;0.8
04;2021-03-06;813;529;22266;7498;2.6;0.9
04;2021-03-07;0;0;22266;7498;2.6;0.9
04;2021-03-08;443;585;22709;8083;2.6;0.9
04;2021-03-09;676;771;23385;8854;2.7;1.0
04;2021-03-10;648;847;24033;9701;2.8;1.1
04;2021-03-11;701;646;24734;10347;2.9;1.2
04;2021-03-12;731;664;25465;11011;3.0;1.3
04;2021-03-13;670;609;26135;11620;3.0;1.4
04;2021-03-14;2;0;26137;11620;3.0;1.4
04;2021-03-15;505;506;26642;12126;3.1;1.4
04;2021-03-16;681;709;27323;12835;3.2;1.5
04;2021-03-17;849;537;28172;13372;3.3;1.6
04;2021-03-18;1021;556;29193;13928;3.4;1.6
04;2021-03-19;789;538;29982;14466;3.5;1.7
04;2021-03-20;579;597;30561;15063;3.6;1.8
04;2021-03-21;0;0;30561;15063;3.6;1.8
04;2021-03-22;565;482;31126;15545;3.6;1.8
04;2021-03-23;780;640;31906;16185;3.7;1.9
04;2021-03-24;793;670;32699;16855;3.8;2.0
04;2021-03-25;930;554;33629;17409;3.9;2.0
04;2021-03-26;921;450;34550;17859;4.0;2.1
04;2021-03-27;783;339;35333;18198;4.1;2.1
04;2021-03-28;1;0;35334;18198;4.1;2.1
04;2021-03-29;962;271;36296;18469;4.2;2.1
04;2021-03-30;886;500;37182;18969;4.3;2.2
04;2021-03-31;744;670;37926;19639;4.4;2.3
04;2021-04-01;718;707;38644;20346;4.5;2.4
04;2021-04-02;688;761;39332;21107;4.6;2.5
04;2021-04-03;699;706;40031;21813;4.7;2.5
04;2021-04-04;0;0;40031;21813;4.7;2.5
04;2021-04-05;0;2;40031;21815;4.7;2.5
04;2021-04-06;799;640;40830;22455;4.7;2.6
04;2021-04-07;1369;789;42199;23244;4.9;2.7
04;2021-04-08;1794;778;43993;24022;5.1;2.8
04;2021-04-09;1509;786;45502;24808;5.3;2.9
04;2021-04-10;1137;651;46639;25459;5.4;3.0
04;2021-04-11;2;0;46641;25459;5.4;3.0
04;2021-04-12;1242;550;47883;26009;5.6;3.0
04;2021-04-13;1438;754;49321;26763;5.7;3.1
04;2021-04-14;2070;777;51391;27540;6.0;3.2
04;2021-04-15;2507;954;53898;28494;6.3;3.3
04;2021-04-16;1932;785;55830;29279;6.5;3.4
04;2021-04-17;1289;604;57119;29883;6.6;3.5
04;2021-04-18;0;0;57119;29883;6.6;3.5
04;2021-04-19;1378;564;58497;30447;6.8;3.5
04;2021-04-20;1650;806;60147;31253;7.0;3.6
04;2021-04-21;2129;606;62276;31859;7.2;3.7
04;2021-04-22;2949;803;65225;32662;7.6;3.8
04;2021-04-23;2310;814;67535;33476;7.9;3.9
04;2021-04-24;1102;798;68637;34274;8.0;4.0
04;2021-04-25;2;0;68639;34274;8.0;4.0
04;2021-04-26;1167;920;69806;35194;8.1;4.1
04;2021-04-27;1681;1027;71487;36221;8.3;4.2
04;2021-04-28;2900;751;74387;36972;8.7;4.3
04;2021-04-29;3946;812;78333;37784;9.1;4.4
04;2021-04-30;3437;902;81770;38686;9.5;4.5
04;2021-05-01;2107;220;83877;38906;9.8;4.5
04;2021-05-02;2;0;83879;38906;9.8;4.5
04;2021-05-03;1866;571;85745;39477;10.0;4.6
04;2021-05-04;2128;1095;87873;40572;10.2;4.7
04;2021-05-05;3120;1639;90993;42211;10.6;4.9
04;2021-05-06;4005;1589;94998;43800;11.0;5.1
04;2021-05-07;3232;1524;98230;45324;11.4;5.3
04;2021-05-08;1567;502;99797;45826;11.6;5.3
04;2021-05-09;1;0;99798;45826;11.6;5.3
04;2021-05-10;2416;992;102214;46818;11.9;5.4
04;2021-05-11;3651;1639;105865;48457;12.3;5.6
04;2021-05-12;4723;2394;110588;50851;12.9;5.9
04;2021-05-13;3562;585;114150;51436;13.3;6.0
04;2021-05-14;5269;2511;119419;53947;13.9;6.3
04;2021-05-15;3164;1537;122583;55484;14.3;6.5
04;2021-05-16;15;18;122598;55502;14.3;6.5
04;2021-05-17;3010;1478;125608;56980;14.6;6.6
04;2021-05-18;3761;1779;129369;58759;15.0;6.8
04;2021-05-19;4686;2332;134055;61091;15.6;7.1
04;2021-05-20;5148;2803;139203;63894;16.2;7.4
04;2021-05-21;4994;2635;144197;66529;16.8;7.7
04;2021-05-22;3369;1251;147566;67780;17.2;7.9
04;2021-05-23;5;3;147571;67783;17.2;7.9
04;2021-05-24;3651;1075;151222;68858;17.6;8.0
04;2021-05-25;4256;1908;155478;70766;18.1;8.2
04;2021-05-26;4984;2966;160462;73732;18.7;8.6
04;2021-05-27;4608;4089;165070;77821;19.2;9.0
04;2021-05-28;4385;3820;169455;81641;19.7;9.5
04;2021-05-29;2558;2455;172013;84096;20.0;9.8
04;2021-05-30;7;14;172020;84110;20.0;9.8
04;2021-05-31;2357;2250;174377;86360;20.3;10.0
04;2021-06-01;3297;2719;177674;89079;20.7;10.4
04;2021-06-02;3928;3352;181602;92431;21.1;10.7
04;2021-06-03;4017;3664;185619;96095;21.6;11.2
04;2021-06-04;3824;3752;189443;99847;22.0;11.6
04;2021-06-05;2197;1923;191640;101770;22.3;11.8
04;2021-06-06;1061;128;192701;101898;22.4;11.8
04;2021-06-07;2004;2530;194705;104428;22.6;12.1
04;2021-06-08;2518;3320;197223;107748;22.9;12.5
04;2021-06-09;2946;4771;200169;112519;23.3;13.1
04;2021-06-10;3342;4448;203511;116967;23.7;13.6
04;2021-06-11;2833;4620;206344;121587;24.0;14.1
04;2021-06-12;1711;3378;208055;124965;24.2;14.5
04;2021-06-13;1312;243;209367;125208;24.3;14.6
04;2021-06-14;1483;3179;210850;128387;24.5;14.9
04;2021-06-15;2041;3615;212891;132002;24.8;15.3
04;2021-06-16;2718;4650;215609;136652;25.1;15.9
04;2021-06-17;2503;4899;218112;141551;25.4;16.5
04;2021-06-18;2564;4901;220676;146452;25.7;17.0
04;2021-06-19;1296;3515;221972;149967;25.8;17.4
04;2021-06-20;625;286;222597;150253;25.9;17.5
04;2021-06-21;1262;3233;223859;153486;26.0;17.8
04;2021-06-22;1607;3747;225466;157233;26.2;18.3
04;2021-06-23;2222;4961;227688;162194;26.5;18.9
04;2021-06-24;2265;4063;229953;166257;26.7;19.3
04;2021-06-25;2168;4100;232121;170357;27.0;19.8
04;2021-06-26;1394;2706;233515;173063;27.2;20.1
04;2021-06-27;651;258;234166;173321;27.2;20.2
04;2021-06-28;1299;2480;235465;175801;27.4;20.4
04;2021-06-29;1687;2807;237152;178608;27.6;20.8
05;2020-12-27;0;0;0;0;0.0;0.0
05;2020-12-28;0;0;0;0;0.0;0.0
05;2020-12-29;0;0;0;0;0.0;0.0
05;2020-12-30;0;0;0;0;0.0;0.0
05;2020-12-31;0;0;0;0;0.0;0.0
05;2021-01-01;0;0;0;0;0.0;0.0
05;2021-01-02;0;0;0;0;0.0;0.0
05;2021-01-03;0;0;0;0;0.0;0.0
05;2021-01-04;0;0;0;0;0.0;0.0
05;2021-01-05;0;0;0;0;0.0;0.0
05;2021-01-06;0;0;0;0;0.0;0.0
05;2021-01-07;0;0;0;0;0.0;0.0
05;2021-01-08;0;0;0;0;0.0;0.0
05;2021-01-09;0;0;0;0;0.0;0.0
05;2021-01-10;0;0;0;0;0.0;0.0
05;2021-01-11;0;0;0;0;0.0;0.0
05;2021-01-12;0;0;0;0;0.0;0.0
05;2021-01-13;0;0;0;0;0.0;0.0
05;2021-01-14;0;0;0;0;0.0;0.0
05;2021-01-15;0;0;0;0;0.0;0.0
05;2021-01-16;0;0;0;0;0.0;0.0
05;2021-01-17;0;0;0;0;0.0;0.0
05;2021-01-18;0;0;0;0;0.0;0.0
05;2021-01-19;0;0;0;0;0.0;0.0
05;2021-01-20;0;0;0;0;0.0;0.0
05;2021-01-21;0;0;0;0;0.0;0.0
05;2021-01-22;0;0;0;0;0.0;0.0
05;2021-01-23;0;0;0;0;0.0;0.0
05;2021-01-24;0;0;0;0;0.0;0.0
05;2021-01-25;0;0;0;0;0.0;0.0
05;2021-01-26;0;0;0;0;0.0;0.0
05;2021-01-27;0;0;0;0;0.0;0.0
05;2021-01-28;0;0;0;0;0.0;0.0
05;2021-01-29;0;0;0;0;0.0;0.0
05;2021-01-30;0;0;0;0;0.0;0.0
05;2021-01-31;0;0;0;0;0.0;0.0
05;2021-02-01;0;0;0;0;0.0;0.0
05;2021-02-02;0;0;0;0;0.0;0.0
05;2021-02-03;0;0;0;0;0.0;0.0
05;2021-02-04;0;0;0;0;0.0;0.0
05;2021-02-05;0;0;0;0;0.0;0.0
05;2021-02-06;0;0;0;0;0.0;0.0
05;2021-02-07;0;0;0;0;0.0;0.0
05;2021-02-08;0;0;0;0;0.0;0.0
05;2021-02-09;0;0;0;0;0.0;0.0
05;2021-02-10;0;0;0;0;0.0;0.0
05;2021-02-11;0;0;0;0;0.0;0.0
05;2021-02-12;0;0;0;0;0.0;0.0
05;2021-02-13;0;0;0;0;0.0;0.0
05;2021-02-14;0;0;0;0;0.0;0.0
05;2021-02-15;0;0;0;0;0.0;0.0
05;2021-02-16;0;0;0;0;0.0;0.0
05;2021-02-17;0;0;0;0;0.0;0.0
05;2021-02-18;0;0;0;0;0.0;0.0
05;2021-02-19;0;0;0;0;0.0;0.0
05;2021-02-20;0;0;0;0;0.0;0.0
05;2021-02-21;0;0;0;0;0.0;0.0
05;2021-02-22;0;0;0;0;0.0;0.0
05;2021-02-23;0;0;0;0;0.0;0.0
05;2021-02-24;0;0;0;0;0.0;0.0
05;2021-02-25;0;0;0;0;0.0;0.0
05;2021-02-26;0;0;0;0;0.0;0.0
05;2021-02-27;0;0;0;0;0.0;0.0
05;2021-02-28;0;0;0;0;0.0;0.0
05;2021-03-01;0;0;0;0;0.0;0.0
05;2021-03-02;0;0;0;0;0.0;0.0
05;2021-03-03;0;0;0;0;0.0;0.0
05;2021-03-04;0;0;0;0;0.0;0.0
05;2021-03-05;0;0;0;0;0.0;0.0
05;2021-03-06;0;0;0;0;0.0;0.0
05;2021-03-07;0;0;0;0;0.0;0.0
05;2021-03-08;0;0;0;0;0.0;0.0
05;2021-03-09;0;0;0;0;0.0;0.0
05;2021-03-10;0;0;0;0;0.0;0.0
05;2021-03-11;0;0;0;0;0.0;0.0
05;2021-03-12;0;0;0;0;0.0;0.0
05;2021-03-13;0;0;0;0;0.0;0.0
05;2021-03-14;0;0;0;0;0.0;0.0
05;2021-03-15;0;0;0;0;0.0;0.0
05;2021-03-16;0;0;0;0;0.0;0.0
05;2021-03-17;0;0;0;0;0.0;0.0
05;2021-03-18;0;0;0;0;0.0;0.0
05;2021-03-19;0;0;0;0;0.0;0.0
05;2021-03-20;0;0;0;0;0.0;0.0
05;2021-03-21;0;0;0;0;0.0;0.0
05;2021-03-22;0;0;0;0;0.0;0.0
05;2021-03-23;0;0;0;0;0.0;0.0
05;2021-03-24;0;0;0;0;0.0;0.0
05;2021-03-25;0;0;0;0;0.0;0.0
05;2021-03-26;0;0;0;0;0.0;0.0
05;2021-03-27;0;0;0;0;0.0;0.0
05;2021-03-28;0;0;0;0;0.0;0.0
05;2021-03-29;2;0;2;0;0.0;0.0
05;2021-03-30;0;0;2;0;0.0;0.0
05;2021-03-31;0;0;2;0;0.0;0.0
05;2021-04-01;0;0;2;0;0.0;0.0
05;2021-04-02;0;0;2;0;0.0;0.0
05;2021-04-03;0;0;2;0;0.0;0.0
05;2021-04-04;0;0;2;0;0.0;0.0
05;2021-04-05;0;0;2;0;0.0;0.0
05;2021-04-06;0;0;2;0;0.0;0.0
05;2021-04-07;0;0;2;0;0.0;0.0
05;2021-04-08;1;0;3;0;0.1;0.0
05;2021-04-09;0;0;3;0;0.1;0.0
05;2021-04-10;0;0;3;0;0.1;0.0
05;2021-04-11;0;0;3;0;0.1;0.0
05;2021-04-12;0;0;3;0;0.1;0.0
05;2021-04-13;0;0;3;0;0.1;0.0
05;2021-04-14;0;0;3;0;0.1;0.0
05;2021-04-15;0;0;3;0;0.1;0.0
05;2021-04-16;0;0;3;0;0.1;0.0
05;2021-04-17;0;0;3;0;0.1;0.0
05;2021-04-18;0;0;3;0;0.1;0.0
05;2021-04-19;0;0;3;0;0.1;0.0
05;2021-04-20;0;0;3;0;0.1;0.0
05;2021-04-21;0;0;3;0;0.1;0.0
05;2021-04-22;0;0;3;0;0.1;0.0
05;2021-04-23;0;0;3;0;0.1;0.0
05;2021-04-24;0;0;3;0;0.1;0.0
05;2021-04-25;0;0;3;0;0.1;0.0
05;2021-04-26;0;0;3;0;0.1;0.0
05;2021-04-27;0;0;3;0;0.1;0.0
05;2021-04-28;0;0;3;0;0.1;0.0
05;2021-04-29;0;0;3;0;0.1;0.0
05;2021-04-30;0;0;3;0;0.1;0.0
05;2021-05-01;0;0;3;0;0.1;0.0
05;2021-05-02;0;0;3;0;0.1;0.0
05;2021-05-03;0;0;3;0;0.1;0.0
05;2021-05-04;0;0;3;0;0.1;0.0
05;2021-05-05;0;0;3;0;0.1;0.0
05;2021-05-06;0;0;3;0;0.1;0.0
05;2021-05-07;0;0;3;0;0.1;0.0
05;2021-05-08;0;0;3;0;0.1;0.0
05;2021-05-09;0;0;3;0;0.1;0.0
05;2021-05-10;0;0;3;0;0.1;0.0
05;2021-05-11;0;0;3;0;0.1;0.0
05;2021-05-12;0;0;3;0;0.1;0.0
05;2021-05-13;0;0;3;0;0.1;0.0
05;2021-05-14;0;0;3;0;0.1;0.0
05;2021-05-15;0;0;3;0;0.1;0.0
05;2021-05-16;0;0;3;0;0.1;0.0
05;2021-05-17;0;0;3;0;0.1;0.0
05;2021-05-18;0;0;3;0;0.1;0.0
05;2021-05-19;0;0;3;0;0.1;0.0
05;2021-05-20;0;0;3;0;0.1;0.0
05;2021-05-21;0;0;3;0;0.1;0.0
05;2021-05-22;0;0;3;0;0.1;0.0
05;2021-05-23;0;0;3;0;0.1;0.0
05;2021-05-24;0;0;3;0;0.1;0.0
05;2021-05-25;0;0;3;0;0.1;0.0
05;2021-05-26;0;0;3;0;0.1;0.0
05;2021-05-27;0;0;3;0;0.1;0.0
05;2021-05-28;0;0;3;0;0.1;0.0
05;2021-05-29;0;2;3;2;0.1;0.0
05;2021-05-30;0;0;3;2;0.1;0.0
05;2021-05-31;0;0;3;2;0.1;0.0
05;2021-06-01;0;0;3;2;0.1;0.0
05;2021-06-02;0;0;3;2;0.1;0.0
05;2021-06-03;0;0;3;2;0.1;0.0
05;2021-06-04;0;0;3;2;0.1;0.0
05;2021-06-05;0;0;3;2;0.1;0.0
05;2021-06-06;0;0;3;2;0.1;0.0
05;2021-06-07;0;0;3;2;0.1;0.0
05;2021-06-08;0;0;3;2;0.1;0.0
05;2021-06-09;0;0;3;2;0.1;0.0
05;2021-06-10;0;0;3;2;0.1;0.0
05;2021-06-11;0;0;3;2;0.1;0.0
05;2021-06-12;0;0;3;2;0.1;0.0
05;2021-06-13;0;0;3;2;0.1;0.0
05;2021-06-14;0;0;3;2;0.1;0.0
05;2021-06-15;0;0;3;2;0.1;0.0
05;2021-06-16;0;0;3;2;0.1;0.0
05;2021-06-17;0;0;3;2;0.1;0.0
05;2021-06-18;0;0;3;2;0.1;0.0
05;2021-06-19;0;0;3;2;0.1;0.0
05;2021-06-20;0;0;3;2;0.1;0.0
05;2021-06-21;0;0;3;2;0.1;0.0
05;2021-06-22;0;0;3;2;0.1;0.0
05;2021-06-23;0;0;3;2;0.1;0.0
05;2021-06-24;0;0;3;2;0.1;0.0
05;2021-06-25;0;0;3;2;0.1;0.0
05;2021-06-26;0;0;3;2;0.1;0.0
05;2021-06-27;0;0;3;2;0.1;0.0
05;2021-06-28;0;0;3;2;0.1;0.0
05;2021-06-29;0;0;3;2;0.1;0.0
06;2020-12-27;0;0;0;0;0.0;0.0
06;2020-12-28;0;0;0;0;0.0;0.0
06;2020-12-29;0;0;0;0;0.0;0.0
06;2020-12-30;0;0;0;0;0.0;0.0
06;2020-12-31;0;0;0;0;0.0;0.0
06;2021-01-01;0;0;0;0;0.0;0.0
06;2021-01-02;0;0;0;0;0.0;0.0
06;2021-01-03;0;0;0;0;0.0;0.0
06;2021-01-04;0;0;0;0;0.0;0.0
06;2021-01-05;0;0;0;0;0.0;0.0
06;2021-01-06;0;0;0;0;0.0;0.0
06;2021-01-07;0;0;0;0;0.0;0.0
06;2021-01-08;0;0;0;0;0.0;0.0
06;2021-01-09;0;0;0;0;0.0;0.0
06;2021-01-10;0;0;0;0;0.0;0.0
06;2021-01-11;9;0;9;0;0.0;0.0
06;2021-01-12;0;0;9;0;0.0;0.0
06;2021-01-13;0;0;9;0;0.0;0.0
06;2021-01-14;0;0;9;0;0.0;0.0
06;2021-01-15;1;0;10;0;0.0;0.0
06;2021-01-16;1;0;11;0;0.0;0.0
06;2021-01-17;0;0;11;0;0.0;0.0
06;2021-01-18;1;0;12;0;0.0;0.0
06;2021-01-19;0;0;12;0;0.0;0.0
06;2021-01-20;0;0;12;0;0.0;0.0
06;2021-01-21;0;0;12;0;0.0;0.0
06;2021-01-22;0;0;12;0;0.0;0.0
06;2021-01-23;1;0;13;0;0.0;0.0
06;2021-01-24;0;0;13;0;0.0;0.0
06;2021-01-25;141;1;154;1;0.1;0.0
06;2021-01-26;166;4;320;5;0.1;0.0
06;2021-01-27;250;2;570;7;0.2;0.0
06;2021-01-28;101;5;671;12;0.2;0.0
06;2021-01-29;230;2;901;14;0.3;0.0
06;2021-01-30;286;9;1187;23;0.4;0.0
06;2021-01-31;1;0;1188;23;0.4;0.0
06;2021-02-01;160;0;1348;23;0.5;0.0
06;2021-02-02;329;7;1677;30;0.6;0.0
06;2021-02-03;228;2;1905;32;0.7;0.0
06;2021-02-04;215;7;2120;39;0.8;0.0
06;2021-02-05;214;1;2334;40;0.8;0.0
06;2021-02-06;83;10;2417;50;0.9;0.0
06;2021-02-07;0;0;2417;50;0.9;0.0
06;2021-02-08;82;3;2499;53;0.9;0.0
06;2021-02-09;193;0;2692;53;1.0;0.0
06;2021-02-10;187;2;2879;55;1.0;0.0
06;2021-02-11;235;3;3114;58;1.1;0.0
06;2021-02-12;287;3;3401;61;1.2;0.0
06;2021-02-13;56;0;3457;61;1.2;0.0
06;2021-02-14;1;0;3458;61;1.2;0.0
06;2021-02-15;359;5;3817;66;1.4;0.0
06;2021-02-16;266;6;4083;72;1.5;0.0
06;2021-02-17;167;5;4250;77;1.5;0.0
06;2021-02-18;217;12;4467;89;1.6;0.0
06;2021-02-19;235;23;4702;112;1.7;0.0
06;2021-02-20;138;7;4840;119;1.7;0.0
06;2021-02-21;0;0;4840;119;1.7;0.0
06;2021-02-22;130;122;4970;241;1.8;0.1
06;2021-02-23;187;151;5157;392;1.8;0.1
06;2021-02-24;176;145;5333;537;1.9;0.2
06;2021-02-25;227;285;5560;822;2.0;0.3
06;2021-02-26;242;259;5802;1081;2.1;0.4
06;2021-02-27;0;0;5802;1081;2.1;0.4
06;2021-02-28;0;0;5802;1081;2.1;0.4
06;2021-03-01;145;258;5947;1339;2.1;0.5
06;2021-03-02;228;257;6175;1596;2.2;0.6
06;2021-03-03;202;189;6377;1785;2.3;0.6
06;2021-03-04;205;140;6582;1925;2.4;0.7
06;2021-03-05;224;114;6806;2039;2.4;0.7
06;2021-03-06;1;0;6807;2039;2.4;0.7
06;2021-03-07;0;0;6807;2039;2.4;0.7
06;2021-03-08;189;125;6996;2164;2.5;0.8
06;2021-03-09;391;156;7387;2320;2.6;0.8
06;2021-03-10;180;178;7567;2498;2.7;0.9
06;2021-03-11;167;207;7734;2705;2.8;1.0
06;2021-03-12;238;288;7972;2993;2.9;1.1
06;2021-03-13;2;0;7974;2993;2.9;1.1
06;2021-03-14;0;0;7974;2993;2.9;1.1
06;2021-03-15;156;292;8130;3285;2.9;1.2
06;2021-03-16;236;223;8366;3508;3.0;1.3
06;2021-03-17;267;141;8633;3649;3.1;1.3
06;2021-03-18;172;232;8805;3881;3.2;1.4
06;2021-03-19;172;298;8977;4179;3.2;1.5
06;2021-03-20;0;0;8977;4179;3.2;1.5
06;2021-03-21;0;0;8977;4179;3.2;1.5
06;2021-03-22;97;136;9074;4315;3.2;1.5
06;2021-03-23;136;240;9210;4555;3.3;1.6
06;2021-03-24;160;146;9370;4701;3.4;1.7
06;2021-03-25;186;206;9556;4907;3.4;1.8
06;2021-03-26;160;212;9716;5119;3.5;1.8
06;2021-03-27;18;0;9734;5119;3.5;1.8
06;2021-03-28;0;0;9734;5119;3.5;1.8
06;2021-03-29;0;2;9734;5121;3.5;1.8
06;2021-03-30;272;334;10006;5455;3.6;2.0
06;2021-03-31;225;125;10231;5580;3.7;2.0
06;2021-04-01;243;104;10474;5684;3.7;2.0
06;2021-04-02;285;263;10759;5947;3.8;2.1
06;2021-04-03;906;307;11665;6254;4.2;2.2
06;2021-04-04;1;0;11666;6254;4.2;2.2
06;2021-04-05;1;0;11667;6254;4.2;2.2
06;2021-04-06;160;282;11827;6536;4.2;2.3
06;2021-04-07;237;265;12064;6801;4.3;2.4
06;2021-04-08;286;140;12350;6941;4.4;2.5
06;2021-04-09;248;171;12598;7112;4.5;2.5
06;2021-04-10;181;114;12779;7226;4.6;2.6
06;2021-04-11;7;0;12786;7226;4.6;2.6
06;2021-04-12;0;19;12786;7245;4.6;2.6
06;2021-04-13;393;343;13179;7588;4.7;2.7
06;2021-04-14;239;205;13418;7793;4.8;2.8
06;2021-04-15;207;117;13625;7910;4.9;2.8
06;2021-04-16;214;127;13839;8037;5.0;2.9
06;2021-04-17;226;132;14065;8169;5.0;2.9
06;2021-04-18;1;0;14066;8169;5.0;2.9
06;2021-04-19;7;1;14073;8170;5.0;2.9
06;2021-04-20;368;224;14441;8394;5.2;3.0
06;2021-04-21;412;150;14853;8544;5.3;3.1
06;2021-04-22;410;150;15263;8694;5.5;3.1
06;2021-04-23;367;166;15630;8860;5.6;3.2
06;2021-04-24;413;127;16043;8987;5.7;3.2
06;2021-04-25;2;0;16045;8987;5.7;3.2
06;2021-04-26;54;8;16099;8995;5.8;3.2
06;2021-04-27;351;293;16450;9288;5.9;3.3
06;2021-04-28;355;515;16805;9803;6.0;3.5
06;2021-04-29;558;345;17363;10148;6.2;3.6
06;2021-04-30;403;238;17766;10386;6.4;3.7
06;2021-05-01;670;285;18436;10671;6.6;3.8
06;2021-05-02;0;0;18436;10671;6.6;3.8
06;2021-05-03;137;6;18573;10677;6.6;3.8
06;2021-05-04;353;426;18926;11103;6.8;4.0
06;2021-05-05;444;317;19370;11420;6.9;4.1
06;2021-05-06;319;200;19689;11620;7.0;4.2
06;2021-05-07;341;134;20030;11754;7.2;4.2
06;2021-05-08;300;140;20330;11894;7.3;4.3
06;2021-05-09;0;0;20330;11894;7.3;4.3
06;2021-05-10;8;9;20338;11903;7.3;4.3
06;2021-05-11;359;489;20697;12392;7.4;4.4
06;2021-05-12;331;310;21028;12702;7.5;4.5
06;2021-05-13;127;97;21155;12799;7.6;4.6
06;2021-05-14;0;0;21155;12799;7.6;4.6
06;2021-05-15;484;283;21639;13082;7.7;4.7
06;2021-05-16;0;0;21639;13082;7.7;4.7
06;2021-05-17;122;51;21761;13133;7.8;4.7
06;2021-05-18;515;430;22276;13563;8.0;4.9
06;2021-05-19;650;663;22926;14226;8.2;5.1
06;2021-05-20;1055;496;23981;14722;8.6;5.3
06;2021-05-21;1046;314;25027;15036;9.0;5.4
06;2021-05-22;1242;300;26269;15336;9.4;5.5
06;2021-05-23;0;0;26269;15336;9.4;5.5
06;2021-05-24;1;0;26270;15336;9.4;5.5
06;2021-05-25;882;623;27152;15959;9.7;5.7
06;2021-05-26;1034;841;28186;16800;10.1;6.0
06;2021-05-27;1313;506;29499;17306;10.6;6.2
06;2021-05-28;952;372;30451;17678;10.9;6.3
06;2021-05-29;1132;390;31583;18068;11.3;6.5
06;2021-05-30;0;1;31583;18069;11.3;6.5
06;2021-05-31;104;6;31687;18075;11.3;6.5
06;2021-06-01;1145;650;32832;18725;11.7;6.7
06;2021-06-02;1167;496;33999;19221;12.2;6.9
06;2021-06-03;795;333;34794;19554;12.4;7.0
06;2021-06-04;985;321;35779;19875;12.8;7.1
06;2021-06-05;656;298;36435;20173;13.0;7.2
06;2021-06-06;0;0;36435;20173;13.0;7.2
06;2021-06-07;84;12;36519;20185;13.1;7.2
06;2021-06-08;917;442;37436;20627;13.4;7.4
06;2021-06-09;951;546;38387;21173;13.7;7.6
06;2021-06-10;651;225;39038;21398;14.0;7.7
06;2021-06-11;825;368;39863;21766;14.3;7.8
06;2021-06-12;563;273;40426;22039;14.5;7.9
06;2021-06-13;0;0;40426;22039;14.5;7.9
06;2021-06-14;178;112;40604;22151;14.5;7.9
06;2021-06-15;399;839;41003;22990;14.7;8.2
06;2021-06-16;880;1437;41883;24427;15.0;8.7
06;2021-06-17;757;651;42640;25078;15.3;9.0
06;2021-06-18;686;616;43326;25694;15.5;9.2
06;2021-06-19;527;639;43853;26333;15.7;9.4
06;2021-06-20;0;0;43853;26333;15.7;9.4
06;2021-06-21;122;128;43975;26461;15.7;9.5
06;2021-06-22;424;1144;44399;27605;15.9;9.9
06;2021-06-23;646;1179;45045;28784;16.1;10.3
06;2021-06-24;455;540;45500;29324;16.3;10.5
06;2021-06-25;522;472;46022;29796;16.5;10.7
06;2021-06-26;382;684;46404;30480;16.6;10.9
06;2021-06-27;0;0;46404;30480;16.6;10.9
06;2021-06-28;99;190;46503;30670;16.6;11.0
06;2021-06-29;412;950;46915;31620;16.8;11.3
07;2020-12-27;0;0;0;0;0.0;0.0
07;2020-12-28;0;0;0;0;0.0;0.0
07;2020-12-29;0;0;0;0;0.0;0.0
07;2020-12-30;0;0;0;0;0.0;0.0
07;2020-12-31;0;0;0;0;0.0;0.0
07;2021-01-01;0;0;0;0;0.0;0.0
07;2021-01-02;0;0;0;0;0.0;0.0
07;2021-01-03;0;0;0;0;0.0;0.0
07;2021-01-04;0;0;0;0;0.0;0.0
07;2021-01-05;0;0;0;0;0.0;0.0
07;2021-01-06;0;0;0;0;0.0;0.0
07;2021-01-07;0;0;0;0;0.0;0.0
07;2021-01-08;0;0;0;0;0.0;0.0
07;2021-01-09;0;0;0;0;0.0;0.0
07;2021-01-10;0;0;0;0;0.0;0.0
07;2021-01-11;0;0;0;0;0.0;0.0
07;2021-01-12;0;0;0;0;0.0;0.0
07;2021-01-13;0;0;0;0;0.0;0.0
07;2021-01-14;0;0;0;0;0.0;0.0
07;2021-01-15;0;0;0;0;0.0;0.0
07;2021-01-16;0;0;0;0;0.0;0.0
07;2021-01-17;0;0;0;0;0.0;0.0
07;2021-01-18;1;0;1;0;0.0;0.0
07;2021-01-19;0;0;1;0;0.0;0.0
07;2021-01-20;0;0;1;0;0.0;0.0
07;2021-01-21;12;0;13;0;0.1;0.0
07;2021-01-22;12;0;25;0;0.3;0.0
07;2021-01-23;0;0;25;0;0.3;0.0
07;2021-01-24;0;0;25;0;0.3;0.0
07;2021-01-25;0;0;25;0;0.3;0.0
07;2021-01-26;0;0;25;0;0.3;0.0
07;2021-01-27;12;0;37;0;0.4;0.0
07;2021-01-28;1;0;38;0;0.4;0.0
07;2021-01-29;6;0;44;0;0.4;0.0
07;2021-01-30;0;0;44;0;0.4;0.0
07;2021-01-31;0;0;44;0;0.4;0.0
07;2021-02-01;0;0;44;0;0.4;0.0
07;2021-02-02;0;0;44;0;0.4;0.0
07;2021-02-03;11;0;55;0;0.6;0.0
07;2021-02-04;12;0;67;0;0.7;0.0
07;2021-02-05;11;0;78;0;0.8;0.0
07;2021-02-06;0;0;78;0;0.8;0.0
07;2021-02-07;0;0;78;0;0.8;0.0
07;2021-02-08;0;0;78;0;0.8;0.0
07;2021-02-09;13;0;91;0;0.9;0.0
07;2021-02-10;0;0;91;0;0.9;0.0
07;2021-02-11;16;0;107;0;1.1;0.0
07;2021-02-12;45;0;152;0;1.5;0.0
07;2021-02-13;0;0;152;0;1.5;0.0
07;2021-02-14;0;0;152;0;1.5;0.0
07;2021-02-15;0;0;152;0;1.5;0.0
07;2021-02-16;0;0;152;0;1.5;0.0
07;2021-02-17;0;0;152;0;1.5;0.0
07;2021-02-18;18;0;170;0;1.7;0.0
07;2021-02-19;34;0;204;0;2.0;0.0
07;2021-02-20;0;0;204;0;2.0;0.0
07;2021-02-21;0;0;204;0;2.0;0.0
07;2021-02-22;0;0;204;0;2.0;0.0
07;2021-02-23;0;22;204;22;2.0;0.2
07;2021-02-24;0;0;204;22;2.0;0.2
07;2021-02-25;15;10;219;32;2.2;0.3
07;2021-02-26;33;21;252;53;2.5;0.5
07;2021-02-27;0;0;252;53;2.5;0.5
07;2021-02-28;0;0;252;53;2.5;0.5
07;2021-03-01;0;0;252;53;2.5;0.5
07;2021-03-02;17;11;269;64;2.7;0.6
07;2021-03-03;0;0;269;64;2.7;0.6
07;2021-03-04;16;11;285;75;2.9;0.8
07;2021-03-05;33;19;318;94;3.2;0.9
07;2021-03-06;0;0;318;94;3.2;0.9
07;2021-03-07;0;0;318;94;3.2;0.9
07;2021-03-08;0;0;318;94;3.2;0.9
07;2021-03-09;1;0;319;94;3.2;0.9
07;2021-03-10;0;0;319;94;3.2;0.9
07;2021-03-11;20;30;339;124;3.4;1.2
07;2021-03-12;62;42;401;166;4.0;1.7
07;2021-03-13;0;0;401;166;4.0;1.7
07;2021-03-14;0;0;401;166;4.0;1.7
07;2021-03-15;0;0;401;166;4.0;1.7
07;2021-03-16;30;9;431;175;4.3;1.8
07;2021-03-17;0;0;431;175;4.3;1.8
07;2021-03-18;29;16;460;191;4.6;1.9
07;2021-03-19;56;31;516;222;5.2;2.2
07;2021-03-20;0;0;516;222;5.2;2.2
07;2021-03-21;0;0;516;222;5.2;2.2
07;2021-03-22;0;0;516;222;5.2;2.2
07;2021-03-23;0;0;516;222;5.2;2.2
07;2021-03-24;0;0;516;222;5.2;2.2
07;2021-03-25;65;17;581;239;5.8;2.4
07;2021-03-26;73;26;654;265;6.6;2.7
07;2021-03-27;0;0;654;265;6.6;2.7
07;2021-03-28;0;0;654;265;6.6;2.7
07;2021-03-29;0;0;654;265;6.6;2.7
07;2021-03-30;40;18;694;283;7.0;2.8
07;2021-03-31;26;15;720;298;7.2;3.0
07;2021-04-01;25;32;745;330;7.5;3.3
07;2021-04-02;0;0;745;330;7.5;3.3
07;2021-04-03;0;0;745;330;7.5;3.3
07;2021-04-04;0;0;745;330;7.5;3.3
07;2021-04-05;9;0;754;330;7.6;3.3
07;2021-04-06;0;0;754;330;7.6;3.3
07;2021-04-07;0;0;754;330;7.6;3.3
07;2021-04-08;57;46;811;376;8.1;3.8
07;2021-04-09;59;31;870;407;8.7;4.1
07;2021-04-10;0;0;870;407;8.7;4.1
07;2021-04-11;0;0;870;407;8.7;4.1
07;2021-04-12;0;0;870;407;8.7;4.1
07;2021-04-13;0;0;870;407;8.7;4.1
07;2021-04-14;5;6;875;413;8.8;4.1
07;2021-04-15;56;71;931;484;9.3;4.9
07;2021-04-16;90;35;1021;519;10.2;5.2
07;2021-04-17;0;1;1021;520;10.2;5.2
07;2021-04-18;0;0;1021;520;10.2;5.2
07;2021-04-19;1;0;1022;520;10.3;5.2
07;2021-04-20;335;66;1357;586;13.6;5.9
07;2021-04-21;337;29;1694;615;17.0;6.2
07;2021-04-22;284;50;1978;665;19.9;6.7
07;2021-04-23;258;41;2236;706;22.4;7.1
07;2021-04-24;231;1;2467;707;24.8;7.1
07;2021-04-25;0;0;2467;707;24.8;7.1
07;2021-04-26;283;20;2750;727;27.6;7.3
07;2021-04-27;224;69;2974;796;29.9;8.0
07;2021-04-28;192;26;3166;822;31.8;8.3
07;2021-04-29;170;22;3336;844;33.5;8.5
07;2021-04-30;172;15;3508;859;35.2;8.6
07;2021-05-01;200;12;3708;871;37.2;8.7
07;2021-05-02;0;0;3708;871;37.2;8.7
07;2021-05-03;134;10;3842;881;38.6;8.8
07;2021-05-04;161;54;4003;935;40.2;9.4
07;2021-05-05;221;30;4224;965;42.4;9.7
07;2021-05-06;175;31;4399;996;44.2;10.0
07;2021-05-07;149;31;4548;1027;45.7;10.3
07;2021-05-08;1;0;4549;1027;45.7;10.3
07;2021-05-09;0;2;4549;1029;45.7;10.3
07;2021-05-10;0;0;4549;1029;45.7;10.3
07;2021-05-11;2;41;4551;1070;45.7;10.7
07;2021-05-12;6;36;4557;1106;45.7;11.1
07;2021-05-13;0;0;4557;1106;45.7;11.1
07;2021-05-14;28;98;4585;1204;46.0;12.1
07;2021-05-15;0;0;4585;1204;46.0;12.1
07;2021-05-16;0;0;4585;1204;46.0;12.1
07;2021-05-17;1;14;4586;1218;46.0;12.2
07;2021-05-18;17;32;4603;1250;46.2;12.5
07;2021-05-19;0;1;4603;1251;46.2;12.6
07;2021-05-20;0;8;4603;1259;46.2;12.6
07;2021-05-21;12;32;4615;1291;46.3;13.0
07;2021-05-22;0;0;4615;1291;46.3;13.0
07;2021-05-23;0;0;4615;1291;46.3;13.0
07;2021-05-24;0;0;4615;1291;46.3;13.0
07;2021-05-25;50;334;4665;1625;46.8;16.3
07;2021-05-26;55;359;4720;1984;47.4;19.9
07;2021-05-27;34;317;4754;2301;47.7;23.1
07;2021-05-28;27;256;4781;2557;48.0;25.7
07;2021-05-29;35;376;4816;2933;48.3;29.4
07;2021-05-30;0;0;4816;2933;48.3;29.4
07;2021-05-31;45;218;4861;3151;48.8;31.6
07;2021-06-01;47;226;4908;3377;49.3;33.9
07;2021-06-02;69;273;4977;3650;50.0;36.6
07;2021-06-03;41;252;5018;3902;50.4;39.2
07;2021-06-04;73;272;5091;4174;51.1;41.9
07;2021-06-05;1;0;5092;4174;51.1;41.9
07;2021-06-06;0;0;5092;4174;51.1;41.9
07;2021-06-07;1;1;5093;4175;51.1;41.9
07;2021-06-08;3;2;5096;4177;51.2;41.9
07;2021-06-09;0;3;5096;4180;51.2;42.0
07;2021-06-10;8;4;5104;4184;51.2;42.0
07;2021-06-11;3;8;5107;4192;51.3;42.1
07;2021-06-12;15;59;5122;4251;51.4;42.7
07;2021-06-13;0;0;5122;4251;51.4;42.7
07;2021-06-14;0;0;5122;4251;51.4;42.7
07;2021-06-15;0;1;5122;4252;51.4;42.7
07;2021-06-16;0;0;5122;4252;51.4;42.7
07;2021-06-17;2;6;5124;4258;51.4;42.7
07;2021-06-18;0;2;5124;4260;51.4;42.8
07;2021-06-19;25;49;5149;4309;51.7;43.3
07;2021-06-20;0;0;5149;4309;51.7;43.3
07;2021-06-21;0;2;5149;4311;51.7;43.3
07;2021-06-22;8;0;5157;4311;51.8;43.3
07;2021-06-23;15;9;5172;4320;51.9;43.4
07;2021-06-24;10;5;5182;4325;52.0;43.4
07;2021-06-25;0;0;5182;4325;52.0;43.4
07;2021-06-26;28;49;5210;4374;52.3;43.9
07;2021-06-27;0;0;5210;4374;52.3;43.9
07;2021-06-28;0;1;5210;4375;52.3;43.9
07;2021-06-29;0;0;5210;4375;52.3;43.9
08;2020-12-27;0;0;0;0;0.0;0.0
08;2020-12-28;0;0;0;0;0.0;0.0
08;2020-12-29;0;0;0;0;0.0;0.0
08;2020-12-30;0;0;0;0;0.0;0.0
08;2020-12-31;0;0;0;0;0.0;0.0
08;2021-01-01;0;0;0;0;0.0;0.0
08;2021-01-02;0;0;0;0;0.0;0.0
08;2021-01-03;0;0;0;0;0.0;0.0
08;2021-01-04;0;0;0;0;0.0;0.0
08;2021-01-05;0;0;0;0;0.0;0.0
08;2021-01-06;0;0;0;0;0.0;0.0
08;2021-01-07;0;0;0;0;0.0;0.0
08;2021-01-08;0;0;0;0;0.0;0.0
08;2021-01-09;0;0;0;0;0.0;0.0
08;2021-01-10;0;0;0;0;0.0;0.0
08;2021-01-11;0;0;0;0;0.0;0.0
08;2021-01-12;0;0;0;0;0.0;0.0
08;2021-01-13;10;0;10;0;0.0;0.0
08;2021-01-14;12;0;22;0;0.1;0.0
08;2021-01-15;7;0;29;0;0.1;0.0
08;2021-01-16;0;0;29;0;0.1;0.0
08;2021-01-17;0;0;29;0;0.1;0.0
08;2021-01-18;0;0;29;0;0.1;0.0
08;2021-01-19;12;0;41;0;0.1;0.0
08;2021-01-20;12;0;53;0;0.1;0.0
08;2021-01-21;6;0;59;0;0.2;0.0
08;2021-01-22;0;0;59;0;0.2;0.0
08;2021-01-23;0;0;59;0;0.2;0.0
08;2021-01-24;0;0;59;0;0.2;0.0
08;2021-01-25;0;0;59;0;0.2;0.0
08;2021-01-26;9;0;68;0;0.2;0.0
08;2021-01-27;10;0;78;0;0.2;0.0
08;2021-01-28;6;0;84;0;0.2;0.0
08;2021-01-29;0;0;84;0;0.2;0.0
08;2021-01-30;0;0;84;0;0.2;0.0
08;2021-01-31;0;0;84;0;0.2;0.0
08;2021-02-01;0;0;84;0;0.2;0.0
08;2021-02-02;38;0;122;0;0.3;0.0
08;2021-02-03;10;0;132;0;0.4;0.0
08;2021-02-04;30;0;162;0;0.5;0.0
08;2021-02-05;7;0;169;0;0.5;0.0
08;2021-02-06;0;0;169;0;0.5;0.0
08;2021-02-07;0;0;169;0;0.5;0.0
08;2021-02-08;0;0;169;0;0.5;0.0
08;2021-02-09;38;0;207;0;0.6;0.0
08;2021-02-10;27;1;234;1;0.7;0.0
08;2021-02-11;0;0;234;1;0.7;0.0
08;2021-02-12;36;0;270;1;0.8;0.0
08;2021-02-13;0;0;270;1;0.8;0.0
08;2021-02-14;0;0;270;1;0.8;0.0
08;2021-02-15;50;0;320;1;0.9;0.0
08;2021-02-16;0;0;320;1;0.9;0.0
08;2021-02-17;0;0;320;1;0.9;0.0
08;2021-02-18;27;0;347;1;1.0;0.0
08;2021-02-19;44;0;391;1;1.1;0.0
08;2021-02-20;0;0;391;1;1.1;0.0
08;2021-02-21;0;0;391;1;1.1;0.0
08;2021-02-22;46;4;437;5;1.2;0.0
08;2021-02-23;41;29;478;34;1.4;0.1
08;2021-02-24;35;1;513;35;1.5;0.1
08;2021-02-25;55;36;568;71;1.6;0.2
08;2021-02-26;39;5;607;76;1.7;0.2
08;2021-02-27;0;0;607;76;1.7;0.2
08;2021-02-28;0;0;607;76;1.7;0.2
08;2021-03-01;48;5;655;81;1.9;0.2
08;2021-03-02;7;27;662;108;1.9;0.3
08;2021-03-03;38;27;700;135;2.0;0.4
08;2021-03-04;30;26;730;161;2.1;0.5
08;2021-03-05;46;11;776;172;2.2;0.5
08;2021-03-06;0;0;776;172;2.2;0.5
08;2021-03-07;0;0;776;172;2.2;0.5
08;2021-03-08;30;7;806;179;2.3;0.5
08;2021-03-09;19;27;825;206;2.3;0.6
08;2021-03-10;32;28;857;234;2.4;0.7
08;2021-03-11;2;0;859;234;2.4;0.7
08;2021-03-12;52;21;911;255;2.6;0.7
08;2021-03-13;11;0;922;255;2.6;0.7
08;2021-03-14;0;0;922;255;2.6;0.7
08;2021-03-15;32;42;954;297;2.7;0.8
08;2021-03-16;73;6;1027;303;2.9;0.9
08;2021-03-17;67;13;1094;316;3.1;0.9
08;2021-03-18;82;39;1176;355;3.3;1.0
08;2021-03-19;31;50;1207;405;3.4;1.1
08;2021-03-20;0;0;1207;405;3.4;1.1
08;2021-03-21;0;0;1207;405;3.4;1.1
08;2021-03-22;34;45;1241;450;3.5;1.3
08;2021-03-23;30;43;1271;493;3.6;1.4
08;2021-03-24;38;42;1309;535;3.7;1.5
08;2021-03-25;92;34;1401;569;4.0;1.6
08;2021-03-26;45;33;1446;602;4.1;1.7
08;2021-03-27;94;3;1540;605;4.4;1.7
08;2021-03-28;0;0;1540;605;4.4;1.7
08;2021-03-29;69;49;1609;654;4.6;1.9
08;2021-03-30;98;24;1707;678;4.8;1.9
08;2021-03-31;89;47;1796;725;5.1;2.1
08;2021-04-01;56;48;1852;773;5.2;2.2
08;2021-04-02;0;0;1852;773;5.2;2.2
08;2021-04-03;0;0;1852;773;5.2;2.2
08;2021-04-04;0;0;1852;773;5.2;2.2
08;2021-04-05;0;0;1852;773;5.2;2.2
08;2021-04-06;49;63;1901;836;5.4;2.4
08;2021-04-07;91;32;1992;868;5.6;2.5
08;2021-04-08;120;7;2112;875;6.0;2.5
08;2021-04-09;89;39;2201;914;6.2;2.6
08;2021-04-10;162;9;2363;923;6.7;2.6
08;2021-04-11;0;0;2363;923;6.7;2.6
08;2021-04-12;41;76;2404;999;6.8;2.8
08;2021-04-13;48;71;2452;1070;6.9;3.0
08;2021-04-14;82;44;2534;1114;7.2;3.2
08;2021-04-15;93;24;2627;1138;7.4;3.2
08;2021-04-16;77;42;2704;1180;7.7;3.3
08;2021-04-17;165;4;2869;1184;8.1;3.4
08;2021-04-18;0;0;2869;1184;8.1;3.4
08;2021-04-19;52;67;2921;1251;8.3;3.5
08;2021-04-20;83;27;3004;1278;8.5;3.6
08;2021-04-21;91;29;3095;1307;8.8;3.7
08;2021-04-22;101;20;3196;1327;9.0;3.8
08;2021-04-23;44;66;3240;1393;9.2;3.9
08;2021-04-24;99;78;3339;1471;9.4;4.2
08;2021-04-25;0;0;3339;1471;9.4;4.2
08;2021-04-26;30;91;3369;1562;9.5;4.4
08;2021-04-27;58;63;3427;1625;9.7;4.6
08;2021-04-28;88;39;3515;1664;9.9;4.7
08;2021-04-29;91;34;3606;1698;10.2;4.8
08;2021-04-30;104;15;3710;1713;10.5;4.8
08;2021-05-01;0;8;3710;1721;10.5;4.9
08;2021-05-02;0;0;3710;1721;10.5;4.9
08;2021-05-03;25;101;3735;1822;10.6;5.2
08;2021-05-04;158;102;3893;1924;11.0;5.4
08;2021-05-05;141;58;4034;1982;11.4;5.6
08;2021-05-06;199;49;4233;2031;12.0;5.7
08;2021-05-07;127;71;4360;2102;12.3;5.9
08;2021-05-08;69;122;4429;2224;12.5;6.3
08;2021-05-09;0;0;4429;2224;12.5;6.3
08;2021-05-10;127;99;4556;2323;12.9;6.6
08;2021-05-11;137;72;4693;2395;13.3;6.8
08;2021-05-12;157;76;4850;2471;13.7;7.0
08;2021-05-13;83;6;4933;2477;14.0;7.0
08;2021-05-14;129;62;5062;2539;14.3;7.2
08;2021-05-15;86;4;5148;2543;14.6;7.2
08;2021-05-16;0;0;5148;2543;14.6;7.2
08;2021-05-17;147;112;5295;2655;15.0;7.5
08;2021-05-18;156;94;5451;2749;15.4;7.8
08;2021-05-19;85;69;5536;2818;15.7;8.0
08;2021-05-20;103;26;5639;2844;16.0;8.0
08;2021-05-21;98;52;5737;2896;16.2;8.2
08;2021-05-22;99;11;5836;2907;16.5;8.2
08;2021-05-23;0;0;5836;2907;16.5;8.2
08;2021-05-24;33;7;5869;2914;16.6;8.2
08;2021-05-25;119;78;5988;2992;16.9;8.5
08;2021-05-26;108;50;6096;3042;17.3;8.6
08;2021-05-27;110;42;6206;3084;17.6;8.7
08;2021-05-28;33;1;6239;3085;17.7;8.7
08;2021-05-29;59;215;6298;3300;17.8;9.3
08;2021-05-30;0;0;6298;3300;17.8;9.3
08;2021-05-31;109;63;6407;3363;18.1;9.5
08;2021-06-01;112;63;6519;3426;18.4;9.7
08;2021-06-02;130;33;6649;3459;18.8;9.8
08;2021-06-03;100;38;6749;3497;19.1;9.9
08;2021-06-04;128;71;6877;3568;19.5;10.1
08;2021-06-05;82;21;6959;3589;19.7;10.2
08;2021-06-06;0;0;6959;3589;19.7;10.2
08;2021-06-07;98;94;7057;3683;20.0;10.4
08;2021-06-08;79;90;7136;3773;20.2;10.7
08;2021-06-09;98;74;7234;3847;20.5;10.9
08;2021-06-10;111;66;7345;3913;20.8;11.1
08;2021-06-11;116;108;7461;4021;21.1;11.4
08;2021-06-12;57;30;7518;4051;21.3;11.5
08;2021-06-13;0;0;7518;4051;21.3;11.5
08;2021-06-14;106;128;7624;4179;21.6;11.8
08;2021-06-15;87;118;7711;4297;21.8;12.2
08;2021-06-16;104;148;7815;4445;22.1;12.6
08;2021-06-17;84;72;7899;4517;22.4;12.8
08;2021-06-18;66;99;7965;4616;22.5;13.1
08;2021-06-19;66;79;8031;4695;22.7;13.3
08;2021-06-20;0;0;8031;4695;22.7;13.3
08;2021-06-21;81;149;8112;4844;23.0;13.7
08;2021-06-22;72;100;8184;4944;23.2;14.0
08;2021-06-23;70;113;8254;5057;23.4;14.3
08;2021-06-24;45;73;8299;5130;23.5;14.5
08;2021-06-25;63;99;8362;5229;23.7;14.8
08;2021-06-26;35;61;8397;5290;23.8;15.0
08;2021-06-27;0;0;8397;5290;23.8;15.0
08;2021-06-28;70;127;8467;5417;24.0;15.3
08;2021-06-29;57;100;8524;5517;24.1;15.6
11;2020-12-27;13;2;13;2;0.0;0.0
11;2020-12-28;11;0;24;2;0.0;0.0
11;2020-12-29;56;0;80;2;0.0;0.0
11;2020-12-30;91;0;171;2;0.0;0.0
11;2020-12-31;39;0;210;2;0.0;0.0
11;2021-01-01;31;1;241;3;0.0;0.0
11;2021-01-02;64;1;305;4;0.0;0.0
11;2021-01-03;78;0;383;4;0.0;0.0
11;2021-01-04;554;5;937;9;0.0;0.0
11;2021-01-05;2070;17;3007;26;0.0;0.0
11;2021-01-06;3022;23;6029;49;0.0;0.0
11;2021-01-07;5389;38;11418;87;0.1;0.0
11;2021-01-08;7125;48;18543;135;0.2;0.0
11;2021-01-09;1890;7;20433;142;0.2;0.0
11;2021-01-10;1755;7;22188;149;0.2;0.0
11;2021-01-11;8016;67;30204;216;0.2;0.0
11;2021-01-12;10373;102;40577;318;0.3;0.0
11;2021-01-13;10021;100;50598;418;0.4;0.0
11;2021-01-14;10129;135;60727;553;0.5;0.0
11;2021-01-15;8923;88;69650;641;0.6;0.0
11;2021-01-16;2413;37;72063;678;0.6;0.0
11;2021-01-17;1090;19;73153;697;0.6;0.0
11;2021-01-18;12264;136;85417;833;0.7;0.0
11;2021-01-19;15860;128;101277;961;0.8;0.0
11;2021-01-20;18384;122;119661;1083;1.0;0.0
11;2021-01-21;22295;155;141956;1238;1.2;0.0
11;2021-01-22;17112;168;159068;1406;1.3;0.0
11;2021-01-23;4964;21;164032;1427;1.3;0.0
11;2021-01-24;1283;6;165315;1433;1.3;0.0
11;2021-01-25;8875;193;174190;1626;1.4;0.0
11;2021-01-26;12342;387;186532;2013;1.5;0.0
11;2021-01-27;16234;693;202766;2706;1.7;0.0
11;2021-01-28;20307;1197;223073;3903;1.8;0.0
11;2021-01-29;15397;1389;238470;5292;1.9;0.0
11;2021-01-30;4465;106;242935;5398;2.0;0.0
11;2021-01-31;585;22;243520;5420;2.0;0.0
11;2021-02-01;7389;1960;250909;7380;2.0;0.1
11;2021-02-02;8356;2821;259265;10201;2.1;0.1
11;2021-02-03;8126;3806;267391;14007;2.2;0.1
11;2021-02-04;8788;4595;276179;18602;2.2;0.2
11;2021-02-05;8957;4427;285136;23029;2.3;0.2
11;2021-02-06;3273;752;288409;23781;2.3;0.2
11;2021-02-07;589;543;288998;24324;2.4;0.2
11;2021-02-08;6236;5919;295234;30243;2.4;0.2
11;2021-02-09;8455;9676;303689;39919;2.5;0.3
11;2021-02-10;10017;11196;313706;51115;2.6;0.4
11;2021-02-11;12374;16491;326080;67606;2.7;0.6
11;2021-02-12;11882;10617;337962;78223;2.8;0.6
11;2021-02-13;2594;2591;340556;80814;2.8;0.7
11;2021-02-14;312;560;340868;81374;2.8;0.7
11;2021-02-15;4467;12026;345335;93400;2.8;0.8
11;2021-02-16;5683;18510;351018;111910;2.9;0.9
11;2021-02-17;5691;15623;356709;127533;2.9;1.0
11;2021-02-18;8656;20805;365365;148338;3.0;1.2
11;2021-02-19;9071;15440;374436;163778;3.0;1.3
11;2021-02-20;1694;4847;376130;168625;3.1;1.4
11;2021-02-21;397;830;376527;169455;3.1;1.4
11;2021-02-22;4241;9925;380768;179380;3.1;1.5
11;2021-02-23;4959;10557;385727;189937;3.1;1.5
11;2021-02-24;5420;9886;391147;199823;3.2;1.6
11;2021-02-25;8642;14162;399789;213985;3.3;1.7
11;2021-02-26;11197;10202;410986;224187;3.3;1.8
11;2021-02-27;5069;3340;416055;227527;3.4;1.9
11;2021-02-28;742;661;416797;228188;3.4;1.9
11;2021-03-01;8857;8004;425654;236192;3.5;1.9
11;2021-03-02;14396;9672;440050;245864;3.6;2.0
11;2021-03-03;18688;10152;458738;256016;3.7;2.1
11;2021-03-04;28282;11171;487020;267187;4.0;2.2
11;2021-03-05;36521;11157;523541;278344;4.3;2.3
11;2021-03-06;46438;3617;569979;281961;4.6;2.3
11;2021-03-07;34307;2816;604286;284777;4.9;2.3
11;2021-03-08;17777;7442;622063;292219;5.1;2.4
11;2021-03-09;26872;7779;648935;299998;5.3;2.4
11;2021-03-10;27665;8411;676600;308409;5.5;2.5
11;2021-03-11;37065;9980;713665;318389;5.8;2.6
11;2021-03-12;44818;9521;758483;327910;6.2;2.7
11;2021-03-13;39893;2730;798376;330640;6.5;2.7
11;2021-03-14;14276;826;812652;331466;6.6;2.7
11;2021-03-15;29233;4057;841885;335523;6.9;2.7
11;2021-03-16;23764;3892;865649;339415;7.1;2.8
11;2021-03-17;24446;3703;890095;343118;7.2;2.8
11;2021-03-18;29026;4173;919121;347291;7.5;2.8
11;2021-03-19;39685;4368;958806;351659;7.8;2.9
11;2021-03-20;25875;1626;984681;353285;8.0;2.9
11;2021-03-21;5628;1339;990309;354624;8.1;2.9
11;2021-03-22;32148;4295;1022457;358919;8.3;2.9
11;2021-03-23;43330;5523;1065787;364442;8.7;3.0
11;2021-03-24;42665;5141;1108452;369583;9.0;3.0
11;2021-03-25;57941;5348;1166393;374931;9.5;3.1
11;2021-03-26;57758;6098;1224151;381029;10.0;3.1
11;2021-03-27;34511;2158;1258662;383187;10.3;3.1
11;2021-03-28;10162;505;1268824;383692;10.3;3.1
11;2021-03-29;33072;8241;1301896;391933;10.6;3.2
11;2021-03-30;44893;11693;1346789;403626;11.0;3.3
11;2021-03-31;39916;14012;1386705;417638;11.3;3.4
11;2021-04-01;45408;21914;1432113;439552;11.7;3.6
11;2021-04-02;39430;24199;1471543;463751;12.0;3.8
11;2021-04-03;18397;21189;1489940;484940;12.1;3.9
11;2021-04-04;6121;7363;1496061;492303;12.2;4.0
11;2021-04-05;5962;2172;1502023;494475;12.2;4.0
11;2021-04-06;30008;18515;1532031;512990;12.5;4.2
11;2021-04-07;37584;20106;1569615;533096;12.8;4.3
11;2021-04-08;46710;21237;1616325;554333;13.2;4.5
11;2021-04-09;53834;21723;1670159;576056;13.6;4.7
11;2021-04-10;28984;19772;1699143;595828;13.8;4.9
11;2021-04-11;6551;7242;1705694;603070;13.9;4.9
11;2021-04-12;30340;19352;1736034;622422;14.1;5.1
11;2021-04-13;37349;27672;1773383;650094;14.4;5.3
11;2021-04-14;35039;24429;1808422;674523;14.7;5.5
11;2021-04-15;39196;28611;1847618;703134;15.0;5.7
11;2021-04-16;41086;27913;1888704;731047;15.4;6.0
11;2021-04-17;22803;15037;1911507;746084;15.6;6.1
11;2021-04-18;5303;3748;1916810;749832;15.6;6.1
11;2021-04-19;25116;23259;1941926;773091;15.8;6.3
11;2021-04-20;30620;27973;1972546;801064;16.1;6.5
11;2021-04-21;32260;28298;2004806;829362;16.3;6.8
11;2021-04-22;34514;34847;2039320;864209;16.6;7.0
11;2021-04-23;37985;32417;2077305;896626;16.9;7.3
11;2021-04-24;37988;23252;2115293;919878;17.2;7.5
11;2021-04-25;20524;8041;2135817;927919;17.4;7.6
11;2021-04-26;33912;25311;2169729;953230;17.7;7.8
11;2021-04-27;45781;30202;2215510;983432;18.0;8.0
11;2021-04-28;48493;29939;2264003;1013371;18.4;8.3
11;2021-04-29;57851;32438;2321854;1045809;18.9;8.5
11;2021-04-30;61349;31223;2383203;1077032;19.4;8.8
11;2021-05-01;24106;6073;2407309;1083105;19.6;8.8
11;2021-05-02;14631;5037;2421940;1088142;19.7;8.9
11;2021-05-03;54452;35347;2476392;1123489;20.2;9.2
11;2021-05-04;59784;33998;2536176;1157487;20.7;9.4
11;2021-05-05;60358;34217;2596534;1191704;21.1;9.7
11;2021-05-06;67301;38179;2663835;1229883;21.7;10.0
11;2021-05-07;65604;40109;2729439;1269992;22.2;10.3
11;2021-05-08;51189;16993;2780628;1286985;22.6;10.5
11;2021-05-09;33187;10255;2813815;1297240;22.9;10.6
11;2021-05-10;70854;30681;2884669;1327921;23.5;10.8
11;2021-05-11;81871;38207;2966540;1366128;24.2;11.1
11;2021-05-12;83692;32589;3050232;1398717;24.8;11.4
11;2021-05-13;68208;10089;3118440;1408806;25.4;11.5
11;2021-05-14;84643;22266;3203083;1431072;26.1;11.7
11;2021-05-15;66806;15513;3269889;1446585;26.6;11.8
11;2021-05-16;36711;5221;3306600;1451806;26.9;11.8
11;2021-05-17;82933;17030;3389533;1468836;27.6;12.0
11;2021-05-18;99693;20080;3489226;1488916;28.4;12.1
11;2021-05-19;98221;27960;3587447;1516876;29.2;12.4
11;2021-05-20;106894;28939;3694341;1545815;30.1;12.6
11;2021-05-21;101232;26113;3795573;1571928;30.9;12.8
11;2021-05-22;79545;14933;3875118;1586861;31.6;12.9
11;2021-05-23;41729;6103;3916847;1592964;31.9;13.0
11;2021-05-24;59696;8837;3976543;1601801;32.4;13.0
11;2021-05-25;85490;32331;4062033;1634132;33.1;13.3
11;2021-05-26;84032;32586;4146065;1666718;33.8;13.6
11;2021-05-27;92229;40651;4238294;1707369;34.5;13.9
11;2021-05-28;86888;45695;4325182;1753064;35.2;14.3
11;2021-05-29;68207;27606;4393389;1780670;35.8;14.5
11;2021-05-30;35948;8549;4429337;1789219;36.1;14.6
11;2021-05-31;77946;40039;4507283;1829258;36.7;14.9
11;2021-06-01;86983;51026;4594266;1880284;37.4;15.3
11;2021-06-02;83023;45647;4677289;1925931;38.1;15.7
11;2021-06-03;88800;53792;4766089;1979723;38.8;16.1
11;2021-06-04;84597;58858;4850686;2038581;39.5;16.6
11;2021-06-05;63552;49998;4914238;2088579;40.0;17.0
11;2021-06-06;37901;17616;4952139;2106195;40.3;17.2
11;2021-06-07;68887;53711;5021026;2159906;40.9;17.6
11;2021-06-08;72288;61962;5093314;2221868;41.5;18.1
11;2021-06-09;70448;63172;5163762;2285040;42.1;18.6
11;2021-06-10;70919;80889;5234681;2365929;42.6;19.3
11;2021-06-11;65515;72171;5300196;2438100;43.2;19.9
11;2021-06-12;63679;47730;5363875;2485830;43.7;20.2
11;2021-06-13;29520;22885;5393395;2508715;43.9;20.4
11;2021-06-14;43162;75314;5436557;2584029;44.3;21.0
11;2021-06-15;51040;82997;5487597;2667026;44.7;21.7
11;2021-06-16;52312;78293;5539909;2745319;45.1;22.4
11;2021-06-17;54002;81788;5593911;2827107;45.6;23.0
11;2021-06-18;49929;96038;5643840;2923145;46.0;23.8
11;2021-06-19;43474;69211;5687314;2992356;46.3;24.4
11;2021-06-20;16295;36078;5703609;3028434;46.5;24.7
11;2021-06-21;34337;84371;5737946;3112805;46.7;25.4
11;2021-06-22;38960;101211;5776906;3214016;47.1;26.2
11;2021-06-23;39420;98201;5816326;3312217;47.4;27.0
11;2021-06-24;42222;96125;5858548;3408342;47.7;27.8
11;2021-06-25;38485;110704;5897033;3519046;48.0;28.7
11;2021-06-26;35243;86044;5932276;3605090;48.3;29.4
11;2021-06-27;13287;40354;5945563;3645444;48.4;29.7
11;2021-06-28;30035;95860;5975598;3741304;48.7;30.5
11;2021-06-29;34255;107674;6009853;3848978;48.9;31.3
24;2020-12-27;0;0;0;0;0.0;0.0
24;2020-12-28;17;0;17;0;0.0;0.0
24;2020-12-29;10;0;27;0;0.0;0.0
24;2020-12-30;1;0;28;0;0.0;0.0
24;2020-12-31;0;0;28;0;0.0;0.0
24;2021-01-01;1;0;29;0;0.0;0.0
24;2021-01-02;0;0;29;0;0.0;0.0
24;2021-01-03;0;0;29;0;0.0;0.0
24;2021-01-04;24;0;53;0;0.0;0.0
24;2021-01-05;163;0;216;0;0.0;0.0
24;2021-01-06;328;0;544;0;0.0;0.0
24;2021-01-07;492;1;1036;1;0.0;0.0
24;2021-01-08;952;2;1988;3;0.1;0.0
24;2021-01-09;504;0;2492;3;0.1;0.0
24;2021-01-10;395;0;2887;3;0.1;0.0
24;2021-01-11;1279;2;4166;5;0.2;0.0
24;2021-01-12;2575;9;6741;14;0.3;0.0
24;2021-01-13;2189;8;8930;22;0.3;0.0
24;2021-01-14;2503;53;11433;75;0.4;0.0
24;2021-01-15;2114;9;13547;84;0.5;0.0
24;2021-01-16;857;5;14404;89;0.6;0.0
24;2021-01-17;322;3;14726;92;0.6;0.0
24;2021-01-18;3214;16;17940;108;0.7;0.0
24;2021-01-19;6325;17;24265;125;0.9;0.0
24;2021-01-20;7167;10;31432;135;1.2;0.0
24;2021-01-21;7418;4;38850;139;1.5;0.0
24;2021-01-22;5119;5;43969;144;1.7;0.0
24;2021-01-23;1275;1;45244;145;1.8;0.0
24;2021-01-24;225;1;45469;146;1.8;0.0
24;2021-01-25;3114;24;48583;170;1.9;0.0
24;2021-01-26;4849;88;53432;258;2.1;0.0
24;2021-01-27;5045;185;58477;443;2.3;0.0
24;2021-01-28;5634;508;64111;951;2.5;0.0
24;2021-01-29;3422;731;67533;1682;2.6;0.1
24;2021-01-30;1210;397;68743;2079;2.7;0.1
24;2021-01-31;251;368;68994;2447;2.7;0.1
24;2021-02-01;2171;927;71165;3374;2.8;0.1
24;2021-02-02;3034;1889;74199;5263;2.9;0.2
24;2021-02-03;3111;1767;77310;7030;3.0;0.3
24;2021-02-04;3236;1616;80546;8646;3.1;0.3
24;2021-02-05;2398;1368;82944;10014;3.2;0.4
24;2021-02-06;707;263;83651;10277;3.3;0.4
24;2021-02-07;134;32;83785;10309;3.3;0.4
24;2021-02-08;1967;1571;85752;11880;3.4;0.5
24;2021-02-09;3414;3319;89166;15199;3.5;0.6
24;2021-02-10;4086;3756;93252;18955;3.6;0.7
24;2021-02-11;4659;4773;97911;23728;3.8;0.9
24;2021-02-12;3482;3271;101393;26999;4.0;1.1
24;2021-02-13;840;769;102233;27768;4.0;1.1
24;2021-02-14;426;256;102659;28024;4.0;1.1
24;2021-02-15;1966;2857;104625;30881;4.1;1.2
24;2021-02-16;2858;4488;107483;35369;4.2;1.4
24;2021-02-17;2699;5099;110182;40468;4.3;1.6
24;2021-02-18;3524;5170;113706;45638;4.4;1.8
24;2021-02-19;3207;3551;116913;49189;4.6;1.9
24;2021-02-20;1290;983;118203;50172;4.6;2.0
24;2021-02-21;433;239;118636;50411;4.6;2.0
24;2021-02-22;1656;3054;120292;53465;4.7;2.1
24;2021-02-23;2343;3136;122635;56601;4.8;2.2
24;2021-02-24;2102;3457;124737;60058;4.9;2.3
24;2021-02-25;3637;3153;128374;63211;5.0;2.5
24;2021-02-26;4480;2611;132854;65822;5.2;2.6
24;2021-02-27;1877;994;134731;66816;5.3;2.6
24;2021-02-28;97;219;134828;67035;5.3;2.6
24;2021-03-01;2179;2017;137007;69052;5.4;2.7
24;2021-03-02;3438;2887;140445;71939;5.5;2.8
24;2021-03-03;3556;3407;144001;75346;5.6;2.9
24;2021-03-04;5341;3716;149342;79062;5.8;3.1
24;2021-03-05;7041;3173;156383;82235;6.1;3.2
24;2021-03-06;7376;753;163759;82988;6.4;3.2
24;2021-03-07;2430;290;166189;83278;6.5;3.3
24;2021-03-08;2700;2613;168889;85891;6.6;3.4
24;2021-03-09;5788;2841;174677;88732;6.8;3.5
24;2021-03-10;6424;3513;181101;92245;7.1;3.6
24;2021-03-11;7816;3503;188917;95748;7.4;3.7
24;2021-03-12;10797;2688;199714;98436;7.8;3.8
24;2021-03-13;7120;725;206834;99161;8.1;3.9
24;2021-03-14;1549;270;208383;99431;8.1;3.9
24;2021-03-15;4565;1972;212948;101403;8.3;4.0
24;2021-03-16;4604;2362;217552;103765;8.5;4.1
24;2021-03-17;4474;1976;222026;105741;8.7;4.1
24;2021-03-18;5070;2086;227096;107827;8.9;4.2
24;2021-03-19;7783;1680;234879;109507;9.2;4.3
24;2021-03-20;4435;883;239314;110390;9.4;4.3
24;2021-03-21;557;349;239871;110739;9.4;4.3
24;2021-03-22;4867;1714;244738;112453;9.6;4.4
24;2021-03-23;8038;2298;252776;114751;9.9;4.5
24;2021-03-24;8819;2011;261595;116762;10.2;4.6
24;2021-03-25;12151;1963;273746;118725;10.7;4.6
24;2021-03-26;13278;1992;287024;120717;11.2;4.7
24;2021-03-27;5779;679;292803;121396;11.4;4.7
24;2021-03-28;520;97;293323;121493;11.5;4.7
24;2021-03-29;6770;1878;300093;123371;11.7;4.8
24;2021-03-30;10184;2790;310277;126161;12.1;4.9
24;2021-03-31;9898;2347;320175;128508;12.5;5.0
24;2021-04-01;12049;3395;332224;131903;13.0;5.2
24;2021-04-02;10630;3346;342854;135249;13.4;5.3
24;2021-04-03;3412;1717;346266;136966;13.5;5.4
24;2021-04-04;394;344;346660;137310;13.5;5.4
24;2021-04-05;397;51;347057;137361;13.6;5.4
24;2021-04-06;8340;3408;355397;140769;13.9;5.5
24;2021-04-07;11070;4551;366467;145320;14.3;5.7
24;2021-04-08;14196;4741;380663;150061;14.9;5.9
24;2021-04-09;17755;3721;398418;153782;15.6;6.0
24;2021-04-10;9387;2081;407805;155863;15.9;6.1
24;2021-04-11;2909;1248;410714;157111;16.0;6.1
24;2021-04-12;10850;3444;421564;160555;16.5;6.3
24;2021-04-13;15007;4812;436571;165367;17.1;6.5
24;2021-04-14;13472;4922;450043;170289;17.6;6.7
24;2021-04-15;15347;5127;465390;175416;18.2;6.9
24;2021-04-16;15692;4336;481082;179752;18.8;7.0
24;2021-04-17;8195;1321;489277;181073;19.1;7.1
24;2021-04-18;1100;289;490377;181362;19.2;7.1
24;2021-04-19;9455;4138;499832;185500;19.5;7.2
24;2021-04-20;12735;5969;512567;191469;20.0;7.5
24;2021-04-21;12333;6000;524900;197469;20.5;7.7
24;2021-04-22;13868;7540;538768;205009;21.1;8.0
24;2021-04-23;13704;7044;552472;212053;21.6;8.3
24;2021-04-24;10241;3255;562713;215308;22.0;8.4
24;2021-04-25;3048;433;565761;215741;22.1;8.4
24;2021-04-26;10214;5424;575975;221165;22.5;8.6
24;2021-04-27;13891;7749;589866;228914;23.0;8.9
24;2021-04-28;13036;8445;602902;237359;23.6;9.3
24;2021-04-29;16590;8590;619492;245949;24.2;9.6
24;2021-04-30;17483;7236;636975;253185;24.9;9.9
24;2021-05-01;2911;671;639886;253856;25.0;9.9
24;2021-05-02;2142;320;642028;254176;25.1;9.9
24;2021-05-03;11313;6106;653341;260282;25.5;10.2
24;2021-05-04;12824;10293;666165;270575;26.0;10.6
24;2021-05-05;13892;9575;680057;280150;26.6;10.9
24;2021-05-06;17506;9670;697563;289820;27.3;11.3
24;2021-05-07;14557;11981;712120;301801;27.8;11.8
24;2021-05-08;3707;2376;715827;304177;28.0;11.9
24;2021-05-09;2326;3731;718153;307908;28.1;12.0
24;2021-05-10;11531;12190;729684;320098;28.5;12.5
24;2021-05-11;16383;14200;746067;334298;29.2;13.1
24;2021-05-12;18259;13141;764326;347439;29.9;13.6
24;2021-05-13;6927;3168;771253;350607;30.1;13.7
24;2021-05-14;14527;9177;785780;359784;30.7;14.1
24;2021-05-15;10472;5051;796252;364835;31.1;14.3
24;2021-05-16;3167;1188;799419;366023;31.2;14.3
24;2021-05-17;13338;7662;812757;373685;31.8;14.6
24;2021-05-18;18550;8200;831307;381885;32.5;14.9
24;2021-05-19;19046;7496;850353;389381;33.2;15.2
24;2021-05-20;21340;8421;871693;397802;34.1;15.5
24;2021-05-21;18408;9085;890101;406887;34.8;15.9
24;2021-05-22;7626;4190;897727;411077;35.1;16.1
24;2021-05-23;2983;942;900710;412019;35.2;16.1
24;2021-05-24;8347;1592;909057;413611;35.5;16.2
24;2021-05-25;17760;8843;926817;422454;36.2;16.5
24;2021-05-26;19280;8289;946097;430743;37.0;16.8
24;2021-05-27;20902;10036;966999;440779;37.8;17.2
24;2021-05-28;20475;12259;987474;453038;38.6;17.7
24;2021-05-29;12422;5901;999896;458939;39.1;17.9
24;2021-05-30;2033;1485;1001929;460424;39.2;18.0
24;2021-05-31;14600;8900;1016529;469324;39.7;18.3
24;2021-06-01;19720;12005;1036249;481329;40.5;18.8
24;2021-06-02;17760;10800;1054009;492129;41.2;19.2
24;2021-06-03;20870;11908;1074879;504037;42.0;19.7
24;2021-06-04;19936;13855;1094815;517892;42.8;20.2
24;2021-06-05;9868;8855;1104683;526747;43.2;20.6
24;2021-06-06;1992;3021;1106675;529768;43.2;20.7
24;2021-06-07;14430;12015;1121105;541783;43.8;21.2
24;2021-06-08;16082;14956;1137187;556739;44.4;21.8
24;2021-06-09;16467;12767;1153654;569506;45.1;22.3
24;2021-06-10;17882;12112;1171536;581618;45.8;22.7
24;2021-06-11;17165;15305;1188701;596923;46.5;23.3
24;2021-06-12;10075;7334;1198776;604257;46.8;23.6
24;2021-06-13;892;1313;1199668;605570;46.9;23.7
24;2021-06-14;10462;15265;1210130;620835;47.3;24.3
24;2021-06-15;12981;17118;1223111;637953;47.8;24.9
24;2021-06-16;13455;16271;1236566;654224;48.3;25.6
24;2021-06-17;13116;17310;1249682;671534;48.8;26.2
24;2021-06-18;14551;19824;1264233;691358;49.4;27.0
24;2021-06-19;7923;6654;1272156;698012;49.7;27.3
24;2021-06-20;554;858;1272710;698870;49.7;27.3
24;2021-06-21;8844;16479;1281554;715349;50.1;28.0
24;2021-06-22;10214;19410;1291768;734759;50.5;28.7
24;2021-06-23;9713;17861;1301481;752620;50.9;29.4
24;2021-06-24;8995;12868;1310476;765488;51.2;29.9
24;2021-06-25;10654;19886;1321130;785374;51.6;30.7
24;2021-06-26;5289;10972;1326419;796346;51.8;31.1
24;2021-06-27;795;2214;1327214;798560;51.9;31.2
24;2021-06-28;6486;18529;1333700;817089;52.1;31.9
24;2021-06-29;7947;23971;1341647;841060;52.4;32.9
27;2020-12-27;4;0;4;0;0.0;0.0
27;2020-12-28;0;0;4;0;0.0;0.0
27;2020-12-29;19;0;23;0;0.0;0.0
27;2020-12-30;20;0;43;0;0.0;0.0
27;2020-12-31;2;0;45;0;0.0;0.0
27;2021-01-01;0;0;45;0;0.0;0.0
27;2021-01-02;1;0;46;0;0.0;0.0
27;2021-01-03;1;0;47;0;0.0;0.0
27;2021-01-04;27;0;74;0;0.0;0.0
27;2021-01-05;263;2;337;2;0.0;0.0
27;2021-01-06;718;1;1055;3;0.0;0.0
27;2021-01-07;1581;3;2636;6;0.1;0.0
27;2021-01-08;1896;4;4532;10;0.2;0.0
27;2021-01-09;689;0;5221;10;0.2;0.0
27;2021-01-10;3;0;5224;10;0.2;0.0
27;2021-01-11;2420;4;7644;14;0.3;0.0
27;2021-01-12;3823;4;11467;18;0.4;0.0
27;2021-01-13;3848;8;15315;26;0.6;0.0
27;2021-01-14;4753;48;20068;74;0.7;0.0
27;2021-01-15;3593;22;23661;96;0.9;0.0
27;2021-01-16;793;11;24454;107;0.9;0.0
27;2021-01-17;116;1;24570;108;0.9;0.0
27;2021-01-18;6256;20;30826;128;1.1;0.0
27;2021-01-19;8398;23;39224;151;1.4;0.0
27;2021-01-20;7908;59;47132;210;1.7;0.0
27;2021-01-21;9456;23;56588;233;2.0;0.0
27;2021-01-22;7708;18;64296;251;2.3;0.0
27;2021-01-23;2986;6;67282;257;2.4;0.0
27;2021-01-24;347;0;67629;257;2.4;0.0
27;2021-01-25;5220;30;72849;287;2.6;0.0
27;2021-01-26;7391;229;80240;516;2.9;0.0
27;2021-01-27;7096;355;87336;871;3.1;0.0
27;2021-01-28;6336;896;93672;1767;3.4;0.1
27;2021-01-29;5930;1267;99602;3034;3.6;0.1
27;2021-01-30;2496;347;102098;3381;3.7;0.1
27;2021-01-31;252;22;102350;3403;3.7;0.1
27;2021-02-01;3360;1402;105710;4805;3.8;0.2
27;2021-02-02;4040;2225;109750;7030;3.9;0.3
27;2021-02-03;3619;2397;113369;9427;4.1;0.3
27;2021-02-04;3704;3152;117073;12579;4.2;0.5
27;2021-02-05;3242;2586;120315;15165;4.3;0.5
27;2021-02-06;1608;672;121923;15837;4.4;0.6
27;2021-02-07;5;87;121928;15924;4.4;0.6
27;2021-02-08;2914;2686;124842;18610;4.5;0.7
27;2021-02-09;3017;3660;127859;22270;4.6;0.8
27;2021-02-10;3055;3413;130914;25683;4.7;0.9
27;2021-02-11;3318;4653;134232;30336;4.8;1.1
27;2021-02-12;2727;4463;136959;34799;4.9;1.3
27;2021-02-13;987;1466;137946;36265;5.0;1.3
27;2021-02-14;258;301;138204;36566;5.0;1.3
27;2021-02-15;1243;5757;139447;42323;5.0;1.5
27;2021-02-16;1508;7439;140955;49762;5.1;1.8
27;2021-02-17;1812;6912;142767;56674;5.1;2.0
27;2021-02-18;2152;6466;144919;63140;5.2;2.3
27;2021-02-19;1740;5670;146659;68810;5.3;2.5
27;2021-02-20;713;2179;147372;70989;5.3;2.6
27;2021-02-21;2;280;147374;71269;5.3;2.6
27;2021-02-22;982;4898;148356;76167;5.3;2.7
27;2021-02-23;1211;5441;149567;81608;5.4;2.9
27;2021-02-24;1509;4870;151076;86478;5.4;3.1
27;2021-02-25;2926;5061;154002;91539;5.5;3.3
27;2021-02-26;3687;4220;157689;95759;5.7;3.4
27;2021-02-27;1911;1959;159600;97718;5.7;3.5
27;2021-02-28;107;282;159707;98000;5.7;3.5
27;2021-03-01;3675;3511;163382;101511;5.9;3.6
27;2021-03-02;5412;4342;168794;105853;6.1;3.8
27;2021-03-03;5967;3576;174761;109429;6.3;3.9
27;2021-03-04;7710;3576;182471;113005;6.6;4.1
27;2021-03-05;9702;3203;192173;116208;6.9;4.2
27;2021-03-06;6229;1090;198402;117298;7.1;4.2
27;2021-03-07;872;187;199274;117485;7.2;4.2
27;2021-03-08;4546;3423;203820;120908;7.3;4.3
27;2021-03-09;8422;3409;212242;124317;7.6;4.5
27;2021-03-10;8725;2816;220967;127133;7.9;4.6
27;2021-03-11;10275;3210;231242;130343;8.3;4.7
27;2021-03-12;11900;2473;243142;132816;8.7;4.8
27;2021-03-13;7051;699;250193;133515;9.0;4.8
27;2021-03-14;213;60;250406;133575;9.0;4.8
27;2021-03-15;7323;1384;257729;134959;9.3;4.8
27;2021-03-16;8248;1095;265977;136054;9.6;4.9
27;2021-03-17;8539;1183;274516;137237;9.9;4.9
27;2021-03-18;8632;1419;283148;138656;10.2;5.0
27;2021-03-19;9443;1101;292591;139757;10.5;5.0
27;2021-03-20;5670;399;298261;140156;10.7;5.0
27;2021-03-21;238;11;298499;140167;10.7;5.0
27;2021-03-22;9337;965;307836;141132;11.1;5.1
27;2021-03-23;14725;1202;322561;142334;11.6;5.1
27;2021-03-24;15198;1251;337759;143585;12.1;5.2
27;2021-03-25;18383;1473;356142;145058;12.8;5.2
27;2021-03-26;18394;1274;374536;146332;13.5;5.3
27;2021-03-27;7684;414;382220;146746;13.7;5.3
27;2021-03-28;492;124;382712;146870;13.8;5.3
27;2021-03-29;10033;3405;392745;150275;14.1;5.4
27;2021-03-30;12975;4011;405720;154286;14.6;5.5
27;2021-03-31;12842;4212;418562;158498;15.0;5.7
27;2021-04-01;14560;4152;433122;162650;15.6;5.8
27;2021-04-02;12960;4050;446082;166700;16.0;6.0
27;2021-04-03;4479;1138;450561;167838;16.2;6.0
27;2021-04-04;69;35;450630;167873;16.2;6.0
27;2021-04-05;345;7;450975;167880;16.2;6.0
27;2021-04-06;9573;6181;460548;174061;16.5;6.3
27;2021-04-07;10197;6467;470745;180528;16.9;6.5
27;2021-04-08;15732;6154;486477;186682;17.5;6.7
27;2021-04-09;17846;6010;504323;192692;18.1;6.9
27;2021-04-10;6069;1951;510392;194643;18.3;7.0
27;2021-04-11;420;83;510812;194726;18.4;7.0
27;2021-04-12;9073;6795;519885;201521;18.7;7.2
27;2021-04-13;11750;8509;531635;210030;19.1;7.5
27;2021-04-14;10303;7836;541938;217866;19.5;7.8
27;2021-04-15;12970;7676;554908;225542;19.9;8.1
27;2021-04-16;12758;6447;567666;231989;20.4;8.3
27;2021-04-17;5924;3036;573590;235025;20.6;8.4
27;2021-04-18;354;189;573944;235214;20.6;8.5
27;2021-04-19;6980;8856;580924;244070;20.9;8.8
27;2021-04-20;8492;10532;589416;254602;21.2;9.1
27;2021-04-21;8352;10137;597768;264739;21.5;9.5
27;2021-04-22;9867;11524;607635;276263;21.8;9.9
27;2021-04-23;11342;10292;618977;286555;22.2;10.3
27;2021-04-24;5167;3960;624144;290515;22.4;10.4
27;2021-04-25;440;295;624584;290810;22.4;10.4
27;2021-04-26;9566;8732;634150;299542;22.8;10.8
27;2021-04-27;13477;10237;647627;309779;23.3;11.1
27;2021-04-28;14201;10352;661828;320131;23.8;11.5
27;2021-04-29;17877;11525;679705;331656;24.4;11.9
27;2021-04-30;18733;9493;698438;341149;25.1;12.3
27;2021-05-01;5426;1544;703864;342693;25.3;12.3
27;2021-05-02;603;73;704467;342766;25.3;12.3
27;2021-05-03;14909;6323;719376;349089;25.8;12.5
27;2021-05-04;13950;10787;733326;359876;26.3;12.9
27;2021-05-05;15566;10008;748892;369884;26.9;13.3
27;2021-05-06;18289;12324;767181;382208;27.6;13.7
27;2021-05-07;17227;11745;784408;393953;28.2;14.2
27;2021-05-08;5947;1507;790355;395460;28.4;14.2
27;2021-05-09;533;439;790888;395899;28.4;14.2
27;2021-05-10;15280;9873;806168;405772;29.0;14.6
27;2021-05-11;20771;12901;826939;418673;29.7;15.0
27;2021-05-12;19674;11735;846613;430408;30.4;15.5
27;2021-05-13;12293;2036;858906;432444;30.9;15.5
27;2021-05-14;22938;8382;881844;440826;31.7;15.8
27;2021-05-15;15413;3399;897257;444225;32.2;16.0
27;2021-05-16;1890;236;899147;444461;32.3;16.0
27;2021-05-17;18975;6793;918122;451254;33.0;16.2
27;2021-05-18;20733;9283;938855;460537;33.7;16.5
27;2021-05-19;22272;7290;961127;467827;34.5;16.8
27;2021-05-20;23210;8201;984337;476028;35.4;17.1
27;2021-05-21;21096;10039;1005433;486067;36.1;17.5
27;2021-05-22;8263;3599;1013696;489666;36.4;17.6
27;2021-05-23;909;305;1014605;489971;36.5;17.6
27;2021-05-24;4232;1083;1018837;491054;36.6;17.6
27;2021-05-25;14898;11605;1033735;502659;37.1;18.1
27;2021-05-26;15387;10640;1049122;513299;37.7;18.4
27;2021-05-27;18404;11794;1067526;525093;38.4;18.9
27;2021-05-28;16089;14115;1083615;539208;38.9;19.4
27;2021-05-29;6819;5152;1090434;544360;39.2;19.6
27;2021-05-30;391;255;1090825;544615;39.2;19.6
27;2021-05-31;13315;10926;1104140;555541;39.7;20.0
27;2021-06-01;16530;13417;1120670;568958;40.3;20.4
27;2021-06-02;16165;11445;1136835;580403;40.8;20.9
27;2021-06-03;17744;11856;1154579;592259;41.5;21.3
27;2021-06-04;16173;14612;1170752;606871;42.1;21.8
27;2021-06-05;8340;6758;1179092;613629;42.4;22.0
27;2021-06-06;1717;645;1180809;614274;42.4;22.1
27;2021-06-07;17450;13086;1198259;627360;43.1;22.5
27;2021-06-08;19664;15325;1217923;642685;43.8;23.1
27;2021-06-09;19042;12488;1236965;655173;44.4;23.5
27;2021-06-10;19000;13893;1255965;669066;45.1;24.0
27;2021-06-11;18109;17084;1274074;686150;45.8;24.7
27;2021-06-12;9468;7841;1283542;693991;46.1;24.9
27;2021-06-13;942;948;1284484;694939;46.2;25.0
27;2021-06-14;11062;17040;1295546;711979;46.6;25.6
27;2021-06-15;14136;17622;1309682;729601;47.1;26.2
27;2021-06-16;14684;15601;1324366;745202;47.6;26.8
27;2021-06-17;15157;17240;1339523;762442;48.1;27.4
27;2021-06-18;14780;20169;1354303;782611;48.7;28.1
27;2021-06-19;7656;8653;1361959;791264;48.9;28.4
27;2021-06-20;170;457;1362129;791721;48.9;28.4
27;2021-06-21;7761;19020;1369890;810741;49.2;29.1
27;2021-06-22;9568;24245;1379458;834986;49.6;30.0
27;2021-06-23;11251;19286;1390709;854272;50.0;30.7
27;2021-06-24;10472;17959;1401181;872231;50.3;31.3
27;2021-06-25;9359;26976;1410540;899207;50.7;32.3
27;2021-06-26;5069;15791;1415609;914998;50.9;32.9
27;2021-06-27;665;1883;1416274;916881;50.9;32.9
27;2021-06-28;6246;21938;1422520;938819;51.1;33.7
27;2021-06-29;7259;24439;1429779;963258;51.4;34.6
28;2020-12-27;0;0;0;0;0.0;0.0
28;2020-12-28;1;0;1;0;0.0;0.0
28;2020-12-29;2;0;3;0;0.0;0.0
28;2020-12-30;0;0;3;0;0.0;0.0
28;2020-12-31;1;0;4;0;0.0;0.0
28;2021-01-01;2;0;6;0;0.0;0.0
28;2021-01-02;1;0;7;0;0.0;0.0
28;2021-01-03;1;0;8;0;0.0;0.0
28;2021-01-04;16;0;24;0;0.0;0.0
28;2021-01-05;169;0;193;0;0.0;0.0
28;2021-01-06;1393;2;1586;2;0.0;0.0
28;2021-01-07;2599;9;4185;11;0.1;0.0
28;2021-01-08;3428;3;7613;14;0.2;0.0
28;2021-01-09;1331;3;8944;17;0.3;0.0
28;2021-01-10;705;1;9649;18;0.3;0.0
28;2021-01-11;3179;4;12828;22;0.4;0.0
28;2021-01-12;3978;3;16806;25;0.5;0.0
28;2021-01-13;4303;7;21109;32;0.6;0.0
28;2021-01-14;8098;73;29207;105;0.9;0.0
28;2021-01-15;6219;25;35426;130;1.1;0.0
28;2021-01-16;2086;9;37512;139;1.1;0.0
28;2021-01-17;4071;24;41583;163;1.3;0.0
28;2021-01-18;8784;17;50367;180;1.5;0.0
28;2021-01-19;7143;13;57510;193;1.7;0.0
28;2021-01-20;6507;11;64017;204;1.9;0.0
28;2021-01-21;5993;9;70010;213;2.1;0.0
28;2021-01-22;5440;12;75450;225;2.3;0.0
28;2021-01-23;2020;8;77470;233;2.3;0.0
28;2021-01-24;1447;11;78917;244;2.4;0.0
28;2021-01-25;6239;179;85156;423;2.6;0.0
28;2021-01-26;4575;394;89731;817;2.7;0.0
28;2021-01-27;4034;765;93765;1582;2.8;0.0
28;2021-01-28;3755;1049;97520;2631;3.0;0.1
28;2021-01-29;3488;1306;101008;3937;3.1;0.1
28;2021-01-30;1386;517;102394;4454;3.1;0.1
28;2021-01-31;195;126;102589;4580;3.1;0.1
28;2021-02-01;2781;1661;105370;6241;3.2;0.2
28;2021-02-02;2987;2392;108357;8633;3.3;0.3
28;2021-02-03;2948;2670;111305;11303;3.4;0.3
28;2021-02-04;3728;5207;115033;16510;3.5;0.5
28;2021-02-05;3887;4391;118920;20901;3.6;0.6
28;2021-02-06;1140;1549;120060;22450;3.6;0.7
28;2021-02-07;715;1975;120775;24425;3.7;0.7
28;2021-02-08;3801;6862;124576;31287;3.8;0.9
28;2021-02-09;3460;6033;128036;37320;3.9;1.1
28;2021-02-10;3455;5078;131491;42398;4.0;1.3
28;2021-02-11;4210;4901;135701;47299;4.1;1.4
28;2021-02-12;4045;4617;139746;51916;4.2;1.6
28;2021-02-13;1127;1582;140873;53498;4.3;1.6
28;2021-02-14;285;1388;141158;54886;4.3;1.7
28;2021-02-15;2217;6284;143375;61170;4.3;1.9
28;2021-02-16;2662;5664;146037;66834;4.4;2.0
28;2021-02-17;1954;4554;147991;71388;4.5;2.2
28;2021-02-18;2574;4309;150565;75697;4.6;2.3
28;2021-02-19;2551;3721;153116;79418;4.6;2.4
28;2021-02-20;945;1260;154061;80678;4.7;2.4
28;2021-02-21;104;415;154165;81093;4.7;2.5
28;2021-02-22;1675;4227;155840;85320;4.7;2.6
28;2021-02-23;2177;3838;158017;89158;4.8;2.7
28;2021-02-24;2379;3892;160396;93050;4.9;2.8
28;2021-02-25;4777;4197;165173;97247;5.0;2.9
28;2021-02-26;5965;3741;171138;100988;5.2;3.1
28;2021-02-27;3009;1031;174147;102019;5.3;3.1
28;2021-02-28;341;386;174488;102405;5.3;3.1
28;2021-03-01;2529;4659;177017;107064;5.4;3.2
28;2021-03-02;3901;4105;180918;111169;5.5;3.4
28;2021-03-03;4795;3485;185713;114654;5.6;3.5
28;2021-03-04;7307;2862;193020;117516;5.8;3.6
28;2021-03-05;10149;2501;203169;120017;6.2;3.6
28;2021-03-06;9808;795;212977;120812;6.4;3.7
28;2021-03-07;3772;126;216749;120938;6.6;3.7
28;2021-03-08;5868;3276;222617;124214;6.7;3.8
28;2021-03-09;9289;2821;231906;127035;7.0;3.8
28;2021-03-10;9805;2444;241711;129479;7.3;3.9
28;2021-03-11;13963;2018;255674;131497;7.7;4.0
28;2021-03-12;17990;1557;273664;133054;8.3;4.0
28;2021-03-13;11151;527;284815;133581;8.6;4.0
28;2021-03-14;2260;98;287075;133679;8.7;4.0
28;2021-03-15;8647;869;295722;134548;9.0;4.1
28;2021-03-16;7492;1187;303214;135735;9.2;4.1
28;2021-03-17;7718;1193;310932;136928;9.4;4.1
28;2021-03-18;8168;1372;319100;138300;9.7;4.2
28;2021-03-19;11568;1459;330668;139759;10.0;4.2
28;2021-03-20;9672;539;340340;140298;10.3;4.2
28;2021-03-21;2409;22;342749;140320;10.4;4.2
28;2021-03-22;9392;1633;352141;141953;10.7;4.3
28;2021-03-23;12488;1509;364629;143462;11.0;4.3
28;2021-03-24;13253;1599;377882;145061;11.4;4.4
28;2021-03-25;17621;1816;395503;146877;12.0;4.4
28;2021-03-26;20830;1883;416333;148760;12.6;4.5
28;2021-03-27;11496;1128;427829;149888;13.0;4.5
28;2021-03-28;2967;91;430796;149979;13.0;4.5
28;2021-03-29;11767;2959;442563;152938;13.4;4.6
28;2021-03-30;14420;3075;456983;156013;13.8;4.7
28;2021-03-31;14397;3565;471380;159578;14.3;4.8
28;2021-04-01;18040;5548;489420;165126;14.8;5.0
28;2021-04-02;16827;6371;506247;171497;15.3;5.2
28;2021-04-03;7001;3965;513248;175462;15.5;5.3
28;2021-04-04;1783;796;515031;176258;15.6;5.3
28;2021-04-05;3290;736;518321;176994;15.7;5.4
28;2021-04-06;10821;7374;529142;184368;16.0;5.6
28;2021-04-07;12697;6954;541839;191322;16.4;5.8
28;2021-04-08;17680;7541;559519;198863;16.9;6.0
28;2021-04-09;23828;7833;583347;206696;17.7;6.3
28;2021-04-10;13833;4123;597180;210819;18.1;6.4
28;2021-04-11;3028;1194;600208;212013;18.2;6.4
28;2021-04-12;13786;8029;613994;220042;18.6;6.7
28;2021-04-13;16190;8044;630184;228086;19.1;6.9
28;2021-04-14;14326;8024;644510;236110;19.5;7.1
28;2021-04-15;17227;8394;661737;244504;20.0;7.4
28;2021-04-16;20276;7833;682013;252337;20.6;7.6
28;2021-04-17;12754;5033;694767;257370;21.0;7.8
28;2021-04-18;2287;1242;697054;258612;21.1;7.8
28;2021-04-19;10883;8859;707937;267471;21.4;8.1
28;2021-04-20;13911;9767;721848;277238;21.9;8.4
28;2021-04-21;13302;9979;735150;287217;22.3;8.7
28;2021-04-22;15297;11902;750447;299119;22.7;9.1
28;2021-04-23;16452;12298;766899;311417;23.2;9.4
28;2021-04-24;12584;7266;779483;318683;23.6;9.6
28;2021-04-25;3297;1917;782780;320600;23.7;9.7
28;2021-04-26;12541;10188;795321;330788;24.1;10.0
28;2021-04-27;14869;11739;810190;342527;24.5;10.4
28;2021-04-28;15052;10699;825242;353226;25.0;10.7
28;2021-04-29;18461;11770;843703;364996;25.5;11.0
28;2021-04-30;20378;11892;864081;376888;26.2;11.4
28;2021-05-01;12805;2973;876886;379861;26.5;11.5
28;2021-05-02;5991;1837;882877;381698;26.7;11.6
28;2021-05-03;12860;9999;895737;391697;27.1;11.9
28;2021-05-04;13820;13129;909557;404826;27.5;12.3
28;2021-05-05;13958;14464;923515;419290;28.0;12.7
28;2021-05-06;18317;15086;941832;434376;28.5;13.1
28;2021-05-07;17840;17372;959672;451748;29.1;13.7
28;2021-05-08;12626;4699;972298;456447;29.4;13.8
28;2021-05-09;7146;1825;979444;458272;29.6;13.9
28;2021-05-10;14217;14793;993661;473065;30.1;14.3
28;2021-05-11;18131;15331;1011792;488396;30.6;14.8
28;2021-05-12;18800;13970;1030592;502366;31.2;15.2
28;2021-05-13;19679;3734;1050271;506100;31.8;15.3
28;2021-05-14;26358;12520;1076629;518620;32.6;15.7
28;2021-05-15;26934;7109;1103563;525729;33.4;15.9
28;2021-05-16;14142;1579;1117705;527308;33.8;16.0
28;2021-05-17;16222;9440;1133927;536748;34.3;16.2
28;2021-05-18;21087;8765;1155014;545513;35.0;16.5
28;2021-05-19;20904;8485;1175918;553998;35.6;16.8
28;2021-05-20;23123;9660;1199041;563658;36.3;17.1
28;2021-05-21;21469;12072;1220510;575730;36.9;17.4
28;2021-05-22;17575;5988;1238085;581718;37.5;17.6
28;2021-05-23;9116;935;1247201;582653;37.8;17.6
28;2021-05-24;13407;3169;1260608;585822;38.2;17.7
28;2021-05-25;19161;11581;1279769;597403;38.7;18.1
28;2021-05-26;19294;10002;1299063;607405;39.3;18.4
28;2021-05-27;21737;12373;1320800;619778;40.0;18.8
28;2021-05-28;21608;16510;1342408;636288;40.6;19.3
28;2021-05-29;17576;10159;1359984;646447;41.2;19.6
28;2021-05-30;6266;1273;1366250;647720;41.4;19.6
28;2021-05-31;19867;11927;1386117;659647;42.0;20.0
28;2021-06-01;23716;13839;1409833;673486;42.7;20.4
28;2021-06-02;20817;12320;1430650;685806;43.3;20.8
28;2021-06-03;26459;14658;1457109;700464;44.1;21.2
28;2021-06-04;24577;18928;1481686;719392;44.9;21.8
28;2021-06-05;18360;12077;1500046;731469;45.4;22.1
28;2021-06-06;7663;2410;1507709;733879;45.6;22.2
28;2021-06-07;19232;14165;1526941;748044;46.2;22.6
28;2021-06-08;22616;15539;1549557;763583;46.9;23.1
28;2021-06-09;19746;14672;1569303;778255;47.5;23.6
28;2021-06-10;21197;14777;1590500;793032;48.1;24.0
28;2021-06-11;21024;21130;1611524;814162;48.8;24.6
28;2021-06-12;17910;17129;1629434;831291;49.3;25.2
28;2021-06-13;6339;5886;1635773;837177;49.5;25.3
28;2021-06-14;13895;17721;1649668;854898;49.9;25.9
28;2021-06-15;16217;18714;1665885;873612;50.4;26.4
28;2021-06-16;16695;18563;1682580;892175;50.9;27.0
28;2021-06-17;17233;20493;1699813;912668;51.5;27.6
28;2021-06-18;18510;24411;1718323;937079;52.0;28.4
28;2021-06-19;14789;15797;1733112;952876;52.5;28.8
28;2021-06-20;4982;5127;1738094;958003;52.6;29.0
28;2021-06-21;11339;20737;1749433;978740;53.0;29.6
28;2021-06-22;12740;23855;1762173;1002595;53.3;30.3
28;2021-06-23;11912;23578;1774085;1026173;53.7;31.1
28;2021-06-24;12629;24452;1786714;1050625;54.1;31.8
28;2021-06-25;12397;29413;1799111;1080038;54.5;32.7
28;2021-06-26;9198;23401;1808309;1103439;54.7;33.4
28;2021-06-27;2908;10106;1811217;1113545;54.8;33.7
28;2021-06-28;8157;22888;1819374;1136433;55.1;34.4
28;2021-06-29;9761;26062;1829135;1162495;55.4;35.2
32;2020-12-27;1;0;1;0;0.0;0.0
32;2020-12-28;27;0;28;0;0.0;0.0
32;2020-12-29;12;0;40;0;0.0;0.0
32;2020-12-30;0;0;40;0;0.0;0.0
32;2020-12-31;0;0;40;0;0.0;0.0
32;2021-01-01;1;0;41;0;0.0;0.0
32;2021-01-02;6;0;47;0;0.0;0.0
32;2021-01-03;4;0;51;0;0.0;0.0
32;2021-01-04;82;0;133;0;0.0;0.0
32;2021-01-05;300;0;433;0;0.0;0.0
32;2021-01-06;787;2;1220;2;0.0;0.0
32;2021-01-07;2431;4;3651;6;0.1;0.0
32;2021-01-08;3165;9;6816;15;0.1;0.0
32;2021-01-09;957;3;7773;18;0.1;0.0
32;2021-01-10;640;0;8413;18;0.1;0.0
32;2021-01-11;3269;6;11682;24;0.2;0.0
32;2021-01-12;5018;7;16700;31;0.3;0.0
32;2021-01-13;4947;11;21647;42;0.4;0.0
32;2021-01-14;5724;44;27371;86;0.5;0.0
32;2021-01-15;5228;28;32599;114;0.5;0.0
32;2021-01-16;1636;12;34235;126;0.6;0.0
32;2021-01-17;860;3;35095;129;0.6;0.0
32;2021-01-18;7233;21;42328;150;0.7;0.0
32;2021-01-19;9899;38;52227;188;0.9;0.0
32;2021-01-20;10354;30;62581;218;1.0;0.0
32;2021-01-21;12706;46;75287;264;1.3;0.0
32;2021-01-22;9878;28;85165;292;1.4;0.0
32;2021-01-23;3411;4;88576;296;1.5;0.0
32;2021-01-24;1119;3;89695;299;1.5;0.0
32;2021-01-25;6865;85;96560;384;1.6;0.0
32;2021-01-26;7447;183;104007;567;1.7;0.0
32;2021-01-27;4837;512;108844;1079;1.8;0.0
32;2021-01-28;8598;1691;117442;2770;2.0;0.0
32;2021-01-29;5384;1861;122826;4631;2.1;0.1
32;2021-01-30;534;413;123360;5044;2.1;0.1
32;2021-01-31;67;74;123427;5118;2.1;0.1
32;2021-02-01;191;1816;123618;6934;2.1;0.1
32;2021-02-02;788;3167;124406;10101;2.1;0.2
32;2021-02-03;4076;3190;128482;13291;2.2;0.2
32;2021-02-04;3685;3620;132167;16911;2.2;0.3
32;2021-02-05;1963;3278;134130;20189;2.2;0.3
32;2021-02-06;517;875;134647;21064;2.3;0.4
32;2021-02-07;540;100;135187;21164;2.3;0.4
32;2021-02-08;1868;3682;137055;24846;2.3;0.4
32;2021-02-09;2553;4367;139608;29213;2.3;0.5
32;2021-02-10;2986;5344;142594;34557;2.4;0.6
32;2021-02-11;4798;6199;147392;40756;2.5;0.7
32;2021-02-12;5097;4676;152489;45432;2.6;0.8
32;2021-02-13;940;1894;153429;47326;2.6;0.8
32;2021-02-14;116;711;153545;48037;2.6;0.8
32;2021-02-15;3618;6930;157163;54967;2.6;0.9
32;2021-02-16;4032;8244;161195;63211;2.7;1.1
32;2021-02-17;4305;8698;165500;71909;2.8;1.2
32;2021-02-18;7042;11429;172542;83338;2.9;1.4
32;2021-02-19;7086;8319;179628;91657;3.0;1.5
32;2021-02-20;2520;3017;182148;94674;3.1;1.6
32;2021-02-21;434;490;182582;95164;3.1;1.6
32;2021-02-22;3263;5335;185845;100499;3.1;1.7
32;2021-02-23;5510;5925;191355;106424;3.2;1.8
32;2021-02-24;7443;6073;198798;112497;3.3;1.9
32;2021-02-25;12833;5045;211631;117542;3.5;2.0
32;2021-02-26;12538;2902;224169;120444;3.8;2.0
32;2021-02-27;6486;320;230655;120764;3.9;2.0
32;2021-02-28;364;134;231019;120898;3.9;2.0
32;2021-03-01;7245;865;238264;121763;4.0;2.0
32;2021-03-02;10959;1000;249223;122763;4.2;2.1
32;2021-03-03;11991;1747;261214;124510;4.4;2.1
32;2021-03-04;15100;2461;276314;126971;4.6;2.1
32;2021-03-05;17125;2120;293439;129091;4.9;2.2
32;2021-03-06;28099;1071;321538;130162;5.4;2.2
32;2021-03-07;19862;501;341400;130663;5.7;2.2
32;2021-03-08;8918;2576;350318;133239;5.9;2.2
32;2021-03-09;14292;3326;364610;136565;6.1;2.3
32;2021-03-10;15768;3242;380378;139807;6.4;2.3
32;2021-03-11;20925;4744;401303;144551;6.7;2.4
32;2021-03-12;26069;4267;427372;148818;7.2;2.5
32;2021-03-13;41596;2045;468968;150863;7.9;2.5
32;2021-03-14;20100;597;489068;151460;8.2;2.5
32;2021-03-15;13054;3609;502122;155069;8.4;2.6
32;2021-03-16;9798;3477;511920;158546;8.6;2.7
32;2021-03-17;9715;4138;521635;162684;8.7;2.7
32;2021-03-18;10015;5045;531650;167729;8.9;2.8
32;2021-03-19;17943;3834;549593;171563;9.2;2.9
32;2021-03-20;36500;1989;586093;173552;9.8;2.9
32;2021-03-21;19844;791;605937;174343;10.2;2.9
32;2021-03-22;12153;4300;618090;178643;10.4;3.0
32;2021-03-23;18925;5944;637015;184587;10.7;3.1
32;2021-03-24;17911;6162;654926;190749;11.0;3.2
32;2021-03-25;25301;5727;680227;196476;11.4;3.3
32;2021-03-26;28988;5922;709215;202398;11.9;3.4
32;2021-03-27;36668;2175;745883;204573;12.5;3.4
32;2021-03-28;18642;636;764525;205209;12.8;3.4
32;2021-03-29;14587;7040;779112;212249;13.1;3.6
32;2021-03-30;18876;8668;797988;220917;13.4;3.7
32;2021-03-31;15791;9316;813779;230233;13.6;3.9
32;2021-04-01;18218;11050;831997;241283;14.0;4.0
32;2021-04-02;19966;12580;851963;253863;14.3;4.3
32;2021-04-03;30030;10186;881993;264049;14.8;4.4
32;2021-04-04;11660;4736;893653;268785;15.0;4.5
32;2021-04-05;9595;2337;903248;271122;15.1;4.5
32;2021-04-06;14284;10881;917532;282003;15.4;4.7
32;2021-04-07;18077;12572;935609;294575;15.7;4.9
32;2021-04-08;23509;12975;959118;307550;16.1;5.2
32;2021-04-09;29929;13155;989047;320705;16.6;5.4
32;2021-04-10;26134;18809;1015181;339514;17.0;5.7
32;2021-04-11;9142;12016;1024323;351530;17.2;5.9
32;2021-04-12;15387;9508;1039710;361038;17.4;6.1
32;2021-04-13;21790;11580;1061500;372618;17.8;6.2
32;2021-04-14;22474;11129;1083974;383747;18.2;6.4
32;2021-04-15;25714;11142;1109688;394889;18.6;6.6
32;2021-04-16;25295;12455;1134983;407344;19.0;6.8
32;2021-04-17;17969;22989;1152952;430333;19.3;7.2
32;2021-04-18;6393;14045;1159345;444378;19.4;7.5
32;2021-04-19;11656;9808;1171001;454186;19.6;7.6
32;2021-04-20;16408;12283;1187409;466469;19.9;7.8
32;2021-04-21;15786;12570;1203195;479039;20.2;8.0
32;2021-04-22;19034;15009;1222229;494048;20.5;8.3
32;2021-04-23;19650;15964;1241879;510012;20.8;8.6
32;2021-04-24;15457;21027;1257336;531039;21.1;8.9
32;2021-04-25;6963;12290;1264299;543329;21.2;9.1
32;2021-04-26;13209;10729;1277508;554058;21.4;9.3
32;2021-04-27;18686;14110;1296194;568168;21.7;9.5
32;2021-04-28;20192;16052;1316386;584220;22.1;9.8
32;2021-04-29;22398;19939;1338784;604159;22.5;10.1
32;2021-04-30;25015;21563;1363799;625722;22.9;10.5
32;2021-05-01;23028;13941;1386827;639663;23.3;10.7
32;2021-05-02;20949;10340;1407776;650003;23.6;10.9
32;2021-05-03;21937;11297;1429713;661300;24.0;11.1
32;2021-05-04;23847;16276;1453560;677576;24.4;11.4
32;2021-05-05;23938;17414;1477498;694990;24.8;11.7
32;2021-05-06;25747;19881;1503245;714871;25.2;12.0
32;2021-05-07;30747;21494;1533992;736365;25.7;12.3
32;2021-05-08;34582;9069;1568574;745434;26.3;12.5
32;2021-05-09;26799;6507;1595373;751941;26.8;12.6
32;2021-05-10;24221;16126;1619594;768067;27.2;12.9
32;2021-05-11;31306;19040;1650900;787107;27.7;13.2
32;2021-05-12;37290;18816;1688190;805923;28.3;13.5
32;2021-05-13;40525;7347;1728715;813270;29.0;13.6
32;2021-05-14;41783;14621;1770498;827891;29.7;13.9
32;2021-05-15;59643;12199;1830141;840090;30.7;14.1
32;2021-05-16;47878;4881;1878019;844971;31.5;14.2
32;2021-05-17;31461;10963;1909480;855934;32.0;14.4
32;2021-05-18;36834;12495;1946314;868429;32.6;14.6
32;2021-05-19;38806;11571;1985120;880000;33.3;14.8
32;2021-05-20;39756;14912;2024876;894912;34.0;15.0
32;2021-05-21;42333;16976;2067209;911888;34.7;15.3
32;2021-05-22;57728;13069;2124937;924957;35.6;15.5
32;2021-05-23;38909;4393;2163846;929350;36.3;15.6
32;2021-05-24;28443;3830;2192289;933180;36.8;15.7
32;2021-05-25;31073;14876;2223362;948056;37.3;15.9
32;2021-05-26;34023;16764;2257385;964820;37.9;16.2
32;2021-05-27;34632;20666;2292017;985486;38.4;16.5
32;2021-05-28;34294;25160;2326311;1010646;39.0;16.9
32;2021-05-29;37416;19639;2363727;1030285;39.6;17.3
32;2021-05-30;16099;3516;2379826;1033801;39.9;17.3
32;2021-05-31;27927;16515;2407753;1050316;40.4;17.6
32;2021-06-01;32806;23976;2440559;1074292;40.9;18.0
32;2021-06-02;32216;21683;2472775;1095975;41.5;18.4
32;2021-06-03;34292;25072;2507067;1121047;42.0;18.8
32;2021-06-04;35858;27710;2542925;1148757;42.6;19.3
32;2021-06-05;34368;22782;2577293;1171539;43.2;19.6
32;2021-06-06;16518;5722;2593811;1177261;43.5;19.7
32;2021-06-07;21171;19361;2614982;1196622;43.9;20.1
32;2021-06-08;26281;24342;2641263;1220964;44.3;20.5
32;2021-06-09;24360;24392;2665623;1245356;44.7;20.9
32;2021-06-10;24951;26459;2690574;1271815;45.1;21.3
32;2021-06-11;26333;36062;2716907;1307877;45.6;21.9
32;2021-06-12;25975;31519;2742882;1339396;46.0;22.5
32;2021-06-13;11806;14808;2754688;1354204;46.2;22.7
32;2021-06-14;13215;28043;2767903;1382247;46.4;23.2
32;2021-06-15;19596;34593;2787499;1416840;46.7;23.8
32;2021-06-16;20487;32436;2807986;1449276;47.1;24.3
32;2021-06-17;21389;34945;2829375;1484221;47.5;24.9
32;2021-06-18;21547;42589;2850922;1526810;47.8;25.6
32;2021-06-19;22561;43815;2873483;1570625;48.2;26.3
32;2021-06-20;9217;19110;2882700;1589735;48.3;26.7
32;2021-06-21;11359;34845;2894059;1624580;48.5;27.2
32;2021-06-22;13668;41766;2907727;1666346;48.8;27.9
32;2021-06-23;14246;43510;2921973;1709856;49.0;28.7
32;2021-06-24;15309;45737;2937282;1755593;49.3;29.4
32;2021-06-25;14697;53364;2951979;1808957;49.5;30.3
32;2021-06-26;14890;59507;2966869;1868464;49.8;31.3
32;2021-06-27;7463;33860;2974332;1902324;49.9;31.9
32;2021-06-28;10336;38994;2984668;1941318;50.1;32.6
32;2021-06-29;13411;44490;2998079;1985808;50.3;33.3
44;2020-12-27;0;0;0;0;0.0;0.0
44;2020-12-28;0;0;0;0;0.0;0.0
44;2020-12-29;0;0;0;0;0.0;0.0
44;2020-12-30;0;0;0;0;0.0;0.0
44;2020-12-31;11;0;11;0;0.0;0.0
44;2021-01-01;1;0;12;0;0.0;0.0
44;2021-01-02;3;0;15;0;0.0;0.0
44;2021-01-03;3;0;18;0;0.0;0.0
44;2021-01-04;243;0;261;0;0.0;0.0
44;2021-01-05;771;0;1032;0;0.0;0.0
44;2021-01-06;1248;3;2280;3;0.0;0.0
44;2021-01-07;2426;4;4706;7;0.1;0.0
44;2021-01-08;3132;9;7838;16;0.1;0.0
44;2021-01-09;943;1;8781;17;0.2;0.0
44;2021-01-10;239;0;9020;17;0.2;0.0
44;2021-01-11;2988;7;12008;24;0.2;0.0
44;2021-01-12;5280;9;17288;33;0.3;0.0
44;2021-01-13;7664;19;24952;52;0.5;0.0
44;2021-01-14;9551;83;34503;135;0.6;0.0
44;2021-01-15;6700;27;41203;162;0.7;0.0
44;2021-01-16;1917;10;43120;172;0.8;0.0
44;2021-01-17;902;1;44022;173;0.8;0.0
44;2021-01-18;8717;27;52739;200;1.0;0.0
44;2021-01-19;10667;17;63406;217;1.2;0.0
44;2021-01-20;11028;46;74434;263;1.4;0.0
44;2021-01-21;11731;27;86165;290;1.6;0.0
44;2021-01-22;9634;31;95799;321;1.7;0.0
44;2021-01-23;3287;20;99086;341;1.8;0.0
44;2021-01-24;1568;5;100654;346;1.8;0.0
44;2021-01-25;6634;304;107288;650;1.9;0.0
44;2021-01-26;5643;434;112931;1084;2.0;0.0
44;2021-01-27;7378;603;120309;1687;2.2;0.0
44;2021-01-28;8831;1252;129140;2939;2.3;0.1
44;2021-01-29;6758;1804;135898;4743;2.5;0.1
44;2021-01-30;2550;495;138448;5238;2.5;0.1
44;2021-01-31;1252;55;139700;5293;2.5;0.1
44;2021-02-01;6385;2383;146085;7676;2.7;0.1
44;2021-02-02;6215;3812;152300;11488;2.8;0.2
44;2021-02-03;5598;4555;157898;16043;2.9;0.3
44;2021-02-04;6443;6969;164341;23012;3.0;0.4
44;2021-02-05;6392;5240;170733;28252;3.1;0.5
44;2021-02-06;1973;1207;172706;29459;3.1;0.5
44;2021-02-07;406;595;173112;30054;3.1;0.5
44;2021-02-08;3823;4471;176935;34525;3.2;0.6
44;2021-02-09;5719;5849;182654;40374;3.3;0.7
44;2021-02-10;6254;6048;188908;46422;3.4;0.8
44;2021-02-11;7063;6574;195971;52996;3.6;1.0
44;2021-02-12;7280;5558;203251;58554;3.7;1.1
44;2021-02-13;2546;1257;205797;59811;3.7;1.1
44;2021-02-14;1613;826;207410;60637;3.8;1.1
44;2021-02-15;3999;7217;211409;67854;3.8;1.2
44;2021-02-16;4577;7975;215986;75829;3.9;1.4
44;2021-02-17;4711;8550;220697;84379;4.0;1.5
44;2021-02-18;6066;9286;226763;93665;4.1;1.7
44;2021-02-19;5547;7516;232310;101181;4.2;1.8
44;2021-02-20;2341;2842;234651;104023;4.3;1.9
44;2021-02-21;542;1402;235193;105425;4.3;1.9
44;2021-02-22;4487;7034;239680;112459;4.3;2.0
44;2021-02-23;6030;7276;245710;119735;4.5;2.2
44;2021-02-24;6606;5948;252316;125683;4.6;2.3
44;2021-02-25;10537;7570;262853;133253;4.8;2.4
44;2021-02-26;12374;6378;275227;139631;5.0;2.5
44;2021-02-27;7888;2168;283115;141799;5.1;2.6
44;2021-02-28;2118;520;285233;142319;5.2;2.6
44;2021-03-01;6079;4677;291312;146996;5.3;2.7
44;2021-03-02;9392;5675;300704;152671;5.5;2.8
44;2021-03-03;11270;5598;311974;158269;5.7;2.9
44;2021-03-04;13264;5798;325238;164067;5.9;3.0
44;2021-03-05;17884;5703;343122;169770;6.2;3.1
44;2021-03-06;21352;2177;364474;171947;6.6;3.1
44;2021-03-07;12204;750;376678;172697;6.8;3.1
44;2021-03-08;9406;4268;386084;176965;7.0;3.2
44;2021-03-09;15197;4981;401281;181946;7.3;3.3
44;2021-03-10;16605;5194;417886;187140;7.6;3.4
44;2021-03-11;20346;5677;438232;192817;8.0;3.5
44;2021-03-12;26805;5539;465037;198356;8.4;3.6
44;2021-03-13;24217;2419;489254;200775;8.9;3.6
44;2021-03-14;6767;882;496021;201657;9.0;3.7
44;2021-03-15;12958;3476;508979;205133;9.2;3.7
44;2021-03-16;12842;3982;521821;209115;9.5;3.8
44;2021-03-17;14197;3642;536018;212757;9.7;3.9
44;2021-03-18;15415;3793;551433;216550;10.0;3.9
44;2021-03-19;21415;3910;572848;220460;10.4;4.0
44;2021-03-20;15566;1960;588414;222420;10.7;4.0
44;2021-03-21;4618;288;593032;222708;10.8;4.0
44;2021-03-22;12522;3917;605554;226625;11.0;4.1
44;2021-03-23;19440;5079;624994;231704;11.3;4.2
44;2021-03-24;22045;5198;647039;236902;11.7;4.3
44;2021-03-25;28189;5781;675228;242683;12.3;4.4
44;2021-03-26;30340;5493;705568;248176;12.8;4.5
44;2021-03-27;16228;4702;721796;252878;13.1;4.6
44;2021-03-28;4079;1978;725875;254856;13.2;4.6
44;2021-03-29;14312;6125;740187;260981;13.4;4.7
44;2021-03-30;21402;7828;761589;268809;13.8;4.9
44;2021-03-31;20121;8010;781710;276819;14.2;5.0
44;2021-04-01;23550;9346;805260;286165;14.6;5.2
44;2021-04-02;16237;6903;821497;293068;14.9;5.3
44;2021-04-03;10190;5766;831687;298834;15.1;5.4
44;2021-04-04;3133;1654;834820;300488;15.1;5.5
44;2021-04-05;4424;1415;839244;301903;15.2;5.5
44;2021-04-06;13419;10555;852663;312458;15.5;5.7
44;2021-04-07;17656;12107;870319;324565;15.8;5.9
44;2021-04-08;26018;12408;896337;336973;16.3;6.1
44;2021-04-09;32234;12753;928571;349726;16.8;6.3
44;2021-04-10;18248;10061;946819;359787;17.2;6.5
44;2021-04-11;3035;5962;949854;365749;17.2;6.6
44;2021-04-12;16959;11238;966813;376987;17.5;6.8
44;2021-04-13;21975;13770;988788;390757;17.9;7.1
44;2021-04-14;23108;14056;1011896;404813;18.4;7.3
44;2021-04-15;26277;15367;1038173;420180;18.8;7.6
44;2021-04-16;28095;15203;1066268;435383;19.3;7.9
44;2021-04-17;19820;9043;1086088;444426;19.7;8.1
44;2021-04-18;5049;4629;1091137;449055;19.8;8.1
44;2021-04-19;16930;11745;1108067;460800;20.1;8.4
44;2021-04-20;19112;14299;1127179;475099;20.5;8.6
44;2021-04-21;21131;14950;1148310;490049;20.8;8.9
44;2021-04-22;23693;15871;1172003;505920;21.3;9.2
44;2021-04-23;27805;16563;1199808;522483;21.8;9.5
44;2021-04-24;16977;9158;1216785;531641;22.1;9.6
44;2021-04-25;4827;3560;1221612;535201;22.2;9.7
44;2021-04-26;16704;12011;1238316;547212;22.5;9.9
44;2021-04-27;21152;14621;1259468;561833;22.9;10.2
44;2021-04-28;23783;14794;1283251;576627;23.3;10.5
44;2021-04-29;28126;16944;1311377;593571;23.8;10.8
44;2021-04-30;33104;16004;1344481;609575;24.4;11.1
44;2021-05-01;14846;7013;1359327;616588;24.7;11.2
44;2021-05-02;7898;3991;1367225;620579;24.8;11.3
44;2021-05-03;24001;12360;1391226;632939;25.2;11.5
44;2021-05-04;26969;17250;1418195;650189;25.7;11.8
44;2021-05-05;30800;19133;1448995;669322;26.3;12.1
44;2021-05-06;37987;21068;1486982;690390;27.0;12.5
44;2021-05-07;36133;24770;1523115;715160;27.6;13.0
44;2021-05-08;19559;6695;1542674;721855;28.0;13.1
44;2021-05-09;11303;2902;1553977;724757;28.2;13.1
44;2021-05-10;24496;20745;1578473;745502;28.6;13.5
44;2021-05-11;34441;22880;1612914;768382;29.3;13.9
44;2021-05-12;37122;23976;1650036;792358;29.9;14.4
44;2021-05-13;27872;6359;1677908;798717;30.4;14.5
44;2021-05-14;44200;18874;1722108;817591;31.2;14.8
44;2021-05-15;34034;14079;1756142;831670;31.9;15.1
44;2021-05-16;15602;3505;1771744;835175;32.1;15.2
44;2021-05-17;27201;14518;1798945;849693;32.6;15.4
44;2021-05-18;35292;15250;1834237;864943;33.3;15.7
44;2021-05-19;36878;16323;1871115;881266;33.9;16.0
44;2021-05-20;40831;16427;1911946;897693;34.7;16.3
44;2021-05-21;42801;20858;1954747;918551;35.5;16.7
44;2021-05-22;27659;11548;1982406;930099;36.0;16.9
44;2021-05-23;8663;1713;1991069;931812;36.1;16.9
44;2021-05-24;17898;4646;2008967;936458;36.4;17.0
44;2021-05-25;30212;17585;2039179;954043;37.0;17.3
44;2021-05-26;32360;19479;2071539;973522;37.6;17.7
44;2021-05-27;34521;20783;2106060;994305;38.2;18.0
44;2021-05-28;37480;27783;2143540;1022088;38.9;18.5
44;2021-05-29;26769;20107;2170309;1042195;39.4;18.9
44;2021-05-30;6121;4207;2176430;1046402;39.5;19.0
44;2021-05-31;26996;19660;2203426;1066062;40.0;19.3
44;2021-06-01;31538;22859;2234964;1088921;40.5;19.8
44;2021-06-02;33530;22893;2268494;1111814;41.2;20.2
44;2021-06-03;34535;25260;2303029;1137074;41.8;20.6
44;2021-06-04;39923;32160;2342952;1169234;42.5;21.2
44;2021-06-05;23043;20085;2365995;1189319;42.9;21.6
44;2021-06-06;8304;4451;2374299;1193770;43.1;21.7
44;2021-06-07;28092;22058;2402391;1215828;43.6;22.1
44;2021-06-08;33022;26644;2435413;1242472;44.2;22.5
44;2021-06-09;35598;24857;2471011;1267329;44.8;23.0
44;2021-06-10;34527;25573;2505538;1292902;45.5;23.5
44;2021-06-11;32326;35367;2537864;1328269;46.0;24.1
44;2021-06-12;25668;23428;2563532;1351697;46.5;24.5
44;2021-06-13;6765;6058;2570297;1357755;46.6;24.6
44;2021-06-14;17596;29546;2587893;1387301;47.0;25.2
44;2021-06-15;23573;34940;2611466;1422241;47.4;25.8
44;2021-06-16;24287;36579;2635753;1458820;47.8;26.5
44;2021-06-17;23759;39220;2659512;1498040;48.3;27.2
44;2021-06-18;26413;42935;2685925;1540975;48.7;28.0
44;2021-06-19;21006;28170;2706931;1569145;49.1;28.5
44;2021-06-20;3670;6646;2710601;1575791;49.2;28.6
44;2021-06-21;14794;34021;2725395;1609812;49.4;29.2
44;2021-06-22;15422;41529;2740817;1651341;49.7;30.0
44;2021-06-23;20032;41292;2760849;1692633;50.1;30.7
44;2021-06-24;16494;34194;2777343;1726827;50.4;31.3
44;2021-06-25;18843;49389;2796186;1776216;50.7;32.2
44;2021-06-26;13967;37278;2810153;1813494;51.0;32.9
44;2021-06-27;3322;11532;2813475;1825026;51.0;33.1
44;2021-06-28;11258;37360;2824733;1862386;51.2;33.8
44;2021-06-29;11960;41688;2836693;1904074;51.5;34.5
52;2020-12-27;0;0;0;0;0.0;0.0
52;2020-12-28;1;0;1;0;0.0;0.0
52;2020-12-29;0;0;1;0;0.0;0.0
52;2020-12-30;0;0;1;0;0.0;0.0
52;2020-12-31;0;0;1;0;0.0;0.0
52;2021-01-01;5;0;6;0;0.0;0.0
52;2021-01-02;1;0;7;0;0.0;0.0
52;2021-01-03;1;0;8;0;0.0;0.0
52;2021-01-04;34;0;42;0;0.0;0.0
52;2021-01-05;168;0;210;0;0.0;0.0
52;2021-01-06;384;1;594;1;0.0;0.0
52;2021-01-07;964;0;1558;1;0.0;0.0
52;2021-01-08;1664;3;3222;4;0.1;0.0
52;2021-01-09;1049;2;4271;6;0.1;0.0
52;2021-01-10;643;1;4914;7;0.1;0.0
52;2021-01-11;2197;0;7111;7;0.2;0.0
52;2021-01-12;3169;4;10280;11;0.3;0.0
52;2021-01-13;2983;4;13263;15;0.3;0.0
52;2021-01-14;3303;25;16566;40;0.4;0.0
52;2021-01-15;3017;9;19583;49;0.5;0.0
52;2021-01-16;894;7;20477;56;0.5;0.0
52;2021-01-17;499;3;20976;59;0.6;0.0
52;2021-01-18;3200;6;24176;65;0.6;0.0
52;2021-01-19;6553;9;30729;74;0.8;0.0
52;2021-01-20;8336;12;39065;86;1.0;0.0
52;2021-01-21;12168;11;51233;97;1.3;0.0
52;2021-01-22;7274;30;58507;127;1.5;0.0
52;2021-01-23;1677;5;60184;132;1.6;0.0
52;2021-01-24;174;0;60358;132;1.6;0.0
52;2021-01-25;3006;13;63364;145;1.7;0.0
52;2021-01-26;6737;154;70101;299;1.8;0.0
52;2021-01-27;7285;151;77386;450;2.0;0.0
52;2021-01-28;9728;470;87114;920;2.3;0.0
52;2021-01-29;5958;909;93072;1829;2.4;0.0
52;2021-01-30;1258;271;94330;2100;2.5;0.1
52;2021-01-31;79;314;94409;2414;2.5;0.1
52;2021-02-01;2523;1189;96932;3603;2.5;0.1
52;2021-02-02;2973;1856;99905;5459;2.6;0.1
52;2021-02-03;2691;2156;102596;7615;2.7;0.2
52;2021-02-04;2966;2113;105562;9728;2.8;0.3
52;2021-02-05;2965;2206;108527;11934;2.9;0.3
52;2021-02-06;1075;662;109602;12596;2.9;0.3
52;2021-02-07;151;297;109753;12893;2.9;0.3
52;2021-02-08;1931;2118;111684;15011;2.9;0.4
52;2021-02-09;3174;3723;114858;18734;3.0;0.5
52;2021-02-10;3322;4762;118180;23496;3.1;0.6
52;2021-02-11;6103;9303;124283;32799;3.3;0.9
52;2021-02-12;4706;5148;128989;37947;3.4;1.0
52;2021-02-13;1150;1244;130139;39191;3.4;1.0
52;2021-02-14;22;541;130161;39732;3.4;1.0
52;2021-02-15;2033;3533;132194;43265;3.5;1.1
52;2021-02-16;4125;6758;136319;50023;3.6;1.3
52;2021-02-17;3879;6948;140198;56971;3.7;1.5
52;2021-02-18;6145;9293;146343;66264;3.8;1.7
52;2021-02-19;5333;5844;151676;72108;4.0;1.9
52;2021-02-20;1031;1473;152707;73581;4.0;1.9
52;2021-02-21;7;274;152714;73855;4.0;1.9
52;2021-02-22;2651;3488;155365;77343;4.1;2.0
52;2021-02-23;3429;3700;158794;81043;4.2;2.1
52;2021-02-24;3306;3038;162100;84081;4.3;2.2
52;2021-02-25;6348;3218;168448;87299;4.4;2.3
52;2021-02-26;6218;2927;174666;90226;4.6;2.4
52;2021-02-27;2217;1046;176883;91272;4.7;2.4
52;2021-02-28;76;88;176959;91360;4.7;2.4
52;2021-03-01;3117;2331;180076;93691;4.7;2.5
52;2021-03-02;4729;3436;184805;97127;4.9;2.6
52;2021-03-03;5284;3413;190089;100540;5.0;2.6
52;2021-03-04;7796;4777;197885;105317;5.2;2.8
52;2021-03-05;9009;3936;206894;109253;5.4;2.9
52;2021-03-06;5640;1154;212534;110407;5.6;2.9
52;2021-03-07;2661;136;215195;110543;5.7;2.9
52;2021-03-08;5854;2417;221049;112960;5.8;3.0
52;2021-03-09;9554;3335;230603;116295;6.1;3.1
52;2021-03-10;9395;3402;239998;119697;6.3;3.1
52;2021-03-11;13580;5061;253578;124758;6.7;3.3
52;2021-03-12;15336;3754;268914;128512;7.1;3.4
52;2021-03-13;8290;763;277204;129275;7.3;3.4
52;2021-03-14;624;73;277828;129348;7.3;3.4
52;2021-03-15;8837;1913;286665;131261;7.5;3.5
52;2021-03-16;7576;2618;294241;133879;7.7;3.5
52;2021-03-17;6465;2380;300706;136259;7.9;3.6
52;2021-03-18;8307;2512;309013;138771;8.1;3.7
52;2021-03-19;11891;2131;320904;140902;8.4;3.7
52;2021-03-20;7085;765;327989;141667;8.6;3.7
52;2021-03-21;1689;48;329678;141715;8.7;3.7
52;2021-03-22;9015;2013;338693;143728;8.9;3.8
52;2021-03-23;13181;2600;351874;146328;9.3;3.8
52;2021-03-24;13258;2045;365132;148373;9.6;3.9
52;2021-03-25;18197;2816;383329;151189;10.1;4.0
52;2021-03-26;18934;2378;402263;153567;10.6;4.0
52;2021-03-27;7555;652;409818;154219;10.8;4.1
52;2021-03-28;2193;67;412011;154286;10.8;4.1
52;2021-03-29;10974;2719;422985;157005;11.1;4.1
52;2021-03-30;15684;3607;438669;160612;11.5;4.2
52;2021-03-31;13690;3284;452359;163896;11.9;4.3
52;2021-04-01;18884;3694;471243;167590;12.4;4.4
52;2021-04-02;17086;3517;488329;171107;12.8;4.5
52;2021-04-03;5520;1190;493849;172297;13.0;4.5
52;2021-04-04;1324;51;495173;172348;13.0;4.5
52;2021-04-05;1781;538;496954;172886;13.1;4.5
52;2021-04-06;11796;5256;508750;178142;13.4;4.7
52;2021-04-07;15196;5698;523946;183840;13.8;4.8
52;2021-04-08;21220;6392;545166;190232;14.3;5.0
52;2021-04-09;26636;5308;571802;195540;15.0;5.1
52;2021-04-10;10117;2363;581919;197903;15.3;5.2
52;2021-04-11;2567;434;584486;198337;15.4;5.2
52;2021-04-12;16342;6576;600828;204913;15.8;5.4
52;2021-04-13;20744;8167;621572;213080;16.3;5.6
52;2021-04-14;17663;6916;639235;219996;16.8;5.8
52;2021-04-15;21161;8024;660396;228020;17.4;6.0
52;2021-04-16;22603;7469;682999;235489;18.0;6.2
52;2021-04-17;9972;3033;692971;238522;18.2;6.3
52;2021-04-18;3037;1307;696008;239829;18.3;6.3
52;2021-04-19;14182;7811;710190;247640;18.7;6.5
52;2021-04-20;18284;9383;728474;257023;19.2;6.8
52;2021-04-21;15992;9156;744466;266179;19.6;7.0
52;2021-04-22;19423;10151;763889;276330;20.1;7.3
52;2021-04-23;20529;9962;784418;286292;20.6;7.5
52;2021-04-24;10015;4977;794433;291269;20.9;7.7
52;2021-04-25;3985;1948;798418;293217;21.0;7.7
52;2021-04-26;16842;9897;815260;303114;21.4;8.0
52;2021-04-27;21081;12550;836341;315664;22.0;8.3
52;2021-04-28;22771;10653;859112;326317;22.6;8.6
52;2021-04-29;25019;12671;884131;338988;23.3;8.9
52;2021-04-30;25643;12484;909774;351472;23.9;9.2
52;2021-05-01;8614;2478;918388;353950;24.2;9.3
52;2021-05-02;4300;1270;922688;355220;24.3;9.3
52;2021-05-03;19069;10620;941757;365840;24.8;9.6
52;2021-05-04;20095;14377;961852;380217;25.3;10.0
52;2021-05-05;20874;12756;982726;392973;25.8;10.3
52;2021-05-06;22487;13830;1005213;406803;26.4;10.7
52;2021-05-07;20716;18012;1025929;424815;27.0;11.2
52;2021-05-08;11227;2084;1037156;426899;27.3;11.2
52;2021-05-09;5399;2225;1042555;429124;27.4;11.3
52;2021-05-10;20799;17270;1063354;446394;28.0;11.7
52;2021-05-11;24928;19532;1088282;465926;28.6;12.3
52;2021-05-12;24830;17096;1113112;483022;29.3;12.7
52;2021-05-13;18582;2744;1131694;485766;29.8;12.8
52;2021-05-14;22761;12421;1154455;498187;30.4;13.1
52;2021-05-15;15654;5211;1170109;503398;30.8;13.2
52;2021-05-16;10287;1160;1180396;504558;31.0;13.3
52;2021-05-17;21156;14650;1201552;519208;31.6;13.7
52;2021-05-18;24904;14986;1226456;534194;32.3;14.1
52;2021-05-19;26829;11438;1253285;545632;33.0;14.4
52;2021-05-20;29334;11999;1282619;557631;33.7;14.7
52;2021-05-21;27397;13838;1310016;571469;34.5;15.0
52;2021-05-22;15426;4707;1325442;576176;34.9;15.2
52;2021-05-23;4471;1143;1329913;577319;35.0;15.2
52;2021-05-24;16006;2759;1345919;580078;35.4;15.3
52;2021-05-25;24472;14508;1370391;594586;36.0;15.6
52;2021-05-26;25180;12649;1395571;607235;36.7;16.0
52;2021-05-27;29103;14807;1424674;622042;37.5;16.4
52;2021-05-28;27963;17835;1452637;639877;38.2;16.8
52;2021-05-29;18338;7772;1470975;647649;38.7;17.0
52;2021-05-30;4230;1719;1475205;649368;38.8;17.1
52;2021-05-31;24437;15862;1499642;665230;39.4;17.5
52;2021-06-01;28846;17794;1528488;683024;40.2;18.0
52;2021-06-02;27481;15212;1555969;698236;40.9;18.4
52;2021-06-03;31724;16275;1587693;714511;41.8;18.8
52;2021-06-04;29223;20727;1616916;735238;42.5;19.3
52;2021-06-05;14540;11800;1631456;747038;42.9;19.6
52;2021-06-06;4778;3530;1636234;750568;43.0;19.7
52;2021-06-07;21719;20878;1657953;771446;43.6;20.3
52;2021-06-08;26442;22032;1684395;793478;44.3;20.9
52;2021-06-09;25666;18615;1710061;812093;45.0;21.4
52;2021-06-10;28734;17591;1738795;829684;45.7;21.8
52;2021-06-11;26970;24313;1765765;853997;46.4;22.5
52;2021-06-12;14596;11845;1780361;865842;46.8;22.8
52;2021-06-13;4383;4518;1784744;870360;46.9;22.9
52;2021-06-14;17610;25395;1802354;895755;47.4;23.6
52;2021-06-15;23711;25325;1826065;921080;48.0;24.2
52;2021-06-16;23283;22468;1849348;943548;48.6;24.8
52;2021-06-17;25927;23081;1875275;966629;49.3;25.4
52;2021-06-18;23243;28716;1898518;995345;49.9;26.2
52;2021-06-19;12435;14243;1910953;1009588;50.3;26.6
52;2021-06-20;3017;4417;1913970;1014005;50.3;26.7
52;2021-06-21;14837;28880;1928807;1042885;50.7;27.4
52;2021-06-22;17396;31774;1946203;1074659;51.2;28.3
52;2021-06-23;18429;26992;1964632;1101651;51.7;29.0
52;2021-06-24;20998;24069;1985630;1125720;52.2;29.6
52;2021-06-25;16595;31259;2002225;1156979;52.7;30.4
52;2021-06-26;8438;18079;2010663;1175058;52.9;30.9
52;2021-06-27;1336;7441;2011999;1182499;52.9;31.1
52;2021-06-28;10620;31102;2022619;1213601;53.2;31.9
52;2021-06-29;13662;34379;2036281;1247980;53.6;32.8
53;2020-12-27;0;0;0;0;0.0;0.0
53;2020-12-28;0;0;0;0;0.0;0.0
53;2020-12-29;0;0;0;0;0.0;0.0
53;2020-12-30;0;0;0;0;0.0;0.0
53;2020-12-31;0;0;0;0;0.0;0.0
53;2021-01-01;3;0;3;0;0.0;0.0
53;2021-01-02;4;0;7;0;0.0;0.0
53;2021-01-03;0;0;7;0;0.0;0.0
53;2021-01-04;43;0;50;0;0.0;0.0
53;2021-01-05;200;0;250;0;0.0;0.0
53;2021-01-06;331;1;581;1;0.0;0.0
53;2021-01-07;835;1;1416;2;0.0;0.0
53;2021-01-08;1213;0;2629;2;0.1;0.0
53;2021-01-09;34;0;2663;2;0.1;0.0
53;2021-01-10;4;0;2667;2;0.1;0.0
53;2021-01-11;1661;3;4328;5;0.1;0.0
53;2021-01-12;3380;1;7708;6;0.2;0.0
53;2021-01-13;3355;5;11063;11;0.3;0.0
53;2021-01-14;3814;30;14877;41;0.4;0.0
53;2021-01-15;3297;17;18174;58;0.5;0.0
53;2021-01-16;684;4;18858;62;0.6;0.0
53;2021-01-17;180;1;19038;63;0.6;0.0
53;2021-01-18;3362;7;22400;70;0.7;0.0
53;2021-01-19;8179;6;30579;76;0.9;0.0
53;2021-01-20;7060;4;37639;80;1.1;0.0
53;2021-01-21;11484;7;49123;87;1.5;0.0
53;2021-01-22;7813;13;56936;100;1.7;0.0
53;2021-01-23;1492;2;58428;102;1.7;0.0
53;2021-01-24;255;1;58683;103;1.8;0.0
53;2021-01-25;3056;35;61739;138;1.8;0.0
53;2021-01-26;4114;232;65853;370;2.0;0.0
53;2021-01-27;7239;325;73092;695;2.2;0.0
53;2021-01-28;7134;643;80226;1338;2.4;0.0
53;2021-01-29;4231;729;84457;2067;2.5;0.1
53;2021-01-30;844;43;85301;2110;2.6;0.1
53;2021-01-31;79;3;85380;2113;2.6;0.1
53;2021-02-01;2212;1026;87592;3139;2.6;0.1
53;2021-02-02;3439;2017;91031;5156;2.7;0.2
53;2021-02-03;3175;2185;94206;7341;2.8;0.2
53;2021-02-04;7096;2270;101302;9611;3.0;0.3
53;2021-02-05;5588;2134;106890;11745;3.2;0.4
53;2021-02-06;1201;277;108091;12022;3.2;0.4
53;2021-02-07;214;132;108305;12154;3.2;0.4
53;2021-02-08;1651;1532;109956;13686;3.3;0.4
53;2021-02-09;3981;5257;113937;18943;3.4;0.6
53;2021-02-10;3791;4651;117728;23594;3.5;0.7
53;2021-02-11;5738;8792;123466;32386;3.7;1.0
53;2021-02-12;5662;5255;129128;37641;3.9;1.1
53;2021-02-13;1232;852;130360;38493;3.9;1.2
53;2021-02-14;25;348;130385;38841;3.9;1.2
53;2021-02-15;2325;3586;132710;42427;4.0;1.3
53;2021-02-16;4055;3543;136765;45970;4.1;1.4
53;2021-02-17;4077;5373;140842;51343;4.2;1.5
53;2021-02-18;5954;5744;146796;57087;4.4;1.7
53;2021-02-19;5360;4858;152156;61945;4.6;1.9
53;2021-02-20;1190;892;153346;62837;4.6;1.9
53;2021-02-21;166;218;153512;63055;4.6;1.9
53;2021-02-22;2319;2834;155831;65889;4.7;2.0
53;2021-02-23;3952;3672;159783;69561;4.8;2.1
53;2021-02-24;4472;3786;164255;73347;4.9;2.2
53;2021-02-25;7955;7141;172210;80488;5.2;2.4
53;2021-02-26;8684;4409;180894;84897;5.4;2.5
53;2021-02-27;3450;1105;184344;86002;5.5;2.6
53;2021-02-28;228;194;184572;86196;5.5;2.6
53;2021-03-01;3481;2268;188053;88464;5.6;2.6
53;2021-03-02;5619;4462;193672;92926;5.8;2.8
53;2021-03-03;6450;3789;200122;96715;6.0;2.9
53;2021-03-04;9288;4926;209410;101641;6.3;3.0
53;2021-03-05;11920;5213;221330;106854;6.6;3.2
53;2021-03-06;5637;1022;226967;107876;6.8;3.2
53;2021-03-07;913;146;227880;108022;6.8;3.2
53;2021-03-08;5166;2214;233046;110236;7.0;3.3
53;2021-03-09;9669;2932;242715;113168;7.3;3.4
53;2021-03-10;9281;3373;251996;116541;7.5;3.5
53;2021-03-11;14305;4054;266301;120595;8.0;3.6
53;2021-03-12;18608;3264;284909;123859;8.5;3.7
53;2021-03-13;8813;949;293722;124808;8.8;3.7
53;2021-03-14;812;50;294534;124858;8.8;3.7
53;2021-03-15;6894;2035;301428;126893;9.0;3.8
53;2021-03-16;6984;3409;308412;130302;9.2;3.9
53;2021-03-17;8232;2823;316644;133125;9.5;4.0
53;2021-03-18;8723;4652;325367;137777;9.7;4.1
53;2021-03-19;12993;3647;338360;141424;10.1;4.2
53;2021-03-20;7131;818;345491;142242;10.3;4.3
53;2021-03-21;383;32;345874;142274;10.4;4.3
53;2021-03-22;7348;2163;353222;144437;10.6;4.3
53;2021-03-23;12995;3663;366217;148100;11.0;4.4
53;2021-03-24;14408;3235;380625;151335;11.4;4.5
53;2021-03-25;18286;3371;398911;154706;11.9;4.6
53;2021-03-26;20319;3205;419230;157911;12.6;4.7
53;2021-03-27;7407;1014;426637;158925;12.8;4.8
53;2021-03-28;528;86;427165;159011;12.8;4.8
53;2021-03-29;9801;3164;436966;162175;13.1;4.9
53;2021-03-30;15312;4596;452278;166771;13.5;5.0
53;2021-03-31;14151;4263;466429;171034;14.0;5.1
53;2021-04-01;18198;4270;484627;175304;14.5;5.2
53;2021-04-02;17899;4349;502526;179653;15.0;5.4
53;2021-04-03;6432;1427;508958;181080;15.2;5.4
53;2021-04-04;413;33;509371;181113;15.2;5.4
53;2021-04-05;1233;336;510604;181449;15.3;5.4
53;2021-04-06;12543;5669;523147;187118;15.7;5.6
53;2021-04-07;15020;5330;538167;192448;16.1;5.8
53;2021-04-08;20687;6095;558854;198543;16.7;5.9
53;2021-04-09;26650;5572;585504;204115;17.5;6.1
53;2021-04-10;10334;1724;595838;205839;17.8;6.2
53;2021-04-11;817;213;596655;206052;17.9;6.2
53;2021-04-12;15830;4913;612485;210965;18.3;6.3
53;2021-04-13;22694;7258;635179;218223;19.0;6.5
53;2021-04-14;19351;7923;654530;226146;19.6;6.8
53;2021-04-15;25358;8058;679888;234204;20.4;7.0
53;2021-04-16;26186;7537;706074;241741;21.1;7.2
53;2021-04-17;10397;3578;716471;245319;21.4;7.3
53;2021-04-18;1033;149;717504;245468;21.5;7.3
53;2021-04-19;15405;6531;732909;251999;21.9;7.5
53;2021-04-20;16929;9509;749838;261508;22.4;7.8
53;2021-04-21;16750;9438;766588;270946;22.9;8.1
53;2021-04-22;21753;10182;788341;281128;23.6;8.4
53;2021-04-23;21660;10080;810001;291208;24.2;8.7
53;2021-04-24;9985;4169;819986;295377;24.5;8.8
53;2021-04-25;905;334;820891;295711;24.6;8.9
53;2021-04-26;18248;8472;839139;304183;25.1;9.1
53;2021-04-27;19873;12054;859012;316237;25.7;9.5
53;2021-04-28;19949;10811;878961;327048;26.3;9.8
53;2021-04-29;23556;12281;902517;339329;27.0;10.2
53;2021-04-30;23903;12441;926420;351770;27.7;10.5
53;2021-05-01;5123;1637;931543;353407;27.9;10.6
53;2021-05-02;2793;521;934336;353928;28.0;10.6
53;2021-05-03;15719;9374;950055;363302;28.4;10.9
53;2021-05-04;15696;15793;965751;379095;28.9;11.3
53;2021-05-05;14942;14689;980693;393784;29.4;11.8
53;2021-05-06;19264;17844;999957;411628;29.9;12.3
53;2021-05-07;18655;18212;1018612;429840;30.5;12.9
53;2021-05-08;5485;1121;1024097;430961;30.7;12.9
53;2021-05-09;3511;861;1027608;431822;30.8;12.9
53;2021-05-10;16686;15218;1044294;447040;31.3;13.4
53;2021-05-11;18682;18727;1062976;465767;31.8;13.9
53;2021-05-12;21214;15635;1084190;481402;32.5;14.4
53;2021-05-13;9025;3955;1093215;485357;32.7;14.5
53;2021-05-14;21721;13739;1114936;499096;33.4;14.9
53;2021-05-15;13429;5338;1128365;504434;33.8;15.1
53;2021-05-16;3222;877;1131587;505311;33.9;15.1
53;2021-05-17;18219;11170;1149806;516481;34.4;15.5
53;2021-05-18;21063;12407;1170869;528888;35.1;15.8
53;2021-05-19;21637;10636;1192506;539524;35.7;16.2
53;2021-05-20;23871;14722;1216377;554246;36.4;16.6
53;2021-05-21;22872;15231;1239249;569477;37.1;17.0
53;2021-05-22;13149;5839;1252398;575316;37.5;17.2
53;2021-05-23;2977;310;1255375;575626;37.6;17.2
53;2021-05-24;13954;2499;1269329;578125;38.0;17.3
53;2021-05-25;19976;12814;1289305;590939;38.6;17.7
53;2021-05-26;19275;13788;1308580;604727;39.2;18.1
53;2021-05-27;22058;17416;1330638;622143;39.8;18.6
53;2021-05-28;21781;20404;1352419;642547;40.5;19.2
53;2021-05-29;12150;7330;1364569;649877;40.9;19.5
53;2021-05-30;2308;472;1366877;650349;40.9;19.5
53;2021-05-31;20693;14092;1387570;664441;41.5;19.9
53;2021-06-01;22958;16472;1410528;680913;42.2;20.4
53;2021-06-02;21774;14231;1432302;695144;42.9;20.8
53;2021-06-03;25046;16857;1457348;712001;43.6;21.3
53;2021-06-04;23082;22569;1480430;734570;44.3;22.0
53;2021-06-05;17310;9003;1497740;743573;44.8;22.3
53;2021-06-06;4998;1325;1502738;744898;45.0;22.3
53;2021-06-07;18398;17789;1521136;762687;45.5;22.8
53;2021-06-08;23364;18043;1544500;780730;46.2;23.4
53;2021-06-09;23616;15874;1568116;796604;46.9;23.8
53;2021-06-10;26787;16872;1594903;813476;47.7;24.4
53;2021-06-11;26195;21431;1621098;834907;48.5;25.0
53;2021-06-12;18602;7510;1639700;842417;49.1;25.2
53;2021-06-13;7794;3119;1647494;845536;49.3;25.3
53;2021-06-14;16037;19800;1663531;865336;49.8;25.9
53;2021-06-15;20056;20953;1683587;886289;50.4;26.5
53;2021-06-16;21172;18533;1704759;904822;51.0;27.1
53;2021-06-17;21884;20094;1726643;924916;51.7;27.7
53;2021-06-18;22240;25642;1748883;950558;52.4;28.5
53;2021-06-19;12832;9607;1761715;960165;52.7;28.7
53;2021-06-20;5453;2680;1767168;962845;52.9;28.8
53;2021-06-21;14600;22351;1781768;985196;53.3;29.5
53;2021-06-22;16986;24914;1798754;1010110;53.8;30.2
53;2021-06-23;16714;23518;1815468;1033628;54.3;30.9
53;2021-06-24;19030;21834;1834498;1055462;54.9;31.6
53;2021-06-25;15477;29032;1849975;1084494;55.4;32.5
53;2021-06-26;7139;13963;1857114;1098457;55.6;32.9
53;2021-06-27;3886;3309;1861000;1101766;55.7;33.0
53;2021-06-28;9657;24195;1870657;1125961;56.0;33.7
53;2021-06-29;11654;27207;1882311;1153168;56.4;34.5
75;2020-12-27;1;0;1;0;0.0;0.0
75;2020-12-28;2;0;3;0;0.0;0.0
75;2020-12-29;3;0;6;0;0.0;0.0
75;2020-12-30;2;0;8;0;0.0;0.0
75;2020-12-31;0;0;8;0;0.0;0.0
75;2021-01-01;4;0;12;0;0.0;0.0
75;2021-01-02;2;0;14;0;0.0;0.0
75;2021-01-03;0;0;14;0;0.0;0.0
75;2021-01-04;90;0;104;0;0.0;0.0
75;2021-01-05;124;0;228;0;0.0;0.0
75;2021-01-06;736;1;964;1;0.0;0.0
75;2021-01-07;4923;2;5887;3;0.1;0.0
75;2021-01-08;5468;6;11355;9;0.2;0.0
75;2021-01-09;845;1;12200;10;0.2;0.0
75;2021-01-10;479;0;12679;10;0.2;0.0
75;2021-01-11;3585;1;16264;11;0.3;0.0
75;2021-01-12;5949;6;22213;17;0.4;0.0
75;2021-01-13;6553;15;28766;32;0.5;0.0
75;2021-01-14;8123;63;36889;95;0.6;0.0
75;2021-01-15;7629;32;44518;127;0.7;0.0
75;2021-01-16;1607;14;46125;141;0.8;0.0
75;2021-01-17;425;6;46550;147;0.8;0.0
75;2021-01-18;6888;32;53438;179;0.9;0.0
75;2021-01-19;14054;13;67492;192;1.1;0.0
75;2021-01-20;15535;27;83027;219;1.4;0.0
75;2021-01-21;16966;21;99993;240;1.7;0.0
75;2021-01-22;12971;23;112964;263;1.9;0.0
75;2021-01-23;4421;3;117385;266;2.0;0.0
75;2021-01-24;700;1;118085;267;2.0;0.0
75;2021-01-25;8871;219;126956;486;2.1;0.0
75;2021-01-26;11722;454;138678;940;2.3;0.0
75;2021-01-27;12279;770;150957;1710;2.5;0.0
75;2021-01-28;12941;2658;163898;4368;2.7;0.1
75;2021-01-29;10004;2984;173902;7352;2.9;0.1
75;2021-01-30;3379;516;177281;7868;3.0;0.1
75;2021-01-31;646;420;177927;8288;3.0;0.1
75;2021-02-01;5717;2639;183644;10927;3.1;0.2
75;2021-02-02;9614;4355;193258;15282;3.2;0.3
75;2021-02-03;9602;4373;202860;19655;3.4;0.3
75;2021-02-04;10764;5682;213624;25337;3.6;0.4
75;2021-02-05;7490;5637;221114;30974;3.7;0.5
75;2021-02-06;2381;1105;223495;32079;3.7;0.5
75;2021-02-07;673;252;224168;32331;3.7;0.5
75;2021-02-08;5138;3652;229306;35983;3.8;0.6
75;2021-02-09;7315;8082;236621;44065;3.9;0.7
75;2021-02-10;7542;8742;244163;52807;4.1;0.9
75;2021-02-11;8861;10270;253024;63077;4.2;1.1
75;2021-02-12;7419;8834;260443;71911;4.3;1.2
75;2021-02-13;1953;1761;262396;73672;4.4;1.2
75;2021-02-14;274;364;262670;74036;4.4;1.2
75;2021-02-15;3198;7834;265868;81870;4.4;1.4
75;2021-02-16;4629;10530;270497;92400;4.5;1.5
75;2021-02-17;4768;11299;275265;103699;4.6;1.7
75;2021-02-18;5458;12842;280723;116541;4.7;1.9
75;2021-02-19;5423;9634;286146;126175;4.8;2.1
75;2021-02-20;989;2633;287135;128808;4.8;2.1
75;2021-02-21;188;666;287323;129474;4.8;2.2
75;2021-02-22;3655;8513;290978;137987;4.8;2.3
75;2021-02-23;5365;10952;296343;148939;4.9;2.5
75;2021-02-24;6135;10287;302478;159226;5.0;2.7
75;2021-02-25;10056;11719;312534;170945;5.2;2.8
75;2021-02-26;12276;8867;324810;179812;5.4;3.0
75;2021-02-27;5788;2487;330598;182299;5.5;3.0
75;2021-02-28;312;694;330910;182993;5.5;3.0
75;2021-03-01;5100;7011;336010;190004;5.6;3.2
75;2021-03-02;9361;8170;345371;198174;5.8;3.3
75;2021-03-03;10828;7772;356199;205946;5.9;3.4
75;2021-03-04;16745;8176;372944;214122;6.2;3.6
75;2021-03-05;20820;7473;393764;221595;6.6;3.7
75;2021-03-06;13415;2235;407179;223830;6.8;3.7
75;2021-03-07;3722;468;410901;224298;6.8;3.7
75;2021-03-08;10001;5387;420902;229685;7.0;3.8
75;2021-03-09;16860;6497;437762;236182;7.3;3.9
75;2021-03-10;18261;6317;456023;242499;7.6;4.0
75;2021-03-11;26441;6689;482464;249188;8.0;4.2
75;2021-03-12;31312;5278;513776;254466;8.6;4.2
75;2021-03-13;17863;1205;531639;255671;8.9;4.3
75;2021-03-14;1713;251;533352;255922;8.9;4.3
75;2021-03-15;14079;3428;547431;259350;9.1;4.3
75;2021-03-16;13690;3712;561121;263062;9.4;4.4
75;2021-03-17;14759;3880;575880;266942;9.6;4.4
75;2021-03-18;16386;4686;592266;271628;9.9;4.5
75;2021-03-19;22440;4299;614706;275927;10.2;4.6
75;2021-03-20;14031;824;628737;276751;10.5;4.6
75;2021-03-21;2474;107;631211;276858;10.5;4.6
75;2021-03-22;16801;3465;648012;280323;10.8;4.7
75;2021-03-23;25286;3894;673298;284217;11.2;4.7
75;2021-03-24;27170;4314;700468;288531;11.7;4.8
75;2021-03-25;35666;4654;736134;293185;12.3;4.9
75;2021-03-26;38631;4190;774765;297375;12.9;5.0
75;2021-03-27;15717;1286;790482;298661;13.2;5.0
75;2021-03-28;2727;396;793209;299057;13.2;5.0
75;2021-03-29;22846;4152;816055;303209;13.6;5.1
75;2021-03-30;31664;5981;847719;309190;14.1;5.2
75;2021-03-31;29762;5948;877481;315138;14.6;5.3
75;2021-04-01;35032;6960;912513;322098;15.2;5.4
75;2021-04-02;32363;6881;944876;328979;15.7;5.5
75;2021-04-03;12843;2642;957719;331621;16.0;5.5
75;2021-04-04;2138;341;959857;331962;16.0;5.5
75;2021-04-05;6369;604;966226;332566;16.1;5.5
75;2021-04-06;26393;10841;992619;343407;16.5;5.7
75;2021-04-07;32387;11028;1025006;354435;17.1;5.9
75;2021-04-08;39620;12380;1064626;366815;17.7;6.1
75;2021-04-09;49271;11001;1113897;377816;18.6;6.3
75;2021-04-10;24456;4983;1138353;382799;19.0;6.4
75;2021-04-11;4970;721;1143323;383520;19.1;6.4
75;2021-04-12;27386;11858;1170709;395378;19.5;6.6
75;2021-04-13;35753;14344;1206462;409722;20.1;6.8
75;2021-04-14;35455;14503;1241917;424225;20.7;7.1
75;2021-04-15;37713;15075;1279630;439300;21.3;7.3
75;2021-04-16;37156;15141;1316786;454441;21.9;7.6
75;2021-04-17;19577;7393;1336363;461834;22.3;7.7
75;2021-04-18;4074;2056;1340437;463890;22.3;7.7
75;2021-04-19;20911;14962;1361348;478852;22.7;8.0
75;2021-04-20;28504;19118;1389852;497970;23.2;8.3
75;2021-04-21;27861;18090;1417713;516060;23.6;8.6
75;2021-04-22;30380;19700;1448093;535760;24.1;8.9
75;2021-04-23;29092;20259;1477185;556019;24.6;9.3
75;2021-04-24;17015;9149;1494200;565168;24.9;9.4
75;2021-04-25;4598;1502;1498798;566670;25.0;9.4
75;2021-04-26;22328;19303;1521126;585973;25.4;9.8
75;2021-04-27;29209;24322;1550335;610295;25.8;10.2
75;2021-04-28;31161;24027;1581496;634322;26.4;10.6
75;2021-04-29;37277;26649;1618773;660971;27.0;11.0
75;2021-04-30;37771;25879;1656544;686850;27.6;11.4
75;2021-05-01;15683;5754;1672227;692604;27.9;11.5
75;2021-05-02;7260;2598;1679487;695202;28.0;11.6
75;2021-05-03;27272;21187;1706759;716389;28.4;11.9
75;2021-05-04;30372;29298;1737131;745687;29.0;12.4
75;2021-05-05;31521;31000;1768652;776687;29.5;12.9
75;2021-05-06;35980;32404;1804632;809091;30.1;13.5
75;2021-05-07;37459;34369;1842091;843460;30.7;14.1
75;2021-05-08;17715;8093;1859806;851553;31.0;14.2
75;2021-05-09;7314;4153;1867120;855706;31.1;14.3
75;2021-05-10;25240;29014;1892360;884720;31.5;14.7
75;2021-05-11;35621;32971;1927981;917691;32.1;15.3
75;2021-05-12;35642;30155;1963623;947846;32.7;15.8
75;2021-05-13;22721;7548;1986344;955394;33.1;15.9
75;2021-05-14;33927;20876;2020271;976270;33.7;16.3
75;2021-05-15;22959;11117;2043230;987387;34.1;16.5
75;2021-05-16;7416;2064;2050646;989451;34.2;16.5
75;2021-05-17;33942;19248;2084588;1008699;34.7;16.8
75;2021-05-18;42930;19967;2127518;1028666;35.5;17.1
75;2021-05-19;42780;17632;2170298;1046298;36.2;17.4
75;2021-05-20;45984;20378;2216282;1066676;36.9;17.8
75;2021-05-21;42929;21392;2259211;1088068;37.7;18.1
75;2021-05-22;23259;9809;2282470;1097877;38.0;18.3
75;2021-05-23;7810;1421;2290280;1099298;38.2;18.3
75;2021-05-24;18851;4076;2309131;1103374;38.5;18.4
75;2021-05-25;36870;20953;2346001;1124327;39.1;18.7
75;2021-05-26;38324;21494;2384325;1145821;39.7;19.1
75;2021-05-27;42952;27092;2427277;1172913;40.5;19.5
75;2021-05-28;38895;32290;2466172;1205203;41.1;20.1
75;2021-05-29;19670;18096;2485842;1223299;41.4;20.4
75;2021-05-30;5781;2286;2491623;1225585;41.5;20.4
75;2021-05-31;31656;23128;2523279;1248713;42.1;20.8
75;2021-06-01;41081;29602;2564360;1278315;42.7;21.3
75;2021-06-02;41390;28243;2605750;1306558;43.4;21.8
75;2021-06-03;47613;31222;2653363;1337780;44.2;22.3
75;2021-06-04;44405;36973;2697768;1374753;45.0;22.9
75;2021-06-05;24413;18538;2722181;1393291;45.4;23.2
75;2021-06-06;8733;4322;2730914;1397613;45.5;23.3
75;2021-06-07;31402;31546;2762316;1429159;46.0;23.8
75;2021-06-08;38444;35962;2800760;1465121;46.7;24.4
75;2021-06-09;39350;32941;2840110;1498062;47.3;25.0
75;2021-06-10;42948;31827;2883058;1529889;48.1;25.5
75;2021-06-11;40274;40327;2923332;1570216;48.7;26.2
75;2021-06-12;23199;21535;2946531;1591751;49.1;26.5
75;2021-06-13;8100;5658;2954631;1597409;49.2;26.6
75;2021-06-14;23978;37941;2978609;1635350;49.6;27.3
75;2021-06-15;33145;41693;3011754;1677043;50.2;28.0
75;2021-06-16;34659;37297;3046413;1714340;50.8;28.6
75;2021-06-17;36085;38582;3082498;1752922;51.4;29.2
75;2021-06-18;34707;45304;3117205;1798226;52.0;30.0
75;2021-06-19;20150;23251;3137355;1821477;52.3;30.4
75;2021-06-20;6211;5731;3143566;1827208;52.4;30.5
75;2021-06-21;21419;37339;3164985;1864547;52.7;31.1
75;2021-06-22;25235;43601;3190220;1908148;53.2;31.8
75;2021-06-23;26179;40809;3216399;1948957;53.6;32.5
75;2021-06-24;27816;35602;3244215;1984559;54.1;33.1
75;2021-06-25;23987;48625;3268202;2033184;54.5;33.9
75;2021-06-26;13600;26789;3281802;2059973;54.7;34.3
75;2021-06-27;4563;8572;3286365;2068545;54.8;34.5
75;2021-06-28;14799;44586;3301164;2113131;55.0;35.2
75;2021-06-29;18762;51633;3319926;2164764;55.3;36.1
76;2020-12-27;0;0;0;0;0.0;0.0
76;2020-12-28;4;0;4;0;0.0;0.0
76;2020-12-29;0;0;4;0;0.0;0.0
76;2020-12-30;0;0;4;0;0.0;0.0
76;2020-12-31;1;0;5;0;0.0;0.0
76;2021-01-01;3;0;8;0;0.0;0.0
76;2021-01-02;2;0;10;0;0.0;0.0
76;2021-01-03;2;0;12;0;0.0;0.0
76;2021-01-04;59;1;71;1;0.0;0.0
76;2021-01-05;473;1;544;2;0.0;0.0
76;2021-01-06;784;2;1328;4;0.0;0.0
76;2021-01-07;2538;3;3866;7;0.1;0.0
76;2021-01-08;3215;2;7081;9;0.1;0.0
76;2021-01-09;1540;1;8621;10;0.1;0.0
76;2021-01-10;517;0;9138;10;0.2;0.0
76;2021-01-11;3526;9;12664;19;0.2;0.0
76;2021-01-12;5746;10;18410;29;0.3;0.0
76;2021-01-13;6475;14;24885;43;0.4;0.0
76;2021-01-14;9001;86;33886;129;0.6;0.0
76;2021-01-15;7254;34;41140;163;0.7;0.0
76;2021-01-16;1954;21;43094;184;0.7;0.0
76;2021-01-17;710;2;43804;186;0.7;0.0
76;2021-01-18;7704;21;51508;207;0.9;0.0
76;2021-01-19;11212;31;62720;238;1.1;0.0
76;2021-01-20;13726;26;76446;264;1.3;0.0
76;2021-01-21;16716;22;93162;286;1.6;0.0
76;2021-01-22;11926;34;105088;320;1.8;0.0
76;2021-01-23;3897;9;108985;329;1.8;0.0
76;2021-01-24;771;12;109756;341;1.9;0.0
76;2021-01-25;7829;98;117585;439;2.0;0.0
76;2021-01-26;10345;283;127930;722;2.2;0.0
76;2021-01-27;10849;483;138779;1205;2.3;0.0
76;2021-01-28;10138;1695;148917;2900;2.5;0.0
76;2021-01-29;8090;1990;157007;4890;2.6;0.1
76;2021-01-30;3185;772;160192;5662;2.7;0.1
76;2021-01-31;521;267;160713;5929;2.7;0.1
76;2021-02-01;5861;2601;166574;8530;2.8;0.1
76;2021-02-02;10059;4002;176633;12532;3.0;0.2
76;2021-02-03;9523;4068;186156;16600;3.1;0.3
76;2021-02-04;10109;5956;196265;22556;3.3;0.4
76;2021-02-05;7774;5027;204039;27583;3.4;0.5
76;2021-02-06;2696;1051;206735;28634;3.5;0.5
76;2021-02-07;542;498;207277;29132;3.5;0.5
76;2021-02-08;4842;4528;212119;33660;3.6;0.6
76;2021-02-09;6329;6821;218448;40481;3.7;0.7
76;2021-02-10;7184;9236;225632;49717;3.8;0.8
76;2021-02-11;9146;10735;234778;60452;4.0;1.0
76;2021-02-12;8050;7688;242828;68140;4.1;1.2
76;2021-02-13;2648;2271;245476;70411;4.1;1.2
76;2021-02-14;358;994;245834;71405;4.1;1.2
76;2021-02-15;3382;6469;249216;77874;4.2;1.3
76;2021-02-16;4246;8693;253462;86567;4.3;1.5
76;2021-02-17;4380;9654;257842;96221;4.4;1.6
76;2021-02-18;5894;9969;263736;106190;4.5;1.8
76;2021-02-19;4859;8114;268595;114304;4.5;1.9
76;2021-02-20;1534;3037;270129;117341;4.6;2.0
76;2021-02-21;265;595;270394;117936;4.6;2.0
76;2021-02-22;3287;7659;273681;125595;4.6;2.1
76;2021-02-23;4926;10240;278607;135835;4.7;2.3
76;2021-02-24;4652;10424;283259;146259;4.8;2.5
76;2021-02-25;8326;9909;291585;156168;4.9;2.6
76;2021-02-26;9650;8394;301235;164562;5.1;2.8
76;2021-02-27;3736;3094;304971;167656;5.1;2.8
76;2021-02-28;432;453;305403;168109;5.2;2.8
76;2021-03-01;5314;6146;310717;174255;5.2;2.9
76;2021-03-02;8229;7559;318946;181814;5.4;3.1
76;2021-03-03;9263;7490;328209;189304;5.5;3.2
76;2021-03-04;14334;7889;342543;197193;5.8;3.3
76;2021-03-05;16873;7121;359416;204314;6.1;3.4
76;2021-03-06;15887;2169;375303;206483;6.3;3.5
76;2021-03-07;11377;470;386680;206953;6.5;3.5
76;2021-03-08;9981;5531;396661;212484;6.7;3.6
76;2021-03-09;16233;6474;412894;218958;7.0;3.7
76;2021-03-10;16429;6494;429323;225452;7.2;3.8
76;2021-03-11;22603;6407;451926;231859;7.6;3.9
76;2021-03-12;26447;5265;478373;237124;8.1;4.0
76;2021-03-13;14927;2165;493300;239289;8.3;4.0
76;2021-03-14;2323;355;495623;239644;8.4;4.0
76;2021-03-15;13521;3300;509144;242944;8.6;4.1
76;2021-03-16;11761;4526;520905;247470;8.8;4.2
76;2021-03-17;12843;3969;533748;251439;9.0;4.2
76;2021-03-18;13704;4986;547452;256425;9.2;4.3
76;2021-03-19;18657;4012;566109;260437;9.6;4.4
76;2021-03-20;10662;1132;576771;261569;9.7;4.4
76;2021-03-21;3198;224;579969;261793;9.8;4.4
76;2021-03-22;14692;3585;594661;265378;10.0;4.5
76;2021-03-23;22248;4328;616909;269706;10.4;4.6
76;2021-03-24;23611;4203;640520;273909;10.8;4.6
76;2021-03-25;32017;4616;672537;278525;11.4;4.7
76;2021-03-26;30849;4080;703386;282605;11.9;4.8
76;2021-03-27;16240;1419;719626;284024;12.1;4.8
76;2021-03-28;4870;194;724496;284218;12.2;4.8
76;2021-03-29;22307;4888;746803;289106;12.6;4.9
76;2021-03-30;29725;5721;776528;294827;13.1;5.0
76;2021-03-31;26893;5595;803421;300422;13.6;5.1
76;2021-04-01;34461;5904;837882;306326;14.1;5.2
76;2021-04-02;29348;5782;867230;312108;14.6;5.3
76;2021-04-03;12156;2850;879386;314958;14.8;5.3
76;2021-04-04;4352;660;883738;315618;14.9;5.3
76;2021-04-05;4291;676;888029;316294;15.0;5.3
76;2021-04-06;22856;9741;910885;326035;15.4;5.5
76;2021-04-07;25274;9866;936159;335901;15.8;5.7
76;2021-04-08;33123;10237;969282;346138;16.4;5.8
76;2021-04-09;38901;9634;1008183;355772;17.0;6.0
76;2021-04-10;22703;5157;1030886;360929;17.4;6.1
76;2021-04-11;8861;1431;1039747;362360;17.5;6.1
76;2021-04-12;26041;10513;1065788;372873;18.0;6.3
76;2021-04-13;35797;12848;1101585;385721;18.6;6.5
76;2021-04-14;32872;13250;1134457;398971;19.1;6.7
76;2021-04-15;37467;13848;1171924;412819;19.8;7.0
76;2021-04-16;34431;13150;1206355;425969;20.4;7.2
76;2021-04-17;21390;6662;1227745;432631;20.7;7.3
76;2021-04-18;7714;2689;1235459;435320;20.9;7.3
76;2021-04-19;22065;12906;1257524;448226;21.2;7.6
76;2021-04-20;27975;16741;1285499;464967;21.7;7.8
76;2021-04-21;27026;16934;1312525;481901;22.2;8.1
76;2021-04-22;30374;17942;1342899;499843;22.7;8.4
76;2021-04-23;28717;16400;1371616;516243;23.2;8.7
76;2021-04-24;18505;10396;1390121;526639;23.5;8.9
76;2021-04-25;6932;4181;1397053;530820;23.6;9.0
76;2021-04-26;19954;18395;1417007;549215;23.9;9.3
76;2021-04-27;26751;21402;1443758;570617;24.4;9.6
76;2021-04-28;25912;20965;1469670;591582;24.8;10.0
76;2021-04-29;29744;23193;1499414;614775;25.3;10.4
76;2021-04-30;30789;20140;1530203;634915;25.8;10.7
76;2021-05-01;17427;7019;1547630;641934;26.1;10.8
76;2021-05-02;9498;4769;1557128;646703;26.3;10.9
76;2021-05-03;26532;16772;1583660;663475;26.7;11.2
76;2021-05-04;30013;25815;1613673;689290;27.2;11.6
76;2021-05-05;28200;26394;1641873;715684;27.7;12.1
76;2021-05-06;31042;30860;1672915;746544;28.2;12.6
76;2021-05-07;31651;30773;1704566;777317;28.8;13.1
76;2021-05-08;17368;10551;1721934;787868;29.1;13.3
76;2021-05-09;9723;8669;1731657;796537;29.2;13.4
76;2021-05-10;24113;28028;1755770;824565;29.6;13.9
76;2021-05-11;31664;33060;1787434;857625;30.2;14.5
76;2021-05-12;33354;29387;1820788;887012;30.7;15.0
76;2021-05-13;25966;9719;1846754;896731;31.2;15.1
76;2021-05-14;34557;21316;1881311;918047;31.8;15.5
76;2021-05-15;24498;12194;1905809;930241;32.2;15.7
76;2021-05-16;15466;3793;1921275;934034;32.4;15.8
76;2021-05-17;27861;19250;1949136;953284;32.9;16.1
76;2021-05-18;35451;19496;1984587;972780;33.5;16.4
76;2021-05-19;36778;16832;2021365;989612;34.1;16.7
76;2021-05-20;40926;18644;2062291;1008256;34.8;17.0
76;2021-05-21;37709;19956;2100000;1028212;35.4;17.4
76;2021-05-22;26949;9258;2126949;1037470;35.9;17.5
76;2021-05-23;13296;1804;2140245;1039274;36.1;17.5
76;2021-05-24;15390;4106;2155635;1043380;36.4;17.6
76;2021-05-25;31577;20734;2187212;1064114;36.9;18.0
76;2021-05-26;33345;19190;2220557;1083304;37.5;18.3
76;2021-05-27;36273;24399;2256830;1107703;38.1;18.7
76;2021-05-28;32456;28250;2289286;1135953;38.6;19.2
76;2021-05-29;19583;16738;2308869;1152691;39.0;19.5
76;2021-05-30;6219;6306;2315088;1158997;39.1;19.6
76;2021-05-31;25765;22856;2340853;1181853;39.5;19.9
76;2021-06-01;31198;29802;2372051;1211655;40.0;20.5
76;2021-06-02;30724;28073;2402775;1239728;40.6;20.9
76;2021-06-03;34167;33108;2436942;1272836;41.1;21.5
76;2021-06-04;35045;34239;2471987;1307075;41.7;22.1
76;2021-06-05;26001;19723;2497988;1326798;42.2;22.4
76;2021-06-06;14098;6468;2512086;1333266;42.4;22.5
76;2021-06-07;25732;27668;2537818;1360934;42.8;23.0
76;2021-06-08;32382;31576;2570200;1392510;43.4;23.5
76;2021-06-09;32254;29081;2602454;1421591;43.9;24.0
76;2021-06-10;31912;29463;2634366;1451054;44.5;24.5
76;2021-06-11;33529;36120;2667895;1487174;45.0;25.1
76;2021-06-12;23183;21898;2691078;1509072;45.4;25.5
76;2021-06-13;12023;7135;2703101;1516207;45.6;25.6
76;2021-06-14;21540;33611;2724641;1549818;46.0;26.2
76;2021-06-15;28715;39696;2753356;1589514;46.5;26.8
76;2021-06-16;26981;36344;2780337;1625858;46.9;27.4
76;2021-06-17;26767;34163;2807104;1660021;47.4;28.0
76;2021-06-18;27376;41113;2834480;1701134;47.8;28.7
76;2021-06-19;20795;23115;2855275;1724249;48.2;29.1
76;2021-06-20;8907;10339;2864182;1734588;48.3;29.3
76;2021-06-21;15029;35208;2879211;1769796;48.6;29.9
76;2021-06-22;18210;40460;2897421;1810256;48.9;30.6
76;2021-06-23;18937;37956;2916358;1848212;49.2;31.2
76;2021-06-24;17429;35334;2933787;1883546;49.5;31.8
76;2021-06-25;18255;44775;2952042;1928321;49.8;32.5
76;2021-06-26;12220;28871;2964262;1957192;50.0;33.0
76;2021-06-27;5713;14599;2969975;1971791;50.1;33.3
76;2021-06-28;12581;38119;2982556;2009910;50.3;33.9
76;2021-06-29;15074;43537;2997630;2053447;50.6;34.7
84;2020-12-27;1;0;1;0;0.0;0.0
84;2020-12-28;7;0;8;0;0.0;0.0
84;2020-12-29;5;0;13;0;0.0;0.0
84;2020-12-30;6;0;19;0;0.0;0.0
84;2020-12-31;15;0;34;0;0.0;0.0
84;2021-01-01;10;0;44;0;0.0;0.0
84;2021-01-02;2;1;46;1;0.0;0.0
84;2021-01-03;0;0;46;1;0.0;0.0
84;2021-01-04;174;0;220;1;0.0;0.0
84;2021-01-05;468;1;688;2;0.0;0.0
84;2021-01-06;1135;1;1823;3;0.0;0.0
84;2021-01-07;2887;3;4710;6;0.1;0.0
84;2021-01-08;3081;3;7791;9;0.1;0.0
84;2021-01-09;513;1;8304;10;0.1;0.0
84;2021-01-10;161;0;8465;10;0.1;0.0
84;2021-01-11;4295;9;12760;19;0.2;0.0
84;2021-01-12;6364;17;19124;36;0.2;0.0
84;2021-01-13;6845;15;25969;51;0.3;0.0
84;2021-01-14;9082;56;35051;107;0.4;0.0
84;2021-01-15;7774;32;42825;139;0.5;0.0
84;2021-01-16;2953;7;45778;146;0.6;0.0
84;2021-01-17;920;2;46698;148;0.6;0.0
84;2021-01-18;8967;34;55665;182;0.7;0.0
84;2021-01-19;15048;85;70713;267;0.9;0.0
84;2021-01-20;15496;36;86209;303;1.1;0.0
84;2021-01-21;14583;51;100792;354;1.3;0.0
84;2021-01-22;12415;45;113207;399;1.4;0.0
84;2021-01-23;4762;3;117969;402;1.5;0.0
84;2021-01-24;810;1;118779;403;1.5;0.0
84;2021-01-25;8766;154;127545;557;1.6;0.0
84;2021-01-26;11899;320;139444;877;1.7;0.0
84;2021-01-27;12081;620;151525;1497;1.9;0.0
84;2021-01-28;13834;1542;165359;3039;2.1;0.0
84;2021-01-29;10800;1311;176159;4350;2.2;0.1
84;2021-01-30;4141;147;180300;4497;2.2;0.1
84;2021-01-31;499;1;180799;4498;2.3;0.1
84;2021-02-01;6536;1887;187335;6385;2.3;0.1
84;2021-02-02;10595;3519;197930;9904;2.5;0.1
84;2021-02-03;11536;3929;209466;13833;2.6;0.2
84;2021-02-04;12564;5552;222030;19385;2.8;0.2
84;2021-02-05;8620;4697;230650;24082;2.9;0.3
84;2021-02-06;2653;960;233303;25042;2.9;0.3
84;2021-02-07;451;443;233754;25485;2.9;0.3
84;2021-02-08;6224;4968;239978;30453;3.0;0.4
84;2021-02-09;9343;8276;249321;38729;3.1;0.5
84;2021-02-10;9687;8628;259008;47357;3.2;0.6
84;2021-02-11;10705;9921;269713;57278;3.4;0.7
84;2021-02-12;9725;7950;279438;65228;3.5;0.8
84;2021-02-13;3503;2353;282941;67581;3.5;0.8
84;2021-02-14;624;457;283565;68038;3.5;0.8
84;2021-02-15;4886;8369;288451;76407;3.6;1.0
84;2021-02-16;6118;10779;294569;87186;3.7;1.1
84;2021-02-17;6086;11574;300655;98760;3.7;1.2
84;2021-02-18;7127;11764;307782;110524;3.8;1.4
84;2021-02-19;6665;9354;314447;119878;3.9;1.5
84;2021-02-20;1842;3268;316289;123146;3.9;1.5
84;2021-02-21;180;504;316469;123650;3.9;1.5
84;2021-02-22;4307;8853;320776;132503;4.0;1.6
84;2021-02-23;7300;11431;328076;143934;4.1;1.8
84;2021-02-24;7801;12034;335877;155968;4.2;1.9
84;2021-02-25;12746;13823;348623;169791;4.3;2.1
84;2021-02-26;14887;10359;363510;180150;4.5;2.2
84;2021-02-27;5565;2926;369075;183076;4.6;2.3
84;2021-02-28;501;514;369576;183590;4.6;2.3
84;2021-03-01;9303;6424;378879;190014;4.7;2.4
84;2021-03-02;14972;8828;393851;198842;4.9;2.5
84;2021-03-03;14822;8673;408673;207515;5.1;2.6
84;2021-03-04;21047;8469;429720;215984;5.3;2.7
84;2021-03-05;25800;7745;455520;223729;5.7;2.8
84;2021-03-06;19498;2408;475018;226137;5.9;2.8
84;2021-03-07;8418;480;483436;226617;6.0;2.8
84;2021-03-08;12221;6823;495657;233440;6.2;2.9
84;2021-03-09;20694;7716;516351;241156;6.4;3.0
84;2021-03-10;20252;7551;536603;248707;6.7;3.1
84;2021-03-11;29497;8188;566100;256895;7.0;3.2
84;2021-03-12;36193;7736;602293;264631;7.5;3.3
84;2021-03-13;21433;1898;623726;266529;7.8;3.3
84;2021-03-14;4685;484;628411;267013;7.8;3.3
84;2021-03-15;18879;4813;647290;271826;8.1;3.4
84;2021-03-16;17059;6115;664349;277941;8.3;3.5
84;2021-03-17;17589;6475;681938;284416;8.5;3.5
84;2021-03-18;21507;6967;703445;291383;8.8;3.6
84;2021-03-19;29002;5539;732447;296922;9.1;3.7
84;2021-03-20;14539;1418;746986;298340;9.3;3.7
84;2021-03-21;3239;278;750225;298618;9.3;3.7
84;2021-03-22;19746;5146;769971;303764;9.6;3.8
84;2021-03-23;30800;5978;800771;309742;10.0;3.9
84;2021-03-24;29983;5884;830754;315626;10.3;3.9
84;2021-03-25;41567;6524;872321;322150;10.9;4.0
84;2021-03-26;42988;6808;915309;328958;11.4;4.1
84;2021-03-27;18223;2940;933532;331898;11.6;4.1
84;2021-03-28;6513;605;940045;332503;11.7;4.1
84;2021-03-29;22960;7952;963005;340455;12.0;4.2
84;2021-03-30;34976;10242;997981;350697;12.4;4.4
84;2021-03-31;29606;11054;1027587;361751;12.8;4.5
84;2021-04-01;37293;11482;1064880;373233;13.3;4.6
84;2021-04-02;34900;11404;1099780;384637;13.7;4.8
84;2021-04-03;14800;6238;1114580;390875;13.9;4.9
84;2021-04-04;9932;2003;1124512;392878;14.0;4.9
84;2021-04-05;13533;1681;1138045;394559;14.2;4.9
84;2021-04-06;26324;13257;1164369;407816;14.5;5.1
84;2021-04-07;29508;14704;1193877;422520;14.9;5.3
84;2021-04-08;39706;15496;1233583;438016;15.4;5.5
84;2021-04-09;49462;15127;1283045;453143;16.0;5.6
84;2021-04-10;20470;8159;1303515;461302;16.2;5.7
84;2021-04-11;7229;2703;1310744;464005;16.3;5.8
84;2021-04-12;27318;15606;1338062;479611;16.7;6.0
84;2021-04-13;36153;19424;1374215;499035;17.1;6.2
84;2021-04-14;34648;18297;1408863;517332;17.5;6.4
84;2021-04-15;40154;19731;1449017;537063;18.0;6.7
84;2021-04-16;38243;20128;1487260;557191;18.5;6.9
84;2021-04-17;20472;9051;1507732;566242;18.8;7.0
84;2021-04-18;6841;2714;1514573;568956;18.9;7.1
84;2021-04-19;26250;18598;1540823;587554;19.2;7.3
84;2021-04-20;31232;22538;1572055;610092;19.6;7.6
84;2021-04-21;28068;21489;1600123;631581;19.9;7.9
84;2021-04-22;32278;22643;1632401;654224;20.3;8.1
84;2021-04-23;32726;23130;1665127;677354;20.7;8.4
84;2021-04-24;17866;11908;1682993;689262;21.0;8.6
84;2021-04-25;7138;4293;1690131;693555;21.0;8.6
84;2021-04-26;23735;20062;1713866;713617;21.3;8.9
84;2021-04-27;31797;25281;1745663;738898;21.7;9.2
84;2021-04-28;32505;24844;1778168;763742;22.1;9.5
84;2021-04-29;39670;26578;1817838;790320;22.6;9.8
84;2021-04-30;38166;27884;1856004;818204;23.1;10.2
84;2021-05-01;17163;5389;1873167;823593;23.3;10.3
84;2021-05-02;7986;8577;1881153;832170;23.4;10.4
84;2021-05-03;30376;27515;1911529;859685;23.8;10.7
84;2021-05-04;37161;33780;1948690;893465;24.3;11.1
84;2021-05-05;40268;30185;1988958;923650;24.8;11.5
84;2021-05-06;46642;32669;2035600;956319;25.3;11.9
84;2021-05-07;47074;36820;2082674;993139;25.9;12.4
84;2021-05-08;22380;7670;2105054;1000809;26.2;12.5
84;2021-05-09;15928;8909;2120982;1009718;26.4;12.6
84;2021-05-10;36145;32004;2157127;1041722;26.9;13.0
84;2021-05-11;52667;36291;2209794;1078013;27.5;13.4
84;2021-05-12;56962;31899;2266756;1109912;28.2;13.8
84;2021-05-13;47441;10528;2314197;1120440;28.8;13.9
84;2021-05-14;57523;25018;2371720;1145458;29.5;14.3
84;2021-05-15;44264;13649;2415984;1159107;30.1;14.4
84;2021-05-16;30618;5149;2446602;1164256;30.5;14.5
84;2021-05-17;48511;24972;2495113;1189228;31.1;14.8
84;2021-05-18;59445;27419;2554558;1216647;31.8;15.1
84;2021-05-19;58534;23565;2613092;1240212;32.5;15.4
84;2021-05-20;61844;27043;2674936;1267255;33.3;15.8
84;2021-05-21;61087;29399;2736023;1296654;34.1;16.1
84;2021-05-22;40450;12912;2776473;1309566;34.6;16.3
84;2021-05-23;21381;3981;2797854;1313547;34.8;16.4
84;2021-05-24;39939;8547;2837793;1322094;35.3;16.5
84;2021-05-25;50331;31684;2888124;1353778;36.0;16.9
84;2021-05-26;49894;28927;2938018;1382705;36.6;17.2
84;2021-05-27;55745;31832;2993763;1414537;37.3;17.6
84;2021-05-28;54859;40491;3048622;1455028;38.0;18.1
84;2021-05-29;37650;22373;3086272;1477401;38.4;18.4
84;2021-05-30;16118;7264;3102390;1484665;38.6;18.5
84;2021-05-31;44342;29405;3146732;1514070;39.2;18.8
84;2021-06-01;48520;36634;3195252;1550704;39.8;19.3
84;2021-06-02;47746;31246;3242998;1581950;40.4;19.7
84;2021-06-03;56083;36587;3299081;1618537;41.1;20.2
84;2021-06-04;54632;42401;3353713;1660938;41.8;20.7
84;2021-06-05;38063;21680;3391776;1682618;42.2;20.9
84;2021-06-06;15908;6294;3407684;1688912;42.4;21.0
84;2021-06-07;41355;35166;3449039;1724078;42.9;21.5
84;2021-06-08;45042;37922;3494081;1762000;43.5;21.9
84;2021-06-09;40548;33941;3534629;1795941;44.0;22.4
84;2021-06-10;41200;33892;3575829;1829833;44.5;22.8
84;2021-06-11;43271;46360;3619100;1876193;45.1;23.4
84;2021-06-12;28126;22945;3647226;1899138;45.4;23.6
84;2021-06-13;8609;7135;3655835;1906273;45.5;23.7
84;2021-06-14;25541;44547;3681376;1950820;45.8;24.3
84;2021-06-15;31595;49299;3712971;2000119;46.2;24.9
84;2021-06-16;33320;45434;3746291;2045553;46.6;25.5
84;2021-06-17;30519;46951;3776810;2092504;47.0;26.1
84;2021-06-18;34886;59942;3811696;2152446;47.5;26.8
84;2021-06-19;22747;35739;3834443;2188185;47.7;27.2
84;2021-06-20;8669;14416;3843112;2202601;47.8;27.4
84;2021-06-21;19975;56161;3863087;2258762;48.1;28.1
84;2021-06-22;21002;62744;3884089;2321506;48.4;28.9
84;2021-06-23;22295;57609;3906384;2379115;48.6;29.6
84;2021-06-24;23130;55081;3929514;2434196;48.9;30.3
84;2021-06-25;23516;70285;3953030;2504481;49.2;31.2
84;2021-06-26;14020;46206;3967050;2550687;49.4;31.8
84;2021-06-27;6851;23500;3973901;2574187;49.5;32.0
84;2021-06-28;15665;64733;3989566;2638920;49.7;32.9
84;2021-06-29;19011;66800;4008577;2705720;49.9;33.7
93;2020-12-27;1;0;1;0;0.0;0.0
93;2020-12-28;2;0;3;0;0.0;0.0
93;2020-12-29;1;0;4;0;0.0;0.0
93;2020-12-30;3;0;7;0;0.0;0.0
93;2020-12-31;19;0;26;0;0.0;0.0
93;2021-01-01;13;0;39;0;0.0;0.0
93;2021-01-02;2;0;41;0;0.0;0.0
93;2021-01-03;2;0;43;0;0.0;0.0
93;2021-01-04;133;1;176;1;0.0;0.0
93;2021-01-05;251;1;427;2;0.0;0.0
93;2021-01-06;410;0;837;2;0.0;0.0
93;2021-01-07;1245;2;2082;4;0.0;0.0
93;2021-01-08;1566;2;3648;6;0.1;0.0
93;2021-01-09;541;1;4189;7;0.1;0.0
93;2021-01-10;74;0;4263;7;0.1;0.0
93;2021-01-11;2412;1;6675;8;0.1;0.0
93;2021-01-12;5093;7;11768;15;0.2;0.0
93;2021-01-13;4466;16;16234;31;0.3;0.0
93;2021-01-14;5580;51;21814;82;0.4;0.0
93;2021-01-15;4934;15;26748;97;0.5;0.0
93;2021-01-16;1679;5;28427;102;0.6;0.0
93;2021-01-17;300;1;28727;103;0.6;0.0
93;2021-01-18;7158;30;35885;133;0.7;0.0
93;2021-01-19;13530;36;49415;169;1.0;0.0
93;2021-01-20;12259;37;61674;206;1.2;0.0
93;2021-01-21;12309;49;73983;255;1.5;0.0
93;2021-01-22;10206;28;84189;283;1.7;0.0
93;2021-01-23;3327;6;87516;289;1.7;0.0
93;2021-01-24;537;4;88053;293;1.7;0.0
93;2021-01-25;7255;41;95308;334;1.9;0.0
93;2021-01-26;10074;138;105382;472;2.1;0.0
93;2021-01-27;9692;291;115074;763;2.3;0.0
93;2021-01-28;13668;833;128742;1596;2.5;0.0
93;2021-01-29;9847;982;138589;2578;2.7;0.1
93;2021-01-30;2240;159;140829;2737;2.8;0.1
93;2021-01-31;304;5;141133;2742;2.8;0.1
93;2021-02-01;5164;1519;146297;4261;2.9;0.1
93;2021-02-02;6648;2380;152945;6641;3.0;0.1
93;2021-02-03;5024;1822;157969;8463;3.1;0.2
93;2021-02-04;5537;3161;163506;11624;3.2;0.2
93;2021-02-05;6110;4127;169616;15751;3.4;0.3
93;2021-02-06;1246;973;170862;16724;3.4;0.3
93;2021-02-07;280;81;171142;16805;3.4;0.3
93;2021-02-08;4303;3747;175445;20552;3.5;0.4
93;2021-02-09;5890;7103;181335;27655;3.6;0.5
93;2021-02-10;5972;5884;187307;33539;3.7;0.7
93;2021-02-11;6607;6719;193914;40258;3.8;0.8
93;2021-02-12;5727;6474;199641;46732;3.9;0.9
93;2021-02-13;1129;1449;200770;48181;4.0;1.0
93;2021-02-14;73;384;200843;48565;4.0;1.0
93;2021-02-15;2419;5637;203262;54202;4.0;1.1
93;2021-02-16;3196;7707;206458;61909;4.1;1.2
93;2021-02-17;3608;8528;210066;70437;4.2;1.4
93;2021-02-18;6014;11425;216080;81862;4.3;1.6
93;2021-02-19;5650;8678;221730;90540;4.4;1.8
93;2021-02-20;880;1801;222610;92341;4.4;1.8
93;2021-02-21;70;417;222680;92758;4.4;1.8
93;2021-02-22;3032;6999;225712;99757;4.5;2.0
93;2021-02-23;3967;7244;229679;107001;4.5;2.1
93;2021-02-24;4752;6798;234431;113799;4.6;2.3
93;2021-02-25;8256;6668;242687;120467;4.8;2.4
93;2021-02-26;8285;6184;250972;126651;5.0;2.5
93;2021-02-27;3293;1490;254265;128141;5.0;2.5
93;2021-02-28;306;238;254571;128379;5.0;2.5
93;2021-03-01;5661;4488;260232;132867;5.1;2.6
93;2021-03-02;7229;5932;267461;138799;5.3;2.7
93;2021-03-03;8990;6556;276451;145355;5.5;2.9
93;2021-03-04;12071;6467;288522;151822;5.7;3.0
93;2021-03-05;12213;6099;300735;157921;5.9;3.1
93;2021-03-06;22891;1320;323626;159241;6.4;3.1
93;2021-03-07;18002;618;341628;159859;6.8;3.2
93;2021-03-08;10248;5280;351876;165139;7.0;3.3
93;2021-03-09;13976;5564;365852;170703;7.2;3.4
93;2021-03-10;14497;5287;380349;175990;7.5;3.5
93;2021-03-11;20400;6168;400749;182158;7.9;3.6
93;2021-03-12;21920;5318;422669;187476;8.4;3.7
93;2021-03-13;24609;1237;447278;188713;8.8;3.7
93;2021-03-14;6472;264;453750;188977;9.0;3.7
93;2021-03-15;15949;3095;469699;192072;9.3;3.8
93;2021-03-16;12722;3638;482421;195710;9.5;3.9
93;2021-03-17;16015;4641;498436;200351;9.9;4.0
93;2021-03-18;17039;4900;515475;205251;10.2;4.1
93;2021-03-19;21030;4706;536505;209957;10.6;4.2
93;2021-03-20;10993;1324;547498;211281;10.8;4.2
93;2021-03-21;3258;130;550756;211411;10.9;4.2
93;2021-03-22;17103;3559;567859;214970;11.2;4.3
93;2021-03-23;22665;3880;590524;218850;11.7;4.3
93;2021-03-24;21982;6634;612506;225484;12.1;4.5
93;2021-03-25;29046;6511;641552;231995;12.7;4.6
93;2021-03-26;29924;5041;671476;237036;13.3;4.7
93;2021-03-27;12458;1637;683934;238673;13.5;4.7
93;2021-03-28;3577;100;687511;238773;13.6;4.7
93;2021-03-29;18542;5330;706053;244103;14.0;4.8
93;2021-03-30;28514;6693;734567;250796;14.5;5.0
93;2021-03-31;28798;6637;763365;257433;15.1;5.1
93;2021-04-01;30778;7487;794143;264920;15.7;5.2
93;2021-04-02;26945;8493;821088;273413;16.2;5.4
93;2021-04-03;9772;4983;830860;278396;16.4;5.5
93;2021-04-04;2122;1253;832982;279649;16.5;5.5
93;2021-04-05;6064;1564;839046;281213;16.6;5.6
93;2021-04-06;23431;10026;862477;291239;17.1;5.8
93;2021-04-07;26087;11675;888564;302914;17.6;6.0
93;2021-04-08;28872;14979;917436;317893;18.1;6.3
93;2021-04-09;33631;14624;951067;332517;18.8;6.6
93;2021-04-10;14824;8173;965891;340690;19.1;6.7
93;2021-04-11;3634;2963;969525;343653;19.2;6.8
93;2021-04-12;20607;12214;990132;355867;19.6;7.0
93;2021-04-13;25605;15241;1015737;371108;20.1;7.3
93;2021-04-14;25191;15260;1040928;386368;20.6;7.6
93;2021-04-15;27020;15666;1067948;402034;21.1;8.0
93;2021-04-16;27915;16456;1095863;418490;21.7;8.3
93;2021-04-17;12839;7740;1108702;426230;21.9;8.4
93;2021-04-18;5254;2960;1113956;429190;22.0;8.5
93;2021-04-19;19100;15966;1133056;445156;22.4;8.8
93;2021-04-20;21360;18746;1154416;463902;22.8;9.2
93;2021-04-21;23923;18326;1178339;482228;23.3;9.5
93;2021-04-22;25875;19275;1204214;501503;23.8;9.9
93;2021-04-23;25410;18184;1229624;519687;24.3;10.3
93;2021-04-24;11544;8700;1241168;528387;24.6;10.5
93;2021-04-25;3208;2140;1244376;530527;24.6;10.5
93;2021-04-26;16468;15865;1260844;546392;24.9;10.8
93;2021-04-27;19461;20168;1280305;566560;25.3;11.2
93;2021-04-28;21510;20111;1301815;586671;25.7;11.6
93;2021-04-29;27913;21786;1329728;608457;26.3;12.0
93;2021-04-30;27313;20612;1357041;629069;26.8;12.4
93;2021-05-01;11723;5298;1368764;634367;27.1;12.5
93;2021-05-02;4062;1884;1372826;636251;27.2;12.6
93;2021-05-03;20484;18180;1393310;654431;27.6;12.9
93;2021-05-04;20793;22732;1414103;677163;28.0;13.4
93;2021-05-05;19520;21510;1433623;698673;28.4;13.8
93;2021-05-06;24812;21649;1458435;720322;28.8;14.2
93;2021-05-07;22420;25007;1480855;745329;29.3;14.7
93;2021-05-08;13553;6898;1494408;752227;29.6;14.9
93;2021-05-09;3465;2320;1497873;754547;29.6;14.9
93;2021-05-10;18684;22591;1516557;777138;30.0;15.4
93;2021-05-11;25398;25653;1541955;802791;30.5;15.9
93;2021-05-12;32536;22544;1574491;825335;31.1;16.3
93;2021-05-13;28115;7894;1602606;833229;31.7;16.5
93;2021-05-14;35430;16439;1638036;849668;32.4;16.8
93;2021-05-15;29687;10274;1667723;859942;33.0;17.0
93;2021-05-16;12787;2536;1680510;862478;33.2;17.1
93;2021-05-17;25831;17490;1706341;879968;33.8;17.4
93;2021-05-18;30561;16771;1736902;896739;34.4;17.7
93;2021-05-19;30201;15186;1767103;911925;35.0;18.0
93;2021-05-20;32859;16720;1799962;928645;35.6;18.4
93;2021-05-21;33855;17878;1833817;946523;36.3;18.7
93;2021-05-22;18583;7678;1852400;954201;36.6;18.9
93;2021-05-23;5916;2022;1858316;956223;36.8;18.9
93;2021-05-24;17609;4992;1875925;961215;37.1;19.0
93;2021-05-25;23580;20449;1899505;981664;37.6;19.4
93;2021-05-26;24638;21907;1924143;1003571;38.1;19.9
93;2021-05-27;26461;23319;1950604;1026890;38.6;20.3
93;2021-05-28;22835;26624;1973439;1053514;39.0;20.8
93;2021-05-29;13151;14362;1986590;1067876;39.3;21.1
93;2021-05-30;2589;3179;1989179;1071055;39.3;21.2
93;2021-05-31;20856;21298;2010035;1092353;39.8;21.6
93;2021-06-01;24417;26155;2034452;1118508;40.2;22.1
93;2021-06-02;22188;26104;2056640;1144612;40.7;22.6
93;2021-06-03;27595;27278;2084235;1171890;41.2;23.2
93;2021-06-04;27951;28341;2112186;1200231;41.8;23.7
93;2021-06-05;16273;14244;2128459;1214475;42.1;24.0
93;2021-06-06;4886;2795;2133345;1217270;42.2;24.1
93;2021-06-07;17643;24400;2150988;1241670;42.5;24.6
93;2021-06-08;21007;24096;2171995;1265766;43.0;25.0
93;2021-06-09;20651;25754;2192646;1291520;43.4;25.5
93;2021-06-10;21621;24692;2214267;1316212;43.8;26.0
93;2021-06-11;19690;30790;2233957;1347002;44.2;26.6
93;2021-06-12;12948;15301;2246905;1362303;44.4;26.9
93;2021-06-13;2548;3320;2249453;1365623;44.5;27.0
93;2021-06-14;13065;29370;2262518;1394993;44.8;27.6
93;2021-06-15;16427;30973;2278945;1425966;45.1;28.2
93;2021-06-16;17011;25635;2295956;1451601;45.4;28.7
93;2021-06-17;17099;28145;2313055;1479746;45.8;29.3
93;2021-06-18;16226;27989;2329281;1507735;46.1;29.8
93;2021-06-19;9672;15322;2338953;1523057;46.3;30.1
93;2021-06-20;2389;3700;2341342;1526757;46.3;30.2
93;2021-06-21;9877;30432;2351219;1557189;46.5;30.8
93;2021-06-22;11510;34437;2362729;1591626;46.7;31.5
93;2021-06-23;11388;32243;2374117;1623869;47.0;32.1
93;2021-06-24;12138;34069;2386255;1657938;47.2;32.8
93;2021-06-25;11000;37818;2397255;1695756;47.4;33.5
93;2021-06-26;6478;21662;2403733;1717418;47.5;34.0
93;2021-06-27;1981;5792;2405714;1723210;47.6;34.1
93;2021-06-28;7732;32555;2413446;1755765;47.7;34.7
93;2021-06-29;10035;33601;2423481;1789366;47.9;35.4
94;2020-12-27;0;0;0;0;0.0;0.0
94;2020-12-28;0;0;0;0;0.0;0.0
94;2020-12-29;0;0;0;0;0.0;0.0
94;2020-12-30;0;0;0;0;0.0;0.0
94;2020-12-31;0;0;0;0;0.0;0.0
94;2021-01-01;0;0;0;0;0.0;0.0
94;2021-01-02;0;0;0;0;0.0;0.0
94;2021-01-03;0;0;0;0;0.0;0.0
94;2021-01-04;2;0;2;0;0.0;0.0
94;2021-01-05;0;0;2;0;0.0;0.0
94;2021-01-06;53;1;55;1;0.0;0.0
94;2021-01-07;333;1;388;2;0.1;0.0
94;2021-01-08;310;0;698;2;0.2;0.0
94;2021-01-09;78;0;776;2;0.2;0.0
94;2021-01-10;34;0;810;2;0.2;0.0
94;2021-01-11;152;2;962;4;0.3;0.0
94;2021-01-12;209;1;1171;5;0.3;0.0
94;2021-01-13;203;0;1374;5;0.4;0.0
94;2021-01-14;264;1;1638;6;0.5;0.0
94;2021-01-15;405;0;2043;6;0.6;0.0
94;2021-01-16;200;1;2243;7;0.7;0.0
94;2021-01-17;91;1;2334;8;0.7;0.0
94;2021-01-18;471;2;2805;10;0.8;0.0
94;2021-01-19;982;0;3787;10;1.1;0.0
94;2021-01-20;808;0;4595;10;1.3;0.0
94;2021-01-21;808;1;5403;11;1.6;0.0
94;2021-01-22;727;0;6130;11;1.8;0.0
94;2021-01-23;243;0;6373;11;1.8;0.0
94;2021-01-24;147;0;6520;11;1.9;0.0
94;2021-01-25;422;2;6942;13;2.0;0.0
94;2021-01-26;790;7;7732;20;2.2;0.0
94;2021-01-27;663;55;8395;75;2.4;0.0
94;2021-01-28;699;230;9094;305;2.6;0.1
94;2021-01-29;626;229;9720;534;2.8;0.2
94;2021-01-30;204;74;9924;608;2.9;0.2
94;2021-01-31;150;12;10074;620;2.9;0.2
94;2021-02-01;458;147;10532;767;3.1;0.2
94;2021-02-02;643;196;11175;963;3.2;0.3
94;2021-02-03;783;167;11958;1130;3.5;0.3
94;2021-02-04;714;298;12672;1428;3.7;0.4
94;2021-02-05;659;201;13331;1629;3.9;0.5
94;2021-02-06;207;75;13538;1704;3.9;0.5
94;2021-02-07;126;58;13664;1762;4.0;0.5
94;2021-02-08;322;366;13986;2128;4.1;0.6
94;2021-02-09;714;616;14700;2744;4.3;0.8
94;2021-02-10;643;430;15343;3174;4.5;0.9
94;2021-02-11;678;497;16021;3671;4.6;1.1
94;2021-02-12;641;429;16662;4100;4.8;1.2
94;2021-02-13;301;72;16963;4172;4.9;1.2
94;2021-02-14;195;78;17158;4250;5.0;1.2
94;2021-02-15;380;310;17538;4560;5.1;1.3
94;2021-02-16;634;606;18172;5166;5.3;1.5
94;2021-02-17;592;482;18764;5648;5.4;1.6
94;2021-02-18;550;545;19314;6193;5.6;1.8
94;2021-02-19;309;610;19623;6803;5.7;2.0
94;2021-02-20;276;199;19899;7002;5.8;2.0
94;2021-02-21;84;84;19983;7086;5.8;2.1
94;2021-02-22;211;406;20194;7492;5.9;2.2
94;2021-02-23;352;648;20546;8140;6.0;2.4
94;2021-02-24;299;609;20845;8749;6.0;2.5
94;2021-02-25;348;608;21193;9357;6.1;2.7
94;2021-02-26;420;555;21613;9912;6.3;2.9
94;2021-02-27;368;152;21981;10064;6.4;2.9
94;2021-02-28;70;123;22051;10187;6.4;3.0
94;2021-03-01;361;413;22412;10600;6.5;3.1
94;2021-03-02;549;655;22961;11255;6.7;3.3
94;2021-03-03;532;692;23493;11947;6.8;3.5
94;2021-03-04;950;635;24443;12582;7.1;3.7
94;2021-03-05;1584;676;26027;13258;7.6;3.8
94;2021-03-06;1843;164;27870;13422;8.1;3.9
94;2021-03-07;1381;100;29251;13522;8.5;3.9
94;2021-03-08;1228;324;30479;13846;8.8;4.0
94;2021-03-09;1313;656;31792;14502;9.2;4.2
94;2021-03-10;1260;577;33052;15079;9.6;4.4
94;2021-03-11;1307;635;34359;15714;10.0;4.6
94;2021-03-12;1517;541;35876;16255;10.4;4.7
94;2021-03-13;1118;303;36994;16558;10.7;4.8
94;2021-03-14;537;185;37531;16743;10.9;4.9
94;2021-03-15;886;400;38417;17143;11.1;5.0
94;2021-03-16;1065;641;39482;17784;11.5;5.2
94;2021-03-17;1225;530;40707;18314;11.8;5.3
94;2021-03-18;995;530;41702;18844;12.1;5.5
94;2021-03-19;1285;342;42987;19186;12.5;5.6
94;2021-03-20;1732;292;44719;19478;13.0;5.7
94;2021-03-21;1126;83;45845;19561;13.3;5.7
94;2021-03-22;889;188;46734;19749;13.6;5.7
94;2021-03-23;1302;319;48036;20068;13.9;5.8
94;2021-03-24;1687;306;49723;20374;14.4;5.9
94;2021-03-25;1753;296;51476;20670;14.9;6.0
94;2021-03-26;2031;345;53507;21015;15.5;6.1
94;2021-03-27;2271;228;55778;21243;16.2;6.2
94;2021-03-28;1070;217;56848;21460;16.5;6.2
94;2021-03-29;1025;312;57873;21772;16.8;6.3
94;2021-03-30;1358;556;59231;22328;17.2;6.5
94;2021-03-31;1428;488;60659;22816;17.6;6.6
94;2021-04-01;1642;679;62301;23495;18.1;6.8
94;2021-04-02;1863;1191;64164;24686;18.6;7.2
94;2021-04-03;1891;1128;66055;25814;19.2;7.5
94;2021-04-04;770;843;66825;26657;19.4;7.7
94;2021-04-05;629;806;67454;27463;19.6;8.0
94;2021-04-06;1581;913;69035;28376;20.0;8.2
94;2021-04-07;2008;849;71043;29225;20.6;8.5
94;2021-04-08;2174;756;73217;29981;21.2;8.7
94;2021-04-09;2099;948;75316;30929;21.9;9.0
94;2021-04-10;2402;625;77718;31554;22.5;9.2
94;2021-04-11;1173;315;78891;31869;22.9;9.2
94;2021-04-12;1517;896;80408;32765;23.3;9.5
94;2021-04-13;1384;1007;81792;33772;23.7;9.8
94;2021-04-14;2088;1075;83880;34847;24.3;10.1
94;2021-04-15;1922;1027;85802;35874;24.9;10.4
94;2021-04-16;1779;1038;87581;36912;25.4;10.7
94;2021-04-17;1750;1373;89331;38285;25.9;11.1
94;2021-04-18;1233;1280;90564;39565;26.3;11.5
94;2021-04-19;1090;772;91654;40337;26.6;11.7
94;2021-04-20;1249;1192;92903;41529;27.0;12.0
94;2021-04-21;1781;1333;94684;42862;27.5;12.4
94;2021-04-22;1832;1374;96516;44236;28.0;12.8
94;2021-04-23;1646;1403;98162;45639;28.5;13.2
94;2021-04-24;2031;1743;100193;47382;29.1;13.7
94;2021-04-25;1261;776;101454;48158;29.4;14.0
94;2021-04-26;1015;1145;102469;49303;29.7;14.3
94;2021-04-27;1308;1217;103777;50520;30.1;14.7
94;2021-04-28;2587;1274;106364;51794;30.9;15.0
94;2021-04-29;1968;1223;108332;53017;31.4;15.4
94;2021-04-30;2262;1878;110594;54895;32.1;15.9
94;2021-05-01;1425;1686;112019;56581;32.5;16.4
94;2021-05-02;1005;947;113024;57528;32.8;16.7
94;2021-05-03;1599;1066;114623;58594;33.3;17.0
94;2021-05-04;1557;1684;116180;60278;33.7;17.5
94;2021-05-05;1808;2357;117988;62635;34.2;18.2
94;2021-05-06;2187;1812;120175;64447;34.9;18.7
94;2021-05-07;2212;1818;122387;66265;35.5;19.2
94;2021-05-08;873;1353;123260;67618;35.8;19.6
94;2021-05-09;1174;1319;124434;68937;36.1;20.0
94;2021-05-10;1373;1537;125807;70474;36.5;20.4
94;2021-05-11;1581;1573;127388;72047;37.0;20.9
94;2021-05-12;1767;1377;129155;73424;37.5;21.3
94;2021-05-13;1940;514;131095;73938;38.0;21.5
94;2021-05-14;1513;1258;132608;75196;38.5;21.8
94;2021-05-15;1479;997;134087;76193;38.9;22.1
94;2021-05-16;1032;672;135119;76865;39.2;22.3
94;2021-05-17;1583;967;136702;77832;39.7;22.6
94;2021-05-18;1594;858;138296;78690;40.1;22.8
94;2021-05-19;1542;896;139838;79586;40.6;23.1
94;2021-05-20;1349;892;141187;80478;41.0;23.3
94;2021-05-21;1226;980;142413;81458;41.3;23.6
94;2021-05-22;1002;697;143415;82155;41.6;23.8
94;2021-05-23;683;328;144098;82483;41.8;23.9
94;2021-05-24;163;146;144261;82629;41.9;24.0
94;2021-05-25;952;856;145213;83485;42.1;24.2
94;2021-05-26;946;1953;146159;85438;42.4;24.8
94;2021-05-27;832;2243;146991;87681;42.6;25.4
94;2021-05-28;830;1822;147821;89503;42.9;26.0
94;2021-05-29;639;1252;148460;90755;43.1;26.3
94;2021-05-30;224;549;148684;91304;43.1;26.5
94;2021-05-31;553;1241;149237;92545;43.3;26.8
94;2021-06-01;736;1768;149973;94313;43.5;27.4
94;2021-06-02;610;1927;150583;96240;43.7;27.9
94;2021-06-03;782;1647;151365;97887;43.9;28.4
94;2021-06-04;604;2344;151969;100231;44.1;29.1
94;2021-06-05;553;1935;152522;102166;44.3;29.6
94;2021-06-06;215;1040;152737;103206;44.3;29.9
94;2021-06-07;436;1608;153173;104814;44.4;30.4
94;2021-06-08;690;1869;153863;106683;44.6;31.0
94;2021-06-09;800;2491;154663;109174;44.9;31.7
94;2021-06-10;669;1792;155332;110966;45.1;32.2
94;2021-06-11;689;2295;156021;113261;45.3;32.9
94;2021-06-12;352;1207;156373;114468;45.4;33.2
94;2021-06-13;202;854;156575;115322;45.4;33.5
94;2021-06-14;421;2038;156996;117360;45.5;34.0
94;2021-06-15;547;1724;157543;119084;45.7;34.5
94;2021-06-16;575;1711;158118;120795;45.9;35.0
94;2021-06-17;612;1637;158730;122432;46.1;35.5
94;2021-06-18;575;1877;159305;124309;46.2;36.1
94;2021-06-19;342;1014;159647;125323;46.3;36.4
94;2021-06-20;188;888;159835;126211;46.4;36.6
94;2021-06-21;435;1756;160270;127967;46.5;37.1
94;2021-06-22;536;1954;160806;129921;46.7;37.7
94;2021-06-23;401;1439;161207;131360;46.8;38.1
94;2021-06-24;463;1124;161670;132484;46.9;38.4
94;2021-06-25;359;1545;162029;134029;47.0;38.9
94;2021-06-26;300;1421;162329;135450;47.1;39.3
94;2021-06-27;199;1005;162528;136455;47.2;39.6
94;2021-06-28;515;1649;163043;138104;47.3;40.1
94;2021-06-29;454;1667;163497;139771;47.4;40.6
